time,subj_course_id,sec_code,sec_id,prof,available,waitlist,total,enrolled_ct
1715630853155,AESE 279B,A00,494370,Wade; Jon P,0,0,33,33
1715630854185,AIP 97,001,660915,Van Den Einde; Yael Dahlia,9998,0,9999,1
1715630855220,AIP 197,001,627712,Vespa; Emanuel Ignacio,9995,0,9999,4
1715630855220,AIP 197,002,650778,Amir; On,9998,0,9999,1
1715630855220,AIP 197,003,650933,Avenancio-Leon; Carlos,9998,0,9999,1
1715630855220,AIP 197,004,658530,Heyman; Gail D.,9998,0,9999,1
1715630855220,AIP 197,005,658631,Neal; Sonya E,9998,0,9999,1
1715630855220,AIP 197,006,658671,Du; Songzi,9998,0,9999,1
1715630856245,ANAR 135S,A00,494369,Braswell; Geoffrey E.,0,0,0,0
1715630857272,BENG 196,001,628496,Engler; Adam J.,9998,0,9999,1
1715630857272,BENG 196,002,660916,Watson; John Thomas,9999,0,9999,0
1715630858301,BISP 197,001,650773,Wilhelm; James E.,9994,0,9999,5
1715630858301,BISP 197,002,658904,Coleman; Aaron B.,9998,0,9999,1
1715630859328,CAT 124RS,A01,519847,Geibel; William,0,0,20,20
1715630860354,CAT 125RS,A01,515971,Geibel; William,0,0,20,20
1715630861384,CLRE 250,A00,511389,Morris; Sheldon,9992,0,9999,7
1715630862417,CLRE 251,A00,507176,Mehta; Ravindra L.,9992,0,9999,7
1715630862417,CLRE 251,B00,511410,Mehta; Ravindra L.,9998,0,9999,1
1715630863446,CLRE 252,A00,507189,Cuomo; Raphael Eduardo,9994,0,9999,5
1715630864474,CLRE 253,A00,507199,Vaida; Florin,9994,0,9999,5
1715630864474,CLRE 253,B00,507202,Vaida; Florin,9999,0,9999,0
1715630865500,CLRE 259,A00,507211,Patel; Hemal,9996,0,9999,3
1715630866526,CLRE 260,A00,507221,Cuomo; Raphael Eduardo,9999,0,9999,0
1715630867551,CLRE 297,001,507242,Cuomo; Raphael Eduardo,9999,0,9999,0
1715630868579,COGS 197,001,638244,Voytek; Bradley Thomas,9997,0,9999,2
1715630869604,CSE 191,A00,516875,Minnes Kemp; Mor Mia,9991,0,9999,8
1715630870633,CSE 197,001,637388,Minnes Kemp; Mor Mia,9992,0,9999,7
1715630871665,CSS 201S,A01,494383,Mignozzetti; Umberto,35,0,35,0
1715630872688,CSS 202S,A01,494387,Mignozzetti; Umberto,35,0,35,0
1715630873712,DSC 197,001,628532,Eldridge; Justin Matthew,9995,0,9999,4
1715630874739,EAP 100,A00,516065,Staff,9799,0,9999,200
1715630875766,ECE 45,A01,507414,Staff,31,0,60,29
1715630877828,ECE 111,A01,507420,Staff,11,0,50,39
1715630878854,ECE 197,001,548057,Sievenpiper; Daniel F.,9991,0,9999,8
1715630879880,EDS 115,A00,507243,Choi; Bailey Miyeon,7,0,28,21
1715630880906,EDS 117,A01,494379,Staff,0,6,34,34
1715630881936,EDS 125,A00,507246,Hopkins; Megan Beth,8,0,30,22
1715630882963,EDS 128A,A01,507264,Fargason; Sharon Gayle,6,0,26,20
1715630883989,EDS 128B,A01,507293,Pappas; Elizabeth,10,0,30,20
1715630885016,EDS 139,A00,507294,Fargason; Sharon Gayle,10,0,30,20
1715630885016,EDS 139,B00,507313,Pappas; Elizabeth,11,0,30,19
1715630886045,EDS 201,A00,507315,Staff,10,0,30,20
1715630887071,EDS 203,A01,507317,Halter; Christopher P.,10,0,30,20
1715630888101,EDS 204R,A01,507319,Halter; Christopher P.,0,3,30,30
1715630888101,EDS 204R,B01,507331,Heinzman; Erica M.,14,0,30,16
1715630889130,EDS 206R,A00,507332,Staff,0,4,30,30
1715630889130,EDS 206R,B00,507343,Staff,15,0,30,15
1715630890166,EDS 250,A00,507344,Hemans; Patricia Ann Benitez,20,0,40,20
1715630891192,EDS 281,A00,507345,Daly; Alan J.,18,0,18,0
1715630892217,EDS 284,A00,507350,Daly; Alan J.,16,0,16,0
1715630893256,EDS 286,A00,507359,Fine; Sarah,18,0,18,0
1715630894281,EDS 289C,A01,507361,Daly; Alan J.,18,0,18,0
1715630895308,EDS 290,A00,507366,Hofstetter; Carolyn,15,0,15,0
1715630896340,LIGM 5A,A00,507421,Fischer-Grunski; Eva K,17,0,20,3
1715630897368,LIGM 5B,A00,507423,Fischer-Grunski; Eva K,19,0,20,1
1715630898392,LIGM 5C,A00,507425,Fischer-Grunski; Eva K,19,0,20,1
1715630899419,LIIT 5AS,A00,507427,Carnelos; Chiara,20,0,20,0
1715630900444,LIIT 5BS,A00,507430,Carnelos; Chiara,20,0,20,0
1715630901470,LIIT 5CS,A00,507432,Carnelos; Chiara,20,0,20,0
1715630902496,LISP 5A,A00,507541,Munoz Sanchez; Alicia,11,0,20,9
1715630903522,LISP 5B,A00,507671,Munoz Sanchez; Alicia,9,0,20,11
1715630904550,LISP 5C,A00,507696,Munoz Sanchez; Alicia,9,0,20,11
1715630905577,MAE 197,001,528363,Boechler; Nicholas Sebastia,9998,0,9999,1
1715630906605,MATH 197,001,523477,Kedlaya; Kiran S.,9994,0,9999,5
1715630906605,MATH 197,002,563811,Zhang; Danna,9994,0,9999,5
1715630906605,MATH 197,003,628552,Dumitriu; Ioana,9998,0,9999,1
1715630906605,MATH 197,004,660885,Floyd; Eric,9998,0,9999,1
1715630907638,MCWP 40R,A00,518780,Staff,2,0,20,18
1715630907638,MCWP 40R,B00,518781,Staff,11,0,20,9
1715630907638,MCWP 40R,C00,518783,Staff,5,0,20,15
1715630908665,MCWP 50R,A00,518791,Staff,0,1,20,20
1715630908665,MCWP 50R,B00,518792,Staff,0,2,20,20
1715630908665,MCWP 50R,C00,518793,Staff,0,4,20,20
1715630908665,MCWP 50R,D00,518794,Staff,0,1,20,20
1715630908665,MCWP 50R,E00,518795,Staff,0,2,20,20
1715630908665,MCWP 50R,F00,518796,Staff,0,1,20,20
1715630908665,MCWP 50R,G00,518797,Staff,0,1,20,20
1715630909690,MMW 12R,A01,514034,Herbst; Matthew,0,2,16,16
1715630909690,MMW 12R,A02,514035,Herbst; Matthew,0,0,16,16
1715630910716,MMW 13R,A01,514037,Staff,0,5,16,16
1715630910716,MMW 13R,A02,514039,Staff,0,5,16,16
1715630910716,MMW 13R,A03,628519,Staff,0,4,16,16
1715630912769,SIO 295LS,A00,523233,Staff,10,0,30,20
1715630913793,SIO 295S,A00,523232,Staff,10,0,30,20
1715630914823,SIOC 290S,A01,637330,Merrifield; Mark A,22,0,30,8
1715630915855,SIOC 291S,A01,637333,Gabriel; Corey John,22,0,30,8
1715630916884,SOCI 117,A01,494376,Staff,0,5,5,5
1715630917913,WES 237B,A00,494380,Staff,10,0,20,10
1715630919990,AESE 279B,A00,494370,Wade; Jon P,0,0,33,33
1715630921016,AIP 97,001,660915,Van Den Einde; Yael Dahlia,9998,0,9999,1
1715630922060,AIP 197,001,627712,Vespa; Emanuel Ignacio,9995,0,9999,4
1715630922060,AIP 197,002,650778,Amir; On,9998,0,9999,1
1715630922060,AIP 197,003,650933,Avenancio-Leon; Carlos,9998,0,9999,1
1715630922060,AIP 197,004,658530,Heyman; Gail D.,9998,0,9999,1
1715630922060,AIP 197,005,658631,Neal; Sonya E,9998,0,9999,1
1715630922060,AIP 197,006,658671,Du; Songzi,9998,0,9999,1
1715630923087,ANAR 135S,A00,494369,Braswell; Geoffrey E.,0,0,0,0
1715630924113,BENG 196,001,628496,Engler; Adam J.,9998,0,9999,1
1715630924113,BENG 196,002,660916,Watson; John Thomas,9999,0,9999,0
1715630925144,BISP 197,001,650773,Wilhelm; James E.,9994,0,9999,5
1715630925144,BISP 197,002,658904,Coleman; Aaron B.,9998,0,9999,1
1715630926171,CAT 124RS,A01,519847,Geibel; William,0,0,20,20
1715630927199,CAT 125RS,A01,515971,Geibel; William,0,0,20,20
1715630928227,CLRE 250,A00,511389,Morris; Sheldon,9992,0,9999,7
1715630929258,CLRE 251,A00,507176,Mehta; Ravindra L.,9992,0,9999,7
1715630929258,CLRE 251,B00,511410,Mehta; Ravindra L.,9998,0,9999,1
1715630930283,CLRE 252,A00,507189,Cuomo; Raphael Eduardo,9994,0,9999,5
1715630931316,CLRE 253,A00,507199,Vaida; Florin,9994,0,9999,5
1715630931316,CLRE 253,B00,507202,Vaida; Florin,9999,0,9999,0
1715630932340,CLRE 259,A00,507211,Patel; Hemal,9996,0,9999,3
1715630933365,CLRE 260,A00,507221,Cuomo; Raphael Eduardo,9999,0,9999,0
1715630934391,CLRE 297,001,507242,Cuomo; Raphael Eduardo,9999,0,9999,0
1715630935418,COGS 197,001,638244,Voytek; Bradley Thomas,9997,0,9999,2
1715630936444,CSE 191,A00,516875,Minnes Kemp; Mor Mia,9991,0,9999,8
1715630937470,CSE 197,001,637388,Minnes Kemp; Mor Mia,9992,0,9999,7
1715630938501,CSS 201S,A01,494383,Mignozzetti; Umberto,35,0,35,0
1715630939528,CSS 202S,A01,494387,Mignozzetti; Umberto,35,0,35,0
1715630940557,DSC 197,001,628532,Eldridge; Justin Matthew,9995,0,9999,4
1715630941594,EAP 100,A00,516065,Staff,9799,0,9999,200
1715630942628,ECE 45,A01,507414,Staff,31,0,60,29
1715630944683,ECE 111,A01,507420,Staff,11,0,50,39
1715630945711,ECE 197,001,548057,Sievenpiper; Daniel F.,9991,0,9999,8
1715630946740,EDS 115,A00,507243,Choi; Bailey Miyeon,7,0,28,21
1715630947770,EDS 117,A01,494379,Staff,0,6,34,34
1715630948798,EDS 125,A00,507246,Hopkins; Megan Beth,8,0,30,22
1715630949827,EDS 128A,A01,507264,Fargason; Sharon Gayle,6,0,26,20
1715630950857,EDS 128B,A01,507293,Pappas; Elizabeth,10,0,30,20
1715630951883,EDS 139,A00,507294,Fargason; Sharon Gayle,10,0,30,20
1715630951883,EDS 139,B00,507313,Pappas; Elizabeth,11,0,30,19
1715630952912,EDS 201,A00,507315,Staff,10,0,30,20
1715630953941,EDS 203,A01,507317,Halter; Christopher P.,10,0,30,20
1715630954970,EDS 204R,A01,507319,Halter; Christopher P.,0,3,30,30
1715630954970,EDS 204R,B01,507331,Heinzman; Erica M.,14,0,30,16
1715630955995,EDS 206R,A00,507332,Staff,0,4,30,30
1715630955995,EDS 206R,B00,507343,Staff,15,0,30,15
1715630957022,EDS 250,A00,507344,Hemans; Patricia Ann Benitez,20,0,40,20
1715630958050,EDS 281,A00,507345,Daly; Alan J.,18,0,18,0
1715630959078,EDS 284,A00,507350,Daly; Alan J.,16,0,16,0
1715630960105,EDS 286,A00,507359,Fine; Sarah,18,0,18,0
1715630961133,EDS 289C,A01,507361,Daly; Alan J.,18,0,18,0
1715630962163,EDS 290,A00,507366,Hofstetter; Carolyn,15,0,15,0
1715630963191,LIGM 5A,A00,507421,Fischer-Grunski; Eva K,17,0,20,3
1715630964216,LIGM 5B,A00,507423,Fischer-Grunski; Eva K,19,0,20,1
1715630965241,LIGM 5C,A00,507425,Fischer-Grunski; Eva K,19,0,20,1
1715630966274,LIIT 5AS,A00,507427,Carnelos; Chiara,20,0,20,0
1715630967303,LIIT 5BS,A00,507430,Carnelos; Chiara,20,0,20,0
1715630968334,LIIT 5CS,A00,507432,Carnelos; Chiara,20,0,20,0
1715630969362,LISP 5A,A00,507541,Munoz Sanchez; Alicia,11,0,20,9
1715630970388,LISP 5B,A00,507671,Munoz Sanchez; Alicia,9,0,20,11
1715630971418,LISP 5C,A00,507696,Munoz Sanchez; Alicia,9,0,20,11
1715630972444,MAE 197,001,528363,Boechler; Nicholas Sebastia,9998,0,9999,1
1715630973472,MATH 197,001,523477,Kedlaya; Kiran S.,9994,0,9999,5
1715630973472,MATH 197,002,563811,Zhang; Danna,9994,0,9999,5
1715630973472,MATH 197,003,628552,Dumitriu; Ioana,9998,0,9999,1
1715630973472,MATH 197,004,660885,Floyd; Eric,9998,0,9999,1
1715630974498,MCWP 40R,A00,518780,Staff,2,0,20,18
1715630974498,MCWP 40R,B00,518781,Staff,11,0,20,9
1715630974498,MCWP 40R,C00,518783,Staff,5,0,20,15
1715630975524,MCWP 50R,A00,518791,Staff,0,1,20,20
1715630975524,MCWP 50R,B00,518792,Staff,0,2,20,20
1715630975524,MCWP 50R,C00,518793,Staff,0,4,20,20
1715630975524,MCWP 50R,D00,518794,Staff,0,1,20,20
1715630975524,MCWP 50R,E00,518795,Staff,0,2,20,20
1715630975524,MCWP 50R,F00,518796,Staff,0,1,20,20
1715630975524,MCWP 50R,G00,518797,Staff,0,1,20,20
1715630976553,MMW 12R,A01,514034,Herbst; Matthew,0,2,16,16
1715630976553,MMW 12R,A02,514035,Herbst; Matthew,0,0,16,16
1715630977581,MMW 13R,A01,514037,Staff,0,5,16,16
1715630977581,MMW 13R,A02,514039,Staff,0,5,16,16
1715630977581,MMW 13R,A03,628519,Staff,0,4,16,16
1715630979637,SIO 295LS,A00,523233,Staff,10,0,30,20
1715630980662,SIO 295S,A00,523232,Staff,10,0,30,20
1715630981692,SIOC 290S,A01,637330,Merrifield; Mark A,22,0,30,8
1715630982718,SIOC 291S,A01,637333,Gabriel; Corey John,22,0,30,8
1715630983743,SOCI 117,A01,494376,Staff,0,5,5,5
1715630984780,WES 237B,A00,494380,Staff,10,0,20,10
1715630986859,AESE 279B,A00,494370,Wade; Jon P,0,0,33,33
1715630987883,AIP 97,001,660915,Van Den Einde; Yael Dahlia,9998,0,9999,1
1715630988916,AIP 197,001,627712,Vespa; Emanuel Ignacio,9995,0,9999,4
1715630988916,AIP 197,002,650778,Amir; On,9998,0,9999,1
1715630988916,AIP 197,003,650933,Avenancio-Leon; Carlos,9998,0,9999,1
1715630988916,AIP 197,004,658530,Heyman; Gail D.,9998,0,9999,1
1715630988916,AIP 197,005,658631,Neal; Sonya E,9998,0,9999,1
1715630988916,AIP 197,006,658671,Du; Songzi,9998,0,9999,1
1715630989942,ANAR 135S,A00,494369,Braswell; Geoffrey E.,0,0,0,0
1715630990969,BENG 196,001,628496,Engler; Adam J.,9998,0,9999,1
1715630990969,BENG 196,002,660916,Watson; John Thomas,9999,0,9999,0
1715630991999,BISP 197,001,650773,Wilhelm; James E.,9994,0,9999,5
1715630991999,BISP 197,002,658904,Coleman; Aaron B.,9998,0,9999,1
1715630993023,CAT 124RS,A01,519847,Geibel; William,0,0,20,20
1715630994049,CAT 125RS,A01,515971,Geibel; William,0,0,20,20
1715630995080,CLRE 250,A00,511389,Morris; Sheldon,9992,0,9999,7
1715630996110,CLRE 251,A00,507176,Mehta; Ravindra L.,9992,0,9999,7
1715630996110,CLRE 251,B00,511410,Mehta; Ravindra L.,9998,0,9999,1
1715630997135,CLRE 252,A00,507189,Cuomo; Raphael Eduardo,9994,0,9999,5
1715630998160,CLRE 253,A00,507199,Vaida; Florin,9994,0,9999,5
1715630998160,CLRE 253,B00,507202,Vaida; Florin,9999,0,9999,0
1715630999189,CLRE 259,A00,507211,Patel; Hemal,9996,0,9999,3
1715631000213,CLRE 260,A00,507221,Cuomo; Raphael Eduardo,9999,0,9999,0
1715631001238,CLRE 297,001,507242,Cuomo; Raphael Eduardo,9999,0,9999,0
1715631002266,COGS 197,001,638244,Voytek; Bradley Thomas,9997,0,9999,2
1715631003294,CSE 191,A00,516875,Minnes Kemp; Mor Mia,9991,0,9999,8
1715631004318,CSE 197,001,637388,Minnes Kemp; Mor Mia,9992,0,9999,7
1715631005348,CSS 201S,A01,494383,Mignozzetti; Umberto,35,0,35,0
1715631006378,CSS 202S,A01,494387,Mignozzetti; Umberto,35,0,35,0
1715631007404,DSC 197,001,628532,Eldridge; Justin Matthew,9995,0,9999,4
1715631008429,EAP 100,A00,516065,Staff,9799,0,9999,200
1715631009458,ECE 45,A01,507414,Staff,31,0,60,29
1715631011510,ECE 111,A01,507420,Staff,11,0,50,39
1715631012561,ECE 197,001,548057,Sievenpiper; Daniel F.,9991,0,9999,8
1715631013592,EDS 115,A00,507243,Choi; Bailey Miyeon,7,0,28,21
1715631014617,EDS 117,A01,494379,Staff,0,6,34,34
1715631015645,EDS 125,A00,507246,Hopkins; Megan Beth,8,0,30,22
1715631016675,EDS 128A,A01,507264,Fargason; Sharon Gayle,6,0,26,20
1715631017703,EDS 128B,A01,507293,Pappas; Elizabeth,10,0,30,20
1715631018730,EDS 139,A00,507294,Fargason; Sharon Gayle,10,0,30,20
1715631018730,EDS 139,B00,507313,Pappas; Elizabeth,11,0,30,19
1715631019754,EDS 201,A00,507315,Staff,10,0,30,20
1715631020783,EDS 203,A01,507317,Halter; Christopher P.,10,0,30,20
1715631021809,EDS 204R,A01,507319,Halter; Christopher P.,0,3,30,30
1715631021809,EDS 204R,B01,507331,Heinzman; Erica M.,14,0,30,16
1715631022833,EDS 206R,A00,507332,Staff,0,4,30,30
1715631022833,EDS 206R,B00,507343,Staff,15,0,30,15
1715631023857,EDS 250,A00,507344,Hemans; Patricia Ann Benitez,20,0,40,20
1715631024886,EDS 281,A00,507345,Daly; Alan J.,18,0,18,0
1715631025913,EDS 284,A00,507350,Daly; Alan J.,16,0,16,0
1715631026938,EDS 286,A00,507359,Fine; Sarah,18,0,18,0
1715631027965,EDS 289C,A01,507361,Daly; Alan J.,18,0,18,0
1715631028988,EDS 290,A00,507366,Hofstetter; Carolyn,15,0,15,0
1715631030015,LIGM 5A,A00,507421,Fischer-Grunski; Eva K,17,0,20,3
1715631031040,LIGM 5B,A00,507423,Fischer-Grunski; Eva K,19,0,20,1
1715631032069,LIGM 5C,A00,507425,Fischer-Grunski; Eva K,19,0,20,1
1715631033097,LIIT 5AS,A00,507427,Carnelos; Chiara,20,0,20,0
1715631034124,LIIT 5BS,A00,507430,Carnelos; Chiara,20,0,20,0
1715631035151,LIIT 5CS,A00,507432,Carnelos; Chiara,20,0,20,0
1715631036178,LISP 5A,A00,507541,Munoz Sanchez; Alicia,11,0,20,9
1715631037208,LISP 5B,A00,507671,Munoz Sanchez; Alicia,9,0,20,11
1715631038235,LISP 5C,A00,507696,Munoz Sanchez; Alicia,9,0,20,11
1715631039264,MAE 197,001,528363,Boechler; Nicholas Sebastia,9998,0,9999,1
1715631040293,MATH 197,001,523477,Kedlaya; Kiran S.,9994,0,9999,5
1715631040293,MATH 197,002,563811,Zhang; Danna,9994,0,9999,5
1715631040293,MATH 197,003,628552,Dumitriu; Ioana,9998,0,9999,1
1715631040293,MATH 197,004,660885,Floyd; Eric,9998,0,9999,1
1715631041319,MCWP 40R,A00,518780,Staff,2,0,20,18
1715631041319,MCWP 40R,B00,518781,Staff,11,0,20,9
1715631041319,MCWP 40R,C00,518783,Staff,5,0,20,15
1715631042346,MCWP 50R,A00,518791,Staff,0,1,20,20
1715631042346,MCWP 50R,B00,518792,Staff,0,2,20,20
1715631042346,MCWP 50R,C00,518793,Staff,0,4,20,20
1715631042346,MCWP 50R,D00,518794,Staff,0,1,20,20
1715631042346,MCWP 50R,E00,518795,Staff,0,2,20,20
1715631042346,MCWP 50R,F00,518796,Staff,0,1,20,20
1715631042346,MCWP 50R,G00,518797,Staff,0,1,20,20
1715631043373,MMW 12R,A01,514034,Herbst; Matthew,0,2,16,16
1715631043373,MMW 12R,A02,514035,Herbst; Matthew,0,0,16,16
1715631044400,MMW 13R,A01,514037,Staff,0,5,16,16
1715631044400,MMW 13R,A02,514039,Staff,0,5,16,16
1715631044400,MMW 13R,A03,628519,Staff,0,4,16,16
1715631046459,SIO 295LS,A00,523233,Staff,10,0,30,20
1715631047486,SIO 295S,A00,523232,Staff,10,0,30,20
1715631048513,SIOC 290S,A01,637330,Merrifield; Mark A,22,0,30,8
1715631049539,SIOC 291S,A01,637333,Gabriel; Corey John,22,0,30,8
1715631050566,SOCI 117,A01,494376,Staff,0,5,5,5
1715631051593,WES 237B,A00,494380,Staff,10,0,20,10
1715631053670,AESE 279B,A00,494370,Wade; Jon P,0,0,33,33
1715631054698,AIP 97,001,660915,Van Den Einde; Yael Dahlia,9998,0,9999,1
1715631055728,AIP 197,001,627712,Vespa; Emanuel Ignacio,9995,0,9999,4
1715631055728,AIP 197,002,650778,Amir; On,9998,0,9999,1
1715631055728,AIP 197,003,650933,Avenancio-Leon; Carlos,9998,0,9999,1
1715631055728,AIP 197,004,658530,Heyman; Gail D.,9998,0,9999,1
1715631055728,AIP 197,005,658631,Neal; Sonya E,9998,0,9999,1
1715631055728,AIP 197,006,658671,Du; Songzi,9998,0,9999,1
1715631056755,ANAR 135S,A00,494369,Braswell; Geoffrey E.,0,0,0,0
1715631057781,BENG 196,001,628496,Engler; Adam J.,9998,0,9999,1
1715631057781,BENG 196,002,660916,Watson; John Thomas,9999,0,9999,0
1715631058805,BISP 197,001,650773,Wilhelm; James E.,9994,0,9999,5
1715631058805,BISP 197,002,658904,Coleman; Aaron B.,9998,0,9999,1
1715631059836,CAT 124RS,A01,519847,Geibel; William,0,0,20,20
1715631060862,CAT 125RS,A01,515971,Geibel; William,0,0,20,20
1715631061894,CLRE 250,A00,511389,Morris; Sheldon,9992,0,9999,7
1715631062922,CLRE 251,A00,507176,Mehta; Ravindra L.,9992,0,9999,7
1715631062922,CLRE 251,B00,511410,Mehta; Ravindra L.,9998,0,9999,1
1715631063949,CLRE 252,A00,507189,Cuomo; Raphael Eduardo,9994,0,9999,5
1715631064977,CLRE 253,A00,507199,Vaida; Florin,9994,0,9999,5
1715631064977,CLRE 253,B00,507202,Vaida; Florin,9999,0,9999,0
1715631066002,CLRE 259,A00,507211,Patel; Hemal,9996,0,9999,3
1715631067029,CLRE 260,A00,507221,Cuomo; Raphael Eduardo,9999,0,9999,0
1715631068053,CLRE 297,001,507242,Cuomo; Raphael Eduardo,9999,0,9999,0
1715631069079,COGS 197,001,638244,Voytek; Bradley Thomas,9997,0,9999,2
1715631070106,CSE 191,A00,516875,Minnes Kemp; Mor Mia,9991,0,9999,8
1715631071131,CSE 197,001,637388,Minnes Kemp; Mor Mia,9992,0,9999,7
1715631072161,CSS 201S,A01,494383,Mignozzetti; Umberto,35,0,35,0
1715631073189,CSS 202S,A01,494387,Mignozzetti; Umberto,35,0,35,0
1715631074216,DSC 197,001,628532,Eldridge; Justin Matthew,9995,0,9999,4
1715631075244,EAP 100,A00,516065,Staff,9799,0,9999,200
1715631076273,ECE 45,A01,507414,Staff,31,0,60,29
1715631078333,ECE 111,A01,507420,Staff,11,0,50,39
1715631079360,ECE 197,001,548057,Sievenpiper; Daniel F.,9991,0,9999,8
1715631080392,EDS 115,A00,507243,Choi; Bailey Miyeon,7,0,28,21
1715631081417,EDS 117,A01,494379,Staff,0,6,34,34
1715631082446,EDS 125,A00,507246,Hopkins; Megan Beth,8,0,30,22
1715631083473,EDS 128A,A01,507264,Fargason; Sharon Gayle,6,0,26,20
1715631084502,EDS 128B,A01,507293,Pappas; Elizabeth,10,0,30,20
1715631085530,EDS 139,A00,507294,Fargason; Sharon Gayle,10,0,30,20
1715631085530,EDS 139,B00,507313,Pappas; Elizabeth,11,0,30,19
1715631086557,EDS 201,A00,507315,Staff,10,0,30,20
1715631087588,EDS 203,A01,507317,Halter; Christopher P.,10,0,30,20
1715631088619,EDS 204R,A01,507319,Halter; Christopher P.,0,3,30,30
1715631088619,EDS 204R,B01,507331,Heinzman; Erica M.,14,0,30,16
1715631089649,EDS 206R,A00,507332,Staff,0,4,30,30
1715631089649,EDS 206R,B00,507343,Staff,15,0,30,15
1715631090675,EDS 250,A00,507344,Hemans; Patricia Ann Benitez,20,0,40,20
1715631091701,EDS 281,A00,507345,Daly; Alan J.,18,0,18,0
1715631092725,EDS 284,A00,507350,Daly; Alan J.,16,0,16,0
1715631093751,EDS 286,A00,507359,Fine; Sarah,18,0,18,0
1715631094778,EDS 289C,A01,507361,Daly; Alan J.,18,0,18,0
1715631095805,EDS 290,A00,507366,Hofstetter; Carolyn,15,0,15,0
1715631096836,LIGM 5A,A00,507421,Fischer-Grunski; Eva K,17,0,20,3
1715631097866,LIGM 5B,A00,507423,Fischer-Grunski; Eva K,19,0,20,1
1715631098893,LIGM 5C,A00,507425,Fischer-Grunski; Eva K,19,0,20,1
1715631099919,LIIT 5AS,A00,507427,Carnelos; Chiara,20,0,20,0
1715631100945,LIIT 5BS,A00,507430,Carnelos; Chiara,20,0,20,0
1715631101971,LIIT 5CS,A00,507432,Carnelos; Chiara,20,0,20,0
1715631102997,LISP 5A,A00,507541,Munoz Sanchez; Alicia,11,0,20,9
1715631104025,LISP 5B,A00,507671,Munoz Sanchez; Alicia,9,0,20,11
1715631105050,LISP 5C,A00,507696,Munoz Sanchez; Alicia,9,0,20,11
1715631106076,MAE 197,001,528363,Boechler; Nicholas Sebastia,9998,0,9999,1
1715631107107,MATH 197,001,523477,Kedlaya; Kiran S.,9994,0,9999,5
1715631107107,MATH 197,002,563811,Zhang; Danna,9994,0,9999,5
1715631107107,MATH 197,003,628552,Dumitriu; Ioana,9998,0,9999,1
1715631107107,MATH 197,004,660885,Floyd; Eric,9998,0,9999,1
1715631108134,MCWP 40R,A00,518780,Staff,2,0,20,18
1715631108134,MCWP 40R,B00,518781,Staff,11,0,20,9
1715631108134,MCWP 40R,C00,518783,Staff,5,0,20,15
1715631109164,MCWP 50R,A00,518791,Staff,0,1,20,20
1715631109164,MCWP 50R,B00,518792,Staff,0,2,20,20
1715631109164,MCWP 50R,C00,518793,Staff,0,4,20,20
1715631109164,MCWP 50R,D00,518794,Staff,0,1,20,20
1715631109164,MCWP 50R,E00,518795,Staff,0,2,20,20
1715631109164,MCWP 50R,F00,518796,Staff,0,1,20,20
1715631109164,MCWP 50R,G00,518797,Staff,0,1,20,20
1715631110191,MMW 12R,A01,514034,Herbst; Matthew,0,2,16,16
1715631110191,MMW 12R,A02,514035,Herbst; Matthew,0,0,16,16
1715631111221,MMW 13R,A01,514037,Staff,0,5,16,16
1715631111221,MMW 13R,A02,514039,Staff,0,5,16,16
1715631111221,MMW 13R,A03,628519,Staff,0,4,16,16
1715631113276,SIO 295LS,A00,523233,Staff,10,0,30,20
1715631114301,SIO 295S,A00,523232,Staff,10,0,30,20
1715631115326,SIOC 290S,A01,637330,Merrifield; Mark A,22,0,30,8
1715631116357,SIOC 291S,A01,637333,Gabriel; Corey John,22,0,30,8
1715631117387,SOCI 117,A01,494376,Staff,0,5,5,5
1715631118418,WES 237B,A00,494380,Staff,10,0,20,10
1715631120492,AESE 279B,A00,494370,Wade; Jon P,0,0,33,33
1715631121519,AIP 97,001,660915,Van Den Einde; Yael Dahlia,9998,0,9999,1
1715631122546,AIP 197,001,627712,Vespa; Emanuel Ignacio,9995,0,9999,4
1715631122546,AIP 197,002,650778,Amir; On,9998,0,9999,1
1715631122546,AIP 197,003,650933,Avenancio-Leon; Carlos,9998,0,9999,1
1715631122546,AIP 197,004,658530,Heyman; Gail D.,9998,0,9999,1
1715631122546,AIP 197,005,658631,Neal; Sonya E,9998,0,9999,1
1715631122546,AIP 197,006,658671,Du; Songzi,9998,0,9999,1
1715631123574,ANAR 135S,A00,494369,Braswell; Geoffrey E.,0,0,0,0
1715631124601,BENG 196,001,628496,Engler; Adam J.,9998,0,9999,1
1715631124601,BENG 196,002,660916,Watson; John Thomas,9999,0,9999,0
1715631125630,BISP 197,001,650773,Wilhelm; James E.,9994,0,9999,5
1715631125630,BISP 197,002,658904,Coleman; Aaron B.,9998,0,9999,1
1715631126660,CAT 124RS,A01,519847,Geibel; William,0,0,20,20
1715631127690,CAT 125RS,A01,515971,Geibel; William,0,0,20,20
1715631128720,CLRE 250,A00,511389,Morris; Sheldon,9992,0,9999,7
1715631129747,CLRE 251,A00,507176,Mehta; Ravindra L.,9992,0,9999,7
1715631129747,CLRE 251,B00,511410,Mehta; Ravindra L.,9998,0,9999,1
1715631130777,CLRE 252,A00,507189,Cuomo; Raphael Eduardo,9994,0,9999,5
1715631131806,CLRE 253,A00,507199,Vaida; Florin,9994,0,9999,5
1715631131806,CLRE 253,B00,507202,Vaida; Florin,9999,0,9999,0
1715631132832,CLRE 259,A00,507211,Patel; Hemal,9996,0,9999,3
1715631133859,CLRE 260,A00,507221,Cuomo; Raphael Eduardo,9999,0,9999,0
1715631134884,CLRE 297,001,507242,Cuomo; Raphael Eduardo,9999,0,9999,0
1715631135910,COGS 197,001,638244,Voytek; Bradley Thomas,9997,0,9999,2
1715631136935,CSE 191,A00,516875,Minnes Kemp; Mor Mia,9991,0,9999,8
1715631137960,CSE 197,001,637388,Minnes Kemp; Mor Mia,9992,0,9999,7
1715631138989,CSS 201S,A01,494383,Mignozzetti; Umberto,35,0,35,0
1715631140014,CSS 202S,A01,494387,Mignozzetti; Umberto,35,0,35,0
1715631141043,DSC 197,001,628532,Eldridge; Justin Matthew,9995,0,9999,4
1715631142068,EAP 100,A00,516065,Staff,9799,0,9999,200
1715631143100,ECE 45,A01,507414,Staff,31,0,60,29
1715631145155,ECE 111,A01,507420,Staff,11,0,50,39
1715631146181,ECE 197,001,548057,Sievenpiper; Daniel F.,9991,0,9999,8
1715631147207,EDS 115,A00,507243,Choi; Bailey Miyeon,7,0,28,21
1715631148234,EDS 117,A01,494379,Staff,0,6,34,34
1715631149262,EDS 125,A00,507246,Hopkins; Megan Beth,8,0,30,22
1715631150290,EDS 128A,A01,507264,Fargason; Sharon Gayle,6,0,26,20
1715631151320,EDS 128B,A01,507293,Pappas; Elizabeth,10,0,30,20
1715631152366,EDS 139,A00,507294,Fargason; Sharon Gayle,10,0,30,20
1715631152366,EDS 139,B00,507313,Pappas; Elizabeth,11,0,30,19
1715631153392,EDS 201,A00,507315,Staff,10,0,30,20
1715631154416,EDS 203,A01,507317,Halter; Christopher P.,10,0,30,20
1715631155445,EDS 204R,A01,507319,Halter; Christopher P.,0,3,30,30
1715631155445,EDS 204R,B01,507331,Heinzman; Erica M.,14,0,30,16
1715631156472,EDS 206R,A00,507332,Staff,0,4,30,30
1715631156472,EDS 206R,B00,507343,Staff,15,0,30,15
1715631157499,EDS 250,A00,507344,Hemans; Patricia Ann Benitez,20,0,40,20
1715631158524,EDS 281,A00,507345,Daly; Alan J.,18,0,18,0
1715631159548,EDS 284,A00,507350,Daly; Alan J.,16,0,16,0
1715631160577,EDS 286,A00,507359,Fine; Sarah,18,0,18,0
1715631161602,EDS 289C,A01,507361,Daly; Alan J.,18,0,18,0
1715631162628,EDS 290,A00,507366,Hofstetter; Carolyn,15,0,15,0
1715631163654,LIGM 5A,A00,507421,Fischer-Grunski; Eva K,17,0,20,3
1715631164684,LIGM 5B,A00,507423,Fischer-Grunski; Eva K,19,0,20,1
1715631165710,LIGM 5C,A00,507425,Fischer-Grunski; Eva K,19,0,20,1
1715631166740,LIIT 5AS,A00,507427,Carnelos; Chiara,20,0,20,0
1715631167770,LIIT 5BS,A00,507430,Carnelos; Chiara,20,0,20,0
1715631168795,LIIT 5CS,A00,507432,Carnelos; Chiara,20,0,20,0
1715631169820,LISP 5A,A00,507541,Munoz Sanchez; Alicia,11,0,20,9
1715631170848,LISP 5B,A00,507671,Munoz Sanchez; Alicia,9,0,20,11
1715631171876,LISP 5C,A00,507696,Munoz Sanchez; Alicia,9,0,20,11
1715631172904,MAE 197,001,528363,Boechler; Nicholas Sebastia,9998,0,9999,1
1715631173935,MATH 197,001,523477,Kedlaya; Kiran S.,9994,0,9999,5
1715631173935,MATH 197,002,563811,Zhang; Danna,9994,0,9999,5
1715631173935,MATH 197,003,628552,Dumitriu; Ioana,9998,0,9999,1
1715631173935,MATH 197,004,660885,Floyd; Eric,9998,0,9999,1
1715631174961,MCWP 40R,A00,518780,Staff,2,0,20,18
1715631174961,MCWP 40R,B00,518781,Staff,11,0,20,9
1715631174961,MCWP 40R,C00,518783,Staff,5,0,20,15
1715631175985,MCWP 50R,A00,518791,Staff,0,1,20,20
1715631175985,MCWP 50R,B00,518792,Staff,0,2,20,20
1715631175985,MCWP 50R,C00,518793,Staff,0,4,20,20
1715631175985,MCWP 50R,D00,518794,Staff,0,1,20,20
1715631175985,MCWP 50R,E00,518795,Staff,0,2,20,20
1715631175985,MCWP 50R,F00,518796,Staff,0,1,20,20
1715631175985,MCWP 50R,G00,518797,Staff,0,1,20,20
1715631177011,MMW 12R,A01,514034,Herbst; Matthew,0,2,16,16
1715631177011,MMW 12R,A02,514035,Herbst; Matthew,0,0,16,16
1715631178036,MMW 13R,A01,514037,Staff,0,5,16,16
1715631178036,MMW 13R,A02,514039,Staff,0,5,16,16
1715631178036,MMW 13R,A03,628519,Staff,0,4,16,16
1715631180088,SIO 295LS,A00,523233,Staff,10,0,30,20
1715631181117,SIO 295S,A00,523232,Staff,10,0,30,20
1715631182161,SIOC 290S,A01,637330,Merrifield; Mark A,22,0,30,8
1715631183210,SIOC 291S,A01,637333,Gabriel; Corey John,22,0,30,8
1715631184238,SOCI 117,A01,494376,Staff,0,5,5,5
1715631185269,WES 237B,A00,494380,Staff,10,0,20,10
1715631187363,AESE 279B,A00,494370,Wade; Jon P,0,0,33,33
1715631188393,AIP 97,001,660915,Van Den Einde; Yael Dahlia,9998,0,9999,1
1715631189422,AIP 197,001,627712,Vespa; Emanuel Ignacio,9995,0,9999,4
1715631189422,AIP 197,002,650778,Amir; On,9998,0,9999,1
1715631189422,AIP 197,003,650933,Avenancio-Leon; Carlos,9998,0,9999,1
1715631189422,AIP 197,004,658530,Heyman; Gail D.,9998,0,9999,1
1715631189422,AIP 197,005,658631,Neal; Sonya E,9998,0,9999,1
1715631189422,AIP 197,006,658671,Du; Songzi,9998,0,9999,1
1715631190449,ANAR 135S,A00,494369,Braswell; Geoffrey E.,0,0,0,0
1715631191476,BENG 196,001,628496,Engler; Adam J.,9998,0,9999,1
1715631191476,BENG 196,002,660916,Watson; John Thomas,9999,0,9999,0
1715631192500,BISP 197,001,650773,Wilhelm; James E.,9994,0,9999,5
1715631192500,BISP 197,002,658904,Coleman; Aaron B.,9998,0,9999,1
1715631193526,CAT 124RS,A01,519847,Geibel; William,0,0,20,20
1715631194568,CAT 125RS,A01,515971,Geibel; William,0,0,20,20
1715631195595,CLRE 250,A00,511389,Morris; Sheldon,9992,0,9999,7
1715631196625,CLRE 251,A00,507176,Mehta; Ravindra L.,9992,0,9999,7
1715631196625,CLRE 251,B00,511410,Mehta; Ravindra L.,9998,0,9999,1
1715631197653,CLRE 252,A00,507189,Cuomo; Raphael Eduardo,9994,0,9999,5
1715631198678,CLRE 253,A00,507199,Vaida; Florin,9994,0,9999,5
1715631198678,CLRE 253,B00,507202,Vaida; Florin,9999,0,9999,0
1715631199704,CLRE 259,A00,507211,Patel; Hemal,9996,0,9999,3
1715631200733,CLRE 260,A00,507221,Cuomo; Raphael Eduardo,9999,0,9999,0
1715631201762,CLRE 297,001,507242,Cuomo; Raphael Eduardo,9999,0,9999,0
1715631202787,COGS 197,001,638244,Voytek; Bradley Thomas,9997,0,9999,2
1715631203812,CSE 191,A00,516875,Minnes Kemp; Mor Mia,9991,0,9999,8
1715631204841,CSE 197,001,637388,Minnes Kemp; Mor Mia,9992,0,9999,7
1715631205869,CSS 201S,A01,494383,Mignozzetti; Umberto,35,0,35,0
1715631206898,CSS 202S,A01,494387,Mignozzetti; Umberto,35,0,35,0
1715631207925,DSC 197,001,628532,Eldridge; Justin Matthew,9995,0,9999,4
1715631208952,EAP 100,A00,516065,Staff,9799,0,9999,200
1715631209984,ECE 45,A01,507414,Staff,31,0,60,29
1715631212036,ECE 111,A01,507420,Staff,11,0,50,39
1715631213118,ECE 197,001,548057,Sievenpiper; Daniel F.,9991,0,9999,8
1715631214143,EDS 115,A00,507243,Choi; Bailey Miyeon,7,0,28,21
1715631215171,EDS 117,A01,494379,Staff,0,6,34,34
1715631216196,EDS 125,A00,507246,Hopkins; Megan Beth,8,0,30,22
1715631217227,EDS 128A,A01,507264,Fargason; Sharon Gayle,6,0,26,20
1715631218254,EDS 128B,A01,507293,Pappas; Elizabeth,10,0,30,20
1715631219280,EDS 139,A00,507294,Fargason; Sharon Gayle,10,0,30,20
1715631219280,EDS 139,B00,507313,Pappas; Elizabeth,11,0,30,19
1715631220306,EDS 201,A00,507315,Staff,10,0,30,20
1715631221335,EDS 203,A01,507317,Halter; Christopher P.,10,0,30,20
1715631222361,EDS 204R,A01,507319,Halter; Christopher P.,0,3,30,30
1715631222361,EDS 204R,B01,507331,Heinzman; Erica M.,14,0,30,16
1715631223390,EDS 206R,A00,507332,Staff,0,4,30,30
1715631223390,EDS 206R,B00,507343,Staff,15,0,30,15
1715631224415,EDS 250,A00,507344,Hemans; Patricia Ann Benitez,20,0,40,20
1715631225441,EDS 281,A00,507345,Daly; Alan J.,18,0,18,0
1715631226467,EDS 284,A00,507350,Daly; Alan J.,16,0,16,0
1715631227496,EDS 286,A00,507359,Fine; Sarah,18,0,18,0
1715631228523,EDS 289C,A01,507361,Daly; Alan J.,18,0,18,0
1715631229550,EDS 290,A00,507366,Hofstetter; Carolyn,15,0,15,0
1715631230578,LIGM 5A,A00,507421,Fischer-Grunski; Eva K,17,0,20,3
1715631231604,LIGM 5B,A00,507423,Fischer-Grunski; Eva K,19,0,20,1
1715631232632,LIGM 5C,A00,507425,Fischer-Grunski; Eva K,19,0,20,1
1715631233657,LIIT 5AS,A00,507427,Carnelos; Chiara,20,0,20,0
1715631234688,LIIT 5BS,A00,507430,Carnelos; Chiara,20,0,20,0
1715631235713,LIIT 5CS,A00,507432,Carnelos; Chiara,20,0,20,0
1715631236745,LISP 5A,A00,507541,Munoz Sanchez; Alicia,11,0,20,9
1715631237771,LISP 5B,A00,507671,Munoz Sanchez; Alicia,9,0,20,11
1715631238795,LISP 5C,A00,507696,Munoz Sanchez; Alicia,9,0,20,11
1715631239823,MAE 197,001,528363,Boechler; Nicholas Sebastia,9998,0,9999,1
1715631240856,MATH 197,001,523477,Kedlaya; Kiran S.,9994,0,9999,5
1715631240856,MATH 197,002,563811,Zhang; Danna,9994,0,9999,5
1715631240856,MATH 197,003,628552,Dumitriu; Ioana,9998,0,9999,1
1715631240856,MATH 197,004,660885,Floyd; Eric,9998,0,9999,1
1715631241885,MCWP 40R,A00,518780,Staff,2,0,20,18
1715631241885,MCWP 40R,B00,518781,Staff,11,0,20,9
1715631241885,MCWP 40R,C00,518783,Staff,5,0,20,15
1715631242913,MCWP 50R,A00,518791,Staff,0,1,20,20
1715631242913,MCWP 50R,B00,518792,Staff,0,2,20,20
1715631242913,MCWP 50R,C00,518793,Staff,0,4,20,20
1715631242913,MCWP 50R,D00,518794,Staff,0,1,20,20
1715631242913,MCWP 50R,E00,518795,Staff,0,2,20,20
1715631242913,MCWP 50R,F00,518796,Staff,0,1,20,20
1715631242913,MCWP 50R,G00,518797,Staff,0,1,20,20
1715631243943,MMW 12R,A01,514034,Herbst; Matthew,0,2,16,16
1715631243943,MMW 12R,A02,514035,Herbst; Matthew,0,0,16,16
1715631244971,MMW 13R,A01,514037,Staff,0,5,16,16
1715631244971,MMW 13R,A02,514039,Staff,0,5,16,16
1715631244971,MMW 13R,A03,628519,Staff,0,4,16,16
1715631247033,SIO 295LS,A00,523233,Staff,10,0,30,20
1715631248057,SIO 295S,A00,523232,Staff,10,0,30,20
1715631249088,SIOC 290S,A01,637330,Merrifield; Mark A,22,0,30,8
1715631250113,SIOC 291S,A01,637333,Gabriel; Corey John,22,0,30,8
1715631251139,SOCI 117,A01,494376,Staff,0,5,5,5
1715631252166,WES 237B,A00,494380,Staff,10,0,20,10
1715631254226,AESE 279B,A00,494370,Wade; Jon P,0,0,33,33
1715631255250,AIP 97,001,660915,Van Den Einde; Yael Dahlia,9998,0,9999,1
1715631256278,AIP 197,001,627712,Vespa; Emanuel Ignacio,9995,0,9999,4
1715631256278,AIP 197,002,650778,Amir; On,9998,0,9999,1
1715631256278,AIP 197,003,650933,Avenancio-Leon; Carlos,9998,0,9999,1
1715631256278,AIP 197,004,658530,Heyman; Gail D.,9998,0,9999,1
1715631256278,AIP 197,005,658631,Neal; Sonya E,9998,0,9999,1
1715631256278,AIP 197,006,658671,Du; Songzi,9998,0,9999,1
1715631257307,ANAR 135S,A00,494369,Braswell; Geoffrey E.,0,0,0,0
1715631258334,BENG 196,001,628496,Engler; Adam J.,9998,0,9999,1
1715631258334,BENG 196,002,660916,Watson; John Thomas,9999,0,9999,0
1715631259360,BISP 197,001,650773,Wilhelm; James E.,9994,0,9999,5
1715631259360,BISP 197,002,658904,Coleman; Aaron B.,9998,0,9999,1
1715631260386,CAT 124RS,A01,519847,Geibel; William,0,0,20,20
1715631261413,CAT 125RS,A01,515971,Geibel; William,0,0,20,20
1715631262438,CLRE 250,A00,511389,Morris; Sheldon,9992,0,9999,7
1715631263466,CLRE 251,A00,507176,Mehta; Ravindra L.,9992,0,9999,7
1715631263466,CLRE 251,B00,511410,Mehta; Ravindra L.,9998,0,9999,1
1715631264496,CLRE 252,A00,507189,Cuomo; Raphael Eduardo,9994,0,9999,5
1715631265527,CLRE 253,A00,507199,Vaida; Florin,9994,0,9999,5
1715631265527,CLRE 253,B00,507202,Vaida; Florin,9999,0,9999,0
1715631266553,CLRE 259,A00,507211,Patel; Hemal,9996,0,9999,3
1715631267592,CLRE 260,A00,507221,Cuomo; Raphael Eduardo,9999,0,9999,0
1715631268619,CLRE 297,001,507242,Cuomo; Raphael Eduardo,9999,0,9999,0
1715631269645,COGS 197,001,638244,Voytek; Bradley Thomas,9997,0,9999,2
1715631270671,CSE 191,A00,516875,Minnes Kemp; Mor Mia,9991,0,9999,8
1715631271698,CSE 197,001,637388,Minnes Kemp; Mor Mia,9992,0,9999,7
1715631272725,CSS 201S,A01,494383,Mignozzetti; Umberto,35,0,35,0
1715631273752,CSS 202S,A01,494387,Mignozzetti; Umberto,35,0,35,0
1715631274776,DSC 197,001,628532,Eldridge; Justin Matthew,9995,0,9999,4
1715631275800,EAP 100,A00,516065,Staff,9799,0,9999,200
1715631276831,ECE 45,A01,507414,Staff,31,0,60,29
1715631278884,ECE 111,A01,507420,Staff,11,0,50,39
1715631279912,ECE 197,001,548057,Sievenpiper; Daniel F.,9991,0,9999,8
1715631280940,EDS 115,A00,507243,Choi; Bailey Miyeon,7,0,28,21
1715631281966,EDS 117,A01,494379,Staff,0,6,34,34
1715631282992,EDS 125,A00,507246,Hopkins; Megan Beth,8,0,30,22
1715631284017,EDS 128A,A01,507264,Fargason; Sharon Gayle,6,0,26,20
1715631285048,EDS 128B,A01,507293,Pappas; Elizabeth,10,0,30,20
1715631286073,EDS 139,A00,507294,Fargason; Sharon Gayle,10,0,30,20
1715631286073,EDS 139,B00,507313,Pappas; Elizabeth,11,0,30,19
1715631287099,EDS 201,A00,507315,Staff,10,0,30,20
1715631288128,EDS 203,A01,507317,Halter; Christopher P.,10,0,30,20
1715631289154,EDS 204R,A01,507319,Halter; Christopher P.,0,3,30,30
1715631289154,EDS 204R,B01,507331,Heinzman; Erica M.,14,0,30,16
1715631290183,EDS 206R,A00,507332,Staff,0,4,30,30
1715631290183,EDS 206R,B00,507343,Staff,15,0,30,15
1715631291208,EDS 250,A00,507344,Hemans; Patricia Ann Benitez,20,0,40,20
1715631292235,EDS 281,A00,507345,Daly; Alan J.,18,0,18,0
1715631293261,EDS 284,A00,507350,Daly; Alan J.,16,0,16,0
1715631294291,EDS 286,A00,507359,Fine; Sarah,18,0,18,0
1715631295320,EDS 289C,A01,507361,Daly; Alan J.,18,0,18,0
1715631296349,EDS 290,A00,507366,Hofstetter; Carolyn,15,0,15,0
1715631297380,LIGM 5A,A00,507421,Fischer-Grunski; Eva K,17,0,20,3
1715631298406,LIGM 5B,A00,507423,Fischer-Grunski; Eva K,19,0,20,1
1715631299435,LIGM 5C,A00,507425,Fischer-Grunski; Eva K,19,0,20,1
1715631300461,LIIT 5AS,A00,507427,Carnelos; Chiara,20,0,20,0
1715631301487,LIIT 5BS,A00,507430,Carnelos; Chiara,20,0,20,0
1715631302515,LIIT 5CS,A00,507432,Carnelos; Chiara,20,0,20,0
1715631303546,LISP 5A,A00,507541,Munoz Sanchez; Alicia,11,0,20,9
1715631304573,LISP 5B,A00,507671,Munoz Sanchez; Alicia,9,0,20,11
1715631305599,LISP 5C,A00,507696,Munoz Sanchez; Alicia,9,0,20,11
1715631306626,MAE 197,001,528363,Boechler; Nicholas Sebastia,9998,0,9999,1
1715631307652,MATH 197,001,523477,Kedlaya; Kiran S.,9994,0,9999,5
1715631307652,MATH 197,002,563811,Zhang; Danna,9994,0,9999,5
1715631307652,MATH 197,003,628552,Dumitriu; Ioana,9998,0,9999,1
1715631307652,MATH 197,004,660885,Floyd; Eric,9998,0,9999,1
1715631308681,MCWP 40R,A00,518780,Staff,2,0,20,18
1715631308681,MCWP 40R,B00,518781,Staff,11,0,20,9
1715631308681,MCWP 40R,C00,518783,Staff,5,0,20,15
1715631309708,MCWP 50R,A00,518791,Staff,0,1,20,20
1715631309708,MCWP 50R,B00,518792,Staff,0,2,20,20
1715631309708,MCWP 50R,C00,518793,Staff,0,4,20,20
1715631309708,MCWP 50R,D00,518794,Staff,0,1,20,20
1715631309708,MCWP 50R,E00,518795,Staff,0,2,20,20
1715631309708,MCWP 50R,F00,518796,Staff,0,1,20,20
1715631309708,MCWP 50R,G00,518797,Staff,0,1,20,20
1715631310735,MMW 12R,A01,514034,Herbst; Matthew,0,2,16,16
1715631310735,MMW 12R,A02,514035,Herbst; Matthew,0,0,16,16
1715631311765,MMW 13R,A01,514037,Staff,0,5,16,16
1715631311765,MMW 13R,A02,514039,Staff,0,5,16,16
1715631311765,MMW 13R,A03,628519,Staff,0,4,16,16
1715631313816,SIO 295LS,A00,523233,Staff,10,0,30,20
1715631314842,SIO 295S,A00,523232,Staff,10,0,30,20
1715631315870,SIOC 290S,A01,637330,Merrifield; Mark A,22,0,30,8
1715631316899,SIOC 291S,A01,637333,Gabriel; Corey John,22,0,30,8
1715631317925,SOCI 117,A01,494376,Staff,0,5,5,5
1715631318954,WES 237B,A00,494380,Staff,10,0,20,10
1715631321023,AESE 279B,A00,494370,Wade; Jon P,0,0,33,33
1715631322050,AIP 97,001,660915,Van Den Einde; Yael Dahlia,9998,0,9999,1
1715631323076,AIP 197,001,627712,Vespa; Emanuel Ignacio,9995,0,9999,4
1715631323076,AIP 197,002,650778,Amir; On,9998,0,9999,1
1715631323076,AIP 197,003,650933,Avenancio-Leon; Carlos,9998,0,9999,1
1715631323076,AIP 197,004,658530,Heyman; Gail D.,9998,0,9999,1
1715631323076,AIP 197,005,658631,Neal; Sonya E,9998,0,9999,1
1715631323076,AIP 197,006,658671,Du; Songzi,9998,0,9999,1
1715631324107,ANAR 135S,A00,494369,Braswell; Geoffrey E.,0,0,0,0
1715631325131,BENG 196,001,628496,Engler; Adam J.,9998,0,9999,1
1715631325131,BENG 196,002,660916,Watson; John Thomas,9999,0,9999,0
1715631326157,BISP 197,001,650773,Wilhelm; James E.,9994,0,9999,5
1715631326157,BISP 197,002,658904,Coleman; Aaron B.,9998,0,9999,1
1715631327184,CAT 124RS,A01,519847,Geibel; William,0,0,20,20
1715631328211,CAT 125RS,A01,515971,Geibel; William,0,0,20,20
1715631329239,CLRE 250,A00,511389,Morris; Sheldon,9992,0,9999,7
1715631330270,CLRE 251,A00,507176,Mehta; Ravindra L.,9992,0,9999,7
1715631330270,CLRE 251,B00,511410,Mehta; Ravindra L.,9998,0,9999,1
1715631331296,CLRE 252,A00,507189,Cuomo; Raphael Eduardo,9994,0,9999,5
1715631332325,CLRE 253,A00,507199,Vaida; Florin,9994,0,9999,5
1715631332325,CLRE 253,B00,507202,Vaida; Florin,9999,0,9999,0
1715631333356,CLRE 259,A00,507211,Patel; Hemal,9996,0,9999,3
1715631334380,CLRE 260,A00,507221,Cuomo; Raphael Eduardo,9999,0,9999,0
1715631335405,CLRE 297,001,507242,Cuomo; Raphael Eduardo,9999,0,9999,0
1715631336433,COGS 197,001,638244,Voytek; Bradley Thomas,9997,0,9999,2
1715631337460,CSE 191,A00,516875,Minnes Kemp; Mor Mia,9991,0,9999,8
1715631338485,CSE 197,001,637388,Minnes Kemp; Mor Mia,9992,0,9999,7
1715631339513,CSS 201S,A01,494383,Mignozzetti; Umberto,35,0,35,0
1715631340538,CSS 202S,A01,494387,Mignozzetti; Umberto,35,0,35,0
1715631341563,DSC 197,001,628532,Eldridge; Justin Matthew,9995,0,9999,4
1715631342592,EAP 100,A00,516065,Staff,9799,0,9999,200
1715631343624,ECE 45,A01,507414,Staff,31,0,60,29
1715631345677,ECE 111,A01,507420,Staff,11,0,50,39
1715631346703,ECE 197,001,548057,Sievenpiper; Daniel F.,9991,0,9999,8
1715631347739,EDS 115,A00,507243,Choi; Bailey Miyeon,7,0,28,21
1715631348764,EDS 117,A01,494379,Staff,0,6,34,34
1715631349794,EDS 125,A00,507246,Hopkins; Megan Beth,8,0,30,22
1715631350818,EDS 128A,A01,507264,Fargason; Sharon Gayle,6,0,26,20
1715631351845,EDS 128B,A01,507293,Pappas; Elizabeth,10,0,30,20
1715631352869,EDS 139,A00,507294,Fargason; Sharon Gayle,10,0,30,20
1715631352869,EDS 139,B00,507313,Pappas; Elizabeth,11,0,30,19
1715631353909,EDS 201,A00,507315,Staff,10,0,30,20
1715631354934,EDS 203,A01,507317,Halter; Christopher P.,10,0,30,20
1715631355957,EDS 204R,A01,507319,Halter; Christopher P.,0,3,30,30
1715631355957,EDS 204R,B01,507331,Heinzman; Erica M.,14,0,30,16
1715631356985,EDS 206R,A00,507332,Staff,0,4,30,30
1715631356985,EDS 206R,B00,507343,Staff,15,0,30,15
1715631358008,EDS 250,A00,507344,Hemans; Patricia Ann Benitez,20,0,40,20
1715631359034,EDS 281,A00,507345,Daly; Alan J.,18,0,18,0
1715631360113,EDS 284,A00,507350,Daly; Alan J.,16,0,16,0
1715631361141,EDS 286,A00,507359,Fine; Sarah,18,0,18,0
1715631362170,EDS 289C,A01,507361,Daly; Alan J.,18,0,18,0
1715631363197,EDS 290,A00,507366,Hofstetter; Carolyn,15,0,15,0
1715631364226,LIGM 5A,A00,507421,Fischer-Grunski; Eva K,17,0,20,3
1715631365255,LIGM 5B,A00,507423,Fischer-Grunski; Eva K,19,0,20,1
1715631366281,LIGM 5C,A00,507425,Fischer-Grunski; Eva K,19,0,20,1
1715631367305,LIIT 5AS,A00,507427,Carnelos; Chiara,20,0,20,0
1715631368330,LIIT 5BS,A00,507430,Carnelos; Chiara,20,0,20,0
1715631369360,LIIT 5CS,A00,507432,Carnelos; Chiara,20,0,20,0
1715631370389,LISP 5A,A00,507541,Munoz Sanchez; Alicia,11,0,20,9
1715631371414,LISP 5B,A00,507671,Munoz Sanchez; Alicia,9,0,20,11
1715631372441,LISP 5C,A00,507696,Munoz Sanchez; Alicia,9,0,20,11
1715631373469,MAE 197,001,528363,Boechler; Nicholas Sebastia,9998,0,9999,1
1715631374502,MATH 197,001,523477,Kedlaya; Kiran S.,9994,0,9999,5
1715631374502,MATH 197,002,563811,Zhang; Danna,9994,0,9999,5
1715631374502,MATH 197,003,628552,Dumitriu; Ioana,9998,0,9999,1
1715631374502,MATH 197,004,660885,Floyd; Eric,9998,0,9999,1
1715631375528,MCWP 40R,A00,518780,Staff,2,0,20,18
1715631375528,MCWP 40R,B00,518781,Staff,11,0,20,9
1715631375528,MCWP 40R,C00,518783,Staff,5,0,20,15
1715631376553,MCWP 50R,A00,518791,Staff,0,1,20,20
1715631376553,MCWP 50R,B00,518792,Staff,0,2,20,20
1715631376553,MCWP 50R,C00,518793,Staff,0,4,20,20
1715631376553,MCWP 50R,D00,518794,Staff,0,1,20,20
1715631376553,MCWP 50R,E00,518795,Staff,0,2,20,20
1715631376553,MCWP 50R,F00,518796,Staff,0,1,20,20
1715631376553,MCWP 50R,G00,518797,Staff,0,1,20,20
1715631377579,MMW 12R,A01,514034,Herbst; Matthew,0,2,16,16
1715631377579,MMW 12R,A02,514035,Herbst; Matthew,0,0,16,16
1715631378606,MMW 13R,A01,514037,Staff,0,5,16,16
1715631378606,MMW 13R,A02,514039,Staff,0,5,16,16
1715631378606,MMW 13R,A03,628519,Staff,0,4,16,16
1715631380661,SIO 295LS,A00,523233,Staff,10,0,30,20
1715631381685,SIO 295S,A00,523232,Staff,10,0,30,20
1715631382711,SIOC 290S,A01,637330,Merrifield; Mark A,22,0,30,8
1715631383738,SIOC 291S,A01,637333,Gabriel; Corey John,22,0,30,8
1715631384761,SOCI 117,A01,494376,Staff,0,5,5,5
1715631385787,WES 237B,A00,494380,Staff,10,0,20,10
1715631387851,AESE 279B,A00,494370,Wade; Jon P,0,0,33,33
1715631388878,AIP 97,001,660915,Van Den Einde; Yael Dahlia,9998,0,9999,1
1715631389904,AIP 197,001,627712,Vespa; Emanuel Ignacio,9995,0,9999,4
1715631389904,AIP 197,002,650778,Amir; On,9998,0,9999,1
1715631389904,AIP 197,003,650933,Avenancio-Leon; Carlos,9998,0,9999,1
1715631389904,AIP 197,004,658530,Heyman; Gail D.,9998,0,9999,1
1715631389904,AIP 197,005,658631,Neal; Sonya E,9998,0,9999,1
1715631389904,AIP 197,006,658671,Du; Songzi,9998,0,9999,1
1715631390931,ANAR 135S,A00,494369,Braswell; Geoffrey E.,0,0,0,0
1715631391954,BENG 196,001,628496,Engler; Adam J.,9998,0,9999,1
1715631391954,BENG 196,002,660916,Watson; John Thomas,9999,0,9999,0
1715631392978,BISP 197,001,650773,Wilhelm; James E.,9994,0,9999,5
1715631392978,BISP 197,002,658904,Coleman; Aaron B.,9998,0,9999,1
1715631394005,CAT 124RS,A01,519847,Geibel; William,0,0,20,20
1715631395027,CAT 125RS,A01,515971,Geibel; William,0,0,20,20
1715631396056,CLRE 250,A00,511389,Morris; Sheldon,9992,0,9999,7
1715631397085,CLRE 251,A00,507176,Mehta; Ravindra L.,9992,0,9999,7
1715631397085,CLRE 251,B00,511410,Mehta; Ravindra L.,9998,0,9999,1
1715631398110,CLRE 252,A00,507189,Cuomo; Raphael Eduardo,9994,0,9999,5
1715631399140,CLRE 253,A00,507199,Vaida; Florin,9994,0,9999,5
1715631399140,CLRE 253,B00,507202,Vaida; Florin,9999,0,9999,0
1715631400165,CLRE 259,A00,507211,Patel; Hemal,9996,0,9999,3
1715631401191,CLRE 260,A00,507221,Cuomo; Raphael Eduardo,9999,0,9999,0
1715631402216,CLRE 297,001,507242,Cuomo; Raphael Eduardo,9999,0,9999,0
1715631403242,COGS 197,001,638244,Voytek; Bradley Thomas,9997,0,9999,2
1715631404271,CSE 191,A00,516875,Minnes Kemp; Mor Mia,9991,0,9999,8
1715631405297,CSE 197,001,637388,Minnes Kemp; Mor Mia,9992,0,9999,7
1715631406327,CSS 201S,A01,494383,Mignozzetti; Umberto,35,0,35,0
1715631407353,CSS 202S,A01,494387,Mignozzetti; Umberto,35,0,35,0
1715631408379,DSC 197,001,628532,Eldridge; Justin Matthew,9995,0,9999,4
1715631409407,EAP 100,A00,516065,Staff,9799,0,9999,200
1715631410437,ECE 45,A01,507414,Staff,31,0,60,29
1715631412489,ECE 111,A01,507420,Staff,11,0,50,39
1715631413519,ECE 197,001,548057,Sievenpiper; Daniel F.,9991,0,9999,8
1715631414545,EDS 115,A00,507243,Choi; Bailey Miyeon,7,0,28,21
1715631415572,EDS 117,A01,494379,Staff,0,6,34,34
1715631416598,EDS 125,A00,507246,Hopkins; Megan Beth,8,0,30,22
1715631417624,EDS 128A,A01,507264,Fargason; Sharon Gayle,6,0,26,20
1715631418654,EDS 128B,A01,507293,Pappas; Elizabeth,10,0,30,20
1715631419681,EDS 139,A00,507294,Fargason; Sharon Gayle,10,0,30,20
1715631419681,EDS 139,B00,507313,Pappas; Elizabeth,11,0,30,19
1715631420711,EDS 201,A00,507315,Staff,10,0,30,20
1715631421742,EDS 203,A01,507317,Halter; Christopher P.,10,0,30,20
1715631422771,EDS 204R,A01,507319,Halter; Christopher P.,0,3,30,30
1715631422771,EDS 204R,B01,507331,Heinzman; Erica M.,14,0,30,16
1715631423799,EDS 206R,A00,507332,Staff,0,4,30,30
1715631423799,EDS 206R,B00,507343,Staff,15,0,30,15
1715631424823,EDS 250,A00,507344,Hemans; Patricia Ann Benitez,20,0,40,20
1715631425847,EDS 281,A00,507345,Daly; Alan J.,18,0,18,0
1715631426874,EDS 284,A00,507350,Daly; Alan J.,16,0,16,0
1715631427903,EDS 286,A00,507359,Fine; Sarah,18,0,18,0
1715631428927,EDS 289C,A01,507361,Daly; Alan J.,18,0,18,0
1715631429951,EDS 290,A00,507366,Hofstetter; Carolyn,15,0,15,0
1715631430976,LIGM 5A,A00,507421,Fischer-Grunski; Eva K,17,0,20,3
1715631432000,LIGM 5B,A00,507423,Fischer-Grunski; Eva K,19,0,20,1
1715631433028,LIGM 5C,A00,507425,Fischer-Grunski; Eva K,19,0,20,1
1715631434053,LIIT 5AS,A00,507427,Carnelos; Chiara,20,0,20,0
1715631435077,LIIT 5BS,A00,507430,Carnelos; Chiara,20,0,20,0
1715631436103,LIIT 5CS,A00,507432,Carnelos; Chiara,20,0,20,0
1715631437130,LISP 5A,A00,507541,Munoz Sanchez; Alicia,11,0,20,9
1715631438160,LISP 5B,A00,507671,Munoz Sanchez; Alicia,9,0,20,11
1715631439187,LISP 5C,A00,507696,Munoz Sanchez; Alicia,9,0,20,11
1715631440213,MAE 197,001,528363,Boechler; Nicholas Sebastia,9998,0,9999,1
1715631441242,MATH 197,001,523477,Kedlaya; Kiran S.,9994,0,9999,5
1715631441242,MATH 197,002,563811,Zhang; Danna,9994,0,9999,5
1715631441242,MATH 197,003,628552,Dumitriu; Ioana,9998,0,9999,1
1715631441242,MATH 197,004,660885,Floyd; Eric,9998,0,9999,1
1715631442269,MCWP 40R,A00,518780,Staff,2,0,20,18
1715631442269,MCWP 40R,B00,518781,Staff,11,0,20,9
1715631442269,MCWP 40R,C00,518783,Staff,5,0,20,15
1715631443301,MCWP 50R,A00,518791,Staff,0,1,20,20
1715631443301,MCWP 50R,B00,518792,Staff,0,2,20,20
1715631443301,MCWP 50R,C00,518793,Staff,0,4,20,20
1715631443301,MCWP 50R,D00,518794,Staff,0,1,20,20
1715631443301,MCWP 50R,E00,518795,Staff,0,2,20,20
1715631443301,MCWP 50R,F00,518796,Staff,0,1,20,20
1715631443301,MCWP 50R,G00,518797,Staff,0,1,20,20
1715631444325,MMW 12R,A01,514034,Herbst; Matthew,0,2,16,16
1715631444325,MMW 12R,A02,514035,Herbst; Matthew,0,0,16,16
1715631445349,MMW 13R,A01,514037,Staff,0,5,16,16
1715631445349,MMW 13R,A02,514039,Staff,0,5,16,16
1715631445349,MMW 13R,A03,628519,Staff,0,4,16,16
1715631447402,SIO 295LS,A00,523233,Staff,10,0,30,20
1715631448428,SIO 295S,A00,523232,Staff,10,0,30,20
1715631449454,SIOC 290S,A01,637330,Merrifield; Mark A,22,0,30,8
1715631450490,SIOC 291S,A01,637333,Gabriel; Corey John,22,0,30,8
1715631451518,SOCI 117,A01,494376,Staff,0,5,5,5
1715631452550,WES 237B,A00,494380,Staff,10,0,20,10
1715631454620,AESE 279B,A00,494370,Wade; Jon P,0,0,33,33
1715631455643,AIP 97,001,660915,Van Den Einde; Yael Dahlia,9998,0,9999,1
1715631456674,AIP 197,001,627712,Vespa; Emanuel Ignacio,9995,0,9999,4
1715631456674,AIP 197,002,650778,Amir; On,9998,0,9999,1
1715631456674,AIP 197,003,650933,Avenancio-Leon; Carlos,9998,0,9999,1
1715631456674,AIP 197,004,658530,Heyman; Gail D.,9998,0,9999,1
1715631456674,AIP 197,005,658631,Neal; Sonya E,9998,0,9999,1
1715631456674,AIP 197,006,658671,Du; Songzi,9998,0,9999,1
1715631457711,ANAR 135S,A00,494369,Braswell; Geoffrey E.,0,0,0,0
1715631458737,BENG 196,001,628496,Engler; Adam J.,9998,0,9999,1
1715631458737,BENG 196,002,660916,Watson; John Thomas,9999,0,9999,0
1715631459762,BISP 197,001,650773,Wilhelm; James E.,9994,0,9999,5
1715631459762,BISP 197,002,658904,Coleman; Aaron B.,9998,0,9999,1
1715631460790,CAT 124RS,A01,519847,Geibel; William,0,0,20,20
1715631461815,CAT 125RS,A01,515971,Geibel; William,0,0,20,20
1715631462839,CLRE 250,A00,511389,Morris; Sheldon,9992,0,9999,7
1715631463869,CLRE 251,A00,507176,Mehta; Ravindra L.,9992,0,9999,7
1715631463869,CLRE 251,B00,511410,Mehta; Ravindra L.,9998,0,9999,1
1715631464896,CLRE 252,A00,507189,Cuomo; Raphael Eduardo,9994,0,9999,5
1715631465925,CLRE 253,A00,507199,Vaida; Florin,9994,0,9999,5
1715631465925,CLRE 253,B00,507202,Vaida; Florin,9999,0,9999,0
1715631466950,CLRE 259,A00,507211,Patel; Hemal,9996,0,9999,3
1715631467975,CLRE 260,A00,507221,Cuomo; Raphael Eduardo,9999,0,9999,0
1715631468999,CLRE 297,001,507242,Cuomo; Raphael Eduardo,9999,0,9999,0
1715631470023,COGS 197,001,638244,Voytek; Bradley Thomas,9997,0,9999,2
1715631471049,CSE 191,A00,516875,Minnes Kemp; Mor Mia,9991,0,9999,8
1715631472073,CSE 197,001,637388,Minnes Kemp; Mor Mia,9992,0,9999,7
1715631473103,CSS 201S,A01,494383,Mignozzetti; Umberto,35,0,35,0
1715631474127,CSS 202S,A01,494387,Mignozzetti; Umberto,35,0,35,0
1715631475150,DSC 197,001,628532,Eldridge; Justin Matthew,9995,0,9999,4
1715631476174,EAP 100,A00,516065,Staff,9799,0,9999,200
1715631477202,ECE 45,A01,507414,Staff,31,0,60,29
1715631479250,ECE 111,A01,507420,Staff,11,0,50,39
1715631480276,ECE 197,001,548057,Sievenpiper; Daniel F.,9991,0,9999,8
1715631481305,EDS 115,A00,507243,Choi; Bailey Miyeon,7,0,28,21
1715631482332,EDS 117,A01,494379,Staff,0,6,34,34
1715631483359,EDS 125,A00,507246,Hopkins; Megan Beth,8,0,30,22
1715631484385,EDS 128A,A01,507264,Fargason; Sharon Gayle,6,0,26,20
1715631485411,EDS 128B,A01,507293,Pappas; Elizabeth,10,0,30,20
1715631486436,EDS 139,A00,507294,Fargason; Sharon Gayle,10,0,30,20
1715631486436,EDS 139,B00,507313,Pappas; Elizabeth,11,0,30,19
1715631487463,EDS 201,A00,507315,Staff,10,0,30,20
1715631488488,EDS 203,A01,507317,Halter; Christopher P.,10,0,30,20
1715631489520,EDS 204R,A01,507319,Halter; Christopher P.,0,3,30,30
1715631489520,EDS 204R,B01,507331,Heinzman; Erica M.,14,0,30,16
1715631490545,EDS 206R,A00,507332,Staff,0,4,30,30
1715631490545,EDS 206R,B00,507343,Staff,15,0,30,15
1715631491571,EDS 250,A00,507344,Hemans; Patricia Ann Benitez,20,0,40,20
1715631492596,EDS 281,A00,507345,Daly; Alan J.,18,0,18,0
1715631493623,EDS 284,A00,507350,Daly; Alan J.,16,0,16,0
1715631494648,EDS 286,A00,507359,Fine; Sarah,18,0,18,0
1715631495675,EDS 289C,A01,507361,Daly; Alan J.,18,0,18,0
1715631496699,EDS 290,A00,507366,Hofstetter; Carolyn,15,0,15,0
1715631497744,LIGM 5A,A00,507421,Fischer-Grunski; Eva K,17,0,20,3
1715631498768,LIGM 5B,A00,507423,Fischer-Grunski; Eva K,19,0,20,1
1715631499798,LIGM 5C,A00,507425,Fischer-Grunski; Eva K,19,0,20,1
1715631500828,LIIT 5AS,A00,507427,Carnelos; Chiara,20,0,20,0
1715631501859,LIIT 5BS,A00,507430,Carnelos; Chiara,20,0,20,0
1715631502884,LIIT 5CS,A00,507432,Carnelos; Chiara,20,0,20,0
1715631503916,LISP 5A,A00,507541,Munoz Sanchez; Alicia,11,0,20,9
1715631504940,LISP 5B,A00,507671,Munoz Sanchez; Alicia,9,0,20,11
1715631505969,LISP 5C,A00,507696,Munoz Sanchez; Alicia,9,0,20,11
1715631506996,MAE 197,001,528363,Boechler; Nicholas Sebastia,9998,0,9999,1
1715631508023,MATH 197,001,523477,Kedlaya; Kiran S.,9994,0,9999,5
1715631508023,MATH 197,002,563811,Zhang; Danna,9994,0,9999,5
1715631508023,MATH 197,003,628552,Dumitriu; Ioana,9998,0,9999,1
1715631508023,MATH 197,004,660885,Floyd; Eric,9998,0,9999,1
1715631509050,MCWP 40R,A00,518780,Staff,2,0,20,18
1715631509050,MCWP 40R,B00,518781,Staff,11,0,20,9
1715631509050,MCWP 40R,C00,518783,Staff,5,0,20,15
1715631510084,MCWP 50R,A00,518791,Staff,0,1,20,20
1715631510084,MCWP 50R,B00,518792,Staff,0,2,20,20
1715631510084,MCWP 50R,C00,518793,Staff,0,4,20,20
1715631510084,MCWP 50R,D00,518794,Staff,0,1,20,20
1715631510084,MCWP 50R,E00,518795,Staff,0,2,20,20
1715631510084,MCWP 50R,F00,518796,Staff,0,1,20,20
1715631510084,MCWP 50R,G00,518797,Staff,0,1,20,20
1715631511111,MMW 12R,A01,514034,Herbst; Matthew,0,2,16,16
1715631511111,MMW 12R,A02,514035,Herbst; Matthew,0,0,16,16
1715631512135,MMW 13R,A01,514037,Staff,0,5,16,16
1715631512135,MMW 13R,A02,514039,Staff,0,5,16,16
1715631512135,MMW 13R,A03,628519,Staff,0,4,16,16
1715631514187,SIO 295LS,A00,523233,Staff,10,0,30,20
1715631515212,SIO 295S,A00,523232,Staff,10,0,30,20
1715631516243,SIOC 290S,A01,637330,Merrifield; Mark A,22,0,30,8
1715631517272,SIOC 291S,A01,637333,Gabriel; Corey John,22,0,30,8
1715631518308,SOCI 117,A01,494376,Staff,0,5,5,5
1715631519332,WES 237B,A00,494380,Staff,10,0,20,10
1715631521416,AESE 279B,A00,494370,Wade; Jon P,0,0,33,33
1715631522445,AIP 97,001,660915,Van Den Einde; Yael Dahlia,9998,0,9999,1
1715631523481,AIP 197,001,627712,Vespa; Emanuel Ignacio,9995,0,9999,4
1715631523481,AIP 197,002,650778,Amir; On,9998,0,9999,1
1715631523481,AIP 197,003,650933,Avenancio-Leon; Carlos,9998,0,9999,1
1715631523481,AIP 197,004,658530,Heyman; Gail D.,9998,0,9999,1
1715631523481,AIP 197,005,658631,Neal; Sonya E,9998,0,9999,1
1715631523481,AIP 197,006,658671,Du; Songzi,9998,0,9999,1
1715631524507,ANAR 135S,A00,494369,Braswell; Geoffrey E.,0,0,0,0
1715631525535,BENG 196,001,628496,Engler; Adam J.,9998,0,9999,1
1715631525535,BENG 196,002,660916,Watson; John Thomas,9999,0,9999,0
1715631526561,BISP 197,001,650773,Wilhelm; James E.,9994,0,9999,5
1715631526561,BISP 197,002,658904,Coleman; Aaron B.,9998,0,9999,1
1715631527588,CAT 124RS,A01,519847,Geibel; William,0,0,20,20
1715631528617,CAT 125RS,A01,515971,Geibel; William,0,0,20,20
1715631529643,CLRE 250,A00,511389,Morris; Sheldon,9992,0,9999,7
1715631530670,CLRE 251,A00,507176,Mehta; Ravindra L.,9992,0,9999,7
1715631530670,CLRE 251,B00,511410,Mehta; Ravindra L.,9998,0,9999,1
1715631531696,CLRE 252,A00,507189,Cuomo; Raphael Eduardo,9994,0,9999,5
1715631532722,CLRE 253,A00,507199,Vaida; Florin,9994,0,9999,5
1715631532722,CLRE 253,B00,507202,Vaida; Florin,9999,0,9999,0
1715631533748,CLRE 259,A00,507211,Patel; Hemal,9996,0,9999,3
1715631534773,CLRE 260,A00,507221,Cuomo; Raphael Eduardo,9999,0,9999,0
1715631535799,CLRE 297,001,507242,Cuomo; Raphael Eduardo,9999,0,9999,0
1715631536826,COGS 197,001,638244,Voytek; Bradley Thomas,9997,0,9999,2
1715631537852,CSE 191,A00,516875,Minnes Kemp; Mor Mia,9991,0,9999,8
1715631538878,CSE 197,001,637388,Minnes Kemp; Mor Mia,9992,0,9999,7
1715631539904,CSS 201S,A01,494383,Mignozzetti; Umberto,35,0,35,0
1715631540928,CSS 202S,A01,494387,Mignozzetti; Umberto,35,0,35,0
1715631541954,DSC 197,001,628532,Eldridge; Justin Matthew,9995,0,9999,4
1715631542978,EAP 100,A00,516065,Staff,9799,0,9999,200
1715631544008,ECE 45,A01,507414,Staff,31,0,60,29
1715631546058,ECE 111,A01,507420,Staff,11,0,50,39
1715631547085,ECE 197,001,548057,Sievenpiper; Daniel F.,9991,0,9999,8
1715631548113,EDS 115,A00,507243,Choi; Bailey Miyeon,7,0,28,21
1715631549145,EDS 117,A01,494379,Staff,0,6,34,34
1715631550173,EDS 125,A00,507246,Hopkins; Megan Beth,8,0,30,22
1715631551200,EDS 128A,A01,507264,Fargason; Sharon Gayle,6,0,26,20
1715631552230,EDS 128B,A01,507293,Pappas; Elizabeth,10,0,30,20
1715631553254,EDS 139,A00,507294,Fargason; Sharon Gayle,10,0,30,20
1715631553254,EDS 139,B00,507313,Pappas; Elizabeth,11,0,30,19
1715631554281,EDS 201,A00,507315,Staff,10,0,30,20
1715631555307,EDS 203,A01,507317,Halter; Christopher P.,10,0,30,20
1715631556331,EDS 204R,A01,507319,Halter; Christopher P.,0,3,30,30
1715631556331,EDS 204R,B01,507331,Heinzman; Erica M.,14,0,30,16
1715631557358,EDS 206R,A00,507332,Staff,0,4,30,30
1715631557358,EDS 206R,B00,507343,Staff,15,0,30,15
1715631558398,EDS 250,A00,507344,Hemans; Patricia Ann Benitez,20,0,40,20
1715631559426,EDS 281,A00,507345,Daly; Alan J.,18,0,18,0
1715631560452,EDS 284,A00,507350,Daly; Alan J.,16,0,16,0
1715631561477,EDS 286,A00,507359,Fine; Sarah,18,0,18,0
1715631562501,EDS 289C,A01,507361,Daly; Alan J.,18,0,18,0
1715631563527,EDS 290,A00,507366,Hofstetter; Carolyn,15,0,15,0
1715631564557,LIGM 5A,A00,507421,Fischer-Grunski; Eva K,17,0,20,3
1715631565584,LIGM 5B,A00,507423,Fischer-Grunski; Eva K,19,0,20,1
1715631566608,LIGM 5C,A00,507425,Fischer-Grunski; Eva K,19,0,20,1
1715631567638,LIIT 5AS,A00,507427,Carnelos; Chiara,20,0,20,0
1715631568662,LIIT 5BS,A00,507430,Carnelos; Chiara,20,0,20,0
1715631569685,LIIT 5CS,A00,507432,Carnelos; Chiara,20,0,20,0
1715631570712,LISP 5A,A00,507541,Munoz Sanchez; Alicia,11,0,20,9
1715631571734,LISP 5B,A00,507671,Munoz Sanchez; Alicia,9,0,20,11
1715631572758,LISP 5C,A00,507696,Munoz Sanchez; Alicia,9,0,20,11
1715631573785,MAE 197,001,528363,Boechler; Nicholas Sebastia,9998,0,9999,1
1715631574812,MATH 197,001,523477,Kedlaya; Kiran S.,9994,0,9999,5
1715631574812,MATH 197,002,563811,Zhang; Danna,9994,0,9999,5
1715631574812,MATH 197,003,628552,Dumitriu; Ioana,9998,0,9999,1
1715631574812,MATH 197,004,660885,Floyd; Eric,9998,0,9999,1
1715631575836,MCWP 40R,A00,518780,Staff,2,0,20,18
1715631575836,MCWP 40R,B00,518781,Staff,11,0,20,9
1715631575836,MCWP 40R,C00,518783,Staff,5,0,20,15
1715631576864,MCWP 50R,A00,518791,Staff,0,1,20,20
1715631576864,MCWP 50R,B00,518792,Staff,0,2,20,20
1715631576864,MCWP 50R,C00,518793,Staff,0,4,20,20
1715631576864,MCWP 50R,D00,518794,Staff,0,1,20,20
1715631576864,MCWP 50R,E00,518795,Staff,0,2,20,20
1715631576864,MCWP 50R,F00,518796,Staff,0,1,20,20
1715631576864,MCWP 50R,G00,518797,Staff,0,1,20,20
1715631577905,MMW 12R,A01,514034,Herbst; Matthew,0,2,16,16
1715631577905,MMW 12R,A02,514035,Herbst; Matthew,0,0,16,16
1715631578934,MMW 13R,A01,514037,Staff,0,5,16,16
1715631578934,MMW 13R,A02,514039,Staff,0,5,16,16
1715631578934,MMW 13R,A03,628519,Staff,0,4,16,16
1715631580987,SIO 295LS,A00,523233,Staff,10,0,30,20
1715631582010,SIO 295S,A00,523232,Staff,10,0,30,20
1715631583041,SIOC 290S,A01,637330,Merrifield; Mark A,22,0,30,8
1715631584067,SIOC 291S,A01,637333,Gabriel; Corey John,22,0,30,8
1715631585100,SOCI 117,A01,494376,Staff,0,5,5,5
1715631586127,WES 237B,A00,494380,Staff,10,0,20,10
1715631588201,AESE 279B,A00,494370,Wade; Jon P,0,0,33,33
1715631589227,AIP 97,001,660915,Van Den Einde; Yael Dahlia,9998,0,9999,1
1715631590264,AIP 197,001,627712,Vespa; Emanuel Ignacio,9995,0,9999,4
1715631590264,AIP 197,002,650778,Amir; On,9998,0,9999,1
1715631590264,AIP 197,003,650933,Avenancio-Leon; Carlos,9998,0,9999,1
1715631590264,AIP 197,004,658530,Heyman; Gail D.,9998,0,9999,1
1715631590264,AIP 197,005,658631,Neal; Sonya E,9998,0,9999,1
1715631590264,AIP 197,006,658671,Du; Songzi,9998,0,9999,1
1715631591292,ANAR 135S,A00,494369,Braswell; Geoffrey E.,0,0,0,0
1715631592317,BENG 196,001,628496,Engler; Adam J.,9998,0,9999,1
1715631592317,BENG 196,002,660916,Watson; John Thomas,9999,0,9999,0
1715631593344,BISP 197,001,650773,Wilhelm; James E.,9994,0,9999,5
1715631593344,BISP 197,002,658904,Coleman; Aaron B.,9998,0,9999,1
1715631594372,CAT 124RS,A01,519847,Geibel; William,0,0,20,20
1715631595400,CAT 125RS,A01,515971,Geibel; William,0,0,20,20
1715631596429,CLRE 250,A00,511389,Morris; Sheldon,9992,0,9999,7
1715631597461,CLRE 251,A00,507176,Mehta; Ravindra L.,9992,0,9999,7
1715631597461,CLRE 251,B00,511410,Mehta; Ravindra L.,9998,0,9999,1
1715631598488,CLRE 252,A00,507189,Cuomo; Raphael Eduardo,9994,0,9999,5
1715631599516,CLRE 253,A00,507199,Vaida; Florin,9994,0,9999,5
1715631599516,CLRE 253,B00,507202,Vaida; Florin,9999,0,9999,0
1715631600541,CLRE 259,A00,507211,Patel; Hemal,9996,0,9999,3
1715631601569,CLRE 260,A00,507221,Cuomo; Raphael Eduardo,9999,0,9999,0
1715631602593,CLRE 297,001,507242,Cuomo; Raphael Eduardo,9999,0,9999,0
1715631603618,COGS 197,001,638244,Voytek; Bradley Thomas,9997,0,9999,2
1715631604648,CSE 191,A00,516875,Minnes Kemp; Mor Mia,9991,0,9999,8
1715631605676,CSE 197,001,637388,Minnes Kemp; Mor Mia,9992,0,9999,7
1715631606703,CSS 201S,A01,494383,Mignozzetti; Umberto,35,0,35,0
1715631607734,CSS 202S,A01,494387,Mignozzetti; Umberto,35,0,35,0
1715631608760,DSC 197,001,628532,Eldridge; Justin Matthew,9995,0,9999,4
1715631609784,EAP 100,A00,516065,Staff,9799,0,9999,200
1715631610814,ECE 45,A01,507414,Staff,31,0,60,29
1715631612867,ECE 111,A01,507420,Staff,11,0,50,39
1715631613897,ECE 197,001,548057,Sievenpiper; Daniel F.,9991,0,9999,8
1715631614922,EDS 115,A00,507243,Choi; Bailey Miyeon,7,0,28,21
1715631615952,EDS 117,A01,494379,Staff,0,6,34,34
1715631616977,EDS 125,A00,507246,Hopkins; Megan Beth,8,0,30,22
1715631618003,EDS 128A,A01,507264,Fargason; Sharon Gayle,6,0,26,20
1715631619029,EDS 128B,A01,507293,Pappas; Elizabeth,10,0,30,20
1715631620053,EDS 139,A00,507294,Fargason; Sharon Gayle,10,0,30,20
1715631620053,EDS 139,B00,507313,Pappas; Elizabeth,11,0,30,19
1715631621081,EDS 201,A00,507315,Staff,10,0,30,20
1715631622110,EDS 203,A01,507317,Halter; Christopher P.,10,0,30,20
1715631623141,EDS 204R,A01,507319,Halter; Christopher P.,0,3,30,30
1715631623141,EDS 204R,B01,507331,Heinzman; Erica M.,14,0,30,16
1715631624167,EDS 206R,A00,507332,Staff,0,4,30,30
1715631624167,EDS 206R,B00,507343,Staff,15,0,30,15
1715631625195,EDS 250,A00,507344,Hemans; Patricia Ann Benitez,20,0,40,20
1715631626219,EDS 281,A00,507345,Daly; Alan J.,18,0,18,0
1715631627244,EDS 284,A00,507350,Daly; Alan J.,16,0,16,0
1715631628269,EDS 286,A00,507359,Fine; Sarah,18,0,18,0
1715631629294,EDS 289C,A01,507361,Daly; Alan J.,18,0,18,0
1715631630322,EDS 290,A00,507366,Hofstetter; Carolyn,15,0,15,0
1715631631350,LIGM 5A,A00,507421,Fischer-Grunski; Eva K,17,0,20,3
1715631632376,LIGM 5B,A00,507423,Fischer-Grunski; Eva K,19,0,20,1
1715631633403,LIGM 5C,A00,507425,Fischer-Grunski; Eva K,19,0,20,1
1715631634428,LIIT 5AS,A00,507427,Carnelos; Chiara,20,0,20,0
1715631635452,LIIT 5BS,A00,507430,Carnelos; Chiara,20,0,20,0
1715631636482,LIIT 5CS,A00,507432,Carnelos; Chiara,20,0,20,0
1715631637554,LISP 5A,A00,507541,Munoz Sanchez; Alicia,11,0,20,9
1715631638581,LISP 5B,A00,507671,Munoz Sanchez; Alicia,9,0,20,11
1715631639606,LISP 5C,A00,507696,Munoz Sanchez; Alicia,9,0,20,11
1715631640634,MAE 197,001,528363,Boechler; Nicholas Sebastia,9998,0,9999,1
1715631641662,MATH 197,001,523477,Kedlaya; Kiran S.,9994,0,9999,5
1715631641662,MATH 197,002,563811,Zhang; Danna,9994,0,9999,5
1715631641662,MATH 197,003,628552,Dumitriu; Ioana,9998,0,9999,1
1715631641662,MATH 197,004,660885,Floyd; Eric,9998,0,9999,1
1715631642692,MCWP 40R,A00,518780,Staff,2,0,20,18
1715631642692,MCWP 40R,B00,518781,Staff,11,0,20,9
1715631642692,MCWP 40R,C00,518783,Staff,5,0,20,15
1715631643715,MCWP 50R,A00,518791,Staff,0,1,20,20
1715631643715,MCWP 50R,B00,518792,Staff,0,2,20,20
1715631643715,MCWP 50R,C00,518793,Staff,0,4,20,20
1715631643715,MCWP 50R,D00,518794,Staff,0,1,20,20
1715631643715,MCWP 50R,E00,518795,Staff,0,2,20,20
1715631643715,MCWP 50R,F00,518796,Staff,0,1,20,20
1715631643715,MCWP 50R,G00,518797,Staff,0,1,20,20
1715631644743,MMW 12R,A01,514034,Herbst; Matthew,0,2,16,16
1715631644743,MMW 12R,A02,514035,Herbst; Matthew,0,0,16,16
1715631645768,MMW 13R,A01,514037,Staff,0,5,16,16
1715631645768,MMW 13R,A02,514039,Staff,0,5,16,16
1715631645768,MMW 13R,A03,628519,Staff,0,4,16,16
1715631647872,SIO 295LS,A00,523233,Staff,10,0,30,20
1715631648898,SIO 295S,A00,523232,Staff,10,0,30,20
1715631649928,SIOC 290S,A01,637330,Merrifield; Mark A,22,0,30,8
1715631650957,SIOC 291S,A01,637333,Gabriel; Corey John,22,0,30,8
1715631651988,SOCI 117,A01,494376,Staff,0,5,5,5
1715631653012,WES 237B,A00,494380,Staff,10,0,20,10
1715631655078,AESE 279B,A00,494370,Wade; Jon P,0,0,33,33
1715631656104,AIP 97,001,660915,Van Den Einde; Yael Dahlia,9998,0,9999,1
1715631657132,AIP 197,001,627712,Vespa; Emanuel Ignacio,9995,0,9999,4
1715631657132,AIP 197,002,650778,Amir; On,9998,0,9999,1
1715631657132,AIP 197,003,650933,Avenancio-Leon; Carlos,9998,0,9999,1
1715631657132,AIP 197,004,658530,Heyman; Gail D.,9998,0,9999,1
1715631657132,AIP 197,005,658631,Neal; Sonya E,9998,0,9999,1
1715631657132,AIP 197,006,658671,Du; Songzi,9998,0,9999,1
1715631658160,ANAR 135S,A00,494369,Braswell; Geoffrey E.,0,0,0,0
1715631659192,BENG 196,001,628496,Engler; Adam J.,9998,0,9999,1
1715631659192,BENG 196,002,660916,Watson; John Thomas,9999,0,9999,0
1715631660223,BISP 197,001,650773,Wilhelm; James E.,9994,0,9999,5
1715631660223,BISP 197,002,658904,Coleman; Aaron B.,9998,0,9999,1
1715631661248,CAT 124RS,A01,519847,Geibel; William,0,0,20,20
1715631662272,CAT 125RS,A01,515971,Geibel; William,0,0,20,20
1715631663301,CLRE 250,A00,511389,Morris; Sheldon,9992,0,9999,7
1715631664328,CLRE 251,A00,507176,Mehta; Ravindra L.,9992,0,9999,7
1715631664328,CLRE 251,B00,511410,Mehta; Ravindra L.,9998,0,9999,1
1715631665353,CLRE 252,A00,507189,Cuomo; Raphael Eduardo,9994,0,9999,5
1715631666381,CLRE 253,A00,507199,Vaida; Florin,9994,0,9999,5
1715631666381,CLRE 253,B00,507202,Vaida; Florin,9999,0,9999,0
1715631667410,CLRE 259,A00,507211,Patel; Hemal,9996,0,9999,3
1715631668436,CLRE 260,A00,507221,Cuomo; Raphael Eduardo,9999,0,9999,0
1715631669468,CLRE 297,001,507242,Cuomo; Raphael Eduardo,9999,0,9999,0
1715631670495,COGS 197,001,638244,Voytek; Bradley Thomas,9997,0,9999,2
1715631671524,CSE 191,A00,516875,Minnes Kemp; Mor Mia,9991,0,9999,8
1715631672550,CSE 197,001,637388,Minnes Kemp; Mor Mia,9992,0,9999,7
1715631673578,CSS 201S,A01,494383,Mignozzetti; Umberto,35,0,35,0
1715631674626,CSS 202S,A01,494387,Mignozzetti; Umberto,35,0,35,0
1715631675654,DSC 197,001,628532,Eldridge; Justin Matthew,9995,0,9999,4
1715631676677,EAP 100,A00,516065,Staff,9799,0,9999,200
1715631677708,ECE 45,A01,507414,Staff,31,0,60,29
1715631679760,ECE 111,A01,507420,Staff,11,0,50,39
1715631680786,ECE 197,001,548057,Sievenpiper; Daniel F.,9991,0,9999,8
1715631681816,EDS 115,A00,507243,Choi; Bailey Miyeon,7,0,28,21
1715631682841,EDS 117,A01,494379,Staff,0,6,34,34
1715631683871,EDS 125,A00,507246,Hopkins; Megan Beth,8,0,30,22
1715631684900,EDS 128A,A01,507264,Fargason; Sharon Gayle,6,0,26,20
1715631685929,EDS 128B,A01,507293,Pappas; Elizabeth,10,0,30,20
1715631686955,EDS 139,A00,507294,Fargason; Sharon Gayle,10,0,30,20
1715631686955,EDS 139,B00,507313,Pappas; Elizabeth,11,0,30,19
1715631687982,EDS 201,A00,507315,Staff,10,0,30,20
1715631689007,EDS 203,A01,507317,Halter; Christopher P.,10,0,30,20
1715631690037,EDS 204R,A01,507319,Halter; Christopher P.,0,3,30,30
1715631690037,EDS 204R,B01,507331,Heinzman; Erica M.,14,0,30,16
1715631691063,EDS 206R,A00,507332,Staff,0,4,30,30
1715631691063,EDS 206R,B00,507343,Staff,15,0,30,15
1715631692088,EDS 250,A00,507344,Hemans; Patricia Ann Benitez,20,0,40,20
1715631693113,EDS 281,A00,507345,Daly; Alan J.,18,0,18,0
1715631694139,EDS 284,A00,507350,Daly; Alan J.,16,0,16,0
1715631695163,EDS 286,A00,507359,Fine; Sarah,18,0,18,0
1715631696187,EDS 289C,A01,507361,Daly; Alan J.,18,0,18,0
1715631697212,EDS 290,A00,507366,Hofstetter; Carolyn,15,0,15,0
1715631698237,LIGM 5A,A00,507421,Fischer-Grunski; Eva K,17,0,20,3
1715631699261,LIGM 5B,A00,507423,Fischer-Grunski; Eva K,19,0,20,1
1715631700286,LIGM 5C,A00,507425,Fischer-Grunski; Eva K,19,0,20,1
1715631701313,LIIT 5AS,A00,507427,Carnelos; Chiara,20,0,20,0
1715631702341,LIIT 5BS,A00,507430,Carnelos; Chiara,20,0,20,0
1715631703368,LIIT 5CS,A00,507432,Carnelos; Chiara,20,0,20,0
1715631704393,LISP 5A,A00,507541,Munoz Sanchez; Alicia,11,0,20,9
1715631705418,LISP 5B,A00,507671,Munoz Sanchez; Alicia,9,0,20,11
1715631706444,LISP 5C,A00,507696,Munoz Sanchez; Alicia,9,0,20,11
1715631707473,MAE 197,001,528363,Boechler; Nicholas Sebastia,9998,0,9999,1
1715631708501,MATH 197,001,523477,Kedlaya; Kiran S.,9994,0,9999,5
1715631708501,MATH 197,002,563811,Zhang; Danna,9994,0,9999,5
1715631708501,MATH 197,003,628552,Dumitriu; Ioana,9998,0,9999,1
1715631708501,MATH 197,004,660885,Floyd; Eric,9998,0,9999,1
1715631709526,MCWP 40R,A00,518780,Staff,2,0,20,18
1715631709526,MCWP 40R,B00,518781,Staff,11,0,20,9
1715631709526,MCWP 40R,C00,518783,Staff,5,0,20,15
1715631710557,MCWP 50R,A00,518791,Staff,0,1,20,20
1715631710557,MCWP 50R,B00,518792,Staff,0,2,20,20
1715631710557,MCWP 50R,C00,518793,Staff,0,4,20,20
1715631710557,MCWP 50R,D00,518794,Staff,0,1,20,20
1715631710557,MCWP 50R,E00,518795,Staff,0,2,20,20
1715631710557,MCWP 50R,F00,518796,Staff,0,1,20,20
1715631710557,MCWP 50R,G00,518797,Staff,0,1,20,20
1715631711586,MMW 12R,A01,514034,Herbst; Matthew,0,2,16,16
1715631711586,MMW 12R,A02,514035,Herbst; Matthew,0,0,16,16
1715631712611,MMW 13R,A01,514037,Staff,0,5,16,16
1715631712611,MMW 13R,A02,514039,Staff,0,5,16,16
1715631712611,MMW 13R,A03,628519,Staff,0,4,16,16
1715631714663,SIO 295LS,A00,523233,Staff,10,0,30,20
1715631715688,SIO 295S,A00,523232,Staff,10,0,30,20
1715631716715,SIOC 290S,A01,637330,Merrifield; Mark A,22,0,30,8
1715631717740,SIOC 291S,A01,637333,Gabriel; Corey John,22,0,30,8
1715631718767,SOCI 117,A01,494376,Staff,0,5,5,5
1715631719794,WES 237B,A00,494380,Staff,10,0,20,10
1715631721863,AESE 279B,A00,494370,Wade; Jon P,0,0,33,33
1715631722889,AIP 97,001,660915,Van Den Einde; Yael Dahlia,9998,0,9999,1
1715631723925,AIP 197,001,627712,Vespa; Emanuel Ignacio,9995,0,9999,4
1715631723925,AIP 197,002,650778,Amir; On,9998,0,9999,1
1715631723925,AIP 197,003,650933,Avenancio-Leon; Carlos,9998,0,9999,1
1715631723925,AIP 197,004,658530,Heyman; Gail D.,9998,0,9999,1
1715631723925,AIP 197,005,658631,Neal; Sonya E,9998,0,9999,1
1715631723925,AIP 197,006,658671,Du; Songzi,9998,0,9999,1
1715631724950,ANAR 135S,A00,494369,Braswell; Geoffrey E.,0,0,0,0
1715631725976,BENG 196,001,628496,Engler; Adam J.,9998,0,9999,1
1715631725976,BENG 196,002,660916,Watson; John Thomas,9999,0,9999,0
1715631727008,BISP 197,001,650773,Wilhelm; James E.,9994,0,9999,5
1715631727008,BISP 197,002,658904,Coleman; Aaron B.,9998,0,9999,1
1715631728035,CAT 124RS,A01,519847,Geibel; William,0,0,20,20
1715631729060,CAT 125RS,A01,515971,Geibel; William,0,0,20,20
1715631730086,CLRE 250,A00,511389,Morris; Sheldon,9992,0,9999,7
1715631731137,CLRE 251,A00,507176,Mehta; Ravindra L.,9992,0,9999,7
1715631731137,CLRE 251,B00,511410,Mehta; Ravindra L.,9998,0,9999,1
1715631732163,CLRE 252,A00,507189,Cuomo; Raphael Eduardo,9994,0,9999,5
1715631733190,CLRE 253,A00,507199,Vaida; Florin,9994,0,9999,5
1715631733190,CLRE 253,B00,507202,Vaida; Florin,9999,0,9999,0
1715631734216,CLRE 259,A00,507211,Patel; Hemal,9996,0,9999,3
1715631735244,CLRE 260,A00,507221,Cuomo; Raphael Eduardo,9999,0,9999,0
1715631736270,CLRE 297,001,507242,Cuomo; Raphael Eduardo,9999,0,9999,0
1715631737297,COGS 197,001,638244,Voytek; Bradley Thomas,9997,0,9999,2
1715631738323,CSE 191,A00,516875,Minnes Kemp; Mor Mia,9991,0,9999,8
1715631739347,CSE 197,001,637388,Minnes Kemp; Mor Mia,9992,0,9999,7
1715631740374,CSS 201S,A01,494383,Mignozzetti; Umberto,35,0,35,0
1715631741402,CSS 202S,A01,494387,Mignozzetti; Umberto,35,0,35,0
1715631742426,DSC 197,001,628532,Eldridge; Justin Matthew,9995,0,9999,4
1715631743451,EAP 100,A00,516065,Staff,9799,0,9999,200
1715631744478,ECE 45,A01,507414,Staff,31,0,60,29
1715631746531,ECE 111,A01,507420,Staff,11,0,50,39
1715631747563,ECE 197,001,548057,Sievenpiper; Daniel F.,9991,0,9999,8
1715631748589,EDS 115,A00,507243,Choi; Bailey Miyeon,7,0,28,21
1715631749618,EDS 117,A01,494379,Staff,0,6,34,34
1715631750643,EDS 125,A00,507246,Hopkins; Megan Beth,8,0,30,22
1715631751676,EDS 128A,A01,507264,Fargason; Sharon Gayle,6,0,26,20
1715631752706,EDS 128B,A01,507293,Pappas; Elizabeth,10,0,30,20
1715631753731,EDS 139,A00,507294,Fargason; Sharon Gayle,10,0,30,20
1715631753731,EDS 139,B00,507313,Pappas; Elizabeth,11,0,30,19
1715631754762,EDS 201,A00,507315,Staff,10,0,30,20
1715631755792,EDS 203,A01,507317,Halter; Christopher P.,10,0,30,20
1715631756817,EDS 204R,A01,507319,Halter; Christopher P.,0,3,30,30
1715631756817,EDS 204R,B01,507331,Heinzman; Erica M.,14,0,30,16
1715631757846,EDS 206R,A00,507332,Staff,0,4,30,30
1715631757846,EDS 206R,B00,507343,Staff,15,0,30,15
1715631758876,EDS 250,A00,507344,Hemans; Patricia Ann Benitez,20,0,40,20
1715631759904,EDS 281,A00,507345,Daly; Alan J.,18,0,18,0
1715631760934,EDS 284,A00,507350,Daly; Alan J.,16,0,16,0
1715631761960,EDS 286,A00,507359,Fine; Sarah,18,0,18,0
1715631763008,EDS 289C,A01,507361,Daly; Alan J.,18,0,18,0
1715631764033,EDS 290,A00,507366,Hofstetter; Carolyn,15,0,15,0
1715631765060,LIGM 5A,A00,507421,Fischer-Grunski; Eva K,17,0,20,3
1715631766083,LIGM 5B,A00,507423,Fischer-Grunski; Eva K,19,0,20,1
1715631767111,LIGM 5C,A00,507425,Fischer-Grunski; Eva K,19,0,20,1
1715631768138,LIIT 5AS,A00,507427,Carnelos; Chiara,20,0,20,0
1715631769161,LIIT 5BS,A00,507430,Carnelos; Chiara,20,0,20,0
1715631770186,LIIT 5CS,A00,507432,Carnelos; Chiara,20,0,20,0
1715631771211,LISP 5A,A00,507541,Munoz Sanchez; Alicia,11,0,20,9
1715631772240,LISP 5B,A00,507671,Munoz Sanchez; Alicia,9,0,20,11
1715631773268,LISP 5C,A00,507696,Munoz Sanchez; Alicia,9,0,20,11
1715631774294,MAE 197,001,528363,Boechler; Nicholas Sebastia,9998,0,9999,1
1715631775331,MATH 197,001,523477,Kedlaya; Kiran S.,9994,0,9999,5
1715631775331,MATH 197,002,563811,Zhang; Danna,9994,0,9999,5
1715631775331,MATH 197,003,628552,Dumitriu; Ioana,9998,0,9999,1
1715631775331,MATH 197,004,660885,Floyd; Eric,9998,0,9999,1
1715631776357,MCWP 40R,A00,518780,Staff,2,0,20,18
1715631776357,MCWP 40R,B00,518781,Staff,11,0,20,9
1715631776357,MCWP 40R,C00,518783,Staff,5,0,20,15
1715631777383,MCWP 50R,A00,518791,Staff,0,1,20,20
1715631777383,MCWP 50R,B00,518792,Staff,0,2,20,20
1715631777383,MCWP 50R,C00,518793,Staff,0,4,20,20
1715631777383,MCWP 50R,D00,518794,Staff,0,1,20,20
1715631777383,MCWP 50R,E00,518795,Staff,0,2,20,20
1715631777383,MCWP 50R,F00,518796,Staff,0,1,20,20
1715631777383,MCWP 50R,G00,518797,Staff,0,1,20,20
1715631778411,MMW 12R,A01,514034,Herbst; Matthew,0,2,16,16
1715631778411,MMW 12R,A02,514035,Herbst; Matthew,0,0,16,16
1715631779436,MMW 13R,A01,514037,Staff,0,5,16,16
1715631779436,MMW 13R,A02,514039,Staff,0,5,16,16
1715631779436,MMW 13R,A03,628519,Staff,0,4,16,16
1715631781490,SIO 295LS,A00,523233,Staff,10,0,30,20
1715631782516,SIO 295S,A00,523232,Staff,10,0,30,20
1715631783543,SIOC 290S,A01,637330,Merrifield; Mark A,22,0,30,8
1715631784571,SIOC 291S,A01,637333,Gabriel; Corey John,22,0,30,8
1715631785599,SOCI 117,A01,494376,Staff,0,5,5,5
1715631786625,WES 237B,A00,494380,Staff,10,0,20,10
1715631788705,AESE 279B,A00,494370,Wade; Jon P,0,0,33,33
1715631789733,AIP 97,001,660915,Van Den Einde; Yael Dahlia,9998,0,9999,1
1715631790767,AIP 197,001,627712,Vespa; Emanuel Ignacio,9995,0,9999,4
1715631790767,AIP 197,002,650778,Amir; On,9998,0,9999,1
1715631790767,AIP 197,003,650933,Avenancio-Leon; Carlos,9998,0,9999,1
1715631790767,AIP 197,004,658530,Heyman; Gail D.,9998,0,9999,1
1715631790767,AIP 197,005,658631,Neal; Sonya E,9998,0,9999,1
1715631790767,AIP 197,006,658671,Du; Songzi,9998,0,9999,1
1715631791793,ANAR 135S,A00,494369,Braswell; Geoffrey E.,0,0,0,0
1715631792818,BENG 196,001,628496,Engler; Adam J.,9998,0,9999,1
1715631792818,BENG 196,002,660916,Watson; John Thomas,9999,0,9999,0
1715631793843,BISP 197,001,650773,Wilhelm; James E.,9994,0,9999,5
1715631793843,BISP 197,002,658904,Coleman; Aaron B.,9998,0,9999,1
1715631794869,CAT 124RS,A01,519847,Geibel; William,0,0,20,20
1715631795896,CAT 125RS,A01,515971,Geibel; William,0,0,20,20
1715631796921,CLRE 250,A00,511389,Morris; Sheldon,9992,0,9999,7
1715631797947,CLRE 251,A00,507176,Mehta; Ravindra L.,9992,0,9999,7
1715631797947,CLRE 251,B00,511410,Mehta; Ravindra L.,9998,0,9999,1
1715631798976,CLRE 252,A00,507189,Cuomo; Raphael Eduardo,9994,0,9999,5
1715631800004,CLRE 253,A00,507199,Vaida; Florin,9994,0,9999,5
1715631800004,CLRE 253,B00,507202,Vaida; Florin,9999,0,9999,0
1715631801030,CLRE 259,A00,507211,Patel; Hemal,9996,0,9999,3
1715631802053,CLRE 260,A00,507221,Cuomo; Raphael Eduardo,9999,0,9999,0
1715631803107,CLRE 297,001,507242,Cuomo; Raphael Eduardo,9999,0,9999,0
1715631804133,COGS 197,001,638244,Voytek; Bradley Thomas,9997,0,9999,2
1715631805157,CSE 191,A00,516875,Minnes Kemp; Mor Mia,9991,0,9999,8
1715631806183,CSE 197,001,637388,Minnes Kemp; Mor Mia,9992,0,9999,7
1715631807208,CSS 201S,A01,494383,Mignozzetti; Umberto,35,0,35,0
1715631808232,CSS 202S,A01,494387,Mignozzetti; Umberto,35,0,35,0
1715631809256,DSC 197,001,628532,Eldridge; Justin Matthew,9995,0,9999,4
1715631810279,EAP 100,A00,516065,Staff,9799,0,9999,200
1715631811311,ECE 45,A01,507414,Staff,31,0,60,29
1715631813361,ECE 111,A01,507420,Staff,11,0,50,39
1715631814390,ECE 197,001,548057,Sievenpiper; Daniel F.,9991,0,9999,8
1715631815416,EDS 115,A00,507243,Choi; Bailey Miyeon,7,0,28,21
1715631816445,EDS 117,A01,494379,Staff,0,6,34,34
1715631817471,EDS 125,A00,507246,Hopkins; Megan Beth,8,0,30,22
1715631818499,EDS 128A,A01,507264,Fargason; Sharon Gayle,6,0,26,20
1715631819524,EDS 128B,A01,507293,Pappas; Elizabeth,10,0,30,20
1715631820550,EDS 139,A00,507294,Fargason; Sharon Gayle,10,0,30,20
1715631820550,EDS 139,B00,507313,Pappas; Elizabeth,11,0,30,19
1715631821577,EDS 201,A00,507315,Staff,10,0,30,20
1715631822604,EDS 203,A01,507317,Halter; Christopher P.,10,0,30,20
1715631823633,EDS 204R,A01,507319,Halter; Christopher P.,0,3,30,30
1715631823633,EDS 204R,B01,507331,Heinzman; Erica M.,14,0,30,16
1715631824658,EDS 206R,A00,507332,Staff,0,4,30,30
1715631824658,EDS 206R,B00,507343,Staff,15,0,30,15
1715631825683,EDS 250,A00,507344,Hemans; Patricia Ann Benitez,20,0,40,20
1715631826742,EDS 281,A00,507345,Daly; Alan J.,18,0,18,0
1715631827769,EDS 284,A00,507350,Daly; Alan J.,16,0,16,0
1715631828797,EDS 286,A00,507359,Fine; Sarah,18,0,18,0
1715631829823,EDS 289C,A01,507361,Daly; Alan J.,18,0,18,0
1715631830851,EDS 290,A00,507366,Hofstetter; Carolyn,15,0,15,0
1715631831905,LIGM 5A,A00,507421,Fischer-Grunski; Eva K,17,0,20,3
1715631832931,LIGM 5B,A00,507423,Fischer-Grunski; Eva K,19,0,20,1
1715631833957,LIGM 5C,A00,507425,Fischer-Grunski; Eva K,19,0,20,1
1715631834985,LIIT 5AS,A00,507427,Carnelos; Chiara,20,0,20,0
1715631836011,LIIT 5BS,A00,507430,Carnelos; Chiara,20,0,20,0
1715631837037,LIIT 5CS,A00,507432,Carnelos; Chiara,20,0,20,0
1715631838068,LISP 5A,A00,507541,Munoz Sanchez; Alicia,11,0,20,9
1715631839096,LISP 5B,A00,507671,Munoz Sanchez; Alicia,9,0,20,11
1715631840129,LISP 5C,A00,507696,Munoz Sanchez; Alicia,9,0,20,11
1715631841155,MAE 197,001,528363,Boechler; Nicholas Sebastia,9998,0,9999,1
1715631842186,MATH 197,001,523477,Kedlaya; Kiran S.,9994,0,9999,5
1715631842186,MATH 197,002,563811,Zhang; Danna,9994,0,9999,5
1715631842186,MATH 197,003,628552,Dumitriu; Ioana,9998,0,9999,1
1715631842186,MATH 197,004,660885,Floyd; Eric,9998,0,9999,1
1715631843214,MCWP 40R,A00,518780,Staff,2,0,20,18
1715631843214,MCWP 40R,B00,518781,Staff,11,0,20,9
1715631843214,MCWP 40R,C00,518783,Staff,5,0,20,15
1715631844245,MCWP 50R,A00,518791,Staff,0,1,20,20
1715631844245,MCWP 50R,B00,518792,Staff,0,2,20,20
1715631844245,MCWP 50R,C00,518793,Staff,0,4,20,20
1715631844245,MCWP 50R,D00,518794,Staff,0,1,20,20
1715631844245,MCWP 50R,E00,518795,Staff,0,2,20,20
1715631844245,MCWP 50R,F00,518796,Staff,0,1,20,20
1715631844245,MCWP 50R,G00,518797,Staff,0,1,20,20
1715631845275,MMW 12R,A01,514034,Herbst; Matthew,0,2,16,16
1715631845275,MMW 12R,A02,514035,Herbst; Matthew,0,0,16,16
1715631846300,MMW 13R,A01,514037,Staff,0,5,16,16
1715631846300,MMW 13R,A02,514039,Staff,0,5,16,16
1715631846300,MMW 13R,A03,628519,Staff,0,4,16,16
1715631848351,SIO 295LS,A00,523233,Staff,10,0,30,20
1715631849378,SIO 295S,A00,523232,Staff,10,0,30,20
1715631850404,SIOC 290S,A01,637330,Merrifield; Mark A,22,0,30,8
1715631851432,SIOC 291S,A01,637333,Gabriel; Corey John,22,0,30,8
1715631852463,SOCI 117,A01,494376,Staff,0,5,5,5
1715631853491,WES 237B,A00,494380,Staff,10,0,20,10
1715631855568,AESE 279B,A00,494370,Wade; Jon P,0,0,33,33
1715631856593,AIP 97,001,660915,Van Den Einde; Yael Dahlia,9998,0,9999,1
1715631857620,AIP 197,001,627712,Vespa; Emanuel Ignacio,9995,0,9999,4
1715631857620,AIP 197,002,650778,Amir; On,9998,0,9999,1
1715631857620,AIP 197,003,650933,Avenancio-Leon; Carlos,9998,0,9999,1
1715631857620,AIP 197,004,658530,Heyman; Gail D.,9998,0,9999,1
1715631857620,AIP 197,005,658631,Neal; Sonya E,9998,0,9999,1
1715631857620,AIP 197,006,658671,Du; Songzi,9998,0,9999,1
1715631858648,ANAR 135S,A00,494369,Braswell; Geoffrey E.,0,0,0,0
1715631859673,BENG 196,001,628496,Engler; Adam J.,9998,0,9999,1
1715631859673,BENG 196,002,660916,Watson; John Thomas,9999,0,9999,0
1715631860697,BISP 197,001,650773,Wilhelm; James E.,9994,0,9999,5
1715631860697,BISP 197,002,658904,Coleman; Aaron B.,9998,0,9999,1
1715631861727,CAT 124RS,A01,519847,Geibel; William,0,0,20,20
1715631862753,CAT 125RS,A01,515971,Geibel; William,0,0,20,20
1715631863783,CLRE 250,A00,511389,Morris; Sheldon,9992,0,9999,7
1715631864814,CLRE 251,A00,507176,Mehta; Ravindra L.,9992,0,9999,7
1715631864814,CLRE 251,B00,511410,Mehta; Ravindra L.,9998,0,9999,1
1715631865839,CLRE 252,A00,507189,Cuomo; Raphael Eduardo,9994,0,9999,5
1715631866864,CLRE 253,A00,507199,Vaida; Florin,9994,0,9999,5
1715631866864,CLRE 253,B00,507202,Vaida; Florin,9999,0,9999,0
1715631867889,CLRE 259,A00,507211,Patel; Hemal,9996,0,9999,3
1715631868914,CLRE 260,A00,507221,Cuomo; Raphael Eduardo,9999,0,9999,0
1715631869938,CLRE 297,001,507242,Cuomo; Raphael Eduardo,9999,0,9999,0
1715631870969,COGS 197,001,638244,Voytek; Bradley Thomas,9997,0,9999,2
1715631871996,CSE 191,A00,516875,Minnes Kemp; Mor Mia,9991,0,9999,8
1715631873023,CSE 197,001,637388,Minnes Kemp; Mor Mia,9992,0,9999,7
1715631874049,CSS 201S,A01,494383,Mignozzetti; Umberto,35,0,35,0
1715631875084,CSS 202S,A01,494387,Mignozzetti; Umberto,35,0,35,0
1715631876113,DSC 197,001,628532,Eldridge; Justin Matthew,9995,0,9999,4
1715631877141,EAP 100,A00,516065,Staff,9799,0,9999,200
1715631878183,ECE 45,A01,507414,Staff,31,0,60,29
1715631880233,ECE 111,A01,507420,Staff,11,0,50,39
1715631881259,ECE 197,001,548057,Sievenpiper; Daniel F.,9991,0,9999,8
1715631882283,EDS 115,A00,507243,Choi; Bailey Miyeon,7,0,28,21
1715631883314,EDS 117,A01,494379,Staff,0,6,34,34
1715631884340,EDS 125,A00,507246,Hopkins; Megan Beth,8,0,30,22
1715631885366,EDS 128A,A01,507264,Fargason; Sharon Gayle,6,0,26,20
1715631886392,EDS 128B,A01,507293,Pappas; Elizabeth,10,0,30,20
1715631887420,EDS 139,A00,507294,Fargason; Sharon Gayle,10,0,30,20
1715631887420,EDS 139,B00,507313,Pappas; Elizabeth,11,0,30,19
1715631888450,EDS 201,A00,507315,Staff,10,0,30,20
1715631889481,EDS 203,A01,507317,Halter; Christopher P.,10,0,30,20
1715631890507,EDS 204R,A01,507319,Halter; Christopher P.,0,3,30,30
1715631890507,EDS 204R,B01,507331,Heinzman; Erica M.,14,0,30,16
1715631891533,EDS 206R,A00,507332,Staff,0,4,30,30
1715631891533,EDS 206R,B00,507343,Staff,15,0,30,15
1715631892558,EDS 250,A00,507344,Hemans; Patricia Ann Benitez,20,0,40,20
1715631893584,EDS 281,A00,507345,Daly; Alan J.,18,0,18,0
1715631894609,EDS 284,A00,507350,Daly; Alan J.,16,0,16,0
1715631895637,EDS 286,A00,507359,Fine; Sarah,18,0,18,0
1715631896663,EDS 289C,A01,507361,Daly; Alan J.,18,0,18,0
1715631897691,EDS 290,A00,507366,Hofstetter; Carolyn,15,0,15,0
1715631898722,LIGM 5A,A00,507421,Fischer-Grunski; Eva K,17,0,20,3
1715631899773,LIGM 5B,A00,507423,Fischer-Grunski; Eva K,19,0,20,1
1715631900803,LIGM 5C,A00,507425,Fischer-Grunski; Eva K,19,0,20,1
1715631901834,LIIT 5AS,A00,507427,Carnelos; Chiara,20,0,20,0
1715631902862,LIIT 5BS,A00,507430,Carnelos; Chiara,20,0,20,0
1715631903898,LIIT 5CS,A00,507432,Carnelos; Chiara,20,0,20,0
1715631904923,LISP 5A,A00,507541,Munoz Sanchez; Alicia,11,0,20,9
1715631905949,LISP 5B,A00,507671,Munoz Sanchez; Alicia,9,0,20,11
1715631906973,LISP 5C,A00,507696,Munoz Sanchez; Alicia,9,0,20,11
1715631907999,MAE 197,001,528363,Boechler; Nicholas Sebastia,9998,0,9999,1
1715631909024,MATH 197,001,523477,Kedlaya; Kiran S.,9994,0,9999,5
1715631909024,MATH 197,002,563811,Zhang; Danna,9994,0,9999,5
1715631909024,MATH 197,003,628552,Dumitriu; Ioana,9998,0,9999,1
1715631909024,MATH 197,004,660885,Floyd; Eric,9998,0,9999,1
1715631910054,MCWP 40R,A00,518780,Staff,2,0,20,18
1715631910054,MCWP 40R,B00,518781,Staff,11,0,20,9
1715631910054,MCWP 40R,C00,518783,Staff,5,0,20,15
1715631911079,MCWP 50R,A00,518791,Staff,0,1,20,20
1715631911079,MCWP 50R,B00,518792,Staff,0,2,20,20
1715631911079,MCWP 50R,C00,518793,Staff,0,4,20,20
1715631911079,MCWP 50R,D00,518794,Staff,0,1,20,20
1715631911079,MCWP 50R,E00,518795,Staff,0,2,20,20
1715631911079,MCWP 50R,F00,518796,Staff,0,1,20,20
1715631911079,MCWP 50R,G00,518797,Staff,0,1,20,20
1715631912105,MMW 12R,A01,514034,Herbst; Matthew,0,2,16,16
1715631912105,MMW 12R,A02,514035,Herbst; Matthew,0,0,16,16
1715631913132,MMW 13R,A01,514037,Staff,0,5,16,16
1715631913132,MMW 13R,A02,514039,Staff,0,5,16,16
1715631913132,MMW 13R,A03,628519,Staff,0,4,16,16
1715631915188,SIO 295LS,A00,523233,Staff,10,0,30,20
1715631916215,SIO 295S,A00,523232,Staff,10,0,30,20
1715631917246,SIOC 290S,A01,637330,Merrifield; Mark A,22,0,30,8
1715631918273,SIOC 291S,A01,637333,Gabriel; Corey John,22,0,30,8
1715631919299,SOCI 117,A01,494376,Staff,0,5,5,5
1715631920328,WES 237B,A00,494380,Staff,10,0,20,10
1715631922409,AESE 279B,A00,494370,Wade; Jon P,0,0,33,33
1715631923434,AIP 97,001,660915,Van Den Einde; Yael Dahlia,9998,0,9999,1
1715631924463,AIP 197,001,627712,Vespa; Emanuel Ignacio,9995,0,9999,4
1715631924463,AIP 197,002,650778,Amir; On,9998,0,9999,1
1715631924463,AIP 197,003,650933,Avenancio-Leon; Carlos,9998,0,9999,1
1715631924463,AIP 197,004,658530,Heyman; Gail D.,9998,0,9999,1
1715631924463,AIP 197,005,658631,Neal; Sonya E,9998,0,9999,1
1715631924463,AIP 197,006,658671,Du; Songzi,9998,0,9999,1
1715631925491,ANAR 135S,A00,494369,Braswell; Geoffrey E.,0,0,0,0
1715631926515,BENG 196,001,628496,Engler; Adam J.,9998,0,9999,1
1715631926515,BENG 196,002,660916,Watson; John Thomas,9999,0,9999,0
1715631927539,BISP 197,001,650773,Wilhelm; James E.,9994,0,9999,5
1715631927539,BISP 197,002,658904,Coleman; Aaron B.,9998,0,9999,1
1715631928564,CAT 124RS,A01,519847,Geibel; William,0,0,20,20
1715631929589,CAT 125RS,A01,515971,Geibel; William,0,0,20,20
1715631930616,CLRE 250,A00,511389,Morris; Sheldon,9992,0,9999,7
1715631931646,CLRE 251,A00,507176,Mehta; Ravindra L.,9992,0,9999,7
1715631931646,CLRE 251,B00,511410,Mehta; Ravindra L.,9998,0,9999,1
1715631932674,CLRE 252,A00,507189,Cuomo; Raphael Eduardo,9994,0,9999,5
1715631933700,CLRE 253,A00,507199,Vaida; Florin,9994,0,9999,5
1715631933700,CLRE 253,B00,507202,Vaida; Florin,9999,0,9999,0
1715631934724,CLRE 259,A00,507211,Patel; Hemal,9996,0,9999,3
1715631935751,CLRE 260,A00,507221,Cuomo; Raphael Eduardo,9999,0,9999,0
1715631936774,CLRE 297,001,507242,Cuomo; Raphael Eduardo,9999,0,9999,0
1715631937800,COGS 197,001,638244,Voytek; Bradley Thomas,9997,0,9999,2
1715631938827,CSE 191,A00,516875,Minnes Kemp; Mor Mia,9991,0,9999,8
1715631939867,CSE 197,001,637388,Minnes Kemp; Mor Mia,9992,0,9999,7
1715631940894,CSS 201S,A01,494383,Mignozzetti; Umberto,35,0,35,0
1715631941919,CSS 202S,A01,494387,Mignozzetti; Umberto,35,0,35,0
1715631942943,DSC 197,001,628532,Eldridge; Justin Matthew,9995,0,9999,4
1715631943968,EAP 100,A00,516065,Staff,9799,0,9999,200
1715631944995,ECE 45,A01,507414,Staff,31,0,60,29
1715631947047,ECE 111,A01,507420,Staff,11,0,50,39
1715631948085,ECE 197,001,548057,Sievenpiper; Daniel F.,9991,0,9999,8
1715631949111,EDS 115,A00,507243,Choi; Bailey Miyeon,7,0,28,21
1715631950139,EDS 117,A01,494379,Staff,0,6,34,34
1715631951165,EDS 125,A00,507246,Hopkins; Megan Beth,8,0,30,22
1715631952190,EDS 128A,A01,507264,Fargason; Sharon Gayle,6,0,26,20
1715631953215,EDS 128B,A01,507293,Pappas; Elizabeth,10,0,30,20
1715631954240,EDS 139,A00,507294,Fargason; Sharon Gayle,10,0,30,20
1715631954240,EDS 139,B00,507313,Pappas; Elizabeth,11,0,30,19
1715631955269,EDS 201,A00,507315,Staff,10,0,30,20
1715631956297,EDS 203,A01,507317,Halter; Christopher P.,10,0,30,20
1715631957327,EDS 204R,A01,507319,Halter; Christopher P.,0,3,30,30
1715631957327,EDS 204R,B01,507331,Heinzman; Erica M.,14,0,30,16
1715631958352,EDS 206R,A00,507332,Staff,0,4,30,30
1715631958352,EDS 206R,B00,507343,Staff,15,0,30,15
1715631959379,EDS 250,A00,507344,Hemans; Patricia Ann Benitez,20,0,40,20
1715631960404,EDS 281,A00,507345,Daly; Alan J.,18,0,18,0
1715631961431,EDS 284,A00,507350,Daly; Alan J.,16,0,16,0
1715631962456,EDS 286,A00,507359,Fine; Sarah,18,0,18,0
1715631963487,EDS 289C,A01,507361,Daly; Alan J.,18,0,18,0
1715631964514,EDS 290,A00,507366,Hofstetter; Carolyn,15,0,15,0
1715631965540,LIGM 5A,A00,507421,Fischer-Grunski; Eva K,17,0,20,3
1715631966565,LIGM 5B,A00,507423,Fischer-Grunski; Eva K,19,0,20,1
1715631967591,LIGM 5C,A00,507425,Fischer-Grunski; Eva K,19,0,20,1
1715631968622,LIIT 5AS,A00,507427,Carnelos; Chiara,20,0,20,0
1715631969648,LIIT 5BS,A00,507430,Carnelos; Chiara,20,0,20,0
1715631970672,LIIT 5CS,A00,507432,Carnelos; Chiara,20,0,20,0
1715631971699,LISP 5A,A00,507541,Munoz Sanchez; Alicia,11,0,20,9
1715631972726,LISP 5B,A00,507671,Munoz Sanchez; Alicia,9,0,20,11
1715631973750,LISP 5C,A00,507696,Munoz Sanchez; Alicia,9,0,20,11
1715631974780,MAE 197,001,528363,Boechler; Nicholas Sebastia,9998,0,9999,1
1715631975812,MATH 197,001,523477,Kedlaya; Kiran S.,9994,0,9999,5
1715631975812,MATH 197,002,563811,Zhang; Danna,9994,0,9999,5
1715631975812,MATH 197,003,628552,Dumitriu; Ioana,9998,0,9999,1
1715631975812,MATH 197,004,660885,Floyd; Eric,9998,0,9999,1
1715631976836,MCWP 40R,A00,518780,Staff,2,0,20,18
1715631976836,MCWP 40R,B00,518781,Staff,11,0,20,9
1715631976836,MCWP 40R,C00,518783,Staff,5,0,20,15
1715631977866,MCWP 50R,A00,518791,Staff,0,1,20,20
1715631977866,MCWP 50R,B00,518792,Staff,0,2,20,20
1715631977866,MCWP 50R,C00,518793,Staff,0,4,20,20
1715631977866,MCWP 50R,D00,518794,Staff,0,1,20,20
1715631977866,MCWP 50R,E00,518795,Staff,0,2,20,20
1715631977866,MCWP 50R,F00,518796,Staff,0,1,20,20
1715631977866,MCWP 50R,G00,518797,Staff,0,1,20,20
1715631978890,MMW 12R,A01,514034,Herbst; Matthew,0,2,16,16
1715631978890,MMW 12R,A02,514035,Herbst; Matthew,0,0,16,16
1715631979916,MMW 13R,A01,514037,Staff,0,5,16,16
1715631979916,MMW 13R,A02,514039,Staff,0,5,16,16
1715631979916,MMW 13R,A03,628519,Staff,0,4,16,16
1715631981966,SIO 295LS,A00,523233,Staff,10,0,30,20
1715631982991,SIO 295S,A00,523232,Staff,10,0,30,20
1715631984017,SIOC 290S,A01,637330,Merrifield; Mark A,22,0,30,8
1715631985044,SIOC 291S,A01,637333,Gabriel; Corey John,22,0,30,8
1715631986072,SOCI 117,A01,494376,Staff,0,5,5,5
1715631987102,WES 237B,A00,494380,Staff,10,0,20,10
1715631989165,AESE 279B,A00,494370,Wade; Jon P,0,0,33,33
1715631990193,AIP 97,001,660915,Van Den Einde; Yael Dahlia,9998,0,9999,1
1715631991227,AIP 197,001,627712,Vespa; Emanuel Ignacio,9995,0,9999,4
1715631991227,AIP 197,002,650778,Amir; On,9998,0,9999,1
1715631991227,AIP 197,003,650933,Avenancio-Leon; Carlos,9998,0,9999,1
1715631991227,AIP 197,004,658530,Heyman; Gail D.,9998,0,9999,1
1715631991227,AIP 197,005,658631,Neal; Sonya E,9998,0,9999,1
1715631991227,AIP 197,006,658671,Du; Songzi,9998,0,9999,1
1715631992251,ANAR 135S,A00,494369,Braswell; Geoffrey E.,0,0,0,0
1715631993279,BENG 196,001,628496,Engler; Adam J.,9998,0,9999,1
1715631993279,BENG 196,002,660916,Watson; John Thomas,9999,0,9999,0
1715631994304,BISP 197,001,650773,Wilhelm; James E.,9994,0,9999,5
1715631994304,BISP 197,002,658904,Coleman; Aaron B.,9998,0,9999,1
1715631995333,CAT 124RS,A01,519847,Geibel; William,0,0,20,20
1715631996359,CAT 125RS,A01,515971,Geibel; William,0,0,20,20
1715631997389,CLRE 250,A00,511389,Morris; Sheldon,9992,0,9999,7
1715631998420,CLRE 251,A00,507176,Mehta; Ravindra L.,9992,0,9999,7
1715631998420,CLRE 251,B00,511410,Mehta; Ravindra L.,9998,0,9999,1
1715631999447,CLRE 252,A00,507189,Cuomo; Raphael Eduardo,9994,0,9999,5
1715632000472,CLRE 253,A00,507199,Vaida; Florin,9994,0,9999,5
1715632000472,CLRE 253,B00,507202,Vaida; Florin,9999,0,9999,0
1715632001499,CLRE 259,A00,507211,Patel; Hemal,9996,0,9999,3
1715632002524,CLRE 260,A00,507221,Cuomo; Raphael Eduardo,9999,0,9999,0
1715632003552,CLRE 297,001,507242,Cuomo; Raphael Eduardo,9999,0,9999,0
1715632004578,COGS 197,001,638244,Voytek; Bradley Thomas,9997,0,9999,2
1715632005605,CSE 191,A00,516875,Minnes Kemp; Mor Mia,9991,0,9999,8
1715632006648,CSE 197,001,637388,Minnes Kemp; Mor Mia,9992,0,9999,7
1715632007679,CSS 201S,A01,494383,Mignozzetti; Umberto,35,0,35,0
1715632008703,CSS 202S,A01,494387,Mignozzetti; Umberto,35,0,35,0
1715632009728,DSC 197,001,628532,Eldridge; Justin Matthew,9995,0,9999,4
1715632010752,EAP 100,A00,516065,Staff,9799,0,9999,200
1715632011779,ECE 45,A01,507414,Staff,31,0,60,29
1715632013829,ECE 111,A01,507420,Staff,11,0,50,39
1715632014855,ECE 197,001,548057,Sievenpiper; Daniel F.,9991,0,9999,8
1715632015885,EDS 115,A00,507243,Choi; Bailey Miyeon,7,0,28,21
1715632016911,EDS 117,A01,494379,Staff,0,6,34,34
1715632017937,EDS 125,A00,507246,Hopkins; Megan Beth,8,0,30,22
1715632018962,EDS 128A,A01,507264,Fargason; Sharon Gayle,6,0,26,20
1715632019989,EDS 128B,A01,507293,Pappas; Elizabeth,10,0,30,20
1715632021016,EDS 139,A00,507294,Fargason; Sharon Gayle,10,0,30,20
1715632021016,EDS 139,B00,507313,Pappas; Elizabeth,11,0,30,19
1715632022045,EDS 201,A00,507315,Staff,10,0,30,20
1715632023077,EDS 203,A01,507317,Halter; Christopher P.,10,0,30,20
1715632024103,EDS 204R,A01,507319,Halter; Christopher P.,0,3,30,30
1715632024103,EDS 204R,B01,507331,Heinzman; Erica M.,14,0,30,16
1715632025129,EDS 206R,A00,507332,Staff,0,4,30,30
1715632025129,EDS 206R,B00,507343,Staff,15,0,30,15
1715632026157,EDS 250,A00,507344,Hemans; Patricia Ann Benitez,20,0,40,20
1715632027187,EDS 281,A00,507345,Daly; Alan J.,18,0,18,0
1715632028214,EDS 284,A00,507350,Daly; Alan J.,16,0,16,0
1715632029244,EDS 286,A00,507359,Fine; Sarah,18,0,18,0
1715632030268,EDS 289C,A01,507361,Daly; Alan J.,18,0,18,0
1715632031294,EDS 290,A00,507366,Hofstetter; Carolyn,15,0,15,0
1715632032320,LIGM 5A,A00,507421,Fischer-Grunski; Eva K,17,0,20,3
1715632033345,LIGM 5B,A00,507423,Fischer-Grunski; Eva K,19,0,20,1
1715632034370,LIGM 5C,A00,507425,Fischer-Grunski; Eva K,19,0,20,1
1715632035398,LIIT 5AS,A00,507427,Carnelos; Chiara,20,0,20,0
1715632036424,LIIT 5BS,A00,507430,Carnelos; Chiara,20,0,20,0
1715632037449,LIIT 5CS,A00,507432,Carnelos; Chiara,20,0,20,0
1715632038480,LISP 5A,A00,507541,Munoz Sanchez; Alicia,11,0,20,9
1715632039511,LISP 5B,A00,507671,Munoz Sanchez; Alicia,9,0,20,11
1715632040540,LISP 5C,A00,507696,Munoz Sanchez; Alicia,9,0,20,11
1715632041566,MAE 197,001,528363,Boechler; Nicholas Sebastia,9998,0,9999,1
1715632042592,MATH 197,001,523477,Kedlaya; Kiran S.,9994,0,9999,5
1715632042592,MATH 197,002,563811,Zhang; Danna,9994,0,9999,5
1715632042592,MATH 197,003,628552,Dumitriu; Ioana,9998,0,9999,1
1715632042592,MATH 197,004,660885,Floyd; Eric,9998,0,9999,1
1715632043616,MCWP 40R,A00,518780,Staff,2,0,20,18
1715632043616,MCWP 40R,B00,518781,Staff,11,0,20,9
1715632043616,MCWP 40R,C00,518783,Staff,5,0,20,15
1715632044642,MCWP 50R,A00,518791,Staff,0,1,20,20
1715632044642,MCWP 50R,B00,518792,Staff,0,2,20,20
1715632044642,MCWP 50R,C00,518793,Staff,0,4,20,20
1715632044642,MCWP 50R,D00,518794,Staff,0,1,20,20
1715632044642,MCWP 50R,E00,518795,Staff,0,2,20,20
1715632044642,MCWP 50R,F00,518796,Staff,0,1,20,20
1715632044642,MCWP 50R,G00,518797,Staff,0,1,20,20
1715632045666,MMW 12R,A01,514034,Herbst; Matthew,0,2,16,16
1715632045666,MMW 12R,A02,514035,Herbst; Matthew,0,0,16,16
1715632046695,MMW 13R,A01,514037,Staff,0,5,16,16
1715632046695,MMW 13R,A02,514039,Staff,0,5,16,16
1715632046695,MMW 13R,A03,628519,Staff,0,4,16,16
1715632048746,SIO 295LS,A00,523233,Staff,10,0,30,20
1715632049775,SIO 295S,A00,523232,Staff,10,0,30,20
1715632050804,SIOC 290S,A01,637330,Merrifield; Mark A,22,0,30,8
1715632051832,SIOC 291S,A01,637333,Gabriel; Corey John,22,0,30,8
1715632052858,SOCI 117,A01,494376,Staff,0,5,5,5
1715632053899,WES 237B,A00,494380,Staff,10,0,20,10
1715632055965,AESE 279B,A00,494370,Wade; Jon P,0,0,33,33
1715632056989,AIP 97,001,660915,Van Den Einde; Yael Dahlia,9998,0,9999,1
1715632058015,AIP 197,001,627712,Vespa; Emanuel Ignacio,9995,0,9999,4
1715632058015,AIP 197,002,650778,Amir; On,9998,0,9999,1
1715632058015,AIP 197,003,650933,Avenancio-Leon; Carlos,9998,0,9999,1
1715632058015,AIP 197,004,658530,Heyman; Gail D.,9998,0,9999,1
1715632058015,AIP 197,005,658631,Neal; Sonya E,9998,0,9999,1
1715632058015,AIP 197,006,658671,Du; Songzi,9998,0,9999,1
1715632059048,ANAR 135S,A00,494369,Braswell; Geoffrey E.,0,0,0,0
1715632060077,BENG 196,001,628496,Engler; Adam J.,9998,0,9999,1
1715632060077,BENG 196,002,660916,Watson; John Thomas,9999,0,9999,0
1715632061104,BISP 197,001,650773,Wilhelm; James E.,9994,0,9999,5
1715632061104,BISP 197,002,658904,Coleman; Aaron B.,9998,0,9999,1
1715632062130,CAT 124RS,A01,519847,Geibel; William,0,0,20,20
1715632063157,CAT 125RS,A01,515971,Geibel; William,0,0,20,20
1715632064187,CLRE 250,A00,511389,Morris; Sheldon,9992,0,9999,7
1715632065215,CLRE 251,A00,507176,Mehta; Ravindra L.,9992,0,9999,7
1715632065215,CLRE 251,B00,511410,Mehta; Ravindra L.,9998,0,9999,1
1715632066240,CLRE 252,A00,507189,Cuomo; Raphael Eduardo,9994,0,9999,5
1715632067267,CLRE 253,A00,507199,Vaida; Florin,9994,0,9999,5
1715632067267,CLRE 253,B00,507202,Vaida; Florin,9999,0,9999,0
1715632068292,CLRE 259,A00,507211,Patel; Hemal,9996,0,9999,3
1715632069318,CLRE 260,A00,507221,Cuomo; Raphael Eduardo,9999,0,9999,0
1715632070343,CLRE 297,001,507242,Cuomo; Raphael Eduardo,9999,0,9999,0
1715632071369,COGS 197,001,638244,Voytek; Bradley Thomas,9997,0,9999,2
1715632072394,CSE 191,A00,516875,Minnes Kemp; Mor Mia,9991,0,9999,8
1715632073419,CSE 197,001,637388,Minnes Kemp; Mor Mia,9992,0,9999,7
1715632074451,CSS 201S,A01,494383,Mignozzetti; Umberto,35,0,35,0
1715632075479,CSS 202S,A01,494387,Mignozzetti; Umberto,35,0,35,0
1715632076503,DSC 197,001,628532,Eldridge; Justin Matthew,9995,0,9999,4
1715632077532,EAP 100,A00,516065,Staff,9799,0,9999,200
1715632078561,ECE 45,A01,507414,Staff,31,0,60,29
1715632080615,ECE 111,A01,507420,Staff,11,0,50,39
1715632081641,ECE 197,001,548057,Sievenpiper; Daniel F.,9991,0,9999,8
1715632082671,EDS 115,A00,507243,Choi; Bailey Miyeon,7,0,28,21
1715632083697,EDS 117,A01,494379,Staff,0,6,34,34
1715632084725,EDS 125,A00,507246,Hopkins; Megan Beth,8,0,30,22
1715632085751,EDS 128A,A01,507264,Fargason; Sharon Gayle,6,0,26,20
1715632086777,EDS 128B,A01,507293,Pappas; Elizabeth,10,0,30,20
1715632087806,EDS 139,A00,507294,Fargason; Sharon Gayle,10,0,30,20
1715632087806,EDS 139,B00,507313,Pappas; Elizabeth,11,0,30,19
1715632088835,EDS 201,A00,507315,Staff,10,0,30,20
1715632089865,EDS 203,A01,507317,Halter; Christopher P.,10,0,30,20
1715632090897,EDS 204R,A01,507319,Halter; Christopher P.,0,3,30,30
1715632090897,EDS 204R,B01,507331,Heinzman; Erica M.,14,0,30,16
1715632091923,EDS 206R,A00,507332,Staff,0,4,30,30
1715632091923,EDS 206R,B00,507343,Staff,15,0,30,15
1715632092953,EDS 250,A00,507344,Hemans; Patricia Ann Benitez,20,0,40,20
1715632093978,EDS 281,A00,507345,Daly; Alan J.,18,0,18,0
1715632095004,EDS 284,A00,507350,Daly; Alan J.,16,0,16,0
1715632096030,EDS 286,A00,507359,Fine; Sarah,18,0,18,0
1715632097060,EDS 289C,A01,507361,Daly; Alan J.,18,0,18,0
1715632098085,EDS 290,A00,507366,Hofstetter; Carolyn,15,0,15,0
1715632099109,LIGM 5A,A00,507421,Fischer-Grunski; Eva K,17,0,20,3
1715632100133,LIGM 5B,A00,507423,Fischer-Grunski; Eva K,19,0,20,1
1715632101160,LIGM 5C,A00,507425,Fischer-Grunski; Eva K,19,0,20,1
1715632102189,LIIT 5AS,A00,507427,Carnelos; Chiara,20,0,20,0
1715632103214,LIIT 5BS,A00,507430,Carnelos; Chiara,20,0,20,0
1715632104239,LIIT 5CS,A00,507432,Carnelos; Chiara,20,0,20,0
1715632105266,LISP 5A,A00,507541,Munoz Sanchez; Alicia,11,0,20,9
1715632106291,LISP 5B,A00,507671,Munoz Sanchez; Alicia,9,0,20,11
1715632107320,LISP 5C,A00,507696,Munoz Sanchez; Alicia,9,0,20,11
1715632108349,MAE 197,001,528363,Boechler; Nicholas Sebastia,9998,0,9999,1
1715632109383,MATH 197,001,523477,Kedlaya; Kiran S.,9994,0,9999,5
1715632109383,MATH 197,002,563811,Zhang; Danna,9994,0,9999,5
1715632109383,MATH 197,003,628552,Dumitriu; Ioana,9998,0,9999,1
1715632109383,MATH 197,004,660885,Floyd; Eric,9998,0,9999,1
1715632110410,MCWP 40R,A00,518780,Staff,2,0,20,18
1715632110410,MCWP 40R,B00,518781,Staff,11,0,20,9
1715632110410,MCWP 40R,C00,518783,Staff,5,0,20,15
1715632111434,MCWP 50R,A00,518791,Staff,0,1,20,20
1715632111434,MCWP 50R,B00,518792,Staff,0,2,20,20
1715632111434,MCWP 50R,C00,518793,Staff,0,4,20,20
1715632111434,MCWP 50R,D00,518794,Staff,0,1,20,20
1715632111434,MCWP 50R,E00,518795,Staff,0,2,20,20
1715632111434,MCWP 50R,F00,518796,Staff,0,1,20,20
1715632111434,MCWP 50R,G00,518797,Staff,0,1,20,20
1715632112460,MMW 12R,A01,514034,Herbst; Matthew,0,2,16,16
1715632112460,MMW 12R,A02,514035,Herbst; Matthew,0,0,16,16
1715632113486,MMW 13R,A01,514037,Staff,0,5,16,16
1715632113486,MMW 13R,A02,514039,Staff,0,5,16,16
1715632113486,MMW 13R,A03,628519,Staff,0,4,16,16
1715632115538,SIO 295LS,A00,523233,Staff,10,0,30,20
1715632116562,SIO 295S,A00,523232,Staff,10,0,30,20
1715632117589,SIOC 290S,A01,637330,Merrifield; Mark A,22,0,30,8
1715632118615,SIOC 291S,A01,637333,Gabriel; Corey John,22,0,30,8
1715632119644,SOCI 117,A01,494376,Staff,0,5,5,5
1715632120671,WES 237B,A00,494380,Staff,10,0,20,10
1715632122742,AESE 279B,A00,494370,Wade; Jon P,0,0,33,33
1715632123771,AIP 97,001,660915,Van Den Einde; Yael Dahlia,9998,0,9999,1
1715632124802,AIP 197,001,627712,Vespa; Emanuel Ignacio,9995,0,9999,4
1715632124802,AIP 197,002,650778,Amir; On,9998,0,9999,1
1715632124802,AIP 197,003,650933,Avenancio-Leon; Carlos,9998,0,9999,1
1715632124802,AIP 197,004,658530,Heyman; Gail D.,9998,0,9999,1
1715632124802,AIP 197,005,658631,Neal; Sonya E,9998,0,9999,1
1715632124802,AIP 197,006,658671,Du; Songzi,9998,0,9999,1
1715632125830,ANAR 135S,A00,494369,Braswell; Geoffrey E.,0,0,0,0
1715632126856,BENG 196,001,628496,Engler; Adam J.,9998,0,9999,1
1715632126856,BENG 196,002,660916,Watson; John Thomas,9999,0,9999,0
1715632127938,BISP 197,001,650773,Wilhelm; James E.,9994,0,9999,5
1715632127938,BISP 197,002,658904,Coleman; Aaron B.,9998,0,9999,1
1715632128967,CAT 124RS,A01,519847,Geibel; William,0,0,20,20
1715632129995,CAT 125RS,A01,515971,Geibel; William,0,0,20,20
1715632131025,CLRE 250,A00,511389,Morris; Sheldon,9992,0,9999,7
1715632132053,CLRE 251,A00,507176,Mehta; Ravindra L.,9992,0,9999,7
1715632132053,CLRE 251,B00,511410,Mehta; Ravindra L.,9998,0,9999,1
1715632133080,CLRE 252,A00,507189,Cuomo; Raphael Eduardo,9994,0,9999,5
1715632134109,CLRE 253,A00,507199,Vaida; Florin,9994,0,9999,5
1715632134109,CLRE 253,B00,507202,Vaida; Florin,9999,0,9999,0
1715632135135,CLRE 259,A00,507211,Patel; Hemal,9996,0,9999,3
1715632136164,CLRE 260,A00,507221,Cuomo; Raphael Eduardo,9999,0,9999,0
1715632137190,CLRE 297,001,507242,Cuomo; Raphael Eduardo,9999,0,9999,0
1715632138220,COGS 197,001,638244,Voytek; Bradley Thomas,9997,0,9999,2
1715632139248,CSE 191,A00,516875,Minnes Kemp; Mor Mia,9991,0,9999,8
1715632140277,CSE 197,001,637388,Minnes Kemp; Mor Mia,9992,0,9999,7
1715632141310,CSS 201S,A01,494383,Mignozzetti; Umberto,35,0,35,0
1715632142336,CSS 202S,A01,494387,Mignozzetti; Umberto,35,0,35,0
1715632143361,DSC 197,001,628532,Eldridge; Justin Matthew,9995,0,9999,4
1715632144387,EAP 100,A00,516065,Staff,9799,0,9999,200
1715632145415,ECE 45,A01,507414,Staff,31,0,60,29
1715632147466,ECE 111,A01,507420,Staff,11,0,50,39
1715632148491,ECE 197,001,548057,Sievenpiper; Daniel F.,9991,0,9999,8
1715632149516,EDS 115,A00,507243,Choi; Bailey Miyeon,7,0,28,21
1715632150547,EDS 117,A01,494379,Staff,0,6,34,34
1715632151577,EDS 125,A00,507246,Hopkins; Megan Beth,8,0,30,22
1715632152603,EDS 128A,A01,507264,Fargason; Sharon Gayle,6,0,26,20
1715632153632,EDS 128B,A01,507293,Pappas; Elizabeth,10,0,30,20
1715632154657,EDS 139,A00,507294,Fargason; Sharon Gayle,10,0,30,20
1715632154657,EDS 139,B00,507313,Pappas; Elizabeth,11,0,30,19
1715632155681,EDS 201,A00,507315,Staff,10,0,30,20
1715632156705,EDS 203,A01,507317,Halter; Christopher P.,10,0,30,20
1715632157732,EDS 204R,A01,507319,Halter; Christopher P.,0,3,30,30
1715632157732,EDS 204R,B01,507331,Heinzman; Erica M.,14,0,30,16
1715632158760,EDS 206R,A00,507332,Staff,0,4,30,30
1715632158760,EDS 206R,B00,507343,Staff,15,0,30,15
1715632159789,EDS 250,A00,507344,Hemans; Patricia Ann Benitez,20,0,40,20
1715632160814,EDS 281,A00,507345,Daly; Alan J.,18,0,18,0
1715632161839,EDS 284,A00,507350,Daly; Alan J.,16,0,16,0
1715632162863,EDS 286,A00,507359,Fine; Sarah,18,0,18,0
1715632163899,EDS 289C,A01,507361,Daly; Alan J.,18,0,18,0
1715632164924,EDS 290,A00,507366,Hofstetter; Carolyn,15,0,15,0
1715632165950,LIGM 5A,A00,507421,Fischer-Grunski; Eva K,17,0,20,3
1715632166975,LIGM 5B,A00,507423,Fischer-Grunski; Eva K,19,0,20,1
1715632168001,LIGM 5C,A00,507425,Fischer-Grunski; Eva K,19,0,20,1
1715632169025,LIIT 5AS,A00,507427,Carnelos; Chiara,20,0,20,0
1715632170050,LIIT 5BS,A00,507430,Carnelos; Chiara,20,0,20,0
1715632171078,LIIT 5CS,A00,507432,Carnelos; Chiara,20,0,20,0
1715632172109,LISP 5A,A00,507541,Munoz Sanchez; Alicia,11,0,20,9
1715632173133,LISP 5B,A00,507671,Munoz Sanchez; Alicia,9,0,20,11
1715632174158,LISP 5C,A00,507696,Munoz Sanchez; Alicia,9,0,20,11
1715632175188,MAE 197,001,528363,Boechler; Nicholas Sebastia,9998,0,9999,1
1715632176219,MATH 197,001,523477,Kedlaya; Kiran S.,9994,0,9999,5
1715632176219,MATH 197,002,563811,Zhang; Danna,9994,0,9999,5
1715632176219,MATH 197,003,628552,Dumitriu; Ioana,9998,0,9999,1
1715632176219,MATH 197,004,660885,Floyd; Eric,9998,0,9999,1
1715632177246,MCWP 40R,A00,518780,Staff,2,0,20,18
1715632177246,MCWP 40R,B00,518781,Staff,11,0,20,9
1715632177246,MCWP 40R,C00,518783,Staff,5,0,20,15
1715632178275,MCWP 50R,A00,518791,Staff,0,1,20,20
1715632178275,MCWP 50R,B00,518792,Staff,0,2,20,20
1715632178275,MCWP 50R,C00,518793,Staff,0,4,20,20
1715632178275,MCWP 50R,D00,518794,Staff,0,1,20,20
1715632178275,MCWP 50R,E00,518795,Staff,0,2,20,20
1715632178275,MCWP 50R,F00,518796,Staff,0,1,20,20
1715632178275,MCWP 50R,G00,518797,Staff,0,1,20,20
1715632179304,MMW 12R,A01,514034,Herbst; Matthew,0,2,16,16
1715632179304,MMW 12R,A02,514035,Herbst; Matthew,0,0,16,16
1715632180332,MMW 13R,A01,514037,Staff,0,5,16,16
1715632180332,MMW 13R,A02,514039,Staff,0,5,16,16
1715632180332,MMW 13R,A03,628519,Staff,0,4,16,16
1715632182383,SIO 295LS,A00,523233,Staff,10,0,30,20
1715632183407,SIO 295S,A00,523232,Staff,10,0,30,20
1715632184433,SIOC 290S,A01,637330,Merrifield; Mark A,22,0,30,8
1715632185461,SIOC 291S,A01,637333,Gabriel; Corey John,22,0,30,8
1715632186488,SOCI 117,A01,494376,Staff,0,5,5,5
1715632187514,WES 237B,A00,494380,Staff,10,0,20,10
1715632189587,AESE 279B,A00,494370,Wade; Jon P,0,0,33,33
1715632190615,AIP 97,001,660915,Van Den Einde; Yael Dahlia,9998,0,9999,1
1715632191642,AIP 197,001,627712,Vespa; Emanuel Ignacio,9995,0,9999,4
1715632191642,AIP 197,002,650778,Amir; On,9998,0,9999,1
1715632191642,AIP 197,003,650933,Avenancio-Leon; Carlos,9998,0,9999,1
1715632191642,AIP 197,004,658530,Heyman; Gail D.,9998,0,9999,1
1715632191642,AIP 197,005,658631,Neal; Sonya E,9998,0,9999,1
1715632191642,AIP 197,006,658671,Du; Songzi,9998,0,9999,1
1715632192671,ANAR 135S,A00,494369,Braswell; Geoffrey E.,0,0,0,0
1715632193700,BENG 196,001,628496,Engler; Adam J.,9998,0,9999,1
1715632193700,BENG 196,002,660916,Watson; John Thomas,9999,0,9999,0
1715632194729,BISP 197,001,650773,Wilhelm; James E.,9994,0,9999,5
1715632194729,BISP 197,002,658904,Coleman; Aaron B.,9998,0,9999,1
1715632195759,CAT 124RS,A01,519847,Geibel; William,0,0,20,20
1715632196786,CAT 125RS,A01,515971,Geibel; William,0,0,20,20
1715632197814,CLRE 250,A00,511389,Morris; Sheldon,9992,0,9999,7
1715632198842,CLRE 251,A00,507176,Mehta; Ravindra L.,9992,0,9999,7
1715632198842,CLRE 251,B00,511410,Mehta; Ravindra L.,9998,0,9999,1
1715632199870,CLRE 252,A00,507189,Cuomo; Raphael Eduardo,9994,0,9999,5
1715632200898,CLRE 253,A00,507199,Vaida; Florin,9994,0,9999,5
1715632200898,CLRE 253,B00,507202,Vaida; Florin,9999,0,9999,0
1715632201924,CLRE 259,A00,507211,Patel; Hemal,9996,0,9999,3
1715632202948,CLRE 260,A00,507221,Cuomo; Raphael Eduardo,9999,0,9999,0
1715632203974,CLRE 297,001,507242,Cuomo; Raphael Eduardo,9999,0,9999,0
1715632205000,COGS 197,001,638244,Voytek; Bradley Thomas,9997,0,9999,2
1715632206026,CSE 191,A00,516875,Minnes Kemp; Mor Mia,9991,0,9999,8
1715632207054,CSE 197,001,637388,Minnes Kemp; Mor Mia,9992,0,9999,7
1715632208083,CSS 201S,A01,494383,Mignozzetti; Umberto,35,0,35,0
1715632209108,CSS 202S,A01,494387,Mignozzetti; Umberto,35,0,35,0
1715632210133,DSC 197,001,628532,Eldridge; Justin Matthew,9995,0,9999,4
1715632211158,EAP 100,A00,516065,Staff,9799,0,9999,200
1715632212191,ECE 45,A01,507414,Staff,31,0,60,29
1715632214245,ECE 111,A01,507420,Staff,11,0,50,39
1715632215315,ECE 197,001,548057,Sievenpiper; Daniel F.,9991,0,9999,8
1715632216341,EDS 115,A00,507243,Choi; Bailey Miyeon,7,0,28,21
1715632217368,EDS 117,A01,494379,Staff,0,6,34,34
1715632218394,EDS 125,A00,507246,Hopkins; Megan Beth,8,0,30,22
1715632219424,EDS 128A,A01,507264,Fargason; Sharon Gayle,6,0,26,20
1715632220454,EDS 128B,A01,507293,Pappas; Elizabeth,10,0,30,20
1715632221480,EDS 139,A00,507294,Fargason; Sharon Gayle,10,0,30,20
1715632221480,EDS 139,B00,507313,Pappas; Elizabeth,11,0,30,19
1715632222507,EDS 201,A00,507315,Staff,10,0,30,20
1715632223533,EDS 203,A01,507317,Halter; Christopher P.,10,0,30,20
1715632224562,EDS 204R,A01,507319,Halter; Christopher P.,0,3,30,30
1715632224562,EDS 204R,B01,507331,Heinzman; Erica M.,14,0,30,16
1715632225590,EDS 206R,A00,507332,Staff,0,4,30,30
1715632225590,EDS 206R,B00,507343,Staff,15,0,30,15
1715632226614,EDS 250,A00,507344,Hemans; Patricia Ann Benitez,20,0,40,20
1715632227642,EDS 281,A00,507345,Daly; Alan J.,18,0,18,0
1715632228671,EDS 284,A00,507350,Daly; Alan J.,16,0,16,0
1715632229701,EDS 286,A00,507359,Fine; Sarah,18,0,18,0
1715632230728,EDS 289C,A01,507361,Daly; Alan J.,18,0,18,0
1715632231806,EDS 290,A00,507366,Hofstetter; Carolyn,15,0,15,0
1715632232833,LIGM 5A,A00,507421,Fischer-Grunski; Eva K,17,0,20,3
1715632233858,LIGM 5B,A00,507423,Fischer-Grunski; Eva K,19,0,20,1
1715632234881,LIGM 5C,A00,507425,Fischer-Grunski; Eva K,19,0,20,1
1715632235910,LIIT 5AS,A00,507427,Carnelos; Chiara,20,0,20,0
1715632236934,LIIT 5BS,A00,507430,Carnelos; Chiara,20,0,20,0
1715632237961,LIIT 5CS,A00,507432,Carnelos; Chiara,20,0,20,0
1715632238988,LISP 5A,A00,507541,Munoz Sanchez; Alicia,11,0,20,9
1715632240012,LISP 5B,A00,507671,Munoz Sanchez; Alicia,9,0,20,11
1715632241041,LISP 5C,A00,507696,Munoz Sanchez; Alicia,9,0,20,11
1715632242066,MAE 197,001,528363,Boechler; Nicholas Sebastia,9998,0,9999,1
1715632243094,MATH 197,001,523477,Kedlaya; Kiran S.,9994,0,9999,5
1715632243094,MATH 197,002,563811,Zhang; Danna,9994,0,9999,5
1715632243094,MATH 197,003,628552,Dumitriu; Ioana,9998,0,9999,1
1715632243094,MATH 197,004,660885,Floyd; Eric,9998,0,9999,1
1715632244121,MCWP 40R,A00,518780,Staff,2,0,20,18
1715632244121,MCWP 40R,B00,518781,Staff,11,0,20,9
1715632244121,MCWP 40R,C00,518783,Staff,5,0,20,15
1715632245151,MCWP 50R,A00,518791,Staff,0,1,20,20
1715632245151,MCWP 50R,B00,518792,Staff,0,2,20,20
1715632245151,MCWP 50R,C00,518793,Staff,0,4,20,20
1715632245151,MCWP 50R,D00,518794,Staff,0,1,20,20
1715632245151,MCWP 50R,E00,518795,Staff,0,2,20,20
1715632245151,MCWP 50R,F00,518796,Staff,0,1,20,20
1715632245151,MCWP 50R,G00,518797,Staff,0,1,20,20
1715632246180,MMW 12R,A01,514034,Herbst; Matthew,0,2,16,16
1715632246180,MMW 12R,A02,514035,Herbst; Matthew,0,0,16,16
1715632247205,MMW 13R,A01,514037,Staff,0,5,16,16
1715632247205,MMW 13R,A02,514039,Staff,0,5,16,16
1715632247205,MMW 13R,A03,628519,Staff,0,4,16,16
1715632249310,SIO 295LS,A00,523233,Staff,10,0,30,20
1715632250336,SIO 295S,A00,523232,Staff,10,0,30,20
1715632251367,SIOC 290S,A01,637330,Merrifield; Mark A,22,0,30,8
1715632252393,SIOC 291S,A01,637333,Gabriel; Corey John,22,0,30,8
1715632253418,SOCI 117,A01,494376,Staff,0,5,5,5
1715632254447,WES 237B,A00,494380,Staff,10,0,20,10
1715632256523,AESE 279B,A00,494370,Wade; Jon P,0,0,33,33
1715632257549,AIP 97,001,660915,Van Den Einde; Yael Dahlia,9998,0,9999,1
1715632258579,AIP 197,001,627712,Vespa; Emanuel Ignacio,9995,0,9999,4
1715632258579,AIP 197,002,650778,Amir; On,9998,0,9999,1
1715632258579,AIP 197,003,650933,Avenancio-Leon; Carlos,9998,0,9999,1
1715632258579,AIP 197,004,658530,Heyman; Gail D.,9998,0,9999,1
1715632258579,AIP 197,005,658631,Neal; Sonya E,9998,0,9999,1
1715632258579,AIP 197,006,658671,Du; Songzi,9998,0,9999,1
1715632259604,ANAR 135S,A00,494369,Braswell; Geoffrey E.,0,0,0,0
1715632260629,BENG 196,001,628496,Engler; Adam J.,9998,0,9999,1
1715632260629,BENG 196,002,660916,Watson; John Thomas,9999,0,9999,0
1715632261655,BISP 197,001,650773,Wilhelm; James E.,9994,0,9999,5
1715632261655,BISP 197,002,658904,Coleman; Aaron B.,9998,0,9999,1
1715632262682,CAT 124RS,A01,519847,Geibel; William,0,0,20,20
1715632263706,CAT 125RS,A01,515971,Geibel; William,0,0,20,20
1715632264732,CLRE 250,A00,511389,Morris; Sheldon,9992,0,9999,7
1715632265759,CLRE 251,A00,507176,Mehta; Ravindra L.,9992,0,9999,7
1715632265759,CLRE 251,B00,511410,Mehta; Ravindra L.,9998,0,9999,1
1715632266785,CLRE 252,A00,507189,Cuomo; Raphael Eduardo,9994,0,9999,5
1715632267811,CLRE 253,A00,507199,Vaida; Florin,9994,0,9999,5
1715632267811,CLRE 253,B00,507202,Vaida; Florin,9999,0,9999,0
1715632268839,CLRE 259,A00,507211,Patel; Hemal,9996,0,9999,3
1715632269864,CLRE 260,A00,507221,Cuomo; Raphael Eduardo,9999,0,9999,0
1715632270891,CLRE 297,001,507242,Cuomo; Raphael Eduardo,9999,0,9999,0
1715632271919,COGS 197,001,638244,Voytek; Bradley Thomas,9997,0,9999,2
1715632272945,CSE 191,A00,516875,Minnes Kemp; Mor Mia,9991,0,9999,8
1715632273968,CSE 197,001,637388,Minnes Kemp; Mor Mia,9992,0,9999,7
1715632274995,CSS 201S,A01,494383,Mignozzetti; Umberto,35,0,35,0
1715632276025,CSS 202S,A01,494387,Mignozzetti; Umberto,35,0,35,0
1715632277050,DSC 197,001,628532,Eldridge; Justin Matthew,9995,0,9999,4
1715632278076,EAP 100,A00,516065,Staff,9799,0,9999,200
1715632279105,ECE 45,A01,507414,Staff,31,0,60,29
1715632281159,ECE 111,A01,507420,Staff,11,0,50,39
1715632282186,ECE 197,001,548057,Sievenpiper; Daniel F.,9991,0,9999,8
1715632283213,EDS 115,A00,507243,Choi; Bailey Miyeon,7,0,28,21
1715632284245,EDS 117,A01,494379,Staff,0,6,34,34
1715632285268,EDS 125,A00,507246,Hopkins; Megan Beth,8,0,30,22
1715632286294,EDS 128A,A01,507264,Fargason; Sharon Gayle,6,0,26,20
1715632287320,EDS 128B,A01,507293,Pappas; Elizabeth,10,0,30,20
1715632288348,EDS 139,A00,507294,Fargason; Sharon Gayle,10,0,30,20
1715632288348,EDS 139,B00,507313,Pappas; Elizabeth,11,0,30,19
1715632289372,EDS 201,A00,507315,Staff,10,0,30,20
1715632290396,EDS 203,A01,507317,Halter; Christopher P.,10,0,30,20
1715632291427,EDS 204R,A01,507319,Halter; Christopher P.,0,3,30,30
1715632291427,EDS 204R,B01,507331,Heinzman; Erica M.,14,0,30,16
1715632292455,EDS 206R,A00,507332,Staff,0,4,30,30
1715632292455,EDS 206R,B00,507343,Staff,15,0,30,15
1715632293479,EDS 250,A00,507344,Hemans; Patricia Ann Benitez,20,0,40,20
1715632294503,EDS 281,A00,507345,Daly; Alan J.,18,0,18,0
1715632295529,EDS 284,A00,507350,Daly; Alan J.,16,0,16,0
1715632296556,EDS 286,A00,507359,Fine; Sarah,18,0,18,0
1715632297581,EDS 289C,A01,507361,Daly; Alan J.,18,0,18,0
1715632298610,EDS 290,A00,507366,Hofstetter; Carolyn,15,0,15,0
1715632299636,LIGM 5A,A00,507421,Fischer-Grunski; Eva K,17,0,20,3
1715632300666,LIGM 5B,A00,507423,Fischer-Grunski; Eva K,19,0,20,1
1715632301695,LIGM 5C,A00,507425,Fischer-Grunski; Eva K,19,0,20,1
1715632302720,LIIT 5AS,A00,507427,Carnelos; Chiara,20,0,20,0
1715632303748,LIIT 5BS,A00,507430,Carnelos; Chiara,20,0,20,0
1715632304773,LIIT 5CS,A00,507432,Carnelos; Chiara,20,0,20,0
1715632305798,LISP 5A,A00,507541,Munoz Sanchez; Alicia,11,0,20,9
1715632306825,LISP 5B,A00,507671,Munoz Sanchez; Alicia,9,0,20,11
1715632307849,LISP 5C,A00,507696,Munoz Sanchez; Alicia,9,0,20,11
1715632308876,MAE 197,001,528363,Boechler; Nicholas Sebastia,9998,0,9999,1
1715632309905,MATH 197,001,523477,Kedlaya; Kiran S.,9994,0,9999,5
1715632309905,MATH 197,002,563811,Zhang; Danna,9994,0,9999,5
1715632309905,MATH 197,003,628552,Dumitriu; Ioana,9998,0,9999,1
1715632309905,MATH 197,004,660885,Floyd; Eric,9998,0,9999,1
1715632310931,MCWP 40R,A00,518780,Staff,2,0,20,18
1715632310931,MCWP 40R,B00,518781,Staff,11,0,20,9
1715632310931,MCWP 40R,C00,518783,Staff,5,0,20,15
1715632311959,MCWP 50R,A00,518791,Staff,0,1,20,20
1715632311959,MCWP 50R,B00,518792,Staff,0,2,20,20
1715632311959,MCWP 50R,C00,518793,Staff,0,4,20,20
1715632311959,MCWP 50R,D00,518794,Staff,0,1,20,20
1715632311959,MCWP 50R,E00,518795,Staff,0,2,20,20
1715632311959,MCWP 50R,F00,518796,Staff,0,1,20,20
1715632311959,MCWP 50R,G00,518797,Staff,0,1,20,20
1715632312989,MMW 12R,A01,514034,Herbst; Matthew,0,2,16,16
1715632312989,MMW 12R,A02,514035,Herbst; Matthew,0,0,16,16
1715632314018,MMW 13R,A01,514037,Staff,0,5,16,16
1715632314018,MMW 13R,A02,514039,Staff,0,5,16,16
1715632314018,MMW 13R,A03,628519,Staff,0,4,16,16
1715632316069,SIO 295LS,A00,523233,Staff,10,0,30,20
1715632317096,SIO 295S,A00,523232,Staff,10,0,30,20
1715632318122,SIOC 290S,A01,637330,Merrifield; Mark A,22,0,30,8
1715632319149,SIOC 291S,A01,637333,Gabriel; Corey John,22,0,30,8
1715632320178,SOCI 117,A01,494376,Staff,0,5,5,5
1715632321207,WES 237B,A00,494380,Staff,10,0,20,10
1715632323278,AESE 279B,A00,494370,Wade; Jon P,0,0,33,33
1715632324303,AIP 97,001,660915,Van Den Einde; Yael Dahlia,9998,0,9999,1
1715632325330,AIP 197,001,627712,Vespa; Emanuel Ignacio,9995,0,9999,4
1715632325330,AIP 197,002,650778,Amir; On,9998,0,9999,1
1715632325330,AIP 197,003,650933,Avenancio-Leon; Carlos,9998,0,9999,1
1715632325330,AIP 197,004,658530,Heyman; Gail D.,9998,0,9999,1
1715632325330,AIP 197,005,658631,Neal; Sonya E,9998,0,9999,1
1715632325330,AIP 197,006,658671,Du; Songzi,9998,0,9999,1
1715632326356,ANAR 135S,A00,494369,Braswell; Geoffrey E.,0,0,0,0
1715632327381,BENG 196,001,628496,Engler; Adam J.,9998,0,9999,1
1715632327381,BENG 196,002,660916,Watson; John Thomas,9999,0,9999,0
1715632328406,BISP 197,001,650773,Wilhelm; James E.,9994,0,9999,5
1715632328406,BISP 197,002,658904,Coleman; Aaron B.,9998,0,9999,1
1715632329435,CAT 124RS,A01,519847,Geibel; William,0,0,20,20
1715632330460,CAT 125RS,A01,515971,Geibel; William,0,0,20,20
1715632331486,CLRE 250,A00,511389,Morris; Sheldon,9992,0,9999,7
1715632332512,CLRE 251,A00,507176,Mehta; Ravindra L.,9992,0,9999,7
1715632332512,CLRE 251,B00,511410,Mehta; Ravindra L.,9998,0,9999,1
1715632333536,CLRE 252,A00,507189,Cuomo; Raphael Eduardo,9994,0,9999,5
1715632334564,CLRE 253,A00,507199,Vaida; Florin,9994,0,9999,5
1715632334564,CLRE 253,B00,507202,Vaida; Florin,9999,0,9999,0
1715632335591,CLRE 259,A00,507211,Patel; Hemal,9996,0,9999,3
1715632336616,CLRE 260,A00,507221,Cuomo; Raphael Eduardo,9999,0,9999,0
1715632337643,CLRE 297,001,507242,Cuomo; Raphael Eduardo,9999,0,9999,0
1715632338672,COGS 197,001,638244,Voytek; Bradley Thomas,9997,0,9999,2
1715632339700,CSE 191,A00,516875,Minnes Kemp; Mor Mia,9991,0,9999,8
1715632340725,CSE 197,001,637388,Minnes Kemp; Mor Mia,9992,0,9999,7
1715632341752,CSS 201S,A01,494383,Mignozzetti; Umberto,35,0,35,0
1715632342779,CSS 202S,A01,494387,Mignozzetti; Umberto,35,0,35,0
1715632343803,DSC 197,001,628532,Eldridge; Justin Matthew,9995,0,9999,4
1715632344827,EAP 100,A00,516065,Staff,9799,0,9999,200
1715632345854,ECE 45,A01,507414,Staff,31,0,60,29
1715632347909,ECE 111,A01,507420,Staff,11,0,50,39
1715632348932,ECE 197,001,548057,Sievenpiper; Daniel F.,9991,0,9999,8
1715632349957,EDS 115,A00,507243,Choi; Bailey Miyeon,7,0,28,21
1715632350988,EDS 117,A01,494379,Staff,0,6,34,34
1715632352013,EDS 125,A00,507246,Hopkins; Megan Beth,8,0,30,22
1715632353038,EDS 128A,A01,507264,Fargason; Sharon Gayle,6,0,26,20
1715632354063,EDS 128B,A01,507293,Pappas; Elizabeth,10,0,30,20
1715632355087,EDS 139,A00,507294,Fargason; Sharon Gayle,10,0,30,20
1715632355087,EDS 139,B00,507313,Pappas; Elizabeth,11,0,30,19
1715632356114,EDS 201,A00,507315,Staff,10,0,30,20
1715632357141,EDS 203,A01,507317,Halter; Christopher P.,10,0,30,20
1715632358167,EDS 204R,A01,507319,Halter; Christopher P.,0,3,30,30
1715632358167,EDS 204R,B01,507331,Heinzman; Erica M.,14,0,30,16
1715632359195,EDS 206R,A00,507332,Staff,0,4,30,30
1715632359195,EDS 206R,B00,507343,Staff,15,0,30,15
1715632360219,EDS 250,A00,507344,Hemans; Patricia Ann Benitez,20,0,40,20
1715632361247,EDS 281,A00,507345,Daly; Alan J.,18,0,18,0
1715632362271,EDS 284,A00,507350,Daly; Alan J.,16,0,16,0
1715632363297,EDS 286,A00,507359,Fine; Sarah,18,0,18,0
1715632364321,EDS 289C,A01,507361,Daly; Alan J.,18,0,18,0
1715632365347,EDS 290,A00,507366,Hofstetter; Carolyn,15,0,15,0
1715632366373,LIGM 5A,A00,507421,Fischer-Grunski; Eva K,17,0,20,3
1715632367401,LIGM 5B,A00,507423,Fischer-Grunski; Eva K,19,0,20,1
1715632368426,LIGM 5C,A00,507425,Fischer-Grunski; Eva K,19,0,20,1
1715632369457,LIIT 5AS,A00,507427,Carnelos; Chiara,20,0,20,0
1715632370483,LIIT 5BS,A00,507430,Carnelos; Chiara,20,0,20,0
1715632371562,LIIT 5CS,A00,507432,Carnelos; Chiara,20,0,20,0
1715632372588,LISP 5A,A00,507541,Munoz Sanchez; Alicia,11,0,20,9
1715632373614,LISP 5B,A00,507671,Munoz Sanchez; Alicia,9,0,20,11
1715632374643,LISP 5C,A00,507696,Munoz Sanchez; Alicia,9,0,20,11
1715632375671,MAE 197,001,528363,Boechler; Nicholas Sebastia,9998,0,9999,1
1715632376704,MATH 197,001,523477,Kedlaya; Kiran S.,9994,0,9999,5
1715632376704,MATH 197,002,563811,Zhang; Danna,9994,0,9999,5
1715632376704,MATH 197,003,628552,Dumitriu; Ioana,9998,0,9999,1
1715632376704,MATH 197,004,660885,Floyd; Eric,9998,0,9999,1
1715632377732,MCWP 40R,A00,518780,Staff,2,0,20,18
1715632377732,MCWP 40R,B00,518781,Staff,11,0,20,9
1715632377732,MCWP 40R,C00,518783,Staff,5,0,20,15
1715632378761,MCWP 50R,A00,518791,Staff,0,1,20,20
1715632378761,MCWP 50R,B00,518792,Staff,0,2,20,20
1715632378761,MCWP 50R,C00,518793,Staff,0,4,20,20
1715632378761,MCWP 50R,D00,518794,Staff,0,1,20,20
1715632378761,MCWP 50R,E00,518795,Staff,0,2,20,20
1715632378761,MCWP 50R,F00,518796,Staff,0,1,20,20
1715632378761,MCWP 50R,G00,518797,Staff,0,1,20,20
1715632379786,MMW 12R,A01,514034,Herbst; Matthew,0,2,16,16
1715632379786,MMW 12R,A02,514035,Herbst; Matthew,0,0,16,16
1715632380811,MMW 13R,A01,514037,Staff,0,5,16,16
1715632380811,MMW 13R,A02,514039,Staff,0,5,16,16
1715632380811,MMW 13R,A03,628519,Staff,0,4,16,16
1715632382863,SIO 295LS,A00,523233,Staff,10,0,30,20
1715632383886,SIO 295S,A00,523232,Staff,10,0,30,20
1715632384911,SIOC 290S,A01,637330,Merrifield; Mark A,22,0,30,8
1715632385942,SIOC 291S,A01,637333,Gabriel; Corey John,22,0,30,8
1715632386967,SOCI 117,A01,494376,Staff,0,5,5,5
1715632387991,WES 237B,A00,494380,Staff,10,0,20,10
1715632390063,AESE 279B,A00,494370,Wade; Jon P,0,0,33,33
1715632391089,AIP 97,001,660915,Van Den Einde; Yael Dahlia,9998,0,9999,1
1715632392117,AIP 197,001,627712,Vespa; Emanuel Ignacio,9995,0,9999,4
1715632392117,AIP 197,002,650778,Amir; On,9998,0,9999,1
1715632392117,AIP 197,003,650933,Avenancio-Leon; Carlos,9998,0,9999,1
1715632392117,AIP 197,004,658530,Heyman; Gail D.,9998,0,9999,1
1715632392117,AIP 197,005,658631,Neal; Sonya E,9998,0,9999,1
1715632392117,AIP 197,006,658671,Du; Songzi,9998,0,9999,1
1715632393142,ANAR 135S,A00,494369,Braswell; Geoffrey E.,0,0,0,0
1715632394171,BENG 196,001,628496,Engler; Adam J.,9998,0,9999,1
1715632394171,BENG 196,002,660916,Watson; John Thomas,9999,0,9999,0
1715632395197,BISP 197,001,650773,Wilhelm; James E.,9994,0,9999,5
1715632395197,BISP 197,002,658904,Coleman; Aaron B.,9998,0,9999,1
1715632396222,CAT 124RS,A01,519847,Geibel; William,0,0,20,20
1715632397246,CAT 125RS,A01,515971,Geibel; William,0,0,20,20
1715632398271,CLRE 250,A00,511389,Morris; Sheldon,9992,0,9999,7
1715632399300,CLRE 251,A00,507176,Mehta; Ravindra L.,9992,0,9999,7
1715632399300,CLRE 251,B00,511410,Mehta; Ravindra L.,9998,0,9999,1
1715632400326,CLRE 252,A00,507189,Cuomo; Raphael Eduardo,9994,0,9999,5
1715632401353,CLRE 253,A00,507199,Vaida; Florin,9994,0,9999,5
1715632401353,CLRE 253,B00,507202,Vaida; Florin,9999,0,9999,0
1715632402379,CLRE 259,A00,507211,Patel; Hemal,9996,0,9999,3
1715632403404,CLRE 260,A00,507221,Cuomo; Raphael Eduardo,9999,0,9999,0
1715632404431,CLRE 297,001,507242,Cuomo; Raphael Eduardo,9999,0,9999,0
1715632405458,COGS 197,001,638244,Voytek; Bradley Thomas,9997,0,9999,2
1715632406484,CSE 191,A00,516875,Minnes Kemp; Mor Mia,9991,0,9999,8
1715632407510,CSE 197,001,637388,Minnes Kemp; Mor Mia,9992,0,9999,7
1715632408540,CSS 201S,A01,494383,Mignozzetti; Umberto,35,0,35,0
1715632409569,CSS 202S,A01,494387,Mignozzetti; Umberto,35,0,35,0
1715632410597,DSC 197,001,628532,Eldridge; Justin Matthew,9995,0,9999,4
1715632411624,EAP 100,A00,516065,Staff,9799,0,9999,200
1715632412652,ECE 45,A01,507414,Staff,31,0,60,29
1715632414706,ECE 111,A01,507420,Staff,11,0,50,39
1715632415731,ECE 197,001,548057,Sievenpiper; Daniel F.,9991,0,9999,8
1715632416756,EDS 115,A00,507243,Choi; Bailey Miyeon,7,0,28,21
1715632417786,EDS 117,A01,494379,Staff,0,6,34,34
1715632418817,EDS 125,A00,507246,Hopkins; Megan Beth,8,0,30,22
1715632419846,EDS 128A,A01,507264,Fargason; Sharon Gayle,6,0,26,20
1715632420871,EDS 128B,A01,507293,Pappas; Elizabeth,10,0,30,20
1715632421897,EDS 139,A00,507294,Fargason; Sharon Gayle,10,0,30,20
1715632421897,EDS 139,B00,507313,Pappas; Elizabeth,11,0,30,19
1715632422924,EDS 201,A00,507315,Staff,10,0,30,20
1715632423948,EDS 203,A01,507317,Halter; Christopher P.,10,0,30,20
1715632424975,EDS 204R,A01,507319,Halter; Christopher P.,0,3,30,30
1715632424975,EDS 204R,B01,507331,Heinzman; Erica M.,14,0,30,16
1715632426001,EDS 206R,A00,507332,Staff,0,4,30,30
1715632426001,EDS 206R,B00,507343,Staff,15,0,30,15
1715632427028,EDS 250,A00,507344,Hemans; Patricia Ann Benitez,20,0,40,20
1715632428054,EDS 281,A00,507345,Daly; Alan J.,18,0,18,0
1715632429080,EDS 284,A00,507350,Daly; Alan J.,16,0,16,0
1715632430105,EDS 286,A00,507359,Fine; Sarah,18,0,18,0
1715632431134,EDS 289C,A01,507361,Daly; Alan J.,18,0,18,0
1715632432159,EDS 290,A00,507366,Hofstetter; Carolyn,15,0,15,0
1715632433188,LIGM 5A,A00,507421,Fischer-Grunski; Eva K,17,0,20,3
1715632434212,LIGM 5B,A00,507423,Fischer-Grunski; Eva K,19,0,20,1
1715632435238,LIGM 5C,A00,507425,Fischer-Grunski; Eva K,19,0,20,1
1715632436264,LIIT 5AS,A00,507427,Carnelos; Chiara,20,0,20,0
1715632437291,LIIT 5BS,A00,507430,Carnelos; Chiara,20,0,20,0
1715632438320,LIIT 5CS,A00,507432,Carnelos; Chiara,20,0,20,0
1715632439351,LISP 5A,A00,507541,Munoz Sanchez; Alicia,11,0,20,9
1715632440377,LISP 5B,A00,507671,Munoz Sanchez; Alicia,9,0,20,11
1715632441406,LISP 5C,A00,507696,Munoz Sanchez; Alicia,9,0,20,11
1715632442432,MAE 197,001,528363,Boechler; Nicholas Sebastia,9998,0,9999,1
1715632443459,MATH 197,001,523477,Kedlaya; Kiran S.,9994,0,9999,5
1715632443459,MATH 197,002,563811,Zhang; Danna,9994,0,9999,5
1715632443459,MATH 197,003,628552,Dumitriu; Ioana,9998,0,9999,1
1715632443459,MATH 197,004,660885,Floyd; Eric,9998,0,9999,1
1715632444485,MCWP 40R,A00,518780,Staff,2,0,20,18
1715632444485,MCWP 40R,B00,518781,Staff,11,0,20,9
1715632444485,MCWP 40R,C00,518783,Staff,5,0,20,15
1715632445510,MCWP 50R,A00,518791,Staff,0,1,20,20
1715632445510,MCWP 50R,B00,518792,Staff,0,2,20,20
1715632445510,MCWP 50R,C00,518793,Staff,0,4,20,20
1715632445510,MCWP 50R,D00,518794,Staff,0,1,20,20
1715632445510,MCWP 50R,E00,518795,Staff,0,2,20,20
1715632445510,MCWP 50R,F00,518796,Staff,0,1,20,20
1715632445510,MCWP 50R,G00,518797,Staff,0,1,20,20
1715632446539,MMW 12R,A01,514034,Herbst; Matthew,0,2,16,16
1715632446539,MMW 12R,A02,514035,Herbst; Matthew,0,0,16,16
1715632447564,MMW 13R,A01,514037,Staff,0,5,16,16
1715632447564,MMW 13R,A02,514039,Staff,0,5,16,16
1715632447564,MMW 13R,A03,628519,Staff,0,4,16,16
1715632449616,SIO 295LS,A00,523233,Staff,10,0,30,20
1715632450640,SIO 295S,A00,523232,Staff,10,0,30,20
1715632451666,SIOC 290S,A01,637330,Merrifield; Mark A,22,0,30,8
1715632452691,SIOC 291S,A01,637333,Gabriel; Corey John,22,0,30,8
1715632453716,SOCI 117,A01,494376,Staff,0,5,5,5
1715632454742,WES 237B,A00,494380,Staff,10,0,20,10
1715632456803,AESE 279B,A00,494370,Wade; Jon P,0,0,33,33
1715632457828,AIP 97,001,660915,Van Den Einde; Yael Dahlia,9998,0,9999,1
1715632458852,AIP 197,001,627712,Vespa; Emanuel Ignacio,9995,0,9999,4
1715632458852,AIP 197,002,650778,Amir; On,9998,0,9999,1
1715632458852,AIP 197,003,650933,Avenancio-Leon; Carlos,9998,0,9999,1
1715632458852,AIP 197,004,658530,Heyman; Gail D.,9998,0,9999,1
1715632458852,AIP 197,005,658631,Neal; Sonya E,9998,0,9999,1
1715632458852,AIP 197,006,658671,Du; Songzi,9998,0,9999,1
1715632459877,ANAR 135S,A00,494369,Braswell; Geoffrey E.,0,0,0,0
1715632460903,BENG 196,001,628496,Engler; Adam J.,9998,0,9999,1
1715632460903,BENG 196,002,660916,Watson; John Thomas,9999,0,9999,0
1715632461928,BISP 197,001,650773,Wilhelm; James E.,9994,0,9999,5
1715632461928,BISP 197,002,658904,Coleman; Aaron B.,9998,0,9999,1
1715632462954,CAT 124RS,A01,519847,Geibel; William,0,0,20,20
1715632463982,CAT 125RS,A01,515971,Geibel; William,0,0,20,20
1715632465010,CLRE 250,A00,511389,Morris; Sheldon,9992,0,9999,7
1715632466036,CLRE 251,A00,507176,Mehta; Ravindra L.,9992,0,9999,7
1715632466036,CLRE 251,B00,511410,Mehta; Ravindra L.,9998,0,9999,1
1715632467061,CLRE 252,A00,507189,Cuomo; Raphael Eduardo,9994,0,9999,5
1715632468086,CLRE 253,A00,507199,Vaida; Florin,9994,0,9999,5
1715632468086,CLRE 253,B00,507202,Vaida; Florin,9999,0,9999,0
1715632469111,CLRE 259,A00,507211,Patel; Hemal,9996,0,9999,3
1715632470136,CLRE 260,A00,507221,Cuomo; Raphael Eduardo,9999,0,9999,0
1715632471162,CLRE 297,001,507242,Cuomo; Raphael Eduardo,9999,0,9999,0
1715632472187,COGS 197,001,638244,Voytek; Bradley Thomas,9997,0,9999,2
1715632473212,CSE 191,A00,516875,Minnes Kemp; Mor Mia,9991,0,9999,8
1715632474239,CSE 197,001,637388,Minnes Kemp; Mor Mia,9992,0,9999,7
1715632475320,CSS 201S,A01,494383,Mignozzetti; Umberto,35,0,35,0
1715632476346,CSS 202S,A01,494387,Mignozzetti; Umberto,35,0,35,0
1715632477373,DSC 197,001,628532,Eldridge; Justin Matthew,9995,0,9999,4
1715632478402,EAP 100,A00,516065,Staff,9799,0,9999,200
1715632479429,ECE 45,A01,507414,Staff,31,0,60,29
1715632481483,ECE 111,A01,507420,Staff,11,0,50,39
1715632482510,ECE 197,001,548057,Sievenpiper; Daniel F.,9991,0,9999,8
1715632483535,EDS 115,A00,507243,Choi; Bailey Miyeon,7,0,28,21
1715632484565,EDS 117,A01,494379,Staff,0,6,34,34
1715632485592,EDS 125,A00,507246,Hopkins; Megan Beth,8,0,30,22
1715632486622,EDS 128A,A01,507264,Fargason; Sharon Gayle,6,0,26,20
1715632487648,EDS 128B,A01,507293,Pappas; Elizabeth,10,0,30,20
1715632488676,EDS 139,A00,507294,Fargason; Sharon Gayle,10,0,30,20
1715632488676,EDS 139,B00,507313,Pappas; Elizabeth,11,0,30,19
1715632489710,EDS 201,A00,507315,Staff,10,0,30,20
1715632490738,EDS 203,A01,507317,Halter; Christopher P.,10,0,30,20
1715632491763,EDS 204R,A01,507319,Halter; Christopher P.,0,3,30,30
1715632491763,EDS 204R,B01,507331,Heinzman; Erica M.,14,0,30,16
1715632492793,EDS 206R,A00,507332,Staff,0,4,30,30
1715632492793,EDS 206R,B00,507343,Staff,15,0,30,15
1715632493822,EDS 250,A00,507344,Hemans; Patricia Ann Benitez,20,0,40,20
1715632494852,EDS 281,A00,507345,Daly; Alan J.,18,0,18,0
1715632495878,EDS 284,A00,507350,Daly; Alan J.,16,0,16,0
1715632496903,EDS 286,A00,507359,Fine; Sarah,18,0,18,0
1715632497927,EDS 289C,A01,507361,Daly; Alan J.,18,0,18,0
1715632498952,EDS 290,A00,507366,Hofstetter; Carolyn,15,0,15,0
1715632499986,LIGM 5A,A00,507421,Fischer-Grunski; Eva K,17,0,20,3
1715632501010,LIGM 5B,A00,507423,Fischer-Grunski; Eva K,19,0,20,1
1715632502038,LIGM 5C,A00,507425,Fischer-Grunski; Eva K,19,0,20,1
1715632503070,LIIT 5AS,A00,507427,Carnelos; Chiara,20,0,20,0
1715632504094,LIIT 5BS,A00,507430,Carnelos; Chiara,20,0,20,0
1715632505123,LIIT 5CS,A00,507432,Carnelos; Chiara,20,0,20,0
1715632506148,LISP 5A,A00,507541,Munoz Sanchez; Alicia,11,0,20,9
1715632507177,LISP 5B,A00,507671,Munoz Sanchez; Alicia,9,0,20,11
1715632508205,LISP 5C,A00,507696,Munoz Sanchez; Alicia,9,0,20,11
1715632509232,MAE 197,001,528363,Boechler; Nicholas Sebastia,9998,0,9999,1
1715632510254,MATH 197,001,523477,Kedlaya; Kiran S.,9994,0,9999,5
1715632510254,MATH 197,002,563811,Zhang; Danna,9994,0,9999,5
1715632510254,MATH 197,003,628552,Dumitriu; Ioana,9998,0,9999,1
1715632510254,MATH 197,004,660885,Floyd; Eric,9998,0,9999,1
1715632511280,MCWP 40R,A00,518780,Staff,2,0,20,18
1715632511280,MCWP 40R,B00,518781,Staff,11,0,20,9
1715632511280,MCWP 40R,C00,518783,Staff,5,0,20,15
1715632512309,MCWP 50R,A00,518791,Staff,0,1,20,20
1715632512309,MCWP 50R,B00,518792,Staff,0,2,20,20
1715632512309,MCWP 50R,C00,518793,Staff,0,4,20,20
1715632512309,MCWP 50R,D00,518794,Staff,0,1,20,20
1715632512309,MCWP 50R,E00,518795,Staff,0,2,20,20
1715632512309,MCWP 50R,F00,518796,Staff,0,1,20,20
1715632512309,MCWP 50R,G00,518797,Staff,0,1,20,20
1715632513332,MMW 12R,A01,514034,Herbst; Matthew,0,2,16,16
1715632513332,MMW 12R,A02,514035,Herbst; Matthew,0,0,16,16
1715632514358,MMW 13R,A01,514037,Staff,0,5,16,16
1715632514358,MMW 13R,A02,514039,Staff,0,5,16,16
1715632514358,MMW 13R,A03,628519,Staff,0,4,16,16
1715632516409,SIO 295LS,A00,523233,Staff,10,0,30,20
1715632517434,SIO 295S,A00,523232,Staff,10,0,30,20
1715632518465,SIOC 290S,A01,637330,Merrifield; Mark A,22,0,30,8
1715632519490,SIOC 291S,A01,637333,Gabriel; Corey John,22,0,30,8
1715632520518,SOCI 117,A01,494376,Staff,0,5,5,5
1715632521546,WES 237B,A00,494380,Staff,10,0,20,10
1715632523615,AESE 279B,A00,494370,Wade; Jon P,0,0,33,33
1715632524641,AIP 97,001,660915,Van Den Einde; Yael Dahlia,9998,0,9999,1
1715632525671,AIP 197,001,627712,Vespa; Emanuel Ignacio,9995,0,9999,4
1715632525671,AIP 197,002,650778,Amir; On,9998,0,9999,1
1715632525671,AIP 197,003,650933,Avenancio-Leon; Carlos,9998,0,9999,1
1715632525671,AIP 197,004,658530,Heyman; Gail D.,9998,0,9999,1
1715632525671,AIP 197,005,658631,Neal; Sonya E,9998,0,9999,1
1715632525671,AIP 197,006,658671,Du; Songzi,9998,0,9999,1
1715632526697,ANAR 135S,A00,494369,Braswell; Geoffrey E.,0,0,0,0
1715632527722,BENG 196,001,628496,Engler; Adam J.,9998,0,9999,1
1715632527722,BENG 196,002,660916,Watson; John Thomas,9999,0,9999,0
1715632528751,BISP 197,001,650773,Wilhelm; James E.,9994,0,9999,5
1715632528751,BISP 197,002,658904,Coleman; Aaron B.,9998,0,9999,1
1715632529775,CAT 124RS,A01,519847,Geibel; William,0,0,20,20
1715632530802,CAT 125RS,A01,515971,Geibel; William,0,0,20,20
1715632531827,CLRE 250,A00,511389,Morris; Sheldon,9992,0,9999,7
1715632532854,CLRE 251,A00,507176,Mehta; Ravindra L.,9992,0,9999,7
1715632532854,CLRE 251,B00,511410,Mehta; Ravindra L.,9998,0,9999,1
1715632533881,CLRE 252,A00,507189,Cuomo; Raphael Eduardo,9994,0,9999,5
1715632534907,CLRE 253,A00,507199,Vaida; Florin,9994,0,9999,5
1715632534907,CLRE 253,B00,507202,Vaida; Florin,9999,0,9999,0
1715632535936,CLRE 259,A00,507211,Patel; Hemal,9996,0,9999,3
1715632536960,CLRE 260,A00,507221,Cuomo; Raphael Eduardo,9999,0,9999,0
1715632537985,CLRE 297,001,507242,Cuomo; Raphael Eduardo,9999,0,9999,0
1715632539011,COGS 197,001,638244,Voytek; Bradley Thomas,9997,0,9999,2
1715632540037,CSE 191,A00,516875,Minnes Kemp; Mor Mia,9991,0,9999,8
1715632541064,CSE 197,001,637388,Minnes Kemp; Mor Mia,9992,0,9999,7
1715632542097,CSS 201S,A01,494383,Mignozzetti; Umberto,35,0,35,0
1715632543122,CSS 202S,A01,494387,Mignozzetti; Umberto,35,0,35,0
1715632544147,DSC 197,001,628532,Eldridge; Justin Matthew,9995,0,9999,4
1715632545173,EAP 100,A00,516065,Staff,9799,0,9999,200
1715632546199,ECE 45,A01,507414,Staff,31,0,60,29
1715632548252,ECE 111,A01,507420,Staff,11,0,50,39
1715632549277,ECE 197,001,548057,Sievenpiper; Daniel F.,9991,0,9999,8
1715632550307,EDS 115,A00,507243,Choi; Bailey Miyeon,7,0,28,21
1715632551332,EDS 117,A01,494379,Staff,0,6,34,34
1715632552358,EDS 125,A00,507246,Hopkins; Megan Beth,8,0,30,22
1715632553387,EDS 128A,A01,507264,Fargason; Sharon Gayle,6,0,26,20
1715632554415,EDS 128B,A01,507293,Pappas; Elizabeth,10,0,30,20
1715632555439,EDS 139,A00,507294,Fargason; Sharon Gayle,10,0,30,20
1715632555439,EDS 139,B00,507313,Pappas; Elizabeth,11,0,30,19
1715632556466,EDS 201,A00,507315,Staff,10,0,30,20
1715632557492,EDS 203,A01,507317,Halter; Christopher P.,10,0,30,20
1715632558520,EDS 204R,A01,507319,Halter; Christopher P.,0,3,30,30
1715632558520,EDS 204R,B01,507331,Heinzman; Erica M.,14,0,30,16
1715632559549,EDS 206R,A00,507332,Staff,0,4,30,30
1715632559549,EDS 206R,B00,507343,Staff,15,0,30,15
1715632560572,EDS 250,A00,507344,Hemans; Patricia Ann Benitez,20,0,40,20
1715632561599,EDS 281,A00,507345,Daly; Alan J.,18,0,18,0
1715632562624,EDS 284,A00,507350,Daly; Alan J.,16,0,16,0
1715632563652,EDS 286,A00,507359,Fine; Sarah,18,0,18,0
1715632564678,EDS 289C,A01,507361,Daly; Alan J.,18,0,18,0
1715632565704,EDS 290,A00,507366,Hofstetter; Carolyn,15,0,15,0
1715632566734,LIGM 5A,A00,507421,Fischer-Grunski; Eva K,17,0,20,3
1715632567759,LIGM 5B,A00,507423,Fischer-Grunski; Eva K,19,0,20,1
1715632568787,LIGM 5C,A00,507425,Fischer-Grunski; Eva K,19,0,20,1
1715632569814,LIIT 5AS,A00,507427,Carnelos; Chiara,20,0,20,0
1715632570840,LIIT 5BS,A00,507430,Carnelos; Chiara,20,0,20,0
1715632571865,LIIT 5CS,A00,507432,Carnelos; Chiara,20,0,20,0
1715632572891,LISP 5A,A00,507541,Munoz Sanchez; Alicia,11,0,20,9
1715632573919,LISP 5B,A00,507671,Munoz Sanchez; Alicia,9,0,20,11
1715632574947,LISP 5C,A00,507696,Munoz Sanchez; Alicia,9,0,20,11
1715632575972,MAE 197,001,528363,Boechler; Nicholas Sebastia,9998,0,9999,1
1715632576997,MATH 197,001,523477,Kedlaya; Kiran S.,9994,0,9999,5
1715632576997,MATH 197,002,563811,Zhang; Danna,9994,0,9999,5
1715632576997,MATH 197,003,628552,Dumitriu; Ioana,9998,0,9999,1
1715632576997,MATH 197,004,660885,Floyd; Eric,9998,0,9999,1
1715632578024,MCWP 40R,A00,518780,Staff,2,0,20,18
1715632578024,MCWP 40R,B00,518781,Staff,11,0,20,9
1715632578024,MCWP 40R,C00,518783,Staff,5,0,20,15
1715632579107,MCWP 50R,A00,518791,Staff,0,1,20,20
1715632579107,MCWP 50R,B00,518792,Staff,0,2,20,20
1715632579107,MCWP 50R,C00,518793,Staff,0,4,20,20
1715632579107,MCWP 50R,D00,518794,Staff,0,1,20,20
1715632579107,MCWP 50R,E00,518795,Staff,0,2,20,20
1715632579107,MCWP 50R,F00,518796,Staff,0,1,20,20
1715632579107,MCWP 50R,G00,518797,Staff,0,1,20,20
1715632580133,MMW 12R,A01,514034,Herbst; Matthew,0,2,16,16
1715632580133,MMW 12R,A02,514035,Herbst; Matthew,0,0,16,16
1715632581160,MMW 13R,A01,514037,Staff,0,5,16,16
1715632581160,MMW 13R,A02,514039,Staff,0,5,16,16
1715632581160,MMW 13R,A03,628519,Staff,0,4,16,16
1715632583214,SIO 295LS,A00,523233,Staff,10,0,30,20
1715632584239,SIO 295S,A00,523232,Staff,10,0,30,20
1715632585265,SIOC 290S,A01,637330,Merrifield; Mark A,22,0,30,8
1715632586291,SIOC 291S,A01,637333,Gabriel; Corey John,22,0,30,8
1715632587317,SOCI 117,A01,494376,Staff,0,5,5,5
1715632588343,WES 237B,A00,494380,Staff,10,0,20,10
1715632590420,AESE 279B,A00,494370,Wade; Jon P,0,0,33,33
1715632591448,AIP 97,001,660915,Van Den Einde; Yael Dahlia,9998,0,9999,1
1715632592476,AIP 197,001,627712,Vespa; Emanuel Ignacio,9995,0,9999,4
1715632592476,AIP 197,002,650778,Amir; On,9998,0,9999,1
1715632592476,AIP 197,003,650933,Avenancio-Leon; Carlos,9998,0,9999,1
1715632592476,AIP 197,004,658530,Heyman; Gail D.,9998,0,9999,1
1715632592476,AIP 197,005,658631,Neal; Sonya E,9998,0,9999,1
1715632592476,AIP 197,006,658671,Du; Songzi,9998,0,9999,1
1715632593502,ANAR 135S,A00,494369,Braswell; Geoffrey E.,0,0,0,0
1715632594528,BENG 196,001,628496,Engler; Adam J.,9998,0,9999,1
1715632594528,BENG 196,002,660916,Watson; John Thomas,9999,0,9999,0
1715632595555,BISP 197,001,650773,Wilhelm; James E.,9994,0,9999,5
1715632595555,BISP 197,002,658904,Coleman; Aaron B.,9998,0,9999,1
1715632596583,CAT 124RS,A01,519847,Geibel; William,0,0,20,20
1715632597607,CAT 125RS,A01,515971,Geibel; William,0,0,20,20
1715632598633,CLRE 250,A00,511389,Morris; Sheldon,9992,0,9999,7
1715632599660,CLRE 251,A00,507176,Mehta; Ravindra L.,9992,0,9999,7
1715632599660,CLRE 251,B00,511410,Mehta; Ravindra L.,9998,0,9999,1
1715632600690,CLRE 252,A00,507189,Cuomo; Raphael Eduardo,9994,0,9999,5
1715632601715,CLRE 253,A00,507199,Vaida; Florin,9994,0,9999,5
1715632601715,CLRE 253,B00,507202,Vaida; Florin,9999,0,9999,0
1715632602740,CLRE 259,A00,507211,Patel; Hemal,9996,0,9999,3
1715632603765,CLRE 260,A00,507221,Cuomo; Raphael Eduardo,9999,0,9999,0
1715632604792,CLRE 297,001,507242,Cuomo; Raphael Eduardo,9999,0,9999,0
1715632605817,COGS 197,001,638244,Voytek; Bradley Thomas,9997,0,9999,2
1715632606842,CSE 191,A00,516875,Minnes Kemp; Mor Mia,9991,0,9999,8
1715632607870,CSE 197,001,637388,Minnes Kemp; Mor Mia,9992,0,9999,7
1715632608899,CSS 201S,A01,494383,Mignozzetti; Umberto,35,0,35,0
1715632609924,CSS 202S,A01,494387,Mignozzetti; Umberto,35,0,35,0
1715632610948,DSC 197,001,628532,Eldridge; Justin Matthew,9995,0,9999,4
1715632611974,EAP 100,A00,516065,Staff,9799,0,9999,200
1715632613002,ECE 45,A01,507414,Staff,31,0,60,29
1715632615052,ECE 111,A01,507420,Staff,11,0,50,39
1715632616077,ECE 197,001,548057,Sievenpiper; Daniel F.,9991,0,9999,8
1715632617103,EDS 115,A00,507243,Choi; Bailey Miyeon,7,0,28,21
1715632618133,EDS 117,A01,494379,Staff,0,6,34,34
1715632619160,EDS 125,A00,507246,Hopkins; Megan Beth,8,0,30,22
1715632620187,EDS 128A,A01,507264,Fargason; Sharon Gayle,6,0,26,20
1715632621214,EDS 128B,A01,507293,Pappas; Elizabeth,10,0,30,20
1715632622242,EDS 139,A00,507294,Fargason; Sharon Gayle,10,0,30,20
1715632622242,EDS 139,B00,507313,Pappas; Elizabeth,11,0,30,19
1715632623269,EDS 201,A00,507315,Staff,10,0,30,20
1715632624298,EDS 203,A01,507317,Halter; Christopher P.,10,0,30,20
1715632625322,EDS 204R,A01,507319,Halter; Christopher P.,0,3,30,30
1715632625322,EDS 204R,B01,507331,Heinzman; Erica M.,14,0,30,16
1715632626347,EDS 206R,A00,507332,Staff,0,4,30,30
1715632626347,EDS 206R,B00,507343,Staff,15,0,30,15
1715632627375,EDS 250,A00,507344,Hemans; Patricia Ann Benitez,20,0,40,20
1715632628400,EDS 281,A00,507345,Daly; Alan J.,18,0,18,0
1715632629424,EDS 284,A00,507350,Daly; Alan J.,16,0,16,0
1715632630454,EDS 286,A00,507359,Fine; Sarah,18,0,18,0
1715632631479,EDS 289C,A01,507361,Daly; Alan J.,18,0,18,0
1715632632504,EDS 290,A00,507366,Hofstetter; Carolyn,15,0,15,0
1715632633535,LIGM 5A,A00,507421,Fischer-Grunski; Eva K,17,0,20,3
1715632634563,LIGM 5B,A00,507423,Fischer-Grunski; Eva K,19,0,20,1
1715632635593,LIGM 5C,A00,507425,Fischer-Grunski; Eva K,19,0,20,1
1715632636617,LIIT 5AS,A00,507427,Carnelos; Chiara,20,0,20,0
1715632637642,LIIT 5BS,A00,507430,Carnelos; Chiara,20,0,20,0
1715632638666,LIIT 5CS,A00,507432,Carnelos; Chiara,20,0,20,0
1715632639690,LISP 5A,A00,507541,Munoz Sanchez; Alicia,11,0,20,9
1715632640716,LISP 5B,A00,507671,Munoz Sanchez; Alicia,9,0,20,11
1715632641741,LISP 5C,A00,507696,Munoz Sanchez; Alicia,9,0,20,11
1715632642765,MAE 197,001,528363,Boechler; Nicholas Sebastia,9998,0,9999,1
1715632643791,MATH 197,001,523477,Kedlaya; Kiran S.,9994,0,9999,5
1715632643791,MATH 197,002,563811,Zhang; Danna,9994,0,9999,5
1715632643791,MATH 197,003,628552,Dumitriu; Ioana,9998,0,9999,1
1715632643791,MATH 197,004,660885,Floyd; Eric,9998,0,9999,1
1715632644814,MCWP 40R,A00,518780,Staff,2,0,20,18
1715632644814,MCWP 40R,B00,518781,Staff,11,0,20,9
1715632644814,MCWP 40R,C00,518783,Staff,5,0,20,15
1715632645839,MCWP 50R,A00,518791,Staff,0,1,20,20
1715632645839,MCWP 50R,B00,518792,Staff,0,2,20,20
1715632645839,MCWP 50R,C00,518793,Staff,0,4,20,20
1715632645839,MCWP 50R,D00,518794,Staff,0,1,20,20
1715632645839,MCWP 50R,E00,518795,Staff,0,2,20,20
1715632645839,MCWP 50R,F00,518796,Staff,0,1,20,20
1715632645839,MCWP 50R,G00,518797,Staff,0,1,20,20
1715632646868,MMW 12R,A01,514034,Herbst; Matthew,0,2,16,16
1715632646868,MMW 12R,A02,514035,Herbst; Matthew,0,0,16,16
1715632647896,MMW 13R,A01,514037,Staff,0,5,16,16
1715632647896,MMW 13R,A02,514039,Staff,0,5,16,16
1715632647896,MMW 13R,A03,628519,Staff,0,4,16,16
1715632649955,SIO 295LS,A00,523233,Staff,10,0,30,20
1715632650979,SIO 295S,A00,523232,Staff,10,0,30,20
1715632652005,SIOC 290S,A01,637330,Merrifield; Mark A,22,0,30,8
1715632653031,SIOC 291S,A01,637333,Gabriel; Corey John,22,0,30,8
1715632654057,SOCI 117,A01,494376,Staff,0,5,5,5
1715632655091,WES 237B,A00,494380,Staff,10,0,20,10
1715632657179,AESE 279B,A00,494370,Wade; Jon P,0,0,33,33
1715632658203,AIP 97,001,660915,Van Den Einde; Yael Dahlia,9998,0,9999,1
1715632659232,AIP 197,001,627712,Vespa; Emanuel Ignacio,9995,0,9999,4
1715632659232,AIP 197,002,650778,Amir; On,9998,0,9999,1
1715632659232,AIP 197,003,650933,Avenancio-Leon; Carlos,9998,0,9999,1
1715632659232,AIP 197,004,658530,Heyman; Gail D.,9998,0,9999,1
1715632659232,AIP 197,005,658631,Neal; Sonya E,9998,0,9999,1
1715632659232,AIP 197,006,658671,Du; Songzi,9998,0,9999,1
1715632660256,ANAR 135S,A00,494369,Braswell; Geoffrey E.,0,0,0,0
1715632661285,BENG 196,001,628496,Engler; Adam J.,9998,0,9999,1
1715632661285,BENG 196,002,660916,Watson; John Thomas,9999,0,9999,0
1715632662312,BISP 197,001,650773,Wilhelm; James E.,9994,0,9999,5
1715632662312,BISP 197,002,658904,Coleman; Aaron B.,9998,0,9999,1
1715632663338,CAT 124RS,A01,519847,Geibel; William,0,0,20,20
1715632664364,CAT 125RS,A01,515971,Geibel; William,0,0,20,20
1715632665392,CLRE 250,A00,511389,Morris; Sheldon,9992,0,9999,7
1715632666417,CLRE 251,A00,507176,Mehta; Ravindra L.,9992,0,9999,7
1715632666417,CLRE 251,B00,511410,Mehta; Ravindra L.,9998,0,9999,1
1715632667442,CLRE 252,A00,507189,Cuomo; Raphael Eduardo,9994,0,9999,5
1715632668468,CLRE 253,A00,507199,Vaida; Florin,9994,0,9999,5
1715632668468,CLRE 253,B00,507202,Vaida; Florin,9999,0,9999,0
1715632669491,CLRE 259,A00,507211,Patel; Hemal,9996,0,9999,3
1715632670516,CLRE 260,A00,507221,Cuomo; Raphael Eduardo,9999,0,9999,0
1715632671541,CLRE 297,001,507242,Cuomo; Raphael Eduardo,9999,0,9999,0
1715632672566,COGS 197,001,638244,Voytek; Bradley Thomas,9997,0,9999,2
1715632673595,CSE 191,A00,516875,Minnes Kemp; Mor Mia,9991,0,9999,8
1715632674619,CSE 197,001,637388,Minnes Kemp; Mor Mia,9992,0,9999,7
1715632675646,CSS 201S,A01,494383,Mignozzetti; Umberto,35,0,35,0
1715632676674,CSS 202S,A01,494387,Mignozzetti; Umberto,35,0,35,0
1715632677701,DSC 197,001,628532,Eldridge; Justin Matthew,9995,0,9999,4
1715632678726,EAP 100,A00,516065,Staff,9799,0,9999,200
1715632679754,ECE 45,A01,507414,Staff,31,0,60,29
1715632681806,ECE 111,A01,507420,Staff,11,0,50,39
1715632682886,ECE 197,001,548057,Sievenpiper; Daniel F.,9991,0,9999,8
1715632683916,EDS 115,A00,507243,Choi; Bailey Miyeon,7,0,28,21
1715632684945,EDS 117,A01,494379,Staff,0,6,34,34
1715632685971,EDS 125,A00,507246,Hopkins; Megan Beth,8,0,30,22
1715632687002,EDS 128A,A01,507264,Fargason; Sharon Gayle,6,0,26,20
1715632688026,EDS 128B,A01,507293,Pappas; Elizabeth,10,0,30,20
1715632689054,EDS 139,A00,507294,Fargason; Sharon Gayle,10,0,30,20
1715632689054,EDS 139,B00,507313,Pappas; Elizabeth,11,0,30,19
1715632690081,EDS 201,A00,507315,Staff,10,0,30,20
1715632691106,EDS 203,A01,507317,Halter; Christopher P.,10,0,30,20
1715632692133,EDS 204R,A01,507319,Halter; Christopher P.,0,3,30,30
1715632692133,EDS 204R,B01,507331,Heinzman; Erica M.,14,0,30,16
1715632693158,EDS 206R,A00,507332,Staff,0,4,30,30
1715632693158,EDS 206R,B00,507343,Staff,15,0,30,15
1715632694186,EDS 250,A00,507344,Hemans; Patricia Ann Benitez,20,0,40,20
1715632695212,EDS 281,A00,507345,Daly; Alan J.,18,0,18,0
1715632696237,EDS 284,A00,507350,Daly; Alan J.,16,0,16,0
1715632697261,EDS 286,A00,507359,Fine; Sarah,18,0,18,0
1715632698286,EDS 289C,A01,507361,Daly; Alan J.,18,0,18,0
1715632699311,EDS 290,A00,507366,Hofstetter; Carolyn,15,0,15,0
1715632700338,LIGM 5A,A00,507421,Fischer-Grunski; Eva K,17,0,20,3
1715632701363,LIGM 5B,A00,507423,Fischer-Grunski; Eva K,19,0,20,1
1715632702390,LIGM 5C,A00,507425,Fischer-Grunski; Eva K,19,0,20,1
1715632703417,LIIT 5AS,A00,507427,Carnelos; Chiara,20,0,20,0
1715632704442,LIIT 5BS,A00,507430,Carnelos; Chiara,20,0,20,0
1715632705470,LIIT 5CS,A00,507432,Carnelos; Chiara,20,0,20,0
1715632706496,LISP 5A,A00,507541,Munoz Sanchez; Alicia,11,0,20,9
1715632707525,LISP 5B,A00,507671,Munoz Sanchez; Alicia,9,0,20,11
1715632708562,LISP 5C,A00,507696,Munoz Sanchez; Alicia,9,0,20,11
1715632709588,MAE 197,001,528363,Boechler; Nicholas Sebastia,9998,0,9999,1
1715632710615,MATH 197,001,523477,Kedlaya; Kiran S.,9994,0,9999,5
1715632710615,MATH 197,002,563811,Zhang; Danna,9994,0,9999,5
1715632710615,MATH 197,003,628552,Dumitriu; Ioana,9998,0,9999,1
1715632710615,MATH 197,004,660885,Floyd; Eric,9998,0,9999,1
1715632711646,MCWP 40R,A00,518780,Staff,2,0,20,18
1715632711646,MCWP 40R,B00,518781,Staff,11,0,20,9
1715632711646,MCWP 40R,C00,518783,Staff,5,0,20,15
1715632712674,MCWP 50R,A00,518791,Staff,0,1,20,20
1715632712674,MCWP 50R,B00,518792,Staff,0,2,20,20
1715632712674,MCWP 50R,C00,518793,Staff,0,4,20,20
1715632712674,MCWP 50R,D00,518794,Staff,0,1,20,20
1715632712674,MCWP 50R,E00,518795,Staff,0,2,20,20
1715632712674,MCWP 50R,F00,518796,Staff,0,1,20,20
1715632712674,MCWP 50R,G00,518797,Staff,0,1,20,20
1715632713703,MMW 12R,A01,514034,Herbst; Matthew,0,2,16,16
1715632713703,MMW 12R,A02,514035,Herbst; Matthew,0,0,16,16
1715632714728,MMW 13R,A01,514037,Staff,0,5,16,16
1715632714728,MMW 13R,A02,514039,Staff,0,5,16,16
1715632714728,MMW 13R,A03,628519,Staff,0,4,16,16
1715632716779,SIO 295LS,A00,523233,Staff,10,0,30,20
1715632717805,SIO 295S,A00,523232,Staff,10,0,30,20
1715632718830,SIOC 290S,A01,637330,Merrifield; Mark A,22,0,30,8
1715632719861,SIOC 291S,A01,637333,Gabriel; Corey John,22,0,30,8
1715632720889,SOCI 117,A01,494376,Staff,0,5,5,5
1715632721917,WES 237B,A00,494380,Staff,10,0,20,10
1715632723999,AESE 279B,A00,494370,Wade; Jon P,0,0,33,33
1715632725029,AIP 97,001,660915,Van Den Einde; Yael Dahlia,9998,0,9999,1
1715632726064,AIP 197,001,627712,Vespa; Emanuel Ignacio,9995,0,9999,4
1715632726064,AIP 197,002,650778,Amir; On,9998,0,9999,1
1715632726064,AIP 197,003,650933,Avenancio-Leon; Carlos,9998,0,9999,1
1715632726064,AIP 197,004,658530,Heyman; Gail D.,9998,0,9999,1
1715632726064,AIP 197,005,658631,Neal; Sonya E,9998,0,9999,1
1715632726064,AIP 197,006,658671,Du; Songzi,9998,0,9999,1
1715632727094,ANAR 135S,A00,494369,Braswell; Geoffrey E.,0,0,0,0
1715632728119,BENG 196,001,628496,Engler; Adam J.,9998,0,9999,1
1715632728119,BENG 196,002,660916,Watson; John Thomas,9999,0,9999,0
1715632729146,BISP 197,001,650773,Wilhelm; James E.,9994,0,9999,5
1715632729146,BISP 197,002,658904,Coleman; Aaron B.,9998,0,9999,1
1715632730175,CAT 124RS,A01,519847,Geibel; William,0,0,20,20
1715632731201,CAT 125RS,A01,515971,Geibel; William,0,0,20,20
1715632732230,CLRE 250,A00,511389,Morris; Sheldon,9992,0,9999,7
1715632733258,CLRE 251,A00,507176,Mehta; Ravindra L.,9992,0,9999,7
1715632733258,CLRE 251,B00,511410,Mehta; Ravindra L.,9998,0,9999,1
1715632734288,CLRE 252,A00,507189,Cuomo; Raphael Eduardo,9994,0,9999,5
1715632735318,CLRE 253,A00,507199,Vaida; Florin,9994,0,9999,5
1715632735318,CLRE 253,B00,507202,Vaida; Florin,9999,0,9999,0
1715632736342,CLRE 259,A00,507211,Patel; Hemal,9996,0,9999,3
1715632737367,CLRE 260,A00,507221,Cuomo; Raphael Eduardo,9999,0,9999,0
1715632738395,CLRE 297,001,507242,Cuomo; Raphael Eduardo,9999,0,9999,0
1715632739420,COGS 197,001,638244,Voytek; Bradley Thomas,9997,0,9999,2
1715632740447,CSE 191,A00,516875,Minnes Kemp; Mor Mia,9991,0,9999,8
1715632741482,CSE 197,001,637388,Minnes Kemp; Mor Mia,9992,0,9999,7
1715632742508,CSS 201S,A01,494383,Mignozzetti; Umberto,35,0,35,0
1715632743540,CSS 202S,A01,494387,Mignozzetti; Umberto,35,0,35,0
1715632744565,DSC 197,001,628532,Eldridge; Justin Matthew,9995,0,9999,4
1715632745591,EAP 100,A00,516065,Staff,9799,0,9999,200
1715632746618,ECE 45,A01,507414,Staff,31,0,60,29
1715632748674,ECE 111,A01,507420,Staff,11,0,50,39
1715632749709,ECE 197,001,548057,Sievenpiper; Daniel F.,9991,0,9999,8
1715632750735,EDS 115,A00,507243,Choi; Bailey Miyeon,7,0,28,21
1715632751762,EDS 117,A01,494379,Staff,0,6,34,34
1715632752788,EDS 125,A00,507246,Hopkins; Megan Beth,8,0,30,22
1715632753813,EDS 128A,A01,507264,Fargason; Sharon Gayle,6,0,26,20
1715632754842,EDS 128B,A01,507293,Pappas; Elizabeth,10,0,30,20
1715632755870,EDS 139,A00,507294,Fargason; Sharon Gayle,10,0,30,20
1715632755870,EDS 139,B00,507313,Pappas; Elizabeth,11,0,30,19
1715632756898,EDS 201,A00,507315,Staff,10,0,30,20
1715632757926,EDS 203,A01,507317,Halter; Christopher P.,10,0,30,20
1715632758952,EDS 204R,A01,507319,Halter; Christopher P.,0,3,30,30
1715632758952,EDS 204R,B01,507331,Heinzman; Erica M.,14,0,30,16
1715632759979,EDS 206R,A00,507332,Staff,0,4,30,30
1715632759979,EDS 206R,B00,507343,Staff,15,0,30,15
1715632761008,EDS 250,A00,507344,Hemans; Patricia Ann Benitez,20,0,40,20
1715632762037,EDS 281,A00,507345,Daly; Alan J.,18,0,18,0
1715632763062,EDS 284,A00,507350,Daly; Alan J.,16,0,16,0
1715632764088,EDS 286,A00,507359,Fine; Sarah,18,0,18,0
1715632765115,EDS 289C,A01,507361,Daly; Alan J.,18,0,18,0
1715632766144,EDS 290,A00,507366,Hofstetter; Carolyn,15,0,15,0
1715632767171,LIGM 5A,A00,507421,Fischer-Grunski; Eva K,17,0,20,3
1715632768195,LIGM 5B,A00,507423,Fischer-Grunski; Eva K,19,0,20,1
1715632769221,LIGM 5C,A00,507425,Fischer-Grunski; Eva K,19,0,20,1
1715632770247,LIIT 5AS,A00,507427,Carnelos; Chiara,20,0,20,0
1715632771276,LIIT 5BS,A00,507430,Carnelos; Chiara,20,0,20,0
1715632772301,LIIT 5CS,A00,507432,Carnelos; Chiara,20,0,20,0
1715632773327,LISP 5A,A00,507541,Munoz Sanchez; Alicia,11,0,20,9
1715632774356,LISP 5B,A00,507671,Munoz Sanchez; Alicia,9,0,20,11
1715632775382,LISP 5C,A00,507696,Munoz Sanchez; Alicia,9,0,20,11
1715632776410,MAE 197,001,528363,Boechler; Nicholas Sebastia,9998,0,9999,1
1715632777440,MATH 197,001,523477,Kedlaya; Kiran S.,9994,0,9999,5
1715632777440,MATH 197,002,563811,Zhang; Danna,9994,0,9999,5
1715632777440,MATH 197,003,628552,Dumitriu; Ioana,9998,0,9999,1
1715632777440,MATH 197,004,660885,Floyd; Eric,9998,0,9999,1
1715632778467,MCWP 40R,A00,518780,Staff,2,0,20,18
1715632778467,MCWP 40R,B00,518781,Staff,11,0,20,9
1715632778467,MCWP 40R,C00,518783,Staff,5,0,20,15
1715632779495,MCWP 50R,A00,518791,Staff,0,1,20,20
1715632779495,MCWP 50R,B00,518792,Staff,0,2,20,20
1715632779495,MCWP 50R,C00,518793,Staff,0,4,20,20
1715632779495,MCWP 50R,D00,518794,Staff,0,1,20,20
1715632779495,MCWP 50R,E00,518795,Staff,0,2,20,20
1715632779495,MCWP 50R,F00,518796,Staff,0,1,20,20
1715632779495,MCWP 50R,G00,518797,Staff,0,1,20,20
1715632780520,MMW 12R,A01,514034,Herbst; Matthew,0,2,16,16
1715632780520,MMW 12R,A02,514035,Herbst; Matthew,0,0,16,16
1715632781545,MMW 13R,A01,514037,Staff,0,5,16,16
1715632781545,MMW 13R,A02,514039,Staff,0,5,16,16
1715632781545,MMW 13R,A03,628519,Staff,0,4,16,16
1715632783600,SIO 295LS,A00,523233,Staff,10,0,30,20
1715632784629,SIO 295S,A00,523232,Staff,10,0,30,20
1715632785655,SIOC 290S,A01,637330,Merrifield; Mark A,22,0,30,8
1715632786738,SIOC 291S,A01,637333,Gabriel; Corey John,22,0,30,8
1715632787767,SOCI 117,A01,494376,Staff,0,5,5,5
1715632788797,WES 237B,A00,494380,Staff,10,0,20,10
1715632790868,AESE 279B,A00,494370,Wade; Jon P,0,0,33,33
1715632791895,AIP 97,001,660915,Van Den Einde; Yael Dahlia,9998,0,9999,1
1715632792930,AIP 197,001,627712,Vespa; Emanuel Ignacio,9995,0,9999,4
1715632792930,AIP 197,002,650778,Amir; On,9998,0,9999,1
1715632792930,AIP 197,003,650933,Avenancio-Leon; Carlos,9998,0,9999,1
1715632792930,AIP 197,004,658530,Heyman; Gail D.,9998,0,9999,1
1715632792930,AIP 197,005,658631,Neal; Sonya E,9998,0,9999,1
1715632792930,AIP 197,006,658671,Du; Songzi,9998,0,9999,1
1715632793960,ANAR 135S,A00,494369,Braswell; Geoffrey E.,0,0,0,0
1715632794987,BENG 196,001,628496,Engler; Adam J.,9998,0,9999,1
1715632794987,BENG 196,002,660916,Watson; John Thomas,9999,0,9999,0
1715632796012,BISP 197,001,650773,Wilhelm; James E.,9994,0,9999,5
1715632796012,BISP 197,002,658904,Coleman; Aaron B.,9998,0,9999,1
1715632797038,CAT 124RS,A01,519847,Geibel; William,0,0,20,20
1715632798063,CAT 125RS,A01,515971,Geibel; William,0,0,20,20
1715632799090,CLRE 250,A00,511389,Morris; Sheldon,9992,0,9999,7
1715632800122,CLRE 251,A00,507176,Mehta; Ravindra L.,9992,0,9999,7
1715632800122,CLRE 251,B00,511410,Mehta; Ravindra L.,9998,0,9999,1
1715632801148,CLRE 252,A00,507189,Cuomo; Raphael Eduardo,9994,0,9999,5
1715632802178,CLRE 253,A00,507199,Vaida; Florin,9994,0,9999,5
1715632802178,CLRE 253,B00,507202,Vaida; Florin,9999,0,9999,0
1715632803204,CLRE 259,A00,507211,Patel; Hemal,9996,0,9999,3
1715632804233,CLRE 260,A00,507221,Cuomo; Raphael Eduardo,9999,0,9999,0
1715632805258,CLRE 297,001,507242,Cuomo; Raphael Eduardo,9999,0,9999,0
1715632806288,COGS 197,001,638244,Voytek; Bradley Thomas,9997,0,9999,2
1715632807317,CSE 191,A00,516875,Minnes Kemp; Mor Mia,9991,0,9999,8
1715632808343,CSE 197,001,637388,Minnes Kemp; Mor Mia,9992,0,9999,7
1715632809372,CSS 201S,A01,494383,Mignozzetti; Umberto,35,0,35,0
1715632810402,CSS 202S,A01,494387,Mignozzetti; Umberto,35,0,35,0
1715632811427,DSC 197,001,628532,Eldridge; Justin Matthew,9995,0,9999,4
1715632812454,EAP 100,A00,516065,Staff,9799,0,9999,200
1715632813486,ECE 45,A01,507414,Staff,31,0,60,29
1715632826927,ECE 111,A01,507420,Staff,11,0,50,39
1715632827957,ECE 197,001,548057,Sievenpiper; Daniel F.,9991,0,9999,8
1715632828984,EDS 115,A00,507243,Choi; Bailey Miyeon,7,0,28,21
1715632830015,EDS 117,A01,494379,Staff,0,6,34,34
1715632831044,EDS 125,A00,507246,Hopkins; Megan Beth,8,0,30,22
1715632832075,EDS 128A,A01,507264,Fargason; Sharon Gayle,6,0,26,20
1715632833103,EDS 128B,A01,507293,Pappas; Elizabeth,10,0,30,20
1715632834131,EDS 139,A00,507294,Fargason; Sharon Gayle,10,0,30,20
1715632834131,EDS 139,B00,507313,Pappas; Elizabeth,11,0,30,19
1715632835159,EDS 201,A00,507315,Staff,10,0,30,20
1715632836190,EDS 203,A01,507317,Halter; Christopher P.,10,0,30,20
1715632837218,EDS 204R,A01,507319,Halter; Christopher P.,0,3,30,30
1715632837218,EDS 204R,B01,507331,Heinzman; Erica M.,14,0,30,16
1715632838240,EDS 206R,A00,507332,Staff,0,4,30,30
1715632838240,EDS 206R,B00,507343,Staff,15,0,30,15
1715632839264,EDS 250,A00,507344,Hemans; Patricia Ann Benitez,20,0,40,20
1715632840288,EDS 281,A00,507345,Daly; Alan J.,18,0,18,0
1715632841314,EDS 284,A00,507350,Daly; Alan J.,16,0,16,0
1715632842341,EDS 286,A00,507359,Fine; Sarah,18,0,18,0
1715632843369,EDS 289C,A01,507361,Daly; Alan J.,18,0,18,0
1715632844393,EDS 290,A00,507366,Hofstetter; Carolyn,15,0,15,0
1715632845420,LIGM 5A,A00,507421,Fischer-Grunski; Eva K,17,0,20,3
1715632846447,LIGM 5B,A00,507423,Fischer-Grunski; Eva K,19,0,20,1
1715632847473,LIGM 5C,A00,507425,Fischer-Grunski; Eva K,19,0,20,1
1715632848504,LIIT 5AS,A00,507427,Carnelos; Chiara,20,0,20,0
1715632849532,LIIT 5BS,A00,507430,Carnelos; Chiara,20,0,20,0
1715632850557,LIIT 5CS,A00,507432,Carnelos; Chiara,20,0,20,0
1715632851583,LISP 5A,A00,507541,Munoz Sanchez; Alicia,11,0,20,9
1715632852609,LISP 5B,A00,507671,Munoz Sanchez; Alicia,9,0,20,11
1715632853637,LISP 5C,A00,507696,Munoz Sanchez; Alicia,9,0,20,11
1715632854664,MAE 197,001,528363,Boechler; Nicholas Sebastia,9998,0,9999,1
1715632855693,MATH 197,001,523477,Kedlaya; Kiran S.,9994,0,9999,5
1715632855693,MATH 197,002,563811,Zhang; Danna,9994,0,9999,5
1715632855693,MATH 197,003,628552,Dumitriu; Ioana,9998,0,9999,1
1715632855693,MATH 197,004,660885,Floyd; Eric,9998,0,9999,1
1715632856721,MCWP 40R,A00,518780,Staff,2,0,20,18
1715632856721,MCWP 40R,B00,518781,Staff,11,0,20,9
1715632856721,MCWP 40R,C00,518783,Staff,5,0,20,15
1715632857750,MCWP 50R,A00,518791,Staff,0,1,20,20
1715632857750,MCWP 50R,B00,518792,Staff,0,2,20,20
1715632857750,MCWP 50R,C00,518793,Staff,0,4,20,20
1715632857750,MCWP 50R,D00,518794,Staff,0,1,20,20
1715632857750,MCWP 50R,E00,518795,Staff,0,2,20,20
1715632857750,MCWP 50R,F00,518796,Staff,0,1,20,20
1715632857750,MCWP 50R,G00,518797,Staff,0,1,20,20
1715632858775,MMW 12R,A01,514034,Herbst; Matthew,0,2,16,16
1715632858775,MMW 12R,A02,514035,Herbst; Matthew,0,0,16,16
1715632859804,MMW 13R,A01,514037,Staff,0,5,16,16
1715632859804,MMW 13R,A02,514039,Staff,0,5,16,16
1715632859804,MMW 13R,A03,628519,Staff,0,4,16,16
1715632861857,SIO 295LS,A00,523233,Staff,10,0,30,20
1715632862884,SIO 295S,A00,523232,Staff,10,0,30,20
1715632863915,SIOC 290S,A01,637330,Merrifield; Mark A,22,0,30,8
1715632864940,SIOC 291S,A01,637333,Gabriel; Corey John,22,0,30,8
1715632865969,SOCI 117,A01,494376,Staff,0,5,5,5
1715632866994,WES 237B,A00,494380,Staff,10,0,20,10
1715632869051,AESE 279B,A00,494370,Wade; Jon P,0,0,33,33
1715632870078,AIP 97,001,660915,Van Den Einde; Yael Dahlia,9998,0,9999,1
1715632871108,AIP 197,001,627712,Vespa; Emanuel Ignacio,9995,0,9999,4
1715632871108,AIP 197,002,650778,Amir; On,9998,0,9999,1
1715632871108,AIP 197,003,650933,Avenancio-Leon; Carlos,9998,0,9999,1
1715632871108,AIP 197,004,658530,Heyman; Gail D.,9998,0,9999,1
1715632871108,AIP 197,005,658631,Neal; Sonya E,9998,0,9999,1
1715632871108,AIP 197,006,658671,Du; Songzi,9998,0,9999,1
1715632872135,ANAR 135S,A00,494369,Braswell; Geoffrey E.,0,0,0,0
1715632873162,BENG 196,001,628496,Engler; Adam J.,9998,0,9999,1
1715632873162,BENG 196,002,660916,Watson; John Thomas,9999,0,9999,0
1715632874194,BISP 197,001,650773,Wilhelm; James E.,9994,0,9999,5
1715632874194,BISP 197,002,658904,Coleman; Aaron B.,9998,0,9999,1
1715632875222,CAT 124RS,A01,519847,Geibel; William,0,0,20,20
1715632876249,CAT 125RS,A01,515971,Geibel; William,0,0,20,20
1715632877273,CLRE 250,A00,511389,Morris; Sheldon,9992,0,9999,7
1715632878304,CLRE 251,A00,507176,Mehta; Ravindra L.,9992,0,9999,7
1715632878304,CLRE 251,B00,511410,Mehta; Ravindra L.,9998,0,9999,1
1715632879328,CLRE 252,A00,507189,Cuomo; Raphael Eduardo,9994,0,9999,5
1715632880356,CLRE 253,A00,507199,Vaida; Florin,9994,0,9999,5
1715632880356,CLRE 253,B00,507202,Vaida; Florin,9999,0,9999,0
1715632881380,CLRE 259,A00,507211,Patel; Hemal,9996,0,9999,3
1715632882404,CLRE 260,A00,507221,Cuomo; Raphael Eduardo,9999,0,9999,0
1715632883430,CLRE 297,001,507242,Cuomo; Raphael Eduardo,9999,0,9999,0
1715632884456,COGS 197,001,638244,Voytek; Bradley Thomas,9997,0,9999,2
1715632885483,CSE 191,A00,516875,Minnes Kemp; Mor Mia,9991,0,9999,8
1715632886509,CSE 197,001,637388,Minnes Kemp; Mor Mia,9992,0,9999,7
1715632887538,CSS 201S,A01,494383,Mignozzetti; Umberto,35,0,35,0
1715632888565,CSS 202S,A01,494387,Mignozzetti; Umberto,35,0,35,0
1715632889597,DSC 197,001,628532,Eldridge; Justin Matthew,9995,0,9999,4
1715632890621,EAP 100,A00,516065,Staff,9799,0,9999,200
1715632891654,ECE 45,A01,507414,Staff,31,0,60,29
1715632893709,ECE 111,A01,507420,Staff,11,0,50,39
1715632894734,ECE 197,001,548057,Sievenpiper; Daniel F.,9991,0,9999,8
1715632895760,EDS 115,A00,507243,Choi; Bailey Miyeon,7,0,28,21
1715632896786,EDS 117,A01,494379,Staff,0,6,34,34
1715632897811,EDS 125,A00,507246,Hopkins; Megan Beth,8,0,30,22
1715632898838,EDS 128A,A01,507264,Fargason; Sharon Gayle,6,0,26,20
1715632899873,EDS 128B,A01,507293,Pappas; Elizabeth,10,0,30,20
1715632900918,EDS 139,A00,507294,Fargason; Sharon Gayle,10,0,30,20
1715632900918,EDS 139,B00,507313,Pappas; Elizabeth,11,0,30,19
1715632901940,EDS 201,A00,507315,Staff,10,0,30,20
1715632902974,EDS 203,A01,507317,Halter; Christopher P.,10,0,30,20
1715632904000,EDS 204R,A01,507319,Halter; Christopher P.,0,3,30,30
1715632904000,EDS 204R,B01,507331,Heinzman; Erica M.,14,0,30,16
1715632905025,EDS 206R,A00,507332,Staff,0,4,30,30
1715632905025,EDS 206R,B00,507343,Staff,15,0,30,15
1715632906052,EDS 250,A00,507344,Hemans; Patricia Ann Benitez,20,0,40,20
1715632907079,EDS 281,A00,507345,Daly; Alan J.,18,0,18,0
1715632908105,EDS 284,A00,507350,Daly; Alan J.,16,0,16,0
1715632909134,EDS 286,A00,507359,Fine; Sarah,18,0,18,0
1715632910157,EDS 289C,A01,507361,Daly; Alan J.,18,0,18,0
1715632911185,EDS 290,A00,507366,Hofstetter; Carolyn,15,0,15,0
1715632912334,LIGM 5A,A00,507421,Fischer-Grunski; Eva K,17,0,20,3
1715632913361,LIGM 5B,A00,507423,Fischer-Grunski; Eva K,19,0,20,1
1715632914386,LIGM 5C,A00,507425,Fischer-Grunski; Eva K,19,0,20,1
1715632915414,LIIT 5AS,A00,507427,Carnelos; Chiara,20,0,20,0
1715632916440,LIIT 5BS,A00,507430,Carnelos; Chiara,20,0,20,0
1715632917470,LIIT 5CS,A00,507432,Carnelos; Chiara,20,0,20,0
1715632918496,LISP 5A,A00,507541,Munoz Sanchez; Alicia,11,0,20,9
1715632919524,LISP 5B,A00,507671,Munoz Sanchez; Alicia,9,0,20,11
1715632920550,LISP 5C,A00,507696,Munoz Sanchez; Alicia,9,0,20,11
1715632921578,MAE 197,001,528363,Boechler; Nicholas Sebastia,9998,0,9999,1
1715632922607,MATH 197,001,523477,Kedlaya; Kiran S.,9994,0,9999,5
1715632922607,MATH 197,002,563811,Zhang; Danna,9994,0,9999,5
1715632922607,MATH 197,003,628552,Dumitriu; Ioana,9998,0,9999,1
1715632922607,MATH 197,004,660885,Floyd; Eric,9998,0,9999,1
1715632923638,MCWP 40R,A00,518780,Staff,2,0,20,18
1715632923638,MCWP 40R,B00,518781,Staff,11,0,20,9
1715632923638,MCWP 40R,C00,518783,Staff,5,0,20,15
1715632924666,MCWP 50R,A00,518791,Staff,0,1,20,20
1715632924666,MCWP 50R,B00,518792,Staff,0,2,20,20
1715632924666,MCWP 50R,C00,518793,Staff,0,4,20,20
1715632924666,MCWP 50R,D00,518794,Staff,0,1,20,20
1715632924666,MCWP 50R,E00,518795,Staff,0,2,20,20
1715632924666,MCWP 50R,F00,518796,Staff,0,1,20,20
1715632924666,MCWP 50R,G00,518797,Staff,0,1,20,20
1715632925691,MMW 12R,A01,514034,Herbst; Matthew,0,2,16,16
1715632925691,MMW 12R,A02,514035,Herbst; Matthew,0,0,16,16
1715632926717,MMW 13R,A01,514037,Staff,0,5,16,16
1715632926717,MMW 13R,A02,514039,Staff,0,5,16,16
1715632926717,MMW 13R,A03,628519,Staff,0,4,16,16
1715632928774,SIO 295LS,A00,523233,Staff,10,0,30,20
1715632929803,SIO 295S,A00,523232,Staff,10,0,30,20
1715632930835,SIOC 290S,A01,637330,Merrifield; Mark A,22,0,30,8
1715632931866,SIOC 291S,A01,637333,Gabriel; Corey John,21,0,30,9
1715632932890,SOCI 117,A01,494376,Staff,0,5,5,5
1715632933913,WES 237B,A00,494380,Staff,10,0,20,10
1715632935978,AESE 279B,A00,494370,Wade; Jon P,0,0,33,33
1715632937006,AIP 97,001,660915,Van Den Einde; Yael Dahlia,9998,0,9999,1
1715632938036,AIP 197,001,627712,Vespa; Emanuel Ignacio,9995,0,9999,4
1715632938036,AIP 197,002,650778,Amir; On,9998,0,9999,1
1715632938036,AIP 197,003,650933,Avenancio-Leon; Carlos,9998,0,9999,1
1715632938036,AIP 197,004,658530,Heyman; Gail D.,9998,0,9999,1
1715632938036,AIP 197,005,658631,Neal; Sonya E,9998,0,9999,1
1715632938036,AIP 197,006,658671,Du; Songzi,9998,0,9999,1
1715632939060,ANAR 135S,A00,494369,Braswell; Geoffrey E.,0,0,0,0
1715632940086,BENG 196,001,628496,Engler; Adam J.,9998,0,9999,1
1715632940086,BENG 196,002,660916,Watson; John Thomas,9999,0,9999,0
1715632941111,BISP 197,001,650773,Wilhelm; James E.,9994,0,9999,5
1715632941111,BISP 197,002,658904,Coleman; Aaron B.,9998,0,9999,1
1715632942135,CAT 124RS,A01,519847,Geibel; William,0,0,20,20
1715632943161,CAT 125RS,A01,515971,Geibel; William,0,0,20,20
1715632944186,CLRE 250,A00,511389,Morris; Sheldon,9992,0,9999,7
1715632945215,CLRE 251,A00,507176,Mehta; Ravindra L.,9992,0,9999,7
1715632945215,CLRE 251,B00,511410,Mehta; Ravindra L.,9998,0,9999,1
1715632946241,CLRE 252,A00,507189,Cuomo; Raphael Eduardo,9994,0,9999,5
1715632947271,CLRE 253,A00,507199,Vaida; Florin,9994,0,9999,5
1715632947271,CLRE 253,B00,507202,Vaida; Florin,9999,0,9999,0
1715632948298,CLRE 259,A00,507211,Patel; Hemal,9996,0,9999,3
1715632949323,CLRE 260,A00,507221,Cuomo; Raphael Eduardo,9999,0,9999,0
1715632950352,CLRE 297,001,507242,Cuomo; Raphael Eduardo,9999,0,9999,0
1715632951376,COGS 197,001,638244,Voytek; Bradley Thomas,9997,0,9999,2
1715632952401,CSE 191,A00,516875,Minnes Kemp; Mor Mia,9991,0,9999,8
1715632953429,CSE 197,001,637388,Minnes Kemp; Mor Mia,9992,0,9999,7
1715632954458,CSS 201S,A01,494383,Mignozzetti; Umberto,35,0,35,0
1715632955487,CSS 202S,A01,494387,Mignozzetti; Umberto,35,0,35,0
1715632956512,DSC 197,001,628532,Eldridge; Justin Matthew,9995,0,9999,4
1715632957538,EAP 100,A00,516065,Staff,9799,0,9999,200
1715632958568,ECE 45,A01,507414,Staff,31,0,60,29
1715632960622,ECE 111,A01,507420,Staff,11,0,50,39
1715632961651,ECE 197,001,548057,Sievenpiper; Daniel F.,9991,0,9999,8
1715632962678,EDS 115,A00,507243,Choi; Bailey Miyeon,7,0,28,21
1715632963707,EDS 117,A01,494379,Staff,0,6,34,34
1715632964733,EDS 125,A00,507246,Hopkins; Megan Beth,8,0,30,22
1715632965761,EDS 128A,A01,507264,Fargason; Sharon Gayle,6,0,26,20
1715632966788,EDS 128B,A01,507293,Pappas; Elizabeth,10,0,30,20
1715632967814,EDS 139,A00,507294,Fargason; Sharon Gayle,10,0,30,20
1715632967814,EDS 139,B00,507313,Pappas; Elizabeth,11,0,30,19
1715632968841,EDS 201,A00,507315,Staff,10,0,30,20
1715632969868,EDS 203,A01,507317,Halter; Christopher P.,10,0,30,20
1715632970894,EDS 204R,A01,507319,Halter; Christopher P.,0,3,30,30
1715632970894,EDS 204R,B01,507331,Heinzman; Erica M.,14,0,30,16
1715632971920,EDS 206R,A00,507332,Staff,0,4,30,30
1715632971920,EDS 206R,B00,507343,Staff,15,0,30,15
1715632972948,EDS 250,A00,507344,Hemans; Patricia Ann Benitez,20,0,40,20
1715632973974,EDS 281,A00,507345,Daly; Alan J.,18,0,18,0
1715632974998,EDS 284,A00,507350,Daly; Alan J.,16,0,16,0
1715632976024,EDS 286,A00,507359,Fine; Sarah,18,0,18,0
1715632977059,EDS 289C,A01,507361,Daly; Alan J.,18,0,18,0
1715632978087,EDS 290,A00,507366,Hofstetter; Carolyn,15,0,15,0
1715632979113,LIGM 5A,A00,507421,Fischer-Grunski; Eva K,17,0,20,3
1715632980137,LIGM 5B,A00,507423,Fischer-Grunski; Eva K,19,0,20,1
1715632981166,LIGM 5C,A00,507425,Fischer-Grunski; Eva K,19,0,20,1
1715632982193,LIIT 5AS,A00,507427,Carnelos; Chiara,20,0,20,0
1715632983224,LIIT 5BS,A00,507430,Carnelos; Chiara,20,0,20,0
1715632984249,LIIT 5CS,A00,507432,Carnelos; Chiara,20,0,20,0
1715632985275,LISP 5A,A00,507541,Munoz Sanchez; Alicia,11,0,20,9
1715632986305,LISP 5B,A00,507671,Munoz Sanchez; Alicia,9,0,20,11
1715632987330,LISP 5C,A00,507696,Munoz Sanchez; Alicia,9,0,20,11
1715632988360,MAE 197,001,528363,Boechler; Nicholas Sebastia,9998,0,9999,1
1715632989386,MATH 197,001,523477,Kedlaya; Kiran S.,9994,0,9999,5
1715632989386,MATH 197,002,563811,Zhang; Danna,9994,0,9999,5
1715632989386,MATH 197,003,628552,Dumitriu; Ioana,9998,0,9999,1
1715632989386,MATH 197,004,660885,Floyd; Eric,9998,0,9999,1
1715632990410,MCWP 40R,A00,518780,Staff,2,0,20,18
1715632990410,MCWP 40R,B00,518781,Staff,11,0,20,9
1715632990410,MCWP 40R,C00,518783,Staff,5,0,20,15
1715632991435,MCWP 50R,A00,518791,Staff,0,1,20,20
1715632991435,MCWP 50R,B00,518792,Staff,0,2,20,20
1715632991435,MCWP 50R,C00,518793,Staff,0,4,20,20
1715632991435,MCWP 50R,D00,518794,Staff,0,1,20,20
1715632991435,MCWP 50R,E00,518795,Staff,0,2,20,20
1715632991435,MCWP 50R,F00,518796,Staff,0,1,20,20
1715632991435,MCWP 50R,G00,518797,Staff,0,1,20,20
1715632992459,MMW 12R,A01,514034,Herbst; Matthew,0,2,16,16
1715632992459,MMW 12R,A02,514035,Herbst; Matthew,0,0,16,16
1715632993485,MMW 13R,A01,514037,Staff,0,5,16,16
1715632993485,MMW 13R,A02,514039,Staff,0,5,16,16
1715632993485,MMW 13R,A03,628519,Staff,0,4,16,16
1715632995537,SIO 295LS,A00,523233,Staff,10,0,30,20
1715632996565,SIO 295S,A00,523232,Staff,10,0,30,20
1715632997591,SIOC 290S,A01,637330,Merrifield; Mark A,22,0,30,8
1715632998621,SIOC 291S,A01,637333,Gabriel; Corey John,21,0,30,9
1715632999647,SOCI 117,A01,494376,Staff,0,5,5,5
1715633000675,WES 237B,A00,494380,Staff,10,0,20,10
1715633002758,AESE 279B,A00,494370,Wade; Jon P,0,0,33,33
1715633003786,AIP 97,001,660915,Van Den Einde; Yael Dahlia,9998,0,9999,1
1715633004812,AIP 197,001,627712,Vespa; Emanuel Ignacio,9995,0,9999,4
1715633004812,AIP 197,002,650778,Amir; On,9998,0,9999,1
1715633004812,AIP 197,003,650933,Avenancio-Leon; Carlos,9998,0,9999,1
1715633004812,AIP 197,004,658530,Heyman; Gail D.,9998,0,9999,1
1715633004812,AIP 197,005,658631,Neal; Sonya E,9998,0,9999,1
1715633004812,AIP 197,006,658671,Du; Songzi,9998,0,9999,1
1715633005836,ANAR 135S,A00,494369,Braswell; Geoffrey E.,0,0,0,0
1715633006862,BENG 196,001,628496,Engler; Adam J.,9998,0,9999,1
1715633006862,BENG 196,002,660916,Watson; John Thomas,9999,0,9999,0
1715633007888,BISP 197,001,650773,Wilhelm; James E.,9994,0,9999,5
1715633007888,BISP 197,002,658904,Coleman; Aaron B.,9998,0,9999,1
1715633008914,CAT 124RS,A01,519847,Geibel; William,0,0,20,20
1715633009942,CAT 125RS,A01,515971,Geibel; William,0,0,20,20
1715633010967,CLRE 250,A00,511389,Morris; Sheldon,9992,0,9999,7
1715633011995,CLRE 251,A00,507176,Mehta; Ravindra L.,9992,0,9999,7
1715633011995,CLRE 251,B00,511410,Mehta; Ravindra L.,9998,0,9999,1
1715633013020,CLRE 252,A00,507189,Cuomo; Raphael Eduardo,9994,0,9999,5
1715633014050,CLRE 253,A00,507199,Vaida; Florin,9994,0,9999,5
1715633014050,CLRE 253,B00,507202,Vaida; Florin,9999,0,9999,0
1715633015075,CLRE 259,A00,507211,Patel; Hemal,9996,0,9999,3
1715633016099,CLRE 260,A00,507221,Cuomo; Raphael Eduardo,9999,0,9999,0
1715633017122,CLRE 297,001,507242,Cuomo; Raphael Eduardo,9999,0,9999,0
1715633018148,COGS 197,001,638244,Voytek; Bradley Thomas,9997,0,9999,2
1715633019174,CSE 191,A00,516875,Minnes Kemp; Mor Mia,9991,0,9999,8
1715633020202,CSE 197,001,637388,Minnes Kemp; Mor Mia,9992,0,9999,7
1715633021234,CSS 201S,A01,494383,Mignozzetti; Umberto,35,0,35,0
1715633022260,CSS 202S,A01,494387,Mignozzetti; Umberto,35,0,35,0
1715633023284,DSC 197,001,628532,Eldridge; Justin Matthew,9995,0,9999,4
1715633024314,EAP 100,A00,516065,Staff,9799,0,9999,200
1715633025343,ECE 45,A01,507414,Staff,31,0,60,29
1715633027393,ECE 111,A01,507420,Staff,11,0,50,39
1715633028418,ECE 197,001,548057,Sievenpiper; Daniel F.,9991,0,9999,8
1715633029448,EDS 115,A00,507243,Choi; Bailey Miyeon,7,0,28,21
1715633030479,EDS 117,A01,494379,Staff,0,6,34,34
1715633031505,EDS 125,A00,507246,Hopkins; Megan Beth,8,0,30,22
1715633032533,EDS 128A,A01,507264,Fargason; Sharon Gayle,6,0,26,20
1715633033562,EDS 128B,A01,507293,Pappas; Elizabeth,10,0,30,20
1715633034593,EDS 139,A00,507294,Fargason; Sharon Gayle,10,0,30,20
1715633034593,EDS 139,B00,507313,Pappas; Elizabeth,11,0,30,19
1715633035620,EDS 201,A00,507315,Staff,10,0,30,20
1715633036647,EDS 203,A01,507317,Halter; Christopher P.,10,0,30,20
1715633037675,EDS 204R,A01,507319,Halter; Christopher P.,0,3,30,30
1715633037675,EDS 204R,B01,507331,Heinzman; Erica M.,14,0,30,16
1715633038701,EDS 206R,A00,507332,Staff,0,4,30,30
1715633038701,EDS 206R,B00,507343,Staff,15,0,30,15
1715633039727,EDS 250,A00,507344,Hemans; Patricia Ann Benitez,20,0,40,20
1715633040756,EDS 281,A00,507345,Daly; Alan J.,18,0,18,0
1715633041785,EDS 284,A00,507350,Daly; Alan J.,16,0,16,0
1715633042815,EDS 286,A00,507359,Fine; Sarah,18,0,18,0
1715633043840,EDS 289C,A01,507361,Daly; Alan J.,18,0,18,0
1715633044866,EDS 290,A00,507366,Hofstetter; Carolyn,15,0,15,0
1715633045892,LIGM 5A,A00,507421,Fischer-Grunski; Eva K,17,0,20,3
1715633046922,LIGM 5B,A00,507423,Fischer-Grunski; Eva K,19,0,20,1
1715633047945,LIGM 5C,A00,507425,Fischer-Grunski; Eva K,19,0,20,1
1715633048974,LIIT 5AS,A00,507427,Carnelos; Chiara,20,0,20,0
1715633050007,LIIT 5BS,A00,507430,Carnelos; Chiara,20,0,20,0
1715633051033,LIIT 5CS,A00,507432,Carnelos; Chiara,20,0,20,0
1715633052059,LISP 5A,A00,507541,Munoz Sanchez; Alicia,11,0,20,9
1715633053090,LISP 5B,A00,507671,Munoz Sanchez; Alicia,9,0,20,11
1715633054117,LISP 5C,A00,507696,Munoz Sanchez; Alicia,9,0,20,11
1715633055142,MAE 197,001,528363,Boechler; Nicholas Sebastia,9998,0,9999,1
1715633056172,MATH 197,001,523477,Kedlaya; Kiran S.,9994,0,9999,5
1715633056172,MATH 197,002,563811,Zhang; Danna,9994,0,9999,5
1715633056172,MATH 197,003,628552,Dumitriu; Ioana,9998,0,9999,1
1715633056172,MATH 197,004,660885,Floyd; Eric,9998,0,9999,1
1715633057198,MCWP 40R,A00,518780,Staff,2,0,20,18
1715633057198,MCWP 40R,B00,518781,Staff,11,0,20,9
1715633057198,MCWP 40R,C00,518783,Staff,5,0,20,15
1715633058226,MCWP 50R,A00,518791,Staff,0,1,20,20
1715633058226,MCWP 50R,B00,518792,Staff,0,2,20,20
1715633058226,MCWP 50R,C00,518793,Staff,0,4,20,20
1715633058226,MCWP 50R,D00,518794,Staff,0,1,20,20
1715633058226,MCWP 50R,E00,518795,Staff,0,2,20,20
1715633058226,MCWP 50R,F00,518796,Staff,0,1,20,20
1715633058226,MCWP 50R,G00,518797,Staff,0,1,20,20
1715633059255,MMW 12R,A01,514034,Herbst; Matthew,0,2,16,16
1715633059255,MMW 12R,A02,514035,Herbst; Matthew,0,0,16,16
1715633060280,MMW 13R,A01,514037,Staff,0,5,16,16
1715633060280,MMW 13R,A02,514039,Staff,0,5,16,16
1715633060280,MMW 13R,A03,628519,Staff,0,4,16,16
1715633062337,SIO 295LS,A00,523233,Staff,10,0,30,20
1715633063362,SIO 295S,A00,523232,Staff,10,0,30,20
1715633064387,SIOC 290S,A01,637330,Merrifield; Mark A,21,0,30,9
1715633065414,SIOC 291S,A01,637333,Gabriel; Corey John,21,0,30,9
1715633066441,SOCI 117,A01,494376,Staff,0,5,5,5
1715633067469,WES 237B,A00,494380,Staff,10,0,20,10
1715633069543,AESE 279B,A00,494370,Wade; Jon P,0,0,33,33
1715633070569,AIP 97,001,660915,Van Den Einde; Yael Dahlia,9998,0,9999,1
1715633071598,AIP 197,001,627712,Vespa; Emanuel Ignacio,9995,0,9999,4
1715633071598,AIP 197,002,650778,Amir; On,9998,0,9999,1
1715633071598,AIP 197,003,650933,Avenancio-Leon; Carlos,9998,0,9999,1
1715633071598,AIP 197,004,658530,Heyman; Gail D.,9998,0,9999,1
1715633071598,AIP 197,005,658631,Neal; Sonya E,9998,0,9999,1
1715633071598,AIP 197,006,658671,Du; Songzi,9998,0,9999,1
1715633072624,ANAR 135S,A00,494369,Braswell; Geoffrey E.,0,0,0,0
1715633073653,BENG 196,001,628496,Engler; Adam J.,9998,0,9999,1
1715633073653,BENG 196,002,660916,Watson; John Thomas,9999,0,9999,0
1715633074680,BISP 197,001,650773,Wilhelm; James E.,9994,0,9999,5
1715633074680,BISP 197,002,658904,Coleman; Aaron B.,9998,0,9999,1
1715633075706,CAT 124RS,A01,519847,Geibel; William,0,0,20,20
1715633076732,CAT 125RS,A01,515971,Geibel; William,0,0,20,20
1715633077758,CLRE 250,A00,511389,Morris; Sheldon,9992,0,9999,7
1715633078790,CLRE 251,A00,507176,Mehta; Ravindra L.,9992,0,9999,7
1715633078790,CLRE 251,B00,511410,Mehta; Ravindra L.,9998,0,9999,1
1715633079819,CLRE 252,A00,507189,Cuomo; Raphael Eduardo,9994,0,9999,5
1715633080850,CLRE 253,A00,507199,Vaida; Florin,9994,0,9999,5
1715633080850,CLRE 253,B00,507202,Vaida; Florin,9999,0,9999,0
1715633081879,CLRE 259,A00,507211,Patel; Hemal,9996,0,9999,3
1715633082905,CLRE 260,A00,507221,Cuomo; Raphael Eduardo,9999,0,9999,0
1715633083934,CLRE 297,001,507242,Cuomo; Raphael Eduardo,9999,0,9999,0
1715633084960,COGS 197,001,638244,Voytek; Bradley Thomas,9997,0,9999,2
1715633085988,CSE 191,A00,516875,Minnes Kemp; Mor Mia,9991,0,9999,8
1715633087017,CSE 197,001,637388,Minnes Kemp; Mor Mia,9992,0,9999,7
1715633088048,CSS 201S,A01,494383,Mignozzetti; Umberto,35,0,35,0
1715633089075,CSS 202S,A01,494387,Mignozzetti; Umberto,35,0,35,0
1715633090105,DSC 197,001,628532,Eldridge; Justin Matthew,9995,0,9999,4
1715633091132,EAP 100,A00,516065,Staff,9799,0,9999,200
1715633092164,ECE 45,A01,507414,Staff,31,0,60,29
1715633094245,ECE 111,A01,507420,Staff,11,0,50,39
1715633095273,ECE 197,001,548057,Sievenpiper; Daniel F.,9991,0,9999,8
1715633096299,EDS 115,A00,507243,Choi; Bailey Miyeon,7,0,28,21
1715633097326,EDS 117,A01,494379,Staff,0,6,34,34
1715633098355,EDS 125,A00,507246,Hopkins; Megan Beth,8,0,30,22
1715633099380,EDS 128A,A01,507264,Fargason; Sharon Gayle,6,0,26,20
1715633100405,EDS 128B,A01,507293,Pappas; Elizabeth,10,0,30,20
1715633101430,EDS 139,A00,507294,Fargason; Sharon Gayle,10,0,30,20
1715633101430,EDS 139,B00,507313,Pappas; Elizabeth,11,0,30,19
1715633102456,EDS 201,A00,507315,Staff,10,0,30,20
1715633103482,EDS 203,A01,507317,Halter; Christopher P.,10,0,30,20
1715633104506,EDS 204R,A01,507319,Halter; Christopher P.,0,3,30,30
1715633104506,EDS 204R,B01,507331,Heinzman; Erica M.,14,0,30,16
1715633105531,EDS 206R,A00,507332,Staff,0,4,30,30
1715633105531,EDS 206R,B00,507343,Staff,15,0,30,15
1715633106557,EDS 250,A00,507344,Hemans; Patricia Ann Benitez,20,0,40,20
1715633107583,EDS 281,A00,507345,Daly; Alan J.,18,0,18,0
1715633108608,EDS 284,A00,507350,Daly; Alan J.,16,0,16,0
1715633109636,EDS 286,A00,507359,Fine; Sarah,18,0,18,0
1715633110662,EDS 289C,A01,507361,Daly; Alan J.,18,0,18,0
1715633111690,EDS 290,A00,507366,Hofstetter; Carolyn,15,0,15,0
1715633112717,LIGM 5A,A00,507421,Fischer-Grunski; Eva K,17,0,20,3
1715633113743,LIGM 5B,A00,507423,Fischer-Grunski; Eva K,19,0,20,1
1715633114771,LIGM 5C,A00,507425,Fischer-Grunski; Eva K,19,0,20,1
1715633115800,LIIT 5AS,A00,507427,Carnelos; Chiara,20,0,20,0
1715633116826,LIIT 5BS,A00,507430,Carnelos; Chiara,20,0,20,0
1715633117850,LIIT 5CS,A00,507432,Carnelos; Chiara,20,0,20,0
1715633118880,LISP 5A,A00,507541,Munoz Sanchez; Alicia,11,0,20,9
1715633119908,LISP 5B,A00,507671,Munoz Sanchez; Alicia,9,0,20,11
1715633120934,LISP 5C,A00,507696,Munoz Sanchez; Alicia,9,0,20,11
1715633121960,MAE 197,001,528363,Boechler; Nicholas Sebastia,9998,0,9999,1
1715633122993,MATH 197,001,523477,Kedlaya; Kiran S.,9994,0,9999,5
1715633122993,MATH 197,002,563811,Zhang; Danna,9994,0,9999,5
1715633122993,MATH 197,003,628552,Dumitriu; Ioana,9998,0,9999,1
1715633122993,MATH 197,004,660885,Floyd; Eric,9998,0,9999,1
1715633124022,MCWP 40R,A00,518780,Staff,2,0,20,18
1715633124022,MCWP 40R,B00,518781,Staff,11,0,20,9
1715633124022,MCWP 40R,C00,518783,Staff,5,0,20,15
1715633125049,MCWP 50R,A00,518791,Staff,0,1,20,20
1715633125049,MCWP 50R,B00,518792,Staff,0,2,20,20
1715633125049,MCWP 50R,C00,518793,Staff,0,4,20,20
1715633125049,MCWP 50R,D00,518794,Staff,0,1,20,20
1715633125049,MCWP 50R,E00,518795,Staff,0,2,20,20
1715633125049,MCWP 50R,F00,518796,Staff,0,1,20,20
1715633125049,MCWP 50R,G00,518797,Staff,0,1,20,20
1715633126079,MMW 12R,A01,514034,Herbst; Matthew,0,2,16,16
1715633126079,MMW 12R,A02,514035,Herbst; Matthew,0,0,16,16
1715633127106,MMW 13R,A01,514037,Staff,0,5,16,16
1715633127106,MMW 13R,A02,514039,Staff,0,5,16,16
1715633127106,MMW 13R,A03,628519,Staff,0,4,16,16
1715633129158,SIO 295LS,A00,523233,Staff,10,0,30,20
1715633130183,SIO 295S,A00,523232,Staff,10,0,30,20
1715633131210,SIOC 290S,A01,637330,Merrifield; Mark A,21,0,30,9
1715633132239,SIOC 291S,A01,637333,Gabriel; Corey John,21,0,30,9
1715633133265,SOCI 117,A01,494376,Staff,0,5,5,5
1715633134291,WES 237B,A00,494380,Staff,10,0,20,10
1715633136372,AESE 279B,A00,494370,Wade; Jon P,0,0,33,33
1715633137401,AIP 97,001,660915,Van Den Einde; Yael Dahlia,9998,0,9999,1
1715633138430,AIP 197,001,627712,Vespa; Emanuel Ignacio,9995,0,9999,4
1715633138430,AIP 197,002,650778,Amir; On,9998,0,9999,1
1715633138430,AIP 197,003,650933,Avenancio-Leon; Carlos,9998,0,9999,1
1715633138430,AIP 197,004,658530,Heyman; Gail D.,9998,0,9999,1
1715633138430,AIP 197,005,658631,Neal; Sonya E,9998,0,9999,1
1715633138430,AIP 197,006,658671,Du; Songzi,9998,0,9999,1
1715633139458,ANAR 135S,A00,494369,Braswell; Geoffrey E.,0,0,0,0
1715633140486,BENG 196,001,628496,Engler; Adam J.,9998,0,9999,1
1715633140486,BENG 196,002,660916,Watson; John Thomas,9999,0,9999,0
1715633141513,BISP 197,001,650773,Wilhelm; James E.,9994,0,9999,5
1715633141513,BISP 197,002,658904,Coleman; Aaron B.,9998,0,9999,1
1715633142543,CAT 124RS,A01,519847,Geibel; William,0,0,20,20
1715633143570,CAT 125RS,A01,515971,Geibel; William,0,0,20,20
1715633144595,CLRE 250,A00,511389,Morris; Sheldon,9992,0,9999,7
1715633145626,CLRE 251,A00,507176,Mehta; Ravindra L.,9992,0,9999,7
1715633145626,CLRE 251,B00,511410,Mehta; Ravindra L.,9998,0,9999,1
1715633146656,CLRE 252,A00,507189,Cuomo; Raphael Eduardo,9994,0,9999,5
1715633147688,CLRE 253,A00,507199,Vaida; Florin,9994,0,9999,5
1715633147688,CLRE 253,B00,507202,Vaida; Florin,9999,0,9999,0
1715633148714,CLRE 259,A00,507211,Patel; Hemal,9996,0,9999,3
1715633149740,CLRE 260,A00,507221,Cuomo; Raphael Eduardo,9999,0,9999,0
1715633150767,CLRE 297,001,507242,Cuomo; Raphael Eduardo,9999,0,9999,0
1715633151796,COGS 197,001,638244,Voytek; Bradley Thomas,9997,0,9999,2
1715633152822,CSE 191,A00,516875,Minnes Kemp; Mor Mia,9991,0,9999,8
1715633153847,CSE 197,001,637388,Minnes Kemp; Mor Mia,9992,0,9999,7
1715633154874,CSS 201S,A01,494383,Mignozzetti; Umberto,35,0,35,0
1715633155904,CSS 202S,A01,494387,Mignozzetti; Umberto,35,0,35,0
1715633156932,DSC 197,001,628532,Eldridge; Justin Matthew,9995,0,9999,4
1715633157961,EAP 100,A00,516065,Staff,9799,0,9999,200
1715633158989,ECE 45,A01,507414,Staff,31,0,60,29
1715633161057,ECE 111,A01,507420,Staff,11,0,50,39
1715633162083,ECE 197,001,548057,Sievenpiper; Daniel F.,9991,0,9999,8
1715633163168,EDS 115,A00,507243,Choi; Bailey Miyeon,7,0,28,21
1715633164196,EDS 117,A01,494379,Staff,0,6,34,34
1715633165224,EDS 125,A00,507246,Hopkins; Megan Beth,8,0,30,22
1715633166255,EDS 128A,A01,507264,Fargason; Sharon Gayle,6,0,26,20
1715633167285,EDS 128B,A01,507293,Pappas; Elizabeth,10,0,30,20
1715633168314,EDS 139,A00,507294,Fargason; Sharon Gayle,10,0,30,20
1715633168314,EDS 139,B00,507313,Pappas; Elizabeth,11,0,30,19
1715633169339,EDS 201,A00,507315,Staff,10,0,30,20
1715633170365,EDS 203,A01,507317,Halter; Christopher P.,10,0,30,20
1715633171394,EDS 204R,A01,507319,Halter; Christopher P.,0,3,30,30
1715633171394,EDS 204R,B01,507331,Heinzman; Erica M.,14,0,30,16
1715633172420,EDS 206R,A00,507332,Staff,0,4,30,30
1715633172420,EDS 206R,B00,507343,Staff,15,0,30,15
1715633173447,EDS 250,A00,507344,Hemans; Patricia Ann Benitez,20,0,40,20
1715633174473,EDS 281,A00,507345,Daly; Alan J.,18,0,18,0
1715633175501,EDS 284,A00,507350,Daly; Alan J.,16,0,16,0
1715633176527,EDS 286,A00,507359,Fine; Sarah,18,0,18,0
1715633177556,EDS 289C,A01,507361,Daly; Alan J.,18,0,18,0
1715633178586,EDS 290,A00,507366,Hofstetter; Carolyn,15,0,15,0
1715633179615,LIGM 5A,A00,507421,Fischer-Grunski; Eva K,17,0,20,3
1715633180644,LIGM 5B,A00,507423,Fischer-Grunski; Eva K,19,0,20,1
1715633181671,LIGM 5C,A00,507425,Fischer-Grunski; Eva K,19,0,20,1
1715633182701,LIIT 5AS,A00,507427,Carnelos; Chiara,20,0,20,0
1715633183727,LIIT 5BS,A00,507430,Carnelos; Chiara,20,0,20,0
1715633184753,LIIT 5CS,A00,507432,Carnelos; Chiara,20,0,20,0
1715633185782,LISP 5A,A00,507541,Munoz Sanchez; Alicia,11,0,20,9
1715633186813,LISP 5B,A00,507671,Munoz Sanchez; Alicia,9,0,20,11
1715633187839,LISP 5C,A00,507696,Munoz Sanchez; Alicia,9,0,20,11
1715633188863,MAE 197,001,528363,Boechler; Nicholas Sebastia,9998,0,9999,1
1715633189891,MATH 197,001,523477,Kedlaya; Kiran S.,9994,0,9999,5
1715633189891,MATH 197,002,563811,Zhang; Danna,9994,0,9999,5
1715633189891,MATH 197,003,628552,Dumitriu; Ioana,9998,0,9999,1
1715633189891,MATH 197,004,660885,Floyd; Eric,9998,0,9999,1
1715633190922,MCWP 40R,A00,518780,Staff,2,0,20,18
1715633190922,MCWP 40R,B00,518781,Staff,11,0,20,9
1715633190922,MCWP 40R,C00,518783,Staff,5,0,20,15
1715633191951,MCWP 50R,A00,518791,Staff,0,1,20,20
1715633191951,MCWP 50R,B00,518792,Staff,0,2,20,20
1715633191951,MCWP 50R,C00,518793,Staff,0,4,20,20
1715633191951,MCWP 50R,D00,518794,Staff,0,1,20,20
1715633191951,MCWP 50R,E00,518795,Staff,0,2,20,20
1715633191951,MCWP 50R,F00,518796,Staff,0,1,20,20
1715633191951,MCWP 50R,G00,518797,Staff,0,1,20,20
1715633192978,MMW 12R,A01,514034,Herbst; Matthew,0,2,16,16
1715633192978,MMW 12R,A02,514035,Herbst; Matthew,0,0,16,16
1715633194003,MMW 13R,A01,514037,Staff,0,5,16,16
1715633194003,MMW 13R,A02,514039,Staff,0,5,16,16
1715633194003,MMW 13R,A03,628519,Staff,0,4,16,16
1715633196055,SIO 295LS,A00,523233,Staff,10,0,30,20
1715633197081,SIO 295S,A00,523232,Staff,10,0,30,20
1715633198113,SIOC 290S,A01,637330,Merrifield; Mark A,21,0,30,9
1715633199140,SIOC 291S,A01,637333,Gabriel; Corey John,21,0,30,9
1715633200166,SOCI 117,A01,494376,Staff,0,5,5,5
1715633201191,WES 237B,A00,494380,Staff,10,0,20,10
1715633203264,AESE 279B,A00,494370,Wade; Jon P,0,0,33,33
1715633204290,AIP 97,001,660915,Van Den Einde; Yael Dahlia,9998,0,9999,1
1715633205318,AIP 197,001,627712,Vespa; Emanuel Ignacio,9995,0,9999,4
1715633205318,AIP 197,002,650778,Amir; On,9998,0,9999,1
1715633205318,AIP 197,003,650933,Avenancio-Leon; Carlos,9998,0,9999,1
1715633205318,AIP 197,004,658530,Heyman; Gail D.,9998,0,9999,1
1715633205318,AIP 197,005,658631,Neal; Sonya E,9998,0,9999,1
1715633205318,AIP 197,006,658671,Du; Songzi,9998,0,9999,1
1715633206343,ANAR 135S,A00,494369,Braswell; Geoffrey E.,0,0,0,0
1715633207370,BENG 196,001,628496,Engler; Adam J.,9998,0,9999,1
1715633207370,BENG 196,002,660916,Watson; John Thomas,9999,0,9999,0
1715633208397,BISP 197,001,650773,Wilhelm; James E.,9994,0,9999,5
1715633208397,BISP 197,002,658904,Coleman; Aaron B.,9998,0,9999,1
1715633209423,CAT 124RS,A01,519847,Geibel; William,0,0,20,20
1715633210450,CAT 125RS,A01,515971,Geibel; William,0,0,20,20
1715633211476,CLRE 250,A00,511389,Morris; Sheldon,9992,0,9999,7
1715633212502,CLRE 251,A00,507176,Mehta; Ravindra L.,9992,0,9999,7
1715633212502,CLRE 251,B00,511410,Mehta; Ravindra L.,9998,0,9999,1
1715633213529,CLRE 252,A00,507189,Cuomo; Raphael Eduardo,9994,0,9999,5
1715633214558,CLRE 253,A00,507199,Vaida; Florin,9994,0,9999,5
1715633214558,CLRE 253,B00,507202,Vaida; Florin,9999,0,9999,0
1715633215583,CLRE 259,A00,507211,Patel; Hemal,9996,0,9999,3
1715633216608,CLRE 260,A00,507221,Cuomo; Raphael Eduardo,9999,0,9999,0
1715633217637,CLRE 297,001,507242,Cuomo; Raphael Eduardo,9999,0,9999,0
1715633218665,COGS 197,001,638244,Voytek; Bradley Thomas,9997,0,9999,2
1715633219694,CSE 191,A00,516875,Minnes Kemp; Mor Mia,9991,0,9999,8
1715633220722,CSE 197,001,637388,Minnes Kemp; Mor Mia,9992,0,9999,7
1715633221755,CSS 201S,A01,494383,Mignozzetti; Umberto,35,0,35,0
1715633222784,CSS 202S,A01,494387,Mignozzetti; Umberto,35,0,35,0
1715633223813,DSC 197,001,628532,Eldridge; Justin Matthew,9995,0,9999,4
1715633224842,EAP 100,A00,516065,Staff,9799,0,9999,200
1715633225870,ECE 45,A01,507414,Staff,31,0,60,29
1715633227921,ECE 111,A01,507420,Staff,11,0,50,39
1715633228948,ECE 197,001,548057,Sievenpiper; Daniel F.,9991,0,9999,8
1715633229978,EDS 115,A00,507243,Choi; Bailey Miyeon,7,0,28,21
1715633231006,EDS 117,A01,494379,Staff,0,6,34,34
1715633232031,EDS 125,A00,507246,Hopkins; Megan Beth,8,0,30,22
1715633233059,EDS 128A,A01,507264,Fargason; Sharon Gayle,6,0,26,20
1715633234090,EDS 128B,A01,507293,Pappas; Elizabeth,10,0,30,20
1715633235116,EDS 139,A00,507294,Fargason; Sharon Gayle,10,0,30,20
1715633235116,EDS 139,B00,507313,Pappas; Elizabeth,11,0,30,19
1715633236142,EDS 201,A00,507315,Staff,10,0,30,20
1715633237172,EDS 203,A01,507317,Halter; Christopher P.,10,0,30,20
1715633238204,EDS 204R,A01,507319,Halter; Christopher P.,0,3,30,30
1715633238204,EDS 204R,B01,507331,Heinzman; Erica M.,14,0,30,16
1715633239229,EDS 206R,A00,507332,Staff,0,4,30,30
1715633239229,EDS 206R,B00,507343,Staff,15,0,30,15
1715633240254,EDS 250,A00,507344,Hemans; Patricia Ann Benitez,20,0,40,20
1715633241283,EDS 281,A00,507345,Daly; Alan J.,18,0,18,0
1715633242307,EDS 284,A00,507350,Daly; Alan J.,16,0,16,0
1715633243349,EDS 286,A00,507359,Fine; Sarah,18,0,18,0
1715633244377,EDS 289C,A01,507361,Daly; Alan J.,18,0,18,0
1715633245405,EDS 290,A00,507366,Hofstetter; Carolyn,15,0,15,0
1715633246433,LIGM 5A,A00,507421,Fischer-Grunski; Eva K,17,0,20,3
1715633247457,LIGM 5B,A00,507423,Fischer-Grunski; Eva K,19,0,20,1
1715633248482,LIGM 5C,A00,507425,Fischer-Grunski; Eva K,19,0,20,1
1715633249514,LIIT 5AS,A00,507427,Carnelos; Chiara,20,0,20,0
1715633250542,LIIT 5BS,A00,507430,Carnelos; Chiara,20,0,20,0
1715633251569,LIIT 5CS,A00,507432,Carnelos; Chiara,20,0,20,0
1715633252598,LISP 5A,A00,507541,Munoz Sanchez; Alicia,11,0,20,9
1715633253624,LISP 5B,A00,507671,Munoz Sanchez; Alicia,9,0,20,11
1715633254649,LISP 5C,A00,507696,Munoz Sanchez; Alicia,9,0,20,11
1715633255673,MAE 197,001,528363,Boechler; Nicholas Sebastia,9998,0,9999,1
1715633256701,MATH 197,001,523477,Kedlaya; Kiran S.,9994,0,9999,5
1715633256701,MATH 197,002,563811,Zhang; Danna,9994,0,9999,5
1715633256701,MATH 197,003,628552,Dumitriu; Ioana,9998,0,9999,1
1715633256701,MATH 197,004,660885,Floyd; Eric,9998,0,9999,1
1715633257726,MCWP 40R,A00,518780,Staff,2,0,20,18
1715633257726,MCWP 40R,B00,518781,Staff,11,0,20,9
1715633257726,MCWP 40R,C00,518783,Staff,5,0,20,15
1715633258752,MCWP 50R,A00,518791,Staff,0,1,20,20
1715633258752,MCWP 50R,B00,518792,Staff,0,2,20,20
1715633258752,MCWP 50R,C00,518793,Staff,0,4,20,20
1715633258752,MCWP 50R,D00,518794,Staff,0,1,20,20
1715633258752,MCWP 50R,E00,518795,Staff,0,2,20,20
1715633258752,MCWP 50R,F00,518796,Staff,0,1,20,20
1715633258752,MCWP 50R,G00,518797,Staff,0,1,20,20
1715633259780,MMW 12R,A01,514034,Herbst; Matthew,0,2,16,16
1715633259780,MMW 12R,A02,514035,Herbst; Matthew,0,0,16,16
1715633260808,MMW 13R,A01,514037,Staff,0,5,16,16
1715633260808,MMW 13R,A02,514039,Staff,0,5,16,16
1715633260808,MMW 13R,A03,628519,Staff,0,4,16,16
1715633262860,SIO 295LS,A00,523233,Staff,10,0,30,20
1715633263884,SIO 295S,A00,523232,Staff,10,0,30,20
1715633264912,SIOC 290S,A01,637330,Merrifield; Mark A,21,0,30,9
1715633265939,SIOC 291S,A01,637333,Gabriel; Corey John,21,0,30,9
1715633266963,SOCI 117,A01,494376,Staff,0,5,5,5
1715633267992,WES 237B,A00,494380,Staff,10,0,20,10
1715633270074,AESE 279B,A00,494370,Wade; Jon P,0,0,33,33
1715633271102,AIP 97,001,660915,Van Den Einde; Yael Dahlia,9998,0,9999,1
1715633272130,AIP 197,001,627712,Vespa; Emanuel Ignacio,9995,0,9999,4
1715633272130,AIP 197,002,650778,Amir; On,9998,0,9999,1
1715633272130,AIP 197,003,650933,Avenancio-Leon; Carlos,9998,0,9999,1
1715633272130,AIP 197,004,658530,Heyman; Gail D.,9998,0,9999,1
1715633272130,AIP 197,005,658631,Neal; Sonya E,9998,0,9999,1
1715633272130,AIP 197,006,658671,Du; Songzi,9998,0,9999,1
1715633273157,ANAR 135S,A00,494369,Braswell; Geoffrey E.,0,0,0,0
1715633274186,BENG 196,001,628496,Engler; Adam J.,9998,0,9999,1
1715633274186,BENG 196,002,660916,Watson; John Thomas,9999,0,9999,0
1715633275216,BISP 197,001,650773,Wilhelm; James E.,9994,0,9999,5
1715633275216,BISP 197,002,658904,Coleman; Aaron B.,9998,0,9999,1
1715633276241,CAT 124RS,A01,519847,Geibel; William,0,0,20,20
1715633277266,CAT 125RS,A01,515971,Geibel; William,0,0,20,20
1715633278295,CLRE 250,A00,511389,Morris; Sheldon,9992,0,9999,7
1715633279321,CLRE 251,A00,507176,Mehta; Ravindra L.,9992,0,9999,7
1715633279321,CLRE 251,B00,511410,Mehta; Ravindra L.,9998,0,9999,1
1715633280351,CLRE 252,A00,507189,Cuomo; Raphael Eduardo,9994,0,9999,5
1715633281380,CLRE 253,A00,507199,Vaida; Florin,9994,0,9999,5
1715633281380,CLRE 253,B00,507202,Vaida; Florin,9999,0,9999,0
1715633282409,CLRE 259,A00,507211,Patel; Hemal,9996,0,9999,3
1715633283436,CLRE 260,A00,507221,Cuomo; Raphael Eduardo,9999,0,9999,0
1715633284460,CLRE 297,001,507242,Cuomo; Raphael Eduardo,9999,0,9999,0
1715633285486,COGS 197,001,638244,Voytek; Bradley Thomas,9997,0,9999,2
1715633286510,CSE 191,A00,516875,Minnes Kemp; Mor Mia,9991,0,9999,8
1715633287535,CSE 197,001,637388,Minnes Kemp; Mor Mia,9992,0,9999,7
1715633288564,CSS 201S,A01,494383,Mignozzetti; Umberto,35,0,35,0
1715633289590,CSS 202S,A01,494387,Mignozzetti; Umberto,35,0,35,0
1715633290614,DSC 197,001,628532,Eldridge; Justin Matthew,9995,0,9999,4
1715633291638,EAP 100,A00,516065,Staff,9799,0,9999,200
1715633292665,ECE 45,A01,507414,Staff,31,0,60,29
1715633294720,ECE 111,A01,507420,Staff,11,0,50,39
1715633295758,ECE 197,001,548057,Sievenpiper; Daniel F.,9991,0,9999,8
1715633296783,EDS 115,A00,507243,Choi; Bailey Miyeon,7,0,28,21
1715633297808,EDS 117,A01,494379,Staff,0,6,34,34
1715633298834,EDS 125,A00,507246,Hopkins; Megan Beth,8,0,30,22
1715633299857,EDS 128A,A01,507264,Fargason; Sharon Gayle,6,0,26,20
1715633300885,EDS 128B,A01,507293,Pappas; Elizabeth,10,0,30,20
1715633301912,EDS 139,A00,507294,Fargason; Sharon Gayle,10,0,30,20
1715633301912,EDS 139,B00,507313,Pappas; Elizabeth,11,0,30,19
1715633302937,EDS 201,A00,507315,Staff,10,0,30,20
1715633303966,EDS 203,A01,507317,Halter; Christopher P.,10,0,30,20
1715633304994,EDS 204R,A01,507319,Halter; Christopher P.,0,3,30,30
1715633304994,EDS 204R,B01,507331,Heinzman; Erica M.,14,0,30,16
1715633306017,EDS 206R,A00,507332,Staff,0,4,30,30
1715633306017,EDS 206R,B00,507343,Staff,15,0,30,15
1715633307043,EDS 250,A00,507344,Hemans; Patricia Ann Benitez,20,0,40,20
1715633308069,EDS 281,A00,507345,Daly; Alan J.,18,0,18,0
1715633309093,EDS 284,A00,507350,Daly; Alan J.,16,0,16,0
1715633310123,EDS 286,A00,507359,Fine; Sarah,18,0,18,0
1715633311146,EDS 289C,A01,507361,Daly; Alan J.,18,0,18,0
1715633312174,EDS 290,A00,507366,Hofstetter; Carolyn,15,0,15,0
1715633313204,LIGM 5A,A00,507421,Fischer-Grunski; Eva K,17,0,20,3
1715633314229,LIGM 5B,A00,507423,Fischer-Grunski; Eva K,19,0,20,1
1715633315259,LIGM 5C,A00,507425,Fischer-Grunski; Eva K,19,0,20,1
1715633316285,LIIT 5AS,A00,507427,Carnelos; Chiara,20,0,20,0
1715633317311,LIIT 5BS,A00,507430,Carnelos; Chiara,20,0,20,0
1715633318336,LIIT 5CS,A00,507432,Carnelos; Chiara,20,0,20,0
1715633319370,LISP 5A,A00,507541,Munoz Sanchez; Alicia,11,0,20,9
1715633320397,LISP 5B,A00,507671,Munoz Sanchez; Alicia,9,0,20,11
1715633321426,LISP 5C,A00,507696,Munoz Sanchez; Alicia,9,0,20,11
1715633322454,MAE 197,001,528363,Boechler; Nicholas Sebastia,9998,0,9999,1
1715633323481,MATH 197,001,523477,Kedlaya; Kiran S.,9994,0,9999,5
1715633323481,MATH 197,002,563811,Zhang; Danna,9994,0,9999,5
1715633323481,MATH 197,003,628552,Dumitriu; Ioana,9998,0,9999,1
1715633323481,MATH 197,004,660885,Floyd; Eric,9998,0,9999,1
1715633324507,MCWP 40R,A00,518780,Staff,2,0,20,18
1715633324507,MCWP 40R,B00,518781,Staff,11,0,20,9
1715633324507,MCWP 40R,C00,518783,Staff,5,0,20,15
1715633325536,MCWP 50R,A00,518791,Staff,0,1,20,20
1715633325536,MCWP 50R,B00,518792,Staff,0,2,20,20
1715633325536,MCWP 50R,C00,518793,Staff,0,4,20,20
1715633325536,MCWP 50R,D00,518794,Staff,0,1,20,20
1715633325536,MCWP 50R,E00,518795,Staff,0,2,20,20
1715633325536,MCWP 50R,F00,518796,Staff,0,1,20,20
1715633325536,MCWP 50R,G00,518797,Staff,0,1,20,20
1715633326562,MMW 12R,A01,514034,Herbst; Matthew,0,2,16,16
1715633326562,MMW 12R,A02,514035,Herbst; Matthew,0,0,16,16
1715633327589,MMW 13R,A01,514037,Staff,0,5,16,16
1715633327589,MMW 13R,A02,514039,Staff,0,5,16,16
1715633327589,MMW 13R,A03,628519,Staff,0,4,16,16
1715633329642,SIO 295LS,A00,523233,Staff,10,0,30,20
1715633330666,SIO 295S,A00,523232,Staff,10,0,30,20
1715633331693,SIOC 290S,A01,637330,Merrifield; Mark A,21,0,30,9
1715633332719,SIOC 291S,A01,637333,Gabriel; Corey John,21,0,30,9
1715633333746,SOCI 117,A01,494376,Staff,0,5,5,5
1715633334774,WES 237B,A00,494380,Staff,10,0,20,10
1715633336856,AESE 279B,A00,494370,Wade; Jon P,0,0,33,33
1715633337880,AIP 97,001,660915,Van Den Einde; Yael Dahlia,9998,0,9999,1
1715633338908,AIP 197,001,627712,Vespa; Emanuel Ignacio,9995,0,9999,4
1715633338908,AIP 197,002,650778,Amir; On,9998,0,9999,1
1715633338908,AIP 197,003,650933,Avenancio-Leon; Carlos,9998,0,9999,1
1715633338908,AIP 197,004,658530,Heyman; Gail D.,9998,0,9999,1
1715633338908,AIP 197,005,658631,Neal; Sonya E,9998,0,9999,1
1715633338908,AIP 197,006,658671,Du; Songzi,9998,0,9999,1
1715633339935,ANAR 135S,A00,494369,Braswell; Geoffrey E.,0,0,0,0
1715633340960,BENG 196,001,628496,Engler; Adam J.,9998,0,9999,1
1715633340960,BENG 196,002,660916,Watson; John Thomas,9999,0,9999,0
1715633341989,BISP 197,001,650773,Wilhelm; James E.,9994,0,9999,5
1715633341989,BISP 197,002,658904,Coleman; Aaron B.,9998,0,9999,1
1715633343014,CAT 124RS,A01,519847,Geibel; William,0,0,20,20
1715633344039,CAT 125RS,A01,515971,Geibel; William,0,0,20,20
1715633345064,CLRE 250,A00,511389,Morris; Sheldon,9992,0,9999,7
1715633346098,CLRE 251,A00,507176,Mehta; Ravindra L.,9992,0,9999,7
1715633346098,CLRE 251,B00,511410,Mehta; Ravindra L.,9998,0,9999,1
1715633347124,CLRE 252,A00,507189,Cuomo; Raphael Eduardo,9994,0,9999,5
1715633348148,CLRE 253,A00,507199,Vaida; Florin,9994,0,9999,5
1715633348148,CLRE 253,B00,507202,Vaida; Florin,9999,0,9999,0
1715633349240,CLRE 259,A00,507211,Patel; Hemal,9996,0,9999,3
1715633350268,CLRE 260,A00,507221,Cuomo; Raphael Eduardo,9999,0,9999,0
1715633351296,CLRE 297,001,507242,Cuomo; Raphael Eduardo,9999,0,9999,0
1715633352324,COGS 197,001,638244,Voytek; Bradley Thomas,9997,0,9999,2
1715633353349,CSE 191,A00,516875,Minnes Kemp; Mor Mia,9991,0,9999,8
1715633354377,CSE 197,001,637388,Minnes Kemp; Mor Mia,9992,0,9999,7
1715633355407,CSS 201S,A01,494383,Mignozzetti; Umberto,35,0,35,0
1715633356432,CSS 202S,A01,494387,Mignozzetti; Umberto,35,0,35,0
1715633357458,DSC 197,001,628532,Eldridge; Justin Matthew,9995,0,9999,4
1715633358482,EAP 100,A00,516065,Staff,9799,0,9999,200
1715633359511,ECE 45,A01,507414,Staff,31,0,60,29
1715633361567,ECE 111,A01,507420,Staff,11,0,50,39
1715633362596,ECE 197,001,548057,Sievenpiper; Daniel F.,9991,0,9999,8
1715633363623,EDS 115,A00,507243,Choi; Bailey Miyeon,7,0,28,21
1715633364649,EDS 117,A01,494379,Staff,0,6,34,34
1715633365674,EDS 125,A00,507246,Hopkins; Megan Beth,8,0,30,22
1715633366699,EDS 128A,A01,507264,Fargason; Sharon Gayle,6,0,26,20
1715633367727,EDS 128B,A01,507293,Pappas; Elizabeth,10,0,30,20
1715633368753,EDS 139,A00,507294,Fargason; Sharon Gayle,10,0,30,20
1715633368753,EDS 139,B00,507313,Pappas; Elizabeth,11,0,30,19
1715633369781,EDS 201,A00,507315,Staff,10,0,30,20
1715633370811,EDS 203,A01,507317,Halter; Christopher P.,10,0,30,20
1715633371835,EDS 204R,A01,507319,Halter; Christopher P.,0,3,30,30
1715633371835,EDS 204R,B01,507331,Heinzman; Erica M.,14,0,30,16
1715633372862,EDS 206R,A00,507332,Staff,0,4,30,30
1715633372862,EDS 206R,B00,507343,Staff,15,0,30,15
1715633373888,EDS 250,A00,507344,Hemans; Patricia Ann Benitez,20,0,40,20
1715633374914,EDS 281,A00,507345,Daly; Alan J.,18,0,18,0
1715633375941,EDS 284,A00,507350,Daly; Alan J.,16,0,16,0
1715633376968,EDS 286,A00,507359,Fine; Sarah,18,0,18,0
1715633377994,EDS 289C,A01,507361,Daly; Alan J.,18,0,18,0
1715633379019,EDS 290,A00,507366,Hofstetter; Carolyn,15,0,15,0
1715633380049,LIGM 5A,A00,507421,Fischer-Grunski; Eva K,17,0,20,3
1715633381077,LIGM 5B,A00,507423,Fischer-Grunski; Eva K,19,0,20,1
1715633382103,LIGM 5C,A00,507425,Fischer-Grunski; Eva K,19,0,20,1
1715633383134,LIIT 5AS,A00,507427,Carnelos; Chiara,20,0,20,0
1715633384163,LIIT 5BS,A00,507430,Carnelos; Chiara,20,0,20,0
1715633385187,LIIT 5CS,A00,507432,Carnelos; Chiara,20,0,20,0
1715633386212,LISP 5A,A00,507541,Munoz Sanchez; Alicia,11,0,20,9
1715633387240,LISP 5B,A00,507671,Munoz Sanchez; Alicia,9,0,20,11
1715633388264,LISP 5C,A00,507696,Munoz Sanchez; Alicia,9,0,20,11
1715633389290,MAE 197,001,528363,Boechler; Nicholas Sebastia,9998,0,9999,1
1715633390323,MATH 197,001,523477,Kedlaya; Kiran S.,9994,0,9999,5
1715633390323,MATH 197,002,563811,Zhang; Danna,9994,0,9999,5
1715633390323,MATH 197,003,628552,Dumitriu; Ioana,9998,0,9999,1
1715633390323,MATH 197,004,660885,Floyd; Eric,9998,0,9999,1
1715633391347,MCWP 40R,A00,518780,Staff,2,0,20,18
1715633391347,MCWP 40R,B00,518781,Staff,11,0,20,9
1715633391347,MCWP 40R,C00,518783,Staff,5,0,20,15
1715633392377,MCWP 50R,A00,518791,Staff,0,1,20,20
1715633392377,MCWP 50R,B00,518792,Staff,0,2,20,20
1715633392377,MCWP 50R,C00,518793,Staff,0,4,20,20
1715633392377,MCWP 50R,D00,518794,Staff,0,1,20,20
1715633392377,MCWP 50R,E00,518795,Staff,0,2,20,20
1715633392377,MCWP 50R,F00,518796,Staff,0,1,20,20
1715633392377,MCWP 50R,G00,518797,Staff,0,1,20,20
1715633393407,MMW 12R,A01,514034,Herbst; Matthew,0,2,16,16
1715633393407,MMW 12R,A02,514035,Herbst; Matthew,0,0,16,16
1715633394431,MMW 13R,A01,514037,Staff,0,5,16,16
1715633394431,MMW 13R,A02,514039,Staff,0,5,16,16
1715633394431,MMW 13R,A03,628519,Staff,0,4,16,16
1715633396484,SIO 295LS,A00,523233,Staff,10,0,30,20
1715633397514,SIO 295S,A00,523232,Staff,10,0,30,20
1715633398540,SIOC 290S,A01,637330,Merrifield; Mark A,21,0,30,9
1715633399569,SIOC 291S,A01,637333,Gabriel; Corey John,21,0,30,9
1715633400602,SOCI 117,A01,494376,Staff,0,5,5,5
1715633401628,WES 237B,A00,494380,Staff,10,0,20,10
1715633403694,AESE 279B,A00,494370,Wade; Jon P,0,0,33,33
1715633404723,AIP 97,001,660915,Van Den Einde; Yael Dahlia,9998,0,9999,1
1715633405755,AIP 197,001,627712,Vespa; Emanuel Ignacio,9995,0,9999,4
1715633405755,AIP 197,002,650778,Amir; On,9998,0,9999,1
1715633405755,AIP 197,003,650933,Avenancio-Leon; Carlos,9998,0,9999,1
1715633405755,AIP 197,004,658530,Heyman; Gail D.,9998,0,9999,1
1715633405755,AIP 197,005,658631,Neal; Sonya E,9998,0,9999,1
1715633405755,AIP 197,006,658671,Du; Songzi,9998,0,9999,1
1715633406780,ANAR 135S,A00,494369,Braswell; Geoffrey E.,0,0,0,0
1715633407806,BENG 196,001,628496,Engler; Adam J.,9998,0,9999,1
1715633407806,BENG 196,002,660916,Watson; John Thomas,9999,0,9999,0
1715633408834,BISP 197,001,650773,Wilhelm; James E.,9994,0,9999,5
1715633408834,BISP 197,002,658904,Coleman; Aaron B.,9998,0,9999,1
1715633409864,CAT 124RS,A01,519847,Geibel; William,0,0,20,20
1715633410891,CAT 125RS,A01,515971,Geibel; William,0,0,20,20
1715633411936,CLRE 250,A00,511389,Morris; Sheldon,9992,0,9999,7
1715633412967,CLRE 251,A00,507176,Mehta; Ravindra L.,9992,0,9999,7
1715633412967,CLRE 251,B00,511410,Mehta; Ravindra L.,9998,0,9999,1
1715633413995,CLRE 252,A00,507189,Cuomo; Raphael Eduardo,9994,0,9999,5
1715633415021,CLRE 253,A00,507199,Vaida; Florin,9994,0,9999,5
1715633415021,CLRE 253,B00,507202,Vaida; Florin,9999,0,9999,0
1715633416051,CLRE 259,A00,507211,Patel; Hemal,9996,0,9999,3
1715633417076,CLRE 260,A00,507221,Cuomo; Raphael Eduardo,9999,0,9999,0
1715633418103,CLRE 297,001,507242,Cuomo; Raphael Eduardo,9999,0,9999,0
1715633419131,COGS 197,001,638244,Voytek; Bradley Thomas,9997,0,9999,2
1715633420181,CSE 191,A00,516875,Minnes Kemp; Mor Mia,9991,0,9999,8
1715633421205,CSE 197,001,637388,Minnes Kemp; Mor Mia,9992,0,9999,7
1715633422230,CSS 201S,A01,494383,Mignozzetti; Umberto,35,0,35,0
1715633423257,CSS 202S,A01,494387,Mignozzetti; Umberto,35,0,35,0
1715633424284,DSC 197,001,628532,Eldridge; Justin Matthew,9995,0,9999,4
1715633425311,EAP 100,A00,516065,Staff,9799,0,9999,200
1715633426339,ECE 45,A01,507414,Staff,31,0,60,29
1715633428397,ECE 111,A01,507420,Staff,11,0,50,39
1715633429427,ECE 197,001,548057,Sievenpiper; Daniel F.,9991,0,9999,8
1715633430456,EDS 115,A00,507243,Choi; Bailey Miyeon,7,0,28,21
1715633431483,EDS 117,A01,494379,Staff,0,6,34,34
1715633432512,EDS 125,A00,507246,Hopkins; Megan Beth,8,0,30,22
1715633433539,EDS 128A,A01,507264,Fargason; Sharon Gayle,6,0,26,20
1715633434568,EDS 128B,A01,507293,Pappas; Elizabeth,10,0,30,20
1715633435596,EDS 139,A00,507294,Fargason; Sharon Gayle,10,0,30,20
1715633435596,EDS 139,B00,507313,Pappas; Elizabeth,11,0,30,19
1715633436620,EDS 201,A00,507315,Staff,10,0,30,20
1715633437645,EDS 203,A01,507317,Halter; Christopher P.,10,0,30,20
1715633438749,EDS 204R,A01,507319,Halter; Christopher P.,0,3,30,30
1715633438749,EDS 204R,B01,507331,Heinzman; Erica M.,14,0,30,16
1715633439773,EDS 206R,A00,507332,Staff,0,4,30,30
1715633439773,EDS 206R,B00,507343,Staff,15,0,30,15
1715633440797,EDS 250,A00,507344,Hemans; Patricia Ann Benitez,20,0,40,20
1715633441829,EDS 281,A00,507345,Daly; Alan J.,18,0,18,0
1715633442852,EDS 284,A00,507350,Daly; Alan J.,16,0,16,0
1715633443878,EDS 286,A00,507359,Fine; Sarah,18,0,18,0
1715633444912,EDS 289C,A01,507361,Daly; Alan J.,18,0,18,0
1715633445938,EDS 290,A00,507366,Hofstetter; Carolyn,15,0,15,0
1715633446968,LIGM 5A,A00,507421,Fischer-Grunski; Eva K,17,0,20,3
1715633447993,LIGM 5B,A00,507423,Fischer-Grunski; Eva K,19,0,20,1
1715633449022,LIGM 5C,A00,507425,Fischer-Grunski; Eva K,19,0,20,1
1715633450054,LIIT 5AS,A00,507427,Carnelos; Chiara,20,0,20,0
1715633451081,LIIT 5BS,A00,507430,Carnelos; Chiara,20,0,20,0
1715633452106,LIIT 5CS,A00,507432,Carnelos; Chiara,20,0,20,0
1715633453131,LISP 5A,A00,507541,Munoz Sanchez; Alicia,11,0,20,9
1715633454159,LISP 5B,A00,507671,Munoz Sanchez; Alicia,9,0,20,11
1715633455187,LISP 5C,A00,507696,Munoz Sanchez; Alicia,9,0,20,11
1715633456212,MAE 197,001,528363,Boechler; Nicholas Sebastia,9998,0,9999,1
1715633457243,MATH 197,001,523477,Kedlaya; Kiran S.,9994,0,9999,5
1715633457243,MATH 197,002,563811,Zhang; Danna,9994,0,9999,5
1715633457243,MATH 197,003,628552,Dumitriu; Ioana,9998,0,9999,1
1715633457243,MATH 197,004,660885,Floyd; Eric,9998,0,9999,1
1715633458269,MCWP 40R,A00,518780,Staff,2,0,20,18
1715633458269,MCWP 40R,B00,518781,Staff,11,0,20,9
1715633458269,MCWP 40R,C00,518783,Staff,5,0,20,15
1715633459294,MCWP 50R,A00,518791,Staff,0,1,20,20
1715633459294,MCWP 50R,B00,518792,Staff,0,2,20,20
1715633459294,MCWP 50R,C00,518793,Staff,0,4,20,20
1715633459294,MCWP 50R,D00,518794,Staff,0,1,20,20
1715633459294,MCWP 50R,E00,518795,Staff,0,2,20,20
1715633459294,MCWP 50R,F00,518796,Staff,0,1,20,20
1715633459294,MCWP 50R,G00,518797,Staff,0,1,20,20
1715633460320,MMW 12R,A01,514034,Herbst; Matthew,0,2,16,16
1715633460320,MMW 12R,A02,514035,Herbst; Matthew,0,0,16,16
1715633461346,MMW 13R,A01,514037,Staff,0,5,16,16
1715633461346,MMW 13R,A02,514039,Staff,0,5,16,16
1715633461346,MMW 13R,A03,628519,Staff,0,4,16,16
1715633463395,SIO 295LS,A00,523233,Staff,10,0,30,20
1715633464420,SIO 295S,A00,523232,Staff,10,0,30,20
1715633465450,SIOC 290S,A01,637330,Merrifield; Mark A,21,0,30,9
1715633466475,SIOC 291S,A01,637333,Gabriel; Corey John,21,0,30,9
1715633467503,SOCI 117,A01,494376,Staff,0,5,5,5
1715633468533,WES 237B,A00,494380,Staff,10,0,20,10
1715633470629,AESE 279B,A00,494370,Wade; Jon P,0,0,33,33
1715633471655,AIP 97,001,660915,Van Den Einde; Yael Dahlia,9998,0,9999,1
1715633472682,AIP 197,001,627712,Vespa; Emanuel Ignacio,9995,0,9999,4
1715633472682,AIP 197,002,650778,Amir; On,9998,0,9999,1
1715633472682,AIP 197,003,650933,Avenancio-Leon; Carlos,9998,0,9999,1
1715633472682,AIP 197,004,658530,Heyman; Gail D.,9998,0,9999,1
1715633472682,AIP 197,005,658631,Neal; Sonya E,9998,0,9999,1
1715633472682,AIP 197,006,658671,Du; Songzi,9998,0,9999,1
1715633473710,ANAR 135S,A00,494369,Braswell; Geoffrey E.,0,0,0,0
1715633474738,BENG 196,001,628496,Engler; Adam J.,9998,0,9999,1
1715633474738,BENG 196,002,660916,Watson; John Thomas,9999,0,9999,0
1715633475768,BISP 197,001,650773,Wilhelm; James E.,9994,0,9999,5
1715633475768,BISP 197,002,658904,Coleman; Aaron B.,9998,0,9999,1
1715633476792,CAT 124RS,A01,519847,Geibel; William,0,0,20,20
1715633477817,CAT 125RS,A01,515971,Geibel; William,0,0,20,20
1715633478846,CLRE 250,A00,511389,Morris; Sheldon,9992,0,9999,7
1715633479872,CLRE 251,A00,507176,Mehta; Ravindra L.,9992,0,9999,7
1715633479872,CLRE 251,B00,511410,Mehta; Ravindra L.,9998,0,9999,1
1715633480900,CLRE 252,A00,507189,Cuomo; Raphael Eduardo,9994,0,9999,5
1715633481926,CLRE 253,A00,507199,Vaida; Florin,9994,0,9999,5
1715633481926,CLRE 253,B00,507202,Vaida; Florin,9999,0,9999,0
1715633482953,CLRE 259,A00,507211,Patel; Hemal,9996,0,9999,3
1715633483977,CLRE 260,A00,507221,Cuomo; Raphael Eduardo,9999,0,9999,0
1715633485002,CLRE 297,001,507242,Cuomo; Raphael Eduardo,9999,0,9999,0
1715633486027,COGS 197,001,638244,Voytek; Bradley Thomas,9997,0,9999,2
1715633487051,CSE 191,A00,516875,Minnes Kemp; Mor Mia,9991,0,9999,8
1715633488075,CSE 197,001,637388,Minnes Kemp; Mor Mia,9992,0,9999,7
1715633489100,CSS 201S,A01,494383,Mignozzetti; Umberto,35,0,35,0
1715633490125,CSS 202S,A01,494387,Mignozzetti; Umberto,35,0,35,0
1715633491152,DSC 197,001,628532,Eldridge; Justin Matthew,9995,0,9999,4
1715633492178,EAP 100,A00,516065,Staff,9799,0,9999,200
1715633493206,ECE 45,A01,507414,Staff,31,0,60,29
1715633495260,ECE 111,A01,507420,Staff,11,0,50,39
1715633496284,ECE 197,001,548057,Sievenpiper; Daniel F.,9991,0,9999,8
1715633497313,EDS 115,A00,507243,Choi; Bailey Miyeon,7,0,28,21
1715633498340,EDS 117,A01,494379,Staff,0,6,34,34
1715633499367,EDS 125,A00,507246,Hopkins; Megan Beth,8,0,30,22
1715633500397,EDS 128A,A01,507264,Fargason; Sharon Gayle,6,0,26,20
1715633501422,EDS 128B,A01,507293,Pappas; Elizabeth,10,0,30,20
1715633502449,EDS 139,A00,507294,Fargason; Sharon Gayle,10,0,30,20
1715633502449,EDS 139,B00,507313,Pappas; Elizabeth,11,0,30,19
1715633503479,EDS 201,A00,507315,Staff,10,0,30,20
1715633504504,EDS 203,A01,507317,Halter; Christopher P.,10,0,30,20
1715633505535,EDS 204R,A01,507319,Halter; Christopher P.,0,3,30,30
1715633505535,EDS 204R,B01,507331,Heinzman; Erica M.,14,0,30,16
1715633506558,EDS 206R,A00,507332,Staff,0,4,30,30
1715633506558,EDS 206R,B00,507343,Staff,15,0,30,15
1715633507588,EDS 250,A00,507344,Hemans; Patricia Ann Benitez,20,0,40,20
1715633508618,EDS 281,A00,507345,Daly; Alan J.,18,0,18,0
1715633509642,EDS 284,A00,507350,Daly; Alan J.,16,0,16,0
1715633510847,EDS 286,A00,507359,Fine; Sarah,18,0,18,0
1715633511874,EDS 289C,A01,507361,Daly; Alan J.,18,0,18,0
1715633512903,EDS 290,A00,507366,Hofstetter; Carolyn,15,0,15,0
1715633513928,LIGM 5A,A00,507421,Fischer-Grunski; Eva K,17,0,20,3
1715633514952,LIGM 5B,A00,507423,Fischer-Grunski; Eva K,19,0,20,1
1715633515983,LIGM 5C,A00,507425,Fischer-Grunski; Eva K,19,0,20,1
1715633517012,LIIT 5AS,A00,507427,Carnelos; Chiara,20,0,20,0
1715633518037,LIIT 5BS,A00,507430,Carnelos; Chiara,20,0,20,0
1715633519063,LIIT 5CS,A00,507432,Carnelos; Chiara,20,0,20,0
1715633520092,LISP 5A,A00,507541,Munoz Sanchez; Alicia,11,0,20,9
1715633521116,LISP 5B,A00,507671,Munoz Sanchez; Alicia,9,0,20,11
1715633522144,LISP 5C,A00,507696,Munoz Sanchez; Alicia,9,0,20,11
1715633523168,MAE 197,001,528363,Boechler; Nicholas Sebastia,9998,0,9999,1
1715633524197,MATH 197,001,523477,Kedlaya; Kiran S.,9994,0,9999,5
1715633524197,MATH 197,002,563811,Zhang; Danna,9994,0,9999,5
1715633524197,MATH 197,003,628552,Dumitriu; Ioana,9998,0,9999,1
1715633524197,MATH 197,004,660885,Floyd; Eric,9998,0,9999,1
1715633525224,MCWP 40R,A00,518780,Staff,2,0,20,18
1715633525224,MCWP 40R,B00,518781,Staff,11,0,20,9
1715633525224,MCWP 40R,C00,518783,Staff,5,0,20,15
1715633526251,MCWP 50R,A00,518791,Staff,0,1,20,20
1715633526251,MCWP 50R,B00,518792,Staff,0,2,20,20
1715633526251,MCWP 50R,C00,518793,Staff,0,4,20,20
1715633526251,MCWP 50R,D00,518794,Staff,0,1,20,20
1715633526251,MCWP 50R,E00,518795,Staff,0,2,20,20
1715633526251,MCWP 50R,F00,518796,Staff,0,1,20,20
1715633526251,MCWP 50R,G00,518797,Staff,0,1,20,20
1715633527275,MMW 12R,A01,514034,Herbst; Matthew,0,2,16,16
1715633527275,MMW 12R,A02,514035,Herbst; Matthew,0,0,16,16
1715633528300,MMW 13R,A01,514037,Staff,0,5,16,16
1715633528300,MMW 13R,A02,514039,Staff,0,5,16,16
1715633528300,MMW 13R,A03,628519,Staff,0,4,16,16
1715633530358,SIO 295LS,A00,523233,Staff,10,0,30,20
1715633531387,SIO 295S,A00,523232,Staff,10,0,30,20
1715633532415,SIOC 290S,A01,637330,Merrifield; Mark A,21,0,30,9
1715633533443,SIOC 291S,A01,637333,Gabriel; Corey John,21,0,30,9
1715633534472,SOCI 117,A01,494376,Staff,0,5,5,5
1715633535499,WES 237B,A00,494380,Staff,10,0,20,10
1715633537571,AESE 279B,A00,494370,Wade; Jon P,0,0,33,33
1715633538599,AIP 97,001,660915,Van Den Einde; Yael Dahlia,9998,0,9999,1
1715633539627,AIP 197,001,627712,Vespa; Emanuel Ignacio,9995,0,9999,4
1715633539627,AIP 197,002,650778,Amir; On,9998,0,9999,1
1715633539627,AIP 197,003,650933,Avenancio-Leon; Carlos,9998,0,9999,1
1715633539627,AIP 197,004,658530,Heyman; Gail D.,9998,0,9999,1
1715633539627,AIP 197,005,658631,Neal; Sonya E,9998,0,9999,1
1715633539627,AIP 197,006,658671,Du; Songzi,9998,0,9999,1
1715633540655,ANAR 135S,A00,494369,Braswell; Geoffrey E.,0,0,0,0
1715633541684,BENG 196,001,628496,Engler; Adam J.,9998,0,9999,1
1715633541684,BENG 196,002,660916,Watson; John Thomas,9999,0,9999,0
1715633542712,BISP 197,001,650773,Wilhelm; James E.,9994,0,9999,5
1715633542712,BISP 197,002,658904,Coleman; Aaron B.,9998,0,9999,1
1715633543739,CAT 124RS,A01,519847,Geibel; William,0,0,20,20
1715633544765,CAT 125RS,A01,515971,Geibel; William,0,0,20,20
1715633545793,CLRE 250,A00,511389,Morris; Sheldon,9992,0,9999,7
1715633546824,CLRE 251,A00,507176,Mehta; Ravindra L.,9992,0,9999,7
1715633546824,CLRE 251,B00,511410,Mehta; Ravindra L.,9998,0,9999,1
1715633547848,CLRE 252,A00,507189,Cuomo; Raphael Eduardo,9994,0,9999,5
1715633548871,CLRE 253,A00,507199,Vaida; Florin,9994,0,9999,5
1715633548871,CLRE 253,B00,507202,Vaida; Florin,9999,0,9999,0
1715633549899,CLRE 259,A00,507211,Patel; Hemal,9996,0,9999,3
1715633550925,CLRE 260,A00,507221,Cuomo; Raphael Eduardo,9999,0,9999,0
1715633551950,CLRE 297,001,507242,Cuomo; Raphael Eduardo,9999,0,9999,0
1715633552978,COGS 197,001,638244,Voytek; Bradley Thomas,9997,0,9999,2
1715633554033,CSE 191,A00,516875,Minnes Kemp; Mor Mia,9991,0,9999,8
1715633555160,CSE 197,001,637388,Minnes Kemp; Mor Mia,9992,0,9999,7
1715633556253,CSS 201S,A01,494383,Mignozzetti; Umberto,35,0,35,0
1715633557578,CSS 202S,A01,494387,Mignozzetti; Umberto,35,0,35,0
1715633558675,DSC 197,001,628532,Eldridge; Justin Matthew,9995,0,9999,4
1715633559740,EAP 100,A00,516065,Staff,9799,0,9999,200
1715633560839,ECE 45,A01,507414,Staff,31,0,60,29
1715633563040,ECE 111,A01,507420,Staff,11,0,50,39
1715633564157,ECE 197,001,548057,Sievenpiper; Daniel F.,9991,0,9999,8
1715633565233,EDS 115,A00,507243,Choi; Bailey Miyeon,7,0,28,21
1715633566291,EDS 117,A01,494379,Staff,0,6,34,34
1715633567666,EDS 125,A00,507246,Hopkins; Megan Beth,8,0,30,22
1715633568770,EDS 128A,A01,507264,Fargason; Sharon Gayle,6,0,26,20
1715633569877,EDS 128B,A01,507293,Pappas; Elizabeth,10,0,30,20
1715633570957,EDS 139,A00,507294,Fargason; Sharon Gayle,10,0,30,20
1715633570957,EDS 139,B00,507313,Pappas; Elizabeth,11,0,30,19
1715633572051,EDS 201,A00,507315,Staff,10,0,30,20
1715633573165,EDS 203,A01,507317,Halter; Christopher P.,10,0,30,20
1715633574243,EDS 204R,A01,507319,Halter; Christopher P.,0,3,30,30
1715633574243,EDS 204R,B01,507331,Heinzman; Erica M.,14,0,30,16
1715633575345,EDS 206R,A00,507332,Staff,0,4,30,30
1715633575345,EDS 206R,B00,507343,Staff,15,0,30,15
1715633576435,EDS 250,A00,507344,Hemans; Patricia Ann Benitez,20,0,40,20
1715633577551,EDS 281,A00,507345,Daly; Alan J.,18,0,18,0
1715633578665,EDS 284,A00,507350,Daly; Alan J.,16,0,16,0
1715633579765,EDS 286,A00,507359,Fine; Sarah,18,0,18,0
1715633580849,EDS 289C,A01,507361,Daly; Alan J.,18,0,18,0
1715633581947,EDS 290,A00,507366,Hofstetter; Carolyn,15,0,15,0
1715633583042,LIGM 5A,A00,507421,Fischer-Grunski; Eva K,17,0,20,3
1715633584157,LIGM 5B,A00,507423,Fischer-Grunski; Eva K,19,0,20,1
1715633585300,LIGM 5C,A00,507425,Fischer-Grunski; Eva K,19,0,20,1
1715633586384,LIIT 5AS,A00,507427,Carnelos; Chiara,20,0,20,0
1715633587486,LIIT 5BS,A00,507430,Carnelos; Chiara,20,0,20,0
1715633588582,LIIT 5CS,A00,507432,Carnelos; Chiara,20,0,20,0
1715633589657,LISP 5A,A00,507541,Munoz Sanchez; Alicia,11,0,20,9
1715633590778,LISP 5B,A00,507671,Munoz Sanchez; Alicia,9,0,20,11
1715633592050,LISP 5C,A00,507696,Munoz Sanchez; Alicia,9,0,20,11
1715633593165,MAE 197,001,528363,Boechler; Nicholas Sebastia,9998,0,9999,1
1715633594265,MATH 197,001,523477,Kedlaya; Kiran S.,9994,0,9999,5
1715633594265,MATH 197,002,563811,Zhang; Danna,9994,0,9999,5
1715633594265,MATH 197,003,628552,Dumitriu; Ioana,9998,0,9999,1
1715633594265,MATH 197,004,660885,Floyd; Eric,9998,0,9999,1
1715633595392,MCWP 40R,A00,518780,Staff,2,0,20,18
1715633595392,MCWP 40R,B00,518781,Staff,11,0,20,9
1715633595392,MCWP 40R,C00,518783,Staff,5,0,20,15
1715633596458,MCWP 50R,A00,518791,Staff,0,1,20,20
1715633596458,MCWP 50R,B00,518792,Staff,0,2,20,20
1715633596458,MCWP 50R,C00,518793,Staff,0,4,20,20
1715633596458,MCWP 50R,D00,518794,Staff,0,1,20,20
1715633596458,MCWP 50R,E00,518795,Staff,0,2,20,20
1715633596458,MCWP 50R,F00,518796,Staff,0,1,20,20
1715633596458,MCWP 50R,G00,518797,Staff,0,1,20,20
1715633597939,MMW 12R,A01,514034,Herbst; Matthew,0,2,16,16
1715633597939,MMW 12R,A02,514035,Herbst; Matthew,0,0,16,16
1715633599259,MMW 13R,A01,514037,Staff,0,5,16,16
1715633599259,MMW 13R,A02,514039,Staff,0,5,16,16
1715633599259,MMW 13R,A03,628519,Staff,0,4,16,16
1715633601641,SIO 295LS,A00,523233,Staff,10,0,30,20
1715633602882,SIO 295S,A00,523232,Staff,10,0,30,20
1715633604097,SIOC 290S,A01,637330,Merrifield; Mark A,21,0,30,9
1715633605499,SIOC 291S,A01,637333,Gabriel; Corey John,21,0,30,9
1715633606759,SOCI 117,A01,494376,Staff,0,5,5,5
1715633607984,WES 237B,A00,494380,Staff,10,0,20,10
1715633610335,AESE 279B,A00,494370,Wade; Jon P,0,0,33,33
1715633611383,AIP 97,001,660915,Van Den Einde; Yael Dahlia,9998,0,9999,1
1715633612474,AIP 197,001,627712,Vespa; Emanuel Ignacio,9995,0,9999,4
1715633612474,AIP 197,002,650778,Amir; On,9998,0,9999,1
1715633612474,AIP 197,003,650933,Avenancio-Leon; Carlos,9998,0,9999,1
1715633612474,AIP 197,004,658530,Heyman; Gail D.,9998,0,9999,1
1715633612474,AIP 197,005,658631,Neal; Sonya E,9998,0,9999,1
1715633612474,AIP 197,006,658671,Du; Songzi,9998,0,9999,1
1715633613609,ANAR 135S,A00,494369,Braswell; Geoffrey E.,0,0,0,0
1715633614818,BENG 196,001,628496,Engler; Adam J.,9998,0,9999,1
1715633614818,BENG 196,002,660916,Watson; John Thomas,9999,0,9999,0
1715633615949,BISP 197,001,650773,Wilhelm; James E.,9994,0,9999,5
1715633615949,BISP 197,002,658904,Coleman; Aaron B.,9998,0,9999,1
1715633617081,CAT 124RS,A01,519847,Geibel; William,0,0,20,20
1715633618192,CAT 125RS,A01,515971,Geibel; William,0,0,20,20
1715633619259,CLRE 250,A00,511389,Morris; Sheldon,9992,0,9999,7
1715633620436,CLRE 251,A00,507176,Mehta; Ravindra L.,9992,0,9999,7
1715633620436,CLRE 251,B00,511410,Mehta; Ravindra L.,9998,0,9999,1
1715633621518,CLRE 252,A00,507189,Cuomo; Raphael Eduardo,9994,0,9999,5
1715633622620,CLRE 253,A00,507199,Vaida; Florin,9994,0,9999,5
1715633622620,CLRE 253,B00,507202,Vaida; Florin,9999,0,9999,0
1715633623718,CLRE 259,A00,507211,Patel; Hemal,9996,0,9999,3
1715633624920,CLRE 260,A00,507221,Cuomo; Raphael Eduardo,9999,0,9999,0
1715633626094,CLRE 297,001,507242,Cuomo; Raphael Eduardo,9999,0,9999,0
1715633627274,COGS 197,001,638244,Voytek; Bradley Thomas,9997,0,9999,2
1715633628439,CSE 191,A00,516875,Minnes Kemp; Mor Mia,9991,0,9999,8
1715633629730,CSE 197,001,637388,Minnes Kemp; Mor Mia,9992,0,9999,7
1715633631122,CSS 201S,A01,494383,Mignozzetti; Umberto,35,0,35,0
1715633632328,CSS 202S,A01,494387,Mignozzetti; Umberto,35,0,35,0
1715633634111,DSC 197,001,628532,Eldridge; Justin Matthew,9995,0,9999,4
1715633635596,EAP 100,A00,516065,Staff,9799,0,9999,200
1715633637392,ECE 45,A01,507414,Staff,31,0,60,29
1715633641475,ECE 111,A01,507420,Staff,11,0,50,39
1715633644588,ECE 197,001,548057,Sievenpiper; Daniel F.,9991,0,9999,8
1715633646163,EDS 115,A00,507243,Choi; Bailey Miyeon,7,0,28,21
1715633647504,EDS 117,A01,494379,Staff,0,6,34,34
1715633649030,EDS 125,A00,507246,Hopkins; Megan Beth,8,0,30,22
1715633650194,EDS 128A,A01,507264,Fargason; Sharon Gayle,6,0,26,20
1715633651613,EDS 128B,A01,507293,Pappas; Elizabeth,10,0,30,20
1715633652829,EDS 139,A00,507294,Fargason; Sharon Gayle,10,0,30,20
1715633652829,EDS 139,B00,507313,Pappas; Elizabeth,11,0,30,19
1715633654061,EDS 201,A00,507315,Staff,10,0,30,20
1715633655209,EDS 203,A01,507317,Halter; Christopher P.,10,0,30,20
1715633656574,EDS 204R,A01,507319,Halter; Christopher P.,0,3,30,30
1715633656574,EDS 204R,B01,507331,Heinzman; Erica M.,14,0,30,16
1715633657798,EDS 206R,A00,507332,Staff,0,4,30,30
1715633657798,EDS 206R,B00,507343,Staff,15,0,30,15
1715633659024,EDS 250,A00,507344,Hemans; Patricia Ann Benitez,20,0,40,20
1715633660211,EDS 281,A00,507345,Daly; Alan J.,18,0,18,0
1715633661403,EDS 284,A00,507350,Daly; Alan J.,16,0,16,0
1715633662568,EDS 286,A00,507359,Fine; Sarah,18,0,18,0
1715633663797,EDS 289C,A01,507361,Daly; Alan J.,18,0,18,0
1715633665118,EDS 290,A00,507366,Hofstetter; Carolyn,15,0,15,0
1715633666549,LIGM 5A,A00,507421,Fischer-Grunski; Eva K,17,0,20,3
1715633667921,LIGM 5B,A00,507423,Fischer-Grunski; Eva K,19,0,20,1
1715633669287,LIGM 5C,A00,507425,Fischer-Grunski; Eva K,19,0,20,1
1715633670710,LIIT 5AS,A00,507427,Carnelos; Chiara,20,0,20,0
1715633672164,LIIT 5BS,A00,507430,Carnelos; Chiara,20,0,20,0
1715633673600,LIIT 5CS,A00,507432,Carnelos; Chiara,20,0,20,0
1715633674857,LISP 5A,A00,507541,Munoz Sanchez; Alicia,11,0,20,9
1715633676160,LISP 5B,A00,507671,Munoz Sanchez; Alicia,9,0,20,11
1715633677455,LISP 5C,A00,507696,Munoz Sanchez; Alicia,9,0,20,11
1715633678801,MAE 197,001,528363,Boechler; Nicholas Sebastia,9998,0,9999,1
1715633680045,MATH 197,001,523477,Kedlaya; Kiran S.,9994,0,9999,5
1715633680045,MATH 197,002,563811,Zhang; Danna,9994,0,9999,5
1715633680045,MATH 197,003,628552,Dumitriu; Ioana,9998,0,9999,1
1715633680045,MATH 197,004,660885,Floyd; Eric,9998,0,9999,1
1715633681291,MCWP 40R,A00,518780,Staff,2,0,20,18
1715633681291,MCWP 40R,B00,518781,Staff,11,0,20,9
1715633681291,MCWP 40R,C00,518783,Staff,5,0,20,15
1715633682544,MCWP 50R,A00,518791,Staff,0,1,20,20
1715633682544,MCWP 50R,B00,518792,Staff,0,2,20,20
1715633682544,MCWP 50R,C00,518793,Staff,0,4,20,20
1715633682544,MCWP 50R,D00,518794,Staff,0,1,20,20
1715633682544,MCWP 50R,E00,518795,Staff,0,2,20,20
1715633682544,MCWP 50R,F00,518796,Staff,0,1,20,20
1715633682544,MCWP 50R,G00,518797,Staff,0,1,20,20
1715633683892,MMW 12R,A01,514034,Herbst; Matthew,0,2,16,16
1715633683892,MMW 12R,A02,514035,Herbst; Matthew,0,0,16,16
1715633685346,MMW 13R,A01,514037,Staff,0,5,16,16
1715633685346,MMW 13R,A02,514039,Staff,0,5,16,16
1715633685346,MMW 13R,A03,628519,Staff,0,4,16,16
1715633687982,SIO 295LS,A00,523233,Staff,10,0,30,20
1715633689454,SIO 295S,A00,523232,Staff,10,0,30,20
1715633690723,SIOC 290S,A01,637330,Merrifield; Mark A,21,0,30,9
1715633692063,SIOC 291S,A01,637333,Gabriel; Corey John,21,0,30,9
1715633693424,SOCI 117,A01,494376,Staff,0,5,5,5
1715633694750,WES 237B,A00,494380,Staff,10,0,20,10
1715633697490,AESE 279B,A00,494370,Wade; Jon P,0,0,33,33
1715633698682,AIP 97,001,660915,Van Den Einde; Yael Dahlia,9998,0,9999,1
1715633700007,AIP 197,001,627712,Vespa; Emanuel Ignacio,9995,0,9999,4
1715633700007,AIP 197,002,650778,Amir; On,9998,0,9999,1
1715633700007,AIP 197,003,650933,Avenancio-Leon; Carlos,9998,0,9999,1
1715633700007,AIP 197,004,658530,Heyman; Gail D.,9998,0,9999,1
1715633700007,AIP 197,005,658631,Neal; Sonya E,9998,0,9999,1
1715633700007,AIP 197,006,658671,Du; Songzi,9998,0,9999,1
1715633701321,ANAR 135S,A00,494369,Braswell; Geoffrey E.,0,0,0,0
1715633702863,BENG 196,001,628496,Engler; Adam J.,9998,0,9999,1
1715633702863,BENG 196,002,660916,Watson; John Thomas,9999,0,9999,0
1715633704533,BISP 197,001,650773,Wilhelm; James E.,9994,0,9999,5
1715633704533,BISP 197,002,658904,Coleman; Aaron B.,9998,0,9999,1
1715633705648,CAT 124RS,A01,519847,Geibel; William,0,0,20,20
1715633707561,CAT 125RS,A01,515971,Geibel; William,0,0,20,20
1715633709401,CLRE 250,A00,511389,Morris; Sheldon,9992,0,9999,7
1715633711723,CLRE 251,A00,507176,Mehta; Ravindra L.,9992,0,9999,7
1715633711723,CLRE 251,B00,511410,Mehta; Ravindra L.,9998,0,9999,1
1715633713013,CLRE 252,A00,507189,Cuomo; Raphael Eduardo,9994,0,9999,5
1715633714223,CLRE 253,A00,507199,Vaida; Florin,9994,0,9999,5
1715633714223,CLRE 253,B00,507202,Vaida; Florin,9999,0,9999,0
1715633716122,CLRE 259,A00,507211,Patel; Hemal,9996,0,9999,3
1715633717577,CLRE 260,A00,507221,Cuomo; Raphael Eduardo,9999,0,9999,0
1715633719076,CLRE 297,001,507242,Cuomo; Raphael Eduardo,9999,0,9999,0
1715633721024,COGS 197,001,638244,Voytek; Bradley Thomas,9997,0,9999,2
1715633722354,CSE 191,A00,516875,Minnes Kemp; Mor Mia,9991,0,9999,8
1715633724060,CSE 197,001,637388,Minnes Kemp; Mor Mia,9992,0,9999,7
1715633725266,CSS 201S,A01,494383,Mignozzetti; Umberto,35,0,35,0
1715633726557,CSS 202S,A01,494387,Mignozzetti; Umberto,35,0,35,0
1715633727799,DSC 197,001,628532,Eldridge; Justin Matthew,9995,0,9999,4
1715633729255,EAP 100,A00,516065,Staff,9799,0,9999,200
1715633730576,ECE 45,A01,507414,Staff,31,0,60,29
1715633733438,ECE 111,A01,507420,Staff,11,0,50,39
1715633734681,ECE 197,001,548057,Sievenpiper; Daniel F.,9991,0,9999,8
1715633735916,EDS 115,A00,507243,Choi; Bailey Miyeon,7,0,28,21
1715633737241,EDS 117,A01,494379,Staff,0,6,34,34
1715633738394,EDS 125,A00,507246,Hopkins; Megan Beth,8,0,30,22
1715633739682,EDS 128A,A01,507264,Fargason; Sharon Gayle,6,0,26,20
1715633741083,EDS 128B,A01,507293,Pappas; Elizabeth,10,0,30,20
1715633742349,EDS 139,A00,507294,Fargason; Sharon Gayle,10,0,30,20
1715633742349,EDS 139,B00,507313,Pappas; Elizabeth,11,0,30,19
1715633743515,EDS 201,A00,507315,Staff,10,0,30,20
1715633744778,EDS 203,A01,507317,Halter; Christopher P.,10,0,30,20
1715633746019,EDS 204R,A01,507319,Halter; Christopher P.,0,3,30,30
1715633746019,EDS 204R,B01,507331,Heinzman; Erica M.,14,0,30,16
1715633747231,EDS 206R,A00,507332,Staff,0,4,30,30
1715633747231,EDS 206R,B00,507343,Staff,15,0,30,15
1715633748477,EDS 250,A00,507344,Hemans; Patricia Ann Benitez,20,0,40,20
1715633750063,EDS 281,A00,507345,Daly; Alan J.,18,0,18,0
1715633751307,EDS 284,A00,507350,Daly; Alan J.,16,0,16,0
1715633752482,EDS 286,A00,507359,Fine; Sarah,18,0,18,0
1715633753797,EDS 289C,A01,507361,Daly; Alan J.,18,0,18,0
1715633755057,EDS 290,A00,507366,Hofstetter; Carolyn,15,0,15,0
1715633756293,LIGM 5A,A00,507421,Fischer-Grunski; Eva K,17,0,20,3
1715633757856,LIGM 5B,A00,507423,Fischer-Grunski; Eva K,19,0,20,1
1715633759273,LIGM 5C,A00,507425,Fischer-Grunski; Eva K,19,0,20,1
1715633760692,LIIT 5AS,A00,507427,Carnelos; Chiara,20,0,20,0
1715633761948,LIIT 5BS,A00,507430,Carnelos; Chiara,20,0,20,0
1715633763417,LIIT 5CS,A00,507432,Carnelos; Chiara,20,0,20,0
1715633765003,LISP 5A,A00,507541,Munoz Sanchez; Alicia,11,0,20,9
1715633766194,LISP 5B,A00,507671,Munoz Sanchez; Alicia,9,0,20,11
1715633767549,LISP 5C,A00,507696,Munoz Sanchez; Alicia,9,0,20,11
1715633768949,MAE 197,001,528363,Boechler; Nicholas Sebastia,9998,0,9999,1
1715633770132,MATH 197,001,523477,Kedlaya; Kiran S.,9994,0,9999,5
1715633770132,MATH 197,002,563811,Zhang; Danna,9994,0,9999,5
1715633770132,MATH 197,003,628552,Dumitriu; Ioana,9998,0,9999,1
1715633770132,MATH 197,004,660885,Floyd; Eric,9998,0,9999,1
1715633771781,MCWP 40R,A00,518780,Staff,2,0,20,18
1715633771781,MCWP 40R,B00,518781,Staff,11,0,20,9
1715633771781,MCWP 40R,C00,518783,Staff,5,0,20,15
1715633773119,MCWP 50R,A00,518791,Staff,0,1,20,20
1715633773119,MCWP 50R,B00,518792,Staff,0,2,20,20
1715633773119,MCWP 50R,C00,518793,Staff,0,4,20,20
1715633773119,MCWP 50R,D00,518794,Staff,0,1,20,20
1715633773119,MCWP 50R,E00,518795,Staff,0,2,20,20
1715633773119,MCWP 50R,F00,518796,Staff,0,1,20,20
1715633773119,MCWP 50R,G00,518797,Staff,0,1,20,20
1715633774530,MMW 12R,A01,514034,Herbst; Matthew,0,2,16,16
1715633774530,MMW 12R,A02,514035,Herbst; Matthew,0,0,16,16
1715633775881,MMW 13R,A01,514037,Staff,0,5,16,16
1715633775881,MMW 13R,A02,514039,Staff,0,5,16,16
1715633775881,MMW 13R,A03,628519,Staff,0,4,16,16
1715633778798,SIO 295LS,A00,523233,Staff,10,0,30,20
1715633780261,SIO 295S,A00,523232,Staff,10,0,30,20
1715633781544,SIOC 290S,A01,637330,Merrifield; Mark A,21,0,30,9
1715633782736,SIOC 291S,A01,637333,Gabriel; Corey John,21,0,30,9
1715633784263,SOCI 117,A01,494376,Staff,0,5,5,5
1715633786137,WES 237B,A00,494380,Staff,10,0,20,10
1715633788970,AESE 279B,A00,494370,Wade; Jon P,0,0,33,33
1715633790419,AIP 97,001,660915,Van Den Einde; Yael Dahlia,9998,0,9999,1
1715633791854,AIP 197,001,627712,Vespa; Emanuel Ignacio,9995,0,9999,4
1715633791854,AIP 197,002,650778,Amir; On,9998,0,9999,1
1715633791854,AIP 197,003,650933,Avenancio-Leon; Carlos,9998,0,9999,1
1715633791854,AIP 197,004,658530,Heyman; Gail D.,9998,0,9999,1
1715633791854,AIP 197,005,658631,Neal; Sonya E,9998,0,9999,1
1715633791854,AIP 197,006,658671,Du; Songzi,9998,0,9999,1
1715633793150,ANAR 135S,A00,494369,Braswell; Geoffrey E.,0,0,0,0
1715633794751,BENG 196,001,628496,Engler; Adam J.,9998,0,9999,1
1715633794751,BENG 196,002,660916,Watson; John Thomas,9999,0,9999,0
1715633796132,BISP 197,001,650773,Wilhelm; James E.,9994,0,9999,5
1715633796132,BISP 197,002,658904,Coleman; Aaron B.,9998,0,9999,1
1715633797484,CAT 124RS,A01,519847,Geibel; William,0,0,20,20
1715633798977,CAT 125RS,A01,515971,Geibel; William,0,0,20,20
1715633800335,CLRE 250,A00,511389,Morris; Sheldon,9992,0,9999,7
1715633801642,CLRE 251,A00,507176,Mehta; Ravindra L.,9992,0,9999,7
1715633801642,CLRE 251,B00,511410,Mehta; Ravindra L.,9998,0,9999,1
1715633803206,CLRE 252,A00,507189,Cuomo; Raphael Eduardo,9994,0,9999,5
1715633804589,CLRE 253,A00,507199,Vaida; Florin,9994,0,9999,5
1715633804589,CLRE 253,B00,507202,Vaida; Florin,9999,0,9999,0
1715633806127,CLRE 259,A00,507211,Patel; Hemal,9996,0,9999,3
1715633807466,CLRE 260,A00,507221,Cuomo; Raphael Eduardo,9999,0,9999,0
1715633808686,CLRE 297,001,507242,Cuomo; Raphael Eduardo,9999,0,9999,0
1715633810033,COGS 197,001,638244,Voytek; Bradley Thomas,9997,0,9999,2
1715633811467,CSE 191,A00,516875,Minnes Kemp; Mor Mia,9991,0,9999,8
1715633812603,CSE 197,001,637388,Minnes Kemp; Mor Mia,9992,0,9999,7
1715633813975,CSS 201S,A01,494383,Mignozzetti; Umberto,35,0,35,0
1715633815455,CSS 202S,A01,494387,Mignozzetti; Umberto,35,0,35,0
1715633816767,DSC 197,001,628532,Eldridge; Justin Matthew,9995,0,9999,4
1715633818322,EAP 100,A00,516065,Staff,9799,0,9999,200
1715633819699,ECE 45,A01,507414,Staff,31,0,60,29
1715633822584,ECE 111,A01,507420,Staff,11,0,50,39
1715633823838,ECE 197,001,548057,Sievenpiper; Daniel F.,9991,0,9999,8
1715633825118,EDS 115,A00,507243,Choi; Bailey Miyeon,7,0,28,21
1715633826425,EDS 117,A01,494379,Staff,0,6,34,34
1715633827822,EDS 125,A00,507246,Hopkins; Megan Beth,8,0,30,22
1715633829139,EDS 128A,A01,507264,Fargason; Sharon Gayle,6,0,26,20
1715633830473,EDS 128B,A01,507293,Pappas; Elizabeth,10,0,30,20
1715633831873,EDS 139,A00,507294,Fargason; Sharon Gayle,10,0,30,20
1715633831873,EDS 139,B00,507313,Pappas; Elizabeth,11,0,30,19
1715633833169,EDS 201,A00,507315,Staff,10,0,30,20
1715633834502,EDS 203,A01,507317,Halter; Christopher P.,10,0,30,20
1715633835804,EDS 204R,A01,507319,Halter; Christopher P.,0,3,30,30
1715633835804,EDS 204R,B01,507331,Heinzman; Erica M.,14,0,30,16
1715633837159,EDS 206R,A00,507332,Staff,0,4,30,30
1715633837159,EDS 206R,B00,507343,Staff,15,0,30,15
1715633838519,EDS 250,A00,507344,Hemans; Patricia Ann Benitez,20,0,40,20
1715633839988,EDS 281,A00,507345,Daly; Alan J.,18,0,18,0
1715633841423,EDS 284,A00,507350,Daly; Alan J.,16,0,16,0
1715633842791,EDS 286,A00,507359,Fine; Sarah,18,0,18,0
1715633844077,EDS 289C,A01,507361,Daly; Alan J.,18,0,18,0
1715633845509,EDS 290,A00,507366,Hofstetter; Carolyn,15,0,15,0
1715633846977,LIGM 5A,A00,507421,Fischer-Grunski; Eva K,17,0,20,3
1715633848510,LIGM 5B,A00,507423,Fischer-Grunski; Eva K,19,0,20,1
1715633850439,LIGM 5C,A00,507425,Fischer-Grunski; Eva K,19,0,20,1
1715633851902,LIIT 5AS,A00,507427,Carnelos; Chiara,20,0,20,0
1715633853284,LIIT 5BS,A00,507430,Carnelos; Chiara,20,0,20,0
1715633854525,LIIT 5CS,A00,507432,Carnelos; Chiara,20,0,20,0
1715633856275,LISP 5A,A00,507541,Munoz Sanchez; Alicia,11,0,20,9
1715633857436,LISP 5B,A00,507671,Munoz Sanchez; Alicia,9,0,20,11
1715633858592,LISP 5C,A00,507696,Munoz Sanchez; Alicia,9,0,20,11
1715633859751,MAE 197,001,528363,Boechler; Nicholas Sebastia,9998,0,9999,1
1715633860817,MATH 197,001,523477,Kedlaya; Kiran S.,9994,0,9999,5
1715633860817,MATH 197,002,563811,Zhang; Danna,9994,0,9999,5
1715633860817,MATH 197,003,628552,Dumitriu; Ioana,9998,0,9999,1
1715633860817,MATH 197,004,660885,Floyd; Eric,9998,0,9999,1
1715633861960,MCWP 40R,A00,518780,Staff,2,0,20,18
1715633861960,MCWP 40R,B00,518781,Staff,11,0,20,9
1715633861960,MCWP 40R,C00,518783,Staff,5,0,20,15
1715633863080,MCWP 50R,A00,518791,Staff,0,1,20,20
1715633863080,MCWP 50R,B00,518792,Staff,0,2,20,20
1715633863080,MCWP 50R,C00,518793,Staff,0,4,20,20
1715633863080,MCWP 50R,D00,518794,Staff,0,1,20,20
1715633863080,MCWP 50R,E00,518795,Staff,0,2,20,20
1715633863080,MCWP 50R,F00,518796,Staff,0,1,20,20
1715633863080,MCWP 50R,G00,518797,Staff,0,1,20,20
1715633864244,MMW 12R,A01,514034,Herbst; Matthew,0,2,16,16
1715633864244,MMW 12R,A02,514035,Herbst; Matthew,0,0,16,16
1715633865560,MMW 13R,A01,514037,Staff,0,5,16,16
1715633865560,MMW 13R,A02,514039,Staff,0,5,16,16
1715633865560,MMW 13R,A03,628519,Staff,0,4,16,16
1715633867915,SIO 295LS,A00,523233,Staff,10,0,30,20
1715633869177,SIO 295S,A00,523232,Staff,10,0,30,20
1715633870350,SIOC 290S,A01,637330,Merrifield; Mark A,21,0,30,9
1715633871519,SIOC 291S,A01,637333,Gabriel; Corey John,21,0,30,9
1715633872705,SOCI 117,A01,494376,Staff,0,5,5,5
1715633873885,WES 237B,A00,494380,Staff,10,0,20,10
1715633876383,AESE 279B,A00,494370,Wade; Jon P,0,0,33,33
1715633878025,AIP 97,001,660915,Van Den Einde; Yael Dahlia,9998,0,9999,1
1715633879166,AIP 197,001,627712,Vespa; Emanuel Ignacio,9995,0,9999,4
1715633879166,AIP 197,002,650778,Amir; On,9998,0,9999,1
1715633879166,AIP 197,003,650933,Avenancio-Leon; Carlos,9998,0,9999,1
1715633879166,AIP 197,004,658530,Heyman; Gail D.,9998,0,9999,1
1715633879166,AIP 197,005,658631,Neal; Sonya E,9998,0,9999,1
1715633879166,AIP 197,006,658671,Du; Songzi,9998,0,9999,1
1715633880633,ANAR 135S,A00,494369,Braswell; Geoffrey E.,0,0,0,0
1715633881705,BENG 196,001,628496,Engler; Adam J.,9998,0,9999,1
1715633881705,BENG 196,002,660916,Watson; John Thomas,9999,0,9999,0
1715633882874,BISP 197,001,650773,Wilhelm; James E.,9994,0,9999,5
1715633882874,BISP 197,002,658904,Coleman; Aaron B.,9998,0,9999,1
1715633884197,CAT 124RS,A01,519847,Geibel; William,0,0,20,20
1715633885374,CAT 125RS,A01,515971,Geibel; William,0,0,20,20
1715633886772,CLRE 250,A00,511389,Morris; Sheldon,9992,0,9999,7
1715633888140,CLRE 251,A00,507176,Mehta; Ravindra L.,9992,0,9999,7
1715633888140,CLRE 251,B00,511410,Mehta; Ravindra L.,9998,0,9999,1
1715633889381,CLRE 252,A00,507189,Cuomo; Raphael Eduardo,9994,0,9999,5
1715633890593,CLRE 253,A00,507199,Vaida; Florin,9994,0,9999,5
1715633890593,CLRE 253,B00,507202,Vaida; Florin,9999,0,9999,0
1715633891771,CLRE 259,A00,507211,Patel; Hemal,9996,0,9999,3
1715633892978,CLRE 260,A00,507221,Cuomo; Raphael Eduardo,9999,0,9999,0
1715633894388,CLRE 297,001,507242,Cuomo; Raphael Eduardo,9999,0,9999,0
1715633895788,COGS 197,001,638244,Voytek; Bradley Thomas,9997,0,9999,2
1715633897040,CSE 191,A00,516875,Minnes Kemp; Mor Mia,9991,0,9999,8
1715633898275,CSE 197,001,637388,Minnes Kemp; Mor Mia,9992,0,9999,7
1715633899453,CSS 201S,A01,494383,Mignozzetti; Umberto,35,0,35,0
1715633900527,CSS 202S,A01,494387,Mignozzetti; Umberto,35,0,35,0
1715633901791,DSC 197,001,628532,Eldridge; Justin Matthew,9995,0,9999,4
1715633902998,EAP 100,A00,516065,Staff,9799,0,9999,200
1715633904175,ECE 45,A01,507414,Staff,31,0,60,29
1715633906548,ECE 111,A01,507420,Staff,11,0,50,39
1715633907764,ECE 197,001,548057,Sievenpiper; Daniel F.,9991,0,9999,8
1715633908948,EDS 115,A00,507243,Choi; Bailey Miyeon,7,0,28,21
1715633910193,EDS 117,A01,494379,Staff,0,6,34,34
1715633911628,EDS 125,A00,507246,Hopkins; Megan Beth,8,0,30,22
1715633912856,EDS 128A,A01,507264,Fargason; Sharon Gayle,6,0,26,20
1715633914149,EDS 128B,A01,507293,Pappas; Elizabeth,10,0,30,20
1715633915426,EDS 139,A00,507294,Fargason; Sharon Gayle,10,0,30,20
1715633915426,EDS 139,B00,507313,Pappas; Elizabeth,11,0,30,19
1715633916782,EDS 201,A00,507315,Staff,10,0,30,20
1715633918006,EDS 203,A01,507317,Halter; Christopher P.,10,0,30,20
1715633919327,EDS 204R,A01,507319,Halter; Christopher P.,0,3,30,30
1715633919327,EDS 204R,B01,507331,Heinzman; Erica M.,14,0,30,16
1715633920500,EDS 206R,A00,507332,Staff,0,4,30,30
1715633920500,EDS 206R,B00,507343,Staff,15,0,30,15
1715633921769,EDS 250,A00,507344,Hemans; Patricia Ann Benitez,20,0,40,20
1715633923211,EDS 281,A00,507345,Daly; Alan J.,18,0,18,0
1715633924621,EDS 284,A00,507350,Daly; Alan J.,16,0,16,0
1715633925908,EDS 286,A00,507359,Fine; Sarah,18,0,18,0
1715633927410,EDS 289C,A01,507361,Daly; Alan J.,18,0,18,0
1715633928973,EDS 290,A00,507366,Hofstetter; Carolyn,15,0,15,0
1715633930837,LIGM 5A,A00,507421,Fischer-Grunski; Eva K,17,0,20,3
1715633932169,LIGM 5B,A00,507423,Fischer-Grunski; Eva K,19,0,20,1
1715633933381,LIGM 5C,A00,507425,Fischer-Grunski; Eva K,19,0,20,1
1715633934844,LIIT 5AS,A00,507427,Carnelos; Chiara,20,0,20,0
1715633936201,LIIT 5BS,A00,507430,Carnelos; Chiara,20,0,20,0
1715633937486,LIIT 5CS,A00,507432,Carnelos; Chiara,20,0,20,0
1715633939189,LISP 5A,A00,507541,Munoz Sanchez; Alicia,11,0,20,9
1715633940756,LISP 5B,A00,507671,Munoz Sanchez; Alicia,9,0,20,11
1715633942140,LISP 5C,A00,507696,Munoz Sanchez; Alicia,9,0,20,11
1715633943510,MAE 197,001,528363,Boechler; Nicholas Sebastia,9998,0,9999,1
1715633944853,MATH 197,001,523477,Kedlaya; Kiran S.,9994,0,9999,5
1715633944853,MATH 197,002,563811,Zhang; Danna,9994,0,9999,5
1715633944853,MATH 197,003,628552,Dumitriu; Ioana,9998,0,9999,1
1715633944853,MATH 197,004,660885,Floyd; Eric,9998,0,9999,1
1715633946150,MCWP 40R,A00,518780,Staff,2,0,20,18
1715633946150,MCWP 40R,B00,518781,Staff,11,0,20,9
1715633946150,MCWP 40R,C00,518783,Staff,5,0,20,15
1715633947350,MCWP 50R,A00,518791,Staff,0,1,20,20
1715633947350,MCWP 50R,B00,518792,Staff,0,2,20,20
1715633947350,MCWP 50R,C00,518793,Staff,0,4,20,20
1715633947350,MCWP 50R,D00,518794,Staff,0,1,20,20
1715633947350,MCWP 50R,E00,518795,Staff,0,2,20,20
1715633947350,MCWP 50R,F00,518796,Staff,0,1,20,20
1715633947350,MCWP 50R,G00,518797,Staff,0,1,20,20
1715633948710,MMW 12R,A01,514034,Herbst; Matthew,0,2,16,16
1715633948710,MMW 12R,A02,514035,Herbst; Matthew,0,0,16,16
1715633951544,MMW 13R,A01,514037,Staff,0,5,16,16
1715633951544,MMW 13R,A02,514039,Staff,0,5,16,16
1715633951544,MMW 13R,A03,628519,Staff,0,4,16,16
1715633955180,SIO 295LS,A00,523233,Staff,10,0,30,20
1715633956545,SIO 295S,A00,523232,Staff,10,0,30,20
1715633957960,SIOC 290S,A01,637330,Merrifield; Mark A,21,0,30,9
1715633959304,SIOC 291S,A01,637333,Gabriel; Corey John,21,0,30,9
1715633960643,SOCI 117,A01,494376,Staff,0,5,5,5
1715633962311,WES 237B,A00,494380,Staff,10,0,20,10
1715633965352,AESE 279B,A00,494370,Wade; Jon P,0,0,33,33
1715633966738,AIP 97,001,660915,Van Den Einde; Yael Dahlia,9998,0,9999,1
1715633968170,AIP 197,001,627712,Vespa; Emanuel Ignacio,9995,0,9999,4
1715633968170,AIP 197,002,650778,Amir; On,9998,0,9999,1
1715633968170,AIP 197,003,650933,Avenancio-Leon; Carlos,9998,0,9999,1
1715633968170,AIP 197,004,658530,Heyman; Gail D.,9998,0,9999,1
1715633968170,AIP 197,005,658631,Neal; Sonya E,9998,0,9999,1
1715633968170,AIP 197,006,658671,Du; Songzi,9998,0,9999,1
1715633969629,ANAR 135S,A00,494369,Braswell; Geoffrey E.,0,0,0,0
1715633971074,BENG 196,001,628496,Engler; Adam J.,9998,0,9999,1
1715633971074,BENG 196,002,660916,Watson; John Thomas,9999,0,9999,0
1715633972437,BISP 197,001,650773,Wilhelm; James E.,9994,0,9999,5
1715633972437,BISP 197,002,658904,Coleman; Aaron B.,9998,0,9999,1
1715633973792,CAT 124RS,A01,519847,Geibel; William,0,0,20,20
1715633975162,CAT 125RS,A01,515971,Geibel; William,0,0,20,20
1715633976524,CLRE 250,A00,511389,Morris; Sheldon,9992,0,9999,7
1715633977832,CLRE 251,A00,507176,Mehta; Ravindra L.,9992,0,9999,7
1715633977832,CLRE 251,B00,511410,Mehta; Ravindra L.,9998,0,9999,1
1715633980527,CLRE 252,A00,507189,Cuomo; Raphael Eduardo,9994,0,9999,5
1715633982854,CLRE 253,A00,507199,Vaida; Florin,9994,0,9999,5
1715633982854,CLRE 253,B00,507202,Vaida; Florin,9999,0,9999,0
1715633985041,CLRE 259,A00,507211,Patel; Hemal,9996,0,9999,3
1715633987227,CLRE 260,A00,507221,Cuomo; Raphael Eduardo,9999,0,9999,0
1715633989230,CLRE 297,001,507242,Cuomo; Raphael Eduardo,9999,0,9999,0
1715633991690,COGS 197,001,638244,Voytek; Bradley Thomas,9997,0,9999,2
1715633993761,CSE 191,A00,516875,Minnes Kemp; Mor Mia,9991,0,9999,8
1715633995565,CSE 197,001,637388,Minnes Kemp; Mor Mia,9992,0,9999,7
1715633997595,CSS 201S,A01,494383,Mignozzetti; Umberto,35,0,35,0
1715634000229,CSS 202S,A01,494387,Mignozzetti; Umberto,35,0,35,0
1715634007645,DSC 197,001,628532,Eldridge; Justin Matthew,9995,0,9999,4
1715634011378,EAP 100,A00,516065,Staff,9799,0,9999,200
1715634013346,ECE 45,A01,507414,Staff,31,0,60,29
1715634016957,ECE 111,A01,507420,Staff,11,0,50,39
1715634018775,ECE 197,001,548057,Sievenpiper; Daniel F.,9991,0,9999,8
1715634020548,EDS 115,A00,507243,Choi; Bailey Miyeon,7,0,28,21
1715634022330,EDS 117,A01,494379,Staff,0,6,34,34
1715634023994,EDS 125,A00,507246,Hopkins; Megan Beth,8,0,30,22
1715634025636,EDS 128A,A01,507264,Fargason; Sharon Gayle,6,0,26,20
1715634027503,EDS 128B,A01,507293,Pappas; Elizabeth,10,0,30,20
1715634030113,EDS 139,A00,507294,Fargason; Sharon Gayle,10,0,30,20
1715634030113,EDS 139,B00,507313,Pappas; Elizabeth,11,0,30,19
1715634032417,EDS 201,A00,507315,Staff,10,0,30,20
1715634034328,EDS 203,A01,507317,Halter; Christopher P.,10,0,30,20
1715634035829,EDS 204R,A01,507319,Halter; Christopher P.,0,3,30,30
1715634035829,EDS 204R,B01,507331,Heinzman; Erica M.,14,0,30,16
1715634037722,EDS 206R,A00,507332,Staff,0,4,30,30
1715634037722,EDS 206R,B00,507343,Staff,15,0,30,15
1715634039447,EDS 250,A00,507344,Hemans; Patricia Ann Benitez,20,0,40,20
1715634040827,EDS 281,A00,507345,Daly; Alan J.,18,0,18,0
1715634042084,EDS 284,A00,507350,Daly; Alan J.,16,0,16,0
1715634043670,EDS 286,A00,507359,Fine; Sarah,18,0,18,0
1715634045029,EDS 289C,A01,507361,Daly; Alan J.,18,0,18,0
1715634046526,EDS 290,A00,507366,Hofstetter; Carolyn,15,0,15,0
1715634048171,LIGM 5A,A00,507421,Fischer-Grunski; Eva K,17,0,20,3
1715634049608,LIGM 5B,A00,507423,Fischer-Grunski; Eva K,19,0,20,1
1715634051083,LIGM 5C,A00,507425,Fischer-Grunski; Eva K,19,0,20,1
1715634053880,LIIT 5AS,A00,507427,Carnelos; Chiara,20,0,20,0
1715634055372,LIIT 5BS,A00,507430,Carnelos; Chiara,20,0,20,0
1715634056903,LIIT 5CS,A00,507432,Carnelos; Chiara,20,0,20,0
1715634058579,LISP 5A,A00,507541,Munoz Sanchez; Alicia,11,0,20,9
1715634060781,LISP 5B,A00,507671,Munoz Sanchez; Alicia,9,0,20,11
1715634062747,LISP 5C,A00,507696,Munoz Sanchez; Alicia,9,0,20,11
1715634064308,MAE 197,001,528363,Boechler; Nicholas Sebastia,9998,0,9999,1
1715634066076,MATH 197,001,523477,Kedlaya; Kiran S.,9994,0,9999,5
1715634066076,MATH 197,002,563811,Zhang; Danna,9994,0,9999,5
1715634066076,MATH 197,003,628552,Dumitriu; Ioana,9998,0,9999,1
1715634066076,MATH 197,004,660885,Floyd; Eric,9998,0,9999,1
1715634067456,MCWP 40R,A00,518780,Staff,2,0,20,18
1715634067456,MCWP 40R,B00,518781,Staff,11,0,20,9
1715634067456,MCWP 40R,C00,518783,Staff,5,0,20,15
1715634068696,MCWP 50R,A00,518791,Staff,0,1,20,20
1715634068696,MCWP 50R,B00,518792,Staff,0,2,20,20
1715634068696,MCWP 50R,C00,518793,Staff,0,4,20,20
1715634068696,MCWP 50R,D00,518794,Staff,0,1,20,20
1715634068696,MCWP 50R,E00,518795,Staff,0,2,20,20
1715634068696,MCWP 50R,F00,518796,Staff,0,1,20,20
1715634068696,MCWP 50R,G00,518797,Staff,0,1,20,20
1715634069840,MMW 12R,A01,514034,Herbst; Matthew,0,2,16,16
1715634069840,MMW 12R,A02,514035,Herbst; Matthew,0,0,16,16
1715634071221,MMW 13R,A01,514037,Staff,0,5,16,16
1715634071221,MMW 13R,A02,514039,Staff,0,5,16,16
1715634071221,MMW 13R,A03,628519,Staff,0,4,16,16
1715634073809,SIO 295LS,A00,523233,Staff,10,0,30,20
1715634075633,SIO 295S,A00,523232,Staff,10,0,30,20
1715634077495,SIOC 290S,A01,637330,Merrifield; Mark A,21,0,30,9
1715634079253,SIOC 291S,A01,637333,Gabriel; Corey John,21,0,30,9
1715634080692,SOCI 117,A01,494376,Staff,0,5,5,5
1715634082489,WES 237B,A00,494380,Staff,10,0,20,10
1715634086282,AESE 279B,A00,494370,Wade; Jon P,0,0,33,33
1715634087685,AIP 97,001,660915,Van Den Einde; Yael Dahlia,9998,0,9999,1
1715634089391,AIP 197,001,627712,Vespa; Emanuel Ignacio,9995,0,9999,4
1715634089391,AIP 197,002,650778,Amir; On,9998,0,9999,1
1715634089391,AIP 197,003,650933,Avenancio-Leon; Carlos,9998,0,9999,1
1715634089391,AIP 197,004,658530,Heyman; Gail D.,9998,0,9999,1
1715634089391,AIP 197,005,658631,Neal; Sonya E,9998,0,9999,1
1715634089391,AIP 197,006,658671,Du; Songzi,9998,0,9999,1
1715634091064,ANAR 135S,A00,494369,Braswell; Geoffrey E.,0,0,0,0
1715634092783,BENG 196,001,628496,Engler; Adam J.,9998,0,9999,1
1715634092783,BENG 196,002,660916,Watson; John Thomas,9999,0,9999,0
1715634094362,BISP 197,001,650773,Wilhelm; James E.,9994,0,9999,5
1715634094362,BISP 197,002,658904,Coleman; Aaron B.,9998,0,9999,1
1715634095768,CAT 124RS,A01,519847,Geibel; William,0,0,20,20
1715634097476,CAT 125RS,A01,515971,Geibel; William,0,0,20,20
1715634098823,CLRE 250,A00,511389,Morris; Sheldon,9992,0,9999,7
1715634100186,CLRE 251,A00,507176,Mehta; Ravindra L.,9992,0,9999,7
1715634100186,CLRE 251,B00,511410,Mehta; Ravindra L.,9998,0,9999,1
1715634103155,CLRE 252,A00,507189,Cuomo; Raphael Eduardo,9994,0,9999,5
1715634108870,CLRE 253,A00,507199,Vaida; Florin,9994,0,9999,5
1715634108870,CLRE 253,B00,507202,Vaida; Florin,9999,0,9999,0
1715634112160,CLRE 259,A00,507211,Patel; Hemal,9996,0,9999,3
1715634114888,CLRE 260,A00,507221,Cuomo; Raphael Eduardo,9999,0,9999,0
1715634116750,CLRE 297,001,507242,Cuomo; Raphael Eduardo,9999,0,9999,0
1715634118448,COGS 197,001,638244,Voytek; Bradley Thomas,9997,0,9999,2
1715634120240,CSE 191,A00,516875,Minnes Kemp; Mor Mia,9991,0,9999,8
1715634122128,CSE 197,001,637388,Minnes Kemp; Mor Mia,9992,0,9999,7
1715634123520,CSS 201S,A01,494383,Mignozzetti; Umberto,35,0,35,0
1715634124924,CSS 202S,A01,494387,Mignozzetti; Umberto,35,0,35,0
1715634126372,DSC 197,001,628532,Eldridge; Justin Matthew,9995,0,9999,4
1715634127872,EAP 100,A00,516065,Staff,9799,0,9999,200
1715634129534,ECE 45,A01,507414,Staff,31,0,60,29
1715634133152,ECE 111,A01,507420,Staff,11,0,50,39
1715634134679,ECE 197,001,548057,Sievenpiper; Daniel F.,9991,0,9999,8
1715634135967,EDS 115,A00,507243,Choi; Bailey Miyeon,7,0,28,21
1715634137326,EDS 117,A01,494379,Staff,0,6,34,34
1715634138581,EDS 125,A00,507246,Hopkins; Megan Beth,8,0,30,22
1715634140147,EDS 128A,A01,507264,Fargason; Sharon Gayle,6,0,26,20
1715634141557,EDS 128B,A01,507293,Pappas; Elizabeth,10,0,30,20
1715634143072,EDS 139,A00,507294,Fargason; Sharon Gayle,10,0,30,20
1715634143072,EDS 139,B00,507313,Pappas; Elizabeth,11,0,30,19
1715634144242,EDS 201,A00,507315,Staff,10,0,30,20
1715634146029,EDS 203,A01,507317,Halter; Christopher P.,10,0,30,20
1715634147671,EDS 204R,A01,507319,Halter; Christopher P.,0,3,30,30
1715634147671,EDS 204R,B01,507331,Heinzman; Erica M.,14,0,30,16
1715634149199,EDS 206R,A00,507332,Staff,0,4,30,30
1715634149199,EDS 206R,B00,507343,Staff,15,0,30,15
1715634150664,EDS 250,A00,507344,Hemans; Patricia Ann Benitez,20,0,40,20
1715634152544,EDS 281,A00,507345,Daly; Alan J.,18,0,18,0
1715634154514,EDS 284,A00,507350,Daly; Alan J.,16,0,16,0
1715634156029,EDS 286,A00,507359,Fine; Sarah,18,0,18,0
1715634157464,EDS 289C,A01,507361,Daly; Alan J.,18,0,18,0
1715634159515,EDS 290,A00,507366,Hofstetter; Carolyn,15,0,15,0
1715634161381,LIGM 5A,A00,507421,Fischer-Grunski; Eva K,17,0,20,3
1715634162947,LIGM 5B,A00,507423,Fischer-Grunski; Eva K,19,0,20,1
1715634164368,LIGM 5C,A00,507425,Fischer-Grunski; Eva K,19,0,20,1
1715634165992,LIIT 5AS,A00,507427,Carnelos; Chiara,20,0,20,0
1715634167572,LIIT 5BS,A00,507430,Carnelos; Chiara,20,0,20,0
1715634169138,LIIT 5CS,A00,507432,Carnelos; Chiara,20,0,20,0
1715634172422,LISP 5A,A00,507541,Munoz Sanchez; Alicia,11,0,20,9
1715634174135,LISP 5B,A00,507671,Munoz Sanchez; Alicia,9,0,20,11
1715634175922,LISP 5C,A00,507696,Munoz Sanchez; Alicia,9,0,20,11
1715634177323,MAE 197,001,528363,Boechler; Nicholas Sebastia,9998,0,9999,1
1715634179116,MATH 197,001,523477,Kedlaya; Kiran S.,9994,0,9999,5
1715634179116,MATH 197,002,563811,Zhang; Danna,9994,0,9999,5
1715634179116,MATH 197,003,628552,Dumitriu; Ioana,9998,0,9999,1
1715634179116,MATH 197,004,660885,Floyd; Eric,9998,0,9999,1
1715634180681,MCWP 40R,A00,518780,Staff,2,0,20,18
1715634180681,MCWP 40R,B00,518781,Staff,11,0,20,9
1715634180681,MCWP 40R,C00,518783,Staff,5,0,20,15
1715634182446,MCWP 50R,A00,518791,Staff,0,1,20,20
1715634182446,MCWP 50R,B00,518792,Staff,0,2,20,20
1715634182446,MCWP 50R,C00,518793,Staff,0,4,20,20
1715634182446,MCWP 50R,D00,518794,Staff,0,1,20,20
1715634182446,MCWP 50R,E00,518795,Staff,0,2,20,20
1715634182446,MCWP 50R,F00,518796,Staff,0,1,20,20
1715634182446,MCWP 50R,G00,518797,Staff,0,1,20,20
1715634183976,MMW 12R,A01,514034,Herbst; Matthew,0,2,16,16
1715634183976,MMW 12R,A02,514035,Herbst; Matthew,0,0,16,16
1715634185477,MMW 13R,A01,514037,Staff,0,5,16,16
1715634185477,MMW 13R,A02,514039,Staff,0,5,16,16
1715634185477,MMW 13R,A03,628519,Staff,0,4,16,16
1715634188923,SIO 295LS,A00,523233,Staff,10,0,30,20
1715634190604,SIO 295S,A00,523232,Staff,10,0,30,20
1715634191994,SIOC 290S,A01,637330,Merrifield; Mark A,21,0,30,9
1715634193472,SIOC 291S,A01,637333,Gabriel; Corey John,21,0,30,9
1715634195025,SOCI 117,A01,494376,Staff,0,5,5,5
1715634196549,WES 237B,A00,494380,Staff,10,0,20,10
1715634199604,AESE 279B,A00,494370,Wade; Jon P,0,0,33,33
1715634201112,AIP 97,001,660915,Van Den Einde; Yael Dahlia,9998,0,9999,1
1715634202520,AIP 197,001,627712,Vespa; Emanuel Ignacio,9995,0,9999,4
1715634202520,AIP 197,002,650778,Amir; On,9998,0,9999,1
1715634202520,AIP 197,003,650933,Avenancio-Leon; Carlos,9998,0,9999,1
1715634202520,AIP 197,004,658530,Heyman; Gail D.,9998,0,9999,1
1715634202520,AIP 197,005,658631,Neal; Sonya E,9998,0,9999,1
1715634202520,AIP 197,006,658671,Du; Songzi,9998,0,9999,1
1715634203746,ANAR 135S,A00,494369,Braswell; Geoffrey E.,0,0,0,0
1715634204959,BENG 196,001,628496,Engler; Adam J.,9998,0,9999,1
1715634204959,BENG 196,002,660916,Watson; John Thomas,9999,0,9999,0
1715634206555,BISP 197,001,650773,Wilhelm; James E.,9994,0,9999,5
1715634206555,BISP 197,002,658904,Coleman; Aaron B.,9998,0,9999,1
1715634208107,CAT 124RS,A01,519847,Geibel; William,0,0,20,20
1715634209679,CAT 125RS,A01,515971,Geibel; William,0,0,20,20
1715634211033,CLRE 250,A00,511389,Morris; Sheldon,9992,0,9999,7
1715634212504,CLRE 251,A00,507176,Mehta; Ravindra L.,9992,0,9999,7
1715634212504,CLRE 251,B00,511410,Mehta; Ravindra L.,9998,0,9999,1
1715634213948,CLRE 252,A00,507189,Cuomo; Raphael Eduardo,9994,0,9999,5
1715634215347,CLRE 253,A00,507199,Vaida; Florin,9994,0,9999,5
1715634215347,CLRE 253,B00,507202,Vaida; Florin,9999,0,9999,0
1715634217077,CLRE 259,A00,507211,Patel; Hemal,9996,0,9999,3
1715634219348,CLRE 260,A00,507221,Cuomo; Raphael Eduardo,9999,0,9999,0
1715634221700,CLRE 297,001,507242,Cuomo; Raphael Eduardo,9999,0,9999,0
1715634223547,COGS 197,001,638244,Voytek; Bradley Thomas,9997,0,9999,2
1715634225260,CSE 191,A00,516875,Minnes Kemp; Mor Mia,9991,0,9999,8
1715634227460,CSE 197,001,637388,Minnes Kemp; Mor Mia,9992,0,9999,7
1715634230420,CSS 201S,A01,494383,Mignozzetti; Umberto,35,0,35,0
1715634232673,CSS 202S,A01,494387,Mignozzetti; Umberto,35,0,35,0
1715634236357,DSC 197,001,628532,Eldridge; Justin Matthew,9995,0,9999,4
1715634244318,EAP 100,A00,516065,Staff,9799,0,9999,200
1715634248346,ECE 45,A01,507414,Staff,31,0,60,29
1715634250637,ECE 111,A01,507420,Staff,11,0,50,39
1715634251817,ECE 197,001,548057,Sievenpiper; Daniel F.,9991,0,9999,8
1715634253198,EDS 115,A00,507243,Choi; Bailey Miyeon,7,0,28,21
1715634254387,EDS 117,A01,494379,Staff,0,6,34,34
1715634255852,EDS 125,A00,507246,Hopkins; Megan Beth,8,0,30,22
1715634257220,EDS 128A,A01,507264,Fargason; Sharon Gayle,6,0,26,20
1715634258419,EDS 128B,A01,507293,Pappas; Elizabeth,10,0,30,20
1715634259726,EDS 139,A00,507294,Fargason; Sharon Gayle,10,0,30,20
1715634259726,EDS 139,B00,507313,Pappas; Elizabeth,11,0,30,19
1715634260969,EDS 201,A00,507315,Staff,10,0,30,20
1715634262605,EDS 203,A01,507317,Halter; Christopher P.,10,0,30,20
1715634264091,EDS 204R,A01,507319,Halter; Christopher P.,0,3,30,30
1715634264091,EDS 204R,B01,507331,Heinzman; Erica M.,14,0,30,16
1715634265571,EDS 206R,A00,507332,Staff,0,4,30,30
1715634265571,EDS 206R,B00,507343,Staff,15,0,30,15
1715634266976,EDS 250,A00,507344,Hemans; Patricia Ann Benitez,20,0,40,20
1715634268331,EDS 281,A00,507345,Daly; Alan J.,18,0,18,0
1715634269754,EDS 284,A00,507350,Daly; Alan J.,16,0,16,0
1715634271030,EDS 286,A00,507359,Fine; Sarah,18,0,18,0
1715634272463,EDS 289C,A01,507361,Daly; Alan J.,18,0,18,0
1715634273687,EDS 290,A00,507366,Hofstetter; Carolyn,15,0,15,0
1715634274996,LIGM 5A,A00,507421,Fischer-Grunski; Eva K,17,0,20,3
1715634276212,LIGM 5B,A00,507423,Fischer-Grunski; Eva K,19,0,20,1
1715634277498,LIGM 5C,A00,507425,Fischer-Grunski; Eva K,19,0,20,1
1715634278894,LIIT 5AS,A00,507427,Carnelos; Chiara,20,0,20,0
1715634280409,LIIT 5BS,A00,507430,Carnelos; Chiara,20,0,20,0
1715634281756,LIIT 5CS,A00,507432,Carnelos; Chiara,20,0,20,0
1715634283084,LISP 5A,A00,507541,Munoz Sanchez; Alicia,11,0,20,9
1715634284427,LISP 5B,A00,507671,Munoz Sanchez; Alicia,9,0,20,11
1715634285699,LISP 5C,A00,507696,Munoz Sanchez; Alicia,9,0,20,11
1715634287385,MAE 197,001,528363,Boechler; Nicholas Sebastia,9998,0,9999,1
1715634288776,MATH 197,001,523477,Kedlaya; Kiran S.,9994,0,9999,5
1715634288776,MATH 197,002,563811,Zhang; Danna,9994,0,9999,5
1715634288776,MATH 197,003,628552,Dumitriu; Ioana,9998,0,9999,1
1715634288776,MATH 197,004,660885,Floyd; Eric,9998,0,9999,1
1715634290057,MCWP 40R,A00,518780,Staff,2,0,20,18
1715634290057,MCWP 40R,B00,518781,Staff,11,0,20,9
1715634290057,MCWP 40R,C00,518783,Staff,5,0,20,15
1715634291714,MCWP 50R,A00,518791,Staff,0,1,20,20
1715634291714,MCWP 50R,B00,518792,Staff,0,2,20,20
1715634291714,MCWP 50R,C00,518793,Staff,0,4,20,20
1715634291714,MCWP 50R,D00,518794,Staff,0,1,20,20
1715634291714,MCWP 50R,E00,518795,Staff,0,2,20,20
1715634291714,MCWP 50R,F00,518796,Staff,0,1,20,20
1715634291714,MCWP 50R,G00,518797,Staff,0,1,20,20
1715634293064,MMW 12R,A01,514034,Herbst; Matthew,0,2,16,16
1715634293064,MMW 12R,A02,514035,Herbst; Matthew,0,0,16,16
1715634294712,MMW 13R,A01,514037,Staff,0,5,16,16
1715634294712,MMW 13R,A02,514039,Staff,0,5,16,16
1715634294712,MMW 13R,A03,628519,Staff,0,4,16,16
1715634298101,SIO 295LS,A00,523233,Staff,10,0,30,20
1715634299957,SIO 295S,A00,523232,Staff,10,0,30,20
1715634301833,SIOC 290S,A01,637330,Merrifield; Mark A,21,0,30,9
1715634305881,SIOC 291S,A01,637333,Gabriel; Corey John,21,0,30,9
1715634307309,SOCI 117,A01,494376,Staff,0,5,5,5
1715634308504,WES 237B,A00,494380,Staff,10,0,20,10
1715634310962,AESE 279B,A00,494370,Wade; Jon P,0,0,33,33
1715634312427,AIP 97,001,660915,Van Den Einde; Yael Dahlia,9998,0,9999,1
1715634313657,AIP 197,001,627712,Vespa; Emanuel Ignacio,9995,0,9999,4
1715634313657,AIP 197,002,650778,Amir; On,9998,0,9999,1
1715634313657,AIP 197,003,650933,Avenancio-Leon; Carlos,9998,0,9999,1
1715634313657,AIP 197,004,658530,Heyman; Gail D.,9998,0,9999,1
1715634313657,AIP 197,005,658631,Neal; Sonya E,9998,0,9999,1
1715634313657,AIP 197,006,658671,Du; Songzi,9998,0,9999,1
1715634315481,ANAR 135S,A00,494369,Braswell; Geoffrey E.,0,0,0,0
1715634316931,BENG 196,001,628496,Engler; Adam J.,9998,0,9999,1
1715634316931,BENG 196,002,660916,Watson; John Thomas,9999,0,9999,0
1715634318514,BISP 197,001,650773,Wilhelm; James E.,9994,0,9999,5
1715634318514,BISP 197,002,658904,Coleman; Aaron B.,9998,0,9999,1
1715634320175,CAT 124RS,A01,519847,Geibel; William,0,0,20,20
1715634321809,CAT 125RS,A01,515971,Geibel; William,0,0,20,20
1715634323250,CLRE 250,A00,511389,Morris; Sheldon,9992,0,9999,7
1715634324714,CLRE 251,A00,507176,Mehta; Ravindra L.,9992,0,9999,7
1715634324714,CLRE 251,B00,511410,Mehta; Ravindra L.,9998,0,9999,1
1715634326178,CLRE 252,A00,507189,Cuomo; Raphael Eduardo,9994,0,9999,5
1715634327763,CLRE 253,A00,507199,Vaida; Florin,9994,0,9999,5
1715634327763,CLRE 253,B00,507202,Vaida; Florin,9999,0,9999,0
1715634329140,CLRE 259,A00,507211,Patel; Hemal,9996,0,9999,3
1715634330714,CLRE 260,A00,507221,Cuomo; Raphael Eduardo,9999,0,9999,0
1715634332110,CLRE 297,001,507242,Cuomo; Raphael Eduardo,9999,0,9999,0
1715634333595,COGS 197,001,638244,Voytek; Bradley Thomas,9997,0,9999,2
1715634334864,CSE 191,A00,516875,Minnes Kemp; Mor Mia,9991,0,9999,8
1715634336290,CSE 197,001,637388,Minnes Kemp; Mor Mia,9992,0,9999,7
1715634337687,CSS 201S,A01,494383,Mignozzetti; Umberto,35,0,35,0
1715634339528,CSS 202S,A01,494387,Mignozzetti; Umberto,35,0,35,0
1715634340637,DSC 197,001,628532,Eldridge; Justin Matthew,9995,0,9999,4
1715634341683,EAP 100,A00,516065,Staff,9799,0,9999,200
1715634342770,ECE 45,A01,507414,Staff,31,0,60,29
1715634345107,ECE 111,A01,507420,Staff,11,0,50,39
1715634346258,ECE 197,001,548057,Sievenpiper; Daniel F.,9991,0,9999,8
1715634347408,EDS 115,A00,507243,Choi; Bailey Miyeon,7,0,28,21
1715634348567,EDS 117,A01,494379,Staff,0,6,34,34
1715634349758,EDS 125,A00,507246,Hopkins; Megan Beth,8,0,30,22
1715634350933,EDS 128A,A01,507264,Fargason; Sharon Gayle,6,0,26,20
1715634352036,EDS 128B,A01,507293,Pappas; Elizabeth,10,0,30,20
1715634353209,EDS 139,A00,507294,Fargason; Sharon Gayle,10,0,30,20
1715634353209,EDS 139,B00,507313,Pappas; Elizabeth,11,0,30,19
1715634354331,EDS 201,A00,507315,Staff,10,0,30,20
1715634355524,EDS 203,A01,507317,Halter; Christopher P.,10,0,30,20
1715634356647,EDS 204R,A01,507319,Halter; Christopher P.,0,3,30,30
1715634356647,EDS 204R,B01,507331,Heinzman; Erica M.,14,0,30,16
1715634357796,EDS 206R,A00,507332,Staff,0,4,30,30
1715634357796,EDS 206R,B00,507343,Staff,15,0,30,15
1715634359042,EDS 250,A00,507344,Hemans; Patricia Ann Benitez,20,0,40,20
1715634360255,EDS 281,A00,507345,Daly; Alan J.,18,0,18,0
1715634361381,EDS 284,A00,507350,Daly; Alan J.,16,0,16,0
1715634362529,EDS 286,A00,507359,Fine; Sarah,18,0,18,0
1715634363638,EDS 289C,A01,507361,Daly; Alan J.,18,0,18,0
1715634364797,EDS 290,A00,507366,Hofstetter; Carolyn,15,0,15,0
1715634365922,LIGM 5A,A00,507421,Fischer-Grunski; Eva K,17,0,20,3
1715634367012,LIGM 5B,A00,507423,Fischer-Grunski; Eva K,19,0,20,1
1715634368292,LIGM 5C,A00,507425,Fischer-Grunski; Eva K,19,0,20,1
1715634369480,LIIT 5AS,A00,507427,Carnelos; Chiara,20,0,20,0
1715634370581,LIIT 5BS,A00,507430,Carnelos; Chiara,20,0,20,0
1715634371723,LIIT 5CS,A00,507432,Carnelos; Chiara,20,0,20,0
1715634372831,LISP 5A,A00,507541,Munoz Sanchez; Alicia,11,0,20,9
1715634374064,LISP 5B,A00,507671,Munoz Sanchez; Alicia,9,0,20,11
1715634375303,LISP 5C,A00,507696,Munoz Sanchez; Alicia,9,0,20,11
1715634376491,MAE 197,001,528363,Boechler; Nicholas Sebastia,9998,0,9999,1
1715634377630,MATH 197,001,523477,Kedlaya; Kiran S.,9994,0,9999,5
1715634377630,MATH 197,002,563811,Zhang; Danna,9994,0,9999,5
1715634377630,MATH 197,003,628552,Dumitriu; Ioana,9998,0,9999,1
1715634377630,MATH 197,004,660885,Floyd; Eric,9998,0,9999,1
1715634378787,MCWP 40R,A00,518780,Staff,2,0,20,18
1715634378787,MCWP 40R,B00,518781,Staff,11,0,20,9
1715634378787,MCWP 40R,C00,518783,Staff,5,0,20,15
1715634379859,MCWP 50R,A00,518791,Staff,0,1,20,20
1715634379859,MCWP 50R,B00,518792,Staff,0,2,20,20
1715634379859,MCWP 50R,C00,518793,Staff,0,4,20,20
1715634379859,MCWP 50R,D00,518794,Staff,0,1,20,20
1715634379859,MCWP 50R,E00,518795,Staff,0,2,20,20
1715634379859,MCWP 50R,F00,518796,Staff,0,1,20,20
1715634379859,MCWP 50R,G00,518797,Staff,0,1,20,20
1715634381047,MMW 12R,A01,514034,Herbst; Matthew,0,2,16,16
1715634381047,MMW 12R,A02,514035,Herbst; Matthew,0,0,16,16
1715634382238,MMW 13R,A01,514037,Staff,0,5,16,16
1715634382238,MMW 13R,A02,514039,Staff,0,5,16,16
1715634382238,MMW 13R,A03,628519,Staff,0,4,16,16
1715634384789,SIO 295LS,A00,523233,Staff,10,0,30,20
1715634385953,SIO 295S,A00,523232,Staff,10,0,30,20
1715634387244,SIOC 290S,A01,637330,Merrifield; Mark A,21,0,30,9
1715634388415,SIOC 291S,A01,637333,Gabriel; Corey John,21,0,30,9
1715634389540,SOCI 117,A01,494376,Staff,0,5,5,5
1715634390886,WES 237B,A00,494380,Staff,10,0,20,10
1715634393376,AESE 279B,A00,494370,Wade; Jon P,0,0,33,33
1715634394779,AIP 97,001,660915,Van Den Einde; Yael Dahlia,9998,0,9999,1
1715634395982,AIP 197,001,627712,Vespa; Emanuel Ignacio,9995,0,9999,4
1715634395982,AIP 197,002,650778,Amir; On,9998,0,9999,1
1715634395982,AIP 197,003,650933,Avenancio-Leon; Carlos,9998,0,9999,1
1715634395982,AIP 197,004,658530,Heyman; Gail D.,9998,0,9999,1
1715634395982,AIP 197,005,658631,Neal; Sonya E,9998,0,9999,1
1715634395982,AIP 197,006,658671,Du; Songzi,9998,0,9999,1
1715634397384,ANAR 135S,A00,494369,Braswell; Geoffrey E.,0,0,0,0
1715634398646,BENG 196,001,628496,Engler; Adam J.,9998,0,9999,1
1715634398646,BENG 196,002,660916,Watson; John Thomas,9999,0,9999,0
1715634399864,BISP 197,001,650773,Wilhelm; James E.,9994,0,9999,5
1715634399864,BISP 197,002,658904,Coleman; Aaron B.,9998,0,9999,1
1715634401166,CAT 124RS,A01,519847,Geibel; William,0,0,20,20
1715634402553,CAT 125RS,A01,515971,Geibel; William,0,0,20,20
1715634403880,CLRE 250,A00,511389,Morris; Sheldon,9992,0,9999,7
1715634405098,CLRE 251,A00,507176,Mehta; Ravindra L.,9992,0,9999,7
1715634405098,CLRE 251,B00,511410,Mehta; Ravindra L.,9998,0,9999,1
1715634406284,CLRE 252,A00,507189,Cuomo; Raphael Eduardo,9994,0,9999,5
1715634407857,CLRE 253,A00,507199,Vaida; Florin,9994,0,9999,5
1715634407857,CLRE 253,B00,507202,Vaida; Florin,9999,0,9999,0
1715634409020,CLRE 259,A00,507211,Patel; Hemal,9996,0,9999,3
1715634410130,CLRE 260,A00,507221,Cuomo; Raphael Eduardo,9999,0,9999,0
1715634411592,CLRE 297,001,507242,Cuomo; Raphael Eduardo,9999,0,9999,0
1715634412704,COGS 197,001,638244,Voytek; Bradley Thomas,9997,0,9999,2
1715634413808,CSE 191,A00,516875,Minnes Kemp; Mor Mia,9991,0,9999,8
1715634414985,CSE 197,001,637388,Minnes Kemp; Mor Mia,9992,0,9999,7
1715634416135,CSS 201S,A01,494383,Mignozzetti; Umberto,35,0,35,0
1715634417461,CSS 202S,A01,494387,Mignozzetti; Umberto,35,0,35,0
1715634418558,DSC 197,001,628532,Eldridge; Justin Matthew,9995,0,9999,4
1715634419750,EAP 100,A00,516065,Staff,9799,0,9999,200
1715634421115,ECE 45,A01,507414,Staff,31,0,60,29
1715634423573,ECE 111,A01,507420,Staff,11,0,50,39
1715634424986,ECE 197,001,548057,Sievenpiper; Daniel F.,9991,0,9999,8
1715634426142,EDS 115,A00,507243,Choi; Bailey Miyeon,7,0,28,21
1715634427455,EDS 117,A01,494379,Staff,0,6,34,34
1715634428743,EDS 125,A00,507246,Hopkins; Megan Beth,8,0,30,22
1715634430007,EDS 128A,A01,507264,Fargason; Sharon Gayle,6,0,26,20
1715634431232,EDS 128B,A01,507293,Pappas; Elizabeth,10,0,30,20
1715634432412,EDS 139,A00,507294,Fargason; Sharon Gayle,10,0,30,20
1715634432412,EDS 139,B00,507313,Pappas; Elizabeth,11,0,30,19
1715634433613,EDS 201,A00,507315,Staff,10,0,30,20
1715634434761,EDS 203,A01,507317,Halter; Christopher P.,10,0,30,20
1715634435950,EDS 204R,A01,507319,Halter; Christopher P.,0,3,30,30
1715634435950,EDS 204R,B01,507331,Heinzman; Erica M.,14,0,30,16
1715634437094,EDS 206R,A00,507332,Staff,0,4,30,30
1715634437094,EDS 206R,B00,507343,Staff,15,0,30,15
1715634438285,EDS 250,A00,507344,Hemans; Patricia Ann Benitez,20,0,40,20
1715634439427,EDS 281,A00,507345,Daly; Alan J.,18,0,18,0
1715634440581,EDS 284,A00,507350,Daly; Alan J.,16,0,16,0
1715634441843,EDS 286,A00,507359,Fine; Sarah,18,0,18,0
1715634443057,EDS 289C,A01,507361,Daly; Alan J.,18,0,18,0
1715634444225,EDS 290,A00,507366,Hofstetter; Carolyn,15,0,15,0
1715634445441,LIGM 5A,A00,507421,Fischer-Grunski; Eva K,17,0,20,3
1715634446674,LIGM 5B,A00,507423,Fischer-Grunski; Eva K,19,0,20,1
1715634447949,LIGM 5C,A00,507425,Fischer-Grunski; Eva K,19,0,20,1
1715634449326,LIIT 5AS,A00,507427,Carnelos; Chiara,20,0,20,0
1715634450629,LIIT 5BS,A00,507430,Carnelos; Chiara,20,0,20,0
1715634451807,LIIT 5CS,A00,507432,Carnelos; Chiara,20,0,20,0
1715634453020,LISP 5A,A00,507541,Munoz Sanchez; Alicia,11,0,20,9
1715634454426,LISP 5B,A00,507671,Munoz Sanchez; Alicia,9,0,20,11
1715634455540,LISP 5C,A00,507696,Munoz Sanchez; Alicia,9,0,20,11
1715634456745,MAE 197,001,528363,Boechler; Nicholas Sebastia,9998,0,9999,1
1715634457800,MATH 197,001,523477,Kedlaya; Kiran S.,9994,0,9999,5
1715634457800,MATH 197,002,563811,Zhang; Danna,9994,0,9999,5
1715634457800,MATH 197,003,628552,Dumitriu; Ioana,9998,0,9999,1
1715634457800,MATH 197,004,660885,Floyd; Eric,9998,0,9999,1
1715634459045,MCWP 40R,A00,518780,Staff,2,0,20,18
1715634459045,MCWP 40R,B00,518781,Staff,11,0,20,9
1715634459045,MCWP 40R,C00,518783,Staff,5,0,20,15
1715634460149,MCWP 50R,A00,518791,Staff,0,1,20,20
1715634460149,MCWP 50R,B00,518792,Staff,0,2,20,20
1715634460149,MCWP 50R,C00,518793,Staff,0,4,20,20
1715634460149,MCWP 50R,D00,518794,Staff,0,1,20,20
1715634460149,MCWP 50R,E00,518795,Staff,0,2,20,20
1715634460149,MCWP 50R,F00,518796,Staff,0,1,20,20
1715634460149,MCWP 50R,G00,518797,Staff,0,1,20,20
1715634461362,MMW 12R,A01,514034,Herbst; Matthew,0,2,16,16
1715634461362,MMW 12R,A02,514035,Herbst; Matthew,0,0,16,16
1715634462499,MMW 13R,A01,514037,Staff,0,5,16,16
1715634462499,MMW 13R,A02,514039,Staff,0,5,16,16
1715634462499,MMW 13R,A03,628519,Staff,0,4,16,16
1715634464843,SIO 295LS,A00,523233,Staff,10,0,30,20
1715634465964,SIO 295S,A00,523232,Staff,10,0,30,20
1715634467260,SIOC 290S,A01,637330,Merrifield; Mark A,21,0,30,9
1715634468387,SIOC 291S,A01,637333,Gabriel; Corey John,21,0,30,9
1715634469788,SOCI 117,A01,494376,Staff,0,5,5,5
1715634470951,WES 237B,A00,494380,Staff,10,0,20,10
1715634473401,AESE 279B,A00,494370,Wade; Jon P,0,0,33,33
1715634474506,AIP 97,001,660915,Van Den Einde; Yael Dahlia,9998,0,9999,1
1715634475566,AIP 197,001,627712,Vespa; Emanuel Ignacio,9995,0,9999,4
1715634475566,AIP 197,002,650778,Amir; On,9998,0,9999,1
1715634475566,AIP 197,003,650933,Avenancio-Leon; Carlos,9998,0,9999,1
1715634475566,AIP 197,004,658530,Heyman; Gail D.,9998,0,9999,1
1715634475566,AIP 197,005,658631,Neal; Sonya E,9998,0,9999,1
1715634475566,AIP 197,006,658671,Du; Songzi,9998,0,9999,1
1715634476660,ANAR 135S,A00,494369,Braswell; Geoffrey E.,0,0,0,0
1715634477827,BENG 196,001,628496,Engler; Adam J.,9998,0,9999,1
1715634477827,BENG 196,002,660916,Watson; John Thomas,9999,0,9999,0
1715634478974,BISP 197,001,650773,Wilhelm; James E.,9994,0,9999,5
1715634478974,BISP 197,002,658904,Coleman; Aaron B.,9998,0,9999,1
1715634480173,CAT 124RS,A01,519847,Geibel; William,0,0,20,20
1715634481401,CAT 125RS,A01,515971,Geibel; William,0,0,20,20
1715634482623,CLRE 250,A00,511389,Morris; Sheldon,9992,0,9999,7
1715634483965,CLRE 251,A00,507176,Mehta; Ravindra L.,9992,0,9999,7
1715634483965,CLRE 251,B00,511410,Mehta; Ravindra L.,9998,0,9999,1
1715634485249,CLRE 252,A00,507189,Cuomo; Raphael Eduardo,9994,0,9999,5
1715634486624,CLRE 253,A00,507199,Vaida; Florin,9994,0,9999,5
1715634486624,CLRE 253,B00,507202,Vaida; Florin,9999,0,9999,0
1715634487824,CLRE 259,A00,507211,Patel; Hemal,9996,0,9999,3
1715634488933,CLRE 260,A00,507221,Cuomo; Raphael Eduardo,9999,0,9999,0
1715634490277,CLRE 297,001,507242,Cuomo; Raphael Eduardo,9999,0,9999,0
1715634491535,COGS 197,001,638244,Voytek; Bradley Thomas,9997,0,9999,2
1715634492840,CSE 191,A00,516875,Minnes Kemp; Mor Mia,9991,0,9999,8
1715634493932,CSE 197,001,637388,Minnes Kemp; Mor Mia,9992,0,9999,7
1715634495161,CSS 201S,A01,494383,Mignozzetti; Umberto,35,0,35,0
1715634496362,CSS 202S,A01,494387,Mignozzetti; Umberto,35,0,35,0
1715634497972,DSC 197,001,628532,Eldridge; Justin Matthew,9995,0,9999,4
1715634499046,EAP 100,A00,516065,Staff,9799,0,9999,200
1715634500150,ECE 45,A01,507414,Staff,31,0,60,29
1715634502501,ECE 111,A01,507420,Staff,11,0,50,39
1715634503617,ECE 197,001,548057,Sievenpiper; Daniel F.,9991,0,9999,8
1715634504731,EDS 115,A00,507243,Choi; Bailey Miyeon,7,0,28,21
1715634505940,EDS 117,A01,494379,Staff,0,6,34,34
1715634507236,EDS 125,A00,507246,Hopkins; Megan Beth,8,0,30,22
1715634508361,EDS 128A,A01,507264,Fargason; Sharon Gayle,6,0,26,20
1715634509445,EDS 128B,A01,507293,Pappas; Elizabeth,10,0,30,20
1715634510649,EDS 139,A00,507294,Fargason; Sharon Gayle,10,0,30,20
1715634510649,EDS 139,B00,507313,Pappas; Elizabeth,11,0,30,19
1715634511967,EDS 201,A00,507315,Staff,10,0,30,20
1715634513314,EDS 203,A01,507317,Halter; Christopher P.,10,0,30,20
1715634514463,EDS 204R,A01,507319,Halter; Christopher P.,0,3,30,30
1715634514463,EDS 204R,B01,507331,Heinzman; Erica M.,14,0,30,16
1715634515619,EDS 206R,A00,507332,Staff,0,4,30,30
1715634515619,EDS 206R,B00,507343,Staff,15,0,30,15
1715634516818,EDS 250,A00,507344,Hemans; Patricia Ann Benitez,20,0,40,20
1715634517927,EDS 281,A00,507345,Daly; Alan J.,18,0,18,0
1715634519052,EDS 284,A00,507350,Daly; Alan J.,16,0,16,0
1715634520175,EDS 286,A00,507359,Fine; Sarah,18,0,18,0
1715634521248,EDS 289C,A01,507361,Daly; Alan J.,18,0,18,0
1715634522324,EDS 290,A00,507366,Hofstetter; Carolyn,15,0,15,0
1715634523719,LIGM 5A,A00,507421,Fischer-Grunski; Eva K,17,0,20,3
1715634524825,LIGM 5B,A00,507423,Fischer-Grunski; Eva K,19,0,20,1
1715634526056,LIGM 5C,A00,507425,Fischer-Grunski; Eva K,19,0,20,1
1715634527281,LIIT 5AS,A00,507427,Carnelos; Chiara,20,0,20,0
1715634528591,LIIT 5BS,A00,507430,Carnelos; Chiara,20,0,20,0
1715634531982,LIIT 5CS,A00,507432,Carnelos; Chiara,20,0,20,0
1715634534464,LISP 5A,A00,507541,Munoz Sanchez; Alicia,11,0,20,9
1715634535759,LISP 5B,A00,507671,Munoz Sanchez; Alicia,9,0,20,11
1715634536910,LISP 5C,A00,507696,Munoz Sanchez; Alicia,9,0,20,11
1715634538078,MAE 197,001,528363,Boechler; Nicholas Sebastia,9998,0,9999,1
1715634539440,MATH 197,001,523477,Kedlaya; Kiran S.,9994,0,9999,5
1715634539440,MATH 197,002,563811,Zhang; Danna,9994,0,9999,5
1715634539440,MATH 197,003,628552,Dumitriu; Ioana,9998,0,9999,1
1715634539440,MATH 197,004,660885,Floyd; Eric,9998,0,9999,1
1715634540582,MCWP 40R,A00,518780,Staff,2,0,20,18
1715634540582,MCWP 40R,B00,518781,Staff,11,0,20,9
1715634540582,MCWP 40R,C00,518783,Staff,5,0,20,15
1715634541761,MCWP 50R,A00,518791,Staff,0,1,20,20
1715634541761,MCWP 50R,B00,518792,Staff,0,2,20,20
1715634541761,MCWP 50R,C00,518793,Staff,0,4,20,20
1715634541761,MCWP 50R,D00,518794,Staff,0,1,20,20
1715634541761,MCWP 50R,E00,518795,Staff,0,2,20,20
1715634541761,MCWP 50R,F00,518796,Staff,0,1,20,20
1715634541761,MCWP 50R,G00,518797,Staff,0,1,20,20
1715634542900,MMW 12R,A01,514034,Herbst; Matthew,0,2,16,16
1715634542900,MMW 12R,A02,514035,Herbst; Matthew,0,0,16,16
1715634544106,MMW 13R,A01,514037,Staff,0,5,16,16
1715634544106,MMW 13R,A02,514039,Staff,0,5,16,16
1715634544106,MMW 13R,A03,628519,Staff,0,4,16,16
1715634546489,SIO 295LS,A00,523233,Staff,10,0,30,20
1715634547638,SIO 295S,A00,523232,Staff,10,0,30,20
1715634548787,SIOC 290S,A01,637330,Merrifield; Mark A,21,0,30,9
1715634549925,SIOC 291S,A01,637333,Gabriel; Corey John,21,0,30,9
1715634551104,SOCI 117,A01,494376,Staff,0,5,5,5
1715634552471,WES 237B,A00,494380,Staff,10,0,20,10
1715634554894,AESE 279B,A00,494370,Wade; Jon P,0,0,33,33
1715634556085,AIP 97,001,660915,Van Den Einde; Yael Dahlia,9998,0,9999,1
1715634557191,AIP 197,001,627712,Vespa; Emanuel Ignacio,9995,0,9999,4
1715634557191,AIP 197,002,650778,Amir; On,9998,0,9999,1
1715634557191,AIP 197,003,650933,Avenancio-Leon; Carlos,9998,0,9999,1
1715634557191,AIP 197,004,658530,Heyman; Gail D.,9998,0,9999,1
1715634557191,AIP 197,005,658631,Neal; Sonya E,9998,0,9999,1
1715634557191,AIP 197,006,658671,Du; Songzi,9998,0,9999,1
1715634558421,ANAR 135S,A00,494369,Braswell; Geoffrey E.,0,0,0,0
1715634559504,BENG 196,001,628496,Engler; Adam J.,9998,0,9999,1
1715634559504,BENG 196,002,660916,Watson; John Thomas,9999,0,9999,0
1715634560635,BISP 197,001,650773,Wilhelm; James E.,9994,0,9999,5
1715634560635,BISP 197,002,658904,Coleman; Aaron B.,9998,0,9999,1
1715634561796,CAT 124RS,A01,519847,Geibel; William,0,0,20,20
1715634562973,CAT 125RS,A01,515971,Geibel; William,0,0,20,20
1715634564200,CLRE 250,A00,511389,Morris; Sheldon,9992,0,9999,7
1715634565321,CLRE 251,A00,507176,Mehta; Ravindra L.,9992,0,9999,7
1715634565321,CLRE 251,B00,511410,Mehta; Ravindra L.,9998,0,9999,1
1715634566453,CLRE 252,A00,507189,Cuomo; Raphael Eduardo,9994,0,9999,5
1715634567583,CLRE 253,A00,507199,Vaida; Florin,9994,0,9999,5
1715634567583,CLRE 253,B00,507202,Vaida; Florin,9999,0,9999,0
1715634568777,CLRE 259,A00,507211,Patel; Hemal,9996,0,9999,3
1715634569925,CLRE 260,A00,507221,Cuomo; Raphael Eduardo,9999,0,9999,0
1715634571202,CLRE 297,001,507242,Cuomo; Raphael Eduardo,9999,0,9999,0
1715634572407,COGS 197,001,638244,Voytek; Bradley Thomas,9997,0,9999,2
1715634573630,CSE 191,A00,516875,Minnes Kemp; Mor Mia,9991,0,9999,8
1715634574815,CSE 197,001,637388,Minnes Kemp; Mor Mia,9992,0,9999,7
1715634576039,CSS 201S,A01,494383,Mignozzetti; Umberto,35,0,35,0
1715634577201,CSS 202S,A01,494387,Mignozzetti; Umberto,35,0,35,0
1715634578318,DSC 197,001,628532,Eldridge; Justin Matthew,9995,0,9999,4
1715634579488,EAP 100,A00,516065,Staff,9799,0,9999,200
1715634580775,ECE 45,A01,507414,Staff,31,0,60,29
1715634583038,ECE 111,A01,507420,Staff,11,0,50,39
1715634584193,ECE 197,001,548057,Sievenpiper; Daniel F.,9991,0,9999,8
1715634585408,EDS 115,A00,507243,Choi; Bailey Miyeon,7,0,28,21
1715634586595,EDS 117,A01,494379,Staff,0,6,34,34
1715634587761,EDS 125,A00,507246,Hopkins; Megan Beth,8,0,30,22
1715634589035,EDS 128A,A01,507264,Fargason; Sharon Gayle,6,0,26,20
1715634590149,EDS 128B,A01,507293,Pappas; Elizabeth,10,0,30,20
1715634591247,EDS 139,A00,507294,Fargason; Sharon Gayle,10,0,30,20
1715634591247,EDS 139,B00,507313,Pappas; Elizabeth,11,0,30,19
1715634592453,EDS 201,A00,507315,Staff,10,0,30,20
1715634593512,EDS 203,A01,507317,Halter; Christopher P.,10,0,30,20
1715634594950,EDS 204R,A01,507319,Halter; Christopher P.,0,3,30,30
1715634594950,EDS 204R,B01,507331,Heinzman; Erica M.,14,0,30,16
1715634596398,EDS 206R,A00,507332,Staff,0,4,30,30
1715634596398,EDS 206R,B00,507343,Staff,15,0,30,15
1715634597671,EDS 250,A00,507344,Hemans; Patricia Ann Benitez,20,0,40,20
1715634598842,EDS 281,A00,507345,Daly; Alan J.,18,0,18,0
1715634600212,EDS 284,A00,507350,Daly; Alan J.,16,0,16,0
1715634601390,EDS 286,A00,507359,Fine; Sarah,18,0,18,0
1715634603457,EDS 289C,A01,507361,Daly; Alan J.,18,0,18,0
1715634605716,EDS 290,A00,507366,Hofstetter; Carolyn,15,0,15,0
1715634606866,LIGM 5A,A00,507421,Fischer-Grunski; Eva K,17,0,20,3
1715634607971,LIGM 5B,A00,507423,Fischer-Grunski; Eva K,19,0,20,1
1715634609305,LIGM 5C,A00,507425,Fischer-Grunski; Eva K,19,0,20,1
1715634610384,LIIT 5AS,A00,507427,Carnelos; Chiara,20,0,20,0
1715634611754,LIIT 5BS,A00,507430,Carnelos; Chiara,20,0,20,0
1715634612900,LIIT 5CS,A00,507432,Carnelos; Chiara,20,0,20,0
1715634614014,LISP 5A,A00,507541,Munoz Sanchez; Alicia,11,0,20,9
1715634615318,LISP 5B,A00,507671,Munoz Sanchez; Alicia,9,0,20,11
1715634616505,LISP 5C,A00,507696,Munoz Sanchez; Alicia,9,0,20,11
1715634617692,MAE 197,001,528363,Boechler; Nicholas Sebastia,9998,0,9999,1
1715634618817,MATH 197,001,523477,Kedlaya; Kiran S.,9994,0,9999,5
1715634618817,MATH 197,002,563811,Zhang; Danna,9994,0,9999,5
1715634618817,MATH 197,003,628552,Dumitriu; Ioana,9998,0,9999,1
1715634618817,MATH 197,004,660885,Floyd; Eric,9998,0,9999,1
1715634620018,MCWP 40R,A00,518780,Staff,2,0,20,18
1715634620018,MCWP 40R,B00,518781,Staff,11,0,20,9
1715634620018,MCWP 40R,C00,518783,Staff,5,0,20,15
1715634621251,MCWP 50R,A00,518791,Staff,0,1,20,20
1715634621251,MCWP 50R,B00,518792,Staff,0,2,20,20
1715634621251,MCWP 50R,C00,518793,Staff,0,4,20,20
1715634621251,MCWP 50R,D00,518794,Staff,0,1,20,20
1715634621251,MCWP 50R,E00,518795,Staff,0,2,20,20
1715634621251,MCWP 50R,F00,518796,Staff,0,1,20,20
1715634621251,MCWP 50R,G00,518797,Staff,0,1,20,20
1715634622415,MMW 12R,A01,514034,Herbst; Matthew,0,2,16,16
1715634622415,MMW 12R,A02,514035,Herbst; Matthew,0,0,16,16
1715634623589,MMW 13R,A01,514037,Staff,0,5,16,16
1715634623589,MMW 13R,A02,514039,Staff,0,5,16,16
1715634623589,MMW 13R,A03,628519,Staff,0,4,16,16
1715634625800,SIO 295LS,A00,523233,Staff,10,0,30,20
1715634627100,SIO 295S,A00,523232,Staff,10,0,30,20
1715634628221,SIOC 290S,A01,637330,Merrifield; Mark A,21,0,30,9
1715634629495,SIOC 291S,A01,637333,Gabriel; Corey John,21,0,30,9
1715634630794,SOCI 117,A01,494376,Staff,0,5,5,5
1715634631879,WES 237B,A00,494380,Staff,10,0,20,10
1715634634304,AESE 279B,A00,494370,Wade; Jon P,0,0,33,33
1715634635507,AIP 97,001,660915,Van Den Einde; Yael Dahlia,9998,0,9999,1
1715634636694,AIP 197,001,627712,Vespa; Emanuel Ignacio,9995,0,9999,4
1715634636694,AIP 197,002,650778,Amir; On,9998,0,9999,1
1715634636694,AIP 197,003,650933,Avenancio-Leon; Carlos,9998,0,9999,1
1715634636694,AIP 197,004,658530,Heyman; Gail D.,9998,0,9999,1
1715634636694,AIP 197,005,658631,Neal; Sonya E,9998,0,9999,1
1715634636694,AIP 197,006,658671,Du; Songzi,9998,0,9999,1
1715634637978,ANAR 135S,A00,494369,Braswell; Geoffrey E.,0,0,0,0
1715634639190,BENG 196,001,628496,Engler; Adam J.,9998,0,9999,1
1715634639190,BENG 196,002,660916,Watson; John Thomas,9999,0,9999,0
1715634640455,BISP 197,001,650773,Wilhelm; James E.,9994,0,9999,5
1715634640455,BISP 197,002,658904,Coleman; Aaron B.,9998,0,9999,1
1715634641559,CAT 124RS,A01,519847,Geibel; William,0,0,20,20
1715634642779,CAT 125RS,A01,515971,Geibel; William,0,0,20,20
1715634643991,CLRE 250,A00,511389,Morris; Sheldon,9992,0,9999,7
1715634645202,CLRE 251,A00,507176,Mehta; Ravindra L.,9992,0,9999,7
1715634645202,CLRE 251,B00,511410,Mehta; Ravindra L.,9998,0,9999,1
1715634646338,CLRE 252,A00,507189,Cuomo; Raphael Eduardo,9994,0,9999,5
1715634647581,CLRE 253,A00,507199,Vaida; Florin,9994,0,9999,5
1715634647581,CLRE 253,B00,507202,Vaida; Florin,9999,0,9999,0
1715634648807,CLRE 259,A00,507211,Patel; Hemal,9996,0,9999,3
1715634649953,CLRE 260,A00,507221,Cuomo; Raphael Eduardo,9999,0,9999,0
1715634651079,CLRE 297,001,507242,Cuomo; Raphael Eduardo,9999,0,9999,0
1715634652174,COGS 197,001,638244,Voytek; Bradley Thomas,9997,0,9999,2
1715634653327,CSE 191,A00,516875,Minnes Kemp; Mor Mia,9991,0,9999,8
1715634654506,CSE 197,001,637388,Minnes Kemp; Mor Mia,9992,0,9999,7
1715634655600,CSS 201S,A01,494383,Mignozzetti; Umberto,35,0,35,0
1715634656787,CSS 202S,A01,494387,Mignozzetti; Umberto,35,0,35,0
1715634658009,DSC 197,001,628532,Eldridge; Justin Matthew,9995,0,9999,4
1715634659231,EAP 100,A00,516065,Staff,9799,0,9999,200
1715634660362,ECE 45,A01,507414,Staff,31,0,60,29
1715634662555,ECE 111,A01,507420,Staff,11,0,50,39
1715634663680,ECE 197,001,548057,Sievenpiper; Daniel F.,9991,0,9999,8
1715634664862,EDS 115,A00,507243,Choi; Bailey Miyeon,7,0,28,21
1715634666022,EDS 117,A01,494379,Staff,0,6,34,34
1715634667263,EDS 125,A00,507246,Hopkins; Megan Beth,8,0,30,22
1715634668557,EDS 128A,A01,507264,Fargason; Sharon Gayle,6,0,26,20
1715634669729,EDS 128B,A01,507293,Pappas; Elizabeth,10,0,30,20
1715634670911,EDS 139,A00,507294,Fargason; Sharon Gayle,10,0,30,20
1715634670911,EDS 139,B00,507313,Pappas; Elizabeth,11,0,30,19
1715634672038,EDS 201,A00,507315,Staff,10,0,30,20
1715634673244,EDS 203,A01,507317,Halter; Christopher P.,10,0,30,20
1715634674425,EDS 204R,A01,507319,Halter; Christopher P.,0,3,30,30
1715634674425,EDS 204R,B01,507331,Heinzman; Erica M.,14,0,30,16
1715634675636,EDS 206R,A00,507332,Staff,0,4,30,30
1715634675636,EDS 206R,B00,507343,Staff,15,0,30,15
1715634676824,EDS 250,A00,507344,Hemans; Patricia Ann Benitez,20,0,40,20
1715634677976,EDS 281,A00,507345,Daly; Alan J.,18,0,18,0
1715634679099,EDS 284,A00,507350,Daly; Alan J.,16,0,16,0
1715634680289,EDS 286,A00,507359,Fine; Sarah,18,0,18,0
1715634681629,EDS 289C,A01,507361,Daly; Alan J.,18,0,18,0
1715634682803,EDS 290,A00,507366,Hofstetter; Carolyn,15,0,15,0
1715634684040,LIGM 5A,A00,507421,Fischer-Grunski; Eva K,17,0,20,3
1715634685145,LIGM 5B,A00,507423,Fischer-Grunski; Eva K,19,0,20,1
1715634686189,LIGM 5C,A00,507425,Fischer-Grunski; Eva K,19,0,20,1
1715634687535,LIIT 5AS,A00,507427,Carnelos; Chiara,20,0,20,0
1715634688908,LIIT 5BS,A00,507430,Carnelos; Chiara,20,0,20,0
1715634690362,LIIT 5CS,A00,507432,Carnelos; Chiara,20,0,20,0
1715634691592,LISP 5A,A00,507541,Munoz Sanchez; Alicia,11,0,20,9
1715634692746,LISP 5B,A00,507671,Munoz Sanchez; Alicia,9,0,20,11
1715634694020,LISP 5C,A00,507696,Munoz Sanchez; Alicia,9,0,20,11
1715634695162,MAE 197,001,528363,Boechler; Nicholas Sebastia,9998,0,9999,1
1715634696288,MATH 197,001,523477,Kedlaya; Kiran S.,9994,0,9999,5
1715634696288,MATH 197,002,563811,Zhang; Danna,9994,0,9999,5
1715634696288,MATH 197,003,628552,Dumitriu; Ioana,9998,0,9999,1
1715634696288,MATH 197,004,660885,Floyd; Eric,9998,0,9999,1
1715634697660,MCWP 40R,A00,518780,Staff,2,0,20,18
1715634697660,MCWP 40R,B00,518781,Staff,11,0,20,9
1715634697660,MCWP 40R,C00,518783,Staff,5,0,20,15
1715634698852,MCWP 50R,A00,518791,Staff,0,1,20,20
1715634698852,MCWP 50R,B00,518792,Staff,0,2,20,20
1715634698852,MCWP 50R,C00,518793,Staff,0,4,20,20
1715634698852,MCWP 50R,D00,518794,Staff,0,1,20,20
1715634698852,MCWP 50R,E00,518795,Staff,0,2,20,20
1715634698852,MCWP 50R,F00,518796,Staff,0,1,20,20
1715634698852,MCWP 50R,G00,518797,Staff,0,1,20,20
1715634700028,MMW 12R,A01,514034,Herbst; Matthew,0,2,16,16
1715634700028,MMW 12R,A02,514035,Herbst; Matthew,0,0,16,16
1715634701423,MMW 13R,A01,514037,Staff,0,5,16,16
1715634701423,MMW 13R,A02,514039,Staff,0,5,16,16
1715634701423,MMW 13R,A03,628519,Staff,0,4,16,16
1715634703699,SIO 295LS,A00,523233,Staff,10,0,30,20
1715634704851,SIO 295S,A00,523232,Staff,10,0,30,20
1715634706029,SIOC 290S,A01,637330,Merrifield; Mark A,21,0,30,9
1715634707166,SIOC 291S,A01,637333,Gabriel; Corey John,21,0,30,9
1715634708414,SOCI 117,A01,494376,Staff,0,5,5,5
1715634709720,WES 237B,A00,494380,Staff,10,0,20,10
1715634712381,AESE 279B,A00,494370,Wade; Jon P,0,0,33,33
1715634713804,AIP 97,001,660915,Van Den Einde; Yael Dahlia,9998,0,9999,1
1715634715016,AIP 197,001,627712,Vespa; Emanuel Ignacio,9995,0,9999,4
1715634715016,AIP 197,002,650778,Amir; On,9998,0,9999,1
1715634715016,AIP 197,003,650933,Avenancio-Leon; Carlos,9998,0,9999,1
1715634715016,AIP 197,004,658530,Heyman; Gail D.,9998,0,9999,1
1715634715016,AIP 197,005,658631,Neal; Sonya E,9998,0,9999,1
1715634715016,AIP 197,006,658671,Du; Songzi,9998,0,9999,1
1715634716149,ANAR 135S,A00,494369,Braswell; Geoffrey E.,0,0,0,0
1715634717412,BENG 196,001,628496,Engler; Adam J.,9998,0,9999,1
1715634717412,BENG 196,002,660916,Watson; John Thomas,9999,0,9999,0
1715634718634,BISP 197,001,650773,Wilhelm; James E.,9994,0,9999,5
1715634718634,BISP 197,002,658904,Coleman; Aaron B.,9998,0,9999,1
1715634719866,CAT 124RS,A01,519847,Geibel; William,0,0,20,20
1715634720959,CAT 125RS,A01,515971,Geibel; William,0,0,20,20
1715634722132,CLRE 250,A00,511389,Morris; Sheldon,9992,0,9999,7
1715634723481,CLRE 251,A00,507176,Mehta; Ravindra L.,9992,0,9999,7
1715634723481,CLRE 251,B00,511410,Mehta; Ravindra L.,9998,0,9999,1
1715634724699,CLRE 252,A00,507189,Cuomo; Raphael Eduardo,9994,0,9999,5
1715634725897,CLRE 253,A00,507199,Vaida; Florin,9994,0,9999,5
1715634725897,CLRE 253,B00,507202,Vaida; Florin,9999,0,9999,0
1715634727060,CLRE 259,A00,507211,Patel; Hemal,9996,0,9999,3
1715634728173,CLRE 260,A00,507221,Cuomo; Raphael Eduardo,9999,0,9999,0
1715634729321,CLRE 297,001,507242,Cuomo; Raphael Eduardo,9999,0,9999,0
1715634730418,COGS 197,001,638244,Voytek; Bradley Thomas,9997,0,9999,2
1715634731586,CSE 191,A00,516875,Minnes Kemp; Mor Mia,9991,0,9999,8
1715634732769,CSE 197,001,637388,Minnes Kemp; Mor Mia,9992,0,9999,7
1715634733912,CSS 201S,A01,494383,Mignozzetti; Umberto,35,0,35,0
1715634735137,CSS 202S,A01,494387,Mignozzetti; Umberto,35,0,35,0
1715634736329,DSC 197,001,628532,Eldridge; Justin Matthew,9995,0,9999,4
1715634737574,EAP 100,A00,516065,Staff,9799,0,9999,200
1715634738669,ECE 45,A01,507414,Staff,31,0,60,29
1715634741044,ECE 111,A01,507420,Staff,11,0,50,39
1715634742245,ECE 197,001,548057,Sievenpiper; Daniel F.,9991,0,9999,8
1715634743421,EDS 115,A00,507243,Choi; Bailey Miyeon,7,0,28,21
1715634744639,EDS 117,A01,494379,Staff,0,6,34,34
1715634745813,EDS 125,A00,507246,Hopkins; Megan Beth,8,0,30,22
1715634747038,EDS 128A,A01,507264,Fargason; Sharon Gayle,6,0,26,20
1715634748227,EDS 128B,A01,507293,Pappas; Elizabeth,10,0,30,20
1715634749358,EDS 139,A00,507294,Fargason; Sharon Gayle,10,0,30,20
1715634749358,EDS 139,B00,507313,Pappas; Elizabeth,11,0,30,19
1715634750497,EDS 201,A00,507315,Staff,10,0,30,20
1715634751610,EDS 203,A01,507317,Halter; Christopher P.,10,0,30,20
1715634752745,EDS 204R,A01,507319,Halter; Christopher P.,0,3,30,30
1715634752745,EDS 204R,B01,507331,Heinzman; Erica M.,14,0,30,16
1715634753876,EDS 206R,A00,507332,Staff,0,4,30,30
1715634753876,EDS 206R,B00,507343,Staff,15,0,30,15
1715634755036,EDS 250,A00,507344,Hemans; Patricia Ann Benitez,20,0,40,20
1715634756234,EDS 281,A00,507345,Daly; Alan J.,18,0,18,0
1715634757413,EDS 284,A00,507350,Daly; Alan J.,16,0,16,0
1715634758524,EDS 286,A00,507359,Fine; Sarah,18,0,18,0
1715634759675,EDS 289C,A01,507361,Daly; Alan J.,18,0,18,0
1715634760913,EDS 290,A00,507366,Hofstetter; Carolyn,15,0,15,0
1715634762136,LIGM 5A,A00,507421,Fischer-Grunski; Eva K,17,0,20,3
1715634763314,LIGM 5B,A00,507423,Fischer-Grunski; Eva K,19,0,20,1
1715634764494,LIGM 5C,A00,507425,Fischer-Grunski; Eva K,19,0,20,1
1715634765648,LIIT 5AS,A00,507427,Carnelos; Chiara,20,0,20,0
1715634766818,LIIT 5BS,A00,507430,Carnelos; Chiara,20,0,20,0
1715634768091,LIIT 5CS,A00,507432,Carnelos; Chiara,20,0,20,0
1715634769128,LISP 5A,A00,507541,Munoz Sanchez; Alicia,11,0,20,9
1715634770417,LISP 5B,A00,507671,Munoz Sanchez; Alicia,9,0,20,11
1715634771516,LISP 5C,A00,507696,Munoz Sanchez; Alicia,9,0,20,11
1715634772661,MAE 197,001,528363,Boechler; Nicholas Sebastia,9998,0,9999,1
1715634773832,MATH 197,001,523477,Kedlaya; Kiran S.,9994,0,9999,5
1715634773832,MATH 197,002,563811,Zhang; Danna,9994,0,9999,5
1715634773832,MATH 197,003,628552,Dumitriu; Ioana,9998,0,9999,1
1715634773832,MATH 197,004,660885,Floyd; Eric,9998,0,9999,1
1715634774929,MCWP 40R,A00,518780,Staff,2,0,20,18
1715634774929,MCWP 40R,B00,518781,Staff,10,0,20,10
1715634774929,MCWP 40R,C00,518783,Staff,5,0,20,15
1715634776173,MCWP 50R,A00,518791,Staff,0,1,20,20
1715634776173,MCWP 50R,B00,518792,Staff,0,2,20,20
1715634776173,MCWP 50R,C00,518793,Staff,0,4,20,20
1715634776173,MCWP 50R,D00,518794,Staff,0,1,20,20
1715634776173,MCWP 50R,E00,518795,Staff,0,2,20,20
1715634776173,MCWP 50R,F00,518796,Staff,0,1,20,20
1715634776173,MCWP 50R,G00,518797,Staff,0,1,20,20
1715634777427,MMW 12R,A01,514034,Herbst; Matthew,0,2,16,16
1715634777427,MMW 12R,A02,514035,Herbst; Matthew,0,0,16,16
1715634778637,MMW 13R,A01,514037,Staff,0,5,16,16
1715634778637,MMW 13R,A02,514039,Staff,0,5,16,16
1715634778637,MMW 13R,A03,628519,Staff,0,4,16,16
1715634781083,SIO 295LS,A00,523233,Staff,10,0,30,20
1715634782418,SIO 295S,A00,523232,Staff,10,0,30,20
1715634783826,SIOC 290S,A01,637330,Merrifield; Mark A,21,0,30,9
1715634785318,SIOC 291S,A01,637333,Gabriel; Corey John,21,0,30,9
1715634786396,SOCI 117,A01,494376,Staff,0,5,5,5
1715634787531,WES 237B,A00,494380,Staff,10,0,20,10
1715634790682,AESE 279B,A00,494370,Wade; Jon P,0,0,33,33
1715634791867,AIP 97,001,660915,Van Den Einde; Yael Dahlia,9998,0,9999,1
1715634793097,AIP 197,001,627712,Vespa; Emanuel Ignacio,9995,0,9999,4
1715634793097,AIP 197,002,650778,Amir; On,9998,0,9999,1
1715634793097,AIP 197,003,650933,Avenancio-Leon; Carlos,9998,0,9999,1
1715634793097,AIP 197,004,658530,Heyman; Gail D.,9998,0,9999,1
1715634793097,AIP 197,005,658631,Neal; Sonya E,9998,0,9999,1
1715634793097,AIP 197,006,658671,Du; Songzi,9998,0,9999,1
1715634794215,ANAR 135S,A00,494369,Braswell; Geoffrey E.,0,0,0,0
1715634795910,BENG 196,001,628496,Engler; Adam J.,9998,0,9999,1
1715634795910,BENG 196,002,660916,Watson; John Thomas,9999,0,9999,0
1715634797378,BISP 197,001,650773,Wilhelm; James E.,9994,0,9999,5
1715634797378,BISP 197,002,658904,Coleman; Aaron B.,9998,0,9999,1
1715634798500,CAT 124RS,A01,519847,Geibel; William,0,0,20,20
1715634799607,CAT 125RS,A01,515971,Geibel; William,0,0,20,20
1715634800861,CLRE 250,A00,511389,Morris; Sheldon,9992,0,9999,7
1715634802004,CLRE 251,A00,507176,Mehta; Ravindra L.,9992,0,9999,7
1715634802004,CLRE 251,B00,511410,Mehta; Ravindra L.,9998,0,9999,1
1715634803242,CLRE 252,A00,507189,Cuomo; Raphael Eduardo,9994,0,9999,5
1715634804369,CLRE 253,A00,507199,Vaida; Florin,9994,0,9999,5
1715634804369,CLRE 253,B00,507202,Vaida; Florin,9999,0,9999,0
1715634805497,CLRE 259,A00,507211,Patel; Hemal,9996,0,9999,3
1715634806715,CLRE 260,A00,507221,Cuomo; Raphael Eduardo,9999,0,9999,0
1715634807800,CLRE 297,001,507242,Cuomo; Raphael Eduardo,9999,0,9999,0
1715634809025,COGS 197,001,638244,Voytek; Bradley Thomas,9997,0,9999,2
1715634810204,CSE 191,A00,516875,Minnes Kemp; Mor Mia,9991,0,9999,8
1715634811385,CSE 197,001,637388,Minnes Kemp; Mor Mia,9992,0,9999,7
1715634812528,CSS 201S,A01,494383,Mignozzetti; Umberto,35,0,35,0
1715634813650,CSS 202S,A01,494387,Mignozzetti; Umberto,35,0,35,0
1715634814888,DSC 197,001,628532,Eldridge; Justin Matthew,9995,0,9999,4
1715634816090,EAP 100,A00,516065,Staff,9799,0,9999,200
1715634817302,ECE 45,A01,507414,Staff,31,0,60,29
1715634819539,ECE 111,A01,507420,Staff,11,0,50,39
1715634820771,ECE 197,001,548057,Sievenpiper; Daniel F.,9991,0,9999,8
1715634821902,EDS 115,A00,507243,Choi; Bailey Miyeon,7,0,28,21
1715634823001,EDS 117,A01,494379,Staff,0,6,34,34
1715634824166,EDS 125,A00,507246,Hopkins; Megan Beth,8,0,30,22
1715634825353,EDS 128A,A01,507264,Fargason; Sharon Gayle,6,0,26,20
1715634826542,EDS 128B,A01,507293,Pappas; Elizabeth,10,0,30,20
1715634827659,EDS 139,A00,507294,Fargason; Sharon Gayle,10,0,30,20
1715634827659,EDS 139,B00,507313,Pappas; Elizabeth,11,0,30,19
1715634828820,EDS 201,A00,507315,Staff,10,0,30,20
1715634830025,EDS 203,A01,507317,Halter; Christopher P.,10,0,30,20
1715634831662,EDS 204R,A01,507319,Halter; Christopher P.,0,3,30,30
1715634831662,EDS 204R,B01,507331,Heinzman; Erica M.,14,0,30,16
1715634832948,EDS 206R,A00,507332,Staff,0,4,30,30
1715634832948,EDS 206R,B00,507343,Staff,15,0,30,15
1715634834197,EDS 250,A00,507344,Hemans; Patricia Ann Benitez,20,0,40,20
1715634835388,EDS 281,A00,507345,Daly; Alan J.,18,0,18,0
1715634836449,EDS 284,A00,507350,Daly; Alan J.,16,0,16,0
1715634837583,EDS 286,A00,507359,Fine; Sarah,18,0,18,0
1715634838727,EDS 289C,A01,507361,Daly; Alan J.,18,0,18,0
1715634840070,EDS 290,A00,507366,Hofstetter; Carolyn,15,0,15,0
1715634841262,LIGM 5A,A00,507421,Fischer-Grunski; Eva K,17,0,20,3
1715634842432,LIGM 5B,A00,507423,Fischer-Grunski; Eva K,19,0,20,1
1715634843656,LIGM 5C,A00,507425,Fischer-Grunski; Eva K,19,0,20,1
1715634844768,LIIT 5AS,A00,507427,Carnelos; Chiara,20,0,20,0
1715634845904,LIIT 5BS,A00,507430,Carnelos; Chiara,20,0,20,0
1715634847145,LIIT 5CS,A00,507432,Carnelos; Chiara,20,0,20,0
1715634848326,LISP 5A,A00,507541,Munoz Sanchez; Alicia,11,0,20,9
1715634849406,LISP 5B,A00,507671,Munoz Sanchez; Alicia,9,0,20,11
1715634850654,LISP 5C,A00,507696,Munoz Sanchez; Alicia,9,0,20,11
1715634851776,MAE 197,001,528363,Boechler; Nicholas Sebastia,9998,0,9999,1
1715634853050,MATH 197,001,523477,Kedlaya; Kiran S.,9994,0,9999,5
1715634853050,MATH 197,002,563811,Zhang; Danna,9994,0,9999,5
1715634853050,MATH 197,003,628552,Dumitriu; Ioana,9998,0,9999,1
1715634853050,MATH 197,004,660885,Floyd; Eric,9998,0,9999,1
1715634854477,MCWP 40R,A00,518780,Staff,2,0,20,18
1715634854477,MCWP 40R,B00,518781,Staff,10,0,20,10
1715634854477,MCWP 40R,C00,518783,Staff,5,0,20,15
1715634855553,MCWP 50R,A00,518791,Staff,0,1,20,20
1715634855553,MCWP 50R,B00,518792,Staff,0,2,20,20
1715634855553,MCWP 50R,C00,518793,Staff,0,4,20,20
1715634855553,MCWP 50R,D00,518794,Staff,0,1,20,20
1715634855553,MCWP 50R,E00,518795,Staff,0,2,20,20
1715634855553,MCWP 50R,F00,518796,Staff,0,1,20,20
1715634855553,MCWP 50R,G00,518797,Staff,0,1,20,20
1715634856647,MMW 12R,A01,514034,Herbst; Matthew,0,2,16,16
1715634856647,MMW 12R,A02,514035,Herbst; Matthew,0,0,16,16
1715634857859,MMW 13R,A01,514037,Staff,0,5,16,16
1715634857859,MMW 13R,A02,514039,Staff,0,5,16,16
1715634857859,MMW 13R,A03,628519,Staff,0,4,16,16
1715634860113,SIO 295LS,A00,523233,Staff,10,0,30,20
1715634861313,SIO 295S,A00,523232,Staff,10,0,30,20
1715634862595,SIOC 290S,A01,637330,Merrifield; Mark A,21,0,30,9
1715634864117,SIOC 291S,A01,637333,Gabriel; Corey John,21,0,30,9
1715634865498,SOCI 117,A01,494376,Staff,0,5,5,5
1715634866685,WES 237B,A00,494380,Staff,10,0,20,10
1715634869088,AESE 279B,A00,494370,Wade; Jon P,0,0,33,33
1715634870297,AIP 97,001,660915,Van Den Einde; Yael Dahlia,9998,0,9999,1
1715634871460,AIP 197,001,627712,Vespa; Emanuel Ignacio,9995,0,9999,4
1715634871460,AIP 197,002,650778,Amir; On,9998,0,9999,1
1715634871460,AIP 197,003,650933,Avenancio-Leon; Carlos,9998,0,9999,1
1715634871460,AIP 197,004,658530,Heyman; Gail D.,9998,0,9999,1
1715634871460,AIP 197,005,658631,Neal; Sonya E,9998,0,9999,1
1715634871460,AIP 197,006,658671,Du; Songzi,9998,0,9999,1
1715634872633,ANAR 135S,A00,494369,Braswell; Geoffrey E.,0,0,0,0
1715634873997,BENG 196,001,628496,Engler; Adam J.,9998,0,9999,1
1715634873997,BENG 196,002,660916,Watson; John Thomas,9999,0,9999,0
1715634875331,BISP 197,001,650773,Wilhelm; James E.,9994,0,9999,5
1715634875331,BISP 197,002,658904,Coleman; Aaron B.,9998,0,9999,1
1715634876599,CAT 124RS,A01,519847,Geibel; William,0,0,20,20
1715634877801,CAT 125RS,A01,515971,Geibel; William,0,0,20,20
1715634879007,CLRE 250,A00,511389,Morris; Sheldon,9992,0,9999,7
1715634880151,CLRE 251,A00,507176,Mehta; Ravindra L.,9992,0,9999,7
1715634880151,CLRE 251,B00,511410,Mehta; Ravindra L.,9998,0,9999,1
1715634881353,CLRE 252,A00,507189,Cuomo; Raphael Eduardo,9994,0,9999,5
1715634882584,CLRE 253,A00,507199,Vaida; Florin,9994,0,9999,5
1715634882584,CLRE 253,B00,507202,Vaida; Florin,9999,0,9999,0
1715634883857,CLRE 259,A00,507211,Patel; Hemal,9996,0,9999,3
1715634884929,CLRE 260,A00,507221,Cuomo; Raphael Eduardo,9999,0,9999,0
1715634886130,CLRE 297,001,507242,Cuomo; Raphael Eduardo,9999,0,9999,0
1715634887303,COGS 197,001,638244,Voytek; Bradley Thomas,9997,0,9999,2
1715634888504,CSE 191,A00,516875,Minnes Kemp; Mor Mia,9991,0,9999,8
1715634889918,CSE 197,001,637388,Minnes Kemp; Mor Mia,9992,0,9999,7
1715634891033,CSS 201S,A01,494383,Mignozzetti; Umberto,35,0,35,0
1715634892360,CSS 202S,A01,494387,Mignozzetti; Umberto,35,0,35,0
1715634893557,DSC 197,001,628532,Eldridge; Justin Matthew,9995,0,9999,4
1715634894682,EAP 100,A00,516065,Staff,9799,0,9999,200
1715634895879,ECE 45,A01,507414,Staff,31,0,60,29
1715634898227,ECE 111,A01,507420,Staff,11,0,50,39
1715634899408,ECE 197,001,548057,Sievenpiper; Daniel F.,9991,0,9999,8
1715634900532,EDS 115,A00,507243,Choi; Bailey Miyeon,7,0,28,21
1715634901710,EDS 117,A01,494379,Staff,0,6,34,34
1715634902940,EDS 125,A00,507246,Hopkins; Megan Beth,8,0,30,22
1715634904145,EDS 128A,A01,507264,Fargason; Sharon Gayle,6,0,26,20
1715634905265,EDS 128B,A01,507293,Pappas; Elizabeth,10,0,30,20
1715634906457,EDS 139,A00,507294,Fargason; Sharon Gayle,10,0,30,20
1715634906457,EDS 139,B00,507313,Pappas; Elizabeth,11,0,30,19
1715634907602,EDS 201,A00,507315,Staff,10,0,30,20
1715634908774,EDS 203,A01,507317,Halter; Christopher P.,10,0,30,20
1715634909968,EDS 204R,A01,507319,Halter; Christopher P.,0,3,30,30
1715634909968,EDS 204R,B01,507331,Heinzman; Erica M.,14,0,30,16
1715634911173,EDS 206R,A00,507332,Staff,0,4,30,30
1715634911173,EDS 206R,B00,507343,Staff,15,0,30,15
1715634912332,EDS 250,A00,507344,Hemans; Patricia Ann Benitez,20,0,40,20
1715634913545,EDS 281,A00,507345,Daly; Alan J.,18,0,18,0
1715634914641,EDS 284,A00,507350,Daly; Alan J.,16,0,16,0
1715634915772,EDS 286,A00,507359,Fine; Sarah,18,0,18,0
1715634917004,EDS 289C,A01,507361,Daly; Alan J.,18,0,18,0
1715634918096,EDS 290,A00,507366,Hofstetter; Carolyn,15,0,15,0
1715634919306,LIGM 5A,A00,507421,Fischer-Grunski; Eva K,17,0,20,3
1715634920498,LIGM 5B,A00,507423,Fischer-Grunski; Eva K,19,0,20,1
1715634921739,LIGM 5C,A00,507425,Fischer-Grunski; Eva K,19,0,20,1
1715634922957,LIIT 5AS,A00,507427,Carnelos; Chiara,20,0,20,0
1715634924337,LIIT 5BS,A00,507430,Carnelos; Chiara,20,0,20,0
1715634925598,LIIT 5CS,A00,507432,Carnelos; Chiara,20,0,20,0
1715634926706,LISP 5A,A00,507541,Munoz Sanchez; Alicia,11,0,20,9
1715634927949,LISP 5B,A00,507671,Munoz Sanchez; Alicia,9,0,20,11
1715634929171,LISP 5C,A00,507696,Munoz Sanchez; Alicia,9,0,20,11
1715634930335,MAE 197,001,528363,Boechler; Nicholas Sebastia,9998,0,9999,1
1715634931520,MATH 197,001,523477,Kedlaya; Kiran S.,9994,0,9999,5
1715634931520,MATH 197,002,563811,Zhang; Danna,9994,0,9999,5
1715634931520,MATH 197,003,628552,Dumitriu; Ioana,9998,0,9999,1
1715634931520,MATH 197,004,660885,Floyd; Eric,9998,0,9999,1
1715634932605,MCWP 40R,A00,518780,Staff,2,0,20,18
1715634932605,MCWP 40R,B00,518781,Staff,10,0,20,10
1715634932605,MCWP 40R,C00,518783,Staff,5,0,20,15
1715634934028,MCWP 50R,A00,518791,Staff,0,1,20,20
1715634934028,MCWP 50R,B00,518792,Staff,0,2,20,20
1715634934028,MCWP 50R,C00,518793,Staff,0,4,20,20
1715634934028,MCWP 50R,D00,518794,Staff,0,1,20,20
1715634934028,MCWP 50R,E00,518795,Staff,0,2,20,20
1715634934028,MCWP 50R,F00,518796,Staff,0,1,20,20
1715634934028,MCWP 50R,G00,518797,Staff,0,1,20,20
1715634935427,MMW 12R,A01,514034,Herbst; Matthew,0,2,16,16
1715634935427,MMW 12R,A02,514035,Herbst; Matthew,0,0,16,16
1715634936505,MMW 13R,A01,514037,Staff,0,5,16,16
1715634936505,MMW 13R,A02,514039,Staff,0,5,16,16
1715634936505,MMW 13R,A03,628519,Staff,0,4,16,16
1715634938877,SIO 295LS,A00,523233,Staff,10,0,30,20
1715634940036,SIO 295S,A00,523232,Staff,10,0,30,20
1715634941708,SIOC 290S,A01,637330,Merrifield; Mark A,21,0,30,9
1715634942987,SIOC 291S,A01,637333,Gabriel; Corey John,21,0,30,9
1715634944124,SOCI 117,A01,494376,Staff,0,5,5,5
1715634945293,WES 237B,A00,494380,Staff,10,0,20,10
1715634947744,AESE 279B,A00,494370,Wade; Jon P,0,0,33,33
1715634948959,AIP 97,001,660915,Van Den Einde; Yael Dahlia,9998,0,9999,1
1715634950013,AIP 197,001,627712,Vespa; Emanuel Ignacio,9995,0,9999,4
1715634950013,AIP 197,002,650778,Amir; On,9998,0,9999,1
1715634950013,AIP 197,003,650933,Avenancio-Leon; Carlos,9998,0,9999,1
1715634950013,AIP 197,004,658530,Heyman; Gail D.,9998,0,9999,1
1715634950013,AIP 197,005,658631,Neal; Sonya E,9998,0,9999,1
1715634950013,AIP 197,006,658671,Du; Songzi,9998,0,9999,1
1715634951201,ANAR 135S,A00,494369,Braswell; Geoffrey E.,0,0,0,0
1715634952612,BENG 196,001,628496,Engler; Adam J.,9998,0,9999,1
1715634952612,BENG 196,002,660916,Watson; John Thomas,9999,0,9999,0
1715634953870,BISP 197,001,650773,Wilhelm; James E.,9994,0,9999,5
1715634953870,BISP 197,002,658904,Coleman; Aaron B.,9998,0,9999,1
1715634955207,CAT 124RS,A01,519847,Geibel; William,0,0,20,20
1715634956420,CAT 125RS,A01,515971,Geibel; William,0,0,20,20
1715634957649,CLRE 250,A00,511389,Morris; Sheldon,9992,0,9999,7
1715634958791,CLRE 251,A00,507176,Mehta; Ravindra L.,9992,0,9999,7
1715634958791,CLRE 251,B00,511410,Mehta; Ravindra L.,9998,0,9999,1
1715634960030,CLRE 252,A00,507189,Cuomo; Raphael Eduardo,9994,0,9999,5
1715634961289,CLRE 253,A00,507199,Vaida; Florin,9994,0,9999,5
1715634961289,CLRE 253,B00,507202,Vaida; Florin,9999,0,9999,0
1715634962484,CLRE 259,A00,507211,Patel; Hemal,9996,0,9999,3
1715634963652,CLRE 260,A00,507221,Cuomo; Raphael Eduardo,9999,0,9999,0
1715634964837,CLRE 297,001,507242,Cuomo; Raphael Eduardo,9999,0,9999,0
1715634966003,COGS 197,001,638244,Voytek; Bradley Thomas,9997,0,9999,2
1715634967250,CSE 191,A00,516875,Minnes Kemp; Mor Mia,9991,0,9999,8
1715634968375,CSE 197,001,637388,Minnes Kemp; Mor Mia,9992,0,9999,7
1715634969528,CSS 201S,A01,494383,Mignozzetti; Umberto,35,0,35,0
1715634970623,CSS 202S,A01,494387,Mignozzetti; Umberto,35,0,35,0
1715634971797,DSC 197,001,628532,Eldridge; Justin Matthew,9995,0,9999,4
1715634973174,EAP 100,A00,516065,Staff,9799,0,9999,200
1715634974395,ECE 45,A01,507414,Staff,31,0,60,29
1715634976594,ECE 111,A01,507420,Staff,11,0,50,39
1715634977838,ECE 197,001,548057,Sievenpiper; Daniel F.,9991,0,9999,8
1715634978985,EDS 115,A00,507243,Choi; Bailey Miyeon,7,0,28,21
1715634980307,EDS 117,A01,494379,Staff,0,6,34,34
1715634981489,EDS 125,A00,507246,Hopkins; Megan Beth,8,0,30,22
1715634982775,EDS 128A,A01,507264,Fargason; Sharon Gayle,6,0,26,20
1715634983961,EDS 128B,A01,507293,Pappas; Elizabeth,10,0,30,20
1715634985076,EDS 139,A00,507294,Fargason; Sharon Gayle,10,0,30,20
1715634985076,EDS 139,B00,507313,Pappas; Elizabeth,11,0,30,19
1715634986237,EDS 201,A00,507315,Staff,10,0,30,20
1715634987397,EDS 203,A01,507317,Halter; Christopher P.,10,0,30,20
1715634988517,EDS 204R,A01,507319,Halter; Christopher P.,0,3,30,30
1715634988517,EDS 204R,B01,507331,Heinzman; Erica M.,14,0,30,16
1715634989682,EDS 206R,A00,507332,Staff,0,4,30,30
1715634989682,EDS 206R,B00,507343,Staff,15,0,30,15
1715634990886,EDS 250,A00,507344,Hemans; Patricia Ann Benitez,20,0,40,20
1715634992051,EDS 281,A00,507345,Daly; Alan J.,18,0,18,0
1715634993277,EDS 284,A00,507350,Daly; Alan J.,16,0,16,0
1715634994433,EDS 286,A00,507359,Fine; Sarah,18,0,18,0
1715634995625,EDS 289C,A01,507361,Daly; Alan J.,18,0,18,0
1715634996760,EDS 290,A00,507366,Hofstetter; Carolyn,15,0,15,0
1715634997963,LIGM 5A,A00,507421,Fischer-Grunski; Eva K,17,0,20,3
1715634999128,LIGM 5B,A00,507423,Fischer-Grunski; Eva K,19,0,20,1
1715635000323,LIGM 5C,A00,507425,Fischer-Grunski; Eva K,19,0,20,1
1715635001409,LIIT 5AS,A00,507427,Carnelos; Chiara,20,0,20,0
1715635002639,LIIT 5BS,A00,507430,Carnelos; Chiara,20,0,20,0
1715635004008,LIIT 5CS,A00,507432,Carnelos; Chiara,20,0,20,0
1715635005331,LISP 5A,A00,507541,Munoz Sanchez; Alicia,11,0,20,9
1715635006544,LISP 5B,A00,507671,Munoz Sanchez; Alicia,9,0,20,11
1715635007753,LISP 5C,A00,507696,Munoz Sanchez; Alicia,9,0,20,11
1715635008926,MAE 197,001,528363,Boechler; Nicholas Sebastia,9998,0,9999,1
1715635010270,MATH 197,001,523477,Kedlaya; Kiran S.,9994,0,9999,5
1715635010270,MATH 197,002,563811,Zhang; Danna,9994,0,9999,5
1715635010270,MATH 197,003,628552,Dumitriu; Ioana,9998,0,9999,1
1715635010270,MATH 197,004,660885,Floyd; Eric,9998,0,9999,1
1715635011529,MCWP 40R,A00,518780,Staff,2,0,20,18
1715635011529,MCWP 40R,B00,518781,Staff,10,0,20,10
1715635011529,MCWP 40R,C00,518783,Staff,5,0,20,15
1715635012735,MCWP 50R,A00,518791,Staff,0,1,20,20
1715635012735,MCWP 50R,B00,518792,Staff,0,2,20,20
1715635012735,MCWP 50R,C00,518793,Staff,0,4,20,20
1715635012735,MCWP 50R,D00,518794,Staff,0,1,20,20
1715635012735,MCWP 50R,E00,518795,Staff,0,2,20,20
1715635012735,MCWP 50R,F00,518796,Staff,0,1,20,20
1715635012735,MCWP 50R,G00,518797,Staff,0,1,20,20
1715635013917,MMW 12R,A01,514034,Herbst; Matthew,0,2,16,16
1715635013917,MMW 12R,A02,514035,Herbst; Matthew,0,0,16,16
1715635015167,MMW 13R,A01,514037,Staff,0,5,16,16
1715635015167,MMW 13R,A02,514039,Staff,0,5,16,16
1715635015167,MMW 13R,A03,628519,Staff,0,4,16,16
1715635017503,SIO 295LS,A00,523233,Staff,10,0,30,20
1715635018656,SIO 295S,A00,523232,Staff,10,0,30,20
1715635019785,SIOC 290S,A01,637330,Merrifield; Mark A,21,0,30,9
1715635021049,SIOC 291S,A01,637333,Gabriel; Corey John,21,0,30,9
1715635022232,SOCI 117,A01,494376,Staff,0,5,5,5
1715635023531,WES 237B,A00,494380,Staff,10,0,20,10
1715635026013,AESE 279B,A00,494370,Wade; Jon P,0,0,33,33
1715635027295,AIP 97,001,660915,Van Den Einde; Yael Dahlia,9998,0,9999,1
1715635028564,AIP 197,001,627712,Vespa; Emanuel Ignacio,9995,0,9999,4
1715635028564,AIP 197,002,650778,Amir; On,9998,0,9999,1
1715635028564,AIP 197,003,650933,Avenancio-Leon; Carlos,9998,0,9999,1
1715635028564,AIP 197,004,658530,Heyman; Gail D.,9998,0,9999,1
1715635028564,AIP 197,005,658631,Neal; Sonya E,9998,0,9999,1
1715635028564,AIP 197,006,658671,Du; Songzi,9998,0,9999,1
1715635029810,ANAR 135S,A00,494369,Braswell; Geoffrey E.,0,0,0,0
1715635031064,BENG 196,001,628496,Engler; Adam J.,9998,0,9999,1
1715635031064,BENG 196,002,660916,Watson; John Thomas,9999,0,9999,0
1715635032374,BISP 197,001,650773,Wilhelm; James E.,9994,0,9999,5
1715635032374,BISP 197,002,658904,Coleman; Aaron B.,9998,0,9999,1
1715635033641,CAT 124RS,A01,519847,Geibel; William,0,0,20,20
1715635035527,CAT 125RS,A01,515971,Geibel; William,0,0,20,20
1715635036837,CLRE 250,A00,511389,Morris; Sheldon,9992,0,9999,7
1715635038003,CLRE 251,A00,507176,Mehta; Ravindra L.,9992,0,9999,7
1715635038003,CLRE 251,B00,511410,Mehta; Ravindra L.,9998,0,9999,1
1715635039076,CLRE 252,A00,507189,Cuomo; Raphael Eduardo,9994,0,9999,5
1715635040710,CLRE 253,A00,507199,Vaida; Florin,9994,0,9999,5
1715635040710,CLRE 253,B00,507202,Vaida; Florin,9999,0,9999,0
1715635041741,CLRE 259,A00,507211,Patel; Hemal,9996,0,9999,3
1715635042938,CLRE 260,A00,507221,Cuomo; Raphael Eduardo,9999,0,9999,0
1715635044560,CLRE 297,001,507242,Cuomo; Raphael Eduardo,9999,0,9999,0
1715635045937,COGS 197,001,638244,Voytek; Bradley Thomas,9997,0,9999,2
1715635047032,CSE 191,A00,516875,Minnes Kemp; Mor Mia,9991,0,9999,8
1715635048345,CSE 197,001,637388,Minnes Kemp; Mor Mia,9992,0,9999,7
1715635049778,CSS 201S,A01,494383,Mignozzetti; Umberto,35,0,35,0
1715635051224,CSS 202S,A01,494387,Mignozzetti; Umberto,35,0,35,0
1715635052354,DSC 197,001,628532,Eldridge; Justin Matthew,9995,0,9999,4
1715635053761,EAP 100,A00,516065,Staff,9799,0,9999,200
1715635054973,ECE 45,A01,507414,Staff,31,0,60,29
1715635057539,ECE 111,A01,507420,Staff,11,0,50,39
1715635058785,ECE 197,001,548057,Sievenpiper; Daniel F.,9991,0,9999,8
1715635060062,EDS 115,A00,507243,Choi; Bailey Miyeon,7,0,28,21
1715635061478,EDS 117,A01,494379,Staff,0,6,34,34
1715635062613,EDS 125,A00,507246,Hopkins; Megan Beth,8,0,30,22
1715635063901,EDS 128A,A01,507264,Fargason; Sharon Gayle,6,0,26,20
1715635065160,EDS 128B,A01,507293,Pappas; Elizabeth,10,0,30,20
1715635066312,EDS 139,A00,507294,Fargason; Sharon Gayle,10,0,30,20
1715635066312,EDS 139,B00,507313,Pappas; Elizabeth,11,0,30,19
1715635067411,EDS 201,A00,507315,Staff,10,0,30,20
1715635068590,EDS 203,A01,507317,Halter; Christopher P.,10,0,30,20
1715635069785,EDS 204R,A01,507319,Halter; Christopher P.,0,3,30,30
1715635069785,EDS 204R,B01,507331,Heinzman; Erica M.,14,0,30,16
1715635070945,EDS 206R,A00,507332,Staff,0,4,30,30
1715635070945,EDS 206R,B00,507343,Staff,15,0,30,15
1715635072152,EDS 250,A00,507344,Hemans; Patricia Ann Benitez,20,0,40,20
1715635073318,EDS 281,A00,507345,Daly; Alan J.,18,0,18,0
1715635074439,EDS 284,A00,507350,Daly; Alan J.,16,0,16,0
1715635075700,EDS 286,A00,507359,Fine; Sarah,18,0,18,0
1715635076873,EDS 289C,A01,507361,Daly; Alan J.,18,0,18,0
1715635078470,EDS 290,A00,507366,Hofstetter; Carolyn,15,0,15,0
1715635079753,LIGM 5A,A00,507421,Fischer-Grunski; Eva K,17,0,20,3
1715635081206,LIGM 5B,A00,507423,Fischer-Grunski; Eva K,19,0,20,1
1715635082572,LIGM 5C,A00,507425,Fischer-Grunski; Eva K,19,0,20,1
1715635083827,LIIT 5AS,A00,507427,Carnelos; Chiara,20,0,20,0
1715635085175,LIIT 5BS,A00,507430,Carnelos; Chiara,20,0,20,0
1715635086367,LIIT 5CS,A00,507432,Carnelos; Chiara,20,0,20,0
1715635087652,LISP 5A,A00,507541,Munoz Sanchez; Alicia,11,0,20,9
1715635089185,LISP 5B,A00,507671,Munoz Sanchez; Alicia,9,0,20,11
1715635090321,LISP 5C,A00,507696,Munoz Sanchez; Alicia,9,0,20,11
1715635091560,MAE 197,001,528363,Boechler; Nicholas Sebastia,9998,0,9999,1
1715635092755,MATH 197,001,523477,Kedlaya; Kiran S.,9994,0,9999,5
1715635092755,MATH 197,002,563811,Zhang; Danna,9994,0,9999,5
1715635092755,MATH 197,003,628552,Dumitriu; Ioana,9998,0,9999,1
1715635092755,MATH 197,004,660885,Floyd; Eric,9998,0,9999,1
1715635093944,MCWP 40R,A00,518780,Staff,2,0,20,18
1715635093944,MCWP 40R,B00,518781,Staff,10,0,20,10
1715635093944,MCWP 40R,C00,518783,Staff,5,0,20,15
1715635095129,MCWP 50R,A00,518791,Staff,0,1,20,20
1715635095129,MCWP 50R,B00,518792,Staff,0,2,20,20
1715635095129,MCWP 50R,C00,518793,Staff,0,4,20,20
1715635095129,MCWP 50R,D00,518794,Staff,0,1,20,20
1715635095129,MCWP 50R,E00,518795,Staff,0,2,20,20
1715635095129,MCWP 50R,F00,518796,Staff,0,1,20,20
1715635095129,MCWP 50R,G00,518797,Staff,0,1,20,20
1715635096319,MMW 12R,A01,514034,Herbst; Matthew,0,2,16,16
1715635096319,MMW 12R,A02,514035,Herbst; Matthew,0,0,16,16
1715635097456,MMW 13R,A01,514037,Staff,0,5,16,16
1715635097456,MMW 13R,A02,514039,Staff,0,5,16,16
1715635097456,MMW 13R,A03,628519,Staff,0,4,16,16
1715635099862,SIO 295LS,A00,523233,Staff,10,0,30,20
1715635100957,SIO 295S,A00,523232,Staff,10,0,30,20
1715635102153,SIOC 290S,A01,637330,Merrifield; Mark A,21,0,30,9
1715635103343,SIOC 291S,A01,637333,Gabriel; Corey John,21,0,30,9
1715635104613,SOCI 117,A01,494376,Staff,0,5,5,5
1715635105839,WES 237B,A00,494380,Staff,10,0,20,10
1715635108256,AESE 279B,A00,494370,Wade; Jon P,0,0,33,33
1715635109464,AIP 97,001,660915,Van Den Einde; Yael Dahlia,9998,0,9999,1
1715635110699,AIP 197,001,627712,Vespa; Emanuel Ignacio,9995,0,9999,4
1715635110699,AIP 197,002,650778,Amir; On,9998,0,9999,1
1715635110699,AIP 197,003,650933,Avenancio-Leon; Carlos,9998,0,9999,1
1715635110699,AIP 197,004,658530,Heyman; Gail D.,9998,0,9999,1
1715635110699,AIP 197,005,658631,Neal; Sonya E,9998,0,9999,1
1715635110699,AIP 197,006,658671,Du; Songzi,9998,0,9999,1
1715635111854,ANAR 135S,A00,494369,Braswell; Geoffrey E.,0,0,0,0
1715635112983,BENG 196,001,628496,Engler; Adam J.,9998,0,9999,1
1715635112983,BENG 196,002,660916,Watson; John Thomas,9999,0,9999,0
1715635114140,BISP 197,001,650773,Wilhelm; James E.,9994,0,9999,5
1715635114140,BISP 197,002,658904,Coleman; Aaron B.,9998,0,9999,1
1715635115321,CAT 124RS,A01,519847,Geibel; William,0,0,20,20
1715635116596,CAT 125RS,A01,515971,Geibel; William,0,0,20,20
1715635117804,CLRE 250,A00,511389,Morris; Sheldon,9992,0,9999,7
1715635118962,CLRE 251,A00,507176,Mehta; Ravindra L.,9992,0,9999,7
1715635118962,CLRE 251,B00,511410,Mehta; Ravindra L.,9998,0,9999,1
1715635120183,CLRE 252,A00,507189,Cuomo; Raphael Eduardo,9994,0,9999,5
1715635121313,CLRE 253,A00,507199,Vaida; Florin,9994,0,9999,5
1715635121313,CLRE 253,B00,507202,Vaida; Florin,9999,0,9999,0
1715635122467,CLRE 259,A00,507211,Patel; Hemal,9996,0,9999,3
1715635123716,CLRE 260,A00,507221,Cuomo; Raphael Eduardo,9999,0,9999,0
1715635124960,CLRE 297,001,507242,Cuomo; Raphael Eduardo,9999,0,9999,0
1715635126098,COGS 197,001,638244,Voytek; Bradley Thomas,9997,0,9999,2
1715635127278,CSE 191,A00,516875,Minnes Kemp; Mor Mia,9991,0,9999,8
1715635128580,CSE 197,001,637388,Minnes Kemp; Mor Mia,9992,0,9999,7
1715635129823,CSS 201S,A01,494383,Mignozzetti; Umberto,35,0,35,0
1715635131033,CSS 202S,A01,494387,Mignozzetti; Umberto,35,0,35,0
1715635132157,DSC 197,001,628532,Eldridge; Justin Matthew,9995,0,9999,4
1715635133461,EAP 100,A00,516065,Staff,9799,0,9999,200
1715635134841,ECE 45,A01,507414,Staff,31,0,60,29
1715635137470,ECE 111,A01,507420,Staff,11,0,50,39
1715635138602,ECE 197,001,548057,Sievenpiper; Daniel F.,9991,0,9999,8
1715635139737,EDS 115,A00,507243,Choi; Bailey Miyeon,7,0,28,21
1715635141072,EDS 117,A01,494379,Staff,0,6,34,34
1715635142912,EDS 125,A00,507246,Hopkins; Megan Beth,8,0,30,22
1715635144098,EDS 128A,A01,507264,Fargason; Sharon Gayle,6,0,26,20
1715635145551,EDS 128B,A01,507293,Pappas; Elizabeth,10,0,30,20
1715635146713,EDS 139,A00,507294,Fargason; Sharon Gayle,10,0,30,20
1715635146713,EDS 139,B00,507313,Pappas; Elizabeth,11,0,30,19
1715635147989,EDS 201,A00,507315,Staff,10,0,30,20
1715635149261,EDS 203,A01,507317,Halter; Christopher P.,10,0,30,20
1715635150509,EDS 204R,A01,507319,Halter; Christopher P.,0,3,30,30
1715635150509,EDS 204R,B01,507331,Heinzman; Erica M.,14,0,30,16
1715635151715,EDS 206R,A00,507332,Staff,0,4,30,30
1715635151715,EDS 206R,B00,507343,Staff,15,0,30,15
1715635152896,EDS 250,A00,507344,Hemans; Patricia Ann Benitez,20,0,40,20
1715635154097,EDS 281,A00,507345,Daly; Alan J.,18,0,18,0
1715635155306,EDS 284,A00,507350,Daly; Alan J.,16,0,16,0
1715635156539,EDS 286,A00,507359,Fine; Sarah,18,0,18,0
1715635157651,EDS 289C,A01,507361,Daly; Alan J.,18,0,18,0
1715635158807,EDS 290,A00,507366,Hofstetter; Carolyn,15,0,15,0
1715635159920,LIGM 5A,A00,507421,Fischer-Grunski; Eva K,17,0,20,3
1715635161184,LIGM 5B,A00,507423,Fischer-Grunski; Eva K,19,0,20,1
1715635162525,LIGM 5C,A00,507425,Fischer-Grunski; Eva K,19,0,20,1
1715635163608,LIIT 5AS,A00,507427,Carnelos; Chiara,20,0,20,0
1715635164814,LIIT 5BS,A00,507430,Carnelos; Chiara,20,0,20,0
1715635165928,LIIT 5CS,A00,507432,Carnelos; Chiara,20,0,20,0
1715635167155,LISP 5A,A00,507541,Munoz Sanchez; Alicia,11,0,20,9
1715635168363,LISP 5B,A00,507671,Munoz Sanchez; Alicia,9,0,20,11
1715635169566,LISP 5C,A00,507696,Munoz Sanchez; Alicia,9,0,20,11
1715635170949,MAE 197,001,528363,Boechler; Nicholas Sebastia,9998,0,9999,1
1715635172125,MATH 197,001,523477,Kedlaya; Kiran S.,9994,0,9999,5
1715635172125,MATH 197,002,563811,Zhang; Danna,9994,0,9999,5
1715635172125,MATH 197,003,628552,Dumitriu; Ioana,9998,0,9999,1
1715635172125,MATH 197,004,660885,Floyd; Eric,9998,0,9999,1
1715635173376,MCWP 40R,A00,518780,Staff,2,0,20,18
1715635173376,MCWP 40R,B00,518781,Staff,10,0,20,10
1715635173376,MCWP 40R,C00,518783,Staff,5,0,20,15
1715635174770,MCWP 50R,A00,518791,Staff,0,1,20,20
1715635174770,MCWP 50R,B00,518792,Staff,0,2,20,20
1715635174770,MCWP 50R,C00,518793,Staff,0,4,20,20
1715635174770,MCWP 50R,D00,518794,Staff,0,1,20,20
1715635174770,MCWP 50R,E00,518795,Staff,0,2,20,20
1715635174770,MCWP 50R,F00,518796,Staff,0,1,20,20
1715635174770,MCWP 50R,G00,518797,Staff,0,1,20,20
1715635175932,MMW 12R,A01,514034,Herbst; Matthew,0,2,16,16
1715635175932,MMW 12R,A02,514035,Herbst; Matthew,0,0,16,16
1715635177226,MMW 13R,A01,514037,Staff,0,5,16,16
1715635177226,MMW 13R,A02,514039,Staff,0,5,16,16
1715635177226,MMW 13R,A03,628519,Staff,0,4,16,16
1715635179758,SIO 295LS,A00,523233,Staff,10,0,30,20
1715635181021,SIO 295S,A00,523232,Staff,10,0,30,20
1715635182453,SIOC 290S,A01,637330,Merrifield; Mark A,21,0,30,9
1715635183632,SIOC 291S,A01,637333,Gabriel; Corey John,21,0,30,9
1715635184756,SOCI 117,A01,494376,Staff,0,5,5,5
1715635185938,WES 237B,A00,494380,Staff,10,0,20,10
1715635188549,AESE 279B,A00,494370,Wade; Jon P,0,0,33,33
1715635189639,AIP 97,001,660915,Van Den Einde; Yael Dahlia,9998,0,9999,1
1715635190821,AIP 197,001,627712,Vespa; Emanuel Ignacio,9995,0,9999,4
1715635190821,AIP 197,002,650778,Amir; On,9998,0,9999,1
1715635190821,AIP 197,003,650933,Avenancio-Leon; Carlos,9998,0,9999,1
1715635190821,AIP 197,004,658530,Heyman; Gail D.,9998,0,9999,1
1715635190821,AIP 197,005,658631,Neal; Sonya E,9998,0,9999,1
1715635190821,AIP 197,006,658671,Du; Songzi,9998,0,9999,1
1715635192045,ANAR 135S,A00,494369,Braswell; Geoffrey E.,0,0,0,0
1715635193302,BENG 196,001,628496,Engler; Adam J.,9998,0,9999,1
1715635193302,BENG 196,002,660916,Watson; John Thomas,9999,0,9999,0
1715635194590,BISP 197,001,650773,Wilhelm; James E.,9994,0,9999,5
1715635194590,BISP 197,002,658904,Coleman; Aaron B.,9998,0,9999,1
1715635195702,CAT 124RS,A01,519847,Geibel; William,0,0,20,20
1715635196962,CAT 125RS,A01,515971,Geibel; William,0,0,20,20
1715635198237,CLRE 250,A00,511389,Morris; Sheldon,9992,0,9999,7
1715635199578,CLRE 251,A00,507176,Mehta; Ravindra L.,9992,0,9999,7
1715635199578,CLRE 251,B00,511410,Mehta; Ravindra L.,9998,0,9999,1
1715635200874,CLRE 252,A00,507189,Cuomo; Raphael Eduardo,9994,0,9999,5
1715635203460,CLRE 253,A00,507199,Vaida; Florin,9994,0,9999,5
1715635203460,CLRE 253,B00,507202,Vaida; Florin,9999,0,9999,0
1715635204581,CLRE 259,A00,507211,Patel; Hemal,9996,0,9999,3
1715635205819,CLRE 260,A00,507221,Cuomo; Raphael Eduardo,9999,0,9999,0
1715635206981,CLRE 297,001,507242,Cuomo; Raphael Eduardo,9999,0,9999,0
1715635208529,COGS 197,001,638244,Voytek; Bradley Thomas,9997,0,9999,2
1715635209657,CSE 191,A00,516875,Minnes Kemp; Mor Mia,9991,0,9999,8
1715635210886,CSE 197,001,637388,Minnes Kemp; Mor Mia,9992,0,9999,7
1715635212033,CSS 201S,A01,494383,Mignozzetti; Umberto,35,0,35,0
1715635213314,CSS 202S,A01,494387,Mignozzetti; Umberto,35,0,35,0
1715635214420,DSC 197,001,628532,Eldridge; Justin Matthew,9995,0,9999,4
1715635215923,EAP 100,A00,516065,Staff,9799,0,9999,200
1715635217039,ECE 45,A01,507414,Staff,31,0,60,29
1715635219850,ECE 111,A01,507420,Staff,11,0,50,39
1715635221029,ECE 197,001,548057,Sievenpiper; Daniel F.,9991,0,9999,8
1715635222370,EDS 115,A00,507243,Choi; Bailey Miyeon,7,0,28,21
1715635223559,EDS 117,A01,494379,Staff,0,6,34,34
1715635224789,EDS 125,A00,507246,Hopkins; Megan Beth,8,0,30,22
1715635225902,EDS 128A,A01,507264,Fargason; Sharon Gayle,6,0,26,20
1715635227043,EDS 128B,A01,507293,Pappas; Elizabeth,10,0,30,20
1715635228430,EDS 139,A00,507294,Fargason; Sharon Gayle,10,0,30,20
1715635228430,EDS 139,B00,507313,Pappas; Elizabeth,11,0,30,19
1715635229737,EDS 201,A00,507315,Staff,10,0,30,20
1715635230846,EDS 203,A01,507317,Halter; Christopher P.,10,0,30,20
1715635231991,EDS 204R,A01,507319,Halter; Christopher P.,0,3,30,30
1715635231991,EDS 204R,B01,507331,Heinzman; Erica M.,14,0,30,16
1715635233367,EDS 206R,A00,507332,Staff,0,4,30,30
1715635233367,EDS 206R,B00,507343,Staff,15,0,30,15
1715635234764,EDS 250,A00,507344,Hemans; Patricia Ann Benitez,20,0,40,20
1715635236100,EDS 281,A00,507345,Daly; Alan J.,18,0,18,0
1715635237278,EDS 284,A00,507350,Daly; Alan J.,16,0,16,0
1715635238417,EDS 286,A00,507359,Fine; Sarah,18,0,18,0
1715635239670,EDS 289C,A01,507361,Daly; Alan J.,18,0,18,0
1715635240935,EDS 290,A00,507366,Hofstetter; Carolyn,15,0,15,0
1715635242282,LIGM 5A,A00,507421,Fischer-Grunski; Eva K,17,0,20,3
1715635243497,LIGM 5B,A00,507423,Fischer-Grunski; Eva K,19,0,20,1
1715635244646,LIGM 5C,A00,507425,Fischer-Grunski; Eva K,19,0,20,1
1715635245831,LIIT 5AS,A00,507427,Carnelos; Chiara,20,0,20,0
1715635247047,LIIT 5BS,A00,507430,Carnelos; Chiara,20,0,20,0
1715635248144,LIIT 5CS,A00,507432,Carnelos; Chiara,20,0,20,0
1715635249341,LISP 5A,A00,507541,Munoz Sanchez; Alicia,11,0,20,9
1715635250653,LISP 5B,A00,507671,Munoz Sanchez; Alicia,9,0,20,11
1715635251885,LISP 5C,A00,507696,Munoz Sanchez; Alicia,9,0,20,11
1715635253103,MAE 197,001,528363,Boechler; Nicholas Sebastia,9998,0,9999,1
1715635254357,MATH 197,001,523477,Kedlaya; Kiran S.,9994,0,9999,5
1715635254357,MATH 197,002,563811,Zhang; Danna,9994,0,9999,5
1715635254357,MATH 197,003,628552,Dumitriu; Ioana,9998,0,9999,1
1715635254357,MATH 197,004,660885,Floyd; Eric,9998,0,9999,1
1715635255541,MCWP 40R,A00,518780,Staff,2,0,20,18
1715635255541,MCWP 40R,B00,518781,Staff,10,0,20,10
1715635255541,MCWP 40R,C00,518783,Staff,5,0,20,15
1715635256682,MCWP 50R,A00,518791,Staff,0,1,20,20
1715635256682,MCWP 50R,B00,518792,Staff,0,2,20,20
1715635256682,MCWP 50R,C00,518793,Staff,0,4,20,20
1715635256682,MCWP 50R,D00,518794,Staff,0,1,20,20
1715635256682,MCWP 50R,E00,518795,Staff,0,2,20,20
1715635256682,MCWP 50R,F00,518796,Staff,0,1,20,20
1715635256682,MCWP 50R,G00,518797,Staff,0,1,20,20
1715635258095,MMW 12R,A01,514034,Herbst; Matthew,0,2,16,16
1715635258095,MMW 12R,A02,514035,Herbst; Matthew,0,0,16,16
1715635259264,MMW 13R,A01,514037,Staff,0,5,16,16
1715635259264,MMW 13R,A02,514039,Staff,0,5,16,16
1715635259264,MMW 13R,A03,628519,Staff,0,4,16,16
1715635261687,SIO 295LS,A00,523233,Staff,10,0,30,20
1715635262820,SIO 295S,A00,523232,Staff,10,0,30,20
1715635263985,SIOC 290S,A01,637330,Merrifield; Mark A,21,0,30,9
1715635265212,SIOC 291S,A01,637333,Gabriel; Corey John,21,0,30,9
1715635266458,SOCI 117,A01,494376,Staff,0,5,5,5
1715635267619,WES 237B,A00,494380,Staff,10,0,20,10
1715635270294,AESE 279B,A00,494370,Wade; Jon P,0,0,33,33
1715635271397,AIP 97,001,660915,Van Den Einde; Yael Dahlia,9998,0,9999,1
1715635272799,AIP 197,001,627712,Vespa; Emanuel Ignacio,9995,0,9999,4
1715635272799,AIP 197,002,650778,Amir; On,9998,0,9999,1
1715635272799,AIP 197,003,650933,Avenancio-Leon; Carlos,9998,0,9999,1
1715635272799,AIP 197,004,658530,Heyman; Gail D.,9998,0,9999,1
1715635272799,AIP 197,005,658631,Neal; Sonya E,9998,0,9999,1
1715635272799,AIP 197,006,658671,Du; Songzi,9998,0,9999,1
1715635274052,ANAR 135S,A00,494369,Braswell; Geoffrey E.,0,0,0,0
1715635275118,BENG 196,001,628496,Engler; Adam J.,9998,0,9999,1
1715635275118,BENG 196,002,660916,Watson; John Thomas,9999,0,9999,0
1715635276213,BISP 197,001,650773,Wilhelm; James E.,9994,0,9999,5
1715635276213,BISP 197,002,658904,Coleman; Aaron B.,9998,0,9999,1
1715635277427,CAT 124RS,A01,519847,Geibel; William,0,0,20,20
1715635278630,CAT 125RS,A01,515971,Geibel; William,0,0,20,20
1715635279893,CLRE 250,A00,511389,Morris; Sheldon,9992,0,9999,7
1715635281012,CLRE 251,A00,507176,Mehta; Ravindra L.,9992,0,9999,7
1715635281012,CLRE 251,B00,511410,Mehta; Ravindra L.,9998,0,9999,1
1715635282180,CLRE 252,A00,507189,Cuomo; Raphael Eduardo,9994,0,9999,5
1715635283592,CLRE 253,A00,507199,Vaida; Florin,9994,0,9999,5
1715635283592,CLRE 253,B00,507202,Vaida; Florin,9999,0,9999,0
1715635284846,CLRE 259,A00,507211,Patel; Hemal,9996,0,9999,3
1715635286178,CLRE 260,A00,507221,Cuomo; Raphael Eduardo,9999,0,9999,0
1715635287353,CLRE 297,001,507242,Cuomo; Raphael Eduardo,9999,0,9999,0
1715635288476,COGS 197,001,638244,Voytek; Bradley Thomas,9997,0,9999,2
1715635289763,CSE 191,A00,516875,Minnes Kemp; Mor Mia,9991,0,9999,8
1715635290946,CSE 197,001,637388,Minnes Kemp; Mor Mia,9992,0,9999,7
1715635292060,CSS 201S,A01,494383,Mignozzetti; Umberto,35,0,35,0
1715635293274,CSS 202S,A01,494387,Mignozzetti; Umberto,35,0,35,0
1715635294537,DSC 197,001,628532,Eldridge; Justin Matthew,9995,0,9999,4
1715635295846,EAP 100,A00,516065,Staff,9799,0,9999,200
1715635297053,ECE 45,A01,507414,Staff,31,0,60,29
1715635299470,ECE 111,A01,507420,Staff,11,0,50,39
1715635300670,ECE 197,001,548057,Sievenpiper; Daniel F.,9991,0,9999,8
1715635301882,EDS 115,A00,507243,Choi; Bailey Miyeon,7,0,28,21
1715635303053,EDS 117,A01,494379,Staff,0,6,34,34
1715635304312,EDS 125,A00,507246,Hopkins; Megan Beth,8,0,30,22
1715635305608,EDS 128A,A01,507264,Fargason; Sharon Gayle,6,0,26,20
1715635306869,EDS 128B,A01,507293,Pappas; Elizabeth,10,0,30,20
1715635308163,EDS 139,A00,507294,Fargason; Sharon Gayle,10,0,30,20
1715635308163,EDS 139,B00,507313,Pappas; Elizabeth,11,0,30,19
1715635309373,EDS 201,A00,507315,Staff,10,0,30,20
1715635310584,EDS 203,A01,507317,Halter; Christopher P.,10,0,30,20
1715635312023,EDS 204R,A01,507319,Halter; Christopher P.,0,3,30,30
1715635312023,EDS 204R,B01,507331,Heinzman; Erica M.,14,0,30,16
1715635313210,EDS 206R,A00,507332,Staff,0,4,30,30
1715635313210,EDS 206R,B00,507343,Staff,15,0,30,15
1715635314492,EDS 250,A00,507344,Hemans; Patricia Ann Benitez,20,0,40,20
1715635315873,EDS 281,A00,507345,Daly; Alan J.,18,0,18,0
1715635317101,EDS 284,A00,507350,Daly; Alan J.,16,0,16,0
1715635318315,EDS 286,A00,507359,Fine; Sarah,18,0,18,0
1715635319479,EDS 289C,A01,507361,Daly; Alan J.,18,0,18,0
1715635320781,EDS 290,A00,507366,Hofstetter; Carolyn,15,0,15,0
1715635322102,LIGM 5A,A00,507421,Fischer-Grunski; Eva K,17,0,20,3
1715635323393,LIGM 5B,A00,507423,Fischer-Grunski; Eva K,19,0,20,1
1715635324620,LIGM 5C,A00,507425,Fischer-Grunski; Eva K,19,0,20,1
1715635325927,LIIT 5AS,A00,507427,Carnelos; Chiara,20,0,20,0
1715635327226,LIIT 5BS,A00,507430,Carnelos; Chiara,20,0,20,0
1715635328502,LIIT 5CS,A00,507432,Carnelos; Chiara,20,0,20,0
1715635329783,LISP 5A,A00,507541,Munoz Sanchez; Alicia,11,0,20,9
1715635330994,LISP 5B,A00,507671,Munoz Sanchez; Alicia,9,0,20,11
1715635332155,LISP 5C,A00,507696,Munoz Sanchez; Alicia,9,0,20,11
1715635333282,MAE 197,001,528363,Boechler; Nicholas Sebastia,9998,0,9999,1
1715635334604,MATH 197,001,523477,Kedlaya; Kiran S.,9994,0,9999,5
1715635334604,MATH 197,002,563811,Zhang; Danna,9994,0,9999,5
1715635334604,MATH 197,003,628552,Dumitriu; Ioana,9998,0,9999,1
1715635334604,MATH 197,004,660885,Floyd; Eric,9998,0,9999,1
1715635335877,MCWP 40R,A00,518780,Staff,2,0,20,18
1715635335877,MCWP 40R,B00,518781,Staff,10,0,20,10
1715635335877,MCWP 40R,C00,518783,Staff,5,0,20,15
1715635337329,MCWP 50R,A00,518791,Staff,0,1,20,20
1715635337329,MCWP 50R,B00,518792,Staff,0,2,20,20
1715635337329,MCWP 50R,C00,518793,Staff,0,4,20,20
1715635337329,MCWP 50R,D00,518794,Staff,0,1,20,20
1715635337329,MCWP 50R,E00,518795,Staff,0,2,20,20
1715635337329,MCWP 50R,F00,518796,Staff,0,1,20,20
1715635337329,MCWP 50R,G00,518797,Staff,0,1,20,20
1715635338612,MMW 12R,A01,514034,Herbst; Matthew,0,2,16,16
1715635338612,MMW 12R,A02,514035,Herbst; Matthew,0,0,16,16
1715635339642,MMW 13R,A01,514037,Staff,0,5,16,16
1715635339642,MMW 13R,A02,514039,Staff,0,5,16,16
1715635339642,MMW 13R,A03,628519,Staff,0,4,16,16
1715635341975,SIO 295LS,A00,523233,Staff,10,0,30,20
1715635343261,SIO 295S,A00,523232,Staff,10,0,30,20
1715635344534,SIOC 290S,A01,637330,Merrifield; Mark A,21,0,30,9
1715635345761,SIOC 291S,A01,637333,Gabriel; Corey John,21,0,30,9
1715635346970,SOCI 117,A01,494376,Staff,0,5,5,5
1715635348170,WES 237B,A00,494380,Staff,10,0,20,10
1715635350574,AESE 279B,A00,494370,Wade; Jon P,0,0,33,33
1715635351719,AIP 97,001,660915,Van Den Einde; Yael Dahlia,9998,0,9999,1
1715635352934,AIP 197,001,627712,Vespa; Emanuel Ignacio,9995,0,9999,4
1715635352934,AIP 197,002,650778,Amir; On,9998,0,9999,1
1715635352934,AIP 197,003,650933,Avenancio-Leon; Carlos,9998,0,9999,1
1715635352934,AIP 197,004,658530,Heyman; Gail D.,9998,0,9999,1
1715635352934,AIP 197,005,658631,Neal; Sonya E,9998,0,9999,1
1715635352934,AIP 197,006,658671,Du; Songzi,9998,0,9999,1
1715635354093,ANAR 135S,A00,494369,Braswell; Geoffrey E.,0,0,0,0
1715635355313,BENG 196,001,628496,Engler; Adam J.,9998,0,9999,1
1715635355313,BENG 196,002,660916,Watson; John Thomas,9999,0,9999,0
1715635356548,BISP 197,001,650773,Wilhelm; James E.,9994,0,9999,5
1715635356548,BISP 197,002,658904,Coleman; Aaron B.,9998,0,9999,1
1715635357741,CAT 124RS,A01,519847,Geibel; William,0,0,20,20
1715635358880,CAT 125RS,A01,515971,Geibel; William,0,0,20,20
1715635360257,CLRE 250,A00,511389,Morris; Sheldon,9992,0,9999,7
1715635361394,CLRE 251,A00,507176,Mehta; Ravindra L.,9992,0,9999,7
1715635361394,CLRE 251,B00,511410,Mehta; Ravindra L.,9998,0,9999,1
1715635362696,CLRE 252,A00,507189,Cuomo; Raphael Eduardo,9994,0,9999,5
1715635364118,CLRE 253,A00,507199,Vaida; Florin,9994,0,9999,5
1715635364118,CLRE 253,B00,507202,Vaida; Florin,9999,0,9999,0
1715635365157,CLRE 259,A00,507211,Patel; Hemal,9996,0,9999,3
1715635366696,CLRE 260,A00,507221,Cuomo; Raphael Eduardo,9999,0,9999,0
1715635367857,CLRE 297,001,507242,Cuomo; Raphael Eduardo,9999,0,9999,0
1715635369042,COGS 197,001,638244,Voytek; Bradley Thomas,9997,0,9999,2
1715635370297,CSE 191,A00,516875,Minnes Kemp; Mor Mia,9991,0,9999,8
1715635371601,CSE 197,001,637388,Minnes Kemp; Mor Mia,9992,0,9999,7
1715635372679,CSS 201S,A01,494383,Mignozzetti; Umberto,35,0,35,0
1715635373824,CSS 202S,A01,494387,Mignozzetti; Umberto,35,0,35,0
1715635375141,DSC 197,001,628532,Eldridge; Justin Matthew,9995,0,9999,4
1715635376578,EAP 100,A00,516065,Staff,9799,0,9999,200
1715635377860,ECE 45,A01,507414,Staff,31,0,60,29
1715635380350,ECE 111,A01,507420,Staff,11,0,50,39
1715635381673,ECE 197,001,548057,Sievenpiper; Daniel F.,9991,0,9999,8
1715635382832,EDS 115,A00,507243,Choi; Bailey Miyeon,7,0,28,21
1715635383973,EDS 117,A01,494379,Staff,0,6,34,34
1715635385170,EDS 125,A00,507246,Hopkins; Megan Beth,8,0,30,22
1715635386465,EDS 128A,A01,507264,Fargason; Sharon Gayle,6,0,26,20
1715635387658,EDS 128B,A01,507293,Pappas; Elizabeth,10,0,30,20
1715635388948,EDS 139,A00,507294,Fargason; Sharon Gayle,10,0,30,20
1715635388948,EDS 139,B00,507313,Pappas; Elizabeth,11,0,30,19
1715635390443,EDS 201,A00,507315,Staff,10,0,30,20
1715635391561,EDS 203,A01,507317,Halter; Christopher P.,10,0,30,20
1715635392613,EDS 204R,A01,507319,Halter; Christopher P.,0,3,30,30
1715635392613,EDS 204R,B01,507331,Heinzman; Erica M.,14,0,30,16
1715635393688,EDS 206R,A00,507332,Staff,0,4,30,30
1715635393688,EDS 206R,B00,507343,Staff,15,0,30,15
1715635394799,EDS 250,A00,507344,Hemans; Patricia Ann Benitez,20,0,40,20
1715635395955,EDS 281,A00,507345,Daly; Alan J.,18,0,18,0
1715635397147,EDS 284,A00,507350,Daly; Alan J.,16,0,16,0
1715635398438,EDS 286,A00,507359,Fine; Sarah,18,0,18,0
1715635399838,EDS 289C,A01,507361,Daly; Alan J.,18,0,18,0
1715635401036,EDS 290,A00,507366,Hofstetter; Carolyn,15,0,15,0
1715635402221,LIGM 5A,A00,507421,Fischer-Grunski; Eva K,17,0,20,3
1715635403637,LIGM 5B,A00,507423,Fischer-Grunski; Eva K,19,0,20,1
1715635404916,LIGM 5C,A00,507425,Fischer-Grunski; Eva K,19,0,20,1
1715635406083,LIIT 5AS,A00,507427,Carnelos; Chiara,20,0,20,0
1715635407186,LIIT 5BS,A00,507430,Carnelos; Chiara,20,0,20,0
1715635408397,LIIT 5CS,A00,507432,Carnelos; Chiara,20,0,20,0
1715635409541,LISP 5A,A00,507541,Munoz Sanchez; Alicia,11,0,20,9
1715635410862,LISP 5B,A00,507671,Munoz Sanchez; Alicia,9,0,20,11
1715635412117,LISP 5C,A00,507696,Munoz Sanchez; Alicia,9,0,20,11
1715635413426,MAE 197,001,528363,Boechler; Nicholas Sebastia,9998,0,9999,1
1715635414608,MATH 197,001,523477,Kedlaya; Kiran S.,9994,0,9999,5
1715635414608,MATH 197,002,563811,Zhang; Danna,9994,0,9999,5
1715635414608,MATH 197,003,628552,Dumitriu; Ioana,9998,0,9999,1
1715635414608,MATH 197,004,660885,Floyd; Eric,9998,0,9999,1
1715635415825,MCWP 40R,A00,518780,Staff,2,0,20,18
1715635415825,MCWP 40R,B00,518781,Staff,10,0,20,10
1715635415825,MCWP 40R,C00,518783,Staff,5,0,20,15
1715635416979,MCWP 50R,A00,518791,Staff,0,1,20,20
1715635416979,MCWP 50R,B00,518792,Staff,0,2,20,20
1715635416979,MCWP 50R,C00,518793,Staff,0,4,20,20
1715635416979,MCWP 50R,D00,518794,Staff,0,1,20,20
1715635416979,MCWP 50R,E00,518795,Staff,0,2,20,20
1715635416979,MCWP 50R,F00,518796,Staff,0,1,20,20
1715635416979,MCWP 50R,G00,518797,Staff,0,1,20,20
1715635418221,MMW 12R,A01,514034,Herbst; Matthew,0,2,16,16
1715635418221,MMW 12R,A02,514035,Herbst; Matthew,0,0,16,16
1715635419486,MMW 13R,A01,514037,Staff,0,5,16,16
1715635419486,MMW 13R,A02,514039,Staff,0,5,16,16
1715635419486,MMW 13R,A03,628519,Staff,0,4,16,16
1715635421899,SIO 295LS,A00,523233,Staff,10,0,30,20
1715635423062,SIO 295S,A00,523232,Staff,10,0,30,20
1715635424220,SIOC 290S,A01,637330,Merrifield; Mark A,21,0,30,9
1715635425525,SIOC 291S,A01,637333,Gabriel; Corey John,21,0,30,9
1715635426677,SOCI 117,A01,494376,Staff,0,5,5,5
1715635427984,WES 237B,A00,494380,Staff,10,0,20,10
1715635430426,AESE 279B,A00,494370,Wade; Jon P,0,0,33,33
1715635431612,AIP 97,001,660915,Van Den Einde; Yael Dahlia,9998,0,9999,1
1715635432764,AIP 197,001,627712,Vespa; Emanuel Ignacio,9995,0,9999,4
1715635432764,AIP 197,002,650778,Amir; On,9998,0,9999,1
1715635432764,AIP 197,003,650933,Avenancio-Leon; Carlos,9998,0,9999,1
1715635432764,AIP 197,004,658530,Heyman; Gail D.,9998,0,9999,1
1715635432764,AIP 197,005,658631,Neal; Sonya E,9998,0,9999,1
1715635432764,AIP 197,006,658671,Du; Songzi,9998,0,9999,1
1715635433918,ANAR 135S,A00,494369,Braswell; Geoffrey E.,0,0,0,0
1715635435105,BENG 196,001,628496,Engler; Adam J.,9998,0,9999,1
1715635435105,BENG 196,002,660916,Watson; John Thomas,9999,0,9999,0
1715635436248,BISP 197,001,650773,Wilhelm; James E.,9994,0,9999,5
1715635436248,BISP 197,002,658904,Coleman; Aaron B.,9998,0,9999,1
1715635437408,CAT 124RS,A01,519847,Geibel; William,0,0,20,20
1715635438701,CAT 125RS,A01,515971,Geibel; William,0,0,20,20
1715635439997,CLRE 250,A00,511389,Morris; Sheldon,9992,0,9999,7
1715635441158,CLRE 251,A00,507176,Mehta; Ravindra L.,9992,0,9999,7
1715635441158,CLRE 251,B00,511410,Mehta; Ravindra L.,9998,0,9999,1
1715635442448,CLRE 252,A00,507189,Cuomo; Raphael Eduardo,9994,0,9999,5
1715635443544,CLRE 253,A00,507199,Vaida; Florin,9994,0,9999,5
1715635443544,CLRE 253,B00,507202,Vaida; Florin,9999,0,9999,0
1715635444676,CLRE 259,A00,507211,Patel; Hemal,9996,0,9999,3
1715635445936,CLRE 260,A00,507221,Cuomo; Raphael Eduardo,9999,0,9999,0
1715635446986,CLRE 297,001,507242,Cuomo; Raphael Eduardo,9999,0,9999,0
1715635448219,COGS 197,001,638244,Voytek; Bradley Thomas,9997,0,9999,2
1715635449364,CSE 191,A00,516875,Minnes Kemp; Mor Mia,9991,0,9999,8
1715635450564,CSE 197,001,637388,Minnes Kemp; Mor Mia,9992,0,9999,7
1715635451742,CSS 201S,A01,494383,Mignozzetti; Umberto,35,0,35,0
1715635452987,CSS 202S,A01,494387,Mignozzetti; Umberto,35,0,35,0
1715635454258,DSC 197,001,628532,Eldridge; Justin Matthew,9995,0,9999,4
1715635455462,EAP 100,A00,516065,Staff,9799,0,9999,200
1715635456627,ECE 45,A01,507414,Staff,31,0,60,29
1715635459729,ECE 111,A01,507420,Staff,11,0,50,39
1715635460909,ECE 197,001,548057,Sievenpiper; Daniel F.,9991,0,9999,8
1715635462046,EDS 115,A00,507243,Choi; Bailey Miyeon,7,0,28,21
1715635463384,EDS 117,A01,494379,Staff,0,6,34,34
1715635464695,EDS 125,A00,507246,Hopkins; Megan Beth,8,0,30,22
1715635465882,EDS 128A,A01,507264,Fargason; Sharon Gayle,6,0,26,20
1715635467081,EDS 128B,A01,507293,Pappas; Elizabeth,10,0,30,20
1715635468247,EDS 139,A00,507294,Fargason; Sharon Gayle,10,0,30,20
1715635468247,EDS 139,B00,507313,Pappas; Elizabeth,11,0,30,19
1715635469654,EDS 201,A00,507315,Staff,10,0,30,20
1715635470841,EDS 203,A01,507317,Halter; Christopher P.,10,0,30,20
1715635472042,EDS 204R,A01,507319,Halter; Christopher P.,0,3,30,30
1715635472042,EDS 204R,B01,507331,Heinzman; Erica M.,14,0,30,16
1715635473273,EDS 206R,A00,507332,Staff,0,4,30,30
1715635473273,EDS 206R,B00,507343,Staff,15,0,30,15
1715635474515,EDS 250,A00,507344,Hemans; Patricia Ann Benitez,20,0,40,20
1715635475755,EDS 281,A00,507345,Daly; Alan J.,18,0,18,0
1715635476918,EDS 284,A00,507350,Daly; Alan J.,16,0,16,0
1715635478077,EDS 286,A00,507359,Fine; Sarah,18,0,18,0
1715635479246,EDS 289C,A01,507361,Daly; Alan J.,18,0,18,0
1715635480422,EDS 290,A00,507366,Hofstetter; Carolyn,15,0,15,0
1715635481740,LIGM 5A,A00,507421,Fischer-Grunski; Eva K,17,0,20,3
1715635482992,LIGM 5B,A00,507423,Fischer-Grunski; Eva K,19,0,20,1
1715635484173,LIGM 5C,A00,507425,Fischer-Grunski; Eva K,19,0,20,1
1715635485340,LIIT 5AS,A00,507427,Carnelos; Chiara,20,0,20,0
1715635486556,LIIT 5BS,A00,507430,Carnelos; Chiara,20,0,20,0
1715635487779,LIIT 5CS,A00,507432,Carnelos; Chiara,20,0,20,0
1715635488982,LISP 5A,A00,507541,Munoz Sanchez; Alicia,11,0,20,9
1715635490173,LISP 5B,A00,507671,Munoz Sanchez; Alicia,9,0,20,11
1715635491424,LISP 5C,A00,507696,Munoz Sanchez; Alicia,9,0,20,11
1715635492611,MAE 197,001,528363,Boechler; Nicholas Sebastia,9998,0,9999,1
1715635494003,MATH 197,001,523477,Kedlaya; Kiran S.,9994,0,9999,5
1715635494003,MATH 197,002,563811,Zhang; Danna,9994,0,9999,5
1715635494003,MATH 197,003,628552,Dumitriu; Ioana,9998,0,9999,1
1715635494003,MATH 197,004,660885,Floyd; Eric,9998,0,9999,1
1715635495145,MCWP 40R,A00,518780,Staff,2,0,20,18
1715635495145,MCWP 40R,B00,518781,Staff,10,0,20,10
1715635495145,MCWP 40R,C00,518783,Staff,5,0,20,15
1715635496426,MCWP 50R,A00,518791,Staff,0,1,20,20
1715635496426,MCWP 50R,B00,518792,Staff,0,2,20,20
1715635496426,MCWP 50R,C00,518793,Staff,0,4,20,20
1715635496426,MCWP 50R,D00,518794,Staff,0,1,20,20
1715635496426,MCWP 50R,E00,518795,Staff,0,2,20,20
1715635496426,MCWP 50R,F00,518796,Staff,0,1,20,20
1715635496426,MCWP 50R,G00,518797,Staff,0,1,20,20
1715635497729,MMW 12R,A01,514034,Herbst; Matthew,0,2,16,16
1715635497729,MMW 12R,A02,514035,Herbst; Matthew,0,0,16,16
1715635498855,MMW 13R,A01,514037,Staff,0,5,16,16
1715635498855,MMW 13R,A02,514039,Staff,0,5,16,16
1715635498855,MMW 13R,A03,628519,Staff,0,4,16,16
1715635501330,SIO 295LS,A00,523233,Staff,10,0,30,20
1715635502882,SIO 295S,A00,523232,Staff,10,0,30,20
1715635504029,SIOC 290S,A01,637330,Merrifield; Mark A,21,0,30,9
1715635505254,SIOC 291S,A01,637333,Gabriel; Corey John,21,0,30,9
1715635506435,SOCI 117,A01,494376,Staff,0,5,5,5
1715635507692,WES 237B,A00,494380,Staff,10,0,20,10
1715635510378,AESE 279B,A00,494370,Wade; Jon P,0,0,33,33
1715635511517,AIP 97,001,660915,Van Den Einde; Yael Dahlia,9998,0,9999,1
1715635512875,AIP 197,001,627712,Vespa; Emanuel Ignacio,9995,0,9999,4
1715635512875,AIP 197,002,650778,Amir; On,9998,0,9999,1
1715635512875,AIP 197,003,650933,Avenancio-Leon; Carlos,9998,0,9999,1
1715635512875,AIP 197,004,658530,Heyman; Gail D.,9998,0,9999,1
1715635512875,AIP 197,005,658631,Neal; Sonya E,9998,0,9999,1
1715635512875,AIP 197,006,658671,Du; Songzi,9998,0,9999,1
1715635514189,ANAR 135S,A00,494369,Braswell; Geoffrey E.,0,0,0,0
1715635515518,BENG 196,001,628496,Engler; Adam J.,9998,0,9999,1
1715635515518,BENG 196,002,660916,Watson; John Thomas,9999,0,9999,0
1715635516763,BISP 197,001,650773,Wilhelm; James E.,9994,0,9999,5
1715635516763,BISP 197,002,658904,Coleman; Aaron B.,9998,0,9999,1
1715635517986,CAT 124RS,A01,519847,Geibel; William,0,0,20,20
1715635519163,CAT 125RS,A01,515971,Geibel; William,0,0,20,20
1715635520465,CLRE 250,A00,511389,Morris; Sheldon,9992,0,9999,7
1715635521622,CLRE 251,A00,507176,Mehta; Ravindra L.,9992,0,9999,7
1715635521622,CLRE 251,B00,511410,Mehta; Ravindra L.,9998,0,9999,1
1715635522778,CLRE 252,A00,507189,Cuomo; Raphael Eduardo,9994,0,9999,5
1715635524198,CLRE 253,A00,507199,Vaida; Florin,9994,0,9999,5
1715635524198,CLRE 253,B00,507202,Vaida; Florin,9999,0,9999,0
1715635525474,CLRE 259,A00,507211,Patel; Hemal,9996,0,9999,3
1715635526665,CLRE 260,A00,507221,Cuomo; Raphael Eduardo,9999,0,9999,0
1715635527978,CLRE 297,001,507242,Cuomo; Raphael Eduardo,9999,0,9999,0
1715635529367,COGS 197,001,638244,Voytek; Bradley Thomas,9997,0,9999,2
1715635530552,CSE 191,A00,516875,Minnes Kemp; Mor Mia,9991,0,9999,8
1715635531599,CSE 197,001,637388,Minnes Kemp; Mor Mia,9992,0,9999,7
1715635532799,CSS 201S,A01,494383,Mignozzetti; Umberto,35,0,35,0
1715635534001,CSS 202S,A01,494387,Mignozzetti; Umberto,35,0,35,0
1715635535141,DSC 197,001,628532,Eldridge; Justin Matthew,9995,0,9999,4
1715635536250,EAP 100,A00,516065,Staff,9799,0,9999,200
1715635537429,ECE 45,A01,507414,Staff,31,0,60,29
1715635539590,ECE 111,A01,507420,Staff,11,0,50,39
1715635540713,ECE 197,001,548057,Sievenpiper; Daniel F.,9991,0,9999,8
1715635541867,EDS 115,A00,507243,Choi; Bailey Miyeon,7,0,28,21
1715635543365,EDS 117,A01,494379,Staff,0,6,34,34
1715635544958,EDS 125,A00,507246,Hopkins; Megan Beth,8,0,30,22
1715635546095,EDS 128A,A01,507264,Fargason; Sharon Gayle,6,0,26,20
1715635547194,EDS 128B,A01,507293,Pappas; Elizabeth,10,0,30,20
1715635548300,EDS 139,A00,507294,Fargason; Sharon Gayle,10,0,30,20
1715635548300,EDS 139,B00,507313,Pappas; Elizabeth,11,0,30,19
1715635549477,EDS 201,A00,507315,Staff,10,0,30,20
1715635550928,EDS 203,A01,507317,Halter; Christopher P.,10,0,30,20
1715635552121,EDS 204R,A01,507319,Halter; Christopher P.,0,3,30,30
1715635552121,EDS 204R,B01,507331,Heinzman; Erica M.,14,0,30,16
1715635553663,EDS 206R,A00,507332,Staff,0,4,30,30
1715635553663,EDS 206R,B00,507343,Staff,15,0,30,15
1715635555054,EDS 250,A00,507344,Hemans; Patricia Ann Benitez,20,0,40,20
1715635556263,EDS 281,A00,507345,Daly; Alan J.,18,0,18,0
1715635557357,EDS 284,A00,507350,Daly; Alan J.,16,0,16,0
1715635558554,EDS 286,A00,507359,Fine; Sarah,18,0,18,0
1715635559785,EDS 289C,A01,507361,Daly; Alan J.,18,0,18,0
1715635560991,EDS 290,A00,507366,Hofstetter; Carolyn,15,0,15,0
1715635562150,LIGM 5A,A00,507421,Fischer-Grunski; Eva K,17,0,20,3
1715635563388,LIGM 5B,A00,507423,Fischer-Grunski; Eva K,19,0,20,1
1715635564491,LIGM 5C,A00,507425,Fischer-Grunski; Eva K,19,0,20,1
1715635565991,LIIT 5AS,A00,507427,Carnelos; Chiara,20,0,20,0
1715635567176,LIIT 5BS,A00,507430,Carnelos; Chiara,20,0,20,0
1715635568352,LIIT 5CS,A00,507432,Carnelos; Chiara,20,0,20,0
1715635569457,LISP 5A,A00,507541,Munoz Sanchez; Alicia,11,0,20,9
1715635570666,LISP 5B,A00,507671,Munoz Sanchez; Alicia,9,0,20,11
1715635572120,LISP 5C,A00,507696,Munoz Sanchez; Alicia,9,0,20,11
1715635573385,MAE 197,001,528363,Boechler; Nicholas Sebastia,9998,0,9999,1
1715635574621,MATH 197,001,523477,Kedlaya; Kiran S.,9994,0,9999,5
1715635574621,MATH 197,002,563811,Zhang; Danna,9994,0,9999,5
1715635574621,MATH 197,003,628552,Dumitriu; Ioana,9998,0,9999,1
1715635574621,MATH 197,004,660885,Floyd; Eric,9998,0,9999,1
1715635575977,MCWP 40R,A00,518780,Staff,2,0,20,18
1715635575977,MCWP 40R,B00,518781,Staff,10,0,20,10
1715635575977,MCWP 40R,C00,518783,Staff,5,0,20,15
1715635577171,MCWP 50R,A00,518791,Staff,0,1,20,20
1715635577171,MCWP 50R,B00,518792,Staff,0,2,20,20
1715635577171,MCWP 50R,C00,518793,Staff,0,4,20,20
1715635577171,MCWP 50R,D00,518794,Staff,0,1,20,20
1715635577171,MCWP 50R,E00,518795,Staff,0,2,20,20
1715635577171,MCWP 50R,F00,518796,Staff,0,1,20,20
1715635577171,MCWP 50R,G00,518797,Staff,0,1,20,20
1715635578370,MMW 12R,A01,514034,Herbst; Matthew,0,2,16,16
1715635578370,MMW 12R,A02,514035,Herbst; Matthew,0,0,16,16
1715635579630,MMW 13R,A01,514037,Staff,0,5,16,16
1715635579630,MMW 13R,A02,514039,Staff,0,5,16,16
1715635579630,MMW 13R,A03,628519,Staff,0,4,16,16
1715635581953,SIO 295LS,A00,523233,Staff,10,0,30,20
1715635583356,SIO 295S,A00,523232,Staff,10,0,30,20
1715635584530,SIOC 290S,A01,637330,Merrifield; Mark A,21,0,30,9
1715635585747,SIOC 291S,A01,637333,Gabriel; Corey John,21,0,30,9
1715635586962,SOCI 117,A01,494376,Staff,0,5,5,5
1715635588088,WES 237B,A00,494380,Staff,10,0,20,10
1715635590502,AESE 279B,A00,494370,Wade; Jon P,0,0,33,33
1715635591885,AIP 97,001,660915,Van Den Einde; Yael Dahlia,9998,0,9999,1
1715635593048,AIP 197,001,627712,Vespa; Emanuel Ignacio,9995,0,9999,4
1715635593048,AIP 197,002,650778,Amir; On,9998,0,9999,1
1715635593048,AIP 197,003,650933,Avenancio-Leon; Carlos,9998,0,9999,1
1715635593048,AIP 197,004,658530,Heyman; Gail D.,9998,0,9999,1
1715635593048,AIP 197,005,658631,Neal; Sonya E,9998,0,9999,1
1715635593048,AIP 197,006,658671,Du; Songzi,9998,0,9999,1
1715635594227,ANAR 135S,A00,494369,Braswell; Geoffrey E.,0,0,0,0
1715635595497,BENG 196,001,628496,Engler; Adam J.,9998,0,9999,1
1715635595497,BENG 196,002,660916,Watson; John Thomas,9999,0,9999,0
1715635596753,BISP 197,001,650773,Wilhelm; James E.,9994,0,9999,5
1715635596753,BISP 197,002,658904,Coleman; Aaron B.,9998,0,9999,1
1715635598000,CAT 124RS,A01,519847,Geibel; William,0,0,20,20
1715635599116,CAT 125RS,A01,515971,Geibel; William,0,0,20,20
1715635600304,CLRE 250,A00,511389,Morris; Sheldon,9992,0,9999,7
1715635601470,CLRE 251,A00,507176,Mehta; Ravindra L.,9992,0,9999,7
1715635601470,CLRE 251,B00,511410,Mehta; Ravindra L.,9998,0,9999,1
1715635602704,CLRE 252,A00,507189,Cuomo; Raphael Eduardo,9994,0,9999,5
1715635603910,CLRE 253,A00,507199,Vaida; Florin,9994,0,9999,5
1715635603910,CLRE 253,B00,507202,Vaida; Florin,9999,0,9999,0
1715635605136,CLRE 259,A00,507211,Patel; Hemal,9996,0,9999,3
1715635606312,CLRE 260,A00,507221,Cuomo; Raphael Eduardo,9999,0,9999,0
1715635607387,CLRE 297,001,507242,Cuomo; Raphael Eduardo,9999,0,9999,0
1715635608786,COGS 197,001,638244,Voytek; Bradley Thomas,9997,0,9999,2
1715635610139,CSE 191,A00,516875,Minnes Kemp; Mor Mia,9991,0,9999,8
1715635611389,CSE 197,001,637388,Minnes Kemp; Mor Mia,9992,0,9999,7
1715635612639,CSS 201S,A01,494383,Mignozzetti; Umberto,35,0,35,0
1715635613951,CSS 202S,A01,494387,Mignozzetti; Umberto,35,0,35,0
1715635615181,DSC 197,001,628532,Eldridge; Justin Matthew,9995,0,9999,4
1715635616386,EAP 100,A00,516065,Staff,9799,0,9999,200
1715635617676,ECE 45,A01,507414,Staff,31,0,60,29
1715635620039,ECE 111,A01,507420,Staff,11,0,50,39
1715635621211,ECE 197,001,548057,Sievenpiper; Daniel F.,9991,0,9999,8
1715635622410,EDS 115,A00,507243,Choi; Bailey Miyeon,7,0,28,21
1715635623590,EDS 117,A01,494379,Staff,0,6,34,34
1715635624742,EDS 125,A00,507246,Hopkins; Megan Beth,8,0,30,22
1715635625837,EDS 128A,A01,507264,Fargason; Sharon Gayle,6,0,26,20
1715635627086,EDS 128B,A01,507293,Pappas; Elizabeth,10,0,30,20
1715635628248,EDS 139,A00,507294,Fargason; Sharon Gayle,10,0,30,20
1715635628248,EDS 139,B00,507313,Pappas; Elizabeth,11,0,30,19
1715635629398,EDS 201,A00,507315,Staff,10,0,30,20
1715635630550,EDS 203,A01,507317,Halter; Christopher P.,10,0,30,20
1715635631763,EDS 204R,A01,507319,Halter; Christopher P.,0,3,30,30
1715635631763,EDS 204R,B01,507331,Heinzman; Erica M.,14,0,30,16
1715635633077,EDS 206R,A00,507332,Staff,0,4,30,30
1715635633077,EDS 206R,B00,507343,Staff,15,0,30,15
1715635634383,EDS 250,A00,507344,Hemans; Patricia Ann Benitez,20,0,40,20
1715635635513,EDS 281,A00,507345,Daly; Alan J.,18,0,18,0
1715635637010,EDS 284,A00,507350,Daly; Alan J.,16,0,16,0
1715635638130,EDS 286,A00,507359,Fine; Sarah,18,0,18,0
1715635639250,EDS 289C,A01,507361,Daly; Alan J.,18,0,18,0
1715635640772,EDS 290,A00,507366,Hofstetter; Carolyn,15,0,15,0
1715635642025,LIGM 5A,A00,507421,Fischer-Grunski; Eva K,17,0,20,3
1715635643294,LIGM 5B,A00,507423,Fischer-Grunski; Eva K,19,0,20,1
1715635644532,LIGM 5C,A00,507425,Fischer-Grunski; Eva K,19,0,20,1
1715635645636,LIIT 5AS,A00,507427,Carnelos; Chiara,20,0,20,0
1715635646921,LIIT 5BS,A00,507430,Carnelos; Chiara,20,0,20,0
1715635648101,LIIT 5CS,A00,507432,Carnelos; Chiara,20,0,20,0
1715635649219,LISP 5A,A00,507541,Munoz Sanchez; Alicia,11,0,20,9
1715635650474,LISP 5B,A00,507671,Munoz Sanchez; Alicia,9,0,20,11
1715635651788,LISP 5C,A00,507696,Munoz Sanchez; Alicia,9,0,20,11
1715635652867,MAE 197,001,528363,Boechler; Nicholas Sebastia,9998,0,9999,1
1715635654164,MATH 197,001,523477,Kedlaya; Kiran S.,9994,0,9999,5
1715635654164,MATH 197,002,563811,Zhang; Danna,9994,0,9999,5
1715635654164,MATH 197,003,628552,Dumitriu; Ioana,9998,0,9999,1
1715635654164,MATH 197,004,660885,Floyd; Eric,9998,0,9999,1
1715635655357,MCWP 40R,A00,518780,Staff,2,0,20,18
1715635655357,MCWP 40R,B00,518781,Staff,10,0,20,10
1715635655357,MCWP 40R,C00,518783,Staff,5,0,20,15
1715635656554,MCWP 50R,A00,518791,Staff,0,1,20,20
1715635656554,MCWP 50R,B00,518792,Staff,0,2,20,20
1715635656554,MCWP 50R,C00,518793,Staff,0,4,20,20
1715635656554,MCWP 50R,D00,518794,Staff,0,1,20,20
1715635656554,MCWP 50R,E00,518795,Staff,0,2,20,20
1715635656554,MCWP 50R,F00,518796,Staff,0,1,20,20
1715635656554,MCWP 50R,G00,518797,Staff,0,1,20,20
1715635657635,MMW 12R,A01,514034,Herbst; Matthew,0,2,16,16
1715635657635,MMW 12R,A02,514035,Herbst; Matthew,0,0,16,16
1715635658884,MMW 13R,A01,514037,Staff,0,5,16,16
1715635658884,MMW 13R,A02,514039,Staff,0,5,16,16
1715635658884,MMW 13R,A03,628519,Staff,0,4,16,16
1715635661187,SIO 295LS,A00,523233,Staff,10,0,30,20
1715635662383,SIO 295S,A00,523232,Staff,10,0,30,20
1715635663895,SIOC 290S,A01,637330,Merrifield; Mark A,21,0,30,9
1715635665383,SIOC 291S,A01,637333,Gabriel; Corey John,21,0,30,9
1715635666878,SOCI 117,A01,494376,Staff,0,5,5,5
1715635668163,WES 237B,A00,494380,Staff,10,0,20,10
1715635670610,AESE 279B,A00,494370,Wade; Jon P,0,0,33,33
1715635671740,AIP 97,001,660915,Van Den Einde; Yael Dahlia,9998,0,9999,1
1715635672895,AIP 197,001,627712,Vespa; Emanuel Ignacio,9995,0,9999,4
1715635672895,AIP 197,002,650778,Amir; On,9998,0,9999,1
1715635672895,AIP 197,003,650933,Avenancio-Leon; Carlos,9998,0,9999,1
1715635672895,AIP 197,004,658530,Heyman; Gail D.,9998,0,9999,1
1715635672895,AIP 197,005,658631,Neal; Sonya E,9998,0,9999,1
1715635672895,AIP 197,006,658671,Du; Songzi,9998,0,9999,1
1715635674296,ANAR 135S,A00,494369,Braswell; Geoffrey E.,0,0,0,0
1715635675454,BENG 196,001,628496,Engler; Adam J.,9998,0,9999,1
1715635675454,BENG 196,002,660916,Watson; John Thomas,9999,0,9999,0
1715635676578,BISP 197,001,650773,Wilhelm; James E.,9994,0,9999,5
1715635676578,BISP 197,002,658904,Coleman; Aaron B.,9998,0,9999,1
1715635677825,CAT 124RS,A01,519847,Geibel; William,0,0,20,20
1715635679080,CAT 125RS,A01,515971,Geibel; William,0,0,20,20
1715635680384,CLRE 250,A00,511389,Morris; Sheldon,9992,0,9999,7
1715635681628,CLRE 251,A00,507176,Mehta; Ravindra L.,9992,0,9999,7
1715635681628,CLRE 251,B00,511410,Mehta; Ravindra L.,9998,0,9999,1
1715635682811,CLRE 252,A00,507189,Cuomo; Raphael Eduardo,9994,0,9999,5
1715635684068,CLRE 253,A00,507199,Vaida; Florin,9994,0,9999,5
1715635684068,CLRE 253,B00,507202,Vaida; Florin,9999,0,9999,0
1715635685326,CLRE 259,A00,507211,Patel; Hemal,9996,0,9999,3
1715635686610,CLRE 260,A00,507221,Cuomo; Raphael Eduardo,9999,0,9999,0
1715635687775,CLRE 297,001,507242,Cuomo; Raphael Eduardo,9999,0,9999,0
1715635689179,COGS 197,001,638244,Voytek; Bradley Thomas,9997,0,9999,2
1715635690816,CSE 191,A00,516875,Minnes Kemp; Mor Mia,9991,0,9999,8
1715635692079,CSE 197,001,637388,Minnes Kemp; Mor Mia,9992,0,9999,7
1715635693206,CSS 201S,A01,494383,Mignozzetti; Umberto,35,0,35,0
1715635694493,CSS 202S,A01,494387,Mignozzetti; Umberto,35,0,35,0
1715635695883,DSC 197,001,628532,Eldridge; Justin Matthew,9995,0,9999,4
1715635697100,EAP 100,A00,516065,Staff,9799,0,9999,200
1715635698263,ECE 45,A01,507414,Staff,31,0,60,29
1715635700605,ECE 111,A01,507420,Staff,11,0,50,39
1715635701840,ECE 197,001,548057,Sievenpiper; Daniel F.,9991,0,9999,8
1715635702938,EDS 115,A00,507243,Choi; Bailey Miyeon,7,0,28,21
1715635704232,EDS 117,A01,494379,Staff,0,6,34,34
1715635705443,EDS 125,A00,507246,Hopkins; Megan Beth,8,0,30,22
1715635706647,EDS 128A,A01,507264,Fargason; Sharon Gayle,6,0,26,20
1715635707870,EDS 128B,A01,507293,Pappas; Elizabeth,10,0,30,20
1715635709031,EDS 139,A00,507294,Fargason; Sharon Gayle,10,0,30,20
1715635709031,EDS 139,B00,507313,Pappas; Elizabeth,11,0,30,19
1715635710263,EDS 201,A00,507315,Staff,10,0,30,20
1715635711509,EDS 203,A01,507317,Halter; Christopher P.,10,0,30,20
1715635712726,EDS 204R,A01,507319,Halter; Christopher P.,0,3,30,30
1715635712726,EDS 204R,B01,507331,Heinzman; Erica M.,14,0,30,16
1715635713951,EDS 206R,A00,507332,Staff,0,4,30,30
1715635713951,EDS 206R,B00,507343,Staff,15,0,30,15
1715635714979,EDS 250,A00,507344,Hemans; Patricia Ann Benitez,20,0,40,20
1715635716552,EDS 281,A00,507345,Daly; Alan J.,18,0,18,0
1715635717709,EDS 284,A00,507350,Daly; Alan J.,16,0,16,0
1715635718862,EDS 286,A00,507359,Fine; Sarah,18,0,18,0
1715635719999,EDS 289C,A01,507361,Daly; Alan J.,18,0,18,0
1715635721342,EDS 290,A00,507366,Hofstetter; Carolyn,15,0,15,0
1715635722516,LIGM 5A,A00,507421,Fischer-Grunski; Eva K,17,0,20,3
1715635723702,LIGM 5B,A00,507423,Fischer-Grunski; Eva K,19,0,20,1
1715635724949,LIGM 5C,A00,507425,Fischer-Grunski; Eva K,19,0,20,1
1715635726073,LIIT 5AS,A00,507427,Carnelos; Chiara,20,0,20,0
1715635727309,LIIT 5BS,A00,507430,Carnelos; Chiara,20,0,20,0
1715635728403,LIIT 5CS,A00,507432,Carnelos; Chiara,20,0,20,0
1715635729541,LISP 5A,A00,507541,Munoz Sanchez; Alicia,11,0,20,9
1715635730642,LISP 5B,A00,507671,Munoz Sanchez; Alicia,9,0,20,11
1715635731816,LISP 5C,A00,507696,Munoz Sanchez; Alicia,9,0,20,11
1715635732861,MAE 197,001,528363,Boechler; Nicholas Sebastia,9998,0,9999,1
1715635733960,MATH 197,001,523477,Kedlaya; Kiran S.,9994,0,9999,5
1715635733960,MATH 197,002,563811,Zhang; Danna,9994,0,9999,5
1715635733960,MATH 197,003,628552,Dumitriu; Ioana,9998,0,9999,1
1715635733960,MATH 197,004,660885,Floyd; Eric,9998,0,9999,1
1715635735206,MCWP 40R,A00,518780,Staff,2,0,20,18
1715635735206,MCWP 40R,B00,518781,Staff,10,0,20,10
1715635735206,MCWP 40R,C00,518783,Staff,5,0,20,15
1715635736412,MCWP 50R,A00,518791,Staff,0,1,20,20
1715635736412,MCWP 50R,B00,518792,Staff,0,2,20,20
1715635736412,MCWP 50R,C00,518793,Staff,0,4,20,20
1715635736412,MCWP 50R,D00,518794,Staff,0,1,20,20
1715635736412,MCWP 50R,E00,518795,Staff,0,2,20,20
1715635736412,MCWP 50R,F00,518796,Staff,0,1,20,20
1715635736412,MCWP 50R,G00,518797,Staff,0,1,20,20
1715635737642,MMW 12R,A01,514034,Herbst; Matthew,0,2,16,16
1715635737642,MMW 12R,A02,514035,Herbst; Matthew,0,0,16,16
1715635738906,MMW 13R,A01,514037,Staff,0,5,16,16
1715635738906,MMW 13R,A02,514039,Staff,0,5,16,16
1715635738906,MMW 13R,A03,628519,Staff,0,4,16,16
1715635741187,SIO 295LS,A00,523233,Staff,10,0,30,20
1715635742710,SIO 295S,A00,523232,Staff,10,0,30,20
1715635743927,SIOC 290S,A01,637330,Merrifield; Mark A,21,0,30,9
1715635745371,SIOC 291S,A01,637333,Gabriel; Corey John,21,0,30,9
1715635746528,SOCI 117,A01,494376,Staff,0,5,5,5
1715635747627,WES 237B,A00,494380,Staff,10,0,20,10
1715635750016,AESE 279B,A00,494370,Wade; Jon P,0,0,33,33
1715635751069,AIP 97,001,660915,Van Den Einde; Yael Dahlia,9998,0,9999,1
1715635752110,AIP 197,001,627712,Vespa; Emanuel Ignacio,9995,0,9999,4
1715635752110,AIP 197,002,650778,Amir; On,9998,0,9999,1
1715635752110,AIP 197,003,650933,Avenancio-Leon; Carlos,9998,0,9999,1
1715635752110,AIP 197,004,658530,Heyman; Gail D.,9998,0,9999,1
1715635752110,AIP 197,005,658631,Neal; Sonya E,9998,0,9999,1
1715635752110,AIP 197,006,658671,Du; Songzi,9998,0,9999,1
1715635753266,ANAR 135S,A00,494369,Braswell; Geoffrey E.,0,0,0,0
1715635754447,BENG 196,001,628496,Engler; Adam J.,9998,0,9999,1
1715635754447,BENG 196,002,660916,Watson; John Thomas,9998,0,9999,1
1715635755629,BISP 197,001,650773,Wilhelm; James E.,9994,0,9999,5
1715635755629,BISP 197,002,658904,Coleman; Aaron B.,9998,0,9999,1
1715635756795,CAT 124RS,A01,519847,Geibel; William,0,0,20,20
1715635758074,CAT 125RS,A01,515971,Geibel; William,0,0,20,20
1715635759313,CLRE 250,A00,511389,Morris; Sheldon,9992,0,9999,7
1715635760622,CLRE 251,A00,507176,Mehta; Ravindra L.,9992,0,9999,7
1715635760622,CLRE 251,B00,511410,Mehta; Ravindra L.,9998,0,9999,1
1715635761809,CLRE 252,A00,507189,Cuomo; Raphael Eduardo,9994,0,9999,5
1715635763326,CLRE 253,A00,507199,Vaida; Florin,9994,0,9999,5
1715635763326,CLRE 253,B00,507202,Vaida; Florin,9999,0,9999,0
1715635764453,CLRE 259,A00,507211,Patel; Hemal,9996,0,9999,3
1715635765513,CLRE 260,A00,507221,Cuomo; Raphael Eduardo,9999,0,9999,0
1715635766694,CLRE 297,001,507242,Cuomo; Raphael Eduardo,9999,0,9999,0
1715635767966,COGS 197,001,638244,Voytek; Bradley Thomas,9997,0,9999,2
1715635769193,CSE 191,A00,516875,Minnes Kemp; Mor Mia,9991,0,9999,8
1715635770322,CSE 197,001,637388,Minnes Kemp; Mor Mia,9992,0,9999,7
1715635771518,CSS 201S,A01,494383,Mignozzetti; Umberto,35,0,35,0
1715635772783,CSS 202S,A01,494387,Mignozzetti; Umberto,35,0,35,0
1715635774058,DSC 197,001,628532,Eldridge; Justin Matthew,9995,0,9999,4
1715635775277,EAP 100,A00,516065,Staff,9799,0,9999,200
1715635776734,ECE 45,A01,507414,Staff,31,0,60,29
1715635779314,ECE 111,A01,507420,Staff,11,0,50,39
1715635780563,ECE 197,001,548057,Sievenpiper; Daniel F.,9991,0,9999,8
1715635781770,EDS 115,A00,507243,Choi; Bailey Miyeon,7,0,28,21
1715635782963,EDS 117,A01,494379,Staff,0,6,34,34
1715635784133,EDS 125,A00,507246,Hopkins; Megan Beth,8,0,30,22
1715635785322,EDS 128A,A01,507264,Fargason; Sharon Gayle,6,0,26,20
1715635786583,EDS 128B,A01,507293,Pappas; Elizabeth,10,0,30,20
1715635787729,EDS 139,A00,507294,Fargason; Sharon Gayle,10,0,30,20
1715635787729,EDS 139,B00,507313,Pappas; Elizabeth,11,0,30,19
1715635788883,EDS 201,A00,507315,Staff,10,0,30,20
1715635790035,EDS 203,A01,507317,Halter; Christopher P.,10,0,30,20
1715635791267,EDS 204R,A01,507319,Halter; Christopher P.,0,3,30,30
1715635791267,EDS 204R,B01,507331,Heinzman; Erica M.,14,0,30,16
1715635792592,EDS 206R,A00,507332,Staff,0,4,30,30
1715635792592,EDS 206R,B00,507343,Staff,15,0,30,15
1715635793778,EDS 250,A00,507344,Hemans; Patricia Ann Benitez,20,0,40,20
1715635794986,EDS 281,A00,507345,Daly; Alan J.,18,0,18,0
1715635796268,EDS 284,A00,507350,Daly; Alan J.,16,0,16,0
1715635797388,EDS 286,A00,507359,Fine; Sarah,18,0,18,0
1715635798701,EDS 289C,A01,507361,Daly; Alan J.,18,0,18,0
1715635799753,EDS 290,A00,507366,Hofstetter; Carolyn,15,0,15,0
1715635801042,LIGM 5A,A00,507421,Fischer-Grunski; Eva K,17,0,20,3
1715635803226,LIGM 5B,A00,507423,Fischer-Grunski; Eva K,19,0,20,1
1715635804557,LIGM 5C,A00,507425,Fischer-Grunski; Eva K,19,0,20,1
1715635805657,LIIT 5AS,A00,507427,Carnelos; Chiara,20,0,20,0
1715635806896,LIIT 5BS,A00,507430,Carnelos; Chiara,20,0,20,0
1715635808142,LIIT 5CS,A00,507432,Carnelos; Chiara,20,0,20,0
1715635809465,LISP 5A,A00,507541,Munoz Sanchez; Alicia,11,0,20,9
1715635810627,LISP 5B,A00,507671,Munoz Sanchez; Alicia,9,0,20,11
1715635811752,LISP 5C,A00,507696,Munoz Sanchez; Alicia,9,0,20,11
1715635813109,MAE 197,001,528363,Boechler; Nicholas Sebastia,9998,0,9999,1
1715635814312,MATH 197,001,523477,Kedlaya; Kiran S.,9994,0,9999,5
1715635814312,MATH 197,002,563811,Zhang; Danna,9994,0,9999,5
1715635814312,MATH 197,003,628552,Dumitriu; Ioana,9998,0,9999,1
1715635814312,MATH 197,004,660885,Floyd; Eric,9998,0,9999,1
1715635815600,MCWP 40R,A00,518780,Staff,2,0,20,18
1715635815600,MCWP 40R,B00,518781,Staff,10,0,20,10
1715635815600,MCWP 40R,C00,518783,Staff,5,0,20,15
1715635816743,MCWP 50R,A00,518791,Staff,0,1,20,20
1715635816743,MCWP 50R,B00,518792,Staff,0,2,20,20
1715635816743,MCWP 50R,C00,518793,Staff,0,4,20,20
1715635816743,MCWP 50R,D00,518794,Staff,0,1,20,20
1715635816743,MCWP 50R,E00,518795,Staff,0,2,20,20
1715635816743,MCWP 50R,F00,518796,Staff,0,1,20,20
1715635816743,MCWP 50R,G00,518797,Staff,0,1,20,20
1715635817987,MMW 12R,A01,514034,Herbst; Matthew,0,2,16,16
1715635817987,MMW 12R,A02,514035,Herbst; Matthew,0,0,16,16
1715635819110,MMW 13R,A01,514037,Staff,0,5,16,16
1715635819110,MMW 13R,A02,514039,Staff,0,5,16,16
1715635819110,MMW 13R,A03,628519,Staff,0,4,16,16
1715635821410,SIO 295LS,A00,523233,Staff,10,0,30,20
1715635822447,SIO 295S,A00,523232,Staff,10,0,30,20
1715635823647,SIOC 290S,A01,637330,Merrifield; Mark A,21,0,30,9
1715635824849,SIOC 291S,A01,637333,Gabriel; Corey John,21,0,30,9
1715635825975,SOCI 117,A01,494376,Staff,0,5,5,5
1715635827313,WES 237B,A00,494380,Staff,10,0,20,10
1715635829649,AESE 279B,A00,494370,Wade; Jon P,0,0,33,33
1715635830716,AIP 97,001,660915,Van Den Einde; Yael Dahlia,9998,0,9999,1
1715635831911,AIP 197,001,627712,Vespa; Emanuel Ignacio,9995,0,9999,4
1715635831911,AIP 197,002,650778,Amir; On,9998,0,9999,1
1715635831911,AIP 197,003,650933,Avenancio-Leon; Carlos,9998,0,9999,1
1715635831911,AIP 197,004,658530,Heyman; Gail D.,9998,0,9999,1
1715635831911,AIP 197,005,658631,Neal; Sonya E,9998,0,9999,1
1715635831911,AIP 197,006,658671,Du; Songzi,9998,0,9999,1
1715635833157,ANAR 135S,A00,494369,Braswell; Geoffrey E.,0,0,0,0
1715635834422,BENG 196,001,628496,Engler; Adam J.,9998,0,9999,1
1715635834422,BENG 196,002,660916,Watson; John Thomas,9998,0,9999,1
1715635835619,BISP 197,001,650773,Wilhelm; James E.,9994,0,9999,5
1715635835619,BISP 197,002,658904,Coleman; Aaron B.,9998,0,9999,1
1715635836772,CAT 124RS,A01,519847,Geibel; William,0,0,20,20
1715635837860,CAT 125RS,A01,515971,Geibel; William,0,0,20,20
1715635838993,CLRE 250,A00,511389,Morris; Sheldon,9992,0,9999,7
1715635840306,CLRE 251,A00,507176,Mehta; Ravindra L.,9992,0,9999,7
1715635840306,CLRE 251,B00,511410,Mehta; Ravindra L.,9998,0,9999,1
1715635841519,CLRE 252,A00,507189,Cuomo; Raphael Eduardo,9994,0,9999,5
1715635842660,CLRE 253,A00,507199,Vaida; Florin,9994,0,9999,5
1715635842660,CLRE 253,B00,507202,Vaida; Florin,9999,0,9999,0
1715635843774,CLRE 259,A00,507211,Patel; Hemal,9996,0,9999,3
1715635844917,CLRE 260,A00,507221,Cuomo; Raphael Eduardo,9999,0,9999,0
1715635846111,CLRE 297,001,507242,Cuomo; Raphael Eduardo,9999,0,9999,0
1715635847289,COGS 197,001,638244,Voytek; Bradley Thomas,9997,0,9999,2
1715635848479,CSE 191,A00,516875,Minnes Kemp; Mor Mia,9991,0,9999,8
1715635849679,CSE 197,001,637388,Minnes Kemp; Mor Mia,9992,0,9999,7
1715635850846,CSS 201S,A01,494383,Mignozzetti; Umberto,35,0,35,0
1715635852100,CSS 202S,A01,494387,Mignozzetti; Umberto,35,0,35,0
1715635853291,DSC 197,001,628532,Eldridge; Justin Matthew,9995,0,9999,4
1715635854647,EAP 100,A00,516065,Staff,9799,0,9999,200
1715635856388,ECE 45,A01,507414,Staff,31,0,60,29
1715635858690,ECE 111,A01,507420,Staff,11,0,50,39
1715635860043,ECE 197,001,548057,Sievenpiper; Daniel F.,9991,0,9999,8
1715635861342,EDS 115,A00,507243,Choi; Bailey Miyeon,7,0,28,21
1715635862511,EDS 117,A01,494379,Staff,0,6,34,34
1715635863691,EDS 125,A00,507246,Hopkins; Megan Beth,8,0,30,22
1715635864801,EDS 128A,A01,507264,Fargason; Sharon Gayle,6,0,26,20
1715635865950,EDS 128B,A01,507293,Pappas; Elizabeth,10,0,30,20
1715635867133,EDS 139,A00,507294,Fargason; Sharon Gayle,10,0,30,20
1715635867133,EDS 139,B00,507313,Pappas; Elizabeth,11,0,30,19
1715635868197,EDS 201,A00,507315,Staff,10,0,30,20
1715635869440,EDS 203,A01,507317,Halter; Christopher P.,10,0,30,20
1715635870640,EDS 204R,A01,507319,Halter; Christopher P.,0,3,30,30
1715635870640,EDS 204R,B01,507331,Heinzman; Erica M.,14,0,30,16
1715635871954,EDS 206R,A00,507332,Staff,0,4,30,30
1715635871954,EDS 206R,B00,507343,Staff,15,0,30,15
1715635873186,EDS 250,A00,507344,Hemans; Patricia Ann Benitez,20,0,40,20
1715635874990,EDS 281,A00,507345,Daly; Alan J.,18,0,18,0
1715635876356,EDS 284,A00,507350,Daly; Alan J.,16,0,16,0
1715635877520,EDS 286,A00,507359,Fine; Sarah,18,0,18,0
1715635878748,EDS 289C,A01,507361,Daly; Alan J.,18,0,18,0
1715635879901,EDS 290,A00,507366,Hofstetter; Carolyn,15,0,15,0
1715635881073,LIGM 5A,A00,507421,Fischer-Grunski; Eva K,17,0,20,3
1715635882361,LIGM 5B,A00,507423,Fischer-Grunski; Eva K,19,0,20,1
1715635883568,LIGM 5C,A00,507425,Fischer-Grunski; Eva K,19,0,20,1
1715635884747,LIIT 5AS,A00,507427,Carnelos; Chiara,20,0,20,0
1715635885952,LIIT 5BS,A00,507430,Carnelos; Chiara,20,0,20,0
1715635887171,LIIT 5CS,A00,507432,Carnelos; Chiara,20,0,20,0
1715635888360,LISP 5A,A00,507541,Munoz Sanchez; Alicia,11,0,20,9
1715635889525,LISP 5B,A00,507671,Munoz Sanchez; Alicia,9,0,20,11
1715635890662,LISP 5C,A00,507696,Munoz Sanchez; Alicia,9,0,20,11
1715635891830,MAE 197,001,528363,Boechler; Nicholas Sebastia,9998,0,9999,1
1715635893120,MATH 197,001,523477,Kedlaya; Kiran S.,9994,0,9999,5
1715635893120,MATH 197,002,563811,Zhang; Danna,9994,0,9999,5
1715635893120,MATH 197,003,628552,Dumitriu; Ioana,9998,0,9999,1
1715635893120,MATH 197,004,660885,Floyd; Eric,9998,0,9999,1
1715635894378,MCWP 40R,A00,518780,Staff,2,0,20,18
1715635894378,MCWP 40R,B00,518781,Staff,10,0,20,10
1715635894378,MCWP 40R,C00,518783,Staff,5,0,20,15
1715635895551,MCWP 50R,A00,518791,Staff,0,1,20,20
1715635895551,MCWP 50R,B00,518792,Staff,0,2,20,20
1715635895551,MCWP 50R,C00,518793,Staff,0,4,20,20
1715635895551,MCWP 50R,D00,518794,Staff,0,1,20,20
1715635895551,MCWP 50R,E00,518795,Staff,0,2,20,20
1715635895551,MCWP 50R,F00,518796,Staff,0,1,20,20
1715635895551,MCWP 50R,G00,518797,Staff,0,1,20,20
1715635896741,MMW 12R,A01,514034,Herbst; Matthew,0,2,16,16
1715635896741,MMW 12R,A02,514035,Herbst; Matthew,0,0,16,16
1715635897908,MMW 13R,A01,514037,Staff,0,5,16,16
1715635897908,MMW 13R,A02,514039,Staff,0,5,16,16
1715635897908,MMW 13R,A03,628519,Staff,0,4,16,16
1715635900222,SIO 295LS,A00,523233,Staff,10,0,30,20
1715635901450,SIO 295S,A00,523232,Staff,10,0,30,20
1715635902644,SIOC 290S,A01,637330,Merrifield; Mark A,21,0,30,9
1715635903832,SIOC 291S,A01,637333,Gabriel; Corey John,21,0,30,9
1715635904977,SOCI 117,A01,494376,Staff,0,5,5,5
1715635906137,WES 237B,A00,494380,Staff,10,0,20,10
1715635908476,AESE 279B,A00,494370,Wade; Jon P,0,0,33,33
1715635909620,AIP 97,001,660915,Van Den Einde; Yael Dahlia,9998,0,9999,1
1715635910821,AIP 197,001,627712,Vespa; Emanuel Ignacio,9995,0,9999,4
1715635910821,AIP 197,002,650778,Amir; On,9998,0,9999,1
1715635910821,AIP 197,003,650933,Avenancio-Leon; Carlos,9998,0,9999,1
1715635910821,AIP 197,004,658530,Heyman; Gail D.,9998,0,9999,1
1715635910821,AIP 197,005,658631,Neal; Sonya E,9998,0,9999,1
1715635910821,AIP 197,006,658671,Du; Songzi,9998,0,9999,1
1715635911991,ANAR 135S,A00,494369,Braswell; Geoffrey E.,0,0,0,0
1715635913159,BENG 196,001,628496,Engler; Adam J.,9998,0,9999,1
1715635913159,BENG 196,002,660916,Watson; John Thomas,9998,0,9999,1
1715635914386,BISP 197,001,650773,Wilhelm; James E.,9994,0,9999,5
1715635914386,BISP 197,002,658904,Coleman; Aaron B.,9998,0,9999,1
1715635915465,CAT 124RS,A01,519847,Geibel; William,0,0,20,20
1715635916632,CAT 125RS,A01,515971,Geibel; William,0,0,20,20
1715635917952,CLRE 250,A00,511389,Morris; Sheldon,9992,0,9999,7
1715635919023,CLRE 251,A00,507176,Mehta; Ravindra L.,9992,0,9999,7
1715635919023,CLRE 251,B00,511410,Mehta; Ravindra L.,9998,0,9999,1
1715635920549,CLRE 252,A00,507189,Cuomo; Raphael Eduardo,9994,0,9999,5
1715635921931,CLRE 253,A00,507199,Vaida; Florin,9994,0,9999,5
1715635921931,CLRE 253,B00,507202,Vaida; Florin,9999,0,9999,0
1715635923122,CLRE 259,A00,507211,Patel; Hemal,9996,0,9999,3
1715635924319,CLRE 260,A00,507221,Cuomo; Raphael Eduardo,9999,0,9999,0
1715635925531,CLRE 297,001,507242,Cuomo; Raphael Eduardo,9999,0,9999,0
1715635926778,COGS 197,001,638244,Voytek; Bradley Thomas,9997,0,9999,2
1715635927911,CSE 191,A00,516875,Minnes Kemp; Mor Mia,9991,0,9999,8
1715635929302,CSE 197,001,637388,Minnes Kemp; Mor Mia,9992,0,9999,7
1715635930710,CSS 201S,A01,494383,Mignozzetti; Umberto,35,0,35,0
1715635931833,CSS 202S,A01,494387,Mignozzetti; Umberto,35,0,35,0
1715635932937,DSC 197,001,628532,Eldridge; Justin Matthew,9995,0,9999,4
1715635934109,EAP 100,A00,516065,Staff,9799,0,9999,200
1715635935299,ECE 45,A01,507414,Staff,31,0,60,29
1715635937670,ECE 111,A01,507420,Staff,11,0,50,39
1715635938888,ECE 197,001,548057,Sievenpiper; Daniel F.,9991,0,9999,8
1715635940052,EDS 115,A00,507243,Choi; Bailey Miyeon,7,0,28,21
1715635941208,EDS 117,A01,494379,Staff,0,6,34,34
1715635942492,EDS 125,A00,507246,Hopkins; Megan Beth,8,0,30,22
1715635944048,EDS 128A,A01,507264,Fargason; Sharon Gayle,6,0,26,20
1715635945227,EDS 128B,A01,507293,Pappas; Elizabeth,10,0,30,20
1715635946464,EDS 139,A00,507294,Fargason; Sharon Gayle,10,0,30,20
1715635946464,EDS 139,B00,507313,Pappas; Elizabeth,11,0,30,19
1715635947754,EDS 201,A00,507315,Staff,10,0,30,20
1715635949070,EDS 203,A01,507317,Halter; Christopher P.,10,0,30,20
1715635950462,EDS 204R,A01,507319,Halter; Christopher P.,0,3,30,30
1715635950462,EDS 204R,B01,507331,Heinzman; Erica M.,14,0,30,16
1715635951501,EDS 206R,A00,507332,Staff,0,4,30,30
1715635951501,EDS 206R,B00,507343,Staff,15,0,30,15
1715635952651,EDS 250,A00,507344,Hemans; Patricia Ann Benitez,20,0,40,20
1715635953945,EDS 281,A00,507345,Daly; Alan J.,18,0,18,0
1715635955165,EDS 284,A00,507350,Daly; Alan J.,16,0,16,0
1715635956304,EDS 286,A00,507359,Fine; Sarah,18,0,18,0
1715635957672,EDS 289C,A01,507361,Daly; Alan J.,18,0,18,0
1715635959138,EDS 290,A00,507366,Hofstetter; Carolyn,15,0,15,0
1715635960263,LIGM 5A,A00,507421,Fischer-Grunski; Eva K,17,0,20,3
1715635961376,LIGM 5B,A00,507423,Fischer-Grunski; Eva K,19,0,20,1
1715635962589,LIGM 5C,A00,507425,Fischer-Grunski; Eva K,19,0,20,1
1715635963777,LIIT 5AS,A00,507427,Carnelos; Chiara,20,0,20,0
1715635964897,LIIT 5BS,A00,507430,Carnelos; Chiara,20,0,20,0
1715635966271,LIIT 5CS,A00,507432,Carnelos; Chiara,20,0,20,0
1715635967448,LISP 5A,A00,507541,Munoz Sanchez; Alicia,11,0,20,9
1715635968721,LISP 5B,A00,507671,Munoz Sanchez; Alicia,9,0,20,11
1715635969943,LISP 5C,A00,507696,Munoz Sanchez; Alicia,9,0,20,11
1715635971043,MAE 197,001,528363,Boechler; Nicholas Sebastia,9998,0,9999,1
1715635972352,MATH 197,001,523477,Kedlaya; Kiran S.,9994,0,9999,5
1715635972352,MATH 197,002,563811,Zhang; Danna,9994,0,9999,5
1715635972352,MATH 197,003,628552,Dumitriu; Ioana,9998,0,9999,1
1715635972352,MATH 197,004,660885,Floyd; Eric,9998,0,9999,1
1715635973455,MCWP 40R,A00,518780,Staff,2,0,20,18
1715635973455,MCWP 40R,B00,518781,Staff,10,0,20,10
1715635973455,MCWP 40R,C00,518783,Staff,5,0,20,15
1715635974515,MCWP 50R,A00,518791,Staff,0,1,20,20
1715635974515,MCWP 50R,B00,518792,Staff,0,2,20,20
1715635974515,MCWP 50R,C00,518793,Staff,0,4,20,20
1715635974515,MCWP 50R,D00,518794,Staff,0,1,20,20
1715635974515,MCWP 50R,E00,518795,Staff,0,2,20,20
1715635974515,MCWP 50R,F00,518796,Staff,0,1,20,20
1715635974515,MCWP 50R,G00,518797,Staff,0,1,20,20
1715635975589,MMW 12R,A01,514034,Herbst; Matthew,0,2,16,16
1715635975589,MMW 12R,A02,514035,Herbst; Matthew,0,0,16,16
1715635976676,MMW 13R,A01,514037,Staff,0,5,16,16
1715635976676,MMW 13R,A02,514039,Staff,0,5,16,16
1715635976676,MMW 13R,A03,628519,Staff,0,4,16,16
1715635979158,SIO 295LS,A00,523233,Staff,10,0,30,20
1715635980242,SIO 295S,A00,523232,Staff,10,0,30,20
1715635981332,SIOC 290S,A01,637330,Merrifield; Mark A,21,0,30,9
1715635982485,SIOC 291S,A01,637333,Gabriel; Corey John,21,0,30,9
1715635983713,SOCI 117,A01,494376,Staff,0,5,5,5
1715635984960,WES 237B,A00,494380,Staff,10,0,20,10
1715635987272,AESE 279B,A00,494370,Wade; Jon P,0,0,33,33
1715635988582,AIP 97,001,660915,Van Den Einde; Yael Dahlia,9998,0,9999,1
1715635989757,AIP 197,001,627712,Vespa; Emanuel Ignacio,9995,0,9999,4
1715635989757,AIP 197,002,650778,Amir; On,9998,0,9999,1
1715635989757,AIP 197,003,650933,Avenancio-Leon; Carlos,9998,0,9999,1
1715635989757,AIP 197,004,658530,Heyman; Gail D.,9998,0,9999,1
1715635989757,AIP 197,005,658631,Neal; Sonya E,9998,0,9999,1
1715635989757,AIP 197,006,658671,Du; Songzi,9998,0,9999,1
1715635990827,ANAR 135S,A00,494369,Braswell; Geoffrey E.,0,0,0,0
1715635991920,BENG 196,001,628496,Engler; Adam J.,9998,0,9999,1
1715635991920,BENG 196,002,660916,Watson; John Thomas,9998,0,9999,1
1715635993079,BISP 197,001,650773,Wilhelm; James E.,9994,0,9999,5
1715635993079,BISP 197,002,658904,Coleman; Aaron B.,9998,0,9999,1
1715635994498,CAT 124RS,A01,519847,Geibel; William,0,0,20,20
1715635995587,CAT 125RS,A01,515971,Geibel; William,0,0,20,20
1715635996750,CLRE 250,A00,511389,Morris; Sheldon,9992,0,9999,7
1715635997888,CLRE 251,A00,507176,Mehta; Ravindra L.,9992,0,9999,7
1715635997888,CLRE 251,B00,511410,Mehta; Ravindra L.,9998,0,9999,1
1715635999146,CLRE 252,A00,507189,Cuomo; Raphael Eduardo,9994,0,9999,5
1715636000312,CLRE 253,A00,507199,Vaida; Florin,9994,0,9999,5
1715636000312,CLRE 253,B00,507202,Vaida; Florin,9999,0,9999,0
1715636001498,CLRE 259,A00,507211,Patel; Hemal,9996,0,9999,3
1715636002627,CLRE 260,A00,507221,Cuomo; Raphael Eduardo,9999,0,9999,0
1715636003948,CLRE 297,001,507242,Cuomo; Raphael Eduardo,9999,0,9999,0
1715636005185,COGS 197,001,638244,Voytek; Bradley Thomas,9997,0,9999,2
1715636006413,CSE 191,A00,516875,Minnes Kemp; Mor Mia,9991,0,9999,8
1715636007606,CSE 197,001,637388,Minnes Kemp; Mor Mia,9992,0,9999,7
1715636009014,CSS 201S,A01,494383,Mignozzetti; Umberto,35,0,35,0
1715636010238,CSS 202S,A01,494387,Mignozzetti; Umberto,35,0,35,0
1715636011379,DSC 197,001,628532,Eldridge; Justin Matthew,9995,0,9999,4
1715636012519,EAP 100,A00,516065,Staff,9799,0,9999,200
1715636013767,ECE 45,A01,507414,Staff,31,0,60,29
1715636016079,ECE 111,A01,507420,Staff,11,0,50,39
1715636017289,ECE 197,001,548057,Sievenpiper; Daniel F.,9991,0,9999,8
1715636018529,EDS 115,A00,507243,Choi; Bailey Miyeon,7,0,28,21
1715636019821,EDS 117,A01,494379,Staff,0,6,34,34
1715636021005,EDS 125,A00,507246,Hopkins; Megan Beth,8,0,30,22
1715636022269,EDS 128A,A01,507264,Fargason; Sharon Gayle,6,0,26,20
1715636023542,EDS 128B,A01,507293,Pappas; Elizabeth,10,0,30,20
1715636024800,EDS 139,A00,507294,Fargason; Sharon Gayle,10,0,30,20
1715636024800,EDS 139,B00,507313,Pappas; Elizabeth,11,0,30,19
1715636026000,EDS 201,A00,507315,Staff,10,0,30,20
1715636027164,EDS 203,A01,507317,Halter; Christopher P.,10,0,30,20
1715636028341,EDS 204R,A01,507319,Halter; Christopher P.,0,3,30,30
1715636028341,EDS 204R,B01,507331,Heinzman; Erica M.,14,0,30,16
1715636029503,EDS 206R,A00,507332,Staff,0,4,30,30
1715636029503,EDS 206R,B00,507343,Staff,15,0,30,15
1715636030949,EDS 250,A00,507344,Hemans; Patricia Ann Benitez,20,0,40,20
1715636031986,EDS 281,A00,507345,Daly; Alan J.,18,0,18,0
1715636033140,EDS 284,A00,507350,Daly; Alan J.,16,0,16,0
1715636035089,EDS 286,A00,507359,Fine; Sarah,18,0,18,0
1715636036218,EDS 289C,A01,507361,Daly; Alan J.,18,0,18,0
1715636037275,EDS 290,A00,507366,Hofstetter; Carolyn,15,0,15,0
1715636038418,LIGM 5A,A00,507421,Fischer-Grunski; Eva K,17,0,20,3
1715636039677,LIGM 5B,A00,507423,Fischer-Grunski; Eva K,19,0,20,1
1715636041199,LIGM 5C,A00,507425,Fischer-Grunski; Eva K,19,0,20,1
1715636043236,LIIT 5AS,A00,507427,Carnelos; Chiara,20,0,20,0
1715636044409,LIIT 5BS,A00,507430,Carnelos; Chiara,20,0,20,0
1715636045536,LIIT 5CS,A00,507432,Carnelos; Chiara,20,0,20,0
1715636046991,LISP 5A,A00,507541,Munoz Sanchez; Alicia,11,0,20,9
1715636048202,LISP 5B,A00,507671,Munoz Sanchez; Alicia,9,0,20,11
1715636049686,LISP 5C,A00,507696,Munoz Sanchez; Alicia,9,0,20,11
1715636050835,MAE 197,001,528363,Boechler; Nicholas Sebastia,9998,0,9999,1
1715636051981,MATH 197,001,523477,Kedlaya; Kiran S.,9994,0,9999,5
1715636051981,MATH 197,002,563811,Zhang; Danna,9994,0,9999,5
1715636051981,MATH 197,003,628552,Dumitriu; Ioana,9998,0,9999,1
1715636051981,MATH 197,004,660885,Floyd; Eric,9998,0,9999,1
1715636053139,MCWP 40R,A00,518780,Staff,2,0,20,18
1715636053139,MCWP 40R,B00,518781,Staff,10,0,20,10
1715636053139,MCWP 40R,C00,518783,Staff,5,0,20,15
1715636054276,MCWP 50R,A00,518791,Staff,0,1,20,20
1715636054276,MCWP 50R,B00,518792,Staff,0,2,20,20
1715636054276,MCWP 50R,C00,518793,Staff,0,4,20,20
1715636054276,MCWP 50R,D00,518794,Staff,0,1,20,20
1715636054276,MCWP 50R,E00,518795,Staff,0,2,20,20
1715636054276,MCWP 50R,F00,518796,Staff,0,1,20,20
1715636054276,MCWP 50R,G00,518797,Staff,0,1,20,20
1715636055519,MMW 12R,A01,514034,Herbst; Matthew,0,2,16,16
1715636055519,MMW 12R,A02,514035,Herbst; Matthew,0,0,16,16
1715636056685,MMW 13R,A01,514037,Staff,0,5,16,16
1715636056685,MMW 13R,A02,514039,Staff,0,5,16,16
1715636056685,MMW 13R,A03,628519,Staff,0,4,16,16
1715636059138,SIO 295LS,A00,523233,Staff,10,0,30,20
1715636060263,SIO 295S,A00,523232,Staff,10,0,30,20
1715636061434,SIOC 290S,A01,637330,Merrifield; Mark A,21,0,30,9
1715636062675,SIOC 291S,A01,637333,Gabriel; Corey John,21,0,30,9
1715636064110,SOCI 117,A01,494376,Staff,0,5,5,5
1715636065163,WES 237B,A00,494380,Staff,10,0,20,10
1715636067598,AESE 279B,A00,494370,Wade; Jon P,0,0,33,33
1715636068711,AIP 97,001,660915,Van Den Einde; Yael Dahlia,9998,0,9999,1
1715636069945,AIP 197,001,627712,Vespa; Emanuel Ignacio,9995,0,9999,4
1715636069945,AIP 197,002,650778,Amir; On,9998,0,9999,1
1715636069945,AIP 197,003,650933,Avenancio-Leon; Carlos,9998,0,9999,1
1715636069945,AIP 197,004,658530,Heyman; Gail D.,9998,0,9999,1
1715636069945,AIP 197,005,658631,Neal; Sonya E,9998,0,9999,1
1715636069945,AIP 197,006,658671,Du; Songzi,9998,0,9999,1
1715636071217,ANAR 135S,A00,494369,Braswell; Geoffrey E.,0,0,0,0
1715636072286,BENG 196,001,628496,Engler; Adam J.,9998,0,9999,1
1715636072286,BENG 196,002,660916,Watson; John Thomas,9998,0,9999,1
1715636073417,BISP 197,001,650773,Wilhelm; James E.,9994,0,9999,5
1715636073417,BISP 197,002,658904,Coleman; Aaron B.,9998,0,9999,1
1715636074682,CAT 124RS,A01,519847,Geibel; William,0,0,20,20
1715636075863,CAT 125RS,A01,515971,Geibel; William,0,0,20,20
1715636077068,CLRE 250,A00,511389,Morris; Sheldon,9992,0,9999,7
1715636078320,CLRE 251,A00,507176,Mehta; Ravindra L.,9992,0,9999,7
1715636078320,CLRE 251,B00,511410,Mehta; Ravindra L.,9998,0,9999,1
1715636079476,CLRE 252,A00,507189,Cuomo; Raphael Eduardo,9994,0,9999,5
1715636080667,CLRE 253,A00,507199,Vaida; Florin,9994,0,9999,5
1715636080667,CLRE 253,B00,507202,Vaida; Florin,9999,0,9999,0
1715636082081,CLRE 259,A00,507211,Patel; Hemal,9996,0,9999,3
1715636083202,CLRE 260,A00,507221,Cuomo; Raphael Eduardo,9999,0,9999,0
1715636084465,CLRE 297,001,507242,Cuomo; Raphael Eduardo,9999,0,9999,0
1715636085655,COGS 197,001,638244,Voytek; Bradley Thomas,9997,0,9999,2
1715636086822,CSE 191,A00,516875,Minnes Kemp; Mor Mia,9991,0,9999,8
1715636088042,CSE 197,001,637388,Minnes Kemp; Mor Mia,9992,0,9999,7
1715636089142,CSS 201S,A01,494383,Mignozzetti; Umberto,35,0,35,0
1715636090295,CSS 202S,A01,494387,Mignozzetti; Umberto,35,0,35,0
1715636091528,DSC 197,001,628532,Eldridge; Justin Matthew,9995,0,9999,4
1715636092641,EAP 100,A00,516065,Staff,9799,0,9999,200
1715636093844,ECE 45,A01,507414,Staff,31,0,60,29
1715636096242,ECE 111,A01,507420,Staff,11,0,50,39
1715636097503,ECE 197,001,548057,Sievenpiper; Daniel F.,9991,0,9999,8
1715636098660,EDS 115,A00,507243,Choi; Bailey Miyeon,7,0,28,21
1715636099927,EDS 117,A01,494379,Staff,0,6,34,34
1715636101064,EDS 125,A00,507246,Hopkins; Megan Beth,8,0,30,22
1715636102417,EDS 128A,A01,507264,Fargason; Sharon Gayle,6,0,26,20
1715636103555,EDS 128B,A01,507293,Pappas; Elizabeth,10,0,30,20
1715636104670,EDS 139,A00,507294,Fargason; Sharon Gayle,10,0,30,20
1715636104670,EDS 139,B00,507313,Pappas; Elizabeth,11,0,30,19
1715636105806,EDS 201,A00,507315,Staff,10,0,30,20
1715636107026,EDS 203,A01,507317,Halter; Christopher P.,10,0,30,20
1715636108156,EDS 204R,A01,507319,Halter; Christopher P.,0,3,30,30
1715636108156,EDS 204R,B01,507331,Heinzman; Erica M.,14,0,30,16
1715636109284,EDS 206R,A00,507332,Staff,0,4,30,30
1715636109284,EDS 206R,B00,507343,Staff,15,0,30,15
1715636110411,EDS 250,A00,507344,Hemans; Patricia Ann Benitez,20,0,40,20
1715636111529,EDS 281,A00,507345,Daly; Alan J.,18,0,18,0
1715636112660,EDS 284,A00,507350,Daly; Alan J.,16,0,16,0
1715636113815,EDS 286,A00,507359,Fine; Sarah,18,0,18,0
1715636115015,EDS 289C,A01,507361,Daly; Alan J.,18,0,18,0
1715636116251,EDS 290,A00,507366,Hofstetter; Carolyn,15,0,15,0
1715636117446,LIGM 5A,A00,507421,Fischer-Grunski; Eva K,17,0,20,3
1715636118543,LIGM 5B,A00,507423,Fischer-Grunski; Eva K,19,0,20,1
1715636119732,LIGM 5C,A00,507425,Fischer-Grunski; Eva K,19,0,20,1
1715636120975,LIIT 5AS,A00,507427,Carnelos; Chiara,20,0,20,0
1715636122083,LIIT 5BS,A00,507430,Carnelos; Chiara,20,0,20,0
1715636123294,LIIT 5CS,A00,507432,Carnelos; Chiara,20,0,20,0
1715636124622,LISP 5A,A00,507541,Munoz Sanchez; Alicia,11,0,20,9
1715636125757,LISP 5B,A00,507671,Munoz Sanchez; Alicia,9,0,20,11
1715636126982,LISP 5C,A00,507696,Munoz Sanchez; Alicia,9,0,20,11
1715636128200,MAE 197,001,528363,Boechler; Nicholas Sebastia,9998,0,9999,1
1715636129458,MATH 197,001,523477,Kedlaya; Kiran S.,9994,0,9999,5
1715636129458,MATH 197,002,563811,Zhang; Danna,9994,0,9999,5
1715636129458,MATH 197,003,628552,Dumitriu; Ioana,9998,0,9999,1
1715636129458,MATH 197,004,660885,Floyd; Eric,9998,0,9999,1
1715636130583,MCWP 40R,A00,518780,Staff,2,0,20,18
1715636130583,MCWP 40R,B00,518781,Staff,10,0,20,10
1715636130583,MCWP 40R,C00,518783,Staff,5,0,20,15
1715636131771,MCWP 50R,A00,518791,Staff,0,1,20,20
1715636131771,MCWP 50R,B00,518792,Staff,0,2,20,20
1715636131771,MCWP 50R,C00,518793,Staff,0,4,20,20
1715636131771,MCWP 50R,D00,518794,Staff,0,1,20,20
1715636131771,MCWP 50R,E00,518795,Staff,0,2,20,20
1715636131771,MCWP 50R,F00,518796,Staff,0,1,20,20
1715636131771,MCWP 50R,G00,518797,Staff,0,1,20,20
1715636132912,MMW 12R,A01,514034,Herbst; Matthew,0,2,16,16
1715636132912,MMW 12R,A02,514035,Herbst; Matthew,0,0,16,16
1715636134123,MMW 13R,A01,514037,Staff,0,5,16,16
1715636134123,MMW 13R,A02,514039,Staff,0,5,16,16
1715636134123,MMW 13R,A03,628519,Staff,0,4,16,16
1715636136439,SIO 295LS,A00,523233,Staff,10,0,30,20
1715636137589,SIO 295S,A00,523232,Staff,10,0,30,20
1715636138767,SIOC 290S,A01,637330,Merrifield; Mark A,21,0,30,9
1715636139941,SIOC 291S,A01,637333,Gabriel; Corey John,21,0,30,9
1715636141030,SOCI 117,A01,494376,Staff,0,5,5,5
1715636142113,WES 237B,A00,494380,Staff,10,0,20,10
1715636144434,AESE 279B,A00,494370,Wade; Jon P,0,0,33,33
1715636146062,AIP 97,001,660915,Van Den Einde; Yael Dahlia,9998,0,9999,1
1715636147275,AIP 197,001,627712,Vespa; Emanuel Ignacio,9995,0,9999,4
1715636147275,AIP 197,002,650778,Amir; On,9998,0,9999,1
1715636147275,AIP 197,003,650933,Avenancio-Leon; Carlos,9998,0,9999,1
1715636147275,AIP 197,004,658530,Heyman; Gail D.,9998,0,9999,1
1715636147275,AIP 197,005,658631,Neal; Sonya E,9998,0,9999,1
1715636147275,AIP 197,006,658671,Du; Songzi,9998,0,9999,1
1715636148382,ANAR 135S,A00,494369,Braswell; Geoffrey E.,0,0,0,0
1715636149561,BENG 196,001,628496,Engler; Adam J.,9998,0,9999,1
1715636149561,BENG 196,002,660916,Watson; John Thomas,9998,0,9999,1
1715636150727,BISP 197,001,650773,Wilhelm; James E.,9994,0,9999,5
1715636150727,BISP 197,002,658904,Coleman; Aaron B.,9998,0,9999,1
1715636151835,CAT 124RS,A01,519847,Geibel; William,0,0,20,20
1715636153029,CAT 125RS,A01,515971,Geibel; William,0,0,20,20
1715636154227,CLRE 250,A00,511389,Morris; Sheldon,9992,0,9999,7
1715636155413,CLRE 251,A00,507176,Mehta; Ravindra L.,9992,0,9999,7
1715636155413,CLRE 251,B00,511410,Mehta; Ravindra L.,9998,0,9999,1
1715636156502,CLRE 252,A00,507189,Cuomo; Raphael Eduardo,9994,0,9999,5
1715636157651,CLRE 253,A00,507199,Vaida; Florin,9994,0,9999,5
1715636157651,CLRE 253,B00,507202,Vaida; Florin,9999,0,9999,0
1715636158750,CLRE 259,A00,507211,Patel; Hemal,9996,0,9999,3
1715636159978,CLRE 260,A00,507221,Cuomo; Raphael Eduardo,9999,0,9999,0
1715636161229,CLRE 297,001,507242,Cuomo; Raphael Eduardo,9999,0,9999,0
1715636162464,COGS 197,001,638244,Voytek; Bradley Thomas,9997,0,9999,2
1715636163599,CSE 191,A00,516875,Minnes Kemp; Mor Mia,9991,0,9999,8
1715636164849,CSE 197,001,637388,Minnes Kemp; Mor Mia,9992,0,9999,7
1715636166026,CSS 201S,A01,494383,Mignozzetti; Umberto,35,0,35,0
1715636167209,CSS 202S,A01,494387,Mignozzetti; Umberto,35,0,35,0
1715636168322,DSC 197,001,628532,Eldridge; Justin Matthew,9995,0,9999,4
1715636169525,EAP 100,A00,516065,Staff,9799,0,9999,200
1715636170754,ECE 45,A01,507414,Staff,31,0,60,29
1715636173046,ECE 111,A01,507420,Staff,11,0,50,39
1715636174182,ECE 197,001,548057,Sievenpiper; Daniel F.,9991,0,9999,8
1715636175408,EDS 115,A00,507243,Choi; Bailey Miyeon,7,0,28,21
1715636176558,EDS 117,A01,494379,Staff,0,6,34,34
1715636177647,EDS 125,A00,507246,Hopkins; Megan Beth,8,0,30,22
1715636178725,EDS 128A,A01,507264,Fargason; Sharon Gayle,6,0,26,20
1715636179859,EDS 128B,A01,507293,Pappas; Elizabeth,10,0,30,20
1715636181039,EDS 139,A00,507294,Fargason; Sharon Gayle,10,0,30,20
1715636181039,EDS 139,B00,507313,Pappas; Elizabeth,11,0,30,19
1715636182120,EDS 201,A00,507315,Staff,10,0,30,20
1715636183295,EDS 203,A01,507317,Halter; Christopher P.,10,0,30,20
1715636184418,EDS 204R,A01,507319,Halter; Christopher P.,0,3,30,30
1715636184418,EDS 204R,B01,507331,Heinzman; Erica M.,14,0,30,16
1715636185623,EDS 206R,A00,507332,Staff,0,4,30,30
1715636185623,EDS 206R,B00,507343,Staff,15,0,30,15
1715636186814,EDS 250,A00,507344,Hemans; Patricia Ann Benitez,20,0,40,20
1715636188060,EDS 281,A00,507345,Daly; Alan J.,18,0,18,0
1715636189175,EDS 284,A00,507350,Daly; Alan J.,16,0,16,0
1715636190269,EDS 286,A00,507359,Fine; Sarah,18,0,18,0
1715636191420,EDS 289C,A01,507361,Daly; Alan J.,18,0,18,0
1715636192564,EDS 290,A00,507366,Hofstetter; Carolyn,15,0,15,0
1715636193689,LIGM 5A,A00,507421,Fischer-Grunski; Eva K,17,0,20,3
1715636195262,LIGM 5B,A00,507423,Fischer-Grunski; Eva K,19,0,20,1
1715636196412,LIGM 5C,A00,507425,Fischer-Grunski; Eva K,19,0,20,1
1715636197663,LIIT 5AS,A00,507427,Carnelos; Chiara,20,0,20,0
1715636198905,LIIT 5BS,A00,507430,Carnelos; Chiara,20,0,20,0
1715636200171,LIIT 5CS,A00,507432,Carnelos; Chiara,20,0,20,0
1715636201352,LISP 5A,A00,507541,Munoz Sanchez; Alicia,11,0,20,9
1715636202544,LISP 5B,A00,507671,Munoz Sanchez; Alicia,9,0,20,11
1715636203655,LISP 5C,A00,507696,Munoz Sanchez; Alicia,9,0,20,11
1715636204815,MAE 197,001,528363,Boechler; Nicholas Sebastia,9998,0,9999,1
1715636205929,MATH 197,001,523477,Kedlaya; Kiran S.,9994,0,9999,5
1715636205929,MATH 197,002,563811,Zhang; Danna,9994,0,9999,5
1715636205929,MATH 197,003,628552,Dumitriu; Ioana,9998,0,9999,1
1715636205929,MATH 197,004,660885,Floyd; Eric,9998,0,9999,1
1715636207067,MCWP 40R,A00,518780,Staff,2,0,20,18
1715636207067,MCWP 40R,B00,518781,Staff,10,0,20,10
1715636207067,MCWP 40R,C00,518783,Staff,5,0,20,15
1715636208191,MCWP 50R,A00,518791,Staff,0,1,20,20
1715636208191,MCWP 50R,B00,518792,Staff,0,2,20,20
1715636208191,MCWP 50R,C00,518793,Staff,0,4,20,20
1715636208191,MCWP 50R,D00,518794,Staff,0,1,20,20
1715636208191,MCWP 50R,E00,518795,Staff,0,2,20,20
1715636208191,MCWP 50R,F00,518796,Staff,0,1,20,20
1715636208191,MCWP 50R,G00,518797,Staff,0,1,20,20
1715636209369,MMW 12R,A01,514034,Herbst; Matthew,0,2,16,16
1715636209369,MMW 12R,A02,514035,Herbst; Matthew,0,0,16,16
1715636210477,MMW 13R,A01,514037,Staff,0,5,16,16
1715636210477,MMW 13R,A02,514039,Staff,0,5,16,16
1715636210477,MMW 13R,A03,628519,Staff,0,4,16,16
1715636213029,SIO 295LS,A00,523233,Staff,10,0,30,20
1715636214426,SIO 295S,A00,523232,Staff,10,0,30,20
1715636215652,SIOC 290S,A01,637330,Merrifield; Mark A,21,0,30,9
1715636216863,SIOC 291S,A01,637333,Gabriel; Corey John,21,0,30,9
1715636218022,SOCI 117,A01,494376,Staff,0,5,5,5
1715636219255,WES 237B,A00,494380,Staff,10,0,20,10
1715636221663,AESE 279B,A00,494370,Wade; Jon P,0,0,33,33
1715636222824,AIP 97,001,660915,Van Den Einde; Yael Dahlia,9998,0,9999,1
1715636224211,AIP 197,001,627712,Vespa; Emanuel Ignacio,9995,0,9999,4
1715636224211,AIP 197,002,650778,Amir; On,9998,0,9999,1
1715636224211,AIP 197,003,650933,Avenancio-Leon; Carlos,9998,0,9999,1
1715636224211,AIP 197,004,658530,Heyman; Gail D.,9998,0,9999,1
1715636224211,AIP 197,005,658631,Neal; Sonya E,9998,0,9999,1
1715636224211,AIP 197,006,658671,Du; Songzi,9998,0,9999,1
1715636225336,ANAR 135S,A00,494369,Braswell; Geoffrey E.,0,0,0,0
1715636226499,BENG 196,001,628496,Engler; Adam J.,9998,0,9999,1
1715636226499,BENG 196,002,660916,Watson; John Thomas,9998,0,9999,1
1715636227630,BISP 197,001,650773,Wilhelm; James E.,9994,0,9999,5
1715636227630,BISP 197,002,658904,Coleman; Aaron B.,9998,0,9999,1
1715636228782,CAT 124RS,A01,519847,Geibel; William,0,0,20,20
1715636230145,CAT 125RS,A01,515971,Geibel; William,0,0,20,20
1715636231187,CLRE 250,A00,511389,Morris; Sheldon,9992,0,9999,7
1715636232323,CLRE 251,A00,507176,Mehta; Ravindra L.,9992,0,9999,7
1715636232323,CLRE 251,B00,511410,Mehta; Ravindra L.,9998,0,9999,1
1715636233401,CLRE 252,A00,507189,Cuomo; Raphael Eduardo,9994,0,9999,5
1715636234549,CLRE 253,A00,507199,Vaida; Florin,9994,0,9999,5
1715636234549,CLRE 253,B00,507202,Vaida; Florin,9999,0,9999,0
1715636235782,CLRE 259,A00,507211,Patel; Hemal,9996,0,9999,3
1715636236934,CLRE 260,A00,507221,Cuomo; Raphael Eduardo,9999,0,9999,0
1715636238031,CLRE 297,001,507242,Cuomo; Raphael Eduardo,9999,0,9999,0
1715636239175,COGS 197,001,638244,Voytek; Bradley Thomas,9997,0,9999,2
1715636240320,CSE 191,A00,516875,Minnes Kemp; Mor Mia,9991,0,9999,8
1715636241479,CSE 197,001,637388,Minnes Kemp; Mor Mia,9992,0,9999,7
1715636242594,CSS 201S,A01,494383,Mignozzetti; Umberto,35,0,35,0
1715636243882,CSS 202S,A01,494387,Mignozzetti; Umberto,35,0,35,0
1715636245037,DSC 197,001,628532,Eldridge; Justin Matthew,9995,0,9999,4
1715636246302,EAP 100,A00,516065,Staff,9799,0,9999,200
1715636247430,ECE 45,A01,507414,Staff,31,0,60,29
1715636249903,ECE 111,A01,507420,Staff,11,0,50,39
1715636250989,ECE 197,001,548057,Sievenpiper; Daniel F.,9991,0,9999,8
1715636252053,EDS 115,A00,507243,Choi; Bailey Miyeon,7,0,28,21
1715636253471,EDS 117,A01,494379,Staff,0,6,34,34
1715636254607,EDS 125,A00,507246,Hopkins; Megan Beth,8,0,30,22
1715636255690,EDS 128A,A01,507264,Fargason; Sharon Gayle,6,0,26,20
1715636256848,EDS 128B,A01,507293,Pappas; Elizabeth,10,0,30,20
1715636258081,EDS 139,A00,507294,Fargason; Sharon Gayle,10,0,30,20
1715636258081,EDS 139,B00,507313,Pappas; Elizabeth,11,0,30,19
1715636259163,EDS 201,A00,507315,Staff,10,0,30,20
1715636260360,EDS 203,A01,507317,Halter; Christopher P.,10,0,30,20
1715636261493,EDS 204R,A01,507319,Halter; Christopher P.,0,3,30,30
1715636261493,EDS 204R,B01,507331,Heinzman; Erica M.,14,0,30,16
1715636262691,EDS 206R,A00,507332,Staff,0,4,30,30
1715636262691,EDS 206R,B00,507343,Staff,15,0,30,15
1715636263793,EDS 250,A00,507344,Hemans; Patricia Ann Benitez,20,0,40,20
1715636265020,EDS 281,A00,507345,Daly; Alan J.,18,0,18,0
1715636266219,EDS 284,A00,507350,Daly; Alan J.,16,0,16,0
1715636267438,EDS 286,A00,507359,Fine; Sarah,18,0,18,0
1715636268648,EDS 289C,A01,507361,Daly; Alan J.,18,0,18,0
1715636269770,EDS 290,A00,507366,Hofstetter; Carolyn,15,0,15,0
1715636270862,LIGM 5A,A00,507421,Fischer-Grunski; Eva K,17,0,20,3
1715636272101,LIGM 5B,A00,507423,Fischer-Grunski; Eva K,19,0,20,1
1715636273265,LIGM 5C,A00,507425,Fischer-Grunski; Eva K,19,0,20,1
1715636274504,LIIT 5AS,A00,507427,Carnelos; Chiara,20,0,20,0
1715636275684,LIIT 5BS,A00,507430,Carnelos; Chiara,20,0,20,0
1715636276766,LIIT 5CS,A00,507432,Carnelos; Chiara,20,0,20,0
1715636277941,LISP 5A,A00,507541,Munoz Sanchez; Alicia,11,0,20,9
1715636279161,LISP 5B,A00,507671,Munoz Sanchez; Alicia,9,0,20,11
1715636280333,LISP 5C,A00,507696,Munoz Sanchez; Alicia,9,0,20,11
1715636281525,MAE 197,001,528363,Boechler; Nicholas Sebastia,9998,0,9999,1
1715636282760,MATH 197,001,523477,Kedlaya; Kiran S.,9994,0,9999,5
1715636282760,MATH 197,002,563811,Zhang; Danna,9994,0,9999,5
1715636282760,MATH 197,003,628552,Dumitriu; Ioana,9998,0,9999,1
1715636282760,MATH 197,004,660885,Floyd; Eric,9998,0,9999,1
1715636283987,MCWP 40R,A00,518780,Staff,2,0,20,18
1715636283987,MCWP 40R,B00,518781,Staff,10,0,20,10
1715636283987,MCWP 40R,C00,518783,Staff,5,0,20,15
1715636285128,MCWP 50R,A00,518791,Staff,0,1,20,20
1715636285128,MCWP 50R,B00,518792,Staff,0,2,20,20
1715636285128,MCWP 50R,C00,518793,Staff,0,4,20,20
1715636285128,MCWP 50R,D00,518794,Staff,0,1,20,20
1715636285128,MCWP 50R,E00,518795,Staff,0,2,20,20
1715636285128,MCWP 50R,F00,518796,Staff,0,1,20,20
1715636285128,MCWP 50R,G00,518797,Staff,0,1,20,20
1715636286421,MMW 12R,A01,514034,Herbst; Matthew,0,2,16,16
1715636286421,MMW 12R,A02,514035,Herbst; Matthew,0,0,16,16
1715636287605,MMW 13R,A01,514037,Staff,0,5,16,16
1715636287605,MMW 13R,A02,514039,Staff,0,5,16,16
1715636287605,MMW 13R,A03,628519,Staff,0,4,16,16
1715636289999,SIO 295LS,A00,523233,Staff,10,0,30,20
1715636291175,SIO 295S,A00,523232,Staff,10,0,30,20
1715636292287,SIOC 290S,A01,637330,Merrifield; Mark A,21,0,30,9
1715636293528,SIOC 291S,A01,637333,Gabriel; Corey John,21,0,30,9
1715636294648,SOCI 117,A01,494376,Staff,0,5,5,5
1715636295814,WES 237B,A00,494380,Staff,10,0,20,10
1715636298280,AESE 279B,A00,494370,Wade; Jon P,0,0,33,33
1715636299413,AIP 97,001,660915,Van Den Einde; Yael Dahlia,9998,0,9999,1
1715636300630,AIP 197,001,627712,Vespa; Emanuel Ignacio,9995,0,9999,4
1715636300630,AIP 197,002,650778,Amir; On,9998,0,9999,1
1715636300630,AIP 197,003,650933,Avenancio-Leon; Carlos,9998,0,9999,1
1715636300630,AIP 197,004,658530,Heyman; Gail D.,9998,0,9999,1
1715636300630,AIP 197,005,658631,Neal; Sonya E,9998,0,9999,1
1715636300630,AIP 197,006,658671,Du; Songzi,9998,0,9999,1
1715636301906,ANAR 135S,A00,494369,Braswell; Geoffrey E.,0,0,0,0
1715636303114,BENG 196,001,628496,Engler; Adam J.,9998,0,9999,1
1715636303114,BENG 196,002,660916,Watson; John Thomas,9998,0,9999,1
1715636304353,BISP 197,001,650773,Wilhelm; James E.,9994,0,9999,5
1715636304353,BISP 197,002,658904,Coleman; Aaron B.,9998,0,9999,1
1715636305588,CAT 124RS,A01,519847,Geibel; William,0,0,20,20
1715636306728,CAT 125RS,A01,515971,Geibel; William,0,0,20,20
1715636308205,CLRE 250,A00,511389,Morris; Sheldon,9992,0,9999,7
1715636309457,CLRE 251,A00,507176,Mehta; Ravindra L.,9992,0,9999,7
1715636309457,CLRE 251,B00,511410,Mehta; Ravindra L.,9998,0,9999,1
1715636311077,CLRE 252,A00,507189,Cuomo; Raphael Eduardo,9994,0,9999,5
1715636312153,CLRE 253,A00,507199,Vaida; Florin,9994,0,9999,5
1715636312153,CLRE 253,B00,507202,Vaida; Florin,9999,0,9999,0
1715636313390,CLRE 259,A00,507211,Patel; Hemal,9996,0,9999,3
1715636314606,CLRE 260,A00,507221,Cuomo; Raphael Eduardo,9999,0,9999,0
1715636315808,CLRE 297,001,507242,Cuomo; Raphael Eduardo,9999,0,9999,0
1715636317013,COGS 197,001,638244,Voytek; Bradley Thomas,9997,0,9999,2
1715636318216,CSE 191,A00,516875,Minnes Kemp; Mor Mia,9991,0,9999,8
1715636319311,CSE 197,001,637388,Minnes Kemp; Mor Mia,9992,0,9999,7
1715636320526,CSS 201S,A01,494383,Mignozzetti; Umberto,35,0,35,0
1715636321809,CSS 202S,A01,494387,Mignozzetti; Umberto,35,0,35,0
1715636323173,DSC 197,001,628532,Eldridge; Justin Matthew,9995,0,9999,4
1715636324256,EAP 100,A00,516065,Staff,9799,0,9999,200
1715636325372,ECE 45,A01,507414,Staff,31,0,60,29
1715636327896,ECE 111,A01,507420,Staff,11,0,50,39
1715636329101,ECE 197,001,548057,Sievenpiper; Daniel F.,9991,0,9999,8
1715636330225,EDS 115,A00,507243,Choi; Bailey Miyeon,7,0,28,21
1715636331661,EDS 117,A01,494379,Staff,0,6,34,34
1715636332794,EDS 125,A00,507246,Hopkins; Megan Beth,8,0,30,22
1715636333866,EDS 128A,A01,507264,Fargason; Sharon Gayle,6,0,26,20
1715636335201,EDS 128B,A01,507293,Pappas; Elizabeth,10,0,30,20
1715636336509,EDS 139,A00,507294,Fargason; Sharon Gayle,10,0,30,20
1715636336509,EDS 139,B00,507313,Pappas; Elizabeth,11,0,30,19
1715636337613,EDS 201,A00,507315,Staff,10,0,30,20
1715636338754,EDS 203,A01,507317,Halter; Christopher P.,10,0,30,20
1715636340028,EDS 204R,A01,507319,Halter; Christopher P.,0,3,30,30
1715636340028,EDS 204R,B01,507331,Heinzman; Erica M.,14,0,30,16
1715636341135,EDS 206R,A00,507332,Staff,0,4,30,30
1715636341135,EDS 206R,B00,507343,Staff,15,0,30,15
1715636342649,EDS 250,A00,507344,Hemans; Patricia Ann Benitez,20,0,40,20
1715636343961,EDS 281,A00,507345,Daly; Alan J.,18,0,18,0
1715636345068,EDS 284,A00,507350,Daly; Alan J.,16,0,16,0
1715636346276,EDS 286,A00,507359,Fine; Sarah,18,0,18,0
1715636347444,EDS 289C,A01,507361,Daly; Alan J.,18,0,18,0
1715636348551,EDS 290,A00,507366,Hofstetter; Carolyn,15,0,15,0
1715636349735,LIGM 5A,A00,507421,Fischer-Grunski; Eva K,17,0,20,3
1715636350834,LIGM 5B,A00,507423,Fischer-Grunski; Eva K,19,0,20,1
1715636352022,LIGM 5C,A00,507425,Fischer-Grunski; Eva K,19,0,20,1
1715636353223,LIIT 5AS,A00,507427,Carnelos; Chiara,20,0,20,0
1715636354334,LIIT 5BS,A00,507430,Carnelos; Chiara,20,0,20,0
1715636355603,LIIT 5CS,A00,507432,Carnelos; Chiara,20,0,20,0
1715636356774,LISP 5A,A00,507541,Munoz Sanchez; Alicia,11,0,20,9
1715636358016,LISP 5B,A00,507671,Munoz Sanchez; Alicia,9,0,20,11
1715636359228,LISP 5C,A00,507696,Munoz Sanchez; Alicia,9,0,20,11
1715636360386,MAE 197,001,528363,Boechler; Nicholas Sebastia,9998,0,9999,1
1715636361623,MATH 197,001,523477,Kedlaya; Kiran S.,9994,0,9999,5
1715636361623,MATH 197,002,563811,Zhang; Danna,9994,0,9999,5
1715636361623,MATH 197,003,628552,Dumitriu; Ioana,9998,0,9999,1
1715636361623,MATH 197,004,660885,Floyd; Eric,9998,0,9999,1
1715636362907,MCWP 40R,A00,518780,Staff,2,0,20,18
1715636362907,MCWP 40R,B00,518781,Staff,10,0,20,10
1715636362907,MCWP 40R,C00,518783,Staff,5,0,20,15
1715636363993,MCWP 50R,A00,518791,Staff,0,1,20,20
1715636363993,MCWP 50R,B00,518792,Staff,0,2,20,20
1715636363993,MCWP 50R,C00,518793,Staff,0,4,20,20
1715636363993,MCWP 50R,D00,518794,Staff,0,1,20,20
1715636363993,MCWP 50R,E00,518795,Staff,0,2,20,20
1715636363993,MCWP 50R,F00,518796,Staff,0,1,20,20
1715636363993,MCWP 50R,G00,518797,Staff,0,1,20,20
1715636365128,MMW 12R,A01,514034,Herbst; Matthew,0,2,16,16
1715636365128,MMW 12R,A02,514035,Herbst; Matthew,0,0,16,16
1715636366267,MMW 13R,A01,514037,Staff,0,5,16,16
1715636366267,MMW 13R,A02,514039,Staff,0,5,16,16
1715636366267,MMW 13R,A03,628519,Staff,0,4,16,16
1715636368603,SIO 295LS,A00,523233,Staff,10,0,30,20
1715636369707,SIO 295S,A00,523232,Staff,10,0,30,20
1715636370775,SIOC 290S,A01,637330,Merrifield; Mark A,21,0,30,9
1715636371959,SIOC 291S,A01,637333,Gabriel; Corey John,21,0,30,9
1715636373206,SOCI 117,A01,494376,Staff,0,5,5,5
1715636374324,WES 237B,A00,494380,Staff,10,0,20,10
1715636376677,AESE 279B,A00,494370,Wade; Jon P,0,0,33,33
1715636377903,AIP 97,001,660915,Van Den Einde; Yael Dahlia,9998,0,9999,1
1715636379168,AIP 197,001,627712,Vespa; Emanuel Ignacio,9995,0,9999,4
1715636379168,AIP 197,002,650778,Amir; On,9998,0,9999,1
1715636379168,AIP 197,003,650933,Avenancio-Leon; Carlos,9998,0,9999,1
1715636379168,AIP 197,004,658530,Heyman; Gail D.,9998,0,9999,1
1715636379168,AIP 197,005,658631,Neal; Sonya E,9998,0,9999,1
1715636379168,AIP 197,006,658671,Du; Songzi,9998,0,9999,1
1715636380310,ANAR 135S,A00,494369,Braswell; Geoffrey E.,0,0,0,0
1715636381529,BENG 196,001,628496,Engler; Adam J.,9998,0,9999,1
1715636381529,BENG 196,002,660916,Watson; John Thomas,9998,0,9999,1
1715636382886,BISP 197,001,650773,Wilhelm; James E.,9994,0,9999,5
1715636382886,BISP 197,002,658904,Coleman; Aaron B.,9998,0,9999,1
1715636384228,CAT 124RS,A01,519847,Geibel; William,0,0,20,20
1715636385343,CAT 125RS,A01,515971,Geibel; William,0,0,20,20
1715636386590,CLRE 250,A00,511389,Morris; Sheldon,9992,0,9999,7
1715636387828,CLRE 251,A00,507176,Mehta; Ravindra L.,9992,0,9999,7
1715636387828,CLRE 251,B00,511410,Mehta; Ravindra L.,9998,0,9999,1
1715636389021,CLRE 252,A00,507189,Cuomo; Raphael Eduardo,9994,0,9999,5
1715636390173,CLRE 253,A00,507199,Vaida; Florin,9994,0,9999,5
1715636390173,CLRE 253,B00,507202,Vaida; Florin,9999,0,9999,0
1715636391440,CLRE 259,A00,507211,Patel; Hemal,9996,0,9999,3
1715636392913,CLRE 260,A00,507221,Cuomo; Raphael Eduardo,9999,0,9999,0
1715636394160,CLRE 297,001,507242,Cuomo; Raphael Eduardo,9999,0,9999,0
1715636395526,COGS 197,001,638244,Voytek; Bradley Thomas,9997,0,9999,2
1715636396761,CSE 191,A00,516875,Minnes Kemp; Mor Mia,9991,0,9999,8
1715636397935,CSE 197,001,637388,Minnes Kemp; Mor Mia,9992,0,9999,7
1715636399186,CSS 201S,A01,494383,Mignozzetti; Umberto,35,0,35,0
1715636400385,CSS 202S,A01,494387,Mignozzetti; Umberto,35,0,35,0
1715636401643,DSC 197,001,628532,Eldridge; Justin Matthew,9995,0,9999,4
1715636404120,EAP 100,A00,516065,Staff,9799,0,9999,200
1715636405458,ECE 45,A01,507414,Staff,31,0,60,29
1715636407917,ECE 111,A01,507420,Staff,11,0,50,39
1715636409130,ECE 197,001,548057,Sievenpiper; Daniel F.,9991,0,9999,8
1715636410304,EDS 115,A00,507243,Choi; Bailey Miyeon,7,0,28,21
1715636411553,EDS 117,A01,494379,Staff,0,6,34,34
1715636412690,EDS 125,A00,507246,Hopkins; Megan Beth,8,0,30,22
1715636413865,EDS 128A,A01,507264,Fargason; Sharon Gayle,6,0,26,20
1715636415096,EDS 128B,A01,507293,Pappas; Elizabeth,10,0,30,20
1715636416265,EDS 139,A00,507294,Fargason; Sharon Gayle,10,0,30,20
1715636416265,EDS 139,B00,507313,Pappas; Elizabeth,11,0,30,19
1715636417352,EDS 201,A00,507315,Staff,10,0,30,20
1715636418557,EDS 203,A01,507317,Halter; Christopher P.,10,0,30,20
1715636419774,EDS 204R,A01,507319,Halter; Christopher P.,0,3,30,30
1715636419774,EDS 204R,B01,507331,Heinzman; Erica M.,14,0,30,16
1715636421051,EDS 206R,A00,507332,Staff,0,4,30,30
1715636421051,EDS 206R,B00,507343,Staff,15,0,30,15
1715636422233,EDS 250,A00,507344,Hemans; Patricia Ann Benitez,20,0,40,20
1715636423472,EDS 281,A00,507345,Daly; Alan J.,18,0,18,0
1715636424808,EDS 284,A00,507350,Daly; Alan J.,16,0,16,0
1715636425951,EDS 286,A00,507359,Fine; Sarah,18,0,18,0
1715636427052,EDS 289C,A01,507361,Daly; Alan J.,18,0,18,0
1715636428145,EDS 290,A00,507366,Hofstetter; Carolyn,15,0,15,0
1715636429615,LIGM 5A,A00,507421,Fischer-Grunski; Eva K,17,0,20,3
1715636430748,LIGM 5B,A00,507423,Fischer-Grunski; Eva K,19,0,20,1
1715636431849,LIGM 5C,A00,507425,Fischer-Grunski; Eva K,19,0,20,1
1715636432920,LIIT 5AS,A00,507427,Carnelos; Chiara,20,0,20,0
1715636434107,LIIT 5BS,A00,507430,Carnelos; Chiara,20,0,20,0
1715636435265,LIIT 5CS,A00,507432,Carnelos; Chiara,20,0,20,0
1715636436583,LISP 5A,A00,507541,Munoz Sanchez; Alicia,11,0,20,9
1715636437693,LISP 5B,A00,507671,Munoz Sanchez; Alicia,9,0,20,11
1715636438810,LISP 5C,A00,507696,Munoz Sanchez; Alicia,9,0,20,11
1715636439883,MAE 197,001,528363,Boechler; Nicholas Sebastia,9998,0,9999,1
1715636441071,MATH 197,001,523477,Kedlaya; Kiran S.,9994,0,9999,5
1715636441071,MATH 197,002,563811,Zhang; Danna,9994,0,9999,5
1715636441071,MATH 197,003,628552,Dumitriu; Ioana,9998,0,9999,1
1715636441071,MATH 197,004,660885,Floyd; Eric,9998,0,9999,1
1715636442183,MCWP 40R,A00,518780,Staff,2,0,20,18
1715636442183,MCWP 40R,B00,518781,Staff,10,0,20,10
1715636442183,MCWP 40R,C00,518783,Staff,5,0,20,15
1715636443361,MCWP 50R,A00,518791,Staff,0,1,20,20
1715636443361,MCWP 50R,B00,518792,Staff,0,2,20,20
1715636443361,MCWP 50R,C00,518793,Staff,0,4,20,20
1715636443361,MCWP 50R,D00,518794,Staff,0,1,20,20
1715636443361,MCWP 50R,E00,518795,Staff,0,2,20,20
1715636443361,MCWP 50R,F00,518796,Staff,0,1,20,20
1715636443361,MCWP 50R,G00,518797,Staff,0,1,20,20
1715636444476,MMW 12R,A01,514034,Herbst; Matthew,0,2,16,16
1715636444476,MMW 12R,A02,514035,Herbst; Matthew,0,0,16,16
1715636445725,MMW 13R,A01,514037,Staff,0,5,16,16
1715636445725,MMW 13R,A02,514039,Staff,0,5,16,16
1715636445725,MMW 13R,A03,628519,Staff,0,4,16,16
1715636448122,SIO 295LS,A00,523233,Staff,10,0,30,20
1715636449312,SIO 295S,A00,523232,Staff,10,0,30,20
1715636450436,SIOC 290S,A01,637330,Merrifield; Mark A,21,0,30,9
1715636451553,SIOC 291S,A01,637333,Gabriel; Corey John,21,0,30,9
1715636452803,SOCI 117,A01,494376,Staff,0,5,5,5
1715636454009,WES 237B,A00,494380,Staff,10,0,20,10
1715636456327,AESE 279B,A00,494370,Wade; Jon P,0,0,33,33
1715636457478,AIP 97,001,660915,Van Den Einde; Yael Dahlia,9998,0,9999,1
1715636458965,AIP 197,001,627712,Vespa; Emanuel Ignacio,9995,0,9999,4
1715636458965,AIP 197,002,650778,Amir; On,9998,0,9999,1
1715636458965,AIP 197,003,650933,Avenancio-Leon; Carlos,9998,0,9999,1
1715636458965,AIP 197,004,658530,Heyman; Gail D.,9998,0,9999,1
1715636458965,AIP 197,005,658631,Neal; Sonya E,9998,0,9999,1
1715636458965,AIP 197,006,658671,Du; Songzi,9998,0,9999,1
1715636460182,ANAR 135S,A00,494369,Braswell; Geoffrey E.,0,0,0,0
1715636461394,BENG 196,001,628496,Engler; Adam J.,9998,0,9999,1
1715636461394,BENG 196,002,660916,Watson; John Thomas,9998,0,9999,1
1715636462543,BISP 197,001,650773,Wilhelm; James E.,9994,0,9999,5
1715636462543,BISP 197,002,658904,Coleman; Aaron B.,9998,0,9999,1
1715636463646,CAT 124RS,A01,519847,Geibel; William,0,0,20,20
1715636464758,CAT 125RS,A01,515971,Geibel; William,0,0,20,20
1715636466026,CLRE 250,A00,511389,Morris; Sheldon,9992,0,9999,7
1715636467150,CLRE 251,A00,507176,Mehta; Ravindra L.,9992,0,9999,7
1715636467150,CLRE 251,B00,511410,Mehta; Ravindra L.,9998,0,9999,1
1715636468202,CLRE 252,A00,507189,Cuomo; Raphael Eduardo,9994,0,9999,5
1715636469403,CLRE 253,A00,507199,Vaida; Florin,9994,0,9999,5
1715636469403,CLRE 253,B00,507202,Vaida; Florin,9999,0,9999,0
1715636470550,CLRE 259,A00,507211,Patel; Hemal,9996,0,9999,3
1715636471736,CLRE 260,A00,507221,Cuomo; Raphael Eduardo,9999,0,9999,0
1715636472896,CLRE 297,001,507242,Cuomo; Raphael Eduardo,9999,0,9999,0
1715636474023,COGS 197,001,638244,Voytek; Bradley Thomas,9997,0,9999,2
1715636475166,CSE 191,A00,516875,Minnes Kemp; Mor Mia,9991,0,9999,8
1715636476296,CSE 197,001,637388,Minnes Kemp; Mor Mia,9992,0,9999,7
1715636477435,CSS 201S,A01,494383,Mignozzetti; Umberto,35,0,35,0
1715636478680,CSS 202S,A01,494387,Mignozzetti; Umberto,35,0,35,0
1715636479887,DSC 197,001,628532,Eldridge; Justin Matthew,9995,0,9999,4
1715636481072,EAP 100,A00,516065,Staff,9799,0,9999,200
1715636482220,ECE 45,A01,507414,Staff,31,0,60,29
1715636484629,ECE 111,A01,507420,Staff,11,0,50,39
1715636485857,ECE 197,001,548057,Sievenpiper; Daniel F.,9991,0,9999,8
1715636487048,EDS 115,A00,507243,Choi; Bailey Miyeon,7,0,28,21
1715636488167,EDS 117,A01,494379,Staff,0,6,34,34
1715636489411,EDS 125,A00,507246,Hopkins; Megan Beth,8,0,30,22
1715636490555,EDS 128A,A01,507264,Fargason; Sharon Gayle,6,0,26,20
1715636491757,EDS 128B,A01,507293,Pappas; Elizabeth,10,0,30,20
1715636492927,EDS 139,A00,507294,Fargason; Sharon Gayle,10,0,30,20
1715636492927,EDS 139,B00,507313,Pappas; Elizabeth,11,0,30,19
1715636493999,EDS 201,A00,507315,Staff,10,0,30,20
1715636495207,EDS 203,A01,507317,Halter; Christopher P.,10,0,30,20
1715636496349,EDS 204R,A01,507319,Halter; Christopher P.,0,3,30,30
1715636496349,EDS 204R,B01,507331,Heinzman; Erica M.,14,0,30,16
1715636497587,EDS 206R,A00,507332,Staff,0,4,30,30
1715636497587,EDS 206R,B00,507343,Staff,15,0,30,15
1715636498806,EDS 250,A00,507344,Hemans; Patricia Ann Benitez,20,0,40,20
1715636500024,EDS 281,A00,507345,Daly; Alan J.,18,0,18,0
1715636501160,EDS 284,A00,507350,Daly; Alan J.,16,0,16,0
1715636502308,EDS 286,A00,507359,Fine; Sarah,18,0,18,0
1715636503419,EDS 289C,A01,507361,Daly; Alan J.,18,0,18,0
1715636504674,EDS 290,A00,507366,Hofstetter; Carolyn,15,0,15,0
1715636505813,LIGM 5A,A00,507421,Fischer-Grunski; Eva K,17,0,20,3
1715636507137,LIGM 5B,A00,507423,Fischer-Grunski; Eva K,19,0,20,1
1715636508445,LIGM 5C,A00,507425,Fischer-Grunski; Eva K,19,0,20,1
1715636509799,LIIT 5AS,A00,507427,Carnelos; Chiara,20,0,20,0
1715636511310,LIIT 5BS,A00,507430,Carnelos; Chiara,20,0,20,0
1715636512666,LIIT 5CS,A00,507432,Carnelos; Chiara,20,0,20,0
1715636513792,LISP 5A,A00,507541,Munoz Sanchez; Alicia,11,0,20,9
1715636515124,LISP 5B,A00,507671,Munoz Sanchez; Alicia,9,0,20,11
1715636516312,LISP 5C,A00,507696,Munoz Sanchez; Alicia,9,0,20,11
1715636517464,MAE 197,001,528363,Boechler; Nicholas Sebastia,9998,0,9999,1
1715636518645,MATH 197,001,523477,Kedlaya; Kiran S.,9994,0,9999,5
1715636518645,MATH 197,002,563811,Zhang; Danna,9994,0,9999,5
1715636518645,MATH 197,003,628552,Dumitriu; Ioana,9998,0,9999,1
1715636518645,MATH 197,004,660885,Floyd; Eric,9998,0,9999,1
1715636519721,MCWP 40R,A00,518780,Staff,2,0,20,18
1715636519721,MCWP 40R,B00,518781,Staff,10,0,20,10
1715636519721,MCWP 40R,C00,518783,Staff,5,0,20,15
1715636520777,MCWP 50R,A00,518791,Staff,0,1,20,20
1715636520777,MCWP 50R,B00,518792,Staff,0,2,20,20
1715636520777,MCWP 50R,C00,518793,Staff,0,4,20,20
1715636520777,MCWP 50R,D00,518794,Staff,0,1,20,20
1715636520777,MCWP 50R,E00,518795,Staff,0,2,20,20
1715636520777,MCWP 50R,F00,518796,Staff,0,1,20,20
1715636520777,MCWP 50R,G00,518797,Staff,0,1,20,20
1715636521829,MMW 12R,A01,514034,Herbst; Matthew,0,2,16,16
1715636521829,MMW 12R,A02,514035,Herbst; Matthew,0,0,16,16
1715636522944,MMW 13R,A01,514037,Staff,0,5,16,16
1715636522944,MMW 13R,A02,514039,Staff,0,5,16,16
1715636522944,MMW 13R,A03,628519,Staff,0,4,16,16
1715636525365,SIO 295LS,A00,523233,Staff,10,0,30,20
1715636526478,SIO 295S,A00,523232,Staff,10,0,30,20
1715636527752,SIOC 290S,A01,637330,Merrifield; Mark A,21,0,30,9
1715636528846,SIOC 291S,A01,637333,Gabriel; Corey John,21,0,30,9
1715636529943,SOCI 117,A01,494376,Staff,0,5,5,5
1715636531105,WES 237B,A00,494380,Staff,10,0,20,10
1715636533373,AESE 279B,A00,494370,Wade; Jon P,0,0,33,33
1715636534541,AIP 97,001,660915,Van Den Einde; Yael Dahlia,9998,0,9999,1
1715636536025,AIP 197,001,627712,Vespa; Emanuel Ignacio,9995,0,9999,4
1715636536025,AIP 197,002,650778,Amir; On,9998,0,9999,1
1715636536025,AIP 197,003,650933,Avenancio-Leon; Carlos,9998,0,9999,1
1715636536025,AIP 197,004,658530,Heyman; Gail D.,9998,0,9999,1
1715636536025,AIP 197,005,658631,Neal; Sonya E,9998,0,9999,1
1715636536025,AIP 197,006,658671,Du; Songzi,9998,0,9999,1
1715636537085,ANAR 135S,A00,494369,Braswell; Geoffrey E.,0,0,0,0
1715636538286,BENG 196,001,628496,Engler; Adam J.,9998,0,9999,1
1715636538286,BENG 196,002,660916,Watson; John Thomas,9998,0,9999,1
1715636539486,BISP 197,001,650773,Wilhelm; James E.,9994,0,9999,5
1715636539486,BISP 197,002,658904,Coleman; Aaron B.,9998,0,9999,1
1715636540733,CAT 124RS,A01,519847,Geibel; William,0,0,20,20
1715636542005,CAT 125RS,A01,515971,Geibel; William,0,0,20,20
1715636543299,CLRE 250,A00,511389,Morris; Sheldon,9992,0,9999,7
1715636544339,CLRE 251,A00,507176,Mehta; Ravindra L.,9992,0,9999,7
1715636544339,CLRE 251,B00,511410,Mehta; Ravindra L.,9998,0,9999,1
1715636545505,CLRE 252,A00,507189,Cuomo; Raphael Eduardo,9994,0,9999,5
1715636546820,CLRE 253,A00,507199,Vaida; Florin,9994,0,9999,5
1715636546820,CLRE 253,B00,507202,Vaida; Florin,9999,0,9999,0
1715636547893,CLRE 259,A00,507211,Patel; Hemal,9996,0,9999,3
1715636549121,CLRE 260,A00,507221,Cuomo; Raphael Eduardo,9999,0,9999,0
1715636550591,CLRE 297,001,507242,Cuomo; Raphael Eduardo,9999,0,9999,0
1715636551859,COGS 197,001,638244,Voytek; Bradley Thomas,9997,0,9999,2
1715636552959,CSE 191,A00,516875,Minnes Kemp; Mor Mia,9991,0,9999,8
1715636554222,CSE 197,001,637388,Minnes Kemp; Mor Mia,9992,0,9999,7
1715636555478,CSS 201S,A01,494383,Mignozzetti; Umberto,35,0,35,0
1715636556580,CSS 202S,A01,494387,Mignozzetti; Umberto,35,0,35,0
1715636557832,DSC 197,001,628532,Eldridge; Justin Matthew,9995,0,9999,4
1715636559045,EAP 100,A00,516065,Staff,9799,0,9999,200
1715636560370,ECE 45,A01,507414,Staff,31,0,60,29
1715636562937,ECE 111,A01,507420,Staff,11,0,50,39
1715636564205,ECE 197,001,548057,Sievenpiper; Daniel F.,9991,0,9999,8
1715636565423,EDS 115,A00,507243,Choi; Bailey Miyeon,7,0,28,21
1715636566537,EDS 117,A01,494379,Staff,0,6,34,34
1715636567802,EDS 125,A00,507246,Hopkins; Megan Beth,8,0,30,22
1715636569009,EDS 128A,A01,507264,Fargason; Sharon Gayle,6,0,26,20
1715636570399,EDS 128B,A01,507293,Pappas; Elizabeth,10,0,30,20
1715636571572,EDS 139,A00,507294,Fargason; Sharon Gayle,10,0,30,20
1715636571572,EDS 139,B00,507313,Pappas; Elizabeth,11,0,30,19
1715636572812,EDS 201,A00,507315,Staff,10,0,30,20
1715636574174,EDS 203,A01,507317,Halter; Christopher P.,10,0,30,20
1715636575379,EDS 204R,A01,507319,Halter; Christopher P.,0,3,30,30
1715636575379,EDS 204R,B01,507331,Heinzman; Erica M.,14,0,30,16
1715636576727,EDS 206R,A00,507332,Staff,0,4,30,30
1715636576727,EDS 206R,B00,507343,Staff,15,0,30,15
1715636577954,EDS 250,A00,507344,Hemans; Patricia Ann Benitez,20,0,40,20
1715636579317,EDS 281,A00,507345,Daly; Alan J.,18,0,18,0
1715636580497,EDS 284,A00,507350,Daly; Alan J.,16,0,16,0
1715636581592,EDS 286,A00,507359,Fine; Sarah,18,0,18,0
1715636582877,EDS 289C,A01,507361,Daly; Alan J.,18,0,18,0
1715636584064,EDS 290,A00,507366,Hofstetter; Carolyn,15,0,15,0
1715636585202,LIGM 5A,A00,507421,Fischer-Grunski; Eva K,17,0,20,3
1715636586606,LIGM 5B,A00,507423,Fischer-Grunski; Eva K,19,0,20,1
1715636587642,LIGM 5C,A00,507425,Fischer-Grunski; Eva K,19,0,20,1
1715636588764,LIIT 5AS,A00,507427,Carnelos; Chiara,20,0,20,0
1715636589923,LIIT 5BS,A00,507430,Carnelos; Chiara,20,0,20,0
1715636591206,LIIT 5CS,A00,507432,Carnelos; Chiara,20,0,20,0
1715636592621,LISP 5A,A00,507541,Munoz Sanchez; Alicia,11,0,20,9
1715636593789,LISP 5B,A00,507671,Munoz Sanchez; Alicia,9,0,20,11
1715636594912,LISP 5C,A00,507696,Munoz Sanchez; Alicia,9,0,20,11
1715636596171,MAE 197,001,528363,Boechler; Nicholas Sebastia,9998,0,9999,1
1715636597310,MATH 197,001,523477,Kedlaya; Kiran S.,9994,0,9999,5
1715636597310,MATH 197,002,563811,Zhang; Danna,9994,0,9999,5
1715636597310,MATH 197,003,628552,Dumitriu; Ioana,9998,0,9999,1
1715636597310,MATH 197,004,660885,Floyd; Eric,9998,0,9999,1
1715636598747,MCWP 40R,A00,518780,Staff,2,0,20,18
1715636598747,MCWP 40R,B00,518781,Staff,10,0,20,10
1715636598747,MCWP 40R,C00,518783,Staff,5,0,20,15
1715636599885,MCWP 50R,A00,518791,Staff,0,1,20,20
1715636599885,MCWP 50R,B00,518792,Staff,0,2,20,20
1715636599885,MCWP 50R,C00,518793,Staff,0,4,20,20
1715636599885,MCWP 50R,D00,518794,Staff,0,1,20,20
1715636599885,MCWP 50R,E00,518795,Staff,0,2,20,20
1715636599885,MCWP 50R,F00,518796,Staff,0,1,20,20
1715636599885,MCWP 50R,G00,518797,Staff,0,1,20,20
1715636600997,MMW 12R,A01,514034,Herbst; Matthew,0,2,16,16
1715636600997,MMW 12R,A02,514035,Herbst; Matthew,0,0,16,16
1715636602169,MMW 13R,A01,514037,Staff,0,5,16,16
1715636602169,MMW 13R,A02,514039,Staff,0,5,16,16
1715636602169,MMW 13R,A03,628519,Staff,0,4,16,16
1715636604484,SIO 295LS,A00,523233,Staff,10,0,30,20
1715636605714,SIO 295S,A00,523232,Staff,10,0,30,20
1715636606914,SIOC 290S,A01,637330,Merrifield; Mark A,21,0,30,9
1715636608180,SIOC 291S,A01,637333,Gabriel; Corey John,21,0,30,9
1715636609295,SOCI 117,A01,494376,Staff,0,5,5,5
1715636610425,WES 237B,A00,494380,Staff,10,0,20,10
1715636612979,AESE 279B,A00,494370,Wade; Jon P,0,0,33,33
1715636614173,AIP 97,001,660915,Van Den Einde; Yael Dahlia,9998,0,9999,1
1715636615318,AIP 197,001,627712,Vespa; Emanuel Ignacio,9995,0,9999,4
1715636615318,AIP 197,002,650778,Amir; On,9998,0,9999,1
1715636615318,AIP 197,003,650933,Avenancio-Leon; Carlos,9998,0,9999,1
1715636615318,AIP 197,004,658530,Heyman; Gail D.,9998,0,9999,1
1715636615318,AIP 197,005,658631,Neal; Sonya E,9998,0,9999,1
1715636615318,AIP 197,006,658671,Du; Songzi,9998,0,9999,1
1715636616599,ANAR 135S,A00,494369,Braswell; Geoffrey E.,0,0,0,0
1715636617691,BENG 196,001,628496,Engler; Adam J.,9998,0,9999,1
1715636617691,BENG 196,002,660916,Watson; John Thomas,9998,0,9999,1
1715636618778,BISP 197,001,650773,Wilhelm; James E.,9994,0,9999,5
1715636618778,BISP 197,002,658904,Coleman; Aaron B.,9998,0,9999,1
1715636619983,CAT 124RS,A01,519847,Geibel; William,0,0,20,20
1715636621117,CAT 125RS,A01,515971,Geibel; William,0,0,20,20
1715636622281,CLRE 250,A00,511389,Morris; Sheldon,9992,0,9999,7
1715636623677,CLRE 251,A00,507176,Mehta; Ravindra L.,9992,0,9999,7
1715636623677,CLRE 251,B00,511410,Mehta; Ravindra L.,9998,0,9999,1
1715636624721,CLRE 252,A00,507189,Cuomo; Raphael Eduardo,9994,0,9999,5
1715636625823,CLRE 253,A00,507199,Vaida; Florin,9994,0,9999,5
1715636625823,CLRE 253,B00,507202,Vaida; Florin,9999,0,9999,0
1715636626913,CLRE 259,A00,507211,Patel; Hemal,9996,0,9999,3
1715636628111,CLRE 260,A00,507221,Cuomo; Raphael Eduardo,9999,0,9999,0
1715636629238,CLRE 297,001,507242,Cuomo; Raphael Eduardo,9999,0,9999,0
1715636630423,COGS 197,001,638244,Voytek; Bradley Thomas,9997,0,9999,2
1715636631699,CSE 191,A00,516875,Minnes Kemp; Mor Mia,9991,0,9999,8
1715636633014,CSE 197,001,637388,Minnes Kemp; Mor Mia,9992,0,9999,7
1715636634100,CSS 201S,A01,494383,Mignozzetti; Umberto,35,0,35,0
1715636635224,CSS 202S,A01,494387,Mignozzetti; Umberto,35,0,35,0
1715636636536,DSC 197,001,628532,Eldridge; Justin Matthew,9995,0,9999,4
1715636637720,EAP 100,A00,516065,Staff,9799,0,9999,200
1715636638912,ECE 45,A01,507414,Staff,31,0,60,29
1715636641409,ECE 111,A01,507420,Staff,11,0,50,39
1715636642732,ECE 197,001,548057,Sievenpiper; Daniel F.,9991,0,9999,8
1715636643777,EDS 115,A00,507243,Choi; Bailey Miyeon,7,0,28,21
1715636644870,EDS 117,A01,494379,Staff,0,6,34,34
1715636646080,EDS 125,A00,507246,Hopkins; Megan Beth,8,0,30,22
1715636647315,EDS 128A,A01,507264,Fargason; Sharon Gayle,6,0,26,20
1715636648479,EDS 128B,A01,507293,Pappas; Elizabeth,10,0,30,20
1715636649804,EDS 139,A00,507294,Fargason; Sharon Gayle,10,0,30,20
1715636649804,EDS 139,B00,507313,Pappas; Elizabeth,11,0,30,19
1715636650977,EDS 201,A00,507315,Staff,10,0,30,20
1715636652073,EDS 203,A01,507317,Halter; Christopher P.,10,0,30,20
1715636653162,EDS 204R,A01,507319,Halter; Christopher P.,0,3,30,30
1715636653162,EDS 204R,B01,507331,Heinzman; Erica M.,14,0,30,16
1715636654345,EDS 206R,A00,507332,Staff,0,4,30,30
1715636654345,EDS 206R,B00,507343,Staff,15,0,30,15
1715636655497,EDS 250,A00,507344,Hemans; Patricia Ann Benitez,20,0,40,20
1715636656639,EDS 281,A00,507345,Daly; Alan J.,18,0,18,0
1715636657893,EDS 284,A00,507350,Daly; Alan J.,16,0,16,0
1715636659122,EDS 286,A00,507359,Fine; Sarah,18,0,18,0
1715636660393,EDS 289C,A01,507361,Daly; Alan J.,18,0,18,0
1715636661652,EDS 290,A00,507366,Hofstetter; Carolyn,15,0,15,0
1715636662789,LIGM 5A,A00,507421,Fischer-Grunski; Eva K,17,0,20,3
1715636664057,LIGM 5B,A00,507423,Fischer-Grunski; Eva K,19,0,20,1
1715636665267,LIGM 5C,A00,507425,Fischer-Grunski; Eva K,19,0,20,1
1715636666472,LIIT 5AS,A00,507427,Carnelos; Chiara,20,0,20,0
1715636667801,LIIT 5BS,A00,507430,Carnelos; Chiara,20,0,20,0
1715636668938,LIIT 5CS,A00,507432,Carnelos; Chiara,20,0,20,0
1715636670093,LISP 5A,A00,507541,Munoz Sanchez; Alicia,11,0,20,9
1715636671335,LISP 5B,A00,507671,Munoz Sanchez; Alicia,9,0,20,11
1715636672537,LISP 5C,A00,507696,Munoz Sanchez; Alicia,9,0,20,11
1715636673812,MAE 197,001,528363,Boechler; Nicholas Sebastia,9998,0,9999,1
1715636674957,MATH 197,001,523477,Kedlaya; Kiran S.,9994,0,9999,5
1715636674957,MATH 197,002,563811,Zhang; Danna,9994,0,9999,5
1715636674957,MATH 197,003,628552,Dumitriu; Ioana,9998,0,9999,1
1715636674957,MATH 197,004,660885,Floyd; Eric,9998,0,9999,1
1715636676021,MCWP 40R,A00,518780,Staff,2,0,20,18
1715636676021,MCWP 40R,B00,518781,Staff,10,0,20,10
1715636676021,MCWP 40R,C00,518783,Staff,5,0,20,15
1715636677292,MCWP 50R,A00,518791,Staff,0,1,20,20
1715636677292,MCWP 50R,B00,518792,Staff,0,2,20,20
1715636677292,MCWP 50R,C00,518793,Staff,0,4,20,20
1715636677292,MCWP 50R,D00,518794,Staff,0,1,20,20
1715636677292,MCWP 50R,E00,518795,Staff,0,2,20,20
1715636677292,MCWP 50R,F00,518796,Staff,0,1,20,20
1715636677292,MCWP 50R,G00,518797,Staff,0,1,20,20
1715636678519,MMW 12R,A01,514034,Herbst; Matthew,0,2,16,16
1715636678519,MMW 12R,A02,514035,Herbst; Matthew,0,0,16,16
1715636679741,MMW 13R,A01,514037,Staff,0,5,16,16
1715636679741,MMW 13R,A02,514039,Staff,0,5,16,16
1715636679741,MMW 13R,A03,628519,Staff,0,4,16,16
1715636682083,SIO 295LS,A00,523233,Staff,10,0,30,20
1715636683271,SIO 295S,A00,523232,Staff,10,0,30,20
1715636684507,SIOC 290S,A01,637330,Merrifield; Mark A,21,0,30,9
1715636685708,SIOC 291S,A01,637333,Gabriel; Corey John,21,0,30,9
1715636686823,SOCI 117,A01,494376,Staff,0,5,5,5
1715636688330,WES 237B,A00,494380,Staff,10,0,20,10
1715636690874,AESE 279B,A00,494370,Wade; Jon P,0,0,33,33
1715636692031,AIP 97,001,660915,Van Den Einde; Yael Dahlia,9998,0,9999,1
1715636693121,AIP 197,001,627712,Vespa; Emanuel Ignacio,9995,0,9999,4
1715636693121,AIP 197,002,650778,Amir; On,9998,0,9999,1
1715636693121,AIP 197,003,650933,Avenancio-Leon; Carlos,9998,0,9999,1
1715636693121,AIP 197,004,658530,Heyman; Gail D.,9998,0,9999,1
1715636693121,AIP 197,005,658631,Neal; Sonya E,9998,0,9999,1
1715636693121,AIP 197,006,658671,Du; Songzi,9998,0,9999,1
1715636694293,ANAR 135S,A00,494369,Braswell; Geoffrey E.,0,0,0,0
1715636695456,BENG 196,001,628496,Engler; Adam J.,9998,0,9999,1
1715636695456,BENG 196,002,660916,Watson; John Thomas,9998,0,9999,1
1715636696777,BISP 197,001,650773,Wilhelm; James E.,9994,0,9999,5
1715636696777,BISP 197,002,658904,Coleman; Aaron B.,9998,0,9999,1
1715636697885,CAT 124RS,A01,519847,Geibel; William,0,0,20,20
1715636699037,CAT 125RS,A01,515971,Geibel; William,0,0,20,20
1715636700176,CLRE 250,A00,511389,Morris; Sheldon,9992,0,9999,7
1715636701312,CLRE 251,A00,507176,Mehta; Ravindra L.,9992,0,9999,7
1715636701312,CLRE 251,B00,511410,Mehta; Ravindra L.,9998,0,9999,1
1715636703304,CLRE 252,A00,507189,Cuomo; Raphael Eduardo,9994,0,9999,5
1715636704470,CLRE 253,A00,507199,Vaida; Florin,9994,0,9999,5
1715636704470,CLRE 253,B00,507202,Vaida; Florin,9999,0,9999,0
1715636705633,CLRE 259,A00,507211,Patel; Hemal,9996,0,9999,3
1715636706871,CLRE 260,A00,507221,Cuomo; Raphael Eduardo,9999,0,9999,0
1715636708016,CLRE 297,001,507242,Cuomo; Raphael Eduardo,9999,0,9999,0
1715636709118,COGS 197,001,638244,Voytek; Bradley Thomas,9997,0,9999,2
1715636710293,CSE 191,A00,516875,Minnes Kemp; Mor Mia,9991,0,9999,8
1715636711444,CSE 197,001,637388,Minnes Kemp; Mor Mia,9992,0,9999,7
1715636712635,CSS 201S,A01,494383,Mignozzetti; Umberto,35,0,35,0
1715636713780,CSS 202S,A01,494387,Mignozzetti; Umberto,35,0,35,0
1715636715043,DSC 197,001,628532,Eldridge; Justin Matthew,9995,0,9999,4
1715636716444,EAP 100,A00,516065,Staff,9799,0,9999,200
1715636717670,ECE 45,A01,507414,Staff,31,0,60,29
1715636719855,ECE 111,A01,507420,Staff,11,0,50,39
1715636721136,ECE 197,001,548057,Sievenpiper; Daniel F.,9991,0,9999,8
1715636722306,EDS 115,A00,507243,Choi; Bailey Miyeon,7,0,28,21
1715636723468,EDS 117,A01,494379,Staff,0,6,34,34
1715636724595,EDS 125,A00,507246,Hopkins; Megan Beth,8,0,30,22
1715636725822,EDS 128A,A01,507264,Fargason; Sharon Gayle,6,0,26,20
1715636726961,EDS 128B,A01,507293,Pappas; Elizabeth,10,0,30,20
1715636728092,EDS 139,A00,507294,Fargason; Sharon Gayle,10,0,30,20
1715636728092,EDS 139,B00,507313,Pappas; Elizabeth,11,0,30,19
1715636729248,EDS 201,A00,507315,Staff,10,0,30,20
1715636730394,EDS 203,A01,507317,Halter; Christopher P.,10,0,30,20
1715636731526,EDS 204R,A01,507319,Halter; Christopher P.,0,3,30,30
1715636731526,EDS 204R,B01,507331,Heinzman; Erica M.,14,0,30,16
1715636732711,EDS 206R,A00,507332,Staff,0,4,30,30
1715636732711,EDS 206R,B00,507343,Staff,15,0,30,15
1715636734011,EDS 250,A00,507344,Hemans; Patricia Ann Benitez,20,0,40,20
1715636735267,EDS 281,A00,507345,Daly; Alan J.,18,0,18,0
1715636736534,EDS 284,A00,507350,Daly; Alan J.,16,0,16,0
1715636737715,EDS 286,A00,507359,Fine; Sarah,18,0,18,0
1715636738899,EDS 289C,A01,507361,Daly; Alan J.,18,0,18,0
1715636740087,EDS 290,A00,507366,Hofstetter; Carolyn,15,0,15,0
1715636741339,LIGM 5A,A00,507421,Fischer-Grunski; Eva K,17,0,20,3
1715636742567,LIGM 5B,A00,507423,Fischer-Grunski; Eva K,19,0,20,1
1715636743781,LIGM 5C,A00,507425,Fischer-Grunski; Eva K,19,0,20,1
1715636745010,LIIT 5AS,A00,507427,Carnelos; Chiara,20,0,20,0
1715636746204,LIIT 5BS,A00,507430,Carnelos; Chiara,20,0,20,0
1715636747395,LIIT 5CS,A00,507432,Carnelos; Chiara,20,0,20,0
1715636748626,LISP 5A,A00,507541,Munoz Sanchez; Alicia,11,0,20,9
1715636749786,LISP 5B,A00,507671,Munoz Sanchez; Alicia,9,0,20,11
1715636750923,LISP 5C,A00,507696,Munoz Sanchez; Alicia,9,0,20,11
1715636752219,MAE 197,001,528363,Boechler; Nicholas Sebastia,9998,0,9999,1
1715636753416,MATH 197,001,523477,Kedlaya; Kiran S.,9994,0,9999,5
1715636753416,MATH 197,002,563811,Zhang; Danna,9994,0,9999,5
1715636753416,MATH 197,003,628552,Dumitriu; Ioana,9998,0,9999,1
1715636753416,MATH 197,004,660885,Floyd; Eric,9998,0,9999,1
1715636754586,MCWP 40R,A00,518780,Staff,2,0,20,18
1715636754586,MCWP 40R,B00,518781,Staff,10,0,20,10
1715636754586,MCWP 40R,C00,518783,Staff,5,0,20,15
1715636756085,MCWP 50R,A00,518791,Staff,0,1,20,20
1715636756085,MCWP 50R,B00,518792,Staff,0,2,20,20
1715636756085,MCWP 50R,C00,518793,Staff,0,4,20,20
1715636756085,MCWP 50R,D00,518794,Staff,0,1,20,20
1715636756085,MCWP 50R,E00,518795,Staff,0,2,20,20
1715636756085,MCWP 50R,F00,518796,Staff,0,1,20,20
1715636756085,MCWP 50R,G00,518797,Staff,0,1,20,20
1715636757214,MMW 12R,A01,514034,Herbst; Matthew,0,2,16,16
1715636757214,MMW 12R,A02,514035,Herbst; Matthew,0,0,16,16
1715636758390,MMW 13R,A01,514037,Staff,0,5,16,16
1715636758390,MMW 13R,A02,514039,Staff,0,5,16,16
1715636758390,MMW 13R,A03,628519,Staff,0,4,16,16
1715636760761,SIO 295LS,A00,523233,Staff,10,0,30,20
1715636761911,SIO 295S,A00,523232,Staff,10,0,30,20
1715636763448,SIOC 290S,A01,637330,Merrifield; Mark A,21,0,30,9
1715636764685,SIOC 291S,A01,637333,Gabriel; Corey John,21,0,30,9
1715636765805,SOCI 117,A01,494376,Staff,0,5,5,5
1715636767441,WES 237B,A00,494380,Staff,10,0,20,10
1715636769867,AESE 279B,A00,494370,Wade; Jon P,0,0,33,33
1715636771207,AIP 97,001,660915,Van Den Einde; Yael Dahlia,9998,0,9999,1
1715636772341,AIP 197,001,627712,Vespa; Emanuel Ignacio,9995,0,9999,4
1715636772341,AIP 197,002,650778,Amir; On,9998,0,9999,1
1715636772341,AIP 197,003,650933,Avenancio-Leon; Carlos,9998,0,9999,1
1715636772341,AIP 197,004,658530,Heyman; Gail D.,9998,0,9999,1
1715636772341,AIP 197,005,658631,Neal; Sonya E,9998,0,9999,1
1715636772341,AIP 197,006,658671,Du; Songzi,9998,0,9999,1
1715636773515,ANAR 135S,A00,494369,Braswell; Geoffrey E.,0,0,0,0
1715636774701,BENG 196,001,628496,Engler; Adam J.,9998,0,9999,1
1715636774701,BENG 196,002,660916,Watson; John Thomas,9998,0,9999,1
1715636775912,BISP 197,001,650773,Wilhelm; James E.,9994,0,9999,5
1715636775912,BISP 197,002,658904,Coleman; Aaron B.,9998,0,9999,1
1715636777120,CAT 124RS,A01,519847,Geibel; William,0,0,20,20
1715636778263,CAT 125RS,A01,515971,Geibel; William,0,0,20,20
1715636779516,CLRE 250,A00,511389,Morris; Sheldon,9992,0,9999,7
1715636780686,CLRE 251,A00,507176,Mehta; Ravindra L.,9992,0,9999,7
1715636780686,CLRE 251,B00,511410,Mehta; Ravindra L.,9998,0,9999,1
1715636781833,CLRE 252,A00,507189,Cuomo; Raphael Eduardo,9994,0,9999,5
1715636782987,CLRE 253,A00,507199,Vaida; Florin,9994,0,9999,5
1715636782987,CLRE 253,B00,507202,Vaida; Florin,9999,0,9999,0
1715636784138,CLRE 259,A00,507211,Patel; Hemal,9996,0,9999,3
1715636785298,CLRE 260,A00,507221,Cuomo; Raphael Eduardo,9999,0,9999,0
1715636786437,CLRE 297,001,507242,Cuomo; Raphael Eduardo,9999,0,9999,0
1715636787514,COGS 197,001,638244,Voytek; Bradley Thomas,9997,0,9999,2
1715636788679,CSE 191,A00,516875,Minnes Kemp; Mor Mia,9991,0,9999,8
1715636789942,CSE 197,001,637388,Minnes Kemp; Mor Mia,9992,0,9999,7
1715636791096,CSS 201S,A01,494383,Mignozzetti; Umberto,35,0,35,0
1715636792135,CSS 202S,A01,494387,Mignozzetti; Umberto,35,0,35,0
1715636793233,DSC 197,001,628532,Eldridge; Justin Matthew,9995,0,9999,4
1715636794264,EAP 100,A00,516065,Staff,9799,0,9999,200
1715636795301,ECE 45,A01,507414,Staff,31,0,60,29
1715636797624,ECE 111,A01,507420,Staff,11,0,50,39
1715636798783,ECE 197,001,548057,Sievenpiper; Daniel F.,9991,0,9999,8
1715636800008,EDS 115,A00,507243,Choi; Bailey Miyeon,7,0,28,21
1715636801245,EDS 117,A01,494379,Staff,0,6,34,34
1715636802349,EDS 125,A00,507246,Hopkins; Megan Beth,8,0,30,22
1715636803578,EDS 128A,A01,507264,Fargason; Sharon Gayle,6,0,26,20
1715636804735,EDS 128B,A01,507293,Pappas; Elizabeth,10,0,30,20
1715636805865,EDS 139,A00,507294,Fargason; Sharon Gayle,10,0,30,20
1715636805865,EDS 139,B00,507313,Pappas; Elizabeth,11,0,30,19
1715636807032,EDS 201,A00,507315,Staff,10,0,30,20
1715636808130,EDS 203,A01,507317,Halter; Christopher P.,10,0,30,20
1715636809299,EDS 204R,A01,507319,Halter; Christopher P.,0,3,30,30
1715636809299,EDS 204R,B01,507331,Heinzman; Erica M.,14,0,30,16
1715636810431,EDS 206R,A00,507332,Staff,0,4,30,30
1715636810431,EDS 206R,B00,507343,Staff,15,0,30,15
1715636811550,EDS 250,A00,507344,Hemans; Patricia Ann Benitez,20,0,40,20
1715636812697,EDS 281,A00,507345,Daly; Alan J.,18,0,18,0
1715636813872,EDS 284,A00,507350,Daly; Alan J.,16,0,16,0
1715636814945,EDS 286,A00,507359,Fine; Sarah,18,0,18,0
1715636816158,EDS 289C,A01,507361,Daly; Alan J.,18,0,18,0
1715636817354,EDS 290,A00,507366,Hofstetter; Carolyn,15,0,15,0
1715636818518,LIGM 5A,A00,507421,Fischer-Grunski; Eva K,17,0,20,3
1715636819673,LIGM 5B,A00,507423,Fischer-Grunski; Eva K,19,0,20,1
1715636820781,LIGM 5C,A00,507425,Fischer-Grunski; Eva K,19,0,20,1
1715636821903,LIIT 5AS,A00,507427,Carnelos; Chiara,20,0,20,0
1715636823108,LIIT 5BS,A00,507430,Carnelos; Chiara,20,0,20,0
1715636824193,LIIT 5CS,A00,507432,Carnelos; Chiara,20,0,20,0
1715636825400,LISP 5A,A00,507541,Munoz Sanchez; Alicia,11,0,20,9
1715636826469,LISP 5B,A00,507671,Munoz Sanchez; Alicia,9,0,20,11
1715636827663,LISP 5C,A00,507696,Munoz Sanchez; Alicia,9,0,20,11
1715636829118,MAE 197,001,528363,Boechler; Nicholas Sebastia,9998,0,9999,1
1715636830191,MATH 197,001,523477,Kedlaya; Kiran S.,9994,0,9999,5
1715636830191,MATH 197,002,563811,Zhang; Danna,9994,0,9999,5
1715636830191,MATH 197,003,628552,Dumitriu; Ioana,9998,0,9999,1
1715636830191,MATH 197,004,660885,Floyd; Eric,9998,0,9999,1
1715636831266,MCWP 40R,A00,518780,Staff,2,0,20,18
1715636831266,MCWP 40R,B00,518781,Staff,10,0,20,10
1715636831266,MCWP 40R,C00,518783,Staff,5,0,20,15
1715636832430,MCWP 50R,A00,518791,Staff,0,1,20,20
1715636832430,MCWP 50R,B00,518792,Staff,0,2,20,20
1715636832430,MCWP 50R,C00,518793,Staff,0,4,20,20
1715636832430,MCWP 50R,D00,518794,Staff,0,1,20,20
1715636832430,MCWP 50R,E00,518795,Staff,0,2,20,20
1715636832430,MCWP 50R,F00,518796,Staff,0,1,20,20
1715636832430,MCWP 50R,G00,518797,Staff,0,1,20,20
1715636833661,MMW 12R,A01,514034,Herbst; Matthew,0,2,16,16
1715636833661,MMW 12R,A02,514035,Herbst; Matthew,0,0,16,16
1715636834910,MMW 13R,A01,514037,Staff,0,5,16,16
1715636834910,MMW 13R,A02,514039,Staff,0,5,16,16
1715636834910,MMW 13R,A03,628519,Staff,0,4,16,16
1715636837378,SIO 295LS,A00,523233,Staff,10,0,30,20
1715636838555,SIO 295S,A00,523232,Staff,10,0,30,20
1715636839666,SIOC 290S,A01,637330,Merrifield; Mark A,21,0,30,9
1715636840989,SIOC 291S,A01,637333,Gabriel; Corey John,21,0,30,9
1715636842282,SOCI 117,A01,494376,Staff,0,5,5,5
1715636843350,WES 237B,A00,494380,Staff,10,0,20,10
1715636845681,AESE 279B,A00,494370,Wade; Jon P,0,0,33,33
1715636846784,AIP 97,001,660915,Van Den Einde; Yael Dahlia,9998,0,9999,1
1715636848148,AIP 197,001,627712,Vespa; Emanuel Ignacio,9995,0,9999,4
1715636848148,AIP 197,002,650778,Amir; On,9998,0,9999,1
1715636848148,AIP 197,003,650933,Avenancio-Leon; Carlos,9998,0,9999,1
1715636848148,AIP 197,004,658530,Heyman; Gail D.,9998,0,9999,1
1715636848148,AIP 197,005,658631,Neal; Sonya E,9998,0,9999,1
1715636848148,AIP 197,006,658671,Du; Songzi,9998,0,9999,1
1715636849390,ANAR 135S,A00,494369,Braswell; Geoffrey E.,0,0,0,0
1715636850659,BENG 196,001,628496,Engler; Adam J.,9998,0,9999,1
1715636850659,BENG 196,002,660916,Watson; John Thomas,9998,0,9999,1
1715636851875,BISP 197,001,650773,Wilhelm; James E.,9994,0,9999,5
1715636851875,BISP 197,002,658904,Coleman; Aaron B.,9998,0,9999,1
1715636853098,CAT 124RS,A01,519847,Geibel; William,0,0,20,20
1715636854281,CAT 125RS,A01,515971,Geibel; William,0,0,20,20
1715636855550,CLRE 250,A00,511389,Morris; Sheldon,9992,0,9999,7
1715636856620,CLRE 251,A00,507176,Mehta; Ravindra L.,9992,0,9999,7
1715636856620,CLRE 251,B00,511410,Mehta; Ravindra L.,9998,0,9999,1
1715636857735,CLRE 252,A00,507189,Cuomo; Raphael Eduardo,9994,0,9999,5
1715636858949,CLRE 253,A00,507199,Vaida; Florin,9994,0,9999,5
1715636858949,CLRE 253,B00,507202,Vaida; Florin,9999,0,9999,0
1715636860148,CLRE 259,A00,507211,Patel; Hemal,9996,0,9999,3
1715636861252,CLRE 260,A00,507221,Cuomo; Raphael Eduardo,9999,0,9999,0
1715636862509,CLRE 297,001,507242,Cuomo; Raphael Eduardo,9999,0,9999,0
1715636863775,COGS 197,001,638244,Voytek; Bradley Thomas,9997,0,9999,2
1715636864880,CSE 191,A00,516875,Minnes Kemp; Mor Mia,9991,0,9999,8
1715636866114,CSE 197,001,637388,Minnes Kemp; Mor Mia,9992,0,9999,7
1715636867429,CSS 201S,A01,494383,Mignozzetti; Umberto,35,0,35,0
1715636868758,CSS 202S,A01,494387,Mignozzetti; Umberto,35,0,35,0
1715636869899,DSC 197,001,628532,Eldridge; Justin Matthew,9995,0,9999,4
1715636871124,EAP 100,A00,516065,Staff,9799,0,9999,200
1715636872487,ECE 45,A01,507414,Staff,31,0,60,29
1715636875254,ECE 111,A01,507420,Staff,11,0,50,39
1715636876427,ECE 197,001,548057,Sievenpiper; Daniel F.,9991,0,9999,8
1715636877674,EDS 115,A00,507243,Choi; Bailey Miyeon,7,0,28,21
1715636878981,EDS 117,A01,494379,Staff,0,6,34,34
1715636880283,EDS 125,A00,507246,Hopkins; Megan Beth,8,0,30,22
1715636881356,EDS 128A,A01,507264,Fargason; Sharon Gayle,6,0,26,20
1715636882452,EDS 128B,A01,507293,Pappas; Elizabeth,10,0,30,20
1715636883602,EDS 139,A00,507294,Fargason; Sharon Gayle,10,0,30,20
1715636883602,EDS 139,B00,507313,Pappas; Elizabeth,11,0,30,19
1715636884927,EDS 201,A00,507315,Staff,10,0,30,20
1715636886055,EDS 203,A01,507317,Halter; Christopher P.,10,0,30,20
1715636887170,EDS 204R,A01,507319,Halter; Christopher P.,0,3,30,30
1715636887170,EDS 204R,B01,507331,Heinzman; Erica M.,14,0,30,16
1715636888325,EDS 206R,A00,507332,Staff,0,4,30,30
1715636888325,EDS 206R,B00,507343,Staff,15,0,30,15
1715636889398,EDS 250,A00,507344,Hemans; Patricia Ann Benitez,20,0,40,20
1715636890530,EDS 281,A00,507345,Daly; Alan J.,18,0,18,0
1715636891809,EDS 284,A00,507350,Daly; Alan J.,16,0,16,0
1715636893023,EDS 286,A00,507359,Fine; Sarah,18,0,18,0
1715636894309,EDS 289C,A01,507361,Daly; Alan J.,18,0,18,0
1715636895508,EDS 290,A00,507366,Hofstetter; Carolyn,15,0,15,0
1715636896683,LIGM 5A,A00,507421,Fischer-Grunski; Eva K,17,0,20,3
1715636897939,LIGM 5B,A00,507423,Fischer-Grunski; Eva K,19,0,20,1
1715636899113,LIGM 5C,A00,507425,Fischer-Grunski; Eva K,19,0,20,1
1715636900293,LIIT 5AS,A00,507427,Carnelos; Chiara,20,0,20,0
1715636901510,LIIT 5BS,A00,507430,Carnelos; Chiara,20,0,20,0
1715636902773,LIIT 5CS,A00,507432,Carnelos; Chiara,20,0,20,0
1715636903936,LISP 5A,A00,507541,Munoz Sanchez; Alicia,11,0,20,9
1715636905227,LISP 5B,A00,507671,Munoz Sanchez; Alicia,9,0,20,11
1715636906525,LISP 5C,A00,507696,Munoz Sanchez; Alicia,9,0,20,11
1715636907806,MAE 197,001,528363,Boechler; Nicholas Sebastia,9998,0,9999,1
1715636909018,MATH 197,001,523477,Kedlaya; Kiran S.,9994,0,9999,5
1715636909018,MATH 197,002,563811,Zhang; Danna,9994,0,9999,5
1715636909018,MATH 197,003,628552,Dumitriu; Ioana,9998,0,9999,1
1715636909018,MATH 197,004,660885,Floyd; Eric,9998,0,9999,1
1715636910091,MCWP 40R,A00,518780,Staff,2,0,20,18
1715636910091,MCWP 40R,B00,518781,Staff,10,0,20,10
1715636910091,MCWP 40R,C00,518783,Staff,5,0,20,15
1715636911569,MCWP 50R,A00,518791,Staff,0,1,20,20
1715636911569,MCWP 50R,B00,518792,Staff,0,2,20,20
1715636911569,MCWP 50R,C00,518793,Staff,0,4,20,20
1715636911569,MCWP 50R,D00,518794,Staff,0,1,20,20
1715636911569,MCWP 50R,E00,518795,Staff,0,2,20,20
1715636911569,MCWP 50R,F00,518796,Staff,0,1,20,20
1715636911569,MCWP 50R,G00,518797,Staff,0,1,20,20
1715636912640,MMW 12R,A01,514034,Herbst; Matthew,0,2,16,16
1715636912640,MMW 12R,A02,514035,Herbst; Matthew,0,0,16,16
1715636913858,MMW 13R,A01,514037,Staff,0,5,16,16
1715636913858,MMW 13R,A02,514039,Staff,0,5,16,16
1715636913858,MMW 13R,A03,628519,Staff,0,4,16,16
1715636916132,SIO 295LS,A00,523233,Staff,10,0,30,20
1715636917253,SIO 295S,A00,523232,Staff,10,0,30,20
1715636918422,SIOC 290S,A01,637330,Merrifield; Mark A,21,0,30,9
1715636919579,SIOC 291S,A01,637333,Gabriel; Corey John,21,0,30,9
1715636920920,SOCI 117,A01,494376,Staff,0,5,5,5
1715636922077,WES 237B,A00,494380,Staff,10,0,20,10
1715636924555,AESE 279B,A00,494370,Wade; Jon P,0,0,33,33
1715636925884,AIP 97,001,660915,Van Den Einde; Yael Dahlia,9998,0,9999,1
1715636926942,AIP 197,001,627712,Vespa; Emanuel Ignacio,9995,0,9999,4
1715636926942,AIP 197,002,650778,Amir; On,9998,0,9999,1
1715636926942,AIP 197,003,650933,Avenancio-Leon; Carlos,9998,0,9999,1
1715636926942,AIP 197,004,658530,Heyman; Gail D.,9998,0,9999,1
1715636926942,AIP 197,005,658631,Neal; Sonya E,9998,0,9999,1
1715636926942,AIP 197,006,658671,Du; Songzi,9998,0,9999,1
1715636928155,ANAR 135S,A00,494369,Braswell; Geoffrey E.,0,0,0,0
1715636929391,BENG 196,001,628496,Engler; Adam J.,9998,0,9999,1
1715636929391,BENG 196,002,660916,Watson; John Thomas,9998,0,9999,1
1715636930582,BISP 197,001,650773,Wilhelm; James E.,9994,0,9999,5
1715636930582,BISP 197,002,658904,Coleman; Aaron B.,9998,0,9999,1
1715636931752,CAT 124RS,A01,519847,Geibel; William,0,0,20,20
1715636932920,CAT 125RS,A01,515971,Geibel; William,0,0,20,20
1715636934019,CLRE 250,A00,511389,Morris; Sheldon,9992,0,9999,7
1715636935193,CLRE 251,A00,507176,Mehta; Ravindra L.,9992,0,9999,7
1715636935193,CLRE 251,B00,511410,Mehta; Ravindra L.,9998,0,9999,1
1715636937034,CLRE 252,A00,507189,Cuomo; Raphael Eduardo,9994,0,9999,5
1715636938127,CLRE 253,A00,507199,Vaida; Florin,9994,0,9999,5
1715636938127,CLRE 253,B00,507202,Vaida; Florin,9999,0,9999,0
1715636939221,CLRE 259,A00,507211,Patel; Hemal,9996,0,9999,3
1715636940451,CLRE 260,A00,507221,Cuomo; Raphael Eduardo,9999,0,9999,0
1715636941587,CLRE 297,001,507242,Cuomo; Raphael Eduardo,9999,0,9999,0
1715636942862,COGS 197,001,638244,Voytek; Bradley Thomas,9997,0,9999,2
1715636944096,CSE 191,A00,516875,Minnes Kemp; Mor Mia,9991,0,9999,8
1715636945214,CSE 197,001,637388,Minnes Kemp; Mor Mia,9992,0,9999,7
1715636946620,CSS 201S,A01,494383,Mignozzetti; Umberto,35,0,35,0
1715636947844,CSS 202S,A01,494387,Mignozzetti; Umberto,35,0,35,0
1715636948992,DSC 197,001,628532,Eldridge; Justin Matthew,9995,0,9999,4
1715636950115,EAP 100,A00,516065,Staff,9799,0,9999,200
1715636951287,ECE 45,A01,507414,Staff,31,0,60,29
1715636953778,ECE 111,A01,507420,Staff,11,0,50,39
1715636955007,ECE 197,001,548057,Sievenpiper; Daniel F.,9991,0,9999,8
1715636956247,EDS 115,A00,507243,Choi; Bailey Miyeon,7,0,28,21
1715636957416,EDS 117,A01,494379,Staff,0,6,34,34
1715636958611,EDS 125,A00,507246,Hopkins; Megan Beth,8,0,30,22
1715636959766,EDS 128A,A01,507264,Fargason; Sharon Gayle,6,0,26,20
1715636960891,EDS 128B,A01,507293,Pappas; Elizabeth,10,0,30,20
1715636962181,EDS 139,A00,507294,Fargason; Sharon Gayle,10,0,30,20
1715636962181,EDS 139,B00,507313,Pappas; Elizabeth,11,0,30,19
1715636963318,EDS 201,A00,507315,Staff,10,0,30,20
1715636964393,EDS 203,A01,507317,Halter; Christopher P.,10,0,30,20
1715636965906,EDS 204R,A01,507319,Halter; Christopher P.,0,3,30,30
1715636965906,EDS 204R,B01,507331,Heinzman; Erica M.,14,0,30,16
1715636967024,EDS 206R,A00,507332,Staff,0,4,30,30
1715636967024,EDS 206R,B00,507343,Staff,15,0,30,15
1715636968174,EDS 250,A00,507344,Hemans; Patricia Ann Benitez,20,0,40,20
1715636969339,EDS 281,A00,507345,Daly; Alan J.,18,0,18,0
1715636970507,EDS 284,A00,507350,Daly; Alan J.,16,0,16,0
1715636971705,EDS 286,A00,507359,Fine; Sarah,18,0,18,0
1715636972738,EDS 289C,A01,507361,Daly; Alan J.,18,0,18,0
1715636973848,EDS 290,A00,507366,Hofstetter; Carolyn,15,0,15,0
1715636975051,LIGM 5A,A00,507421,Fischer-Grunski; Eva K,17,0,20,3
1715636976149,LIGM 5B,A00,507423,Fischer-Grunski; Eva K,19,0,20,1
1715636977320,LIGM 5C,A00,507425,Fischer-Grunski; Eva K,19,0,20,1
1715636978507,LIIT 5AS,A00,507427,Carnelos; Chiara,20,0,20,0
1715636979676,LIIT 5BS,A00,507430,Carnelos; Chiara,20,0,20,0
1715636980768,LIIT 5CS,A00,507432,Carnelos; Chiara,20,0,20,0
1715636981944,LISP 5A,A00,507541,Munoz Sanchez; Alicia,11,0,20,9
1715636983095,LISP 5B,A00,507671,Munoz Sanchez; Alicia,9,0,20,11
1715636984218,LISP 5C,A00,507696,Munoz Sanchez; Alicia,9,0,20,11
1715636985424,MAE 197,001,528363,Boechler; Nicholas Sebastia,9998,0,9999,1
1715636986642,MATH 197,001,523477,Kedlaya; Kiran S.,9994,0,9999,5
1715636986642,MATH 197,002,563811,Zhang; Danna,9994,0,9999,5
1715636986642,MATH 197,003,628552,Dumitriu; Ioana,9998,0,9999,1
1715636986642,MATH 197,004,660885,Floyd; Eric,9998,0,9999,1
1715636987860,MCWP 40R,A00,518780,Staff,2,0,20,18
1715636987860,MCWP 40R,B00,518781,Staff,10,0,20,10
1715636987860,MCWP 40R,C00,518783,Staff,5,0,20,15
1715636989088,MCWP 50R,A00,518791,Staff,0,1,20,20
1715636989088,MCWP 50R,B00,518792,Staff,0,2,20,20
1715636989088,MCWP 50R,C00,518793,Staff,0,4,20,20
1715636989088,MCWP 50R,D00,518794,Staff,0,1,20,20
1715636989088,MCWP 50R,E00,518795,Staff,0,2,20,20
1715636989088,MCWP 50R,F00,518796,Staff,0,1,20,20
1715636989088,MCWP 50R,G00,518797,Staff,0,1,20,20
1715636990249,MMW 12R,A01,514034,Herbst; Matthew,0,2,16,16
1715636990249,MMW 12R,A02,514035,Herbst; Matthew,0,0,16,16
1715636991379,MMW 13R,A01,514037,Staff,0,5,16,16
1715636991379,MMW 13R,A02,514039,Staff,0,5,16,16
1715636991379,MMW 13R,A03,628519,Staff,0,4,16,16
1715636993838,SIO 295LS,A00,523233,Staff,10,0,30,20
1715636995003,SIO 295S,A00,523232,Staff,10,0,30,20
1715636996186,SIOC 290S,A01,637330,Merrifield; Mark A,21,0,30,9
1715636997382,SIOC 291S,A01,637333,Gabriel; Corey John,21,0,30,9
1715636998566,SOCI 117,A01,494376,Staff,0,5,5,5
1715636999755,WES 237B,A00,494380,Staff,10,0,20,10
1715637003204,AESE 279B,A00,494370,Wade; Jon P,0,0,33,33
1715637004262,AIP 97,001,660915,Van Den Einde; Yael Dahlia,9998,0,9999,1
1715637005554,AIP 197,001,627712,Vespa; Emanuel Ignacio,9995,0,9999,4
1715637005554,AIP 197,002,650778,Amir; On,9998,0,9999,1
1715637005554,AIP 197,003,650933,Avenancio-Leon; Carlos,9998,0,9999,1
1715637005554,AIP 197,004,658530,Heyman; Gail D.,9998,0,9999,1
1715637005554,AIP 197,005,658631,Neal; Sonya E,9998,0,9999,1
1715637005554,AIP 197,006,658671,Du; Songzi,9998,0,9999,1
1715637006861,ANAR 135S,A00,494369,Braswell; Geoffrey E.,0,0,0,0
1715637008083,BENG 196,001,628496,Engler; Adam J.,9998,0,9999,1
1715637008083,BENG 196,002,660916,Watson; John Thomas,9998,0,9999,1
1715637009242,BISP 197,001,650773,Wilhelm; James E.,9994,0,9999,5
1715637009242,BISP 197,002,658904,Coleman; Aaron B.,9998,0,9999,1
1715637010319,CAT 124RS,A01,519847,Geibel; William,0,0,20,20
1715637011594,CAT 125RS,A01,515971,Geibel; William,0,0,20,20
1715637012731,CLRE 250,A00,511389,Morris; Sheldon,9992,0,9999,7
1715637013916,CLRE 251,A00,507176,Mehta; Ravindra L.,9992,0,9999,7
1715637013916,CLRE 251,B00,511410,Mehta; Ravindra L.,9998,0,9999,1
1715637015064,CLRE 252,A00,507189,Cuomo; Raphael Eduardo,9994,0,9999,5
1715637016269,CLRE 253,A00,507199,Vaida; Florin,9994,0,9999,5
1715637016269,CLRE 253,B00,507202,Vaida; Florin,9999,0,9999,0
1715637017480,CLRE 259,A00,507211,Patel; Hemal,9996,0,9999,3
1715637018751,CLRE 260,A00,507221,Cuomo; Raphael Eduardo,9999,0,9999,0
1715637020027,CLRE 297,001,507242,Cuomo; Raphael Eduardo,9999,0,9999,0
1715637021090,COGS 197,001,638244,Voytek; Bradley Thomas,9997,0,9999,2
1715637022251,CSE 191,A00,516875,Minnes Kemp; Mor Mia,9991,0,9999,8
1715637023537,CSE 197,001,637388,Minnes Kemp; Mor Mia,9992,0,9999,7
1715637024858,CSS 201S,A01,494383,Mignozzetti; Umberto,35,0,35,0
1715637026169,CSS 202S,A01,494387,Mignozzetti; Umberto,35,0,35,0
1715637027326,DSC 197,001,628532,Eldridge; Justin Matthew,9995,0,9999,4
1715637028490,EAP 100,A00,516065,Staff,9799,0,9999,200
1715637029610,ECE 45,A01,507414,Staff,31,0,60,29
1715637032016,ECE 111,A01,507420,Staff,11,0,50,39
1715637033267,ECE 197,001,548057,Sievenpiper; Daniel F.,9991,0,9999,8
1715637034439,EDS 115,A00,507243,Choi; Bailey Miyeon,7,0,28,21
1715637035634,EDS 117,A01,494379,Staff,0,6,34,34
1715637036837,EDS 125,A00,507246,Hopkins; Megan Beth,8,0,30,22
1715637037983,EDS 128A,A01,507264,Fargason; Sharon Gayle,6,0,26,20
1715637039189,EDS 128B,A01,507293,Pappas; Elizabeth,10,0,30,20
1715637040376,EDS 139,A00,507294,Fargason; Sharon Gayle,10,0,30,20
1715637040376,EDS 139,B00,507313,Pappas; Elizabeth,11,0,30,19
1715637041588,EDS 201,A00,507315,Staff,10,0,30,20
1715637042879,EDS 203,A01,507317,Halter; Christopher P.,10,0,30,20
1715637044100,EDS 204R,A01,507319,Halter; Christopher P.,0,3,30,30
1715637044100,EDS 204R,B01,507331,Heinzman; Erica M.,14,0,30,16
1715637045275,EDS 206R,A00,507332,Staff,0,4,30,30
1715637045275,EDS 206R,B00,507343,Staff,15,0,30,15
1715637046517,EDS 250,A00,507344,Hemans; Patricia Ann Benitez,20,0,40,20
1715637047733,EDS 281,A00,507345,Daly; Alan J.,18,0,18,0
1715637048838,EDS 284,A00,507350,Daly; Alan J.,16,0,16,0
1715637050094,EDS 286,A00,507359,Fine; Sarah,18,0,18,0
1715637051221,EDS 289C,A01,507361,Daly; Alan J.,18,0,18,0
1715637052515,EDS 290,A00,507366,Hofstetter; Carolyn,15,0,15,0
1715637053658,LIGM 5A,A00,507421,Fischer-Grunski; Eva K,17,0,20,3
1715637054923,LIGM 5B,A00,507423,Fischer-Grunski; Eva K,19,0,20,1
1715637056059,LIGM 5C,A00,507425,Fischer-Grunski; Eva K,19,0,20,1
1715637057226,LIIT 5AS,A00,507427,Carnelos; Chiara,20,0,20,0
1715637058442,LIIT 5BS,A00,507430,Carnelos; Chiara,20,0,20,0
1715637059604,LIIT 5CS,A00,507432,Carnelos; Chiara,20,0,20,0
1715637060881,LISP 5A,A00,507541,Munoz Sanchez; Alicia,11,0,20,9
1715637062133,LISP 5B,A00,507671,Munoz Sanchez; Alicia,9,0,20,11
1715637063282,LISP 5C,A00,507696,Munoz Sanchez; Alicia,9,0,20,11
1715637064444,MAE 197,001,528363,Boechler; Nicholas Sebastia,9998,0,9999,1
1715637065581,MATH 197,001,523477,Kedlaya; Kiran S.,9994,0,9999,5
1715637065581,MATH 197,002,563811,Zhang; Danna,9994,0,9999,5
1715637065581,MATH 197,003,628552,Dumitriu; Ioana,9998,0,9999,1
1715637065581,MATH 197,004,660885,Floyd; Eric,9998,0,9999,1
1715637066694,MCWP 40R,A00,518780,Staff,2,0,20,18
1715637066694,MCWP 40R,B00,518781,Staff,10,0,20,10
1715637066694,MCWP 40R,C00,518783,Staff,5,0,20,15
1715637067800,MCWP 50R,A00,518791,Staff,0,1,20,20
1715637067800,MCWP 50R,B00,518792,Staff,0,2,20,20
1715637067800,MCWP 50R,C00,518793,Staff,0,4,20,20
1715637067800,MCWP 50R,D00,518794,Staff,0,1,20,20
1715637067800,MCWP 50R,E00,518795,Staff,0,2,20,20
1715637067800,MCWP 50R,F00,518796,Staff,0,1,20,20
1715637067800,MCWP 50R,G00,518797,Staff,0,1,20,20
1715637069020,MMW 12R,A01,514034,Herbst; Matthew,0,2,16,16
1715637069020,MMW 12R,A02,514035,Herbst; Matthew,0,0,16,16
1715637070189,MMW 13R,A01,514037,Staff,0,5,16,16
1715637070189,MMW 13R,A02,514039,Staff,0,5,16,16
1715637070189,MMW 13R,A03,628519,Staff,0,4,16,16
1715637072591,SIO 295LS,A00,523233,Staff,10,0,30,20
1715637073707,SIO 295S,A00,523232,Staff,10,0,30,20
1715637074919,SIOC 290S,A01,637330,Merrifield; Mark A,21,0,30,9
1715637076158,SIOC 291S,A01,637333,Gabriel; Corey John,21,0,30,9
1715637077280,SOCI 117,A01,494376,Staff,0,5,5,5
1715637078449,WES 237B,A00,494380,Staff,10,0,20,10
1715637080721,AESE 279B,A00,494370,Wade; Jon P,0,0,33,33
1715637081928,AIP 97,001,660915,Van Den Einde; Yael Dahlia,9998,0,9999,1
1715637083193,AIP 197,001,627712,Vespa; Emanuel Ignacio,9995,0,9999,4
1715637083193,AIP 197,002,650778,Amir; On,9998,0,9999,1
1715637083193,AIP 197,003,650933,Avenancio-Leon; Carlos,9998,0,9999,1
1715637083193,AIP 197,004,658530,Heyman; Gail D.,9998,0,9999,1
1715637083193,AIP 197,005,658631,Neal; Sonya E,9998,0,9999,1
1715637083193,AIP 197,006,658671,Du; Songzi,9998,0,9999,1
1715637084298,ANAR 135S,A00,494369,Braswell; Geoffrey E.,0,0,0,0
1715637085427,BENG 196,001,628496,Engler; Adam J.,9998,0,9999,1
1715637085427,BENG 196,002,660916,Watson; John Thomas,9998,0,9999,1
1715637086602,BISP 197,001,650773,Wilhelm; James E.,9994,0,9999,5
1715637086602,BISP 197,002,658904,Coleman; Aaron B.,9998,0,9999,1
1715637087773,CAT 124RS,A01,519847,Geibel; William,0,0,20,20
1715637088860,CAT 125RS,A01,515971,Geibel; William,0,0,20,20
1715637089927,CLRE 250,A00,511389,Morris; Sheldon,9992,0,9999,7
1715637091109,CLRE 251,A00,507176,Mehta; Ravindra L.,9992,0,9999,7
1715637091109,CLRE 251,B00,511410,Mehta; Ravindra L.,9998,0,9999,1
1715637092322,CLRE 252,A00,507189,Cuomo; Raphael Eduardo,9994,0,9999,5
1715637093504,CLRE 253,A00,507199,Vaida; Florin,9994,0,9999,5
1715637093504,CLRE 253,B00,507202,Vaida; Florin,9999,0,9999,0
1715637094610,CLRE 259,A00,507211,Patel; Hemal,9996,0,9999,3
1715637095811,CLRE 260,A00,507221,Cuomo; Raphael Eduardo,9999,0,9999,0
1715637096976,CLRE 297,001,507242,Cuomo; Raphael Eduardo,9999,0,9999,0
1715637098167,COGS 197,001,638244,Voytek; Bradley Thomas,9997,0,9999,2
1715637099301,CSE 191,A00,516875,Minnes Kemp; Mor Mia,9991,0,9999,8
1715637100494,CSE 197,001,637388,Minnes Kemp; Mor Mia,9992,0,9999,7
1715637101645,CSS 201S,A01,494383,Mignozzetti; Umberto,35,0,35,0
1715637102725,CSS 202S,A01,494387,Mignozzetti; Umberto,35,0,35,0
1715637103957,DSC 197,001,628532,Eldridge; Justin Matthew,9995,0,9999,4
1715637105162,EAP 100,A00,516065,Staff,9799,0,9999,200
1715637106357,ECE 45,A01,507414,Staff,31,0,60,29
1715637108955,ECE 111,A01,507420,Staff,11,0,50,39
1715637110030,ECE 197,001,548057,Sievenpiper; Daniel F.,9991,0,9999,8
1715637111137,EDS 115,A00,507243,Choi; Bailey Miyeon,7,0,28,21
1715637112170,EDS 117,A01,494379,Staff,0,6,34,34
1715637113311,EDS 125,A00,507246,Hopkins; Megan Beth,8,0,30,22
1715637114843,EDS 128A,A01,507264,Fargason; Sharon Gayle,6,0,26,20
1715637116026,EDS 128B,A01,507293,Pappas; Elizabeth,10,0,30,20
1715637117254,EDS 139,A00,507294,Fargason; Sharon Gayle,10,0,30,20
1715637117254,EDS 139,B00,507313,Pappas; Elizabeth,11,0,30,19
1715637118541,EDS 201,A00,507315,Staff,10,0,30,20
1715637119761,EDS 203,A01,507317,Halter; Christopher P.,10,0,30,20
1715637120942,EDS 204R,A01,507319,Halter; Christopher P.,0,3,30,30
1715637120942,EDS 204R,B01,507331,Heinzman; Erica M.,14,0,30,16
1715637122077,EDS 206R,A00,507332,Staff,0,4,30,30
1715637122077,EDS 206R,B00,507343,Staff,15,0,30,15
1715637123285,EDS 250,A00,507344,Hemans; Patricia Ann Benitez,20,0,40,20
1715637124389,EDS 281,A00,507345,Daly; Alan J.,18,0,18,0
1715637125457,EDS 284,A00,507350,Daly; Alan J.,16,0,16,0
1715637126649,EDS 286,A00,507359,Fine; Sarah,18,0,18,0
1715637127852,EDS 289C,A01,507361,Daly; Alan J.,18,0,18,0
1715637129125,EDS 290,A00,507366,Hofstetter; Carolyn,15,0,15,0
1715637130318,LIGM 5A,A00,507421,Fischer-Grunski; Eva K,17,0,20,3
1715637131461,LIGM 5B,A00,507423,Fischer-Grunski; Eva K,19,0,20,1
1715637132663,LIGM 5C,A00,507425,Fischer-Grunski; Eva K,19,0,20,1
1715637133820,LIIT 5AS,A00,507427,Carnelos; Chiara,20,0,20,0
1715637134948,LIIT 5BS,A00,507430,Carnelos; Chiara,20,0,20,0
1715637136207,LIIT 5CS,A00,507432,Carnelos; Chiara,20,0,20,0
1715637137434,LISP 5A,A00,507541,Munoz Sanchez; Alicia,11,0,20,9
1715637138703,LISP 5B,A00,507671,Munoz Sanchez; Alicia,9,0,20,11
1715637139907,LISP 5C,A00,507696,Munoz Sanchez; Alicia,9,0,20,11
1715637141426,MAE 197,001,528363,Boechler; Nicholas Sebastia,9998,0,9999,1
1715637142872,MATH 197,001,523477,Kedlaya; Kiran S.,9994,0,9999,5
1715637142872,MATH 197,002,563811,Zhang; Danna,9994,0,9999,5
1715637142872,MATH 197,003,628552,Dumitriu; Ioana,9998,0,9999,1
1715637142872,MATH 197,004,660885,Floyd; Eric,9998,0,9999,1
1715637144054,MCWP 40R,A00,518780,Staff,2,0,20,18
1715637144054,MCWP 40R,B00,518781,Staff,10,0,20,10
1715637144054,MCWP 40R,C00,518783,Staff,5,0,20,15
1715637145121,MCWP 50R,A00,518791,Staff,0,1,20,20
1715637145121,MCWP 50R,B00,518792,Staff,0,2,20,20
1715637145121,MCWP 50R,C00,518793,Staff,0,4,20,20
1715637145121,MCWP 50R,D00,518794,Staff,0,1,20,20
1715637145121,MCWP 50R,E00,518795,Staff,0,2,20,20
1715637145121,MCWP 50R,F00,518796,Staff,0,1,20,20
1715637145121,MCWP 50R,G00,518797,Staff,0,1,20,20
1715637146712,MMW 12R,A01,514034,Herbst; Matthew,0,2,16,16
1715637146712,MMW 12R,A02,514035,Herbst; Matthew,0,0,16,16
1715637147784,MMW 13R,A01,514037,Staff,0,5,16,16
1715637147784,MMW 13R,A02,514039,Staff,0,5,16,16
1715637147784,MMW 13R,A03,628519,Staff,0,4,16,16
1715637150139,SIO 295LS,A00,523233,Staff,10,0,30,20
1715637151324,SIO 295S,A00,523232,Staff,10,0,30,20
1715637152642,SIOC 290S,A01,637330,Merrifield; Mark A,21,0,30,9
1715637154040,SIOC 291S,A01,637333,Gabriel; Corey John,21,0,30,9
1715637155157,SOCI 117,A01,494376,Staff,0,5,5,5
1715637156353,WES 237B,A00,494380,Staff,10,0,20,10
1715637158792,AESE 279B,A00,494370,Wade; Jon P,0,0,33,33
1715637159978,AIP 97,001,660915,Van Den Einde; Yael Dahlia,9998,0,9999,1
1715637161191,AIP 197,001,627712,Vespa; Emanuel Ignacio,9995,0,9999,4
1715637161191,AIP 197,002,650778,Amir; On,9998,0,9999,1
1715637161191,AIP 197,003,650933,Avenancio-Leon; Carlos,9998,0,9999,1
1715637161191,AIP 197,004,658530,Heyman; Gail D.,9998,0,9999,1
1715637161191,AIP 197,005,658631,Neal; Sonya E,9998,0,9999,1
1715637161191,AIP 197,006,658671,Du; Songzi,9998,0,9999,1
1715637162465,ANAR 135S,A00,494369,Braswell; Geoffrey E.,0,0,0,0
1715637163717,BENG 196,001,628496,Engler; Adam J.,9998,0,9999,1
1715637163717,BENG 196,002,660916,Watson; John Thomas,9998,0,9999,1
1715637164915,BISP 197,001,650773,Wilhelm; James E.,9994,0,9999,5
1715637164915,BISP 197,002,658904,Coleman; Aaron B.,9998,0,9999,1
1715637166072,CAT 124RS,A01,519847,Geibel; William,0,0,20,20
1715637167353,CAT 125RS,A01,515971,Geibel; William,0,0,20,20
1715637168749,CLRE 250,A00,511389,Morris; Sheldon,9992,0,9999,7
1715637169876,CLRE 251,A00,507176,Mehta; Ravindra L.,9992,0,9999,7
1715637169876,CLRE 251,B00,511410,Mehta; Ravindra L.,9998,0,9999,1
1715637170977,CLRE 252,A00,507189,Cuomo; Raphael Eduardo,9994,0,9999,5
1715637172172,CLRE 253,A00,507199,Vaida; Florin,9994,0,9999,5
1715637172172,CLRE 253,B00,507202,Vaida; Florin,9999,0,9999,0
1715637173266,CLRE 259,A00,507211,Patel; Hemal,9996,0,9999,3
1715637174428,CLRE 260,A00,507221,Cuomo; Raphael Eduardo,9999,0,9999,0
1715637175603,CLRE 297,001,507242,Cuomo; Raphael Eduardo,9999,0,9999,0
1715637176825,COGS 197,001,638244,Voytek; Bradley Thomas,9997,0,9999,2
1715637177943,CSE 191,A00,516875,Minnes Kemp; Mor Mia,9991,0,9999,8
1715637179163,CSE 197,001,637388,Minnes Kemp; Mor Mia,9992,0,9999,7
1715637180308,CSS 201S,A01,494383,Mignozzetti; Umberto,35,0,35,0
1715637181530,CSS 202S,A01,494387,Mignozzetti; Umberto,35,0,35,0
1715637182776,DSC 197,001,628532,Eldridge; Justin Matthew,9995,0,9999,4
1715637183987,EAP 100,A00,516065,Staff,9799,0,9999,200
1715637185352,ECE 45,A01,507414,Staff,31,0,60,29
1715637187866,ECE 111,A01,507420,Staff,11,0,50,39
1715637189001,ECE 197,001,548057,Sievenpiper; Daniel F.,9991,0,9999,8
1715637190276,EDS 115,A00,507243,Choi; Bailey Miyeon,7,0,28,21
1715637191494,EDS 117,A01,494379,Staff,0,6,34,34
1715637192849,EDS 125,A00,507246,Hopkins; Megan Beth,8,0,30,22
1715637194007,EDS 128A,A01,507264,Fargason; Sharon Gayle,6,0,26,20
1715637195116,EDS 128B,A01,507293,Pappas; Elizabeth,10,0,30,20
1715637196309,EDS 139,A00,507294,Fargason; Sharon Gayle,10,0,30,20
1715637196309,EDS 139,B00,507313,Pappas; Elizabeth,11,0,30,19
1715637197480,EDS 201,A00,507315,Staff,10,0,30,20
1715637198607,EDS 203,A01,507317,Halter; Christopher P.,10,0,30,20
1715637199790,EDS 204R,A01,507319,Halter; Christopher P.,0,3,30,30
1715637199790,EDS 204R,B01,507331,Heinzman; Erica M.,14,0,30,16
1715637200871,EDS 206R,A00,507332,Staff,0,4,30,30
1715637200871,EDS 206R,B00,507343,Staff,15,0,30,15
1715637202166,EDS 250,A00,507344,Hemans; Patricia Ann Benitez,20,0,40,20
1715637203723,EDS 281,A00,507345,Daly; Alan J.,18,0,18,0
1715637204940,EDS 284,A00,507350,Daly; Alan J.,16,0,16,0
1715637206211,EDS 286,A00,507359,Fine; Sarah,18,0,18,0
1715637207299,EDS 289C,A01,507361,Daly; Alan J.,18,0,18,0
1715637208459,EDS 290,A00,507366,Hofstetter; Carolyn,15,0,15,0
1715637209617,LIGM 5A,A00,507421,Fischer-Grunski; Eva K,17,0,20,3
1715637210752,LIGM 5B,A00,507423,Fischer-Grunski; Eva K,19,0,20,1
1715637211948,LIGM 5C,A00,507425,Fischer-Grunski; Eva K,19,0,20,1
1715637213141,LIIT 5AS,A00,507427,Carnelos; Chiara,20,0,20,0
1715637214217,LIIT 5BS,A00,507430,Carnelos; Chiara,20,0,20,0
1715637215383,LIIT 5CS,A00,507432,Carnelos; Chiara,20,0,20,0
1715637216643,LISP 5A,A00,507541,Munoz Sanchez; Alicia,11,0,20,9
1715637217785,LISP 5B,A00,507671,Munoz Sanchez; Alicia,9,0,20,11
1715637219018,LISP 5C,A00,507696,Munoz Sanchez; Alicia,9,0,20,11
1715637220365,MAE 197,001,528363,Boechler; Nicholas Sebastia,9998,0,9999,1
1715637221529,MATH 197,001,523477,Kedlaya; Kiran S.,9994,0,9999,5
1715637221529,MATH 197,002,563811,Zhang; Danna,9994,0,9999,5
1715637221529,MATH 197,003,628552,Dumitriu; Ioana,9998,0,9999,1
1715637221529,MATH 197,004,660885,Floyd; Eric,9998,0,9999,1
1715637222660,MCWP 40R,A00,518780,Staff,2,0,20,18
1715637222660,MCWP 40R,B00,518781,Staff,10,0,20,10
1715637222660,MCWP 40R,C00,518783,Staff,5,0,20,15
1715637223889,MCWP 50R,A00,518791,Staff,0,1,20,20
1715637223889,MCWP 50R,B00,518792,Staff,0,2,20,20
1715637223889,MCWP 50R,C00,518793,Staff,0,4,20,20
1715637223889,MCWP 50R,D00,518794,Staff,0,1,20,20
1715637223889,MCWP 50R,E00,518795,Staff,0,2,20,20
1715637223889,MCWP 50R,F00,518796,Staff,0,1,20,20
1715637223889,MCWP 50R,G00,518797,Staff,0,1,20,20
1715637225181,MMW 12R,A01,514034,Herbst; Matthew,0,2,16,16
1715637225181,MMW 12R,A02,514035,Herbst; Matthew,0,0,16,16
1715637226470,MMW 13R,A01,514037,Staff,0,5,16,16
1715637226470,MMW 13R,A02,514039,Staff,0,5,16,16
1715637226470,MMW 13R,A03,628519,Staff,0,4,16,16
1715637228944,SIO 295LS,A00,523233,Staff,10,0,30,20
1715637230260,SIO 295S,A00,523232,Staff,10,0,30,20
1715637231440,SIOC 290S,A01,637330,Merrifield; Mark A,21,0,30,9
1715637232512,SIOC 291S,A01,637333,Gabriel; Corey John,21,0,30,9
1715637233697,SOCI 117,A01,494376,Staff,0,5,5,5
1715637234808,WES 237B,A00,494380,Staff,10,0,20,10
1715637237437,AESE 279B,A00,494370,Wade; Jon P,0,0,33,33
1715637238596,AIP 97,001,660915,Van Den Einde; Yael Dahlia,9998,0,9999,1
1715637239742,AIP 197,001,627712,Vespa; Emanuel Ignacio,9995,0,9999,4
1715637239742,AIP 197,002,650778,Amir; On,9998,0,9999,1
1715637239742,AIP 197,003,650933,Avenancio-Leon; Carlos,9998,0,9999,1
1715637239742,AIP 197,004,658530,Heyman; Gail D.,9998,0,9999,1
1715637239742,AIP 197,005,658631,Neal; Sonya E,9998,0,9999,1
1715637239742,AIP 197,006,658671,Du; Songzi,9998,0,9999,1
1715637240858,ANAR 135S,A00,494369,Braswell; Geoffrey E.,0,0,0,0
1715637241991,BENG 196,001,628496,Engler; Adam J.,9998,0,9999,1
1715637241991,BENG 196,002,660916,Watson; John Thomas,9998,0,9999,1
1715637243973,BISP 197,001,650773,Wilhelm; James E.,9994,0,9999,5
1715637243973,BISP 197,002,658904,Coleman; Aaron B.,9998,0,9999,1
1715637245447,CAT 124RS,A01,519847,Geibel; William,0,0,20,20
1715637246768,CAT 125RS,A01,515971,Geibel; William,0,0,20,20
1715637247906,CLRE 250,A00,511389,Morris; Sheldon,9992,0,9999,7
1715637249067,CLRE 251,A00,507176,Mehta; Ravindra L.,9992,0,9999,7
1715637249067,CLRE 251,B00,511410,Mehta; Ravindra L.,9998,0,9999,1
1715637250376,CLRE 252,A00,507189,Cuomo; Raphael Eduardo,9994,0,9999,5
1715637251574,CLRE 253,A00,507199,Vaida; Florin,9994,0,9999,5
1715637251574,CLRE 253,B00,507202,Vaida; Florin,9999,0,9999,0
1715637252745,CLRE 259,A00,507211,Patel; Hemal,9996,0,9999,3
1715637253965,CLRE 260,A00,507221,Cuomo; Raphael Eduardo,9999,0,9999,0
1715637255191,CLRE 297,001,507242,Cuomo; Raphael Eduardo,9999,0,9999,0
1715637256405,COGS 197,001,638244,Voytek; Bradley Thomas,9997,0,9999,2
1715637257578,CSE 191,A00,516875,Minnes Kemp; Mor Mia,9991,0,9999,8
1715637258894,CSE 197,001,637388,Minnes Kemp; Mor Mia,9992,0,9999,7
1715637260116,CSS 201S,A01,494383,Mignozzetti; Umberto,35,0,35,0
1715637261236,CSS 202S,A01,494387,Mignozzetti; Umberto,35,0,35,0
1715637262432,DSC 197,001,628532,Eldridge; Justin Matthew,9995,0,9999,4
1715637263664,EAP 100,A00,516065,Staff,9799,0,9999,200
1715637264749,ECE 45,A01,507414,Staff,31,0,60,29
1715637267119,ECE 111,A01,507420,Staff,11,0,50,39
1715637268272,ECE 197,001,548057,Sievenpiper; Daniel F.,9991,0,9999,8
1715637269400,EDS 115,A00,507243,Choi; Bailey Miyeon,7,0,28,21
1715637270617,EDS 117,A01,494379,Staff,0,6,34,34
1715637271806,EDS 125,A00,507246,Hopkins; Megan Beth,8,0,30,22
1715637273029,EDS 128A,A01,507264,Fargason; Sharon Gayle,6,0,26,20
1715637274186,EDS 128B,A01,507293,Pappas; Elizabeth,10,0,30,20
1715637275487,EDS 139,A00,507294,Fargason; Sharon Gayle,10,0,30,20
1715637275487,EDS 139,B00,507313,Pappas; Elizabeth,11,0,30,19
1715637276720,EDS 201,A00,507315,Staff,10,0,30,20
1715637277894,EDS 203,A01,507317,Halter; Christopher P.,10,0,30,20
1715637279096,EDS 204R,A01,507319,Halter; Christopher P.,0,3,30,30
1715637279096,EDS 204R,B01,507331,Heinzman; Erica M.,14,0,30,16
1715637280284,EDS 206R,A00,507332,Staff,0,4,30,30
1715637280284,EDS 206R,B00,507343,Staff,15,0,30,15
1715637281504,EDS 250,A00,507344,Hemans; Patricia Ann Benitez,20,0,40,20
1715637282672,EDS 281,A00,507345,Daly; Alan J.,18,0,18,0
1715637283866,EDS 284,A00,507350,Daly; Alan J.,16,0,16,0
1715637285026,EDS 286,A00,507359,Fine; Sarah,18,0,18,0
1715637286225,EDS 289C,A01,507361,Daly; Alan J.,18,0,18,0
1715637287395,EDS 290,A00,507366,Hofstetter; Carolyn,15,0,15,0
1715637288594,LIGM 5A,A00,507421,Fischer-Grunski; Eva K,17,0,20,3
1715637289776,LIGM 5B,A00,507423,Fischer-Grunski; Eva K,19,0,20,1
1715637290926,LIGM 5C,A00,507425,Fischer-Grunski; Eva K,19,0,20,1
1715637292095,LIIT 5AS,A00,507427,Carnelos; Chiara,20,0,20,0
1715637293282,LIIT 5BS,A00,507430,Carnelos; Chiara,20,0,20,0
1715637294401,LIIT 5CS,A00,507432,Carnelos; Chiara,20,0,20,0
1715637295679,LISP 5A,A00,507541,Munoz Sanchez; Alicia,11,0,20,9
1715637297027,LISP 5B,A00,507671,Munoz Sanchez; Alicia,9,0,20,11
1715637298157,LISP 5C,A00,507696,Munoz Sanchez; Alicia,9,0,20,11
1715637299362,MAE 197,001,528363,Boechler; Nicholas Sebastia,9998,0,9999,1
1715637300495,MATH 197,001,523477,Kedlaya; Kiran S.,9994,0,9999,5
1715637300495,MATH 197,002,563811,Zhang; Danna,9994,0,9999,5
1715637300495,MATH 197,003,628552,Dumitriu; Ioana,9998,0,9999,1
1715637300495,MATH 197,004,660885,Floyd; Eric,9998,0,9999,1
1715637301631,MCWP 40R,A00,518780,Staff,2,0,20,18
1715637301631,MCWP 40R,B00,518781,Staff,10,0,20,10
1715637301631,MCWP 40R,C00,518783,Staff,5,0,20,15
1715637302848,MCWP 50R,A00,518791,Staff,0,1,20,20
1715637302848,MCWP 50R,B00,518792,Staff,0,2,20,20
1715637302848,MCWP 50R,C00,518793,Staff,0,4,20,20
1715637302848,MCWP 50R,D00,518794,Staff,0,1,20,20
1715637302848,MCWP 50R,E00,518795,Staff,0,2,20,20
1715637302848,MCWP 50R,F00,518796,Staff,0,1,20,20
1715637302848,MCWP 50R,G00,518797,Staff,0,1,20,20
1715637303969,MMW 12R,A01,514034,Herbst; Matthew,0,2,16,16
1715637303969,MMW 12R,A02,514035,Herbst; Matthew,0,0,16,16
1715637305042,MMW 13R,A01,514037,Staff,0,5,16,16
1715637305042,MMW 13R,A02,514039,Staff,0,5,16,16
1715637305042,MMW 13R,A03,628519,Staff,0,4,16,16
1715637307282,SIO 295LS,A00,523233,Staff,10,0,30,20
1715637308486,SIO 295S,A00,523232,Staff,10,0,30,20
1715637309724,SIOC 290S,A01,637330,Merrifield; Mark A,21,0,30,9
1715637310833,SIOC 291S,A01,637333,Gabriel; Corey John,21,0,30,9
1715637312026,SOCI 117,A01,494376,Staff,0,5,5,5
1715637313270,WES 237B,A00,494380,Staff,10,0,20,10
1715637315846,AESE 279B,A00,494370,Wade; Jon P,0,0,33,33
1715637316888,AIP 97,001,660915,Van Den Einde; Yael Dahlia,9998,0,9999,1
1715637317982,AIP 197,001,627712,Vespa; Emanuel Ignacio,9995,0,9999,4
1715637317982,AIP 197,002,650778,Amir; On,9998,0,9999,1
1715637317982,AIP 197,003,650933,Avenancio-Leon; Carlos,9998,0,9999,1
1715637317982,AIP 197,004,658530,Heyman; Gail D.,9998,0,9999,1
1715637317982,AIP 197,005,658631,Neal; Sonya E,9998,0,9999,1
1715637317982,AIP 197,006,658671,Du; Songzi,9998,0,9999,1
1715637319055,ANAR 135S,A00,494369,Braswell; Geoffrey E.,0,0,0,0
1715637320179,BENG 196,001,628496,Engler; Adam J.,9998,0,9999,1
1715637320179,BENG 196,002,660916,Watson; John Thomas,9998,0,9999,1
1715637321422,BISP 197,001,650773,Wilhelm; James E.,9994,0,9999,5
1715637321422,BISP 197,002,658904,Coleman; Aaron B.,9998,0,9999,1
1715637322556,CAT 124RS,A01,519847,Geibel; William,0,0,20,20
1715637323845,CAT 125RS,A01,515971,Geibel; William,0,0,20,20
1715637325124,CLRE 250,A00,511389,Morris; Sheldon,9992,0,9999,7
1715637326490,CLRE 251,A00,507176,Mehta; Ravindra L.,9992,0,9999,7
1715637326490,CLRE 251,B00,511410,Mehta; Ravindra L.,9998,0,9999,1
1715637327659,CLRE 252,A00,507189,Cuomo; Raphael Eduardo,9994,0,9999,5
1715637329092,CLRE 253,A00,507199,Vaida; Florin,9994,0,9999,5
1715637329092,CLRE 253,B00,507202,Vaida; Florin,9999,0,9999,0
1715637330410,CLRE 259,A00,507211,Patel; Hemal,9996,0,9999,3
1715637331595,CLRE 260,A00,507221,Cuomo; Raphael Eduardo,9999,0,9999,0
1715637332692,CLRE 297,001,507242,Cuomo; Raphael Eduardo,9999,0,9999,0
1715637334175,COGS 197,001,638244,Voytek; Bradley Thomas,9997,0,9999,2
1715637335225,CSE 191,A00,516875,Minnes Kemp; Mor Mia,9991,0,9999,8
1715637336590,CSE 197,001,637388,Minnes Kemp; Mor Mia,9992,0,9999,7
1715637337657,CSS 201S,A01,494383,Mignozzetti; Umberto,35,0,35,0
1715637338809,CSS 202S,A01,494387,Mignozzetti; Umberto,35,0,35,0
1715637339985,DSC 197,001,628532,Eldridge; Justin Matthew,9995,0,9999,4
1715637341161,EAP 100,A00,516065,Staff,9799,0,9999,200
1715637342318,ECE 45,A01,507414,Staff,31,0,60,29
1715637344693,ECE 111,A01,507420,Staff,11,0,50,39
1715637346182,ECE 197,001,548057,Sievenpiper; Daniel F.,9991,0,9999,8
1715637347319,EDS 115,A00,507243,Choi; Bailey Miyeon,7,0,28,21
1715637348455,EDS 117,A01,494379,Staff,0,6,34,34
1715637349901,EDS 125,A00,507246,Hopkins; Megan Beth,8,0,30,22
1715637350945,EDS 128A,A01,507264,Fargason; Sharon Gayle,6,0,26,20
1715637352046,EDS 128B,A01,507293,Pappas; Elizabeth,10,0,30,20
1715637353436,EDS 139,A00,507294,Fargason; Sharon Gayle,10,0,30,20
1715637353436,EDS 139,B00,507313,Pappas; Elizabeth,11,0,30,19
1715637354513,EDS 201,A00,507315,Staff,10,0,30,20
1715637355638,EDS 203,A01,507317,Halter; Christopher P.,10,0,30,20
1715637356739,EDS 204R,A01,507319,Halter; Christopher P.,0,3,30,30
1715637356739,EDS 204R,B01,507331,Heinzman; Erica M.,14,0,30,16
1715637357915,EDS 206R,A00,507332,Staff,0,4,30,30
1715637357915,EDS 206R,B00,507343,Staff,15,0,30,15
1715637359155,EDS 250,A00,507344,Hemans; Patricia Ann Benitez,20,0,40,20
1715637360369,EDS 281,A00,507345,Daly; Alan J.,18,0,18,0
1715637361524,EDS 284,A00,507350,Daly; Alan J.,16,0,16,0
1715637362659,EDS 286,A00,507359,Fine; Sarah,18,0,18,0
1715637363811,EDS 289C,A01,507361,Daly; Alan J.,18,0,18,0
1715637364993,EDS 290,A00,507366,Hofstetter; Carolyn,15,0,15,0
1715637366137,LIGM 5A,A00,507421,Fischer-Grunski; Eva K,17,0,20,3
1715637367461,LIGM 5B,A00,507423,Fischer-Grunski; Eva K,19,0,20,1
1715637368624,LIGM 5C,A00,507425,Fischer-Grunski; Eva K,19,0,20,1
1715637369821,LIIT 5AS,A00,507427,Carnelos; Chiara,20,0,20,0
1715637371017,LIIT 5BS,A00,507430,Carnelos; Chiara,20,0,20,0
1715637372202,LIIT 5CS,A00,507432,Carnelos; Chiara,20,0,20,0
1715637373441,LISP 5A,A00,507541,Munoz Sanchez; Alicia,11,0,20,9
1715637374625,LISP 5B,A00,507671,Munoz Sanchez; Alicia,9,0,20,11
1715637375797,LISP 5C,A00,507696,Munoz Sanchez; Alicia,9,0,20,11
1715637377057,MAE 197,001,528363,Boechler; Nicholas Sebastia,9998,0,9999,1
1715637378198,MATH 197,001,523477,Kedlaya; Kiran S.,9994,0,9999,5
1715637378198,MATH 197,002,563811,Zhang; Danna,9994,0,9999,5
1715637378198,MATH 197,003,628552,Dumitriu; Ioana,9998,0,9999,1
1715637378198,MATH 197,004,660885,Floyd; Eric,9998,0,9999,1
1715637379312,MCWP 40R,A00,518780,Staff,2,0,20,18
1715637379312,MCWP 40R,B00,518781,Staff,10,0,20,10
1715637379312,MCWP 40R,C00,518783,Staff,5,0,20,15
1715637380578,MCWP 50R,A00,518791,Staff,0,1,20,20
1715637380578,MCWP 50R,B00,518792,Staff,0,2,20,20
1715637380578,MCWP 50R,C00,518793,Staff,0,4,20,20
1715637380578,MCWP 50R,D00,518794,Staff,0,1,20,20
1715637380578,MCWP 50R,E00,518795,Staff,0,2,20,20
1715637380578,MCWP 50R,F00,518796,Staff,0,1,20,20
1715637380578,MCWP 50R,G00,518797,Staff,0,1,20,20
1715637381722,MMW 12R,A01,514034,Herbst; Matthew,0,2,16,16
1715637381722,MMW 12R,A02,514035,Herbst; Matthew,0,0,16,16
1715637382905,MMW 13R,A01,514037,Staff,0,5,16,16
1715637382905,MMW 13R,A02,514039,Staff,0,5,16,16
1715637382905,MMW 13R,A03,628519,Staff,0,4,16,16
1715637385234,SIO 295LS,A00,523233,Staff,10,0,30,20
1715637386341,SIO 295S,A00,523232,Staff,10,0,30,20
1715637387540,SIOC 290S,A01,637330,Merrifield; Mark A,21,0,30,9
1715637388762,SIOC 291S,A01,637333,Gabriel; Corey John,21,0,30,9
1715637389861,SOCI 117,A01,494376,Staff,0,5,5,5
1715637391038,WES 237B,A00,494380,Staff,10,0,20,10
1715637393817,AESE 279B,A00,494370,Wade; Jon P,0,0,33,33
1715637394902,AIP 97,001,660915,Van Den Einde; Yael Dahlia,9998,0,9999,1
1715637395983,AIP 197,001,627712,Vespa; Emanuel Ignacio,9995,0,9999,4
1715637395983,AIP 197,002,650778,Amir; On,9998,0,9999,1
1715637395983,AIP 197,003,650933,Avenancio-Leon; Carlos,9998,0,9999,1
1715637395983,AIP 197,004,658530,Heyman; Gail D.,9998,0,9999,1
1715637395983,AIP 197,005,658631,Neal; Sonya E,9998,0,9999,1
1715637395983,AIP 197,006,658671,Du; Songzi,9998,0,9999,1
1715637397212,ANAR 135S,A00,494369,Braswell; Geoffrey E.,0,0,0,0
1715637398444,BENG 196,001,628496,Engler; Adam J.,9998,0,9999,1
1715637398444,BENG 196,002,660916,Watson; John Thomas,9998,0,9999,1
1715637399647,BISP 197,001,650773,Wilhelm; James E.,9994,0,9999,5
1715637399647,BISP 197,002,658904,Coleman; Aaron B.,9998,0,9999,1
1715637400942,CAT 124RS,A01,519847,Geibel; William,0,0,20,20
1715637402134,CAT 125RS,A01,515971,Geibel; William,0,0,20,20
1715637403301,CLRE 250,A00,511389,Morris; Sheldon,9992,0,9999,7
1715637404490,CLRE 251,A00,507176,Mehta; Ravindra L.,9992,0,9999,7
1715637404490,CLRE 251,B00,511410,Mehta; Ravindra L.,9998,0,9999,1
1715637405686,CLRE 252,A00,507189,Cuomo; Raphael Eduardo,9994,0,9999,5
1715637407197,CLRE 253,A00,507199,Vaida; Florin,9994,0,9999,5
1715637407197,CLRE 253,B00,507202,Vaida; Florin,9999,0,9999,0
1715637408382,CLRE 259,A00,507211,Patel; Hemal,9996,0,9999,3
1715637409556,CLRE 260,A00,507221,Cuomo; Raphael Eduardo,9999,0,9999,0
1715637410783,CLRE 297,001,507242,Cuomo; Raphael Eduardo,9999,0,9999,0
1715637411892,COGS 197,001,638244,Voytek; Bradley Thomas,9997,0,9999,2
1715637413228,CSE 191,A00,516875,Minnes Kemp; Mor Mia,9991,0,9999,8
1715637414392,CSE 197,001,637388,Minnes Kemp; Mor Mia,9992,0,9999,7
1715637415519,CSS 201S,A01,494383,Mignozzetti; Umberto,35,0,35,0
1715637416845,CSS 202S,A01,494387,Mignozzetti; Umberto,35,0,35,0
1715637417959,DSC 197,001,628532,Eldridge; Justin Matthew,9995,0,9999,4
1715637419114,EAP 100,A00,516065,Staff,9799,0,9999,200
1715637420202,ECE 45,A01,507414,Staff,31,0,60,29
1715637422605,ECE 111,A01,507420,Staff,11,0,50,39
1715637423763,ECE 197,001,548057,Sievenpiper; Daniel F.,9991,0,9999,8
1715637424906,EDS 115,A00,507243,Choi; Bailey Miyeon,7,0,28,21
1715637426175,EDS 117,A01,494379,Staff,0,6,34,34
1715637427320,EDS 125,A00,507246,Hopkins; Megan Beth,8,0,30,22
1715637428481,EDS 128A,A01,507264,Fargason; Sharon Gayle,6,0,26,20
1715637429806,EDS 128B,A01,507293,Pappas; Elizabeth,10,0,30,20
1715637430905,EDS 139,A00,507294,Fargason; Sharon Gayle,10,0,30,20
1715637430905,EDS 139,B00,507313,Pappas; Elizabeth,11,0,30,19
1715637432102,EDS 201,A00,507315,Staff,10,0,30,20
1715637433265,EDS 203,A01,507317,Halter; Christopher P.,10,0,30,20
1715637434433,EDS 204R,A01,507319,Halter; Christopher P.,0,3,30,30
1715637434433,EDS 204R,B01,507331,Heinzman; Erica M.,14,0,30,16
1715637435633,EDS 206R,A00,507332,Staff,0,4,30,30
1715637435633,EDS 206R,B00,507343,Staff,15,0,30,15
1715637436800,EDS 250,A00,507344,Hemans; Patricia Ann Benitez,20,0,40,20
1715637437958,EDS 281,A00,507345,Daly; Alan J.,18,0,18,0
1715637439079,EDS 284,A00,507350,Daly; Alan J.,16,0,16,0
1715637440246,EDS 286,A00,507359,Fine; Sarah,18,0,18,0
1715637441432,EDS 289C,A01,507361,Daly; Alan J.,18,0,18,0
1715637442634,EDS 290,A00,507366,Hofstetter; Carolyn,15,0,15,0
1715637443859,LIGM 5A,A00,507421,Fischer-Grunski; Eva K,17,0,20,3
1715637444959,LIGM 5B,A00,507423,Fischer-Grunski; Eva K,19,0,20,1
1715637446071,LIGM 5C,A00,507425,Fischer-Grunski; Eva K,19,0,20,1
1715637447188,LIIT 5AS,A00,507427,Carnelos; Chiara,20,0,20,0
1715637448393,LIIT 5BS,A00,507430,Carnelos; Chiara,20,0,20,0
1715637449783,LIIT 5CS,A00,507432,Carnelos; Chiara,20,0,20,0
1715637451131,LISP 5A,A00,507541,Munoz Sanchez; Alicia,11,0,20,9
1715637452351,LISP 5B,A00,507671,Munoz Sanchez; Alicia,9,0,20,11
1715637453518,LISP 5C,A00,507696,Munoz Sanchez; Alicia,9,0,20,11
1715637454550,MAE 197,001,528363,Boechler; Nicholas Sebastia,9998,0,9999,1
1715637455651,MATH 197,001,523477,Kedlaya; Kiran S.,9994,0,9999,5
1715637455651,MATH 197,002,563811,Zhang; Danna,9994,0,9999,5
1715637455651,MATH 197,003,628552,Dumitriu; Ioana,9998,0,9999,1
1715637455651,MATH 197,004,660885,Floyd; Eric,9998,0,9999,1
1715637456718,MCWP 40R,A00,518780,Staff,2,0,20,18
1715637456718,MCWP 40R,B00,518781,Staff,10,0,20,10
1715637456718,MCWP 40R,C00,518783,Staff,5,0,20,15
1715637457803,MCWP 50R,A00,518791,Staff,0,1,20,20
1715637457803,MCWP 50R,B00,518792,Staff,0,2,20,20
1715637457803,MCWP 50R,C00,518793,Staff,0,4,20,20
1715637457803,MCWP 50R,D00,518794,Staff,0,1,20,20
1715637457803,MCWP 50R,E00,518795,Staff,0,2,20,20
1715637457803,MCWP 50R,F00,518796,Staff,0,1,20,20
1715637457803,MCWP 50R,G00,518797,Staff,0,1,20,20
1715637458990,MMW 12R,A01,514034,Herbst; Matthew,0,2,16,16
1715637458990,MMW 12R,A02,514035,Herbst; Matthew,0,0,16,16
1715637460118,MMW 13R,A01,514037,Staff,0,5,16,16
1715637460118,MMW 13R,A02,514039,Staff,0,5,16,16
1715637460118,MMW 13R,A03,628519,Staff,0,4,16,16
1715637462545,SIO 295LS,A00,523233,Staff,10,0,30,20
1715637463698,SIO 295S,A00,523232,Staff,10,0,30,20
1715637464894,SIOC 290S,A01,637330,Merrifield; Mark A,21,0,30,9
1715637466200,SIOC 291S,A01,637333,Gabriel; Corey John,21,0,30,9
1715637467428,SOCI 117,A01,494376,Staff,0,5,5,5
1715637468678,WES 237B,A00,494380,Staff,10,0,20,10
1715637471129,AESE 279B,A00,494370,Wade; Jon P,0,0,33,33
1715637472281,AIP 97,001,660915,Van Den Einde; Yael Dahlia,9998,0,9999,1
1715637473452,AIP 197,001,627712,Vespa; Emanuel Ignacio,9995,0,9999,4
1715637473452,AIP 197,002,650778,Amir; On,9998,0,9999,1
1715637473452,AIP 197,003,650933,Avenancio-Leon; Carlos,9998,0,9999,1
1715637473452,AIP 197,004,658530,Heyman; Gail D.,9998,0,9999,1
1715637473452,AIP 197,005,658631,Neal; Sonya E,9998,0,9999,1
1715637473452,AIP 197,006,658671,Du; Songzi,9998,0,9999,1
1715637474673,ANAR 135S,A00,494369,Braswell; Geoffrey E.,0,0,0,0
1715637475823,BENG 196,001,628496,Engler; Adam J.,9998,0,9999,1
1715637475823,BENG 196,002,660916,Watson; John Thomas,9998,0,9999,1
1715637476995,BISP 197,001,650773,Wilhelm; James E.,9994,0,9999,5
1715637476995,BISP 197,002,658904,Coleman; Aaron B.,9998,0,9999,1
1715637478269,CAT 124RS,A01,519847,Geibel; William,0,0,20,20
1715637479425,CAT 125RS,A01,515971,Geibel; William,0,0,20,20
1715637480529,CLRE 250,A00,511389,Morris; Sheldon,9992,0,9999,7
1715637482021,CLRE 251,A00,507176,Mehta; Ravindra L.,9992,0,9999,7
1715637482021,CLRE 251,B00,511410,Mehta; Ravindra L.,9998,0,9999,1
1715637483370,CLRE 252,A00,507189,Cuomo; Raphael Eduardo,9994,0,9999,5
1715637484594,CLRE 253,A00,507199,Vaida; Florin,9994,0,9999,5
1715637484594,CLRE 253,B00,507202,Vaida; Florin,9999,0,9999,0
1715637485630,CLRE 259,A00,507211,Patel; Hemal,9996,0,9999,3
1715637486741,CLRE 260,A00,507221,Cuomo; Raphael Eduardo,9999,0,9999,0
1715637488200,CLRE 297,001,507242,Cuomo; Raphael Eduardo,9999,0,9999,0
1715637489237,COGS 197,001,638244,Voytek; Bradley Thomas,9997,0,9999,2
1715637490407,CSE 191,A00,516875,Minnes Kemp; Mor Mia,9991,0,9999,8
1715637491788,CSE 197,001,637388,Minnes Kemp; Mor Mia,9992,0,9999,7
1715637492829,CSS 201S,A01,494383,Mignozzetti; Umberto,35,0,35,0
1715637493968,CSS 202S,A01,494387,Mignozzetti; Umberto,35,0,35,0
1715637495145,DSC 197,001,628532,Eldridge; Justin Matthew,9995,0,9999,4
1715637496415,EAP 100,A00,516065,Staff,9799,0,9999,200
1715637497633,ECE 45,A01,507414,Staff,31,0,60,29
1715637499959,ECE 111,A01,507420,Staff,11,0,50,39
1715637501109,ECE 197,001,548057,Sievenpiper; Daniel F.,9991,0,9999,8
1715637502394,EDS 115,A00,507243,Choi; Bailey Miyeon,7,0,28,21
1715637503635,EDS 117,A01,494379,Staff,0,6,34,34
1715637504738,EDS 125,A00,507246,Hopkins; Megan Beth,8,0,30,22
1715637505947,EDS 128A,A01,507264,Fargason; Sharon Gayle,6,0,26,20
1715637507207,EDS 128B,A01,507293,Pappas; Elizabeth,10,0,30,20
1715637508409,EDS 139,A00,507294,Fargason; Sharon Gayle,10,0,30,20
1715637508409,EDS 139,B00,507313,Pappas; Elizabeth,11,0,30,19
1715637509685,EDS 201,A00,507315,Staff,10,0,30,20
1715637510833,EDS 203,A01,507317,Halter; Christopher P.,10,0,30,20
1715637512027,EDS 204R,A01,507319,Halter; Christopher P.,0,3,30,30
1715637512027,EDS 204R,B01,507331,Heinzman; Erica M.,14,0,30,16
1715637513216,EDS 206R,A00,507332,Staff,0,4,30,30
1715637513216,EDS 206R,B00,507343,Staff,15,0,30,15
1715637514592,EDS 250,A00,507344,Hemans; Patricia Ann Benitez,20,0,40,20
1715637515741,EDS 281,A00,507345,Daly; Alan J.,18,0,18,0
1715637516956,EDS 284,A00,507350,Daly; Alan J.,16,0,16,0
1715637518008,EDS 286,A00,507359,Fine; Sarah,18,0,18,0
1715637519159,EDS 289C,A01,507361,Daly; Alan J.,18,0,18,0
1715637520371,EDS 290,A00,507366,Hofstetter; Carolyn,15,0,15,0
1715637521644,LIGM 5A,A00,507421,Fischer-Grunski; Eva K,17,0,20,3
1715637522890,LIGM 5B,A00,507423,Fischer-Grunski; Eva K,19,0,20,1
1715637524000,LIGM 5C,A00,507425,Fischer-Grunski; Eva K,19,0,20,1
1715637525222,LIIT 5AS,A00,507427,Carnelos; Chiara,20,0,20,0
1715637526318,LIIT 5BS,A00,507430,Carnelos; Chiara,20,0,20,0
1715637527588,LIIT 5CS,A00,507432,Carnelos; Chiara,20,0,20,0
1715637528710,LISP 5A,A00,507541,Munoz Sanchez; Alicia,11,0,20,9
1715637530168,LISP 5B,A00,507671,Munoz Sanchez; Alicia,9,0,20,11
1715637531413,LISP 5C,A00,507696,Munoz Sanchez; Alicia,9,0,20,11
1715637532566,MAE 197,001,528363,Boechler; Nicholas Sebastia,9998,0,9999,1
1715637533704,MATH 197,001,523477,Kedlaya; Kiran S.,9994,0,9999,5
1715637533704,MATH 197,002,563811,Zhang; Danna,9994,0,9999,5
1715637533704,MATH 197,003,628552,Dumitriu; Ioana,9998,0,9999,1
1715637533704,MATH 197,004,660885,Floyd; Eric,9998,0,9999,1
1715637534805,MCWP 40R,A00,518780,Staff,2,0,20,18
1715637534805,MCWP 40R,B00,518781,Staff,10,0,20,10
1715637534805,MCWP 40R,C00,518783,Staff,5,0,20,15
1715637535946,MCWP 50R,A00,518791,Staff,0,1,20,20
1715637535946,MCWP 50R,B00,518792,Staff,0,2,20,20
1715637535946,MCWP 50R,C00,518793,Staff,0,4,20,20
1715637535946,MCWP 50R,D00,518794,Staff,0,1,20,20
1715637535946,MCWP 50R,E00,518795,Staff,0,2,20,20
1715637535946,MCWP 50R,F00,518796,Staff,0,1,20,20
1715637535946,MCWP 50R,G00,518797,Staff,0,1,20,20
1715637537073,MMW 12R,A01,514034,Herbst; Matthew,0,2,16,16
1715637537073,MMW 12R,A02,514035,Herbst; Matthew,0,0,16,16
1715637538187,MMW 13R,A01,514037,Staff,0,5,16,16
1715637538187,MMW 13R,A02,514039,Staff,0,5,16,16
1715637538187,MMW 13R,A03,628519,Staff,0,4,16,16
1715637540618,SIO 295LS,A00,523233,Staff,10,0,30,20
1715637541779,SIO 295S,A00,523232,Staff,10,0,30,20
1715637542879,SIOC 290S,A01,637330,Merrifield; Mark A,21,0,30,9
1715637544197,SIOC 291S,A01,637333,Gabriel; Corey John,21,0,30,9
1715637545359,SOCI 117,A01,494376,Staff,0,5,5,5
1715637546803,WES 237B,A00,494380,Staff,10,0,20,10
1715637549242,AESE 279B,A00,494370,Wade; Jon P,0,0,33,33
1715637550358,AIP 97,001,660915,Van Den Einde; Yael Dahlia,9998,0,9999,1
1715637551498,AIP 197,001,627712,Vespa; Emanuel Ignacio,9995,0,9999,4
1715637551498,AIP 197,002,650778,Amir; On,9998,0,9999,1
1715637551498,AIP 197,003,650933,Avenancio-Leon; Carlos,9998,0,9999,1
1715637551498,AIP 197,004,658530,Heyman; Gail D.,9998,0,9999,1
1715637551498,AIP 197,005,658631,Neal; Sonya E,9998,0,9999,1
1715637551498,AIP 197,006,658671,Du; Songzi,9998,0,9999,1
1715637552582,ANAR 135S,A00,494369,Braswell; Geoffrey E.,0,0,0,0
1715637553723,BENG 196,001,628496,Engler; Adam J.,9998,0,9999,1
1715637553723,BENG 196,002,660916,Watson; John Thomas,9998,0,9999,1
1715637554766,BISP 197,001,650773,Wilhelm; James E.,9994,0,9999,5
1715637554766,BISP 197,002,658904,Coleman; Aaron B.,9998,0,9999,1
1715637555848,CAT 124RS,A01,519847,Geibel; William,0,0,20,20
1715637557030,CAT 125RS,A01,515971,Geibel; William,0,0,20,20
1715637558244,CLRE 250,A00,511389,Morris; Sheldon,9992,0,9999,7
1715637559488,CLRE 251,A00,507176,Mehta; Ravindra L.,9992,0,9999,7
1715637559488,CLRE 251,B00,511410,Mehta; Ravindra L.,9998,0,9999,1
1715637560618,CLRE 252,A00,507189,Cuomo; Raphael Eduardo,9994,0,9999,5
1715637561898,CLRE 253,A00,507199,Vaida; Florin,9994,0,9999,5
1715637561898,CLRE 253,B00,507202,Vaida; Florin,9999,0,9999,0
1715637563035,CLRE 259,A00,507211,Patel; Hemal,9996,0,9999,3
1715637564284,CLRE 260,A00,507221,Cuomo; Raphael Eduardo,9999,0,9999,0
1715637565718,CLRE 297,001,507242,Cuomo; Raphael Eduardo,9999,0,9999,0
1715637567021,COGS 197,001,638244,Voytek; Bradley Thomas,9997,0,9999,2
1715637568249,CSE 191,A00,516875,Minnes Kemp; Mor Mia,9991,0,9999,8
1715637569442,CSE 197,001,637388,Minnes Kemp; Mor Mia,9992,0,9999,7
1715637570663,CSS 201S,A01,494383,Mignozzetti; Umberto,35,0,35,0
1715637571777,CSS 202S,A01,494387,Mignozzetti; Umberto,35,0,35,0
1715637573017,DSC 197,001,628532,Eldridge; Justin Matthew,9995,0,9999,4
1715637574223,EAP 100,A00,516065,Staff,9799,0,9999,200
1715637575385,ECE 45,A01,507414,Staff,31,0,60,29
1715637577686,ECE 111,A01,507420,Staff,11,0,50,39
1715637578798,ECE 197,001,548057,Sievenpiper; Daniel F.,9991,0,9999,8
1715637579937,EDS 115,A00,507243,Choi; Bailey Miyeon,7,0,28,21
1715637581065,EDS 117,A01,494379,Staff,0,6,34,34
1715637582179,EDS 125,A00,507246,Hopkins; Megan Beth,8,0,30,22
1715637583365,EDS 128A,A01,507264,Fargason; Sharon Gayle,6,0,26,20
1715637584579,EDS 128B,A01,507293,Pappas; Elizabeth,10,0,30,20
1715637585789,EDS 139,A00,507294,Fargason; Sharon Gayle,10,0,30,20
1715637585789,EDS 139,B00,507313,Pappas; Elizabeth,11,0,30,19
1715637586894,EDS 201,A00,507315,Staff,10,0,30,20
1715637588240,EDS 203,A01,507317,Halter; Christopher P.,10,0,30,20
1715637589395,EDS 204R,A01,507319,Halter; Christopher P.,0,3,30,30
1715637589395,EDS 204R,B01,507331,Heinzman; Erica M.,14,0,30,16
1715637590583,EDS 206R,A00,507332,Staff,0,4,30,30
1715637590583,EDS 206R,B00,507343,Staff,15,0,30,15
1715637591934,EDS 250,A00,507344,Hemans; Patricia Ann Benitez,20,0,40,20
1715637593435,EDS 281,A00,507345,Daly; Alan J.,18,0,18,0
1715637594539,EDS 284,A00,507350,Daly; Alan J.,16,0,16,0
1715637595971,EDS 286,A00,507359,Fine; Sarah,18,0,18,0
1715637597137,EDS 289C,A01,507361,Daly; Alan J.,18,0,18,0
1715637598419,EDS 290,A00,507366,Hofstetter; Carolyn,15,0,15,0
1715637599568,LIGM 5A,A00,507421,Fischer-Grunski; Eva K,17,0,20,3
1715637600670,LIGM 5B,A00,507423,Fischer-Grunski; Eva K,19,0,20,1
1715637602068,LIGM 5C,A00,507425,Fischer-Grunski; Eva K,19,0,20,1
1715637604826,LIIT 5AS,A00,507427,Carnelos; Chiara,20,0,20,0
1715637606023,LIIT 5BS,A00,507430,Carnelos; Chiara,20,0,20,0
1715637607275,LIIT 5CS,A00,507432,Carnelos; Chiara,20,0,20,0
1715637608408,LISP 5A,A00,507541,Munoz Sanchez; Alicia,11,0,20,9
1715637609598,LISP 5B,A00,507671,Munoz Sanchez; Alicia,9,0,20,11
1715637610763,LISP 5C,A00,507696,Munoz Sanchez; Alicia,9,0,20,11
1715637611970,MAE 197,001,528363,Boechler; Nicholas Sebastia,9998,0,9999,1
1715637613179,MATH 197,001,523477,Kedlaya; Kiran S.,9994,0,9999,5
1715637613179,MATH 197,002,563811,Zhang; Danna,9994,0,9999,5
1715637613179,MATH 197,003,628552,Dumitriu; Ioana,9998,0,9999,1
1715637613179,MATH 197,004,660885,Floyd; Eric,9998,0,9999,1
1715637614303,MCWP 40R,A00,518780,Staff,2,0,20,18
1715637614303,MCWP 40R,B00,518781,Staff,10,0,20,10
1715637614303,MCWP 40R,C00,518783,Staff,5,0,20,15
1715637615475,MCWP 50R,A00,518791,Staff,0,1,20,20
1715637615475,MCWP 50R,B00,518792,Staff,0,2,20,20
1715637615475,MCWP 50R,C00,518793,Staff,0,4,20,20
1715637615475,MCWP 50R,D00,518794,Staff,0,1,20,20
1715637615475,MCWP 50R,E00,518795,Staff,0,2,20,20
1715637615475,MCWP 50R,F00,518796,Staff,0,1,20,20
1715637615475,MCWP 50R,G00,518797,Staff,0,1,20,20
1715637616700,MMW 12R,A01,514034,Herbst; Matthew,0,2,16,16
1715637616700,MMW 12R,A02,514035,Herbst; Matthew,0,0,16,16
1715637617865,MMW 13R,A01,514037,Staff,0,5,16,16
1715637617865,MMW 13R,A02,514039,Staff,0,5,16,16
1715637617865,MMW 13R,A03,628519,Staff,0,4,16,16
1715637620230,SIO 295LS,A00,523233,Staff,10,0,30,20
1715637621349,SIO 295S,A00,523232,Staff,10,0,30,20
1715637622542,SIOC 290S,A01,637330,Merrifield; Mark A,21,0,30,9
1715637623708,SIOC 291S,A01,637333,Gabriel; Corey John,21,0,30,9
1715637624898,SOCI 117,A01,494376,Staff,0,5,5,5
1715637626107,WES 237B,A00,494380,Staff,10,0,20,10
1715637628537,AESE 279B,A00,494370,Wade; Jon P,0,0,33,33
1715637629610,AIP 97,001,660915,Van Den Einde; Yael Dahlia,9998,0,9999,1
1715637630800,AIP 197,001,627712,Vespa; Emanuel Ignacio,9995,0,9999,4
1715637630800,AIP 197,002,650778,Amir; On,9998,0,9999,1
1715637630800,AIP 197,003,650933,Avenancio-Leon; Carlos,9998,0,9999,1
1715637630800,AIP 197,004,658530,Heyman; Gail D.,9998,0,9999,1
1715637630800,AIP 197,005,658631,Neal; Sonya E,9998,0,9999,1
1715637630800,AIP 197,006,658671,Du; Songzi,9998,0,9999,1
1715637632091,ANAR 135S,A00,494369,Braswell; Geoffrey E.,0,0,0,0
1715637633179,BENG 196,001,628496,Engler; Adam J.,9998,0,9999,1
1715637633179,BENG 196,002,660916,Watson; John Thomas,9998,0,9999,1
1715637634396,BISP 197,001,650773,Wilhelm; James E.,9994,0,9999,5
1715637634396,BISP 197,002,658904,Coleman; Aaron B.,9998,0,9999,1
1715637635568,CAT 124RS,A01,519847,Geibel; William,0,0,20,20
1715637636738,CAT 125RS,A01,515971,Geibel; William,0,0,20,20
1715637637870,CLRE 250,A00,511389,Morris; Sheldon,9992,0,9999,7
1715637639049,CLRE 251,A00,507176,Mehta; Ravindra L.,9992,0,9999,7
1715637639049,CLRE 251,B00,511410,Mehta; Ravindra L.,9998,0,9999,1
1715637640150,CLRE 252,A00,507189,Cuomo; Raphael Eduardo,9994,0,9999,5
1715637641337,CLRE 253,A00,507199,Vaida; Florin,9994,0,9999,5
1715637641337,CLRE 253,B00,507202,Vaida; Florin,9999,0,9999,0
1715637642515,CLRE 259,A00,507211,Patel; Hemal,9996,0,9999,3
1715637643641,CLRE 260,A00,507221,Cuomo; Raphael Eduardo,9999,0,9999,0
1715637644845,CLRE 297,001,507242,Cuomo; Raphael Eduardo,9999,0,9999,0
1715637646143,COGS 197,001,638244,Voytek; Bradley Thomas,9997,0,9999,2
1715637647359,CSE 191,A00,516875,Minnes Kemp; Mor Mia,9991,0,9999,8
1715637648587,CSE 197,001,637388,Minnes Kemp; Mor Mia,9992,0,9999,7
1715637649708,CSS 201S,A01,494383,Mignozzetti; Umberto,35,0,35,0
1715637650816,CSS 202S,A01,494387,Mignozzetti; Umberto,35,0,35,0
1715637651995,DSC 197,001,628532,Eldridge; Justin Matthew,9995,0,9999,4
1715637653169,EAP 100,A00,516065,Staff,9799,0,9999,200
1715637654308,ECE 45,A01,507414,Staff,31,0,60,29
1715637656610,ECE 111,A01,507420,Staff,11,0,50,39
1715637657966,ECE 197,001,548057,Sievenpiper; Daniel F.,9991,0,9999,8
1715637659037,EDS 115,A00,507243,Choi; Bailey Miyeon,7,0,28,21
1715637660182,EDS 117,A01,494379,Staff,0,6,34,34
1715637661327,EDS 125,A00,507246,Hopkins; Megan Beth,8,0,30,22
1715637662546,EDS 128A,A01,507264,Fargason; Sharon Gayle,6,0,26,20
1715637663708,EDS 128B,A01,507293,Pappas; Elizabeth,10,0,30,20
1715637664801,EDS 139,A00,507294,Fargason; Sharon Gayle,10,0,30,20
1715637664801,EDS 139,B00,507313,Pappas; Elizabeth,11,0,30,19
1715637665902,EDS 201,A00,507315,Staff,10,0,30,20
1715637667113,EDS 203,A01,507317,Halter; Christopher P.,10,0,30,20
1715637668335,EDS 204R,A01,507319,Halter; Christopher P.,0,3,30,30
1715637668335,EDS 204R,B01,507331,Heinzman; Erica M.,14,0,30,16
1715637669671,EDS 206R,A00,507332,Staff,0,4,30,30
1715637669671,EDS 206R,B00,507343,Staff,15,0,30,15
1715637670711,EDS 250,A00,507344,Hemans; Patricia Ann Benitez,20,0,40,20
1715637671900,EDS 281,A00,507345,Daly; Alan J.,18,0,18,0
1715637673076,EDS 284,A00,507350,Daly; Alan J.,16,0,16,0
1715637674258,EDS 286,A00,507359,Fine; Sarah,18,0,18,0
1715637675485,EDS 289C,A01,507361,Daly; Alan J.,18,0,18,0
1715637676686,EDS 290,A00,507366,Hofstetter; Carolyn,15,0,15,0
1715637677864,LIGM 5A,A00,507421,Fischer-Grunski; Eva K,17,0,20,3
1715637679126,LIGM 5B,A00,507423,Fischer-Grunski; Eva K,19,0,20,1
1715637680245,LIGM 5C,A00,507425,Fischer-Grunski; Eva K,19,0,20,1
1715637681694,LIIT 5AS,A00,507427,Carnelos; Chiara,20,0,20,0
1715637682900,LIIT 5BS,A00,507430,Carnelos; Chiara,20,0,20,0
1715637684035,LIIT 5CS,A00,507432,Carnelos; Chiara,20,0,20,0
1715637685150,LISP 5A,A00,507541,Munoz Sanchez; Alicia,11,0,20,9
1715637686582,LISP 5B,A00,507671,Munoz Sanchez; Alicia,9,0,20,11
1715637687859,LISP 5C,A00,507696,Munoz Sanchez; Alicia,9,0,20,11
1715637689074,MAE 197,001,528363,Boechler; Nicholas Sebastia,9998,0,9999,1
1715637690304,MATH 197,001,523477,Kedlaya; Kiran S.,9994,0,9999,5
1715637690304,MATH 197,002,563811,Zhang; Danna,9994,0,9999,5
1715637690304,MATH 197,003,628552,Dumitriu; Ioana,9998,0,9999,1
1715637690304,MATH 197,004,660885,Floyd; Eric,9998,0,9999,1
1715637691389,MCWP 40R,A00,518780,Staff,2,0,20,18
1715637691389,MCWP 40R,B00,518781,Staff,10,0,20,10
1715637691389,MCWP 40R,C00,518783,Staff,5,0,20,15
1715637692529,MCWP 50R,A00,518791,Staff,0,1,20,20
1715637692529,MCWP 50R,B00,518792,Staff,0,2,20,20
1715637692529,MCWP 50R,C00,518793,Staff,0,4,20,20
1715637692529,MCWP 50R,D00,518794,Staff,0,1,20,20
1715637692529,MCWP 50R,E00,518795,Staff,0,2,20,20
1715637692529,MCWP 50R,F00,518796,Staff,0,1,20,20
1715637692529,MCWP 50R,G00,518797,Staff,0,1,20,20
1715637693878,MMW 12R,A01,514034,Herbst; Matthew,0,2,16,16
1715637693878,MMW 12R,A02,514035,Herbst; Matthew,0,0,16,16
1715637695205,MMW 13R,A01,514037,Staff,0,5,16,16
1715637695205,MMW 13R,A02,514039,Staff,0,5,16,16
1715637695205,MMW 13R,A03,628519,Staff,0,4,16,16
1715637697499,SIO 295LS,A00,523233,Staff,10,0,30,20
1715637698646,SIO 295S,A00,523232,Staff,10,0,30,20
1715637699801,SIOC 290S,A01,637330,Merrifield; Mark A,21,0,30,9
1715637700950,SIOC 291S,A01,637333,Gabriel; Corey John,21,0,30,9
1715637702035,SOCI 117,A01,494376,Staff,0,5,5,5
1715637703092,WES 237B,A00,494380,Staff,10,0,20,10
1715637705312,AESE 279B,A00,494370,Wade; Jon P,0,0,33,33
1715637706411,AIP 97,001,660915,Van Den Einde; Yael Dahlia,9998,0,9999,1
1715637707675,AIP 197,001,627712,Vespa; Emanuel Ignacio,9995,0,9999,4
1715637707675,AIP 197,002,650778,Amir; On,9998,0,9999,1
1715637707675,AIP 197,003,650933,Avenancio-Leon; Carlos,9998,0,9999,1
1715637707675,AIP 197,004,658530,Heyman; Gail D.,9998,0,9999,1
1715637707675,AIP 197,005,658631,Neal; Sonya E,9998,0,9999,1
1715637707675,AIP 197,006,658671,Du; Songzi,9998,0,9999,1
1715637708833,ANAR 135S,A00,494369,Braswell; Geoffrey E.,0,0,0,0
1715637709922,BENG 196,001,628496,Engler; Adam J.,9998,0,9999,1
1715637709922,BENG 196,002,660916,Watson; John Thomas,9998,0,9999,1
1715637711124,BISP 197,001,650773,Wilhelm; James E.,9994,0,9999,5
1715637711124,BISP 197,002,658904,Coleman; Aaron B.,9998,0,9999,1
1715637712285,CAT 124RS,A01,519847,Geibel; William,0,0,20,20
1715637713490,CAT 125RS,A01,515971,Geibel; William,0,0,20,20
1715637714605,CLRE 250,A00,511389,Morris; Sheldon,9992,0,9999,7
1715637715820,CLRE 251,A00,507176,Mehta; Ravindra L.,9992,0,9999,7
1715637715820,CLRE 251,B00,511410,Mehta; Ravindra L.,9998,0,9999,1
1715637716974,CLRE 252,A00,507189,Cuomo; Raphael Eduardo,9994,0,9999,5
1715637718123,CLRE 253,A00,507199,Vaida; Florin,9994,0,9999,5
1715637718123,CLRE 253,B00,507202,Vaida; Florin,9999,0,9999,0
1715637719340,CLRE 259,A00,507211,Patel; Hemal,9996,0,9999,3
1715637720486,CLRE 260,A00,507221,Cuomo; Raphael Eduardo,9999,0,9999,0
1715637721621,CLRE 297,001,507242,Cuomo; Raphael Eduardo,9999,0,9999,0
1715637722818,COGS 197,001,638244,Voytek; Bradley Thomas,9997,0,9999,2
1715637723997,CSE 191,A00,516875,Minnes Kemp; Mor Mia,9991,0,9999,8
1715637725193,CSE 197,001,637388,Minnes Kemp; Mor Mia,9992,0,9999,7
1715637726528,CSS 201S,A01,494383,Mignozzetti; Umberto,35,0,35,0
1715637727630,CSS 202S,A01,494387,Mignozzetti; Umberto,35,0,35,0
1715637728809,DSC 197,001,628532,Eldridge; Justin Matthew,9995,0,9999,4
1715637729971,EAP 100,A00,516065,Staff,9799,0,9999,200
1715637731150,ECE 45,A01,507414,Staff,31,0,60,29
1715637733473,ECE 111,A01,507420,Staff,11,0,50,39
1715637734621,ECE 197,001,548057,Sievenpiper; Daniel F.,9991,0,9999,8
1715637735799,EDS 115,A00,507243,Choi; Bailey Miyeon,7,0,28,21
1715637736969,EDS 117,A01,494379,Staff,0,6,34,34
1715637738018,EDS 125,A00,507246,Hopkins; Megan Beth,8,0,30,22
1715637739206,EDS 128A,A01,507264,Fargason; Sharon Gayle,6,0,26,20
1715637740387,EDS 128B,A01,507293,Pappas; Elizabeth,10,0,30,20
1715637741547,EDS 139,A00,507294,Fargason; Sharon Gayle,10,0,30,20
1715637741547,EDS 139,B00,507313,Pappas; Elizabeth,11,0,30,19
1715637742670,EDS 201,A00,507315,Staff,10,0,30,20
1715637743866,EDS 203,A01,507317,Halter; Christopher P.,10,0,30,20
1715637745098,EDS 204R,A01,507319,Halter; Christopher P.,0,3,30,30
1715637745098,EDS 204R,B01,507331,Heinzman; Erica M.,14,0,30,16
1715637746216,EDS 206R,A00,507332,Staff,0,4,30,30
1715637746216,EDS 206R,B00,507343,Staff,15,0,30,15
1715637747700,EDS 250,A00,507344,Hemans; Patricia Ann Benitez,20,0,40,20
1715637748841,EDS 281,A00,507345,Daly; Alan J.,18,0,18,0
1715637750288,EDS 284,A00,507350,Daly; Alan J.,16,0,16,0
1715637751458,EDS 286,A00,507359,Fine; Sarah,18,0,18,0
1715637752609,EDS 289C,A01,507361,Daly; Alan J.,18,0,18,0
1715637753795,EDS 290,A00,507366,Hofstetter; Carolyn,15,0,15,0
1715637754936,LIGM 5A,A00,507421,Fischer-Grunski; Eva K,17,0,20,3
1715637756087,LIGM 5B,A00,507423,Fischer-Grunski; Eva K,19,0,20,1
1715637757344,LIGM 5C,A00,507425,Fischer-Grunski; Eva K,19,0,20,1
1715637758639,LIIT 5AS,A00,507427,Carnelos; Chiara,20,0,20,0
1715637759924,LIIT 5BS,A00,507430,Carnelos; Chiara,20,0,20,0
1715637761082,LIIT 5CS,A00,507432,Carnelos; Chiara,20,0,20,0
1715637762336,LISP 5A,A00,507541,Munoz Sanchez; Alicia,11,0,20,9
1715637763538,LISP 5B,A00,507671,Munoz Sanchez; Alicia,9,0,20,11
1715637764862,LISP 5C,A00,507696,Munoz Sanchez; Alicia,9,0,20,11
1715637766032,MAE 197,001,528363,Boechler; Nicholas Sebastia,9998,0,9999,1
1715637767110,MATH 197,001,523477,Kedlaya; Kiran S.,9994,0,9999,5
1715637767110,MATH 197,002,563811,Zhang; Danna,9994,0,9999,5
1715637767110,MATH 197,003,628552,Dumitriu; Ioana,9998,0,9999,1
1715637767110,MATH 197,004,660885,Floyd; Eric,9998,0,9999,1
1715637768359,MCWP 40R,A00,518780,Staff,2,0,20,18
1715637768359,MCWP 40R,B00,518781,Staff,10,0,20,10
1715637768359,MCWP 40R,C00,518783,Staff,5,0,20,15
1715637769522,MCWP 50R,A00,518791,Staff,0,1,20,20
1715637769522,MCWP 50R,B00,518792,Staff,0,2,20,20
1715637769522,MCWP 50R,C00,518793,Staff,0,4,20,20
1715637769522,MCWP 50R,D00,518794,Staff,0,1,20,20
1715637769522,MCWP 50R,E00,518795,Staff,0,2,20,20
1715637769522,MCWP 50R,F00,518796,Staff,0,1,20,20
1715637769522,MCWP 50R,G00,518797,Staff,0,1,20,20
1715637770842,MMW 12R,A01,514034,Herbst; Matthew,0,2,16,16
1715637770842,MMW 12R,A02,514035,Herbst; Matthew,0,0,16,16
1715637772034,MMW 13R,A01,514037,Staff,0,5,16,16
1715637772034,MMW 13R,A02,514039,Staff,0,5,16,16
1715637772034,MMW 13R,A03,628519,Staff,0,4,16,16
1715637774517,SIO 295LS,A00,523233,Staff,10,0,30,20
1715637775632,SIO 295S,A00,523232,Staff,10,0,30,20
1715637777088,SIOC 290S,A01,637330,Merrifield; Mark A,21,0,30,9
1715637778275,SIOC 291S,A01,637333,Gabriel; Corey John,21,0,30,9
1715637779459,SOCI 117,A01,494376,Staff,0,5,5,5
1715637780669,WES 237B,A00,494380,Staff,10,0,20,10
1715637783161,AESE 279B,A00,494370,Wade; Jon P,0,0,33,33
1715637784465,AIP 97,001,660915,Van Den Einde; Yael Dahlia,9998,0,9999,1
1715637785743,AIP 197,001,627712,Vespa; Emanuel Ignacio,9995,0,9999,4
1715637785743,AIP 197,002,650778,Amir; On,9998,0,9999,1
1715637785743,AIP 197,003,650933,Avenancio-Leon; Carlos,9998,0,9999,1
1715637785743,AIP 197,004,658530,Heyman; Gail D.,9998,0,9999,1
1715637785743,AIP 197,005,658631,Neal; Sonya E,9998,0,9999,1
1715637785743,AIP 197,006,658671,Du; Songzi,9998,0,9999,1
1715637787007,ANAR 135S,A00,494369,Braswell; Geoffrey E.,0,0,0,0
1715637788051,BENG 196,001,628496,Engler; Adam J.,9998,0,9999,1
1715637788051,BENG 196,002,660916,Watson; John Thomas,9998,0,9999,1
1715637789505,BISP 197,001,650773,Wilhelm; James E.,9994,0,9999,5
1715637789505,BISP 197,002,658904,Coleman; Aaron B.,9998,0,9999,1
1715637790924,CAT 124RS,A01,519847,Geibel; William,0,0,20,20
1715637791964,CAT 125RS,A01,515971,Geibel; William,0,0,20,20
1715637793192,CLRE 250,A00,511389,Morris; Sheldon,9992,0,9999,7
1715637794319,CLRE 251,A00,507176,Mehta; Ravindra L.,9992,0,9999,7
1715637794319,CLRE 251,B00,511410,Mehta; Ravindra L.,9998,0,9999,1
1715637795409,CLRE 252,A00,507189,Cuomo; Raphael Eduardo,9994,0,9999,5
1715637796626,CLRE 253,A00,507199,Vaida; Florin,9994,0,9999,5
1715637796626,CLRE 253,B00,507202,Vaida; Florin,9999,0,9999,0
1715637797783,CLRE 259,A00,507211,Patel; Hemal,9996,0,9999,3
1715637798952,CLRE 260,A00,507221,Cuomo; Raphael Eduardo,9999,0,9999,0
1715637800153,CLRE 297,001,507242,Cuomo; Raphael Eduardo,9999,0,9999,0
1715637801358,COGS 197,001,638244,Voytek; Bradley Thomas,9997,0,9999,2
1715637802477,CSE 191,A00,516875,Minnes Kemp; Mor Mia,9991,0,9999,8
1715637803679,CSE 197,001,637388,Minnes Kemp; Mor Mia,9992,0,9999,7
1715637804807,CSS 201S,A01,494383,Mignozzetti; Umberto,35,0,35,0
1715637805997,CSS 202S,A01,494387,Mignozzetti; Umberto,35,0,35,0
1715637807344,DSC 197,001,628532,Eldridge; Justin Matthew,9995,0,9999,4
1715637808469,EAP 100,A00,516065,Staff,9799,0,9999,200
1715637809678,ECE 45,A01,507414,Staff,31,0,60,29
1715637812014,ECE 111,A01,507420,Staff,11,0,50,39
1715637813161,ECE 197,001,548057,Sievenpiper; Daniel F.,9991,0,9999,8
1715637814325,EDS 115,A00,507243,Choi; Bailey Miyeon,7,0,28,21
1715637815636,EDS 117,A01,494379,Staff,0,6,34,34
1715637816702,EDS 125,A00,507246,Hopkins; Megan Beth,8,0,30,22
1715637817999,EDS 128A,A01,507264,Fargason; Sharon Gayle,6,0,26,20
1715637819092,EDS 128B,A01,507293,Pappas; Elizabeth,10,0,30,20
1715637820304,EDS 139,A00,507294,Fargason; Sharon Gayle,10,0,30,20
1715637820304,EDS 139,B00,507313,Pappas; Elizabeth,11,0,30,19
1715637821406,EDS 201,A00,507315,Staff,10,0,30,20
1715637822787,EDS 203,A01,507317,Halter; Christopher P.,10,0,30,20
1715637823985,EDS 204R,A01,507319,Halter; Christopher P.,0,3,30,30
1715637823985,EDS 204R,B01,507331,Heinzman; Erica M.,14,0,30,16
1715637825162,EDS 206R,A00,507332,Staff,0,4,30,30
1715637825162,EDS 206R,B00,507343,Staff,15,0,30,15
1715637826270,EDS 250,A00,507344,Hemans; Patricia Ann Benitez,20,0,40,20
1715637827464,EDS 281,A00,507345,Daly; Alan J.,18,0,18,0
1715637828660,EDS 284,A00,507350,Daly; Alan J.,16,0,16,0
1715637829887,EDS 286,A00,507359,Fine; Sarah,18,0,18,0
1715637831185,EDS 289C,A01,507361,Daly; Alan J.,18,0,18,0
1715637832354,EDS 290,A00,507366,Hofstetter; Carolyn,15,0,15,0
1715637833539,LIGM 5A,A00,507421,Fischer-Grunski; Eva K,17,0,20,3
1715637834665,LIGM 5B,A00,507423,Fischer-Grunski; Eva K,19,0,20,1
1715637835841,LIGM 5C,A00,507425,Fischer-Grunski; Eva K,19,0,20,1
1715637837044,LIIT 5AS,A00,507427,Carnelos; Chiara,20,0,20,0
1715637838212,LIIT 5BS,A00,507430,Carnelos; Chiara,20,0,20,0
1715637839729,LIIT 5CS,A00,507432,Carnelos; Chiara,20,0,20,0
1715637840859,LISP 5A,A00,507541,Munoz Sanchez; Alicia,11,0,20,9
1715637841946,LISP 5B,A00,507671,Munoz Sanchez; Alicia,9,0,20,11
1715637843597,LISP 5C,A00,507696,Munoz Sanchez; Alicia,9,0,20,11
1715637845081,MAE 197,001,528363,Boechler; Nicholas Sebastia,9998,0,9999,1
1715637846221,MATH 197,001,523477,Kedlaya; Kiran S.,9994,0,9999,5
1715637846221,MATH 197,002,563811,Zhang; Danna,9994,0,9999,5
1715637846221,MATH 197,003,628552,Dumitriu; Ioana,9998,0,9999,1
1715637846221,MATH 197,004,660885,Floyd; Eric,9998,0,9999,1
1715637847363,MCWP 40R,A00,518780,Staff,2,0,20,18
1715637847363,MCWP 40R,B00,518781,Staff,10,0,20,10
1715637847363,MCWP 40R,C00,518783,Staff,5,0,20,15
1715637848545,MCWP 50R,A00,518791,Staff,0,1,20,20
1715637848545,MCWP 50R,B00,518792,Staff,0,2,20,20
1715637848545,MCWP 50R,C00,518793,Staff,0,4,20,20
1715637848545,MCWP 50R,D00,518794,Staff,0,1,20,20
1715637848545,MCWP 50R,E00,518795,Staff,0,2,20,20
1715637848545,MCWP 50R,F00,518796,Staff,0,1,20,20
1715637848545,MCWP 50R,G00,518797,Staff,0,1,20,20
1715637849653,MMW 12R,A01,514034,Herbst; Matthew,0,2,16,16
1715637849653,MMW 12R,A02,514035,Herbst; Matthew,0,0,16,16
1715637850850,MMW 13R,A01,514037,Staff,0,5,16,16
1715637850850,MMW 13R,A02,514039,Staff,0,5,16,16
1715637850850,MMW 13R,A03,628519,Staff,0,4,16,16
1715637853238,SIO 295LS,A00,523233,Staff,10,0,30,20
1715637854379,SIO 295S,A00,523232,Staff,10,0,30,20
1715637855612,SIOC 290S,A01,637330,Merrifield; Mark A,21,0,30,9
1715637856866,SIOC 291S,A01,637333,Gabriel; Corey John,21,0,30,9
1715637858022,SOCI 117,A01,494376,Staff,0,5,5,5
1715637859215,WES 237B,A00,494380,Staff,10,0,20,10
1715637861531,AESE 279B,A00,494370,Wade; Jon P,0,0,33,33
1715637862723,AIP 97,001,660915,Van Den Einde; Yael Dahlia,9998,0,9999,1
1715637864146,AIP 197,001,627712,Vespa; Emanuel Ignacio,9995,0,9999,4
1715637864146,AIP 197,002,650778,Amir; On,9998,0,9999,1
1715637864146,AIP 197,003,650933,Avenancio-Leon; Carlos,9998,0,9999,1
1715637864146,AIP 197,004,658530,Heyman; Gail D.,9998,0,9999,1
1715637864146,AIP 197,005,658631,Neal; Sonya E,9998,0,9999,1
1715637864146,AIP 197,006,658671,Du; Songzi,9998,0,9999,1
1715637865330,ANAR 135S,A00,494369,Braswell; Geoffrey E.,0,0,0,0
1715637866517,BENG 196,001,628496,Engler; Adam J.,9998,0,9999,1
1715637866517,BENG 196,002,660916,Watson; John Thomas,9998,0,9999,1
1715637867833,BISP 197,001,650773,Wilhelm; James E.,9994,0,9999,5
1715637867833,BISP 197,002,658904,Coleman; Aaron B.,9998,0,9999,1
1715637869019,CAT 124RS,A01,519847,Geibel; William,0,0,20,20
1715637870275,CAT 125RS,A01,515971,Geibel; William,0,0,20,20
1715637871451,CLRE 250,A00,511389,Morris; Sheldon,9992,0,9999,7
1715637872584,CLRE 251,A00,507176,Mehta; Ravindra L.,9992,0,9999,7
1715637872584,CLRE 251,B00,511410,Mehta; Ravindra L.,9998,0,9999,1
1715637873778,CLRE 252,A00,507189,Cuomo; Raphael Eduardo,9994,0,9999,5
1715637874966,CLRE 253,A00,507199,Vaida; Florin,9994,0,9999,5
1715637874966,CLRE 253,B00,507202,Vaida; Florin,9999,0,9999,0
1715637876180,CLRE 259,A00,507211,Patel; Hemal,9996,0,9999,3
1715637877398,CLRE 260,A00,507221,Cuomo; Raphael Eduardo,9999,0,9999,0
1715637878628,CLRE 297,001,507242,Cuomo; Raphael Eduardo,9999,0,9999,0
1715637879798,COGS 197,001,638244,Voytek; Bradley Thomas,9997,0,9999,2
1715637880884,CSE 191,A00,516875,Minnes Kemp; Mor Mia,9991,0,9999,8
1715637882111,CSE 197,001,637388,Minnes Kemp; Mor Mia,9992,0,9999,7
1715637883277,CSS 201S,A01,494383,Mignozzetti; Umberto,35,0,35,0
1715637884444,CSS 202S,A01,494387,Mignozzetti; Umberto,35,0,35,0
1715637885598,DSC 197,001,628532,Eldridge; Justin Matthew,9995,0,9999,4
1715637886792,EAP 100,A00,516065,Staff,9799,0,9999,200
1715637887953,ECE 45,A01,507414,Staff,31,0,60,29
1715637890360,ECE 111,A01,507420,Staff,11,0,50,39
1715637891561,ECE 197,001,548057,Sievenpiper; Daniel F.,9991,0,9999,8
1715637892722,EDS 115,A00,507243,Choi; Bailey Miyeon,7,0,28,21
1715637893930,EDS 117,A01,494379,Staff,0,6,34,34
1715637895018,EDS 125,A00,507246,Hopkins; Megan Beth,8,0,30,22
1715637896202,EDS 128A,A01,507264,Fargason; Sharon Gayle,6,0,26,20
1715637897389,EDS 128B,A01,507293,Pappas; Elizabeth,10,0,30,20
1715637898513,EDS 139,A00,507294,Fargason; Sharon Gayle,10,0,30,20
1715637898513,EDS 139,B00,507313,Pappas; Elizabeth,11,0,30,19
1715637899586,EDS 201,A00,507315,Staff,10,0,30,20
1715637900751,EDS 203,A01,507317,Halter; Christopher P.,10,0,30,20
1715637901999,EDS 204R,A01,507319,Halter; Christopher P.,0,3,30,30
1715637901999,EDS 204R,B01,507331,Heinzman; Erica M.,14,0,30,16
1715637903034,EDS 206R,A00,507332,Staff,0,4,30,30
1715637903034,EDS 206R,B00,507343,Staff,15,0,30,15
1715637904131,EDS 250,A00,507344,Hemans; Patricia Ann Benitez,20,0,40,20
1715637905280,EDS 281,A00,507345,Daly; Alan J.,18,0,18,0
1715637906427,EDS 284,A00,507350,Daly; Alan J.,16,0,16,0
1715637907527,EDS 286,A00,507359,Fine; Sarah,18,0,18,0
1715637908724,EDS 289C,A01,507361,Daly; Alan J.,18,0,18,0
1715637909873,EDS 290,A00,507366,Hofstetter; Carolyn,15,0,15,0
1715637911074,LIGM 5A,A00,507421,Fischer-Grunski; Eva K,17,0,20,3
1715637912134,LIGM 5B,A00,507423,Fischer-Grunski; Eva K,19,0,20,1
1715637913326,LIGM 5C,A00,507425,Fischer-Grunski; Eva K,19,0,20,1
1715637914453,LIIT 5AS,A00,507427,Carnelos; Chiara,20,0,20,0
1715637915609,LIIT 5BS,A00,507430,Carnelos; Chiara,20,0,20,0
1715637916779,LIIT 5CS,A00,507432,Carnelos; Chiara,20,0,20,0
1715637918010,LISP 5A,A00,507541,Munoz Sanchez; Alicia,11,0,20,9
1715637919270,LISP 5B,A00,507671,Munoz Sanchez; Alicia,9,0,20,11
1715637920511,LISP 5C,A00,507696,Munoz Sanchez; Alicia,9,0,20,11
1715637921742,MAE 197,001,528363,Boechler; Nicholas Sebastia,9998,0,9999,1
1715637922846,MATH 197,001,523477,Kedlaya; Kiran S.,9994,0,9999,5
1715637922846,MATH 197,002,563811,Zhang; Danna,9994,0,9999,5
1715637922846,MATH 197,003,628552,Dumitriu; Ioana,9998,0,9999,1
1715637922846,MATH 197,004,660885,Floyd; Eric,9998,0,9999,1
1715637923979,MCWP 40R,A00,518780,Staff,2,0,20,18
1715637923979,MCWP 40R,B00,518781,Staff,10,0,20,10
1715637923979,MCWP 40R,C00,518783,Staff,5,0,20,15
1715637925094,MCWP 50R,A00,518791,Staff,0,1,20,20
1715637925094,MCWP 50R,B00,518792,Staff,0,2,20,20
1715637925094,MCWP 50R,C00,518793,Staff,0,4,20,20
1715637925094,MCWP 50R,D00,518794,Staff,0,1,20,20
1715637925094,MCWP 50R,E00,518795,Staff,0,2,20,20
1715637925094,MCWP 50R,F00,518796,Staff,0,1,20,20
1715637925094,MCWP 50R,G00,518797,Staff,0,1,20,20
1715637926280,MMW 12R,A01,514034,Herbst; Matthew,0,2,16,16
1715637926280,MMW 12R,A02,514035,Herbst; Matthew,0,0,16,16
1715637927454,MMW 13R,A01,514037,Staff,0,5,16,16
1715637927454,MMW 13R,A02,514039,Staff,0,5,16,16
1715637927454,MMW 13R,A03,628519,Staff,0,4,16,16
1715637929788,SIO 295LS,A00,523233,Staff,10,0,30,20
1715637931053,SIO 295S,A00,523232,Staff,10,0,30,20
1715637932206,SIOC 290S,A01,637330,Merrifield; Mark A,21,0,30,9
1715637933367,SIOC 291S,A01,637333,Gabriel; Corey John,21,0,30,9
1715637934549,SOCI 117,A01,494376,Staff,0,5,5,5
1715637935764,WES 237B,A00,494380,Staff,10,0,20,10
1715637938245,AESE 279B,A00,494370,Wade; Jon P,0,0,33,33
1715637939435,AIP 97,001,660915,Van Den Einde; Yael Dahlia,9998,0,9999,1
1715637940527,AIP 197,001,627712,Vespa; Emanuel Ignacio,9995,0,9999,4
1715637940527,AIP 197,002,650778,Amir; On,9998,0,9999,1
1715637940527,AIP 197,003,650933,Avenancio-Leon; Carlos,9998,0,9999,1
1715637940527,AIP 197,004,658530,Heyman; Gail D.,9998,0,9999,1
1715637940527,AIP 197,005,658631,Neal; Sonya E,9998,0,9999,1
1715637940527,AIP 197,006,658671,Du; Songzi,9998,0,9999,1
1715637941657,ANAR 135S,A00,494369,Braswell; Geoffrey E.,0,0,0,0
1715637942813,BENG 196,001,628496,Engler; Adam J.,9998,0,9999,1
1715637942813,BENG 196,002,660916,Watson; John Thomas,9998,0,9999,1
1715637944009,BISP 197,001,650773,Wilhelm; James E.,9994,0,9999,5
1715637944009,BISP 197,002,658904,Coleman; Aaron B.,9998,0,9999,1
1715637945187,CAT 124RS,A01,519847,Geibel; William,0,0,20,20
1715637946388,CAT 125RS,A01,515971,Geibel; William,0,0,20,20
1715637947517,CLRE 250,A00,511389,Morris; Sheldon,9992,0,9999,7
1715637948625,CLRE 251,A00,507176,Mehta; Ravindra L.,9992,0,9999,7
1715637948625,CLRE 251,B00,511410,Mehta; Ravindra L.,9998,0,9999,1
1715637949768,CLRE 252,A00,507189,Cuomo; Raphael Eduardo,9994,0,9999,5
1715637951045,CLRE 253,A00,507199,Vaida; Florin,9994,0,9999,5
1715637951045,CLRE 253,B00,507202,Vaida; Florin,9999,0,9999,0
1715637952299,CLRE 259,A00,507211,Patel; Hemal,9996,0,9999,3
1715637953467,CLRE 260,A00,507221,Cuomo; Raphael Eduardo,9999,0,9999,0
1715637954695,CLRE 297,001,507242,Cuomo; Raphael Eduardo,9999,0,9999,0
1715637955959,COGS 197,001,638244,Voytek; Bradley Thomas,9997,0,9999,2
1715637957231,CSE 191,A00,516875,Minnes Kemp; Mor Mia,9991,0,9999,8
1715637958478,CSE 197,001,637388,Minnes Kemp; Mor Mia,9992,0,9999,7
1715637959848,CSS 201S,A01,494383,Mignozzetti; Umberto,35,0,35,0
1715637960949,CSS 202S,A01,494387,Mignozzetti; Umberto,35,0,35,0
1715637962296,DSC 197,001,628532,Eldridge; Justin Matthew,9995,0,9999,4
1715637963650,EAP 100,A00,516065,Staff,9799,0,9999,200
1715637964817,ECE 45,A01,507414,Staff,31,0,60,29
1715637967253,ECE 111,A01,507420,Staff,11,0,50,39
1715637968522,ECE 197,001,548057,Sievenpiper; Daniel F.,9991,0,9999,8
1715637969697,EDS 115,A00,507243,Choi; Bailey Miyeon,7,0,28,21
1715637970885,EDS 117,A01,494379,Staff,0,6,34,34
1715637972015,EDS 125,A00,507246,Hopkins; Megan Beth,8,0,30,22
1715637973184,EDS 128A,A01,507264,Fargason; Sharon Gayle,6,0,26,20
1715637974290,EDS 128B,A01,507293,Pappas; Elizabeth,10,0,30,20
1715637975520,EDS 139,A00,507294,Fargason; Sharon Gayle,10,0,30,20
1715637975520,EDS 139,B00,507313,Pappas; Elizabeth,11,0,30,19
1715637976634,EDS 201,A00,507315,Staff,10,0,30,20
1715637977744,EDS 203,A01,507317,Halter; Christopher P.,10,0,30,20
1715637978904,EDS 204R,A01,507319,Halter; Christopher P.,0,3,30,30
1715637978904,EDS 204R,B01,507331,Heinzman; Erica M.,14,0,30,16
1715637980049,EDS 206R,A00,507332,Staff,0,4,30,30
1715637980049,EDS 206R,B00,507343,Staff,15,0,30,15
1715637981358,EDS 250,A00,507344,Hemans; Patricia Ann Benitez,20,0,40,20
1715637982473,EDS 281,A00,507345,Daly; Alan J.,18,0,18,0
1715637983660,EDS 284,A00,507350,Daly; Alan J.,16,0,16,0
1715637984911,EDS 286,A00,507359,Fine; Sarah,18,0,18,0
1715637986028,EDS 289C,A01,507361,Daly; Alan J.,18,0,18,0
1715637987200,EDS 290,A00,507366,Hofstetter; Carolyn,15,0,15,0
1715637988387,LIGM 5A,A00,507421,Fischer-Grunski; Eva K,17,0,20,3
1715637989653,LIGM 5B,A00,507423,Fischer-Grunski; Eva K,19,0,20,1
1715637990773,LIGM 5C,A00,507425,Fischer-Grunski; Eva K,19,0,20,1
1715637991938,LIIT 5AS,A00,507427,Carnelos; Chiara,20,0,20,0
1715637993273,LIIT 5BS,A00,507430,Carnelos; Chiara,20,0,20,0
1715637994615,LIIT 5CS,A00,507432,Carnelos; Chiara,20,0,20,0
1715637995710,LISP 5A,A00,507541,Munoz Sanchez; Alicia,11,0,20,9
1715637996899,LISP 5B,A00,507671,Munoz Sanchez; Alicia,9,0,20,11
1715637998163,LISP 5C,A00,507696,Munoz Sanchez; Alicia,9,0,20,11
1715637999276,MAE 197,001,528363,Boechler; Nicholas Sebastia,9998,0,9999,1
1715638000509,MATH 197,001,523477,Kedlaya; Kiran S.,9994,0,9999,5
1715638000509,MATH 197,002,563811,Zhang; Danna,9994,0,9999,5
1715638000509,MATH 197,003,628552,Dumitriu; Ioana,9998,0,9999,1
1715638000509,MATH 197,004,660885,Floyd; Eric,9998,0,9999,1
1715638001790,MCWP 40R,A00,518780,Staff,2,0,20,18
1715638001790,MCWP 40R,B00,518781,Staff,10,0,20,10
1715638001790,MCWP 40R,C00,518783,Staff,5,0,20,15
1715638002995,MCWP 50R,A00,518791,Staff,0,1,20,20
1715638002995,MCWP 50R,B00,518792,Staff,0,2,20,20
1715638002995,MCWP 50R,C00,518793,Staff,0,4,20,20
1715638002995,MCWP 50R,D00,518794,Staff,0,1,20,20
1715638002995,MCWP 50R,E00,518795,Staff,0,2,20,20
1715638002995,MCWP 50R,F00,518796,Staff,0,1,20,20
1715638002995,MCWP 50R,G00,518797,Staff,0,1,20,20
1715638004164,MMW 12R,A01,514034,Herbst; Matthew,0,2,16,16
1715638004164,MMW 12R,A02,514035,Herbst; Matthew,0,0,16,16
1715638005368,MMW 13R,A01,514037,Staff,0,5,16,16
1715638005368,MMW 13R,A02,514039,Staff,0,5,16,16
1715638005368,MMW 13R,A03,628519,Staff,0,4,16,16
1715638007960,SIO 295LS,A00,523233,Staff,10,0,30,20
1715638009326,SIO 295S,A00,523232,Staff,10,0,30,20
1715638010370,SIOC 290S,A01,637330,Merrifield; Mark A,21,0,30,9
1715638011458,SIOC 291S,A01,637333,Gabriel; Corey John,21,0,30,9
1715638012633,SOCI 117,A01,494376,Staff,0,5,5,5
1715638013864,WES 237B,A00,494380,Staff,10,0,20,10
1715638016546,AESE 279B,A00,494370,Wade; Jon P,0,0,33,33
1715638017744,AIP 97,001,660915,Van Den Einde; Yael Dahlia,9998,0,9999,1
1715638018910,AIP 197,001,627712,Vespa; Emanuel Ignacio,9995,0,9999,4
1715638018910,AIP 197,002,650778,Amir; On,9998,0,9999,1
1715638018910,AIP 197,003,650933,Avenancio-Leon; Carlos,9998,0,9999,1
1715638018910,AIP 197,004,658530,Heyman; Gail D.,9998,0,9999,1
1715638018910,AIP 197,005,658631,Neal; Sonya E,9998,0,9999,1
1715638018910,AIP 197,006,658671,Du; Songzi,9998,0,9999,1
1715638020223,ANAR 135S,A00,494369,Braswell; Geoffrey E.,0,0,0,0
1715638021472,BENG 196,001,628496,Engler; Adam J.,9998,0,9999,1
1715638021472,BENG 196,002,660916,Watson; John Thomas,9998,0,9999,1
1715638022728,BISP 197,001,650773,Wilhelm; James E.,9994,0,9999,5
1715638022728,BISP 197,002,658904,Coleman; Aaron B.,9998,0,9999,1
1715638024027,CAT 124RS,A01,519847,Geibel; William,0,0,20,20
1715638025177,CAT 125RS,A01,515971,Geibel; William,0,0,20,20
1715638026417,CLRE 250,A00,511389,Morris; Sheldon,9992,0,9999,7
1715638027551,CLRE 251,A00,507176,Mehta; Ravindra L.,9992,0,9999,7
1715638027551,CLRE 251,B00,511410,Mehta; Ravindra L.,9998,0,9999,1
1715638028719,CLRE 252,A00,507189,Cuomo; Raphael Eduardo,9994,0,9999,5
1715638029993,CLRE 253,A00,507199,Vaida; Florin,9994,0,9999,5
1715638029993,CLRE 253,B00,507202,Vaida; Florin,9999,0,9999,0
1715638031070,CLRE 259,A00,507211,Patel; Hemal,9996,0,9999,3
1715638032217,CLRE 260,A00,507221,Cuomo; Raphael Eduardo,9999,0,9999,0
1715638033398,CLRE 297,001,507242,Cuomo; Raphael Eduardo,9999,0,9999,0
1715638034611,COGS 197,001,638244,Voytek; Bradley Thomas,9997,0,9999,2
1715638035738,CSE 191,A00,516875,Minnes Kemp; Mor Mia,9991,0,9999,8
1715638037108,CSE 197,001,637388,Minnes Kemp; Mor Mia,9992,0,9999,7
1715638038340,CSS 201S,A01,494383,Mignozzetti; Umberto,35,0,35,0
1715638039530,CSS 202S,A01,494387,Mignozzetti; Umberto,35,0,35,0
1715638040830,DSC 197,001,628532,Eldridge; Justin Matthew,9995,0,9999,4
1715638042038,EAP 100,A00,516065,Staff,9799,0,9999,200
1715638043213,ECE 45,A01,507414,Staff,31,0,60,29
1715638045721,ECE 111,A01,507420,Staff,11,0,50,39
1715638046994,ECE 197,001,548057,Sievenpiper; Daniel F.,9991,0,9999,8
1715638048226,EDS 115,A00,507243,Choi; Bailey Miyeon,7,0,28,21
1715638049386,EDS 117,A01,494379,Staff,0,6,34,34
1715638050641,EDS 125,A00,507246,Hopkins; Megan Beth,8,0,30,22
1715638052053,EDS 128A,A01,507264,Fargason; Sharon Gayle,6,0,26,20
1715638053325,EDS 128B,A01,507293,Pappas; Elizabeth,10,0,30,20
1715638054485,EDS 139,A00,507294,Fargason; Sharon Gayle,10,0,30,20
1715638054485,EDS 139,B00,507313,Pappas; Elizabeth,11,0,30,19
1715638055764,EDS 201,A00,507315,Staff,10,0,30,20
1715638057021,EDS 203,A01,507317,Halter; Christopher P.,10,0,30,20
1715638058241,EDS 204R,A01,507319,Halter; Christopher P.,0,3,30,30
1715638058241,EDS 204R,B01,507331,Heinzman; Erica M.,14,0,30,16
1715638059438,EDS 206R,A00,507332,Staff,0,4,30,30
1715638059438,EDS 206R,B00,507343,Staff,15,0,30,15
1715638060778,EDS 250,A00,507344,Hemans; Patricia Ann Benitez,20,0,40,20
1715638061951,EDS 281,A00,507345,Daly; Alan J.,18,0,18,0
1715638063337,EDS 284,A00,507350,Daly; Alan J.,16,0,16,0
1715638064437,EDS 286,A00,507359,Fine; Sarah,18,0,18,0
1715638065548,EDS 289C,A01,507361,Daly; Alan J.,18,0,18,0
1715638066649,EDS 290,A00,507366,Hofstetter; Carolyn,15,0,15,0
1715638067789,LIGM 5A,A00,507421,Fischer-Grunski; Eva K,17,0,20,3
1715638068950,LIGM 5B,A00,507423,Fischer-Grunski; Eva K,19,0,20,1
1715638070138,LIGM 5C,A00,507425,Fischer-Grunski; Eva K,19,0,20,1
1715638071361,LIIT 5AS,A00,507427,Carnelos; Chiara,20,0,20,0
1715638072535,LIIT 5BS,A00,507430,Carnelos; Chiara,20,0,20,0
1715638073624,LIIT 5CS,A00,507432,Carnelos; Chiara,20,0,20,0
1715638074855,LISP 5A,A00,507541,Munoz Sanchez; Alicia,11,0,20,9
1715638076031,LISP 5B,A00,507671,Munoz Sanchez; Alicia,9,0,20,11
1715638077117,LISP 5C,A00,507696,Munoz Sanchez; Alicia,9,0,20,11
1715638078471,MAE 197,001,528363,Boechler; Nicholas Sebastia,9998,0,9999,1
1715638079558,MATH 197,001,523477,Kedlaya; Kiran S.,9994,0,9999,5
1715638079558,MATH 197,002,563811,Zhang; Danna,9994,0,9999,5
1715638079558,MATH 197,003,628552,Dumitriu; Ioana,9998,0,9999,1
1715638079558,MATH 197,004,660885,Floyd; Eric,9998,0,9999,1
1715638080695,MCWP 40R,A00,518780,Staff,2,0,20,18
1715638080695,MCWP 40R,B00,518781,Staff,10,0,20,10
1715638080695,MCWP 40R,C00,518783,Staff,5,0,20,15
1715638081931,MCWP 50R,A00,518791,Staff,0,1,20,20
1715638081931,MCWP 50R,B00,518792,Staff,0,2,20,20
1715638081931,MCWP 50R,C00,518793,Staff,0,4,20,20
1715638081931,MCWP 50R,D00,518794,Staff,0,1,20,20
1715638081931,MCWP 50R,E00,518795,Staff,0,2,20,20
1715638081931,MCWP 50R,F00,518796,Staff,0,1,20,20
1715638081931,MCWP 50R,G00,518797,Staff,0,1,20,20
1715638083137,MMW 12R,A01,514034,Herbst; Matthew,0,2,16,16
1715638083137,MMW 12R,A02,514035,Herbst; Matthew,0,0,16,16
1715638084250,MMW 13R,A01,514037,Staff,0,5,16,16
1715638084250,MMW 13R,A02,514039,Staff,0,5,16,16
1715638084250,MMW 13R,A03,628519,Staff,0,4,16,16
1715638086638,SIO 295LS,A00,523233,Staff,10,0,30,20
1715638087858,SIO 295S,A00,523232,Staff,10,0,30,20
1715638088985,SIOC 290S,A01,637330,Merrifield; Mark A,21,0,30,9
1715638090148,SIOC 291S,A01,637333,Gabriel; Corey John,21,0,30,9
1715638091257,SOCI 117,A01,494376,Staff,0,5,5,5
1715638092435,WES 237B,A00,494380,Staff,10,0,20,10
1715638094689,AESE 279B,A00,494370,Wade; Jon P,0,0,33,33
1715638095854,AIP 97,001,660915,Van Den Einde; Yael Dahlia,9998,0,9999,1
1715638097037,AIP 197,001,627712,Vespa; Emanuel Ignacio,9995,0,9999,4
1715638097037,AIP 197,002,650778,Amir; On,9998,0,9999,1
1715638097037,AIP 197,003,650933,Avenancio-Leon; Carlos,9998,0,9999,1
1715638097037,AIP 197,004,658530,Heyman; Gail D.,9998,0,9999,1
1715638097037,AIP 197,005,658631,Neal; Sonya E,9998,0,9999,1
1715638097037,AIP 197,006,658671,Du; Songzi,9998,0,9999,1
1715638098188,ANAR 135S,A00,494369,Braswell; Geoffrey E.,0,0,0,0
1715638099348,BENG 196,001,628496,Engler; Adam J.,9998,0,9999,1
1715638099348,BENG 196,002,660916,Watson; John Thomas,9998,0,9999,1
1715638100504,BISP 197,001,650773,Wilhelm; James E.,9994,0,9999,5
1715638100504,BISP 197,002,658904,Coleman; Aaron B.,9998,0,9999,1
1715638101690,CAT 124RS,A01,519847,Geibel; William,0,0,20,20
1715638102941,CAT 125RS,A01,515971,Geibel; William,0,0,20,20
1715638104168,CLRE 250,A00,511389,Morris; Sheldon,9992,0,9999,7
1715638105276,CLRE 251,A00,507176,Mehta; Ravindra L.,9992,0,9999,7
1715638105276,CLRE 251,B00,511410,Mehta; Ravindra L.,9998,0,9999,1
1715638106426,CLRE 252,A00,507189,Cuomo; Raphael Eduardo,9994,0,9999,5
1715638107642,CLRE 253,A00,507199,Vaida; Florin,9994,0,9999,5
1715638107642,CLRE 253,B00,507202,Vaida; Florin,9999,0,9999,0
1715638108816,CLRE 259,A00,507211,Patel; Hemal,9996,0,9999,3
1715638110245,CLRE 260,A00,507221,Cuomo; Raphael Eduardo,9999,0,9999,0
1715638111440,CLRE 297,001,507242,Cuomo; Raphael Eduardo,9999,0,9999,0
1715638112573,COGS 197,001,638244,Voytek; Bradley Thomas,9997,0,9999,2
1715638113746,CSE 191,A00,516875,Minnes Kemp; Mor Mia,9991,0,9999,8
1715638114952,CSE 197,001,637388,Minnes Kemp; Mor Mia,9992,0,9999,7
1715638116266,CSS 201S,A01,494383,Mignozzetti; Umberto,35,0,35,0
1715638117428,CSS 202S,A01,494387,Mignozzetti; Umberto,35,0,35,0
1715638118625,DSC 197,001,628532,Eldridge; Justin Matthew,9995,0,9999,4
1715638119823,EAP 100,A00,516065,Staff,9799,0,9999,200
1715638121019,ECE 45,A01,507414,Staff,31,0,60,29
1715638123400,ECE 111,A01,507420,Staff,11,0,50,39
1715638124656,ECE 197,001,548057,Sievenpiper; Daniel F.,9991,0,9999,8
1715638125831,EDS 115,A00,507243,Choi; Bailey Miyeon,7,0,28,21
1715638126961,EDS 117,A01,494379,Staff,0,6,34,34
1715638128156,EDS 125,A00,507246,Hopkins; Megan Beth,8,0,30,22
1715638129259,EDS 128A,A01,507264,Fargason; Sharon Gayle,6,0,26,20
1715638130452,EDS 128B,A01,507293,Pappas; Elizabeth,10,0,30,20
1715638131806,EDS 139,A00,507294,Fargason; Sharon Gayle,10,0,30,20
1715638131806,EDS 139,B00,507313,Pappas; Elizabeth,11,0,30,19
1715638133902,EDS 201,A00,507315,Staff,10,0,30,20
1715638135187,EDS 203,A01,507317,Halter; Christopher P.,10,0,30,20
1715638136414,EDS 204R,A01,507319,Halter; Christopher P.,0,3,30,30
1715638136414,EDS 204R,B01,507331,Heinzman; Erica M.,14,0,30,16
1715638137564,EDS 206R,A00,507332,Staff,0,4,30,30
1715638137564,EDS 206R,B00,507343,Staff,15,0,30,15
1715638138899,EDS 250,A00,507344,Hemans; Patricia Ann Benitez,20,0,40,20
1715638140065,EDS 281,A00,507345,Daly; Alan J.,18,0,18,0
1715638141107,EDS 284,A00,507350,Daly; Alan J.,16,0,16,0
1715638142747,EDS 286,A00,507359,Fine; Sarah,18,0,18,0
1715638143958,EDS 289C,A01,507361,Daly; Alan J.,18,0,18,0
1715638145162,EDS 290,A00,507366,Hofstetter; Carolyn,15,0,15,0
1715638146406,LIGM 5A,A00,507421,Fischer-Grunski; Eva K,17,0,20,3
1715638147751,LIGM 5B,A00,507423,Fischer-Grunski; Eva K,19,0,20,1
1715638148863,LIGM 5C,A00,507425,Fischer-Grunski; Eva K,19,0,20,1
1715638150033,LIIT 5AS,A00,507427,Carnelos; Chiara,20,0,20,0
1715638151250,LIIT 5BS,A00,507430,Carnelos; Chiara,20,0,20,0
1715638152401,LIIT 5CS,A00,507432,Carnelos; Chiara,20,0,20,0
1715638153554,LISP 5A,A00,507541,Munoz Sanchez; Alicia,11,0,20,9
1715638154656,LISP 5B,A00,507671,Munoz Sanchez; Alicia,9,0,20,11
1715638155850,LISP 5C,A00,507696,Munoz Sanchez; Alicia,9,0,20,11
1715638157018,MAE 197,001,528363,Boechler; Nicholas Sebastia,9998,0,9999,1
1715638158228,MATH 197,001,523477,Kedlaya; Kiran S.,9994,0,9999,5
1715638158228,MATH 197,002,563811,Zhang; Danna,9994,0,9999,5
1715638158228,MATH 197,003,628552,Dumitriu; Ioana,9998,0,9999,1
1715638158228,MATH 197,004,660885,Floyd; Eric,9998,0,9999,1
1715638159464,MCWP 40R,A00,518780,Staff,2,0,20,18
1715638159464,MCWP 40R,B00,518781,Staff,10,0,20,10
1715638159464,MCWP 40R,C00,518783,Staff,5,0,20,15
1715638160583,MCWP 50R,A00,518791,Staff,0,1,20,20
1715638160583,MCWP 50R,B00,518792,Staff,0,2,20,20
1715638160583,MCWP 50R,C00,518793,Staff,0,4,20,20
1715638160583,MCWP 50R,D00,518794,Staff,0,1,20,20
1715638160583,MCWP 50R,E00,518795,Staff,0,2,20,20
1715638160583,MCWP 50R,F00,518796,Staff,0,1,20,20
1715638160583,MCWP 50R,G00,518797,Staff,0,1,20,20
1715638161718,MMW 12R,A01,514034,Herbst; Matthew,0,2,16,16
1715638161718,MMW 12R,A02,514035,Herbst; Matthew,0,0,16,16
1715638162909,MMW 13R,A01,514037,Staff,0,5,16,16
1715638162909,MMW 13R,A02,514039,Staff,0,5,16,16
1715638162909,MMW 13R,A03,628519,Staff,0,4,16,16
1715638165211,SIO 295LS,A00,523233,Staff,10,0,30,20
1715638166350,SIO 295S,A00,523232,Staff,10,0,30,20
1715638167617,SIOC 290S,A01,637330,Merrifield; Mark A,21,0,30,9
1715638168789,SIOC 291S,A01,637333,Gabriel; Corey John,21,0,30,9
1715638169903,SOCI 117,A01,494376,Staff,0,5,5,5
1715638171089,WES 237B,A00,494380,Staff,10,0,20,10
1715638173690,AESE 279B,A00,494370,Wade; Jon P,0,0,33,33
1715638174795,AIP 97,001,660915,Van Den Einde; Yael Dahlia,9998,0,9999,1
1715638175966,AIP 197,001,627712,Vespa; Emanuel Ignacio,9995,0,9999,4
1715638175966,AIP 197,002,650778,Amir; On,9998,0,9999,1
1715638175966,AIP 197,003,650933,Avenancio-Leon; Carlos,9998,0,9999,1
1715638175966,AIP 197,004,658530,Heyman; Gail D.,9998,0,9999,1
1715638175966,AIP 197,005,658631,Neal; Sonya E,9998,0,9999,1
1715638175966,AIP 197,006,658671,Du; Songzi,9998,0,9999,1
1715638177215,ANAR 135S,A00,494369,Braswell; Geoffrey E.,0,0,0,0
1715638178448,BENG 196,001,628496,Engler; Adam J.,9998,0,9999,1
1715638178448,BENG 196,002,660916,Watson; John Thomas,9998,0,9999,1
1715638179662,BISP 197,001,650773,Wilhelm; James E.,9994,0,9999,5
1715638179662,BISP 197,002,658904,Coleman; Aaron B.,9998,0,9999,1
1715638180774,CAT 124RS,A01,519847,Geibel; William,0,0,20,20
1715638181874,CAT 125RS,A01,515971,Geibel; William,0,0,20,20
1715638183154,CLRE 250,A00,511389,Morris; Sheldon,9992,0,9999,7
1715638184221,CLRE 251,A00,507176,Mehta; Ravindra L.,9992,0,9999,7
1715638184221,CLRE 251,B00,511410,Mehta; Ravindra L.,9998,0,9999,1
1715638185445,CLRE 252,A00,507189,Cuomo; Raphael Eduardo,9994,0,9999,5
1715638186644,CLRE 253,A00,507199,Vaida; Florin,9994,0,9999,5
1715638186644,CLRE 253,B00,507202,Vaida; Florin,9999,0,9999,0
1715638187773,CLRE 259,A00,507211,Patel; Hemal,9996,0,9999,3
1715638188900,CLRE 260,A00,507221,Cuomo; Raphael Eduardo,9999,0,9999,0
1715638190040,CLRE 297,001,507242,Cuomo; Raphael Eduardo,9999,0,9999,0
1715638191187,COGS 197,001,638244,Voytek; Bradley Thomas,9997,0,9999,2
1715638192467,CSE 191,A00,516875,Minnes Kemp; Mor Mia,9991,0,9999,8
1715638193559,CSE 197,001,637388,Minnes Kemp; Mor Mia,9992,0,9999,7
1715638194785,CSS 201S,A01,494383,Mignozzetti; Umberto,35,0,35,0
1715638196078,CSS 202S,A01,494387,Mignozzetti; Umberto,35,0,35,0
1715638197279,DSC 197,001,628532,Eldridge; Justin Matthew,9995,0,9999,4
1715638198565,EAP 100,A00,516065,Staff,9799,0,9999,200
1715638199871,ECE 45,A01,507414,Staff,31,0,60,29
1715638202366,ECE 111,A01,507420,Staff,11,0,50,39
1715638203629,ECE 197,001,548057,Sievenpiper; Daniel F.,9991,0,9999,8
1715638204748,EDS 115,A00,507243,Choi; Bailey Miyeon,7,0,28,21
1715638205866,EDS 117,A01,494379,Staff,0,6,34,34
1715638207047,EDS 125,A00,507246,Hopkins; Megan Beth,8,0,30,22
1715638208220,EDS 128A,A01,507264,Fargason; Sharon Gayle,6,0,26,20
1715638209480,EDS 128B,A01,507293,Pappas; Elizabeth,10,0,30,20
1715638210664,EDS 139,A00,507294,Fargason; Sharon Gayle,10,0,30,20
1715638210664,EDS 139,B00,507313,Pappas; Elizabeth,11,0,30,19
1715638211925,EDS 201,A00,507315,Staff,10,0,30,20
1715638213078,EDS 203,A01,507317,Halter; Christopher P.,10,0,30,20
1715638214265,EDS 204R,A01,507319,Halter; Christopher P.,0,3,30,30
1715638214265,EDS 204R,B01,507331,Heinzman; Erica M.,14,0,30,16
1715638215356,EDS 206R,A00,507332,Staff,0,4,30,30
1715638215356,EDS 206R,B00,507343,Staff,15,0,30,15
1715638216588,EDS 250,A00,507344,Hemans; Patricia Ann Benitez,20,0,40,20
1715638217745,EDS 281,A00,507345,Daly; Alan J.,18,0,18,0
1715638219024,EDS 284,A00,507350,Daly; Alan J.,16,0,16,0
1715638220305,EDS 286,A00,507359,Fine; Sarah,18,0,18,0
1715638221476,EDS 289C,A01,507361,Daly; Alan J.,18,0,18,0
1715638222656,EDS 290,A00,507366,Hofstetter; Carolyn,15,0,15,0
1715638223908,LIGM 5A,A00,507421,Fischer-Grunski; Eva K,17,0,20,3
1715638225281,LIGM 5B,A00,507423,Fischer-Grunski; Eva K,19,0,20,1
1715638226476,LIGM 5C,A00,507425,Fischer-Grunski; Eva K,19,0,20,1
1715638227584,LIIT 5AS,A00,507427,Carnelos; Chiara,20,0,20,0
1715638228795,LIIT 5BS,A00,507430,Carnelos; Chiara,20,0,20,0
1715638229902,LIIT 5CS,A00,507432,Carnelos; Chiara,20,0,20,0
1715638231026,LISP 5A,A00,507541,Munoz Sanchez; Alicia,11,0,20,9
1715638232209,LISP 5B,A00,507671,Munoz Sanchez; Alicia,9,0,20,11
1715638233350,LISP 5C,A00,507696,Munoz Sanchez; Alicia,9,0,20,11
1715638234448,MAE 197,001,528363,Boechler; Nicholas Sebastia,9998,0,9999,1
1715638235656,MATH 197,001,523477,Kedlaya; Kiran S.,9994,0,9999,5
1715638235656,MATH 197,002,563811,Zhang; Danna,9994,0,9999,5
1715638235656,MATH 197,003,628552,Dumitriu; Ioana,9998,0,9999,1
1715638235656,MATH 197,004,660885,Floyd; Eric,9998,0,9999,1
1715638236841,MCWP 40R,A00,518780,Staff,2,0,20,18
1715638236841,MCWP 40R,B00,518781,Staff,10,0,20,10
1715638236841,MCWP 40R,C00,518783,Staff,5,0,20,15
1715638237973,MCWP 50R,A00,518791,Staff,0,1,20,20
1715638237973,MCWP 50R,B00,518792,Staff,0,2,20,20
1715638237973,MCWP 50R,C00,518793,Staff,0,4,20,20
1715638237973,MCWP 50R,D00,518794,Staff,0,1,20,20
1715638237973,MCWP 50R,E00,518795,Staff,0,2,20,20
1715638237973,MCWP 50R,F00,518796,Staff,0,1,20,20
1715638237973,MCWP 50R,G00,518797,Staff,0,1,20,20
1715638239274,MMW 12R,A01,514034,Herbst; Matthew,0,2,16,16
1715638239274,MMW 12R,A02,514035,Herbst; Matthew,0,0,16,16
1715638240469,MMW 13R,A01,514037,Staff,0,5,16,16
1715638240469,MMW 13R,A02,514039,Staff,0,5,16,16
1715638240469,MMW 13R,A03,628519,Staff,0,4,16,16
1715638242907,SIO 295LS,A00,523233,Staff,10,0,30,20
1715638243994,SIO 295S,A00,523232,Staff,10,0,30,20
1715638245238,SIOC 290S,A01,637330,Merrifield; Mark A,21,0,30,9
1715638246530,SIOC 291S,A01,637333,Gabriel; Corey John,21,0,30,9
1715638247688,SOCI 117,A01,494376,Staff,0,5,5,5
1715638248861,WES 237B,A00,494380,Staff,10,0,20,10
1715638251117,AESE 279B,A00,494370,Wade; Jon P,0,0,33,33
1715638252458,AIP 97,001,660915,Van Den Einde; Yael Dahlia,9998,0,9999,1
1715638253675,AIP 197,001,627712,Vespa; Emanuel Ignacio,9995,0,9999,4
1715638253675,AIP 197,002,650778,Amir; On,9998,0,9999,1
1715638253675,AIP 197,003,650933,Avenancio-Leon; Carlos,9998,0,9999,1
1715638253675,AIP 197,004,658530,Heyman; Gail D.,9998,0,9999,1
1715638253675,AIP 197,005,658631,Neal; Sonya E,9998,0,9999,1
1715638253675,AIP 197,006,658671,Du; Songzi,9998,0,9999,1
1715638254847,ANAR 135S,A00,494369,Braswell; Geoffrey E.,0,0,0,0
1715638256010,BENG 196,001,628496,Engler; Adam J.,9998,0,9999,1
1715638256010,BENG 196,002,660916,Watson; John Thomas,9998,0,9999,1
1715638257183,BISP 197,001,650773,Wilhelm; James E.,9994,0,9999,5
1715638257183,BISP 197,002,658904,Coleman; Aaron B.,9998,0,9999,1
1715638258308,CAT 124RS,A01,519847,Geibel; William,0,0,20,20
1715638259457,CAT 125RS,A01,515971,Geibel; William,0,0,20,20
1715638260634,CLRE 250,A00,511389,Morris; Sheldon,9992,0,9999,7
1715638261838,CLRE 251,A00,507176,Mehta; Ravindra L.,9992,0,9999,7
1715638261838,CLRE 251,B00,511410,Mehta; Ravindra L.,9998,0,9999,1
1715638263032,CLRE 252,A00,507189,Cuomo; Raphael Eduardo,9994,0,9999,5
1715638264193,CLRE 253,A00,507199,Vaida; Florin,9994,0,9999,5
1715638264193,CLRE 253,B00,507202,Vaida; Florin,9999,0,9999,0
1715638265384,CLRE 259,A00,507211,Patel; Hemal,9996,0,9999,3
1715638266609,CLRE 260,A00,507221,Cuomo; Raphael Eduardo,9999,0,9999,0
1715638267855,CLRE 297,001,507242,Cuomo; Raphael Eduardo,9999,0,9999,0
1715638269008,COGS 197,001,638244,Voytek; Bradley Thomas,9997,0,9999,2
1715638270181,CSE 191,A00,516875,Minnes Kemp; Mor Mia,9991,0,9999,8
1715638271338,CSE 197,001,637388,Minnes Kemp; Mor Mia,9992,0,9999,7
1715638272581,CSS 201S,A01,494383,Mignozzetti; Umberto,35,0,35,0
1715638273705,CSS 202S,A01,494387,Mignozzetti; Umberto,35,0,35,0
1715638274929,DSC 197,001,628532,Eldridge; Justin Matthew,9995,0,9999,4
1715638276128,EAP 100,A00,516065,Staff,9799,0,9999,200
1715638277290,ECE 45,A01,507414,Staff,31,0,60,29
1715638279455,ECE 111,A01,507420,Staff,11,0,50,39
1715638280642,ECE 197,001,548057,Sievenpiper; Daniel F.,9991,0,9999,8
1715638281790,EDS 115,A00,507243,Choi; Bailey Miyeon,7,0,28,21
1715638283005,EDS 117,A01,494379,Staff,0,6,34,34
1715638284211,EDS 125,A00,507246,Hopkins; Megan Beth,8,0,30,22
1715638285419,EDS 128A,A01,507264,Fargason; Sharon Gayle,6,0,26,20
1715638286573,EDS 128B,A01,507293,Pappas; Elizabeth,10,0,30,20
1715638287774,EDS 139,A00,507294,Fargason; Sharon Gayle,10,0,30,20
1715638287774,EDS 139,B00,507313,Pappas; Elizabeth,11,0,30,19
1715638288922,EDS 201,A00,507315,Staff,10,0,30,20
1715638290086,EDS 203,A01,507317,Halter; Christopher P.,10,0,30,20
1715638291232,EDS 204R,A01,507319,Halter; Christopher P.,0,3,30,30
1715638291232,EDS 204R,B01,507331,Heinzman; Erica M.,14,0,30,16
1715638292449,EDS 206R,A00,507332,Staff,0,4,30,30
1715638292449,EDS 206R,B00,507343,Staff,15,0,30,15
1715638293797,EDS 250,A00,507344,Hemans; Patricia Ann Benitez,20,0,40,20
1715638295004,EDS 281,A00,507345,Daly; Alan J.,18,0,18,0
1715638296120,EDS 284,A00,507350,Daly; Alan J.,16,0,16,0
1715638297420,EDS 286,A00,507359,Fine; Sarah,18,0,18,0
1715638298605,EDS 289C,A01,507361,Daly; Alan J.,18,0,18,0
1715638299688,EDS 290,A00,507366,Hofstetter; Carolyn,15,0,15,0
1715638300893,LIGM 5A,A00,507421,Fischer-Grunski; Eva K,17,0,20,3
1715638302073,LIGM 5B,A00,507423,Fischer-Grunski; Eva K,19,0,20,1
1715638303290,LIGM 5C,A00,507425,Fischer-Grunski; Eva K,19,0,20,1
1715638304499,LIIT 5AS,A00,507427,Carnelos; Chiara,20,0,20,0
1715638305799,LIIT 5BS,A00,507430,Carnelos; Chiara,20,0,20,0
1715638307416,LIIT 5CS,A00,507432,Carnelos; Chiara,20,0,20,0
1715638308636,LISP 5A,A00,507541,Munoz Sanchez; Alicia,11,0,20,9
1715638309763,LISP 5B,A00,507671,Munoz Sanchez; Alicia,9,0,20,11
1715638310950,LISP 5C,A00,507696,Munoz Sanchez; Alicia,9,0,20,11
1715638312151,MAE 197,001,528363,Boechler; Nicholas Sebastia,9998,0,9999,1
1715638313344,MATH 197,001,523477,Kedlaya; Kiran S.,9994,0,9999,5
1715638313344,MATH 197,002,563811,Zhang; Danna,9994,0,9999,5
1715638313344,MATH 197,003,628552,Dumitriu; Ioana,9998,0,9999,1
1715638313344,MATH 197,004,660885,Floyd; Eric,9998,0,9999,1
1715638314667,MCWP 40R,A00,518780,Staff,2,0,20,18
1715638314667,MCWP 40R,B00,518781,Staff,10,0,20,10
1715638314667,MCWP 40R,C00,518783,Staff,5,0,20,15
1715638315951,MCWP 50R,A00,518791,Staff,0,1,20,20
1715638315951,MCWP 50R,B00,518792,Staff,0,2,20,20
1715638315951,MCWP 50R,C00,518793,Staff,0,4,20,20
1715638315951,MCWP 50R,D00,518794,Staff,0,1,20,20
1715638315951,MCWP 50R,E00,518795,Staff,0,2,20,20
1715638315951,MCWP 50R,F00,518796,Staff,0,1,20,20
1715638315951,MCWP 50R,G00,518797,Staff,0,1,20,20
1715638317290,MMW 12R,A01,514034,Herbst; Matthew,0,2,16,16
1715638317290,MMW 12R,A02,514035,Herbst; Matthew,0,0,16,16
1715638318478,MMW 13R,A01,514037,Staff,0,5,16,16
1715638318478,MMW 13R,A02,514039,Staff,0,5,16,16
1715638318478,MMW 13R,A03,628519,Staff,0,4,16,16
1715638320795,SIO 295LS,A00,523233,Staff,10,0,30,20
1715638321972,SIO 295S,A00,523232,Staff,10,0,30,20
1715638323310,SIOC 290S,A01,637330,Merrifield; Mark A,21,0,30,9
1715638324525,SIOC 291S,A01,637333,Gabriel; Corey John,21,0,30,9
1715638325756,SOCI 117,A01,494376,Staff,0,5,5,5
1715638327061,WES 237B,A00,494380,Staff,10,0,20,10
1715638329727,AESE 279B,A00,494370,Wade; Jon P,0,0,33,33
1715638331242,AIP 97,001,660915,Van Den Einde; Yael Dahlia,9998,0,9999,1
1715638332843,AIP 197,001,627712,Vespa; Emanuel Ignacio,9995,0,9999,4
1715638332843,AIP 197,002,650778,Amir; On,9998,0,9999,1
1715638332843,AIP 197,003,650933,Avenancio-Leon; Carlos,9998,0,9999,1
1715638332843,AIP 197,004,658530,Heyman; Gail D.,9998,0,9999,1
1715638332843,AIP 197,005,658631,Neal; Sonya E,9998,0,9999,1
1715638332843,AIP 197,006,658671,Du; Songzi,9998,0,9999,1
1715638334257,ANAR 135S,A00,494369,Braswell; Geoffrey E.,0,0,0,0
1715638335357,BENG 196,001,628496,Engler; Adam J.,9998,0,9999,1
1715638335357,BENG 196,002,660916,Watson; John Thomas,9998,0,9999,1
1715638336607,BISP 197,001,650773,Wilhelm; James E.,9994,0,9999,5
1715638336607,BISP 197,002,658904,Coleman; Aaron B.,9998,0,9999,1
1715638337719,CAT 124RS,A01,519847,Geibel; William,0,0,20,20
1715638338748,CAT 125RS,A01,515971,Geibel; William,0,0,20,20
1715638339776,CLRE 250,A00,511389,Morris; Sheldon,9992,0,9999,7
1715638340808,CLRE 251,A00,507176,Mehta; Ravindra L.,9992,0,9999,7
1715638340808,CLRE 251,B00,511410,Mehta; Ravindra L.,9998,0,9999,1
1715638341848,CLRE 252,A00,507189,Cuomo; Raphael Eduardo,9994,0,9999,5
1715638342877,CLRE 253,A00,507199,Vaida; Florin,9994,0,9999,5
1715638342877,CLRE 253,B00,507202,Vaida; Florin,9999,0,9999,0
1715638343910,CLRE 259,A00,507211,Patel; Hemal,9996,0,9999,3
1715638344948,CLRE 260,A00,507221,Cuomo; Raphael Eduardo,9999,0,9999,0
1715638345979,CLRE 297,001,507242,Cuomo; Raphael Eduardo,9999,0,9999,0
1715638347013,COGS 197,001,638244,Voytek; Bradley Thomas,9997,0,9999,2
1715638348040,CSE 191,A00,516875,Minnes Kemp; Mor Mia,9991,0,9999,8
1715638349080,CSE 197,001,637388,Minnes Kemp; Mor Mia,9992,0,9999,7
1715638350110,CSS 201S,A01,494383,Mignozzetti; Umberto,35,0,35,0
1715638351145,CSS 202S,A01,494387,Mignozzetti; Umberto,35,0,35,0
1715638352171,DSC 197,001,628532,Eldridge; Justin Matthew,9995,0,9999,4
1715638353206,EAP 100,A00,516065,Staff,9799,0,9999,200
1715638354303,ECE 45,A01,507414,Staff,31,0,60,29
1715638356496,ECE 111,A01,507420,Staff,11,0,50,39
1715638357530,ECE 197,001,548057,Sievenpiper; Daniel F.,9991,0,9999,8
1715638358560,EDS 115,A00,507243,Choi; Bailey Miyeon,7,0,28,21
1715638359589,EDS 117,A01,494379,Staff,0,6,34,34
1715638360613,EDS 125,A00,507246,Hopkins; Megan Beth,8,0,30,22
1715638361644,EDS 128A,A01,507264,Fargason; Sharon Gayle,6,0,26,20
1715638362777,EDS 128B,A01,507293,Pappas; Elizabeth,10,0,30,20
1715638363806,EDS 139,A00,507294,Fargason; Sharon Gayle,10,0,30,20
1715638363806,EDS 139,B00,507313,Pappas; Elizabeth,11,0,30,19
1715638364840,EDS 201,A00,507315,Staff,10,0,30,20
1715638365871,EDS 203,A01,507317,Halter; Christopher P.,10,0,30,20
1715638367000,EDS 204R,A01,507319,Halter; Christopher P.,0,3,30,30
1715638367000,EDS 204R,B01,507331,Heinzman; Erica M.,14,0,30,16
1715638368033,EDS 206R,A00,507332,Staff,0,4,30,30
1715638368033,EDS 206R,B00,507343,Staff,15,0,30,15
1715638369078,EDS 250,A00,507344,Hemans; Patricia Ann Benitez,20,0,40,20
1715638370111,EDS 281,A00,507345,Daly; Alan J.,18,0,18,0
1715638371153,EDS 284,A00,507350,Daly; Alan J.,16,0,16,0
1715638372182,EDS 286,A00,507359,Fine; Sarah,18,0,18,0
1715638373261,EDS 289C,A01,507361,Daly; Alan J.,18,0,18,0
1715638374301,EDS 290,A00,507366,Hofstetter; Carolyn,15,0,15,0
1715638375351,LIGM 5A,A00,507421,Fischer-Grunski; Eva K,17,0,20,3
1715638376396,LIGM 5B,A00,507423,Fischer-Grunski; Eva K,19,0,20,1
1715638377424,LIGM 5C,A00,507425,Fischer-Grunski; Eva K,19,0,20,1
1715638378450,LIIT 5AS,A00,507427,Carnelos; Chiara,20,0,20,0
1715638379475,LIIT 5BS,A00,507430,Carnelos; Chiara,20,0,20,0
1715638380503,LIIT 5CS,A00,507432,Carnelos; Chiara,20,0,20,0
1715638381533,LISP 5A,A00,507541,Munoz Sanchez; Alicia,11,0,20,9
1715638382561,LISP 5B,A00,507671,Munoz Sanchez; Alicia,9,0,20,11
1715638383589,LISP 5C,A00,507696,Munoz Sanchez; Alicia,9,0,20,11
1715638384620,MAE 197,001,528363,Boechler; Nicholas Sebastia,9998,0,9999,1
1715638385645,MATH 197,001,523477,Kedlaya; Kiran S.,9994,0,9999,5
1715638385645,MATH 197,002,563811,Zhang; Danna,9994,0,9999,5
1715638385645,MATH 197,003,628552,Dumitriu; Ioana,9998,0,9999,1
1715638385645,MATH 197,004,660885,Floyd; Eric,9998,0,9999,1
1715638386677,MCWP 40R,A00,518780,Staff,2,0,20,18
1715638386677,MCWP 40R,B00,518781,Staff,10,0,20,10
1715638386677,MCWP 40R,C00,518783,Staff,5,0,20,15
1715638387702,MCWP 50R,A00,518791,Staff,0,1,20,20
1715638387702,MCWP 50R,B00,518792,Staff,0,2,20,20
1715638387702,MCWP 50R,C00,518793,Staff,0,4,20,20
1715638387702,MCWP 50R,D00,518794,Staff,0,1,20,20
1715638387702,MCWP 50R,E00,518795,Staff,0,2,20,20
1715638387702,MCWP 50R,F00,518796,Staff,0,1,20,20
1715638387702,MCWP 50R,G00,518797,Staff,0,1,20,20
1715638388726,MMW 12R,A01,514034,Herbst; Matthew,0,2,16,16
1715638388726,MMW 12R,A02,514035,Herbst; Matthew,0,0,16,16
1715638389757,MMW 13R,A01,514037,Staff,0,5,16,16
1715638389757,MMW 13R,A02,514039,Staff,0,5,16,16
1715638389757,MMW 13R,A03,628519,Staff,0,4,16,16
1715638391810,SIO 295LS,A00,523233,Staff,10,0,30,20
1715638392841,SIO 295S,A00,523232,Staff,10,0,30,20
1715638393865,SIOC 290S,A01,637330,Merrifield; Mark A,21,0,30,9
1715638394896,SIOC 291S,A01,637333,Gabriel; Corey John,21,0,30,9
1715638395921,SOCI 117,A01,494376,Staff,0,5,5,5
1715638396945,WES 237B,A00,494380,Staff,10,0,20,10
1715638399022,AESE 279B,A00,494370,Wade; Jon P,0,0,33,33
1715638400049,AIP 97,001,660915,Van Den Einde; Yael Dahlia,9998,0,9999,1
1715638401079,AIP 197,001,627712,Vespa; Emanuel Ignacio,9995,0,9999,4
1715638401079,AIP 197,002,650778,Amir; On,9998,0,9999,1
1715638401079,AIP 197,003,650933,Avenancio-Leon; Carlos,9998,0,9999,1
1715638401079,AIP 197,004,658530,Heyman; Gail D.,9998,0,9999,1
1715638401079,AIP 197,005,658631,Neal; Sonya E,9998,0,9999,1
1715638401079,AIP 197,006,658671,Du; Songzi,9998,0,9999,1
1715638402110,ANAR 135S,A00,494369,Braswell; Geoffrey E.,0,0,0,0
1715638403137,BENG 196,001,628496,Engler; Adam J.,9998,0,9999,1
1715638403137,BENG 196,002,660916,Watson; John Thomas,9998,0,9999,1
1715638404166,BISP 197,001,650773,Wilhelm; James E.,9994,0,9999,5
1715638404166,BISP 197,002,658904,Coleman; Aaron B.,9998,0,9999,1
1715638405197,CAT 124RS,A01,519847,Geibel; William,0,0,20,20
1715638406224,CAT 125RS,A01,515971,Geibel; William,0,0,20,20
1715638407264,CLRE 250,A00,511389,Morris; Sheldon,9992,0,9999,7
1715638408295,CLRE 251,A00,507176,Mehta; Ravindra L.,9992,0,9999,7
1715638408295,CLRE 251,B00,511410,Mehta; Ravindra L.,9998,0,9999,1
1715638409319,CLRE 252,A00,507189,Cuomo; Raphael Eduardo,9994,0,9999,5
1715638410349,CLRE 253,A00,507199,Vaida; Florin,9994,0,9999,5
1715638410349,CLRE 253,B00,507202,Vaida; Florin,9999,0,9999,0
1715638411375,CLRE 259,A00,507211,Patel; Hemal,9996,0,9999,3
1715638412401,CLRE 260,A00,507221,Cuomo; Raphael Eduardo,9999,0,9999,0
1715638413423,CLRE 297,001,507242,Cuomo; Raphael Eduardo,9999,0,9999,0
1715638414449,COGS 197,001,638244,Voytek; Bradley Thomas,9997,0,9999,2
1715638415475,CSE 191,A00,516875,Minnes Kemp; Mor Mia,9991,0,9999,8
1715638416501,CSE 197,001,637388,Minnes Kemp; Mor Mia,9992,0,9999,7
1715638417527,CSS 201S,A01,494383,Mignozzetti; Umberto,35,0,35,0
1715638418555,CSS 202S,A01,494387,Mignozzetti; Umberto,35,0,35,0
1715638419580,DSC 197,001,628532,Eldridge; Justin Matthew,9995,0,9999,4
1715638420607,EAP 100,A00,516065,Staff,9799,0,9999,200
1715638421641,ECE 45,A01,507414,Staff,31,0,60,29
1715638423699,ECE 111,A01,507420,Staff,11,0,50,39
1715638424725,ECE 197,001,548057,Sievenpiper; Daniel F.,9991,0,9999,8
1715638425750,EDS 115,A00,507243,Choi; Bailey Miyeon,7,0,28,21
1715638426780,EDS 117,A01,494379,Staff,0,6,34,34
1715638427808,EDS 125,A00,507246,Hopkins; Megan Beth,8,0,30,22
1715638428837,EDS 128A,A01,507264,Fargason; Sharon Gayle,6,0,26,20
1715638429861,EDS 128B,A01,507293,Pappas; Elizabeth,10,0,30,20
1715638430887,EDS 139,A00,507294,Fargason; Sharon Gayle,10,0,30,20
1715638430887,EDS 139,B00,507313,Pappas; Elizabeth,11,0,30,19
1715638431913,EDS 201,A00,507315,Staff,10,0,30,20
1715638432937,EDS 203,A01,507317,Halter; Christopher P.,10,0,30,20
1715638433963,EDS 204R,A01,507319,Halter; Christopher P.,0,3,30,30
1715638433963,EDS 204R,B01,507331,Heinzman; Erica M.,14,0,30,16
1715638434990,EDS 206R,A00,507332,Staff,0,4,30,30
1715638434990,EDS 206R,B00,507343,Staff,15,0,30,15
1715638436020,EDS 250,A00,507344,Hemans; Patricia Ann Benitez,20,0,40,20
1715638437050,EDS 281,A00,507345,Daly; Alan J.,18,0,18,0
1715638438076,EDS 284,A00,507350,Daly; Alan J.,16,0,16,0
1715638439103,EDS 286,A00,507359,Fine; Sarah,18,0,18,0
1715638440132,EDS 289C,A01,507361,Daly; Alan J.,18,0,18,0
1715638441159,EDS 290,A00,507366,Hofstetter; Carolyn,15,0,15,0
1715638442190,LIGM 5A,A00,507421,Fischer-Grunski; Eva K,17,0,20,3
1715638443220,LIGM 5B,A00,507423,Fischer-Grunski; Eva K,19,0,20,1
1715638444249,LIGM 5C,A00,507425,Fischer-Grunski; Eva K,19,0,20,1
1715638445281,LIIT 5AS,A00,507427,Carnelos; Chiara,20,0,20,0
1715638446313,LIIT 5BS,A00,507430,Carnelos; Chiara,20,0,20,0
1715638447341,LIIT 5CS,A00,507432,Carnelos; Chiara,20,0,20,0
1715638448374,LISP 5A,A00,507541,Munoz Sanchez; Alicia,11,0,20,9
1715638449401,LISP 5B,A00,507671,Munoz Sanchez; Alicia,9,0,20,11
1715638450432,LISP 5C,A00,507696,Munoz Sanchez; Alicia,9,0,20,11
1715638451461,MAE 197,001,528363,Boechler; Nicholas Sebastia,9998,0,9999,1
1715638452488,MATH 197,001,523477,Kedlaya; Kiran S.,9994,0,9999,5
1715638452488,MATH 197,002,563811,Zhang; Danna,9994,0,9999,5
1715638452488,MATH 197,003,628552,Dumitriu; Ioana,9998,0,9999,1
1715638452488,MATH 197,004,660885,Floyd; Eric,9998,0,9999,1
1715638453519,MCWP 40R,A00,518780,Staff,2,0,20,18
1715638453519,MCWP 40R,B00,518781,Staff,10,0,20,10
1715638453519,MCWP 40R,C00,518783,Staff,5,0,20,15
1715638454546,MCWP 50R,A00,518791,Staff,0,1,20,20
1715638454546,MCWP 50R,B00,518792,Staff,0,2,20,20
1715638454546,MCWP 50R,C00,518793,Staff,0,4,20,20
1715638454546,MCWP 50R,D00,518794,Staff,0,1,20,20
1715638454546,MCWP 50R,E00,518795,Staff,0,2,20,20
1715638454546,MCWP 50R,F00,518796,Staff,0,1,20,20
1715638454546,MCWP 50R,G00,518797,Staff,0,1,20,20
1715638455572,MMW 12R,A01,514034,Herbst; Matthew,0,2,16,16
1715638455572,MMW 12R,A02,514035,Herbst; Matthew,0,0,16,16
1715638456600,MMW 13R,A01,514037,Staff,0,5,16,16
1715638456600,MMW 13R,A02,514039,Staff,0,5,16,16
1715638456600,MMW 13R,A03,628519,Staff,0,4,16,16
1715638458658,SIO 295LS,A00,523233,Staff,10,0,30,20
1715638459686,SIO 295S,A00,523232,Staff,10,0,30,20
1715638460713,SIOC 290S,A01,637330,Merrifield; Mark A,21,0,30,9
1715638461739,SIOC 291S,A01,637333,Gabriel; Corey John,21,0,30,9
1715638462764,SOCI 117,A01,494376,Staff,0,5,5,5
1715638463791,WES 237B,A00,494380,Staff,10,0,20,10
1715638465870,AESE 279B,A00,494370,Wade; Jon P,0,0,33,33
1715638466898,AIP 97,001,660915,Van Den Einde; Yael Dahlia,9998,0,9999,1
1715638467928,AIP 197,001,627712,Vespa; Emanuel Ignacio,9995,0,9999,4
1715638467928,AIP 197,002,650778,Amir; On,9998,0,9999,1
1715638467928,AIP 197,003,650933,Avenancio-Leon; Carlos,9998,0,9999,1
1715638467928,AIP 197,004,658530,Heyman; Gail D.,9998,0,9999,1
1715638467928,AIP 197,005,658631,Neal; Sonya E,9998,0,9999,1
1715638467928,AIP 197,006,658671,Du; Songzi,9998,0,9999,1
1715638468957,ANAR 135S,A00,494369,Braswell; Geoffrey E.,0,0,0,0
1715638469983,BENG 196,001,628496,Engler; Adam J.,9998,0,9999,1
1715638469983,BENG 196,002,660916,Watson; John Thomas,9998,0,9999,1
1715638471009,BISP 197,001,650773,Wilhelm; James E.,9994,0,9999,5
1715638471009,BISP 197,002,658904,Coleman; Aaron B.,9998,0,9999,1
1715638472035,CAT 124RS,A01,519847,Geibel; William,0,0,20,20
1715638473060,CAT 125RS,A01,515971,Geibel; William,0,0,20,20
1715638474086,CLRE 250,A00,511389,Morris; Sheldon,9992,0,9999,7
1715638475116,CLRE 251,A00,507176,Mehta; Ravindra L.,9992,0,9999,7
1715638475116,CLRE 251,B00,511410,Mehta; Ravindra L.,9998,0,9999,1
1715638476146,CLRE 252,A00,507189,Cuomo; Raphael Eduardo,9994,0,9999,5
1715638477175,CLRE 253,A00,507199,Vaida; Florin,9994,0,9999,5
1715638477175,CLRE 253,B00,507202,Vaida; Florin,9999,0,9999,0
1715638478201,CLRE 259,A00,507211,Patel; Hemal,9996,0,9999,3
1715638479224,CLRE 260,A00,507221,Cuomo; Raphael Eduardo,9999,0,9999,0
1715638480251,CLRE 297,001,507242,Cuomo; Raphael Eduardo,9999,0,9999,0
1715638481276,COGS 197,001,638244,Voytek; Bradley Thomas,9997,0,9999,2
1715638482303,CSE 191,A00,516875,Minnes Kemp; Mor Mia,9991,0,9999,8
1715638483328,CSE 197,001,637388,Minnes Kemp; Mor Mia,9992,0,9999,7
1715638484359,CSS 201S,A01,494383,Mignozzetti; Umberto,35,0,35,0
1715638485387,CSS 202S,A01,494387,Mignozzetti; Umberto,35,0,35,0
1715638486412,DSC 197,001,628532,Eldridge; Justin Matthew,9995,0,9999,4
1715638487438,EAP 100,A00,516065,Staff,9799,0,9999,200
1715638488466,ECE 45,A01,507414,Staff,31,0,60,29
1715638490514,ECE 111,A01,507420,Staff,11,0,50,39
1715638491539,ECE 197,001,548057,Sievenpiper; Daniel F.,9991,0,9999,8
1715638492578,EDS 115,A00,507243,Choi; Bailey Miyeon,7,0,28,21
1715638493604,EDS 117,A01,494379,Staff,0,6,34,34
1715638494628,EDS 125,A00,507246,Hopkins; Megan Beth,8,0,30,22
1715638495711,EDS 128A,A01,507264,Fargason; Sharon Gayle,6,0,26,20
1715638496737,EDS 128B,A01,507293,Pappas; Elizabeth,10,0,30,20
1715638497819,EDS 139,A00,507294,Fargason; Sharon Gayle,10,0,30,20
1715638497819,EDS 139,B00,507313,Pappas; Elizabeth,11,0,30,19
1715638498845,EDS 201,A00,507315,Staff,10,0,30,20
1715638499872,EDS 203,A01,507317,Halter; Christopher P.,10,0,30,20
1715638500901,EDS 204R,A01,507319,Halter; Christopher P.,0,3,30,30
1715638500901,EDS 204R,B01,507331,Heinzman; Erica M.,14,0,30,16
1715638501926,EDS 206R,A00,507332,Staff,0,4,30,30
1715638501926,EDS 206R,B00,507343,Staff,15,0,30,15
1715638502951,EDS 250,A00,507344,Hemans; Patricia Ann Benitez,20,0,40,20
1715638503981,EDS 281,A00,507345,Daly; Alan J.,18,0,18,0
1715638505005,EDS 284,A00,507350,Daly; Alan J.,16,0,16,0
1715638506033,EDS 286,A00,507359,Fine; Sarah,18,0,18,0
1715638507057,EDS 289C,A01,507361,Daly; Alan J.,18,0,18,0
1715638508087,EDS 290,A00,507366,Hofstetter; Carolyn,15,0,15,0
1715638509116,LIGM 5A,A00,507421,Fischer-Grunski; Eva K,17,0,20,3
1715638510146,LIGM 5B,A00,507423,Fischer-Grunski; Eva K,19,0,20,1
1715638511171,LIGM 5C,A00,507425,Fischer-Grunski; Eva K,19,0,20,1
1715638512196,LIIT 5AS,A00,507427,Carnelos; Chiara,20,0,20,0
1715638513222,LIIT 5BS,A00,507430,Carnelos; Chiara,20,0,20,0
1715638514248,LIIT 5CS,A00,507432,Carnelos; Chiara,20,0,20,0
1715638515277,LISP 5A,A00,507541,Munoz Sanchez; Alicia,11,0,20,9
1715638516306,LISP 5B,A00,507671,Munoz Sanchez; Alicia,9,0,20,11
1715638517334,LISP 5C,A00,507696,Munoz Sanchez; Alicia,9,0,20,11
1715638518360,MAE 197,001,528363,Boechler; Nicholas Sebastia,9998,0,9999,1
1715638519389,MATH 197,001,523477,Kedlaya; Kiran S.,9994,0,9999,5
1715638519389,MATH 197,002,563811,Zhang; Danna,9994,0,9999,5
1715638519389,MATH 197,003,628552,Dumitriu; Ioana,9998,0,9999,1
1715638519389,MATH 197,004,660885,Floyd; Eric,9998,0,9999,1
1715638520414,MCWP 40R,A00,518780,Staff,2,0,20,18
1715638520414,MCWP 40R,B00,518781,Staff,10,0,20,10
1715638520414,MCWP 40R,C00,518783,Staff,5,0,20,15
1715638521440,MCWP 50R,A00,518791,Staff,0,1,20,20
1715638521440,MCWP 50R,B00,518792,Staff,0,2,20,20
1715638521440,MCWP 50R,C00,518793,Staff,0,4,20,20
1715638521440,MCWP 50R,D00,518794,Staff,0,1,20,20
1715638521440,MCWP 50R,E00,518795,Staff,0,2,20,20
1715638521440,MCWP 50R,F00,518796,Staff,0,1,20,20
1715638521440,MCWP 50R,G00,518797,Staff,0,1,20,20
1715638522465,MMW 12R,A01,514034,Herbst; Matthew,0,2,16,16
1715638522465,MMW 12R,A02,514035,Herbst; Matthew,0,0,16,16
1715638523493,MMW 13R,A01,514037,Staff,0,5,16,16
1715638523493,MMW 13R,A02,514039,Staff,0,5,16,16
1715638523493,MMW 13R,A03,628519,Staff,0,4,16,16
1715638525546,SIO 295LS,A00,523233,Staff,10,0,30,20
1715638526572,SIO 295S,A00,523232,Staff,10,0,30,20
1715638527601,SIOC 290S,A01,637330,Merrifield; Mark A,21,0,30,9
1715638528629,SIOC 291S,A01,637333,Gabriel; Corey John,21,0,30,9
1715638529652,SOCI 117,A01,494376,Staff,0,5,5,5
1715638530677,WES 237B,A00,494380,Staff,10,0,20,10
1715638532744,AESE 279B,A00,494370,Wade; Jon P,0,0,33,33
1715638533772,AIP 97,001,660915,Van Den Einde; Yael Dahlia,9998,0,9999,1
1715638534802,AIP 197,001,627712,Vespa; Emanuel Ignacio,9995,0,9999,4
1715638534802,AIP 197,002,650778,Amir; On,9998,0,9999,1
1715638534802,AIP 197,003,650933,Avenancio-Leon; Carlos,9998,0,9999,1
1715638534802,AIP 197,004,658530,Heyman; Gail D.,9998,0,9999,1
1715638534802,AIP 197,005,658631,Neal; Sonya E,9998,0,9999,1
1715638534802,AIP 197,006,658671,Du; Songzi,9998,0,9999,1
1715638535831,ANAR 135S,A00,494369,Braswell; Geoffrey E.,0,0,0,0
1715638536859,BENG 196,001,628496,Engler; Adam J.,9998,0,9999,1
1715638536859,BENG 196,002,660916,Watson; John Thomas,9998,0,9999,1
1715638537885,BISP 197,001,650773,Wilhelm; James E.,9994,0,9999,5
1715638537885,BISP 197,002,658904,Coleman; Aaron B.,9998,0,9999,1
1715638538911,CAT 124RS,A01,519847,Geibel; William,0,0,20,20
1715638539935,CAT 125RS,A01,515971,Geibel; William,0,0,20,20
1715638540961,CLRE 250,A00,511389,Morris; Sheldon,9992,0,9999,7
1715638541987,CLRE 251,A00,507176,Mehta; Ravindra L.,9992,0,9999,7
1715638541987,CLRE 251,B00,511410,Mehta; Ravindra L.,9998,0,9999,1
1715638543011,CLRE 252,A00,507189,Cuomo; Raphael Eduardo,9994,0,9999,5
1715638544040,CLRE 253,A00,507199,Vaida; Florin,9994,0,9999,5
1715638544040,CLRE 253,B00,507202,Vaida; Florin,9999,0,9999,0
1715638545065,CLRE 259,A00,507211,Patel; Hemal,9996,0,9999,3
1715638546089,CLRE 260,A00,507221,Cuomo; Raphael Eduardo,9999,0,9999,0
1715638547116,CLRE 297,001,507242,Cuomo; Raphael Eduardo,9999,0,9999,0
1715638548144,COGS 197,001,638244,Voytek; Bradley Thomas,9997,0,9999,2
1715638549171,CSE 191,A00,516875,Minnes Kemp; Mor Mia,9991,0,9999,8
1715638550198,CSE 197,001,637388,Minnes Kemp; Mor Mia,9992,0,9999,7
1715638551227,CSS 201S,A01,494383,Mignozzetti; Umberto,35,0,35,0
1715638552255,CSS 202S,A01,494387,Mignozzetti; Umberto,35,0,35,0
1715638553283,DSC 197,001,628532,Eldridge; Justin Matthew,9995,0,9999,4
1715638554308,EAP 100,A00,516065,Staff,9799,0,9999,200
1715638555352,ECE 45,A01,507414,Staff,31,0,60,29
1715638557411,ECE 111,A01,507420,Staff,11,0,50,39
1715638558437,ECE 197,001,548057,Sievenpiper; Daniel F.,9991,0,9999,8
1715638559465,EDS 115,A00,507243,Choi; Bailey Miyeon,7,0,28,21
1715638560538,EDS 117,A01,494379,Staff,0,6,34,34
1715638561564,EDS 125,A00,507246,Hopkins; Megan Beth,8,0,30,22
1715638562590,EDS 128A,A01,507264,Fargason; Sharon Gayle,6,0,26,20
1715638563619,EDS 128B,A01,507293,Pappas; Elizabeth,10,0,30,20
1715638564644,EDS 139,A00,507294,Fargason; Sharon Gayle,10,0,30,20
1715638564644,EDS 139,B00,507313,Pappas; Elizabeth,11,0,30,19
1715638565669,EDS 201,A00,507315,Staff,10,0,30,20
1715638566698,EDS 203,A01,507317,Halter; Christopher P.,10,0,30,20
1715638567725,EDS 204R,A01,507319,Halter; Christopher P.,0,3,30,30
1715638567725,EDS 204R,B01,507331,Heinzman; Erica M.,14,0,30,16
1715638568754,EDS 206R,A00,507332,Staff,0,4,30,30
1715638568754,EDS 206R,B00,507343,Staff,15,0,30,15
1715638569779,EDS 250,A00,507344,Hemans; Patricia Ann Benitez,20,0,40,20
1715638570809,EDS 281,A00,507345,Daly; Alan J.,18,0,18,0
1715638571834,EDS 284,A00,507350,Daly; Alan J.,16,0,16,0
1715638572863,EDS 286,A00,507359,Fine; Sarah,18,0,18,0
1715638573902,EDS 289C,A01,507361,Daly; Alan J.,18,0,18,0
1715638574930,EDS 290,A00,507366,Hofstetter; Carolyn,15,0,15,0
1715638575957,LIGM 5A,A00,507421,Fischer-Grunski; Eva K,17,0,20,3
1715638576982,LIGM 5B,A00,507423,Fischer-Grunski; Eva K,19,0,20,1
1715638578008,LIGM 5C,A00,507425,Fischer-Grunski; Eva K,19,0,20,1
1715638579037,LIIT 5AS,A00,507427,Carnelos; Chiara,20,0,20,0
1715638580061,LIIT 5BS,A00,507430,Carnelos; Chiara,20,0,20,0
1715638581090,LIIT 5CS,A00,507432,Carnelos; Chiara,20,0,20,0
1715638582117,LISP 5A,A00,507541,Munoz Sanchez; Alicia,11,0,20,9
1715638583142,LISP 5B,A00,507671,Munoz Sanchez; Alicia,9,0,20,11
1715638584167,LISP 5C,A00,507696,Munoz Sanchez; Alicia,9,0,20,11
1715638585192,MAE 197,001,528363,Boechler; Nicholas Sebastia,9998,0,9999,1
1715638586220,MATH 197,001,523477,Kedlaya; Kiran S.,9994,0,9999,5
1715638586220,MATH 197,002,563811,Zhang; Danna,9994,0,9999,5
1715638586220,MATH 197,003,628552,Dumitriu; Ioana,9998,0,9999,1
1715638586220,MATH 197,004,660885,Floyd; Eric,9998,0,9999,1
1715638587246,MCWP 40R,A00,518780,Staff,2,0,20,18
1715638587246,MCWP 40R,B00,518781,Staff,10,0,20,10
1715638587246,MCWP 40R,C00,518783,Staff,5,0,20,15
1715638588274,MCWP 50R,A00,518791,Staff,0,1,20,20
1715638588274,MCWP 50R,B00,518792,Staff,0,2,20,20
1715638588274,MCWP 50R,C00,518793,Staff,0,4,20,20
1715638588274,MCWP 50R,D00,518794,Staff,0,1,20,20
1715638588274,MCWP 50R,E00,518795,Staff,0,2,20,20
1715638588274,MCWP 50R,F00,518796,Staff,0,1,20,20
1715638588274,MCWP 50R,G00,518797,Staff,0,1,20,20
1715638589303,MMW 12R,A01,514034,Herbst; Matthew,0,2,16,16
1715638589303,MMW 12R,A02,514035,Herbst; Matthew,0,0,16,16
1715638590328,MMW 13R,A01,514037,Staff,0,5,16,16
1715638590328,MMW 13R,A02,514039,Staff,0,5,16,16
1715638590328,MMW 13R,A03,628519,Staff,0,4,16,16
1715638592383,SIO 295LS,A00,523233,Staff,10,0,30,20
1715638593407,SIO 295S,A00,523232,Staff,10,0,30,20
1715638594433,SIOC 290S,A01,637330,Merrifield; Mark A,21,0,30,9
1715638595459,SIOC 291S,A01,637333,Gabriel; Corey John,21,0,30,9
1715638596487,SOCI 117,A01,494376,Staff,0,5,5,5
1715638597517,WES 237B,A00,494380,Staff,10,0,20,10
1715638599644,AESE 279B,A00,494370,Wade; Jon P,0,0,33,33
1715638600669,AIP 97,001,660915,Van Den Einde; Yael Dahlia,9998,0,9999,1
1715638601697,AIP 197,001,627712,Vespa; Emanuel Ignacio,9995,0,9999,4
1715638601697,AIP 197,002,650778,Amir; On,9998,0,9999,1
1715638601697,AIP 197,003,650933,Avenancio-Leon; Carlos,9998,0,9999,1
1715638601697,AIP 197,004,658530,Heyman; Gail D.,9998,0,9999,1
1715638601697,AIP 197,005,658631,Neal; Sonya E,9998,0,9999,1
1715638601697,AIP 197,006,658671,Du; Songzi,9998,0,9999,1
1715638602723,ANAR 135S,A00,494369,Braswell; Geoffrey E.,0,0,0,0
1715638603748,BENG 196,001,628496,Engler; Adam J.,9998,0,9999,1
1715638603748,BENG 196,002,660916,Watson; John Thomas,9998,0,9999,1
1715638604775,BISP 197,001,650773,Wilhelm; James E.,9994,0,9999,5
1715638604775,BISP 197,002,658904,Coleman; Aaron B.,9998,0,9999,1
1715638605800,CAT 124RS,A01,519847,Geibel; William,0,0,20,20
1715638606824,CAT 125RS,A01,515971,Geibel; William,0,0,20,20
1715638607855,CLRE 250,A00,511389,Morris; Sheldon,9992,0,9999,7
1715638608882,CLRE 251,A00,507176,Mehta; Ravindra L.,9992,0,9999,7
1715638608882,CLRE 251,B00,511410,Mehta; Ravindra L.,9998,0,9999,1
1715638609909,CLRE 252,A00,507189,Cuomo; Raphael Eduardo,9994,0,9999,5
1715638610934,CLRE 253,A00,507199,Vaida; Florin,9994,0,9999,5
1715638610934,CLRE 253,B00,507202,Vaida; Florin,9999,0,9999,0
1715638611962,CLRE 259,A00,507211,Patel; Hemal,9996,0,9999,3
1715638612990,CLRE 260,A00,507221,Cuomo; Raphael Eduardo,9999,0,9999,0
1715638614017,CLRE 297,001,507242,Cuomo; Raphael Eduardo,9999,0,9999,0
1715638615046,COGS 197,001,638244,Voytek; Bradley Thomas,9997,0,9999,2
1715638616073,CSE 191,A00,516875,Minnes Kemp; Mor Mia,9991,0,9999,8
1715638617098,CSE 197,001,637388,Minnes Kemp; Mor Mia,9992,0,9999,7
1715638618129,CSS 201S,A01,494383,Mignozzetti; Umberto,35,0,35,0
1715638619154,CSS 202S,A01,494387,Mignozzetti; Umberto,35,0,35,0
1715638620179,DSC 197,001,628532,Eldridge; Justin Matthew,9995,0,9999,4
1715638621203,EAP 100,A00,516065,Staff,9799,0,9999,200
1715638622235,ECE 45,A01,507414,Staff,31,0,60,29
1715638624289,ECE 111,A01,507420,Staff,11,0,50,39
1715638625317,ECE 197,001,548057,Sievenpiper; Daniel F.,9991,0,9999,8
1715638626343,EDS 115,A00,507243,Choi; Bailey Miyeon,7,0,28,21
1715638627369,EDS 117,A01,494379,Staff,0,6,34,34
1715638628395,EDS 125,A00,507246,Hopkins; Megan Beth,8,0,30,22
1715638629422,EDS 128A,A01,507264,Fargason; Sharon Gayle,6,0,26,20
1715638630453,EDS 128B,A01,507293,Pappas; Elizabeth,10,0,30,20
1715638631479,EDS 139,A00,507294,Fargason; Sharon Gayle,10,0,30,20
1715638631479,EDS 139,B00,507313,Pappas; Elizabeth,11,0,30,19
1715638632506,EDS 201,A00,507315,Staff,10,0,30,20
1715638633531,EDS 203,A01,507317,Halter; Christopher P.,10,0,30,20
1715638634558,EDS 204R,A01,507319,Halter; Christopher P.,0,3,30,30
1715638634558,EDS 204R,B01,507331,Heinzman; Erica M.,14,0,30,16
1715638635584,EDS 206R,A00,507332,Staff,0,4,30,30
1715638635584,EDS 206R,B00,507343,Staff,15,0,30,15
1715638636612,EDS 250,A00,507344,Hemans; Patricia Ann Benitez,20,0,40,20
1715638637640,EDS 281,A00,507345,Daly; Alan J.,18,0,18,0
1715638638665,EDS 284,A00,507350,Daly; Alan J.,16,0,16,0
1715638639691,EDS 286,A00,507359,Fine; Sarah,18,0,18,0
1715638640717,EDS 289C,A01,507361,Daly; Alan J.,18,0,18,0
1715638641743,EDS 290,A00,507366,Hofstetter; Carolyn,15,0,15,0
1715638642771,LIGM 5A,A00,507421,Fischer-Grunski; Eva K,17,0,20,3
1715638643796,LIGM 5B,A00,507423,Fischer-Grunski; Eva K,19,0,20,1
1715638644825,LIGM 5C,A00,507425,Fischer-Grunski; Eva K,19,0,20,1
1715638645850,LIIT 5AS,A00,507427,Carnelos; Chiara,20,0,20,0
1715638646883,LIIT 5BS,A00,507430,Carnelos; Chiara,20,0,20,0
1715638647910,LIIT 5CS,A00,507432,Carnelos; Chiara,20,0,20,0
1715638648937,LISP 5A,A00,507541,Munoz Sanchez; Alicia,11,0,20,9
1715638649966,LISP 5B,A00,507671,Munoz Sanchez; Alicia,9,0,20,11
1715638650991,LISP 5C,A00,507696,Munoz Sanchez; Alicia,9,0,20,11
1715638652017,MAE 197,001,528363,Boechler; Nicholas Sebastia,9998,0,9999,1
1715638653042,MATH 197,001,523477,Kedlaya; Kiran S.,9994,0,9999,5
1715638653042,MATH 197,002,563811,Zhang; Danna,9994,0,9999,5
1715638653042,MATH 197,003,628552,Dumitriu; Ioana,9998,0,9999,1
1715638653042,MATH 197,004,660885,Floyd; Eric,9998,0,9999,1
1715638654068,MCWP 40R,A00,518780,Staff,2,0,20,18
1715638654068,MCWP 40R,B00,518781,Staff,10,0,20,10
1715638654068,MCWP 40R,C00,518783,Staff,5,0,20,15
1715638655095,MCWP 50R,A00,518791,Staff,0,1,20,20
1715638655095,MCWP 50R,B00,518792,Staff,0,2,20,20
1715638655095,MCWP 50R,C00,518793,Staff,0,4,20,20
1715638655095,MCWP 50R,D00,518794,Staff,0,1,20,20
1715638655095,MCWP 50R,E00,518795,Staff,0,2,20,20
1715638655095,MCWP 50R,F00,518796,Staff,0,1,20,20
1715638655095,MCWP 50R,G00,518797,Staff,0,1,20,20
1715638656123,MMW 12R,A01,514034,Herbst; Matthew,0,2,16,16
1715638656123,MMW 12R,A02,514035,Herbst; Matthew,0,0,16,16
1715638657149,MMW 13R,A01,514037,Staff,0,5,16,16
1715638657149,MMW 13R,A02,514039,Staff,0,5,16,16
1715638657149,MMW 13R,A03,628519,Staff,0,4,16,16
1715638659204,SIO 295LS,A00,523233,Staff,10,0,30,20
1715638660236,SIO 295S,A00,523232,Staff,10,0,30,20
1715638661263,SIOC 290S,A01,637330,Merrifield; Mark A,21,0,30,9
1715638662289,SIOC 291S,A01,637333,Gabriel; Corey John,21,0,30,9
1715638663316,SOCI 117,A01,494376,Staff,0,5,5,5
1715638664346,WES 237B,A00,494380,Staff,10,0,20,10
1715638666423,AESE 279B,A00,494370,Wade; Jon P,0,0,33,33
1715638667451,AIP 97,001,660915,Van Den Einde; Yael Dahlia,9998,0,9999,1
1715638668480,AIP 197,001,627712,Vespa; Emanuel Ignacio,9995,0,9999,4
1715638668480,AIP 197,002,650778,Amir; On,9998,0,9999,1
1715638668480,AIP 197,003,650933,Avenancio-Leon; Carlos,9998,0,9999,1
1715638668480,AIP 197,004,658530,Heyman; Gail D.,9998,0,9999,1
1715638668480,AIP 197,005,658631,Neal; Sonya E,9998,0,9999,1
1715638668480,AIP 197,006,658671,Du; Songzi,9998,0,9999,1
1715638669508,ANAR 135S,A00,494369,Braswell; Geoffrey E.,0,0,0,0
1715638670534,BENG 196,001,628496,Engler; Adam J.,9998,0,9999,1
1715638670534,BENG 196,002,660916,Watson; John Thomas,9998,0,9999,1
1715638671560,BISP 197,001,650773,Wilhelm; James E.,9994,0,9999,5
1715638671560,BISP 197,002,658904,Coleman; Aaron B.,9998,0,9999,1
1715638672588,CAT 124RS,A01,519847,Geibel; William,0,0,20,20
1715638673617,CAT 125RS,A01,515971,Geibel; William,0,0,20,20
1715638674650,CLRE 250,A00,511389,Morris; Sheldon,9992,0,9999,7
1715638675680,CLRE 251,A00,507176,Mehta; Ravindra L.,9992,0,9999,7
1715638675680,CLRE 251,B00,511410,Mehta; Ravindra L.,9998,0,9999,1
1715638676706,CLRE 252,A00,507189,Cuomo; Raphael Eduardo,9994,0,9999,5
1715638677732,CLRE 253,A00,507199,Vaida; Florin,9994,0,9999,5
1715638677732,CLRE 253,B00,507202,Vaida; Florin,9999,0,9999,0
1715638678756,CLRE 259,A00,507211,Patel; Hemal,9996,0,9999,3
1715638679784,CLRE 260,A00,507221,Cuomo; Raphael Eduardo,9999,0,9999,0
1715638680808,CLRE 297,001,507242,Cuomo; Raphael Eduardo,9999,0,9999,0
1715638681834,COGS 197,001,638244,Voytek; Bradley Thomas,9997,0,9999,2
1715638682862,CSE 191,A00,516875,Minnes Kemp; Mor Mia,9991,0,9999,8
1715638683885,CSE 197,001,637388,Minnes Kemp; Mor Mia,9992,0,9999,7
1715638684917,CSS 201S,A01,494383,Mignozzetti; Umberto,35,0,35,0
1715638685943,CSS 202S,A01,494387,Mignozzetti; Umberto,35,0,35,0
1715638686971,DSC 197,001,628532,Eldridge; Justin Matthew,9995,0,9999,4
1715638687996,EAP 100,A00,516065,Staff,9799,0,9999,200
1715638689027,ECE 45,A01,507414,Staff,31,0,60,29
1715638691080,ECE 111,A01,507420,Staff,11,0,50,39
1715638692104,ECE 197,001,548057,Sievenpiper; Daniel F.,9991,0,9999,8
1715638693133,EDS 115,A00,507243,Choi; Bailey Miyeon,7,0,28,21
1715638694158,EDS 117,A01,494379,Staff,0,6,34,34
1715638695187,EDS 125,A00,507246,Hopkins; Megan Beth,8,0,30,22
1715638696212,EDS 128A,A01,507264,Fargason; Sharon Gayle,6,0,26,20
1715638697238,EDS 128B,A01,507293,Pappas; Elizabeth,10,0,30,20
1715638698262,EDS 139,A00,507294,Fargason; Sharon Gayle,10,0,30,20
1715638698262,EDS 139,B00,507313,Pappas; Elizabeth,11,0,30,19
1715638699286,EDS 201,A00,507315,Staff,10,0,30,20
1715638700312,EDS 203,A01,507317,Halter; Christopher P.,10,0,30,20
1715638701342,EDS 204R,A01,507319,Halter; Christopher P.,0,3,30,30
1715638701342,EDS 204R,B01,507331,Heinzman; Erica M.,14,0,30,16
1715638702369,EDS 206R,A00,507332,Staff,0,4,30,30
1715638702369,EDS 206R,B00,507343,Staff,15,0,30,15
1715638703464,EDS 250,A00,507344,Hemans; Patricia Ann Benitez,20,0,40,20
1715638704491,EDS 281,A00,507345,Daly; Alan J.,18,0,18,0
1715638705517,EDS 284,A00,507350,Daly; Alan J.,16,0,16,0
1715638706542,EDS 286,A00,507359,Fine; Sarah,18,0,18,0
1715638707568,EDS 289C,A01,507361,Daly; Alan J.,18,0,18,0
1715638708594,EDS 290,A00,507366,Hofstetter; Carolyn,15,0,15,0
1715638709619,LIGM 5A,A00,507421,Fischer-Grunski; Eva K,17,0,20,3
1715638710645,LIGM 5B,A00,507423,Fischer-Grunski; Eva K,19,0,20,1
1715638711669,LIGM 5C,A00,507425,Fischer-Grunski; Eva K,19,0,20,1
1715638712698,LIIT 5AS,A00,507427,Carnelos; Chiara,20,0,20,0
1715638713726,LIIT 5BS,A00,507430,Carnelos; Chiara,20,0,20,0
1715638714751,LIIT 5CS,A00,507432,Carnelos; Chiara,20,0,20,0
1715638715779,LISP 5A,A00,507541,Munoz Sanchez; Alicia,11,0,20,9
1715638716805,LISP 5B,A00,507671,Munoz Sanchez; Alicia,9,0,20,11
1715638717830,LISP 5C,A00,507696,Munoz Sanchez; Alicia,9,0,20,11
1715638718854,MAE 197,001,528363,Boechler; Nicholas Sebastia,9998,0,9999,1
1715638719881,MATH 197,001,523477,Kedlaya; Kiran S.,9994,0,9999,5
1715638719881,MATH 197,002,563811,Zhang; Danna,9994,0,9999,5
1715638719881,MATH 197,003,628552,Dumitriu; Ioana,9998,0,9999,1
1715638719881,MATH 197,004,660885,Floyd; Eric,9998,0,9999,1
1715638720908,MCWP 40R,A00,518780,Staff,2,0,20,18
1715638720908,MCWP 40R,B00,518781,Staff,10,0,20,10
1715638720908,MCWP 40R,C00,518783,Staff,5,0,20,15
1715638721933,MCWP 50R,A00,518791,Staff,0,1,20,20
1715638721933,MCWP 50R,B00,518792,Staff,0,2,20,20
1715638721933,MCWP 50R,C00,518793,Staff,0,4,20,20
1715638721933,MCWP 50R,D00,518794,Staff,0,1,20,20
1715638721933,MCWP 50R,E00,518795,Staff,0,2,20,20
1715638721933,MCWP 50R,F00,518796,Staff,0,1,20,20
1715638721933,MCWP 50R,G00,518797,Staff,0,1,20,20
1715638722957,MMW 12R,A01,514034,Herbst; Matthew,0,2,16,16
1715638722957,MMW 12R,A02,514035,Herbst; Matthew,0,0,16,16
1715638723985,MMW 13R,A01,514037,Staff,0,5,16,16
1715638723985,MMW 13R,A02,514039,Staff,0,5,16,16
1715638723985,MMW 13R,A03,628519,Staff,0,4,16,16
1715638726039,SIO 295LS,A00,523233,Staff,10,0,30,20
1715638727064,SIO 295S,A00,523232,Staff,10,0,30,20
1715638728089,SIOC 290S,A01,637330,Merrifield; Mark A,21,0,30,9
1715638729119,SIOC 291S,A01,637333,Gabriel; Corey John,21,0,30,9
1715638730146,SOCI 117,A01,494376,Staff,0,5,5,5
1715638731171,WES 237B,A00,494380,Staff,10,0,20,10
1715638733251,AESE 279B,A00,494370,Wade; Jon P,0,0,33,33
1715638734280,AIP 97,001,660915,Van Den Einde; Yael Dahlia,9998,0,9999,1
1715638735316,AIP 197,001,627712,Vespa; Emanuel Ignacio,9995,0,9999,4
1715638735316,AIP 197,002,650778,Amir; On,9998,0,9999,1
1715638735316,AIP 197,003,650933,Avenancio-Leon; Carlos,9998,0,9999,1
1715638735316,AIP 197,004,658530,Heyman; Gail D.,9998,0,9999,1
1715638735316,AIP 197,005,658631,Neal; Sonya E,9998,0,9999,1
1715638735316,AIP 197,006,658671,Du; Songzi,9998,0,9999,1
1715638736343,ANAR 135S,A00,494369,Braswell; Geoffrey E.,0,0,0,0
1715638737372,BENG 196,001,628496,Engler; Adam J.,9998,0,9999,1
1715638737372,BENG 196,002,660916,Watson; John Thomas,9998,0,9999,1
1715638738401,BISP 197,001,650773,Wilhelm; James E.,9994,0,9999,5
1715638738401,BISP 197,002,658904,Coleman; Aaron B.,9998,0,9999,1
1715638739426,CAT 124RS,A01,519847,Geibel; William,0,0,20,20
1715638740451,CAT 125RS,A01,515971,Geibel; William,0,0,20,20
1715638741480,CLRE 250,A00,511389,Morris; Sheldon,9992,0,9999,7
1715638742511,CLRE 251,A00,507176,Mehta; Ravindra L.,9992,0,9999,7
1715638742511,CLRE 251,B00,511410,Mehta; Ravindra L.,9998,0,9999,1
1715638743539,CLRE 252,A00,507189,Cuomo; Raphael Eduardo,9994,0,9999,5
1715638744569,CLRE 253,A00,507199,Vaida; Florin,9994,0,9999,5
1715638744569,CLRE 253,B00,507202,Vaida; Florin,9999,0,9999,0
1715638745597,CLRE 259,A00,507211,Patel; Hemal,9996,0,9999,3
1715638746624,CLRE 260,A00,507221,Cuomo; Raphael Eduardo,9999,0,9999,0
1715638747650,CLRE 297,001,507242,Cuomo; Raphael Eduardo,9999,0,9999,0
1715638748675,COGS 197,001,638244,Voytek; Bradley Thomas,9997,0,9999,2
1715638749704,CSE 191,A00,516875,Minnes Kemp; Mor Mia,9991,0,9999,8
1715638750728,CSE 197,001,637388,Minnes Kemp; Mor Mia,9992,0,9999,7
1715638751754,CSS 201S,A01,494383,Mignozzetti; Umberto,35,0,35,0
1715638752782,CSS 202S,A01,494387,Mignozzetti; Umberto,35,0,35,0
1715638753806,DSC 197,001,628532,Eldridge; Justin Matthew,9995,0,9999,4
1715638754834,EAP 100,A00,516065,Staff,9799,0,9999,200
1715638755869,ECE 45,A01,507414,Staff,31,0,60,29
1715638757928,ECE 111,A01,507420,Staff,11,0,50,39
1715638758955,ECE 197,001,548057,Sievenpiper; Daniel F.,9991,0,9999,8
1715638759984,EDS 115,A00,507243,Choi; Bailey Miyeon,7,0,28,21
1715638761013,EDS 117,A01,494379,Staff,0,6,34,34
1715638762041,EDS 125,A00,507246,Hopkins; Megan Beth,8,0,30,22
1715638763072,EDS 128A,A01,507264,Fargason; Sharon Gayle,6,0,26,20
1715638764102,EDS 128B,A01,507293,Pappas; Elizabeth,10,0,30,20
1715638765127,EDS 139,A00,507294,Fargason; Sharon Gayle,10,0,30,20
1715638765127,EDS 139,B00,507313,Pappas; Elizabeth,11,0,30,19
1715638766154,EDS 201,A00,507315,Staff,10,0,30,20
1715638767183,EDS 203,A01,507317,Halter; Christopher P.,10,0,30,20
1715638768211,EDS 204R,A01,507319,Halter; Christopher P.,0,3,30,30
1715638768211,EDS 204R,B01,507331,Heinzman; Erica M.,14,0,30,16
1715638776915,EDS 206R,A00,507332,Staff,0,4,30,30
1715638776915,EDS 206R,B00,507343,Staff,15,0,30,15
1715638787998,EDS 250,A00,507344,Hemans; Patricia Ann Benitez,20,0,40,20
1715638789027,EDS 281,A00,507345,Daly; Alan J.,18,0,18,0
1715638790055,EDS 284,A00,507350,Daly; Alan J.,16,0,16,0
1715638791079,EDS 286,A00,507359,Fine; Sarah,18,0,18,0
1715638792108,EDS 289C,A01,507361,Daly; Alan J.,18,0,18,0
1715638793132,EDS 290,A00,507366,Hofstetter; Carolyn,15,0,15,0
1715638794166,LIGM 5A,A00,507421,Fischer-Grunski; Eva K,17,0,20,3
1715638795194,LIGM 5B,A00,507423,Fischer-Grunski; Eva K,19,0,20,1
1715638796224,LIGM 5C,A00,507425,Fischer-Grunski; Eva K,19,0,20,1
1715638797252,LIIT 5AS,A00,507427,Carnelos; Chiara,20,0,20,0
1715638798278,LIIT 5BS,A00,507430,Carnelos; Chiara,20,0,20,0
1715638799329,LIIT 5CS,A00,507432,Carnelos; Chiara,20,0,20,0
1715638800357,LISP 5A,A00,507541,Munoz Sanchez; Alicia,11,0,20,9
1715638801381,LISP 5B,A00,507671,Munoz Sanchez; Alicia,9,0,20,11
1715638802408,LISP 5C,A00,507696,Munoz Sanchez; Alicia,9,0,20,11
1715638803436,MAE 197,001,528363,Boechler; Nicholas Sebastia,9998,0,9999,1
1715638804465,MATH 197,001,523477,Kedlaya; Kiran S.,9994,0,9999,5
1715638804465,MATH 197,002,563811,Zhang; Danna,9994,0,9999,5
1715638804465,MATH 197,003,628552,Dumitriu; Ioana,9998,0,9999,1
1715638804465,MATH 197,004,660885,Floyd; Eric,9998,0,9999,1
1715638805493,MCWP 40R,A00,518780,Staff,2,0,20,18
1715638805493,MCWP 40R,B00,518781,Staff,10,0,20,10
1715638805493,MCWP 40R,C00,518783,Staff,5,0,20,15
1715638806522,MCWP 50R,A00,518791,Staff,0,1,20,20
1715638806522,MCWP 50R,B00,518792,Staff,0,2,20,20
1715638806522,MCWP 50R,C00,518793,Staff,0,4,20,20
1715638806522,MCWP 50R,D00,518794,Staff,0,1,20,20
1715638806522,MCWP 50R,E00,518795,Staff,0,2,20,20
1715638806522,MCWP 50R,F00,518796,Staff,0,1,20,20
1715638806522,MCWP 50R,G00,518797,Staff,0,1,20,20
1715638807549,MMW 12R,A01,514034,Herbst; Matthew,0,2,16,16
1715638807549,MMW 12R,A02,514035,Herbst; Matthew,0,0,16,16
1715638808576,MMW 13R,A01,514037,Staff,0,5,16,16
1715638808576,MMW 13R,A02,514039,Staff,0,5,16,16
1715638808576,MMW 13R,A03,628519,Staff,0,4,16,16
1715638810627,SIO 295LS,A00,523233,Staff,10,0,30,20
1715638811654,SIO 295S,A00,523232,Staff,10,0,30,20
1715638812683,SIOC 290S,A01,637330,Merrifield; Mark A,21,0,30,9
1715638813707,SIOC 291S,A01,637333,Gabriel; Corey John,21,0,30,9
1715638814732,SOCI 117,A01,494376,Staff,0,5,5,5
1715638815757,WES 237B,A00,494380,Staff,10,0,20,10
1715638817834,AESE 279B,A00,494370,Wade; Jon P,0,0,33,33
1715638818863,AIP 97,001,660915,Van Den Einde; Yael Dahlia,9998,0,9999,1
1715638819889,AIP 197,001,627712,Vespa; Emanuel Ignacio,9995,0,9999,4
1715638819889,AIP 197,002,650778,Amir; On,9998,0,9999,1
1715638819889,AIP 197,003,650933,Avenancio-Leon; Carlos,9998,0,9999,1
1715638819889,AIP 197,004,658530,Heyman; Gail D.,9998,0,9999,1
1715638819889,AIP 197,005,658631,Neal; Sonya E,9998,0,9999,1
1715638819889,AIP 197,006,658671,Du; Songzi,9998,0,9999,1
1715638820917,ANAR 135S,A00,494369,Braswell; Geoffrey E.,0,0,0,0
1715638821944,BENG 196,001,628496,Engler; Adam J.,9998,0,9999,1
1715638821944,BENG 196,002,660916,Watson; John Thomas,9998,0,9999,1
1715638822969,BISP 197,001,650773,Wilhelm; James E.,9994,0,9999,5
1715638822969,BISP 197,002,658904,Coleman; Aaron B.,9998,0,9999,1
1715638823994,CAT 124RS,A01,519847,Geibel; William,0,0,20,20
1715638825019,CAT 125RS,A01,515971,Geibel; William,0,0,20,20
1715638826046,CLRE 250,A00,511389,Morris; Sheldon,9992,0,9999,7
1715638827075,CLRE 251,A00,507176,Mehta; Ravindra L.,9992,0,9999,7
1715638827075,CLRE 251,B00,511410,Mehta; Ravindra L.,9998,0,9999,1
1715638828103,CLRE 252,A00,507189,Cuomo; Raphael Eduardo,9994,0,9999,5
1715638829130,CLRE 253,A00,507199,Vaida; Florin,9994,0,9999,5
1715638829130,CLRE 253,B00,507202,Vaida; Florin,9999,0,9999,0
1715638830155,CLRE 259,A00,507211,Patel; Hemal,9996,0,9999,3
1715638831180,CLRE 260,A00,507221,Cuomo; Raphael Eduardo,9999,0,9999,0
1715638832207,CLRE 297,001,507242,Cuomo; Raphael Eduardo,9999,0,9999,0
1715638833231,COGS 197,001,638244,Voytek; Bradley Thomas,9997,0,9999,2
1715638834258,CSE 191,A00,516875,Minnes Kemp; Mor Mia,9991,0,9999,8
1715638835284,CSE 197,001,637388,Minnes Kemp; Mor Mia,9992,0,9999,7
1715638836313,CSS 201S,A01,494383,Mignozzetti; Umberto,35,0,35,0
1715638837345,CSS 202S,A01,494387,Mignozzetti; Umberto,35,0,35,0
1715638838369,DSC 197,001,628532,Eldridge; Justin Matthew,9995,0,9999,4
1715638839395,EAP 100,A00,516065,Staff,9799,0,9999,200
1715638840422,ECE 45,A01,507414,Staff,31,0,60,29
1715638842477,ECE 111,A01,507420,Staff,11,0,50,39
1715638843505,ECE 197,001,548057,Sievenpiper; Daniel F.,9991,0,9999,8
1715638844531,EDS 115,A00,507243,Choi; Bailey Miyeon,7,0,28,21
1715638845563,EDS 117,A01,494379,Staff,0,6,34,34
1715638846588,EDS 125,A00,507246,Hopkins; Megan Beth,8,0,30,22
1715638847615,EDS 128A,A01,507264,Fargason; Sharon Gayle,6,0,26,20
1715638848643,EDS 128B,A01,507293,Pappas; Elizabeth,10,0,30,20
1715638849666,EDS 139,A00,507294,Fargason; Sharon Gayle,10,0,30,20
1715638849666,EDS 139,B00,507313,Pappas; Elizabeth,11,0,30,19
1715638850693,EDS 201,A00,507315,Staff,10,0,30,20
1715638851719,EDS 203,A01,507317,Halter; Christopher P.,10,0,30,20
1715638852744,EDS 204R,A01,507319,Halter; Christopher P.,0,3,30,30
1715638852744,EDS 204R,B01,507331,Heinzman; Erica M.,14,0,30,16
1715638853777,EDS 206R,A00,507332,Staff,0,4,30,30
1715638853777,EDS 206R,B00,507343,Staff,15,0,30,15
1715638854802,EDS 250,A00,507344,Hemans; Patricia Ann Benitez,20,0,40,20
1715638855825,EDS 281,A00,507345,Daly; Alan J.,18,0,18,0
1715638856851,EDS 284,A00,507350,Daly; Alan J.,16,0,16,0
1715638857876,EDS 286,A00,507359,Fine; Sarah,18,0,18,0
1715638858900,EDS 289C,A01,507361,Daly; Alan J.,18,0,18,0
1715638859926,EDS 290,A00,507366,Hofstetter; Carolyn,15,0,15,0
1715638860950,LIGM 5A,A00,507421,Fischer-Grunski; Eva K,17,0,20,3
1715638861978,LIGM 5B,A00,507423,Fischer-Grunski; Eva K,19,0,20,1
1715638863004,LIGM 5C,A00,507425,Fischer-Grunski; Eva K,19,0,20,1
1715638864033,LIIT 5AS,A00,507427,Carnelos; Chiara,20,0,20,0
1715638865059,LIIT 5BS,A00,507430,Carnelos; Chiara,20,0,20,0
1715638866085,LIIT 5CS,A00,507432,Carnelos; Chiara,20,0,20,0
1715638867113,LISP 5A,A00,507541,Munoz Sanchez; Alicia,11,0,20,9
1715638868138,LISP 5B,A00,507671,Munoz Sanchez; Alicia,9,0,20,11
1715638869163,LISP 5C,A00,507696,Munoz Sanchez; Alicia,9,0,20,11
1715638870189,MAE 197,001,528363,Boechler; Nicholas Sebastia,9998,0,9999,1
1715638871222,MATH 197,001,523477,Kedlaya; Kiran S.,9994,0,9999,5
1715638871222,MATH 197,002,563811,Zhang; Danna,9994,0,9999,5
1715638871222,MATH 197,003,628552,Dumitriu; Ioana,9998,0,9999,1
1715638871222,MATH 197,004,660885,Floyd; Eric,9998,0,9999,1
1715638872249,MCWP 40R,A00,518780,Staff,2,0,20,18
1715638872249,MCWP 40R,B00,518781,Staff,10,0,20,10
1715638872249,MCWP 40R,C00,518783,Staff,5,0,20,15
1715638873278,MCWP 50R,A00,518791,Staff,0,1,20,20
1715638873278,MCWP 50R,B00,518792,Staff,0,2,20,20
1715638873278,MCWP 50R,C00,518793,Staff,0,4,20,20
1715638873278,MCWP 50R,D00,518794,Staff,0,1,20,20
1715638873278,MCWP 50R,E00,518795,Staff,0,2,20,20
1715638873278,MCWP 50R,F00,518796,Staff,0,1,20,20
1715638873278,MCWP 50R,G00,518797,Staff,0,1,20,20
1715638874306,MMW 12R,A01,514034,Herbst; Matthew,0,2,16,16
1715638874306,MMW 12R,A02,514035,Herbst; Matthew,0,0,16,16
1715638875332,MMW 13R,A01,514037,Staff,0,5,16,16
1715638875332,MMW 13R,A02,514039,Staff,0,5,16,16
1715638875332,MMW 13R,A03,628519,Staff,0,4,16,16
1715638877382,SIO 295LS,A00,523233,Staff,10,0,30,20
1715638878405,SIO 295S,A00,523232,Staff,10,0,30,20
1715638879436,SIOC 290S,A01,637330,Merrifield; Mark A,21,0,30,9
1715638880466,SIOC 291S,A01,637333,Gabriel; Corey John,21,0,30,9
1715638881492,SOCI 117,A01,494376,Staff,0,5,5,5
1715638882517,WES 237B,A00,494380,Staff,10,0,20,10
1715638884581,AESE 279B,A00,494370,Wade; Jon P,0,0,33,33
1715638885605,AIP 97,001,660915,Van Den Einde; Yael Dahlia,9998,0,9999,1
1715638886638,AIP 197,001,627712,Vespa; Emanuel Ignacio,9995,0,9999,4
1715638886638,AIP 197,002,650778,Amir; On,9998,0,9999,1
1715638886638,AIP 197,003,650933,Avenancio-Leon; Carlos,9998,0,9999,1
1715638886638,AIP 197,004,658530,Heyman; Gail D.,9998,0,9999,1
1715638886638,AIP 197,005,658631,Neal; Sonya E,9998,0,9999,1
1715638886638,AIP 197,006,658671,Du; Songzi,9998,0,9999,1
1715638887667,ANAR 135S,A00,494369,Braswell; Geoffrey E.,0,0,0,0
1715638888696,BENG 196,001,628496,Engler; Adam J.,9998,0,9999,1
1715638888696,BENG 196,002,660916,Watson; John Thomas,9998,0,9999,1
1715638889721,BISP 197,001,650773,Wilhelm; James E.,9994,0,9999,5
1715638889721,BISP 197,002,658904,Coleman; Aaron B.,9998,0,9999,1
1715638890747,CAT 124RS,A01,519847,Geibel; William,0,0,20,20
1715638891771,CAT 125RS,A01,515971,Geibel; William,0,0,20,20
1715638892802,CLRE 250,A00,511389,Morris; Sheldon,9992,0,9999,7
1715638893834,CLRE 251,A00,507176,Mehta; Ravindra L.,9992,0,9999,7
1715638893834,CLRE 251,B00,511410,Mehta; Ravindra L.,9998,0,9999,1
1715638894864,CLRE 252,A00,507189,Cuomo; Raphael Eduardo,9994,0,9999,5
1715638895893,CLRE 253,A00,507199,Vaida; Florin,9994,0,9999,5
1715638895893,CLRE 253,B00,507202,Vaida; Florin,9999,0,9999,0
1715638896924,CLRE 259,A00,507211,Patel; Hemal,9996,0,9999,3
1715638897948,CLRE 260,A00,507221,Cuomo; Raphael Eduardo,9999,0,9999,0
1715638898974,CLRE 297,001,507242,Cuomo; Raphael Eduardo,9999,0,9999,0
1715638900002,COGS 197,001,638244,Voytek; Bradley Thomas,9997,0,9999,2
1715638901031,CSE 191,A00,516875,Minnes Kemp; Mor Mia,9991,0,9999,8
1715638902056,CSE 197,001,637388,Minnes Kemp; Mor Mia,9992,0,9999,7
1715638903086,CSS 201S,A01,494383,Mignozzetti; Umberto,35,0,35,0
1715638904114,CSS 202S,A01,494387,Mignozzetti; Umberto,35,0,35,0
1715638905138,DSC 197,001,628532,Eldridge; Justin Matthew,9995,0,9999,4
1715638906165,EAP 100,A00,516065,Staff,9799,0,9999,200
1715638907189,ECE 45,A01,507414,Staff,31,0,60,29
1715638909243,ECE 111,A01,507420,Staff,11,0,50,39
1715638910271,ECE 197,001,548057,Sievenpiper; Daniel F.,9991,0,9999,8
1715638911308,EDS 115,A00,507243,Choi; Bailey Miyeon,7,0,28,21
1715638912334,EDS 117,A01,494379,Staff,0,6,34,34
1715638913359,EDS 125,A00,507246,Hopkins; Megan Beth,8,0,30,22
1715638914389,EDS 128A,A01,507264,Fargason; Sharon Gayle,6,0,26,20
1715638915415,EDS 128B,A01,507293,Pappas; Elizabeth,10,0,30,20
1715638916439,EDS 139,A00,507294,Fargason; Sharon Gayle,10,0,30,20
1715638916439,EDS 139,B00,507313,Pappas; Elizabeth,11,0,30,19
1715638917467,EDS 201,A00,507315,Staff,10,0,30,20
1715638918497,EDS 203,A01,507317,Halter; Christopher P.,10,0,30,20
1715638919523,EDS 204R,A01,507319,Halter; Christopher P.,0,3,30,30
1715638919523,EDS 204R,B01,507331,Heinzman; Erica M.,14,0,30,16
1715638920549,EDS 206R,A00,507332,Staff,0,4,30,30
1715638920549,EDS 206R,B00,507343,Staff,15,0,30,15
1715638921579,EDS 250,A00,507344,Hemans; Patricia Ann Benitez,20,0,40,20
1715638922607,EDS 281,A00,507345,Daly; Alan J.,18,0,18,0
1715638923634,EDS 284,A00,507350,Daly; Alan J.,16,0,16,0
1715638924662,EDS 286,A00,507359,Fine; Sarah,18,0,18,0
1715638925686,EDS 289C,A01,507361,Daly; Alan J.,18,0,18,0
1715638926711,EDS 290,A00,507366,Hofstetter; Carolyn,15,0,15,0
1715638927742,LIGM 5A,A00,507421,Fischer-Grunski; Eva K,17,0,20,3
1715638928769,LIGM 5B,A00,507423,Fischer-Grunski; Eva K,19,0,20,1
1715638929800,LIGM 5C,A00,507425,Fischer-Grunski; Eva K,19,0,20,1
1715638930825,LIIT 5AS,A00,507427,Carnelos; Chiara,20,0,20,0
1715638931850,LIIT 5BS,A00,507430,Carnelos; Chiara,20,0,20,0
1715638932873,LIIT 5CS,A00,507432,Carnelos; Chiara,20,0,20,0
1715638933909,LISP 5A,A00,507541,Munoz Sanchez; Alicia,11,0,20,9
1715638934933,LISP 5B,A00,507671,Munoz Sanchez; Alicia,9,0,20,11
1715638935960,LISP 5C,A00,507696,Munoz Sanchez; Alicia,9,0,20,11
1715638936985,MAE 197,001,528363,Boechler; Nicholas Sebastia,9998,0,9999,1
1715638938012,MATH 197,001,523477,Kedlaya; Kiran S.,9994,0,9999,5
1715638938012,MATH 197,002,563811,Zhang; Danna,9994,0,9999,5
1715638938012,MATH 197,003,628552,Dumitriu; Ioana,9998,0,9999,1
1715638938012,MATH 197,004,660885,Floyd; Eric,9998,0,9999,1
1715638939037,MCWP 40R,A00,518780,Staff,2,0,20,18
1715638939037,MCWP 40R,B00,518781,Staff,10,0,20,10
1715638939037,MCWP 40R,C00,518783,Staff,5,0,20,15
1715638940065,MCWP 50R,A00,518791,Staff,0,1,20,20
1715638940065,MCWP 50R,B00,518792,Staff,0,2,20,20
1715638940065,MCWP 50R,C00,518793,Staff,0,4,20,20
1715638940065,MCWP 50R,D00,518794,Staff,0,1,20,20
1715638940065,MCWP 50R,E00,518795,Staff,0,2,20,20
1715638940065,MCWP 50R,F00,518796,Staff,0,1,20,20
1715638940065,MCWP 50R,G00,518797,Staff,0,1,20,20
1715638941090,MMW 12R,A01,514034,Herbst; Matthew,0,2,16,16
1715638941090,MMW 12R,A02,514035,Herbst; Matthew,0,0,16,16
1715638942129,MMW 13R,A01,514037,Staff,0,5,16,16
1715638942129,MMW 13R,A02,514039,Staff,0,5,16,16
1715638942129,MMW 13R,A03,628519,Staff,0,4,16,16
1715638944184,SIO 295LS,A00,523233,Staff,10,0,30,20
1715638945210,SIO 295S,A00,523232,Staff,10,0,30,20
1715638946242,SIOC 290S,A01,637330,Merrifield; Mark A,21,0,30,9
1715638947272,SIOC 291S,A01,637333,Gabriel; Corey John,21,0,30,9
1715638948297,SOCI 117,A01,494376,Staff,0,5,5,5
1715638949322,WES 237B,A00,494380,Staff,10,0,20,10
1715638951381,AESE 279B,A00,494370,Wade; Jon P,0,0,33,33
1715638952409,AIP 97,001,660915,Van Den Einde; Yael Dahlia,9998,0,9999,1
1715638953437,AIP 197,001,627712,Vespa; Emanuel Ignacio,9995,0,9999,4
1715638953437,AIP 197,002,650778,Amir; On,9998,0,9999,1
1715638953437,AIP 197,003,650933,Avenancio-Leon; Carlos,9998,0,9999,1
1715638953437,AIP 197,004,658530,Heyman; Gail D.,9998,0,9999,1
1715638953437,AIP 197,005,658631,Neal; Sonya E,9998,0,9999,1
1715638953437,AIP 197,006,658671,Du; Songzi,9998,0,9999,1
1715638954463,ANAR 135S,A00,494369,Braswell; Geoffrey E.,0,0,0,0
1715638955488,BENG 196,001,628496,Engler; Adam J.,9998,0,9999,1
1715638955488,BENG 196,002,660916,Watson; John Thomas,9998,0,9999,1
1715638956515,BISP 197,001,650773,Wilhelm; James E.,9994,0,9999,5
1715638956515,BISP 197,002,658904,Coleman; Aaron B.,9998,0,9999,1
1715638957544,CAT 124RS,A01,519847,Geibel; William,0,0,20,20
1715638958569,CAT 125RS,A01,515971,Geibel; William,0,0,20,20
1715638959593,CLRE 250,A00,511389,Morris; Sheldon,9992,0,9999,7
1715638960618,CLRE 251,A00,507176,Mehta; Ravindra L.,9992,0,9999,7
1715638960618,CLRE 251,B00,511410,Mehta; Ravindra L.,9998,0,9999,1
1715638961645,CLRE 252,A00,507189,Cuomo; Raphael Eduardo,9994,0,9999,5
1715638962671,CLRE 253,A00,507199,Vaida; Florin,9994,0,9999,5
1715638962671,CLRE 253,B00,507202,Vaida; Florin,9999,0,9999,0
1715638963696,CLRE 259,A00,507211,Patel; Hemal,9996,0,9999,3
1715638964724,CLRE 260,A00,507221,Cuomo; Raphael Eduardo,9999,0,9999,0
1715638965751,CLRE 297,001,507242,Cuomo; Raphael Eduardo,9999,0,9999,0
1715638966779,COGS 197,001,638244,Voytek; Bradley Thomas,9997,0,9999,2
1715638967805,CSE 191,A00,516875,Minnes Kemp; Mor Mia,9991,0,9999,8
1715638968829,CSE 197,001,637388,Minnes Kemp; Mor Mia,9992,0,9999,7
1715638969860,CSS 201S,A01,494383,Mignozzetti; Umberto,35,0,35,0
1715638970893,CSS 202S,A01,494387,Mignozzetti; Umberto,35,0,35,0
1715638971917,DSC 197,001,628532,Eldridge; Justin Matthew,9995,0,9999,4
1715638972941,EAP 100,A00,516065,Staff,9799,0,9999,200
1715638973967,ECE 45,A01,507414,Staff,31,0,60,29
1715638976017,ECE 111,A01,507420,Staff,11,0,50,39
1715638977045,ECE 197,001,548057,Sievenpiper; Daniel F.,9991,0,9999,8
1715638978073,EDS 115,A00,507243,Choi; Bailey Miyeon,7,0,28,21
1715638979103,EDS 117,A01,494379,Staff,0,6,34,34
1715638980130,EDS 125,A00,507246,Hopkins; Megan Beth,8,0,30,22
1715638981157,EDS 128A,A01,507264,Fargason; Sharon Gayle,6,0,26,20
1715638982184,EDS 128B,A01,507293,Pappas; Elizabeth,10,0,30,20
1715638983209,EDS 139,A00,507294,Fargason; Sharon Gayle,10,0,30,20
1715638983209,EDS 139,B00,507313,Pappas; Elizabeth,11,0,30,19
1715638984239,EDS 201,A00,507315,Staff,10,0,30,20
1715638985265,EDS 203,A01,507317,Halter; Christopher P.,10,0,30,20
1715638986290,EDS 204R,A01,507319,Halter; Christopher P.,0,3,30,30
1715638986290,EDS 204R,B01,507331,Heinzman; Erica M.,14,0,30,16
1715638987319,EDS 206R,A00,507332,Staff,0,4,30,30
1715638987319,EDS 206R,B00,507343,Staff,15,0,30,15
1715638988350,EDS 250,A00,507344,Hemans; Patricia Ann Benitez,20,0,40,20
1715638989377,EDS 281,A00,507345,Daly; Alan J.,18,0,18,0
1715638990405,EDS 284,A00,507350,Daly; Alan J.,16,0,16,0
1715638991431,EDS 286,A00,507359,Fine; Sarah,18,0,18,0
1715638992457,EDS 289C,A01,507361,Daly; Alan J.,18,0,18,0
1715638993482,EDS 290,A00,507366,Hofstetter; Carolyn,15,0,15,0
1715638994508,LIGM 5A,A00,507421,Fischer-Grunski; Eva K,17,0,20,3
1715638995533,LIGM 5B,A00,507423,Fischer-Grunski; Eva K,19,0,20,1
1715638996561,LIGM 5C,A00,507425,Fischer-Grunski; Eva K,19,0,20,1
1715638997587,LIIT 5AS,A00,507427,Carnelos; Chiara,20,0,20,0
1715638998612,LIIT 5BS,A00,507430,Carnelos; Chiara,20,0,20,0
1715638999639,LIIT 5CS,A00,507432,Carnelos; Chiara,20,0,20,0
1715639000666,LISP 5A,A00,507541,Munoz Sanchez; Alicia,11,0,20,9
1715639001695,LISP 5B,A00,507671,Munoz Sanchez; Alicia,9,0,20,11
1715639002724,LISP 5C,A00,507696,Munoz Sanchez; Alicia,9,0,20,11
1715639003754,MAE 197,001,528363,Boechler; Nicholas Sebastia,9998,0,9999,1
1715639004784,MATH 197,001,523477,Kedlaya; Kiran S.,9994,0,9999,5
1715639004784,MATH 197,002,563811,Zhang; Danna,9994,0,9999,5
1715639004784,MATH 197,003,628552,Dumitriu; Ioana,9998,0,9999,1
1715639004784,MATH 197,004,660885,Floyd; Eric,9998,0,9999,1
1715639005813,MCWP 40R,A00,518780,Staff,2,0,20,18
1715639005813,MCWP 40R,B00,518781,Staff,10,0,20,10
1715639005813,MCWP 40R,C00,518783,Staff,5,0,20,15
1715639006840,MCWP 50R,A00,518791,Staff,0,1,20,20
1715639006840,MCWP 50R,B00,518792,Staff,0,2,20,20
1715639006840,MCWP 50R,C00,518793,Staff,0,4,20,20
1715639006840,MCWP 50R,D00,518794,Staff,0,1,20,20
1715639006840,MCWP 50R,E00,518795,Staff,0,2,20,20
1715639006840,MCWP 50R,F00,518796,Staff,0,1,20,20
1715639006840,MCWP 50R,G00,518797,Staff,0,1,20,20
1715639007866,MMW 12R,A01,514034,Herbst; Matthew,0,2,16,16
1715639007866,MMW 12R,A02,514035,Herbst; Matthew,0,0,16,16
1715639008893,MMW 13R,A01,514037,Staff,0,5,16,16
1715639008893,MMW 13R,A02,514039,Staff,0,5,16,16
1715639008893,MMW 13R,A03,628519,Staff,0,4,16,16
1715639010947,SIO 295LS,A00,523233,Staff,10,0,30,20
1715639011973,SIO 295S,A00,523232,Staff,10,0,30,20
1715639013006,SIOC 290S,A01,637330,Merrifield; Mark A,21,0,30,9
1715639014034,SIOC 291S,A01,637333,Gabriel; Corey John,21,0,30,9
1715639015059,SOCI 117,A01,494376,Staff,0,5,5,5
1715639016086,WES 237B,A00,494380,Staff,10,0,20,10
1715639018157,AESE 279B,A00,494370,Wade; Jon P,0,0,33,33
1715639019182,AIP 97,001,660915,Van Den Einde; Yael Dahlia,9998,0,9999,1
1715639020210,AIP 197,001,627712,Vespa; Emanuel Ignacio,9995,0,9999,4
1715639020210,AIP 197,002,650778,Amir; On,9998,0,9999,1
1715639020210,AIP 197,003,650933,Avenancio-Leon; Carlos,9998,0,9999,1
1715639020210,AIP 197,004,658530,Heyman; Gail D.,9998,0,9999,1
1715639020210,AIP 197,005,658631,Neal; Sonya E,9998,0,9999,1
1715639020210,AIP 197,006,658671,Du; Songzi,9998,0,9999,1
1715639021238,ANAR 135S,A00,494369,Braswell; Geoffrey E.,0,0,0,0
1715639022266,BENG 196,001,628496,Engler; Adam J.,9998,0,9999,1
1715639022266,BENG 196,002,660916,Watson; John Thomas,9998,0,9999,1
1715639023293,BISP 197,001,650773,Wilhelm; James E.,9994,0,9999,5
1715639023293,BISP 197,002,658904,Coleman; Aaron B.,9998,0,9999,1
1715639024322,CAT 124RS,A01,519847,Geibel; William,0,0,20,20
1715639025350,CAT 125RS,A01,515971,Geibel; William,0,0,20,20
1715639026379,CLRE 250,A00,511389,Morris; Sheldon,9992,0,9999,7
1715639027407,CLRE 251,A00,507176,Mehta; Ravindra L.,9992,0,9999,7
1715639027407,CLRE 251,B00,511410,Mehta; Ravindra L.,9998,0,9999,1
1715639028437,CLRE 252,A00,507189,Cuomo; Raphael Eduardo,9994,0,9999,5
1715639029466,CLRE 253,A00,507199,Vaida; Florin,9994,0,9999,5
1715639029466,CLRE 253,B00,507202,Vaida; Florin,9999,0,9999,0
1715639030494,CLRE 259,A00,507211,Patel; Hemal,9996,0,9999,3
1715639031519,CLRE 260,A00,507221,Cuomo; Raphael Eduardo,9999,0,9999,0
1715639032547,CLRE 297,001,507242,Cuomo; Raphael Eduardo,9999,0,9999,0
1715639033574,COGS 197,001,638244,Voytek; Bradley Thomas,9997,0,9999,2
1715639034603,CSE 191,A00,516875,Minnes Kemp; Mor Mia,9991,0,9999,8
1715639035630,CSE 197,001,637388,Minnes Kemp; Mor Mia,9992,0,9999,7
1715639036663,CSS 201S,A01,494383,Mignozzetti; Umberto,35,0,35,0
1715639037690,CSS 202S,A01,494387,Mignozzetti; Umberto,35,0,35,0
1715639038720,DSC 197,001,628532,Eldridge; Justin Matthew,9995,0,9999,4
1715639039745,EAP 100,A00,516065,Staff,9799,0,9999,200
1715639040778,ECE 45,A01,507414,Staff,31,0,60,29
1715639042837,ECE 111,A01,507420,Staff,11,0,50,39
1715639043862,ECE 197,001,548057,Sievenpiper; Daniel F.,9991,0,9999,8
1715639044890,EDS 115,A00,507243,Choi; Bailey Miyeon,7,0,28,21
1715639045920,EDS 117,A01,494379,Staff,0,6,34,34
1715639046950,EDS 125,A00,507246,Hopkins; Megan Beth,8,0,30,22
1715639047981,EDS 128A,A01,507264,Fargason; Sharon Gayle,6,0,26,20
1715639049011,EDS 128B,A01,507293,Pappas; Elizabeth,10,0,30,20
1715639050036,EDS 139,A00,507294,Fargason; Sharon Gayle,10,0,30,20
1715639050036,EDS 139,B00,507313,Pappas; Elizabeth,11,0,30,19
1715639051063,EDS 201,A00,507315,Staff,10,0,30,20
1715639052092,EDS 203,A01,507317,Halter; Christopher P.,10,0,30,20
1715639053121,EDS 204R,A01,507319,Halter; Christopher P.,0,3,30,30
1715639053121,EDS 204R,B01,507331,Heinzman; Erica M.,14,0,30,16
1715639054150,EDS 206R,A00,507332,Staff,0,4,30,30
1715639054150,EDS 206R,B00,507343,Staff,15,0,30,15
1715639055175,EDS 250,A00,507344,Hemans; Patricia Ann Benitez,20,0,40,20
1715639056203,EDS 281,A00,507345,Daly; Alan J.,18,0,18,0
1715639057231,EDS 284,A00,507350,Daly; Alan J.,16,0,16,0
1715639058255,EDS 286,A00,507359,Fine; Sarah,18,0,18,0
1715639059280,EDS 289C,A01,507361,Daly; Alan J.,18,0,18,0
1715639060308,EDS 290,A00,507366,Hofstetter; Carolyn,15,0,15,0
1715639061334,LIGM 5A,A00,507421,Fischer-Grunski; Eva K,17,0,20,3
1715639062365,LIGM 5B,A00,507423,Fischer-Grunski; Eva K,19,0,20,1
1715639063391,LIGM 5C,A00,507425,Fischer-Grunski; Eva K,19,0,20,1
1715639064417,LIIT 5AS,A00,507427,Carnelos; Chiara,20,0,20,0
1715639065441,LIIT 5BS,A00,507430,Carnelos; Chiara,20,0,20,0
1715639066466,LIIT 5CS,A00,507432,Carnelos; Chiara,20,0,20,0
1715639067494,LISP 5A,A00,507541,Munoz Sanchez; Alicia,11,0,20,9
1715639068524,LISP 5B,A00,507671,Munoz Sanchez; Alicia,9,0,20,11
1715639069551,LISP 5C,A00,507696,Munoz Sanchez; Alicia,9,0,20,11
1715639070577,MAE 197,001,528363,Boechler; Nicholas Sebastia,9998,0,9999,1
1715639071613,MATH 197,001,523477,Kedlaya; Kiran S.,9994,0,9999,5
1715639071613,MATH 197,002,563811,Zhang; Danna,9994,0,9999,5
1715639071613,MATH 197,003,628552,Dumitriu; Ioana,9998,0,9999,1
1715639071613,MATH 197,004,660885,Floyd; Eric,9998,0,9999,1
1715639072638,MCWP 40R,A00,518780,Staff,2,0,20,18
1715639072638,MCWP 40R,B00,518781,Staff,10,0,20,10
1715639072638,MCWP 40R,C00,518783,Staff,5,0,20,15
1715639073665,MCWP 50R,A00,518791,Staff,0,1,20,20
1715639073665,MCWP 50R,B00,518792,Staff,0,2,20,20
1715639073665,MCWP 50R,C00,518793,Staff,0,4,20,20
1715639073665,MCWP 50R,D00,518794,Staff,0,1,20,20
1715639073665,MCWP 50R,E00,518795,Staff,0,2,20,20
1715639073665,MCWP 50R,F00,518796,Staff,0,1,20,20
1715639073665,MCWP 50R,G00,518797,Staff,0,1,20,20
1715639074690,MMW 12R,A01,514034,Herbst; Matthew,0,2,16,16
1715639074690,MMW 12R,A02,514035,Herbst; Matthew,0,0,16,16
1715639075717,MMW 13R,A01,514037,Staff,0,5,16,16
1715639075717,MMW 13R,A02,514039,Staff,0,5,16,16
1715639075717,MMW 13R,A03,628519,Staff,0,4,16,16
1715639077772,SIO 295LS,A00,523233,Staff,10,0,30,20
1715639078797,SIO 295S,A00,523232,Staff,10,0,30,20
1715639079826,SIOC 290S,A01,637330,Merrifield; Mark A,21,0,30,9
1715639080854,SIOC 291S,A01,637333,Gabriel; Corey John,21,0,30,9
1715639081880,SOCI 117,A01,494376,Staff,0,5,5,5
1715639082908,WES 237B,A00,494380,Staff,10,0,20,10
1715639084970,AESE 279B,A00,494370,Wade; Jon P,0,0,33,33
1715639085995,AIP 97,001,660915,Van Den Einde; Yael Dahlia,9998,0,9999,1
1715639087022,AIP 197,001,627712,Vespa; Emanuel Ignacio,9995,0,9999,4
1715639087022,AIP 197,002,650778,Amir; On,9998,0,9999,1
1715639087022,AIP 197,003,650933,Avenancio-Leon; Carlos,9998,0,9999,1
1715639087022,AIP 197,004,658530,Heyman; Gail D.,9998,0,9999,1
1715639087022,AIP 197,005,658631,Neal; Sonya E,9998,0,9999,1
1715639087022,AIP 197,006,658671,Du; Songzi,9998,0,9999,1
1715639088049,ANAR 135S,A00,494369,Braswell; Geoffrey E.,0,0,0,0
1715639089078,BENG 196,001,628496,Engler; Adam J.,9998,0,9999,1
1715639089078,BENG 196,002,660916,Watson; John Thomas,9998,0,9999,1
1715639090107,BISP 197,001,650773,Wilhelm; James E.,9994,0,9999,5
1715639090107,BISP 197,002,658904,Coleman; Aaron B.,9998,0,9999,1
1715639091133,CAT 124RS,A01,519847,Geibel; William,0,0,20,20
1715639092159,CAT 125RS,A01,515971,Geibel; William,0,0,20,20
1715639093187,CLRE 250,A00,511389,Morris; Sheldon,9992,0,9999,7
1715639094219,CLRE 251,A00,507176,Mehta; Ravindra L.,9992,0,9999,7
1715639094219,CLRE 251,B00,511410,Mehta; Ravindra L.,9998,0,9999,1
1715639095249,CLRE 252,A00,507189,Cuomo; Raphael Eduardo,9994,0,9999,5
1715639096281,CLRE 253,A00,507199,Vaida; Florin,9994,0,9999,5
1715639096281,CLRE 253,B00,507202,Vaida; Florin,9999,0,9999,0
1715639097306,CLRE 259,A00,507211,Patel; Hemal,9996,0,9999,3
1715639098335,CLRE 260,A00,507221,Cuomo; Raphael Eduardo,9999,0,9999,0
1715639099363,CLRE 297,001,507242,Cuomo; Raphael Eduardo,9999,0,9999,0
1715639100389,COGS 197,001,638244,Voytek; Bradley Thomas,9997,0,9999,2
1715639101434,CSE 191,A00,516875,Minnes Kemp; Mor Mia,9991,0,9999,8
1715639102459,CSE 197,001,637388,Minnes Kemp; Mor Mia,9992,0,9999,7
1715639103487,CSS 201S,A01,494383,Mignozzetti; Umberto,35,0,35,0
1715639104516,CSS 202S,A01,494387,Mignozzetti; Umberto,35,0,35,0
1715639105541,DSC 197,001,628532,Eldridge; Justin Matthew,9995,0,9999,4
1715639106570,EAP 100,A00,516065,Staff,9799,0,9999,200
1715639107602,ECE 45,A01,507414,Staff,31,0,60,29
1715639109653,ECE 111,A01,507420,Staff,11,0,50,39
1715639110679,ECE 197,001,548057,Sievenpiper; Daniel F.,9991,0,9999,8
1715639111710,EDS 115,A00,507243,Choi; Bailey Miyeon,7,0,28,21
1715639112736,EDS 117,A01,494379,Staff,0,6,34,34
1715639113764,EDS 125,A00,507246,Hopkins; Megan Beth,8,0,30,22
1715639114789,EDS 128A,A01,507264,Fargason; Sharon Gayle,6,0,26,20
1715639115814,EDS 128B,A01,507293,Pappas; Elizabeth,10,0,30,20
1715639116839,EDS 139,A00,507294,Fargason; Sharon Gayle,10,0,30,20
1715639116839,EDS 139,B00,507313,Pappas; Elizabeth,11,0,30,19
1715639117866,EDS 201,A00,507315,Staff,10,0,30,20
1715639118896,EDS 203,A01,507317,Halter; Christopher P.,10,0,30,20
1715639119921,EDS 204R,A01,507319,Halter; Christopher P.,0,3,30,30
1715639119921,EDS 204R,B01,507331,Heinzman; Erica M.,14,0,30,16
1715639120946,EDS 206R,A00,507332,Staff,0,4,30,30
1715639120946,EDS 206R,B00,507343,Staff,15,0,30,15
1715639121973,EDS 250,A00,507344,Hemans; Patricia Ann Benitez,20,0,40,20
1715639123001,EDS 281,A00,507345,Daly; Alan J.,18,0,18,0
1715639124028,EDS 284,A00,507350,Daly; Alan J.,16,0,16,0
1715639125057,EDS 286,A00,507359,Fine; Sarah,18,0,18,0
1715639126082,EDS 289C,A01,507361,Daly; Alan J.,18,0,18,0
1715639127109,EDS 290,A00,507366,Hofstetter; Carolyn,15,0,15,0
1715639128137,LIGM 5A,A00,507421,Fischer-Grunski; Eva K,17,0,20,3
1715639129162,LIGM 5B,A00,507423,Fischer-Grunski; Eva K,19,0,20,1
1715639130188,LIGM 5C,A00,507425,Fischer-Grunski; Eva K,19,0,20,1
1715639131215,LIIT 5AS,A00,507427,Carnelos; Chiara,20,0,20,0
1715639132247,LIIT 5BS,A00,507430,Carnelos; Chiara,20,0,20,0
1715639133274,LIIT 5CS,A00,507432,Carnelos; Chiara,20,0,20,0
1715639134304,LISP 5A,A00,507541,Munoz Sanchez; Alicia,11,0,20,9
1715639135333,LISP 5B,A00,507671,Munoz Sanchez; Alicia,9,0,20,11
1715639136363,LISP 5C,A00,507696,Munoz Sanchez; Alicia,9,0,20,11
1715639137389,MAE 197,001,528363,Boechler; Nicholas Sebastia,9998,0,9999,1
1715639138418,MATH 197,001,523477,Kedlaya; Kiran S.,9994,0,9999,5
1715639138418,MATH 197,002,563811,Zhang; Danna,9994,0,9999,5
1715639138418,MATH 197,003,628552,Dumitriu; Ioana,9998,0,9999,1
1715639138418,MATH 197,004,660885,Floyd; Eric,9998,0,9999,1
1715639139444,MCWP 40R,A00,518780,Staff,2,0,20,18
1715639139444,MCWP 40R,B00,518781,Staff,10,0,20,10
1715639139444,MCWP 40R,C00,518783,Staff,5,0,20,15
1715639140468,MCWP 50R,A00,518791,Staff,0,1,20,20
1715639140468,MCWP 50R,B00,518792,Staff,0,2,20,20
1715639140468,MCWP 50R,C00,518793,Staff,0,4,20,20
1715639140468,MCWP 50R,D00,518794,Staff,0,1,20,20
1715639140468,MCWP 50R,E00,518795,Staff,0,2,20,20
1715639140468,MCWP 50R,F00,518796,Staff,0,1,20,20
1715639140468,MCWP 50R,G00,518797,Staff,0,1,20,20
1715639141494,MMW 12R,A01,514034,Herbst; Matthew,0,2,16,16
1715639141494,MMW 12R,A02,514035,Herbst; Matthew,0,0,16,16
1715639142518,MMW 13R,A01,514037,Staff,0,5,16,16
1715639142518,MMW 13R,A02,514039,Staff,0,5,16,16
1715639142518,MMW 13R,A03,628519,Staff,0,4,16,16
1715639144567,SIO 295LS,A00,523233,Staff,10,0,30,20
1715639145591,SIO 295S,A00,523232,Staff,10,0,30,20
1715639146621,SIOC 290S,A01,637330,Merrifield; Mark A,21,0,30,9
1715639147645,SIOC 291S,A01,637333,Gabriel; Corey John,21,0,30,9
1715639148674,SOCI 117,A01,494376,Staff,0,5,5,5
1715639149701,WES 237B,A00,494380,Staff,10,0,20,10
1715639151779,AESE 279B,A00,494370,Wade; Jon P,0,0,33,33
1715639152810,AIP 97,001,660915,Van Den Einde; Yael Dahlia,9998,0,9999,1
1715639153896,AIP 197,001,627712,Vespa; Emanuel Ignacio,9995,0,9999,4
1715639153896,AIP 197,002,650778,Amir; On,9998,0,9999,1
1715639153896,AIP 197,003,650933,Avenancio-Leon; Carlos,9998,0,9999,1
1715639153896,AIP 197,004,658530,Heyman; Gail D.,9998,0,9999,1
1715639153896,AIP 197,005,658631,Neal; Sonya E,9998,0,9999,1
1715639153896,AIP 197,006,658671,Du; Songzi,9998,0,9999,1
1715639154925,ANAR 135S,A00,494369,Braswell; Geoffrey E.,0,0,0,0
1715639155957,BENG 196,001,628496,Engler; Adam J.,9998,0,9999,1
1715639155957,BENG 196,002,660916,Watson; John Thomas,9998,0,9999,1
1715639156984,BISP 197,001,650773,Wilhelm; James E.,9994,0,9999,5
1715639156984,BISP 197,002,658904,Coleman; Aaron B.,9998,0,9999,1
1715639158010,CAT 124RS,A01,519847,Geibel; William,0,0,20,20
1715639159035,CAT 125RS,A01,515971,Geibel; William,0,0,20,20
1715639160064,CLRE 250,A00,511389,Morris; Sheldon,9992,0,9999,7
1715639161092,CLRE 251,A00,507176,Mehta; Ravindra L.,9992,0,9999,7
1715639161092,CLRE 251,B00,511410,Mehta; Ravindra L.,9998,0,9999,1
1715639162118,CLRE 252,A00,507189,Cuomo; Raphael Eduardo,9994,0,9999,5
1715639163152,CLRE 253,A00,507199,Vaida; Florin,9994,0,9999,5
1715639163152,CLRE 253,B00,507202,Vaida; Florin,9999,0,9999,0
1715639164177,CLRE 259,A00,507211,Patel; Hemal,9996,0,9999,3
1715639165202,CLRE 260,A00,507221,Cuomo; Raphael Eduardo,9999,0,9999,0
1715639166227,CLRE 297,001,507242,Cuomo; Raphael Eduardo,9999,0,9999,0
1715639167255,COGS 197,001,638244,Voytek; Bradley Thomas,9997,0,9999,2
1715639168283,CSE 191,A00,516875,Minnes Kemp; Mor Mia,9991,0,9999,8
1715639169310,CSE 197,001,637388,Minnes Kemp; Mor Mia,9992,0,9999,7
1715639170351,CSS 201S,A01,494383,Mignozzetti; Umberto,35,0,35,0
1715639171379,CSS 202S,A01,494387,Mignozzetti; Umberto,35,0,35,0
1715639172405,DSC 197,001,628532,Eldridge; Justin Matthew,9995,0,9999,4
1715639173433,EAP 100,A00,516065,Staff,9799,0,9999,200
1715639174464,ECE 45,A01,507414,Staff,31,0,60,29
1715639176517,ECE 111,A01,507420,Staff,11,0,50,39
1715639177542,ECE 197,001,548057,Sievenpiper; Daniel F.,9991,0,9999,8
1715639178568,EDS 115,A00,507243,Choi; Bailey Miyeon,7,0,28,21
1715639179596,EDS 117,A01,494379,Staff,0,6,34,34
1715639180622,EDS 125,A00,507246,Hopkins; Megan Beth,8,0,30,22
1715639181648,EDS 128A,A01,507264,Fargason; Sharon Gayle,6,0,26,20
1715639182675,EDS 128B,A01,507293,Pappas; Elizabeth,10,0,30,20
1715639183702,EDS 139,A00,507294,Fargason; Sharon Gayle,10,0,30,20
1715639183702,EDS 139,B00,507313,Pappas; Elizabeth,11,0,30,19
1715639184731,EDS 201,A00,507315,Staff,10,0,30,20
1715639185757,EDS 203,A01,507317,Halter; Christopher P.,10,0,30,20
1715639186784,EDS 204R,A01,507319,Halter; Christopher P.,0,3,30,30
1715639186784,EDS 204R,B01,507331,Heinzman; Erica M.,14,0,30,16
1715639187809,EDS 206R,A00,507332,Staff,0,4,30,30
1715639187809,EDS 206R,B00,507343,Staff,15,0,30,15
1715639188836,EDS 250,A00,507344,Hemans; Patricia Ann Benitez,20,0,40,20
1715639189865,EDS 281,A00,507345,Daly; Alan J.,18,0,18,0
1715639190892,EDS 284,A00,507350,Daly; Alan J.,16,0,16,0
1715639191920,EDS 286,A00,507359,Fine; Sarah,18,0,18,0
1715639192945,EDS 289C,A01,507361,Daly; Alan J.,18,0,18,0
1715639193970,EDS 290,A00,507366,Hofstetter; Carolyn,15,0,15,0
1715639194995,LIGM 5A,A00,507421,Fischer-Grunski; Eva K,17,0,20,3
1715639196024,LIGM 5B,A00,507423,Fischer-Grunski; Eva K,19,0,20,1
1715639197049,LIGM 5C,A00,507425,Fischer-Grunski; Eva K,19,0,20,1
1715639198077,LIIT 5AS,A00,507427,Carnelos; Chiara,20,0,20,0
1715639199103,LIIT 5BS,A00,507430,Carnelos; Chiara,20,0,20,0
1715639200132,LIIT 5CS,A00,507432,Carnelos; Chiara,20,0,20,0
1715639201161,LISP 5A,A00,507541,Munoz Sanchez; Alicia,11,0,20,9
1715639202186,LISP 5B,A00,507671,Munoz Sanchez; Alicia,9,0,20,11
1715639203215,LISP 5C,A00,507696,Munoz Sanchez; Alicia,9,0,20,11
1715639204244,MAE 197,001,528363,Boechler; Nicholas Sebastia,9998,0,9999,1
1715639205274,MATH 197,001,523477,Kedlaya; Kiran S.,9994,0,9999,5
1715639205274,MATH 197,002,563811,Zhang; Danna,9994,0,9999,5
1715639205274,MATH 197,003,628552,Dumitriu; Ioana,9998,0,9999,1
1715639205274,MATH 197,004,660885,Floyd; Eric,9998,0,9999,1
1715639206301,MCWP 40R,A00,518780,Staff,2,0,20,18
1715639206301,MCWP 40R,B00,518781,Staff,10,0,20,10
1715639206301,MCWP 40R,C00,518783,Staff,5,0,20,15
1715639207326,MCWP 50R,A00,518791,Staff,0,1,20,20
1715639207326,MCWP 50R,B00,518792,Staff,0,2,20,20
1715639207326,MCWP 50R,C00,518793,Staff,0,4,20,20
1715639207326,MCWP 50R,D00,518794,Staff,0,1,20,20
1715639207326,MCWP 50R,E00,518795,Staff,0,2,20,20
1715639207326,MCWP 50R,F00,518796,Staff,0,1,20,20
1715639207326,MCWP 50R,G00,518797,Staff,0,1,20,20
1715639208357,MMW 12R,A01,514034,Herbst; Matthew,0,2,16,16
1715639208357,MMW 12R,A02,514035,Herbst; Matthew,0,0,16,16
1715639209385,MMW 13R,A01,514037,Staff,0,5,16,16
1715639209385,MMW 13R,A02,514039,Staff,0,5,16,16
1715639209385,MMW 13R,A03,628519,Staff,0,4,16,16
1715639211435,SIO 295LS,A00,523233,Staff,10,0,30,20
1715639212460,SIO 295S,A00,523232,Staff,10,0,30,20
1715639213486,SIOC 290S,A01,637330,Merrifield; Mark A,21,0,30,9
1715639214512,SIOC 291S,A01,637333,Gabriel; Corey John,21,0,30,9
1715639215538,SOCI 117,A01,494376,Staff,0,5,5,5
1715639216564,WES 237B,A00,494380,Staff,10,0,20,10
1715639218636,AESE 279B,A00,494370,Wade; Jon P,0,0,33,33
1715639219663,AIP 97,001,660915,Van Den Einde; Yael Dahlia,9998,0,9999,1
1715639220697,AIP 197,001,627712,Vespa; Emanuel Ignacio,9995,0,9999,4
1715639220697,AIP 197,002,650778,Amir; On,9998,0,9999,1
1715639220697,AIP 197,003,650933,Avenancio-Leon; Carlos,9998,0,9999,1
1715639220697,AIP 197,004,658530,Heyman; Gail D.,9998,0,9999,1
1715639220697,AIP 197,005,658631,Neal; Sonya E,9998,0,9999,1
1715639220697,AIP 197,006,658671,Du; Songzi,9998,0,9999,1
1715639221722,ANAR 135S,A00,494369,Braswell; Geoffrey E.,0,0,0,0
1715639222753,BENG 196,001,628496,Engler; Adam J.,9998,0,9999,1
1715639222753,BENG 196,002,660916,Watson; John Thomas,9998,0,9999,1
1715639223780,BISP 197,001,650773,Wilhelm; James E.,9994,0,9999,5
1715639223780,BISP 197,002,658904,Coleman; Aaron B.,9998,0,9999,1
1715639224807,CAT 124RS,A01,519847,Geibel; William,0,0,20,20
1715639225834,CAT 125RS,A01,515971,Geibel; William,0,0,20,20
1715639226858,CLRE 250,A00,511389,Morris; Sheldon,9992,0,9999,7
1715639227883,CLRE 251,A00,507176,Mehta; Ravindra L.,9992,0,9999,7
1715639227883,CLRE 251,B00,511410,Mehta; Ravindra L.,9998,0,9999,1
1715639228911,CLRE 252,A00,507189,Cuomo; Raphael Eduardo,9994,0,9999,5
1715639229935,CLRE 253,A00,507199,Vaida; Florin,9994,0,9999,5
1715639229935,CLRE 253,B00,507202,Vaida; Florin,9999,0,9999,0
1715639230960,CLRE 259,A00,507211,Patel; Hemal,9996,0,9999,3
1715639231985,CLRE 260,A00,507221,Cuomo; Raphael Eduardo,9999,0,9999,0
1715639233010,CLRE 297,001,507242,Cuomo; Raphael Eduardo,9999,0,9999,0
1715639234037,COGS 197,001,638244,Voytek; Bradley Thomas,9997,0,9999,2
1715639235066,CSE 191,A00,516875,Minnes Kemp; Mor Mia,9991,0,9999,8
1715639236093,CSE 197,001,637388,Minnes Kemp; Mor Mia,9992,0,9999,7
1715639237123,CSS 201S,A01,494383,Mignozzetti; Umberto,35,0,35,0
1715639238153,CSS 202S,A01,494387,Mignozzetti; Umberto,35,0,35,0
1715639239176,DSC 197,001,628532,Eldridge; Justin Matthew,9995,0,9999,4
1715639240201,EAP 100,A00,516065,Staff,9799,0,9999,200
1715639241226,ECE 45,A01,507414,Staff,31,0,60,29
1715639243295,ECE 111,A01,507420,Staff,11,0,50,39
1715639244325,ECE 197,001,548057,Sievenpiper; Daniel F.,9991,0,9999,8
1715639245350,EDS 115,A00,507243,Choi; Bailey Miyeon,7,0,28,21
1715639246374,EDS 117,A01,494379,Staff,0,6,34,34
1715639247404,EDS 125,A00,507246,Hopkins; Megan Beth,8,0,30,22
1715639248430,EDS 128A,A01,507264,Fargason; Sharon Gayle,6,0,26,20
1715639249455,EDS 128B,A01,507293,Pappas; Elizabeth,10,0,30,20
1715639250480,EDS 139,A00,507294,Fargason; Sharon Gayle,10,0,30,20
1715639250480,EDS 139,B00,507313,Pappas; Elizabeth,11,0,30,19
1715639251504,EDS 201,A00,507315,Staff,10,0,30,20
1715639252534,EDS 203,A01,507317,Halter; Christopher P.,10,0,30,20
1715639253563,EDS 204R,A01,507319,Halter; Christopher P.,0,3,30,30
1715639253563,EDS 204R,B01,507331,Heinzman; Erica M.,14,0,30,16
1715639254591,EDS 206R,A00,507332,Staff,0,4,30,30
1715639254591,EDS 206R,B00,507343,Staff,15,0,30,15
1715639255617,EDS 250,A00,507344,Hemans; Patricia Ann Benitez,20,0,40,20
1715639256644,EDS 281,A00,507345,Daly; Alan J.,18,0,18,0
1715639257671,EDS 284,A00,507350,Daly; Alan J.,16,0,16,0
1715639258697,EDS 286,A00,507359,Fine; Sarah,18,0,18,0
1715639259724,EDS 289C,A01,507361,Daly; Alan J.,18,0,18,0
1715639260750,EDS 290,A00,507366,Hofstetter; Carolyn,15,0,15,0
1715639261775,LIGM 5A,A00,507421,Fischer-Grunski; Eva K,17,0,20,3
1715639262801,LIGM 5B,A00,507423,Fischer-Grunski; Eva K,19,0,20,1
1715639263825,LIGM 5C,A00,507425,Fischer-Grunski; Eva K,19,0,20,1
1715639264855,LIIT 5AS,A00,507427,Carnelos; Chiara,20,0,20,0
1715639265879,LIIT 5BS,A00,507430,Carnelos; Chiara,20,0,20,0
1715639266905,LIIT 5CS,A00,507432,Carnelos; Chiara,20,0,20,0
1715639267932,LISP 5A,A00,507541,Munoz Sanchez; Alicia,11,0,20,9
1715639268959,LISP 5B,A00,507671,Munoz Sanchez; Alicia,8,0,20,12
1715639269985,LISP 5C,A00,507696,Munoz Sanchez; Alicia,8,0,20,12
1715639271010,MAE 197,001,528363,Boechler; Nicholas Sebastia,9998,0,9999,1
1715639272043,MATH 197,001,523477,Kedlaya; Kiran S.,9994,0,9999,5
1715639272043,MATH 197,002,563811,Zhang; Danna,9994,0,9999,5
1715639272043,MATH 197,003,628552,Dumitriu; Ioana,9998,0,9999,1
1715639272043,MATH 197,004,660885,Floyd; Eric,9998,0,9999,1
1715639273070,MCWP 40R,A00,518780,Staff,2,0,20,18
1715639273070,MCWP 40R,B00,518781,Staff,10,0,20,10
1715639273070,MCWP 40R,C00,518783,Staff,5,0,20,15
1715639274097,MCWP 50R,A00,518791,Staff,0,1,20,20
1715639274097,MCWP 50R,B00,518792,Staff,0,2,20,20
1715639274097,MCWP 50R,C00,518793,Staff,0,4,20,20
1715639274097,MCWP 50R,D00,518794,Staff,0,1,20,20
1715639274097,MCWP 50R,E00,518795,Staff,0,2,20,20
1715639274097,MCWP 50R,F00,518796,Staff,0,1,20,20
1715639274097,MCWP 50R,G00,518797,Staff,0,1,20,20
1715639275121,MMW 12R,A01,514034,Herbst; Matthew,0,2,16,16
1715639275121,MMW 12R,A02,514035,Herbst; Matthew,0,0,16,16
1715639276150,MMW 13R,A01,514037,Staff,0,5,16,16
1715639276150,MMW 13R,A02,514039,Staff,0,5,16,16
1715639276150,MMW 13R,A03,628519,Staff,0,4,16,16
1715639278200,SIO 295LS,A00,523233,Staff,10,0,30,20
1715639279226,SIO 295S,A00,523232,Staff,10,0,30,20
1715639280252,SIOC 290S,A01,637330,Merrifield; Mark A,21,0,30,9
1715639281281,SIOC 291S,A01,637333,Gabriel; Corey John,21,0,30,9
1715639282320,SOCI 117,A01,494376,Staff,0,5,5,5
1715639283349,WES 237B,A00,494380,Staff,10,0,20,10
1715639285416,AESE 279B,A00,494370,Wade; Jon P,0,0,33,33
1715639286443,AIP 97,001,660915,Van Den Einde; Yael Dahlia,9998,0,9999,1
1715639287484,AIP 197,001,627712,Vespa; Emanuel Ignacio,9995,0,9999,4
1715639287484,AIP 197,002,650778,Amir; On,9998,0,9999,1
1715639287484,AIP 197,003,650933,Avenancio-Leon; Carlos,9998,0,9999,1
1715639287484,AIP 197,004,658530,Heyman; Gail D.,9998,0,9999,1
1715639287484,AIP 197,005,658631,Neal; Sonya E,9998,0,9999,1
1715639287484,AIP 197,006,658671,Du; Songzi,9998,0,9999,1
1715639288515,ANAR 135S,A00,494369,Braswell; Geoffrey E.,0,0,0,0
1715639289545,BENG 196,001,628496,Engler; Adam J.,9998,0,9999,1
1715639289545,BENG 196,002,660916,Watson; John Thomas,9998,0,9999,1
1715639290574,BISP 197,001,650773,Wilhelm; James E.,9994,0,9999,5
1715639290574,BISP 197,002,658904,Coleman; Aaron B.,9998,0,9999,1
1715639291603,CAT 124RS,A01,519847,Geibel; William,0,0,20,20
1715639292633,CAT 125RS,A01,515971,Geibel; William,0,0,20,20
1715639293658,CLRE 250,A00,511389,Morris; Sheldon,9992,0,9999,7
1715639294688,CLRE 251,A00,507176,Mehta; Ravindra L.,9992,0,9999,7
1715639294688,CLRE 251,B00,511410,Mehta; Ravindra L.,9998,0,9999,1
1715639295716,CLRE 252,A00,507189,Cuomo; Raphael Eduardo,9994,0,9999,5
1715639296743,CLRE 253,A00,507199,Vaida; Florin,9994,0,9999,5
1715639296743,CLRE 253,B00,507202,Vaida; Florin,9999,0,9999,0
1715639297773,CLRE 259,A00,507211,Patel; Hemal,9996,0,9999,3
1715639298798,CLRE 260,A00,507221,Cuomo; Raphael Eduardo,9999,0,9999,0
1715639299822,CLRE 297,001,507242,Cuomo; Raphael Eduardo,9999,0,9999,0
1715639300848,COGS 197,001,638244,Voytek; Bradley Thomas,9997,0,9999,2
1715639301873,CSE 191,A00,516875,Minnes Kemp; Mor Mia,9991,0,9999,8
1715639302899,CSE 197,001,637388,Minnes Kemp; Mor Mia,9992,0,9999,7
1715639303925,CSS 201S,A01,494383,Mignozzetti; Umberto,35,0,35,0
1715639304956,CSS 202S,A01,494387,Mignozzetti; Umberto,35,0,35,0
1715639305984,DSC 197,001,628532,Eldridge; Justin Matthew,9995,0,9999,4
1715639307011,EAP 100,A00,516065,Staff,9799,0,9999,200
1715639308039,ECE 45,A01,507414,Staff,31,0,60,29
1715639310089,ECE 111,A01,507420,Staff,11,0,50,39
1715639311115,ECE 197,001,548057,Sievenpiper; Daniel F.,9991,0,9999,8
1715639312147,EDS 115,A00,507243,Choi; Bailey Miyeon,7,0,28,21
1715639313245,EDS 117,A01,494379,Staff,0,6,34,34
1715639314272,EDS 125,A00,507246,Hopkins; Megan Beth,8,0,30,22
1715639315300,EDS 128A,A01,507264,Fargason; Sharon Gayle,6,0,26,20
1715639316327,EDS 128B,A01,507293,Pappas; Elizabeth,10,0,30,20
1715639317354,EDS 139,A00,507294,Fargason; Sharon Gayle,10,0,30,20
1715639317354,EDS 139,B00,507313,Pappas; Elizabeth,11,0,30,19
1715639318378,EDS 201,A00,507315,Staff,10,0,30,20
1715639319404,EDS 203,A01,507317,Halter; Christopher P.,10,0,30,20
1715639320429,EDS 204R,A01,507319,Halter; Christopher P.,0,3,30,30
1715639320429,EDS 204R,B01,507331,Heinzman; Erica M.,14,0,30,16
1715639321458,EDS 206R,A00,507332,Staff,0,4,30,30
1715639321458,EDS 206R,B00,507343,Staff,15,0,30,15
1715639322485,EDS 250,A00,507344,Hemans; Patricia Ann Benitez,20,0,40,20
1715639323517,EDS 281,A00,507345,Daly; Alan J.,18,0,18,0
1715639324541,EDS 284,A00,507350,Daly; Alan J.,16,0,16,0
1715639325571,EDS 286,A00,507359,Fine; Sarah,18,0,18,0
1715639326598,EDS 289C,A01,507361,Daly; Alan J.,18,0,18,0
1715639327630,EDS 290,A00,507366,Hofstetter; Carolyn,15,0,15,0
1715639328662,LIGM 5A,A00,507421,Fischer-Grunski; Eva K,17,0,20,3
1715639329688,LIGM 5B,A00,507423,Fischer-Grunski; Eva K,19,0,20,1
1715639330719,LIGM 5C,A00,507425,Fischer-Grunski; Eva K,19,0,20,1
1715639331746,LIIT 5AS,A00,507427,Carnelos; Chiara,20,0,20,0
1715639332777,LIIT 5BS,A00,507430,Carnelos; Chiara,20,0,20,0
1715639333805,LIIT 5CS,A00,507432,Carnelos; Chiara,20,0,20,0
1715639334832,LISP 5A,A00,507541,Munoz Sanchez; Alicia,11,0,20,9
1715639335856,LISP 5B,A00,507671,Munoz Sanchez; Alicia,8,0,20,12
1715639336881,LISP 5C,A00,507696,Munoz Sanchez; Alicia,8,0,20,12
1715639337906,MAE 197,001,528363,Boechler; Nicholas Sebastia,9998,0,9999,1
1715639338933,MATH 197,001,523477,Kedlaya; Kiran S.,9994,0,9999,5
1715639338933,MATH 197,002,563811,Zhang; Danna,9994,0,9999,5
1715639338933,MATH 197,003,628552,Dumitriu; Ioana,9998,0,9999,1
1715639338933,MATH 197,004,660885,Floyd; Eric,9998,0,9999,1
1715639339960,MCWP 40R,A00,518780,Staff,2,0,20,18
1715639339960,MCWP 40R,B00,518781,Staff,10,0,20,10
1715639339960,MCWP 40R,C00,518783,Staff,5,0,20,15
1715639340990,MCWP 50R,A00,518791,Staff,0,1,20,20
1715639340990,MCWP 50R,B00,518792,Staff,0,2,20,20
1715639340990,MCWP 50R,C00,518793,Staff,0,4,20,20
1715639340990,MCWP 50R,D00,518794,Staff,0,1,20,20
1715639340990,MCWP 50R,E00,518795,Staff,0,2,20,20
1715639340990,MCWP 50R,F00,518796,Staff,0,1,20,20
1715639340990,MCWP 50R,G00,518797,Staff,0,1,20,20
1715639342020,MMW 12R,A01,514034,Herbst; Matthew,0,2,16,16
1715639342020,MMW 12R,A02,514035,Herbst; Matthew,0,0,16,16
1715639343053,MMW 13R,A01,514037,Staff,0,5,16,16
1715639343053,MMW 13R,A02,514039,Staff,0,5,16,16
1715639343053,MMW 13R,A03,628519,Staff,0,4,16,16
1715639345107,SIO 295LS,A00,523233,Staff,10,0,30,20
1715639346133,SIO 295S,A00,523232,Staff,10,0,30,20
1715639347164,SIOC 290S,A01,637330,Merrifield; Mark A,21,0,30,9
1715639348190,SIOC 291S,A01,637333,Gabriel; Corey John,21,0,30,9
1715639349219,SOCI 117,A01,494376,Staff,0,5,5,5
1715639350244,WES 237B,A00,494380,Staff,10,0,20,10
1715639352312,AESE 279B,A00,494370,Wade; Jon P,0,0,33,33
1715639353341,AIP 97,001,660915,Van Den Einde; Yael Dahlia,9998,0,9999,1
1715639354369,AIP 197,001,627712,Vespa; Emanuel Ignacio,9995,0,9999,4
1715639354369,AIP 197,002,650778,Amir; On,9998,0,9999,1
1715639354369,AIP 197,003,650933,Avenancio-Leon; Carlos,9998,0,9999,1
1715639354369,AIP 197,004,658530,Heyman; Gail D.,9998,0,9999,1
1715639354369,AIP 197,005,658631,Neal; Sonya E,9998,0,9999,1
1715639354369,AIP 197,006,658671,Du; Songzi,9998,0,9999,1
1715639355398,ANAR 135S,A00,494369,Braswell; Geoffrey E.,0,0,0,0
1715639356427,BENG 196,001,628496,Engler; Adam J.,9998,0,9999,1
1715639356427,BENG 196,002,660916,Watson; John Thomas,9998,0,9999,1
1715639357452,BISP 197,001,650773,Wilhelm; James E.,9994,0,9999,5
1715639357452,BISP 197,002,658904,Coleman; Aaron B.,9998,0,9999,1
1715639358478,CAT 124RS,A01,519847,Geibel; William,0,0,20,20
1715639359504,CAT 125RS,A01,515971,Geibel; William,0,0,20,20
1715639360530,CLRE 250,A00,511389,Morris; Sheldon,9992,0,9999,7
1715639361560,CLRE 251,A00,507176,Mehta; Ravindra L.,9992,0,9999,7
1715639361560,CLRE 251,B00,511410,Mehta; Ravindra L.,9998,0,9999,1
1715639362587,CLRE 252,A00,507189,Cuomo; Raphael Eduardo,9994,0,9999,5
1715639363615,CLRE 253,A00,507199,Vaida; Florin,9994,0,9999,5
1715639363615,CLRE 253,B00,507202,Vaida; Florin,9999,0,9999,0
1715639364645,CLRE 259,A00,507211,Patel; Hemal,9996,0,9999,3
1715639365668,CLRE 260,A00,507221,Cuomo; Raphael Eduardo,9999,0,9999,0
1715639366694,CLRE 297,001,507242,Cuomo; Raphael Eduardo,9999,0,9999,0
1715639367718,COGS 197,001,638244,Voytek; Bradley Thomas,9997,0,9999,2
1715639368745,CSE 191,A00,516875,Minnes Kemp; Mor Mia,9991,0,9999,8
1715639369770,CSE 197,001,637388,Minnes Kemp; Mor Mia,9992,0,9999,7
1715639370801,CSS 201S,A01,494383,Mignozzetti; Umberto,35,0,35,0
1715639371828,CSS 202S,A01,494387,Mignozzetti; Umberto,35,0,35,0
1715639372855,DSC 197,001,628532,Eldridge; Justin Matthew,9995,0,9999,4
1715639373881,EAP 100,A00,516065,Staff,9799,0,9999,200
1715639374910,ECE 45,A01,507414,Staff,31,0,60,29
1715639376959,ECE 111,A01,507420,Staff,11,0,50,39
1715639377985,ECE 197,001,548057,Sievenpiper; Daniel F.,9991,0,9999,8
1715639379010,EDS 115,A00,507243,Choi; Bailey Miyeon,7,0,28,21
1715639380036,EDS 117,A01,494379,Staff,0,6,34,35
1715639381065,EDS 125,A00,507246,Hopkins; Megan Beth,8,0,30,22
1715639382090,EDS 128A,A01,507264,Fargason; Sharon Gayle,6,0,26,20
1715639383119,EDS 128B,A01,507293,Pappas; Elizabeth,10,0,30,20
1715639384145,EDS 139,A00,507294,Fargason; Sharon Gayle,10,0,30,20
1715639384145,EDS 139,B00,507313,Pappas; Elizabeth,10,0,30,20
1715639385169,EDS 201,A00,507315,Staff,10,0,30,20
1715639386200,EDS 203,A01,507317,Halter; Christopher P.,10,0,30,20
1715639387228,EDS 204R,A01,507319,Halter; Christopher P.,0,3,30,30
1715639387228,EDS 204R,B01,507331,Heinzman; Erica M.,14,0,30,16
1715639388252,EDS 206R,A00,507332,Staff,0,4,30,30
1715639388252,EDS 206R,B00,507343,Staff,15,0,30,15
1715639389280,EDS 250,A00,507344,Hemans; Patricia Ann Benitez,20,0,40,20
1715639390306,EDS 281,A00,507345,Daly; Alan J.,18,0,18,0
1715639391331,EDS 284,A00,507350,Daly; Alan J.,16,0,16,0
1715639392361,EDS 286,A00,507359,Fine; Sarah,18,0,18,0
1715639393390,EDS 289C,A01,507361,Daly; Alan J.,18,0,18,0
1715639394419,EDS 290,A00,507366,Hofstetter; Carolyn,15,0,15,0
1715639395446,LIGM 5A,A00,507421,Fischer-Grunski; Eva K,17,0,20,3
1715639396473,LIGM 5B,A00,507423,Fischer-Grunski; Eva K,19,0,20,1
1715639397500,LIGM 5C,A00,507425,Fischer-Grunski; Eva K,19,0,20,1
1715639398529,LIIT 5AS,A00,507427,Carnelos; Chiara,20,0,20,0
1715639399557,LIIT 5BS,A00,507430,Carnelos; Chiara,20,0,20,0
1715639400586,LIIT 5CS,A00,507432,Carnelos; Chiara,20,0,20,0
1715639401617,LISP 5A,A00,507541,Munoz Sanchez; Alicia,11,0,20,9
1715639402642,LISP 5B,A00,507671,Munoz Sanchez; Alicia,8,0,20,12
1715639403669,LISP 5C,A00,507696,Munoz Sanchez; Alicia,8,0,20,12
1715639404695,MAE 197,001,528363,Boechler; Nicholas Sebastia,9998,0,9999,1
1715639405729,MATH 197,001,523477,Kedlaya; Kiran S.,9994,0,9999,5
1715639405729,MATH 197,002,563811,Zhang; Danna,9994,0,9999,5
1715639405729,MATH 197,003,628552,Dumitriu; Ioana,9998,0,9999,1
1715639405729,MATH 197,004,660885,Floyd; Eric,9998,0,9999,1
1715639406755,MCWP 40R,A00,518780,Staff,2,0,20,18
1715639406755,MCWP 40R,B00,518781,Staff,10,0,20,10
1715639406755,MCWP 40R,C00,518783,Staff,5,0,20,15
1715639407780,MCWP 50R,A00,518791,Staff,0,1,20,20
1715639407780,MCWP 50R,B00,518792,Staff,0,2,20,20
1715639407780,MCWP 50R,C00,518793,Staff,0,4,20,20
1715639407780,MCWP 50R,D00,518794,Staff,0,1,20,20
1715639407780,MCWP 50R,E00,518795,Staff,0,2,20,20
1715639407780,MCWP 50R,F00,518796,Staff,0,1,20,20
1715639407780,MCWP 50R,G00,518797,Staff,0,1,20,20
1715639408808,MMW 12R,A01,514034,Herbst; Matthew,0,2,16,16
1715639408808,MMW 12R,A02,514035,Herbst; Matthew,0,0,16,16
1715639409835,MMW 13R,A01,514037,Staff,0,5,16,16
1715639409835,MMW 13R,A02,514039,Staff,0,5,16,16
1715639409835,MMW 13R,A03,628519,Staff,0,4,16,16
1715639411894,SIO 295LS,A00,523233,Staff,10,0,30,20
1715639412922,SIO 295S,A00,523232,Staff,10,0,30,20
1715639413948,SIOC 290S,A01,637330,Merrifield; Mark A,21,0,30,9
1715639414975,SIOC 291S,A01,637333,Gabriel; Corey John,21,0,30,9
1715639416001,SOCI 117,A01,494376,Staff,0,5,5,5
1715639417082,WES 237B,A00,494380,Staff,10,0,20,10
1715639419149,AESE 279B,A00,494370,Wade; Jon P,0,0,33,33
1715639420178,AIP 97,001,660915,Van Den Einde; Yael Dahlia,9998,0,9999,1
1715639421210,AIP 197,001,627712,Vespa; Emanuel Ignacio,9995,0,9999,4
1715639421210,AIP 197,002,650778,Amir; On,9998,0,9999,1
1715639421210,AIP 197,003,650933,Avenancio-Leon; Carlos,9998,0,9999,1
1715639421210,AIP 197,004,658530,Heyman; Gail D.,9998,0,9999,1
1715639421210,AIP 197,005,658631,Neal; Sonya E,9998,0,9999,1
1715639421210,AIP 197,006,658671,Du; Songzi,9998,0,9999,1
1715639422242,ANAR 135S,A00,494369,Braswell; Geoffrey E.,0,0,0,0
1715639423272,BENG 196,001,628496,Engler; Adam J.,9998,0,9999,1
1715639423272,BENG 196,002,660916,Watson; John Thomas,9998,0,9999,1
1715639424299,BISP 197,001,650773,Wilhelm; James E.,9994,0,9999,5
1715639424299,BISP 197,002,658904,Coleman; Aaron B.,9998,0,9999,1
1715639425325,CAT 124RS,A01,519847,Geibel; William,0,0,20,20
1715639426351,CAT 125RS,A01,515971,Geibel; William,0,0,20,20
1715639427376,CLRE 250,A00,511389,Morris; Sheldon,9992,0,9999,7
1715639428406,CLRE 251,A00,507176,Mehta; Ravindra L.,9992,0,9999,7
1715639428406,CLRE 251,B00,511410,Mehta; Ravindra L.,9998,0,9999,1
1715639429431,CLRE 252,A00,507189,Cuomo; Raphael Eduardo,9994,0,9999,5
1715639430457,CLRE 253,A00,507199,Vaida; Florin,9994,0,9999,5
1715639430457,CLRE 253,B00,507202,Vaida; Florin,9999,0,9999,0
1715639431482,CLRE 259,A00,507211,Patel; Hemal,9996,0,9999,3
1715639432506,CLRE 260,A00,507221,Cuomo; Raphael Eduardo,9999,0,9999,0
1715639433536,CLRE 297,001,507242,Cuomo; Raphael Eduardo,9999,0,9999,0
1715639434561,COGS 197,001,638244,Voytek; Bradley Thomas,9997,0,9999,2
1715639435589,CSE 191,A00,516875,Minnes Kemp; Mor Mia,9991,0,9999,8
1715639436618,CSE 197,001,637388,Minnes Kemp; Mor Mia,9992,0,9999,7
1715639437645,CSS 201S,A01,494383,Mignozzetti; Umberto,35,0,35,0
1715639438670,CSS 202S,A01,494387,Mignozzetti; Umberto,35,0,35,0
1715639439696,DSC 197,001,628532,Eldridge; Justin Matthew,9995,0,9999,4
1715639440718,EAP 100,A00,516065,Staff,9799,0,9999,200
1715639441742,ECE 45,A01,507414,Staff,31,0,60,29
1715639443793,ECE 111,A01,507420,Staff,11,0,50,39
1715639444821,ECE 197,001,548057,Sievenpiper; Daniel F.,9991,0,9999,8
1715639445847,EDS 115,A00,507243,Choi; Bailey Miyeon,6,0,28,22
1715639446876,EDS 117,A01,494379,Staff,0,6,34,35
1715639447900,EDS 125,A00,507246,Hopkins; Megan Beth,7,0,30,23
1715639448925,EDS 128A,A01,507264,Fargason; Sharon Gayle,5,0,26,21
1715639449949,EDS 128B,A01,507293,Pappas; Elizabeth,9,0,30,21
1715639450974,EDS 139,A00,507294,Fargason; Sharon Gayle,9,0,30,21
1715639450974,EDS 139,B00,507313,Pappas; Elizabeth,10,0,30,20
1715639452003,EDS 201,A00,507315,Staff,10,0,30,20
1715639453027,EDS 203,A01,507317,Halter; Christopher P.,10,0,30,20
1715639454057,EDS 204R,A01,507319,Halter; Christopher P.,0,3,30,30
1715639454057,EDS 204R,B01,507331,Heinzman; Erica M.,14,0,30,16
1715639455084,EDS 206R,A00,507332,Staff,0,4,30,30
1715639455084,EDS 206R,B00,507343,Staff,15,0,30,15
1715639456114,EDS 250,A00,507344,Hemans; Patricia Ann Benitez,20,0,40,20
1715639457140,EDS 281,A00,507345,Daly; Alan J.,18,0,18,0
1715639458169,EDS 284,A00,507350,Daly; Alan J.,16,0,16,0
1715639459194,EDS 286,A00,507359,Fine; Sarah,18,0,18,0
1715639460227,EDS 289C,A01,507361,Daly; Alan J.,18,0,18,0
1715639461255,EDS 290,A00,507366,Hofstetter; Carolyn,15,0,15,0
1715639462282,LIGM 5A,A00,507421,Fischer-Grunski; Eva K,17,0,20,3
1715639463306,LIGM 5B,A00,507423,Fischer-Grunski; Eva K,19,0,20,1
1715639464336,LIGM 5C,A00,507425,Fischer-Grunski; Eva K,19,0,20,1
1715639465366,LIIT 5AS,A00,507427,Carnelos; Chiara,20,0,20,0
1715639466393,LIIT 5BS,A00,507430,Carnelos; Chiara,20,0,20,0
1715639467421,LIIT 5CS,A00,507432,Carnelos; Chiara,20,0,20,0
1715639468447,LISP 5A,A00,507541,Munoz Sanchez; Alicia,11,0,20,9
1715639469472,LISP 5B,A00,507671,Munoz Sanchez; Alicia,8,0,20,12
1715639470501,LISP 5C,A00,507696,Munoz Sanchez; Alicia,8,0,20,12
1715639471526,MAE 197,001,528363,Boechler; Nicholas Sebastia,9998,0,9999,1
1715639472556,MATH 197,001,523477,Kedlaya; Kiran S.,9994,0,9999,5
1715639472556,MATH 197,002,563811,Zhang; Danna,9994,0,9999,5
1715639472556,MATH 197,003,628552,Dumitriu; Ioana,9998,0,9999,1
1715639472556,MATH 197,004,660885,Floyd; Eric,9998,0,9999,1
1715639473582,MCWP 40R,A00,518780,Staff,2,0,20,18
1715639473582,MCWP 40R,B00,518781,Staff,10,0,20,10
1715639473582,MCWP 40R,C00,518783,Staff,5,0,20,15
1715639474607,MCWP 50R,A00,518791,Staff,0,1,20,20
1715639474607,MCWP 50R,B00,518792,Staff,0,2,20,20
1715639474607,MCWP 50R,C00,518793,Staff,0,4,20,20
1715639474607,MCWP 50R,D00,518794,Staff,0,1,20,20
1715639474607,MCWP 50R,E00,518795,Staff,0,2,20,20
1715639474607,MCWP 50R,F00,518796,Staff,0,1,20,20
1715639474607,MCWP 50R,G00,518797,Staff,0,1,20,20
1715639475635,MMW 12R,A01,514034,Herbst; Matthew,0,2,16,16
1715639475635,MMW 12R,A02,514035,Herbst; Matthew,0,0,16,16
1715639476660,MMW 13R,A01,514037,Staff,0,5,16,16
1715639476660,MMW 13R,A02,514039,Staff,0,5,16,16
1715639476660,MMW 13R,A03,628519,Staff,0,4,16,16
1715639478714,SIO 295LS,A00,523233,Staff,10,0,30,20
1715639479740,SIO 295S,A00,523232,Staff,10,0,30,20
1715639480767,SIOC 290S,A01,637330,Merrifield; Mark A,21,0,30,9
1715639481793,SIOC 291S,A01,637333,Gabriel; Corey John,21,0,30,9
1715639482817,SOCI 117,A01,494376,Staff,0,5,5,5
1715639483845,WES 237B,A00,494380,Staff,10,0,20,10
1715639485923,AESE 279B,A00,494370,Wade; Jon P,0,0,33,33
1715639486951,AIP 97,001,660915,Van Den Einde; Yael Dahlia,9998,0,9999,1
1715639487978,AIP 197,001,627712,Vespa; Emanuel Ignacio,9995,0,9999,4
1715639487978,AIP 197,002,650778,Amir; On,9998,0,9999,1
1715639487978,AIP 197,003,650933,Avenancio-Leon; Carlos,9998,0,9999,1
1715639487978,AIP 197,004,658530,Heyman; Gail D.,9998,0,9999,1
1715639487978,AIP 197,005,658631,Neal; Sonya E,9998,0,9999,1
1715639487978,AIP 197,006,658671,Du; Songzi,9998,0,9999,1
1715639489007,ANAR 135S,A00,494369,Braswell; Geoffrey E.,0,0,0,0
1715639490035,BENG 196,001,628496,Engler; Adam J.,9998,0,9999,1
1715639490035,BENG 196,002,660916,Watson; John Thomas,9998,0,9999,1
1715639491062,BISP 197,001,650773,Wilhelm; James E.,9994,0,9999,5
1715639491062,BISP 197,002,658904,Coleman; Aaron B.,9998,0,9999,1
1715639492093,CAT 124RS,A01,519847,Geibel; William,0,0,20,20
1715639493117,CAT 125RS,A01,515971,Geibel; William,0,0,20,20
1715639494146,CLRE 250,A00,511389,Morris; Sheldon,9992,0,9999,7
1715639495173,CLRE 251,A00,507176,Mehta; Ravindra L.,9992,0,9999,7
1715639495173,CLRE 251,B00,511410,Mehta; Ravindra L.,9998,0,9999,1
1715639496200,CLRE 252,A00,507189,Cuomo; Raphael Eduardo,9994,0,9999,5
1715639497230,CLRE 253,A00,507199,Vaida; Florin,9994,0,9999,5
1715639497230,CLRE 253,B00,507202,Vaida; Florin,9999,0,9999,0
1715639498255,CLRE 259,A00,507211,Patel; Hemal,9996,0,9999,3
1715639499279,CLRE 260,A00,507221,Cuomo; Raphael Eduardo,9999,0,9999,0
1715639500307,CLRE 297,001,507242,Cuomo; Raphael Eduardo,9999,0,9999,0
1715639501335,COGS 197,001,638244,Voytek; Bradley Thomas,9997,0,9999,2
1715639502361,CSE 191,A00,516875,Minnes Kemp; Mor Mia,9991,0,9999,8
1715639503389,CSE 197,001,637388,Minnes Kemp; Mor Mia,9992,0,9999,7
1715639504415,CSS 201S,A01,494383,Mignozzetti; Umberto,35,0,35,0
1715639505441,CSS 202S,A01,494387,Mignozzetti; Umberto,35,0,35,0
1715639506468,DSC 197,001,628532,Eldridge; Justin Matthew,9995,0,9999,4
1715639507493,EAP 100,A00,516065,Staff,9799,0,9999,200
1715639508518,ECE 45,A01,507414,Staff,31,0,60,29
1715639510568,ECE 111,A01,507420,Staff,11,0,50,39
1715639511595,ECE 197,001,548057,Sievenpiper; Daniel F.,9991,0,9999,8
1715639512626,EDS 115,A00,507243,Choi; Bailey Miyeon,6,0,28,22
1715639513654,EDS 117,A01,494379,Staff,0,6,34,35
1715639514683,EDS 125,A00,507246,Hopkins; Megan Beth,7,0,30,23
1715639515712,EDS 128A,A01,507264,Fargason; Sharon Gayle,5,0,26,21
1715639516740,EDS 128B,A01,507293,Pappas; Elizabeth,9,0,30,21
1715639517765,EDS 139,A00,507294,Fargason; Sharon Gayle,9,0,30,21
1715639517765,EDS 139,B00,507313,Pappas; Elizabeth,9,0,30,21
1715639518789,EDS 201,A00,507315,Staff,10,0,30,20
1715639519820,EDS 203,A01,507317,Halter; Christopher P.,10,0,30,20
1715639520900,EDS 204R,A01,507319,Halter; Christopher P.,0,3,30,30
1715639520900,EDS 204R,B01,507331,Heinzman; Erica M.,14,0,30,16
1715639521926,EDS 206R,A00,507332,Staff,0,4,30,30
1715639521926,EDS 206R,B00,507343,Staff,15,0,30,15
1715639522951,EDS 250,A00,507344,Hemans; Patricia Ann Benitez,20,0,40,20
1715639523981,EDS 281,A00,507345,Daly; Alan J.,18,0,18,0
1715639525007,EDS 284,A00,507350,Daly; Alan J.,16,0,16,0
1715639526031,EDS 286,A00,507359,Fine; Sarah,18,0,18,0
1715639527056,EDS 289C,A01,507361,Daly; Alan J.,18,0,18,0
1715639528085,EDS 290,A00,507366,Hofstetter; Carolyn,15,0,15,0
1715639529110,LIGM 5A,A00,507421,Fischer-Grunski; Eva K,17,0,20,3
1715639530138,LIGM 5B,A00,507423,Fischer-Grunski; Eva K,19,0,20,1
1715639531165,LIGM 5C,A00,507425,Fischer-Grunski; Eva K,19,0,20,1
1715639532194,LIIT 5AS,A00,507427,Carnelos; Chiara,20,0,20,0
1715639533219,LIIT 5BS,A00,507430,Carnelos; Chiara,20,0,20,0
1715639534245,LIIT 5CS,A00,507432,Carnelos; Chiara,20,0,20,0
1715639535272,LISP 5A,A00,507541,Munoz Sanchez; Alicia,11,0,20,9
1715639536303,LISP 5B,A00,507671,Munoz Sanchez; Alicia,8,0,20,12
1715639537329,LISP 5C,A00,507696,Munoz Sanchez; Alicia,8,0,20,12
1715639538357,MAE 197,001,528363,Boechler; Nicholas Sebastia,9998,0,9999,1
1715639539383,MATH 197,001,523477,Kedlaya; Kiran S.,9994,0,9999,5
1715639539383,MATH 197,002,563811,Zhang; Danna,9994,0,9999,5
1715639539383,MATH 197,003,628552,Dumitriu; Ioana,9998,0,9999,1
1715639539383,MATH 197,004,660885,Floyd; Eric,9998,0,9999,1
1715639540407,MCWP 40R,A00,518780,Staff,2,0,20,18
1715639540407,MCWP 40R,B00,518781,Staff,10,0,20,10
1715639540407,MCWP 40R,C00,518783,Staff,5,0,20,15
1715639541431,MCWP 50R,A00,518791,Staff,0,1,20,20
1715639541431,MCWP 50R,B00,518792,Staff,0,2,20,20
1715639541431,MCWP 50R,C00,518793,Staff,0,4,20,20
1715639541431,MCWP 50R,D00,518794,Staff,0,1,20,20
1715639541431,MCWP 50R,E00,518795,Staff,0,2,20,20
1715639541431,MCWP 50R,F00,518796,Staff,0,1,20,20
1715639541431,MCWP 50R,G00,518797,Staff,0,1,20,20
1715639542485,MMW 12R,A01,514034,Herbst; Matthew,0,2,16,16
1715639542485,MMW 12R,A02,514035,Herbst; Matthew,0,0,16,16
1715639543510,MMW 13R,A01,514037,Staff,0,5,16,16
1715639543510,MMW 13R,A02,514039,Staff,0,5,16,16
1715639543510,MMW 13R,A03,628519,Staff,0,4,16,16
1715639545564,SIO 295LS,A00,523233,Staff,10,0,30,20
1715639546592,SIO 295S,A00,523232,Staff,10,0,30,20
1715639547619,SIOC 290S,A01,637330,Merrifield; Mark A,21,0,30,9
1715639548647,SIOC 291S,A01,637333,Gabriel; Corey John,21,0,30,9
1715639549674,SOCI 117,A01,494376,Staff,0,5,5,5
1715639550703,WES 237B,A00,494380,Staff,10,0,20,10
1715639552783,AESE 279B,A00,494370,Wade; Jon P,0,0,33,33
1715639553809,AIP 97,001,660915,Van Den Einde; Yael Dahlia,9998,0,9999,1
1715639554837,AIP 197,001,627712,Vespa; Emanuel Ignacio,9995,0,9999,4
1715639554837,AIP 197,002,650778,Amir; On,9998,0,9999,1
1715639554837,AIP 197,003,650933,Avenancio-Leon; Carlos,9998,0,9999,1
1715639554837,AIP 197,004,658530,Heyman; Gail D.,9998,0,9999,1
1715639554837,AIP 197,005,658631,Neal; Sonya E,9998,0,9999,1
1715639554837,AIP 197,006,658671,Du; Songzi,9998,0,9999,1
1715639555863,ANAR 135S,A00,494369,Braswell; Geoffrey E.,0,0,0,0
1715639556889,BENG 196,001,628496,Engler; Adam J.,9998,0,9999,1
1715639556889,BENG 196,002,660916,Watson; John Thomas,9998,0,9999,1
1715639557915,BISP 197,001,650773,Wilhelm; James E.,9994,0,9999,5
1715639557915,BISP 197,002,658904,Coleman; Aaron B.,9998,0,9999,1
1715639558943,CAT 124RS,A01,519847,Geibel; William,0,0,20,20
1715639559969,CAT 125RS,A01,515971,Geibel; William,0,0,20,20
1715639560998,CLRE 250,A00,511389,Morris; Sheldon,9992,0,9999,7
1715639562026,CLRE 251,A00,507176,Mehta; Ravindra L.,9992,0,9999,7
1715639562026,CLRE 251,B00,511410,Mehta; Ravindra L.,9998,0,9999,1
1715639563050,CLRE 252,A00,507189,Cuomo; Raphael Eduardo,9994,0,9999,5
1715639564079,CLRE 253,A00,507199,Vaida; Florin,9994,0,9999,5
1715639564079,CLRE 253,B00,507202,Vaida; Florin,9999,0,9999,0
1715639565105,CLRE 259,A00,507211,Patel; Hemal,9996,0,9999,3
1715639566139,CLRE 260,A00,507221,Cuomo; Raphael Eduardo,9999,0,9999,0
1715639567163,CLRE 297,001,507242,Cuomo; Raphael Eduardo,9999,0,9999,0
1715639568190,COGS 197,001,638244,Voytek; Bradley Thomas,9997,0,9999,2
1715639569215,CSE 191,A00,516875,Minnes Kemp; Mor Mia,9991,0,9999,8
1715639570245,CSE 197,001,637388,Minnes Kemp; Mor Mia,9992,0,9999,7
1715639571274,CSS 201S,A01,494383,Mignozzetti; Umberto,35,0,35,0
1715639572304,CSS 202S,A01,494387,Mignozzetti; Umberto,35,0,35,0
1715639573330,DSC 197,001,628532,Eldridge; Justin Matthew,9995,0,9999,4
1715639574354,EAP 100,A00,516065,Staff,9799,0,9999,200
1715639575382,ECE 45,A01,507414,Staff,31,0,60,29
1715639577434,ECE 111,A01,507420,Staff,11,0,50,39
1715639578461,ECE 197,001,548057,Sievenpiper; Daniel F.,9991,0,9999,8
1715639579489,EDS 115,A00,507243,Choi; Bailey Miyeon,6,0,28,22
1715639580551,EDS 117,A01,494379,Staff,0,6,34,35
1715639581574,EDS 125,A00,507246,Hopkins; Megan Beth,7,0,30,23
1715639582600,EDS 128A,A01,507264,Fargason; Sharon Gayle,5,0,26,21
1715639583629,EDS 128B,A01,507293,Pappas; Elizabeth,9,0,30,21
1715639584655,EDS 139,A00,507294,Fargason; Sharon Gayle,9,0,30,21
1715639584655,EDS 139,B00,507313,Pappas; Elizabeth,9,0,30,21
1715639585679,EDS 201,A00,507315,Staff,10,0,30,20
1715639586706,EDS 203,A01,507317,Halter; Christopher P.,10,0,30,20
1715639587734,EDS 204R,A01,507319,Halter; Christopher P.,0,3,30,30
1715639587734,EDS 204R,B01,507331,Heinzman; Erica M.,14,0,30,16
1715639588760,EDS 206R,A00,507332,Staff,0,4,30,30
1715639588760,EDS 206R,B00,507343,Staff,15,0,30,15
1715639589786,EDS 250,A00,507344,Hemans; Patricia Ann Benitez,20,0,40,20
1715639590811,EDS 281,A00,507345,Daly; Alan J.,18,0,18,0
1715639591837,EDS 284,A00,507350,Daly; Alan J.,16,0,16,0
1715639592866,EDS 286,A00,507359,Fine; Sarah,18,0,18,0
1715639593894,EDS 289C,A01,507361,Daly; Alan J.,18,0,18,0
1715639594920,EDS 290,A00,507366,Hofstetter; Carolyn,15,0,15,0
1715639595954,LIGM 5A,A00,507421,Fischer-Grunski; Eva K,17,0,20,3
1715639596981,LIGM 5B,A00,507423,Fischer-Grunski; Eva K,19,0,20,1
1715639598005,LIGM 5C,A00,507425,Fischer-Grunski; Eva K,19,0,20,1
1715639599034,LIIT 5AS,A00,507427,Carnelos; Chiara,20,0,20,0
1715639600059,LIIT 5BS,A00,507430,Carnelos; Chiara,20,0,20,0
1715639601083,LIIT 5CS,A00,507432,Carnelos; Chiara,20,0,20,0
1715639602113,LISP 5A,A00,507541,Munoz Sanchez; Alicia,11,0,20,9
1715639603137,LISP 5B,A00,507671,Munoz Sanchez; Alicia,8,0,20,12
1715639604160,LISP 5C,A00,507696,Munoz Sanchez; Alicia,8,0,20,12
1715639605185,MAE 197,001,528363,Boechler; Nicholas Sebastia,9998,0,9999,1
1715639606213,MATH 197,001,523477,Kedlaya; Kiran S.,9994,0,9999,5
1715639606213,MATH 197,002,563811,Zhang; Danna,9994,0,9999,5
1715639606213,MATH 197,003,628552,Dumitriu; Ioana,9998,0,9999,1
1715639606213,MATH 197,004,660885,Floyd; Eric,9998,0,9999,1
1715639607262,MCWP 40R,A00,518780,Staff,2,0,20,18
1715639607262,MCWP 40R,B00,518781,Staff,10,0,20,10
1715639607262,MCWP 40R,C00,518783,Staff,5,0,20,15
1715639608288,MCWP 50R,A00,518791,Staff,0,1,20,20
1715639608288,MCWP 50R,B00,518792,Staff,0,2,20,20
1715639608288,MCWP 50R,C00,518793,Staff,0,4,20,20
1715639608288,MCWP 50R,D00,518794,Staff,0,1,20,20
1715639608288,MCWP 50R,E00,518795,Staff,0,2,20,20
1715639608288,MCWP 50R,F00,518796,Staff,0,1,20,20
1715639608288,MCWP 50R,G00,518797,Staff,0,1,20,20
1715639609312,MMW 12R,A01,514034,Herbst; Matthew,0,2,16,16
1715639609312,MMW 12R,A02,514035,Herbst; Matthew,0,0,16,16
1715639610336,MMW 13R,A01,514037,Staff,0,5,16,16
1715639610336,MMW 13R,A02,514039,Staff,0,5,16,16
1715639610336,MMW 13R,A03,628519,Staff,0,4,16,16
1715639612414,SIO 295LS,A00,523233,Staff,10,0,30,20
1715639613439,SIO 295S,A00,523232,Staff,10,0,30,20
1715639614469,SIOC 290S,A01,637330,Merrifield; Mark A,21,0,30,9
1715639615500,SIOC 291S,A01,637333,Gabriel; Corey John,21,0,30,9
1715639616525,SOCI 117,A01,494376,Staff,0,5,5,5
1715639617549,WES 237B,A00,494380,Staff,10,0,20,10
1715639619618,AESE 279B,A00,494370,Wade; Jon P,0,0,33,33
1715639620642,AIP 97,001,660915,Van Den Einde; Yael Dahlia,9998,0,9999,1
1715639621673,AIP 197,001,627712,Vespa; Emanuel Ignacio,9995,0,9999,4
1715639621673,AIP 197,002,650778,Amir; On,9998,0,9999,1
1715639621673,AIP 197,003,650933,Avenancio-Leon; Carlos,9998,0,9999,1
1715639621673,AIP 197,004,658530,Heyman; Gail D.,9998,0,9999,1
1715639621673,AIP 197,005,658631,Neal; Sonya E,9998,0,9999,1
1715639621673,AIP 197,006,658671,Du; Songzi,9998,0,9999,1
1715639622699,ANAR 135S,A00,494369,Braswell; Geoffrey E.,0,0,0,0
1715639623724,BENG 196,001,628496,Engler; Adam J.,9998,0,9999,1
1715639623724,BENG 196,002,660916,Watson; John Thomas,9998,0,9999,1
1715639624751,BISP 197,001,650773,Wilhelm; James E.,9994,0,9999,5
1715639624751,BISP 197,002,658904,Coleman; Aaron B.,9998,0,9999,1
1715639625777,CAT 124RS,A01,519847,Geibel; William,0,0,20,20
1715639626804,CAT 125RS,A01,515971,Geibel; William,0,0,20,20
1715639627832,CLRE 250,A00,511389,Morris; Sheldon,9992,0,9999,7
1715639628857,CLRE 251,A00,507176,Mehta; Ravindra L.,9992,0,9999,7
1715639628857,CLRE 251,B00,511410,Mehta; Ravindra L.,9998,0,9999,1
1715639629881,CLRE 252,A00,507189,Cuomo; Raphael Eduardo,9994,0,9999,5
1715639630907,CLRE 253,A00,507199,Vaida; Florin,9994,0,9999,5
1715639630907,CLRE 253,B00,507202,Vaida; Florin,9999,0,9999,0
1715639631932,CLRE 259,A00,507211,Patel; Hemal,9996,0,9999,3
1715639632956,CLRE 260,A00,507221,Cuomo; Raphael Eduardo,9999,0,9999,0
1715639633982,CLRE 297,001,507242,Cuomo; Raphael Eduardo,9999,0,9999,0
1715639635008,COGS 197,001,638244,Voytek; Bradley Thomas,9997,0,9999,2
1715639636030,CSE 191,A00,516875,Minnes Kemp; Mor Mia,9991,0,9999,8
1715639637061,CSE 197,001,637388,Minnes Kemp; Mor Mia,9992,0,9999,7
1715639638087,CSS 201S,A01,494383,Mignozzetti; Umberto,35,0,35,0
1715639639112,CSS 202S,A01,494387,Mignozzetti; Umberto,35,0,35,0
1715639640137,DSC 197,001,628532,Eldridge; Justin Matthew,9995,0,9999,4
1715639641165,EAP 100,A00,516065,Staff,9799,0,9999,200
1715639642193,ECE 45,A01,507414,Staff,31,0,60,29
1715639644243,ECE 111,A01,507420,Staff,11,0,50,39
1715639645277,ECE 197,001,548057,Sievenpiper; Daniel F.,9991,0,9999,8
1715639646304,EDS 115,A00,507243,Choi; Bailey Miyeon,6,0,28,22
1715639647332,EDS 117,A01,494379,Staff,0,6,34,35
1715639648363,EDS 125,A00,507246,Hopkins; Megan Beth,7,0,30,23
1715639649389,EDS 128A,A01,507264,Fargason; Sharon Gayle,5,0,26,21
1715639650419,EDS 128B,A01,507293,Pappas; Elizabeth,9,0,30,21
1715639651444,EDS 139,A00,507294,Fargason; Sharon Gayle,9,0,30,21
1715639651444,EDS 139,B00,507313,Pappas; Elizabeth,9,0,30,21
1715639652473,EDS 201,A00,507315,Staff,10,0,30,20
1715639653518,EDS 203,A01,507317,Halter; Christopher P.,10,0,30,20
1715639654541,EDS 204R,A01,507319,Halter; Christopher P.,0,3,30,30
1715639654541,EDS 204R,B01,507331,Heinzman; Erica M.,14,0,30,16
1715639655568,EDS 206R,A00,507332,Staff,0,4,30,30
1715639655568,EDS 206R,B00,507343,Staff,15,0,30,15
1715639656596,EDS 250,A00,507344,Hemans; Patricia Ann Benitez,20,0,40,20
1715639657625,EDS 281,A00,507345,Daly; Alan J.,18,0,18,0
1715639658650,EDS 284,A00,507350,Daly; Alan J.,16,0,16,0
1715639659674,EDS 286,A00,507359,Fine; Sarah,18,0,18,0
1715639660699,EDS 289C,A01,507361,Daly; Alan J.,18,0,18,0
1715639661726,EDS 290,A00,507366,Hofstetter; Carolyn,15,0,15,0
1715639662753,LIGM 5A,A00,507421,Fischer-Grunski; Eva K,17,0,20,3
1715639663776,LIGM 5B,A00,507423,Fischer-Grunski; Eva K,19,0,20,1
1715639664804,LIGM 5C,A00,507425,Fischer-Grunski; Eva K,19,0,20,1
1715639665828,LIIT 5AS,A00,507427,Carnelos; Chiara,20,0,20,0
1715639666858,LIIT 5BS,A00,507430,Carnelos; Chiara,20,0,20,0
1715639667885,LIIT 5CS,A00,507432,Carnelos; Chiara,20,0,20,0
1715639668916,LISP 5A,A00,507541,Munoz Sanchez; Alicia,11,0,20,9
1715639669943,LISP 5B,A00,507671,Munoz Sanchez; Alicia,8,0,20,12
1715639670969,LISP 5C,A00,507696,Munoz Sanchez; Alicia,8,0,20,12
1715639671997,MAE 197,001,528363,Boechler; Nicholas Sebastia,9998,0,9999,1
1715639673029,MATH 197,001,523477,Kedlaya; Kiran S.,9994,0,9999,5
1715639673029,MATH 197,002,563811,Zhang; Danna,9994,0,9999,5
1715639673029,MATH 197,003,628552,Dumitriu; Ioana,9998,0,9999,1
1715639673029,MATH 197,004,660885,Floyd; Eric,9998,0,9999,1
1715639674052,MCWP 40R,A00,518780,Staff,1,0,20,19
1715639674052,MCWP 40R,B00,518781,Staff,10,0,20,10
1715639674052,MCWP 40R,C00,518783,Staff,5,0,20,15
1715639675079,MCWP 50R,A00,518791,Staff,0,1,20,20
1715639675079,MCWP 50R,B00,518792,Staff,0,2,20,20
1715639675079,MCWP 50R,C00,518793,Staff,0,4,20,20
1715639675079,MCWP 50R,D00,518794,Staff,0,1,20,20
1715639675079,MCWP 50R,E00,518795,Staff,0,2,20,20
1715639675079,MCWP 50R,F00,518796,Staff,0,1,20,20
1715639675079,MCWP 50R,G00,518797,Staff,0,1,20,20
1715639676106,MMW 12R,A01,514034,Herbst; Matthew,0,2,16,16
1715639676106,MMW 12R,A02,514035,Herbst; Matthew,0,0,16,16
1715639677131,MMW 13R,A01,514037,Staff,0,5,16,16
1715639677131,MMW 13R,A02,514039,Staff,0,5,16,16
1715639677131,MMW 13R,A03,628519,Staff,0,4,16,16
1715639679185,SIO 295LS,A00,523233,Staff,10,0,30,20
1715639680210,SIO 295S,A00,523232,Staff,10,0,30,20
1715639681234,SIOC 290S,A01,637330,Merrifield; Mark A,21,0,30,9
1715639682260,SIOC 291S,A01,637333,Gabriel; Corey John,21,0,30,9
1715639683290,SOCI 117,A01,494376,Staff,0,5,5,5
1715639684316,WES 237B,A00,494380,Staff,10,0,20,10
1715639686382,AESE 279B,A00,494370,Wade; Jon P,0,0,33,33
1715639687410,AIP 97,001,660915,Van Den Einde; Yael Dahlia,9998,0,9999,1
1715639688444,AIP 197,001,627712,Vespa; Emanuel Ignacio,9995,0,9999,4
1715639688444,AIP 197,002,650778,Amir; On,9998,0,9999,1
1715639688444,AIP 197,003,650933,Avenancio-Leon; Carlos,9998,0,9999,1
1715639688444,AIP 197,004,658530,Heyman; Gail D.,9998,0,9999,1
1715639688444,AIP 197,005,658631,Neal; Sonya E,9998,0,9999,1
1715639688444,AIP 197,006,658671,Du; Songzi,9998,0,9999,1
1715639689469,ANAR 135S,A00,494369,Braswell; Geoffrey E.,0,0,0,0
1715639690494,BENG 196,001,628496,Engler; Adam J.,9998,0,9999,1
1715639690494,BENG 196,002,660916,Watson; John Thomas,9998,0,9999,1
1715639691521,BISP 197,001,650773,Wilhelm; James E.,9994,0,9999,5
1715639691521,BISP 197,002,658904,Coleman; Aaron B.,9998,0,9999,1
1715639692551,CAT 124RS,A01,519847,Geibel; William,0,0,20,20
1715639693581,CAT 125RS,A01,515971,Geibel; William,0,0,20,20
1715639694609,CLRE 250,A00,511389,Morris; Sheldon,9992,0,9999,7
1715639695635,CLRE 251,A00,507176,Mehta; Ravindra L.,9992,0,9999,7
1715639695635,CLRE 251,B00,511410,Mehta; Ravindra L.,9998,0,9999,1
1715639696662,CLRE 252,A00,507189,Cuomo; Raphael Eduardo,9994,0,9999,5
1715639697687,CLRE 253,A00,507199,Vaida; Florin,9994,0,9999,5
1715639697687,CLRE 253,B00,507202,Vaida; Florin,9999,0,9999,0
1715639698720,CLRE 259,A00,507211,Patel; Hemal,9996,0,9999,3
1715639699745,CLRE 260,A00,507221,Cuomo; Raphael Eduardo,9999,0,9999,0
1715639700773,CLRE 297,001,507242,Cuomo; Raphael Eduardo,9999,0,9999,0
1715639701800,COGS 197,001,638244,Voytek; Bradley Thomas,9997,0,9999,2
1715639702830,CSE 191,A00,516875,Minnes Kemp; Mor Mia,9991,0,9999,8
1715639703856,CSE 197,001,637388,Minnes Kemp; Mor Mia,9992,0,9999,7
1715639704887,CSS 201S,A01,494383,Mignozzetti; Umberto,35,0,35,0
1715639705917,CSS 202S,A01,494387,Mignozzetti; Umberto,35,0,35,0
1715639706942,DSC 197,001,628532,Eldridge; Justin Matthew,9995,0,9999,4
1715639707966,EAP 100,A00,516065,Staff,9799,0,9999,200
1715639708995,ECE 45,A01,507414,Staff,31,0,60,29
1715639711051,ECE 111,A01,507420,Staff,11,0,50,39
1715639712077,ECE 197,001,548057,Sievenpiper; Daniel F.,9991,0,9999,8
1715639713138,EDS 115,A00,507243,Choi; Bailey Miyeon,6,0,28,22
1715639714166,EDS 117,A01,494379,Staff,0,6,34,35
1715639715194,EDS 125,A00,507246,Hopkins; Megan Beth,7,0,30,23
1715639716224,EDS 128A,A01,507264,Fargason; Sharon Gayle,5,0,26,21
1715639717253,EDS 128B,A01,507293,Pappas; Elizabeth,9,0,30,21
1715639718280,EDS 139,A00,507294,Fargason; Sharon Gayle,9,0,30,21
1715639718280,EDS 139,B00,507313,Pappas; Elizabeth,9,0,30,21
1715639719309,EDS 201,A00,507315,Staff,10,0,30,20
1715639720338,EDS 203,A01,507317,Halter; Christopher P.,10,0,30,20
1715639721366,EDS 204R,A01,507319,Halter; Christopher P.,0,3,30,30
1715639721366,EDS 204R,B01,507331,Heinzman; Erica M.,14,0,30,16
1715639722394,EDS 206R,A00,507332,Staff,0,4,30,30
1715639722394,EDS 206R,B00,507343,Staff,15,0,30,15
1715639723420,EDS 250,A00,507344,Hemans; Patricia Ann Benitez,20,0,40,20
1715639724448,EDS 281,A00,507345,Daly; Alan J.,18,0,18,0
1715639725475,EDS 284,A00,507350,Daly; Alan J.,16,0,16,0
1715639726504,EDS 286,A00,507359,Fine; Sarah,18,0,18,0
1715639727530,EDS 289C,A01,507361,Daly; Alan J.,18,0,18,0
1715639728556,EDS 290,A00,507366,Hofstetter; Carolyn,15,0,15,0
1715639729581,LIGM 5A,A00,507421,Fischer-Grunski; Eva K,17,0,20,3
1715639730606,LIGM 5B,A00,507423,Fischer-Grunski; Eva K,19,0,20,1
1715639731654,LIGM 5C,A00,507425,Fischer-Grunski; Eva K,19,0,20,1
1715639732684,LIIT 5AS,A00,507427,Carnelos; Chiara,20,0,20,0
1715639733709,LIIT 5BS,A00,507430,Carnelos; Chiara,20,0,20,0
1715639734736,LIIT 5CS,A00,507432,Carnelos; Chiara,20,0,20,0
1715639735772,LISP 5A,A00,507541,Munoz Sanchez; Alicia,11,0,20,9
1715639736799,LISP 5B,A00,507671,Munoz Sanchez; Alicia,8,0,20,12
1715639737827,LISP 5C,A00,507696,Munoz Sanchez; Alicia,8,0,20,12
1715639738852,MAE 197,001,528363,Boechler; Nicholas Sebastia,9998,0,9999,1
1715639739878,MATH 197,001,523477,Kedlaya; Kiran S.,9994,0,9999,5
1715639739878,MATH 197,002,563811,Zhang; Danna,9994,0,9999,5
1715639739878,MATH 197,003,628552,Dumitriu; Ioana,9998,0,9999,1
1715639739878,MATH 197,004,660885,Floyd; Eric,9998,0,9999,1
1715639740906,MCWP 40R,A00,518780,Staff,1,0,20,19
1715639740906,MCWP 40R,B00,518781,Staff,10,0,20,10
1715639740906,MCWP 40R,C00,518783,Staff,5,0,20,15
1715639741931,MCWP 50R,A00,518791,Staff,0,1,20,20
1715639741931,MCWP 50R,B00,518792,Staff,0,2,20,20
1715639741931,MCWP 50R,C00,518793,Staff,0,4,20,20
1715639741931,MCWP 50R,D00,518794,Staff,0,1,20,20
1715639741931,MCWP 50R,E00,518795,Staff,0,2,20,20
1715639741931,MCWP 50R,F00,518796,Staff,0,1,20,20
1715639741931,MCWP 50R,G00,518797,Staff,0,1,20,20
1715639742959,MMW 12R,A01,514034,Herbst; Matthew,0,2,16,16
1715639742959,MMW 12R,A02,514035,Herbst; Matthew,0,0,16,16
1715639743983,MMW 13R,A01,514037,Staff,0,5,16,16
1715639743983,MMW 13R,A02,514039,Staff,0,5,16,16
1715639743983,MMW 13R,A03,628519,Staff,0,4,16,16
1715639746037,SIO 295LS,A00,523233,Staff,10,0,30,20
1715639747062,SIO 295S,A00,523232,Staff,10,0,30,20
1715639748091,SIOC 290S,A01,637330,Merrifield; Mark A,21,0,30,9
1715639749116,SIOC 291S,A01,637333,Gabriel; Corey John,21,0,30,9
1715639750141,SOCI 117,A01,494376,Staff,0,5,5,5
1715639751166,WES 237B,A00,494380,Staff,10,0,20,10
1715639753236,AESE 279B,A00,494370,Wade; Jon P,0,0,33,33
1715639754263,AIP 97,001,660915,Van Den Einde; Yael Dahlia,9998,0,9999,1
1715639755292,AIP 197,001,627712,Vespa; Emanuel Ignacio,9995,0,9999,4
1715639755292,AIP 197,002,650778,Amir; On,9998,0,9999,1
1715639755292,AIP 197,003,650933,Avenancio-Leon; Carlos,9998,0,9999,1
1715639755292,AIP 197,004,658530,Heyman; Gail D.,9998,0,9999,1
1715639755292,AIP 197,005,658631,Neal; Sonya E,9998,0,9999,1
1715639755292,AIP 197,006,658671,Du; Songzi,9998,0,9999,1
1715639756318,ANAR 135S,A00,494369,Braswell; Geoffrey E.,0,0,0,0
1715639757343,BENG 196,001,628496,Engler; Adam J.,9998,0,9999,1
1715639757343,BENG 196,002,660916,Watson; John Thomas,9998,0,9999,1
1715639758369,BISP 197,001,650773,Wilhelm; James E.,9994,0,9999,5
1715639758369,BISP 197,002,658904,Coleman; Aaron B.,9998,0,9999,1
1715639759395,CAT 124RS,A01,519847,Geibel; William,0,0,20,20
1715639760420,CAT 125RS,A01,515971,Geibel; William,0,0,20,20
1715639761450,CLRE 250,A00,511389,Morris; Sheldon,9992,0,9999,7
1715639762480,CLRE 251,A00,507176,Mehta; Ravindra L.,9992,0,9999,7
1715639762480,CLRE 251,B00,511410,Mehta; Ravindra L.,9998,0,9999,1
1715639763507,CLRE 252,A00,507189,Cuomo; Raphael Eduardo,9994,0,9999,5
1715639764533,CLRE 253,A00,507199,Vaida; Florin,9994,0,9999,5
1715639764533,CLRE 253,B00,507202,Vaida; Florin,9999,0,9999,0
1715639765559,CLRE 259,A00,507211,Patel; Hemal,9996,0,9999,3
1715639766584,CLRE 260,A00,507221,Cuomo; Raphael Eduardo,9999,0,9999,0
1715639767610,CLRE 297,001,507242,Cuomo; Raphael Eduardo,9999,0,9999,0
1715639768635,COGS 197,001,638244,Voytek; Bradley Thomas,9997,0,9999,2
1715639769663,CSE 191,A00,516875,Minnes Kemp; Mor Mia,9991,0,9999,8
1715639770693,CSE 197,001,637388,Minnes Kemp; Mor Mia,9992,0,9999,7
1715639771738,CSS 201S,A01,494383,Mignozzetti; Umberto,35,0,35,0
1715639772762,CSS 202S,A01,494387,Mignozzetti; Umberto,35,0,35,0
1715639773787,DSC 197,001,628532,Eldridge; Justin Matthew,9995,0,9999,4
1715639774813,EAP 100,A00,516065,Staff,9799,0,9999,200
1715639775843,ECE 45,A01,507414,Staff,31,0,60,29
1715639777893,ECE 111,A01,507420,Staff,11,0,50,39
1715639778919,ECE 197,001,548057,Sievenpiper; Daniel F.,9991,0,9999,8
1715639779946,EDS 115,A00,507243,Choi; Bailey Miyeon,6,0,28,22
1715639780971,EDS 117,A01,494379,Staff,0,6,34,35
1715639781997,EDS 125,A00,507246,Hopkins; Megan Beth,7,0,30,23
1715639783022,EDS 128A,A01,507264,Fargason; Sharon Gayle,5,0,26,21
1715639784054,EDS 128B,A01,507293,Pappas; Elizabeth,9,0,30,21
1715639785078,EDS 139,A00,507294,Fargason; Sharon Gayle,9,0,30,21
1715639785078,EDS 139,B00,507313,Pappas; Elizabeth,9,0,30,21
1715639786107,EDS 201,A00,507315,Staff,10,0,30,20
1715639787131,EDS 203,A01,507317,Halter; Christopher P.,10,0,30,20
1715639788157,EDS 204R,A01,507319,Halter; Christopher P.,0,3,30,30
1715639788157,EDS 204R,B01,507331,Heinzman; Erica M.,14,0,30,16
1715639789185,EDS 206R,A00,507332,Staff,0,4,30,30
1715639789185,EDS 206R,B00,507343,Staff,15,0,30,15
1715639790210,EDS 250,A00,507344,Hemans; Patricia Ann Benitez,20,0,40,20
1715639791240,EDS 281,A00,507345,Daly; Alan J.,18,0,18,0
1715639792265,EDS 284,A00,507350,Daly; Alan J.,16,0,16,0
1715639793293,EDS 286,A00,507359,Fine; Sarah,18,0,18,0
1715639794317,EDS 289C,A01,507361,Daly; Alan J.,18,0,18,0
1715639795342,EDS 290,A00,507366,Hofstetter; Carolyn,15,0,15,0
1715639796368,LIGM 5A,A00,507421,Fischer-Grunski; Eva K,17,0,20,3
1715639797396,LIGM 5B,A00,507423,Fischer-Grunski; Eva K,19,0,20,1
1715639798423,LIGM 5C,A00,507425,Fischer-Grunski; Eva K,19,0,20,1
1715639799449,LIIT 5AS,A00,507427,Carnelos; Chiara,20,0,20,0
1715639800476,LIIT 5BS,A00,507430,Carnelos; Chiara,20,0,20,0
1715639801502,LIIT 5CS,A00,507432,Carnelos; Chiara,20,0,20,0
1715639802528,LISP 5A,A00,507541,Munoz Sanchez; Alicia,11,0,20,9
1715639803556,LISP 5B,A00,507671,Munoz Sanchez; Alicia,8,0,20,12
1715639804581,LISP 5C,A00,507696,Munoz Sanchez; Alicia,8,0,20,12
1715639805609,MAE 197,001,528363,Boechler; Nicholas Sebastia,9998,0,9999,1
1715639806641,MATH 197,001,523477,Kedlaya; Kiran S.,9994,0,9999,5
1715639806641,MATH 197,002,563811,Zhang; Danna,9994,0,9999,5
1715639806641,MATH 197,003,628552,Dumitriu; Ioana,9998,0,9999,1
1715639806641,MATH 197,004,660885,Floyd; Eric,9998,0,9999,1
1715639807666,MCWP 40R,A00,518780,Staff,1,0,20,19
1715639807666,MCWP 40R,B00,518781,Staff,10,0,20,10
1715639807666,MCWP 40R,C00,518783,Staff,5,0,20,15
1715639808691,MCWP 50R,A00,518791,Staff,0,1,20,20
1715639808691,MCWP 50R,B00,518792,Staff,0,2,20,20
1715639808691,MCWP 50R,C00,518793,Staff,0,4,20,20
1715639808691,MCWP 50R,D00,518794,Staff,0,1,20,20
1715639808691,MCWP 50R,E00,518795,Staff,0,2,20,20
1715639808691,MCWP 50R,F00,518796,Staff,0,1,20,20
1715639808691,MCWP 50R,G00,518797,Staff,0,1,20,20
1715639809717,MMW 12R,A01,514034,Herbst; Matthew,0,2,16,16
1715639809717,MMW 12R,A02,514035,Herbst; Matthew,0,0,16,16
1715639810747,MMW 13R,A01,514037,Staff,0,5,16,16
1715639810747,MMW 13R,A02,514039,Staff,0,5,16,16
1715639810747,MMW 13R,A03,628519,Staff,0,4,16,16
1715639812798,SIO 295LS,A00,523233,Staff,10,0,30,20
1715639813825,SIO 295S,A00,523232,Staff,10,0,30,20
1715639814849,SIOC 290S,A01,637330,Merrifield; Mark A,21,0,30,9
1715639815877,SIOC 291S,A01,637333,Gabriel; Corey John,21,0,30,9
1715639816905,SOCI 117,A01,494376,Staff,0,5,5,5
1715639817934,WES 237B,A00,494380,Staff,10,0,20,10
1715639820003,AESE 279B,A00,494370,Wade; Jon P,0,0,33,33
1715639821029,AIP 97,001,660915,Van Den Einde; Yael Dahlia,9998,0,9999,1
1715639822059,AIP 197,001,627712,Vespa; Emanuel Ignacio,9995,0,9999,4
1715639822059,AIP 197,002,650778,Amir; On,9998,0,9999,1
1715639822059,AIP 197,003,650933,Avenancio-Leon; Carlos,9998,0,9999,1
1715639822059,AIP 197,004,658530,Heyman; Gail D.,9998,0,9999,1
1715639822059,AIP 197,005,658631,Neal; Sonya E,9998,0,9999,1
1715639822059,AIP 197,006,658671,Du; Songzi,9998,0,9999,1
1715639823086,ANAR 135S,A00,494369,Braswell; Geoffrey E.,0,0,0,0
1715639824114,BENG 196,001,628496,Engler; Adam J.,9998,0,9999,1
1715639824114,BENG 196,002,660916,Watson; John Thomas,9998,0,9999,1
1715639825139,BISP 197,001,650773,Wilhelm; James E.,9994,0,9999,5
1715639825139,BISP 197,002,658904,Coleman; Aaron B.,9998,0,9999,1
1715639826165,CAT 124RS,A01,519847,Geibel; William,0,0,20,20
1715639827189,CAT 125RS,A01,515971,Geibel; William,0,0,20,20
1715639828218,CLRE 250,A00,511389,Morris; Sheldon,9992,0,9999,7
1715639829251,CLRE 251,A00,507176,Mehta; Ravindra L.,9992,0,9999,7
1715639829251,CLRE 251,B00,511410,Mehta; Ravindra L.,9998,0,9999,1
1715639830276,CLRE 252,A00,507189,Cuomo; Raphael Eduardo,9994,0,9999,5
1715639831302,CLRE 253,A00,507199,Vaida; Florin,9994,0,9999,5
1715639831302,CLRE 253,B00,507202,Vaida; Florin,9999,0,9999,0
1715639832327,CLRE 259,A00,507211,Patel; Hemal,9996,0,9999,3
1715639833425,CLRE 260,A00,507221,Cuomo; Raphael Eduardo,9999,0,9999,0
1715639834451,CLRE 297,001,507242,Cuomo; Raphael Eduardo,9999,0,9999,0
1715639835476,COGS 197,001,638244,Voytek; Bradley Thomas,9997,0,9999,2
1715639836502,CSE 191,A00,516875,Minnes Kemp; Mor Mia,9991,0,9999,8
1715639837528,CSE 197,001,637388,Minnes Kemp; Mor Mia,9992,0,9999,7
1715639838557,CSS 201S,A01,494383,Mignozzetti; Umberto,35,0,35,0
1715639839582,CSS 202S,A01,494387,Mignozzetti; Umberto,35,0,35,0
1715639840609,DSC 197,001,628532,Eldridge; Justin Matthew,9995,0,9999,4
1715639841636,EAP 100,A00,516065,Staff,9799,0,9999,200
1715639842668,ECE 45,A01,507414,Staff,31,0,60,29
1715639844718,ECE 111,A01,507420,Staff,11,0,50,39
1715639845742,ECE 197,001,548057,Sievenpiper; Daniel F.,9991,0,9999,8
1715639846771,EDS 115,A00,507243,Choi; Bailey Miyeon,6,0,28,22
1715639847797,EDS 117,A01,494379,Staff,0,6,34,35
1715639848822,EDS 125,A00,507246,Hopkins; Megan Beth,7,0,30,23
1715639849847,EDS 128A,A01,507264,Fargason; Sharon Gayle,5,0,26,21
1715639850872,EDS 128B,A01,507293,Pappas; Elizabeth,9,0,30,21
1715639851900,EDS 139,A00,507294,Fargason; Sharon Gayle,9,0,30,21
1715639851900,EDS 139,B00,507313,Pappas; Elizabeth,9,0,30,21
1715639852924,EDS 201,A00,507315,Staff,10,0,30,20
1715639853956,EDS 203,A01,507317,Halter; Christopher P.,10,0,30,20
1715639854985,EDS 204R,A01,507319,Halter; Christopher P.,0,3,30,30
1715639854985,EDS 204R,B01,507331,Heinzman; Erica M.,14,0,30,16
1715639856010,EDS 206R,A00,507332,Staff,0,4,30,30
1715639856010,EDS 206R,B00,507343,Staff,15,0,30,15
1715639857035,EDS 250,A00,507344,Hemans; Patricia Ann Benitez,20,0,40,20
1715639858064,EDS 281,A00,507345,Daly; Alan J.,18,0,18,0
1715639859089,EDS 284,A00,507350,Daly; Alan J.,16,0,16,0
1715639860116,EDS 286,A00,507359,Fine; Sarah,18,0,18,0
1715639861142,EDS 289C,A01,507361,Daly; Alan J.,18,0,18,0
1715639862171,EDS 290,A00,507366,Hofstetter; Carolyn,15,0,15,0
1715639863203,LIGM 5A,A00,507421,Fischer-Grunski; Eva K,17,0,20,3
1715639864227,LIGM 5B,A00,507423,Fischer-Grunski; Eva K,19,0,20,1
1715639865257,LIGM 5C,A00,507425,Fischer-Grunski; Eva K,19,0,20,1
1715639866283,LIIT 5AS,A00,507427,Carnelos; Chiara,20,0,20,0
1715639867310,LIIT 5BS,A00,507430,Carnelos; Chiara,20,0,20,0
1715639868392,LIIT 5CS,A00,507432,Carnelos; Chiara,20,0,20,0
1715639869420,LISP 5A,A00,507541,Munoz Sanchez; Alicia,11,0,20,9
1715639870448,LISP 5B,A00,507671,Munoz Sanchez; Alicia,8,0,20,12
1715639871474,LISP 5C,A00,507696,Munoz Sanchez; Alicia,8,0,20,12
1715639872499,MAE 197,001,528363,Boechler; Nicholas Sebastia,9998,0,9999,1
1715639873533,MATH 197,001,523477,Kedlaya; Kiran S.,9994,0,9999,5
1715639873533,MATH 197,002,563811,Zhang; Danna,9994,0,9999,5
1715639873533,MATH 197,003,628552,Dumitriu; Ioana,9998,0,9999,1
1715639873533,MATH 197,004,660885,Floyd; Eric,9998,0,9999,1
1715639874563,MCWP 40R,A00,518780,Staff,1,0,20,19
1715639874563,MCWP 40R,B00,518781,Staff,10,0,20,10
1715639874563,MCWP 40R,C00,518783,Staff,5,0,20,15
1715639875593,MCWP 50R,A00,518791,Staff,0,1,20,20
1715639875593,MCWP 50R,B00,518792,Staff,0,2,20,20
1715639875593,MCWP 50R,C00,518793,Staff,0,4,20,20
1715639875593,MCWP 50R,D00,518794,Staff,0,1,20,20
1715639875593,MCWP 50R,E00,518795,Staff,0,2,20,20
1715639875593,MCWP 50R,F00,518796,Staff,0,1,20,20
1715639875593,MCWP 50R,G00,518797,Staff,0,1,20,20
1715639876619,MMW 12R,A01,514034,Herbst; Matthew,0,2,16,16
1715639876619,MMW 12R,A02,514035,Herbst; Matthew,0,0,16,16
1715639877646,MMW 13R,A01,514037,Staff,0,5,16,16
1715639877646,MMW 13R,A02,514039,Staff,0,5,16,16
1715639877646,MMW 13R,A03,628519,Staff,0,4,16,16
1715639879705,SIO 295LS,A00,523233,Staff,10,0,30,20
1715639880732,SIO 295S,A00,523232,Staff,10,0,30,20
1715639881769,SIOC 290S,A01,637330,Merrifield; Mark A,21,0,30,9
1715639882795,SIOC 291S,A01,637333,Gabriel; Corey John,21,0,30,9
1715639883825,SOCI 117,A01,494376,Staff,0,5,5,5
1715639884852,WES 237B,A00,494380,Staff,10,0,20,10
1715639886918,AESE 279B,A00,494370,Wade; Jon P,0,0,33,33
1715639887944,AIP 97,001,660915,Van Den Einde; Yael Dahlia,9998,0,9999,1
1715639888980,AIP 197,001,627712,Vespa; Emanuel Ignacio,9995,0,9999,4
1715639888980,AIP 197,002,650778,Amir; On,9998,0,9999,1
1715639888980,AIP 197,003,650933,Avenancio-Leon; Carlos,9998,0,9999,1
1715639888980,AIP 197,004,658530,Heyman; Gail D.,9998,0,9999,1
1715639888980,AIP 197,005,658631,Neal; Sonya E,9998,0,9999,1
1715639888980,AIP 197,006,658671,Du; Songzi,9998,0,9999,1
1715639890003,ANAR 135S,A00,494369,Braswell; Geoffrey E.,0,0,0,0
1715639891033,BENG 196,001,628496,Engler; Adam J.,9998,0,9999,1
1715639891033,BENG 196,002,660916,Watson; John Thomas,9998,0,9999,1
1715639892061,BISP 197,001,650773,Wilhelm; James E.,9994,0,9999,5
1715639892061,BISP 197,002,658904,Coleman; Aaron B.,9998,0,9999,1
1715639893087,CAT 124RS,A01,519847,Geibel; William,0,0,20,20
1715639894112,CAT 125RS,A01,515971,Geibel; William,0,0,20,20
1715639895141,CLRE 250,A00,511389,Morris; Sheldon,9992,0,9999,7
1715639896279,CLRE 251,A00,507176,Mehta; Ravindra L.,9992,0,9999,7
1715639896279,CLRE 251,B00,511410,Mehta; Ravindra L.,9998,0,9999,1
1715639897304,CLRE 252,A00,507189,Cuomo; Raphael Eduardo,9994,0,9999,5
1715639898327,CLRE 253,A00,507199,Vaida; Florin,9994,0,9999,5
1715639898327,CLRE 253,B00,507202,Vaida; Florin,9999,0,9999,0
1715639899356,CLRE 259,A00,507211,Patel; Hemal,9996,0,9999,3
1715639900584,CLRE 260,A00,507221,Cuomo; Raphael Eduardo,9999,0,9999,0
1715639901609,CLRE 297,001,507242,Cuomo; Raphael Eduardo,9999,0,9999,0
1715639902637,COGS 197,001,638244,Voytek; Bradley Thomas,9997,0,9999,2
1715639903667,CSE 191,A00,516875,Minnes Kemp; Mor Mia,9991,0,9999,8
1715639904696,CSE 197,001,637388,Minnes Kemp; Mor Mia,9992,0,9999,7
1715639905725,CSS 201S,A01,494383,Mignozzetti; Umberto,35,0,35,0
1715639906757,CSS 202S,A01,494387,Mignozzetti; Umberto,35,0,35,0
1715639907784,DSC 197,001,628532,Eldridge; Justin Matthew,9995,0,9999,4
1715639908813,EAP 100,A00,516065,Staff,9799,0,9999,200
1715639909846,ECE 45,A01,507414,Staff,31,0,60,29
1715639911900,ECE 111,A01,507420,Staff,11,0,50,39
1715639912927,ECE 197,001,548057,Sievenpiper; Daniel F.,9991,0,9999,8
1715639913954,EDS 115,A00,507243,Choi; Bailey Miyeon,6,0,28,22
1715639914984,EDS 117,A01,494379,Staff,0,6,34,35
1715639916009,EDS 125,A00,507246,Hopkins; Megan Beth,7,0,30,23
1715639917093,EDS 128A,A01,507264,Fargason; Sharon Gayle,5,0,26,21
1715639918120,EDS 128B,A01,507293,Pappas; Elizabeth,9,0,30,21
1715639919149,EDS 139,A00,507294,Fargason; Sharon Gayle,9,0,30,21
1715639919149,EDS 139,B00,507313,Pappas; Elizabeth,9,0,30,21
1715639920174,EDS 201,A00,507315,Staff,10,0,30,20
1715639921199,EDS 203,A01,507317,Halter; Christopher P.,10,0,30,20
1715639922225,EDS 204R,A01,507319,Halter; Christopher P.,0,3,30,30
1715639922225,EDS 204R,B01,507331,Heinzman; Erica M.,14,0,30,16
1715639923253,EDS 206R,A00,507332,Staff,0,4,30,30
1715639923253,EDS 206R,B00,507343,Staff,15,0,30,15
1715639924279,EDS 250,A00,507344,Hemans; Patricia Ann Benitez,20,0,40,20
1715639925305,EDS 281,A00,507345,Daly; Alan J.,18,0,18,0
1715639926330,EDS 284,A00,507350,Daly; Alan J.,16,0,16,0
1715639927359,EDS 286,A00,507359,Fine; Sarah,18,0,18,0
1715639928390,EDS 289C,A01,507361,Daly; Alan J.,18,0,18,0
1715639929420,EDS 290,A00,507366,Hofstetter; Carolyn,15,0,15,0
1715639930449,LIGM 5A,A00,507421,Fischer-Grunski; Eva K,17,0,20,3
1715639931475,LIGM 5B,A00,507423,Fischer-Grunski; Eva K,19,0,20,1
1715639932501,LIGM 5C,A00,507425,Fischer-Grunski; Eva K,19,0,20,1
1715639933532,LIIT 5AS,A00,507427,Carnelos; Chiara,20,0,20,0
1715639934560,LIIT 5BS,A00,507430,Carnelos; Chiara,20,0,20,0
1715639935586,LIIT 5CS,A00,507432,Carnelos; Chiara,20,0,20,0
1715639936612,LISP 5A,A00,507541,Munoz Sanchez; Alicia,11,0,20,9
1715639937639,LISP 5B,A00,507671,Munoz Sanchez; Alicia,8,0,20,12
1715639938663,LISP 5C,A00,507696,Munoz Sanchez; Alicia,8,0,20,12
1715639939689,MAE 197,001,528363,Boechler; Nicholas Sebastia,9998,0,9999,1
1715639940717,MATH 197,001,523477,Kedlaya; Kiran S.,9994,0,9999,5
1715639940717,MATH 197,002,563811,Zhang; Danna,9994,0,9999,5
1715639940717,MATH 197,003,628552,Dumitriu; Ioana,9998,0,9999,1
1715639940717,MATH 197,004,660885,Floyd; Eric,9998,0,9999,1
1715639941746,MCWP 40R,A00,518780,Staff,1,0,20,19
1715639941746,MCWP 40R,B00,518781,Staff,10,0,20,10
1715639941746,MCWP 40R,C00,518783,Staff,5,0,20,15
1715639942774,MCWP 50R,A00,518791,Staff,0,1,20,20
1715639942774,MCWP 50R,B00,518792,Staff,0,2,20,20
1715639942774,MCWP 50R,C00,518793,Staff,0,4,20,20
1715639942774,MCWP 50R,D00,518794,Staff,0,1,20,20
1715639942774,MCWP 50R,E00,518795,Staff,0,2,20,20
1715639942774,MCWP 50R,F00,518796,Staff,0,1,20,20
1715639942774,MCWP 50R,G00,518797,Staff,0,1,20,20
1715639943801,MMW 12R,A01,514034,Herbst; Matthew,0,2,16,16
1715639943801,MMW 12R,A02,514035,Herbst; Matthew,0,0,16,16
1715639944826,MMW 13R,A01,514037,Staff,0,5,16,16
1715639944826,MMW 13R,A02,514039,Staff,0,5,16,16
1715639944826,MMW 13R,A03,628519,Staff,0,4,16,16
1715639946877,SIO 295LS,A00,523233,Staff,10,0,30,20
1715639947903,SIO 295S,A00,523232,Staff,10,0,30,20
1715639948929,SIOC 290S,A01,637330,Merrifield; Mark A,21,0,30,9
1715639949956,SIOC 291S,A01,637333,Gabriel; Corey John,21,0,30,9
1715639950981,SOCI 117,A01,494376,Staff,0,5,5,5
1715639952005,WES 237B,A00,494380,Staff,10,0,20,10
1715639954080,AESE 279B,A00,494370,Wade; Jon P,0,0,33,33
1715639955109,AIP 97,001,660915,Van Den Einde; Yael Dahlia,9998,0,9999,1
1715639956143,AIP 197,001,627712,Vespa; Emanuel Ignacio,9995,0,9999,4
1715639956143,AIP 197,002,650778,Amir; On,9998,0,9999,1
1715639956143,AIP 197,003,650933,Avenancio-Leon; Carlos,9998,0,9999,1
1715639956143,AIP 197,004,658530,Heyman; Gail D.,9998,0,9999,1
1715639956143,AIP 197,005,658631,Neal; Sonya E,9998,0,9999,1
1715639956143,AIP 197,006,658671,Du; Songzi,9998,0,9999,1
1715639957169,ANAR 135S,A00,494369,Braswell; Geoffrey E.,0,0,0,0
1715639958194,BENG 196,001,628496,Engler; Adam J.,9998,0,9999,1
1715639958194,BENG 196,002,660916,Watson; John Thomas,9998,0,9999,1
1715639959220,BISP 197,001,650773,Wilhelm; James E.,9994,0,9999,5
1715639959220,BISP 197,002,658904,Coleman; Aaron B.,9998,0,9999,1
1715639960246,CAT 124RS,A01,519847,Geibel; William,0,0,20,20
1715639961270,CAT 125RS,A01,515971,Geibel; William,0,0,20,20
1715639962296,CLRE 250,A00,511389,Morris; Sheldon,9992,0,9999,7
1715639963328,CLRE 251,A00,507176,Mehta; Ravindra L.,9992,0,9999,7
1715639963328,CLRE 251,B00,511410,Mehta; Ravindra L.,9998,0,9999,1
1715639964357,CLRE 252,A00,507189,Cuomo; Raphael Eduardo,9994,0,9999,5
1715639965383,CLRE 253,A00,507199,Vaida; Florin,9994,0,9999,5
1715639965383,CLRE 253,B00,507202,Vaida; Florin,9999,0,9999,0
1715639966412,CLRE 259,A00,507211,Patel; Hemal,9996,0,9999,3
1715639967439,CLRE 260,A00,507221,Cuomo; Raphael Eduardo,9999,0,9999,0
1715639968471,CLRE 297,001,507242,Cuomo; Raphael Eduardo,9999,0,9999,0
1715639969499,COGS 197,001,638244,Voytek; Bradley Thomas,9997,0,9999,2
1715639970525,CSE 191,A00,516875,Minnes Kemp; Mor Mia,9991,0,9999,8
1715639971552,CSE 197,001,637388,Minnes Kemp; Mor Mia,9992,0,9999,7
1715639972583,CSS 201S,A01,494383,Mignozzetti; Umberto,35,0,35,0
1715639973610,CSS 202S,A01,494387,Mignozzetti; Umberto,35,0,35,0
1715639974634,DSC 197,001,628532,Eldridge; Justin Matthew,9995,0,9999,4
1715639975657,EAP 100,A00,516065,Staff,9799,0,9999,200
1715639976684,ECE 45,A01,507414,Staff,31,0,60,29
1715639978736,ECE 111,A01,507420,Staff,11,0,50,39
1715639979766,ECE 197,001,548057,Sievenpiper; Daniel F.,9991,0,9999,8
1715639980793,EDS 115,A00,507243,Choi; Bailey Miyeon,6,0,28,22
1715639981824,EDS 117,A01,494379,Staff,0,6,34,35
1715639982852,EDS 125,A00,507246,Hopkins; Megan Beth,7,0,30,23
1715639983883,EDS 128A,A01,507264,Fargason; Sharon Gayle,5,0,26,21
1715639984909,EDS 128B,A01,507293,Pappas; Elizabeth,9,0,30,21
1715639985937,EDS 139,A00,507294,Fargason; Sharon Gayle,9,0,30,21
1715639985937,EDS 139,B00,507313,Pappas; Elizabeth,9,0,30,21
1715639986963,EDS 201,A00,507315,Staff,10,0,30,20
1715639987991,EDS 203,A01,507317,Halter; Christopher P.,10,0,30,20
1715639989016,EDS 204R,A01,507319,Halter; Christopher P.,0,3,30,30
1715639989016,EDS 204R,B01,507331,Heinzman; Erica M.,14,0,30,16
1715639990040,EDS 206R,A00,507332,Staff,0,4,30,30
1715639990040,EDS 206R,B00,507343,Staff,15,0,30,15
1715639991068,EDS 250,A00,507344,Hemans; Patricia Ann Benitez,20,0,40,20
1715639992099,EDS 281,A00,507345,Daly; Alan J.,18,0,18,0
1715639993124,EDS 284,A00,507350,Daly; Alan J.,16,0,16,0
1715639994150,EDS 286,A00,507359,Fine; Sarah,18,0,18,0
1715639995180,EDS 289C,A01,507361,Daly; Alan J.,18,0,18,0
1715639996205,EDS 290,A00,507366,Hofstetter; Carolyn,15,0,15,0
1715639997235,LIGM 5A,A00,507421,Fischer-Grunski; Eva K,17,0,20,3
1715639998263,LIGM 5B,A00,507423,Fischer-Grunski; Eva K,19,0,20,1
1715639999288,LIGM 5C,A00,507425,Fischer-Grunski; Eva K,19,0,20,1
1715640000315,LIIT 5AS,A00,507427,Carnelos; Chiara,20,0,20,0
1715640001340,LIIT 5BS,A00,507430,Carnelos; Chiara,20,0,20,0
1715640002369,LIIT 5CS,A00,507432,Carnelos; Chiara,20,0,20,0
1715640003400,LISP 5A,A00,507541,Munoz Sanchez; Alicia,11,0,20,9
1715640004427,LISP 5B,A00,507671,Munoz Sanchez; Alicia,8,0,20,12
1715640005457,LISP 5C,A00,507696,Munoz Sanchez; Alicia,8,0,20,12
1715640006487,MAE 197,001,528363,Boechler; Nicholas Sebastia,9998,0,9999,1
1715640007522,MATH 197,001,523477,Kedlaya; Kiran S.,9994,0,9999,5
1715640007522,MATH 197,002,563811,Zhang; Danna,9994,0,9999,5
1715640007522,MATH 197,003,628552,Dumitriu; Ioana,9998,0,9999,1
1715640007522,MATH 197,004,660885,Floyd; Eric,9998,0,9999,1
1715640008550,MCWP 40R,A00,518780,Staff,1,0,20,19
1715640008550,MCWP 40R,B00,518781,Staff,10,0,20,10
1715640008550,MCWP 40R,C00,518783,Staff,5,0,20,15
1715640009576,MCWP 50R,A00,518791,Staff,0,1,20,20
1715640009576,MCWP 50R,B00,518792,Staff,0,2,20,20
1715640009576,MCWP 50R,C00,518793,Staff,0,4,20,20
1715640009576,MCWP 50R,D00,518794,Staff,0,1,20,20
1715640009576,MCWP 50R,E00,518795,Staff,0,2,20,20
1715640009576,MCWP 50R,F00,518796,Staff,0,1,20,20
1715640009576,MCWP 50R,G00,518797,Staff,0,1,20,20
1715640010605,MMW 12R,A01,514034,Herbst; Matthew,0,2,16,16
1715640010605,MMW 12R,A02,514035,Herbst; Matthew,0,0,16,16
1715640011633,MMW 13R,A01,514037,Staff,0,5,16,16
1715640011633,MMW 13R,A02,514039,Staff,0,5,16,16
1715640011633,MMW 13R,A03,628519,Staff,0,4,16,16
1715640013684,SIO 295LS,A00,523233,Staff,10,0,30,20
1715640014713,SIO 295S,A00,523232,Staff,10,0,30,20
1715640015739,SIOC 290S,A01,637330,Merrifield; Mark A,21,0,30,9
1715640016766,SIOC 291S,A01,637333,Gabriel; Corey John,21,0,30,9
1715640017793,SOCI 117,A01,494376,Staff,0,5,5,5
1715640018820,WES 237B,A00,494380,Staff,10,0,20,10
1715640020954,AESE 279B,A00,494370,Wade; Jon P,0,0,33,33
1715640021984,AIP 97,001,660915,Van Den Einde; Yael Dahlia,9998,0,9999,1
1715640023013,AIP 197,001,627712,Vespa; Emanuel Ignacio,9995,0,9999,4
1715640023013,AIP 197,002,650778,Amir; On,9998,0,9999,1
1715640023013,AIP 197,003,650933,Avenancio-Leon; Carlos,9998,0,9999,1
1715640023013,AIP 197,004,658530,Heyman; Gail D.,9998,0,9999,1
1715640023013,AIP 197,005,658631,Neal; Sonya E,9998,0,9999,1
1715640023013,AIP 197,006,658671,Du; Songzi,9998,0,9999,1
1715640024042,ANAR 135S,A00,494369,Braswell; Geoffrey E.,0,0,0,0
1715640025071,BENG 196,001,628496,Engler; Adam J.,9998,0,9999,1
1715640025071,BENG 196,002,660916,Watson; John Thomas,9998,0,9999,1
1715640026100,BISP 197,001,650773,Wilhelm; James E.,9994,0,9999,5
1715640026100,BISP 197,002,658904,Coleman; Aaron B.,9998,0,9999,1
1715640027125,CAT 124RS,A01,519847,Geibel; William,0,0,20,20
1715640028152,CAT 125RS,A01,515971,Geibel; William,0,0,20,20
1715640029183,CLRE 250,A00,511389,Morris; Sheldon,9992,0,9999,7
1715640030211,CLRE 251,A00,507176,Mehta; Ravindra L.,9992,0,9999,7
1715640030211,CLRE 251,B00,511410,Mehta; Ravindra L.,9998,0,9999,1
1715640031238,CLRE 252,A00,507189,Cuomo; Raphael Eduardo,9994,0,9999,5
1715640032265,CLRE 253,A00,507199,Vaida; Florin,9994,0,9999,5
1715640032265,CLRE 253,B00,507202,Vaida; Florin,9999,0,9999,0
1715640033290,CLRE 259,A00,507211,Patel; Hemal,9996,0,9999,3
1715640034315,CLRE 260,A00,507221,Cuomo; Raphael Eduardo,9999,0,9999,0
1715640035341,CLRE 297,001,507242,Cuomo; Raphael Eduardo,9999,0,9999,0
1715640036367,COGS 197,001,638244,Voytek; Bradley Thomas,9997,0,9999,2
1715640037393,CSE 191,A00,516875,Minnes Kemp; Mor Mia,9991,0,9999,8
1715640038419,CSE 197,001,637388,Minnes Kemp; Mor Mia,9992,0,9999,7
1715640039448,CSS 201S,A01,494383,Mignozzetti; Umberto,35,0,35,0
1715640040480,CSS 202S,A01,494387,Mignozzetti; Umberto,35,0,35,0
1715640041509,DSC 197,001,628532,Eldridge; Justin Matthew,9995,0,9999,4
1715640042535,EAP 100,A00,516065,Staff,9799,0,9999,200
1715640043563,ECE 45,A01,507414,Staff,31,0,60,29
1715640045618,ECE 111,A01,507420,Staff,11,0,50,39
1715640046648,ECE 197,001,548057,Sievenpiper; Daniel F.,9991,0,9999,8
1715640047674,EDS 115,A00,507243,Choi; Bailey Miyeon,6,0,28,22
1715640048700,EDS 117,A01,494379,Staff,0,6,34,35
1715640049727,EDS 125,A00,507246,Hopkins; Megan Beth,7,0,30,23
1715640050757,EDS 128A,A01,507264,Fargason; Sharon Gayle,5,0,26,21
1715640051783,EDS 128B,A01,507293,Pappas; Elizabeth,9,0,30,21
1715640052839,EDS 139,A00,507294,Fargason; Sharon Gayle,9,0,30,21
1715640052839,EDS 139,B00,507313,Pappas; Elizabeth,9,0,30,21
1715640053865,EDS 201,A00,507315,Staff,10,0,30,20
1715640054891,EDS 203,A01,507317,Halter; Christopher P.,10,0,30,20
1715640055916,EDS 204R,A01,507319,Halter; Christopher P.,0,3,30,30
1715640055916,EDS 204R,B01,507331,Heinzman; Erica M.,14,0,30,16
1715640056943,EDS 206R,A00,507332,Staff,0,4,30,30
1715640056943,EDS 206R,B00,507343,Staff,15,0,30,15
1715640057969,EDS 250,A00,507344,Hemans; Patricia Ann Benitez,20,0,40,20
1715640058999,EDS 281,A00,507345,Daly; Alan J.,18,0,18,0
1715640060025,EDS 284,A00,507350,Daly; Alan J.,16,0,16,0
1715640061057,EDS 286,A00,507359,Fine; Sarah,18,0,18,0
1715640062083,EDS 289C,A01,507361,Daly; Alan J.,18,0,18,0
1715640063113,EDS 290,A00,507366,Hofstetter; Carolyn,15,0,15,0
1715640064140,LIGM 5A,A00,507421,Fischer-Grunski; Eva K,17,0,20,3
1715640065167,LIGM 5B,A00,507423,Fischer-Grunski; Eva K,19,0,20,1
1715640066195,LIGM 5C,A00,507425,Fischer-Grunski; Eva K,19,0,20,1
1715640067221,LIIT 5AS,A00,507427,Carnelos; Chiara,20,0,20,0
1715640068250,LIIT 5BS,A00,507430,Carnelos; Chiara,20,0,20,0
1715640069276,LIIT 5CS,A00,507432,Carnelos; Chiara,20,0,20,0
1715640070304,LISP 5A,A00,507541,Munoz Sanchez; Alicia,11,0,20,9
1715640071329,LISP 5B,A00,507671,Munoz Sanchez; Alicia,8,0,20,12
1715640072355,LISP 5C,A00,507696,Munoz Sanchez; Alicia,8,0,20,12
1715640073384,MAE 197,001,528363,Boechler; Nicholas Sebastia,9998,0,9999,1
1715640074418,MATH 197,001,523477,Kedlaya; Kiran S.,9994,0,9999,5
1715640074418,MATH 197,002,563811,Zhang; Danna,9994,0,9999,5
1715640074418,MATH 197,003,628552,Dumitriu; Ioana,9998,0,9999,1
1715640074418,MATH 197,004,660885,Floyd; Eric,9998,0,9999,1
1715640075443,MCWP 40R,A00,518780,Staff,1,0,20,19
1715640075443,MCWP 40R,B00,518781,Staff,10,0,20,10
1715640075443,MCWP 40R,C00,518783,Staff,5,0,20,15
1715640076473,MCWP 50R,A00,518791,Staff,0,1,20,20
1715640076473,MCWP 50R,B00,518792,Staff,0,2,20,20
1715640076473,MCWP 50R,C00,518793,Staff,0,4,20,20
1715640076473,MCWP 50R,D00,518794,Staff,0,1,20,20
1715640076473,MCWP 50R,E00,518795,Staff,0,2,20,20
1715640076473,MCWP 50R,F00,518796,Staff,0,1,20,20
1715640076473,MCWP 50R,G00,518797,Staff,0,1,20,20
1715640077499,MMW 12R,A01,514034,Herbst; Matthew,0,2,16,16
1715640077499,MMW 12R,A02,514035,Herbst; Matthew,0,0,16,16
1715640078528,MMW 13R,A01,514037,Staff,0,5,16,16
1715640078528,MMW 13R,A02,514039,Staff,0,5,16,16
1715640078528,MMW 13R,A03,628519,Staff,0,4,16,16
1715640080586,SIO 295LS,A00,523233,Staff,10,0,30,20
1715640081611,SIO 295S,A00,523232,Staff,10,0,30,20
1715640082643,SIOC 290S,A01,637330,Merrifield; Mark A,21,0,30,9
1715640083672,SIOC 291S,A01,637333,Gabriel; Corey John,21,0,30,9
1715640084700,SOCI 117,A01,494376,Staff,0,5,5,5
1715640085729,WES 237B,A00,494380,Staff,10,0,20,10
1715640087800,AESE 279B,A00,494370,Wade; Jon P,0,0,33,33
1715640088825,AIP 97,001,660915,Van Den Einde; Yael Dahlia,9998,0,9999,1
1715640089857,AIP 197,001,627712,Vespa; Emanuel Ignacio,9995,0,9999,4
1715640089857,AIP 197,002,650778,Amir; On,9998,0,9999,1
1715640089857,AIP 197,003,650933,Avenancio-Leon; Carlos,9998,0,9999,1
1715640089857,AIP 197,004,658530,Heyman; Gail D.,9998,0,9999,1
1715640089857,AIP 197,005,658631,Neal; Sonya E,9998,0,9999,1
1715640089857,AIP 197,006,658671,Du; Songzi,9998,0,9999,1
1715640090883,ANAR 135S,A00,494369,Braswell; Geoffrey E.,0,0,0,0
1715640091909,BENG 196,001,628496,Engler; Adam J.,9998,0,9999,1
1715640091909,BENG 196,002,660916,Watson; John Thomas,9998,0,9999,1
1715640092938,BISP 197,001,650773,Wilhelm; James E.,9994,0,9999,5
1715640092938,BISP 197,002,658904,Coleman; Aaron B.,9998,0,9999,1
1715640093968,CAT 124RS,A01,519847,Geibel; William,0,0,20,20
1715640094992,CAT 125RS,A01,515971,Geibel; William,0,0,20,20
1715640096021,CLRE 250,A00,511389,Morris; Sheldon,9992,0,9999,7
1715640097049,CLRE 251,A00,507176,Mehta; Ravindra L.,9992,0,9999,7
1715640097049,CLRE 251,B00,511410,Mehta; Ravindra L.,9998,0,9999,1
1715640098076,CLRE 252,A00,507189,Cuomo; Raphael Eduardo,9994,0,9999,5
1715640099103,CLRE 253,A00,507199,Vaida; Florin,9994,0,9999,5
1715640099103,CLRE 253,B00,507202,Vaida; Florin,9999,0,9999,0
1715640100128,CLRE 259,A00,507211,Patel; Hemal,9996,0,9999,3
1715640101153,CLRE 260,A00,507221,Cuomo; Raphael Eduardo,9999,0,9999,0
1715640102178,CLRE 297,001,507242,Cuomo; Raphael Eduardo,9999,0,9999,0
1715640103207,COGS 197,001,638244,Voytek; Bradley Thomas,9997,0,9999,2
1715640104231,CSE 191,A00,516875,Minnes Kemp; Mor Mia,9991,0,9999,8
1715640105258,CSE 197,001,637388,Minnes Kemp; Mor Mia,9992,0,9999,7
1715640106291,CSS 201S,A01,494383,Mignozzetti; Umberto,35,0,35,0
1715640107323,CSS 202S,A01,494387,Mignozzetti; Umberto,35,0,35,0
1715640108352,DSC 197,001,628532,Eldridge; Justin Matthew,9995,0,9999,4
1715640109379,EAP 100,A00,516065,Staff,9799,0,9999,200
1715640110410,ECE 45,A01,507414,Staff,31,0,60,29
1715640112465,ECE 111,A01,507420,Staff,11,0,50,39
1715640113491,ECE 197,001,548057,Sievenpiper; Daniel F.,9991,0,9999,8
1715640114521,EDS 115,A00,507243,Choi; Bailey Miyeon,6,0,28,22
1715640115547,EDS 117,A01,494379,Staff,0,6,34,35
1715640116577,EDS 125,A00,507246,Hopkins; Megan Beth,7,0,30,23
1715640117606,EDS 128A,A01,507264,Fargason; Sharon Gayle,5,0,26,21
1715640118633,EDS 128B,A01,507293,Pappas; Elizabeth,9,0,30,21
1715640119657,EDS 139,A00,507294,Fargason; Sharon Gayle,9,0,30,21
1715640119657,EDS 139,B00,507313,Pappas; Elizabeth,9,0,30,21
1715640120682,EDS 201,A00,507315,Staff,10,0,30,20
1715640121708,EDS 203,A01,507317,Halter; Christopher P.,10,0,30,20
1715640122740,EDS 204R,A01,507319,Halter; Christopher P.,0,3,30,30
1715640122740,EDS 204R,B01,507331,Heinzman; Erica M.,14,0,30,16
1715640123765,EDS 206R,A00,507332,Staff,0,4,30,30
1715640123765,EDS 206R,B00,507343,Staff,15,0,30,15
1715640124793,EDS 250,A00,507344,Hemans; Patricia Ann Benitez,20,0,40,20
1715640125822,EDS 281,A00,507345,Daly; Alan J.,18,0,18,0
1715640126846,EDS 284,A00,507350,Daly; Alan J.,16,0,16,0
1715640127872,EDS 286,A00,507359,Fine; Sarah,18,0,18,0
1715640128899,EDS 289C,A01,507361,Daly; Alan J.,18,0,18,0
1715640129924,EDS 290,A00,507366,Hofstetter; Carolyn,15,0,15,0
1715640130952,LIGM 5A,A00,507421,Fischer-Grunski; Eva K,17,0,20,3
1715640131977,LIGM 5B,A00,507423,Fischer-Grunski; Eva K,19,0,20,1
1715640133005,LIGM 5C,A00,507425,Fischer-Grunski; Eva K,19,0,20,1
1715640134033,LIIT 5AS,A00,507427,Carnelos; Chiara,20,0,20,0
1715640135061,LIIT 5BS,A00,507430,Carnelos; Chiara,20,0,20,0
1715640136087,LIIT 5CS,A00,507432,Carnelos; Chiara,20,0,20,0
1715640137118,LISP 5A,A00,507541,Munoz Sanchez; Alicia,11,0,20,9
1715640138142,LISP 5B,A00,507671,Munoz Sanchez; Alicia,8,0,20,12
1715640139167,LISP 5C,A00,507696,Munoz Sanchez; Alicia,8,0,20,12
1715640140194,MAE 197,001,528363,Boechler; Nicholas Sebastia,9998,0,9999,1
1715640141221,MATH 197,001,523477,Kedlaya; Kiran S.,9994,0,9999,5
1715640141221,MATH 197,002,563811,Zhang; Danna,9994,0,9999,5
1715640141221,MATH 197,003,628552,Dumitriu; Ioana,9998,0,9999,1
1715640141221,MATH 197,004,660885,Floyd; Eric,9998,0,9999,1
1715640142247,MCWP 40R,A00,518780,Staff,1,0,20,19
1715640142247,MCWP 40R,B00,518781,Staff,10,0,20,10
1715640142247,MCWP 40R,C00,518783,Staff,5,0,20,15
1715640143274,MCWP 50R,A00,518791,Staff,0,1,20,20
1715640143274,MCWP 50R,B00,518792,Staff,0,2,20,20
1715640143274,MCWP 50R,C00,518793,Staff,0,4,20,20
1715640143274,MCWP 50R,D00,518794,Staff,0,1,20,20
1715640143274,MCWP 50R,E00,518795,Staff,0,2,20,20
1715640143274,MCWP 50R,F00,518796,Staff,0,1,20,20
1715640143274,MCWP 50R,G00,518797,Staff,0,1,20,20
1715640144301,MMW 12R,A01,514034,Herbst; Matthew,0,2,16,16
1715640144301,MMW 12R,A02,514035,Herbst; Matthew,0,0,16,16
1715640145326,MMW 13R,A01,514037,Staff,0,5,16,16
1715640145326,MMW 13R,A02,514039,Staff,0,5,16,16
1715640145326,MMW 13R,A03,628519,Staff,0,4,16,16
1715640147375,SIO 295LS,A00,523233,Staff,10,0,30,20
1715640148399,SIO 295S,A00,523232,Staff,10,0,30,20
1715640149424,SIOC 290S,A01,637330,Merrifield; Mark A,21,0,30,9
1715640150449,SIOC 291S,A01,637333,Gabriel; Corey John,21,0,30,9
1715640151475,SOCI 117,A01,494376,Staff,0,5,5,5
1715640152505,WES 237B,A00,494380,Staff,10,0,20,10
1715640154567,AESE 279B,A00,494370,Wade; Jon P,0,0,33,33
1715640155594,AIP 97,001,660915,Van Den Einde; Yael Dahlia,9998,0,9999,1
1715640156626,AIP 197,001,627712,Vespa; Emanuel Ignacio,9995,0,9999,4
1715640156626,AIP 197,002,650778,Amir; On,9998,0,9999,1
1715640156626,AIP 197,003,650933,Avenancio-Leon; Carlos,9998,0,9999,1
1715640156626,AIP 197,004,658530,Heyman; Gail D.,9998,0,9999,1
1715640156626,AIP 197,005,658631,Neal; Sonya E,9998,0,9999,1
1715640156626,AIP 197,006,658671,Du; Songzi,9998,0,9999,1
1715640157653,ANAR 135S,A00,494369,Braswell; Geoffrey E.,0,0,0,0
1715640158683,BENG 196,001,628496,Engler; Adam J.,9998,0,9999,1
1715640158683,BENG 196,002,660916,Watson; John Thomas,9998,0,9999,1
1715640159716,BISP 197,001,650773,Wilhelm; James E.,9994,0,9999,5
1715640159716,BISP 197,002,658904,Coleman; Aaron B.,9998,0,9999,1
1715640160740,CAT 124RS,A01,519847,Geibel; William,0,0,20,20
1715640161775,CAT 125RS,A01,515971,Geibel; William,0,0,20,20
1715640162803,CLRE 250,A00,511389,Morris; Sheldon,9992,0,9999,7
1715640163835,CLRE 251,A00,507176,Mehta; Ravindra L.,9992,0,9999,7
1715640163835,CLRE 251,B00,511410,Mehta; Ravindra L.,9998,0,9999,1
1715640164860,CLRE 252,A00,507189,Cuomo; Raphael Eduardo,9994,0,9999,5
1715640165888,CLRE 253,A00,507199,Vaida; Florin,9994,0,9999,5
1715640165888,CLRE 253,B00,507202,Vaida; Florin,9999,0,9999,0
1715640166915,CLRE 259,A00,507211,Patel; Hemal,9996,0,9999,3
1715640167995,CLRE 260,A00,507221,Cuomo; Raphael Eduardo,9999,0,9999,0
1715640169025,CLRE 297,001,507242,Cuomo; Raphael Eduardo,9999,0,9999,0
1715640170053,COGS 197,001,638244,Voytek; Bradley Thomas,9997,0,9999,2
1715640171078,CSE 191,A00,516875,Minnes Kemp; Mor Mia,9991,0,9999,8
1715640172103,CSE 197,001,637388,Minnes Kemp; Mor Mia,9992,0,9999,7
1715640173135,CSS 201S,A01,494383,Mignozzetti; Umberto,35,0,35,0
1715640174160,CSS 202S,A01,494387,Mignozzetti; Umberto,35,0,35,0
1715640175187,DSC 197,001,628532,Eldridge; Justin Matthew,9995,0,9999,4
1715640176223,EAP 100,A00,516065,Staff,9799,0,9999,200
1715640177251,ECE 45,A01,507414,Staff,31,0,60,29
1715640179307,ECE 111,A01,507420,Staff,11,0,50,39
1715640180331,ECE 197,001,548057,Sievenpiper; Daniel F.,9991,0,9999,8
1715640181360,EDS 115,A00,507243,Choi; Bailey Miyeon,6,0,28,22
1715640182386,EDS 117,A01,494379,Staff,0,6,34,35
1715640183415,EDS 125,A00,507246,Hopkins; Megan Beth,7,0,30,23
1715640184443,EDS 128A,A01,507264,Fargason; Sharon Gayle,5,0,26,21
1715640185468,EDS 128B,A01,507293,Pappas; Elizabeth,9,0,30,21
1715640186494,EDS 139,A00,507294,Fargason; Sharon Gayle,9,0,30,21
1715640186494,EDS 139,B00,507313,Pappas; Elizabeth,9,0,30,21
1715640187521,EDS 201,A00,507315,Staff,10,0,30,20
1715640188547,EDS 203,A01,507317,Halter; Christopher P.,10,0,30,20
1715640189573,EDS 204R,A01,507319,Halter; Christopher P.,0,3,30,30
1715640189573,EDS 204R,B01,507331,Heinzman; Erica M.,14,0,30,16
1715640190599,EDS 206R,A00,507332,Staff,0,4,30,30
1715640190599,EDS 206R,B00,507343,Staff,15,0,30,15
1715640191628,EDS 250,A00,507344,Hemans; Patricia Ann Benitez,20,0,40,20
1715640192652,EDS 281,A00,507345,Daly; Alan J.,18,0,18,0
1715640193677,EDS 284,A00,507350,Daly; Alan J.,16,0,16,0
1715640194704,EDS 286,A00,507359,Fine; Sarah,18,0,18,0
1715640195729,EDS 289C,A01,507361,Daly; Alan J.,18,0,18,0
1715640196756,EDS 290,A00,507366,Hofstetter; Carolyn,15,0,15,0
1715640197782,LIGM 5A,A00,507421,Fischer-Grunski; Eva K,17,0,20,3
1715640198806,LIGM 5B,A00,507423,Fischer-Grunski; Eva K,19,0,20,1
1715640199830,LIGM 5C,A00,507425,Fischer-Grunski; Eva K,19,0,20,1
1715640200854,LIIT 5AS,A00,507427,Carnelos; Chiara,20,0,20,0
1715640201880,LIIT 5BS,A00,507430,Carnelos; Chiara,20,0,20,0
1715640202911,LIIT 5CS,A00,507432,Carnelos; Chiara,20,0,20,0
1715640203942,LISP 5A,A00,507541,Munoz Sanchez; Alicia,11,0,20,9
1715640204970,LISP 5B,A00,507671,Munoz Sanchez; Alicia,8,0,20,12
1715640205994,LISP 5C,A00,507696,Munoz Sanchez; Alicia,8,0,20,12
1715640207021,MAE 197,001,528363,Boechler; Nicholas Sebastia,9998,0,9999,1
1715640208050,MATH 197,001,523477,Kedlaya; Kiran S.,9994,0,9999,5
1715640208050,MATH 197,002,563811,Zhang; Danna,9994,0,9999,5
1715640208050,MATH 197,003,628552,Dumitriu; Ioana,9998,0,9999,1
1715640208050,MATH 197,004,660885,Floyd; Eric,9998,0,9999,1
1715640209101,MCWP 40R,A00,518780,Staff,1,0,20,19
1715640209101,MCWP 40R,B00,518781,Staff,10,0,20,10
1715640209101,MCWP 40R,C00,518783,Staff,5,0,20,15
1715640210128,MCWP 50R,A00,518791,Staff,0,1,20,20
1715640210128,MCWP 50R,B00,518792,Staff,0,2,20,20
1715640210128,MCWP 50R,C00,518793,Staff,0,4,20,20
1715640210128,MCWP 50R,D00,518794,Staff,0,1,20,20
1715640210128,MCWP 50R,E00,518795,Staff,0,2,20,20
1715640210128,MCWP 50R,F00,518796,Staff,0,1,20,20
1715640210128,MCWP 50R,G00,518797,Staff,0,1,20,20
1715640211156,MMW 12R,A01,514034,Herbst; Matthew,0,2,16,16
1715640211156,MMW 12R,A02,514035,Herbst; Matthew,0,0,16,16
1715640212182,MMW 13R,A01,514037,Staff,0,5,16,16
1715640212182,MMW 13R,A02,514039,Staff,0,5,16,16
1715640212182,MMW 13R,A03,628519,Staff,0,4,16,16
1715640214234,SIO 295LS,A00,523233,Staff,10,0,30,20
1715640215261,SIO 295S,A00,523232,Staff,10,0,30,20
1715640216287,SIOC 290S,A01,637330,Merrifield; Mark A,21,0,30,9
1715640217317,SIOC 291S,A01,637333,Gabriel; Corey John,21,0,30,9
1715640218340,SOCI 117,A01,494376,Staff,0,5,5,5
1715640219365,WES 237B,A00,494380,Staff,10,0,20,10
1715640221446,AESE 279B,A00,494370,Wade; Jon P,0,0,33,33
1715640222473,AIP 97,001,660915,Van Den Einde; Yael Dahlia,9998,0,9999,1
1715640223506,AIP 197,001,627712,Vespa; Emanuel Ignacio,9995,0,9999,4
1715640223506,AIP 197,002,650778,Amir; On,9998,0,9999,1
1715640223506,AIP 197,003,650933,Avenancio-Leon; Carlos,9998,0,9999,1
1715640223506,AIP 197,004,658530,Heyman; Gail D.,9998,0,9999,1
1715640223506,AIP 197,005,658631,Neal; Sonya E,9998,0,9999,1
1715640223506,AIP 197,006,658671,Du; Songzi,9998,0,9999,1
1715640224532,ANAR 135S,A00,494369,Braswell; Geoffrey E.,0,0,0,0
1715640225558,BENG 196,001,628496,Engler; Adam J.,9998,0,9999,1
1715640225558,BENG 196,002,660916,Watson; John Thomas,9998,0,9999,1
1715640226586,BISP 197,001,650773,Wilhelm; James E.,9994,0,9999,5
1715640226586,BISP 197,002,658904,Coleman; Aaron B.,9998,0,9999,1
1715640227617,CAT 124RS,A01,519847,Geibel; William,0,0,20,20
1715640228642,CAT 125RS,A01,515971,Geibel; William,0,0,20,20
1715640229667,CLRE 250,A00,511389,Morris; Sheldon,9992,0,9999,7
1715640230696,CLRE 251,A00,507176,Mehta; Ravindra L.,9992,0,9999,7
1715640230696,CLRE 251,B00,511410,Mehta; Ravindra L.,9998,0,9999,1
1715640231727,CLRE 252,A00,507189,Cuomo; Raphael Eduardo,9994,0,9999,5
1715640232758,CLRE 253,A00,507199,Vaida; Florin,9994,0,9999,5
1715640232758,CLRE 253,B00,507202,Vaida; Florin,9999,0,9999,0
1715640233785,CLRE 259,A00,507211,Patel; Hemal,9996,0,9999,3
1715640234811,CLRE 260,A00,507221,Cuomo; Raphael Eduardo,9999,0,9999,0
1715640235841,CLRE 297,001,507242,Cuomo; Raphael Eduardo,9999,0,9999,0
1715640236867,COGS 197,001,638244,Voytek; Bradley Thomas,9997,0,9999,2
1715640237894,CSE 191,A00,516875,Minnes Kemp; Mor Mia,9991,0,9999,8
1715640238921,CSE 197,001,637388,Minnes Kemp; Mor Mia,9992,0,9999,7
1715640239948,CSS 201S,A01,494383,Mignozzetti; Umberto,35,0,35,0
1715640240973,CSS 202S,A01,494387,Mignozzetti; Umberto,35,0,35,0
1715640242004,DSC 197,001,628532,Eldridge; Justin Matthew,9995,0,9999,4
1715640243029,EAP 100,A00,516065,Staff,9799,0,9999,200
1715640244057,ECE 45,A01,507414,Staff,31,0,60,29
1715640246109,ECE 111,A01,507420,Staff,11,0,50,39
1715640247135,ECE 197,001,548057,Sievenpiper; Daniel F.,9991,0,9999,8
1715640248161,EDS 115,A00,507243,Choi; Bailey Miyeon,6,0,28,22
1715640249190,EDS 117,A01,494379,Staff,0,6,34,35
1715640250271,EDS 125,A00,507246,Hopkins; Megan Beth,7,0,30,23
1715640251296,EDS 128A,A01,507264,Fargason; Sharon Gayle,5,0,26,21
1715640252325,EDS 128B,A01,507293,Pappas; Elizabeth,9,0,30,21
1715640253351,EDS 139,A00,507294,Fargason; Sharon Gayle,9,0,30,21
1715640253351,EDS 139,B00,507313,Pappas; Elizabeth,9,0,30,21
1715640254378,EDS 201,A00,507315,Staff,10,0,30,20
1715640255406,EDS 203,A01,507317,Halter; Christopher P.,10,0,30,20
1715640256432,EDS 204R,A01,507319,Halter; Christopher P.,0,3,30,30
1715640256432,EDS 204R,B01,507331,Heinzman; Erica M.,14,0,30,16
1715640257458,EDS 206R,A00,507332,Staff,0,4,30,30
1715640257458,EDS 206R,B00,507343,Staff,15,0,30,15
1715640258483,EDS 250,A00,507344,Hemans; Patricia Ann Benitez,20,0,40,20
1715640259510,EDS 281,A00,507345,Daly; Alan J.,18,0,18,0
1715640260534,EDS 284,A00,507350,Daly; Alan J.,16,0,16,0
1715640261561,EDS 286,A00,507359,Fine; Sarah,18,0,18,0
1715640262590,EDS 289C,A01,507361,Daly; Alan J.,18,0,18,0
1715640263614,EDS 290,A00,507366,Hofstetter; Carolyn,15,0,15,0
1715640264640,LIGM 5A,A00,507421,Fischer-Grunski; Eva K,17,0,20,3
1715640265668,LIGM 5B,A00,507423,Fischer-Grunski; Eva K,19,0,20,1
1715640266699,LIGM 5C,A00,507425,Fischer-Grunski; Eva K,19,0,20,1
1715640267726,LIIT 5AS,A00,507427,Carnelos; Chiara,20,0,20,0
1715640268751,LIIT 5BS,A00,507430,Carnelos; Chiara,20,0,20,0
1715640269777,LIIT 5CS,A00,507432,Carnelos; Chiara,20,0,20,0
1715640270803,LISP 5A,A00,507541,Munoz Sanchez; Alicia,11,0,20,9
1715640271831,LISP 5B,A00,507671,Munoz Sanchez; Alicia,8,0,20,12
1715640272856,LISP 5C,A00,507696,Munoz Sanchez; Alicia,8,0,20,12
1715640273881,MAE 197,001,528363,Boechler; Nicholas Sebastia,9998,0,9999,1
1715640274908,MATH 197,001,523477,Kedlaya; Kiran S.,9994,0,9999,5
1715640274908,MATH 197,002,563811,Zhang; Danna,9994,0,9999,5
1715640274908,MATH 197,003,628552,Dumitriu; Ioana,9998,0,9999,1
1715640274908,MATH 197,004,660885,Floyd; Eric,9998,0,9999,1
1715640275933,MCWP 40R,A00,518780,Staff,1,0,20,19
1715640275933,MCWP 40R,B00,518781,Staff,10,0,20,10
1715640275933,MCWP 40R,C00,518783,Staff,5,0,20,15
1715640276959,MCWP 50R,A00,518791,Staff,0,1,20,20
1715640276959,MCWP 50R,B00,518792,Staff,0,2,20,20
1715640276959,MCWP 50R,C00,518793,Staff,0,4,20,20
1715640276959,MCWP 50R,D00,518794,Staff,0,1,20,20
1715640276959,MCWP 50R,E00,518795,Staff,0,2,20,20
1715640276959,MCWP 50R,F00,518796,Staff,0,1,20,20
1715640276959,MCWP 50R,G00,518797,Staff,0,1,20,20
1715640277986,MMW 12R,A01,514034,Herbst; Matthew,0,2,16,16
1715640277986,MMW 12R,A02,514035,Herbst; Matthew,0,0,16,16
1715640279012,MMW 13R,A01,514037,Staff,0,5,16,16
1715640279012,MMW 13R,A02,514039,Staff,0,5,16,16
1715640279012,MMW 13R,A03,628519,Staff,0,4,16,16
1715640281065,SIO 295LS,A00,523233,Staff,10,0,30,20
1715640282095,SIO 295S,A00,523232,Staff,10,0,30,20
1715640283129,SIOC 290S,A01,637330,Merrifield; Mark A,21,0,30,9
1715640284155,SIOC 291S,A01,637333,Gabriel; Corey John,21,0,30,9
1715640285210,SOCI 117,A01,494376,Staff,0,5,5,5
1715640286234,WES 237B,A00,494380,Staff,10,0,20,10
1715640288313,AESE 279B,A00,494370,Wade; Jon P,0,0,33,33
1715640289339,AIP 97,001,660915,Van Den Einde; Yael Dahlia,9998,0,9999,1
1715640290366,AIP 197,001,627712,Vespa; Emanuel Ignacio,9995,0,9999,4
1715640290366,AIP 197,002,650778,Amir; On,9998,0,9999,1
1715640290366,AIP 197,003,650933,Avenancio-Leon; Carlos,9998,0,9999,1
1715640290366,AIP 197,004,658530,Heyman; Gail D.,9998,0,9999,1
1715640290366,AIP 197,005,658631,Neal; Sonya E,9998,0,9999,1
1715640290366,AIP 197,006,658671,Du; Songzi,9998,0,9999,1
1715640291394,ANAR 135S,A00,494369,Braswell; Geoffrey E.,0,0,0,0
1715640292419,BENG 196,001,628496,Engler; Adam J.,9998,0,9999,1
1715640292419,BENG 196,002,660916,Watson; John Thomas,9998,0,9999,1
1715640293448,BISP 197,001,650773,Wilhelm; James E.,9994,0,9999,5
1715640293448,BISP 197,002,658904,Coleman; Aaron B.,9998,0,9999,1
1715640294477,CAT 124RS,A01,519847,Geibel; William,0,0,20,20
1715640295500,CAT 125RS,A01,515971,Geibel; William,0,0,20,20
1715640296530,CLRE 250,A00,511389,Morris; Sheldon,9992,0,9999,7
1715640297561,CLRE 251,A00,507176,Mehta; Ravindra L.,9992,0,9999,7
1715640297561,CLRE 251,B00,511410,Mehta; Ravindra L.,9998,0,9999,1
1715640298586,CLRE 252,A00,507189,Cuomo; Raphael Eduardo,9994,0,9999,5
1715640299613,CLRE 253,A00,507199,Vaida; Florin,9994,0,9999,5
1715640299613,CLRE 253,B00,507202,Vaida; Florin,9999,0,9999,0
1715640300638,CLRE 259,A00,507211,Patel; Hemal,9996,0,9999,3
1715640301664,CLRE 260,A00,507221,Cuomo; Raphael Eduardo,9999,0,9999,0
1715640302690,CLRE 297,001,507242,Cuomo; Raphael Eduardo,9999,0,9999,0
1715640303720,COGS 197,001,638244,Voytek; Bradley Thomas,9997,0,9999,2
1715640304750,CSE 191,A00,516875,Minnes Kemp; Mor Mia,9991,0,9999,8
1715640305780,CSE 197,001,637388,Minnes Kemp; Mor Mia,9992,0,9999,7
1715640306807,CSS 201S,A01,494383,Mignozzetti; Umberto,35,0,35,0
1715640307833,CSS 202S,A01,494387,Mignozzetti; Umberto,35,0,35,0
1715640308860,DSC 197,001,628532,Eldridge; Justin Matthew,9995,0,9999,4
1715640309887,EAP 100,A00,516065,Staff,9799,0,9999,200
1715640310921,ECE 45,A01,507414,Staff,31,0,60,29
1715640312979,ECE 111,A01,507420,Staff,11,0,50,39
1715640314007,ECE 197,001,548057,Sievenpiper; Daniel F.,9991,0,9999,8
1715640315035,EDS 115,A00,507243,Choi; Bailey Miyeon,6,0,28,22
1715640316063,EDS 117,A01,494379,Staff,0,6,34,35
1715640317092,EDS 125,A00,507246,Hopkins; Megan Beth,7,0,30,23
1715640318121,EDS 128A,A01,507264,Fargason; Sharon Gayle,5,0,26,21
1715640319147,EDS 128B,A01,507293,Pappas; Elizabeth,9,0,30,21
1715640320176,EDS 139,A00,507294,Fargason; Sharon Gayle,9,0,30,21
1715640320176,EDS 139,B00,507313,Pappas; Elizabeth,9,0,30,21
1715640321204,EDS 201,A00,507315,Staff,10,0,30,20
1715640322236,EDS 203,A01,507317,Halter; Christopher P.,10,0,30,20
1715640323262,EDS 204R,A01,507319,Halter; Christopher P.,0,3,30,30
1715640323262,EDS 204R,B01,507331,Heinzman; Erica M.,14,0,30,16
1715640324290,EDS 206R,A00,507332,Staff,0,4,30,30
1715640324290,EDS 206R,B00,507343,Staff,15,0,30,15
1715640325317,EDS 250,A00,507344,Hemans; Patricia Ann Benitez,20,0,40,20
1715640326344,EDS 281,A00,507345,Daly; Alan J.,18,0,18,0
1715640327371,EDS 284,A00,507350,Daly; Alan J.,16,0,16,0
1715640328396,EDS 286,A00,507359,Fine; Sarah,18,0,18,0
1715640329421,EDS 289C,A01,507361,Daly; Alan J.,18,0,18,0
1715640330446,EDS 290,A00,507366,Hofstetter; Carolyn,15,0,15,0
1715640331472,LIGM 5A,A00,507421,Fischer-Grunski; Eva K,17,0,20,3
1715640332519,LIGM 5B,A00,507423,Fischer-Grunski; Eva K,19,0,20,1
1715640333545,LIGM 5C,A00,507425,Fischer-Grunski; Eva K,19,0,20,1
1715640334571,LIIT 5AS,A00,507427,Carnelos; Chiara,20,0,20,0
1715640335596,LIIT 5BS,A00,507430,Carnelos; Chiara,20,0,20,0
1715640336620,LIIT 5CS,A00,507432,Carnelos; Chiara,20,0,20,0
1715640337645,LISP 5A,A00,507541,Munoz Sanchez; Alicia,11,0,20,9
1715640338674,LISP 5B,A00,507671,Munoz Sanchez; Alicia,8,0,20,12
1715640339703,LISP 5C,A00,507696,Munoz Sanchez; Alicia,8,0,20,12
1715640340729,MAE 197,001,528363,Boechler; Nicholas Sebastia,9998,0,9999,1
1715640341757,MATH 197,001,523477,Kedlaya; Kiran S.,9994,0,9999,5
1715640341757,MATH 197,002,563811,Zhang; Danna,9994,0,9999,5
1715640341757,MATH 197,003,628552,Dumitriu; Ioana,9998,0,9999,1
1715640341757,MATH 197,004,660885,Floyd; Eric,9998,0,9999,1
1715640342782,MCWP 40R,A00,518780,Staff,1,0,20,19
1715640342782,MCWP 40R,B00,518781,Staff,10,0,20,10
1715640342782,MCWP 40R,C00,518783,Staff,5,0,20,15
1715640343807,MCWP 50R,A00,518791,Staff,0,1,20,20
1715640343807,MCWP 50R,B00,518792,Staff,0,2,20,20
1715640343807,MCWP 50R,C00,518793,Staff,0,4,20,20
1715640343807,MCWP 50R,D00,518794,Staff,0,1,20,20
1715640343807,MCWP 50R,E00,518795,Staff,0,2,20,20
1715640343807,MCWP 50R,F00,518796,Staff,0,1,20,20
1715640343807,MCWP 50R,G00,518797,Staff,0,1,20,20
1715640344837,MMW 12R,A01,514034,Herbst; Matthew,0,2,16,16
1715640344837,MMW 12R,A02,514035,Herbst; Matthew,0,0,16,16
1715640345866,MMW 13R,A01,514037,Staff,0,5,16,16
1715640345866,MMW 13R,A02,514039,Staff,0,5,16,16
1715640345866,MMW 13R,A03,628519,Staff,0,4,16,16
1715640347915,SIO 295LS,A00,523233,Staff,10,0,30,20
1715640348941,SIO 295S,A00,523232,Staff,10,0,30,20
1715640349965,SIOC 290S,A01,637330,Merrifield; Mark A,21,0,30,9
1715640350991,SIOC 291S,A01,637333,Gabriel; Corey John,21,0,30,9
1715640352020,SOCI 117,A01,494376,Staff,0,5,5,5
1715640353045,WES 237B,A00,494380,Staff,10,0,20,10
1715640355122,AESE 279B,A00,494370,Wade; Jon P,0,0,33,33
1715640356152,AIP 97,001,660915,Van Den Einde; Yael Dahlia,9998,0,9999,1
1715640357186,AIP 197,001,627712,Vespa; Emanuel Ignacio,9995,0,9999,4
1715640357186,AIP 197,002,650778,Amir; On,9998,0,9999,1
1715640357186,AIP 197,003,650933,Avenancio-Leon; Carlos,9998,0,9999,1
1715640357186,AIP 197,004,658530,Heyman; Gail D.,9998,0,9999,1
1715640357186,AIP 197,005,658631,Neal; Sonya E,9998,0,9999,1
1715640357186,AIP 197,006,658671,Du; Songzi,9998,0,9999,1
1715640358212,ANAR 135S,A00,494369,Braswell; Geoffrey E.,0,0,0,0
1715640359242,BENG 196,001,628496,Engler; Adam J.,9998,0,9999,1
1715640359242,BENG 196,002,660916,Watson; John Thomas,9998,0,9999,1
1715640360270,BISP 197,001,650773,Wilhelm; James E.,9994,0,9999,5
1715640360270,BISP 197,002,658904,Coleman; Aaron B.,9998,0,9999,1
1715640361302,CAT 124RS,A01,519847,Geibel; William,0,0,20,20
1715640362330,CAT 125RS,A01,515971,Geibel; William,0,0,20,20
1715640363354,CLRE 250,A00,511389,Morris; Sheldon,9992,0,9999,7
1715640364380,CLRE 251,A00,507176,Mehta; Ravindra L.,9992,0,9999,7
1715640364380,CLRE 251,B00,511410,Mehta; Ravindra L.,9998,0,9999,1
1715640365407,CLRE 252,A00,507189,Cuomo; Raphael Eduardo,9994,0,9999,5
1715640366432,CLRE 253,A00,507199,Vaida; Florin,9994,0,9999,5
1715640366432,CLRE 253,B00,507202,Vaida; Florin,9999,0,9999,0
1715640367459,CLRE 259,A00,507211,Patel; Hemal,9996,0,9999,3
1715640368485,CLRE 260,A00,507221,Cuomo; Raphael Eduardo,9999,0,9999,0
1715640369513,CLRE 297,001,507242,Cuomo; Raphael Eduardo,9999,0,9999,0
1715640370540,COGS 197,001,638244,Voytek; Bradley Thomas,9997,0,9999,2
1715640371567,CSE 191,A00,516875,Minnes Kemp; Mor Mia,9991,0,9999,8
1715640372596,CSE 197,001,637388,Minnes Kemp; Mor Mia,9992,0,9999,7
1715640373627,CSS 201S,A01,494383,Mignozzetti; Umberto,35,0,35,0
1715640374653,CSS 202S,A01,494387,Mignozzetti; Umberto,35,0,35,0
1715640375678,DSC 197,001,628532,Eldridge; Justin Matthew,9995,0,9999,4
1715640376738,EAP 100,A00,516065,Staff,9799,0,9999,200
1715640377765,ECE 45,A01,507414,Staff,31,0,60,29
1715640379817,ECE 111,A01,507420,Staff,11,0,50,39
1715640380842,ECE 197,001,548057,Sievenpiper; Daniel F.,9991,0,9999,8
1715640381872,EDS 115,A00,507243,Choi; Bailey Miyeon,6,0,28,22
1715640382901,EDS 117,A01,494379,Staff,0,6,34,35
1715640383930,EDS 125,A00,507246,Hopkins; Megan Beth,7,0,30,23
1715640384955,EDS 128A,A01,507264,Fargason; Sharon Gayle,5,0,26,21
1715640385983,EDS 128B,A01,507293,Pappas; Elizabeth,9,0,30,21
1715640387007,EDS 139,A00,507294,Fargason; Sharon Gayle,9,0,30,21
1715640387007,EDS 139,B00,507313,Pappas; Elizabeth,9,0,30,21
1715640388033,EDS 201,A00,507315,Staff,10,0,30,20
1715640389058,EDS 203,A01,507317,Halter; Christopher P.,10,0,30,20
1715640390086,EDS 204R,A01,507319,Halter; Christopher P.,0,3,30,30
1715640390086,EDS 204R,B01,507331,Heinzman; Erica M.,14,0,30,16
1715640391115,EDS 206R,A00,507332,Staff,0,4,30,30
1715640391115,EDS 206R,B00,507343,Staff,15,0,30,15
1715640392139,EDS 250,A00,507344,Hemans; Patricia Ann Benitez,20,0,40,20
1715640393163,EDS 281,A00,507345,Daly; Alan J.,18,0,18,0
1715640394190,EDS 284,A00,507350,Daly; Alan J.,16,0,16,0
1715640395214,EDS 286,A00,507359,Fine; Sarah,18,0,18,0
1715640396239,EDS 289C,A01,507361,Daly; Alan J.,18,0,18,0
1715640397264,EDS 290,A00,507366,Hofstetter; Carolyn,15,0,15,0
1715640398291,LIGM 5A,A00,507421,Fischer-Grunski; Eva K,17,0,20,3
1715640399317,LIGM 5B,A00,507423,Fischer-Grunski; Eva K,19,0,20,1
1715640400346,LIGM 5C,A00,507425,Fischer-Grunski; Eva K,19,0,20,1
1715640401374,LIIT 5AS,A00,507427,Carnelos; Chiara,20,0,20,0
1715640402423,LIIT 5BS,A00,507430,Carnelos; Chiara,20,0,20,0
1715640403451,LIIT 5CS,A00,507432,Carnelos; Chiara,20,0,20,0
1715640404483,LISP 5A,A00,507541,Munoz Sanchez; Alicia,11,0,20,9
1715640405509,LISP 5B,A00,507671,Munoz Sanchez; Alicia,8,0,20,12
1715640406538,LISP 5C,A00,507696,Munoz Sanchez; Alicia,8,0,20,12
1715640407563,MAE 197,001,528363,Boechler; Nicholas Sebastia,9998,0,9999,1
1715640408594,MATH 197,001,523477,Kedlaya; Kiran S.,9994,0,9999,5
1715640408594,MATH 197,002,563811,Zhang; Danna,9994,0,9999,5
1715640408594,MATH 197,003,628552,Dumitriu; Ioana,9998,0,9999,1
1715640408594,MATH 197,004,660885,Floyd; Eric,9998,0,9999,1
1715640409620,MCWP 40R,A00,518780,Staff,1,0,20,19
1715640409620,MCWP 40R,B00,518781,Staff,10,0,20,10
1715640409620,MCWP 40R,C00,518783,Staff,5,0,20,15
1715640410647,MCWP 50R,A00,518791,Staff,0,1,20,20
1715640410647,MCWP 50R,B00,518792,Staff,0,2,20,20
1715640410647,MCWP 50R,C00,518793,Staff,0,4,20,20
1715640410647,MCWP 50R,D00,518794,Staff,0,1,20,20
1715640410647,MCWP 50R,E00,518795,Staff,0,2,20,20
1715640410647,MCWP 50R,F00,518796,Staff,0,1,20,20
1715640410647,MCWP 50R,G00,518797,Staff,0,1,20,20
1715640411673,MMW 12R,A01,514034,Herbst; Matthew,0,2,16,16
1715640411673,MMW 12R,A02,514035,Herbst; Matthew,0,0,16,16
1715640412703,MMW 13R,A01,514037,Staff,0,5,16,16
1715640412703,MMW 13R,A02,514039,Staff,0,5,16,16
1715640412703,MMW 13R,A03,628519,Staff,0,4,16,16
1715640414756,SIO 295LS,A00,523233,Staff,10,0,30,20
1715640415782,SIO 295S,A00,523232,Staff,10,0,30,20
1715640416812,SIOC 290S,A01,637330,Merrifield; Mark A,21,0,30,9
1715640417838,SIOC 291S,A01,637333,Gabriel; Corey John,21,0,30,9
1715640418862,SOCI 117,A01,494376,Staff,0,5,5,5
1715640419886,WES 237B,A00,494380,Staff,10,0,20,10
1715640421959,AESE 279B,A00,494370,Wade; Jon P,0,0,33,33
1715640422985,AIP 97,001,660915,Van Den Einde; Yael Dahlia,9998,0,9999,1
1715640424014,AIP 197,001,627712,Vespa; Emanuel Ignacio,9995,0,9999,4
1715640424014,AIP 197,002,650778,Amir; On,9998,0,9999,1
1715640424014,AIP 197,003,650933,Avenancio-Leon; Carlos,9998,0,9999,1
1715640424014,AIP 197,004,658530,Heyman; Gail D.,9998,0,9999,1
1715640424014,AIP 197,005,658631,Neal; Sonya E,9998,0,9999,1
1715640424014,AIP 197,006,658671,Du; Songzi,9998,0,9999,1
1715640425043,ANAR 135S,A00,494369,Braswell; Geoffrey E.,0,0,0,0
1715640426070,BENG 196,001,628496,Engler; Adam J.,9998,0,9999,1
1715640426070,BENG 196,002,660916,Watson; John Thomas,9998,0,9999,1
1715640427096,BISP 197,001,650773,Wilhelm; James E.,9994,0,9999,5
1715640427096,BISP 197,002,658904,Coleman; Aaron B.,9998,0,9999,1
1715640428125,CAT 124RS,A01,519847,Geibel; William,0,0,20,20
1715640429151,CAT 125RS,A01,515971,Geibel; William,0,0,20,20
1715640430182,CLRE 250,A00,511389,Morris; Sheldon,9992,0,9999,7
1715640431207,CLRE 251,A00,507176,Mehta; Ravindra L.,9992,0,9999,7
1715640431207,CLRE 251,B00,511410,Mehta; Ravindra L.,9998,0,9999,1
1715640432236,CLRE 252,A00,507189,Cuomo; Raphael Eduardo,9994,0,9999,5
1715640433262,CLRE 253,A00,507199,Vaida; Florin,9994,0,9999,5
1715640433262,CLRE 253,B00,507202,Vaida; Florin,9999,0,9999,0
1715640434287,CLRE 259,A00,507211,Patel; Hemal,9996,0,9999,3
1715640435312,CLRE 260,A00,507221,Cuomo; Raphael Eduardo,9999,0,9999,0
1715640436342,CLRE 297,001,507242,Cuomo; Raphael Eduardo,9999,0,9999,0
1715640437367,COGS 197,001,638244,Voytek; Bradley Thomas,9997,0,9999,2
1715640438394,CSE 191,A00,516875,Minnes Kemp; Mor Mia,9991,0,9999,8
1715640439425,CSE 197,001,637388,Minnes Kemp; Mor Mia,9992,0,9999,7
1715640440451,CSS 201S,A01,494383,Mignozzetti; Umberto,35,0,35,0
1715640441477,CSS 202S,A01,494387,Mignozzetti; Umberto,35,0,35,0
1715640442505,DSC 197,001,628532,Eldridge; Justin Matthew,9995,0,9999,4
1715640443530,EAP 100,A00,516065,Staff,9799,0,9999,200
1715640444557,ECE 45,A01,507414,Staff,31,0,60,29
1715640446613,ECE 111,A01,507420,Staff,11,0,50,39
1715640447641,ECE 197,001,548057,Sievenpiper; Daniel F.,9991,0,9999,8
1715640448669,EDS 115,A00,507243,Choi; Bailey Miyeon,6,0,28,22
1715640449697,EDS 117,A01,494379,Staff,0,6,34,35
1715640450721,EDS 125,A00,507246,Hopkins; Megan Beth,7,0,30,23
1715640451750,EDS 128A,A01,507264,Fargason; Sharon Gayle,5,0,26,21
1715640452774,EDS 128B,A01,507293,Pappas; Elizabeth,9,0,30,21
1715640453800,EDS 139,A00,507294,Fargason; Sharon Gayle,9,0,30,21
1715640453800,EDS 139,B00,507313,Pappas; Elizabeth,9,0,30,21
1715640454824,EDS 201,A00,507315,Staff,10,0,30,20
1715640455850,EDS 203,A01,507317,Halter; Christopher P.,10,0,30,20
1715640456875,EDS 204R,A01,507319,Halter; Christopher P.,0,3,30,30
1715640456875,EDS 204R,B01,507331,Heinzman; Erica M.,14,0,30,16
1715640457901,EDS 206R,A00,507332,Staff,0,4,30,30
1715640457901,EDS 206R,B00,507343,Staff,15,0,30,15
1715640458929,EDS 250,A00,507344,Hemans; Patricia Ann Benitez,20,0,40,20
1715640459957,EDS 281,A00,507345,Daly; Alan J.,18,0,18,0
1715640460981,EDS 284,A00,507350,Daly; Alan J.,16,0,16,0
1715640462007,EDS 286,A00,507359,Fine; Sarah,18,0,18,0
1715640463037,EDS 289C,A01,507361,Daly; Alan J.,18,0,18,0
1715640464062,EDS 290,A00,507366,Hofstetter; Carolyn,15,0,15,0
1715640465093,LIGM 5A,A00,507421,Fischer-Grunski; Eva K,17,0,20,3
1715640466121,LIGM 5B,A00,507423,Fischer-Grunski; Eva K,19,0,20,1
1715640467145,LIGM 5C,A00,507425,Fischer-Grunski; Eva K,19,0,20,1
1715640468171,LIIT 5AS,A00,507427,Carnelos; Chiara,20,0,20,0
1715640469197,LIIT 5BS,A00,507430,Carnelos; Chiara,20,0,20,0
1715640470227,LIIT 5CS,A00,507432,Carnelos; Chiara,20,0,20,0
1715640471253,LISP 5A,A00,507541,Munoz Sanchez; Alicia,11,0,20,9
1715640472282,LISP 5B,A00,507671,Munoz Sanchez; Alicia,8,0,20,12
1715640473311,LISP 5C,A00,507696,Munoz Sanchez; Alicia,8,0,20,12
1715640474337,MAE 197,001,528363,Boechler; Nicholas Sebastia,9998,0,9999,1
1715640475366,MATH 197,001,523477,Kedlaya; Kiran S.,9994,0,9999,5
1715640475366,MATH 197,002,563811,Zhang; Danna,9994,0,9999,5
1715640475366,MATH 197,003,628552,Dumitriu; Ioana,9998,0,9999,1
1715640475366,MATH 197,004,660885,Floyd; Eric,9998,0,9999,1
1715640476396,MCWP 40R,A00,518780,Staff,1,0,20,19
1715640476396,MCWP 40R,B00,518781,Staff,10,0,20,10
1715640476396,MCWP 40R,C00,518783,Staff,5,0,20,15
1715640477430,MCWP 50R,A00,518791,Staff,0,1,20,20
1715640477430,MCWP 50R,B00,518792,Staff,0,2,20,20
1715640477430,MCWP 50R,C00,518793,Staff,0,4,20,20
1715640477430,MCWP 50R,D00,518794,Staff,0,1,20,20
1715640477430,MCWP 50R,E00,518795,Staff,0,2,20,20
1715640477430,MCWP 50R,F00,518796,Staff,0,1,20,20
1715640477430,MCWP 50R,G00,518797,Staff,0,1,20,20
1715640478460,MMW 12R,A01,514034,Herbst; Matthew,0,2,16,16
1715640478460,MMW 12R,A02,514035,Herbst; Matthew,0,0,16,16
1715640479493,MMW 13R,A01,514037,Staff,0,5,16,16
1715640479493,MMW 13R,A02,514039,Staff,0,5,16,16
1715640479493,MMW 13R,A03,628519,Staff,0,4,16,16
1715640481545,SIO 295LS,A00,523233,Staff,10,0,30,20
1715640482571,SIO 295S,A00,523232,Staff,10,0,30,20
1715640483598,SIOC 290S,A01,637330,Merrifield; Mark A,21,0,30,9
1715640484625,SIOC 291S,A01,637333,Gabriel; Corey John,21,0,30,9
1715640485651,SOCI 117,A01,494376,Staff,0,5,5,5
1715640486679,WES 237B,A00,494380,Staff,10,0,20,10
1715640488753,AESE 279B,A00,494370,Wade; Jon P,0,0,33,33
1715640489779,AIP 97,001,660915,Van Den Einde; Yael Dahlia,9998,0,9999,1
1715640490807,AIP 197,001,627712,Vespa; Emanuel Ignacio,9995,0,9999,4
1715640490807,AIP 197,002,650778,Amir; On,9998,0,9999,1
1715640490807,AIP 197,003,650933,Avenancio-Leon; Carlos,9998,0,9999,1
1715640490807,AIP 197,004,658530,Heyman; Gail D.,9998,0,9999,1
1715640490807,AIP 197,005,658631,Neal; Sonya E,9998,0,9999,1
1715640490807,AIP 197,006,658671,Du; Songzi,9998,0,9999,1
1715640491832,ANAR 135S,A00,494369,Braswell; Geoffrey E.,0,0,0,0
1715640492863,BENG 196,001,628496,Engler; Adam J.,9998,0,9999,1
1715640492863,BENG 196,002,660916,Watson; John Thomas,9998,0,9999,1
1715640493893,BISP 197,001,650773,Wilhelm; James E.,9994,0,9999,5
1715640493893,BISP 197,002,658904,Coleman; Aaron B.,9998,0,9999,1
1715640494918,CAT 124RS,A01,519847,Geibel; William,0,0,20,20
1715640495942,CAT 125RS,A01,515971,Geibel; William,0,0,20,20
1715640496975,CLRE 250,A00,511389,Morris; Sheldon,9992,0,9999,7
1715640498002,CLRE 251,A00,507176,Mehta; Ravindra L.,9992,0,9999,7
1715640498002,CLRE 251,B00,511410,Mehta; Ravindra L.,9998,0,9999,1
1715640499029,CLRE 252,A00,507189,Cuomo; Raphael Eduardo,9994,0,9999,5
1715640500059,CLRE 253,A00,507199,Vaida; Florin,9994,0,9999,5
1715640500059,CLRE 253,B00,507202,Vaida; Florin,9999,0,9999,0
1715640501089,CLRE 259,A00,507211,Patel; Hemal,9996,0,9999,3
1715640502117,CLRE 260,A00,507221,Cuomo; Raphael Eduardo,9999,0,9999,0
1715640503144,CLRE 297,001,507242,Cuomo; Raphael Eduardo,9999,0,9999,0
1715640504171,COGS 197,001,638244,Voytek; Bradley Thomas,9997,0,9999,2
1715640505197,CSE 191,A00,516875,Minnes Kemp; Mor Mia,9991,0,9999,8
1715640506222,CSE 197,001,637388,Minnes Kemp; Mor Mia,9992,0,9999,7
1715640507251,CSS 201S,A01,494383,Mignozzetti; Umberto,35,0,35,0
1715640508275,CSS 202S,A01,494387,Mignozzetti; Umberto,35,0,35,0
1715640509300,DSC 197,001,628532,Eldridge; Justin Matthew,9995,0,9999,4
1715640510324,EAP 100,A00,516065,Staff,9799,0,9999,200
1715640511354,ECE 45,A01,507414,Staff,31,0,60,29
1715640513407,ECE 111,A01,507420,Staff,11,0,50,39
1715640514433,ECE 197,001,548057,Sievenpiper; Daniel F.,9991,0,9999,8
1715640515461,EDS 115,A00,507243,Choi; Bailey Miyeon,6,0,28,22
1715640516489,EDS 117,A01,494379,Staff,0,6,34,35
1715640517519,EDS 125,A00,507246,Hopkins; Megan Beth,7,0,30,23
1715640518545,EDS 128A,A01,507264,Fargason; Sharon Gayle,5,0,26,21
1715640519574,EDS 128B,A01,507293,Pappas; Elizabeth,9,0,30,21
1715640520598,EDS 139,A00,507294,Fargason; Sharon Gayle,9,0,30,21
1715640520598,EDS 139,B00,507313,Pappas; Elizabeth,9,0,30,21
1715640521625,EDS 201,A00,507315,Staff,10,0,30,20
1715640522657,EDS 203,A01,507317,Halter; Christopher P.,10,0,30,20
1715640523686,EDS 204R,A01,507319,Halter; Christopher P.,0,3,30,30
1715640523686,EDS 204R,B01,507331,Heinzman; Erica M.,14,0,30,16
1715640524713,EDS 206R,A00,507332,Staff,0,4,30,30
1715640524713,EDS 206R,B00,507343,Staff,15,0,30,15
1715640525740,EDS 250,A00,507344,Hemans; Patricia Ann Benitez,20,0,40,20
1715640526768,EDS 281,A00,507345,Daly; Alan J.,18,0,18,0
1715640527792,EDS 284,A00,507350,Daly; Alan J.,16,0,16,0
1715640528821,EDS 286,A00,507359,Fine; Sarah,18,0,18,0
1715640529848,EDS 289C,A01,507361,Daly; Alan J.,18,0,18,0
1715640530876,EDS 290,A00,507366,Hofstetter; Carolyn,15,0,15,0
1715640531904,LIGM 5A,A00,507421,Fischer-Grunski; Eva K,17,0,20,3
1715640532931,LIGM 5B,A00,507423,Fischer-Grunski; Eva K,19,0,20,1
1715640533961,LIGM 5C,A00,507425,Fischer-Grunski; Eva K,19,0,20,1
1715640534987,LIIT 5AS,A00,507427,Carnelos; Chiara,20,0,20,0
1715640536012,LIIT 5BS,A00,507430,Carnelos; Chiara,20,0,20,0
1715640537038,LIIT 5CS,A00,507432,Carnelos; Chiara,20,0,20,0
1715640538063,LISP 5A,A00,507541,Munoz Sanchez; Alicia,11,0,20,9
1715640539093,LISP 5B,A00,507671,Munoz Sanchez; Alicia,8,0,20,12
1715640540123,LISP 5C,A00,507696,Munoz Sanchez; Alicia,8,0,20,12
1715640541154,MAE 197,001,528363,Boechler; Nicholas Sebastia,9998,0,9999,1
1715640542189,MATH 197,001,523477,Kedlaya; Kiran S.,9994,0,9999,5
1715640542189,MATH 197,002,563811,Zhang; Danna,9994,0,9999,5
1715640542189,MATH 197,003,628552,Dumitriu; Ioana,9998,0,9999,1
1715640542189,MATH 197,004,660885,Floyd; Eric,9998,0,9999,1
1715640543215,MCWP 40R,A00,518780,Staff,1,0,20,19
1715640543215,MCWP 40R,B00,518781,Staff,10,0,20,10
1715640543215,MCWP 40R,C00,518783,Staff,5,0,20,15
1715640544247,MCWP 50R,A00,518791,Staff,0,1,20,20
1715640544247,MCWP 50R,B00,518792,Staff,0,2,20,20
1715640544247,MCWP 50R,C00,518793,Staff,0,4,20,20
1715640544247,MCWP 50R,D00,518794,Staff,0,1,20,20
1715640544247,MCWP 50R,E00,518795,Staff,0,2,20,20
1715640544247,MCWP 50R,F00,518796,Staff,0,1,20,20
1715640544247,MCWP 50R,G00,518797,Staff,0,1,20,20
1715640545275,MMW 12R,A01,514034,Herbst; Matthew,0,2,16,16
1715640545275,MMW 12R,A02,514035,Herbst; Matthew,0,0,16,16
1715640546308,MMW 13R,A01,514037,Staff,0,5,16,16
1715640546308,MMW 13R,A02,514039,Staff,0,5,16,16
1715640546308,MMW 13R,A03,628519,Staff,0,4,16,16
1715640548359,SIO 295LS,A00,523233,Staff,10,0,30,20
1715640549387,SIO 295S,A00,523232,Staff,10,0,30,20
1715640550414,SIOC 290S,A01,637330,Merrifield; Mark A,21,0,30,9
1715640551440,SIOC 291S,A01,637333,Gabriel; Corey John,21,0,30,9
1715640552465,SOCI 117,A01,494376,Staff,0,5,5,5
1715640553490,WES 237B,A00,494380,Staff,10,0,20,10
1715640555560,AESE 279B,A00,494370,Wade; Jon P,0,0,33,33
1715640556589,AIP 97,001,660915,Van Den Einde; Yael Dahlia,9998,0,9999,1
1715640557623,AIP 197,001,627712,Vespa; Emanuel Ignacio,9995,0,9999,4
1715640557623,AIP 197,002,650778,Amir; On,9998,0,9999,1
1715640557623,AIP 197,003,650933,Avenancio-Leon; Carlos,9998,0,9999,1
1715640557623,AIP 197,004,658530,Heyman; Gail D.,9998,0,9999,1
1715640557623,AIP 197,005,658631,Neal; Sonya E,9998,0,9999,1
1715640557623,AIP 197,006,658671,Du; Songzi,9998,0,9999,1
1715640558648,ANAR 135S,A00,494369,Braswell; Geoffrey E.,0,0,0,0
1715640559680,BENG 196,001,628496,Engler; Adam J.,9998,0,9999,1
1715640559680,BENG 196,002,660916,Watson; John Thomas,9998,0,9999,1
1715640560709,BISP 197,001,650773,Wilhelm; James E.,9994,0,9999,5
1715640560709,BISP 197,002,658904,Coleman; Aaron B.,9998,0,9999,1
1715640561735,CAT 124RS,A01,519847,Geibel; William,0,0,20,20
1715640562762,CAT 125RS,A01,515971,Geibel; William,0,0,20,20
1715640563843,CLRE 250,A00,511389,Morris; Sheldon,9992,0,9999,7
1715640564871,CLRE 251,A00,507176,Mehta; Ravindra L.,9992,0,9999,7
1715640564871,CLRE 251,B00,511410,Mehta; Ravindra L.,9998,0,9999,1
1715640565902,CLRE 252,A00,507189,Cuomo; Raphael Eduardo,9994,0,9999,5
1715640566928,CLRE 253,A00,507199,Vaida; Florin,9994,0,9999,5
1715640566928,CLRE 253,B00,507202,Vaida; Florin,9999,0,9999,0
1715640567958,CLRE 259,A00,507211,Patel; Hemal,9996,0,9999,3
1715640568985,CLRE 260,A00,507221,Cuomo; Raphael Eduardo,9999,0,9999,0
1715640570017,CLRE 297,001,507242,Cuomo; Raphael Eduardo,9999,0,9999,0
1715640571046,COGS 197,001,638244,Voytek; Bradley Thomas,9997,0,9999,2
1715640572073,CSE 191,A00,516875,Minnes Kemp; Mor Mia,9991,0,9999,8
1715640573124,CSE 197,001,637388,Minnes Kemp; Mor Mia,9992,0,9999,7
1715640574153,CSS 201S,A01,494383,Mignozzetti; Umberto,35,0,35,0
1715640575184,CSS 202S,A01,494387,Mignozzetti; Umberto,35,0,35,0
1715640576211,DSC 197,001,628532,Eldridge; Justin Matthew,9995,0,9999,4
1715640577239,EAP 100,A00,516065,Staff,9799,0,9999,200
1715640578267,ECE 45,A01,507414,Staff,31,0,60,29
1715640580325,ECE 111,A01,507420,Staff,11,0,50,39
1715640581358,ECE 197,001,548057,Sievenpiper; Daniel F.,9991,0,9999,8
1715640582385,EDS 115,A00,507243,Choi; Bailey Miyeon,6,0,28,22
1715640583412,EDS 117,A01,494379,Staff,0,6,34,35
1715640584438,EDS 125,A00,507246,Hopkins; Megan Beth,7,0,30,23
1715640585465,EDS 128A,A01,507264,Fargason; Sharon Gayle,5,0,26,21
1715640586503,EDS 128B,A01,507293,Pappas; Elizabeth,9,0,30,21
1715640587532,EDS 139,A00,507294,Fargason; Sharon Gayle,9,0,30,21
1715640587532,EDS 139,B00,507313,Pappas; Elizabeth,9,0,30,21
1715640588556,EDS 201,A00,507315,Staff,10,0,30,20
1715640589582,EDS 203,A01,507317,Halter; Christopher P.,10,0,30,20
1715640590607,EDS 204R,A01,507319,Halter; Christopher P.,0,3,30,30
1715640590607,EDS 204R,B01,507331,Heinzman; Erica M.,14,0,30,16
1715640591635,EDS 206R,A00,507332,Staff,0,4,30,30
1715640591635,EDS 206R,B00,507343,Staff,15,0,30,15
1715640592660,EDS 250,A00,507344,Hemans; Patricia Ann Benitez,20,0,40,20
1715640593685,EDS 281,A00,507345,Daly; Alan J.,18,0,18,0
1715640594712,EDS 284,A00,507350,Daly; Alan J.,16,0,16,0
1715640595739,EDS 286,A00,507359,Fine; Sarah,18,0,18,0
1715640596763,EDS 289C,A01,507361,Daly; Alan J.,18,0,18,0
1715640597788,EDS 290,A00,507366,Hofstetter; Carolyn,15,0,15,0
1715640598815,LIGM 5A,A00,507421,Fischer-Grunski; Eva K,17,0,20,3
1715640599844,LIGM 5B,A00,507423,Fischer-Grunski; Eva K,19,0,20,1
1715640600872,LIGM 5C,A00,507425,Fischer-Grunski; Eva K,19,0,20,1
1715640601898,LIIT 5AS,A00,507427,Carnelos; Chiara,20,0,20,0
1715640602927,LIIT 5BS,A00,507430,Carnelos; Chiara,20,0,20,0
1715640603952,LIIT 5CS,A00,507432,Carnelos; Chiara,20,0,20,0
1715640604978,LISP 5A,A00,507541,Munoz Sanchez; Alicia,11,0,20,9
1715640606006,LISP 5B,A00,507671,Munoz Sanchez; Alicia,8,0,20,12
1715640607033,LISP 5C,A00,507696,Munoz Sanchez; Alicia,8,0,20,12
1715640608059,MAE 197,001,528363,Boechler; Nicholas Sebastia,9998,0,9999,1
1715640609087,MATH 197,001,523477,Kedlaya; Kiran S.,9994,0,9999,5
1715640609087,MATH 197,002,563811,Zhang; Danna,9994,0,9999,5
1715640609087,MATH 197,003,628552,Dumitriu; Ioana,9998,0,9999,1
1715640609087,MATH 197,004,660885,Floyd; Eric,9998,0,9999,1
1715640610113,MCWP 40R,A00,518780,Staff,1,0,20,19
1715640610113,MCWP 40R,B00,518781,Staff,10,0,20,10
1715640610113,MCWP 40R,C00,518783,Staff,5,0,20,15
1715640611138,MCWP 50R,A00,518791,Staff,0,1,20,20
1715640611138,MCWP 50R,B00,518792,Staff,0,2,20,20
1715640611138,MCWP 50R,C00,518793,Staff,0,4,20,20
1715640611138,MCWP 50R,D00,518794,Staff,0,1,20,20
1715640611138,MCWP 50R,E00,518795,Staff,0,2,20,20
1715640611138,MCWP 50R,F00,518796,Staff,0,1,20,20
1715640611138,MCWP 50R,G00,518797,Staff,0,1,20,20
1715640612167,MMW 12R,A01,514034,Herbst; Matthew,0,2,16,16
1715640612167,MMW 12R,A02,514035,Herbst; Matthew,0,0,16,16
1715640613194,MMW 13R,A01,514037,Staff,0,5,16,16
1715640613194,MMW 13R,A02,514039,Staff,0,5,16,16
1715640613194,MMW 13R,A03,628519,Staff,0,4,16,16
1715640615249,SIO 295LS,A00,523233,Staff,10,0,30,20
1715640616273,SIO 295S,A00,523232,Staff,10,0,30,20
1715640617306,SIOC 290S,A01,637330,Merrifield; Mark A,21,0,30,9
1715640618332,SIOC 291S,A01,637333,Gabriel; Corey John,21,0,30,9
1715640619361,SOCI 117,A01,494376,Staff,0,5,5,5
1715640620387,WES 237B,A00,494380,Staff,10,0,20,10
1715640622450,AESE 279B,A00,494370,Wade; Jon P,0,0,33,33
1715640623480,AIP 97,001,660915,Van Den Einde; Yael Dahlia,9998,0,9999,1
1715640624512,AIP 197,001,627712,Vespa; Emanuel Ignacio,9995,0,9999,4
1715640624512,AIP 197,002,650778,Amir; On,9998,0,9999,1
1715640624512,AIP 197,003,650933,Avenancio-Leon; Carlos,9998,0,9999,1
1715640624512,AIP 197,004,658530,Heyman; Gail D.,9998,0,9999,1
1715640624512,AIP 197,005,658631,Neal; Sonya E,9998,0,9999,1
1715640624512,AIP 197,006,658671,Du; Songzi,9998,0,9999,1
1715640625542,ANAR 135S,A00,494369,Braswell; Geoffrey E.,0,0,0,0
1715640626571,BENG 196,001,628496,Engler; Adam J.,9998,0,9999,1
1715640626571,BENG 196,002,660916,Watson; John Thomas,9998,0,9999,1
1715640627600,BISP 197,001,650773,Wilhelm; James E.,9994,0,9999,5
1715640627600,BISP 197,002,658904,Coleman; Aaron B.,9998,0,9999,1
1715640628629,CAT 124RS,A01,519847,Geibel; William,0,0,20,20
1715640629657,CAT 125RS,A01,515971,Geibel; William,0,0,20,20
1715640630684,CLRE 250,A00,511389,Morris; Sheldon,9992,0,9999,7
1715640631711,CLRE 251,A00,507176,Mehta; Ravindra L.,9992,0,9999,7
1715640631711,CLRE 251,B00,511410,Mehta; Ravindra L.,9998,0,9999,1
1715640632737,CLRE 252,A00,507189,Cuomo; Raphael Eduardo,9994,0,9999,5
1715640633766,CLRE 253,A00,507199,Vaida; Florin,9994,0,9999,5
1715640633766,CLRE 253,B00,507202,Vaida; Florin,9999,0,9999,0
1715640634794,CLRE 259,A00,507211,Patel; Hemal,9996,0,9999,3
1715640635824,CLRE 260,A00,507221,Cuomo; Raphael Eduardo,9999,0,9999,0
1715640636852,CLRE 297,001,507242,Cuomo; Raphael Eduardo,9999,0,9999,0
1715640637877,COGS 197,001,638244,Voytek; Bradley Thomas,9997,0,9999,2
1715640638902,CSE 191,A00,516875,Minnes Kemp; Mor Mia,9991,0,9999,8
1715640639931,CSE 197,001,637388,Minnes Kemp; Mor Mia,9992,0,9999,7
1715640640958,CSS 201S,A01,494383,Mignozzetti; Umberto,35,0,35,0
1715640641991,CSS 202S,A01,494387,Mignozzetti; Umberto,35,0,35,0
1715640643018,DSC 197,001,628532,Eldridge; Justin Matthew,9995,0,9999,4
1715640644042,EAP 100,A00,516065,Staff,9799,0,9999,200
1715640645078,ECE 45,A01,507414,Staff,31,0,60,29
1715640647136,ECE 111,A01,507420,Staff,11,0,50,39
1715640648165,ECE 197,001,548057,Sievenpiper; Daniel F.,9991,0,9999,8
1715640649198,EDS 115,A00,507243,Choi; Bailey Miyeon,6,0,28,22
1715640650223,EDS 117,A01,494379,Staff,0,6,34,35
1715640651252,EDS 125,A00,507246,Hopkins; Megan Beth,7,0,30,23
1715640652279,EDS 128A,A01,507264,Fargason; Sharon Gayle,5,0,26,21
1715640653305,EDS 128B,A01,507293,Pappas; Elizabeth,9,0,30,21
1715640654331,EDS 139,A00,507294,Fargason; Sharon Gayle,9,0,30,21
1715640654331,EDS 139,B00,507313,Pappas; Elizabeth,9,0,30,21
1715640655359,EDS 201,A00,507315,Staff,10,0,30,20
1715640656386,EDS 203,A01,507317,Halter; Christopher P.,10,0,30,20
1715640657412,EDS 204R,A01,507319,Halter; Christopher P.,0,3,30,30
1715640657412,EDS 204R,B01,507331,Heinzman; Erica M.,14,0,30,16
1715640658441,EDS 206R,A00,507332,Staff,0,4,30,30
1715640658441,EDS 206R,B00,507343,Staff,15,0,30,15
1715640659467,EDS 250,A00,507344,Hemans; Patricia Ann Benitez,20,0,40,20
1715640660494,EDS 281,A00,507345,Daly; Alan J.,18,0,18,0
1715640661520,EDS 284,A00,507350,Daly; Alan J.,16,0,16,0
1715640662546,EDS 286,A00,507359,Fine; Sarah,18,0,18,0
1715640663574,EDS 289C,A01,507361,Daly; Alan J.,18,0,18,0
1715640664605,EDS 290,A00,507366,Hofstetter; Carolyn,15,0,15,0
1715640665637,LIGM 5A,A00,507421,Fischer-Grunski; Eva K,17,0,20,3
1715640666667,LIGM 5B,A00,507423,Fischer-Grunski; Eva K,19,0,20,1
1715640667694,LIGM 5C,A00,507425,Fischer-Grunski; Eva K,19,0,20,1
1715640668719,LIIT 5AS,A00,507427,Carnelos; Chiara,20,0,20,0
1715640669744,LIIT 5BS,A00,507430,Carnelos; Chiara,20,0,20,0
1715640670770,LIIT 5CS,A00,507432,Carnelos; Chiara,20,0,20,0
1715640671798,LISP 5A,A00,507541,Munoz Sanchez; Alicia,11,0,20,9
1715640672827,LISP 5B,A00,507671,Munoz Sanchez; Alicia,8,0,20,12
1715640673855,LISP 5C,A00,507696,Munoz Sanchez; Alicia,8,0,20,12
1715640674880,MAE 197,001,528363,Boechler; Nicholas Sebastia,9998,0,9999,1
1715640675907,MATH 197,001,523477,Kedlaya; Kiran S.,9994,0,9999,5
1715640675907,MATH 197,002,563811,Zhang; Danna,9994,0,9999,5
1715640675907,MATH 197,003,628552,Dumitriu; Ioana,9998,0,9999,1
1715640675907,MATH 197,004,660885,Floyd; Eric,9998,0,9999,1
1715640676933,MCWP 40R,A00,518780,Staff,1,0,20,19
1715640676933,MCWP 40R,B00,518781,Staff,10,0,20,10
1715640676933,MCWP 40R,C00,518783,Staff,5,0,20,15
1715640677961,MCWP 50R,A00,518791,Staff,0,1,20,20
1715640677961,MCWP 50R,B00,518792,Staff,0,2,20,20
1715640677961,MCWP 50R,C00,518793,Staff,0,4,20,20
1715640677961,MCWP 50R,D00,518794,Staff,0,1,20,20
1715640677961,MCWP 50R,E00,518795,Staff,0,2,20,20
1715640677961,MCWP 50R,F00,518796,Staff,0,1,20,20
1715640677961,MCWP 50R,G00,518797,Staff,0,1,20,20
1715640678985,MMW 12R,A01,514034,Herbst; Matthew,0,2,16,16
1715640678985,MMW 12R,A02,514035,Herbst; Matthew,0,0,16,16
1715640680011,MMW 13R,A01,514037,Staff,0,5,16,16
1715640680011,MMW 13R,A02,514039,Staff,0,5,16,16
1715640680011,MMW 13R,A03,628519,Staff,0,4,16,16
1715640682068,SIO 295LS,A00,523233,Staff,10,0,30,20
1715640683094,SIO 295S,A00,523232,Staff,10,0,30,20
1715640684122,SIOC 290S,A01,637330,Merrifield; Mark A,21,0,30,9
1715640685150,SIOC 291S,A01,637333,Gabriel; Corey John,21,0,30,9
1715640686179,SOCI 117,A01,494376,Staff,0,5,5,5
1715640687204,WES 237B,A00,494380,Staff,10,0,20,10
1715640689287,AESE 279B,A00,494370,Wade; Jon P,0,0,33,33
1715640690315,AIP 97,001,660915,Van Den Einde; Yael Dahlia,9998,0,9999,1
1715640691342,AIP 197,001,627712,Vespa; Emanuel Ignacio,9995,0,9999,4
1715640691342,AIP 197,002,650778,Amir; On,9998,0,9999,1
1715640691342,AIP 197,003,650933,Avenancio-Leon; Carlos,9998,0,9999,1
1715640691342,AIP 197,004,658530,Heyman; Gail D.,9998,0,9999,1
1715640691342,AIP 197,005,658631,Neal; Sonya E,9998,0,9999,1
1715640691342,AIP 197,006,658671,Du; Songzi,9998,0,9999,1
1715640692367,ANAR 135S,A00,494369,Braswell; Geoffrey E.,0,0,0,0
1715640693393,BENG 196,001,628496,Engler; Adam J.,9998,0,9999,1
1715640693393,BENG 196,002,660916,Watson; John Thomas,9998,0,9999,1
1715640694420,BISP 197,001,650773,Wilhelm; James E.,9994,0,9999,5
1715640694420,BISP 197,002,658904,Coleman; Aaron B.,9998,0,9999,1
1715640695450,CAT 124RS,A01,519847,Geibel; William,0,0,20,20
1715640696474,CAT 125RS,A01,515971,Geibel; William,0,0,20,20
1715640697506,CLRE 250,A00,511389,Morris; Sheldon,9992,0,9999,7
1715640698536,CLRE 251,A00,507176,Mehta; Ravindra L.,9992,0,9999,7
1715640698536,CLRE 251,B00,511410,Mehta; Ravindra L.,9998,0,9999,1
1715640699567,CLRE 252,A00,507189,Cuomo; Raphael Eduardo,9994,0,9999,5
1715640700704,CLRE 253,A00,507199,Vaida; Florin,9994,0,9999,5
1715640700704,CLRE 253,B00,507202,Vaida; Florin,9999,0,9999,0
1715640701729,CLRE 259,A00,507211,Patel; Hemal,9996,0,9999,3
1715640702758,CLRE 260,A00,507221,Cuomo; Raphael Eduardo,9999,0,9999,0
1715640703780,CLRE 297,001,507242,Cuomo; Raphael Eduardo,9999,0,9999,0
1715640704808,COGS 197,001,638244,Voytek; Bradley Thomas,9997,0,9999,2
1715640705833,CSE 191,A00,516875,Minnes Kemp; Mor Mia,9991,0,9999,8
1715640706857,CSE 197,001,637388,Minnes Kemp; Mor Mia,9992,0,9999,7
1715640707883,CSS 201S,A01,494383,Mignozzetti; Umberto,35,0,35,0
1715640708914,CSS 202S,A01,494387,Mignozzetti; Umberto,35,0,35,0
1715640709940,DSC 197,001,628532,Eldridge; Justin Matthew,9995,0,9999,4
1715640710964,EAP 100,A00,516065,Staff,9799,0,9999,200
1715640711991,ECE 45,A01,507414,Staff,31,0,60,29
1715640714042,ECE 111,A01,507420,Staff,11,0,50,39
1715640715067,ECE 197,001,548057,Sievenpiper; Daniel F.,9991,0,9999,8
1715640716096,EDS 115,A00,507243,Choi; Bailey Miyeon,6,0,28,22
1715640717121,EDS 117,A01,494379,Staff,0,6,34,35
1715640718149,EDS 125,A00,507246,Hopkins; Megan Beth,7,0,30,23
1715640719178,EDS 128A,A01,507264,Fargason; Sharon Gayle,5,0,26,21
1715640720203,EDS 128B,A01,507293,Pappas; Elizabeth,9,0,30,21
1715640721228,EDS 139,A00,507294,Fargason; Sharon Gayle,9,0,30,21
1715640721228,EDS 139,B00,507313,Pappas; Elizabeth,9,0,30,21
1715640722257,EDS 201,A00,507315,Staff,10,0,30,20
1715640723281,EDS 203,A01,507317,Halter; Christopher P.,10,0,30,20
1715640724309,EDS 204R,A01,507319,Halter; Christopher P.,0,3,30,30
1715640724309,EDS 204R,B01,507331,Heinzman; Erica M.,14,0,30,16
1715640725337,EDS 206R,A00,507332,Staff,0,4,30,30
1715640725337,EDS 206R,B00,507343,Staff,15,0,30,15
1715640726365,EDS 250,A00,507344,Hemans; Patricia Ann Benitez,20,0,40,20
1715640727393,EDS 281,A00,507345,Daly; Alan J.,18,0,18,0
1715640728420,EDS 284,A00,507350,Daly; Alan J.,16,0,16,0
1715640729445,EDS 286,A00,507359,Fine; Sarah,18,0,18,0
1715640730473,EDS 289C,A01,507361,Daly; Alan J.,18,0,18,0
1715640731498,EDS 290,A00,507366,Hofstetter; Carolyn,15,0,15,0
1715640732526,LIGM 5A,A00,507421,Fischer-Grunski; Eva K,17,0,20,3
1715640733551,LIGM 5B,A00,507423,Fischer-Grunski; Eva K,19,0,20,1
1715640734576,LIGM 5C,A00,507425,Fischer-Grunski; Eva K,19,0,20,1
1715640735601,LIIT 5AS,A00,507427,Carnelos; Chiara,20,0,20,0
1715640736628,LIIT 5BS,A00,507430,Carnelos; Chiara,20,0,20,0
1715640737654,LIIT 5CS,A00,507432,Carnelos; Chiara,20,0,20,0
1715640738679,LISP 5A,A00,507541,Munoz Sanchez; Alicia,11,0,20,9
1715640739759,LISP 5B,A00,507671,Munoz Sanchez; Alicia,8,0,20,12
1715640740785,LISP 5C,A00,507696,Munoz Sanchez; Alicia,8,0,20,12
1715640741810,MAE 197,001,528363,Boechler; Nicholas Sebastia,9998,0,9999,1
1715640742841,MATH 197,001,523477,Kedlaya; Kiran S.,9994,0,9999,5
1715640742841,MATH 197,002,563811,Zhang; Danna,9994,0,9999,5
1715640742841,MATH 197,003,628552,Dumitriu; Ioana,9998,0,9999,1
1715640742841,MATH 197,004,660885,Floyd; Eric,9998,0,9999,1
1715640743882,MCWP 40R,A00,518780,Staff,1,0,20,19
1715640743882,MCWP 40R,B00,518781,Staff,10,0,20,10
1715640743882,MCWP 40R,C00,518783,Staff,5,0,20,15
1715640744908,MCWP 50R,A00,518791,Staff,0,1,20,20
1715640744908,MCWP 50R,B00,518792,Staff,0,2,20,20
1715640744908,MCWP 50R,C00,518793,Staff,0,4,20,20
1715640744908,MCWP 50R,D00,518794,Staff,0,1,20,20
1715640744908,MCWP 50R,E00,518795,Staff,0,2,20,20
1715640744908,MCWP 50R,F00,518796,Staff,0,1,20,20
1715640744908,MCWP 50R,G00,518797,Staff,0,1,20,20
1715640745937,MMW 12R,A01,514034,Herbst; Matthew,0,2,16,16
1715640745937,MMW 12R,A02,514035,Herbst; Matthew,0,0,16,16
1715640746966,MMW 13R,A01,514037,Staff,0,5,16,16
1715640746966,MMW 13R,A02,514039,Staff,0,5,16,16
1715640746966,MMW 13R,A03,628519,Staff,0,4,16,16
1715640749018,SIO 295LS,A00,523233,Staff,10,0,30,20
1715640750042,SIO 295S,A00,523232,Staff,10,0,30,20
1715640751071,SIOC 290S,A01,637330,Merrifield; Mark A,21,0,30,9
1715640752096,SIOC 291S,A01,637333,Gabriel; Corey John,21,0,30,9
1715640753125,SOCI 117,A01,494376,Staff,0,5,5,5
1715640754153,WES 237B,A00,494380,Staff,10,0,20,10
1715640756236,AESE 279B,A00,494370,Wade; Jon P,0,0,33,33
1715640757265,AIP 97,001,660915,Van Den Einde; Yael Dahlia,9998,0,9999,1
1715640758297,AIP 197,001,627712,Vespa; Emanuel Ignacio,9995,0,9999,4
1715640758297,AIP 197,002,650778,Amir; On,9998,0,9999,1
1715640758297,AIP 197,003,650933,Avenancio-Leon; Carlos,9998,0,9999,1
1715640758297,AIP 197,004,658530,Heyman; Gail D.,9998,0,9999,1
1715640758297,AIP 197,005,658631,Neal; Sonya E,9998,0,9999,1
1715640758297,AIP 197,006,658671,Du; Songzi,9998,0,9999,1
1715640759325,ANAR 135S,A00,494369,Braswell; Geoffrey E.,0,0,0,0
1715640760350,BENG 196,001,628496,Engler; Adam J.,9998,0,9999,1
1715640760350,BENG 196,002,660916,Watson; John Thomas,9998,0,9999,1
1715640761376,BISP 197,001,650773,Wilhelm; James E.,9994,0,9999,5
1715640761376,BISP 197,002,658904,Coleman; Aaron B.,9998,0,9999,1
1715640762403,CAT 124RS,A01,519847,Geibel; William,0,0,20,20
1715640763428,CAT 125RS,A01,515971,Geibel; William,0,0,20,20
1715640764454,CLRE 250,A00,511389,Morris; Sheldon,9992,0,9999,7
1715640765485,CLRE 251,A00,507176,Mehta; Ravindra L.,9992,0,9999,7
1715640765485,CLRE 251,B00,511410,Mehta; Ravindra L.,9998,0,9999,1
1715640766515,CLRE 252,A00,507189,Cuomo; Raphael Eduardo,9994,0,9999,5
1715640767544,CLRE 253,A00,507199,Vaida; Florin,9994,0,9999,5
1715640767544,CLRE 253,B00,507202,Vaida; Florin,9999,0,9999,0
1715640768569,CLRE 259,A00,507211,Patel; Hemal,9996,0,9999,3
1715640769597,CLRE 260,A00,507221,Cuomo; Raphael Eduardo,9999,0,9999,0
1715640770621,CLRE 297,001,507242,Cuomo; Raphael Eduardo,9999,0,9999,0
1715640771652,COGS 197,001,638244,Voytek; Bradley Thomas,9997,0,9999,2
1715640772681,CSE 191,A00,516875,Minnes Kemp; Mor Mia,9991,0,9999,8
1715640773705,CSE 197,001,637388,Minnes Kemp; Mor Mia,9992,0,9999,7
1715640774736,CSS 201S,A01,494383,Mignozzetti; Umberto,35,0,35,0
1715640775762,CSS 202S,A01,494387,Mignozzetti; Umberto,35,0,35,0
1715640776787,DSC 197,001,628532,Eldridge; Justin Matthew,9995,0,9999,4
1715640777814,EAP 100,A00,516065,Staff,9799,0,9999,200
1715640778843,ECE 45,A01,507414,Staff,31,0,60,29
1715640780893,ECE 111,A01,507420,Staff,11,0,50,39
1715640781917,ECE 197,001,548057,Sievenpiper; Daniel F.,9991,0,9999,8
1715640782944,EDS 115,A00,507243,Choi; Bailey Miyeon,6,0,28,22
1715640783971,EDS 117,A01,494379,Staff,0,6,34,35
1715640785001,EDS 125,A00,507246,Hopkins; Megan Beth,7,0,30,23
1715640786026,EDS 128A,A01,507264,Fargason; Sharon Gayle,5,0,26,21
1715640787052,EDS 128B,A01,507293,Pappas; Elizabeth,9,0,30,21
1715640788078,EDS 139,A00,507294,Fargason; Sharon Gayle,9,0,30,21
1715640788078,EDS 139,B00,507313,Pappas; Elizabeth,9,0,30,21
1715640789108,EDS 201,A00,507315,Staff,10,0,30,20
1715640790138,EDS 203,A01,507317,Halter; Christopher P.,10,0,30,20
1715640791165,EDS 204R,A01,507319,Halter; Christopher P.,0,3,30,30
1715640791165,EDS 204R,B01,507331,Heinzman; Erica M.,14,0,30,16
1715640792190,EDS 206R,A00,507332,Staff,0,4,30,30
1715640792190,EDS 206R,B00,507343,Staff,15,0,30,15
1715640793227,EDS 250,A00,507344,Hemans; Patricia Ann Benitez,20,0,40,20
1715640794252,EDS 281,A00,507345,Daly; Alan J.,18,0,18,0
1715640795276,EDS 284,A00,507350,Daly; Alan J.,16,0,16,0
1715640796305,EDS 286,A00,507359,Fine; Sarah,18,0,18,0
1715640797331,EDS 289C,A01,507361,Daly; Alan J.,18,0,18,0
1715640798358,EDS 290,A00,507366,Hofstetter; Carolyn,15,0,15,0
1715640799388,LIGM 5A,A00,507421,Fischer-Grunski; Eva K,17,0,20,3
1715640800413,LIGM 5B,A00,507423,Fischer-Grunski; Eva K,19,0,20,1
1715640801439,LIGM 5C,A00,507425,Fischer-Grunski; Eva K,19,0,20,1
1715640802466,LIIT 5AS,A00,507427,Carnelos; Chiara,20,0,20,0
1715640803493,LIIT 5BS,A00,507430,Carnelos; Chiara,20,0,20,0
1715640804526,LIIT 5CS,A00,507432,Carnelos; Chiara,20,0,20,0
1715640805557,LISP 5A,A00,507541,Munoz Sanchez; Alicia,11,0,20,9
1715640806585,LISP 5B,A00,507671,Munoz Sanchez; Alicia,8,0,20,12
1715640807615,LISP 5C,A00,507696,Munoz Sanchez; Alicia,8,0,20,12
1715640808646,MAE 197,001,528363,Boechler; Nicholas Sebastia,9998,0,9999,1
1715640809680,MATH 197,001,523477,Kedlaya; Kiran S.,9994,0,9999,5
1715640809680,MATH 197,002,563811,Zhang; Danna,9994,0,9999,5
1715640809680,MATH 197,003,628552,Dumitriu; Ioana,9998,0,9999,1
1715640809680,MATH 197,004,660885,Floyd; Eric,9998,0,9999,1
1715640810706,MCWP 40R,A00,518780,Staff,1,0,20,19
1715640810706,MCWP 40R,B00,518781,Staff,10,0,20,10
1715640810706,MCWP 40R,C00,518783,Staff,5,0,20,15
1715640811733,MCWP 50R,A00,518791,Staff,0,1,20,20
1715640811733,MCWP 50R,B00,518792,Staff,0,2,20,20
1715640811733,MCWP 50R,C00,518793,Staff,0,4,20,20
1715640811733,MCWP 50R,D00,518794,Staff,0,1,20,20
1715640811733,MCWP 50R,E00,518795,Staff,0,2,20,20
1715640811733,MCWP 50R,F00,518796,Staff,0,1,20,20
1715640811733,MCWP 50R,G00,518797,Staff,0,1,20,20
1715640812761,MMW 12R,A01,514034,Herbst; Matthew,0,2,16,16
1715640812761,MMW 12R,A02,514035,Herbst; Matthew,0,0,16,16
1715640813787,MMW 13R,A01,514037,Staff,0,5,16,16
1715640813787,MMW 13R,A02,514039,Staff,0,5,16,16
1715640813787,MMW 13R,A03,628519,Staff,0,4,16,16
1715640815840,SIO 295LS,A00,523233,Staff,10,0,30,20
1715640816868,SIO 295S,A00,523232,Staff,10,0,30,20
1715640817899,SIOC 290S,A01,637330,Merrifield; Mark A,21,0,30,9
1715640818925,SIOC 291S,A01,637333,Gabriel; Corey John,21,0,30,9
1715640819950,SOCI 117,A01,494376,Staff,0,5,5,5
1715640820979,WES 237B,A00,494380,Staff,10,0,20,10
1715640823051,AESE 279B,A00,494370,Wade; Jon P,0,0,33,33
1715640824078,AIP 97,001,660915,Van Den Einde; Yael Dahlia,9998,0,9999,1
1715640825106,AIP 197,001,627712,Vespa; Emanuel Ignacio,9995,0,9999,4
1715640825106,AIP 197,002,650778,Amir; On,9998,0,9999,1
1715640825106,AIP 197,003,650933,Avenancio-Leon; Carlos,9998,0,9999,1
1715640825106,AIP 197,004,658530,Heyman; Gail D.,9998,0,9999,1
1715640825106,AIP 197,005,658631,Neal; Sonya E,9998,0,9999,1
1715640825106,AIP 197,006,658671,Du; Songzi,9998,0,9999,1
1715640826132,ANAR 135S,A00,494369,Braswell; Geoffrey E.,0,0,0,0
1715640827157,BENG 196,001,628496,Engler; Adam J.,9998,0,9999,1
1715640827157,BENG 196,002,660916,Watson; John Thomas,9998,0,9999,1
1715640828185,BISP 197,001,650773,Wilhelm; James E.,9994,0,9999,5
1715640828185,BISP 197,002,658904,Coleman; Aaron B.,9998,0,9999,1
1715640829215,CAT 124RS,A01,519847,Geibel; William,0,0,20,20
1715640830245,CAT 125RS,A01,515971,Geibel; William,0,0,20,20
1715640831278,CLRE 250,A00,511389,Morris; Sheldon,9992,0,9999,7
1715640832308,CLRE 251,A00,507176,Mehta; Ravindra L.,9992,0,9999,7
1715640832308,CLRE 251,B00,511410,Mehta; Ravindra L.,9998,0,9999,1
1715640833335,CLRE 252,A00,507189,Cuomo; Raphael Eduardo,9994,0,9999,5
1715640834362,CLRE 253,A00,507199,Vaida; Florin,9994,0,9999,5
1715640834362,CLRE 253,B00,507202,Vaida; Florin,9999,0,9999,0
1715640835386,CLRE 259,A00,507211,Patel; Hemal,9996,0,9999,3
1715640836414,CLRE 260,A00,507221,Cuomo; Raphael Eduardo,9999,0,9999,0
1715640837440,CLRE 297,001,507242,Cuomo; Raphael Eduardo,9999,0,9999,0
1715640838468,COGS 197,001,638244,Voytek; Bradley Thomas,9997,0,9999,2
1715640839497,CSE 191,A00,516875,Minnes Kemp; Mor Mia,9991,0,9999,8
1715640840525,CSE 197,001,637388,Minnes Kemp; Mor Mia,9992,0,9999,7
1715640841552,CSS 201S,A01,494383,Mignozzetti; Umberto,35,0,35,0
1715640842586,CSS 202S,A01,494387,Mignozzetti; Umberto,35,0,35,0
1715640843674,DSC 197,001,628532,Eldridge; Justin Matthew,9995,0,9999,4
1715640844704,EAP 100,A00,516065,Staff,9799,0,9999,200
1715640845736,ECE 45,A01,507414,Staff,31,0,60,29
1715640847788,ECE 111,A01,507420,Staff,11,0,50,39
1715640848815,ECE 197,001,548057,Sievenpiper; Daniel F.,9991,0,9999,8
1715640849850,EDS 115,A00,507243,Choi; Bailey Miyeon,6,0,28,22
1715640850880,EDS 117,A01,494379,Staff,0,6,34,35
1715640851911,EDS 125,A00,507246,Hopkins; Megan Beth,7,0,30,23
1715640852938,EDS 128A,A01,507264,Fargason; Sharon Gayle,5,0,26,21
1715640853963,EDS 128B,A01,507293,Pappas; Elizabeth,9,0,30,21
1715640855046,EDS 139,A00,507294,Fargason; Sharon Gayle,9,0,30,21
1715640855046,EDS 139,B00,507313,Pappas; Elizabeth,9,0,30,21
1715640856080,EDS 201,A00,507315,Staff,10,0,30,20
1715640857107,EDS 203,A01,507317,Halter; Christopher P.,10,0,30,20
1715640858135,EDS 204R,A01,507319,Halter; Christopher P.,0,3,30,30
1715640858135,EDS 204R,B01,507331,Heinzman; Erica M.,14,0,30,16
1715640859160,EDS 206R,A00,507332,Staff,0,4,30,30
1715640859160,EDS 206R,B00,507343,Staff,15,0,30,15
1715640860189,EDS 250,A00,507344,Hemans; Patricia Ann Benitez,20,0,40,20
1715640861214,EDS 281,A00,507345,Daly; Alan J.,18,0,18,0
1715640862242,EDS 284,A00,507350,Daly; Alan J.,16,0,16,0
1715640863276,EDS 286,A00,507359,Fine; Sarah,18,0,18,0
1715640864301,EDS 289C,A01,507361,Daly; Alan J.,18,0,18,0
1715640865327,EDS 290,A00,507366,Hofstetter; Carolyn,15,0,15,0
1715640866354,LIGM 5A,A00,507421,Fischer-Grunski; Eva K,17,0,20,3
1715640867379,LIGM 5B,A00,507423,Fischer-Grunski; Eva K,19,0,20,1
1715640868403,LIGM 5C,A00,507425,Fischer-Grunski; Eva K,19,0,20,1
1715640869429,LIIT 5AS,A00,507427,Carnelos; Chiara,20,0,20,0
1715640870454,LIIT 5BS,A00,507430,Carnelos; Chiara,20,0,20,0
1715640871480,LIIT 5CS,A00,507432,Carnelos; Chiara,20,0,20,0
1715640872506,LISP 5A,A00,507541,Munoz Sanchez; Alicia,11,0,20,9
1715640873534,LISP 5B,A00,507671,Munoz Sanchez; Alicia,8,0,20,12
1715640874564,LISP 5C,A00,507696,Munoz Sanchez; Alicia,8,0,20,12
1715640875588,MAE 197,001,528363,Boechler; Nicholas Sebastia,9998,0,9999,1
1715640876615,MATH 197,001,523477,Kedlaya; Kiran S.,9994,0,9999,5
1715640876615,MATH 197,002,563811,Zhang; Danna,9994,0,9999,5
1715640876615,MATH 197,003,628552,Dumitriu; Ioana,9998,0,9999,1
1715640876615,MATH 197,004,660885,Floyd; Eric,9998,0,9999,1
1715640877638,MCWP 40R,A00,518780,Staff,1,0,20,19
1715640877638,MCWP 40R,B00,518781,Staff,10,0,20,10
1715640877638,MCWP 40R,C00,518783,Staff,5,0,20,15
1715640879208,MCWP 50R,A00,518791,Staff,0,1,20,20
1715640879208,MCWP 50R,B00,518792,Staff,0,2,20,20
1715640879208,MCWP 50R,C00,518793,Staff,0,4,20,20
1715640879208,MCWP 50R,D00,518794,Staff,0,1,20,20
1715640879208,MCWP 50R,E00,518795,Staff,0,2,20,20
1715640879208,MCWP 50R,F00,518796,Staff,0,1,20,20
1715640879208,MCWP 50R,G00,518797,Staff,0,1,20,20
1715640880233,MMW 12R,A01,514034,Herbst; Matthew,0,2,16,16
1715640880233,MMW 12R,A02,514035,Herbst; Matthew,0,0,16,16
1715640881263,MMW 13R,A01,514037,Staff,0,5,16,16
1715640881263,MMW 13R,A02,514039,Staff,0,5,16,16
1715640881263,MMW 13R,A03,628519,Staff,0,4,16,16
1715640883318,SIO 295LS,A00,523233,Staff,10,0,30,20
1715640884344,SIO 295S,A00,523232,Staff,10,0,30,20
1715640885370,SIOC 290S,A01,637330,Merrifield; Mark A,21,0,30,9
1715640886396,SIOC 291S,A01,637333,Gabriel; Corey John,21,0,30,9
1715640887425,SOCI 117,A01,494376,Staff,0,5,5,5
1715640888449,WES 237B,A00,494380,Staff,10,0,20,10
1715640890519,AESE 279B,A00,494370,Wade; Jon P,0,0,33,33
1715640891545,AIP 97,001,660915,Van Den Einde; Yael Dahlia,9998,0,9999,1
1715640892578,AIP 197,001,627712,Vespa; Emanuel Ignacio,9995,0,9999,4
1715640892578,AIP 197,002,650778,Amir; On,9998,0,9999,1
1715640892578,AIP 197,003,650933,Avenancio-Leon; Carlos,9998,0,9999,1
1715640892578,AIP 197,004,658530,Heyman; Gail D.,9998,0,9999,1
1715640892578,AIP 197,005,658631,Neal; Sonya E,9998,0,9999,1
1715640892578,AIP 197,006,658671,Du; Songzi,9998,0,9999,1
1715640893607,ANAR 135S,A00,494369,Braswell; Geoffrey E.,0,0,0,0
1715640894633,BENG 196,001,628496,Engler; Adam J.,9998,0,9999,1
1715640894633,BENG 196,002,660916,Watson; John Thomas,9998,0,9999,1
1715640895661,BISP 197,001,650773,Wilhelm; James E.,9994,0,9999,5
1715640895661,BISP 197,002,658904,Coleman; Aaron B.,9998,0,9999,1
1715640896688,CAT 124RS,A01,519847,Geibel; William,0,0,20,20
1715640897713,CAT 125RS,A01,515971,Geibel; William,0,0,20,20
1715640898740,CLRE 250,A00,511389,Morris; Sheldon,9992,0,9999,7
1715640899765,CLRE 251,A00,507176,Mehta; Ravindra L.,9992,0,9999,7
1715640899765,CLRE 251,B00,511410,Mehta; Ravindra L.,9998,0,9999,1
1715640900791,CLRE 252,A00,507189,Cuomo; Raphael Eduardo,9994,0,9999,5
1715640901818,CLRE 253,A00,507199,Vaida; Florin,9994,0,9999,5
1715640901818,CLRE 253,B00,507202,Vaida; Florin,9999,0,9999,0
1715640902845,CLRE 259,A00,507211,Patel; Hemal,9996,0,9999,3
1715640903874,CLRE 260,A00,507221,Cuomo; Raphael Eduardo,9999,0,9999,0
1715640904900,CLRE 297,001,507242,Cuomo; Raphael Eduardo,9999,0,9999,0
1715640905927,COGS 197,001,638244,Voytek; Bradley Thomas,9997,0,9999,2
1715640906954,CSE 191,A00,516875,Minnes Kemp; Mor Mia,9991,0,9999,8
1715640907984,CSE 197,001,637388,Minnes Kemp; Mor Mia,9992,0,9999,7
1715640909016,CSS 201S,A01,494383,Mignozzetti; Umberto,35,0,35,0
1715640910047,CSS 202S,A01,494387,Mignozzetti; Umberto,35,0,35,0
1715640911073,DSC 197,001,628532,Eldridge; Justin Matthew,9995,0,9999,4
1715640912100,EAP 100,A00,516065,Staff,9799,0,9999,200
1715640913127,ECE 45,A01,507414,Staff,31,0,60,29
1715640915182,ECE 111,A01,507420,Staff,11,0,50,39
1715640916209,ECE 197,001,548057,Sievenpiper; Daniel F.,9991,0,9999,8
1715640917234,EDS 115,A00,507243,Choi; Bailey Miyeon,6,0,28,22
1715640918265,EDS 117,A01,494379,Staff,0,6,34,35
1715640919294,EDS 125,A00,507246,Hopkins; Megan Beth,7,0,30,23
1715640920319,EDS 128A,A01,507264,Fargason; Sharon Gayle,5,0,26,21
1715640921348,EDS 128B,A01,507293,Pappas; Elizabeth,9,0,30,21
1715640922374,EDS 139,A00,507294,Fargason; Sharon Gayle,9,0,30,21
1715640922374,EDS 139,B00,507313,Pappas; Elizabeth,9,0,30,21
1715640923403,EDS 201,A00,507315,Staff,10,0,30,20
1715640924431,EDS 203,A01,507317,Halter; Christopher P.,10,0,30,20
1715640925458,EDS 204R,A01,507319,Halter; Christopher P.,0,3,30,30
1715640925458,EDS 204R,B01,507331,Heinzman; Erica M.,14,0,30,16
1715640926488,EDS 206R,A00,507332,Staff,0,4,30,30
1715640926488,EDS 206R,B00,507343,Staff,15,0,30,15
1715640927513,EDS 250,A00,507344,Hemans; Patricia Ann Benitez,20,0,40,20
1715640928540,EDS 281,A00,507345,Daly; Alan J.,18,0,18,0
1715640929568,EDS 284,A00,507350,Daly; Alan J.,16,0,16,0
1715640930593,EDS 286,A00,507359,Fine; Sarah,18,0,18,0
1715640931623,EDS 289C,A01,507361,Daly; Alan J.,18,0,18,0
1715640932655,EDS 290,A00,507366,Hofstetter; Carolyn,15,0,15,0
1715640933684,LIGM 5A,A00,507421,Fischer-Grunski; Eva K,17,0,20,3
1715640934713,LIGM 5B,A00,507423,Fischer-Grunski; Eva K,19,0,20,1
1715640935742,LIGM 5C,A00,507425,Fischer-Grunski; Eva K,19,0,20,1
1715640936767,LIIT 5AS,A00,507427,Carnelos; Chiara,20,0,20,0
1715640937793,LIIT 5BS,A00,507430,Carnelos; Chiara,20,0,20,0
1715640938824,LIIT 5CS,A00,507432,Carnelos; Chiara,20,0,20,0
1715640939849,LISP 5A,A00,507541,Munoz Sanchez; Alicia,11,0,20,9
1715640940878,LISP 5B,A00,507671,Munoz Sanchez; Alicia,8,0,20,12
1715640941907,LISP 5C,A00,507696,Munoz Sanchez; Alicia,8,0,20,12
1715640942933,MAE 197,001,528363,Boechler; Nicholas Sebastia,9998,0,9999,1
1715640943964,MATH 197,001,523477,Kedlaya; Kiran S.,9994,0,9999,5
1715640943964,MATH 197,002,563811,Zhang; Danna,9994,0,9999,5
1715640943964,MATH 197,003,628552,Dumitriu; Ioana,9998,0,9999,1
1715640943964,MATH 197,004,660885,Floyd; Eric,9998,0,9999,1
1715640944991,MCWP 40R,A00,518780,Staff,1,0,20,19
1715640944991,MCWP 40R,B00,518781,Staff,10,0,20,10
1715640944991,MCWP 40R,C00,518783,Staff,5,0,20,15
1715640946017,MCWP 50R,A00,518791,Staff,0,1,20,20
1715640946017,MCWP 50R,B00,518792,Staff,0,2,20,20
1715640946017,MCWP 50R,C00,518793,Staff,0,4,20,20
1715640946017,MCWP 50R,D00,518794,Staff,0,1,20,20
1715640946017,MCWP 50R,E00,518795,Staff,0,2,20,20
1715640946017,MCWP 50R,F00,518796,Staff,0,1,20,20
1715640946017,MCWP 50R,G00,518797,Staff,0,1,20,20
1715640947042,MMW 12R,A01,514034,Herbst; Matthew,0,2,16,16
1715640947042,MMW 12R,A02,514035,Herbst; Matthew,0,0,16,16
1715640948068,MMW 13R,A01,514037,Staff,0,5,16,16
1715640948068,MMW 13R,A02,514039,Staff,0,5,16,16
1715640948068,MMW 13R,A03,628519,Staff,0,4,16,16
1715640950119,SIO 295LS,A00,523233,Staff,10,0,30,20
1715640951144,SIO 295S,A00,523232,Staff,10,0,30,20
1715640952176,SIOC 290S,A01,637330,Merrifield; Mark A,21,0,30,9
1715640953205,SIOC 291S,A01,637333,Gabriel; Corey John,21,0,30,9
1715640954231,SOCI 117,A01,494376,Staff,0,5,5,5
1715640955255,WES 237B,A00,494380,Staff,10,0,20,10
1715640957340,AESE 279B,A00,494370,Wade; Jon P,0,0,33,33
1715640958366,AIP 97,001,660915,Van Den Einde; Yael Dahlia,9998,0,9999,1
1715640959395,AIP 197,001,627712,Vespa; Emanuel Ignacio,9995,0,9999,4
1715640959395,AIP 197,002,650778,Amir; On,9998,0,9999,1
1715640959395,AIP 197,003,650933,Avenancio-Leon; Carlos,9998,0,9999,1
1715640959395,AIP 197,004,658530,Heyman; Gail D.,9998,0,9999,1
1715640959395,AIP 197,005,658631,Neal; Sonya E,9998,0,9999,1
1715640959395,AIP 197,006,658671,Du; Songzi,9998,0,9999,1
1715640960419,ANAR 135S,A00,494369,Braswell; Geoffrey E.,0,0,0,0
1715640961450,BENG 196,001,628496,Engler; Adam J.,9998,0,9999,1
1715640961450,BENG 196,002,660916,Watson; John Thomas,9998,0,9999,1
1715640962477,BISP 197,001,650773,Wilhelm; James E.,9994,0,9999,5
1715640962477,BISP 197,002,658904,Coleman; Aaron B.,9998,0,9999,1
1715640963508,CAT 124RS,A01,519847,Geibel; William,0,0,20,20
1715640964536,CAT 125RS,A01,515971,Geibel; William,0,0,20,20
1715640965564,CLRE 250,A00,511389,Morris; Sheldon,9992,0,9999,7
1715640966597,CLRE 251,A00,507176,Mehta; Ravindra L.,9992,0,9999,7
1715640966597,CLRE 251,B00,511410,Mehta; Ravindra L.,9998,0,9999,1
1715640967622,CLRE 252,A00,507189,Cuomo; Raphael Eduardo,9994,0,9999,5
1715640968647,CLRE 253,A00,507199,Vaida; Florin,9994,0,9999,5
1715640968647,CLRE 253,B00,507202,Vaida; Florin,9999,0,9999,0
1715640969674,CLRE 259,A00,507211,Patel; Hemal,9996,0,9999,3
1715640970699,CLRE 260,A00,507221,Cuomo; Raphael Eduardo,9999,0,9999,0
1715640971726,CLRE 297,001,507242,Cuomo; Raphael Eduardo,9999,0,9999,0
1715640972752,COGS 197,001,638244,Voytek; Bradley Thomas,9997,0,9999,2
1715640973782,CSE 191,A00,516875,Minnes Kemp; Mor Mia,9991,0,9999,8
1715640974806,CSE 197,001,637388,Minnes Kemp; Mor Mia,9992,0,9999,7
1715640975832,CSS 201S,A01,494383,Mignozzetti; Umberto,35,0,35,0
1715640976859,CSS 202S,A01,494387,Mignozzetti; Umberto,35,0,35,0
1715640977883,DSC 197,001,628532,Eldridge; Justin Matthew,9995,0,9999,4
1715640978907,EAP 100,A00,516065,Staff,9799,0,9999,200
1715640979939,ECE 45,A01,507414,Staff,31,0,60,29
1715640981992,ECE 111,A01,507420,Staff,11,0,50,39
1715640983015,ECE 197,001,548057,Sievenpiper; Daniel F.,9991,0,9999,8
1715640984042,EDS 115,A00,507243,Choi; Bailey Miyeon,6,0,28,22
1715640985069,EDS 117,A01,494379,Staff,0,6,34,35
1715640986100,EDS 125,A00,507246,Hopkins; Megan Beth,7,0,30,23
1715640987127,EDS 128A,A01,507264,Fargason; Sharon Gayle,5,0,26,21
1715640988156,EDS 128B,A01,507293,Pappas; Elizabeth,9,0,30,21
1715640989181,EDS 139,A00,507294,Fargason; Sharon Gayle,9,0,30,21
1715640989181,EDS 139,B00,507313,Pappas; Elizabeth,9,0,30,21
1715640990208,EDS 201,A00,507315,Staff,10,0,30,20
1715640991240,EDS 203,A01,507317,Halter; Christopher P.,10,0,30,20
1715640992269,EDS 204R,A01,507319,Halter; Christopher P.,0,3,30,30
1715640992269,EDS 204R,B01,507331,Heinzman; Erica M.,14,0,30,16
1715640993294,EDS 206R,A00,507332,Staff,0,4,30,30
1715640993294,EDS 206R,B00,507343,Staff,15,0,30,15
1715640994318,EDS 250,A00,507344,Hemans; Patricia Ann Benitez,20,0,40,20
1715640995343,EDS 281,A00,507345,Daly; Alan J.,18,0,18,0
1715640996370,EDS 284,A00,507350,Daly; Alan J.,16,0,16,0
1715640997395,EDS 286,A00,507359,Fine; Sarah,18,0,18,0
1715640998421,EDS 289C,A01,507361,Daly; Alan J.,18,0,18,0
1715640999447,EDS 290,A00,507366,Hofstetter; Carolyn,15,0,15,0
1715641000473,LIGM 5A,A00,507421,Fischer-Grunski; Eva K,17,0,20,3
1715641001498,LIGM 5B,A00,507423,Fischer-Grunski; Eva K,19,0,20,1
1715641002530,LIGM 5C,A00,507425,Fischer-Grunski; Eva K,19,0,20,1
1715641003555,LIIT 5AS,A00,507427,Carnelos; Chiara,20,0,20,0
1715641004579,LIIT 5BS,A00,507430,Carnelos; Chiara,20,0,20,0
1715641005603,LIIT 5CS,A00,507432,Carnelos; Chiara,20,0,20,0
1715641006641,LISP 5A,A00,507541,Munoz Sanchez; Alicia,11,0,20,9
1715641007666,LISP 5B,A00,507671,Munoz Sanchez; Alicia,8,0,20,12
1715641008695,LISP 5C,A00,507696,Munoz Sanchez; Alicia,8,0,20,12
1715641009722,MAE 197,001,528363,Boechler; Nicholas Sebastia,9998,0,9999,1
1715641010752,MATH 197,001,523477,Kedlaya; Kiran S.,9994,0,9999,5
1715641010752,MATH 197,002,563811,Zhang; Danna,9994,0,9999,5
1715641010752,MATH 197,003,628552,Dumitriu; Ioana,9998,0,9999,1
1715641010752,MATH 197,004,660885,Floyd; Eric,9998,0,9999,1
1715641011782,MCWP 40R,A00,518780,Staff,1,0,20,19
1715641011782,MCWP 40R,B00,518781,Staff,10,0,20,10
1715641011782,MCWP 40R,C00,518783,Staff,5,0,20,15
1715641012813,MCWP 50R,A00,518791,Staff,0,1,20,20
1715641012813,MCWP 50R,B00,518792,Staff,0,2,20,20
1715641012813,MCWP 50R,C00,518793,Staff,0,4,20,20
1715641012813,MCWP 50R,D00,518794,Staff,0,1,20,20
1715641012813,MCWP 50R,E00,518795,Staff,0,2,20,20
1715641012813,MCWP 50R,F00,518796,Staff,0,1,20,20
1715641012813,MCWP 50R,G00,518797,Staff,0,1,20,20
1715641013839,MMW 12R,A01,514034,Herbst; Matthew,0,2,16,16
1715641013839,MMW 12R,A02,514035,Herbst; Matthew,0,0,16,16
1715641014866,MMW 13R,A01,514037,Staff,0,5,16,16
1715641014866,MMW 13R,A02,514039,Staff,0,5,16,16
1715641014866,MMW 13R,A03,628519,Staff,0,4,16,16
1715641016916,SIO 295LS,A00,523233,Staff,10,0,30,20
1715641017942,SIO 295S,A00,523232,Staff,10,0,30,20
1715641018974,SIOC 290S,A01,637330,Merrifield; Mark A,21,0,30,9
1715641020004,SIOC 291S,A01,637333,Gabriel; Corey John,21,0,30,9
1715641021032,SOCI 117,A01,494376,Staff,0,5,5,5
1715641022057,WES 237B,A00,494380,Staff,10,0,20,10
1715641024126,AESE 279B,A00,494370,Wade; Jon P,0,0,33,33
1715641025152,AIP 97,001,660915,Van Den Einde; Yael Dahlia,9998,0,9999,1
1715641026181,AIP 197,001,627712,Vespa; Emanuel Ignacio,9995,0,9999,4
1715641026181,AIP 197,002,650778,Amir; On,9998,0,9999,1
1715641026181,AIP 197,003,650933,Avenancio-Leon; Carlos,9998,0,9999,1
1715641026181,AIP 197,004,658530,Heyman; Gail D.,9998,0,9999,1
1715641026181,AIP 197,005,658631,Neal; Sonya E,9998,0,9999,1
1715641026181,AIP 197,006,658671,Du; Songzi,9998,0,9999,1
1715641027208,ANAR 135S,A00,494369,Braswell; Geoffrey E.,0,0,0,0
1715641028239,BENG 196,001,628496,Engler; Adam J.,9998,0,9999,1
1715641028239,BENG 196,002,660916,Watson; John Thomas,9998,0,9999,1
1715641029264,BISP 197,001,650773,Wilhelm; James E.,9994,0,9999,5
1715641029264,BISP 197,002,658904,Coleman; Aaron B.,9998,0,9999,1
1715641030291,CAT 124RS,A01,519847,Geibel; William,0,0,20,20
1715641031316,CAT 125RS,A01,515971,Geibel; William,0,0,20,20
1715641032346,CLRE 250,A00,511389,Morris; Sheldon,9992,0,9999,7
1715641033379,CLRE 251,A00,507176,Mehta; Ravindra L.,9992,0,9999,7
1715641033379,CLRE 251,B00,511410,Mehta; Ravindra L.,9998,0,9999,1
1715641034407,CLRE 252,A00,507189,Cuomo; Raphael Eduardo,9994,0,9999,5
1715641035432,CLRE 253,A00,507199,Vaida; Florin,9994,0,9999,5
1715641035432,CLRE 253,B00,507202,Vaida; Florin,9999,0,9999,0
1715641036461,CLRE 259,A00,507211,Patel; Hemal,9996,0,9999,3
1715641037488,CLRE 260,A00,507221,Cuomo; Raphael Eduardo,9999,0,9999,0
1715641038513,CLRE 297,001,507242,Cuomo; Raphael Eduardo,9999,0,9999,0
1715641039538,COGS 197,001,638244,Voytek; Bradley Thomas,9997,0,9999,2
1715641040565,CSE 191,A00,516875,Minnes Kemp; Mor Mia,9991,0,9999,8
1715641041594,CSE 197,001,637388,Minnes Kemp; Mor Mia,9992,0,9999,7
1715641042625,CSS 201S,A01,494383,Mignozzetti; Umberto,35,0,35,0
1715641043651,CSS 202S,A01,494387,Mignozzetti; Umberto,35,0,35,0
1715641044680,DSC 197,001,628532,Eldridge; Justin Matthew,9995,0,9999,4
1715641045708,EAP 100,A00,516065,Staff,9799,0,9999,200
1715641046736,ECE 45,A01,507414,Staff,31,0,60,29
1715641048790,ECE 111,A01,507420,Staff,11,0,50,39
1715641049815,ECE 197,001,548057,Sievenpiper; Daniel F.,9991,0,9999,8
1715641050848,EDS 115,A00,507243,Choi; Bailey Miyeon,6,0,28,22
1715641051874,EDS 117,A01,494379,Staff,0,6,34,35
1715641052900,EDS 125,A00,507246,Hopkins; Megan Beth,7,0,30,23
1715641053931,EDS 128A,A01,507264,Fargason; Sharon Gayle,5,0,26,21
1715641054961,EDS 128B,A01,507293,Pappas; Elizabeth,9,0,30,21
1715641055985,EDS 139,A00,507294,Fargason; Sharon Gayle,9,0,30,21
1715641055985,EDS 139,B00,507313,Pappas; Elizabeth,9,0,30,21
1715641057011,EDS 201,A00,507315,Staff,10,0,30,20
1715641058036,EDS 203,A01,507317,Halter; Christopher P.,10,0,30,20
1715641059064,EDS 204R,A01,507319,Halter; Christopher P.,0,3,30,30
1715641059064,EDS 204R,B01,507331,Heinzman; Erica M.,14,0,30,16
1715641060090,EDS 206R,A00,507332,Staff,0,4,30,30
1715641060090,EDS 206R,B00,507343,Staff,15,0,30,15
1715641061120,EDS 250,A00,507344,Hemans; Patricia Ann Benitez,20,0,40,20
1715641062146,EDS 281,A00,507345,Daly; Alan J.,18,0,18,0
1715641063171,EDS 284,A00,507350,Daly; Alan J.,16,0,16,0
1715641064196,EDS 286,A00,507359,Fine; Sarah,18,0,18,0
1715641065222,EDS 289C,A01,507361,Daly; Alan J.,18,0,18,0
1715641066247,EDS 290,A00,507366,Hofstetter; Carolyn,15,0,15,0
1715641067273,LIGM 5A,A00,507421,Fischer-Grunski; Eva K,17,0,20,3
1715641068298,LIGM 5B,A00,507423,Fischer-Grunski; Eva K,19,0,20,1
1715641069326,LIGM 5C,A00,507425,Fischer-Grunski; Eva K,19,0,20,1
1715641070352,LIIT 5AS,A00,507427,Carnelos; Chiara,20,0,20,0
1715641071382,LIIT 5BS,A00,507430,Carnelos; Chiara,20,0,20,0
1715641072411,LIIT 5CS,A00,507432,Carnelos; Chiara,20,0,20,0
1715641073438,LISP 5A,A00,507541,Munoz Sanchez; Alicia,11,0,20,9
1715641074467,LISP 5B,A00,507671,Munoz Sanchez; Alicia,8,0,20,12
1715641075495,LISP 5C,A00,507696,Munoz Sanchez; Alicia,8,0,20,12
1715641076525,MAE 197,001,528363,Boechler; Nicholas Sebastia,9998,0,9999,1
1715641077554,MATH 197,001,523477,Kedlaya; Kiran S.,9994,0,9999,5
1715641077554,MATH 197,002,563811,Zhang; Danna,9994,0,9999,5
1715641077554,MATH 197,003,628552,Dumitriu; Ioana,9998,0,9999,1
1715641077554,MATH 197,004,660885,Floyd; Eric,9998,0,9999,1
1715641078583,MCWP 40R,A00,518780,Staff,1,0,20,19
1715641078583,MCWP 40R,B00,518781,Staff,10,0,20,10
1715641078583,MCWP 40R,C00,518783,Staff,5,0,20,15
1715641079609,MCWP 50R,A00,518791,Staff,0,1,20,20
1715641079609,MCWP 50R,B00,518792,Staff,0,2,20,20
1715641079609,MCWP 50R,C00,518793,Staff,0,4,20,20
1715641079609,MCWP 50R,D00,518794,Staff,0,1,20,20
1715641079609,MCWP 50R,E00,518795,Staff,0,2,20,20
1715641079609,MCWP 50R,F00,518796,Staff,0,1,20,20
1715641079609,MCWP 50R,G00,518797,Staff,0,1,20,20
1715641080639,MMW 12R,A01,514034,Herbst; Matthew,0,2,16,16
1715641080639,MMW 12R,A02,514035,Herbst; Matthew,0,0,16,16
1715641081669,MMW 13R,A01,514037,Staff,0,5,16,16
1715641081669,MMW 13R,A02,514039,Staff,0,5,16,16
1715641081669,MMW 13R,A03,628519,Staff,0,4,16,16
1715641083720,SIO 295LS,A00,523233,Staff,10,0,30,20
1715641084749,SIO 295S,A00,523232,Staff,10,0,30,20
1715641085776,SIOC 290S,A01,637330,Merrifield; Mark A,21,0,30,9
1715641086804,SIOC 291S,A01,637333,Gabriel; Corey John,21,0,30,9
1715641087834,SOCI 117,A01,494376,Staff,0,5,5,5
1715641088863,WES 237B,A00,494380,Staff,10,0,20,10
1715641090943,AESE 279B,A00,494370,Wade; Jon P,0,0,33,33
1715641091984,AIP 97,001,660915,Van Den Einde; Yael Dahlia,9998,0,9999,1
1715641093013,AIP 197,001,627712,Vespa; Emanuel Ignacio,9995,0,9999,4
1715641093013,AIP 197,002,650778,Amir; On,9998,0,9999,1
1715641093013,AIP 197,003,650933,Avenancio-Leon; Carlos,9998,0,9999,1
1715641093013,AIP 197,004,658530,Heyman; Gail D.,9998,0,9999,1
1715641093013,AIP 197,005,658631,Neal; Sonya E,9998,0,9999,1
1715641093013,AIP 197,006,658671,Du; Songzi,9998,0,9999,1
1715641094044,ANAR 135S,A00,494369,Braswell; Geoffrey E.,0,0,0,0
1715641095071,BENG 196,001,628496,Engler; Adam J.,9998,0,9999,1
1715641095071,BENG 196,002,660916,Watson; John Thomas,9998,0,9999,1
1715641096103,BISP 197,001,650773,Wilhelm; James E.,9994,0,9999,5
1715641096103,BISP 197,002,658904,Coleman; Aaron B.,9998,0,9999,1
1715641097132,CAT 124RS,A01,519847,Geibel; William,0,0,20,20
1715641098157,CAT 125RS,A01,515971,Geibel; William,0,0,20,20
1715641099184,CLRE 250,A00,511389,Morris; Sheldon,9992,0,9999,7
1715641100212,CLRE 251,A00,507176,Mehta; Ravindra L.,9992,0,9999,7
1715641100212,CLRE 251,B00,511410,Mehta; Ravindra L.,9998,0,9999,1
1715641101238,CLRE 252,A00,507189,Cuomo; Raphael Eduardo,9994,0,9999,5
1715641102268,CLRE 253,A00,507199,Vaida; Florin,9994,0,9999,5
1715641102268,CLRE 253,B00,507202,Vaida; Florin,9999,0,9999,0
1715641103294,CLRE 259,A00,507211,Patel; Hemal,9996,0,9999,3
1715641104324,CLRE 260,A00,507221,Cuomo; Raphael Eduardo,9999,0,9999,0
1715641105351,CLRE 297,001,507242,Cuomo; Raphael Eduardo,9999,0,9999,0
1715641106377,COGS 197,001,638244,Voytek; Bradley Thomas,9997,0,9999,2
1715641107404,CSE 191,A00,516875,Minnes Kemp; Mor Mia,9991,0,9999,8
1715641108429,CSE 197,001,637388,Minnes Kemp; Mor Mia,9992,0,9999,7
1715641109455,CSS 201S,A01,494383,Mignozzetti; Umberto,35,0,35,0
1715641110482,CSS 202S,A01,494387,Mignozzetti; Umberto,35,0,35,0
1715641111510,DSC 197,001,628532,Eldridge; Justin Matthew,9995,0,9999,4
1715641112539,EAP 100,A00,516065,Staff,9799,0,9999,200
1715641113570,ECE 45,A01,507414,Staff,31,0,60,29
1715641115624,ECE 111,A01,507420,Staff,11,0,50,39
1715641116650,ECE 197,001,548057,Sievenpiper; Daniel F.,9991,0,9999,8
1715641117680,EDS 115,A00,507243,Choi; Bailey Miyeon,6,0,28,22
1715641118706,EDS 117,A01,494379,Staff,0,6,34,35
1715641119738,EDS 125,A00,507246,Hopkins; Megan Beth,7,0,30,23
1715641120768,EDS 128A,A01,507264,Fargason; Sharon Gayle,5,0,26,21
1715641121797,EDS 128B,A01,507293,Pappas; Elizabeth,9,0,30,21
1715641122826,EDS 139,A00,507294,Fargason; Sharon Gayle,9,0,30,21
1715641122826,EDS 139,B00,507313,Pappas; Elizabeth,9,0,30,21
1715641123852,EDS 201,A00,507315,Staff,10,0,30,20
1715641124878,EDS 203,A01,507317,Halter; Christopher P.,10,0,30,20
1715641125904,EDS 204R,A01,507319,Halter; Christopher P.,0,3,30,30
1715641125904,EDS 204R,B01,507331,Heinzman; Erica M.,14,0,30,16
1715641126929,EDS 206R,A00,507332,Staff,0,4,30,30
1715641126929,EDS 206R,B00,507343,Staff,15,0,30,15
1715641127960,EDS 250,A00,507344,Hemans; Patricia Ann Benitez,20,0,40,20
1715641128986,EDS 281,A00,507345,Daly; Alan J.,18,0,18,0
1715641130011,EDS 284,A00,507350,Daly; Alan J.,16,0,16,0
1715641131038,EDS 286,A00,507359,Fine; Sarah,18,0,18,0
1715641132063,EDS 289C,A01,507361,Daly; Alan J.,18,0,18,0
1715641133090,EDS 290,A00,507366,Hofstetter; Carolyn,15,0,15,0
1715641134116,LIGM 5A,A00,507421,Fischer-Grunski; Eva K,17,0,20,3
1715641135141,LIGM 5B,A00,507423,Fischer-Grunski; Eva K,19,0,20,1
1715641136170,LIGM 5C,A00,507425,Fischer-Grunski; Eva K,19,0,20,1
1715641137198,LIIT 5AS,A00,507427,Carnelos; Chiara,20,0,20,0
1715641138232,LIIT 5BS,A00,507430,Carnelos; Chiara,20,0,20,0
1715641139261,LIIT 5CS,A00,507432,Carnelos; Chiara,20,0,20,0
1715641140286,LISP 5A,A00,507541,Munoz Sanchez; Alicia,11,0,20,9
1715641141312,LISP 5B,A00,507671,Munoz Sanchez; Alicia,8,0,20,12
1715641142342,LISP 5C,A00,507696,Munoz Sanchez; Alicia,8,0,20,12
1715641143371,MAE 197,001,528363,Boechler; Nicholas Sebastia,9998,0,9999,1
1715641144405,MATH 197,001,523477,Kedlaya; Kiran S.,9994,0,9999,5
1715641144405,MATH 197,002,563811,Zhang; Danna,9994,0,9999,5
1715641144405,MATH 197,003,628552,Dumitriu; Ioana,9998,0,9999,1
1715641144405,MATH 197,004,660885,Floyd; Eric,9998,0,9999,1
1715641145431,MCWP 40R,A00,518780,Staff,1,0,20,19
1715641145431,MCWP 40R,B00,518781,Staff,10,0,20,10
1715641145431,MCWP 40R,C00,518783,Staff,5,0,20,15
1715641146458,MCWP 50R,A00,518791,Staff,0,1,20,20
1715641146458,MCWP 50R,B00,518792,Staff,0,2,20,20
1715641146458,MCWP 50R,C00,518793,Staff,0,4,20,20
1715641146458,MCWP 50R,D00,518794,Staff,0,1,20,20
1715641146458,MCWP 50R,E00,518795,Staff,0,2,20,20
1715641146458,MCWP 50R,F00,518796,Staff,0,1,20,20
1715641146458,MCWP 50R,G00,518797,Staff,0,1,20,20
1715641147483,MMW 12R,A01,514034,Herbst; Matthew,0,2,16,16
1715641147483,MMW 12R,A02,514035,Herbst; Matthew,0,0,16,16
1715641148509,MMW 13R,A01,514037,Staff,0,5,16,16
1715641148509,MMW 13R,A02,514039,Staff,0,5,16,16
1715641148509,MMW 13R,A03,628519,Staff,0,4,16,16
1715641150564,SIO 295LS,A00,523233,Staff,10,0,30,20
1715641151590,SIO 295S,A00,523232,Staff,10,0,30,20
1715641152622,SIOC 290S,A01,637330,Merrifield; Mark A,21,0,30,9
1715641153654,SIOC 291S,A01,637333,Gabriel; Corey John,21,0,30,9
1715641154685,SOCI 117,A01,494376,Staff,0,5,5,5
1715641155710,WES 237B,A00,494380,Staff,10,0,20,10
1715641157786,AESE 279B,A00,494370,Wade; Jon P,0,0,33,33
1715641158812,AIP 97,001,660915,Van Den Einde; Yael Dahlia,9998,0,9999,1
1715641159842,AIP 197,001,627712,Vespa; Emanuel Ignacio,9995,0,9999,4
1715641159842,AIP 197,002,650778,Amir; On,9998,0,9999,1
1715641159842,AIP 197,003,650933,Avenancio-Leon; Carlos,9998,0,9999,1
1715641159842,AIP 197,004,658530,Heyman; Gail D.,9998,0,9999,1
1715641159842,AIP 197,005,658631,Neal; Sonya E,9998,0,9999,1
1715641159842,AIP 197,006,658671,Du; Songzi,9998,0,9999,1
1715641160871,ANAR 135S,A00,494369,Braswell; Geoffrey E.,0,0,0,0
1715641161898,BENG 196,001,628496,Engler; Adam J.,9998,0,9999,1
1715641161898,BENG 196,002,660916,Watson; John Thomas,9998,0,9999,1
1715641162927,BISP 197,001,650773,Wilhelm; James E.,9994,0,9999,5
1715641162927,BISP 197,002,658904,Coleman; Aaron B.,9998,0,9999,1
1715641163953,CAT 124RS,A01,519847,Geibel; William,0,0,20,20
1715641164977,CAT 125RS,A01,515971,Geibel; William,0,0,20,20
1715641166004,CLRE 250,A00,511389,Morris; Sheldon,9992,0,9999,7
1715641167031,CLRE 251,A00,507176,Mehta; Ravindra L.,9992,0,9999,7
1715641167031,CLRE 251,B00,511410,Mehta; Ravindra L.,9998,0,9999,1
1715641168059,CLRE 252,A00,507189,Cuomo; Raphael Eduardo,9994,0,9999,5
1715641169085,CLRE 253,A00,507199,Vaida; Florin,9994,0,9999,5
1715641169085,CLRE 253,B00,507202,Vaida; Florin,9999,0,9999,0
1715641170114,CLRE 259,A00,507211,Patel; Hemal,9996,0,9999,3
1715641171143,CLRE 260,A00,507221,Cuomo; Raphael Eduardo,9999,0,9999,0
1715641172172,CLRE 297,001,507242,Cuomo; Raphael Eduardo,9999,0,9999,0
1715641173198,COGS 197,001,638244,Voytek; Bradley Thomas,9997,0,9999,2
1715641174224,CSE 191,A00,516875,Minnes Kemp; Mor Mia,9991,0,9999,8
1715641175253,CSE 197,001,637388,Minnes Kemp; Mor Mia,9992,0,9999,7
1715641176284,CSS 201S,A01,494383,Mignozzetti; Umberto,35,0,35,0
1715641177309,CSS 202S,A01,494387,Mignozzetti; Umberto,35,0,35,0
1715641178338,DSC 197,001,628532,Eldridge; Justin Matthew,9995,0,9999,4
1715641179364,EAP 100,A00,516065,Staff,9799,0,9999,200
1715641180392,ECE 45,A01,507414,Staff,31,0,60,29
1715641182447,ECE 111,A01,507420,Staff,11,0,50,39
1715641183472,ECE 197,001,548057,Sievenpiper; Daniel F.,9991,0,9999,8
1715641184499,EDS 115,A00,507243,Choi; Bailey Miyeon,6,0,28,22
1715641185525,EDS 117,A01,494379,Staff,0,6,34,35
1715641186554,EDS 125,A00,507246,Hopkins; Megan Beth,7,0,30,23
1715641187583,EDS 128A,A01,507264,Fargason; Sharon Gayle,5,0,26,21
1715641188609,EDS 128B,A01,507293,Pappas; Elizabeth,9,0,30,21
1715641189637,EDS 139,A00,507294,Fargason; Sharon Gayle,9,0,30,21
1715641189637,EDS 139,B00,507313,Pappas; Elizabeth,9,0,30,21
1715641190666,EDS 201,A00,507315,Staff,10,0,30,20
1715641191690,EDS 203,A01,507317,Halter; Christopher P.,10,0,30,20
1715641192720,EDS 204R,A01,507319,Halter; Christopher P.,0,3,30,30
1715641192720,EDS 204R,B01,507331,Heinzman; Erica M.,14,0,30,16
1715641193749,EDS 206R,A00,507332,Staff,0,4,30,30
1715641193749,EDS 206R,B00,507343,Staff,15,0,30,15
1715641194774,EDS 250,A00,507344,Hemans; Patricia Ann Benitez,20,0,40,20
1715641195802,EDS 281,A00,507345,Daly; Alan J.,18,0,18,0
1715641196826,EDS 284,A00,507350,Daly; Alan J.,16,0,16,0
1715641197851,EDS 286,A00,507359,Fine; Sarah,18,0,18,0
1715641198875,EDS 289C,A01,507361,Daly; Alan J.,18,0,18,0
1715641199904,EDS 290,A00,507366,Hofstetter; Carolyn,15,0,15,0
1715641200930,LIGM 5A,A00,507421,Fischer-Grunski; Eva K,17,0,20,3
1715641201956,LIGM 5B,A00,507423,Fischer-Grunski; Eva K,19,0,20,1
1715641202982,LIGM 5C,A00,507425,Fischer-Grunski; Eva K,19,0,20,1
1715641204011,LIIT 5AS,A00,507427,Carnelos; Chiara,20,0,20,0
1715641205038,LIIT 5BS,A00,507430,Carnelos; Chiara,20,0,20,0
1715641206064,LIIT 5CS,A00,507432,Carnelos; Chiara,20,0,20,0
1715641207090,LISP 5A,A00,507541,Munoz Sanchez; Alicia,11,0,20,9
1715641208116,LISP 5B,A00,507671,Munoz Sanchez; Alicia,8,0,20,12
1715641209145,LISP 5C,A00,507696,Munoz Sanchez; Alicia,8,0,20,12
1715641210176,MAE 197,001,528363,Boechler; Nicholas Sebastia,9998,0,9999,1
1715641211203,MATH 197,001,523477,Kedlaya; Kiran S.,9994,0,9999,5
1715641211203,MATH 197,002,563811,Zhang; Danna,9994,0,9999,5
1715641211203,MATH 197,003,628552,Dumitriu; Ioana,9998,0,9999,1
1715641211203,MATH 197,004,660885,Floyd; Eric,9998,0,9999,1
1715641212230,MCWP 40R,A00,518780,Staff,1,0,20,19
1715641212230,MCWP 40R,B00,518781,Staff,10,0,20,10
1715641212230,MCWP 40R,C00,518783,Staff,5,0,20,15
1715641213255,MCWP 50R,A00,518791,Staff,0,1,20,20
1715641213255,MCWP 50R,B00,518792,Staff,0,2,20,20
1715641213255,MCWP 50R,C00,518793,Staff,0,4,20,20
1715641213255,MCWP 50R,D00,518794,Staff,0,1,20,20
1715641213255,MCWP 50R,E00,518795,Staff,0,2,20,20
1715641213255,MCWP 50R,F00,518796,Staff,0,1,20,20
1715641213255,MCWP 50R,G00,518797,Staff,0,1,20,20
1715641214281,MMW 12R,A01,514034,Herbst; Matthew,0,2,16,16
1715641214281,MMW 12R,A02,514035,Herbst; Matthew,0,0,16,16
1715641215306,MMW 13R,A01,514037,Staff,0,5,16,16
1715641215306,MMW 13R,A02,514039,Staff,0,5,16,16
1715641215306,MMW 13R,A03,628519,Staff,0,4,16,16
1715641217356,SIO 295LS,A00,523233,Staff,10,0,30,20
1715641218381,SIO 295S,A00,523232,Staff,10,0,30,20
1715641219411,SIOC 290S,A01,637330,Merrifield; Mark A,21,0,30,9
1715641220439,SIOC 291S,A01,637333,Gabriel; Corey John,21,0,30,9
1715641221467,SOCI 117,A01,494376,Staff,0,5,5,5
1715641222496,WES 237B,A00,494380,Staff,10,0,20,10
1715641224562,AESE 279B,A00,494370,Wade; Jon P,0,0,33,33
1715641225592,AIP 97,001,660915,Van Den Einde; Yael Dahlia,9998,0,9999,1
1715641226619,AIP 197,001,627712,Vespa; Emanuel Ignacio,9995,0,9999,4
1715641226619,AIP 197,002,650778,Amir; On,9998,0,9999,1
1715641226619,AIP 197,003,650933,Avenancio-Leon; Carlos,9998,0,9999,1
1715641226619,AIP 197,004,658530,Heyman; Gail D.,9998,0,9999,1
1715641226619,AIP 197,005,658631,Neal; Sonya E,9998,0,9999,1
1715641226619,AIP 197,006,658671,Du; Songzi,9998,0,9999,1
1715641227649,ANAR 135S,A00,494369,Braswell; Geoffrey E.,0,0,0,0
1715641228675,BENG 196,001,628496,Engler; Adam J.,9998,0,9999,1
1715641228675,BENG 196,002,660916,Watson; John Thomas,9998,0,9999,1
1715641229702,BISP 197,001,650773,Wilhelm; James E.,9994,0,9999,5
1715641229702,BISP 197,002,658904,Coleman; Aaron B.,9998,0,9999,1
1715641230726,CAT 124RS,A01,519847,Geibel; William,0,0,20,20
1715641231754,CAT 125RS,A01,515971,Geibel; William,0,0,20,20
1715641232840,CLRE 250,A00,511389,Morris; Sheldon,9992,0,9999,7
1715641233866,CLRE 251,A00,507176,Mehta; Ravindra L.,9992,0,9999,7
1715641233866,CLRE 251,B00,511410,Mehta; Ravindra L.,9998,0,9999,1
1715641234896,CLRE 252,A00,507189,Cuomo; Raphael Eduardo,9994,0,9999,5
1715641235924,CLRE 253,A00,507199,Vaida; Florin,9994,0,9999,5
1715641235924,CLRE 253,B00,507202,Vaida; Florin,9999,0,9999,0
1715641236949,CLRE 259,A00,507211,Patel; Hemal,9996,0,9999,3
1715641237976,CLRE 260,A00,507221,Cuomo; Raphael Eduardo,9999,0,9999,0
1715641239003,CLRE 297,001,507242,Cuomo; Raphael Eduardo,9999,0,9999,0
1715641240031,COGS 197,001,638244,Voytek; Bradley Thomas,9997,0,9999,2
1715641241058,CSE 191,A00,516875,Minnes Kemp; Mor Mia,9991,0,9999,8
1715641242087,CSE 197,001,637388,Minnes Kemp; Mor Mia,9992,0,9999,7
1715641243114,CSS 201S,A01,494383,Mignozzetti; Umberto,35,0,35,0
1715641244140,CSS 202S,A01,494387,Mignozzetti; Umberto,35,0,35,0
1715641245165,DSC 197,001,628532,Eldridge; Justin Matthew,9995,0,9999,4
1715641246190,EAP 100,A00,516065,Staff,9799,0,9999,200
1715641247223,ECE 45,A01,507414,Staff,31,0,60,29
1715641249274,ECE 111,A01,507420,Staff,11,0,50,39
1715641250299,ECE 197,001,548057,Sievenpiper; Daniel F.,9991,0,9999,8
1715641251328,EDS 115,A00,507243,Choi; Bailey Miyeon,6,0,28,22
1715641252354,EDS 117,A01,494379,Staff,0,6,34,35
1715641253379,EDS 125,A00,507246,Hopkins; Megan Beth,7,0,30,23
1715641254408,EDS 128A,A01,507264,Fargason; Sharon Gayle,5,0,26,21
1715641255436,EDS 128B,A01,507293,Pappas; Elizabeth,9,0,30,21
1715641256462,EDS 139,A00,507294,Fargason; Sharon Gayle,9,0,30,21
1715641256462,EDS 139,B00,507313,Pappas; Elizabeth,9,0,30,21
1715641257487,EDS 201,A00,507315,Staff,10,0,30,20
1715641258516,EDS 203,A01,507317,Halter; Christopher P.,10,0,30,20
1715641259542,EDS 204R,A01,507319,Halter; Christopher P.,0,3,30,30
1715641259542,EDS 204R,B01,507331,Heinzman; Erica M.,14,0,30,16
1715641260576,EDS 206R,A00,507332,Staff,0,4,30,30
1715641260576,EDS 206R,B00,507343,Staff,15,0,30,15
1715641261607,EDS 250,A00,507344,Hemans; Patricia Ann Benitez,20,0,40,20
1715641262632,EDS 281,A00,507345,Daly; Alan J.,18,0,18,0
1715641263657,EDS 284,A00,507350,Daly; Alan J.,16,0,16,0
1715641264683,EDS 286,A00,507359,Fine; Sarah,18,0,18,0
1715641265708,EDS 289C,A01,507361,Daly; Alan J.,18,0,18,0
1715641266738,EDS 290,A00,507366,Hofstetter; Carolyn,15,0,15,0
1715641267769,LIGM 5A,A00,507421,Fischer-Grunski; Eva K,17,0,20,3
1715641268794,LIGM 5B,A00,507423,Fischer-Grunski; Eva K,19,0,20,1
1715641269818,LIGM 5C,A00,507425,Fischer-Grunski; Eva K,19,0,20,1
1715641270847,LIIT 5AS,A00,507427,Carnelos; Chiara,20,0,20,0
1715641271875,LIIT 5BS,A00,507430,Carnelos; Chiara,20,0,20,0
1715641272900,LIIT 5CS,A00,507432,Carnelos; Chiara,20,0,20,0
1715641273926,LISP 5A,A00,507541,Munoz Sanchez; Alicia,11,0,20,9
1715641274952,LISP 5B,A00,507671,Munoz Sanchez; Alicia,8,0,20,12
1715641275982,LISP 5C,A00,507696,Munoz Sanchez; Alicia,8,0,20,12
1715641277006,MAE 197,001,528363,Boechler; Nicholas Sebastia,9998,0,9999,1
1715641278032,MATH 197,001,523477,Kedlaya; Kiran S.,9994,0,9999,5
1715641278032,MATH 197,002,563811,Zhang; Danna,9994,0,9999,5
1715641278032,MATH 197,003,628552,Dumitriu; Ioana,9998,0,9999,1
1715641278032,MATH 197,004,660885,Floyd; Eric,9998,0,9999,1
1715641279056,MCWP 40R,A00,518780,Staff,1,0,20,19
1715641279056,MCWP 40R,B00,518781,Staff,10,0,20,10
1715641279056,MCWP 40R,C00,518783,Staff,5,0,20,15
1715641280085,MCWP 50R,A00,518791,Staff,0,1,20,20
1715641280085,MCWP 50R,B00,518792,Staff,0,2,20,20
1715641280085,MCWP 50R,C00,518793,Staff,0,4,20,20
1715641280085,MCWP 50R,D00,518794,Staff,0,1,20,20
1715641280085,MCWP 50R,E00,518795,Staff,0,2,20,20
1715641280085,MCWP 50R,F00,518796,Staff,0,1,20,20
1715641280085,MCWP 50R,G00,518797,Staff,0,1,20,20
1715641281110,MMW 12R,A01,514034,Herbst; Matthew,0,2,16,16
1715641281110,MMW 12R,A02,514035,Herbst; Matthew,0,0,16,16
1715641282139,MMW 13R,A01,514037,Staff,0,5,16,16
1715641282139,MMW 13R,A02,514039,Staff,0,5,16,16
1715641282139,MMW 13R,A03,628519,Staff,0,4,16,16
1715641284193,SIO 295LS,A00,523233,Staff,10,0,30,20
1715641285220,SIO 295S,A00,523232,Staff,10,0,30,20
1715641286256,SIOC 290S,A01,637330,Merrifield; Mark A,21,0,30,9
1715641287283,SIOC 291S,A01,637333,Gabriel; Corey John,21,0,30,9
1715641288310,SOCI 117,A01,494376,Staff,0,5,5,5
1715641289335,WES 237B,A00,494380,Staff,10,0,20,10
1715641291418,AESE 279B,A00,494370,Wade; Jon P,0,0,33,33
1715641292444,AIP 97,001,660915,Van Den Einde; Yael Dahlia,9998,0,9999,1
1715641293473,AIP 197,001,627712,Vespa; Emanuel Ignacio,9995,0,9999,4
1715641293473,AIP 197,002,650778,Amir; On,9998,0,9999,1
1715641293473,AIP 197,003,650933,Avenancio-Leon; Carlos,9998,0,9999,1
1715641293473,AIP 197,004,658530,Heyman; Gail D.,9998,0,9999,1
1715641293473,AIP 197,005,658631,Neal; Sonya E,9998,0,9999,1
1715641293473,AIP 197,006,658671,Du; Songzi,9998,0,9999,1
1715641294501,ANAR 135S,A00,494369,Braswell; Geoffrey E.,0,0,0,0
1715641295527,BENG 196,001,628496,Engler; Adam J.,9998,0,9999,1
1715641295527,BENG 196,002,660916,Watson; John Thomas,9998,0,9999,1
1715641296551,BISP 197,001,650773,Wilhelm; James E.,9994,0,9999,5
1715641296551,BISP 197,002,658904,Coleman; Aaron B.,9998,0,9999,1
1715641297576,CAT 124RS,A01,519847,Geibel; William,0,0,20,20
1715641298600,CAT 125RS,A01,515971,Geibel; William,0,0,20,20
1715641299639,CLRE 250,A00,511389,Morris; Sheldon,9992,0,9999,7
1715641300671,CLRE 251,A00,507176,Mehta; Ravindra L.,9992,0,9999,7
1715641300671,CLRE 251,B00,511410,Mehta; Ravindra L.,9998,0,9999,1
1715641301697,CLRE 252,A00,507189,Cuomo; Raphael Eduardo,9994,0,9999,5
1715641302726,CLRE 253,A00,507199,Vaida; Florin,9994,0,9999,5
1715641302726,CLRE 253,B00,507202,Vaida; Florin,9999,0,9999,0
1715641303753,CLRE 259,A00,507211,Patel; Hemal,9996,0,9999,3
1715641304778,CLRE 260,A00,507221,Cuomo; Raphael Eduardo,9999,0,9999,0
1715641305802,CLRE 297,001,507242,Cuomo; Raphael Eduardo,9999,0,9999,0
1715641306827,COGS 197,001,638244,Voytek; Bradley Thomas,9997,0,9999,2
1715641307852,CSE 191,A00,516875,Minnes Kemp; Mor Mia,9991,0,9999,8
1715641308876,CSE 197,001,637388,Minnes Kemp; Mor Mia,9992,0,9999,7
1715641309902,CSS 201S,A01,494383,Mignozzetti; Umberto,35,0,35,0
1715641310929,CSS 202S,A01,494387,Mignozzetti; Umberto,35,0,35,0
1715641311957,DSC 197,001,628532,Eldridge; Justin Matthew,9995,0,9999,4
1715641312980,EAP 100,A00,516065,Staff,9799,0,9999,200
1715641314007,ECE 45,A01,507414,Staff,31,0,60,29
1715641316056,ECE 111,A01,507420,Staff,11,0,50,39
1715641317081,ECE 197,001,548057,Sievenpiper; Daniel F.,9991,0,9999,8
1715641318106,EDS 115,A00,507243,Choi; Bailey Miyeon,6,0,28,22
1715641319132,EDS 117,A01,494379,Staff,0,6,34,35
1715641320157,EDS 125,A00,507246,Hopkins; Megan Beth,7,0,30,23
1715641321181,EDS 128A,A01,507264,Fargason; Sharon Gayle,5,0,26,21
1715641322206,EDS 128B,A01,507293,Pappas; Elizabeth,9,0,30,21
1715641323232,EDS 139,A00,507294,Fargason; Sharon Gayle,9,0,30,21
1715641323232,EDS 139,B00,507313,Pappas; Elizabeth,9,0,30,21
1715641324465,EDS 201,A00,507315,Staff,10,0,30,20
1715641325490,EDS 203,A01,507317,Halter; Christopher P.,10,0,30,20
1715641326516,EDS 204R,A01,507319,Halter; Christopher P.,0,3,30,30
1715641326516,EDS 204R,B01,507331,Heinzman; Erica M.,14,0,30,16
1715641327545,EDS 206R,A00,507332,Staff,0,4,30,30
1715641327545,EDS 206R,B00,507343,Staff,15,0,30,15
1715641328573,EDS 250,A00,507344,Hemans; Patricia Ann Benitez,20,0,40,20
1715641329598,EDS 281,A00,507345,Daly; Alan J.,18,0,18,0
1715641330623,EDS 284,A00,507350,Daly; Alan J.,16,0,16,0
1715641331649,EDS 286,A00,507359,Fine; Sarah,18,0,18,0
1715641332674,EDS 289C,A01,507361,Daly; Alan J.,18,0,18,0
1715641333702,EDS 290,A00,507366,Hofstetter; Carolyn,15,0,15,0
1715641334727,LIGM 5A,A00,507421,Fischer-Grunski; Eva K,17,0,20,3
1715641335759,LIGM 5B,A00,507423,Fischer-Grunski; Eva K,19,0,20,1
1715641336788,LIGM 5C,A00,507425,Fischer-Grunski; Eva K,19,0,20,1
1715641337813,LIIT 5AS,A00,507427,Carnelos; Chiara,20,0,20,0
1715641338839,LIIT 5BS,A00,507430,Carnelos; Chiara,20,0,20,0
1715641339865,LIIT 5CS,A00,507432,Carnelos; Chiara,20,0,20,0
1715641340893,LISP 5A,A00,507541,Munoz Sanchez; Alicia,11,0,20,9
1715641341918,LISP 5B,A00,507671,Munoz Sanchez; Alicia,8,0,20,12
1715641342942,LISP 5C,A00,507696,Munoz Sanchez; Alicia,8,0,20,12
1715641343971,MAE 197,001,528363,Boechler; Nicholas Sebastia,9998,0,9999,1
1715641345006,MATH 197,001,523477,Kedlaya; Kiran S.,9994,0,9999,5
1715641345006,MATH 197,002,563811,Zhang; Danna,9994,0,9999,5
1715641345006,MATH 197,003,628552,Dumitriu; Ioana,9998,0,9999,1
1715641345006,MATH 197,004,660885,Floyd; Eric,9998,0,9999,1
1715641346033,MCWP 40R,A00,518780,Staff,1,0,20,19
1715641346033,MCWP 40R,B00,518781,Staff,10,0,20,10
1715641346033,MCWP 40R,C00,518783,Staff,5,0,20,15
1715641347063,MCWP 50R,A00,518791,Staff,0,1,20,20
1715641347063,MCWP 50R,B00,518792,Staff,0,2,20,20
1715641347063,MCWP 50R,C00,518793,Staff,0,4,20,20
1715641347063,MCWP 50R,D00,518794,Staff,0,1,20,20
1715641347063,MCWP 50R,E00,518795,Staff,0,2,20,20
1715641347063,MCWP 50R,F00,518796,Staff,0,1,20,20
1715641347063,MCWP 50R,G00,518797,Staff,0,1,20,20
1715641348090,MMW 12R,A01,514034,Herbst; Matthew,0,2,16,16
1715641348090,MMW 12R,A02,514035,Herbst; Matthew,0,0,16,16
1715641349116,MMW 13R,A01,514037,Staff,0,5,16,16
1715641349116,MMW 13R,A02,514039,Staff,0,5,16,16
1715641349116,MMW 13R,A03,628519,Staff,0,4,16,16
1715641351169,SIO 295LS,A00,523233,Staff,10,0,30,20
1715641352196,SIO 295S,A00,523232,Staff,10,0,30,20
1715641353227,SIOC 290S,A01,637330,Merrifield; Mark A,21,0,30,9
1715641354256,SIOC 291S,A01,637333,Gabriel; Corey John,21,0,30,9
1715641355285,SOCI 117,A01,494376,Staff,0,5,5,5
1715641356311,WES 237B,A00,494380,Staff,10,0,20,10
1715641358400,AESE 279B,A00,494370,Wade; Jon P,0,0,33,33
1715641359425,AIP 97,001,660915,Van Den Einde; Yael Dahlia,9998,0,9999,1
1715641360452,AIP 197,001,627712,Vespa; Emanuel Ignacio,9995,0,9999,4
1715641360452,AIP 197,002,650778,Amir; On,9998,0,9999,1
1715641360452,AIP 197,003,650933,Avenancio-Leon; Carlos,9998,0,9999,1
1715641360452,AIP 197,004,658530,Heyman; Gail D.,9998,0,9999,1
1715641360452,AIP 197,005,658631,Neal; Sonya E,9998,0,9999,1
1715641360452,AIP 197,006,658671,Du; Songzi,9998,0,9999,1
1715641361477,ANAR 135S,A00,494369,Braswell; Geoffrey E.,0,0,0,0
1715641362503,BENG 196,001,628496,Engler; Adam J.,9998,0,9999,1
1715641362503,BENG 196,002,660916,Watson; John Thomas,9998,0,9999,1
1715641363542,BISP 197,001,650773,Wilhelm; James E.,9994,0,9999,5
1715641363542,BISP 197,002,658904,Coleman; Aaron B.,9998,0,9999,1
1715641364571,CAT 124RS,A01,519847,Geibel; William,0,0,20,20
1715641365598,CAT 125RS,A01,515971,Geibel; William,0,0,20,20
1715641366625,CLRE 250,A00,511389,Morris; Sheldon,9992,0,9999,7
1715641367651,CLRE 251,A00,507176,Mehta; Ravindra L.,9992,0,9999,7
1715641367651,CLRE 251,B00,511410,Mehta; Ravindra L.,9998,0,9999,1
1715641368677,CLRE 252,A00,507189,Cuomo; Raphael Eduardo,9994,0,9999,5
1715641369702,CLRE 253,A00,507199,Vaida; Florin,9994,0,9999,5
1715641369702,CLRE 253,B00,507202,Vaida; Florin,9999,0,9999,0
1715641370727,CLRE 259,A00,507211,Patel; Hemal,9996,0,9999,3
1715641371752,CLRE 260,A00,507221,Cuomo; Raphael Eduardo,9999,0,9999,0
1715641372777,CLRE 297,001,507242,Cuomo; Raphael Eduardo,9999,0,9999,0
1715641373802,COGS 197,001,638244,Voytek; Bradley Thomas,9997,0,9999,2
1715641374828,CSE 191,A00,516875,Minnes Kemp; Mor Mia,9991,0,9999,8
1715641375856,CSE 197,001,637388,Minnes Kemp; Mor Mia,9992,0,9999,7
1715641376882,CSS 201S,A01,494383,Mignozzetti; Umberto,35,0,35,0
1715641377911,CSS 202S,A01,494387,Mignozzetti; Umberto,35,0,35,0
1715641378938,DSC 197,001,628532,Eldridge; Justin Matthew,9995,0,9999,4
1715641379963,EAP 100,A00,516065,Staff,9799,0,9999,200
1715641380992,ECE 45,A01,507414,Staff,31,0,60,29
1715641383047,ECE 111,A01,507420,Staff,11,0,50,39
1715641384074,ECE 197,001,548057,Sievenpiper; Daniel F.,9991,0,9999,8
1715641385106,EDS 115,A00,507243,Choi; Bailey Miyeon,6,0,28,22
1715641386132,EDS 117,A01,494379,Staff,0,6,34,35
1715641387160,EDS 125,A00,507246,Hopkins; Megan Beth,7,0,30,23
1715641388186,EDS 128A,A01,507264,Fargason; Sharon Gayle,5,0,26,21
1715641389218,EDS 128B,A01,507293,Pappas; Elizabeth,9,0,30,21
1715641390247,EDS 139,A00,507294,Fargason; Sharon Gayle,9,0,30,21
1715641390247,EDS 139,B00,507313,Pappas; Elizabeth,9,0,30,21
1715641391273,EDS 201,A00,507315,Staff,10,0,30,20
1715641392303,EDS 203,A01,507317,Halter; Christopher P.,10,0,30,20
1715641393334,EDS 204R,A01,507319,Halter; Christopher P.,0,3,30,30
1715641393334,EDS 204R,B01,507331,Heinzman; Erica M.,14,0,30,16
1715641394358,EDS 206R,A00,507332,Staff,0,4,30,30
1715641394358,EDS 206R,B00,507343,Staff,15,0,30,15
1715641395384,EDS 250,A00,507344,Hemans; Patricia Ann Benitez,20,0,40,20
1715641396409,EDS 281,A00,507345,Daly; Alan J.,18,0,18,0
1715641397436,EDS 284,A00,507350,Daly; Alan J.,16,0,16,0
1715641398463,EDS 286,A00,507359,Fine; Sarah,18,0,18,0
1715641399492,EDS 289C,A01,507361,Daly; Alan J.,18,0,18,0
1715641400517,EDS 290,A00,507366,Hofstetter; Carolyn,15,0,15,0
1715641401544,LIGM 5A,A00,507421,Fischer-Grunski; Eva K,17,0,20,3
1715641402570,LIGM 5B,A00,507423,Fischer-Grunski; Eva K,19,0,20,1
1715641403594,LIGM 5C,A00,507425,Fischer-Grunski; Eva K,19,0,20,1
1715641404618,LIIT 5AS,A00,507427,Carnelos; Chiara,20,0,20,0
1715641405646,LIIT 5BS,A00,507430,Carnelos; Chiara,20,0,20,0
1715641406673,LIIT 5CS,A00,507432,Carnelos; Chiara,20,0,20,0
1715641407698,LISP 5A,A00,507541,Munoz Sanchez; Alicia,11,0,20,9
1715641408728,LISP 5B,A00,507671,Munoz Sanchez; Alicia,8,0,20,12
1715641409756,LISP 5C,A00,507696,Munoz Sanchez; Alicia,8,0,20,12
1715641410783,MAE 197,001,528363,Boechler; Nicholas Sebastia,9998,0,9999,1
1715641411811,MATH 197,001,523477,Kedlaya; Kiran S.,9994,0,9999,5
1715641411811,MATH 197,002,563811,Zhang; Danna,9994,0,9999,5
1715641411811,MATH 197,003,628552,Dumitriu; Ioana,9998,0,9999,1
1715641411811,MATH 197,004,660885,Floyd; Eric,9998,0,9999,1
1715641412836,MCWP 40R,A00,518780,Staff,1,0,20,19
1715641412836,MCWP 40R,B00,518781,Staff,10,0,20,10
1715641412836,MCWP 40R,C00,518783,Staff,5,0,20,15
1715641413865,MCWP 50R,A00,518791,Staff,0,1,20,20
1715641413865,MCWP 50R,B00,518792,Staff,0,2,20,20
1715641413865,MCWP 50R,C00,518793,Staff,0,4,20,20
1715641413865,MCWP 50R,D00,518794,Staff,0,1,20,20
1715641413865,MCWP 50R,E00,518795,Staff,0,2,20,20
1715641413865,MCWP 50R,F00,518796,Staff,0,1,20,20
1715641413865,MCWP 50R,G00,518797,Staff,0,1,20,20
1715641414890,MMW 12R,A01,514034,Herbst; Matthew,0,2,16,16
1715641414890,MMW 12R,A02,514035,Herbst; Matthew,0,0,16,16
1715641415915,MMW 13R,A01,514037,Staff,0,5,16,16
1715641415915,MMW 13R,A02,514039,Staff,0,5,16,16
1715641415915,MMW 13R,A03,628519,Staff,0,4,16,16
1715641418010,SIO 295LS,A00,523233,Staff,10,0,30,20
1715641419035,SIO 295S,A00,523232,Staff,10,0,30,20
1715641420067,SIOC 290S,A01,637330,Merrifield; Mark A,21,0,30,9
1715641421096,SIOC 291S,A01,637333,Gabriel; Corey John,21,0,30,9
1715641422123,SOCI 117,A01,494376,Staff,0,5,5,5
1715641423151,WES 237B,A00,494380,Staff,10,0,20,10
1715641425232,AESE 279B,A00,494370,Wade; Jon P,0,0,33,33
1715641426260,AIP 97,001,660915,Van Den Einde; Yael Dahlia,9998,0,9999,1
1715641427293,AIP 197,001,627712,Vespa; Emanuel Ignacio,9995,0,9999,4
1715641427293,AIP 197,002,650778,Amir; On,9998,0,9999,1
1715641427293,AIP 197,003,650933,Avenancio-Leon; Carlos,9998,0,9999,1
1715641427293,AIP 197,004,658530,Heyman; Gail D.,9998,0,9999,1
1715641427293,AIP 197,005,658631,Neal; Sonya E,9998,0,9999,1
1715641427293,AIP 197,006,658671,Du; Songzi,9998,0,9999,1
1715641428322,ANAR 135S,A00,494369,Braswell; Geoffrey E.,0,0,0,0
1715641429348,BENG 196,001,628496,Engler; Adam J.,9998,0,9999,1
1715641429348,BENG 196,002,660916,Watson; John Thomas,9998,0,9999,1
1715641430374,BISP 197,001,650773,Wilhelm; James E.,9994,0,9999,5
1715641430374,BISP 197,002,658904,Coleman; Aaron B.,9998,0,9999,1
1715641431405,CAT 124RS,A01,519847,Geibel; William,0,0,20,20
1715641432430,CAT 125RS,A01,515971,Geibel; William,0,0,20,20
1715641433461,CLRE 250,A00,511389,Morris; Sheldon,9992,0,9999,7
1715641434488,CLRE 251,A00,507176,Mehta; Ravindra L.,9992,0,9999,7
1715641434488,CLRE 251,B00,511410,Mehta; Ravindra L.,9998,0,9999,1
1715641435517,CLRE 252,A00,507189,Cuomo; Raphael Eduardo,9994,0,9999,5
1715641436544,CLRE 253,A00,507199,Vaida; Florin,9994,0,9999,5
1715641436544,CLRE 253,B00,507202,Vaida; Florin,9999,0,9999,0
1715641437571,CLRE 259,A00,507211,Patel; Hemal,9996,0,9999,3
1715641438596,CLRE 260,A00,507221,Cuomo; Raphael Eduardo,9999,0,9999,0
1715641439623,CLRE 297,001,507242,Cuomo; Raphael Eduardo,9999,0,9999,0
1715641440652,COGS 197,001,638244,Voytek; Bradley Thomas,9997,0,9999,2
1715641441687,CSE 191,A00,516875,Minnes Kemp; Mor Mia,9991,0,9999,8
1715641442715,CSE 197,001,637388,Minnes Kemp; Mor Mia,9992,0,9999,7
1715641443742,CSS 201S,A01,494383,Mignozzetti; Umberto,35,0,35,0
1715641444772,CSS 202S,A01,494387,Mignozzetti; Umberto,35,0,35,0
1715641445798,DSC 197,001,628532,Eldridge; Justin Matthew,9995,0,9999,4
1715641446824,EAP 100,A00,516065,Staff,9799,0,9999,200
1715641447850,ECE 45,A01,507414,Staff,31,0,60,29
1715641449905,ECE 111,A01,507420,Staff,11,0,50,39
1715641450929,ECE 197,001,548057,Sievenpiper; Daniel F.,9991,0,9999,8
1715641451956,EDS 115,A00,507243,Choi; Bailey Miyeon,6,0,28,22
1715641452981,EDS 117,A01,494379,Staff,0,6,34,35
1715641454007,EDS 125,A00,507246,Hopkins; Megan Beth,7,0,30,23
1715641455032,EDS 128A,A01,507264,Fargason; Sharon Gayle,5,0,26,21
1715641456059,EDS 128B,A01,507293,Pappas; Elizabeth,9,0,30,21
1715641457086,EDS 139,A00,507294,Fargason; Sharon Gayle,9,0,30,21
1715641457086,EDS 139,B00,507313,Pappas; Elizabeth,9,0,30,21
1715641458110,EDS 201,A00,507315,Staff,10,0,30,20
1715641459138,EDS 203,A01,507317,Halter; Christopher P.,10,0,30,20
1715641460166,EDS 204R,A01,507319,Halter; Christopher P.,0,3,30,30
1715641460166,EDS 204R,B01,507331,Heinzman; Erica M.,14,0,30,16
1715641461192,EDS 206R,A00,507332,Staff,0,4,30,30
1715641461192,EDS 206R,B00,507343,Staff,15,0,30,15
1715641462220,EDS 250,A00,507344,Hemans; Patricia Ann Benitez,20,0,40,20
1715641463249,EDS 281,A00,507345,Daly; Alan J.,18,0,18,0
1715641464276,EDS 284,A00,507350,Daly; Alan J.,16,0,16,0
1715641465305,EDS 286,A00,507359,Fine; Sarah,18,0,18,0
1715641466330,EDS 289C,A01,507361,Daly; Alan J.,18,0,18,0
1715641467356,EDS 290,A00,507366,Hofstetter; Carolyn,15,0,15,0
1715641468382,LIGM 5A,A00,507421,Fischer-Grunski; Eva K,17,0,20,3
1715641469412,LIGM 5B,A00,507423,Fischer-Grunski; Eva K,19,0,20,1
1715641470439,LIGM 5C,A00,507425,Fischer-Grunski; Eva K,19,0,20,1
1715641471470,LIIT 5AS,A00,507427,Carnelos; Chiara,20,0,20,0
1715641472497,LIIT 5BS,A00,507430,Carnelos; Chiara,20,0,20,0
1715641473525,LIIT 5CS,A00,507432,Carnelos; Chiara,20,0,20,0
1715641474551,LISP 5A,A00,507541,Munoz Sanchez; Alicia,11,0,20,9
1715641475581,LISP 5B,A00,507671,Munoz Sanchez; Alicia,8,0,20,12
1715641476610,LISP 5C,A00,507696,Munoz Sanchez; Alicia,8,0,20,12
1715641477637,MAE 197,001,528363,Boechler; Nicholas Sebastia,9998,0,9999,1
1715641478670,MATH 197,001,523477,Kedlaya; Kiran S.,9994,0,9999,5
1715641478670,MATH 197,002,563811,Zhang; Danna,9994,0,9999,5
1715641478670,MATH 197,003,628552,Dumitriu; Ioana,9998,0,9999,1
1715641478670,MATH 197,004,660885,Floyd; Eric,9998,0,9999,1
1715641479696,MCWP 40R,A00,518780,Staff,1,0,20,19
1715641479696,MCWP 40R,B00,518781,Staff,10,0,20,10
1715641479696,MCWP 40R,C00,518783,Staff,5,0,20,15
1715641480721,MCWP 50R,A00,518791,Staff,0,1,20,20
1715641480721,MCWP 50R,B00,518792,Staff,0,2,20,20
1715641480721,MCWP 50R,C00,518793,Staff,0,4,20,20
1715641480721,MCWP 50R,D00,518794,Staff,0,1,20,20
1715641480721,MCWP 50R,E00,518795,Staff,0,2,20,20
1715641480721,MCWP 50R,F00,518796,Staff,0,1,20,20
1715641480721,MCWP 50R,G00,518797,Staff,0,1,20,20
1715641481747,MMW 12R,A01,514034,Herbst; Matthew,0,2,16,16
1715641481747,MMW 12R,A02,514035,Herbst; Matthew,0,0,16,16
1715641482775,MMW 13R,A01,514037,Staff,0,5,16,16
1715641482775,MMW 13R,A02,514039,Staff,0,5,16,16
1715641482775,MMW 13R,A03,628519,Staff,0,4,16,16
1715641484827,SIO 295LS,A00,523233,Staff,10,0,30,20
1715641485856,SIO 295S,A00,523232,Staff,10,0,30,20
1715641486886,SIOC 290S,A01,637330,Merrifield; Mark A,21,0,30,9
1715641487912,SIOC 291S,A01,637333,Gabriel; Corey John,21,0,30,9
1715641488937,SOCI 117,A01,494376,Staff,0,5,5,5
1715641489964,WES 237B,A00,494380,Staff,10,0,20,10
1715641492040,AESE 279B,A00,494370,Wade; Jon P,0,0,33,33
1715641493064,AIP 97,001,660915,Van Den Einde; Yael Dahlia,9998,0,9999,1
1715641494092,AIP 197,001,627712,Vespa; Emanuel Ignacio,9995,0,9999,4
1715641494092,AIP 197,002,650778,Amir; On,9998,0,9999,1
1715641494092,AIP 197,003,650933,Avenancio-Leon; Carlos,9998,0,9999,1
1715641494092,AIP 197,004,658530,Heyman; Gail D.,9998,0,9999,1
1715641494092,AIP 197,005,658631,Neal; Sonya E,9998,0,9999,1
1715641494092,AIP 197,006,658671,Du; Songzi,9998,0,9999,1
1715641495117,ANAR 135S,A00,494369,Braswell; Geoffrey E.,0,0,0,0
1715641496144,BENG 196,001,628496,Engler; Adam J.,9998,0,9999,1
1715641496144,BENG 196,002,660916,Watson; John Thomas,9998,0,9999,1
1715641497171,BISP 197,001,650773,Wilhelm; James E.,9994,0,9999,5
1715641497171,BISP 197,002,658904,Coleman; Aaron B.,9998,0,9999,1
1715641498199,CAT 124RS,A01,519847,Geibel; William,0,0,20,20
1715641499225,CAT 125RS,A01,515971,Geibel; William,0,0,20,20
1715641500250,CLRE 250,A00,511389,Morris; Sheldon,9992,0,9999,7
1715641501276,CLRE 251,A00,507176,Mehta; Ravindra L.,9992,0,9999,7
1715641501276,CLRE 251,B00,511410,Mehta; Ravindra L.,9998,0,9999,1
1715641502303,CLRE 252,A00,507189,Cuomo; Raphael Eduardo,9994,0,9999,5
1715641503332,CLRE 253,A00,507199,Vaida; Florin,9994,0,9999,5
1715641503332,CLRE 253,B00,507202,Vaida; Florin,9999,0,9999,0
1715641504357,CLRE 259,A00,507211,Patel; Hemal,9996,0,9999,3
1715641505385,CLRE 260,A00,507221,Cuomo; Raphael Eduardo,9999,0,9999,0
1715641506409,CLRE 297,001,507242,Cuomo; Raphael Eduardo,9999,0,9999,0
1715641507438,COGS 197,001,638244,Voytek; Bradley Thomas,9997,0,9999,2
1715641508464,CSE 191,A00,516875,Minnes Kemp; Mor Mia,9991,0,9999,8
1715641509490,CSE 197,001,637388,Minnes Kemp; Mor Mia,9992,0,9999,7
1715641510520,CSS 201S,A01,494383,Mignozzetti; Umberto,35,0,35,0
1715641511552,CSS 202S,A01,494387,Mignozzetti; Umberto,35,0,35,0
1715641512578,DSC 197,001,628532,Eldridge; Justin Matthew,9995,0,9999,4
1715641513604,EAP 100,A00,516065,Staff,9799,0,9999,200
1715641514638,ECE 45,A01,507414,Staff,31,0,60,29
1715641516694,ECE 111,A01,507420,Staff,11,0,50,39
1715641517721,ECE 197,001,548057,Sievenpiper; Daniel F.,9991,0,9999,8
1715641518748,EDS 115,A00,507243,Choi; Bailey Miyeon,6,0,28,22
1715641519772,EDS 117,A01,494379,Staff,0,6,34,35
1715641520799,EDS 125,A00,507246,Hopkins; Megan Beth,7,0,30,23
1715641521829,EDS 128A,A01,507264,Fargason; Sharon Gayle,5,0,26,21
1715641522854,EDS 128B,A01,507293,Pappas; Elizabeth,9,0,30,21
1715641523882,EDS 139,A00,507294,Fargason; Sharon Gayle,9,0,30,21
1715641523882,EDS 139,B00,507313,Pappas; Elizabeth,9,0,30,21
1715641524907,EDS 201,A00,507315,Staff,10,0,30,20
1715641525932,EDS 203,A01,507317,Halter; Christopher P.,10,0,30,20
1715641526962,EDS 204R,A01,507319,Halter; Christopher P.,0,3,30,30
1715641526962,EDS 204R,B01,507331,Heinzman; Erica M.,14,0,30,16
1715641527988,EDS 206R,A00,507332,Staff,0,4,30,30
1715641527988,EDS 206R,B00,507343,Staff,15,0,30,15
1715641529014,EDS 250,A00,507344,Hemans; Patricia Ann Benitez,20,0,40,20
1715641530040,EDS 281,A00,507345,Daly; Alan J.,18,0,18,0
1715641531067,EDS 284,A00,507350,Daly; Alan J.,16,0,16,0
1715641532093,EDS 286,A00,507359,Fine; Sarah,18,0,18,0
1715641533121,EDS 289C,A01,507361,Daly; Alan J.,18,0,18,0
1715641534146,EDS 290,A00,507366,Hofstetter; Carolyn,15,0,15,0
1715641535173,LIGM 5A,A00,507421,Fischer-Grunski; Eva K,17,0,20,3
1715641536198,LIGM 5B,A00,507423,Fischer-Grunski; Eva K,19,0,20,1
1715641537229,LIGM 5C,A00,507425,Fischer-Grunski; Eva K,19,0,20,1
1715641538258,LIIT 5AS,A00,507427,Carnelos; Chiara,20,0,20,0
1715641539283,LIIT 5BS,A00,507430,Carnelos; Chiara,20,0,20,0
1715641540309,LIIT 5CS,A00,507432,Carnelos; Chiara,20,0,20,0
1715641541339,LISP 5A,A00,507541,Munoz Sanchez; Alicia,11,0,20,9
1715641542364,LISP 5B,A00,507671,Munoz Sanchez; Alicia,8,0,20,12
1715641543390,LISP 5C,A00,507696,Munoz Sanchez; Alicia,8,0,20,12
1715641544418,MAE 197,001,528363,Boechler; Nicholas Sebastia,9998,0,9999,1
1715641545445,MATH 197,001,523477,Kedlaya; Kiran S.,9994,0,9999,5
1715641545445,MATH 197,002,563811,Zhang; Danna,9994,0,9999,5
1715641545445,MATH 197,003,628552,Dumitriu; Ioana,9998,0,9999,1
1715641545445,MATH 197,004,660885,Floyd; Eric,9998,0,9999,1
1715641546472,MCWP 40R,A00,518780,Staff,1,0,20,19
1715641546472,MCWP 40R,B00,518781,Staff,10,0,20,10
1715641546472,MCWP 40R,C00,518783,Staff,5,0,20,15
1715641547503,MCWP 50R,A00,518791,Staff,0,1,20,20
1715641547503,MCWP 50R,B00,518792,Staff,0,2,20,20
1715641547503,MCWP 50R,C00,518793,Staff,0,4,20,20
1715641547503,MCWP 50R,D00,518794,Staff,0,1,20,20
1715641547503,MCWP 50R,E00,518795,Staff,0,2,20,20
1715641547503,MCWP 50R,F00,518796,Staff,0,1,20,20
1715641547503,MCWP 50R,G00,518797,Staff,0,1,20,20
1715641548532,MMW 12R,A01,514034,Herbst; Matthew,0,2,16,16
1715641548532,MMW 12R,A02,514035,Herbst; Matthew,0,0,16,16
1715641549558,MMW 13R,A01,514037,Staff,0,5,16,16
1715641549558,MMW 13R,A02,514039,Staff,0,5,16,16
1715641549558,MMW 13R,A03,628519,Staff,0,4,16,16
1715641551613,SIO 295LS,A00,523233,Staff,10,0,30,20
1715641552640,SIO 295S,A00,523232,Staff,10,0,30,20
1715641553670,SIOC 290S,A01,637330,Merrifield; Mark A,21,0,30,9
1715641554696,SIOC 291S,A01,637333,Gabriel; Corey John,21,0,30,9
1715641555723,SOCI 117,A01,494376,Staff,0,5,5,5
1715641556747,WES 237B,A00,494380,Staff,10,0,20,10
1715641558815,AESE 279B,A00,494370,Wade; Jon P,0,0,33,33
1715641559841,AIP 97,001,660915,Van Den Einde; Yael Dahlia,9998,0,9999,1
1715641560870,AIP 197,001,627712,Vespa; Emanuel Ignacio,9995,0,9999,4
1715641560870,AIP 197,002,650778,Amir; On,9998,0,9999,1
1715641560870,AIP 197,003,650933,Avenancio-Leon; Carlos,9998,0,9999,1
1715641560870,AIP 197,004,658530,Heyman; Gail D.,9998,0,9999,1
1715641560870,AIP 197,005,658631,Neal; Sonya E,9998,0,9999,1
1715641560870,AIP 197,006,658671,Du; Songzi,9998,0,9999,1
1715641561899,ANAR 135S,A00,494369,Braswell; Geoffrey E.,0,0,0,0
1715641562924,BENG 196,001,628496,Engler; Adam J.,9998,0,9999,1
1715641562924,BENG 196,002,660916,Watson; John Thomas,9998,0,9999,1
1715641563951,BISP 197,001,650773,Wilhelm; James E.,9994,0,9999,5
1715641563951,BISP 197,002,658904,Coleman; Aaron B.,9998,0,9999,1
1715641564976,CAT 124RS,A01,519847,Geibel; William,0,0,20,20
1715641566002,CAT 125RS,A01,515971,Geibel; William,0,0,20,20
1715641567028,CLRE 250,A00,511389,Morris; Sheldon,9992,0,9999,7
1715641568056,CLRE 251,A00,507176,Mehta; Ravindra L.,9992,0,9999,7
1715641568056,CLRE 251,B00,511410,Mehta; Ravindra L.,9998,0,9999,1
1715641569086,CLRE 252,A00,507189,Cuomo; Raphael Eduardo,9994,0,9999,5
1715641570116,CLRE 253,A00,507199,Vaida; Florin,9994,0,9999,5
1715641570116,CLRE 253,B00,507202,Vaida; Florin,9999,0,9999,0
1715641571146,CLRE 259,A00,507211,Patel; Hemal,9996,0,9999,3
1715641572170,CLRE 260,A00,507221,Cuomo; Raphael Eduardo,9999,0,9999,0
1715641573196,CLRE 297,001,507242,Cuomo; Raphael Eduardo,9999,0,9999,0
1715641574222,COGS 197,001,638244,Voytek; Bradley Thomas,9997,0,9999,2
1715641575249,CSE 191,A00,516875,Minnes Kemp; Mor Mia,9991,0,9999,8
1715641576279,CSE 197,001,637388,Minnes Kemp; Mor Mia,9992,0,9999,7
1715641577304,CSS 201S,A01,494383,Mignozzetti; Umberto,35,0,35,0
1715641578334,CSS 202S,A01,494387,Mignozzetti; Umberto,35,0,35,0
1715641579362,DSC 197,001,628532,Eldridge; Justin Matthew,9995,0,9999,4
1715641580387,EAP 100,A00,516065,Staff,9799,0,9999,200
1715641581417,ECE 45,A01,507414,Staff,31,0,60,29
1715641583471,ECE 111,A01,507420,Staff,11,0,50,39
1715641584500,ECE 197,001,548057,Sievenpiper; Daniel F.,9991,0,9999,8
1715641585529,EDS 115,A00,507243,Choi; Bailey Miyeon,6,0,28,22
1715641586559,EDS 117,A01,494379,Staff,0,6,34,35
1715641587589,EDS 125,A00,507246,Hopkins; Megan Beth,7,0,30,23
1715641588616,EDS 128A,A01,507264,Fargason; Sharon Gayle,5,0,26,21
1715641589641,EDS 128B,A01,507293,Pappas; Elizabeth,9,0,30,21
1715641590671,EDS 139,A00,507294,Fargason; Sharon Gayle,9,0,30,21
1715641590671,EDS 139,B00,507313,Pappas; Elizabeth,9,0,30,21
1715641591699,EDS 201,A00,507315,Staff,10,0,30,20
1715641592729,EDS 203,A01,507317,Halter; Christopher P.,10,0,30,20
1715641593759,EDS 204R,A01,507319,Halter; Christopher P.,0,3,30,30
1715641593759,EDS 204R,B01,507331,Heinzman; Erica M.,14,0,30,16
1715641594786,EDS 206R,A00,507332,Staff,0,4,30,30
1715641594786,EDS 206R,B00,507343,Staff,15,0,30,15
1715641595814,EDS 250,A00,507344,Hemans; Patricia Ann Benitez,20,0,40,20
1715641596842,EDS 281,A00,507345,Daly; Alan J.,18,0,18,0
1715641597867,EDS 284,A00,507350,Daly; Alan J.,16,0,16,0
1715641598895,EDS 286,A00,507359,Fine; Sarah,18,0,18,0
1715641599920,EDS 289C,A01,507361,Daly; Alan J.,18,0,18,0
1715641600945,EDS 290,A00,507366,Hofstetter; Carolyn,15,0,15,0
1715641601977,LIGM 5A,A00,507421,Fischer-Grunski; Eva K,17,0,20,3
1715641603005,LIGM 5B,A00,507423,Fischer-Grunski; Eva K,19,0,20,1
1715641604030,LIGM 5C,A00,507425,Fischer-Grunski; Eva K,19,0,20,1
1715641605061,LIIT 5AS,A00,507427,Carnelos; Chiara,20,0,20,0
1715641606088,LIIT 5BS,A00,507430,Carnelos; Chiara,20,0,20,0
1715641607116,LIIT 5CS,A00,507432,Carnelos; Chiara,20,0,20,0
1715641608143,LISP 5A,A00,507541,Munoz Sanchez; Alicia,11,0,20,9
1715641609172,LISP 5B,A00,507671,Munoz Sanchez; Alicia,8,0,20,12
1715641610198,LISP 5C,A00,507696,Munoz Sanchez; Alicia,8,0,20,12
1715641611222,MAE 197,001,528363,Boechler; Nicholas Sebastia,9998,0,9999,1
1715641612251,MATH 197,001,523477,Kedlaya; Kiran S.,9994,0,9999,5
1715641612251,MATH 197,002,563811,Zhang; Danna,9994,0,9999,5
1715641612251,MATH 197,003,628552,Dumitriu; Ioana,9998,0,9999,1
1715641612251,MATH 197,004,660885,Floyd; Eric,9998,0,9999,1
1715641613280,MCWP 40R,A00,518780,Staff,1,0,20,19
1715641613280,MCWP 40R,B00,518781,Staff,10,0,20,10
1715641613280,MCWP 40R,C00,518783,Staff,5,0,20,15
1715641614309,MCWP 50R,A00,518791,Staff,0,1,20,20
1715641614309,MCWP 50R,B00,518792,Staff,0,2,20,20
1715641614309,MCWP 50R,C00,518793,Staff,0,4,20,20
1715641614309,MCWP 50R,D00,518794,Staff,0,1,20,20
1715641614309,MCWP 50R,E00,518795,Staff,0,2,20,20
1715641614309,MCWP 50R,F00,518796,Staff,0,1,20,20
1715641614309,MCWP 50R,G00,518797,Staff,0,1,20,20
1715641615338,MMW 12R,A01,514034,Herbst; Matthew,0,2,16,16
1715641615338,MMW 12R,A02,514035,Herbst; Matthew,0,0,16,16
1715641616362,MMW 13R,A01,514037,Staff,0,5,16,16
1715641616362,MMW 13R,A02,514039,Staff,0,5,16,16
1715641616362,MMW 13R,A03,628519,Staff,0,4,16,16
1715641618414,SIO 295LS,A00,523233,Staff,10,0,30,20
1715641619439,SIO 295S,A00,523232,Staff,10,0,30,20
1715641620471,SIOC 290S,A01,637330,Merrifield; Mark A,21,0,30,9
1715641621496,SIOC 291S,A01,637333,Gabriel; Corey John,21,0,30,9
1715641622523,SOCI 117,A01,494376,Staff,0,5,5,5
1715641623550,WES 237B,A00,494380,Staff,10,0,20,10
1715641625620,AESE 279B,A00,494370,Wade; Jon P,0,0,33,33
1715641626650,AIP 97,001,660915,Van Den Einde; Yael Dahlia,9998,0,9999,1
1715641627682,AIP 197,001,627712,Vespa; Emanuel Ignacio,9995,0,9999,4
1715641627682,AIP 197,002,650778,Amir; On,9998,0,9999,1
1715641627682,AIP 197,003,650933,Avenancio-Leon; Carlos,9998,0,9999,1
1715641627682,AIP 197,004,658530,Heyman; Gail D.,9998,0,9999,1
1715641627682,AIP 197,005,658631,Neal; Sonya E,9998,0,9999,1
1715641627682,AIP 197,006,658671,Du; Songzi,9998,0,9999,1
1715641628708,ANAR 135S,A00,494369,Braswell; Geoffrey E.,0,0,0,0
1715641629733,BENG 196,001,628496,Engler; Adam J.,9998,0,9999,1
1715641629733,BENG 196,002,660916,Watson; John Thomas,9998,0,9999,1
1715641630758,BISP 197,001,650773,Wilhelm; James E.,9994,0,9999,5
1715641630758,BISP 197,002,658904,Coleman; Aaron B.,9998,0,9999,1
1715641631787,CAT 124RS,A01,519847,Geibel; William,0,0,20,20
1715641632812,CAT 125RS,A01,515971,Geibel; William,0,0,20,20
1715641633837,CLRE 250,A00,511389,Morris; Sheldon,9992,0,9999,7
1715641634866,CLRE 251,A00,507176,Mehta; Ravindra L.,9992,0,9999,7
1715641634866,CLRE 251,B00,511410,Mehta; Ravindra L.,9998,0,9999,1
1715641635892,CLRE 252,A00,507189,Cuomo; Raphael Eduardo,9994,0,9999,5
1715641636920,CLRE 253,A00,507199,Vaida; Florin,9994,0,9999,5
1715641636920,CLRE 253,B00,507202,Vaida; Florin,9999,0,9999,0
1715641637949,CLRE 259,A00,507211,Patel; Hemal,9996,0,9999,3
1715641638976,CLRE 260,A00,507221,Cuomo; Raphael Eduardo,9999,0,9999,0
1715641640000,CLRE 297,001,507242,Cuomo; Raphael Eduardo,9999,0,9999,0
1715641641024,COGS 197,001,638244,Voytek; Bradley Thomas,9997,0,9999,2
1715641642050,CSE 191,A00,516875,Minnes Kemp; Mor Mia,9991,0,9999,8
1715641643075,CSE 197,001,637388,Minnes Kemp; Mor Mia,9992,0,9999,7
1715641644101,CSS 201S,A01,494383,Mignozzetti; Umberto,35,0,35,0
1715641645131,CSS 202S,A01,494387,Mignozzetti; Umberto,35,0,35,0
1715641646157,DSC 197,001,628532,Eldridge; Justin Matthew,9995,0,9999,4
1715641647182,EAP 100,A00,516065,Staff,9799,0,9999,200
1715641648210,ECE 45,A01,507414,Staff,31,0,60,29
1715641650271,ECE 111,A01,507420,Staff,11,0,50,39
1715641651298,ECE 197,001,548057,Sievenpiper; Daniel F.,9991,0,9999,8
1715641652329,EDS 115,A00,507243,Choi; Bailey Miyeon,6,0,28,22
1715641653358,EDS 117,A01,494379,Staff,0,6,34,35
1715641654384,EDS 125,A00,507246,Hopkins; Megan Beth,7,0,30,23
1715641655412,EDS 128A,A01,507264,Fargason; Sharon Gayle,5,0,26,21
1715641656443,EDS 128B,A01,507293,Pappas; Elizabeth,9,0,30,21
1715641657470,EDS 139,A00,507294,Fargason; Sharon Gayle,9,0,30,21
1715641657470,EDS 139,B00,507313,Pappas; Elizabeth,9,0,30,21
1715641658494,EDS 201,A00,507315,Staff,10,0,30,20
1715641659520,EDS 203,A01,507317,Halter; Christopher P.,10,0,30,20
1715641660545,EDS 204R,A01,507319,Halter; Christopher P.,0,3,30,30
1715641660545,EDS 204R,B01,507331,Heinzman; Erica M.,14,0,30,16
1715641661572,EDS 206R,A00,507332,Staff,0,4,30,30
1715641661572,EDS 206R,B00,507343,Staff,15,0,30,15
1715641662600,EDS 250,A00,507344,Hemans; Patricia Ann Benitez,20,0,40,20
1715641663627,EDS 281,A00,507345,Daly; Alan J.,18,0,18,0
1715641664653,EDS 284,A00,507350,Daly; Alan J.,16,0,16,0
1715641665685,EDS 286,A00,507359,Fine; Sarah,18,0,18,0
1715641666710,EDS 289C,A01,507361,Daly; Alan J.,18,0,18,0
1715641667736,EDS 290,A00,507366,Hofstetter; Carolyn,15,0,15,0
1715641668766,LIGM 5A,A00,507421,Fischer-Grunski; Eva K,17,0,20,3
1715641669789,LIGM 5B,A00,507423,Fischer-Grunski; Eva K,19,0,20,1
1715641670815,LIGM 5C,A00,507425,Fischer-Grunski; Eva K,19,0,20,1
1715641671845,LIIT 5AS,A00,507427,Carnelos; Chiara,20,0,20,0
1715641672875,LIIT 5BS,A00,507430,Carnelos; Chiara,20,0,20,0
1715641673905,LIIT 5CS,A00,507432,Carnelos; Chiara,20,0,20,0
1715641674936,LISP 5A,A00,507541,Munoz Sanchez; Alicia,11,0,20,9
1715641675966,LISP 5B,A00,507671,Munoz Sanchez; Alicia,8,0,20,12
1715641676993,LISP 5C,A00,507696,Munoz Sanchez; Alicia,8,0,20,12
1715641678020,MAE 197,001,528363,Boechler; Nicholas Sebastia,9998,0,9999,1
1715641679046,MATH 197,001,523477,Kedlaya; Kiran S.,9994,0,9999,5
1715641679046,MATH 197,002,563811,Zhang; Danna,9994,0,9999,5
1715641679046,MATH 197,003,628552,Dumitriu; Ioana,9998,0,9999,1
1715641679046,MATH 197,004,660885,Floyd; Eric,9998,0,9999,1
1715641680075,MCWP 40R,A00,518780,Staff,1,0,20,19
1715641680075,MCWP 40R,B00,518781,Staff,10,0,20,10
1715641680075,MCWP 40R,C00,518783,Staff,5,0,20,15
1715641681100,MCWP 50R,A00,518791,Staff,0,1,20,20
1715641681100,MCWP 50R,B00,518792,Staff,0,2,20,20
1715641681100,MCWP 50R,C00,518793,Staff,0,4,20,20
1715641681100,MCWP 50R,D00,518794,Staff,0,1,20,20
1715641681100,MCWP 50R,E00,518795,Staff,0,2,20,20
1715641681100,MCWP 50R,F00,518796,Staff,0,1,20,20
1715641681100,MCWP 50R,G00,518797,Staff,0,1,20,20
1715641682126,MMW 12R,A01,514034,Herbst; Matthew,0,2,16,16
1715641682126,MMW 12R,A02,514035,Herbst; Matthew,0,0,16,16
1715641683152,MMW 13R,A01,514037,Staff,0,5,16,16
1715641683152,MMW 13R,A02,514039,Staff,0,5,16,16
1715641683152,MMW 13R,A03,628519,Staff,0,4,16,16
1715641685207,SIO 295LS,A00,523233,Staff,10,0,30,20
1715641686236,SIO 295S,A00,523232,Staff,10,0,30,20
1715641687268,SIOC 290S,A01,637330,Merrifield; Mark A,21,0,30,9
1715641688296,SIOC 291S,A01,637333,Gabriel; Corey John,21,0,30,9
1715641689325,SOCI 117,A01,494376,Staff,0,5,5,5
1715641690352,WES 237B,A00,494380,Staff,10,0,20,10
1715641692425,AESE 279B,A00,494370,Wade; Jon P,0,0,33,33
1715641693450,AIP 97,001,660915,Van Den Einde; Yael Dahlia,9998,0,9999,1
1715641694479,AIP 197,001,627712,Vespa; Emanuel Ignacio,9995,0,9999,4
1715641694479,AIP 197,002,650778,Amir; On,9998,0,9999,1
1715641694479,AIP 197,003,650933,Avenancio-Leon; Carlos,9998,0,9999,1
1715641694479,AIP 197,004,658530,Heyman; Gail D.,9998,0,9999,1
1715641694479,AIP 197,005,658631,Neal; Sonya E,9998,0,9999,1
1715641694479,AIP 197,006,658671,Du; Songzi,9998,0,9999,1
1715641695503,ANAR 135S,A00,494369,Braswell; Geoffrey E.,0,0,0,0
1715641696534,BENG 196,001,628496,Engler; Adam J.,9998,0,9999,1
1715641696534,BENG 196,002,660916,Watson; John Thomas,9998,0,9999,1
1715641697559,BISP 197,001,650773,Wilhelm; James E.,9994,0,9999,5
1715641697559,BISP 197,002,658904,Coleman; Aaron B.,9998,0,9999,1
1715641698586,CAT 124RS,A01,519847,Geibel; William,0,0,20,20
1715641699612,CAT 125RS,A01,515971,Geibel; William,0,0,20,20
1715641700637,CLRE 250,A00,511389,Morris; Sheldon,9992,0,9999,7
1715641701667,CLRE 251,A00,507176,Mehta; Ravindra L.,9992,0,9999,7
1715641701667,CLRE 251,B00,511410,Mehta; Ravindra L.,9998,0,9999,1
1715641702692,CLRE 252,A00,507189,Cuomo; Raphael Eduardo,9994,0,9999,5
1715641703718,CLRE 253,A00,507199,Vaida; Florin,9994,0,9999,5
1715641703718,CLRE 253,B00,507202,Vaida; Florin,9999,0,9999,0
1715641704744,CLRE 259,A00,507211,Patel; Hemal,9996,0,9999,3
1715641705771,CLRE 260,A00,507221,Cuomo; Raphael Eduardo,9999,0,9999,0
1715641706796,CLRE 297,001,507242,Cuomo; Raphael Eduardo,9999,0,9999,0
1715641707822,COGS 197,001,638244,Voytek; Bradley Thomas,9997,0,9999,2
1715641708848,CSE 191,A00,516875,Minnes Kemp; Mor Mia,9991,0,9999,8
1715641709872,CSE 197,001,637388,Minnes Kemp; Mor Mia,9992,0,9999,7
1715641710903,CSS 201S,A01,494383,Mignozzetti; Umberto,35,0,35,0
1715641711932,CSS 202S,A01,494387,Mignozzetti; Umberto,35,0,35,0
1715641712960,DSC 197,001,628532,Eldridge; Justin Matthew,9995,0,9999,4
1715641713985,EAP 100,A00,516065,Staff,9799,0,9999,200
1715641715011,ECE 45,A01,507414,Staff,31,0,60,29
1715641717063,ECE 111,A01,507420,Staff,11,0,50,39
1715641718087,ECE 197,001,548057,Sievenpiper; Daniel F.,9991,0,9999,8
1715641719117,EDS 115,A00,507243,Choi; Bailey Miyeon,6,0,28,22
1715641720144,EDS 117,A01,494379,Staff,0,6,34,35
1715641721169,EDS 125,A00,507246,Hopkins; Megan Beth,7,0,30,23
1715641722195,EDS 128A,A01,507264,Fargason; Sharon Gayle,5,0,26,21
1715641723221,EDS 128B,A01,507293,Pappas; Elizabeth,9,0,30,21
1715641724245,EDS 139,A00,507294,Fargason; Sharon Gayle,9,0,30,21
1715641724245,EDS 139,B00,507313,Pappas; Elizabeth,9,0,30,21
1715641725271,EDS 201,A00,507315,Staff,10,0,30,20
1715641726296,EDS 203,A01,507317,Halter; Christopher P.,10,0,30,20
1715641727321,EDS 204R,A01,507319,Halter; Christopher P.,0,3,30,30
1715641727321,EDS 204R,B01,507331,Heinzman; Erica M.,14,0,30,16
1715641728348,EDS 206R,A00,507332,Staff,0,4,30,30
1715641728348,EDS 206R,B00,507343,Staff,15,0,30,15
1715641729376,EDS 250,A00,507344,Hemans; Patricia Ann Benitez,20,0,40,20
1715641730401,EDS 281,A00,507345,Daly; Alan J.,18,0,18,0
1715641731432,EDS 284,A00,507350,Daly; Alan J.,16,0,16,0
1715641732461,EDS 286,A00,507359,Fine; Sarah,18,0,18,0
1715641733489,EDS 289C,A01,507361,Daly; Alan J.,18,0,18,0
1715641734517,EDS 290,A00,507366,Hofstetter; Carolyn,15,0,15,0
1715641735544,LIGM 5A,A00,507421,Fischer-Grunski; Eva K,17,0,20,3
1715641736574,LIGM 5B,A00,507423,Fischer-Grunski; Eva K,19,0,20,1
1715641737600,LIGM 5C,A00,507425,Fischer-Grunski; Eva K,19,0,20,1
1715641738627,LIIT 5AS,A00,507427,Carnelos; Chiara,20,0,20,0
1715641739656,LIIT 5BS,A00,507430,Carnelos; Chiara,20,0,20,0
1715641740689,LIIT 5CS,A00,507432,Carnelos; Chiara,20,0,20,0
1715641741730,LISP 5A,A00,507541,Munoz Sanchez; Alicia,11,0,20,9
1715641742755,LISP 5B,A00,507671,Munoz Sanchez; Alicia,8,0,20,12
1715641743784,LISP 5C,A00,507696,Munoz Sanchez; Alicia,8,0,20,12
1715641744815,MAE 197,001,528363,Boechler; Nicholas Sebastia,9998,0,9999,1
1715641745846,MATH 197,001,523477,Kedlaya; Kiran S.,9994,0,9999,5
1715641745846,MATH 197,002,563811,Zhang; Danna,9994,0,9999,5
1715641745846,MATH 197,003,628552,Dumitriu; Ioana,9998,0,9999,1
1715641745846,MATH 197,004,660885,Floyd; Eric,9998,0,9999,1
1715641746871,MCWP 40R,A00,518780,Staff,1,0,20,19
1715641746871,MCWP 40R,B00,518781,Staff,10,0,20,10
1715641746871,MCWP 40R,C00,518783,Staff,5,0,20,15
1715641747901,MCWP 50R,A00,518791,Staff,0,1,20,20
1715641747901,MCWP 50R,B00,518792,Staff,0,2,20,20
1715641747901,MCWP 50R,C00,518793,Staff,0,4,20,20
1715641747901,MCWP 50R,D00,518794,Staff,0,1,20,20
1715641747901,MCWP 50R,E00,518795,Staff,0,2,20,20
1715641747901,MCWP 50R,F00,518796,Staff,0,1,20,20
1715641747901,MCWP 50R,G00,518797,Staff,0,1,20,20
1715641748925,MMW 12R,A01,514034,Herbst; Matthew,0,2,16,16
1715641748925,MMW 12R,A02,514035,Herbst; Matthew,0,0,16,16
1715641749951,MMW 13R,A01,514037,Staff,0,5,16,16
1715641749951,MMW 13R,A02,514039,Staff,0,5,16,16
1715641749951,MMW 13R,A03,628519,Staff,0,4,16,16
1715641752005,SIO 295LS,A00,523233,Staff,10,0,30,20
1715641753032,SIO 295S,A00,523232,Staff,10,0,30,20
1715641754062,SIOC 290S,A01,637330,Merrifield; Mark A,21,0,30,9
1715641755089,SIOC 291S,A01,637333,Gabriel; Corey John,21,0,30,9
1715641756115,SOCI 117,A01,494376,Staff,0,5,5,5
1715641757142,WES 237B,A00,494380,Staff,10,0,20,10
1715641759212,AESE 279B,A00,494370,Wade; Jon P,0,0,33,33
1715641760239,AIP 97,001,660915,Van Den Einde; Yael Dahlia,9998,0,9999,1
1715641761269,AIP 197,001,627712,Vespa; Emanuel Ignacio,9995,0,9999,4
1715641761269,AIP 197,002,650778,Amir; On,9998,0,9999,1
1715641761269,AIP 197,003,650933,Avenancio-Leon; Carlos,9998,0,9999,1
1715641761269,AIP 197,004,658530,Heyman; Gail D.,9998,0,9999,1
1715641761269,AIP 197,005,658631,Neal; Sonya E,9998,0,9999,1
1715641761269,AIP 197,006,658671,Du; Songzi,9998,0,9999,1
1715641762293,ANAR 135S,A00,494369,Braswell; Geoffrey E.,0,0,0,0
1715641763322,BENG 196,001,628496,Engler; Adam J.,9998,0,9999,1
1715641763322,BENG 196,002,660916,Watson; John Thomas,9998,0,9999,1
1715641764347,BISP 197,001,650773,Wilhelm; James E.,9994,0,9999,5
1715641764347,BISP 197,002,658904,Coleman; Aaron B.,9998,0,9999,1
1715641765376,CAT 124RS,A01,519847,Geibel; William,0,0,20,20
1715641766401,CAT 125RS,A01,515971,Geibel; William,0,0,20,20
1715641767425,CLRE 250,A00,511389,Morris; Sheldon,9992,0,9999,7
1715641768456,CLRE 251,A00,507176,Mehta; Ravindra L.,9992,0,9999,7
1715641768456,CLRE 251,B00,511410,Mehta; Ravindra L.,9998,0,9999,1
1715641769481,CLRE 252,A00,507189,Cuomo; Raphael Eduardo,9994,0,9999,5
1715641770508,CLRE 253,A00,507199,Vaida; Florin,9994,0,9999,5
1715641770508,CLRE 253,B00,507202,Vaida; Florin,9999,0,9999,0
1715641771533,CLRE 259,A00,507211,Patel; Hemal,9996,0,9999,3
1715641772557,CLRE 260,A00,507221,Cuomo; Raphael Eduardo,9999,0,9999,0
1715641773581,CLRE 297,001,507242,Cuomo; Raphael Eduardo,9999,0,9999,0
1715641774607,COGS 197,001,638244,Voytek; Bradley Thomas,9997,0,9999,2
1715641775635,CSE 191,A00,516875,Minnes Kemp; Mor Mia,9991,0,9999,8
1715641776657,CSE 197,001,637388,Minnes Kemp; Mor Mia,9992,0,9999,7
1715641777681,CSS 201S,A01,494383,Mignozzetti; Umberto,35,0,35,0
1715641778709,CSS 202S,A01,494387,Mignozzetti; Umberto,35,0,35,0
1715641779733,DSC 197,001,628532,Eldridge; Justin Matthew,9995,0,9999,4
1715641780757,EAP 100,A00,516065,Staff,9799,0,9999,200
1715641781784,ECE 45,A01,507414,Staff,31,0,60,29
1715641783840,ECE 111,A01,507420,Staff,11,0,50,39
1715641784868,ECE 197,001,548057,Sievenpiper; Daniel F.,9991,0,9999,8
1715641785897,EDS 115,A00,507243,Choi; Bailey Miyeon,6,0,28,22
1715641786941,EDS 117,A01,494379,Staff,0,6,34,35
1715641787965,EDS 125,A00,507246,Hopkins; Megan Beth,7,0,30,23
1715641788994,EDS 128A,A01,507264,Fargason; Sharon Gayle,5,0,26,21
1715641790024,EDS 128B,A01,507293,Pappas; Elizabeth,9,0,30,21
1715641791051,EDS 139,A00,507294,Fargason; Sharon Gayle,9,0,30,21
1715641791051,EDS 139,B00,507313,Pappas; Elizabeth,9,0,30,21
1715641792074,EDS 201,A00,507315,Staff,10,0,30,20
1715641793103,EDS 203,A01,507317,Halter; Christopher P.,10,0,30,20
1715641794130,EDS 204R,A01,507319,Halter; Christopher P.,0,3,30,30
1715641794130,EDS 204R,B01,507331,Heinzman; Erica M.,14,0,30,16
1715641795154,EDS 206R,A00,507332,Staff,0,4,30,30
1715641795154,EDS 206R,B00,507343,Staff,15,0,30,15
1715641796179,EDS 250,A00,507344,Hemans; Patricia Ann Benitez,20,0,40,20
1715641797203,EDS 281,A00,507345,Daly; Alan J.,18,0,18,0
1715641798226,EDS 284,A00,507350,Daly; Alan J.,16,0,16,0
1715641799252,EDS 286,A00,507359,Fine; Sarah,18,0,18,0
1715641800280,EDS 289C,A01,507361,Daly; Alan J.,18,0,18,0
1715641801305,EDS 290,A00,507366,Hofstetter; Carolyn,15,0,15,0
1715641802353,LIGM 5A,A00,507421,Fischer-Grunski; Eva K,17,0,20,3
1715641803378,LIGM 5B,A00,507423,Fischer-Grunski; Eva K,19,0,20,1
1715641804402,LIGM 5C,A00,507425,Fischer-Grunski; Eva K,19,0,20,1
1715641805432,LIIT 5AS,A00,507427,Carnelos; Chiara,20,0,20,0
1715641806461,LIIT 5BS,A00,507430,Carnelos; Chiara,20,0,20,0
1715641807486,LIIT 5CS,A00,507432,Carnelos; Chiara,20,0,20,0
1715641808515,LISP 5A,A00,507541,Munoz Sanchez; Alicia,11,0,20,9
1715641809548,LISP 5B,A00,507671,Munoz Sanchez; Alicia,8,0,20,12
1715641810573,LISP 5C,A00,507696,Munoz Sanchez; Alicia,8,0,20,12
1715641811598,MAE 197,001,528363,Boechler; Nicholas Sebastia,9998,0,9999,1
1715641812625,MATH 197,001,523477,Kedlaya; Kiran S.,9994,0,9999,5
1715641812625,MATH 197,002,563811,Zhang; Danna,9994,0,9999,5
1715641812625,MATH 197,003,628552,Dumitriu; Ioana,9998,0,9999,1
1715641812625,MATH 197,004,660885,Floyd; Eric,9998,0,9999,1
1715641813656,MCWP 40R,A00,518780,Staff,1,0,20,19
1715641813656,MCWP 40R,B00,518781,Staff,10,0,20,10
1715641813656,MCWP 40R,C00,518783,Staff,5,0,20,15
1715641814681,MCWP 50R,A00,518791,Staff,0,1,20,20
1715641814681,MCWP 50R,B00,518792,Staff,0,2,20,20
1715641814681,MCWP 50R,C00,518793,Staff,0,4,20,20
1715641814681,MCWP 50R,D00,518794,Staff,0,1,20,20
1715641814681,MCWP 50R,E00,518795,Staff,0,2,20,20
1715641814681,MCWP 50R,F00,518796,Staff,0,1,20,20
1715641814681,MCWP 50R,G00,518797,Staff,0,1,20,20
1715641815712,MMW 12R,A01,514034,Herbst; Matthew,0,2,16,16
1715641815712,MMW 12R,A02,514035,Herbst; Matthew,0,0,16,16
1715641816740,MMW 13R,A01,514037,Staff,0,5,16,16
1715641816740,MMW 13R,A02,514039,Staff,0,5,16,16
1715641816740,MMW 13R,A03,628519,Staff,0,4,16,16
1715641818794,SIO 295LS,A00,523233,Staff,10,0,30,20
1715641819817,SIO 295S,A00,523232,Staff,10,0,30,20
1715641820848,SIOC 290S,A01,637330,Merrifield; Mark A,21,0,30,9
1715641821872,SIOC 291S,A01,637333,Gabriel; Corey John,21,0,30,9
1715641822903,SOCI 117,A01,494376,Staff,0,5,5,5
1715641823942,WES 237B,A00,494380,Staff,10,0,20,10
1715641826010,AESE 279B,A00,494370,Wade; Jon P,0,0,33,33
1715641827036,AIP 97,001,660915,Van Den Einde; Yael Dahlia,9998,0,9999,1
1715641828060,AIP 197,001,627712,Vespa; Emanuel Ignacio,9995,0,9999,4
1715641828060,AIP 197,002,650778,Amir; On,9998,0,9999,1
1715641828060,AIP 197,003,650933,Avenancio-Leon; Carlos,9998,0,9999,1
1715641828060,AIP 197,004,658530,Heyman; Gail D.,9998,0,9999,1
1715641828060,AIP 197,005,658631,Neal; Sonya E,9998,0,9999,1
1715641828060,AIP 197,006,658671,Du; Songzi,9998,0,9999,1
1715641829090,ANAR 135S,A00,494369,Braswell; Geoffrey E.,0,0,0,0
1715641830120,BENG 196,001,628496,Engler; Adam J.,9998,0,9999,1
1715641830120,BENG 196,002,660916,Watson; John Thomas,9998,0,9999,1
1715641831144,BISP 197,001,650773,Wilhelm; James E.,9994,0,9999,5
1715641831144,BISP 197,002,658904,Coleman; Aaron B.,9998,0,9999,1
1715641832173,CAT 124RS,A01,519847,Geibel; William,0,0,20,20
1715641833197,CAT 125RS,A01,515971,Geibel; William,0,0,20,20
1715641834222,CLRE 250,A00,511389,Morris; Sheldon,9992,0,9999,7
1715641835252,CLRE 251,A00,507176,Mehta; Ravindra L.,9992,0,9999,7
1715641835252,CLRE 251,B00,511410,Mehta; Ravindra L.,9998,0,9999,1
1715641836277,CLRE 252,A00,507189,Cuomo; Raphael Eduardo,9994,0,9999,5
1715641837306,CLRE 253,A00,507199,Vaida; Florin,9994,0,9999,5
1715641837306,CLRE 253,B00,507202,Vaida; Florin,9999,0,9999,0
1715641838331,CLRE 259,A00,507211,Patel; Hemal,9996,0,9999,3
1715641839357,CLRE 260,A00,507221,Cuomo; Raphael Eduardo,9999,0,9999,0
1715641840382,CLRE 297,001,507242,Cuomo; Raphael Eduardo,9999,0,9999,0
1715641841407,COGS 197,001,638244,Voytek; Bradley Thomas,9997,0,9999,2
1715641842432,CSE 191,A00,516875,Minnes Kemp; Mor Mia,9991,0,9999,8
1715641843457,CSE 197,001,637388,Minnes Kemp; Mor Mia,9992,0,9999,7
1715641844511,CSS 201S,A01,494383,Mignozzetti; Umberto,35,0,35,0
1715641845536,CSS 202S,A01,494387,Mignozzetti; Umberto,35,0,35,0
1715641846561,DSC 197,001,628532,Eldridge; Justin Matthew,9995,0,9999,4
1715641847587,EAP 100,A00,516065,Staff,9799,0,9999,200
1715641848613,ECE 45,A01,507414,Staff,31,0,60,29
1715641850671,ECE 111,A01,507420,Staff,11,0,50,39
1715641851697,ECE 197,001,548057,Sievenpiper; Daniel F.,9991,0,9999,8
1715641852723,EDS 115,A00,507243,Choi; Bailey Miyeon,6,0,28,22
1715641853749,EDS 117,A01,494379,Staff,0,6,34,35
1715641854775,EDS 125,A00,507246,Hopkins; Megan Beth,7,0,30,23
1715641855803,EDS 128A,A01,507264,Fargason; Sharon Gayle,5,0,26,21
1715641856831,EDS 128B,A01,507293,Pappas; Elizabeth,9,0,30,21
1715641857857,EDS 139,A00,507294,Fargason; Sharon Gayle,9,0,30,21
1715641857857,EDS 139,B00,507313,Pappas; Elizabeth,9,0,30,21
1715641858881,EDS 201,A00,507315,Staff,10,0,30,20
1715641859907,EDS 203,A01,507317,Halter; Christopher P.,10,0,30,20
1715641860935,EDS 204R,A01,507319,Halter; Christopher P.,0,3,30,30
1715641860935,EDS 204R,B01,507331,Heinzman; Erica M.,14,0,30,16
1715641861960,EDS 206R,A00,507332,Staff,0,4,30,30
1715641861960,EDS 206R,B00,507343,Staff,15,0,30,15
1715641862987,EDS 250,A00,507344,Hemans; Patricia Ann Benitez,20,0,40,20
1715641864011,EDS 281,A00,507345,Daly; Alan J.,18,0,18,0
1715641865038,EDS 284,A00,507350,Daly; Alan J.,16,0,16,0
1715641866064,EDS 286,A00,507359,Fine; Sarah,18,0,18,0
1715641867092,EDS 289C,A01,507361,Daly; Alan J.,18,0,18,0
1715641868121,EDS 290,A00,507366,Hofstetter; Carolyn,15,0,15,0
1715641869147,LIGM 5A,A00,507421,Fischer-Grunski; Eva K,17,0,20,3
1715641870176,LIGM 5B,A00,507423,Fischer-Grunski; Eva K,19,0,20,1
1715641871203,LIGM 5C,A00,507425,Fischer-Grunski; Eva K,19,0,20,1
1715641872228,LIIT 5AS,A00,507427,Carnelos; Chiara,20,0,20,0
1715641873258,LIIT 5BS,A00,507430,Carnelos; Chiara,20,0,20,0
1715641874283,LIIT 5CS,A00,507432,Carnelos; Chiara,20,0,20,0
1715641875309,LISP 5A,A00,507541,Munoz Sanchez; Alicia,11,0,20,9
1715641876336,LISP 5B,A00,507671,Munoz Sanchez; Alicia,8,0,20,12
1715641877362,LISP 5C,A00,507696,Munoz Sanchez; Alicia,8,0,20,12
1715641878391,MAE 197,001,528363,Boechler; Nicholas Sebastia,9998,0,9999,1
1715641879428,MATH 197,001,523477,Kedlaya; Kiran S.,9994,0,9999,5
1715641879428,MATH 197,002,563811,Zhang; Danna,9994,0,9999,5
1715641879428,MATH 197,003,628552,Dumitriu; Ioana,9998,0,9999,1
1715641879428,MATH 197,004,660885,Floyd; Eric,9998,0,9999,1
1715641880459,MCWP 40R,A00,518780,Staff,1,0,20,19
1715641880459,MCWP 40R,B00,518781,Staff,10,0,20,10
1715641880459,MCWP 40R,C00,518783,Staff,5,0,20,15
1715641881539,MCWP 50R,A00,518791,Staff,0,1,20,20
1715641881539,MCWP 50R,B00,518792,Staff,0,2,20,20
1715641881539,MCWP 50R,C00,518793,Staff,0,4,20,20
1715641881539,MCWP 50R,D00,518794,Staff,0,1,20,20
1715641881539,MCWP 50R,E00,518795,Staff,0,2,20,20
1715641881539,MCWP 50R,F00,518796,Staff,0,1,20,20
1715641881539,MCWP 50R,G00,518797,Staff,0,1,20,20
1715641882569,MMW 12R,A01,514034,Herbst; Matthew,0,2,16,16
1715641882569,MMW 12R,A02,514035,Herbst; Matthew,0,0,16,16
1715641883597,MMW 13R,A01,514037,Staff,0,5,16,16
1715641883597,MMW 13R,A02,514039,Staff,0,5,16,16
1715641883597,MMW 13R,A03,628519,Staff,0,4,16,16
1715641885652,SIO 295LS,A00,523233,Staff,10,0,30,20
1715641886676,SIO 295S,A00,523232,Staff,10,0,30,20
1715641887706,SIOC 290S,A01,637330,Merrifield; Mark A,21,0,30,9
1715641888736,SIOC 291S,A01,637333,Gabriel; Corey John,21,0,30,9
1715641889760,SOCI 117,A01,494376,Staff,0,5,5,5
1715641890785,WES 237B,A00,494380,Staff,10,0,20,10
1715641892866,AESE 279B,A00,494370,Wade; Jon P,0,0,33,33
1715641893904,AIP 97,001,660915,Van Den Einde; Yael Dahlia,9998,0,9999,1
1715641894931,AIP 197,001,627712,Vespa; Emanuel Ignacio,9995,0,9999,4
1715641894931,AIP 197,002,650778,Amir; On,9998,0,9999,1
1715641894931,AIP 197,003,650933,Avenancio-Leon; Carlos,9998,0,9999,1
1715641894931,AIP 197,004,658530,Heyman; Gail D.,9998,0,9999,1
1715641894931,AIP 197,005,658631,Neal; Sonya E,9998,0,9999,1
1715641894931,AIP 197,006,658671,Du; Songzi,9998,0,9999,1
1715641895956,ANAR 135S,A00,494369,Braswell; Geoffrey E.,0,0,0,0
1715641896982,BENG 196,001,628496,Engler; Adam J.,9998,0,9999,1
1715641896982,BENG 196,002,660916,Watson; John Thomas,9998,0,9999,1
1715641898009,BISP 197,001,650773,Wilhelm; James E.,9994,0,9999,5
1715641898009,BISP 197,002,658904,Coleman; Aaron B.,9998,0,9999,1
1715641899037,CAT 124RS,A01,519847,Geibel; William,0,0,20,20
1715641900062,CAT 125RS,A01,515971,Geibel; William,0,0,20,20
1715641901088,CLRE 250,A00,511389,Morris; Sheldon,9992,0,9999,7
1715641902119,CLRE 251,A00,507176,Mehta; Ravindra L.,9992,0,9999,7
1715641902119,CLRE 251,B00,511410,Mehta; Ravindra L.,9998,0,9999,1
1715641903147,CLRE 252,A00,507189,Cuomo; Raphael Eduardo,9994,0,9999,5
1715641904174,CLRE 253,A00,507199,Vaida; Florin,9994,0,9999,5
1715641904174,CLRE 253,B00,507202,Vaida; Florin,9999,0,9999,0
1715641905200,CLRE 259,A00,507211,Patel; Hemal,9996,0,9999,3
1715641906228,CLRE 260,A00,507221,Cuomo; Raphael Eduardo,9999,0,9999,0
1715641907252,CLRE 297,001,507242,Cuomo; Raphael Eduardo,9999,0,9999,0
1715641908277,COGS 197,001,638244,Voytek; Bradley Thomas,9997,0,9999,2
1715641909304,CSE 191,A00,516875,Minnes Kemp; Mor Mia,9991,0,9999,8
1715641910332,CSE 197,001,637388,Minnes Kemp; Mor Mia,9992,0,9999,7
1715641911357,CSS 201S,A01,494383,Mignozzetti; Umberto,35,0,35,0
1715641912381,CSS 202S,A01,494387,Mignozzetti; Umberto,35,0,35,0
1715641913410,DSC 197,001,628532,Eldridge; Justin Matthew,9995,0,9999,4
1715641914438,EAP 100,A00,516065,Staff,9799,0,9999,200
1715641915469,ECE 45,A01,507414,Staff,31,0,60,29
1715641917522,ECE 111,A01,507420,Staff,11,0,50,39
1715641918547,ECE 197,001,548057,Sievenpiper; Daniel F.,9991,0,9999,8
1715641919571,EDS 115,A00,507243,Choi; Bailey Miyeon,6,0,28,22
1715641920598,EDS 117,A01,494379,Staff,0,6,34,35
1715641921625,EDS 125,A00,507246,Hopkins; Megan Beth,7,0,30,23
1715641922649,EDS 128A,A01,507264,Fargason; Sharon Gayle,5,0,26,21
1715641923680,EDS 128B,A01,507293,Pappas; Elizabeth,9,0,30,21
1715641924710,EDS 139,A00,507294,Fargason; Sharon Gayle,9,0,30,21
1715641924710,EDS 139,B00,507313,Pappas; Elizabeth,9,0,30,21
1715641925739,EDS 201,A00,507315,Staff,10,0,30,20
1715641926768,EDS 203,A01,507317,Halter; Christopher P.,10,0,30,20
1715641927793,EDS 204R,A01,507319,Halter; Christopher P.,0,3,30,30
1715641927793,EDS 204R,B01,507331,Heinzman; Erica M.,14,0,30,16
1715641928822,EDS 206R,A00,507332,Staff,0,4,30,30
1715641928822,EDS 206R,B00,507343,Staff,15,0,30,15
1715641929851,EDS 250,A00,507344,Hemans; Patricia Ann Benitez,20,0,40,20
1715641930875,EDS 281,A00,507345,Daly; Alan J.,18,0,18,0
1715641931903,EDS 284,A00,507350,Daly; Alan J.,16,0,16,0
1715641932927,EDS 286,A00,507359,Fine; Sarah,18,0,18,0
1715641933950,EDS 289C,A01,507361,Daly; Alan J.,18,0,18,0
1715641934979,EDS 290,A00,507366,Hofstetter; Carolyn,15,0,15,0
1715641936004,LIGM 5A,A00,507421,Fischer-Grunski; Eva K,17,0,20,3
1715641937031,LIGM 5B,A00,507423,Fischer-Grunski; Eva K,19,0,20,1
1715641938055,LIGM 5C,A00,507425,Fischer-Grunski; Eva K,19,0,20,1
1715641939080,LIIT 5AS,A00,507427,Carnelos; Chiara,20,0,20,0
1715641940112,LIIT 5BS,A00,507430,Carnelos; Chiara,20,0,20,0
1715641941139,LIIT 5CS,A00,507432,Carnelos; Chiara,20,0,20,0
1715641942168,LISP 5A,A00,507541,Munoz Sanchez; Alicia,11,0,20,9
1715641943192,LISP 5B,A00,507671,Munoz Sanchez; Alicia,8,0,20,12
1715641944217,LISP 5C,A00,507696,Munoz Sanchez; Alicia,8,0,20,12
1715641945242,MAE 197,001,528363,Boechler; Nicholas Sebastia,9998,0,9999,1
1715641946270,MATH 197,001,523477,Kedlaya; Kiran S.,9994,0,9999,5
1715641946270,MATH 197,002,563811,Zhang; Danna,9994,0,9999,5
1715641946270,MATH 197,003,628552,Dumitriu; Ioana,9998,0,9999,1
1715641946270,MATH 197,004,660885,Floyd; Eric,9998,0,9999,1
1715641947297,MCWP 40R,A00,518780,Staff,1,0,20,19
1715641947297,MCWP 40R,B00,518781,Staff,10,0,20,10
1715641947297,MCWP 40R,C00,518783,Staff,5,0,20,15
1715641948322,MCWP 50R,A00,518791,Staff,0,1,20,20
1715641948322,MCWP 50R,B00,518792,Staff,0,2,20,20
1715641948322,MCWP 50R,C00,518793,Staff,0,4,20,20
1715641948322,MCWP 50R,D00,518794,Staff,0,1,20,20
1715641948322,MCWP 50R,E00,518795,Staff,0,2,20,20
1715641948322,MCWP 50R,F00,518796,Staff,0,1,20,20
1715641948322,MCWP 50R,G00,518797,Staff,0,1,20,20
1715641949373,MMW 12R,A01,514034,Herbst; Matthew,0,2,16,16
1715641949373,MMW 12R,A02,514035,Herbst; Matthew,0,0,16,16
1715641950400,MMW 13R,A01,514037,Staff,0,5,16,16
1715641950400,MMW 13R,A02,514039,Staff,0,5,16,16
1715641950400,MMW 13R,A03,628519,Staff,0,4,16,16
1715641952451,SIO 295LS,A00,523233,Staff,10,0,30,20
1715641953480,SIO 295S,A00,523232,Staff,10,0,30,20
1715641954508,SIOC 290S,A01,637330,Merrifield; Mark A,21,0,30,9
1715641955532,SIOC 291S,A01,637333,Gabriel; Corey John,21,0,30,9
1715641956558,SOCI 117,A01,494376,Staff,0,5,5,5
1715641957581,WES 237B,A00,494380,Staff,10,0,20,10
1715641959665,AESE 279B,A00,494370,Wade; Jon P,0,0,33,33
1715641960689,AIP 97,001,660915,Van Den Einde; Yael Dahlia,9998,0,9999,1
1715641961721,AIP 197,001,627712,Vespa; Emanuel Ignacio,9995,0,9999,4
1715641961721,AIP 197,002,650778,Amir; On,9998,0,9999,1
1715641961721,AIP 197,003,650933,Avenancio-Leon; Carlos,9998,0,9999,1
1715641961721,AIP 197,004,658530,Heyman; Gail D.,9998,0,9999,1
1715641961721,AIP 197,005,658631,Neal; Sonya E,9998,0,9999,1
1715641961721,AIP 197,006,658671,Du; Songzi,9998,0,9999,1
1715641962749,ANAR 135S,A00,494369,Braswell; Geoffrey E.,0,0,0,0
1715641963774,BENG 196,001,628496,Engler; Adam J.,9998,0,9999,1
1715641963774,BENG 196,002,660916,Watson; John Thomas,9998,0,9999,1
1715641964801,BISP 197,001,650773,Wilhelm; James E.,9994,0,9999,5
1715641964801,BISP 197,002,658904,Coleman; Aaron B.,9998,0,9999,1
1715641965828,CAT 124RS,A01,519847,Geibel; William,0,0,20,20
1715641966854,CAT 125RS,A01,515971,Geibel; William,0,0,20,20
1715641967880,CLRE 250,A00,511389,Morris; Sheldon,9992,0,9999,7
1715641968906,CLRE 251,A00,507176,Mehta; Ravindra L.,9992,0,9999,7
1715641968906,CLRE 251,B00,511410,Mehta; Ravindra L.,9998,0,9999,1
1715641969931,CLRE 252,A00,507189,Cuomo; Raphael Eduardo,9994,0,9999,5
1715641970956,CLRE 253,A00,507199,Vaida; Florin,9994,0,9999,5
1715641970956,CLRE 253,B00,507202,Vaida; Florin,9999,0,9999,0
1715641971984,CLRE 259,A00,507211,Patel; Hemal,9996,0,9999,3
1715641973009,CLRE 260,A00,507221,Cuomo; Raphael Eduardo,9999,0,9999,0
1715641974033,CLRE 297,001,507242,Cuomo; Raphael Eduardo,9999,0,9999,0
1715641975059,COGS 197,001,638244,Voytek; Bradley Thomas,9997,0,9999,2
1715641976087,CSE 191,A00,516875,Minnes Kemp; Mor Mia,9991,0,9999,8
1715641977112,CSE 197,001,637388,Minnes Kemp; Mor Mia,9992,0,9999,7
1715641978137,CSS 201S,A01,494383,Mignozzetti; Umberto,35,0,35,0
1715641979164,CSS 202S,A01,494387,Mignozzetti; Umberto,35,0,35,0
1715641980189,DSC 197,001,628532,Eldridge; Justin Matthew,9995,0,9999,4
1715641981215,EAP 100,A00,516065,Staff,9799,0,9999,200
1715641982241,ECE 45,A01,507414,Staff,31,0,60,29
1715641984305,ECE 111,A01,507420,Staff,11,0,50,39
1715641985335,ECE 197,001,548057,Sievenpiper; Daniel F.,9991,0,9999,8
1715641986365,EDS 115,A00,507243,Choi; Bailey Miyeon,6,0,28,22
1715641987390,EDS 117,A01,494379,Staff,0,6,34,35
1715641988419,EDS 125,A00,507246,Hopkins; Megan Beth,7,0,30,23
1715641989450,EDS 128A,A01,507264,Fargason; Sharon Gayle,5,0,26,21
1715641990536,EDS 128B,A01,507293,Pappas; Elizabeth,9,0,30,21
1715641991564,EDS 139,A00,507294,Fargason; Sharon Gayle,9,0,30,21
1715641991564,EDS 139,B00,507313,Pappas; Elizabeth,9,0,30,21
1715641992591,EDS 201,A00,507315,Staff,10,0,30,20
1715641993643,EDS 203,A01,507317,Halter; Christopher P.,10,0,30,20
1715641994672,EDS 204R,A01,507319,Halter; Christopher P.,0,3,30,30
1715641994672,EDS 204R,B01,507331,Heinzman; Erica M.,14,0,30,16
1715641995699,EDS 206R,A00,507332,Staff,0,4,30,30
1715641995699,EDS 206R,B00,507343,Staff,15,0,30,15
1715641996727,EDS 250,A00,507344,Hemans; Patricia Ann Benitez,20,0,40,20
1715641997752,EDS 281,A00,507345,Daly; Alan J.,18,0,18,0
1715641998777,EDS 284,A00,507350,Daly; Alan J.,16,0,16,0
1715641999804,EDS 286,A00,507359,Fine; Sarah,18,0,18,0
1715642000831,EDS 289C,A01,507361,Daly; Alan J.,18,0,18,0
1715642001859,EDS 290,A00,507366,Hofstetter; Carolyn,15,0,15,0
1715642002895,LIGM 5A,A00,507421,Fischer-Grunski; Eva K,17,0,20,3
1715642003922,LIGM 5B,A00,507423,Fischer-Grunski; Eva K,19,0,20,1
1715642004947,LIGM 5C,A00,507425,Fischer-Grunski; Eva K,19,0,20,1
1715642005977,LIIT 5AS,A00,507427,Carnelos; Chiara,20,0,20,0
1715642007003,LIIT 5BS,A00,507430,Carnelos; Chiara,20,0,20,0
1715642008029,LIIT 5CS,A00,507432,Carnelos; Chiara,20,0,20,0
1715642009058,LISP 5A,A00,507541,Munoz Sanchez; Alicia,11,0,20,9
1715642010082,LISP 5B,A00,507671,Munoz Sanchez; Alicia,8,0,20,12
1715642011112,LISP 5C,A00,507696,Munoz Sanchez; Alicia,8,0,20,12
1715642012142,MAE 197,001,528363,Boechler; Nicholas Sebastia,9998,0,9999,1
1715642013168,MATH 197,001,523477,Kedlaya; Kiran S.,9994,0,9999,5
1715642013168,MATH 197,002,563811,Zhang; Danna,9994,0,9999,5
1715642013168,MATH 197,003,628552,Dumitriu; Ioana,9998,0,9999,1
1715642013168,MATH 197,004,660885,Floyd; Eric,9998,0,9999,1
1715642014240,MCWP 40R,A00,518780,Staff,1,0,20,19
1715642014240,MCWP 40R,B00,518781,Staff,10,0,20,10
1715642014240,MCWP 40R,C00,518783,Staff,5,0,20,15
1715642015278,MCWP 50R,A00,518791,Staff,0,1,20,20
1715642015278,MCWP 50R,B00,518792,Staff,0,2,20,20
1715642015278,MCWP 50R,C00,518793,Staff,0,4,20,20
1715642015278,MCWP 50R,D00,518794,Staff,0,1,20,20
1715642015278,MCWP 50R,E00,518795,Staff,0,2,20,20
1715642015278,MCWP 50R,F00,518796,Staff,0,1,20,20
1715642015278,MCWP 50R,G00,518797,Staff,0,1,20,20
1715642016305,MMW 12R,A01,514034,Herbst; Matthew,0,2,16,16
1715642016305,MMW 12R,A02,514035,Herbst; Matthew,0,0,16,16
1715642017331,MMW 13R,A01,514037,Staff,0,5,16,16
1715642017331,MMW 13R,A02,514039,Staff,0,5,16,16
1715642017331,MMW 13R,A03,628519,Staff,0,4,16,16
1715642019377,SIO 295LS,A00,523233,Staff,10,0,30,20
1715642020404,SIO 295S,A00,523232,Staff,10,0,30,20
1715642021430,SIOC 290S,A01,637330,Merrifield; Mark A,21,0,30,9
1715642022456,SIOC 291S,A01,637333,Gabriel; Corey John,21,0,30,9
1715642023484,SOCI 117,A01,494376,Staff,0,5,5,5
1715642024509,WES 237B,A00,494380,Staff,10,0,20,10
1715642026580,AESE 279B,A00,494370,Wade; Jon P,0,0,33,33
1715642027604,AIP 97,001,660915,Van Den Einde; Yael Dahlia,9998,0,9999,1
1715642028633,AIP 197,001,627712,Vespa; Emanuel Ignacio,9995,0,9999,4
1715642028633,AIP 197,002,650778,Amir; On,9998,0,9999,1
1715642028633,AIP 197,003,650933,Avenancio-Leon; Carlos,9998,0,9999,1
1715642028633,AIP 197,004,658530,Heyman; Gail D.,9998,0,9999,1
1715642028633,AIP 197,005,658631,Neal; Sonya E,9998,0,9999,1
1715642028633,AIP 197,006,658671,Du; Songzi,9998,0,9999,1
1715642029657,ANAR 135S,A00,494369,Braswell; Geoffrey E.,0,0,0,0
1715642030683,BENG 196,001,628496,Engler; Adam J.,9998,0,9999,1
1715642030683,BENG 196,002,660916,Watson; John Thomas,9998,0,9999,1
1715642031711,BISP 197,001,650773,Wilhelm; James E.,9994,0,9999,5
1715642031711,BISP 197,002,658904,Coleman; Aaron B.,9998,0,9999,1
1715642032738,CAT 124RS,A01,519847,Geibel; William,0,0,20,20
1715642033762,CAT 125RS,A01,515971,Geibel; William,0,0,20,20
1715642034790,CLRE 250,A00,511389,Morris; Sheldon,9992,0,9999,7
1715642035824,CLRE 251,A00,507176,Mehta; Ravindra L.,9992,0,9999,7
1715642035824,CLRE 251,B00,511410,Mehta; Ravindra L.,9998,0,9999,1
1715642036852,CLRE 252,A00,507189,Cuomo; Raphael Eduardo,9994,0,9999,5
1715642037881,CLRE 253,A00,507199,Vaida; Florin,9994,0,9999,5
1715642037881,CLRE 253,B00,507202,Vaida; Florin,9999,0,9999,0
1715642038908,CLRE 259,A00,507211,Patel; Hemal,9996,0,9999,3
1715642039934,CLRE 260,A00,507221,Cuomo; Raphael Eduardo,9999,0,9999,0
1715642040960,CLRE 297,001,507242,Cuomo; Raphael Eduardo,9999,0,9999,0
1715642041990,COGS 197,001,638244,Voytek; Bradley Thomas,9997,0,9999,2
1715642043019,CSE 191,A00,516875,Minnes Kemp; Mor Mia,9991,0,9999,8
1715642044046,CSE 197,001,637388,Minnes Kemp; Mor Mia,9992,0,9999,7
1715642045081,CSS 201S,A01,494383,Mignozzetti; Umberto,35,0,35,0
1715642046110,CSS 202S,A01,494387,Mignozzetti; Umberto,35,0,35,0
1715642047137,DSC 197,001,628532,Eldridge; Justin Matthew,9995,0,9999,4
1715642048162,EAP 100,A00,516065,Staff,9799,0,9999,200
1715642049189,ECE 45,A01,507414,Staff,31,0,60,29
1715642051238,ECE 111,A01,507420,Staff,11,0,50,39
1715642052264,ECE 197,001,548057,Sievenpiper; Daniel F.,9991,0,9999,8
1715642053294,EDS 115,A00,507243,Choi; Bailey Miyeon,6,0,28,22
1715642054323,EDS 117,A01,494379,Staff,0,6,34,35
1715642055349,EDS 125,A00,507246,Hopkins; Megan Beth,7,0,30,23
1715642056374,EDS 128A,A01,507264,Fargason; Sharon Gayle,5,0,26,21
1715642057399,EDS 128B,A01,507293,Pappas; Elizabeth,9,0,30,21
1715642058425,EDS 139,A00,507294,Fargason; Sharon Gayle,9,0,30,21
1715642058425,EDS 139,B00,507313,Pappas; Elizabeth,9,0,30,21
1715642059451,EDS 201,A00,507315,Staff,10,0,30,20
1715642060476,EDS 203,A01,507317,Halter; Christopher P.,10,0,30,20
1715642061503,EDS 204R,A01,507319,Halter; Christopher P.,0,3,30,30
1715642061503,EDS 204R,B01,507331,Heinzman; Erica M.,14,0,30,16
1715642062532,EDS 206R,A00,507332,Staff,0,4,30,30
1715642062532,EDS 206R,B00,507343,Staff,15,0,30,15
1715642063562,EDS 250,A00,507344,Hemans; Patricia Ann Benitez,20,0,40,20
1715642064590,EDS 281,A00,507345,Daly; Alan J.,18,0,18,0
1715642065616,EDS 284,A00,507350,Daly; Alan J.,16,0,16,0
1715642066642,EDS 286,A00,507359,Fine; Sarah,18,0,18,0
1715642067667,EDS 289C,A01,507361,Daly; Alan J.,18,0,18,0
1715642068693,EDS 290,A00,507366,Hofstetter; Carolyn,15,0,15,0
1715642069719,LIGM 5A,A00,507421,Fischer-Grunski; Eva K,17,0,20,3
1715642070748,LIGM 5B,A00,507423,Fischer-Grunski; Eva K,19,0,20,1
1715642071776,LIGM 5C,A00,507425,Fischer-Grunski; Eva K,19,0,20,1
1715642072803,LIIT 5AS,A00,507427,Carnelos; Chiara,20,0,20,0
1715642073828,LIIT 5BS,A00,507430,Carnelos; Chiara,20,0,20,0
1715642074856,LIIT 5CS,A00,507432,Carnelos; Chiara,20,0,20,0
1715642075881,LISP 5A,A00,507541,Munoz Sanchez; Alicia,11,0,20,9
1715642076905,LISP 5B,A00,507671,Munoz Sanchez; Alicia,8,0,20,12
1715642077932,LISP 5C,A00,507696,Munoz Sanchez; Alicia,8,0,20,12
1715642078956,MAE 197,001,528363,Boechler; Nicholas Sebastia,9998,0,9999,1
1715642079983,MATH 197,001,523477,Kedlaya; Kiran S.,9994,0,9999,5
1715642079983,MATH 197,002,563811,Zhang; Danna,9994,0,9999,5
1715642079983,MATH 197,003,628552,Dumitriu; Ioana,9998,0,9999,1
1715642079983,MATH 197,004,660885,Floyd; Eric,9998,0,9999,1
1715642081008,MCWP 40R,A00,518780,Staff,1,0,20,19
1715642081008,MCWP 40R,B00,518781,Staff,10,0,20,10
1715642081008,MCWP 40R,C00,518783,Staff,5,0,20,15
1715642082034,MCWP 50R,A00,518791,Staff,0,1,20,20
1715642082034,MCWP 50R,B00,518792,Staff,0,2,20,20
1715642082034,MCWP 50R,C00,518793,Staff,0,4,20,20
1715642082034,MCWP 50R,D00,518794,Staff,0,1,20,20
1715642082034,MCWP 50R,E00,518795,Staff,0,2,20,20
1715642082034,MCWP 50R,F00,518796,Staff,0,1,20,20
1715642082034,MCWP 50R,G00,518797,Staff,0,1,20,20
1715642083063,MMW 12R,A01,514034,Herbst; Matthew,0,2,16,16
1715642083063,MMW 12R,A02,514035,Herbst; Matthew,0,0,16,16
1715642084089,MMW 13R,A01,514037,Staff,0,5,16,16
1715642084089,MMW 13R,A02,514039,Staff,0,5,16,16
1715642084089,MMW 13R,A03,628519,Staff,0,4,16,16
1715642086142,SIO 295LS,A00,523233,Staff,10,0,30,20
1715642087168,SIO 295S,A00,523232,Staff,10,0,30,20
1715642088199,SIOC 290S,A01,637330,Merrifield; Mark A,21,0,30,9
1715642089228,SIOC 291S,A01,637333,Gabriel; Corey John,21,0,30,9
1715642090252,SOCI 117,A01,494376,Staff,0,5,5,5
1715642091276,WES 237B,A00,494380,Staff,10,0,20,10
1715642093347,AESE 279B,A00,494370,Wade; Jon P,0,0,33,33
1715642094374,AIP 97,001,660915,Van Den Einde; Yael Dahlia,9998,0,9999,1
1715642095407,AIP 197,001,627712,Vespa; Emanuel Ignacio,9995,0,9999,4
1715642095407,AIP 197,002,650778,Amir; On,9998,0,9999,1
1715642095407,AIP 197,003,650933,Avenancio-Leon; Carlos,9998,0,9999,1
1715642095407,AIP 197,004,658530,Heyman; Gail D.,9998,0,9999,1
1715642095407,AIP 197,005,658631,Neal; Sonya E,9998,0,9999,1
1715642095407,AIP 197,006,658671,Du; Songzi,9998,0,9999,1
1715642096432,ANAR 135S,A00,494369,Braswell; Geoffrey E.,0,0,0,0
1715642097459,BENG 196,001,628496,Engler; Adam J.,9998,0,9999,1
1715642097459,BENG 196,002,660916,Watson; John Thomas,9998,0,9999,1
1715642098490,BISP 197,001,650773,Wilhelm; James E.,9994,0,9999,5
1715642098490,BISP 197,002,658904,Coleman; Aaron B.,9998,0,9999,1
1715642099520,CAT 124RS,A01,519847,Geibel; William,0,0,20,20
1715642100547,CAT 125RS,A01,515971,Geibel; William,0,0,20,20
1715642101580,CLRE 250,A00,511389,Morris; Sheldon,9992,0,9999,7
1715642102608,CLRE 251,A00,507176,Mehta; Ravindra L.,9992,0,9999,7
1715642102608,CLRE 251,B00,511410,Mehta; Ravindra L.,9998,0,9999,1
1715642103638,CLRE 252,A00,507189,Cuomo; Raphael Eduardo,9994,0,9999,5
1715642104663,CLRE 253,A00,507199,Vaida; Florin,9994,0,9999,5
1715642104663,CLRE 253,B00,507202,Vaida; Florin,9999,0,9999,0
1715642105693,CLRE 259,A00,507211,Patel; Hemal,9996,0,9999,3
1715642106717,CLRE 260,A00,507221,Cuomo; Raphael Eduardo,9999,0,9999,0
1715642107742,CLRE 297,001,507242,Cuomo; Raphael Eduardo,9999,0,9999,0
1715642108769,COGS 197,001,638244,Voytek; Bradley Thomas,9997,0,9999,2
1715642109797,CSE 191,A00,516875,Minnes Kemp; Mor Mia,9991,0,9999,8
1715642110821,CSE 197,001,637388,Minnes Kemp; Mor Mia,9992,0,9999,7
1715642111850,CSS 201S,A01,494383,Mignozzetti; Umberto,35,0,35,0
1715642112878,CSS 202S,A01,494387,Mignozzetti; Umberto,35,0,35,0
1715642113907,DSC 197,001,628532,Eldridge; Justin Matthew,9995,0,9999,4
1715642114935,EAP 100,A00,516065,Staff,9799,0,9999,200
1715642115960,ECE 45,A01,507414,Staff,31,0,60,29
1715642118008,ECE 111,A01,507420,Staff,11,0,50,39
1715642119034,ECE 197,001,548057,Sievenpiper; Daniel F.,9991,0,9999,8
1715642120067,EDS 115,A00,507243,Choi; Bailey Miyeon,6,0,28,22
1715642121092,EDS 117,A01,494379,Staff,0,6,34,35
1715642122118,EDS 125,A00,507246,Hopkins; Megan Beth,7,0,30,23
1715642123148,EDS 128A,A01,507264,Fargason; Sharon Gayle,5,0,26,21
1715642124173,EDS 128B,A01,507293,Pappas; Elizabeth,9,0,30,21
1715642125200,EDS 139,A00,507294,Fargason; Sharon Gayle,9,0,30,21
1715642125200,EDS 139,B00,507313,Pappas; Elizabeth,9,0,30,21
1715642126228,EDS 201,A00,507315,Staff,10,0,30,20
1715642127252,EDS 203,A01,507317,Halter; Christopher P.,10,0,30,20
1715642128281,EDS 204R,A01,507319,Halter; Christopher P.,0,3,30,30
1715642128281,EDS 204R,B01,507331,Heinzman; Erica M.,14,0,30,16
1715642129306,EDS 206R,A00,507332,Staff,0,4,30,30
1715642129306,EDS 206R,B00,507343,Staff,15,0,30,15
1715642130389,EDS 250,A00,507344,Hemans; Patricia Ann Benitez,20,0,40,20
1715642131415,EDS 281,A00,507345,Daly; Alan J.,18,0,18,0
1715642132441,EDS 284,A00,507350,Daly; Alan J.,16,0,16,0
1715642133467,EDS 286,A00,507359,Fine; Sarah,18,0,18,0
1715642134493,EDS 289C,A01,507361,Daly; Alan J.,18,0,18,0
1715642135517,EDS 290,A00,507366,Hofstetter; Carolyn,15,0,15,0
1715642136543,LIGM 5A,A00,507421,Fischer-Grunski; Eva K,17,0,20,3
1715642137568,LIGM 5B,A00,507423,Fischer-Grunski; Eva K,19,0,20,1
1715642138597,LIGM 5C,A00,507425,Fischer-Grunski; Eva K,19,0,20,1
1715642139623,LIIT 5AS,A00,507427,Carnelos; Chiara,20,0,20,0
1715642140647,LIIT 5BS,A00,507430,Carnelos; Chiara,20,0,20,0
1715642141671,LIIT 5CS,A00,507432,Carnelos; Chiara,20,0,20,0
1715642142697,LISP 5A,A00,507541,Munoz Sanchez; Alicia,11,0,20,9
1715642143725,LISP 5B,A00,507671,Munoz Sanchez; Alicia,8,0,20,12
1715642144751,LISP 5C,A00,507696,Munoz Sanchez; Alicia,8,0,20,12
1715642145780,MAE 197,001,528363,Boechler; Nicholas Sebastia,9998,0,9999,1
1715642146809,MATH 197,001,523477,Kedlaya; Kiran S.,9994,0,9999,5
1715642146809,MATH 197,002,563811,Zhang; Danna,9994,0,9999,5
1715642146809,MATH 197,003,628552,Dumitriu; Ioana,9998,0,9999,1
1715642146809,MATH 197,004,660885,Floyd; Eric,9998,0,9999,1
1715642147834,MCWP 40R,A00,518780,Staff,1,0,20,19
1715642147834,MCWP 40R,B00,518781,Staff,10,0,20,10
1715642147834,MCWP 40R,C00,518783,Staff,5,0,20,15
1715642148860,MCWP 50R,A00,518791,Staff,0,1,20,20
1715642148860,MCWP 50R,B00,518792,Staff,0,2,20,20
1715642148860,MCWP 50R,C00,518793,Staff,0,4,20,20
1715642148860,MCWP 50R,D00,518794,Staff,0,1,20,20
1715642148860,MCWP 50R,E00,518795,Staff,0,2,20,20
1715642148860,MCWP 50R,F00,518796,Staff,0,1,20,20
1715642148860,MCWP 50R,G00,518797,Staff,0,1,20,20
1715642149883,MMW 12R,A01,514034,Herbst; Matthew,0,2,16,16
1715642149883,MMW 12R,A02,514035,Herbst; Matthew,0,0,16,16
1715642150907,MMW 13R,A01,514037,Staff,0,5,16,16
1715642150907,MMW 13R,A02,514039,Staff,0,5,16,16
1715642150907,MMW 13R,A03,628519,Staff,0,4,16,16
1715642152958,SIO 295LS,A00,523233,Staff,10,0,30,20
1715642153982,SIO 295S,A00,523232,Staff,10,0,30,20
1715642155011,SIOC 290S,A01,637330,Merrifield; Mark A,21,0,30,9
1715642156036,SIOC 291S,A01,637333,Gabriel; Corey John,21,0,30,9
1715642157062,SOCI 117,A01,494376,Staff,0,5,5,5
1715642158091,WES 237B,A00,494380,Staff,10,0,20,10
1715642160165,AESE 279B,A00,494370,Wade; Jon P,0,0,33,33
1715642161190,AIP 97,001,660915,Van Den Einde; Yael Dahlia,9998,0,9999,1
1715642162219,AIP 197,001,627712,Vespa; Emanuel Ignacio,9995,0,9999,4
1715642162219,AIP 197,002,650778,Amir; On,9998,0,9999,1
1715642162219,AIP 197,003,650933,Avenancio-Leon; Carlos,9998,0,9999,1
1715642162219,AIP 197,004,658530,Heyman; Gail D.,9998,0,9999,1
1715642162219,AIP 197,005,658631,Neal; Sonya E,9998,0,9999,1
1715642162219,AIP 197,006,658671,Du; Songzi,9998,0,9999,1
1715642163244,ANAR 135S,A00,494369,Braswell; Geoffrey E.,0,0,0,0
1715642164277,BENG 196,001,628496,Engler; Adam J.,9998,0,9999,1
1715642164277,BENG 196,002,660916,Watson; John Thomas,9998,0,9999,1
1715642165327,BISP 197,001,650773,Wilhelm; James E.,9994,0,9999,5
1715642165327,BISP 197,002,658904,Coleman; Aaron B.,9998,0,9999,1
1715642166352,CAT 124RS,A01,519847,Geibel; William,0,0,20,20
1715642167378,CAT 125RS,A01,515971,Geibel; William,0,0,20,20
1715642168404,CLRE 250,A00,511389,Morris; Sheldon,9992,0,9999,7
1715642169434,CLRE 251,A00,507176,Mehta; Ravindra L.,9992,0,9999,7
1715642169434,CLRE 251,B00,511410,Mehta; Ravindra L.,9998,0,9999,1
1715642170463,CLRE 252,A00,507189,Cuomo; Raphael Eduardo,9994,0,9999,5
1715642171492,CLRE 253,A00,507199,Vaida; Florin,9994,0,9999,5
1715642171492,CLRE 253,B00,507202,Vaida; Florin,9999,0,9999,0
1715642172519,CLRE 259,A00,507211,Patel; Hemal,9996,0,9999,3
1715642173546,CLRE 260,A00,507221,Cuomo; Raphael Eduardo,9999,0,9999,0
1715642174574,CLRE 297,001,507242,Cuomo; Raphael Eduardo,9999,0,9999,0
1715642175599,COGS 197,001,638244,Voytek; Bradley Thomas,9997,0,9999,2
1715642176628,CSE 191,A00,516875,Minnes Kemp; Mor Mia,9991,0,9999,8
1715642177652,CSE 197,001,637388,Minnes Kemp; Mor Mia,9992,0,9999,7
1715642178679,CSS 201S,A01,494383,Mignozzetti; Umberto,35,0,35,0
1715642179705,CSS 202S,A01,494387,Mignozzetti; Umberto,35,0,35,0
1715642180732,DSC 197,001,628532,Eldridge; Justin Matthew,9995,0,9999,4
1715642181758,EAP 100,A00,516065,Staff,9799,0,9999,200
1715642182786,ECE 45,A01,507414,Staff,31,0,60,29
1715642184840,ECE 111,A01,507420,Staff,11,0,50,39
1715642185864,ECE 197,001,548057,Sievenpiper; Daniel F.,9991,0,9999,8
1715642186895,EDS 115,A00,507243,Choi; Bailey Miyeon,6,0,28,22
1715642187920,EDS 117,A01,494379,Staff,0,6,34,35
1715642188948,EDS 125,A00,507246,Hopkins; Megan Beth,7,0,30,23
1715642189975,EDS 128A,A01,507264,Fargason; Sharon Gayle,5,0,26,21
1715642191000,EDS 128B,A01,507293,Pappas; Elizabeth,9,0,30,21
1715642192026,EDS 139,A00,507294,Fargason; Sharon Gayle,9,0,30,21
1715642192026,EDS 139,B00,507313,Pappas; Elizabeth,9,0,30,21
1715642193051,EDS 201,A00,507315,Staff,10,0,30,20
1715642194081,EDS 203,A01,507317,Halter; Christopher P.,10,0,30,20
1715642195107,EDS 204R,A01,507319,Halter; Christopher P.,0,3,30,30
1715642195107,EDS 204R,B01,507331,Heinzman; Erica M.,14,0,30,16
1715642196133,EDS 206R,A00,507332,Staff,0,4,30,30
1715642196133,EDS 206R,B00,507343,Staff,15,0,30,15
1715642197162,EDS 250,A00,507344,Hemans; Patricia Ann Benitez,20,0,40,20
1715642198187,EDS 281,A00,507345,Daly; Alan J.,18,0,18,0
1715642199215,EDS 284,A00,507350,Daly; Alan J.,16,0,16,0
1715642200240,EDS 286,A00,507359,Fine; Sarah,18,0,18,0
1715642201265,EDS 289C,A01,507361,Daly; Alan J.,18,0,18,0
1715642202294,EDS 290,A00,507366,Hofstetter; Carolyn,15,0,15,0
1715642203325,LIGM 5A,A00,507421,Fischer-Grunski; Eva K,17,0,20,3
1715642204362,LIGM 5B,A00,507423,Fischer-Grunski; Eva K,19,0,20,1
1715642205388,LIGM 5C,A00,507425,Fischer-Grunski; Eva K,19,0,20,1
1715642206418,LIIT 5AS,A00,507427,Carnelos; Chiara,20,0,20,0
1715642207447,LIIT 5BS,A00,507430,Carnelos; Chiara,20,0,20,0
1715642208471,LIIT 5CS,A00,507432,Carnelos; Chiara,20,0,20,0
1715642209498,LISP 5A,A00,507541,Munoz Sanchez; Alicia,11,0,20,9
1715642210529,LISP 5B,A00,507671,Munoz Sanchez; Alicia,8,0,20,12
1715642211556,LISP 5C,A00,507696,Munoz Sanchez; Alicia,8,0,20,12
1715642212583,MAE 197,001,528363,Boechler; Nicholas Sebastia,9998,0,9999,1
1715642213611,MATH 197,001,523477,Kedlaya; Kiran S.,9994,0,9999,5
1715642213611,MATH 197,002,563811,Zhang; Danna,9994,0,9999,5
1715642213611,MATH 197,003,628552,Dumitriu; Ioana,9998,0,9999,1
1715642213611,MATH 197,004,660885,Floyd; Eric,9998,0,9999,1
1715642214636,MCWP 40R,A00,518780,Staff,1,0,20,19
1715642214636,MCWP 40R,B00,518781,Staff,10,0,20,10
1715642214636,MCWP 40R,C00,518783,Staff,5,0,20,15
1715642215666,MCWP 50R,A00,518791,Staff,0,1,20,20
1715642215666,MCWP 50R,B00,518792,Staff,0,2,20,20
1715642215666,MCWP 50R,C00,518793,Staff,0,4,20,20
1715642215666,MCWP 50R,D00,518794,Staff,0,1,20,20
1715642215666,MCWP 50R,E00,518795,Staff,0,2,20,20
1715642215666,MCWP 50R,F00,518796,Staff,0,1,20,20
1715642215666,MCWP 50R,G00,518797,Staff,0,1,20,20
1715642216696,MMW 12R,A01,514034,Herbst; Matthew,0,2,16,16
1715642216696,MMW 12R,A02,514035,Herbst; Matthew,0,0,16,16
1715642217721,MMW 13R,A01,514037,Staff,0,5,16,16
1715642217721,MMW 13R,A02,514039,Staff,0,5,16,16
1715642217721,MMW 13R,A03,628519,Staff,0,4,16,16
1715642219772,SIO 295LS,A00,523233,Staff,10,0,30,20
1715642220798,SIO 295S,A00,523232,Staff,10,0,30,20
1715642221827,SIOC 290S,A01,637330,Merrifield; Mark A,21,0,30,9
1715642222853,SIOC 291S,A01,637333,Gabriel; Corey John,21,0,30,9
1715642223879,SOCI 117,A01,494376,Staff,0,5,5,5
1715642224905,WES 237B,A00,494380,Staff,10,0,20,10
1715642226978,AESE 279B,A00,494370,Wade; Jon P,0,0,33,33
1715642228001,AIP 97,001,660915,Van Den Einde; Yael Dahlia,9998,0,9999,1
1715642229030,AIP 197,001,627712,Vespa; Emanuel Ignacio,9995,0,9999,4
1715642229030,AIP 197,002,650778,Amir; On,9998,0,9999,1
1715642229030,AIP 197,003,650933,Avenancio-Leon; Carlos,9998,0,9999,1
1715642229030,AIP 197,004,658530,Heyman; Gail D.,9998,0,9999,1
1715642229030,AIP 197,005,658631,Neal; Sonya E,9998,0,9999,1
1715642229030,AIP 197,006,658671,Du; Songzi,9998,0,9999,1
1715642230058,ANAR 135S,A00,494369,Braswell; Geoffrey E.,0,0,0,0
1715642231084,BENG 196,001,628496,Engler; Adam J.,9998,0,9999,1
1715642231084,BENG 196,002,660916,Watson; John Thomas,9998,0,9999,1
1715642232108,BISP 197,001,650773,Wilhelm; James E.,9994,0,9999,5
1715642232108,BISP 197,002,658904,Coleman; Aaron B.,9998,0,9999,1
1715642233133,CAT 124RS,A01,519847,Geibel; William,0,0,20,20
1715642234212,CAT 125RS,A01,515971,Geibel; William,0,0,20,20
1715642235237,CLRE 250,A00,511389,Morris; Sheldon,9992,0,9999,7
1715642236271,CLRE 251,A00,507176,Mehta; Ravindra L.,9992,0,9999,7
1715642236271,CLRE 251,B00,511410,Mehta; Ravindra L.,9998,0,9999,1
1715642237298,CLRE 252,A00,507189,Cuomo; Raphael Eduardo,9994,0,9999,5
1715642238332,CLRE 253,A00,507199,Vaida; Florin,9994,0,9999,5
1715642238332,CLRE 253,B00,507202,Vaida; Florin,9999,0,9999,0
1715642239359,CLRE 259,A00,507211,Patel; Hemal,9996,0,9999,3
1715642240385,CLRE 260,A00,507221,Cuomo; Raphael Eduardo,9999,0,9999,0
1715642241411,CLRE 297,001,507242,Cuomo; Raphael Eduardo,9999,0,9999,0
1715642242436,COGS 197,001,638244,Voytek; Bradley Thomas,9997,0,9999,2
1715642243466,CSE 191,A00,516875,Minnes Kemp; Mor Mia,9991,0,9999,8
1715642244491,CSE 197,001,637388,Minnes Kemp; Mor Mia,9992,0,9999,7
1715642245517,CSS 201S,A01,494383,Mignozzetti; Umberto,35,0,35,0
1715642246542,CSS 202S,A01,494387,Mignozzetti; Umberto,35,0,35,0
1715642247572,DSC 197,001,628532,Eldridge; Justin Matthew,9995,0,9999,4
1715642248596,EAP 100,A00,516065,Staff,9799,0,9999,200
1715642249630,ECE 45,A01,507414,Staff,31,0,60,29
1715642251682,ECE 111,A01,507420,Staff,11,0,50,39
1715642252707,ECE 197,001,548057,Sievenpiper; Daniel F.,9991,0,9999,8
1715642253734,EDS 115,A00,507243,Choi; Bailey Miyeon,6,0,28,22
1715642254763,EDS 117,A01,494379,Staff,0,6,34,35
1715642255789,EDS 125,A00,507246,Hopkins; Megan Beth,7,0,30,23
1715642256819,EDS 128A,A01,507264,Fargason; Sharon Gayle,5,0,26,21
1715642257844,EDS 128B,A01,507293,Pappas; Elizabeth,9,0,30,21
1715642258871,EDS 139,A00,507294,Fargason; Sharon Gayle,9,0,30,21
1715642258871,EDS 139,B00,507313,Pappas; Elizabeth,9,0,30,21
1715642259897,EDS 201,A00,507315,Staff,10,0,30,20
1715642260926,EDS 203,A01,507317,Halter; Christopher P.,10,0,30,20
1715642261955,EDS 204R,A01,507319,Halter; Christopher P.,0,3,30,30
1715642261955,EDS 204R,B01,507331,Heinzman; Erica M.,14,0,30,16
1715642262981,EDS 206R,A00,507332,Staff,0,4,30,30
1715642262981,EDS 206R,B00,507343,Staff,15,0,30,15
1715642264010,EDS 250,A00,507344,Hemans; Patricia Ann Benitez,20,0,40,20
1715642265035,EDS 281,A00,507345,Daly; Alan J.,18,0,18,0
1715642266060,EDS 284,A00,507350,Daly; Alan J.,16,0,16,0
1715642267088,EDS 286,A00,507359,Fine; Sarah,18,0,18,0
1715642268116,EDS 289C,A01,507361,Daly; Alan J.,18,0,18,0
1715642269145,EDS 290,A00,507366,Hofstetter; Carolyn,15,0,15,0
1715642270176,LIGM 5A,A00,507421,Fischer-Grunski; Eva K,17,0,20,3
1715642271202,LIGM 5B,A00,507423,Fischer-Grunski; Eva K,19,0,20,1
1715642272230,LIGM 5C,A00,507425,Fischer-Grunski; Eva K,19,0,20,1
1715642273259,LIIT 5AS,A00,507427,Carnelos; Chiara,20,0,20,0
1715642274288,LIIT 5BS,A00,507430,Carnelos; Chiara,20,0,20,0
1715642275313,LIIT 5CS,A00,507432,Carnelos; Chiara,20,0,20,0
1715642276341,LISP 5A,A00,507541,Munoz Sanchez; Alicia,11,0,20,9
1715642277366,LISP 5B,A00,507671,Munoz Sanchez; Alicia,8,0,20,12
1715642278393,LISP 5C,A00,507696,Munoz Sanchez; Alicia,8,0,20,12
1715642279420,MAE 197,001,528363,Boechler; Nicholas Sebastia,9998,0,9999,1
1715642280452,MATH 197,001,523477,Kedlaya; Kiran S.,9994,0,9999,5
1715642280452,MATH 197,002,563811,Zhang; Danna,9994,0,9999,5
1715642280452,MATH 197,003,628552,Dumitriu; Ioana,9998,0,9999,1
1715642280452,MATH 197,004,660885,Floyd; Eric,9998,0,9999,1
1715642281479,MCWP 40R,A00,518780,Staff,1,0,20,19
1715642281479,MCWP 40R,B00,518781,Staff,10,0,20,10
1715642281479,MCWP 40R,C00,518783,Staff,5,0,20,15
1715642282508,MCWP 50R,A00,518791,Staff,0,1,20,20
1715642282508,MCWP 50R,B00,518792,Staff,0,2,20,20
1715642282508,MCWP 50R,C00,518793,Staff,0,4,20,20
1715642282508,MCWP 50R,D00,518794,Staff,0,1,20,20
1715642282508,MCWP 50R,E00,518795,Staff,0,2,20,20
1715642282508,MCWP 50R,F00,518796,Staff,0,1,20,20
1715642282508,MCWP 50R,G00,518797,Staff,0,1,20,20
1715642283534,MMW 12R,A01,514034,Herbst; Matthew,0,2,16,16
1715642283534,MMW 12R,A02,514035,Herbst; Matthew,0,0,16,16
1715642284559,MMW 13R,A01,514037,Staff,0,5,16,16
1715642284559,MMW 13R,A02,514039,Staff,0,5,16,16
1715642284559,MMW 13R,A03,628519,Staff,0,4,16,16
1715642286611,SIO 295LS,A00,523233,Staff,10,0,30,20
1715642287637,SIO 295S,A00,523232,Staff,10,0,30,20
1715642288667,SIOC 290S,A01,637330,Merrifield; Mark A,21,0,30,9
1715642289699,SIOC 291S,A01,637333,Gabriel; Corey John,21,0,30,9
1715642290725,SOCI 117,A01,494376,Staff,0,5,5,5
1715642291753,WES 237B,A00,494380,Staff,10,0,20,10
1715642293822,AESE 279B,A00,494370,Wade; Jon P,0,0,33,33
1715642294849,AIP 97,001,660915,Van Den Einde; Yael Dahlia,9998,0,9999,1
1715642295878,AIP 197,001,627712,Vespa; Emanuel Ignacio,9995,0,9999,4
1715642295878,AIP 197,002,650778,Amir; On,9998,0,9999,1
1715642295878,AIP 197,003,650933,Avenancio-Leon; Carlos,9998,0,9999,1
1715642295878,AIP 197,004,658530,Heyman; Gail D.,9998,0,9999,1
1715642295878,AIP 197,005,658631,Neal; Sonya E,9998,0,9999,1
1715642295878,AIP 197,006,658671,Du; Songzi,9998,0,9999,1
1715642296906,ANAR 135S,A00,494369,Braswell; Geoffrey E.,0,0,0,0
1715642297937,BENG 196,001,628496,Engler; Adam J.,9998,0,9999,1
1715642297937,BENG 196,002,660916,Watson; John Thomas,9998,0,9999,1
1715642298963,BISP 197,001,650773,Wilhelm; James E.,9994,0,9999,5
1715642298963,BISP 197,002,658904,Coleman; Aaron B.,9998,0,9999,1
1715642299988,CAT 124RS,A01,519847,Geibel; William,0,0,20,20
1715642301015,CAT 125RS,A01,515971,Geibel; William,0,0,20,20
1715642302044,CLRE 250,A00,511389,Morris; Sheldon,9992,0,9999,7
1715642303071,CLRE 251,A00,507176,Mehta; Ravindra L.,9992,0,9999,7
1715642303071,CLRE 251,B00,511410,Mehta; Ravindra L.,9998,0,9999,1
1715642304096,CLRE 252,A00,507189,Cuomo; Raphael Eduardo,9994,0,9999,5
1715642305126,CLRE 253,A00,507199,Vaida; Florin,9994,0,9999,5
1715642305126,CLRE 253,B00,507202,Vaida; Florin,9999,0,9999,0
1715642306152,CLRE 259,A00,507211,Patel; Hemal,9996,0,9999,3
1715642307180,CLRE 260,A00,507221,Cuomo; Raphael Eduardo,9999,0,9999,0
1715642308208,CLRE 297,001,507242,Cuomo; Raphael Eduardo,9999,0,9999,0
1715642309234,COGS 197,001,638244,Voytek; Bradley Thomas,9997,0,9999,2
1715642310260,CSE 191,A00,516875,Minnes Kemp; Mor Mia,9991,0,9999,8
1715642311287,CSE 197,001,637388,Minnes Kemp; Mor Mia,9992,0,9999,7
1715642312320,CSS 201S,A01,494383,Mignozzetti; Umberto,35,0,35,0
1715642313345,CSS 202S,A01,494387,Mignozzetti; Umberto,35,0,35,0
1715642314373,DSC 197,001,628532,Eldridge; Justin Matthew,9995,0,9999,4
1715642315399,EAP 100,A00,516065,Staff,9799,0,9999,200
1715642316430,ECE 45,A01,507414,Staff,31,0,60,29
1715642318479,ECE 111,A01,507420,Staff,11,0,50,39
1715642319506,ECE 197,001,548057,Sievenpiper; Daniel F.,9991,0,9999,8
1715642320536,EDS 115,A00,507243,Choi; Bailey Miyeon,6,0,28,22
1715642321564,EDS 117,A01,494379,Staff,0,6,34,35
1715642322592,EDS 125,A00,507246,Hopkins; Megan Beth,7,0,30,23
1715642323618,EDS 128A,A01,507264,Fargason; Sharon Gayle,5,0,26,21
1715642324644,EDS 128B,A01,507293,Pappas; Elizabeth,9,0,30,21
1715642325670,EDS 139,A00,507294,Fargason; Sharon Gayle,9,0,30,21
1715642325670,EDS 139,B00,507313,Pappas; Elizabeth,9,0,30,21
1715642326694,EDS 201,A00,507315,Staff,10,0,30,20
1715642327723,EDS 203,A01,507317,Halter; Christopher P.,10,0,30,20
1715642328748,EDS 204R,A01,507319,Halter; Christopher P.,0,3,30,30
1715642328748,EDS 204R,B01,507331,Heinzman; Erica M.,14,0,30,16
1715642329778,EDS 206R,A00,507332,Staff,0,4,30,30
1715642329778,EDS 206R,B00,507343,Staff,15,0,30,15
1715642330803,EDS 250,A00,507344,Hemans; Patricia Ann Benitez,20,0,40,20
1715642331828,EDS 281,A00,507345,Daly; Alan J.,18,0,18,0
1715642332854,EDS 284,A00,507350,Daly; Alan J.,16,0,16,0
1715642333896,EDS 286,A00,507359,Fine; Sarah,18,0,18,0
1715642334922,EDS 289C,A01,507361,Daly; Alan J.,18,0,18,0
1715642335948,EDS 290,A00,507366,Hofstetter; Carolyn,15,0,15,0
1715642336976,LIGM 5A,A00,507421,Fischer-Grunski; Eva K,17,0,20,3
1715642338063,LIGM 5B,A00,507423,Fischer-Grunski; Eva K,19,0,20,1
1715642339092,LIGM 5C,A00,507425,Fischer-Grunski; Eva K,19,0,20,1
1715642340118,LIIT 5AS,A00,507427,Carnelos; Chiara,20,0,20,0
1715642341144,LIIT 5BS,A00,507430,Carnelos; Chiara,20,0,20,0
1715642342172,LIIT 5CS,A00,507432,Carnelos; Chiara,20,0,20,0
1715642343201,LISP 5A,A00,507541,Munoz Sanchez; Alicia,11,0,20,9
1715642344229,LISP 5B,A00,507671,Munoz Sanchez; Alicia,8,0,20,12
1715642345260,LISP 5C,A00,507696,Munoz Sanchez; Alicia,8,0,20,12
1715642346286,MAE 197,001,528363,Boechler; Nicholas Sebastia,9998,0,9999,1
1715642347315,MATH 197,001,523477,Kedlaya; Kiran S.,9994,0,9999,5
1715642347315,MATH 197,002,563811,Zhang; Danna,9994,0,9999,5
1715642347315,MATH 197,003,628552,Dumitriu; Ioana,9998,0,9999,1
1715642347315,MATH 197,004,660885,Floyd; Eric,9998,0,9999,1
1715642348346,MCWP 40R,A00,518780,Staff,1,0,20,19
1715642348346,MCWP 40R,B00,518781,Staff,10,0,20,10
1715642348346,MCWP 40R,C00,518783,Staff,5,0,20,15
1715642349377,MCWP 50R,A00,518791,Staff,0,1,20,20
1715642349377,MCWP 50R,B00,518792,Staff,0,2,20,20
1715642349377,MCWP 50R,C00,518793,Staff,0,4,20,20
1715642349377,MCWP 50R,D00,518794,Staff,0,1,20,20
1715642349377,MCWP 50R,E00,518795,Staff,0,2,20,20
1715642349377,MCWP 50R,F00,518796,Staff,0,1,20,20
1715642349377,MCWP 50R,G00,518797,Staff,0,1,20,20
1715642350402,MMW 12R,A01,514034,Herbst; Matthew,0,2,16,16
1715642350402,MMW 12R,A02,514035,Herbst; Matthew,0,0,16,16
1715642351430,MMW 13R,A01,514037,Staff,0,5,16,16
1715642351430,MMW 13R,A02,514039,Staff,0,5,16,16
1715642351430,MMW 13R,A03,628519,Staff,0,4,16,16
1715642353483,SIO 295LS,A00,523233,Staff,10,0,30,20
1715642354508,SIO 295S,A00,523232,Staff,10,0,30,20
1715642355537,SIOC 290S,A01,637330,Merrifield; Mark A,21,0,30,9
1715642356566,SIOC 291S,A01,637333,Gabriel; Corey John,21,0,30,9
1715642357590,SOCI 117,A01,494376,Staff,0,5,5,5
1715642358616,WES 237B,A00,494380,Staff,10,0,20,10
1715642360687,AESE 279B,A00,494370,Wade; Jon P,0,0,33,33
1715642361712,AIP 97,001,660915,Van Den Einde; Yael Dahlia,9998,0,9999,1
1715642362738,AIP 197,001,627712,Vespa; Emanuel Ignacio,9995,0,9999,4
1715642362738,AIP 197,002,650778,Amir; On,9998,0,9999,1
1715642362738,AIP 197,003,650933,Avenancio-Leon; Carlos,9998,0,9999,1
1715642362738,AIP 197,004,658530,Heyman; Gail D.,9998,0,9999,1
1715642362738,AIP 197,005,658631,Neal; Sonya E,9998,0,9999,1
1715642362738,AIP 197,006,658671,Du; Songzi,9998,0,9999,1
1715642363768,ANAR 135S,A00,494369,Braswell; Geoffrey E.,0,0,0,0
1715642364798,BENG 196,001,628496,Engler; Adam J.,9998,0,9999,1
1715642364798,BENG 196,002,660916,Watson; John Thomas,9998,0,9999,1
1715642365823,BISP 197,001,650773,Wilhelm; James E.,9994,0,9999,5
1715642365823,BISP 197,002,658904,Coleman; Aaron B.,9998,0,9999,1
1715642366850,CAT 124RS,A01,519847,Geibel; William,0,0,20,20
1715642367874,CAT 125RS,A01,515971,Geibel; William,0,0,20,20
1715642368902,CLRE 250,A00,511389,Morris; Sheldon,9992,0,9999,7
1715642369934,CLRE 251,A00,507176,Mehta; Ravindra L.,9992,0,9999,7
1715642369934,CLRE 251,B00,511410,Mehta; Ravindra L.,9998,0,9999,1
1715642370960,CLRE 252,A00,507189,Cuomo; Raphael Eduardo,9994,0,9999,5
1715642371987,CLRE 253,A00,507199,Vaida; Florin,9994,0,9999,5
1715642371987,CLRE 253,B00,507202,Vaida; Florin,9999,0,9999,0
1715642373013,CLRE 259,A00,507211,Patel; Hemal,9996,0,9999,3
1715642374038,CLRE 260,A00,507221,Cuomo; Raphael Eduardo,9999,0,9999,0
1715642375065,CLRE 297,001,507242,Cuomo; Raphael Eduardo,9999,0,9999,0
1715642376092,COGS 197,001,638244,Voytek; Bradley Thomas,9997,0,9999,2
1715642377119,CSE 191,A00,516875,Minnes Kemp; Mor Mia,9991,0,9999,8
1715642378143,CSE 197,001,637388,Minnes Kemp; Mor Mia,9992,0,9999,7
1715642379172,CSS 201S,A01,494383,Mignozzetti; Umberto,35,0,35,0
1715642380231,CSS 202S,A01,494387,Mignozzetti; Umberto,35,0,35,0
1715642381258,DSC 197,001,628532,Eldridge; Justin Matthew,9995,0,9999,4
1715642382283,EAP 100,A00,516065,Staff,9799,0,9999,200
1715642383316,ECE 45,A01,507414,Staff,31,0,60,29
1715642385370,ECE 111,A01,507420,Staff,11,0,50,39
1715642386396,ECE 197,001,548057,Sievenpiper; Daniel F.,9991,0,9999,8
1715642387425,EDS 115,A00,507243,Choi; Bailey Miyeon,6,0,28,22
1715642388450,EDS 117,A01,494379,Staff,0,6,34,35
1715642389476,EDS 125,A00,507246,Hopkins; Megan Beth,7,0,30,23
1715642390507,EDS 128A,A01,507264,Fargason; Sharon Gayle,5,0,26,21
1715642391533,EDS 128B,A01,507293,Pappas; Elizabeth,9,0,30,21
1715642392558,EDS 139,A00,507294,Fargason; Sharon Gayle,9,0,30,21
1715642392558,EDS 139,B00,507313,Pappas; Elizabeth,9,0,30,21
1715642393584,EDS 201,A00,507315,Staff,10,0,30,20
1715642394610,EDS 203,A01,507317,Halter; Christopher P.,10,0,30,20
1715642395641,EDS 204R,A01,507319,Halter; Christopher P.,0,3,30,30
1715642395641,EDS 204R,B01,507331,Heinzman; Erica M.,14,0,30,16
1715642396669,EDS 206R,A00,507332,Staff,0,4,30,30
1715642396669,EDS 206R,B00,507343,Staff,15,0,30,15
1715642397697,EDS 250,A00,507344,Hemans; Patricia Ann Benitez,20,0,40,20
1715642398726,EDS 281,A00,507345,Daly; Alan J.,18,0,18,0
1715642399753,EDS 284,A00,507350,Daly; Alan J.,16,0,16,0
1715642400779,EDS 286,A00,507359,Fine; Sarah,18,0,18,0
1715642401811,EDS 289C,A01,507361,Daly; Alan J.,18,0,18,0
1715642402837,EDS 290,A00,507366,Hofstetter; Carolyn,15,0,15,0
1715642403867,LIGM 5A,A00,507421,Fischer-Grunski; Eva K,17,0,20,3
1715642404894,LIGM 5B,A00,507423,Fischer-Grunski; Eva K,19,0,20,1
1715642405922,LIGM 5C,A00,507425,Fischer-Grunski; Eva K,19,0,20,1
1715642406955,LIIT 5AS,A00,507427,Carnelos; Chiara,20,0,20,0
1715642407980,LIIT 5BS,A00,507430,Carnelos; Chiara,20,0,20,0
1715642409006,LIIT 5CS,A00,507432,Carnelos; Chiara,20,0,20,0
1715642410033,LISP 5A,A00,507541,Munoz Sanchez; Alicia,11,0,20,9
1715642411058,LISP 5B,A00,507671,Munoz Sanchez; Alicia,8,0,20,12
1715642412088,LISP 5C,A00,507696,Munoz Sanchez; Alicia,8,0,20,12
1715642413118,MAE 197,001,528363,Boechler; Nicholas Sebastia,9998,0,9999,1
1715642414145,MATH 197,001,523477,Kedlaya; Kiran S.,9994,0,9999,5
1715642414145,MATH 197,002,563811,Zhang; Danna,9994,0,9999,5
1715642414145,MATH 197,003,628552,Dumitriu; Ioana,9998,0,9999,1
1715642414145,MATH 197,004,660885,Floyd; Eric,9998,0,9999,1
1715642415171,MCWP 40R,A00,518780,Staff,1,0,20,19
1715642415171,MCWP 40R,B00,518781,Staff,10,0,20,10
1715642415171,MCWP 40R,C00,518783,Staff,5,0,20,15
1715642416199,MCWP 50R,A00,518791,Staff,0,1,20,20
1715642416199,MCWP 50R,B00,518792,Staff,0,2,20,20
1715642416199,MCWP 50R,C00,518793,Staff,0,4,20,20
1715642416199,MCWP 50R,D00,518794,Staff,0,1,20,20
1715642416199,MCWP 50R,E00,518795,Staff,0,2,20,20
1715642416199,MCWP 50R,F00,518796,Staff,0,1,20,20
1715642416199,MCWP 50R,G00,518797,Staff,0,1,20,20
1715642417225,MMW 12R,A01,514034,Herbst; Matthew,0,2,16,16
1715642417225,MMW 12R,A02,514035,Herbst; Matthew,0,0,16,16
1715642418250,MMW 13R,A01,514037,Staff,0,5,16,16
1715642418250,MMW 13R,A02,514039,Staff,0,5,16,16
1715642418250,MMW 13R,A03,628519,Staff,0,4,16,16
1715642420307,SIO 295LS,A00,523233,Staff,10,0,30,20
1715642421333,SIO 295S,A00,523232,Staff,10,0,30,20
1715642422358,SIOC 290S,A01,637330,Merrifield; Mark A,21,0,30,9
1715642423385,SIOC 291S,A01,637333,Gabriel; Corey John,21,0,30,9
1715642424413,SOCI 117,A01,494376,Staff,0,5,5,5
1715642425439,WES 237B,A00,494380,Staff,10,0,20,10
1715642427503,AESE 279B,A00,494370,Wade; Jon P,0,0,33,33
1715642428529,AIP 97,001,660915,Van Den Einde; Yael Dahlia,9998,0,9999,1
1715642429560,AIP 197,001,627712,Vespa; Emanuel Ignacio,9995,0,9999,4
1715642429560,AIP 197,002,650778,Amir; On,9998,0,9999,1
1715642429560,AIP 197,003,650933,Avenancio-Leon; Carlos,9998,0,9999,1
1715642429560,AIP 197,004,658530,Heyman; Gail D.,9998,0,9999,1
1715642429560,AIP 197,005,658631,Neal; Sonya E,9998,0,9999,1
1715642429560,AIP 197,006,658671,Du; Songzi,9998,0,9999,1
1715642430590,ANAR 135S,A00,494369,Braswell; Geoffrey E.,0,0,0,0
1715642431623,BENG 196,001,628496,Engler; Adam J.,9998,0,9999,1
1715642431623,BENG 196,002,660916,Watson; John Thomas,9998,0,9999,1
1715642432655,BISP 197,001,650773,Wilhelm; James E.,9994,0,9999,5
1715642432655,BISP 197,002,658904,Coleman; Aaron B.,9998,0,9999,1
1715642433684,CAT 124RS,A01,519847,Geibel; William,0,0,20,20
1715642434712,CAT 125RS,A01,515971,Geibel; William,0,0,20,20
1715642435742,CLRE 250,A00,511389,Morris; Sheldon,9992,0,9999,7
1715642436768,CLRE 251,A00,507176,Mehta; Ravindra L.,9992,0,9999,7
1715642436768,CLRE 251,B00,511410,Mehta; Ravindra L.,9998,0,9999,1
1715642437796,CLRE 252,A00,507189,Cuomo; Raphael Eduardo,9994,0,9999,5
1715642438821,CLRE 253,A00,507199,Vaida; Florin,9994,0,9999,5
1715642438821,CLRE 253,B00,507202,Vaida; Florin,9999,0,9999,0
1715642439851,CLRE 259,A00,507211,Patel; Hemal,9996,0,9999,3
1715642440876,CLRE 260,A00,507221,Cuomo; Raphael Eduardo,9999,0,9999,0
1715642441956,CLRE 297,001,507242,Cuomo; Raphael Eduardo,9999,0,9999,0
1715642442984,COGS 197,001,638244,Voytek; Bradley Thomas,9997,0,9999,2
1715642444013,CSE 191,A00,516875,Minnes Kemp; Mor Mia,9991,0,9999,8
1715642445038,CSE 197,001,637388,Minnes Kemp; Mor Mia,9992,0,9999,7
1715642446066,CSS 201S,A01,494383,Mignozzetti; Umberto,35,0,35,0
1715642447094,CSS 202S,A01,494387,Mignozzetti; Umberto,35,0,35,0
1715642448124,DSC 197,001,628532,Eldridge; Justin Matthew,9995,0,9999,4
1715642449149,EAP 100,A00,516065,Staff,9799,0,9999,200
1715642450186,ECE 45,A01,507414,Staff,31,0,60,29
1715642452238,ECE 111,A01,507420,Staff,11,0,50,39
1715642453268,ECE 197,001,548057,Sievenpiper; Daniel F.,9991,0,9999,8
1715642454296,EDS 115,A00,507243,Choi; Bailey Miyeon,6,0,28,22
1715642455322,EDS 117,A01,494379,Staff,0,6,34,35
1715642456349,EDS 125,A00,507246,Hopkins; Megan Beth,7,0,30,23
1715642457379,EDS 128A,A01,507264,Fargason; Sharon Gayle,5,0,26,21
1715642458405,EDS 128B,A01,507293,Pappas; Elizabeth,9,0,30,21
1715642459431,EDS 139,A00,507294,Fargason; Sharon Gayle,9,0,30,21
1715642459431,EDS 139,B00,507313,Pappas; Elizabeth,9,0,30,21
1715642460458,EDS 201,A00,507315,Staff,10,0,30,20
1715642461487,EDS 203,A01,507317,Halter; Christopher P.,10,0,30,20
1715642462512,EDS 204R,A01,507319,Halter; Christopher P.,0,3,30,30
1715642462512,EDS 204R,B01,507331,Heinzman; Erica M.,14,0,30,16
1715642463542,EDS 206R,A00,507332,Staff,0,4,30,30
1715642463542,EDS 206R,B00,507343,Staff,15,0,30,15
1715642464567,EDS 250,A00,507344,Hemans; Patricia Ann Benitez,20,0,40,20
1715642465591,EDS 281,A00,507345,Daly; Alan J.,18,0,18,0
1715642466621,EDS 284,A00,507350,Daly; Alan J.,16,0,16,0
1715642467651,EDS 286,A00,507359,Fine; Sarah,18,0,18,0
1715642468676,EDS 289C,A01,507361,Daly; Alan J.,18,0,18,0
1715642469704,EDS 290,A00,507366,Hofstetter; Carolyn,15,0,15,0
1715642470740,LIGM 5A,A00,507421,Fischer-Grunski; Eva K,17,0,20,3
1715642471766,LIGM 5B,A00,507423,Fischer-Grunski; Eva K,19,0,20,1
1715642472796,LIGM 5C,A00,507425,Fischer-Grunski; Eva K,19,0,20,1
1715642473822,LIIT 5AS,A00,507427,Carnelos; Chiara,20,0,20,0
1715642474853,LIIT 5BS,A00,507430,Carnelos; Chiara,20,0,20,0
1715642475880,LIIT 5CS,A00,507432,Carnelos; Chiara,20,0,20,0
1715642476909,LISP 5A,A00,507541,Munoz Sanchez; Alicia,11,0,20,9
1715642477934,LISP 5B,A00,507671,Munoz Sanchez; Alicia,8,0,20,12
1715642478961,LISP 5C,A00,507696,Munoz Sanchez; Alicia,8,0,20,12
1715642479987,MAE 197,001,528363,Boechler; Nicholas Sebastia,9998,0,9999,1
1715642481015,MATH 197,001,523477,Kedlaya; Kiran S.,9994,0,9999,5
1715642481015,MATH 197,002,563811,Zhang; Danna,9994,0,9999,5
1715642481015,MATH 197,003,628552,Dumitriu; Ioana,9998,0,9999,1
1715642481015,MATH 197,004,660885,Floyd; Eric,9998,0,9999,1
1715642482040,MCWP 40R,A00,518780,Staff,1,0,20,19
1715642482040,MCWP 40R,B00,518781,Staff,10,0,20,10
1715642482040,MCWP 40R,C00,518783,Staff,5,0,20,15
1715642483071,MCWP 50R,A00,518791,Staff,0,1,20,20
1715642483071,MCWP 50R,B00,518792,Staff,0,2,20,20
1715642483071,MCWP 50R,C00,518793,Staff,0,4,20,20
1715642483071,MCWP 50R,D00,518794,Staff,0,1,20,20
1715642483071,MCWP 50R,E00,518795,Staff,0,2,20,20
1715642483071,MCWP 50R,F00,518796,Staff,0,1,20,20
1715642483071,MCWP 50R,G00,518797,Staff,0,1,20,20
1715642484099,MMW 12R,A01,514034,Herbst; Matthew,0,2,16,16
1715642484099,MMW 12R,A02,514035,Herbst; Matthew,0,0,16,16
1715642485128,MMW 13R,A01,514037,Staff,0,5,16,16
1715642485128,MMW 13R,A02,514039,Staff,0,5,16,16
1715642485128,MMW 13R,A03,628519,Staff,0,4,16,16
1715642487180,SIO 295LS,A00,523233,Staff,10,0,30,20
1715642488207,SIO 295S,A00,523232,Staff,10,0,30,20
1715642489239,SIOC 290S,A01,637330,Merrifield; Mark A,21,0,30,9
1715642490268,SIOC 291S,A01,637333,Gabriel; Corey John,21,0,30,9
1715642491293,SOCI 117,A01,494376,Staff,0,5,5,5
1715642492320,WES 237B,A00,494380,Staff,10,0,20,10
1715642494401,AESE 279B,A00,494370,Wade; Jon P,0,0,33,33
1715642495428,AIP 97,001,660915,Van Den Einde; Yael Dahlia,9998,0,9999,1
1715642496456,AIP 197,001,627712,Vespa; Emanuel Ignacio,9995,0,9999,4
1715642496456,AIP 197,002,650778,Amir; On,9998,0,9999,1
1715642496456,AIP 197,003,650933,Avenancio-Leon; Carlos,9998,0,9999,1
1715642496456,AIP 197,004,658530,Heyman; Gail D.,9998,0,9999,1
1715642496456,AIP 197,005,658631,Neal; Sonya E,9998,0,9999,1
1715642496456,AIP 197,006,658671,Du; Songzi,9998,0,9999,1
1715642497485,ANAR 135S,A00,494369,Braswell; Geoffrey E.,0,0,0,0
1715642498512,BENG 196,001,628496,Engler; Adam J.,9998,0,9999,1
1715642498512,BENG 196,002,660916,Watson; John Thomas,9998,0,9999,1
1715642499540,BISP 197,001,650773,Wilhelm; James E.,9994,0,9999,5
1715642499540,BISP 197,002,658904,Coleman; Aaron B.,9998,0,9999,1
1715642500570,CAT 124RS,A01,519847,Geibel; William,0,0,20,20
1715642501597,CAT 125RS,A01,515971,Geibel; William,0,0,20,20
1715642502627,CLRE 250,A00,511389,Morris; Sheldon,9992,0,9999,7
1715642503663,CLRE 251,A00,507176,Mehta; Ravindra L.,9992,0,9999,7
1715642503663,CLRE 251,B00,511410,Mehta; Ravindra L.,9998,0,9999,1
1715642504691,CLRE 252,A00,507189,Cuomo; Raphael Eduardo,9994,0,9999,5
1715642505717,CLRE 253,A00,507199,Vaida; Florin,9994,0,9999,5
1715642505717,CLRE 253,B00,507202,Vaida; Florin,9999,0,9999,0
1715642506745,CLRE 259,A00,507211,Patel; Hemal,9996,0,9999,3
1715642507770,CLRE 260,A00,507221,Cuomo; Raphael Eduardo,9999,0,9999,0
1715642508828,CLRE 297,001,507242,Cuomo; Raphael Eduardo,9999,0,9999,0
1715642509854,COGS 197,001,638244,Voytek; Bradley Thomas,9997,0,9999,2
1715642510884,CSE 191,A00,516875,Minnes Kemp; Mor Mia,9991,0,9999,8
1715642511912,CSE 197,001,637388,Minnes Kemp; Mor Mia,9992,0,9999,7
1715642512939,CSS 201S,A01,494383,Mignozzetti; Umberto,35,0,35,0
1715642513968,CSS 202S,A01,494387,Mignozzetti; Umberto,35,0,35,0
1715642514996,DSC 197,001,628532,Eldridge; Justin Matthew,9995,0,9999,4
1715642516026,EAP 100,A00,516065,Staff,9799,0,9999,200
1715642517058,ECE 45,A01,507414,Staff,31,0,60,29
1715642519249,ECE 111,A01,507420,Staff,11,0,50,39
1715642520275,ECE 197,001,548057,Sievenpiper; Daniel F.,9991,0,9999,8
1715642521302,EDS 115,A00,507243,Choi; Bailey Miyeon,6,0,28,22
1715642522331,EDS 117,A01,494379,Staff,0,6,34,35
1715642523359,EDS 125,A00,507246,Hopkins; Megan Beth,7,0,30,23
1715642524389,EDS 128A,A01,507264,Fargason; Sharon Gayle,5,0,26,21
1715642525416,EDS 128B,A01,507293,Pappas; Elizabeth,9,0,30,21
1715642526442,EDS 139,A00,507294,Fargason; Sharon Gayle,9,0,30,21
1715642526442,EDS 139,B00,507313,Pappas; Elizabeth,9,0,30,21
1715642527470,EDS 201,A00,507315,Staff,10,0,30,20
1715642528496,EDS 203,A01,507317,Halter; Christopher P.,10,0,30,20
1715642529526,EDS 204R,A01,507319,Halter; Christopher P.,0,3,30,30
1715642529526,EDS 204R,B01,507331,Heinzman; Erica M.,14,0,30,16
1715642530551,EDS 206R,A00,507332,Staff,0,4,30,30
1715642530551,EDS 206R,B00,507343,Staff,15,0,30,15
1715642531577,EDS 250,A00,507344,Hemans; Patricia Ann Benitez,20,0,40,20
1715642532605,EDS 281,A00,507345,Daly; Alan J.,18,0,18,0
1715642533630,EDS 284,A00,507350,Daly; Alan J.,16,0,16,0
1715642534661,EDS 286,A00,507359,Fine; Sarah,18,0,18,0
1715642535686,EDS 289C,A01,507361,Daly; Alan J.,18,0,18,0
1715642536710,EDS 290,A00,507366,Hofstetter; Carolyn,15,0,15,0
1715642537738,LIGM 5A,A00,507421,Fischer-Grunski; Eva K,17,0,20,3
1715642538769,LIGM 5B,A00,507423,Fischer-Grunski; Eva K,19,0,20,1
1715642539792,LIGM 5C,A00,507425,Fischer-Grunski; Eva K,19,0,20,1
1715642540819,LIIT 5AS,A00,507427,Carnelos; Chiara,20,0,20,0
1715642541848,LIIT 5BS,A00,507430,Carnelos; Chiara,20,0,20,0
1715642542874,LIIT 5CS,A00,507432,Carnelos; Chiara,20,0,20,0
1715642543902,LISP 5A,A00,507541,Munoz Sanchez; Alicia,11,0,20,9
1715642544927,LISP 5B,A00,507671,Munoz Sanchez; Alicia,8,0,20,12
1715642546007,LISP 5C,A00,507696,Munoz Sanchez; Alicia,8,0,20,12
1715642547032,MAE 197,001,528363,Boechler; Nicholas Sebastia,9998,0,9999,1
1715642548059,MATH 197,001,523477,Kedlaya; Kiran S.,9994,0,9999,5
1715642548059,MATH 197,002,563811,Zhang; Danna,9994,0,9999,5
1715642548059,MATH 197,003,628552,Dumitriu; Ioana,9998,0,9999,1
1715642548059,MATH 197,004,660885,Floyd; Eric,9998,0,9999,1
1715642549085,MCWP 40R,A00,518780,Staff,1,0,20,19
1715642549085,MCWP 40R,B00,518781,Staff,10,0,20,10
1715642549085,MCWP 40R,C00,518783,Staff,5,0,20,15
1715642550112,MCWP 50R,A00,518791,Staff,0,1,20,20
1715642550112,MCWP 50R,B00,518792,Staff,0,2,20,20
1715642550112,MCWP 50R,C00,518793,Staff,0,4,20,20
1715642550112,MCWP 50R,D00,518794,Staff,0,1,20,20
1715642550112,MCWP 50R,E00,518795,Staff,0,2,20,20
1715642550112,MCWP 50R,F00,518796,Staff,0,1,20,20
1715642550112,MCWP 50R,G00,518797,Staff,0,1,20,20
1715642551144,MMW 12R,A01,514034,Herbst; Matthew,0,2,16,16
1715642551144,MMW 12R,A02,514035,Herbst; Matthew,0,0,16,16
1715642552169,MMW 13R,A01,514037,Staff,0,5,16,16
1715642552169,MMW 13R,A02,514039,Staff,0,5,16,16
1715642552169,MMW 13R,A03,628519,Staff,0,4,16,16
1715642554223,SIO 295LS,A00,523233,Staff,10,0,30,20
1715642555248,SIO 295S,A00,523232,Staff,10,0,30,20
1715642556277,SIOC 290S,A01,637330,Merrifield; Mark A,21,0,30,9
1715642557308,SIOC 291S,A01,637333,Gabriel; Corey John,21,0,30,9
1715642558333,SOCI 117,A01,494376,Staff,0,5,5,5
1715642559359,WES 237B,A00,494380,Staff,10,0,20,10
1715642561443,AESE 279B,A00,494370,Wade; Jon P,0,0,33,33
1715642562472,AIP 97,001,660915,Van Den Einde; Yael Dahlia,9998,0,9999,1
1715642563501,AIP 197,001,627712,Vespa; Emanuel Ignacio,9995,0,9999,4
1715642563501,AIP 197,002,650778,Amir; On,9998,0,9999,1
1715642563501,AIP 197,003,650933,Avenancio-Leon; Carlos,9998,0,9999,1
1715642563501,AIP 197,004,658530,Heyman; Gail D.,9998,0,9999,1
1715642563501,AIP 197,005,658631,Neal; Sonya E,9998,0,9999,1
1715642563501,AIP 197,006,658671,Du; Songzi,9998,0,9999,1
1715642564530,ANAR 135S,A00,494369,Braswell; Geoffrey E.,0,0,0,0
1715642565560,BENG 196,001,628496,Engler; Adam J.,9998,0,9999,1
1715642565560,BENG 196,002,660916,Watson; John Thomas,9998,0,9999,1
1715642566597,BISP 197,001,650773,Wilhelm; James E.,9994,0,9999,5
1715642566597,BISP 197,002,658904,Coleman; Aaron B.,9998,0,9999,1
1715642567623,CAT 124RS,A01,519847,Geibel; William,0,0,20,20
1715642568651,CAT 125RS,A01,515971,Geibel; William,0,0,20,20
1715642569680,CLRE 250,A00,511389,Morris; Sheldon,9992,0,9999,7
1715642570706,CLRE 251,A00,507176,Mehta; Ravindra L.,9992,0,9999,7
1715642570706,CLRE 251,B00,511410,Mehta; Ravindra L.,9998,0,9999,1
1715642571732,CLRE 252,A00,507189,Cuomo; Raphael Eduardo,9994,0,9999,5
1715642572758,CLRE 253,A00,507199,Vaida; Florin,9994,0,9999,5
1715642572758,CLRE 253,B00,507202,Vaida; Florin,9999,0,9999,0
1715642573783,CLRE 259,A00,507211,Patel; Hemal,9996,0,9999,3
1715642574811,CLRE 260,A00,507221,Cuomo; Raphael Eduardo,9999,0,9999,0
1715642575840,CLRE 297,001,507242,Cuomo; Raphael Eduardo,9999,0,9999,0
1715642576867,COGS 197,001,638244,Voytek; Bradley Thomas,9997,0,9999,2
1715642577892,CSE 191,A00,516875,Minnes Kemp; Mor Mia,9991,0,9999,8
1715642578920,CSE 197,001,637388,Minnes Kemp; Mor Mia,9992,0,9999,7
1715642579947,CSS 201S,A01,494383,Mignozzetti; Umberto,35,0,35,0
1715642580976,CSS 202S,A01,494387,Mignozzetti; Umberto,35,0,35,0
1715642582001,DSC 197,001,628532,Eldridge; Justin Matthew,9995,0,9999,4
1715642583027,EAP 100,A00,516065,Staff,9799,0,9999,200
1715642584057,ECE 45,A01,507414,Staff,31,0,60,29
1715642586113,ECE 111,A01,507420,Staff,11,0,50,39
1715642587139,ECE 197,001,548057,Sievenpiper; Daniel F.,9991,0,9999,8
1715642588168,EDS 115,A00,507243,Choi; Bailey Miyeon,6,0,28,22
1715642589198,EDS 117,A01,494379,Staff,0,6,34,35
1715642590223,EDS 125,A00,507246,Hopkins; Megan Beth,7,0,30,23
1715642591253,EDS 128A,A01,507264,Fargason; Sharon Gayle,5,0,26,21
1715642592284,EDS 128B,A01,507293,Pappas; Elizabeth,9,0,30,21
1715642593311,EDS 139,A00,507294,Fargason; Sharon Gayle,9,0,30,21
1715642593311,EDS 139,B00,507313,Pappas; Elizabeth,9,0,30,21
1715642594339,EDS 201,A00,507315,Staff,10,0,30,20
1715642595368,EDS 203,A01,507317,Halter; Christopher P.,10,0,30,20
1715642596398,EDS 204R,A01,507319,Halter; Christopher P.,0,3,30,30
1715642596398,EDS 204R,B01,507331,Heinzman; Erica M.,14,0,30,16
1715642597426,EDS 206R,A00,507332,Staff,0,4,30,30
1715642597426,EDS 206R,B00,507343,Staff,15,0,30,15
1715642598452,EDS 250,A00,507344,Hemans; Patricia Ann Benitez,20,0,40,20
1715642599478,EDS 281,A00,507345,Daly; Alan J.,18,0,18,0
1715642600504,EDS 284,A00,507350,Daly; Alan J.,16,0,16,0
1715642601532,EDS 286,A00,507359,Fine; Sarah,18,0,18,0
1715642602560,EDS 289C,A01,507361,Daly; Alan J.,18,0,18,0
1715642603586,EDS 290,A00,507366,Hofstetter; Carolyn,15,0,15,0
1715642604615,LIGM 5A,A00,507421,Fischer-Grunski; Eva K,17,0,20,3
1715642605643,LIGM 5B,A00,507423,Fischer-Grunski; Eva K,19,0,20,1
1715642606668,LIGM 5C,A00,507425,Fischer-Grunski; Eva K,19,0,20,1
1715642607695,LIIT 5AS,A00,507427,Carnelos; Chiara,20,0,20,0
1715642608723,LIIT 5BS,A00,507430,Carnelos; Chiara,20,0,20,0
1715642609753,LIIT 5CS,A00,507432,Carnelos; Chiara,20,0,20,0
1715642610779,LISP 5A,A00,507541,Munoz Sanchez; Alicia,11,0,20,9
1715642611808,LISP 5B,A00,507671,Munoz Sanchez; Alicia,8,0,20,12
1715642612835,LISP 5C,A00,507696,Munoz Sanchez; Alicia,8,0,20,12
1715642613870,MAE 197,001,528363,Boechler; Nicholas Sebastia,9998,0,9999,1
1715642614895,MATH 197,001,523477,Kedlaya; Kiran S.,9994,0,9999,5
1715642614895,MATH 197,002,563811,Zhang; Danna,9994,0,9999,5
1715642614895,MATH 197,003,628552,Dumitriu; Ioana,9998,0,9999,1
1715642614895,MATH 197,004,660885,Floyd; Eric,9998,0,9999,1
1715642615922,MCWP 40R,A00,518780,Staff,1,0,20,19
1715642615922,MCWP 40R,B00,518781,Staff,10,0,20,10
1715642615922,MCWP 40R,C00,518783,Staff,5,0,20,15
1715642616953,MCWP 50R,A00,518791,Staff,0,1,20,20
1715642616953,MCWP 50R,B00,518792,Staff,0,2,20,20
1715642616953,MCWP 50R,C00,518793,Staff,0,4,20,20
1715642616953,MCWP 50R,D00,518794,Staff,0,1,20,20
1715642616953,MCWP 50R,E00,518795,Staff,0,2,20,20
1715642616953,MCWP 50R,F00,518796,Staff,0,1,20,20
1715642616953,MCWP 50R,G00,518797,Staff,0,1,20,20
1715642617978,MMW 12R,A01,514034,Herbst; Matthew,0,2,16,16
1715642617978,MMW 12R,A02,514035,Herbst; Matthew,0,0,16,16
1715642619003,MMW 13R,A01,514037,Staff,0,5,16,16
1715642619003,MMW 13R,A02,514039,Staff,0,5,16,16
1715642619003,MMW 13R,A03,628519,Staff,0,4,16,16
1715642621060,SIO 295LS,A00,523233,Staff,10,0,30,20
1715642622086,SIO 295S,A00,523232,Staff,10,0,30,20
1715642623117,SIOC 290S,A01,637330,Merrifield; Mark A,21,0,30,9
1715642624142,SIOC 291S,A01,637333,Gabriel; Corey John,21,0,30,9
1715642625167,SOCI 117,A01,494376,Staff,0,5,5,5
1715642626192,WES 237B,A00,494380,Staff,10,0,20,10
1715642628271,AESE 279B,A00,494370,Wade; Jon P,0,0,33,33
1715642629298,AIP 97,001,660915,Van Den Einde; Yael Dahlia,9998,0,9999,1
1715642630328,AIP 197,001,627712,Vespa; Emanuel Ignacio,9995,0,9999,4
1715642630328,AIP 197,002,650778,Amir; On,9998,0,9999,1
1715642630328,AIP 197,003,650933,Avenancio-Leon; Carlos,9998,0,9999,1
1715642630328,AIP 197,004,658530,Heyman; Gail D.,9998,0,9999,1
1715642630328,AIP 197,005,658631,Neal; Sonya E,9998,0,9999,1
1715642630328,AIP 197,006,658671,Du; Songzi,9998,0,9999,1
1715642631358,ANAR 135S,A00,494369,Braswell; Geoffrey E.,0,0,0,0
1715642632383,BENG 196,001,628496,Engler; Adam J.,9998,0,9999,1
1715642632383,BENG 196,002,660916,Watson; John Thomas,9998,0,9999,1
1715642633409,BISP 197,001,650773,Wilhelm; James E.,9994,0,9999,5
1715642633409,BISP 197,002,658904,Coleman; Aaron B.,9998,0,9999,1
1715642634434,CAT 124RS,A01,519847,Geibel; William,0,0,20,20
1715642635464,CAT 125RS,A01,515971,Geibel; William,0,0,20,20
1715642636494,CLRE 250,A00,511389,Morris; Sheldon,9992,0,9999,7
1715642637524,CLRE 251,A00,507176,Mehta; Ravindra L.,9992,0,9999,7
1715642637524,CLRE 251,B00,511410,Mehta; Ravindra L.,9998,0,9999,1
1715642638550,CLRE 252,A00,507189,Cuomo; Raphael Eduardo,9994,0,9999,5
1715642639576,CLRE 253,A00,507199,Vaida; Florin,9994,0,9999,5
1715642639576,CLRE 253,B00,507202,Vaida; Florin,9999,0,9999,0
1715642640601,CLRE 259,A00,507211,Patel; Hemal,9996,0,9999,3
1715642641629,CLRE 260,A00,507221,Cuomo; Raphael Eduardo,9999,0,9999,0
1715642642656,CLRE 297,001,507242,Cuomo; Raphael Eduardo,9999,0,9999,0
1715642643684,COGS 197,001,638244,Voytek; Bradley Thomas,9997,0,9999,2
1715642644709,CSE 191,A00,516875,Minnes Kemp; Mor Mia,9991,0,9999,8
1715642645735,CSE 197,001,637388,Minnes Kemp; Mor Mia,9992,0,9999,7
1715642646766,CSS 201S,A01,494383,Mignozzetti; Umberto,35,0,35,0
1715642647800,CSS 202S,A01,494387,Mignozzetti; Umberto,35,0,35,0
1715642648827,DSC 197,001,628532,Eldridge; Justin Matthew,9995,0,9999,4
1715642649910,EAP 100,A00,516065,Staff,9799,0,9999,200
1715642650945,ECE 45,A01,507414,Staff,31,0,60,29
1715642653000,ECE 111,A01,507420,Staff,11,0,50,39
1715642654026,ECE 197,001,548057,Sievenpiper; Daniel F.,9991,0,9999,8
1715642655053,EDS 115,A00,507243,Choi; Bailey Miyeon,6,0,28,22
1715642656079,EDS 117,A01,494379,Staff,0,6,34,35
1715642657110,EDS 125,A00,507246,Hopkins; Megan Beth,7,0,30,23
1715642658138,EDS 128A,A01,507264,Fargason; Sharon Gayle,5,0,26,21
1715642659165,EDS 128B,A01,507293,Pappas; Elizabeth,9,0,30,21
1715642660193,EDS 139,A00,507294,Fargason; Sharon Gayle,9,0,30,21
1715642660193,EDS 139,B00,507313,Pappas; Elizabeth,9,0,30,21
1715642661218,EDS 201,A00,507315,Staff,10,0,30,20
1715642662243,EDS 203,A01,507317,Halter; Christopher P.,10,0,30,20
1715642663273,EDS 204R,A01,507319,Halter; Christopher P.,0,3,30,30
1715642663273,EDS 204R,B01,507331,Heinzman; Erica M.,14,0,30,16
1715642664322,EDS 206R,A00,507332,Staff,0,4,30,30
1715642664322,EDS 206R,B00,507343,Staff,15,0,30,15
1715642665349,EDS 250,A00,507344,Hemans; Patricia Ann Benitez,20,0,40,20
1715642666377,EDS 281,A00,507345,Daly; Alan J.,18,0,18,0
1715642667402,EDS 284,A00,507350,Daly; Alan J.,16,0,16,0
1715642668430,EDS 286,A00,507359,Fine; Sarah,18,0,18,0
1715642669459,EDS 289C,A01,507361,Daly; Alan J.,18,0,18,0
1715642670485,EDS 290,A00,507366,Hofstetter; Carolyn,15,0,15,0
1715642671516,LIGM 5A,A00,507421,Fischer-Grunski; Eva K,17,0,20,3
1715642672545,LIGM 5B,A00,507423,Fischer-Grunski; Eva K,19,0,20,1
1715642673571,LIGM 5C,A00,507425,Fischer-Grunski; Eva K,19,0,20,1
1715642674603,LIIT 5AS,A00,507427,Carnelos; Chiara,20,0,20,0
1715642675627,LIIT 5BS,A00,507430,Carnelos; Chiara,20,0,20,0
1715642676653,LIIT 5CS,A00,507432,Carnelos; Chiara,20,0,20,0
1715642677678,LISP 5A,A00,507541,Munoz Sanchez; Alicia,11,0,20,9
1715642678708,LISP 5B,A00,507671,Munoz Sanchez; Alicia,8,0,20,12
1715642679737,LISP 5C,A00,507696,Munoz Sanchez; Alicia,8,0,20,12
1715642680764,MAE 197,001,528363,Boechler; Nicholas Sebastia,9998,0,9999,1
1715642681798,MATH 197,001,523477,Kedlaya; Kiran S.,9994,0,9999,5
1715642681798,MATH 197,002,563811,Zhang; Danna,9994,0,9999,5
1715642681798,MATH 197,003,628552,Dumitriu; Ioana,9998,0,9999,1
1715642681798,MATH 197,004,660885,Floyd; Eric,9998,0,9999,1
1715642682824,MCWP 40R,A00,518780,Staff,1,0,20,19
1715642682824,MCWP 40R,B00,518781,Staff,10,0,20,10
1715642682824,MCWP 40R,C00,518783,Staff,5,0,20,15
1715642684071,MCWP 50R,A00,518791,Staff,0,1,20,20
1715642684071,MCWP 50R,B00,518792,Staff,0,2,20,20
1715642684071,MCWP 50R,C00,518793,Staff,0,4,20,20
1715642684071,MCWP 50R,D00,518794,Staff,0,1,20,20
1715642684071,MCWP 50R,E00,518795,Staff,0,2,20,20
1715642684071,MCWP 50R,F00,518796,Staff,0,1,20,20
1715642684071,MCWP 50R,G00,518797,Staff,0,1,20,20
1715642685102,MMW 12R,A01,514034,Herbst; Matthew,0,2,16,16
1715642685102,MMW 12R,A02,514035,Herbst; Matthew,0,0,16,16
1715642686130,MMW 13R,A01,514037,Staff,0,5,16,16
1715642686130,MMW 13R,A02,514039,Staff,0,5,16,16
1715642686130,MMW 13R,A03,628519,Staff,0,4,16,16
1715642688187,SIO 295LS,A00,523233,Staff,10,0,30,20
1715642689214,SIO 295S,A00,523232,Staff,10,0,30,20
1715642690241,SIOC 290S,A01,637330,Merrifield; Mark A,21,0,30,9
1715642691266,SIOC 291S,A01,637333,Gabriel; Corey John,21,0,30,9
1715642692381,SOCI 117,A01,494376,Staff,0,5,5,5
1715642693415,WES 237B,A00,494380,Staff,10,0,20,10
1715642695485,AESE 279B,A00,494370,Wade; Jon P,0,0,33,33
1715642696514,AIP 97,001,660915,Van Den Einde; Yael Dahlia,9998,0,9999,1
1715642697540,AIP 197,001,627712,Vespa; Emanuel Ignacio,9995,0,9999,4
1715642697540,AIP 197,002,650778,Amir; On,9998,0,9999,1
1715642697540,AIP 197,003,650933,Avenancio-Leon; Carlos,9998,0,9999,1
1715642697540,AIP 197,004,658530,Heyman; Gail D.,9998,0,9999,1
1715642697540,AIP 197,005,658631,Neal; Sonya E,9998,0,9999,1
1715642697540,AIP 197,006,658671,Du; Songzi,9998,0,9999,1
1715642698565,ANAR 135S,A00,494369,Braswell; Geoffrey E.,0,0,0,0
1715642699591,BENG 196,001,628496,Engler; Adam J.,9998,0,9999,1
1715642699591,BENG 196,002,660916,Watson; John Thomas,9998,0,9999,1
1715642700616,BISP 197,001,650773,Wilhelm; James E.,9994,0,9999,5
1715642700616,BISP 197,002,658904,Coleman; Aaron B.,9998,0,9999,1
1715642701649,CAT 124RS,A01,519847,Geibel; William,0,0,20,20
1715642702677,CAT 125RS,A01,515971,Geibel; William,0,0,20,20
1715642703703,CLRE 250,A00,511389,Morris; Sheldon,9992,0,9999,7
1715642704735,CLRE 251,A00,507176,Mehta; Ravindra L.,9992,0,9999,7
1715642704735,CLRE 251,B00,511410,Mehta; Ravindra L.,9998,0,9999,1
1715642705761,CLRE 252,A00,507189,Cuomo; Raphael Eduardo,9994,0,9999,5
1715642706787,CLRE 253,A00,507199,Vaida; Florin,9994,0,9999,5
1715642706787,CLRE 253,B00,507202,Vaida; Florin,9999,0,9999,0
1715642707812,CLRE 259,A00,507211,Patel; Hemal,9996,0,9999,3
1715642708840,CLRE 260,A00,507221,Cuomo; Raphael Eduardo,9999,0,9999,0
1715642709868,CLRE 297,001,507242,Cuomo; Raphael Eduardo,9999,0,9999,0
1715642710892,COGS 197,001,638244,Voytek; Bradley Thomas,9997,0,9999,2
1715642711921,CSE 191,A00,516875,Minnes Kemp; Mor Mia,9991,0,9999,8
1715642712946,CSE 197,001,637388,Minnes Kemp; Mor Mia,9992,0,9999,7
1715642713971,CSS 201S,A01,494383,Mignozzetti; Umberto,35,0,35,0
1715642714996,CSS 202S,A01,494387,Mignozzetti; Umberto,35,0,35,0
1715642716021,DSC 197,001,628532,Eldridge; Justin Matthew,9995,0,9999,4
1715642717048,EAP 100,A00,516065,Staff,9799,0,9999,200
1715642718077,ECE 45,A01,507414,Staff,31,0,60,29
1715642720128,ECE 111,A01,507420,Staff,11,0,50,39
1715642721152,ECE 197,001,548057,Sievenpiper; Daniel F.,9991,0,9999,8
1715642722178,EDS 115,A00,507243,Choi; Bailey Miyeon,6,0,28,22
1715642723204,EDS 117,A01,494379,Staff,0,6,34,35
1715642724231,EDS 125,A00,507246,Hopkins; Megan Beth,7,0,30,23
1715642725257,EDS 128A,A01,507264,Fargason; Sharon Gayle,5,0,26,21
1715642726282,EDS 128B,A01,507293,Pappas; Elizabeth,9,0,30,21
1715642727327,EDS 139,A00,507294,Fargason; Sharon Gayle,9,0,30,21
1715642727327,EDS 139,B00,507313,Pappas; Elizabeth,9,0,30,21
1715642728353,EDS 201,A00,507315,Staff,10,0,30,20
1715642729378,EDS 203,A01,507317,Halter; Christopher P.,10,0,30,20
1715642730404,EDS 204R,A01,507319,Halter; Christopher P.,0,3,30,30
1715642730404,EDS 204R,B01,507331,Heinzman; Erica M.,14,0,30,16
1715642731430,EDS 206R,A00,507332,Staff,0,4,30,30
1715642731430,EDS 206R,B00,507343,Staff,15,0,30,15
1715642732457,EDS 250,A00,507344,Hemans; Patricia Ann Benitez,20,0,40,20
1715642733487,EDS 281,A00,507345,Daly; Alan J.,18,0,18,0
1715642734513,EDS 284,A00,507350,Daly; Alan J.,16,0,16,0
1715642735540,EDS 286,A00,507359,Fine; Sarah,18,0,18,0
1715642736565,EDS 289C,A01,507361,Daly; Alan J.,18,0,18,0
1715642737595,EDS 290,A00,507366,Hofstetter; Carolyn,15,0,15,0
1715642738624,LIGM 5A,A00,507421,Fischer-Grunski; Eva K,17,0,20,3
1715642739650,LIGM 5B,A00,507423,Fischer-Grunski; Eva K,19,0,20,1
1715642740673,LIGM 5C,A00,507425,Fischer-Grunski; Eva K,19,0,20,1
1715642741702,LIIT 5AS,A00,507427,Carnelos; Chiara,20,0,20,0
1715642742728,LIIT 5BS,A00,507430,Carnelos; Chiara,20,0,20,0
1715642743758,LIIT 5CS,A00,507432,Carnelos; Chiara,20,0,20,0
1715642744790,LISP 5A,A00,507541,Munoz Sanchez; Alicia,11,0,20,9
1715642745820,LISP 5B,A00,507671,Munoz Sanchez; Alicia,8,0,20,12
1715642746849,LISP 5C,A00,507696,Munoz Sanchez; Alicia,8,0,20,12
1715642747876,MAE 197,001,528363,Boechler; Nicholas Sebastia,9998,0,9999,1
1715642748903,MATH 197,001,523477,Kedlaya; Kiran S.,9994,0,9999,5
1715642748903,MATH 197,002,563811,Zhang; Danna,9994,0,9999,5
1715642748903,MATH 197,003,628552,Dumitriu; Ioana,9998,0,9999,1
1715642748903,MATH 197,004,660885,Floyd; Eric,9998,0,9999,1
1715642749929,MCWP 40R,A00,518780,Staff,1,0,20,19
1715642749929,MCWP 40R,B00,518781,Staff,10,0,20,10
1715642749929,MCWP 40R,C00,518783,Staff,5,0,20,15
1715642750957,MCWP 50R,A00,518791,Staff,0,1,20,20
1715642750957,MCWP 50R,B00,518792,Staff,0,2,20,20
1715642750957,MCWP 50R,C00,518793,Staff,0,4,20,20
1715642750957,MCWP 50R,D00,518794,Staff,0,1,20,20
1715642750957,MCWP 50R,E00,518795,Staff,0,2,20,20
1715642750957,MCWP 50R,F00,518796,Staff,0,1,20,20
1715642750957,MCWP 50R,G00,518797,Staff,0,1,20,20
1715642751987,MMW 12R,A01,514034,Herbst; Matthew,0,2,16,16
1715642751987,MMW 12R,A02,514035,Herbst; Matthew,0,0,16,16
1715642753011,MMW 13R,A01,514037,Staff,0,5,16,16
1715642753011,MMW 13R,A02,514039,Staff,0,5,16,16
1715642753011,MMW 13R,A03,628519,Staff,0,4,16,16
1715642755059,SIO 295LS,A00,523233,Staff,10,0,30,20
1715642756087,SIO 295S,A00,523232,Staff,10,0,30,20
1715642757116,SIOC 290S,A01,637330,Merrifield; Mark A,21,0,30,9
1715642758142,SIOC 291S,A01,637333,Gabriel; Corey John,21,0,30,9
1715642759167,SOCI 117,A01,494376,Staff,0,5,5,5
1715642760191,WES 237B,A00,494380,Staff,10,0,20,10
1715642762260,AESE 279B,A00,494370,Wade; Jon P,0,0,33,33
1715642763285,AIP 97,001,660915,Van Den Einde; Yael Dahlia,9998,0,9999,1
1715642764314,AIP 197,001,627712,Vespa; Emanuel Ignacio,9995,0,9999,4
1715642764314,AIP 197,002,650778,Amir; On,9998,0,9999,1
1715642764314,AIP 197,003,650933,Avenancio-Leon; Carlos,9998,0,9999,1
1715642764314,AIP 197,004,658530,Heyman; Gail D.,9998,0,9999,1
1715642764314,AIP 197,005,658631,Neal; Sonya E,9998,0,9999,1
1715642764314,AIP 197,006,658671,Du; Songzi,9998,0,9999,1
1715642765340,ANAR 135S,A00,494369,Braswell; Geoffrey E.,0,0,0,0
1715642766367,BENG 196,001,628496,Engler; Adam J.,9998,0,9999,1
1715642766367,BENG 196,002,660916,Watson; John Thomas,9998,0,9999,1
1715642767393,BISP 197,001,650773,Wilhelm; James E.,9994,0,9999,5
1715642767393,BISP 197,002,658904,Coleman; Aaron B.,9998,0,9999,1
1715642768423,CAT 124RS,A01,519847,Geibel; William,0,0,20,20
1715642769448,CAT 125RS,A01,515971,Geibel; William,0,0,20,20
1715642770478,CLRE 250,A00,511389,Morris; Sheldon,9992,0,9999,7
1715642771503,CLRE 251,A00,507176,Mehta; Ravindra L.,9992,0,9999,7
1715642771503,CLRE 251,B00,511410,Mehta; Ravindra L.,9998,0,9999,1
1715642772529,CLRE 252,A00,507189,Cuomo; Raphael Eduardo,9994,0,9999,5
1715642773555,CLRE 253,A00,507199,Vaida; Florin,9994,0,9999,5
1715642773555,CLRE 253,B00,507202,Vaida; Florin,9999,0,9999,0
1715642774581,CLRE 259,A00,507211,Patel; Hemal,9996,0,9999,3
1715642775604,CLRE 260,A00,507221,Cuomo; Raphael Eduardo,9999,0,9999,0
1715642776628,CLRE 297,001,507242,Cuomo; Raphael Eduardo,9999,0,9999,0
1715642777663,COGS 197,001,638244,Voytek; Bradley Thomas,9997,0,9999,2
1715642778688,CSE 191,A00,516875,Minnes Kemp; Mor Mia,9991,0,9999,8
1715642779712,CSE 197,001,637388,Minnes Kemp; Mor Mia,9992,0,9999,7
1715642780738,CSS 201S,A01,494383,Mignozzetti; Umberto,35,0,35,0
1715642781766,CSS 202S,A01,494387,Mignozzetti; Umberto,35,0,35,0
1715642782794,DSC 197,001,628532,Eldridge; Justin Matthew,9995,0,9999,4
1715642783819,EAP 100,A00,516065,Staff,9799,0,9999,200
1715642784847,ECE 45,A01,507414,Staff,31,0,60,29
1715642786895,ECE 111,A01,507420,Staff,11,0,50,39
1715642787924,ECE 197,001,548057,Sievenpiper; Daniel F.,9991,0,9999,8
1715642788949,EDS 115,A00,507243,Choi; Bailey Miyeon,6,0,28,22
1715642789976,EDS 117,A01,494379,Staff,0,6,34,35
1715642791001,EDS 125,A00,507246,Hopkins; Megan Beth,7,0,30,23
1715642792028,EDS 128A,A01,507264,Fargason; Sharon Gayle,5,0,26,21
1715642793053,EDS 128B,A01,507293,Pappas; Elizabeth,9,0,30,21
1715642794079,EDS 139,A00,507294,Fargason; Sharon Gayle,9,0,30,21
1715642794079,EDS 139,B00,507313,Pappas; Elizabeth,9,0,30,21
1715642795107,EDS 201,A00,507315,Staff,10,0,30,20
1715642796133,EDS 203,A01,507317,Halter; Christopher P.,10,0,30,20
1715642797158,EDS 204R,A01,507319,Halter; Christopher P.,0,3,30,30
1715642797158,EDS 204R,B01,507331,Heinzman; Erica M.,14,0,30,16
1715642798187,EDS 206R,A00,507332,Staff,0,4,30,30
1715642798187,EDS 206R,B00,507343,Staff,15,0,30,15
1715642799214,EDS 250,A00,507344,Hemans; Patricia Ann Benitez,20,0,40,20
1715642800240,EDS 281,A00,507345,Daly; Alan J.,18,0,18,0
1715642801265,EDS 284,A00,507350,Daly; Alan J.,16,0,16,0
1715642802289,EDS 286,A00,507359,Fine; Sarah,18,0,18,0
1715642803313,EDS 289C,A01,507361,Daly; Alan J.,18,0,18,0
1715642804342,EDS 290,A00,507366,Hofstetter; Carolyn,15,0,15,0
1715642805368,LIGM 5A,A00,507421,Fischer-Grunski; Eva K,17,0,20,3
1715642806395,LIGM 5B,A00,507423,Fischer-Grunski; Eva K,19,0,20,1
1715642807422,LIGM 5C,A00,507425,Fischer-Grunski; Eva K,19,0,20,1
1715642808452,LIIT 5AS,A00,507427,Carnelos; Chiara,20,0,20,0
1715642809503,LIIT 5BS,A00,507430,Carnelos; Chiara,20,0,20,0
1715642810533,LIIT 5CS,A00,507432,Carnelos; Chiara,20,0,20,0
1715642811559,LISP 5A,A00,507541,Munoz Sanchez; Alicia,11,0,20,9
1715642812587,LISP 5B,A00,507671,Munoz Sanchez; Alicia,8,0,20,12
1715642813612,LISP 5C,A00,507696,Munoz Sanchez; Alicia,8,0,20,12
1715642814638,MAE 197,001,528363,Boechler; Nicholas Sebastia,9998,0,9999,1
1715642815669,MATH 197,001,523477,Kedlaya; Kiran S.,9994,0,9999,5
1715642815669,MATH 197,002,563811,Zhang; Danna,9994,0,9999,5
1715642815669,MATH 197,003,628552,Dumitriu; Ioana,9998,0,9999,1
1715642815669,MATH 197,004,660885,Floyd; Eric,9998,0,9999,1
1715642816697,MCWP 40R,A00,518780,Staff,1,0,20,19
1715642816697,MCWP 40R,B00,518781,Staff,10,0,20,10
1715642816697,MCWP 40R,C00,518783,Staff,5,0,20,15
1715642817723,MCWP 50R,A00,518791,Staff,0,1,20,20
1715642817723,MCWP 50R,B00,518792,Staff,0,2,20,20
1715642817723,MCWP 50R,C00,518793,Staff,0,4,20,20
1715642817723,MCWP 50R,D00,518794,Staff,0,1,20,20
1715642817723,MCWP 50R,E00,518795,Staff,0,2,20,20
1715642817723,MCWP 50R,F00,518796,Staff,0,1,20,20
1715642817723,MCWP 50R,G00,518797,Staff,0,1,20,20
1715642818749,MMW 12R,A01,514034,Herbst; Matthew,0,2,16,16
1715642818749,MMW 12R,A02,514035,Herbst; Matthew,0,0,16,16
1715642819777,MMW 13R,A01,514037,Staff,0,5,16,16
1715642819777,MMW 13R,A02,514039,Staff,0,5,16,16
1715642819777,MMW 13R,A03,628519,Staff,0,4,16,16
1715642821831,SIO 295LS,A00,523233,Staff,10,0,30,20
1715642822858,SIO 295S,A00,523232,Staff,10,0,30,20
1715642823890,SIOC 290S,A01,637330,Merrifield; Mark A,21,0,30,9
1715642824915,SIOC 291S,A01,637333,Gabriel; Corey John,21,0,30,9
1715642825940,SOCI 117,A01,494376,Staff,0,5,5,5
1715642826968,WES 237B,A00,494380,Staff,10,0,20,10
1715642829045,AESE 279B,A00,494370,Wade; Jon P,0,0,33,33
1715642830070,AIP 97,001,660915,Van Den Einde; Yael Dahlia,9998,0,9999,1
1715642831097,AIP 197,001,627712,Vespa; Emanuel Ignacio,9995,0,9999,4
1715642831097,AIP 197,002,650778,Amir; On,9998,0,9999,1
1715642831097,AIP 197,003,650933,Avenancio-Leon; Carlos,9998,0,9999,1
1715642831097,AIP 197,004,658530,Heyman; Gail D.,9998,0,9999,1
1715642831097,AIP 197,005,658631,Neal; Sonya E,9998,0,9999,1
1715642831097,AIP 197,006,658671,Du; Songzi,9998,0,9999,1
1715642832123,ANAR 135S,A00,494369,Braswell; Geoffrey E.,0,0,0,0
1715642833149,BENG 196,001,628496,Engler; Adam J.,9998,0,9999,1
1715642833149,BENG 196,002,660916,Watson; John Thomas,9998,0,9999,1
1715642834178,BISP 197,001,650773,Wilhelm; James E.,9994,0,9999,5
1715642834178,BISP 197,002,658904,Coleman; Aaron B.,9998,0,9999,1
1715642835207,CAT 124RS,A01,519847,Geibel; William,0,0,20,20
1715642836231,CAT 125RS,A01,515971,Geibel; William,0,0,20,20
1715642837261,CLRE 250,A00,511389,Morris; Sheldon,9992,0,9999,7
1715642838291,CLRE 251,A00,507176,Mehta; Ravindra L.,9992,0,9999,7
1715642838291,CLRE 251,B00,511410,Mehta; Ravindra L.,9998,0,9999,1
1715642839319,CLRE 252,A00,507189,Cuomo; Raphael Eduardo,9994,0,9999,5
1715642840347,CLRE 253,A00,507199,Vaida; Florin,9994,0,9999,5
1715642840347,CLRE 253,B00,507202,Vaida; Florin,9999,0,9999,0
1715642841375,CLRE 259,A00,507211,Patel; Hemal,9996,0,9999,3
1715642842400,CLRE 260,A00,507221,Cuomo; Raphael Eduardo,9999,0,9999,0
1715642843424,CLRE 297,001,507242,Cuomo; Raphael Eduardo,9999,0,9999,0
1715642844449,COGS 197,001,638244,Voytek; Bradley Thomas,9997,0,9999,2
1715642845474,CSE 191,A00,516875,Minnes Kemp; Mor Mia,9991,0,9999,8
1715642846499,CSE 197,001,637388,Minnes Kemp; Mor Mia,9992,0,9999,7
1715642847527,CSS 201S,A01,494383,Mignozzetti; Umberto,35,0,35,0
1715642848552,CSS 202S,A01,494387,Mignozzetti; Umberto,35,0,35,0
1715642849577,DSC 197,001,628532,Eldridge; Justin Matthew,9995,0,9999,4
1715642850604,EAP 100,A00,516065,Staff,9799,0,9999,200
1715642851639,ECE 45,A01,507414,Staff,31,0,60,29
1715642853690,ECE 111,A01,507420,Staff,11,0,50,39
1715642854717,ECE 197,001,548057,Sievenpiper; Daniel F.,9991,0,9999,8
1715642855802,EDS 115,A00,507243,Choi; Bailey Miyeon,6,0,28,22
1715642856828,EDS 117,A01,494379,Staff,0,6,34,35
1715642857868,EDS 125,A00,507246,Hopkins; Megan Beth,7,0,30,23
1715642858900,EDS 128A,A01,507264,Fargason; Sharon Gayle,5,0,26,21
1715642859931,EDS 128B,A01,507293,Pappas; Elizabeth,9,0,30,21
1715642860954,EDS 139,A00,507294,Fargason; Sharon Gayle,9,0,30,21
1715642860954,EDS 139,B00,507313,Pappas; Elizabeth,9,0,30,21
1715642861983,EDS 201,A00,507315,Staff,10,0,30,20
1715642863012,EDS 203,A01,507317,Halter; Christopher P.,10,0,30,20
1715642864041,EDS 204R,A01,507319,Halter; Christopher P.,0,3,30,30
1715642864041,EDS 204R,B01,507331,Heinzman; Erica M.,14,0,30,16
1715642865070,EDS 206R,A00,507332,Staff,0,4,30,30
1715642865070,EDS 206R,B00,507343,Staff,15,0,30,15
1715642866096,EDS 250,A00,507344,Hemans; Patricia Ann Benitez,20,0,40,20
1715642867123,EDS 281,A00,507345,Daly; Alan J.,18,0,18,0
1715642868149,EDS 284,A00,507350,Daly; Alan J.,16,0,16,0
1715642869176,EDS 286,A00,507359,Fine; Sarah,18,0,18,0
1715642870204,EDS 289C,A01,507361,Daly; Alan J.,18,0,18,0
1715642871229,EDS 290,A00,507366,Hofstetter; Carolyn,15,0,15,0
1715642872255,LIGM 5A,A00,507421,Fischer-Grunski; Eva K,17,0,20,3
1715642873282,LIGM 5B,A00,507423,Fischer-Grunski; Eva K,19,0,20,1
1715642874311,LIGM 5C,A00,507425,Fischer-Grunski; Eva K,19,0,20,1
1715642875337,LIIT 5AS,A00,507427,Carnelos; Chiara,20,0,20,0
1715642876365,LIIT 5BS,A00,507430,Carnelos; Chiara,20,0,20,0
1715642877390,LIIT 5CS,A00,507432,Carnelos; Chiara,20,0,20,0
1715642878420,LISP 5A,A00,507541,Munoz Sanchez; Alicia,11,0,20,9
1715642879449,LISP 5B,A00,507671,Munoz Sanchez; Alicia,8,0,20,12
1715642880475,LISP 5C,A00,507696,Munoz Sanchez; Alicia,8,0,20,12
1715642881501,MAE 197,001,528363,Boechler; Nicholas Sebastia,9998,0,9999,1
1715642882531,MATH 197,001,523477,Kedlaya; Kiran S.,9994,0,9999,5
1715642882531,MATH 197,002,563811,Zhang; Danna,9994,0,9999,5
1715642882531,MATH 197,003,628552,Dumitriu; Ioana,9998,0,9999,1
1715642882531,MATH 197,004,660885,Floyd; Eric,9998,0,9999,1
1715642883559,MCWP 40R,A00,518780,Staff,1,0,20,19
1715642883559,MCWP 40R,B00,518781,Staff,10,0,20,10
1715642883559,MCWP 40R,C00,518783,Staff,5,0,20,15
1715642884587,MCWP 50R,A00,518791,Staff,0,1,20,20
1715642884587,MCWP 50R,B00,518792,Staff,0,2,20,20
1715642884587,MCWP 50R,C00,518793,Staff,0,4,20,20
1715642884587,MCWP 50R,D00,518794,Staff,0,1,20,20
1715642884587,MCWP 50R,E00,518795,Staff,0,2,20,20
1715642884587,MCWP 50R,F00,518796,Staff,0,1,20,20
1715642884587,MCWP 50R,G00,518797,Staff,0,1,20,20
1715642885615,MMW 12R,A01,514034,Herbst; Matthew,0,2,16,16
1715642885615,MMW 12R,A02,514035,Herbst; Matthew,0,0,16,16
1715642886643,MMW 13R,A01,514037,Staff,0,5,16,16
1715642886643,MMW 13R,A02,514039,Staff,0,5,16,16
1715642886643,MMW 13R,A03,628519,Staff,0,4,16,16
1715642888694,SIO 295LS,A00,523233,Staff,10,0,30,20
1715642889718,SIO 295S,A00,523232,Staff,10,0,30,20
1715642890744,SIOC 290S,A01,637330,Merrifield; Mark A,21,0,30,9
1715642891768,SIOC 291S,A01,637333,Gabriel; Corey John,21,0,30,9
1715642892793,SOCI 117,A01,494376,Staff,0,5,5,5
1715642893818,WES 237B,A00,494380,Staff,10,0,20,10
1715642895884,AESE 279B,A00,494370,Wade; Jon P,0,0,33,33
1715642896909,AIP 97,001,660915,Van Den Einde; Yael Dahlia,9998,0,9999,1
1715642897936,AIP 197,001,627712,Vespa; Emanuel Ignacio,9995,0,9999,4
1715642897936,AIP 197,002,650778,Amir; On,9998,0,9999,1
1715642897936,AIP 197,003,650933,Avenancio-Leon; Carlos,9998,0,9999,1
1715642897936,AIP 197,004,658530,Heyman; Gail D.,9998,0,9999,1
1715642897936,AIP 197,005,658631,Neal; Sonya E,9998,0,9999,1
1715642897936,AIP 197,006,658671,Du; Songzi,9998,0,9999,1
1715642898967,ANAR 135S,A00,494369,Braswell; Geoffrey E.,0,0,0,0
1715642899993,BENG 196,001,628496,Engler; Adam J.,9998,0,9999,1
1715642899993,BENG 196,002,660916,Watson; John Thomas,9998,0,9999,1
1715642901018,BISP 197,001,650773,Wilhelm; James E.,9994,0,9999,5
1715642901018,BISP 197,002,658904,Coleman; Aaron B.,9998,0,9999,1
1715642902043,CAT 124RS,A01,519847,Geibel; William,0,0,20,20
1715642903070,CAT 125RS,A01,515971,Geibel; William,0,0,20,20
1715642904095,CLRE 250,A00,511389,Morris; Sheldon,9992,0,9999,7
1715642905129,CLRE 251,A00,507176,Mehta; Ravindra L.,9992,0,9999,7
1715642905129,CLRE 251,B00,511410,Mehta; Ravindra L.,9998,0,9999,1
1715642906154,CLRE 252,A00,507189,Cuomo; Raphael Eduardo,9994,0,9999,5
1715642907185,CLRE 253,A00,507199,Vaida; Florin,9994,0,9999,5
1715642907185,CLRE 253,B00,507202,Vaida; Florin,9999,0,9999,0
1715642908213,CLRE 259,A00,507211,Patel; Hemal,9996,0,9999,3
1715642909239,CLRE 260,A00,507221,Cuomo; Raphael Eduardo,9999,0,9999,0
1715642910267,CLRE 297,001,507242,Cuomo; Raphael Eduardo,9999,0,9999,0
1715642911323,COGS 197,001,638244,Voytek; Bradley Thomas,9997,0,9999,2
1715642912350,CSE 191,A00,516875,Minnes Kemp; Mor Mia,9991,0,9999,8
1715642913378,CSE 197,001,637388,Minnes Kemp; Mor Mia,9992,0,9999,7
1715642914405,CSS 201S,A01,494383,Mignozzetti; Umberto,35,0,35,0
1715642915430,CSS 202S,A01,494387,Mignozzetti; Umberto,35,0,35,0
1715642916457,DSC 197,001,628532,Eldridge; Justin Matthew,9995,0,9999,4
1715642917483,EAP 100,A00,516065,Staff,9799,0,9999,200
1715642918510,ECE 45,A01,507414,Staff,31,0,60,29
1715642920566,ECE 111,A01,507420,Staff,11,0,50,39
1715642921591,ECE 197,001,548057,Sievenpiper; Daniel F.,9991,0,9999,8
1715642922620,EDS 115,A00,507243,Choi; Bailey Miyeon,6,0,28,22
1715642923645,EDS 117,A01,494379,Staff,0,6,34,35
1715642924672,EDS 125,A00,507246,Hopkins; Megan Beth,7,0,30,23
1715642925698,EDS 128A,A01,507264,Fargason; Sharon Gayle,5,0,26,21
1715642926725,EDS 128B,A01,507293,Pappas; Elizabeth,9,0,30,21
1715642927752,EDS 139,A00,507294,Fargason; Sharon Gayle,9,0,30,21
1715642927752,EDS 139,B00,507313,Pappas; Elizabeth,9,0,30,21
1715642928778,EDS 201,A00,507315,Staff,10,0,30,20
1715642929807,EDS 203,A01,507317,Halter; Christopher P.,10,0,30,20
1715642930837,EDS 204R,A01,507319,Halter; Christopher P.,0,3,30,30
1715642930837,EDS 204R,B01,507331,Heinzman; Erica M.,14,0,30,16
1715642931863,EDS 206R,A00,507332,Staff,0,4,30,30
1715642931863,EDS 206R,B00,507343,Staff,15,0,30,15
1715642932888,EDS 250,A00,507344,Hemans; Patricia Ann Benitez,20,0,40,20
1715642933918,EDS 281,A00,507345,Daly; Alan J.,18,0,18,0
1715642934941,EDS 284,A00,507350,Daly; Alan J.,16,0,16,0
1715642935967,EDS 286,A00,507359,Fine; Sarah,18,0,18,0
1715642936992,EDS 289C,A01,507361,Daly; Alan J.,18,0,18,0
1715642938039,EDS 290,A00,507366,Hofstetter; Carolyn,15,0,15,0
1715642939065,LIGM 5A,A00,507421,Fischer-Grunski; Eva K,17,0,20,3
1715642940095,LIGM 5B,A00,507423,Fischer-Grunski; Eva K,19,0,20,1
1715642941119,LIGM 5C,A00,507425,Fischer-Grunski; Eva K,19,0,20,1
1715642942146,LIIT 5AS,A00,507427,Carnelos; Chiara,20,0,20,0
1715642943171,LIIT 5BS,A00,507430,Carnelos; Chiara,20,0,20,0
1715642944198,LIIT 5CS,A00,507432,Carnelos; Chiara,20,0,20,0
1715642945228,LISP 5A,A00,507541,Munoz Sanchez; Alicia,11,0,20,9
1715642946256,LISP 5B,A00,507671,Munoz Sanchez; Alicia,8,0,20,12
1715642947285,LISP 5C,A00,507696,Munoz Sanchez; Alicia,8,0,20,12
1715642948310,MAE 197,001,528363,Boechler; Nicholas Sebastia,9998,0,9999,1
1715642949344,MATH 197,001,523477,Kedlaya; Kiran S.,9994,0,9999,5
1715642949344,MATH 197,002,563811,Zhang; Danna,9994,0,9999,5
1715642949344,MATH 197,003,628552,Dumitriu; Ioana,9998,0,9999,1
1715642949344,MATH 197,004,660885,Floyd; Eric,9998,0,9999,1
1715642950369,MCWP 40R,A00,518780,Staff,1,0,20,19
1715642950369,MCWP 40R,B00,518781,Staff,10,0,20,10
1715642950369,MCWP 40R,C00,518783,Staff,5,0,20,15
1715642951396,MCWP 50R,A00,518791,Staff,0,1,20,20
1715642951396,MCWP 50R,B00,518792,Staff,0,2,20,20
1715642951396,MCWP 50R,C00,518793,Staff,0,4,20,20
1715642951396,MCWP 50R,D00,518794,Staff,0,1,20,20
1715642951396,MCWP 50R,E00,518795,Staff,0,2,20,20
1715642951396,MCWP 50R,F00,518796,Staff,0,1,20,20
1715642951396,MCWP 50R,G00,518797,Staff,0,1,20,20
1715642952421,MMW 12R,A01,514034,Herbst; Matthew,0,2,16,16
1715642952421,MMW 12R,A02,514035,Herbst; Matthew,0,0,16,16
1715642953445,MMW 13R,A01,514037,Staff,0,5,16,16
1715642953445,MMW 13R,A02,514039,Staff,0,5,16,16
1715642953445,MMW 13R,A03,628519,Staff,0,4,16,16
1715642955501,SIO 295LS,A00,523233,Staff,10,0,30,20
1715642956526,SIO 295S,A00,523232,Staff,10,0,30,20
1715642957553,SIOC 290S,A01,637330,Merrifield; Mark A,21,0,30,9
1715642958579,SIOC 291S,A01,637333,Gabriel; Corey John,21,0,30,9
1715642959608,SOCI 117,A01,494376,Staff,0,5,5,5
1715642960632,WES 237B,A00,494380,Staff,10,0,20,10
1715642962695,AESE 279B,A00,494370,Wade; Jon P,0,0,33,33
1715642963721,AIP 97,001,660915,Van Den Einde; Yael Dahlia,9998,0,9999,1
1715642964753,AIP 197,001,627712,Vespa; Emanuel Ignacio,9995,0,9999,4
1715642964753,AIP 197,002,650778,Amir; On,9998,0,9999,1
1715642964753,AIP 197,003,650933,Avenancio-Leon; Carlos,9998,0,9999,1
1715642964753,AIP 197,004,658530,Heyman; Gail D.,9998,0,9999,1
1715642964753,AIP 197,005,658631,Neal; Sonya E,9998,0,9999,1
1715642964753,AIP 197,006,658671,Du; Songzi,9998,0,9999,1
1715642965777,ANAR 135S,A00,494369,Braswell; Geoffrey E.,0,0,0,0
1715642966805,BENG 196,001,628496,Engler; Adam J.,9998,0,9999,1
1715642966805,BENG 196,002,660916,Watson; John Thomas,9998,0,9999,1
1715642967835,BISP 197,001,650773,Wilhelm; James E.,9994,0,9999,5
1715642967835,BISP 197,002,658904,Coleman; Aaron B.,9998,0,9999,1
1715642968861,CAT 124RS,A01,519847,Geibel; William,0,0,20,20
1715642969890,CAT 125RS,A01,515971,Geibel; William,0,0,20,20
1715642970919,CLRE 250,A00,511389,Morris; Sheldon,9992,0,9999,7
1715642971946,CLRE 251,A00,507176,Mehta; Ravindra L.,9992,0,9999,7
1715642971946,CLRE 251,B00,511410,Mehta; Ravindra L.,9998,0,9999,1
1715642972975,CLRE 252,A00,507189,Cuomo; Raphael Eduardo,9994,0,9999,5
1715642974005,CLRE 253,A00,507199,Vaida; Florin,9994,0,9999,5
1715642974005,CLRE 253,B00,507202,Vaida; Florin,9999,0,9999,0
1715642975031,CLRE 259,A00,507211,Patel; Hemal,9996,0,9999,3
1715642976060,CLRE 260,A00,507221,Cuomo; Raphael Eduardo,9999,0,9999,0
1715642977085,CLRE 297,001,507242,Cuomo; Raphael Eduardo,9999,0,9999,0
1715642978110,COGS 197,001,638244,Voytek; Bradley Thomas,9997,0,9999,2
1715642979140,CSE 191,A00,516875,Minnes Kemp; Mor Mia,9991,0,9999,8
1715642980169,CSE 197,001,637388,Minnes Kemp; Mor Mia,9992,0,9999,7
1715642981197,CSS 201S,A01,494383,Mignozzetti; Umberto,35,0,35,0
1715642982228,CSS 202S,A01,494387,Mignozzetti; Umberto,35,0,35,0
1715642983258,DSC 197,001,628532,Eldridge; Justin Matthew,9995,0,9999,4
1715642984287,EAP 100,A00,516065,Staff,9799,0,9999,200
1715642985320,ECE 45,A01,507414,Staff,31,0,60,29
1715642987372,ECE 111,A01,507420,Staff,11,0,50,39
1715642988399,ECE 197,001,548057,Sievenpiper; Daniel F.,9991,0,9999,8
1715642989430,EDS 115,A00,507243,Choi; Bailey Miyeon,6,0,28,22
1715642990458,EDS 117,A01,494379,Staff,0,6,34,35
1715642991483,EDS 125,A00,507246,Hopkins; Megan Beth,7,0,30,23
1715642992510,EDS 128A,A01,507264,Fargason; Sharon Gayle,5,0,26,21
1715642993537,EDS 128B,A01,507293,Pappas; Elizabeth,9,0,30,21
1715642994563,EDS 139,A00,507294,Fargason; Sharon Gayle,9,0,30,21
1715642994563,EDS 139,B00,507313,Pappas; Elizabeth,9,0,30,21
1715642995592,EDS 201,A00,507315,Staff,10,0,30,20
1715642996619,EDS 203,A01,507317,Halter; Christopher P.,10,0,30,20
1715642997649,EDS 204R,A01,507319,Halter; Christopher P.,0,3,30,30
1715642997649,EDS 204R,B01,507331,Heinzman; Erica M.,14,0,30,16
1715642998675,EDS 206R,A00,507332,Staff,0,4,30,30
1715642998675,EDS 206R,B00,507343,Staff,15,0,30,15
1715642999702,EDS 250,A00,507344,Hemans; Patricia Ann Benitez,20,0,40,20
1715643000728,EDS 281,A00,507345,Daly; Alan J.,18,0,18,0
1715643001755,EDS 284,A00,507350,Daly; Alan J.,16,0,16,0
1715643002781,EDS 286,A00,507359,Fine; Sarah,18,0,18,0
1715643003810,EDS 289C,A01,507361,Daly; Alan J.,18,0,18,0
1715643004836,EDS 290,A00,507366,Hofstetter; Carolyn,15,0,15,0
1715643005863,LIGM 5A,A00,507421,Fischer-Grunski; Eva K,17,0,20,3
1715643006893,LIGM 5B,A00,507423,Fischer-Grunski; Eva K,19,0,20,1
1715643007919,LIGM 5C,A00,507425,Fischer-Grunski; Eva K,19,0,20,1
1715643008949,LIIT 5AS,A00,507427,Carnelos; Chiara,20,0,20,0
1715643009998,LIIT 5BS,A00,507430,Carnelos; Chiara,20,0,20,0
1715643011024,LIIT 5CS,A00,507432,Carnelos; Chiara,20,0,20,0
1715643012051,LISP 5A,A00,507541,Munoz Sanchez; Alicia,11,0,20,9
1715643013077,LISP 5B,A00,507671,Munoz Sanchez; Alicia,8,0,20,12
1715643014102,LISP 5C,A00,507696,Munoz Sanchez; Alicia,8,0,20,12
1715643015127,MAE 197,001,528363,Boechler; Nicholas Sebastia,9998,0,9999,1
1715643016159,MATH 197,001,523477,Kedlaya; Kiran S.,9994,0,9999,5
1715643016159,MATH 197,002,563811,Zhang; Danna,9994,0,9999,5
1715643016159,MATH 197,003,628552,Dumitriu; Ioana,9998,0,9999,1
1715643016159,MATH 197,004,660885,Floyd; Eric,9998,0,9999,1
1715643017185,MCWP 40R,A00,518780,Staff,1,0,20,19
1715643017185,MCWP 40R,B00,518781,Staff,10,0,20,10
1715643017185,MCWP 40R,C00,518783,Staff,5,0,20,15
1715643018210,MCWP 50R,A00,518791,Staff,0,1,20,20
1715643018210,MCWP 50R,B00,518792,Staff,0,2,20,20
1715643018210,MCWP 50R,C00,518793,Staff,0,4,20,20
1715643018210,MCWP 50R,D00,518794,Staff,0,1,20,20
1715643018210,MCWP 50R,E00,518795,Staff,0,2,20,20
1715643018210,MCWP 50R,F00,518796,Staff,0,1,20,20
1715643018210,MCWP 50R,G00,518797,Staff,0,1,20,20
1715643019240,MMW 12R,A01,514034,Herbst; Matthew,0,2,16,16
1715643019240,MMW 12R,A02,514035,Herbst; Matthew,0,0,16,16
1715643020266,MMW 13R,A01,514037,Staff,0,5,16,16
1715643020266,MMW 13R,A02,514039,Staff,0,5,16,16
1715643020266,MMW 13R,A03,628519,Staff,0,4,16,16
1715643022315,SIO 295LS,A00,523233,Staff,10,0,30,20
1715643023345,SIO 295S,A00,523232,Staff,10,0,30,20
1715643024375,SIOC 290S,A01,637330,Merrifield; Mark A,21,0,30,9
1715643025402,SIOC 291S,A01,637333,Gabriel; Corey John,21,0,30,9
1715643026432,SOCI 117,A01,494376,Staff,0,5,5,5
1715643027460,WES 237B,A00,494380,Staff,10,0,20,10
1715643029535,AESE 279B,A00,494370,Wade; Jon P,0,0,33,33
1715643030561,AIP 97,001,660915,Van Den Einde; Yael Dahlia,9998,0,9999,1
1715643031597,AIP 197,001,627712,Vespa; Emanuel Ignacio,9995,0,9999,4
1715643031597,AIP 197,002,650778,Amir; On,9998,0,9999,1
1715643031597,AIP 197,003,650933,Avenancio-Leon; Carlos,9998,0,9999,1
1715643031597,AIP 197,004,658530,Heyman; Gail D.,9998,0,9999,1
1715643031597,AIP 197,005,658631,Neal; Sonya E,9998,0,9999,1
1715643031597,AIP 197,006,658671,Du; Songzi,9998,0,9999,1
1715643032622,ANAR 135S,A00,494369,Braswell; Geoffrey E.,0,0,0,0
1715643033650,BENG 196,001,628496,Engler; Adam J.,9998,0,9999,1
1715643033650,BENG 196,002,660916,Watson; John Thomas,9998,0,9999,1
1715643034675,BISP 197,001,650773,Wilhelm; James E.,9994,0,9999,5
1715643034675,BISP 197,002,658904,Coleman; Aaron B.,9998,0,9999,1
1715643035705,CAT 124RS,A01,519847,Geibel; William,0,0,20,20
1715643036730,CAT 125RS,A01,515971,Geibel; William,0,0,20,20
1715643037755,CLRE 250,A00,511389,Morris; Sheldon,9992,0,9999,7
1715643038783,CLRE 251,A00,507176,Mehta; Ravindra L.,9992,0,9999,7
1715643038783,CLRE 251,B00,511410,Mehta; Ravindra L.,9998,0,9999,1
1715643039814,CLRE 252,A00,507189,Cuomo; Raphael Eduardo,9994,0,9999,5
1715643040838,CLRE 253,A00,507199,Vaida; Florin,9994,0,9999,5
1715643040838,CLRE 253,B00,507202,Vaida; Florin,9999,0,9999,0
1715643041865,CLRE 259,A00,507211,Patel; Hemal,9996,0,9999,3
1715643042889,CLRE 260,A00,507221,Cuomo; Raphael Eduardo,9999,0,9999,0
1715643043915,CLRE 297,001,507242,Cuomo; Raphael Eduardo,9999,0,9999,0
1715643044943,COGS 197,001,638244,Voytek; Bradley Thomas,9997,0,9999,2
1715643045989,CSE 191,A00,516875,Minnes Kemp; Mor Mia,9991,0,9999,8
1715643047013,CSE 197,001,637388,Minnes Kemp; Mor Mia,9992,0,9999,7
1715643048040,CSS 201S,A01,494383,Mignozzetti; Umberto,35,0,35,0
1715643049065,CSS 202S,A01,494387,Mignozzetti; Umberto,35,0,35,0
1715643050091,DSC 197,001,628532,Eldridge; Justin Matthew,9995,0,9999,4
1715643051118,EAP 100,A00,516065,Staff,9799,0,9999,200
1715643052147,ECE 45,A01,507414,Staff,31,0,60,29
1715643054206,ECE 111,A01,507420,Staff,11,0,50,39
1715643055232,ECE 197,001,548057,Sievenpiper; Daniel F.,9991,0,9999,8
1715643056261,EDS 115,A00,507243,Choi; Bailey Miyeon,6,0,28,22
1715643057289,EDS 117,A01,494379,Staff,0,6,34,35
1715643058316,EDS 125,A00,507246,Hopkins; Megan Beth,7,0,30,23
1715643059345,EDS 128A,A01,507264,Fargason; Sharon Gayle,5,0,26,21
1715643060372,EDS 128B,A01,507293,Pappas; Elizabeth,9,0,30,21
1715643061397,EDS 139,A00,507294,Fargason; Sharon Gayle,9,0,30,21
1715643061397,EDS 139,B00,507313,Pappas; Elizabeth,9,0,30,21
1715643062425,EDS 201,A00,507315,Staff,10,0,30,20
1715643063450,EDS 203,A01,507317,Halter; Christopher P.,10,0,30,20
1715643064476,EDS 204R,A01,507319,Halter; Christopher P.,0,3,30,30
1715643064476,EDS 204R,B01,507331,Heinzman; Erica M.,14,0,30,16
1715643065506,EDS 206R,A00,507332,Staff,0,4,30,30
1715643065506,EDS 206R,B00,507343,Staff,15,0,30,15
1715643066536,EDS 250,A00,507344,Hemans; Patricia Ann Benitez,20,0,40,20
1715643067561,EDS 281,A00,507345,Daly; Alan J.,18,0,18,0
1715643068588,EDS 284,A00,507350,Daly; Alan J.,16,0,16,0
1715643069620,EDS 286,A00,507359,Fine; Sarah,18,0,18,0
1715643070649,EDS 289C,A01,507361,Daly; Alan J.,18,0,18,0
1715643071678,EDS 290,A00,507366,Hofstetter; Carolyn,15,0,15,0
1715643072706,LIGM 5A,A00,507421,Fischer-Grunski; Eva K,17,0,20,3
1715643073734,LIGM 5B,A00,507423,Fischer-Grunski; Eva K,19,0,20,1
1715643074763,LIGM 5C,A00,507425,Fischer-Grunski; Eva K,19,0,20,1
1715643075788,LIIT 5AS,A00,507427,Carnelos; Chiara,20,0,20,0
1715643076815,LIIT 5BS,A00,507430,Carnelos; Chiara,20,0,20,0
1715643077842,LIIT 5CS,A00,507432,Carnelos; Chiara,20,0,20,0
1715643078871,LISP 5A,A00,507541,Munoz Sanchez; Alicia,11,0,20,9
1715643079898,LISP 5B,A00,507671,Munoz Sanchez; Alicia,8,0,20,12
1715643080924,LISP 5C,A00,507696,Munoz Sanchez; Alicia,8,0,20,12
1715643081955,MAE 197,001,528363,Boechler; Nicholas Sebastia,9998,0,9999,1
1715643082983,MATH 197,001,523477,Kedlaya; Kiran S.,9994,0,9999,5
1715643082983,MATH 197,002,563811,Zhang; Danna,9994,0,9999,5
1715643082983,MATH 197,003,628552,Dumitriu; Ioana,9998,0,9999,1
1715643082983,MATH 197,004,660885,Floyd; Eric,9998,0,9999,1
1715643084016,MCWP 40R,A00,518780,Staff,1,0,20,19
1715643084016,MCWP 40R,B00,518781,Staff,10,0,20,10
1715643084016,MCWP 40R,C00,518783,Staff,5,0,20,15
1715643085042,MCWP 50R,A00,518791,Staff,0,1,20,20
1715643085042,MCWP 50R,B00,518792,Staff,0,2,20,20
1715643085042,MCWP 50R,C00,518793,Staff,0,4,20,20
1715643085042,MCWP 50R,D00,518794,Staff,0,1,20,20
1715643085042,MCWP 50R,E00,518795,Staff,0,2,20,20
1715643085042,MCWP 50R,F00,518796,Staff,0,1,20,20
1715643085042,MCWP 50R,G00,518797,Staff,0,1,20,20
1715643086070,MMW 12R,A01,514034,Herbst; Matthew,0,2,16,16
1715643086070,MMW 12R,A02,514035,Herbst; Matthew,0,0,16,16
1715643087095,MMW 13R,A01,514037,Staff,0,5,16,16
1715643087095,MMW 13R,A02,514039,Staff,0,5,16,16
1715643087095,MMW 13R,A03,628519,Staff,0,4,16,16
1715643089148,SIO 295LS,A00,523233,Staff,10,0,30,20
1715643090175,SIO 295S,A00,523232,Staff,10,0,30,20
1715643091205,SIOC 290S,A01,637330,Merrifield; Mark A,21,0,30,9
1715643092235,SIOC 291S,A01,637333,Gabriel; Corey John,21,0,30,9
1715643093262,SOCI 117,A01,494376,Staff,0,5,5,5
1715643094288,WES 237B,A00,494380,Staff,10,0,20,10
1715643096357,AESE 279B,A00,494370,Wade; Jon P,0,0,33,33
1715643097386,AIP 97,001,660915,Van Den Einde; Yael Dahlia,9998,0,9999,1
1715643098413,AIP 197,001,627712,Vespa; Emanuel Ignacio,9995,0,9999,4
1715643098413,AIP 197,002,650778,Amir; On,9998,0,9999,1
1715643098413,AIP 197,003,650933,Avenancio-Leon; Carlos,9998,0,9999,1
1715643098413,AIP 197,004,658530,Heyman; Gail D.,9998,0,9999,1
1715643098413,AIP 197,005,658631,Neal; Sonya E,9998,0,9999,1
1715643098413,AIP 197,006,658671,Du; Songzi,9998,0,9999,1
1715643099441,ANAR 135S,A00,494369,Braswell; Geoffrey E.,0,0,0,0
1715643100467,BENG 196,001,628496,Engler; Adam J.,9998,0,9999,1
1715643100467,BENG 196,002,660916,Watson; John Thomas,9998,0,9999,1
1715643101497,BISP 197,001,650773,Wilhelm; James E.,9994,0,9999,5
1715643101497,BISP 197,002,658904,Coleman; Aaron B.,9998,0,9999,1
1715643102524,CAT 124RS,A01,519847,Geibel; William,0,0,20,20
1715643103549,CAT 125RS,A01,515971,Geibel; William,0,0,20,20
1715643104573,CLRE 250,A00,511389,Morris; Sheldon,9992,0,9999,7
1715643105602,CLRE 251,A00,507176,Mehta; Ravindra L.,9992,0,9999,7
1715643105602,CLRE 251,B00,511410,Mehta; Ravindra L.,9998,0,9999,1
1715643106629,CLRE 252,A00,507189,Cuomo; Raphael Eduardo,9994,0,9999,5
1715643107660,CLRE 253,A00,507199,Vaida; Florin,9994,0,9999,5
1715643107660,CLRE 253,B00,507202,Vaida; Florin,9999,0,9999,0
1715643108684,CLRE 259,A00,507211,Patel; Hemal,9996,0,9999,3
1715643109710,CLRE 260,A00,507221,Cuomo; Raphael Eduardo,9999,0,9999,0
1715643110740,CLRE 297,001,507242,Cuomo; Raphael Eduardo,9999,0,9999,0
1715643111768,COGS 197,001,638244,Voytek; Bradley Thomas,9997,0,9999,2
1715643112797,CSE 191,A00,516875,Minnes Kemp; Mor Mia,9991,0,9999,8
1715643113825,CSE 197,001,637388,Minnes Kemp; Mor Mia,9992,0,9999,7
1715643114854,CSS 201S,A01,494383,Mignozzetti; Umberto,35,0,35,0
1715643115885,CSS 202S,A01,494387,Mignozzetti; Umberto,35,0,35,0
1715643116910,DSC 197,001,628532,Eldridge; Justin Matthew,9995,0,9999,4
1715643117937,EAP 100,A00,516065,Staff,9799,0,9999,200
1715643118963,ECE 45,A01,507414,Staff,31,0,60,29
1715643121021,ECE 111,A01,507420,Staff,11,0,50,39
1715643122047,ECE 197,001,548057,Sievenpiper; Daniel F.,9991,0,9999,8
1715643123073,EDS 115,A00,507243,Choi; Bailey Miyeon,6,0,28,22
1715643124098,EDS 117,A01,494379,Staff,0,6,34,35
1715643125123,EDS 125,A00,507246,Hopkins; Megan Beth,7,0,30,23
1715643126147,EDS 128A,A01,507264,Fargason; Sharon Gayle,5,0,26,21
1715643127173,EDS 128B,A01,507293,Pappas; Elizabeth,9,0,30,21
1715643128198,EDS 139,A00,507294,Fargason; Sharon Gayle,9,0,30,21
1715643128198,EDS 139,B00,507313,Pappas; Elizabeth,9,0,30,21
1715643129227,EDS 201,A00,507315,Staff,10,0,30,20
1715643130260,EDS 203,A01,507317,Halter; Christopher P.,10,0,30,20
1715643131290,EDS 204R,A01,507319,Halter; Christopher P.,0,3,30,30
1715643131290,EDS 204R,B01,507331,Heinzman; Erica M.,14,0,30,16
1715643132318,EDS 206R,A00,507332,Staff,0,4,30,30
1715643132318,EDS 206R,B00,507343,Staff,15,0,30,15
1715643133347,EDS 250,A00,507344,Hemans; Patricia Ann Benitez,20,0,40,20
1715643134372,EDS 281,A00,507345,Daly; Alan J.,18,0,18,0
1715643135395,EDS 284,A00,507350,Daly; Alan J.,16,0,16,0
1715643136424,EDS 286,A00,507359,Fine; Sarah,18,0,18,0
1715643137448,EDS 289C,A01,507361,Daly; Alan J.,18,0,18,0
1715643138475,EDS 290,A00,507366,Hofstetter; Carolyn,15,0,15,0
1715643139500,LIGM 5A,A00,507421,Fischer-Grunski; Eva K,17,0,20,3
1715643140527,LIGM 5B,A00,507423,Fischer-Grunski; Eva K,19,0,20,1
1715643141555,LIGM 5C,A00,507425,Fischer-Grunski; Eva K,19,0,20,1
1715643142580,LIIT 5AS,A00,507427,Carnelos; Chiara,20,0,20,0
1715643143605,LIIT 5BS,A00,507430,Carnelos; Chiara,20,0,20,0
1715643144628,LIIT 5CS,A00,507432,Carnelos; Chiara,20,0,20,0
1715643145659,LISP 5A,A00,507541,Munoz Sanchez; Alicia,11,0,20,9
1715643146686,LISP 5B,A00,507671,Munoz Sanchez; Alicia,8,0,20,12
1715643147717,LISP 5C,A00,507696,Munoz Sanchez; Alicia,8,0,20,12
1715643148743,MAE 197,001,528363,Boechler; Nicholas Sebastia,9998,0,9999,1
1715643149773,MATH 197,001,523477,Kedlaya; Kiran S.,9994,0,9999,5
1715643149773,MATH 197,002,563811,Zhang; Danna,9994,0,9999,5
1715643149773,MATH 197,003,628552,Dumitriu; Ioana,9998,0,9999,1
1715643149773,MATH 197,004,660885,Floyd; Eric,9998,0,9999,1
1715643150800,MCWP 40R,A00,518780,Staff,1,0,20,19
1715643150800,MCWP 40R,B00,518781,Staff,10,0,20,10
1715643150800,MCWP 40R,C00,518783,Staff,5,0,20,15
1715643151831,MCWP 50R,A00,518791,Staff,0,1,20,20
1715643151831,MCWP 50R,B00,518792,Staff,0,2,20,20
1715643151831,MCWP 50R,C00,518793,Staff,0,4,20,20
1715643151831,MCWP 50R,D00,518794,Staff,0,1,20,20
1715643151831,MCWP 50R,E00,518795,Staff,0,2,20,20
1715643151831,MCWP 50R,F00,518796,Staff,0,1,20,20
1715643151831,MCWP 50R,G00,518797,Staff,0,1,20,20
1715643152857,MMW 12R,A01,514034,Herbst; Matthew,0,2,16,16
1715643152857,MMW 12R,A02,514035,Herbst; Matthew,0,0,16,16
1715643153882,MMW 13R,A01,514037,Staff,0,5,16,16
1715643153882,MMW 13R,A02,514039,Staff,0,5,16,16
1715643153882,MMW 13R,A03,628519,Staff,0,4,16,16
1715643155935,SIO 295LS,A00,523233,Staff,10,0,30,20
1715643156959,SIO 295S,A00,523232,Staff,10,0,30,20
1715643157985,SIOC 290S,A01,637330,Merrifield; Mark A,21,0,30,9
1715643159011,SIOC 291S,A01,637333,Gabriel; Corey John,21,0,30,9
1715643160039,SOCI 117,A01,494376,Staff,0,5,5,5
1715643161068,WES 237B,A00,494380,Staff,10,0,20,10
1715643163139,AESE 279B,A00,494370,Wade; Jon P,0,0,33,33
1715643164165,AIP 97,001,660915,Van Den Einde; Yael Dahlia,9998,0,9999,1
1715643165205,AIP 197,001,627712,Vespa; Emanuel Ignacio,9995,0,9999,4
1715643165205,AIP 197,002,650778,Amir; On,9998,0,9999,1
1715643165205,AIP 197,003,650933,Avenancio-Leon; Carlos,9998,0,9999,1
1715643165205,AIP 197,004,658530,Heyman; Gail D.,9998,0,9999,1
1715643165205,AIP 197,005,658631,Neal; Sonya E,9998,0,9999,1
1715643165205,AIP 197,006,658671,Du; Songzi,9998,0,9999,1
1715643166230,ANAR 135S,A00,494369,Braswell; Geoffrey E.,0,0,0,0
1715643167255,BENG 196,001,628496,Engler; Adam J.,9998,0,9999,1
1715643167255,BENG 196,002,660916,Watson; John Thomas,9998,0,9999,1
1715643168283,BISP 197,001,650773,Wilhelm; James E.,9994,0,9999,5
1715643168283,BISP 197,002,658904,Coleman; Aaron B.,9998,0,9999,1
1715643169308,CAT 124RS,A01,519847,Geibel; William,0,0,20,20
1715643170337,CAT 125RS,A01,515971,Geibel; William,0,0,20,20
1715643171366,CLRE 250,A00,511389,Morris; Sheldon,9992,0,9999,7
1715643172395,CLRE 251,A00,507176,Mehta; Ravindra L.,9992,0,9999,7
1715643172395,CLRE 251,B00,511410,Mehta; Ravindra L.,9998,0,9999,1
1715643173424,CLRE 252,A00,507189,Cuomo; Raphael Eduardo,9994,0,9999,5
1715643174448,CLRE 253,A00,507199,Vaida; Florin,9994,0,9999,5
1715643174448,CLRE 253,B00,507202,Vaida; Florin,9999,0,9999,0
1715643175474,CLRE 259,A00,507211,Patel; Hemal,9996,0,9999,3
1715643176499,CLRE 260,A00,507221,Cuomo; Raphael Eduardo,9999,0,9999,0
1715643177526,CLRE 297,001,507242,Cuomo; Raphael Eduardo,9999,0,9999,0
1715643178554,COGS 197,001,638244,Voytek; Bradley Thomas,9997,0,9999,2
1715643179578,CSE 191,A00,516875,Minnes Kemp; Mor Mia,9991,0,9999,8
1715643180605,CSE 197,001,637388,Minnes Kemp; Mor Mia,9992,0,9999,7
1715643181638,CSS 201S,A01,494383,Mignozzetti; Umberto,35,0,35,0
1715643182667,CSS 202S,A01,494387,Mignozzetti; Umberto,35,0,35,0
1715643183692,DSC 197,001,628532,Eldridge; Justin Matthew,9995,0,9999,4
1715643184720,EAP 100,A00,516065,Staff,9799,0,9999,200
1715643185748,ECE 45,A01,507414,Staff,31,0,60,29
1715643187798,ECE 111,A01,507420,Staff,11,0,50,39
1715643188822,ECE 197,001,548057,Sievenpiper; Daniel F.,9991,0,9999,8
1715643189848,EDS 115,A00,507243,Choi; Bailey Miyeon,6,0,28,22
1715643190874,EDS 117,A01,494379,Staff,0,6,34,35
1715643191903,EDS 125,A00,507246,Hopkins; Megan Beth,7,0,30,23
1715643192930,EDS 128A,A01,507264,Fargason; Sharon Gayle,5,0,26,21
1715643193958,EDS 128B,A01,507293,Pappas; Elizabeth,9,0,30,21
1715643194984,EDS 139,A00,507294,Fargason; Sharon Gayle,9,0,30,21
1715643194984,EDS 139,B00,507313,Pappas; Elizabeth,9,0,30,21
1715643196009,EDS 201,A00,507315,Staff,10,0,30,20
1715643197035,EDS 203,A01,507317,Halter; Christopher P.,10,0,30,20
1715643198060,EDS 204R,A01,507319,Halter; Christopher P.,0,3,30,30
1715643198060,EDS 204R,B01,507331,Heinzman; Erica M.,14,0,30,16
1715643199089,EDS 206R,A00,507332,Staff,0,4,30,30
1715643199089,EDS 206R,B00,507343,Staff,15,0,30,15
1715643200114,EDS 250,A00,507344,Hemans; Patricia Ann Benitez,20,0,40,20
1715643201140,EDS 281,A00,507345,Daly; Alan J.,18,0,18,0
1715643202167,EDS 284,A00,507350,Daly; Alan J.,16,0,16,0
1715643203194,EDS 286,A00,507359,Fine; Sarah,18,0,18,0
1715643204219,EDS 289C,A01,507361,Daly; Alan J.,18,0,18,0
1715643205245,EDS 290,A00,507366,Hofstetter; Carolyn,15,0,15,0
1715643206270,LIGM 5A,A00,507421,Fischer-Grunski; Eva K,17,0,20,3
1715643207296,LIGM 5B,A00,507423,Fischer-Grunski; Eva K,19,0,20,1
1715643208321,LIGM 5C,A00,507425,Fischer-Grunski; Eva K,19,0,20,1
1715643209348,LIIT 5AS,A00,507427,Carnelos; Chiara,20,0,20,0
1715643210376,LIIT 5BS,A00,507430,Carnelos; Chiara,20,0,20,0
1715643211403,LIIT 5CS,A00,507432,Carnelos; Chiara,20,0,20,0
1715643212430,LISP 5A,A00,507541,Munoz Sanchez; Alicia,11,0,20,9
1715643213455,LISP 5B,A00,507671,Munoz Sanchez; Alicia,8,0,20,12
1715643214479,LISP 5C,A00,507696,Munoz Sanchez; Alicia,8,0,20,12
1715643215505,MAE 197,001,528363,Boechler; Nicholas Sebastia,9998,0,9999,1
1715643216534,MATH 197,001,523477,Kedlaya; Kiran S.,9994,0,9999,5
1715643216534,MATH 197,002,563811,Zhang; Danna,9994,0,9999,5
1715643216534,MATH 197,003,628552,Dumitriu; Ioana,9998,0,9999,1
1715643216534,MATH 197,004,660885,Floyd; Eric,9998,0,9999,1
1715643217558,MCWP 40R,A00,518780,Staff,1,0,20,19
1715643217558,MCWP 40R,B00,518781,Staff,10,0,20,10
1715643217558,MCWP 40R,C00,518783,Staff,5,0,20,15
1715643218589,MCWP 50R,A00,518791,Staff,0,1,20,20
1715643218589,MCWP 50R,B00,518792,Staff,0,2,20,20
1715643218589,MCWP 50R,C00,518793,Staff,0,4,20,20
1715643218589,MCWP 50R,D00,518794,Staff,0,1,20,20
1715643218589,MCWP 50R,E00,518795,Staff,0,2,20,20
1715643218589,MCWP 50R,F00,518796,Staff,0,1,20,20
1715643218589,MCWP 50R,G00,518797,Staff,0,1,20,20
1715643219618,MMW 12R,A01,514034,Herbst; Matthew,0,2,16,16
1715643219618,MMW 12R,A02,514035,Herbst; Matthew,0,0,16,16
1715643220646,MMW 13R,A01,514037,Staff,0,5,16,16
1715643220646,MMW 13R,A02,514039,Staff,0,5,16,16
1715643220646,MMW 13R,A03,628519,Staff,0,4,16,16
1715643222699,SIO 295LS,A00,523233,Staff,10,0,30,20
1715643223726,SIO 295S,A00,523232,Staff,10,0,30,20
1715643224757,SIOC 290S,A01,637330,Merrifield; Mark A,21,0,30,9
1715643225787,SIOC 291S,A01,637333,Gabriel; Corey John,21,0,30,9
1715643226812,SOCI 117,A01,494376,Staff,0,5,5,5
1715643227838,WES 237B,A00,494380,Staff,10,0,20,10
1715643229903,AESE 279B,A00,494370,Wade; Jon P,0,0,33,33
1715643230928,AIP 97,001,660915,Van Den Einde; Yael Dahlia,9998,0,9999,1
1715643231959,AIP 197,001,627712,Vespa; Emanuel Ignacio,9995,0,9999,4
1715643231959,AIP 197,002,650778,Amir; On,9998,0,9999,1
1715643231959,AIP 197,003,650933,Avenancio-Leon; Carlos,9998,0,9999,1
1715643231959,AIP 197,004,658530,Heyman; Gail D.,9998,0,9999,1
1715643231959,AIP 197,005,658631,Neal; Sonya E,9998,0,9999,1
1715643231959,AIP 197,006,658671,Du; Songzi,9998,0,9999,1
1715643232987,ANAR 135S,A00,494369,Braswell; Geoffrey E.,0,0,0,0
1715643234019,BENG 196,001,628496,Engler; Adam J.,9998,0,9999,1
1715643234019,BENG 196,002,660916,Watson; John Thomas,9998,0,9999,1
1715643235046,BISP 197,001,650773,Wilhelm; James E.,9994,0,9999,5
1715643235046,BISP 197,002,658904,Coleman; Aaron B.,9998,0,9999,1
1715643236073,CAT 124RS,A01,519847,Geibel; William,0,0,20,20
1715643237101,CAT 125RS,A01,515971,Geibel; William,0,0,20,20
1715643238130,CLRE 250,A00,511389,Morris; Sheldon,9992,0,9999,7
1715643239159,CLRE 251,A00,507176,Mehta; Ravindra L.,9992,0,9999,7
1715643239159,CLRE 251,B00,511410,Mehta; Ravindra L.,9998,0,9999,1
1715643240185,CLRE 252,A00,507189,Cuomo; Raphael Eduardo,9994,0,9999,5
1715643241214,CLRE 253,A00,507199,Vaida; Florin,9994,0,9999,5
1715643241214,CLRE 253,B00,507202,Vaida; Florin,9999,0,9999,0
1715643242242,CLRE 259,A00,507211,Patel; Hemal,9996,0,9999,3
1715643243267,CLRE 260,A00,507221,Cuomo; Raphael Eduardo,9999,0,9999,0
1715643244292,CLRE 297,001,507242,Cuomo; Raphael Eduardo,9999,0,9999,0
1715643245320,COGS 197,001,638244,Voytek; Bradley Thomas,9997,0,9999,2
1715643246346,CSE 191,A00,516875,Minnes Kemp; Mor Mia,9991,0,9999,8
1715643247371,CSE 197,001,637388,Minnes Kemp; Mor Mia,9992,0,9999,7
1715643248398,CSS 201S,A01,494383,Mignozzetti; Umberto,35,0,35,0
1715643249423,CSS 202S,A01,494387,Mignozzetti; Umberto,35,0,35,0
1715643250448,DSC 197,001,628532,Eldridge; Justin Matthew,9995,0,9999,4
1715643251474,EAP 100,A00,516065,Staff,9799,0,9999,200
1715643252501,ECE 45,A01,507414,Staff,31,0,60,29
1715643254553,ECE 111,A01,507420,Staff,11,0,50,39
1715643255580,ECE 197,001,548057,Sievenpiper; Daniel F.,9991,0,9999,8
1715643256608,EDS 115,A00,507243,Choi; Bailey Miyeon,6,0,28,22
1715643257634,EDS 117,A01,494379,Staff,0,6,34,35
1715643258664,EDS 125,A00,507246,Hopkins; Megan Beth,7,0,30,23
1715643259692,EDS 128A,A01,507264,Fargason; Sharon Gayle,5,0,26,21
1715643260723,EDS 128B,A01,507293,Pappas; Elizabeth,9,0,30,21
1715643261748,EDS 139,A00,507294,Fargason; Sharon Gayle,9,0,30,21
1715643261748,EDS 139,B00,507313,Pappas; Elizabeth,9,0,30,21
1715643262775,EDS 201,A00,507315,Staff,10,0,30,20
1715643263802,EDS 203,A01,507317,Halter; Christopher P.,10,0,30,20
1715643264827,EDS 204R,A01,507319,Halter; Christopher P.,0,3,30,30
1715643264827,EDS 204R,B01,507331,Heinzman; Erica M.,14,0,30,16
1715643265856,EDS 206R,A00,507332,Staff,0,4,30,30
1715643265856,EDS 206R,B00,507343,Staff,15,0,30,15
1715643266882,EDS 250,A00,507344,Hemans; Patricia Ann Benitez,20,0,40,20
1715643267908,EDS 281,A00,507345,Daly; Alan J.,18,0,18,0
1715643268934,EDS 284,A00,507350,Daly; Alan J.,16,0,16,0
1715643269958,EDS 286,A00,507359,Fine; Sarah,18,0,18,0
1715643270986,EDS 289C,A01,507361,Daly; Alan J.,18,0,18,0
1715643272012,EDS 290,A00,507366,Hofstetter; Carolyn,15,0,15,0
1715643273038,LIGM 5A,A00,507421,Fischer-Grunski; Eva K,17,0,20,3
1715643274067,LIGM 5B,A00,507423,Fischer-Grunski; Eva K,19,0,20,1
1715643275093,LIGM 5C,A00,507425,Fischer-Grunski; Eva K,19,0,20,1
1715643276123,LIIT 5AS,A00,507427,Carnelos; Chiara,20,0,20,0
1715643277148,LIIT 5BS,A00,507430,Carnelos; Chiara,20,0,20,0
1715643278174,LIIT 5CS,A00,507432,Carnelos; Chiara,20,0,20,0
1715643279200,LISP 5A,A00,507541,Munoz Sanchez; Alicia,11,0,20,9
1715643280228,LISP 5B,A00,507671,Munoz Sanchez; Alicia,8,0,20,12
1715643281258,LISP 5C,A00,507696,Munoz Sanchez; Alicia,8,0,20,12
1715643282286,MAE 197,001,528363,Boechler; Nicholas Sebastia,9998,0,9999,1
1715643283313,MATH 197,001,523477,Kedlaya; Kiran S.,9994,0,9999,5
1715643283313,MATH 197,002,563811,Zhang; Danna,9994,0,9999,5
1715643283313,MATH 197,003,628552,Dumitriu; Ioana,9998,0,9999,1
1715643283313,MATH 197,004,660885,Floyd; Eric,9998,0,9999,1
1715643284344,MCWP 40R,A00,518780,Staff,1,0,20,19
1715643284344,MCWP 40R,B00,518781,Carter; Jennifer A,10,0,20,10
1715643284344,MCWP 40R,C00,518783,Smith; Haydee Marie,5,0,20,15
1715643285371,MCWP 50R,A00,518791,Staff,0,1,20,20
1715643285371,MCWP 50R,B00,518792,Staff,0,2,20,20
1715643285371,MCWP 50R,C00,518793,Staff,0,4,20,20
1715643285371,MCWP 50R,D00,518794,Staff,0,1,20,20
1715643285371,MCWP 50R,E00,518795,Staff,0,2,20,20
1715643285371,MCWP 50R,F00,518796,Staff,0,1,20,20
1715643285371,MCWP 50R,G00,518797,Staff,0,1,20,20
1715643286395,MMW 12R,A01,514034,Herbst; Matthew,0,2,16,16
1715643286395,MMW 12R,A02,514035,Herbst; Matthew,0,0,16,16
1715643287420,MMW 13R,A01,514037,Staff,0,5,16,16
1715643287420,MMW 13R,A02,514039,Staff,0,5,16,16
1715643287420,MMW 13R,A03,628519,Staff,0,4,16,16
1715643289472,SIO 295LS,A00,523233,Staff,10,0,30,20
1715643290498,SIO 295S,A00,523232,Staff,10,0,30,20
1715643291525,SIOC 290S,A01,637330,Merrifield; Mark A,21,0,30,9
1715643292555,SIOC 291S,A01,637333,Gabriel; Corey John,21,0,30,9
1715643293580,SOCI 117,A01,494376,Staff,0,5,5,5
1715643294604,WES 237B,A00,494380,Staff,10,0,20,10
1715643296676,AESE 279B,A00,494370,Wade; Jon P,0,0,33,33
1715643297704,AIP 97,001,660915,Van Den Einde; Yael Dahlia,9998,0,9999,1
1715643298730,AIP 197,001,627712,Vespa; Emanuel Ignacio,9995,0,9999,4
1715643298730,AIP 197,002,650778,Amir; On,9998,0,9999,1
1715643298730,AIP 197,003,650933,Avenancio-Leon; Carlos,9998,0,9999,1
1715643298730,AIP 197,004,658530,Heyman; Gail D.,9998,0,9999,1
1715643298730,AIP 197,005,658631,Neal; Sonya E,9998,0,9999,1
1715643298730,AIP 197,006,658671,Du; Songzi,9998,0,9999,1
1715643299755,ANAR 135S,A00,494369,Braswell; Geoffrey E.,0,0,0,0
1715643300781,BENG 196,001,628496,Engler; Adam J.,9998,0,9999,1
1715643300781,BENG 196,002,660916,Watson; John Thomas,9998,0,9999,1
1715643301811,BISP 197,001,650773,Wilhelm; James E.,9994,0,9999,5
1715643301811,BISP 197,002,658904,Coleman; Aaron B.,9998,0,9999,1
1715643302835,CAT 124RS,A01,519847,Geibel; William,0,0,20,20
1715643303865,CAT 125RS,A01,515971,Geibel; William,0,0,20,20
1715643304890,CLRE 250,A00,511389,Morris; Sheldon,9992,0,9999,7
1715643305920,CLRE 251,A00,507176,Mehta; Ravindra L.,9992,0,9999,7
1715643305920,CLRE 251,B00,511410,Mehta; Ravindra L.,9998,0,9999,1
1715643306947,CLRE 252,A00,507189,Cuomo; Raphael Eduardo,9994,0,9999,5
1715643307972,CLRE 253,A00,507199,Vaida; Florin,9994,0,9999,5
1715643307972,CLRE 253,B00,507202,Vaida; Florin,9999,0,9999,0
1715643308999,CLRE 259,A00,507211,Patel; Hemal,9996,0,9999,3
1715643310025,CLRE 260,A00,507221,Cuomo; Raphael Eduardo,9999,0,9999,0
1715643311051,CLRE 297,001,507242,Cuomo; Raphael Eduardo,9999,0,9999,0
1715643312078,COGS 197,001,638244,Voytek; Bradley Thomas,9997,0,9999,2
1715643313104,CSE 191,A00,516875,Minnes Kemp; Mor Mia,9991,0,9999,8
1715643314129,CSE 197,001,637388,Minnes Kemp; Mor Mia,9992,0,9999,7
1715643315155,CSS 201S,A01,494383,Mignozzetti; Umberto,35,0,35,0
1715643316183,CSS 202S,A01,494387,Mignozzetti; Umberto,35,0,35,0
1715643317208,DSC 197,001,628532,Eldridge; Justin Matthew,9995,0,9999,4
1715643318236,EAP 100,A00,516065,Staff,9799,0,9999,200
1715643319268,ECE 45,A01,507414,Staff,31,0,60,29
1715643321318,ECE 111,A01,507420,Staff,11,0,50,39
1715643322343,ECE 197,001,548057,Sievenpiper; Daniel F.,9991,0,9999,8
1715643323370,EDS 115,A00,507243,Choi; Bailey Miyeon,6,0,28,22
1715643324394,EDS 117,A01,494379,Staff,0,6,34,35
1715643325420,EDS 125,A00,507246,Hopkins; Megan Beth,7,0,30,23
1715643326446,EDS 128A,A01,507264,Fargason; Sharon Gayle,5,0,26,21
1715643327475,EDS 128B,A01,507293,Pappas; Elizabeth,9,0,30,21
1715643328502,EDS 139,A00,507294,Fargason; Sharon Gayle,9,0,30,21
1715643328502,EDS 139,B00,507313,Pappas; Elizabeth,9,0,30,21
1715643329526,EDS 201,A00,507315,Staff,10,0,30,20
1715643330558,EDS 203,A01,507317,Halter; Christopher P.,10,0,30,20
1715643331586,EDS 204R,A01,507319,Halter; Christopher P.,0,3,30,30
1715643331586,EDS 204R,B01,507331,Heinzman; Erica M.,14,0,30,16
1715643332614,EDS 206R,A00,507332,Staff,0,4,30,30
1715643332614,EDS 206R,B00,507343,Staff,15,0,30,15
1715643333639,EDS 250,A00,507344,Hemans; Patricia Ann Benitez,20,0,40,20
1715643334666,EDS 281,A00,507345,Daly; Alan J.,18,0,18,0
1715643335691,EDS 284,A00,507350,Daly; Alan J.,16,0,16,0
1715643336719,EDS 286,A00,507359,Fine; Sarah,18,0,18,0
1715643337743,EDS 289C,A01,507361,Daly; Alan J.,18,0,18,0
1715643338768,EDS 290,A00,507366,Hofstetter; Carolyn,15,0,15,0
1715643339854,LIGM 5A,A00,507421,Fischer-Grunski; Eva K,17,0,20,3
1715643340880,LIGM 5B,A00,507423,Fischer-Grunski; Eva K,19,0,20,1
1715643341907,LIGM 5C,A00,507425,Fischer-Grunski; Eva K,19,0,20,1
1715643342937,LIIT 5AS,A00,507427,Carnelos; Chiara,20,0,20,0
1715643343966,LIIT 5BS,A00,507430,Carnelos; Chiara,20,0,20,0
1715643344991,LIIT 5CS,A00,507432,Carnelos; Chiara,20,0,20,0
1715643346017,LISP 5A,A00,507541,Munoz Sanchez; Alicia,11,0,20,9
1715643347049,LISP 5B,A00,507671,Munoz Sanchez; Alicia,8,0,20,12
1715643348075,LISP 5C,A00,507696,Munoz Sanchez; Alicia,8,0,20,12
1715643349102,MAE 197,001,528363,Boechler; Nicholas Sebastia,9998,0,9999,1
1715643350131,MATH 197,001,523477,Kedlaya; Kiran S.,9994,0,9999,5
1715643350131,MATH 197,002,563811,Zhang; Danna,9994,0,9999,5
1715643350131,MATH 197,003,628552,Dumitriu; Ioana,9998,0,9999,1
1715643350131,MATH 197,004,660885,Floyd; Eric,9998,0,9999,1
1715643351165,MCWP 40R,A00,518780,Staff,1,0,20,19
1715643351165,MCWP 40R,B00,518781,Carter; Jennifer A,10,0,20,10
1715643351165,MCWP 40R,C00,518783,Smith; Haydee Marie,5,0,20,15
1715643352197,MCWP 50R,A00,518791,Redela; Pamela Morgan,0,1,20,20
1715643352197,MCWP 50R,B00,518792,Krone; Jarret,0,2,20,20
1715643352197,MCWP 50R,C00,518793,Staff,0,4,20,20
1715643352197,MCWP 50R,D00,518794,Staff,0,1,20,20
1715643352197,MCWP 50R,E00,518795,Staff,0,2,20,20
1715643352197,MCWP 50R,F00,518796,Staff,0,1,20,20
1715643352197,MCWP 50R,G00,518797,Staff,0,1,20,20
1715643353227,MMW 12R,A01,514034,Herbst; Matthew,0,2,16,16
1715643353227,MMW 12R,A02,514035,Herbst; Matthew,0,0,16,16
1715643354253,MMW 13R,A01,514037,Staff,0,5,16,16
1715643354253,MMW 13R,A02,514039,Staff,0,5,16,16
1715643354253,MMW 13R,A03,628519,Staff,0,4,16,16
1715643356305,SIO 295LS,A00,523233,Staff,10,0,30,20
1715643357333,SIO 295S,A00,523232,Staff,10,0,30,20
1715643358364,SIOC 290S,A01,637330,Merrifield; Mark A,21,0,30,9
1715643359395,SIOC 291S,A01,637333,Gabriel; Corey John,21,0,30,9
1715643360426,SOCI 117,A01,494376,Staff,0,5,5,5
1715643361450,WES 237B,A00,494380,Staff,10,0,20,10
1715643363524,AESE 279B,A00,494370,Wade; Jon P,0,0,33,33
1715643364550,AIP 97,001,660915,Van Den Einde; Yael Dahlia,9998,0,9999,1
1715643365586,AIP 197,001,627712,Vespa; Emanuel Ignacio,9995,0,9999,4
1715643365586,AIP 197,002,650778,Amir; On,9998,0,9999,1
1715643365586,AIP 197,003,650933,Avenancio-Leon; Carlos,9998,0,9999,1
1715643365586,AIP 197,004,658530,Heyman; Gail D.,9998,0,9999,1
1715643365586,AIP 197,005,658631,Neal; Sonya E,9998,0,9999,1
1715643365586,AIP 197,006,658671,Du; Songzi,9998,0,9999,1
1715643366615,ANAR 135S,A00,494369,Braswell; Geoffrey E.,0,0,0,0
1715643367643,BENG 196,001,628496,Engler; Adam J.,9998,0,9999,1
1715643367643,BENG 196,002,660916,Watson; John Thomas,9998,0,9999,1
1715643368672,BISP 197,001,650773,Wilhelm; James E.,9994,0,9999,5
1715643368672,BISP 197,002,658904,Coleman; Aaron B.,9998,0,9999,1
1715643369699,CAT 124RS,A01,519847,Geibel; William,0,0,20,20
1715643370723,CAT 125RS,A01,515971,Geibel; William,0,0,20,20
1715643371748,CLRE 250,A00,511389,Morris; Sheldon,9992,0,9999,7
1715643372781,CLRE 251,A00,507176,Mehta; Ravindra L.,9992,0,9999,7
1715643372781,CLRE 251,B00,511410,Mehta; Ravindra L.,9998,0,9999,1
1715643373812,CLRE 252,A00,507189,Cuomo; Raphael Eduardo,9994,0,9999,5
1715643374841,CLRE 253,A00,507199,Vaida; Florin,9994,0,9999,5
1715643374841,CLRE 253,B00,507202,Vaida; Florin,9999,0,9999,0
1715643375866,CLRE 259,A00,507211,Patel; Hemal,9996,0,9999,3
1715643376894,CLRE 260,A00,507221,Cuomo; Raphael Eduardo,9999,0,9999,0
1715643377919,CLRE 297,001,507242,Cuomo; Raphael Eduardo,9999,0,9999,0
1715643378946,COGS 197,001,638244,Voytek; Bradley Thomas,9997,0,9999,2
1715643379973,CSE 191,A00,516875,Minnes Kemp; Mor Mia,9991,0,9999,8
1715643380997,CSE 197,001,637388,Minnes Kemp; Mor Mia,9992,0,9999,7
1715643382027,CSS 201S,A01,494383,Mignozzetti; Umberto,35,0,35,0
1715643383052,CSS 202S,A01,494387,Mignozzetti; Umberto,35,0,35,0
1715643384080,DSC 197,001,628532,Eldridge; Justin Matthew,9995,0,9999,4
1715643385106,EAP 100,A00,516065,Staff,9799,0,9999,200
1715643386133,ECE 45,A01,507414,Staff,31,0,60,29
1715643388185,ECE 111,A01,507420,Staff,11,0,50,39
1715643389213,ECE 197,001,548057,Sievenpiper; Daniel F.,9991,0,9999,8
1715643390239,EDS 115,A00,507243,Choi; Bailey Miyeon,6,0,28,22
1715643391266,EDS 117,A01,494379,Staff,0,6,34,35
1715643392294,EDS 125,A00,507246,Hopkins; Megan Beth,7,0,30,23
1715643393320,EDS 128A,A01,507264,Fargason; Sharon Gayle,5,0,26,21
1715643394343,EDS 128B,A01,507293,Pappas; Elizabeth,9,0,30,21
1715643395371,EDS 139,A00,507294,Fargason; Sharon Gayle,9,0,30,21
1715643395371,EDS 139,B00,507313,Pappas; Elizabeth,9,0,30,21
1715643396396,EDS 201,A00,507315,Staff,10,0,30,20
1715643397426,EDS 203,A01,507317,Halter; Christopher P.,10,0,30,20
1715643398454,EDS 204R,A01,507319,Halter; Christopher P.,0,3,30,30
1715643398454,EDS 204R,B01,507331,Heinzman; Erica M.,14,0,30,16
1715643399481,EDS 206R,A00,507332,Staff,0,4,30,30
1715643399481,EDS 206R,B00,507343,Staff,15,0,30,15
1715643400512,EDS 250,A00,507344,Hemans; Patricia Ann Benitez,20,0,40,20
1715643401542,EDS 281,A00,507345,Daly; Alan J.,18,0,18,0
1715643402568,EDS 284,A00,507350,Daly; Alan J.,16,0,16,0
1715643403598,EDS 286,A00,507359,Fine; Sarah,18,0,18,0
1715643404622,EDS 289C,A01,507361,Daly; Alan J.,18,0,18,0
1715643405648,EDS 290,A00,507366,Hofstetter; Carolyn,15,0,15,0
1715643406678,LIGM 5A,A00,507421,Fischer-Grunski; Eva K,17,0,20,3
1715643407702,LIGM 5B,A00,507423,Fischer-Grunski; Eva K,19,0,20,1
1715643408728,LIGM 5C,A00,507425,Fischer-Grunski; Eva K,19,0,20,1
1715643409757,LIIT 5AS,A00,507427,Carnelos; Chiara,20,0,20,0
1715643410783,LIIT 5BS,A00,507430,Carnelos; Chiara,20,0,20,0
1715643411807,LIIT 5CS,A00,507432,Carnelos; Chiara,20,0,20,0
1715643412834,LISP 5A,A00,507541,Munoz Sanchez; Alicia,11,0,20,9
1715643413858,LISP 5B,A00,507671,Munoz Sanchez; Alicia,8,0,20,12
1715643414884,LISP 5C,A00,507696,Munoz Sanchez; Alicia,8,0,20,12
1715643415912,MAE 197,001,528363,Boechler; Nicholas Sebastia,9998,0,9999,1
1715643416940,MATH 197,001,523477,Kedlaya; Kiran S.,9994,0,9999,5
1715643416940,MATH 197,002,563811,Zhang; Danna,9994,0,9999,5
1715643416940,MATH 197,003,628552,Dumitriu; Ioana,9998,0,9999,1
1715643416940,MATH 197,004,660885,Floyd; Eric,9998,0,9999,1
1715643417969,MCWP 40R,A00,518780,Staff,1,0,20,19
1715643417969,MCWP 40R,B00,518781,Carter; Jennifer A,10,0,20,10
1715643417969,MCWP 40R,C00,518783,Smith; Haydee Marie,5,0,20,15
1715643419003,MCWP 50R,A00,518791,Redela; Pamela Morgan,0,1,20,20
1715643419003,MCWP 50R,B00,518792,Krone; Jarret,0,2,20,20
1715643419003,MCWP 50R,C00,518793,Staff,0,4,20,20
1715643419003,MCWP 50R,D00,518794,Morshed; Michael James,0,1,20,20
1715643419003,MCWP 50R,E00,518795,Carter; Andrea L,0,2,20,20
1715643419003,MCWP 50R,F00,518796,Miller; Elizabeth Deen,0,1,20,20
1715643419003,MCWP 50R,G00,518797,Staff,0,1,20,20
1715643420034,MMW 12R,A01,514034,Herbst; Matthew,0,2,16,16
1715643420034,MMW 12R,A02,514035,Herbst; Matthew,0,0,16,16
1715643421060,MMW 13R,A01,514037,Staff,0,5,16,16
1715643421060,MMW 13R,A02,514039,Staff,0,5,16,16
1715643421060,MMW 13R,A03,628519,Staff,0,4,16,16
1715643423116,SIO 295LS,A00,523233,Staff,10,0,30,20
1715643424143,SIO 295S,A00,523232,Staff,10,0,30,20
1715643425175,SIOC 290S,A01,637330,Merrifield; Mark A,21,0,30,9
1715643426201,SIOC 291S,A01,637333,Gabriel; Corey John,21,0,30,9
1715643427230,SOCI 117,A01,494376,Staff,0,5,5,5
1715643428254,WES 237B,A00,494380,Staff,10,0,20,10
1715643430340,AESE 279B,A00,494370,Wade; Jon P,0,0,33,33
1715643431367,AIP 97,001,660915,Van Den Einde; Yael Dahlia,9998,0,9999,1
1715643432394,AIP 197,001,627712,Vespa; Emanuel Ignacio,9995,0,9999,4
1715643432394,AIP 197,002,650778,Amir; On,9998,0,9999,1
1715643432394,AIP 197,003,650933,Avenancio-Leon; Carlos,9998,0,9999,1
1715643432394,AIP 197,004,658530,Heyman; Gail D.,9998,0,9999,1
1715643432394,AIP 197,005,658631,Neal; Sonya E,9998,0,9999,1
1715643432394,AIP 197,006,658671,Du; Songzi,9998,0,9999,1
1715643433424,ANAR 135S,A00,494369,Braswell; Geoffrey E.,0,0,0,0
1715643434449,BENG 196,001,628496,Engler; Adam J.,9998,0,9999,1
1715643434449,BENG 196,002,660916,Watson; John Thomas,9998,0,9999,1
1715643435476,BISP 197,001,650773,Wilhelm; James E.,9994,0,9999,5
1715643435476,BISP 197,002,658904,Coleman; Aaron B.,9998,0,9999,1
1715643436502,CAT 124RS,A01,519847,Geibel; William,0,0,20,20
1715643437528,CAT 125RS,A01,515971,Geibel; William,0,0,20,20
1715643438556,CLRE 250,A00,511389,Morris; Sheldon,9992,0,9999,7
1715643439587,CLRE 251,A00,507176,Mehta; Ravindra L.,9992,0,9999,7
1715643439587,CLRE 251,B00,511410,Mehta; Ravindra L.,9998,0,9999,1
1715643440615,CLRE 252,A00,507189,Cuomo; Raphael Eduardo,9994,0,9999,5
1715643441641,CLRE 253,A00,507199,Vaida; Florin,9994,0,9999,5
1715643441641,CLRE 253,B00,507202,Vaida; Florin,9999,0,9999,0
1715643442668,CLRE 259,A00,507211,Patel; Hemal,9996,0,9999,3
1715643443748,CLRE 260,A00,507221,Cuomo; Raphael Eduardo,9999,0,9999,0
1715643444774,CLRE 297,001,507242,Cuomo; Raphael Eduardo,9999,0,9999,0
1715643445799,COGS 197,001,638244,Voytek; Bradley Thomas,9997,0,9999,2
1715643446828,CSE 191,A00,516875,Minnes Kemp; Mor Mia,9991,0,9999,8
1715643447855,CSE 197,001,637388,Minnes Kemp; Mor Mia,9992,0,9999,7
1715643448881,CSS 201S,A01,494383,Mignozzetti; Umberto,35,0,35,0
1715643449904,CSS 202S,A01,494387,Mignozzetti; Umberto,35,0,35,0
1715643450933,DSC 197,001,628532,Eldridge; Justin Matthew,9995,0,9999,4
1715643451957,EAP 100,A00,516065,Staff,9799,0,9999,200
1715643452985,ECE 45,A01,507414,Staff,31,0,60,29
1715643455040,ECE 111,A01,507420,Staff,11,0,50,39
1715643456066,ECE 197,001,548057,Sievenpiper; Daniel F.,9991,0,9999,8
1715643457096,EDS 115,A00,507243,Choi; Bailey Miyeon,6,0,28,22
1715643458122,EDS 117,A01,494379,Staff,0,6,34,35
1715643459149,EDS 125,A00,507246,Hopkins; Megan Beth,7,0,30,23
1715643460175,EDS 128A,A01,507264,Fargason; Sharon Gayle,5,0,26,21
1715643461202,EDS 128B,A01,507293,Pappas; Elizabeth,9,0,30,21
1715643462230,EDS 139,A00,507294,Fargason; Sharon Gayle,9,0,30,21
1715643462230,EDS 139,B00,507313,Pappas; Elizabeth,9,0,30,21
1715643463259,EDS 201,A00,507315,Staff,10,0,30,20
1715643464285,EDS 203,A01,507317,Halter; Christopher P.,10,0,30,20
1715643465311,EDS 204R,A01,507319,Halter; Christopher P.,0,3,30,30
1715643465311,EDS 204R,B01,507331,Heinzman; Erica M.,14,0,30,16
1715643466340,EDS 206R,A00,507332,Staff,0,4,30,30
1715643466340,EDS 206R,B00,507343,Staff,15,0,30,15
1715643467366,EDS 250,A00,507344,Hemans; Patricia Ann Benitez,20,0,40,20
1715643468394,EDS 281,A00,507345,Daly; Alan J.,18,0,18,0
1715643469418,EDS 284,A00,507350,Daly; Alan J.,16,0,16,0
1715643470447,EDS 286,A00,507359,Fine; Sarah,18,0,18,0
1715643471473,EDS 289C,A01,507361,Daly; Alan J.,18,0,18,0
1715643472500,EDS 290,A00,507366,Hofstetter; Carolyn,15,0,15,0
1715643473530,LIGM 5A,A00,507421,Fischer-Grunski; Eva K,17,0,20,3
1715643474555,LIGM 5B,A00,507423,Fischer-Grunski; Eva K,19,0,20,1
1715643475585,LIGM 5C,A00,507425,Fischer-Grunski; Eva K,19,0,20,1
1715643476611,LIIT 5AS,A00,507427,Carnelos; Chiara,20,0,20,0
1715643477638,LIIT 5BS,A00,507430,Carnelos; Chiara,20,0,20,0
1715643478663,LIIT 5CS,A00,507432,Carnelos; Chiara,20,0,20,0
1715643479690,LISP 5A,A00,507541,Munoz Sanchez; Alicia,11,0,20,9
1715643480718,LISP 5B,A00,507671,Munoz Sanchez; Alicia,8,0,20,12
1715643481742,LISP 5C,A00,507696,Munoz Sanchez; Alicia,8,0,20,12
1715643482767,MAE 197,001,528363,Boechler; Nicholas Sebastia,9998,0,9999,1
1715643483794,MATH 197,001,523477,Kedlaya; Kiran S.,9994,0,9999,5
1715643483794,MATH 197,002,563811,Zhang; Danna,9994,0,9999,5
1715643483794,MATH 197,003,628552,Dumitriu; Ioana,9998,0,9999,1
1715643483794,MATH 197,004,660885,Floyd; Eric,9998,0,9999,1
1715643484820,MCWP 40R,A00,518780,Staff,1,0,20,19
1715643484820,MCWP 40R,B00,518781,Carter; Jennifer A,10,0,20,10
1715643484820,MCWP 40R,C00,518783,Smith; Haydee Marie,5,0,20,15
1715643485855,MCWP 50R,A00,518791,Redela; Pamela Morgan,0,1,20,20
1715643485855,MCWP 50R,B00,518792,Krone; Jarret,0,2,20,20
1715643485855,MCWP 50R,C00,518793,Staff,0,4,20,20
1715643485855,MCWP 50R,D00,518794,Morshed; Michael James,0,1,20,20
1715643485855,MCWP 50R,E00,518795,Carter; Andrea L,0,2,20,20
1715643485855,MCWP 50R,F00,518796,Miller; Elizabeth Deen,0,1,20,20
1715643485855,MCWP 50R,G00,518797,Guillen; Melinda,0,1,20,20
1715643486881,MMW 12R,A01,514034,Herbst; Matthew,0,2,16,16
1715643486881,MMW 12R,A02,514035,Herbst; Matthew,0,0,16,16
1715643487906,MMW 13R,A01,514037,Staff,0,5,16,16
1715643487906,MMW 13R,A02,514039,Staff,0,5,16,16
1715643487906,MMW 13R,A03,628519,Staff,0,4,16,16
1715643489959,SIO 295LS,A00,523233,Staff,10,0,30,20
1715643490984,SIO 295S,A00,523232,Staff,10,0,30,20
1715643492010,SIOC 290S,A01,637330,Merrifield; Mark A,21,0,30,9
1715643493036,SIOC 291S,A01,637333,Gabriel; Corey John,21,0,30,9
1715643494063,SOCI 117,A01,494376,Staff,0,5,5,5
1715643495089,WES 237B,A00,494380,Staff,10,0,20,10
1715643497158,AESE 279B,A00,494370,Wade; Jon P,0,0,33,33
1715643498183,AIP 97,001,660915,Van Den Einde; Yael Dahlia,9998,0,9999,1
1715643499210,AIP 197,001,627712,Vespa; Emanuel Ignacio,9995,0,9999,4
1715643499210,AIP 197,002,650778,Amir; On,9998,0,9999,1
1715643499210,AIP 197,003,650933,Avenancio-Leon; Carlos,9998,0,9999,1
1715643499210,AIP 197,004,658530,Heyman; Gail D.,9998,0,9999,1
1715643499210,AIP 197,005,658631,Neal; Sonya E,9998,0,9999,1
1715643499210,AIP 197,006,658671,Du; Songzi,9998,0,9999,1
1715643500237,ANAR 135S,A00,494369,Braswell; Geoffrey E.,0,0,0,0
1715643501264,BENG 196,001,628496,Engler; Adam J.,9998,0,9999,1
1715643501264,BENG 196,002,660916,Watson; John Thomas,9998,0,9999,1
1715643502293,BISP 197,001,650773,Wilhelm; James E.,9994,0,9999,5
1715643502293,BISP 197,002,658904,Coleman; Aaron B.,9998,0,9999,1
1715643503318,CAT 124RS,A01,519847,Geibel; William,0,0,20,20
1715643504342,CAT 125RS,A01,515971,Geibel; William,0,0,20,20
1715643505372,CLRE 250,A00,511389,Morris; Sheldon,9992,0,9999,7
1715643506398,CLRE 251,A00,507176,Mehta; Ravindra L.,9992,0,9999,7
1715643506398,CLRE 251,B00,511410,Mehta; Ravindra L.,9998,0,9999,1
1715643507442,CLRE 252,A00,507189,Cuomo; Raphael Eduardo,9994,0,9999,5
1715643508471,CLRE 253,A00,507199,Vaida; Florin,9994,0,9999,5
1715643508471,CLRE 253,B00,507202,Vaida; Florin,9999,0,9999,0
1715643509501,CLRE 259,A00,507211,Patel; Hemal,9996,0,9999,3
1715643510527,CLRE 260,A00,507221,Cuomo; Raphael Eduardo,9999,0,9999,0
1715643511554,CLRE 297,001,507242,Cuomo; Raphael Eduardo,9999,0,9999,0
1715643512580,COGS 197,001,638244,Voytek; Bradley Thomas,9997,0,9999,2
1715643513609,CSE 191,A00,516875,Minnes Kemp; Mor Mia,9991,0,9999,8
1715643514633,CSE 197,001,637388,Minnes Kemp; Mor Mia,9992,0,9999,7
1715643515665,CSS 201S,A01,494383,Mignozzetti; Umberto,35,0,35,0
1715643516691,CSS 202S,A01,494387,Mignozzetti; Umberto,35,0,35,0
1715643517717,DSC 197,001,628532,Eldridge; Justin Matthew,9995,0,9999,4
1715643518743,EAP 100,A00,516065,Staff,9799,0,9999,200
1715643519768,ECE 45,A01,507414,Staff,31,0,60,29
1715643521818,ECE 111,A01,507420,Staff,11,0,50,39
1715643522844,ECE 197,001,548057,Sievenpiper; Daniel F.,9991,0,9999,8
1715643523876,EDS 115,A00,507243,Choi; Bailey Miyeon,6,0,28,22
1715643524900,EDS 117,A01,494379,Staff,0,6,34,35
1715643525926,EDS 125,A00,507246,Hopkins; Megan Beth,7,0,30,23
1715643526950,EDS 128A,A01,507264,Fargason; Sharon Gayle,5,0,26,21
1715643527982,EDS 128B,A01,507293,Pappas; Elizabeth,9,0,30,21
1715643529007,EDS 139,A00,507294,Fargason; Sharon Gayle,9,0,30,21
1715643529007,EDS 139,B00,507313,Pappas; Elizabeth,9,0,30,21
1715643530031,EDS 201,A00,507315,Staff,10,0,30,20
1715643531063,EDS 203,A01,507317,Halter; Christopher P.,10,0,30,20
1715643532088,EDS 204R,A01,507319,Halter; Christopher P.,0,3,30,30
1715643532088,EDS 204R,B01,507331,Heinzman; Erica M.,14,0,30,16
1715643533114,EDS 206R,A00,507332,Staff,0,4,30,30
1715643533114,EDS 206R,B00,507343,Staff,15,0,30,15
1715643534143,EDS 250,A00,507344,Hemans; Patricia Ann Benitez,20,0,40,20
1715643535168,EDS 281,A00,507345,Daly; Alan J.,18,0,18,0
1715643536192,EDS 284,A00,507350,Daly; Alan J.,16,0,16,0
1715643537218,EDS 286,A00,507359,Fine; Sarah,18,0,18,0
1715643538243,EDS 289C,A01,507361,Daly; Alan J.,18,0,18,0
1715643539269,EDS 290,A00,507366,Hofstetter; Carolyn,15,0,15,0
1715643540299,LIGM 5A,A00,507421,Fischer-Grunski; Eva K,17,0,20,3
1715643541325,LIGM 5B,A00,507423,Fischer-Grunski; Eva K,19,0,20,1
1715643542352,LIGM 5C,A00,507425,Fischer-Grunski; Eva K,19,0,20,1
1715643543378,LIIT 5AS,A00,507427,Carnelos; Chiara,20,0,20,0
1715643544404,LIIT 5BS,A00,507430,Carnelos; Chiara,20,0,20,0
1715643545428,LIIT 5CS,A00,507432,Carnelos; Chiara,20,0,20,0
1715643546455,LISP 5A,A00,507541,Munoz Sanchez; Alicia,11,0,20,9
1715643547484,LISP 5B,A00,507671,Munoz Sanchez; Alicia,8,0,20,12
1715643548510,LISP 5C,A00,507696,Munoz Sanchez; Alicia,8,0,20,12
1715643549536,MAE 197,001,528363,Boechler; Nicholas Sebastia,9998,0,9999,1
1715643550568,MATH 197,001,523477,Kedlaya; Kiran S.,9994,0,9999,5
1715643550568,MATH 197,002,563811,Zhang; Danna,9994,0,9999,5
1715643550568,MATH 197,003,628552,Dumitriu; Ioana,9998,0,9999,1
1715643550568,MATH 197,004,660885,Floyd; Eric,9998,0,9999,1
1715643551594,MCWP 40R,A00,518780,Staff,1,0,20,19
1715643551594,MCWP 40R,B00,518781,Carter; Jennifer A,10,0,20,10
1715643551594,MCWP 40R,C00,518783,Smith; Haydee Marie,5,0,20,15
1715643552638,MCWP 50R,A00,518791,Redela; Pamela Morgan,0,1,20,20
1715643552638,MCWP 50R,B00,518792,Krone; Jarret,0,2,20,20
1715643552638,MCWP 50R,C00,518793,Staff,0,4,20,20
1715643552638,MCWP 50R,D00,518794,Morshed; Michael James,0,1,20,20
1715643552638,MCWP 50R,E00,518795,Carter; Andrea L,0,2,20,20
1715643552638,MCWP 50R,F00,518796,Miller; Elizabeth Deen,0,1,20,20
1715643552638,MCWP 50R,G00,518797,Guillen; Melinda,0,1,20,20
1715643553663,MMW 12R,A01,514034,Herbst; Matthew,0,2,16,16
1715643553663,MMW 12R,A02,514035,Herbst; Matthew,0,0,16,16
1715643554691,MMW 13R,A01,514037,Staff,0,5,16,16
1715643554691,MMW 13R,A02,514039,Staff,0,5,16,16
1715643554691,MMW 13R,A03,628519,Staff,0,4,16,16
1715643556745,SIO 295LS,A00,523233,Staff,10,0,30,20
1715643557771,SIO 295S,A00,523232,Staff,10,0,30,20
1715643558802,SIOC 290S,A01,637330,Merrifield; Mark A,21,0,30,9
1715643559831,SIOC 291S,A01,637333,Gabriel; Corey John,21,0,30,9
1715643560855,SOCI 117,A01,494376,Staff,0,5,5,5
1715643561883,WES 237B,A00,494380,Staff,10,0,20,10
1715643563955,AESE 279B,A00,494370,Wade; Jon P,0,0,33,33
1715643564980,AIP 97,001,660915,Van Den Einde; Yael Dahlia,9998,0,9999,1
1715643566004,AIP 197,001,627712,Vespa; Emanuel Ignacio,9995,0,9999,4
1715643566004,AIP 197,002,650778,Amir; On,9998,0,9999,1
1715643566004,AIP 197,003,650933,Avenancio-Leon; Carlos,9998,0,9999,1
1715643566004,AIP 197,004,658530,Heyman; Gail D.,9998,0,9999,1
1715643566004,AIP 197,005,658631,Neal; Sonya E,9998,0,9999,1
1715643566004,AIP 197,006,658671,Du; Songzi,9998,0,9999,1
1715643567033,ANAR 135S,A00,494369,Braswell; Geoffrey E.,0,0,0,0
1715643568057,BENG 196,001,628496,Engler; Adam J.,9998,0,9999,1
1715643568057,BENG 196,002,660916,Watson; John Thomas,9998,0,9999,1
1715643569082,BISP 197,001,650773,Wilhelm; James E.,9994,0,9999,5
1715643569082,BISP 197,002,658904,Coleman; Aaron B.,9998,0,9999,1
1715643570108,CAT 124RS,A01,519847,Geibel; William,0,0,20,20
1715643571137,CAT 125RS,A01,515971,Geibel; William,0,0,20,20
1715643572162,CLRE 250,A00,511389,Morris; Sheldon,9992,0,9999,7
1715643573188,CLRE 251,A00,507176,Mehta; Ravindra L.,9992,0,9999,7
1715643573188,CLRE 251,B00,511410,Mehta; Ravindra L.,9998,0,9999,1
1715643574214,CLRE 252,A00,507189,Cuomo; Raphael Eduardo,9994,0,9999,5
1715643575247,CLRE 253,A00,507199,Vaida; Florin,9994,0,9999,5
1715643575247,CLRE 253,B00,507202,Vaida; Florin,9999,0,9999,0
1715643576274,CLRE 259,A00,507211,Patel; Hemal,9996,0,9999,3
1715643577304,CLRE 260,A00,507221,Cuomo; Raphael Eduardo,9999,0,9999,0
1715643578328,CLRE 297,001,507242,Cuomo; Raphael Eduardo,9999,0,9999,0
1715643579357,COGS 197,001,638244,Voytek; Bradley Thomas,9997,0,9999,2
1715643580381,CSE 191,A00,516875,Minnes Kemp; Mor Mia,9991,0,9999,8
1715643581406,CSE 197,001,637388,Minnes Kemp; Mor Mia,9992,0,9999,7
1715643582433,CSS 201S,A01,494383,Mignozzetti; Umberto,35,0,35,0
1715643583463,CSS 202S,A01,494387,Mignozzetti; Umberto,35,0,35,0
1715643584490,DSC 197,001,628532,Eldridge; Justin Matthew,9995,0,9999,4
1715643585517,EAP 100,A00,516065,Staff,9799,0,9999,200
1715643586562,ECE 45,A01,507414,Staff,32,0,60,28
1715643588620,ECE 111,A01,507420,Staff,11,0,50,39
1715643589648,ECE 197,001,548057,Sievenpiper; Daniel F.,9991,0,9999,8
1715643590674,EDS 115,A00,507243,Choi; Bailey Miyeon,6,0,28,22
1715643591699,EDS 117,A01,494379,Staff,0,6,34,35
1715643592723,EDS 125,A00,507246,Hopkins; Megan Beth,7,0,30,23
1715643593753,EDS 128A,A01,507264,Fargason; Sharon Gayle,5,0,26,21
1715643594780,EDS 128B,A01,507293,Pappas; Elizabeth,9,0,30,21
1715643595807,EDS 139,A00,507294,Fargason; Sharon Gayle,9,0,30,21
1715643595807,EDS 139,B00,507313,Pappas; Elizabeth,9,0,30,21
1715643596834,EDS 201,A00,507315,Staff,10,0,30,20
1715643597862,EDS 203,A01,507317,Halter; Christopher P.,10,0,30,20
1715643598890,EDS 204R,A01,507319,Halter; Christopher P.,0,3,30,30
1715643598890,EDS 204R,B01,507331,Heinzman; Erica M.,14,0,30,16
1715643599915,EDS 206R,A00,507332,Staff,0,4,30,30
1715643599915,EDS 206R,B00,507343,Staff,15,0,30,15
1715643600944,EDS 250,A00,507344,Hemans; Patricia Ann Benitez,20,0,40,20
1715643601969,EDS 281,A00,507345,Daly; Alan J.,18,0,18,0
1715643602998,EDS 284,A00,507350,Daly; Alan J.,16,0,16,0
1715643604023,EDS 286,A00,507359,Fine; Sarah,18,0,18,0
1715643605050,EDS 289C,A01,507361,Daly; Alan J.,18,0,18,0
1715643606080,EDS 290,A00,507366,Hofstetter; Carolyn,15,0,15,0
1715643607106,LIGM 5A,A00,507421,Fischer-Grunski; Eva K,17,0,20,3
1715643608136,LIGM 5B,A00,507423,Fischer-Grunski; Eva K,19,0,20,1
1715643609162,LIGM 5C,A00,507425,Fischer-Grunski; Eva K,19,0,20,1
1715643610192,LIIT 5AS,A00,507427,Carnelos; Chiara,20,0,20,0
1715643611217,LIIT 5BS,A00,507430,Carnelos; Chiara,20,0,20,0
1715643612251,LIIT 5CS,A00,507432,Carnelos; Chiara,20,0,20,0
1715643613282,LISP 5A,A00,507541,Munoz Sanchez; Alicia,11,0,20,9
1715643614306,LISP 5B,A00,507671,Munoz Sanchez; Alicia,8,0,20,12
1715643615341,LISP 5C,A00,507696,Munoz Sanchez; Alicia,8,0,20,12
1715643616366,MAE 197,001,528363,Boechler; Nicholas Sebastia,9998,0,9999,1
1715643617400,MATH 197,001,523477,Kedlaya; Kiran S.,9994,0,9999,5
1715643617400,MATH 197,002,563811,Zhang; Danna,9994,0,9999,5
1715643617400,MATH 197,003,628552,Dumitriu; Ioana,9998,0,9999,1
1715643617400,MATH 197,004,660885,Floyd; Eric,9998,0,9999,1
1715643618431,MCWP 40R,A00,518780,Staff,1,0,20,19
1715643618431,MCWP 40R,B00,518781,Carter; Jennifer A,10,0,20,10
1715643618431,MCWP 40R,C00,518783,Smith; Haydee Marie,5,0,20,15
1715643619459,MCWP 50R,A00,518791,Redela; Pamela Morgan,0,1,20,20
1715643619459,MCWP 50R,B00,518792,Krone; Jarret,0,2,20,20
1715643619459,MCWP 50R,C00,518793,Staff,0,4,20,20
1715643619459,MCWP 50R,D00,518794,Morshed; Michael James,0,1,20,20
1715643619459,MCWP 50R,E00,518795,Carter; Andrea L,0,2,20,20
1715643619459,MCWP 50R,F00,518796,Miller; Elizabeth Deen,0,1,20,20
1715643619459,MCWP 50R,G00,518797,Guillen; Melinda,0,1,20,20
1715643620488,MMW 12R,A01,514034,Herbst; Matthew,0,2,16,16
1715643620488,MMW 12R,A02,514035,Herbst; Matthew,0,0,16,16
1715643621513,MMW 13R,A01,514037,Staff,0,5,16,16
1715643621513,MMW 13R,A02,514039,Staff,0,5,16,16
1715643621513,MMW 13R,A03,628519,Staff,0,4,16,16
1715643623565,SIO 295LS,A00,523233,Staff,10,0,30,20
1715643624590,SIO 295S,A00,523232,Staff,10,0,30,20
1715643625617,SIOC 290S,A01,637330,Merrifield; Mark A,21,0,30,9
1715643626646,SIOC 291S,A01,637333,Gabriel; Corey John,21,0,30,9
1715643627670,SOCI 117,A01,494376,Staff,0,5,5,5
1715643628696,WES 237B,A00,494380,Staff,10,0,20,10
1715643630761,AESE 279B,A00,494370,Wade; Jon P,0,0,33,33
1715643631789,AIP 97,001,660915,Van Den Einde; Yael Dahlia,9998,0,9999,1
1715643632821,AIP 197,001,627712,Vespa; Emanuel Ignacio,9995,0,9999,4
1715643632821,AIP 197,002,650778,Amir; On,9998,0,9999,1
1715643632821,AIP 197,003,650933,Avenancio-Leon; Carlos,9998,0,9999,1
1715643632821,AIP 197,004,658530,Heyman; Gail D.,9998,0,9999,1
1715643632821,AIP 197,005,658631,Neal; Sonya E,9998,0,9999,1
1715643632821,AIP 197,006,658671,Du; Songzi,9998,0,9999,1
1715643633845,ANAR 135S,A00,494369,Braswell; Geoffrey E.,0,0,0,0
1715643634876,BENG 196,001,628496,Engler; Adam J.,9998,0,9999,1
1715643634876,BENG 196,002,660916,Watson; John Thomas,9998,0,9999,1
1715643635901,BISP 197,001,650773,Wilhelm; James E.,9994,0,9999,5
1715643635901,BISP 197,002,658904,Coleman; Aaron B.,9998,0,9999,1
1715643636930,CAT 124RS,A01,519847,Geibel; William,0,0,20,20
1715643637958,CAT 125RS,A01,515971,Geibel; William,0,0,20,20
1715643638984,CLRE 250,A00,511389,Morris; Sheldon,9992,0,9999,7
1715643640009,CLRE 251,A00,507176,Mehta; Ravindra L.,9992,0,9999,7
1715643640009,CLRE 251,B00,511410,Mehta; Ravindra L.,9998,0,9999,1
1715643641037,CLRE 252,A00,507189,Cuomo; Raphael Eduardo,9994,0,9999,5
1715643642064,CLRE 253,A00,507199,Vaida; Florin,9994,0,9999,5
1715643642064,CLRE 253,B00,507202,Vaida; Florin,9999,0,9999,0
1715643643092,CLRE 259,A00,507211,Patel; Hemal,9996,0,9999,3
1715643644120,CLRE 260,A00,507221,Cuomo; Raphael Eduardo,9999,0,9999,0
1715643645145,CLRE 297,001,507242,Cuomo; Raphael Eduardo,9999,0,9999,0
1715643646193,COGS 197,001,638244,Voytek; Bradley Thomas,9997,0,9999,2
1715643647218,CSE 191,A00,516875,Minnes Kemp; Mor Mia,9991,0,9999,8
1715643648245,CSE 197,001,637388,Minnes Kemp; Mor Mia,9992,0,9999,7
1715643649274,CSS 201S,A01,494383,Mignozzetti; Umberto,35,0,35,0
1715643650301,CSS 202S,A01,494387,Mignozzetti; Umberto,35,0,35,0
1715643651326,DSC 197,001,628532,Eldridge; Justin Matthew,9995,0,9999,4
1715643652350,EAP 100,A00,516065,Staff,9799,0,9999,200
1715643653376,ECE 45,A01,507414,Staff,32,0,60,28
1715643655428,ECE 111,A01,507420,Staff,11,0,50,39
1715643656456,ECE 197,001,548057,Sievenpiper; Daniel F.,9991,0,9999,8
1715643657481,EDS 115,A00,507243,Choi; Bailey Miyeon,6,0,28,22
1715643658509,EDS 117,A01,494379,Staff,0,6,34,35
1715643659533,EDS 125,A00,507246,Hopkins; Megan Beth,7,0,30,23
1715643660561,EDS 128A,A01,507264,Fargason; Sharon Gayle,5,0,26,21
1715643661589,EDS 128B,A01,507293,Pappas; Elizabeth,9,0,30,21
1715643662615,EDS 139,A00,507294,Fargason; Sharon Gayle,9,0,30,21
1715643662615,EDS 139,B00,507313,Pappas; Elizabeth,9,0,30,21
1715643663639,EDS 201,A00,507315,Staff,10,0,30,20
1715643664667,EDS 203,A01,507317,Halter; Christopher P.,10,0,30,20
1715643665697,EDS 204R,A01,507319,Halter; Christopher P.,0,3,30,30
1715643665697,EDS 204R,B01,507331,Heinzman; Erica M.,14,0,30,16
1715643666728,EDS 206R,A00,507332,Staff,0,4,30,30
1715643666728,EDS 206R,B00,507343,Staff,15,0,30,15
1715643667761,EDS 250,A00,507344,Hemans; Patricia Ann Benitez,20,0,40,20
1715643668787,EDS 281,A00,507345,Daly; Alan J.,18,0,18,0
1715643669813,EDS 284,A00,507350,Daly; Alan J.,16,0,16,0
1715643670838,EDS 286,A00,507359,Fine; Sarah,18,0,18,0
1715643671863,EDS 289C,A01,507361,Daly; Alan J.,18,0,18,0
1715643672887,EDS 290,A00,507366,Hofstetter; Carolyn,15,0,15,0
1715643673912,LIGM 5A,A00,507421,Fischer-Grunski; Eva K,17,0,20,3
1715643674938,LIGM 5B,A00,507423,Fischer-Grunski; Eva K,19,0,20,1
1715643675966,LIGM 5C,A00,507425,Fischer-Grunski; Eva K,19,0,20,1
1715643676995,LIIT 5AS,A00,507427,Carnelos; Chiara,20,0,20,0
1715643678022,LIIT 5BS,A00,507430,Carnelos; Chiara,20,0,20,0
1715643679048,LIIT 5CS,A00,507432,Carnelos; Chiara,20,0,20,0
1715643680074,LISP 5A,A00,507541,Munoz Sanchez; Alicia,11,0,20,9
1715643681098,LISP 5B,A00,507671,Munoz Sanchez; Alicia,8,0,20,12
1715643682122,LISP 5C,A00,507696,Munoz Sanchez; Alicia,8,0,20,12
1715643683148,MAE 197,001,528363,Boechler; Nicholas Sebastia,9998,0,9999,1
1715643684174,MATH 197,001,523477,Kedlaya; Kiran S.,9994,0,9999,5
1715643684174,MATH 197,002,563811,Zhang; Danna,9994,0,9999,5
1715643684174,MATH 197,003,628552,Dumitriu; Ioana,9998,0,9999,1
1715643684174,MATH 197,004,660885,Floyd; Eric,9998,0,9999,1
1715643685202,MCWP 40R,A00,518780,Staff,1,0,20,19
1715643685202,MCWP 40R,B00,518781,Carter; Jennifer A,10,0,20,10
1715643685202,MCWP 40R,C00,518783,Smith; Haydee Marie,5,0,20,15
1715643686238,MCWP 50R,A00,518791,Redela; Pamela Morgan,0,1,20,20
1715643686238,MCWP 50R,B00,518792,Krone; Jarret,0,2,20,20
1715643686238,MCWP 50R,C00,518793,Staff,0,4,20,20
1715643686238,MCWP 50R,D00,518794,Morshed; Michael James,0,1,20,20
1715643686238,MCWP 50R,E00,518795,Carter; Andrea L,0,2,20,20
1715643686238,MCWP 50R,F00,518796,Miller; Elizabeth Deen,0,1,20,20
1715643686238,MCWP 50R,G00,518797,Guillen; Melinda,0,1,20,20
1715643687264,MMW 12R,A01,514034,Herbst; Matthew,0,2,16,16
1715643687264,MMW 12R,A02,514035,Herbst; Matthew,0,0,16,16
1715643688290,MMW 13R,A01,514037,Staff,0,5,16,16
1715643688290,MMW 13R,A02,514039,Staff,0,5,16,16
1715643688290,MMW 13R,A03,628519,Staff,0,4,16,16
1715643690347,SIO 295LS,A00,523233,Staff,10,0,30,20
1715643691376,SIO 295S,A00,523232,Staff,10,0,30,20
1715643692408,SIOC 290S,A01,637330,Merrifield; Mark A,21,0,30,9
1715643693432,SIOC 291S,A01,637333,Gabriel; Corey John,21,0,30,9
1715643694458,SOCI 117,A01,494376,Staff,0,5,5,5
1715643695485,WES 237B,A00,494380,Staff,10,0,20,10
1715643697560,AESE 279B,A00,494370,Wade; Jon P,0,0,33,33
1715643698586,AIP 97,001,660915,Van Den Einde; Yael Dahlia,9998,0,9999,1
1715643699619,AIP 197,001,627712,Vespa; Emanuel Ignacio,9995,0,9999,4
1715643699619,AIP 197,002,650778,Amir; On,9998,0,9999,1
1715643699619,AIP 197,003,650933,Avenancio-Leon; Carlos,9998,0,9999,1
1715643699619,AIP 197,004,658530,Heyman; Gail D.,9998,0,9999,1
1715643699619,AIP 197,005,658631,Neal; Sonya E,9998,0,9999,1
1715643699619,AIP 197,006,658671,Du; Songzi,9998,0,9999,1
1715643700645,ANAR 135S,A00,494369,Braswell; Geoffrey E.,0,0,0,0
1715643701672,BENG 196,001,628496,Engler; Adam J.,9998,0,9999,1
1715643701672,BENG 196,002,660916,Watson; John Thomas,9998,0,9999,1
1715643702700,BISP 197,001,650773,Wilhelm; James E.,9994,0,9999,5
1715643702700,BISP 197,002,658904,Coleman; Aaron B.,9998,0,9999,1
1715643703727,CAT 124RS,A01,519847,Geibel; William,0,0,20,20
1715643704752,CAT 125RS,A01,515971,Geibel; William,0,0,20,20
1715643705781,CLRE 250,A00,511389,Morris; Sheldon,9992,0,9999,7
1715643706805,CLRE 251,A00,507176,Mehta; Ravindra L.,9992,0,9999,7
1715643706805,CLRE 251,B00,511410,Mehta; Ravindra L.,9998,0,9999,1
1715643707830,CLRE 252,A00,507189,Cuomo; Raphael Eduardo,9994,0,9999,5
1715643708854,CLRE 253,A00,507199,Vaida; Florin,9994,0,9999,5
1715643708854,CLRE 253,B00,507202,Vaida; Florin,9999,0,9999,0
1715643709880,CLRE 259,A00,507211,Patel; Hemal,9996,0,9999,3
1715643710904,CLRE 260,A00,507221,Cuomo; Raphael Eduardo,9999,0,9999,0
1715643711931,CLRE 297,001,507242,Cuomo; Raphael Eduardo,9999,0,9999,0
1715643712958,COGS 197,001,638244,Voytek; Bradley Thomas,9997,0,9999,2
1715643713985,CSE 191,A00,516875,Minnes Kemp; Mor Mia,9991,0,9999,8
1715643715009,CSE 197,001,637388,Minnes Kemp; Mor Mia,9992,0,9999,7
1715643716039,CSS 201S,A01,494383,Mignozzetti; Umberto,35,0,35,0
1715643717067,CSS 202S,A01,494387,Mignozzetti; Umberto,35,0,35,0
1715643718093,DSC 197,001,628532,Eldridge; Justin Matthew,9995,0,9999,4
1715643719120,EAP 100,A00,516065,Staff,9799,0,9999,200
1715643720152,ECE 45,A01,507414,Staff,32,0,60,28
1715643722202,ECE 111,A01,507420,Staff,11,0,50,39
1715643723227,ECE 197,001,548057,Sievenpiper; Daniel F.,9991,0,9999,8
1715643724252,EDS 115,A00,507243,Choi; Bailey Miyeon,6,0,28,22
1715643725294,EDS 117,A01,494379,Staff,0,6,34,35
1715643726323,EDS 125,A00,507246,Hopkins; Megan Beth,7,0,30,23
1715643727351,EDS 128A,A01,507264,Fargason; Sharon Gayle,5,0,26,21
1715643728377,EDS 128B,A01,507293,Pappas; Elizabeth,9,0,30,21
1715643729401,EDS 139,A00,507294,Fargason; Sharon Gayle,9,0,30,21
1715643729401,EDS 139,B00,507313,Pappas; Elizabeth,9,0,30,21
1715643730426,EDS 201,A00,507315,Staff,10,0,30,20
1715643731451,EDS 203,A01,507317,Halter; Christopher P.,10,0,30,20
1715643732477,EDS 204R,A01,507319,Halter; Christopher P.,0,3,30,30
1715643732477,EDS 204R,B01,507331,Heinzman; Erica M.,14,0,30,16
1715643733515,EDS 206R,A00,507332,Staff,0,4,30,30
1715643733515,EDS 206R,B00,507343,Staff,15,0,30,15
1715643734542,EDS 250,A00,507344,Hemans; Patricia Ann Benitez,20,0,40,20
1715643735570,EDS 281,A00,507345,Daly; Alan J.,18,0,18,0
1715643736597,EDS 284,A00,507350,Daly; Alan J.,16,0,16,0
1715643737626,EDS 286,A00,507359,Fine; Sarah,18,0,18,0
1715643738654,EDS 289C,A01,507361,Daly; Alan J.,18,0,18,0
1715643739678,EDS 290,A00,507366,Hofstetter; Carolyn,15,0,15,0
1715643740703,LIGM 5A,A00,507421,Fischer-Grunski; Eva K,17,0,20,3
1715643741730,LIGM 5B,A00,507423,Fischer-Grunski; Eva K,19,0,20,1
1715643742759,LIGM 5C,A00,507425,Fischer-Grunski; Eva K,19,0,20,1
1715643743787,LIIT 5AS,A00,507427,Carnelos; Chiara,20,0,20,0
1715643744810,LIIT 5BS,A00,507430,Carnelos; Chiara,20,0,20,0
1715643745870,LIIT 5CS,A00,507432,Carnelos; Chiara,20,0,20,0
1715643746898,LISP 5A,A00,507541,Munoz Sanchez; Alicia,11,0,20,9
1715643747922,LISP 5B,A00,507671,Munoz Sanchez; Alicia,8,0,20,12
1715643748946,LISP 5C,A00,507696,Munoz Sanchez; Alicia,8,0,20,12
1715643749971,MAE 197,001,528363,Boechler; Nicholas Sebastia,9998,0,9999,1
1715643750999,MATH 197,001,523477,Kedlaya; Kiran S.,9994,0,9999,5
1715643750999,MATH 197,002,563811,Zhang; Danna,9994,0,9999,5
1715643750999,MATH 197,003,628552,Dumitriu; Ioana,9998,0,9999,1
1715643750999,MATH 197,004,660885,Floyd; Eric,9998,0,9999,1
1715643752027,MCWP 40R,A00,518780,Staff,1,0,20,19
1715643752027,MCWP 40R,B00,518781,Carter; Jennifer A,10,0,20,10
1715643752027,MCWP 40R,C00,518783,Smith; Haydee Marie,5,0,20,15
1715643753061,MCWP 50R,A00,518791,Redela; Pamela Morgan,0,1,20,20
1715643753061,MCWP 50R,B00,518792,Krone; Jarret,0,2,20,20
1715643753061,MCWP 50R,C00,518793,Staff,0,4,20,20
1715643753061,MCWP 50R,D00,518794,Morshed; Michael James,0,1,20,20
1715643753061,MCWP 50R,E00,518795,Carter; Andrea L,0,2,20,20
1715643753061,MCWP 50R,F00,518796,Miller; Elizabeth Deen,0,1,20,20
1715643753061,MCWP 50R,G00,518797,Guillen; Melinda,0,1,20,20
1715643754090,MMW 12R,A01,514034,Herbst; Matthew,0,2,16,16
1715643754090,MMW 12R,A02,514035,Herbst; Matthew,0,0,16,16
1715643755168,MMW 13R,A01,514037,Staff,0,5,16,16
1715643755168,MMW 13R,A02,514039,Staff,0,5,16,16
1715643755168,MMW 13R,A03,628519,Staff,0,4,16,16
1715643757223,SIO 295LS,A00,523233,Staff,10,0,30,20
1715643758246,SIO 295S,A00,523232,Staff,10,0,30,20
1715643759277,SIOC 290S,A01,637330,Merrifield; Mark A,21,0,30,9
1715643760302,SIOC 291S,A01,637333,Gabriel; Corey John,21,0,30,9
1715643761330,SOCI 117,A01,494376,Staff,0,5,5,5
1715643762360,WES 237B,A00,494380,Staff,10,0,20,10
1715643764432,AESE 279B,A00,494370,Wade; Jon P,0,0,33,33
1715643765460,AIP 97,001,660915,Van Den Einde; Yael Dahlia,9998,0,9999,1
1715643766487,AIP 197,001,627712,Vespa; Emanuel Ignacio,9995,0,9999,4
1715643766487,AIP 197,002,650778,Amir; On,9998,0,9999,1
1715643766487,AIP 197,003,650933,Avenancio-Leon; Carlos,9998,0,9999,1
1715643766487,AIP 197,004,658530,Heyman; Gail D.,9998,0,9999,1
1715643766487,AIP 197,005,658631,Neal; Sonya E,9998,0,9999,1
1715643766487,AIP 197,006,658671,Du; Songzi,9998,0,9999,1
1715643767513,ANAR 135S,A00,494369,Braswell; Geoffrey E.,0,0,0,0
1715643768538,BENG 196,001,628496,Engler; Adam J.,9998,0,9999,1
1715643768538,BENG 196,002,660916,Watson; John Thomas,9998,0,9999,1
1715643769567,BISP 197,001,650773,Wilhelm; James E.,9994,0,9999,5
1715643769567,BISP 197,002,658904,Coleman; Aaron B.,9998,0,9999,1
1715643770593,CAT 124RS,A01,519847,Geibel; William,0,0,20,20
1715643771619,CAT 125RS,A01,515971,Geibel; William,0,0,20,20
1715643772652,CLRE 250,A00,511389,Morris; Sheldon,9992,0,9999,7
1715643773678,CLRE 251,A00,507176,Mehta; Ravindra L.,9992,0,9999,7
1715643773678,CLRE 251,B00,511410,Mehta; Ravindra L.,9998,0,9999,1
1715643774703,CLRE 252,A00,507189,Cuomo; Raphael Eduardo,9994,0,9999,5
1715643775729,CLRE 253,A00,507199,Vaida; Florin,9994,0,9999,5
1715643775729,CLRE 253,B00,507202,Vaida; Florin,9999,0,9999,0
1715643776755,CLRE 259,A00,507211,Patel; Hemal,9996,0,9999,3
1715643777780,CLRE 260,A00,507221,Cuomo; Raphael Eduardo,9999,0,9999,0
1715643778803,CLRE 297,001,507242,Cuomo; Raphael Eduardo,9999,0,9999,0
1715643779830,COGS 197,001,638244,Voytek; Bradley Thomas,9997,0,9999,2
1715643780861,CSE 191,A00,516875,Minnes Kemp; Mor Mia,9991,0,9999,8
1715643781886,CSE 197,001,637388,Minnes Kemp; Mor Mia,9992,0,9999,7
1715643782914,CSS 201S,A01,494383,Mignozzetti; Umberto,35,0,35,0
1715643783942,CSS 202S,A01,494387,Mignozzetti; Umberto,35,0,35,0
1715643784968,DSC 197,001,628532,Eldridge; Justin Matthew,9995,0,9999,4
1715643785992,EAP 100,A00,516065,Staff,9799,0,9999,200
1715643787018,ECE 45,A01,507414,Staff,32,0,60,28
1715643789066,ECE 111,A01,507420,Staff,11,0,50,39
1715643790094,ECE 197,001,548057,Sievenpiper; Daniel F.,9991,0,9999,8
1715643791120,EDS 115,A00,507243,Choi; Bailey Miyeon,6,0,28,22
1715643792148,EDS 117,A01,494379,Staff,0,6,34,35
1715643793179,EDS 125,A00,507246,Hopkins; Megan Beth,7,0,30,23
1715643794206,EDS 128A,A01,507264,Fargason; Sharon Gayle,5,0,26,21
1715643795232,EDS 128B,A01,507293,Pappas; Elizabeth,9,0,30,21
1715643796261,EDS 139,A00,507294,Fargason; Sharon Gayle,9,0,30,21
1715643796261,EDS 139,B00,507313,Pappas; Elizabeth,9,0,30,21
1715643797287,EDS 201,A00,507315,Staff,10,0,30,20
1715643798313,EDS 203,A01,507317,Halter; Christopher P.,10,0,30,20
1715643799338,EDS 204R,A01,507319,Halter; Christopher P.,0,3,30,30
1715643799338,EDS 204R,B01,507331,Heinzman; Erica M.,14,0,30,16
1715643800367,EDS 206R,A00,507332,Staff,0,4,30,30
1715643800367,EDS 206R,B00,507343,Staff,15,0,30,15
1715643801390,EDS 250,A00,507344,Hemans; Patricia Ann Benitez,20,0,40,20
1715643802415,EDS 281,A00,507345,Daly; Alan J.,18,0,18,0
1715643803441,EDS 284,A00,507350,Daly; Alan J.,16,0,16,0
1715643804471,EDS 286,A00,507359,Fine; Sarah,18,0,18,0
1715643805498,EDS 289C,A01,507361,Daly; Alan J.,18,0,18,0
1715643806523,EDS 290,A00,507366,Hofstetter; Carolyn,15,0,15,0
1715643807552,LIGM 5A,A00,507421,Fischer-Grunski; Eva K,17,0,20,3
1715643808578,LIGM 5B,A00,507423,Fischer-Grunski; Eva K,19,0,20,1
1715643809604,LIGM 5C,A00,507425,Fischer-Grunski; Eva K,19,0,20,1
1715643810633,LIIT 5AS,A00,507427,Carnelos; Chiara,20,0,20,0
1715643811662,LIIT 5BS,A00,507430,Carnelos; Chiara,20,0,20,0
1715643812687,LIIT 5CS,A00,507432,Carnelos; Chiara,20,0,20,0
1715643813715,LISP 5A,A00,507541,Munoz Sanchez; Alicia,11,0,20,9
1715643814741,LISP 5B,A00,507671,Munoz Sanchez; Alicia,8,0,20,12
1715643815772,LISP 5C,A00,507696,Munoz Sanchez; Alicia,8,0,20,12
1715643816797,MAE 197,001,528363,Boechler; Nicholas Sebastia,9998,0,9999,1
1715643817825,MATH 197,001,523477,Kedlaya; Kiran S.,9994,0,9999,5
1715643817825,MATH 197,002,563811,Zhang; Danna,9994,0,9999,5
1715643817825,MATH 197,003,628552,Dumitriu; Ioana,9998,0,9999,1
1715643817825,MATH 197,004,660885,Floyd; Eric,9998,0,9999,1
1715643818850,MCWP 40R,A00,518780,Staff,1,0,20,19
1715643818850,MCWP 40R,B00,518781,Carter; Jennifer A,10,0,20,10
1715643818850,MCWP 40R,C00,518783,Smith; Haydee Marie,5,0,20,15
1715643819878,MCWP 50R,A00,518791,Redela; Pamela Morgan,0,1,20,20
1715643819878,MCWP 50R,B00,518792,Krone; Jarret,0,2,20,20
1715643819878,MCWP 50R,C00,518793,Staff,0,4,20,20
1715643819878,MCWP 50R,D00,518794,Morshed; Michael James,0,1,20,20
1715643819878,MCWP 50R,E00,518795,Carter; Andrea L,0,2,20,20
1715643819878,MCWP 50R,F00,518796,Miller; Elizabeth Deen,0,1,20,20
1715643819878,MCWP 50R,G00,518797,Guillen; Melinda,0,1,20,20
1715643820905,MMW 12R,A01,514034,Herbst; Matthew,0,2,16,16
1715643820905,MMW 12R,A02,514035,Herbst; Matthew,0,0,16,16
1715643821929,MMW 13R,A01,514037,Staff,0,5,16,16
1715643821929,MMW 13R,A02,514039,Staff,0,5,16,16
1715643821929,MMW 13R,A03,628519,Staff,0,4,16,16
1715643823982,SIO 295LS,A00,523233,Staff,10,0,30,20
1715643825009,SIO 295S,A00,523232,Staff,10,0,30,20
1715643826036,SIOC 290S,A01,637330,Merrifield; Mark A,21,0,30,9
1715643827063,SIOC 291S,A01,637333,Gabriel; Corey John,21,0,30,9
1715643828088,SOCI 117,A01,494376,Staff,0,5,5,5
1715643829117,WES 237B,A00,494380,Staff,10,0,20,10
1715643831202,AESE 279B,A00,494370,Wade; Jon P,0,0,33,33
1715643832227,AIP 97,001,660915,Van Den Einde; Yael Dahlia,9998,0,9999,1
1715643833256,AIP 197,001,627712,Vespa; Emanuel Ignacio,9995,0,9999,4
1715643833256,AIP 197,002,650778,Amir; On,9998,0,9999,1
1715643833256,AIP 197,003,650933,Avenancio-Leon; Carlos,9998,0,9999,1
1715643833256,AIP 197,004,658530,Heyman; Gail D.,9998,0,9999,1
1715643833256,AIP 197,005,658631,Neal; Sonya E,9998,0,9999,1
1715643833256,AIP 197,006,658671,Du; Songzi,9998,0,9999,1
1715643834286,ANAR 135S,A00,494369,Braswell; Geoffrey E.,0,0,0,0
1715643835323,BENG 196,001,628496,Engler; Adam J.,9998,0,9999,1
1715643835323,BENG 196,002,660916,Watson; John Thomas,9998,0,9999,1
1715643836354,BISP 197,001,650773,Wilhelm; James E.,9994,0,9999,5
1715643836354,BISP 197,002,658904,Coleman; Aaron B.,9998,0,9999,1
1715643837379,CAT 124RS,A01,519847,Geibel; William,0,0,20,20
1715643838406,CAT 125RS,A01,515971,Geibel; William,0,0,20,20
1715643839432,CLRE 250,A00,511389,Morris; Sheldon,9992,0,9999,7
1715643840465,CLRE 251,A00,507176,Mehta; Ravindra L.,9992,0,9999,7
1715643840465,CLRE 251,B00,511410,Mehta; Ravindra L.,9998,0,9999,1
1715643841491,CLRE 252,A00,507189,Cuomo; Raphael Eduardo,9994,0,9999,5
1715643842519,CLRE 253,A00,507199,Vaida; Florin,9994,0,9999,5
1715643842519,CLRE 253,B00,507202,Vaida; Florin,9999,0,9999,0
1715643843544,CLRE 259,A00,507211,Patel; Hemal,9996,0,9999,3
1715643844572,CLRE 260,A00,507221,Cuomo; Raphael Eduardo,9999,0,9999,0
1715643845599,CLRE 297,001,507242,Cuomo; Raphael Eduardo,9999,0,9999,0
1715643846625,COGS 197,001,638244,Voytek; Bradley Thomas,9997,0,9999,2
1715643847649,CSE 191,A00,516875,Minnes Kemp; Mor Mia,9991,0,9999,8
1715643848675,CSE 197,001,637388,Minnes Kemp; Mor Mia,9992,0,9999,7
1715643849703,CSS 201S,A01,494383,Mignozzetti; Umberto,35,0,35,0
1715643850729,CSS 202S,A01,494387,Mignozzetti; Umberto,35,0,35,0
1715643851754,DSC 197,001,628532,Eldridge; Justin Matthew,9995,0,9999,4
1715643852779,EAP 100,A00,516065,Staff,9799,0,9999,200
1715643853808,ECE 45,A01,507414,Staff,32,0,60,28
1715643855864,ECE 111,A01,507420,Staff,11,0,50,39
1715643856892,ECE 197,001,548057,Sievenpiper; Daniel F.,9991,0,9999,8
1715643857920,EDS 115,A00,507243,Choi; Bailey Miyeon,6,0,28,22
1715643858948,EDS 117,A01,494379,Staff,0,6,34,35
1715643859974,EDS 125,A00,507246,Hopkins; Megan Beth,7,0,30,23
1715643860999,EDS 128A,A01,507264,Fargason; Sharon Gayle,5,0,26,21
1715643862028,EDS 128B,A01,507293,Pappas; Elizabeth,9,0,30,21
1715643863051,EDS 139,A00,507294,Fargason; Sharon Gayle,9,0,30,21
1715643863051,EDS 139,B00,507313,Pappas; Elizabeth,9,0,30,21
1715643864075,EDS 201,A00,507315,Staff,10,0,30,20
1715643865101,EDS 203,A01,507317,Halter; Christopher P.,10,0,30,20
1715643866129,EDS 204R,A01,507319,Halter; Christopher P.,0,3,30,30
1715643866129,EDS 204R,B01,507331,Heinzman; Erica M.,14,0,30,16
1715643867154,EDS 206R,A00,507332,Staff,0,4,30,30
1715643867154,EDS 206R,B00,507343,Staff,15,0,30,15
1715643868182,EDS 250,A00,507344,Hemans; Patricia Ann Benitez,20,0,40,20
1715643869207,EDS 281,A00,507345,Daly; Alan J.,18,0,18,0
1715643870259,EDS 284,A00,507350,Daly; Alan J.,16,0,16,0
1715643871284,EDS 286,A00,507359,Fine; Sarah,18,0,18,0
1715643872309,EDS 289C,A01,507361,Daly; Alan J.,18,0,18,0
1715643873335,EDS 290,A00,507366,Hofstetter; Carolyn,15,0,15,0
1715643874361,LIGM 5A,A00,507421,Fischer-Grunski; Eva K,17,0,20,3
1715643875386,LIGM 5B,A00,507423,Fischer-Grunski; Eva K,19,0,20,1
1715643876410,LIGM 5C,A00,507425,Fischer-Grunski; Eva K,19,0,20,1
1715643877437,LIIT 5AS,A00,507427,Carnelos; Chiara,20,0,20,0
1715643878467,LIIT 5BS,A00,507430,Carnelos; Chiara,20,0,20,0
1715643879497,LIIT 5CS,A00,507432,Carnelos; Chiara,20,0,20,0
1715643880528,LISP 5A,A00,507541,Munoz Sanchez; Alicia,11,0,20,9
1715643881557,LISP 5B,A00,507671,Munoz Sanchez; Alicia,8,0,20,12
1715643882586,LISP 5C,A00,507696,Munoz Sanchez; Alicia,8,0,20,12
1715643883611,MAE 197,001,528363,Boechler; Nicholas Sebastia,9998,0,9999,1
1715643884643,MATH 197,001,523477,Kedlaya; Kiran S.,9994,0,9999,5
1715643884643,MATH 197,002,563811,Zhang; Danna,9994,0,9999,5
1715643884643,MATH 197,003,628552,Dumitriu; Ioana,9998,0,9999,1
1715643884643,MATH 197,004,660885,Floyd; Eric,9998,0,9999,1
1715643885673,MCWP 40R,A00,518780,Staff,1,0,20,19
1715643885673,MCWP 40R,B00,518781,Carter; Jennifer A,10,0,20,10
1715643885673,MCWP 40R,C00,518783,Smith; Haydee Marie,5,0,20,15
1715643886699,MCWP 50R,A00,518791,Redela; Pamela Morgan,0,1,20,20
1715643886699,MCWP 50R,B00,518792,Krone; Jarret,0,2,20,20
1715643886699,MCWP 50R,C00,518793,Staff,0,4,20,20
1715643886699,MCWP 50R,D00,518794,Morshed; Michael James,0,1,20,20
1715643886699,MCWP 50R,E00,518795,Carter; Andrea L,0,2,20,20
1715643886699,MCWP 50R,F00,518796,Miller; Elizabeth Deen,0,1,20,20
1715643886699,MCWP 50R,G00,518797,Guillen; Melinda,0,1,20,20
1715643887723,MMW 12R,A01,514034,Herbst; Matthew,0,2,16,16
1715643887723,MMW 12R,A02,514035,Herbst; Matthew,0,0,16,16
1715643888749,MMW 13R,A01,514037,Staff,0,5,16,16
1715643888749,MMW 13R,A02,514039,Staff,0,5,16,16
1715643888749,MMW 13R,A03,628519,Staff,0,4,16,16
1715643890796,SIO 295LS,A00,523233,Staff,10,0,30,20
1715643891820,SIO 295S,A00,523232,Staff,10,0,30,20
1715643892844,SIOC 290S,A01,637330,Merrifield; Mark A,21,0,30,9
1715643893881,SIOC 291S,A01,637333,Gabriel; Corey John,21,0,30,9
1715643894907,SOCI 117,A01,494376,Staff,0,5,5,5
1715643895934,WES 237B,A00,494380,Staff,10,0,20,10
1715643898003,AESE 279B,A00,494370,Wade; Jon P,0,0,33,33
1715643899031,AIP 97,001,660915,Van Den Einde; Yael Dahlia,9998,0,9999,1
1715643900062,AIP 197,001,627712,Vespa; Emanuel Ignacio,9995,0,9999,4
1715643900062,AIP 197,002,650778,Amir; On,9998,0,9999,1
1715643900062,AIP 197,003,650933,Avenancio-Leon; Carlos,9998,0,9999,1
1715643900062,AIP 197,004,658530,Heyman; Gail D.,9998,0,9999,1
1715643900062,AIP 197,005,658631,Neal; Sonya E,9998,0,9999,1
1715643900062,AIP 197,006,658671,Du; Songzi,9998,0,9999,1
1715643901088,ANAR 135S,A00,494369,Braswell; Geoffrey E.,0,0,0,0
1715643902119,BENG 196,001,628496,Engler; Adam J.,9998,0,9999,1
1715643902119,BENG 196,002,660916,Watson; John Thomas,9998,0,9999,1
1715643903149,BISP 197,001,650773,Wilhelm; James E.,9994,0,9999,5
1715643903149,BISP 197,002,658904,Coleman; Aaron B.,9998,0,9999,1
1715643904180,CAT 124RS,A01,519847,Geibel; William,0,0,20,20
1715643905206,CAT 125RS,A01,515971,Geibel; William,0,0,20,20
1715643906231,CLRE 250,A00,511389,Morris; Sheldon,9992,0,9999,7
1715643907257,CLRE 251,A00,507176,Mehta; Ravindra L.,9992,0,9999,7
1715643907257,CLRE 251,B00,511410,Mehta; Ravindra L.,9998,0,9999,1
1715643908283,CLRE 252,A00,507189,Cuomo; Raphael Eduardo,9994,0,9999,5
1715643909311,CLRE 253,A00,507199,Vaida; Florin,9994,0,9999,5
1715643909311,CLRE 253,B00,507202,Vaida; Florin,9999,0,9999,0
1715643910339,CLRE 259,A00,507211,Patel; Hemal,9996,0,9999,3
1715643911363,CLRE 260,A00,507221,Cuomo; Raphael Eduardo,9999,0,9999,0
1715643912388,CLRE 297,001,507242,Cuomo; Raphael Eduardo,9999,0,9999,0
1715643913412,COGS 197,001,638244,Voytek; Bradley Thomas,9997,0,9999,2
1715643914442,CSE 191,A00,516875,Minnes Kemp; Mor Mia,9991,0,9999,8
1715643915469,CSE 197,001,637388,Minnes Kemp; Mor Mia,9992,0,9999,7
1715643916494,CSS 201S,A01,494383,Mignozzetti; Umberto,35,0,35,0
1715643917523,CSS 202S,A01,494387,Mignozzetti; Umberto,35,0,35,0
1715643918548,DSC 197,001,628532,Eldridge; Justin Matthew,9995,0,9999,4
1715643919573,EAP 100,A00,516065,Staff,9799,0,9999,200
1715643920605,ECE 45,A01,507414,Staff,32,0,60,28
1715643922654,ECE 111,A01,507420,Staff,11,0,50,39
1715643923683,ECE 197,001,548057,Sievenpiper; Daniel F.,9991,0,9999,8
1715643924710,EDS 115,A00,507243,Choi; Bailey Miyeon,6,0,28,22
1715643925736,EDS 117,A01,494379,Staff,0,6,34,35
1715643926761,EDS 125,A00,507246,Hopkins; Megan Beth,7,0,30,23
1715643927790,EDS 128A,A01,507264,Fargason; Sharon Gayle,5,0,26,21
1715643928825,EDS 128B,A01,507293,Pappas; Elizabeth,9,0,30,21
1715643929850,EDS 139,A00,507294,Fargason; Sharon Gayle,9,0,30,21
1715643929850,EDS 139,B00,507313,Pappas; Elizabeth,9,0,30,21
1715643930875,EDS 201,A00,507315,Staff,10,0,30,20
1715643931903,EDS 203,A01,507317,Halter; Christopher P.,10,0,30,20
1715643932931,EDS 204R,A01,507319,Halter; Christopher P.,0,3,30,30
1715643932931,EDS 204R,B01,507331,Heinzman; Erica M.,14,0,30,16
1715643933954,EDS 206R,A00,507332,Staff,0,4,30,30
1715643933954,EDS 206R,B00,507343,Staff,15,0,30,15
1715643934982,EDS 250,A00,507344,Hemans; Patricia Ann Benitez,20,0,40,20
1715643936007,EDS 281,A00,507345,Daly; Alan J.,18,0,18,0
1715643937032,EDS 284,A00,507350,Daly; Alan J.,16,0,16,0
1715643938058,EDS 286,A00,507359,Fine; Sarah,18,0,18,0
1715643939086,EDS 289C,A01,507361,Daly; Alan J.,18,0,18,0
1715643940111,EDS 290,A00,507366,Hofstetter; Carolyn,15,0,15,0
1715643941137,LIGM 5A,A00,507421,Fischer-Grunski; Eva K,17,0,20,3
1715643942163,LIGM 5B,A00,507423,Fischer-Grunski; Eva K,19,0,20,1
1715643943190,LIGM 5C,A00,507425,Fischer-Grunski; Eva K,19,0,20,1
1715643944216,LIIT 5AS,A00,507427,Carnelos; Chiara,20,0,20,0
1715643945242,LIIT 5BS,A00,507430,Carnelos; Chiara,20,0,20,0
1715643946270,LIIT 5CS,A00,507432,Carnelos; Chiara,20,0,20,0
1715643947296,LISP 5A,A00,507541,Munoz Sanchez; Alicia,11,0,20,9
1715643948324,LISP 5B,A00,507671,Munoz Sanchez; Alicia,8,0,20,12
1715643949353,LISP 5C,A00,507696,Munoz Sanchez; Alicia,8,0,20,12
1715643950382,MAE 197,001,528363,Boechler; Nicholas Sebastia,9998,0,9999,1
1715643951412,MATH 197,001,523477,Kedlaya; Kiran S.,9994,0,9999,5
1715643951412,MATH 197,002,563811,Zhang; Danna,9994,0,9999,5
1715643951412,MATH 197,003,628552,Dumitriu; Ioana,9998,0,9999,1
1715643951412,MATH 197,004,660885,Floyd; Eric,9998,0,9999,1
1715643952443,MCWP 40R,A00,518780,Staff,1,0,20,19
1715643952443,MCWP 40R,B00,518781,Carter; Jennifer A,10,0,20,10
1715643952443,MCWP 40R,C00,518783,Smith; Haydee Marie,5,0,20,15
1715643953471,MCWP 50R,A00,518791,Redela; Pamela Morgan,0,1,20,20
1715643953471,MCWP 50R,B00,518792,Krone; Jarret,0,2,20,20
1715643953471,MCWP 50R,C00,518793,Staff,0,4,20,20
1715643953471,MCWP 50R,D00,518794,Morshed; Michael James,0,1,20,20
1715643953471,MCWP 50R,E00,518795,Carter; Andrea L,0,2,20,20
1715643953471,MCWP 50R,F00,518796,Miller; Elizabeth Deen,0,1,20,20
1715643953471,MCWP 50R,G00,518797,Guillen; Melinda,0,1,20,20
1715643954501,MMW 12R,A01,514034,Herbst; Matthew,0,2,16,16
1715643954501,MMW 12R,A02,514035,Herbst; Matthew,0,0,16,16
1715643955527,MMW 13R,A01,514037,Staff,0,5,16,16
1715643955527,MMW 13R,A02,514039,Staff,0,5,16,16
1715643955527,MMW 13R,A03,628519,Staff,0,4,16,16
1715643957578,SIO 295LS,A00,523233,Staff,10,0,30,20
1715643958606,SIO 295S,A00,523232,Staff,10,0,30,20
1715643959634,SIOC 290S,A01,637330,Merrifield; Mark A,21,0,30,9
1715643960663,SIOC 291S,A01,637333,Gabriel; Corey John,21,0,30,9
1715643961691,SOCI 117,A01,494376,Staff,0,5,5,5
1715643962716,WES 237B,A00,494380,Staff,10,0,20,10
1715643964790,AESE 279B,A00,494370,Wade; Jon P,0,0,33,33
1715643965818,AIP 97,001,660915,Van Den Einde; Yael Dahlia,9998,0,9999,1
1715643966850,AIP 197,001,627712,Vespa; Emanuel Ignacio,9995,0,9999,4
1715643966850,AIP 197,002,650778,Amir; On,9998,0,9999,1
1715643966850,AIP 197,003,650933,Avenancio-Leon; Carlos,9998,0,9999,1
1715643966850,AIP 197,004,658530,Heyman; Gail D.,9998,0,9999,1
1715643966850,AIP 197,005,658631,Neal; Sonya E,9998,0,9999,1
1715643966850,AIP 197,006,658671,Du; Songzi,9998,0,9999,1
1715643967874,ANAR 135S,A00,494369,Braswell; Geoffrey E.,0,0,0,0
1715643968901,BENG 196,001,628496,Engler; Adam J.,9998,0,9999,1
1715643968901,BENG 196,002,660916,Watson; John Thomas,9998,0,9999,1
1715643969925,BISP 197,001,650773,Wilhelm; James E.,9994,0,9999,5
1715643969925,BISP 197,002,658904,Coleman; Aaron B.,9998,0,9999,1
1715643970951,CAT 124RS,A01,519847,Geibel; William,0,0,20,20
1715643971979,CAT 125RS,A01,515971,Geibel; William,0,0,20,20
1715643973004,CLRE 250,A00,511389,Morris; Sheldon,9992,0,9999,7
1715643974034,CLRE 251,A00,507176,Mehta; Ravindra L.,9992,0,9999,7
1715643974034,CLRE 251,B00,511410,Mehta; Ravindra L.,9998,0,9999,1
1715643975060,CLRE 252,A00,507189,Cuomo; Raphael Eduardo,9994,0,9999,5
1715643976089,CLRE 253,A00,507199,Vaida; Florin,9994,0,9999,5
1715643976089,CLRE 253,B00,507202,Vaida; Florin,9999,0,9999,0
1715643977116,CLRE 259,A00,507211,Patel; Hemal,9996,0,9999,3
1715643978142,CLRE 260,A00,507221,Cuomo; Raphael Eduardo,9999,0,9999,0
1715643979167,CLRE 297,001,507242,Cuomo; Raphael Eduardo,9999,0,9999,0
1715643980193,COGS 197,001,638244,Voytek; Bradley Thomas,9997,0,9999,2
1715643981219,CSE 191,A00,516875,Minnes Kemp; Mor Mia,9991,0,9999,8
1715643982248,CSE 197,001,637388,Minnes Kemp; Mor Mia,9992,0,9999,7
1715643983275,CSS 201S,A01,494383,Mignozzetti; Umberto,35,0,35,0
1715643984304,CSS 202S,A01,494387,Mignozzetti; Umberto,35,0,35,0
1715643985336,DSC 197,001,628532,Eldridge; Justin Matthew,9995,0,9999,4
1715643986361,EAP 100,A00,516065,Staff,9799,0,9999,200
1715643987387,ECE 45,A01,507414,Staff,32,0,60,28
1715643989439,ECE 111,A01,507420,Staff,11,0,50,39
1715643990467,ECE 197,001,548057,Sievenpiper; Daniel F.,9991,0,9999,8
1715643991491,EDS 115,A00,507243,Choi; Bailey Miyeon,6,0,28,22
1715643992521,EDS 117,A01,494379,Staff,0,6,34,35
1715643993545,EDS 125,A00,507246,Hopkins; Megan Beth,7,0,30,23
1715643994575,EDS 128A,A01,507264,Fargason; Sharon Gayle,5,0,26,21
1715643995599,EDS 128B,A01,507293,Pappas; Elizabeth,9,0,30,21
1715643996626,EDS 139,A00,507294,Fargason; Sharon Gayle,9,0,30,21
1715643996626,EDS 139,B00,507313,Pappas; Elizabeth,9,0,30,21
1715643997650,EDS 201,A00,507315,Staff,10,0,30,20
1715643998680,EDS 203,A01,507317,Halter; Christopher P.,10,0,30,20
1715643999708,EDS 204R,A01,507319,Halter; Christopher P.,0,3,30,30
1715643999708,EDS 204R,B01,507331,Heinzman; Erica M.,14,0,30,16
1715644000732,EDS 206R,A00,507332,Staff,0,4,30,30
1715644000732,EDS 206R,B00,507343,Staff,15,0,30,15
1715644001759,EDS 250,A00,507344,Hemans; Patricia Ann Benitez,20,0,40,20
1715644002784,EDS 281,A00,507345,Daly; Alan J.,18,0,18,0
1715644003815,EDS 284,A00,507350,Daly; Alan J.,16,0,16,0
1715644004845,EDS 286,A00,507359,Fine; Sarah,18,0,18,0
1715644005870,EDS 289C,A01,507361,Daly; Alan J.,18,0,18,0
1715644006895,EDS 290,A00,507366,Hofstetter; Carolyn,15,0,15,0
1715644007926,LIGM 5A,A00,507421,Fischer-Grunski; Eva K,17,0,20,3
1715644008954,LIGM 5B,A00,507423,Fischer-Grunski; Eva K,19,0,20,1
1715644009982,LIGM 5C,A00,507425,Fischer-Grunski; Eva K,19,0,20,1
1715644011007,LIIT 5AS,A00,507427,Carnelos; Chiara,20,0,20,0
1715644012034,LIIT 5BS,A00,507430,Carnelos; Chiara,20,0,20,0
1715644013058,LIIT 5CS,A00,507432,Carnelos; Chiara,20,0,20,0
1715644014084,LISP 5A,A00,507541,Munoz Sanchez; Alicia,11,0,20,9
1715644015114,LISP 5B,A00,507671,Munoz Sanchez; Alicia,8,0,20,12
1715644016137,LISP 5C,A00,507696,Munoz Sanchez; Alicia,8,0,20,12
1715644017161,MAE 197,001,528363,Boechler; Nicholas Sebastia,9998,0,9999,1
1715644018190,MATH 197,001,523477,Kedlaya; Kiran S.,9994,0,9999,5
1715644018190,MATH 197,002,563811,Zhang; Danna,9994,0,9999,5
1715644018190,MATH 197,003,628552,Dumitriu; Ioana,9998,0,9999,1
1715644018190,MATH 197,004,660885,Floyd; Eric,9998,0,9999,1
1715644019218,MCWP 40R,A00,518780,Staff,1,0,20,19
1715644019218,MCWP 40R,B00,518781,Carter; Jennifer A,10,0,20,10
1715644019218,MCWP 40R,C00,518783,Smith; Haydee Marie,5,0,20,15
1715644020246,MCWP 50R,A00,518791,Redela; Pamela Morgan,0,1,20,20
1715644020246,MCWP 50R,B00,518792,Krone; Jarret,0,2,20,20
1715644020246,MCWP 50R,C00,518793,Staff,0,4,20,20
1715644020246,MCWP 50R,D00,518794,Morshed; Michael James,0,1,20,20
1715644020246,MCWP 50R,E00,518795,Carter; Andrea L,0,2,20,20
1715644020246,MCWP 50R,F00,518796,Miller; Elizabeth Deen,0,1,20,20
1715644020246,MCWP 50R,G00,518797,Guillen; Melinda,0,1,20,20
1715644021273,MMW 12R,A01,514034,Herbst; Matthew,0,2,16,16
1715644021273,MMW 12R,A02,514035,Herbst; Matthew,0,0,16,16
1715644022304,MMW 13R,A01,514037,Staff,0,5,16,16
1715644022304,MMW 13R,A02,514039,Staff,0,5,16,16
1715644022304,MMW 13R,A03,628519,Staff,0,4,16,16
1715644024356,SIO 295LS,A00,523233,Staff,10,0,30,20
1715644025383,SIO 295S,A00,523232,Staff,10,0,30,20
1715644026416,SIOC 290S,A01,637330,Merrifield; Mark A,21,0,30,9
1715644027441,SIOC 291S,A01,637333,Gabriel; Corey John,21,0,30,9
1715644028470,SOCI 117,A01,494376,Staff,0,5,5,5
1715644029495,WES 237B,A00,494380,Staff,10,0,20,10
1715644031563,AESE 279B,A00,494370,Wade; Jon P,0,0,33,33
1715644032587,AIP 97,001,660915,Van Den Einde; Yael Dahlia,9998,0,9999,1
1715644033615,AIP 197,001,627712,Vespa; Emanuel Ignacio,9995,0,9999,4
1715644033615,AIP 197,002,650778,Amir; On,9998,0,9999,1
1715644033615,AIP 197,003,650933,Avenancio-Leon; Carlos,9998,0,9999,1
1715644033615,AIP 197,004,658530,Heyman; Gail D.,9998,0,9999,1
1715644033615,AIP 197,005,658631,Neal; Sonya E,9998,0,9999,1
1715644033615,AIP 197,006,658671,Du; Songzi,9998,0,9999,1
1715644034642,ANAR 135S,A00,494369,Braswell; Geoffrey E.,0,0,0,0
1715644035665,BENG 196,001,628496,Engler; Adam J.,9998,0,9999,1
1715644035665,BENG 196,002,660916,Watson; John Thomas,9998,0,9999,1
1715644036697,BISP 197,001,650773,Wilhelm; James E.,9994,0,9999,5
1715644036697,BISP 197,002,658904,Coleman; Aaron B.,9998,0,9999,1
1715644037723,CAT 124RS,A01,519847,Geibel; William,0,0,20,20
1715644038748,CAT 125RS,A01,515971,Geibel; William,0,0,20,20
1715644039773,CLRE 250,A00,511389,Morris; Sheldon,9992,0,9999,7
1715644040829,CLRE 251,A00,507176,Mehta; Ravindra L.,9992,0,9999,7
1715644040829,CLRE 251,B00,511410,Mehta; Ravindra L.,9998,0,9999,1
1715644041854,CLRE 252,A00,507189,Cuomo; Raphael Eduardo,9994,0,9999,5
1715644042878,CLRE 253,A00,507199,Vaida; Florin,9994,0,9999,5
1715644042878,CLRE 253,B00,507202,Vaida; Florin,9999,0,9999,0
1715644043902,CLRE 259,A00,507211,Patel; Hemal,9996,0,9999,3
1715644044927,CLRE 260,A00,507221,Cuomo; Raphael Eduardo,9999,0,9999,0
1715644045953,CLRE 297,001,507242,Cuomo; Raphael Eduardo,9999,0,9999,0
1715644046979,COGS 197,001,638244,Voytek; Bradley Thomas,9997,0,9999,2
1715644048008,CSE 191,A00,516875,Minnes Kemp; Mor Mia,9991,0,9999,8
1715644049032,CSE 197,001,637388,Minnes Kemp; Mor Mia,9992,0,9999,7
1715644050066,CSS 201S,A01,494383,Mignozzetti; Umberto,35,0,35,0
1715644051092,CSS 202S,A01,494387,Mignozzetti; Umberto,35,0,35,0
1715644052118,DSC 197,001,628532,Eldridge; Justin Matthew,9995,0,9999,4
1715644053148,EAP 100,A00,516065,Staff,9799,0,9999,200
1715644054180,ECE 45,A01,507414,Staff,32,0,60,28
1715644056236,ECE 111,A01,507420,Staff,11,0,50,39
1715644057263,ECE 197,001,548057,Sievenpiper; Daniel F.,9991,0,9999,8
1715644058290,EDS 115,A00,507243,Choi; Bailey Miyeon,6,0,28,22
1715644059322,EDS 117,A01,494379,Staff,0,6,34,35
1715644060351,EDS 125,A00,507246,Hopkins; Megan Beth,7,0,30,23
1715644061385,EDS 128A,A01,507264,Fargason; Sharon Gayle,5,0,26,21
1715644062415,EDS 128B,A01,507293,Pappas; Elizabeth,9,0,30,21
1715644063441,EDS 139,A00,507294,Fargason; Sharon Gayle,9,0,30,21
1715644063441,EDS 139,B00,507313,Pappas; Elizabeth,9,0,30,21
1715644064468,EDS 201,A00,507315,Staff,10,0,30,20
1715644065496,EDS 203,A01,507317,Halter; Christopher P.,10,0,30,20
1715644066522,EDS 204R,A01,507319,Halter; Christopher P.,0,3,30,30
1715644066522,EDS 204R,B01,507331,Heinzman; Erica M.,14,0,30,16
1715644067548,EDS 206R,A00,507332,Staff,0,4,30,30
1715644067548,EDS 206R,B00,507343,Staff,15,0,30,15
1715644068576,EDS 250,A00,507344,Hemans; Patricia Ann Benitez,20,0,40,20
1715644069605,EDS 281,A00,507345,Daly; Alan J.,18,0,18,0
1715644070631,EDS 284,A00,507350,Daly; Alan J.,16,0,16,0
1715644071657,EDS 286,A00,507359,Fine; Sarah,18,0,18,0
1715644072683,EDS 289C,A01,507361,Daly; Alan J.,18,0,18,0
1715644073709,EDS 290,A00,507366,Hofstetter; Carolyn,15,0,15,0
1715644074735,LIGM 5A,A00,507421,Fischer-Grunski; Eva K,17,0,20,3
1715644075761,LIGM 5B,A00,507423,Fischer-Grunski; Eva K,19,0,20,1
1715644076787,LIGM 5C,A00,507425,Fischer-Grunski; Eva K,19,0,20,1
1715644077817,LIIT 5AS,A00,507427,Carnelos; Chiara,20,0,20,0
1715644078843,LIIT 5BS,A00,507430,Carnelos; Chiara,20,0,20,0
1715644079873,LIIT 5CS,A00,507432,Carnelos; Chiara,20,0,20,0
1715644080900,LISP 5A,A00,507541,Munoz Sanchez; Alicia,11,0,20,9
1715644081926,LISP 5B,A00,507671,Munoz Sanchez; Alicia,8,0,20,12
1715644082956,LISP 5C,A00,507696,Munoz Sanchez; Alicia,8,0,20,12
1715644083981,MAE 197,001,528363,Boechler; Nicholas Sebastia,9998,0,9999,1
1715644085008,MATH 197,001,523477,Kedlaya; Kiran S.,9994,0,9999,5
1715644085008,MATH 197,002,563811,Zhang; Danna,9994,0,9999,5
1715644085008,MATH 197,003,628552,Dumitriu; Ioana,9998,0,9999,1
1715644085008,MATH 197,004,660885,Floyd; Eric,9998,0,9999,1
1715644086036,MCWP 40R,A00,518780,Staff,1,0,20,19
1715644086036,MCWP 40R,B00,518781,Carter; Jennifer A,10,0,20,10
1715644086036,MCWP 40R,C00,518783,Smith; Haydee Marie,5,0,20,15
1715644087070,MCWP 50R,A00,518791,Redela; Pamela Morgan,0,1,20,20
1715644087070,MCWP 50R,B00,518792,Krone; Jarret,0,2,20,20
1715644087070,MCWP 50R,C00,518793,Staff,0,4,20,20
1715644087070,MCWP 50R,D00,518794,Morshed; Michael James,0,1,20,20
1715644087070,MCWP 50R,E00,518795,Carter; Andrea L,0,2,20,20
1715644087070,MCWP 50R,F00,518796,Miller; Elizabeth Deen,0,1,20,20
1715644087070,MCWP 50R,G00,518797,Guillen; Melinda,0,1,20,20
1715644088095,MMW 12R,A01,514034,Herbst; Matthew,0,2,16,16
1715644088095,MMW 12R,A02,514035,Herbst; Matthew,0,0,16,16
1715644089124,MMW 13R,A01,514037,Staff,0,5,16,16
1715644089124,MMW 13R,A02,514039,Staff,0,5,16,16
1715644089124,MMW 13R,A03,628519,Staff,0,4,16,16
1715644091182,SIO 295LS,A00,523233,Staff,10,0,30,20
1715644092209,SIO 295S,A00,523232,Staff,10,0,30,20
1715644093241,SIOC 290S,A01,637330,Merrifield; Mark A,21,0,30,9
1715644094272,SIOC 291S,A01,637333,Gabriel; Corey John,21,0,30,9
1715644095298,SOCI 117,A01,494376,Staff,0,5,5,5
1715644096326,WES 237B,A00,494380,Staff,10,0,20,10
1715644098405,AESE 279B,A00,494370,Wade; Jon P,0,0,33,33
1715644099436,AIP 97,001,660915,Van Den Einde; Yael Dahlia,9998,0,9999,1
1715644100469,AIP 197,001,627712,Vespa; Emanuel Ignacio,9995,0,9999,4
1715644100469,AIP 197,002,650778,Amir; On,9998,0,9999,1
1715644100469,AIP 197,003,650933,Avenancio-Leon; Carlos,9998,0,9999,1
1715644100469,AIP 197,004,658530,Heyman; Gail D.,9998,0,9999,1
1715644100469,AIP 197,005,658631,Neal; Sonya E,9998,0,9999,1
1715644100469,AIP 197,006,658671,Du; Songzi,9998,0,9999,1
1715644101497,ANAR 135S,A00,494369,Braswell; Geoffrey E.,0,0,0,0
1715644102527,BENG 196,001,628496,Engler; Adam J.,9998,0,9999,1
1715644102527,BENG 196,002,660916,Watson; John Thomas,9998,0,9999,1
1715644103556,BISP 197,001,650773,Wilhelm; James E.,9994,0,9999,5
1715644103556,BISP 197,002,658904,Coleman; Aaron B.,9998,0,9999,1
1715644104585,CAT 124RS,A01,519847,Geibel; William,0,0,20,20
1715644105610,CAT 125RS,A01,515971,Geibel; William,0,0,20,20
1715644106640,CLRE 250,A00,511389,Morris; Sheldon,9992,0,9999,7
1715644107667,CLRE 251,A00,507176,Mehta; Ravindra L.,9992,0,9999,7
1715644107667,CLRE 251,B00,511410,Mehta; Ravindra L.,9998,0,9999,1
1715644108691,CLRE 252,A00,507189,Cuomo; Raphael Eduardo,9994,0,9999,5
1715644109718,CLRE 253,A00,507199,Vaida; Florin,9994,0,9999,5
1715644109718,CLRE 253,B00,507202,Vaida; Florin,9999,0,9999,0
1715644110745,CLRE 259,A00,507211,Patel; Hemal,9996,0,9999,3
1715644111769,CLRE 260,A00,507221,Cuomo; Raphael Eduardo,9999,0,9999,0
1715644112793,CLRE 297,001,507242,Cuomo; Raphael Eduardo,9999,0,9999,0
1715644113817,COGS 197,001,638244,Voytek; Bradley Thomas,9997,0,9999,2
1715644114844,CSE 191,A00,516875,Minnes Kemp; Mor Mia,9991,0,9999,8
1715644115871,CSE 197,001,637388,Minnes Kemp; Mor Mia,9992,0,9999,7
1715644116897,CSS 201S,A01,494383,Mignozzetti; Umberto,35,0,35,0
1715644117921,CSS 202S,A01,494387,Mignozzetti; Umberto,35,0,35,0
1715644118951,DSC 197,001,628532,Eldridge; Justin Matthew,9995,0,9999,4
1715644119975,EAP 100,A00,516065,Staff,9799,0,9999,200
1715644121003,ECE 45,A01,507414,Staff,32,0,60,28
1715644123067,ECE 111,A01,507420,Staff,11,0,50,39
1715644124095,ECE 197,001,548057,Sievenpiper; Daniel F.,9991,0,9999,8
1715644125123,EDS 115,A00,507243,Choi; Bailey Miyeon,6,0,28,22
1715644126151,EDS 117,A01,494379,Staff,0,6,34,35
1715644127179,EDS 125,A00,507246,Hopkins; Megan Beth,7,0,30,23
1715644128204,EDS 128A,A01,507264,Fargason; Sharon Gayle,5,0,26,21
1715644129232,EDS 128B,A01,507293,Pappas; Elizabeth,9,0,30,21
1715644130258,EDS 139,A00,507294,Fargason; Sharon Gayle,9,0,30,21
1715644130258,EDS 139,B00,507313,Pappas; Elizabeth,9,0,30,21
1715644131283,EDS 201,A00,507315,Staff,10,0,30,20
1715644132314,EDS 203,A01,507317,Halter; Christopher P.,10,0,30,20
1715644133343,EDS 204R,A01,507319,Halter; Christopher P.,0,3,30,30
1715644133343,EDS 204R,B01,507331,Heinzman; Erica M.,14,0,30,16
1715644134369,EDS 206R,A00,507332,Staff,0,4,30,30
1715644134369,EDS 206R,B00,507343,Staff,15,0,30,15
1715644135395,EDS 250,A00,507344,Hemans; Patricia Ann Benitez,20,0,40,20
1715644136424,EDS 281,A00,507345,Daly; Alan J.,18,0,18,0
1715644137450,EDS 284,A00,507350,Daly; Alan J.,16,0,16,0
1715644138477,EDS 286,A00,507359,Fine; Sarah,18,0,18,0
1715644139503,EDS 289C,A01,507361,Daly; Alan J.,18,0,18,0
1715644140533,EDS 290,A00,507366,Hofstetter; Carolyn,15,0,15,0
1715644141560,LIGM 5A,A00,507421,Fischer-Grunski; Eva K,17,0,20,3
1715644142586,LIGM 5B,A00,507423,Fischer-Grunski; Eva K,19,0,20,1
1715644143613,LIGM 5C,A00,507425,Fischer-Grunski; Eva K,19,0,20,1
1715644144644,LIIT 5AS,A00,507427,Carnelos; Chiara,20,0,20,0
1715644145672,LIIT 5BS,A00,507430,Carnelos; Chiara,20,0,20,0
1715644146697,LIIT 5CS,A00,507432,Carnelos; Chiara,20,0,20,0
1715644147724,LISP 5A,A00,507541,Munoz Sanchez; Alicia,11,0,20,9
1715644148750,LISP 5B,A00,507671,Munoz Sanchez; Alicia,8,0,20,12
1715644149781,LISP 5C,A00,507696,Munoz Sanchez; Alicia,8,0,20,12
1715644150805,MAE 197,001,528363,Boechler; Nicholas Sebastia,9998,0,9999,1
1715644151839,MATH 197,001,523477,Kedlaya; Kiran S.,9994,0,9999,5
1715644151839,MATH 197,002,563811,Zhang; Danna,9994,0,9999,5
1715644151839,MATH 197,003,628552,Dumitriu; Ioana,9998,0,9999,1
1715644151839,MATH 197,004,660885,Floyd; Eric,9998,0,9999,1
1715644152869,MCWP 40R,A00,518780,Staff,1,0,20,19
1715644152869,MCWP 40R,B00,518781,Carter; Jennifer A,10,0,20,10
1715644152869,MCWP 40R,C00,518783,Smith; Haydee Marie,5,0,20,15
1715644153908,MCWP 50R,A00,518791,Redela; Pamela Morgan,0,1,20,20
1715644153908,MCWP 50R,B00,518792,Krone; Jarret,0,2,20,20
1715644153908,MCWP 50R,C00,518793,Staff,0,4,20,20
1715644153908,MCWP 50R,D00,518794,Morshed; Michael James,0,1,20,20
1715644153908,MCWP 50R,E00,518795,Carter; Andrea L,0,2,20,20
1715644153908,MCWP 50R,F00,518796,Miller; Elizabeth Deen,0,1,20,20
1715644153908,MCWP 50R,G00,518797,Guillen; Melinda,0,1,20,20
1715644154939,MMW 12R,A01,514034,Herbst; Matthew,0,2,16,16
1715644154939,MMW 12R,A02,514035,Herbst; Matthew,0,0,16,16
1715644155965,MMW 13R,A01,514037,Staff,0,5,16,16
1715644155965,MMW 13R,A02,514039,Staff,0,5,16,16
1715644155965,MMW 13R,A03,628519,Staff,0,4,16,16
1715644158023,SIO 295LS,A00,523233,Staff,10,0,30,20
1715644159050,SIO 295S,A00,523232,Staff,10,0,30,20
1715644160102,SIOC 290S,A01,637330,Merrifield; Mark A,21,0,30,9
1715644161131,SIOC 291S,A01,637333,Gabriel; Corey John,21,0,30,9
1715644162158,SOCI 117,A01,494376,Staff,0,5,5,5
1715644163191,WES 237B,A00,494380,Staff,10,0,20,10
1715644165268,AESE 279B,A00,494370,Wade; Jon P,0,0,33,33
1715644166297,AIP 97,001,660915,Van Den Einde; Yael Dahlia,9998,0,9999,1
1715644167328,AIP 197,001,627712,Vespa; Emanuel Ignacio,9995,0,9999,4
1715644167328,AIP 197,002,650778,Amir; On,9998,0,9999,1
1715644167328,AIP 197,003,650933,Avenancio-Leon; Carlos,9998,0,9999,1
1715644167328,AIP 197,004,658530,Heyman; Gail D.,9998,0,9999,1
1715644167328,AIP 197,005,658631,Neal; Sonya E,9998,0,9999,1
1715644167328,AIP 197,006,658671,Du; Songzi,9998,0,9999,1
1715644168353,ANAR 135S,A00,494369,Braswell; Geoffrey E.,0,0,0,0
1715644169378,BENG 196,001,628496,Engler; Adam J.,9998,0,9999,1
1715644169378,BENG 196,002,660916,Watson; John Thomas,9998,0,9999,1
1715644170408,BISP 197,001,650773,Wilhelm; James E.,9994,0,9999,5
1715644170408,BISP 197,002,658904,Coleman; Aaron B.,9998,0,9999,1
1715644171434,CAT 124RS,A01,519847,Geibel; William,0,0,20,20
1715644172462,CAT 125RS,A01,515971,Geibel; William,0,0,20,20
1715644173488,CLRE 250,A00,511389,Morris; Sheldon,9992,0,9999,7
1715644174517,CLRE 251,A00,507176,Mehta; Ravindra L.,9992,0,9999,7
1715644174517,CLRE 251,B00,511410,Mehta; Ravindra L.,9998,0,9999,1
1715644175547,CLRE 252,A00,507189,Cuomo; Raphael Eduardo,9994,0,9999,5
1715644176573,CLRE 253,A00,507199,Vaida; Florin,9994,0,9999,5
1715644176573,CLRE 253,B00,507202,Vaida; Florin,9999,0,9999,0
1715644177598,CLRE 259,A00,507211,Patel; Hemal,9996,0,9999,3
1715644178626,CLRE 260,A00,507221,Cuomo; Raphael Eduardo,9999,0,9999,0
1715644179653,CLRE 297,001,507242,Cuomo; Raphael Eduardo,9999,0,9999,0
1715644180681,COGS 197,001,638244,Voytek; Bradley Thomas,9997,0,9999,2
1715644181709,CSE 191,A00,516875,Minnes Kemp; Mor Mia,9991,0,9999,8
1715644182736,CSE 197,001,637388,Minnes Kemp; Mor Mia,9992,0,9999,7
1715644183762,CSS 201S,A01,494383,Mignozzetti; Umberto,35,0,35,0
1715644184787,CSS 202S,A01,494387,Mignozzetti; Umberto,35,0,35,0
1715644185813,DSC 197,001,628532,Eldridge; Justin Matthew,9995,0,9999,4
1715644186838,EAP 100,A00,516065,Staff,9799,0,9999,200
1715644187869,ECE 45,A01,507414,Staff,32,0,60,28
1715644189917,ECE 111,A01,507420,Staff,11,0,50,39
1715644190946,ECE 197,001,548057,Sievenpiper; Daniel F.,9991,0,9999,8
1715644191973,EDS 115,A00,507243,Choi; Bailey Miyeon,6,0,28,22
1715644192999,EDS 117,A01,494379,Staff,0,6,34,35
1715644194026,EDS 125,A00,507246,Hopkins; Megan Beth,7,0,30,23
1715644195052,EDS 128A,A01,507264,Fargason; Sharon Gayle,5,0,26,21
1715644196136,EDS 128B,A01,507293,Pappas; Elizabeth,9,0,30,21
1715644197161,EDS 139,A00,507294,Fargason; Sharon Gayle,9,0,30,21
1715644197161,EDS 139,B00,507313,Pappas; Elizabeth,9,0,30,21
1715644198188,EDS 201,A00,507315,Staff,10,0,30,20
1715644199216,EDS 203,A01,507317,Halter; Christopher P.,10,0,30,20
1715644200243,EDS 204R,A01,507319,Halter; Christopher P.,0,3,30,30
1715644200243,EDS 204R,B01,507331,Heinzman; Erica M.,14,0,30,16
1715644201270,EDS 206R,A00,507332,Staff,0,4,30,30
1715644201270,EDS 206R,B00,507343,Staff,15,0,30,15
1715644202296,EDS 250,A00,507344,Hemans; Patricia Ann Benitez,20,0,40,20
1715644203327,EDS 281,A00,507345,Daly; Alan J.,18,0,18,0
1715644204354,EDS 284,A00,507350,Daly; Alan J.,16,0,16,0
1715644205381,EDS 286,A00,507359,Fine; Sarah,18,0,18,0
1715644206411,EDS 289C,A01,507361,Daly; Alan J.,18,0,18,0
1715644207437,EDS 290,A00,507366,Hofstetter; Carolyn,15,0,15,0
1715644208467,LIGM 5A,A00,507421,Fischer-Grunski; Eva K,17,0,20,3
1715644209493,LIGM 5B,A00,507423,Fischer-Grunski; Eva K,19,0,20,1
1715644210519,LIGM 5C,A00,507425,Fischer-Grunski; Eva K,19,0,20,1
1715644211549,LIIT 5AS,A00,507427,Carnelos; Chiara,20,0,20,0
1715644212576,LIIT 5BS,A00,507430,Carnelos; Chiara,20,0,20,0
1715644213604,LIIT 5CS,A00,507432,Carnelos; Chiara,20,0,20,0
1715644214632,LISP 5A,A00,507541,Munoz Sanchez; Alicia,11,0,20,9
1715644215657,LISP 5B,A00,507671,Munoz Sanchez; Alicia,8,0,20,12
1715644216684,LISP 5C,A00,507696,Munoz Sanchez; Alicia,8,0,20,12
1715644217713,MAE 197,001,528363,Boechler; Nicholas Sebastia,9998,0,9999,1
1715644218741,MATH 197,001,523477,Kedlaya; Kiran S.,9994,0,9999,5
1715644218741,MATH 197,002,563811,Zhang; Danna,9994,0,9999,5
1715644218741,MATH 197,003,628552,Dumitriu; Ioana,9998,0,9999,1
1715644218741,MATH 197,004,660885,Floyd; Eric,9998,0,9999,1
1715644219768,MCWP 40R,A00,518780,Staff,1,0,20,19
1715644219768,MCWP 40R,B00,518781,Carter; Jennifer A,10,0,20,10
1715644219768,MCWP 40R,C00,518783,Smith; Haydee Marie,5,0,20,15
1715644220796,MCWP 50R,A00,518791,Redela; Pamela Morgan,0,1,20,20
1715644220796,MCWP 50R,B00,518792,Krone; Jarret,0,2,20,20
1715644220796,MCWP 50R,C00,518793,Staff,0,4,20,20
1715644220796,MCWP 50R,D00,518794,Morshed; Michael James,0,1,20,20
1715644220796,MCWP 50R,E00,518795,Carter; Andrea L,0,2,20,20
1715644220796,MCWP 50R,F00,518796,Miller; Elizabeth Deen,0,1,20,20
1715644220796,MCWP 50R,G00,518797,Guillen; Melinda,0,1,20,20
1715644221824,MMW 12R,A01,514034,Herbst; Matthew,0,2,16,16
1715644221824,MMW 12R,A02,514035,Herbst; Matthew,0,0,16,16
1715644222851,MMW 13R,A01,514037,Staff,0,5,16,16
1715644222851,MMW 13R,A02,514039,Staff,0,5,16,16
1715644222851,MMW 13R,A03,628519,Staff,0,4,16,16
1715644224902,SIO 295LS,A00,523233,Staff,10,0,30,20
1715644225929,SIO 295S,A00,523232,Staff,10,0,30,20
1715644226959,SIOC 290S,A01,637330,Merrifield; Mark A,21,0,30,9
1715644227985,SIOC 291S,A01,637333,Gabriel; Corey John,21,0,30,9
1715644229014,SOCI 117,A01,494376,Staff,0,5,5,5
1715644230040,WES 237B,A00,494380,Staff,10,0,20,10
1715644232123,AESE 279B,A00,494370,Wade; Jon P,0,0,33,33
1715644233149,AIP 97,001,660915,Van Den Einde; Yael Dahlia,9998,0,9999,1
1715644234178,AIP 197,001,627712,Vespa; Emanuel Ignacio,9995,0,9999,4
1715644234178,AIP 197,002,650778,Amir; On,9998,0,9999,1
1715644234178,AIP 197,003,650933,Avenancio-Leon; Carlos,9998,0,9999,1
1715644234178,AIP 197,004,658530,Heyman; Gail D.,9998,0,9999,1
1715644234178,AIP 197,005,658631,Neal; Sonya E,9998,0,9999,1
1715644234178,AIP 197,006,658671,Du; Songzi,9998,0,9999,1
1715644235207,ANAR 135S,A00,494369,Braswell; Geoffrey E.,0,0,0,0
1715644236238,BENG 196,001,628496,Engler; Adam J.,9998,0,9999,1
1715644236238,BENG 196,002,660916,Watson; John Thomas,9998,0,9999,1
1715644237263,BISP 197,001,650773,Wilhelm; James E.,9994,0,9999,5
1715644237263,BISP 197,002,658904,Coleman; Aaron B.,9998,0,9999,1
1715644238290,CAT 124RS,A01,519847,Geibel; William,0,0,20,20
1715644239315,CAT 125RS,A01,515971,Geibel; William,0,0,20,20
1715644240343,CLRE 250,A00,511389,Morris; Sheldon,9992,0,9999,7
1715644241367,CLRE 251,A00,507176,Mehta; Ravindra L.,9992,0,9999,7
1715644241367,CLRE 251,B00,511410,Mehta; Ravindra L.,9998,0,9999,1
1715644242392,CLRE 252,A00,507189,Cuomo; Raphael Eduardo,9994,0,9999,5
1715644243418,CLRE 253,A00,507199,Vaida; Florin,9994,0,9999,5
1715644243418,CLRE 253,B00,507202,Vaida; Florin,9999,0,9999,0
1715644244447,CLRE 259,A00,507211,Patel; Hemal,9996,0,9999,3
1715644245474,CLRE 260,A00,507221,Cuomo; Raphael Eduardo,9999,0,9999,0
1715644246498,CLRE 297,001,507242,Cuomo; Raphael Eduardo,9999,0,9999,0
1715644247525,COGS 197,001,638244,Voytek; Bradley Thomas,9997,0,9999,2
1715644248551,CSE 191,A00,516875,Minnes Kemp; Mor Mia,9991,0,9999,8
1715644249577,CSE 197,001,637388,Minnes Kemp; Mor Mia,9992,0,9999,7
1715644250605,CSS 201S,A01,494383,Mignozzetti; Umberto,35,0,35,0
1715644251631,CSS 202S,A01,494387,Mignozzetti; Umberto,35,0,35,0
1715644252657,DSC 197,001,628532,Eldridge; Justin Matthew,9995,0,9999,4
1715644253683,EAP 100,A00,516065,Staff,9799,0,9999,200
1715644254714,ECE 45,A01,507414,Staff,32,0,60,28
1715644256763,ECE 111,A01,507420,Staff,11,0,50,39
1715644257792,ECE 197,001,548057,Sievenpiper; Daniel F.,9991,0,9999,8
1715644258823,EDS 115,A00,507243,Choi; Bailey Miyeon,6,0,28,22
1715644259851,EDS 117,A01,494379,Staff,0,6,34,35
1715644260879,EDS 125,A00,507246,Hopkins; Megan Beth,7,0,30,23
1715644261908,EDS 128A,A01,507264,Fargason; Sharon Gayle,5,0,26,21
1715644262934,EDS 128B,A01,507293,Pappas; Elizabeth,9,0,30,21
1715644263959,EDS 139,A00,507294,Fargason; Sharon Gayle,9,0,30,21
1715644263959,EDS 139,B00,507313,Pappas; Elizabeth,9,0,30,21
1715644264986,EDS 201,A00,507315,Staff,10,0,30,20
1715644266012,EDS 203,A01,507317,Halter; Christopher P.,10,0,30,20
1715644267036,EDS 204R,A01,507319,Halter; Christopher P.,0,3,30,30
1715644267036,EDS 204R,B01,507331,Heinzman; Erica M.,14,0,30,16
1715644268063,EDS 206R,A00,507332,Staff,0,4,30,30
1715644268063,EDS 206R,B00,507343,Staff,15,0,30,15
1715644269088,EDS 250,A00,507344,Hemans; Patricia Ann Benitez,20,0,40,20
1715644270114,EDS 281,A00,507345,Daly; Alan J.,18,0,18,0
1715644271140,EDS 284,A00,507350,Daly; Alan J.,16,0,16,0
1715644272165,EDS 286,A00,507359,Fine; Sarah,18,0,18,0
1715644273198,EDS 289C,A01,507361,Daly; Alan J.,18,0,18,0
1715644274223,EDS 290,A00,507366,Hofstetter; Carolyn,15,0,15,0
1715644275255,LIGM 5A,A00,507421,Fischer-Grunski; Eva K,17,0,20,3
1715644276283,LIGM 5B,A00,507423,Fischer-Grunski; Eva K,19,0,20,1
1715644277308,LIGM 5C,A00,507425,Fischer-Grunski; Eva K,19,0,20,1
1715644278341,LIIT 5AS,A00,507427,Carnelos; Chiara,20,0,20,0
1715644279367,LIIT 5BS,A00,507430,Carnelos; Chiara,20,0,20,0
1715644280393,LIIT 5CS,A00,507432,Carnelos; Chiara,20,0,20,0
1715644281419,LISP 5A,A00,507541,Munoz Sanchez; Alicia,11,0,20,9
1715644282444,LISP 5B,A00,507671,Munoz Sanchez; Alicia,8,0,20,12
1715644283472,LISP 5C,A00,507696,Munoz Sanchez; Alicia,8,0,20,12
1715644284499,MAE 197,001,528363,Boechler; Nicholas Sebastia,9998,0,9999,1
1715644285527,MATH 197,001,523477,Kedlaya; Kiran S.,9994,0,9999,5
1715644285527,MATH 197,002,563811,Zhang; Danna,9994,0,9999,5
1715644285527,MATH 197,003,628552,Dumitriu; Ioana,9998,0,9999,1
1715644285527,MATH 197,004,660885,Floyd; Eric,9998,0,9999,1
1715644286553,MCWP 40R,A00,518780,Staff,1,0,20,19
1715644286553,MCWP 40R,B00,518781,Carter; Jennifer A,10,0,20,10
1715644286553,MCWP 40R,C00,518783,Smith; Haydee Marie,5,0,20,15
1715644287581,MCWP 50R,A00,518791,Redela; Pamela Morgan,0,1,20,20
1715644287581,MCWP 50R,B00,518792,Krone; Jarret,0,2,20,20
1715644287581,MCWP 50R,C00,518793,Staff,0,4,20,20
1715644287581,MCWP 50R,D00,518794,Morshed; Michael James,0,1,20,20
1715644287581,MCWP 50R,E00,518795,Carter; Andrea L,0,2,20,20
1715644287581,MCWP 50R,F00,518796,Miller; Elizabeth Deen,0,1,20,20
1715644287581,MCWP 50R,G00,518797,Guillen; Melinda,0,1,20,20
1715644288610,MMW 12R,A01,514034,Herbst; Matthew,0,2,16,16
1715644288610,MMW 12R,A02,514035,Herbst; Matthew,0,0,16,16
1715644289636,MMW 13R,A01,514037,Staff,0,5,16,16
1715644289636,MMW 13R,A02,514039,Staff,0,5,16,16
1715644289636,MMW 13R,A03,628519,Staff,0,4,16,16
1715644291686,SIO 295LS,A00,523233,Staff,10,0,30,20
1715644292713,SIO 295S,A00,523232,Staff,10,0,30,20
1715644293740,SIOC 290S,A01,637330,Merrifield; Mark A,21,0,30,9
1715644294766,SIOC 291S,A01,637333,Gabriel; Corey John,21,0,30,9
1715644295791,SOCI 117,A01,494376,Staff,0,5,5,5
1715644296815,WES 237B,A00,494380,Staff,10,0,20,10
1715644298893,AESE 279B,A00,494370,Wade; Jon P,0,0,33,33
1715644299972,AIP 97,001,660915,Van Den Einde; Yael Dahlia,9998,0,9999,1
1715644301004,AIP 197,001,627712,Vespa; Emanuel Ignacio,9995,0,9999,4
1715644301004,AIP 197,002,650778,Amir; On,9998,0,9999,1
1715644301004,AIP 197,003,650933,Avenancio-Leon; Carlos,9998,0,9999,1
1715644301004,AIP 197,004,658530,Heyman; Gail D.,9998,0,9999,1
1715644301004,AIP 197,005,658631,Neal; Sonya E,9998,0,9999,1
1715644301004,AIP 197,006,658671,Du; Songzi,9998,0,9999,1
1715644302032,ANAR 135S,A00,494369,Braswell; Geoffrey E.,0,0,0,0
1715644303061,BENG 196,001,628496,Engler; Adam J.,9998,0,9999,1
1715644303061,BENG 196,002,660916,Watson; John Thomas,9998,0,9999,1
1715644304090,BISP 197,001,650773,Wilhelm; James E.,9994,0,9999,5
1715644304090,BISP 197,002,658904,Coleman; Aaron B.,9998,0,9999,1
1715644305117,CAT 124RS,A01,519847,Geibel; William,0,0,20,20
1715644306143,CAT 125RS,A01,515971,Geibel; William,0,0,20,20
1715644307168,CLRE 250,A00,511389,Morris; Sheldon,9992,0,9999,7
1715644308196,CLRE 251,A00,507176,Mehta; Ravindra L.,9992,0,9999,7
1715644308196,CLRE 251,B00,511410,Mehta; Ravindra L.,9998,0,9999,1
1715644309221,CLRE 252,A00,507189,Cuomo; Raphael Eduardo,9994,0,9999,5
1715644310250,CLRE 253,A00,507199,Vaida; Florin,9994,0,9999,5
1715644310250,CLRE 253,B00,507202,Vaida; Florin,9999,0,9999,0
1715644311277,CLRE 259,A00,507211,Patel; Hemal,9996,0,9999,3
1715644312304,CLRE 260,A00,507221,Cuomo; Raphael Eduardo,9999,0,9999,0
1715644313329,CLRE 297,001,507242,Cuomo; Raphael Eduardo,9999,0,9999,0
1715644314355,COGS 197,001,638244,Voytek; Bradley Thomas,9997,0,9999,2
1715644315380,CSE 191,A00,516875,Minnes Kemp; Mor Mia,9991,0,9999,8
1715644316407,CSE 197,001,637388,Minnes Kemp; Mor Mia,9992,0,9999,7
1715644317433,CSS 201S,A01,494383,Mignozzetti; Umberto,35,0,35,0
1715644318463,CSS 202S,A01,494387,Mignozzetti; Umberto,35,0,35,0
1715644319488,DSC 197,001,628532,Eldridge; Justin Matthew,9995,0,9999,4
1715644320515,EAP 100,A00,516065,Staff,9799,0,9999,200
1715644321546,ECE 45,A01,507414,Staff,32,0,60,28
1715644323598,ECE 111,A01,507420,Staff,11,0,50,39
1715644324629,ECE 197,001,548057,Sievenpiper; Daniel F.,9991,0,9999,8
1715644325655,EDS 115,A00,507243,Choi; Bailey Miyeon,6,0,28,22
1715644326682,EDS 117,A01,494379,Staff,0,6,34,35
1715644327710,EDS 125,A00,507246,Hopkins; Megan Beth,7,0,30,23
1715644328736,EDS 128A,A01,507264,Fargason; Sharon Gayle,5,0,26,21
1715644329766,EDS 128B,A01,507293,Pappas; Elizabeth,9,0,30,21
1715644330793,EDS 139,A00,507294,Fargason; Sharon Gayle,9,0,30,21
1715644330793,EDS 139,B00,507313,Pappas; Elizabeth,9,0,30,21
1715644331821,EDS 201,A00,507315,Staff,10,0,30,20
1715644332846,EDS 203,A01,507317,Halter; Christopher P.,10,0,30,20
1715644333873,EDS 204R,A01,507319,Halter; Christopher P.,0,3,30,30
1715644333873,EDS 204R,B01,507331,Heinzman; Erica M.,14,0,30,16
1715644334900,EDS 206R,A00,507332,Staff,0,4,30,30
1715644334900,EDS 206R,B00,507343,Staff,15,0,30,15
1715644335929,EDS 250,A00,507344,Hemans; Patricia Ann Benitez,20,0,40,20
1715644336957,EDS 281,A00,507345,Daly; Alan J.,18,0,18,0
1715644337981,EDS 284,A00,507350,Daly; Alan J.,16,0,16,0
1715644339009,EDS 286,A00,507359,Fine; Sarah,18,0,18,0
1715644340032,EDS 289C,A01,507361,Daly; Alan J.,18,0,18,0
1715644341057,EDS 290,A00,507366,Hofstetter; Carolyn,15,0,15,0
1715644342082,LIGM 5A,A00,507421,Fischer-Grunski; Eva K,17,0,20,3
1715644343111,LIGM 5B,A00,507423,Fischer-Grunski; Eva K,19,0,20,1
1715644344140,LIGM 5C,A00,507425,Fischer-Grunski; Eva K,19,0,20,1
1715644345166,LIIT 5AS,A00,507427,Carnelos; Chiara,20,0,20,0
1715644346191,LIIT 5BS,A00,507430,Carnelos; Chiara,20,0,20,0
1715644347216,LIIT 5CS,A00,507432,Carnelos; Chiara,20,0,20,0
1715644348242,LISP 5A,A00,507541,Munoz Sanchez; Alicia,11,0,20,9
1715644349267,LISP 5B,A00,507671,Munoz Sanchez; Alicia,8,0,20,12
1715644350293,LISP 5C,A00,507696,Munoz Sanchez; Alicia,8,0,20,12
1715644351318,MAE 197,001,528363,Boechler; Nicholas Sebastia,9998,0,9999,1
1715644352346,MATH 197,001,523477,Kedlaya; Kiran S.,9994,0,9999,5
1715644352346,MATH 197,002,563811,Zhang; Danna,9994,0,9999,5
1715644352346,MATH 197,003,628552,Dumitriu; Ioana,9998,0,9999,1
1715644352346,MATH 197,004,660885,Floyd; Eric,9998,0,9999,1
1715644353373,MCWP 40R,A00,518780,Staff,1,0,20,19
1715644353373,MCWP 40R,B00,518781,Carter; Jennifer A,10,0,20,10
1715644353373,MCWP 40R,C00,518783,Smith; Haydee Marie,5,0,20,15
1715644354401,MCWP 50R,A00,518791,Redela; Pamela Morgan,0,1,20,20
1715644354401,MCWP 50R,B00,518792,Krone; Jarret,0,2,20,20
1715644354401,MCWP 50R,C00,518793,Staff,0,4,20,20
1715644354401,MCWP 50R,D00,518794,Morshed; Michael James,0,1,20,20
1715644354401,MCWP 50R,E00,518795,Carter; Andrea L,0,2,20,20
1715644354401,MCWP 50R,F00,518796,Miller; Elizabeth Deen,0,1,20,20
1715644354401,MCWP 50R,G00,518797,Guillen; Melinda,0,1,20,20
1715644355427,MMW 12R,A01,514034,Herbst; Matthew,0,2,16,16
1715644355427,MMW 12R,A02,514035,Herbst; Matthew,0,0,16,16
1715644356455,MMW 13R,A01,514037,Staff,0,5,16,16
1715644356455,MMW 13R,A02,514039,Staff,0,5,16,16
1715644356455,MMW 13R,A03,628519,Staff,0,4,16,16
1715644358512,SIO 295LS,A00,523233,Staff,10,0,30,20
1715644359536,SIO 295S,A00,523232,Staff,10,0,30,20
1715644360563,SIOC 290S,A01,637330,Merrifield; Mark A,21,0,30,9
1715644361588,SIOC 291S,A01,637333,Gabriel; Corey John,21,0,30,9
1715644362617,SOCI 117,A01,494376,Staff,0,5,5,5
1715644363642,WES 237B,A00,494380,Staff,10,0,20,10
1715644365723,AESE 279B,A00,494370,Wade; Jon P,0,0,33,33
1715644366749,AIP 97,001,660915,Van Den Einde; Yael Dahlia,9998,0,9999,1
1715644367778,AIP 197,001,627712,Vespa; Emanuel Ignacio,9995,0,9999,4
1715644367778,AIP 197,002,650778,Amir; On,9998,0,9999,1
1715644367778,AIP 197,003,650933,Avenancio-Leon; Carlos,9998,0,9999,1
1715644367778,AIP 197,004,658530,Heyman; Gail D.,9998,0,9999,1
1715644367778,AIP 197,005,658631,Neal; Sonya E,9998,0,9999,1
1715644367778,AIP 197,006,658671,Du; Songzi,9998,0,9999,1
1715644368804,ANAR 135S,A00,494369,Braswell; Geoffrey E.,0,0,0,0
1715644369829,BENG 196,001,628496,Engler; Adam J.,9998,0,9999,1
1715644369829,BENG 196,002,660916,Watson; John Thomas,9998,0,9999,1
1715644370856,BISP 197,001,650773,Wilhelm; James E.,9994,0,9999,5
1715644370856,BISP 197,002,658904,Coleman; Aaron B.,9998,0,9999,1
1715644371885,CAT 124RS,A01,519847,Geibel; William,0,0,20,20
1715644372909,CAT 125RS,A01,515971,Geibel; William,0,0,20,20
1715644373939,CLRE 250,A00,511389,Morris; Sheldon,9992,0,9999,7
1715644374965,CLRE 251,A00,507176,Mehta; Ravindra L.,9992,0,9999,7
1715644374965,CLRE 251,B00,511410,Mehta; Ravindra L.,9998,0,9999,1
1715644375994,CLRE 252,A00,507189,Cuomo; Raphael Eduardo,9994,0,9999,5
1715644377019,CLRE 253,A00,507199,Vaida; Florin,9994,0,9999,5
1715644377019,CLRE 253,B00,507202,Vaida; Florin,9999,0,9999,0
1715644378048,CLRE 259,A00,507211,Patel; Hemal,9996,0,9999,3
1715644379072,CLRE 260,A00,507221,Cuomo; Raphael Eduardo,9999,0,9999,0
1715644380099,CLRE 297,001,507242,Cuomo; Raphael Eduardo,9999,0,9999,0
1715644381125,COGS 197,001,638244,Voytek; Bradley Thomas,9997,0,9999,2
1715644382153,CSE 191,A00,516875,Minnes Kemp; Mor Mia,9991,0,9999,8
1715644383180,CSE 197,001,637388,Minnes Kemp; Mor Mia,9992,0,9999,7
1715644384211,CSS 201S,A01,494383,Mignozzetti; Umberto,35,0,35,0
1715644385236,CSS 202S,A01,494387,Mignozzetti; Umberto,35,0,35,0
1715644386264,DSC 197,001,628532,Eldridge; Justin Matthew,9995,0,9999,4
1715644387290,EAP 100,A00,516065,Staff,9799,0,9999,200
1715644388318,ECE 45,A01,507414,Staff,32,0,60,28
1715644390367,ECE 111,A01,507420,Staff,11,0,50,39
1715644391393,ECE 197,001,548057,Sievenpiper; Daniel F.,9991,0,9999,8
1715644392423,EDS 115,A00,507243,Choi; Bailey Miyeon,6,0,28,22
1715644393452,EDS 117,A01,494379,Staff,0,6,34,35
1715644394480,EDS 125,A00,507246,Hopkins; Megan Beth,7,0,30,23
1715644395506,EDS 128A,A01,507264,Fargason; Sharon Gayle,5,0,26,21
1715644396532,EDS 128B,A01,507293,Pappas; Elizabeth,9,0,30,21
1715644397561,EDS 139,A00,507294,Fargason; Sharon Gayle,9,0,30,21
1715644397561,EDS 139,B00,507313,Pappas; Elizabeth,9,0,30,21
1715644398589,EDS 201,A00,507315,Staff,10,0,30,20
1715644399618,EDS 203,A01,507317,Halter; Christopher P.,10,0,30,20
1715644400644,EDS 204R,A01,507319,Halter; Christopher P.,0,3,30,30
1715644400644,EDS 204R,B01,507331,Heinzman; Erica M.,14,0,30,16
1715644401670,EDS 206R,A00,507332,Staff,0,4,30,30
1715644401670,EDS 206R,B00,507343,Staff,15,0,30,15
1715644402698,EDS 250,A00,507344,Hemans; Patricia Ann Benitez,20,0,40,20
1715644403794,EDS 281,A00,507345,Daly; Alan J.,18,0,18,0
1715644404822,EDS 284,A00,507350,Daly; Alan J.,16,0,16,0
1715644405846,EDS 286,A00,507359,Fine; Sarah,18,0,18,0
1715644406875,EDS 289C,A01,507361,Daly; Alan J.,18,0,18,0
1715644407904,EDS 290,A00,507366,Hofstetter; Carolyn,15,0,15,0
1715644408930,LIGM 5A,A00,507421,Fischer-Grunski; Eva K,17,0,20,3
1715644409959,LIGM 5B,A00,507423,Fischer-Grunski; Eva K,19,0,20,1
1715644410984,LIGM 5C,A00,507425,Fischer-Grunski; Eva K,19,0,20,1
1715644412010,LIIT 5AS,A00,507427,Carnelos; Chiara,20,0,20,0
1715644413035,LIIT 5BS,A00,507430,Carnelos; Chiara,20,0,20,0
1715644414063,LIIT 5CS,A00,507432,Carnelos; Chiara,20,0,20,0
1715644415089,LISP 5A,A00,507541,Munoz Sanchez; Alicia,11,0,20,9
1715644416114,LISP 5B,A00,507671,Munoz Sanchez; Alicia,8,0,20,12
1715644417140,LISP 5C,A00,507696,Munoz Sanchez; Alicia,8,0,20,12
1715644418166,MAE 197,001,528363,Boechler; Nicholas Sebastia,9998,0,9999,1
1715644419193,MATH 197,001,523477,Kedlaya; Kiran S.,9994,0,9999,5
1715644419193,MATH 197,002,563811,Zhang; Danna,9994,0,9999,5
1715644419193,MATH 197,003,628552,Dumitriu; Ioana,9998,0,9999,1
1715644419193,MATH 197,004,660885,Floyd; Eric,9998,0,9999,1
1715644420219,MCWP 40R,A00,518780,Staff,1,0,20,19
1715644420219,MCWP 40R,B00,518781,Carter; Jennifer A,10,0,20,10
1715644420219,MCWP 40R,C00,518783,Smith; Haydee Marie,5,0,20,15
1715644421249,MCWP 50R,A00,518791,Redela; Pamela Morgan,0,1,20,20
1715644421249,MCWP 50R,B00,518792,Krone; Jarret,0,2,20,20
1715644421249,MCWP 50R,C00,518793,Staff,0,4,20,20
1715644421249,MCWP 50R,D00,518794,Morshed; Michael James,0,1,20,20
1715644421249,MCWP 50R,E00,518795,Carter; Andrea L,0,2,20,20
1715644421249,MCWP 50R,F00,518796,Miller; Elizabeth Deen,0,1,20,20
1715644421249,MCWP 50R,G00,518797,Guillen; Melinda,0,1,20,20
1715644422276,MMW 12R,A01,514034,Herbst; Matthew,0,2,16,16
1715644422276,MMW 12R,A02,514035,Herbst; Matthew,0,0,16,16
1715644423301,MMW 13R,A01,514037,Staff,0,5,16,16
1715644423301,MMW 13R,A02,514039,Staff,0,5,16,16
1715644423301,MMW 13R,A03,628519,Staff,0,4,16,16
1715644425352,SIO 295LS,A00,523233,Staff,10,0,30,20
1715644426377,SIO 295S,A00,523232,Staff,10,0,30,20
1715644427407,SIOC 290S,A01,637330,Merrifield; Mark A,21,0,30,9
1715644428437,SIOC 291S,A01,637333,Gabriel; Corey John,21,0,30,9
1715644429462,SOCI 117,A01,494376,Staff,0,5,5,5
1715644430488,WES 237B,A00,494380,Staff,10,0,20,10
1715644432553,AESE 279B,A00,494370,Wade; Jon P,0,0,33,33
1715644433584,AIP 97,001,660915,Van Den Einde; Yael Dahlia,9998,0,9999,1
1715644434615,AIP 197,001,627712,Vespa; Emanuel Ignacio,9995,0,9999,4
1715644434615,AIP 197,002,650778,Amir; On,9998,0,9999,1
1715644434615,AIP 197,003,650933,Avenancio-Leon; Carlos,9998,0,9999,1
1715644434615,AIP 197,004,658530,Heyman; Gail D.,9998,0,9999,1
1715644434615,AIP 197,005,658631,Neal; Sonya E,9998,0,9999,1
1715644434615,AIP 197,006,658671,Du; Songzi,9998,0,9999,1
1715644435640,ANAR 135S,A00,494369,Braswell; Geoffrey E.,0,0,0,0
1715644436668,BENG 196,001,628496,Engler; Adam J.,9998,0,9999,1
1715644436668,BENG 196,002,660916,Watson; John Thomas,9998,0,9999,1
1715644437695,BISP 197,001,650773,Wilhelm; James E.,9994,0,9999,5
1715644437695,BISP 197,002,658904,Coleman; Aaron B.,9998,0,9999,1
1715644438721,CAT 124RS,A01,519847,Geibel; William,0,0,20,20
1715644439747,CAT 125RS,A01,515971,Geibel; William,0,0,20,20
1715644440777,CLRE 250,A00,511389,Morris; Sheldon,9992,0,9999,7
1715644441808,CLRE 251,A00,507176,Mehta; Ravindra L.,9992,0,9999,7
1715644441808,CLRE 251,B00,511410,Mehta; Ravindra L.,9998,0,9999,1
1715644442845,CLRE 252,A00,507189,Cuomo; Raphael Eduardo,9994,0,9999,5
1715644443870,CLRE 253,A00,507199,Vaida; Florin,9994,0,9999,5
1715644443870,CLRE 253,B00,507202,Vaida; Florin,9999,0,9999,0
1715644444896,CLRE 259,A00,507211,Patel; Hemal,9996,0,9999,3
1715644445921,CLRE 260,A00,507221,Cuomo; Raphael Eduardo,9999,0,9999,0
1715644446950,CLRE 297,001,507242,Cuomo; Raphael Eduardo,9999,0,9999,0
1715644447979,COGS 197,001,638244,Voytek; Bradley Thomas,9997,0,9999,2
1715644449006,CSE 191,A00,516875,Minnes Kemp; Mor Mia,9991,0,9999,8
1715644450032,CSE 197,001,637388,Minnes Kemp; Mor Mia,9992,0,9999,7
1715644451058,CSS 201S,A01,494383,Mignozzetti; Umberto,35,0,35,0
1715644452081,CSS 202S,A01,494387,Mignozzetti; Umberto,35,0,35,0
1715644453110,DSC 197,001,628532,Eldridge; Justin Matthew,9995,0,9999,4
1715644454137,EAP 100,A00,516065,Staff,9799,0,9999,200
1715644455167,ECE 45,A01,507414,Staff,32,0,60,28
1715644457221,ECE 111,A01,507420,Staff,11,0,50,39
1715644458248,ECE 197,001,548057,Sievenpiper; Daniel F.,9991,0,9999,8
1715644459278,EDS 115,A00,507243,Choi; Bailey Miyeon,6,0,28,22
1715644460302,EDS 117,A01,494379,Staff,0,6,34,35
1715644461327,EDS 125,A00,507246,Hopkins; Megan Beth,7,0,30,23
1715644462351,EDS 128A,A01,507264,Fargason; Sharon Gayle,5,0,26,21
1715644463379,EDS 128B,A01,507293,Pappas; Elizabeth,9,0,30,21
1715644464404,EDS 139,A00,507294,Fargason; Sharon Gayle,9,0,30,21
1715644464404,EDS 139,B00,507313,Pappas; Elizabeth,9,0,30,21
1715644465427,EDS 201,A00,507315,Staff,10,0,30,20
1715644466452,EDS 203,A01,507317,Halter; Christopher P.,10,0,30,20
1715644467477,EDS 204R,A01,507319,Halter; Christopher P.,0,3,30,30
1715644467477,EDS 204R,B01,507331,Heinzman; Erica M.,14,0,30,16
1715644468501,EDS 206R,A00,507332,Staff,0,4,30,30
1715644468501,EDS 206R,B00,507343,Staff,15,0,30,15
1715644469527,EDS 250,A00,507344,Hemans; Patricia Ann Benitez,20,0,40,20
1715644470556,EDS 281,A00,507345,Daly; Alan J.,18,0,18,0
1715644471582,EDS 284,A00,507350,Daly; Alan J.,16,0,16,0
1715644472608,EDS 286,A00,507359,Fine; Sarah,18,0,18,0
1715644473632,EDS 289C,A01,507361,Daly; Alan J.,18,0,18,0
1715644474659,EDS 290,A00,507366,Hofstetter; Carolyn,15,0,15,0
1715644475686,LIGM 5A,A00,507421,Fischer-Grunski; Eva K,17,0,20,3
1715644476710,LIGM 5B,A00,507423,Fischer-Grunski; Eva K,19,0,20,1
1715644477734,LIGM 5C,A00,507425,Fischer-Grunski; Eva K,19,0,20,1
1715644478759,LIIT 5AS,A00,507427,Carnelos; Chiara,20,0,20,0
1715644479789,LIIT 5BS,A00,507430,Carnelos; Chiara,20,0,20,0
1715644480816,LIIT 5CS,A00,507432,Carnelos; Chiara,20,0,20,0
1715644481842,LISP 5A,A00,507541,Munoz Sanchez; Alicia,11,0,20,9
1715644482870,LISP 5B,A00,507671,Munoz Sanchez; Alicia,8,0,20,12
1715644483904,LISP 5C,A00,507696,Munoz Sanchez; Alicia,8,0,20,12
1715644484933,MAE 197,001,528363,Boechler; Nicholas Sebastia,9998,0,9999,1
1715644485965,MATH 197,001,523477,Kedlaya; Kiran S.,9994,0,9999,5
1715644485965,MATH 197,002,563811,Zhang; Danna,9994,0,9999,5
1715644485965,MATH 197,003,628552,Dumitriu; Ioana,9998,0,9999,1
1715644485965,MATH 197,004,660885,Floyd; Eric,9998,0,9999,1
1715644486994,MCWP 40R,A00,518780,Staff,1,0,20,19
1715644486994,MCWP 40R,B00,518781,Carter; Jennifer A,10,0,20,10
1715644486994,MCWP 40R,C00,518783,Smith; Haydee Marie,5,0,20,15
1715644488021,MCWP 50R,A00,518791,Redela; Pamela Morgan,0,1,20,20
1715644488021,MCWP 50R,B00,518792,Krone; Jarret,0,2,20,20
1715644488021,MCWP 50R,C00,518793,Staff,0,4,20,20
1715644488021,MCWP 50R,D00,518794,Morshed; Michael James,0,1,20,20
1715644488021,MCWP 50R,E00,518795,Carter; Andrea L,0,2,20,20
1715644488021,MCWP 50R,F00,518796,Miller; Elizabeth Deen,0,1,20,20
1715644488021,MCWP 50R,G00,518797,Guillen; Melinda,0,1,20,20
1715644489046,MMW 12R,A01,514034,Herbst; Matthew,0,2,16,16
1715644489046,MMW 12R,A02,514035,Herbst; Matthew,0,0,16,16
1715644490070,MMW 13R,A01,514037,Staff,0,5,16,16
1715644490070,MMW 13R,A02,514039,Staff,0,5,16,16
1715644490070,MMW 13R,A03,628519,Staff,0,4,16,16
1715644492128,SIO 295LS,A00,523233,Staff,10,0,30,20
1715644493155,SIO 295S,A00,523232,Staff,10,0,30,20
1715644494185,SIOC 290S,A01,637330,Merrifield; Mark A,21,0,30,9
1715644495210,SIOC 291S,A01,637333,Gabriel; Corey John,21,0,30,9
1715644496240,SOCI 117,A01,494376,Staff,0,5,5,5
1715644497264,WES 237B,A00,494380,Staff,10,0,20,10
1715644499328,AESE 279B,A00,494370,Wade; Jon P,0,0,33,33
1715644500354,AIP 97,001,660915,Van Den Einde; Yael Dahlia,9998,0,9999,1
1715644501382,AIP 197,001,627712,Vespa; Emanuel Ignacio,9995,0,9999,4
1715644501382,AIP 197,002,650778,Amir; On,9998,0,9999,1
1715644501382,AIP 197,003,650933,Avenancio-Leon; Carlos,9998,0,9999,1
1715644501382,AIP 197,004,658530,Heyman; Gail D.,9998,0,9999,1
1715644501382,AIP 197,005,658631,Neal; Sonya E,9998,0,9999,1
1715644501382,AIP 197,006,658671,Du; Songzi,9998,0,9999,1
1715644502416,ANAR 135S,A00,494369,Braswell; Geoffrey E.,0,0,0,0
1715644503453,BENG 196,001,628496,Engler; Adam J.,9998,0,9999,1
1715644503453,BENG 196,002,660916,Watson; John Thomas,9998,0,9999,1
1715644504482,BISP 197,001,650773,Wilhelm; James E.,9994,0,9999,5
1715644504482,BISP 197,002,658904,Coleman; Aaron B.,9998,0,9999,1
1715644505507,CAT 124RS,A01,519847,Geibel; William,0,0,20,20
1715644506532,CAT 125RS,A01,515971,Geibel; William,0,0,20,20
1715644507559,CLRE 250,A00,511389,Morris; Sheldon,9992,0,9999,7
1715644508588,CLRE 251,A00,507176,Mehta; Ravindra L.,9992,0,9999,7
1715644508588,CLRE 251,B00,511410,Mehta; Ravindra L.,9998,0,9999,1
1715644509616,CLRE 252,A00,507189,Cuomo; Raphael Eduardo,9994,0,9999,5
1715644510640,CLRE 253,A00,507199,Vaida; Florin,9994,0,9999,5
1715644510640,CLRE 253,B00,507202,Vaida; Florin,9999,0,9999,0
1715644511670,CLRE 259,A00,507211,Patel; Hemal,9996,0,9999,3
1715644512698,CLRE 260,A00,507221,Cuomo; Raphael Eduardo,9999,0,9999,0
1715644513725,CLRE 297,001,507242,Cuomo; Raphael Eduardo,9999,0,9999,0
1715644514752,COGS 197,001,638244,Voytek; Bradley Thomas,9997,0,9999,2
1715644515781,CSE 191,A00,516875,Minnes Kemp; Mor Mia,9991,0,9999,8
1715644516808,CSE 197,001,637388,Minnes Kemp; Mor Mia,9992,0,9999,7
1715644517835,CSS 201S,A01,494383,Mignozzetti; Umberto,35,0,35,0
1715644518862,CSS 202S,A01,494387,Mignozzetti; Umberto,35,0,35,0
1715644519889,DSC 197,001,628532,Eldridge; Justin Matthew,9995,0,9999,4
1715644520917,EAP 100,A00,516065,Staff,9799,0,9999,200
1715644521942,ECE 45,A01,507414,Staff,32,0,60,28
1715644523990,ECE 111,A01,507420,Staff,11,0,50,39
1715644525018,ECE 197,001,548057,Sievenpiper; Daniel F.,9991,0,9999,8
1715644526045,EDS 115,A00,507243,Choi; Bailey Miyeon,6,0,28,22
1715644527070,EDS 117,A01,494379,Staff,0,6,34,35
1715644528095,EDS 125,A00,507246,Hopkins; Megan Beth,7,0,30,23
1715644529123,EDS 128A,A01,507264,Fargason; Sharon Gayle,5,0,26,21
1715644530148,EDS 128B,A01,507293,Pappas; Elizabeth,9,0,30,21
1715644531175,EDS 139,A00,507294,Fargason; Sharon Gayle,9,0,30,21
1715644531175,EDS 139,B00,507313,Pappas; Elizabeth,9,0,30,21
1715644532202,EDS 201,A00,507315,Staff,10,0,30,20
1715644533231,EDS 203,A01,507317,Halter; Christopher P.,10,0,30,20
1715644534256,EDS 204R,A01,507319,Halter; Christopher P.,0,3,30,30
1715644534256,EDS 204R,B01,507331,Heinzman; Erica M.,14,0,30,16
1715644535284,EDS 206R,A00,507332,Staff,0,4,30,30
1715644535284,EDS 206R,B00,507343,Staff,15,0,30,15
1715644536308,EDS 250,A00,507344,Hemans; Patricia Ann Benitez,20,0,40,20
1715644537332,EDS 281,A00,507345,Daly; Alan J.,18,0,18,0
1715644538359,EDS 284,A00,507350,Daly; Alan J.,16,0,16,0
1715644539386,EDS 286,A00,507359,Fine; Sarah,18,0,18,0
1715644540412,EDS 289C,A01,507361,Daly; Alan J.,18,0,18,0
1715644541437,EDS 290,A00,507366,Hofstetter; Carolyn,15,0,15,0
1715644542466,LIGM 5A,A00,507421,Fischer-Grunski; Eva K,17,0,20,3
1715644543490,LIGM 5B,A00,507423,Fischer-Grunski; Eva K,19,0,20,1
1715644544514,LIGM 5C,A00,507425,Fischer-Grunski; Eva K,19,0,20,1
1715644545539,LIIT 5AS,A00,507427,Carnelos; Chiara,20,0,20,0
1715644546568,LIIT 5BS,A00,507430,Carnelos; Chiara,20,0,20,0
1715644547592,LIIT 5CS,A00,507432,Carnelos; Chiara,20,0,20,0
1715644548619,LISP 5A,A00,507541,Munoz Sanchez; Alicia,11,0,20,9
1715644549645,LISP 5B,A00,507671,Munoz Sanchez; Alicia,8,0,20,12
1715644550672,LISP 5C,A00,507696,Munoz Sanchez; Alicia,8,0,20,12
1715644551698,MAE 197,001,528363,Boechler; Nicholas Sebastia,9998,0,9999,1
1715644552730,MATH 197,001,523477,Kedlaya; Kiran S.,9994,0,9999,5
1715644552730,MATH 197,002,563811,Zhang; Danna,9994,0,9999,5
1715644552730,MATH 197,003,628552,Dumitriu; Ioana,9998,0,9999,1
1715644552730,MATH 197,004,660885,Floyd; Eric,9998,0,9999,1
1715644553756,MCWP 40R,A00,518780,Staff,1,0,20,19
1715644553756,MCWP 40R,B00,518781,Carter; Jennifer A,10,0,20,10
1715644553756,MCWP 40R,C00,518783,Smith; Haydee Marie,5,0,20,15
1715644554792,MCWP 50R,A00,518791,Redela; Pamela Morgan,0,1,20,20
1715644554792,MCWP 50R,B00,518792,Krone; Jarret,0,2,20,20
1715644554792,MCWP 50R,C00,518793,Staff,0,4,20,20
1715644554792,MCWP 50R,D00,518794,Morshed; Michael James,0,1,20,20
1715644554792,MCWP 50R,E00,518795,Carter; Andrea L,0,2,20,20
1715644554792,MCWP 50R,F00,518796,Miller; Elizabeth Deen,0,1,20,20
1715644554792,MCWP 50R,G00,518797,Guillen; Melinda,0,1,20,20
1715644555818,MMW 12R,A01,514034,Herbst; Matthew,0,2,16,16
1715644555818,MMW 12R,A02,514035,Herbst; Matthew,0,0,16,16
1715644556845,MMW 13R,A01,514037,Staff,0,5,16,16
1715644556845,MMW 13R,A02,514039,Staff,0,5,16,16
1715644556845,MMW 13R,A03,628519,Staff,0,4,16,16
1715644558897,SIO 295LS,A00,523233,Staff,10,0,30,20
1715644559923,SIO 295S,A00,523232,Staff,10,0,30,20
1715644560950,SIOC 290S,A01,637330,Merrifield; Mark A,21,0,30,9
1715644561980,SIOC 291S,A01,637333,Gabriel; Corey John,21,0,30,9
1715644563008,SOCI 117,A01,494376,Staff,0,5,5,5
1715644564032,WES 237B,A00,494380,Staff,10,0,20,10
1715644566110,AESE 279B,A00,494370,Wade; Jon P,0,0,33,33
1715644567135,AIP 97,001,660915,Van Den Einde; Yael Dahlia,9998,0,9999,1
1715644568164,AIP 197,001,627712,Vespa; Emanuel Ignacio,9995,0,9999,4
1715644568164,AIP 197,002,650778,Amir; On,9998,0,9999,1
1715644568164,AIP 197,003,650933,Avenancio-Leon; Carlos,9998,0,9999,1
1715644568164,AIP 197,004,658530,Heyman; Gail D.,9998,0,9999,1
1715644568164,AIP 197,005,658631,Neal; Sonya E,9998,0,9999,1
1715644568164,AIP 197,006,658671,Du; Songzi,9998,0,9999,1
1715644569194,ANAR 135S,A00,494369,Braswell; Geoffrey E.,0,0,0,0
1715644570226,BENG 196,001,628496,Engler; Adam J.,9998,0,9999,1
1715644570226,BENG 196,002,660916,Watson; John Thomas,9998,0,9999,1
1715644571254,BISP 197,001,650773,Wilhelm; James E.,9994,0,9999,5
1715644571254,BISP 197,002,658904,Coleman; Aaron B.,9998,0,9999,1
1715644572280,CAT 124RS,A01,519847,Geibel; William,0,0,20,20
1715644573304,CAT 125RS,A01,515971,Geibel; William,0,0,20,20
1715644574331,CLRE 250,A00,511389,Morris; Sheldon,9992,0,9999,7
1715644575356,CLRE 251,A00,507176,Mehta; Ravindra L.,9992,0,9999,7
1715644575356,CLRE 251,B00,511410,Mehta; Ravindra L.,9998,0,9999,1
1715644576386,CLRE 252,A00,507189,Cuomo; Raphael Eduardo,9994,0,9999,5
1715644577410,CLRE 253,A00,507199,Vaida; Florin,9994,0,9999,5
1715644577410,CLRE 253,B00,507202,Vaida; Florin,9999,0,9999,0
1715644578439,CLRE 259,A00,507211,Patel; Hemal,9996,0,9999,3
1715644579466,CLRE 260,A00,507221,Cuomo; Raphael Eduardo,9999,0,9999,0
1715644580491,CLRE 297,001,507242,Cuomo; Raphael Eduardo,9999,0,9999,0
1715644581516,COGS 197,001,638244,Voytek; Bradley Thomas,9997,0,9999,2
1715644582544,CSE 191,A00,516875,Minnes Kemp; Mor Mia,9991,0,9999,8
1715644583572,CSE 197,001,637388,Minnes Kemp; Mor Mia,9992,0,9999,7
1715644584597,CSS 201S,A01,494383,Mignozzetti; Umberto,35,0,35,0
1715644585623,CSS 202S,A01,494387,Mignozzetti; Umberto,35,0,35,0
1715644586648,DSC 197,001,628532,Eldridge; Justin Matthew,9995,0,9999,4
1715644587672,EAP 100,A00,516065,Staff,9799,0,9999,200
1715644588697,ECE 45,A01,507414,Staff,32,0,60,28
1715644590747,ECE 111,A01,507420,Staff,11,0,50,39
1715644591772,ECE 197,001,548057,Sievenpiper; Daniel F.,9991,0,9999,8
1715644592797,EDS 115,A00,507243,Choi; Bailey Miyeon,6,0,28,22
1715644593824,EDS 117,A01,494379,Staff,0,6,34,35
1715644594848,EDS 125,A00,507246,Hopkins; Megan Beth,7,0,30,23
1715644595874,EDS 128A,A01,507264,Fargason; Sharon Gayle,5,0,26,21
1715644596903,EDS 128B,A01,507293,Pappas; Elizabeth,9,0,30,21
1715644597926,EDS 139,A00,507294,Fargason; Sharon Gayle,9,0,30,21
1715644597926,EDS 139,B00,507313,Pappas; Elizabeth,9,0,30,21
1715644598951,EDS 201,A00,507315,Staff,10,0,30,20
1715644599976,EDS 203,A01,507317,Halter; Christopher P.,10,0,30,20
1715644601002,EDS 204R,A01,507319,Halter; Christopher P.,0,3,30,30
1715644601002,EDS 204R,B01,507331,Heinzman; Erica M.,14,0,30,16
1715644602026,EDS 206R,A00,507332,Staff,0,4,30,30
1715644602026,EDS 206R,B00,507343,Staff,15,0,30,15
1715644603051,EDS 250,A00,507344,Hemans; Patricia Ann Benitez,20,0,40,20
1715644604077,EDS 281,A00,507345,Daly; Alan J.,18,0,18,0
1715644605104,EDS 284,A00,507350,Daly; Alan J.,16,0,16,0
1715644606131,EDS 286,A00,507359,Fine; Sarah,18,0,18,0
1715644607157,EDS 289C,A01,507361,Daly; Alan J.,18,0,18,0
1715644608183,EDS 290,A00,507366,Hofstetter; Carolyn,15,0,15,0
1715644609211,LIGM 5A,A00,507421,Fischer-Grunski; Eva K,17,0,20,3
1715644610236,LIGM 5B,A00,507423,Fischer-Grunski; Eva K,19,0,20,1
1715644611321,LIGM 5C,A00,507425,Fischer-Grunski; Eva K,19,0,20,1
1715644612346,LIIT 5AS,A00,507427,Carnelos; Chiara,20,0,20,0
1715644613372,LIIT 5BS,A00,507430,Carnelos; Chiara,20,0,20,0
1715644614399,LIIT 5CS,A00,507432,Carnelos; Chiara,20,0,20,0
1715644615428,LISP 5A,A00,507541,Munoz Sanchez; Alicia,11,0,20,9
1715644616452,LISP 5B,A00,507671,Munoz Sanchez; Alicia,8,0,20,12
1715644617479,LISP 5C,A00,507696,Munoz Sanchez; Alicia,8,0,20,12
1715644618504,MAE 197,001,528363,Boechler; Nicholas Sebastia,9998,0,9999,1
1715644619531,MATH 197,001,523477,Kedlaya; Kiran S.,9994,0,9999,5
1715644619531,MATH 197,002,563811,Zhang; Danna,9994,0,9999,5
1715644619531,MATH 197,003,628552,Dumitriu; Ioana,9998,0,9999,1
1715644619531,MATH 197,004,660885,Floyd; Eric,9998,0,9999,1
1715644620562,MCWP 40R,A00,518780,Staff,1,0,20,19
1715644620562,MCWP 40R,B00,518781,Carter; Jennifer A,10,0,20,10
1715644620562,MCWP 40R,C00,518783,Smith; Haydee Marie,5,0,20,15
1715644621591,MCWP 50R,A00,518791,Redela; Pamela Morgan,0,1,20,20
1715644621591,MCWP 50R,B00,518792,Krone; Jarret,0,2,20,20
1715644621591,MCWP 50R,C00,518793,Staff,0,4,20,20
1715644621591,MCWP 50R,D00,518794,Morshed; Michael James,0,1,20,20
1715644621591,MCWP 50R,E00,518795,Carter; Andrea L,0,2,20,20
1715644621591,MCWP 50R,F00,518796,Miller; Elizabeth Deen,0,1,20,20
1715644621591,MCWP 50R,G00,518797,Guillen; Melinda,0,1,20,20
1715644622618,MMW 12R,A01,514034,Herbst; Matthew,0,2,16,16
1715644622618,MMW 12R,A02,514035,Herbst; Matthew,0,0,16,16
1715644623645,MMW 13R,A01,514037,Staff,0,5,16,16
1715644623645,MMW 13R,A02,514039,Staff,0,5,16,16
1715644623645,MMW 13R,A03,628519,Staff,0,4,16,16
1715644625699,SIO 295LS,A00,523233,Staff,10,0,30,20
1715644626725,SIO 295S,A00,523232,Staff,10,0,30,20
1715644627751,SIOC 290S,A01,637330,Merrifield; Mark A,21,0,30,9
1715644628780,SIOC 291S,A01,637333,Gabriel; Corey John,21,0,30,9
1715644629806,SOCI 117,A01,494376,Staff,0,5,5,5
1715644630832,WES 237B,A00,494380,Staff,10,0,20,10
1715644632906,AESE 279B,A00,494370,Wade; Jon P,0,0,33,33
1715644633931,AIP 97,001,660915,Van Den Einde; Yael Dahlia,9998,0,9999,1
1715644634961,AIP 197,001,627712,Vespa; Emanuel Ignacio,9995,0,9999,4
1715644634961,AIP 197,002,650778,Amir; On,9998,0,9999,1
1715644634961,AIP 197,003,650933,Avenancio-Leon; Carlos,9998,0,9999,1
1715644634961,AIP 197,004,658530,Heyman; Gail D.,9998,0,9999,1
1715644634961,AIP 197,005,658631,Neal; Sonya E,9998,0,9999,1
1715644634961,AIP 197,006,658671,Du; Songzi,9998,0,9999,1
1715644635989,ANAR 135S,A00,494369,Braswell; Geoffrey E.,0,0,0,0
1715644637018,BENG 196,001,628496,Engler; Adam J.,9998,0,9999,1
1715644637018,BENG 196,002,660916,Watson; John Thomas,9998,0,9999,1
1715644638043,BISP 197,001,650773,Wilhelm; James E.,9994,0,9999,5
1715644638043,BISP 197,002,658904,Coleman; Aaron B.,9998,0,9999,1
1715644639070,CAT 124RS,A01,519847,Geibel; William,0,0,20,20
1715644640096,CAT 125RS,A01,515971,Geibel; William,0,0,20,20
1715644641121,CLRE 250,A00,511389,Morris; Sheldon,9992,0,9999,7
1715644642148,CLRE 251,A00,507176,Mehta; Ravindra L.,9992,0,9999,7
1715644642148,CLRE 251,B00,511410,Mehta; Ravindra L.,9998,0,9999,1
1715644643176,CLRE 252,A00,507189,Cuomo; Raphael Eduardo,9994,0,9999,5
1715644644203,CLRE 253,A00,507199,Vaida; Florin,9994,0,9999,5
1715644644203,CLRE 253,B00,507202,Vaida; Florin,9999,0,9999,0
1715644645230,CLRE 259,A00,507211,Patel; Hemal,9996,0,9999,3
1715644646254,CLRE 260,A00,507221,Cuomo; Raphael Eduardo,9999,0,9999,0
1715644647280,CLRE 297,001,507242,Cuomo; Raphael Eduardo,9999,0,9999,0
1715644648313,COGS 197,001,638244,Voytek; Bradley Thomas,9997,0,9999,2
1715644649339,CSE 191,A00,516875,Minnes Kemp; Mor Mia,9991,0,9999,8
1715644650364,CSE 197,001,637388,Minnes Kemp; Mor Mia,9992,0,9999,7
1715644651392,CSS 201S,A01,494383,Mignozzetti; Umberto,35,0,35,0
1715644652417,CSS 202S,A01,494387,Mignozzetti; Umberto,35,0,35,0
1715644653446,DSC 197,001,628532,Eldridge; Justin Matthew,9995,0,9999,4
1715644654474,EAP 100,A00,516065,Staff,9799,0,9999,200
1715644655508,ECE 45,A01,507414,Staff,32,0,60,28
1715644657564,ECE 111,A01,507420,Staff,11,0,50,39
1715644658589,ECE 197,001,548057,Sievenpiper; Daniel F.,9991,0,9999,8
1715644659620,EDS 115,A00,507243,Choi; Bailey Miyeon,6,0,28,22
1715644660646,EDS 117,A01,494379,Staff,0,6,34,35
1715644661673,EDS 125,A00,507246,Hopkins; Megan Beth,7,0,30,23
1715644662699,EDS 128A,A01,507264,Fargason; Sharon Gayle,5,0,26,21
1715644663728,EDS 128B,A01,507293,Pappas; Elizabeth,9,0,30,21
1715644664756,EDS 139,A00,507294,Fargason; Sharon Gayle,9,0,30,21
1715644664756,EDS 139,B00,507313,Pappas; Elizabeth,9,0,30,21
1715644665781,EDS 201,A00,507315,Staff,10,0,30,20
1715644666805,EDS 203,A01,507317,Halter; Christopher P.,10,0,30,20
1715644667830,EDS 204R,A01,507319,Halter; Christopher P.,0,3,30,30
1715644667830,EDS 204R,B01,507331,Heinzman; Erica M.,14,0,30,16
1715644668857,EDS 206R,A00,507332,Staff,0,4,30,30
1715644668857,EDS 206R,B00,507343,Staff,15,0,30,15
1715644669881,EDS 250,A00,507344,Hemans; Patricia Ann Benitez,20,0,40,20
1715644670909,EDS 281,A00,507345,Daly; Alan J.,18,0,18,0
1715644671935,EDS 284,A00,507350,Daly; Alan J.,16,0,16,0
1715644672965,EDS 286,A00,507359,Fine; Sarah,18,0,18,0
1715644673989,EDS 289C,A01,507361,Daly; Alan J.,18,0,18,0
1715644675015,EDS 290,A00,507366,Hofstetter; Carolyn,15,0,15,0
1715644676041,LIGM 5A,A00,507421,Fischer-Grunski; Eva K,17,0,20,3
1715644677068,LIGM 5B,A00,507423,Fischer-Grunski; Eva K,19,0,20,1
1715644678094,LIGM 5C,A00,507425,Fischer-Grunski; Eva K,19,0,20,1
1715644679121,LIIT 5AS,A00,507427,Carnelos; Chiara,20,0,20,0
1715644680151,LIIT 5BS,A00,507430,Carnelos; Chiara,20,0,20,0
1715644681177,LIIT 5CS,A00,507432,Carnelos; Chiara,20,0,20,0
1715644682207,LISP 5A,A00,507541,Munoz Sanchez; Alicia,11,0,20,9
1715644683240,LISP 5B,A00,507671,Munoz Sanchez; Alicia,8,0,20,12
1715644684270,LISP 5C,A00,507696,Munoz Sanchez; Alicia,8,0,20,12
1715644685299,MAE 197,001,528363,Boechler; Nicholas Sebastia,9998,0,9999,1
1715644686331,MATH 197,001,523477,Kedlaya; Kiran S.,9994,0,9999,5
1715644686331,MATH 197,002,563811,Zhang; Danna,9994,0,9999,5
1715644686331,MATH 197,003,628552,Dumitriu; Ioana,9998,0,9999,1
1715644686331,MATH 197,004,660885,Floyd; Eric,9998,0,9999,1
1715644687357,MCWP 40R,A00,518780,Staff,1,0,20,19
1715644687357,MCWP 40R,B00,518781,Carter; Jennifer A,10,0,20,10
1715644687357,MCWP 40R,C00,518783,Smith; Haydee Marie,5,0,20,15
1715644688392,MCWP 50R,A00,518791,Redela; Pamela Morgan,0,1,20,20
1715644688392,MCWP 50R,B00,518792,Krone; Jarret,0,2,20,20
1715644688392,MCWP 50R,C00,518793,Staff,0,4,20,20
1715644688392,MCWP 50R,D00,518794,Morshed; Michael James,0,1,20,20
1715644688392,MCWP 50R,E00,518795,Carter; Andrea L,0,2,20,20
1715644688392,MCWP 50R,F00,518796,Miller; Elizabeth Deen,0,1,20,20
1715644688392,MCWP 50R,G00,518797,Guillen; Melinda,0,1,20,20
1715644689424,MMW 12R,A01,514034,Herbst; Matthew,0,2,16,16
1715644689424,MMW 12R,A02,514035,Herbst; Matthew,0,0,16,16
1715644690448,MMW 13R,A01,514037,Staff,0,5,16,16
1715644690448,MMW 13R,A02,514039,Staff,0,5,16,16
1715644690448,MMW 13R,A03,628519,Staff,0,4,16,16
1715644692498,SIO 295LS,A00,523233,Staff,10,0,30,20
1715644693522,SIO 295S,A00,523232,Staff,10,0,30,20
1715644694557,SIOC 290S,A01,637330,Merrifield; Mark A,21,0,30,9
1715644695584,SIOC 291S,A01,637333,Gabriel; Corey John,21,0,30,9
1715644696613,SOCI 117,A01,494376,Staff,0,5,5,5
1715644697641,WES 237B,A00,494380,Staff,10,0,20,10
1715644699713,AESE 279B,A00,494370,Wade; Jon P,0,0,33,33
1715644700742,AIP 97,001,660915,Van Den Einde; Yael Dahlia,9998,0,9999,1
1715644701776,AIP 197,001,627712,Vespa; Emanuel Ignacio,9995,0,9999,4
1715644701776,AIP 197,002,650778,Amir; On,9998,0,9999,1
1715644701776,AIP 197,003,650933,Avenancio-Leon; Carlos,9998,0,9999,1
1715644701776,AIP 197,004,658530,Heyman; Gail D.,9998,0,9999,1
1715644701776,AIP 197,005,658631,Neal; Sonya E,9998,0,9999,1
1715644701776,AIP 197,006,658671,Du; Songzi,9998,0,9999,1
1715644702804,ANAR 135S,A00,494369,Braswell; Geoffrey E.,0,0,0,0
1715644703830,BENG 196,001,628496,Engler; Adam J.,9998,0,9999,1
1715644703830,BENG 196,002,660916,Watson; John Thomas,9998,0,9999,1
1715644704856,BISP 197,001,650773,Wilhelm; James E.,9994,0,9999,5
1715644704856,BISP 197,002,658904,Coleman; Aaron B.,9998,0,9999,1
1715644705881,CAT 124RS,A01,519847,Geibel; William,0,0,20,20
1715644706907,CAT 125RS,A01,515971,Geibel; William,0,0,20,20
1715644707932,CLRE 250,A00,511389,Morris; Sheldon,9992,0,9999,7
1715644708958,CLRE 251,A00,507176,Mehta; Ravindra L.,9992,0,9999,7
1715644708958,CLRE 251,B00,511410,Mehta; Ravindra L.,9998,0,9999,1
1715644709986,CLRE 252,A00,507189,Cuomo; Raphael Eduardo,9994,0,9999,5
1715644711014,CLRE 253,A00,507199,Vaida; Florin,9994,0,9999,5
1715644711014,CLRE 253,B00,507202,Vaida; Florin,9999,0,9999,0
1715644712044,CLRE 259,A00,507211,Patel; Hemal,9996,0,9999,3
1715644713069,CLRE 260,A00,507221,Cuomo; Raphael Eduardo,9999,0,9999,0
1715644714093,CLRE 297,001,507242,Cuomo; Raphael Eduardo,9999,0,9999,0
1715644715193,COGS 197,001,638244,Voytek; Bradley Thomas,9997,0,9999,2
1715644716218,CSE 191,A00,516875,Minnes Kemp; Mor Mia,9991,0,9999,8
1715644717246,CSE 197,001,637388,Minnes Kemp; Mor Mia,9992,0,9999,7
1715644718279,CSS 201S,A01,494383,Mignozzetti; Umberto,35,0,35,0
1715644719305,CSS 202S,A01,494387,Mignozzetti; Umberto,35,0,35,0
1715644720331,DSC 197,001,628532,Eldridge; Justin Matthew,9995,0,9999,4
1715644721357,EAP 100,A00,516065,Staff,9799,0,9999,200
1715644722389,ECE 45,A01,507414,Staff,32,0,60,28
1715644724444,ECE 111,A01,507420,Staff,11,0,50,39
1715644725471,ECE 197,001,548057,Sievenpiper; Daniel F.,9991,0,9999,8
1715644726501,EDS 115,A00,507243,Choi; Bailey Miyeon,6,0,28,22
1715644727535,EDS 117,A01,494379,Staff,0,6,34,35
1715644728569,EDS 125,A00,507246,Hopkins; Megan Beth,7,0,30,23
1715644729597,EDS 128A,A01,507264,Fargason; Sharon Gayle,5,0,26,21
1715644730626,EDS 128B,A01,507293,Pappas; Elizabeth,9,0,30,21
1715644731652,EDS 139,A00,507294,Fargason; Sharon Gayle,9,0,30,21
1715644731652,EDS 139,B00,507313,Pappas; Elizabeth,9,0,30,21
1715644732682,EDS 201,A00,507315,Staff,10,0,30,20
1715644733712,EDS 203,A01,507317,Halter; Christopher P.,10,0,30,20
1715644734742,EDS 204R,A01,507319,Halter; Christopher P.,0,3,30,30
1715644734742,EDS 204R,B01,507331,Heinzman; Erica M.,14,0,30,16
1715644735770,EDS 206R,A00,507332,Staff,0,4,30,30
1715644735770,EDS 206R,B00,507343,Staff,15,0,30,15
1715644736796,EDS 250,A00,507344,Hemans; Patricia Ann Benitez,20,0,40,20
1715644737827,EDS 281,A00,507345,Daly; Alan J.,18,0,18,0
1715644738856,EDS 284,A00,507350,Daly; Alan J.,16,0,16,0
1715644739882,EDS 286,A00,507359,Fine; Sarah,18,0,18,0
1715644740912,EDS 289C,A01,507361,Daly; Alan J.,18,0,18,0
1715644741939,EDS 290,A00,507366,Hofstetter; Carolyn,15,0,15,0
1715644742966,LIGM 5A,A00,507421,Fischer-Grunski; Eva K,17,0,20,3
1715644743995,LIGM 5B,A00,507423,Fischer-Grunski; Eva K,19,0,20,1
1715644745024,LIGM 5C,A00,507425,Fischer-Grunski; Eva K,19,0,20,1
1715644746055,LIIT 5AS,A00,507427,Carnelos; Chiara,20,0,20,0
1715644747082,LIIT 5BS,A00,507430,Carnelos; Chiara,20,0,20,0
1715644748115,LIIT 5CS,A00,507432,Carnelos; Chiara,20,0,20,0
1715644749141,LISP 5A,A00,507541,Munoz Sanchez; Alicia,11,0,20,9
1715644750167,LISP 5B,A00,507671,Munoz Sanchez; Alicia,8,0,20,12
1715644751196,LISP 5C,A00,507696,Munoz Sanchez; Alicia,8,0,20,12
1715644752222,MAE 197,001,528363,Boechler; Nicholas Sebastia,9998,0,9999,1
1715644753249,MATH 197,001,523477,Kedlaya; Kiran S.,9994,0,9999,5
1715644753249,MATH 197,002,563811,Zhang; Danna,9994,0,9999,5
1715644753249,MATH 197,003,628552,Dumitriu; Ioana,9998,0,9999,1
1715644753249,MATH 197,004,660885,Floyd; Eric,9998,0,9999,1
1715644754277,MCWP 40R,A00,518780,Staff,1,0,20,19
1715644754277,MCWP 40R,B00,518781,Carter; Jennifer A,10,0,20,10
1715644754277,MCWP 40R,C00,518783,Smith; Haydee Marie,5,0,20,15
1715644755308,MCWP 50R,A00,518791,Redela; Pamela Morgan,0,1,20,20
1715644755308,MCWP 50R,B00,518792,Krone; Jarret,0,2,20,20
1715644755308,MCWP 50R,C00,518793,Staff,0,4,20,20
1715644755308,MCWP 50R,D00,518794,Morshed; Michael James,0,1,20,20
1715644755308,MCWP 50R,E00,518795,Carter; Andrea L,0,2,20,20
1715644755308,MCWP 50R,F00,518796,Miller; Elizabeth Deen,0,1,20,20
1715644755308,MCWP 50R,G00,518797,Guillen; Melinda,0,1,20,20
1715644756333,MMW 12R,A01,514034,Herbst; Matthew,0,2,16,16
1715644756333,MMW 12R,A02,514035,Herbst; Matthew,0,0,16,16
1715644757360,MMW 13R,A01,514037,Staff,0,5,16,16
1715644757360,MMW 13R,A02,514039,Staff,0,5,16,16
1715644757360,MMW 13R,A03,628519,Staff,0,4,16,16
1715644759415,SIO 295LS,A00,523233,Staff,10,0,30,20
1715644760443,SIO 295S,A00,523232,Staff,10,0,30,20
1715644761571,SIOC 290S,A01,637330,Merrifield; Mark A,21,0,30,9
1715644762597,SIOC 291S,A01,637333,Gabriel; Corey John,21,0,30,9
1715644763622,SOCI 117,A01,494376,Staff,0,5,5,5
1715644764648,WES 237B,A00,494380,Staff,10,0,20,10
1715644766718,AESE 279B,A00,494370,Wade; Jon P,0,0,33,33
1715644767742,AIP 97,001,660915,Van Den Einde; Yael Dahlia,9998,0,9999,1
1715644768768,AIP 197,001,627712,Vespa; Emanuel Ignacio,9995,0,9999,4
1715644768768,AIP 197,002,650778,Amir; On,9998,0,9999,1
1715644768768,AIP 197,003,650933,Avenancio-Leon; Carlos,9998,0,9999,1
1715644768768,AIP 197,004,658530,Heyman; Gail D.,9998,0,9999,1
1715644768768,AIP 197,005,658631,Neal; Sonya E,9998,0,9999,1
1715644768768,AIP 197,006,658671,Du; Songzi,9998,0,9999,1
1715644769794,ANAR 135S,A00,494369,Braswell; Geoffrey E.,0,0,0,0
1715644770821,BENG 196,001,628496,Engler; Adam J.,9998,0,9999,1
1715644770821,BENG 196,002,660916,Watson; John Thomas,9998,0,9999,1
1715644771848,BISP 197,001,650773,Wilhelm; James E.,9994,0,9999,5
1715644771848,BISP 197,002,658904,Coleman; Aaron B.,9998,0,9999,1
1715644772874,CAT 124RS,A01,519847,Geibel; William,0,0,20,20
1715644773901,CAT 125RS,A01,515971,Geibel; William,0,0,20,20
1715644774929,CLRE 250,A00,511389,Morris; Sheldon,9992,0,9999,7
1715644775957,CLRE 251,A00,507176,Mehta; Ravindra L.,9992,0,9999,7
1715644775957,CLRE 251,B00,511410,Mehta; Ravindra L.,9998,0,9999,1
1715644776984,CLRE 252,A00,507189,Cuomo; Raphael Eduardo,9994,0,9999,5
1715644778015,CLRE 253,A00,507199,Vaida; Florin,9994,0,9999,5
1715644778015,CLRE 253,B00,507202,Vaida; Florin,9999,0,9999,0
1715644779043,CLRE 259,A00,507211,Patel; Hemal,9996,0,9999,3
1715644780068,CLRE 260,A00,507221,Cuomo; Raphael Eduardo,9999,0,9999,0
1715644781094,CLRE 297,001,507242,Cuomo; Raphael Eduardo,9999,0,9999,0
1715644782121,COGS 197,001,638244,Voytek; Bradley Thomas,9997,0,9999,2
1715644783152,CSE 191,A00,516875,Minnes Kemp; Mor Mia,9991,0,9999,8
1715644784180,CSE 197,001,637388,Minnes Kemp; Mor Mia,9992,0,9999,7
1715644785210,CSS 201S,A01,494383,Mignozzetti; Umberto,35,0,35,0
1715644786237,CSS 202S,A01,494387,Mignozzetti; Umberto,35,0,35,0
1715644787265,DSC 197,001,628532,Eldridge; Justin Matthew,9995,0,9999,4
1715644788292,EAP 100,A00,516065,Staff,9799,0,9999,200
1715644789317,ECE 45,A01,507414,Staff,32,0,60,28
1715644791371,ECE 111,A01,507420,Staff,11,0,50,39
1715644792397,ECE 197,001,548057,Sievenpiper; Daniel F.,9991,0,9999,8
1715644793427,EDS 115,A00,507243,Choi; Bailey Miyeon,6,0,28,22
1715644794453,EDS 117,A01,494379,Staff,0,6,34,35
1715644795480,EDS 125,A00,507246,Hopkins; Megan Beth,7,0,30,23
1715644796512,EDS 128A,A01,507264,Fargason; Sharon Gayle,5,0,26,21
1715644797539,EDS 128B,A01,507293,Pappas; Elizabeth,9,0,30,21
1715644798568,EDS 139,A00,507294,Fargason; Sharon Gayle,9,0,30,21
1715644798568,EDS 139,B00,507313,Pappas; Elizabeth,9,0,30,21
1715644799597,EDS 201,A00,507315,Staff,10,0,30,20
1715644800623,EDS 203,A01,507317,Halter; Christopher P.,10,0,30,20
1715644801648,EDS 204R,A01,507319,Halter; Christopher P.,0,3,30,30
1715644801648,EDS 204R,B01,507331,Heinzman; Erica M.,14,0,30,16
1715644802676,EDS 206R,A00,507332,Staff,0,4,30,30
1715644802676,EDS 206R,B00,507343,Staff,15,0,30,15
1715644803706,EDS 250,A00,507344,Hemans; Patricia Ann Benitez,20,0,40,20
1715644804738,EDS 281,A00,507345,Daly; Alan J.,18,0,18,0
1715644805763,EDS 284,A00,507350,Daly; Alan J.,16,0,16,0
1715644806788,EDS 286,A00,507359,Fine; Sarah,18,0,18,0
1715644807815,EDS 289C,A01,507361,Daly; Alan J.,18,0,18,0
1715644808842,EDS 290,A00,507366,Hofstetter; Carolyn,15,0,15,0
1715644809872,LIGM 5A,A00,507421,Fischer-Grunski; Eva K,17,0,20,3
1715644810901,LIGM 5B,A00,507423,Fischer-Grunski; Eva K,19,0,20,1
1715644811929,LIGM 5C,A00,507425,Fischer-Grunski; Eva K,19,0,20,1
1715644812960,LIIT 5AS,A00,507427,Carnelos; Chiara,20,0,20,0
1715644813986,LIIT 5BS,A00,507430,Carnelos; Chiara,20,0,20,0
1715644815015,LIIT 5CS,A00,507432,Carnelos; Chiara,20,0,20,0
1715644816072,LISP 5A,A00,507541,Munoz Sanchez; Alicia,11,0,20,9
1715644817097,LISP 5B,A00,507671,Munoz Sanchez; Alicia,8,0,20,12
1715644818128,LISP 5C,A00,507696,Munoz Sanchez; Alicia,8,0,20,12
1715644819210,MAE 197,001,528363,Boechler; Nicholas Sebastia,9998,0,9999,1
1715644820238,MATH 197,001,523477,Kedlaya; Kiran S.,9994,0,9999,5
1715644820238,MATH 197,002,563811,Zhang; Danna,9994,0,9999,5
1715644820238,MATH 197,003,628552,Dumitriu; Ioana,9998,0,9999,1
1715644820238,MATH 197,004,660885,Floyd; Eric,9998,0,9999,1
1715644821265,MCWP 40R,A00,518780,Staff,1,0,20,19
1715644821265,MCWP 40R,B00,518781,Carter; Jennifer A,10,0,20,10
1715644821265,MCWP 40R,C00,518783,Smith; Haydee Marie,5,0,20,15
1715644822297,MCWP 50R,A00,518791,Redela; Pamela Morgan,0,1,20,20
1715644822297,MCWP 50R,B00,518792,Krone; Jarret,0,2,20,20
1715644822297,MCWP 50R,C00,518793,Staff,0,4,20,20
1715644822297,MCWP 50R,D00,518794,Morshed; Michael James,0,1,20,20
1715644822297,MCWP 50R,E00,518795,Carter; Andrea L,0,2,20,20
1715644822297,MCWP 50R,F00,518796,Miller; Elizabeth Deen,0,1,20,20
1715644822297,MCWP 50R,G00,518797,Guillen; Melinda,0,1,20,20
1715644823322,MMW 12R,A01,514034,Herbst; Matthew,0,2,16,16
1715644823322,MMW 12R,A02,514035,Herbst; Matthew,0,0,16,16
1715644824350,MMW 13R,A01,514037,Staff,0,5,16,16
1715644824350,MMW 13R,A02,514039,Staff,0,5,16,16
1715644824350,MMW 13R,A03,628519,Staff,0,4,16,16
1715644826401,SIO 295LS,A00,523233,Staff,10,0,30,20
1715644827428,SIO 295S,A00,523232,Staff,10,0,30,20
1715644828459,SIOC 290S,A01,637330,Merrifield; Mark A,21,0,30,9
1715644829486,SIOC 291S,A01,637333,Gabriel; Corey John,21,0,30,9
1715644830511,SOCI 117,A01,494376,Staff,0,5,5,5
1715644831536,WES 237B,A00,494380,Staff,10,0,20,10
1715644833605,AESE 279B,A00,494370,Wade; Jon P,0,0,33,33
1715644834630,AIP 97,001,660915,Van Den Einde; Yael Dahlia,9998,0,9999,1
1715644835663,AIP 197,001,627712,Vespa; Emanuel Ignacio,9995,0,9999,4
1715644835663,AIP 197,002,650778,Amir; On,9998,0,9999,1
1715644835663,AIP 197,003,650933,Avenancio-Leon; Carlos,9998,0,9999,1
1715644835663,AIP 197,004,658530,Heyman; Gail D.,9998,0,9999,1
1715644835663,AIP 197,005,658631,Neal; Sonya E,9998,0,9999,1
1715644835663,AIP 197,006,658671,Du; Songzi,9998,0,9999,1
1715644836693,ANAR 135S,A00,494369,Braswell; Geoffrey E.,0,0,0,0
1715644837722,BENG 196,001,628496,Engler; Adam J.,9998,0,9999,1
1715644837722,BENG 196,002,660916,Watson; John Thomas,9998,0,9999,1
1715644838749,BISP 197,001,650773,Wilhelm; James E.,9994,0,9999,5
1715644838749,BISP 197,002,658904,Coleman; Aaron B.,9998,0,9999,1
1715644839776,CAT 124RS,A01,519847,Geibel; William,0,0,20,20
1715644840800,CAT 125RS,A01,515971,Geibel; William,0,0,20,20
1715644841829,CLRE 250,A00,511389,Morris; Sheldon,9992,0,9999,7
1715644842857,CLRE 251,A00,507176,Mehta; Ravindra L.,9992,0,9999,7
1715644842857,CLRE 251,B00,511410,Mehta; Ravindra L.,9998,0,9999,1
1715644843883,CLRE 252,A00,507189,Cuomo; Raphael Eduardo,9994,0,9999,5
1715644844912,CLRE 253,A00,507199,Vaida; Florin,9994,0,9999,5
1715644844912,CLRE 253,B00,507202,Vaida; Florin,9999,0,9999,0
1715644845938,CLRE 259,A00,507211,Patel; Hemal,9996,0,9999,3
1715644846966,CLRE 260,A00,507221,Cuomo; Raphael Eduardo,9999,0,9999,0
1715644847994,CLRE 297,001,507242,Cuomo; Raphael Eduardo,9999,0,9999,0
1715644849023,COGS 197,001,638244,Voytek; Bradley Thomas,9997,0,9999,2
1715644850048,CSE 191,A00,516875,Minnes Kemp; Mor Mia,9991,0,9999,8
1715644851073,CSE 197,001,637388,Minnes Kemp; Mor Mia,9992,0,9999,7
1715644852100,CSS 201S,A01,494383,Mignozzetti; Umberto,35,0,35,0
1715644853129,CSS 202S,A01,494387,Mignozzetti; Umberto,35,0,35,0
1715644854155,DSC 197,001,628532,Eldridge; Justin Matthew,9995,0,9999,4
1715644855181,EAP 100,A00,516065,Staff,9799,0,9999,200
1715644856208,ECE 45,A01,507414,Staff,32,0,60,28
1715644858260,ECE 111,A01,507420,Staff,11,0,50,39
1715644859287,ECE 197,001,548057,Sievenpiper; Daniel F.,9991,0,9999,8
1715644860317,EDS 115,A00,507243,Choi; Bailey Miyeon,6,0,28,22
1715644861347,EDS 117,A01,494379,Staff,0,6,34,35
1715644862374,EDS 125,A00,507246,Hopkins; Megan Beth,7,0,30,23
1715644863400,EDS 128A,A01,507264,Fargason; Sharon Gayle,5,0,26,21
1715644864429,EDS 128B,A01,507293,Pappas; Elizabeth,9,0,30,21
1715644865514,EDS 139,A00,507294,Fargason; Sharon Gayle,9,0,30,21
1715644865514,EDS 139,B00,507313,Pappas; Elizabeth,9,0,30,21
1715644866541,EDS 201,A00,507315,Staff,10,0,30,20
1715644867568,EDS 203,A01,507317,Halter; Christopher P.,10,0,30,20
1715644868602,EDS 204R,A01,507319,Halter; Christopher P.,0,3,30,30
1715644868602,EDS 204R,B01,507331,Heinzman; Erica M.,14,0,30,16
1715644869628,EDS 206R,A00,507332,Staff,0,4,30,30
1715644869628,EDS 206R,B00,507343,Staff,15,0,30,15
1715644870657,EDS 250,A00,507344,Hemans; Patricia Ann Benitez,20,0,40,20
1715644871687,EDS 281,A00,507345,Daly; Alan J.,18,0,18,0
1715644872712,EDS 284,A00,507350,Daly; Alan J.,16,0,16,0
1715644873738,EDS 286,A00,507359,Fine; Sarah,18,0,18,0
1715644874767,EDS 289C,A01,507361,Daly; Alan J.,18,0,18,0
1715644875793,EDS 290,A00,507366,Hofstetter; Carolyn,15,0,15,0
1715644876823,LIGM 5A,A00,507421,Fischer-Grunski; Eva K,17,0,20,3
1715644877848,LIGM 5B,A00,507423,Fischer-Grunski; Eva K,19,0,20,1
1715644878874,LIGM 5C,A00,507425,Fischer-Grunski; Eva K,19,0,20,1
1715644879904,LIIT 5AS,A00,507427,Carnelos; Chiara,20,0,20,0
1715644880930,LIIT 5BS,A00,507430,Carnelos; Chiara,20,0,20,0
1715644881961,LIIT 5CS,A00,507432,Carnelos; Chiara,20,0,20,0
1715644882987,LISP 5A,A00,507541,Munoz Sanchez; Alicia,11,0,20,9
1715644884017,LISP 5B,A00,507671,Munoz Sanchez; Alicia,8,0,20,12
1715644885046,LISP 5C,A00,507696,Munoz Sanchez; Alicia,8,0,20,12
1715644886079,MAE 197,001,528363,Boechler; Nicholas Sebastia,9998,0,9999,1
1715644887114,MATH 197,001,523477,Kedlaya; Kiran S.,9994,0,9999,5
1715644887114,MATH 197,002,563811,Zhang; Danna,9994,0,9999,5
1715644887114,MATH 197,003,628552,Dumitriu; Ioana,9998,0,9999,1
1715644887114,MATH 197,004,660885,Floyd; Eric,9998,0,9999,1
1715644888142,MCWP 40R,A00,518780,Staff,1,0,20,19
1715644888142,MCWP 40R,B00,518781,Carter; Jennifer A,10,0,20,10
1715644888142,MCWP 40R,C00,518783,Smith; Haydee Marie,5,0,20,15
1715644889226,MCWP 50R,A00,518791,Redela; Pamela Morgan,0,1,20,20
1715644889226,MCWP 50R,B00,518792,Krone; Jarret,0,2,20,20
1715644889226,MCWP 50R,C00,518793,Staff,0,4,20,20
1715644889226,MCWP 50R,D00,518794,Morshed; Michael James,0,1,20,20
1715644889226,MCWP 50R,E00,518795,Carter; Andrea L,0,2,20,20
1715644889226,MCWP 50R,F00,518796,Miller; Elizabeth Deen,0,1,20,20
1715644889226,MCWP 50R,G00,518797,Guillen; Melinda,0,1,20,20
1715644890256,MMW 12R,A01,514034,Herbst; Matthew,0,2,16,16
1715644890256,MMW 12R,A02,514035,Herbst; Matthew,0,0,16,16
1715644891286,MMW 13R,A01,514037,Staff,0,5,16,16
1715644891286,MMW 13R,A02,514039,Staff,0,5,16,16
1715644891286,MMW 13R,A03,628519,Staff,0,4,16,16
1715644893339,SIO 295LS,A00,523233,Staff,10,0,30,20
1715644894366,SIO 295S,A00,523232,Staff,10,0,30,20
1715644895396,SIOC 290S,A01,637330,Merrifield; Mark A,21,0,30,9
1715644896423,SIOC 291S,A01,637333,Gabriel; Corey John,21,0,30,9
1715644897448,SOCI 117,A01,494376,Staff,0,5,5,5
1715644898479,WES 237B,A00,494380,Staff,10,0,20,10
1715644900552,AESE 279B,A00,494370,Wade; Jon P,0,0,33,33
1715644901577,AIP 97,001,660915,Van Den Einde; Yael Dahlia,9998,0,9999,1
1715644902612,AIP 197,001,627712,Vespa; Emanuel Ignacio,9995,0,9999,4
1715644902612,AIP 197,002,650778,Amir; On,9998,0,9999,1
1715644902612,AIP 197,003,650933,Avenancio-Leon; Carlos,9998,0,9999,1
1715644902612,AIP 197,004,658530,Heyman; Gail D.,9998,0,9999,1
1715644902612,AIP 197,005,658631,Neal; Sonya E,9998,0,9999,1
1715644902612,AIP 197,006,658671,Du; Songzi,9998,0,9999,1
1715644903639,ANAR 135S,A00,494369,Braswell; Geoffrey E.,0,0,0,0
1715644904664,BENG 196,001,628496,Engler; Adam J.,9998,0,9999,1
1715644904664,BENG 196,002,660916,Watson; John Thomas,9998,0,9999,1
1715644905693,BISP 197,001,650773,Wilhelm; James E.,9994,0,9999,5
1715644905693,BISP 197,002,658904,Coleman; Aaron B.,9998,0,9999,1
1715644906716,CAT 124RS,A01,519847,Geibel; William,0,0,20,20
1715644907745,CAT 125RS,A01,515971,Geibel; William,0,0,20,20
1715644908771,CLRE 250,A00,511389,Morris; Sheldon,9992,0,9999,7
1715644909801,CLRE 251,A00,507176,Mehta; Ravindra L.,9992,0,9999,7
1715644909801,CLRE 251,B00,511410,Mehta; Ravindra L.,9998,0,9999,1
1715644910827,CLRE 252,A00,507189,Cuomo; Raphael Eduardo,9994,0,9999,5
1715644911855,CLRE 253,A00,507199,Vaida; Florin,9994,0,9999,5
1715644911855,CLRE 253,B00,507202,Vaida; Florin,9999,0,9999,0
1715644912881,CLRE 259,A00,507211,Patel; Hemal,9996,0,9999,3
1715644913905,CLRE 260,A00,507221,Cuomo; Raphael Eduardo,9999,0,9999,0
1715644914930,CLRE 297,001,507242,Cuomo; Raphael Eduardo,9999,0,9999,0
1715644915956,COGS 197,001,638244,Voytek; Bradley Thomas,9997,0,9999,2
1715644916982,CSE 191,A00,516875,Minnes Kemp; Mor Mia,9991,0,9999,8
1715644918010,CSE 197,001,637388,Minnes Kemp; Mor Mia,9992,0,9999,7
1715644919039,CSS 201S,A01,494383,Mignozzetti; Umberto,35,0,35,0
1715644920063,CSS 202S,A01,494387,Mignozzetti; Umberto,35,0,35,0
1715644921105,DSC 197,001,628532,Eldridge; Justin Matthew,9995,0,9999,4
1715644922131,EAP 100,A00,516065,Staff,9799,0,9999,200
1715644923171,ECE 45,A01,507414,Staff,32,0,60,28
1715644925220,ECE 111,A01,507420,Staff,11,0,50,39
1715644926246,ECE 197,001,548057,Sievenpiper; Daniel F.,9991,0,9999,8
1715644927276,EDS 115,A00,507243,Choi; Bailey Miyeon,6,0,28,22
1715644928301,EDS 117,A01,494379,Staff,0,6,34,35
1715644929328,EDS 125,A00,507246,Hopkins; Megan Beth,7,0,30,23
1715644930472,EDS 128A,A01,507264,Fargason; Sharon Gayle,5,0,26,21
1715644931503,EDS 128B,A01,507293,Pappas; Elizabeth,9,0,30,21
1715644932529,EDS 139,A00,507294,Fargason; Sharon Gayle,9,0,30,21
1715644932529,EDS 139,B00,507313,Pappas; Elizabeth,9,0,30,21
1715644933555,EDS 201,A00,507315,Staff,10,0,30,20
1715644934582,EDS 203,A01,507317,Halter; Christopher P.,10,0,30,20
1715644935608,EDS 204R,A01,507319,Halter; Christopher P.,0,3,30,30
1715644935608,EDS 204R,B01,507331,Heinzman; Erica M.,14,0,30,16
1715644936633,EDS 206R,A00,507332,Staff,0,4,30,30
1715644936633,EDS 206R,B00,507343,Staff,15,0,30,15
1715644937658,EDS 250,A00,507344,Hemans; Patricia Ann Benitez,20,0,40,20
1715644938685,EDS 281,A00,507345,Daly; Alan J.,18,0,18,0
1715644939714,EDS 284,A00,507350,Daly; Alan J.,16,0,16,0
1715644940740,EDS 286,A00,507359,Fine; Sarah,18,0,18,0
1715644941768,EDS 289C,A01,507361,Daly; Alan J.,18,0,18,0
1715644942798,EDS 290,A00,507366,Hofstetter; Carolyn,15,0,15,0
1715644943829,LIGM 5A,A00,507421,Fischer-Grunski; Eva K,17,0,20,3
1715644944854,LIGM 5B,A00,507423,Fischer-Grunski; Eva K,19,0,20,1
1715644945882,LIGM 5C,A00,507425,Fischer-Grunski; Eva K,19,0,20,1
1715644946913,LIIT 5AS,A00,507427,Carnelos; Chiara,20,0,20,0
1715644947939,LIIT 5BS,A00,507430,Carnelos; Chiara,20,0,20,0
1715644948968,LIIT 5CS,A00,507432,Carnelos; Chiara,20,0,20,0
1715644949994,LISP 5A,A00,507541,Munoz Sanchez; Alicia,11,0,20,9
1715644951024,LISP 5B,A00,507671,Munoz Sanchez; Alicia,8,0,20,12
1715644952055,LISP 5C,A00,507696,Munoz Sanchez; Alicia,8,0,20,12
1715644953083,MAE 197,001,528363,Boechler; Nicholas Sebastia,9998,0,9999,1
1715644954112,MATH 197,001,523477,Kedlaya; Kiran S.,9994,0,9999,5
1715644954112,MATH 197,002,563811,Zhang; Danna,9994,0,9999,5
1715644954112,MATH 197,003,628552,Dumitriu; Ioana,9998,0,9999,1
1715644954112,MATH 197,004,660885,Floyd; Eric,9998,0,9999,1
1715644955139,MCWP 40R,A00,518780,Staff,1,0,20,19
1715644955139,MCWP 40R,B00,518781,Carter; Jennifer A,10,0,20,10
1715644955139,MCWP 40R,C00,518783,Smith; Haydee Marie,5,0,20,15
1715644956168,MCWP 50R,A00,518791,Redela; Pamela Morgan,0,1,20,20
1715644956168,MCWP 50R,B00,518792,Krone; Jarret,0,2,20,20
1715644956168,MCWP 50R,C00,518793,Staff,0,4,20,20
1715644956168,MCWP 50R,D00,518794,Morshed; Michael James,0,1,20,20
1715644956168,MCWP 50R,E00,518795,Carter; Andrea L,0,2,20,20
1715644956168,MCWP 50R,F00,518796,Miller; Elizabeth Deen,0,1,20,20
1715644956168,MCWP 50R,G00,518797,Guillen; Melinda,0,1,20,20
1715644957193,MMW 12R,A01,514034,Herbst; Matthew,0,2,16,16
1715644957193,MMW 12R,A02,514035,Herbst; Matthew,0,0,16,16
1715644958218,MMW 13R,A01,514037,Staff,0,5,16,16
1715644958218,MMW 13R,A02,514039,Staff,0,5,16,16
1715644958218,MMW 13R,A03,628519,Staff,0,4,16,16
1715644960272,SIO 295LS,A00,523233,Staff,10,0,30,20
1715644961301,SIO 295S,A00,523232,Staff,10,0,30,20
1715644962333,SIOC 290S,A01,637330,Merrifield; Mark A,21,0,30,9
1715644963363,SIOC 291S,A01,637333,Gabriel; Corey John,21,0,30,9
1715644964392,SOCI 117,A01,494376,Staff,0,5,5,5
1715644965418,WES 237B,A00,494380,Staff,10,0,20,10
1715644967496,AESE 279B,A00,494370,Wade; Jon P,0,0,33,33
1715644968524,AIP 97,001,660915,Van Den Einde; Yael Dahlia,9998,0,9999,1
1715644969564,AIP 197,001,627712,Vespa; Emanuel Ignacio,9995,0,9999,4
1715644969564,AIP 197,002,650778,Amir; On,9998,0,9999,1
1715644969564,AIP 197,003,650933,Avenancio-Leon; Carlos,9998,0,9999,1
1715644969564,AIP 197,004,658530,Heyman; Gail D.,9998,0,9999,1
1715644969564,AIP 197,005,658631,Neal; Sonya E,9998,0,9999,1
1715644969564,AIP 197,006,658671,Du; Songzi,9998,0,9999,1
1715644970595,ANAR 135S,A00,494369,Braswell; Geoffrey E.,0,0,0,0
1715644971620,BENG 196,001,628496,Engler; Adam J.,9998,0,9999,1
1715644971620,BENG 196,002,660916,Watson; John Thomas,9998,0,9999,1
1715644972647,BISP 197,001,650773,Wilhelm; James E.,9994,0,9999,5
1715644972647,BISP 197,002,658904,Coleman; Aaron B.,9998,0,9999,1
1715644973673,CAT 124RS,A01,519847,Geibel; William,0,0,20,20
1715644974699,CAT 125RS,A01,515971,Geibel; William,0,0,20,20
1715644975723,CLRE 250,A00,511389,Morris; Sheldon,9992,0,9999,7
1715644976751,CLRE 251,A00,507176,Mehta; Ravindra L.,9992,0,9999,7
1715644976751,CLRE 251,B00,511410,Mehta; Ravindra L.,9998,0,9999,1
1715644977778,CLRE 252,A00,507189,Cuomo; Raphael Eduardo,9994,0,9999,5
1715644978804,CLRE 253,A00,507199,Vaida; Florin,9994,0,9999,5
1715644978804,CLRE 253,B00,507202,Vaida; Florin,9999,0,9999,0
1715644979831,CLRE 259,A00,507211,Patel; Hemal,9996,0,9999,3
1715644980855,CLRE 260,A00,507221,Cuomo; Raphael Eduardo,9999,0,9999,0
1715644981881,CLRE 297,001,507242,Cuomo; Raphael Eduardo,9999,0,9999,0
1715644982908,COGS 197,001,638244,Voytek; Bradley Thomas,9997,0,9999,2
1715644983937,CSE 191,A00,516875,Minnes Kemp; Mor Mia,9991,0,9999,8
1715644984960,CSE 197,001,637388,Minnes Kemp; Mor Mia,9992,0,9999,7
1715644985992,CSS 201S,A01,494383,Mignozzetti; Umberto,35,0,35,0
1715644987016,CSS 202S,A01,494387,Mignozzetti; Umberto,35,0,35,0
1715644988040,DSC 197,001,628532,Eldridge; Justin Matthew,9995,0,9999,4
1715644989066,EAP 100,A00,516065,Staff,9799,0,9999,200
1715644990093,ECE 45,A01,507414,Staff,32,0,60,28
1715644992145,ECE 111,A01,507420,Staff,11,0,50,39
1715644993168,ECE 197,001,548057,Sievenpiper; Daniel F.,9991,0,9999,8
1715644994193,EDS 115,A00,507243,Choi; Bailey Miyeon,6,0,28,22
1715644995219,EDS 117,A01,494379,Staff,0,6,34,35
1715644996248,EDS 125,A00,507246,Hopkins; Megan Beth,7,0,30,23
1715644997273,EDS 128A,A01,507264,Fargason; Sharon Gayle,5,0,26,21
1715644998299,EDS 128B,A01,507293,Pappas; Elizabeth,9,0,30,21
1715644999323,EDS 139,A00,507294,Fargason; Sharon Gayle,9,0,30,21
1715644999323,EDS 139,B00,507313,Pappas; Elizabeth,9,0,30,21
1715645000348,EDS 201,A00,507315,Staff,10,0,30,20
1715645001373,EDS 203,A01,507317,Halter; Christopher P.,10,0,30,20
1715645002399,EDS 204R,A01,507319,Halter; Christopher P.,0,3,30,30
1715645002399,EDS 204R,B01,507331,Heinzman; Erica M.,14,0,30,16
1715645003425,EDS 206R,A00,507332,Staff,0,4,30,30
1715645003425,EDS 206R,B00,507343,Staff,15,0,30,15
1715645004452,EDS 250,A00,507344,Hemans; Patricia Ann Benitez,20,0,40,20
1715645005481,EDS 281,A00,507345,Daly; Alan J.,18,0,18,0
1715645006507,EDS 284,A00,507350,Daly; Alan J.,16,0,16,0
1715645007533,EDS 286,A00,507359,Fine; Sarah,18,0,18,0
1715645008560,EDS 289C,A01,507361,Daly; Alan J.,18,0,18,0
1715645009587,EDS 290,A00,507366,Hofstetter; Carolyn,15,0,15,0
1715645010613,LIGM 5A,A00,507421,Fischer-Grunski; Eva K,17,0,20,3
1715645011641,LIGM 5B,A00,507423,Fischer-Grunski; Eva K,19,0,20,1
1715645012667,LIGM 5C,A00,507425,Fischer-Grunski; Eva K,19,0,20,1
1715645013693,LIIT 5AS,A00,507427,Carnelos; Chiara,20,0,20,0
1715645014766,LIIT 5BS,A00,507430,Carnelos; Chiara,20,0,20,0
1715645015795,LIIT 5CS,A00,507432,Carnelos; Chiara,20,0,20,0
1715645016821,LISP 5A,A00,507541,Munoz Sanchez; Alicia,11,0,20,9
1715645017847,LISP 5B,A00,507671,Munoz Sanchez; Alicia,8,0,20,12
1715645018875,LISP 5C,A00,507696,Munoz Sanchez; Alicia,8,0,20,12
1715645019900,MAE 197,001,528363,Boechler; Nicholas Sebastia,9998,0,9999,1
1715645020932,MATH 197,001,523477,Kedlaya; Kiran S.,9994,0,9999,5
1715645020932,MATH 197,002,563811,Zhang; Danna,9994,0,9999,5
1715645020932,MATH 197,003,628552,Dumitriu; Ioana,9998,0,9999,1
1715645020932,MATH 197,004,660885,Floyd; Eric,9998,0,9999,1
1715645021960,MCWP 40R,A00,518780,Staff,1,0,20,19
1715645021960,MCWP 40R,B00,518781,Carter; Jennifer A,10,0,20,10
1715645021960,MCWP 40R,C00,518783,Smith; Haydee Marie,5,0,20,15
1715645022993,MCWP 50R,A00,518791,Redela; Pamela Morgan,0,1,20,20
1715645022993,MCWP 50R,B00,518792,Krone; Jarret,0,2,20,20
1715645022993,MCWP 50R,C00,518793,Staff,0,4,20,20
1715645022993,MCWP 50R,D00,518794,Morshed; Michael James,0,1,20,20
1715645022993,MCWP 50R,E00,518795,Carter; Andrea L,0,2,20,20
1715645022993,MCWP 50R,F00,518796,Miller; Elizabeth Deen,0,1,20,20
1715645022993,MCWP 50R,G00,518797,Guillen; Melinda,0,1,20,20
1715645024021,MMW 12R,A01,514034,Herbst; Matthew,0,2,16,16
1715645024021,MMW 12R,A02,514035,Herbst; Matthew,0,0,16,16
1715645025050,MMW 13R,A01,514037,Staff,0,5,16,16
1715645025050,MMW 13R,A02,514039,Staff,0,5,16,16
1715645025050,MMW 13R,A03,628519,Staff,0,4,16,16
1715645027100,SIO 295LS,A00,523233,Staff,10,0,30,20
1715645028128,SIO 295S,A00,523232,Staff,10,0,30,20
1715645029159,SIOC 290S,A01,637330,Merrifield; Mark A,21,0,30,9
1715645030184,SIOC 291S,A01,637333,Gabriel; Corey John,21,0,30,9
1715645031208,SOCI 117,A01,494376,Staff,0,5,5,5
1715645032234,WES 237B,A00,494380,Staff,10,0,20,10
1715645034308,AESE 279B,A00,494370,Wade; Jon P,0,0,33,33
1715645035333,AIP 97,001,660915,Van Den Einde; Yael Dahlia,9998,0,9999,1
1715645036361,AIP 197,001,627712,Vespa; Emanuel Ignacio,9995,0,9999,4
1715645036361,AIP 197,002,650778,Amir; On,9998,0,9999,1
1715645036361,AIP 197,003,650933,Avenancio-Leon; Carlos,9998,0,9999,1
1715645036361,AIP 197,004,658530,Heyman; Gail D.,9998,0,9999,1
1715645036361,AIP 197,005,658631,Neal; Sonya E,9998,0,9999,1
1715645036361,AIP 197,006,658671,Du; Songzi,9998,0,9999,1
1715645037387,ANAR 135S,A00,494369,Braswell; Geoffrey E.,0,0,0,0
1715645038416,BENG 196,001,628496,Engler; Adam J.,9998,0,9999,1
1715645038416,BENG 196,002,660916,Watson; John Thomas,9998,0,9999,1
1715645039446,BISP 197,001,650773,Wilhelm; James E.,9994,0,9999,5
1715645039446,BISP 197,002,658904,Coleman; Aaron B.,9998,0,9999,1
1715645040475,CAT 124RS,A01,519847,Geibel; William,0,0,20,20
1715645041499,CAT 125RS,A01,515971,Geibel; William,0,0,20,20
1715645042526,CLRE 250,A00,511389,Morris; Sheldon,9992,0,9999,7
1715645043554,CLRE 251,A00,507176,Mehta; Ravindra L.,9992,0,9999,7
1715645043554,CLRE 251,B00,511410,Mehta; Ravindra L.,9998,0,9999,1
1715645044580,CLRE 252,A00,507189,Cuomo; Raphael Eduardo,9994,0,9999,5
1715645045607,CLRE 253,A00,507199,Vaida; Florin,9994,0,9999,5
1715645045607,CLRE 253,B00,507202,Vaida; Florin,9999,0,9999,0
1715645046633,CLRE 259,A00,507211,Patel; Hemal,9996,0,9999,3
1715645047658,CLRE 260,A00,507221,Cuomo; Raphael Eduardo,9999,0,9999,0
1715645048681,CLRE 297,001,507242,Cuomo; Raphael Eduardo,9999,0,9999,0
1715645049704,COGS 197,001,638244,Voytek; Bradley Thomas,9997,0,9999,2
1715645050734,CSE 191,A00,516875,Minnes Kemp; Mor Mia,9991,0,9999,8
1715645051758,CSE 197,001,637388,Minnes Kemp; Mor Mia,9992,0,9999,7
1715645052789,CSS 201S,A01,494383,Mignozzetti; Umberto,35,0,35,0
1715645053817,CSS 202S,A01,494387,Mignozzetti; Umberto,35,0,35,0
1715645054846,DSC 197,001,628532,Eldridge; Justin Matthew,9995,0,9999,4
1715645055879,EAP 100,A00,516065,Staff,9799,0,9999,200
1715645056908,ECE 45,A01,507414,Staff,32,0,60,28
1715645058961,ECE 111,A01,507420,Staff,11,0,50,39
1715645059985,ECE 197,001,548057,Sievenpiper; Daniel F.,9991,0,9999,8
1715645061015,EDS 115,A00,507243,Choi; Bailey Miyeon,6,0,28,22
1715645062042,EDS 117,A01,494379,Staff,0,6,34,35
1715645063069,EDS 125,A00,507246,Hopkins; Megan Beth,7,0,30,23
1715645064096,EDS 128A,A01,507264,Fargason; Sharon Gayle,5,0,26,21
1715645065123,EDS 128B,A01,507293,Pappas; Elizabeth,9,0,30,21
1715645066148,EDS 139,A00,507294,Fargason; Sharon Gayle,9,0,30,21
1715645066148,EDS 139,B00,507313,Pappas; Elizabeth,9,0,30,21
1715645067177,EDS 201,A00,507315,Staff,10,0,30,20
1715645068202,EDS 203,A01,507317,Halter; Christopher P.,10,0,30,20
1715645069233,EDS 204R,A01,507319,Halter; Christopher P.,0,3,30,30
1715645069233,EDS 204R,B01,507331,Heinzman; Erica M.,14,0,30,16
1715645070261,EDS 206R,A00,507332,Staff,0,4,30,30
1715645070261,EDS 206R,B00,507343,Staff,15,0,30,15
1715645071287,EDS 250,A00,507344,Hemans; Patricia Ann Benitez,20,0,40,20
1715645072313,EDS 281,A00,507345,Daly; Alan J.,18,0,18,0
1715645073337,EDS 284,A00,507350,Daly; Alan J.,16,0,16,0
1715645074364,EDS 286,A00,507359,Fine; Sarah,18,0,18,0
1715645075389,EDS 289C,A01,507361,Daly; Alan J.,18,0,18,0
1715645076412,EDS 290,A00,507366,Hofstetter; Carolyn,15,0,15,0
1715645077438,LIGM 5A,A00,507421,Fischer-Grunski; Eva K,17,0,20,3
1715645078464,LIGM 5B,A00,507423,Fischer-Grunski; Eva K,19,0,20,1
1715645079488,LIGM 5C,A00,507425,Fischer-Grunski; Eva K,19,0,20,1
1715645080514,LIIT 5AS,A00,507427,Carnelos; Chiara,20,0,20,0
1715645081540,LIIT 5BS,A00,507430,Carnelos; Chiara,20,0,20,0
1715645082565,LIIT 5CS,A00,507432,Carnelos; Chiara,20,0,20,0
1715645083594,LISP 5A,A00,507541,Munoz Sanchez; Alicia,11,0,20,9
1715645084617,LISP 5B,A00,507671,Munoz Sanchez; Alicia,8,0,20,12
1715645085646,LISP 5C,A00,507696,Munoz Sanchez; Alicia,8,0,20,12
1715645086674,MAE 197,001,528363,Boechler; Nicholas Sebastia,9998,0,9999,1
1715645087700,MATH 197,001,523477,Kedlaya; Kiran S.,9994,0,9999,5
1715645087700,MATH 197,002,563811,Zhang; Danna,9994,0,9999,5
1715645087700,MATH 197,003,628552,Dumitriu; Ioana,9998,0,9999,1
1715645087700,MATH 197,004,660885,Floyd; Eric,9998,0,9999,1
1715645088727,MCWP 40R,A00,518780,Staff,1,0,20,19
1715645088727,MCWP 40R,B00,518781,Carter; Jennifer A,10,0,20,10
1715645088727,MCWP 40R,C00,518783,Smith; Haydee Marie,5,0,20,15
1715645089756,MCWP 50R,A00,518791,Redela; Pamela Morgan,0,1,20,20
1715645089756,MCWP 50R,B00,518792,Krone; Jarret,0,2,20,20
1715645089756,MCWP 50R,C00,518793,Staff,0,4,20,20
1715645089756,MCWP 50R,D00,518794,Morshed; Michael James,0,1,20,20
1715645089756,MCWP 50R,E00,518795,Carter; Andrea L,0,2,20,20
1715645089756,MCWP 50R,F00,518796,Miller; Elizabeth Deen,0,1,20,20
1715645089756,MCWP 50R,G00,518797,Guillen; Melinda,0,1,20,20
1715645090786,MMW 12R,A01,514034,Herbst; Matthew,0,2,16,16
1715645090786,MMW 12R,A02,514035,Herbst; Matthew,0,0,16,16
1715645091813,MMW 13R,A01,514037,Staff,0,5,16,16
1715645091813,MMW 13R,A02,514039,Staff,0,5,16,16
1715645091813,MMW 13R,A03,628519,Staff,0,4,16,16
1715645093881,SIO 295LS,A00,523233,Staff,10,0,30,20
1715645094909,SIO 295S,A00,523232,Staff,10,0,30,20
1715645095941,SIOC 290S,A01,637330,Merrifield; Mark A,21,0,30,9
1715645096967,SIOC 291S,A01,637333,Gabriel; Corey John,21,0,30,9
1715645097994,SOCI 117,A01,494376,Staff,0,5,5,5
1715645099024,WES 237B,A00,494380,Staff,10,0,20,10
1715645101109,AESE 279B,A00,494370,Wade; Jon P,0,0,33,33
1715645102141,AIP 97,001,660915,Van Den Einde; Yael Dahlia,9998,0,9999,1
1715645103169,AIP 197,001,627712,Vespa; Emanuel Ignacio,9995,0,9999,4
1715645103169,AIP 197,002,650778,Amir; On,9998,0,9999,1
1715645103169,AIP 197,003,650933,Avenancio-Leon; Carlos,9998,0,9999,1
1715645103169,AIP 197,004,658530,Heyman; Gail D.,9998,0,9999,1
1715645103169,AIP 197,005,658631,Neal; Sonya E,9998,0,9999,1
1715645103169,AIP 197,006,658671,Du; Songzi,9998,0,9999,1
1715645104195,ANAR 135S,A00,494369,Braswell; Geoffrey E.,0,0,0,0
1715645105219,BENG 196,001,628496,Engler; Adam J.,9998,0,9999,1
1715645105219,BENG 196,002,660916,Watson; John Thomas,9998,0,9999,1
1715645106247,BISP 197,001,650773,Wilhelm; James E.,9994,0,9999,5
1715645106247,BISP 197,002,658904,Coleman; Aaron B.,9998,0,9999,1
1715645107273,CAT 124RS,A01,519847,Geibel; William,0,0,20,20
1715645108301,CAT 125RS,A01,515971,Geibel; William,0,0,20,20
1715645109327,CLRE 250,A00,511389,Morris; Sheldon,9992,0,9999,7
1715645110355,CLRE 251,A00,507176,Mehta; Ravindra L.,9992,0,9999,7
1715645110355,CLRE 251,B00,511410,Mehta; Ravindra L.,9998,0,9999,1
1715645111382,CLRE 252,A00,507189,Cuomo; Raphael Eduardo,9994,0,9999,5
1715645112411,CLRE 253,A00,507199,Vaida; Florin,9994,0,9999,5
1715645112411,CLRE 253,B00,507202,Vaida; Florin,9999,0,9999,0
1715645113437,CLRE 259,A00,507211,Patel; Hemal,9996,0,9999,3
1715645114465,CLRE 260,A00,507221,Cuomo; Raphael Eduardo,9999,0,9999,0
1715645115489,CLRE 297,001,507242,Cuomo; Raphael Eduardo,9999,0,9999,0
1715645116516,COGS 197,001,638244,Voytek; Bradley Thomas,9997,0,9999,2
1715645117550,CSE 191,A00,516875,Minnes Kemp; Mor Mia,9991,0,9999,8
1715645118574,CSE 197,001,637388,Minnes Kemp; Mor Mia,9992,0,9999,7
1715645119606,CSS 201S,A01,494383,Mignozzetti; Umberto,35,0,35,0
1715645120631,CSS 202S,A01,494387,Mignozzetti; Umberto,35,0,35,0
1715645121657,DSC 197,001,628532,Eldridge; Justin Matthew,9995,0,9999,4
1715645122689,EAP 100,A00,516065,Staff,9799,0,9999,200
1715645123716,ECE 45,A01,507414,Staff,32,0,60,28
1715645125765,ECE 111,A01,507420,Staff,11,0,50,39
1715645126794,ECE 197,001,548057,Sievenpiper; Daniel F.,9991,0,9999,8
1715645127824,EDS 115,A00,507243,Choi; Bailey Miyeon,6,0,28,22
1715645128851,EDS 117,A01,494379,Staff,0,6,34,35
1715645129879,EDS 125,A00,507246,Hopkins; Megan Beth,7,0,30,23
1715645130904,EDS 128A,A01,507264,Fargason; Sharon Gayle,5,0,26,21
1715645131929,EDS 128B,A01,507293,Pappas; Elizabeth,9,0,30,21
1715645132955,EDS 139,A00,507294,Fargason; Sharon Gayle,9,0,30,21
1715645132955,EDS 139,B00,507313,Pappas; Elizabeth,9,0,30,21
1715645133985,EDS 201,A00,507315,Staff,10,0,30,20
1715645135011,EDS 203,A01,507317,Halter; Christopher P.,10,0,30,20
1715645136040,EDS 204R,A01,507319,Halter; Christopher P.,0,3,30,30
1715645136040,EDS 204R,B01,507331,Heinzman; Erica M.,14,0,30,16
1715645137065,EDS 206R,A00,507332,Staff,0,4,30,30
1715645137065,EDS 206R,B00,507343,Staff,15,0,30,15
1715645138093,EDS 250,A00,507344,Hemans; Patricia Ann Benitez,20,0,40,20
1715645139119,EDS 281,A00,507345,Daly; Alan J.,18,0,18,0
1715645140143,EDS 284,A00,507350,Daly; Alan J.,16,0,16,0
1715645141175,EDS 286,A00,507359,Fine; Sarah,18,0,18,0
1715645142202,EDS 289C,A01,507361,Daly; Alan J.,18,0,18,0
1715645143228,EDS 290,A00,507366,Hofstetter; Carolyn,15,0,15,0
1715645144269,LIGM 5A,A00,507421,Fischer-Grunski; Eva K,17,0,20,3
1715645145292,LIGM 5B,A00,507423,Fischer-Grunski; Eva K,19,0,20,1
1715645146322,LIGM 5C,A00,507425,Fischer-Grunski; Eva K,19,0,20,1
1715645147348,LIIT 5AS,A00,507427,Carnelos; Chiara,20,0,20,0
1715645148378,LIIT 5BS,A00,507430,Carnelos; Chiara,20,0,20,0
1715645149403,LIIT 5CS,A00,507432,Carnelos; Chiara,20,0,20,0
1715645150434,LISP 5A,A00,507541,Munoz Sanchez; Alicia,11,0,20,9
1715645151460,LISP 5B,A00,507671,Munoz Sanchez; Alicia,8,0,20,12
1715645152489,LISP 5C,A00,507696,Munoz Sanchez; Alicia,8,0,20,12
1715645153518,MAE 197,001,528363,Boechler; Nicholas Sebastia,9998,0,9999,1
1715645154550,MATH 197,001,523477,Kedlaya; Kiran S.,9994,0,9999,5
1715645154550,MATH 197,002,563811,Zhang; Danna,9994,0,9999,5
1715645154550,MATH 197,003,628552,Dumitriu; Ioana,9998,0,9999,1
1715645154550,MATH 197,004,660885,Floyd; Eric,9998,0,9999,1
1715645155576,MCWP 40R,A00,518780,Staff,1,0,20,19
1715645155576,MCWP 40R,B00,518781,Carter; Jennifer A,10,0,20,10
1715645155576,MCWP 40R,C00,518783,Smith; Haydee Marie,5,0,20,15
1715645156602,MCWP 50R,A00,518791,Redela; Pamela Morgan,0,1,20,20
1715645156602,MCWP 50R,B00,518792,Krone; Jarret,0,2,20,20
1715645156602,MCWP 50R,C00,518793,Staff,0,4,20,20
1715645156602,MCWP 50R,D00,518794,Morshed; Michael James,0,1,20,20
1715645156602,MCWP 50R,E00,518795,Carter; Andrea L,0,2,20,20
1715645156602,MCWP 50R,F00,518796,Miller; Elizabeth Deen,0,1,20,20
1715645156602,MCWP 50R,G00,518797,Guillen; Melinda,0,1,20,20
1715645157633,MMW 12R,A01,514034,Herbst; Matthew,0,2,16,16
1715645157633,MMW 12R,A02,514035,Herbst; Matthew,0,0,16,16
1715645158658,MMW 13R,A01,514037,Staff,0,5,16,16
1715645158658,MMW 13R,A02,514039,Staff,0,5,16,16
1715645158658,MMW 13R,A03,628519,Staff,0,4,16,16
1715645160719,SIO 295LS,A00,523233,Staff,10,0,30,20
1715645161744,SIO 295S,A00,523232,Staff,10,0,30,20
1715645162775,SIOC 290S,A01,637330,Merrifield; Mark A,21,0,30,9
1715645163802,SIOC 291S,A01,637333,Gabriel; Corey John,21,0,30,9
1715645164832,SOCI 117,A01,494376,Staff,0,5,5,5
1715645165857,WES 237B,A00,494380,Staff,10,0,20,10
1715645167932,AESE 279B,A00,494370,Wade; Jon P,0,0,33,33
1715645168957,AIP 97,001,660915,Van Den Einde; Yael Dahlia,9998,0,9999,1
1715645169990,AIP 197,001,627712,Vespa; Emanuel Ignacio,9995,0,9999,4
1715645169990,AIP 197,002,650778,Amir; On,9998,0,9999,1
1715645169990,AIP 197,003,650933,Avenancio-Leon; Carlos,9998,0,9999,1
1715645169990,AIP 197,004,658530,Heyman; Gail D.,9998,0,9999,1
1715645169990,AIP 197,005,658631,Neal; Sonya E,9998,0,9999,1
1715645169990,AIP 197,006,658671,Du; Songzi,9998,0,9999,1
1715645171023,ANAR 135S,A00,494369,Braswell; Geoffrey E.,0,0,0,0
1715645172059,BENG 196,001,628496,Engler; Adam J.,9998,0,9999,1
1715645172059,BENG 196,002,660916,Watson; John Thomas,9998,0,9999,1
1715645173088,BISP 197,001,650773,Wilhelm; James E.,9994,0,9999,5
1715645173088,BISP 197,002,658904,Coleman; Aaron B.,9998,0,9999,1
1715645174116,CAT 124RS,A01,519847,Geibel; William,0,0,20,20
1715645175142,CAT 125RS,A01,515971,Geibel; William,0,0,20,20
1715645176166,CLRE 250,A00,511389,Morris; Sheldon,9992,0,9999,7
1715645177197,CLRE 251,A00,507176,Mehta; Ravindra L.,9992,0,9999,7
1715645177197,CLRE 251,B00,511410,Mehta; Ravindra L.,9998,0,9999,1
1715645178229,CLRE 252,A00,507189,Cuomo; Raphael Eduardo,9994,0,9999,5
1715645179257,CLRE 253,A00,507199,Vaida; Florin,9994,0,9999,5
1715645179257,CLRE 253,B00,507202,Vaida; Florin,9999,0,9999,0
1715645180282,CLRE 259,A00,507211,Patel; Hemal,9996,0,9999,3
1715645181305,CLRE 260,A00,507221,Cuomo; Raphael Eduardo,9999,0,9999,0
1715645182334,CLRE 297,001,507242,Cuomo; Raphael Eduardo,9999,0,9999,0
1715645183360,COGS 197,001,638244,Voytek; Bradley Thomas,9997,0,9999,2
1715645184385,CSE 191,A00,516875,Minnes Kemp; Mor Mia,9991,0,9999,8
1715645185414,CSE 197,001,637388,Minnes Kemp; Mor Mia,9992,0,9999,7
1715645186441,CSS 201S,A01,494383,Mignozzetti; Umberto,35,0,35,0
1715645187468,CSS 202S,A01,494387,Mignozzetti; Umberto,35,0,35,0
1715645188497,DSC 197,001,628532,Eldridge; Justin Matthew,9995,0,9999,4
1715645189521,EAP 100,A00,516065,Staff,9799,0,9999,200
1715645190553,ECE 45,A01,507414,Staff,32,0,60,28
1715645192609,ECE 111,A01,507420,Staff,11,0,50,39
1715645193635,ECE 197,001,548057,Sievenpiper; Daniel F.,9991,0,9999,8
1715645194666,EDS 115,A00,507243,Choi; Bailey Miyeon,6,0,28,22
1715645195695,EDS 117,A01,494379,Staff,0,6,34,35
1715645196728,EDS 125,A00,507246,Hopkins; Megan Beth,7,0,30,23
1715645197758,EDS 128A,A01,507264,Fargason; Sharon Gayle,5,0,26,21
1715645198784,EDS 128B,A01,507293,Pappas; Elizabeth,9,0,30,21
1715645199811,EDS 139,A00,507294,Fargason; Sharon Gayle,9,0,30,21
1715645199811,EDS 139,B00,507313,Pappas; Elizabeth,9,0,30,21
1715645200838,EDS 201,A00,507315,Staff,10,0,30,20
1715645201867,EDS 203,A01,507317,Halter; Christopher P.,10,0,30,20
1715645202899,EDS 204R,A01,507319,Halter; Christopher P.,0,3,30,30
1715645202899,EDS 204R,B01,507331,Heinzman; Erica M.,14,0,30,16
1715645203925,EDS 206R,A00,507332,Staff,0,4,30,30
1715645203925,EDS 206R,B00,507343,Staff,15,0,30,15
1715645204955,EDS 250,A00,507344,Hemans; Patricia Ann Benitez,20,0,40,20
1715645205984,EDS 281,A00,507345,Daly; Alan J.,18,0,18,0
1715645207009,EDS 284,A00,507350,Daly; Alan J.,16,0,16,0
1715645208038,EDS 286,A00,507359,Fine; Sarah,18,0,18,0
1715645209066,EDS 289C,A01,507361,Daly; Alan J.,18,0,18,0
1715645210099,EDS 290,A00,507366,Hofstetter; Carolyn,15,0,15,0
1715645211131,LIGM 5A,A00,507421,Fischer-Grunski; Eva K,17,0,20,3
1715645212158,LIGM 5B,A00,507423,Fischer-Grunski; Eva K,19,0,20,1
1715645213183,LIGM 5C,A00,507425,Fischer-Grunski; Eva K,19,0,20,1
1715645214209,LIIT 5AS,A00,507427,Carnelos; Chiara,20,0,20,0
1715645215239,LIIT 5BS,A00,507430,Carnelos; Chiara,20,0,20,0
1715645216266,LIIT 5CS,A00,507432,Carnelos; Chiara,20,0,20,0
1715645217292,LISP 5A,A00,507541,Munoz Sanchez; Alicia,11,0,20,9
1715645218321,LISP 5B,A00,507671,Munoz Sanchez; Alicia,8,0,20,12
1715645219346,LISP 5C,A00,507696,Munoz Sanchez; Alicia,8,0,20,12
1715645220372,MAE 197,001,528363,Boechler; Nicholas Sebastia,9998,0,9999,1
1715645221399,MATH 197,001,523477,Kedlaya; Kiran S.,9994,0,9999,5
1715645221399,MATH 197,002,563811,Zhang; Danna,9994,0,9999,5
1715645221399,MATH 197,003,628552,Dumitriu; Ioana,9998,0,9999,1
1715645221399,MATH 197,004,660885,Floyd; Eric,9998,0,9999,1
1715645222425,MCWP 40R,A00,518780,Staff,1,0,20,19
1715645222425,MCWP 40R,B00,518781,Carter; Jennifer A,10,0,20,10
1715645222425,MCWP 40R,C00,518783,Smith; Haydee Marie,5,0,20,15
1715645223457,MCWP 50R,A00,518791,Redela; Pamela Morgan,0,1,20,20
1715645223457,MCWP 50R,B00,518792,Krone; Jarret,0,2,20,20
1715645223457,MCWP 50R,C00,518793,Staff,0,4,20,20
1715645223457,MCWP 50R,D00,518794,Morshed; Michael James,0,1,20,20
1715645223457,MCWP 50R,E00,518795,Carter; Andrea L,0,2,20,20
1715645223457,MCWP 50R,F00,518796,Miller; Elizabeth Deen,0,1,20,20
1715645223457,MCWP 50R,G00,518797,Guillen; Melinda,0,1,20,20
1715645224490,MMW 12R,A01,514034,Herbst; Matthew,0,2,16,16
1715645224490,MMW 12R,A02,514035,Herbst; Matthew,0,0,16,16
1715645225520,MMW 13R,A01,514037,Staff,0,5,16,16
1715645225520,MMW 13R,A02,514039,Staff,0,5,16,16
1715645225520,MMW 13R,A03,628519,Staff,0,4,16,16
1715645227598,SIO 295LS,A00,523233,Staff,10,0,30,20
1715645228629,SIO 295S,A00,523232,Staff,10,0,30,20
1715645229660,SIOC 290S,A01,637330,Merrifield; Mark A,21,0,30,9
1715645230684,SIOC 291S,A01,637333,Gabriel; Corey John,21,0,30,9
1715645231714,SOCI 117,A01,494376,Staff,0,5,5,5
1715645232740,WES 237B,A00,494380,Staff,10,0,20,10
1715645234819,AESE 279B,A00,494370,Wade; Jon P,0,0,33,33
1715645235846,AIP 97,001,660915,Van Den Einde; Yael Dahlia,9998,0,9999,1
1715645236875,AIP 197,001,627712,Vespa; Emanuel Ignacio,9995,0,9999,4
1715645236875,AIP 197,002,650778,Amir; On,9998,0,9999,1
1715645236875,AIP 197,003,650933,Avenancio-Leon; Carlos,9998,0,9999,1
1715645236875,AIP 197,004,658530,Heyman; Gail D.,9998,0,9999,1
1715645236875,AIP 197,005,658631,Neal; Sonya E,9998,0,9999,1
1715645236875,AIP 197,006,658671,Du; Songzi,9998,0,9999,1
1715645237904,ANAR 135S,A00,494369,Braswell; Geoffrey E.,0,0,0,0
1715645238935,BENG 196,001,628496,Engler; Adam J.,9998,0,9999,1
1715645238935,BENG 196,002,660916,Watson; John Thomas,9998,0,9999,1
1715645239960,BISP 197,001,650773,Wilhelm; James E.,9994,0,9999,5
1715645239960,BISP 197,002,658904,Coleman; Aaron B.,9998,0,9999,1
1715645240985,CAT 124RS,A01,519847,Geibel; William,0,0,20,20
1715645242016,CAT 125RS,A01,515971,Geibel; William,0,0,20,20
1715645243041,CLRE 250,A00,511389,Morris; Sheldon,9992,0,9999,7
1715645244067,CLRE 251,A00,507176,Mehta; Ravindra L.,9992,0,9999,7
1715645244067,CLRE 251,B00,511410,Mehta; Ravindra L.,9998,0,9999,1
1715645245093,CLRE 252,A00,507189,Cuomo; Raphael Eduardo,9994,0,9999,5
1715645246120,CLRE 253,A00,507199,Vaida; Florin,9994,0,9999,5
1715645246120,CLRE 253,B00,507202,Vaida; Florin,9999,0,9999,0
1715645247146,CLRE 259,A00,507211,Patel; Hemal,9996,0,9999,3
1715645248170,CLRE 260,A00,507221,Cuomo; Raphael Eduardo,9999,0,9999,0
1715645249198,CLRE 297,001,507242,Cuomo; Raphael Eduardo,9999,0,9999,0
1715645250228,COGS 197,001,638244,Voytek; Bradley Thomas,9997,0,9999,2
1715645251255,CSE 191,A00,516875,Minnes Kemp; Mor Mia,9991,0,9999,8
1715645252280,CSE 197,001,637388,Minnes Kemp; Mor Mia,9992,0,9999,7
1715645253305,CSS 201S,A01,494383,Mignozzetti; Umberto,35,0,35,0
1715645254332,CSS 202S,A01,494387,Mignozzetti; Umberto,35,0,35,0
1715645255359,DSC 197,001,628532,Eldridge; Justin Matthew,9995,0,9999,4
1715645256387,EAP 100,A00,516065,Staff,9799,0,9999,200
1715645257416,ECE 45,A01,507414,Staff,32,0,60,28
1715645259466,ECE 111,A01,507420,Staff,11,0,50,39
1715645260495,ECE 197,001,548057,Sievenpiper; Daniel F.,9991,0,9999,8
1715645261523,EDS 115,A00,507243,Choi; Bailey Miyeon,6,0,28,22
1715645262549,EDS 117,A01,494379,Staff,0,6,34,35
1715645263603,EDS 125,A00,507246,Hopkins; Megan Beth,7,0,30,23
1715645264627,EDS 128A,A01,507264,Fargason; Sharon Gayle,5,0,26,21
1715645265654,EDS 128B,A01,507293,Pappas; Elizabeth,9,0,30,21
1715645266678,EDS 139,A00,507294,Fargason; Sharon Gayle,9,0,30,21
1715645266678,EDS 139,B00,507313,Pappas; Elizabeth,9,0,30,21
1715645267703,EDS 201,A00,507315,Staff,10,0,30,20
1715645268729,EDS 203,A01,507317,Halter; Christopher P.,10,0,30,20
1715645269754,EDS 204R,A01,507319,Halter; Christopher P.,0,3,30,30
1715645269754,EDS 204R,B01,507331,Heinzman; Erica M.,14,0,30,16
1715645270779,EDS 206R,A00,507332,Staff,0,4,30,30
1715645270779,EDS 206R,B00,507343,Staff,15,0,30,15
1715645271805,EDS 250,A00,507344,Hemans; Patricia Ann Benitez,20,0,40,20
1715645272829,EDS 281,A00,507345,Daly; Alan J.,18,0,18,0
1715645273857,EDS 284,A00,507350,Daly; Alan J.,16,0,16,0
1715645274882,EDS 286,A00,507359,Fine; Sarah,18,0,18,0
1715645275906,EDS 289C,A01,507361,Daly; Alan J.,18,0,18,0
1715645276931,EDS 290,A00,507366,Hofstetter; Carolyn,15,0,15,0
1715645277961,LIGM 5A,A00,507421,Fischer-Grunski; Eva K,17,0,20,3
1715645278986,LIGM 5B,A00,507423,Fischer-Grunski; Eva K,19,0,20,1
1715645280017,LIGM 5C,A00,507425,Fischer-Grunski; Eva K,19,0,20,1
1715645281042,LIIT 5AS,A00,507427,Carnelos; Chiara,20,0,20,0
1715645282068,LIIT 5BS,A00,507430,Carnelos; Chiara,20,0,20,0
1715645283092,LIIT 5CS,A00,507432,Carnelos; Chiara,20,0,20,0
1715645284118,LISP 5A,A00,507541,Munoz Sanchez; Alicia,11,0,20,9
1715645285151,LISP 5B,A00,507671,Munoz Sanchez; Alicia,8,0,20,12
1715645286178,LISP 5C,A00,507696,Munoz Sanchez; Alicia,8,0,20,12
1715645287206,MAE 197,001,528363,Boechler; Nicholas Sebastia,9998,0,9999,1
1715645288242,MATH 197,001,523477,Kedlaya; Kiran S.,9994,0,9999,5
1715645288242,MATH 197,002,563811,Zhang; Danna,9994,0,9999,5
1715645288242,MATH 197,003,628552,Dumitriu; Ioana,9998,0,9999,1
1715645288242,MATH 197,004,660885,Floyd; Eric,9998,0,9999,1
1715645289269,MCWP 40R,A00,518780,Staff,1,0,20,19
1715645289269,MCWP 40R,B00,518781,Carter; Jennifer A,10,0,20,10
1715645289269,MCWP 40R,C00,518783,Smith; Haydee Marie,5,0,20,15
1715645290297,MCWP 50R,A00,518791,Redela; Pamela Morgan,0,1,20,20
1715645290297,MCWP 50R,B00,518792,Krone; Jarret,0,2,20,20
1715645290297,MCWP 50R,C00,518793,Staff,0,4,20,20
1715645290297,MCWP 50R,D00,518794,Morshed; Michael James,0,1,20,20
1715645290297,MCWP 50R,E00,518795,Carter; Andrea L,0,2,20,20
1715645290297,MCWP 50R,F00,518796,Miller; Elizabeth Deen,0,1,20,20
1715645290297,MCWP 50R,G00,518797,Guillen; Melinda,0,1,20,20
1715645291324,MMW 12R,A01,514034,Herbst; Matthew,0,2,16,16
1715645291324,MMW 12R,A02,514035,Herbst; Matthew,0,0,16,16
1715645292350,MMW 13R,A01,514037,Staff,0,5,16,16
1715645292350,MMW 13R,A02,514039,Staff,0,5,16,16
1715645292350,MMW 13R,A03,628519,Staff,0,4,16,16
1715645294403,SIO 295LS,A00,523233,Staff,10,0,30,20
1715645295432,SIO 295S,A00,523232,Staff,10,0,30,20
1715645296459,SIOC 290S,A01,637330,Merrifield; Mark A,21,0,30,9
1715645297485,SIOC 291S,A01,637333,Gabriel; Corey John,21,0,30,9
1715645298513,SOCI 117,A01,494376,Staff,0,5,5,5
1715645299538,WES 237B,A00,494380,Staff,10,0,20,10
1715645301610,AESE 279B,A00,494370,Wade; Jon P,0,0,33,33
1715645302636,AIP 97,001,660915,Van Den Einde; Yael Dahlia,9998,0,9999,1
1715645303670,AIP 197,001,627712,Vespa; Emanuel Ignacio,9995,0,9999,4
1715645303670,AIP 197,002,650778,Amir; On,9998,0,9999,1
1715645303670,AIP 197,003,650933,Avenancio-Leon; Carlos,9998,0,9999,1
1715645303670,AIP 197,004,658530,Heyman; Gail D.,9998,0,9999,1
1715645303670,AIP 197,005,658631,Neal; Sonya E,9998,0,9999,1
1715645303670,AIP 197,006,658671,Du; Songzi,9998,0,9999,1
1715645304697,ANAR 135S,A00,494369,Braswell; Geoffrey E.,0,0,0,0
1715645305729,BENG 196,001,628496,Engler; Adam J.,9998,0,9999,1
1715645305729,BENG 196,002,660916,Watson; John Thomas,9998,0,9999,1
1715645306755,BISP 197,001,650773,Wilhelm; James E.,9994,0,9999,5
1715645306755,BISP 197,002,658904,Coleman; Aaron B.,9998,0,9999,1
1715645307780,CAT 124RS,A01,519847,Geibel; William,0,0,20,20
1715645308804,CAT 125RS,A01,515971,Geibel; William,0,0,20,20
1715645309831,CLRE 250,A00,511389,Morris; Sheldon,9992,0,9999,7
1715645310858,CLRE 251,A00,507176,Mehta; Ravindra L.,9992,0,9999,7
1715645310858,CLRE 251,B00,511410,Mehta; Ravindra L.,9998,0,9999,1
1715645311884,CLRE 252,A00,507189,Cuomo; Raphael Eduardo,9994,0,9999,5
1715645312910,CLRE 253,A00,507199,Vaida; Florin,9994,0,9999,5
1715645312910,CLRE 253,B00,507202,Vaida; Florin,9999,0,9999,0
1715645313935,CLRE 259,A00,507211,Patel; Hemal,9996,0,9999,3
1715645314962,CLRE 260,A00,507221,Cuomo; Raphael Eduardo,9999,0,9999,0
1715645315989,CLRE 297,001,507242,Cuomo; Raphael Eduardo,9999,0,9999,0
1715645317015,COGS 197,001,638244,Voytek; Bradley Thomas,9997,0,9999,2
1715645318039,CSE 191,A00,516875,Minnes Kemp; Mor Mia,9991,0,9999,8
1715645319065,CSE 197,001,637388,Minnes Kemp; Mor Mia,9992,0,9999,7
1715645320097,CSS 201S,A01,494383,Mignozzetti; Umberto,35,0,35,0
1715645321123,CSS 202S,A01,494387,Mignozzetti; Umberto,35,0,35,0
1715645322149,DSC 197,001,628532,Eldridge; Justin Matthew,9995,0,9999,4
1715645323176,EAP 100,A00,516065,Staff,9799,0,9999,200
1715645324210,ECE 45,A01,507414,Staff,32,0,60,28
1715645326264,ECE 111,A01,507420,Staff,11,0,50,39
1715645327290,ECE 197,001,548057,Sievenpiper; Daniel F.,9991,0,9999,8
1715645328316,EDS 115,A00,507243,Choi; Bailey Miyeon,6,0,28,22
1715645329349,EDS 117,A01,494379,Staff,0,6,34,35
1715645330374,EDS 125,A00,507246,Hopkins; Megan Beth,7,0,30,23
1715645331400,EDS 128A,A01,507264,Fargason; Sharon Gayle,5,0,26,21
1715645332431,EDS 128B,A01,507293,Pappas; Elizabeth,9,0,30,21
1715645333460,EDS 139,A00,507294,Fargason; Sharon Gayle,9,0,30,21
1715645333460,EDS 139,B00,507313,Pappas; Elizabeth,9,0,30,21
1715645334486,EDS 201,A00,507315,Staff,10,0,30,20
1715645335518,EDS 203,A01,507317,Halter; Christopher P.,10,0,30,20
1715645336547,EDS 204R,A01,507319,Halter; Christopher P.,0,3,30,30
1715645336547,EDS 204R,B01,507331,Heinzman; Erica M.,14,0,30,16
1715645337578,EDS 206R,A00,507332,Staff,0,4,30,30
1715645337578,EDS 206R,B00,507343,Staff,15,0,30,15
1715645338607,EDS 250,A00,507344,Hemans; Patricia Ann Benitez,20,0,40,20
1715645339636,EDS 281,A00,507345,Daly; Alan J.,18,0,18,0
1715645340662,EDS 284,A00,507350,Daly; Alan J.,16,0,16,0
1715645341693,EDS 286,A00,507359,Fine; Sarah,18,0,18,0
1715645342722,EDS 289C,A01,507361,Daly; Alan J.,18,0,18,0
1715645343749,EDS 290,A00,507366,Hofstetter; Carolyn,15,0,15,0
1715645344776,LIGM 5A,A00,507421,Fischer-Grunski; Eva K,17,0,20,3
1715645345809,LIGM 5B,A00,507423,Fischer-Grunski; Eva K,19,0,20,1
1715645346834,LIGM 5C,A00,507425,Fischer-Grunski; Eva K,19,0,20,1
1715645347865,LIIT 5AS,A00,507427,Carnelos; Chiara,20,0,20,0
1715645348890,LIIT 5BS,A00,507430,Carnelos; Chiara,20,0,20,0
1715645349916,LIIT 5CS,A00,507432,Carnelos; Chiara,20,0,20,0
1715645350942,LISP 5A,A00,507541,Munoz Sanchez; Alicia,11,0,20,9
1715645351971,LISP 5B,A00,507671,Munoz Sanchez; Alicia,8,0,20,12
1715645352997,LISP 5C,A00,507696,Munoz Sanchez; Alicia,8,0,20,12
1715645354026,MAE 197,001,528363,Boechler; Nicholas Sebastia,9998,0,9999,1
1715645355064,MATH 197,001,523477,Kedlaya; Kiran S.,9994,0,9999,5
1715645355064,MATH 197,002,563811,Zhang; Danna,9994,0,9999,5
1715645355064,MATH 197,003,628552,Dumitriu; Ioana,9998,0,9999,1
1715645355064,MATH 197,004,660885,Floyd; Eric,9998,0,9999,1
1715645356096,MCWP 40R,A00,518780,Staff,1,0,20,19
1715645356096,MCWP 40R,B00,518781,Carter; Jennifer A,10,0,20,10
1715645356096,MCWP 40R,C00,518783,Smith; Haydee Marie,5,0,20,15
1715645357129,MCWP 50R,A00,518791,Redela; Pamela Morgan,0,1,20,20
1715645357129,MCWP 50R,B00,518792,Krone; Jarret,0,2,20,20
1715645357129,MCWP 50R,C00,518793,Staff,0,4,20,20
1715645357129,MCWP 50R,D00,518794,Morshed; Michael James,0,1,20,20
1715645357129,MCWP 50R,E00,518795,Carter; Andrea L,0,2,20,20
1715645357129,MCWP 50R,F00,518796,Miller; Elizabeth Deen,0,1,20,20
1715645357129,MCWP 50R,G00,518797,Guillen; Melinda,0,1,20,20
1715645358155,MMW 12R,A01,514034,Herbst; Matthew,0,2,16,16
1715645358155,MMW 12R,A02,514035,Herbst; Matthew,0,0,16,16
1715645359183,MMW 13R,A01,514037,Staff,0,5,16,16
1715645359183,MMW 13R,A02,514039,Staff,0,5,16,16
1715645359183,MMW 13R,A03,628519,Staff,0,4,16,16
1715645361233,SIO 295LS,A00,523233,Staff,10,0,30,20
1715645362258,SIO 295S,A00,523232,Staff,10,0,30,20
1715645363295,SIOC 290S,A01,637330,Merrifield; Mark A,21,0,30,9
1715645364321,SIOC 291S,A01,637333,Gabriel; Corey John,21,0,30,9
1715645365347,SOCI 117,A01,494376,Staff,0,5,5,5
1715645366374,WES 237B,A00,494380,Staff,10,0,20,10
1715645368445,AESE 279B,A00,494370,Wade; Jon P,0,0,33,33
1715645369477,AIP 97,001,660915,Van Den Einde; Yael Dahlia,9998,0,9999,1
1715645370505,AIP 197,001,627712,Vespa; Emanuel Ignacio,9995,0,9999,4
1715645370505,AIP 197,002,650778,Amir; On,9998,0,9999,1
1715645370505,AIP 197,003,650933,Avenancio-Leon; Carlos,9998,0,9999,1
1715645370505,AIP 197,004,658530,Heyman; Gail D.,9998,0,9999,1
1715645370505,AIP 197,005,658631,Neal; Sonya E,9998,0,9999,1
1715645370505,AIP 197,006,658671,Du; Songzi,9998,0,9999,1
1715645371532,ANAR 135S,A00,494369,Braswell; Geoffrey E.,0,0,0,0
1715645372559,BENG 196,001,628496,Engler; Adam J.,9998,0,9999,1
1715645372559,BENG 196,002,660916,Watson; John Thomas,9998,0,9999,1
1715645373585,BISP 197,001,650773,Wilhelm; James E.,9994,0,9999,5
1715645373585,BISP 197,002,658904,Coleman; Aaron B.,9998,0,9999,1
1715645374614,CAT 124RS,A01,519847,Geibel; William,0,0,20,20
1715645375639,CAT 125RS,A01,515971,Geibel; William,0,0,20,20
1715645376668,CLRE 250,A00,511389,Morris; Sheldon,9992,0,9999,7
1715645377694,CLRE 251,A00,507176,Mehta; Ravindra L.,9992,0,9999,7
1715645377694,CLRE 251,B00,511410,Mehta; Ravindra L.,9998,0,9999,1
1715645378725,CLRE 252,A00,507189,Cuomo; Raphael Eduardo,9994,0,9999,5
1715645379748,CLRE 253,A00,507199,Vaida; Florin,9994,0,9999,5
1715645379748,CLRE 253,B00,507202,Vaida; Florin,9999,0,9999,0
1715645380772,CLRE 259,A00,507211,Patel; Hemal,9996,0,9999,3
1715645381797,CLRE 260,A00,507221,Cuomo; Raphael Eduardo,9999,0,9999,0
1715645382821,CLRE 297,001,507242,Cuomo; Raphael Eduardo,9999,0,9999,0
1715645383859,COGS 197,001,638244,Voytek; Bradley Thomas,9997,0,9999,2
1715645384884,CSE 191,A00,516875,Minnes Kemp; Mor Mia,9991,0,9999,8
1715645385910,CSE 197,001,637388,Minnes Kemp; Mor Mia,9992,0,9999,7
1715645386937,CSS 201S,A01,494383,Mignozzetti; Umberto,35,0,35,0
1715645387969,CSS 202S,A01,494387,Mignozzetti; Umberto,35,0,35,0
1715645388994,DSC 197,001,628532,Eldridge; Justin Matthew,9995,0,9999,4
1715645390021,EAP 100,A00,516065,Staff,9799,0,9999,200
1715645391056,ECE 45,A01,507414,Staff,32,0,60,28
1715645393109,ECE 111,A01,507420,Staff,11,0,50,39
1715645394135,ECE 197,001,548057,Sievenpiper; Daniel F.,9991,0,9999,8
1715645395163,EDS 115,A00,507243,Choi; Bailey Miyeon,6,0,28,22
1715645396194,EDS 117,A01,494379,Staff,0,6,34,35
1715645397221,EDS 125,A00,507246,Hopkins; Megan Beth,7,0,30,23
1715645398247,EDS 128A,A01,507264,Fargason; Sharon Gayle,5,0,26,21
1715645399277,EDS 128B,A01,507293,Pappas; Elizabeth,9,0,30,21
1715645400302,EDS 139,A00,507294,Fargason; Sharon Gayle,9,0,30,21
1715645400302,EDS 139,B00,507313,Pappas; Elizabeth,9,0,30,21
1715645401327,EDS 201,A00,507315,Staff,10,0,30,20
1715645402356,EDS 203,A01,507317,Halter; Christopher P.,10,0,30,20
1715645403386,EDS 204R,A01,507319,Halter; Christopher P.,0,3,30,30
1715645403386,EDS 204R,B01,507331,Heinzman; Erica M.,14,0,30,16
1715645404415,EDS 206R,A00,507332,Staff,0,4,30,30
1715645404415,EDS 206R,B00,507343,Staff,15,0,30,15
1715645405439,EDS 250,A00,507344,Hemans; Patricia Ann Benitez,20,0,40,20
1715645406463,EDS 281,A00,507345,Daly; Alan J.,18,0,18,0
1715645407488,EDS 284,A00,507350,Daly; Alan J.,16,0,16,0
1715645408518,EDS 286,A00,507359,Fine; Sarah,18,0,18,0
1715645409543,EDS 289C,A01,507361,Daly; Alan J.,18,0,18,0
1715645410571,EDS 290,A00,507366,Hofstetter; Carolyn,15,0,15,0
1715645411601,LIGM 5A,A00,507421,Fischer-Grunski; Eva K,17,0,20,3
1715645412630,LIGM 5B,A00,507423,Fischer-Grunski; Eva K,19,0,20,1
1715645413655,LIGM 5C,A00,507425,Fischer-Grunski; Eva K,19,0,20,1
1715645414687,LIIT 5AS,A00,507427,Carnelos; Chiara,20,0,20,0
1715645415715,LIIT 5BS,A00,507430,Carnelos; Chiara,20,0,20,0
1715645416741,LIIT 5CS,A00,507432,Carnelos; Chiara,20,0,20,0
1715645417766,LISP 5A,A00,507541,Munoz Sanchez; Alicia,11,0,20,9
1715645418797,LISP 5B,A00,507671,Munoz Sanchez; Alicia,8,0,20,12
1715645419825,LISP 5C,A00,507696,Munoz Sanchez; Alicia,8,0,20,12
1715645420852,MAE 197,001,528363,Boechler; Nicholas Sebastia,9998,0,9999,1
1715645421881,MATH 197,001,523477,Kedlaya; Kiran S.,9994,0,9999,5
1715645421881,MATH 197,002,563811,Zhang; Danna,9994,0,9999,5
1715645421881,MATH 197,003,628552,Dumitriu; Ioana,9998,0,9999,1
1715645421881,MATH 197,004,660885,Floyd; Eric,9998,0,9999,1
1715645422912,MCWP 40R,A00,518780,Staff,1,0,20,19
1715645422912,MCWP 40R,B00,518781,Carter; Jennifer A,10,0,20,10
1715645422912,MCWP 40R,C00,518783,Smith; Haydee Marie,5,0,20,15
1715645423941,MCWP 50R,A00,518791,Redela; Pamela Morgan,0,1,20,20
1715645423941,MCWP 50R,B00,518792,Krone; Jarret,0,2,20,20
1715645423941,MCWP 50R,C00,518793,Staff,0,4,20,20
1715645423941,MCWP 50R,D00,518794,Morshed; Michael James,0,1,20,20
1715645423941,MCWP 50R,E00,518795,Carter; Andrea L,0,2,20,20
1715645423941,MCWP 50R,F00,518796,Miller; Elizabeth Deen,0,1,20,20
1715645423941,MCWP 50R,G00,518797,Guillen; Melinda,0,1,20,20
1715645424966,MMW 12R,A01,514034,Herbst; Matthew,0,2,16,16
1715645424966,MMW 12R,A02,514035,Herbst; Matthew,0,0,16,16
1715645425995,MMW 13R,A01,514037,Staff,0,5,16,16
1715645425995,MMW 13R,A02,514039,Staff,0,5,16,16
1715645425995,MMW 13R,A03,628519,Staff,0,4,16,16
1715645428046,SIO 295LS,A00,523233,Staff,10,0,30,20
1715645429071,SIO 295S,A00,523232,Staff,10,0,30,20
1715645430101,SIOC 290S,A01,637330,Merrifield; Mark A,21,0,30,9
1715645431131,SIOC 291S,A01,637333,Gabriel; Corey John,21,0,30,9
1715645432157,SOCI 117,A01,494376,Staff,0,5,5,5
1715645433183,WES 237B,A00,494380,Staff,10,0,20,10
1715645435253,AESE 279B,A00,494370,Wade; Jon P,0,0,33,33
1715645436279,AIP 97,001,660915,Van Den Einde; Yael Dahlia,9998,0,9999,1
1715645437306,AIP 197,001,627712,Vespa; Emanuel Ignacio,9995,0,9999,4
1715645437306,AIP 197,002,650778,Amir; On,9998,0,9999,1
1715645437306,AIP 197,003,650933,Avenancio-Leon; Carlos,9998,0,9999,1
1715645437306,AIP 197,004,658530,Heyman; Gail D.,9998,0,9999,1
1715645437306,AIP 197,005,658631,Neal; Sonya E,9998,0,9999,1
1715645437306,AIP 197,006,658671,Du; Songzi,9998,0,9999,1
1715645438366,ANAR 135S,A00,494369,Braswell; Geoffrey E.,0,0,0,0
1715645439393,BENG 196,001,628496,Engler; Adam J.,9998,0,9999,1
1715645439393,BENG 196,002,660916,Watson; John Thomas,9998,0,9999,1
1715645440419,BISP 197,001,650773,Wilhelm; James E.,9994,0,9999,5
1715645440419,BISP 197,002,658904,Coleman; Aaron B.,9998,0,9999,1
1715645441444,CAT 124RS,A01,519847,Geibel; William,0,0,20,20
1715645442470,CAT 125RS,A01,515971,Geibel; William,0,0,20,20
1715645443496,CLRE 250,A00,511389,Morris; Sheldon,9992,0,9999,7
1715645444530,CLRE 251,A00,507176,Mehta; Ravindra L.,9992,0,9999,7
1715645444530,CLRE 251,B00,511410,Mehta; Ravindra L.,9998,0,9999,1
1715645445565,CLRE 252,A00,507189,Cuomo; Raphael Eduardo,9994,0,9999,5
1715645446591,CLRE 253,A00,507199,Vaida; Florin,9994,0,9999,5
1715645446591,CLRE 253,B00,507202,Vaida; Florin,9999,0,9999,0
1715645447616,CLRE 259,A00,507211,Patel; Hemal,9996,0,9999,3
1715645448645,CLRE 260,A00,507221,Cuomo; Raphael Eduardo,9999,0,9999,0
1715645449670,CLRE 297,001,507242,Cuomo; Raphael Eduardo,9999,0,9999,0
1715645450693,COGS 197,001,638244,Voytek; Bradley Thomas,9997,0,9999,2
1715645451719,CSE 191,A00,516875,Minnes Kemp; Mor Mia,9991,0,9999,8
1715645452747,CSE 197,001,637388,Minnes Kemp; Mor Mia,9992,0,9999,7
1715645453981,CSS 201S,A01,494383,Mignozzetti; Umberto,35,0,35,0
1715645455011,CSS 202S,A01,494387,Mignozzetti; Umberto,35,0,35,0
1715645456035,DSC 197,001,628532,Eldridge; Justin Matthew,9995,0,9999,4
1715645457060,EAP 100,A00,516065,Staff,9799,0,9999,200
1715645458087,ECE 45,A01,507414,Staff,32,0,60,28
1715645460140,ECE 111,A01,507420,Staff,11,0,50,39
1715645461165,ECE 197,001,548057,Sievenpiper; Daniel F.,9991,0,9999,8
1715645462197,EDS 115,A00,507243,Choi; Bailey Miyeon,6,0,28,22
1715645463226,EDS 117,A01,494379,Staff,0,6,34,35
1715645464251,EDS 125,A00,507246,Hopkins; Megan Beth,7,0,30,23
1715645465277,EDS 128A,A01,507264,Fargason; Sharon Gayle,5,0,26,21
1715645466303,EDS 128B,A01,507293,Pappas; Elizabeth,9,0,30,21
1715645467328,EDS 139,A00,507294,Fargason; Sharon Gayle,9,0,30,21
1715645467328,EDS 139,B00,507313,Pappas; Elizabeth,9,0,30,21
1715645468354,EDS 201,A00,507315,Staff,10,0,30,20
1715645469383,EDS 203,A01,507317,Halter; Christopher P.,10,0,30,20
1715645470409,EDS 204R,A01,507319,Halter; Christopher P.,0,3,30,30
1715645470409,EDS 204R,B01,507331,Heinzman; Erica M.,14,0,30,16
1715645471433,EDS 206R,A00,507332,Staff,0,4,30,30
1715645471433,EDS 206R,B00,507343,Staff,15,0,30,15
1715645472458,EDS 250,A00,507344,Hemans; Patricia Ann Benitez,20,0,40,20
1715645473486,EDS 281,A00,507345,Daly; Alan J.,18,0,18,0
1715645474511,EDS 284,A00,507350,Daly; Alan J.,16,0,16,0
1715645475542,EDS 286,A00,507359,Fine; Sarah,18,0,18,0
1715645476573,EDS 289C,A01,507361,Daly; Alan J.,18,0,18,0
1715645477598,EDS 290,A00,507366,Hofstetter; Carolyn,15,0,15,0
1715645478625,LIGM 5A,A00,507421,Fischer-Grunski; Eva K,17,0,20,3
1715645479651,LIGM 5B,A00,507423,Fischer-Grunski; Eva K,19,0,20,1
1715645480677,LIGM 5C,A00,507425,Fischer-Grunski; Eva K,19,0,20,1
1715645481702,LIIT 5AS,A00,507427,Carnelos; Chiara,20,0,20,0
1715645482729,LIIT 5BS,A00,507430,Carnelos; Chiara,20,0,20,0
1715645483755,LIIT 5CS,A00,507432,Carnelos; Chiara,20,0,20,0
1715645484805,LISP 5A,A00,507541,Munoz Sanchez; Alicia,11,0,20,9
1715645485833,LISP 5B,A00,507671,Munoz Sanchez; Alicia,8,0,20,12
1715645486857,LISP 5C,A00,507696,Munoz Sanchez; Alicia,8,0,20,12
1715645487884,MAE 197,001,528363,Boechler; Nicholas Sebastia,9998,0,9999,1
1715645488910,MATH 197,001,523477,Kedlaya; Kiran S.,9994,0,9999,5
1715645488910,MATH 197,002,563811,Zhang; Danna,9994,0,9999,5
1715645488910,MATH 197,003,628552,Dumitriu; Ioana,9998,0,9999,1
1715645488910,MATH 197,004,660885,Floyd; Eric,9998,0,9999,1
1715645489938,MCWP 40R,A00,518780,Staff,1,0,20,19
1715645489938,MCWP 40R,B00,518781,Carter; Jennifer A,10,0,20,10
1715645489938,MCWP 40R,C00,518783,Smith; Haydee Marie,5,0,20,15
1715645490964,MCWP 50R,A00,518791,Redela; Pamela Morgan,0,1,20,20
1715645490964,MCWP 50R,B00,518792,Krone; Jarret,0,2,20,20
1715645490964,MCWP 50R,C00,518793,Staff,0,4,20,20
1715645490964,MCWP 50R,D00,518794,Morshed; Michael James,0,1,20,20
1715645490964,MCWP 50R,E00,518795,Carter; Andrea L,0,2,20,20
1715645490964,MCWP 50R,F00,518796,Miller; Elizabeth Deen,0,1,20,20
1715645490964,MCWP 50R,G00,518797,Guillen; Melinda,0,1,20,20
1715645491989,MMW 12R,A01,514034,Herbst; Matthew,0,2,16,16
1715645491989,MMW 12R,A02,514035,Herbst; Matthew,0,0,16,16
1715645493014,MMW 13R,A01,514037,Staff,0,5,16,16
1715645493014,MMW 13R,A02,514039,Staff,0,5,16,16
1715645493014,MMW 13R,A03,628519,Staff,0,4,16,16
1715645495076,SIO 295LS,A00,523233,Staff,10,0,30,20
1715645496103,SIO 295S,A00,523232,Staff,10,0,30,20
1715645497130,SIOC 290S,A01,637330,Merrifield; Mark A,21,0,30,9
1715645498159,SIOC 291S,A01,637333,Gabriel; Corey John,21,0,30,9
1715645499184,SOCI 117,A01,494376,Staff,0,5,5,5
1715645500210,WES 237B,A00,494380,Staff,10,0,20,10
1715645502277,AESE 279B,A00,494370,Wade; Jon P,0,0,33,33
1715645503303,AIP 97,001,660915,Van Den Einde; Yael Dahlia,9998,0,9999,1
1715645504332,AIP 197,001,627712,Vespa; Emanuel Ignacio,9995,0,9999,4
1715645504332,AIP 197,002,650778,Amir; On,9998,0,9999,1
1715645504332,AIP 197,003,650933,Avenancio-Leon; Carlos,9998,0,9999,1
1715645504332,AIP 197,004,658530,Heyman; Gail D.,9998,0,9999,1
1715645504332,AIP 197,005,658631,Neal; Sonya E,9998,0,9999,1
1715645504332,AIP 197,006,658671,Du; Songzi,9998,0,9999,1
1715645505356,ANAR 135S,A00,494369,Braswell; Geoffrey E.,0,0,0,0
1715645506382,BENG 196,001,628496,Engler; Adam J.,9998,0,9999,1
1715645506382,BENG 196,002,660916,Watson; John Thomas,9998,0,9999,1
1715645507413,BISP 197,001,650773,Wilhelm; James E.,9994,0,9999,5
1715645507413,BISP 197,002,658904,Coleman; Aaron B.,9998,0,9999,1
1715645508442,CAT 124RS,A01,519847,Geibel; William,0,0,20,20
1715645509467,CAT 125RS,A01,515971,Geibel; William,0,0,20,20
1715645510495,CLRE 250,A00,511389,Morris; Sheldon,9992,0,9999,7
1715645511522,CLRE 251,A00,507176,Mehta; Ravindra L.,9992,0,9999,7
1715645511522,CLRE 251,B00,511410,Mehta; Ravindra L.,9998,0,9999,1
1715645512549,CLRE 252,A00,507189,Cuomo; Raphael Eduardo,9994,0,9999,5
1715645513579,CLRE 253,A00,507199,Vaida; Florin,9994,0,9999,5
1715645513579,CLRE 253,B00,507202,Vaida; Florin,9999,0,9999,0
1715645514607,CLRE 259,A00,507211,Patel; Hemal,9996,0,9999,3
1715645515632,CLRE 260,A00,507221,Cuomo; Raphael Eduardo,9999,0,9999,0
1715645516662,CLRE 297,001,507242,Cuomo; Raphael Eduardo,9999,0,9999,0
1715645517689,COGS 197,001,638244,Voytek; Bradley Thomas,9997,0,9999,2
1715645518718,CSE 191,A00,516875,Minnes Kemp; Mor Mia,9991,0,9999,8
1715645519742,CSE 197,001,637388,Minnes Kemp; Mor Mia,9992,0,9999,7
1715645520770,CSS 201S,A01,494383,Mignozzetti; Umberto,35,0,35,0
1715645521795,CSS 202S,A01,494387,Mignozzetti; Umberto,35,0,35,0
1715645522820,DSC 197,001,628532,Eldridge; Justin Matthew,9995,0,9999,4
1715645523845,EAP 100,A00,516065,Staff,9799,0,9999,200
1715645524872,ECE 45,A01,507414,Staff,32,0,60,28
1715645526926,ECE 111,A01,507420,Staff,11,0,50,39
1715645527950,ECE 197,001,548057,Sievenpiper; Daniel F.,9991,0,9999,8
1715645528977,EDS 115,A00,507243,Choi; Bailey Miyeon,6,0,28,22
1715645530004,EDS 117,A01,494379,Staff,0,6,34,35
1715645531035,EDS 125,A00,507246,Hopkins; Megan Beth,7,0,30,23
1715645532063,EDS 128A,A01,507264,Fargason; Sharon Gayle,5,0,26,21
1715645533089,EDS 128B,A01,507293,Pappas; Elizabeth,9,0,30,21
1715645534114,EDS 139,A00,507294,Fargason; Sharon Gayle,9,0,30,21
1715645534114,EDS 139,B00,507313,Pappas; Elizabeth,9,0,30,21
1715645535143,EDS 201,A00,507315,Staff,10,0,30,20
1715645536174,EDS 203,A01,507317,Halter; Christopher P.,10,0,30,20
1715645537200,EDS 204R,A01,507319,Halter; Christopher P.,0,3,30,30
1715645537200,EDS 204R,B01,507331,Heinzman; Erica M.,14,0,30,16
1715645538226,EDS 206R,A00,507332,Staff,0,4,30,30
1715645538226,EDS 206R,B00,507343,Staff,15,0,30,15
1715645539253,EDS 250,A00,507344,Hemans; Patricia Ann Benitez,20,0,40,20
1715645540279,EDS 281,A00,507345,Daly; Alan J.,18,0,18,0
1715645541311,EDS 284,A00,507350,Daly; Alan J.,16,0,16,0
1715645542341,EDS 286,A00,507359,Fine; Sarah,18,0,18,0
1715645543370,EDS 289C,A01,507361,Daly; Alan J.,18,0,18,0
1715645544399,EDS 290,A00,507366,Hofstetter; Carolyn,15,0,15,0
1715645545433,LIGM 5A,A00,507421,Fischer-Grunski; Eva K,17,0,20,3
1715645546459,LIGM 5B,A00,507423,Fischer-Grunski; Eva K,19,0,20,1
1715645547486,LIGM 5C,A00,507425,Fischer-Grunski; Eva K,19,0,20,1
1715645548512,LIIT 5AS,A00,507427,Carnelos; Chiara,20,0,20,0
1715645549553,LIIT 5BS,A00,507430,Carnelos; Chiara,20,0,20,0
1715645550578,LIIT 5CS,A00,507432,Carnelos; Chiara,20,0,20,0
1715645551606,LISP 5A,A00,507541,Munoz Sanchez; Alicia,11,0,20,9
1715645552638,LISP 5B,A00,507671,Munoz Sanchez; Alicia,8,0,20,12
1715645553664,LISP 5C,A00,507696,Munoz Sanchez; Alicia,8,0,20,12
1715645554696,MAE 197,001,528363,Boechler; Nicholas Sebastia,9998,0,9999,1
1715645555728,MATH 197,001,523477,Kedlaya; Kiran S.,9994,0,9999,5
1715645555728,MATH 197,002,563811,Zhang; Danna,9994,0,9999,5
1715645555728,MATH 197,003,628552,Dumitriu; Ioana,9998,0,9999,1
1715645555728,MATH 197,004,660885,Floyd; Eric,9998,0,9999,1
1715645556752,MCWP 40R,A00,518780,Staff,1,0,20,19
1715645556752,MCWP 40R,B00,518781,Carter; Jennifer A,10,0,20,10
1715645556752,MCWP 40R,C00,518783,Smith; Haydee Marie,5,0,20,15
1715645557781,MCWP 50R,A00,518791,Redela; Pamela Morgan,0,1,20,20
1715645557781,MCWP 50R,B00,518792,Krone; Jarret,0,2,20,20
1715645557781,MCWP 50R,C00,518793,Staff,0,4,20,20
1715645557781,MCWP 50R,D00,518794,Morshed; Michael James,0,1,20,20
1715645557781,MCWP 50R,E00,518795,Carter; Andrea L,0,2,20,20
1715645557781,MCWP 50R,F00,518796,Miller; Elizabeth Deen,0,1,20,20
1715645557781,MCWP 50R,G00,518797,Guillen; Melinda,0,2,20,20
1715645558807,MMW 12R,A01,514034,Herbst; Matthew,0,2,16,16
1715645558807,MMW 12R,A02,514035,Herbst; Matthew,0,0,16,16
1715645559841,MMW 13R,A01,514037,Staff,0,5,16,16
1715645559841,MMW 13R,A02,514039,Staff,0,5,16,16
1715645559841,MMW 13R,A03,628519,Staff,0,4,16,16
1715645561899,SIO 295LS,A00,523233,Staff,10,0,30,20
1715645562925,SIO 295S,A00,523232,Staff,10,0,30,20
1715645563952,SIOC 290S,A01,637330,Merrifield; Mark A,21,0,30,9
1715645564977,SIOC 291S,A01,637333,Gabriel; Corey John,21,0,30,9
1715645566012,SOCI 117,A01,494376,Staff,0,5,5,5
1715645567044,WES 237B,A00,494380,Staff,10,0,20,10
1715645569140,AESE 279B,A00,494370,Wade; Jon P,0,0,33,33
1715645570175,AIP 97,001,660915,Van Den Einde; Yael Dahlia,9998,0,9999,1
1715645571203,AIP 197,001,627712,Vespa; Emanuel Ignacio,9995,0,9999,4
1715645571203,AIP 197,002,650778,Amir; On,9998,0,9999,1
1715645571203,AIP 197,003,650933,Avenancio-Leon; Carlos,9998,0,9999,1
1715645571203,AIP 197,004,658530,Heyman; Gail D.,9998,0,9999,1
1715645571203,AIP 197,005,658631,Neal; Sonya E,9998,0,9999,1
1715645571203,AIP 197,006,658671,Du; Songzi,9998,0,9999,1
1715645572232,ANAR 135S,A00,494369,Braswell; Geoffrey E.,0,0,0,0
1715645573268,BENG 196,001,628496,Engler; Adam J.,9998,0,9999,1
1715645573268,BENG 196,002,660916,Watson; John Thomas,9998,0,9999,1
1715645574294,BISP 197,001,650773,Wilhelm; James E.,9994,0,9999,5
1715645574294,BISP 197,002,658904,Coleman; Aaron B.,9998,0,9999,1
1715645575320,CAT 124RS,A01,519847,Geibel; William,0,0,20,20
1715645576345,CAT 125RS,A01,515971,Geibel; William,0,0,20,20
1715645577370,CLRE 250,A00,511389,Morris; Sheldon,9992,0,9999,7
1715645578397,CLRE 251,A00,507176,Mehta; Ravindra L.,9992,0,9999,7
1715645578397,CLRE 251,B00,511410,Mehta; Ravindra L.,9998,0,9999,1
1715645579425,CLRE 252,A00,507189,Cuomo; Raphael Eduardo,9994,0,9999,5
1715645580451,CLRE 253,A00,507199,Vaida; Florin,9994,0,9999,5
1715645580451,CLRE 253,B00,507202,Vaida; Florin,9999,0,9999,0
1715645581477,CLRE 259,A00,507211,Patel; Hemal,9996,0,9999,3
1715645582504,CLRE 260,A00,507221,Cuomo; Raphael Eduardo,9999,0,9999,0
1715645583539,CLRE 297,001,507242,Cuomo; Raphael Eduardo,9999,0,9999,0
1715645584565,COGS 197,001,638244,Voytek; Bradley Thomas,9997,0,9999,2
1715645585591,CSE 191,A00,516875,Minnes Kemp; Mor Mia,9991,0,9999,8
1715645586621,CSE 197,001,637388,Minnes Kemp; Mor Mia,9992,0,9999,7
1715645587647,CSS 201S,A01,494383,Mignozzetti; Umberto,35,0,35,0
1715645588674,CSS 202S,A01,494387,Mignozzetti; Umberto,35,0,35,0
1715645589701,DSC 197,001,628532,Eldridge; Justin Matthew,9995,0,9999,4
1715645590730,EAP 100,A00,516065,Staff,9799,0,9999,200
1715645591757,ECE 45,A01,507414,Staff,32,0,60,28
1715645593813,ECE 111,A01,507420,Staff,11,0,50,39
1715645594846,ECE 197,001,548057,Sievenpiper; Daniel F.,9991,0,9999,8
1715645595893,EDS 115,A00,507243,Choi; Bailey Miyeon,6,0,28,22
1715645596920,EDS 117,A01,494379,Staff,0,6,34,35
1715645597945,EDS 125,A00,507246,Hopkins; Megan Beth,7,0,30,23
1715645598971,EDS 128A,A01,507264,Fargason; Sharon Gayle,5,0,26,21
1715645599999,EDS 128B,A01,507293,Pappas; Elizabeth,9,0,30,21
1715645601024,EDS 139,A00,507294,Fargason; Sharon Gayle,9,0,30,21
1715645601024,EDS 139,B00,507313,Pappas; Elizabeth,9,0,30,21
1715645602054,EDS 201,A00,507315,Staff,10,0,30,20
1715645603086,EDS 203,A01,507317,Halter; Christopher P.,10,0,30,20
1715645604112,EDS 204R,A01,507319,Halter; Christopher P.,0,3,30,30
1715645604112,EDS 204R,B01,507331,Heinzman; Erica M.,14,0,30,16
1715645605139,EDS 206R,A00,507332,Staff,0,4,30,30
1715645605139,EDS 206R,B00,507343,Staff,15,0,30,15
1715645606168,EDS 250,A00,507344,Hemans; Patricia Ann Benitez,20,0,40,20
1715645607198,EDS 281,A00,507345,Daly; Alan J.,18,0,18,0
1715645608223,EDS 284,A00,507350,Daly; Alan J.,16,0,16,0
1715645609250,EDS 286,A00,507359,Fine; Sarah,18,0,18,0
1715645610277,EDS 289C,A01,507361,Daly; Alan J.,18,0,18,0
1715645611312,EDS 290,A00,507366,Hofstetter; Carolyn,15,0,15,0
1715645612347,LIGM 5A,A00,507421,Fischer-Grunski; Eva K,17,0,20,3
1715645613372,LIGM 5B,A00,507423,Fischer-Grunski; Eva K,19,0,20,1
1715645614399,LIGM 5C,A00,507425,Fischer-Grunski; Eva K,19,0,20,1
1715645615425,LIIT 5AS,A00,507427,Carnelos; Chiara,20,0,20,0
1715645616450,LIIT 5BS,A00,507430,Carnelos; Chiara,20,0,20,0
1715645617476,LIIT 5CS,A00,507432,Carnelos; Chiara,20,0,20,0
1715645618510,LISP 5A,A00,507541,Munoz Sanchez; Alicia,11,0,20,9
1715645619534,LISP 5B,A00,507671,Munoz Sanchez; Alicia,8,0,20,12
1715645620567,LISP 5C,A00,507696,Munoz Sanchez; Alicia,8,0,20,12
1715645621602,MAE 197,001,528363,Boechler; Nicholas Sebastia,9998,0,9999,1
1715645622630,MATH 197,001,523477,Kedlaya; Kiran S.,9994,0,9999,5
1715645622630,MATH 197,002,563811,Zhang; Danna,9994,0,9999,5
1715645622630,MATH 197,003,628552,Dumitriu; Ioana,9998,0,9999,1
1715645622630,MATH 197,004,660885,Floyd; Eric,9998,0,9999,1
1715645623657,MCWP 40R,A00,518780,Staff,1,0,20,19
1715645623657,MCWP 40R,B00,518781,Carter; Jennifer A,10,0,20,10
1715645623657,MCWP 40R,C00,518783,Smith; Haydee Marie,5,0,20,15
1715645624687,MCWP 50R,A00,518791,Redela; Pamela Morgan,0,1,20,20
1715645624687,MCWP 50R,B00,518792,Krone; Jarret,0,2,20,20
1715645624687,MCWP 50R,C00,518793,Staff,0,4,20,20
1715645624687,MCWP 50R,D00,518794,Morshed; Michael James,0,1,20,20
1715645624687,MCWP 50R,E00,518795,Carter; Andrea L,0,2,20,20
1715645624687,MCWP 50R,F00,518796,Miller; Elizabeth Deen,0,1,20,20
1715645624687,MCWP 50R,G00,518797,Guillen; Melinda,0,2,20,20
1715645625712,MMW 12R,A01,514034,Herbst; Matthew,0,2,16,16
1715645625712,MMW 12R,A02,514035,Herbst; Matthew,0,0,16,16
1715645626744,MMW 13R,A01,514037,Staff,0,5,16,16
1715645626744,MMW 13R,A02,514039,Staff,0,5,16,16
1715645626744,MMW 13R,A03,628519,Staff,0,4,16,16
1715645628797,SIO 295LS,A00,523233,Staff,10,0,30,20
1715645629821,SIO 295S,A00,523232,Staff,10,0,30,20
1715645630848,SIOC 290S,A01,637330,Merrifield; Mark A,21,0,30,9
1715645631879,SIOC 291S,A01,637333,Gabriel; Corey John,21,0,30,9
1715645632910,SOCI 117,A01,494376,Staff,0,5,5,5
1715645633937,WES 237B,A00,494380,Staff,10,0,20,10
1715645636028,AESE 279B,A00,494370,Wade; Jon P,0,0,33,33
1715645637058,AIP 97,001,660915,Van Den Einde; Yael Dahlia,9998,0,9999,1
1715645638090,AIP 197,001,627712,Vespa; Emanuel Ignacio,9995,0,9999,4
1715645638090,AIP 197,002,650778,Amir; On,9998,0,9999,1
1715645638090,AIP 197,003,650933,Avenancio-Leon; Carlos,9998,0,9999,1
1715645638090,AIP 197,004,658530,Heyman; Gail D.,9998,0,9999,1
1715645638090,AIP 197,005,658631,Neal; Sonya E,9998,0,9999,1
1715645638090,AIP 197,006,658671,Du; Songzi,9998,0,9999,1
1715645639115,ANAR 135S,A00,494369,Braswell; Geoffrey E.,0,0,0,0
1715645640141,BENG 196,001,628496,Engler; Adam J.,9998,0,9999,1
1715645640141,BENG 196,002,660916,Watson; John Thomas,9998,0,9999,1
1715645641166,BISP 197,001,650773,Wilhelm; James E.,9994,0,9999,5
1715645641166,BISP 197,002,658904,Coleman; Aaron B.,9998,0,9999,1
1715645642193,CAT 124RS,A01,519847,Geibel; William,0,0,20,20
1715645643221,CAT 125RS,A01,515971,Geibel; William,0,0,20,20
1715645644254,CLRE 250,A00,511389,Morris; Sheldon,9992,0,9999,7
1715645645289,CLRE 251,A00,507176,Mehta; Ravindra L.,9992,0,9999,7
1715645645289,CLRE 251,B00,511410,Mehta; Ravindra L.,9998,0,9999,1
1715645646315,CLRE 252,A00,507189,Cuomo; Raphael Eduardo,9994,0,9999,5
1715645647341,CLRE 253,A00,507199,Vaida; Florin,9994,0,9999,5
1715645647341,CLRE 253,B00,507202,Vaida; Florin,9999,0,9999,0
1715645648368,CLRE 259,A00,507211,Patel; Hemal,9996,0,9999,3
1715645649395,CLRE 260,A00,507221,Cuomo; Raphael Eduardo,9999,0,9999,0
1715645650419,CLRE 297,001,507242,Cuomo; Raphael Eduardo,9999,0,9999,0
1715645651446,COGS 197,001,638244,Voytek; Bradley Thomas,9997,0,9999,2
1715645652470,CSE 191,A00,516875,Minnes Kemp; Mor Mia,9991,0,9999,8
1715645653501,CSE 197,001,637388,Minnes Kemp; Mor Mia,9992,0,9999,7
1715645654528,CSS 201S,A01,494383,Mignozzetti; Umberto,35,0,35,0
1715645655554,CSS 202S,A01,494387,Mignozzetti; Umberto,35,0,35,0
1715645656580,DSC 197,001,628532,Eldridge; Justin Matthew,9995,0,9999,4
1715645657605,EAP 100,A00,516065,Staff,9799,0,9999,200
1715645658633,ECE 45,A01,507414,Staff,32,0,60,28
1715645660684,ECE 111,A01,507420,Staff,11,0,50,39
1715645661714,ECE 197,001,548057,Sievenpiper; Daniel F.,9991,0,9999,8
1715645662740,EDS 115,A00,507243,Choi; Bailey Miyeon,6,0,28,22
1715645663771,EDS 117,A01,494379,Staff,0,6,34,35
1715645664798,EDS 125,A00,507246,Hopkins; Megan Beth,7,0,30,23
1715645665830,EDS 128A,A01,507264,Fargason; Sharon Gayle,5,0,26,21
1715645666983,EDS 128B,A01,507293,Pappas; Elizabeth,9,0,30,21
1715645668012,EDS 139,A00,507294,Fargason; Sharon Gayle,9,0,30,21
1715645668012,EDS 139,B00,507313,Pappas; Elizabeth,9,0,30,21
1715645669039,EDS 201,A00,507315,Staff,10,0,30,20
1715645670069,EDS 203,A01,507317,Halter; Christopher P.,10,0,30,20
1715645671094,EDS 204R,A01,507319,Halter; Christopher P.,0,3,30,30
1715645671094,EDS 204R,B01,507331,Heinzman; Erica M.,14,0,30,16
1715645672121,EDS 206R,A00,507332,Staff,0,4,30,30
1715645672121,EDS 206R,B00,507343,Staff,15,0,30,15
1715645673147,EDS 250,A00,507344,Hemans; Patricia Ann Benitez,20,0,40,20
1715645674172,EDS 281,A00,507345,Daly; Alan J.,18,0,18,0
1715645675198,EDS 284,A00,507350,Daly; Alan J.,16,0,16,0
1715645676229,EDS 286,A00,507359,Fine; Sarah,18,0,18,0
1715645677256,EDS 289C,A01,507361,Daly; Alan J.,18,0,18,0
1715645678284,EDS 290,A00,507366,Hofstetter; Carolyn,15,0,15,0
1715645679311,LIGM 5A,A00,507421,Fischer-Grunski; Eva K,17,0,20,3
1715645680338,LIGM 5B,A00,507423,Fischer-Grunski; Eva K,19,0,20,1
1715645681363,LIGM 5C,A00,507425,Fischer-Grunski; Eva K,19,0,20,1
1715645682397,LIIT 5AS,A00,507427,Carnelos; Chiara,20,0,20,0
1715645683422,LIIT 5BS,A00,507430,Carnelos; Chiara,20,0,20,0
1715645684451,LIIT 5CS,A00,507432,Carnelos; Chiara,20,0,20,0
1715645685484,LISP 5A,A00,507541,Munoz Sanchez; Alicia,11,0,20,9
1715645686514,LISP 5B,A00,507671,Munoz Sanchez; Alicia,8,0,20,12
1715645687539,LISP 5C,A00,507696,Munoz Sanchez; Alicia,8,0,20,12
1715645688565,MAE 197,001,528363,Boechler; Nicholas Sebastia,9998,0,9999,1
1715645689603,MATH 197,001,523477,Kedlaya; Kiran S.,9994,0,9999,5
1715645689603,MATH 197,002,563811,Zhang; Danna,9994,0,9999,5
1715645689603,MATH 197,003,628552,Dumitriu; Ioana,9998,0,9999,1
1715645689603,MATH 197,004,660885,Floyd; Eric,9998,0,9999,1
1715645690638,MCWP 40R,A00,518780,Staff,1,0,20,19
1715645690638,MCWP 40R,B00,518781,Carter; Jennifer A,10,0,20,10
1715645690638,MCWP 40R,C00,518783,Smith; Haydee Marie,5,0,20,15
1715645691675,MCWP 50R,A00,518791,Redela; Pamela Morgan,0,1,20,20
1715645691675,MCWP 50R,B00,518792,Krone; Jarret,0,2,20,20
1715645691675,MCWP 50R,C00,518793,Staff,0,4,20,20
1715645691675,MCWP 50R,D00,518794,Morshed; Michael James,0,2,20,20
1715645691675,MCWP 50R,E00,518795,Carter; Andrea L,0,2,20,20
1715645691675,MCWP 50R,F00,518796,Miller; Elizabeth Deen,0,1,20,20
1715645691675,MCWP 50R,G00,518797,Guillen; Melinda,0,1,20,20
1715645692704,MMW 12R,A01,514034,Herbst; Matthew,0,2,16,16
1715645692704,MMW 12R,A02,514035,Herbst; Matthew,0,0,16,16
1715645693735,MMW 13R,A01,514037,Staff,0,5,16,16
1715645693735,MMW 13R,A02,514039,Staff,0,5,16,16
1715645693735,MMW 13R,A03,628519,Staff,0,4,16,16
1715645695783,SIO 295LS,A00,523233,Staff,10,0,30,20
1715645696808,SIO 295S,A00,523232,Staff,10,0,30,20
1715645697834,SIOC 290S,A01,637330,Merrifield; Mark A,21,0,30,9
1715645698858,SIOC 291S,A01,637333,Gabriel; Corey John,21,0,30,9
1715645699883,SOCI 117,A01,494376,Staff,0,5,5,5
1715645700913,WES 237B,A00,494380,Staff,10,0,20,10
1715645702978,AESE 279B,A00,494370,Wade; Jon P,0,0,33,33
1715645704007,AIP 97,001,660915,Van Den Einde; Yael Dahlia,9998,0,9999,1
1715645705033,AIP 197,001,627712,Vespa; Emanuel Ignacio,9995,0,9999,4
1715645705033,AIP 197,002,650778,Amir; On,9998,0,9999,1
1715645705033,AIP 197,003,650933,Avenancio-Leon; Carlos,9998,0,9999,1
1715645705033,AIP 197,004,658530,Heyman; Gail D.,9998,0,9999,1
1715645705033,AIP 197,005,658631,Neal; Sonya E,9998,0,9999,1
1715645705033,AIP 197,006,658671,Du; Songzi,9998,0,9999,1
1715645706062,ANAR 135S,A00,494369,Braswell; Geoffrey E.,0,0,0,0
1715645707087,BENG 196,001,628496,Engler; Adam J.,9998,0,9999,1
1715645707087,BENG 196,002,660916,Watson; John Thomas,9998,0,9999,1
1715645708112,BISP 197,001,650773,Wilhelm; James E.,9994,0,9999,5
1715645708112,BISP 197,002,658904,Coleman; Aaron B.,9998,0,9999,1
1715645709139,CAT 124RS,A01,519847,Geibel; William,0,0,20,20
1715645710165,CAT 125RS,A01,515971,Geibel; William,0,0,20,20
1715645711194,CLRE 250,A00,511389,Morris; Sheldon,9992,0,9999,7
1715645712219,CLRE 251,A00,507176,Mehta; Ravindra L.,9992,0,9999,7
1715645712219,CLRE 251,B00,511410,Mehta; Ravindra L.,9998,0,9999,1
1715645713244,CLRE 252,A00,507189,Cuomo; Raphael Eduardo,9994,0,9999,5
1715645714274,CLRE 253,A00,507199,Vaida; Florin,9994,0,9999,5
1715645714274,CLRE 253,B00,507202,Vaida; Florin,9999,0,9999,0
1715645715300,CLRE 259,A00,507211,Patel; Hemal,9996,0,9999,3
1715645716382,CLRE 260,A00,507221,Cuomo; Raphael Eduardo,9999,0,9999,0
1715645717409,CLRE 297,001,507242,Cuomo; Raphael Eduardo,9999,0,9999,0
1715645718437,COGS 197,001,638244,Voytek; Bradley Thomas,9997,0,9999,2
1715645719467,CSE 191,A00,516875,Minnes Kemp; Mor Mia,9991,0,9999,8
1715645720491,CSE 197,001,637388,Minnes Kemp; Mor Mia,9992,0,9999,7
1715645721521,CSS 201S,A01,494383,Mignozzetti; Umberto,35,0,35,0
1715645722547,CSS 202S,A01,494387,Mignozzetti; Umberto,35,0,35,0
1715645723577,DSC 197,001,628532,Eldridge; Justin Matthew,9995,0,9999,4
1715645724606,EAP 100,A00,516065,Staff,9799,0,9999,200
1715645725633,ECE 45,A01,507414,Staff,32,0,60,28
1715645727686,ECE 111,A01,507420,Staff,11,0,50,39
1715645728710,ECE 197,001,548057,Sievenpiper; Daniel F.,9991,0,9999,8
1715645729856,EDS 115,A00,507243,Choi; Bailey Miyeon,6,0,28,22
1715645730887,EDS 117,A01,494379,Staff,0,6,34,35
1715645731912,EDS 125,A00,507246,Hopkins; Megan Beth,7,0,30,23
1715645732940,EDS 128A,A01,507264,Fargason; Sharon Gayle,5,0,26,21
1715645733971,EDS 128B,A01,507293,Pappas; Elizabeth,9,0,30,21
1715645734999,EDS 139,A00,507294,Fargason; Sharon Gayle,9,0,30,21
1715645734999,EDS 139,B00,507313,Pappas; Elizabeth,9,0,30,21
1715645736023,EDS 201,A00,507315,Staff,10,0,30,20
1715645737049,EDS 203,A01,507317,Halter; Christopher P.,10,0,30,20
1715645738076,EDS 204R,A01,507319,Halter; Christopher P.,0,3,30,30
1715645738076,EDS 204R,B01,507331,Heinzman; Erica M.,14,0,30,16
1715645739104,EDS 206R,A00,507332,Staff,0,4,30,30
1715645739104,EDS 206R,B00,507343,Staff,15,0,30,15
1715645740135,EDS 250,A00,507344,Hemans; Patricia Ann Benitez,20,0,40,20
1715645741159,EDS 281,A00,507345,Daly; Alan J.,18,0,18,0
1715645742187,EDS 284,A00,507350,Daly; Alan J.,16,0,16,0
1715645743212,EDS 286,A00,507359,Fine; Sarah,18,0,18,0
1715645744238,EDS 289C,A01,507361,Daly; Alan J.,18,0,18,0
1715645745268,EDS 290,A00,507366,Hofstetter; Carolyn,15,0,15,0
1715645746293,LIGM 5A,A00,507421,Fischer-Grunski; Eva K,17,0,20,3
1715645747319,LIGM 5B,A00,507423,Fischer-Grunski; Eva K,19,0,20,1
1715645748343,LIGM 5C,A00,507425,Fischer-Grunski; Eva K,19,0,20,1
1715645749377,LIIT 5AS,A00,507427,Carnelos; Chiara,20,0,20,0
1715645750406,LIIT 5BS,A00,507430,Carnelos; Chiara,20,0,20,0
1715645751432,LIIT 5CS,A00,507432,Carnelos; Chiara,20,0,20,0
1715645752465,LISP 5A,A00,507541,Munoz Sanchez; Alicia,11,0,20,9
1715645753491,LISP 5B,A00,507671,Munoz Sanchez; Alicia,8,0,20,12
1715645754517,LISP 5C,A00,507696,Munoz Sanchez; Alicia,8,0,20,12
1715645755544,MAE 197,001,528363,Boechler; Nicholas Sebastia,9998,0,9999,1
1715645756572,MATH 197,001,523477,Kedlaya; Kiran S.,9994,0,9999,5
1715645756572,MATH 197,002,563811,Zhang; Danna,9994,0,9999,5
1715645756572,MATH 197,003,628552,Dumitriu; Ioana,9998,0,9999,1
1715645756572,MATH 197,004,660885,Floyd; Eric,9998,0,9999,1
1715645757600,MCWP 40R,A00,518780,Staff,1,0,20,19
1715645757600,MCWP 40R,B00,518781,Carter; Jennifer A,10,0,20,10
1715645757600,MCWP 40R,C00,518783,Smith; Haydee Marie,5,0,20,15
1715645758638,MCWP 50R,A00,518791,Redela; Pamela Morgan,0,1,20,20
1715645758638,MCWP 50R,B00,518792,Krone; Jarret,0,2,20,20
1715645758638,MCWP 50R,C00,518793,Staff,0,4,20,20
1715645758638,MCWP 50R,D00,518794,Morshed; Michael James,0,2,20,20
1715645758638,MCWP 50R,E00,518795,Carter; Andrea L,0,2,20,20
1715645758638,MCWP 50R,F00,518796,Miller; Elizabeth Deen,0,1,20,20
1715645758638,MCWP 50R,G00,518797,Guillen; Melinda,0,1,20,20
1715645759670,MMW 12R,A01,514034,Herbst; Matthew,0,2,16,16
1715645759670,MMW 12R,A02,514035,Herbst; Matthew,0,0,16,16
1715645760705,MMW 13R,A01,514037,Staff,0,5,16,16
1715645760705,MMW 13R,A02,514039,Staff,0,5,16,16
1715645760705,MMW 13R,A03,628519,Staff,0,4,16,16
1715645762760,SIO 295LS,A00,523233,Staff,10,0,30,20
1715645763785,SIO 295S,A00,523232,Staff,10,0,30,20
1715645764812,SIOC 290S,A01,637330,Merrifield; Mark A,21,0,30,9
1715645765837,SIOC 291S,A01,637333,Gabriel; Corey John,21,0,30,9
1715645766865,SOCI 117,A01,494376,Staff,0,5,5,5
1715645767892,WES 237B,A00,494380,Staff,10,0,20,10
1715645769963,AESE 279B,A00,494370,Wade; Jon P,0,0,33,33
1715645770992,AIP 97,001,660915,Van Den Einde; Yael Dahlia,9998,0,9999,1
1715645772021,AIP 197,001,627712,Vespa; Emanuel Ignacio,9995,0,9999,4
1715645772021,AIP 197,002,650778,Amir; On,9998,0,9999,1
1715645772021,AIP 197,003,650933,Avenancio-Leon; Carlos,9998,0,9999,1
1715645772021,AIP 197,004,658530,Heyman; Gail D.,9998,0,9999,1
1715645772021,AIP 197,005,658631,Neal; Sonya E,9998,0,9999,1
1715645772021,AIP 197,006,658671,Du; Songzi,9998,0,9999,1
1715645773047,ANAR 135S,A00,494369,Braswell; Geoffrey E.,0,0,0,0
1715645774078,BENG 196,001,628496,Engler; Adam J.,9998,0,9999,1
1715645774078,BENG 196,002,660916,Watson; John Thomas,9998,0,9999,1
1715645775105,BISP 197,001,650773,Wilhelm; James E.,9994,0,9999,5
1715645775105,BISP 197,002,658904,Coleman; Aaron B.,9998,0,9999,1
1715645776131,CAT 124RS,A01,519847,Geibel; William,0,0,20,20
1715645777156,CAT 125RS,A01,515971,Geibel; William,0,0,20,20
1715645778185,CLRE 250,A00,511389,Morris; Sheldon,9992,0,9999,7
1715645779212,CLRE 251,A00,507176,Mehta; Ravindra L.,9992,0,9999,7
1715645779212,CLRE 251,B00,511410,Mehta; Ravindra L.,9998,0,9999,1
1715645780239,CLRE 252,A00,507189,Cuomo; Raphael Eduardo,9994,0,9999,5
1715645781270,CLRE 253,A00,507199,Vaida; Florin,9994,0,9999,5
1715645781270,CLRE 253,B00,507202,Vaida; Florin,9999,0,9999,0
1715645782296,CLRE 259,A00,507211,Patel; Hemal,9996,0,9999,3
1715645783321,CLRE 260,A00,507221,Cuomo; Raphael Eduardo,9999,0,9999,0
1715645784347,CLRE 297,001,507242,Cuomo; Raphael Eduardo,9999,0,9999,0
1715645785372,COGS 197,001,638244,Voytek; Bradley Thomas,9997,0,9999,2
1715645786401,CSE 191,A00,516875,Minnes Kemp; Mor Mia,9991,0,9999,8
1715645787426,CSE 197,001,637388,Minnes Kemp; Mor Mia,9992,0,9999,7
1715645788486,CSS 201S,A01,494383,Mignozzetti; Umberto,35,0,35,0
1715645789514,CSS 202S,A01,494387,Mignozzetti; Umberto,35,0,35,0
1715645790540,DSC 197,001,628532,Eldridge; Justin Matthew,9995,0,9999,4
1715645791566,EAP 100,A00,516065,Staff,9799,0,9999,200
1715645792597,ECE 45,A01,507414,Staff,32,0,60,28
1715645794649,ECE 111,A01,507420,Staff,11,0,50,39
1715645795676,ECE 197,001,548057,Sievenpiper; Daniel F.,9991,0,9999,8
1715645796702,EDS 115,A00,507243,Choi; Bailey Miyeon,6,0,28,22
1715645797730,EDS 117,A01,494379,Staff,0,6,34,35
1715645798758,EDS 125,A00,507246,Hopkins; Megan Beth,7,0,30,23
1715645799785,EDS 128A,A01,507264,Fargason; Sharon Gayle,5,0,26,21
1715645800812,EDS 128B,A01,507293,Pappas; Elizabeth,9,0,30,21
1715645801839,EDS 139,A00,507294,Fargason; Sharon Gayle,9,0,30,21
1715645801839,EDS 139,B00,507313,Pappas; Elizabeth,9,0,30,21
1715645802868,EDS 201,A00,507315,Staff,10,0,30,20
1715645803898,EDS 203,A01,507317,Halter; Christopher P.,10,0,30,20
1715645804923,EDS 204R,A01,507319,Halter; Christopher P.,0,3,30,30
1715645804923,EDS 204R,B01,507331,Heinzman; Erica M.,14,0,30,16
1715645805952,EDS 206R,A00,507332,Staff,0,4,30,30
1715645805952,EDS 206R,B00,507343,Staff,15,0,30,15
1715645806978,EDS 250,A00,507344,Hemans; Patricia Ann Benitez,20,0,40,20
1715645808006,EDS 281,A00,507345,Daly; Alan J.,18,0,18,0
1715645809034,EDS 284,A00,507350,Daly; Alan J.,16,0,16,0
1715645810061,EDS 286,A00,507359,Fine; Sarah,18,0,18,0
1715645811088,EDS 289C,A01,507361,Daly; Alan J.,18,0,18,0
1715645812117,EDS 290,A00,507366,Hofstetter; Carolyn,15,0,15,0
1715645813342,LIGM 5A,A00,507421,Fischer-Grunski; Eva K,17,0,20,3
1715645814368,LIGM 5B,A00,507423,Fischer-Grunski; Eva K,19,0,20,1
1715645815393,LIGM 5C,A00,507425,Fischer-Grunski; Eva K,19,0,20,1
1715645816419,LIIT 5AS,A00,507427,Carnelos; Chiara,20,0,20,0
1715645817447,LIIT 5BS,A00,507430,Carnelos; Chiara,20,0,20,0
1715645818472,LIIT 5CS,A00,507432,Carnelos; Chiara,20,0,20,0
1715645819499,LISP 5A,A00,507541,Munoz Sanchez; Alicia,11,0,20,9
1715645820526,LISP 5B,A00,507671,Munoz Sanchez; Alicia,8,0,20,12
1715645821551,LISP 5C,A00,507696,Munoz Sanchez; Alicia,8,0,20,12
1715645822578,MAE 197,001,528363,Boechler; Nicholas Sebastia,9998,0,9999,1
1715645823665,MATH 197,001,523477,Kedlaya; Kiran S.,9994,0,9999,5
1715645823665,MATH 197,002,563811,Zhang; Danna,9994,0,9999,5
1715645823665,MATH 197,003,628552,Dumitriu; Ioana,9998,0,9999,1
1715645823665,MATH 197,004,660885,Floyd; Eric,9998,0,9999,1
1715645824690,MCWP 40R,A00,518780,Staff,1,0,20,19
1715645824690,MCWP 40R,B00,518781,Carter; Jennifer A,10,0,20,10
1715645824690,MCWP 40R,C00,518783,Smith; Haydee Marie,5,0,20,15
1715645825723,MCWP 50R,A00,518791,Redela; Pamela Morgan,0,1,20,20
1715645825723,MCWP 50R,B00,518792,Krone; Jarret,0,2,20,20
1715645825723,MCWP 50R,C00,518793,Staff,0,4,20,20
1715645825723,MCWP 50R,D00,518794,Morshed; Michael James,0,2,20,20
1715645825723,MCWP 50R,E00,518795,Carter; Andrea L,0,2,20,20
1715645825723,MCWP 50R,F00,518796,Miller; Elizabeth Deen,0,1,20,20
1715645825723,MCWP 50R,G00,518797,Guillen; Melinda,0,1,20,20
1715645826749,MMW 12R,A01,514034,Herbst; Matthew,0,2,16,16
1715645826749,MMW 12R,A02,514035,Herbst; Matthew,0,0,16,16
1715645827774,MMW 13R,A01,514037,Staff,0,5,16,16
1715645827774,MMW 13R,A02,514039,Staff,0,5,16,16
1715645827774,MMW 13R,A03,628519,Staff,0,4,16,16
1715645829825,SIO 295LS,A00,523233,Staff,10,0,30,20
1715645830852,SIO 295S,A00,523232,Staff,10,0,30,20
1715645831878,SIOC 290S,A01,637330,Merrifield; Mark A,21,0,30,9
1715645832906,SIOC 291S,A01,637333,Gabriel; Corey John,21,0,30,9
1715645833930,SOCI 117,A01,494376,Staff,0,5,5,5
1715645834956,WES 237B,A00,494380,Staff,10,0,20,10
1715645837032,AESE 279B,A00,494370,Wade; Jon P,0,0,33,33
1715645838059,AIP 97,001,660915,Van Den Einde; Yael Dahlia,9998,0,9999,1
1715645839088,AIP 197,001,627712,Vespa; Emanuel Ignacio,9995,0,9999,4
1715645839088,AIP 197,002,650778,Amir; On,9998,0,9999,1
1715645839088,AIP 197,003,650933,Avenancio-Leon; Carlos,9998,0,9999,1
1715645839088,AIP 197,004,658530,Heyman; Gail D.,9998,0,9999,1
1715645839088,AIP 197,005,658631,Neal; Sonya E,9998,0,9999,1
1715645839088,AIP 197,006,658671,Du; Songzi,9998,0,9999,1
1715645840115,ANAR 135S,A00,494369,Braswell; Geoffrey E.,0,0,0,0
1715645841144,BENG 196,001,628496,Engler; Adam J.,9998,0,9999,1
1715645841144,BENG 196,002,660916,Watson; John Thomas,9998,0,9999,1
1715645842181,BISP 197,001,650773,Wilhelm; James E.,9994,0,9999,5
1715645842181,BISP 197,002,658904,Coleman; Aaron B.,9998,0,9999,1
1715645843208,CAT 124RS,A01,519847,Geibel; William,0,0,20,20
1715645844236,CAT 125RS,A01,515971,Geibel; William,0,0,20,20
1715645845267,CLRE 250,A00,511389,Morris; Sheldon,9992,0,9999,7
1715645846300,CLRE 251,A00,507176,Mehta; Ravindra L.,9992,0,9999,7
1715645846300,CLRE 251,B00,511410,Mehta; Ravindra L.,9998,0,9999,1
1715645847329,CLRE 252,A00,507189,Cuomo; Raphael Eduardo,9994,0,9999,5
1715645848355,CLRE 253,A00,507199,Vaida; Florin,9994,0,9999,5
1715645848355,CLRE 253,B00,507202,Vaida; Florin,9999,0,9999,0
1715645849385,CLRE 259,A00,507211,Patel; Hemal,9996,0,9999,3
1715645850413,CLRE 260,A00,507221,Cuomo; Raphael Eduardo,9999,0,9999,0
1715645851440,CLRE 297,001,507242,Cuomo; Raphael Eduardo,9999,0,9999,0
1715645852465,COGS 197,001,638244,Voytek; Bradley Thomas,9997,0,9999,2
1715645853496,CSE 191,A00,516875,Minnes Kemp; Mor Mia,9991,0,9999,8
1715645854522,CSE 197,001,637388,Minnes Kemp; Mor Mia,9992,0,9999,7
1715645855549,CSS 201S,A01,494383,Mignozzetti; Umberto,35,0,35,0
1715645856573,CSS 202S,A01,494387,Mignozzetti; Umberto,35,0,35,0
1715645857598,DSC 197,001,628532,Eldridge; Justin Matthew,9995,0,9999,4
1715645858625,EAP 100,A00,516065,Staff,9799,0,9999,200
1715645859656,ECE 45,A01,507414,Staff,32,0,60,28
1715645861762,ECE 111,A01,507420,Staff,11,0,50,39
1715645862790,ECE 197,001,548057,Sievenpiper; Daniel F.,9991,0,9999,8
1715645863820,EDS 115,A00,507243,Choi; Bailey Miyeon,6,0,28,22
1715645864849,EDS 117,A01,494379,Staff,0,6,34,35
1715645865875,EDS 125,A00,507246,Hopkins; Megan Beth,7,0,30,23
1715645866900,EDS 128A,A01,507264,Fargason; Sharon Gayle,5,0,26,21
1715645867930,EDS 128B,A01,507293,Pappas; Elizabeth,9,0,30,21
1715645868954,EDS 139,A00,507294,Fargason; Sharon Gayle,9,0,30,21
1715645868954,EDS 139,B00,507313,Pappas; Elizabeth,9,0,30,21
1715645869979,EDS 201,A00,507315,Staff,10,0,30,20
1715645871005,EDS 203,A01,507317,Halter; Christopher P.,10,0,30,20
1715645872031,EDS 204R,A01,507319,Halter; Christopher P.,0,3,30,30
1715645872031,EDS 204R,B01,507331,Heinzman; Erica M.,14,0,30,16
1715645873058,EDS 206R,A00,507332,Staff,0,4,30,30
1715645873058,EDS 206R,B00,507343,Staff,15,0,30,15
1715645874083,EDS 250,A00,507344,Hemans; Patricia Ann Benitez,20,0,40,20
1715645875652,EDS 281,A00,507345,Daly; Alan J.,18,0,18,0
1715645876713,EDS 284,A00,507350,Daly; Alan J.,16,0,16,0
1715645877739,EDS 286,A00,507359,Fine; Sarah,18,0,18,0
1715645878764,EDS 289C,A01,507361,Daly; Alan J.,18,0,18,0
1715645879792,EDS 290,A00,507366,Hofstetter; Carolyn,15,0,15,0
1715645880819,LIGM 5A,A00,507421,Fischer-Grunski; Eva K,17,0,20,3
1715645881845,LIGM 5B,A00,507423,Fischer-Grunski; Eva K,19,0,20,1
1715645882873,LIGM 5C,A00,507425,Fischer-Grunski; Eva K,19,0,20,1
1715645883901,LIIT 5AS,A00,507427,Carnelos; Chiara,20,0,20,0
1715645884927,LIIT 5BS,A00,507430,Carnelos; Chiara,20,0,20,0
1715645885955,LIIT 5CS,A00,507432,Carnelos; Chiara,20,0,20,0
1715645886982,LISP 5A,A00,507541,Munoz Sanchez; Alicia,11,0,20,9
1715645888008,LISP 5B,A00,507671,Munoz Sanchez; Alicia,8,0,20,12
1715645889036,LISP 5C,A00,507696,Munoz Sanchez; Alicia,8,0,20,12
1715645890064,MAE 197,001,528363,Boechler; Nicholas Sebastia,9998,0,9999,1
1715645891093,MATH 197,001,523477,Kedlaya; Kiran S.,9994,0,9999,5
1715645891093,MATH 197,002,563811,Zhang; Danna,9994,0,9999,5
1715645891093,MATH 197,003,628552,Dumitriu; Ioana,9998,0,9999,1
1715645891093,MATH 197,004,660885,Floyd; Eric,9998,0,9999,1
1715645892119,MCWP 40R,A00,518780,Staff,1,0,20,19
1715645892119,MCWP 40R,B00,518781,Carter; Jennifer A,10,0,20,10
1715645892119,MCWP 40R,C00,518783,Smith; Haydee Marie,5,0,20,15
1715645893147,MCWP 50R,A00,518791,Redela; Pamela Morgan,0,1,20,20
1715645893147,MCWP 50R,B00,518792,Krone; Jarret,0,2,20,20
1715645893147,MCWP 50R,C00,518793,Staff,0,4,20,20
1715645893147,MCWP 50R,D00,518794,Morshed; Michael James,0,2,20,20
1715645893147,MCWP 50R,E00,518795,Carter; Andrea L,0,2,20,20
1715645893147,MCWP 50R,F00,518796,Miller; Elizabeth Deen,0,1,20,20
1715645893147,MCWP 50R,G00,518797,Guillen; Melinda,0,1,20,20
1715645894176,MMW 12R,A01,514034,Herbst; Matthew,0,2,16,16
1715645894176,MMW 12R,A02,514035,Herbst; Matthew,0,0,16,16
1715645895201,MMW 13R,A01,514037,Staff,0,5,16,16
1715645895201,MMW 13R,A02,514039,Staff,0,5,16,16
1715645895201,MMW 13R,A03,628519,Staff,0,4,16,16
1715645897255,SIO 295LS,A00,523233,Staff,10,0,30,20
1715645898284,SIO 295S,A00,523232,Staff,10,0,30,20
1715645899317,SIOC 290S,A01,637330,Merrifield; Mark A,21,0,30,9
1715645900343,SIOC 291S,A01,637333,Gabriel; Corey John,21,0,30,9
1715645901368,SOCI 117,A01,494376,Staff,0,5,5,5
1715645902393,WES 237B,A00,494380,Staff,10,0,20,10
1715645904455,AESE 279B,A00,494370,Wade; Jon P,0,0,33,33
1715645905480,AIP 97,001,660915,Van Den Einde; Yael Dahlia,9998,0,9999,1
1715645906512,AIP 197,001,627712,Vespa; Emanuel Ignacio,9995,0,9999,4
1715645906512,AIP 197,002,650778,Amir; On,9998,0,9999,1
1715645906512,AIP 197,003,650933,Avenancio-Leon; Carlos,9998,0,9999,1
1715645906512,AIP 197,004,658530,Heyman; Gail D.,9998,0,9999,1
1715645906512,AIP 197,005,658631,Neal; Sonya E,9998,0,9999,1
1715645906512,AIP 197,006,658671,Du; Songzi,9998,0,9999,1
1715645907536,ANAR 135S,A00,494369,Braswell; Geoffrey E.,0,0,0,0
1715645908563,BENG 196,001,628496,Engler; Adam J.,9998,0,9999,1
1715645908563,BENG 196,002,660916,Watson; John Thomas,9998,0,9999,1
1715645909588,BISP 197,001,650773,Wilhelm; James E.,9994,0,9999,5
1715645909588,BISP 197,002,658904,Coleman; Aaron B.,9998,0,9999,1
1715645910619,CAT 124RS,A01,519847,Geibel; William,0,0,20,20
1715645911647,CAT 125RS,A01,515971,Geibel; William,0,0,20,20
1715645912675,CLRE 250,A00,511389,Morris; Sheldon,9992,0,9999,7
1715645913701,CLRE 251,A00,507176,Mehta; Ravindra L.,9992,0,9999,7
1715645913701,CLRE 251,B00,511410,Mehta; Ravindra L.,9998,0,9999,1
1715645914728,CLRE 252,A00,507189,Cuomo; Raphael Eduardo,9994,0,9999,5
1715645915752,CLRE 253,A00,507199,Vaida; Florin,9994,0,9999,5
1715645915752,CLRE 253,B00,507202,Vaida; Florin,9999,0,9999,0
1715645916780,CLRE 259,A00,507211,Patel; Hemal,9996,0,9999,3
1715645917806,CLRE 260,A00,507221,Cuomo; Raphael Eduardo,9999,0,9999,0
1715645918832,CLRE 297,001,507242,Cuomo; Raphael Eduardo,9999,0,9999,0
1715645919860,COGS 197,001,638244,Voytek; Bradley Thomas,9997,0,9999,2
1715645920885,CSE 191,A00,516875,Minnes Kemp; Mor Mia,9991,0,9999,8
1715645921911,CSE 197,001,637388,Minnes Kemp; Mor Mia,9992,0,9999,7
1715645922936,CSS 201S,A01,494383,Mignozzetti; Umberto,35,0,35,0
1715645923960,CSS 202S,A01,494387,Mignozzetti; Umberto,35,0,35,0
1715645924986,DSC 197,001,628532,Eldridge; Justin Matthew,9995,0,9999,4
1715645926016,EAP 100,A00,516065,Staff,9799,0,9999,200
1715645927047,ECE 45,A01,507414,Staff,32,0,60,28
1715645929119,ECE 111,A01,507420,Staff,11,0,50,39
1715645930145,ECE 197,001,548057,Sievenpiper; Daniel F.,9991,0,9999,8
1715645931170,EDS 115,A00,507243,Choi; Bailey Miyeon,6,0,28,22
1715645932212,EDS 117,A01,494379,Staff,0,6,34,35
1715645933239,EDS 125,A00,507246,Hopkins; Megan Beth,7,0,30,23
1715645934268,EDS 128A,A01,507264,Fargason; Sharon Gayle,5,0,26,21
1715645935297,EDS 128B,A01,507293,Pappas; Elizabeth,9,0,30,21
1715645936321,EDS 139,A00,507294,Fargason; Sharon Gayle,9,0,30,21
1715645936321,EDS 139,B00,507313,Pappas; Elizabeth,9,0,30,21
1715645937349,EDS 201,A00,507315,Staff,10,0,30,20
1715645938378,EDS 203,A01,507317,Halter; Christopher P.,10,0,30,20
1715645939404,EDS 204R,A01,507319,Halter; Christopher P.,0,3,30,30
1715645939404,EDS 204R,B01,507331,Heinzman; Erica M.,14,0,30,16
1715645940430,EDS 206R,A00,507332,Staff,0,4,30,30
1715645940430,EDS 206R,B00,507343,Staff,15,0,30,15
1715645941458,EDS 250,A00,507344,Hemans; Patricia Ann Benitez,20,0,40,20
1715645942486,EDS 281,A00,507345,Daly; Alan J.,18,0,18,0
1715645943511,EDS 284,A00,507350,Daly; Alan J.,16,0,16,0
1715645944547,EDS 286,A00,507359,Fine; Sarah,18,0,18,0
1715645945572,EDS 289C,A01,507361,Daly; Alan J.,18,0,18,0
1715645946598,EDS 290,A00,507366,Hofstetter; Carolyn,15,0,15,0
1715645947630,LIGM 5A,A00,507421,Fischer-Grunski; Eva K,17,0,20,3
1715645948656,LIGM 5B,A00,507423,Fischer-Grunski; Eva K,19,0,20,1
1715645949683,LIGM 5C,A00,507425,Fischer-Grunski; Eva K,19,0,20,1
1715645950711,LIIT 5AS,A00,507427,Carnelos; Chiara,20,0,20,0
1715645951736,LIIT 5BS,A00,507430,Carnelos; Chiara,20,0,20,0
1715645952766,LIIT 5CS,A00,507432,Carnelos; Chiara,20,0,20,0
1715645953792,LISP 5A,A00,507541,Munoz Sanchez; Alicia,11,0,20,9
1715645954821,LISP 5B,A00,507671,Munoz Sanchez; Alicia,8,0,20,12
1715645955846,LISP 5C,A00,507696,Munoz Sanchez; Alicia,8,0,20,12
1715645956873,MAE 197,001,528363,Boechler; Nicholas Sebastia,9998,0,9999,1
1715645957905,MATH 197,001,523477,Kedlaya; Kiran S.,9994,0,9999,5
1715645957905,MATH 197,002,563811,Zhang; Danna,9994,0,9999,5
1715645957905,MATH 197,003,628552,Dumitriu; Ioana,9998,0,9999,1
1715645957905,MATH 197,004,660885,Floyd; Eric,9998,0,9999,1
1715645958933,MCWP 40R,A00,518780,Staff,1,0,20,19
1715645958933,MCWP 40R,B00,518781,Carter; Jennifer A,10,0,20,10
1715645958933,MCWP 40R,C00,518783,Smith; Haydee Marie,5,0,20,15
1715645959957,MCWP 50R,A00,518791,Redela; Pamela Morgan,0,1,20,20
1715645959957,MCWP 50R,B00,518792,Krone; Jarret,0,2,20,20
1715645959957,MCWP 50R,C00,518793,Staff,0,4,20,20
1715645959957,MCWP 50R,D00,518794,Morshed; Michael James,0,2,20,20
1715645959957,MCWP 50R,E00,518795,Carter; Andrea L,0,2,20,20
1715645959957,MCWP 50R,F00,518796,Miller; Elizabeth Deen,0,1,20,20
1715645959957,MCWP 50R,G00,518797,Guillen; Melinda,0,1,20,20
1715645960983,MMW 12R,A01,514034,Herbst; Matthew,0,2,16,16
1715645960983,MMW 12R,A02,514035,Herbst; Matthew,0,0,16,16
1715645962006,MMW 13R,A01,514037,Staff,0,5,16,16
1715645962006,MMW 13R,A02,514039,Staff,0,5,16,16
1715645962006,MMW 13R,A03,628519,Staff,0,4,16,16
1715645964063,SIO 295LS,A00,523233,Staff,10,0,30,20
1715645965087,SIO 295S,A00,523232,Staff,10,0,30,20
1715645966117,SIOC 290S,A01,637330,Merrifield; Mark A,21,0,30,9
1715645967141,SIOC 291S,A01,637333,Gabriel; Corey John,21,0,30,9
1715645968166,SOCI 117,A01,494376,Staff,0,5,5,5
1715645969193,WES 237B,A00,494380,Staff,10,0,20,10
1715645971261,AESE 279B,A00,494370,Wade; Jon P,0,0,33,33
1715645972285,AIP 97,001,660915,Van Den Einde; Yael Dahlia,9998,0,9999,1
1715645973314,AIP 197,001,627712,Vespa; Emanuel Ignacio,9995,0,9999,4
1715645973314,AIP 197,002,650778,Amir; On,9998,0,9999,1
1715645973314,AIP 197,003,650933,Avenancio-Leon; Carlos,9998,0,9999,1
1715645973314,AIP 197,004,658530,Heyman; Gail D.,9998,0,9999,1
1715645973314,AIP 197,005,658631,Neal; Sonya E,9998,0,9999,1
1715645973314,AIP 197,006,658671,Du; Songzi,9998,0,9999,1
1715645974340,ANAR 135S,A00,494369,Braswell; Geoffrey E.,0,0,0,0
1715645975366,BENG 196,001,628496,Engler; Adam J.,9998,0,9999,1
1715645975366,BENG 196,002,660916,Watson; John Thomas,9998,0,9999,1
1715645976391,BISP 197,001,650773,Wilhelm; James E.,9994,0,9999,5
1715645976391,BISP 197,002,658904,Coleman; Aaron B.,9998,0,9999,1
1715645977416,CAT 124RS,A01,519847,Geibel; William,0,0,20,20
1715645978440,CAT 125RS,A01,515971,Geibel; William,0,0,20,20
1715645979466,CLRE 250,A00,511389,Morris; Sheldon,9992,0,9999,7
1715645980492,CLRE 251,A00,507176,Mehta; Ravindra L.,9992,0,9999,7
1715645980492,CLRE 251,B00,511410,Mehta; Ravindra L.,9998,0,9999,1
1715645981522,CLRE 252,A00,507189,Cuomo; Raphael Eduardo,9994,0,9999,5
1715645982550,CLRE 253,A00,507199,Vaida; Florin,9994,0,9999,5
1715645982550,CLRE 253,B00,507202,Vaida; Florin,9999,0,9999,0
1715645983575,CLRE 259,A00,507211,Patel; Hemal,9996,0,9999,3
1715645984603,CLRE 260,A00,507221,Cuomo; Raphael Eduardo,9999,0,9999,0
1715645985627,CLRE 297,001,507242,Cuomo; Raphael Eduardo,9999,0,9999,0
1715645986654,COGS 197,001,638244,Voytek; Bradley Thomas,9997,0,9999,2
1715645987682,CSE 191,A00,516875,Minnes Kemp; Mor Mia,9991,0,9999,8
1715645988710,CSE 197,001,637388,Minnes Kemp; Mor Mia,9992,0,9999,7
1715645989740,CSS 201S,A01,494383,Mignozzetti; Umberto,35,0,35,0
1715645990766,CSS 202S,A01,494387,Mignozzetti; Umberto,35,0,35,0
1715645991792,DSC 197,001,628532,Eldridge; Justin Matthew,9995,0,9999,4
1715645992818,EAP 100,A00,516065,Staff,9799,0,9999,200
1715645993872,ECE 45,A01,507414,Staff,32,0,60,28
1715645995921,ECE 111,A01,507420,Staff,11,0,50,39
1715645996947,ECE 197,001,548057,Sievenpiper; Daniel F.,9991,0,9999,8
1715645997979,EDS 115,A00,507243,Choi; Bailey Miyeon,6,0,28,22
1715645999009,EDS 117,A01,494379,Staff,0,6,34,35
1715646000090,EDS 125,A00,507246,Hopkins; Megan Beth,7,0,30,23
1715646001121,EDS 128A,A01,507264,Fargason; Sharon Gayle,5,0,26,21
1715646002147,EDS 128B,A01,507293,Pappas; Elizabeth,9,0,30,21
1715646003178,EDS 139,A00,507294,Fargason; Sharon Gayle,9,0,30,21
1715646003178,EDS 139,B00,507313,Pappas; Elizabeth,9,0,30,21
1715646004206,EDS 201,A00,507315,Staff,10,0,30,20
1715646005230,EDS 203,A01,507317,Halter; Christopher P.,10,0,30,20
1715646006271,EDS 204R,A01,507319,Halter; Christopher P.,0,3,30,30
1715646006271,EDS 204R,B01,507331,Heinzman; Erica M.,14,0,30,16
1715646007298,EDS 206R,A00,507332,Staff,0,4,30,30
1715646007298,EDS 206R,B00,507343,Staff,15,0,30,15
1715646008329,EDS 250,A00,507344,Hemans; Patricia Ann Benitez,20,0,40,20
1715646009355,EDS 281,A00,507345,Daly; Alan J.,18,0,18,0
1715646010385,EDS 284,A00,507350,Daly; Alan J.,16,0,16,0
1715646011412,EDS 286,A00,507359,Fine; Sarah,18,0,18,0
1715646012442,EDS 289C,A01,507361,Daly; Alan J.,18,0,18,0
1715646013470,EDS 290,A00,507366,Hofstetter; Carolyn,15,0,15,0
1715646014503,LIGM 5A,A00,507421,Fischer-Grunski; Eva K,17,0,20,3
1715646015534,LIGM 5B,A00,507423,Fischer-Grunski; Eva K,19,0,20,1
1715646016561,LIGM 5C,A00,507425,Fischer-Grunski; Eva K,19,0,20,1
1715646017585,LIIT 5AS,A00,507427,Carnelos; Chiara,20,0,20,0
1715646018611,LIIT 5BS,A00,507430,Carnelos; Chiara,20,0,20,0
1715646019637,LIIT 5CS,A00,507432,Carnelos; Chiara,20,0,20,0
1715646020667,LISP 5A,A00,507541,Munoz Sanchez; Alicia,11,0,20,9
1715646021696,LISP 5B,A00,507671,Munoz Sanchez; Alicia,8,0,20,12
1715646022723,LISP 5C,A00,507696,Munoz Sanchez; Alicia,8,0,20,12
1715646023747,MAE 197,001,528363,Boechler; Nicholas Sebastia,9998,0,9999,1
1715646024779,MATH 197,001,523477,Kedlaya; Kiran S.,9994,0,9999,5
1715646024779,MATH 197,002,563811,Zhang; Danna,9994,0,9999,5
1715646024779,MATH 197,003,628552,Dumitriu; Ioana,9998,0,9999,1
1715646024779,MATH 197,004,660885,Floyd; Eric,9998,0,9999,1
1715646025804,MCWP 40R,A00,518780,Staff,1,0,20,19
1715646025804,MCWP 40R,B00,518781,Carter; Jennifer A,10,0,20,10
1715646025804,MCWP 40R,C00,518783,Smith; Haydee Marie,5,0,20,15
1715646026833,MCWP 50R,A00,518791,Redela; Pamela Morgan,0,1,20,20
1715646026833,MCWP 50R,B00,518792,Krone; Jarret,0,2,20,20
1715646026833,MCWP 50R,C00,518793,Staff,0,4,20,20
1715646026833,MCWP 50R,D00,518794,Morshed; Michael James,0,2,20,20
1715646026833,MCWP 50R,E00,518795,Carter; Andrea L,0,2,20,20
1715646026833,MCWP 50R,F00,518796,Miller; Elizabeth Deen,0,1,20,20
1715646026833,MCWP 50R,G00,518797,Guillen; Melinda,0,1,20,20
1715646027859,MMW 12R,A01,514034,Herbst; Matthew,0,2,16,16
1715646027859,MMW 12R,A02,514035,Herbst; Matthew,0,0,16,16
1715646028887,MMW 13R,A01,514037,Staff,0,5,16,16
1715646028887,MMW 13R,A02,514039,Staff,0,5,16,16
1715646028887,MMW 13R,A03,628519,Staff,0,4,16,16
1715646030937,SIO 295LS,A00,523233,Staff,10,0,30,20
1715646031962,SIO 295S,A00,523232,Staff,10,0,30,20
1715646032988,SIOC 290S,A01,637330,Merrifield; Mark A,21,0,30,9
1715646034014,SIOC 291S,A01,637333,Gabriel; Corey John,21,0,30,9
1715646035039,SOCI 117,A01,494376,Staff,0,5,5,5
1715646036065,WES 237B,A00,494380,Staff,10,0,20,10
1715646038131,AESE 279B,A00,494370,Wade; Jon P,0,0,33,33
1715646039161,AIP 97,001,660915,Van Den Einde; Yael Dahlia,9998,0,9999,1
1715646040191,AIP 197,001,627712,Vespa; Emanuel Ignacio,9995,0,9999,4
1715646040191,AIP 197,002,650778,Amir; On,9998,0,9999,1
1715646040191,AIP 197,003,650933,Avenancio-Leon; Carlos,9998,0,9999,1
1715646040191,AIP 197,004,658530,Heyman; Gail D.,9998,0,9999,1
1715646040191,AIP 197,005,658631,Neal; Sonya E,9998,0,9999,1
1715646040191,AIP 197,006,658671,Du; Songzi,9998,0,9999,1
1715646041217,ANAR 135S,A00,494369,Braswell; Geoffrey E.,0,0,0,0
1715646042242,BENG 196,001,628496,Engler; Adam J.,9998,0,9999,1
1715646042242,BENG 196,002,660916,Watson; John Thomas,9998,0,9999,1
1715646043271,BISP 197,001,650773,Wilhelm; James E.,9994,0,9999,5
1715646043271,BISP 197,002,658904,Coleman; Aaron B.,9998,0,9999,1
1715646044301,CAT 124RS,A01,519847,Geibel; William,0,0,20,20
1715646045328,CAT 125RS,A01,515971,Geibel; William,0,0,20,20
1715646046354,CLRE 250,A00,511389,Morris; Sheldon,9992,0,9999,7
1715646047378,CLRE 251,A00,507176,Mehta; Ravindra L.,9992,0,9999,7
1715646047378,CLRE 251,B00,511410,Mehta; Ravindra L.,9998,0,9999,1
1715646048403,CLRE 252,A00,507189,Cuomo; Raphael Eduardo,9994,0,9999,5
1715646049430,CLRE 253,A00,507199,Vaida; Florin,9994,0,9999,5
1715646049430,CLRE 253,B00,507202,Vaida; Florin,9999,0,9999,0
1715646050455,CLRE 259,A00,507211,Patel; Hemal,9996,0,9999,3
1715646051483,CLRE 260,A00,507221,Cuomo; Raphael Eduardo,9999,0,9999,0
1715646052511,CLRE 297,001,507242,Cuomo; Raphael Eduardo,9999,0,9999,0
1715646053538,COGS 197,001,638244,Voytek; Bradley Thomas,9997,0,9999,2
1715646054565,CSE 191,A00,516875,Minnes Kemp; Mor Mia,9991,0,9999,8
1715646055592,CSE 197,001,637388,Minnes Kemp; Mor Mia,9992,0,9999,7
1715646056622,CSS 201S,A01,494383,Mignozzetti; Umberto,35,0,35,0
1715646057652,CSS 202S,A01,494387,Mignozzetti; Umberto,35,0,35,0
1715646058677,DSC 197,001,628532,Eldridge; Justin Matthew,9995,0,9999,4
1715646059702,EAP 100,A00,516065,Staff,9799,0,9999,200
1715646060731,ECE 45,A01,507414,Staff,32,0,60,28
1715646062781,ECE 111,A01,507420,Staff,11,0,50,39
1715646063806,ECE 197,001,548057,Sievenpiper; Daniel F.,9991,0,9999,8
1715646064837,EDS 115,A00,507243,Choi; Bailey Miyeon,6,0,28,22
1715646065868,EDS 117,A01,494379,Staff,0,6,34,35
1715646066893,EDS 125,A00,507246,Hopkins; Megan Beth,7,0,30,23
1715646067922,EDS 128A,A01,507264,Fargason; Sharon Gayle,5,0,26,21
1715646068954,EDS 128B,A01,507293,Pappas; Elizabeth,9,0,30,21
1715646069977,EDS 139,A00,507294,Fargason; Sharon Gayle,9,0,30,21
1715646069977,EDS 139,B00,507313,Pappas; Elizabeth,9,0,30,21
1715646071001,EDS 201,A00,507315,Staff,10,0,30,20
1715646072026,EDS 203,A01,507317,Halter; Christopher P.,10,0,30,20
1715646073055,EDS 204R,A01,507319,Halter; Christopher P.,0,3,30,30
1715646073055,EDS 204R,B01,507331,Heinzman; Erica M.,14,0,30,16
1715646074082,EDS 206R,A00,507332,Staff,0,4,30,30
1715646074082,EDS 206R,B00,507343,Staff,15,0,30,15
1715646075110,EDS 250,A00,507344,Hemans; Patricia Ann Benitez,20,0,40,20
1715646076136,EDS 281,A00,507345,Daly; Alan J.,18,0,18,0
1715646077165,EDS 284,A00,507350,Daly; Alan J.,16,0,16,0
1715646078189,EDS 286,A00,507359,Fine; Sarah,18,0,18,0
1715646079215,EDS 289C,A01,507361,Daly; Alan J.,18,0,18,0
1715646080239,EDS 290,A00,507366,Hofstetter; Carolyn,15,0,15,0
1715646081266,LIGM 5A,A00,507421,Fischer-Grunski; Eva K,17,0,20,3
1715646082292,LIGM 5B,A00,507423,Fischer-Grunski; Eva K,19,0,20,1
1715646083317,LIGM 5C,A00,507425,Fischer-Grunski; Eva K,19,0,20,1
1715646084342,LIIT 5AS,A00,507427,Carnelos; Chiara,20,0,20,0
1715646085372,LIIT 5BS,A00,507430,Carnelos; Chiara,20,0,20,0
1715646086403,LIIT 5CS,A00,507432,Carnelos; Chiara,20,0,20,0
1715646087434,LISP 5A,A00,507541,Munoz Sanchez; Alicia,11,0,20,9
1715646088458,LISP 5B,A00,507671,Munoz Sanchez; Alicia,8,0,20,12
1715646089484,LISP 5C,A00,507696,Munoz Sanchez; Alicia,8,0,20,12
1715646090514,MAE 197,001,528363,Boechler; Nicholas Sebastia,9998,0,9999,1
1715646091542,MATH 197,001,523477,Kedlaya; Kiran S.,9994,0,9999,5
1715646091542,MATH 197,002,563811,Zhang; Danna,9994,0,9999,5
1715646091542,MATH 197,003,628552,Dumitriu; Ioana,9998,0,9999,1
1715646091542,MATH 197,004,660885,Floyd; Eric,9998,0,9999,1
1715646092571,MCWP 40R,A00,518780,Staff,1,0,20,19
1715646092571,MCWP 40R,B00,518781,Carter; Jennifer A,10,0,20,10
1715646092571,MCWP 40R,C00,518783,Smith; Haydee Marie,5,0,20,15
1715646093599,MCWP 50R,A00,518791,Redela; Pamela Morgan,0,1,20,20
1715646093599,MCWP 50R,B00,518792,Krone; Jarret,0,2,20,20
1715646093599,MCWP 50R,C00,518793,Staff,0,4,20,20
1715646093599,MCWP 50R,D00,518794,Morshed; Michael James,0,2,20,20
1715646093599,MCWP 50R,E00,518795,Carter; Andrea L,0,2,20,20
1715646093599,MCWP 50R,F00,518796,Miller; Elizabeth Deen,0,1,20,20
1715646093599,MCWP 50R,G00,518797,Guillen; Melinda,0,1,20,20
1715646094626,MMW 12R,A01,514034,Herbst; Matthew,0,2,16,16
1715646094626,MMW 12R,A02,514035,Herbst; Matthew,0,0,16,16
1715646095651,MMW 13R,A01,514037,Staff,0,5,16,16
1715646095651,MMW 13R,A02,514039,Staff,0,5,16,16
1715646095651,MMW 13R,A03,628519,Staff,0,4,16,16
1715646097705,SIO 295LS,A00,523233,Staff,10,0,30,20
1715646098732,SIO 295S,A00,523232,Staff,10,0,30,20
1715646099758,SIOC 290S,A01,637330,Merrifield; Mark A,21,0,30,9
1715646100791,SIOC 291S,A01,637333,Gabriel; Corey John,21,0,30,9
1715646101815,SOCI 117,A01,494376,Staff,0,5,5,5
1715646102842,WES 237B,A00,494380,Staff,10,0,20,10
1715646104979,AESE 279B,A00,494370,Wade; Jon P,0,0,33,33
1715646106005,AIP 97,001,660915,Van Den Einde; Yael Dahlia,9998,0,9999,1
1715646107038,AIP 197,001,627712,Vespa; Emanuel Ignacio,9995,0,9999,4
1715646107038,AIP 197,002,650778,Amir; On,9998,0,9999,1
1715646107038,AIP 197,003,650933,Avenancio-Leon; Carlos,9998,0,9999,1
1715646107038,AIP 197,004,658530,Heyman; Gail D.,9998,0,9999,1
1715646107038,AIP 197,005,658631,Neal; Sonya E,9998,0,9999,1
1715646107038,AIP 197,006,658671,Du; Songzi,9998,0,9999,1
1715646108067,ANAR 135S,A00,494369,Braswell; Geoffrey E.,0,0,0,0
1715646109093,BENG 196,001,628496,Engler; Adam J.,9998,0,9999,1
1715646109093,BENG 196,002,660916,Watson; John Thomas,9998,0,9999,1
1715646110124,BISP 197,001,650773,Wilhelm; James E.,9994,0,9999,5
1715646110124,BISP 197,002,658904,Coleman; Aaron B.,9998,0,9999,1
1715646111148,CAT 124RS,A01,519847,Geibel; William,0,0,20,20
1715646112173,CAT 125RS,A01,515971,Geibel; William,0,0,20,20
1715646113199,CLRE 250,A00,511389,Morris; Sheldon,9992,0,9999,7
1715646114226,CLRE 251,A00,507176,Mehta; Ravindra L.,9992,0,9999,7
1715646114226,CLRE 251,B00,511410,Mehta; Ravindra L.,9998,0,9999,1
1715646115253,CLRE 252,A00,507189,Cuomo; Raphael Eduardo,9994,0,9999,5
1715646116279,CLRE 253,A00,507199,Vaida; Florin,9994,0,9999,5
1715646116279,CLRE 253,B00,507202,Vaida; Florin,9999,0,9999,0
1715646117304,CLRE 259,A00,507211,Patel; Hemal,9996,0,9999,3
1715646118333,CLRE 260,A00,507221,Cuomo; Raphael Eduardo,9999,0,9999,0
1715646119358,CLRE 297,001,507242,Cuomo; Raphael Eduardo,9999,0,9999,0
1715646120389,COGS 197,001,638244,Voytek; Bradley Thomas,9997,0,9999,2
1715646121416,CSE 191,A00,516875,Minnes Kemp; Mor Mia,9991,0,9999,8
1715646122443,CSE 197,001,637388,Minnes Kemp; Mor Mia,9992,0,9999,7
1715646123469,CSS 201S,A01,494383,Mignozzetti; Umberto,35,0,35,0
1715646124498,CSS 202S,A01,494387,Mignozzetti; Umberto,35,0,35,0
1715646125526,DSC 197,001,628532,Eldridge; Justin Matthew,9995,0,9999,4
1715646126554,EAP 100,A00,516065,Staff,9799,0,9999,200
1715646127582,ECE 45,A01,507414,Staff,32,0,60,28
1715646129637,ECE 111,A01,507420,Staff,11,0,50,39
1715646130666,ECE 197,001,548057,Sievenpiper; Daniel F.,9991,0,9999,8
1715646131695,EDS 115,A00,507243,Choi; Bailey Miyeon,6,0,28,22
1715646132721,EDS 117,A01,494379,Staff,0,6,34,35
1715646133745,EDS 125,A00,507246,Hopkins; Megan Beth,7,0,30,23
1715646134770,EDS 128A,A01,507264,Fargason; Sharon Gayle,5,0,26,21
1715646135797,EDS 128B,A01,507293,Pappas; Elizabeth,9,0,30,21
1715646136822,EDS 139,A00,507294,Fargason; Sharon Gayle,9,0,30,21
1715646136822,EDS 139,B00,507313,Pappas; Elizabeth,9,0,30,21
1715646137850,EDS 201,A00,507315,Staff,10,0,30,20
1715646138876,EDS 203,A01,507317,Halter; Christopher P.,10,0,30,20
1715646139902,EDS 204R,A01,507319,Halter; Christopher P.,0,3,30,30
1715646139902,EDS 204R,B01,507331,Heinzman; Erica M.,14,0,30,16
1715646140929,EDS 206R,A00,507332,Staff,0,4,30,30
1715646140929,EDS 206R,B00,507343,Staff,15,0,30,15
1715646141955,EDS 250,A00,507344,Hemans; Patricia Ann Benitez,20,0,40,20
1715646142978,EDS 281,A00,507345,Daly; Alan J.,18,0,18,0
1715646144004,EDS 284,A00,507350,Daly; Alan J.,16,0,16,0
1715646145033,EDS 286,A00,507359,Fine; Sarah,18,0,18,0
1715646146058,EDS 289C,A01,507361,Daly; Alan J.,18,0,18,0
1715646147083,EDS 290,A00,507366,Hofstetter; Carolyn,15,0,15,0
1715646148108,LIGM 5A,A00,507421,Fischer-Grunski; Eva K,17,0,20,3
1715646149133,LIGM 5B,A00,507423,Fischer-Grunski; Eva K,19,0,20,1
1715646150162,LIGM 5C,A00,507425,Fischer-Grunski; Eva K,19,0,20,1
1715646151188,LIIT 5AS,A00,507427,Carnelos; Chiara,20,0,20,0
1715646152213,LIIT 5BS,A00,507430,Carnelos; Chiara,20,0,20,0
1715646153243,LIIT 5CS,A00,507432,Carnelos; Chiara,20,0,20,0
1715646154274,LISP 5A,A00,507541,Munoz Sanchez; Alicia,11,0,20,9
1715646155299,LISP 5B,A00,507671,Munoz Sanchez; Alicia,8,0,20,12
1715646156324,LISP 5C,A00,507696,Munoz Sanchez; Alicia,8,0,20,12
1715646157351,MAE 197,001,528363,Boechler; Nicholas Sebastia,9998,0,9999,1
1715646158380,MATH 197,001,523477,Kedlaya; Kiran S.,9994,0,9999,5
1715646158380,MATH 197,002,563811,Zhang; Danna,9994,0,9999,5
1715646158380,MATH 197,003,628552,Dumitriu; Ioana,9998,0,9999,1
1715646158380,MATH 197,004,660885,Floyd; Eric,9998,0,9999,1
1715646159410,MCWP 40R,A00,518780,Staff,1,0,20,19
1715646159410,MCWP 40R,B00,518781,Carter; Jennifer A,10,0,20,10
1715646159410,MCWP 40R,C00,518783,Smith; Haydee Marie,5,0,20,15
1715646160439,MCWP 50R,A00,518791,Redela; Pamela Morgan,0,1,20,20
1715646160439,MCWP 50R,B00,518792,Krone; Jarret,0,2,20,20
1715646160439,MCWP 50R,C00,518793,Staff,0,4,20,20
1715646160439,MCWP 50R,D00,518794,Morshed; Michael James,0,2,20,20
1715646160439,MCWP 50R,E00,518795,Carter; Andrea L,0,2,20,20
1715646160439,MCWP 50R,F00,518796,Miller; Elizabeth Deen,0,1,20,20
1715646160439,MCWP 50R,G00,518797,Guillen; Melinda,0,1,20,20
1715646161465,MMW 12R,A01,514034,Herbst; Matthew,0,2,16,16
1715646161465,MMW 12R,A02,514035,Herbst; Matthew,0,0,16,16
1715646162489,MMW 13R,A01,514037,Staff,0,5,16,16
1715646162489,MMW 13R,A02,514039,Staff,0,5,16,16
1715646162489,MMW 13R,A03,628519,Staff,0,4,16,16
1715646164540,SIO 295LS,A00,523233,Staff,10,0,30,20
1715646165564,SIO 295S,A00,523232,Staff,10,0,30,20
1715646166594,SIOC 290S,A01,637330,Merrifield; Mark A,21,0,30,9
1715646167620,SIOC 291S,A01,637333,Gabriel; Corey John,21,0,30,9
1715646168644,SOCI 117,A01,494376,Staff,0,5,5,5
1715646169668,WES 237B,A00,494380,Staff,10,0,20,10
1715646171737,AESE 279B,A00,494370,Wade; Jon P,0,0,33,33
1715646172768,AIP 97,001,660915,Van Den Einde; Yael Dahlia,9998,0,9999,1
1715646173795,AIP 197,001,627712,Vespa; Emanuel Ignacio,9995,0,9999,4
1715646173795,AIP 197,002,650778,Amir; On,9998,0,9999,1
1715646173795,AIP 197,003,650933,Avenancio-Leon; Carlos,9998,0,9999,1
1715646173795,AIP 197,004,658530,Heyman; Gail D.,9998,0,9999,1
1715646173795,AIP 197,005,658631,Neal; Sonya E,9998,0,9999,1
1715646173795,AIP 197,006,658671,Du; Songzi,9998,0,9999,1
1715646174826,ANAR 135S,A00,494369,Braswell; Geoffrey E.,0,0,0,0
1715646175855,BENG 196,001,628496,Engler; Adam J.,9998,0,9999,1
1715646175855,BENG 196,002,660916,Watson; John Thomas,9998,0,9999,1
1715646176880,BISP 197,001,650773,Wilhelm; James E.,9994,0,9999,5
1715646176880,BISP 197,002,658904,Coleman; Aaron B.,9998,0,9999,1
1715646177909,CAT 124RS,A01,519847,Geibel; William,0,0,20,20
1715646178934,CAT 125RS,A01,515971,Geibel; William,0,0,20,20
1715646179965,CLRE 250,A00,511389,Morris; Sheldon,9992,0,9999,7
1715646180995,CLRE 251,A00,507176,Mehta; Ravindra L.,9992,0,9999,7
1715646180995,CLRE 251,B00,511410,Mehta; Ravindra L.,9998,0,9999,1
1715646182020,CLRE 252,A00,507189,Cuomo; Raphael Eduardo,9994,0,9999,5
1715646183048,CLRE 253,A00,507199,Vaida; Florin,9994,0,9999,5
1715646183048,CLRE 253,B00,507202,Vaida; Florin,9999,0,9999,0
1715646184075,CLRE 259,A00,507211,Patel; Hemal,9996,0,9999,3
1715646185102,CLRE 260,A00,507221,Cuomo; Raphael Eduardo,9999,0,9999,0
1715646186130,CLRE 297,001,507242,Cuomo; Raphael Eduardo,9999,0,9999,0
1715646187158,COGS 197,001,638244,Voytek; Bradley Thomas,9997,0,9999,2
1715646188183,CSE 191,A00,516875,Minnes Kemp; Mor Mia,9991,0,9999,8
1715646189208,CSE 197,001,637388,Minnes Kemp; Mor Mia,9992,0,9999,7
1715646190234,CSS 201S,A01,494383,Mignozzetti; Umberto,35,0,35,0
1715646191261,CSS 202S,A01,494387,Mignozzetti; Umberto,35,0,35,0
1715646192287,DSC 197,001,628532,Eldridge; Justin Matthew,9995,0,9999,4
1715646193312,EAP 100,A00,516065,Staff,9799,0,9999,200
1715646194343,ECE 45,A01,507414,Staff,32,0,60,28
1715646196395,ECE 111,A01,507420,Staff,11,0,50,39
1715646197420,ECE 197,001,548057,Sievenpiper; Daniel F.,9991,0,9999,8
1715646198447,EDS 115,A00,507243,Choi; Bailey Miyeon,6,0,28,22
1715646199473,EDS 117,A01,494379,Staff,0,6,34,35
1715646200503,EDS 125,A00,507246,Hopkins; Megan Beth,7,0,30,23
1715646201530,EDS 128A,A01,507264,Fargason; Sharon Gayle,5,0,26,21
1715646202559,EDS 128B,A01,507293,Pappas; Elizabeth,9,0,30,21
1715646203584,EDS 139,A00,507294,Fargason; Sharon Gayle,9,0,30,21
1715646203584,EDS 139,B00,507313,Pappas; Elizabeth,9,0,30,21
1715646204614,EDS 201,A00,507315,Staff,10,0,30,20
1715646205646,EDS 203,A01,507317,Halter; Christopher P.,10,0,30,20
1715646206675,EDS 204R,A01,507319,Halter; Christopher P.,0,3,30,30
1715646206675,EDS 204R,B01,507331,Heinzman; Erica M.,14,0,30,16
1715646207774,EDS 206R,A00,507332,Staff,0,4,30,30
1715646207774,EDS 206R,B00,507343,Staff,15,0,30,15
1715646208800,EDS 250,A00,507344,Hemans; Patricia Ann Benitez,20,0,40,20
1715646209828,EDS 281,A00,507345,Daly; Alan J.,18,0,18,0
1715646210854,EDS 284,A00,507350,Daly; Alan J.,16,0,16,0
1715646211932,EDS 286,A00,507359,Fine; Sarah,18,0,18,0
1715646212961,EDS 289C,A01,507361,Daly; Alan J.,18,0,18,0
1715646213989,EDS 290,A00,507366,Hofstetter; Carolyn,15,0,15,0
1715646215015,LIGM 5A,A00,507421,Fischer-Grunski; Eva K,17,0,20,3
1715646216045,LIGM 5B,A00,507423,Fischer-Grunski; Eva K,19,0,20,1
1715646217072,LIGM 5C,A00,507425,Fischer-Grunski; Eva K,19,0,20,1
1715646218097,LIIT 5AS,A00,507427,Carnelos; Chiara,20,0,20,0
1715646219128,LIIT 5BS,A00,507430,Carnelos; Chiara,20,0,20,0
1715646220156,LIIT 5CS,A00,507432,Carnelos; Chiara,20,0,20,0
1715646221186,LISP 5A,A00,507541,Munoz Sanchez; Alicia,11,0,20,9
1715646222211,LISP 5B,A00,507671,Munoz Sanchez; Alicia,8,0,20,12
1715646223241,LISP 5C,A00,507696,Munoz Sanchez; Alicia,8,0,20,12
1715646224278,MAE 197,001,528363,Boechler; Nicholas Sebastia,9998,0,9999,1
1715646225314,MATH 197,001,523477,Kedlaya; Kiran S.,9994,0,9999,5
1715646225314,MATH 197,002,563811,Zhang; Danna,9994,0,9999,5
1715646225314,MATH 197,003,628552,Dumitriu; Ioana,9998,0,9999,1
1715646225314,MATH 197,004,660885,Floyd; Eric,9998,0,9999,1
1715646226341,MCWP 40R,A00,518780,Staff,1,0,20,19
1715646226341,MCWP 40R,B00,518781,Carter; Jennifer A,10,0,20,10
1715646226341,MCWP 40R,C00,518783,Smith; Haydee Marie,5,0,20,15
1715646227370,MCWP 50R,A00,518791,Redela; Pamela Morgan,0,1,20,20
1715646227370,MCWP 50R,B00,518792,Krone; Jarret,0,2,20,20
1715646227370,MCWP 50R,C00,518793,Staff,0,4,20,20
1715646227370,MCWP 50R,D00,518794,Morshed; Michael James,0,2,20,20
1715646227370,MCWP 50R,E00,518795,Carter; Andrea L,0,2,20,20
1715646227370,MCWP 50R,F00,518796,Miller; Elizabeth Deen,0,1,20,20
1715646227370,MCWP 50R,G00,518797,Guillen; Melinda,0,1,20,20
1715646228396,MMW 12R,A01,514034,Herbst; Matthew,0,2,16,16
1715646228396,MMW 12R,A02,514035,Herbst; Matthew,0,0,16,16
1715646229422,MMW 13R,A01,514037,Staff,0,5,16,16
1715646229422,MMW 13R,A02,514039,Staff,0,5,16,16
1715646229422,MMW 13R,A03,628519,Staff,0,4,16,16
1715646231480,SIO 295LS,A00,523233,Staff,10,0,30,20
1715646232505,SIO 295S,A00,523232,Staff,10,0,30,20
1715646233532,SIOC 290S,A01,637330,Merrifield; Mark A,21,0,30,9
1715646234562,SIOC 291S,A01,637333,Gabriel; Corey John,21,0,30,9
1715646235589,SOCI 117,A01,494376,Staff,0,5,5,5
1715646236618,WES 237B,A00,494380,Staff,10,0,20,10
1715646238693,AESE 279B,A00,494370,Wade; Jon P,0,0,33,33
1715646239721,AIP 97,001,660915,Van Den Einde; Yael Dahlia,9998,0,9999,1
1715646240748,AIP 197,001,627712,Vespa; Emanuel Ignacio,9995,0,9999,4
1715646240748,AIP 197,002,650778,Amir; On,9998,0,9999,1
1715646240748,AIP 197,003,650933,Avenancio-Leon; Carlos,9998,0,9999,1
1715646240748,AIP 197,004,658530,Heyman; Gail D.,9998,0,9999,1
1715646240748,AIP 197,005,658631,Neal; Sonya E,9998,0,9999,1
1715646240748,AIP 197,006,658671,Du; Songzi,9998,0,9999,1
1715646241775,ANAR 135S,A00,494369,Braswell; Geoffrey E.,0,0,0,0
1715646242801,BENG 196,001,628496,Engler; Adam J.,9998,0,9999,1
1715646242801,BENG 196,002,660916,Watson; John Thomas,9998,0,9999,1
1715646243832,BISP 197,001,650773,Wilhelm; James E.,9994,0,9999,5
1715646243832,BISP 197,002,658904,Coleman; Aaron B.,9998,0,9999,1
1715646244858,CAT 124RS,A01,519847,Geibel; William,0,0,20,20
1715646245886,CAT 125RS,A01,515971,Geibel; William,0,0,20,20
1715646246912,CLRE 250,A00,511389,Morris; Sheldon,9992,0,9999,7
1715646247943,CLRE 251,A00,507176,Mehta; Ravindra L.,9992,0,9999,7
1715646247943,CLRE 251,B00,511410,Mehta; Ravindra L.,9998,0,9999,1
1715646248969,CLRE 252,A00,507189,Cuomo; Raphael Eduardo,9994,0,9999,5
1715646249997,CLRE 253,A00,507199,Vaida; Florin,9994,0,9999,5
1715646249997,CLRE 253,B00,507202,Vaida; Florin,9999,0,9999,0
1715646251024,CLRE 259,A00,507211,Patel; Hemal,9996,0,9999,3
1715646252051,CLRE 260,A00,507221,Cuomo; Raphael Eduardo,9999,0,9999,0
1715646253076,CLRE 297,001,507242,Cuomo; Raphael Eduardo,9999,0,9999,0
1715646254106,COGS 197,001,638244,Voytek; Bradley Thomas,9997,0,9999,2
1715646255134,CSE 191,A00,516875,Minnes Kemp; Mor Mia,9991,0,9999,8
1715646256162,CSE 197,001,637388,Minnes Kemp; Mor Mia,9992,0,9999,7
1715646257190,CSS 201S,A01,494383,Mignozzetti; Umberto,35,0,35,0
1715646258220,CSS 202S,A01,494387,Mignozzetti; Umberto,35,0,35,0
1715646259247,DSC 197,001,628532,Eldridge; Justin Matthew,9995,0,9999,4
1715646260271,EAP 100,A00,516065,Staff,9799,0,9999,200
1715646261299,ECE 45,A01,507414,Staff,32,0,60,28
1715646263350,ECE 111,A01,507420,Staff,11,0,50,39
1715646264377,ECE 197,001,548057,Sievenpiper; Daniel F.,9991,0,9999,8
1715646265566,EDS 115,A00,507243,Choi; Bailey Miyeon,6,0,28,22
1715646266595,EDS 117,A01,494379,Staff,0,6,34,35
1715646267621,EDS 125,A00,507246,Hopkins; Megan Beth,7,0,30,23
1715646268651,EDS 128A,A01,507264,Fargason; Sharon Gayle,5,0,26,21
1715646269680,EDS 128B,A01,507293,Pappas; Elizabeth,9,0,30,21
1715646270708,EDS 139,A00,507294,Fargason; Sharon Gayle,9,0,30,21
1715646270708,EDS 139,B00,507313,Pappas; Elizabeth,9,0,30,21
1715646271736,EDS 201,A00,507315,Staff,10,0,30,20
1715646272766,EDS 203,A01,507317,Halter; Christopher P.,10,0,30,20
1715646273794,EDS 204R,A01,507319,Halter; Christopher P.,0,3,30,30
1715646273794,EDS 204R,B01,507331,Heinzman; Erica M.,14,0,30,16
1715646274820,EDS 206R,A00,507332,Staff,0,4,30,30
1715646274820,EDS 206R,B00,507343,Staff,15,0,30,15
1715646275848,EDS 250,A00,507344,Hemans; Patricia Ann Benitez,20,0,40,20
1715646276877,EDS 281,A00,507345,Daly; Alan J.,18,0,18,0
1715646277903,EDS 284,A00,507350,Daly; Alan J.,16,0,16,0
1715646278929,EDS 286,A00,507359,Fine; Sarah,18,0,18,0
1715646279957,EDS 289C,A01,507361,Daly; Alan J.,18,0,18,0
1715646280982,EDS 290,A00,507366,Hofstetter; Carolyn,15,0,15,0
1715646282008,LIGM 5A,A00,507421,Fischer-Grunski; Eva K,17,0,20,3
1715646283036,LIGM 5B,A00,507423,Fischer-Grunski; Eva K,19,0,20,1
1715646284062,LIGM 5C,A00,507425,Fischer-Grunski; Eva K,19,0,20,1
1715646285090,LIIT 5AS,A00,507427,Carnelos; Chiara,20,0,20,0
1715646286115,LIIT 5BS,A00,507430,Carnelos; Chiara,20,0,20,0
1715646287140,LIIT 5CS,A00,507432,Carnelos; Chiara,20,0,20,0
1715646288166,LISP 5A,A00,507541,Munoz Sanchez; Alicia,11,0,20,9
1715646289195,LISP 5B,A00,507671,Munoz Sanchez; Alicia,8,0,20,12
1715646290220,LISP 5C,A00,507696,Munoz Sanchez; Alicia,8,0,20,12
1715646291245,MAE 197,001,528363,Boechler; Nicholas Sebastia,9998,0,9999,1
1715646292272,MATH 197,001,523477,Kedlaya; Kiran S.,9994,0,9999,5
1715646292272,MATH 197,002,563811,Zhang; Danna,9994,0,9999,5
1715646292272,MATH 197,003,628552,Dumitriu; Ioana,9998,0,9999,1
1715646292272,MATH 197,004,660885,Floyd; Eric,9998,0,9999,1
1715646293299,MCWP 40R,A00,518780,Staff,1,0,20,19
1715646293299,MCWP 40R,B00,518781,Carter; Jennifer A,10,0,20,10
1715646293299,MCWP 40R,C00,518783,Smith; Haydee Marie,5,0,20,15
1715646294326,MCWP 50R,A00,518791,Redela; Pamela Morgan,0,1,20,20
1715646294326,MCWP 50R,B00,518792,Krone; Jarret,0,2,20,20
1715646294326,MCWP 50R,C00,518793,Staff,0,4,20,20
1715646294326,MCWP 50R,D00,518794,Morshed; Michael James,0,2,20,20
1715646294326,MCWP 50R,E00,518795,Carter; Andrea L,0,2,20,20
1715646294326,MCWP 50R,F00,518796,Miller; Elizabeth Deen,0,1,20,20
1715646294326,MCWP 50R,G00,518797,Guillen; Melinda,0,1,20,20
1715646295352,MMW 12R,A01,514034,Herbst; Matthew,0,2,16,16
1715646295352,MMW 12R,A02,514035,Herbst; Matthew,0,0,16,16
1715646296379,MMW 13R,A01,514037,Staff,0,5,16,16
1715646296379,MMW 13R,A02,514039,Staff,0,5,16,16
1715646296379,MMW 13R,A03,628519,Staff,0,4,16,16
1715646298428,SIO 295LS,A00,523233,Staff,10,0,30,20
1715646299454,SIO 295S,A00,523232,Staff,10,0,30,20
1715646300485,SIOC 290S,A01,637330,Merrifield; Mark A,21,0,30,9
1715646301510,SIOC 291S,A01,637333,Gabriel; Corey John,21,0,30,9
1715646302538,SOCI 117,A01,494376,Staff,0,5,5,5
1715646303566,WES 237B,A00,494380,Staff,10,0,20,10
1715646305631,AESE 279B,A00,494370,Wade; Jon P,0,0,33,33
1715646306656,AIP 97,001,660915,Van Den Einde; Yael Dahlia,9998,0,9999,1
1715646307682,AIP 197,001,627712,Vespa; Emanuel Ignacio,9995,0,9999,4
1715646307682,AIP 197,002,650778,Amir; On,9998,0,9999,1
1715646307682,AIP 197,003,650933,Avenancio-Leon; Carlos,9998,0,9999,1
1715646307682,AIP 197,004,658530,Heyman; Gail D.,9998,0,9999,1
1715646307682,AIP 197,005,658631,Neal; Sonya E,9998,0,9999,1
1715646307682,AIP 197,006,658671,Du; Songzi,9998,0,9999,1
1715646308712,ANAR 135S,A00,494369,Braswell; Geoffrey E.,0,0,0,0
1715646309744,BENG 196,001,628496,Engler; Adam J.,9998,0,9999,1
1715646309744,BENG 196,002,660916,Watson; John Thomas,9998,0,9999,1
1715646310773,BISP 197,001,650773,Wilhelm; James E.,9994,0,9999,5
1715646310773,BISP 197,002,658904,Coleman; Aaron B.,9998,0,9999,1
1715646311857,CAT 124RS,A01,519847,Geibel; William,0,0,20,20
1715646312883,CAT 125RS,A01,515971,Geibel; William,0,0,20,20
1715646313909,CLRE 250,A00,511389,Morris; Sheldon,9992,0,9999,7
1715646314937,CLRE 251,A00,507176,Mehta; Ravindra L.,9992,0,9999,7
1715646314937,CLRE 251,B00,511410,Mehta; Ravindra L.,9998,0,9999,1
1715646315972,CLRE 252,A00,507189,Cuomo; Raphael Eduardo,9994,0,9999,5
1715646317008,CLRE 253,A00,507199,Vaida; Florin,9994,0,9999,5
1715646317008,CLRE 253,B00,507202,Vaida; Florin,9999,0,9999,0
1715646318037,CLRE 259,A00,507211,Patel; Hemal,9996,0,9999,3
1715646319066,CLRE 260,A00,507221,Cuomo; Raphael Eduardo,9999,0,9999,0
1715646320091,CLRE 297,001,507242,Cuomo; Raphael Eduardo,9999,0,9999,0
1715646321123,COGS 197,001,638244,Voytek; Bradley Thomas,9997,0,9999,2
1715646322152,CSE 191,A00,516875,Minnes Kemp; Mor Mia,9991,0,9999,8
1715646323177,CSE 197,001,637388,Minnes Kemp; Mor Mia,9992,0,9999,7
1715646324205,CSS 201S,A01,494383,Mignozzetti; Umberto,35,0,35,0
1715646325230,CSS 202S,A01,494387,Mignozzetti; Umberto,35,0,35,0
1715646326256,DSC 197,001,628532,Eldridge; Justin Matthew,9995,0,9999,4
1715646327284,EAP 100,A00,516065,Staff,9799,0,9999,200
1715646328316,ECE 45,A01,507414,Staff,32,0,60,28
1715646330369,ECE 111,A01,507420,Staff,11,0,50,39
1715646331395,ECE 197,001,548057,Sievenpiper; Daniel F.,9991,0,9999,8
1715646332420,EDS 115,A00,507243,Choi; Bailey Miyeon,6,0,28,22
1715646333446,EDS 117,A01,494379,Staff,0,6,34,35
1715646334483,EDS 125,A00,507246,Hopkins; Megan Beth,7,0,30,23
1715646335513,EDS 128A,A01,507264,Fargason; Sharon Gayle,5,0,26,21
1715646336541,EDS 128B,A01,507293,Pappas; Elizabeth,9,0,30,21
1715646337565,EDS 139,A00,507294,Fargason; Sharon Gayle,9,0,30,21
1715646337565,EDS 139,B00,507313,Pappas; Elizabeth,9,0,30,21
1715646338593,EDS 201,A00,507315,Staff,10,0,30,20
1715646339623,EDS 203,A01,507317,Halter; Christopher P.,10,0,30,20
1715646340650,EDS 204R,A01,507319,Halter; Christopher P.,0,3,30,30
1715646340650,EDS 204R,B01,507331,Heinzman; Erica M.,14,0,30,16
1715646341674,EDS 206R,A00,507332,Staff,0,4,30,30
1715646341674,EDS 206R,B00,507343,Staff,15,0,30,15
1715646342699,EDS 250,A00,507344,Hemans; Patricia Ann Benitez,20,0,40,20
1715646343727,EDS 281,A00,507345,Daly; Alan J.,18,0,18,0
1715646344753,EDS 284,A00,507350,Daly; Alan J.,16,0,16,0
1715646345781,EDS 286,A00,507359,Fine; Sarah,18,0,18,0
1715646346805,EDS 289C,A01,507361,Daly; Alan J.,18,0,18,0
1715646347832,EDS 290,A00,507366,Hofstetter; Carolyn,15,0,15,0
1715646348857,LIGM 5A,A00,507421,Fischer-Grunski; Eva K,17,0,20,3
1715646349883,LIGM 5B,A00,507423,Fischer-Grunski; Eva K,19,0,20,1
1715646350908,LIGM 5C,A00,507425,Fischer-Grunski; Eva K,19,0,20,1
1715646351940,LIIT 5AS,A00,507427,Carnelos; Chiara,20,0,20,0
1715646352965,LIIT 5BS,A00,507430,Carnelos; Chiara,20,0,20,0
1715646353994,LIIT 5CS,A00,507432,Carnelos; Chiara,20,0,20,0
1715646355021,LISP 5A,A00,507541,Munoz Sanchez; Alicia,11,0,20,9
1715646356046,LISP 5B,A00,507671,Munoz Sanchez; Alicia,8,0,20,12
1715646357073,LISP 5C,A00,507696,Munoz Sanchez; Alicia,8,0,20,12
1715646358099,MAE 197,001,528363,Boechler; Nicholas Sebastia,9998,0,9999,1
1715646359126,MATH 197,001,523477,Kedlaya; Kiran S.,9994,0,9999,5
1715646359126,MATH 197,002,563811,Zhang; Danna,9994,0,9999,5
1715646359126,MATH 197,003,628552,Dumitriu; Ioana,9998,0,9999,1
1715646359126,MATH 197,004,660885,Floyd; Eric,9998,0,9999,1
1715646360152,MCWP 40R,A00,518780,Staff,1,0,20,19
1715646360152,MCWP 40R,B00,518781,Carter; Jennifer A,10,0,20,10
1715646360152,MCWP 40R,C00,518783,Smith; Haydee Marie,5,0,20,15
1715646361179,MCWP 50R,A00,518791,Redela; Pamela Morgan,0,1,20,20
1715646361179,MCWP 50R,B00,518792,Krone; Jarret,0,2,20,20
1715646361179,MCWP 50R,C00,518793,Staff,0,4,20,20
1715646361179,MCWP 50R,D00,518794,Morshed; Michael James,0,2,20,20
1715646361179,MCWP 50R,E00,518795,Carter; Andrea L,0,2,20,20
1715646361179,MCWP 50R,F00,518796,Miller; Elizabeth Deen,0,1,20,20
1715646361179,MCWP 50R,G00,518797,Guillen; Melinda,0,1,20,20
1715646362204,MMW 12R,A01,514034,Herbst; Matthew,0,2,16,16
1715646362204,MMW 12R,A02,514035,Herbst; Matthew,0,0,16,16
1715646363234,MMW 13R,A01,514037,Staff,0,5,16,16
1715646363234,MMW 13R,A02,514039,Staff,0,5,16,16
1715646363234,MMW 13R,A03,628519,Staff,0,4,16,16
1715646365289,SIO 295LS,A00,523233,Staff,10,0,30,20
1715646366316,SIO 295S,A00,523232,Staff,10,0,30,20
1715646367342,SIOC 290S,A01,637330,Merrifield; Mark A,21,0,30,9
1715646368368,SIOC 291S,A01,637333,Gabriel; Corey John,21,0,30,9
1715646369397,SOCI 117,A01,494376,Staff,0,5,5,5
1715646370421,WES 237B,A00,494380,Staff,10,0,20,10
1715646372495,AESE 279B,A00,494370,Wade; Jon P,0,0,33,33
1715646373524,AIP 97,001,660915,Van Den Einde; Yael Dahlia,9998,0,9999,1
1715646374553,AIP 197,001,627712,Vespa; Emanuel Ignacio,9995,0,9999,4
1715646374553,AIP 197,002,650778,Amir; On,9998,0,9999,1
1715646374553,AIP 197,003,650933,Avenancio-Leon; Carlos,9998,0,9999,1
1715646374553,AIP 197,004,658530,Heyman; Gail D.,9998,0,9999,1
1715646374553,AIP 197,005,658631,Neal; Sonya E,9998,0,9999,1
1715646374553,AIP 197,006,658671,Du; Songzi,9998,0,9999,1
1715646375581,ANAR 135S,A00,494369,Braswell; Geoffrey E.,0,0,0,0
1715646376611,BENG 196,001,628496,Engler; Adam J.,9998,0,9999,1
1715646376611,BENG 196,002,660916,Watson; John Thomas,9998,0,9999,1
1715646377642,BISP 197,001,650773,Wilhelm; James E.,9994,0,9999,5
1715646377642,BISP 197,002,658904,Coleman; Aaron B.,9998,0,9999,1
1715646378668,CAT 124RS,A01,519847,Geibel; William,0,0,20,20
1715646379693,CAT 125RS,A01,515971,Geibel; William,0,0,20,20
1715646380718,CLRE 250,A00,511389,Morris; Sheldon,9992,0,9999,7
1715646381746,CLRE 251,A00,507176,Mehta; Ravindra L.,9992,0,9999,7
1715646381746,CLRE 251,B00,511410,Mehta; Ravindra L.,9998,0,9999,1
1715646382772,CLRE 252,A00,507189,Cuomo; Raphael Eduardo,9994,0,9999,5
1715646383801,CLRE 253,A00,507199,Vaida; Florin,9994,0,9999,5
1715646383801,CLRE 253,B00,507202,Vaida; Florin,9999,0,9999,0
1715646384830,CLRE 259,A00,507211,Patel; Hemal,9996,0,9999,3
1715646385855,CLRE 260,A00,507221,Cuomo; Raphael Eduardo,9999,0,9999,0
1715646386879,CLRE 297,001,507242,Cuomo; Raphael Eduardo,9999,0,9999,0
1715646387907,COGS 197,001,638244,Voytek; Bradley Thomas,9997,0,9999,2
1715646388932,CSE 191,A00,516875,Minnes Kemp; Mor Mia,9991,0,9999,8
1715646389957,CSE 197,001,637388,Minnes Kemp; Mor Mia,9992,0,9999,7
1715646390984,CSS 201S,A01,494383,Mignozzetti; Umberto,35,0,35,0
1715646392008,CSS 202S,A01,494387,Mignozzetti; Umberto,35,0,35,0
1715646393038,DSC 197,001,628532,Eldridge; Justin Matthew,9995,0,9999,4
1715646394064,EAP 100,A00,516065,Staff,9799,0,9999,200
1715646395090,ECE 45,A01,507414,Staff,32,0,60,28
1715646397140,ECE 111,A01,507420,Staff,11,0,50,39
1715646398166,ECE 197,001,548057,Sievenpiper; Daniel F.,9991,0,9999,8
1715646399194,EDS 115,A00,507243,Choi; Bailey Miyeon,6,0,28,22
1715646400221,EDS 117,A01,494379,Staff,0,6,34,35
1715646401249,EDS 125,A00,507246,Hopkins; Megan Beth,7,0,30,23
1715646402279,EDS 128A,A01,507264,Fargason; Sharon Gayle,5,0,26,21
1715646403309,EDS 128B,A01,507293,Pappas; Elizabeth,9,0,30,21
1715646404333,EDS 139,A00,507294,Fargason; Sharon Gayle,9,0,30,21
1715646404333,EDS 139,B00,507313,Pappas; Elizabeth,9,0,30,21
1715646405361,EDS 201,A00,507315,Staff,10,0,30,20
1715646406388,EDS 203,A01,507317,Halter; Christopher P.,10,0,30,20
1715646407417,EDS 204R,A01,507319,Halter; Christopher P.,0,3,30,30
1715646407417,EDS 204R,B01,507331,Heinzman; Erica M.,14,0,30,16
1715646408445,EDS 206R,A00,507332,Staff,0,4,30,30
1715646408445,EDS 206R,B00,507343,Staff,15,0,30,15
1715646409475,EDS 250,A00,507344,Hemans; Patricia Ann Benitez,20,0,40,20
1715646410503,EDS 281,A00,507345,Daly; Alan J.,18,0,18,0
1715646411528,EDS 284,A00,507350,Daly; Alan J.,16,0,16,0
1715646412558,EDS 286,A00,507359,Fine; Sarah,18,0,18,0
1715646413585,EDS 289C,A01,507361,Daly; Alan J.,18,0,18,0
1715646414610,EDS 290,A00,507366,Hofstetter; Carolyn,15,0,15,0
1715646415691,LIGM 5A,A00,507421,Fischer-Grunski; Eva K,17,0,20,3
1715646416720,LIGM 5B,A00,507423,Fischer-Grunski; Eva K,19,0,20,1
1715646417749,LIGM 5C,A00,507425,Fischer-Grunski; Eva K,19,0,20,1
1715646418775,LIIT 5AS,A00,507427,Carnelos; Chiara,20,0,20,0
1715646419800,LIIT 5BS,A00,507430,Carnelos; Chiara,20,0,20,0
1715646420828,LIIT 5CS,A00,507432,Carnelos; Chiara,20,0,20,0
1715646421857,LISP 5A,A00,507541,Munoz Sanchez; Alicia,11,0,20,9
1715646422884,LISP 5B,A00,507671,Munoz Sanchez; Alicia,8,0,20,12
1715646423914,LISP 5C,A00,507696,Munoz Sanchez; Alicia,8,0,20,12
1715646424941,MAE 197,001,528363,Boechler; Nicholas Sebastia,9998,0,9999,1
1715646425968,MATH 197,001,523477,Kedlaya; Kiran S.,9994,0,9999,5
1715646425968,MATH 197,002,563811,Zhang; Danna,9994,0,9999,5
1715646425968,MATH 197,003,628552,Dumitriu; Ioana,9998,0,9999,1
1715646425968,MATH 197,004,660885,Floyd; Eric,9998,0,9999,1
1715646426996,MCWP 40R,A00,518780,Staff,1,0,20,19
1715646426996,MCWP 40R,B00,518781,Carter; Jennifer A,10,0,20,10
1715646426996,MCWP 40R,C00,518783,Smith; Haydee Marie,5,0,20,15
1715646428027,MCWP 50R,A00,518791,Redela; Pamela Morgan,0,1,20,20
1715646428027,MCWP 50R,B00,518792,Krone; Jarret,0,2,20,20
1715646428027,MCWP 50R,C00,518793,Staff,0,4,20,20
1715646428027,MCWP 50R,D00,518794,Morshed; Michael James,0,2,20,20
1715646428027,MCWP 50R,E00,518795,Carter; Andrea L,0,2,20,20
1715646428027,MCWP 50R,F00,518796,Miller; Elizabeth Deen,0,1,20,20
1715646428027,MCWP 50R,G00,518797,Guillen; Melinda,0,1,20,20
1715646429057,MMW 12R,A01,514034,Herbst; Matthew,0,2,16,16
1715646429057,MMW 12R,A02,514035,Herbst; Matthew,0,0,16,16
1715646430085,MMW 13R,A01,514037,Staff,0,5,16,16
1715646430085,MMW 13R,A02,514039,Staff,0,5,16,16
1715646430085,MMW 13R,A03,628519,Staff,0,4,16,16
1715646432137,SIO 295LS,A00,523233,Staff,10,0,30,20
1715646433165,SIO 295S,A00,523232,Staff,10,0,30,20
1715646434195,SIOC 290S,A01,637330,Merrifield; Mark A,21,0,30,9
1715646435224,SIOC 291S,A01,637333,Gabriel; Corey John,21,0,30,9
1715646436249,SOCI 117,A01,494376,Staff,0,5,5,5
1715646437276,WES 237B,A00,494380,Staff,10,0,20,10
1715646439344,AESE 279B,A00,494370,Wade; Jon P,0,0,33,33
1715646440369,AIP 97,001,660915,Van Den Einde; Yael Dahlia,9998,0,9999,1
1715646441400,AIP 197,001,627712,Vespa; Emanuel Ignacio,9995,0,9999,4
1715646441400,AIP 197,002,650778,Amir; On,9998,0,9999,1
1715646441400,AIP 197,003,650933,Avenancio-Leon; Carlos,9998,0,9999,1
1715646441400,AIP 197,004,658530,Heyman; Gail D.,9998,0,9999,1
1715646441400,AIP 197,005,658631,Neal; Sonya E,9998,0,9999,1
1715646441400,AIP 197,006,658671,Du; Songzi,9998,0,9999,1
1715646442426,ANAR 135S,A00,494369,Braswell; Geoffrey E.,0,0,0,0
1715646443456,BENG 196,001,628496,Engler; Adam J.,9998,0,9999,1
1715646443456,BENG 196,002,660916,Watson; John Thomas,9998,0,9999,1
1715646444483,BISP 197,001,650773,Wilhelm; James E.,9994,0,9999,5
1715646444483,BISP 197,002,658904,Coleman; Aaron B.,9998,0,9999,1
1715646445513,CAT 124RS,A01,519847,Geibel; William,0,0,20,20
1715646446541,CAT 125RS,A01,515971,Geibel; William,0,0,20,20
1715646447567,CLRE 250,A00,511389,Morris; Sheldon,9992,0,9999,7
1715646448593,CLRE 251,A00,507176,Mehta; Ravindra L.,9992,0,9999,7
1715646448593,CLRE 251,B00,511410,Mehta; Ravindra L.,9998,0,9999,1
1715646449624,CLRE 252,A00,507189,Cuomo; Raphael Eduardo,9994,0,9999,5
1715646450650,CLRE 253,A00,507199,Vaida; Florin,9994,0,9999,5
1715646450650,CLRE 253,B00,507202,Vaida; Florin,9999,0,9999,0
1715646451676,CLRE 259,A00,507211,Patel; Hemal,9996,0,9999,3
1715646452701,CLRE 260,A00,507221,Cuomo; Raphael Eduardo,9999,0,9999,0
1715646453727,CLRE 297,001,507242,Cuomo; Raphael Eduardo,9999,0,9999,0
1715646454753,COGS 197,001,638244,Voytek; Bradley Thomas,9997,0,9999,2
1715646455778,CSE 191,A00,516875,Minnes Kemp; Mor Mia,9991,0,9999,8
1715646456804,CSE 197,001,637388,Minnes Kemp; Mor Mia,9992,0,9999,7
1715646457830,CSS 201S,A01,494383,Mignozzetti; Umberto,35,0,35,0
1715646458857,CSS 202S,A01,494387,Mignozzetti; Umberto,35,0,35,0
1715646459884,DSC 197,001,628532,Eldridge; Justin Matthew,9995,0,9999,4
1715646460907,EAP 100,A00,516065,Staff,9799,0,9999,200
1715646461934,ECE 45,A01,507414,Staff,32,0,60,28
1715646463986,ECE 111,A01,507420,Staff,11,0,50,39
1715646465014,ECE 197,001,548057,Sievenpiper; Daniel F.,9991,0,9999,8
1715646466042,EDS 115,A00,507243,Choi; Bailey Miyeon,6,0,28,22
1715646467068,EDS 117,A01,494379,Staff,0,6,34,35
1715646468097,EDS 125,A00,507246,Hopkins; Megan Beth,7,0,30,23
1715646469127,EDS 128A,A01,507264,Fargason; Sharon Gayle,5,0,26,21
1715646470153,EDS 128B,A01,507293,Pappas; Elizabeth,9,0,30,21
1715646471180,EDS 139,A00,507294,Fargason; Sharon Gayle,9,0,30,21
1715646471180,EDS 139,B00,507313,Pappas; Elizabeth,9,0,30,21
1715646472206,EDS 201,A00,507315,Staff,10,0,30,20
1715646473236,EDS 203,A01,507317,Halter; Christopher P.,10,0,30,20
1715646474270,EDS 204R,A01,507319,Halter; Christopher P.,0,3,30,30
1715646474270,EDS 204R,B01,507331,Heinzman; Erica M.,14,0,30,16
1715646475294,EDS 206R,A00,507332,Staff,0,4,30,30
1715646475294,EDS 206R,B00,507343,Staff,15,0,30,15
1715646476322,EDS 250,A00,507344,Hemans; Patricia Ann Benitez,20,0,40,20
1715646477353,EDS 281,A00,507345,Daly; Alan J.,18,0,18,0
1715646478381,EDS 284,A00,507350,Daly; Alan J.,16,0,16,0
1715646479409,EDS 286,A00,507359,Fine; Sarah,18,0,18,0
1715646480437,EDS 289C,A01,507361,Daly; Alan J.,18,0,18,0
1715646481467,EDS 290,A00,507366,Hofstetter; Carolyn,15,0,15,0
1715646482492,LIGM 5A,A00,507421,Fischer-Grunski; Eva K,17,0,20,3
1715646483521,LIGM 5B,A00,507423,Fischer-Grunski; Eva K,19,0,20,1
1715646484547,LIGM 5C,A00,507425,Fischer-Grunski; Eva K,19,0,20,1
1715646485574,LIIT 5AS,A00,507427,Carnelos; Chiara,20,0,20,0
1715646486601,LIIT 5BS,A00,507430,Carnelos; Chiara,20,0,20,0
1715646487632,LIIT 5CS,A00,507432,Carnelos; Chiara,20,0,20,0
1715646488658,LISP 5A,A00,507541,Munoz Sanchez; Alicia,11,0,20,9
1715646489689,LISP 5B,A00,507671,Munoz Sanchez; Alicia,8,0,20,12
1715646490715,LISP 5C,A00,507696,Munoz Sanchez; Alicia,8,0,20,12
1715646491743,MAE 197,001,528363,Boechler; Nicholas Sebastia,9998,0,9999,1
1715646492779,MATH 197,001,523477,Kedlaya; Kiran S.,9994,0,9999,5
1715646492779,MATH 197,002,563811,Zhang; Danna,9994,0,9999,5
1715646492779,MATH 197,003,628552,Dumitriu; Ioana,9998,0,9999,1
1715646492779,MATH 197,004,660885,Floyd; Eric,9998,0,9999,1
1715646493809,MCWP 40R,A00,518780,Staff,1,0,20,19
1715646493809,MCWP 40R,B00,518781,Carter; Jennifer A,10,0,20,10
1715646493809,MCWP 40R,C00,518783,Smith; Haydee Marie,5,0,20,15
1715646494849,MCWP 50R,A00,518791,Redela; Pamela Morgan,0,1,20,20
1715646494849,MCWP 50R,B00,518792,Krone; Jarret,0,2,20,20
1715646494849,MCWP 50R,C00,518793,Staff,0,4,20,20
1715646494849,MCWP 50R,D00,518794,Morshed; Michael James,0,2,20,20
1715646494849,MCWP 50R,E00,518795,Carter; Andrea L,0,2,20,20
1715646494849,MCWP 50R,F00,518796,Miller; Elizabeth Deen,0,1,20,20
1715646494849,MCWP 50R,G00,518797,Guillen; Melinda,0,1,20,20
1715646495879,MMW 12R,A01,514034,Herbst; Matthew,0,2,16,16
1715646495879,MMW 12R,A02,514035,Herbst; Matthew,0,0,16,16
1715646496906,MMW 13R,A01,514037,Staff,0,5,16,16
1715646496906,MMW 13R,A02,514039,Staff,0,5,16,16
1715646496906,MMW 13R,A03,628519,Staff,0,4,16,16
1715646498959,SIO 295LS,A00,523233,Staff,10,0,30,20
1715646499983,SIO 295S,A00,523232,Staff,10,0,30,20
1715646501021,SIOC 290S,A01,637330,Merrifield; Mark A,21,0,30,9
1715646502047,SIOC 291S,A01,637333,Gabriel; Corey John,21,0,30,9
1715646503078,SOCI 117,A01,494376,Staff,0,5,5,5
1715646504104,WES 237B,A00,494380,Staff,10,0,20,10
1715646506182,AESE 279B,A00,494370,Wade; Jon P,0,0,33,33
1715646507210,AIP 97,001,660915,Van Den Einde; Yael Dahlia,9998,0,9999,1
1715646508246,AIP 197,001,627712,Vespa; Emanuel Ignacio,9995,0,9999,4
1715646508246,AIP 197,002,650778,Amir; On,9998,0,9999,1
1715646508246,AIP 197,003,650933,Avenancio-Leon; Carlos,9998,0,9999,1
1715646508246,AIP 197,004,658530,Heyman; Gail D.,9998,0,9999,1
1715646508246,AIP 197,005,658631,Neal; Sonya E,9998,0,9999,1
1715646508246,AIP 197,006,658671,Du; Songzi,9998,0,9999,1
1715646509272,ANAR 135S,A00,494369,Braswell; Geoffrey E.,0,0,0,0
1715646510298,BENG 196,001,628496,Engler; Adam J.,9998,0,9999,1
1715646510298,BENG 196,002,660916,Watson; John Thomas,9998,0,9999,1
1715646511322,BISP 197,001,650773,Wilhelm; James E.,9994,0,9999,5
1715646511322,BISP 197,002,658904,Coleman; Aaron B.,9998,0,9999,1
1715646512350,CAT 124RS,A01,519847,Geibel; William,0,0,20,20
1715646513376,CAT 125RS,A01,515971,Geibel; William,0,0,20,20
1715646514407,CLRE 250,A00,511389,Morris; Sheldon,9992,0,9999,7
1715646515434,CLRE 251,A00,507176,Mehta; Ravindra L.,9992,0,9999,7
1715646515434,CLRE 251,B00,511410,Mehta; Ravindra L.,9998,0,9999,1
1715646516461,CLRE 252,A00,507189,Cuomo; Raphael Eduardo,9994,0,9999,5
1715646517493,CLRE 253,A00,507199,Vaida; Florin,9994,0,9999,5
1715646517493,CLRE 253,B00,507202,Vaida; Florin,9999,0,9999,0
1715646518518,CLRE 259,A00,507211,Patel; Hemal,9996,0,9999,3
1715646519546,CLRE 260,A00,507221,Cuomo; Raphael Eduardo,9999,0,9999,0
1715646520573,CLRE 297,001,507242,Cuomo; Raphael Eduardo,9999,0,9999,0
1715646521603,COGS 197,001,638244,Voytek; Bradley Thomas,9997,0,9999,2
1715646533394,CSE 191,A00,516875,Minnes Kemp; Mor Mia,9991,0,9999,8
1715646534426,CSE 197,001,637388,Minnes Kemp; Mor Mia,9992,0,9999,7
1715646535464,CSS 201S,A01,494383,Mignozzetti; Umberto,35,0,35,0
1715646536499,CSS 202S,A01,494387,Mignozzetti; Umberto,35,0,35,0
1715646537525,DSC 197,001,628532,Eldridge; Justin Matthew,9995,0,9999,4
1715646538553,EAP 100,A00,516065,Staff,9799,0,9999,200
1715646539587,ECE 45,A01,507414,Staff,32,0,60,28
1715646541658,ECE 111,A01,507420,Staff,11,0,50,39
1715646542684,ECE 197,001,548057,Sievenpiper; Daniel F.,9991,0,9999,8
1715646543709,EDS 115,A00,507243,Choi; Bailey Miyeon,6,0,28,22
1715646544732,EDS 117,A01,494379,Staff,0,6,34,35
1715646545757,EDS 125,A00,507246,Hopkins; Megan Beth,7,0,30,23
1715646546781,EDS 128A,A01,507264,Fargason; Sharon Gayle,5,0,26,21
1715646547805,EDS 128B,A01,507293,Pappas; Elizabeth,9,0,30,21
1715646548828,EDS 139,A00,507294,Fargason; Sharon Gayle,9,0,30,21
1715646548828,EDS 139,B00,507313,Pappas; Elizabeth,9,0,30,21
1715646549853,EDS 201,A00,507315,Staff,10,0,30,20
1715646550880,EDS 203,A01,507317,Halter; Christopher P.,10,0,30,20
1715646551905,EDS 204R,A01,507319,Halter; Christopher P.,0,3,30,30
1715646551905,EDS 204R,B01,507331,Heinzman; Erica M.,14,0,30,16
1715646552930,EDS 206R,A00,507332,Staff,0,4,30,30
1715646552930,EDS 206R,B00,507343,Staff,15,0,30,15
1715646553958,EDS 250,A00,507344,Hemans; Patricia Ann Benitez,20,0,40,20
1715646554983,EDS 281,A00,507345,Daly; Alan J.,18,0,18,0
1715646556011,EDS 284,A00,507350,Daly; Alan J.,16,0,16,0
1715646557040,EDS 286,A00,507359,Fine; Sarah,18,0,18,0
1715646558070,EDS 289C,A01,507361,Daly; Alan J.,18,0,18,0
1715646559096,EDS 290,A00,507366,Hofstetter; Carolyn,15,0,15,0
1715646560122,LIGM 5A,A00,507421,Fischer-Grunski; Eva K,17,0,20,3
1715646561150,LIGM 5B,A00,507423,Fischer-Grunski; Eva K,19,0,20,1
1715646562174,LIGM 5C,A00,507425,Fischer-Grunski; Eva K,19,0,20,1
1715646563200,LIIT 5AS,A00,507427,Carnelos; Chiara,20,0,20,0
1715646564227,LIIT 5BS,A00,507430,Carnelos; Chiara,20,0,20,0
1715646565252,LIIT 5CS,A00,507432,Carnelos; Chiara,20,0,20,0
1715646566278,LISP 5A,A00,507541,Munoz Sanchez; Alicia,11,0,20,9
1715646567304,LISP 5B,A00,507671,Munoz Sanchez; Alicia,8,0,20,12
1715646568330,LISP 5C,A00,507696,Munoz Sanchez; Alicia,8,0,20,12
1715646569359,MAE 197,001,528363,Boechler; Nicholas Sebastia,9998,0,9999,1
1715646570386,MATH 197,001,523477,Kedlaya; Kiran S.,9994,0,9999,5
1715646570386,MATH 197,002,563811,Zhang; Danna,9994,0,9999,5
1715646570386,MATH 197,003,628552,Dumitriu; Ioana,9998,0,9999,1
1715646570386,MATH 197,004,660885,Floyd; Eric,9998,0,9999,1
1715646571412,MCWP 40R,A00,518780,Staff,1,0,20,19
1715646571412,MCWP 40R,B00,518781,Carter; Jennifer A,10,0,20,10
1715646571412,MCWP 40R,C00,518783,Smith; Haydee Marie,5,0,20,15
1715646572439,MCWP 50R,A00,518791,Redela; Pamela Morgan,0,1,20,20
1715646572439,MCWP 50R,B00,518792,Krone; Jarret,0,2,20,20
1715646572439,MCWP 50R,C00,518793,Staff,0,4,20,20
1715646572439,MCWP 50R,D00,518794,Morshed; Michael James,0,2,20,20
1715646572439,MCWP 50R,E00,518795,Carter; Andrea L,0,2,20,20
1715646572439,MCWP 50R,F00,518796,Miller; Elizabeth Deen,0,1,20,20
1715646572439,MCWP 50R,G00,518797,Guillen; Melinda,0,1,20,20
1715646573464,MMW 12R,A01,514034,Herbst; Matthew,0,2,16,16
1715646573464,MMW 12R,A02,514035,Herbst; Matthew,0,0,16,16
1715646574490,MMW 13R,A01,514037,Staff,0,5,16,16
1715646574490,MMW 13R,A02,514039,Staff,0,5,16,16
1715646574490,MMW 13R,A03,628519,Staff,0,4,16,16
1715646576542,SIO 295LS,A00,523233,Staff,10,0,30,20
1715646577567,SIO 295S,A00,523232,Staff,10,0,30,20
1715646578594,SIOC 290S,A01,637330,Merrifield; Mark A,21,0,30,9
1715646579621,SIOC 291S,A01,637333,Gabriel; Corey John,21,0,30,9
1715646580648,SOCI 117,A01,494376,Staff,0,5,5,5
1715646581673,WES 237B,A00,494380,Staff,10,0,20,10
1715646583744,AESE 279B,A00,494370,Wade; Jon P,0,0,33,33
1715646584770,AIP 97,001,660915,Van Den Einde; Yael Dahlia,9998,0,9999,1
1715646585801,AIP 197,001,627712,Vespa; Emanuel Ignacio,9995,0,9999,4
1715646585801,AIP 197,002,650778,Amir; On,9998,0,9999,1
1715646585801,AIP 197,003,650933,Avenancio-Leon; Carlos,9998,0,9999,1
1715646585801,AIP 197,004,658530,Heyman; Gail D.,9998,0,9999,1
1715646585801,AIP 197,005,658631,Neal; Sonya E,9998,0,9999,1
1715646585801,AIP 197,006,658671,Du; Songzi,9998,0,9999,1
1715646586829,ANAR 135S,A00,494369,Braswell; Geoffrey E.,0,0,0,0
1715646587856,BENG 196,001,628496,Engler; Adam J.,9998,0,9999,1
1715646587856,BENG 196,002,660916,Watson; John Thomas,9998,0,9999,1
1715646588882,BISP 197,001,650773,Wilhelm; James E.,9994,0,9999,5
1715646588882,BISP 197,002,658904,Coleman; Aaron B.,9998,0,9999,1
1715646589906,CAT 124RS,A01,519847,Geibel; William,0,0,20,20
1715646590930,CAT 125RS,A01,515971,Geibel; William,0,0,20,20
1715646591959,CLRE 250,A00,511389,Morris; Sheldon,9992,0,9999,7
1715646592990,CLRE 251,A00,507176,Mehta; Ravindra L.,9992,0,9999,7
1715646592990,CLRE 251,B00,511410,Mehta; Ravindra L.,9998,0,9999,1
1715646594020,CLRE 252,A00,507189,Cuomo; Raphael Eduardo,9994,0,9999,5
1715646595052,CLRE 253,A00,507199,Vaida; Florin,9994,0,9999,5
1715646595052,CLRE 253,B00,507202,Vaida; Florin,9999,0,9999,0
1715646596076,CLRE 259,A00,507211,Patel; Hemal,9996,0,9999,3
1715646597109,CLRE 260,A00,507221,Cuomo; Raphael Eduardo,9999,0,9999,0
1715646598135,CLRE 297,001,507242,Cuomo; Raphael Eduardo,9999,0,9999,0
1715646599161,COGS 197,001,638244,Voytek; Bradley Thomas,9997,0,9999,2
1715646600192,CSE 191,A00,516875,Minnes Kemp; Mor Mia,9991,0,9999,8
1715646601216,CSE 197,001,637388,Minnes Kemp; Mor Mia,9992,0,9999,7
1715646602249,CSS 201S,A01,494383,Mignozzetti; Umberto,35,0,35,0
1715646603278,CSS 202S,A01,494387,Mignozzetti; Umberto,35,0,35,0
1715646604305,DSC 197,001,628532,Eldridge; Justin Matthew,9995,0,9999,4
1715646605332,EAP 100,A00,516065,Staff,9799,0,9999,200
1715646606362,ECE 45,A01,507414,Staff,32,0,60,28
1715646608414,ECE 111,A01,507420,Staff,11,0,50,39
1715646609443,ECE 197,001,548057,Sievenpiper; Daniel F.,9991,0,9999,8
1715646610471,EDS 115,A00,507243,Choi; Bailey Miyeon,6,0,28,22
1715646611496,EDS 117,A01,494379,Staff,0,6,34,35
1715646612525,EDS 125,A00,507246,Hopkins; Megan Beth,7,0,30,23
1715646613550,EDS 128A,A01,507264,Fargason; Sharon Gayle,5,0,26,21
1715646614578,EDS 128B,A01,507293,Pappas; Elizabeth,9,0,30,21
1715646615603,EDS 139,A00,507294,Fargason; Sharon Gayle,9,0,30,21
1715646615603,EDS 139,B00,507313,Pappas; Elizabeth,9,0,30,21
1715646616627,EDS 201,A00,507315,Staff,10,0,30,20
1715646617651,EDS 203,A01,507317,Halter; Christopher P.,10,0,30,20
1715646618682,EDS 204R,A01,507319,Halter; Christopher P.,0,3,30,30
1715646618682,EDS 204R,B01,507331,Heinzman; Erica M.,14,0,30,16
1715646619710,EDS 206R,A00,507332,Staff,0,4,30,30
1715646619710,EDS 206R,B00,507343,Staff,15,0,30,15
1715646620741,EDS 250,A00,507344,Hemans; Patricia Ann Benitez,20,0,40,20
1715646621766,EDS 281,A00,507345,Daly; Alan J.,18,0,18,0
1715646622793,EDS 284,A00,507350,Daly; Alan J.,16,0,16,0
1715646623821,EDS 286,A00,507359,Fine; Sarah,18,0,18,0
1715646624846,EDS 289C,A01,507361,Daly; Alan J.,18,0,18,0
1715646625876,EDS 290,A00,507366,Hofstetter; Carolyn,15,0,15,0
1715646626902,LIGM 5A,A00,507421,Fischer-Grunski; Eva K,17,0,20,3
1715646627928,LIGM 5B,A00,507423,Fischer-Grunski; Eva K,19,0,20,1
1715646628953,LIGM 5C,A00,507425,Fischer-Grunski; Eva K,19,0,20,1
1715646630111,LIIT 5AS,A00,507427,Carnelos; Chiara,20,0,20,0
1715646631138,LIIT 5BS,A00,507430,Carnelos; Chiara,20,0,20,0
1715646632163,LIIT 5CS,A00,507432,Carnelos; Chiara,20,0,20,0
1715646633188,LISP 5A,A00,507541,Munoz Sanchez; Alicia,11,0,20,9
1715646634213,LISP 5B,A00,507671,Munoz Sanchez; Alicia,8,0,20,12
1715646635241,LISP 5C,A00,507696,Munoz Sanchez; Alicia,8,0,20,12
1715646636266,MAE 197,001,528363,Boechler; Nicholas Sebastia,9998,0,9999,1
1715646637293,MATH 197,001,523477,Kedlaya; Kiran S.,9994,0,9999,5
1715646637293,MATH 197,002,563811,Zhang; Danna,9994,0,9999,5
1715646637293,MATH 197,003,628552,Dumitriu; Ioana,9998,0,9999,1
1715646637293,MATH 197,004,660885,Floyd; Eric,9998,0,9999,1
1715646638319,MCWP 40R,A00,518780,Staff,1,0,20,19
1715646638319,MCWP 40R,B00,518781,Carter; Jennifer A,10,0,20,10
1715646638319,MCWP 40R,C00,518783,Smith; Haydee Marie,5,0,20,15
1715646639346,MCWP 50R,A00,518791,Redela; Pamela Morgan,0,1,20,20
1715646639346,MCWP 50R,B00,518792,Krone; Jarret,0,2,20,20
1715646639346,MCWP 50R,C00,518793,Staff,0,4,20,20
1715646639346,MCWP 50R,D00,518794,Morshed; Michael James,0,2,20,20
1715646639346,MCWP 50R,E00,518795,Carter; Andrea L,0,2,20,20
1715646639346,MCWP 50R,F00,518796,Miller; Elizabeth Deen,0,1,20,20
1715646639346,MCWP 50R,G00,518797,Guillen; Melinda,0,1,20,20
1715646640371,MMW 12R,A01,514034,Herbst; Matthew,0,2,16,16
1715646640371,MMW 12R,A02,514035,Herbst; Matthew,0,0,16,16
1715646641399,MMW 13R,A01,514037,Staff,0,5,16,16
1715646641399,MMW 13R,A02,514039,Staff,0,5,16,16
1715646641399,MMW 13R,A03,628519,Staff,0,4,16,16
1715646643450,SIO 295LS,A00,523233,Staff,10,0,30,20
1715646644474,SIO 295S,A00,523232,Staff,10,0,30,20
1715646645502,SIOC 290S,A01,637330,Merrifield; Mark A,21,0,30,9
1715646646527,SIOC 291S,A01,637333,Gabriel; Corey John,21,0,30,9
1715646647585,SOCI 117,A01,494376,Staff,0,5,5,5
1715646648612,WES 237B,A00,494380,Staff,10,0,20,10
1715646650695,AESE 279B,A00,494370,Wade; Jon P,0,0,33,33
1715646651721,AIP 97,001,660915,Van Den Einde; Yael Dahlia,9998,0,9999,1
1715646652749,AIP 197,001,627712,Vespa; Emanuel Ignacio,9995,0,9999,4
1715646652749,AIP 197,002,650778,Amir; On,9998,0,9999,1
1715646652749,AIP 197,003,650933,Avenancio-Leon; Carlos,9998,0,9999,1
1715646652749,AIP 197,004,658530,Heyman; Gail D.,9998,0,9999,1
1715646652749,AIP 197,005,658631,Neal; Sonya E,9998,0,9999,1
1715646652749,AIP 197,006,658671,Du; Songzi,9998,0,9999,1
1715646653778,ANAR 135S,A00,494369,Braswell; Geoffrey E.,0,0,0,0
1715646654804,BENG 196,001,628496,Engler; Adam J.,9998,0,9999,1
1715646654804,BENG 196,002,660916,Watson; John Thomas,9998,0,9999,1
1715646655830,BISP 197,001,650773,Wilhelm; James E.,9994,0,9999,5
1715646655830,BISP 197,002,658904,Coleman; Aaron B.,9998,0,9999,1
1715646656855,CAT 124RS,A01,519847,Geibel; William,0,0,20,20
1715646657880,CAT 125RS,A01,515971,Geibel; William,0,0,20,20
1715646658904,CLRE 250,A00,511389,Morris; Sheldon,9992,0,9999,7
1715646659932,CLRE 251,A00,507176,Mehta; Ravindra L.,9992,0,9999,7
1715646659932,CLRE 251,B00,511410,Mehta; Ravindra L.,9998,0,9999,1
1715646660958,CLRE 252,A00,507189,Cuomo; Raphael Eduardo,9994,0,9999,5
1715646661984,CLRE 253,A00,507199,Vaida; Florin,9994,0,9999,5
1715646661984,CLRE 253,B00,507202,Vaida; Florin,9999,0,9999,0
1715646663015,CLRE 259,A00,507211,Patel; Hemal,9996,0,9999,3
1715646664039,CLRE 260,A00,507221,Cuomo; Raphael Eduardo,9999,0,9999,0
1715646665065,CLRE 297,001,507242,Cuomo; Raphael Eduardo,9999,0,9999,0
1715646666092,COGS 197,001,638244,Voytek; Bradley Thomas,9997,0,9999,2
1715646667130,CSE 191,A00,516875,Minnes Kemp; Mor Mia,9991,0,9999,8
1715646668154,CSE 197,001,637388,Minnes Kemp; Mor Mia,9992,0,9999,7
1715646669179,CSS 201S,A01,494383,Mignozzetti; Umberto,35,0,35,0
1715646670203,CSS 202S,A01,494387,Mignozzetti; Umberto,35,0,35,0
1715646671231,DSC 197,001,628532,Eldridge; Justin Matthew,9995,0,9999,4
1715646672257,EAP 100,A00,516065,Staff,9799,0,9999,200
1715646673284,ECE 45,A01,507414,Staff,32,0,60,28
1715646675333,ECE 111,A01,507420,Staff,11,0,50,39
1715646676360,ECE 197,001,548057,Sievenpiper; Daniel F.,9991,0,9999,8
1715646677432,EDS 115,A00,507243,Choi; Bailey Miyeon,6,0,28,22
1715646678462,EDS 117,A01,494379,Staff,0,6,34,35
1715646679489,EDS 125,A00,507246,Hopkins; Megan Beth,7,0,30,23
1715646680523,EDS 128A,A01,507264,Fargason; Sharon Gayle,5,0,26,21
1715646681549,EDS 128B,A01,507293,Pappas; Elizabeth,9,0,30,21
1715646682576,EDS 139,A00,507294,Fargason; Sharon Gayle,9,0,30,21
1715646682576,EDS 139,B00,507313,Pappas; Elizabeth,9,0,30,21
1715646683604,EDS 201,A00,507315,Staff,10,0,30,20
1715646684632,EDS 203,A01,507317,Halter; Christopher P.,10,0,30,20
1715646685660,EDS 204R,A01,507319,Halter; Christopher P.,0,3,30,30
1715646685660,EDS 204R,B01,507331,Heinzman; Erica M.,14,0,30,16
1715646686686,EDS 206R,A00,507332,Staff,0,4,30,30
1715646686686,EDS 206R,B00,507343,Staff,15,0,30,15
1715646687715,EDS 250,A00,507344,Hemans; Patricia Ann Benitez,20,0,40,20
1715646688741,EDS 281,A00,507345,Daly; Alan J.,18,0,18,0
1715646689765,EDS 284,A00,507350,Daly; Alan J.,16,0,16,0
1715646690789,EDS 286,A00,507359,Fine; Sarah,18,0,18,0
1715646691815,EDS 289C,A01,507361,Daly; Alan J.,18,0,18,0
1715646692844,EDS 290,A00,507366,Hofstetter; Carolyn,15,0,15,0
1715646693875,LIGM 5A,A00,507421,Fischer-Grunski; Eva K,17,0,20,3
1715646694900,LIGM 5B,A00,507423,Fischer-Grunski; Eva K,19,0,20,1
1715646695929,LIGM 5C,A00,507425,Fischer-Grunski; Eva K,19,0,20,1
1715646696955,LIIT 5AS,A00,507427,Carnelos; Chiara,20,0,20,0
1715646697983,LIIT 5BS,A00,507430,Carnelos; Chiara,20,0,20,0
1715646699011,LIIT 5CS,A00,507432,Carnelos; Chiara,20,0,20,0
1715646700037,LISP 5A,A00,507541,Munoz Sanchez; Alicia,11,0,20,9
1715646701065,LISP 5B,A00,507671,Munoz Sanchez; Alicia,8,0,20,12
1715646702091,LISP 5C,A00,507696,Munoz Sanchez; Alicia,8,0,20,12
1715646703116,MAE 197,001,528363,Boechler; Nicholas Sebastia,9998,0,9999,1
1715646704206,MATH 197,001,523477,Kedlaya; Kiran S.,9994,0,9999,5
1715646704206,MATH 197,002,563811,Zhang; Danna,9994,0,9999,5
1715646704206,MATH 197,003,628552,Dumitriu; Ioana,9998,0,9999,1
1715646704206,MATH 197,004,660885,Floyd; Eric,9998,0,9999,1
1715646705233,MCWP 40R,A00,518780,Staff,1,0,20,19
1715646705233,MCWP 40R,B00,518781,Carter; Jennifer A,10,0,20,10
1715646705233,MCWP 40R,C00,518783,Smith; Haydee Marie,5,0,20,15
1715646706261,MCWP 50R,A00,518791,Redela; Pamela Morgan,0,1,20,20
1715646706261,MCWP 50R,B00,518792,Krone; Jarret,0,2,20,20
1715646706261,MCWP 50R,C00,518793,Staff,0,4,20,20
1715646706261,MCWP 50R,D00,518794,Morshed; Michael James,0,2,20,20
1715646706261,MCWP 50R,E00,518795,Carter; Andrea L,0,2,20,20
1715646706261,MCWP 50R,F00,518796,Miller; Elizabeth Deen,0,1,20,20
1715646706261,MCWP 50R,G00,518797,Guillen; Melinda,0,1,20,20
1715646707290,MMW 12R,A01,514034,Herbst; Matthew,0,2,16,16
1715646707290,MMW 12R,A02,514035,Herbst; Matthew,0,0,16,16
1715646708318,MMW 13R,A01,514037,Staff,0,5,16,16
1715646708318,MMW 13R,A02,514039,Staff,0,5,16,16
1715646708318,MMW 13R,A03,628519,Staff,0,4,16,16
1715646710369,SIO 295LS,A00,523233,Staff,10,0,30,20
1715646711395,SIO 295S,A00,523232,Staff,10,0,30,20
1715646712420,SIOC 290S,A01,637330,Merrifield; Mark A,21,0,30,9
1715646713448,SIOC 291S,A01,637333,Gabriel; Corey John,21,0,30,9
1715646714476,SOCI 117,A01,494376,Staff,0,5,5,5
1715646715503,WES 237B,A00,494380,Staff,10,0,20,10
1715646717575,AESE 279B,A00,494370,Wade; Jon P,0,0,33,33
1715646718601,AIP 97,001,660915,Van Den Einde; Yael Dahlia,9998,0,9999,1
1715646719630,AIP 197,001,627712,Vespa; Emanuel Ignacio,9995,0,9999,4
1715646719630,AIP 197,002,650778,Amir; On,9998,0,9999,1
1715646719630,AIP 197,003,650933,Avenancio-Leon; Carlos,9998,0,9999,1
1715646719630,AIP 197,004,658530,Heyman; Gail D.,9998,0,9999,1
1715646719630,AIP 197,005,658631,Neal; Sonya E,9998,0,9999,1
1715646719630,AIP 197,006,658671,Du; Songzi,9998,0,9999,1
1715646720656,ANAR 135S,A00,494369,Braswell; Geoffrey E.,0,0,0,0
1715646721683,BENG 196,001,628496,Engler; Adam J.,9998,0,9999,1
1715646721683,BENG 196,002,660916,Watson; John Thomas,9998,0,9999,1
1715646722709,BISP 197,001,650773,Wilhelm; James E.,9994,0,9999,5
1715646722709,BISP 197,002,658904,Coleman; Aaron B.,9998,0,9999,1
1715646723735,CAT 124RS,A01,519847,Geibel; William,0,0,20,20
1715646724762,CAT 125RS,A01,515971,Geibel; William,0,0,20,20
1715646725791,CLRE 250,A00,511389,Morris; Sheldon,9992,0,9999,7
1715646726819,CLRE 251,A00,507176,Mehta; Ravindra L.,9992,0,9999,7
1715646726819,CLRE 251,B00,511410,Mehta; Ravindra L.,9998,0,9999,1
1715646727844,CLRE 252,A00,507189,Cuomo; Raphael Eduardo,9994,0,9999,5
1715646728872,CLRE 253,A00,507199,Vaida; Florin,9994,0,9999,5
1715646728872,CLRE 253,B00,507202,Vaida; Florin,9999,0,9999,0
1715646729900,CLRE 259,A00,507211,Patel; Hemal,9996,0,9999,3
1715646730925,CLRE 260,A00,507221,Cuomo; Raphael Eduardo,9999,0,9999,0
1715646731952,CLRE 297,001,507242,Cuomo; Raphael Eduardo,9999,0,9999,0
1715646732980,COGS 197,001,638244,Voytek; Bradley Thomas,9997,0,9999,2
1715646734008,CSE 191,A00,516875,Minnes Kemp; Mor Mia,9991,0,9999,8
1715646735034,CSE 197,001,637388,Minnes Kemp; Mor Mia,9992,0,9999,7
1715646736060,CSS 201S,A01,494383,Mignozzetti; Umberto,35,0,35,0
1715646737084,CSS 202S,A01,494387,Mignozzetti; Umberto,35,0,35,0
1715646738110,DSC 197,001,628532,Eldridge; Justin Matthew,9995,0,9999,4
1715646739134,EAP 100,A00,516065,Staff,9799,0,9999,200
1715646740162,ECE 45,A01,507414,Staff,32,0,60,28
1715646742216,ECE 111,A01,507420,Staff,11,0,50,39
1715646743243,ECE 197,001,548057,Sievenpiper; Daniel F.,9991,0,9999,8
1715646744268,EDS 115,A00,507243,Choi; Bailey Miyeon,6,0,28,22
1715646745293,EDS 117,A01,494379,Staff,0,6,34,35
1715646746321,EDS 125,A00,507246,Hopkins; Megan Beth,7,0,30,23
1715646747349,EDS 128A,A01,507264,Fargason; Sharon Gayle,5,0,26,21
1715646748378,EDS 128B,A01,507293,Pappas; Elizabeth,9,0,30,21
1715646749406,EDS 139,A00,507294,Fargason; Sharon Gayle,9,0,30,21
1715646749406,EDS 139,B00,507313,Pappas; Elizabeth,9,0,30,21
1715646750431,EDS 201,A00,507315,Staff,10,0,30,20
1715646751460,EDS 203,A01,507317,Halter; Christopher P.,10,0,30,20
1715646752490,EDS 204R,A01,507319,Halter; Christopher P.,0,3,30,30
1715646752490,EDS 204R,B01,507331,Heinzman; Erica M.,14,0,30,16
1715646753518,EDS 206R,A00,507332,Staff,0,4,30,30
1715646753518,EDS 206R,B00,507343,Staff,15,0,30,15
1715646754547,EDS 250,A00,507344,Hemans; Patricia Ann Benitez,20,0,40,20
1715646755572,EDS 281,A00,507345,Daly; Alan J.,18,0,18,0
1715646756597,EDS 284,A00,507350,Daly; Alan J.,16,0,16,0
1715646757622,EDS 286,A00,507359,Fine; Sarah,18,0,18,0
1715646758650,EDS 289C,A01,507361,Daly; Alan J.,18,0,18,0
1715646759678,EDS 290,A00,507366,Hofstetter; Carolyn,15,0,15,0
1715646760704,LIGM 5A,A00,507421,Fischer-Grunski; Eva K,17,0,20,3
1715646761734,LIGM 5B,A00,507423,Fischer-Grunski; Eva K,19,0,20,1
1715646762762,LIGM 5C,A00,507425,Fischer-Grunski; Eva K,19,0,20,1
1715646763789,LIIT 5AS,A00,507427,Carnelos; Chiara,20,0,20,0
1715646764821,LIIT 5BS,A00,507430,Carnelos; Chiara,20,0,20,0
1715646765846,LIIT 5CS,A00,507432,Carnelos; Chiara,20,0,20,0
1715646766873,LISP 5A,A00,507541,Munoz Sanchez; Alicia,11,0,20,9
1715646767899,LISP 5B,A00,507671,Munoz Sanchez; Alicia,8,0,20,12
1715646768927,LISP 5C,A00,507696,Munoz Sanchez; Alicia,8,0,20,12
1715646769953,MAE 197,001,528363,Boechler; Nicholas Sebastia,9998,0,9999,1
1715646770986,MATH 197,001,523477,Kedlaya; Kiran S.,9994,0,9999,5
1715646770986,MATH 197,002,563811,Zhang; Danna,9994,0,9999,5
1715646770986,MATH 197,003,628552,Dumitriu; Ioana,9998,0,9999,1
1715646770986,MATH 197,004,660885,Floyd; Eric,9998,0,9999,1
1715646772012,MCWP 40R,A00,518780,Staff,1,0,20,19
1715646772012,MCWP 40R,B00,518781,Carter; Jennifer A,10,0,20,10
1715646772012,MCWP 40R,C00,518783,Smith; Haydee Marie,5,0,20,15
1715646773042,MCWP 50R,A00,518791,Redela; Pamela Morgan,0,1,20,20
1715646773042,MCWP 50R,B00,518792,Krone; Jarret,0,2,20,20
1715646773042,MCWP 50R,C00,518793,Staff,0,4,20,20
1715646773042,MCWP 50R,D00,518794,Morshed; Michael James,0,2,20,20
1715646773042,MCWP 50R,E00,518795,Carter; Andrea L,0,2,20,20
1715646773042,MCWP 50R,F00,518796,Miller; Elizabeth Deen,0,1,20,20
1715646773042,MCWP 50R,G00,518797,Guillen; Melinda,0,1,20,20
1715646774070,MMW 12R,A01,514034,Herbst; Matthew,0,2,16,16
1715646774070,MMW 12R,A02,514035,Herbst; Matthew,0,0,16,16
1715646775098,MMW 13R,A01,514037,Staff,0,5,16,16
1715646775098,MMW 13R,A02,514039,Staff,0,5,16,16
1715646775098,MMW 13R,A03,628519,Staff,0,4,16,16
1715646777149,SIO 295LS,A00,523233,Staff,10,0,30,20
1715646778177,SIO 295S,A00,523232,Staff,10,0,30,20
1715646779216,SIOC 290S,A01,637330,Merrifield; Mark A,21,0,30,9
1715646780245,SIOC 291S,A01,637333,Gabriel; Corey John,21,0,30,9
1715646781270,SOCI 117,A01,494376,Staff,0,5,5,5
1715646782302,WES 237B,A00,494380,Staff,10,0,20,10
1715646784374,AESE 279B,A00,494370,Wade; Jon P,0,0,33,33
1715646785399,AIP 97,001,660915,Van Den Einde; Yael Dahlia,9998,0,9999,1
1715646786427,AIP 197,001,627712,Vespa; Emanuel Ignacio,9995,0,9999,4
1715646786427,AIP 197,002,650778,Amir; On,9998,0,9999,1
1715646786427,AIP 197,003,650933,Avenancio-Leon; Carlos,9998,0,9999,1
1715646786427,AIP 197,004,658530,Heyman; Gail D.,9998,0,9999,1
1715646786427,AIP 197,005,658631,Neal; Sonya E,9998,0,9999,1
1715646786427,AIP 197,006,658671,Du; Songzi,9998,0,9999,1
1715646787456,ANAR 135S,A00,494369,Braswell; Geoffrey E.,0,0,0,0
1715646788485,BENG 196,001,628496,Engler; Adam J.,9998,0,9999,1
1715646788485,BENG 196,002,660916,Watson; John Thomas,9998,0,9999,1
1715646789513,BISP 197,001,650773,Wilhelm; James E.,9994,0,9999,5
1715646789513,BISP 197,002,658904,Coleman; Aaron B.,9998,0,9999,1
1715646790540,CAT 124RS,A01,519847,Geibel; William,0,0,20,20
1715646791565,CAT 125RS,A01,515971,Geibel; William,0,0,20,20
1715646792591,CLRE 250,A00,511389,Morris; Sheldon,9992,0,9999,7
1715646793616,CLRE 251,A00,507176,Mehta; Ravindra L.,9992,0,9999,7
1715646793616,CLRE 251,B00,511410,Mehta; Ravindra L.,9998,0,9999,1
1715646794643,CLRE 252,A00,507189,Cuomo; Raphael Eduardo,9994,0,9999,5
1715646795672,CLRE 253,A00,507199,Vaida; Florin,9994,0,9999,5
1715646795672,CLRE 253,B00,507202,Vaida; Florin,9999,0,9999,0
1715646796697,CLRE 259,A00,507211,Patel; Hemal,9996,0,9999,3
1715646797721,CLRE 260,A00,507221,Cuomo; Raphael Eduardo,9999,0,9999,0
1715646798748,CLRE 297,001,507242,Cuomo; Raphael Eduardo,9999,0,9999,0
1715646799773,COGS 197,001,638244,Voytek; Bradley Thomas,9997,0,9999,2
1715646800801,CSE 191,A00,516875,Minnes Kemp; Mor Mia,9991,0,9999,8
1715646801829,CSE 197,001,637388,Minnes Kemp; Mor Mia,9992,0,9999,7
1715646802856,CSS 201S,A01,494383,Mignozzetti; Umberto,35,0,35,0
1715646803883,CSS 202S,A01,494387,Mignozzetti; Umberto,35,0,35,0
1715646804908,DSC 197,001,628532,Eldridge; Justin Matthew,9995,0,9999,4
1715646805935,EAP 100,A00,516065,Staff,9799,0,9999,200
1715646806963,ECE 45,A01,507414,Staff,32,0,60,28
1715646809019,ECE 111,A01,507420,Staff,11,0,50,39
1715646810045,ECE 197,001,548057,Sievenpiper; Daniel F.,9991,0,9999,8
1715646811076,EDS 115,A00,507243,Choi; Bailey Miyeon,6,0,28,22
1715646812102,EDS 117,A01,494379,Staff,0,6,34,35
1715646813129,EDS 125,A00,507246,Hopkins; Megan Beth,7,0,30,23
1715646814154,EDS 128A,A01,507264,Fargason; Sharon Gayle,5,0,26,21
1715646815180,EDS 128B,A01,507293,Pappas; Elizabeth,9,0,30,21
1715646816206,EDS 139,A00,507294,Fargason; Sharon Gayle,9,0,30,21
1715646816206,EDS 139,B00,507313,Pappas; Elizabeth,9,0,30,21
1715646817232,EDS 201,A00,507315,Staff,10,0,30,20
1715646818258,EDS 203,A01,507317,Halter; Christopher P.,10,0,30,20
1715646819285,EDS 204R,A01,507319,Halter; Christopher P.,0,3,30,30
1715646819285,EDS 204R,B01,507331,Heinzman; Erica M.,14,0,30,16
1715646820313,EDS 206R,A00,507332,Staff,0,4,30,30
1715646820313,EDS 206R,B00,507343,Staff,15,0,30,15
1715646821338,EDS 250,A00,507344,Hemans; Patricia Ann Benitez,20,0,40,20
1715646822365,EDS 281,A00,507345,Daly; Alan J.,18,0,18,0
1715646823393,EDS 284,A00,507350,Daly; Alan J.,16,0,16,0
1715646824420,EDS 286,A00,507359,Fine; Sarah,18,0,18,0
1715646825446,EDS 289C,A01,507361,Daly; Alan J.,18,0,18,0
1715646826471,EDS 290,A00,507366,Hofstetter; Carolyn,15,0,15,0
1715646827499,LIGM 5A,A00,507421,Fischer-Grunski; Eva K,17,0,20,3
1715646828524,LIGM 5B,A00,507423,Fischer-Grunski; Eva K,19,0,20,1
1715646829549,LIGM 5C,A00,507425,Fischer-Grunski; Eva K,19,0,20,1
1715646830575,LIIT 5AS,A00,507427,Carnelos; Chiara,20,0,20,0
1715646831605,LIIT 5BS,A00,507430,Carnelos; Chiara,20,0,20,0
1715646832636,LIIT 5CS,A00,507432,Carnelos; Chiara,20,0,20,0
1715646833661,LISP 5A,A00,507541,Munoz Sanchez; Alicia,11,0,20,9
1715646834688,LISP 5B,A00,507671,Munoz Sanchez; Alicia,8,0,20,12
1715646835717,LISP 5C,A00,507696,Munoz Sanchez; Alicia,8,0,20,12
1715646836743,MAE 197,001,528363,Boechler; Nicholas Sebastia,9998,0,9999,1
1715646837771,MATH 197,001,523477,Kedlaya; Kiran S.,9994,0,9999,5
1715646837771,MATH 197,002,563811,Zhang; Danna,9994,0,9999,5
1715646837771,MATH 197,003,628552,Dumitriu; Ioana,9998,0,9999,1
1715646837771,MATH 197,004,660885,Floyd; Eric,9998,0,9999,1
1715646838800,MCWP 40R,A00,518780,Staff,1,0,20,19
1715646838800,MCWP 40R,B00,518781,Carter; Jennifer A,10,0,20,10
1715646838800,MCWP 40R,C00,518783,Smith; Haydee Marie,5,0,20,15
1715646839829,MCWP 50R,A00,518791,Redela; Pamela Morgan,0,1,20,20
1715646839829,MCWP 50R,B00,518792,Krone; Jarret,0,2,20,20
1715646839829,MCWP 50R,C00,518793,Staff,0,4,20,20
1715646839829,MCWP 50R,D00,518794,Morshed; Michael James,0,2,20,20
1715646839829,MCWP 50R,E00,518795,Carter; Andrea L,0,2,20,20
1715646839829,MCWP 50R,F00,518796,Miller; Elizabeth Deen,0,1,20,20
1715646839829,MCWP 50R,G00,518797,Guillen; Melinda,0,1,20,20
1715646840855,MMW 12R,A01,514034,Herbst; Matthew,0,2,16,16
1715646840855,MMW 12R,A02,514035,Herbst; Matthew,0,0,16,16
1715646841885,MMW 13R,A01,514037,Staff,0,5,16,16
1715646841885,MMW 13R,A02,514039,Staff,0,5,16,16
1715646841885,MMW 13R,A03,628519,Staff,0,4,16,16
1715646843942,SIO 295LS,A00,523233,Staff,10,0,30,20
1715646844970,SIO 295S,A00,523232,Staff,10,0,30,20
1715646846000,SIOC 290S,A01,637330,Merrifield; Mark A,21,0,30,9
1715646847029,SIOC 291S,A01,637333,Gabriel; Corey John,21,0,30,9
1715646848055,SOCI 117,A01,494376,Staff,0,5,5,5
1715646849081,WES 237B,A00,494380,Staff,10,0,20,10
1715646851148,AESE 279B,A00,494370,Wade; Jon P,0,0,33,33
1715646852175,AIP 97,001,660915,Van Den Einde; Yael Dahlia,9998,0,9999,1
1715646853207,AIP 197,001,627712,Vespa; Emanuel Ignacio,9995,0,9999,4
1715646853207,AIP 197,002,650778,Amir; On,9998,0,9999,1
1715646853207,AIP 197,003,650933,Avenancio-Leon; Carlos,9998,0,9999,1
1715646853207,AIP 197,004,658530,Heyman; Gail D.,9998,0,9999,1
1715646853207,AIP 197,005,658631,Neal; Sonya E,9998,0,9999,1
1715646853207,AIP 197,006,658671,Du; Songzi,9998,0,9999,1
1715646854234,ANAR 135S,A00,494369,Braswell; Geoffrey E.,0,0,0,0
1715646855262,BENG 196,001,628496,Engler; Adam J.,9998,0,9999,1
1715646855262,BENG 196,002,660916,Watson; John Thomas,9998,0,9999,1
1715646856291,BISP 197,001,650773,Wilhelm; James E.,9994,0,9999,5
1715646856291,BISP 197,002,658904,Coleman; Aaron B.,9998,0,9999,1
1715646857316,CAT 124RS,A01,519847,Geibel; William,0,0,20,20
1715646858344,CAT 125RS,A01,515971,Geibel; William,0,0,20,20
1715646859369,CLRE 250,A00,511389,Morris; Sheldon,9992,0,9999,7
1715646860395,CLRE 251,A00,507176,Mehta; Ravindra L.,9992,0,9999,7
1715646860395,CLRE 251,B00,511410,Mehta; Ravindra L.,9998,0,9999,1
1715646861423,CLRE 252,A00,507189,Cuomo; Raphael Eduardo,9994,0,9999,5
1715646862453,CLRE 253,A00,507199,Vaida; Florin,9994,0,9999,5
1715646862453,CLRE 253,B00,507202,Vaida; Florin,9999,0,9999,0
1715646863478,CLRE 259,A00,507211,Patel; Hemal,9996,0,9999,3
1715646864506,CLRE 260,A00,507221,Cuomo; Raphael Eduardo,9999,0,9999,0
1715646865531,CLRE 297,001,507242,Cuomo; Raphael Eduardo,9999,0,9999,0
1715646866557,COGS 197,001,638244,Voytek; Bradley Thomas,9997,0,9999,2
1715646867585,CSE 191,A00,516875,Minnes Kemp; Mor Mia,9991,0,9999,8
1715646868667,CSE 197,001,637388,Minnes Kemp; Mor Mia,9992,0,9999,7
1715646869697,CSS 201S,A01,494383,Mignozzetti; Umberto,35,0,35,0
1715646870728,CSS 202S,A01,494387,Mignozzetti; Umberto,35,0,35,0
1715646871753,DSC 197,001,628532,Eldridge; Justin Matthew,9995,0,9999,4
1715646872778,EAP 100,A00,516065,Staff,9799,0,9999,200
1715646873805,ECE 45,A01,507414,Staff,32,0,60,28
1715646875859,ECE 111,A01,507420,Staff,11,0,50,39
1715646876885,ECE 197,001,548057,Sievenpiper; Daniel F.,9991,0,9999,8
1715646877913,EDS 115,A00,507243,Choi; Bailey Miyeon,6,0,28,22
1715646878939,EDS 117,A01,494379,Staff,0,6,34,35
1715646879965,EDS 125,A00,507246,Hopkins; Megan Beth,7,0,30,23
1715646880996,EDS 128A,A01,507264,Fargason; Sharon Gayle,5,0,26,21
1715646882048,EDS 128B,A01,507293,Pappas; Elizabeth,9,0,30,21
1715646883077,EDS 139,A00,507294,Fargason; Sharon Gayle,9,0,30,21
1715646883077,EDS 139,B00,507313,Pappas; Elizabeth,9,0,30,21
1715646884104,EDS 201,A00,507315,Staff,10,0,30,20
1715646885130,EDS 203,A01,507317,Halter; Christopher P.,10,0,30,20
1715646886156,EDS 204R,A01,507319,Halter; Christopher P.,0,3,30,30
1715646886156,EDS 204R,B01,507331,Heinzman; Erica M.,14,0,30,16
1715646887181,EDS 206R,A00,507332,Staff,0,4,30,30
1715646887181,EDS 206R,B00,507343,Staff,15,0,30,15
1715646888209,EDS 250,A00,507344,Hemans; Patricia Ann Benitez,20,0,40,20
1715646889236,EDS 281,A00,507345,Daly; Alan J.,18,0,18,0
1715646890263,EDS 284,A00,507350,Daly; Alan J.,16,0,16,0
1715646891289,EDS 286,A00,507359,Fine; Sarah,18,0,18,0
1715646892314,EDS 289C,A01,507361,Daly; Alan J.,18,0,18,0
1715646893340,EDS 290,A00,507366,Hofstetter; Carolyn,15,0,15,0
1715646894366,LIGM 5A,A00,507421,Fischer-Grunski; Eva K,17,0,20,3
1715646895391,LIGM 5B,A00,507423,Fischer-Grunski; Eva K,19,0,20,1
1715646896421,LIGM 5C,A00,507425,Fischer-Grunski; Eva K,19,0,20,1
1715646897449,LIIT 5AS,A00,507427,Carnelos; Chiara,20,0,20,0
1715646898475,LIIT 5BS,A00,507430,Carnelos; Chiara,20,0,20,0
1715646899504,LIIT 5CS,A00,507432,Carnelos; Chiara,20,0,20,0
1715646900534,LISP 5A,A00,507541,Munoz Sanchez; Alicia,11,0,20,9
1715646901558,LISP 5B,A00,507671,Munoz Sanchez; Alicia,8,0,20,12
1715646902583,LISP 5C,A00,507696,Munoz Sanchez; Alicia,8,0,20,12
1715646903609,MAE 197,001,528363,Boechler; Nicholas Sebastia,9998,0,9999,1
1715646904637,MATH 197,001,523477,Kedlaya; Kiran S.,9994,0,9999,5
1715646904637,MATH 197,002,563811,Zhang; Danna,9994,0,9999,5
1715646904637,MATH 197,003,628552,Dumitriu; Ioana,9998,0,9999,1
1715646904637,MATH 197,004,660885,Floyd; Eric,9998,0,9999,1
1715646905663,MCWP 40R,A00,518780,Staff,1,0,20,19
1715646905663,MCWP 40R,B00,518781,Carter; Jennifer A,10,0,20,10
1715646905663,MCWP 40R,C00,518783,Smith; Haydee Marie,5,0,20,15
1715646906699,MCWP 50R,A00,518791,Redela; Pamela Morgan,0,1,20,20
1715646906699,MCWP 50R,B00,518792,Krone; Jarret,0,2,20,20
1715646906699,MCWP 50R,C00,518793,Staff,0,4,20,20
1715646906699,MCWP 50R,D00,518794,Morshed; Michael James,0,2,20,20
1715646906699,MCWP 50R,E00,518795,Carter; Andrea L,0,2,20,20
1715646906699,MCWP 50R,F00,518796,Miller; Elizabeth Deen,0,1,20,20
1715646906699,MCWP 50R,G00,518797,Guillen; Melinda,0,1,20,20
1715646907725,MMW 12R,A01,514034,Herbst; Matthew,0,2,16,16
1715646907725,MMW 12R,A02,514035,Herbst; Matthew,0,0,16,16
1715646908750,MMW 13R,A01,514037,Staff,0,5,16,16
1715646908750,MMW 13R,A02,514039,Staff,0,5,16,16
1715646908750,MMW 13R,A03,628519,Staff,0,4,16,16
1715646910799,SIO 295LS,A00,523233,Staff,10,0,30,20
1715646911824,SIO 295S,A00,523232,Staff,10,0,30,20
1715646912853,SIOC 290S,A01,637330,Merrifield; Mark A,21,0,30,9
1715646913880,SIOC 291S,A01,637333,Gabriel; Corey John,21,0,30,9
1715646914905,SOCI 117,A01,494376,Staff,0,5,5,5
1715646915932,WES 237B,A00,494380,Staff,10,0,20,10
1715646918010,AESE 279B,A00,494370,Wade; Jon P,0,0,33,33
1715646919035,AIP 97,001,660915,Van Den Einde; Yael Dahlia,9998,0,9999,1
1715646920068,AIP 197,001,627712,Vespa; Emanuel Ignacio,9995,0,9999,4
1715646920068,AIP 197,002,650778,Amir; On,9998,0,9999,1
1715646920068,AIP 197,003,650933,Avenancio-Leon; Carlos,9998,0,9999,1
1715646920068,AIP 197,004,658530,Heyman; Gail D.,9998,0,9999,1
1715646920068,AIP 197,005,658631,Neal; Sonya E,9998,0,9999,1
1715646920068,AIP 197,006,658671,Du; Songzi,9998,0,9999,1
1715646921096,ANAR 135S,A00,494369,Braswell; Geoffrey E.,0,0,0,0
1715646922123,BENG 196,001,628496,Engler; Adam J.,9998,0,9999,1
1715646922123,BENG 196,002,660916,Watson; John Thomas,9998,0,9999,1
1715646923150,BISP 197,001,650773,Wilhelm; James E.,9994,0,9999,5
1715646923150,BISP 197,002,658904,Coleman; Aaron B.,9998,0,9999,1
1715646924177,CAT 124RS,A01,519847,Geibel; William,0,0,20,20
1715646925201,CAT 125RS,A01,515971,Geibel; William,0,0,20,20
1715646926226,CLRE 250,A00,511389,Morris; Sheldon,9992,0,9999,7
1715646927268,CLRE 251,A00,507176,Mehta; Ravindra L.,9992,0,9999,7
1715646927268,CLRE 251,B00,511410,Mehta; Ravindra L.,9998,0,9999,1
1715646928294,CLRE 252,A00,507189,Cuomo; Raphael Eduardo,9994,0,9999,5
1715646929323,CLRE 253,A00,507199,Vaida; Florin,9994,0,9999,5
1715646929323,CLRE 253,B00,507202,Vaida; Florin,9999,0,9999,0
1715646930352,CLRE 259,A00,507211,Patel; Hemal,9996,0,9999,3
1715646931376,CLRE 260,A00,507221,Cuomo; Raphael Eduardo,9999,0,9999,0
1715646932404,CLRE 297,001,507242,Cuomo; Raphael Eduardo,9999,0,9999,0
1715646933430,COGS 197,001,638244,Voytek; Bradley Thomas,9997,0,9999,2
1715646934455,CSE 191,A00,516875,Minnes Kemp; Mor Mia,9991,0,9999,8
1715646935480,CSE 197,001,637388,Minnes Kemp; Mor Mia,9992,0,9999,7
1715646936507,CSS 201S,A01,494383,Mignozzetti; Umberto,35,0,35,0
1715646937533,CSS 202S,A01,494387,Mignozzetti; Umberto,35,0,35,0
1715646938562,DSC 197,001,628532,Eldridge; Justin Matthew,9995,0,9999,4
1715646939588,EAP 100,A00,516065,Staff,9799,0,9999,200
1715646940618,ECE 45,A01,507414,Staff,32,0,60,28
1715646942671,ECE 111,A01,507420,Staff,11,0,50,39
1715646943699,ECE 197,001,548057,Sievenpiper; Daniel F.,9991,0,9999,8
1715646944729,EDS 115,A00,507243,Choi; Bailey Miyeon,6,0,28,22
1715646945805,EDS 117,A01,494379,Staff,0,6,34,35
1715646946833,EDS 125,A00,507246,Hopkins; Megan Beth,7,0,30,23
1715646947858,EDS 128A,A01,507264,Fargason; Sharon Gayle,5,0,26,21
1715646948886,EDS 128B,A01,507293,Pappas; Elizabeth,9,0,30,21
1715646949912,EDS 139,A00,507294,Fargason; Sharon Gayle,9,0,30,21
1715646949912,EDS 139,B00,507313,Pappas; Elizabeth,9,0,30,21
1715646950938,EDS 201,A00,507315,Staff,10,0,30,20
1715646951969,EDS 203,A01,507317,Halter; Christopher P.,10,0,30,20
1715646952993,EDS 204R,A01,507319,Halter; Christopher P.,0,3,30,30
1715646952993,EDS 204R,B01,507331,Heinzman; Erica M.,14,0,30,16
1715646954021,EDS 206R,A00,507332,Staff,0,4,30,30
1715646954021,EDS 206R,B00,507343,Staff,15,0,30,15
1715646955047,EDS 250,A00,507344,Hemans; Patricia Ann Benitez,20,0,40,20
1715646956074,EDS 281,A00,507345,Daly; Alan J.,18,0,18,0
1715646957102,EDS 284,A00,507350,Daly; Alan J.,16,0,16,0
1715646958129,EDS 286,A00,507359,Fine; Sarah,18,0,18,0
1715646959157,EDS 289C,A01,507361,Daly; Alan J.,18,0,18,0
1715646960184,EDS 290,A00,507366,Hofstetter; Carolyn,15,0,15,0
1715646961209,LIGM 5A,A00,507421,Fischer-Grunski; Eva K,17,0,20,3
1715646962236,LIGM 5B,A00,507423,Fischer-Grunski; Eva K,19,0,20,1
1715646963261,LIGM 5C,A00,507425,Fischer-Grunski; Eva K,19,0,20,1
1715646964286,LIIT 5AS,A00,507427,Carnelos; Chiara,20,0,20,0
1715646965313,LIIT 5BS,A00,507430,Carnelos; Chiara,20,0,20,0
1715646966339,LIIT 5CS,A00,507432,Carnelos; Chiara,20,0,20,0
1715646967364,LISP 5A,A00,507541,Munoz Sanchez; Alicia,11,0,20,9
1715646968390,LISP 5B,A00,507671,Munoz Sanchez; Alicia,8,0,20,12
1715646969415,LISP 5C,A00,507696,Munoz Sanchez; Alicia,8,0,20,12
1715646970442,MAE 197,001,528363,Boechler; Nicholas Sebastia,9998,0,9999,1
1715646971470,MATH 197,001,523477,Kedlaya; Kiran S.,9994,0,9999,5
1715646971470,MATH 197,002,563811,Zhang; Danna,9994,0,9999,5
1715646971470,MATH 197,003,628552,Dumitriu; Ioana,9998,0,9999,1
1715646971470,MATH 197,004,660885,Floyd; Eric,9998,0,9999,1
1715646972499,MCWP 40R,A00,518780,Staff,1,0,20,19
1715646972499,MCWP 40R,B00,518781,Carter; Jennifer A,10,0,20,10
1715646972499,MCWP 40R,C00,518783,Smith; Haydee Marie,5,0,20,15
1715646973534,MCWP 50R,A00,518791,Redela; Pamela Morgan,0,1,20,20
1715646973534,MCWP 50R,B00,518792,Krone; Jarret,0,2,20,20
1715646973534,MCWP 50R,C00,518793,Staff,0,4,20,20
1715646973534,MCWP 50R,D00,518794,Morshed; Michael James,0,2,20,20
1715646973534,MCWP 50R,E00,518795,Carter; Andrea L,0,2,20,20
1715646973534,MCWP 50R,F00,518796,Miller; Elizabeth Deen,0,1,20,20
1715646973534,MCWP 50R,G00,518797,Guillen; Melinda,0,1,20,20
1715646974562,MMW 12R,A01,514034,Herbst; Matthew,0,2,16,16
1715646974562,MMW 12R,A02,514035,Herbst; Matthew,0,0,16,16
1715646975588,MMW 13R,A01,514037,Staff,0,5,16,16
1715646975588,MMW 13R,A02,514039,Staff,0,5,16,16
1715646975588,MMW 13R,A03,628519,Staff,0,4,16,16
1715646977647,SIO 295LS,A00,523233,Staff,10,0,30,20
1715646978678,SIO 295S,A00,523232,Staff,10,0,30,20
1715646979713,SIOC 290S,A01,637330,Merrifield; Mark A,21,0,30,9
1715646980739,SIOC 291S,A01,637333,Gabriel; Corey John,21,0,30,9
1715646981767,SOCI 117,A01,494376,Staff,0,5,5,5
1715646982794,WES 237B,A00,494380,Staff,10,0,20,10
1715646984858,AESE 279B,A00,494370,Wade; Jon P,0,0,33,33
1715646985884,AIP 97,001,660915,Van Den Einde; Yael Dahlia,9998,0,9999,1
1715646986912,AIP 197,001,627712,Vespa; Emanuel Ignacio,9995,0,9999,4
1715646986912,AIP 197,002,650778,Amir; On,9998,0,9999,1
1715646986912,AIP 197,003,650933,Avenancio-Leon; Carlos,9998,0,9999,1
1715646986912,AIP 197,004,658530,Heyman; Gail D.,9998,0,9999,1
1715646986912,AIP 197,005,658631,Neal; Sonya E,9998,0,9999,1
1715646986912,AIP 197,006,658671,Du; Songzi,9998,0,9999,1
1715646987937,ANAR 135S,A00,494369,Braswell; Geoffrey E.,0,0,0,0
1715646988962,BENG 196,001,628496,Engler; Adam J.,9998,0,9999,1
1715646988962,BENG 196,002,660916,Watson; John Thomas,9998,0,9999,1
1715646989989,BISP 197,001,650773,Wilhelm; James E.,9994,0,9999,5
1715646989989,BISP 197,002,658904,Coleman; Aaron B.,9998,0,9999,1
1715646991018,CAT 124RS,A01,519847,Geibel; William,0,0,20,20
1715646992046,CAT 125RS,A01,515971,Geibel; William,0,0,20,20
1715646993075,CLRE 250,A00,511389,Morris; Sheldon,9992,0,9999,7
1715646994101,CLRE 251,A00,507176,Mehta; Ravindra L.,9992,0,9999,7
1715646994101,CLRE 251,B00,511410,Mehta; Ravindra L.,9998,0,9999,1
1715646995127,CLRE 252,A00,507189,Cuomo; Raphael Eduardo,9994,0,9999,5
1715646996154,CLRE 253,A00,507199,Vaida; Florin,9994,0,9999,5
1715646996154,CLRE 253,B00,507202,Vaida; Florin,9999,0,9999,0
1715646997181,CLRE 259,A00,507211,Patel; Hemal,9996,0,9999,3
1715646998207,CLRE 260,A00,507221,Cuomo; Raphael Eduardo,9999,0,9999,0
1715646999232,CLRE 297,001,507242,Cuomo; Raphael Eduardo,9999,0,9999,0
1715647000261,COGS 197,001,638244,Voytek; Bradley Thomas,9997,0,9999,2
1715647001286,CSE 191,A00,516875,Minnes Kemp; Mor Mia,9991,0,9999,8
1715647002313,CSE 197,001,637388,Minnes Kemp; Mor Mia,9992,0,9999,7
1715647003341,CSS 201S,A01,494383,Mignozzetti; Umberto,35,0,35,0
1715647004366,CSS 202S,A01,494387,Mignozzetti; Umberto,35,0,35,0
1715647005391,DSC 197,001,628532,Eldridge; Justin Matthew,9995,0,9999,4
1715647006416,EAP 100,A00,516065,Staff,9799,0,9999,200
1715647007447,ECE 45,A01,507414,Staff,32,0,60,28
1715647009501,ECE 111,A01,507420,Staff,11,0,50,39
1715647010527,ECE 197,001,548057,Sievenpiper; Daniel F.,9991,0,9999,8
1715647011555,EDS 115,A00,507243,Choi; Bailey Miyeon,6,0,28,22
1715647012580,EDS 117,A01,494379,Staff,0,6,34,35
1715647013607,EDS 125,A00,507246,Hopkins; Megan Beth,7,0,30,23
1715647014637,EDS 128A,A01,507264,Fargason; Sharon Gayle,5,0,26,21
1715647015661,EDS 128B,A01,507293,Pappas; Elizabeth,9,0,30,21
1715647016694,EDS 139,A00,507294,Fargason; Sharon Gayle,9,0,30,21
1715647016694,EDS 139,B00,507313,Pappas; Elizabeth,9,0,30,21
1715647017720,EDS 201,A00,507315,Staff,10,0,30,20
1715647018747,EDS 203,A01,507317,Halter; Christopher P.,10,0,30,20
1715647019774,EDS 204R,A01,507319,Halter; Christopher P.,0,3,30,30
1715647019774,EDS 204R,B01,507331,Heinzman; Erica M.,14,0,30,16
1715647020800,EDS 206R,A00,507332,Staff,0,4,30,30
1715647020800,EDS 206R,B00,507343,Staff,15,0,30,15
1715647021828,EDS 250,A00,507344,Hemans; Patricia Ann Benitez,20,0,40,20
1715647022854,EDS 281,A00,507345,Daly; Alan J.,18,0,18,0
1715647023881,EDS 284,A00,507350,Daly; Alan J.,16,0,16,0
1715647024912,EDS 286,A00,507359,Fine; Sarah,18,0,18,0
1715647025939,EDS 289C,A01,507361,Daly; Alan J.,18,0,18,0
1715647026964,EDS 290,A00,507366,Hofstetter; Carolyn,15,0,15,0
1715647027994,LIGM 5A,A00,507421,Fischer-Grunski; Eva K,17,0,20,3
1715647029024,LIGM 5B,A00,507423,Fischer-Grunski; Eva K,19,0,20,1
1715647030049,LIGM 5C,A00,507425,Fischer-Grunski; Eva K,19,0,20,1
1715647031076,LIIT 5AS,A00,507427,Carnelos; Chiara,20,0,20,0
1715647032105,LIIT 5BS,A00,507430,Carnelos; Chiara,20,0,20,0
1715647033130,LIIT 5CS,A00,507432,Carnelos; Chiara,20,0,20,0
1715647034161,LISP 5A,A00,507541,Munoz Sanchez; Alicia,11,0,20,9
1715647035189,LISP 5B,A00,507671,Munoz Sanchez; Alicia,8,0,20,12
1715647036214,LISP 5C,A00,507696,Munoz Sanchez; Alicia,8,0,20,12
1715647037239,MAE 197,001,528363,Boechler; Nicholas Sebastia,9998,0,9999,1
1715647038266,MATH 197,001,523477,Kedlaya; Kiran S.,9994,0,9999,5
1715647038266,MATH 197,002,563811,Zhang; Danna,9994,0,9999,5
1715647038266,MATH 197,003,628552,Dumitriu; Ioana,9998,0,9999,1
1715647038266,MATH 197,004,660885,Floyd; Eric,9998,0,9999,1
1715647039295,MCWP 40R,A00,518780,Staff,1,0,20,19
1715647039295,MCWP 40R,B00,518781,Carter; Jennifer A,10,0,20,10
1715647039295,MCWP 40R,C00,518783,Smith; Haydee Marie,5,0,20,15
1715647040326,MCWP 50R,A00,518791,Redela; Pamela Morgan,0,1,20,20
1715647040326,MCWP 50R,B00,518792,Krone; Jarret,0,2,20,20
1715647040326,MCWP 50R,C00,518793,Staff,0,4,20,20
1715647040326,MCWP 50R,D00,518794,Morshed; Michael James,0,2,20,20
1715647040326,MCWP 50R,E00,518795,Carter; Andrea L,0,2,20,20
1715647040326,MCWP 50R,F00,518796,Miller; Elizabeth Deen,0,1,20,20
1715647040326,MCWP 50R,G00,518797,Guillen; Melinda,0,1,20,20
1715647041355,MMW 12R,A01,514034,Herbst; Matthew,0,2,16,16
1715647041355,MMW 12R,A02,514035,Herbst; Matthew,0,0,16,16
1715647042379,MMW 13R,A01,514037,Staff,0,5,16,16
1715647042379,MMW 13R,A02,514039,Staff,0,5,16,16
1715647042379,MMW 13R,A03,628519,Staff,0,4,16,16
1715647044434,SIO 295LS,A00,523233,Staff,10,0,30,20
1715647045459,SIO 295S,A00,523232,Staff,10,0,30,20
1715647046492,SIOC 290S,A01,637330,Merrifield; Mark A,21,0,30,9
1715647047520,SIOC 291S,A01,637333,Gabriel; Corey John,21,0,30,9
1715647048545,SOCI 117,A01,494376,Staff,0,5,5,5
1715647049569,WES 237B,A00,494380,Staff,10,0,20,10
1715647051652,AESE 279B,A00,494370,Wade; Jon P,0,0,33,33
1715647052681,AIP 97,001,660915,Van Den Einde; Yael Dahlia,9998,0,9999,1
1715647053714,AIP 197,001,627712,Vespa; Emanuel Ignacio,9995,0,9999,4
1715647053714,AIP 197,002,650778,Amir; On,9998,0,9999,1
1715647053714,AIP 197,003,650933,Avenancio-Leon; Carlos,9998,0,9999,1
1715647053714,AIP 197,004,658530,Heyman; Gail D.,9998,0,9999,1
1715647053714,AIP 197,005,658631,Neal; Sonya E,9998,0,9999,1
1715647053714,AIP 197,006,658671,Du; Songzi,9998,0,9999,1
1715647054739,ANAR 135S,A00,494369,Braswell; Geoffrey E.,0,0,0,0
1715647055770,BENG 196,001,628496,Engler; Adam J.,9998,0,9999,1
1715647055770,BENG 196,002,660916,Watson; John Thomas,9998,0,9999,1
1715647056800,BISP 197,001,650773,Wilhelm; James E.,9994,0,9999,5
1715647056800,BISP 197,002,658904,Coleman; Aaron B.,9998,0,9999,1
1715647057831,CAT 124RS,A01,519847,Geibel; William,0,0,20,20
1715647058859,CAT 125RS,A01,515971,Geibel; William,0,0,20,20
1715647059885,CLRE 250,A00,511389,Morris; Sheldon,9992,0,9999,7
1715647060913,CLRE 251,A00,507176,Mehta; Ravindra L.,9992,0,9999,7
1715647060913,CLRE 251,B00,511410,Mehta; Ravindra L.,9998,0,9999,1
1715647061942,CLRE 252,A00,507189,Cuomo; Raphael Eduardo,9994,0,9999,5
1715647062968,CLRE 253,A00,507199,Vaida; Florin,9994,0,9999,5
1715647062968,CLRE 253,B00,507202,Vaida; Florin,9999,0,9999,0
1715647063995,CLRE 259,A00,507211,Patel; Hemal,9996,0,9999,3
1715647065023,CLRE 260,A00,507221,Cuomo; Raphael Eduardo,9999,0,9999,0
1715647066049,CLRE 297,001,507242,Cuomo; Raphael Eduardo,9999,0,9999,0
1715647067076,COGS 197,001,638244,Voytek; Bradley Thomas,9997,0,9999,2
1715647068101,CSE 191,A00,516875,Minnes Kemp; Mor Mia,9991,0,9999,8
1715647069126,CSE 197,001,637388,Minnes Kemp; Mor Mia,9992,0,9999,7
1715647070160,CSS 201S,A01,494383,Mignozzetti; Umberto,35,0,35,0
1715647071185,CSS 202S,A01,494387,Mignozzetti; Umberto,35,0,35,0
1715647072217,DSC 197,001,628532,Eldridge; Justin Matthew,9995,0,9999,4
1715647073244,EAP 100,A00,516065,Staff,9799,0,9999,200
1715647074277,ECE 45,A01,507414,Staff,32,0,60,28
1715647076332,ECE 111,A01,507420,Staff,11,0,50,39
1715647077377,ECE 197,001,548057,Sievenpiper; Daniel F.,9991,0,9999,8
1715647078403,EDS 115,A00,507243,Choi; Bailey Miyeon,6,0,28,22
1715647079428,EDS 117,A01,494379,Staff,0,6,34,35
1715647080454,EDS 125,A00,507246,Hopkins; Megan Beth,7,0,30,23
1715647081479,EDS 128A,A01,507264,Fargason; Sharon Gayle,5,0,26,21
1715647082507,EDS 128B,A01,507293,Pappas; Elizabeth,9,0,30,21
1715647083532,EDS 139,A00,507294,Fargason; Sharon Gayle,9,0,30,21
1715647083532,EDS 139,B00,507313,Pappas; Elizabeth,9,0,30,21
1715647084557,EDS 201,A00,507315,Staff,10,0,30,20
1715647085586,EDS 203,A01,507317,Halter; Christopher P.,10,0,30,20
1715647086615,EDS 204R,A01,507319,Halter; Christopher P.,0,3,30,30
1715647086615,EDS 204R,B01,507331,Heinzman; Erica M.,14,0,30,16
1715647087641,EDS 206R,A00,507332,Staff,0,4,30,30
1715647087641,EDS 206R,B00,507343,Staff,15,0,30,15
1715647088670,EDS 250,A00,507344,Hemans; Patricia Ann Benitez,20,0,40,20
1715647089697,EDS 281,A00,507345,Daly; Alan J.,18,0,18,0
1715647090725,EDS 284,A00,507350,Daly; Alan J.,16,0,16,0
1715647091751,EDS 286,A00,507359,Fine; Sarah,18,0,18,0
1715647092777,EDS 289C,A01,507361,Daly; Alan J.,18,0,18,0
1715647093803,EDS 290,A00,507366,Hofstetter; Carolyn,15,0,15,0
1715647094831,LIGM 5A,A00,507421,Fischer-Grunski; Eva K,17,0,20,3
1715647095856,LIGM 5B,A00,507423,Fischer-Grunski; Eva K,19,0,20,1
1715647096881,LIGM 5C,A00,507425,Fischer-Grunski; Eva K,19,0,20,1
1715647097912,LIIT 5AS,A00,507427,Carnelos; Chiara,20,0,20,0
1715647098936,LIIT 5BS,A00,507430,Carnelos; Chiara,20,0,20,0
1715647099964,LIIT 5CS,A00,507432,Carnelos; Chiara,20,0,20,0
1715647100991,LISP 5A,A00,507541,Munoz Sanchez; Alicia,11,0,20,9
1715647102016,LISP 5B,A00,507671,Munoz Sanchez; Alicia,8,0,20,12
1715647103043,LISP 5C,A00,507696,Munoz Sanchez; Alicia,8,0,20,12
1715647104069,MAE 197,001,528363,Boechler; Nicholas Sebastia,9998,0,9999,1
1715647105101,MATH 197,001,523477,Kedlaya; Kiran S.,9994,0,9999,5
1715647105101,MATH 197,002,563811,Zhang; Danna,9994,0,9999,5
1715647105101,MATH 197,003,628552,Dumitriu; Ioana,9998,0,9999,1
1715647105101,MATH 197,004,660885,Floyd; Eric,9998,0,9999,1
1715647106128,MCWP 40R,A00,518780,Staff,1,0,20,19
1715647106128,MCWP 40R,B00,518781,Carter; Jennifer A,10,0,20,10
1715647106128,MCWP 40R,C00,518783,Smith; Haydee Marie,5,0,20,15
1715647107156,MCWP 50R,A00,518791,Redela; Pamela Morgan,0,1,20,20
1715647107156,MCWP 50R,B00,518792,Krone; Jarret,0,2,20,20
1715647107156,MCWP 50R,C00,518793,Staff,0,4,20,20
1715647107156,MCWP 50R,D00,518794,Morshed; Michael James,0,2,20,20
1715647107156,MCWP 50R,E00,518795,Carter; Andrea L,0,2,20,20
1715647107156,MCWP 50R,F00,518796,Miller; Elizabeth Deen,0,1,20,20
1715647107156,MCWP 50R,G00,518797,Guillen; Melinda,0,1,20,20
1715647108185,MMW 12R,A01,514034,Herbst; Matthew,0,2,16,16
1715647108185,MMW 12R,A02,514035,Herbst; Matthew,0,0,16,16
1715647109210,MMW 13R,A01,514037,Staff,0,5,16,16
1715647109210,MMW 13R,A02,514039,Staff,0,5,16,16
1715647109210,MMW 13R,A03,628519,Staff,0,4,16,16
1715647111264,SIO 295LS,A00,523233,Staff,10,0,30,20
1715647112288,SIO 295S,A00,523232,Staff,10,0,30,20
1715647113316,SIOC 290S,A01,637330,Merrifield; Mark A,21,0,30,9
1715647114344,SIOC 291S,A01,637333,Gabriel; Corey John,21,0,30,9
1715647115370,SOCI 117,A01,494376,Staff,0,5,5,5
1715647116395,WES 237B,A00,494380,Staff,10,0,20,10
1715647118460,AESE 279B,A00,494370,Wade; Jon P,0,0,33,33
1715647119483,AIP 97,001,660915,Van Den Einde; Yael Dahlia,9998,0,9999,1
1715647120511,AIP 197,001,627712,Vespa; Emanuel Ignacio,9995,0,9999,4
1715647120511,AIP 197,002,650778,Amir; On,9998,0,9999,1
1715647120511,AIP 197,003,650933,Avenancio-Leon; Carlos,9998,0,9999,1
1715647120511,AIP 197,004,658530,Heyman; Gail D.,9998,0,9999,1
1715647120511,AIP 197,005,658631,Neal; Sonya E,9998,0,9999,1
1715647120511,AIP 197,006,658671,Du; Songzi,9998,0,9999,1
1715647121539,ANAR 135S,A00,494369,Braswell; Geoffrey E.,0,0,0,0
1715647122568,BENG 196,001,628496,Engler; Adam J.,9998,0,9999,1
1715647122568,BENG 196,002,660916,Watson; John Thomas,9998,0,9999,1
1715647123596,BISP 197,001,650773,Wilhelm; James E.,9994,0,9999,5
1715647123596,BISP 197,002,658904,Coleman; Aaron B.,9998,0,9999,1
1715647124625,CAT 124RS,A01,519847,Geibel; William,0,0,20,20
1715647125649,CAT 125RS,A01,515971,Geibel; William,0,0,20,20
1715647126694,CLRE 250,A00,511389,Morris; Sheldon,9992,0,9999,7
1715647127721,CLRE 251,A00,507176,Mehta; Ravindra L.,9992,0,9999,7
1715647127721,CLRE 251,B00,511410,Mehta; Ravindra L.,9998,0,9999,1
1715647128746,CLRE 252,A00,507189,Cuomo; Raphael Eduardo,9994,0,9999,5
1715647129772,CLRE 253,A00,507199,Vaida; Florin,9994,0,9999,5
1715647129772,CLRE 253,B00,507202,Vaida; Florin,9999,0,9999,0
1715647130797,CLRE 259,A00,507211,Patel; Hemal,9996,0,9999,3
1715647131823,CLRE 260,A00,507221,Cuomo; Raphael Eduardo,9999,0,9999,0
1715647132850,CLRE 297,001,507242,Cuomo; Raphael Eduardo,9999,0,9999,0
1715647133879,COGS 197,001,638244,Voytek; Bradley Thomas,9997,0,9999,2
1715647134909,CSE 191,A00,516875,Minnes Kemp; Mor Mia,9991,0,9999,8
1715647135933,CSE 197,001,637388,Minnes Kemp; Mor Mia,9992,0,9999,7
1715647136959,CSS 201S,A01,494383,Mignozzetti; Umberto,35,0,35,0
1715647137988,CSS 202S,A01,494387,Mignozzetti; Umberto,35,0,35,0
1715647139011,DSC 197,001,628532,Eldridge; Justin Matthew,9995,0,9999,4
1715647140039,EAP 100,A00,516065,Staff,9799,0,9999,200
1715647141073,ECE 45,A01,507414,Staff,32,0,60,28
1715647143127,ECE 111,A01,507420,Staff,11,0,50,39
1715647144160,ECE 197,001,548057,Sievenpiper; Daniel F.,9991,0,9999,8
1715647145186,EDS 115,A00,507243,Choi; Bailey Miyeon,6,0,28,22
1715647146214,EDS 117,A01,494379,Staff,0,6,34,35
1715647147239,EDS 125,A00,507246,Hopkins; Megan Beth,7,0,30,23
1715647148268,EDS 128A,A01,507264,Fargason; Sharon Gayle,5,0,26,21
1715647149293,EDS 128B,A01,507293,Pappas; Elizabeth,9,0,30,21
1715647150321,EDS 139,A00,507294,Fargason; Sharon Gayle,9,0,30,21
1715647150321,EDS 139,B00,507313,Pappas; Elizabeth,9,0,30,21
1715647151349,EDS 201,A00,507315,Staff,10,0,30,20
1715647152383,EDS 203,A01,507317,Halter; Christopher P.,10,0,30,20
1715647153408,EDS 204R,A01,507319,Halter; Christopher P.,0,3,30,30
1715647153408,EDS 204R,B01,507331,Heinzman; Erica M.,14,0,30,16
1715647154433,EDS 206R,A00,507332,Staff,0,4,30,30
1715647154433,EDS 206R,B00,507343,Staff,15,0,30,15
1715647155458,EDS 250,A00,507344,Hemans; Patricia Ann Benitez,20,0,40,20
1715647156485,EDS 281,A00,507345,Daly; Alan J.,18,0,18,0
1715647157512,EDS 284,A00,507350,Daly; Alan J.,16,0,16,0
1715647158540,EDS 286,A00,507359,Fine; Sarah,18,0,18,0
1715647159567,EDS 289C,A01,507361,Daly; Alan J.,18,0,18,0
1715647160593,EDS 290,A00,507366,Hofstetter; Carolyn,15,0,15,0
1715647161623,LIGM 5A,A00,507421,Fischer-Grunski; Eva K,17,0,20,3
1715647162648,LIGM 5B,A00,507423,Fischer-Grunski; Eva K,19,0,20,1
1715647163677,LIGM 5C,A00,507425,Fischer-Grunski; Eva K,19,0,20,1
1715647164703,LIIT 5AS,A00,507427,Carnelos; Chiara,20,0,20,0
1715647165728,LIIT 5BS,A00,507430,Carnelos; Chiara,20,0,20,0
1715647166755,LIIT 5CS,A00,507432,Carnelos; Chiara,20,0,20,0
1715647167812,LISP 5A,A00,507541,Munoz Sanchez; Alicia,11,0,20,9
1715647168837,LISP 5B,A00,507671,Munoz Sanchez; Alicia,8,0,20,12
1715647169864,LISP 5C,A00,507696,Munoz Sanchez; Alicia,8,0,20,12
1715647170892,MAE 197,001,528363,Boechler; Nicholas Sebastia,9998,0,9999,1
1715647171917,MATH 197,001,523477,Kedlaya; Kiran S.,9994,0,9999,5
1715647171917,MATH 197,002,563811,Zhang; Danna,9994,0,9999,5
1715647171917,MATH 197,003,628552,Dumitriu; Ioana,9998,0,9999,1
1715647171917,MATH 197,004,660885,Floyd; Eric,9998,0,9999,1
1715647172944,MCWP 40R,A00,518780,Staff,1,0,20,19
1715647172944,MCWP 40R,B00,518781,Carter; Jennifer A,10,0,20,10
1715647172944,MCWP 40R,C00,518783,Smith; Haydee Marie,5,0,20,15
1715647173973,MCWP 50R,A00,518791,Redela; Pamela Morgan,0,1,20,20
1715647173973,MCWP 50R,B00,518792,Krone; Jarret,0,2,20,20
1715647173973,MCWP 50R,C00,518793,Staff,0,4,20,20
1715647173973,MCWP 50R,D00,518794,Morshed; Michael James,0,2,20,20
1715647173973,MCWP 50R,E00,518795,Carter; Andrea L,0,2,20,20
1715647173973,MCWP 50R,F00,518796,Miller; Elizabeth Deen,0,1,20,20
1715647173973,MCWP 50R,G00,518797,Guillen; Melinda,0,1,20,20
1715647175002,MMW 12R,A01,514034,Herbst; Matthew,0,2,16,16
1715647175002,MMW 12R,A02,514035,Herbst; Matthew,0,0,16,16
1715647176029,MMW 13R,A01,514037,Staff,0,5,16,16
1715647176029,MMW 13R,A02,514039,Staff,0,5,16,16
1715647176029,MMW 13R,A03,628519,Staff,0,4,16,16
1715647178081,SIO 295LS,A00,523233,Staff,10,0,30,20
1715647179108,SIO 295S,A00,523232,Staff,10,0,30,20
1715647180141,SIOC 290S,A01,637330,Merrifield; Mark A,21,0,30,9
1715647181166,SIOC 291S,A01,637333,Gabriel; Corey John,21,0,30,9
1715647182192,SOCI 117,A01,494376,Staff,0,5,5,5
1715647183217,WES 237B,A00,494380,Staff,10,0,20,10
1715647185289,AESE 279B,A00,494370,Wade; Jon P,0,0,33,33
1715647186315,AIP 97,001,660915,Van Den Einde; Yael Dahlia,9998,0,9999,1
1715647187341,AIP 197,001,627712,Vespa; Emanuel Ignacio,9995,0,9999,4
1715647187341,AIP 197,002,650778,Amir; On,9998,0,9999,1
1715647187341,AIP 197,003,650933,Avenancio-Leon; Carlos,9998,0,9999,1
1715647187341,AIP 197,004,658530,Heyman; Gail D.,9998,0,9999,1
1715647187341,AIP 197,005,658631,Neal; Sonya E,9998,0,9999,1
1715647187341,AIP 197,006,658671,Du; Songzi,9998,0,9999,1
1715647188368,ANAR 135S,A00,494369,Braswell; Geoffrey E.,0,0,0,0
1715647189400,BENG 196,001,628496,Engler; Adam J.,9998,0,9999,1
1715647189400,BENG 196,002,660916,Watson; John Thomas,9998,0,9999,1
1715647190425,BISP 197,001,650773,Wilhelm; James E.,9994,0,9999,5
1715647190425,BISP 197,002,658904,Coleman; Aaron B.,9998,0,9999,1
1715647191454,CAT 124RS,A01,519847,Geibel; William,0,0,20,20
1715647192480,CAT 125RS,A01,515971,Geibel; William,0,0,20,20
1715647193508,CLRE 250,A00,511389,Morris; Sheldon,9992,0,9999,7
1715647194535,CLRE 251,A00,507176,Mehta; Ravindra L.,9992,0,9999,7
1715647194535,CLRE 251,B00,511410,Mehta; Ravindra L.,9998,0,9999,1
1715647195562,CLRE 252,A00,507189,Cuomo; Raphael Eduardo,9994,0,9999,5
1715647196590,CLRE 253,A00,507199,Vaida; Florin,9994,0,9999,5
1715647196590,CLRE 253,B00,507202,Vaida; Florin,9999,0,9999,0
1715647197616,CLRE 259,A00,507211,Patel; Hemal,9996,0,9999,3
1715647198643,CLRE 260,A00,507221,Cuomo; Raphael Eduardo,9999,0,9999,0
1715647199668,CLRE 297,001,507242,Cuomo; Raphael Eduardo,9999,0,9999,0
1715647200694,COGS 197,001,638244,Voytek; Bradley Thomas,9997,0,9999,2
1715647201720,CSE 191,A00,516875,Minnes Kemp; Mor Mia,9991,0,9999,8
1715647202743,CSE 197,001,637388,Minnes Kemp; Mor Mia,9992,0,9999,7
1715647203770,CSS 201S,A01,494383,Mignozzetti; Umberto,35,0,35,0
1715647204798,CSS 202S,A01,494387,Mignozzetti; Umberto,35,0,35,0
1715647205826,DSC 197,001,628532,Eldridge; Justin Matthew,9995,0,9999,4
1715647206852,EAP 100,A00,516065,Staff,9799,0,9999,200
1715647207885,ECE 45,A01,507414,Staff,32,0,60,28
1715647209939,ECE 111,A01,507420,Staff,11,0,50,39
1715647210964,ECE 197,001,548057,Sievenpiper; Daniel F.,9991,0,9999,8
1715647211990,EDS 115,A00,507243,Choi; Bailey Miyeon,6,0,28,22
1715647213019,EDS 117,A01,494379,Staff,0,6,34,35
1715647214042,EDS 125,A00,507246,Hopkins; Megan Beth,7,0,30,23
1715647215072,EDS 128A,A01,507264,Fargason; Sharon Gayle,5,0,26,21
1715647216102,EDS 128B,A01,507293,Pappas; Elizabeth,9,0,30,21
1715647217128,EDS 139,A00,507294,Fargason; Sharon Gayle,9,0,30,21
1715647217128,EDS 139,B00,507313,Pappas; Elizabeth,9,0,30,21
1715647218152,EDS 201,A00,507315,Staff,10,0,30,20
1715647219181,EDS 203,A01,507317,Halter; Christopher P.,10,0,30,20
1715647220209,EDS 204R,A01,507319,Halter; Christopher P.,0,3,30,30
1715647220209,EDS 204R,B01,507331,Heinzman; Erica M.,14,0,30,16
1715647221238,EDS 206R,A00,507332,Staff,0,4,30,30
1715647221238,EDS 206R,B00,507343,Staff,15,0,30,15
1715647222267,EDS 250,A00,507344,Hemans; Patricia Ann Benitez,20,0,40,20
1715647223294,EDS 281,A00,507345,Daly; Alan J.,18,0,18,0
1715647224321,EDS 284,A00,507350,Daly; Alan J.,16,0,16,0
1715647225346,EDS 286,A00,507359,Fine; Sarah,18,0,18,0
1715647226371,EDS 289C,A01,507361,Daly; Alan J.,18,0,18,0
1715647227396,EDS 290,A00,507366,Hofstetter; Carolyn,15,0,15,0
1715647228427,LIGM 5A,A00,507421,Fischer-Grunski; Eva K,17,0,20,3
1715647229456,LIGM 5B,A00,507423,Fischer-Grunski; Eva K,19,0,20,1
1715647230486,LIGM 5C,A00,507425,Fischer-Grunski; Eva K,19,0,20,1
1715647231516,LIIT 5AS,A00,507427,Carnelos; Chiara,20,0,20,0
1715647232545,LIIT 5BS,A00,507430,Carnelos; Chiara,20,0,20,0
1715647233571,LIIT 5CS,A00,507432,Carnelos; Chiara,20,0,20,0
1715647234597,LISP 5A,A00,507541,Munoz Sanchez; Alicia,11,0,20,9
1715647235625,LISP 5B,A00,507671,Munoz Sanchez; Alicia,8,0,20,12
1715647236653,LISP 5C,A00,507696,Munoz Sanchez; Alicia,8,0,20,12
1715647237680,MAE 197,001,528363,Boechler; Nicholas Sebastia,9998,0,9999,1
1715647238705,MATH 197,001,523477,Kedlaya; Kiran S.,9994,0,9999,5
1715647238705,MATH 197,002,563811,Zhang; Danna,9994,0,9999,5
1715647238705,MATH 197,003,628552,Dumitriu; Ioana,9998,0,9999,1
1715647238705,MATH 197,004,660885,Floyd; Eric,9998,0,9999,1
1715647239735,MCWP 40R,A00,518780,Staff,1,0,20,19
1715647239735,MCWP 40R,B00,518781,Carter; Jennifer A,10,0,20,10
1715647239735,MCWP 40R,C00,518783,Smith; Haydee Marie,5,0,20,15
1715647240764,MCWP 50R,A00,518791,Redela; Pamela Morgan,0,1,20,20
1715647240764,MCWP 50R,B00,518792,Krone; Jarret,0,2,20,20
1715647240764,MCWP 50R,C00,518793,Staff,0,4,20,20
1715647240764,MCWP 50R,D00,518794,Morshed; Michael James,0,2,20,20
1715647240764,MCWP 50R,E00,518795,Carter; Andrea L,0,2,20,20
1715647240764,MCWP 50R,F00,518796,Miller; Elizabeth Deen,0,1,20,20
1715647240764,MCWP 50R,G00,518797,Guillen; Melinda,0,1,20,20
1715647241793,MMW 12R,A01,514034,Herbst; Matthew,0,2,16,16
1715647241793,MMW 12R,A02,514035,Herbst; Matthew,0,0,16,16
1715647242822,MMW 13R,A01,514037,Staff,0,5,16,16
1715647242822,MMW 13R,A02,514039,Staff,0,5,16,16
1715647242822,MMW 13R,A03,628519,Staff,0,4,16,16
1715647244876,SIO 295LS,A00,523233,Staff,10,0,30,20
1715647245903,SIO 295S,A00,523232,Staff,10,0,30,20
1715647246928,SIOC 290S,A01,637330,Merrifield; Mark A,21,0,30,9
1715647247957,SIOC 291S,A01,637333,Gabriel; Corey John,21,0,30,9
1715647248982,SOCI 117,A01,494376,Staff,0,5,5,5
1715647250061,WES 237B,A00,494380,Staff,10,0,20,10
1715647252130,AESE 279B,A00,494370,Wade; Jon P,0,0,33,33
1715647253156,AIP 97,001,660915,Van Den Einde; Yael Dahlia,9998,0,9999,1
1715647254188,AIP 197,001,627712,Vespa; Emanuel Ignacio,9995,0,9999,4
1715647254188,AIP 197,002,650778,Amir; On,9998,0,9999,1
1715647254188,AIP 197,003,650933,Avenancio-Leon; Carlos,9998,0,9999,1
1715647254188,AIP 197,004,658530,Heyman; Gail D.,9998,0,9999,1
1715647254188,AIP 197,005,658631,Neal; Sonya E,9998,0,9999,1
1715647254188,AIP 197,006,658671,Du; Songzi,9998,0,9999,1
1715647255213,ANAR 135S,A00,494369,Braswell; Geoffrey E.,0,0,0,0
1715647256242,BENG 196,001,628496,Engler; Adam J.,9998,0,9999,1
1715647256242,BENG 196,002,660916,Watson; John Thomas,9998,0,9999,1
1715647257269,BISP 197,001,650773,Wilhelm; James E.,9994,0,9999,5
1715647257269,BISP 197,002,658904,Coleman; Aaron B.,9998,0,9999,1
1715647258295,CAT 124RS,A01,519847,Geibel; William,0,0,20,20
1715647259378,CAT 125RS,A01,515971,Geibel; William,0,0,20,20
1715647260404,CLRE 250,A00,511389,Morris; Sheldon,9992,0,9999,7
1715647261437,CLRE 251,A00,507176,Mehta; Ravindra L.,9992,0,9999,7
1715647261437,CLRE 251,B00,511410,Mehta; Ravindra L.,9998,0,9999,1
1715647262463,CLRE 252,A00,507189,Cuomo; Raphael Eduardo,9994,0,9999,5
1715647263488,CLRE 253,A00,507199,Vaida; Florin,9994,0,9999,5
1715647263488,CLRE 253,B00,507202,Vaida; Florin,9999,0,9999,0
1715647264514,CLRE 259,A00,507211,Patel; Hemal,9996,0,9999,3
1715647265542,CLRE 260,A00,507221,Cuomo; Raphael Eduardo,9999,0,9999,0
1715647266566,CLRE 297,001,507242,Cuomo; Raphael Eduardo,9999,0,9999,0
1715647267593,COGS 197,001,638244,Voytek; Bradley Thomas,9997,0,9999,2
1715647268619,CSE 191,A00,516875,Minnes Kemp; Mor Mia,9991,0,9999,8
1715647269647,CSE 197,001,637388,Minnes Kemp; Mor Mia,9992,0,9999,7
1715647270676,CSS 201S,A01,494383,Mignozzetti; Umberto,35,0,35,0
1715647271704,CSS 202S,A01,494387,Mignozzetti; Umberto,35,0,35,0
1715647272730,DSC 197,001,628532,Eldridge; Justin Matthew,9995,0,9999,4
1715647273754,EAP 100,A00,516065,Staff,9799,0,9999,200
1715647274783,ECE 45,A01,507414,Staff,32,0,60,28
1715647276835,ECE 111,A01,507420,Staff,11,0,50,39
1715647277860,ECE 197,001,548057,Sievenpiper; Daniel F.,9991,0,9999,8
1715647278886,EDS 115,A00,507243,Choi; Bailey Miyeon,6,0,28,22
1715647279914,EDS 117,A01,494379,Staff,0,6,34,35
1715647280940,EDS 125,A00,507246,Hopkins; Megan Beth,7,0,30,23
1715647281968,EDS 128A,A01,507264,Fargason; Sharon Gayle,5,0,26,21
1715647282997,EDS 128B,A01,507293,Pappas; Elizabeth,9,0,30,21
1715647284025,EDS 139,A00,507294,Fargason; Sharon Gayle,9,0,30,21
1715647284025,EDS 139,B00,507313,Pappas; Elizabeth,9,0,30,21
1715647285055,EDS 201,A00,507315,Staff,10,0,30,20
1715647286085,EDS 203,A01,507317,Halter; Christopher P.,10,0,30,20
1715647287112,EDS 204R,A01,507319,Halter; Christopher P.,0,3,30,30
1715647287112,EDS 204R,B01,507331,Heinzman; Erica M.,14,0,30,16
1715647288139,EDS 206R,A00,507332,Staff,0,4,30,30
1715647288139,EDS 206R,B00,507343,Staff,15,0,30,15
1715647289164,EDS 250,A00,507344,Hemans; Patricia Ann Benitez,20,0,40,20
1715647290189,EDS 281,A00,507345,Daly; Alan J.,18,0,18,0
1715647291217,EDS 284,A00,507350,Daly; Alan J.,16,0,16,0
1715647292246,EDS 286,A00,507359,Fine; Sarah,18,0,18,0
1715647293272,EDS 289C,A01,507361,Daly; Alan J.,18,0,18,0
1715647294297,EDS 290,A00,507366,Hofstetter; Carolyn,15,0,15,0
1715647295323,LIGM 5A,A00,507421,Fischer-Grunski; Eva K,17,0,20,3
1715647296351,LIGM 5B,A00,507423,Fischer-Grunski; Eva K,19,0,20,1
1715647297380,LIGM 5C,A00,507425,Fischer-Grunski; Eva K,19,0,20,1
1715647298405,LIIT 5AS,A00,507427,Carnelos; Chiara,20,0,20,0
1715647299433,LIIT 5BS,A00,507430,Carnelos; Chiara,20,0,20,0
1715647300462,LIIT 5CS,A00,507432,Carnelos; Chiara,20,0,20,0
1715647301491,LISP 5A,A00,507541,Munoz Sanchez; Alicia,11,0,20,9
1715647302520,LISP 5B,A00,507671,Munoz Sanchez; Alicia,8,0,20,12
1715647303546,LISP 5C,A00,507696,Munoz Sanchez; Alicia,8,0,20,12
1715647304575,MAE 197,001,528363,Boechler; Nicholas Sebastia,9998,0,9999,1
1715647305602,MATH 197,001,523477,Kedlaya; Kiran S.,9994,0,9999,5
1715647305602,MATH 197,002,563811,Zhang; Danna,9994,0,9999,5
1715647305602,MATH 197,003,628552,Dumitriu; Ioana,9998,0,9999,1
1715647305602,MATH 197,004,660885,Floyd; Eric,9998,0,9999,1
1715647306632,MCWP 40R,A00,518780,Staff,1,0,20,19
1715647306632,MCWP 40R,B00,518781,Carter; Jennifer A,10,0,20,10
1715647306632,MCWP 40R,C00,518783,Smith; Haydee Marie,5,0,20,15
1715647307659,MCWP 50R,A00,518791,Redela; Pamela Morgan,0,1,20,20
1715647307659,MCWP 50R,B00,518792,Krone; Jarret,0,2,20,20
1715647307659,MCWP 50R,C00,518793,Staff,0,4,20,20
1715647307659,MCWP 50R,D00,518794,Morshed; Michael James,0,2,20,20
1715647307659,MCWP 50R,E00,518795,Carter; Andrea L,0,2,20,20
1715647307659,MCWP 50R,F00,518796,Miller; Elizabeth Deen,0,1,20,20
1715647307659,MCWP 50R,G00,518797,Guillen; Melinda,0,1,20,20
1715647308685,MMW 12R,A01,514034,Herbst; Matthew,0,2,16,16
1715647308685,MMW 12R,A02,514035,Herbst; Matthew,0,0,16,16
1715647309711,MMW 13R,A01,514037,Staff,0,5,16,16
1715647309711,MMW 13R,A02,514039,Staff,0,5,16,16
1715647309711,MMW 13R,A03,628519,Staff,0,4,16,16
1715647311766,SIO 295LS,A00,523233,Staff,10,0,30,20
1715647312791,SIO 295S,A00,523232,Staff,10,0,30,20
1715647313820,SIOC 290S,A01,637330,Merrifield; Mark A,21,0,30,9
1715647314849,SIOC 291S,A01,637333,Gabriel; Corey John,21,0,30,9
1715647315877,SOCI 117,A01,494376,Staff,0,5,5,5
1715647316902,WES 237B,A00,494380,Staff,10,0,20,10
1715647318987,AESE 279B,A00,494370,Wade; Jon P,0,0,33,33
1715647320067,AIP 97,001,660915,Van Den Einde; Yael Dahlia,9998,0,9999,1
1715647321096,AIP 197,001,627712,Vespa; Emanuel Ignacio,9995,0,9999,4
1715647321096,AIP 197,002,650778,Amir; On,9998,0,9999,1
1715647321096,AIP 197,003,650933,Avenancio-Leon; Carlos,9998,0,9999,1
1715647321096,AIP 197,004,658530,Heyman; Gail D.,9998,0,9999,1
1715647321096,AIP 197,005,658631,Neal; Sonya E,9998,0,9999,1
1715647321096,AIP 197,006,658671,Du; Songzi,9998,0,9999,1
1715647322122,ANAR 135S,A00,494369,Braswell; Geoffrey E.,0,0,0,0
1715647323149,BENG 196,001,628496,Engler; Adam J.,9998,0,9999,1
1715647323149,BENG 196,002,660916,Watson; John Thomas,9998,0,9999,1
1715647324176,BISP 197,001,650773,Wilhelm; James E.,9994,0,9999,5
1715647324176,BISP 197,002,658904,Coleman; Aaron B.,9998,0,9999,1
1715647325201,CAT 124RS,A01,519847,Geibel; William,0,0,20,20
1715647326225,CAT 125RS,A01,515971,Geibel; William,0,0,20,20
1715647327250,CLRE 250,A00,511389,Morris; Sheldon,9992,0,9999,7
1715647328277,CLRE 251,A00,507176,Mehta; Ravindra L.,9992,0,9999,7
1715647328277,CLRE 251,B00,511410,Mehta; Ravindra L.,9998,0,9999,1
1715647329303,CLRE 252,A00,507189,Cuomo; Raphael Eduardo,9994,0,9999,5
1715647330331,CLRE 253,A00,507199,Vaida; Florin,9994,0,9999,5
1715647330331,CLRE 253,B00,507202,Vaida; Florin,9999,0,9999,0
1715647331357,CLRE 259,A00,507211,Patel; Hemal,9996,0,9999,3
1715647332383,CLRE 260,A00,507221,Cuomo; Raphael Eduardo,9999,0,9999,0
1715647333408,CLRE 297,001,507242,Cuomo; Raphael Eduardo,9999,0,9999,0
1715647334433,COGS 197,001,638244,Voytek; Bradley Thomas,9997,0,9999,2
1715647335462,CSE 191,A00,516875,Minnes Kemp; Mor Mia,9991,0,9999,8
1715647336490,CSE 197,001,637388,Minnes Kemp; Mor Mia,9992,0,9999,7
1715647337527,CSS 201S,A01,494383,Mignozzetti; Umberto,35,0,35,0
1715647338553,CSS 202S,A01,494387,Mignozzetti; Umberto,35,0,35,0
1715647339585,DSC 197,001,628532,Eldridge; Justin Matthew,9995,0,9999,4
1715647340609,EAP 100,A00,516065,Staff,9799,0,9999,200
1715647341639,ECE 45,A01,507414,Staff,32,0,60,28
1715647343691,ECE 111,A01,507420,Staff,11,0,50,39
1715647344717,ECE 197,001,548057,Sievenpiper; Daniel F.,9991,0,9999,8
1715647345746,EDS 115,A00,507243,Choi; Bailey Miyeon,6,0,28,22
1715647346772,EDS 117,A01,494379,Staff,0,6,34,35
1715647347798,EDS 125,A00,507246,Hopkins; Megan Beth,7,0,30,23
1715647348824,EDS 128A,A01,507264,Fargason; Sharon Gayle,5,0,26,21
1715647349854,EDS 128B,A01,507293,Pappas; Elizabeth,9,0,30,21
1715647350880,EDS 139,A00,507294,Fargason; Sharon Gayle,9,0,30,21
1715647350880,EDS 139,B00,507313,Pappas; Elizabeth,9,0,30,21
1715647351908,EDS 201,A00,507315,Staff,10,0,30,20
1715647352934,EDS 203,A01,507317,Halter; Christopher P.,10,0,30,20
1715647353963,EDS 204R,A01,507319,Halter; Christopher P.,0,3,30,30
1715647353963,EDS 204R,B01,507331,Heinzman; Erica M.,14,0,30,16
1715647354992,EDS 206R,A00,507332,Staff,0,4,30,30
1715647354992,EDS 206R,B00,507343,Staff,15,0,30,15
1715647356023,EDS 250,A00,507344,Hemans; Patricia Ann Benitez,20,0,40,20
1715647357048,EDS 281,A00,507345,Daly; Alan J.,18,0,18,0
1715647358074,EDS 284,A00,507350,Daly; Alan J.,16,0,16,0
1715647359100,EDS 286,A00,507359,Fine; Sarah,18,0,18,0
1715647360127,EDS 289C,A01,507361,Daly; Alan J.,18,0,18,0
1715647361153,EDS 290,A00,507366,Hofstetter; Carolyn,15,0,15,0
1715647362181,LIGM 5A,A00,507421,Fischer-Grunski; Eva K,17,0,20,3
1715647363208,LIGM 5B,A00,507423,Fischer-Grunski; Eva K,19,0,20,1
1715647364234,LIGM 5C,A00,507425,Fischer-Grunski; Eva K,19,0,20,1
1715647365264,LIIT 5AS,A00,507427,Carnelos; Chiara,20,0,20,0
1715647366293,LIIT 5BS,A00,507430,Carnelos; Chiara,20,0,20,0
1715647367323,LIIT 5CS,A00,507432,Carnelos; Chiara,20,0,20,0
1715647368352,LISP 5A,A00,507541,Munoz Sanchez; Alicia,11,0,20,9
1715647369376,LISP 5B,A00,507671,Munoz Sanchez; Alicia,8,0,20,12
1715647370402,LISP 5C,A00,507696,Munoz Sanchez; Alicia,8,0,20,12
1715647371427,MAE 197,001,528363,Boechler; Nicholas Sebastia,9998,0,9999,1
1715647372460,MATH 197,001,523477,Kedlaya; Kiran S.,9994,0,9999,5
1715647372460,MATH 197,002,563811,Zhang; Danna,9994,0,9999,5
1715647372460,MATH 197,003,628552,Dumitriu; Ioana,9998,0,9999,1
1715647372460,MATH 197,004,660885,Floyd; Eric,9998,0,9999,1
1715647373487,MCWP 40R,A00,518780,Staff,1,0,20,19
1715647373487,MCWP 40R,B00,518781,Carter; Jennifer A,10,0,20,10
1715647373487,MCWP 40R,C00,518783,Smith; Haydee Marie,5,0,20,15
1715647374516,MCWP 50R,A00,518791,Redela; Pamela Morgan,0,1,20,20
1715647374516,MCWP 50R,B00,518792,Krone; Jarret,0,2,20,20
1715647374516,MCWP 50R,C00,518793,Staff,0,4,20,20
1715647374516,MCWP 50R,D00,518794,Morshed; Michael James,0,2,20,20
1715647374516,MCWP 50R,E00,518795,Carter; Andrea L,0,2,20,20
1715647374516,MCWP 50R,F00,518796,Miller; Elizabeth Deen,0,1,20,20
1715647374516,MCWP 50R,G00,518797,Guillen; Melinda,0,1,20,20
1715647375545,MMW 12R,A01,514034,Herbst; Matthew,0,2,16,16
1715647375545,MMW 12R,A02,514035,Herbst; Matthew,0,0,16,16
1715647376569,MMW 13R,A01,514037,Staff,0,5,16,16
1715647376569,MMW 13R,A02,514039,Staff,0,5,16,16
1715647376569,MMW 13R,A03,628519,Staff,0,4,16,16
1715647378624,SIO 295LS,A00,523233,Staff,10,0,30,20
1715647379650,SIO 295S,A00,523232,Staff,10,0,30,20
1715647380677,SIOC 290S,A01,637330,Merrifield; Mark A,21,0,30,9
1715647381764,SIOC 291S,A01,637333,Gabriel; Corey John,21,0,30,9
1715647382796,SOCI 117,A01,494376,Staff,0,5,5,5
1715647383821,WES 237B,A00,494380,Staff,10,0,20,10
1715647385890,AESE 279B,A00,494370,Wade; Jon P,0,0,33,33
1715647386916,AIP 97,001,660915,Van Den Einde; Yael Dahlia,9998,0,9999,1
1715647387944,AIP 197,001,627712,Vespa; Emanuel Ignacio,9995,0,9999,4
1715647387944,AIP 197,002,650778,Amir; On,9998,0,9999,1
1715647387944,AIP 197,003,650933,Avenancio-Leon; Carlos,9998,0,9999,1
1715647387944,AIP 197,004,658530,Heyman; Gail D.,9998,0,9999,1
1715647387944,AIP 197,005,658631,Neal; Sonya E,9998,0,9999,1
1715647387944,AIP 197,006,658671,Du; Songzi,9998,0,9999,1
1715647388972,ANAR 135S,A00,494369,Braswell; Geoffrey E.,0,0,0,0
1715647390005,BENG 196,001,628496,Engler; Adam J.,9998,0,9999,1
1715647390005,BENG 196,002,660916,Watson; John Thomas,9998,0,9999,1
1715647391031,BISP 197,001,650773,Wilhelm; James E.,9994,0,9999,5
1715647391031,BISP 197,002,658904,Coleman; Aaron B.,9998,0,9999,1
1715647392058,CAT 124RS,A01,519847,Geibel; William,0,0,20,20
1715647393083,CAT 125RS,A01,515971,Geibel; William,0,0,20,20
1715647394111,CLRE 250,A00,511389,Morris; Sheldon,9992,0,9999,7
1715647395138,CLRE 251,A00,507176,Mehta; Ravindra L.,9992,0,9999,7
1715647395138,CLRE 251,B00,511410,Mehta; Ravindra L.,9998,0,9999,1
1715647396184,CLRE 252,A00,507189,Cuomo; Raphael Eduardo,9994,0,9999,5
1715647397213,CLRE 253,A00,507199,Vaida; Florin,9994,0,9999,5
1715647397213,CLRE 253,B00,507202,Vaida; Florin,9999,0,9999,0
1715647398242,CLRE 259,A00,507211,Patel; Hemal,9996,0,9999,3
1715647399268,CLRE 260,A00,507221,Cuomo; Raphael Eduardo,9999,0,9999,0
1715647400293,CLRE 297,001,507242,Cuomo; Raphael Eduardo,9999,0,9999,0
1715647401318,COGS 197,001,638244,Voytek; Bradley Thomas,9997,0,9999,2
1715647402343,CSE 191,A00,516875,Minnes Kemp; Mor Mia,9991,0,9999,8
1715647403371,CSE 197,001,637388,Minnes Kemp; Mor Mia,9992,0,9999,7
1715647404402,CSS 201S,A01,494383,Mignozzetti; Umberto,35,0,35,0
1715647405427,CSS 202S,A01,494387,Mignozzetti; Umberto,35,0,35,0
1715647406452,DSC 197,001,628532,Eldridge; Justin Matthew,9995,0,9999,4
1715647407481,EAP 100,A00,516065,Staff,9799,0,9999,200
1715647408509,ECE 45,A01,507414,Staff,32,0,60,28
1715647410560,ECE 111,A01,507420,Staff,11,0,50,39
1715647411588,ECE 197,001,548057,Sievenpiper; Daniel F.,9991,0,9999,8
1715647412615,EDS 115,A00,507243,Choi; Bailey Miyeon,6,0,28,22
1715647413644,EDS 117,A01,494379,Staff,0,6,34,35
1715647414670,EDS 125,A00,507246,Hopkins; Megan Beth,7,0,30,23
1715647415695,EDS 128A,A01,507264,Fargason; Sharon Gayle,5,0,26,21
1715647416726,EDS 128B,A01,507293,Pappas; Elizabeth,9,0,30,21
1715647417752,EDS 139,A00,507294,Fargason; Sharon Gayle,9,0,30,21
1715647417752,EDS 139,B00,507313,Pappas; Elizabeth,9,0,30,21
1715647418781,EDS 201,A00,507315,Staff,10,0,30,20
1715647419809,EDS 203,A01,507317,Halter; Christopher P.,10,0,30,20
1715647420833,EDS 204R,A01,507319,Halter; Christopher P.,0,3,30,30
1715647420833,EDS 204R,B01,507331,Heinzman; Erica M.,14,0,30,16
1715647421857,EDS 206R,A00,507332,Staff,0,4,30,30
1715647421857,EDS 206R,B00,507343,Staff,15,0,30,15
1715647422883,EDS 250,A00,507344,Hemans; Patricia Ann Benitez,20,0,40,20
1715647423907,EDS 281,A00,507345,Daly; Alan J.,18,0,18,0
1715647424933,EDS 284,A00,507350,Daly; Alan J.,16,0,16,0
1715647425959,EDS 286,A00,507359,Fine; Sarah,18,0,18,0
1715647426985,EDS 289C,A01,507361,Daly; Alan J.,18,0,18,0
1715647428013,EDS 290,A00,507366,Hofstetter; Carolyn,15,0,15,0
1715647429040,LIGM 5A,A00,507421,Fischer-Grunski; Eva K,17,0,20,3
1715647430071,LIGM 5B,A00,507423,Fischer-Grunski; Eva K,19,0,20,1
1715647431099,LIGM 5C,A00,507425,Fischer-Grunski; Eva K,19,0,20,1
1715647432125,LIIT 5AS,A00,507427,Carnelos; Chiara,20,0,20,0
1715647433150,LIIT 5BS,A00,507430,Carnelos; Chiara,20,0,20,0
1715647434179,LIIT 5CS,A00,507432,Carnelos; Chiara,20,0,20,0
1715647435210,LISP 5A,A00,507541,Munoz Sanchez; Alicia,11,0,20,9
1715647436240,LISP 5B,A00,507671,Munoz Sanchez; Alicia,8,0,20,12
1715647437265,LISP 5C,A00,507696,Munoz Sanchez; Alicia,8,0,20,12
1715647438296,MAE 197,001,528363,Boechler; Nicholas Sebastia,9998,0,9999,1
1715647439322,MATH 197,001,523477,Kedlaya; Kiran S.,9994,0,9999,5
1715647439322,MATH 197,002,563811,Zhang; Danna,9994,0,9999,5
1715647439322,MATH 197,003,628552,Dumitriu; Ioana,9998,0,9999,1
1715647439322,MATH 197,004,660885,Floyd; Eric,9998,0,9999,1
1715647440351,MCWP 40R,A00,518780,Staff,1,0,20,19
1715647440351,MCWP 40R,B00,518781,Carter; Jennifer A,10,0,20,10
1715647440351,MCWP 40R,C00,518783,Smith; Haydee Marie,5,0,20,15
1715647441380,MCWP 50R,A00,518791,Redela; Pamela Morgan,0,1,20,20
1715647441380,MCWP 50R,B00,518792,Krone; Jarret,0,2,20,20
1715647441380,MCWP 50R,C00,518793,Staff,0,4,20,20
1715647441380,MCWP 50R,D00,518794,Morshed; Michael James,0,2,20,20
1715647441380,MCWP 50R,E00,518795,Carter; Andrea L,0,2,20,20
1715647441380,MCWP 50R,F00,518796,Miller; Elizabeth Deen,0,1,20,20
1715647441380,MCWP 50R,G00,518797,Guillen; Melinda,0,1,20,20
1715647442411,MMW 12R,A01,514034,Herbst; Matthew,0,2,16,16
1715647442411,MMW 12R,A02,514035,Herbst; Matthew,0,0,16,16
1715647443434,MMW 13R,A01,514037,Staff,0,5,16,16
1715647443434,MMW 13R,A02,514039,Staff,0,5,16,16
1715647443434,MMW 13R,A03,628519,Staff,0,4,16,16
1715647445490,SIO 295LS,A00,523233,Staff,10,0,30,20
1715647446516,SIO 295S,A00,523232,Staff,10,0,30,20
1715647447545,SIOC 290S,A01,637330,Merrifield; Mark A,21,0,30,9
1715647448575,SIOC 291S,A01,637333,Gabriel; Corey John,21,0,30,9
1715647449602,SOCI 117,A01,494376,Staff,0,5,5,5
1715647450628,WES 237B,A00,494380,Staff,10,0,20,10
1715647452708,AESE 279B,A00,494370,Wade; Jon P,0,0,33,33
1715647453732,AIP 97,001,660915,Van Den Einde; Yael Dahlia,9998,0,9999,1
1715647454765,AIP 197,001,627712,Vespa; Emanuel Ignacio,9995,0,9999,4
1715647454765,AIP 197,002,650778,Amir; On,9998,0,9999,1
1715647454765,AIP 197,003,650933,Avenancio-Leon; Carlos,9998,0,9999,1
1715647454765,AIP 197,004,658530,Heyman; Gail D.,9998,0,9999,1
1715647454765,AIP 197,005,658631,Neal; Sonya E,9998,0,9999,1
1715647454765,AIP 197,006,658671,Du; Songzi,9998,0,9999,1
1715647455790,ANAR 135S,A00,494369,Braswell; Geoffrey E.,0,0,0,0
1715647456819,BENG 196,001,628496,Engler; Adam J.,9998,0,9999,1
1715647456819,BENG 196,002,660916,Watson; John Thomas,9998,0,9999,1
1715647457855,BISP 197,001,650773,Wilhelm; James E.,9994,0,9999,5
1715647457855,BISP 197,002,658904,Coleman; Aaron B.,9998,0,9999,1
1715647458885,CAT 124RS,A01,519847,Geibel; William,0,0,20,20
1715647459908,CAT 125RS,A01,515971,Geibel; William,0,0,20,20
1715647460934,CLRE 250,A00,511389,Morris; Sheldon,9992,0,9999,7
1715647461961,CLRE 251,A00,507176,Mehta; Ravindra L.,9992,0,9999,7
1715647461961,CLRE 251,B00,511410,Mehta; Ravindra L.,9998,0,9999,1
1715647462989,CLRE 252,A00,507189,Cuomo; Raphael Eduardo,9994,0,9999,5
1715647464013,CLRE 253,A00,507199,Vaida; Florin,9994,0,9999,5
1715647464013,CLRE 253,B00,507202,Vaida; Florin,9999,0,9999,0
1715647465042,CLRE 259,A00,507211,Patel; Hemal,9996,0,9999,3
1715647466070,CLRE 260,A00,507221,Cuomo; Raphael Eduardo,9999,0,9999,0
1715647467096,CLRE 297,001,507242,Cuomo; Raphael Eduardo,9999,0,9999,0
1715647468125,COGS 197,001,638244,Voytek; Bradley Thomas,9997,0,9999,2
1715647469148,CSE 191,A00,516875,Minnes Kemp; Mor Mia,9991,0,9999,8
1715647470173,CSE 197,001,637388,Minnes Kemp; Mor Mia,9992,0,9999,7
1715647471199,CSS 201S,A01,494383,Mignozzetti; Umberto,35,0,35,0
1715647472223,CSS 202S,A01,494387,Mignozzetti; Umberto,35,0,35,0
1715647473253,DSC 197,001,628532,Eldridge; Justin Matthew,9995,0,9999,4
1715647474278,EAP 100,A00,516065,Staff,9799,0,9999,200
1715647475304,ECE 45,A01,507414,Staff,32,0,60,28
1715647477353,ECE 111,A01,507420,Staff,11,0,50,39
1715647478381,ECE 197,001,548057,Sievenpiper; Daniel F.,9991,0,9999,8
1715647479408,EDS 115,A00,507243,Choi; Bailey Miyeon,6,0,28,22
1715647480437,EDS 117,A01,494379,Staff,0,6,34,35
1715647481462,EDS 125,A00,507246,Hopkins; Megan Beth,7,0,30,23
1715647482492,EDS 128A,A01,507264,Fargason; Sharon Gayle,5,0,26,21
1715647483517,EDS 128B,A01,507293,Pappas; Elizabeth,9,0,30,21
1715647484544,EDS 139,A00,507294,Fargason; Sharon Gayle,9,0,30,21
1715647484544,EDS 139,B00,507313,Pappas; Elizabeth,9,0,30,21
1715647485570,EDS 201,A00,507315,Staff,10,0,30,20
1715647486595,EDS 203,A01,507317,Halter; Christopher P.,10,0,30,20
1715647487622,EDS 204R,A01,507319,Halter; Christopher P.,0,3,30,30
1715647487622,EDS 204R,B01,507331,Heinzman; Erica M.,14,0,30,16
1715647488647,EDS 206R,A00,507332,Staff,0,4,30,30
1715647488647,EDS 206R,B00,507343,Staff,15,0,30,15
1715647489670,EDS 250,A00,507344,Hemans; Patricia Ann Benitez,20,0,40,20
1715647490697,EDS 281,A00,507345,Daly; Alan J.,18,0,18,0
1715647491723,EDS 284,A00,507350,Daly; Alan J.,16,0,16,0
1715647492749,EDS 286,A00,507359,Fine; Sarah,18,0,18,0
1715647493775,EDS 289C,A01,507361,Daly; Alan J.,18,0,18,0
1715647494800,EDS 290,A00,507366,Hofstetter; Carolyn,15,0,15,0
1715647495826,LIGM 5A,A00,507421,Fischer-Grunski; Eva K,17,0,20,3
1715647496851,LIGM 5B,A00,507423,Fischer-Grunski; Eva K,19,0,20,1
1715647497880,LIGM 5C,A00,507425,Fischer-Grunski; Eva K,19,0,20,1
1715647498905,LIIT 5AS,A00,507427,Carnelos; Chiara,20,0,20,0
1715647499931,LIIT 5BS,A00,507430,Carnelos; Chiara,20,0,20,0
1715647500960,LIIT 5CS,A00,507432,Carnelos; Chiara,20,0,20,0
1715647501989,LISP 5A,A00,507541,Munoz Sanchez; Alicia,11,0,20,9
1715647503014,LISP 5B,A00,507671,Munoz Sanchez; Alicia,8,0,20,12
1715647504047,LISP 5C,A00,507696,Munoz Sanchez; Alicia,8,0,20,12
1715647505073,MAE 197,001,528363,Boechler; Nicholas Sebastia,9998,0,9999,1
1715647506100,MATH 197,001,523477,Kedlaya; Kiran S.,9994,0,9999,5
1715647506100,MATH 197,002,563811,Zhang; Danna,9994,0,9999,5
1715647506100,MATH 197,003,628552,Dumitriu; Ioana,9998,0,9999,1
1715647506100,MATH 197,004,660885,Floyd; Eric,9998,0,9999,1
1715647507130,MCWP 40R,A00,518780,Staff,1,0,20,19
1715647507130,MCWP 40R,B00,518781,Carter; Jennifer A,10,0,20,10
1715647507130,MCWP 40R,C00,518783,Smith; Haydee Marie,5,0,20,15
1715647508157,MCWP 50R,A00,518791,Redela; Pamela Morgan,0,1,20,20
1715647508157,MCWP 50R,B00,518792,Krone; Jarret,0,2,20,20
1715647508157,MCWP 50R,C00,518793,Staff,0,4,20,20
1715647508157,MCWP 50R,D00,518794,Morshed; Michael James,0,2,20,20
1715647508157,MCWP 50R,E00,518795,Carter; Andrea L,0,2,20,20
1715647508157,MCWP 50R,F00,518796,Miller; Elizabeth Deen,0,1,20,20
1715647508157,MCWP 50R,G00,518797,Guillen; Melinda,0,1,20,20
1715647509187,MMW 12R,A01,514034,Herbst; Matthew,0,2,16,16
1715647509187,MMW 12R,A02,514035,Herbst; Matthew,0,0,16,16
1715647510212,MMW 13R,A01,514037,Staff,0,5,16,16
1715647510212,MMW 13R,A02,514039,Staff,0,5,16,16
1715647510212,MMW 13R,A03,628519,Staff,0,4,16,16
1715647512266,SIO 295LS,A00,523233,Staff,10,0,30,20
1715647513293,SIO 295S,A00,523232,Staff,10,0,30,20
1715647514322,SIOC 290S,A01,637330,Merrifield; Mark A,21,0,30,9
1715647515351,SIOC 291S,A01,637333,Gabriel; Corey John,21,0,30,9
1715647516377,SOCI 117,A01,494376,Staff,0,5,5,5
1715647517408,WES 237B,A00,494380,Staff,10,0,20,10
1715647519486,AESE 279B,A00,494370,Wade; Jon P,0,0,33,33
1715647520513,AIP 97,001,660915,Van Den Einde; Yael Dahlia,9998,0,9999,1
1715647521543,AIP 197,001,627712,Vespa; Emanuel Ignacio,9995,0,9999,4
1715647521543,AIP 197,002,650778,Amir; On,9998,0,9999,1
1715647521543,AIP 197,003,650933,Avenancio-Leon; Carlos,9998,0,9999,1
1715647521543,AIP 197,004,658530,Heyman; Gail D.,9998,0,9999,1
1715647521543,AIP 197,005,658631,Neal; Sonya E,9998,0,9999,1
1715647521543,AIP 197,006,658671,Du; Songzi,9998,0,9999,1
1715647522574,ANAR 135S,A00,494369,Braswell; Geoffrey E.,0,0,0,0
1715647523605,BENG 196,001,628496,Engler; Adam J.,9998,0,9999,1
1715647523605,BENG 196,002,660916,Watson; John Thomas,9998,0,9999,1
1715647524631,BISP 197,001,650773,Wilhelm; James E.,9994,0,9999,5
1715647524631,BISP 197,002,658904,Coleman; Aaron B.,9998,0,9999,1
1715647525656,CAT 124RS,A01,519847,Geibel; William,0,0,20,20
1715647526681,CAT 125RS,A01,515971,Geibel; William,0,0,20,20
1715647527709,CLRE 250,A00,511389,Morris; Sheldon,9992,0,9999,7
1715647528736,CLRE 251,A00,507176,Mehta; Ravindra L.,9992,0,9999,7
1715647528736,CLRE 251,B00,511410,Mehta; Ravindra L.,9998,0,9999,1
1715647529762,CLRE 252,A00,507189,Cuomo; Raphael Eduardo,9994,0,9999,5
1715647530787,CLRE 253,A00,507199,Vaida; Florin,9994,0,9999,5
1715647530787,CLRE 253,B00,507202,Vaida; Florin,9999,0,9999,0
1715647531815,CLRE 259,A00,507211,Patel; Hemal,9996,0,9999,3
1715647532840,CLRE 260,A00,507221,Cuomo; Raphael Eduardo,9999,0,9999,0
1715647533880,CLRE 297,001,507242,Cuomo; Raphael Eduardo,9999,0,9999,0
1715647534909,COGS 197,001,638244,Voytek; Bradley Thomas,9997,0,9999,2
1715647535933,CSE 191,A00,516875,Minnes Kemp; Mor Mia,9991,0,9999,8
1715647536961,CSE 197,001,637388,Minnes Kemp; Mor Mia,9992,0,9999,7
1715647537987,CSS 201S,A01,494383,Mignozzetti; Umberto,35,0,35,0
1715647539066,CSS 202S,A01,494387,Mignozzetti; Umberto,35,0,35,0
1715647540091,DSC 197,001,628532,Eldridge; Justin Matthew,9995,0,9999,4
1715647541115,EAP 100,A00,516065,Staff,9799,0,9999,200
1715647542147,ECE 45,A01,507414,Staff,32,0,60,28
1715647544202,ECE 111,A01,507420,Staff,11,0,50,39
1715647545227,ECE 197,001,548057,Sievenpiper; Daniel F.,9991,0,9999,8
1715647546253,EDS 115,A00,507243,Choi; Bailey Miyeon,6,0,28,22
1715647547279,EDS 117,A01,494379,Staff,0,6,34,35
1715647548304,EDS 125,A00,507246,Hopkins; Megan Beth,7,0,30,23
1715647549329,EDS 128A,A01,507264,Fargason; Sharon Gayle,5,0,26,21
1715647550359,EDS 128B,A01,507293,Pappas; Elizabeth,9,0,30,21
1715647551383,EDS 139,A00,507294,Fargason; Sharon Gayle,9,0,30,21
1715647551383,EDS 139,B00,507313,Pappas; Elizabeth,9,0,30,21
1715647552408,EDS 201,A00,507315,Staff,10,0,30,20
1715647553434,EDS 203,A01,507317,Halter; Christopher P.,10,0,30,20
1715647554465,EDS 204R,A01,507319,Halter; Christopher P.,0,3,30,30
1715647554465,EDS 204R,B01,507331,Heinzman; Erica M.,14,0,30,16
1715647555490,EDS 206R,A00,507332,Staff,0,4,30,30
1715647555490,EDS 206R,B00,507343,Staff,15,0,30,15
1715647556515,EDS 250,A00,507344,Hemans; Patricia Ann Benitez,20,0,40,20
1715647557541,EDS 281,A00,507345,Daly; Alan J.,18,0,18,0
1715647558567,EDS 284,A00,507350,Daly; Alan J.,16,0,16,0
1715647559591,EDS 286,A00,507359,Fine; Sarah,18,0,18,0
1715647560617,EDS 289C,A01,507361,Daly; Alan J.,18,0,18,0
1715647561643,EDS 290,A00,507366,Hofstetter; Carolyn,15,0,15,0
1715647562670,LIGM 5A,A00,507421,Fischer-Grunski; Eva K,17,0,20,3
1715647563695,LIGM 5B,A00,507423,Fischer-Grunski; Eva K,19,0,20,1
1715647564722,LIGM 5C,A00,507425,Fischer-Grunski; Eva K,19,0,20,1
1715647565747,LIIT 5AS,A00,507427,Carnelos; Chiara,20,0,20,0
1715647566776,LIIT 5BS,A00,507430,Carnelos; Chiara,20,0,20,0
1715647567801,LIIT 5CS,A00,507432,Carnelos; Chiara,20,0,20,0
1715647568827,LISP 5A,A00,507541,Munoz Sanchez; Alicia,11,0,20,9
1715647569851,LISP 5B,A00,507671,Munoz Sanchez; Alicia,8,0,20,12
1715647570875,LISP 5C,A00,507696,Munoz Sanchez; Alicia,8,0,20,12
1715647571904,MAE 197,001,528363,Boechler; Nicholas Sebastia,9998,0,9999,1
1715647572931,MATH 197,001,523477,Kedlaya; Kiran S.,9994,0,9999,5
1715647572931,MATH 197,002,563811,Zhang; Danna,9994,0,9999,5
1715647572931,MATH 197,003,628552,Dumitriu; Ioana,9998,0,9999,1
1715647572931,MATH 197,004,660885,Floyd; Eric,9998,0,9999,1
1715647573962,MCWP 40R,A00,518780,Staff,1,0,20,19
1715647573962,MCWP 40R,B00,518781,Carter; Jennifer A,10,0,20,10
1715647573962,MCWP 40R,C00,518783,Smith; Haydee Marie,5,0,20,15
1715647574990,MCWP 50R,A00,518791,Redela; Pamela Morgan,0,1,20,20
1715647574990,MCWP 50R,B00,518792,Krone; Jarret,0,2,20,20
1715647574990,MCWP 50R,C00,518793,Staff,0,4,20,20
1715647574990,MCWP 50R,D00,518794,Morshed; Michael James,0,2,20,20
1715647574990,MCWP 50R,E00,518795,Carter; Andrea L,0,2,20,20
1715647574990,MCWP 50R,F00,518796,Miller; Elizabeth Deen,0,1,20,20
1715647574990,MCWP 50R,G00,518797,Guillen; Melinda,0,1,20,20
1715647576019,MMW 12R,A01,514034,Herbst; Matthew,0,2,16,16
1715647576019,MMW 12R,A02,514035,Herbst; Matthew,0,0,16,16
1715647577047,MMW 13R,A01,514037,Staff,0,5,16,16
1715647577047,MMW 13R,A02,514039,Staff,0,5,16,16
1715647577047,MMW 13R,A03,628519,Staff,0,4,16,16
1715647579095,SIO 295LS,A00,523233,Staff,10,0,30,20
1715647580120,SIO 295S,A00,523232,Staff,10,0,30,20
1715647581148,SIOC 290S,A01,637330,Merrifield; Mark A,21,0,30,9
1715647582171,SIOC 291S,A01,637333,Gabriel; Corey John,21,0,30,9
1715647583196,SOCI 117,A01,494376,Staff,0,5,5,5
1715647584222,WES 237B,A00,494380,Staff,10,0,20,10
1715647586283,AESE 279B,A00,494370,Wade; Jon P,0,0,33,33
1715647587313,AIP 97,001,660915,Van Den Einde; Yael Dahlia,9998,0,9999,1
1715647588340,AIP 197,001,627712,Vespa; Emanuel Ignacio,9995,0,9999,4
1715647588340,AIP 197,002,650778,Amir; On,9998,0,9999,1
1715647588340,AIP 197,003,650933,Avenancio-Leon; Carlos,9998,0,9999,1
1715647588340,AIP 197,004,658530,Heyman; Gail D.,9998,0,9999,1
1715647588340,AIP 197,005,658631,Neal; Sonya E,9998,0,9999,1
1715647588340,AIP 197,006,658671,Du; Songzi,9998,0,9999,1
1715647589367,ANAR 135S,A00,494369,Braswell; Geoffrey E.,0,0,0,0
1715647590397,BENG 196,001,628496,Engler; Adam J.,9998,0,9999,1
1715647590397,BENG 196,002,660916,Watson; John Thomas,9998,0,9999,1
1715647591422,BISP 197,001,650773,Wilhelm; James E.,9994,0,9999,5
1715647591422,BISP 197,002,658904,Coleman; Aaron B.,9998,0,9999,1
1715647592449,CAT 124RS,A01,519847,Geibel; William,0,0,20,20
1715647593474,CAT 125RS,A01,515971,Geibel; William,0,0,20,20
1715647594503,CLRE 250,A00,511389,Morris; Sheldon,9992,0,9999,7
1715647595535,CLRE 251,A00,507176,Mehta; Ravindra L.,9992,0,9999,7
1715647595535,CLRE 251,B00,511410,Mehta; Ravindra L.,9998,0,9999,1
1715647596563,CLRE 252,A00,507189,Cuomo; Raphael Eduardo,9994,0,9999,5
1715647597588,CLRE 253,A00,507199,Vaida; Florin,9994,0,9999,5
1715647597588,CLRE 253,B00,507202,Vaida; Florin,9999,0,9999,0
1715647598615,CLRE 259,A00,507211,Patel; Hemal,9996,0,9999,3
1715647599640,CLRE 260,A00,507221,Cuomo; Raphael Eduardo,9999,0,9999,0
1715647600667,CLRE 297,001,507242,Cuomo; Raphael Eduardo,9999,0,9999,0
1715647601694,COGS 197,001,638244,Voytek; Bradley Thomas,9997,0,9999,2
1715647602723,CSE 191,A00,516875,Minnes Kemp; Mor Mia,9991,0,9999,8
1715647603747,CSE 197,001,637388,Minnes Kemp; Mor Mia,9992,0,9999,7
1715647604774,CSS 201S,A01,494383,Mignozzetti; Umberto,35,0,35,0
1715647605802,CSS 202S,A01,494387,Mignozzetti; Umberto,35,0,35,0
1715647606827,DSC 197,001,628532,Eldridge; Justin Matthew,9995,0,9999,4
1715647607852,EAP 100,A00,516065,Staff,9799,0,9999,200
1715647608882,ECE 45,A01,507414,Staff,32,0,60,28
1715647610935,ECE 111,A01,507420,Staff,11,0,50,39
1715647611964,ECE 197,001,548057,Sievenpiper; Daniel F.,9991,0,9999,8
1715647612993,EDS 115,A00,507243,Choi; Bailey Miyeon,6,0,28,22
1715647614020,EDS 117,A01,494379,Staff,0,6,34,35
1715647615051,EDS 125,A00,507246,Hopkins; Megan Beth,7,0,30,23
1715647616077,EDS 128A,A01,507264,Fargason; Sharon Gayle,5,0,26,21
1715647617107,EDS 128B,A01,507293,Pappas; Elizabeth,9,0,30,21
1715647618134,EDS 139,A00,507294,Fargason; Sharon Gayle,9,0,30,21
1715647618134,EDS 139,B00,507313,Pappas; Elizabeth,9,0,30,21
1715647619162,EDS 201,A00,507315,Staff,10,0,30,20
1715647620191,EDS 203,A01,507317,Halter; Christopher P.,10,0,30,20
1715647621221,EDS 204R,A01,507319,Halter; Christopher P.,0,3,30,30
1715647621221,EDS 204R,B01,507331,Heinzman; Erica M.,14,0,30,16
1715647622247,EDS 206R,A00,507332,Staff,0,4,30,30
1715647622247,EDS 206R,B00,507343,Staff,15,0,30,15
1715647623275,EDS 250,A00,507344,Hemans; Patricia Ann Benitez,20,0,40,20
1715647624301,EDS 281,A00,507345,Daly; Alan J.,18,0,18,0
1715647625326,EDS 284,A00,507350,Daly; Alan J.,16,0,16,0
1715647626355,EDS 286,A00,507359,Fine; Sarah,18,0,18,0
1715647627380,EDS 289C,A01,507361,Daly; Alan J.,18,0,18,0
1715647628407,EDS 290,A00,507366,Hofstetter; Carolyn,15,0,15,0
1715647629437,LIGM 5A,A00,507421,Fischer-Grunski; Eva K,17,0,20,3
1715647630463,LIGM 5B,A00,507423,Fischer-Grunski; Eva K,19,0,20,1
1715647631497,LIGM 5C,A00,507425,Fischer-Grunski; Eva K,19,0,20,1
1715647632522,LIIT 5AS,A00,507427,Carnelos; Chiara,20,0,20,0
1715647633548,LIIT 5BS,A00,507430,Carnelos; Chiara,20,0,20,0
1715647634573,LIIT 5CS,A00,507432,Carnelos; Chiara,20,0,20,0
1715647635603,LISP 5A,A00,507541,Munoz Sanchez; Alicia,11,0,20,9
1715647636631,LISP 5B,A00,507671,Munoz Sanchez; Alicia,8,0,20,12
1715647637661,LISP 5C,A00,507696,Munoz Sanchez; Alicia,8,0,20,12
1715647638690,MAE 197,001,528363,Boechler; Nicholas Sebastia,9998,0,9999,1
1715647639716,MATH 197,001,523477,Kedlaya; Kiran S.,9994,0,9999,5
1715647639716,MATH 197,002,563811,Zhang; Danna,9994,0,9999,5
1715647639716,MATH 197,003,628552,Dumitriu; Ioana,9998,0,9999,1
1715647639716,MATH 197,004,660885,Floyd; Eric,9998,0,9999,1
1715647640743,MCWP 40R,A00,518780,Staff,1,0,20,19
1715647640743,MCWP 40R,B00,518781,Carter; Jennifer A,10,0,20,10
1715647640743,MCWP 40R,C00,518783,Smith; Haydee Marie,5,0,20,15
1715647641777,MCWP 50R,A00,518791,Redela; Pamela Morgan,0,1,20,20
1715647641777,MCWP 50R,B00,518792,Krone; Jarret,0,2,20,20
1715647641777,MCWP 50R,C00,518793,Staff,0,4,20,20
1715647641777,MCWP 50R,D00,518794,Morshed; Michael James,0,2,20,20
1715647641777,MCWP 50R,E00,518795,Carter; Andrea L,0,2,20,20
1715647641777,MCWP 50R,F00,518796,Miller; Elizabeth Deen,0,1,20,20
1715647641777,MCWP 50R,G00,518797,Guillen; Melinda,0,1,20,20
1715647642858,MMW 12R,A01,514034,Herbst; Matthew,0,2,16,16
1715647642858,MMW 12R,A02,514035,Herbst; Matthew,0,0,16,16
1715647643888,MMW 13R,A01,514037,Staff,0,5,16,16
1715647643888,MMW 13R,A02,514039,Staff,0,5,16,16
1715647643888,MMW 13R,A03,628519,Staff,0,4,16,16
1715647645939,SIO 295LS,A00,523233,Staff,10,0,30,20
1715647646963,SIO 295S,A00,523232,Staff,10,0,30,20
1715647647994,SIOC 290S,A01,637330,Merrifield; Mark A,21,0,30,9
1715647649021,SIOC 291S,A01,637333,Gabriel; Corey John,21,0,30,9
1715647650047,SOCI 117,A01,494376,Staff,0,5,5,5
1715647651072,WES 237B,A00,494380,Staff,10,0,20,10
1715647653147,AESE 279B,A00,494370,Wade; Jon P,0,0,33,33
1715647654173,AIP 97,001,660915,Van Den Einde; Yael Dahlia,9998,0,9999,1
1715647655201,AIP 197,001,627712,Vespa; Emanuel Ignacio,9995,0,9999,4
1715647655201,AIP 197,002,650778,Amir; On,9998,0,9999,1
1715647655201,AIP 197,003,650933,Avenancio-Leon; Carlos,9998,0,9999,1
1715647655201,AIP 197,004,658530,Heyman; Gail D.,9998,0,9999,1
1715647655201,AIP 197,005,658631,Neal; Sonya E,9998,0,9999,1
1715647655201,AIP 197,006,658671,Du; Songzi,9998,0,9999,1
1715647656225,ANAR 135S,A00,494369,Braswell; Geoffrey E.,0,0,0,0
1715647657252,BENG 196,001,628496,Engler; Adam J.,9998,0,9999,1
1715647657252,BENG 196,002,660916,Watson; John Thomas,9998,0,9999,1
1715647658280,BISP 197,001,650773,Wilhelm; James E.,9994,0,9999,5
1715647658280,BISP 197,002,658904,Coleman; Aaron B.,9998,0,9999,1
1715647659306,CAT 124RS,A01,519847,Geibel; William,0,0,20,20
1715647660333,CAT 125RS,A01,515971,Geibel; William,0,0,20,20
1715647661560,CLRE 250,A00,511389,Morris; Sheldon,9992,0,9999,7
1715647662590,CLRE 251,A00,507176,Mehta; Ravindra L.,9992,0,9999,7
1715647662590,CLRE 251,B00,511410,Mehta; Ravindra L.,9998,0,9999,1
1715647663617,CLRE 252,A00,507189,Cuomo; Raphael Eduardo,9994,0,9999,5
1715647664642,CLRE 253,A00,507199,Vaida; Florin,9994,0,9999,5
1715647664642,CLRE 253,B00,507202,Vaida; Florin,9999,0,9999,0
1715647665671,CLRE 259,A00,507211,Patel; Hemal,9996,0,9999,3
1715647666695,CLRE 260,A00,507221,Cuomo; Raphael Eduardo,9999,0,9999,0
1715647667725,CLRE 297,001,507242,Cuomo; Raphael Eduardo,9999,0,9999,0
1715647668755,COGS 197,001,638244,Voytek; Bradley Thomas,9997,0,9999,2
1715647669779,CSE 191,A00,516875,Minnes Kemp; Mor Mia,9991,0,9999,8
1715647670805,CSE 197,001,637388,Minnes Kemp; Mor Mia,9992,0,9999,7
1715647671832,CSS 201S,A01,494383,Mignozzetti; Umberto,35,0,35,0
1715647672858,CSS 202S,A01,494387,Mignozzetti; Umberto,35,0,35,0
1715647673883,DSC 197,001,628532,Eldridge; Justin Matthew,9995,0,9999,4
1715647674908,EAP 100,A00,516065,Staff,9799,0,9999,200
1715647675941,ECE 45,A01,507414,Staff,32,0,60,28
1715647677994,ECE 111,A01,507420,Staff,11,0,50,39
1715647679018,ECE 197,001,548057,Sievenpiper; Daniel F.,9991,0,9999,8
1715647680045,EDS 115,A00,507243,Choi; Bailey Miyeon,6,0,28,22
1715647681070,EDS 117,A01,494379,Staff,0,6,34,35
1715647682099,EDS 125,A00,507246,Hopkins; Megan Beth,7,0,30,23
1715647683127,EDS 128A,A01,507264,Fargason; Sharon Gayle,5,0,26,21
1715647684154,EDS 128B,A01,507293,Pappas; Elizabeth,9,0,30,21
1715647685180,EDS 139,A00,507294,Fargason; Sharon Gayle,9,0,30,21
1715647685180,EDS 139,B00,507313,Pappas; Elizabeth,9,0,30,21
1715647686206,EDS 201,A00,507315,Staff,10,0,30,20
1715647687233,EDS 203,A01,507317,Halter; Christopher P.,10,0,30,20
1715647688259,EDS 204R,A01,507319,Halter; Christopher P.,0,3,30,30
1715647688259,EDS 204R,B01,507331,Heinzman; Erica M.,14,0,30,16
1715647689287,EDS 206R,A00,507332,Staff,0,4,30,30
1715647689287,EDS 206R,B00,507343,Staff,15,0,30,15
1715647690315,EDS 250,A00,507344,Hemans; Patricia Ann Benitez,20,0,40,20
1715647691341,EDS 281,A00,507345,Daly; Alan J.,18,0,18,0
1715647692364,EDS 284,A00,507350,Daly; Alan J.,16,0,16,0
1715647693390,EDS 286,A00,507359,Fine; Sarah,18,0,18,0
1715647694414,EDS 289C,A01,507361,Daly; Alan J.,18,0,18,0
1715647695441,EDS 290,A00,507366,Hofstetter; Carolyn,15,0,15,0
1715647696469,LIGM 5A,A00,507421,Fischer-Grunski; Eva K,17,0,20,3
1715647697494,LIGM 5B,A00,507423,Fischer-Grunski; Eva K,19,0,20,1
1715647698521,LIGM 5C,A00,507425,Fischer-Grunski; Eva K,19,0,20,1
1715647699546,LIIT 5AS,A00,507427,Carnelos; Chiara,20,0,20,0
1715647700572,LIIT 5BS,A00,507430,Carnelos; Chiara,20,0,20,0
1715647701600,LIIT 5CS,A00,507432,Carnelos; Chiara,20,0,20,0
1715647702625,LISP 5A,A00,507541,Munoz Sanchez; Alicia,11,0,20,9
1715647703654,LISP 5B,A00,507671,Munoz Sanchez; Alicia,8,0,20,12
1715647704680,LISP 5C,A00,507696,Munoz Sanchez; Alicia,8,0,20,12
1715647705708,MAE 197,001,528363,Boechler; Nicholas Sebastia,9998,0,9999,1
1715647706735,MATH 197,001,523477,Kedlaya; Kiran S.,9994,0,9999,5
1715647706735,MATH 197,002,563811,Zhang; Danna,9994,0,9999,5
1715647706735,MATH 197,003,628552,Dumitriu; Ioana,9998,0,9999,1
1715647706735,MATH 197,004,660885,Floyd; Eric,9998,0,9999,1
1715647707762,MCWP 40R,A00,518780,Staff,1,0,20,19
1715647707762,MCWP 40R,B00,518781,Carter; Jennifer A,10,0,20,10
1715647707762,MCWP 40R,C00,518783,Smith; Haydee Marie,5,0,20,15
1715647708793,MCWP 50R,A00,518791,Redela; Pamela Morgan,0,1,20,20
1715647708793,MCWP 50R,B00,518792,Krone; Jarret,0,2,20,20
1715647708793,MCWP 50R,C00,518793,Staff,0,4,20,20
1715647708793,MCWP 50R,D00,518794,Morshed; Michael James,0,2,20,20
1715647708793,MCWP 50R,E00,518795,Carter; Andrea L,0,2,20,20
1715647708793,MCWP 50R,F00,518796,Miller; Elizabeth Deen,0,1,20,20
1715647708793,MCWP 50R,G00,518797,Guillen; Melinda,0,1,20,20
1715647709820,MMW 12R,A01,514034,Herbst; Matthew,0,2,16,16
1715647709820,MMW 12R,A02,514035,Herbst; Matthew,0,0,16,16
1715647710847,MMW 13R,A01,514037,Staff,0,5,16,16
1715647710847,MMW 13R,A02,514039,Staff,0,5,16,16
1715647710847,MMW 13R,A03,628519,Staff,0,4,16,16
1715647712901,SIO 295LS,A00,523233,Staff,10,0,30,20
1715647713926,SIO 295S,A00,523232,Staff,10,0,30,20
1715647714952,SIOC 290S,A01,637330,Merrifield; Mark A,21,0,30,9
1715647715979,SIOC 291S,A01,637333,Gabriel; Corey John,21,0,30,9
1715647717004,SOCI 117,A01,494376,Staff,0,5,5,5
1715647718029,WES 237B,A00,494380,Staff,10,0,20,10
1715647720098,AESE 279B,A00,494370,Wade; Jon P,0,0,33,33
1715647721125,AIP 97,001,660915,Van Den Einde; Yael Dahlia,9998,0,9999,1
1715647722166,AIP 197,001,627712,Vespa; Emanuel Ignacio,9995,0,9999,4
1715647722166,AIP 197,002,650778,Amir; On,9998,0,9999,1
1715647722166,AIP 197,003,650933,Avenancio-Leon; Carlos,9998,0,9999,1
1715647722166,AIP 197,004,658530,Heyman; Gail D.,9998,0,9999,1
1715647722166,AIP 197,005,658631,Neal; Sonya E,9998,0,9999,1
1715647722166,AIP 197,006,658671,Du; Songzi,9998,0,9999,1
1715647723191,ANAR 135S,A00,494369,Braswell; Geoffrey E.,0,0,0,0
1715647724218,BENG 196,001,628496,Engler; Adam J.,9998,0,9999,1
1715647724218,BENG 196,002,660916,Watson; John Thomas,9998,0,9999,1
1715647725245,BISP 197,001,650773,Wilhelm; James E.,9994,0,9999,5
1715647725245,BISP 197,002,658904,Coleman; Aaron B.,9998,0,9999,1
1715647726273,CAT 124RS,A01,519847,Geibel; William,0,0,20,20
1715647727299,CAT 125RS,A01,515971,Geibel; William,0,0,20,20
1715647728324,CLRE 250,A00,511389,Morris; Sheldon,9992,0,9999,7
1715647729353,CLRE 251,A00,507176,Mehta; Ravindra L.,9992,0,9999,7
1715647729353,CLRE 251,B00,511410,Mehta; Ravindra L.,9998,0,9999,1
1715647730378,CLRE 252,A00,507189,Cuomo; Raphael Eduardo,9994,0,9999,5
1715647731405,CLRE 253,A00,507199,Vaida; Florin,9994,0,9999,5
1715647731405,CLRE 253,B00,507202,Vaida; Florin,9999,0,9999,0
1715647732430,CLRE 259,A00,507211,Patel; Hemal,9996,0,9999,3
1715647733468,CLRE 260,A00,507221,Cuomo; Raphael Eduardo,9999,0,9999,0
1715647734494,CLRE 297,001,507242,Cuomo; Raphael Eduardo,9999,0,9999,0
1715647735521,COGS 197,001,638244,Voytek; Bradley Thomas,9997,0,9999,2
1715647736549,CSE 191,A00,516875,Minnes Kemp; Mor Mia,9991,0,9999,8
1715647737577,CSE 197,001,637388,Minnes Kemp; Mor Mia,9992,0,9999,7
1715647738619,CSS 201S,A01,494383,Mignozzetti; Umberto,35,0,35,0
1715647739648,CSS 202S,A01,494387,Mignozzetti; Umberto,35,0,35,0
1715647740677,DSC 197,001,628532,Eldridge; Justin Matthew,9995,0,9999,4
1715647741718,EAP 100,A00,516065,Staff,9799,0,9999,200
1715647742746,ECE 45,A01,507414,Staff,32,0,60,28
1715647744797,ECE 111,A01,507420,Staff,11,0,50,39
1715647745824,ECE 197,001,548057,Sievenpiper; Daniel F.,9991,0,9999,8
1715647746908,EDS 115,A00,507243,Choi; Bailey Miyeon,6,0,28,22
1715647747935,EDS 117,A01,494379,Staff,0,6,34,35
1715647748965,EDS 125,A00,507246,Hopkins; Megan Beth,7,0,30,23
1715647749995,EDS 128A,A01,507264,Fargason; Sharon Gayle,5,0,26,21
1715647751020,EDS 128B,A01,507293,Pappas; Elizabeth,9,0,30,21
1715647752046,EDS 139,A00,507294,Fargason; Sharon Gayle,9,0,30,21
1715647752046,EDS 139,B00,507313,Pappas; Elizabeth,9,0,30,21
1715647753076,EDS 201,A00,507315,Staff,10,0,30,20
1715647754102,EDS 203,A01,507317,Halter; Christopher P.,10,0,30,20
1715647755127,EDS 204R,A01,507319,Halter; Christopher P.,0,3,30,30
1715647755127,EDS 204R,B01,507331,Heinzman; Erica M.,14,0,30,16
1715647756153,EDS 206R,A00,507332,Staff,0,4,30,30
1715647756153,EDS 206R,B00,507343,Staff,15,0,30,15
1715647757183,EDS 250,A00,507344,Hemans; Patricia Ann Benitez,20,0,40,20
1715647758212,EDS 281,A00,507345,Daly; Alan J.,18,0,18,0
1715647759239,EDS 284,A00,507350,Daly; Alan J.,16,0,16,0
1715647760270,EDS 286,A00,507359,Fine; Sarah,18,0,18,0
1715647761296,EDS 289C,A01,507361,Daly; Alan J.,18,0,18,0
1715647762322,EDS 290,A00,507366,Hofstetter; Carolyn,15,0,15,0
1715647763349,LIGM 5A,A00,507421,Fischer-Grunski; Eva K,17,0,20,3
1715647764376,LIGM 5B,A00,507423,Fischer-Grunski; Eva K,19,0,20,1
1715647765406,LIGM 5C,A00,507425,Fischer-Grunski; Eva K,19,0,20,1
1715647766431,LIIT 5AS,A00,507427,Carnelos; Chiara,20,0,20,0
1715647767455,LIIT 5BS,A00,507430,Carnelos; Chiara,20,0,20,0
1715647768480,LIIT 5CS,A00,507432,Carnelos; Chiara,20,0,20,0
1715647769677,LISP 5A,A00,507541,Munoz Sanchez; Alicia,11,0,20,9
1715647770703,LISP 5B,A00,507671,Munoz Sanchez; Alicia,8,0,20,12
1715647771728,LISP 5C,A00,507696,Munoz Sanchez; Alicia,8,0,20,12
1715647772753,MAE 197,001,528363,Boechler; Nicholas Sebastia,9998,0,9999,1
1715647773783,MATH 197,001,523477,Kedlaya; Kiran S.,9994,0,9999,5
1715647773783,MATH 197,002,563811,Zhang; Danna,9994,0,9999,5
1715647773783,MATH 197,003,628552,Dumitriu; Ioana,9998,0,9999,1
1715647773783,MATH 197,004,660885,Floyd; Eric,9998,0,9999,1
1715647774811,MCWP 40R,A00,518780,Staff,1,0,20,19
1715647774811,MCWP 40R,B00,518781,Carter; Jennifer A,10,0,20,10
1715647774811,MCWP 40R,C00,518783,Smith; Haydee Marie,5,0,20,15
1715647775841,MCWP 50R,A00,518791,Redela; Pamela Morgan,0,1,20,20
1715647775841,MCWP 50R,B00,518792,Krone; Jarret,0,2,20,20
1715647775841,MCWP 50R,C00,518793,Staff,0,4,20,20
1715647775841,MCWP 50R,D00,518794,Morshed; Michael James,0,2,20,20
1715647775841,MCWP 50R,E00,518795,Carter; Andrea L,0,2,20,20
1715647775841,MCWP 50R,F00,518796,Miller; Elizabeth Deen,0,1,20,20
1715647775841,MCWP 50R,G00,518797,Guillen; Melinda,0,1,20,20
1715647776869,MMW 12R,A01,514034,Herbst; Matthew,0,2,16,16
1715647776869,MMW 12R,A02,514035,Herbst; Matthew,0,0,16,16
1715647777897,MMW 13R,A01,514037,Staff,0,5,16,16
1715647777897,MMW 13R,A02,514039,Staff,0,5,16,16
1715647777897,MMW 13R,A03,628519,Staff,0,4,16,16
1715647779946,SIO 295LS,A00,523233,Staff,10,0,30,20
1715647780972,SIO 295S,A00,523232,Staff,10,0,30,20
1715647782002,SIOC 290S,A01,637330,Merrifield; Mark A,21,0,30,9
1715647783027,SIOC 291S,A01,637333,Gabriel; Corey John,21,0,30,9
1715647784053,SOCI 117,A01,494376,Staff,0,5,5,5
1715647785080,WES 237B,A00,494380,Staff,10,0,20,10
1715647787157,AESE 279B,A00,494370,Wade; Jon P,0,0,33,33
1715647788181,AIP 97,001,660915,Van Den Einde; Yael Dahlia,9998,0,9999,1
1715647789212,AIP 197,001,627712,Vespa; Emanuel Ignacio,9995,0,9999,4
1715647789212,AIP 197,002,650778,Amir; On,9998,0,9999,1
1715647789212,AIP 197,003,650933,Avenancio-Leon; Carlos,9998,0,9999,1
1715647789212,AIP 197,004,658530,Heyman; Gail D.,9998,0,9999,1
1715647789212,AIP 197,005,658631,Neal; Sonya E,9998,0,9999,1
1715647789212,AIP 197,006,658671,Du; Songzi,9998,0,9999,1
1715647790239,ANAR 135S,A00,494369,Braswell; Geoffrey E.,0,0,0,0
1715647791273,BENG 196,001,628496,Engler; Adam J.,9998,0,9999,1
1715647791273,BENG 196,002,660916,Watson; John Thomas,9998,0,9999,1
1715647792303,BISP 197,001,650773,Wilhelm; James E.,9994,0,9999,5
1715647792303,BISP 197,002,658904,Coleman; Aaron B.,9998,0,9999,1
1715647793329,CAT 124RS,A01,519847,Geibel; William,0,0,20,20
1715647794356,CAT 125RS,A01,515971,Geibel; William,0,0,20,20
1715647795384,CLRE 250,A00,511389,Morris; Sheldon,9992,0,9999,7
1715647796412,CLRE 251,A00,507176,Mehta; Ravindra L.,9992,0,9999,7
1715647796412,CLRE 251,B00,511410,Mehta; Ravindra L.,9998,0,9999,1
1715647797436,CLRE 252,A00,507189,Cuomo; Raphael Eduardo,9994,0,9999,5
1715647798464,CLRE 253,A00,507199,Vaida; Florin,9994,0,9999,5
1715647798464,CLRE 253,B00,507202,Vaida; Florin,9999,0,9999,0
1715647799489,CLRE 259,A00,507211,Patel; Hemal,9996,0,9999,3
1715647800516,CLRE 260,A00,507221,Cuomo; Raphael Eduardo,9999,0,9999,0
1715647801545,CLRE 297,001,507242,Cuomo; Raphael Eduardo,9999,0,9999,0
1715647802579,COGS 197,001,638244,Voytek; Bradley Thomas,9997,0,9999,2
1715647803608,CSE 191,A00,516875,Minnes Kemp; Mor Mia,9991,0,9999,8
1715647804632,CSE 197,001,637388,Minnes Kemp; Mor Mia,9992,0,9999,7
1715647805661,CSS 201S,A01,494383,Mignozzetti; Umberto,35,0,35,0
1715647806690,CSS 202S,A01,494387,Mignozzetti; Umberto,35,0,35,0
1715647807716,DSC 197,001,628532,Eldridge; Justin Matthew,9995,0,9999,4
1715647808743,EAP 100,A00,516065,Staff,9799,0,9999,200
1715647809775,ECE 45,A01,507414,Staff,32,0,60,28
1715647811831,ECE 111,A01,507420,Staff,11,0,50,39
1715647812855,ECE 197,001,548057,Sievenpiper; Daniel F.,9991,0,9999,8
1715647813882,EDS 115,A00,507243,Choi; Bailey Miyeon,6,0,28,22
1715647814911,EDS 117,A01,494379,Staff,0,6,34,35
1715647815940,EDS 125,A00,507246,Hopkins; Megan Beth,7,0,30,23
1715647816964,EDS 128A,A01,507264,Fargason; Sharon Gayle,5,0,26,21
1715647817989,EDS 128B,A01,507293,Pappas; Elizabeth,9,0,30,21
1715647819016,EDS 139,A00,507294,Fargason; Sharon Gayle,9,0,30,21
1715647819016,EDS 139,B00,507313,Pappas; Elizabeth,9,0,30,21
1715647820040,EDS 201,A00,507315,Staff,10,0,30,20
1715647821064,EDS 203,A01,507317,Halter; Christopher P.,10,0,30,20
1715647822093,EDS 204R,A01,507319,Halter; Christopher P.,0,3,30,30
1715647822093,EDS 204R,B01,507331,Heinzman; Erica M.,14,0,30,16
1715647823118,EDS 206R,A00,507332,Staff,0,4,30,30
1715647823118,EDS 206R,B00,507343,Staff,15,0,30,15
1715647824148,EDS 250,A00,507344,Hemans; Patricia Ann Benitez,20,0,40,20
1715647825176,EDS 281,A00,507345,Daly; Alan J.,18,0,18,0
1715647826201,EDS 284,A00,507350,Daly; Alan J.,16,0,16,0
1715647827226,EDS 286,A00,507359,Fine; Sarah,18,0,18,0
1715647828251,EDS 289C,A01,507361,Daly; Alan J.,18,0,18,0
1715647829277,EDS 290,A00,507366,Hofstetter; Carolyn,15,0,15,0
1715647830305,LIGM 5A,A00,507421,Fischer-Grunski; Eva K,17,0,20,3
1715647831331,LIGM 5B,A00,507423,Fischer-Grunski; Eva K,19,0,20,1
1715647832355,LIGM 5C,A00,507425,Fischer-Grunski; Eva K,19,0,20,1
1715647833380,LIIT 5AS,A00,507427,Carnelos; Chiara,20,0,20,0
1715647834461,LIIT 5BS,A00,507430,Carnelos; Chiara,20,0,20,0
1715647835491,LIIT 5CS,A00,507432,Carnelos; Chiara,20,0,20,0
1715647836518,LISP 5A,A00,507541,Munoz Sanchez; Alicia,11,0,20,9
1715647837543,LISP 5B,A00,507671,Munoz Sanchez; Alicia,8,0,20,12
1715647838572,LISP 5C,A00,507696,Munoz Sanchez; Alicia,8,0,20,12
1715647839597,MAE 197,001,528363,Boechler; Nicholas Sebastia,9998,0,9999,1
1715647840626,MATH 197,001,523477,Kedlaya; Kiran S.,9994,0,9999,5
1715647840626,MATH 197,002,563811,Zhang; Danna,9994,0,9999,5
1715647840626,MATH 197,003,628552,Dumitriu; Ioana,9998,0,9999,1
1715647840626,MATH 197,004,660885,Floyd; Eric,9998,0,9999,1
1715647841656,MCWP 40R,A00,518780,Staff,1,0,20,19
1715647841656,MCWP 40R,B00,518781,Carter; Jennifer A,10,0,20,10
1715647841656,MCWP 40R,C00,518783,Smith; Haydee Marie,5,0,20,15
1715647842683,MCWP 50R,A00,518791,Redela; Pamela Morgan,0,1,20,20
1715647842683,MCWP 50R,B00,518792,Krone; Jarret,0,2,20,20
1715647842683,MCWP 50R,C00,518793,Staff,0,4,20,20
1715647842683,MCWP 50R,D00,518794,Morshed; Michael James,0,2,20,20
1715647842683,MCWP 50R,E00,518795,Carter; Andrea L,0,2,20,20
1715647842683,MCWP 50R,F00,518796,Miller; Elizabeth Deen,0,1,20,20
1715647842683,MCWP 50R,G00,518797,Guillen; Melinda,0,1,20,20
1715647843710,MMW 12R,A01,514034,Herbst; Matthew,0,2,16,16
1715647843710,MMW 12R,A02,514035,Herbst; Matthew,0,0,16,16
1715647844738,MMW 13R,A01,514037,Staff,0,5,16,16
1715647844738,MMW 13R,A02,514039,Staff,0,5,16,16
1715647844738,MMW 13R,A03,628519,Staff,0,4,16,16
1715647846789,SIO 295LS,A00,523233,Staff,10,0,30,20
1715647847826,SIO 295S,A00,523232,Staff,10,0,30,20
1715647848852,SIOC 290S,A01,637330,Merrifield; Mark A,21,0,30,9
1715647849879,SIOC 291S,A01,637333,Gabriel; Corey John,21,0,30,9
1715647850909,SOCI 117,A01,494376,Staff,0,5,5,5
1715647851935,WES 237B,A00,494380,Staff,10,0,20,10
1715647854013,AESE 279B,A00,494370,Wade; Jon P,0,0,33,33
1715647855039,AIP 97,001,660915,Van Den Einde; Yael Dahlia,9998,0,9999,1
1715647856067,AIP 197,001,627712,Vespa; Emanuel Ignacio,9995,0,9999,4
1715647856067,AIP 197,002,650778,Amir; On,9998,0,9999,1
1715647856067,AIP 197,003,650933,Avenancio-Leon; Carlos,9998,0,9999,1
1715647856067,AIP 197,004,658530,Heyman; Gail D.,9998,0,9999,1
1715647856067,AIP 197,005,658631,Neal; Sonya E,9998,0,9999,1
1715647856067,AIP 197,006,658671,Du; Songzi,9998,0,9999,1
1715647857096,ANAR 135S,A00,494369,Braswell; Geoffrey E.,0,0,0,0
1715647858123,BENG 196,001,628496,Engler; Adam J.,9998,0,9999,1
1715647858123,BENG 196,002,660916,Watson; John Thomas,9998,0,9999,1
1715647859149,BISP 197,001,650773,Wilhelm; James E.,9994,0,9999,5
1715647859149,BISP 197,002,658904,Coleman; Aaron B.,9998,0,9999,1
1715647860176,CAT 124RS,A01,519847,Geibel; William,0,0,20,20
1715647861203,CAT 125RS,A01,515971,Geibel; William,0,0,20,20
1715647862234,CLRE 250,A00,511389,Morris; Sheldon,9992,0,9999,7
1715647863261,CLRE 251,A00,507176,Mehta; Ravindra L.,9992,0,9999,7
1715647863261,CLRE 251,B00,511410,Mehta; Ravindra L.,9998,0,9999,1
1715647864288,CLRE 252,A00,507189,Cuomo; Raphael Eduardo,9994,0,9999,5
1715647865314,CLRE 253,A00,507199,Vaida; Florin,9994,0,9999,5
1715647865314,CLRE 253,B00,507202,Vaida; Florin,9999,0,9999,0
1715647866342,CLRE 259,A00,507211,Patel; Hemal,9996,0,9999,3
1715647867368,CLRE 260,A00,507221,Cuomo; Raphael Eduardo,9999,0,9999,0
1715647868393,CLRE 297,001,507242,Cuomo; Raphael Eduardo,9999,0,9999,0
1715647869419,COGS 197,001,638244,Voytek; Bradley Thomas,9997,0,9999,2
1715647870445,CSE 191,A00,516875,Minnes Kemp; Mor Mia,9991,0,9999,8
1715647871469,CSE 197,001,637388,Minnes Kemp; Mor Mia,9992,0,9999,7
1715647872494,CSS 201S,A01,494383,Mignozzetti; Umberto,35,0,35,0
1715647873520,CSS 202S,A01,494387,Mignozzetti; Umberto,35,0,35,0
1715647874549,DSC 197,001,628532,Eldridge; Justin Matthew,9995,0,9999,4
1715647875574,EAP 100,A00,516065,Staff,9799,0,9999,200
1715647876606,ECE 45,A01,507414,Staff,32,0,60,28
1715647878658,ECE 111,A01,507420,Staff,11,0,50,39
1715647879685,ECE 197,001,548057,Sievenpiper; Daniel F.,9991,0,9999,8
1715647880713,EDS 115,A00,507243,Choi; Bailey Miyeon,6,0,28,22
1715647881743,EDS 117,A01,494379,Staff,0,6,34,35
1715647882768,EDS 125,A00,507246,Hopkins; Megan Beth,7,0,30,23
1715647883795,EDS 128A,A01,507264,Fargason; Sharon Gayle,5,0,26,21
1715647884819,EDS 128B,A01,507293,Pappas; Elizabeth,9,0,30,21
1715647885843,EDS 139,A00,507294,Fargason; Sharon Gayle,9,0,30,21
1715647885843,EDS 139,B00,507313,Pappas; Elizabeth,9,0,30,21
1715647886870,EDS 201,A00,507315,Staff,10,0,30,20
1715647887900,EDS 203,A01,507317,Halter; Christopher P.,10,0,30,20
1715647888926,EDS 204R,A01,507319,Halter; Christopher P.,0,3,30,30
1715647888926,EDS 204R,B01,507331,Heinzman; Erica M.,14,0,30,16
1715647889954,EDS 206R,A00,507332,Staff,0,4,30,30
1715647889954,EDS 206R,B00,507343,Staff,15,0,30,15
1715647890978,EDS 250,A00,507344,Hemans; Patricia Ann Benitez,20,0,40,20
1715647892002,EDS 281,A00,507345,Daly; Alan J.,18,0,18,0
1715647893031,EDS 284,A00,507350,Daly; Alan J.,16,0,16,0
1715647894059,EDS 286,A00,507359,Fine; Sarah,18,0,18,0
1715647895088,EDS 289C,A01,507361,Daly; Alan J.,18,0,18,0
1715647896112,EDS 290,A00,507366,Hofstetter; Carolyn,15,0,15,0
1715647897142,LIGM 5A,A00,507421,Fischer-Grunski; Eva K,17,0,20,3
1715647898168,LIGM 5B,A00,507423,Fischer-Grunski; Eva K,19,0,20,1
1715647899196,LIGM 5C,A00,507425,Fischer-Grunski; Eva K,19,0,20,1
1715647900227,LIIT 5AS,A00,507427,Carnelos; Chiara,20,0,20,0
1715647901255,LIIT 5BS,A00,507430,Carnelos; Chiara,20,0,20,0
1715647902279,LIIT 5CS,A00,507432,Carnelos; Chiara,20,0,20,0
1715647903306,LISP 5A,A00,507541,Munoz Sanchez; Alicia,11,0,20,9
1715647904331,LISP 5B,A00,507671,Munoz Sanchez; Alicia,8,0,20,12
1715647905355,LISP 5C,A00,507696,Munoz Sanchez; Alicia,8,0,20,12
1715647906380,MAE 197,001,528363,Boechler; Nicholas Sebastia,9998,0,9999,1
1715647907412,MATH 197,001,523477,Kedlaya; Kiran S.,9994,0,9999,5
1715647907412,MATH 197,002,563811,Zhang; Danna,9994,0,9999,5
1715647907412,MATH 197,003,628552,Dumitriu; Ioana,9998,0,9999,1
1715647907412,MATH 197,004,660885,Floyd; Eric,9998,0,9999,1
1715647908446,MCWP 40R,A00,518780,Staff,1,0,20,19
1715647908446,MCWP 40R,B00,518781,Carter; Jennifer A,10,0,20,10
1715647908446,MCWP 40R,C00,518783,Smith; Haydee Marie,5,0,20,15
1715647909480,MCWP 50R,A00,518791,Redela; Pamela Morgan,0,1,20,20
1715647909480,MCWP 50R,B00,518792,Krone; Jarret,0,2,20,20
1715647909480,MCWP 50R,C00,518793,Staff,0,4,20,20
1715647909480,MCWP 50R,D00,518794,Morshed; Michael James,0,2,20,20
1715647909480,MCWP 50R,E00,518795,Carter; Andrea L,0,2,20,20
1715647909480,MCWP 50R,F00,518796,Miller; Elizabeth Deen,0,1,20,20
1715647909480,MCWP 50R,G00,518797,Guillen; Melinda,0,1,20,20
1715647910509,MMW 12R,A01,514034,Herbst; Matthew,0,2,16,16
1715647910509,MMW 12R,A02,514035,Herbst; Matthew,0,0,16,16
1715647911536,MMW 13R,A01,514037,Staff,0,5,16,16
1715647911536,MMW 13R,A02,514039,Staff,0,5,16,16
1715647911536,MMW 13R,A03,628519,Staff,0,4,16,16
1715647913588,SIO 295LS,A00,523233,Staff,10,0,30,20
1715647914615,SIO 295S,A00,523232,Staff,10,0,30,20
1715647915639,SIOC 290S,A01,637330,Merrifield; Mark A,21,0,30,9
1715647916669,SIOC 291S,A01,637333,Gabriel; Corey John,21,0,30,9
1715647917696,SOCI 117,A01,494376,Staff,0,5,5,5
1715647918726,WES 237B,A00,494380,Staff,10,0,20,10
1715647920794,AESE 279B,A00,494370,Wade; Jon P,0,0,33,33
1715647921823,AIP 97,001,660915,Van Den Einde; Yael Dahlia,9998,0,9999,1
1715647922851,AIP 197,001,627712,Vespa; Emanuel Ignacio,9995,0,9999,4
1715647922851,AIP 197,002,650778,Amir; On,9998,0,9999,1
1715647922851,AIP 197,003,650933,Avenancio-Leon; Carlos,9998,0,9999,1
1715647922851,AIP 197,004,658530,Heyman; Gail D.,9998,0,9999,1
1715647922851,AIP 197,005,658631,Neal; Sonya E,9998,0,9999,1
1715647922851,AIP 197,006,658671,Du; Songzi,9998,0,9999,1
1715647923877,ANAR 135S,A00,494369,Braswell; Geoffrey E.,0,0,0,0
1715647924907,BENG 196,001,628496,Engler; Adam J.,9998,0,9999,1
1715647924907,BENG 196,002,660916,Watson; John Thomas,9998,0,9999,1
1715647925933,BISP 197,001,650773,Wilhelm; James E.,9994,0,9999,5
1715647925933,BISP 197,002,658904,Coleman; Aaron B.,9998,0,9999,1
1715647926964,CAT 124RS,A01,519847,Geibel; William,0,0,20,20
1715647927991,CAT 125RS,A01,515971,Geibel; William,0,0,20,20
1715647929017,CLRE 250,A00,511389,Morris; Sheldon,9992,0,9999,7
1715647930045,CLRE 251,A00,507176,Mehta; Ravindra L.,9992,0,9999,7
1715647930045,CLRE 251,B00,511410,Mehta; Ravindra L.,9998,0,9999,1
1715647931074,CLRE 252,A00,507189,Cuomo; Raphael Eduardo,9994,0,9999,5
1715647932103,CLRE 253,A00,507199,Vaida; Florin,9994,0,9999,5
1715647932103,CLRE 253,B00,507202,Vaida; Florin,9999,0,9999,0
1715647933132,CLRE 259,A00,507211,Patel; Hemal,9996,0,9999,3
1715647934156,CLRE 260,A00,507221,Cuomo; Raphael Eduardo,9999,0,9999,0
1715647935183,CLRE 297,001,507242,Cuomo; Raphael Eduardo,9999,0,9999,0
1715647936212,COGS 197,001,638244,Voytek; Bradley Thomas,9997,0,9999,2
1715647937241,CSE 191,A00,516875,Minnes Kemp; Mor Mia,9991,0,9999,8
1715647938320,CSE 197,001,637388,Minnes Kemp; Mor Mia,9992,0,9999,7
1715647939347,CSS 201S,A01,494383,Mignozzetti; Umberto,35,0,35,0
1715647940371,CSS 202S,A01,494387,Mignozzetti; Umberto,35,0,35,0
1715647941397,DSC 197,001,628532,Eldridge; Justin Matthew,9995,0,9999,4
1715647942426,EAP 100,A00,516065,Staff,9799,0,9999,200
1715647943455,ECE 45,A01,507414,Staff,32,0,60,28
1715647945505,ECE 111,A01,507420,Staff,11,0,50,39
1715647946531,ECE 197,001,548057,Sievenpiper; Daniel F.,9991,0,9999,8
1715647947558,EDS 115,A00,507243,Choi; Bailey Miyeon,6,0,28,22
1715647948632,EDS 117,A01,494379,Staff,0,6,34,35
1715647949659,EDS 125,A00,507246,Hopkins; Megan Beth,7,0,30,23
1715647950683,EDS 128A,A01,507264,Fargason; Sharon Gayle,5,0,26,21
1715647951711,EDS 128B,A01,507293,Pappas; Elizabeth,9,0,30,21
1715647952737,EDS 139,A00,507294,Fargason; Sharon Gayle,9,0,30,21
1715647952737,EDS 139,B00,507313,Pappas; Elizabeth,9,0,30,21
1715647953764,EDS 201,A00,507315,Staff,10,0,30,20
1715647954793,EDS 203,A01,507317,Halter; Christopher P.,10,0,30,20
1715647955819,EDS 204R,A01,507319,Halter; Christopher P.,0,3,30,30
1715647955819,EDS 204R,B01,507331,Heinzman; Erica M.,14,0,30,16
1715647956843,EDS 206R,A00,507332,Staff,0,4,30,30
1715647956843,EDS 206R,B00,507343,Staff,15,0,30,15
1715647957872,EDS 250,A00,507344,Hemans; Patricia Ann Benitez,20,0,40,20
1715647958898,EDS 281,A00,507345,Daly; Alan J.,18,0,18,0
1715647959927,EDS 284,A00,507350,Daly; Alan J.,16,0,16,0
1715647960953,EDS 286,A00,507359,Fine; Sarah,18,0,18,0
1715647961978,EDS 289C,A01,507361,Daly; Alan J.,18,0,18,0
1715647963003,EDS 290,A00,507366,Hofstetter; Carolyn,15,0,15,0
1715647964033,LIGM 5A,A00,507421,Fischer-Grunski; Eva K,17,0,20,3
1715647965059,LIGM 5B,A00,507423,Fischer-Grunski; Eva K,19,0,20,1
1715647966088,LIGM 5C,A00,507425,Fischer-Grunski; Eva K,19,0,20,1
1715647967113,LIIT 5AS,A00,507427,Carnelos; Chiara,20,0,20,0
1715647968139,LIIT 5BS,A00,507430,Carnelos; Chiara,20,0,20,0
1715647969167,LIIT 5CS,A00,507432,Carnelos; Chiara,20,0,20,0
1715647970191,LISP 5A,A00,507541,Munoz Sanchez; Alicia,11,0,20,9
1715647971220,LISP 5B,A00,507671,Munoz Sanchez; Alicia,8,0,20,12
1715647972250,LISP 5C,A00,507696,Munoz Sanchez; Alicia,8,0,20,12
1715647973276,MAE 197,001,528363,Boechler; Nicholas Sebastia,9998,0,9999,1
1715647974306,MATH 197,001,523477,Kedlaya; Kiran S.,9994,0,9999,5
1715647974306,MATH 197,002,563811,Zhang; Danna,9994,0,9999,5
1715647974306,MATH 197,003,628552,Dumitriu; Ioana,9998,0,9999,1
1715647974306,MATH 197,004,660885,Floyd; Eric,9998,0,9999,1
1715647975334,MCWP 40R,A00,518780,Staff,1,0,20,19
1715647975334,MCWP 40R,B00,518781,Carter; Jennifer A,10,0,20,10
1715647975334,MCWP 40R,C00,518783,Smith; Haydee Marie,5,0,20,15
1715647976361,MCWP 50R,A00,518791,Redela; Pamela Morgan,0,1,20,20
1715647976361,MCWP 50R,B00,518792,Krone; Jarret,0,2,20,20
1715647976361,MCWP 50R,C00,518793,Staff,0,4,20,20
1715647976361,MCWP 50R,D00,518794,Morshed; Michael James,0,2,20,20
1715647976361,MCWP 50R,E00,518795,Carter; Andrea L,0,2,20,20
1715647976361,MCWP 50R,F00,518796,Miller; Elizabeth Deen,0,1,20,20
1715647976361,MCWP 50R,G00,518797,Guillen; Melinda,0,1,20,20
1715647977387,MMW 12R,A01,514034,Herbst; Matthew,0,2,16,16
1715647977387,MMW 12R,A02,514035,Herbst; Matthew,0,0,16,16
1715647978412,MMW 13R,A01,514037,Staff,0,5,16,16
1715647978412,MMW 13R,A02,514039,Staff,0,5,16,16
1715647978412,MMW 13R,A03,628519,Staff,0,4,16,16
1715647980476,SIO 295LS,A00,523233,Staff,10,0,30,20
1715647981511,SIO 295S,A00,523232,Staff,10,0,30,20
1715647982544,SIOC 290S,A01,637330,Merrifield; Mark A,21,0,30,9
1715647983571,SIOC 291S,A01,637333,Gabriel; Corey John,21,0,30,9
1715647984597,SOCI 117,A01,494376,Staff,0,5,5,5
1715647985623,WES 237B,A00,494380,Staff,10,0,20,10
1715647987689,AESE 279B,A00,494370,Wade; Jon P,0,0,33,33
1715647988716,AIP 97,001,660915,Van Den Einde; Yael Dahlia,9998,0,9999,1
1715647989752,AIP 197,001,627712,Vespa; Emanuel Ignacio,9995,0,9999,4
1715647989752,AIP 197,002,650778,Amir; On,9998,0,9999,1
1715647989752,AIP 197,003,650933,Avenancio-Leon; Carlos,9998,0,9999,1
1715647989752,AIP 197,004,658530,Heyman; Gail D.,9998,0,9999,1
1715647989752,AIP 197,005,658631,Neal; Sonya E,9998,0,9999,1
1715647989752,AIP 197,006,658671,Du; Songzi,9998,0,9999,1
1715647990782,ANAR 135S,A00,494369,Braswell; Geoffrey E.,0,0,0,0
1715647991807,BENG 196,001,628496,Engler; Adam J.,9998,0,9999,1
1715647991807,BENG 196,002,660916,Watson; John Thomas,9998,0,9999,1
1715647992837,BISP 197,001,650773,Wilhelm; James E.,9994,0,9999,5
1715647992837,BISP 197,002,658904,Coleman; Aaron B.,9998,0,9999,1
1715647993870,CAT 124RS,A01,519847,Geibel; William,0,0,20,20
1715647994894,CAT 125RS,A01,515971,Geibel; William,0,0,20,20
1715647995918,CLRE 250,A00,511389,Morris; Sheldon,9992,0,9999,7
1715647996942,CLRE 251,A00,507176,Mehta; Ravindra L.,9992,0,9999,7
1715647996942,CLRE 251,B00,511410,Mehta; Ravindra L.,9998,0,9999,1
1715647997967,CLRE 252,A00,507189,Cuomo; Raphael Eduardo,9994,0,9999,5
1715647998995,CLRE 253,A00,507199,Vaida; Florin,9994,0,9999,5
1715647998995,CLRE 253,B00,507202,Vaida; Florin,9999,0,9999,0
1715648000021,CLRE 259,A00,507211,Patel; Hemal,9996,0,9999,3
1715648001046,CLRE 260,A00,507221,Cuomo; Raphael Eduardo,9999,0,9999,0
1715648002070,CLRE 297,001,507242,Cuomo; Raphael Eduardo,9999,0,9999,0
1715648003097,COGS 197,001,638244,Voytek; Bradley Thomas,9997,0,9999,2
1715648004126,CSE 191,A00,516875,Minnes Kemp; Mor Mia,9991,0,9999,8
1715648005152,CSE 197,001,637388,Minnes Kemp; Mor Mia,9992,0,9999,7
1715648006179,CSS 201S,A01,494383,Mignozzetti; Umberto,35,0,35,0
1715648007207,CSS 202S,A01,494387,Mignozzetti; Umberto,35,0,35,0
1715648008234,DSC 197,001,628532,Eldridge; Justin Matthew,9995,0,9999,4
1715648009259,EAP 100,A00,516065,Staff,9799,0,9999,200
1715648010285,ECE 45,A01,507414,Staff,32,0,60,28
1715648012341,ECE 111,A01,507420,Staff,11,0,50,39
1715648013366,ECE 197,001,548057,Sievenpiper; Daniel F.,9991,0,9999,8
1715648014395,EDS 115,A00,507243,Choi; Bailey Miyeon,6,0,28,22
1715648015423,EDS 117,A01,494379,Staff,0,6,34,35
1715648016448,EDS 125,A00,507246,Hopkins; Megan Beth,7,0,30,23
1715648017476,EDS 128A,A01,507264,Fargason; Sharon Gayle,5,0,26,21
1715648018505,EDS 128B,A01,507293,Pappas; Elizabeth,9,0,30,21
1715648019532,EDS 139,A00,507294,Fargason; Sharon Gayle,9,0,30,21
1715648019532,EDS 139,B00,507313,Pappas; Elizabeth,9,0,30,21
1715648020557,EDS 201,A00,507315,Staff,10,0,30,20
1715648021583,EDS 203,A01,507317,Halter; Christopher P.,10,0,30,20
1715648022613,EDS 204R,A01,507319,Halter; Christopher P.,0,3,30,30
1715648022613,EDS 204R,B01,507331,Heinzman; Erica M.,14,0,30,16
1715648023642,EDS 206R,A00,507332,Staff,0,4,30,30
1715648023642,EDS 206R,B00,507343,Staff,15,0,30,15
1715648024667,EDS 250,A00,507344,Hemans; Patricia Ann Benitez,20,0,40,20
1715648025696,EDS 281,A00,507345,Daly; Alan J.,18,0,18,0
1715648026720,EDS 284,A00,507350,Daly; Alan J.,16,0,16,0
1715648027747,EDS 286,A00,507359,Fine; Sarah,18,0,18,0
1715648028776,EDS 289C,A01,507361,Daly; Alan J.,18,0,18,0
1715648029800,EDS 290,A00,507366,Hofstetter; Carolyn,15,0,15,0
1715648030835,LIGM 5A,A00,507421,Fischer-Grunski; Eva K,17,0,20,3
1715648031867,LIGM 5B,A00,507423,Fischer-Grunski; Eva K,19,0,20,1
1715648032893,LIGM 5C,A00,507425,Fischer-Grunski; Eva K,19,0,20,1
1715648033919,LIIT 5AS,A00,507427,Carnelos; Chiara,20,0,20,0
1715648034949,LIIT 5BS,A00,507430,Carnelos; Chiara,20,0,20,0
1715648035975,LIIT 5CS,A00,507432,Carnelos; Chiara,20,0,20,0
1715648037005,LISP 5A,A00,507541,Munoz Sanchez; Alicia,11,0,20,9
1715648038031,LISP 5B,A00,507671,Munoz Sanchez; Alicia,8,0,20,12
1715648039056,LISP 5C,A00,507696,Munoz Sanchez; Alicia,8,0,20,12
1715648040085,MAE 197,001,528363,Boechler; Nicholas Sebastia,9998,0,9999,1
1715648041116,MATH 197,001,523477,Kedlaya; Kiran S.,9994,0,9999,5
1715648041116,MATH 197,002,563811,Zhang; Danna,9994,0,9999,5
1715648041116,MATH 197,003,628552,Dumitriu; Ioana,9998,0,9999,1
1715648041116,MATH 197,004,660885,Floyd; Eric,9998,0,9999,1
1715648042200,MCWP 40R,A00,518780,Staff,1,0,20,19
1715648042200,MCWP 40R,B00,518781,Carter; Jennifer A,10,0,20,10
1715648042200,MCWP 40R,C00,518783,Smith; Haydee Marie,5,0,20,15
1715648043228,MCWP 50R,A00,518791,Redela; Pamela Morgan,0,1,20,20
1715648043228,MCWP 50R,B00,518792,Krone; Jarret,0,2,20,20
1715648043228,MCWP 50R,C00,518793,Staff,0,4,20,20
1715648043228,MCWP 50R,D00,518794,Morshed; Michael James,0,2,20,20
1715648043228,MCWP 50R,E00,518795,Carter; Andrea L,0,2,20,20
1715648043228,MCWP 50R,F00,518796,Miller; Elizabeth Deen,0,1,20,20
1715648043228,MCWP 50R,G00,518797,Guillen; Melinda,0,1,20,20
1715648044259,MMW 12R,A01,514034,Herbst; Matthew,0,2,16,16
1715648044259,MMW 12R,A02,514035,Herbst; Matthew,0,0,16,16
1715648045284,MMW 13R,A01,514037,Staff,0,5,16,16
1715648045284,MMW 13R,A02,514039,Staff,0,5,16,16
1715648045284,MMW 13R,A03,628519,Staff,0,4,16,16
1715648047334,SIO 295LS,A00,523233,Staff,10,0,30,20
1715648048361,SIO 295S,A00,523232,Staff,10,0,30,20
1715648049387,SIOC 290S,A01,637330,Merrifield; Mark A,21,0,30,9
1715648050415,SIOC 291S,A01,637333,Gabriel; Corey John,21,0,30,9
1715648051440,SOCI 117,A01,494376,Staff,0,5,5,5
1715648052466,WES 237B,A00,494380,Staff,10,0,20,10
1715648054596,AESE 279B,A00,494370,Wade; Jon P,0,0,33,33
1715648055626,AIP 97,001,660915,Van Den Einde; Yael Dahlia,9998,0,9999,1
1715648056655,AIP 197,001,627712,Vespa; Emanuel Ignacio,9995,0,9999,4
1715648056655,AIP 197,002,650778,Amir; On,9998,0,9999,1
1715648056655,AIP 197,003,650933,Avenancio-Leon; Carlos,9998,0,9999,1
1715648056655,AIP 197,004,658530,Heyman; Gail D.,9998,0,9999,1
1715648056655,AIP 197,005,658631,Neal; Sonya E,9998,0,9999,1
1715648056655,AIP 197,006,658671,Du; Songzi,9998,0,9999,1
1715648057683,ANAR 135S,A00,494369,Braswell; Geoffrey E.,0,0,0,0
1715648058712,BENG 196,001,628496,Engler; Adam J.,9998,0,9999,1
1715648058712,BENG 196,002,660916,Watson; John Thomas,9998,0,9999,1
1715648059736,BISP 197,001,650773,Wilhelm; James E.,9994,0,9999,5
1715648059736,BISP 197,002,658904,Coleman; Aaron B.,9998,0,9999,1
1715648060763,CAT 124RS,A01,519847,Geibel; William,0,0,20,20
1715648061793,CAT 125RS,A01,515971,Geibel; William,0,0,20,20
1715648062819,CLRE 250,A00,511389,Morris; Sheldon,9992,0,9999,7
1715648063850,CLRE 251,A00,507176,Mehta; Ravindra L.,9992,0,9999,7
1715648063850,CLRE 251,B00,511410,Mehta; Ravindra L.,9998,0,9999,1
1715648064879,CLRE 252,A00,507189,Cuomo; Raphael Eduardo,9994,0,9999,5
1715648065905,CLRE 253,A00,507199,Vaida; Florin,9994,0,9999,5
1715648065905,CLRE 253,B00,507202,Vaida; Florin,9999,0,9999,0
1715648066932,CLRE 259,A00,507211,Patel; Hemal,9996,0,9999,3
1715648067957,CLRE 260,A00,507221,Cuomo; Raphael Eduardo,9999,0,9999,0
1715648068982,CLRE 297,001,507242,Cuomo; Raphael Eduardo,9999,0,9999,0
1715648070007,COGS 197,001,638244,Voytek; Bradley Thomas,9997,0,9999,2
1715648071034,CSE 191,A00,516875,Minnes Kemp; Mor Mia,9991,0,9999,8
1715648072060,CSE 197,001,637388,Minnes Kemp; Mor Mia,9992,0,9999,7
1715648073090,CSS 201S,A01,494383,Mignozzetti; Umberto,35,0,35,0
1715648074117,CSS 202S,A01,494387,Mignozzetti; Umberto,35,0,35,0
1715648075145,DSC 197,001,628532,Eldridge; Justin Matthew,9995,0,9999,4
1715648076170,EAP 100,A00,516065,Staff,9799,0,9999,200
1715648077197,ECE 45,A01,507414,Staff,32,0,60,28
1715648079248,ECE 111,A01,507420,Staff,11,0,50,39
1715648080273,ECE 197,001,548057,Sievenpiper; Daniel F.,9991,0,9999,8
1715648081300,EDS 115,A00,507243,Choi; Bailey Miyeon,6,0,28,22
1715648082328,EDS 117,A01,494379,Staff,0,6,34,35
1715648083353,EDS 125,A00,507246,Hopkins; Megan Beth,7,0,30,23
1715648084380,EDS 128A,A01,507264,Fargason; Sharon Gayle,5,0,26,21
1715648085405,EDS 128B,A01,507293,Pappas; Elizabeth,9,0,30,21
1715648086434,EDS 139,A00,507294,Fargason; Sharon Gayle,9,0,30,21
1715648086434,EDS 139,B00,507313,Pappas; Elizabeth,9,0,30,21
1715648087459,EDS 201,A00,507315,Staff,10,0,30,20
1715648088484,EDS 203,A01,507317,Halter; Christopher P.,10,0,30,20
1715648089508,EDS 204R,A01,507319,Halter; Christopher P.,0,3,30,30
1715648089508,EDS 204R,B01,507331,Heinzman; Erica M.,14,0,30,16
1715648090538,EDS 206R,A00,507332,Staff,0,4,30,30
1715648090538,EDS 206R,B00,507343,Staff,15,0,30,15
1715648091563,EDS 250,A00,507344,Hemans; Patricia Ann Benitez,20,0,40,20
1715648092587,EDS 281,A00,507345,Daly; Alan J.,18,0,18,0
1715648093614,EDS 284,A00,507350,Daly; Alan J.,16,0,16,0
1715648094642,EDS 286,A00,507359,Fine; Sarah,18,0,18,0
1715648095667,EDS 289C,A01,507361,Daly; Alan J.,18,0,18,0
1715648096693,EDS 290,A00,507366,Hofstetter; Carolyn,15,0,15,0
1715648097726,LIGM 5A,A00,507421,Fischer-Grunski; Eva K,17,0,20,3
1715648098750,LIGM 5B,A00,507423,Fischer-Grunski; Eva K,19,0,20,1
1715648099773,LIGM 5C,A00,507425,Fischer-Grunski; Eva K,19,0,20,1
1715648100810,LIIT 5AS,A00,507427,Carnelos; Chiara,20,0,20,0
1715648101836,LIIT 5BS,A00,507430,Carnelos; Chiara,20,0,20,0
1715648102864,LIIT 5CS,A00,507432,Carnelos; Chiara,20,0,20,0
1715648103897,LISP 5A,A00,507541,Munoz Sanchez; Alicia,11,0,20,9
1715648104923,LISP 5B,A00,507671,Munoz Sanchez; Alicia,8,0,20,12
1715648105948,LISP 5C,A00,507696,Munoz Sanchez; Alicia,8,0,20,12
1715648106977,MAE 197,001,528363,Boechler; Nicholas Sebastia,9998,0,9999,1
1715648108007,MATH 197,001,523477,Kedlaya; Kiran S.,9994,0,9999,5
1715648108007,MATH 197,002,563811,Zhang; Danna,9994,0,9999,5
1715648108007,MATH 197,003,628552,Dumitriu; Ioana,9998,0,9999,1
1715648108007,MATH 197,004,660885,Floyd; Eric,9998,0,9999,1
1715648109038,MCWP 40R,A00,518780,Staff,1,0,20,19
1715648109038,MCWP 40R,B00,518781,Carter; Jennifer A,10,0,20,10
1715648109038,MCWP 40R,C00,518783,Smith; Haydee Marie,5,0,20,15
1715648110065,MCWP 50R,A00,518791,Redela; Pamela Morgan,0,1,20,20
1715648110065,MCWP 50R,B00,518792,Krone; Jarret,0,2,20,20
1715648110065,MCWP 50R,C00,518793,Staff,0,4,20,20
1715648110065,MCWP 50R,D00,518794,Morshed; Michael James,0,2,20,20
1715648110065,MCWP 50R,E00,518795,Carter; Andrea L,0,2,20,20
1715648110065,MCWP 50R,F00,518796,Miller; Elizabeth Deen,0,1,20,20
1715648110065,MCWP 50R,G00,518797,Guillen; Melinda,0,1,20,20
1715648111090,MMW 12R,A01,514034,Herbst; Matthew,0,2,16,16
1715648111090,MMW 12R,A02,514035,Herbst; Matthew,0,0,16,16
1715648112115,MMW 13R,A01,514037,Staff,0,5,16,16
1715648112115,MMW 13R,A02,514039,Staff,0,5,16,16
1715648112115,MMW 13R,A03,628519,Staff,0,4,16,16
1715648114171,SIO 295LS,A00,523233,Staff,10,0,30,20
1715648115198,SIO 295S,A00,523232,Staff,10,0,30,20
1715648116224,SIOC 290S,A01,637330,Merrifield; Mark A,21,0,30,9
1715648117253,SIOC 291S,A01,637333,Gabriel; Corey John,21,0,30,9
1715648118282,SOCI 117,A01,494376,Staff,0,5,5,5
1715648119307,WES 237B,A00,494380,Staff,10,0,20,10
1715648121385,AESE 279B,A00,494370,Wade; Jon P,0,0,33,33
1715648122410,AIP 97,001,660915,Van Den Einde; Yael Dahlia,9998,0,9999,1
1715648123439,AIP 197,001,627712,Vespa; Emanuel Ignacio,9995,0,9999,4
1715648123439,AIP 197,002,650778,Amir; On,9998,0,9999,1
1715648123439,AIP 197,003,650933,Avenancio-Leon; Carlos,9998,0,9999,1
1715648123439,AIP 197,004,658530,Heyman; Gail D.,9998,0,9999,1
1715648123439,AIP 197,005,658631,Neal; Sonya E,9998,0,9999,1
1715648123439,AIP 197,006,658671,Du; Songzi,9998,0,9999,1
1715648124465,ANAR 135S,A00,494369,Braswell; Geoffrey E.,0,0,0,0
1715648125495,BENG 196,001,628496,Engler; Adam J.,9998,0,9999,1
1715648125495,BENG 196,002,660916,Watson; John Thomas,9998,0,9999,1
1715648126525,BISP 197,001,650773,Wilhelm; James E.,9994,0,9999,5
1715648126525,BISP 197,002,658904,Coleman; Aaron B.,9998,0,9999,1
1715648127553,CAT 124RS,A01,519847,Geibel; William,0,0,20,20
1715648128579,CAT 125RS,A01,515971,Geibel; William,0,0,20,20
1715648129607,CLRE 250,A00,511389,Morris; Sheldon,9992,0,9999,7
1715648130632,CLRE 251,A00,507176,Mehta; Ravindra L.,9992,0,9999,7
1715648130632,CLRE 251,B00,511410,Mehta; Ravindra L.,9998,0,9999,1
1715648131659,CLRE 252,A00,507189,Cuomo; Raphael Eduardo,9994,0,9999,5
1715648132685,CLRE 253,A00,507199,Vaida; Florin,9994,0,9999,5
1715648132685,CLRE 253,B00,507202,Vaida; Florin,9999,0,9999,0
1715648133713,CLRE 259,A00,507211,Patel; Hemal,9996,0,9999,3
1715648134866,CLRE 260,A00,507221,Cuomo; Raphael Eduardo,9999,0,9999,0
1715648135902,CLRE 297,001,507242,Cuomo; Raphael Eduardo,9999,0,9999,0
1715648136927,COGS 197,001,638244,Voytek; Bradley Thomas,9997,0,9999,2
1715648137954,CSE 191,A00,516875,Minnes Kemp; Mor Mia,9991,0,9999,8
1715648138983,CSE 197,001,637388,Minnes Kemp; Mor Mia,9992,0,9999,7
1715648140011,CSS 201S,A01,494383,Mignozzetti; Umberto,35,0,35,0
1715648141037,CSS 202S,A01,494387,Mignozzetti; Umberto,35,0,35,0
1715648142066,DSC 197,001,628532,Eldridge; Justin Matthew,9995,0,9999,4
1715648143090,EAP 100,A00,516065,Staff,9799,0,9999,200
1715648144120,ECE 45,A01,507414,Staff,32,0,60,28
1715648146227,ECE 111,A01,507420,Staff,11,0,50,39
1715648147255,ECE 197,001,548057,Sievenpiper; Daniel F.,9991,0,9999,8
1715648148280,EDS 115,A00,507243,Choi; Bailey Miyeon,6,0,28,22
1715648149305,EDS 117,A01,494379,Staff,0,6,34,35
1715648150334,EDS 125,A00,507246,Hopkins; Megan Beth,7,0,30,23
1715648151362,EDS 128A,A01,507264,Fargason; Sharon Gayle,5,0,26,21
1715648152386,EDS 128B,A01,507293,Pappas; Elizabeth,9,0,30,21
1715648153411,EDS 139,A00,507294,Fargason; Sharon Gayle,9,0,30,21
1715648153411,EDS 139,B00,507313,Pappas; Elizabeth,9,0,30,21
1715648154438,EDS 201,A00,507315,Staff,10,0,30,20
1715648155466,EDS 203,A01,507317,Halter; Christopher P.,10,0,30,20
1715648156494,EDS 204R,A01,507319,Halter; Christopher P.,0,3,30,30
1715648156494,EDS 204R,B01,507331,Heinzman; Erica M.,14,0,30,16
1715648157518,EDS 206R,A00,507332,Staff,0,4,30,30
1715648157518,EDS 206R,B00,507343,Staff,15,0,30,15
1715648158544,EDS 250,A00,507344,Hemans; Patricia Ann Benitez,20,0,40,20
1715648159571,EDS 281,A00,507345,Daly; Alan J.,18,0,18,0
1715648160595,EDS 284,A00,507350,Daly; Alan J.,16,0,16,0
1715648161622,EDS 286,A00,507359,Fine; Sarah,18,0,18,0
1715648162648,EDS 289C,A01,507361,Daly; Alan J.,18,0,18,0
1715648163674,EDS 290,A00,507366,Hofstetter; Carolyn,15,0,15,0
1715648164704,LIGM 5A,A00,507421,Fischer-Grunski; Eva K,17,0,20,3
1715648165731,LIGM 5B,A00,507423,Fischer-Grunski; Eva K,19,0,20,1
1715648166758,LIGM 5C,A00,507425,Fischer-Grunski; Eva K,19,0,20,1
1715648167783,LIIT 5AS,A00,507427,Carnelos; Chiara,20,0,20,0
1715648168811,LIIT 5BS,A00,507430,Carnelos; Chiara,20,0,20,0
1715648169838,LIIT 5CS,A00,507432,Carnelos; Chiara,20,0,20,0
1715648170862,LISP 5A,A00,507541,Munoz Sanchez; Alicia,11,0,20,9
1715648171887,LISP 5B,A00,507671,Munoz Sanchez; Alicia,8,0,20,12
1715648172911,LISP 5C,A00,507696,Munoz Sanchez; Alicia,8,0,20,12
1715648173940,MAE 197,001,528363,Boechler; Nicholas Sebastia,9998,0,9999,1
1715648174968,MATH 197,001,523477,Kedlaya; Kiran S.,9994,0,9999,5
1715648174968,MATH 197,002,563811,Zhang; Danna,9994,0,9999,5
1715648174968,MATH 197,003,628552,Dumitriu; Ioana,9998,0,9999,1
1715648174968,MATH 197,004,660885,Floyd; Eric,9998,0,9999,1
1715648175995,MCWP 40R,A00,518780,Staff,1,0,20,19
1715648175995,MCWP 40R,B00,518781,Carter; Jennifer A,10,0,20,10
1715648175995,MCWP 40R,C00,518783,Smith; Haydee Marie,5,0,20,15
1715648177029,MCWP 50R,A00,518791,Redela; Pamela Morgan,0,1,20,20
1715648177029,MCWP 50R,B00,518792,Krone; Jarret,0,2,20,20
1715648177029,MCWP 50R,C00,518793,Staff,0,4,20,20
1715648177029,MCWP 50R,D00,518794,Morshed; Michael James,0,2,20,20
1715648177029,MCWP 50R,E00,518795,Carter; Andrea L,0,2,20,20
1715648177029,MCWP 50R,F00,518796,Miller; Elizabeth Deen,0,1,20,20
1715648177029,MCWP 50R,G00,518797,Guillen; Melinda,0,1,20,20
1715648178055,MMW 12R,A01,514034,Herbst; Matthew,0,2,16,16
1715648178055,MMW 12R,A02,514035,Herbst; Matthew,0,0,16,16
1715648179080,MMW 13R,A01,514037,Staff,0,5,16,16
1715648179080,MMW 13R,A02,514039,Staff,0,5,16,16
1715648179080,MMW 13R,A03,628519,Staff,0,4,16,16
1715648181133,SIO 295LS,A00,523233,Staff,10,0,30,20
1715648182158,SIO 295S,A00,523232,Staff,10,0,30,20
1715648183188,SIOC 290S,A01,637330,Merrifield; Mark A,21,0,30,9
1715648184214,SIOC 291S,A01,637333,Gabriel; Corey John,21,0,30,9
1715648185239,SOCI 117,A01,494376,Staff,0,5,5,5
1715648186266,WES 237B,A00,494380,Staff,10,0,20,10
1715648188336,AESE 279B,A00,494370,Wade; Jon P,0,0,33,33
1715648189363,AIP 97,001,660915,Van Den Einde; Yael Dahlia,9998,0,9999,1
1715648190397,AIP 197,001,627712,Vespa; Emanuel Ignacio,9995,0,9999,4
1715648190397,AIP 197,002,650778,Amir; On,9998,0,9999,1
1715648190397,AIP 197,003,650933,Avenancio-Leon; Carlos,9998,0,9999,1
1715648190397,AIP 197,004,658530,Heyman; Gail D.,9998,0,9999,1
1715648190397,AIP 197,005,658631,Neal; Sonya E,9998,0,9999,1
1715648190397,AIP 197,006,658671,Du; Songzi,9998,0,9999,1
1715648191427,ANAR 135S,A00,494369,Braswell; Geoffrey E.,0,0,0,0
1715648192451,BENG 196,001,628496,Engler; Adam J.,9998,0,9999,1
1715648192451,BENG 196,002,660916,Watson; John Thomas,9998,0,9999,1
1715648193481,BISP 197,001,650773,Wilhelm; James E.,9994,0,9999,5
1715648193481,BISP 197,002,658904,Coleman; Aaron B.,9998,0,9999,1
1715648194507,CAT 124RS,A01,519847,Geibel; William,0,0,20,20
1715648195532,CAT 125RS,A01,515971,Geibel; William,0,0,20,20
1715648196557,CLRE 250,A00,511389,Morris; Sheldon,9992,0,9999,7
1715648197589,CLRE 251,A00,507176,Mehta; Ravindra L.,9992,0,9999,7
1715648197589,CLRE 251,B00,511410,Mehta; Ravindra L.,9998,0,9999,1
1715648198614,CLRE 252,A00,507189,Cuomo; Raphael Eduardo,9994,0,9999,5
1715648199639,CLRE 253,A00,507199,Vaida; Florin,9994,0,9999,5
1715648199639,CLRE 253,B00,507202,Vaida; Florin,9999,0,9999,0
1715648200664,CLRE 259,A00,507211,Patel; Hemal,9996,0,9999,3
1715648201688,CLRE 260,A00,507221,Cuomo; Raphael Eduardo,9999,0,9999,0
1715648202712,CLRE 297,001,507242,Cuomo; Raphael Eduardo,9999,0,9999,0
1715648203737,COGS 197,001,638244,Voytek; Bradley Thomas,9997,0,9999,2
1715648204765,CSE 191,A00,516875,Minnes Kemp; Mor Mia,9991,0,9999,8
1715648205790,CSE 197,001,637388,Minnes Kemp; Mor Mia,9992,0,9999,7
1715648206820,CSS 201S,A01,494383,Mignozzetti; Umberto,35,0,35,0
1715648207846,CSS 202S,A01,494387,Mignozzetti; Umberto,35,0,35,0
1715648208874,DSC 197,001,628532,Eldridge; Justin Matthew,9995,0,9999,4
1715648209898,EAP 100,A00,516065,Staff,9799,0,9999,200
1715648210925,ECE 45,A01,507414,Staff,32,0,60,28
1715648212976,ECE 111,A01,507420,Staff,11,0,50,39
1715648214003,ECE 197,001,548057,Sievenpiper; Daniel F.,9991,0,9999,8
1715648215029,EDS 115,A00,507243,Choi; Bailey Miyeon,6,0,28,22
1715648216053,EDS 117,A01,494379,Staff,0,6,34,35
1715648217077,EDS 125,A00,507246,Hopkins; Megan Beth,7,0,30,23
1715648218103,EDS 128A,A01,507264,Fargason; Sharon Gayle,5,0,26,21
1715648219129,EDS 128B,A01,507293,Pappas; Elizabeth,9,0,30,21
1715648220157,EDS 139,A00,507294,Fargason; Sharon Gayle,9,0,30,21
1715648220157,EDS 139,B00,507313,Pappas; Elizabeth,9,0,30,21
1715648221181,EDS 201,A00,507315,Staff,10,0,30,20
1715648222210,EDS 203,A01,507317,Halter; Christopher P.,10,0,30,20
1715648223236,EDS 204R,A01,507319,Halter; Christopher P.,0,3,30,30
1715648223236,EDS 204R,B01,507331,Heinzman; Erica M.,14,0,30,16
1715648224261,EDS 206R,A00,507332,Staff,0,4,30,30
1715648224261,EDS 206R,B00,507343,Staff,15,0,30,15
1715648225291,EDS 250,A00,507344,Hemans; Patricia Ann Benitez,20,0,40,20
1715648226318,EDS 281,A00,507345,Daly; Alan J.,18,0,18,0
1715648227344,EDS 284,A00,507350,Daly; Alan J.,16,0,16,0
1715648228370,EDS 286,A00,507359,Fine; Sarah,18,0,18,0
1715648229398,EDS 289C,A01,507361,Daly; Alan J.,18,0,18,0
1715648230425,EDS 290,A00,507366,Hofstetter; Carolyn,15,0,15,0
1715648231455,LIGM 5A,A00,507421,Fischer-Grunski; Eva K,17,0,20,3
1715648232480,LIGM 5B,A00,507423,Fischer-Grunski; Eva K,19,0,20,1
1715648233508,LIGM 5C,A00,507425,Fischer-Grunski; Eva K,19,0,20,1
1715648234554,LIIT 5AS,A00,507427,Carnelos; Chiara,20,0,20,0
1715648235583,LIIT 5BS,A00,507430,Carnelos; Chiara,20,0,20,0
1715648236609,LIIT 5CS,A00,507432,Carnelos; Chiara,20,0,20,0
1715648237635,LISP 5A,A00,507541,Munoz Sanchez; Alicia,11,0,20,9
1715648238660,LISP 5B,A00,507671,Munoz Sanchez; Alicia,8,0,20,12
1715648239684,LISP 5C,A00,507696,Munoz Sanchez; Alicia,8,0,20,12
1715648240711,MAE 197,001,528363,Boechler; Nicholas Sebastia,9998,0,9999,1
1715648241738,MATH 197,001,523477,Kedlaya; Kiran S.,9994,0,9999,5
1715648241738,MATH 197,002,563811,Zhang; Danna,9994,0,9999,5
1715648241738,MATH 197,003,628552,Dumitriu; Ioana,9998,0,9999,1
1715648241738,MATH 197,004,660885,Floyd; Eric,9998,0,9999,1
1715648242768,MCWP 40R,A00,518780,Staff,1,0,20,19
1715648242768,MCWP 40R,B00,518781,Carter; Jennifer A,10,0,20,10
1715648242768,MCWP 40R,C00,518783,Smith; Haydee Marie,5,0,20,15
1715648243795,MCWP 50R,A00,518791,Redela; Pamela Morgan,0,1,20,20
1715648243795,MCWP 50R,B00,518792,Krone; Jarret,0,2,20,20
1715648243795,MCWP 50R,C00,518793,Staff,0,4,20,20
1715648243795,MCWP 50R,D00,518794,Morshed; Michael James,0,2,20,20
1715648243795,MCWP 50R,E00,518795,Carter; Andrea L,0,2,20,20
1715648243795,MCWP 50R,F00,518796,Miller; Elizabeth Deen,0,1,20,20
1715648243795,MCWP 50R,G00,518797,Guillen; Melinda,0,1,20,20
1715648244825,MMW 12R,A01,514034,Herbst; Matthew,0,2,16,16
1715648244825,MMW 12R,A02,514035,Herbst; Matthew,0,0,16,16
1715648245850,MMW 13R,A01,514037,Staff,0,5,16,16
1715648245850,MMW 13R,A02,514039,Staff,0,5,16,16
1715648245850,MMW 13R,A03,628519,Staff,0,4,16,16
1715648247901,SIO 295LS,A00,523233,Staff,10,0,30,20
1715648248928,SIO 295S,A00,523232,Staff,10,0,30,20
1715648250010,SIOC 290S,A01,637330,Merrifield; Mark A,21,0,30,9
1715648251036,SIOC 291S,A01,637333,Gabriel; Corey John,21,0,30,9
1715648252064,SOCI 117,A01,494376,Staff,0,5,5,5
1715648253090,WES 237B,A00,494380,Staff,10,0,20,10
1715648255157,AESE 279B,A00,494370,Wade; Jon P,0,0,33,33
1715648256184,AIP 97,001,660915,Van Den Einde; Yael Dahlia,9998,0,9999,1
1715648257212,AIP 197,001,627712,Vespa; Emanuel Ignacio,9995,0,9999,4
1715648257212,AIP 197,002,650778,Amir; On,9998,0,9999,1
1715648257212,AIP 197,003,650933,Avenancio-Leon; Carlos,9998,0,9999,1
1715648257212,AIP 197,004,658530,Heyman; Gail D.,9998,0,9999,1
1715648257212,AIP 197,005,658631,Neal; Sonya E,9998,0,9999,1
1715648257212,AIP 197,006,658671,Du; Songzi,9998,0,9999,1
1715648258238,ANAR 135S,A00,494369,Braswell; Geoffrey E.,0,0,0,0
1715648259267,BENG 196,001,628496,Engler; Adam J.,9998,0,9999,1
1715648259267,BENG 196,002,660916,Watson; John Thomas,9998,0,9999,1
1715648260296,BISP 197,001,650773,Wilhelm; James E.,9994,0,9999,5
1715648260296,BISP 197,002,658904,Coleman; Aaron B.,9998,0,9999,1
1715648261324,CAT 124RS,A01,519847,Geibel; William,0,0,20,20
1715648262353,CAT 125RS,A01,515971,Geibel; William,0,0,20,20
1715648263382,CLRE 250,A00,511389,Morris; Sheldon,9992,0,9999,7
1715648264413,CLRE 251,A00,507176,Mehta; Ravindra L.,9992,0,9999,7
1715648264413,CLRE 251,B00,511410,Mehta; Ravindra L.,9998,0,9999,1
1715648265439,CLRE 252,A00,507189,Cuomo; Raphael Eduardo,9994,0,9999,5
1715648266466,CLRE 253,A00,507199,Vaida; Florin,9994,0,9999,5
1715648266466,CLRE 253,B00,507202,Vaida; Florin,9999,0,9999,0
1715648267492,CLRE 259,A00,507211,Patel; Hemal,9996,0,9999,3
1715648268517,CLRE 260,A00,507221,Cuomo; Raphael Eduardo,9999,0,9999,0
1715648269545,CLRE 297,001,507242,Cuomo; Raphael Eduardo,9999,0,9999,0
1715648270574,COGS 197,001,638244,Voytek; Bradley Thomas,9997,0,9999,2
1715648271604,CSE 191,A00,516875,Minnes Kemp; Mor Mia,9991,0,9999,8
1715648272629,CSE 197,001,637388,Minnes Kemp; Mor Mia,9992,0,9999,7
1715648273656,CSS 201S,A01,494383,Mignozzetti; Umberto,35,0,35,0
1715648274681,CSS 202S,A01,494387,Mignozzetti; Umberto,35,0,35,0
1715648275708,DSC 197,001,628532,Eldridge; Justin Matthew,9995,0,9999,4
1715648276736,EAP 100,A00,516065,Staff,9799,0,9999,200
1715648277769,ECE 45,A01,507414,Staff,32,0,60,28
1715648279828,ECE 111,A01,507420,Staff,11,0,50,39
1715648280853,ECE 197,001,548057,Sievenpiper; Daniel F.,9991,0,9999,8
1715648281879,EDS 115,A00,507243,Choi; Bailey Miyeon,6,0,28,22
1715648282909,EDS 117,A01,494379,Staff,0,6,34,35
1715648283935,EDS 125,A00,507246,Hopkins; Megan Beth,7,0,30,23
1715648284964,EDS 128A,A01,507264,Fargason; Sharon Gayle,5,0,26,21
1715648285990,EDS 128B,A01,507293,Pappas; Elizabeth,9,0,30,21
1715648287020,EDS 139,A00,507294,Fargason; Sharon Gayle,9,0,30,21
1715648287020,EDS 139,B00,507313,Pappas; Elizabeth,9,0,30,21
1715648288048,EDS 201,A00,507315,Staff,10,0,30,20
1715648289074,EDS 203,A01,507317,Halter; Christopher P.,10,0,30,20
1715648290099,EDS 204R,A01,507319,Halter; Christopher P.,0,3,30,30
1715648290099,EDS 204R,B01,507331,Heinzman; Erica M.,14,0,30,16
1715648291127,EDS 206R,A00,507332,Staff,0,4,30,30
1715648291127,EDS 206R,B00,507343,Staff,15,0,30,15
1715648292154,EDS 250,A00,507344,Hemans; Patricia Ann Benitez,20,0,40,20
1715648293180,EDS 281,A00,507345,Daly; Alan J.,18,0,18,0
1715648294207,EDS 284,A00,507350,Daly; Alan J.,16,0,16,0
1715648295236,EDS 286,A00,507359,Fine; Sarah,18,0,18,0
1715648296263,EDS 289C,A01,507361,Daly; Alan J.,18,0,18,0
1715648297294,EDS 290,A00,507366,Hofstetter; Carolyn,15,0,15,0
1715648298320,LIGM 5A,A00,507421,Fischer-Grunski; Eva K,17,0,20,3
1715648299346,LIGM 5B,A00,507423,Fischer-Grunski; Eva K,19,0,20,1
1715648300375,LIGM 5C,A00,507425,Fischer-Grunski; Eva K,19,0,20,1
1715648301402,LIIT 5AS,A00,507427,Carnelos; Chiara,20,0,20,0
1715648302430,LIIT 5BS,A00,507430,Carnelos; Chiara,20,0,20,0
1715648303456,LIIT 5CS,A00,507432,Carnelos; Chiara,20,0,20,0
1715648304482,LISP 5A,A00,507541,Munoz Sanchez; Alicia,11,0,20,9
1715648305512,LISP 5B,A00,507671,Munoz Sanchez; Alicia,8,0,20,12
1715648306541,LISP 5C,A00,507696,Munoz Sanchez; Alicia,8,0,20,12
1715648307566,MAE 197,001,528363,Boechler; Nicholas Sebastia,9998,0,9999,1
1715648308595,MATH 197,001,523477,Kedlaya; Kiran S.,9994,0,9999,5
1715648308595,MATH 197,002,563811,Zhang; Danna,9994,0,9999,5
1715648308595,MATH 197,003,628552,Dumitriu; Ioana,9998,0,9999,1
1715648308595,MATH 197,004,660885,Floyd; Eric,9998,0,9999,1
1715648309626,MCWP 40R,A00,518780,Staff,1,0,20,19
1715648309626,MCWP 40R,B00,518781,Carter; Jennifer A,10,0,20,10
1715648309626,MCWP 40R,C00,518783,Smith; Haydee Marie,5,0,20,15
1715648310656,MCWP 50R,A00,518791,Redela; Pamela Morgan,0,1,20,20
1715648310656,MCWP 50R,B00,518792,Krone; Jarret,0,2,20,20
1715648310656,MCWP 50R,C00,518793,Staff,0,4,20,20
1715648310656,MCWP 50R,D00,518794,Morshed; Michael James,0,2,20,20
1715648310656,MCWP 50R,E00,518795,Carter; Andrea L,0,2,20,20
1715648310656,MCWP 50R,F00,518796,Miller; Elizabeth Deen,0,1,20,20
1715648310656,MCWP 50R,G00,518797,Guillen; Melinda,0,1,20,20
1715648311685,MMW 12R,A01,514034,Herbst; Matthew,0,2,16,16
1715648311685,MMW 12R,A02,514035,Herbst; Matthew,0,0,16,16
1715648312712,MMW 13R,A01,514037,Staff,0,5,16,16
1715648312712,MMW 13R,A02,514039,Staff,0,5,16,16
1715648312712,MMW 13R,A03,628519,Staff,0,4,16,16
1715648314768,SIO 295LS,A00,523233,Staff,10,0,30,20
1715648315797,SIO 295S,A00,523232,Staff,10,0,30,20
1715648316824,SIOC 290S,A01,637330,Merrifield; Mark A,21,0,30,9
1715648317850,SIOC 291S,A01,637333,Gabriel; Corey John,21,0,30,9
1715648318880,SOCI 117,A01,494376,Staff,0,5,5,5
1715648319908,WES 237B,A00,494380,Staff,10,0,20,10
1715648321974,AESE 279B,A00,494370,Wade; Jon P,0,0,33,33
1715648323001,AIP 97,001,660915,Van Den Einde; Yael Dahlia,9998,0,9999,1
1715648324031,AIP 197,001,627712,Vespa; Emanuel Ignacio,9995,0,9999,4
1715648324031,AIP 197,002,650778,Amir; On,9998,0,9999,1
1715648324031,AIP 197,003,650933,Avenancio-Leon; Carlos,9998,0,9999,1
1715648324031,AIP 197,004,658530,Heyman; Gail D.,9998,0,9999,1
1715648324031,AIP 197,005,658631,Neal; Sonya E,9998,0,9999,1
1715648324031,AIP 197,006,658671,Du; Songzi,9998,0,9999,1
1715648325057,ANAR 135S,A00,494369,Braswell; Geoffrey E.,0,0,0,0
1715648326084,BENG 196,001,628496,Engler; Adam J.,9998,0,9999,1
1715648326084,BENG 196,002,660916,Watson; John Thomas,9998,0,9999,1
1715648327114,BISP 197,001,650773,Wilhelm; James E.,9994,0,9999,5
1715648327114,BISP 197,002,658904,Coleman; Aaron B.,9998,0,9999,1
1715648328139,CAT 124RS,A01,519847,Geibel; William,0,0,20,20
1715648329165,CAT 125RS,A01,515971,Geibel; William,0,0,20,20
1715648330191,CLRE 250,A00,511389,Morris; Sheldon,9992,0,9999,7
1715648331222,CLRE 251,A00,507176,Mehta; Ravindra L.,9992,0,9999,7
1715648331222,CLRE 251,B00,511410,Mehta; Ravindra L.,9998,0,9999,1
1715648332251,CLRE 252,A00,507189,Cuomo; Raphael Eduardo,9994,0,9999,5
1715648333278,CLRE 253,A00,507199,Vaida; Florin,9994,0,9999,5
1715648333278,CLRE 253,B00,507202,Vaida; Florin,9999,0,9999,0
1715648334305,CLRE 259,A00,507211,Patel; Hemal,9996,0,9999,3
1715648335331,CLRE 260,A00,507221,Cuomo; Raphael Eduardo,9999,0,9999,0
1715648336361,CLRE 297,001,507242,Cuomo; Raphael Eduardo,9999,0,9999,0
1715648337389,COGS 197,001,638244,Voytek; Bradley Thomas,9997,0,9999,2
1715648338421,CSE 191,A00,516875,Minnes Kemp; Mor Mia,9991,0,9999,8
1715648339449,CSE 197,001,637388,Minnes Kemp; Mor Mia,9992,0,9999,7
1715648340484,CSS 201S,A01,494383,Mignozzetti; Umberto,35,0,35,0
1715648341514,CSS 202S,A01,494387,Mignozzetti; Umberto,35,0,35,0
1715648342544,DSC 197,001,628532,Eldridge; Justin Matthew,9995,0,9999,4
1715648343574,EAP 100,A00,516065,Staff,9799,0,9999,200
1715648344605,ECE 45,A01,507414,Staff,32,0,60,28
1715648346660,ECE 111,A01,507420,Staff,11,0,50,39
1715648347686,ECE 197,001,548057,Sievenpiper; Daniel F.,9991,0,9999,8
1715648348712,EDS 115,A00,507243,Choi; Bailey Miyeon,6,0,28,22
1715648349741,EDS 117,A01,494379,Staff,0,6,34,35
1715648350770,EDS 125,A00,507246,Hopkins; Megan Beth,7,0,30,23
1715648351803,EDS 128A,A01,507264,Fargason; Sharon Gayle,5,0,26,21
1715648352829,EDS 128B,A01,507293,Pappas; Elizabeth,9,0,30,21
1715648353914,EDS 139,A00,507294,Fargason; Sharon Gayle,9,0,30,21
1715648353914,EDS 139,B00,507313,Pappas; Elizabeth,9,0,30,21
1715648354942,EDS 201,A00,507315,Staff,10,0,30,20
1715648355969,EDS 203,A01,507317,Halter; Christopher P.,10,0,30,20
1715648356997,EDS 204R,A01,507319,Halter; Christopher P.,0,3,30,30
1715648356997,EDS 204R,B01,507331,Heinzman; Erica M.,14,0,30,16
1715648358023,EDS 206R,A00,507332,Staff,0,4,30,30
1715648358023,EDS 206R,B00,507343,Staff,15,0,30,15
1715648359050,EDS 250,A00,507344,Hemans; Patricia Ann Benitez,20,0,40,20
1715648360078,EDS 281,A00,507345,Daly; Alan J.,18,0,18,0
1715648361105,EDS 284,A00,507350,Daly; Alan J.,16,0,16,0
1715648362132,EDS 286,A00,507359,Fine; Sarah,18,0,18,0
1715648363158,EDS 289C,A01,507361,Daly; Alan J.,18,0,18,0
1715648364190,EDS 290,A00,507366,Hofstetter; Carolyn,15,0,15,0
1715648365217,LIGM 5A,A00,507421,Fischer-Grunski; Eva K,17,0,20,3
1715648366244,LIGM 5B,A00,507423,Fischer-Grunski; Eva K,19,0,20,1
1715648367270,LIGM 5C,A00,507425,Fischer-Grunski; Eva K,19,0,20,1
1715648368296,LIIT 5AS,A00,507427,Carnelos; Chiara,20,0,20,0
1715648369326,LIIT 5BS,A00,507430,Carnelos; Chiara,20,0,20,0
1715648370355,LIIT 5CS,A00,507432,Carnelos; Chiara,20,0,20,0
1715648371381,LISP 5A,A00,507541,Munoz Sanchez; Alicia,11,0,20,9
1715648372406,LISP 5B,A00,507671,Munoz Sanchez; Alicia,8,0,20,12
1715648373435,LISP 5C,A00,507696,Munoz Sanchez; Alicia,8,0,20,12
1715648374464,MAE 197,001,528363,Boechler; Nicholas Sebastia,9998,0,9999,1
1715648375496,MATH 197,001,523477,Kedlaya; Kiran S.,9994,0,9999,5
1715648375496,MATH 197,002,563811,Zhang; Danna,9994,0,9999,5
1715648375496,MATH 197,003,628552,Dumitriu; Ioana,9998,0,9999,1
1715648375496,MATH 197,004,660885,Floyd; Eric,9998,0,9999,1
1715648376524,MCWP 40R,A00,518780,Staff,1,0,20,19
1715648376524,MCWP 40R,B00,518781,Carter; Jennifer A,10,0,20,10
1715648376524,MCWP 40R,C00,518783,Smith; Haydee Marie,5,0,20,15
1715648377554,MCWP 50R,A00,518791,Redela; Pamela Morgan,0,1,20,20
1715648377554,MCWP 50R,B00,518792,Krone; Jarret,0,2,20,20
1715648377554,MCWP 50R,C00,518793,Staff,0,4,20,20
1715648377554,MCWP 50R,D00,518794,Morshed; Michael James,0,2,20,20
1715648377554,MCWP 50R,E00,518795,Carter; Andrea L,0,2,20,20
1715648377554,MCWP 50R,F00,518796,Miller; Elizabeth Deen,0,1,20,20
1715648377554,MCWP 50R,G00,518797,Guillen; Melinda,0,1,20,20
1715648378581,MMW 12R,A01,514034,Herbst; Matthew,0,2,16,16
1715648378581,MMW 12R,A02,514035,Herbst; Matthew,0,0,16,16
1715648379610,MMW 13R,A01,514037,Staff,0,5,16,16
1715648379610,MMW 13R,A02,514039,Staff,0,5,16,16
1715648379610,MMW 13R,A03,628519,Staff,0,4,16,16
1715648381666,SIO 295LS,A00,523233,Staff,10,0,30,20
1715648382693,SIO 295S,A00,523232,Staff,10,0,30,20
1715648383719,SIOC 290S,A01,637330,Merrifield; Mark A,21,0,30,9
1715648384745,SIOC 291S,A01,637333,Gabriel; Corey John,21,0,30,9
1715648385772,SOCI 117,A01,494376,Staff,0,5,5,5
1715648386800,WES 237B,A00,494380,Staff,10,0,20,10
1715648388878,AESE 279B,A00,494370,Wade; Jon P,0,0,33,33
1715648389904,AIP 97,001,660915,Van Den Einde; Yael Dahlia,9998,0,9999,1
1715648390931,AIP 197,001,627712,Vespa; Emanuel Ignacio,9995,0,9999,4
1715648390931,AIP 197,002,650778,Amir; On,9998,0,9999,1
1715648390931,AIP 197,003,650933,Avenancio-Leon; Carlos,9998,0,9999,1
1715648390931,AIP 197,004,658530,Heyman; Gail D.,9998,0,9999,1
1715648390931,AIP 197,005,658631,Neal; Sonya E,9998,0,9999,1
1715648390931,AIP 197,006,658671,Du; Songzi,9998,0,9999,1
1715648391956,ANAR 135S,A00,494369,Braswell; Geoffrey E.,0,0,0,0
1715648392981,BENG 196,001,628496,Engler; Adam J.,9998,0,9999,1
1715648392981,BENG 196,002,660916,Watson; John Thomas,9998,0,9999,1
1715648394007,BISP 197,001,650773,Wilhelm; James E.,9994,0,9999,5
1715648394007,BISP 197,002,658904,Coleman; Aaron B.,9998,0,9999,1
1715648395036,CAT 124RS,A01,519847,Geibel; William,0,0,20,20
1715648396065,CAT 125RS,A01,515971,Geibel; William,0,0,20,20
1715648397096,CLRE 250,A00,511389,Morris; Sheldon,9992,0,9999,7
1715648398132,CLRE 251,A00,507176,Mehta; Ravindra L.,9992,0,9999,7
1715648398132,CLRE 251,B00,511410,Mehta; Ravindra L.,9998,0,9999,1
1715648399163,CLRE 252,A00,507189,Cuomo; Raphael Eduardo,9994,0,9999,5
1715648400189,CLRE 253,A00,507199,Vaida; Florin,9994,0,9999,5
1715648400189,CLRE 253,B00,507202,Vaida; Florin,9999,0,9999,0
1715648401215,CLRE 259,A00,507211,Patel; Hemal,9996,0,9999,3
1715648402244,CLRE 260,A00,507221,Cuomo; Raphael Eduardo,9999,0,9999,0
1715648403272,CLRE 297,001,507242,Cuomo; Raphael Eduardo,9999,0,9999,0
1715648404296,COGS 197,001,638244,Voytek; Bradley Thomas,9997,0,9999,2
1715648405324,CSE 191,A00,516875,Minnes Kemp; Mor Mia,9991,0,9999,8
1715648406350,CSE 197,001,637388,Minnes Kemp; Mor Mia,9992,0,9999,7
1715648407384,CSS 201S,A01,494383,Mignozzetti; Umberto,35,0,35,0
1715648408415,CSS 202S,A01,494387,Mignozzetti; Umberto,35,0,35,0
1715648409443,DSC 197,001,628532,Eldridge; Justin Matthew,9995,0,9999,4
1715648410471,EAP 100,A00,516065,Staff,9799,0,9999,200
1715648411499,ECE 45,A01,507414,Staff,32,0,60,28
1715648413553,ECE 111,A01,507420,Staff,11,0,50,39
1715648414578,ECE 197,001,548057,Sievenpiper; Daniel F.,9991,0,9999,8
1715648415604,EDS 115,A00,507243,Choi; Bailey Miyeon,6,0,28,22
1715648416632,EDS 117,A01,494379,Staff,0,6,34,35
1715648417660,EDS 125,A00,507246,Hopkins; Megan Beth,7,0,30,23
1715648418689,EDS 128A,A01,507264,Fargason; Sharon Gayle,5,0,26,21
1715648419713,EDS 128B,A01,507293,Pappas; Elizabeth,9,0,30,21
1715648420737,EDS 139,A00,507294,Fargason; Sharon Gayle,9,0,30,21
1715648420737,EDS 139,B00,507313,Pappas; Elizabeth,9,0,30,21
1715648421767,EDS 201,A00,507315,Staff,10,0,30,20
1715648422796,EDS 203,A01,507317,Halter; Christopher P.,10,0,30,20
1715648423826,EDS 204R,A01,507319,Halter; Christopher P.,0,3,30,30
1715648423826,EDS 204R,B01,507331,Heinzman; Erica M.,14,0,30,16
1715648424851,EDS 206R,A00,507332,Staff,0,4,30,30
1715648424851,EDS 206R,B00,507343,Staff,15,0,30,15
1715648425877,EDS 250,A00,507344,Hemans; Patricia Ann Benitez,20,0,40,20
1715648426903,EDS 281,A00,507345,Daly; Alan J.,18,0,18,0
1715648427929,EDS 284,A00,507350,Daly; Alan J.,16,0,16,0
1715648428952,EDS 286,A00,507359,Fine; Sarah,18,0,18,0
1715648429977,EDS 289C,A01,507361,Daly; Alan J.,18,0,18,0
1715648431007,EDS 290,A00,507366,Hofstetter; Carolyn,15,0,15,0
1715648432032,LIGM 5A,A00,507421,Fischer-Grunski; Eva K,17,0,20,3
1715648433057,LIGM 5B,A00,507423,Fischer-Grunski; Eva K,19,0,20,1
1715648434082,LIGM 5C,A00,507425,Fischer-Grunski; Eva K,19,0,20,1
1715648435113,LIIT 5AS,A00,507427,Carnelos; Chiara,20,0,20,0
1715648436140,LIIT 5BS,A00,507430,Carnelos; Chiara,20,0,20,0
1715648437175,LIIT 5CS,A00,507432,Carnelos; Chiara,20,0,20,0
1715648438205,LISP 5A,A00,507541,Munoz Sanchez; Alicia,11,0,20,9
1715648439234,LISP 5B,A00,507671,Munoz Sanchez; Alicia,8,0,20,12
1715648440262,LISP 5C,A00,507696,Munoz Sanchez; Alicia,8,0,20,12
1715648441286,MAE 197,001,528363,Boechler; Nicholas Sebastia,9998,0,9999,1
1715648442313,MATH 197,001,523477,Kedlaya; Kiran S.,9994,0,9999,5
1715648442313,MATH 197,002,563811,Zhang; Danna,9994,0,9999,5
1715648442313,MATH 197,003,628552,Dumitriu; Ioana,9998,0,9999,1
1715648442313,MATH 197,004,660885,Floyd; Eric,9998,0,9999,1
1715648443339,MCWP 40R,A00,518780,Staff,1,0,20,19
1715648443339,MCWP 40R,B00,518781,Carter; Jennifer A,10,0,20,10
1715648443339,MCWP 40R,C00,518783,Smith; Haydee Marie,5,0,20,15
1715648444367,MCWP 50R,A00,518791,Redela; Pamela Morgan,0,1,20,20
1715648444367,MCWP 50R,B00,518792,Krone; Jarret,0,2,20,20
1715648444367,MCWP 50R,C00,518793,Staff,0,4,20,20
1715648444367,MCWP 50R,D00,518794,Morshed; Michael James,0,2,20,20
1715648444367,MCWP 50R,E00,518795,Carter; Andrea L,0,2,20,20
1715648444367,MCWP 50R,F00,518796,Miller; Elizabeth Deen,0,1,20,20
1715648444367,MCWP 50R,G00,518797,Guillen; Melinda,0,1,20,20
1715648445397,MMW 12R,A01,514034,Herbst; Matthew,0,2,16,16
1715648445397,MMW 12R,A02,514035,Herbst; Matthew,0,0,16,16
1715648446423,MMW 13R,A01,514037,Staff,0,5,16,16
1715648446423,MMW 13R,A02,514039,Staff,0,5,16,16
1715648446423,MMW 13R,A03,628519,Staff,0,4,16,16
1715648448476,SIO 295LS,A00,523233,Staff,10,0,30,20
1715648449503,SIO 295S,A00,523232,Staff,10,0,30,20
1715648450538,SIOC 290S,A01,637330,Merrifield; Mark A,21,0,30,9
1715648451562,SIOC 291S,A01,637333,Gabriel; Corey John,21,0,30,9
1715648452591,SOCI 117,A01,494376,Staff,0,5,5,5
1715648453618,WES 237B,A00,494380,Staff,10,0,20,10
1715648455692,AESE 279B,A00,494370,Wade; Jon P,0,0,33,33
1715648456718,AIP 97,001,660915,Van Den Einde; Yael Dahlia,9998,0,9999,1
1715648457744,AIP 197,001,627712,Vespa; Emanuel Ignacio,9995,0,9999,4
1715648457744,AIP 197,002,650778,Amir; On,9998,0,9999,1
1715648457744,AIP 197,003,650933,Avenancio-Leon; Carlos,9998,0,9999,1
1715648457744,AIP 197,004,658530,Heyman; Gail D.,9998,0,9999,1
1715648457744,AIP 197,005,658631,Neal; Sonya E,9998,0,9999,1
1715648457744,AIP 197,006,658671,Du; Songzi,9998,0,9999,1
1715648458771,ANAR 135S,A00,494369,Braswell; Geoffrey E.,0,0,0,0
1715648459797,BENG 196,001,628496,Engler; Adam J.,9998,0,9999,1
1715648459797,BENG 196,002,660916,Watson; John Thomas,9998,0,9999,1
1715648460830,BISP 197,001,650773,Wilhelm; James E.,9994,0,9999,5
1715648460830,BISP 197,002,658904,Coleman; Aaron B.,9998,0,9999,1
1715648461861,CAT 124RS,A01,519847,Geibel; William,0,0,20,20
1715648462890,CAT 125RS,A01,515971,Geibel; William,0,0,20,20
1715648463916,CLRE 250,A00,511389,Morris; Sheldon,9992,0,9999,7
1715648464942,CLRE 251,A00,507176,Mehta; Ravindra L.,9992,0,9999,7
1715648464942,CLRE 251,B00,511410,Mehta; Ravindra L.,9998,0,9999,1
1715648465972,CLRE 252,A00,507189,Cuomo; Raphael Eduardo,9994,0,9999,5
1715648466997,CLRE 253,A00,507199,Vaida; Florin,9994,0,9999,5
1715648466997,CLRE 253,B00,507202,Vaida; Florin,9999,0,9999,0
1715648468021,CLRE 259,A00,507211,Patel; Hemal,9996,0,9999,3
1715648469047,CLRE 260,A00,507221,Cuomo; Raphael Eduardo,9999,0,9999,0
1715648470072,CLRE 297,001,507242,Cuomo; Raphael Eduardo,9999,0,9999,0
1715648471097,COGS 197,001,638244,Voytek; Bradley Thomas,9997,0,9999,2
1715648472128,CSE 191,A00,516875,Minnes Kemp; Mor Mia,9991,0,9999,8
1715648473153,CSE 197,001,637388,Minnes Kemp; Mor Mia,9992,0,9999,7
1715648474181,CSS 201S,A01,494383,Mignozzetti; Umberto,35,0,35,0
1715648475206,CSS 202S,A01,494387,Mignozzetti; Umberto,35,0,35,0
1715648476233,DSC 197,001,628532,Eldridge; Justin Matthew,9995,0,9999,4
1715648477263,EAP 100,A00,516065,Staff,9799,0,9999,200
1715648478294,ECE 45,A01,507414,Staff,32,0,60,28
1715648480344,ECE 111,A01,507420,Staff,11,0,50,39
1715648481373,ECE 197,001,548057,Sievenpiper; Daniel F.,9991,0,9999,8
1715648482403,EDS 115,A00,507243,Choi; Bailey Miyeon,6,0,28,22
1715648483430,EDS 117,A01,494379,Staff,0,6,34,35
1715648484457,EDS 125,A00,507246,Hopkins; Megan Beth,7,0,30,23
1715648485482,EDS 128A,A01,507264,Fargason; Sharon Gayle,5,0,26,21
1715648486508,EDS 128B,A01,507293,Pappas; Elizabeth,9,0,30,21
1715648487536,EDS 139,A00,507294,Fargason; Sharon Gayle,9,0,30,21
1715648487536,EDS 139,B00,507313,Pappas; Elizabeth,9,0,30,21
1715648488618,EDS 201,A00,507315,Staff,10,0,30,20
1715648489648,EDS 203,A01,507317,Halter; Christopher P.,10,0,30,20
1715648490677,EDS 204R,A01,507319,Halter; Christopher P.,0,3,30,30
1715648490677,EDS 204R,B01,507331,Heinzman; Erica M.,14,0,30,16
1715648491718,EDS 206R,A00,507332,Staff,0,4,30,30
1715648491718,EDS 206R,B00,507343,Staff,15,0,30,15
1715648492745,EDS 250,A00,507344,Hemans; Patricia Ann Benitez,20,0,40,20
1715648493771,EDS 281,A00,507345,Daly; Alan J.,18,0,18,0
1715648494797,EDS 284,A00,507350,Daly; Alan J.,16,0,16,0
1715648495826,EDS 286,A00,507359,Fine; Sarah,18,0,18,0
1715648496855,EDS 289C,A01,507361,Daly; Alan J.,18,0,18,0
1715648497882,EDS 290,A00,507366,Hofstetter; Carolyn,15,0,15,0
1715648498913,LIGM 5A,A00,507421,Fischer-Grunski; Eva K,17,0,20,3
1715648499940,LIGM 5B,A00,507423,Fischer-Grunski; Eva K,19,0,20,1
1715648500965,LIGM 5C,A00,507425,Fischer-Grunski; Eva K,19,0,20,1
1715648501995,LIIT 5AS,A00,507427,Carnelos; Chiara,20,0,20,0
1715648503020,LIIT 5BS,A00,507430,Carnelos; Chiara,20,0,20,0
1715648504047,LIIT 5CS,A00,507432,Carnelos; Chiara,20,0,20,0
1715648505077,LISP 5A,A00,507541,Munoz Sanchez; Alicia,11,0,20,9
1715648506103,LISP 5B,A00,507671,Munoz Sanchez; Alicia,8,0,20,12
1715648507127,LISP 5C,A00,507696,Munoz Sanchez; Alicia,8,0,20,12
1715648508154,MAE 197,001,528363,Boechler; Nicholas Sebastia,9998,0,9999,1
1715648509182,MATH 197,001,523477,Kedlaya; Kiran S.,9994,0,9999,5
1715648509182,MATH 197,002,563811,Zhang; Danna,9994,0,9999,5
1715648509182,MATH 197,003,628552,Dumitriu; Ioana,9998,0,9999,1
1715648509182,MATH 197,004,660885,Floyd; Eric,9998,0,9999,1
1715648510215,MCWP 40R,A00,518780,Staff,1,0,20,19
1715648510215,MCWP 40R,B00,518781,Carter; Jennifer A,10,0,20,10
1715648510215,MCWP 40R,C00,518783,Smith; Haydee Marie,5,0,20,15
1715648511245,MCWP 50R,A00,518791,Redela; Pamela Morgan,0,1,20,20
1715648511245,MCWP 50R,B00,518792,Krone; Jarret,0,2,20,20
1715648511245,MCWP 50R,C00,518793,Staff,0,4,20,20
1715648511245,MCWP 50R,D00,518794,Morshed; Michael James,0,2,20,20
1715648511245,MCWP 50R,E00,518795,Carter; Andrea L,0,2,20,20
1715648511245,MCWP 50R,F00,518796,Miller; Elizabeth Deen,0,1,20,20
1715648511245,MCWP 50R,G00,518797,Guillen; Melinda,0,1,20,20
1715648512269,MMW 12R,A01,514034,Herbst; Matthew,0,2,16,16
1715648512269,MMW 12R,A02,514035,Herbst; Matthew,0,0,16,16
1715648513295,MMW 13R,A01,514037,Staff,0,5,16,16
1715648513295,MMW 13R,A02,514039,Staff,0,5,16,16
1715648513295,MMW 13R,A03,628519,Staff,0,4,16,16
1715648515355,SIO 295LS,A00,523233,Staff,10,0,30,20
1715648516383,SIO 295S,A00,523232,Staff,10,0,30,20
1715648517416,SIOC 290S,A01,637330,Merrifield; Mark A,21,0,30,9
1715648518442,SIOC 291S,A01,637333,Gabriel; Corey John,21,0,30,9
1715648519468,SOCI 117,A01,494376,Staff,0,5,5,5
1715648520498,WES 237B,A00,494380,Staff,10,0,20,10
1715648522587,AESE 279B,A00,494370,Wade; Jon P,0,0,33,33
1715648523612,AIP 97,001,660915,Van Den Einde; Yael Dahlia,9998,0,9999,1
1715648524648,AIP 197,001,627712,Vespa; Emanuel Ignacio,9995,0,9999,4
1715648524648,AIP 197,002,650778,Amir; On,9998,0,9999,1
1715648524648,AIP 197,003,650933,Avenancio-Leon; Carlos,9998,0,9999,1
1715648524648,AIP 197,004,658530,Heyman; Gail D.,9998,0,9999,1
1715648524648,AIP 197,005,658631,Neal; Sonya E,9998,0,9999,1
1715648524648,AIP 197,006,658671,Du; Songzi,9998,0,9999,1
1715648525680,ANAR 135S,A00,494369,Braswell; Geoffrey E.,0,0,0,0
1715648526705,BENG 196,001,628496,Engler; Adam J.,9998,0,9999,1
1715648526705,BENG 196,002,660916,Watson; John Thomas,9998,0,9999,1
1715648527731,BISP 197,001,650773,Wilhelm; James E.,9994,0,9999,5
1715648527731,BISP 197,002,658904,Coleman; Aaron B.,9998,0,9999,1
1715648528757,CAT 124RS,A01,519847,Geibel; William,0,0,20,20
1715648529783,CAT 125RS,A01,515971,Geibel; William,0,0,20,20
1715648530811,CLRE 250,A00,511389,Morris; Sheldon,9992,0,9999,7
1715648531837,CLRE 251,A00,507176,Mehta; Ravindra L.,9992,0,9999,7
1715648531837,CLRE 251,B00,511410,Mehta; Ravindra L.,9998,0,9999,1
1715648532866,CLRE 252,A00,507189,Cuomo; Raphael Eduardo,9994,0,9999,5
1715648533909,CLRE 253,A00,507199,Vaida; Florin,9994,0,9999,5
1715648533909,CLRE 253,B00,507202,Vaida; Florin,9999,0,9999,0
1715648534937,CLRE 259,A00,507211,Patel; Hemal,9996,0,9999,3
1715648535965,CLRE 260,A00,507221,Cuomo; Raphael Eduardo,9999,0,9999,0
1715648536992,CLRE 297,001,507242,Cuomo; Raphael Eduardo,9999,0,9999,0
1715648538019,COGS 197,001,638244,Voytek; Bradley Thomas,9997,0,9999,2
1715648539043,CSE 191,A00,516875,Minnes Kemp; Mor Mia,9991,0,9999,8
1715648540068,CSE 197,001,637388,Minnes Kemp; Mor Mia,9992,0,9999,7
1715648541095,CSS 201S,A01,494383,Mignozzetti; Umberto,35,0,35,0
1715648542125,CSS 202S,A01,494387,Mignozzetti; Umberto,35,0,35,0
1715648543154,DSC 197,001,628532,Eldridge; Justin Matthew,9995,0,9999,4
1715648544185,EAP 100,A00,516065,Staff,9799,0,9999,200
1715648545212,ECE 45,A01,507414,Staff,32,0,60,28
1715648547264,ECE 111,A01,507420,Staff,11,0,50,39
1715648548288,ECE 197,001,548057,Sievenpiper; Daniel F.,9991,0,9999,8
1715648549315,EDS 115,A00,507243,Choi; Bailey Miyeon,6,0,28,22
1715648550345,EDS 117,A01,494379,Staff,0,6,34,35
1715648551372,EDS 125,A00,507246,Hopkins; Megan Beth,7,0,30,23
1715648552400,EDS 128A,A01,507264,Fargason; Sharon Gayle,5,0,26,21
1715648553427,EDS 128B,A01,507293,Pappas; Elizabeth,9,0,30,21
1715648554452,EDS 139,A00,507294,Fargason; Sharon Gayle,9,0,30,21
1715648554452,EDS 139,B00,507313,Pappas; Elizabeth,9,0,30,21
1715648555478,EDS 201,A00,507315,Staff,10,0,30,20
1715648556504,EDS 203,A01,507317,Halter; Christopher P.,10,0,30,20
1715648557534,EDS 204R,A01,507319,Halter; Christopher P.,0,3,30,30
1715648557534,EDS 204R,B01,507331,Heinzman; Erica M.,14,0,30,16
1715648558559,EDS 206R,A00,507332,Staff,0,4,30,30
1715648558559,EDS 206R,B00,507343,Staff,15,0,30,15
1715648559588,EDS 250,A00,507344,Hemans; Patricia Ann Benitez,20,0,40,20
1715648560613,EDS 281,A00,507345,Daly; Alan J.,18,0,18,0
1715648561639,EDS 284,A00,507350,Daly; Alan J.,16,0,16,0
1715648562666,EDS 286,A00,507359,Fine; Sarah,18,0,18,0
1715648563690,EDS 289C,A01,507361,Daly; Alan J.,18,0,18,0
1715648564715,EDS 290,A00,507366,Hofstetter; Carolyn,15,0,15,0
1715648565740,LIGM 5A,A00,507421,Fischer-Grunski; Eva K,17,0,20,3
1715648566768,LIGM 5B,A00,507423,Fischer-Grunski; Eva K,19,0,20,1
1715648567793,LIGM 5C,A00,507425,Fischer-Grunski; Eva K,19,0,20,1
1715648568819,LIIT 5AS,A00,507427,Carnelos; Chiara,20,0,20,0
1715648569847,LIIT 5BS,A00,507430,Carnelos; Chiara,20,0,20,0
1715648570873,LIIT 5CS,A00,507432,Carnelos; Chiara,20,0,20,0
1715648571904,LISP 5A,A00,507541,Munoz Sanchez; Alicia,11,0,20,9
1715648572934,LISP 5B,A00,507671,Munoz Sanchez; Alicia,8,0,20,12
1715648573959,LISP 5C,A00,507696,Munoz Sanchez; Alicia,8,0,20,12
1715648574984,MAE 197,001,528363,Boechler; Nicholas Sebastia,9998,0,9999,1
1715648576014,MATH 197,001,523477,Kedlaya; Kiran S.,9994,0,9999,5
1715648576014,MATH 197,002,563811,Zhang; Danna,9994,0,9999,5
1715648576014,MATH 197,003,628552,Dumitriu; Ioana,9998,0,9999,1
1715648576014,MATH 197,004,660885,Floyd; Eric,9998,0,9999,1
1715648577041,MCWP 40R,A00,518780,Staff,1,0,20,19
1715648577041,MCWP 40R,B00,518781,Carter; Jennifer A,10,0,20,10
1715648577041,MCWP 40R,C00,518783,Smith; Haydee Marie,5,0,20,15
1715648578074,MCWP 50R,A00,518791,Redela; Pamela Morgan,0,1,20,20
1715648578074,MCWP 50R,B00,518792,Krone; Jarret,0,2,20,20
1715648578074,MCWP 50R,C00,518793,Staff,0,4,20,20
1715648578074,MCWP 50R,D00,518794,Morshed; Michael James,0,2,20,20
1715648578074,MCWP 50R,E00,518795,Carter; Andrea L,0,2,20,20
1715648578074,MCWP 50R,F00,518796,Miller; Elizabeth Deen,0,1,20,20
1715648578074,MCWP 50R,G00,518797,Guillen; Melinda,0,1,20,20
1715648579100,MMW 12R,A01,514034,Herbst; Matthew,0,2,16,16
1715648579100,MMW 12R,A02,514035,Herbst; Matthew,0,0,16,16
1715648580126,MMW 13R,A01,514037,Staff,0,5,16,16
1715648580126,MMW 13R,A02,514039,Staff,0,5,16,16
1715648580126,MMW 13R,A03,628519,Staff,0,4,16,16
1715648582179,SIO 295LS,A00,523233,Staff,10,0,30,20
1715648583204,SIO 295S,A00,523232,Staff,10,0,30,20
1715648584231,SIOC 290S,A01,637330,Merrifield; Mark A,21,0,30,9
1715648585257,SIOC 291S,A01,637333,Gabriel; Corey John,21,0,30,9
1715648586282,SOCI 117,A01,494376,Staff,0,5,5,5
1715648587308,WES 237B,A00,494380,Staff,10,0,20,10
1715648589392,AESE 279B,A00,494370,Wade; Jon P,0,0,33,33
1715648590417,AIP 97,001,660915,Van Den Einde; Yael Dahlia,9998,0,9999,1
1715648591453,AIP 197,001,627712,Vespa; Emanuel Ignacio,9995,0,9999,4
1715648591453,AIP 197,002,650778,Amir; On,9998,0,9999,1
1715648591453,AIP 197,003,650933,Avenancio-Leon; Carlos,9998,0,9999,1
1715648591453,AIP 197,004,658530,Heyman; Gail D.,9998,0,9999,1
1715648591453,AIP 197,005,658631,Neal; Sonya E,9998,0,9999,1
1715648591453,AIP 197,006,658671,Du; Songzi,9998,0,9999,1
1715648592534,ANAR 135S,A00,494369,Braswell; Geoffrey E.,0,0,0,0
1715648593565,BENG 196,001,628496,Engler; Adam J.,9998,0,9999,1
1715648593565,BENG 196,002,660916,Watson; John Thomas,9998,0,9999,1
1715648594591,BISP 197,001,650773,Wilhelm; James E.,9994,0,9999,5
1715648594591,BISP 197,002,658904,Coleman; Aaron B.,9998,0,9999,1
1715648595621,CAT 124RS,A01,519847,Geibel; William,0,0,20,20
1715648596647,CAT 125RS,A01,515971,Geibel; William,0,0,20,20
1715648597673,CLRE 250,A00,511389,Morris; Sheldon,9992,0,9999,7
1715648598700,CLRE 251,A00,507176,Mehta; Ravindra L.,9992,0,9999,7
1715648598700,CLRE 251,B00,511410,Mehta; Ravindra L.,9998,0,9999,1
1715648599725,CLRE 252,A00,507189,Cuomo; Raphael Eduardo,9994,0,9999,5
1715648600755,CLRE 253,A00,507199,Vaida; Florin,9994,0,9999,5
1715648600755,CLRE 253,B00,507202,Vaida; Florin,9999,0,9999,0
1715648601782,CLRE 259,A00,507211,Patel; Hemal,9996,0,9999,3
1715648602807,CLRE 260,A00,507221,Cuomo; Raphael Eduardo,9999,0,9999,0
1715648603832,CLRE 297,001,507242,Cuomo; Raphael Eduardo,9999,0,9999,0
1715648604856,COGS 197,001,638244,Voytek; Bradley Thomas,9997,0,9999,2
1715648605881,CSE 191,A00,516875,Minnes Kemp; Mor Mia,9991,0,9999,8
1715648606906,CSE 197,001,637388,Minnes Kemp; Mor Mia,9992,0,9999,7
1715648607933,CSS 201S,A01,494383,Mignozzetti; Umberto,35,0,35,0
1715648608962,CSS 202S,A01,494387,Mignozzetti; Umberto,35,0,35,0
1715648609992,DSC 197,001,628532,Eldridge; Justin Matthew,9995,0,9999,4
1715648611017,EAP 100,A00,516065,Staff,9799,0,9999,200
1715648612047,ECE 45,A01,507414,Staff,32,0,60,28
1715648614098,ECE 111,A01,507420,Staff,11,0,50,39
1715648615127,ECE 197,001,548057,Sievenpiper; Daniel F.,9991,0,9999,8
1715648616151,EDS 115,A00,507243,Choi; Bailey Miyeon,6,0,28,22
1715648617183,EDS 117,A01,494379,Staff,0,6,34,35
1715648618217,EDS 125,A00,507246,Hopkins; Megan Beth,7,0,30,23
1715648619243,EDS 128A,A01,507264,Fargason; Sharon Gayle,5,0,26,21
1715648620273,EDS 128B,A01,507293,Pappas; Elizabeth,9,0,30,21
1715648621302,EDS 139,A00,507294,Fargason; Sharon Gayle,9,0,30,21
1715648621302,EDS 139,B00,507313,Pappas; Elizabeth,9,0,30,21
1715648622328,EDS 201,A00,507315,Staff,10,0,30,20
1715648623360,EDS 203,A01,507317,Halter; Christopher P.,10,0,30,20
1715648624388,EDS 204R,A01,507319,Halter; Christopher P.,0,3,30,30
1715648624388,EDS 204R,B01,507331,Heinzman; Erica M.,14,0,30,16
1715648625414,EDS 206R,A00,507332,Staff,0,4,30,30
1715648625414,EDS 206R,B00,507343,Staff,15,0,30,15
1715648626439,EDS 250,A00,507344,Hemans; Patricia Ann Benitez,20,0,40,20
1715648627465,EDS 281,A00,507345,Daly; Alan J.,18,0,18,0
1715648628493,EDS 284,A00,507350,Daly; Alan J.,16,0,16,0
1715648629524,EDS 286,A00,507359,Fine; Sarah,18,0,18,0
1715648630551,EDS 289C,A01,507361,Daly; Alan J.,18,0,18,0
1715648631579,EDS 290,A00,507366,Hofstetter; Carolyn,15,0,15,0
1715648632607,LIGM 5A,A00,507421,Fischer-Grunski; Eva K,17,0,20,3
1715648633638,LIGM 5B,A00,507423,Fischer-Grunski; Eva K,19,0,20,1
1715648634669,LIGM 5C,A00,507425,Fischer-Grunski; Eva K,19,0,20,1
1715648635697,LIIT 5AS,A00,507427,Carnelos; Chiara,20,0,20,0
1715648636727,LIIT 5BS,A00,507430,Carnelos; Chiara,20,0,20,0
1715648637757,LIIT 5CS,A00,507432,Carnelos; Chiara,20,0,20,0
1715648638787,LISP 5A,A00,507541,Munoz Sanchez; Alicia,11,0,20,9
1715648639816,LISP 5B,A00,507671,Munoz Sanchez; Alicia,8,0,20,12
1715648640846,LISP 5C,A00,507696,Munoz Sanchez; Alicia,8,0,20,12
1715648641870,MAE 197,001,528363,Boechler; Nicholas Sebastia,9998,0,9999,1
1715648642902,MATH 197,001,523477,Kedlaya; Kiran S.,9994,0,9999,5
1715648642902,MATH 197,002,563811,Zhang; Danna,9994,0,9999,5
1715648642902,MATH 197,003,628552,Dumitriu; Ioana,9998,0,9999,1
1715648642902,MATH 197,004,660885,Floyd; Eric,9998,0,9999,1
1715648643929,MCWP 40R,A00,518780,Staff,1,0,20,19
1715648643929,MCWP 40R,B00,518781,Carter; Jennifer A,10,0,20,10
1715648643929,MCWP 40R,C00,518783,Smith; Haydee Marie,5,0,20,15
1715648644956,MCWP 50R,A00,518791,Redela; Pamela Morgan,0,1,20,20
1715648644956,MCWP 50R,B00,518792,Krone; Jarret,0,2,20,20
1715648644956,MCWP 50R,C00,518793,Staff,0,4,20,20
1715648644956,MCWP 50R,D00,518794,Morshed; Michael James,0,2,20,20
1715648644956,MCWP 50R,E00,518795,Carter; Andrea L,0,2,20,20
1715648644956,MCWP 50R,F00,518796,Miller; Elizabeth Deen,0,1,20,20
1715648644956,MCWP 50R,G00,518797,Guillen; Melinda,0,1,20,20
1715648645990,MMW 12R,A01,514034,Herbst; Matthew,0,2,16,16
1715648645990,MMW 12R,A02,514035,Herbst; Matthew,0,0,16,16
1715648647020,MMW 13R,A01,514037,Staff,0,5,16,16
1715648647020,MMW 13R,A02,514039,Staff,0,5,16,16
1715648647020,MMW 13R,A03,628519,Staff,0,4,16,16
1715648649079,SIO 295LS,A00,523233,Staff,10,0,30,20
1715648650107,SIO 295S,A00,523232,Staff,10,0,30,20
1715648651133,SIOC 290S,A01,637330,Merrifield; Mark A,21,0,30,9
1715648652163,SIOC 291S,A01,637333,Gabriel; Corey John,21,0,30,9
1715648653190,SOCI 117,A01,494376,Staff,0,5,5,5
1715648654216,WES 237B,A00,494380,Staff,10,0,20,10
1715648656288,AESE 279B,A00,494370,Wade; Jon P,0,0,33,33
1715648657316,AIP 97,001,660915,Van Den Einde; Yael Dahlia,9998,0,9999,1
1715648658343,AIP 197,001,627712,Vespa; Emanuel Ignacio,9995,0,9999,4
1715648658343,AIP 197,002,650778,Amir; On,9998,0,9999,1
1715648658343,AIP 197,003,650933,Avenancio-Leon; Carlos,9998,0,9999,1
1715648658343,AIP 197,004,658530,Heyman; Gail D.,9998,0,9999,1
1715648658343,AIP 197,005,658631,Neal; Sonya E,9998,0,9999,1
1715648658343,AIP 197,006,658671,Du; Songzi,9998,0,9999,1
1715648659368,ANAR 135S,A00,494369,Braswell; Geoffrey E.,0,0,0,0
1715648660395,BENG 196,001,628496,Engler; Adam J.,9998,0,9999,1
1715648660395,BENG 196,002,660916,Watson; John Thomas,9998,0,9999,1
1715648661422,BISP 197,001,650773,Wilhelm; James E.,9994,0,9999,5
1715648661422,BISP 197,002,658904,Coleman; Aaron B.,9998,0,9999,1
1715648662450,CAT 124RS,A01,519847,Geibel; William,0,0,20,20
1715648663477,CAT 125RS,A01,515971,Geibel; William,0,0,20,20
1715648664510,CLRE 250,A00,511389,Morris; Sheldon,9992,0,9999,7
1715648665540,CLRE 251,A00,507176,Mehta; Ravindra L.,9992,0,9999,7
1715648665540,CLRE 251,B00,511410,Mehta; Ravindra L.,9998,0,9999,1
1715648666567,CLRE 252,A00,507189,Cuomo; Raphael Eduardo,9994,0,9999,5
1715648667593,CLRE 253,A00,507199,Vaida; Florin,9994,0,9999,5
1715648667593,CLRE 253,B00,507202,Vaida; Florin,9999,0,9999,0
1715648668618,CLRE 259,A00,507211,Patel; Hemal,9996,0,9999,3
1715648669643,CLRE 260,A00,507221,Cuomo; Raphael Eduardo,9999,0,9999,0
1715648670671,CLRE 297,001,507242,Cuomo; Raphael Eduardo,9999,0,9999,0
1715648671695,COGS 197,001,638244,Voytek; Bradley Thomas,9997,0,9999,2
1715648672725,CSE 191,A00,516875,Minnes Kemp; Mor Mia,9991,0,9999,8
1715648673750,CSE 197,001,637388,Minnes Kemp; Mor Mia,9992,0,9999,7
1715648674780,CSS 201S,A01,494383,Mignozzetti; Umberto,35,0,35,0
1715648675806,CSS 202S,A01,494387,Mignozzetti; Umberto,35,0,35,0
1715648676837,DSC 197,001,628532,Eldridge; Justin Matthew,9995,0,9999,4
1715648677861,EAP 100,A00,516065,Staff,9799,0,9999,200
1715648678888,ECE 45,A01,507414,Staff,32,0,60,28
1715648680936,ECE 111,A01,507420,Staff,11,0,50,39
1715648681964,ECE 197,001,548057,Sievenpiper; Daniel F.,9991,0,9999,8
1715648682988,EDS 115,A00,507243,Choi; Bailey Miyeon,6,0,28,22
1715648684014,EDS 117,A01,494379,Staff,0,6,34,35
1715648685042,EDS 125,A00,507246,Hopkins; Megan Beth,7,0,30,23
1715648686068,EDS 128A,A01,507264,Fargason; Sharon Gayle,5,0,26,21
1715648687092,EDS 128B,A01,507293,Pappas; Elizabeth,9,0,30,21
1715648688121,EDS 139,A00,507294,Fargason; Sharon Gayle,9,0,30,21
1715648688121,EDS 139,B00,507313,Pappas; Elizabeth,9,0,30,21
1715648689150,EDS 201,A00,507315,Staff,10,0,30,20
1715648690179,EDS 203,A01,507317,Halter; Christopher P.,10,0,30,20
1715648691204,EDS 204R,A01,507319,Halter; Christopher P.,0,3,30,30
1715648691204,EDS 204R,B01,507331,Heinzman; Erica M.,14,0,30,16
1715648692237,EDS 206R,A00,507332,Staff,0,4,30,30
1715648692237,EDS 206R,B00,507343,Staff,15,0,30,15
1715648693262,EDS 250,A00,507344,Hemans; Patricia Ann Benitez,20,0,40,20
1715648694289,EDS 281,A00,507345,Daly; Alan J.,18,0,18,0
1715648695317,EDS 284,A00,507350,Daly; Alan J.,16,0,16,0
1715648696398,EDS 286,A00,507359,Fine; Sarah,18,0,18,0
1715648697427,EDS 289C,A01,507361,Daly; Alan J.,18,0,18,0
1715648698457,EDS 290,A00,507366,Hofstetter; Carolyn,15,0,15,0
1715648699484,LIGM 5A,A00,507421,Fischer-Grunski; Eva K,17,0,20,3
1715648700517,LIGM 5B,A00,507423,Fischer-Grunski; Eva K,19,0,20,1
1715648701543,LIGM 5C,A00,507425,Fischer-Grunski; Eva K,19,0,20,1
1715648702569,LIIT 5AS,A00,507427,Carnelos; Chiara,20,0,20,0
1715648703594,LIIT 5BS,A00,507430,Carnelos; Chiara,20,0,20,0
1715648704620,LIIT 5CS,A00,507432,Carnelos; Chiara,20,0,20,0
1715648705650,LISP 5A,A00,507541,Munoz Sanchez; Alicia,11,0,20,9
1715648706676,LISP 5B,A00,507671,Munoz Sanchez; Alicia,8,0,20,12
1715648707704,LISP 5C,A00,507696,Munoz Sanchez; Alicia,8,0,20,12
1715648708730,MAE 197,001,528363,Boechler; Nicholas Sebastia,9998,0,9999,1
1715648709763,MATH 197,001,523477,Kedlaya; Kiran S.,9994,0,9999,5
1715648709763,MATH 197,002,563811,Zhang; Danna,9994,0,9999,5
1715648709763,MATH 197,003,628552,Dumitriu; Ioana,9998,0,9999,1
1715648709763,MATH 197,004,660885,Floyd; Eric,9998,0,9999,1
1715648710788,MCWP 40R,A00,518780,Staff,1,0,20,19
1715648710788,MCWP 40R,B00,518781,Carter; Jennifer A,10,0,20,10
1715648710788,MCWP 40R,C00,518783,Smith; Haydee Marie,5,0,20,15
1715648711822,MCWP 50R,A00,518791,Redela; Pamela Morgan,0,1,20,20
1715648711822,MCWP 50R,B00,518792,Krone; Jarret,0,2,20,20
1715648711822,MCWP 50R,C00,518793,Staff,0,4,20,20
1715648711822,MCWP 50R,D00,518794,Morshed; Michael James,0,2,20,20
1715648711822,MCWP 50R,E00,518795,Carter; Andrea L,0,2,20,20
1715648711822,MCWP 50R,F00,518796,Miller; Elizabeth Deen,0,1,20,20
1715648711822,MCWP 50R,G00,518797,Guillen; Melinda,0,1,20,20
1715648712846,MMW 12R,A01,514034,Herbst; Matthew,0,2,16,16
1715648712846,MMW 12R,A02,514035,Herbst; Matthew,0,0,16,16
1715648713872,MMW 13R,A01,514037,Staff,0,5,16,16
1715648713872,MMW 13R,A02,514039,Staff,0,5,16,16
1715648713872,MMW 13R,A03,628519,Staff,0,4,16,16
1715648715928,SIO 295LS,A00,523233,Staff,10,0,30,20
1715648716957,SIO 295S,A00,523232,Staff,10,0,30,20
1715648717987,SIOC 290S,A01,637330,Merrifield; Mark A,21,0,30,9
1715648719016,SIOC 291S,A01,637333,Gabriel; Corey John,21,0,30,9
1715648720044,SOCI 117,A01,494376,Staff,0,5,5,5
1715648721073,WES 237B,A00,494380,Staff,10,0,20,10
1715648723147,AESE 279B,A00,494370,Wade; Jon P,0,0,33,33
1715648724176,AIP 97,001,660915,Van Den Einde; Yael Dahlia,9998,0,9999,1
1715648725203,AIP 197,001,627712,Vespa; Emanuel Ignacio,9995,0,9999,4
1715648725203,AIP 197,002,650778,Amir; On,9998,0,9999,1
1715648725203,AIP 197,003,650933,Avenancio-Leon; Carlos,9998,0,9999,1
1715648725203,AIP 197,004,658530,Heyman; Gail D.,9998,0,9999,1
1715648725203,AIP 197,005,658631,Neal; Sonya E,9998,0,9999,1
1715648725203,AIP 197,006,658671,Du; Songzi,9998,0,9999,1
1715648726229,ANAR 135S,A00,494369,Braswell; Geoffrey E.,0,0,0,0
1715648727255,BENG 196,001,628496,Engler; Adam J.,9998,0,9999,1
1715648727255,BENG 196,002,660916,Watson; John Thomas,9998,0,9999,1
1715648728282,BISP 197,001,650773,Wilhelm; James E.,9994,0,9999,5
1715648728282,BISP 197,002,658904,Coleman; Aaron B.,9998,0,9999,1
1715648729309,CAT 124RS,A01,519847,Geibel; William,0,0,20,20
1715648730335,CAT 125RS,A01,515971,Geibel; William,0,0,20,20
1715648731362,CLRE 250,A00,511389,Morris; Sheldon,9992,0,9999,7
1715648732392,CLRE 251,A00,507176,Mehta; Ravindra L.,9992,0,9999,7
1715648732392,CLRE 251,B00,511410,Mehta; Ravindra L.,9998,0,9999,1
1715648733422,CLRE 252,A00,507189,Cuomo; Raphael Eduardo,9994,0,9999,5
1715648734448,CLRE 253,A00,507199,Vaida; Florin,9994,0,9999,5
1715648734448,CLRE 253,B00,507202,Vaida; Florin,9999,0,9999,0
1715648735478,CLRE 259,A00,507211,Patel; Hemal,9996,0,9999,3
1715648736503,CLRE 260,A00,507221,Cuomo; Raphael Eduardo,9999,0,9999,0
1715648737530,CLRE 297,001,507242,Cuomo; Raphael Eduardo,9999,0,9999,0
1715648738558,COGS 197,001,638244,Voytek; Bradley Thomas,9997,0,9999,2
1715648739584,CSE 191,A00,516875,Minnes Kemp; Mor Mia,9991,0,9999,8
1715648740610,CSE 197,001,637388,Minnes Kemp; Mor Mia,9992,0,9999,7
1715648741641,CSS 201S,A01,494383,Mignozzetti; Umberto,35,0,35,0
1715648742666,CSS 202S,A01,494387,Mignozzetti; Umberto,35,0,35,0
1715648743689,DSC 197,001,628532,Eldridge; Justin Matthew,9995,0,9999,4
1715648744714,EAP 100,A00,516065,Staff,9799,0,9999,200
1715648745740,ECE 45,A01,507414,Staff,32,0,60,28
1715648747793,ECE 111,A01,507420,Staff,11,0,50,39
1715648748818,ECE 197,001,548057,Sievenpiper; Daniel F.,9991,0,9999,8
1715648749843,EDS 115,A00,507243,Choi; Bailey Miyeon,6,0,28,22
1715648750869,EDS 117,A01,494379,Staff,0,6,34,35
1715648751899,EDS 125,A00,507246,Hopkins; Megan Beth,7,0,30,23
1715648752929,EDS 128A,A01,507264,Fargason; Sharon Gayle,5,0,26,21
1715648753957,EDS 128B,A01,507293,Pappas; Elizabeth,9,0,30,21
1715648754983,EDS 139,A00,507294,Fargason; Sharon Gayle,9,0,30,21
1715648754983,EDS 139,B00,507313,Pappas; Elizabeth,9,0,30,21
1715648756008,EDS 201,A00,507315,Staff,10,0,30,20
1715648757034,EDS 203,A01,507317,Halter; Christopher P.,10,0,30,20
1715648758063,EDS 204R,A01,507319,Halter; Christopher P.,0,3,30,30
1715648758063,EDS 204R,B01,507331,Heinzman; Erica M.,14,0,30,16
1715648759089,EDS 206R,A00,507332,Staff,0,4,30,30
1715648759089,EDS 206R,B00,507343,Staff,15,0,30,15
1715648760114,EDS 250,A00,507344,Hemans; Patricia Ann Benitez,20,0,40,20
1715648761141,EDS 281,A00,507345,Daly; Alan J.,18,0,18,0
1715648762166,EDS 284,A00,507350,Daly; Alan J.,16,0,16,0
1715648763192,EDS 286,A00,507359,Fine; Sarah,18,0,18,0
1715648764216,EDS 289C,A01,507361,Daly; Alan J.,18,0,18,0
1715648765245,EDS 290,A00,507366,Hofstetter; Carolyn,15,0,15,0
1715648766272,LIGM 5A,A00,507421,Fischer-Grunski; Eva K,17,0,20,3
1715648767298,LIGM 5B,A00,507423,Fischer-Grunski; Eva K,19,0,20,1
1715648768324,LIGM 5C,A00,507425,Fischer-Grunski; Eva K,19,0,20,1
1715648769353,LIIT 5AS,A00,507427,Carnelos; Chiara,20,0,20,0
1715648770383,LIIT 5BS,A00,507430,Carnelos; Chiara,20,0,20,0
1715648771408,LIIT 5CS,A00,507432,Carnelos; Chiara,20,0,20,0
1715648772440,LISP 5A,A00,507541,Munoz Sanchez; Alicia,11,0,20,9
1715648773465,LISP 5B,A00,507671,Munoz Sanchez; Alicia,8,0,20,12
1715648774496,LISP 5C,A00,507696,Munoz Sanchez; Alicia,8,0,20,12
1715648775527,MAE 197,001,528363,Boechler; Nicholas Sebastia,9998,0,9999,1
1715648776563,MATH 197,001,523477,Kedlaya; Kiran S.,9994,0,9999,5
1715648776563,MATH 197,002,563811,Zhang; Danna,9994,0,9999,5
1715648776563,MATH 197,003,628552,Dumitriu; Ioana,9998,0,9999,1
1715648776563,MATH 197,004,660885,Floyd; Eric,9998,0,9999,1
1715648777590,MCWP 40R,A00,518780,Staff,1,0,20,19
1715648777590,MCWP 40R,B00,518781,Carter; Jennifer A,10,0,20,10
1715648777590,MCWP 40R,C00,518783,Smith; Haydee Marie,5,0,20,15
1715648778617,MCWP 50R,A00,518791,Redela; Pamela Morgan,0,1,20,20
1715648778617,MCWP 50R,B00,518792,Krone; Jarret,0,2,20,20
1715648778617,MCWP 50R,C00,518793,Staff,0,4,20,20
1715648778617,MCWP 50R,D00,518794,Morshed; Michael James,0,2,20,20
1715648778617,MCWP 50R,E00,518795,Carter; Andrea L,0,2,20,20
1715648778617,MCWP 50R,F00,518796,Miller; Elizabeth Deen,0,1,20,20
1715648778617,MCWP 50R,G00,518797,Guillen; Melinda,0,1,20,20
1715648779646,MMW 12R,A01,514034,Herbst; Matthew,0,2,16,16
1715648779646,MMW 12R,A02,514035,Herbst; Matthew,0,0,16,16
1715648780673,MMW 13R,A01,514037,Staff,0,5,16,16
1715648780673,MMW 13R,A02,514039,Staff,0,5,16,16
1715648780673,MMW 13R,A03,628519,Staff,0,4,16,16
1715648782726,SIO 295LS,A00,523233,Staff,10,0,30,20
1715648783751,SIO 295S,A00,523232,Staff,10,0,30,20
1715648784777,SIOC 290S,A01,637330,Merrifield; Mark A,21,0,30,9
1715648785804,SIOC 291S,A01,637333,Gabriel; Corey John,21,0,30,9
1715648786831,SOCI 117,A01,494376,Staff,0,5,5,5
1715648787857,WES 237B,A00,494380,Staff,10,0,20,10
1715648789921,AESE 279B,A00,494370,Wade; Jon P,0,0,33,33
1715648790949,AIP 97,001,660915,Van Den Einde; Yael Dahlia,9998,0,9999,1
1715648791976,AIP 197,001,627712,Vespa; Emanuel Ignacio,9995,0,9999,4
1715648791976,AIP 197,002,650778,Amir; On,9998,0,9999,1
1715648791976,AIP 197,003,650933,Avenancio-Leon; Carlos,9998,0,9999,1
1715648791976,AIP 197,004,658530,Heyman; Gail D.,9998,0,9999,1
1715648791976,AIP 197,005,658631,Neal; Sonya E,9998,0,9999,1
1715648791976,AIP 197,006,658671,Du; Songzi,9998,0,9999,1
1715648793001,ANAR 135S,A00,494369,Braswell; Geoffrey E.,0,0,0,0
1715648794028,BENG 196,001,628496,Engler; Adam J.,9998,0,9999,1
1715648794028,BENG 196,002,660916,Watson; John Thomas,9998,0,9999,1
1715648795058,BISP 197,001,650773,Wilhelm; James E.,9994,0,9999,5
1715648795058,BISP 197,002,658904,Coleman; Aaron B.,9998,0,9999,1
1715648796087,CAT 124RS,A01,519847,Geibel; William,0,0,20,20
1715648797112,CAT 125RS,A01,515971,Geibel; William,0,0,20,20
1715648798139,CLRE 250,A00,511389,Morris; Sheldon,9992,0,9999,7
1715648799170,CLRE 251,A00,507176,Mehta; Ravindra L.,9992,0,9999,7
1715648799170,CLRE 251,B00,511410,Mehta; Ravindra L.,9998,0,9999,1
1715648800253,CLRE 252,A00,507189,Cuomo; Raphael Eduardo,9994,0,9999,5
1715648801282,CLRE 253,A00,507199,Vaida; Florin,9994,0,9999,5
1715648801282,CLRE 253,B00,507202,Vaida; Florin,9999,0,9999,0
1715648802307,CLRE 259,A00,507211,Patel; Hemal,9996,0,9999,3
1715648803331,CLRE 260,A00,507221,Cuomo; Raphael Eduardo,9999,0,9999,0
1715648804356,CLRE 297,001,507242,Cuomo; Raphael Eduardo,9999,0,9999,0
1715648805382,COGS 197,001,638244,Voytek; Bradley Thomas,9997,0,9999,2
1715648806407,CSE 191,A00,516875,Minnes Kemp; Mor Mia,9991,0,9999,8
1715648807431,CSE 197,001,637388,Minnes Kemp; Mor Mia,9992,0,9999,7
1715648808462,CSS 201S,A01,494383,Mignozzetti; Umberto,35,0,35,0
1715648809493,CSS 202S,A01,494387,Mignozzetti; Umberto,35,0,35,0
1715648810517,DSC 197,001,628532,Eldridge; Justin Matthew,9995,0,9999,4
1715648811544,EAP 100,A00,516065,Staff,9799,0,9999,200
1715648812574,ECE 45,A01,507414,Staff,32,0,60,28
1715648814628,ECE 111,A01,507420,Staff,11,0,50,39
1715648815656,ECE 197,001,548057,Sievenpiper; Daniel F.,9991,0,9999,8
1715648816683,EDS 115,A00,507243,Choi; Bailey Miyeon,6,0,28,22
1715648817708,EDS 117,A01,494379,Staff,0,6,34,35
1715648818738,EDS 125,A00,507246,Hopkins; Megan Beth,7,0,30,23
1715648819765,EDS 128A,A01,507264,Fargason; Sharon Gayle,5,0,26,21
1715648820792,EDS 128B,A01,507293,Pappas; Elizabeth,9,0,30,21
1715648821819,EDS 139,A00,507294,Fargason; Sharon Gayle,9,0,30,21
1715648821819,EDS 139,B00,507313,Pappas; Elizabeth,9,0,30,21
1715648822843,EDS 201,A00,507315,Staff,10,0,30,20
1715648823869,EDS 203,A01,507317,Halter; Christopher P.,10,0,30,20
1715648824895,EDS 204R,A01,507319,Halter; Christopher P.,0,3,30,30
1715648824895,EDS 204R,B01,507331,Heinzman; Erica M.,14,0,30,16
1715648825920,EDS 206R,A00,507332,Staff,0,4,30,30
1715648825920,EDS 206R,B00,507343,Staff,15,0,30,15
1715648826947,EDS 250,A00,507344,Hemans; Patricia Ann Benitez,20,0,40,20
1715648827973,EDS 281,A00,507345,Daly; Alan J.,18,0,18,0
1715648828998,EDS 284,A00,507350,Daly; Alan J.,16,0,16,0
1715648830024,EDS 286,A00,507359,Fine; Sarah,18,0,18,0
1715648831052,EDS 289C,A01,507361,Daly; Alan J.,18,0,18,0
1715648832077,EDS 290,A00,507366,Hofstetter; Carolyn,15,0,15,0
1715648833108,LIGM 5A,A00,507421,Fischer-Grunski; Eva K,17,0,20,3
1715648834133,LIGM 5B,A00,507423,Fischer-Grunski; Eva K,19,0,20,1
1715648835157,LIGM 5C,A00,507425,Fischer-Grunski; Eva K,19,0,20,1
1715648836186,LIIT 5AS,A00,507427,Carnelos; Chiara,20,0,20,0
1715648837211,LIIT 5BS,A00,507430,Carnelos; Chiara,20,0,20,0
1715648838237,LIIT 5CS,A00,507432,Carnelos; Chiara,20,0,20,0
1715648839267,LISP 5A,A00,507541,Munoz Sanchez; Alicia,11,0,20,9
1715648840293,LISP 5B,A00,507671,Munoz Sanchez; Alicia,8,0,20,12
1715648841320,LISP 5C,A00,507696,Munoz Sanchez; Alicia,8,0,20,12
1715648842348,MAE 197,001,528363,Boechler; Nicholas Sebastia,9998,0,9999,1
1715648843385,MATH 197,001,523477,Kedlaya; Kiran S.,9994,0,9999,5
1715648843385,MATH 197,002,563811,Zhang; Danna,9994,0,9999,5
1715648843385,MATH 197,003,628552,Dumitriu; Ioana,9998,0,9999,1
1715648843385,MATH 197,004,660885,Floyd; Eric,9998,0,9999,1
1715648844419,MCWP 40R,A00,518780,Staff,1,0,20,19
1715648844419,MCWP 40R,B00,518781,Carter; Jennifer A,10,0,20,10
1715648844419,MCWP 40R,C00,518783,Smith; Haydee Marie,5,0,20,15
1715648845453,MCWP 50R,A00,518791,Redela; Pamela Morgan,0,1,20,20
1715648845453,MCWP 50R,B00,518792,Krone; Jarret,0,2,20,20
1715648845453,MCWP 50R,C00,518793,Staff,0,4,20,20
1715648845453,MCWP 50R,D00,518794,Morshed; Michael James,0,2,20,20
1715648845453,MCWP 50R,E00,518795,Carter; Andrea L,0,2,20,20
1715648845453,MCWP 50R,F00,518796,Miller; Elizabeth Deen,0,1,20,20
1715648845453,MCWP 50R,G00,518797,Guillen; Melinda,0,1,20,20
1715648846478,MMW 12R,A01,514034,Herbst; Matthew,0,2,16,16
1715648846478,MMW 12R,A02,514035,Herbst; Matthew,0,0,16,16
1715648847502,MMW 13R,A01,514037,Staff,0,5,16,16
1715648847502,MMW 13R,A02,514039,Staff,0,5,16,16
1715648847502,MMW 13R,A03,628519,Staff,0,4,16,16
1715648849557,SIO 295LS,A00,523233,Staff,10,0,30,20
1715648850581,SIO 295S,A00,523232,Staff,10,0,30,20
1715648851612,SIOC 290S,A01,637330,Merrifield; Mark A,21,0,30,9
1715648852642,SIOC 291S,A01,637333,Gabriel; Corey John,21,0,30,9
1715648853673,SOCI 117,A01,494376,Staff,0,5,5,5
1715648854697,WES 237B,A00,494380,Staff,10,0,20,10
1715648856781,AESE 279B,A00,494370,Wade; Jon P,0,0,33,33
1715648857807,AIP 97,001,660915,Van Den Einde; Yael Dahlia,9998,0,9999,1
1715648858844,AIP 197,001,627712,Vespa; Emanuel Ignacio,9995,0,9999,4
1715648858844,AIP 197,002,650778,Amir; On,9998,0,9999,1
1715648858844,AIP 197,003,650933,Avenancio-Leon; Carlos,9998,0,9999,1
1715648858844,AIP 197,004,658530,Heyman; Gail D.,9998,0,9999,1
1715648858844,AIP 197,005,658631,Neal; Sonya E,9998,0,9999,1
1715648858844,AIP 197,006,658671,Du; Songzi,9998,0,9999,1
1715648859868,ANAR 135S,A00,494369,Braswell; Geoffrey E.,0,0,0,0
1715648860894,BENG 196,001,628496,Engler; Adam J.,9998,0,9999,1
1715648860894,BENG 196,002,660916,Watson; John Thomas,9998,0,9999,1
1715648861921,BISP 197,001,650773,Wilhelm; James E.,9994,0,9999,5
1715648861921,BISP 197,002,658904,Coleman; Aaron B.,9998,0,9999,1
1715648862947,CAT 124RS,A01,519847,Geibel; William,0,0,20,20
1715648863970,CAT 125RS,A01,515971,Geibel; William,0,0,20,20
1715648864999,CLRE 250,A00,511389,Morris; Sheldon,9992,0,9999,7
1715648866031,CLRE 251,A00,507176,Mehta; Ravindra L.,9992,0,9999,7
1715648866031,CLRE 251,B00,511410,Mehta; Ravindra L.,9998,0,9999,1
1715648867056,CLRE 252,A00,507189,Cuomo; Raphael Eduardo,9994,0,9999,5
1715648868086,CLRE 253,A00,507199,Vaida; Florin,9994,0,9999,5
1715648868086,CLRE 253,B00,507202,Vaida; Florin,9999,0,9999,0
1715648869115,CLRE 259,A00,507211,Patel; Hemal,9996,0,9999,3
1715648870140,CLRE 260,A00,507221,Cuomo; Raphael Eduardo,9999,0,9999,0
1715648871165,CLRE 297,001,507242,Cuomo; Raphael Eduardo,9999,0,9999,0
1715648872190,COGS 197,001,638244,Voytek; Bradley Thomas,9997,0,9999,2
1715648873219,CSE 191,A00,516875,Minnes Kemp; Mor Mia,9991,0,9999,8
1715648874247,CSE 197,001,637388,Minnes Kemp; Mor Mia,9992,0,9999,7
1715648875274,CSS 201S,A01,494383,Mignozzetti; Umberto,35,0,35,0
1715648876303,CSS 202S,A01,494387,Mignozzetti; Umberto,35,0,35,0
1715648877330,DSC 197,001,628532,Eldridge; Justin Matthew,9995,0,9999,4
1715648878355,EAP 100,A00,516065,Staff,9799,0,9999,200
1715648879382,ECE 45,A01,507414,Staff,32,0,60,28
1715648881436,ECE 111,A01,507420,Staff,11,0,50,39
1715648882464,ECE 197,001,548057,Sievenpiper; Daniel F.,9991,0,9999,8
1715648883492,EDS 115,A00,507243,Choi; Bailey Miyeon,6,0,28,22
1715648884521,EDS 117,A01,494379,Staff,0,6,34,35
1715648885546,EDS 125,A00,507246,Hopkins; Megan Beth,7,0,30,23
1715648886574,EDS 128A,A01,507264,Fargason; Sharon Gayle,5,0,26,21
1715648887600,EDS 128B,A01,507293,Pappas; Elizabeth,9,0,30,21
1715648888627,EDS 139,A00,507294,Fargason; Sharon Gayle,9,0,30,21
1715648888627,EDS 139,B00,507313,Pappas; Elizabeth,9,0,30,21
1715648889655,EDS 201,A00,507315,Staff,10,0,30,20
1715648890684,EDS 203,A01,507317,Halter; Christopher P.,10,0,30,20
1715648891714,EDS 204R,A01,507319,Halter; Christopher P.,0,3,30,30
1715648891714,EDS 204R,B01,507331,Heinzman; Erica M.,14,0,30,16
1715648892743,EDS 206R,A00,507332,Staff,0,4,30,30
1715648892743,EDS 206R,B00,507343,Staff,15,0,30,15
1715648893767,EDS 250,A00,507344,Hemans; Patricia Ann Benitez,20,0,40,20
1715648894799,EDS 281,A00,507345,Daly; Alan J.,18,0,18,0
1715648895823,EDS 284,A00,507350,Daly; Alan J.,16,0,16,0
1715648896848,EDS 286,A00,507359,Fine; Sarah,18,0,18,0
1715648897875,EDS 289C,A01,507361,Daly; Alan J.,18,0,18,0
1715648898902,EDS 290,A00,507366,Hofstetter; Carolyn,15,0,15,0
1715648899932,LIGM 5A,A00,507421,Fischer-Grunski; Eva K,17,0,20,3
1715648900958,LIGM 5B,A00,507423,Fischer-Grunski; Eva K,19,0,20,1
1715648901989,LIGM 5C,A00,507425,Fischer-Grunski; Eva K,19,0,20,1
1715648903013,LIIT 5AS,A00,507427,Carnelos; Chiara,20,0,20,0
1715648904113,LIIT 5BS,A00,507430,Carnelos; Chiara,20,0,20,0
1715648905138,LIIT 5CS,A00,507432,Carnelos; Chiara,20,0,20,0
1715648906164,LISP 5A,A00,507541,Munoz Sanchez; Alicia,11,0,20,9
1715648907194,LISP 5B,A00,507671,Munoz Sanchez; Alicia,8,0,20,12
1715648908223,LISP 5C,A00,507696,Munoz Sanchez; Alicia,8,0,20,12
1715648909252,MAE 197,001,528363,Boechler; Nicholas Sebastia,9998,0,9999,1
1715648910281,MATH 197,001,523477,Kedlaya; Kiran S.,9994,0,9999,5
1715648910281,MATH 197,002,563811,Zhang; Danna,9994,0,9999,5
1715648910281,MATH 197,003,628552,Dumitriu; Ioana,9998,0,9999,1
1715648910281,MATH 197,004,660885,Floyd; Eric,9998,0,9999,1
1715648911308,MCWP 40R,A00,518780,Staff,1,0,20,19
1715648911308,MCWP 40R,B00,518781,Carter; Jennifer A,10,0,20,10
1715648911308,MCWP 40R,C00,518783,Smith; Haydee Marie,5,0,20,15
1715648912340,MCWP 50R,A00,518791,Redela; Pamela Morgan,0,1,20,20
1715648912340,MCWP 50R,B00,518792,Krone; Jarret,0,2,20,20
1715648912340,MCWP 50R,C00,518793,Staff,0,4,20,20
1715648912340,MCWP 50R,D00,518794,Morshed; Michael James,0,2,20,20
1715648912340,MCWP 50R,E00,518795,Carter; Andrea L,0,2,20,20
1715648912340,MCWP 50R,F00,518796,Miller; Elizabeth Deen,0,1,20,20
1715648912340,MCWP 50R,G00,518797,Guillen; Melinda,0,1,20,20
1715648913368,MMW 12R,A01,514034,Herbst; Matthew,0,2,16,16
1715648913368,MMW 12R,A02,514035,Herbst; Matthew,0,0,16,16
1715648914393,MMW 13R,A01,514037,Staff,0,5,16,16
1715648914393,MMW 13R,A02,514039,Staff,0,5,16,16
1715648914393,MMW 13R,A03,628519,Staff,0,4,16,16
1715648916445,SIO 295LS,A00,523233,Staff,10,0,30,20
1715648917471,SIO 295S,A00,523232,Staff,10,0,30,20
1715648918521,SIOC 290S,A01,637330,Merrifield; Mark A,21,0,30,9
1715648919547,SIOC 291S,A01,637333,Gabriel; Corey John,21,0,30,9
1715648920576,SOCI 117,A01,494376,Staff,0,5,5,5
1715648921603,WES 237B,A00,494380,Staff,10,0,20,10
1715648923670,AESE 279B,A00,494370,Wade; Jon P,0,0,33,33
1715648924696,AIP 97,001,660915,Van Den Einde; Yael Dahlia,9998,0,9999,1
1715648925721,AIP 197,001,627712,Vespa; Emanuel Ignacio,9995,0,9999,4
1715648925721,AIP 197,002,650778,Amir; On,9998,0,9999,1
1715648925721,AIP 197,003,650933,Avenancio-Leon; Carlos,9998,0,9999,1
1715648925721,AIP 197,004,658530,Heyman; Gail D.,9998,0,9999,1
1715648925721,AIP 197,005,658631,Neal; Sonya E,9998,0,9999,1
1715648925721,AIP 197,006,658671,Du; Songzi,9998,0,9999,1
1715648926752,ANAR 135S,A00,494369,Braswell; Geoffrey E.,0,0,0,0
1715648927781,BENG 196,001,628496,Engler; Adam J.,9998,0,9999,1
1715648927781,BENG 196,002,660916,Watson; John Thomas,9998,0,9999,1
1715648928814,BISP 197,001,650773,Wilhelm; James E.,9994,0,9999,5
1715648928814,BISP 197,002,658904,Coleman; Aaron B.,9998,0,9999,1
1715648929839,CAT 124RS,A01,519847,Geibel; William,0,0,20,20
1715648930865,CAT 125RS,A01,515971,Geibel; William,0,0,20,20
1715648931894,CLRE 250,A00,511389,Morris; Sheldon,9992,0,9999,7
1715648932920,CLRE 251,A00,507176,Mehta; Ravindra L.,9992,0,9999,7
1715648932920,CLRE 251,B00,511410,Mehta; Ravindra L.,9998,0,9999,1
1715648933946,CLRE 252,A00,507189,Cuomo; Raphael Eduardo,9994,0,9999,5
1715648934976,CLRE 253,A00,507199,Vaida; Florin,9994,0,9999,5
1715648934976,CLRE 253,B00,507202,Vaida; Florin,9999,0,9999,0
1715648936002,CLRE 259,A00,507211,Patel; Hemal,9996,0,9999,3
1715648937028,CLRE 260,A00,507221,Cuomo; Raphael Eduardo,9999,0,9999,0
1715648938054,CLRE 297,001,507242,Cuomo; Raphael Eduardo,9999,0,9999,0
1715648939083,COGS 197,001,638244,Voytek; Bradley Thomas,9997,0,9999,2
1715648940645,CSE 191,A00,516875,Minnes Kemp; Mor Mia,9991,0,9999,8
1715648941673,CSE 197,001,637388,Minnes Kemp; Mor Mia,9992,0,9999,7
1715648942707,CSS 201S,A01,494383,Mignozzetti; Umberto,35,0,35,0
1715648943737,CSS 202S,A01,494387,Mignozzetti; Umberto,35,0,35,0
1715648944765,DSC 197,001,628532,Eldridge; Justin Matthew,9995,0,9999,4
1715648945791,EAP 100,A00,516065,Staff,9799,0,9999,200
1715648946817,ECE 45,A01,507414,Staff,32,0,60,28
1715648948868,ECE 111,A01,507420,Staff,11,0,50,39
1715648949896,ECE 197,001,548057,Sievenpiper; Daniel F.,9991,0,9999,8
1715648950922,EDS 115,A00,507243,Choi; Bailey Miyeon,6,0,28,22
1715648951947,EDS 117,A01,494379,Staff,0,6,34,35
1715648952973,EDS 125,A00,507246,Hopkins; Megan Beth,7,0,30,23
1715648953998,EDS 128A,A01,507264,Fargason; Sharon Gayle,5,0,26,21
1715648955023,EDS 128B,A01,507293,Pappas; Elizabeth,9,0,30,21
1715648956053,EDS 139,A00,507294,Fargason; Sharon Gayle,9,0,30,21
1715648956053,EDS 139,B00,507313,Pappas; Elizabeth,9,0,30,21
1715648957078,EDS 201,A00,507315,Staff,10,0,30,20
1715648958102,EDS 203,A01,507317,Halter; Christopher P.,10,0,30,20
1715648959131,EDS 204R,A01,507319,Halter; Christopher P.,0,3,30,30
1715648959131,EDS 204R,B01,507331,Heinzman; Erica M.,14,0,30,16
1715648960155,EDS 206R,A00,507332,Staff,0,4,30,30
1715648960155,EDS 206R,B00,507343,Staff,15,0,30,15
1715648961178,EDS 250,A00,507344,Hemans; Patricia Ann Benitez,20,0,40,20
1715648962205,EDS 281,A00,507345,Daly; Alan J.,18,0,18,0
1715648963230,EDS 284,A00,507350,Daly; Alan J.,16,0,16,0
1715648964258,EDS 286,A00,507359,Fine; Sarah,18,0,18,0
1715648965285,EDS 289C,A01,507361,Daly; Alan J.,18,0,18,0
1715648966314,EDS 290,A00,507366,Hofstetter; Carolyn,15,0,15,0
1715648967341,LIGM 5A,A00,507421,Fischer-Grunski; Eva K,17,0,20,3
1715648968367,LIGM 5B,A00,507423,Fischer-Grunski; Eva K,19,0,20,1
1715648969394,LIGM 5C,A00,507425,Fischer-Grunski; Eva K,19,0,20,1
1715648970420,LIIT 5AS,A00,507427,Carnelos; Chiara,20,0,20,0
1715648971446,LIIT 5BS,A00,507430,Carnelos; Chiara,20,0,20,0
1715648972474,LIIT 5CS,A00,507432,Carnelos; Chiara,20,0,20,0
1715648973505,LISP 5A,A00,507541,Munoz Sanchez; Alicia,11,0,20,9
1715648974532,LISP 5B,A00,507671,Munoz Sanchez; Alicia,8,0,20,12
1715648975557,LISP 5C,A00,507696,Munoz Sanchez; Alicia,8,0,20,12
1715648976583,MAE 197,001,528363,Boechler; Nicholas Sebastia,9998,0,9999,1
1715648977611,MATH 197,001,523477,Kedlaya; Kiran S.,9994,0,9999,5
1715648977611,MATH 197,002,563811,Zhang; Danna,9994,0,9999,5
1715648977611,MATH 197,003,628552,Dumitriu; Ioana,9998,0,9999,1
1715648977611,MATH 197,004,660885,Floyd; Eric,9998,0,9999,1
1715648978635,MCWP 40R,A00,518780,Staff,1,0,20,19
1715648978635,MCWP 40R,B00,518781,Carter; Jennifer A,10,0,20,10
1715648978635,MCWP 40R,C00,518783,Smith; Haydee Marie,5,0,20,15
1715648979661,MCWP 50R,A00,518791,Redela; Pamela Morgan,0,1,20,20
1715648979661,MCWP 50R,B00,518792,Krone; Jarret,0,2,20,20
1715648979661,MCWP 50R,C00,518793,Staff,0,4,20,20
1715648979661,MCWP 50R,D00,518794,Morshed; Michael James,0,2,20,20
1715648979661,MCWP 50R,E00,518795,Carter; Andrea L,0,2,20,20
1715648979661,MCWP 50R,F00,518796,Miller; Elizabeth Deen,0,1,20,20
1715648979661,MCWP 50R,G00,518797,Guillen; Melinda,0,1,20,20
1715648980688,MMW 12R,A01,514034,Herbst; Matthew,0,2,16,16
1715648980688,MMW 12R,A02,514035,Herbst; Matthew,0,0,16,16
1715648981717,MMW 13R,A01,514037,Staff,0,5,16,16
1715648981717,MMW 13R,A02,514039,Staff,0,5,16,16
1715648981717,MMW 13R,A03,628519,Staff,0,4,16,16
1715648983771,SIO 295LS,A00,523233,Staff,10,0,30,20
1715648984797,SIO 295S,A00,523232,Staff,10,0,30,20
1715648985826,SIOC 290S,A01,637330,Merrifield; Mark A,21,0,30,9
1715648986853,SIOC 291S,A01,637333,Gabriel; Corey John,21,0,30,9
1715648987878,SOCI 117,A01,494376,Staff,0,5,5,5
1715648988903,WES 237B,A00,494380,Staff,10,0,20,10
1715648990982,AESE 279B,A00,494370,Wade; Jon P,0,0,33,33
1715648992006,AIP 97,001,660915,Van Den Einde; Yael Dahlia,9998,0,9999,1
1715648993033,AIP 197,001,627712,Vespa; Emanuel Ignacio,9995,0,9999,4
1715648993033,AIP 197,002,650778,Amir; On,9998,0,9999,1
1715648993033,AIP 197,003,650933,Avenancio-Leon; Carlos,9998,0,9999,1
1715648993033,AIP 197,004,658530,Heyman; Gail D.,9998,0,9999,1
1715648993033,AIP 197,005,658631,Neal; Sonya E,9998,0,9999,1
1715648993033,AIP 197,006,658671,Du; Songzi,9998,0,9999,1
1715648994061,ANAR 135S,A00,494369,Braswell; Geoffrey E.,0,0,0,0
1715648995089,BENG 196,001,628496,Engler; Adam J.,9998,0,9999,1
1715648995089,BENG 196,002,660916,Watson; John Thomas,9998,0,9999,1
1715648996116,BISP 197,001,650773,Wilhelm; James E.,9994,0,9999,5
1715648996116,BISP 197,002,658904,Coleman; Aaron B.,9998,0,9999,1
1715648997144,CAT 124RS,A01,519847,Geibel; William,0,0,20,20
1715648998169,CAT 125RS,A01,515971,Geibel; William,0,0,20,20
1715648999198,CLRE 250,A00,511389,Morris; Sheldon,9992,0,9999,7
1715649000229,CLRE 251,A00,507176,Mehta; Ravindra L.,9992,0,9999,7
1715649000229,CLRE 251,B00,511410,Mehta; Ravindra L.,9998,0,9999,1
1715649001254,CLRE 252,A00,507189,Cuomo; Raphael Eduardo,9994,0,9999,5
1715649002278,CLRE 253,A00,507199,Vaida; Florin,9994,0,9999,5
1715649002278,CLRE 253,B00,507202,Vaida; Florin,9999,0,9999,0
1715649003307,CLRE 259,A00,507211,Patel; Hemal,9996,0,9999,3
1715649004335,CLRE 260,A00,507221,Cuomo; Raphael Eduardo,9999,0,9999,0
1715649005363,CLRE 297,001,507242,Cuomo; Raphael Eduardo,9999,0,9999,0
1715649006393,COGS 197,001,638244,Voytek; Bradley Thomas,9997,0,9999,2
1715649007418,CSE 191,A00,516875,Minnes Kemp; Mor Mia,9991,0,9999,8
1715649008498,CSE 197,001,637388,Minnes Kemp; Mor Mia,9992,0,9999,7
1715649009526,CSS 201S,A01,494383,Mignozzetti; Umberto,35,0,35,0
1715649010555,CSS 202S,A01,494387,Mignozzetti; Umberto,35,0,35,0
1715649011582,DSC 197,001,628532,Eldridge; Justin Matthew,9995,0,9999,4
1715649012607,EAP 100,A00,516065,Staff,9799,0,9999,200
1715649013637,ECE 45,A01,507414,Staff,32,0,60,28
1715649015689,ECE 111,A01,507420,Staff,11,0,50,39
1715649016713,ECE 197,001,548057,Sievenpiper; Daniel F.,9991,0,9999,8
1715649017746,EDS 115,A00,507243,Choi; Bailey Miyeon,6,0,28,22
1715649018773,EDS 117,A01,494379,Staff,0,6,34,35
1715649019799,EDS 125,A00,507246,Hopkins; Megan Beth,7,0,30,23
1715649020824,EDS 128A,A01,507264,Fargason; Sharon Gayle,5,0,26,21
1715649021851,EDS 128B,A01,507293,Pappas; Elizabeth,9,0,30,21
1715649022875,EDS 139,A00,507294,Fargason; Sharon Gayle,9,0,30,21
1715649022875,EDS 139,B00,507313,Pappas; Elizabeth,9,0,30,21
1715649023909,EDS 201,A00,507315,Staff,10,0,30,20
1715649024935,EDS 203,A01,507317,Halter; Christopher P.,10,0,30,20
1715649025962,EDS 204R,A01,507319,Halter; Christopher P.,0,3,30,30
1715649025962,EDS 204R,B01,507331,Heinzman; Erica M.,14,0,30,16
1715649026989,EDS 206R,A00,507332,Staff,0,4,30,30
1715649026989,EDS 206R,B00,507343,Staff,15,0,30,15
1715649028014,EDS 250,A00,507344,Hemans; Patricia Ann Benitez,20,0,40,20
1715649029043,EDS 281,A00,507345,Daly; Alan J.,18,0,18,0
1715649030067,EDS 284,A00,507350,Daly; Alan J.,16,0,16,0
1715649031093,EDS 286,A00,507359,Fine; Sarah,18,0,18,0
1715649032119,EDS 289C,A01,507361,Daly; Alan J.,18,0,18,0
1715649033147,EDS 290,A00,507366,Hofstetter; Carolyn,15,0,15,0
1715649034174,LIGM 5A,A00,507421,Fischer-Grunski; Eva K,17,0,20,3
1715649035200,LIGM 5B,A00,507423,Fischer-Grunski; Eva K,19,0,20,1
1715649036226,LIGM 5C,A00,507425,Fischer-Grunski; Eva K,19,0,20,1
1715649037251,LIIT 5AS,A00,507427,Carnelos; Chiara,20,0,20,0
1715649038283,LIIT 5BS,A00,507430,Carnelos; Chiara,20,0,20,0
1715649039306,LIIT 5CS,A00,507432,Carnelos; Chiara,20,0,20,0
1715649040336,LISP 5A,A00,507541,Munoz Sanchez; Alicia,11,0,20,9
1715649041365,LISP 5B,A00,507671,Munoz Sanchez; Alicia,8,0,20,12
1715649042388,LISP 5C,A00,507696,Munoz Sanchez; Alicia,8,0,20,12
1715649043415,MAE 197,001,528363,Boechler; Nicholas Sebastia,9998,0,9999,1
1715649044443,MATH 197,001,523477,Kedlaya; Kiran S.,9994,0,9999,5
1715649044443,MATH 197,002,563811,Zhang; Danna,9994,0,9999,5
1715649044443,MATH 197,003,628552,Dumitriu; Ioana,9998,0,9999,1
1715649044443,MATH 197,004,660885,Floyd; Eric,9998,0,9999,1
1715649045474,MCWP 40R,A00,518780,Staff,1,0,20,19
1715649045474,MCWP 40R,B00,518781,Carter; Jennifer A,10,0,20,10
1715649045474,MCWP 40R,C00,518783,Smith; Haydee Marie,5,0,20,15
1715649046501,MCWP 50R,A00,518791,Redela; Pamela Morgan,0,1,20,20
1715649046501,MCWP 50R,B00,518792,Krone; Jarret,0,2,20,20
1715649046501,MCWP 50R,C00,518793,Staff,0,4,20,20
1715649046501,MCWP 50R,D00,518794,Morshed; Michael James,0,2,20,20
1715649046501,MCWP 50R,E00,518795,Carter; Andrea L,0,2,20,20
1715649046501,MCWP 50R,F00,518796,Miller; Elizabeth Deen,0,1,20,20
1715649046501,MCWP 50R,G00,518797,Guillen; Melinda,0,1,20,20
1715649047527,MMW 12R,A01,514034,Herbst; Matthew,0,2,16,16
1715649047527,MMW 12R,A02,514035,Herbst; Matthew,0,0,16,16
1715649048558,MMW 13R,A01,514037,Staff,0,5,16,16
1715649048558,MMW 13R,A02,514039,Staff,0,5,16,16
1715649048558,MMW 13R,A03,628519,Staff,0,4,16,16
1715649050608,SIO 295LS,A00,523233,Staff,10,0,30,20
1715649051633,SIO 295S,A00,523232,Staff,10,0,30,20
1715649052658,SIOC 290S,A01,637330,Merrifield; Mark A,21,0,30,9
1715649053685,SIOC 291S,A01,637333,Gabriel; Corey John,21,0,30,9
1715649054712,SOCI 117,A01,494376,Staff,0,5,5,5
1715649055737,WES 237B,A00,494380,Staff,10,0,20,10
1715649057819,AESE 279B,A00,494370,Wade; Jon P,0,0,33,33
1715649058847,AIP 97,001,660915,Van Den Einde; Yael Dahlia,9998,0,9999,1
1715649059874,AIP 197,001,627712,Vespa; Emanuel Ignacio,9995,0,9999,4
1715649059874,AIP 197,002,650778,Amir; On,9998,0,9999,1
1715649059874,AIP 197,003,650933,Avenancio-Leon; Carlos,9998,0,9999,1
1715649059874,AIP 197,004,658530,Heyman; Gail D.,9998,0,9999,1
1715649059874,AIP 197,005,658631,Neal; Sonya E,9998,0,9999,1
1715649059874,AIP 197,006,658671,Du; Songzi,9998,0,9999,1
1715649060898,ANAR 135S,A00,494369,Braswell; Geoffrey E.,0,0,0,0
1715649061925,BENG 196,001,628496,Engler; Adam J.,9998,0,9999,1
1715649061925,BENG 196,002,660916,Watson; John Thomas,9998,0,9999,1
1715649062949,BISP 197,001,650773,Wilhelm; James E.,9994,0,9999,5
1715649062949,BISP 197,002,658904,Coleman; Aaron B.,9998,0,9999,1
1715649063973,CAT 124RS,A01,519847,Geibel; William,0,0,20,20
1715649064998,CAT 125RS,A01,515971,Geibel; William,0,0,20,20
1715649066026,CLRE 250,A00,511389,Morris; Sheldon,9992,0,9999,7
1715649067052,CLRE 251,A00,507176,Mehta; Ravindra L.,9992,0,9999,7
1715649067052,CLRE 251,B00,511410,Mehta; Ravindra L.,9998,0,9999,1
1715649068087,CLRE 252,A00,507189,Cuomo; Raphael Eduardo,9994,0,9999,5
1715649069112,CLRE 253,A00,507199,Vaida; Florin,9994,0,9999,5
1715649069112,CLRE 253,B00,507202,Vaida; Florin,9999,0,9999,0
1715649070139,CLRE 259,A00,507211,Patel; Hemal,9996,0,9999,3
1715649071164,CLRE 260,A00,507221,Cuomo; Raphael Eduardo,9999,0,9999,0
1715649072188,CLRE 297,001,507242,Cuomo; Raphael Eduardo,9999,0,9999,0
1715649073214,COGS 197,001,638244,Voytek; Bradley Thomas,9997,0,9999,2
1715649074242,CSE 191,A00,516875,Minnes Kemp; Mor Mia,9991,0,9999,8
1715649075267,CSE 197,001,637388,Minnes Kemp; Mor Mia,9992,0,9999,7
1715649076296,CSS 201S,A01,494383,Mignozzetti; Umberto,35,0,35,0
1715649077322,CSS 202S,A01,494387,Mignozzetti; Umberto,35,0,35,0
1715649078348,DSC 197,001,628532,Eldridge; Justin Matthew,9995,0,9999,4
1715649079373,EAP 100,A00,516065,Staff,9799,0,9999,200
1715649080400,ECE 45,A01,507414,Staff,32,0,60,28
1715649082452,ECE 111,A01,507420,Staff,11,0,50,39
1715649083476,ECE 197,001,548057,Sievenpiper; Daniel F.,9991,0,9999,8
1715649084504,EDS 115,A00,507243,Choi; Bailey Miyeon,6,0,28,22
1715649085530,EDS 117,A01,494379,Staff,0,6,34,35
1715649086575,EDS 125,A00,507246,Hopkins; Megan Beth,7,0,30,23
1715649087602,EDS 128A,A01,507264,Fargason; Sharon Gayle,5,0,26,21
1715649088631,EDS 128B,A01,507293,Pappas; Elizabeth,9,0,30,21
1715649089655,EDS 139,A00,507294,Fargason; Sharon Gayle,9,0,30,21
1715649089655,EDS 139,B00,507313,Pappas; Elizabeth,9,0,30,21
1715649090681,EDS 201,A00,507315,Staff,10,0,30,20
1715649091707,EDS 203,A01,507317,Halter; Christopher P.,10,0,30,20
1715649092733,EDS 204R,A01,507319,Halter; Christopher P.,0,3,30,30
1715649092733,EDS 204R,B01,507331,Heinzman; Erica M.,14,0,30,16
1715649093760,EDS 206R,A00,507332,Staff,0,4,30,30
1715649093760,EDS 206R,B00,507343,Staff,15,0,30,15
1715649094786,EDS 250,A00,507344,Hemans; Patricia Ann Benitez,20,0,40,20
1715649095810,EDS 281,A00,507345,Daly; Alan J.,18,0,18,0
1715649096837,EDS 284,A00,507350,Daly; Alan J.,16,0,16,0
1715649097863,EDS 286,A00,507359,Fine; Sarah,18,0,18,0
1715649098887,EDS 289C,A01,507361,Daly; Alan J.,18,0,18,0
1715649099913,EDS 290,A00,507366,Hofstetter; Carolyn,15,0,15,0
1715649100937,LIGM 5A,A00,507421,Fischer-Grunski; Eva K,17,0,20,3
1715649101963,LIGM 5B,A00,507423,Fischer-Grunski; Eva K,19,0,20,1
1715649102993,LIGM 5C,A00,507425,Fischer-Grunski; Eva K,19,0,20,1
1715649104026,LIIT 5AS,A00,507427,Carnelos; Chiara,20,0,20,0
1715649105051,LIIT 5BS,A00,507430,Carnelos; Chiara,20,0,20,0
1715649106075,LIIT 5CS,A00,507432,Carnelos; Chiara,20,0,20,0
1715649107104,LISP 5A,A00,507541,Munoz Sanchez; Alicia,11,0,20,9
1715649108133,LISP 5B,A00,507671,Munoz Sanchez; Alicia,8,0,20,12
1715649109158,LISP 5C,A00,507696,Munoz Sanchez; Alicia,8,0,20,12
1715649110187,MAE 197,001,528363,Boechler; Nicholas Sebastia,9998,0,9999,1
1715649111214,MATH 197,001,523477,Kedlaya; Kiran S.,9994,0,9999,5
1715649111214,MATH 197,002,563811,Zhang; Danna,9994,0,9999,5
1715649111214,MATH 197,003,628552,Dumitriu; Ioana,9998,0,9999,1
1715649111214,MATH 197,004,660885,Floyd; Eric,9998,0,9999,1
1715649112246,MCWP 40R,A00,518780,Staff,1,0,20,19
1715649112246,MCWP 40R,B00,518781,Carter; Jennifer A,10,0,20,10
1715649112246,MCWP 40R,C00,518783,Smith; Haydee Marie,5,0,20,15
1715649113272,MCWP 50R,A00,518791,Redela; Pamela Morgan,0,1,20,20
1715649113272,MCWP 50R,B00,518792,Krone; Jarret,0,2,20,20
1715649113272,MCWP 50R,C00,518793,Staff,0,4,20,20
1715649113272,MCWP 50R,D00,518794,Morshed; Michael James,0,2,20,20
1715649113272,MCWP 50R,E00,518795,Carter; Andrea L,0,2,20,20
1715649113272,MCWP 50R,F00,518796,Miller; Elizabeth Deen,0,1,20,20
1715649113272,MCWP 50R,G00,518797,Guillen; Melinda,0,1,20,20
1715649114300,MMW 12R,A01,514034,Herbst; Matthew,0,2,16,16
1715649114300,MMW 12R,A02,514035,Herbst; Matthew,0,0,16,16
1715649115326,MMW 13R,A01,514037,Staff,0,5,16,16
1715649115326,MMW 13R,A02,514039,Staff,0,5,16,16
1715649115326,MMW 13R,A03,628519,Staff,0,4,16,16
1715649117379,SIO 295LS,A00,523233,Staff,10,0,30,20
1715649118407,SIO 295S,A00,523232,Staff,10,0,30,20
1715649119435,SIOC 290S,A01,637330,Merrifield; Mark A,21,0,30,9
1715649120467,SIOC 291S,A01,637333,Gabriel; Corey John,21,0,30,9
1715649121495,SOCI 117,A01,494376,Staff,0,5,5,5
1715649122521,WES 237B,A00,494380,Staff,10,0,20,10
1715649124591,AESE 279B,A00,494370,Wade; Jon P,0,0,33,33
1715649125616,AIP 97,001,660915,Van Den Einde; Yael Dahlia,9998,0,9999,1
1715649126650,AIP 197,001,627712,Vespa; Emanuel Ignacio,9995,0,9999,4
1715649126650,AIP 197,002,650778,Amir; On,9998,0,9999,1
1715649126650,AIP 197,003,650933,Avenancio-Leon; Carlos,9998,0,9999,1
1715649126650,AIP 197,004,658530,Heyman; Gail D.,9998,0,9999,1
1715649126650,AIP 197,005,658631,Neal; Sonya E,9998,0,9999,1
1715649126650,AIP 197,006,658671,Du; Songzi,9998,0,9999,1
1715649127682,ANAR 135S,A00,494369,Braswell; Geoffrey E.,0,0,0,0
1715649128711,BENG 196,001,628496,Engler; Adam J.,9998,0,9999,1
1715649128711,BENG 196,002,660916,Watson; John Thomas,9998,0,9999,1
1715649129738,BISP 197,001,650773,Wilhelm; James E.,9994,0,9999,5
1715649129738,BISP 197,002,658904,Coleman; Aaron B.,9998,0,9999,1
1715649130763,CAT 124RS,A01,519847,Geibel; William,0,0,20,20
1715649131791,CAT 125RS,A01,515971,Geibel; William,0,0,20,20
1715649132821,CLRE 250,A00,511389,Morris; Sheldon,9992,0,9999,7
1715649133849,CLRE 251,A00,507176,Mehta; Ravindra L.,9992,0,9999,7
1715649133849,CLRE 251,B00,511410,Mehta; Ravindra L.,9998,0,9999,1
1715649134900,CLRE 252,A00,507189,Cuomo; Raphael Eduardo,9994,0,9999,5
1715649135926,CLRE 253,A00,507199,Vaida; Florin,9994,0,9999,5
1715649135926,CLRE 253,B00,507202,Vaida; Florin,9999,0,9999,0
1715649136954,CLRE 259,A00,507211,Patel; Hemal,9996,0,9999,3
1715649137979,CLRE 260,A00,507221,Cuomo; Raphael Eduardo,9999,0,9999,0
1715649139003,CLRE 297,001,507242,Cuomo; Raphael Eduardo,9999,0,9999,0
1715649140027,COGS 197,001,638244,Voytek; Bradley Thomas,9997,0,9999,2
1715649141052,CSE 191,A00,516875,Minnes Kemp; Mor Mia,9991,0,9999,8
1715649142079,CSE 197,001,637388,Minnes Kemp; Mor Mia,9992,0,9999,7
1715649143114,CSS 201S,A01,494383,Mignozzetti; Umberto,35,0,35,0
1715649144144,CSS 202S,A01,494387,Mignozzetti; Umberto,35,0,35,0
1715649145168,DSC 197,001,628532,Eldridge; Justin Matthew,9995,0,9999,4
1715649146197,EAP 100,A00,516065,Staff,9799,0,9999,200
1715649147224,ECE 45,A01,507414,Staff,32,0,60,28
1715649149273,ECE 111,A01,507420,Staff,11,0,50,39
1715649150300,ECE 197,001,548057,Sievenpiper; Daniel F.,9991,0,9999,8
1715649151325,EDS 115,A00,507243,Choi; Bailey Miyeon,6,0,28,22
1715649152350,EDS 117,A01,494379,Staff,0,6,34,35
1715649153375,EDS 125,A00,507246,Hopkins; Megan Beth,7,0,30,23
1715649154402,EDS 128A,A01,507264,Fargason; Sharon Gayle,5,0,26,21
1715649155432,EDS 128B,A01,507293,Pappas; Elizabeth,9,0,30,21
1715649156458,EDS 139,A00,507294,Fargason; Sharon Gayle,9,0,30,21
1715649156458,EDS 139,B00,507313,Pappas; Elizabeth,9,0,30,21
1715649157484,EDS 201,A00,507315,Staff,10,0,30,20
1715649158510,EDS 203,A01,507317,Halter; Christopher P.,10,0,30,20
1715649159535,EDS 204R,A01,507319,Halter; Christopher P.,0,3,30,30
1715649159535,EDS 204R,B01,507331,Heinzman; Erica M.,14,0,30,16
1715649160559,EDS 206R,A00,507332,Staff,0,4,30,30
1715649160559,EDS 206R,B00,507343,Staff,15,0,30,15
1715649161584,EDS 250,A00,507344,Hemans; Patricia Ann Benitez,20,0,40,20
1715649162608,EDS 281,A00,507345,Daly; Alan J.,18,0,18,0
1715649163648,EDS 284,A00,507350,Daly; Alan J.,16,0,16,0
1715649164673,EDS 286,A00,507359,Fine; Sarah,18,0,18,0
1715649165697,EDS 289C,A01,507361,Daly; Alan J.,18,0,18,0
1715649166722,EDS 290,A00,507366,Hofstetter; Carolyn,15,0,15,0
1715649167749,LIGM 5A,A00,507421,Fischer-Grunski; Eva K,17,0,20,3
1715649168773,LIGM 5B,A00,507423,Fischer-Grunski; Eva K,19,0,20,1
1715649169796,LIGM 5C,A00,507425,Fischer-Grunski; Eva K,19,0,20,1
1715649170822,LIIT 5AS,A00,507427,Carnelos; Chiara,20,0,20,0
1715649171847,LIIT 5BS,A00,507430,Carnelos; Chiara,20,0,20,0
1715649172878,LIIT 5CS,A00,507432,Carnelos; Chiara,20,0,20,0
1715649173906,LISP 5A,A00,507541,Munoz Sanchez; Alicia,11,0,20,9
1715649174935,LISP 5B,A00,507671,Munoz Sanchez; Alicia,8,0,20,12
1715649175959,LISP 5C,A00,507696,Munoz Sanchez; Alicia,8,0,20,12
1715649176983,MAE 197,001,528363,Boechler; Nicholas Sebastia,9998,0,9999,1
1715649178011,MATH 197,001,523477,Kedlaya; Kiran S.,9994,0,9999,5
1715649178011,MATH 197,002,563811,Zhang; Danna,9994,0,9999,5
1715649178011,MATH 197,003,628552,Dumitriu; Ioana,9998,0,9999,1
1715649178011,MATH 197,004,660885,Floyd; Eric,9998,0,9999,1
1715649179043,MCWP 40R,A00,518780,Staff,1,0,20,19
1715649179043,MCWP 40R,B00,518781,Carter; Jennifer A,10,0,20,10
1715649179043,MCWP 40R,C00,518783,Smith; Haydee Marie,5,0,20,15
1715649180082,MCWP 50R,A00,518791,Redela; Pamela Morgan,0,1,20,20
1715649180082,MCWP 50R,B00,518792,Krone; Jarret,0,2,20,20
1715649180082,MCWP 50R,C00,518793,Staff,0,4,20,20
1715649180082,MCWP 50R,D00,518794,Morshed; Michael James,0,2,20,20
1715649180082,MCWP 50R,E00,518795,Carter; Andrea L,0,2,20,20
1715649180082,MCWP 50R,F00,518796,Miller; Elizabeth Deen,0,1,20,20
1715649180082,MCWP 50R,G00,518797,Guillen; Melinda,0,1,20,20
1715649181108,MMW 12R,A01,514034,Herbst; Matthew,0,2,16,16
1715649181108,MMW 12R,A02,514035,Herbst; Matthew,0,0,16,16
1715649182146,MMW 13R,A01,514037,Staff,0,5,16,16
1715649182146,MMW 13R,A02,514039,Staff,0,5,16,16
1715649182146,MMW 13R,A03,628519,Staff,0,4,16,16
1715649184202,SIO 295LS,A00,523233,Staff,10,0,30,20
1715649185226,SIO 295S,A00,523232,Staff,10,0,30,20
1715649186261,SIOC 290S,A01,637330,Merrifield; Mark A,21,0,30,9
1715649187290,SIOC 291S,A01,637333,Gabriel; Corey John,21,0,30,9
1715649188317,SOCI 117,A01,494376,Staff,0,5,5,5
1715649189343,WES 237B,A00,494380,Staff,10,0,20,10
1715649191423,AESE 279B,A00,494370,Wade; Jon P,0,0,33,33
1715649192452,AIP 97,001,660915,Van Den Einde; Yael Dahlia,9998,0,9999,1
1715649193480,AIP 197,001,627712,Vespa; Emanuel Ignacio,9995,0,9999,4
1715649193480,AIP 197,002,650778,Amir; On,9998,0,9999,1
1715649193480,AIP 197,003,650933,Avenancio-Leon; Carlos,9998,0,9999,1
1715649193480,AIP 197,004,658530,Heyman; Gail D.,9998,0,9999,1
1715649193480,AIP 197,005,658631,Neal; Sonya E,9998,0,9999,1
1715649193480,AIP 197,006,658671,Du; Songzi,9998,0,9999,1
1715649194507,ANAR 135S,A00,494369,Braswell; Geoffrey E.,0,0,0,0
1715649195534,BENG 196,001,628496,Engler; Adam J.,9998,0,9999,1
1715649195534,BENG 196,002,660916,Watson; John Thomas,9998,0,9999,1
1715649196560,BISP 197,001,650773,Wilhelm; James E.,9994,0,9999,5
1715649196560,BISP 197,002,658904,Coleman; Aaron B.,9998,0,9999,1
1715649197586,CAT 124RS,A01,519847,Geibel; William,0,0,20,20
1715649198611,CAT 125RS,A01,515971,Geibel; William,0,0,20,20
1715649199641,CLRE 250,A00,511389,Morris; Sheldon,9992,0,9999,7
1715649200668,CLRE 251,A00,507176,Mehta; Ravindra L.,9992,0,9999,7
1715649200668,CLRE 251,B00,511410,Mehta; Ravindra L.,9998,0,9999,1
1715649201798,CLRE 252,A00,507189,Cuomo; Raphael Eduardo,9994,0,9999,5
1715649202823,CLRE 253,A00,507199,Vaida; Florin,9994,0,9999,5
1715649202823,CLRE 253,B00,507202,Vaida; Florin,9999,0,9999,0
1715649203849,CLRE 259,A00,507211,Patel; Hemal,9996,0,9999,3
1715649204875,CLRE 260,A00,507221,Cuomo; Raphael Eduardo,9999,0,9999,0
1715649205899,CLRE 297,001,507242,Cuomo; Raphael Eduardo,9999,0,9999,0
1715649206928,COGS 197,001,638244,Voytek; Bradley Thomas,9997,0,9999,2
1715649207953,CSE 191,A00,516875,Minnes Kemp; Mor Mia,9991,0,9999,8
1715649208978,CSE 197,001,637388,Minnes Kemp; Mor Mia,9992,0,9999,7
1715649210011,CSS 201S,A01,494383,Mignozzetti; Umberto,35,0,35,0
1715649211036,CSS 202S,A01,494387,Mignozzetti; Umberto,35,0,35,0
1715649212062,DSC 197,001,628532,Eldridge; Justin Matthew,9995,0,9999,4
1715649213087,EAP 100,A00,516065,Staff,9799,0,9999,200
1715649214115,ECE 45,A01,507414,Staff,32,0,60,28
1715649216174,ECE 111,A01,507420,Staff,11,0,50,39
1715649217199,ECE 197,001,548057,Sievenpiper; Daniel F.,9991,0,9999,8
1715649218229,EDS 115,A00,507243,Choi; Bailey Miyeon,6,0,28,22
1715649219259,EDS 117,A01,494379,Staff,0,6,34,35
1715649220285,EDS 125,A00,507246,Hopkins; Megan Beth,7,0,30,23
1715649221310,EDS 128A,A01,507264,Fargason; Sharon Gayle,5,0,26,21
1715649222335,EDS 128B,A01,507293,Pappas; Elizabeth,9,0,30,21
1715649223360,EDS 139,A00,507294,Fargason; Sharon Gayle,9,0,30,21
1715649223360,EDS 139,B00,507313,Pappas; Elizabeth,9,0,30,21
1715649224385,EDS 201,A00,507315,Staff,10,0,30,20
1715649225416,EDS 203,A01,507317,Halter; Christopher P.,10,0,30,20
1715649226445,EDS 204R,A01,507319,Halter; Christopher P.,0,3,30,30
1715649226445,EDS 204R,B01,507331,Heinzman; Erica M.,14,0,30,16
1715649227472,EDS 206R,A00,507332,Staff,0,4,30,30
1715649227472,EDS 206R,B00,507343,Staff,15,0,30,15
1715649228498,EDS 250,A00,507344,Hemans; Patricia Ann Benitez,20,0,40,20
1715649229524,EDS 281,A00,507345,Daly; Alan J.,18,0,18,0
1715649230550,EDS 284,A00,507350,Daly; Alan J.,16,0,16,0
1715649231575,EDS 286,A00,507359,Fine; Sarah,18,0,18,0
1715649232599,EDS 289C,A01,507361,Daly; Alan J.,18,0,18,0
1715649233623,EDS 290,A00,507366,Hofstetter; Carolyn,15,0,15,0
1715649234652,LIGM 5A,A00,507421,Fischer-Grunski; Eva K,17,0,20,3
1715649235682,LIGM 5B,A00,507423,Fischer-Grunski; Eva K,19,0,20,1
1715649236709,LIGM 5C,A00,507425,Fischer-Grunski; Eva K,19,0,20,1
1715649237735,LIIT 5AS,A00,507427,Carnelos; Chiara,20,0,20,0
1715649238761,LIIT 5BS,A00,507430,Carnelos; Chiara,20,0,20,0
1715649239787,LIIT 5CS,A00,507432,Carnelos; Chiara,20,0,20,0
1715649240814,LISP 5A,A00,507541,Munoz Sanchez; Alicia,11,0,20,9
1715649241843,LISP 5B,A00,507671,Munoz Sanchez; Alicia,8,0,20,12
1715649242868,LISP 5C,A00,507696,Munoz Sanchez; Alicia,8,0,20,12
1715649243893,MAE 197,001,528363,Boechler; Nicholas Sebastia,9998,0,9999,1
1715649244921,MATH 197,001,523477,Kedlaya; Kiran S.,9994,0,9999,5
1715649244921,MATH 197,002,563811,Zhang; Danna,9994,0,9999,5
1715649244921,MATH 197,003,628552,Dumitriu; Ioana,9998,0,9999,1
1715649244921,MATH 197,004,660885,Floyd; Eric,9998,0,9999,1
1715649245947,MCWP 40R,A00,518780,Staff,1,0,20,19
1715649245947,MCWP 40R,B00,518781,Carter; Jennifer A,10,0,20,10
1715649245947,MCWP 40R,C00,518783,Smith; Haydee Marie,5,0,20,15
1715649246982,MCWP 50R,A00,518791,Redela; Pamela Morgan,0,1,20,20
1715649246982,MCWP 50R,B00,518792,Krone; Jarret,0,2,20,20
1715649246982,MCWP 50R,C00,518793,Staff,0,4,20,20
1715649246982,MCWP 50R,D00,518794,Morshed; Michael James,0,2,20,20
1715649246982,MCWP 50R,E00,518795,Carter; Andrea L,0,2,20,20
1715649246982,MCWP 50R,F00,518796,Miller; Elizabeth Deen,0,1,20,20
1715649246982,MCWP 50R,G00,518797,Guillen; Melinda,0,1,20,20
1715649248007,MMW 12R,A01,514034,Herbst; Matthew,0,2,16,16
1715649248007,MMW 12R,A02,514035,Herbst; Matthew,0,0,16,16
1715649249036,MMW 13R,A01,514037,Staff,0,5,16,16
1715649249036,MMW 13R,A02,514039,Staff,0,5,16,16
1715649249036,MMW 13R,A03,628519,Staff,0,4,16,16
1715649251086,SIO 295LS,A00,523233,Staff,10,0,30,20
1715649252110,SIO 295S,A00,523232,Staff,10,0,30,20
1715649253135,SIOC 290S,A01,637330,Merrifield; Mark A,21,0,30,9
1715649254164,SIOC 291S,A01,637333,Gabriel; Corey John,21,0,30,9
1715649255189,SOCI 117,A01,494376,Staff,0,5,5,5
1715649256214,WES 237B,A00,494380,Staff,10,0,20,10
1715649258294,AESE 279B,A00,494370,Wade; Jon P,0,0,33,33
1715649259321,AIP 97,001,660915,Van Den Einde; Yael Dahlia,9998,0,9999,1
1715649260350,AIP 197,001,627712,Vespa; Emanuel Ignacio,9995,0,9999,4
1715649260350,AIP 197,002,650778,Amir; On,9998,0,9999,1
1715649260350,AIP 197,003,650933,Avenancio-Leon; Carlos,9998,0,9999,1
1715649260350,AIP 197,004,658530,Heyman; Gail D.,9998,0,9999,1
1715649260350,AIP 197,005,658631,Neal; Sonya E,9998,0,9999,1
1715649260350,AIP 197,006,658671,Du; Songzi,9998,0,9999,1
1715649261377,ANAR 135S,A00,494369,Braswell; Geoffrey E.,0,0,0,0
1715649262402,BENG 196,001,628496,Engler; Adam J.,9998,0,9999,1
1715649262402,BENG 196,002,660916,Watson; John Thomas,9998,0,9999,1
1715649263429,BISP 197,001,650773,Wilhelm; James E.,9994,0,9999,5
1715649263429,BISP 197,002,658904,Coleman; Aaron B.,9998,0,9999,1
1715649264454,CAT 124RS,A01,519847,Geibel; William,0,0,20,20
1715649265478,CAT 125RS,A01,515971,Geibel; William,0,0,20,20
1715649266504,CLRE 250,A00,511389,Morris; Sheldon,9992,0,9999,7
1715649267535,CLRE 251,A00,507176,Mehta; Ravindra L.,9992,0,9999,7
1715649267535,CLRE 251,B00,511410,Mehta; Ravindra L.,9998,0,9999,1
1715649268561,CLRE 252,A00,507189,Cuomo; Raphael Eduardo,9994,0,9999,5
1715649269587,CLRE 253,A00,507199,Vaida; Florin,9994,0,9999,5
1715649269587,CLRE 253,B00,507202,Vaida; Florin,9999,0,9999,0
1715649270611,CLRE 259,A00,507211,Patel; Hemal,9996,0,9999,3
1715649271637,CLRE 260,A00,507221,Cuomo; Raphael Eduardo,9999,0,9999,0
1715649272665,CLRE 297,001,507242,Cuomo; Raphael Eduardo,9999,0,9999,0
1715649273691,COGS 197,001,638244,Voytek; Bradley Thomas,9997,0,9999,2
1715649274716,CSE 191,A00,516875,Minnes Kemp; Mor Mia,9991,0,9999,8
1715649275741,CSE 197,001,637388,Minnes Kemp; Mor Mia,9992,0,9999,7
1715649276769,CSS 201S,A01,494383,Mignozzetti; Umberto,35,0,35,0
1715649277799,CSS 202S,A01,494387,Mignozzetti; Umberto,35,0,35,0
1715649278828,DSC 197,001,628532,Eldridge; Justin Matthew,9995,0,9999,4
1715649279856,EAP 100,A00,516065,Staff,9799,0,9999,200
1715649280882,ECE 45,A01,507414,Staff,32,0,60,28
1715649282933,ECE 111,A01,507420,Staff,11,0,50,39
1715649283961,ECE 197,001,548057,Sievenpiper; Daniel F.,9991,0,9999,8
1715649285042,EDS 115,A00,507243,Choi; Bailey Miyeon,6,0,28,22
1715649286069,EDS 117,A01,494379,Staff,0,6,34,35
1715649287095,EDS 125,A00,507246,Hopkins; Megan Beth,7,0,30,23
1715649288125,EDS 128A,A01,507264,Fargason; Sharon Gayle,5,0,26,21
1715649289152,EDS 128B,A01,507293,Pappas; Elizabeth,9,0,30,21
1715649290179,EDS 139,A00,507294,Fargason; Sharon Gayle,9,0,30,21
1715649290179,EDS 139,B00,507313,Pappas; Elizabeth,9,0,30,21
1715649291203,EDS 201,A00,507315,Staff,10,0,30,20
1715649292227,EDS 203,A01,507317,Halter; Christopher P.,10,0,30,20
1715649293265,EDS 204R,A01,507319,Halter; Christopher P.,0,3,30,30
1715649293265,EDS 204R,B01,507331,Heinzman; Erica M.,14,0,30,16
1715649294293,EDS 206R,A00,507332,Staff,0,4,30,30
1715649294293,EDS 206R,B00,507343,Staff,15,0,30,15
1715649295320,EDS 250,A00,507344,Hemans; Patricia Ann Benitez,20,0,40,20
1715649296344,EDS 281,A00,507345,Daly; Alan J.,18,0,18,0
1715649297369,EDS 284,A00,507350,Daly; Alan J.,16,0,16,0
1715649298397,EDS 286,A00,507359,Fine; Sarah,18,0,18,0
1715649299421,EDS 289C,A01,507361,Daly; Alan J.,18,0,18,0
1715649300450,EDS 290,A00,507366,Hofstetter; Carolyn,15,0,15,0
1715649301477,LIGM 5A,A00,507421,Fischer-Grunski; Eva K,17,0,20,3
1715649302503,LIGM 5B,A00,507423,Fischer-Grunski; Eva K,19,0,20,1
1715649303528,LIGM 5C,A00,507425,Fischer-Grunski; Eva K,19,0,20,1
1715649304555,LIIT 5AS,A00,507427,Carnelos; Chiara,20,0,20,0
1715649305583,LIIT 5BS,A00,507430,Carnelos; Chiara,20,0,20,0
1715649306609,LIIT 5CS,A00,507432,Carnelos; Chiara,20,0,20,0
1715649307637,LISP 5A,A00,507541,Munoz Sanchez; Alicia,11,0,20,9
1715649308665,LISP 5B,A00,507671,Munoz Sanchez; Alicia,8,0,20,12
1715649309695,LISP 5C,A00,507696,Munoz Sanchez; Alicia,8,0,20,12
1715649310720,MAE 197,001,528363,Boechler; Nicholas Sebastia,9998,0,9999,1
1715649311749,MATH 197,001,523477,Kedlaya; Kiran S.,9994,0,9999,5
1715649311749,MATH 197,002,563811,Zhang; Danna,9994,0,9999,5
1715649311749,MATH 197,003,628552,Dumitriu; Ioana,9998,0,9999,1
1715649311749,MATH 197,004,660885,Floyd; Eric,9998,0,9999,1
1715649312774,MCWP 40R,A00,518780,Staff,1,0,20,19
1715649312774,MCWP 40R,B00,518781,Carter; Jennifer A,10,0,20,10
1715649312774,MCWP 40R,C00,518783,Smith; Haydee Marie,5,0,20,15
1715649313805,MCWP 50R,A00,518791,Redela; Pamela Morgan,0,1,20,20
1715649313805,MCWP 50R,B00,518792,Krone; Jarret,0,2,20,20
1715649313805,MCWP 50R,C00,518793,Staff,0,4,20,20
1715649313805,MCWP 50R,D00,518794,Morshed; Michael James,0,2,20,20
1715649313805,MCWP 50R,E00,518795,Carter; Andrea L,0,2,20,20
1715649313805,MCWP 50R,F00,518796,Miller; Elizabeth Deen,0,1,20,20
1715649313805,MCWP 50R,G00,518797,Guillen; Melinda,0,1,20,20
1715649314831,MMW 12R,A01,514034,Herbst; Matthew,0,2,16,16
1715649314831,MMW 12R,A02,514035,Herbst; Matthew,0,0,16,16
1715649315859,MMW 13R,A01,514037,Staff,0,5,16,16
1715649315859,MMW 13R,A02,514039,Staff,0,5,16,16
1715649315859,MMW 13R,A03,628519,Staff,0,4,16,16
1715649317910,SIO 295LS,A00,523233,Staff,10,0,30,20
1715649318940,SIO 295S,A00,523232,Staff,10,0,30,20
1715649319971,SIOC 290S,A01,637330,Merrifield; Mark A,21,0,30,9
1715649320996,SIOC 291S,A01,637333,Gabriel; Corey John,21,0,30,9
1715649322021,SOCI 117,A01,494376,Staff,0,5,5,5
1715649323047,WES 237B,A00,494380,Staff,10,0,20,10
1715649325126,AESE 279B,A00,494370,Wade; Jon P,0,0,33,33
1715649326151,AIP 97,001,660915,Van Den Einde; Yael Dahlia,9998,0,9999,1
1715649327184,AIP 197,001,627712,Vespa; Emanuel Ignacio,9995,0,9999,4
1715649327184,AIP 197,002,650778,Amir; On,9998,0,9999,1
1715649327184,AIP 197,003,650933,Avenancio-Leon; Carlos,9998,0,9999,1
1715649327184,AIP 197,004,658530,Heyman; Gail D.,9998,0,9999,1
1715649327184,AIP 197,005,658631,Neal; Sonya E,9998,0,9999,1
1715649327184,AIP 197,006,658671,Du; Songzi,9998,0,9999,1
1715649328209,ANAR 135S,A00,494369,Braswell; Geoffrey E.,0,0,0,0
1715649329237,BENG 196,001,628496,Engler; Adam J.,9998,0,9999,1
1715649329237,BENG 196,002,660916,Watson; John Thomas,9998,0,9999,1
1715649330262,BISP 197,001,650773,Wilhelm; James E.,9994,0,9999,5
1715649330262,BISP 197,002,658904,Coleman; Aaron B.,9998,0,9999,1
1715649331290,CAT 124RS,A01,519847,Geibel; William,0,0,20,20
1715649332313,CAT 125RS,A01,515971,Geibel; William,0,0,20,20
1715649333338,CLRE 250,A00,511389,Morris; Sheldon,9992,0,9999,7
1715649334396,CLRE 251,A00,507176,Mehta; Ravindra L.,9992,0,9999,7
1715649334396,CLRE 251,B00,511410,Mehta; Ravindra L.,9998,0,9999,1
1715649335425,CLRE 252,A00,507189,Cuomo; Raphael Eduardo,9994,0,9999,5
1715649336453,CLRE 253,A00,507199,Vaida; Florin,9994,0,9999,5
1715649336453,CLRE 253,B00,507202,Vaida; Florin,9999,0,9999,0
1715649337480,CLRE 259,A00,507211,Patel; Hemal,9996,0,9999,3
1715649338505,CLRE 260,A00,507221,Cuomo; Raphael Eduardo,9999,0,9999,0
1715649339531,CLRE 297,001,507242,Cuomo; Raphael Eduardo,9999,0,9999,0
1715649340555,COGS 197,001,638244,Voytek; Bradley Thomas,9997,0,9999,2
1715649341580,CSE 191,A00,516875,Minnes Kemp; Mor Mia,9991,0,9999,8
1715649342608,CSE 197,001,637388,Minnes Kemp; Mor Mia,9992,0,9999,7
1715649343781,CSS 201S,A01,494383,Mignozzetti; Umberto,35,0,35,0
1715649344811,CSS 202S,A01,494387,Mignozzetti; Umberto,35,0,35,0
1715649345838,DSC 197,001,628532,Eldridge; Justin Matthew,9995,0,9999,4
1715649346862,EAP 100,A00,516065,Staff,9799,0,9999,200
1715649347890,ECE 45,A01,507414,Staff,32,0,60,28
1715649349944,ECE 111,A01,507420,Staff,11,0,50,39
1715649350971,ECE 197,001,548057,Sievenpiper; Daniel F.,9991,0,9999,8
1715649351997,EDS 115,A00,507243,Choi; Bailey Miyeon,6,0,28,22
1715649353023,EDS 117,A01,494379,Staff,0,6,34,35
1715649354053,EDS 125,A00,507246,Hopkins; Megan Beth,7,0,30,23
1715649355080,EDS 128A,A01,507264,Fargason; Sharon Gayle,5,0,26,21
1715649356109,EDS 128B,A01,507293,Pappas; Elizabeth,9,0,30,21
1715649357136,EDS 139,A00,507294,Fargason; Sharon Gayle,9,0,30,21
1715649357136,EDS 139,B00,507313,Pappas; Elizabeth,9,0,30,21
1715649358165,EDS 201,A00,507315,Staff,10,0,30,20
1715649359194,EDS 203,A01,507317,Halter; Christopher P.,10,0,30,20
1715649360220,EDS 204R,A01,507319,Halter; Christopher P.,0,3,30,30
1715649360220,EDS 204R,B01,507331,Heinzman; Erica M.,14,0,30,16
1715649361247,EDS 206R,A00,507332,Staff,0,4,30,30
1715649361247,EDS 206R,B00,507343,Staff,15,0,30,15
1715649362271,EDS 250,A00,507344,Hemans; Patricia Ann Benitez,20,0,40,20
1715649363299,EDS 281,A00,507345,Daly; Alan J.,18,0,18,0
1715649364325,EDS 284,A00,507350,Daly; Alan J.,16,0,16,0
1715649365351,EDS 286,A00,507359,Fine; Sarah,18,0,18,0
1715649366376,EDS 289C,A01,507361,Daly; Alan J.,18,0,18,0
1715649367401,EDS 290,A00,507366,Hofstetter; Carolyn,15,0,15,0
1715649368429,LIGM 5A,A00,507421,Fischer-Grunski; Eva K,17,0,20,3
1715649369458,LIGM 5B,A00,507423,Fischer-Grunski; Eva K,19,0,20,1
1715649370485,LIGM 5C,A00,507425,Fischer-Grunski; Eva K,19,0,20,1
1715649371511,LIIT 5AS,A00,507427,Carnelos; Chiara,20,0,20,0
1715649372536,LIIT 5BS,A00,507430,Carnelos; Chiara,20,0,20,0
1715649373565,LIIT 5CS,A00,507432,Carnelos; Chiara,20,0,20,0
1715649374593,LISP 5A,A00,507541,Munoz Sanchez; Alicia,11,0,20,9
1715649375618,LISP 5B,A00,507671,Munoz Sanchez; Alicia,8,0,20,12
1715649376643,LISP 5C,A00,507696,Munoz Sanchez; Alicia,8,0,20,12
1715649377666,MAE 197,001,528363,Boechler; Nicholas Sebastia,9998,0,9999,1
1715649378693,MATH 197,001,523477,Kedlaya; Kiran S.,9994,0,9999,5
1715649378693,MATH 197,002,563811,Zhang; Danna,9994,0,9999,5
1715649378693,MATH 197,003,628552,Dumitriu; Ioana,9998,0,9999,1
1715649378693,MATH 197,004,660885,Floyd; Eric,9998,0,9999,1
1715649379721,MCWP 40R,A00,518780,Staff,1,0,20,19
1715649379721,MCWP 40R,B00,518781,Carter; Jennifer A,10,0,20,10
1715649379721,MCWP 40R,C00,518783,Smith; Haydee Marie,5,0,20,15
1715649380753,MCWP 50R,A00,518791,Redela; Pamela Morgan,0,1,20,20
1715649380753,MCWP 50R,B00,518792,Krone; Jarret,0,2,20,20
1715649380753,MCWP 50R,C00,518793,Staff,0,4,20,20
1715649380753,MCWP 50R,D00,518794,Morshed; Michael James,0,2,20,20
1715649380753,MCWP 50R,E00,518795,Carter; Andrea L,0,2,20,20
1715649380753,MCWP 50R,F00,518796,Miller; Elizabeth Deen,0,1,20,20
1715649380753,MCWP 50R,G00,518797,Guillen; Melinda,0,1,20,20
1715649381781,MMW 12R,A01,514034,Herbst; Matthew,0,2,16,16
1715649381781,MMW 12R,A02,514035,Herbst; Matthew,0,0,16,16
1715649382807,MMW 13R,A01,514037,Staff,0,5,16,16
1715649382807,MMW 13R,A02,514039,Staff,0,5,16,16
1715649382807,MMW 13R,A03,628519,Staff,0,4,16,16
1715649384858,SIO 295LS,A00,523233,Staff,10,0,30,20
1715649385884,SIO 295S,A00,523232,Staff,10,0,30,20
1715649386911,SIOC 290S,A01,637330,Merrifield; Mark A,21,0,30,9
1715649387937,SIOC 291S,A01,637333,Gabriel; Corey John,21,0,30,9
1715649388962,SOCI 117,A01,494376,Staff,0,5,5,5
1715649389986,WES 237B,A00,494380,Staff,10,0,20,10
1715649392055,AESE 279B,A00,494370,Wade; Jon P,0,0,33,33
1715649393081,AIP 97,001,660915,Van Den Einde; Yael Dahlia,9998,0,9999,1
1715649394112,AIP 197,001,627712,Vespa; Emanuel Ignacio,9995,0,9999,4
1715649394112,AIP 197,002,650778,Amir; On,9998,0,9999,1
1715649394112,AIP 197,003,650933,Avenancio-Leon; Carlos,9998,0,9999,1
1715649394112,AIP 197,004,658530,Heyman; Gail D.,9998,0,9999,1
1715649394112,AIP 197,005,658631,Neal; Sonya E,9998,0,9999,1
1715649394112,AIP 197,006,658671,Du; Songzi,9998,0,9999,1
1715649395140,ANAR 135S,A00,494369,Braswell; Geoffrey E.,0,0,0,0
1715649396167,BENG 196,001,628496,Engler; Adam J.,9998,0,9999,1
1715649396167,BENG 196,002,660916,Watson; John Thomas,9998,0,9999,1
1715649397195,BISP 197,001,650773,Wilhelm; James E.,9994,0,9999,5
1715649397195,BISP 197,002,658904,Coleman; Aaron B.,9998,0,9999,1
1715649398223,CAT 124RS,A01,519847,Geibel; William,0,0,20,20
1715649399247,CAT 125RS,A01,515971,Geibel; William,0,0,20,20
1715649400273,CLRE 250,A00,511389,Morris; Sheldon,9992,0,9999,7
1715649401300,CLRE 251,A00,507176,Mehta; Ravindra L.,9992,0,9999,7
1715649401300,CLRE 251,B00,511410,Mehta; Ravindra L.,9998,0,9999,1
1715649402330,CLRE 252,A00,507189,Cuomo; Raphael Eduardo,9994,0,9999,5
1715649403355,CLRE 253,A00,507199,Vaida; Florin,9994,0,9999,5
1715649403355,CLRE 253,B00,507202,Vaida; Florin,9999,0,9999,0
1715649404382,CLRE 259,A00,507211,Patel; Hemal,9996,0,9999,3
1715649405409,CLRE 260,A00,507221,Cuomo; Raphael Eduardo,9999,0,9999,0
1715649406442,CLRE 297,001,507242,Cuomo; Raphael Eduardo,9999,0,9999,0
1715649407467,COGS 197,001,638244,Voytek; Bradley Thomas,9997,0,9999,2
1715649408494,CSE 191,A00,516875,Minnes Kemp; Mor Mia,9991,0,9999,8
1715649409521,CSE 197,001,637388,Minnes Kemp; Mor Mia,9992,0,9999,7
1715649410554,CSS 201S,A01,494383,Mignozzetti; Umberto,35,0,35,0
1715649411579,CSS 202S,A01,494387,Mignozzetti; Umberto,35,0,35,0
1715649412605,DSC 197,001,628532,Eldridge; Justin Matthew,9995,0,9999,4
1715649413632,EAP 100,A00,516065,Staff,9799,0,9999,200
1715649414660,ECE 45,A01,507414,Staff,32,0,60,28
1715649416713,ECE 111,A01,507420,Staff,11,0,50,39
1715649417741,ECE 197,001,548057,Sievenpiper; Daniel F.,9991,0,9999,8
1715649418768,EDS 115,A00,507243,Choi; Bailey Miyeon,6,0,28,22
1715649419794,EDS 117,A01,494379,Staff,0,6,34,35
1715649420819,EDS 125,A00,507246,Hopkins; Megan Beth,7,0,30,23
1715649421845,EDS 128A,A01,507264,Fargason; Sharon Gayle,5,0,26,21
1715649422874,EDS 128B,A01,507293,Pappas; Elizabeth,9,0,30,21
1715649423901,EDS 139,A00,507294,Fargason; Sharon Gayle,9,0,30,21
1715649423901,EDS 139,B00,507313,Pappas; Elizabeth,9,0,30,21
1715649424925,EDS 201,A00,507315,Staff,10,0,30,20
1715649425954,EDS 203,A01,507317,Halter; Christopher P.,10,0,30,20
1715649426984,EDS 204R,A01,507319,Halter; Christopher P.,0,3,30,30
1715649426984,EDS 204R,B01,507331,Heinzman; Erica M.,14,0,30,16
1715649428011,EDS 206R,A00,507332,Staff,0,4,30,30
1715649428011,EDS 206R,B00,507343,Staff,15,0,30,15
1715649429037,EDS 250,A00,507344,Hemans; Patricia Ann Benitez,20,0,40,20
1715649430063,EDS 281,A00,507345,Daly; Alan J.,18,0,18,0
1715649431091,EDS 284,A00,507350,Daly; Alan J.,16,0,16,0
1715649432118,EDS 286,A00,507359,Fine; Sarah,18,0,18,0
1715649433145,EDS 289C,A01,507361,Daly; Alan J.,18,0,18,0
1715649434171,EDS 290,A00,507366,Hofstetter; Carolyn,15,0,15,0
1715649435203,LIGM 5A,A00,507421,Fischer-Grunski; Eva K,17,0,20,3
1715649436232,LIGM 5B,A00,507423,Fischer-Grunski; Eva K,19,0,20,1
1715649437257,LIGM 5C,A00,507425,Fischer-Grunski; Eva K,19,0,20,1
1715649438286,LIIT 5AS,A00,507427,Carnelos; Chiara,20,0,20,0
1715649439310,LIIT 5BS,A00,507430,Carnelos; Chiara,20,0,20,0
1715649440335,LIIT 5CS,A00,507432,Carnelos; Chiara,20,0,20,0
1715649441360,LISP 5A,A00,507541,Munoz Sanchez; Alicia,11,0,20,9
1715649442387,LISP 5B,A00,507671,Munoz Sanchez; Alicia,8,0,20,12
1715649443416,LISP 5C,A00,507696,Munoz Sanchez; Alicia,8,0,20,12
1715649444447,MAE 197,001,528363,Boechler; Nicholas Sebastia,9998,0,9999,1
1715649445476,MATH 197,001,523477,Kedlaya; Kiran S.,9994,0,9999,5
1715649445476,MATH 197,002,563811,Zhang; Danna,9994,0,9999,5
1715649445476,MATH 197,003,628552,Dumitriu; Ioana,9998,0,9999,1
1715649445476,MATH 197,004,660885,Floyd; Eric,9998,0,9999,1
1715649446561,MCWP 40R,A00,518780,Staff,1,0,20,19
1715649446561,MCWP 40R,B00,518781,Carter; Jennifer A,10,0,20,10
1715649446561,MCWP 40R,C00,518783,Smith; Haydee Marie,5,0,20,15
1715649447593,MCWP 50R,A00,518791,Redela; Pamela Morgan,0,1,20,20
1715649447593,MCWP 50R,B00,518792,Krone; Jarret,0,2,20,20
1715649447593,MCWP 50R,C00,518793,Staff,0,4,20,20
1715649447593,MCWP 50R,D00,518794,Morshed; Michael James,0,2,20,20
1715649447593,MCWP 50R,E00,518795,Carter; Andrea L,0,2,20,20
1715649447593,MCWP 50R,F00,518796,Miller; Elizabeth Deen,0,1,20,20
1715649447593,MCWP 50R,G00,518797,Guillen; Melinda,0,1,20,20
1715649448619,MMW 12R,A01,514034,Herbst; Matthew,0,2,16,16
1715649448619,MMW 12R,A02,514035,Herbst; Matthew,0,0,16,16
1715649449647,MMW 13R,A01,514037,Staff,0,5,16,16
1715649449647,MMW 13R,A02,514039,Staff,0,5,16,16
1715649449647,MMW 13R,A03,628519,Staff,0,4,16,16
1715649451700,SIO 295LS,A00,523233,Staff,10,0,30,20
1715649452725,SIO 295S,A00,523232,Staff,10,0,30,20
1715649453749,SIOC 290S,A01,637330,Merrifield; Mark A,21,0,30,9
1715649454777,SIOC 291S,A01,637333,Gabriel; Corey John,21,0,30,9
1715649455805,SOCI 117,A01,494376,Staff,0,5,5,5
1715649456829,WES 237B,A00,494380,Staff,10,0,20,10
1715649458901,AESE 279B,A00,494370,Wade; Jon P,0,0,33,33
1715649459925,AIP 97,001,660915,Van Den Einde; Yael Dahlia,9998,0,9999,1
1715649460952,AIP 197,001,627712,Vespa; Emanuel Ignacio,9995,0,9999,4
1715649460952,AIP 197,002,650778,Amir; On,9998,0,9999,1
1715649460952,AIP 197,003,650933,Avenancio-Leon; Carlos,9998,0,9999,1
1715649460952,AIP 197,004,658530,Heyman; Gail D.,9998,0,9999,1
1715649460952,AIP 197,005,658631,Neal; Sonya E,9998,0,9999,1
1715649460952,AIP 197,006,658671,Du; Songzi,9998,0,9999,1
1715649461979,ANAR 135S,A00,494369,Braswell; Geoffrey E.,0,0,0,0
1715649463005,BENG 196,001,628496,Engler; Adam J.,9998,0,9999,1
1715649463005,BENG 196,002,660916,Watson; John Thomas,9998,0,9999,1
1715649464030,BISP 197,001,650773,Wilhelm; James E.,9994,0,9999,5
1715649464030,BISP 197,002,658904,Coleman; Aaron B.,9998,0,9999,1
1715649465054,CAT 124RS,A01,519847,Geibel; William,0,0,20,20
1715649466079,CAT 125RS,A01,515971,Geibel; William,0,0,20,20
1715649467107,CLRE 250,A00,511389,Morris; Sheldon,9992,0,9999,7
1715649468135,CLRE 251,A00,507176,Mehta; Ravindra L.,9992,0,9999,7
1715649468135,CLRE 251,B00,511410,Mehta; Ravindra L.,9998,0,9999,1
1715649469163,CLRE 252,A00,507189,Cuomo; Raphael Eduardo,9994,0,9999,5
1715649470189,CLRE 253,A00,507199,Vaida; Florin,9994,0,9999,5
1715649470189,CLRE 253,B00,507202,Vaida; Florin,9999,0,9999,0
1715649471218,CLRE 259,A00,507211,Patel; Hemal,9996,0,9999,3
1715649472243,CLRE 260,A00,507221,Cuomo; Raphael Eduardo,9999,0,9999,0
1715649473268,CLRE 297,001,507242,Cuomo; Raphael Eduardo,9999,0,9999,0
1715649474293,COGS 197,001,638244,Voytek; Bradley Thomas,9997,0,9999,2
1715649475322,CSE 191,A00,516875,Minnes Kemp; Mor Mia,9991,0,9999,8
1715649476347,CSE 197,001,637388,Minnes Kemp; Mor Mia,9992,0,9999,7
1715649477373,CSS 201S,A01,494383,Mignozzetti; Umberto,35,0,35,0
1715649478398,CSS 202S,A01,494387,Mignozzetti; Umberto,35,0,35,0
1715649479424,DSC 197,001,628532,Eldridge; Justin Matthew,9995,0,9999,4
1715649480448,EAP 100,A00,516065,Staff,9799,0,9999,200
1715649481474,ECE 45,A01,507414,Staff,32,0,60,28
1715649483528,ECE 111,A01,507420,Staff,11,0,50,39
1715649484556,ECE 197,001,548057,Sievenpiper; Daniel F.,9991,0,9999,8
1715649485582,EDS 115,A00,507243,Choi; Bailey Miyeon,6,0,28,22
1715649486608,EDS 117,A01,494379,Staff,0,6,34,35
1715649487633,EDS 125,A00,507246,Hopkins; Megan Beth,7,0,30,23
1715649488661,EDS 128A,A01,507264,Fargason; Sharon Gayle,5,0,26,21
1715649489688,EDS 128B,A01,507293,Pappas; Elizabeth,9,0,30,21
1715649490712,EDS 139,A00,507294,Fargason; Sharon Gayle,9,0,30,21
1715649490712,EDS 139,B00,507313,Pappas; Elizabeth,9,0,30,21
1715649491737,EDS 201,A00,507315,Staff,10,0,30,20
1715649492763,EDS 203,A01,507317,Halter; Christopher P.,10,0,30,20
1715649493788,EDS 204R,A01,507319,Halter; Christopher P.,0,3,30,30
1715649493788,EDS 204R,B01,507331,Heinzman; Erica M.,14,0,30,16
1715649494813,EDS 206R,A00,507332,Staff,0,4,30,30
1715649494813,EDS 206R,B00,507343,Staff,15,0,30,15
1715649495838,EDS 250,A00,507344,Hemans; Patricia Ann Benitez,20,0,40,20
1715649496863,EDS 281,A00,507345,Daly; Alan J.,18,0,18,0
1715649497887,EDS 284,A00,507350,Daly; Alan J.,16,0,16,0
1715649498912,EDS 286,A00,507359,Fine; Sarah,18,0,18,0
1715649499939,EDS 289C,A01,507361,Daly; Alan J.,18,0,18,0
1715649500964,EDS 290,A00,507366,Hofstetter; Carolyn,15,0,15,0
1715649501993,LIGM 5A,A00,507421,Fischer-Grunski; Eva K,17,0,20,3
1715649503019,LIGM 5B,A00,507423,Fischer-Grunski; Eva K,19,0,20,1
1715649504048,LIGM 5C,A00,507425,Fischer-Grunski; Eva K,19,0,20,1
1715649505077,LIIT 5AS,A00,507427,Carnelos; Chiara,20,0,20,0
1715649506102,LIIT 5BS,A00,507430,Carnelos; Chiara,20,0,20,0
1715649507130,LIIT 5CS,A00,507432,Carnelos; Chiara,20,0,20,0
1715649508155,LISP 5A,A00,507541,Munoz Sanchez; Alicia,11,0,20,9
1715649509181,LISP 5B,A00,507671,Munoz Sanchez; Alicia,8,0,20,12
1715649510209,LISP 5C,A00,507696,Munoz Sanchez; Alicia,8,0,20,12
1715649511233,MAE 197,001,528363,Boechler; Nicholas Sebastia,9998,0,9999,1
1715649512261,MATH 197,001,523477,Kedlaya; Kiran S.,9994,0,9999,5
1715649512261,MATH 197,002,563811,Zhang; Danna,9994,0,9999,5
1715649512261,MATH 197,003,628552,Dumitriu; Ioana,9998,0,9999,1
1715649512261,MATH 197,004,660885,Floyd; Eric,9998,0,9999,1
1715649513292,MCWP 40R,A00,518780,Staff,1,0,20,19
1715649513292,MCWP 40R,B00,518781,Carter; Jennifer A,10,0,20,10
1715649513292,MCWP 40R,C00,518783,Smith; Haydee Marie,5,0,20,15
1715649514320,MCWP 50R,A00,518791,Redela; Pamela Morgan,0,1,20,20
1715649514320,MCWP 50R,B00,518792,Krone; Jarret,0,2,20,20
1715649514320,MCWP 50R,C00,518793,Staff,0,4,20,20
1715649514320,MCWP 50R,D00,518794,Morshed; Michael James,0,2,20,20
1715649514320,MCWP 50R,E00,518795,Carter; Andrea L,0,2,20,20
1715649514320,MCWP 50R,F00,518796,Miller; Elizabeth Deen,0,1,20,20
1715649514320,MCWP 50R,G00,518797,Guillen; Melinda,0,1,20,20
1715649515350,MMW 12R,A01,514034,Herbst; Matthew,0,2,16,16
1715649515350,MMW 12R,A02,514035,Herbst; Matthew,0,0,16,16
1715649516378,MMW 13R,A01,514037,Staff,0,5,16,16
1715649516378,MMW 13R,A02,514039,Staff,0,5,16,16
1715649516378,MMW 13R,A03,628519,Staff,0,4,16,16
1715649518430,SIO 295LS,A00,523233,Staff,10,0,30,20
1715649519455,SIO 295S,A00,523232,Staff,10,0,30,20
1715649520482,SIOC 290S,A01,637330,Merrifield; Mark A,21,0,30,9
1715649521509,SIOC 291S,A01,637333,Gabriel; Corey John,21,0,30,9
1715649522540,SOCI 117,A01,494376,Staff,0,5,5,5
1715649523565,WES 237B,A00,494380,Staff,10,0,20,10
1715649525659,AESE 279B,A00,494370,Wade; Jon P,0,0,33,33
1715649526688,AIP 97,001,660915,Van Den Einde; Yael Dahlia,9998,0,9999,1
1715649527717,AIP 197,001,627712,Vespa; Emanuel Ignacio,9995,0,9999,4
1715649527717,AIP 197,002,650778,Amir; On,9998,0,9999,1
1715649527717,AIP 197,003,650933,Avenancio-Leon; Carlos,9998,0,9999,1
1715649527717,AIP 197,004,658530,Heyman; Gail D.,9998,0,9999,1
1715649527717,AIP 197,005,658631,Neal; Sonya E,9998,0,9999,1
1715649527717,AIP 197,006,658671,Du; Songzi,9998,0,9999,1
1715649528742,ANAR 135S,A00,494369,Braswell; Geoffrey E.,0,0,0,0
1715649529767,BENG 196,001,628496,Engler; Adam J.,9998,0,9999,1
1715649529767,BENG 196,002,660916,Watson; John Thomas,9998,0,9999,1
1715649530796,BISP 197,001,650773,Wilhelm; James E.,9994,0,9999,5
1715649530796,BISP 197,002,658904,Coleman; Aaron B.,9998,0,9999,1
1715649531822,CAT 124RS,A01,519847,Geibel; William,0,0,20,20
1715649532850,CAT 125RS,A01,515971,Geibel; William,0,0,20,20
1715649533881,CLRE 250,A00,511389,Morris; Sheldon,9992,0,9999,7
1715649534908,CLRE 251,A00,507176,Mehta; Ravindra L.,9992,0,9999,7
1715649534908,CLRE 251,B00,511410,Mehta; Ravindra L.,9998,0,9999,1
1715649535932,CLRE 252,A00,507189,Cuomo; Raphael Eduardo,9994,0,9999,5
1715649536957,CLRE 253,A00,507199,Vaida; Florin,9994,0,9999,5
1715649536957,CLRE 253,B00,507202,Vaida; Florin,9999,0,9999,0
1715649537984,CLRE 259,A00,507211,Patel; Hemal,9996,0,9999,3
1715649539009,CLRE 260,A00,507221,Cuomo; Raphael Eduardo,9999,0,9999,0
1715649540040,CLRE 297,001,507242,Cuomo; Raphael Eduardo,9999,0,9999,0
1715649541067,COGS 197,001,638244,Voytek; Bradley Thomas,9997,0,9999,2
1715649542097,CSE 191,A00,516875,Minnes Kemp; Mor Mia,9991,0,9999,8
1715649543122,CSE 197,001,637388,Minnes Kemp; Mor Mia,9992,0,9999,7
1715649544154,CSS 201S,A01,494383,Mignozzetti; Umberto,35,0,35,0
1715649545179,CSS 202S,A01,494387,Mignozzetti; Umberto,35,0,35,0
1715649546205,DSC 197,001,628532,Eldridge; Justin Matthew,9995,0,9999,4
1715649547234,EAP 100,A00,516065,Staff,9799,0,9999,200
1715649548261,ECE 45,A01,507414,Staff,32,0,60,28
1715649550372,ECE 111,A01,507420,Staff,11,0,50,39
1715649551399,ECE 197,001,548057,Sievenpiper; Daniel F.,9991,0,9999,8
1715649552426,EDS 115,A00,507243,Choi; Bailey Miyeon,6,0,28,22
1715649553451,EDS 117,A01,494379,Staff,0,6,34,35
1715649554481,EDS 125,A00,507246,Hopkins; Megan Beth,7,0,30,23
1715649555506,EDS 128A,A01,507264,Fargason; Sharon Gayle,5,0,26,21
1715649556534,EDS 128B,A01,507293,Pappas; Elizabeth,9,0,30,21
1715649557559,EDS 139,A00,507294,Fargason; Sharon Gayle,9,0,30,21
1715649557559,EDS 139,B00,507313,Pappas; Elizabeth,9,0,30,21
1715649558583,EDS 201,A00,507315,Staff,10,0,30,20
1715649559609,EDS 203,A01,507317,Halter; Christopher P.,10,0,30,20
1715649560637,EDS 204R,A01,507319,Halter; Christopher P.,0,3,30,30
1715649560637,EDS 204R,B01,507331,Heinzman; Erica M.,14,0,30,16
1715649561664,EDS 206R,A00,507332,Staff,0,4,30,30
1715649561664,EDS 206R,B00,507343,Staff,15,0,30,15
1715649562688,EDS 250,A00,507344,Hemans; Patricia Ann Benitez,20,0,40,20
1715649563716,EDS 281,A00,507345,Daly; Alan J.,18,0,18,0
1715649564740,EDS 284,A00,507350,Daly; Alan J.,16,0,16,0
1715649565767,EDS 286,A00,507359,Fine; Sarah,18,0,18,0
1715649566792,EDS 289C,A01,507361,Daly; Alan J.,18,0,18,0
1715649567817,EDS 290,A00,507366,Hofstetter; Carolyn,15,0,15,0
1715649568843,LIGM 5A,A00,507421,Fischer-Grunski; Eva K,17,0,20,3
1715649569874,LIGM 5B,A00,507423,Fischer-Grunski; Eva K,19,0,20,1
1715649570900,LIGM 5C,A00,507425,Fischer-Grunski; Eva K,19,0,20,1
1715649571931,LIIT 5AS,A00,507427,Carnelos; Chiara,20,0,20,0
1715649572955,LIIT 5BS,A00,507430,Carnelos; Chiara,20,0,20,0
1715649573982,LIIT 5CS,A00,507432,Carnelos; Chiara,20,0,20,0
1715649575009,LISP 5A,A00,507541,Munoz Sanchez; Alicia,11,0,20,9
1715649576034,LISP 5B,A00,507671,Munoz Sanchez; Alicia,8,0,20,12
1715649577063,LISP 5C,A00,507696,Munoz Sanchez; Alicia,8,0,20,12
1715649578092,MAE 197,001,528363,Boechler; Nicholas Sebastia,9998,0,9999,1
1715649579120,MATH 197,001,523477,Kedlaya; Kiran S.,9994,0,9999,5
1715649579120,MATH 197,002,563811,Zhang; Danna,9994,0,9999,5
1715649579120,MATH 197,003,628552,Dumitriu; Ioana,9998,0,9999,1
1715649579120,MATH 197,004,660885,Floyd; Eric,9998,0,9999,1
1715649580149,MCWP 40R,A00,518780,Staff,1,0,20,19
1715649580149,MCWP 40R,B00,518781,Carter; Jennifer A,10,0,20,10
1715649580149,MCWP 40R,C00,518783,Smith; Haydee Marie,5,0,20,15
1715649581182,MCWP 50R,A00,518791,Redela; Pamela Morgan,0,1,20,20
1715649581182,MCWP 50R,B00,518792,Krone; Jarret,0,2,20,20
1715649581182,MCWP 50R,C00,518793,Staff,0,4,20,20
1715649581182,MCWP 50R,D00,518794,Morshed; Michael James,0,2,20,20
1715649581182,MCWP 50R,E00,518795,Carter; Andrea L,0,2,20,20
1715649581182,MCWP 50R,F00,518796,Miller; Elizabeth Deen,0,1,20,20
1715649581182,MCWP 50R,G00,518797,Guillen; Melinda,0,1,20,20
1715649582211,MMW 12R,A01,514034,Herbst; Matthew,0,2,16,16
1715649582211,MMW 12R,A02,514035,Herbst; Matthew,0,0,16,16
1715649583238,MMW 13R,A01,514037,Staff,0,5,16,16
1715649583238,MMW 13R,A02,514039,Staff,0,5,16,16
1715649583238,MMW 13R,A03,628519,Staff,0,4,16,16
1715649585292,SIO 295LS,A00,523233,Staff,10,0,30,20
1715649586317,SIO 295S,A00,523232,Staff,10,0,30,20
1715649587343,SIOC 290S,A01,637330,Merrifield; Mark A,21,0,30,9
1715649588373,SIOC 291S,A01,637333,Gabriel; Corey John,21,0,30,9
1715649589398,SOCI 117,A01,494376,Staff,0,5,5,5
1715649590421,WES 237B,A00,494380,Staff,10,0,20,10
1715649592497,AESE 279B,A00,494370,Wade; Jon P,0,0,33,33
1715649593522,AIP 97,001,660915,Van Den Einde; Yael Dahlia,9998,0,9999,1
1715649594550,AIP 197,001,627712,Vespa; Emanuel Ignacio,9995,0,9999,4
1715649594550,AIP 197,002,650778,Amir; On,9998,0,9999,1
1715649594550,AIP 197,003,650933,Avenancio-Leon; Carlos,9998,0,9999,1
1715649594550,AIP 197,004,658530,Heyman; Gail D.,9998,0,9999,1
1715649594550,AIP 197,005,658631,Neal; Sonya E,9998,0,9999,1
1715649594550,AIP 197,006,658671,Du; Songzi,9998,0,9999,1
1715649595577,ANAR 135S,A00,494369,Braswell; Geoffrey E.,0,0,0,0
1715649596605,BENG 196,001,628496,Engler; Adam J.,9998,0,9999,1
1715649596605,BENG 196,002,660916,Watson; John Thomas,9998,0,9999,1
1715649597633,BISP 197,001,650773,Wilhelm; James E.,9994,0,9999,5
1715649597633,BISP 197,002,658904,Coleman; Aaron B.,9998,0,9999,1
1715649598658,CAT 124RS,A01,519847,Geibel; William,0,0,20,20
1715649599685,CAT 125RS,A01,515971,Geibel; William,0,0,20,20
1715649600709,CLRE 250,A00,511389,Morris; Sheldon,9992,0,9999,7
1715649601737,CLRE 251,A00,507176,Mehta; Ravindra L.,9992,0,9999,7
1715649601737,CLRE 251,B00,511410,Mehta; Ravindra L.,9998,0,9999,1
1715649602769,CLRE 252,A00,507189,Cuomo; Raphael Eduardo,9994,0,9999,5
1715649603809,CLRE 253,A00,507199,Vaida; Florin,9994,0,9999,5
1715649603809,CLRE 253,B00,507202,Vaida; Florin,9999,0,9999,0
1715649604836,CLRE 259,A00,507211,Patel; Hemal,9996,0,9999,3
1715649605861,CLRE 260,A00,507221,Cuomo; Raphael Eduardo,9999,0,9999,0
1715649606885,CLRE 297,001,507242,Cuomo; Raphael Eduardo,9999,0,9999,0
1715649607911,COGS 197,001,638244,Voytek; Bradley Thomas,9997,0,9999,2
1715649608936,CSE 191,A00,516875,Minnes Kemp; Mor Mia,9991,0,9999,8
1715649609961,CSE 197,001,637388,Minnes Kemp; Mor Mia,9992,0,9999,7
1715649610988,CSS 201S,A01,494383,Mignozzetti; Umberto,35,0,35,0
1715649612018,CSS 202S,A01,494387,Mignozzetti; Umberto,35,0,35,0
1715649613046,DSC 197,001,628532,Eldridge; Justin Matthew,9995,0,9999,4
1715649614070,EAP 100,A00,516065,Staff,9799,0,9999,200
1715649615098,ECE 45,A01,507414,Staff,32,0,60,28
1715649617148,ECE 111,A01,507420,Staff,11,0,50,39
1715649618175,ECE 197,001,548057,Sievenpiper; Daniel F.,9991,0,9999,8
1715649619205,EDS 115,A00,507243,Choi; Bailey Miyeon,6,0,28,22
1715649620231,EDS 117,A01,494379,Staff,0,6,34,35
1715649621256,EDS 125,A00,507246,Hopkins; Megan Beth,7,0,30,23
1715649622285,EDS 128A,A01,507264,Fargason; Sharon Gayle,5,0,26,21
1715649623310,EDS 128B,A01,507293,Pappas; Elizabeth,9,0,30,21
1715649624335,EDS 139,A00,507294,Fargason; Sharon Gayle,9,0,30,21
1715649624335,EDS 139,B00,507313,Pappas; Elizabeth,9,0,30,21
1715649625363,EDS 201,A00,507315,Staff,10,0,30,20
1715649626391,EDS 203,A01,507317,Halter; Christopher P.,10,0,30,20
1715649627419,EDS 204R,A01,507319,Halter; Christopher P.,0,3,30,30
1715649627419,EDS 204R,B01,507331,Heinzman; Erica M.,14,0,30,16
1715649628444,EDS 206R,A00,507332,Staff,0,4,30,30
1715649628444,EDS 206R,B00,507343,Staff,15,0,30,15
1715649629471,EDS 250,A00,507344,Hemans; Patricia Ann Benitez,20,0,40,20
1715649630503,EDS 281,A00,507345,Daly; Alan J.,18,0,18,0
1715649631532,EDS 284,A00,507350,Daly; Alan J.,16,0,16,0
1715649632558,EDS 286,A00,507359,Fine; Sarah,18,0,18,0
1715649633582,EDS 289C,A01,507361,Daly; Alan J.,18,0,18,0
1715649634608,EDS 290,A00,507366,Hofstetter; Carolyn,15,0,15,0
1715649635640,LIGM 5A,A00,507421,Fischer-Grunski; Eva K,17,0,20,3
1715649636667,LIGM 5B,A00,507423,Fischer-Grunski; Eva K,19,0,20,1
1715649637690,LIGM 5C,A00,507425,Fischer-Grunski; Eva K,19,0,20,1
1715649638717,LIIT 5AS,A00,507427,Carnelos; Chiara,20,0,20,0
1715649639743,LIIT 5BS,A00,507430,Carnelos; Chiara,20,0,20,0
1715649640771,LIIT 5CS,A00,507432,Carnelos; Chiara,20,0,20,0
1715649641898,LISP 5A,A00,507541,Munoz Sanchez; Alicia,11,0,20,9
1715649642924,LISP 5B,A00,507671,Munoz Sanchez; Alicia,8,0,20,12
1715649643949,LISP 5C,A00,507696,Munoz Sanchez; Alicia,8,0,20,12
1715649644977,MAE 197,001,528363,Boechler; Nicholas Sebastia,9998,0,9999,1
1715649646009,MATH 197,001,523477,Kedlaya; Kiran S.,9994,0,9999,5
1715649646009,MATH 197,002,563811,Zhang; Danna,9994,0,9999,5
1715649646009,MATH 197,003,628552,Dumitriu; Ioana,9998,0,9999,1
1715649646009,MATH 197,004,660885,Floyd; Eric,9998,0,9999,1
1715649647035,MCWP 40R,A00,518780,Staff,1,0,20,19
1715649647035,MCWP 40R,B00,518781,Carter; Jennifer A,10,0,20,10
1715649647035,MCWP 40R,C00,518783,Smith; Haydee Marie,5,0,20,15
1715649648061,MCWP 50R,A00,518791,Redela; Pamela Morgan,0,1,20,20
1715649648061,MCWP 50R,B00,518792,Krone; Jarret,0,2,20,20
1715649648061,MCWP 50R,C00,518793,Staff,0,4,20,20
1715649648061,MCWP 50R,D00,518794,Morshed; Michael James,0,2,20,20
1715649648061,MCWP 50R,E00,518795,Carter; Andrea L,0,2,20,20
1715649648061,MCWP 50R,F00,518796,Miller; Elizabeth Deen,0,1,20,20
1715649648061,MCWP 50R,G00,518797,Guillen; Melinda,0,1,20,20
1715649649088,MMW 12R,A01,514034,Herbst; Matthew,0,2,16,16
1715649649088,MMW 12R,A02,514035,Herbst; Matthew,0,0,16,16
1715649650115,MMW 13R,A01,514037,Staff,0,5,16,16
1715649650115,MMW 13R,A02,514039,Staff,0,5,16,16
1715649650115,MMW 13R,A03,628519,Staff,0,4,16,16
1715649652167,SIO 295LS,A00,523233,Staff,10,0,30,20
1715649653193,SIO 295S,A00,523232,Staff,10,0,30,20
1715649654220,SIOC 290S,A01,637330,Merrifield; Mark A,21,0,30,9
1715649655250,SIOC 291S,A01,637333,Gabriel; Corey John,21,0,30,9
1715649656281,SOCI 117,A01,494376,Staff,0,5,5,5
1715649657311,WES 237B,A00,494380,Staff,10,0,20,10
1715649659379,AESE 279B,A00,494370,Wade; Jon P,0,0,33,33
1715649660407,AIP 97,001,660915,Van Den Einde; Yael Dahlia,9998,0,9999,1
1715649661437,AIP 197,001,627712,Vespa; Emanuel Ignacio,9995,0,9999,4
1715649661437,AIP 197,002,650778,Amir; On,9998,0,9999,1
1715649661437,AIP 197,003,650933,Avenancio-Leon; Carlos,9998,0,9999,1
1715649661437,AIP 197,004,658530,Heyman; Gail D.,9998,0,9999,1
1715649661437,AIP 197,005,658631,Neal; Sonya E,9998,0,9999,1
1715649661437,AIP 197,006,658671,Du; Songzi,9998,0,9999,1
1715649662465,ANAR 135S,A00,494369,Braswell; Geoffrey E.,0,0,0,0
1715649663494,BENG 196,001,628496,Engler; Adam J.,9998,0,9999,1
1715649663494,BENG 196,002,660916,Watson; John Thomas,9998,0,9999,1
1715649664520,BISP 197,001,650773,Wilhelm; James E.,9994,0,9999,5
1715649664520,BISP 197,002,658904,Coleman; Aaron B.,9998,0,9999,1
1715649665546,CAT 124RS,A01,519847,Geibel; William,0,0,20,20
1715649666571,CAT 125RS,A01,515971,Geibel; William,0,0,20,20
1715649667597,CLRE 250,A00,511389,Morris; Sheldon,9992,0,9999,7
1715649668624,CLRE 251,A00,507176,Mehta; Ravindra L.,9992,0,9999,7
1715649668624,CLRE 251,B00,511410,Mehta; Ravindra L.,9998,0,9999,1
1715649669651,CLRE 252,A00,507189,Cuomo; Raphael Eduardo,9994,0,9999,5
1715649670681,CLRE 253,A00,507199,Vaida; Florin,9994,0,9999,5
1715649670681,CLRE 253,B00,507202,Vaida; Florin,9999,0,9999,0
1715649671709,CLRE 259,A00,507211,Patel; Hemal,9996,0,9999,3
1715649672736,CLRE 260,A00,507221,Cuomo; Raphael Eduardo,9999,0,9999,0
1715649673762,CLRE 297,001,507242,Cuomo; Raphael Eduardo,9999,0,9999,0
1715649674787,COGS 197,001,638244,Voytek; Bradley Thomas,9997,0,9999,2
1715649675812,CSE 191,A00,516875,Minnes Kemp; Mor Mia,9991,0,9999,8
1715649676837,CSE 197,001,637388,Minnes Kemp; Mor Mia,9992,0,9999,7
1715649677866,CSS 201S,A01,494383,Mignozzetti; Umberto,35,0,35,0
1715649678891,CSS 202S,A01,494387,Mignozzetti; Umberto,35,0,35,0
1715649679918,DSC 197,001,628532,Eldridge; Justin Matthew,9995,0,9999,4
1715649680941,EAP 100,A00,516065,Staff,9799,0,9999,200
1715649681972,ECE 45,A01,507414,Staff,32,0,60,28
1715649684021,ECE 111,A01,507420,Staff,11,0,50,39
1715649685050,ECE 197,001,548057,Sievenpiper; Daniel F.,9991,0,9999,8
1715649686076,EDS 115,A00,507243,Choi; Bailey Miyeon,6,0,28,22
1715649687101,EDS 117,A01,494379,Staff,0,6,34,35
1715649688129,EDS 125,A00,507246,Hopkins; Megan Beth,7,0,30,23
1715649689157,EDS 128A,A01,507264,Fargason; Sharon Gayle,5,0,26,21
1715649690183,EDS 128B,A01,507293,Pappas; Elizabeth,9,0,30,21
1715649691207,EDS 139,A00,507294,Fargason; Sharon Gayle,9,0,30,21
1715649691207,EDS 139,B00,507313,Pappas; Elizabeth,9,0,30,21
1715649692235,EDS 201,A00,507315,Staff,10,0,30,20
1715649693264,EDS 203,A01,507317,Halter; Christopher P.,10,0,30,20
1715649694292,EDS 204R,A01,507319,Halter; Christopher P.,0,3,30,30
1715649694292,EDS 204R,B01,507331,Heinzman; Erica M.,14,0,30,16
1715649695318,EDS 206R,A00,507332,Staff,0,4,30,30
1715649695318,EDS 206R,B00,507343,Staff,15,0,30,15
1715649696342,EDS 250,A00,507344,Hemans; Patricia Ann Benitez,20,0,40,20
1715649697368,EDS 281,A00,507345,Daly; Alan J.,18,0,18,0
1715649698395,EDS 284,A00,507350,Daly; Alan J.,16,0,16,0
1715649699419,EDS 286,A00,507359,Fine; Sarah,18,0,18,0
1715649700447,EDS 289C,A01,507361,Daly; Alan J.,18,0,18,0
1715649701476,EDS 290,A00,507366,Hofstetter; Carolyn,15,0,15,0
1715649702507,LIGM 5A,A00,507421,Fischer-Grunski; Eva K,17,0,20,3
1715649703531,LIGM 5B,A00,507423,Fischer-Grunski; Eva K,19,0,20,1
1715649704561,LIGM 5C,A00,507425,Fischer-Grunski; Eva K,19,0,20,1
1715649705586,LIIT 5AS,A00,507427,Carnelos; Chiara,20,0,20,0
1715649706610,LIIT 5BS,A00,507430,Carnelos; Chiara,20,0,20,0
1715649707634,LIIT 5CS,A00,507432,Carnelos; Chiara,20,0,20,0
1715649708660,LISP 5A,A00,507541,Munoz Sanchez; Alicia,11,0,20,9
1715649709688,LISP 5B,A00,507671,Munoz Sanchez; Alicia,8,0,20,12
1715649710715,LISP 5C,A00,507696,Munoz Sanchez; Alicia,8,0,20,12
1715649711747,MAE 197,001,528363,Boechler; Nicholas Sebastia,9998,0,9999,1
1715649712773,MATH 197,001,523477,Kedlaya; Kiran S.,9994,0,9999,5
1715649712773,MATH 197,002,563811,Zhang; Danna,9994,0,9999,5
1715649712773,MATH 197,003,628552,Dumitriu; Ioana,9998,0,9999,1
1715649712773,MATH 197,004,660885,Floyd; Eric,9998,0,9999,1
1715649713803,MCWP 40R,A00,518780,Staff,1,0,20,19
1715649713803,MCWP 40R,B00,518781,Carter; Jennifer A,10,0,20,10
1715649713803,MCWP 40R,C00,518783,Smith; Haydee Marie,5,0,20,15
1715649714838,MCWP 50R,A00,518791,Redela; Pamela Morgan,0,1,20,20
1715649714838,MCWP 50R,B00,518792,Krone; Jarret,0,2,20,20
1715649714838,MCWP 50R,C00,518793,Staff,0,4,20,20
1715649714838,MCWP 50R,D00,518794,Morshed; Michael James,0,2,20,20
1715649714838,MCWP 50R,E00,518795,Carter; Andrea L,0,2,20,20
1715649714838,MCWP 50R,F00,518796,Miller; Elizabeth Deen,0,1,20,20
1715649714838,MCWP 50R,G00,518797,Guillen; Melinda,0,1,20,20
1715649715863,MMW 12R,A01,514034,Herbst; Matthew,0,2,16,16
1715649715863,MMW 12R,A02,514035,Herbst; Matthew,0,0,16,16
1715649716887,MMW 13R,A01,514037,Staff,0,5,16,16
1715649716887,MMW 13R,A02,514039,Staff,0,5,16,16
1715649716887,MMW 13R,A03,628519,Staff,0,4,16,16
1715649718937,SIO 295LS,A00,523233,Staff,10,0,30,20
1715649719966,SIO 295S,A00,523232,Staff,10,0,30,20
1715649720994,SIOC 290S,A01,637330,Merrifield; Mark A,21,0,30,9
1715649722019,SIOC 291S,A01,637333,Gabriel; Corey John,21,0,30,9
1715649723043,SOCI 117,A01,494376,Staff,0,5,5,5
1715649724072,WES 237B,A00,494380,Staff,10,0,20,10
1715649726154,AESE 279B,A00,494370,Wade; Jon P,0,0,33,33
1715649727179,AIP 97,001,660915,Van Den Einde; Yael Dahlia,9998,0,9999,1
1715649728208,AIP 197,001,627712,Vespa; Emanuel Ignacio,9995,0,9999,4
1715649728208,AIP 197,002,650778,Amir; On,9998,0,9999,1
1715649728208,AIP 197,003,650933,Avenancio-Leon; Carlos,9998,0,9999,1
1715649728208,AIP 197,004,658530,Heyman; Gail D.,9998,0,9999,1
1715649728208,AIP 197,005,658631,Neal; Sonya E,9998,0,9999,1
1715649728208,AIP 197,006,658671,Du; Songzi,9998,0,9999,1
1715649729240,ANAR 135S,A00,494369,Braswell; Geoffrey E.,0,0,0,0
1715649730269,BENG 196,001,628496,Engler; Adam J.,9998,0,9999,1
1715649730269,BENG 196,002,660916,Watson; John Thomas,9998,0,9999,1
1715649731299,BISP 197,001,650773,Wilhelm; James E.,9994,0,9999,5
1715649731299,BISP 197,002,658904,Coleman; Aaron B.,9998,0,9999,1
1715649732326,CAT 124RS,A01,519847,Geibel; William,0,0,20,20
1715649733352,CAT 125RS,A01,515971,Geibel; William,0,0,20,20
1715649734376,CLRE 250,A00,511389,Morris; Sheldon,9992,0,9999,7
1715649735407,CLRE 251,A00,507176,Mehta; Ravindra L.,9992,0,9999,7
1715649735407,CLRE 251,B00,511410,Mehta; Ravindra L.,9998,0,9999,1
1715649736433,CLRE 252,A00,507189,Cuomo; Raphael Eduardo,9994,0,9999,5
1715649737458,CLRE 253,A00,507199,Vaida; Florin,9994,0,9999,5
1715649737458,CLRE 253,B00,507202,Vaida; Florin,9999,0,9999,0
1715649738484,CLRE 259,A00,507211,Patel; Hemal,9996,0,9999,3
1715649739507,CLRE 260,A00,507221,Cuomo; Raphael Eduardo,9999,0,9999,0
1715649740532,CLRE 297,001,507242,Cuomo; Raphael Eduardo,9999,0,9999,0
1715649741559,COGS 197,001,638244,Voytek; Bradley Thomas,9997,0,9999,2
1715649742590,CSE 191,A00,516875,Minnes Kemp; Mor Mia,9991,0,9999,8
1715649743622,CSE 197,001,637388,Minnes Kemp; Mor Mia,9992,0,9999,7
1715649744653,CSS 201S,A01,494383,Mignozzetti; Umberto,35,0,35,0
1715649745679,CSS 202S,A01,494387,Mignozzetti; Umberto,35,0,35,0
1715649746706,DSC 197,001,628532,Eldridge; Justin Matthew,9995,0,9999,4
1715649747733,EAP 100,A00,516065,Staff,9799,0,9999,200
1715649748759,ECE 45,A01,507414,Staff,32,0,60,28
1715649750813,ECE 111,A01,507420,Staff,11,0,50,39
1715649751839,ECE 197,001,548057,Sievenpiper; Daniel F.,9991,0,9999,8
1715649752866,EDS 115,A00,507243,Choi; Bailey Miyeon,6,0,28,22
1715649753895,EDS 117,A01,494379,Staff,0,6,34,35
1715649754919,EDS 125,A00,507246,Hopkins; Megan Beth,7,0,30,23
1715649755944,EDS 128A,A01,507264,Fargason; Sharon Gayle,5,0,26,21
1715649756969,EDS 128B,A01,507293,Pappas; Elizabeth,9,0,30,21
1715649758052,EDS 139,A00,507294,Fargason; Sharon Gayle,9,0,30,21
1715649758052,EDS 139,B00,507313,Pappas; Elizabeth,9,0,30,21
1715649759078,EDS 201,A00,507315,Staff,10,0,30,20
1715649760103,EDS 203,A01,507317,Halter; Christopher P.,10,0,30,20
1715649761134,EDS 204R,A01,507319,Halter; Christopher P.,0,3,30,30
1715649761134,EDS 204R,B01,507331,Heinzman; Erica M.,14,0,30,16
1715649762159,EDS 206R,A00,507332,Staff,0,4,30,30
1715649762159,EDS 206R,B00,507343,Staff,15,0,30,15
1715649763190,EDS 250,A00,507344,Hemans; Patricia Ann Benitez,20,0,40,20
1715649764214,EDS 281,A00,507345,Daly; Alan J.,18,0,18,0
1715649765239,EDS 284,A00,507350,Daly; Alan J.,16,0,16,0
1715649766267,EDS 286,A00,507359,Fine; Sarah,18,0,18,0
1715649767293,EDS 289C,A01,507361,Daly; Alan J.,18,0,18,0
1715649768318,EDS 290,A00,507366,Hofstetter; Carolyn,15,0,15,0
1715649769343,LIGM 5A,A00,507421,Fischer-Grunski; Eva K,17,0,20,3
1715649770367,LIGM 5B,A00,507423,Fischer-Grunski; Eva K,19,0,20,1
1715649771396,LIGM 5C,A00,507425,Fischer-Grunski; Eva K,19,0,20,1
1715649772425,LIIT 5AS,A00,507427,Carnelos; Chiara,20,0,20,0
1715649773453,LIIT 5BS,A00,507430,Carnelos; Chiara,20,0,20,0
1715649774481,LIIT 5CS,A00,507432,Carnelos; Chiara,20,0,20,0
1715649775506,LISP 5A,A00,507541,Munoz Sanchez; Alicia,11,0,20,9
1715649776531,LISP 5B,A00,507671,Munoz Sanchez; Alicia,8,0,20,12
1715649777561,LISP 5C,A00,507696,Munoz Sanchez; Alicia,8,0,20,12
1715649778590,MAE 197,001,528363,Boechler; Nicholas Sebastia,9998,0,9999,1
1715649779618,MATH 197,001,523477,Kedlaya; Kiran S.,9994,0,9999,5
1715649779618,MATH 197,002,563811,Zhang; Danna,9994,0,9999,5
1715649779618,MATH 197,003,628552,Dumitriu; Ioana,9998,0,9999,1
1715649779618,MATH 197,004,660885,Floyd; Eric,9998,0,9999,1
1715649780645,MCWP 40R,A00,518780,Staff,1,0,20,19
1715649780645,MCWP 40R,B00,518781,Carter; Jennifer A,10,0,20,10
1715649780645,MCWP 40R,C00,518783,Smith; Haydee Marie,5,0,20,15
1715649781674,MCWP 50R,A00,518791,Redela; Pamela Morgan,0,1,20,20
1715649781674,MCWP 50R,B00,518792,Krone; Jarret,0,2,20,20
1715649781674,MCWP 50R,C00,518793,Staff,0,4,20,20
1715649781674,MCWP 50R,D00,518794,Morshed; Michael James,0,2,20,20
1715649781674,MCWP 50R,E00,518795,Carter; Andrea L,0,2,20,20
1715649781674,MCWP 50R,F00,518796,Miller; Elizabeth Deen,0,1,20,20
1715649781674,MCWP 50R,G00,518797,Guillen; Melinda,0,1,20,20
1715649782701,MMW 12R,A01,514034,Herbst; Matthew,0,2,16,16
1715649782701,MMW 12R,A02,514035,Herbst; Matthew,0,0,16,16
1715649783729,MMW 13R,A01,514037,Staff,0,5,16,16
1715649783729,MMW 13R,A02,514039,Staff,0,5,16,16
1715649783729,MMW 13R,A03,628519,Staff,0,4,16,16
1715649785783,SIO 295LS,A00,523233,Staff,10,0,30,20
1715649786811,SIO 295S,A00,523232,Staff,10,0,30,20
1715649787837,SIOC 290S,A01,637330,Merrifield; Mark A,21,0,30,9
1715649788863,SIOC 291S,A01,637333,Gabriel; Corey John,21,0,30,9
1715649789891,SOCI 117,A01,494376,Staff,0,5,5,5
1715649790918,WES 237B,A00,494380,Staff,10,0,20,10
1715649792992,AESE 279B,A00,494370,Wade; Jon P,0,0,33,33
1715649794018,AIP 97,001,660915,Van Den Einde; Yael Dahlia,9998,0,9999,1
1715649795046,AIP 197,001,627712,Vespa; Emanuel Ignacio,9995,0,9999,4
1715649795046,AIP 197,002,650778,Amir; On,9998,0,9999,1
1715649795046,AIP 197,003,650933,Avenancio-Leon; Carlos,9998,0,9999,1
1715649795046,AIP 197,004,658530,Heyman; Gail D.,9998,0,9999,1
1715649795046,AIP 197,005,658631,Neal; Sonya E,9998,0,9999,1
1715649795046,AIP 197,006,658671,Du; Songzi,9998,0,9999,1
1715649796073,ANAR 135S,A00,494369,Braswell; Geoffrey E.,0,0,0,0
1715649797099,BENG 196,001,628496,Engler; Adam J.,9998,0,9999,1
1715649797099,BENG 196,002,660916,Watson; John Thomas,9998,0,9999,1
1715649798129,BISP 197,001,650773,Wilhelm; James E.,9994,0,9999,5
1715649798129,BISP 197,002,658904,Coleman; Aaron B.,9998,0,9999,1
1715649799155,CAT 124RS,A01,519847,Geibel; William,0,0,20,20
1715649800179,CAT 125RS,A01,515971,Geibel; William,0,0,20,20
1715649801214,CLRE 250,A00,511389,Morris; Sheldon,9992,0,9999,7
1715649802247,CLRE 251,A00,507176,Mehta; Ravindra L.,9992,0,9999,7
1715649802247,CLRE 251,B00,511410,Mehta; Ravindra L.,9998,0,9999,1
1715649803273,CLRE 252,A00,507189,Cuomo; Raphael Eduardo,9994,0,9999,5
1715649804302,CLRE 253,A00,507199,Vaida; Florin,9994,0,9999,5
1715649804302,CLRE 253,B00,507202,Vaida; Florin,9999,0,9999,0
1715649805329,CLRE 259,A00,507211,Patel; Hemal,9996,0,9999,3
1715649806354,CLRE 260,A00,507221,Cuomo; Raphael Eduardo,9999,0,9999,0
1715649807379,CLRE 297,001,507242,Cuomo; Raphael Eduardo,9999,0,9999,0
1715649808405,COGS 197,001,638244,Voytek; Bradley Thomas,9997,0,9999,2
1715649809434,CSE 191,A00,516875,Minnes Kemp; Mor Mia,9991,0,9999,8
1715649810457,CSE 197,001,637388,Minnes Kemp; Mor Mia,9992,0,9999,7
1715649811487,CSS 201S,A01,494383,Mignozzetti; Umberto,35,0,35,0
1715649812513,CSS 202S,A01,494387,Mignozzetti; Umberto,35,0,35,0
1715649813540,DSC 197,001,628532,Eldridge; Justin Matthew,9995,0,9999,4
1715649814566,EAP 100,A00,516065,Staff,9799,0,9999,200
1715649815596,ECE 45,A01,507414,Staff,32,0,60,28
1715649817648,ECE 111,A01,507420,Staff,11,0,50,39
1715649818675,ECE 197,001,548057,Sievenpiper; Daniel F.,9991,0,9999,8
1715649819709,EDS 115,A00,507243,Choi; Bailey Miyeon,6,0,28,22
1715649820734,EDS 117,A01,494379,Staff,0,6,34,35
1715649821760,EDS 125,A00,507246,Hopkins; Megan Beth,7,0,30,23
1715649822787,EDS 128A,A01,507264,Fargason; Sharon Gayle,5,0,26,21
1715649823813,EDS 128B,A01,507293,Pappas; Elizabeth,9,0,30,21
1715649824837,EDS 139,A00,507294,Fargason; Sharon Gayle,9,0,30,21
1715649824837,EDS 139,B00,507313,Pappas; Elizabeth,9,0,30,21
1715649825865,EDS 201,A00,507315,Staff,10,0,30,20
1715649826891,EDS 203,A01,507317,Halter; Christopher P.,10,0,30,20
1715649827920,EDS 204R,A01,507319,Halter; Christopher P.,0,3,30,30
1715649827920,EDS 204R,B01,507331,Heinzman; Erica M.,14,0,30,16
1715649828951,EDS 206R,A00,507332,Staff,0,4,30,30
1715649828951,EDS 206R,B00,507343,Staff,15,0,30,15
1715649829977,EDS 250,A00,507344,Hemans; Patricia Ann Benitez,20,0,40,20
1715649831002,EDS 281,A00,507345,Daly; Alan J.,18,0,18,0
1715649832030,EDS 284,A00,507350,Daly; Alan J.,16,0,16,0
1715649833116,EDS 286,A00,507359,Fine; Sarah,18,0,18,0
1715649834143,EDS 289C,A01,507361,Daly; Alan J.,18,0,18,0
1715649835169,EDS 290,A00,507366,Hofstetter; Carolyn,15,0,15,0
1715649836205,LIGM 5A,A00,507421,Fischer-Grunski; Eva K,17,0,20,3
1715649837231,LIGM 5B,A00,507423,Fischer-Grunski; Eva K,19,0,20,1
1715649838261,LIGM 5C,A00,507425,Fischer-Grunski; Eva K,19,0,20,1
1715649839287,LIIT 5AS,A00,507427,Carnelos; Chiara,20,0,20,0
1715649840311,LIIT 5BS,A00,507430,Carnelos; Chiara,20,0,20,0
1715649841342,LIIT 5CS,A00,507432,Carnelos; Chiara,20,0,20,0
1715649842366,LISP 5A,A00,507541,Munoz Sanchez; Alicia,11,0,20,9
1715649843396,LISP 5B,A00,507671,Munoz Sanchez; Alicia,8,0,20,12
1715649844425,LISP 5C,A00,507696,Munoz Sanchez; Alicia,8,0,20,12
1715649845454,MAE 197,001,528363,Boechler; Nicholas Sebastia,9998,0,9999,1
1715649846481,MATH 197,001,523477,Kedlaya; Kiran S.,9994,0,9999,5
1715649846481,MATH 197,002,563811,Zhang; Danna,9994,0,9999,5
1715649846481,MATH 197,003,628552,Dumitriu; Ioana,9998,0,9999,1
1715649846481,MATH 197,004,660885,Floyd; Eric,9998,0,9999,1
1715649847513,MCWP 40R,A00,518780,Staff,1,0,20,19
1715649847513,MCWP 40R,B00,518781,Carter; Jennifer A,10,0,20,10
1715649847513,MCWP 40R,C00,518783,Smith; Haydee Marie,5,0,20,15
1715649848541,MCWP 50R,A00,518791,Redela; Pamela Morgan,0,1,20,20
1715649848541,MCWP 50R,B00,518792,Krone; Jarret,0,2,20,20
1715649848541,MCWP 50R,C00,518793,Staff,0,4,20,20
1715649848541,MCWP 50R,D00,518794,Morshed; Michael James,0,2,20,20
1715649848541,MCWP 50R,E00,518795,Carter; Andrea L,0,2,20,20
1715649848541,MCWP 50R,F00,518796,Miller; Elizabeth Deen,0,1,20,20
1715649848541,MCWP 50R,G00,518797,Guillen; Melinda,0,1,20,20
1715649849570,MMW 12R,A01,514034,Herbst; Matthew,0,2,16,16
1715649849570,MMW 12R,A02,514035,Herbst; Matthew,0,0,16,16
1715649850599,MMW 13R,A01,514037,Staff,0,5,16,16
1715649850599,MMW 13R,A02,514039,Staff,0,5,16,16
1715649850599,MMW 13R,A03,628519,Staff,0,4,16,16
1715649852655,SIO 295LS,A00,523233,Staff,10,0,30,20
1715649853680,SIO 295S,A00,523232,Staff,10,0,30,20
1715649854707,SIOC 290S,A01,637330,Merrifield; Mark A,21,0,30,9
1715649855738,SIOC 291S,A01,637333,Gabriel; Corey John,21,0,30,9
1715649856767,SOCI 117,A01,494376,Staff,0,5,5,5
1715649857794,WES 237B,A00,494380,Staff,10,0,20,10
1715649859876,AESE 279B,A00,494370,Wade; Jon P,0,0,33,33
1715649860904,AIP 97,001,660915,Van Den Einde; Yael Dahlia,9998,0,9999,1
1715649861936,AIP 197,001,627712,Vespa; Emanuel Ignacio,9995,0,9999,4
1715649861936,AIP 197,002,650778,Amir; On,9998,0,9999,1
1715649861936,AIP 197,003,650933,Avenancio-Leon; Carlos,9998,0,9999,1
1715649861936,AIP 197,004,658530,Heyman; Gail D.,9998,0,9999,1
1715649861936,AIP 197,005,658631,Neal; Sonya E,9998,0,9999,1
1715649861936,AIP 197,006,658671,Du; Songzi,9998,0,9999,1
1715649862962,ANAR 135S,A00,494369,Braswell; Geoffrey E.,0,0,0,0
1715649863991,BENG 196,001,628496,Engler; Adam J.,9998,0,9999,1
1715649863991,BENG 196,002,660916,Watson; John Thomas,9998,0,9999,1
1715649865020,BISP 197,001,650773,Wilhelm; James E.,9994,0,9999,5
1715649865020,BISP 197,002,658904,Coleman; Aaron B.,9998,0,9999,1
1715649866047,CAT 124RS,A01,519847,Geibel; William,0,0,20,20
1715649867072,CAT 125RS,A01,515971,Geibel; William,0,0,20,20
1715649868101,CLRE 250,A00,511389,Morris; Sheldon,9992,0,9999,7
1715649869126,CLRE 251,A00,507176,Mehta; Ravindra L.,9992,0,9999,7
1715649869126,CLRE 251,B00,511410,Mehta; Ravindra L.,9998,0,9999,1
1715649870152,CLRE 252,A00,507189,Cuomo; Raphael Eduardo,9994,0,9999,5
1715649871178,CLRE 253,A00,507199,Vaida; Florin,9994,0,9999,5
1715649871178,CLRE 253,B00,507202,Vaida; Florin,9999,0,9999,0
1715649872206,CLRE 259,A00,507211,Patel; Hemal,9996,0,9999,3
1715649873232,CLRE 260,A00,507221,Cuomo; Raphael Eduardo,9999,0,9999,0
1715649874257,CLRE 297,001,507242,Cuomo; Raphael Eduardo,9999,0,9999,0
1715649875288,COGS 197,001,638244,Voytek; Bradley Thomas,9997,0,9999,2
1715649876313,CSE 191,A00,516875,Minnes Kemp; Mor Mia,9991,0,9999,8
1715649877341,CSE 197,001,637388,Minnes Kemp; Mor Mia,9992,0,9999,7
1715649878372,CSS 201S,A01,494383,Mignozzetti; Umberto,35,0,35,0
1715649879402,CSS 202S,A01,494387,Mignozzetti; Umberto,35,0,35,0
1715649880427,DSC 197,001,628532,Eldridge; Justin Matthew,9995,0,9999,4
1715649881452,EAP 100,A00,516065,Staff,9799,0,9999,200
1715649882482,ECE 45,A01,507414,Staff,32,0,60,28
1715649884537,ECE 111,A01,507420,Staff,11,0,50,39
1715649885563,ECE 197,001,548057,Sievenpiper; Daniel F.,9991,0,9999,8
1715649886592,EDS 115,A00,507243,Choi; Bailey Miyeon,6,0,28,22
1715649887619,EDS 117,A01,494379,Staff,0,6,34,35
1715649888643,EDS 125,A00,507246,Hopkins; Megan Beth,7,0,30,23
1715649889671,EDS 128A,A01,507264,Fargason; Sharon Gayle,5,0,26,21
1715649890702,EDS 128B,A01,507293,Pappas; Elizabeth,9,0,30,21
1715649891731,EDS 139,A00,507294,Fargason; Sharon Gayle,9,0,30,21
1715649891731,EDS 139,B00,507313,Pappas; Elizabeth,9,0,30,21
1715649892755,EDS 201,A00,507315,Staff,10,0,30,20
1715649893785,EDS 203,A01,507317,Halter; Christopher P.,10,0,30,20
1715649894814,EDS 204R,A01,507319,Halter; Christopher P.,0,3,30,30
1715649894814,EDS 204R,B01,507331,Heinzman; Erica M.,14,0,30,16
1715649895839,EDS 206R,A00,507332,Staff,0,4,30,30
1715649895839,EDS 206R,B00,507343,Staff,15,0,30,15
1715649896869,EDS 250,A00,507344,Hemans; Patricia Ann Benitez,20,0,40,20
1715649897896,EDS 281,A00,507345,Daly; Alan J.,18,0,18,0
1715649898919,EDS 284,A00,507350,Daly; Alan J.,16,0,16,0
1715649899948,EDS 286,A00,507359,Fine; Sarah,18,0,18,0
1715649900977,EDS 289C,A01,507361,Daly; Alan J.,18,0,18,0
1715649902003,EDS 290,A00,507366,Hofstetter; Carolyn,15,0,15,0
1715649903035,LIGM 5A,A00,507421,Fischer-Grunski; Eva K,17,0,20,3
1715649904063,LIGM 5B,A00,507423,Fischer-Grunski; Eva K,19,0,20,1
1715649905088,LIGM 5C,A00,507425,Fischer-Grunski; Eva K,19,0,20,1
1715649906115,LIIT 5AS,A00,507427,Carnelos; Chiara,20,0,20,0
1715649907144,LIIT 5BS,A00,507430,Carnelos; Chiara,20,0,20,0
1715649908169,LIIT 5CS,A00,507432,Carnelos; Chiara,20,0,20,0
1715649909200,LISP 5A,A00,507541,Munoz Sanchez; Alicia,11,0,20,9
1715649910229,LISP 5B,A00,507671,Munoz Sanchez; Alicia,8,0,20,12
1715649911255,LISP 5C,A00,507696,Munoz Sanchez; Alicia,8,0,20,12
1715649912282,MAE 197,001,528363,Boechler; Nicholas Sebastia,9998,0,9999,1
1715649913310,MATH 197,001,523477,Kedlaya; Kiran S.,9994,0,9999,5
1715649913310,MATH 197,002,563811,Zhang; Danna,9994,0,9999,5
1715649913310,MATH 197,003,628552,Dumitriu; Ioana,9998,0,9999,1
1715649913310,MATH 197,004,660885,Floyd; Eric,9998,0,9999,1
1715649914338,MCWP 40R,A00,518780,Staff,1,0,20,19
1715649914338,MCWP 40R,B00,518781,Carter; Jennifer A,10,0,20,10
1715649914338,MCWP 40R,C00,518783,Smith; Haydee Marie,5,0,20,15
1715649915373,MCWP 50R,A00,518791,Redela; Pamela Morgan,0,1,20,20
1715649915373,MCWP 50R,B00,518792,Krone; Jarret,0,2,20,20
1715649915373,MCWP 50R,C00,518793,Staff,0,4,20,20
1715649915373,MCWP 50R,D00,518794,Morshed; Michael James,0,2,20,20
1715649915373,MCWP 50R,E00,518795,Carter; Andrea L,0,2,20,20
1715649915373,MCWP 50R,F00,518796,Miller; Elizabeth Deen,0,1,20,20
1715649915373,MCWP 50R,G00,518797,Guillen; Melinda,0,1,20,20
1715649916402,MMW 12R,A01,514034,Herbst; Matthew,0,2,16,16
1715649916402,MMW 12R,A02,514035,Herbst; Matthew,0,0,16,16
1715649917427,MMW 13R,A01,514037,Staff,0,5,16,16
1715649917427,MMW 13R,A02,514039,Staff,0,5,16,16
1715649917427,MMW 13R,A03,628519,Staff,0,4,16,16
1715649919480,SIO 295LS,A00,523233,Staff,10,0,30,20
1715649920505,SIO 295S,A00,523232,Staff,10,0,30,20
1715649921531,SIOC 290S,A01,637330,Merrifield; Mark A,21,0,30,9
1715649922559,SIOC 291S,A01,637333,Gabriel; Corey John,21,0,30,9
1715649923585,SOCI 117,A01,494376,Staff,0,5,5,5
1715649924613,WES 237B,A00,494380,Staff,10,0,20,10
1715649926691,AESE 279B,A00,494370,Wade; Jon P,0,0,33,33
1715649927716,AIP 97,001,660915,Van Den Einde; Yael Dahlia,9998,0,9999,1
1715649928748,AIP 197,001,627712,Vespa; Emanuel Ignacio,9995,0,9999,4
1715649928748,AIP 197,002,650778,Amir; On,9998,0,9999,1
1715649928748,AIP 197,003,650933,Avenancio-Leon; Carlos,9998,0,9999,1
1715649928748,AIP 197,004,658530,Heyman; Gail D.,9998,0,9999,1
1715649928748,AIP 197,005,658631,Neal; Sonya E,9998,0,9999,1
1715649928748,AIP 197,006,658671,Du; Songzi,9998,0,9999,1
1715649929779,ANAR 135S,A00,494369,Braswell; Geoffrey E.,0,0,0,0
1715649930805,BENG 196,001,628496,Engler; Adam J.,9998,0,9999,1
1715649930805,BENG 196,002,660916,Watson; John Thomas,9998,0,9999,1
1715649931830,BISP 197,001,650773,Wilhelm; James E.,9994,0,9999,5
1715649931830,BISP 197,002,658904,Coleman; Aaron B.,9998,0,9999,1
1715649932859,CAT 124RS,A01,519847,Geibel; William,0,0,20,20
1715649933889,CAT 125RS,A01,515971,Geibel; William,0,0,20,20
1715649934914,CLRE 250,A00,511389,Morris; Sheldon,9992,0,9999,7
1715649935940,CLRE 251,A00,507176,Mehta; Ravindra L.,9992,0,9999,7
1715649935940,CLRE 251,B00,511410,Mehta; Ravindra L.,9998,0,9999,1
1715649936965,CLRE 252,A00,507189,Cuomo; Raphael Eduardo,9994,0,9999,5
1715649937991,CLRE 253,A00,507199,Vaida; Florin,9994,0,9999,5
1715649937991,CLRE 253,B00,507202,Vaida; Florin,9999,0,9999,0
1715649939019,CLRE 259,A00,507211,Patel; Hemal,9996,0,9999,3
1715649940044,CLRE 260,A00,507221,Cuomo; Raphael Eduardo,9999,0,9999,0
1715649941071,CLRE 297,001,507242,Cuomo; Raphael Eduardo,9999,0,9999,0
1715649942096,COGS 197,001,638244,Voytek; Bradley Thomas,9997,0,9999,2
1715649943121,CSE 191,A00,516875,Minnes Kemp; Mor Mia,9991,0,9999,8
1715649944144,CSE 197,001,637388,Minnes Kemp; Mor Mia,9992,0,9999,7
1715649945174,CSS 201S,A01,494383,Mignozzetti; Umberto,35,0,35,0
1715649946200,CSS 202S,A01,494387,Mignozzetti; Umberto,35,0,35,0
1715649947228,DSC 197,001,628532,Eldridge; Justin Matthew,9995,0,9999,4
1715649948253,EAP 100,A00,516065,Staff,9799,0,9999,200
1715649949282,ECE 45,A01,507414,Staff,32,0,60,28
1715649951333,ECE 111,A01,507420,Staff,11,0,50,39
1715649952358,ECE 197,001,548057,Sievenpiper; Daniel F.,9991,0,9999,8
1715649953385,EDS 115,A00,507243,Choi; Bailey Miyeon,6,0,28,22
1715649954416,EDS 117,A01,494379,Staff,0,6,34,35
1715649955446,EDS 125,A00,507246,Hopkins; Megan Beth,7,0,30,23
1715649956479,EDS 128A,A01,507264,Fargason; Sharon Gayle,5,0,26,21
1715649957509,EDS 128B,A01,507293,Pappas; Elizabeth,9,0,30,21
1715649958543,EDS 139,A00,507294,Fargason; Sharon Gayle,9,0,30,21
1715649958543,EDS 139,B00,507313,Pappas; Elizabeth,9,0,30,21
1715649959568,EDS 201,A00,507315,Staff,10,0,30,20
1715649960597,EDS 203,A01,507317,Halter; Christopher P.,10,0,30,20
1715649961628,EDS 204R,A01,507319,Halter; Christopher P.,0,3,30,30
1715649961628,EDS 204R,B01,507331,Heinzman; Erica M.,14,0,30,16
1715649962657,EDS 206R,A00,507332,Staff,0,4,30,30
1715649962657,EDS 206R,B00,507343,Staff,15,0,30,15
1715649963686,EDS 250,A00,507344,Hemans; Patricia Ann Benitez,20,0,40,20
1715649964710,EDS 281,A00,507345,Daly; Alan J.,18,0,18,0
1715649965735,EDS 284,A00,507350,Daly; Alan J.,16,0,16,0
1715649966761,EDS 286,A00,507359,Fine; Sarah,18,0,18,0
1715649967785,EDS 289C,A01,507361,Daly; Alan J.,18,0,18,0
1715649968812,EDS 290,A00,507366,Hofstetter; Carolyn,15,0,15,0
1715649969843,LIGM 5A,A00,507421,Fischer-Grunski; Eva K,17,0,20,3
1715649970872,LIGM 5B,A00,507423,Fischer-Grunski; Eva K,19,0,20,1
1715649971900,LIGM 5C,A00,507425,Fischer-Grunski; Eva K,19,0,20,1
1715649972930,LIIT 5AS,A00,507427,Carnelos; Chiara,20,0,20,0
1715649973956,LIIT 5BS,A00,507430,Carnelos; Chiara,20,0,20,0
1715649974982,LIIT 5CS,A00,507432,Carnelos; Chiara,20,0,20,0
1715649976008,LISP 5A,A00,507541,Munoz Sanchez; Alicia,11,0,20,9
1715649977034,LISP 5B,A00,507671,Munoz Sanchez; Alicia,8,0,20,12
1715649978062,LISP 5C,A00,507696,Munoz Sanchez; Alicia,8,0,20,12
1715649979091,MAE 197,001,528363,Boechler; Nicholas Sebastia,9998,0,9999,1
1715649980122,MATH 197,001,523477,Kedlaya; Kiran S.,9994,0,9999,5
1715649980122,MATH 197,002,563811,Zhang; Danna,9994,0,9999,5
1715649980122,MATH 197,003,628552,Dumitriu; Ioana,9998,0,9999,1
1715649980122,MATH 197,004,660885,Floyd; Eric,9998,0,9999,1
1715649981150,MCWP 40R,A00,518780,Staff,1,0,20,19
1715649981150,MCWP 40R,B00,518781,Carter; Jennifer A,10,0,20,10
1715649981150,MCWP 40R,C00,518783,Smith; Haydee Marie,5,0,20,15
1715649982179,MCWP 50R,A00,518791,Redela; Pamela Morgan,0,1,20,20
1715649982179,MCWP 50R,B00,518792,Krone; Jarret,0,2,20,20
1715649982179,MCWP 50R,C00,518793,Staff,0,4,20,20
1715649982179,MCWP 50R,D00,518794,Morshed; Michael James,0,2,20,20
1715649982179,MCWP 50R,E00,518795,Carter; Andrea L,0,2,20,20
1715649982179,MCWP 50R,F00,518796,Miller; Elizabeth Deen,0,1,20,20
1715649982179,MCWP 50R,G00,518797,Guillen; Melinda,0,1,20,20
1715649983208,MMW 12R,A01,514034,Herbst; Matthew,0,2,16,16
1715649983208,MMW 12R,A02,514035,Herbst; Matthew,0,0,16,16
1715649984236,MMW 13R,A01,514037,Staff,0,5,16,16
1715649984236,MMW 13R,A02,514039,Staff,0,5,16,16
1715649984236,MMW 13R,A03,628519,Staff,0,4,16,16
1715649986287,SIO 295LS,A00,523233,Staff,10,0,30,20
1715649987316,SIO 295S,A00,523232,Staff,10,0,30,20
1715649988346,SIOC 290S,A01,637330,Merrifield; Mark A,21,0,30,9
1715649989377,SIOC 291S,A01,637333,Gabriel; Corey John,21,0,30,9
1715649990403,SOCI 117,A01,494376,Staff,0,5,5,5
1715649991429,WES 237B,A00,494380,Staff,10,0,20,10
1715649993521,AESE 279B,A00,494370,Wade; Jon P,0,0,33,33
1715649994546,AIP 97,001,660915,Van Den Einde; Yael Dahlia,9998,0,9999,1
1715649995580,AIP 197,001,627712,Vespa; Emanuel Ignacio,9995,0,9999,4
1715649995580,AIP 197,002,650778,Amir; On,9998,0,9999,1
1715649995580,AIP 197,003,650933,Avenancio-Leon; Carlos,9998,0,9999,1
1715649995580,AIP 197,004,658530,Heyman; Gail D.,9998,0,9999,1
1715649995580,AIP 197,005,658631,Neal; Sonya E,9998,0,9999,1
1715649995580,AIP 197,006,658671,Du; Songzi,9998,0,9999,1
1715649996605,ANAR 135S,A00,494369,Braswell; Geoffrey E.,0,0,0,0
1715649997636,BENG 196,001,628496,Engler; Adam J.,9998,0,9999,1
1715649997636,BENG 196,002,660916,Watson; John Thomas,9998,0,9999,1
1715649998662,BISP 197,001,650773,Wilhelm; James E.,9994,0,9999,5
1715649998662,BISP 197,002,658904,Coleman; Aaron B.,9998,0,9999,1
1715649999691,CAT 124RS,A01,519847,Geibel; William,0,0,20,20
1715650000714,CAT 125RS,A01,515971,Geibel; William,0,0,20,20
1715650001742,CLRE 250,A00,511389,Morris; Sheldon,9992,0,9999,7
1715650002771,CLRE 251,A00,507176,Mehta; Ravindra L.,9992,0,9999,7
1715650002771,CLRE 251,B00,511410,Mehta; Ravindra L.,9998,0,9999,1
1715650003799,CLRE 252,A00,507189,Cuomo; Raphael Eduardo,9994,0,9999,5
1715650004825,CLRE 253,A00,507199,Vaida; Florin,9994,0,9999,5
1715650004825,CLRE 253,B00,507202,Vaida; Florin,9999,0,9999,0
1715650005851,CLRE 259,A00,507211,Patel; Hemal,9996,0,9999,3
1715650006877,CLRE 260,A00,507221,Cuomo; Raphael Eduardo,9999,0,9999,0
1715650007902,CLRE 297,001,507242,Cuomo; Raphael Eduardo,9999,0,9999,0
1715650008930,COGS 197,001,638244,Voytek; Bradley Thomas,9997,0,9999,2
1715650009957,CSE 191,A00,516875,Minnes Kemp; Mor Mia,9991,0,9999,8
1715650010981,CSE 197,001,637388,Minnes Kemp; Mor Mia,9992,0,9999,7
1715650012012,CSS 201S,A01,494383,Mignozzetti; Umberto,35,0,35,0
1715650013041,CSS 202S,A01,494387,Mignozzetti; Umberto,35,0,35,0
1715650014066,DSC 197,001,628532,Eldridge; Justin Matthew,9995,0,9999,4
1715650015090,EAP 100,A00,516065,Staff,9799,0,9999,200
1715650016120,ECE 45,A01,507414,Staff,32,0,60,28
1715650018174,ECE 111,A01,507420,Staff,11,0,50,39
1715650019202,ECE 197,001,548057,Sievenpiper; Daniel F.,9991,0,9999,8
1715650020229,EDS 115,A00,507243,Choi; Bailey Miyeon,6,0,28,22
1715650021255,EDS 117,A01,494379,Staff,0,6,34,35
1715650022281,EDS 125,A00,507246,Hopkins; Megan Beth,7,0,30,23
1715650023308,EDS 128A,A01,507264,Fargason; Sharon Gayle,5,0,26,21
1715650024334,EDS 128B,A01,507293,Pappas; Elizabeth,9,0,30,21
1715650025363,EDS 139,A00,507294,Fargason; Sharon Gayle,9,0,30,21
1715650025363,EDS 139,B00,507313,Pappas; Elizabeth,9,0,30,21
1715650026392,EDS 201,A00,507315,Staff,10,0,30,20
1715650027419,EDS 203,A01,507317,Halter; Christopher P.,10,0,30,20
1715650028449,EDS 204R,A01,507319,Halter; Christopher P.,0,3,30,30
1715650028449,EDS 204R,B01,507331,Heinzman; Erica M.,14,0,30,16
1715650029479,EDS 206R,A00,507332,Staff,0,4,30,30
1715650029479,EDS 206R,B00,507343,Staff,15,0,30,15
1715650030506,EDS 250,A00,507344,Hemans; Patricia Ann Benitez,20,0,40,20
1715650031530,EDS 281,A00,507345,Daly; Alan J.,18,0,18,0
1715650032558,EDS 284,A00,507350,Daly; Alan J.,16,0,16,0
1715650033587,EDS 286,A00,507359,Fine; Sarah,18,0,18,0
1715650034613,EDS 289C,A01,507361,Daly; Alan J.,18,0,18,0
1715650035641,EDS 290,A00,507366,Hofstetter; Carolyn,15,0,15,0
1715650036666,LIGM 5A,A00,507421,Fischer-Grunski; Eva K,17,0,20,3
1715650037697,LIGM 5B,A00,507423,Fischer-Grunski; Eva K,19,0,20,1
1715650038723,LIGM 5C,A00,507425,Fischer-Grunski; Eva K,19,0,20,1
1715650039749,LIIT 5AS,A00,507427,Carnelos; Chiara,20,0,20,0
1715650040775,LIIT 5BS,A00,507430,Carnelos; Chiara,20,0,20,0
1715650041805,LIIT 5CS,A00,507432,Carnelos; Chiara,20,0,20,0
1715650042834,LISP 5A,A00,507541,Munoz Sanchez; Alicia,11,0,20,9
1715650043862,LISP 5B,A00,507671,Munoz Sanchez; Alicia,8,0,20,12
1715650044892,LISP 5C,A00,507696,Munoz Sanchez; Alicia,8,0,20,12
1715650045919,MAE 197,001,528363,Boechler; Nicholas Sebastia,9998,0,9999,1
1715650046948,MATH 197,001,523477,Kedlaya; Kiran S.,9994,0,9999,5
1715650046948,MATH 197,002,563811,Zhang; Danna,9994,0,9999,5
1715650046948,MATH 197,003,628552,Dumitriu; Ioana,9998,0,9999,1
1715650046948,MATH 197,004,660885,Floyd; Eric,9998,0,9999,1
1715650047979,MCWP 40R,A00,518780,Staff,1,0,20,19
1715650047979,MCWP 40R,B00,518781,Carter; Jennifer A,10,0,20,10
1715650047979,MCWP 40R,C00,518783,Smith; Haydee Marie,5,0,20,15
1715650049006,MCWP 50R,A00,518791,Redela; Pamela Morgan,0,1,20,20
1715650049006,MCWP 50R,B00,518792,Krone; Jarret,0,2,20,20
1715650049006,MCWP 50R,C00,518793,Staff,0,4,20,20
1715650049006,MCWP 50R,D00,518794,Morshed; Michael James,0,2,20,20
1715650049006,MCWP 50R,E00,518795,Carter; Andrea L,0,2,20,20
1715650049006,MCWP 50R,F00,518796,Miller; Elizabeth Deen,0,1,20,20
1715650049006,MCWP 50R,G00,518797,Guillen; Melinda,0,1,20,20
1715650050032,MMW 12R,A01,514034,Herbst; Matthew,0,2,16,16
1715650050032,MMW 12R,A02,514035,Herbst; Matthew,0,0,16,16
1715650051060,MMW 13R,A01,514037,Staff,0,5,16,16
1715650051060,MMW 13R,A02,514039,Staff,0,5,16,16
1715650051060,MMW 13R,A03,628519,Staff,0,4,16,16
1715650053325,SIO 295LS,A00,523233,Staff,10,0,30,20
1715650054353,SIO 295S,A00,523232,Staff,10,0,30,20
1715650055383,SIOC 290S,A01,637330,Merrifield; Mark A,21,0,30,9
1715650056409,SIOC 291S,A01,637333,Gabriel; Corey John,21,0,30,9
1715650057435,SOCI 117,A01,494376,Staff,0,5,5,5
1715650058462,WES 237B,A00,494380,Staff,10,0,20,10
1715650060548,AESE 279B,A00,494370,Wade; Jon P,0,0,33,33
1715650061573,AIP 97,001,660915,Van Den Einde; Yael Dahlia,9998,0,9999,1
1715650062601,AIP 197,001,627712,Vespa; Emanuel Ignacio,9995,0,9999,4
1715650062601,AIP 197,002,650778,Amir; On,9998,0,9999,1
1715650062601,AIP 197,003,650933,Avenancio-Leon; Carlos,9998,0,9999,1
1715650062601,AIP 197,004,658530,Heyman; Gail D.,9998,0,9999,1
1715650062601,AIP 197,005,658631,Neal; Sonya E,9998,0,9999,1
1715650062601,AIP 197,006,658671,Du; Songzi,9998,0,9999,1
1715650063630,ANAR 135S,A00,494369,Braswell; Geoffrey E.,0,0,0,0
1715650064657,BENG 196,001,628496,Engler; Adam J.,9998,0,9999,1
1715650064657,BENG 196,002,660916,Watson; John Thomas,9998,0,9999,1
1715650065682,BISP 197,001,650773,Wilhelm; James E.,9994,0,9999,5
1715650065682,BISP 197,002,658904,Coleman; Aaron B.,9998,0,9999,1
1715650066709,CAT 124RS,A01,519847,Geibel; William,0,0,20,20
1715650067734,CAT 125RS,A01,515971,Geibel; William,0,0,20,20
1715650068762,CLRE 250,A00,511389,Morris; Sheldon,9992,0,9999,7
1715650069788,CLRE 251,A00,507176,Mehta; Ravindra L.,9992,0,9999,7
1715650069788,CLRE 251,B00,511410,Mehta; Ravindra L.,9998,0,9999,1
1715650070813,CLRE 252,A00,507189,Cuomo; Raphael Eduardo,9994,0,9999,5
1715650071841,CLRE 253,A00,507199,Vaida; Florin,9994,0,9999,5
1715650071841,CLRE 253,B00,507202,Vaida; Florin,9999,0,9999,0
1715650072865,CLRE 259,A00,507211,Patel; Hemal,9996,0,9999,3
1715650073892,CLRE 260,A00,507221,Cuomo; Raphael Eduardo,9999,0,9999,0
1715650074919,CLRE 297,001,507242,Cuomo; Raphael Eduardo,9999,0,9999,0
1715650075945,COGS 197,001,638244,Voytek; Bradley Thomas,9997,0,9999,2
1715650076971,CSE 191,A00,516875,Minnes Kemp; Mor Mia,9991,0,9999,8
1715650077997,CSE 197,001,637388,Minnes Kemp; Mor Mia,9992,0,9999,7
1715650079022,CSS 201S,A01,494383,Mignozzetti; Umberto,35,0,35,0
1715650080048,CSS 202S,A01,494387,Mignozzetti; Umberto,35,0,35,0
1715650081073,DSC 197,001,628532,Eldridge; Justin Matthew,9995,0,9999,4
1715650082100,EAP 100,A00,516065,Staff,9799,0,9999,200
1715650083130,ECE 45,A01,507414,Staff,32,0,60,28
1715650085186,ECE 111,A01,507420,Staff,11,0,50,39
1715650086212,ECE 197,001,548057,Sievenpiper; Daniel F.,9991,0,9999,8
1715650087242,EDS 115,A00,507243,Choi; Bailey Miyeon,6,0,28,22
1715650088273,EDS 117,A01,494379,Staff,0,6,34,35
1715650089300,EDS 125,A00,507246,Hopkins; Megan Beth,7,0,30,23
1715650090329,EDS 128A,A01,507264,Fargason; Sharon Gayle,5,0,26,21
1715650091358,EDS 128B,A01,507293,Pappas; Elizabeth,9,0,30,21
1715650092386,EDS 139,A00,507294,Fargason; Sharon Gayle,9,0,30,21
1715650092386,EDS 139,B00,507313,Pappas; Elizabeth,9,0,30,21
1715650093410,EDS 201,A00,507315,Staff,10,0,30,20
1715650094436,EDS 203,A01,507317,Halter; Christopher P.,10,0,30,20
1715650095461,EDS 204R,A01,507319,Halter; Christopher P.,0,3,30,30
1715650095461,EDS 204R,B01,507331,Heinzman; Erica M.,14,0,30,16
1715650096489,EDS 206R,A00,507332,Staff,0,4,30,30
1715650096489,EDS 206R,B00,507343,Staff,15,0,30,15
1715650097515,EDS 250,A00,507344,Hemans; Patricia Ann Benitez,20,0,40,20
1715650098540,EDS 281,A00,507345,Daly; Alan J.,18,0,18,0
1715650099568,EDS 284,A00,507350,Daly; Alan J.,16,0,16,0
1715650100596,EDS 286,A00,507359,Fine; Sarah,18,0,18,0
1715650101621,EDS 289C,A01,507361,Daly; Alan J.,18,0,18,0
1715650102650,EDS 290,A00,507366,Hofstetter; Carolyn,15,0,15,0
1715650103676,LIGM 5A,A00,507421,Fischer-Grunski; Eva K,17,0,20,3
1715650104702,LIGM 5B,A00,507423,Fischer-Grunski; Eva K,19,0,20,1
1715650105731,LIGM 5C,A00,507425,Fischer-Grunski; Eva K,19,0,20,1
1715650106757,LIIT 5AS,A00,507427,Carnelos; Chiara,20,0,20,0
1715650107786,LIIT 5BS,A00,507430,Carnelos; Chiara,20,0,20,0
1715650108815,LIIT 5CS,A00,507432,Carnelos; Chiara,20,0,20,0
1715650109843,LISP 5A,A00,507541,Munoz Sanchez; Alicia,11,0,20,9
1715650110870,LISP 5B,A00,507671,Munoz Sanchez; Alicia,8,0,20,12
1715650111896,LISP 5C,A00,507696,Munoz Sanchez; Alicia,8,0,20,12
1715650112927,MAE 197,001,528363,Boechler; Nicholas Sebastia,9998,0,9999,1
1715650113952,MATH 197,001,523477,Kedlaya; Kiran S.,9994,0,9999,5
1715650113952,MATH 197,002,563811,Zhang; Danna,9994,0,9999,5
1715650113952,MATH 197,003,628552,Dumitriu; Ioana,9998,0,9999,1
1715650113952,MATH 197,004,660885,Floyd; Eric,9998,0,9999,1
1715650114978,MCWP 40R,A00,518780,Staff,1,0,20,19
1715650114978,MCWP 40R,B00,518781,Carter; Jennifer A,10,0,20,10
1715650114978,MCWP 40R,C00,518783,Smith; Haydee Marie,5,0,20,15
1715650116008,MCWP 50R,A00,518791,Redela; Pamela Morgan,0,1,20,20
1715650116008,MCWP 50R,B00,518792,Krone; Jarret,0,2,20,20
1715650116008,MCWP 50R,C00,518793,Staff,0,4,20,20
1715650116008,MCWP 50R,D00,518794,Morshed; Michael James,0,2,20,20
1715650116008,MCWP 50R,E00,518795,Carter; Andrea L,0,2,20,20
1715650116008,MCWP 50R,F00,518796,Miller; Elizabeth Deen,0,1,20,20
1715650116008,MCWP 50R,G00,518797,Guillen; Melinda,0,1,20,20
1715650117036,MMW 12R,A01,514034,Herbst; Matthew,0,2,16,16
1715650117036,MMW 12R,A02,514035,Herbst; Matthew,0,0,16,16
1715650118064,MMW 13R,A01,514037,Staff,0,5,16,16
1715650118064,MMW 13R,A02,514039,Staff,0,5,16,16
1715650118064,MMW 13R,A03,628519,Staff,0,4,16,16
1715650120115,SIO 295LS,A00,523233,Staff,10,0,30,20
1715650121141,SIO 295S,A00,523232,Staff,10,0,30,20
1715650122169,SIOC 290S,A01,637330,Merrifield; Mark A,21,0,30,9
1715650123197,SIOC 291S,A01,637333,Gabriel; Corey John,21,0,30,9
1715650124221,SOCI 117,A01,494376,Staff,0,5,5,5
1715650125247,WES 237B,A00,494380,Staff,10,0,20,10
1715650127329,AESE 279B,A00,494370,Wade; Jon P,0,0,33,33
1715650128355,AIP 97,001,660915,Van Den Einde; Yael Dahlia,9998,0,9999,1
1715650129387,AIP 197,001,627712,Vespa; Emanuel Ignacio,9995,0,9999,4
1715650129387,AIP 197,002,650778,Amir; On,9998,0,9999,1
1715650129387,AIP 197,003,650933,Avenancio-Leon; Carlos,9998,0,9999,1
1715650129387,AIP 197,004,658530,Heyman; Gail D.,9998,0,9999,1
1715650129387,AIP 197,005,658631,Neal; Sonya E,9998,0,9999,1
1715650129387,AIP 197,006,658671,Du; Songzi,9998,0,9999,1
1715650130414,ANAR 135S,A00,494369,Braswell; Geoffrey E.,0,0,0,0
1715650131440,BENG 196,001,628496,Engler; Adam J.,9998,0,9999,1
1715650131440,BENG 196,002,660916,Watson; John Thomas,9998,0,9999,1
1715650132469,BISP 197,001,650773,Wilhelm; James E.,9994,0,9999,5
1715650132469,BISP 197,002,658904,Coleman; Aaron B.,9998,0,9999,1
1715650133497,CAT 124RS,A01,519847,Geibel; William,0,0,20,20
1715650134526,CAT 125RS,A01,515971,Geibel; William,0,0,20,20
1715650135553,CLRE 250,A00,511389,Morris; Sheldon,9992,0,9999,7
1715650136580,CLRE 251,A00,507176,Mehta; Ravindra L.,9992,0,9999,7
1715650136580,CLRE 251,B00,511410,Mehta; Ravindra L.,9998,0,9999,1
1715650137612,CLRE 252,A00,507189,Cuomo; Raphael Eduardo,9994,0,9999,5
1715650138641,CLRE 253,A00,507199,Vaida; Florin,9994,0,9999,5
1715650138641,CLRE 253,B00,507202,Vaida; Florin,9999,0,9999,0
1715650139667,CLRE 259,A00,507211,Patel; Hemal,9996,0,9999,3
1715650140697,CLRE 260,A00,507221,Cuomo; Raphael Eduardo,9999,0,9999,0
1715650141724,CLRE 297,001,507242,Cuomo; Raphael Eduardo,9999,0,9999,0
1715650142757,COGS 197,001,638244,Voytek; Bradley Thomas,9997,0,9999,2
1715650143785,CSE 191,A00,516875,Minnes Kemp; Mor Mia,9991,0,9999,8
1715650144813,CSE 197,001,637388,Minnes Kemp; Mor Mia,9992,0,9999,7
1715650145845,CSS 201S,A01,494383,Mignozzetti; Umberto,35,0,35,0
1715650146874,CSS 202S,A01,494387,Mignozzetti; Umberto,35,0,35,0
1715650147898,DSC 197,001,628532,Eldridge; Justin Matthew,9995,0,9999,4
1715650148922,EAP 100,A00,516065,Staff,9799,0,9999,200
1715650149951,ECE 45,A01,507414,Staff,32,0,60,28
1715650152003,ECE 111,A01,507420,Staff,11,0,50,39
1715650153031,ECE 197,001,548057,Sievenpiper; Daniel F.,9991,0,9999,8
1715650154061,EDS 115,A00,507243,Choi; Bailey Miyeon,6,0,28,22
1715650155088,EDS 117,A01,494379,Staff,0,6,34,35
1715650156118,EDS 125,A00,507246,Hopkins; Megan Beth,7,0,30,23
1715650157146,EDS 128A,A01,507264,Fargason; Sharon Gayle,5,0,26,21
1715650158173,EDS 128B,A01,507293,Pappas; Elizabeth,9,0,30,21
1715650159211,EDS 139,A00,507294,Fargason; Sharon Gayle,9,0,30,21
1715650159211,EDS 139,B00,507313,Pappas; Elizabeth,9,0,30,21
1715650160238,EDS 201,A00,507315,Staff,10,0,30,20
1715650161263,EDS 203,A01,507317,Halter; Christopher P.,10,0,30,20
1715650162288,EDS 204R,A01,507319,Halter; Christopher P.,0,3,30,30
1715650162288,EDS 204R,B01,507331,Heinzman; Erica M.,14,0,30,16
1715650163312,EDS 206R,A00,507332,Staff,0,4,30,30
1715650163312,EDS 206R,B00,507343,Staff,15,0,30,15
1715650164340,EDS 250,A00,507344,Hemans; Patricia Ann Benitez,20,0,40,20
1715650165365,EDS 281,A00,507345,Daly; Alan J.,18,0,18,0
1715650166391,EDS 284,A00,507350,Daly; Alan J.,16,0,16,0
1715650167419,EDS 286,A00,507359,Fine; Sarah,18,0,18,0
1715650168443,EDS 289C,A01,507361,Daly; Alan J.,18,0,18,0
1715650169468,EDS 290,A00,507366,Hofstetter; Carolyn,15,0,15,0
1715650170498,LIGM 5A,A00,507421,Fischer-Grunski; Eva K,17,0,20,3
1715650171523,LIGM 5B,A00,507423,Fischer-Grunski; Eva K,19,0,20,1
1715650172547,LIGM 5C,A00,507425,Fischer-Grunski; Eva K,19,0,20,1
1715650173577,LIIT 5AS,A00,507427,Carnelos; Chiara,20,0,20,0
1715650174601,LIIT 5BS,A00,507430,Carnelos; Chiara,20,0,20,0
1715650175628,LIIT 5CS,A00,507432,Carnelos; Chiara,20,0,20,0
1715650176654,LISP 5A,A00,507541,Munoz Sanchez; Alicia,11,0,20,9
1715650177679,LISP 5B,A00,507671,Munoz Sanchez; Alicia,8,0,20,12
1715650178708,LISP 5C,A00,507696,Munoz Sanchez; Alicia,8,0,20,12
1715650179737,MAE 197,001,528363,Boechler; Nicholas Sebastia,9998,0,9999,1
1715650180765,MATH 197,001,523477,Kedlaya; Kiran S.,9994,0,9999,5
1715650180765,MATH 197,002,563811,Zhang; Danna,9994,0,9999,5
1715650180765,MATH 197,003,628552,Dumitriu; Ioana,9998,0,9999,1
1715650180765,MATH 197,004,660885,Floyd; Eric,9998,0,9999,1
1715650181795,MCWP 40R,A00,518780,Staff,1,0,20,19
1715650181795,MCWP 40R,B00,518781,Carter; Jennifer A,10,0,20,10
1715650181795,MCWP 40R,C00,518783,Smith; Haydee Marie,5,0,20,15
1715650182823,MCWP 50R,A00,518791,Redela; Pamela Morgan,0,1,20,20
1715650182823,MCWP 50R,B00,518792,Krone; Jarret,0,2,20,20
1715650182823,MCWP 50R,C00,518793,Staff,0,4,20,20
1715650182823,MCWP 50R,D00,518794,Morshed; Michael James,0,2,20,20
1715650182823,MCWP 50R,E00,518795,Carter; Andrea L,0,2,20,20
1715650182823,MCWP 50R,F00,518796,Miller; Elizabeth Deen,0,1,20,20
1715650182823,MCWP 50R,G00,518797,Guillen; Melinda,0,1,20,20
1715650183849,MMW 12R,A01,514034,Herbst; Matthew,0,2,16,16
1715650183849,MMW 12R,A02,514035,Herbst; Matthew,0,0,16,16
1715650184877,MMW 13R,A01,514037,Staff,0,5,16,16
1715650184877,MMW 13R,A02,514039,Staff,0,5,16,16
1715650184877,MMW 13R,A03,628519,Staff,0,4,16,16
1715650186928,SIO 295LS,A00,523233,Staff,10,0,30,20
1715650187956,SIO 295S,A00,523232,Staff,10,0,30,20
1715650188986,SIOC 290S,A01,637330,Merrifield; Mark A,21,0,30,9
1715650190010,SIOC 291S,A01,637333,Gabriel; Corey John,21,0,30,9
1715650191036,SOCI 117,A01,494376,Staff,0,5,5,5
1715650192064,WES 237B,A00,494380,Staff,10,0,20,10
1715650194151,AESE 279B,A00,494370,Wade; Jon P,0,0,33,33
1715650195179,AIP 97,001,660915,Van Den Einde; Yael Dahlia,9998,0,9999,1
1715650196207,AIP 197,001,627712,Vespa; Emanuel Ignacio,9995,0,9999,4
1715650196207,AIP 197,002,650778,Amir; On,9998,0,9999,1
1715650196207,AIP 197,003,650933,Avenancio-Leon; Carlos,9998,0,9999,1
1715650196207,AIP 197,004,658530,Heyman; Gail D.,9998,0,9999,1
1715650196207,AIP 197,005,658631,Neal; Sonya E,9998,0,9999,1
1715650196207,AIP 197,006,658671,Du; Songzi,9998,0,9999,1
1715650197236,ANAR 135S,A00,494369,Braswell; Geoffrey E.,0,0,0,0
1715650198262,BENG 196,001,628496,Engler; Adam J.,9998,0,9999,1
1715650198262,BENG 196,002,660916,Watson; John Thomas,9998,0,9999,1
1715650199290,BISP 197,001,650773,Wilhelm; James E.,9994,0,9999,5
1715650199290,BISP 197,002,658904,Coleman; Aaron B.,9998,0,9999,1
1715650200315,CAT 124RS,A01,519847,Geibel; William,0,0,20,20
1715650201343,CAT 125RS,A01,515971,Geibel; William,0,0,20,20
1715650202370,CLRE 250,A00,511389,Morris; Sheldon,9992,0,9999,7
1715650203397,CLRE 251,A00,507176,Mehta; Ravindra L.,9992,0,9999,7
1715650203397,CLRE 251,B00,511410,Mehta; Ravindra L.,9998,0,9999,1
1715650204422,CLRE 252,A00,507189,Cuomo; Raphael Eduardo,9994,0,9999,5
1715650205450,CLRE 253,A00,507199,Vaida; Florin,9994,0,9999,5
1715650205450,CLRE 253,B00,507202,Vaida; Florin,9999,0,9999,0
1715650206483,CLRE 259,A00,507211,Patel; Hemal,9996,0,9999,3
1715650207510,CLRE 260,A00,507221,Cuomo; Raphael Eduardo,9999,0,9999,0
1715650208536,CLRE 297,001,507242,Cuomo; Raphael Eduardo,9999,0,9999,0
1715650209561,COGS 197,001,638244,Voytek; Bradley Thomas,9997,0,9999,2
1715650210585,CSE 191,A00,516875,Minnes Kemp; Mor Mia,9991,0,9999,8
1715650211609,CSE 197,001,637388,Minnes Kemp; Mor Mia,9992,0,9999,7
1715650212637,CSS 201S,A01,494383,Mignozzetti; Umberto,35,0,35,0
1715650213666,CSS 202S,A01,494387,Mignozzetti; Umberto,35,0,35,0
1715650214693,DSC 197,001,628532,Eldridge; Justin Matthew,9995,0,9999,4
1715650215720,EAP 100,A00,516065,Staff,9799,0,9999,200
1715650216750,ECE 45,A01,507414,Staff,32,0,60,28
1715650218801,ECE 111,A01,507420,Staff,11,0,50,39
1715650219825,ECE 197,001,548057,Sievenpiper; Daniel F.,9991,0,9999,8
1715650220851,EDS 115,A00,507243,Choi; Bailey Miyeon,6,0,28,22
1715650221880,EDS 117,A01,494379,Staff,0,6,34,35
1715650222904,EDS 125,A00,507246,Hopkins; Megan Beth,7,0,30,23
1715650223930,EDS 128A,A01,507264,Fargason; Sharon Gayle,5,0,26,21
1715650224955,EDS 128B,A01,507293,Pappas; Elizabeth,9,0,30,21
1715650225981,EDS 139,A00,507294,Fargason; Sharon Gayle,9,0,30,21
1715650225981,EDS 139,B00,507313,Pappas; Elizabeth,9,0,30,21
1715650227009,EDS 201,A00,507315,Staff,10,0,30,20
1715650228037,EDS 203,A01,507317,Halter; Christopher P.,10,0,30,20
1715650229065,EDS 204R,A01,507319,Halter; Christopher P.,0,3,30,30
1715650229065,EDS 204R,B01,507331,Heinzman; Erica M.,14,0,30,16
1715650230089,EDS 206R,A00,507332,Staff,0,4,30,30
1715650230089,EDS 206R,B00,507343,Staff,15,0,30,15
1715650231116,EDS 250,A00,507344,Hemans; Patricia Ann Benitez,20,0,40,20
1715650232142,EDS 281,A00,507345,Daly; Alan J.,18,0,18,0
1715650233168,EDS 284,A00,507350,Daly; Alan J.,16,0,16,0
1715650234193,EDS 286,A00,507359,Fine; Sarah,18,0,18,0
1715650235217,EDS 289C,A01,507361,Daly; Alan J.,18,0,18,0
1715650236247,EDS 290,A00,507366,Hofstetter; Carolyn,15,0,15,0
1715650237274,LIGM 5A,A00,507421,Fischer-Grunski; Eva K,17,0,20,3
1715650238302,LIGM 5B,A00,507423,Fischer-Grunski; Eva K,19,0,20,1
1715650239328,LIGM 5C,A00,507425,Fischer-Grunski; Eva K,19,0,20,1
1715650240353,LIIT 5AS,A00,507427,Carnelos; Chiara,20,0,20,0
1715650241379,LIIT 5BS,A00,507430,Carnelos; Chiara,20,0,20,0
1715650242409,LIIT 5CS,A00,507432,Carnelos; Chiara,20,0,20,0
1715650243434,LISP 5A,A00,507541,Munoz Sanchez; Alicia,11,0,20,9
1715650244460,LISP 5B,A00,507671,Munoz Sanchez; Alicia,8,0,20,12
1715650245484,LISP 5C,A00,507696,Munoz Sanchez; Alicia,8,0,20,12
1715650246512,MAE 197,001,528363,Boechler; Nicholas Sebastia,9998,0,9999,1
1715650247545,MATH 197,001,523477,Kedlaya; Kiran S.,9994,0,9999,5
1715650247545,MATH 197,002,563811,Zhang; Danna,9994,0,9999,5
1715650247545,MATH 197,003,628552,Dumitriu; Ioana,9998,0,9999,1
1715650247545,MATH 197,004,660885,Floyd; Eric,9998,0,9999,1
1715650248575,MCWP 40R,A00,518780,Staff,1,0,20,19
1715650248575,MCWP 40R,B00,518781,Carter; Jennifer A,10,0,20,10
1715650248575,MCWP 40R,C00,518783,Smith; Haydee Marie,5,0,20,15
1715650249607,MCWP 50R,A00,518791,Redela; Pamela Morgan,0,1,20,20
1715650249607,MCWP 50R,B00,518792,Krone; Jarret,0,2,20,20
1715650249607,MCWP 50R,C00,518793,Staff,0,4,20,20
1715650249607,MCWP 50R,D00,518794,Morshed; Michael James,0,2,20,20
1715650249607,MCWP 50R,E00,518795,Carter; Andrea L,0,2,20,20
1715650249607,MCWP 50R,F00,518796,Miller; Elizabeth Deen,0,1,20,20
1715650249607,MCWP 50R,G00,518797,Guillen; Melinda,0,1,20,20
1715650250638,MMW 12R,A01,514034,Herbst; Matthew,0,2,16,16
1715650250638,MMW 12R,A02,514035,Herbst; Matthew,0,0,16,16
1715650251665,MMW 13R,A01,514037,Staff,0,5,16,16
1715650251665,MMW 13R,A02,514039,Staff,0,5,16,16
1715650251665,MMW 13R,A03,628519,Staff,0,4,16,16
1715650253715,SIO 295LS,A00,523233,Staff,10,0,30,20
1715650254738,SIO 295S,A00,523232,Staff,10,0,30,20
1715650255767,SIOC 290S,A01,637330,Merrifield; Mark A,21,0,30,9
1715650256792,SIOC 291S,A01,637333,Gabriel; Corey John,21,0,30,9
1715650257815,SOCI 117,A01,494376,Staff,0,5,5,5
1715650258843,WES 237B,A00,494380,Staff,10,0,20,10
1715650260914,AESE 279B,A00,494370,Wade; Jon P,0,0,33,33
1715650261941,AIP 97,001,660915,Van Den Einde; Yael Dahlia,9998,0,9999,1
1715650262983,AIP 197,001,627712,Vespa; Emanuel Ignacio,9995,0,9999,4
1715650262983,AIP 197,002,650778,Amir; On,9998,0,9999,1
1715650262983,AIP 197,003,650933,Avenancio-Leon; Carlos,9998,0,9999,1
1715650262983,AIP 197,004,658530,Heyman; Gail D.,9998,0,9999,1
1715650262983,AIP 197,005,658631,Neal; Sonya E,9998,0,9999,1
1715650262983,AIP 197,006,658671,Du; Songzi,9998,0,9999,1
1715650264010,ANAR 135S,A00,494369,Braswell; Geoffrey E.,0,0,0,0
1715650265041,BENG 196,001,628496,Engler; Adam J.,9998,0,9999,1
1715650265041,BENG 196,002,660916,Watson; John Thomas,9998,0,9999,1
1715650266067,BISP 197,001,650773,Wilhelm; James E.,9994,0,9999,5
1715650266067,BISP 197,002,658904,Coleman; Aaron B.,9998,0,9999,1
1715650267093,CAT 124RS,A01,519847,Geibel; William,0,0,20,20
1715650268120,CAT 125RS,A01,515971,Geibel; William,0,0,20,20
1715650269145,CLRE 250,A00,511389,Morris; Sheldon,9992,0,9999,7
1715650270175,CLRE 251,A00,507176,Mehta; Ravindra L.,9992,0,9999,7
1715650270175,CLRE 251,B00,511410,Mehta; Ravindra L.,9998,0,9999,1
1715650271202,CLRE 252,A00,507189,Cuomo; Raphael Eduardo,9994,0,9999,5
1715650272227,CLRE 253,A00,507199,Vaida; Florin,9994,0,9999,5
1715650272227,CLRE 253,B00,507202,Vaida; Florin,9999,0,9999,0
1715650273251,CLRE 259,A00,507211,Patel; Hemal,9996,0,9999,3
1715650274277,CLRE 260,A00,507221,Cuomo; Raphael Eduardo,9999,0,9999,0
1715650275302,CLRE 297,001,507242,Cuomo; Raphael Eduardo,9999,0,9999,0
1715650276329,COGS 197,001,638244,Voytek; Bradley Thomas,9997,0,9999,2
1715650277355,CSE 191,A00,516875,Minnes Kemp; Mor Mia,9991,0,9999,8
1715650278379,CSE 197,001,637388,Minnes Kemp; Mor Mia,9992,0,9999,7
1715650279411,CSS 201S,A01,494383,Mignozzetti; Umberto,35,0,35,0
1715650280439,CSS 202S,A01,494387,Mignozzetti; Umberto,35,0,35,0
1715650281465,DSC 197,001,628532,Eldridge; Justin Matthew,9995,0,9999,4
1715650282489,EAP 100,A00,516065,Staff,9799,0,9999,200
1715650283515,ECE 45,A01,507414,Staff,32,0,60,28
1715650285568,ECE 111,A01,507420,Staff,11,0,50,39
1715650286596,ECE 197,001,548057,Sievenpiper; Daniel F.,9991,0,9999,8
1715650287626,EDS 115,A00,507243,Choi; Bailey Miyeon,6,0,28,22
1715650288656,EDS 117,A01,494379,Staff,0,6,34,35
1715650289683,EDS 125,A00,507246,Hopkins; Megan Beth,7,0,30,23
1715650290708,EDS 128A,A01,507264,Fargason; Sharon Gayle,5,0,26,21
1715650291734,EDS 128B,A01,507293,Pappas; Elizabeth,9,0,30,21
1715650292762,EDS 139,A00,507294,Fargason; Sharon Gayle,9,0,30,21
1715650292762,EDS 139,B00,507313,Pappas; Elizabeth,9,0,30,21
1715650293786,EDS 201,A00,507315,Staff,10,0,30,20
1715650294815,EDS 203,A01,507317,Halter; Christopher P.,10,0,30,20
1715650295839,EDS 204R,A01,507319,Halter; Christopher P.,0,3,30,30
1715650295839,EDS 204R,B01,507331,Heinzman; Erica M.,14,0,30,16
1715650296863,EDS 206R,A00,507332,Staff,0,4,30,30
1715650296863,EDS 206R,B00,507343,Staff,15,0,30,15
1715650297890,EDS 250,A00,507344,Hemans; Patricia Ann Benitez,20,0,40,20
1715650298919,EDS 281,A00,507345,Daly; Alan J.,18,0,18,0
1715650299943,EDS 284,A00,507350,Daly; Alan J.,16,0,16,0
1715650300967,EDS 286,A00,507359,Fine; Sarah,18,0,18,0
1715650301997,EDS 289C,A01,507361,Daly; Alan J.,18,0,18,0
1715650303025,EDS 290,A00,507366,Hofstetter; Carolyn,15,0,15,0
1715650304050,LIGM 5A,A00,507421,Fischer-Grunski; Eva K,17,0,20,3
1715650305080,LIGM 5B,A00,507423,Fischer-Grunski; Eva K,19,0,20,1
1715650306107,LIGM 5C,A00,507425,Fischer-Grunski; Eva K,19,0,20,1
1715650307132,LIIT 5AS,A00,507427,Carnelos; Chiara,20,0,20,0
1715650308160,LIIT 5BS,A00,507430,Carnelos; Chiara,20,0,20,0
1715650309190,LIIT 5CS,A00,507432,Carnelos; Chiara,20,0,20,0
1715650310220,LISP 5A,A00,507541,Munoz Sanchez; Alicia,11,0,20,9
1715650311245,LISP 5B,A00,507671,Munoz Sanchez; Alicia,8,0,20,12
1715650312273,LISP 5C,A00,507696,Munoz Sanchez; Alicia,8,0,20,12
1715650313297,MAE 197,001,528363,Boechler; Nicholas Sebastia,9998,0,9999,1
1715650314327,MATH 197,001,523477,Kedlaya; Kiran S.,9994,0,9999,5
1715650314327,MATH 197,002,563811,Zhang; Danna,9994,0,9999,5
1715650314327,MATH 197,003,628552,Dumitriu; Ioana,9998,0,9999,1
1715650314327,MATH 197,004,660885,Floyd; Eric,9998,0,9999,1
1715650315357,MCWP 40R,A00,518780,Staff,1,0,20,19
1715650315357,MCWP 40R,B00,518781,Carter; Jennifer A,10,0,20,10
1715650315357,MCWP 40R,C00,518783,Smith; Haydee Marie,5,0,20,15
1715650316384,MCWP 50R,A00,518791,Redela; Pamela Morgan,0,1,20,20
1715650316384,MCWP 50R,B00,518792,Krone; Jarret,0,2,20,20
1715650316384,MCWP 50R,C00,518793,Staff,0,4,20,20
1715650316384,MCWP 50R,D00,518794,Morshed; Michael James,0,2,20,20
1715650316384,MCWP 50R,E00,518795,Carter; Andrea L,0,2,20,20
1715650316384,MCWP 50R,F00,518796,Miller; Elizabeth Deen,0,1,20,20
1715650316384,MCWP 50R,G00,518797,Guillen; Melinda,0,1,20,20
1715650317409,MMW 12R,A01,514034,Herbst; Matthew,0,2,16,16
1715650317409,MMW 12R,A02,514035,Herbst; Matthew,0,0,16,16
1715650318441,MMW 13R,A01,514037,Staff,0,5,16,16
1715650318441,MMW 13R,A02,514039,Staff,0,5,16,16
1715650318441,MMW 13R,A03,628519,Staff,0,4,16,16
1715650320493,SIO 295LS,A00,523233,Staff,10,0,30,20
1715650321521,SIO 295S,A00,523232,Staff,10,0,30,20
1715650322547,SIOC 290S,A01,637330,Merrifield; Mark A,21,0,30,9
1715650323577,SIOC 291S,A01,637333,Gabriel; Corey John,21,0,30,9
1715650324602,SOCI 117,A01,494376,Staff,0,5,5,5
1715650325626,WES 237B,A00,494380,Staff,10,0,20,10
1715650327695,AESE 279B,A00,494370,Wade; Jon P,0,0,33,33
1715650328720,AIP 97,001,660915,Van Den Einde; Yael Dahlia,9998,0,9999,1
1715650329747,AIP 197,001,627712,Vespa; Emanuel Ignacio,9995,0,9999,4
1715650329747,AIP 197,002,650778,Amir; On,9998,0,9999,1
1715650329747,AIP 197,003,650933,Avenancio-Leon; Carlos,9998,0,9999,1
1715650329747,AIP 197,004,658530,Heyman; Gail D.,9998,0,9999,1
1715650329747,AIP 197,005,658631,Neal; Sonya E,9998,0,9999,1
1715650329747,AIP 197,006,658671,Du; Songzi,9998,0,9999,1
1715650330773,ANAR 135S,A00,494369,Braswell; Geoffrey E.,0,0,0,0
1715650331798,BENG 196,001,628496,Engler; Adam J.,9998,0,9999,1
1715650331798,BENG 196,002,660916,Watson; John Thomas,9998,0,9999,1
1715650332827,BISP 197,001,650773,Wilhelm; James E.,9994,0,9999,5
1715650332827,BISP 197,002,658904,Coleman; Aaron B.,9998,0,9999,1
1715650333853,CAT 124RS,A01,519847,Geibel; William,0,0,20,20
1715650334879,CAT 125RS,A01,515971,Geibel; William,0,0,20,20
1715650335906,CLRE 250,A00,511389,Morris; Sheldon,9992,0,9999,7
1715650336930,CLRE 251,A00,507176,Mehta; Ravindra L.,9992,0,9999,7
1715650336930,CLRE 251,B00,511410,Mehta; Ravindra L.,9998,0,9999,1
1715650337954,CLRE 252,A00,507189,Cuomo; Raphael Eduardo,9994,0,9999,5
1715650338978,CLRE 253,A00,507199,Vaida; Florin,9994,0,9999,5
1715650338978,CLRE 253,B00,507202,Vaida; Florin,9999,0,9999,0
1715650340002,CLRE 259,A00,507211,Patel; Hemal,9996,0,9999,3
1715650341029,CLRE 260,A00,507221,Cuomo; Raphael Eduardo,9999,0,9999,0
1715650342055,CLRE 297,001,507242,Cuomo; Raphael Eduardo,9999,0,9999,0
1715650343081,COGS 197,001,638244,Voytek; Bradley Thomas,9997,0,9999,2
1715650344107,CSE 191,A00,516875,Minnes Kemp; Mor Mia,9991,0,9999,8
1715650345132,CSE 197,001,637388,Minnes Kemp; Mor Mia,9992,0,9999,7
1715650346164,CSS 201S,A01,494383,Mignozzetti; Umberto,35,0,35,0
1715650347195,CSS 202S,A01,494387,Mignozzetti; Umberto,35,0,35,0
1715650348219,DSC 197,001,628532,Eldridge; Justin Matthew,9995,0,9999,4
1715650349242,EAP 100,A00,516065,Staff,9799,0,9999,200
1715650350271,ECE 45,A01,507414,Staff,32,0,60,28
1715650352321,ECE 111,A01,507420,Staff,11,0,50,39
1715650353347,ECE 197,001,548057,Sievenpiper; Daniel F.,9991,0,9999,8
1715650354377,EDS 115,A00,507243,Choi; Bailey Miyeon,6,0,28,22
1715650355403,EDS 117,A01,494379,Staff,0,6,34,35
1715650356429,EDS 125,A00,507246,Hopkins; Megan Beth,7,0,30,23
1715650357457,EDS 128A,A01,507264,Fargason; Sharon Gayle,5,0,26,21
1715650358486,EDS 128B,A01,507293,Pappas; Elizabeth,9,0,30,21
1715650359511,EDS 139,A00,507294,Fargason; Sharon Gayle,9,0,30,21
1715650359511,EDS 139,B00,507313,Pappas; Elizabeth,9,0,30,21
1715650360534,EDS 201,A00,507315,Staff,10,0,30,20
1715650361564,EDS 203,A01,507317,Halter; Christopher P.,10,0,30,20
1715650362591,EDS 204R,A01,507319,Halter; Christopher P.,0,3,30,30
1715650362591,EDS 204R,B01,507331,Heinzman; Erica M.,14,0,30,16
1715650363619,EDS 206R,A00,507332,Staff,0,4,30,30
1715650363619,EDS 206R,B00,507343,Staff,15,0,30,15
1715650364644,EDS 250,A00,507344,Hemans; Patricia Ann Benitez,20,0,40,20
1715650365673,EDS 281,A00,507345,Daly; Alan J.,18,0,18,0
1715650366699,EDS 284,A00,507350,Daly; Alan J.,16,0,16,0
1715650367725,EDS 286,A00,507359,Fine; Sarah,18,0,18,0
1715650368749,EDS 289C,A01,507361,Daly; Alan J.,18,0,18,0
1715650370461,EDS 290,A00,507366,Hofstetter; Carolyn,15,0,15,0
1715650371486,LIGM 5A,A00,507421,Fischer-Grunski; Eva K,17,0,20,3
1715650372513,LIGM 5B,A00,507423,Fischer-Grunski; Eva K,19,0,20,1
1715650373540,LIGM 5C,A00,507425,Fischer-Grunski; Eva K,19,0,20,1
1715650374567,LIIT 5AS,A00,507427,Carnelos; Chiara,20,0,20,0
1715650375596,LIIT 5BS,A00,507430,Carnelos; Chiara,20,0,20,0
1715650376622,LIIT 5CS,A00,507432,Carnelos; Chiara,20,0,20,0
1715650377651,LISP 5A,A00,507541,Munoz Sanchez; Alicia,11,0,20,9
1715650378678,LISP 5B,A00,507671,Munoz Sanchez; Alicia,8,0,20,12
1715650379707,LISP 5C,A00,507696,Munoz Sanchez; Alicia,8,0,20,12
1715650380733,MAE 197,001,528363,Boechler; Nicholas Sebastia,9998,0,9999,1
1715650381762,MATH 197,001,523477,Kedlaya; Kiran S.,9994,0,9999,5
1715650381762,MATH 197,002,563811,Zhang; Danna,9994,0,9999,5
1715650381762,MATH 197,003,628552,Dumitriu; Ioana,9998,0,9999,1
1715650381762,MATH 197,004,660885,Floyd; Eric,9998,0,9999,1
1715650382794,MCWP 40R,A00,518780,Staff,1,0,20,19
1715650382794,MCWP 40R,B00,518781,Carter; Jennifer A,10,0,20,10
1715650382794,MCWP 40R,C00,518783,Smith; Haydee Marie,5,0,20,15
1715650383821,MCWP 50R,A00,518791,Redela; Pamela Morgan,0,1,20,20
1715650383821,MCWP 50R,B00,518792,Krone; Jarret,0,2,20,20
1715650383821,MCWP 50R,C00,518793,Staff,0,4,20,20
1715650383821,MCWP 50R,D00,518794,Morshed; Michael James,0,2,20,20
1715650383821,MCWP 50R,E00,518795,Carter; Andrea L,0,2,20,20
1715650383821,MCWP 50R,F00,518796,Miller; Elizabeth Deen,0,1,20,20
1715650383821,MCWP 50R,G00,518797,Guillen; Melinda,0,1,20,20
1715650384845,MMW 12R,A01,514034,Herbst; Matthew,0,2,16,16
1715650384845,MMW 12R,A02,514035,Herbst; Matthew,0,0,16,16
1715650385873,MMW 13R,A01,514037,Staff,0,5,16,16
1715650385873,MMW 13R,A02,514039,Staff,0,5,16,16
1715650385873,MMW 13R,A03,628519,Staff,0,4,16,16
1715650387923,SIO 295LS,A00,523233,Staff,10,0,30,20
1715650388949,SIO 295S,A00,523232,Staff,10,0,30,20
1715650389980,SIOC 290S,A01,637330,Merrifield; Mark A,21,0,30,9
1715650391007,SIOC 291S,A01,637333,Gabriel; Corey John,21,0,30,9
1715650392033,SOCI 117,A01,494376,Staff,0,5,5,5
1715650393060,WES 237B,A00,494380,Staff,10,0,20,10
1715650395140,AESE 279B,A00,494370,Wade; Jon P,0,0,33,33
1715650396165,AIP 97,001,660915,Van Den Einde; Yael Dahlia,9998,0,9999,1
1715650397195,AIP 197,001,627712,Vespa; Emanuel Ignacio,9995,0,9999,4
1715650397195,AIP 197,002,650778,Amir; On,9998,0,9999,1
1715650397195,AIP 197,003,650933,Avenancio-Leon; Carlos,9998,0,9999,1
1715650397195,AIP 197,004,658530,Heyman; Gail D.,9998,0,9999,1
1715650397195,AIP 197,005,658631,Neal; Sonya E,9998,0,9999,1
1715650397195,AIP 197,006,658671,Du; Songzi,9998,0,9999,1
1715650398221,ANAR 135S,A00,494369,Braswell; Geoffrey E.,0,0,0,0
1715650399248,BENG 196,001,628496,Engler; Adam J.,9998,0,9999,1
1715650399248,BENG 196,002,660916,Watson; John Thomas,9998,0,9999,1
1715650400273,BISP 197,001,650773,Wilhelm; James E.,9994,0,9999,5
1715650400273,BISP 197,002,658904,Coleman; Aaron B.,9998,0,9999,1
1715650401302,CAT 124RS,A01,519847,Geibel; William,0,0,20,20
1715650402327,CAT 125RS,A01,515971,Geibel; William,0,0,20,20
1715650403358,CLRE 250,A00,511389,Morris; Sheldon,9992,0,9999,7
1715650404385,CLRE 251,A00,507176,Mehta; Ravindra L.,9992,0,9999,7
1715650404385,CLRE 251,B00,511410,Mehta; Ravindra L.,9998,0,9999,1
1715650405415,CLRE 252,A00,507189,Cuomo; Raphael Eduardo,9994,0,9999,5
1715650406440,CLRE 253,A00,507199,Vaida; Florin,9994,0,9999,5
1715650406440,CLRE 253,B00,507202,Vaida; Florin,9999,0,9999,0
1715650407466,CLRE 259,A00,507211,Patel; Hemal,9996,0,9999,3
1715650408491,CLRE 260,A00,507221,Cuomo; Raphael Eduardo,9999,0,9999,0
1715650409516,CLRE 297,001,507242,Cuomo; Raphael Eduardo,9999,0,9999,0
1715650410543,COGS 197,001,638244,Voytek; Bradley Thomas,9997,0,9999,2
1715650411572,CSE 191,A00,516875,Minnes Kemp; Mor Mia,9991,0,9999,8
1715650412598,CSE 197,001,637388,Minnes Kemp; Mor Mia,9992,0,9999,7
1715650413625,CSS 201S,A01,494383,Mignozzetti; Umberto,35,0,35,0
1715650414652,CSS 202S,A01,494387,Mignozzetti; Umberto,35,0,35,0
1715650415730,DSC 197,001,628532,Eldridge; Justin Matthew,9995,0,9999,4
1715650416754,EAP 100,A00,516065,Staff,9799,0,9999,200
1715650417786,ECE 45,A01,507414,Staff,32,0,60,28
1715650419839,ECE 111,A01,507420,Staff,11,0,50,39
1715650420866,ECE 197,001,548057,Sievenpiper; Daniel F.,9991,0,9999,8
1715650421894,EDS 115,A00,507243,Choi; Bailey Miyeon,6,0,28,22
1715650422922,EDS 117,A01,494379,Staff,0,6,34,35
1715650423947,EDS 125,A00,507246,Hopkins; Megan Beth,7,0,30,23
1715650424977,EDS 128A,A01,507264,Fargason; Sharon Gayle,5,0,26,21
1715650426002,EDS 128B,A01,507293,Pappas; Elizabeth,9,0,30,21
1715650427027,EDS 139,A00,507294,Fargason; Sharon Gayle,9,0,30,21
1715650427027,EDS 139,B00,507313,Pappas; Elizabeth,9,0,30,21
1715650428051,EDS 201,A00,507315,Staff,10,0,30,20
1715650429077,EDS 203,A01,507317,Halter; Christopher P.,10,0,30,20
1715650430104,EDS 204R,A01,507319,Halter; Christopher P.,0,3,30,30
1715650430104,EDS 204R,B01,507331,Heinzman; Erica M.,14,0,30,16
1715650431130,EDS 206R,A00,507332,Staff,0,4,30,30
1715650431130,EDS 206R,B00,507343,Staff,15,0,30,15
1715650432160,EDS 250,A00,507344,Hemans; Patricia Ann Benitez,20,0,40,20
1715650433186,EDS 281,A00,507345,Daly; Alan J.,18,0,18,0
1715650434211,EDS 284,A00,507350,Daly; Alan J.,16,0,16,0
1715650435240,EDS 286,A00,507359,Fine; Sarah,18,0,18,0
1715650436269,EDS 289C,A01,507361,Daly; Alan J.,18,0,18,0
1715650437299,EDS 290,A00,507366,Hofstetter; Carolyn,15,0,15,0
1715650438326,LIGM 5A,A00,507421,Fischer-Grunski; Eva K,17,0,20,3
1715650439355,LIGM 5B,A00,507423,Fischer-Grunski; Eva K,19,0,20,1
1715650440380,LIGM 5C,A00,507425,Fischer-Grunski; Eva K,19,0,20,1
1715650441410,LIIT 5AS,A00,507427,Carnelos; Chiara,20,0,20,0
1715650442435,LIIT 5BS,A00,507430,Carnelos; Chiara,20,0,20,0
1715650443461,LIIT 5CS,A00,507432,Carnelos; Chiara,20,0,20,0
1715650444494,LISP 5A,A00,507541,Munoz Sanchez; Alicia,11,0,20,9
1715650445519,LISP 5B,A00,507671,Munoz Sanchez; Alicia,8,0,20,12
1715650446547,LISP 5C,A00,507696,Munoz Sanchez; Alicia,8,0,20,12
1715650447577,MAE 197,001,528363,Boechler; Nicholas Sebastia,9998,0,9999,1
1715650448608,MATH 197,001,523477,Kedlaya; Kiran S.,9994,0,9999,5
1715650448608,MATH 197,002,563811,Zhang; Danna,9994,0,9999,5
1715650448608,MATH 197,003,628552,Dumitriu; Ioana,9998,0,9999,1
1715650448608,MATH 197,004,660885,Floyd; Eric,9998,0,9999,1
1715650449634,MCWP 40R,A00,518780,Staff,1,0,20,19
1715650449634,MCWP 40R,B00,518781,Carter; Jennifer A,10,0,20,10
1715650449634,MCWP 40R,C00,518783,Smith; Haydee Marie,5,0,20,15
1715650450663,MCWP 50R,A00,518791,Redela; Pamela Morgan,0,1,20,20
1715650450663,MCWP 50R,B00,518792,Krone; Jarret,0,2,20,20
1715650450663,MCWP 50R,C00,518793,Staff,0,4,20,20
1715650450663,MCWP 50R,D00,518794,Morshed; Michael James,0,2,20,20
1715650450663,MCWP 50R,E00,518795,Carter; Andrea L,0,2,20,20
1715650450663,MCWP 50R,F00,518796,Miller; Elizabeth Deen,0,1,20,20
1715650450663,MCWP 50R,G00,518797,Guillen; Melinda,0,1,20,20
1715650451690,MMW 12R,A01,514034,Herbst; Matthew,0,2,16,16
1715650451690,MMW 12R,A02,514035,Herbst; Matthew,0,0,16,16
1715650452718,MMW 13R,A01,514037,Staff,0,5,16,16
1715650452718,MMW 13R,A02,514039,Staff,0,5,16,16
1715650452718,MMW 13R,A03,628519,Staff,0,4,16,16
1715650454770,SIO 295LS,A00,523233,Staff,10,0,30,20
1715650455798,SIO 295S,A00,523232,Staff,10,0,30,20
1715650456826,SIOC 290S,A01,637330,Merrifield; Mark A,21,0,30,9
1715650457856,SIOC 291S,A01,637333,Gabriel; Corey John,21,0,30,9
1715650458879,SOCI 117,A01,494376,Staff,0,5,5,5
1715650459904,WES 237B,A00,494380,Staff,10,0,20,10
1715650461993,AESE 279B,A00,494370,Wade; Jon P,0,0,33,33
1715650463017,AIP 97,001,660915,Van Den Einde; Yael Dahlia,9998,0,9999,1
1715650464046,AIP 197,001,627712,Vespa; Emanuel Ignacio,9995,0,9999,4
1715650464046,AIP 197,002,650778,Amir; On,9998,0,9999,1
1715650464046,AIP 197,003,650933,Avenancio-Leon; Carlos,9998,0,9999,1
1715650464046,AIP 197,004,658530,Heyman; Gail D.,9998,0,9999,1
1715650464046,AIP 197,005,658631,Neal; Sonya E,9998,0,9999,1
1715650464046,AIP 197,006,658671,Du; Songzi,9998,0,9999,1
1715650465071,ANAR 135S,A00,494369,Braswell; Geoffrey E.,0,0,0,0
1715650466101,BENG 196,001,628496,Engler; Adam J.,9998,0,9999,1
1715650466101,BENG 196,002,660916,Watson; John Thomas,9998,0,9999,1
1715650467125,BISP 197,001,650773,Wilhelm; James E.,9994,0,9999,5
1715650467125,BISP 197,002,658904,Coleman; Aaron B.,9998,0,9999,1
1715650468154,CAT 124RS,A01,519847,Geibel; William,0,0,20,20
1715650469180,CAT 125RS,A01,515971,Geibel; William,0,0,20,20
1715650470205,CLRE 250,A00,511389,Morris; Sheldon,9992,0,9999,7
1715650471231,CLRE 251,A00,507176,Mehta; Ravindra L.,9992,0,9999,7
1715650471231,CLRE 251,B00,511410,Mehta; Ravindra L.,9998,0,9999,1
1715650472260,CLRE 252,A00,507189,Cuomo; Raphael Eduardo,9994,0,9999,5
1715650473285,CLRE 253,A00,507199,Vaida; Florin,9994,0,9999,5
1715650473285,CLRE 253,B00,507202,Vaida; Florin,9999,0,9999,0
1715650474313,CLRE 259,A00,507211,Patel; Hemal,9996,0,9999,3
1715650475340,CLRE 260,A00,507221,Cuomo; Raphael Eduardo,9999,0,9999,0
1715650476367,CLRE 297,001,507242,Cuomo; Raphael Eduardo,9999,0,9999,0
1715650477397,COGS 197,001,638244,Voytek; Bradley Thomas,9997,0,9999,2
1715650478423,CSE 191,A00,516875,Minnes Kemp; Mor Mia,9991,0,9999,8
1715650479449,CSE 197,001,637388,Minnes Kemp; Mor Mia,9992,0,9999,7
1715650480482,CSS 201S,A01,494383,Mignozzetti; Umberto,35,0,35,0
1715650481507,CSS 202S,A01,494387,Mignozzetti; Umberto,35,0,35,0
1715650482533,DSC 197,001,628532,Eldridge; Justin Matthew,9995,0,9999,4
1715650483558,EAP 100,A00,516065,Staff,9799,0,9999,200
1715650484590,ECE 45,A01,507414,Staff,32,0,60,28
1715650486641,ECE 111,A01,507420,Staff,11,0,50,39
1715650487666,ECE 197,001,548057,Sievenpiper; Daniel F.,9991,0,9999,8
1715650488697,EDS 115,A00,507243,Choi; Bailey Miyeon,6,0,28,22
1715650489722,EDS 117,A01,494379,Staff,0,6,34,35
1715650490747,EDS 125,A00,507246,Hopkins; Megan Beth,7,0,30,23
1715650491776,EDS 128A,A01,507264,Fargason; Sharon Gayle,5,0,26,21
1715650492801,EDS 128B,A01,507293,Pappas; Elizabeth,9,0,30,21
1715650493830,EDS 139,A00,507294,Fargason; Sharon Gayle,9,0,30,21
1715650493830,EDS 139,B00,507313,Pappas; Elizabeth,9,0,30,21
1715650494858,EDS 201,A00,507315,Staff,10,0,30,20
1715650495884,EDS 203,A01,507317,Halter; Christopher P.,10,0,30,20
1715650496914,EDS 204R,A01,507319,Halter; Christopher P.,0,3,30,30
1715650496914,EDS 204R,B01,507331,Heinzman; Erica M.,14,0,30,16
1715650497942,EDS 206R,A00,507332,Staff,0,4,30,30
1715650497942,EDS 206R,B00,507343,Staff,15,0,30,15
1715650498967,EDS 250,A00,507344,Hemans; Patricia Ann Benitez,20,0,40,20
1715650499994,EDS 281,A00,507345,Daly; Alan J.,18,0,18,0
1715650501020,EDS 284,A00,507350,Daly; Alan J.,16,0,16,0
1715650502051,EDS 286,A00,507359,Fine; Sarah,18,0,18,0
1715650503077,EDS 289C,A01,507361,Daly; Alan J.,18,0,18,0
1715650504105,EDS 290,A00,507366,Hofstetter; Carolyn,15,0,15,0
1715650505131,LIGM 5A,A00,507421,Fischer-Grunski; Eva K,17,0,20,3
1715650506157,LIGM 5B,A00,507423,Fischer-Grunski; Eva K,19,0,20,1
1715650507192,LIGM 5C,A00,507425,Fischer-Grunski; Eva K,19,0,20,1
1715650508221,LIIT 5AS,A00,507427,Carnelos; Chiara,20,0,20,0
1715650509248,LIIT 5BS,A00,507430,Carnelos; Chiara,20,0,20,0
1715650510274,LIIT 5CS,A00,507432,Carnelos; Chiara,20,0,20,0
1715650511305,LISP 5A,A00,507541,Munoz Sanchez; Alicia,11,0,20,9
1715650512330,LISP 5B,A00,507671,Munoz Sanchez; Alicia,8,0,20,12
1715650513354,LISP 5C,A00,507696,Munoz Sanchez; Alicia,8,0,20,12
1715650514383,MAE 197,001,528363,Boechler; Nicholas Sebastia,9998,0,9999,1
1715650515413,MATH 197,001,523477,Kedlaya; Kiran S.,9994,0,9999,5
1715650515413,MATH 197,002,563811,Zhang; Danna,9994,0,9999,5
1715650515413,MATH 197,003,628552,Dumitriu; Ioana,9998,0,9999,1
1715650515413,MATH 197,004,660885,Floyd; Eric,9998,0,9999,1
1715650516439,MCWP 40R,A00,518780,Staff,1,0,20,19
1715650516439,MCWP 40R,B00,518781,Carter; Jennifer A,10,0,20,10
1715650516439,MCWP 40R,C00,518783,Smith; Haydee Marie,5,0,20,15
1715650517466,MCWP 50R,A00,518791,Redela; Pamela Morgan,0,1,20,20
1715650517466,MCWP 50R,B00,518792,Krone; Jarret,0,2,20,20
1715650517466,MCWP 50R,C00,518793,Staff,0,4,20,20
1715650517466,MCWP 50R,D00,518794,Morshed; Michael James,0,2,20,20
1715650517466,MCWP 50R,E00,518795,Carter; Andrea L,0,2,20,20
1715650517466,MCWP 50R,F00,518796,Miller; Elizabeth Deen,0,1,20,20
1715650517466,MCWP 50R,G00,518797,Guillen; Melinda,0,1,20,20
1715650518493,MMW 12R,A01,514034,Herbst; Matthew,0,2,16,16
1715650518493,MMW 12R,A02,514035,Herbst; Matthew,0,0,16,16
1715650519518,MMW 13R,A01,514037,Staff,0,5,16,16
1715650519518,MMW 13R,A02,514039,Staff,0,5,16,16
1715650519518,MMW 13R,A03,628519,Staff,0,4,16,16
1715650521572,SIO 295LS,A00,523233,Staff,10,0,30,20
1715650522598,SIO 295S,A00,523232,Staff,10,0,30,20
1715650523629,SIOC 290S,A01,637330,Merrifield; Mark A,21,0,30,9
1715650524659,SIOC 291S,A01,637333,Gabriel; Corey John,21,0,30,9
1715650525686,SOCI 117,A01,494376,Staff,0,5,5,5
1715650526714,WES 237B,A00,494380,Staff,10,0,20,10
1715650528794,AESE 279B,A00,494370,Wade; Jon P,0,0,33,33
1715650529819,AIP 97,001,660915,Van Den Einde; Yael Dahlia,9998,0,9999,1
1715650530849,AIP 197,001,627712,Vespa; Emanuel Ignacio,9995,0,9999,4
1715650530849,AIP 197,002,650778,Amir; On,9998,0,9999,1
1715650530849,AIP 197,003,650933,Avenancio-Leon; Carlos,9998,0,9999,1
1715650530849,AIP 197,004,658530,Heyman; Gail D.,9998,0,9999,1
1715650530849,AIP 197,005,658631,Neal; Sonya E,9998,0,9999,1
1715650530849,AIP 197,006,658671,Du; Songzi,9998,0,9999,1
1715650531875,ANAR 135S,A00,494369,Braswell; Geoffrey E.,0,0,0,0
1715650532900,BENG 196,001,628496,Engler; Adam J.,9998,0,9999,1
1715650532900,BENG 196,002,660916,Watson; John Thomas,9998,0,9999,1
1715650533927,BISP 197,001,650773,Wilhelm; James E.,9994,0,9999,5
1715650533927,BISP 197,002,658904,Coleman; Aaron B.,9998,0,9999,1
1715650534956,CAT 124RS,A01,519847,Geibel; William,0,0,20,20
1715650535981,CAT 125RS,A01,515971,Geibel; William,0,0,20,20
1715650537007,CLRE 250,A00,511389,Morris; Sheldon,9992,0,9999,7
1715650538032,CLRE 251,A00,507176,Mehta; Ravindra L.,9992,0,9999,7
1715650538032,CLRE 251,B00,511410,Mehta; Ravindra L.,9998,0,9999,1
1715650539059,CLRE 252,A00,507189,Cuomo; Raphael Eduardo,9994,0,9999,5
1715650540088,CLRE 253,A00,507199,Vaida; Florin,9994,0,9999,5
1715650540088,CLRE 253,B00,507202,Vaida; Florin,9999,0,9999,0
1715650541113,CLRE 259,A00,507211,Patel; Hemal,9996,0,9999,3
1715650542142,CLRE 260,A00,507221,Cuomo; Raphael Eduardo,9999,0,9999,0
1715650543167,CLRE 297,001,507242,Cuomo; Raphael Eduardo,9999,0,9999,0
1715650544192,COGS 197,001,638244,Voytek; Bradley Thomas,9997,0,9999,2
1715650545221,CSE 191,A00,516875,Minnes Kemp; Mor Mia,9991,0,9999,8
1715650546245,CSE 197,001,637388,Minnes Kemp; Mor Mia,9992,0,9999,7
1715650547276,CSS 201S,A01,494383,Mignozzetti; Umberto,35,0,35,0
1715650548304,CSS 202S,A01,494387,Mignozzetti; Umberto,35,0,35,0
1715650549331,DSC 197,001,628532,Eldridge; Justin Matthew,9995,0,9999,4
1715650550356,EAP 100,A00,516065,Staff,9799,0,9999,200
1715650551385,ECE 45,A01,507414,Staff,32,0,60,28
1715650553437,ECE 111,A01,507420,Staff,11,0,50,39
1715650554464,ECE 197,001,548057,Sievenpiper; Daniel F.,9991,0,9999,8
1715650555492,EDS 115,A00,507243,Choi; Bailey Miyeon,6,0,28,22
1715650556521,EDS 117,A01,494379,Staff,0,6,34,35
1715650557547,EDS 125,A00,507246,Hopkins; Megan Beth,7,0,30,23
1715650558571,EDS 128A,A01,507264,Fargason; Sharon Gayle,5,0,26,21
1715650559598,EDS 128B,A01,507293,Pappas; Elizabeth,9,0,30,21
1715650560625,EDS 139,A00,507294,Fargason; Sharon Gayle,9,0,30,21
1715650560625,EDS 139,B00,507313,Pappas; Elizabeth,9,0,30,21
1715650561651,EDS 201,A00,507315,Staff,10,0,30,20
1715650562685,EDS 203,A01,507317,Halter; Christopher P.,10,0,30,20
1715650563711,EDS 204R,A01,507319,Halter; Christopher P.,0,3,30,30
1715650563711,EDS 204R,B01,507331,Heinzman; Erica M.,14,0,30,16
1715650564740,EDS 206R,A00,507332,Staff,0,4,30,30
1715650564740,EDS 206R,B00,507343,Staff,15,0,30,15
1715650565766,EDS 250,A00,507344,Hemans; Patricia Ann Benitez,20,0,40,20
1715650566794,EDS 281,A00,507345,Daly; Alan J.,18,0,18,0
1715650567821,EDS 284,A00,507350,Daly; Alan J.,16,0,16,0
1715650568846,EDS 286,A00,507359,Fine; Sarah,18,0,18,0
1715650569871,EDS 289C,A01,507361,Daly; Alan J.,18,0,18,0
1715650570895,EDS 290,A00,507366,Hofstetter; Carolyn,15,0,15,0
1715650571922,LIGM 5A,A00,507421,Fischer-Grunski; Eva K,17,0,20,3
1715650572953,LIGM 5B,A00,507423,Fischer-Grunski; Eva K,19,0,20,1
1715650573981,LIGM 5C,A00,507425,Fischer-Grunski; Eva K,19,0,20,1
1715650575008,LIIT 5AS,A00,507427,Carnelos; Chiara,20,0,20,0
1715650576033,LIIT 5BS,A00,507430,Carnelos; Chiara,20,0,20,0
1715650577059,LIIT 5CS,A00,507432,Carnelos; Chiara,20,0,20,0
1715650578090,LISP 5A,A00,507541,Munoz Sanchez; Alicia,11,0,20,9
1715650579116,LISP 5B,A00,507671,Munoz Sanchez; Alicia,8,0,20,12
1715650580145,LISP 5C,A00,507696,Munoz Sanchez; Alicia,8,0,20,12
1715650581170,MAE 197,001,528363,Boechler; Nicholas Sebastia,9998,0,9999,1
1715650582210,MATH 197,001,523477,Kedlaya; Kiran S.,9994,0,9999,5
1715650582210,MATH 197,002,563811,Zhang; Danna,9994,0,9999,5
1715650582210,MATH 197,003,628552,Dumitriu; Ioana,9998,0,9999,1
1715650582210,MATH 197,004,660885,Floyd; Eric,9998,0,9999,1
1715650583236,MCWP 40R,A00,518780,Staff,1,0,20,19
1715650583236,MCWP 40R,B00,518781,Carter; Jennifer A,10,0,20,10
1715650583236,MCWP 40R,C00,518783,Smith; Haydee Marie,5,0,20,15
1715650584269,MCWP 50R,A00,518791,Redela; Pamela Morgan,0,1,20,20
1715650584269,MCWP 50R,B00,518792,Krone; Jarret,0,2,20,20
1715650584269,MCWP 50R,C00,518793,Staff,0,4,20,20
1715650584269,MCWP 50R,D00,518794,Morshed; Michael James,0,2,20,20
1715650584269,MCWP 50R,E00,518795,Carter; Andrea L,0,2,20,20
1715650584269,MCWP 50R,F00,518796,Miller; Elizabeth Deen,0,1,20,20
1715650584269,MCWP 50R,G00,518797,Guillen; Melinda,0,1,20,20
1715650585298,MMW 12R,A01,514034,Herbst; Matthew,0,2,16,16
1715650585298,MMW 12R,A02,514035,Herbst; Matthew,0,0,16,16
1715650586324,MMW 13R,A01,514037,Staff,0,5,16,16
1715650586324,MMW 13R,A02,514039,Staff,0,5,16,16
1715650586324,MMW 13R,A03,628519,Staff,0,4,16,16
1715650588377,SIO 295LS,A00,523233,Staff,10,0,30,20
1715650589405,SIO 295S,A00,523232,Staff,10,0,30,20
1715650590431,SIOC 290S,A01,637330,Merrifield; Mark A,21,0,30,9
1715650591458,SIOC 291S,A01,637333,Gabriel; Corey John,21,0,30,9
1715650592486,SOCI 117,A01,494376,Staff,0,5,5,5
1715650593513,WES 237B,A00,494380,Staff,10,0,20,10
1715650595589,AESE 279B,A00,494370,Wade; Jon P,0,0,33,33
1715650596614,AIP 97,001,660915,Van Den Einde; Yael Dahlia,9998,0,9999,1
1715650597643,AIP 197,001,627712,Vespa; Emanuel Ignacio,9995,0,9999,4
1715650597643,AIP 197,002,650778,Amir; On,9998,0,9999,1
1715650597643,AIP 197,003,650933,Avenancio-Leon; Carlos,9998,0,9999,1
1715650597643,AIP 197,004,658530,Heyman; Gail D.,9998,0,9999,1
1715650597643,AIP 197,005,658631,Neal; Sonya E,9998,0,9999,1
1715650597643,AIP 197,006,658671,Du; Songzi,9998,0,9999,1
1715650598669,ANAR 135S,A00,494369,Braswell; Geoffrey E.,0,0,0,0
1715650599695,BENG 196,001,628496,Engler; Adam J.,9998,0,9999,1
1715650599695,BENG 196,002,660916,Watson; John Thomas,9998,0,9999,1
1715650600722,BISP 197,001,650773,Wilhelm; James E.,9994,0,9999,5
1715650600722,BISP 197,002,658904,Coleman; Aaron B.,9998,0,9999,1
1715650601748,CAT 124RS,A01,519847,Geibel; William,0,0,20,20
1715650602773,CAT 125RS,A01,515971,Geibel; William,0,0,20,20
1715650603798,CLRE 250,A00,511389,Morris; Sheldon,9992,0,9999,7
1715650604829,CLRE 251,A00,507176,Mehta; Ravindra L.,9992,0,9999,7
1715650604829,CLRE 251,B00,511410,Mehta; Ravindra L.,9998,0,9999,1
1715650605855,CLRE 252,A00,507189,Cuomo; Raphael Eduardo,9994,0,9999,5
1715650606881,CLRE 253,A00,507199,Vaida; Florin,9994,0,9999,5
1715650606881,CLRE 253,B00,507202,Vaida; Florin,9999,0,9999,0
1715650607907,CLRE 259,A00,507211,Patel; Hemal,9996,0,9999,3
1715650608932,CLRE 260,A00,507221,Cuomo; Raphael Eduardo,9999,0,9999,0
1715650609961,CLRE 297,001,507242,Cuomo; Raphael Eduardo,9999,0,9999,0
1715650610987,COGS 197,001,638244,Voytek; Bradley Thomas,9997,0,9999,2
1715650612014,CSE 191,A00,516875,Minnes Kemp; Mor Mia,9991,0,9999,8
1715650613040,CSE 197,001,637388,Minnes Kemp; Mor Mia,9992,0,9999,7
1715650614070,CSS 201S,A01,494383,Mignozzetti; Umberto,35,0,35,0
1715650615097,CSS 202S,A01,494387,Mignozzetti; Umberto,35,0,35,0
1715650616125,DSC 197,001,628532,Eldridge; Justin Matthew,9995,0,9999,4
1715650617152,EAP 100,A00,516065,Staff,9799,0,9999,200
1715650618178,ECE 45,A01,507414,Staff,32,0,60,28
1715650620231,ECE 111,A01,507420,Staff,11,0,50,39
1715650621257,ECE 197,001,548057,Sievenpiper; Daniel F.,9991,0,9999,8
1715650622285,EDS 115,A00,507243,Choi; Bailey Miyeon,6,0,28,22
1715650623311,EDS 117,A01,494379,Staff,0,6,34,35
1715650624337,EDS 125,A00,507246,Hopkins; Megan Beth,7,0,30,23
1715650625361,EDS 128A,A01,507264,Fargason; Sharon Gayle,5,0,26,21
1715650626389,EDS 128B,A01,507293,Pappas; Elizabeth,9,0,30,21
1715650627414,EDS 139,A00,507294,Fargason; Sharon Gayle,9,0,30,21
1715650627414,EDS 139,B00,507313,Pappas; Elizabeth,9,0,30,21
1715650628440,EDS 201,A00,507315,Staff,10,0,30,20
1715650629467,EDS 203,A01,507317,Halter; Christopher P.,10,0,30,20
1715650630497,EDS 204R,A01,507319,Halter; Christopher P.,0,3,30,30
1715650630497,EDS 204R,B01,507331,Heinzman; Erica M.,14,0,30,16
1715650631526,EDS 206R,A00,507332,Staff,0,4,30,30
1715650631526,EDS 206R,B00,507343,Staff,15,0,30,15
1715650632553,EDS 250,A00,507344,Hemans; Patricia Ann Benitez,20,0,40,20
1715650633578,EDS 281,A00,507345,Daly; Alan J.,18,0,18,0
1715650634603,EDS 284,A00,507350,Daly; Alan J.,16,0,16,0
1715650635628,EDS 286,A00,507359,Fine; Sarah,18,0,18,0
1715650636655,EDS 289C,A01,507361,Daly; Alan J.,18,0,18,0
1715650637681,EDS 290,A00,507366,Hofstetter; Carolyn,15,0,15,0
1715650638711,LIGM 5A,A00,507421,Fischer-Grunski; Eva K,17,0,20,3
1715650639736,LIGM 5B,A00,507423,Fischer-Grunski; Eva K,19,0,20,1
1715650640766,LIGM 5C,A00,507425,Fischer-Grunski; Eva K,19,0,20,1
1715650641795,LIIT 5AS,A00,507427,Carnelos; Chiara,20,0,20,0
1715650642825,LIIT 5BS,A00,507430,Carnelos; Chiara,20,0,20,0
1715650643853,LIIT 5CS,A00,507432,Carnelos; Chiara,20,0,20,0
1715650644879,LISP 5A,A00,507541,Munoz Sanchez; Alicia,11,0,20,9
1715650645907,LISP 5B,A00,507671,Munoz Sanchez; Alicia,8,0,20,12
1715650646932,LISP 5C,A00,507696,Munoz Sanchez; Alicia,8,0,20,12
1715650647957,MAE 197,001,528363,Boechler; Nicholas Sebastia,9998,0,9999,1
1715650648984,MATH 197,001,523477,Kedlaya; Kiran S.,9994,0,9999,5
1715650648984,MATH 197,002,563811,Zhang; Danna,9994,0,9999,5
1715650648984,MATH 197,003,628552,Dumitriu; Ioana,9998,0,9999,1
1715650648984,MATH 197,004,660885,Floyd; Eric,9998,0,9999,1
1715650650010,MCWP 40R,A00,518780,Staff,1,0,20,19
1715650650010,MCWP 40R,B00,518781,Carter; Jennifer A,10,0,20,10
1715650650010,MCWP 40R,C00,518783,Smith; Haydee Marie,5,0,20,15
1715650651044,MCWP 50R,A00,518791,Redela; Pamela Morgan,0,1,20,20
1715650651044,MCWP 50R,B00,518792,Krone; Jarret,0,2,20,20
1715650651044,MCWP 50R,C00,518793,Staff,0,4,20,20
1715650651044,MCWP 50R,D00,518794,Morshed; Michael James,0,2,20,20
1715650651044,MCWP 50R,E00,518795,Carter; Andrea L,0,2,20,20
1715650651044,MCWP 50R,F00,518796,Miller; Elizabeth Deen,0,1,20,20
1715650651044,MCWP 50R,G00,518797,Guillen; Melinda,0,1,20,20
1715650652070,MMW 12R,A01,514034,Herbst; Matthew,0,2,16,16
1715650652070,MMW 12R,A02,514035,Herbst; Matthew,0,0,16,16
1715650653096,MMW 13R,A01,514037,Staff,0,5,16,16
1715650653096,MMW 13R,A02,514039,Staff,0,5,16,16
1715650653096,MMW 13R,A03,628519,Staff,0,4,16,16
1715650655150,SIO 295LS,A00,523233,Staff,10,0,30,20
1715650656178,SIO 295S,A00,523232,Staff,10,0,30,20
1715650657205,SIOC 290S,A01,637330,Merrifield; Mark A,21,0,30,9
1715650658234,SIOC 291S,A01,637333,Gabriel; Corey John,21,0,30,9
1715650659265,SOCI 117,A01,494376,Staff,0,5,5,5
1715650660290,WES 237B,A00,494380,Staff,10,0,20,10
1715650662363,AESE 279B,A00,494370,Wade; Jon P,0,0,33,33
1715650663391,AIP 97,001,660915,Van Den Einde; Yael Dahlia,9998,0,9999,1
1715650664420,AIP 197,001,627712,Vespa; Emanuel Ignacio,9995,0,9999,4
1715650664420,AIP 197,002,650778,Amir; On,9998,0,9999,1
1715650664420,AIP 197,003,650933,Avenancio-Leon; Carlos,9998,0,9999,1
1715650664420,AIP 197,004,658530,Heyman; Gail D.,9998,0,9999,1
1715650664420,AIP 197,005,658631,Neal; Sonya E,9998,0,9999,1
1715650664420,AIP 197,006,658671,Du; Songzi,9998,0,9999,1
1715650665446,ANAR 135S,A00,494369,Braswell; Geoffrey E.,0,0,0,0
1715650666472,BENG 196,001,628496,Engler; Adam J.,9998,0,9999,1
1715650666472,BENG 196,002,660916,Watson; John Thomas,9998,0,9999,1
1715650667500,BISP 197,001,650773,Wilhelm; James E.,9994,0,9999,5
1715650667500,BISP 197,002,658904,Coleman; Aaron B.,9998,0,9999,1
1715650668528,CAT 124RS,A01,519847,Geibel; William,0,0,20,20
1715650669553,CAT 125RS,A01,515971,Geibel; William,0,0,20,20
1715650670578,CLRE 250,A00,511389,Morris; Sheldon,9992,0,9999,7
1715650671605,CLRE 251,A00,507176,Mehta; Ravindra L.,9992,0,9999,7
1715650671605,CLRE 251,B00,511410,Mehta; Ravindra L.,9998,0,9999,1
1715650672630,CLRE 252,A00,507189,Cuomo; Raphael Eduardo,9994,0,9999,5
1715650673655,CLRE 253,A00,507199,Vaida; Florin,9994,0,9999,5
1715650673655,CLRE 253,B00,507202,Vaida; Florin,9999,0,9999,0
1715650674680,CLRE 259,A00,507211,Patel; Hemal,9996,0,9999,3
1715650675703,CLRE 260,A00,507221,Cuomo; Raphael Eduardo,9999,0,9999,0
1715650676727,CLRE 297,001,507242,Cuomo; Raphael Eduardo,9999,0,9999,0
1715650677753,COGS 197,001,638244,Voytek; Bradley Thomas,9997,0,9999,2
1715650678782,CSE 191,A00,516875,Minnes Kemp; Mor Mia,9991,0,9999,8
1715650679811,CSE 197,001,637388,Minnes Kemp; Mor Mia,9992,0,9999,7
1715650680838,CSS 201S,A01,494383,Mignozzetti; Umberto,35,0,35,0
1715650681871,CSS 202S,A01,494387,Mignozzetti; Umberto,35,0,35,0
1715650682897,DSC 197,001,628532,Eldridge; Justin Matthew,9995,0,9999,4
1715650683922,EAP 100,A00,516065,Staff,9799,0,9999,200
1715650684955,ECE 45,A01,507414,Staff,32,0,60,28
1715650687006,ECE 111,A01,507420,Staff,11,0,50,39
1715650688030,ECE 197,001,548057,Sievenpiper; Daniel F.,9991,0,9999,8
1715650689058,EDS 115,A00,507243,Choi; Bailey Miyeon,6,0,28,22
1715650690083,EDS 117,A01,494379,Staff,0,6,34,35
1715650691110,EDS 125,A00,507246,Hopkins; Megan Beth,7,0,30,23
1715650692135,EDS 128A,A01,507264,Fargason; Sharon Gayle,5,0,26,21
1715650693163,EDS 128B,A01,507293,Pappas; Elizabeth,9,0,30,21
1715650694190,EDS 139,A00,507294,Fargason; Sharon Gayle,9,0,30,21
1715650694190,EDS 139,B00,507313,Pappas; Elizabeth,9,0,30,21
1715650695216,EDS 201,A00,507315,Staff,10,0,30,20
1715650696240,EDS 203,A01,507317,Halter; Christopher P.,10,0,30,20
1715650697265,EDS 204R,A01,507319,Halter; Christopher P.,0,3,30,30
1715650697265,EDS 204R,B01,507331,Heinzman; Erica M.,14,0,30,16
1715650698293,EDS 206R,A00,507332,Staff,0,4,30,30
1715650698293,EDS 206R,B00,507343,Staff,15,0,30,15
1715650699322,EDS 250,A00,507344,Hemans; Patricia Ann Benitez,20,0,40,20
1715650700348,EDS 281,A00,507345,Daly; Alan J.,18,0,18,0
1715650701375,EDS 284,A00,507350,Daly; Alan J.,16,0,16,0
1715650702405,EDS 286,A00,507359,Fine; Sarah,18,0,18,0
1715650703435,EDS 289C,A01,507361,Daly; Alan J.,18,0,18,0
1715650704461,EDS 290,A00,507366,Hofstetter; Carolyn,15,0,15,0
1715650705491,LIGM 5A,A00,507421,Fischer-Grunski; Eva K,17,0,20,3
1715650706517,LIGM 5B,A00,507423,Fischer-Grunski; Eva K,19,0,20,1
1715650707546,LIGM 5C,A00,507425,Fischer-Grunski; Eva K,19,0,20,1
1715650708573,LIIT 5AS,A00,507427,Carnelos; Chiara,20,0,20,0
1715650709602,LIIT 5BS,A00,507430,Carnelos; Chiara,20,0,20,0
1715650710631,LIIT 5CS,A00,507432,Carnelos; Chiara,20,0,20,0
1715650711658,LISP 5A,A00,507541,Munoz Sanchez; Alicia,11,0,20,9
1715650712683,LISP 5B,A00,507671,Munoz Sanchez; Alicia,8,0,20,12
1715650713710,LISP 5C,A00,507696,Munoz Sanchez; Alicia,8,0,20,12
1715650714737,MAE 197,001,528363,Boechler; Nicholas Sebastia,9998,0,9999,1
1715650715767,MATH 197,001,523477,Kedlaya; Kiran S.,9994,0,9999,5
1715650715767,MATH 197,002,563811,Zhang; Danna,9994,0,9999,5
1715650715767,MATH 197,003,628552,Dumitriu; Ioana,9998,0,9999,1
1715650715767,MATH 197,004,660885,Floyd; Eric,9998,0,9999,1
1715650716795,MCWP 40R,A00,518780,Staff,1,0,20,19
1715650716795,MCWP 40R,B00,518781,Carter; Jennifer A,10,0,20,10
1715650716795,MCWP 40R,C00,518783,Smith; Haydee Marie,5,0,20,15
1715650717823,MCWP 50R,A00,518791,Redela; Pamela Morgan,0,1,20,20
1715650717823,MCWP 50R,B00,518792,Krone; Jarret,0,2,20,20
1715650717823,MCWP 50R,C00,518793,Staff,0,4,20,20
1715650717823,MCWP 50R,D00,518794,Morshed; Michael James,0,2,20,20
1715650717823,MCWP 50R,E00,518795,Carter; Andrea L,0,2,20,20
1715650717823,MCWP 50R,F00,518796,Miller; Elizabeth Deen,0,1,20,20
1715650717823,MCWP 50R,G00,518797,Guillen; Melinda,0,1,20,20
1715650718850,MMW 12R,A01,514034,Herbst; Matthew,0,2,16,16
1715650718850,MMW 12R,A02,514035,Herbst; Matthew,0,0,16,16
1715650719875,MMW 13R,A01,514037,Staff,0,5,16,16
1715650719875,MMW 13R,A02,514039,Staff,0,5,16,16
1715650719875,MMW 13R,A03,628519,Staff,0,4,16,16
1715650721926,SIO 295LS,A00,523233,Staff,10,0,30,20
1715650722955,SIO 295S,A00,523232,Staff,10,0,30,20
1715650723980,SIOC 290S,A01,637330,Merrifield; Mark A,21,0,30,9
1715650725007,SIOC 291S,A01,637333,Gabriel; Corey John,21,0,30,9
1715650726035,SOCI 117,A01,494376,Staff,0,5,5,5
1715650727135,WES 237B,A00,494380,Staff,10,0,20,10
1715650729197,AESE 279B,A00,494370,Wade; Jon P,0,0,33,33
1715650730228,AIP 97,001,660915,Van Den Einde; Yael Dahlia,9998,0,9999,1
1715650731262,AIP 197,001,627712,Vespa; Emanuel Ignacio,9995,0,9999,4
1715650731262,AIP 197,002,650778,Amir; On,9998,0,9999,1
1715650731262,AIP 197,003,650933,Avenancio-Leon; Carlos,9998,0,9999,1
1715650731262,AIP 197,004,658530,Heyman; Gail D.,9998,0,9999,1
1715650731262,AIP 197,005,658631,Neal; Sonya E,9998,0,9999,1
1715650731262,AIP 197,006,658671,Du; Songzi,9998,0,9999,1
1715650732290,ANAR 135S,A00,494369,Braswell; Geoffrey E.,0,0,0,0
1715650733317,BENG 196,001,628496,Engler; Adam J.,9998,0,9999,1
1715650733317,BENG 196,002,660916,Watson; John Thomas,9998,0,9999,1
1715650734343,BISP 197,001,650773,Wilhelm; James E.,9994,0,9999,5
1715650734343,BISP 197,002,658904,Coleman; Aaron B.,9998,0,9999,1
1715650735371,CAT 124RS,A01,519847,Geibel; William,0,0,20,20
1715650736396,CAT 125RS,A01,515971,Geibel; William,0,0,20,20
1715650737422,CLRE 250,A00,511389,Morris; Sheldon,9992,0,9999,7
1715650738450,CLRE 251,A00,507176,Mehta; Ravindra L.,9992,0,9999,7
1715650738450,CLRE 251,B00,511410,Mehta; Ravindra L.,9998,0,9999,1
1715650739477,CLRE 252,A00,507189,Cuomo; Raphael Eduardo,9994,0,9999,5
1715650740508,CLRE 253,A00,507199,Vaida; Florin,9994,0,9999,5
1715650740508,CLRE 253,B00,507202,Vaida; Florin,9999,0,9999,0
1715650741537,CLRE 259,A00,507211,Patel; Hemal,9996,0,9999,3
1715650742564,CLRE 260,A00,507221,Cuomo; Raphael Eduardo,9999,0,9999,0
1715650743594,CLRE 297,001,507242,Cuomo; Raphael Eduardo,9999,0,9999,0
1715650744623,COGS 197,001,638244,Voytek; Bradley Thomas,9997,0,9999,2
1715650745649,CSE 191,A00,516875,Minnes Kemp; Mor Mia,9991,0,9999,8
1715650746675,CSE 197,001,637388,Minnes Kemp; Mor Mia,9992,0,9999,7
1715650747703,CSS 201S,A01,494383,Mignozzetti; Umberto,35,0,35,0
1715650748730,CSS 202S,A01,494387,Mignozzetti; Umberto,35,0,35,0
1715650749762,DSC 197,001,628532,Eldridge; Justin Matthew,9995,0,9999,4
1715650750787,EAP 100,A00,516065,Staff,9799,0,9999,200
1715650751820,ECE 45,A01,507414,Staff,32,0,60,28
1715650753879,ECE 111,A01,507420,Staff,11,0,50,39
1715650754908,ECE 197,001,548057,Sievenpiper; Daniel F.,9991,0,9999,8
1715650755935,EDS 115,A00,507243,Choi; Bailey Miyeon,6,0,28,22
1715650756962,EDS 117,A01,494379,Staff,0,6,34,35
1715650757991,EDS 125,A00,507246,Hopkins; Megan Beth,7,0,30,23
1715650759020,EDS 128A,A01,507264,Fargason; Sharon Gayle,5,0,26,21
1715650760045,EDS 128B,A01,507293,Pappas; Elizabeth,9,0,30,21
1715650761071,EDS 139,A00,507294,Fargason; Sharon Gayle,9,0,30,21
1715650761071,EDS 139,B00,507313,Pappas; Elizabeth,9,0,30,21
1715650762097,EDS 201,A00,507315,Staff,10,0,30,20
1715650763125,EDS 203,A01,507317,Halter; Christopher P.,10,0,30,20
1715650764150,EDS 204R,A01,507319,Halter; Christopher P.,0,3,30,30
1715650764150,EDS 204R,B01,507331,Heinzman; Erica M.,14,0,30,16
1715650765176,EDS 206R,A00,507332,Staff,0,4,30,30
1715650765176,EDS 206R,B00,507343,Staff,15,0,30,15
1715650766202,EDS 250,A00,507344,Hemans; Patricia Ann Benitez,20,0,40,20
1715650767226,EDS 281,A00,507345,Daly; Alan J.,18,0,18,0
1715650768251,EDS 284,A00,507350,Daly; Alan J.,16,0,16,0
1715650769280,EDS 286,A00,507359,Fine; Sarah,18,0,18,0
1715650770306,EDS 289C,A01,507361,Daly; Alan J.,18,0,18,0
1715650771333,EDS 290,A00,507366,Hofstetter; Carolyn,15,0,15,0
1715650772363,LIGM 5A,A00,507421,Fischer-Grunski; Eva K,17,0,20,3
1715650773391,LIGM 5B,A00,507423,Fischer-Grunski; Eva K,19,0,20,1
1715650774415,LIGM 5C,A00,507425,Fischer-Grunski; Eva K,19,0,20,1
1715650775445,LIIT 5AS,A00,507427,Carnelos; Chiara,20,0,20,0
1715650776475,LIIT 5BS,A00,507430,Carnelos; Chiara,20,0,20,0
1715650777501,LIIT 5CS,A00,507432,Carnelos; Chiara,20,0,20,0
1715650778527,LISP 5A,A00,507541,Munoz Sanchez; Alicia,11,0,20,9
1715650779553,LISP 5B,A00,507671,Munoz Sanchez; Alicia,8,0,20,12
1715650780578,LISP 5C,A00,507696,Munoz Sanchez; Alicia,8,0,20,12
1715650781606,MAE 197,001,528363,Boechler; Nicholas Sebastia,9998,0,9999,1
1715650782635,MATH 197,001,523477,Kedlaya; Kiran S.,9994,0,9999,5
1715650782635,MATH 197,002,563811,Zhang; Danna,9994,0,9999,5
1715650782635,MATH 197,003,628552,Dumitriu; Ioana,9998,0,9999,1
1715650782635,MATH 197,004,660885,Floyd; Eric,9998,0,9999,1
1715650783666,MCWP 40R,A00,518780,Staff,1,0,20,19
1715650783666,MCWP 40R,B00,518781,Carter; Jennifer A,10,0,20,10
1715650783666,MCWP 40R,C00,518783,Smith; Haydee Marie,5,0,20,15
1715650784697,MCWP 50R,A00,518791,Redela; Pamela Morgan,0,1,20,20
1715650784697,MCWP 50R,B00,518792,Krone; Jarret,0,2,20,20
1715650784697,MCWP 50R,C00,518793,Staff,0,4,20,20
1715650784697,MCWP 50R,D00,518794,Morshed; Michael James,0,2,20,20
1715650784697,MCWP 50R,E00,518795,Carter; Andrea L,0,2,20,20
1715650784697,MCWP 50R,F00,518796,Miller; Elizabeth Deen,0,1,20,20
1715650784697,MCWP 50R,G00,518797,Guillen; Melinda,0,1,20,20
1715650785728,MMW 12R,A01,514034,Herbst; Matthew,0,2,16,16
1715650785728,MMW 12R,A02,514035,Herbst; Matthew,0,0,16,16
1715650786754,MMW 13R,A01,514037,Staff,0,5,16,16
1715650786754,MMW 13R,A02,514039,Staff,0,5,16,16
1715650786754,MMW 13R,A03,628519,Staff,0,4,16,16
1715650788804,SIO 295LS,A00,523233,Staff,10,0,30,20
1715650789830,SIO 295S,A00,523232,Staff,10,0,30,20
1715650790856,SIOC 290S,A01,637330,Merrifield; Mark A,21,0,30,9
1715650791882,SIOC 291S,A01,637333,Gabriel; Corey John,21,0,30,9
1715650792911,SOCI 117,A01,494376,Staff,0,5,5,5
1715650793939,WES 237B,A00,494380,Staff,10,0,20,10
1715650796020,AESE 279B,A00,494370,Wade; Jon P,0,0,33,33
1715650797043,AIP 97,001,660915,Van Den Einde; Yael Dahlia,9998,0,9999,1
1715650798070,AIP 197,001,627712,Vespa; Emanuel Ignacio,9995,0,9999,4
1715650798070,AIP 197,002,650778,Amir; On,9998,0,9999,1
1715650798070,AIP 197,003,650933,Avenancio-Leon; Carlos,9998,0,9999,1
1715650798070,AIP 197,004,658530,Heyman; Gail D.,9998,0,9999,1
1715650798070,AIP 197,005,658631,Neal; Sonya E,9998,0,9999,1
1715650798070,AIP 197,006,658671,Du; Songzi,9998,0,9999,1
1715650799099,ANAR 135S,A00,494369,Braswell; Geoffrey E.,0,0,0,0
1715650800123,BENG 196,001,628496,Engler; Adam J.,9998,0,9999,1
1715650800123,BENG 196,002,660916,Watson; John Thomas,9998,0,9999,1
1715650801150,BISP 197,001,650773,Wilhelm; James E.,9994,0,9999,5
1715650801150,BISP 197,002,658904,Coleman; Aaron B.,9998,0,9999,1
1715650802178,CAT 124RS,A01,519847,Geibel; William,0,0,20,20
1715650803204,CAT 125RS,A01,515971,Geibel; William,0,0,20,20
1715650804234,CLRE 250,A00,511389,Morris; Sheldon,9992,0,9999,7
1715650805261,CLRE 251,A00,507176,Mehta; Ravindra L.,9992,0,9999,7
1715650805261,CLRE 251,B00,511410,Mehta; Ravindra L.,9998,0,9999,1
1715650806287,CLRE 252,A00,507189,Cuomo; Raphael Eduardo,9994,0,9999,5
1715650807317,CLRE 253,A00,507199,Vaida; Florin,9994,0,9999,5
1715650807317,CLRE 253,B00,507202,Vaida; Florin,9999,0,9999,0
1715650808341,CLRE 259,A00,507211,Patel; Hemal,9996,0,9999,3
1715650809365,CLRE 260,A00,507221,Cuomo; Raphael Eduardo,9999,0,9999,0
1715650810391,CLRE 297,001,507242,Cuomo; Raphael Eduardo,9999,0,9999,0
1715650811417,COGS 197,001,638244,Voytek; Bradley Thomas,9997,0,9999,2
1715650812446,CSE 191,A00,516875,Minnes Kemp; Mor Mia,9991,0,9999,8
1715650813472,CSE 197,001,637388,Minnes Kemp; Mor Mia,9992,0,9999,7
1715650814503,CSS 201S,A01,494383,Mignozzetti; Umberto,35,0,35,0
1715650815529,CSS 202S,A01,494387,Mignozzetti; Umberto,35,0,35,0
1715650816553,DSC 197,001,628532,Eldridge; Justin Matthew,9995,0,9999,4
1715650817580,EAP 100,A00,516065,Staff,9799,0,9999,200
1715650818610,ECE 45,A01,507414,Staff,32,0,60,28
1715650820661,ECE 111,A01,507420,Staff,11,0,50,39
1715650821687,ECE 197,001,548057,Sievenpiper; Daniel F.,9991,0,9999,8
1715650822712,EDS 115,A00,507243,Choi; Bailey Miyeon,6,0,28,22
1715650823743,EDS 117,A01,494379,Staff,0,6,34,35
1715650824769,EDS 125,A00,507246,Hopkins; Megan Beth,7,0,30,23
1715650825794,EDS 128A,A01,507264,Fargason; Sharon Gayle,5,0,26,21
1715650826823,EDS 128B,A01,507293,Pappas; Elizabeth,9,0,30,21
1715650827848,EDS 139,A00,507294,Fargason; Sharon Gayle,9,0,30,21
1715650827848,EDS 139,B00,507313,Pappas; Elizabeth,9,0,30,21
1715650828871,EDS 201,A00,507315,Staff,10,0,30,20
1715650829898,EDS 203,A01,507317,Halter; Christopher P.,10,0,30,20
1715650830983,EDS 204R,A01,507319,Halter; Christopher P.,0,3,30,30
1715650830983,EDS 204R,B01,507331,Heinzman; Erica M.,14,0,30,16
1715650832008,EDS 206R,A00,507332,Staff,0,4,30,30
1715650832008,EDS 206R,B00,507343,Staff,15,0,30,15
1715650833034,EDS 250,A00,507344,Hemans; Patricia Ann Benitez,20,0,40,20
1715650834063,EDS 281,A00,507345,Daly; Alan J.,18,0,18,0
1715650835091,EDS 284,A00,507350,Daly; Alan J.,16,0,16,0
1715650836121,EDS 286,A00,507359,Fine; Sarah,18,0,18,0
1715650837148,EDS 289C,A01,507361,Daly; Alan J.,18,0,18,0
1715650838174,EDS 290,A00,507366,Hofstetter; Carolyn,15,0,15,0
1715650839203,LIGM 5A,A00,507421,Fischer-Grunski; Eva K,17,0,20,3
1715650840228,LIGM 5B,A00,507423,Fischer-Grunski; Eva K,19,0,20,1
1715650841259,LIGM 5C,A00,507425,Fischer-Grunski; Eva K,19,0,20,1
1715650842290,LIIT 5AS,A00,507427,Carnelos; Chiara,20,0,20,0
1715650843316,LIIT 5BS,A00,507430,Carnelos; Chiara,20,0,20,0
1715650844342,LIIT 5CS,A00,507432,Carnelos; Chiara,20,0,20,0
1715650845371,LISP 5A,A00,507541,Munoz Sanchez; Alicia,11,0,20,9
1715650846398,LISP 5B,A00,507671,Munoz Sanchez; Alicia,8,0,20,12
1715650847422,LISP 5C,A00,507696,Munoz Sanchez; Alicia,8,0,20,12
1715650848450,MAE 197,001,528363,Boechler; Nicholas Sebastia,9998,0,9999,1
1715650849479,MATH 197,001,523477,Kedlaya; Kiran S.,9994,0,9999,5
1715650849479,MATH 197,002,563811,Zhang; Danna,9994,0,9999,5
1715650849479,MATH 197,003,628552,Dumitriu; Ioana,9998,0,9999,1
1715650849479,MATH 197,004,660885,Floyd; Eric,9998,0,9999,1
1715650850509,MCWP 40R,A00,518780,Staff,1,0,20,19
1715650850509,MCWP 40R,B00,518781,Carter; Jennifer A,10,0,20,10
1715650850509,MCWP 40R,C00,518783,Smith; Haydee Marie,5,0,20,15
1715650851643,MCWP 50R,A00,518791,Redela; Pamela Morgan,0,1,20,20
1715650851643,MCWP 50R,B00,518792,Krone; Jarret,0,2,20,20
1715650851643,MCWP 50R,C00,518793,Staff,0,4,20,20
1715650851643,MCWP 50R,D00,518794,Morshed; Michael James,0,2,20,20
1715650851643,MCWP 50R,E00,518795,Carter; Andrea L,0,2,20,20
1715650851643,MCWP 50R,F00,518796,Miller; Elizabeth Deen,0,1,20,20
1715650851643,MCWP 50R,G00,518797,Guillen; Melinda,0,1,20,20
1715650852669,MMW 12R,A01,514034,Herbst; Matthew,0,2,16,16
1715650852669,MMW 12R,A02,514035,Herbst; Matthew,0,0,16,16
1715650853694,MMW 13R,A01,514037,Staff,0,5,16,16
1715650853694,MMW 13R,A02,514039,Staff,0,5,16,16
1715650853694,MMW 13R,A03,628519,Staff,0,4,16,16
1715650855746,SIO 295LS,A00,523233,Staff,10,0,30,20
1715650856773,SIO 295S,A00,523232,Staff,10,0,30,20
1715650857801,SIOC 290S,A01,637330,Merrifield; Mark A,21,0,30,9
1715650858827,SIOC 291S,A01,637333,Gabriel; Corey John,21,0,30,9
1715650859853,SOCI 117,A01,494376,Staff,0,5,5,5
1715650860880,WES 237B,A00,494380,Staff,10,0,20,10
1715650862960,AESE 279B,A00,494370,Wade; Jon P,0,0,33,33
1715650863986,AIP 97,001,660915,Van Den Einde; Yael Dahlia,9998,0,9999,1
1715650865015,AIP 197,001,627712,Vespa; Emanuel Ignacio,9995,0,9999,4
1715650865015,AIP 197,002,650778,Amir; On,9998,0,9999,1
1715650865015,AIP 197,003,650933,Avenancio-Leon; Carlos,9998,0,9999,1
1715650865015,AIP 197,004,658530,Heyman; Gail D.,9998,0,9999,1
1715650865015,AIP 197,005,658631,Neal; Sonya E,9998,0,9999,1
1715650865015,AIP 197,006,658671,Du; Songzi,9998,0,9999,1
1715650866039,ANAR 135S,A00,494369,Braswell; Geoffrey E.,0,0,0,0
1715650867065,BENG 196,001,628496,Engler; Adam J.,9998,0,9999,1
1715650867065,BENG 196,002,660916,Watson; John Thomas,9998,0,9999,1
1715650868091,BISP 197,001,650773,Wilhelm; James E.,9994,0,9999,5
1715650868091,BISP 197,002,658904,Coleman; Aaron B.,9998,0,9999,1
1715650869118,CAT 124RS,A01,519847,Geibel; William,0,0,20,20
1715650870142,CAT 125RS,A01,515971,Geibel; William,0,0,20,20
1715650871167,CLRE 250,A00,511389,Morris; Sheldon,9992,0,9999,7
1715650872195,CLRE 251,A00,507176,Mehta; Ravindra L.,9992,0,9999,7
1715650872195,CLRE 251,B00,511410,Mehta; Ravindra L.,9998,0,9999,1
1715650873225,CLRE 252,A00,507189,Cuomo; Raphael Eduardo,9994,0,9999,5
1715650874250,CLRE 253,A00,507199,Vaida; Florin,9994,0,9999,5
1715650874250,CLRE 253,B00,507202,Vaida; Florin,9999,0,9999,0
1715650875274,CLRE 259,A00,507211,Patel; Hemal,9996,0,9999,3
1715650876303,CLRE 260,A00,507221,Cuomo; Raphael Eduardo,9999,0,9999,0
1715650877331,CLRE 297,001,507242,Cuomo; Raphael Eduardo,9999,0,9999,0
1715650878357,COGS 197,001,638244,Voytek; Bradley Thomas,9997,0,9999,2
1715650879386,CSE 191,A00,516875,Minnes Kemp; Mor Mia,9991,0,9999,8
1715650880411,CSE 197,001,637388,Minnes Kemp; Mor Mia,9992,0,9999,7
1715650881439,CSS 201S,A01,494383,Mignozzetti; Umberto,35,0,35,0
1715650882467,CSS 202S,A01,494387,Mignozzetti; Umberto,35,0,35,0
1715650883494,DSC 197,001,628532,Eldridge; Justin Matthew,9995,0,9999,4
1715650884521,EAP 100,A00,516065,Staff,9799,0,9999,200
1715650885548,ECE 45,A01,507414,Staff,32,0,60,28
1715650887600,ECE 111,A01,507420,Staff,11,0,50,39
1715650888626,ECE 197,001,548057,Sievenpiper; Daniel F.,9991,0,9999,8
1715650889654,EDS 115,A00,507243,Choi; Bailey Miyeon,6,0,28,22
1715650890678,EDS 117,A01,494379,Staff,0,6,34,35
1715650891709,EDS 125,A00,507246,Hopkins; Megan Beth,7,0,30,23
1715650892740,EDS 128A,A01,507264,Fargason; Sharon Gayle,5,0,26,21
1715650893772,EDS 128B,A01,507293,Pappas; Elizabeth,9,0,30,21
1715650894798,EDS 139,A00,507294,Fargason; Sharon Gayle,9,0,30,21
1715650894798,EDS 139,B00,507313,Pappas; Elizabeth,9,0,30,21
1715650895826,EDS 201,A00,507315,Staff,10,0,30,20
1715650896857,EDS 203,A01,507317,Halter; Christopher P.,10,0,30,20
1715650897883,EDS 204R,A01,507319,Halter; Christopher P.,0,3,30,30
1715650897883,EDS 204R,B01,507331,Heinzman; Erica M.,14,0,30,16
1715650898909,EDS 206R,A00,507332,Staff,0,4,30,30
1715650898909,EDS 206R,B00,507343,Staff,15,0,30,15
1715650899938,EDS 250,A00,507344,Hemans; Patricia Ann Benitez,20,0,40,20
1715650900962,EDS 281,A00,507345,Daly; Alan J.,18,0,18,0
1715650901988,EDS 284,A00,507350,Daly; Alan J.,16,0,16,0
1715650903015,EDS 286,A00,507359,Fine; Sarah,18,0,18,0
1715650904041,EDS 289C,A01,507361,Daly; Alan J.,18,0,18,0
1715650905066,EDS 290,A00,507366,Hofstetter; Carolyn,15,0,15,0
1715650906093,LIGM 5A,A00,507421,Fischer-Grunski; Eva K,17,0,20,3
1715650907121,LIGM 5B,A00,507423,Fischer-Grunski; Eva K,19,0,20,1
1715650908145,LIGM 5C,A00,507425,Fischer-Grunski; Eva K,19,0,20,1
1715650909170,LIIT 5AS,A00,507427,Carnelos; Chiara,20,0,20,0
1715650910195,LIIT 5BS,A00,507430,Carnelos; Chiara,20,0,20,0
1715650911225,LIIT 5CS,A00,507432,Carnelos; Chiara,20,0,20,0
1715650912250,LISP 5A,A00,507541,Munoz Sanchez; Alicia,11,0,20,9
1715650913279,LISP 5B,A00,507671,Munoz Sanchez; Alicia,8,0,20,12
1715650914306,LISP 5C,A00,507696,Munoz Sanchez; Alicia,8,0,20,12
1715650915331,MAE 197,001,528363,Boechler; Nicholas Sebastia,9998,0,9999,1
1715650916359,MATH 197,001,523477,Kedlaya; Kiran S.,9994,0,9999,5
1715650916359,MATH 197,002,563811,Zhang; Danna,9994,0,9999,5
1715650916359,MATH 197,003,628552,Dumitriu; Ioana,9998,0,9999,1
1715650916359,MATH 197,004,660885,Floyd; Eric,9998,0,9999,1
1715650917389,MCWP 40R,A00,518780,Staff,1,0,20,19
1715650917389,MCWP 40R,B00,518781,Carter; Jennifer A,10,0,20,10
1715650917389,MCWP 40R,C00,518783,Smith; Haydee Marie,5,0,20,15
1715650918414,MCWP 50R,A00,518791,Redela; Pamela Morgan,0,1,20,20
1715650918414,MCWP 50R,B00,518792,Krone; Jarret,0,2,20,20
1715650918414,MCWP 50R,C00,518793,Staff,0,4,20,20
1715650918414,MCWP 50R,D00,518794,Morshed; Michael James,0,2,20,20
1715650918414,MCWP 50R,E00,518795,Carter; Andrea L,0,2,20,20
1715650918414,MCWP 50R,F00,518796,Miller; Elizabeth Deen,0,1,20,20
1715650918414,MCWP 50R,G00,518797,Guillen; Melinda,0,1,20,20
1715650919443,MMW 12R,A01,514034,Herbst; Matthew,0,2,16,16
1715650919443,MMW 12R,A02,514035,Herbst; Matthew,0,0,16,16
1715650920471,MMW 13R,A01,514037,Staff,0,5,16,16
1715650920471,MMW 13R,A02,514039,Staff,0,5,16,16
1715650920471,MMW 13R,A03,628519,Staff,0,4,16,16
1715650922527,SIO 295LS,A00,523233,Staff,10,0,30,20
1715650923550,SIO 295S,A00,523232,Staff,10,0,30,20
1715650924576,SIOC 290S,A01,637330,Merrifield; Mark A,21,0,30,9
1715650925602,SIOC 291S,A01,637333,Gabriel; Corey John,21,0,30,9
1715650926626,SOCI 117,A01,494376,Staff,0,5,5,5
1715650927653,WES 237B,A00,494380,Staff,10,0,20,10
1715650929731,AESE 279B,A00,494370,Wade; Jon P,0,0,33,33
1715650930758,AIP 97,001,660915,Van Den Einde; Yael Dahlia,9998,0,9999,1
1715650931786,AIP 197,001,627712,Vespa; Emanuel Ignacio,9995,0,9999,4
1715650931786,AIP 197,002,650778,Amir; On,9998,0,9999,1
1715650931786,AIP 197,003,650933,Avenancio-Leon; Carlos,9998,0,9999,1
1715650931786,AIP 197,004,658530,Heyman; Gail D.,9998,0,9999,1
1715650931786,AIP 197,005,658631,Neal; Sonya E,9998,0,9999,1
1715650931786,AIP 197,006,658671,Du; Songzi,9998,0,9999,1
1715650932813,ANAR 135S,A00,494369,Braswell; Geoffrey E.,0,0,0,0
1715650933838,BENG 196,001,628496,Engler; Adam J.,9998,0,9999,1
1715650933838,BENG 196,002,660916,Watson; John Thomas,9998,0,9999,1
1715650934917,BISP 197,001,650773,Wilhelm; James E.,9994,0,9999,5
1715650934917,BISP 197,002,658904,Coleman; Aaron B.,9998,0,9999,1
1715650935948,CAT 124RS,A01,519847,Geibel; William,0,0,20,20
1715650936977,CAT 125RS,A01,515971,Geibel; William,0,0,20,20
1715650938009,CLRE 250,A00,511389,Morris; Sheldon,9992,0,9999,7
1715650939037,CLRE 251,A00,507176,Mehta; Ravindra L.,9992,0,9999,7
1715650939037,CLRE 251,B00,511410,Mehta; Ravindra L.,9998,0,9999,1
1715650940064,CLRE 252,A00,507189,Cuomo; Raphael Eduardo,9994,0,9999,5
1715650941094,CLRE 253,A00,507199,Vaida; Florin,9994,0,9999,5
1715650941094,CLRE 253,B00,507202,Vaida; Florin,9999,0,9999,0
1715650942122,CLRE 259,A00,507211,Patel; Hemal,9996,0,9999,3
1715650943151,CLRE 260,A00,507221,Cuomo; Raphael Eduardo,9999,0,9999,0
1715650944179,CLRE 297,001,507242,Cuomo; Raphael Eduardo,9999,0,9999,0
1715650945207,COGS 197,001,638244,Voytek; Bradley Thomas,9997,0,9999,2
1715650946233,CSE 191,A00,516875,Minnes Kemp; Mor Mia,9991,0,9999,8
1715650947258,CSE 197,001,637388,Minnes Kemp; Mor Mia,9992,0,9999,7
1715650948291,CSS 201S,A01,494383,Mignozzetti; Umberto,35,0,35,0
1715650949320,CSS 202S,A01,494387,Mignozzetti; Umberto,35,0,35,0
1715650950345,DSC 197,001,628532,Eldridge; Justin Matthew,9995,0,9999,4
1715650951369,EAP 100,A00,516065,Staff,9799,0,9999,200
1715650952402,ECE 45,A01,507414,Staff,32,0,60,28
1715650954456,ECE 111,A01,507420,Staff,11,0,50,39
1715650955480,ECE 197,001,548057,Sievenpiper; Daniel F.,9991,0,9999,8
1715650956511,EDS 115,A00,507243,Choi; Bailey Miyeon,6,0,28,22
1715650957539,EDS 117,A01,494379,Staff,0,6,34,35
1715650958565,EDS 125,A00,507246,Hopkins; Megan Beth,7,0,30,23
1715650959590,EDS 128A,A01,507264,Fargason; Sharon Gayle,5,0,26,21
1715650960619,EDS 128B,A01,507293,Pappas; Elizabeth,9,0,30,21
1715650961649,EDS 139,A00,507294,Fargason; Sharon Gayle,9,0,30,21
1715650961649,EDS 139,B00,507313,Pappas; Elizabeth,9,0,30,21
1715650962678,EDS 201,A00,507315,Staff,10,0,30,20
1715650963701,EDS 203,A01,507317,Halter; Christopher P.,10,0,30,20
1715650964727,EDS 204R,A01,507319,Halter; Christopher P.,0,3,30,30
1715650964727,EDS 204R,B01,507331,Heinzman; Erica M.,14,0,30,16
1715650965753,EDS 206R,A00,507332,Staff,0,4,30,30
1715650965753,EDS 206R,B00,507343,Staff,15,0,30,15
1715650966778,EDS 250,A00,507344,Hemans; Patricia Ann Benitez,20,0,40,20
1715650967807,EDS 281,A00,507345,Daly; Alan J.,18,0,18,0
1715650968832,EDS 284,A00,507350,Daly; Alan J.,16,0,16,0
1715650969857,EDS 286,A00,507359,Fine; Sarah,18,0,18,0
1715650970883,EDS 289C,A01,507361,Daly; Alan J.,18,0,18,0
1715650971909,EDS 290,A00,507366,Hofstetter; Carolyn,15,0,15,0
1715650972935,LIGM 5A,A00,507421,Fischer-Grunski; Eva K,17,0,20,3
1715650973960,LIGM 5B,A00,507423,Fischer-Grunski; Eva K,19,0,20,1
1715650974990,LIGM 5C,A00,507425,Fischer-Grunski; Eva K,19,0,20,1
1715650976016,LIIT 5AS,A00,507427,Carnelos; Chiara,20,0,20,0
1715650977041,LIIT 5BS,A00,507430,Carnelos; Chiara,20,0,20,0
1715650978067,LIIT 5CS,A00,507432,Carnelos; Chiara,20,0,20,0
1715650979096,LISP 5A,A00,507541,Munoz Sanchez; Alicia,11,0,20,9
1715650980125,LISP 5B,A00,507671,Munoz Sanchez; Alicia,8,0,20,12
1715650981149,LISP 5C,A00,507696,Munoz Sanchez; Alicia,8,0,20,12
1715650982176,MAE 197,001,528363,Boechler; Nicholas Sebastia,9998,0,9999,1
1715650983204,MATH 197,001,523477,Kedlaya; Kiran S.,9994,0,9999,5
1715650983204,MATH 197,002,563811,Zhang; Danna,9994,0,9999,5
1715650983204,MATH 197,003,628552,Dumitriu; Ioana,9998,0,9999,1
1715650983204,MATH 197,004,660885,Floyd; Eric,9998,0,9999,1
1715650984230,MCWP 40R,A00,518780,Staff,1,0,20,19
1715650984230,MCWP 40R,B00,518781,Carter; Jennifer A,10,0,20,10
1715650984230,MCWP 40R,C00,518783,Smith; Haydee Marie,5,0,20,15
1715650985263,MCWP 50R,A00,518791,Redela; Pamela Morgan,0,1,20,20
1715650985263,MCWP 50R,B00,518792,Krone; Jarret,0,2,20,20
1715650985263,MCWP 50R,C00,518793,Staff,0,4,20,20
1715650985263,MCWP 50R,D00,518794,Morshed; Michael James,0,2,20,20
1715650985263,MCWP 50R,E00,518795,Carter; Andrea L,0,2,20,20
1715650985263,MCWP 50R,F00,518796,Miller; Elizabeth Deen,0,1,20,20
1715650985263,MCWP 50R,G00,518797,Guillen; Melinda,0,1,20,20
1715650986288,MMW 12R,A01,514034,Herbst; Matthew,0,2,16,16
1715650986288,MMW 12R,A02,514035,Herbst; Matthew,0,0,16,16
1715650987313,MMW 13R,A01,514037,Staff,0,5,16,16
1715650987313,MMW 13R,A02,514039,Staff,0,5,16,16
1715650987313,MMW 13R,A03,628519,Staff,0,4,16,16
1715650989362,SIO 295LS,A00,523233,Staff,10,0,30,20
1715650990388,SIO 295S,A00,523232,Staff,10,0,30,20
1715650991416,SIOC 290S,A01,637330,Merrifield; Mark A,21,0,30,9
1715650992442,SIOC 291S,A01,637333,Gabriel; Corey John,21,0,30,9
1715650993474,SOCI 117,A01,494376,Staff,0,5,5,5
1715650994499,WES 237B,A00,494380,Staff,10,0,20,10
1715650996585,AESE 279B,A00,494370,Wade; Jon P,0,0,33,33
1715650997609,AIP 97,001,660915,Van Den Einde; Yael Dahlia,9998,0,9999,1
1715650998637,AIP 197,001,627712,Vespa; Emanuel Ignacio,9995,0,9999,4
1715650998637,AIP 197,002,650778,Amir; On,9998,0,9999,1
1715650998637,AIP 197,003,650933,Avenancio-Leon; Carlos,9998,0,9999,1
1715650998637,AIP 197,004,658530,Heyman; Gail D.,9998,0,9999,1
1715650998637,AIP 197,005,658631,Neal; Sonya E,9998,0,9999,1
1715650998637,AIP 197,006,658671,Du; Songzi,9998,0,9999,1
1715650999665,ANAR 135S,A00,494369,Braswell; Geoffrey E.,0,0,0,0
1715651000690,BENG 196,001,628496,Engler; Adam J.,9998,0,9999,1
1715651000690,BENG 196,002,660916,Watson; John Thomas,9998,0,9999,1
1715651001717,BISP 197,001,650773,Wilhelm; James E.,9994,0,9999,5
1715651001717,BISP 197,002,658904,Coleman; Aaron B.,9998,0,9999,1
1715651002744,CAT 124RS,A01,519847,Geibel; William,0,0,20,20
1715651003769,CAT 125RS,A01,515971,Geibel; William,0,0,20,20
1715651004797,CLRE 250,A00,511389,Morris; Sheldon,9992,0,9999,7
1715651005829,CLRE 251,A00,507176,Mehta; Ravindra L.,9992,0,9999,7
1715651005829,CLRE 251,B00,511410,Mehta; Ravindra L.,9998,0,9999,1
1715651006855,CLRE 252,A00,507189,Cuomo; Raphael Eduardo,9994,0,9999,5
1715651007882,CLRE 253,A00,507199,Vaida; Florin,9994,0,9999,5
1715651007882,CLRE 253,B00,507202,Vaida; Florin,9999,0,9999,0
1715651008907,CLRE 259,A00,507211,Patel; Hemal,9996,0,9999,3
1715651009933,CLRE 260,A00,507221,Cuomo; Raphael Eduardo,9999,0,9999,0
1715651010960,CLRE 297,001,507242,Cuomo; Raphael Eduardo,9999,0,9999,0
1715651011986,COGS 197,001,638244,Voytek; Bradley Thomas,9997,0,9999,2
1715651013013,CSE 191,A00,516875,Minnes Kemp; Mor Mia,9991,0,9999,8
1715651014041,CSE 197,001,637388,Minnes Kemp; Mor Mia,9992,0,9999,7
1715651015073,CSS 201S,A01,494383,Mignozzetti; Umberto,35,0,35,0
1715651016099,CSS 202S,A01,494387,Mignozzetti; Umberto,35,0,35,0
1715651017125,DSC 197,001,628532,Eldridge; Justin Matthew,9995,0,9999,4
1715651018152,EAP 100,A00,516065,Staff,9799,0,9999,200
1715651019178,ECE 45,A01,507414,Staff,32,0,60,28
1715651021232,ECE 111,A01,507420,Staff,11,0,50,39
1715651022258,ECE 197,001,548057,Sievenpiper; Daniel F.,9991,0,9999,8
1715651023285,EDS 115,A00,507243,Choi; Bailey Miyeon,6,0,28,22
1715651024313,EDS 117,A01,494379,Staff,0,6,34,35
1715651025339,EDS 125,A00,507246,Hopkins; Megan Beth,7,0,30,23
1715651026365,EDS 128A,A01,507264,Fargason; Sharon Gayle,5,0,26,21
1715651027391,EDS 128B,A01,507293,Pappas; Elizabeth,9,0,30,21
1715651028416,EDS 139,A00,507294,Fargason; Sharon Gayle,9,0,30,21
1715651028416,EDS 139,B00,507313,Pappas; Elizabeth,9,0,30,21
1715651029444,EDS 201,A00,507315,Staff,10,0,30,20
1715651030473,EDS 203,A01,507317,Halter; Christopher P.,10,0,30,20
1715651031499,EDS 204R,A01,507319,Halter; Christopher P.,0,3,30,30
1715651031499,EDS 204R,B01,507331,Heinzman; Erica M.,14,0,30,16
1715651032525,EDS 206R,A00,507332,Staff,0,4,30,30
1715651032525,EDS 206R,B00,507343,Staff,15,0,30,15
1715651033550,EDS 250,A00,507344,Hemans; Patricia Ann Benitez,20,0,40,20
1715651034574,EDS 281,A00,507345,Daly; Alan J.,18,0,18,0
1715651035602,EDS 284,A00,507350,Daly; Alan J.,16,0,16,0
1715651036630,EDS 286,A00,507359,Fine; Sarah,18,0,18,0
1715651037657,EDS 289C,A01,507361,Daly; Alan J.,18,0,18,0
1715651038740,EDS 290,A00,507366,Hofstetter; Carolyn,15,0,15,0
1715651039767,LIGM 5A,A00,507421,Fischer-Grunski; Eva K,17,0,20,3
1715651040793,LIGM 5B,A00,507423,Fischer-Grunski; Eva K,19,0,20,1
1715651041817,LIGM 5C,A00,507425,Fischer-Grunski; Eva K,19,0,20,1
1715651042843,LIIT 5AS,A00,507427,Carnelos; Chiara,20,0,20,0
1715651043883,LIIT 5BS,A00,507430,Carnelos; Chiara,20,0,20,0
1715651044909,LIIT 5CS,A00,507432,Carnelos; Chiara,20,0,20,0
1715651045939,LISP 5A,A00,507541,Munoz Sanchez; Alicia,11,0,20,9
1715651046969,LISP 5B,A00,507671,Munoz Sanchez; Alicia,8,0,20,12
1715651047993,LISP 5C,A00,507696,Munoz Sanchez; Alicia,8,0,20,12
1715651049020,MAE 197,001,528363,Boechler; Nicholas Sebastia,9998,0,9999,1
1715651050048,MATH 197,001,523477,Kedlaya; Kiran S.,9994,0,9999,5
1715651050048,MATH 197,002,563811,Zhang; Danna,9994,0,9999,5
1715651050048,MATH 197,003,628552,Dumitriu; Ioana,9998,0,9999,1
1715651050048,MATH 197,004,660885,Floyd; Eric,9998,0,9999,1
1715651051079,MCWP 40R,A00,518780,Staff,1,0,20,19
1715651051079,MCWP 40R,B00,518781,Carter; Jennifer A,10,0,20,10
1715651051079,MCWP 40R,C00,518783,Smith; Haydee Marie,5,0,20,15
1715651052106,MCWP 50R,A00,518791,Redela; Pamela Morgan,0,1,20,20
1715651052106,MCWP 50R,B00,518792,Krone; Jarret,0,2,20,20
1715651052106,MCWP 50R,C00,518793,Staff,0,4,20,20
1715651052106,MCWP 50R,D00,518794,Morshed; Michael James,0,2,20,20
1715651052106,MCWP 50R,E00,518795,Carter; Andrea L,0,2,20,20
1715651052106,MCWP 50R,F00,518796,Miller; Elizabeth Deen,0,1,20,20
1715651052106,MCWP 50R,G00,518797,Guillen; Melinda,0,1,20,20
1715651053133,MMW 12R,A01,514034,Herbst; Matthew,0,2,16,16
1715651053133,MMW 12R,A02,514035,Herbst; Matthew,0,0,16,16
1715651054161,MMW 13R,A01,514037,Staff,0,5,16,16
1715651054161,MMW 13R,A02,514039,Staff,0,5,16,16
1715651054161,MMW 13R,A03,628519,Staff,0,4,16,16
1715651056220,SIO 295LS,A00,523233,Staff,10,0,30,20
1715651057244,SIO 295S,A00,523232,Staff,10,0,30,20
1715651058270,SIOC 290S,A01,637330,Merrifield; Mark A,21,0,30,9
1715651059297,SIOC 291S,A01,637333,Gabriel; Corey John,21,0,30,9
1715651060323,SOCI 117,A01,494376,Staff,0,5,5,5
1715651061351,WES 237B,A00,494380,Staff,10,0,20,10
1715651063431,AESE 279B,A00,494370,Wade; Jon P,0,0,33,33
1715651064457,AIP 97,001,660915,Van Den Einde; Yael Dahlia,9998,0,9999,1
1715651065485,AIP 197,001,627712,Vespa; Emanuel Ignacio,9995,0,9999,4
1715651065485,AIP 197,002,650778,Amir; On,9998,0,9999,1
1715651065485,AIP 197,003,650933,Avenancio-Leon; Carlos,9998,0,9999,1
1715651065485,AIP 197,004,658530,Heyman; Gail D.,9998,0,9999,1
1715651065485,AIP 197,005,658631,Neal; Sonya E,9998,0,9999,1
1715651065485,AIP 197,006,658671,Du; Songzi,9998,0,9999,1
1715651066510,ANAR 135S,A00,494369,Braswell; Geoffrey E.,0,0,0,0
1715651067536,BENG 196,001,628496,Engler; Adam J.,9998,0,9999,1
1715651067536,BENG 196,002,660916,Watson; John Thomas,9998,0,9999,1
1715651068560,BISP 197,001,650773,Wilhelm; James E.,9994,0,9999,5
1715651068560,BISP 197,002,658904,Coleman; Aaron B.,9998,0,9999,1
1715651069589,CAT 124RS,A01,519847,Geibel; William,0,0,20,20
1715651070614,CAT 125RS,A01,515971,Geibel; William,0,0,20,20
1715651071639,CLRE 250,A00,511389,Morris; Sheldon,9992,0,9999,7
1715651072667,CLRE 251,A00,507176,Mehta; Ravindra L.,9992,0,9999,7
1715651072667,CLRE 251,B00,511410,Mehta; Ravindra L.,9998,0,9999,1
1715651073691,CLRE 252,A00,507189,Cuomo; Raphael Eduardo,9994,0,9999,5
1715651074719,CLRE 253,A00,507199,Vaida; Florin,9994,0,9999,5
1715651074719,CLRE 253,B00,507202,Vaida; Florin,9999,0,9999,0
1715651075747,CLRE 259,A00,507211,Patel; Hemal,9996,0,9999,3
1715651076770,CLRE 260,A00,507221,Cuomo; Raphael Eduardo,9999,0,9999,0
1715651077799,CLRE 297,001,507242,Cuomo; Raphael Eduardo,9999,0,9999,0
1715651078829,COGS 197,001,638244,Voytek; Bradley Thomas,9997,0,9999,2
1715651079856,CSE 191,A00,516875,Minnes Kemp; Mor Mia,9991,0,9999,8
1715651080881,CSE 197,001,637388,Minnes Kemp; Mor Mia,9992,0,9999,7
1715651081909,CSS 201S,A01,494383,Mignozzetti; Umberto,35,0,35,0
1715651082936,CSS 202S,A01,494387,Mignozzetti; Umberto,35,0,35,0
1715651083961,DSC 197,001,628532,Eldridge; Justin Matthew,9995,0,9999,4
1715651084985,EAP 100,A00,516065,Staff,9799,0,9999,200
1715651086012,ECE 45,A01,507414,Staff,32,0,60,28
1715651088064,ECE 111,A01,507420,Staff,11,0,50,39
1715651089090,ECE 197,001,548057,Sievenpiper; Daniel F.,9991,0,9999,8
1715651090120,EDS 115,A00,507243,Choi; Bailey Miyeon,6,0,28,22
1715651091151,EDS 117,A01,494379,Staff,0,6,34,35
1715651092179,EDS 125,A00,507246,Hopkins; Megan Beth,7,0,30,23
1715651093207,EDS 128A,A01,507264,Fargason; Sharon Gayle,5,0,26,21
1715651094231,EDS 128B,A01,507293,Pappas; Elizabeth,9,0,30,21
1715651095263,EDS 139,A00,507294,Fargason; Sharon Gayle,9,0,30,21
1715651095263,EDS 139,B00,507313,Pappas; Elizabeth,9,0,30,21
1715651096291,EDS 201,A00,507315,Staff,10,0,30,20
1715651097321,EDS 203,A01,507317,Halter; Christopher P.,10,0,30,20
1715651098347,EDS 204R,A01,507319,Halter; Christopher P.,0,3,30,30
1715651098347,EDS 204R,B01,507331,Heinzman; Erica M.,14,0,30,16
1715651099372,EDS 206R,A00,507332,Staff,0,4,30,30
1715651099372,EDS 206R,B00,507343,Staff,15,0,30,15
1715651100399,EDS 250,A00,507344,Hemans; Patricia Ann Benitez,20,0,40,20
1715651101424,EDS 281,A00,507345,Daly; Alan J.,18,0,18,0
1715651102476,EDS 284,A00,507350,Daly; Alan J.,16,0,16,0
1715651103500,EDS 286,A00,507359,Fine; Sarah,18,0,18,0
1715651104526,EDS 289C,A01,507361,Daly; Alan J.,18,0,18,0
1715651105552,EDS 290,A00,507366,Hofstetter; Carolyn,15,0,15,0
1715651106579,LIGM 5A,A00,507421,Fischer-Grunski; Eva K,17,0,20,3
1715651107607,LIGM 5B,A00,507423,Fischer-Grunski; Eva K,19,0,20,1
1715651108635,LIGM 5C,A00,507425,Fischer-Grunski; Eva K,19,0,20,1
1715651109664,LIIT 5AS,A00,507427,Carnelos; Chiara,20,0,20,0
1715651110693,LIIT 5BS,A00,507430,Carnelos; Chiara,20,0,20,0
1715651111723,LIIT 5CS,A00,507432,Carnelos; Chiara,20,0,20,0
1715651112748,LISP 5A,A00,507541,Munoz Sanchez; Alicia,11,0,20,9
1715651113777,LISP 5B,A00,507671,Munoz Sanchez; Alicia,8,0,20,12
1715651114802,LISP 5C,A00,507696,Munoz Sanchez; Alicia,8,0,20,12
1715651115826,MAE 197,001,528363,Boechler; Nicholas Sebastia,9998,0,9999,1
1715651116853,MATH 197,001,523477,Kedlaya; Kiran S.,9994,0,9999,5
1715651116853,MATH 197,002,563811,Zhang; Danna,9994,0,9999,5
1715651116853,MATH 197,003,628552,Dumitriu; Ioana,9998,0,9999,1
1715651116853,MATH 197,004,660885,Floyd; Eric,9998,0,9999,1
1715651117879,MCWP 40R,A00,518780,Staff,1,0,20,19
1715651117879,MCWP 40R,B00,518781,Carter; Jennifer A,10,0,20,10
1715651117879,MCWP 40R,C00,518783,Smith; Haydee Marie,5,0,20,15
1715651118909,MCWP 50R,A00,518791,Redela; Pamela Morgan,0,1,20,20
1715651118909,MCWP 50R,B00,518792,Krone; Jarret,0,2,20,20
1715651118909,MCWP 50R,C00,518793,Staff,0,4,20,20
1715651118909,MCWP 50R,D00,518794,Morshed; Michael James,0,2,20,20
1715651118909,MCWP 50R,E00,518795,Carter; Andrea L,0,2,20,20
1715651118909,MCWP 50R,F00,518796,Miller; Elizabeth Deen,0,1,20,20
1715651118909,MCWP 50R,G00,518797,Guillen; Melinda,0,1,20,20
1715651119934,MMW 12R,A01,514034,Herbst; Matthew,0,2,16,16
1715651119934,MMW 12R,A02,514035,Herbst; Matthew,0,0,16,16
1715651120962,MMW 13R,A01,514037,Staff,0,5,16,16
1715651120962,MMW 13R,A02,514039,Staff,0,5,16,16
1715651120962,MMW 13R,A03,628519,Staff,0,4,16,16
1715651123011,SIO 295LS,A00,523233,Staff,10,0,30,20
1715651124036,SIO 295S,A00,523232,Staff,10,0,30,20
1715651125068,SIOC 290S,A01,637330,Merrifield; Mark A,21,0,30,9
1715651126098,SIOC 291S,A01,637333,Gabriel; Corey John,21,0,30,9
1715651127123,SOCI 117,A01,494376,Staff,0,5,5,5
1715651128152,WES 237B,A00,494380,Staff,10,0,20,10
1715651130219,AESE 279B,A00,494370,Wade; Jon P,0,0,33,33
1715651131246,AIP 97,001,660915,Van Den Einde; Yael Dahlia,9998,0,9999,1
1715651132275,AIP 197,001,627712,Vespa; Emanuel Ignacio,9995,0,9999,4
1715651132275,AIP 197,002,650778,Amir; On,9998,0,9999,1
1715651132275,AIP 197,003,650933,Avenancio-Leon; Carlos,9998,0,9999,1
1715651132275,AIP 197,004,658530,Heyman; Gail D.,9998,0,9999,1
1715651132275,AIP 197,005,658631,Neal; Sonya E,9998,0,9999,1
1715651132275,AIP 197,006,658671,Du; Songzi,9998,0,9999,1
1715651133302,ANAR 135S,A00,494369,Braswell; Geoffrey E.,0,0,0,0
1715651134328,BENG 196,001,628496,Engler; Adam J.,9998,0,9999,1
1715651134328,BENG 196,002,660916,Watson; John Thomas,9998,0,9999,1
1715651135354,BISP 197,001,650773,Wilhelm; James E.,9994,0,9999,5
1715651135354,BISP 197,002,658904,Coleman; Aaron B.,9998,0,9999,1
1715651136380,CAT 124RS,A01,519847,Geibel; William,0,0,20,20
1715651137405,CAT 125RS,A01,515971,Geibel; William,0,0,20,20
1715651138432,CLRE 250,A00,511389,Morris; Sheldon,9992,0,9999,7
1715651139459,CLRE 251,A00,507176,Mehta; Ravindra L.,9992,0,9999,7
1715651139459,CLRE 251,B00,511410,Mehta; Ravindra L.,9998,0,9999,1
1715651140486,CLRE 252,A00,507189,Cuomo; Raphael Eduardo,9994,0,9999,5
1715651141512,CLRE 253,A00,507199,Vaida; Florin,9994,0,9999,5
1715651141512,CLRE 253,B00,507202,Vaida; Florin,9999,0,9999,0
1715651142555,CLRE 259,A00,507211,Patel; Hemal,9996,0,9999,3
1715651143582,CLRE 260,A00,507221,Cuomo; Raphael Eduardo,9999,0,9999,0
1715651144607,CLRE 297,001,507242,Cuomo; Raphael Eduardo,9999,0,9999,0
1715651145634,COGS 197,001,638244,Voytek; Bradley Thomas,9997,0,9999,2
1715651146660,CSE 191,A00,516875,Minnes Kemp; Mor Mia,9991,0,9999,8
1715651147687,CSE 197,001,637388,Minnes Kemp; Mor Mia,9992,0,9999,7
1715651148717,CSS 201S,A01,494383,Mignozzetti; Umberto,35,0,35,0
1715651149744,CSS 202S,A01,494387,Mignozzetti; Umberto,35,0,35,0
1715651150768,DSC 197,001,628532,Eldridge; Justin Matthew,9995,0,9999,4
1715651151795,EAP 100,A00,516065,Staff,9799,0,9999,200
1715651152825,ECE 45,A01,507414,Staff,32,0,60,28
1715651154877,ECE 111,A01,507420,Staff,11,0,50,39
1715651155901,ECE 197,001,548057,Sievenpiper; Daniel F.,9991,0,9999,8
1715651156927,EDS 115,A00,507243,Choi; Bailey Miyeon,6,0,28,22
1715651157955,EDS 117,A01,494379,Staff,0,6,34,35
1715651158979,EDS 125,A00,507246,Hopkins; Megan Beth,7,0,30,23
1715651160018,EDS 128A,A01,507264,Fargason; Sharon Gayle,5,0,26,21
1715651161047,EDS 128B,A01,507293,Pappas; Elizabeth,9,0,30,21
1715651162075,EDS 139,A00,507294,Fargason; Sharon Gayle,9,0,30,21
1715651162075,EDS 139,B00,507313,Pappas; Elizabeth,9,0,30,21
1715651163099,EDS 201,A00,507315,Staff,10,0,30,20
1715651164126,EDS 203,A01,507317,Halter; Christopher P.,10,0,30,20
1715651165156,EDS 204R,A01,507319,Halter; Christopher P.,0,3,30,30
1715651165156,EDS 204R,B01,507331,Heinzman; Erica M.,14,0,30,16
1715651166185,EDS 206R,A00,507332,Staff,0,4,30,30
1715651166185,EDS 206R,B00,507343,Staff,15,0,30,15
1715651167209,EDS 250,A00,507344,Hemans; Patricia Ann Benitez,20,0,40,20
1715651168238,EDS 281,A00,507345,Daly; Alan J.,18,0,18,0
1715651169262,EDS 284,A00,507350,Daly; Alan J.,16,0,16,0
1715651170286,EDS 286,A00,507359,Fine; Sarah,18,0,18,0
1715651171309,EDS 289C,A01,507361,Daly; Alan J.,18,0,18,0
1715651172335,EDS 290,A00,507366,Hofstetter; Carolyn,15,0,15,0
1715651173363,LIGM 5A,A00,507421,Fischer-Grunski; Eva K,17,0,20,3
1715651174392,LIGM 5B,A00,507423,Fischer-Grunski; Eva K,19,0,20,1
1715651175421,LIGM 5C,A00,507425,Fischer-Grunski; Eva K,19,0,20,1
1715651176449,LIIT 5AS,A00,507427,Carnelos; Chiara,20,0,20,0
1715651177475,LIIT 5BS,A00,507430,Carnelos; Chiara,20,0,20,0
1715651178507,LIIT 5CS,A00,507432,Carnelos; Chiara,20,0,20,0
1715651179534,LISP 5A,A00,507541,Munoz Sanchez; Alicia,11,0,20,9
1715651180558,LISP 5B,A00,507671,Munoz Sanchez; Alicia,8,0,20,12
1715651181585,LISP 5C,A00,507696,Munoz Sanchez; Alicia,8,0,20,12
1715651182613,MAE 197,001,528363,Boechler; Nicholas Sebastia,9998,0,9999,1
1715651183647,MATH 197,001,523477,Kedlaya; Kiran S.,9994,0,9999,5
1715651183647,MATH 197,002,563811,Zhang; Danna,9994,0,9999,5
1715651183647,MATH 197,003,628552,Dumitriu; Ioana,9998,0,9999,1
1715651183647,MATH 197,004,660885,Floyd; Eric,9998,0,9999,1
1715651184675,MCWP 40R,A00,518780,Staff,1,0,20,19
1715651184675,MCWP 40R,B00,518781,Carter; Jennifer A,10,0,20,10
1715651184675,MCWP 40R,C00,518783,Smith; Haydee Marie,5,0,20,15
1715651185729,MCWP 50R,A00,518791,Redela; Pamela Morgan,0,1,20,20
1715651185729,MCWP 50R,B00,518792,Krone; Jarret,0,2,20,20
1715651185729,MCWP 50R,C00,518793,Staff,0,4,20,20
1715651185729,MCWP 50R,D00,518794,Morshed; Michael James,0,2,20,20
1715651185729,MCWP 50R,E00,518795,Carter; Andrea L,0,2,20,20
1715651185729,MCWP 50R,F00,518796,Miller; Elizabeth Deen,0,1,20,20
1715651185729,MCWP 50R,G00,518797,Guillen; Melinda,0,1,20,20
1715651186754,MMW 12R,A01,514034,Herbst; Matthew,0,2,16,16
1715651186754,MMW 12R,A02,514035,Herbst; Matthew,0,0,16,16
1715651187782,MMW 13R,A01,514037,Staff,0,5,16,16
1715651187782,MMW 13R,A02,514039,Staff,0,5,16,16
1715651187782,MMW 13R,A03,628519,Staff,0,4,16,16
1715651189830,SIO 295LS,A00,523233,Staff,10,0,30,20
1715651190856,SIO 295S,A00,523232,Staff,10,0,30,20
1715651191882,SIOC 290S,A01,637330,Merrifield; Mark A,21,0,30,9
1715651192911,SIOC 291S,A01,637333,Gabriel; Corey John,21,0,30,9
1715651193937,SOCI 117,A01,494376,Staff,0,5,5,5
1715651194962,WES 237B,A00,494380,Staff,10,0,20,10
1715651197037,AESE 279B,A00,494370,Wade; Jon P,0,0,33,33
1715651198066,AIP 97,001,660915,Van Den Einde; Yael Dahlia,9998,0,9999,1
1715651199094,AIP 197,001,627712,Vespa; Emanuel Ignacio,9995,0,9999,4
1715651199094,AIP 197,002,650778,Amir; On,9998,0,9999,1
1715651199094,AIP 197,003,650933,Avenancio-Leon; Carlos,9998,0,9999,1
1715651199094,AIP 197,004,658530,Heyman; Gail D.,9998,0,9999,1
1715651199094,AIP 197,005,658631,Neal; Sonya E,9998,0,9999,1
1715651199094,AIP 197,006,658671,Du; Songzi,9998,0,9999,1
1715651200118,ANAR 135S,A00,494369,Braswell; Geoffrey E.,0,0,0,0
1715651201145,BENG 196,001,628496,Engler; Adam J.,9998,0,9999,1
1715651201145,BENG 196,002,660916,Watson; John Thomas,9998,0,9999,1
1715651202172,BISP 197,001,650773,Wilhelm; James E.,9994,0,9999,5
1715651202172,BISP 197,002,658904,Coleman; Aaron B.,9998,0,9999,1
1715651203199,CAT 124RS,A01,519847,Geibel; William,0,0,20,20
1715651204223,CAT 125RS,A01,515971,Geibel; William,0,0,20,20
1715651205250,CLRE 250,A00,511389,Morris; Sheldon,9992,0,9999,7
1715651206283,CLRE 251,A00,507176,Mehta; Ravindra L.,9992,0,9999,7
1715651206283,CLRE 251,B00,511410,Mehta; Ravindra L.,9998,0,9999,1
1715651207308,CLRE 252,A00,507189,Cuomo; Raphael Eduardo,9994,0,9999,5
1715651208336,CLRE 253,A00,507199,Vaida; Florin,9994,0,9999,5
1715651208336,CLRE 253,B00,507202,Vaida; Florin,9999,0,9999,0
1715651209360,CLRE 259,A00,507211,Patel; Hemal,9996,0,9999,3
1715651210384,CLRE 260,A00,507221,Cuomo; Raphael Eduardo,9999,0,9999,0
1715651211408,CLRE 297,001,507242,Cuomo; Raphael Eduardo,9999,0,9999,0
1715651212433,COGS 197,001,638244,Voytek; Bradley Thomas,9997,0,9999,2
1715651213457,CSE 191,A00,516875,Minnes Kemp; Mor Mia,9991,0,9999,8
1715651214483,CSE 197,001,637388,Minnes Kemp; Mor Mia,9992,0,9999,7
1715651215510,CSS 201S,A01,494383,Mignozzetti; Umberto,35,0,35,0
1715651216539,CSS 202S,A01,494387,Mignozzetti; Umberto,35,0,35,0
1715651217565,DSC 197,001,628532,Eldridge; Justin Matthew,9995,0,9999,4
1715651218589,EAP 100,A00,516065,Staff,9799,0,9999,200
1715651219622,ECE 45,A01,507414,Staff,32,0,60,28
1715651221676,ECE 111,A01,507420,Staff,11,0,50,39
1715651222701,ECE 197,001,548057,Sievenpiper; Daniel F.,9991,0,9999,8
1715651223729,EDS 115,A00,507243,Choi; Bailey Miyeon,6,0,28,22
1715651224754,EDS 117,A01,494379,Staff,0,6,34,35
1715651225788,EDS 125,A00,507246,Hopkins; Megan Beth,7,0,30,23
1715651226813,EDS 128A,A01,507264,Fargason; Sharon Gayle,5,0,26,21
1715651227843,EDS 128B,A01,507293,Pappas; Elizabeth,9,0,30,21
1715651228867,EDS 139,A00,507294,Fargason; Sharon Gayle,9,0,30,21
1715651228867,EDS 139,B00,507313,Pappas; Elizabeth,9,0,30,21
1715651229894,EDS 201,A00,507315,Staff,10,0,30,20
1715651230921,EDS 203,A01,507317,Halter; Christopher P.,10,0,30,20
1715651231949,EDS 204R,A01,507319,Halter; Christopher P.,0,3,30,30
1715651231949,EDS 204R,B01,507331,Heinzman; Erica M.,14,0,30,16
1715651232978,EDS 206R,A00,507332,Staff,0,4,30,30
1715651232978,EDS 206R,B00,507343,Staff,15,0,30,15
1715651234004,EDS 250,A00,507344,Hemans; Patricia Ann Benitez,20,0,40,20
1715651235029,EDS 281,A00,507345,Daly; Alan J.,18,0,18,0
1715651236054,EDS 284,A00,507350,Daly; Alan J.,16,0,16,0
1715651237083,EDS 286,A00,507359,Fine; Sarah,18,0,18,0
1715651238108,EDS 289C,A01,507361,Daly; Alan J.,18,0,18,0
1715651239138,EDS 290,A00,507366,Hofstetter; Carolyn,15,0,15,0
1715651240165,LIGM 5A,A00,507421,Fischer-Grunski; Eva K,17,0,20,3
1715651241193,LIGM 5B,A00,507423,Fischer-Grunski; Eva K,19,0,20,1
1715651242218,LIGM 5C,A00,507425,Fischer-Grunski; Eva K,19,0,20,1
1715651243249,LIIT 5AS,A00,507427,Carnelos; Chiara,20,0,20,0
1715651244278,LIIT 5BS,A00,507430,Carnelos; Chiara,20,0,20,0
1715651245303,LIIT 5CS,A00,507432,Carnelos; Chiara,20,0,20,0
1715651246335,LISP 5A,A00,507541,Munoz Sanchez; Alicia,11,0,20,9
1715651247361,LISP 5B,A00,507671,Munoz Sanchez; Alicia,8,0,20,12
1715651248389,LISP 5C,A00,507696,Munoz Sanchez; Alicia,8,0,20,12
1715651249418,MAE 197,001,528363,Boechler; Nicholas Sebastia,9998,0,9999,1
1715651250451,MATH 197,001,523477,Kedlaya; Kiran S.,9994,0,9999,5
1715651250451,MATH 197,002,563811,Zhang; Danna,9994,0,9999,5
1715651250451,MATH 197,003,628552,Dumitriu; Ioana,9998,0,9999,1
1715651250451,MATH 197,004,660885,Floyd; Eric,9998,0,9999,1
1715651251477,MCWP 40R,A00,518780,Staff,1,0,20,19
1715651251477,MCWP 40R,B00,518781,Carter; Jennifer A,10,0,20,10
1715651251477,MCWP 40R,C00,518783,Smith; Haydee Marie,5,0,20,15
1715651252509,MCWP 50R,A00,518791,Redela; Pamela Morgan,0,1,20,20
1715651252509,MCWP 50R,B00,518792,Krone; Jarret,0,2,20,20
1715651252509,MCWP 50R,C00,518793,Staff,0,4,20,20
1715651252509,MCWP 50R,D00,518794,Morshed; Michael James,0,2,20,20
1715651252509,MCWP 50R,E00,518795,Carter; Andrea L,0,2,20,20
1715651252509,MCWP 50R,F00,518796,Miller; Elizabeth Deen,0,1,20,20
1715651252509,MCWP 50R,G00,518797,Guillen; Melinda,0,1,20,20
1715651253534,MMW 12R,A01,514034,Herbst; Matthew,0,2,16,16
1715651253534,MMW 12R,A02,514035,Herbst; Matthew,0,0,16,16
1715651254559,MMW 13R,A01,514037,Staff,0,5,16,16
1715651254559,MMW 13R,A02,514039,Staff,0,5,16,16
1715651254559,MMW 13R,A03,628519,Staff,0,4,16,16
1715651256612,SIO 295LS,A00,523233,Staff,10,0,30,20
1715651257642,SIO 295S,A00,523232,Staff,10,0,30,20
1715651258669,SIOC 290S,A01,637330,Merrifield; Mark A,21,0,30,9
1715651259699,SIOC 291S,A01,637333,Gabriel; Corey John,21,0,30,9
1715651260724,SOCI 117,A01,494376,Staff,0,5,5,5
1715651261751,WES 237B,A00,494380,Staff,10,0,20,10
1715651263823,AESE 279B,A00,494370,Wade; Jon P,0,0,33,33
1715651264848,AIP 97,001,660915,Van Den Einde; Yael Dahlia,9998,0,9999,1
1715651265876,AIP 197,001,627712,Vespa; Emanuel Ignacio,9995,0,9999,4
1715651265876,AIP 197,002,650778,Amir; On,9998,0,9999,1
1715651265876,AIP 197,003,650933,Avenancio-Leon; Carlos,9998,0,9999,1
1715651265876,AIP 197,004,658530,Heyman; Gail D.,9998,0,9999,1
1715651265876,AIP 197,005,658631,Neal; Sonya E,9998,0,9999,1
1715651265876,AIP 197,006,658671,Du; Songzi,9998,0,9999,1
1715651266901,ANAR 135S,A00,494369,Braswell; Geoffrey E.,0,0,0,0
1715651267926,BENG 196,001,628496,Engler; Adam J.,9998,0,9999,1
1715651267926,BENG 196,002,660916,Watson; John Thomas,9998,0,9999,1
1715651268955,BISP 197,001,650773,Wilhelm; James E.,9994,0,9999,5
1715651268955,BISP 197,002,658904,Coleman; Aaron B.,9998,0,9999,1
1715651270006,CAT 124RS,A01,519847,Geibel; William,0,0,20,20
1715651271030,CAT 125RS,A01,515971,Geibel; William,0,0,20,20
1715651272056,CLRE 250,A00,511389,Morris; Sheldon,9992,0,9999,7
1715651273082,CLRE 251,A00,507176,Mehta; Ravindra L.,9992,0,9999,7
1715651273082,CLRE 251,B00,511410,Mehta; Ravindra L.,9998,0,9999,1
1715651274108,CLRE 252,A00,507189,Cuomo; Raphael Eduardo,9994,0,9999,5
1715651275140,CLRE 253,A00,507199,Vaida; Florin,9994,0,9999,5
1715651275140,CLRE 253,B00,507202,Vaida; Florin,9999,0,9999,0
1715651276168,CLRE 259,A00,507211,Patel; Hemal,9996,0,9999,3
1715651277196,CLRE 260,A00,507221,Cuomo; Raphael Eduardo,9999,0,9999,0
1715651278220,CLRE 297,001,507242,Cuomo; Raphael Eduardo,9999,0,9999,0
1715651279247,COGS 197,001,638244,Voytek; Bradley Thomas,9997,0,9999,2
1715651280275,CSE 191,A00,516875,Minnes Kemp; Mor Mia,9991,0,9999,8
1715651281303,CSE 197,001,637388,Minnes Kemp; Mor Mia,9992,0,9999,7
1715651282333,CSS 201S,A01,494383,Mignozzetti; Umberto,35,0,35,0
1715651283357,CSS 202S,A01,494387,Mignozzetti; Umberto,35,0,35,0
1715651284382,DSC 197,001,628532,Eldridge; Justin Matthew,9995,0,9999,4
1715651285409,EAP 100,A00,516065,Staff,9799,0,9999,200
1715651286439,ECE 45,A01,507414,Staff,32,0,60,28
1715651288497,ECE 111,A01,507420,Staff,11,0,50,39
1715651289525,ECE 197,001,548057,Sievenpiper; Daniel F.,9991,0,9999,8
1715651290551,EDS 115,A00,507243,Choi; Bailey Miyeon,6,0,28,22
1715651291577,EDS 117,A01,494379,Staff,0,6,34,35
1715651292602,EDS 125,A00,507246,Hopkins; Megan Beth,7,0,30,23
1715651293630,EDS 128A,A01,507264,Fargason; Sharon Gayle,5,0,26,21
1715651294658,EDS 128B,A01,507293,Pappas; Elizabeth,9,0,30,21
1715651295682,EDS 139,A00,507294,Fargason; Sharon Gayle,9,0,30,21
1715651295682,EDS 139,B00,507313,Pappas; Elizabeth,9,0,30,21
1715651296710,EDS 201,A00,507315,Staff,10,0,30,20
1715651297737,EDS 203,A01,507317,Halter; Christopher P.,10,0,30,20
1715651298764,EDS 204R,A01,507319,Halter; Christopher P.,0,3,30,30
1715651298764,EDS 204R,B01,507331,Heinzman; Erica M.,14,0,30,16
1715651299788,EDS 206R,A00,507332,Staff,0,4,30,30
1715651299788,EDS 206R,B00,507343,Staff,15,0,30,15
1715651300813,EDS 250,A00,507344,Hemans; Patricia Ann Benitez,20,0,40,20
1715651301839,EDS 281,A00,507345,Daly; Alan J.,18,0,18,0
1715651302865,EDS 284,A00,507350,Daly; Alan J.,16,0,16,0
1715651303898,EDS 286,A00,507359,Fine; Sarah,18,0,18,0
1715651304926,EDS 289C,A01,507361,Daly; Alan J.,18,0,18,0
1715651305955,EDS 290,A00,507366,Hofstetter; Carolyn,15,0,15,0
1715651306981,LIGM 5A,A00,507421,Fischer-Grunski; Eva K,17,0,20,3
1715651308011,LIGM 5B,A00,507423,Fischer-Grunski; Eva K,19,0,20,1
1715651309036,LIGM 5C,A00,507425,Fischer-Grunski; Eva K,19,0,20,1
1715651310119,LIIT 5AS,A00,507427,Carnelos; Chiara,20,0,20,0
1715651311144,LIIT 5BS,A00,507430,Carnelos; Chiara,20,0,20,0
1715651312168,LIIT 5CS,A00,507432,Carnelos; Chiara,20,0,20,0
1715651313194,LISP 5A,A00,507541,Munoz Sanchez; Alicia,11,0,20,9
1715651314221,LISP 5B,A00,507671,Munoz Sanchez; Alicia,8,0,20,12
1715651315246,LISP 5C,A00,507696,Munoz Sanchez; Alicia,8,0,20,12
1715651316272,MAE 197,001,528363,Boechler; Nicholas Sebastia,9998,0,9999,1
1715651317301,MATH 197,001,523477,Kedlaya; Kiran S.,9994,0,9999,5
1715651317301,MATH 197,002,563811,Zhang; Danna,9994,0,9999,5
1715651317301,MATH 197,003,628552,Dumitriu; Ioana,9998,0,9999,1
1715651317301,MATH 197,004,660885,Floyd; Eric,9998,0,9999,1
1715651318334,MCWP 40R,A00,518780,Staff,1,0,20,19
1715651318334,MCWP 40R,B00,518781,Carter; Jennifer A,10,0,20,10
1715651318334,MCWP 40R,C00,518783,Smith; Haydee Marie,5,0,20,15
1715651319373,MCWP 50R,A00,518791,Redela; Pamela Morgan,0,1,20,20
1715651319373,MCWP 50R,B00,518792,Krone; Jarret,0,2,20,20
1715651319373,MCWP 50R,C00,518793,Staff,0,4,20,20
1715651319373,MCWP 50R,D00,518794,Morshed; Michael James,0,2,20,20
1715651319373,MCWP 50R,E00,518795,Carter; Andrea L,0,2,20,20
1715651319373,MCWP 50R,F00,518796,Miller; Elizabeth Deen,0,1,20,20
1715651319373,MCWP 50R,G00,518797,Guillen; Melinda,0,1,20,20
1715651320399,MMW 12R,A01,514034,Herbst; Matthew,0,2,16,16
1715651320399,MMW 12R,A02,514035,Herbst; Matthew,0,0,16,16
1715651321426,MMW 13R,A01,514037,Staff,0,5,16,16
1715651321426,MMW 13R,A02,514039,Staff,0,5,16,16
1715651321426,MMW 13R,A03,628519,Staff,0,4,16,16
1715651323476,SIO 295LS,A00,523233,Staff,10,0,30,20
1715651324505,SIO 295S,A00,523232,Staff,10,0,30,20
1715651325534,SIOC 290S,A01,637330,Merrifield; Mark A,21,0,30,9
1715651326561,SIOC 291S,A01,637333,Gabriel; Corey John,21,0,30,9
1715651327588,SOCI 117,A01,494376,Staff,0,5,5,5
1715651328616,WES 237B,A00,494380,Staff,10,0,20,10
1715651330690,AESE 279B,A00,494370,Wade; Jon P,0,0,33,33
1715651331720,AIP 97,001,660915,Van Den Einde; Yael Dahlia,9998,0,9999,1
1715651332748,AIP 197,001,627712,Vespa; Emanuel Ignacio,9995,0,9999,4
1715651332748,AIP 197,002,650778,Amir; On,9998,0,9999,1
1715651332748,AIP 197,003,650933,Avenancio-Leon; Carlos,9998,0,9999,1
1715651332748,AIP 197,004,658530,Heyman; Gail D.,9998,0,9999,1
1715651332748,AIP 197,005,658631,Neal; Sonya E,9998,0,9999,1
1715651332748,AIP 197,006,658671,Du; Songzi,9998,0,9999,1
1715651333773,ANAR 135S,A00,494369,Braswell; Geoffrey E.,0,0,0,0
1715651334800,BENG 196,001,628496,Engler; Adam J.,9998,0,9999,1
1715651334800,BENG 196,002,660916,Watson; John Thomas,9998,0,9999,1
1715651335827,BISP 197,001,650773,Wilhelm; James E.,9994,0,9999,5
1715651335827,BISP 197,002,658904,Coleman; Aaron B.,9998,0,9999,1
1715651336855,CAT 124RS,A01,519847,Geibel; William,0,0,20,20
1715651337881,CAT 125RS,A01,515971,Geibel; William,0,0,20,20
1715651338906,CLRE 250,A00,511389,Morris; Sheldon,9992,0,9999,7
1715651339933,CLRE 251,A00,507176,Mehta; Ravindra L.,9992,0,9999,7
1715651339933,CLRE 251,B00,511410,Mehta; Ravindra L.,9998,0,9999,1
1715651340958,CLRE 252,A00,507189,Cuomo; Raphael Eduardo,9994,0,9999,5
1715651341983,CLRE 253,A00,507199,Vaida; Florin,9994,0,9999,5
1715651341983,CLRE 253,B00,507202,Vaida; Florin,9999,0,9999,0
1715651343012,CLRE 259,A00,507211,Patel; Hemal,9996,0,9999,3
1715651344040,CLRE 260,A00,507221,Cuomo; Raphael Eduardo,9999,0,9999,0
1715651345063,CLRE 297,001,507242,Cuomo; Raphael Eduardo,9999,0,9999,0
1715651346089,COGS 197,001,638244,Voytek; Bradley Thomas,9997,0,9999,2
1715651347116,CSE 191,A00,516875,Minnes Kemp; Mor Mia,9991,0,9999,8
1715651348141,CSE 197,001,637388,Minnes Kemp; Mor Mia,9992,0,9999,7
1715651349173,CSS 201S,A01,494383,Mignozzetti; Umberto,35,0,35,0
1715651350202,CSS 202S,A01,494387,Mignozzetti; Umberto,35,0,35,0
1715651351227,DSC 197,001,628532,Eldridge; Justin Matthew,9995,0,9999,4
1715651352252,EAP 100,A00,516065,Staff,9799,0,9999,200
1715651353280,ECE 45,A01,507414,Staff,32,0,60,28
1715651355330,ECE 111,A01,507420,Staff,11,0,50,39
1715651356355,ECE 197,001,548057,Sievenpiper; Daniel F.,9991,0,9999,8
1715651357384,EDS 115,A00,507243,Choi; Bailey Miyeon,6,0,28,22
1715651358408,EDS 117,A01,494379,Staff,0,6,34,35
1715651359435,EDS 125,A00,507246,Hopkins; Megan Beth,7,0,30,23
1715651360462,EDS 128A,A01,507264,Fargason; Sharon Gayle,5,0,26,21
1715651361488,EDS 128B,A01,507293,Pappas; Elizabeth,9,0,30,21
1715651362515,EDS 139,A00,507294,Fargason; Sharon Gayle,9,0,30,21
1715651362515,EDS 139,B00,507313,Pappas; Elizabeth,9,0,30,21
1715651363541,EDS 201,A00,507315,Staff,10,0,30,20
1715651364571,EDS 203,A01,507317,Halter; Christopher P.,10,0,30,20
1715651365599,EDS 204R,A01,507319,Halter; Christopher P.,0,3,30,30
1715651365599,EDS 204R,B01,507331,Heinzman; Erica M.,14,0,30,16
1715651366624,EDS 206R,A00,507332,Staff,0,4,30,30
1715651366624,EDS 206R,B00,507343,Staff,15,0,30,15
1715651367649,EDS 250,A00,507344,Hemans; Patricia Ann Benitez,20,0,40,20
1715651368676,EDS 281,A00,507345,Daly; Alan J.,18,0,18,0
1715651369703,EDS 284,A00,507350,Daly; Alan J.,16,0,16,0
1715651370729,EDS 286,A00,507359,Fine; Sarah,18,0,18,0
1715651371753,EDS 289C,A01,507361,Daly; Alan J.,18,0,18,0
1715651372778,EDS 290,A00,507366,Hofstetter; Carolyn,15,0,15,0
1715651373803,LIGM 5A,A00,507421,Fischer-Grunski; Eva K,17,0,20,3
1715651374828,LIGM 5B,A00,507423,Fischer-Grunski; Eva K,19,0,20,1
1715651375855,LIGM 5C,A00,507425,Fischer-Grunski; Eva K,19,0,20,1
1715651376881,LIIT 5AS,A00,507427,Carnelos; Chiara,20,0,20,0
1715651377906,LIIT 5BS,A00,507430,Carnelos; Chiara,20,0,20,0
1715651378934,LIIT 5CS,A00,507432,Carnelos; Chiara,20,0,20,0
1715651379963,LISP 5A,A00,507541,Munoz Sanchez; Alicia,11,0,20,9
1715651380990,LISP 5B,A00,507671,Munoz Sanchez; Alicia,8,0,20,12
1715651382018,LISP 5C,A00,507696,Munoz Sanchez; Alicia,8,0,20,12
1715651383044,MAE 197,001,528363,Boechler; Nicholas Sebastia,9998,0,9999,1
1715651384074,MATH 197,001,523477,Kedlaya; Kiran S.,9994,0,9999,5
1715651384074,MATH 197,002,563811,Zhang; Danna,9994,0,9999,5
1715651384074,MATH 197,003,628552,Dumitriu; Ioana,9998,0,9999,1
1715651384074,MATH 197,004,660885,Floyd; Eric,9998,0,9999,1
1715651385102,MCWP 40R,A00,518780,Staff,1,0,20,19
1715651385102,MCWP 40R,B00,518781,Carter; Jennifer A,10,0,20,10
1715651385102,MCWP 40R,C00,518783,Smith; Haydee Marie,5,0,20,15
1715651386130,MCWP 50R,A00,518791,Redela; Pamela Morgan,0,1,20,20
1715651386130,MCWP 50R,B00,518792,Krone; Jarret,0,2,20,20
1715651386130,MCWP 50R,C00,518793,Staff,0,4,20,20
1715651386130,MCWP 50R,D00,518794,Morshed; Michael James,0,2,20,20
1715651386130,MCWP 50R,E00,518795,Carter; Andrea L,0,2,20,20
1715651386130,MCWP 50R,F00,518796,Miller; Elizabeth Deen,0,1,20,20
1715651386130,MCWP 50R,G00,518797,Guillen; Melinda,0,1,20,20
1715651387155,MMW 12R,A01,514034,Herbst; Matthew,0,2,16,16
1715651387155,MMW 12R,A02,514035,Herbst; Matthew,0,0,16,16
1715651388181,MMW 13R,A01,514037,Staff,0,5,16,16
1715651388181,MMW 13R,A02,514039,Staff,0,5,16,16
1715651388181,MMW 13R,A03,628519,Staff,0,4,16,16
1715651390232,SIO 295LS,A00,523233,Staff,10,0,30,20
1715651391257,SIO 295S,A00,523232,Staff,10,0,30,20
1715651392356,SIOC 290S,A01,637330,Merrifield; Mark A,21,0,30,9
1715651393379,SIOC 291S,A01,637333,Gabriel; Corey John,21,0,30,9
1715651394408,SOCI 117,A01,494376,Staff,0,5,5,5
1715651395433,WES 237B,A00,494380,Staff,10,0,20,10
1715651397512,AESE 279B,A00,494370,Wade; Jon P,0,0,33,33
1715651398536,AIP 97,001,660915,Van Den Einde; Yael Dahlia,9998,0,9999,1
1715651399565,AIP 197,001,627712,Vespa; Emanuel Ignacio,9995,0,9999,4
1715651399565,AIP 197,002,650778,Amir; On,9998,0,9999,1
1715651399565,AIP 197,003,650933,Avenancio-Leon; Carlos,9998,0,9999,1
1715651399565,AIP 197,004,658530,Heyman; Gail D.,9998,0,9999,1
1715651399565,AIP 197,005,658631,Neal; Sonya E,9998,0,9999,1
1715651399565,AIP 197,006,658671,Du; Songzi,9998,0,9999,1
1715651400593,ANAR 135S,A00,494369,Braswell; Geoffrey E.,0,0,0,0
1715651401622,BENG 196,001,628496,Engler; Adam J.,9998,0,9999,1
1715651401622,BENG 196,002,660916,Watson; John Thomas,9998,0,9999,1
1715651402647,BISP 197,001,650773,Wilhelm; James E.,9994,0,9999,5
1715651402647,BISP 197,002,658904,Coleman; Aaron B.,9998,0,9999,1
1715651403675,CAT 124RS,A01,519847,Geibel; William,0,0,20,20
1715651404701,CAT 125RS,A01,515971,Geibel; William,0,0,20,20
1715651405726,CLRE 250,A00,511389,Morris; Sheldon,9992,0,9999,7
1715651406755,CLRE 251,A00,507176,Mehta; Ravindra L.,9992,0,9999,7
1715651406755,CLRE 251,B00,511410,Mehta; Ravindra L.,9998,0,9999,1
1715651407780,CLRE 252,A00,507189,Cuomo; Raphael Eduardo,9994,0,9999,5
1715651408809,CLRE 253,A00,507199,Vaida; Florin,9994,0,9999,5
1715651408809,CLRE 253,B00,507202,Vaida; Florin,9999,0,9999,0
1715651409836,CLRE 259,A00,507211,Patel; Hemal,9996,0,9999,3
1715651410860,CLRE 260,A00,507221,Cuomo; Raphael Eduardo,9999,0,9999,0
1715651411888,CLRE 297,001,507242,Cuomo; Raphael Eduardo,9999,0,9999,0
1715651412913,COGS 197,001,638244,Voytek; Bradley Thomas,9997,0,9999,2
1715651413995,CSE 191,A00,516875,Minnes Kemp; Mor Mia,9991,0,9999,8
1715651415024,CSE 197,001,637388,Minnes Kemp; Mor Mia,9992,0,9999,7
1715651416050,CSS 201S,A01,494383,Mignozzetti; Umberto,35,0,35,0
1715651417081,CSS 202S,A01,494387,Mignozzetti; Umberto,35,0,35,0
1715651418104,DSC 197,001,628532,Eldridge; Justin Matthew,9995,0,9999,4
1715651419131,EAP 100,A00,516065,Staff,9799,0,9999,200
1715651420163,ECE 45,A01,507414,Staff,32,0,60,28
1715651422217,ECE 111,A01,507420,Staff,11,0,50,39
1715651423249,ECE 197,001,548057,Sievenpiper; Daniel F.,9991,0,9999,8
1715651424277,EDS 115,A00,507243,Choi; Bailey Miyeon,6,0,28,22
1715651425302,EDS 117,A01,494379,Staff,0,6,34,35
1715651426327,EDS 125,A00,507246,Hopkins; Megan Beth,7,0,30,23
1715651427351,EDS 128A,A01,507264,Fargason; Sharon Gayle,5,0,26,21
1715651428376,EDS 128B,A01,507293,Pappas; Elizabeth,9,0,30,21
1715651429402,EDS 139,A00,507294,Fargason; Sharon Gayle,9,0,30,21
1715651429402,EDS 139,B00,507313,Pappas; Elizabeth,9,0,30,21
1715651430429,EDS 201,A00,507315,Staff,10,0,30,20
1715651431459,EDS 203,A01,507317,Halter; Christopher P.,10,0,30,20
1715651432489,EDS 204R,A01,507319,Halter; Christopher P.,0,3,30,30
1715651432489,EDS 204R,B01,507331,Heinzman; Erica M.,14,0,30,16
1715651433517,EDS 206R,A00,507332,Staff,0,4,30,30
1715651433517,EDS 206R,B00,507343,Staff,15,0,30,15
1715651434544,EDS 250,A00,507344,Hemans; Patricia Ann Benitez,20,0,40,20
1715651435573,EDS 281,A00,507345,Daly; Alan J.,18,0,18,0
1715651436600,EDS 284,A00,507350,Daly; Alan J.,16,0,16,0
1715651437625,EDS 286,A00,507359,Fine; Sarah,18,0,18,0
1715651438649,EDS 289C,A01,507361,Daly; Alan J.,18,0,18,0
1715651439675,EDS 290,A00,507366,Hofstetter; Carolyn,15,0,15,0
1715651440701,LIGM 5A,A00,507421,Fischer-Grunski; Eva K,17,0,20,3
1715651441730,LIGM 5B,A00,507423,Fischer-Grunski; Eva K,19,0,20,1
1715651442758,LIGM 5C,A00,507425,Fischer-Grunski; Eva K,19,0,20,1
1715651443782,LIIT 5AS,A00,507427,Carnelos; Chiara,20,0,20,0
1715651444811,LIIT 5BS,A00,507430,Carnelos; Chiara,20,0,20,0
1715651445840,LIIT 5CS,A00,507432,Carnelos; Chiara,20,0,20,0
1715651446865,LISP 5A,A00,507541,Munoz Sanchez; Alicia,11,0,20,9
1715651447890,LISP 5B,A00,507671,Munoz Sanchez; Alicia,8,0,20,12
1715651448919,LISP 5C,A00,507696,Munoz Sanchez; Alicia,8,0,20,12
1715651449948,MAE 197,001,528363,Boechler; Nicholas Sebastia,9998,0,9999,1
1715651450980,MATH 197,001,523477,Kedlaya; Kiran S.,9994,0,9999,5
1715651450980,MATH 197,002,563811,Zhang; Danna,9994,0,9999,5
1715651450980,MATH 197,003,628552,Dumitriu; Ioana,9998,0,9999,1
1715651450980,MATH 197,004,660885,Floyd; Eric,9998,0,9999,1
1715651452006,MCWP 40R,A00,518780,Staff,1,0,20,19
1715651452006,MCWP 40R,B00,518781,Carter; Jennifer A,10,0,20,10
1715651452006,MCWP 40R,C00,518783,Smith; Haydee Marie,5,0,20,15
1715651453036,MCWP 50R,A00,518791,Redela; Pamela Morgan,0,1,20,20
1715651453036,MCWP 50R,B00,518792,Krone; Jarret,0,2,20,20
1715651453036,MCWP 50R,C00,518793,Staff,0,4,20,20
1715651453036,MCWP 50R,D00,518794,Morshed; Michael James,0,2,20,20
1715651453036,MCWP 50R,E00,518795,Carter; Andrea L,0,2,20,20
1715651453036,MCWP 50R,F00,518796,Miller; Elizabeth Deen,0,1,20,20
1715651453036,MCWP 50R,G00,518797,Guillen; Melinda,0,1,20,20
1715651454065,MMW 12R,A01,514034,Herbst; Matthew,0,2,16,16
1715651454065,MMW 12R,A02,514035,Herbst; Matthew,0,0,16,16
1715651455091,MMW 13R,A01,514037,Staff,0,5,16,16
1715651455091,MMW 13R,A02,514039,Staff,0,5,16,16
1715651455091,MMW 13R,A03,628519,Staff,0,4,16,16
1715651457144,SIO 295LS,A00,523233,Staff,10,0,30,20
1715651458172,SIO 295S,A00,523232,Staff,10,0,30,20
1715651459202,SIOC 290S,A01,637330,Merrifield; Mark A,21,0,30,9
1715651460228,SIOC 291S,A01,637333,Gabriel; Corey John,21,0,30,9
1715651461253,SOCI 117,A01,494376,Staff,0,5,5,5
1715651462277,WES 237B,A00,494380,Staff,10,0,20,10
1715651464360,AESE 279B,A00,494370,Wade; Jon P,0,0,33,33
1715651465389,AIP 97,001,660915,Van Den Einde; Yael Dahlia,9998,0,9999,1
1715651466419,AIP 197,001,627712,Vespa; Emanuel Ignacio,9995,0,9999,4
1715651466419,AIP 197,002,650778,Amir; On,9998,0,9999,1
1715651466419,AIP 197,003,650933,Avenancio-Leon; Carlos,9998,0,9999,1
1715651466419,AIP 197,004,658530,Heyman; Gail D.,9998,0,9999,1
1715651466419,AIP 197,005,658631,Neal; Sonya E,9998,0,9999,1
1715651466419,AIP 197,006,658671,Du; Songzi,9998,0,9999,1
1715651467449,ANAR 135S,A00,494369,Braswell; Geoffrey E.,0,0,0,0
1715651468474,BENG 196,001,628496,Engler; Adam J.,9998,0,9999,1
1715651468474,BENG 196,002,660916,Watson; John Thomas,9998,0,9999,1
1715651469502,BISP 197,001,650773,Wilhelm; James E.,9994,0,9999,5
1715651469502,BISP 197,002,658904,Coleman; Aaron B.,9998,0,9999,1
1715651470528,CAT 124RS,A01,519847,Geibel; William,0,0,20,20
1715651471553,CAT 125RS,A01,515971,Geibel; William,0,0,20,20
1715651472583,CLRE 250,A00,511389,Morris; Sheldon,9992,0,9999,7
1715651473613,CLRE 251,A00,507176,Mehta; Ravindra L.,9992,0,9999,7
1715651473613,CLRE 251,B00,511410,Mehta; Ravindra L.,9998,0,9999,1
1715651474636,CLRE 252,A00,507189,Cuomo; Raphael Eduardo,9994,0,9999,5
1715651475665,CLRE 253,A00,507199,Vaida; Florin,9994,0,9999,5
1715651475665,CLRE 253,B00,507202,Vaida; Florin,9999,0,9999,0
1715651476689,CLRE 259,A00,507211,Patel; Hemal,9996,0,9999,3
1715651477715,CLRE 260,A00,507221,Cuomo; Raphael Eduardo,9999,0,9999,0
1715651478741,CLRE 297,001,507242,Cuomo; Raphael Eduardo,9999,0,9999,0
1715651479766,COGS 197,001,638244,Voytek; Bradley Thomas,9997,0,9999,2
1715651480794,CSE 191,A00,516875,Minnes Kemp; Mor Mia,9991,0,9999,8
1715651481819,CSE 197,001,637388,Minnes Kemp; Mor Mia,9992,0,9999,7
1715651482851,CSS 201S,A01,494383,Mignozzetti; Umberto,35,0,35,0
1715651483882,CSS 202S,A01,494387,Mignozzetti; Umberto,35,0,35,0
1715651484910,DSC 197,001,628532,Eldridge; Justin Matthew,9995,0,9999,4
1715651485935,EAP 100,A00,516065,Staff,9799,0,9999,200
1715651486963,ECE 45,A01,507414,Staff,32,0,60,28
1715651489014,ECE 111,A01,507420,Staff,11,0,50,39
1715651490041,ECE 197,001,548057,Sievenpiper; Daniel F.,9991,0,9999,8
1715651491068,EDS 115,A00,507243,Choi; Bailey Miyeon,6,0,28,22
1715651492093,EDS 117,A01,494379,Staff,0,6,34,35
1715651493117,EDS 125,A00,507246,Hopkins; Megan Beth,7,0,30,23
1715651494143,EDS 128A,A01,507264,Fargason; Sharon Gayle,5,0,26,21
1715651495172,EDS 128B,A01,507293,Pappas; Elizabeth,9,0,30,21
1715651496196,EDS 139,A00,507294,Fargason; Sharon Gayle,9,0,30,21
1715651496196,EDS 139,B00,507313,Pappas; Elizabeth,9,0,30,21
1715651497220,EDS 201,A00,507315,Staff,10,0,30,20
1715651498246,EDS 203,A01,507317,Halter; Christopher P.,10,0,30,20
1715651499273,EDS 204R,A01,507319,Halter; Christopher P.,0,3,30,30
1715651499273,EDS 204R,B01,507331,Heinzman; Erica M.,14,0,30,16
1715651500298,EDS 206R,A00,507332,Staff,0,4,30,30
1715651500298,EDS 206R,B00,507343,Staff,15,0,30,15
1715651501324,EDS 250,A00,507344,Hemans; Patricia Ann Benitez,20,0,40,20
1715651502349,EDS 281,A00,507345,Daly; Alan J.,18,0,18,0
1715651503376,EDS 284,A00,507350,Daly; Alan J.,16,0,16,0
1715651504401,EDS 286,A00,507359,Fine; Sarah,18,0,18,0
1715651505429,EDS 289C,A01,507361,Daly; Alan J.,18,0,18,0
1715651506454,EDS 290,A00,507366,Hofstetter; Carolyn,15,0,15,0
1715651507483,LIGM 5A,A00,507421,Fischer-Grunski; Eva K,17,0,20,3
1715651508509,LIGM 5B,A00,507423,Fischer-Grunski; Eva K,19,0,20,1
1715651509538,LIGM 5C,A00,507425,Fischer-Grunski; Eva K,19,0,20,1
1715651510563,LIIT 5AS,A00,507427,Carnelos; Chiara,20,0,20,0
1715651511592,LIIT 5BS,A00,507430,Carnelos; Chiara,20,0,20,0
1715651512621,LIIT 5CS,A00,507432,Carnelos; Chiara,20,0,20,0
1715651513651,LISP 5A,A00,507541,Munoz Sanchez; Alicia,11,0,20,9
1715651514679,LISP 5B,A00,507671,Munoz Sanchez; Alicia,8,0,20,12
1715651515705,LISP 5C,A00,507696,Munoz Sanchez; Alicia,8,0,20,12
1715651516731,MAE 197,001,528363,Boechler; Nicholas Sebastia,9998,0,9999,1
1715651517814,MATH 197,001,523477,Kedlaya; Kiran S.,9994,0,9999,5
1715651517814,MATH 197,002,563811,Zhang; Danna,9994,0,9999,5
1715651517814,MATH 197,003,628552,Dumitriu; Ioana,9998,0,9999,1
1715651517814,MATH 197,004,660885,Floyd; Eric,9998,0,9999,1
1715651518846,MCWP 40R,A00,518780,Staff,1,0,20,19
1715651518846,MCWP 40R,B00,518781,Carter; Jennifer A,10,0,20,10
1715651518846,MCWP 40R,C00,518783,Smith; Haydee Marie,5,0,20,15
1715651519875,MCWP 50R,A00,518791,Redela; Pamela Morgan,0,1,20,20
1715651519875,MCWP 50R,B00,518792,Krone; Jarret,0,2,20,20
1715651519875,MCWP 50R,C00,518793,Staff,0,4,20,20
1715651519875,MCWP 50R,D00,518794,Morshed; Michael James,0,2,20,20
1715651519875,MCWP 50R,E00,518795,Carter; Andrea L,0,2,20,20
1715651519875,MCWP 50R,F00,518796,Miller; Elizabeth Deen,0,1,20,20
1715651519875,MCWP 50R,G00,518797,Guillen; Melinda,0,1,20,20
1715651520901,MMW 12R,A01,514034,Herbst; Matthew,0,2,16,16
1715651520901,MMW 12R,A02,514035,Herbst; Matthew,0,0,16,16
1715651521929,MMW 13R,A01,514037,Staff,0,5,16,16
1715651521929,MMW 13R,A02,514039,Staff,0,5,16,16
1715651521929,MMW 13R,A03,628519,Staff,0,4,16,16
1715651523982,SIO 295LS,A00,523233,Staff,10,0,30,20
1715651525006,SIO 295S,A00,523232,Staff,10,0,30,20
1715651526033,SIOC 290S,A01,637330,Merrifield; Mark A,21,0,30,9
1715651527059,SIOC 291S,A01,637333,Gabriel; Corey John,21,0,30,9
1715651528087,SOCI 117,A01,494376,Staff,0,5,5,5
1715651529113,WES 237B,A00,494380,Staff,10,0,20,10
1715651531201,AESE 279B,A00,494370,Wade; Jon P,0,0,33,33
1715651532226,AIP 97,001,660915,Van Den Einde; Yael Dahlia,9998,0,9999,1
1715651533254,AIP 197,001,627712,Vespa; Emanuel Ignacio,9995,0,9999,4
1715651533254,AIP 197,002,650778,Amir; On,9998,0,9999,1
1715651533254,AIP 197,003,650933,Avenancio-Leon; Carlos,9998,0,9999,1
1715651533254,AIP 197,004,658530,Heyman; Gail D.,9998,0,9999,1
1715651533254,AIP 197,005,658631,Neal; Sonya E,9998,0,9999,1
1715651533254,AIP 197,006,658671,Du; Songzi,9998,0,9999,1
1715651534279,ANAR 135S,A00,494369,Braswell; Geoffrey E.,0,0,0,0
1715651535307,BENG 196,001,628496,Engler; Adam J.,9998,0,9999,1
1715651535307,BENG 196,002,660916,Watson; John Thomas,9998,0,9999,1
1715651536334,BISP 197,001,650773,Wilhelm; James E.,9994,0,9999,5
1715651536334,BISP 197,002,658904,Coleman; Aaron B.,9998,0,9999,1
1715651537362,CAT 124RS,A01,519847,Geibel; William,0,0,20,20
1715651538389,CAT 125RS,A01,515971,Geibel; William,0,0,20,20
1715651539421,CLRE 250,A00,511389,Morris; Sheldon,9992,0,9999,7
1715651540448,CLRE 251,A00,507176,Mehta; Ravindra L.,9992,0,9999,7
1715651540448,CLRE 251,B00,511410,Mehta; Ravindra L.,9998,0,9999,1
1715651541476,CLRE 252,A00,507189,Cuomo; Raphael Eduardo,9994,0,9999,5
1715651542502,CLRE 253,A00,507199,Vaida; Florin,9994,0,9999,5
1715651542502,CLRE 253,B00,507202,Vaida; Florin,9999,0,9999,0
1715651543527,CLRE 259,A00,507211,Patel; Hemal,9996,0,9999,3
1715651544554,CLRE 260,A00,507221,Cuomo; Raphael Eduardo,9999,0,9999,0
1715651545578,CLRE 297,001,507242,Cuomo; Raphael Eduardo,9999,0,9999,0
1715651546603,COGS 197,001,638244,Voytek; Bradley Thomas,9997,0,9999,2
1715651547633,CSE 191,A00,516875,Minnes Kemp; Mor Mia,9991,0,9999,8
1715651548658,CSE 197,001,637388,Minnes Kemp; Mor Mia,9992,0,9999,7
1715651549685,CSS 201S,A01,494383,Mignozzetti; Umberto,35,0,35,0
1715651550712,CSS 202S,A01,494387,Mignozzetti; Umberto,35,0,35,0
1715651551737,DSC 197,001,628532,Eldridge; Justin Matthew,9995,0,9999,4
1715651552765,EAP 100,A00,516065,Staff,9799,0,9999,200
1715651553793,ECE 45,A01,507414,Staff,32,0,60,28
1715651555845,ECE 111,A01,507420,Staff,11,0,50,39
1715651556871,ECE 197,001,548057,Sievenpiper; Daniel F.,9991,0,9999,8
1715651557895,EDS 115,A00,507243,Choi; Bailey Miyeon,6,0,28,22
1715651558922,EDS 117,A01,494379,Staff,0,6,34,35
1715651559947,EDS 125,A00,507246,Hopkins; Megan Beth,7,0,30,23
1715651560973,EDS 128A,A01,507264,Fargason; Sharon Gayle,5,0,26,21
1715651562002,EDS 128B,A01,507293,Pappas; Elizabeth,9,0,30,21
1715651563027,EDS 139,A00,507294,Fargason; Sharon Gayle,9,0,30,21
1715651563027,EDS 139,B00,507313,Pappas; Elizabeth,9,0,30,21
1715651564053,EDS 201,A00,507315,Staff,10,0,30,20
1715651565085,EDS 203,A01,507317,Halter; Christopher P.,10,0,30,20
1715651566111,EDS 204R,A01,507319,Halter; Christopher P.,0,3,30,30
1715651566111,EDS 204R,B01,507331,Heinzman; Erica M.,14,0,30,16
1715651567137,EDS 206R,A00,507332,Staff,0,4,30,30
1715651567137,EDS 206R,B00,507343,Staff,15,0,30,15
1715651568161,EDS 250,A00,507344,Hemans; Patricia Ann Benitez,20,0,40,20
1715651569188,EDS 281,A00,507345,Daly; Alan J.,18,0,18,0
1715651570215,EDS 284,A00,507350,Daly; Alan J.,16,0,16,0
1715651571241,EDS 286,A00,507359,Fine; Sarah,18,0,18,0
1715651572268,EDS 289C,A01,507361,Daly; Alan J.,18,0,18,0
1715651573292,EDS 290,A00,507366,Hofstetter; Carolyn,15,0,15,0
1715651574320,LIGM 5A,A00,507421,Fischer-Grunski; Eva K,17,0,20,3
1715651575345,LIGM 5B,A00,507423,Fischer-Grunski; Eva K,19,0,20,1
1715651576371,LIGM 5C,A00,507425,Fischer-Grunski; Eva K,19,0,20,1
1715651577395,LIIT 5AS,A00,507427,Carnelos; Chiara,20,0,20,0
1715651578421,LIIT 5BS,A00,507430,Carnelos; Chiara,20,0,20,0
1715651579445,LIIT 5CS,A00,507432,Carnelos; Chiara,20,0,20,0
1715651580476,LISP 5A,A00,507541,Munoz Sanchez; Alicia,11,0,20,9
1715651581499,LISP 5B,A00,507671,Munoz Sanchez; Alicia,8,0,20,12
1715651582524,LISP 5C,A00,507696,Munoz Sanchez; Alicia,8,0,20,12
1715651583549,MAE 197,001,528363,Boechler; Nicholas Sebastia,9998,0,9999,1
1715651584577,MATH 197,001,523477,Kedlaya; Kiran S.,9994,0,9999,5
1715651584577,MATH 197,002,563811,Zhang; Danna,9994,0,9999,5
1715651584577,MATH 197,003,628552,Dumitriu; Ioana,9998,0,9999,1
1715651584577,MATH 197,004,660885,Floyd; Eric,9998,0,9999,1
1715651585609,MCWP 40R,A00,518780,Staff,1,0,20,19
1715651585609,MCWP 40R,B00,518781,Carter; Jennifer A,10,0,20,10
1715651585609,MCWP 40R,C00,518783,Smith; Haydee Marie,5,0,20,15
1715651586636,MCWP 50R,A00,518791,Redela; Pamela Morgan,0,1,20,20
1715651586636,MCWP 50R,B00,518792,Krone; Jarret,0,2,20,20
1715651586636,MCWP 50R,C00,518793,Staff,0,4,20,20
1715651586636,MCWP 50R,D00,518794,Morshed; Michael James,0,2,20,20
1715651586636,MCWP 50R,E00,518795,Carter; Andrea L,0,2,20,20
1715651586636,MCWP 50R,F00,518796,Miller; Elizabeth Deen,0,1,20,20
1715651586636,MCWP 50R,G00,518797,Guillen; Melinda,0,1,20,20
1715651587664,MMW 12R,A01,514034,Herbst; Matthew,0,2,16,16
1715651587664,MMW 12R,A02,514035,Herbst; Matthew,0,0,16,16
1715651588693,MMW 13R,A01,514037,Staff,0,5,16,16
1715651588693,MMW 13R,A02,514039,Staff,0,5,16,16
1715651588693,MMW 13R,A03,628519,Staff,0,4,16,16
1715651590747,SIO 295LS,A00,523233,Staff,10,0,30,20
1715651591773,SIO 295S,A00,523232,Staff,10,0,30,20
1715651592805,SIOC 290S,A01,637330,Merrifield; Mark A,21,0,30,9
1715651593833,SIOC 291S,A01,637333,Gabriel; Corey John,21,0,30,9
1715651594859,SOCI 117,A01,494376,Staff,0,5,5,5
1715651595884,WES 237B,A00,494380,Staff,10,0,20,10
1715651597967,AESE 279B,A00,494370,Wade; Jon P,0,0,33,33
1715651598996,AIP 97,001,660915,Van Den Einde; Yael Dahlia,9998,0,9999,1
1715651600026,AIP 197,001,627712,Vespa; Emanuel Ignacio,9995,0,9999,4
1715651600026,AIP 197,002,650778,Amir; On,9998,0,9999,1
1715651600026,AIP 197,003,650933,Avenancio-Leon; Carlos,9998,0,9999,1
1715651600026,AIP 197,004,658530,Heyman; Gail D.,9998,0,9999,1
1715651600026,AIP 197,005,658631,Neal; Sonya E,9998,0,9999,1
1715651600026,AIP 197,006,658671,Du; Songzi,9998,0,9999,1
1715651601056,ANAR 135S,A00,494369,Braswell; Geoffrey E.,0,0,0,0
1715651602084,BENG 196,001,628496,Engler; Adam J.,9998,0,9999,1
1715651602084,BENG 196,002,660916,Watson; John Thomas,9998,0,9999,1
1715651603112,BISP 197,001,650773,Wilhelm; James E.,9994,0,9999,5
1715651603112,BISP 197,002,658904,Coleman; Aaron B.,9998,0,9999,1
1715651604141,CAT 124RS,A01,519847,Geibel; William,0,0,20,20
1715651605167,CAT 125RS,A01,515971,Geibel; William,0,0,20,20
1715651606192,CLRE 250,A00,511389,Morris; Sheldon,9992,0,9999,7
1715651607225,CLRE 251,A00,507176,Mehta; Ravindra L.,9992,0,9999,7
1715651607225,CLRE 251,B00,511410,Mehta; Ravindra L.,9998,0,9999,1
1715651608250,CLRE 252,A00,507189,Cuomo; Raphael Eduardo,9994,0,9999,5
1715651609278,CLRE 253,A00,507199,Vaida; Florin,9994,0,9999,5
1715651609278,CLRE 253,B00,507202,Vaida; Florin,9999,0,9999,0
1715651610304,CLRE 259,A00,507211,Patel; Hemal,9996,0,9999,3
1715651611333,CLRE 260,A00,507221,Cuomo; Raphael Eduardo,9999,0,9999,0
1715651612359,CLRE 297,001,507242,Cuomo; Raphael Eduardo,9999,0,9999,0
1715651613389,COGS 197,001,638244,Voytek; Bradley Thomas,9997,0,9999,2
1715651614417,CSE 191,A00,516875,Minnes Kemp; Mor Mia,9991,0,9999,8
1715651615441,CSE 197,001,637388,Minnes Kemp; Mor Mia,9992,0,9999,7
1715651616468,CSS 201S,A01,494383,Mignozzetti; Umberto,35,0,35,0
1715651617497,CSS 202S,A01,494387,Mignozzetti; Umberto,35,0,35,0
1715651618526,DSC 197,001,628532,Eldridge; Justin Matthew,9995,0,9999,4
1715651619552,EAP 100,A00,516065,Staff,9799,0,9999,200
1715651620593,ECE 45,A01,507414,Staff,32,0,60,28
1715651622702,ECE 111,A01,507420,Staff,11,0,50,39
1715651623731,ECE 197,001,548057,Sievenpiper; Daniel F.,9991,0,9999,8
1715651624762,EDS 115,A00,507243,Choi; Bailey Miyeon,6,0,28,22
1715651625789,EDS 117,A01,494379,Staff,0,6,34,35
1715651626819,EDS 125,A00,507246,Hopkins; Megan Beth,7,0,30,23
1715651627845,EDS 128A,A01,507264,Fargason; Sharon Gayle,5,0,26,21
1715651628871,EDS 128B,A01,507293,Pappas; Elizabeth,9,0,30,21
1715651629897,EDS 139,A00,507294,Fargason; Sharon Gayle,9,0,30,21
1715651629897,EDS 139,B00,507313,Pappas; Elizabeth,9,0,30,21
1715651630923,EDS 201,A00,507315,Staff,10,0,30,20
1715651631952,EDS 203,A01,507317,Halter; Christopher P.,10,0,30,20
1715651632983,EDS 204R,A01,507319,Halter; Christopher P.,0,3,30,30
1715651632983,EDS 204R,B01,507331,Heinzman; Erica M.,14,0,30,16
1715651634011,EDS 206R,A00,507332,Staff,0,4,30,30
1715651634011,EDS 206R,B00,507343,Staff,15,0,30,15
1715651635042,EDS 250,A00,507344,Hemans; Patricia Ann Benitez,20,0,40,20
1715651636070,EDS 281,A00,507345,Daly; Alan J.,18,0,18,0
1715651637095,EDS 284,A00,507350,Daly; Alan J.,16,0,16,0
1715651638123,EDS 286,A00,507359,Fine; Sarah,18,0,18,0
1715651639149,EDS 289C,A01,507361,Daly; Alan J.,18,0,18,0
1715651640178,EDS 290,A00,507366,Hofstetter; Carolyn,15,0,15,0
1715651641210,LIGM 5A,A00,507421,Fischer-Grunski; Eva K,17,0,20,3
1715651642239,LIGM 5B,A00,507423,Fischer-Grunski; Eva K,19,0,20,1
1715651643265,LIGM 5C,A00,507425,Fischer-Grunski; Eva K,19,0,20,1
1715651644290,LIIT 5AS,A00,507427,Carnelos; Chiara,20,0,20,0
1715651645316,LIIT 5BS,A00,507430,Carnelos; Chiara,20,0,20,0
1715651646345,LIIT 5CS,A00,507432,Carnelos; Chiara,20,0,20,0
1715651647377,LISP 5A,A00,507541,Munoz Sanchez; Alicia,11,0,20,9
1715651648407,LISP 5B,A00,507671,Munoz Sanchez; Alicia,8,0,20,12
1715651649432,LISP 5C,A00,507696,Munoz Sanchez; Alicia,8,0,20,12
1715651650456,MAE 197,001,528363,Boechler; Nicholas Sebastia,9998,0,9999,1
1715651651486,MATH 197,001,523477,Kedlaya; Kiran S.,9994,0,9999,5
1715651651486,MATH 197,002,563811,Zhang; Danna,9994,0,9999,5
1715651651486,MATH 197,003,628552,Dumitriu; Ioana,9998,0,9999,1
1715651651486,MATH 197,004,660885,Floyd; Eric,9998,0,9999,1
1715651652516,MCWP 40R,A00,518780,Staff,1,0,20,19
1715651652516,MCWP 40R,B00,518781,Carter; Jennifer A,10,0,20,10
1715651652516,MCWP 40R,C00,518783,Smith; Haydee Marie,5,0,20,15
1715651653545,MCWP 50R,A00,518791,Redela; Pamela Morgan,0,1,20,20
1715651653545,MCWP 50R,B00,518792,Krone; Jarret,0,2,20,20
1715651653545,MCWP 50R,C00,518793,Staff,0,4,20,20
1715651653545,MCWP 50R,D00,518794,Morshed; Michael James,0,2,20,20
1715651653545,MCWP 50R,E00,518795,Carter; Andrea L,0,2,20,20
1715651653545,MCWP 50R,F00,518796,Miller; Elizabeth Deen,0,1,20,20
1715651653545,MCWP 50R,G00,518797,Guillen; Melinda,0,1,20,20
1715651654570,MMW 12R,A01,514034,Herbst; Matthew,0,2,16,16
1715651654570,MMW 12R,A02,514035,Herbst; Matthew,0,0,16,16
1715651655597,MMW 13R,A01,514037,Staff,0,5,16,16
1715651655597,MMW 13R,A02,514039,Staff,0,5,16,16
1715651655597,MMW 13R,A03,628519,Staff,0,4,16,16
1715651657650,SIO 295LS,A00,523233,Staff,10,0,30,20
1715651658678,SIO 295S,A00,523232,Staff,10,0,30,20
1715651659705,SIOC 290S,A01,637330,Merrifield; Mark A,21,0,30,9
1715651660730,SIOC 291S,A01,637333,Gabriel; Corey John,21,0,30,9
1715651661759,SOCI 117,A01,494376,Staff,0,5,5,5
1715651662784,WES 237B,A00,494380,Staff,10,0,20,10
1715651664849,AESE 279B,A00,494370,Wade; Jon P,0,0,33,33
1715651665878,AIP 97,001,660915,Van Den Einde; Yael Dahlia,9998,0,9999,1
1715651666908,AIP 197,001,627712,Vespa; Emanuel Ignacio,9995,0,9999,4
1715651666908,AIP 197,002,650778,Amir; On,9998,0,9999,1
1715651666908,AIP 197,003,650933,Avenancio-Leon; Carlos,9998,0,9999,1
1715651666908,AIP 197,004,658530,Heyman; Gail D.,9998,0,9999,1
1715651666908,AIP 197,005,658631,Neal; Sonya E,9998,0,9999,1
1715651666908,AIP 197,006,658671,Du; Songzi,9998,0,9999,1
1715651667938,ANAR 135S,A00,494369,Braswell; Geoffrey E.,0,0,0,0
1715651668966,BENG 196,001,628496,Engler; Adam J.,9998,0,9999,1
1715651668966,BENG 196,002,660916,Watson; John Thomas,9998,0,9999,1
1715651669995,BISP 197,001,650773,Wilhelm; James E.,9994,0,9999,5
1715651669995,BISP 197,002,658904,Coleman; Aaron B.,9998,0,9999,1
1715651671021,CAT 124RS,A01,519847,Geibel; William,0,0,20,20
1715651672046,CAT 125RS,A01,515971,Geibel; William,0,0,20,20
1715651673075,CLRE 250,A00,511389,Morris; Sheldon,9992,0,9999,7
1715651674103,CLRE 251,A00,507176,Mehta; Ravindra L.,9992,0,9999,7
1715651674103,CLRE 251,B00,511410,Mehta; Ravindra L.,9998,0,9999,1
1715651675131,CLRE 252,A00,507189,Cuomo; Raphael Eduardo,9994,0,9999,5
1715651676157,CLRE 253,A00,507199,Vaida; Florin,9994,0,9999,5
1715651676157,CLRE 253,B00,507202,Vaida; Florin,9999,0,9999,0
1715651677185,CLRE 259,A00,507211,Patel; Hemal,9996,0,9999,3
1715651678211,CLRE 260,A00,507221,Cuomo; Raphael Eduardo,9999,0,9999,0
1715651679237,CLRE 297,001,507242,Cuomo; Raphael Eduardo,9999,0,9999,0
1715651680267,COGS 197,001,638244,Voytek; Bradley Thomas,9997,0,9999,2
1715651681294,CSE 191,A00,516875,Minnes Kemp; Mor Mia,9991,0,9999,8
1715651682319,CSE 197,001,637388,Minnes Kemp; Mor Mia,9992,0,9999,7
1715651683350,CSS 201S,A01,494383,Mignozzetti; Umberto,35,0,35,0
1715651684379,CSS 202S,A01,494387,Mignozzetti; Umberto,35,0,35,0
1715651685405,DSC 197,001,628532,Eldridge; Justin Matthew,9995,0,9999,4
1715651686434,EAP 100,A00,516065,Staff,9799,0,9999,200
1715651687461,ECE 45,A01,507414,Staff,32,0,60,28
1715651689514,ECE 111,A01,507420,Staff,11,0,50,39
1715651690539,ECE 197,001,548057,Sievenpiper; Daniel F.,9991,0,9999,8
1715651691569,EDS 115,A00,507243,Choi; Bailey Miyeon,6,0,28,22
1715651692599,EDS 117,A01,494379,Staff,0,6,34,35
1715651693626,EDS 125,A00,507246,Hopkins; Megan Beth,7,0,30,23
1715651694653,EDS 128A,A01,507264,Fargason; Sharon Gayle,5,0,26,21
1715651695680,EDS 128B,A01,507293,Pappas; Elizabeth,9,0,30,21
1715651696704,EDS 139,A00,507294,Fargason; Sharon Gayle,9,0,30,21
1715651696704,EDS 139,B00,507313,Pappas; Elizabeth,9,0,30,21
1715651697729,EDS 201,A00,507315,Staff,10,0,30,20
1715651698754,EDS 203,A01,507317,Halter; Christopher P.,10,0,30,20
1715651699780,EDS 204R,A01,507319,Halter; Christopher P.,0,3,30,30
1715651699780,EDS 204R,B01,507331,Heinzman; Erica M.,14,0,30,16
1715651700805,EDS 206R,A00,507332,Staff,0,4,30,30
1715651700805,EDS 206R,B00,507343,Staff,15,0,30,15
1715651701831,EDS 250,A00,507344,Hemans; Patricia Ann Benitez,20,0,40,20
1715651702855,EDS 281,A00,507345,Daly; Alan J.,18,0,18,0
1715651703880,EDS 284,A00,507350,Daly; Alan J.,16,0,16,0
1715651704905,EDS 286,A00,507359,Fine; Sarah,18,0,18,0
1715651705931,EDS 289C,A01,507361,Daly; Alan J.,18,0,18,0
1715651706959,EDS 290,A00,507366,Hofstetter; Carolyn,15,0,15,0
1715651707988,LIGM 5A,A00,507421,Fischer-Grunski; Eva K,17,0,20,3
1715651709015,LIGM 5B,A00,507423,Fischer-Grunski; Eva K,19,0,20,1
1715651710044,LIGM 5C,A00,507425,Fischer-Grunski; Eva K,19,0,20,1
1715651711073,LIIT 5AS,A00,507427,Carnelos; Chiara,20,0,20,0
1715651712098,LIIT 5BS,A00,507430,Carnelos; Chiara,20,0,20,0
1715651713130,LIIT 5CS,A00,507432,Carnelos; Chiara,20,0,20,0
1715651714156,LISP 5A,A00,507541,Munoz Sanchez; Alicia,11,0,20,9
1715651715181,LISP 5B,A00,507671,Munoz Sanchez; Alicia,8,0,20,12
1715651716207,LISP 5C,A00,507696,Munoz Sanchez; Alicia,8,0,20,12
1715651717234,MAE 197,001,528363,Boechler; Nicholas Sebastia,9998,0,9999,1
1715651718261,MATH 197,001,523477,Kedlaya; Kiran S.,9994,0,9999,5
1715651718261,MATH 197,002,563811,Zhang; Danna,9994,0,9999,5
1715651718261,MATH 197,003,628552,Dumitriu; Ioana,9998,0,9999,1
1715651718261,MATH 197,004,660885,Floyd; Eric,9998,0,9999,1
1715651719288,MCWP 40R,A00,518780,Staff,1,0,20,19
1715651719288,MCWP 40R,B00,518781,Carter; Jennifer A,10,0,20,10
1715651719288,MCWP 40R,C00,518783,Smith; Haydee Marie,5,0,20,15
1715651720316,MCWP 50R,A00,518791,Redela; Pamela Morgan,0,1,20,20
1715651720316,MCWP 50R,B00,518792,Krone; Jarret,0,2,20,20
1715651720316,MCWP 50R,C00,518793,Staff,0,4,20,20
1715651720316,MCWP 50R,D00,518794,Morshed; Michael James,0,2,20,20
1715651720316,MCWP 50R,E00,518795,Carter; Andrea L,0,2,20,20
1715651720316,MCWP 50R,F00,518796,Miller; Elizabeth Deen,0,1,20,20
1715651720316,MCWP 50R,G00,518797,Guillen; Melinda,0,1,20,20
1715651721341,MMW 12R,A01,514034,Herbst; Matthew,0,2,16,16
1715651721341,MMW 12R,A02,514035,Herbst; Matthew,0,0,16,16
1715651722366,MMW 13R,A01,514037,Staff,0,5,16,16
1715651722366,MMW 13R,A02,514039,Staff,0,5,16,16
1715651722366,MMW 13R,A03,628519,Staff,0,4,16,16
1715651724419,SIO 295LS,A00,523233,Staff,10,0,30,20
1715651725448,SIO 295S,A00,523232,Staff,10,0,30,20
1715651726479,SIOC 290S,A01,637330,Merrifield; Mark A,21,0,30,9
1715651727509,SIOC 291S,A01,637333,Gabriel; Corey John,21,0,30,9
1715651728534,SOCI 117,A01,494376,Staff,0,5,5,5
1715651729559,WES 237B,A00,494380,Staff,10,0,20,10
1715651731629,AESE 279B,A00,494370,Wade; Jon P,0,0,33,33
1715651732654,AIP 97,001,660915,Van Den Einde; Yael Dahlia,9998,0,9999,1
1715651733681,AIP 197,001,627712,Vespa; Emanuel Ignacio,9995,0,9999,4
1715651733681,AIP 197,002,650778,Amir; On,9998,0,9999,1
1715651733681,AIP 197,003,650933,Avenancio-Leon; Carlos,9998,0,9999,1
1715651733681,AIP 197,004,658530,Heyman; Gail D.,9998,0,9999,1
1715651733681,AIP 197,005,658631,Neal; Sonya E,9998,0,9999,1
1715651733681,AIP 197,006,658671,Du; Songzi,9998,0,9999,1
1715651734706,ANAR 135S,A00,494369,Braswell; Geoffrey E.,0,0,0,0
1715651735735,BENG 196,001,628496,Engler; Adam J.,9998,0,9999,1
1715651735735,BENG 196,002,660916,Watson; John Thomas,9998,0,9999,1
1715651736766,BISP 197,001,650773,Wilhelm; James E.,9994,0,9999,5
1715651736766,BISP 197,002,658904,Coleman; Aaron B.,9998,0,9999,1
1715651737795,CAT 124RS,A01,519847,Geibel; William,0,0,20,20
1715651738820,CAT 125RS,A01,515971,Geibel; William,0,0,20,20
1715651739846,CLRE 250,A00,511389,Morris; Sheldon,9992,0,9999,7
1715651740876,CLRE 251,A00,507176,Mehta; Ravindra L.,9992,0,9999,7
1715651740876,CLRE 251,B00,511410,Mehta; Ravindra L.,9998,0,9999,1
1715651741901,CLRE 252,A00,507189,Cuomo; Raphael Eduardo,9994,0,9999,5
1715651742928,CLRE 253,A00,507199,Vaida; Florin,9994,0,9999,5
1715651742928,CLRE 253,B00,507202,Vaida; Florin,9999,0,9999,0
1715651743954,CLRE 259,A00,507211,Patel; Hemal,9996,0,9999,3
1715651744978,CLRE 260,A00,507221,Cuomo; Raphael Eduardo,9999,0,9999,0
1715651746004,CLRE 297,001,507242,Cuomo; Raphael Eduardo,9999,0,9999,0
1715651747030,COGS 197,001,638244,Voytek; Bradley Thomas,9997,0,9999,2
1715651748056,CSE 191,A00,516875,Minnes Kemp; Mor Mia,9991,0,9999,8
1715651749081,CSE 197,001,637388,Minnes Kemp; Mor Mia,9992,0,9999,7
1715651750108,CSS 201S,A01,494383,Mignozzetti; Umberto,35,0,35,0
1715651751138,CSS 202S,A01,494387,Mignozzetti; Umberto,35,0,35,0
1715651752163,DSC 197,001,628532,Eldridge; Justin Matthew,9995,0,9999,4
1715651753190,EAP 100,A00,516065,Staff,9799,0,9999,200
1715651754218,ECE 45,A01,507414,Staff,32,0,60,28
1715651756271,ECE 111,A01,507420,Staff,11,0,50,39
1715651757300,ECE 197,001,548057,Sievenpiper; Daniel F.,9991,0,9999,8
1715651758329,EDS 115,A00,507243,Choi; Bailey Miyeon,6,0,28,22
1715651759355,EDS 117,A01,494379,Staff,0,6,34,35
1715651760382,EDS 125,A00,507246,Hopkins; Megan Beth,7,0,30,23
1715651761408,EDS 128A,A01,507264,Fargason; Sharon Gayle,5,0,26,21
1715651762437,EDS 128B,A01,507293,Pappas; Elizabeth,9,0,30,21
1715651763461,EDS 139,A00,507294,Fargason; Sharon Gayle,9,0,30,21
1715651763461,EDS 139,B00,507313,Pappas; Elizabeth,9,0,30,21
1715651764487,EDS 201,A00,507315,Staff,10,0,30,20
1715651765516,EDS 203,A01,507317,Halter; Christopher P.,10,0,30,20
1715651766543,EDS 204R,A01,507319,Halter; Christopher P.,0,3,30,30
1715651766543,EDS 204R,B01,507331,Heinzman; Erica M.,14,0,30,16
1715651767567,EDS 206R,A00,507332,Staff,0,4,30,30
1715651767567,EDS 206R,B00,507343,Staff,15,0,30,15
1715651768596,EDS 250,A00,507344,Hemans; Patricia Ann Benitez,20,0,40,20
1715651769621,EDS 281,A00,507345,Daly; Alan J.,18,0,18,0
1715651770646,EDS 284,A00,507350,Daly; Alan J.,16,0,16,0
1715651771671,EDS 286,A00,507359,Fine; Sarah,18,0,18,0
1715651772695,EDS 289C,A01,507361,Daly; Alan J.,18,0,18,0
1715651773719,EDS 290,A00,507366,Hofstetter; Carolyn,15,0,15,0
1715651774744,LIGM 5A,A00,507421,Fischer-Grunski; Eva K,17,0,20,3
1715651775770,LIGM 5B,A00,507423,Fischer-Grunski; Eva K,19,0,20,1
1715651776797,LIGM 5C,A00,507425,Fischer-Grunski; Eva K,19,0,20,1
1715651777822,LIIT 5AS,A00,507427,Carnelos; Chiara,20,0,20,0
1715651778846,LIIT 5BS,A00,507430,Carnelos; Chiara,20,0,20,0
1715651779869,LIIT 5CS,A00,507432,Carnelos; Chiara,20,0,20,0
1715651780896,LISP 5A,A00,507541,Munoz Sanchez; Alicia,11,0,20,9
1715651781925,LISP 5B,A00,507671,Munoz Sanchez; Alicia,8,0,20,12
1715651782953,LISP 5C,A00,507696,Munoz Sanchez; Alicia,8,0,20,12
1715651783982,MAE 197,001,528363,Boechler; Nicholas Sebastia,9998,0,9999,1
1715651785011,MATH 197,001,523477,Kedlaya; Kiran S.,9994,0,9999,5
1715651785011,MATH 197,002,563811,Zhang; Danna,9994,0,9999,5
1715651785011,MATH 197,003,628552,Dumitriu; Ioana,9998,0,9999,1
1715651785011,MATH 197,004,660885,Floyd; Eric,9998,0,9999,1
1715651786039,MCWP 40R,A00,518780,Staff,1,0,20,19
1715651786039,MCWP 40R,B00,518781,Carter; Jennifer A,10,0,20,10
1715651786039,MCWP 40R,C00,518783,Smith; Haydee Marie,5,0,20,15
1715651787066,MCWP 50R,A00,518791,Redela; Pamela Morgan,0,1,20,20
1715651787066,MCWP 50R,B00,518792,Krone; Jarret,0,2,20,20
1715651787066,MCWP 50R,C00,518793,Staff,0,4,20,20
1715651787066,MCWP 50R,D00,518794,Morshed; Michael James,0,2,20,20
1715651787066,MCWP 50R,E00,518795,Carter; Andrea L,0,2,20,20
1715651787066,MCWP 50R,F00,518796,Miller; Elizabeth Deen,0,1,20,20
1715651787066,MCWP 50R,G00,518797,Guillen; Melinda,0,1,20,20
1715651788091,MMW 12R,A01,514034,Herbst; Matthew,0,2,16,16
1715651788091,MMW 12R,A02,514035,Herbst; Matthew,0,0,16,16
1715651789117,MMW 13R,A01,514037,Staff,0,5,16,16
1715651789117,MMW 13R,A02,514039,Staff,0,5,16,16
1715651789117,MMW 13R,A03,628519,Staff,0,4,16,16
1715651791173,SIO 295LS,A00,523233,Staff,10,0,30,20
1715651792197,SIO 295S,A00,523232,Staff,10,0,30,20
1715651793223,SIOC 290S,A01,637330,Merrifield; Mark A,21,0,30,9
1715651794249,SIOC 291S,A01,637333,Gabriel; Corey John,21,0,30,9
1715651795273,SOCI 117,A01,494376,Staff,0,5,5,5
1715651796297,WES 237B,A00,494380,Staff,10,0,20,10
1715651798381,AESE 279B,A00,494370,Wade; Jon P,0,0,33,33
1715651799406,AIP 97,001,660915,Van Den Einde; Yael Dahlia,9998,0,9999,1
1715651800444,AIP 197,001,627712,Vespa; Emanuel Ignacio,9995,0,9999,4
1715651800444,AIP 197,002,650778,Amir; On,9998,0,9999,1
1715651800444,AIP 197,003,650933,Avenancio-Leon; Carlos,9998,0,9999,1
1715651800444,AIP 197,004,658530,Heyman; Gail D.,9998,0,9999,1
1715651800444,AIP 197,005,658631,Neal; Sonya E,9998,0,9999,1
1715651800444,AIP 197,006,658671,Du; Songzi,9998,0,9999,1
1715651801471,ANAR 135S,A00,494369,Braswell; Geoffrey E.,0,0,0,0
1715651802497,BENG 196,001,628496,Engler; Adam J.,9998,0,9999,1
1715651802497,BENG 196,002,660916,Watson; John Thomas,9998,0,9999,1
1715651803526,BISP 197,001,650773,Wilhelm; James E.,9994,0,9999,5
1715651803526,BISP 197,002,658904,Coleman; Aaron B.,9998,0,9999,1
1715651804551,CAT 124RS,A01,519847,Geibel; William,0,0,20,20
1715651805579,CAT 125RS,A01,515971,Geibel; William,0,0,20,20
1715651806607,CLRE 250,A00,511389,Morris; Sheldon,9992,0,9999,7
1715651807638,CLRE 251,A00,507176,Mehta; Ravindra L.,9992,0,9999,7
1715651807638,CLRE 251,B00,511410,Mehta; Ravindra L.,9998,0,9999,1
1715651808666,CLRE 252,A00,507189,Cuomo; Raphael Eduardo,9994,0,9999,5
1715651809694,CLRE 253,A00,507199,Vaida; Florin,9994,0,9999,5
1715651809694,CLRE 253,B00,507202,Vaida; Florin,9999,0,9999,0
1715651810723,CLRE 259,A00,507211,Patel; Hemal,9996,0,9999,3
1715651811751,CLRE 260,A00,507221,Cuomo; Raphael Eduardo,9999,0,9999,0
1715651812778,CLRE 297,001,507242,Cuomo; Raphael Eduardo,9999,0,9999,0
1715651813806,COGS 197,001,638244,Voytek; Bradley Thomas,9997,0,9999,2
1715651814833,CSE 191,A00,516875,Minnes Kemp; Mor Mia,9991,0,9999,8
1715651815859,CSE 197,001,637388,Minnes Kemp; Mor Mia,9992,0,9999,7
1715651816889,CSS 201S,A01,494383,Mignozzetti; Umberto,35,0,35,0
1715651817918,CSS 202S,A01,494387,Mignozzetti; Umberto,35,0,35,0
1715651818944,DSC 197,001,628532,Eldridge; Justin Matthew,9995,0,9999,4
1715651819969,EAP 100,A00,516065,Staff,9799,0,9999,200
1715651821002,ECE 45,A01,507414,Staff,32,0,60,28
1715651823053,ECE 111,A01,507420,Staff,11,0,50,39
1715651824080,ECE 197,001,548057,Sievenpiper; Daniel F.,9991,0,9999,8
1715651825109,EDS 115,A00,507243,Choi; Bailey Miyeon,6,0,28,22
1715651826188,EDS 117,A01,494379,Staff,0,6,34,35
1715651827213,EDS 125,A00,507246,Hopkins; Megan Beth,7,0,30,23
1715651828244,EDS 128A,A01,507264,Fargason; Sharon Gayle,5,0,26,21
1715651829268,EDS 128B,A01,507293,Pappas; Elizabeth,9,0,30,21
1715651830297,EDS 139,A00,507294,Fargason; Sharon Gayle,9,0,30,21
1715651830297,EDS 139,B00,507313,Pappas; Elizabeth,9,0,30,21
1715651831325,EDS 201,A00,507315,Staff,10,0,30,20
1715651832354,EDS 203,A01,507317,Halter; Christopher P.,10,0,30,20
1715651833383,EDS 204R,A01,507319,Halter; Christopher P.,0,3,30,30
1715651833383,EDS 204R,B01,507331,Heinzman; Erica M.,14,0,30,16
1715651834407,EDS 206R,A00,507332,Staff,0,4,30,30
1715651834407,EDS 206R,B00,507343,Staff,15,0,30,15
1715651835435,EDS 250,A00,507344,Hemans; Patricia Ann Benitez,20,0,40,20
1715651836461,EDS 281,A00,507345,Daly; Alan J.,18,0,18,0
1715651837487,EDS 284,A00,507350,Daly; Alan J.,16,0,16,0
1715651838513,EDS 286,A00,507359,Fine; Sarah,18,0,18,0
1715651839539,EDS 289C,A01,507361,Daly; Alan J.,18,0,18,0
1715651840567,EDS 290,A00,507366,Hofstetter; Carolyn,15,0,15,0
1715651841593,LIGM 5A,A00,507421,Fischer-Grunski; Eva K,17,0,20,3
1715651842623,LIGM 5B,A00,507423,Fischer-Grunski; Eva K,19,0,20,1
1715651843650,LIGM 5C,A00,507425,Fischer-Grunski; Eva K,19,0,20,1
1715651844679,LIIT 5AS,A00,507427,Carnelos; Chiara,20,0,20,0
1715651845708,LIIT 5BS,A00,507430,Carnelos; Chiara,20,0,20,0
1715651846733,LIIT 5CS,A00,507432,Carnelos; Chiara,20,0,20,0
1715651847757,LISP 5A,A00,507541,Munoz Sanchez; Alicia,11,0,20,9
1715651848782,LISP 5B,A00,507671,Munoz Sanchez; Alicia,8,0,20,12
1715651849807,LISP 5C,A00,507696,Munoz Sanchez; Alicia,8,0,20,12
1715651850831,MAE 197,001,528363,Boechler; Nicholas Sebastia,9998,0,9999,1
1715651851858,MATH 197,001,523477,Kedlaya; Kiran S.,9994,0,9999,5
1715651851858,MATH 197,002,563811,Zhang; Danna,9994,0,9999,5
1715651851858,MATH 197,003,628552,Dumitriu; Ioana,9998,0,9999,1
1715651851858,MATH 197,004,660885,Floyd; Eric,9998,0,9999,1
1715651852888,MCWP 40R,A00,518780,Staff,1,0,20,19
1715651852888,MCWP 40R,B00,518781,Carter; Jennifer A,10,0,20,10
1715651852888,MCWP 40R,C00,518783,Smith; Haydee Marie,5,0,20,15
1715651853915,MCWP 50R,A00,518791,Redela; Pamela Morgan,0,1,20,20
1715651853915,MCWP 50R,B00,518792,Krone; Jarret,0,2,20,20
1715651853915,MCWP 50R,C00,518793,Staff,0,4,20,20
1715651853915,MCWP 50R,D00,518794,Morshed; Michael James,0,2,20,20
1715651853915,MCWP 50R,E00,518795,Carter; Andrea L,0,2,20,20
1715651853915,MCWP 50R,F00,518796,Miller; Elizabeth Deen,0,1,20,20
1715651853915,MCWP 50R,G00,518797,Guillen; Melinda,0,1,20,20
1715651854940,MMW 12R,A01,514034,Herbst; Matthew,0,2,16,16
1715651854940,MMW 12R,A02,514035,Herbst; Matthew,0,0,16,16
1715651855969,MMW 13R,A01,514037,Staff,0,5,16,16
1715651855969,MMW 13R,A02,514039,Staff,0,5,16,16
1715651855969,MMW 13R,A03,628519,Staff,0,4,16,16
1715651858020,SIO 295LS,A00,523233,Staff,10,0,30,20
1715651859045,SIO 295S,A00,523232,Staff,10,0,30,20
1715651860077,SIOC 290S,A01,637330,Merrifield; Mark A,21,0,30,9
1715651861101,SIOC 291S,A01,637333,Gabriel; Corey John,21,0,30,9
1715651862129,SOCI 117,A01,494376,Staff,0,5,5,5
1715651863155,WES 237B,A00,494380,Staff,10,0,20,10
1715651865225,AESE 279B,A00,494370,Wade; Jon P,0,0,33,33
1715651866252,AIP 97,001,660915,Van Den Einde; Yael Dahlia,9998,0,9999,1
1715651867280,AIP 197,001,627712,Vespa; Emanuel Ignacio,9995,0,9999,4
1715651867280,AIP 197,002,650778,Amir; On,9998,0,9999,1
1715651867280,AIP 197,003,650933,Avenancio-Leon; Carlos,9998,0,9999,1
1715651867280,AIP 197,004,658530,Heyman; Gail D.,9998,0,9999,1
1715651867280,AIP 197,005,658631,Neal; Sonya E,9998,0,9999,1
1715651867280,AIP 197,006,658671,Du; Songzi,9998,0,9999,1
1715651868309,ANAR 135S,A00,494369,Braswell; Geoffrey E.,0,0,0,0
1715651869339,BENG 196,001,628496,Engler; Adam J.,9998,0,9999,1
1715651869339,BENG 196,002,660916,Watson; John Thomas,9998,0,9999,1
1715651870364,BISP 197,001,650773,Wilhelm; James E.,9994,0,9999,5
1715651870364,BISP 197,002,658904,Coleman; Aaron B.,9998,0,9999,1
1715651871390,CAT 124RS,A01,519847,Geibel; William,0,0,20,20
1715651872415,CAT 125RS,A01,515971,Geibel; William,0,0,20,20
1715651873444,CLRE 250,A00,511389,Morris; Sheldon,9992,0,9999,7
1715651874469,CLRE 251,A00,507176,Mehta; Ravindra L.,9992,0,9999,7
1715651874469,CLRE 251,B00,511410,Mehta; Ravindra L.,9998,0,9999,1
1715651875494,CLRE 252,A00,507189,Cuomo; Raphael Eduardo,9994,0,9999,5
1715651876521,CLRE 253,A00,507199,Vaida; Florin,9994,0,9999,5
1715651876521,CLRE 253,B00,507202,Vaida; Florin,9999,0,9999,0
1715651877549,CLRE 259,A00,507211,Patel; Hemal,9996,0,9999,3
1715651878574,CLRE 260,A00,507221,Cuomo; Raphael Eduardo,9999,0,9999,0
1715651879598,CLRE 297,001,507242,Cuomo; Raphael Eduardo,9999,0,9999,0
1715651880625,COGS 197,001,638244,Voytek; Bradley Thomas,9997,0,9999,2
1715651881656,CSE 191,A00,516875,Minnes Kemp; Mor Mia,9991,0,9999,8
1715651882682,CSE 197,001,637388,Minnes Kemp; Mor Mia,9992,0,9999,7
1715651883713,CSS 201S,A01,494383,Mignozzetti; Umberto,35,0,35,0
1715651884741,CSS 202S,A01,494387,Mignozzetti; Umberto,35,0,35,0
1715651885768,DSC 197,001,628532,Eldridge; Justin Matthew,9995,0,9999,4
1715651886795,EAP 100,A00,516065,Staff,9799,0,9999,200
1715651887822,ECE 45,A01,507414,Staff,32,0,60,28
1715651889876,ECE 111,A01,507420,Staff,11,0,50,39
1715651890902,ECE 197,001,548057,Sievenpiper; Daniel F.,9991,0,9999,8
1715651891941,EDS 115,A00,507243,Choi; Bailey Miyeon,6,0,28,22
1715651892970,EDS 117,A01,494379,Staff,0,6,34,35
1715651893994,EDS 125,A00,507246,Hopkins; Megan Beth,7,0,30,23
1715651895021,EDS 128A,A01,507264,Fargason; Sharon Gayle,5,0,26,21
1715651896049,EDS 128B,A01,507293,Pappas; Elizabeth,9,0,30,21
1715651897076,EDS 139,A00,507294,Fargason; Sharon Gayle,9,0,30,21
1715651897076,EDS 139,B00,507313,Pappas; Elizabeth,9,0,30,21
1715651898102,EDS 201,A00,507315,Staff,10,0,30,20
1715651899129,EDS 203,A01,507317,Halter; Christopher P.,10,0,30,20
1715651900155,EDS 204R,A01,507319,Halter; Christopher P.,0,3,30,30
1715651900155,EDS 204R,B01,507331,Heinzman; Erica M.,14,0,30,16
1715651901183,EDS 206R,A00,507332,Staff,0,4,30,30
1715651901183,EDS 206R,B00,507343,Staff,15,0,30,15
1715651902212,EDS 250,A00,507344,Hemans; Patricia Ann Benitez,20,0,40,20
1715651903237,EDS 281,A00,507345,Daly; Alan J.,18,0,18,0
1715651904263,EDS 284,A00,507350,Daly; Alan J.,16,0,16,0
1715651905292,EDS 286,A00,507359,Fine; Sarah,18,0,18,0
1715651906321,EDS 289C,A01,507361,Daly; Alan J.,18,0,18,0
1715651907350,EDS 290,A00,507366,Hofstetter; Carolyn,15,0,15,0
1715651908381,LIGM 5A,A00,507421,Fischer-Grunski; Eva K,17,0,20,3
1715651909407,LIGM 5B,A00,507423,Fischer-Grunski; Eva K,19,0,20,1
1715651910432,LIGM 5C,A00,507425,Fischer-Grunski; Eva K,19,0,20,1
1715651911461,LIIT 5AS,A00,507427,Carnelos; Chiara,20,0,20,0
1715651912487,LIIT 5BS,A00,507430,Carnelos; Chiara,20,0,20,0
1715651913510,LIIT 5CS,A00,507432,Carnelos; Chiara,20,0,20,0
1715651914536,LISP 5A,A00,507541,Munoz Sanchez; Alicia,11,0,20,9
1715651915565,LISP 5B,A00,507671,Munoz Sanchez; Alicia,8,0,20,12
1715651916591,LISP 5C,A00,507696,Munoz Sanchez; Alicia,8,0,20,12
1715651917616,MAE 197,001,528363,Boechler; Nicholas Sebastia,9998,0,9999,1
1715651918643,MATH 197,001,523477,Kedlaya; Kiran S.,9994,0,9999,5
1715651918643,MATH 197,002,563811,Zhang; Danna,9994,0,9999,5
1715651918643,MATH 197,003,628552,Dumitriu; Ioana,9998,0,9999,1
1715651918643,MATH 197,004,660885,Floyd; Eric,9998,0,9999,1
1715651919675,MCWP 40R,A00,518780,Staff,1,0,20,19
1715651919675,MCWP 40R,B00,518781,Carter; Jennifer A,10,0,20,10
1715651919675,MCWP 40R,C00,518783,Smith; Haydee Marie,5,0,20,15
1715651920702,MCWP 50R,A00,518791,Redela; Pamela Morgan,0,1,20,20
1715651920702,MCWP 50R,B00,518792,Krone; Jarret,0,2,20,20
1715651920702,MCWP 50R,C00,518793,Staff,0,4,20,20
1715651920702,MCWP 50R,D00,518794,Morshed; Michael James,0,2,20,20
1715651920702,MCWP 50R,E00,518795,Carter; Andrea L,0,2,20,20
1715651920702,MCWP 50R,F00,518796,Miller; Elizabeth Deen,0,1,20,20
1715651920702,MCWP 50R,G00,518797,Guillen; Melinda,0,1,20,20
1715651921732,MMW 12R,A01,514034,Herbst; Matthew,0,2,16,16
1715651921732,MMW 12R,A02,514035,Herbst; Matthew,0,0,16,16
1715651922757,MMW 13R,A01,514037,Staff,0,5,16,16
1715651922757,MMW 13R,A02,514039,Staff,0,5,16,16
1715651922757,MMW 13R,A03,628519,Staff,0,4,16,16
1715651924809,SIO 295LS,A00,523233,Staff,10,0,30,20
1715651925834,SIO 295S,A00,523232,Staff,10,0,30,20
1715651926863,SIOC 290S,A01,637330,Merrifield; Mark A,21,0,30,9
1715651927889,SIOC 291S,A01,637333,Gabriel; Corey John,21,0,30,9
1715651928917,SOCI 117,A01,494376,Staff,0,5,5,5
1715651929943,WES 237B,A00,494380,Staff,10,0,20,10
1715651932010,AESE 279B,A00,494370,Wade; Jon P,0,0,33,33
1715651933039,AIP 97,001,660915,Van Den Einde; Yael Dahlia,9998,0,9999,1
1715651934069,AIP 197,001,627712,Vespa; Emanuel Ignacio,9995,0,9999,4
1715651934069,AIP 197,002,650778,Amir; On,9998,0,9999,1
1715651934069,AIP 197,003,650933,Avenancio-Leon; Carlos,9998,0,9999,1
1715651934069,AIP 197,004,658530,Heyman; Gail D.,9998,0,9999,1
1715651934069,AIP 197,005,658631,Neal; Sonya E,9998,0,9999,1
1715651934069,AIP 197,006,658671,Du; Songzi,9998,0,9999,1
1715651935095,ANAR 135S,A00,494369,Braswell; Geoffrey E.,0,0,0,0
1715651936123,BENG 196,001,628496,Engler; Adam J.,9998,0,9999,1
1715651936123,BENG 196,002,660916,Watson; John Thomas,9998,0,9999,1
1715651937149,BISP 197,001,650773,Wilhelm; James E.,9994,0,9999,5
1715651937149,BISP 197,002,658904,Coleman; Aaron B.,9998,0,9999,1
1715651938178,CAT 124RS,A01,519847,Geibel; William,0,0,20,20
1715651939206,CAT 125RS,A01,515971,Geibel; William,0,0,20,20
1715651940233,CLRE 250,A00,511389,Morris; Sheldon,9992,0,9999,7
1715651941259,CLRE 251,A00,507176,Mehta; Ravindra L.,9992,0,9999,7
1715651941259,CLRE 251,B00,511410,Mehta; Ravindra L.,9998,0,9999,1
1715651942286,CLRE 252,A00,507189,Cuomo; Raphael Eduardo,9994,0,9999,5
1715651943312,CLRE 253,A00,507199,Vaida; Florin,9994,0,9999,5
1715651943312,CLRE 253,B00,507202,Vaida; Florin,9999,0,9999,0
1715651944339,CLRE 259,A00,507211,Patel; Hemal,9996,0,9999,3
1715651945364,CLRE 260,A00,507221,Cuomo; Raphael Eduardo,9999,0,9999,0
1715651946390,CLRE 297,001,507242,Cuomo; Raphael Eduardo,9999,0,9999,0
1715651947415,COGS 197,001,638244,Voytek; Bradley Thomas,9997,0,9999,2
1715651948440,CSE 191,A00,516875,Minnes Kemp; Mor Mia,9991,0,9999,8
1715651949466,CSE 197,001,637388,Minnes Kemp; Mor Mia,9992,0,9999,7
1715651950492,CSS 201S,A01,494383,Mignozzetti; Umberto,35,0,35,0
1715651951517,CSS 202S,A01,494387,Mignozzetti; Umberto,35,0,35,0
1715651952545,DSC 197,001,628532,Eldridge; Justin Matthew,9995,0,9999,4
1715651953573,EAP 100,A00,516065,Staff,9799,0,9999,200
1715651954604,ECE 45,A01,507414,Staff,32,0,60,28
1715651956655,ECE 111,A01,507420,Staff,11,0,50,39
1715651957684,ECE 197,001,548057,Sievenpiper; Daniel F.,9991,0,9999,8
1715651958714,EDS 115,A00,507243,Choi; Bailey Miyeon,6,0,28,22
1715651959739,EDS 117,A01,494379,Staff,0,6,34,35
1715651960764,EDS 125,A00,507246,Hopkins; Megan Beth,7,0,30,23
1715651961791,EDS 128A,A01,507264,Fargason; Sharon Gayle,5,0,26,21
1715651962819,EDS 128B,A01,507293,Pappas; Elizabeth,9,0,30,21
1715651963846,EDS 139,A00,507294,Fargason; Sharon Gayle,9,0,30,21
1715651963846,EDS 139,B00,507313,Pappas; Elizabeth,9,0,30,21
1715651964870,EDS 201,A00,507315,Staff,10,0,30,20
1715651965895,EDS 203,A01,507317,Halter; Christopher P.,10,0,30,20
1715651966925,EDS 204R,A01,507319,Halter; Christopher P.,0,3,30,30
1715651966925,EDS 204R,B01,507331,Heinzman; Erica M.,14,0,30,16
1715651967950,EDS 206R,A00,507332,Staff,0,4,30,30
1715651967950,EDS 206R,B00,507343,Staff,15,0,30,15
1715651968980,EDS 250,A00,507344,Hemans; Patricia Ann Benitez,20,0,40,20
1715651970005,EDS 281,A00,507345,Daly; Alan J.,18,0,18,0
1715651971030,EDS 284,A00,507350,Daly; Alan J.,16,0,16,0
1715651972055,EDS 286,A00,507359,Fine; Sarah,18,0,18,0
1715651973083,EDS 289C,A01,507361,Daly; Alan J.,18,0,18,0
1715651974108,EDS 290,A00,507366,Hofstetter; Carolyn,15,0,15,0
1715651975138,LIGM 5A,A00,507421,Fischer-Grunski; Eva K,17,0,20,3
1715651976165,LIGM 5B,A00,507423,Fischer-Grunski; Eva K,19,0,20,1
1715651977190,LIGM 5C,A00,507425,Fischer-Grunski; Eva K,19,0,20,1
1715651978216,LIIT 5AS,A00,507427,Carnelos; Chiara,20,0,20,0
1715651979241,LIIT 5BS,A00,507430,Carnelos; Chiara,20,0,20,0
1715651980265,LIIT 5CS,A00,507432,Carnelos; Chiara,20,0,20,0
1715651981293,LISP 5A,A00,507541,Munoz Sanchez; Alicia,11,0,20,9
1715651982318,LISP 5B,A00,507671,Munoz Sanchez; Alicia,8,0,20,12
1715651983343,LISP 5C,A00,507696,Munoz Sanchez; Alicia,8,0,20,12
1715651984370,MAE 197,001,528363,Boechler; Nicholas Sebastia,9998,0,9999,1
1715651985397,MATH 197,001,523477,Kedlaya; Kiran S.,9994,0,9999,5
1715651985397,MATH 197,002,563811,Zhang; Danna,9994,0,9999,5
1715651985397,MATH 197,003,628552,Dumitriu; Ioana,9998,0,9999,1
1715651985397,MATH 197,004,660885,Floyd; Eric,9998,0,9999,1
1715651986423,MCWP 40R,A00,518780,Staff,1,0,20,19
1715651986423,MCWP 40R,B00,518781,Carter; Jennifer A,10,0,20,10
1715651986423,MCWP 40R,C00,518783,Smith; Haydee Marie,5,0,20,15
1715651987455,MCWP 50R,A00,518791,Redela; Pamela Morgan,0,1,20,20
1715651987455,MCWP 50R,B00,518792,Krone; Jarret,0,2,20,20
1715651987455,MCWP 50R,C00,518793,Staff,0,4,20,20
1715651987455,MCWP 50R,D00,518794,Morshed; Michael James,0,2,20,20
1715651987455,MCWP 50R,E00,518795,Carter; Andrea L,0,2,20,20
1715651987455,MCWP 50R,F00,518796,Miller; Elizabeth Deen,0,1,20,20
1715651987455,MCWP 50R,G00,518797,Guillen; Melinda,0,1,20,20
1715651988481,MMW 12R,A01,514034,Herbst; Matthew,0,2,16,16
1715651988481,MMW 12R,A02,514035,Herbst; Matthew,0,0,16,16
1715651989513,MMW 13R,A01,514037,Staff,0,5,16,16
1715651989513,MMW 13R,A02,514039,Staff,0,5,16,16
1715651989513,MMW 13R,A03,628519,Staff,0,4,16,16
1715651991565,SIO 295LS,A00,523233,Staff,10,0,30,20
1715651992591,SIO 295S,A00,523232,Staff,10,0,30,20
1715651993616,SIOC 290S,A01,637330,Merrifield; Mark A,21,0,30,9
1715651994646,SIOC 291S,A01,637333,Gabriel; Corey John,21,0,30,9
1715651995674,SOCI 117,A01,494376,Staff,0,5,5,5
1715651996699,WES 237B,A00,494380,Staff,10,0,20,10
1715651998781,AESE 279B,A00,494370,Wade; Jon P,0,0,33,33
1715651999805,AIP 97,001,660915,Van Den Einde; Yael Dahlia,9998,0,9999,1
1715652000834,AIP 197,001,627712,Vespa; Emanuel Ignacio,9995,0,9999,4
1715652000834,AIP 197,002,650778,Amir; On,9998,0,9999,1
1715652000834,AIP 197,003,650933,Avenancio-Leon; Carlos,9998,0,9999,1
1715652000834,AIP 197,004,658530,Heyman; Gail D.,9998,0,9999,1
1715652000834,AIP 197,005,658631,Neal; Sonya E,9998,0,9999,1
1715652000834,AIP 197,006,658671,Du; Songzi,9998,0,9999,1
1715652001863,ANAR 135S,A00,494369,Braswell; Geoffrey E.,0,0,0,0
1715652002889,BENG 196,001,628496,Engler; Adam J.,9998,0,9999,1
1715652002889,BENG 196,002,660916,Watson; John Thomas,9998,0,9999,1
1715652003919,BISP 197,001,650773,Wilhelm; James E.,9994,0,9999,5
1715652003919,BISP 197,002,658904,Coleman; Aaron B.,9998,0,9999,1
1715652004950,CAT 124RS,A01,519847,Geibel; William,0,0,20,20
1715652005978,CAT 125RS,A01,515971,Geibel; William,0,0,20,20
1715652007005,CLRE 250,A00,511389,Morris; Sheldon,9992,0,9999,7
1715652008036,CLRE 251,A00,507176,Mehta; Ravindra L.,9992,0,9999,7
1715652008036,CLRE 251,B00,511410,Mehta; Ravindra L.,9998,0,9999,1
1715652009061,CLRE 252,A00,507189,Cuomo; Raphael Eduardo,9994,0,9999,5
1715652010088,CLRE 253,A00,507199,Vaida; Florin,9994,0,9999,5
1715652010088,CLRE 253,B00,507202,Vaida; Florin,9999,0,9999,0
1715652011114,CLRE 259,A00,507211,Patel; Hemal,9996,0,9999,3
1715652012139,CLRE 260,A00,507221,Cuomo; Raphael Eduardo,9999,0,9999,0
1715652013163,CLRE 297,001,507242,Cuomo; Raphael Eduardo,9999,0,9999,0
1715652014188,COGS 197,001,638244,Voytek; Bradley Thomas,9997,0,9999,2
1715652015216,CSE 191,A00,516875,Minnes Kemp; Mor Mia,9991,0,9999,8
1715652016243,CSE 197,001,637388,Minnes Kemp; Mor Mia,9992,0,9999,7
1715652017270,CSS 201S,A01,494383,Mignozzetti; Umberto,35,0,35,0
1715652018294,CSS 202S,A01,494387,Mignozzetti; Umberto,35,0,35,0
1715652019321,DSC 197,001,628532,Eldridge; Justin Matthew,9995,0,9999,4
1715652020348,EAP 100,A00,516065,Staff,9799,0,9999,200
1715652021383,ECE 45,A01,507414,Staff,32,0,60,28
1715652023441,ECE 111,A01,507420,Staff,11,0,50,39
1715652024468,ECE 197,001,548057,Sievenpiper; Daniel F.,9991,0,9999,8
1715652025500,EDS 115,A00,507243,Choi; Bailey Miyeon,6,0,28,22
1715652026530,EDS 117,A01,494379,Staff,0,6,34,35
1715652027559,EDS 125,A00,507246,Hopkins; Megan Beth,7,0,30,23
1715652028584,EDS 128A,A01,507264,Fargason; Sharon Gayle,5,0,26,21
1715652029642,EDS 128B,A01,507293,Pappas; Elizabeth,9,0,30,21
1715652030670,EDS 139,A00,507294,Fargason; Sharon Gayle,9,0,30,21
1715652030670,EDS 139,B00,507313,Pappas; Elizabeth,9,0,30,21
1715652031698,EDS 201,A00,507315,Staff,10,0,30,20
1715652032728,EDS 203,A01,507317,Halter; Christopher P.,10,0,30,20
1715652033754,EDS 204R,A01,507319,Halter; Christopher P.,0,3,30,30
1715652033754,EDS 204R,B01,507331,Heinzman; Erica M.,14,0,30,16
1715652034781,EDS 206R,A00,507332,Staff,0,4,30,30
1715652034781,EDS 206R,B00,507343,Staff,15,0,30,15
1715652035812,EDS 250,A00,507344,Hemans; Patricia Ann Benitez,20,0,40,20
1715652036841,EDS 281,A00,507345,Daly; Alan J.,18,0,18,0
1715652037870,EDS 284,A00,507350,Daly; Alan J.,16,0,16,0
1715652038898,EDS 286,A00,507359,Fine; Sarah,18,0,18,0
1715652039925,EDS 289C,A01,507361,Daly; Alan J.,18,0,18,0
1715652040956,EDS 290,A00,507366,Hofstetter; Carolyn,15,0,15,0
1715652041986,LIGM 5A,A00,507421,Fischer-Grunski; Eva K,17,0,20,3
1715652043012,LIGM 5B,A00,507423,Fischer-Grunski; Eva K,19,0,20,1
1715652044037,LIGM 5C,A00,507425,Fischer-Grunski; Eva K,19,0,20,1
1715652045077,LIIT 5AS,A00,507427,Carnelos; Chiara,20,0,20,0
1715652046103,LIIT 5BS,A00,507430,Carnelos; Chiara,20,0,20,0
1715652047134,LIIT 5CS,A00,507432,Carnelos; Chiara,20,0,20,0
1715652048159,LISP 5A,A00,507541,Munoz Sanchez; Alicia,11,0,20,9
1715652049183,LISP 5B,A00,507671,Munoz Sanchez; Alicia,8,0,20,12
1715652050212,LISP 5C,A00,507696,Munoz Sanchez; Alicia,8,0,20,12
1715652051240,MAE 197,001,528363,Boechler; Nicholas Sebastia,9998,0,9999,1
1715652052272,MATH 197,001,523477,Kedlaya; Kiran S.,9994,0,9999,5
1715652052272,MATH 197,002,563811,Zhang; Danna,9994,0,9999,5
1715652052272,MATH 197,003,628552,Dumitriu; Ioana,9998,0,9999,1
1715652052272,MATH 197,004,660885,Floyd; Eric,9998,0,9999,1
1715652053298,MCWP 40R,A00,518780,Staff,1,0,20,19
1715652053298,MCWP 40R,B00,518781,Carter; Jennifer A,10,0,20,10
1715652053298,MCWP 40R,C00,518783,Smith; Haydee Marie,5,0,20,15
1715652054328,MCWP 50R,A00,518791,Redela; Pamela Morgan,0,1,20,20
1715652054328,MCWP 50R,B00,518792,Krone; Jarret,0,2,20,20
1715652054328,MCWP 50R,C00,518793,Staff,0,4,20,20
1715652054328,MCWP 50R,D00,518794,Morshed; Michael James,0,2,20,20
1715652054328,MCWP 50R,E00,518795,Carter; Andrea L,0,2,20,20
1715652054328,MCWP 50R,F00,518796,Miller; Elizabeth Deen,0,1,20,20
1715652054328,MCWP 50R,G00,518797,Guillen; Melinda,0,1,20,20
1715652055353,MMW 12R,A01,514034,Herbst; Matthew,0,2,16,16
1715652055353,MMW 12R,A02,514035,Herbst; Matthew,0,0,16,16
1715652056378,MMW 13R,A01,514037,Staff,0,5,16,16
1715652056378,MMW 13R,A02,514039,Staff,0,5,16,16
1715652056378,MMW 13R,A03,628519,Staff,0,4,16,16
1715652058430,SIO 295LS,A00,523233,Staff,10,0,30,20
1715652059457,SIO 295S,A00,523232,Staff,10,0,30,20
1715652060523,SIOC 290S,A01,637330,Merrifield; Mark A,21,0,30,9
1715652061553,SIOC 291S,A01,637333,Gabriel; Corey John,21,0,30,9
1715652062580,SOCI 117,A01,494376,Staff,0,5,5,5
1715652063612,WES 237B,A00,494380,Staff,10,0,20,10
1715652065693,AESE 279B,A00,494370,Wade; Jon P,0,0,33,33
1715652066718,AIP 97,001,660915,Van Den Einde; Yael Dahlia,9998,0,9999,1
1715652067751,AIP 197,001,627712,Vespa; Emanuel Ignacio,9995,0,9999,4
1715652067751,AIP 197,002,650778,Amir; On,9998,0,9999,1
1715652067751,AIP 197,003,650933,Avenancio-Leon; Carlos,9998,0,9999,1
1715652067751,AIP 197,004,658530,Heyman; Gail D.,9998,0,9999,1
1715652067751,AIP 197,005,658631,Neal; Sonya E,9998,0,9999,1
1715652067751,AIP 197,006,658671,Du; Songzi,9998,0,9999,1
1715652068780,ANAR 135S,A00,494369,Braswell; Geoffrey E.,0,0,0,0
1715652069809,BENG 196,001,628496,Engler; Adam J.,9998,0,9999,1
1715652069809,BENG 196,002,660916,Watson; John Thomas,9998,0,9999,1
1715652070833,BISP 197,001,650773,Wilhelm; James E.,9994,0,9999,5
1715652070833,BISP 197,002,658904,Coleman; Aaron B.,9998,0,9999,1
1715652071862,CAT 124RS,A01,519847,Geibel; William,0,0,20,20
1715652072891,CAT 125RS,A01,515971,Geibel; William,0,0,20,20
1715652073915,CLRE 250,A00,511389,Morris; Sheldon,9992,0,9999,7
1715652074949,CLRE 251,A00,507176,Mehta; Ravindra L.,9992,0,9999,7
1715652074949,CLRE 251,B00,511410,Mehta; Ravindra L.,9998,0,9999,1
1715652075976,CLRE 252,A00,507189,Cuomo; Raphael Eduardo,9994,0,9999,5
1715652077003,CLRE 253,A00,507199,Vaida; Florin,9994,0,9999,5
1715652077003,CLRE 253,B00,507202,Vaida; Florin,9999,0,9999,0
1715652078029,CLRE 259,A00,507211,Patel; Hemal,9996,0,9999,3
1715652079053,CLRE 260,A00,507221,Cuomo; Raphael Eduardo,9999,0,9999,0
1715652080079,CLRE 297,001,507242,Cuomo; Raphael Eduardo,9999,0,9999,0
1715652081119,COGS 197,001,638244,Voytek; Bradley Thomas,9997,0,9999,2
1715652082148,CSE 191,A00,516875,Minnes Kemp; Mor Mia,9991,0,9999,8
1715652083171,CSE 197,001,637388,Minnes Kemp; Mor Mia,9992,0,9999,7
1715652084201,CSS 201S,A01,494383,Mignozzetti; Umberto,35,0,35,0
1715652085231,CSS 202S,A01,494387,Mignozzetti; Umberto,35,0,35,0
1715652086256,DSC 197,001,628532,Eldridge; Justin Matthew,9995,0,9999,4
1715652087281,EAP 100,A00,516065,Staff,9799,0,9999,200
1715652088308,ECE 45,A01,507414,Staff,32,0,60,28
1715652090362,ECE 111,A01,507420,Staff,11,0,50,39
1715652091385,ECE 197,001,548057,Sievenpiper; Daniel F.,9991,0,9999,8
1715652092412,EDS 115,A00,507243,Choi; Bailey Miyeon,6,0,28,22
1715652093440,EDS 117,A01,494379,Staff,0,6,34,35
1715652094467,EDS 125,A00,507246,Hopkins; Megan Beth,7,0,30,23
1715652095494,EDS 128A,A01,507264,Fargason; Sharon Gayle,5,0,26,21
1715652096523,EDS 128B,A01,507293,Pappas; Elizabeth,9,0,30,21
1715652097549,EDS 139,A00,507294,Fargason; Sharon Gayle,9,0,30,21
1715652097549,EDS 139,B00,507313,Pappas; Elizabeth,9,0,30,21
1715652098573,EDS 201,A00,507315,Staff,10,0,30,20
1715652099599,EDS 203,A01,507317,Halter; Christopher P.,10,0,30,20
1715652100625,EDS 204R,A01,507319,Halter; Christopher P.,0,3,30,30
1715652100625,EDS 204R,B01,507331,Heinzman; Erica M.,14,0,30,16
1715652101653,EDS 206R,A00,507332,Staff,0,4,30,30
1715652101653,EDS 206R,B00,507343,Staff,15,0,30,15
1715652102678,EDS 250,A00,507344,Hemans; Patricia Ann Benitez,20,0,40,20
1715652103703,EDS 281,A00,507345,Daly; Alan J.,18,0,18,0
1715652104727,EDS 284,A00,507350,Daly; Alan J.,16,0,16,0
1715652105752,EDS 286,A00,507359,Fine; Sarah,18,0,18,0
1715652106782,EDS 289C,A01,507361,Daly; Alan J.,18,0,18,0
1715652107809,EDS 290,A00,507366,Hofstetter; Carolyn,15,0,15,0
1715652108839,LIGM 5A,A00,507421,Fischer-Grunski; Eva K,17,0,20,3
1715652109868,LIGM 5B,A00,507423,Fischer-Grunski; Eva K,19,0,20,1
1715652110894,LIGM 5C,A00,507425,Fischer-Grunski; Eva K,19,0,20,1
1715652111922,LIIT 5AS,A00,507427,Carnelos; Chiara,20,0,20,0
1715652112952,LIIT 5BS,A00,507430,Carnelos; Chiara,20,0,20,0
1715652113981,LIIT 5CS,A00,507432,Carnelos; Chiara,20,0,20,0
1715652115009,LISP 5A,A00,507541,Munoz Sanchez; Alicia,11,0,20,9
1715652116035,LISP 5B,A00,507671,Munoz Sanchez; Alicia,8,0,20,12
1715652117064,LISP 5C,A00,507696,Munoz Sanchez; Alicia,8,0,20,12
1715652118092,MAE 197,001,528363,Boechler; Nicholas Sebastia,9998,0,9999,1
1715652119121,MATH 197,001,523477,Kedlaya; Kiran S.,9994,0,9999,5
1715652119121,MATH 197,002,563811,Zhang; Danna,9994,0,9999,5
1715652119121,MATH 197,003,628552,Dumitriu; Ioana,9998,0,9999,1
1715652119121,MATH 197,004,660885,Floyd; Eric,9998,0,9999,1
1715652120148,MCWP 40R,A00,518780,Staff,1,0,20,19
1715652120148,MCWP 40R,B00,518781,Carter; Jennifer A,10,0,20,10
1715652120148,MCWP 40R,C00,518783,Smith; Haydee Marie,5,0,20,15
1715652121178,MCWP 50R,A00,518791,Redela; Pamela Morgan,0,1,20,20
1715652121178,MCWP 50R,B00,518792,Krone; Jarret,0,2,20,20
1715652121178,MCWP 50R,C00,518793,Staff,0,4,20,20
1715652121178,MCWP 50R,D00,518794,Morshed; Michael James,0,2,20,20
1715652121178,MCWP 50R,E00,518795,Carter; Andrea L,0,2,20,20
1715652121178,MCWP 50R,F00,518796,Miller; Elizabeth Deen,0,1,20,20
1715652121178,MCWP 50R,G00,518797,Guillen; Melinda,0,1,20,20
1715652122209,MMW 12R,A01,514034,Herbst; Matthew,0,2,16,16
1715652122209,MMW 12R,A02,514035,Herbst; Matthew,0,0,16,16
1715652123239,MMW 13R,A01,514037,Staff,0,5,16,16
1715652123239,MMW 13R,A02,514039,Staff,0,5,16,16
1715652123239,MMW 13R,A03,628519,Staff,0,4,16,16
1715652125293,SIO 295LS,A00,523233,Staff,10,0,30,20
1715652126320,SIO 295S,A00,523232,Staff,10,0,30,20
1715652127348,SIOC 290S,A01,637330,Merrifield; Mark A,21,0,30,9
1715652128378,SIOC 291S,A01,637333,Gabriel; Corey John,21,0,30,9
1715652129404,SOCI 117,A01,494376,Staff,0,5,5,5
1715652130427,WES 237B,A00,494380,Staff,10,0,20,10
1715652132501,AESE 279B,A00,494370,Wade; Jon P,0,0,33,33
1715652133526,AIP 97,001,660915,Van Den Einde; Yael Dahlia,9998,0,9999,1
1715652134558,AIP 197,001,627712,Vespa; Emanuel Ignacio,9995,0,9999,4
1715652134558,AIP 197,002,650778,Amir; On,9998,0,9999,1
1715652134558,AIP 197,003,650933,Avenancio-Leon; Carlos,9998,0,9999,1
1715652134558,AIP 197,004,658530,Heyman; Gail D.,9998,0,9999,1
1715652134558,AIP 197,005,658631,Neal; Sonya E,9998,0,9999,1
1715652134558,AIP 197,006,658671,Du; Songzi,9998,0,9999,1
1715652135586,ANAR 135S,A00,494369,Braswell; Geoffrey E.,0,0,0,0
1715652136613,BENG 196,001,628496,Engler; Adam J.,9998,0,9999,1
1715652136613,BENG 196,002,660916,Watson; John Thomas,9998,0,9999,1
1715652137637,BISP 197,001,650773,Wilhelm; James E.,9994,0,9999,5
1715652137637,BISP 197,002,658904,Coleman; Aaron B.,9998,0,9999,1
1715652138662,CAT 124RS,A01,519847,Geibel; William,0,0,20,20
1715652139688,CAT 125RS,A01,515971,Geibel; William,0,0,20,20
1715652140713,CLRE 250,A00,511389,Morris; Sheldon,9992,0,9999,7
1715652141738,CLRE 251,A00,507176,Mehta; Ravindra L.,9992,0,9999,7
1715652141738,CLRE 251,B00,511410,Mehta; Ravindra L.,9998,0,9999,1
1715652142770,CLRE 252,A00,507189,Cuomo; Raphael Eduardo,9994,0,9999,5
1715652143798,CLRE 253,A00,507199,Vaida; Florin,9994,0,9999,5
1715652143798,CLRE 253,B00,507202,Vaida; Florin,9999,0,9999,0
1715652144825,CLRE 259,A00,507211,Patel; Hemal,9996,0,9999,3
1715652145850,CLRE 260,A00,507221,Cuomo; Raphael Eduardo,9999,0,9999,0
1715652146875,CLRE 297,001,507242,Cuomo; Raphael Eduardo,9999,0,9999,0
1715652147905,COGS 197,001,638244,Voytek; Bradley Thomas,9997,0,9999,2
1715652148934,CSE 191,A00,516875,Minnes Kemp; Mor Mia,9991,0,9999,8
1715652149963,CSE 197,001,637388,Minnes Kemp; Mor Mia,9992,0,9999,7
1715652150996,CSS 201S,A01,494383,Mignozzetti; Umberto,35,0,35,0
1715652152025,CSS 202S,A01,494387,Mignozzetti; Umberto,35,0,35,0
1715652153052,DSC 197,001,628532,Eldridge; Justin Matthew,9995,0,9999,4
1715652154077,EAP 100,A00,516065,Staff,9799,0,9999,200
1715652155104,ECE 45,A01,507414,Staff,32,0,60,28
1715652157155,ECE 111,A01,507420,Staff,11,0,50,39
1715652158179,ECE 197,001,548057,Sievenpiper; Daniel F.,9991,0,9999,8
1715652159206,EDS 115,A00,507243,Choi; Bailey Miyeon,6,0,28,22
1715652160230,EDS 117,A01,494379,Staff,0,6,34,35
1715652161259,EDS 125,A00,507246,Hopkins; Megan Beth,7,0,30,23
1715652162287,EDS 128A,A01,507264,Fargason; Sharon Gayle,5,0,26,21
1715652163311,EDS 128B,A01,507293,Pappas; Elizabeth,9,0,30,21
1715652164336,EDS 139,A00,507294,Fargason; Sharon Gayle,9,0,30,21
1715652164336,EDS 139,B00,507313,Pappas; Elizabeth,9,0,30,21
1715652165363,EDS 201,A00,507315,Staff,10,0,30,20
1715652166391,EDS 203,A01,507317,Halter; Christopher P.,10,0,30,20
1715652167419,EDS 204R,A01,507319,Halter; Christopher P.,0,3,30,30
1715652167419,EDS 204R,B01,507331,Heinzman; Erica M.,14,0,30,16
1715652168445,EDS 206R,A00,507332,Staff,0,4,30,30
1715652168445,EDS 206R,B00,507343,Staff,15,0,30,15
1715652169477,EDS 250,A00,507344,Hemans; Patricia Ann Benitez,20,0,40,20
1715652170518,EDS 281,A00,507345,Daly; Alan J.,18,0,18,0
1715652171545,EDS 284,A00,507350,Daly; Alan J.,16,0,16,0
1715652172572,EDS 286,A00,507359,Fine; Sarah,18,0,18,0
1715652173597,EDS 289C,A01,507361,Daly; Alan J.,18,0,18,0
1715652174626,EDS 290,A00,507366,Hofstetter; Carolyn,15,0,15,0
1715652175653,LIGM 5A,A00,507421,Fischer-Grunski; Eva K,17,0,20,3
1715652176678,LIGM 5B,A00,507423,Fischer-Grunski; Eva K,19,0,20,1
1715652177708,LIGM 5C,A00,507425,Fischer-Grunski; Eva K,19,0,20,1
1715652178737,LIIT 5AS,A00,507427,Carnelos; Chiara,20,0,20,0
1715652179765,LIIT 5BS,A00,507430,Carnelos; Chiara,20,0,20,0
1715652180789,LIIT 5CS,A00,507432,Carnelos; Chiara,20,0,20,0
1715652181815,LISP 5A,A00,507541,Munoz Sanchez; Alicia,11,0,20,9
1715652182841,LISP 5B,A00,507671,Munoz Sanchez; Alicia,8,0,20,12
1715652183865,LISP 5C,A00,507696,Munoz Sanchez; Alicia,8,0,20,12
1715652184891,MAE 197,001,528363,Boechler; Nicholas Sebastia,9998,0,9999,1
1715652185923,MATH 197,001,523477,Kedlaya; Kiran S.,9994,0,9999,5
1715652185923,MATH 197,002,563811,Zhang; Danna,9994,0,9999,5
1715652185923,MATH 197,003,628552,Dumitriu; Ioana,9998,0,9999,1
1715652185923,MATH 197,004,660885,Floyd; Eric,9998,0,9999,1
1715652186949,MCWP 40R,A00,518780,Staff,1,0,20,19
1715652186949,MCWP 40R,B00,518781,Carter; Jennifer A,10,0,20,10
1715652186949,MCWP 40R,C00,518783,Smith; Haydee Marie,5,0,20,15
1715652187984,MCWP 50R,A00,518791,Redela; Pamela Morgan,0,1,20,20
1715652187984,MCWP 50R,B00,518792,Krone; Jarret,0,2,20,20
1715652187984,MCWP 50R,C00,518793,Staff,0,4,20,20
1715652187984,MCWP 50R,D00,518794,Morshed; Michael James,0,2,20,20
1715652187984,MCWP 50R,E00,518795,Carter; Andrea L,0,2,20,20
1715652187984,MCWP 50R,F00,518796,Miller; Elizabeth Deen,0,1,20,20
1715652187984,MCWP 50R,G00,518797,Guillen; Melinda,0,1,20,20
1715652189009,MMW 12R,A01,514034,Herbst; Matthew,0,2,16,16
1715652189009,MMW 12R,A02,514035,Herbst; Matthew,0,0,16,16
1715652190034,MMW 13R,A01,514037,Staff,0,5,16,16
1715652190034,MMW 13R,A02,514039,Staff,0,5,16,16
1715652190034,MMW 13R,A03,628519,Staff,0,4,16,16
1715652192086,SIO 295LS,A00,523233,Staff,10,0,30,20
1715652193113,SIO 295S,A00,523232,Staff,10,0,30,20
1715652194145,SIOC 290S,A01,637330,Merrifield; Mark A,21,0,30,9
1715652195171,SIOC 291S,A01,637333,Gabriel; Corey John,21,0,30,9
1715652196201,SOCI 117,A01,494376,Staff,0,5,5,5
1715652197230,WES 237B,A00,494380,Staff,10,0,20,10
1715652199307,AESE 279B,A00,494370,Wade; Jon P,0,0,33,33
1715652200332,AIP 97,001,660915,Van Den Einde; Yael Dahlia,9998,0,9999,1
1715652201360,AIP 197,001,627712,Vespa; Emanuel Ignacio,9995,0,9999,4
1715652201360,AIP 197,002,650778,Amir; On,9998,0,9999,1
1715652201360,AIP 197,003,650933,Avenancio-Leon; Carlos,9998,0,9999,1
1715652201360,AIP 197,004,658530,Heyman; Gail D.,9998,0,9999,1
1715652201360,AIP 197,005,658631,Neal; Sonya E,9998,0,9999,1
1715652201360,AIP 197,006,658671,Du; Songzi,9998,0,9999,1
1715652202386,ANAR 135S,A00,494369,Braswell; Geoffrey E.,0,0,0,0
1715652203411,BENG 196,001,628496,Engler; Adam J.,9998,0,9999,1
1715652203411,BENG 196,002,660916,Watson; John Thomas,9998,0,9999,1
1715652204439,BISP 197,001,650773,Wilhelm; James E.,9994,0,9999,5
1715652204439,BISP 197,002,658904,Coleman; Aaron B.,9998,0,9999,1
1715652205468,CAT 124RS,A01,519847,Geibel; William,0,0,20,20
1715652206496,CAT 125RS,A01,515971,Geibel; William,0,0,20,20
1715652207521,CLRE 250,A00,511389,Morris; Sheldon,9992,0,9999,7
1715652208552,CLRE 251,A00,507176,Mehta; Ravindra L.,9992,0,9999,7
1715652208552,CLRE 251,B00,511410,Mehta; Ravindra L.,9998,0,9999,1
1715652209577,CLRE 252,A00,507189,Cuomo; Raphael Eduardo,9994,0,9999,5
1715652210601,CLRE 253,A00,507199,Vaida; Florin,9994,0,9999,5
1715652210601,CLRE 253,B00,507202,Vaida; Florin,9999,0,9999,0
1715652211626,CLRE 259,A00,507211,Patel; Hemal,9996,0,9999,3
1715652212649,CLRE 260,A00,507221,Cuomo; Raphael Eduardo,9999,0,9999,0
1715652213676,CLRE 297,001,507242,Cuomo; Raphael Eduardo,9999,0,9999,0
1715652214703,COGS 197,001,638244,Voytek; Bradley Thomas,9997,0,9999,2
1715652215731,CSE 191,A00,516875,Minnes Kemp; Mor Mia,9991,0,9999,8
1715652216757,CSE 197,001,637388,Minnes Kemp; Mor Mia,9992,0,9999,7
1715652217784,CSS 201S,A01,494383,Mignozzetti; Umberto,35,0,35,0
1715652218811,CSS 202S,A01,494387,Mignozzetti; Umberto,35,0,35,0
1715652219840,DSC 197,001,628532,Eldridge; Justin Matthew,9995,0,9999,4
1715652220866,EAP 100,A00,516065,Staff,9799,0,9999,200
1715652221898,ECE 45,A01,507414,Staff,32,0,60,28
1715652223955,ECE 111,A01,507420,Staff,11,0,50,39
1715652224980,ECE 197,001,548057,Sievenpiper; Daniel F.,9991,0,9999,8
1715652226007,EDS 115,A00,507243,Choi; Bailey Miyeon,6,0,28,22
1715652227034,EDS 117,A01,494379,Staff,0,6,34,35
1715652228061,EDS 125,A00,507246,Hopkins; Megan Beth,7,0,30,23
1715652229085,EDS 128A,A01,507264,Fargason; Sharon Gayle,5,0,26,21
1715652230114,EDS 128B,A01,507293,Pappas; Elizabeth,9,0,30,21
1715652231139,EDS 139,A00,507294,Fargason; Sharon Gayle,9,0,30,21
1715652231139,EDS 139,B00,507313,Pappas; Elizabeth,9,0,30,21
1715652232167,EDS 201,A00,507315,Staff,10,0,30,20
1715652233194,EDS 203,A01,507317,Halter; Christopher P.,10,0,30,20
1715652234226,EDS 204R,A01,507319,Halter; Christopher P.,0,3,30,30
1715652234226,EDS 204R,B01,507331,Heinzman; Erica M.,14,0,30,16
1715652235250,EDS 206R,A00,507332,Staff,0,4,30,30
1715652235250,EDS 206R,B00,507343,Staff,15,0,30,15
1715652236300,EDS 250,A00,507344,Hemans; Patricia Ann Benitez,20,0,40,20
1715652237326,EDS 281,A00,507345,Daly; Alan J.,18,0,18,0
1715652238354,EDS 284,A00,507350,Daly; Alan J.,16,0,16,0
1715652239379,EDS 286,A00,507359,Fine; Sarah,18,0,18,0
1715652240405,EDS 289C,A01,507361,Daly; Alan J.,18,0,18,0
1715652241435,EDS 290,A00,507366,Hofstetter; Carolyn,15,0,15,0
1715652242474,LIGM 5A,A00,507421,Fischer-Grunski; Eva K,17,0,20,3
1715652243499,LIGM 5B,A00,507423,Fischer-Grunski; Eva K,19,0,20,1
1715652244529,LIGM 5C,A00,507425,Fischer-Grunski; Eva K,19,0,20,1
1715652245557,LIIT 5AS,A00,507427,Carnelos; Chiara,20,0,20,0
1715652246583,LIIT 5BS,A00,507430,Carnelos; Chiara,20,0,20,0
1715652247608,LIIT 5CS,A00,507432,Carnelos; Chiara,20,0,20,0
1715652248637,LISP 5A,A00,507541,Munoz Sanchez; Alicia,11,0,20,9
1715652249662,LISP 5B,A00,507671,Munoz Sanchez; Alicia,8,0,20,12
1715652250691,LISP 5C,A00,507696,Munoz Sanchez; Alicia,8,0,20,12
1715652251720,MAE 197,001,528363,Boechler; Nicholas Sebastia,9998,0,9999,1
1715652252753,MATH 197,001,523477,Kedlaya; Kiran S.,9994,0,9999,5
1715652252753,MATH 197,002,563811,Zhang; Danna,9994,0,9999,5
1715652252753,MATH 197,003,628552,Dumitriu; Ioana,9998,0,9999,1
1715652252753,MATH 197,004,660885,Floyd; Eric,9998,0,9999,1
1715652253778,MCWP 40R,A00,518780,Staff,1,0,20,19
1715652253778,MCWP 40R,B00,518781,Carter; Jennifer A,10,0,20,10
1715652253778,MCWP 40R,C00,518783,Smith; Haydee Marie,5,0,20,15
1715652254805,MCWP 50R,A00,518791,Redela; Pamela Morgan,0,1,20,20
1715652254805,MCWP 50R,B00,518792,Krone; Jarret,0,2,20,20
1715652254805,MCWP 50R,C00,518793,Staff,0,4,20,20
1715652254805,MCWP 50R,D00,518794,Morshed; Michael James,0,2,20,20
1715652254805,MCWP 50R,E00,518795,Carter; Andrea L,0,2,20,20
1715652254805,MCWP 50R,F00,518796,Miller; Elizabeth Deen,0,1,20,20
1715652254805,MCWP 50R,G00,518797,Guillen; Melinda,0,1,20,20
1715652255831,MMW 12R,A01,514034,Herbst; Matthew,0,2,16,16
1715652255831,MMW 12R,A02,514035,Herbst; Matthew,0,0,16,16
1715652256859,MMW 13R,A01,514037,Staff,0,5,16,16
1715652256859,MMW 13R,A02,514039,Staff,0,5,16,16
1715652256859,MMW 13R,A03,628519,Staff,0,4,16,16
1715652258911,SIO 295LS,A00,523233,Staff,10,0,30,20
1715652259938,SIO 295S,A00,523232,Staff,10,0,30,20
1715652260965,SIOC 290S,A01,637330,Merrifield; Mark A,21,0,30,9
1715652261991,SIOC 291S,A01,637333,Gabriel; Corey John,21,0,30,9
1715652263016,SOCI 117,A01,494376,Staff,0,5,5,5
1715652264040,WES 237B,A00,494380,Staff,10,0,20,10
1715652266110,AESE 279B,A00,494370,Wade; Jon P,0,0,33,33
1715652267135,AIP 97,001,660915,Van Den Einde; Yael Dahlia,9998,0,9999,1
1715652268165,AIP 197,001,627712,Vespa; Emanuel Ignacio,9995,0,9999,4
1715652268165,AIP 197,002,650778,Amir; On,9998,0,9999,1
1715652268165,AIP 197,003,650933,Avenancio-Leon; Carlos,9998,0,9999,1
1715652268165,AIP 197,004,658530,Heyman; Gail D.,9998,0,9999,1
1715652268165,AIP 197,005,658631,Neal; Sonya E,9998,0,9999,1
1715652268165,AIP 197,006,658671,Du; Songzi,9998,0,9999,1
1715652269190,ANAR 135S,A00,494369,Braswell; Geoffrey E.,0,0,0,0
1715652270221,BENG 196,001,628496,Engler; Adam J.,9998,0,9999,1
1715652270221,BENG 196,002,660916,Watson; John Thomas,9998,0,9999,1
1715652271247,BISP 197,001,650773,Wilhelm; James E.,9994,0,9999,5
1715652271247,BISP 197,002,658904,Coleman; Aaron B.,9998,0,9999,1
1715652272274,CAT 124RS,A01,519847,Geibel; William,0,0,20,20
1715652273301,CAT 125RS,A01,515971,Geibel; William,0,0,20,20
1715652274327,CLRE 250,A00,511389,Morris; Sheldon,9992,0,9999,7
1715652275354,CLRE 251,A00,507176,Mehta; Ravindra L.,9992,0,9999,7
1715652275354,CLRE 251,B00,511410,Mehta; Ravindra L.,9998,0,9999,1
1715652276380,CLRE 252,A00,507189,Cuomo; Raphael Eduardo,9994,0,9999,5
1715652277405,CLRE 253,A00,507199,Vaida; Florin,9994,0,9999,5
1715652277405,CLRE 253,B00,507202,Vaida; Florin,9999,0,9999,0
1715652278432,CLRE 259,A00,507211,Patel; Hemal,9996,0,9999,3
1715652279457,CLRE 260,A00,507221,Cuomo; Raphael Eduardo,9999,0,9999,0
1715652280485,CLRE 297,001,507242,Cuomo; Raphael Eduardo,9999,0,9999,0
1715652281510,COGS 197,001,638244,Voytek; Bradley Thomas,9997,0,9999,2
1715652282537,CSE 191,A00,516875,Minnes Kemp; Mor Mia,9991,0,9999,8
1715652283581,CSE 197,001,637388,Minnes Kemp; Mor Mia,9992,0,9999,7
1715652284611,CSS 201S,A01,494383,Mignozzetti; Umberto,35,0,35,0
1715652285640,CSS 202S,A01,494387,Mignozzetti; Umberto,35,0,35,0
1715652286665,DSC 197,001,628532,Eldridge; Justin Matthew,9995,0,9999,4
1715652287691,EAP 100,A00,516065,Staff,9799,0,9999,200
1715652288721,ECE 45,A01,507414,Staff,32,0,60,28
1715652290775,ECE 111,A01,507420,Staff,11,0,50,39
1715652291801,ECE 197,001,548057,Sievenpiper; Daniel F.,9991,0,9999,8
1715652292830,EDS 115,A00,507243,Choi; Bailey Miyeon,6,0,28,22
1715652293857,EDS 117,A01,494379,Staff,0,6,34,35
1715652294883,EDS 125,A00,507246,Hopkins; Megan Beth,7,0,30,23
1715652295909,EDS 128A,A01,507264,Fargason; Sharon Gayle,5,0,26,21
1715652296940,EDS 128B,A01,507293,Pappas; Elizabeth,9,0,30,21
1715652297967,EDS 139,A00,507294,Fargason; Sharon Gayle,9,0,30,21
1715652297967,EDS 139,B00,507313,Pappas; Elizabeth,9,0,30,21
1715652298993,EDS 201,A00,507315,Staff,10,0,30,20
1715652300019,EDS 203,A01,507317,Halter; Christopher P.,10,0,30,20
1715652301048,EDS 204R,A01,507319,Halter; Christopher P.,0,3,30,30
1715652301048,EDS 204R,B01,507331,Heinzman; Erica M.,14,0,30,16
1715652302085,EDS 206R,A00,507332,Staff,0,4,30,30
1715652302085,EDS 206R,B00,507343,Staff,15,0,30,15
1715652303111,EDS 250,A00,507344,Hemans; Patricia Ann Benitez,20,0,40,20
1715652304136,EDS 281,A00,507345,Daly; Alan J.,18,0,18,0
1715652305160,EDS 284,A00,507350,Daly; Alan J.,16,0,16,0
1715652306189,EDS 286,A00,507359,Fine; Sarah,18,0,18,0
1715652307215,EDS 289C,A01,507361,Daly; Alan J.,18,0,18,0
1715652308241,EDS 290,A00,507366,Hofstetter; Carolyn,15,0,15,0
1715652309267,LIGM 5A,A00,507421,Fischer-Grunski; Eva K,17,0,20,3
1715652310292,LIGM 5B,A00,507423,Fischer-Grunski; Eva K,19,0,20,1
1715652311321,LIGM 5C,A00,507425,Fischer-Grunski; Eva K,19,0,20,1
1715652312351,LIIT 5AS,A00,507427,Carnelos; Chiara,20,0,20,0
1715652313377,LIIT 5BS,A00,507430,Carnelos; Chiara,20,0,20,0
1715652314407,LIIT 5CS,A00,507432,Carnelos; Chiara,20,0,20,0
1715652315433,LISP 5A,A00,507541,Munoz Sanchez; Alicia,11,0,20,9
1715652316458,LISP 5B,A00,507671,Munoz Sanchez; Alicia,8,0,20,12
1715652317489,LISP 5C,A00,507696,Munoz Sanchez; Alicia,8,0,20,12
1715652318515,MAE 197,001,528363,Boechler; Nicholas Sebastia,9998,0,9999,1
1715652319544,MATH 197,001,523477,Kedlaya; Kiran S.,9994,0,9999,5
1715652319544,MATH 197,002,563811,Zhang; Danna,9994,0,9999,5
1715652319544,MATH 197,003,628552,Dumitriu; Ioana,9998,0,9999,1
1715652319544,MATH 197,004,660885,Floyd; Eric,9998,0,9999,1
1715652320570,MCWP 40R,A00,518780,Staff,1,0,20,19
1715652320570,MCWP 40R,B00,518781,Carter; Jennifer A,10,0,20,10
1715652320570,MCWP 40R,C00,518783,Smith; Haydee Marie,5,0,20,15
1715652321598,MCWP 50R,A00,518791,Redela; Pamela Morgan,0,1,20,20
1715652321598,MCWP 50R,B00,518792,Krone; Jarret,0,2,20,20
1715652321598,MCWP 50R,C00,518793,Staff,0,4,20,20
1715652321598,MCWP 50R,D00,518794,Morshed; Michael James,0,2,20,20
1715652321598,MCWP 50R,E00,518795,Carter; Andrea L,0,2,20,20
1715652321598,MCWP 50R,F00,518796,Miller; Elizabeth Deen,0,1,20,20
1715652321598,MCWP 50R,G00,518797,Guillen; Melinda,0,1,20,20
1715652322626,MMW 12R,A01,514034,Herbst; Matthew,0,2,16,16
1715652322626,MMW 12R,A02,514035,Herbst; Matthew,0,0,16,16
1715652323650,MMW 13R,A01,514037,Staff,0,5,16,16
1715652323650,MMW 13R,A02,514039,Staff,0,5,16,16
1715652323650,MMW 13R,A03,628519,Staff,0,4,16,16
1715652325700,SIO 295LS,A00,523233,Staff,10,0,30,20
1715652326728,SIO 295S,A00,523232,Staff,10,0,30,20
1715652327753,SIOC 290S,A01,637330,Merrifield; Mark A,21,0,30,9
1715652328778,SIOC 291S,A01,637333,Gabriel; Corey John,21,0,30,9
1715652329807,SOCI 117,A01,494376,Staff,0,5,5,5
1715652330834,WES 237B,A00,494380,Staff,10,0,20,10
1715652332933,AESE 279B,A00,494370,Wade; Jon P,0,0,33,33
1715652333959,AIP 97,001,660915,Van Den Einde; Yael Dahlia,9998,0,9999,1
1715652334986,AIP 197,001,627712,Vespa; Emanuel Ignacio,9995,0,9999,4
1715652334986,AIP 197,002,650778,Amir; On,9998,0,9999,1
1715652334986,AIP 197,003,650933,Avenancio-Leon; Carlos,9998,0,9999,1
1715652334986,AIP 197,004,658530,Heyman; Gail D.,9998,0,9999,1
1715652334986,AIP 197,005,658631,Neal; Sonya E,9998,0,9999,1
1715652334986,AIP 197,006,658671,Du; Songzi,9998,0,9999,1
1715652336014,ANAR 135S,A00,494369,Braswell; Geoffrey E.,0,0,0,0
1715652337042,BENG 196,001,628496,Engler; Adam J.,9998,0,9999,1
1715652337042,BENG 196,002,660916,Watson; John Thomas,9998,0,9999,1
1715652338070,BISP 197,001,650773,Wilhelm; James E.,9994,0,9999,5
1715652338070,BISP 197,002,658904,Coleman; Aaron B.,9998,0,9999,1
1715652339095,CAT 124RS,A01,519847,Geibel; William,0,0,20,20
1715652340124,CAT 125RS,A01,515971,Geibel; William,0,0,20,20
1715652341149,CLRE 250,A00,511389,Morris; Sheldon,9992,0,9999,7
1715652342179,CLRE 251,A00,507176,Mehta; Ravindra L.,9992,0,9999,7
1715652342179,CLRE 251,B00,511410,Mehta; Ravindra L.,9998,0,9999,1
1715652343207,CLRE 252,A00,507189,Cuomo; Raphael Eduardo,9994,0,9999,5
1715652344234,CLRE 253,A00,507199,Vaida; Florin,9994,0,9999,5
1715652344234,CLRE 253,B00,507202,Vaida; Florin,9999,0,9999,0
1715652345259,CLRE 259,A00,507211,Patel; Hemal,9996,0,9999,3
1715652346283,CLRE 260,A00,507221,Cuomo; Raphael Eduardo,9999,0,9999,0
1715652347310,CLRE 297,001,507242,Cuomo; Raphael Eduardo,9999,0,9999,0
1715652348336,COGS 197,001,638244,Voytek; Bradley Thomas,9997,0,9999,2
1715652349362,CSE 191,A00,516875,Minnes Kemp; Mor Mia,9991,0,9999,8
1715652350386,CSE 197,001,637388,Minnes Kemp; Mor Mia,9992,0,9999,7
1715652351413,CSS 201S,A01,494383,Mignozzetti; Umberto,35,0,35,0
1715652352439,CSS 202S,A01,494387,Mignozzetti; Umberto,35,0,35,0
1715652353467,DSC 197,001,628532,Eldridge; Justin Matthew,9995,0,9999,4
1715652354495,EAP 100,A00,516065,Staff,9799,0,9999,200
1715652355525,ECE 45,A01,507414,Staff,32,0,60,28
1715652357577,ECE 111,A01,507420,Staff,11,0,50,39
1715652358602,ECE 197,001,548057,Sievenpiper; Daniel F.,9991,0,9999,8
1715652359630,EDS 115,A00,507243,Choi; Bailey Miyeon,6,0,28,22
1715652360657,EDS 117,A01,494379,Staff,0,6,34,35
1715652361683,EDS 125,A00,507246,Hopkins; Megan Beth,7,0,30,23
1715652362709,EDS 128A,A01,507264,Fargason; Sharon Gayle,5,0,26,21
1715652363735,EDS 128B,A01,507293,Pappas; Elizabeth,9,0,30,21
1715652364761,EDS 139,A00,507294,Fargason; Sharon Gayle,9,0,30,21
1715652364761,EDS 139,B00,507313,Pappas; Elizabeth,9,0,30,21
1715652365788,EDS 201,A00,507315,Staff,10,0,30,20
1715652366818,EDS 203,A01,507317,Halter; Christopher P.,10,0,30,20
1715652367849,EDS 204R,A01,507319,Halter; Christopher P.,0,3,30,30
1715652367849,EDS 204R,B01,507331,Heinzman; Erica M.,14,0,30,16
1715652368874,EDS 206R,A00,507332,Staff,0,4,30,30
1715652368874,EDS 206R,B00,507343,Staff,15,0,30,15
1715652369899,EDS 250,A00,507344,Hemans; Patricia Ann Benitez,20,0,40,20
1715652370922,EDS 281,A00,507345,Daly; Alan J.,18,0,18,0
1715652371949,EDS 284,A00,507350,Daly; Alan J.,16,0,16,0
1715652372979,EDS 286,A00,507359,Fine; Sarah,18,0,18,0
1715652374005,EDS 289C,A01,507361,Daly; Alan J.,18,0,18,0
1715652375031,EDS 290,A00,507366,Hofstetter; Carolyn,15,0,15,0
1715652376059,LIGM 5A,A00,507421,Fischer-Grunski; Eva K,17,0,20,3
1715652377087,LIGM 5B,A00,507423,Fischer-Grunski; Eva K,19,0,20,1
1715652378322,LIGM 5C,A00,507425,Fischer-Grunski; Eva K,19,0,20,1
1715652379348,LIIT 5AS,A00,507427,Carnelos; Chiara,20,0,20,0
1715652380376,LIIT 5BS,A00,507430,Carnelos; Chiara,20,0,20,0
1715652381405,LIIT 5CS,A00,507432,Carnelos; Chiara,20,0,20,0
1715652382433,LISP 5A,A00,507541,Munoz Sanchez; Alicia,11,0,20,9
1715652383458,LISP 5B,A00,507671,Munoz Sanchez; Alicia,8,0,20,12
1715652384485,LISP 5C,A00,507696,Munoz Sanchez; Alicia,8,0,20,12
1715652385510,MAE 197,001,528363,Boechler; Nicholas Sebastia,9998,0,9999,1
1715652386545,MATH 197,001,523477,Kedlaya; Kiran S.,9994,0,9999,5
1715652386545,MATH 197,002,563811,Zhang; Danna,9994,0,9999,5
1715652386545,MATH 197,003,628552,Dumitriu; Ioana,9998,0,9999,1
1715652386545,MATH 197,004,660885,Floyd; Eric,9998,0,9999,1
1715652387574,MCWP 40R,A00,518780,Staff,1,0,20,19
1715652387574,MCWP 40R,B00,518781,Carter; Jennifer A,10,0,20,10
1715652387574,MCWP 40R,C00,518783,Smith; Haydee Marie,5,0,20,15
1715652388609,MCWP 50R,A00,518791,Redela; Pamela Morgan,0,1,20,20
1715652388609,MCWP 50R,B00,518792,Krone; Jarret,0,2,20,20
1715652388609,MCWP 50R,C00,518793,Staff,0,4,20,20
1715652388609,MCWP 50R,D00,518794,Morshed; Michael James,0,2,20,20
1715652388609,MCWP 50R,E00,518795,Carter; Andrea L,0,2,20,20
1715652388609,MCWP 50R,F00,518796,Miller; Elizabeth Deen,0,1,20,20
1715652388609,MCWP 50R,G00,518797,Guillen; Melinda,0,1,20,20
1715652389637,MMW 12R,A01,514034,Herbst; Matthew,0,2,16,16
1715652389637,MMW 12R,A02,514035,Herbst; Matthew,0,0,16,16
1715652390664,MMW 13R,A01,514037,Staff,0,5,16,16
1715652390664,MMW 13R,A02,514039,Staff,0,5,16,16
1715652390664,MMW 13R,A03,628519,Staff,0,4,16,16
1715652392717,SIO 295LS,A00,523233,Staff,10,0,30,20
1715652393743,SIO 295S,A00,523232,Staff,10,0,30,20
1715652394774,SIOC 290S,A01,637330,Merrifield; Mark A,21,0,30,9
1715652395799,SIOC 291S,A01,637333,Gabriel; Corey John,21,0,30,9
1715652396828,SOCI 117,A01,494376,Staff,0,5,5,5
1715652397853,WES 237B,A00,494380,Staff,10,0,20,10
1715652399918,AESE 279B,A00,494370,Wade; Jon P,0,0,33,33
1715652400943,AIP 97,001,660915,Van Den Einde; Yael Dahlia,9998,0,9999,1
1715652401973,AIP 197,001,627712,Vespa; Emanuel Ignacio,9995,0,9999,4
1715652401973,AIP 197,002,650778,Amir; On,9998,0,9999,1
1715652401973,AIP 197,003,650933,Avenancio-Leon; Carlos,9998,0,9999,1
1715652401973,AIP 197,004,658530,Heyman; Gail D.,9998,0,9999,1
1715652401973,AIP 197,005,658631,Neal; Sonya E,9998,0,9999,1
1715652401973,AIP 197,006,658671,Du; Songzi,9998,0,9999,1
1715652403002,ANAR 135S,A00,494369,Braswell; Geoffrey E.,0,0,0,0
1715652404028,BENG 196,001,628496,Engler; Adam J.,9998,0,9999,1
1715652404028,BENG 196,002,660916,Watson; John Thomas,9998,0,9999,1
1715652405054,BISP 197,001,650773,Wilhelm; James E.,9994,0,9999,5
1715652405054,BISP 197,002,658904,Coleman; Aaron B.,9998,0,9999,1
1715652406080,CAT 124RS,A01,519847,Geibel; William,0,0,20,20
1715652407105,CAT 125RS,A01,515971,Geibel; William,0,0,20,20
1715652408133,CLRE 250,A00,511389,Morris; Sheldon,9992,0,9999,7
1715652409161,CLRE 251,A00,507176,Mehta; Ravindra L.,9992,0,9999,7
1715652409161,CLRE 251,B00,511410,Mehta; Ravindra L.,9998,0,9999,1
1715652410191,CLRE 252,A00,507189,Cuomo; Raphael Eduardo,9994,0,9999,5
1715652411216,CLRE 253,A00,507199,Vaida; Florin,9994,0,9999,5
1715652411216,CLRE 253,B00,507202,Vaida; Florin,9999,0,9999,0
1715652412242,CLRE 259,A00,507211,Patel; Hemal,9996,0,9999,3
1715652413268,CLRE 260,A00,507221,Cuomo; Raphael Eduardo,9999,0,9999,0
1715652414293,CLRE 297,001,507242,Cuomo; Raphael Eduardo,9999,0,9999,0
1715652415319,COGS 197,001,638244,Voytek; Bradley Thomas,9997,0,9999,2
1715652416353,CSE 191,A00,516875,Minnes Kemp; Mor Mia,9991,0,9999,8
1715652417380,CSE 197,001,637388,Minnes Kemp; Mor Mia,9992,0,9999,7
1715652418407,CSS 201S,A01,494383,Mignozzetti; Umberto,35,0,35,0
1715652419436,CSS 202S,A01,494387,Mignozzetti; Umberto,35,0,35,0
1715652420461,DSC 197,001,628532,Eldridge; Justin Matthew,9995,0,9999,4
1715652421486,EAP 100,A00,516065,Staff,9799,0,9999,200
1715652422516,ECE 45,A01,507414,Staff,32,0,60,28
1715652424566,ECE 111,A01,507420,Staff,11,0,50,39
1715652425594,ECE 197,001,548057,Sievenpiper; Daniel F.,9991,0,9999,8
1715652426621,EDS 115,A00,507243,Choi; Bailey Miyeon,6,0,28,22
1715652427647,EDS 117,A01,494379,Staff,0,6,34,35
1715652428671,EDS 125,A00,507246,Hopkins; Megan Beth,7,0,30,23
1715652429695,EDS 128A,A01,507264,Fargason; Sharon Gayle,5,0,26,21
1715652430726,EDS 128B,A01,507293,Pappas; Elizabeth,9,0,30,21
1715652431755,EDS 139,A00,507294,Fargason; Sharon Gayle,9,0,30,21
1715652431755,EDS 139,B00,507313,Pappas; Elizabeth,9,0,30,21
1715652432783,EDS 201,A00,507315,Staff,10,0,30,20
1715652433808,EDS 203,A01,507317,Halter; Christopher P.,10,0,30,20
1715652434838,EDS 204R,A01,507319,Halter; Christopher P.,0,3,30,30
1715652434838,EDS 204R,B01,507331,Heinzman; Erica M.,14,0,30,16
1715652435867,EDS 206R,A00,507332,Staff,0,4,30,30
1715652435867,EDS 206R,B00,507343,Staff,15,0,30,15
1715652436891,EDS 250,A00,507344,Hemans; Patricia Ann Benitez,20,0,40,20
1715652437915,EDS 281,A00,507345,Daly; Alan J.,18,0,18,0
1715652438939,EDS 284,A00,507350,Daly; Alan J.,16,0,16,0
1715652439965,EDS 286,A00,507359,Fine; Sarah,18,0,18,0
1715652440990,EDS 289C,A01,507361,Daly; Alan J.,18,0,18,0
1715652442019,EDS 290,A00,507366,Hofstetter; Carolyn,15,0,15,0
1715652443046,LIGM 5A,A00,507421,Fischer-Grunski; Eva K,17,0,20,3
1715652444074,LIGM 5B,A00,507423,Fischer-Grunski; Eva K,19,0,20,1
1715652445102,LIGM 5C,A00,507425,Fischer-Grunski; Eva K,19,0,20,1
1715652446128,LIIT 5AS,A00,507427,Carnelos; Chiara,20,0,20,0
1715652447156,LIIT 5BS,A00,507430,Carnelos; Chiara,20,0,20,0
1715652448182,LIIT 5CS,A00,507432,Carnelos; Chiara,20,0,20,0
1715652449209,LISP 5A,A00,507541,Munoz Sanchez; Alicia,11,0,20,9
1715652450237,LISP 5B,A00,507671,Munoz Sanchez; Alicia,8,0,20,12
1715652451266,LISP 5C,A00,507696,Munoz Sanchez; Alicia,8,0,20,12
1715652452291,MAE 197,001,528363,Boechler; Nicholas Sebastia,9998,0,9999,1
1715652453317,MATH 197,001,523477,Kedlaya; Kiran S.,9994,0,9999,5
1715652453317,MATH 197,002,563811,Zhang; Danna,9994,0,9999,5
1715652453317,MATH 197,003,628552,Dumitriu; Ioana,9998,0,9999,1
1715652453317,MATH 197,004,660885,Floyd; Eric,9998,0,9999,1
1715652454343,MCWP 40R,A00,518780,Staff,1,0,20,19
1715652454343,MCWP 40R,B00,518781,Carter; Jennifer A,10,0,20,10
1715652454343,MCWP 40R,C00,518783,Smith; Haydee Marie,5,0,20,15
1715652455375,MCWP 50R,A00,518791,Redela; Pamela Morgan,0,1,20,20
1715652455375,MCWP 50R,B00,518792,Krone; Jarret,0,2,20,20
1715652455375,MCWP 50R,C00,518793,Staff,0,4,20,20
1715652455375,MCWP 50R,D00,518794,Morshed; Michael James,0,2,20,20
1715652455375,MCWP 50R,E00,518795,Carter; Andrea L,0,2,20,20
1715652455375,MCWP 50R,F00,518796,Miller; Elizabeth Deen,0,1,20,20
1715652455375,MCWP 50R,G00,518797,Guillen; Melinda,0,1,20,20
1715652456457,MMW 12R,A01,514034,Herbst; Matthew,0,2,16,16
1715652456457,MMW 12R,A02,514035,Herbst; Matthew,0,0,16,16
1715652457483,MMW 13R,A01,514037,Staff,0,5,16,16
1715652457483,MMW 13R,A02,514039,Staff,0,5,16,16
1715652457483,MMW 13R,A03,628519,Staff,0,4,16,16
1715652459533,SIO 295LS,A00,523233,Staff,10,0,30,20
1715652460562,SIO 295S,A00,523232,Staff,10,0,30,20
1715652461589,SIOC 290S,A01,637330,Merrifield; Mark A,21,0,30,9
1715652462619,SIOC 291S,A01,637333,Gabriel; Corey John,21,0,30,9
1715652463645,SOCI 117,A01,494376,Staff,0,5,5,5
1715652464671,WES 237B,A00,494380,Staff,10,0,20,10
1715652466753,AESE 279B,A00,494370,Wade; Jon P,0,0,33,33
1715652467779,AIP 97,001,660915,Van Den Einde; Yael Dahlia,9998,0,9999,1
1715652468808,AIP 197,001,627712,Vespa; Emanuel Ignacio,9995,0,9999,4
1715652468808,AIP 197,002,650778,Amir; On,9998,0,9999,1
1715652468808,AIP 197,003,650933,Avenancio-Leon; Carlos,9998,0,9999,1
1715652468808,AIP 197,004,658530,Heyman; Gail D.,9998,0,9999,1
1715652468808,AIP 197,005,658631,Neal; Sonya E,9998,0,9999,1
1715652468808,AIP 197,006,658671,Du; Songzi,9998,0,9999,1
1715652469832,ANAR 135S,A00,494369,Braswell; Geoffrey E.,0,0,0,0
1715652470858,BENG 196,001,628496,Engler; Adam J.,9998,0,9999,1
1715652470858,BENG 196,002,660916,Watson; John Thomas,9998,0,9999,1
1715652471888,BISP 197,001,650773,Wilhelm; James E.,9994,0,9999,5
1715652471888,BISP 197,002,658904,Coleman; Aaron B.,9998,0,9999,1
1715652472911,CAT 124RS,A01,519847,Geibel; William,0,0,20,20
1715652473939,CAT 125RS,A01,515971,Geibel; William,0,0,20,20
1715652474967,CLRE 250,A00,511389,Morris; Sheldon,9992,0,9999,7
1715652475993,CLRE 251,A00,507176,Mehta; Ravindra L.,9992,0,9999,7
1715652475993,CLRE 251,B00,511410,Mehta; Ravindra L.,9998,0,9999,1
1715652477019,CLRE 252,A00,507189,Cuomo; Raphael Eduardo,9994,0,9999,5
1715652478050,CLRE 253,A00,507199,Vaida; Florin,9994,0,9999,5
1715652478050,CLRE 253,B00,507202,Vaida; Florin,9999,0,9999,0
1715652479078,CLRE 259,A00,507211,Patel; Hemal,9996,0,9999,3
1715652480104,CLRE 260,A00,507221,Cuomo; Raphael Eduardo,9999,0,9999,0
1715652481130,CLRE 297,001,507242,Cuomo; Raphael Eduardo,9999,0,9999,0
1715652482158,COGS 197,001,638244,Voytek; Bradley Thomas,9997,0,9999,2
1715652483185,CSE 191,A00,516875,Minnes Kemp; Mor Mia,9991,0,9999,8
1715652484214,CSE 197,001,637388,Minnes Kemp; Mor Mia,9992,0,9999,7
1715652485242,CSS 201S,A01,494383,Mignozzetti; Umberto,35,0,35,0
1715652486270,CSS 202S,A01,494387,Mignozzetti; Umberto,35,0,35,0
1715652487293,DSC 197,001,628532,Eldridge; Justin Matthew,9995,0,9999,4
1715652488323,EAP 100,A00,516065,Staff,9799,0,9999,200
1715652489347,ECE 45,A01,507414,Staff,32,0,60,28
1715652491408,ECE 111,A01,507420,Staff,11,0,50,39
1715652492440,ECE 197,001,548057,Sievenpiper; Daniel F.,9991,0,9999,8
1715652493473,EDS 115,A00,507243,Choi; Bailey Miyeon,6,0,28,22
1715652494501,EDS 117,A01,494379,Staff,0,6,34,35
1715652495534,EDS 125,A00,507246,Hopkins; Megan Beth,7,0,30,23
1715652496561,EDS 128A,A01,507264,Fargason; Sharon Gayle,5,0,26,21
1715652497587,EDS 128B,A01,507293,Pappas; Elizabeth,9,0,30,21
1715652498613,EDS 139,A00,507294,Fargason; Sharon Gayle,9,0,30,21
1715652498613,EDS 139,B00,507313,Pappas; Elizabeth,9,0,30,21
1715652499636,EDS 201,A00,507315,Staff,10,0,30,20
1715652500661,EDS 203,A01,507317,Halter; Christopher P.,10,0,30,20
1715652501686,EDS 204R,A01,507319,Halter; Christopher P.,0,3,30,30
1715652501686,EDS 204R,B01,507331,Heinzman; Erica M.,14,0,30,16
1715652502715,EDS 206R,A00,507332,Staff,0,4,30,30
1715652502715,EDS 206R,B00,507343,Staff,15,0,30,15
1715652503741,EDS 250,A00,507344,Hemans; Patricia Ann Benitez,20,0,40,20
1715652504769,EDS 281,A00,507345,Daly; Alan J.,18,0,18,0
1715652505792,EDS 284,A00,507350,Daly; Alan J.,16,0,16,0
1715652506818,EDS 286,A00,507359,Fine; Sarah,18,0,18,0
1715652507845,EDS 289C,A01,507361,Daly; Alan J.,18,0,18,0
1715652508870,EDS 290,A00,507366,Hofstetter; Carolyn,15,0,15,0
1715652509895,LIGM 5A,A00,507421,Fischer-Grunski; Eva K,17,0,20,3
1715652510926,LIGM 5B,A00,507423,Fischer-Grunski; Eva K,19,0,20,1
1715652511950,LIGM 5C,A00,507425,Fischer-Grunski; Eva K,19,0,20,1
1715652512978,LIIT 5AS,A00,507427,Carnelos; Chiara,20,0,20,0
1715652514005,LIIT 5BS,A00,507430,Carnelos; Chiara,20,0,20,0
1715652515029,LIIT 5CS,A00,507432,Carnelos; Chiara,20,0,20,0
1715652516057,LISP 5A,A00,507541,Munoz Sanchez; Alicia,11,0,20,9
1715652517107,LISP 5B,A00,507671,Munoz Sanchez; Alicia,8,0,20,12
1715652518141,LISP 5C,A00,507696,Munoz Sanchez; Alicia,8,0,20,12
1715652519171,MAE 197,001,528363,Boechler; Nicholas Sebastia,9998,0,9999,1
1715652520203,MATH 197,001,523477,Kedlaya; Kiran S.,9994,0,9999,5
1715652520203,MATH 197,002,563811,Zhang; Danna,9994,0,9999,5
1715652520203,MATH 197,003,628552,Dumitriu; Ioana,9998,0,9999,1
1715652520203,MATH 197,004,660885,Floyd; Eric,9998,0,9999,1
1715652521233,MCWP 40R,A00,518780,Staff,1,0,20,19
1715652521233,MCWP 40R,B00,518781,Carter; Jennifer A,10,0,20,10
1715652521233,MCWP 40R,C00,518783,Smith; Haydee Marie,5,0,20,15
1715652522269,MCWP 50R,A00,518791,Redela; Pamela Morgan,0,1,20,20
1715652522269,MCWP 50R,B00,518792,Krone; Jarret,0,2,20,20
1715652522269,MCWP 50R,C00,518793,Staff,0,4,20,20
1715652522269,MCWP 50R,D00,518794,Morshed; Michael James,0,2,20,20
1715652522269,MCWP 50R,E00,518795,Carter; Andrea L,0,2,20,20
1715652522269,MCWP 50R,F00,518796,Miller; Elizabeth Deen,0,1,20,20
1715652522269,MCWP 50R,G00,518797,Guillen; Melinda,0,1,20,20
1715652523297,MMW 12R,A01,514034,Herbst; Matthew,0,2,16,16
1715652523297,MMW 12R,A02,514035,Herbst; Matthew,0,0,16,16
1715652524325,MMW 13R,A01,514037,Staff,0,5,16,16
1715652524325,MMW 13R,A02,514039,Staff,0,5,16,16
1715652524325,MMW 13R,A03,628519,Staff,0,4,16,16
1715652526381,SIO 295LS,A00,523233,Staff,10,0,30,20
1715652527407,SIO 295S,A00,523232,Staff,10,0,30,20
1715652528436,SIOC 290S,A01,637330,Merrifield; Mark A,21,0,30,9
1715652529472,SIOC 291S,A01,637333,Gabriel; Corey John,21,0,30,9
1715652530500,SOCI 117,A01,494376,Staff,0,5,5,5
1715652531525,WES 237B,A00,494380,Staff,10,0,20,10
1715652533595,AESE 279B,A00,494370,Wade; Jon P,0,0,33,33
1715652534622,AIP 97,001,660915,Van Den Einde; Yael Dahlia,9998,0,9999,1
1715652535654,AIP 197,001,627712,Vespa; Emanuel Ignacio,9995,0,9999,4
1715652535654,AIP 197,002,650778,Amir; On,9998,0,9999,1
1715652535654,AIP 197,003,650933,Avenancio-Leon; Carlos,9998,0,9999,1
1715652535654,AIP 197,004,658530,Heyman; Gail D.,9998,0,9999,1
1715652535654,AIP 197,005,658631,Neal; Sonya E,9998,0,9999,1
1715652535654,AIP 197,006,658671,Du; Songzi,9998,0,9999,1
1715652536679,ANAR 135S,A00,494369,Braswell; Geoffrey E.,0,0,0,0
1715652537713,BENG 196,001,628496,Engler; Adam J.,9998,0,9999,1
1715652537713,BENG 196,002,660916,Watson; John Thomas,9998,0,9999,1
1715652538741,BISP 197,001,650773,Wilhelm; James E.,9994,0,9999,5
1715652538741,BISP 197,002,658904,Coleman; Aaron B.,9998,0,9999,1
1715652539770,CAT 124RS,A01,519847,Geibel; William,0,0,20,20
1715652540797,CAT 125RS,A01,515971,Geibel; William,0,0,20,20
1715652541825,CLRE 250,A00,511389,Morris; Sheldon,9992,0,9999,7
1715652542852,CLRE 251,A00,507176,Mehta; Ravindra L.,9992,0,9999,7
1715652542852,CLRE 251,B00,511410,Mehta; Ravindra L.,9998,0,9999,1
1715652543899,CLRE 252,A00,507189,Cuomo; Raphael Eduardo,9994,0,9999,5
1715652544929,CLRE 253,A00,507199,Vaida; Florin,9994,0,9999,5
1715652544929,CLRE 253,B00,507202,Vaida; Florin,9999,0,9999,0
1715652545955,CLRE 259,A00,507211,Patel; Hemal,9996,0,9999,3
1715652546982,CLRE 260,A00,507221,Cuomo; Raphael Eduardo,9999,0,9999,0
1715652548011,CLRE 297,001,507242,Cuomo; Raphael Eduardo,9999,0,9999,0
1715652549037,COGS 197,001,638244,Voytek; Bradley Thomas,9997,0,9999,2
1715652550067,CSE 191,A00,516875,Minnes Kemp; Mor Mia,9991,0,9999,8
1715652551106,CSE 197,001,637388,Minnes Kemp; Mor Mia,9992,0,9999,7
1715652552154,CSS 201S,A01,494383,Mignozzetti; Umberto,35,0,35,0
1715652553179,CSS 202S,A01,494387,Mignozzetti; Umberto,35,0,35,0
1715652554208,DSC 197,001,628532,Eldridge; Justin Matthew,9995,0,9999,4
1715652555232,EAP 100,A00,516065,Staff,9799,0,9999,200
1715652556265,ECE 45,A01,507414,Staff,32,0,60,28
1715652558319,ECE 111,A01,507420,Staff,11,0,50,39
1715652559344,ECE 197,001,548057,Sievenpiper; Daniel F.,9991,0,9999,8
1715652560425,EDS 115,A00,507243,Choi; Bailey Miyeon,6,0,28,22
1715652561545,EDS 117,A01,494379,Staff,0,6,34,35
1715652562574,EDS 125,A00,507246,Hopkins; Megan Beth,7,0,30,23
1715652563600,EDS 128A,A01,507264,Fargason; Sharon Gayle,5,0,26,21
1715652564630,EDS 128B,A01,507293,Pappas; Elizabeth,9,0,30,21
1715652565655,EDS 139,A00,507294,Fargason; Sharon Gayle,9,0,30,21
1715652565655,EDS 139,B00,507313,Pappas; Elizabeth,9,0,30,21
1715652566680,EDS 201,A00,507315,Staff,10,0,30,20
1715652567708,EDS 203,A01,507317,Halter; Christopher P.,10,0,30,20
1715652568735,EDS 204R,A01,507319,Halter; Christopher P.,0,3,30,30
1715652568735,EDS 204R,B01,507331,Heinzman; Erica M.,14,0,30,16
1715652569762,EDS 206R,A00,507332,Staff,0,4,30,30
1715652569762,EDS 206R,B00,507343,Staff,15,0,30,15
1715652570799,EDS 250,A00,507344,Hemans; Patricia Ann Benitez,20,0,40,20
1715652571830,EDS 281,A00,507345,Daly; Alan J.,18,0,18,0
1715652572856,EDS 284,A00,507350,Daly; Alan J.,16,0,16,0
1715652573898,EDS 286,A00,507359,Fine; Sarah,18,0,18,0
1715652574925,EDS 289C,A01,507361,Daly; Alan J.,18,0,18,0
1715652575950,EDS 290,A00,507366,Hofstetter; Carolyn,15,0,15,0
1715652576975,LIGM 5A,A00,507421,Fischer-Grunski; Eva K,17,0,20,3
1715652578004,LIGM 5B,A00,507423,Fischer-Grunski; Eva K,19,0,20,1
1715652579028,LIGM 5C,A00,507425,Fischer-Grunski; Eva K,19,0,20,1
1715652580058,LIIT 5AS,A00,507427,Carnelos; Chiara,20,0,20,0
1715652581081,LIIT 5BS,A00,507430,Carnelos; Chiara,20,0,20,0
1715652582105,LIIT 5CS,A00,507432,Carnelos; Chiara,20,0,20,0
1715652583136,LISP 5A,A00,507541,Munoz Sanchez; Alicia,11,0,20,9
1715652584165,LISP 5B,A00,507671,Munoz Sanchez; Alicia,8,0,20,12
1715652585189,LISP 5C,A00,507696,Munoz Sanchez; Alicia,8,0,20,12
1715652586215,MAE 197,001,528363,Boechler; Nicholas Sebastia,9998,0,9999,1
1715652587243,MATH 197,001,523477,Kedlaya; Kiran S.,9994,0,9999,5
1715652587243,MATH 197,002,563811,Zhang; Danna,9994,0,9999,5
1715652587243,MATH 197,003,628552,Dumitriu; Ioana,9998,0,9999,1
1715652587243,MATH 197,004,660885,Floyd; Eric,9998,0,9999,1
1715652588272,MCWP 40R,A00,518780,Staff,1,0,20,19
1715652588272,MCWP 40R,B00,518781,Carter; Jennifer A,10,0,20,10
1715652588272,MCWP 40R,C00,518783,Smith; Haydee Marie,5,0,20,15
1715652589301,MCWP 50R,A00,518791,Redela; Pamela Morgan,0,1,20,20
1715652589301,MCWP 50R,B00,518792,Krone; Jarret,0,2,20,20
1715652589301,MCWP 50R,C00,518793,Staff,0,4,20,20
1715652589301,MCWP 50R,D00,518794,Morshed; Michael James,0,2,20,20
1715652589301,MCWP 50R,E00,518795,Carter; Andrea L,0,2,20,20
1715652589301,MCWP 50R,F00,518796,Miller; Elizabeth Deen,0,1,20,20
1715652589301,MCWP 50R,G00,518797,Guillen; Melinda,0,1,20,20
1715652590357,MMW 12R,A01,514034,Herbst; Matthew,0,2,16,16
1715652590357,MMW 12R,A02,514035,Herbst; Matthew,0,0,16,16
1715652591387,MMW 13R,A01,514037,Staff,0,5,16,16
1715652591387,MMW 13R,A02,514039,Staff,0,5,16,16
1715652591387,MMW 13R,A03,628519,Staff,0,4,16,16
1715652593447,SIO 295LS,A00,523233,Staff,10,0,30,20
1715652594473,SIO 295S,A00,523232,Staff,10,0,30,20
1715652595504,SIOC 290S,A01,637330,Merrifield; Mark A,21,0,30,9
1715652596537,SIOC 291S,A01,637333,Gabriel; Corey John,21,0,30,9
1715652597562,SOCI 117,A01,494376,Staff,0,5,5,5
1715652598588,WES 237B,A00,494380,Staff,10,0,20,10
1715652600667,AESE 279B,A00,494370,Wade; Jon P,0,0,33,33
1715652601693,AIP 97,001,660915,Van Den Einde; Yael Dahlia,9998,0,9999,1
1715652602723,AIP 197,001,627712,Vespa; Emanuel Ignacio,9995,0,9999,4
1715652602723,AIP 197,002,650778,Amir; On,9998,0,9999,1
1715652602723,AIP 197,003,650933,Avenancio-Leon; Carlos,9998,0,9999,1
1715652602723,AIP 197,004,658530,Heyman; Gail D.,9998,0,9999,1
1715652602723,AIP 197,005,658631,Neal; Sonya E,9998,0,9999,1
1715652602723,AIP 197,006,658671,Du; Songzi,9998,0,9999,1
1715652603750,ANAR 135S,A00,494369,Braswell; Geoffrey E.,0,0,0,0
1715652604781,BENG 196,001,628496,Engler; Adam J.,9998,0,9999,1
1715652604781,BENG 196,002,660916,Watson; John Thomas,9998,0,9999,1
1715652605812,BISP 197,001,650773,Wilhelm; James E.,9994,0,9999,5
1715652605812,BISP 197,002,658904,Coleman; Aaron B.,9998,0,9999,1
1715652606844,CAT 124RS,A01,519847,Geibel; William,0,0,20,20
1715652607872,CAT 125RS,A01,515971,Geibel; William,0,0,20,20
1715652608902,CLRE 250,A00,511389,Morris; Sheldon,9992,0,9999,7
1715652609933,CLRE 251,A00,507176,Mehta; Ravindra L.,9992,0,9999,7
1715652609933,CLRE 251,B00,511410,Mehta; Ravindra L.,9998,0,9999,1
1715652610961,CLRE 252,A00,507189,Cuomo; Raphael Eduardo,9994,0,9999,5
1715652611991,CLRE 253,A00,507199,Vaida; Florin,9994,0,9999,5
1715652611991,CLRE 253,B00,507202,Vaida; Florin,9999,0,9999,0
1715652613017,CLRE 259,A00,507211,Patel; Hemal,9996,0,9999,3
1715652614047,CLRE 260,A00,507221,Cuomo; Raphael Eduardo,9999,0,9999,0
1715652615074,CLRE 297,001,507242,Cuomo; Raphael Eduardo,9999,0,9999,0
1715652616105,COGS 197,001,638244,Voytek; Bradley Thomas,9997,0,9999,2
1715652617128,CSE 191,A00,516875,Minnes Kemp; Mor Mia,9991,0,9999,8
1715652618155,CSE 197,001,637388,Minnes Kemp; Mor Mia,9992,0,9999,7
1715652619182,CSS 201S,A01,494383,Mignozzetti; Umberto,35,0,35,0
1715652620213,CSS 202S,A01,494387,Mignozzetti; Umberto,35,0,35,0
1715652621239,DSC 197,001,628532,Eldridge; Justin Matthew,9995,0,9999,4
1715652622263,EAP 100,A00,516065,Staff,9799,0,9999,200
1715652623300,ECE 45,A01,507414,Staff,32,0,60,28
1715652625357,ECE 111,A01,507420,Staff,11,0,50,39
1715652626385,ECE 197,001,548057,Sievenpiper; Daniel F.,9991,0,9999,8
1715652627418,EDS 115,A00,507243,Choi; Bailey Miyeon,6,0,28,22
1715652628443,EDS 117,A01,494379,Staff,0,6,34,35
1715652629468,EDS 125,A00,507246,Hopkins; Megan Beth,7,0,30,23
1715652630496,EDS 128A,A01,507264,Fargason; Sharon Gayle,5,0,26,21
1715652631527,EDS 128B,A01,507293,Pappas; Elizabeth,9,0,30,21
1715652632552,EDS 139,A00,507294,Fargason; Sharon Gayle,9,0,30,21
1715652632552,EDS 139,B00,507313,Pappas; Elizabeth,9,0,30,21
1715652633576,EDS 201,A00,507315,Staff,10,0,30,20
1715652634601,EDS 203,A01,507317,Halter; Christopher P.,10,0,30,20
1715652635682,EDS 204R,A01,507319,Halter; Christopher P.,0,3,30,30
1715652635682,EDS 204R,B01,507331,Heinzman; Erica M.,14,0,30,16
1715652636708,EDS 206R,A00,507332,Staff,0,4,30,30
1715652636708,EDS 206R,B00,507343,Staff,15,0,30,15
1715652637732,EDS 250,A00,507344,Hemans; Patricia Ann Benitez,20,0,40,20
1715652638757,EDS 281,A00,507345,Daly; Alan J.,18,0,18,0
1715652639787,EDS 284,A00,507350,Daly; Alan J.,16,0,16,0
1715652640813,EDS 286,A00,507359,Fine; Sarah,18,0,18,0
1715652641841,EDS 289C,A01,507361,Daly; Alan J.,18,0,18,0
1715652642869,EDS 290,A00,507366,Hofstetter; Carolyn,15,0,15,0
1715652643899,LIGM 5A,A00,507421,Fischer-Grunski; Eva K,17,0,20,3
1715652644929,LIGM 5B,A00,507423,Fischer-Grunski; Eva K,19,0,20,1
1715652645955,LIGM 5C,A00,507425,Fischer-Grunski; Eva K,19,0,20,1
1715652646984,LIIT 5AS,A00,507427,Carnelos; Chiara,20,0,20,0
1715652648010,LIIT 5BS,A00,507430,Carnelos; Chiara,20,0,20,0
1715652649040,LIIT 5CS,A00,507432,Carnelos; Chiara,20,0,20,0
1715652650067,LISP 5A,A00,507541,Munoz Sanchez; Alicia,11,0,20,9
1715652651093,LISP 5B,A00,507671,Munoz Sanchez; Alicia,8,0,20,12
1715652652119,LISP 5C,A00,507696,Munoz Sanchez; Alicia,8,0,20,12
1715652653149,MAE 197,001,528363,Boechler; Nicholas Sebastia,9998,0,9999,1
1715652654179,MATH 197,001,523477,Kedlaya; Kiran S.,9994,0,9999,5
1715652654179,MATH 197,002,563811,Zhang; Danna,9994,0,9999,5
1715652654179,MATH 197,003,628552,Dumitriu; Ioana,9998,0,9999,1
1715652654179,MATH 197,004,660885,Floyd; Eric,9998,0,9999,1
1715652655207,MCWP 40R,A00,518780,Staff,1,0,20,19
1715652655207,MCWP 40R,B00,518781,Carter; Jennifer A,10,0,20,10
1715652655207,MCWP 40R,C00,518783,Smith; Haydee Marie,5,0,20,15
1715652656236,MCWP 50R,A00,518791,Redela; Pamela Morgan,0,1,20,20
1715652656236,MCWP 50R,B00,518792,Krone; Jarret,0,2,20,20
1715652656236,MCWP 50R,C00,518793,Staff,0,4,20,20
1715652656236,MCWP 50R,D00,518794,Morshed; Michael James,0,2,20,20
1715652656236,MCWP 50R,E00,518795,Carter; Andrea L,0,2,20,20
1715652656236,MCWP 50R,F00,518796,Miller; Elizabeth Deen,0,1,20,20
1715652656236,MCWP 50R,G00,518797,Guillen; Melinda,0,1,20,20
1715652657262,MMW 12R,A01,514034,Herbst; Matthew,0,2,16,16
1715652657262,MMW 12R,A02,514035,Herbst; Matthew,0,0,16,16
1715652658289,MMW 13R,A01,514037,Staff,0,5,16,16
1715652658289,MMW 13R,A02,514039,Staff,0,5,16,16
1715652658289,MMW 13R,A03,628519,Staff,0,4,16,16
1715652660344,SIO 295LS,A00,523233,Staff,10,0,30,20
1715652661373,SIO 295S,A00,523232,Staff,10,0,30,20
1715652662403,SIOC 290S,A01,637330,Merrifield; Mark A,21,0,30,9
1715652663432,SIOC 291S,A01,637333,Gabriel; Corey John,21,0,30,9
1715652664460,SOCI 117,A01,494376,Staff,0,5,5,5
1715652665486,WES 237B,A00,494380,Staff,10,0,20,10
1715652667559,AESE 279B,A00,494370,Wade; Jon P,0,0,33,33
1715652668585,AIP 97,001,660915,Van Den Einde; Yael Dahlia,9998,0,9999,1
1715652669612,AIP 197,001,627712,Vespa; Emanuel Ignacio,9995,0,9999,4
1715652669612,AIP 197,002,650778,Amir; On,9998,0,9999,1
1715652669612,AIP 197,003,650933,Avenancio-Leon; Carlos,9998,0,9999,1
1715652669612,AIP 197,004,658530,Heyman; Gail D.,9998,0,9999,1
1715652669612,AIP 197,005,658631,Neal; Sonya E,9998,0,9999,1
1715652669612,AIP 197,006,658671,Du; Songzi,9998,0,9999,1
1715652670639,ANAR 135S,A00,494369,Braswell; Geoffrey E.,0,0,0,0
1715652671666,BENG 196,001,628496,Engler; Adam J.,9998,0,9999,1
1715652671666,BENG 196,002,660916,Watson; John Thomas,9998,0,9999,1
1715652672696,BISP 197,001,650773,Wilhelm; James E.,9994,0,9999,5
1715652672696,BISP 197,002,658904,Coleman; Aaron B.,9998,0,9999,1
1715652673720,CAT 124RS,A01,519847,Geibel; William,0,0,20,20
1715652674747,CAT 125RS,A01,515971,Geibel; William,0,0,20,20
1715652675776,CLRE 250,A00,511389,Morris; Sheldon,9992,0,9999,7
1715652676807,CLRE 251,A00,507176,Mehta; Ravindra L.,9992,0,9999,7
1715652676807,CLRE 251,B00,511410,Mehta; Ravindra L.,9998,0,9999,1
1715652677834,CLRE 252,A00,507189,Cuomo; Raphael Eduardo,9994,0,9999,5
1715652678859,CLRE 253,A00,507199,Vaida; Florin,9994,0,9999,5
1715652678859,CLRE 253,B00,507202,Vaida; Florin,9999,0,9999,0
1715652679886,CLRE 259,A00,507211,Patel; Hemal,9996,0,9999,3
1715652680911,CLRE 260,A00,507221,Cuomo; Raphael Eduardo,9999,0,9999,0
1715652681937,CLRE 297,001,507242,Cuomo; Raphael Eduardo,9999,0,9999,0
1715652682964,COGS 197,001,638244,Voytek; Bradley Thomas,9997,0,9999,2
1715652683991,CSE 191,A00,516875,Minnes Kemp; Mor Mia,9991,0,9999,8
1715652685016,CSE 197,001,637388,Minnes Kemp; Mor Mia,9992,0,9999,7
1715652686047,CSS 201S,A01,494383,Mignozzetti; Umberto,35,0,35,0
1715652687077,CSS 202S,A01,494387,Mignozzetti; Umberto,35,0,35,0
1715652688102,DSC 197,001,628532,Eldridge; Justin Matthew,9995,0,9999,4
1715652689129,EAP 100,A00,516065,Staff,9799,0,9999,200
1715652690156,ECE 45,A01,507414,Staff,32,0,60,28
1715652692208,ECE 111,A01,507420,Staff,11,0,50,39
1715652693233,ECE 197,001,548057,Sievenpiper; Daniel F.,9991,0,9999,8
1715652694262,EDS 115,A00,507243,Choi; Bailey Miyeon,6,0,28,22
1715652695293,EDS 117,A01,494379,Staff,0,6,34,35
1715652696322,EDS 125,A00,507246,Hopkins; Megan Beth,7,0,30,23
1715652697349,EDS 128A,A01,507264,Fargason; Sharon Gayle,5,0,26,21
1715652698378,EDS 128B,A01,507293,Pappas; Elizabeth,9,0,30,21
1715652699404,EDS 139,A00,507294,Fargason; Sharon Gayle,9,0,30,21
1715652699404,EDS 139,B00,507313,Pappas; Elizabeth,9,0,30,21
1715652700429,EDS 201,A00,507315,Staff,10,0,30,20
1715652701454,EDS 203,A01,507317,Halter; Christopher P.,10,0,30,20
1715652702480,EDS 204R,A01,507319,Halter; Christopher P.,0,3,30,30
1715652702480,EDS 204R,B01,507331,Heinzman; Erica M.,14,0,30,16
1715652703505,EDS 206R,A00,507332,Staff,0,4,30,30
1715652703505,EDS 206R,B00,507343,Staff,15,0,30,15
1715652704531,EDS 250,A00,507344,Hemans; Patricia Ann Benitez,20,0,40,20
1715652705559,EDS 281,A00,507345,Daly; Alan J.,18,0,18,0
1715652706585,EDS 284,A00,507350,Daly; Alan J.,16,0,16,0
1715652707612,EDS 286,A00,507359,Fine; Sarah,18,0,18,0
1715652708636,EDS 289C,A01,507361,Daly; Alan J.,18,0,18,0
1715652709661,EDS 290,A00,507366,Hofstetter; Carolyn,15,0,15,0
1715652710688,LIGM 5A,A00,507421,Fischer-Grunski; Eva K,17,0,20,3
1715652711717,LIGM 5B,A00,507423,Fischer-Grunski; Eva K,19,0,20,1
1715652712745,LIGM 5C,A00,507425,Fischer-Grunski; Eva K,19,0,20,1
1715652713775,LIIT 5AS,A00,507427,Carnelos; Chiara,20,0,20,0
1715652714803,LIIT 5BS,A00,507430,Carnelos; Chiara,20,0,20,0
1715652715827,LIIT 5CS,A00,507432,Carnelos; Chiara,20,0,20,0
1715652716857,LISP 5A,A00,507541,Munoz Sanchez; Alicia,11,0,20,9
1715652717883,LISP 5B,A00,507671,Munoz Sanchez; Alicia,8,0,20,12
1715652718908,LISP 5C,A00,507696,Munoz Sanchez; Alicia,8,0,20,12
1715652719934,MAE 197,001,528363,Boechler; Nicholas Sebastia,9998,0,9999,1
1715652720961,MATH 197,001,523477,Kedlaya; Kiran S.,9994,0,9999,5
1715652720961,MATH 197,002,563811,Zhang; Danna,9994,0,9999,5
1715652720961,MATH 197,003,628552,Dumitriu; Ioana,9998,0,9999,1
1715652720961,MATH 197,004,660885,Floyd; Eric,9998,0,9999,1
1715652721990,MCWP 40R,A00,518780,Staff,1,0,20,19
1715652721990,MCWP 40R,B00,518781,Carter; Jennifer A,10,0,20,10
1715652721990,MCWP 40R,C00,518783,Smith; Haydee Marie,5,0,20,15
1715652723017,MCWP 50R,A00,518791,Redela; Pamela Morgan,0,1,20,20
1715652723017,MCWP 50R,B00,518792,Krone; Jarret,0,2,20,20
1715652723017,MCWP 50R,C00,518793,Staff,0,4,20,20
1715652723017,MCWP 50R,D00,518794,Morshed; Michael James,0,2,20,20
1715652723017,MCWP 50R,E00,518795,Carter; Andrea L,0,2,20,20
1715652723017,MCWP 50R,F00,518796,Miller; Elizabeth Deen,0,1,20,20
1715652723017,MCWP 50R,G00,518797,Guillen; Melinda,0,1,20,20
1715652724042,MMW 12R,A01,514034,Herbst; Matthew,0,2,16,16
1715652724042,MMW 12R,A02,514035,Herbst; Matthew,0,0,16,16
1715652725069,MMW 13R,A01,514037,Staff,0,5,16,16
1715652725069,MMW 13R,A02,514039,Staff,0,5,16,16
1715652725069,MMW 13R,A03,628519,Staff,0,4,16,16
1715652727119,SIO 295LS,A00,523233,Staff,10,0,30,20
1715652728145,SIO 295S,A00,523232,Staff,10,0,30,20
1715652729177,SIOC 290S,A01,637330,Merrifield; Mark A,21,0,30,9
1715652730203,SIOC 291S,A01,637333,Gabriel; Corey John,21,0,30,9
1715652731229,SOCI 117,A01,494376,Staff,0,5,5,5
1715652732255,WES 237B,A00,494380,Staff,10,0,20,10
1715652734329,AESE 279B,A00,494370,Wade; Jon P,0,0,33,33
1715652735356,AIP 97,001,660915,Van Den Einde; Yael Dahlia,9998,0,9999,1
1715652736387,AIP 197,001,627712,Vespa; Emanuel Ignacio,9995,0,9999,4
1715652736387,AIP 197,002,650778,Amir; On,9998,0,9999,1
1715652736387,AIP 197,003,650933,Avenancio-Leon; Carlos,9998,0,9999,1
1715652736387,AIP 197,004,658530,Heyman; Gail D.,9998,0,9999,1
1715652736387,AIP 197,005,658631,Neal; Sonya E,9998,0,9999,1
1715652736387,AIP 197,006,658671,Du; Songzi,9998,0,9999,1
1715652737413,ANAR 135S,A00,494369,Braswell; Geoffrey E.,0,0,0,0
1715652738439,BENG 196,001,628496,Engler; Adam J.,9998,0,9999,1
1715652738439,BENG 196,002,660916,Watson; John Thomas,9998,0,9999,1
1715652739519,BISP 197,001,650773,Wilhelm; James E.,9994,0,9999,5
1715652739519,BISP 197,002,658904,Coleman; Aaron B.,9998,0,9999,1
1715652740545,CAT 124RS,A01,519847,Geibel; William,0,0,20,20
1715652741571,CAT 125RS,A01,515971,Geibel; William,0,0,20,20
1715652742597,CLRE 250,A00,511389,Morris; Sheldon,9992,0,9999,7
1715652743624,CLRE 251,A00,507176,Mehta; Ravindra L.,9992,0,9999,7
1715652743624,CLRE 251,B00,511410,Mehta; Ravindra L.,9998,0,9999,1
1715652744649,CLRE 252,A00,507189,Cuomo; Raphael Eduardo,9994,0,9999,5
1715652745677,CLRE 253,A00,507199,Vaida; Florin,9994,0,9999,5
1715652745677,CLRE 253,B00,507202,Vaida; Florin,9999,0,9999,0
1715652746703,CLRE 259,A00,507211,Patel; Hemal,9996,0,9999,3
1715652747728,CLRE 260,A00,507221,Cuomo; Raphael Eduardo,9999,0,9999,0
1715652748758,CLRE 297,001,507242,Cuomo; Raphael Eduardo,9999,0,9999,0
1715652749786,COGS 197,001,638244,Voytek; Bradley Thomas,9997,0,9999,2
1715652750815,CSE 191,A00,516875,Minnes Kemp; Mor Mia,9991,0,9999,8
1715652751840,CSE 197,001,637388,Minnes Kemp; Mor Mia,9992,0,9999,7
1715652752867,CSS 201S,A01,494383,Mignozzetti; Umberto,35,0,35,0
1715652753894,CSS 202S,A01,494387,Mignozzetti; Umberto,35,0,35,0
1715652754919,DSC 197,001,628532,Eldridge; Justin Matthew,9995,0,9999,4
1715652755949,EAP 100,A00,516065,Staff,9799,0,9999,200
1715652756978,ECE 45,A01,507414,Staff,32,0,60,28
1715652759030,ECE 111,A01,507420,Staff,11,0,50,39
1715652760059,ECE 197,001,548057,Sievenpiper; Daniel F.,9991,0,9999,8
1715652761088,EDS 115,A00,507243,Choi; Bailey Miyeon,6,0,28,22
1715652762117,EDS 117,A01,494379,Staff,0,6,34,35
1715652763146,EDS 125,A00,507246,Hopkins; Megan Beth,7,0,30,23
1715652764173,EDS 128A,A01,507264,Fargason; Sharon Gayle,5,0,26,21
1715652765197,EDS 128B,A01,507293,Pappas; Elizabeth,9,0,30,21
1715652766222,EDS 139,A00,507294,Fargason; Sharon Gayle,9,0,30,21
1715652766222,EDS 139,B00,507313,Pappas; Elizabeth,9,0,30,21
1715652767247,EDS 201,A00,507315,Staff,10,0,30,20
1715652768273,EDS 203,A01,507317,Halter; Christopher P.,10,0,30,20
1715652769305,EDS 204R,A01,507319,Halter; Christopher P.,0,3,30,30
1715652769305,EDS 204R,B01,507331,Heinzman; Erica M.,14,0,30,16
1715652770335,EDS 206R,A00,507332,Staff,0,4,30,30
1715652770335,EDS 206R,B00,507343,Staff,15,0,30,15
1715652771365,EDS 250,A00,507344,Hemans; Patricia Ann Benitez,20,0,40,20
1715652772394,EDS 281,A00,507345,Daly; Alan J.,18,0,18,0
1715652773419,EDS 284,A00,507350,Daly; Alan J.,16,0,16,0
1715652774447,EDS 286,A00,507359,Fine; Sarah,18,0,18,0
1715652775472,EDS 289C,A01,507361,Daly; Alan J.,18,0,18,0
1715652776497,EDS 290,A00,507366,Hofstetter; Carolyn,15,0,15,0
1715652777523,LIGM 5A,A00,507421,Fischer-Grunski; Eva K,17,0,20,3
1715652778549,LIGM 5B,A00,507423,Fischer-Grunski; Eva K,19,0,20,1
1715652779578,LIGM 5C,A00,507425,Fischer-Grunski; Eva K,19,0,20,1
1715652780605,LIIT 5AS,A00,507427,Carnelos; Chiara,20,0,20,0
1715652781632,LIIT 5BS,A00,507430,Carnelos; Chiara,20,0,20,0
1715652782656,LIIT 5CS,A00,507432,Carnelos; Chiara,20,0,20,0
1715652783683,LISP 5A,A00,507541,Munoz Sanchez; Alicia,11,0,20,9
1715652784712,LISP 5B,A00,507671,Munoz Sanchez; Alicia,8,0,20,12
1715652785739,LISP 5C,A00,507696,Munoz Sanchez; Alicia,8,0,20,12
1715652786766,MAE 197,001,528363,Boechler; Nicholas Sebastia,9998,0,9999,1
1715652787798,MATH 197,001,523477,Kedlaya; Kiran S.,9994,0,9999,5
1715652787798,MATH 197,002,563811,Zhang; Danna,9994,0,9999,5
1715652787798,MATH 197,003,628552,Dumitriu; Ioana,9998,0,9999,1
1715652787798,MATH 197,004,660885,Floyd; Eric,9998,0,9999,1
1715652788824,MCWP 40R,A00,518780,Staff,1,0,20,19
1715652788824,MCWP 40R,B00,518781,Carter; Jennifer A,10,0,20,10
1715652788824,MCWP 40R,C00,518783,Smith; Haydee Marie,5,0,20,15
1715652789853,MCWP 50R,A00,518791,Redela; Pamela Morgan,0,1,20,20
1715652789853,MCWP 50R,B00,518792,Krone; Jarret,0,2,20,20
1715652789853,MCWP 50R,C00,518793,Staff,0,4,20,20
1715652789853,MCWP 50R,D00,518794,Morshed; Michael James,0,2,20,20
1715652789853,MCWP 50R,E00,518795,Carter; Andrea L,0,2,20,20
1715652789853,MCWP 50R,F00,518796,Miller; Elizabeth Deen,0,1,20,20
1715652789853,MCWP 50R,G00,518797,Guillen; Melinda,0,1,20,20
1715652790882,MMW 12R,A01,514034,Herbst; Matthew,0,2,16,16
1715652790882,MMW 12R,A02,514035,Herbst; Matthew,0,0,16,16
1715652791909,MMW 13R,A01,514037,Staff,0,5,16,16
1715652791909,MMW 13R,A02,514039,Staff,0,5,16,16
1715652791909,MMW 13R,A03,628519,Staff,0,4,16,16
1715652793961,SIO 295LS,A00,523233,Staff,10,0,30,20
1715652794989,SIO 295S,A00,523232,Staff,10,0,30,20
1715652796021,SIOC 290S,A01,637330,Merrifield; Mark A,21,0,30,9
1715652797051,SIOC 291S,A01,637333,Gabriel; Corey John,21,0,30,9
1715652798082,SOCI 117,A01,494376,Staff,0,5,5,5
1715652799108,WES 237B,A00,494380,Staff,10,0,20,10
1715652801177,AESE 279B,A00,494370,Wade; Jon P,0,0,33,33
1715652802203,AIP 97,001,660915,Van Den Einde; Yael Dahlia,9998,0,9999,1
1715652803232,AIP 197,001,627712,Vespa; Emanuel Ignacio,9995,0,9999,4
1715652803232,AIP 197,002,650778,Amir; On,9998,0,9999,1
1715652803232,AIP 197,003,650933,Avenancio-Leon; Carlos,9998,0,9999,1
1715652803232,AIP 197,004,658530,Heyman; Gail D.,9998,0,9999,1
1715652803232,AIP 197,005,658631,Neal; Sonya E,9998,0,9999,1
1715652803232,AIP 197,006,658671,Du; Songzi,9998,0,9999,1
1715652804258,ANAR 135S,A00,494369,Braswell; Geoffrey E.,0,0,0,0
1715652805285,BENG 196,001,628496,Engler; Adam J.,9998,0,9999,1
1715652805285,BENG 196,002,660916,Watson; John Thomas,9998,0,9999,1
1715652806316,BISP 197,001,650773,Wilhelm; James E.,9994,0,9999,5
1715652806316,BISP 197,002,658904,Coleman; Aaron B.,9998,0,9999,1
1715652807347,CAT 124RS,A01,519847,Geibel; William,0,0,20,20
1715652808372,CAT 125RS,A01,515971,Geibel; William,0,0,20,20
1715652809398,CLRE 250,A00,511389,Morris; Sheldon,9992,0,9999,7
1715652810430,CLRE 251,A00,507176,Mehta; Ravindra L.,9992,0,9999,7
1715652810430,CLRE 251,B00,511410,Mehta; Ravindra L.,9998,0,9999,1
1715652811457,CLRE 252,A00,507189,Cuomo; Raphael Eduardo,9994,0,9999,5
1715652812483,CLRE 253,A00,507199,Vaida; Florin,9994,0,9999,5
1715652812483,CLRE 253,B00,507202,Vaida; Florin,9999,0,9999,0
1715652813507,CLRE 259,A00,507211,Patel; Hemal,9996,0,9999,3
1715652814534,CLRE 260,A00,507221,Cuomo; Raphael Eduardo,9999,0,9999,0
1715652815561,CLRE 297,001,507242,Cuomo; Raphael Eduardo,9999,0,9999,0
1715652816587,COGS 197,001,638244,Voytek; Bradley Thomas,9997,0,9999,2
1715652817614,CSE 191,A00,516875,Minnes Kemp; Mor Mia,9991,0,9999,8
1715652818638,CSE 197,001,637388,Minnes Kemp; Mor Mia,9992,0,9999,7
1715652819665,CSS 201S,A01,494383,Mignozzetti; Umberto,35,0,35,0
1715652820691,CSS 202S,A01,494387,Mignozzetti; Umberto,35,0,35,0
1715652821718,DSC 197,001,628532,Eldridge; Justin Matthew,9995,0,9999,4
1715652822744,EAP 100,A00,516065,Staff,9799,0,9999,200
1715652823773,ECE 45,A01,507414,Staff,32,0,60,28
1715652825823,ECE 111,A01,507420,Staff,11,0,50,39
1715652826847,ECE 197,001,548057,Sievenpiper; Daniel F.,9991,0,9999,8
1715652827877,EDS 115,A00,507243,Choi; Bailey Miyeon,6,0,28,22
1715652828905,EDS 117,A01,494379,Staff,0,6,34,35
1715652829931,EDS 125,A00,507246,Hopkins; Megan Beth,7,0,30,23
1715652830957,EDS 128A,A01,507264,Fargason; Sharon Gayle,5,0,26,21
1715652831983,EDS 128B,A01,507293,Pappas; Elizabeth,9,0,30,21
1715652833010,EDS 139,A00,507294,Fargason; Sharon Gayle,9,0,30,21
1715652833010,EDS 139,B00,507313,Pappas; Elizabeth,9,0,30,21
1715652834038,EDS 201,A00,507315,Staff,10,0,30,20
1715652852426,EDS 203,A01,507317,Halter; Christopher P.,10,0,30,20
1715652853456,EDS 204R,A01,507319,Halter; Christopher P.,0,3,30,30
1715652853456,EDS 204R,B01,507331,Heinzman; Erica M.,14,0,30,16
1715652854484,EDS 206R,A00,507332,Staff,0,4,30,30
1715652854484,EDS 206R,B00,507343,Staff,15,0,30,15
1715652855513,EDS 250,A00,507344,Hemans; Patricia Ann Benitez,20,0,40,20
1715652856539,EDS 281,A00,507345,Daly; Alan J.,18,0,18,0
1715652857570,EDS 284,A00,507350,Daly; Alan J.,16,0,16,0
1715652858597,EDS 286,A00,507359,Fine; Sarah,18,0,18,0
1715652859622,EDS 289C,A01,507361,Daly; Alan J.,18,0,18,0
1715652860649,EDS 290,A00,507366,Hofstetter; Carolyn,15,0,15,0
1715652861677,LIGM 5A,A00,507421,Fischer-Grunski; Eva K,17,0,20,3
1715652862702,LIGM 5B,A00,507423,Fischer-Grunski; Eva K,19,0,20,1
1715652863731,LIGM 5C,A00,507425,Fischer-Grunski; Eva K,19,0,20,1
1715652864759,LIIT 5AS,A00,507427,Carnelos; Chiara,20,0,20,0
1715652865781,LIIT 5BS,A00,507430,Carnelos; Chiara,20,0,20,0
1715652866810,LIIT 5CS,A00,507432,Carnelos; Chiara,20,0,20,0
1715652867838,LISP 5A,A00,507541,Munoz Sanchez; Alicia,11,0,20,9
1715652868865,LISP 5B,A00,507671,Munoz Sanchez; Alicia,8,0,20,12
1715652869891,LISP 5C,A00,507696,Munoz Sanchez; Alicia,8,0,20,12
1715652870918,MAE 197,001,528363,Boechler; Nicholas Sebastia,9998,0,9999,1
1715652871949,MATH 197,001,523477,Kedlaya; Kiran S.,9994,0,9999,5
1715652871949,MATH 197,002,563811,Zhang; Danna,9994,0,9999,5
1715652871949,MATH 197,003,628552,Dumitriu; Ioana,9998,0,9999,1
1715652871949,MATH 197,004,660885,Floyd; Eric,9998,0,9999,1
1715652872976,MCWP 40R,A00,518780,Staff,1,0,20,19
1715652872976,MCWP 40R,B00,518781,Carter; Jennifer A,10,0,20,10
1715652872976,MCWP 40R,C00,518783,Smith; Haydee Marie,5,0,20,15
1715652874005,MCWP 50R,A00,518791,Redela; Pamela Morgan,0,1,20,20
1715652874005,MCWP 50R,B00,518792,Krone; Jarret,0,2,20,20
1715652874005,MCWP 50R,C00,518793,Staff,0,4,20,20
1715652874005,MCWP 50R,D00,518794,Morshed; Michael James,0,2,20,20
1715652874005,MCWP 50R,E00,518795,Carter; Andrea L,0,2,20,20
1715652874005,MCWP 50R,F00,518796,Miller; Elizabeth Deen,0,1,20,20
1715652874005,MCWP 50R,G00,518797,Guillen; Melinda,0,1,20,20
1715652875031,MMW 12R,A01,514034,Herbst; Matthew,0,2,16,16
1715652875031,MMW 12R,A02,514035,Herbst; Matthew,0,0,16,16
1715652876055,MMW 13R,A01,514037,Staff,0,5,16,16
1715652876055,MMW 13R,A02,514039,Staff,0,5,16,16
1715652876055,MMW 13R,A03,628519,Staff,0,4,16,16
1715652878136,SIO 295LS,A00,523233,Staff,10,0,30,20
1715652879164,SIO 295S,A00,523232,Staff,10,0,30,20
1715652880190,SIOC 290S,A01,637330,Merrifield; Mark A,21,0,30,9
1715652881214,SIOC 291S,A01,637333,Gabriel; Corey John,21,0,30,9
1715652882238,SOCI 117,A01,494376,Staff,0,5,5,5
1715652883264,WES 237B,A00,494380,Staff,10,0,20,10
1715652885331,AESE 279B,A00,494370,Wade; Jon P,0,0,33,33
1715652886355,AIP 97,001,660915,Van Den Einde; Yael Dahlia,9998,0,9999,1
1715652887382,AIP 197,001,627712,Vespa; Emanuel Ignacio,9995,0,9999,4
1715652887382,AIP 197,002,650778,Amir; On,9998,0,9999,1
1715652887382,AIP 197,003,650933,Avenancio-Leon; Carlos,9998,0,9999,1
1715652887382,AIP 197,004,658530,Heyman; Gail D.,9998,0,9999,1
1715652887382,AIP 197,005,658631,Neal; Sonya E,9998,0,9999,1
1715652887382,AIP 197,006,658671,Du; Songzi,9998,0,9999,1
1715652888409,ANAR 135S,A00,494369,Braswell; Geoffrey E.,0,0,0,0
1715652889438,BENG 196,001,628496,Engler; Adam J.,9998,0,9999,1
1715652889438,BENG 196,002,660916,Watson; John Thomas,9998,0,9999,1
1715652890463,BISP 197,001,650773,Wilhelm; James E.,9994,0,9999,5
1715652890463,BISP 197,002,658904,Coleman; Aaron B.,9998,0,9999,1
1715652891489,CAT 124RS,A01,519847,Geibel; William,0,0,20,20
1715652892513,CAT 125RS,A01,515971,Geibel; William,0,0,20,20
1715652893537,CLRE 250,A00,511389,Morris; Sheldon,9992,0,9999,7
1715652894567,CLRE 251,A00,507176,Mehta; Ravindra L.,9992,0,9999,7
1715652894567,CLRE 251,B00,511410,Mehta; Ravindra L.,9998,0,9999,1
1715652895591,CLRE 252,A00,507189,Cuomo; Raphael Eduardo,9994,0,9999,5
1715652896618,CLRE 253,A00,507199,Vaida; Florin,9994,0,9999,5
1715652896618,CLRE 253,B00,507202,Vaida; Florin,9999,0,9999,0
1715652897645,CLRE 259,A00,507211,Patel; Hemal,9996,0,9999,3
1715652898671,CLRE 260,A00,507221,Cuomo; Raphael Eduardo,9999,0,9999,0
1715652899695,CLRE 297,001,507242,Cuomo; Raphael Eduardo,9999,0,9999,0
1715652900721,COGS 197,001,638244,Voytek; Bradley Thomas,9997,0,9999,2
1715652901750,CSE 191,A00,516875,Minnes Kemp; Mor Mia,9991,0,9999,8
1715652902775,CSE 197,001,637388,Minnes Kemp; Mor Mia,9992,0,9999,7
1715652903806,CSS 201S,A01,494383,Mignozzetti; Umberto,35,0,35,0
1715652904830,CSS 202S,A01,494387,Mignozzetti; Umberto,35,0,35,0
1715652905853,DSC 197,001,628532,Eldridge; Justin Matthew,9995,0,9999,4
1715652906877,EAP 100,A00,516065,Staff,9799,0,9999,200
1715652907908,ECE 45,A01,507414,Staff,32,0,60,28
1715652909957,ECE 111,A01,507420,Staff,11,0,50,39
1715652910983,ECE 197,001,548057,Sievenpiper; Daniel F.,9991,0,9999,8
1715652912013,EDS 115,A00,507243,Choi; Bailey Miyeon,6,0,28,22
1715652913040,EDS 117,A01,494379,Staff,0,6,34,35
1715652914065,EDS 125,A00,507246,Hopkins; Megan Beth,7,0,30,23
1715652915091,EDS 128A,A01,507264,Fargason; Sharon Gayle,5,0,26,21
1715652916117,EDS 128B,A01,507293,Pappas; Elizabeth,9,0,30,21
1715652917141,EDS 139,A00,507294,Fargason; Sharon Gayle,9,0,30,21
1715652917141,EDS 139,B00,507313,Pappas; Elizabeth,9,0,30,21
1715652918166,EDS 201,A00,507315,Staff,10,0,30,20
1715652919191,EDS 203,A01,507317,Halter; Christopher P.,10,0,30,20
1715652920221,EDS 204R,A01,507319,Halter; Christopher P.,0,3,30,30
1715652920221,EDS 204R,B01,507331,Heinzman; Erica M.,14,0,30,16
1715652921247,EDS 206R,A00,507332,Staff,0,4,30,30
1715652921247,EDS 206R,B00,507343,Staff,15,0,30,15
1715652922273,EDS 250,A00,507344,Hemans; Patricia Ann Benitez,20,0,40,20
1715652923299,EDS 281,A00,507345,Daly; Alan J.,18,0,18,0
1715652924324,EDS 284,A00,507350,Daly; Alan J.,16,0,16,0
1715652925353,EDS 286,A00,507359,Fine; Sarah,18,0,18,0
1715652926378,EDS 289C,A01,507361,Daly; Alan J.,18,0,18,0
1715652927406,EDS 290,A00,507366,Hofstetter; Carolyn,15,0,15,0
1715652928435,LIGM 5A,A00,507421,Fischer-Grunski; Eva K,17,0,20,3
1715652929460,LIGM 5B,A00,507423,Fischer-Grunski; Eva K,19,0,20,1
1715652930486,LIGM 5C,A00,507425,Fischer-Grunski; Eva K,19,0,20,1
1715652931513,LIIT 5AS,A00,507427,Carnelos; Chiara,20,0,20,0
1715652932540,LIIT 5BS,A00,507430,Carnelos; Chiara,20,0,20,0
1715652933565,LIIT 5CS,A00,507432,Carnelos; Chiara,20,0,20,0
1715652934596,LISP 5A,A00,507541,Munoz Sanchez; Alicia,11,0,20,9
1715652935621,LISP 5B,A00,507671,Munoz Sanchez; Alicia,8,0,20,12
1715652936648,LISP 5C,A00,507696,Munoz Sanchez; Alicia,8,0,20,12
1715652937676,MAE 197,001,528363,Boechler; Nicholas Sebastia,9998,0,9999,1
1715652938726,MATH 197,001,523477,Kedlaya; Kiran S.,9994,0,9999,5
1715652938726,MATH 197,002,563811,Zhang; Danna,9994,0,9999,5
1715652938726,MATH 197,003,628552,Dumitriu; Ioana,9998,0,9999,1
1715652938726,MATH 197,004,660885,Floyd; Eric,9998,0,9999,1
1715652939759,MCWP 40R,A00,518780,Staff,1,0,20,19
1715652939759,MCWP 40R,B00,518781,Carter; Jennifer A,10,0,20,10
1715652939759,MCWP 40R,C00,518783,Smith; Haydee Marie,5,0,20,15
1715652940787,MCWP 50R,A00,518791,Redela; Pamela Morgan,0,1,20,20
1715652940787,MCWP 50R,B00,518792,Krone; Jarret,0,2,20,20
1715652940787,MCWP 50R,C00,518793,Staff,0,4,20,20
1715652940787,MCWP 50R,D00,518794,Morshed; Michael James,0,2,20,20
1715652940787,MCWP 50R,E00,518795,Carter; Andrea L,0,2,20,20
1715652940787,MCWP 50R,F00,518796,Miller; Elizabeth Deen,0,1,20,20
1715652940787,MCWP 50R,G00,518797,Guillen; Melinda,0,1,20,20
1715652941815,MMW 12R,A01,514034,Herbst; Matthew,0,2,16,16
1715652941815,MMW 12R,A02,514035,Herbst; Matthew,0,0,16,16
1715652942840,MMW 13R,A01,514037,Staff,0,5,16,16
1715652942840,MMW 13R,A02,514039,Staff,0,5,16,16
1715652942840,MMW 13R,A03,628519,Staff,0,4,16,16
1715652944892,SIO 295LS,A00,523233,Staff,10,0,30,20
1715652945917,SIO 295S,A00,523232,Staff,10,0,30,20
1715652946942,SIOC 290S,A01,637330,Merrifield; Mark A,21,0,30,9
1715652947970,SIOC 291S,A01,637333,Gabriel; Corey John,21,0,30,9
1715652948995,SOCI 117,A01,494376,Staff,0,5,5,5
1715652950020,WES 237B,A00,494380,Staff,10,0,20,10
1715652952089,AESE 279B,A00,494370,Wade; Jon P,0,0,33,33
1715652953116,AIP 97,001,660915,Van Den Einde; Yael Dahlia,9998,0,9999,1
1715652954144,AIP 197,001,627712,Vespa; Emanuel Ignacio,9995,0,9999,4
1715652954144,AIP 197,002,650778,Amir; On,9998,0,9999,1
1715652954144,AIP 197,003,650933,Avenancio-Leon; Carlos,9998,0,9999,1
1715652954144,AIP 197,004,658530,Heyman; Gail D.,9998,0,9999,1
1715652954144,AIP 197,005,658631,Neal; Sonya E,9998,0,9999,1
1715652954144,AIP 197,006,658671,Du; Songzi,9998,0,9999,1
1715652955168,ANAR 135S,A00,494369,Braswell; Geoffrey E.,0,0,0,0
1715652956198,BENG 196,001,628496,Engler; Adam J.,9998,0,9999,1
1715652956198,BENG 196,002,660916,Watson; John Thomas,9998,0,9999,1
1715652957227,BISP 197,001,650773,Wilhelm; James E.,9994,0,9999,5
1715652957227,BISP 197,002,658904,Coleman; Aaron B.,9998,0,9999,1
1715652958255,CAT 124RS,A01,519847,Geibel; William,0,0,20,20
1715652959281,CAT 125RS,A01,515971,Geibel; William,0,0,20,20
1715652960310,CLRE 250,A00,511389,Morris; Sheldon,9992,0,9999,7
1715652961338,CLRE 251,A00,507176,Mehta; Ravindra L.,9992,0,9999,7
1715652961338,CLRE 251,B00,511410,Mehta; Ravindra L.,9998,0,9999,1
1715652962365,CLRE 252,A00,507189,Cuomo; Raphael Eduardo,9994,0,9999,5
1715652963392,CLRE 253,A00,507199,Vaida; Florin,9994,0,9999,5
1715652963392,CLRE 253,B00,507202,Vaida; Florin,9999,0,9999,0
1715652964419,CLRE 259,A00,507211,Patel; Hemal,9996,0,9999,3
1715652965444,CLRE 260,A00,507221,Cuomo; Raphael Eduardo,9999,0,9999,0
1715652966471,CLRE 297,001,507242,Cuomo; Raphael Eduardo,9999,0,9999,0
1715652967498,COGS 197,001,638244,Voytek; Bradley Thomas,9997,0,9999,2
1715652968523,CSE 191,A00,516875,Minnes Kemp; Mor Mia,9991,0,9999,8
1715652969549,CSE 197,001,637388,Minnes Kemp; Mor Mia,9992,0,9999,7
1715652970575,CSS 201S,A01,494383,Mignozzetti; Umberto,35,0,35,0
1715652971601,CSS 202S,A01,494387,Mignozzetti; Umberto,35,0,35,0
1715652972626,DSC 197,001,628532,Eldridge; Justin Matthew,9995,0,9999,4
1715652973650,EAP 100,A00,516065,Staff,9799,0,9999,200
1715652974680,ECE 45,A01,507414,Staff,32,0,60,28
1715652976732,ECE 111,A01,507420,Staff,11,0,50,39
1715652977757,ECE 197,001,548057,Sievenpiper; Daniel F.,9991,0,9999,8
1715652978783,EDS 115,A00,507243,Choi; Bailey Miyeon,6,0,28,22
1715652979809,EDS 117,A01,494379,Staff,0,6,34,35
1715652980839,EDS 125,A00,507246,Hopkins; Megan Beth,7,0,30,23
1715652981867,EDS 128A,A01,507264,Fargason; Sharon Gayle,5,0,26,21
1715652982897,EDS 128B,A01,507293,Pappas; Elizabeth,9,0,30,21
1715652983922,EDS 139,A00,507294,Fargason; Sharon Gayle,9,0,30,21
1715652983922,EDS 139,B00,507313,Pappas; Elizabeth,9,0,30,21
1715652984947,EDS 201,A00,507315,Staff,10,0,30,20
1715652985973,EDS 203,A01,507317,Halter; Christopher P.,10,0,30,20
1715652986999,EDS 204R,A01,507319,Halter; Christopher P.,0,3,30,30
1715652986999,EDS 204R,B01,507331,Heinzman; Erica M.,14,0,30,16
1715652988026,EDS 206R,A00,507332,Staff,0,4,30,30
1715652988026,EDS 206R,B00,507343,Staff,15,0,30,15
1715652989054,EDS 250,A00,507344,Hemans; Patricia Ann Benitez,20,0,40,20
1715652990083,EDS 281,A00,507345,Daly; Alan J.,18,0,18,0
1715652991108,EDS 284,A00,507350,Daly; Alan J.,16,0,16,0
1715652992134,EDS 286,A00,507359,Fine; Sarah,18,0,18,0
1715652993162,EDS 289C,A01,507361,Daly; Alan J.,18,0,18,0
1715652994190,EDS 290,A00,507366,Hofstetter; Carolyn,15,0,15,0
1715652995218,LIGM 5A,A00,507421,Fischer-Grunski; Eva K,17,0,20,3
1715652996247,LIGM 5B,A00,507423,Fischer-Grunski; Eva K,19,0,20,1
1715652997328,LIGM 5C,A00,507425,Fischer-Grunski; Eva K,19,0,20,1
1715652998354,LIIT 5AS,A00,507427,Carnelos; Chiara,20,0,20,0
1715652999383,LIIT 5BS,A00,507430,Carnelos; Chiara,20,0,20,0
1715653000410,LIIT 5CS,A00,507432,Carnelos; Chiara,20,0,20,0
1715653001435,LISP 5A,A00,507541,Munoz Sanchez; Alicia,11,0,20,9
1715653002465,LISP 5B,A00,507671,Munoz Sanchez; Alicia,8,0,20,12
1715653003492,LISP 5C,A00,507696,Munoz Sanchez; Alicia,8,0,20,12
1715653004516,MAE 197,001,528363,Boechler; Nicholas Sebastia,9998,0,9999,1
1715653005543,MATH 197,001,523477,Kedlaya; Kiran S.,9994,0,9999,5
1715653005543,MATH 197,002,563811,Zhang; Danna,9994,0,9999,5
1715653005543,MATH 197,003,628552,Dumitriu; Ioana,9998,0,9999,1
1715653005543,MATH 197,004,660885,Floyd; Eric,9998,0,9999,1
1715653006573,MCWP 40R,A00,518780,Staff,1,0,20,19
1715653006573,MCWP 40R,B00,518781,Carter; Jennifer A,10,0,20,10
1715653006573,MCWP 40R,C00,518783,Smith; Haydee Marie,5,0,20,15
1715653007601,MCWP 50R,A00,518791,Redela; Pamela Morgan,0,1,20,20
1715653007601,MCWP 50R,B00,518792,Krone; Jarret,0,2,20,20
1715653007601,MCWP 50R,C00,518793,Staff,0,4,20,20
1715653007601,MCWP 50R,D00,518794,Morshed; Michael James,0,2,20,20
1715653007601,MCWP 50R,E00,518795,Carter; Andrea L,0,2,20,20
1715653007601,MCWP 50R,F00,518796,Miller; Elizabeth Deen,0,1,20,20
1715653007601,MCWP 50R,G00,518797,Guillen; Melinda,0,1,20,20
1715653008626,MMW 12R,A01,514034,Herbst; Matthew,0,2,16,16
1715653008626,MMW 12R,A02,514035,Herbst; Matthew,0,0,16,16
1715653009649,MMW 13R,A01,514037,Staff,0,5,16,16
1715653009649,MMW 13R,A02,514039,Staff,0,5,16,16
1715653009649,MMW 13R,A03,628519,Staff,0,4,16,16
1715653011701,SIO 295LS,A00,523233,Staff,10,0,30,20
1715653012727,SIO 295S,A00,523232,Staff,10,0,30,20
1715653013754,SIOC 290S,A01,637330,Merrifield; Mark A,21,0,30,9
1715653014779,SIOC 291S,A01,637333,Gabriel; Corey John,21,0,30,9
1715653015803,SOCI 117,A01,494376,Staff,0,5,5,5
1715653016830,WES 237B,A00,494380,Staff,10,0,20,10
1715653018905,AESE 279B,A00,494370,Wade; Jon P,0,0,33,33
1715653019930,AIP 97,001,660915,Van Den Einde; Yael Dahlia,9998,0,9999,1
1715653020957,AIP 197,001,627712,Vespa; Emanuel Ignacio,9995,0,9999,4
1715653020957,AIP 197,002,650778,Amir; On,9998,0,9999,1
1715653020957,AIP 197,003,650933,Avenancio-Leon; Carlos,9998,0,9999,1
1715653020957,AIP 197,004,658530,Heyman; Gail D.,9998,0,9999,1
1715653020957,AIP 197,005,658631,Neal; Sonya E,9998,0,9999,1
1715653020957,AIP 197,006,658671,Du; Songzi,9998,0,9999,1
1715653021983,ANAR 135S,A00,494369,Braswell; Geoffrey E.,0,0,0,0
1715653023030,BENG 196,001,628496,Engler; Adam J.,9998,0,9999,1
1715653023030,BENG 196,002,660916,Watson; John Thomas,9998,0,9999,1
1715653024056,BISP 197,001,650773,Wilhelm; James E.,9994,0,9999,5
1715653024056,BISP 197,002,658904,Coleman; Aaron B.,9998,0,9999,1
1715653025081,CAT 124RS,A01,519847,Geibel; William,0,0,20,20
1715653026104,CAT 125RS,A01,515971,Geibel; William,0,0,20,20
1715653027129,CLRE 250,A00,511389,Morris; Sheldon,9992,0,9999,7
1715653028156,CLRE 251,A00,507176,Mehta; Ravindra L.,9992,0,9999,7
1715653028156,CLRE 251,B00,511410,Mehta; Ravindra L.,9998,0,9999,1
1715653029180,CLRE 252,A00,507189,Cuomo; Raphael Eduardo,9994,0,9999,5
1715653030203,CLRE 253,A00,507199,Vaida; Florin,9994,0,9999,5
1715653030203,CLRE 253,B00,507202,Vaida; Florin,9999,0,9999,0
1715653031229,CLRE 259,A00,507211,Patel; Hemal,9996,0,9999,3
1715653032256,CLRE 260,A00,507221,Cuomo; Raphael Eduardo,9999,0,9999,0
1715653033280,CLRE 297,001,507242,Cuomo; Raphael Eduardo,9999,0,9999,0
1715653034310,COGS 197,001,638244,Voytek; Bradley Thomas,9997,0,9999,2
1715653035338,CSE 191,A00,516875,Minnes Kemp; Mor Mia,9991,0,9999,8
1715653036363,CSE 197,001,637388,Minnes Kemp; Mor Mia,9992,0,9999,7
1715653037390,CSS 201S,A01,494383,Mignozzetti; Umberto,35,0,35,0
1715653038419,CSS 202S,A01,494387,Mignozzetti; Umberto,35,0,35,0
1715653039446,DSC 197,001,628532,Eldridge; Justin Matthew,9995,0,9999,4
1715653040470,EAP 100,A00,516065,Staff,9799,0,9999,200
1715653041505,ECE 45,A01,507414,Staff,32,0,60,28
1715653043560,ECE 111,A01,507420,Staff,11,0,50,39
1715653044586,ECE 197,001,548057,Sievenpiper; Daniel F.,9991,0,9999,8
1715653045613,EDS 115,A00,507243,Choi; Bailey Miyeon,6,0,28,22
1715653046642,EDS 117,A01,494379,Staff,0,6,34,35
1715653047668,EDS 125,A00,507246,Hopkins; Megan Beth,7,0,30,23
1715653048695,EDS 128A,A01,507264,Fargason; Sharon Gayle,5,0,26,21
1715653049722,EDS 128B,A01,507293,Pappas; Elizabeth,9,0,30,21
1715653050750,EDS 139,A00,507294,Fargason; Sharon Gayle,9,0,30,21
1715653050750,EDS 139,B00,507313,Pappas; Elizabeth,9,0,30,21
1715653051772,EDS 201,A00,507315,Staff,10,0,30,20
1715653052797,EDS 203,A01,507317,Halter; Christopher P.,10,0,30,20
1715653053822,EDS 204R,A01,507319,Halter; Christopher P.,0,3,30,30
1715653053822,EDS 204R,B01,507331,Heinzman; Erica M.,14,0,30,16
1715653054847,EDS 206R,A00,507332,Staff,0,4,30,30
1715653054847,EDS 206R,B00,507343,Staff,15,0,30,15
1715653055874,EDS 250,A00,507344,Hemans; Patricia Ann Benitez,20,0,40,20
1715653056901,EDS 281,A00,507345,Daly; Alan J.,18,0,18,0
1715653057925,EDS 284,A00,507350,Daly; Alan J.,16,0,16,0
1715653058953,EDS 286,A00,507359,Fine; Sarah,18,0,18,0
1715653059981,EDS 289C,A01,507361,Daly; Alan J.,18,0,18,0
1715653061007,EDS 290,A00,507366,Hofstetter; Carolyn,15,0,15,0
1715653062033,LIGM 5A,A00,507421,Fischer-Grunski; Eva K,17,0,20,3
1715653063062,LIGM 5B,A00,507423,Fischer-Grunski; Eva K,19,0,20,1
1715653064089,LIGM 5C,A00,507425,Fischer-Grunski; Eva K,19,0,20,1
1715653065118,LIIT 5AS,A00,507427,Carnelos; Chiara,20,0,20,0
1715653066199,LIIT 5BS,A00,507430,Carnelos; Chiara,20,0,20,0
1715653067228,LIIT 5CS,A00,507432,Carnelos; Chiara,20,0,20,0
1715653068259,LISP 5A,A00,507541,Munoz Sanchez; Alicia,11,0,20,9
1715653069289,LISP 5B,A00,507671,Munoz Sanchez; Alicia,8,0,20,12
1715653070317,LISP 5C,A00,507696,Munoz Sanchez; Alicia,8,0,20,12
1715653071345,MAE 197,001,528363,Boechler; Nicholas Sebastia,9998,0,9999,1
1715653072373,MATH 197,001,523477,Kedlaya; Kiran S.,9994,0,9999,5
1715653072373,MATH 197,002,563811,Zhang; Danna,9994,0,9999,5
1715653072373,MATH 197,003,628552,Dumitriu; Ioana,9998,0,9999,1
1715653072373,MATH 197,004,660885,Floyd; Eric,9998,0,9999,1
1715653073405,MCWP 40R,A00,518780,Staff,1,0,20,19
1715653073405,MCWP 40R,B00,518781,Carter; Jennifer A,10,0,20,10
1715653073405,MCWP 40R,C00,518783,Smith; Haydee Marie,5,0,20,15
1715653074434,MCWP 50R,A00,518791,Redela; Pamela Morgan,0,1,20,20
1715653074434,MCWP 50R,B00,518792,Krone; Jarret,0,2,20,20
1715653074434,MCWP 50R,C00,518793,Staff,0,4,20,20
1715653074434,MCWP 50R,D00,518794,Morshed; Michael James,0,2,20,20
1715653074434,MCWP 50R,E00,518795,Carter; Andrea L,0,2,20,20
1715653074434,MCWP 50R,F00,518796,Miller; Elizabeth Deen,0,1,20,20
1715653074434,MCWP 50R,G00,518797,Guillen; Melinda,0,1,20,20
1715653075462,MMW 12R,A01,514034,Herbst; Matthew,0,2,16,16
1715653075462,MMW 12R,A02,514035,Herbst; Matthew,0,0,16,16
1715653076490,MMW 13R,A01,514037,Staff,0,5,16,16
1715653076490,MMW 13R,A02,514039,Staff,0,5,16,16
1715653076490,MMW 13R,A03,628519,Staff,0,4,16,16
1715653078545,SIO 295LS,A00,523233,Staff,10,0,30,20
1715653079570,SIO 295S,A00,523232,Staff,10,0,30,20
1715653080600,SIOC 290S,A01,637330,Merrifield; Mark A,21,0,30,9
1715653081626,SIOC 291S,A01,637333,Gabriel; Corey John,21,0,30,9
1715653082650,SOCI 117,A01,494376,Staff,0,5,5,5
1715653083678,WES 237B,A00,494380,Staff,10,0,20,10
1715653085737,AESE 279B,A00,494370,Wade; Jon P,0,0,33,33
1715653086763,AIP 97,001,660915,Van Den Einde; Yael Dahlia,9998,0,9999,1
1715653087789,AIP 197,001,627712,Vespa; Emanuel Ignacio,9995,0,9999,4
1715653087789,AIP 197,002,650778,Amir; On,9998,0,9999,1
1715653087789,AIP 197,003,650933,Avenancio-Leon; Carlos,9998,0,9999,1
1715653087789,AIP 197,004,658530,Heyman; Gail D.,9998,0,9999,1
1715653087789,AIP 197,005,658631,Neal; Sonya E,9998,0,9999,1
1715653087789,AIP 197,006,658671,Du; Songzi,9998,0,9999,1
1715653088818,ANAR 135S,A00,494369,Braswell; Geoffrey E.,0,0,0,0
1715653089843,BENG 196,001,628496,Engler; Adam J.,9998,0,9999,1
1715653089843,BENG 196,002,660916,Watson; John Thomas,9998,0,9999,1
1715653090870,BISP 197,001,650773,Wilhelm; James E.,9994,0,9999,5
1715653090870,BISP 197,002,658904,Coleman; Aaron B.,9998,0,9999,1
1715653091898,CAT 124RS,A01,519847,Geibel; William,0,0,20,20
1715653092923,CAT 125RS,A01,515971,Geibel; William,0,0,20,20
1715653093949,CLRE 250,A00,511389,Morris; Sheldon,9992,0,9999,7
1715653094989,CLRE 251,A00,507176,Mehta; Ravindra L.,9992,0,9999,7
1715653094989,CLRE 251,B00,511410,Mehta; Ravindra L.,9998,0,9999,1
1715653096019,CLRE 252,A00,507189,Cuomo; Raphael Eduardo,9994,0,9999,5
1715653097048,CLRE 253,A00,507199,Vaida; Florin,9994,0,9999,5
1715653097048,CLRE 253,B00,507202,Vaida; Florin,9999,0,9999,0
1715653098079,CLRE 259,A00,507211,Patel; Hemal,9996,0,9999,3
1715653099104,CLRE 260,A00,507221,Cuomo; Raphael Eduardo,9999,0,9999,0
1715653100129,CLRE 297,001,507242,Cuomo; Raphael Eduardo,9999,0,9999,0
1715653101154,COGS 197,001,638244,Voytek; Bradley Thomas,9997,0,9999,2
1715653102180,CSE 191,A00,516875,Minnes Kemp; Mor Mia,9991,0,9999,8
1715653103203,CSE 197,001,637388,Minnes Kemp; Mor Mia,9992,0,9999,7
1715653104235,CSS 201S,A01,494383,Mignozzetti; Umberto,35,0,35,0
1715653105259,CSS 202S,A01,494387,Mignozzetti; Umberto,35,0,35,0
1715653106283,DSC 197,001,628532,Eldridge; Justin Matthew,9995,0,9999,4
1715653107311,EAP 100,A00,516065,Staff,9799,0,9999,200
1715653108342,ECE 45,A01,507414,Staff,32,0,60,28
1715653110396,ECE 111,A01,507420,Staff,11,0,50,39
1715653111424,ECE 197,001,548057,Sievenpiper; Daniel F.,9991,0,9999,8
1715653112451,EDS 115,A00,507243,Choi; Bailey Miyeon,6,0,28,22
1715653113477,EDS 117,A01,494379,Staff,0,6,34,35
1715653114501,EDS 125,A00,507246,Hopkins; Megan Beth,7,0,30,23
1715653115528,EDS 128A,A01,507264,Fargason; Sharon Gayle,5,0,26,21
1715653116556,EDS 128B,A01,507293,Pappas; Elizabeth,9,0,30,21
1715653117580,EDS 139,A00,507294,Fargason; Sharon Gayle,9,0,30,21
1715653117580,EDS 139,B00,507313,Pappas; Elizabeth,9,0,30,21
1715653118608,EDS 201,A00,507315,Staff,10,0,30,20
1715653119639,EDS 203,A01,507317,Halter; Christopher P.,10,0,30,20
1715653120666,EDS 204R,A01,507319,Halter; Christopher P.,0,3,30,30
1715653120666,EDS 204R,B01,507331,Heinzman; Erica M.,14,0,30,16
1715653121695,EDS 206R,A00,507332,Staff,0,4,30,30
1715653121695,EDS 206R,B00,507343,Staff,15,0,30,15
1715653122719,EDS 250,A00,507344,Hemans; Patricia Ann Benitez,20,0,40,20
1715653123743,EDS 281,A00,507345,Daly; Alan J.,18,0,18,0
1715653124767,EDS 284,A00,507350,Daly; Alan J.,16,0,16,0
1715653125793,EDS 286,A00,507359,Fine; Sarah,18,0,18,0
1715653126818,EDS 289C,A01,507361,Daly; Alan J.,18,0,18,0
1715653127845,EDS 290,A00,507366,Hofstetter; Carolyn,15,0,15,0
1715653128874,LIGM 5A,A00,507421,Fischer-Grunski; Eva K,17,0,20,3
1715653129897,LIGM 5B,A00,507423,Fischer-Grunski; Eva K,19,0,20,1
1715653130921,LIGM 5C,A00,507425,Fischer-Grunski; Eva K,19,0,20,1
1715653131953,LIIT 5AS,A00,507427,Carnelos; Chiara,20,0,20,0
1715653132979,LIIT 5BS,A00,507430,Carnelos; Chiara,20,0,20,0
1715653134004,LIIT 5CS,A00,507432,Carnelos; Chiara,20,0,20,0
1715653135033,LISP 5A,A00,507541,Munoz Sanchez; Alicia,11,0,20,9
1715653136060,LISP 5B,A00,507671,Munoz Sanchez; Alicia,8,0,20,12
1715653137086,LISP 5C,A00,507696,Munoz Sanchez; Alicia,8,0,20,12
1715653138113,MAE 197,001,528363,Boechler; Nicholas Sebastia,9998,0,9999,1
1715653139142,MATH 197,001,523477,Kedlaya; Kiran S.,9994,0,9999,5
1715653139142,MATH 197,002,563811,Zhang; Danna,9994,0,9999,5
1715653139142,MATH 197,003,628552,Dumitriu; Ioana,9998,0,9999,1
1715653139142,MATH 197,004,660885,Floyd; Eric,9998,0,9999,1
1715653140171,MCWP 40R,A00,518780,Staff,1,0,20,19
1715653140171,MCWP 40R,B00,518781,Carter; Jennifer A,9,0,20,11
1715653140171,MCWP 40R,C00,518783,Smith; Haydee Marie,5,0,20,15
1715653141198,MCWP 50R,A00,518791,Redela; Pamela Morgan,0,1,20,20
1715653141198,MCWP 50R,B00,518792,Krone; Jarret,0,2,20,20
1715653141198,MCWP 50R,C00,518793,Staff,0,4,20,20
1715653141198,MCWP 50R,D00,518794,Morshed; Michael James,0,2,20,20
1715653141198,MCWP 50R,E00,518795,Carter; Andrea L,0,2,20,20
1715653141198,MCWP 50R,F00,518796,Miller; Elizabeth Deen,0,1,20,20
1715653141198,MCWP 50R,G00,518797,Guillen; Melinda,0,1,20,20
1715653142229,MMW 12R,A01,514034,Herbst; Matthew,0,2,16,16
1715653142229,MMW 12R,A02,514035,Herbst; Matthew,0,0,16,16
1715653143255,MMW 13R,A01,514037,Staff,0,5,16,16
1715653143255,MMW 13R,A02,514039,Staff,0,5,16,16
1715653143255,MMW 13R,A03,628519,Staff,0,4,16,16
1715653145314,SIO 295LS,A00,523233,Staff,10,0,30,20
1715653146339,SIO 295S,A00,523232,Staff,10,0,30,20
1715653147368,SIOC 290S,A01,637330,Merrifield; Mark A,21,0,30,9
1715653148396,SIOC 291S,A01,637333,Gabriel; Corey John,21,0,30,9
1715653149421,SOCI 117,A01,494376,Staff,0,5,5,5
1715653150446,WES 237B,A00,494380,Staff,10,0,20,10
1715653152531,AESE 279B,A00,494370,Wade; Jon P,0,0,33,33
1715653153559,AIP 97,001,660915,Van Den Einde; Yael Dahlia,9998,0,9999,1
1715653154588,AIP 197,001,627712,Vespa; Emanuel Ignacio,9995,0,9999,4
1715653154588,AIP 197,002,650778,Amir; On,9998,0,9999,1
1715653154588,AIP 197,003,650933,Avenancio-Leon; Carlos,9998,0,9999,1
1715653154588,AIP 197,004,658530,Heyman; Gail D.,9998,0,9999,1
1715653154588,AIP 197,005,658631,Neal; Sonya E,9998,0,9999,1
1715653154588,AIP 197,006,658671,Du; Songzi,9998,0,9999,1
1715653155615,ANAR 135S,A00,494369,Braswell; Geoffrey E.,0,0,0,0
1715653156644,BENG 196,001,628496,Engler; Adam J.,9998,0,9999,1
1715653156644,BENG 196,002,660916,Watson; John Thomas,9998,0,9999,1
1715653157673,BISP 197,001,650773,Wilhelm; James E.,9994,0,9999,5
1715653157673,BISP 197,002,658904,Coleman; Aaron B.,9998,0,9999,1
1715653158699,CAT 124RS,A01,519847,Geibel; William,0,0,20,20
1715653159725,CAT 125RS,A01,515971,Geibel; William,0,0,20,20
1715653160750,CLRE 250,A00,511389,Morris; Sheldon,9992,0,9999,7
1715653161775,CLRE 251,A00,507176,Mehta; Ravindra L.,9992,0,9999,7
1715653161775,CLRE 251,B00,511410,Mehta; Ravindra L.,9998,0,9999,1
1715653162804,CLRE 252,A00,507189,Cuomo; Raphael Eduardo,9994,0,9999,5
1715653163828,CLRE 253,A00,507199,Vaida; Florin,9994,0,9999,5
1715653163828,CLRE 253,B00,507202,Vaida; Florin,9999,0,9999,0
1715653164854,CLRE 259,A00,507211,Patel; Hemal,9996,0,9999,3
1715653165878,CLRE 260,A00,507221,Cuomo; Raphael Eduardo,9999,0,9999,0
1715653166905,CLRE 297,001,507242,Cuomo; Raphael Eduardo,9999,0,9999,0
1715653167934,COGS 197,001,638244,Voytek; Bradley Thomas,9997,0,9999,2
1715653168960,CSE 191,A00,516875,Minnes Kemp; Mor Mia,9991,0,9999,8
1715653169986,CSE 197,001,637388,Minnes Kemp; Mor Mia,9992,0,9999,7
1715653171012,CSS 201S,A01,494383,Mignozzetti; Umberto,35,0,35,0
1715653172037,CSS 202S,A01,494387,Mignozzetti; Umberto,35,0,35,0
1715653173060,DSC 197,001,628532,Eldridge; Justin Matthew,9995,0,9999,4
1715653174088,EAP 100,A00,516065,Staff,9799,0,9999,200
1715653175146,ECE 45,A01,507414,Staff,32,0,60,28
1715653177198,ECE 111,A01,507420,Staff,11,0,50,39
1715653178227,ECE 197,001,548057,Sievenpiper; Daniel F.,9991,0,9999,8
1715653179257,EDS 115,A00,507243,Choi; Bailey Miyeon,6,0,28,22
1715653180281,EDS 117,A01,494379,Staff,0,6,34,35
1715653181310,EDS 125,A00,507246,Hopkins; Megan Beth,7,0,30,23
1715653182336,EDS 128A,A01,507264,Fargason; Sharon Gayle,5,0,26,21
1715653183361,EDS 128B,A01,507293,Pappas; Elizabeth,9,0,30,21
1715653184388,EDS 139,A00,507294,Fargason; Sharon Gayle,9,0,30,21
1715653184388,EDS 139,B00,507313,Pappas; Elizabeth,9,0,30,21
1715653185416,EDS 201,A00,507315,Staff,10,0,30,20
1715653186442,EDS 203,A01,507317,Halter; Christopher P.,10,0,30,20
1715653187474,EDS 204R,A01,507319,Halter; Christopher P.,0,3,30,30
1715653187474,EDS 204R,B01,507331,Heinzman; Erica M.,14,0,30,16
1715653188501,EDS 206R,A00,507332,Staff,0,4,30,30
1715653188501,EDS 206R,B00,507343,Staff,15,0,30,15
1715653189528,EDS 250,A00,507344,Hemans; Patricia Ann Benitez,20,0,40,20
1715653190552,EDS 281,A00,507345,Daly; Alan J.,18,0,18,0
1715653191576,EDS 284,A00,507350,Daly; Alan J.,16,0,16,0
1715653192602,EDS 286,A00,507359,Fine; Sarah,18,0,18,0
1715653193627,EDS 289C,A01,507361,Daly; Alan J.,18,0,18,0
1715653194652,EDS 290,A00,507366,Hofstetter; Carolyn,15,0,15,0
1715653195683,LIGM 5A,A00,507421,Fischer-Grunski; Eva K,17,0,20,3
1715653196709,LIGM 5B,A00,507423,Fischer-Grunski; Eva K,19,0,20,1
1715653197733,LIGM 5C,A00,507425,Fischer-Grunski; Eva K,19,0,20,1
1715653198761,LIIT 5AS,A00,507427,Carnelos; Chiara,20,0,20,0
1715653199786,LIIT 5BS,A00,507430,Carnelos; Chiara,20,0,20,0
1715653200815,LIIT 5CS,A00,507432,Carnelos; Chiara,20,0,20,0
1715653201841,LISP 5A,A00,507541,Munoz Sanchez; Alicia,11,0,20,9
1715653202870,LISP 5B,A00,507671,Munoz Sanchez; Alicia,8,0,20,12
1715653203909,LISP 5C,A00,507696,Munoz Sanchez; Alicia,8,0,20,12
1715653204937,MAE 197,001,528363,Boechler; Nicholas Sebastia,9998,0,9999,1
1715653205963,MATH 197,001,523477,Kedlaya; Kiran S.,9994,0,9999,5
1715653205963,MATH 197,002,563811,Zhang; Danna,9994,0,9999,5
1715653205963,MATH 197,003,628552,Dumitriu; Ioana,9998,0,9999,1
1715653205963,MATH 197,004,660885,Floyd; Eric,9998,0,9999,1
1715653206991,MCWP 40R,A00,518780,Staff,1,0,20,19
1715653206991,MCWP 40R,B00,518781,Carter; Jennifer A,9,0,20,11
1715653206991,MCWP 40R,C00,518783,Smith; Haydee Marie,5,0,20,15
1715653208023,MCWP 50R,A00,518791,Redela; Pamela Morgan,0,1,20,20
1715653208023,MCWP 50R,B00,518792,Krone; Jarret,0,2,20,20
1715653208023,MCWP 50R,C00,518793,Staff,0,4,20,20
1715653208023,MCWP 50R,D00,518794,Morshed; Michael James,0,2,20,20
1715653208023,MCWP 50R,E00,518795,Carter; Andrea L,0,2,20,20
1715653208023,MCWP 50R,F00,518796,Miller; Elizabeth Deen,0,1,20,20
1715653208023,MCWP 50R,G00,518797,Guillen; Melinda,0,1,20,20
1715653209053,MMW 12R,A01,514034,Herbst; Matthew,0,2,16,16
1715653209053,MMW 12R,A02,514035,Herbst; Matthew,0,0,16,16
1715653210078,MMW 13R,A01,514037,Staff,0,5,16,16
1715653210078,MMW 13R,A02,514039,Staff,0,5,16,16
1715653210078,MMW 13R,A03,628519,Staff,0,4,16,16
1715653212134,SIO 295LS,A00,523233,Staff,10,0,30,20
1715653213159,SIO 295S,A00,523232,Staff,10,0,30,20
1715653214184,SIOC 290S,A01,637330,Merrifield; Mark A,21,0,30,9
1715653215213,SIOC 291S,A01,637333,Gabriel; Corey John,21,0,30,9
1715653216242,SOCI 117,A01,494376,Staff,0,5,5,5
1715653217266,WES 237B,A00,494380,Staff,10,0,20,10
1715653219342,AESE 279B,A00,494370,Wade; Jon P,0,0,33,33
1715653220369,AIP 97,001,660915,Van Den Einde; Yael Dahlia,9998,0,9999,1
1715653221403,AIP 197,001,627712,Vespa; Emanuel Ignacio,9995,0,9999,4
1715653221403,AIP 197,002,650778,Amir; On,9998,0,9999,1
1715653221403,AIP 197,003,650933,Avenancio-Leon; Carlos,9998,0,9999,1
1715653221403,AIP 197,004,658530,Heyman; Gail D.,9998,0,9999,1
1715653221403,AIP 197,005,658631,Neal; Sonya E,9998,0,9999,1
1715653221403,AIP 197,006,658671,Du; Songzi,9998,0,9999,1
1715653222431,ANAR 135S,A00,494369,Braswell; Geoffrey E.,0,0,0,0
1715653223457,BENG 196,001,628496,Engler; Adam J.,9998,0,9999,1
1715653223457,BENG 196,002,660916,Watson; John Thomas,9998,0,9999,1
1715653224484,BISP 197,001,650773,Wilhelm; James E.,9994,0,9999,5
1715653224484,BISP 197,002,658904,Coleman; Aaron B.,9998,0,9999,1
1715653225512,CAT 124RS,A01,519847,Geibel; William,0,0,20,20
1715653226541,CAT 125RS,A01,515971,Geibel; William,0,0,20,20
1715653227567,CLRE 250,A00,511389,Morris; Sheldon,9992,0,9999,7
1715653228594,CLRE 251,A00,507176,Mehta; Ravindra L.,9992,0,9999,7
1715653228594,CLRE 251,B00,511410,Mehta; Ravindra L.,9998,0,9999,1
1715653229620,CLRE 252,A00,507189,Cuomo; Raphael Eduardo,9994,0,9999,5
1715653230649,CLRE 253,A00,507199,Vaida; Florin,9994,0,9999,5
1715653230649,CLRE 253,B00,507202,Vaida; Florin,9999,0,9999,0
1715653231673,CLRE 259,A00,507211,Patel; Hemal,9996,0,9999,3
1715653232701,CLRE 260,A00,507221,Cuomo; Raphael Eduardo,9999,0,9999,0
1715653233725,CLRE 297,001,507242,Cuomo; Raphael Eduardo,9999,0,9999,0
1715653234753,COGS 197,001,638244,Voytek; Bradley Thomas,9997,0,9999,2
1715653235782,CSE 191,A00,516875,Minnes Kemp; Mor Mia,9991,0,9999,8
1715653236810,CSE 197,001,637388,Minnes Kemp; Mor Mia,9992,0,9999,7
1715653237842,CSS 201S,A01,494383,Mignozzetti; Umberto,35,0,35,0
1715653238871,CSS 202S,A01,494387,Mignozzetti; Umberto,35,0,35,0
1715653239895,DSC 197,001,628532,Eldridge; Justin Matthew,9995,0,9999,4
1715653240921,EAP 100,A00,516065,Staff,9799,0,9999,200
1715653241947,ECE 45,A01,507414,Staff,32,0,60,28
1715653244000,ECE 111,A01,507420,Staff,11,0,50,39
1715653245029,ECE 197,001,548057,Sievenpiper; Daniel F.,9991,0,9999,8
1715653246056,EDS 115,A00,507243,Choi; Bailey Miyeon,6,0,28,22
1715653247085,EDS 117,A01,494379,Staff,0,6,34,35
1715653248112,EDS 125,A00,507246,Hopkins; Megan Beth,7,0,30,23
1715653249137,EDS 128A,A01,507264,Fargason; Sharon Gayle,5,0,26,21
1715653250165,EDS 128B,A01,507293,Pappas; Elizabeth,9,0,30,21
1715653251193,EDS 139,A00,507294,Fargason; Sharon Gayle,9,0,30,21
1715653251193,EDS 139,B00,507313,Pappas; Elizabeth,9,0,30,21
1715653252218,EDS 201,A00,507315,Staff,10,0,30,20
1715653253243,EDS 203,A01,507317,Halter; Christopher P.,10,0,30,20
1715653254269,EDS 204R,A01,507319,Halter; Christopher P.,0,3,30,30
1715653254269,EDS 204R,B01,507331,Heinzman; Erica M.,14,0,30,16
1715653255296,EDS 206R,A00,507332,Staff,0,4,30,30
1715653255296,EDS 206R,B00,507343,Staff,15,0,30,15
1715653256322,EDS 250,A00,507344,Hemans; Patricia Ann Benitez,20,0,40,20
1715653257351,EDS 281,A00,507345,Daly; Alan J.,18,0,18,0
1715653258376,EDS 284,A00,507350,Daly; Alan J.,16,0,16,0
1715653259405,EDS 286,A00,507359,Fine; Sarah,18,0,18,0
1715653260430,EDS 289C,A01,507361,Daly; Alan J.,18,0,18,0
1715653261455,EDS 290,A00,507366,Hofstetter; Carolyn,15,0,15,0
1715653262481,LIGM 5A,A00,507421,Fischer-Grunski; Eva K,17,0,20,3
1715653263513,LIGM 5B,A00,507423,Fischer-Grunski; Eva K,19,0,20,1
1715653264541,LIGM 5C,A00,507425,Fischer-Grunski; Eva K,19,0,20,1
1715653265566,LIIT 5AS,A00,507427,Carnelos; Chiara,20,0,20,0
1715653266595,LIIT 5BS,A00,507430,Carnelos; Chiara,20,0,20,0
1715653267625,LIIT 5CS,A00,507432,Carnelos; Chiara,20,0,20,0
1715653268656,LISP 5A,A00,507541,Munoz Sanchez; Alicia,11,0,20,9
1715653269685,LISP 5B,A00,507671,Munoz Sanchez; Alicia,8,0,20,12
1715653270714,LISP 5C,A00,507696,Munoz Sanchez; Alicia,8,0,20,12
1715653271740,MAE 197,001,528363,Boechler; Nicholas Sebastia,9998,0,9999,1
1715653272766,MATH 197,001,523477,Kedlaya; Kiran S.,9994,0,9999,5
1715653272766,MATH 197,002,563811,Zhang; Danna,9994,0,9999,5
1715653272766,MATH 197,003,628552,Dumitriu; Ioana,9998,0,9999,1
1715653272766,MATH 197,004,660885,Floyd; Eric,9998,0,9999,1
1715653273794,MCWP 40R,A00,518780,Staff,1,0,20,19
1715653273794,MCWP 40R,B00,518781,Carter; Jennifer A,9,0,20,11
1715653273794,MCWP 40R,C00,518783,Smith; Haydee Marie,5,0,20,15
1715653274821,MCWP 50R,A00,518791,Redela; Pamela Morgan,0,1,20,20
1715653274821,MCWP 50R,B00,518792,Krone; Jarret,0,2,20,20
1715653274821,MCWP 50R,C00,518793,Staff,0,4,20,20
1715653274821,MCWP 50R,D00,518794,Morshed; Michael James,0,2,20,20
1715653274821,MCWP 50R,E00,518795,Carter; Andrea L,0,2,20,20
1715653274821,MCWP 50R,F00,518796,Miller; Elizabeth Deen,0,1,20,20
1715653274821,MCWP 50R,G00,518797,Guillen; Melinda,0,1,20,20
1715653275846,MMW 12R,A01,514034,Herbst; Matthew,0,2,16,16
1715653275846,MMW 12R,A02,514035,Herbst; Matthew,0,0,16,16
1715653276870,MMW 13R,A01,514037,Staff,0,5,16,16
1715653276870,MMW 13R,A02,514039,Staff,0,5,16,16
1715653276870,MMW 13R,A03,628519,Staff,0,4,16,16
1715653278992,SIO 295LS,A00,523233,Staff,10,0,30,20
1715653280018,SIO 295S,A00,523232,Staff,10,0,30,20
1715653281047,SIOC 290S,A01,637330,Merrifield; Mark A,21,0,30,9
1715653282079,SIOC 291S,A01,637333,Gabriel; Corey John,21,0,30,9
1715653283109,SOCI 117,A01,494376,Staff,0,5,5,5
1715653284134,WES 237B,A00,494380,Staff,10,0,20,10
1715653286217,AESE 279B,A00,494370,Wade; Jon P,0,0,33,33
1715653287242,AIP 97,001,660915,Van Den Einde; Yael Dahlia,9998,0,9999,1
1715653288277,AIP 197,001,627712,Vespa; Emanuel Ignacio,9995,0,9999,4
1715653288277,AIP 197,002,650778,Amir; On,9998,0,9999,1
1715653288277,AIP 197,003,650933,Avenancio-Leon; Carlos,9998,0,9999,1
1715653288277,AIP 197,004,658530,Heyman; Gail D.,9998,0,9999,1
1715653288277,AIP 197,005,658631,Neal; Sonya E,9998,0,9999,1
1715653288277,AIP 197,006,658671,Du; Songzi,9998,0,9999,1
1715653289302,ANAR 135S,A00,494369,Braswell; Geoffrey E.,0,0,0,0
1715653290332,BENG 196,001,628496,Engler; Adam J.,9998,0,9999,1
1715653290332,BENG 196,002,660916,Watson; John Thomas,9998,0,9999,1
1715653291359,BISP 197,001,650773,Wilhelm; James E.,9994,0,9999,5
1715653291359,BISP 197,002,658904,Coleman; Aaron B.,9998,0,9999,1
1715653292389,CAT 124RS,A01,519847,Geibel; William,0,0,20,20
1715653293419,CAT 125RS,A01,515971,Geibel; William,0,0,20,20
1715653294445,CLRE 250,A00,511389,Morris; Sheldon,9992,0,9999,7
1715653295472,CLRE 251,A00,507176,Mehta; Ravindra L.,9992,0,9999,7
1715653295472,CLRE 251,B00,511410,Mehta; Ravindra L.,9998,0,9999,1
1715653296498,CLRE 252,A00,507189,Cuomo; Raphael Eduardo,9994,0,9999,5
1715653297524,CLRE 253,A00,507199,Vaida; Florin,9994,0,9999,5
1715653297524,CLRE 253,B00,507202,Vaida; Florin,9999,0,9999,0
1715653298549,CLRE 259,A00,507211,Patel; Hemal,9996,0,9999,3
1715653299576,CLRE 260,A00,507221,Cuomo; Raphael Eduardo,9999,0,9999,0
1715653300602,CLRE 297,001,507242,Cuomo; Raphael Eduardo,9999,0,9999,0
1715653301626,COGS 197,001,638244,Voytek; Bradley Thomas,9997,0,9999,2
1715653302653,CSE 191,A00,516875,Minnes Kemp; Mor Mia,9991,0,9999,8
1715653303678,CSE 197,001,637388,Minnes Kemp; Mor Mia,9992,0,9999,7
1715653304708,CSS 201S,A01,494383,Mignozzetti; Umberto,35,0,35,0
1715653305733,CSS 202S,A01,494387,Mignozzetti; Umberto,35,0,35,0
1715653306759,DSC 197,001,628532,Eldridge; Justin Matthew,9995,0,9999,4
1715653307783,EAP 100,A00,516065,Staff,9799,0,9999,200
1715653308817,ECE 45,A01,507414,Staff,32,0,60,28
1715653310868,ECE 111,A01,507420,Staff,11,0,50,39
1715653311894,ECE 197,001,548057,Sievenpiper; Daniel F.,9991,0,9999,8
1715653312924,EDS 115,A00,507243,Choi; Bailey Miyeon,6,0,28,22
1715653313949,EDS 117,A01,494379,Staff,0,6,34,35
1715653314977,EDS 125,A00,507246,Hopkins; Megan Beth,7,0,30,23
1715653316006,EDS 128A,A01,507264,Fargason; Sharon Gayle,5,0,26,21
1715653317035,EDS 128B,A01,507293,Pappas; Elizabeth,9,0,30,21
1715653318059,EDS 139,A00,507294,Fargason; Sharon Gayle,9,0,30,21
1715653318059,EDS 139,B00,507313,Pappas; Elizabeth,9,0,30,21
1715653319085,EDS 201,A00,507315,Staff,10,0,30,20
1715653320115,EDS 203,A01,507317,Halter; Christopher P.,10,0,30,20
1715653321141,EDS 204R,A01,507319,Halter; Christopher P.,0,3,30,30
1715653321141,EDS 204R,B01,507331,Heinzman; Erica M.,14,0,30,16
1715653322168,EDS 206R,A00,507332,Staff,0,4,30,30
1715653322168,EDS 206R,B00,507343,Staff,15,0,30,15
1715653323194,EDS 250,A00,507344,Hemans; Patricia Ann Benitez,20,0,40,20
1715653324220,EDS 281,A00,507345,Daly; Alan J.,18,0,18,0
1715653325253,EDS 284,A00,507350,Daly; Alan J.,16,0,16,0
1715653326278,EDS 286,A00,507359,Fine; Sarah,18,0,18,0
1715653327303,EDS 289C,A01,507361,Daly; Alan J.,18,0,18,0
1715653328330,EDS 290,A00,507366,Hofstetter; Carolyn,15,0,15,0
1715653329361,LIGM 5A,A00,507421,Fischer-Grunski; Eva K,17,0,20,3
1715653330386,LIGM 5B,A00,507423,Fischer-Grunski; Eva K,19,0,20,1
1715653331412,LIGM 5C,A00,507425,Fischer-Grunski; Eva K,19,0,20,1
1715653332439,LIIT 5AS,A00,507427,Carnelos; Chiara,20,0,20,0
1715653333468,LIIT 5BS,A00,507430,Carnelos; Chiara,20,0,20,0
1715653334492,LIIT 5CS,A00,507432,Carnelos; Chiara,20,0,20,0
1715653335522,LISP 5A,A00,507541,Munoz Sanchez; Alicia,11,0,20,9
1715653336550,LISP 5B,A00,507671,Munoz Sanchez; Alicia,8,0,20,12
1715653337575,LISP 5C,A00,507696,Munoz Sanchez; Alicia,8,0,20,12
1715653338601,MAE 197,001,528363,Boechler; Nicholas Sebastia,9998,0,9999,1
1715653339630,MATH 197,001,523477,Kedlaya; Kiran S.,9994,0,9999,5
1715653339630,MATH 197,002,563811,Zhang; Danna,9994,0,9999,5
1715653339630,MATH 197,003,628552,Dumitriu; Ioana,9998,0,9999,1
1715653339630,MATH 197,004,660885,Floyd; Eric,9998,0,9999,1
1715653340658,MCWP 40R,A00,518780,Staff,1,0,20,19
1715653340658,MCWP 40R,B00,518781,Carter; Jennifer A,9,0,20,11
1715653340658,MCWP 40R,C00,518783,Smith; Haydee Marie,5,0,20,15
1715653341687,MCWP 50R,A00,518791,Redela; Pamela Morgan,0,1,20,20
1715653341687,MCWP 50R,B00,518792,Krone; Jarret,0,2,20,20
1715653341687,MCWP 50R,C00,518793,Staff,0,4,20,20
1715653341687,MCWP 50R,D00,518794,Morshed; Michael James,0,2,20,20
1715653341687,MCWP 50R,E00,518795,Carter; Andrea L,0,2,20,20
1715653341687,MCWP 50R,F00,518796,Miller; Elizabeth Deen,0,1,20,20
1715653341687,MCWP 50R,G00,518797,Guillen; Melinda,0,1,20,20
1715653342712,MMW 12R,A01,514034,Herbst; Matthew,0,2,16,16
1715653342712,MMW 12R,A02,514035,Herbst; Matthew,0,0,16,16
1715653343739,MMW 13R,A01,514037,Staff,0,5,16,16
1715653343739,MMW 13R,A02,514039,Staff,0,5,16,16
1715653343739,MMW 13R,A03,628519,Staff,0,4,16,16
1715653345789,SIO 295LS,A00,523233,Staff,10,0,30,20
1715653346817,SIO 295S,A00,523232,Staff,10,0,30,20
1715653347846,SIOC 290S,A01,637330,Merrifield; Mark A,21,0,30,9
1715653348871,SIOC 291S,A01,637333,Gabriel; Corey John,21,0,30,9
1715653349898,SOCI 117,A01,494376,Staff,0,5,5,5
1715653350929,WES 237B,A00,494380,Staff,10,0,20,10
1715653353003,AESE 279B,A00,494370,Wade; Jon P,0,0,33,33
1715653354028,AIP 97,001,660915,Van Den Einde; Yael Dahlia,9998,0,9999,1
1715653355057,AIP 197,001,627712,Vespa; Emanuel Ignacio,9995,0,9999,4
1715653355057,AIP 197,002,650778,Amir; On,9998,0,9999,1
1715653355057,AIP 197,003,650933,Avenancio-Leon; Carlos,9998,0,9999,1
1715653355057,AIP 197,004,658530,Heyman; Gail D.,9998,0,9999,1
1715653355057,AIP 197,005,658631,Neal; Sonya E,9998,0,9999,1
1715653355057,AIP 197,006,658671,Du; Songzi,9998,0,9999,1
1715653356081,ANAR 135S,A00,494369,Braswell; Geoffrey E.,0,0,0,0
1715653357106,BENG 196,001,628496,Engler; Adam J.,9998,0,9999,1
1715653357106,BENG 196,002,660916,Watson; John Thomas,9998,0,9999,1
1715653358133,BISP 197,001,650773,Wilhelm; James E.,9994,0,9999,5
1715653358133,BISP 197,002,658904,Coleman; Aaron B.,9998,0,9999,1
1715653359161,CAT 124RS,A01,519847,Geibel; William,0,0,20,20
1715653360202,CAT 125RS,A01,515971,Geibel; William,0,0,20,20
1715653361230,CLRE 250,A00,511389,Morris; Sheldon,9992,0,9999,7
1715653362259,CLRE 251,A00,507176,Mehta; Ravindra L.,9992,0,9999,7
1715653362259,CLRE 251,B00,511410,Mehta; Ravindra L.,9998,0,9999,1
1715653363284,CLRE 252,A00,507189,Cuomo; Raphael Eduardo,9994,0,9999,5
1715653364311,CLRE 253,A00,507199,Vaida; Florin,9994,0,9999,5
1715653364311,CLRE 253,B00,507202,Vaida; Florin,9999,0,9999,0
1715653365340,CLRE 259,A00,507211,Patel; Hemal,9996,0,9999,3
1715653366365,CLRE 260,A00,507221,Cuomo; Raphael Eduardo,9999,0,9999,0
1715653367390,CLRE 297,001,507242,Cuomo; Raphael Eduardo,9999,0,9999,0
1715653368415,COGS 197,001,638244,Voytek; Bradley Thomas,9997,0,9999,2
1715653369443,CSE 191,A00,516875,Minnes Kemp; Mor Mia,9991,0,9999,8
1715653370469,CSE 197,001,637388,Minnes Kemp; Mor Mia,9992,0,9999,7
1715653371495,CSS 201S,A01,494383,Mignozzetti; Umberto,35,0,35,0
1715653372521,CSS 202S,A01,494387,Mignozzetti; Umberto,35,0,35,0
1715653373548,DSC 197,001,628532,Eldridge; Justin Matthew,9995,0,9999,4
1715653374574,EAP 100,A00,516065,Staff,9799,0,9999,200
1715653375608,ECE 45,A01,507414,Staff,32,0,60,28
1715653377658,ECE 111,A01,507420,Staff,11,0,50,39
1715653378685,ECE 197,001,548057,Sievenpiper; Daniel F.,9991,0,9999,8
1715653379711,EDS 115,A00,507243,Choi; Bailey Miyeon,6,0,28,22
1715653380740,EDS 117,A01,494379,Staff,0,6,34,35
1715653381765,EDS 125,A00,507246,Hopkins; Megan Beth,7,0,30,23
1715653382790,EDS 128A,A01,507264,Fargason; Sharon Gayle,5,0,26,21
1715653383814,EDS 128B,A01,507293,Pappas; Elizabeth,9,0,30,21
1715653384842,EDS 139,A00,507294,Fargason; Sharon Gayle,9,0,30,21
1715653384842,EDS 139,B00,507313,Pappas; Elizabeth,9,0,30,21
1715653385871,EDS 201,A00,507315,Staff,10,0,30,20
1715653386895,EDS 203,A01,507317,Halter; Christopher P.,10,0,30,20
1715653387918,EDS 204R,A01,507319,Halter; Christopher P.,0,3,30,30
1715653387918,EDS 204R,B01,507331,Heinzman; Erica M.,14,0,30,16
1715653388945,EDS 206R,A00,507332,Staff,0,4,30,30
1715653388945,EDS 206R,B00,507343,Staff,15,0,30,15
1715653389970,EDS 250,A00,507344,Hemans; Patricia Ann Benitez,20,0,40,20
1715653390995,EDS 281,A00,507345,Daly; Alan J.,18,0,18,0
1715653392019,EDS 284,A00,507350,Daly; Alan J.,16,0,16,0
1715653393046,EDS 286,A00,507359,Fine; Sarah,18,0,18,0
1715653394074,EDS 289C,A01,507361,Daly; Alan J.,18,0,18,0
1715653395100,EDS 290,A00,507366,Hofstetter; Carolyn,15,0,15,0
1715653396127,LIGM 5A,A00,507421,Fischer-Grunski; Eva K,17,0,20,3
1715653397153,LIGM 5B,A00,507423,Fischer-Grunski; Eva K,19,0,20,1
1715653398177,LIGM 5C,A00,507425,Fischer-Grunski; Eva K,19,0,20,1
1715653399201,LIIT 5AS,A00,507427,Carnelos; Chiara,20,0,20,0
1715653400227,LIIT 5BS,A00,507430,Carnelos; Chiara,20,0,20,0
1715653401252,LIIT 5CS,A00,507432,Carnelos; Chiara,20,0,20,0
1715653402278,LISP 5A,A00,507541,Munoz Sanchez; Alicia,11,0,20,9
1715653403304,LISP 5B,A00,507671,Munoz Sanchez; Alicia,8,0,20,12
1715653404334,LISP 5C,A00,507696,Munoz Sanchez; Alicia,8,0,20,12
1715653405361,MAE 197,001,528363,Boechler; Nicholas Sebastia,9998,0,9999,1
1715653406388,MATH 197,001,523477,Kedlaya; Kiran S.,9994,0,9999,5
1715653406388,MATH 197,002,563811,Zhang; Danna,9994,0,9999,5
1715653406388,MATH 197,003,628552,Dumitriu; Ioana,9998,0,9999,1
1715653406388,MATH 197,004,660885,Floyd; Eric,9998,0,9999,1
1715653407419,MCWP 40R,A00,518780,Staff,1,0,20,19
1715653407419,MCWP 40R,B00,518781,Carter; Jennifer A,9,0,20,11
1715653407419,MCWP 40R,C00,518783,Smith; Haydee Marie,5,0,20,15
1715653408449,MCWP 50R,A00,518791,Redela; Pamela Morgan,0,1,20,20
1715653408449,MCWP 50R,B00,518792,Krone; Jarret,0,2,20,20
1715653408449,MCWP 50R,C00,518793,Staff,0,4,20,20
1715653408449,MCWP 50R,D00,518794,Morshed; Michael James,0,2,20,20
1715653408449,MCWP 50R,E00,518795,Carter; Andrea L,0,2,20,20
1715653408449,MCWP 50R,F00,518796,Miller; Elizabeth Deen,0,1,20,20
1715653408449,MCWP 50R,G00,518797,Guillen; Melinda,0,1,20,20
1715653409475,MMW 12R,A01,514034,Herbst; Matthew,0,2,16,16
1715653409475,MMW 12R,A02,514035,Herbst; Matthew,0,0,16,16
1715653410502,MMW 13R,A01,514037,Staff,0,5,16,16
1715653410502,MMW 13R,A02,514039,Staff,0,5,16,16
1715653410502,MMW 13R,A03,628519,Staff,0,4,16,16
1715653412554,SIO 295LS,A00,523233,Staff,10,0,30,20
1715653413582,SIO 295S,A00,523232,Staff,10,0,30,20
1715653414611,SIOC 290S,A01,637330,Merrifield; Mark A,21,0,30,9
1715653415641,SIOC 291S,A01,637333,Gabriel; Corey John,21,0,30,9
1715653416667,SOCI 117,A01,494376,Staff,0,5,5,5
1715653417693,WES 237B,A00,494380,Staff,10,0,20,10
1715653419765,AESE 279B,A00,494370,Wade; Jon P,0,0,33,33
1715653420790,AIP 97,001,660915,Van Den Einde; Yael Dahlia,9998,0,9999,1
1715653421819,AIP 197,001,627712,Vespa; Emanuel Ignacio,9995,0,9999,4
1715653421819,AIP 197,002,650778,Amir; On,9998,0,9999,1
1715653421819,AIP 197,003,650933,Avenancio-Leon; Carlos,9998,0,9999,1
1715653421819,AIP 197,004,658530,Heyman; Gail D.,9998,0,9999,1
1715653421819,AIP 197,005,658631,Neal; Sonya E,9998,0,9999,1
1715653421819,AIP 197,006,658671,Du; Songzi,9998,0,9999,1
1715653422845,ANAR 135S,A00,494369,Braswell; Geoffrey E.,0,0,0,0
1715653423881,BENG 196,001,628496,Engler; Adam J.,9998,0,9999,1
1715653423881,BENG 196,002,660916,Watson; John Thomas,9998,0,9999,1
1715653424908,BISP 197,001,650773,Wilhelm; James E.,9994,0,9999,5
1715653424908,BISP 197,002,658904,Coleman; Aaron B.,9998,0,9999,1
1715653425936,CAT 124RS,A01,519847,Geibel; William,0,0,20,20
1715653426961,CAT 125RS,A01,515971,Geibel; William,0,0,20,20
1715653427989,CLRE 250,A00,511389,Morris; Sheldon,9992,0,9999,7
1715653429018,CLRE 251,A00,507176,Mehta; Ravindra L.,9992,0,9999,7
1715653429018,CLRE 251,B00,511410,Mehta; Ravindra L.,9998,0,9999,1
1715653430045,CLRE 252,A00,507189,Cuomo; Raphael Eduardo,9994,0,9999,5
1715653431070,CLRE 253,A00,507199,Vaida; Florin,9994,0,9999,5
1715653431070,CLRE 253,B00,507202,Vaida; Florin,9999,0,9999,0
1715653432096,CLRE 259,A00,507211,Patel; Hemal,9996,0,9999,3
1715653433121,CLRE 260,A00,507221,Cuomo; Raphael Eduardo,9999,0,9999,0
1715653434148,CLRE 297,001,507242,Cuomo; Raphael Eduardo,9999,0,9999,0
1715653435178,COGS 197,001,638244,Voytek; Bradley Thomas,9997,0,9999,2
1715653436207,CSE 191,A00,516875,Minnes Kemp; Mor Mia,9991,0,9999,8
1715653437231,CSE 197,001,637388,Minnes Kemp; Mor Mia,9992,0,9999,7
1715653438265,CSS 201S,A01,494383,Mignozzetti; Umberto,35,0,35,0
1715653439290,CSS 202S,A01,494387,Mignozzetti; Umberto,35,0,35,0
1715653440315,DSC 197,001,628532,Eldridge; Justin Matthew,9995,0,9999,4
1715653441351,EAP 100,A00,516065,Staff,9799,0,9999,200
1715653442385,ECE 45,A01,507414,Staff,32,0,60,28
1715653444443,ECE 111,A01,507420,Staff,11,0,50,39
1715653445468,ECE 197,001,548057,Sievenpiper; Daniel F.,9991,0,9999,8
1715653446499,EDS 115,A00,507243,Choi; Bailey Miyeon,6,0,28,22
1715653447525,EDS 117,A01,494379,Staff,0,6,34,35
1715653448555,EDS 125,A00,507246,Hopkins; Megan Beth,7,0,30,23
1715653449580,EDS 128A,A01,507264,Fargason; Sharon Gayle,5,0,26,21
1715653450611,EDS 128B,A01,507293,Pappas; Elizabeth,9,0,30,21
1715653451637,EDS 139,A00,507294,Fargason; Sharon Gayle,9,0,30,21
1715653451637,EDS 139,B00,507313,Pappas; Elizabeth,9,0,30,21
1715653452664,EDS 201,A00,507315,Staff,10,0,30,20
1715653453694,EDS 203,A01,507317,Halter; Christopher P.,10,0,30,20
1715653454720,EDS 204R,A01,507319,Halter; Christopher P.,0,3,30,30
1715653454720,EDS 204R,B01,507331,Heinzman; Erica M.,14,0,30,16
1715653455748,EDS 206R,A00,507332,Staff,0,4,30,30
1715653455748,EDS 206R,B00,507343,Staff,15,0,30,15
1715653456778,EDS 250,A00,507344,Hemans; Patricia Ann Benitez,20,0,40,20
1715653457807,EDS 281,A00,507345,Daly; Alan J.,18,0,18,0
1715653458834,EDS 284,A00,507350,Daly; Alan J.,16,0,16,0
1715653459859,EDS 286,A00,507359,Fine; Sarah,18,0,18,0
1715653460887,EDS 289C,A01,507361,Daly; Alan J.,18,0,18,0
1715653461927,EDS 290,A00,507366,Hofstetter; Carolyn,15,0,15,0
1715653462953,LIGM 5A,A00,507421,Fischer-Grunski; Eva K,17,0,20,3
1715653463981,LIGM 5B,A00,507423,Fischer-Grunski; Eva K,19,0,20,1
1715653465007,LIGM 5C,A00,507425,Fischer-Grunski; Eva K,19,0,20,1
1715653466031,LIIT 5AS,A00,507427,Carnelos; Chiara,20,0,20,0
1715653467059,LIIT 5BS,A00,507430,Carnelos; Chiara,20,0,20,0
1715653468086,LIIT 5CS,A00,507432,Carnelos; Chiara,20,0,20,0
1715653469113,LISP 5A,A00,507541,Munoz Sanchez; Alicia,11,0,20,9
1715653470141,LISP 5B,A00,507671,Munoz Sanchez; Alicia,8,0,20,12
1715653471169,LISP 5C,A00,507696,Munoz Sanchez; Alicia,8,0,20,12
1715653472194,MAE 197,001,528363,Boechler; Nicholas Sebastia,9998,0,9999,1
1715653473223,MATH 197,001,523477,Kedlaya; Kiran S.,9994,0,9999,5
1715653473223,MATH 197,002,563811,Zhang; Danna,9994,0,9999,5
1715653473223,MATH 197,003,628552,Dumitriu; Ioana,9998,0,9999,1
1715653473223,MATH 197,004,660885,Floyd; Eric,9998,0,9999,1
1715653474253,MCWP 40R,A00,518780,Staff,1,0,20,19
1715653474253,MCWP 40R,B00,518781,Carter; Jennifer A,9,0,20,11
1715653474253,MCWP 40R,C00,518783,Smith; Haydee Marie,5,0,20,15
1715653475281,MCWP 50R,A00,518791,Redela; Pamela Morgan,0,1,20,20
1715653475281,MCWP 50R,B00,518792,Krone; Jarret,0,2,20,20
1715653475281,MCWP 50R,C00,518793,Staff,0,4,20,20
1715653475281,MCWP 50R,D00,518794,Morshed; Michael James,0,2,20,20
1715653475281,MCWP 50R,E00,518795,Carter; Andrea L,0,2,20,20
1715653475281,MCWP 50R,F00,518796,Miller; Elizabeth Deen,0,1,20,20
1715653475281,MCWP 50R,G00,518797,Guillen; Melinda,0,1,20,20
1715653476310,MMW 12R,A01,514034,Herbst; Matthew,0,2,16,16
1715653476310,MMW 12R,A02,514035,Herbst; Matthew,0,0,16,16
1715653477333,MMW 13R,A01,514037,Staff,0,5,16,16
1715653477333,MMW 13R,A02,514039,Staff,0,5,16,16
1715653477333,MMW 13R,A03,628519,Staff,0,4,16,16
1715653479384,SIO 295LS,A00,523233,Staff,10,0,30,20
1715653480408,SIO 295S,A00,523232,Staff,10,0,30,20
1715653481436,SIOC 290S,A01,637330,Merrifield; Mark A,21,0,30,9
1715653482464,SIOC 291S,A01,637333,Gabriel; Corey John,21,0,30,9
1715653483489,SOCI 117,A01,494376,Staff,0,5,5,5
1715653484517,WES 237B,A00,494380,Staff,10,0,20,10
1715653486585,AESE 279B,A00,494370,Wade; Jon P,0,0,33,33
1715653487610,AIP 97,001,660915,Van Den Einde; Yael Dahlia,9998,0,9999,1
1715653488638,AIP 197,001,627712,Vespa; Emanuel Ignacio,9995,0,9999,4
1715653488638,AIP 197,002,650778,Amir; On,9998,0,9999,1
1715653488638,AIP 197,003,650933,Avenancio-Leon; Carlos,9998,0,9999,1
1715653488638,AIP 197,004,658530,Heyman; Gail D.,9998,0,9999,1
1715653488638,AIP 197,005,658631,Neal; Sonya E,9998,0,9999,1
1715653488638,AIP 197,006,658671,Du; Songzi,9998,0,9999,1
1715653489663,ANAR 135S,A00,494369,Braswell; Geoffrey E.,0,0,0,0
1715653490690,BENG 196,001,628496,Engler; Adam J.,9998,0,9999,1
1715653490690,BENG 196,002,660916,Watson; John Thomas,9998,0,9999,1
1715653491720,BISP 197,001,650773,Wilhelm; James E.,9994,0,9999,5
1715653491720,BISP 197,002,658904,Coleman; Aaron B.,9998,0,9999,1
1715653492749,CAT 124RS,A01,519847,Geibel; William,0,0,20,20
1715653493774,CAT 125RS,A01,515971,Geibel; William,0,0,20,20
1715653494801,CLRE 250,A00,511389,Morris; Sheldon,9992,0,9999,7
1715653495828,CLRE 251,A00,507176,Mehta; Ravindra L.,9992,0,9999,7
1715653495828,CLRE 251,B00,511410,Mehta; Ravindra L.,9998,0,9999,1
1715653496854,CLRE 252,A00,507189,Cuomo; Raphael Eduardo,9994,0,9999,5
1715653497881,CLRE 253,A00,507199,Vaida; Florin,9994,0,9999,5
1715653497881,CLRE 253,B00,507202,Vaida; Florin,9999,0,9999,0
1715653498906,CLRE 259,A00,507211,Patel; Hemal,9996,0,9999,3
1715653499933,CLRE 260,A00,507221,Cuomo; Raphael Eduardo,9999,0,9999,0
1715653500961,CLRE 297,001,507242,Cuomo; Raphael Eduardo,9999,0,9999,0
1715653501986,COGS 197,001,638244,Voytek; Bradley Thomas,9997,0,9999,2
1715653503015,CSE 191,A00,516875,Minnes Kemp; Mor Mia,9991,0,9999,8
1715653504043,CSE 197,001,637388,Minnes Kemp; Mor Mia,9992,0,9999,7
1715653505068,CSS 201S,A01,494383,Mignozzetti; Umberto,35,0,35,0
1715653506098,CSS 202S,A01,494387,Mignozzetti; Umberto,35,0,35,0
1715653507127,DSC 197,001,628532,Eldridge; Justin Matthew,9995,0,9999,4
1715653508154,EAP 100,A00,516065,Staff,9799,0,9999,200
1715653509181,ECE 45,A01,507414,Staff,32,0,60,28
1715653511234,ECE 111,A01,507420,Staff,11,0,50,39
1715653512258,ECE 197,001,548057,Sievenpiper; Daniel F.,9991,0,9999,8
1715653513289,EDS 115,A00,507243,Choi; Bailey Miyeon,6,0,28,22
1715653514317,EDS 117,A01,494379,Staff,0,6,34,35
1715653515345,EDS 125,A00,507246,Hopkins; Megan Beth,7,0,30,23
1715653516374,EDS 128A,A01,507264,Fargason; Sharon Gayle,5,0,26,21
1715653517401,EDS 128B,A01,507293,Pappas; Elizabeth,9,0,30,21
1715653518428,EDS 139,A00,507294,Fargason; Sharon Gayle,9,0,30,21
1715653518428,EDS 139,B00,507313,Pappas; Elizabeth,9,0,30,21
1715653519454,EDS 201,A00,507315,Staff,10,0,30,20
1715653520480,EDS 203,A01,507317,Halter; Christopher P.,10,0,30,20
1715653521505,EDS 204R,A01,507319,Halter; Christopher P.,0,3,30,30
1715653521505,EDS 204R,B01,507331,Heinzman; Erica M.,14,0,30,16
1715653522530,EDS 206R,A00,507332,Staff,0,4,30,30
1715653522530,EDS 206R,B00,507343,Staff,15,0,30,15
1715653523559,EDS 250,A00,507344,Hemans; Patricia Ann Benitez,20,0,40,20
1715653524587,EDS 281,A00,507345,Daly; Alan J.,18,0,18,0
1715653525611,EDS 284,A00,507350,Daly; Alan J.,16,0,16,0
1715653526637,EDS 286,A00,507359,Fine; Sarah,18,0,18,0
1715653527661,EDS 289C,A01,507361,Daly; Alan J.,18,0,18,0
1715653528687,EDS 290,A00,507366,Hofstetter; Carolyn,15,0,15,0
1715653529719,LIGM 5A,A00,507421,Fischer-Grunski; Eva K,17,0,20,3
1715653530745,LIGM 5B,A00,507423,Fischer-Grunski; Eva K,19,0,20,1
1715653531774,LIGM 5C,A00,507425,Fischer-Grunski; Eva K,19,0,20,1
1715653532800,LIIT 5AS,A00,507427,Carnelos; Chiara,20,0,20,0
1715653533825,LIIT 5BS,A00,507430,Carnelos; Chiara,20,0,20,0
1715653534850,LIIT 5CS,A00,507432,Carnelos; Chiara,20,0,20,0
1715653535877,LISP 5A,A00,507541,Munoz Sanchez; Alicia,11,0,20,9
1715653536907,LISP 5B,A00,507671,Munoz Sanchez; Alicia,8,0,20,12
1715653537931,LISP 5C,A00,507696,Munoz Sanchez; Alicia,8,0,20,12
1715653538958,MAE 197,001,528363,Boechler; Nicholas Sebastia,9998,0,9999,1
1715653539985,MATH 197,001,523477,Kedlaya; Kiran S.,9994,0,9999,5
1715653539985,MATH 197,002,563811,Zhang; Danna,9994,0,9999,5
1715653539985,MATH 197,003,628552,Dumitriu; Ioana,9998,0,9999,1
1715653539985,MATH 197,004,660885,Floyd; Eric,9998,0,9999,1
1715653541015,MCWP 40R,A00,518780,Staff,1,0,20,19
1715653541015,MCWP 40R,B00,518781,Carter; Jennifer A,9,0,20,11
1715653541015,MCWP 40R,C00,518783,Smith; Haydee Marie,5,0,20,15
1715653542046,MCWP 50R,A00,518791,Redela; Pamela Morgan,0,1,20,20
1715653542046,MCWP 50R,B00,518792,Krone; Jarret,0,2,20,20
1715653542046,MCWP 50R,C00,518793,Staff,0,4,20,20
1715653542046,MCWP 50R,D00,518794,Morshed; Michael James,0,2,20,20
1715653542046,MCWP 50R,E00,518795,Carter; Andrea L,0,2,20,20
1715653542046,MCWP 50R,F00,518796,Miller; Elizabeth Deen,0,1,20,20
1715653542046,MCWP 50R,G00,518797,Guillen; Melinda,0,1,20,20
1715653543071,MMW 12R,A01,514034,Herbst; Matthew,0,2,16,16
1715653543071,MMW 12R,A02,514035,Herbst; Matthew,0,0,16,16
1715653544096,MMW 13R,A01,514037,Staff,0,5,16,16
1715653544096,MMW 13R,A02,514039,Staff,0,5,16,16
1715653544096,MMW 13R,A03,628519,Staff,0,4,16,16
1715653546148,SIO 295LS,A00,523233,Staff,10,0,30,20
1715653547178,SIO 295S,A00,523232,Staff,10,0,30,20
1715653548207,SIOC 290S,A01,637330,Merrifield; Mark A,21,0,30,9
1715653549237,SIOC 291S,A01,637333,Gabriel; Corey John,21,0,30,9
1715653550265,SOCI 117,A01,494376,Staff,0,5,5,5
1715653551291,WES 237B,A00,494380,Staff,10,0,20,10
1715653553372,AESE 279B,A00,494370,Wade; Jon P,0,0,33,33
1715653554397,AIP 97,001,660915,Van Den Einde; Yael Dahlia,9998,0,9999,1
1715653555427,AIP 197,001,627712,Vespa; Emanuel Ignacio,9995,0,9999,4
1715653555427,AIP 197,002,650778,Amir; On,9998,0,9999,1
1715653555427,AIP 197,003,650933,Avenancio-Leon; Carlos,9998,0,9999,1
1715653555427,AIP 197,004,658530,Heyman; Gail D.,9998,0,9999,1
1715653555427,AIP 197,005,658631,Neal; Sonya E,9998,0,9999,1
1715653555427,AIP 197,006,658671,Du; Songzi,9998,0,9999,1
1715653556454,ANAR 135S,A00,494369,Braswell; Geoffrey E.,0,0,0,0
1715653557480,BENG 196,001,628496,Engler; Adam J.,9998,0,9999,1
1715653557480,BENG 196,002,660916,Watson; John Thomas,9998,0,9999,1
1715653558506,BISP 197,001,650773,Wilhelm; James E.,9994,0,9999,5
1715653558506,BISP 197,002,658904,Coleman; Aaron B.,9998,0,9999,1
1715653559535,CAT 124RS,A01,519847,Geibel; William,0,0,20,20
1715653560563,CAT 125RS,A01,515971,Geibel; William,0,0,20,20
1715653561589,CLRE 250,A00,511389,Morris; Sheldon,9992,0,9999,7
1715653562615,CLRE 251,A00,507176,Mehta; Ravindra L.,9992,0,9999,7
1715653562615,CLRE 251,B00,511410,Mehta; Ravindra L.,9998,0,9999,1
1715653563641,CLRE 252,A00,507189,Cuomo; Raphael Eduardo,9994,0,9999,5
1715653564667,CLRE 253,A00,507199,Vaida; Florin,9994,0,9999,5
1715653564667,CLRE 253,B00,507202,Vaida; Florin,9999,0,9999,0
1715653565693,CLRE 259,A00,507211,Patel; Hemal,9996,0,9999,3
1715653566721,CLRE 260,A00,507221,Cuomo; Raphael Eduardo,9999,0,9999,0
1715653567746,CLRE 297,001,507242,Cuomo; Raphael Eduardo,9999,0,9999,0
1715653568771,COGS 197,001,638244,Voytek; Bradley Thomas,9997,0,9999,2
1715653569799,CSE 191,A00,516875,Minnes Kemp; Mor Mia,9991,0,9999,8
1715653570825,CSE 197,001,637388,Minnes Kemp; Mor Mia,9992,0,9999,7
1715653571851,CSS 201S,A01,494383,Mignozzetti; Umberto,35,0,35,0
1715653572878,CSS 202S,A01,494387,Mignozzetti; Umberto,35,0,35,0
1715653573906,DSC 197,001,628532,Eldridge; Justin Matthew,9995,0,9999,4
1715653574934,EAP 100,A00,516065,Staff,9799,0,9999,200
1715653575959,ECE 45,A01,507414,Staff,32,0,60,28
1715653578016,ECE 111,A01,507420,Staff,11,0,50,39
1715653579045,ECE 197,001,548057,Sievenpiper; Daniel F.,9991,0,9999,8
1715653580075,EDS 115,A00,507243,Choi; Bailey Miyeon,6,0,28,22
1715653581100,EDS 117,A01,494379,Staff,0,6,34,35
1715653582127,EDS 125,A00,507246,Hopkins; Megan Beth,7,0,30,23
1715653583154,EDS 128A,A01,507264,Fargason; Sharon Gayle,5,0,26,21
1715653584179,EDS 128B,A01,507293,Pappas; Elizabeth,9,0,30,21
1715653585205,EDS 139,A00,507294,Fargason; Sharon Gayle,9,0,30,21
1715653585205,EDS 139,B00,507313,Pappas; Elizabeth,9,0,30,21
1715653586230,EDS 201,A00,507315,Staff,10,0,30,20
1715653587255,EDS 203,A01,507317,Halter; Christopher P.,10,0,30,20
1715653588280,EDS 204R,A01,507319,Halter; Christopher P.,0,3,30,30
1715653588280,EDS 204R,B01,507331,Heinzman; Erica M.,14,0,30,16
1715653589306,EDS 206R,A00,507332,Staff,0,4,30,30
1715653589306,EDS 206R,B00,507343,Staff,15,0,30,15
1715653590390,EDS 250,A00,507344,Hemans; Patricia Ann Benitez,20,0,40,20
1715653591418,EDS 281,A00,507345,Daly; Alan J.,18,0,18,0
1715653592443,EDS 284,A00,507350,Daly; Alan J.,16,0,16,0
1715653593476,EDS 286,A00,507359,Fine; Sarah,18,0,18,0
1715653594501,EDS 289C,A01,507361,Daly; Alan J.,18,0,18,0
1715653595529,EDS 290,A00,507366,Hofstetter; Carolyn,15,0,15,0
1715653596560,LIGM 5A,A00,507421,Fischer-Grunski; Eva K,17,0,20,3
1715653597586,LIGM 5B,A00,507423,Fischer-Grunski; Eva K,19,0,20,1
1715653598612,LIGM 5C,A00,507425,Fischer-Grunski; Eva K,19,0,20,1
1715653599641,LIIT 5AS,A00,507427,Carnelos; Chiara,20,0,20,0
1715653600667,LIIT 5BS,A00,507430,Carnelos; Chiara,20,0,20,0
1715653601695,LIIT 5CS,A00,507432,Carnelos; Chiara,20,0,20,0
1715653602719,LISP 5A,A00,507541,Munoz Sanchez; Alicia,11,0,20,9
1715653603744,LISP 5B,A00,507671,Munoz Sanchez; Alicia,8,0,20,12
1715653604769,LISP 5C,A00,507696,Munoz Sanchez; Alicia,8,0,20,12
1715653605797,MAE 197,001,528363,Boechler; Nicholas Sebastia,9998,0,9999,1
1715653606824,MATH 197,001,523477,Kedlaya; Kiran S.,9994,0,9999,5
1715653606824,MATH 197,002,563811,Zhang; Danna,9994,0,9999,5
1715653606824,MATH 197,003,628552,Dumitriu; Ioana,9998,0,9999,1
1715653606824,MATH 197,004,660885,Floyd; Eric,9998,0,9999,1
1715653607854,MCWP 40R,A00,518780,Staff,1,0,20,19
1715653607854,MCWP 40R,B00,518781,Carter; Jennifer A,9,0,20,11
1715653607854,MCWP 40R,C00,518783,Smith; Haydee Marie,5,0,20,15
1715653608883,MCWP 50R,A00,518791,Redela; Pamela Morgan,0,1,20,20
1715653608883,MCWP 50R,B00,518792,Krone; Jarret,0,2,20,20
1715653608883,MCWP 50R,C00,518793,Staff,0,4,20,20
1715653608883,MCWP 50R,D00,518794,Morshed; Michael James,0,2,20,20
1715653608883,MCWP 50R,E00,518795,Carter; Andrea L,0,2,20,20
1715653608883,MCWP 50R,F00,518796,Miller; Elizabeth Deen,0,1,20,20
1715653608883,MCWP 50R,G00,518797,Guillen; Melinda,0,1,20,20
1715653609910,MMW 12R,A01,514034,Herbst; Matthew,0,2,16,16
1715653609910,MMW 12R,A02,514035,Herbst; Matthew,0,0,16,16
1715653610934,MMW 13R,A01,514037,Staff,0,5,16,16
1715653610934,MMW 13R,A02,514039,Staff,0,5,16,16
1715653610934,MMW 13R,A03,628519,Staff,0,4,16,16
1715653612993,SIO 295LS,A00,523233,Staff,10,0,30,20
1715653614023,SIO 295S,A00,523232,Staff,10,0,30,20
1715653615049,SIOC 290S,A01,637330,Merrifield; Mark A,21,0,30,9
1715653616075,SIOC 291S,A01,637333,Gabriel; Corey John,21,0,30,9
1715653617105,SOCI 117,A01,494376,Staff,0,5,5,5
1715653618130,WES 237B,A00,494380,Staff,10,0,20,10
1715653620198,AESE 279B,A00,494370,Wade; Jon P,0,0,33,33
1715653621228,AIP 97,001,660915,Van Den Einde; Yael Dahlia,9998,0,9999,1
1715653622264,AIP 197,001,627712,Vespa; Emanuel Ignacio,9995,0,9999,4
1715653622264,AIP 197,002,650778,Amir; On,9998,0,9999,1
1715653622264,AIP 197,003,650933,Avenancio-Leon; Carlos,9998,0,9999,1
1715653622264,AIP 197,004,658530,Heyman; Gail D.,9998,0,9999,1
1715653622264,AIP 197,005,658631,Neal; Sonya E,9998,0,9999,1
1715653622264,AIP 197,006,658671,Du; Songzi,9998,0,9999,1
1715653623296,ANAR 135S,A00,494369,Braswell; Geoffrey E.,0,0,0,0
1715653624323,BENG 196,001,628496,Engler; Adam J.,9998,0,9999,1
1715653624323,BENG 196,002,660916,Watson; John Thomas,9998,0,9999,1
1715653625356,BISP 197,001,650773,Wilhelm; James E.,9994,0,9999,5
1715653625356,BISP 197,002,658904,Coleman; Aaron B.,9998,0,9999,1
1715653626382,CAT 124RS,A01,519847,Geibel; William,0,0,20,20
1715653627407,CAT 125RS,A01,515971,Geibel; William,0,0,20,20
1715653628437,CLRE 250,A00,511389,Morris; Sheldon,9992,0,9999,7
1715653629465,CLRE 251,A00,507176,Mehta; Ravindra L.,9992,0,9999,7
1715653629465,CLRE 251,B00,511410,Mehta; Ravindra L.,9998,0,9999,1
1715653630489,CLRE 252,A00,507189,Cuomo; Raphael Eduardo,9994,0,9999,5
1715653631515,CLRE 253,A00,507199,Vaida; Florin,9994,0,9999,5
1715653631515,CLRE 253,B00,507202,Vaida; Florin,9999,0,9999,0
1715653632546,CLRE 259,A00,507211,Patel; Hemal,9996,0,9999,3
1715653633573,CLRE 260,A00,507221,Cuomo; Raphael Eduardo,9999,0,9999,0
1715653634598,CLRE 297,001,507242,Cuomo; Raphael Eduardo,9999,0,9999,0
1715653635625,COGS 197,001,638244,Voytek; Bradley Thomas,9997,0,9999,2
1715653636652,CSE 191,A00,516875,Minnes Kemp; Mor Mia,9991,0,9999,8
1715653637677,CSE 197,001,637388,Minnes Kemp; Mor Mia,9992,0,9999,7
1715653638706,CSS 201S,A01,494383,Mignozzetti; Umberto,35,0,35,0
1715653639733,CSS 202S,A01,494387,Mignozzetti; Umberto,35,0,35,0
1715653640759,DSC 197,001,628532,Eldridge; Justin Matthew,9995,0,9999,4
1715653641785,EAP 100,A00,516065,Staff,9799,0,9999,200
1715653642814,ECE 45,A01,507414,Staff,32,0,60,28
1715653644868,ECE 111,A01,507420,Staff,11,0,50,39
1715653645894,ECE 197,001,548057,Sievenpiper; Daniel F.,9991,0,9999,8
1715653646924,EDS 115,A00,507243,Choi; Bailey Miyeon,6,0,28,22
1715653647952,EDS 117,A01,494379,Staff,0,6,34,35
1715653648983,EDS 125,A00,507246,Hopkins; Megan Beth,7,0,30,23
1715653650009,EDS 128A,A01,507264,Fargason; Sharon Gayle,5,0,26,21
1715653651040,EDS 128B,A01,507293,Pappas; Elizabeth,9,0,30,21
1715653652069,EDS 139,A00,507294,Fargason; Sharon Gayle,9,0,30,21
1715653652069,EDS 139,B00,507313,Pappas; Elizabeth,9,0,30,21
1715653653095,EDS 201,A00,507315,Staff,10,0,30,20
1715653654124,EDS 203,A01,507317,Halter; Christopher P.,10,0,30,20
1715653655150,EDS 204R,A01,507319,Halter; Christopher P.,0,3,30,30
1715653655150,EDS 204R,B01,507331,Heinzman; Erica M.,14,0,30,16
1715653656176,EDS 206R,A00,507332,Staff,0,4,30,30
1715653656176,EDS 206R,B00,507343,Staff,15,0,30,15
1715653657205,EDS 250,A00,507344,Hemans; Patricia Ann Benitez,20,0,40,20
1715653658230,EDS 281,A00,507345,Daly; Alan J.,18,0,18,0
1715653659258,EDS 284,A00,507350,Daly; Alan J.,16,0,16,0
1715653660290,EDS 286,A00,507359,Fine; Sarah,18,0,18,0
1715653661317,EDS 289C,A01,507361,Daly; Alan J.,18,0,18,0
1715653662348,EDS 290,A00,507366,Hofstetter; Carolyn,15,0,15,0
1715653663379,LIGM 5A,A00,507421,Fischer-Grunski; Eva K,17,0,20,3
1715653664405,LIGM 5B,A00,507423,Fischer-Grunski; Eva K,19,0,20,1
1715653665430,LIGM 5C,A00,507425,Fischer-Grunski; Eva K,19,0,20,1
1715653666531,LIIT 5AS,A00,507427,Carnelos; Chiara,20,0,20,0
1715653667558,LIIT 5BS,A00,507430,Carnelos; Chiara,20,0,20,0
1715653668585,LIIT 5CS,A00,507432,Carnelos; Chiara,20,0,20,0
1715653669612,LISP 5A,A00,507541,Munoz Sanchez; Alicia,11,0,20,9
1715653670637,LISP 5B,A00,507671,Munoz Sanchez; Alicia,8,0,20,12
1715653671664,LISP 5C,A00,507696,Munoz Sanchez; Alicia,8,0,20,12
1715653672690,MAE 197,001,528363,Boechler; Nicholas Sebastia,9998,0,9999,1
1715653673721,MATH 197,001,523477,Kedlaya; Kiran S.,9994,0,9999,5
1715653673721,MATH 197,002,563811,Zhang; Danna,9994,0,9999,5
1715653673721,MATH 197,003,628552,Dumitriu; Ioana,9998,0,9999,1
1715653673721,MATH 197,004,660885,Floyd; Eric,9998,0,9999,1
1715653674752,MCWP 40R,A00,518780,Staff,1,0,20,19
1715653674752,MCWP 40R,B00,518781,Carter; Jennifer A,9,0,20,11
1715653674752,MCWP 40R,C00,518783,Smith; Haydee Marie,5,0,20,15
1715653675779,MCWP 50R,A00,518791,Redela; Pamela Morgan,0,1,20,20
1715653675779,MCWP 50R,B00,518792,Krone; Jarret,0,2,20,20
1715653675779,MCWP 50R,C00,518793,Staff,0,4,20,20
1715653675779,MCWP 50R,D00,518794,Morshed; Michael James,0,2,20,20
1715653675779,MCWP 50R,E00,518795,Carter; Andrea L,0,2,20,20
1715653675779,MCWP 50R,F00,518796,Miller; Elizabeth Deen,0,1,20,20
1715653675779,MCWP 50R,G00,518797,Guillen; Melinda,0,1,20,20
1715653676808,MMW 12R,A01,514034,Herbst; Matthew,0,2,16,16
1715653676808,MMW 12R,A02,514035,Herbst; Matthew,0,0,16,16
1715653677836,MMW 13R,A01,514037,Staff,0,5,16,16
1715653677836,MMW 13R,A02,514039,Staff,0,5,16,16
1715653677836,MMW 13R,A03,628519,Staff,0,4,16,16
1715653679888,SIO 295LS,A00,523233,Staff,10,0,30,20
1715653680916,SIO 295S,A00,523232,Staff,10,0,30,20
1715653681941,SIOC 290S,A01,637330,Merrifield; Mark A,21,0,30,9
1715653682970,SIOC 291S,A01,637333,Gabriel; Corey John,21,0,30,9
1715653683998,SOCI 117,A01,494376,Staff,0,5,5,5
1715653685026,WES 237B,A00,494380,Staff,10,0,20,10
1715653687091,AESE 279B,A00,494370,Wade; Jon P,0,0,33,33
1715653688119,AIP 97,001,660915,Van Den Einde; Yael Dahlia,9998,0,9999,1
1715653689149,AIP 197,001,627712,Vespa; Emanuel Ignacio,9995,0,9999,4
1715653689149,AIP 197,002,650778,Amir; On,9998,0,9999,1
1715653689149,AIP 197,003,650933,Avenancio-Leon; Carlos,9998,0,9999,1
1715653689149,AIP 197,004,658530,Heyman; Gail D.,9998,0,9999,1
1715653689149,AIP 197,005,658631,Neal; Sonya E,9998,0,9999,1
1715653689149,AIP 197,006,658671,Du; Songzi,9998,0,9999,1
1715653690174,ANAR 135S,A00,494369,Braswell; Geoffrey E.,0,0,0,0
1715653691200,BENG 196,001,628496,Engler; Adam J.,9998,0,9999,1
1715653691200,BENG 196,002,660916,Watson; John Thomas,9998,0,9999,1
1715653692225,BISP 197,001,650773,Wilhelm; James E.,9994,0,9999,5
1715653692225,BISP 197,002,658904,Coleman; Aaron B.,9998,0,9999,1
1715653693253,CAT 124RS,A01,519847,Geibel; William,0,0,20,20
1715653694337,CAT 125RS,A01,515971,Geibel; William,0,0,20,20
1715653695362,CLRE 250,A00,511389,Morris; Sheldon,9992,0,9999,7
1715653696390,CLRE 251,A00,507176,Mehta; Ravindra L.,9992,0,9999,7
1715653696390,CLRE 251,B00,511410,Mehta; Ravindra L.,9998,0,9999,1
1715653697413,CLRE 252,A00,507189,Cuomo; Raphael Eduardo,9994,0,9999,5
1715653698438,CLRE 253,A00,507199,Vaida; Florin,9994,0,9999,5
1715653698438,CLRE 253,B00,507202,Vaida; Florin,9999,0,9999,0
1715653699468,CLRE 259,A00,507211,Patel; Hemal,9996,0,9999,3
1715653700493,CLRE 260,A00,507221,Cuomo; Raphael Eduardo,9999,0,9999,0
1715653701520,CLRE 297,001,507242,Cuomo; Raphael Eduardo,9999,0,9999,0
1715653702545,COGS 197,001,638244,Voytek; Bradley Thomas,9997,0,9999,2
1715653703568,CSE 191,A00,516875,Minnes Kemp; Mor Mia,9991,0,9999,8
1715653704593,CSE 197,001,637388,Minnes Kemp; Mor Mia,9992,0,9999,7
1715653705623,CSS 201S,A01,494383,Mignozzetti; Umberto,35,0,35,0
1715653706649,CSS 202S,A01,494387,Mignozzetti; Umberto,35,0,35,0
1715653707679,DSC 197,001,628532,Eldridge; Justin Matthew,9995,0,9999,4
1715653708706,EAP 100,A00,516065,Staff,9799,0,9999,200
1715653709737,ECE 45,A01,507414,Staff,32,0,60,28
1715653711791,ECE 111,A01,507420,Staff,11,0,50,39
1715653712818,ECE 197,001,548057,Sievenpiper; Daniel F.,9991,0,9999,8
1715653713844,EDS 115,A00,507243,Choi; Bailey Miyeon,6,0,28,22
1715653714869,EDS 117,A01,494379,Staff,0,6,34,35
1715653715894,EDS 125,A00,507246,Hopkins; Megan Beth,7,0,30,23
1715653716919,EDS 128A,A01,507264,Fargason; Sharon Gayle,5,0,26,21
1715653717943,EDS 128B,A01,507293,Pappas; Elizabeth,9,0,30,21
1715653718971,EDS 139,A00,507294,Fargason; Sharon Gayle,9,0,30,21
1715653718971,EDS 139,B00,507313,Pappas; Elizabeth,9,0,30,21
1715653719996,EDS 201,A00,507315,Staff,10,0,30,20
1715653721024,EDS 203,A01,507317,Halter; Christopher P.,10,0,30,20
1715653722053,EDS 204R,A01,507319,Halter; Christopher P.,0,3,30,30
1715653722053,EDS 204R,B01,507331,Heinzman; Erica M.,14,0,30,16
1715653723077,EDS 206R,A00,507332,Staff,0,4,30,30
1715653723077,EDS 206R,B00,507343,Staff,15,0,30,15
1715653724101,EDS 250,A00,507344,Hemans; Patricia Ann Benitez,20,0,40,20
1715653725126,EDS 281,A00,507345,Daly; Alan J.,18,0,18,0
1715653726150,EDS 284,A00,507350,Daly; Alan J.,16,0,16,0
1715653727176,EDS 286,A00,507359,Fine; Sarah,18,0,18,0
1715653728201,EDS 289C,A01,507361,Daly; Alan J.,18,0,18,0
1715653729230,EDS 290,A00,507366,Hofstetter; Carolyn,15,0,15,0
1715653730261,LIGM 5A,A00,507421,Fischer-Grunski; Eva K,17,0,20,3
1715653731286,LIGM 5B,A00,507423,Fischer-Grunski; Eva K,19,0,20,1
1715653732313,LIGM 5C,A00,507425,Fischer-Grunski; Eva K,19,0,20,1
1715653733343,LIIT 5AS,A00,507427,Carnelos; Chiara,20,0,20,0
1715653734375,LIIT 5BS,A00,507430,Carnelos; Chiara,20,0,20,0
1715653735401,LIIT 5CS,A00,507432,Carnelos; Chiara,20,0,20,0
1715653736427,LISP 5A,A00,507541,Munoz Sanchez; Alicia,11,0,20,9
1715653737453,LISP 5B,A00,507671,Munoz Sanchez; Alicia,8,0,20,12
1715653738480,LISP 5C,A00,507696,Munoz Sanchez; Alicia,8,0,20,12
1715653739505,MAE 197,001,528363,Boechler; Nicholas Sebastia,9998,0,9999,1
1715653740539,MATH 197,001,523477,Kedlaya; Kiran S.,9994,0,9999,5
1715653740539,MATH 197,002,563811,Zhang; Danna,9994,0,9999,5
1715653740539,MATH 197,003,628552,Dumitriu; Ioana,9998,0,9999,1
1715653740539,MATH 197,004,660885,Floyd; Eric,9998,0,9999,1
1715653741565,MCWP 40R,A00,518780,Staff,1,0,20,19
1715653741565,MCWP 40R,B00,518781,Carter; Jennifer A,9,0,20,11
1715653741565,MCWP 40R,C00,518783,Smith; Haydee Marie,5,0,20,15
1715653742593,MCWP 50R,A00,518791,Redela; Pamela Morgan,0,1,20,20
1715653742593,MCWP 50R,B00,518792,Krone; Jarret,0,2,20,20
1715653742593,MCWP 50R,C00,518793,Staff,0,4,20,20
1715653742593,MCWP 50R,D00,518794,Morshed; Michael James,0,2,20,20
1715653742593,MCWP 50R,E00,518795,Carter; Andrea L,0,2,20,20
1715653742593,MCWP 50R,F00,518796,Miller; Elizabeth Deen,0,1,20,20
1715653742593,MCWP 50R,G00,518797,Guillen; Melinda,0,1,20,20
1715653743619,MMW 12R,A01,514034,Herbst; Matthew,0,2,16,16
1715653743619,MMW 12R,A02,514035,Herbst; Matthew,0,0,16,16
1715653744647,MMW 13R,A01,514037,Staff,0,5,16,16
1715653744647,MMW 13R,A02,514039,Staff,0,5,16,16
1715653744647,MMW 13R,A03,628519,Staff,0,4,16,16
1715653746702,SIO 295LS,A00,523233,Staff,10,0,30,20
1715653747728,SIO 295S,A00,523232,Staff,10,0,30,20
1715653748758,SIOC 290S,A01,637330,Merrifield; Mark A,21,0,30,9
1715653749783,SIOC 291S,A01,637333,Gabriel; Corey John,21,0,30,9
1715653750809,SOCI 117,A01,494376,Staff,0,5,5,5
1715653751836,WES 237B,A00,494380,Staff,10,0,20,10
1715653753917,AESE 279B,A00,494370,Wade; Jon P,0,0,33,33
1715653754946,AIP 97,001,660915,Van Den Einde; Yael Dahlia,9998,0,9999,1
1715653755986,AIP 197,001,627712,Vespa; Emanuel Ignacio,9995,0,9999,4
1715653755986,AIP 197,002,650778,Amir; On,9998,0,9999,1
1715653755986,AIP 197,003,650933,Avenancio-Leon; Carlos,9998,0,9999,1
1715653755986,AIP 197,004,658530,Heyman; Gail D.,9998,0,9999,1
1715653755986,AIP 197,005,658631,Neal; Sonya E,9998,0,9999,1
1715653755986,AIP 197,006,658671,Du; Songzi,9998,0,9999,1
1715653757016,ANAR 135S,A00,494369,Braswell; Geoffrey E.,0,0,0,0
1715653758044,BENG 196,001,628496,Engler; Adam J.,9998,0,9999,1
1715653758044,BENG 196,002,660916,Watson; John Thomas,9998,0,9999,1
1715653759071,BISP 197,001,650773,Wilhelm; James E.,9994,0,9999,5
1715653759071,BISP 197,002,658904,Coleman; Aaron B.,9998,0,9999,1
1715653760097,CAT 124RS,A01,519847,Geibel; William,0,0,20,20
1715653761124,CAT 125RS,A01,515971,Geibel; William,0,0,20,20
1715653762153,CLRE 250,A00,511389,Morris; Sheldon,9992,0,9999,7
1715653763180,CLRE 251,A00,507176,Mehta; Ravindra L.,9992,0,9999,7
1715653763180,CLRE 251,B00,511410,Mehta; Ravindra L.,9998,0,9999,1
1715653764205,CLRE 252,A00,507189,Cuomo; Raphael Eduardo,9994,0,9999,5
1715653765238,CLRE 253,A00,507199,Vaida; Florin,9994,0,9999,5
1715653765238,CLRE 253,B00,507202,Vaida; Florin,9999,0,9999,0
1715653766263,CLRE 259,A00,507211,Patel; Hemal,9996,0,9999,3
1715653767288,CLRE 260,A00,507221,Cuomo; Raphael Eduardo,9999,0,9999,0
1715653768313,CLRE 297,001,507242,Cuomo; Raphael Eduardo,9999,0,9999,0
1715653769338,COGS 197,001,638244,Voytek; Bradley Thomas,9997,0,9999,2
1715653770365,CSE 191,A00,516875,Minnes Kemp; Mor Mia,9991,0,9999,8
1715653771389,CSE 197,001,637388,Minnes Kemp; Mor Mia,9992,0,9999,7
1715653772414,CSS 201S,A01,494383,Mignozzetti; Umberto,35,0,35,0
1715653773439,CSS 202S,A01,494387,Mignozzetti; Umberto,35,0,35,0
1715653774467,DSC 197,001,628532,Eldridge; Justin Matthew,9995,0,9999,4
1715653775491,EAP 100,A00,516065,Staff,9799,0,9999,200
1715653776527,ECE 45,A01,507414,Staff,32,0,60,28
1715653778586,ECE 111,A01,507420,Staff,11,0,50,39
1715653779612,ECE 197,001,548057,Sievenpiper; Daniel F.,9991,0,9999,8
1715653780640,EDS 115,A00,507243,Choi; Bailey Miyeon,6,0,28,22
1715653781672,EDS 117,A01,494379,Staff,0,6,34,35
1715653782699,EDS 125,A00,507246,Hopkins; Megan Beth,7,0,30,23
1715653783725,EDS 128A,A01,507264,Fargason; Sharon Gayle,5,0,26,21
1715653784752,EDS 128B,A01,507293,Pappas; Elizabeth,9,0,30,21
1715653785777,EDS 139,A00,507294,Fargason; Sharon Gayle,9,0,30,21
1715653785777,EDS 139,B00,507313,Pappas; Elizabeth,9,0,30,21
1715653786803,EDS 201,A00,507315,Staff,10,0,30,20
1715653787837,EDS 203,A01,507317,Halter; Christopher P.,10,0,30,20
1715653788865,EDS 204R,A01,507319,Halter; Christopher P.,0,3,30,30
1715653788865,EDS 204R,B01,507331,Heinzman; Erica M.,14,0,30,16
1715653789888,EDS 206R,A00,507332,Staff,0,4,30,30
1715653789888,EDS 206R,B00,507343,Staff,15,0,30,15
1715653790917,EDS 250,A00,507344,Hemans; Patricia Ann Benitez,20,0,40,20
1715653791941,EDS 281,A00,507345,Daly; Alan J.,18,0,18,0
1715653792968,EDS 284,A00,507350,Daly; Alan J.,16,0,16,0
1715653793992,EDS 286,A00,507359,Fine; Sarah,18,0,18,0
1715653795021,EDS 289C,A01,507361,Daly; Alan J.,18,0,18,0
1715653796050,EDS 290,A00,507366,Hofstetter; Carolyn,15,0,15,0
1715653797079,LIGM 5A,A00,507421,Fischer-Grunski; Eva K,17,0,20,3
1715653798159,LIGM 5B,A00,507423,Fischer-Grunski; Eva K,19,0,20,1
1715653799184,LIGM 5C,A00,507425,Fischer-Grunski; Eva K,19,0,20,1
1715653800209,LIIT 5AS,A00,507427,Carnelos; Chiara,20,0,20,0
1715653801234,LIIT 5BS,A00,507430,Carnelos; Chiara,20,0,20,0
1715653802261,LIIT 5CS,A00,507432,Carnelos; Chiara,20,0,20,0
1715653803290,LISP 5A,A00,507541,Munoz Sanchez; Alicia,11,0,20,9
1715653804322,LISP 5B,A00,507671,Munoz Sanchez; Alicia,8,0,20,12
1715653805347,LISP 5C,A00,507696,Munoz Sanchez; Alicia,8,0,20,12
1715653806372,MAE 197,001,528363,Boechler; Nicholas Sebastia,9998,0,9999,1
1715653807401,MATH 197,001,523477,Kedlaya; Kiran S.,9994,0,9999,5
1715653807401,MATH 197,002,563811,Zhang; Danna,9994,0,9999,5
1715653807401,MATH 197,003,628552,Dumitriu; Ioana,9998,0,9999,1
1715653807401,MATH 197,004,660885,Floyd; Eric,9998,0,9999,1
1715653808431,MCWP 40R,A00,518780,Staff,1,0,20,19
1715653808431,MCWP 40R,B00,518781,Carter; Jennifer A,9,0,20,11
1715653808431,MCWP 40R,C00,518783,Smith; Haydee Marie,5,0,20,15
1715653809463,MCWP 50R,A00,518791,Redela; Pamela Morgan,0,1,20,20
1715653809463,MCWP 50R,B00,518792,Krone; Jarret,0,2,20,20
1715653809463,MCWP 50R,C00,518793,Staff,0,4,20,20
1715653809463,MCWP 50R,D00,518794,Morshed; Michael James,0,2,20,20
1715653809463,MCWP 50R,E00,518795,Carter; Andrea L,0,2,20,20
1715653809463,MCWP 50R,F00,518796,Miller; Elizabeth Deen,0,1,20,20
1715653809463,MCWP 50R,G00,518797,Guillen; Melinda,0,1,20,20
1715653810489,MMW 12R,A01,514034,Herbst; Matthew,0,2,16,16
1715653810489,MMW 12R,A02,514035,Herbst; Matthew,0,0,16,16
1715653811513,MMW 13R,A01,514037,Staff,0,5,16,16
1715653811513,MMW 13R,A02,514039,Staff,0,5,16,16
1715653811513,MMW 13R,A03,628519,Staff,0,4,16,16
1715653813567,SIO 295LS,A00,523233,Staff,10,0,30,20
1715653814593,SIO 295S,A00,523232,Staff,10,0,30,20
1715653815617,SIOC 290S,A01,637330,Merrifield; Mark A,21,0,30,9
1715653816649,SIOC 291S,A01,637333,Gabriel; Corey John,21,0,30,9
1715653817674,SOCI 117,A01,494376,Staff,0,5,5,5
1715653818702,WES 237B,A00,494380,Staff,10,0,20,10
1715653820790,AESE 279B,A00,494370,Wade; Jon P,0,0,33,33
1715653821819,AIP 97,001,660915,Van Den Einde; Yael Dahlia,9998,0,9999,1
1715653822854,AIP 197,001,627712,Vespa; Emanuel Ignacio,9995,0,9999,4
1715653822854,AIP 197,002,650778,Amir; On,9998,0,9999,1
1715653822854,AIP 197,003,650933,Avenancio-Leon; Carlos,9998,0,9999,1
1715653822854,AIP 197,004,658530,Heyman; Gail D.,9998,0,9999,1
1715653822854,AIP 197,005,658631,Neal; Sonya E,9998,0,9999,1
1715653822854,AIP 197,006,658671,Du; Songzi,9998,0,9999,1
1715653823880,ANAR 135S,A00,494369,Braswell; Geoffrey E.,0,0,0,0
1715653824906,BENG 196,001,628496,Engler; Adam J.,9998,0,9999,1
1715653824906,BENG 196,002,660916,Watson; John Thomas,9998,0,9999,1
1715653825932,BISP 197,001,650773,Wilhelm; James E.,9994,0,9999,5
1715653825932,BISP 197,002,658904,Coleman; Aaron B.,9998,0,9999,1
1715653826961,CAT 124RS,A01,519847,Geibel; William,0,0,20,20
1715653827988,CAT 125RS,A01,515971,Geibel; William,0,0,20,20
1715653829017,CLRE 250,A00,511389,Morris; Sheldon,9992,0,9999,7
1715653830049,CLRE 251,A00,507176,Mehta; Ravindra L.,9992,0,9999,7
1715653830049,CLRE 251,B00,511410,Mehta; Ravindra L.,9998,0,9999,1
1715653831074,CLRE 252,A00,507189,Cuomo; Raphael Eduardo,9994,0,9999,5
1715653832100,CLRE 253,A00,507199,Vaida; Florin,9994,0,9999,5
1715653832100,CLRE 253,B00,507202,Vaida; Florin,9999,0,9999,0
1715653833127,CLRE 259,A00,507211,Patel; Hemal,9996,0,9999,3
1715653834152,CLRE 260,A00,507221,Cuomo; Raphael Eduardo,9999,0,9999,0
1715653835177,CLRE 297,001,507242,Cuomo; Raphael Eduardo,9999,0,9999,0
1715653836202,COGS 197,001,638244,Voytek; Bradley Thomas,9997,0,9999,2
1715653837228,CSE 191,A00,516875,Minnes Kemp; Mor Mia,9991,0,9999,8
1715653838253,CSE 197,001,637388,Minnes Kemp; Mor Mia,9992,0,9999,7
1715653839279,CSS 201S,A01,494383,Mignozzetti; Umberto,35,0,35,0
1715653840310,CSS 202S,A01,494387,Mignozzetti; Umberto,35,0,35,0
1715653841338,DSC 197,001,628532,Eldridge; Justin Matthew,9995,0,9999,4
1715653842363,EAP 100,A00,516065,Staff,9799,0,9999,200
1715653843393,ECE 45,A01,507414,Staff,32,0,60,28
1715653845449,ECE 111,A01,507420,Staff,11,0,50,39
1715653846475,ECE 197,001,548057,Sievenpiper; Daniel F.,9991,0,9999,8
1715653847502,EDS 115,A00,507243,Choi; Bailey Miyeon,6,0,28,22
1715653848532,EDS 117,A01,494379,Staff,0,6,34,35
1715653849562,EDS 125,A00,507246,Hopkins; Megan Beth,7,0,30,23
1715653850591,EDS 128A,A01,507264,Fargason; Sharon Gayle,5,0,26,21
1715653851620,EDS 128B,A01,507293,Pappas; Elizabeth,9,0,30,21
1715653852645,EDS 139,A00,507294,Fargason; Sharon Gayle,9,0,30,21
1715653852645,EDS 139,B00,507313,Pappas; Elizabeth,9,0,30,21
1715653853668,EDS 201,A00,507315,Staff,10,0,30,20
1715653854697,EDS 203,A01,507317,Halter; Christopher P.,10,0,30,20
1715653855725,EDS 204R,A01,507319,Halter; Christopher P.,0,3,30,30
1715653855725,EDS 204R,B01,507331,Heinzman; Erica M.,14,0,30,16
1715653856751,EDS 206R,A00,507332,Staff,0,4,30,30
1715653856751,EDS 206R,B00,507343,Staff,15,0,30,15
1715653857784,EDS 250,A00,507344,Hemans; Patricia Ann Benitez,20,0,40,20
1715653858809,EDS 281,A00,507345,Daly; Alan J.,18,0,18,0
1715653859835,EDS 284,A00,507350,Daly; Alan J.,16,0,16,0
1715653860864,EDS 286,A00,507359,Fine; Sarah,18,0,18,0
1715653861890,EDS 289C,A01,507361,Daly; Alan J.,18,0,18,0
1715653862917,EDS 290,A00,507366,Hofstetter; Carolyn,15,0,15,0
1715653863945,LIGM 5A,A00,507421,Fischer-Grunski; Eva K,17,0,20,3
1715653864969,LIGM 5B,A00,507423,Fischer-Grunski; Eva K,19,0,20,1
1715653865995,LIGM 5C,A00,507425,Fischer-Grunski; Eva K,19,0,20,1
1715653867025,LIIT 5AS,A00,507427,Carnelos; Chiara,20,0,20,0
1715653868050,LIIT 5BS,A00,507430,Carnelos; Chiara,20,0,20,0
1715653869077,LIIT 5CS,A00,507432,Carnelos; Chiara,20,0,20,0
1715653870179,LISP 5A,A00,507541,Munoz Sanchez; Alicia,11,0,20,9
1715653871205,LISP 5B,A00,507671,Munoz Sanchez; Alicia,8,0,20,12
1715653872230,LISP 5C,A00,507696,Munoz Sanchez; Alicia,8,0,20,12
1715653873260,MAE 197,001,528363,Boechler; Nicholas Sebastia,9998,0,9999,1
1715653874289,MATH 197,001,523477,Kedlaya; Kiran S.,9994,0,9999,5
1715653874289,MATH 197,002,563811,Zhang; Danna,9994,0,9999,5
1715653874289,MATH 197,003,628552,Dumitriu; Ioana,9998,0,9999,1
1715653874289,MATH 197,004,660885,Floyd; Eric,9998,0,9999,1
1715653875315,MCWP 40R,A00,518780,Staff,1,0,20,19
1715653875315,MCWP 40R,B00,518781,Carter; Jennifer A,9,0,20,11
1715653875315,MCWP 40R,C00,518783,Smith; Haydee Marie,5,0,20,15
1715653876346,MCWP 50R,A00,518791,Redela; Pamela Morgan,0,1,20,20
1715653876346,MCWP 50R,B00,518792,Krone; Jarret,0,2,20,20
1715653876346,MCWP 50R,C00,518793,Staff,0,4,20,20
1715653876346,MCWP 50R,D00,518794,Morshed; Michael James,0,2,20,20
1715653876346,MCWP 50R,E00,518795,Carter; Andrea L,0,2,20,20
1715653876346,MCWP 50R,F00,518796,Miller; Elizabeth Deen,0,1,20,20
1715653876346,MCWP 50R,G00,518797,Guillen; Melinda,0,1,20,20
1715653877373,MMW 12R,A01,514034,Herbst; Matthew,0,2,16,16
1715653877373,MMW 12R,A02,514035,Herbst; Matthew,0,0,16,16
1715653878396,MMW 13R,A01,514037,Staff,0,5,16,16
1715653878396,MMW 13R,A02,514039,Staff,0,5,16,16
1715653878396,MMW 13R,A03,628519,Staff,0,4,16,16
1715653880449,SIO 295LS,A00,523233,Staff,10,0,30,20
1715653881477,SIO 295S,A00,523232,Staff,10,0,30,20
1715653882503,SIOC 290S,A01,637330,Merrifield; Mark A,21,0,30,9
1715653883534,SIOC 291S,A01,637333,Gabriel; Corey John,21,0,30,9
1715653884562,SOCI 117,A01,494376,Staff,0,5,5,5
1715653885589,WES 237B,A00,494380,Staff,10,0,20,10
1715653887665,AESE 279B,A00,494370,Wade; Jon P,0,0,33,33
1715653888693,AIP 97,001,660915,Van Den Einde; Yael Dahlia,9998,0,9999,1
1715653889725,AIP 197,001,627712,Vespa; Emanuel Ignacio,9995,0,9999,4
1715653889725,AIP 197,002,650778,Amir; On,9998,0,9999,1
1715653889725,AIP 197,003,650933,Avenancio-Leon; Carlos,9998,0,9999,1
1715653889725,AIP 197,004,658530,Heyman; Gail D.,9998,0,9999,1
1715653889725,AIP 197,005,658631,Neal; Sonya E,9998,0,9999,1
1715653889725,AIP 197,006,658671,Du; Songzi,9998,0,9999,1
1715653890754,ANAR 135S,A00,494369,Braswell; Geoffrey E.,0,0,0,0
1715653891778,BENG 196,001,628496,Engler; Adam J.,9998,0,9999,1
1715653891778,BENG 196,002,660916,Watson; John Thomas,9998,0,9999,1
1715653892807,BISP 197,001,650773,Wilhelm; James E.,9994,0,9999,5
1715653892807,BISP 197,002,658904,Coleman; Aaron B.,9998,0,9999,1
1715653893832,CAT 124RS,A01,519847,Geibel; William,0,0,20,20
1715653894856,CAT 125RS,A01,515971,Geibel; William,0,0,20,20
1715653895881,CLRE 250,A00,511389,Morris; Sheldon,9992,0,9999,7
1715653896909,CLRE 251,A00,507176,Mehta; Ravindra L.,9992,0,9999,7
1715653896909,CLRE 251,B00,511410,Mehta; Ravindra L.,9998,0,9999,1
1715653897938,CLRE 252,A00,507189,Cuomo; Raphael Eduardo,9994,0,9999,5
1715653898967,CLRE 253,A00,507199,Vaida; Florin,9994,0,9999,5
1715653898967,CLRE 253,B00,507202,Vaida; Florin,9999,0,9999,0
1715653899991,CLRE 259,A00,507211,Patel; Hemal,9996,0,9999,3
1715653901017,CLRE 260,A00,507221,Cuomo; Raphael Eduardo,9999,0,9999,0
1715653902045,CLRE 297,001,507242,Cuomo; Raphael Eduardo,9999,0,9999,0
1715653903069,COGS 197,001,638244,Voytek; Bradley Thomas,9997,0,9999,2
1715653904095,CSE 191,A00,516875,Minnes Kemp; Mor Mia,9991,0,9999,8
1715653905121,CSE 197,001,637388,Minnes Kemp; Mor Mia,9992,0,9999,7
1715653906146,CSS 201S,A01,494383,Mignozzetti; Umberto,35,0,35,0
1715653907171,CSS 202S,A01,494387,Mignozzetti; Umberto,35,0,35,0
1715653908195,DSC 197,001,628532,Eldridge; Justin Matthew,9995,0,9999,4
1715653909220,EAP 100,A00,516065,Staff,9799,0,9999,200
1715653910252,ECE 45,A01,507414,Staff,32,0,60,28
1715653912301,ECE 111,A01,507420,Staff,11,0,50,39
1715653913328,ECE 197,001,548057,Sievenpiper; Daniel F.,9991,0,9999,8
1715653914353,EDS 115,A00,507243,Choi; Bailey Miyeon,6,0,28,22
1715653915379,EDS 117,A01,494379,Staff,0,6,34,35
1715653916405,EDS 125,A00,507246,Hopkins; Megan Beth,7,0,30,23
1715653917434,EDS 128A,A01,507264,Fargason; Sharon Gayle,5,0,26,21
1715653918465,EDS 128B,A01,507293,Pappas; Elizabeth,9,0,30,21
1715653919492,EDS 139,A00,507294,Fargason; Sharon Gayle,9,0,30,21
1715653919492,EDS 139,B00,507313,Pappas; Elizabeth,9,0,30,21
1715653920520,EDS 201,A00,507315,Staff,10,0,30,20
1715653921545,EDS 203,A01,507317,Halter; Christopher P.,10,0,30,20
1715653922570,EDS 204R,A01,507319,Halter; Christopher P.,0,3,30,30
1715653922570,EDS 204R,B01,507331,Heinzman; Erica M.,14,0,30,16
1715653923597,EDS 206R,A00,507332,Staff,0,4,30,30
1715653923597,EDS 206R,B00,507343,Staff,15,0,30,15
1715653924625,EDS 250,A00,507344,Hemans; Patricia Ann Benitez,20,0,40,20
1715653925654,EDS 281,A00,507345,Daly; Alan J.,18,0,18,0
1715653926684,EDS 284,A00,507350,Daly; Alan J.,16,0,16,0
1715653927712,EDS 286,A00,507359,Fine; Sarah,18,0,18,0
1715653928737,EDS 289C,A01,507361,Daly; Alan J.,18,0,18,0
1715653929761,EDS 290,A00,507366,Hofstetter; Carolyn,15,0,15,0
1715653930790,LIGM 5A,A00,507421,Fischer-Grunski; Eva K,17,0,20,3
1715653931815,LIGM 5B,A00,507423,Fischer-Grunski; Eva K,19,0,20,1
1715653932841,LIGM 5C,A00,507425,Fischer-Grunski; Eva K,19,0,20,1
1715653933881,LIIT 5AS,A00,507427,Carnelos; Chiara,20,0,20,0
1715653934907,LIIT 5BS,A00,507430,Carnelos; Chiara,20,0,20,0
1715653935933,LIIT 5CS,A00,507432,Carnelos; Chiara,20,0,20,0
1715653936957,LISP 5A,A00,507541,Munoz Sanchez; Alicia,11,0,20,9
1715653937983,LISP 5B,A00,507671,Munoz Sanchez; Alicia,8,0,20,12
1715653939013,LISP 5C,A00,507696,Munoz Sanchez; Alicia,8,0,20,12
1715653940038,MAE 197,001,528363,Boechler; Nicholas Sebastia,9998,0,9999,1
1715653941069,MATH 197,001,523477,Kedlaya; Kiran S.,9994,0,9999,5
1715653941069,MATH 197,002,563811,Zhang; Danna,9994,0,9999,5
1715653941069,MATH 197,003,628552,Dumitriu; Ioana,9998,0,9999,1
1715653941069,MATH 197,004,660885,Floyd; Eric,9998,0,9999,1
1715653942096,MCWP 40R,A00,518780,Staff,1,0,20,19
1715653942096,MCWP 40R,B00,518781,Carter; Jennifer A,9,0,20,11
1715653942096,MCWP 40R,C00,518783,Smith; Haydee Marie,5,0,20,15
1715653943123,MCWP 50R,A00,518791,Redela; Pamela Morgan,0,1,20,20
1715653943123,MCWP 50R,B00,518792,Krone; Jarret,0,2,20,20
1715653943123,MCWP 50R,C00,518793,Staff,0,4,20,20
1715653943123,MCWP 50R,D00,518794,Morshed; Michael James,0,2,20,20
1715653943123,MCWP 50R,E00,518795,Carter; Andrea L,0,2,20,20
1715653943123,MCWP 50R,F00,518796,Miller; Elizabeth Deen,0,1,20,20
1715653943123,MCWP 50R,G00,518797,Guillen; Melinda,0,1,20,20
1715653944148,MMW 12R,A01,514034,Herbst; Matthew,0,2,16,16
1715653944148,MMW 12R,A02,514035,Herbst; Matthew,0,0,16,16
1715653945173,MMW 13R,A01,514037,Staff,0,5,16,16
1715653945173,MMW 13R,A02,514039,Staff,0,5,16,16
1715653945173,MMW 13R,A03,628519,Staff,0,4,16,16
1715653947229,SIO 295LS,A00,523233,Staff,10,0,30,20
1715653948258,SIO 295S,A00,523232,Staff,10,0,30,20
1715653949287,SIOC 290S,A01,637330,Merrifield; Mark A,21,0,30,9
1715653950316,SIOC 291S,A01,637333,Gabriel; Corey John,21,0,30,9
1715653951345,SOCI 117,A01,494376,Staff,0,5,5,5
1715653952373,WES 237B,A00,494380,Staff,10,0,20,10
1715653954443,AESE 279B,A00,494370,Wade; Jon P,0,0,33,33
1715653955467,AIP 97,001,660915,Van Den Einde; Yael Dahlia,9998,0,9999,1
1715653956500,AIP 197,001,627712,Vespa; Emanuel Ignacio,9995,0,9999,4
1715653956500,AIP 197,002,650778,Amir; On,9998,0,9999,1
1715653956500,AIP 197,003,650933,Avenancio-Leon; Carlos,9998,0,9999,1
1715653956500,AIP 197,004,658530,Heyman; Gail D.,9998,0,9999,1
1715653956500,AIP 197,005,658631,Neal; Sonya E,9998,0,9999,1
1715653956500,AIP 197,006,658671,Du; Songzi,9998,0,9999,1
1715653957526,ANAR 135S,A00,494369,Braswell; Geoffrey E.,0,0,0,0
1715653958553,BENG 196,001,628496,Engler; Adam J.,9998,0,9999,1
1715653958553,BENG 196,002,660916,Watson; John Thomas,9998,0,9999,1
1715653959578,BISP 197,001,650773,Wilhelm; James E.,9994,0,9999,5
1715653959578,BISP 197,002,658904,Coleman; Aaron B.,9998,0,9999,1
1715653960604,CAT 124RS,A01,519847,Geibel; William,0,0,20,20
1715653961640,CAT 125RS,A01,515971,Geibel; William,0,0,20,20
1715653962670,CLRE 250,A00,511389,Morris; Sheldon,9992,0,9999,7
1715653963698,CLRE 251,A00,507176,Mehta; Ravindra L.,9992,0,9999,7
1715653963698,CLRE 251,B00,511410,Mehta; Ravindra L.,9998,0,9999,1
1715653964727,CLRE 252,A00,507189,Cuomo; Raphael Eduardo,9994,0,9999,5
1715653965752,CLRE 253,A00,507199,Vaida; Florin,9994,0,9999,5
1715653965752,CLRE 253,B00,507202,Vaida; Florin,9999,0,9999,0
1715653966782,CLRE 259,A00,507211,Patel; Hemal,9996,0,9999,3
1715653967807,CLRE 260,A00,507221,Cuomo; Raphael Eduardo,9999,0,9999,0
1715653968832,CLRE 297,001,507242,Cuomo; Raphael Eduardo,9999,0,9999,0
1715653969856,COGS 197,001,638244,Voytek; Bradley Thomas,9997,0,9999,2
1715653970882,CSE 191,A00,516875,Minnes Kemp; Mor Mia,9991,0,9999,8
1715653971909,CSE 197,001,637388,Minnes Kemp; Mor Mia,9992,0,9999,7
1715653972934,CSS 201S,A01,494383,Mignozzetti; Umberto,35,0,35,0
1715653973964,CSS 202S,A01,494387,Mignozzetti; Umberto,35,0,35,0
1715653974990,DSC 197,001,628532,Eldridge; Justin Matthew,9995,0,9999,4
1715653976014,EAP 100,A00,516065,Staff,9799,0,9999,200
1715653977044,ECE 45,A01,507414,Staff,32,0,60,28
1715653979094,ECE 111,A01,507420,Staff,11,0,50,39
1715653980121,ECE 197,001,548057,Sievenpiper; Daniel F.,9991,0,9999,8
1715653981146,EDS 115,A00,507243,Choi; Bailey Miyeon,6,0,28,22
1715653982173,EDS 117,A01,494379,Staff,0,6,34,35
1715653983199,EDS 125,A00,507246,Hopkins; Megan Beth,7,0,30,23
1715653984228,EDS 128A,A01,507264,Fargason; Sharon Gayle,5,0,26,21
1715653985257,EDS 128B,A01,507293,Pappas; Elizabeth,9,0,30,21
1715653986283,EDS 139,A00,507294,Fargason; Sharon Gayle,9,0,30,21
1715653986283,EDS 139,B00,507313,Pappas; Elizabeth,9,0,30,21
1715653987313,EDS 201,A00,507315,Staff,10,0,30,20
1715653988341,EDS 203,A01,507317,Halter; Christopher P.,10,0,30,20
1715653989370,EDS 204R,A01,507319,Halter; Christopher P.,0,3,30,30
1715653989370,EDS 204R,B01,507331,Heinzman; Erica M.,14,0,30,16
1715653990396,EDS 206R,A00,507332,Staff,0,4,30,30
1715653990396,EDS 206R,B00,507343,Staff,15,0,30,15
1715653991426,EDS 250,A00,507344,Hemans; Patricia Ann Benitez,20,0,40,20
1715653992456,EDS 281,A00,507345,Daly; Alan J.,18,0,18,0
1715653993481,EDS 284,A00,507350,Daly; Alan J.,16,0,16,0
1715653994507,EDS 286,A00,507359,Fine; Sarah,18,0,18,0
1715653995534,EDS 289C,A01,507361,Daly; Alan J.,18,0,18,0
1715653996564,EDS 290,A00,507366,Hofstetter; Carolyn,15,0,15,0
1715653997593,LIGM 5A,A00,507421,Fischer-Grunski; Eva K,17,0,20,3
1715653998622,LIGM 5B,A00,507423,Fischer-Grunski; Eva K,19,0,20,1
1715653999648,LIGM 5C,A00,507425,Fischer-Grunski; Eva K,19,0,20,1
1715654000678,LIIT 5AS,A00,507427,Carnelos; Chiara,20,0,20,0
1715654001703,LIIT 5BS,A00,507430,Carnelos; Chiara,20,0,20,0
1715654002733,LIIT 5CS,A00,507432,Carnelos; Chiara,20,0,20,0
1715654003765,LISP 5A,A00,507541,Munoz Sanchez; Alicia,11,0,20,9
1715654004792,LISP 5B,A00,507671,Munoz Sanchez; Alicia,8,0,20,12
1715654005820,LISP 5C,A00,507696,Munoz Sanchez; Alicia,8,0,20,12
1715654006849,MAE 197,001,528363,Boechler; Nicholas Sebastia,9998,0,9999,1
1715654007876,MATH 197,001,523477,Kedlaya; Kiran S.,9994,0,9999,5
1715654007876,MATH 197,002,563811,Zhang; Danna,9994,0,9999,5
1715654007876,MATH 197,003,628552,Dumitriu; Ioana,9998,0,9999,1
1715654007876,MATH 197,004,660885,Floyd; Eric,9998,0,9999,1
1715654008901,MCWP 40R,A00,518780,Staff,1,0,20,19
1715654008901,MCWP 40R,B00,518781,Carter; Jennifer A,9,0,20,11
1715654008901,MCWP 40R,C00,518783,Smith; Haydee Marie,5,0,20,15
1715654009930,MCWP 50R,A00,518791,Redela; Pamela Morgan,0,1,20,20
1715654009930,MCWP 50R,B00,518792,Krone; Jarret,0,2,20,20
1715654009930,MCWP 50R,C00,518793,Staff,0,4,20,20
1715654009930,MCWP 50R,D00,518794,Morshed; Michael James,0,2,20,20
1715654009930,MCWP 50R,E00,518795,Carter; Andrea L,0,2,20,20
1715654009930,MCWP 50R,F00,518796,Miller; Elizabeth Deen,0,1,20,20
1715654009930,MCWP 50R,G00,518797,Guillen; Melinda,0,1,20,20
1715654010958,MMW 12R,A01,514034,Herbst; Matthew,0,2,16,16
1715654010958,MMW 12R,A02,514035,Herbst; Matthew,0,0,16,16
1715654011988,MMW 13R,A01,514037,Staff,0,5,16,16
1715654011988,MMW 13R,A02,514039,Staff,0,5,16,16
1715654011988,MMW 13R,A03,628519,Staff,0,4,16,16
1715654014046,SIO 295LS,A00,523233,Staff,10,0,30,20
1715654015071,SIO 295S,A00,523232,Staff,10,0,30,20
1715654016104,SIOC 290S,A01,637330,Merrifield; Mark A,21,0,30,9
1715654017134,SIOC 291S,A01,637333,Gabriel; Corey John,21,0,30,9
1715654018160,SOCI 117,A01,494376,Staff,0,5,5,5
1715654019186,WES 237B,A00,494380,Staff,10,0,20,10
1715654021273,AESE 279B,A00,494370,Wade; Jon P,0,0,33,33
1715654022301,AIP 97,001,660915,Van Den Einde; Yael Dahlia,9998,0,9999,1
1715654023329,AIP 197,001,627712,Vespa; Emanuel Ignacio,9995,0,9999,4
1715654023329,AIP 197,002,650778,Amir; On,9998,0,9999,1
1715654023329,AIP 197,003,650933,Avenancio-Leon; Carlos,9998,0,9999,1
1715654023329,AIP 197,004,658530,Heyman; Gail D.,9998,0,9999,1
1715654023329,AIP 197,005,658631,Neal; Sonya E,9998,0,9999,1
1715654023329,AIP 197,006,658671,Du; Songzi,9998,0,9999,1
1715654024365,ANAR 135S,A00,494369,Braswell; Geoffrey E.,0,0,0,0
1715654025393,BENG 196,001,628496,Engler; Adam J.,9998,0,9999,1
1715654025393,BENG 196,002,660916,Watson; John Thomas,9998,0,9999,1
1715654026420,BISP 197,001,650773,Wilhelm; James E.,9994,0,9999,5
1715654026420,BISP 197,002,658904,Coleman; Aaron B.,9998,0,9999,1
1715654027451,CAT 124RS,A01,519847,Geibel; William,0,0,20,20
1715654028480,CAT 125RS,A01,515971,Geibel; William,0,0,20,20
1715654029506,CLRE 250,A00,511389,Morris; Sheldon,9992,0,9999,7
1715654030535,CLRE 251,A00,507176,Mehta; Ravindra L.,9992,0,9999,7
1715654030535,CLRE 251,B00,511410,Mehta; Ravindra L.,9998,0,9999,1
1715654031564,CLRE 252,A00,507189,Cuomo; Raphael Eduardo,9994,0,9999,5
1715654032591,CLRE 253,A00,507199,Vaida; Florin,9994,0,9999,5
1715654032591,CLRE 253,B00,507202,Vaida; Florin,9999,0,9999,0
1715654033620,CLRE 259,A00,507211,Patel; Hemal,9996,0,9999,3
1715654034648,CLRE 260,A00,507221,Cuomo; Raphael Eduardo,9999,0,9999,0
1715654035675,CLRE 297,001,507242,Cuomo; Raphael Eduardo,9999,0,9999,0
1715654036705,COGS 197,001,638244,Voytek; Bradley Thomas,9997,0,9999,2
1715654037731,CSE 191,A00,516875,Minnes Kemp; Mor Mia,9991,0,9999,8
1715654038760,CSE 197,001,637388,Minnes Kemp; Mor Mia,9992,0,9999,7
1715654039793,CSS 201S,A01,494383,Mignozzetti; Umberto,35,0,35,0
1715654040824,CSS 202S,A01,494387,Mignozzetti; Umberto,35,0,35,0
1715654041860,DSC 197,001,628532,Eldridge; Justin Matthew,9995,0,9999,4
1715654042891,EAP 100,A00,516065,Staff,9799,0,9999,200
1715654043920,ECE 45,A01,507414,Staff,32,0,60,28
1715654045976,ECE 111,A01,507420,Staff,11,0,50,39
1715654047001,ECE 197,001,548057,Sievenpiper; Daniel F.,9991,0,9999,8
1715654048029,EDS 115,A00,507243,Choi; Bailey Miyeon,6,0,28,22
1715654049054,EDS 117,A01,494379,Staff,0,6,34,35
1715654050079,EDS 125,A00,507246,Hopkins; Megan Beth,7,0,30,23
1715654051109,EDS 128A,A01,507264,Fargason; Sharon Gayle,5,0,26,21
1715654052139,EDS 128B,A01,507293,Pappas; Elizabeth,9,0,30,21
1715654053167,EDS 139,A00,507294,Fargason; Sharon Gayle,9,0,30,21
1715654053167,EDS 139,B00,507313,Pappas; Elizabeth,9,0,30,21
1715654054194,EDS 201,A00,507315,Staff,10,0,30,20
1715654055223,EDS 203,A01,507317,Halter; Christopher P.,10,0,30,20
1715654056252,EDS 204R,A01,507319,Halter; Christopher P.,0,3,30,30
1715654056252,EDS 204R,B01,507331,Heinzman; Erica M.,14,0,30,16
1715654057278,EDS 206R,A00,507332,Staff,0,4,30,30
1715654057278,EDS 206R,B00,507343,Staff,15,0,30,15
1715654058305,EDS 250,A00,507344,Hemans; Patricia Ann Benitez,20,0,40,20
1715654059333,EDS 281,A00,507345,Daly; Alan J.,18,0,18,0
1715654060358,EDS 284,A00,507350,Daly; Alan J.,16,0,16,0
1715654061384,EDS 286,A00,507359,Fine; Sarah,18,0,18,0
1715654062415,EDS 289C,A01,507361,Daly; Alan J.,18,0,18,0
1715654063441,EDS 290,A00,507366,Hofstetter; Carolyn,15,0,15,0
1715654064470,LIGM 5A,A00,507421,Fischer-Grunski; Eva K,17,0,20,3
1715654065496,LIGM 5B,A00,507423,Fischer-Grunski; Eva K,19,0,20,1
1715654066521,LIGM 5C,A00,507425,Fischer-Grunski; Eva K,19,0,20,1
1715654067552,LIIT 5AS,A00,507427,Carnelos; Chiara,20,0,20,0
1715654068577,LIIT 5BS,A00,507430,Carnelos; Chiara,20,0,20,0
1715654069603,LIIT 5CS,A00,507432,Carnelos; Chiara,20,0,20,0
1715654070629,LISP 5A,A00,507541,Munoz Sanchez; Alicia,11,0,20,9
1715654071657,LISP 5B,A00,507671,Munoz Sanchez; Alicia,8,0,20,12
1715654072685,LISP 5C,A00,507696,Munoz Sanchez; Alicia,8,0,20,12
1715654073713,MAE 197,001,528363,Boechler; Nicholas Sebastia,9998,0,9999,1
1715654074745,MATH 197,001,523477,Kedlaya; Kiran S.,9994,0,9999,5
1715654074745,MATH 197,002,563811,Zhang; Danna,9994,0,9999,5
1715654074745,MATH 197,003,628552,Dumitriu; Ioana,9998,0,9999,1
1715654074745,MATH 197,004,660885,Floyd; Eric,9998,0,9999,1
1715654075779,MCWP 40R,A00,518780,Staff,1,0,20,19
1715654075779,MCWP 40R,B00,518781,Carter; Jennifer A,9,0,20,11
1715654075779,MCWP 40R,C00,518783,Smith; Haydee Marie,5,0,20,15
1715654076816,MCWP 50R,A00,518791,Redela; Pamela Morgan,0,1,20,20
1715654076816,MCWP 50R,B00,518792,Krone; Jarret,0,2,20,20
1715654076816,MCWP 50R,C00,518793,Staff,0,4,20,20
1715654076816,MCWP 50R,D00,518794,Morshed; Michael James,0,2,20,20
1715654076816,MCWP 50R,E00,518795,Carter; Andrea L,0,2,20,20
1715654076816,MCWP 50R,F00,518796,Miller; Elizabeth Deen,0,1,20,20
1715654076816,MCWP 50R,G00,518797,Guillen; Melinda,0,1,20,20
1715654077842,MMW 12R,A01,514034,Herbst; Matthew,0,2,16,16
1715654077842,MMW 12R,A02,514035,Herbst; Matthew,0,0,16,16
1715654078868,MMW 13R,A01,514037,Staff,0,5,16,16
1715654078868,MMW 13R,A02,514039,Staff,0,5,16,16
1715654078868,MMW 13R,A03,628519,Staff,0,4,16,16
1715654080923,SIO 295LS,A00,523233,Staff,10,0,30,20
1715654081951,SIO 295S,A00,523232,Staff,10,0,30,20
1715654082977,SIOC 290S,A01,637330,Merrifield; Mark A,21,0,30,9
1715654084003,SIOC 291S,A01,637333,Gabriel; Corey John,21,0,30,9
1715654085083,SOCI 117,A01,494376,Staff,0,5,5,5
1715654086109,WES 237B,A00,494380,Staff,10,0,20,10
1715654088178,AESE 279B,A00,494370,Wade; Jon P,0,0,33,33
1715654089207,AIP 97,001,660915,Van Den Einde; Yael Dahlia,9998,0,9999,1
1715654090244,AIP 197,001,627712,Vespa; Emanuel Ignacio,9995,0,9999,4
1715654090244,AIP 197,002,650778,Amir; On,9998,0,9999,1
1715654090244,AIP 197,003,650933,Avenancio-Leon; Carlos,9998,0,9999,1
1715654090244,AIP 197,004,658530,Heyman; Gail D.,9998,0,9999,1
1715654090244,AIP 197,005,658631,Neal; Sonya E,9998,0,9999,1
1715654090244,AIP 197,006,658671,Du; Songzi,9998,0,9999,1
1715654091272,ANAR 135S,A00,494369,Braswell; Geoffrey E.,0,0,0,0
1715654092297,BENG 196,001,628496,Engler; Adam J.,9998,0,9999,1
1715654092297,BENG 196,002,660916,Watson; John Thomas,9998,0,9999,1
1715654093323,BISP 197,001,650773,Wilhelm; James E.,9994,0,9999,5
1715654093323,BISP 197,002,658904,Coleman; Aaron B.,9998,0,9999,1
1715654094352,CAT 124RS,A01,519847,Geibel; William,0,0,20,20
1715654095377,CAT 125RS,A01,515971,Geibel; William,0,0,20,20
1715654096405,CLRE 250,A00,511389,Morris; Sheldon,9992,0,9999,7
1715654097432,CLRE 251,A00,507176,Mehta; Ravindra L.,9992,0,9999,7
1715654097432,CLRE 251,B00,511410,Mehta; Ravindra L.,9998,0,9999,1
1715654098461,CLRE 252,A00,507189,Cuomo; Raphael Eduardo,9994,0,9999,5
1715654099490,CLRE 253,A00,507199,Vaida; Florin,9994,0,9999,5
1715654099490,CLRE 253,B00,507202,Vaida; Florin,9999,0,9999,0
1715654100515,CLRE 259,A00,507211,Patel; Hemal,9996,0,9999,3
1715654101541,CLRE 260,A00,507221,Cuomo; Raphael Eduardo,9999,0,9999,0
1715654102566,CLRE 297,001,507242,Cuomo; Raphael Eduardo,9999,0,9999,0
1715654103594,COGS 197,001,638244,Voytek; Bradley Thomas,9997,0,9999,2
1715654104623,CSE 191,A00,516875,Minnes Kemp; Mor Mia,9991,0,9999,8
1715654105655,CSE 197,001,637388,Minnes Kemp; Mor Mia,9992,0,9999,7
1715654106686,CSS 201S,A01,494383,Mignozzetti; Umberto,35,0,35,0
1715654107714,CSS 202S,A01,494387,Mignozzetti; Umberto,35,0,35,0
1715654108738,DSC 197,001,628532,Eldridge; Justin Matthew,9995,0,9999,4
1715654109763,EAP 100,A00,516065,Staff,9799,0,9999,200
1715654110792,ECE 45,A01,507414,Staff,32,0,60,28
1715654112846,ECE 111,A01,507420,Staff,11,0,50,39
1715654113888,ECE 197,001,548057,Sievenpiper; Daniel F.,9991,0,9999,8
1715654114916,EDS 115,A00,507243,Choi; Bailey Miyeon,6,0,28,22
1715654115944,EDS 117,A01,494379,Staff,0,6,34,35
1715654116970,EDS 125,A00,507246,Hopkins; Megan Beth,7,0,30,23
1715654117999,EDS 128A,A01,507264,Fargason; Sharon Gayle,5,0,26,21
1715654119025,EDS 128B,A01,507293,Pappas; Elizabeth,9,0,30,21
1715654120049,EDS 139,A00,507294,Fargason; Sharon Gayle,9,0,30,21
1715654120049,EDS 139,B00,507313,Pappas; Elizabeth,9,0,30,21
1715654121077,EDS 201,A00,507315,Staff,10,0,30,20
1715654122106,EDS 203,A01,507317,Halter; Christopher P.,10,0,30,20
1715654123133,EDS 204R,A01,507319,Halter; Christopher P.,0,3,30,30
1715654123133,EDS 204R,B01,507331,Heinzman; Erica M.,14,0,30,16
1715654124158,EDS 206R,A00,507332,Staff,0,4,30,30
1715654124158,EDS 206R,B00,507343,Staff,15,0,30,15
1715654125184,EDS 250,A00,507344,Hemans; Patricia Ann Benitez,20,0,40,20
1715654126210,EDS 281,A00,507345,Daly; Alan J.,18,0,18,0
1715654127235,EDS 284,A00,507350,Daly; Alan J.,16,0,16,0
1715654128260,EDS 286,A00,507359,Fine; Sarah,18,0,18,0
1715654129287,EDS 289C,A01,507361,Daly; Alan J.,18,0,18,0
1715654130314,EDS 290,A00,507366,Hofstetter; Carolyn,15,0,15,0
1715654131340,LIGM 5A,A00,507421,Fischer-Grunski; Eva K,17,0,20,3
1715654132371,LIGM 5B,A00,507423,Fischer-Grunski; Eva K,19,0,20,1
1715654133395,LIGM 5C,A00,507425,Fischer-Grunski; Eva K,19,0,20,1
1715654134425,LIIT 5AS,A00,507427,Carnelos; Chiara,20,0,20,0
1715654135453,LIIT 5BS,A00,507430,Carnelos; Chiara,20,0,20,0
1715654136482,LIIT 5CS,A00,507432,Carnelos; Chiara,20,0,20,0
1715654137511,LISP 5A,A00,507541,Munoz Sanchez; Alicia,11,0,20,9
1715654138537,LISP 5B,A00,507671,Munoz Sanchez; Alicia,8,0,20,12
1715654139565,LISP 5C,A00,507696,Munoz Sanchez; Alicia,8,0,20,12
1715654140591,MAE 197,001,528363,Boechler; Nicholas Sebastia,9998,0,9999,1
1715654141619,MATH 197,001,523477,Kedlaya; Kiran S.,9994,0,9999,5
1715654141619,MATH 197,002,563811,Zhang; Danna,9994,0,9999,5
1715654141619,MATH 197,003,628552,Dumitriu; Ioana,9998,0,9999,1
1715654141619,MATH 197,004,660885,Floyd; Eric,9998,0,9999,1
1715654142652,MCWP 40R,A00,518780,Staff,1,0,20,19
1715654142652,MCWP 40R,B00,518781,Carter; Jennifer A,9,0,20,11
1715654142652,MCWP 40R,C00,518783,Smith; Haydee Marie,5,0,20,15
1715654143682,MCWP 50R,A00,518791,Redela; Pamela Morgan,0,1,20,20
1715654143682,MCWP 50R,B00,518792,Krone; Jarret,0,2,20,20
1715654143682,MCWP 50R,C00,518793,Staff,0,4,20,20
1715654143682,MCWP 50R,D00,518794,Morshed; Michael James,0,2,20,20
1715654143682,MCWP 50R,E00,518795,Carter; Andrea L,0,2,20,20
1715654143682,MCWP 50R,F00,518796,Miller; Elizabeth Deen,0,1,20,20
1715654143682,MCWP 50R,G00,518797,Guillen; Melinda,0,1,20,20
1715654144708,MMW 12R,A01,514034,Herbst; Matthew,0,2,16,16
1715654144708,MMW 12R,A02,514035,Herbst; Matthew,0,0,16,16
1715654145733,MMW 13R,A01,514037,Staff,0,5,16,16
1715654145733,MMW 13R,A02,514039,Staff,0,5,16,16
1715654145733,MMW 13R,A03,628519,Staff,0,4,16,16
1715654147789,SIO 295LS,A00,523233,Staff,10,0,30,20
1715654148815,SIO 295S,A00,523232,Staff,10,0,30,20
1715654149840,SIOC 290S,A01,637330,Merrifield; Mark A,21,0,30,9
1715654150868,SIOC 291S,A01,637333,Gabriel; Corey John,21,0,30,9
1715654151893,SOCI 117,A01,494376,Staff,0,5,5,5
1715654152917,WES 237B,A00,494380,Staff,10,0,20,10
1715654154991,AESE 279B,A00,494370,Wade; Jon P,0,0,33,33
1715654156016,AIP 97,001,660915,Van Den Einde; Yael Dahlia,9998,0,9999,1
1715654157045,AIP 197,001,627712,Vespa; Emanuel Ignacio,9995,0,9999,4
1715654157045,AIP 197,002,650778,Amir; On,9998,0,9999,1
1715654157045,AIP 197,003,650933,Avenancio-Leon; Carlos,9998,0,9999,1
1715654157045,AIP 197,004,658530,Heyman; Gail D.,9998,0,9999,1
1715654157045,AIP 197,005,658631,Neal; Sonya E,9998,0,9999,1
1715654157045,AIP 197,006,658671,Du; Songzi,9998,0,9999,1
1715654158072,ANAR 135S,A00,494369,Braswell; Geoffrey E.,0,0,0,0
1715654159099,BENG 196,001,628496,Engler; Adam J.,9998,0,9999,1
1715654159099,BENG 196,002,660916,Watson; John Thomas,9998,0,9999,1
1715654160131,BISP 197,001,650773,Wilhelm; James E.,9994,0,9999,5
1715654160131,BISP 197,002,658904,Coleman; Aaron B.,9998,0,9999,1
1715654161157,CAT 124RS,A01,519847,Geibel; William,0,0,20,20
1715654162184,CAT 125RS,A01,515971,Geibel; William,0,0,20,20
1715654163210,CLRE 250,A00,511389,Morris; Sheldon,9992,0,9999,7
1715654164240,CLRE 251,A00,507176,Mehta; Ravindra L.,9992,0,9999,7
1715654164240,CLRE 251,B00,511410,Mehta; Ravindra L.,9998,0,9999,1
1715654165271,CLRE 252,A00,507189,Cuomo; Raphael Eduardo,9994,0,9999,5
1715654166297,CLRE 253,A00,507199,Vaida; Florin,9994,0,9999,5
1715654166297,CLRE 253,B00,507202,Vaida; Florin,9999,0,9999,0
1715654167326,CLRE 259,A00,507211,Patel; Hemal,9996,0,9999,3
1715654168352,CLRE 260,A00,507221,Cuomo; Raphael Eduardo,9999,0,9999,0
1715654169376,CLRE 297,001,507242,Cuomo; Raphael Eduardo,9999,0,9999,0
1715654170401,COGS 197,001,638244,Voytek; Bradley Thomas,9997,0,9999,2
1715654171426,CSE 191,A00,516875,Minnes Kemp; Mor Mia,9991,0,9999,8
1715654172452,CSE 197,001,637388,Minnes Kemp; Mor Mia,9992,0,9999,7
1715654173479,CSS 201S,A01,494383,Mignozzetti; Umberto,35,0,35,0
1715654174505,CSS 202S,A01,494387,Mignozzetti; Umberto,35,0,35,0
1715654175534,DSC 197,001,628532,Eldridge; Justin Matthew,9995,0,9999,4
1715654176562,EAP 100,A00,516065,Staff,9799,0,9999,200
1715654177594,ECE 45,A01,507414,Staff,32,0,60,28
1715654179650,ECE 111,A01,507420,Staff,11,0,50,39
1715654180676,ECE 197,001,548057,Sievenpiper; Daniel F.,9991,0,9999,8
1715654181704,EDS 115,A00,507243,Choi; Bailey Miyeon,6,0,28,22
1715654182728,EDS 117,A01,494379,Staff,0,6,34,35
1715654183755,EDS 125,A00,507246,Hopkins; Megan Beth,7,0,30,23
1715654184785,EDS 128A,A01,507264,Fargason; Sharon Gayle,5,0,26,21
1715654185810,EDS 128B,A01,507293,Pappas; Elizabeth,9,0,30,21
1715654186837,EDS 139,A00,507294,Fargason; Sharon Gayle,9,0,30,21
1715654186837,EDS 139,B00,507313,Pappas; Elizabeth,9,0,30,21
1715654187863,EDS 201,A00,507315,Staff,10,0,30,20
1715654188945,EDS 203,A01,507317,Halter; Christopher P.,10,0,30,20
1715654189970,EDS 204R,A01,507319,Halter; Christopher P.,0,3,30,30
1715654189970,EDS 204R,B01,507331,Heinzman; Erica M.,14,0,30,16
1715654190996,EDS 206R,A00,507332,Staff,0,4,30,30
1715654190996,EDS 206R,B00,507343,Staff,15,0,30,15
1715654192024,EDS 250,A00,507344,Hemans; Patricia Ann Benitez,20,0,40,20
1715654193053,EDS 281,A00,507345,Daly; Alan J.,18,0,18,0
1715654194077,EDS 284,A00,507350,Daly; Alan J.,16,0,16,0
1715654195105,EDS 286,A00,507359,Fine; Sarah,18,0,18,0
1715654196134,EDS 289C,A01,507361,Daly; Alan J.,18,0,18,0
1715654197160,EDS 290,A00,507366,Hofstetter; Carolyn,15,0,15,0
1715654198189,LIGM 5A,A00,507421,Fischer-Grunski; Eva K,17,0,20,3
1715654199215,LIGM 5B,A00,507423,Fischer-Grunski; Eva K,19,0,20,1
1715654200240,LIGM 5C,A00,507425,Fischer-Grunski; Eva K,19,0,20,1
1715654201266,LIIT 5AS,A00,507427,Carnelos; Chiara,20,0,20,0
1715654202296,LIIT 5BS,A00,507430,Carnelos; Chiara,20,0,20,0
1715654203321,LIIT 5CS,A00,507432,Carnelos; Chiara,20,0,20,0
1715654204354,LISP 5A,A00,507541,Munoz Sanchez; Alicia,11,0,20,9
1715654205380,LISP 5B,A00,507671,Munoz Sanchez; Alicia,8,0,20,12
1715654206409,LISP 5C,A00,507696,Munoz Sanchez; Alicia,8,0,20,12
1715654207437,MAE 197,001,528363,Boechler; Nicholas Sebastia,9998,0,9999,1
1715654208474,MATH 197,001,523477,Kedlaya; Kiran S.,9994,0,9999,5
1715654208474,MATH 197,002,563811,Zhang; Danna,9994,0,9999,5
1715654208474,MATH 197,003,628552,Dumitriu; Ioana,9998,0,9999,1
1715654208474,MATH 197,004,660885,Floyd; Eric,9998,0,9999,1
1715654209504,MCWP 40R,A00,518780,Staff,1,0,20,19
1715654209504,MCWP 40R,B00,518781,Carter; Jennifer A,9,0,20,11
1715654209504,MCWP 40R,C00,518783,Smith; Haydee Marie,5,0,20,15
1715654210537,MCWP 50R,A00,518791,Redela; Pamela Morgan,0,1,20,20
1715654210537,MCWP 50R,B00,518792,Krone; Jarret,0,2,20,20
1715654210537,MCWP 50R,C00,518793,Staff,0,4,20,20
1715654210537,MCWP 50R,D00,518794,Morshed; Michael James,0,2,20,20
1715654210537,MCWP 50R,E00,518795,Carter; Andrea L,0,2,20,20
1715654210537,MCWP 50R,F00,518796,Miller; Elizabeth Deen,0,1,20,20
1715654210537,MCWP 50R,G00,518797,Guillen; Melinda,0,1,20,20
1715654211563,MMW 12R,A01,514034,Herbst; Matthew,0,2,16,16
1715654211563,MMW 12R,A02,514035,Herbst; Matthew,0,0,16,16
1715654212593,MMW 13R,A01,514037,Staff,0,5,16,16
1715654212593,MMW 13R,A02,514039,Staff,0,5,16,16
1715654212593,MMW 13R,A03,628519,Staff,0,4,16,16
1715654214650,SIO 295LS,A00,523233,Staff,10,0,30,20
1715654215675,SIO 295S,A00,523232,Staff,10,0,30,20
1715654216701,SIOC 290S,A01,637330,Merrifield; Mark A,21,0,30,9
1715654217728,SIOC 291S,A01,637333,Gabriel; Corey John,21,0,30,9
1715654218756,SOCI 117,A01,494376,Staff,0,5,5,5
1715654219785,WES 237B,A00,494380,Staff,10,0,20,10
1715654221858,AESE 279B,A00,494370,Wade; Jon P,0,0,33,33
1715654222886,AIP 97,001,660915,Van Den Einde; Yael Dahlia,9998,0,9999,1
1715654223915,AIP 197,001,627712,Vespa; Emanuel Ignacio,9995,0,9999,4
1715654223915,AIP 197,002,650778,Amir; On,9998,0,9999,1
1715654223915,AIP 197,003,650933,Avenancio-Leon; Carlos,9998,0,9999,1
1715654223915,AIP 197,004,658530,Heyman; Gail D.,9998,0,9999,1
1715654223915,AIP 197,005,658631,Neal; Sonya E,9998,0,9999,1
1715654223915,AIP 197,006,658671,Du; Songzi,9998,0,9999,1
1715654224940,ANAR 135S,A00,494369,Braswell; Geoffrey E.,0,0,0,0
1715654225969,BENG 196,001,628496,Engler; Adam J.,9998,0,9999,1
1715654225969,BENG 196,002,660916,Watson; John Thomas,9998,0,9999,1
1715654226997,BISP 197,001,650773,Wilhelm; James E.,9994,0,9999,5
1715654226997,BISP 197,002,658904,Coleman; Aaron B.,9998,0,9999,1
1715654228022,CAT 124RS,A01,519847,Geibel; William,0,0,20,20
1715654229047,CAT 125RS,A01,515971,Geibel; William,0,0,20,20
1715654230077,CLRE 250,A00,511389,Morris; Sheldon,9992,0,9999,7
1715654231106,CLRE 251,A00,507176,Mehta; Ravindra L.,9992,0,9999,7
1715654231106,CLRE 251,B00,511410,Mehta; Ravindra L.,9998,0,9999,1
1715654232131,CLRE 252,A00,507189,Cuomo; Raphael Eduardo,9994,0,9999,5
1715654233346,CLRE 253,A00,507199,Vaida; Florin,9994,0,9999,5
1715654233346,CLRE 253,B00,507202,Vaida; Florin,9999,0,9999,0
1715654234376,CLRE 259,A00,507211,Patel; Hemal,9996,0,9999,3
1715654235401,CLRE 260,A00,507221,Cuomo; Raphael Eduardo,9999,0,9999,0
1715654236431,CLRE 297,001,507242,Cuomo; Raphael Eduardo,9999,0,9999,0
1715654237464,COGS 197,001,638244,Voytek; Bradley Thomas,9997,0,9999,2
1715654238492,CSE 191,A00,516875,Minnes Kemp; Mor Mia,9991,0,9999,8
1715654239518,CSE 197,001,637388,Minnes Kemp; Mor Mia,9992,0,9999,7
1715654240543,CSS 201S,A01,494383,Mignozzetti; Umberto,35,0,35,0
1715654241574,CSS 202S,A01,494387,Mignozzetti; Umberto,35,0,35,0
1715654242599,DSC 197,001,628532,Eldridge; Justin Matthew,9995,0,9999,4
1715654243625,EAP 100,A00,516065,Staff,9799,0,9999,200
1715654244657,ECE 45,A01,507414,Staff,32,0,60,28
1715654246710,ECE 111,A01,507420,Staff,11,0,50,39
1715654247737,ECE 197,001,548057,Sievenpiper; Daniel F.,9991,0,9999,8
1715654248761,EDS 115,A00,507243,Choi; Bailey Miyeon,6,0,28,22
1715654249789,EDS 117,A01,494379,Staff,0,6,34,35
1715654250818,EDS 125,A00,507246,Hopkins; Megan Beth,7,0,30,23
1715654251847,EDS 128A,A01,507264,Fargason; Sharon Gayle,5,0,26,21
1715654252875,EDS 128B,A01,507293,Pappas; Elizabeth,9,0,30,21
1715654253909,EDS 139,A00,507294,Fargason; Sharon Gayle,9,0,30,21
1715654253909,EDS 139,B00,507313,Pappas; Elizabeth,9,0,30,21
1715654254934,EDS 201,A00,507315,Staff,10,0,30,20
1715654255960,EDS 203,A01,507317,Halter; Christopher P.,10,0,30,20
1715654256988,EDS 204R,A01,507319,Halter; Christopher P.,0,3,30,30
1715654256988,EDS 204R,B01,507331,Heinzman; Erica M.,14,0,30,16
1715654258014,EDS 206R,A00,507332,Staff,0,4,30,30
1715654258014,EDS 206R,B00,507343,Staff,15,0,30,15
1715654259044,EDS 250,A00,507344,Hemans; Patricia Ann Benitez,20,0,40,20
1715654260066,EDS 281,A00,507345,Daly; Alan J.,18,0,18,0
1715654261095,EDS 284,A00,507350,Daly; Alan J.,16,0,16,0
1715654262121,EDS 286,A00,507359,Fine; Sarah,18,0,18,0
1715654263146,EDS 289C,A01,507361,Daly; Alan J.,18,0,18,0
1715654264174,EDS 290,A00,507366,Hofstetter; Carolyn,15,0,15,0
1715654265203,LIGM 5A,A00,507421,Fischer-Grunski; Eva K,17,0,20,3
1715654266231,LIGM 5B,A00,507423,Fischer-Grunski; Eva K,19,0,20,1
1715654267254,LIGM 5C,A00,507425,Fischer-Grunski; Eva K,19,0,20,1
1715654268280,LIIT 5AS,A00,507427,Carnelos; Chiara,20,0,20,0
1715654269305,LIIT 5BS,A00,507430,Carnelos; Chiara,20,0,20,0
1715654270329,LIIT 5CS,A00,507432,Carnelos; Chiara,20,0,20,0
1715654271358,LISP 5A,A00,507541,Munoz Sanchez; Alicia,11,0,20,9
1715654272388,LISP 5B,A00,507671,Munoz Sanchez; Alicia,8,0,20,12
1715654273415,LISP 5C,A00,507696,Munoz Sanchez; Alicia,8,0,20,12
1715654274441,MAE 197,001,528363,Boechler; Nicholas Sebastia,9998,0,9999,1
1715654275469,MATH 197,001,523477,Kedlaya; Kiran S.,9994,0,9999,5
1715654275469,MATH 197,002,563811,Zhang; Danna,9994,0,9999,5
1715654275469,MATH 197,003,628552,Dumitriu; Ioana,9998,0,9999,1
1715654275469,MATH 197,004,660885,Floyd; Eric,9998,0,9999,1
1715654276496,MCWP 40R,A00,518780,Staff,1,0,20,19
1715654276496,MCWP 40R,B00,518781,Carter; Jennifer A,9,0,20,11
1715654276496,MCWP 40R,C00,518783,Smith; Haydee Marie,5,0,20,15
1715654277525,MCWP 50R,A00,518791,Redela; Pamela Morgan,0,1,20,20
1715654277525,MCWP 50R,B00,518792,Krone; Jarret,0,2,20,20
1715654277525,MCWP 50R,C00,518793,Staff,0,4,20,20
1715654277525,MCWP 50R,D00,518794,Morshed; Michael James,0,2,20,20
1715654277525,MCWP 50R,E00,518795,Carter; Andrea L,0,2,20,20
1715654277525,MCWP 50R,F00,518796,Miller; Elizabeth Deen,0,1,20,20
1715654277525,MCWP 50R,G00,518797,Guillen; Melinda,0,1,20,20
1715654278551,MMW 12R,A01,514034,Herbst; Matthew,0,2,16,16
1715654278551,MMW 12R,A02,514035,Herbst; Matthew,0,0,16,16
1715654279577,MMW 13R,A01,514037,Staff,0,5,16,16
1715654279577,MMW 13R,A02,514039,Staff,0,5,16,16
1715654279577,MMW 13R,A03,628519,Staff,0,4,16,16
1715654281627,SIO 295LS,A00,523233,Staff,10,0,30,20
1715654282651,SIO 295S,A00,523232,Staff,10,0,30,20
1715654283678,SIOC 290S,A01,637330,Merrifield; Mark A,21,0,30,9
1715654284703,SIOC 291S,A01,637333,Gabriel; Corey John,21,0,30,9
1715654285732,SOCI 117,A01,494376,Staff,0,5,5,5
1715654286760,WES 237B,A00,494380,Staff,10,0,20,10
1715654288843,AESE 279B,A00,494370,Wade; Jon P,0,0,33,33
1715654289868,AIP 97,001,660915,Van Den Einde; Yael Dahlia,9998,0,9999,1
1715654290898,AIP 197,001,627712,Vespa; Emanuel Ignacio,9995,0,9999,4
1715654290898,AIP 197,002,650778,Amir; On,9998,0,9999,1
1715654290898,AIP 197,003,650933,Avenancio-Leon; Carlos,9998,0,9999,1
1715654290898,AIP 197,004,658530,Heyman; Gail D.,9998,0,9999,1
1715654290898,AIP 197,005,658631,Neal; Sonya E,9998,0,9999,1
1715654290898,AIP 197,006,658671,Du; Songzi,9998,0,9999,1
1715654291923,ANAR 135S,A00,494369,Braswell; Geoffrey E.,0,0,0,0
1715654292951,BENG 196,001,628496,Engler; Adam J.,9998,0,9999,1
1715654292951,BENG 196,002,660916,Watson; John Thomas,9998,0,9999,1
1715654293976,BISP 197,001,650773,Wilhelm; James E.,9994,0,9999,5
1715654293976,BISP 197,002,658904,Coleman; Aaron B.,9998,0,9999,1
1715654295001,CAT 124RS,A01,519847,Geibel; William,0,0,20,20
1715654296024,CAT 125RS,A01,515971,Geibel; William,0,0,20,20
1715654297052,CLRE 250,A00,511389,Morris; Sheldon,9992,0,9999,7
1715654298079,CLRE 251,A00,507176,Mehta; Ravindra L.,9992,0,9999,7
1715654298079,CLRE 251,B00,511410,Mehta; Ravindra L.,9998,0,9999,1
1715654299125,CLRE 252,A00,507189,Cuomo; Raphael Eduardo,9994,0,9999,5
1715654300151,CLRE 253,A00,507199,Vaida; Florin,9994,0,9999,5
1715654300151,CLRE 253,B00,507202,Vaida; Florin,9999,0,9999,0
1715654301187,CLRE 259,A00,507211,Patel; Hemal,9996,0,9999,3
1715654302212,CLRE 260,A00,507221,Cuomo; Raphael Eduardo,9999,0,9999,0
1715654303238,CLRE 297,001,507242,Cuomo; Raphael Eduardo,9999,0,9999,0
1715654304262,COGS 197,001,638244,Voytek; Bradley Thomas,9997,0,9999,2
1715654305287,CSE 191,A00,516875,Minnes Kemp; Mor Mia,9991,0,9999,8
1715654306314,CSE 197,001,637388,Minnes Kemp; Mor Mia,9992,0,9999,7
1715654307340,CSS 201S,A01,494383,Mignozzetti; Umberto,35,0,35,0
1715654308364,CSS 202S,A01,494387,Mignozzetti; Umberto,35,0,35,0
1715654309388,DSC 197,001,628532,Eldridge; Justin Matthew,9995,0,9999,4
1715654310416,EAP 100,A00,516065,Staff,9799,0,9999,200
1715654311447,ECE 45,A01,507414,Staff,32,0,60,28
1715654313504,ECE 111,A01,507420,Staff,11,0,50,39
1715654314530,ECE 197,001,548057,Sievenpiper; Daniel F.,9991,0,9999,8
1715654315559,EDS 115,A00,507243,Choi; Bailey Miyeon,6,0,28,22
1715654316588,EDS 117,A01,494379,Staff,0,6,34,35
1715654317617,EDS 125,A00,507246,Hopkins; Megan Beth,7,0,30,23
1715654318646,EDS 128A,A01,507264,Fargason; Sharon Gayle,5,0,26,21
1715654319673,EDS 128B,A01,507293,Pappas; Elizabeth,9,0,30,21
1715654320700,EDS 139,A00,507294,Fargason; Sharon Gayle,9,0,30,21
1715654320700,EDS 139,B00,507313,Pappas; Elizabeth,9,0,30,21
1715654321727,EDS 201,A00,507315,Staff,10,0,30,20
1715654322757,EDS 203,A01,507317,Halter; Christopher P.,10,0,30,20
1715654323781,EDS 204R,A01,507319,Halter; Christopher P.,0,3,30,30
1715654323781,EDS 204R,B01,507331,Heinzman; Erica M.,14,0,30,16
1715654324806,EDS 206R,A00,507332,Staff,0,4,30,30
1715654324806,EDS 206R,B00,507343,Staff,15,0,30,15
1715654325834,EDS 250,A00,507344,Hemans; Patricia Ann Benitez,20,0,40,20
1715654326860,EDS 281,A00,507345,Daly; Alan J.,18,0,18,0
1715654327888,EDS 284,A00,507350,Daly; Alan J.,16,0,16,0
1715654328917,EDS 286,A00,507359,Fine; Sarah,18,0,18,0
1715654329944,EDS 289C,A01,507361,Daly; Alan J.,18,0,18,0
1715654330974,EDS 290,A00,507366,Hofstetter; Carolyn,15,0,15,0
1715654332004,LIGM 5A,A00,507421,Fischer-Grunski; Eva K,17,0,20,3
1715654333031,LIGM 5B,A00,507423,Fischer-Grunski; Eva K,19,0,20,1
1715654334057,LIGM 5C,A00,507425,Fischer-Grunski; Eva K,19,0,20,1
1715654335088,LIIT 5AS,A00,507427,Carnelos; Chiara,20,0,20,0
1715654336119,LIIT 5BS,A00,507430,Carnelos; Chiara,20,0,20,0
1715654337147,LIIT 5CS,A00,507432,Carnelos; Chiara,20,0,20,0
1715654338174,LISP 5A,A00,507541,Munoz Sanchez; Alicia,11,0,20,9
1715654339201,LISP 5B,A00,507671,Munoz Sanchez; Alicia,8,0,20,12
1715654340229,LISP 5C,A00,507696,Munoz Sanchez; Alicia,8,0,20,12
1715654341255,MAE 197,001,528363,Boechler; Nicholas Sebastia,9998,0,9999,1
1715654342291,MATH 197,001,523477,Kedlaya; Kiran S.,9994,0,9999,5
1715654342291,MATH 197,002,563811,Zhang; Danna,9994,0,9999,5
1715654342291,MATH 197,003,628552,Dumitriu; Ioana,9998,0,9999,1
1715654342291,MATH 197,004,660885,Floyd; Eric,9998,0,9999,1
1715654343321,MCWP 40R,A00,518780,Staff,1,0,20,19
1715654343321,MCWP 40R,B00,518781,Carter; Jennifer A,9,0,20,11
1715654343321,MCWP 40R,C00,518783,Smith; Haydee Marie,5,0,20,15
1715654344349,MCWP 50R,A00,518791,Redela; Pamela Morgan,0,1,20,20
1715654344349,MCWP 50R,B00,518792,Krone; Jarret,0,2,20,20
1715654344349,MCWP 50R,C00,518793,Staff,0,4,20,20
1715654344349,MCWP 50R,D00,518794,Morshed; Michael James,0,2,20,20
1715654344349,MCWP 50R,E00,518795,Carter; Andrea L,0,2,20,20
1715654344349,MCWP 50R,F00,518796,Miller; Elizabeth Deen,0,1,20,20
1715654344349,MCWP 50R,G00,518797,Guillen; Melinda,0,1,20,20
1715654345373,MMW 12R,A01,514034,Herbst; Matthew,0,2,16,16
1715654345373,MMW 12R,A02,514035,Herbst; Matthew,0,0,16,16
1715654346402,MMW 13R,A01,514037,Staff,0,5,16,16
1715654346402,MMW 13R,A02,514039,Staff,0,5,16,16
1715654346402,MMW 13R,A03,628519,Staff,0,4,16,16
1715654348455,SIO 295LS,A00,523233,Staff,10,0,30,20
1715654349481,SIO 295S,A00,523232,Staff,10,0,30,20
1715654350508,SIOC 290S,A01,637330,Merrifield; Mark A,21,0,30,9
1715654351536,SIOC 291S,A01,637333,Gabriel; Corey John,21,0,30,9
1715654352562,SOCI 117,A01,494376,Staff,0,5,5,5
1715654353588,WES 237B,A00,494380,Staff,10,0,20,10
1715654355664,AESE 279B,A00,494370,Wade; Jon P,0,0,33,33
1715654356691,AIP 97,001,660915,Van Den Einde; Yael Dahlia,9998,0,9999,1
1715654357721,AIP 197,001,627712,Vespa; Emanuel Ignacio,9995,0,9999,4
1715654357721,AIP 197,002,650778,Amir; On,9998,0,9999,1
1715654357721,AIP 197,003,650933,Avenancio-Leon; Carlos,9998,0,9999,1
1715654357721,AIP 197,004,658530,Heyman; Gail D.,9998,0,9999,1
1715654357721,AIP 197,005,658631,Neal; Sonya E,9998,0,9999,1
1715654357721,AIP 197,006,658671,Du; Songzi,9998,0,9999,1
1715654358747,ANAR 135S,A00,494369,Braswell; Geoffrey E.,0,0,0,0
1715654359776,BENG 196,001,628496,Engler; Adam J.,9998,0,9999,1
1715654359776,BENG 196,002,660916,Watson; John Thomas,9998,0,9999,1
1715654360802,BISP 197,001,650773,Wilhelm; James E.,9994,0,9999,5
1715654360802,BISP 197,002,658904,Coleman; Aaron B.,9998,0,9999,1
1715654361828,CAT 124RS,A01,519847,Geibel; William,0,0,20,20
1715654362856,CAT 125RS,A01,515971,Geibel; William,0,0,20,20
1715654363882,CLRE 250,A00,511389,Morris; Sheldon,9992,0,9999,7
1715654364910,CLRE 251,A00,507176,Mehta; Ravindra L.,9992,0,9999,7
1715654364910,CLRE 251,B00,511410,Mehta; Ravindra L.,9998,0,9999,1
1715654365935,CLRE 252,A00,507189,Cuomo; Raphael Eduardo,9994,0,9999,5
1715654366961,CLRE 253,A00,507199,Vaida; Florin,9994,0,9999,5
1715654366961,CLRE 253,B00,507202,Vaida; Florin,9999,0,9999,0
1715654367986,CLRE 259,A00,507211,Patel; Hemal,9996,0,9999,3
1715654369015,CLRE 260,A00,507221,Cuomo; Raphael Eduardo,9999,0,9999,0
1715654370040,CLRE 297,001,507242,Cuomo; Raphael Eduardo,9999,0,9999,0
1715654371065,COGS 197,001,638244,Voytek; Bradley Thomas,9997,0,9999,2
1715654372090,CSE 191,A00,516875,Minnes Kemp; Mor Mia,9991,0,9999,8
1715654373117,CSE 197,001,637388,Minnes Kemp; Mor Mia,9992,0,9999,7
1715654374150,CSS 201S,A01,494383,Mignozzetti; Umberto,35,0,35,0
1715654375180,CSS 202S,A01,494387,Mignozzetti; Umberto,35,0,35,0
1715654376205,DSC 197,001,628532,Eldridge; Justin Matthew,9995,0,9999,4
1715654377230,EAP 100,A00,516065,Staff,9799,0,9999,200
1715654378256,ECE 45,A01,507414,Staff,32,0,60,28
1715654380313,ECE 111,A01,507420,Staff,11,0,50,39
1715654381338,ECE 197,001,548057,Sievenpiper; Daniel F.,9991,0,9999,8
1715654382365,EDS 115,A00,507243,Choi; Bailey Miyeon,6,0,28,22
1715654383392,EDS 117,A01,494379,Staff,0,6,34,35
1715654384421,EDS 125,A00,507246,Hopkins; Megan Beth,7,0,30,23
1715654385447,EDS 128A,A01,507264,Fargason; Sharon Gayle,5,0,26,21
1715654386473,EDS 128B,A01,507293,Pappas; Elizabeth,9,0,30,21
1715654387496,EDS 139,A00,507294,Fargason; Sharon Gayle,9,0,30,21
1715654387496,EDS 139,B00,507313,Pappas; Elizabeth,9,0,30,21
1715654388524,EDS 201,A00,507315,Staff,10,0,30,20
1715654389550,EDS 203,A01,507317,Halter; Christopher P.,10,0,30,20
1715654390581,EDS 204R,A01,507319,Halter; Christopher P.,0,3,30,30
1715654390581,EDS 204R,B01,507331,Heinzman; Erica M.,14,0,30,16
1715654391607,EDS 206R,A00,507332,Staff,0,4,30,30
1715654391607,EDS 206R,B00,507343,Staff,15,0,30,15
1715654392632,EDS 250,A00,507344,Hemans; Patricia Ann Benitez,20,0,40,20
1715654393658,EDS 281,A00,507345,Daly; Alan J.,18,0,18,0
1715654394685,EDS 284,A00,507350,Daly; Alan J.,16,0,16,0
1715654395711,EDS 286,A00,507359,Fine; Sarah,18,0,18,0
1715654396737,EDS 289C,A01,507361,Daly; Alan J.,18,0,18,0
1715654397764,EDS 290,A00,507366,Hofstetter; Carolyn,15,0,15,0
1715654398792,LIGM 5A,A00,507421,Fischer-Grunski; Eva K,17,0,20,3
1715654399818,LIGM 5B,A00,507423,Fischer-Grunski; Eva K,19,0,20,1
1715654400847,LIGM 5C,A00,507425,Fischer-Grunski; Eva K,19,0,20,1
1715654401908,LIIT 5AS,A00,507427,Carnelos; Chiara,20,0,20,0
1715654402936,LIIT 5BS,A00,507430,Carnelos; Chiara,20,0,20,0
1715654403960,LIIT 5CS,A00,507432,Carnelos; Chiara,20,0,20,0
1715654404996,LISP 5A,A00,507541,Munoz Sanchez; Alicia,11,0,20,9
1715654406024,LISP 5B,A00,507671,Munoz Sanchez; Alicia,8,0,20,12
1715654407053,LISP 5C,A00,507696,Munoz Sanchez; Alicia,8,0,20,12
1715654408078,MAE 197,001,528363,Boechler; Nicholas Sebastia,9998,0,9999,1
1715654409106,MATH 197,001,523477,Kedlaya; Kiran S.,9994,0,9999,5
1715654409106,MATH 197,002,563811,Zhang; Danna,9994,0,9999,5
1715654409106,MATH 197,003,628552,Dumitriu; Ioana,9998,0,9999,1
1715654409106,MATH 197,004,660885,Floyd; Eric,9998,0,9999,1
1715654410135,MCWP 40R,A00,518780,Staff,1,0,20,19
1715654410135,MCWP 40R,B00,518781,Carter; Jennifer A,9,0,20,11
1715654410135,MCWP 40R,C00,518783,Smith; Haydee Marie,5,0,20,15
1715654411163,MCWP 50R,A00,518791,Redela; Pamela Morgan,0,1,20,20
1715654411163,MCWP 50R,B00,518792,Krone; Jarret,0,2,20,20
1715654411163,MCWP 50R,C00,518793,Staff,0,4,20,20
1715654411163,MCWP 50R,D00,518794,Morshed; Michael James,0,2,20,20
1715654411163,MCWP 50R,E00,518795,Carter; Andrea L,0,2,20,20
1715654411163,MCWP 50R,F00,518796,Miller; Elizabeth Deen,0,1,20,20
1715654411163,MCWP 50R,G00,518797,Guillen; Melinda,0,1,20,20
1715654412188,MMW 12R,A01,514034,Herbst; Matthew,0,2,16,16
1715654412188,MMW 12R,A02,514035,Herbst; Matthew,0,0,16,16
1715654413218,MMW 13R,A01,514037,Staff,0,5,16,16
1715654413218,MMW 13R,A02,514039,Staff,0,5,16,16
1715654413218,MMW 13R,A03,628519,Staff,0,4,16,16
1715654415272,SIO 295LS,A00,523233,Staff,10,0,30,20
1715654416297,SIO 295S,A00,523232,Staff,10,0,30,20
1715654417324,SIOC 290S,A01,637330,Merrifield; Mark A,21,0,30,9
1715654418352,SIOC 291S,A01,637333,Gabriel; Corey John,21,0,30,9
1715654419377,SOCI 117,A01,494376,Staff,0,5,5,5
1715654420401,WES 237B,A00,494380,Staff,10,0,20,10
1715654422469,AESE 279B,A00,494370,Wade; Jon P,0,0,33,33
1715654423494,AIP 97,001,660915,Van Den Einde; Yael Dahlia,9998,0,9999,1
1715654424522,AIP 197,001,627712,Vespa; Emanuel Ignacio,9995,0,9999,4
1715654424522,AIP 197,002,650778,Amir; On,9998,0,9999,1
1715654424522,AIP 197,003,650933,Avenancio-Leon; Carlos,9998,0,9999,1
1715654424522,AIP 197,004,658530,Heyman; Gail D.,9998,0,9999,1
1715654424522,AIP 197,005,658631,Neal; Sonya E,9998,0,9999,1
1715654424522,AIP 197,006,658671,Du; Songzi,9998,0,9999,1
1715654425548,ANAR 135S,A00,494369,Braswell; Geoffrey E.,0,0,0,0
1715654426574,BENG 196,001,628496,Engler; Adam J.,9998,0,9999,1
1715654426574,BENG 196,002,660916,Watson; John Thomas,9998,0,9999,1
1715654427603,BISP 197,001,650773,Wilhelm; James E.,9994,0,9999,5
1715654427603,BISP 197,002,658904,Coleman; Aaron B.,9998,0,9999,1
1715654428630,CAT 124RS,A01,519847,Geibel; William,0,0,20,20
1715654429658,CAT 125RS,A01,515971,Geibel; William,0,0,20,20
1715654430687,CLRE 250,A00,511389,Morris; Sheldon,9992,0,9999,7
1715654431717,CLRE 251,A00,507176,Mehta; Ravindra L.,9992,0,9999,7
1715654431717,CLRE 251,B00,511410,Mehta; Ravindra L.,9998,0,9999,1
1715654432743,CLRE 252,A00,507189,Cuomo; Raphael Eduardo,9994,0,9999,5
1715654433770,CLRE 253,A00,507199,Vaida; Florin,9994,0,9999,5
1715654433770,CLRE 253,B00,507202,Vaida; Florin,9999,0,9999,0
1715654434796,CLRE 259,A00,507211,Patel; Hemal,9996,0,9999,3
1715654435822,CLRE 260,A00,507221,Cuomo; Raphael Eduardo,9999,0,9999,0
1715654436848,CLRE 297,001,507242,Cuomo; Raphael Eduardo,9999,0,9999,0
1715654437872,COGS 197,001,638244,Voytek; Bradley Thomas,9997,0,9999,2
1715654438902,CSE 191,A00,516875,Minnes Kemp; Mor Mia,9991,0,9999,8
1715654439927,CSE 197,001,637388,Minnes Kemp; Mor Mia,9992,0,9999,7
1715654440953,CSS 201S,A01,494383,Mignozzetti; Umberto,35,0,35,0
1715654441979,CSS 202S,A01,494387,Mignozzetti; Umberto,35,0,35,0
1715654443004,DSC 197,001,628532,Eldridge; Justin Matthew,9995,0,9999,4
1715654444031,EAP 100,A00,516065,Staff,9799,0,9999,200
1715654445065,ECE 45,A01,507414,Staff,32,0,60,28
1715654447121,ECE 111,A01,507420,Staff,11,0,50,39
1715654448146,ECE 197,001,548057,Sievenpiper; Daniel F.,9991,0,9999,8
1715654449175,EDS 115,A00,507243,Choi; Bailey Miyeon,6,0,28,22
1715654450202,EDS 117,A01,494379,Staff,0,6,34,35
1715654451229,EDS 125,A00,507246,Hopkins; Megan Beth,7,0,30,23
1715654452258,EDS 128A,A01,507264,Fargason; Sharon Gayle,5,0,26,21
1715654453288,EDS 128B,A01,507293,Pappas; Elizabeth,9,0,30,21
1715654454314,EDS 139,A00,507294,Fargason; Sharon Gayle,9,0,30,21
1715654454314,EDS 139,B00,507313,Pappas; Elizabeth,9,0,30,21
1715654455340,EDS 201,A00,507315,Staff,10,0,30,20
1715654456370,EDS 203,A01,507317,Halter; Christopher P.,10,0,30,20
1715654457400,EDS 204R,A01,507319,Halter; Christopher P.,0,3,30,30
1715654457400,EDS 204R,B01,507331,Heinzman; Erica M.,14,0,30,16
1715654458426,EDS 206R,A00,507332,Staff,0,4,30,30
1715654458426,EDS 206R,B00,507343,Staff,15,0,30,15
1715654459456,EDS 250,A00,507344,Hemans; Patricia Ann Benitez,20,0,40,20
1715654460480,EDS 281,A00,507345,Daly; Alan J.,18,0,18,0
1715654461508,EDS 284,A00,507350,Daly; Alan J.,16,0,16,0
1715654462534,EDS 286,A00,507359,Fine; Sarah,18,0,18,0
1715654463560,EDS 289C,A01,507361,Daly; Alan J.,18,0,18,0
1715654464588,EDS 290,A00,507366,Hofstetter; Carolyn,15,0,15,0
1715654465615,LIGM 5A,A00,507421,Fischer-Grunski; Eva K,17,0,20,3
1715654466640,LIGM 5B,A00,507423,Fischer-Grunski; Eva K,19,0,20,1
1715654467664,LIGM 5C,A00,507425,Fischer-Grunski; Eva K,19,0,20,1
1715654468692,LIIT 5AS,A00,507427,Carnelos; Chiara,20,0,20,0
1715654469722,LIIT 5BS,A00,507430,Carnelos; Chiara,20,0,20,0
1715654470746,LIIT 5CS,A00,507432,Carnelos; Chiara,20,0,20,0
1715654471930,LISP 5A,A00,507541,Munoz Sanchez; Alicia,11,0,20,9
1715654472961,LISP 5B,A00,507671,Munoz Sanchez; Alicia,8,0,20,12
1715654473986,LISP 5C,A00,507696,Munoz Sanchez; Alicia,8,0,20,12
1715654475016,MAE 197,001,528363,Boechler; Nicholas Sebastia,9998,0,9999,1
1715654476046,MATH 197,001,523477,Kedlaya; Kiran S.,9994,0,9999,5
1715654476046,MATH 197,002,563811,Zhang; Danna,9994,0,9999,5
1715654476046,MATH 197,003,628552,Dumitriu; Ioana,9998,0,9999,1
1715654476046,MATH 197,004,660885,Floyd; Eric,9998,0,9999,1
1715654477074,MCWP 40R,A00,518780,Staff,1,0,20,19
1715654477074,MCWP 40R,B00,518781,Carter; Jennifer A,9,0,20,11
1715654477074,MCWP 40R,C00,518783,Smith; Haydee Marie,5,0,20,15
1715654478111,MCWP 50R,A00,518791,Redela; Pamela Morgan,0,1,20,20
1715654478111,MCWP 50R,B00,518792,Krone; Jarret,0,2,20,20
1715654478111,MCWP 50R,C00,518793,Staff,0,4,20,20
1715654478111,MCWP 50R,D00,518794,Morshed; Michael James,0,2,20,20
1715654478111,MCWP 50R,E00,518795,Carter; Andrea L,0,2,20,20
1715654478111,MCWP 50R,F00,518796,Miller; Elizabeth Deen,0,1,20,20
1715654478111,MCWP 50R,G00,518797,Guillen; Melinda,0,1,20,20
1715654479138,MMW 12R,A01,514034,Herbst; Matthew,0,2,16,16
1715654479138,MMW 12R,A02,514035,Herbst; Matthew,0,0,16,16
1715654480164,MMW 13R,A01,514037,Staff,0,5,16,16
1715654480164,MMW 13R,A02,514039,Staff,0,5,16,16
1715654480164,MMW 13R,A03,628519,Staff,0,4,16,16
1715654482217,SIO 295LS,A00,523233,Staff,10,0,30,20
1715654483241,SIO 295S,A00,523232,Staff,10,0,30,20
1715654484268,SIOC 290S,A01,637330,Merrifield; Mark A,21,0,30,9
1715654485293,SIOC 291S,A01,637333,Gabriel; Corey John,21,0,30,9
1715654486320,SOCI 117,A01,494376,Staff,0,5,5,5
1715654487346,WES 237B,A00,494380,Staff,10,0,20,10
1715654489428,AESE 279B,A00,494370,Wade; Jon P,0,0,33,33
1715654490455,AIP 97,001,660915,Van Den Einde; Yael Dahlia,9998,0,9999,1
1715654491482,AIP 197,001,627712,Vespa; Emanuel Ignacio,9995,0,9999,4
1715654491482,AIP 197,002,650778,Amir; On,9998,0,9999,1
1715654491482,AIP 197,003,650933,Avenancio-Leon; Carlos,9998,0,9999,1
1715654491482,AIP 197,004,658530,Heyman; Gail D.,9998,0,9999,1
1715654491482,AIP 197,005,658631,Neal; Sonya E,9998,0,9999,1
1715654491482,AIP 197,006,658671,Du; Songzi,9998,0,9999,1
1715654492506,ANAR 135S,A00,494369,Braswell; Geoffrey E.,0,0,0,0
1715654493538,BENG 196,001,628496,Engler; Adam J.,9998,0,9999,1
1715654493538,BENG 196,002,660916,Watson; John Thomas,9998,0,9999,1
1715654494567,BISP 197,001,650773,Wilhelm; James E.,9994,0,9999,5
1715654494567,BISP 197,002,658904,Coleman; Aaron B.,9998,0,9999,1
1715654495592,CAT 124RS,A01,519847,Geibel; William,0,0,20,20
1715654496620,CAT 125RS,A01,515971,Geibel; William,0,0,20,20
1715654497646,CLRE 250,A00,511389,Morris; Sheldon,9992,0,9999,7
1715654498674,CLRE 251,A00,507176,Mehta; Ravindra L.,9992,0,9999,7
1715654498674,CLRE 251,B00,511410,Mehta; Ravindra L.,9998,0,9999,1
1715654499704,CLRE 252,A00,507189,Cuomo; Raphael Eduardo,9994,0,9999,5
1715654500732,CLRE 253,A00,507199,Vaida; Florin,9994,0,9999,5
1715654500732,CLRE 253,B00,507202,Vaida; Florin,9999,0,9999,0
1715654501757,CLRE 259,A00,507211,Patel; Hemal,9996,0,9999,3
1715654502784,CLRE 260,A00,507221,Cuomo; Raphael Eduardo,9999,0,9999,0
1715654503811,CLRE 297,001,507242,Cuomo; Raphael Eduardo,9999,0,9999,0
1715654504838,COGS 197,001,638244,Voytek; Bradley Thomas,9997,0,9999,2
1715654505864,CSE 191,A00,516875,Minnes Kemp; Mor Mia,9991,0,9999,8
1715654506897,CSE 197,001,637388,Minnes Kemp; Mor Mia,9992,0,9999,7
1715654507928,CSS 201S,A01,494383,Mignozzetti; Umberto,35,0,35,0
1715654508956,CSS 202S,A01,494387,Mignozzetti; Umberto,35,0,35,0
1715654509980,DSC 197,001,628532,Eldridge; Justin Matthew,9995,0,9999,4
1715654511003,EAP 100,A00,516065,Staff,9799,0,9999,200
1715654512036,ECE 45,A01,507414,Staff,32,0,60,28
1715654514089,ECE 111,A01,507420,Staff,11,0,50,39
1715654515115,ECE 197,001,548057,Sievenpiper; Daniel F.,9991,0,9999,8
1715654516142,EDS 115,A00,507243,Choi; Bailey Miyeon,6,0,28,22
1715654517170,EDS 117,A01,494379,Staff,0,6,34,35
1715654518196,EDS 125,A00,507246,Hopkins; Megan Beth,7,0,30,23
1715654519224,EDS 128A,A01,507264,Fargason; Sharon Gayle,5,0,26,21
1715654520250,EDS 128B,A01,507293,Pappas; Elizabeth,9,0,30,21
1715654521274,EDS 139,A00,507294,Fargason; Sharon Gayle,9,0,30,21
1715654521274,EDS 139,B00,507313,Pappas; Elizabeth,9,0,30,21
1715654522304,EDS 201,A00,507315,Staff,10,0,30,20
1715654523334,EDS 203,A01,507317,Halter; Christopher P.,10,0,30,20
1715654524361,EDS 204R,A01,507319,Halter; Christopher P.,0,3,30,30
1715654524361,EDS 204R,B01,507331,Heinzman; Erica M.,14,0,30,16
1715654525383,EDS 206R,A00,507332,Staff,0,4,30,30
1715654525383,EDS 206R,B00,507343,Staff,15,0,30,15
1715654526409,EDS 250,A00,507344,Hemans; Patricia Ann Benitez,20,0,40,20
1715654527439,EDS 281,A00,507345,Daly; Alan J.,18,0,18,0
1715654528468,EDS 284,A00,507350,Daly; Alan J.,16,0,16,0
1715654529517,EDS 286,A00,507359,Fine; Sarah,18,0,18,0
1715654530545,EDS 289C,A01,507361,Daly; Alan J.,18,0,18,0
1715654531571,EDS 290,A00,507366,Hofstetter; Carolyn,15,0,15,0
1715654532602,LIGM 5A,A00,507421,Fischer-Grunski; Eva K,17,0,20,3
1715654533631,LIGM 5B,A00,507423,Fischer-Grunski; Eva K,19,0,20,1
1715654534656,LIGM 5C,A00,507425,Fischer-Grunski; Eva K,19,0,20,1
1715654535681,LIIT 5AS,A00,507427,Carnelos; Chiara,20,0,20,0
1715654536705,LIIT 5BS,A00,507430,Carnelos; Chiara,20,0,20,0
1715654537734,LIIT 5CS,A00,507432,Carnelos; Chiara,20,0,20,0
1715654538762,LISP 5A,A00,507541,Munoz Sanchez; Alicia,11,0,20,9
1715654539789,LISP 5B,A00,507671,Munoz Sanchez; Alicia,8,0,20,12
1715654540817,LISP 5C,A00,507696,Munoz Sanchez; Alicia,8,0,20,12
1715654541842,MAE 197,001,528363,Boechler; Nicholas Sebastia,9998,0,9999,1
1715654542875,MATH 197,001,523477,Kedlaya; Kiran S.,9994,0,9999,5
1715654542875,MATH 197,002,563811,Zhang; Danna,9994,0,9999,5
1715654542875,MATH 197,003,628552,Dumitriu; Ioana,9998,0,9999,1
1715654542875,MATH 197,004,660885,Floyd; Eric,9998,0,9999,1
1715654543905,MCWP 40R,A00,518780,Staff,1,0,20,19
1715654543905,MCWP 40R,B00,518781,Carter; Jennifer A,9,0,20,11
1715654543905,MCWP 40R,C00,518783,Smith; Haydee Marie,5,0,20,15
1715654544938,MCWP 50R,A00,518791,Redela; Pamela Morgan,0,1,20,20
1715654544938,MCWP 50R,B00,518792,Krone; Jarret,0,2,20,20
1715654544938,MCWP 50R,C00,518793,Staff,0,4,20,20
1715654544938,MCWP 50R,D00,518794,Morshed; Michael James,0,2,20,20
1715654544938,MCWP 50R,E00,518795,Carter; Andrea L,0,2,20,20
1715654544938,MCWP 50R,F00,518796,Miller; Elizabeth Deen,0,1,20,20
1715654544938,MCWP 50R,G00,518797,Guillen; Melinda,0,1,20,20
1715654545967,MMW 12R,A01,514034,Herbst; Matthew,0,2,16,16
1715654545967,MMW 12R,A02,514035,Herbst; Matthew,0,0,16,16
1715654546992,MMW 13R,A01,514037,Staff,0,5,16,16
1715654546992,MMW 13R,A02,514039,Staff,0,5,16,16
1715654546992,MMW 13R,A03,628519,Staff,0,4,16,16
1715654549043,SIO 295LS,A00,523233,Staff,10,0,30,20
1715654550069,SIO 295S,A00,523232,Staff,10,0,30,20
1715654551099,SIOC 290S,A01,637330,Merrifield; Mark A,21,0,30,9
1715654552125,SIOC 291S,A01,637333,Gabriel; Corey John,21,0,30,9
1715654553153,SOCI 117,A01,494376,Staff,0,5,5,5
1715654554180,WES 237B,A00,494380,Staff,10,0,20,10
1715654556252,AESE 279B,A00,494370,Wade; Jon P,0,0,33,33
1715654557280,AIP 97,001,660915,Van Den Einde; Yael Dahlia,9998,0,9999,1
1715654558309,AIP 197,001,627712,Vespa; Emanuel Ignacio,9995,0,9999,4
1715654558309,AIP 197,002,650778,Amir; On,9998,0,9999,1
1715654558309,AIP 197,003,650933,Avenancio-Leon; Carlos,9998,0,9999,1
1715654558309,AIP 197,004,658530,Heyman; Gail D.,9998,0,9999,1
1715654558309,AIP 197,005,658631,Neal; Sonya E,9998,0,9999,1
1715654558309,AIP 197,006,658671,Du; Songzi,9998,0,9999,1
1715654559336,ANAR 135S,A00,494369,Braswell; Geoffrey E.,0,0,0,0
1715654560366,BENG 196,001,628496,Engler; Adam J.,9998,0,9999,1
1715654560366,BENG 196,002,660916,Watson; John Thomas,9998,0,9999,1
1715654561396,BISP 197,001,650773,Wilhelm; James E.,9994,0,9999,5
1715654561396,BISP 197,002,658904,Coleman; Aaron B.,9998,0,9999,1
1715654562421,CAT 124RS,A01,519847,Geibel; William,0,0,20,20
1715654563447,CAT 125RS,A01,515971,Geibel; William,0,0,20,20
1715654564473,CLRE 250,A00,511389,Morris; Sheldon,9992,0,9999,7
1715654565503,CLRE 251,A00,507176,Mehta; Ravindra L.,9992,0,9999,7
1715654565503,CLRE 251,B00,511410,Mehta; Ravindra L.,9998,0,9999,1
1715654566529,CLRE 252,A00,507189,Cuomo; Raphael Eduardo,9994,0,9999,5
1715654567555,CLRE 253,A00,507199,Vaida; Florin,9994,0,9999,5
1715654567555,CLRE 253,B00,507202,Vaida; Florin,9999,0,9999,0
1715654568583,CLRE 259,A00,507211,Patel; Hemal,9996,0,9999,3
1715654569612,CLRE 260,A00,507221,Cuomo; Raphael Eduardo,9999,0,9999,0
1715654570636,CLRE 297,001,507242,Cuomo; Raphael Eduardo,9999,0,9999,0
1715654571665,COGS 197,001,638244,Voytek; Bradley Thomas,9997,0,9999,2
1715654572690,CSE 191,A00,516875,Minnes Kemp; Mor Mia,9991,0,9999,8
1715654573717,CSE 197,001,637388,Minnes Kemp; Mor Mia,9992,0,9999,7
1715654574743,CSS 201S,A01,494383,Mignozzetti; Umberto,35,0,35,0
1715654575768,CSS 202S,A01,494387,Mignozzetti; Umberto,35,0,35,0
1715654576794,DSC 197,001,628532,Eldridge; Justin Matthew,9995,0,9999,4
1715654577820,EAP 100,A00,516065,Staff,9799,0,9999,200
1715654578845,ECE 45,A01,507414,Staff,32,0,60,28
1715654580892,ECE 111,A01,507420,Staff,11,0,50,39
1715654581919,ECE 197,001,548057,Sievenpiper; Daniel F.,9991,0,9999,8
1715654582951,EDS 115,A00,507243,Choi; Bailey Miyeon,6,0,28,22
1715654583979,EDS 117,A01,494379,Staff,0,6,34,35
1715654585006,EDS 125,A00,507246,Hopkins; Megan Beth,7,0,30,23
1715654586031,EDS 128A,A01,507264,Fargason; Sharon Gayle,5,0,26,21
1715654587060,EDS 128B,A01,507293,Pappas; Elizabeth,9,0,30,21
1715654588086,EDS 139,A00,507294,Fargason; Sharon Gayle,9,0,30,21
1715654588086,EDS 139,B00,507313,Pappas; Elizabeth,9,0,30,21
1715654589725,EDS 201,A00,507315,Staff,10,0,30,20
1715654590883,EDS 203,A01,507317,Halter; Christopher P.,10,0,30,20
1715654591911,EDS 204R,A01,507319,Halter; Christopher P.,0,3,30,30
1715654591911,EDS 204R,B01,507331,Heinzman; Erica M.,14,0,30,16
1715654592936,EDS 206R,A00,507332,Staff,0,4,30,30
1715654592936,EDS 206R,B00,507343,Staff,15,0,30,15
1715654593960,EDS 250,A00,507344,Hemans; Patricia Ann Benitez,20,0,40,20
1715654594984,EDS 281,A00,507345,Daly; Alan J.,18,0,18,0
1715654596013,EDS 284,A00,507350,Daly; Alan J.,16,0,16,0
1715654597041,EDS 286,A00,507359,Fine; Sarah,18,0,18,0
1715654598067,EDS 289C,A01,507361,Daly; Alan J.,18,0,18,0
1715654599096,EDS 290,A00,507366,Hofstetter; Carolyn,15,0,15,0
1715654600124,LIGM 5A,A00,507421,Fischer-Grunski; Eva K,17,0,20,3
1715654601153,LIGM 5B,A00,507423,Fischer-Grunski; Eva K,19,0,20,1
1715654602179,LIGM 5C,A00,507425,Fischer-Grunski; Eva K,19,0,20,1
1715654603207,LIIT 5AS,A00,507427,Carnelos; Chiara,20,0,20,0
1715654604236,LIIT 5BS,A00,507430,Carnelos; Chiara,20,0,20,0
1715654605264,LIIT 5CS,A00,507432,Carnelos; Chiara,20,0,20,0
1715654606295,LISP 5A,A00,507541,Munoz Sanchez; Alicia,11,0,20,9
1715654607325,LISP 5B,A00,507671,Munoz Sanchez; Alicia,8,0,20,12
1715654608354,LISP 5C,A00,507696,Munoz Sanchez; Alicia,8,0,20,12
1715654609382,MAE 197,001,528363,Boechler; Nicholas Sebastia,9998,0,9999,1
1715654610412,MATH 197,001,523477,Kedlaya; Kiran S.,9994,0,9999,5
1715654610412,MATH 197,002,563811,Zhang; Danna,9994,0,9999,5
1715654610412,MATH 197,003,628552,Dumitriu; Ioana,9998,0,9999,1
1715654610412,MATH 197,004,660885,Floyd; Eric,9998,0,9999,1
1715654611444,MCWP 40R,A00,518780,Staff,1,0,20,19
1715654611444,MCWP 40R,B00,518781,Carter; Jennifer A,9,0,20,11
1715654611444,MCWP 40R,C00,518783,Smith; Haydee Marie,5,0,20,15
1715654612471,MCWP 50R,A00,518791,Redela; Pamela Morgan,0,1,20,20
1715654612471,MCWP 50R,B00,518792,Krone; Jarret,0,2,20,20
1715654612471,MCWP 50R,C00,518793,Staff,0,4,20,20
1715654612471,MCWP 50R,D00,518794,Morshed; Michael James,0,2,20,20
1715654612471,MCWP 50R,E00,518795,Carter; Andrea L,0,2,20,20
1715654612471,MCWP 50R,F00,518796,Miller; Elizabeth Deen,0,1,20,20
1715654612471,MCWP 50R,G00,518797,Guillen; Melinda,0,1,20,20
1715654613496,MMW 12R,A01,514034,Herbst; Matthew,0,2,16,16
1715654613496,MMW 12R,A02,514035,Herbst; Matthew,0,0,16,16
1715654614525,MMW 13R,A01,514037,Staff,0,5,16,16
1715654614525,MMW 13R,A02,514039,Staff,0,5,16,16
1715654614525,MMW 13R,A03,628519,Staff,0,4,16,16
1715654616579,SIO 295LS,A00,523233,Staff,10,0,30,20
1715654617604,SIO 295S,A00,523232,Staff,10,0,30,20
1715654618630,SIOC 290S,A01,637330,Merrifield; Mark A,21,0,30,9
1715654619657,SIOC 291S,A01,637333,Gabriel; Corey John,21,0,30,9
1715654620686,SOCI 117,A01,494376,Staff,0,5,5,5
1715654621711,WES 237B,A00,494380,Staff,10,0,20,10
1715654623787,AESE 279B,A00,494370,Wade; Jon P,0,0,33,33
1715654624820,AIP 97,001,660915,Van Den Einde; Yael Dahlia,9998,0,9999,1
1715654625856,AIP 197,001,627712,Vespa; Emanuel Ignacio,9995,0,9999,4
1715654625856,AIP 197,002,650778,Amir; On,9998,0,9999,1
1715654625856,AIP 197,003,650933,Avenancio-Leon; Carlos,9998,0,9999,1
1715654625856,AIP 197,004,658530,Heyman; Gail D.,9998,0,9999,1
1715654625856,AIP 197,005,658631,Neal; Sonya E,9998,0,9999,1
1715654625856,AIP 197,006,658671,Du; Songzi,9998,0,9999,1
1715654626881,ANAR 135S,A00,494369,Braswell; Geoffrey E.,0,0,0,0
1715654627911,BENG 196,001,628496,Engler; Adam J.,9998,0,9999,1
1715654627911,BENG 196,002,660916,Watson; John Thomas,9998,0,9999,1
1715654628937,BISP 197,001,650773,Wilhelm; James E.,9994,0,9999,5
1715654628937,BISP 197,002,658904,Coleman; Aaron B.,9998,0,9999,1
1715654629966,CAT 124RS,A01,519847,Geibel; William,0,0,20,20
1715654630992,CAT 125RS,A01,515971,Geibel; William,0,0,20,20
1715654632022,CLRE 250,A00,511389,Morris; Sheldon,9992,0,9999,7
1715654633048,CLRE 251,A00,507176,Mehta; Ravindra L.,9992,0,9999,7
1715654633048,CLRE 251,B00,511410,Mehta; Ravindra L.,9998,0,9999,1
1715654634075,CLRE 252,A00,507189,Cuomo; Raphael Eduardo,9994,0,9999,5
1715654635104,CLRE 253,A00,507199,Vaida; Florin,9994,0,9999,5
1715654635104,CLRE 253,B00,507202,Vaida; Florin,9999,0,9999,0
1715654636134,CLRE 259,A00,507211,Patel; Hemal,9996,0,9999,3
1715654637159,CLRE 260,A00,507221,Cuomo; Raphael Eduardo,9999,0,9999,0
1715654638182,CLRE 297,001,507242,Cuomo; Raphael Eduardo,9999,0,9999,0
1715654639209,COGS 197,001,638244,Voytek; Bradley Thomas,9997,0,9999,2
1715654640235,CSE 191,A00,516875,Minnes Kemp; Mor Mia,9991,0,9999,8
1715654641262,CSE 197,001,637388,Minnes Kemp; Mor Mia,9992,0,9999,7
1715654642293,CSS 201S,A01,494383,Mignozzetti; Umberto,35,0,35,0
1715654643319,CSS 202S,A01,494387,Mignozzetti; Umberto,35,0,35,0
1715654644348,DSC 197,001,628532,Eldridge; Justin Matthew,9995,0,9999,4
1715654645373,EAP 100,A00,516065,Staff,9799,0,9999,200
1715654646403,ECE 45,A01,507414,Staff,32,0,60,28
1715654648455,ECE 111,A01,507420,Staff,11,0,50,39
1715654649481,ECE 197,001,548057,Sievenpiper; Daniel F.,9991,0,9999,8
1715654650510,EDS 115,A00,507243,Choi; Bailey Miyeon,6,0,28,22
1715654651537,EDS 117,A01,494379,Staff,0,6,34,35
1715654652566,EDS 125,A00,507246,Hopkins; Megan Beth,7,0,30,23
1715654653592,EDS 128A,A01,507264,Fargason; Sharon Gayle,5,0,26,21
1715654654618,EDS 128B,A01,507293,Pappas; Elizabeth,9,0,30,21
1715654655643,EDS 139,A00,507294,Fargason; Sharon Gayle,9,0,30,21
1715654655643,EDS 139,B00,507313,Pappas; Elizabeth,9,0,30,21
1715654656672,EDS 201,A00,507315,Staff,10,0,30,20
1715654657696,EDS 203,A01,507317,Halter; Christopher P.,10,0,30,20
1715654658723,EDS 204R,A01,507319,Halter; Christopher P.,0,3,30,30
1715654658723,EDS 204R,B01,507331,Heinzman; Erica M.,14,0,30,16
1715654659748,EDS 206R,A00,507332,Staff,0,4,30,30
1715654659748,EDS 206R,B00,507343,Staff,15,0,30,15
1715654660774,EDS 250,A00,507344,Hemans; Patricia Ann Benitez,20,0,40,20
1715654661801,EDS 281,A00,507345,Daly; Alan J.,18,0,18,0
1715654662828,EDS 284,A00,507350,Daly; Alan J.,16,0,16,0
1715654663902,EDS 286,A00,507359,Fine; Sarah,18,0,18,0
1715654664927,EDS 289C,A01,507361,Daly; Alan J.,18,0,18,0
1715654665953,EDS 290,A00,507366,Hofstetter; Carolyn,15,0,15,0
1715654666982,LIGM 5A,A00,507421,Fischer-Grunski; Eva K,17,0,20,3
1715654668008,LIGM 5B,A00,507423,Fischer-Grunski; Eva K,19,0,20,1
1715654669033,LIGM 5C,A00,507425,Fischer-Grunski; Eva K,19,0,20,1
1715654670064,LIIT 5AS,A00,507427,Carnelos; Chiara,20,0,20,0
1715654671089,LIIT 5BS,A00,507430,Carnelos; Chiara,20,0,20,0
1715654672115,LIIT 5CS,A00,507432,Carnelos; Chiara,20,0,20,0
1715654673141,LISP 5A,A00,507541,Munoz Sanchez; Alicia,11,0,20,9
1715654674168,LISP 5B,A00,507671,Munoz Sanchez; Alicia,8,0,20,12
1715654675193,LISP 5C,A00,507696,Munoz Sanchez; Alicia,8,0,20,12
1715654676223,MAE 197,001,528363,Boechler; Nicholas Sebastia,9998,0,9999,1
1715654677253,MATH 197,001,523477,Kedlaya; Kiran S.,9994,0,9999,5
1715654677253,MATH 197,002,563811,Zhang; Danna,9994,0,9999,5
1715654677253,MATH 197,003,628552,Dumitriu; Ioana,9998,0,9999,1
1715654677253,MATH 197,004,660885,Floyd; Eric,9998,0,9999,1
1715654678284,MCWP 40R,A00,518780,Staff,1,0,20,19
1715654678284,MCWP 40R,B00,518781,Carter; Jennifer A,9,0,20,11
1715654678284,MCWP 40R,C00,518783,Smith; Haydee Marie,5,0,20,15
1715654679316,MCWP 50R,A00,518791,Redela; Pamela Morgan,0,1,20,20
1715654679316,MCWP 50R,B00,518792,Krone; Jarret,0,2,20,20
1715654679316,MCWP 50R,C00,518793,Staff,0,4,20,20
1715654679316,MCWP 50R,D00,518794,Morshed; Michael James,0,2,20,20
1715654679316,MCWP 50R,E00,518795,Carter; Andrea L,0,2,20,20
1715654679316,MCWP 50R,F00,518796,Miller; Elizabeth Deen,0,1,20,20
1715654679316,MCWP 50R,G00,518797,Guillen; Melinda,0,1,20,20
1715654680345,MMW 12R,A01,514034,Herbst; Matthew,0,2,16,16
1715654680345,MMW 12R,A02,514035,Herbst; Matthew,0,0,16,16
1715654681375,MMW 13R,A01,514037,Staff,0,5,16,16
1715654681375,MMW 13R,A02,514039,Staff,0,5,16,16
1715654681375,MMW 13R,A03,628519,Staff,0,4,16,16
1715654683479,SIO 295LS,A00,523233,Staff,10,0,30,20
1715654684503,SIO 295S,A00,523232,Staff,10,0,30,20
1715654685532,SIOC 290S,A01,637330,Merrifield; Mark A,21,0,30,9
1715654686562,SIOC 291S,A01,637333,Gabriel; Corey John,21,0,30,9
1715654687591,SOCI 117,A01,494376,Staff,0,5,5,5
1715654688618,WES 237B,A00,494380,Staff,10,0,20,10
1715654690696,AESE 279B,A00,494370,Wade; Jon P,0,0,33,33
1715654691725,AIP 97,001,660915,Van Den Einde; Yael Dahlia,9998,0,9999,1
1715654692757,AIP 197,001,627712,Vespa; Emanuel Ignacio,9995,0,9999,4
1715654692757,AIP 197,002,650778,Amir; On,9998,0,9999,1
1715654692757,AIP 197,003,650933,Avenancio-Leon; Carlos,9998,0,9999,1
1715654692757,AIP 197,004,658530,Heyman; Gail D.,9998,0,9999,1
1715654692757,AIP 197,005,658631,Neal; Sonya E,9998,0,9999,1
1715654692757,AIP 197,006,658671,Du; Songzi,9998,0,9999,1
1715654693784,ANAR 135S,A00,494369,Braswell; Geoffrey E.,0,0,0,0
1715654694810,BENG 196,001,628496,Engler; Adam J.,9998,0,9999,1
1715654694810,BENG 196,002,660916,Watson; John Thomas,9998,0,9999,1
1715654695835,BISP 197,001,650773,Wilhelm; James E.,9994,0,9999,5
1715654695835,BISP 197,002,658904,Coleman; Aaron B.,9998,0,9999,1
1715654696864,CAT 124RS,A01,519847,Geibel; William,0,0,20,20
1715654697889,CAT 125RS,A01,515971,Geibel; William,0,0,20,20
1715654698917,CLRE 250,A00,511389,Morris; Sheldon,9992,0,9999,7
1715654699944,CLRE 251,A00,507176,Mehta; Ravindra L.,9992,0,9999,7
1715654699944,CLRE 251,B00,511410,Mehta; Ravindra L.,9998,0,9999,1
1715654700975,CLRE 252,A00,507189,Cuomo; Raphael Eduardo,9994,0,9999,5
1715654702005,CLRE 253,A00,507199,Vaida; Florin,9994,0,9999,5
1715654702005,CLRE 253,B00,507202,Vaida; Florin,9999,0,9999,0
1715654703032,CLRE 259,A00,507211,Patel; Hemal,9996,0,9999,3
1715654704059,CLRE 260,A00,507221,Cuomo; Raphael Eduardo,9999,0,9999,0
1715654705083,CLRE 297,001,507242,Cuomo; Raphael Eduardo,9999,0,9999,0
1715654706113,COGS 197,001,638244,Voytek; Bradley Thomas,9997,0,9999,2
1715654707139,CSE 191,A00,516875,Minnes Kemp; Mor Mia,9991,0,9999,8
1715654708166,CSE 197,001,637388,Minnes Kemp; Mor Mia,9992,0,9999,7
1715654709194,CSS 201S,A01,494383,Mignozzetti; Umberto,35,0,35,0
1715654710224,CSS 202S,A01,494387,Mignozzetti; Umberto,35,0,35,0
1715654711252,DSC 197,001,628532,Eldridge; Justin Matthew,9995,0,9999,4
1715654712281,EAP 100,A00,516065,Staff,9799,0,9999,200
1715654713307,ECE 45,A01,507414,Staff,32,0,60,28
1715654715359,ECE 111,A01,507420,Staff,11,0,50,39
1715654716386,ECE 197,001,548057,Sievenpiper; Daniel F.,9991,0,9999,8
1715654717411,EDS 115,A00,507243,Choi; Bailey Miyeon,6,0,28,22
1715654718440,EDS 117,A01,494379,Staff,0,6,34,35
1715654719469,EDS 125,A00,507246,Hopkins; Megan Beth,7,0,30,23
1715654720496,EDS 128A,A01,507264,Fargason; Sharon Gayle,5,0,26,21
1715654721522,EDS 128B,A01,507293,Pappas; Elizabeth,9,0,30,21
1715654722550,EDS 139,A00,507294,Fargason; Sharon Gayle,9,0,30,21
1715654722550,EDS 139,B00,507313,Pappas; Elizabeth,9,0,30,21
1715654723579,EDS 201,A00,507315,Staff,10,0,30,20
1715654724604,EDS 203,A01,507317,Halter; Christopher P.,10,0,30,20
1715654725634,EDS 204R,A01,507319,Halter; Christopher P.,0,3,30,30
1715654725634,EDS 204R,B01,507331,Heinzman; Erica M.,14,0,30,16
1715654726660,EDS 206R,A00,507332,Staff,0,4,30,30
1715654726660,EDS 206R,B00,507343,Staff,15,0,30,15
1715654727686,EDS 250,A00,507344,Hemans; Patricia Ann Benitez,20,0,40,20
1715654728712,EDS 281,A00,507345,Daly; Alan J.,18,0,18,0
1715654729740,EDS 284,A00,507350,Daly; Alan J.,16,0,16,0
1715654730769,EDS 286,A00,507359,Fine; Sarah,18,0,18,0
1715654731796,EDS 289C,A01,507361,Daly; Alan J.,18,0,18,0
1715654732826,EDS 290,A00,507366,Hofstetter; Carolyn,15,0,15,0
1715654733854,LIGM 5A,A00,507421,Fischer-Grunski; Eva K,17,0,20,3
1715654734885,LIGM 5B,A00,507423,Fischer-Grunski; Eva K,19,0,20,1
1715654735909,LIGM 5C,A00,507425,Fischer-Grunski; Eva K,19,0,20,1
1715654736936,LIIT 5AS,A00,507427,Carnelos; Chiara,20,0,20,0
1715654737964,LIIT 5BS,A00,507430,Carnelos; Chiara,20,0,20,0
1715654738990,LIIT 5CS,A00,507432,Carnelos; Chiara,20,0,20,0
1715654740016,LISP 5A,A00,507541,Munoz Sanchez; Alicia,11,0,20,9
1715654741043,LISP 5B,A00,507671,Munoz Sanchez; Alicia,8,0,20,12
1715654742081,LISP 5C,A00,507696,Munoz Sanchez; Alicia,8,0,20,12
1715654743111,MAE 197,001,528363,Boechler; Nicholas Sebastia,9998,0,9999,1
1715654744139,MATH 197,001,523477,Kedlaya; Kiran S.,9994,0,9999,5
1715654744139,MATH 197,002,563811,Zhang; Danna,9994,0,9999,5
1715654744139,MATH 197,003,628552,Dumitriu; Ioana,9998,0,9999,1
1715654744139,MATH 197,004,660885,Floyd; Eric,9998,0,9999,1
1715654745169,MCWP 40R,A00,518780,Staff,1,0,20,19
1715654745169,MCWP 40R,B00,518781,Carter; Jennifer A,9,0,20,11
1715654745169,MCWP 40R,C00,518783,Smith; Haydee Marie,5,0,20,15
1715654746196,MCWP 50R,A00,518791,Redela; Pamela Morgan,0,1,20,20
1715654746196,MCWP 50R,B00,518792,Krone; Jarret,0,2,20,20
1715654746196,MCWP 50R,C00,518793,Staff,0,4,20,20
1715654746196,MCWP 50R,D00,518794,Morshed; Michael James,0,2,20,20
1715654746196,MCWP 50R,E00,518795,Carter; Andrea L,0,2,20,20
1715654746196,MCWP 50R,F00,518796,Miller; Elizabeth Deen,0,1,20,20
1715654746196,MCWP 50R,G00,518797,Guillen; Melinda,0,1,20,20
1715654747224,MMW 12R,A01,514034,Herbst; Matthew,0,2,16,16
1715654747224,MMW 12R,A02,514035,Herbst; Matthew,0,0,16,16
1715654748251,MMW 13R,A01,514037,Staff,0,5,16,16
1715654748251,MMW 13R,A02,514039,Staff,0,5,16,16
1715654748251,MMW 13R,A03,628519,Staff,0,4,16,16
1715654750304,SIO 295LS,A00,523233,Staff,10,0,30,20
1715654751330,SIO 295S,A00,523232,Staff,10,0,30,20
1715654752357,SIOC 290S,A01,637330,Merrifield; Mark A,21,0,30,9
1715654753383,SIOC 291S,A01,637333,Gabriel; Corey John,21,0,30,9
1715654754412,SOCI 117,A01,494376,Staff,0,5,5,5
1715654755438,WES 237B,A00,494380,Staff,10,0,20,10
1715654757526,AESE 279B,A00,494370,Wade; Jon P,0,0,33,33
1715654758551,AIP 97,001,660915,Van Den Einde; Yael Dahlia,9998,0,9999,1
1715654759579,AIP 197,001,627712,Vespa; Emanuel Ignacio,9995,0,9999,4
1715654759579,AIP 197,002,650778,Amir; On,9998,0,9999,1
1715654759579,AIP 197,003,650933,Avenancio-Leon; Carlos,9998,0,9999,1
1715654759579,AIP 197,004,658530,Heyman; Gail D.,9998,0,9999,1
1715654759579,AIP 197,005,658631,Neal; Sonya E,9998,0,9999,1
1715654759579,AIP 197,006,658671,Du; Songzi,9998,0,9999,1
1715654760604,ANAR 135S,A00,494369,Braswell; Geoffrey E.,0,0,0,0
1715654761633,BENG 196,001,628496,Engler; Adam J.,9998,0,9999,1
1715654761633,BENG 196,002,660916,Watson; John Thomas,9998,0,9999,1
1715654762660,BISP 197,001,650773,Wilhelm; James E.,9994,0,9999,5
1715654762660,BISP 197,002,658904,Coleman; Aaron B.,9998,0,9999,1
1715654763685,CAT 124RS,A01,519847,Geibel; William,0,0,20,20
1715654764711,CAT 125RS,A01,515971,Geibel; William,0,0,20,20
1715654765737,CLRE 250,A00,511389,Morris; Sheldon,9992,0,9999,7
1715654766767,CLRE 251,A00,507176,Mehta; Ravindra L.,9992,0,9999,7
1715654766767,CLRE 251,B00,511410,Mehta; Ravindra L.,9998,0,9999,1
1715654767798,CLRE 252,A00,507189,Cuomo; Raphael Eduardo,9994,0,9999,5
1715654768827,CLRE 253,A00,507199,Vaida; Florin,9994,0,9999,5
1715654768827,CLRE 253,B00,507202,Vaida; Florin,9999,0,9999,0
1715654769852,CLRE 259,A00,507211,Patel; Hemal,9996,0,9999,3
1715654770879,CLRE 260,A00,507221,Cuomo; Raphael Eduardo,9999,0,9999,0
1715654771904,CLRE 297,001,507242,Cuomo; Raphael Eduardo,9999,0,9999,0
1715654772934,COGS 197,001,638244,Voytek; Bradley Thomas,9997,0,9999,2
1715654773959,CSE 191,A00,516875,Minnes Kemp; Mor Mia,9991,0,9999,8
1715654774986,CSE 197,001,637388,Minnes Kemp; Mor Mia,9992,0,9999,7
1715654776011,CSS 201S,A01,494383,Mignozzetti; Umberto,35,0,35,0
1715654777035,CSS 202S,A01,494387,Mignozzetti; Umberto,35,0,35,0
1715654778062,DSC 197,001,628532,Eldridge; Justin Matthew,9995,0,9999,4
1715654779086,EAP 100,A00,516065,Staff,9799,0,9999,200
1715654780116,ECE 45,A01,507414,Staff,32,0,60,28
1715654782166,ECE 111,A01,507420,Staff,11,0,50,39
1715654783191,ECE 197,001,548057,Sievenpiper; Daniel F.,9991,0,9999,8
1715654784218,EDS 115,A00,507243,Choi; Bailey Miyeon,6,0,28,22
1715654785245,EDS 117,A01,494379,Staff,0,6,34,35
1715654786275,EDS 125,A00,507246,Hopkins; Megan Beth,7,0,30,23
1715654787374,EDS 128A,A01,507264,Fargason; Sharon Gayle,5,0,26,21
1715654788400,EDS 128B,A01,507293,Pappas; Elizabeth,9,0,30,21
1715654789425,EDS 139,A00,507294,Fargason; Sharon Gayle,9,0,30,21
1715654789425,EDS 139,B00,507313,Pappas; Elizabeth,9,0,30,21
1715654790453,EDS 201,A00,507315,Staff,10,0,30,20
1715654791485,EDS 203,A01,507317,Halter; Christopher P.,10,0,30,20
1715654792509,EDS 204R,A01,507319,Halter; Christopher P.,0,3,30,30
1715654792509,EDS 204R,B01,507331,Heinzman; Erica M.,14,0,30,16
1715654793540,EDS 206R,A00,507332,Staff,0,4,30,30
1715654793540,EDS 206R,B00,507343,Staff,15,0,30,15
1715654794568,EDS 250,A00,507344,Hemans; Patricia Ann Benitez,20,0,40,20
1715654795597,EDS 281,A00,507345,Daly; Alan J.,18,0,18,0
1715654796625,EDS 284,A00,507350,Daly; Alan J.,16,0,16,0
1715654797653,EDS 286,A00,507359,Fine; Sarah,18,0,18,0
1715654798678,EDS 289C,A01,507361,Daly; Alan J.,18,0,18,0
1715654799703,EDS 290,A00,507366,Hofstetter; Carolyn,15,0,15,0
1715654800732,LIGM 5A,A00,507421,Fischer-Grunski; Eva K,17,0,20,3
1715654801757,LIGM 5B,A00,507423,Fischer-Grunski; Eva K,19,0,20,1
1715654802783,LIGM 5C,A00,507425,Fischer-Grunski; Eva K,19,0,20,1
1715654803808,LIIT 5AS,A00,507427,Carnelos; Chiara,20,0,20,0
1715654804835,LIIT 5BS,A00,507430,Carnelos; Chiara,20,0,20,0
1715654805860,LIIT 5CS,A00,507432,Carnelos; Chiara,20,0,20,0
1715654806885,LISP 5A,A00,507541,Munoz Sanchez; Alicia,11,0,20,9
1715654807910,LISP 5B,A00,507671,Munoz Sanchez; Alicia,8,0,20,12
1715654808939,LISP 5C,A00,507696,Munoz Sanchez; Alicia,8,0,20,12
1715654809967,MAE 197,001,528363,Boechler; Nicholas Sebastia,9998,0,9999,1
1715654811002,MATH 197,001,523477,Kedlaya; Kiran S.,9994,0,9999,5
1715654811002,MATH 197,002,563811,Zhang; Danna,9994,0,9999,5
1715654811002,MATH 197,003,628552,Dumitriu; Ioana,9998,0,9999,1
1715654811002,MATH 197,004,660885,Floyd; Eric,9998,0,9999,1
1715654812033,MCWP 40R,A00,518780,Staff,1,0,20,19
1715654812033,MCWP 40R,B00,518781,Carter; Jennifer A,9,0,20,11
1715654812033,MCWP 40R,C00,518783,Smith; Haydee Marie,5,0,20,15
1715654813066,MCWP 50R,A00,518791,Redela; Pamela Morgan,0,1,20,20
1715654813066,MCWP 50R,B00,518792,Krone; Jarret,0,2,20,20
1715654813066,MCWP 50R,C00,518793,Staff,0,4,20,20
1715654813066,MCWP 50R,D00,518794,Morshed; Michael James,0,2,20,20
1715654813066,MCWP 50R,E00,518795,Carter; Andrea L,0,2,20,20
1715654813066,MCWP 50R,F00,518796,Miller; Elizabeth Deen,0,1,20,20
1715654813066,MCWP 50R,G00,518797,Guillen; Melinda,0,1,20,20
1715654814092,MMW 12R,A01,514034,Herbst; Matthew,0,2,16,16
1715654814092,MMW 12R,A02,514035,Herbst; Matthew,0,0,16,16
1715654815116,MMW 13R,A01,514037,Staff,0,5,16,16
1715654815116,MMW 13R,A02,514039,Staff,0,5,16,16
1715654815116,MMW 13R,A03,628519,Staff,0,4,16,16
1715654817167,SIO 295LS,A00,523233,Staff,10,0,30,20
1715654818192,SIO 295S,A00,523232,Staff,10,0,30,20
1715654819219,SIOC 290S,A01,637330,Merrifield; Mark A,21,0,30,9
1715654820245,SIOC 291S,A01,637333,Gabriel; Corey John,21,0,30,9
1715654821272,SOCI 117,A01,494376,Staff,0,5,5,5
1715654822299,WES 237B,A00,494380,Staff,10,0,20,10
1715654824371,AESE 279B,A00,494370,Wade; Jon P,0,0,33,33
1715654825395,AIP 97,001,660915,Van Den Einde; Yael Dahlia,9998,0,9999,1
1715654826427,AIP 197,001,627712,Vespa; Emanuel Ignacio,9995,0,9999,4
1715654826427,AIP 197,002,650778,Amir; On,9998,0,9999,1
1715654826427,AIP 197,003,650933,Avenancio-Leon; Carlos,9998,0,9999,1
1715654826427,AIP 197,004,658530,Heyman; Gail D.,9998,0,9999,1
1715654826427,AIP 197,005,658631,Neal; Sonya E,9998,0,9999,1
1715654826427,AIP 197,006,658671,Du; Songzi,9998,0,9999,1
1715654827453,ANAR 135S,A00,494369,Braswell; Geoffrey E.,0,0,0,0
1715654828479,BENG 196,001,628496,Engler; Adam J.,9998,0,9999,1
1715654828479,BENG 196,002,660916,Watson; John Thomas,9998,0,9999,1
1715654829506,BISP 197,001,650773,Wilhelm; James E.,9994,0,9999,5
1715654829506,BISP 197,002,658904,Coleman; Aaron B.,9998,0,9999,1
1715654830532,CAT 124RS,A01,519847,Geibel; William,0,0,20,20
1715654831560,CAT 125RS,A01,515971,Geibel; William,0,0,20,20
1715654832587,CLRE 250,A00,511389,Morris; Sheldon,9992,0,9999,7
1715654833614,CLRE 251,A00,507176,Mehta; Ravindra L.,9992,0,9999,7
1715654833614,CLRE 251,B00,511410,Mehta; Ravindra L.,9998,0,9999,1
1715654834640,CLRE 252,A00,507189,Cuomo; Raphael Eduardo,9994,0,9999,5
1715654835665,CLRE 253,A00,507199,Vaida; Florin,9994,0,9999,5
1715654835665,CLRE 253,B00,507202,Vaida; Florin,9999,0,9999,0
1715654836690,CLRE 259,A00,507211,Patel; Hemal,9996,0,9999,3
1715654837715,CLRE 260,A00,507221,Cuomo; Raphael Eduardo,9999,0,9999,0
1715654838741,CLRE 297,001,507242,Cuomo; Raphael Eduardo,9999,0,9999,0
1715654839769,COGS 197,001,638244,Voytek; Bradley Thomas,9997,0,9999,2
1715654840792,CSE 191,A00,516875,Minnes Kemp; Mor Mia,9991,0,9999,8
1715654841819,CSE 197,001,637388,Minnes Kemp; Mor Mia,9992,0,9999,7
1715654842851,CSS 201S,A01,494383,Mignozzetti; Umberto,35,0,35,0
1715654843876,CSS 202S,A01,494387,Mignozzetti; Umberto,35,0,35,0
1715654844903,DSC 197,001,628532,Eldridge; Justin Matthew,9995,0,9999,4
1715654845930,EAP 100,A00,516065,Staff,9799,0,9999,200
1715654846958,ECE 45,A01,507414,Staff,32,0,60,28
1715654849010,ECE 111,A01,507420,Staff,11,0,50,39
1715654850037,ECE 197,001,548057,Sievenpiper; Daniel F.,9991,0,9999,8
1715654851064,EDS 115,A00,507243,Choi; Bailey Miyeon,6,0,28,22
1715654852092,EDS 117,A01,494379,Staff,0,6,34,35
1715654853120,EDS 125,A00,507246,Hopkins; Megan Beth,7,0,30,23
1715654854149,EDS 128A,A01,507264,Fargason; Sharon Gayle,5,0,26,21
1715654855177,EDS 128B,A01,507293,Pappas; Elizabeth,9,0,30,21
1715654856204,EDS 139,A00,507294,Fargason; Sharon Gayle,9,0,30,21
1715654856204,EDS 139,B00,507313,Pappas; Elizabeth,9,0,30,21
1715654857232,EDS 201,A00,507315,Staff,10,0,30,20
1715654858261,EDS 203,A01,507317,Halter; Christopher P.,10,0,30,20
1715654859290,EDS 204R,A01,507319,Halter; Christopher P.,0,3,30,30
1715654859290,EDS 204R,B01,507331,Heinzman; Erica M.,14,0,30,16
1715654860320,EDS 206R,A00,507332,Staff,0,4,30,30
1715654860320,EDS 206R,B00,507343,Staff,15,0,30,15
1715654861346,EDS 250,A00,507344,Hemans; Patricia Ann Benitez,20,0,40,20
1715654862372,EDS 281,A00,507345,Daly; Alan J.,18,0,18,0
1715654863400,EDS 284,A00,507350,Daly; Alan J.,16,0,16,0
1715654864427,EDS 286,A00,507359,Fine; Sarah,18,0,18,0
1715654865456,EDS 289C,A01,507361,Daly; Alan J.,18,0,18,0
1715654866481,EDS 290,A00,507366,Hofstetter; Carolyn,15,0,15,0
1715654867512,LIGM 5A,A00,507421,Fischer-Grunski; Eva K,17,0,20,3
1715654868536,LIGM 5B,A00,507423,Fischer-Grunski; Eva K,19,0,20,1
1715654869561,LIGM 5C,A00,507425,Fischer-Grunski; Eva K,19,0,20,1
1715654870586,LIIT 5AS,A00,507427,Carnelos; Chiara,20,0,20,0
1715654871612,LIIT 5BS,A00,507430,Carnelos; Chiara,20,0,20,0
1715654872642,LIIT 5CS,A00,507432,Carnelos; Chiara,20,0,20,0
1715654873670,LISP 5A,A00,507541,Munoz Sanchez; Alicia,11,0,20,9
1715654874697,LISP 5B,A00,507671,Munoz Sanchez; Alicia,8,0,20,12
1715654875726,LISP 5C,A00,507696,Munoz Sanchez; Alicia,8,0,20,12
1715654876751,MAE 197,001,528363,Boechler; Nicholas Sebastia,9998,0,9999,1
1715654877784,MATH 197,001,523477,Kedlaya; Kiran S.,9994,0,9999,5
1715654877784,MATH 197,002,563811,Zhang; Danna,9994,0,9999,5
1715654877784,MATH 197,003,628552,Dumitriu; Ioana,9998,0,9999,1
1715654877784,MATH 197,004,660885,Floyd; Eric,9998,0,9999,1
1715654878811,MCWP 40R,A00,518780,Staff,1,0,20,19
1715654878811,MCWP 40R,B00,518781,Carter; Jennifer A,9,0,20,11
1715654878811,MCWP 40R,C00,518783,Smith; Haydee Marie,5,0,20,15
1715654879839,MCWP 50R,A00,518791,Redela; Pamela Morgan,0,1,20,20
1715654879839,MCWP 50R,B00,518792,Krone; Jarret,0,2,20,20
1715654879839,MCWP 50R,C00,518793,Staff,0,4,20,20
1715654879839,MCWP 50R,D00,518794,Morshed; Michael James,0,2,20,20
1715654879839,MCWP 50R,E00,518795,Carter; Andrea L,0,2,20,20
1715654879839,MCWP 50R,F00,518796,Miller; Elizabeth Deen,0,1,20,20
1715654879839,MCWP 50R,G00,518797,Guillen; Melinda,0,1,20,20
1715654880865,MMW 12R,A01,514034,Herbst; Matthew,0,2,16,16
1715654880865,MMW 12R,A02,514035,Herbst; Matthew,0,0,16,16
1715654881893,MMW 13R,A01,514037,Staff,0,5,16,16
1715654881893,MMW 13R,A02,514039,Staff,0,5,16,16
1715654881893,MMW 13R,A03,628519,Staff,0,4,16,16
1715654883946,SIO 295LS,A00,523233,Staff,10,0,30,20
1715654884972,SIO 295S,A00,523232,Staff,10,0,30,20
1715654886002,SIOC 290S,A01,637330,Merrifield; Mark A,21,0,30,9
1715654887028,SIOC 291S,A01,637333,Gabriel; Corey John,21,0,30,9
1715654888056,SOCI 117,A01,494376,Staff,0,5,5,5
1715654889083,WES 237B,A00,494380,Staff,10,0,20,10
1715654891206,AESE 279B,A00,494370,Wade; Jon P,0,0,33,33
1715654892233,AIP 97,001,660915,Van Den Einde; Yael Dahlia,9998,0,9999,1
1715654893265,AIP 197,001,627712,Vespa; Emanuel Ignacio,9995,0,9999,4
1715654893265,AIP 197,002,650778,Amir; On,9998,0,9999,1
1715654893265,AIP 197,003,650933,Avenancio-Leon; Carlos,9998,0,9999,1
1715654893265,AIP 197,004,658530,Heyman; Gail D.,9998,0,9999,1
1715654893265,AIP 197,005,658631,Neal; Sonya E,9998,0,9999,1
1715654893265,AIP 197,006,658671,Du; Songzi,9998,0,9999,1
1715654894294,ANAR 135S,A00,494369,Braswell; Geoffrey E.,0,0,0,0
1715654895324,BENG 196,001,628496,Engler; Adam J.,9998,0,9999,1
1715654895324,BENG 196,002,660916,Watson; John Thomas,9998,0,9999,1
1715654896350,BISP 197,001,650773,Wilhelm; James E.,9994,0,9999,5
1715654896350,BISP 197,002,658904,Coleman; Aaron B.,9998,0,9999,1
1715654897378,CAT 124RS,A01,519847,Geibel; William,0,0,20,20
1715654898403,CAT 125RS,A01,515971,Geibel; William,0,0,20,20
1715654899428,CLRE 250,A00,511389,Morris; Sheldon,9992,0,9999,7
1715654900458,CLRE 251,A00,507176,Mehta; Ravindra L.,9992,0,9999,7
1715654900458,CLRE 251,B00,511410,Mehta; Ravindra L.,9998,0,9999,1
1715654901489,CLRE 252,A00,507189,Cuomo; Raphael Eduardo,9994,0,9999,5
1715654902514,CLRE 253,A00,507199,Vaida; Florin,9994,0,9999,5
1715654902514,CLRE 253,B00,507202,Vaida; Florin,9999,0,9999,0
1715654903542,CLRE 259,A00,507211,Patel; Hemal,9996,0,9999,3
1715654904567,CLRE 260,A00,507221,Cuomo; Raphael Eduardo,9999,0,9999,0
1715654905592,CLRE 297,001,507242,Cuomo; Raphael Eduardo,9999,0,9999,0
1715654906618,COGS 197,001,638244,Voytek; Bradley Thomas,9997,0,9999,2
1715654907644,CSE 191,A00,516875,Minnes Kemp; Mor Mia,9991,0,9999,8
1715654908673,CSE 197,001,637388,Minnes Kemp; Mor Mia,9992,0,9999,7
1715654909700,CSS 201S,A01,494383,Mignozzetti; Umberto,35,0,35,0
1715654910728,CSS 202S,A01,494387,Mignozzetti; Umberto,35,0,35,0
1715654911753,DSC 197,001,628532,Eldridge; Justin Matthew,9995,0,9999,4
1715654912779,EAP 100,A00,516065,Staff,9799,0,9999,200
1715654913810,ECE 45,A01,507414,Staff,32,0,60,28
1715654915863,ECE 111,A01,507420,Staff,11,0,50,39
1715654916889,ECE 197,001,548057,Sievenpiper; Daniel F.,9991,0,9999,8
1715654917915,EDS 115,A00,507243,Choi; Bailey Miyeon,6,0,28,22
1715654918942,EDS 117,A01,494379,Staff,0,6,34,35
1715654919970,EDS 125,A00,507246,Hopkins; Megan Beth,7,0,30,23
1715654920995,EDS 128A,A01,507264,Fargason; Sharon Gayle,5,0,26,21
1715654922021,EDS 128B,A01,507293,Pappas; Elizabeth,9,0,30,21
1715654923047,EDS 139,A00,507294,Fargason; Sharon Gayle,9,0,30,21
1715654923047,EDS 139,B00,507313,Pappas; Elizabeth,9,0,30,21
1715654924077,EDS 201,A00,507315,Staff,10,0,30,20
1715654925102,EDS 203,A01,507317,Halter; Christopher P.,10,0,30,20
1715654926129,EDS 204R,A01,507319,Halter; Christopher P.,0,3,30,30
1715654926129,EDS 204R,B01,507331,Heinzman; Erica M.,14,0,30,16
1715654927157,EDS 206R,A00,507332,Staff,0,4,30,30
1715654927157,EDS 206R,B00,507343,Staff,15,0,30,15
1715654928183,EDS 250,A00,507344,Hemans; Patricia Ann Benitez,20,0,40,20
1715654929212,EDS 281,A00,507345,Daly; Alan J.,18,0,18,0
1715654930243,EDS 284,A00,507350,Daly; Alan J.,16,0,16,0
1715654931285,EDS 286,A00,507359,Fine; Sarah,18,0,18,0
1715654932311,EDS 289C,A01,507361,Daly; Alan J.,18,0,18,0
1715654933339,EDS 290,A00,507366,Hofstetter; Carolyn,15,0,15,0
1715654934366,LIGM 5A,A00,507421,Fischer-Grunski; Eva K,17,0,20,3
1715654935391,LIGM 5B,A00,507423,Fischer-Grunski; Eva K,19,0,20,1
1715654936417,LIGM 5C,A00,507425,Fischer-Grunski; Eva K,19,0,20,1
1715654937447,LIIT 5AS,A00,507427,Carnelos; Chiara,20,0,20,0
1715654938472,LIIT 5BS,A00,507430,Carnelos; Chiara,20,0,20,0
1715654939501,LIIT 5CS,A00,507432,Carnelos; Chiara,20,0,20,0
1715654940531,LISP 5A,A00,507541,Munoz Sanchez; Alicia,11,0,20,9
1715654941559,LISP 5B,A00,507671,Munoz Sanchez; Alicia,8,0,20,12
1715654942590,LISP 5C,A00,507696,Munoz Sanchez; Alicia,8,0,20,12
1715654943615,MAE 197,001,528363,Boechler; Nicholas Sebastia,9998,0,9999,1
1715654944647,MATH 197,001,523477,Kedlaya; Kiran S.,9994,0,9999,5
1715654944647,MATH 197,002,563811,Zhang; Danna,9994,0,9999,5
1715654944647,MATH 197,003,628552,Dumitriu; Ioana,9998,0,9999,1
1715654944647,MATH 197,004,660885,Floyd; Eric,9998,0,9999,1
1715654945674,MCWP 40R,A00,518780,Staff,1,0,20,19
1715654945674,MCWP 40R,B00,518781,Carter; Jennifer A,9,0,20,11
1715654945674,MCWP 40R,C00,518783,Smith; Haydee Marie,5,0,20,15
1715654946702,MCWP 50R,A00,518791,Redela; Pamela Morgan,0,1,20,20
1715654946702,MCWP 50R,B00,518792,Krone; Jarret,0,2,20,20
1715654946702,MCWP 50R,C00,518793,Staff,0,4,20,20
1715654946702,MCWP 50R,D00,518794,Morshed; Michael James,0,2,20,20
1715654946702,MCWP 50R,E00,518795,Carter; Andrea L,0,2,20,20
1715654946702,MCWP 50R,F00,518796,Miller; Elizabeth Deen,0,1,20,20
1715654946702,MCWP 50R,G00,518797,Guillen; Melinda,0,1,20,20
1715654947729,MMW 12R,A01,514034,Herbst; Matthew,0,2,16,16
1715654947729,MMW 12R,A02,514035,Herbst; Matthew,0,0,16,16
1715654948758,MMW 13R,A01,514037,Staff,0,5,16,16
1715654948758,MMW 13R,A02,514039,Staff,0,5,16,16
1715654948758,MMW 13R,A03,628519,Staff,0,4,16,16
1715654950812,SIO 295LS,A00,523233,Staff,10,0,30,20
1715654951839,SIO 295S,A00,523232,Staff,10,0,30,20
1715654952867,SIOC 290S,A01,637330,Merrifield; Mark A,21,0,30,9
1715654953907,SIOC 291S,A01,637333,Gabriel; Corey John,21,0,30,9
1715654954935,SOCI 117,A01,494376,Staff,0,5,5,5
1715654955961,WES 237B,A00,494380,Staff,10,0,20,10
1715654958055,AESE 279B,A00,494370,Wade; Jon P,0,0,33,33
1715654959085,AIP 97,001,660915,Van Den Einde; Yael Dahlia,9998,0,9999,1
1715654960119,AIP 197,001,627712,Vespa; Emanuel Ignacio,9995,0,9999,4
1715654960119,AIP 197,002,650778,Amir; On,9998,0,9999,1
1715654960119,AIP 197,003,650933,Avenancio-Leon; Carlos,9998,0,9999,1
1715654960119,AIP 197,004,658530,Heyman; Gail D.,9998,0,9999,1
1715654960119,AIP 197,005,658631,Neal; Sonya E,9998,0,9999,1
1715654960119,AIP 197,006,658671,Du; Songzi,9998,0,9999,1
1715654961145,ANAR 135S,A00,494369,Braswell; Geoffrey E.,0,0,0,0
1715654962174,BENG 196,001,628496,Engler; Adam J.,9998,0,9999,1
1715654962174,BENG 196,002,660916,Watson; John Thomas,9998,0,9999,1
1715654963202,BISP 197,001,650773,Wilhelm; James E.,9994,0,9999,5
1715654963202,BISP 197,002,658904,Coleman; Aaron B.,9998,0,9999,1
1715654964230,CAT 124RS,A01,519847,Geibel; William,0,0,20,20
1715654965255,CAT 125RS,A01,515971,Geibel; William,0,0,20,20
1715654966284,CLRE 250,A00,511389,Morris; Sheldon,9992,0,9999,7
1715654967315,CLRE 251,A00,507176,Mehta; Ravindra L.,9992,0,9999,7
1715654967315,CLRE 251,B00,511410,Mehta; Ravindra L.,9998,0,9999,1
1715654968342,CLRE 252,A00,507189,Cuomo; Raphael Eduardo,9994,0,9999,5
1715654969368,CLRE 253,A00,507199,Vaida; Florin,9994,0,9999,5
1715654969368,CLRE 253,B00,507202,Vaida; Florin,9999,0,9999,0
1715654970398,CLRE 259,A00,507211,Patel; Hemal,9996,0,9999,3
1715654971426,CLRE 260,A00,507221,Cuomo; Raphael Eduardo,9999,0,9999,0
1715654972454,CLRE 297,001,507242,Cuomo; Raphael Eduardo,9999,0,9999,0
1715654973483,COGS 197,001,638244,Voytek; Bradley Thomas,9997,0,9999,2
1715654974508,CSE 191,A00,516875,Minnes Kemp; Mor Mia,9991,0,9999,8
1715654975533,CSE 197,001,637388,Minnes Kemp; Mor Mia,9992,0,9999,7
1715654976565,CSS 201S,A01,494383,Mignozzetti; Umberto,35,0,35,0
1715654977590,CSS 202S,A01,494387,Mignozzetti; Umberto,35,0,35,0
1715654978619,DSC 197,001,628532,Eldridge; Justin Matthew,9995,0,9999,4
1715654979647,EAP 100,A00,516065,Staff,9799,0,9999,200
1715654980675,ECE 45,A01,507414,Staff,32,0,60,28
1715654982728,ECE 111,A01,507420,Staff,11,0,50,39
1715654983753,ECE 197,001,548057,Sievenpiper; Daniel F.,9991,0,9999,8
1715654984779,EDS 115,A00,507243,Choi; Bailey Miyeon,6,0,28,22
1715654985808,EDS 117,A01,494379,Staff,0,6,34,35
1715654986834,EDS 125,A00,507246,Hopkins; Megan Beth,7,0,30,23
1715654987859,EDS 128A,A01,507264,Fargason; Sharon Gayle,5,0,26,21
1715654988888,EDS 128B,A01,507293,Pappas; Elizabeth,9,0,30,21
1715654989914,EDS 139,A00,507294,Fargason; Sharon Gayle,9,0,30,21
1715654989914,EDS 139,B00,507313,Pappas; Elizabeth,9,0,30,21
1715654990940,EDS 201,A00,507315,Staff,10,0,30,20
1715654991966,EDS 203,A01,507317,Halter; Christopher P.,10,0,30,20
1715654992995,EDS 204R,A01,507319,Halter; Christopher P.,0,3,30,30
1715654992995,EDS 204R,B01,507331,Heinzman; Erica M.,14,0,30,16
1715654994020,EDS 206R,A00,507332,Staff,0,4,30,30
1715654994020,EDS 206R,B00,507343,Staff,15,0,30,15
1715654995109,EDS 250,A00,507344,Hemans; Patricia Ann Benitez,20,0,40,20
1715654996134,EDS 281,A00,507345,Daly; Alan J.,18,0,18,0
1715654997158,EDS 284,A00,507350,Daly; Alan J.,16,0,16,0
1715654998186,EDS 286,A00,507359,Fine; Sarah,18,0,18,0
1715654999213,EDS 289C,A01,507361,Daly; Alan J.,18,0,18,0
1715655000239,EDS 290,A00,507366,Hofstetter; Carolyn,15,0,15,0
1715655001271,LIGM 5A,A00,507421,Fischer-Grunski; Eva K,17,0,20,3
1715655002298,LIGM 5B,A00,507423,Fischer-Grunski; Eva K,19,0,20,1
1715655003325,LIGM 5C,A00,507425,Fischer-Grunski; Eva K,19,0,20,1
1715655004356,LIIT 5AS,A00,507427,Carnelos; Chiara,20,0,20,0
1715655005381,LIIT 5BS,A00,507430,Carnelos; Chiara,20,0,20,0
1715655006407,LIIT 5CS,A00,507432,Carnelos; Chiara,20,0,20,0
1715655007433,LISP 5A,A00,507541,Munoz Sanchez; Alicia,11,0,20,9
1715655008459,LISP 5B,A00,507671,Munoz Sanchez; Alicia,8,0,20,12
1715655009486,LISP 5C,A00,507696,Munoz Sanchez; Alicia,8,0,20,12
1715655010512,MAE 197,001,528363,Boechler; Nicholas Sebastia,9998,0,9999,1
1715655011541,MATH 197,001,523477,Kedlaya; Kiran S.,9994,0,9999,5
1715655011541,MATH 197,002,563811,Zhang; Danna,9994,0,9999,5
1715655011541,MATH 197,003,628552,Dumitriu; Ioana,9998,0,9999,1
1715655011541,MATH 197,004,660885,Floyd; Eric,9998,0,9999,1
1715655012570,MCWP 40R,A00,518780,Staff,1,0,20,19
1715655012570,MCWP 40R,B00,518781,Carter; Jennifer A,9,0,20,11
1715655012570,MCWP 40R,C00,518783,Smith; Haydee Marie,5,0,20,15
1715655013598,MCWP 50R,A00,518791,Redela; Pamela Morgan,0,1,20,20
1715655013598,MCWP 50R,B00,518792,Krone; Jarret,0,2,20,20
1715655013598,MCWP 50R,C00,518793,Staff,0,4,20,20
1715655013598,MCWP 50R,D00,518794,Morshed; Michael James,0,2,20,20
1715655013598,MCWP 50R,E00,518795,Carter; Andrea L,0,2,20,20
1715655013598,MCWP 50R,F00,518796,Miller; Elizabeth Deen,0,1,20,20
1715655013598,MCWP 50R,G00,518797,Guillen; Melinda,0,1,20,20
1715655014628,MMW 12R,A01,514034,Herbst; Matthew,0,2,16,16
1715655014628,MMW 12R,A02,514035,Herbst; Matthew,0,0,16,16
1715655015653,MMW 13R,A01,514037,Staff,0,5,16,16
1715655015653,MMW 13R,A02,514039,Staff,0,5,16,16
1715655015653,MMW 13R,A03,628519,Staff,0,4,16,16
1715655017704,SIO 295LS,A00,523233,Staff,10,0,30,20
1715655018730,SIO 295S,A00,523232,Staff,10,0,30,20
1715655019759,SIOC 290S,A01,637330,Merrifield; Mark A,21,0,30,9
1715655020789,SIOC 291S,A01,637333,Gabriel; Corey John,21,0,30,9
1715655021816,SOCI 117,A01,494376,Staff,0,5,5,5
1715655022841,WES 237B,A00,494380,Staff,10,0,20,10
1715655024929,AESE 279B,A00,494370,Wade; Jon P,0,0,33,33
1715655025954,AIP 97,001,660915,Van Den Einde; Yael Dahlia,9998,0,9999,1
1715655026988,AIP 197,001,627712,Vespa; Emanuel Ignacio,9995,0,9999,4
1715655026988,AIP 197,002,650778,Amir; On,9998,0,9999,1
1715655026988,AIP 197,003,650933,Avenancio-Leon; Carlos,9998,0,9999,1
1715655026988,AIP 197,004,658530,Heyman; Gail D.,9998,0,9999,1
1715655026988,AIP 197,005,658631,Neal; Sonya E,9998,0,9999,1
1715655026988,AIP 197,006,658671,Du; Songzi,9998,0,9999,1
1715655028019,ANAR 135S,A00,494369,Braswell; Geoffrey E.,0,0,0,0
1715655029047,BENG 196,001,628496,Engler; Adam J.,9998,0,9999,1
1715655029047,BENG 196,002,660916,Watson; John Thomas,9998,0,9999,1
1715655030076,BISP 197,001,650773,Wilhelm; James E.,9994,0,9999,5
1715655030076,BISP 197,002,658904,Coleman; Aaron B.,9998,0,9999,1
1715655031102,CAT 124RS,A01,519847,Geibel; William,0,0,20,20
1715655032128,CAT 125RS,A01,515971,Geibel; William,0,0,20,20
1715655033154,CLRE 250,A00,511389,Morris; Sheldon,9992,0,9999,7
1715655034181,CLRE 251,A00,507176,Mehta; Ravindra L.,9992,0,9999,7
1715655034181,CLRE 251,B00,511410,Mehta; Ravindra L.,9998,0,9999,1
1715655035206,CLRE 252,A00,507189,Cuomo; Raphael Eduardo,9994,0,9999,5
1715655036233,CLRE 253,A00,507199,Vaida; Florin,9994,0,9999,5
1715655036233,CLRE 253,B00,507202,Vaida; Florin,9999,0,9999,0
1715655037258,CLRE 259,A00,507211,Patel; Hemal,9996,0,9999,3
1715655038283,CLRE 260,A00,507221,Cuomo; Raphael Eduardo,9999,0,9999,0
1715655039309,CLRE 297,001,507242,Cuomo; Raphael Eduardo,9999,0,9999,0
1715655040334,COGS 197,001,638244,Voytek; Bradley Thomas,9997,0,9999,2
1715655041360,CSE 191,A00,516875,Minnes Kemp; Mor Mia,9991,0,9999,8
1715655042386,CSE 197,001,637388,Minnes Kemp; Mor Mia,9992,0,9999,7
1715655043417,CSS 201S,A01,494383,Mignozzetti; Umberto,35,0,35,0
1715655044446,CSS 202S,A01,494387,Mignozzetti; Umberto,35,0,35,0
1715655045473,DSC 197,001,628532,Eldridge; Justin Matthew,9995,0,9999,4
1715655046501,EAP 100,A00,516065,Staff,9799,0,9999,200
1715655047528,ECE 45,A01,507414,Staff,32,0,60,28
1715655049583,ECE 111,A01,507420,Staff,11,0,50,39
1715655050609,ECE 197,001,548057,Sievenpiper; Daniel F.,9991,0,9999,8
1715655051636,EDS 115,A00,507243,Choi; Bailey Miyeon,6,0,28,22
1715655052660,EDS 117,A01,494379,Staff,0,6,34,35
1715655053687,EDS 125,A00,507246,Hopkins; Megan Beth,7,0,30,23
1715655054712,EDS 128A,A01,507264,Fargason; Sharon Gayle,5,0,26,21
1715655055736,EDS 128B,A01,507293,Pappas; Elizabeth,9,0,30,21
1715655056765,EDS 139,A00,507294,Fargason; Sharon Gayle,9,0,30,21
1715655056765,EDS 139,B00,507313,Pappas; Elizabeth,9,0,30,21
1715655057790,EDS 201,A00,507315,Staff,10,0,30,20
1715655058817,EDS 203,A01,507317,Halter; Christopher P.,10,0,30,20
1715655059844,EDS 204R,A01,507319,Halter; Christopher P.,0,3,30,30
1715655059844,EDS 204R,B01,507331,Heinzman; Erica M.,14,0,30,16
1715655060870,EDS 206R,A00,507332,Staff,0,4,30,30
1715655060870,EDS 206R,B00,507343,Staff,15,0,30,15
1715655061895,EDS 250,A00,507344,Hemans; Patricia Ann Benitez,20,0,40,20
1715655062920,EDS 281,A00,507345,Daly; Alan J.,18,0,18,0
1715655063946,EDS 284,A00,507350,Daly; Alan J.,16,0,16,0
1715655064971,EDS 286,A00,507359,Fine; Sarah,18,0,18,0
1715655065999,EDS 289C,A01,507361,Daly; Alan J.,18,0,18,0
1715655067024,EDS 290,A00,507366,Hofstetter; Carolyn,15,0,15,0
1715655068051,LIGM 5A,A00,507421,Fischer-Grunski; Eva K,17,0,20,3
1715655069081,LIGM 5B,A00,507423,Fischer-Grunski; Eva K,19,0,20,1
1715655070105,LIGM 5C,A00,507425,Fischer-Grunski; Eva K,19,0,20,1
1715655071133,LIIT 5AS,A00,507427,Carnelos; Chiara,20,0,20,0
1715655072162,LIIT 5BS,A00,507430,Carnelos; Chiara,20,0,20,0
1715655073186,LIIT 5CS,A00,507432,Carnelos; Chiara,20,0,20,0
1715655074212,LISP 5A,A00,507541,Munoz Sanchez; Alicia,11,0,20,9
1715655075238,LISP 5B,A00,507671,Munoz Sanchez; Alicia,8,0,20,12
1715655076266,LISP 5C,A00,507696,Munoz Sanchez; Alicia,8,0,20,12
1715655077293,MAE 197,001,528363,Boechler; Nicholas Sebastia,9998,0,9999,1
1715655078321,MATH 197,001,523477,Kedlaya; Kiran S.,9994,0,9999,5
1715655078321,MATH 197,002,563811,Zhang; Danna,9994,0,9999,5
1715655078321,MATH 197,003,628552,Dumitriu; Ioana,9998,0,9999,1
1715655078321,MATH 197,004,660885,Floyd; Eric,9998,0,9999,1
1715655079355,MCWP 40R,A00,518780,Staff,1,0,20,19
1715655079355,MCWP 40R,B00,518781,Carter; Jennifer A,9,0,20,11
1715655079355,MCWP 40R,C00,518783,Smith; Haydee Marie,5,0,20,15
1715655080384,MCWP 50R,A00,518791,Redela; Pamela Morgan,0,1,20,20
1715655080384,MCWP 50R,B00,518792,Krone; Jarret,0,2,20,20
1715655080384,MCWP 50R,C00,518793,Staff,0,4,20,20
1715655080384,MCWP 50R,D00,518794,Morshed; Michael James,0,2,20,20
1715655080384,MCWP 50R,E00,518795,Carter; Andrea L,0,2,20,20
1715655080384,MCWP 50R,F00,518796,Miller; Elizabeth Deen,0,1,20,20
1715655080384,MCWP 50R,G00,518797,Guillen; Melinda,0,1,20,20
1715655081409,MMW 12R,A01,514034,Herbst; Matthew,0,2,16,16
1715655081409,MMW 12R,A02,514035,Herbst; Matthew,0,0,16,16
1715655082438,MMW 13R,A01,514037,Staff,0,5,16,16
1715655082438,MMW 13R,A02,514039,Staff,0,5,16,16
1715655082438,MMW 13R,A03,628519,Staff,0,4,16,16
1715655084491,SIO 295LS,A00,523233,Staff,10,0,30,20
1715655085520,SIO 295S,A00,523232,Staff,10,0,30,20
1715655086552,SIOC 290S,A01,637330,Merrifield; Mark A,21,0,30,9
1715655087584,SIOC 291S,A01,637333,Gabriel; Corey John,21,0,30,9
1715655088609,SOCI 117,A01,494376,Staff,0,5,5,5
1715655089634,WES 237B,A00,494380,Staff,10,0,20,10
1715655091703,AESE 279B,A00,494370,Wade; Jon P,0,0,33,33
1715655092732,AIP 97,001,660915,Van Den Einde; Yael Dahlia,9998,0,9999,1
1715655093762,AIP 197,001,627712,Vespa; Emanuel Ignacio,9995,0,9999,4
1715655093762,AIP 197,002,650778,Amir; On,9998,0,9999,1
1715655093762,AIP 197,003,650933,Avenancio-Leon; Carlos,9998,0,9999,1
1715655093762,AIP 197,004,658530,Heyman; Gail D.,9998,0,9999,1
1715655093762,AIP 197,005,658631,Neal; Sonya E,9998,0,9999,1
1715655093762,AIP 197,006,658671,Du; Songzi,9998,0,9999,1
1715655094790,ANAR 135S,A00,494369,Braswell; Geoffrey E.,0,0,0,0
1715655095820,BENG 196,001,628496,Engler; Adam J.,9998,0,9999,1
1715655095820,BENG 196,002,660916,Watson; John Thomas,9998,0,9999,1
1715655096846,BISP 197,001,650773,Wilhelm; James E.,9994,0,9999,5
1715655096846,BISP 197,002,658904,Coleman; Aaron B.,9998,0,9999,1
1715655097875,CAT 124RS,A01,519847,Geibel; William,0,0,20,20
1715655098962,CAT 125RS,A01,515971,Geibel; William,0,0,20,20
1715655099988,CLRE 250,A00,511389,Morris; Sheldon,9992,0,9999,7
1715655101016,CLRE 251,A00,507176,Mehta; Ravindra L.,9992,0,9999,7
1715655101016,CLRE 251,B00,511410,Mehta; Ravindra L.,9998,0,9999,1
1715655102042,CLRE 252,A00,507189,Cuomo; Raphael Eduardo,9994,0,9999,5
1715655103069,CLRE 253,A00,507199,Vaida; Florin,9994,0,9999,5
1715655103069,CLRE 253,B00,507202,Vaida; Florin,9999,0,9999,0
1715655104097,CLRE 259,A00,507211,Patel; Hemal,9996,0,9999,3
1715655105122,CLRE 260,A00,507221,Cuomo; Raphael Eduardo,9999,0,9999,0
1715655106146,CLRE 297,001,507242,Cuomo; Raphael Eduardo,9999,0,9999,0
1715655107173,COGS 197,001,638244,Voytek; Bradley Thomas,9997,0,9999,2
1715655108202,CSE 191,A00,516875,Minnes Kemp; Mor Mia,9991,0,9999,8
1715655109225,CSE 197,001,637388,Minnes Kemp; Mor Mia,9992,0,9999,7
1715655110254,CSS 201S,A01,494383,Mignozzetti; Umberto,35,0,35,0
1715655111283,CSS 202S,A01,494387,Mignozzetti; Umberto,35,0,35,0
1715655112312,DSC 197,001,628532,Eldridge; Justin Matthew,9995,0,9999,4
1715655113336,EAP 100,A00,516065,Staff,9799,0,9999,200
1715655114369,ECE 45,A01,507414,Staff,32,0,60,28
1715655116423,ECE 111,A01,507420,Staff,11,0,50,39
1715655117450,ECE 197,001,548057,Sievenpiper; Daniel F.,9991,0,9999,8
1715655118476,EDS 115,A00,507243,Choi; Bailey Miyeon,6,0,28,22
1715655119505,EDS 117,A01,494379,Staff,0,6,34,35
1715655120529,EDS 125,A00,507246,Hopkins; Megan Beth,7,0,30,23
1715655121557,EDS 128A,A01,507264,Fargason; Sharon Gayle,5,0,26,21
1715655122583,EDS 128B,A01,507293,Pappas; Elizabeth,9,0,30,21
1715655123623,EDS 139,A00,507294,Fargason; Sharon Gayle,9,0,30,21
1715655123623,EDS 139,B00,507313,Pappas; Elizabeth,9,0,30,21
1715655124650,EDS 201,A00,507315,Staff,10,0,30,20
1715655125674,EDS 203,A01,507317,Halter; Christopher P.,10,0,30,20
1715655126701,EDS 204R,A01,507319,Halter; Christopher P.,0,3,30,30
1715655126701,EDS 204R,B01,507331,Heinzman; Erica M.,14,0,30,16
1715655127726,EDS 206R,A00,507332,Staff,0,4,30,30
1715655127726,EDS 206R,B00,507343,Staff,15,0,30,15
1715655128757,EDS 250,A00,507344,Hemans; Patricia Ann Benitez,20,0,40,20
1715655129782,EDS 281,A00,507345,Daly; Alan J.,18,0,18,0
1715655130809,EDS 284,A00,507350,Daly; Alan J.,16,0,16,0
1715655131840,EDS 286,A00,507359,Fine; Sarah,18,0,18,0
1715655132868,EDS 289C,A01,507361,Daly; Alan J.,18,0,18,0
1715655133895,EDS 290,A00,507366,Hofstetter; Carolyn,15,0,15,0
1715655134923,LIGM 5A,A00,507421,Fischer-Grunski; Eva K,17,0,20,3
1715655135950,LIGM 5B,A00,507423,Fischer-Grunski; Eva K,19,0,20,1
1715655136975,LIGM 5C,A00,507425,Fischer-Grunski; Eva K,19,0,20,1
1715655138000,LIIT 5AS,A00,507427,Carnelos; Chiara,20,0,20,0
1715655139033,LIIT 5BS,A00,507430,Carnelos; Chiara,20,0,20,0
1715655140060,LIIT 5CS,A00,507432,Carnelos; Chiara,20,0,20,0
1715655141090,LISP 5A,A00,507541,Munoz Sanchez; Alicia,11,0,20,9
1715655142122,LISP 5B,A00,507671,Munoz Sanchez; Alicia,8,0,20,12
1715655143147,LISP 5C,A00,507696,Munoz Sanchez; Alicia,8,0,20,12
1715655144173,MAE 197,001,528363,Boechler; Nicholas Sebastia,9998,0,9999,1
1715655145205,MATH 197,001,523477,Kedlaya; Kiran S.,9994,0,9999,5
1715655145205,MATH 197,002,563811,Zhang; Danna,9994,0,9999,5
1715655145205,MATH 197,003,628552,Dumitriu; Ioana,9998,0,9999,1
1715655145205,MATH 197,004,660885,Floyd; Eric,9998,0,9999,1
1715655146236,MCWP 40R,A00,518780,Staff,1,0,20,19
1715655146236,MCWP 40R,B00,518781,Carter; Jennifer A,9,0,20,11
1715655146236,MCWP 40R,C00,518783,Smith; Haydee Marie,5,0,20,15
1715655147270,MCWP 50R,A00,518791,Redela; Pamela Morgan,0,1,20,20
1715655147270,MCWP 50R,B00,518792,Krone; Jarret,0,2,20,20
1715655147270,MCWP 50R,C00,518793,Staff,0,4,20,20
1715655147270,MCWP 50R,D00,518794,Morshed; Michael James,0,2,20,20
1715655147270,MCWP 50R,E00,518795,Carter; Andrea L,0,2,20,20
1715655147270,MCWP 50R,F00,518796,Miller; Elizabeth Deen,0,1,20,20
1715655147270,MCWP 50R,G00,518797,Guillen; Melinda,0,1,20,20
1715655148296,MMW 12R,A01,514034,Herbst; Matthew,0,2,16,16
1715655148296,MMW 12R,A02,514035,Herbst; Matthew,0,0,16,16
1715655149322,MMW 13R,A01,514037,Staff,0,5,16,16
1715655149322,MMW 13R,A02,514039,Staff,0,5,16,16
1715655149322,MMW 13R,A03,628519,Staff,0,4,16,16
1715655151376,SIO 295LS,A00,523233,Staff,10,0,30,20
1715655152408,SIO 295S,A00,523232,Staff,10,0,30,20
1715655153436,SIOC 290S,A01,637330,Merrifield; Mark A,21,0,30,9
1715655154461,SIOC 291S,A01,637333,Gabriel; Corey John,21,0,30,9
1715655155487,SOCI 117,A01,494376,Staff,0,5,5,5
1715655156513,WES 237B,A00,494380,Staff,10,0,20,10
1715655158587,AESE 279B,A00,494370,Wade; Jon P,0,0,33,33
1715655159612,AIP 97,001,660915,Van Den Einde; Yael Dahlia,9998,0,9999,1
1715655160644,AIP 197,001,627712,Vespa; Emanuel Ignacio,9995,0,9999,4
1715655160644,AIP 197,002,650778,Amir; On,9998,0,9999,1
1715655160644,AIP 197,003,650933,Avenancio-Leon; Carlos,9998,0,9999,1
1715655160644,AIP 197,004,658530,Heyman; Gail D.,9998,0,9999,1
1715655160644,AIP 197,005,658631,Neal; Sonya E,9998,0,9999,1
1715655160644,AIP 197,006,658671,Du; Songzi,9998,0,9999,1
1715655161670,ANAR 135S,A00,494369,Braswell; Geoffrey E.,0,0,0,0
1715655162696,BENG 196,001,628496,Engler; Adam J.,9998,0,9999,1
1715655162696,BENG 196,002,660916,Watson; John Thomas,9998,0,9999,1
1715655163727,BISP 197,001,650773,Wilhelm; James E.,9994,0,9999,5
1715655163727,BISP 197,002,658904,Coleman; Aaron B.,9998,0,9999,1
1715655164752,CAT 124RS,A01,519847,Geibel; William,0,0,20,20
1715655165778,CAT 125RS,A01,515971,Geibel; William,0,0,20,20
1715655166802,CLRE 250,A00,511389,Morris; Sheldon,9992,0,9999,7
1715655167832,CLRE 251,A00,507176,Mehta; Ravindra L.,9992,0,9999,7
1715655167832,CLRE 251,B00,511410,Mehta; Ravindra L.,9998,0,9999,1
1715655168859,CLRE 252,A00,507189,Cuomo; Raphael Eduardo,9994,0,9999,5
1715655169883,CLRE 253,A00,507199,Vaida; Florin,9994,0,9999,5
1715655169883,CLRE 253,B00,507202,Vaida; Florin,9999,0,9999,0
1715655170909,CLRE 259,A00,507211,Patel; Hemal,9996,0,9999,3
1715655171936,CLRE 260,A00,507221,Cuomo; Raphael Eduardo,9999,0,9999,0
1715655172962,CLRE 297,001,507242,Cuomo; Raphael Eduardo,9999,0,9999,0
1715655173991,COGS 197,001,638244,Voytek; Bradley Thomas,9997,0,9999,2
1715655175018,CSE 191,A00,516875,Minnes Kemp; Mor Mia,9991,0,9999,8
1715655176046,CSE 197,001,637388,Minnes Kemp; Mor Mia,9992,0,9999,7
1715655177073,CSS 201S,A01,494383,Mignozzetti; Umberto,35,0,35,0
1715655178102,CSS 202S,A01,494387,Mignozzetti; Umberto,35,0,35,0
1715655179127,DSC 197,001,628532,Eldridge; Justin Matthew,9995,0,9999,4
1715655180153,EAP 100,A00,516065,Staff,9799,0,9999,200
1715655181181,ECE 45,A01,507414,Staff,32,0,60,28
1715655183232,ECE 111,A01,507420,Staff,11,0,50,39
1715655184257,ECE 197,001,548057,Sievenpiper; Daniel F.,9991,0,9999,8
1715655185283,EDS 115,A00,507243,Choi; Bailey Miyeon,6,0,28,22
1715655186311,EDS 117,A01,494379,Staff,0,6,34,35
1715655187337,EDS 125,A00,507246,Hopkins; Megan Beth,7,0,30,23
1715655188369,EDS 128A,A01,507264,Fargason; Sharon Gayle,5,0,26,21
1715655189395,EDS 128B,A01,507293,Pappas; Elizabeth,9,0,30,21
1715655190423,EDS 139,A00,507294,Fargason; Sharon Gayle,9,0,30,21
1715655190423,EDS 139,B00,507313,Pappas; Elizabeth,9,0,30,21
1715655191449,EDS 201,A00,507315,Staff,10,0,30,20
1715655192482,EDS 203,A01,507317,Halter; Christopher P.,10,0,30,20
1715655193512,EDS 204R,A01,507319,Halter; Christopher P.,0,3,30,30
1715655193512,EDS 204R,B01,507331,Heinzman; Erica M.,14,0,30,16
1715655194537,EDS 206R,A00,507332,Staff,0,4,30,30
1715655194537,EDS 206R,B00,507343,Staff,15,0,30,15
1715655195567,EDS 250,A00,507344,Hemans; Patricia Ann Benitez,20,0,40,20
1715655196591,EDS 281,A00,507345,Daly; Alan J.,18,0,18,0
1715655197619,EDS 284,A00,507350,Daly; Alan J.,16,0,16,0
1715655198643,EDS 286,A00,507359,Fine; Sarah,18,0,18,0
1715655199668,EDS 289C,A01,507361,Daly; Alan J.,18,0,18,0
1715655200694,EDS 290,A00,507366,Hofstetter; Carolyn,15,0,15,0
1715655201721,LIGM 5A,A00,507421,Fischer-Grunski; Eva K,17,0,20,3
1715655202748,LIGM 5B,A00,507423,Fischer-Grunski; Eva K,19,0,20,1
1715655203776,LIGM 5C,A00,507425,Fischer-Grunski; Eva K,19,0,20,1
1715655204803,LIIT 5AS,A00,507427,Carnelos; Chiara,20,0,20,0
1715655205830,LIIT 5BS,A00,507430,Carnelos; Chiara,20,0,20,0
1715655206858,LIIT 5CS,A00,507432,Carnelos; Chiara,20,0,20,0
1715655207888,LISP 5A,A00,507541,Munoz Sanchez; Alicia,11,0,20,9
1715655208914,LISP 5B,A00,507671,Munoz Sanchez; Alicia,8,0,20,12
1715655209940,LISP 5C,A00,507696,Munoz Sanchez; Alicia,8,0,20,12
1715655210968,MAE 197,001,528363,Boechler; Nicholas Sebastia,9998,0,9999,1
1715655211996,MATH 197,001,523477,Kedlaya; Kiran S.,9994,0,9999,5
1715655211996,MATH 197,002,563811,Zhang; Danna,9994,0,9999,5
1715655211996,MATH 197,003,628552,Dumitriu; Ioana,9998,0,9999,1
1715655211996,MATH 197,004,660885,Floyd; Eric,9998,0,9999,1
1715655213025,MCWP 40R,A00,518780,Staff,1,0,20,19
1715655213025,MCWP 40R,B00,518781,Carter; Jennifer A,9,0,20,11
1715655213025,MCWP 40R,C00,518783,Smith; Haydee Marie,5,0,20,15
1715655214055,MCWP 50R,A00,518791,Redela; Pamela Morgan,0,1,20,20
1715655214055,MCWP 50R,B00,518792,Krone; Jarret,0,2,20,20
1715655214055,MCWP 50R,C00,518793,Staff,0,4,20,20
1715655214055,MCWP 50R,D00,518794,Morshed; Michael James,0,2,20,20
1715655214055,MCWP 50R,E00,518795,Carter; Andrea L,0,2,20,20
1715655214055,MCWP 50R,F00,518796,Miller; Elizabeth Deen,0,1,20,20
1715655214055,MCWP 50R,G00,518797,Guillen; Melinda,0,1,20,20
1715655215085,MMW 12R,A01,514034,Herbst; Matthew,0,2,16,16
1715655215085,MMW 12R,A02,514035,Herbst; Matthew,0,0,16,16
1715655216110,MMW 13R,A01,514037,Staff,0,5,16,16
1715655216110,MMW 13R,A02,514039,Staff,0,5,16,16
1715655216110,MMW 13R,A03,628519,Staff,0,4,16,16
1715655218163,SIO 295LS,A00,523233,Staff,10,0,30,20
1715655219191,SIO 295S,A00,523232,Staff,10,0,30,20
1715655220219,SIOC 290S,A01,637330,Merrifield; Mark A,21,0,30,9
1715655221249,SIOC 291S,A01,637333,Gabriel; Corey John,21,0,30,9
1715655222278,SOCI 117,A01,494376,Staff,0,5,5,5
1715655223303,WES 237B,A00,494380,Staff,10,0,20,10
1715655225378,AESE 279B,A00,494370,Wade; Jon P,0,0,33,33
1715655226409,AIP 97,001,660915,Van Den Einde; Yael Dahlia,9998,0,9999,1
1715655227438,AIP 197,001,627712,Vespa; Emanuel Ignacio,9995,0,9999,4
1715655227438,AIP 197,002,650778,Amir; On,9998,0,9999,1
1715655227438,AIP 197,003,650933,Avenancio-Leon; Carlos,9998,0,9999,1
1715655227438,AIP 197,004,658530,Heyman; Gail D.,9998,0,9999,1
1715655227438,AIP 197,005,658631,Neal; Sonya E,9998,0,9999,1
1715655227438,AIP 197,006,658671,Du; Songzi,9998,0,9999,1
1715655228464,ANAR 135S,A00,494369,Braswell; Geoffrey E.,0,0,0,0
1715655229493,BENG 196,001,628496,Engler; Adam J.,9998,0,9999,1
1715655229493,BENG 196,002,660916,Watson; John Thomas,9998,0,9999,1
1715655230520,BISP 197,001,650773,Wilhelm; James E.,9994,0,9999,5
1715655230520,BISP 197,002,658904,Coleman; Aaron B.,9998,0,9999,1
1715655231548,CAT 124RS,A01,519847,Geibel; William,0,0,20,20
1715655232574,CAT 125RS,A01,515971,Geibel; William,0,0,20,20
1715655233601,CLRE 250,A00,511389,Morris; Sheldon,9992,0,9999,7
1715655234632,CLRE 251,A00,507176,Mehta; Ravindra L.,9992,0,9999,7
1715655234632,CLRE 251,B00,511410,Mehta; Ravindra L.,9998,0,9999,1
1715655235657,CLRE 252,A00,507189,Cuomo; Raphael Eduardo,9994,0,9999,5
1715655236684,CLRE 253,A00,507199,Vaida; Florin,9994,0,9999,5
1715655236684,CLRE 253,B00,507202,Vaida; Florin,9999,0,9999,0
1715655237709,CLRE 259,A00,507211,Patel; Hemal,9996,0,9999,3
1715655238735,CLRE 260,A00,507221,Cuomo; Raphael Eduardo,9999,0,9999,0
1715655239763,CLRE 297,001,507242,Cuomo; Raphael Eduardo,9999,0,9999,0
1715655240790,COGS 197,001,638244,Voytek; Bradley Thomas,9997,0,9999,2
1715655241816,CSE 191,A00,516875,Minnes Kemp; Mor Mia,9991,0,9999,8
1715655242842,CSE 197,001,637388,Minnes Kemp; Mor Mia,9992,0,9999,7
1715655243870,CSS 201S,A01,494383,Mignozzetti; Umberto,35,0,35,0
1715655244895,CSS 202S,A01,494387,Mignozzetti; Umberto,35,0,35,0
1715655245924,DSC 197,001,628532,Eldridge; Justin Matthew,9995,0,9999,4
1715655246951,EAP 100,A00,516065,Staff,9799,0,9999,200
1715655247980,ECE 45,A01,507414,Staff,32,0,60,28
1715655250033,ECE 111,A01,507420,Staff,11,0,50,39
1715655251060,ECE 197,001,548057,Sievenpiper; Daniel F.,9991,0,9999,8
1715655252089,EDS 115,A00,507243,Choi; Bailey Miyeon,6,0,28,22
1715655253116,EDS 117,A01,494379,Staff,0,6,34,35
1715655254142,EDS 125,A00,507246,Hopkins; Megan Beth,7,0,30,23
1715655255171,EDS 128A,A01,507264,Fargason; Sharon Gayle,5,0,26,21
1715655256196,EDS 128B,A01,507293,Pappas; Elizabeth,9,0,30,21
1715655257226,EDS 139,A00,507294,Fargason; Sharon Gayle,9,0,30,21
1715655257226,EDS 139,B00,507313,Pappas; Elizabeth,9,0,30,21
1715655258277,EDS 201,A00,507315,Staff,10,0,30,20
1715655259303,EDS 203,A01,507317,Halter; Christopher P.,10,0,30,20
1715655260332,EDS 204R,A01,507319,Halter; Christopher P.,0,3,30,30
1715655260332,EDS 204R,B01,507331,Heinzman; Erica M.,14,0,30,16
1715655261357,EDS 206R,A00,507332,Staff,0,4,30,30
1715655261357,EDS 206R,B00,507343,Staff,15,0,30,15
1715655262383,EDS 250,A00,507344,Hemans; Patricia Ann Benitez,20,0,40,20
1715655263412,EDS 281,A00,507345,Daly; Alan J.,18,0,18,0
1715655264437,EDS 284,A00,507350,Daly; Alan J.,16,0,16,0
1715655265463,EDS 286,A00,507359,Fine; Sarah,18,0,18,0
1715655266488,EDS 289C,A01,507361,Daly; Alan J.,18,0,18,0
1715655267518,EDS 290,A00,507366,Hofstetter; Carolyn,15,0,15,0
1715655268544,LIGM 5A,A00,507421,Fischer-Grunski; Eva K,17,0,20,3
1715655269571,LIGM 5B,A00,507423,Fischer-Grunski; Eva K,19,0,20,1
1715655270599,LIGM 5C,A00,507425,Fischer-Grunski; Eva K,19,0,20,1
1715655271625,LIIT 5AS,A00,507427,Carnelos; Chiara,20,0,20,0
1715655272652,LIIT 5BS,A00,507430,Carnelos; Chiara,20,0,20,0
1715655273678,LIIT 5CS,A00,507432,Carnelos; Chiara,20,0,20,0
1715655274707,LISP 5A,A00,507541,Munoz Sanchez; Alicia,11,0,20,9
1715655275736,LISP 5B,A00,507671,Munoz Sanchez; Alicia,8,0,20,12
1715655276761,LISP 5C,A00,507696,Munoz Sanchez; Alicia,8,0,20,12
1715655277786,MAE 197,001,528363,Boechler; Nicholas Sebastia,9998,0,9999,1
1715655278817,MATH 197,001,523477,Kedlaya; Kiran S.,9994,0,9999,5
1715655278817,MATH 197,002,563811,Zhang; Danna,9994,0,9999,5
1715655278817,MATH 197,003,628552,Dumitriu; Ioana,9998,0,9999,1
1715655278817,MATH 197,004,660885,Floyd; Eric,9998,0,9999,1
1715655279845,MCWP 40R,A00,518780,Staff,1,0,20,19
1715655279845,MCWP 40R,B00,518781,Carter; Jennifer A,9,0,20,11
1715655279845,MCWP 40R,C00,518783,Smith; Haydee Marie,5,0,20,15
1715655280875,MCWP 50R,A00,518791,Redela; Pamela Morgan,0,1,20,20
1715655280875,MCWP 50R,B00,518792,Krone; Jarret,0,2,20,20
1715655280875,MCWP 50R,C00,518793,Staff,0,4,20,20
1715655280875,MCWP 50R,D00,518794,Morshed; Michael James,0,2,20,20
1715655280875,MCWP 50R,E00,518795,Carter; Andrea L,0,2,20,20
1715655280875,MCWP 50R,F00,518796,Miller; Elizabeth Deen,0,1,20,20
1715655280875,MCWP 50R,G00,518797,Guillen; Melinda,0,1,20,20
1715655281902,MMW 12R,A01,514034,Herbst; Matthew,0,2,16,16
1715655281902,MMW 12R,A02,514035,Herbst; Matthew,0,0,16,16
1715655282928,MMW 13R,A01,514037,Staff,0,5,16,16
1715655282928,MMW 13R,A02,514039,Staff,0,5,16,16
1715655282928,MMW 13R,A03,628519,Staff,0,4,16,16
1715655284979,SIO 295LS,A00,523233,Staff,10,0,30,20
1715655286006,SIO 295S,A00,523232,Staff,10,0,30,20
1715655287032,SIOC 290S,A01,637330,Merrifield; Mark A,21,0,30,9
1715655288063,SIOC 291S,A01,637333,Gabriel; Corey John,21,0,30,9
1715655289088,SOCI 117,A01,494376,Staff,0,5,5,5
1715655290117,WES 237B,A00,494380,Staff,10,0,20,10
1715655292192,AESE 279B,A00,494370,Wade; Jon P,0,0,33,33
1715655293219,AIP 97,001,660915,Van Den Einde; Yael Dahlia,9998,0,9999,1
1715655294249,AIP 197,001,627712,Vespa; Emanuel Ignacio,9995,0,9999,4
1715655294249,AIP 197,002,650778,Amir; On,9998,0,9999,1
1715655294249,AIP 197,003,650933,Avenancio-Leon; Carlos,9998,0,9999,1
1715655294249,AIP 197,004,658530,Heyman; Gail D.,9998,0,9999,1
1715655294249,AIP 197,005,658631,Neal; Sonya E,9998,0,9999,1
1715655294249,AIP 197,006,658671,Du; Songzi,9998,0,9999,1
1715655295278,ANAR 135S,A00,494369,Braswell; Geoffrey E.,0,0,0,0
1715655296360,BENG 196,001,628496,Engler; Adam J.,9998,0,9999,1
1715655296360,BENG 196,002,660916,Watson; John Thomas,9998,0,9999,1
1715655297388,BISP 197,001,650773,Wilhelm; James E.,9994,0,9999,5
1715655297388,BISP 197,002,658904,Coleman; Aaron B.,9998,0,9999,1
1715655298413,CAT 124RS,A01,519847,Geibel; William,0,0,20,20
1715655299439,CAT 125RS,A01,515971,Geibel; William,0,0,20,20
1715655300464,CLRE 250,A00,511389,Morris; Sheldon,9992,0,9999,7
1715655301491,CLRE 251,A00,507176,Mehta; Ravindra L.,9992,0,9999,7
1715655301491,CLRE 251,B00,511410,Mehta; Ravindra L.,9998,0,9999,1
1715655302517,CLRE 252,A00,507189,Cuomo; Raphael Eduardo,9994,0,9999,5
1715655303545,CLRE 253,A00,507199,Vaida; Florin,9994,0,9999,5
1715655303545,CLRE 253,B00,507202,Vaida; Florin,9999,0,9999,0
1715655304570,CLRE 259,A00,507211,Patel; Hemal,9996,0,9999,3
1715655305596,CLRE 260,A00,507221,Cuomo; Raphael Eduardo,9999,0,9999,0
1715655306622,CLRE 297,001,507242,Cuomo; Raphael Eduardo,9999,0,9999,0
1715655307646,COGS 197,001,638244,Voytek; Bradley Thomas,9997,0,9999,2
1715655308674,CSE 191,A00,516875,Minnes Kemp; Mor Mia,9991,0,9999,8
1715655309700,CSE 197,001,637388,Minnes Kemp; Mor Mia,9992,0,9999,7
1715655310726,CSS 201S,A01,494383,Mignozzetti; Umberto,35,0,35,0
1715655311758,CSS 202S,A01,494387,Mignozzetti; Umberto,35,0,35,0
1715655312782,DSC 197,001,628532,Eldridge; Justin Matthew,9995,0,9999,4
1715655313809,EAP 100,A00,516065,Staff,9799,0,9999,200
1715655314840,ECE 45,A01,507414,Staff,32,0,60,28
1715655316896,ECE 111,A01,507420,Staff,11,0,50,39
1715655317923,ECE 197,001,548057,Sievenpiper; Daniel F.,9991,0,9999,8
1715655318951,EDS 115,A00,507243,Choi; Bailey Miyeon,6,0,28,22
1715655319980,EDS 117,A01,494379,Staff,0,6,34,35
1715655321006,EDS 125,A00,507246,Hopkins; Megan Beth,7,0,30,23
1715655322036,EDS 128A,A01,507264,Fargason; Sharon Gayle,5,0,26,21
1715655323064,EDS 128B,A01,507293,Pappas; Elizabeth,9,0,30,21
1715655324092,EDS 139,A00,507294,Fargason; Sharon Gayle,9,0,30,21
1715655324092,EDS 139,B00,507313,Pappas; Elizabeth,9,0,30,21
1715655325116,EDS 201,A00,507315,Staff,10,0,30,20
1715655326142,EDS 203,A01,507317,Halter; Christopher P.,10,0,30,20
1715655327168,EDS 204R,A01,507319,Halter; Christopher P.,0,3,30,30
1715655327168,EDS 204R,B01,507331,Heinzman; Erica M.,14,0,30,16
1715655328195,EDS 206R,A00,507332,Staff,0,4,30,30
1715655328195,EDS 206R,B00,507343,Staff,15,0,30,15
1715655329221,EDS 250,A00,507344,Hemans; Patricia Ann Benitez,20,0,40,20
1715655330247,EDS 281,A00,507345,Daly; Alan J.,18,0,18,0
1715655331273,EDS 284,A00,507350,Daly; Alan J.,16,0,16,0
1715655332298,EDS 286,A00,507359,Fine; Sarah,18,0,18,0
1715655333323,EDS 289C,A01,507361,Daly; Alan J.,18,0,18,0
1715655334349,EDS 290,A00,507366,Hofstetter; Carolyn,15,0,15,0
1715655335375,LIGM 5A,A00,507421,Fischer-Grunski; Eva K,17,0,20,3
1715655336400,LIGM 5B,A00,507423,Fischer-Grunski; Eva K,19,0,20,1
1715655337429,LIGM 5C,A00,507425,Fischer-Grunski; Eva K,19,0,20,1
1715655338454,LIIT 5AS,A00,507427,Carnelos; Chiara,20,0,20,0
1715655339481,LIIT 5BS,A00,507430,Carnelos; Chiara,20,0,20,0
1715655340510,LIIT 5CS,A00,507432,Carnelos; Chiara,20,0,20,0
1715655341536,LISP 5A,A00,507541,Munoz Sanchez; Alicia,11,0,20,9
1715655342564,LISP 5B,A00,507671,Munoz Sanchez; Alicia,8,0,20,12
1715655343590,LISP 5C,A00,507696,Munoz Sanchez; Alicia,8,0,20,12
1715655344616,MAE 197,001,528363,Boechler; Nicholas Sebastia,9998,0,9999,1
1715655345647,MATH 197,001,523477,Kedlaya; Kiran S.,9994,0,9999,5
1715655345647,MATH 197,002,563811,Zhang; Danna,9994,0,9999,5
1715655345647,MATH 197,003,628552,Dumitriu; Ioana,9998,0,9999,1
1715655345647,MATH 197,004,660885,Floyd; Eric,9998,0,9999,1
1715655346677,MCWP 40R,A00,518780,Staff,1,0,20,19
1715655346677,MCWP 40R,B00,518781,Carter; Jennifer A,9,0,20,11
1715655346677,MCWP 40R,C00,518783,Smith; Haydee Marie,5,0,20,15
1715655347711,MCWP 50R,A00,518791,Redela; Pamela Morgan,0,1,20,20
1715655347711,MCWP 50R,B00,518792,Krone; Jarret,0,2,20,20
1715655347711,MCWP 50R,C00,518793,Staff,0,4,20,20
1715655347711,MCWP 50R,D00,518794,Morshed; Michael James,0,2,20,20
1715655347711,MCWP 50R,E00,518795,Carter; Andrea L,0,2,20,20
1715655347711,MCWP 50R,F00,518796,Miller; Elizabeth Deen,0,1,20,20
1715655347711,MCWP 50R,G00,518797,Guillen; Melinda,0,1,20,20
1715655348737,MMW 12R,A01,514034,Herbst; Matthew,0,2,16,16
1715655348737,MMW 12R,A02,514035,Herbst; Matthew,0,0,16,16
1715655349761,MMW 13R,A01,514037,Staff,0,5,16,16
1715655349761,MMW 13R,A02,514039,Staff,0,5,16,16
1715655349761,MMW 13R,A03,628519,Staff,0,4,16,16
1715655351818,SIO 295LS,A00,523233,Staff,10,0,30,20
1715655352846,SIO 295S,A00,523232,Staff,10,0,30,20
1715655353882,SIOC 290S,A01,637330,Merrifield; Mark A,21,0,30,9
1715655354908,SIOC 291S,A01,637333,Gabriel; Corey John,21,0,30,9
1715655355936,SOCI 117,A01,494376,Staff,0,5,5,5
1715655356962,WES 237B,A00,494380,Staff,10,0,20,10
1715655359028,AESE 279B,A00,494370,Wade; Jon P,0,0,33,33
1715655360056,AIP 97,001,660915,Van Den Einde; Yael Dahlia,9998,0,9999,1
1715655361093,AIP 197,001,627712,Vespa; Emanuel Ignacio,9995,0,9999,4
1715655361093,AIP 197,002,650778,Amir; On,9998,0,9999,1
1715655361093,AIP 197,003,650933,Avenancio-Leon; Carlos,9998,0,9999,1
1715655361093,AIP 197,004,658530,Heyman; Gail D.,9998,0,9999,1
1715655361093,AIP 197,005,658631,Neal; Sonya E,9998,0,9999,1
1715655361093,AIP 197,006,658671,Du; Songzi,9998,0,9999,1
1715655362118,ANAR 135S,A00,494369,Braswell; Geoffrey E.,0,0,0,0
1715655363146,BENG 196,001,628496,Engler; Adam J.,9998,0,9999,1
1715655363146,BENG 196,002,660916,Watson; John Thomas,9998,0,9999,1
1715655364174,BISP 197,001,650773,Wilhelm; James E.,9994,0,9999,5
1715655364174,BISP 197,002,658904,Coleman; Aaron B.,9998,0,9999,1
1715655365200,CAT 124RS,A01,519847,Geibel; William,0,0,20,20
1715655366225,CAT 125RS,A01,515971,Geibel; William,0,0,20,20
1715655367250,CLRE 250,A00,511389,Morris; Sheldon,9992,0,9999,7
1715655368276,CLRE 251,A00,507176,Mehta; Ravindra L.,9992,0,9999,7
1715655368276,CLRE 251,B00,511410,Mehta; Ravindra L.,9998,0,9999,1
1715655369302,CLRE 252,A00,507189,Cuomo; Raphael Eduardo,9994,0,9999,5
1715655370328,CLRE 253,A00,507199,Vaida; Florin,9994,0,9999,5
1715655370328,CLRE 253,B00,507202,Vaida; Florin,9999,0,9999,0
1715655371352,CLRE 259,A00,507211,Patel; Hemal,9996,0,9999,3
1715655372379,CLRE 260,A00,507221,Cuomo; Raphael Eduardo,9999,0,9999,0
1715655373406,CLRE 297,001,507242,Cuomo; Raphael Eduardo,9999,0,9999,0
1715655374434,COGS 197,001,638244,Voytek; Bradley Thomas,9997,0,9999,2
1715655375459,CSE 191,A00,516875,Minnes Kemp; Mor Mia,9991,0,9999,8
1715655376487,CSE 197,001,637388,Minnes Kemp; Mor Mia,9992,0,9999,7
1715655377518,CSS 201S,A01,494383,Mignozzetti; Umberto,35,0,35,0
1715655378548,CSS 202S,A01,494387,Mignozzetti; Umberto,35,0,35,0
1715655379573,DSC 197,001,628532,Eldridge; Justin Matthew,9995,0,9999,4
1715655380600,EAP 100,A00,516065,Staff,9799,0,9999,200
1715655381685,ECE 45,A01,507414,Staff,32,0,60,28
1715655383737,ECE 111,A01,507420,Staff,11,0,50,39
1715655384762,ECE 197,001,548057,Sievenpiper; Daniel F.,9991,0,9999,8
1715655385792,EDS 115,A00,507243,Choi; Bailey Miyeon,6,0,28,22
1715655386822,EDS 117,A01,494379,Staff,0,6,34,35
1715655387848,EDS 125,A00,507246,Hopkins; Megan Beth,7,0,30,23
1715655388872,EDS 128A,A01,507264,Fargason; Sharon Gayle,5,0,26,21
1715655389900,EDS 128B,A01,507293,Pappas; Elizabeth,9,0,30,21
1715655390927,EDS 139,A00,507294,Fargason; Sharon Gayle,9,0,30,21
1715655390927,EDS 139,B00,507313,Pappas; Elizabeth,9,0,30,21
1715655391953,EDS 201,A00,507315,Staff,10,0,30,20
1715655392979,EDS 203,A01,507317,Halter; Christopher P.,10,0,30,20
1715655394007,EDS 204R,A01,507319,Halter; Christopher P.,0,3,30,30
1715655394007,EDS 204R,B01,507331,Heinzman; Erica M.,14,0,30,16
1715655395030,EDS 206R,A00,507332,Staff,0,4,30,30
1715655395030,EDS 206R,B00,507343,Staff,15,0,30,15
1715655396055,EDS 250,A00,507344,Hemans; Patricia Ann Benitez,20,0,40,20
1715655397080,EDS 281,A00,507345,Daly; Alan J.,18,0,18,0
1715655398105,EDS 284,A00,507350,Daly; Alan J.,16,0,16,0
1715655399131,EDS 286,A00,507359,Fine; Sarah,18,0,18,0
1715655400156,EDS 289C,A01,507361,Daly; Alan J.,18,0,18,0
1715655401187,EDS 290,A00,507366,Hofstetter; Carolyn,15,0,15,0
1715655402214,LIGM 5A,A00,507421,Fischer-Grunski; Eva K,17,0,20,3
1715655403245,LIGM 5B,A00,507423,Fischer-Grunski; Eva K,19,0,20,1
1715655404269,LIGM 5C,A00,507425,Fischer-Grunski; Eva K,19,0,20,1
1715655405295,LIIT 5AS,A00,507427,Carnelos; Chiara,20,0,20,0
1715655406323,LIIT 5BS,A00,507430,Carnelos; Chiara,20,0,20,0
1715655407350,LIIT 5CS,A00,507432,Carnelos; Chiara,20,0,20,0
1715655408382,LISP 5A,A00,507541,Munoz Sanchez; Alicia,11,0,20,9
1715655409409,LISP 5B,A00,507671,Munoz Sanchez; Alicia,8,0,20,12
1715655410434,LISP 5C,A00,507696,Munoz Sanchez; Alicia,8,0,20,12
1715655411462,MAE 197,001,528363,Boechler; Nicholas Sebastia,9998,0,9999,1
1715655412496,MATH 197,001,523477,Kedlaya; Kiran S.,9994,0,9999,5
1715655412496,MATH 197,002,563811,Zhang; Danna,9994,0,9999,5
1715655412496,MATH 197,003,628552,Dumitriu; Ioana,9998,0,9999,1
1715655412496,MATH 197,004,660885,Floyd; Eric,9998,0,9999,1
1715655413522,MCWP 40R,A00,518780,Staff,1,0,20,19
1715655413522,MCWP 40R,B00,518781,Carter; Jennifer A,9,0,20,11
1715655413522,MCWP 40R,C00,518783,Smith; Haydee Marie,5,0,20,15
1715655414551,MCWP 50R,A00,518791,Redela; Pamela Morgan,0,1,20,20
1715655414551,MCWP 50R,B00,518792,Krone; Jarret,0,2,20,20
1715655414551,MCWP 50R,C00,518793,Staff,0,4,20,20
1715655414551,MCWP 50R,D00,518794,Morshed; Michael James,0,2,20,20
1715655414551,MCWP 50R,E00,518795,Carter; Andrea L,0,2,20,20
1715655414551,MCWP 50R,F00,518796,Miller; Elizabeth Deen,0,1,20,20
1715655414551,MCWP 50R,G00,518797,Guillen; Melinda,0,1,20,20
1715655415578,MMW 12R,A01,514034,Herbst; Matthew,0,2,16,16
1715655415578,MMW 12R,A02,514035,Herbst; Matthew,0,0,16,16
1715655416605,MMW 13R,A01,514037,Staff,0,5,16,16
1715655416605,MMW 13R,A02,514039,Staff,0,5,16,16
1715655416605,MMW 13R,A03,628519,Staff,0,4,16,16
1715655418659,SIO 295LS,A00,523233,Staff,10,0,30,20
1715655419687,SIO 295S,A00,523232,Staff,10,0,30,20
1715655420714,SIOC 290S,A01,637330,Merrifield; Mark A,21,0,30,9
1715655421739,SIOC 291S,A01,637333,Gabriel; Corey John,21,0,30,9
1715655422764,SOCI 117,A01,494376,Staff,0,5,5,5
1715655423790,WES 237B,A00,494380,Staff,10,0,20,10
1715655425858,AESE 279B,A00,494370,Wade; Jon P,0,0,33,33
1715655426886,AIP 97,001,660915,Van Den Einde; Yael Dahlia,9998,0,9999,1
1715655427914,AIP 197,001,627712,Vespa; Emanuel Ignacio,9995,0,9999,4
1715655427914,AIP 197,002,650778,Amir; On,9998,0,9999,1
1715655427914,AIP 197,003,650933,Avenancio-Leon; Carlos,9998,0,9999,1
1715655427914,AIP 197,004,658530,Heyman; Gail D.,9998,0,9999,1
1715655427914,AIP 197,005,658631,Neal; Sonya E,9998,0,9999,1
1715655427914,AIP 197,006,658671,Du; Songzi,9998,0,9999,1
1715655428941,ANAR 135S,A00,494369,Braswell; Geoffrey E.,0,0,0,0
1715655429974,BENG 196,001,628496,Engler; Adam J.,9998,0,9999,1
1715655429974,BENG 196,002,660916,Watson; John Thomas,9998,0,9999,1
1715655430997,BISP 197,001,650773,Wilhelm; James E.,9994,0,9999,5
1715655430997,BISP 197,002,658904,Coleman; Aaron B.,9998,0,9999,1
1715655432025,CAT 124RS,A01,519847,Geibel; William,0,0,20,20
1715655433054,CAT 125RS,A01,515971,Geibel; William,0,0,20,20
1715655434080,CLRE 250,A00,511389,Morris; Sheldon,9992,0,9999,7
1715655435110,CLRE 251,A00,507176,Mehta; Ravindra L.,9992,0,9999,7
1715655435110,CLRE 251,B00,511410,Mehta; Ravindra L.,9998,0,9999,1
1715655436134,CLRE 252,A00,507189,Cuomo; Raphael Eduardo,9994,0,9999,5
1715655437160,CLRE 253,A00,507199,Vaida; Florin,9994,0,9999,5
1715655437160,CLRE 253,B00,507202,Vaida; Florin,9999,0,9999,0
1715655438186,CLRE 259,A00,507211,Patel; Hemal,9996,0,9999,3
1715655439211,CLRE 260,A00,507221,Cuomo; Raphael Eduardo,9999,0,9999,0
1715655440236,CLRE 297,001,507242,Cuomo; Raphael Eduardo,9999,0,9999,0
1715655441264,COGS 197,001,638244,Voytek; Bradley Thomas,9997,0,9999,2
1715655442287,CSE 191,A00,516875,Minnes Kemp; Mor Mia,9991,0,9999,8
1715655443312,CSE 197,001,637388,Minnes Kemp; Mor Mia,9992,0,9999,7
1715655444337,CSS 201S,A01,494383,Mignozzetti; Umberto,35,0,35,0
1715655445367,CSS 202S,A01,494387,Mignozzetti; Umberto,35,0,35,0
1715655446394,DSC 197,001,628532,Eldridge; Justin Matthew,9995,0,9999,4
1715655447421,EAP 100,A00,516065,Staff,9799,0,9999,200
1715655448446,ECE 45,A01,507414,Staff,32,0,60,28
1715655450499,ECE 111,A01,507420,Staff,11,0,50,39
1715655451526,ECE 197,001,548057,Sievenpiper; Daniel F.,9991,0,9999,8
1715655452571,EDS 115,A00,507243,Choi; Bailey Miyeon,6,0,28,22
1715655453596,EDS 117,A01,494379,Staff,0,6,34,35
1715655454624,EDS 125,A00,507246,Hopkins; Megan Beth,7,0,30,23
1715655455648,EDS 128A,A01,507264,Fargason; Sharon Gayle,5,0,26,21
1715655456678,EDS 128B,A01,507293,Pappas; Elizabeth,9,0,30,21
1715655457701,EDS 139,A00,507294,Fargason; Sharon Gayle,9,0,30,21
1715655457701,EDS 139,B00,507313,Pappas; Elizabeth,9,0,30,21
1715655458724,EDS 201,A00,507315,Staff,10,0,30,20
1715655459763,EDS 203,A01,507317,Halter; Christopher P.,10,0,30,20
1715655460792,EDS 204R,A01,507319,Halter; Christopher P.,0,3,30,30
1715655460792,EDS 204R,B01,507331,Heinzman; Erica M.,14,0,30,16
1715655461817,EDS 206R,A00,507332,Staff,0,4,30,30
1715655461817,EDS 206R,B00,507343,Staff,15,0,30,15
1715655462841,EDS 250,A00,507344,Hemans; Patricia Ann Benitez,20,0,40,20
1715655463867,EDS 281,A00,507345,Daly; Alan J.,18,0,18,0
1715655464892,EDS 284,A00,507350,Daly; Alan J.,16,0,16,0
1715655465917,EDS 286,A00,507359,Fine; Sarah,18,0,18,0
1715655466968,EDS 289C,A01,507361,Daly; Alan J.,18,0,18,0
1715655467996,EDS 290,A00,507366,Hofstetter; Carolyn,15,0,15,0
1715655469027,LIGM 5A,A00,507421,Fischer-Grunski; Eva K,17,0,20,3
1715655470053,LIGM 5B,A00,507423,Fischer-Grunski; Eva K,19,0,20,1
1715655471078,LIGM 5C,A00,507425,Fischer-Grunski; Eva K,19,0,20,1
1715655472103,LIIT 5AS,A00,507427,Carnelos; Chiara,20,0,20,0
1715655473131,LIIT 5BS,A00,507430,Carnelos; Chiara,20,0,20,0
1715655474155,LIIT 5CS,A00,507432,Carnelos; Chiara,20,0,20,0
1715655475180,LISP 5A,A00,507541,Munoz Sanchez; Alicia,11,0,20,9
1715655476207,LISP 5B,A00,507671,Munoz Sanchez; Alicia,8,0,20,12
1715655477235,LISP 5C,A00,507696,Munoz Sanchez; Alicia,8,0,20,12
1715655478261,MAE 197,001,528363,Boechler; Nicholas Sebastia,9998,0,9999,1
1715655479289,MATH 197,001,523477,Kedlaya; Kiran S.,9994,0,9999,5
1715655479289,MATH 197,002,563811,Zhang; Danna,9994,0,9999,5
1715655479289,MATH 197,003,628552,Dumitriu; Ioana,9998,0,9999,1
1715655479289,MATH 197,004,660885,Floyd; Eric,9998,0,9999,1
1715655480315,MCWP 40R,A00,518780,Staff,1,0,20,19
1715655480315,MCWP 40R,B00,518781,Carter; Jennifer A,9,0,20,11
1715655480315,MCWP 40R,C00,518783,Smith; Haydee Marie,5,0,20,15
1715655481343,MCWP 50R,A00,518791,Redela; Pamela Morgan,0,1,20,20
1715655481343,MCWP 50R,B00,518792,Krone; Jarret,0,2,20,20
1715655481343,MCWP 50R,C00,518793,Staff,0,4,20,20
1715655481343,MCWP 50R,D00,518794,Morshed; Michael James,0,2,20,20
1715655481343,MCWP 50R,E00,518795,Carter; Andrea L,0,2,20,20
1715655481343,MCWP 50R,F00,518796,Miller; Elizabeth Deen,0,1,20,20
1715655481343,MCWP 50R,G00,518797,Guillen; Melinda,0,1,20,20
1715655482372,MMW 12R,A01,514034,Herbst; Matthew,0,2,16,16
1715655482372,MMW 12R,A02,514035,Herbst; Matthew,0,0,16,16
1715655483396,MMW 13R,A01,514037,Staff,0,5,16,16
1715655483396,MMW 13R,A02,514039,Staff,0,5,16,16
1715655483396,MMW 13R,A03,628519,Staff,0,4,16,16
1715655485446,SIO 295LS,A00,523233,Staff,10,0,30,20
1715655486471,SIO 295S,A00,523232,Staff,10,0,30,20
1715655487497,SIOC 290S,A01,637330,Merrifield; Mark A,21,0,30,9
1715655488526,SIOC 291S,A01,637333,Gabriel; Corey John,21,0,30,9
1715655489551,SOCI 117,A01,494376,Staff,0,5,5,5
1715655490579,WES 237B,A00,494380,Staff,10,0,20,10
1715655492659,AESE 279B,A00,494370,Wade; Jon P,0,0,33,33
1715655493687,AIP 97,001,660915,Van Den Einde; Yael Dahlia,9998,0,9999,1
1715655494716,AIP 197,001,627712,Vespa; Emanuel Ignacio,9995,0,9999,4
1715655494716,AIP 197,002,650778,Amir; On,9998,0,9999,1
1715655494716,AIP 197,003,650933,Avenancio-Leon; Carlos,9998,0,9999,1
1715655494716,AIP 197,004,658530,Heyman; Gail D.,9998,0,9999,1
1715655494716,AIP 197,005,658631,Neal; Sonya E,9998,0,9999,1
1715655494716,AIP 197,006,658671,Du; Songzi,9998,0,9999,1
1715655495744,ANAR 135S,A00,494369,Braswell; Geoffrey E.,0,0,0,0
1715655496768,BENG 196,001,628496,Engler; Adam J.,9998,0,9999,1
1715655496768,BENG 196,002,660916,Watson; John Thomas,9998,0,9999,1
1715655497793,BISP 197,001,650773,Wilhelm; James E.,9994,0,9999,5
1715655497793,BISP 197,002,658904,Coleman; Aaron B.,9998,0,9999,1
1715655498821,CAT 124RS,A01,519847,Geibel; William,0,0,20,20
1715655499845,CAT 125RS,A01,515971,Geibel; William,0,0,20,20
1715655500873,CLRE 250,A00,511389,Morris; Sheldon,9992,0,9999,7
1715655501900,CLRE 251,A00,507176,Mehta; Ravindra L.,9992,0,9999,7
1715655501900,CLRE 251,B00,511410,Mehta; Ravindra L.,9998,0,9999,1
1715655502928,CLRE 252,A00,507189,Cuomo; Raphael Eduardo,9994,0,9999,5
1715655503953,CLRE 253,A00,507199,Vaida; Florin,9994,0,9999,5
1715655503953,CLRE 253,B00,507202,Vaida; Florin,9999,0,9999,0
1715655504977,CLRE 259,A00,507211,Patel; Hemal,9996,0,9999,3
1715655506005,CLRE 260,A00,507221,Cuomo; Raphael Eduardo,9999,0,9999,0
1715655507033,CLRE 297,001,507242,Cuomo; Raphael Eduardo,9999,0,9999,0
1715655508058,COGS 197,001,638244,Voytek; Bradley Thomas,9997,0,9999,2
1715655509087,CSE 191,A00,516875,Minnes Kemp; Mor Mia,9991,0,9999,8
1715655510110,CSE 197,001,637388,Minnes Kemp; Mor Mia,9992,0,9999,7
1715655511137,CSS 201S,A01,494383,Mignozzetti; Umberto,35,0,35,0
1715655512166,CSS 202S,A01,494387,Mignozzetti; Umberto,35,0,35,0
1715655513199,DSC 197,001,628532,Eldridge; Justin Matthew,9995,0,9999,4
1715655514225,EAP 100,A00,516065,Staff,9799,0,9999,200
1715655515252,ECE 45,A01,507414,Staff,32,0,60,28
1715655517304,ECE 111,A01,507420,Staff,11,0,50,39
1715655518333,ECE 197,001,548057,Sievenpiper; Daniel F.,9991,0,9999,8
1715655519361,EDS 115,A00,507243,Choi; Bailey Miyeon,6,0,28,22
1715655520442,EDS 117,A01,494379,Staff,0,6,34,35
1715655521470,EDS 125,A00,507246,Hopkins; Megan Beth,7,0,30,23
1715655522497,EDS 128A,A01,507264,Fargason; Sharon Gayle,5,0,26,21
1715655523522,EDS 128B,A01,507293,Pappas; Elizabeth,9,0,30,21
1715655524549,EDS 139,A00,507294,Fargason; Sharon Gayle,9,0,30,21
1715655524549,EDS 139,B00,507313,Pappas; Elizabeth,9,0,30,21
1715655525575,EDS 201,A00,507315,Staff,10,0,30,20
1715655526605,EDS 203,A01,507317,Halter; Christopher P.,10,0,30,20
1715655527634,EDS 204R,A01,507319,Halter; Christopher P.,0,3,30,30
1715655527634,EDS 204R,B01,507331,Heinzman; Erica M.,14,0,30,16
1715655528663,EDS 206R,A00,507332,Staff,0,4,30,30
1715655528663,EDS 206R,B00,507343,Staff,15,0,30,15
1715655529692,EDS 250,A00,507344,Hemans; Patricia Ann Benitez,20,0,40,20
1715655530718,EDS 281,A00,507345,Daly; Alan J.,18,0,18,0
1715655531744,EDS 284,A00,507350,Daly; Alan J.,16,0,16,0
1715655532772,EDS 286,A00,507359,Fine; Sarah,18,0,18,0
1715655533797,EDS 289C,A01,507361,Daly; Alan J.,18,0,18,0
1715655534828,EDS 290,A00,507366,Hofstetter; Carolyn,15,0,15,0
1715655535857,LIGM 5A,A00,507421,Fischer-Grunski; Eva K,17,0,20,3
1715655536888,LIGM 5B,A00,507423,Fischer-Grunski; Eva K,19,0,20,1
1715655537920,LIGM 5C,A00,507425,Fischer-Grunski; Eva K,19,0,20,1
1715655538944,LIIT 5AS,A00,507427,Carnelos; Chiara,20,0,20,0
1715655539972,LIIT 5BS,A00,507430,Carnelos; Chiara,20,0,20,0
1715655540999,LIIT 5CS,A00,507432,Carnelos; Chiara,20,0,20,0
1715655542029,LISP 5A,A00,507541,Munoz Sanchez; Alicia,11,0,20,9
1715655543057,LISP 5B,A00,507671,Munoz Sanchez; Alicia,8,0,20,12
1715655544092,LISP 5C,A00,507696,Munoz Sanchez; Alicia,8,0,20,12
1715655545120,MAE 197,001,528363,Boechler; Nicholas Sebastia,9998,0,9999,1
1715655546148,MATH 197,001,523477,Kedlaya; Kiran S.,9994,0,9999,5
1715655546148,MATH 197,002,563811,Zhang; Danna,9994,0,9999,5
1715655546148,MATH 197,003,628552,Dumitriu; Ioana,9998,0,9999,1
1715655546148,MATH 197,004,660885,Floyd; Eric,9998,0,9999,1
1715655547177,MCWP 40R,A00,518780,Staff,1,0,20,19
1715655547177,MCWP 40R,B00,518781,Carter; Jennifer A,9,0,20,11
1715655547177,MCWP 40R,C00,518783,Smith; Haydee Marie,5,0,20,15
1715655548206,MCWP 50R,A00,518791,Redela; Pamela Morgan,0,1,20,20
1715655548206,MCWP 50R,B00,518792,Krone; Jarret,0,2,20,20
1715655548206,MCWP 50R,C00,518793,Staff,0,4,20,20
1715655548206,MCWP 50R,D00,518794,Morshed; Michael James,0,2,20,20
1715655548206,MCWP 50R,E00,518795,Carter; Andrea L,0,2,20,20
1715655548206,MCWP 50R,F00,518796,Miller; Elizabeth Deen,0,1,20,20
1715655548206,MCWP 50R,G00,518797,Guillen; Melinda,0,1,20,20
1715655549231,MMW 12R,A01,514034,Herbst; Matthew,0,2,16,16
1715655549231,MMW 12R,A02,514035,Herbst; Matthew,0,0,16,16
1715655550259,MMW 13R,A01,514037,Staff,0,5,16,16
1715655550259,MMW 13R,A02,514039,Staff,0,5,16,16
1715655550259,MMW 13R,A03,628519,Staff,0,4,16,16
1715655552310,SIO 295LS,A00,523233,Staff,10,0,30,20
1715655553339,SIO 295S,A00,523232,Staff,10,0,30,20
1715655554365,SIOC 290S,A01,637330,Merrifield; Mark A,21,0,30,9
1715655555390,SIOC 291S,A01,637333,Gabriel; Corey John,21,0,30,9
1715655556414,SOCI 117,A01,494376,Staff,0,5,5,5
1715655557441,WES 237B,A00,494380,Staff,10,0,20,10
1715655559515,AESE 279B,A00,494370,Wade; Jon P,0,0,33,33
1715655560541,AIP 97,001,660915,Van Den Einde; Yael Dahlia,9998,0,9999,1
1715655561568,AIP 197,001,627712,Vespa; Emanuel Ignacio,9995,0,9999,4
1715655561568,AIP 197,002,650778,Amir; On,9998,0,9999,1
1715655561568,AIP 197,003,650933,Avenancio-Leon; Carlos,9998,0,9999,1
1715655561568,AIP 197,004,658530,Heyman; Gail D.,9998,0,9999,1
1715655561568,AIP 197,005,658631,Neal; Sonya E,9998,0,9999,1
1715655561568,AIP 197,006,658671,Du; Songzi,9998,0,9999,1
1715655562594,ANAR 135S,A00,494369,Braswell; Geoffrey E.,0,0,0,0
1715655563622,BENG 196,001,628496,Engler; Adam J.,9998,0,9999,1
1715655563622,BENG 196,002,660916,Watson; John Thomas,9998,0,9999,1
1715655564648,BISP 197,001,650773,Wilhelm; James E.,9994,0,9999,5
1715655564648,BISP 197,002,658904,Coleman; Aaron B.,9998,0,9999,1
1715655565674,CAT 124RS,A01,519847,Geibel; William,0,0,20,20
1715655566700,CAT 125RS,A01,515971,Geibel; William,0,0,20,20
1715655567729,CLRE 250,A00,511389,Morris; Sheldon,9992,0,9999,7
1715655568757,CLRE 251,A00,507176,Mehta; Ravindra L.,9992,0,9999,7
1715655568757,CLRE 251,B00,511410,Mehta; Ravindra L.,9998,0,9999,1
1715655569784,CLRE 252,A00,507189,Cuomo; Raphael Eduardo,9994,0,9999,5
1715655570810,CLRE 253,A00,507199,Vaida; Florin,9994,0,9999,5
1715655570810,CLRE 253,B00,507202,Vaida; Florin,9999,0,9999,0
1715655571835,CLRE 259,A00,507211,Patel; Hemal,9996,0,9999,3
1715655572862,CLRE 260,A00,507221,Cuomo; Raphael Eduardo,9999,0,9999,0
1715655573886,CLRE 297,001,507242,Cuomo; Raphael Eduardo,9999,0,9999,0
1715655574917,COGS 197,001,638244,Voytek; Bradley Thomas,9997,0,9999,2
1715655575942,CSE 191,A00,516875,Minnes Kemp; Mor Mia,9991,0,9999,8
1715655576970,CSE 197,001,637388,Minnes Kemp; Mor Mia,9992,0,9999,7
1715655577995,CSS 201S,A01,494383,Mignozzetti; Umberto,35,0,35,0
1715655579021,CSS 202S,A01,494387,Mignozzetti; Umberto,35,0,35,0
1715655580048,DSC 197,001,628532,Eldridge; Justin Matthew,9995,0,9999,4
1715655581073,EAP 100,A00,516065,Staff,9799,0,9999,200
1715655582101,ECE 45,A01,507414,Staff,32,0,60,28
1715655584152,ECE 111,A01,507420,Staff,11,0,50,39
1715655585177,ECE 197,001,548057,Sievenpiper; Daniel F.,9991,0,9999,8
1715655586208,EDS 115,A00,507243,Choi; Bailey Miyeon,6,0,28,22
1715655587233,EDS 117,A01,494379,Staff,0,6,34,35
1715655588260,EDS 125,A00,507246,Hopkins; Megan Beth,7,0,30,23
1715655589287,EDS 128A,A01,507264,Fargason; Sharon Gayle,5,0,26,21
1715655590317,EDS 128B,A01,507293,Pappas; Elizabeth,9,0,30,21
1715655591342,EDS 139,A00,507294,Fargason; Sharon Gayle,9,0,30,21
1715655591342,EDS 139,B00,507313,Pappas; Elizabeth,9,0,30,21
1715655592370,EDS 201,A00,507315,Staff,10,0,30,20
1715655593399,EDS 203,A01,507317,Halter; Christopher P.,10,0,30,20
1715655594427,EDS 204R,A01,507319,Halter; Christopher P.,0,3,30,30
1715655594427,EDS 204R,B01,507331,Heinzman; Erica M.,14,0,30,16
1715655595452,EDS 206R,A00,507332,Staff,0,4,30,30
1715655595452,EDS 206R,B00,507343,Staff,15,0,30,15
1715655596477,EDS 250,A00,507344,Hemans; Patricia Ann Benitez,20,0,40,20
1715655597502,EDS 281,A00,507345,Daly; Alan J.,18,0,18,0
1715655598530,EDS 284,A00,507350,Daly; Alan J.,16,0,16,0
1715655599557,EDS 286,A00,507359,Fine; Sarah,18,0,18,0
1715655600582,EDS 289C,A01,507361,Daly; Alan J.,18,0,18,0
1715655601608,EDS 290,A00,507366,Hofstetter; Carolyn,15,0,15,0
1715655602634,LIGM 5A,A00,507421,Fischer-Grunski; Eva K,17,0,20,3
1715655603662,LIGM 5B,A00,507423,Fischer-Grunski; Eva K,19,0,20,1
1715655604696,LIGM 5C,A00,507425,Fischer-Grunski; Eva K,19,0,20,1
1715655605722,LIIT 5AS,A00,507427,Carnelos; Chiara,20,0,20,0
1715655606752,LIIT 5BS,A00,507430,Carnelos; Chiara,20,0,20,0
1715655607779,LIIT 5CS,A00,507432,Carnelos; Chiara,20,0,20,0
1715655608810,LISP 5A,A00,507541,Munoz Sanchez; Alicia,11,0,20,9
1715655609836,LISP 5B,A00,507671,Munoz Sanchez; Alicia,8,0,20,12
1715655610866,LISP 5C,A00,507696,Munoz Sanchez; Alicia,8,0,20,12
1715655611893,MAE 197,001,528363,Boechler; Nicholas Sebastia,9998,0,9999,1
1715655612920,MATH 197,001,523477,Kedlaya; Kiran S.,9994,0,9999,5
1715655612920,MATH 197,002,563811,Zhang; Danna,9994,0,9999,5
1715655612920,MATH 197,003,628552,Dumitriu; Ioana,9998,0,9999,1
1715655612920,MATH 197,004,660885,Floyd; Eric,9998,0,9999,1
1715655613947,MCWP 40R,A00,518780,Staff,1,0,20,19
1715655613947,MCWP 40R,B00,518781,Carter; Jennifer A,9,0,20,11
1715655613947,MCWP 40R,C00,518783,Smith; Haydee Marie,5,0,20,15
1715655614979,MCWP 50R,A00,518791,Redela; Pamela Morgan,0,1,20,20
1715655614979,MCWP 50R,B00,518792,Krone; Jarret,0,2,20,20
1715655614979,MCWP 50R,C00,518793,Staff,0,4,20,20
1715655614979,MCWP 50R,D00,518794,Morshed; Michael James,0,2,20,20
1715655614979,MCWP 50R,E00,518795,Carter; Andrea L,0,2,20,20
1715655614979,MCWP 50R,F00,518796,Miller; Elizabeth Deen,0,1,20,20
1715655614979,MCWP 50R,G00,518797,Guillen; Melinda,0,1,20,20
1715655616006,MMW 12R,A01,514034,Herbst; Matthew,0,2,16,16
1715655616006,MMW 12R,A02,514035,Herbst; Matthew,0,0,16,16
1715655617035,MMW 13R,A01,514037,Staff,0,5,16,16
1715655617035,MMW 13R,A02,514039,Staff,0,5,16,16
1715655617035,MMW 13R,A03,628519,Staff,0,4,16,16
1715655619089,SIO 295LS,A00,523233,Staff,10,0,30,20
1715655620119,SIO 295S,A00,523232,Staff,10,0,30,20
1715655621147,SIOC 290S,A01,637330,Merrifield; Mark A,21,0,30,9
1715655622174,SIOC 291S,A01,637333,Gabriel; Corey John,21,0,30,9
1715655623199,SOCI 117,A01,494376,Staff,0,5,5,5
1715655624224,WES 237B,A00,494380,Staff,10,0,20,10
1715655626292,AESE 279B,A00,494370,Wade; Jon P,0,0,33,33
1715655627321,AIP 97,001,660915,Van Den Einde; Yael Dahlia,9998,0,9999,1
1715655628349,AIP 197,001,627712,Vespa; Emanuel Ignacio,9995,0,9999,4
1715655628349,AIP 197,002,650778,Amir; On,9998,0,9999,1
1715655628349,AIP 197,003,650933,Avenancio-Leon; Carlos,9998,0,9999,1
1715655628349,AIP 197,004,658530,Heyman; Gail D.,9998,0,9999,1
1715655628349,AIP 197,005,658631,Neal; Sonya E,9998,0,9999,1
1715655628349,AIP 197,006,658671,Du; Songzi,9998,0,9999,1
1715655629375,ANAR 135S,A00,494369,Braswell; Geoffrey E.,0,0,0,0
1715655630404,BENG 196,001,628496,Engler; Adam J.,9998,0,9999,1
1715655630404,BENG 196,002,660916,Watson; John Thomas,9998,0,9999,1
1715655631434,BISP 197,001,650773,Wilhelm; James E.,9994,0,9999,5
1715655631434,BISP 197,002,658904,Coleman; Aaron B.,9998,0,9999,1
1715655632464,CAT 124RS,A01,519847,Geibel; William,0,0,20,20
1715655633491,CAT 125RS,A01,515971,Geibel; William,0,0,20,20
1715655634518,CLRE 250,A00,511389,Morris; Sheldon,9992,0,9999,7
1715655635548,CLRE 251,A00,507176,Mehta; Ravindra L.,9992,0,9999,7
1715655635548,CLRE 251,B00,511410,Mehta; Ravindra L.,9998,0,9999,1
1715655636577,CLRE 252,A00,507189,Cuomo; Raphael Eduardo,9994,0,9999,5
1715655637607,CLRE 253,A00,507199,Vaida; Florin,9994,0,9999,5
1715655637607,CLRE 253,B00,507202,Vaida; Florin,9999,0,9999,0
1715655638637,CLRE 259,A00,507211,Patel; Hemal,9996,0,9999,3
1715655639662,CLRE 260,A00,507221,Cuomo; Raphael Eduardo,9999,0,9999,0
1715655640689,CLRE 297,001,507242,Cuomo; Raphael Eduardo,9999,0,9999,0
1715655641715,COGS 197,001,638244,Voytek; Bradley Thomas,9997,0,9999,2
1715655642745,CSE 191,A00,516875,Minnes Kemp; Mor Mia,9991,0,9999,8
1715655643769,CSE 197,001,637388,Minnes Kemp; Mor Mia,9992,0,9999,7
1715655644794,CSS 201S,A01,494383,Mignozzetti; Umberto,35,0,35,0
1715655645825,CSS 202S,A01,494387,Mignozzetti; Umberto,35,0,35,0
1715655646852,DSC 197,001,628532,Eldridge; Justin Matthew,9995,0,9999,4
1715655647880,EAP 100,A00,516065,Staff,9799,0,9999,200
1715655648911,ECE 45,A01,507414,Staff,32,0,60,28
1715655650964,ECE 111,A01,507420,Staff,11,0,50,39
1715655651992,ECE 197,001,548057,Sievenpiper; Daniel F.,9991,0,9999,8
1715655653018,EDS 115,A00,507243,Choi; Bailey Miyeon,6,0,28,22
1715655654045,EDS 117,A01,494379,Staff,0,6,34,35
1715655655075,EDS 125,A00,507246,Hopkins; Megan Beth,7,0,30,23
1715655656101,EDS 128A,A01,507264,Fargason; Sharon Gayle,5,0,26,21
1715655657130,EDS 128B,A01,507293,Pappas; Elizabeth,9,0,30,21
1715655658162,EDS 139,A00,507294,Fargason; Sharon Gayle,9,0,30,21
1715655658162,EDS 139,B00,507313,Pappas; Elizabeth,9,0,30,21
1715655659246,EDS 201,A00,507315,Staff,10,0,30,20
1715655660279,EDS 203,A01,507317,Halter; Christopher P.,10,0,30,20
1715655661305,EDS 204R,A01,507319,Halter; Christopher P.,0,3,30,30
1715655661305,EDS 204R,B01,507331,Heinzman; Erica M.,14,0,30,16
1715655662331,EDS 206R,A00,507332,Staff,0,4,30,30
1715655662331,EDS 206R,B00,507343,Staff,15,0,30,15
1715655663358,EDS 250,A00,507344,Hemans; Patricia Ann Benitez,20,0,40,20
1715655664388,EDS 281,A00,507345,Daly; Alan J.,18,0,18,0
1715655665414,EDS 284,A00,507350,Daly; Alan J.,16,0,16,0
1715655666440,EDS 286,A00,507359,Fine; Sarah,18,0,18,0
1715655667465,EDS 289C,A01,507361,Daly; Alan J.,18,0,18,0
1715655668491,EDS 290,A00,507366,Hofstetter; Carolyn,15,0,15,0
1715655669522,LIGM 5A,A00,507421,Fischer-Grunski; Eva K,17,0,20,3
1715655670548,LIGM 5B,A00,507423,Fischer-Grunski; Eva K,19,0,20,1
1715655671573,LIGM 5C,A00,507425,Fischer-Grunski; Eva K,19,0,20,1
1715655672602,LIIT 5AS,A00,507427,Carnelos; Chiara,20,0,20,0
1715655673628,LIIT 5BS,A00,507430,Carnelos; Chiara,20,0,20,0
1715655674653,LIIT 5CS,A00,507432,Carnelos; Chiara,20,0,20,0
1715655675678,LISP 5A,A00,507541,Munoz Sanchez; Alicia,11,0,20,9
1715655676705,LISP 5B,A00,507671,Munoz Sanchez; Alicia,8,0,20,12
1715655677734,LISP 5C,A00,507696,Munoz Sanchez; Alicia,8,0,20,12
1715655678759,MAE 197,001,528363,Boechler; Nicholas Sebastia,9998,0,9999,1
1715655679785,MATH 197,001,523477,Kedlaya; Kiran S.,9994,0,9999,5
1715655679785,MATH 197,002,563811,Zhang; Danna,9994,0,9999,5
1715655679785,MATH 197,003,628552,Dumitriu; Ioana,9998,0,9999,1
1715655679785,MATH 197,004,660885,Floyd; Eric,9998,0,9999,1
1715655680811,MCWP 40R,A00,518780,Staff,1,0,20,19
1715655680811,MCWP 40R,B00,518781,Carter; Jennifer A,9,0,20,11
1715655680811,MCWP 40R,C00,518783,Smith; Haydee Marie,5,0,20,15
1715655681844,MCWP 50R,A00,518791,Redela; Pamela Morgan,0,1,20,20
1715655681844,MCWP 50R,B00,518792,Krone; Jarret,0,2,20,20
1715655681844,MCWP 50R,C00,518793,Staff,0,4,20,20
1715655681844,MCWP 50R,D00,518794,Morshed; Michael James,0,2,20,20
1715655681844,MCWP 50R,E00,518795,Carter; Andrea L,0,2,20,20
1715655681844,MCWP 50R,F00,518796,Miller; Elizabeth Deen,0,1,20,20
1715655681844,MCWP 50R,G00,518797,Guillen; Melinda,0,1,20,20
1715655682871,MMW 12R,A01,514034,Herbst; Matthew,0,2,16,16
1715655682871,MMW 12R,A02,514035,Herbst; Matthew,0,0,16,16
1715655683903,MMW 13R,A01,514037,Staff,0,5,16,16
1715655683903,MMW 13R,A02,514039,Staff,0,5,16,16
1715655683903,MMW 13R,A03,628519,Staff,0,4,16,16
1715655685957,SIO 295LS,A00,523233,Staff,10,0,30,20
1715655686982,SIO 295S,A00,523232,Staff,10,0,30,20
1715655688009,SIOC 290S,A01,637330,Merrifield; Mark A,21,0,30,9
1715655689040,SIOC 291S,A01,637333,Gabriel; Corey John,21,0,30,9
1715655690065,SOCI 117,A01,494376,Staff,0,5,5,5
1715655691094,WES 237B,A00,494380,Staff,10,0,20,10
1715655693336,AESE 279B,A00,494370,Wade; Jon P,0,0,33,33
1715655694361,AIP 97,001,660915,Van Den Einde; Yael Dahlia,9998,0,9999,1
1715655695394,AIP 197,001,627712,Vespa; Emanuel Ignacio,9995,0,9999,4
1715655695394,AIP 197,002,650778,Amir; On,9998,0,9999,1
1715655695394,AIP 197,003,650933,Avenancio-Leon; Carlos,9998,0,9999,1
1715655695394,AIP 197,004,658530,Heyman; Gail D.,9998,0,9999,1
1715655695394,AIP 197,005,658631,Neal; Sonya E,9998,0,9999,1
1715655695394,AIP 197,006,658671,Du; Songzi,9998,0,9999,1
1715655696423,ANAR 135S,A00,494369,Braswell; Geoffrey E.,0,0,0,0
1715655697453,BENG 196,001,628496,Engler; Adam J.,9998,0,9999,1
1715655697453,BENG 196,002,660916,Watson; John Thomas,9998,0,9999,1
1715655698479,BISP 197,001,650773,Wilhelm; James E.,9994,0,9999,5
1715655698479,BISP 197,002,658904,Coleman; Aaron B.,9998,0,9999,1
1715655699509,CAT 124RS,A01,519847,Geibel; William,0,0,20,20
1715655700534,CAT 125RS,A01,515971,Geibel; William,0,0,20,20
1715655701560,CLRE 250,A00,511389,Morris; Sheldon,9992,0,9999,7
1715655702586,CLRE 251,A00,507176,Mehta; Ravindra L.,9992,0,9999,7
1715655702586,CLRE 251,B00,511410,Mehta; Ravindra L.,9998,0,9999,1
1715655703617,CLRE 252,A00,507189,Cuomo; Raphael Eduardo,9994,0,9999,5
1715655704642,CLRE 253,A00,507199,Vaida; Florin,9994,0,9999,5
1715655704642,CLRE 253,B00,507202,Vaida; Florin,9999,0,9999,0
1715655705670,CLRE 259,A00,507211,Patel; Hemal,9996,0,9999,3
1715655706695,CLRE 260,A00,507221,Cuomo; Raphael Eduardo,9999,0,9999,0
1715655707721,CLRE 297,001,507242,Cuomo; Raphael Eduardo,9999,0,9999,0
1715655708749,COGS 197,001,638244,Voytek; Bradley Thomas,9997,0,9999,2
1715655709774,CSE 191,A00,516875,Minnes Kemp; Mor Mia,9991,0,9999,8
1715655710803,CSE 197,001,637388,Minnes Kemp; Mor Mia,9992,0,9999,7
1715655711830,CSS 201S,A01,494383,Mignozzetti; Umberto,35,0,35,0
1715655712861,CSS 202S,A01,494387,Mignozzetti; Umberto,35,0,35,0
1715655713886,DSC 197,001,628532,Eldridge; Justin Matthew,9995,0,9999,4
1715655714911,EAP 100,A00,516065,Staff,9799,0,9999,200
1715655715941,ECE 45,A01,507414,Staff,32,0,60,28
1715655717996,ECE 111,A01,507420,Staff,11,0,50,39
1715655719022,ECE 197,001,548057,Sievenpiper; Daniel F.,9991,0,9999,8
1715655720048,EDS 115,A00,507243,Choi; Bailey Miyeon,6,0,28,22
1715655721073,EDS 117,A01,494379,Staff,0,6,34,35
1715655722098,EDS 125,A00,507246,Hopkins; Megan Beth,7,0,30,23
1715655723127,EDS 128A,A01,507264,Fargason; Sharon Gayle,5,0,26,21
1715655724152,EDS 128B,A01,507293,Pappas; Elizabeth,9,0,30,21
1715655725176,EDS 139,A00,507294,Fargason; Sharon Gayle,9,0,30,21
1715655725176,EDS 139,B00,507313,Pappas; Elizabeth,9,0,30,21
1715655726203,EDS 201,A00,507315,Staff,10,0,30,20
1715655727233,EDS 203,A01,507317,Halter; Christopher P.,10,0,30,20
1715655728329,EDS 204R,A01,507319,Halter; Christopher P.,0,3,30,30
1715655728329,EDS 204R,B01,507331,Heinzman; Erica M.,14,0,30,16
1715655729353,EDS 206R,A00,507332,Staff,0,4,30,30
1715655729353,EDS 206R,B00,507343,Staff,15,0,30,15
1715655730381,EDS 250,A00,507344,Hemans; Patricia Ann Benitez,20,0,40,20
1715655731406,EDS 281,A00,507345,Daly; Alan J.,18,0,18,0
1715655732433,EDS 284,A00,507350,Daly; Alan J.,16,0,16,0
1715655733468,EDS 286,A00,507359,Fine; Sarah,18,0,18,0
1715655734493,EDS 289C,A01,507361,Daly; Alan J.,18,0,18,0
1715655735519,EDS 290,A00,507366,Hofstetter; Carolyn,15,0,15,0
1715655736551,LIGM 5A,A00,507421,Fischer-Grunski; Eva K,17,0,20,3
1715655737574,LIGM 5B,A00,507423,Fischer-Grunski; Eva K,19,0,20,1
1715655738599,LIGM 5C,A00,507425,Fischer-Grunski; Eva K,19,0,20,1
1715655739627,LIIT 5AS,A00,507427,Carnelos; Chiara,20,0,20,0
1715655740652,LIIT 5BS,A00,507430,Carnelos; Chiara,20,0,20,0
1715655741680,LIIT 5CS,A00,507432,Carnelos; Chiara,20,0,20,0
1715655742706,LISP 5A,A00,507541,Munoz Sanchez; Alicia,11,0,20,9
1715655743734,LISP 5B,A00,507671,Munoz Sanchez; Alicia,8,0,20,12
1715655744762,LISP 5C,A00,507696,Munoz Sanchez; Alicia,8,0,20,12
1715655745789,MAE 197,001,528363,Boechler; Nicholas Sebastia,9998,0,9999,1
1715655746817,MATH 197,001,523477,Kedlaya; Kiran S.,9994,0,9999,5
1715655746817,MATH 197,002,563811,Zhang; Danna,9994,0,9999,5
1715655746817,MATH 197,003,628552,Dumitriu; Ioana,9998,0,9999,1
1715655746817,MATH 197,004,660885,Floyd; Eric,9998,0,9999,1
1715655747845,MCWP 40R,A00,518780,Staff,1,0,20,19
1715655747845,MCWP 40R,B00,518781,Carter; Jennifer A,9,0,20,11
1715655747845,MCWP 40R,C00,518783,Smith; Haydee Marie,5,0,20,15
1715655748874,MCWP 50R,A00,518791,Redela; Pamela Morgan,0,1,20,20
1715655748874,MCWP 50R,B00,518792,Krone; Jarret,0,2,20,20
1715655748874,MCWP 50R,C00,518793,Staff,0,4,20,20
1715655748874,MCWP 50R,D00,518794,Morshed; Michael James,0,2,20,20
1715655748874,MCWP 50R,E00,518795,Carter; Andrea L,0,2,20,20
1715655748874,MCWP 50R,F00,518796,Miller; Elizabeth Deen,0,1,20,20
1715655748874,MCWP 50R,G00,518797,Guillen; Melinda,0,1,20,20
1715655749899,MMW 12R,A01,514034,Herbst; Matthew,0,2,16,16
1715655749899,MMW 12R,A02,514035,Herbst; Matthew,0,0,16,16
1715655750926,MMW 13R,A01,514037,Staff,0,5,16,16
1715655750926,MMW 13R,A02,514039,Staff,0,5,16,16
1715655750926,MMW 13R,A03,628519,Staff,0,4,16,16
1715655752978,SIO 295LS,A00,523233,Staff,10,0,30,20
1715655754007,SIO 295S,A00,523232,Staff,10,0,30,20
1715655755033,SIOC 290S,A01,637330,Merrifield; Mark A,21,0,30,9
1715655756064,SIOC 291S,A01,637333,Gabriel; Corey John,21,0,30,9
1715655757096,SOCI 117,A01,494376,Staff,0,5,5,5
1715655758126,WES 237B,A00,494380,Staff,10,0,20,10
1715655760201,AESE 279B,A00,494370,Wade; Jon P,0,0,33,33
1715655761230,AIP 97,001,660915,Van Den Einde; Yael Dahlia,9998,0,9999,1
1715655762268,AIP 197,001,627712,Vespa; Emanuel Ignacio,9995,0,9999,4
1715655762268,AIP 197,002,650778,Amir; On,9998,0,9999,1
1715655762268,AIP 197,003,650933,Avenancio-Leon; Carlos,9998,0,9999,1
1715655762268,AIP 197,004,658530,Heyman; Gail D.,9998,0,9999,1
1715655762268,AIP 197,005,658631,Neal; Sonya E,9998,0,9999,1
1715655762268,AIP 197,006,658671,Du; Songzi,9998,0,9999,1
1715655763297,ANAR 135S,A00,494369,Braswell; Geoffrey E.,0,0,0,0
1715655764326,BENG 196,001,628496,Engler; Adam J.,9998,0,9999,1
1715655764326,BENG 196,002,660916,Watson; John Thomas,9998,0,9999,1
1715655765351,BISP 197,001,650773,Wilhelm; James E.,9994,0,9999,5
1715655765351,BISP 197,002,658904,Coleman; Aaron B.,9998,0,9999,1
1715655766429,CAT 124RS,A01,519847,Geibel; William,0,0,20,20
1715655767457,CAT 125RS,A01,515971,Geibel; William,0,0,20,20
1715655768484,CLRE 250,A00,511389,Morris; Sheldon,9992,0,9999,7
1715655769512,CLRE 251,A00,507176,Mehta; Ravindra L.,9992,0,9999,7
1715655769512,CLRE 251,B00,511410,Mehta; Ravindra L.,9998,0,9999,1
1715655770538,CLRE 252,A00,507189,Cuomo; Raphael Eduardo,9994,0,9999,5
1715655771566,CLRE 253,A00,507199,Vaida; Florin,9994,0,9999,5
1715655771566,CLRE 253,B00,507202,Vaida; Florin,9999,0,9999,0
1715655772592,CLRE 259,A00,507211,Patel; Hemal,9996,0,9999,3
1715655773622,CLRE 260,A00,507221,Cuomo; Raphael Eduardo,9999,0,9999,0
1715655774647,CLRE 297,001,507242,Cuomo; Raphael Eduardo,9999,0,9999,0
1715655775674,COGS 197,001,638244,Voytek; Bradley Thomas,9997,0,9999,2
1715655776703,CSE 191,A00,516875,Minnes Kemp; Mor Mia,9991,0,9999,8
1715655777730,CSE 197,001,637388,Minnes Kemp; Mor Mia,9992,0,9999,7
1715655778758,CSS 201S,A01,494383,Mignozzetti; Umberto,35,0,35,0
1715655779784,CSS 202S,A01,494387,Mignozzetti; Umberto,35,0,35,0
1715655780814,DSC 197,001,628532,Eldridge; Justin Matthew,9995,0,9999,4
1715655781850,EAP 100,A00,516065,Staff,9799,0,9999,200
1715655782890,ECE 45,A01,507414,Staff,32,0,60,28
1715655784947,ECE 111,A01,507420,Staff,11,0,50,39
1715655785976,ECE 197,001,548057,Sievenpiper; Daniel F.,9991,0,9999,8
1715655787003,EDS 115,A00,507243,Choi; Bailey Miyeon,6,0,28,22
1715655788027,EDS 117,A01,494379,Staff,0,6,34,35
1715655789055,EDS 125,A00,507246,Hopkins; Megan Beth,7,0,30,23
1715655790080,EDS 128A,A01,507264,Fargason; Sharon Gayle,5,0,26,21
1715655791105,EDS 128B,A01,507293,Pappas; Elizabeth,9,0,30,21
1715655792130,EDS 139,A00,507294,Fargason; Sharon Gayle,9,0,30,21
1715655792130,EDS 139,B00,507313,Pappas; Elizabeth,9,0,30,21
1715655793154,EDS 201,A00,507315,Staff,10,0,30,20
1715655794179,EDS 203,A01,507317,Halter; Christopher P.,10,0,30,20
1715655795207,EDS 204R,A01,507319,Halter; Christopher P.,0,3,30,30
1715655795207,EDS 204R,B01,507331,Heinzman; Erica M.,14,0,30,16
1715655796246,EDS 206R,A00,507332,Staff,0,4,30,30
1715655796246,EDS 206R,B00,507343,Staff,15,0,30,15
1715655797273,EDS 250,A00,507344,Hemans; Patricia Ann Benitez,20,0,40,20
1715655798299,EDS 281,A00,507345,Daly; Alan J.,18,0,18,0
1715655799325,EDS 284,A00,507350,Daly; Alan J.,16,0,16,0
1715655800351,EDS 286,A00,507359,Fine; Sarah,18,0,18,0
1715655801377,EDS 289C,A01,507361,Daly; Alan J.,18,0,18,0
1715655802407,EDS 290,A00,507366,Hofstetter; Carolyn,15,0,15,0
1715655803433,LIGM 5A,A00,507421,Fischer-Grunski; Eva K,17,0,20,3
1715655804464,LIGM 5B,A00,507423,Fischer-Grunski; Eva K,19,0,20,1
1715655805489,LIGM 5C,A00,507425,Fischer-Grunski; Eva K,19,0,20,1
1715655806515,LIIT 5AS,A00,507427,Carnelos; Chiara,20,0,20,0
1715655807540,LIIT 5BS,A00,507430,Carnelos; Chiara,20,0,20,0
1715655808570,LIIT 5CS,A00,507432,Carnelos; Chiara,20,0,20,0
1715655809596,LISP 5A,A00,507541,Munoz Sanchez; Alicia,11,0,20,9
1715655810626,LISP 5B,A00,507671,Munoz Sanchez; Alicia,8,0,20,12
1715655811654,LISP 5C,A00,507696,Munoz Sanchez; Alicia,8,0,20,12
1715655812682,MAE 197,001,528363,Boechler; Nicholas Sebastia,9998,0,9999,1
1715655813711,MATH 197,001,523477,Kedlaya; Kiran S.,9994,0,9999,5
1715655813711,MATH 197,002,563811,Zhang; Danna,9994,0,9999,5
1715655813711,MATH 197,003,628552,Dumitriu; Ioana,9998,0,9999,1
1715655813711,MATH 197,004,660885,Floyd; Eric,9998,0,9999,1
1715655814738,MCWP 40R,A00,518780,Staff,1,0,20,19
1715655814738,MCWP 40R,B00,518781,Carter; Jennifer A,9,0,20,11
1715655814738,MCWP 40R,C00,518783,Smith; Haydee Marie,5,0,20,15
1715655815772,MCWP 50R,A00,518791,Redela; Pamela Morgan,0,1,20,20
1715655815772,MCWP 50R,B00,518792,Krone; Jarret,0,2,20,20
1715655815772,MCWP 50R,C00,518793,Staff,0,4,20,20
1715655815772,MCWP 50R,D00,518794,Morshed; Michael James,0,2,20,20
1715655815772,MCWP 50R,E00,518795,Carter; Andrea L,0,2,20,20
1715655815772,MCWP 50R,F00,518796,Miller; Elizabeth Deen,0,1,20,20
1715655815772,MCWP 50R,G00,518797,Guillen; Melinda,0,1,20,20
1715655816803,MMW 12R,A01,514034,Herbst; Matthew,0,2,16,16
1715655816803,MMW 12R,A02,514035,Herbst; Matthew,0,0,16,16
1715655817828,MMW 13R,A01,514037,Staff,0,5,16,16
1715655817828,MMW 13R,A02,514039,Staff,0,5,16,16
1715655817828,MMW 13R,A03,628519,Staff,0,4,16,16
1715655819878,SIO 295LS,A00,523233,Staff,10,0,30,20
1715655820906,SIO 295S,A00,523232,Staff,10,0,30,20
1715655821932,SIOC 290S,A01,637330,Merrifield; Mark A,21,0,30,9
1715655822958,SIOC 291S,A01,637333,Gabriel; Corey John,21,0,30,9
1715655823983,SOCI 117,A01,494376,Staff,0,5,5,5
1715655825012,WES 237B,A00,494380,Staff,10,0,20,10
1715655827101,AESE 279B,A00,494370,Wade; Jon P,0,0,33,33
1715655828129,AIP 97,001,660915,Van Den Einde; Yael Dahlia,9998,0,9999,1
1715655829181,AIP 197,001,627712,Vespa; Emanuel Ignacio,9995,0,9999,4
1715655829181,AIP 197,002,650778,Amir; On,9998,0,9999,1
1715655829181,AIP 197,003,650933,Avenancio-Leon; Carlos,9998,0,9999,1
1715655829181,AIP 197,004,658530,Heyman; Gail D.,9998,0,9999,1
1715655829181,AIP 197,005,658631,Neal; Sonya E,9998,0,9999,1
1715655829181,AIP 197,006,658671,Du; Songzi,9998,0,9999,1
1715655830208,ANAR 135S,A00,494369,Braswell; Geoffrey E.,0,0,0,0
1715655831236,BENG 196,001,628496,Engler; Adam J.,9998,0,9999,1
1715655831236,BENG 196,002,660916,Watson; John Thomas,9998,0,9999,1
1715655832278,BISP 197,001,650773,Wilhelm; James E.,9994,0,9999,5
1715655832278,BISP 197,002,658904,Coleman; Aaron B.,9998,0,9999,1
1715655833307,CAT 124RS,A01,519847,Geibel; William,0,0,20,20
1715655834333,CAT 125RS,A01,515971,Geibel; William,0,0,20,20
1715655835361,CLRE 250,A00,511389,Morris; Sheldon,9992,0,9999,7
1715655836388,CLRE 251,A00,507176,Mehta; Ravindra L.,9992,0,9999,7
1715655836388,CLRE 251,B00,511410,Mehta; Ravindra L.,9998,0,9999,1
1715655837413,CLRE 252,A00,507189,Cuomo; Raphael Eduardo,9994,0,9999,5
1715655838437,CLRE 253,A00,507199,Vaida; Florin,9994,0,9999,5
1715655838437,CLRE 253,B00,507202,Vaida; Florin,9999,0,9999,0
1715655839466,CLRE 259,A00,507211,Patel; Hemal,9996,0,9999,3
1715655840494,CLRE 260,A00,507221,Cuomo; Raphael Eduardo,9999,0,9999,0
1715655841526,CLRE 297,001,507242,Cuomo; Raphael Eduardo,9999,0,9999,0
1715655842558,COGS 197,001,638244,Voytek; Bradley Thomas,9997,0,9999,2
1715655843585,CSE 191,A00,516875,Minnes Kemp; Mor Mia,9991,0,9999,8
1715655844617,CSE 197,001,637388,Minnes Kemp; Mor Mia,9992,0,9999,7
1715655845644,CSS 201S,A01,494383,Mignozzetti; Umberto,35,0,35,0
1715655846672,CSS 202S,A01,494387,Mignozzetti; Umberto,35,0,35,0
1715655847701,DSC 197,001,628532,Eldridge; Justin Matthew,9995,0,9999,4
1715655848725,EAP 100,A00,516065,Staff,9799,0,9999,200
1715655849751,ECE 45,A01,507414,Staff,32,0,60,28
1715655851803,ECE 111,A01,507420,Staff,11,0,50,39
1715655852829,ECE 197,001,548057,Sievenpiper; Daniel F.,9991,0,9999,8
1715655853855,EDS 115,A00,507243,Choi; Bailey Miyeon,6,0,28,22
1715655854881,EDS 117,A01,494379,Staff,0,6,34,35
1715655855906,EDS 125,A00,507246,Hopkins; Megan Beth,7,0,30,23
1715655856934,EDS 128A,A01,507264,Fargason; Sharon Gayle,5,0,26,21
1715655857962,EDS 128B,A01,507293,Pappas; Elizabeth,9,0,30,21
1715655858989,EDS 139,A00,507294,Fargason; Sharon Gayle,9,0,30,21
1715655858989,EDS 139,B00,507313,Pappas; Elizabeth,9,0,30,21
1715655860017,EDS 201,A00,507315,Staff,10,0,30,20
1715655861049,EDS 203,A01,507317,Halter; Christopher P.,10,0,30,20
1715655862074,EDS 204R,A01,507319,Halter; Christopher P.,0,3,30,30
1715655862074,EDS 204R,B01,507331,Heinzman; Erica M.,14,0,30,16
1715655863100,EDS 206R,A00,507332,Staff,0,4,30,30
1715655863100,EDS 206R,B00,507343,Staff,15,0,30,15
1715655864126,EDS 250,A00,507344,Hemans; Patricia Ann Benitez,20,0,40,20
1715655865154,EDS 281,A00,507345,Daly; Alan J.,18,0,18,0
1715655866181,EDS 284,A00,507350,Daly; Alan J.,16,0,16,0
1715655867205,EDS 286,A00,507359,Fine; Sarah,18,0,18,0
1715655868238,EDS 289C,A01,507361,Daly; Alan J.,18,0,18,0
1715655869267,EDS 290,A00,507366,Hofstetter; Carolyn,15,0,15,0
1715655870294,LIGM 5A,A00,507421,Fischer-Grunski; Eva K,17,0,20,3
1715655871323,LIGM 5B,A00,507423,Fischer-Grunski; Eva K,19,0,20,1
1715655872348,LIGM 5C,A00,507425,Fischer-Grunski; Eva K,19,0,20,1
1715655873376,LIIT 5AS,A00,507427,Carnelos; Chiara,20,0,20,0
1715655874405,LIIT 5BS,A00,507430,Carnelos; Chiara,20,0,20,0
1715655875429,LIIT 5CS,A00,507432,Carnelos; Chiara,20,0,20,0
1715655876458,LISP 5A,A00,507541,Munoz Sanchez; Alicia,11,0,20,9
1715655877485,LISP 5B,A00,507671,Munoz Sanchez; Alicia,8,0,20,12
1715655878514,LISP 5C,A00,507696,Munoz Sanchez; Alicia,8,0,20,12
1715655879543,MAE 197,001,528363,Boechler; Nicholas Sebastia,9998,0,9999,1
1715655880575,MATH 197,001,523477,Kedlaya; Kiran S.,9994,0,9999,5
1715655880575,MATH 197,002,563811,Zhang; Danna,9994,0,9999,5
1715655880575,MATH 197,003,628552,Dumitriu; Ioana,9998,0,9999,1
1715655880575,MATH 197,004,660885,Floyd; Eric,9998,0,9999,1
1715655881600,MCWP 40R,A00,518780,Staff,1,0,20,19
1715655881600,MCWP 40R,B00,518781,Carter; Jennifer A,9,0,20,11
1715655881600,MCWP 40R,C00,518783,Smith; Haydee Marie,5,0,20,15
1715655882627,MCWP 50R,A00,518791,Redela; Pamela Morgan,0,1,20,20
1715655882627,MCWP 50R,B00,518792,Krone; Jarret,0,2,20,20
1715655882627,MCWP 50R,C00,518793,Staff,0,4,20,20
1715655882627,MCWP 50R,D00,518794,Morshed; Michael James,0,2,20,20
1715655882627,MCWP 50R,E00,518795,Carter; Andrea L,0,2,20,20
1715655882627,MCWP 50R,F00,518796,Miller; Elizabeth Deen,0,1,20,20
1715655882627,MCWP 50R,G00,518797,Guillen; Melinda,0,1,20,20
1715655883652,MMW 12R,A01,514034,Herbst; Matthew,0,2,16,16
1715655883652,MMW 12R,A02,514035,Herbst; Matthew,0,0,16,16
1715655884678,MMW 13R,A01,514037,Staff,0,5,16,16
1715655884678,MMW 13R,A02,514039,Staff,0,5,16,16
1715655884678,MMW 13R,A03,628519,Staff,0,4,16,16
1715655886728,SIO 295LS,A00,523233,Staff,10,0,30,20
1715655887754,SIO 295S,A00,523232,Staff,10,0,30,20
1715655888783,SIOC 290S,A01,637330,Merrifield; Mark A,21,0,30,9
1715655889809,SIOC 291S,A01,637333,Gabriel; Corey John,21,0,30,9
1715655890837,SOCI 117,A01,494376,Staff,0,5,5,5
1715655891864,WES 237B,A00,494380,Staff,10,0,20,10
1715655893944,AESE 279B,A00,494370,Wade; Jon P,0,0,33,33
1715655894971,AIP 97,001,660915,Van Den Einde; Yael Dahlia,9998,0,9999,1
1715655896000,AIP 197,001,627712,Vespa; Emanuel Ignacio,9995,0,9999,4
1715655896000,AIP 197,002,650778,Amir; On,9998,0,9999,1
1715655896000,AIP 197,003,650933,Avenancio-Leon; Carlos,9998,0,9999,1
1715655896000,AIP 197,004,658530,Heyman; Gail D.,9998,0,9999,1
1715655896000,AIP 197,005,658631,Neal; Sonya E,9998,0,9999,1
1715655896000,AIP 197,006,658671,Du; Songzi,9998,0,9999,1
1715655897029,ANAR 135S,A00,494369,Braswell; Geoffrey E.,0,0,0,0
1715655898054,BENG 196,001,628496,Engler; Adam J.,9998,0,9999,1
1715655898054,BENG 196,002,660916,Watson; John Thomas,9998,0,9999,1
1715655899079,BISP 197,001,650773,Wilhelm; James E.,9994,0,9999,5
1715655899079,BISP 197,002,658904,Coleman; Aaron B.,9998,0,9999,1
1715655900107,CAT 124RS,A01,519847,Geibel; William,0,0,20,20
1715655901134,CAT 125RS,A01,515971,Geibel; William,0,0,20,20
1715655902164,CLRE 250,A00,511389,Morris; Sheldon,9992,0,9999,7
1715655903247,CLRE 251,A00,507176,Mehta; Ravindra L.,9992,0,9999,7
1715655903247,CLRE 251,B00,511410,Mehta; Ravindra L.,9998,0,9999,1
1715655904275,CLRE 252,A00,507189,Cuomo; Raphael Eduardo,9994,0,9999,5
1715655905306,CLRE 253,A00,507199,Vaida; Florin,9994,0,9999,5
1715655905306,CLRE 253,B00,507202,Vaida; Florin,9999,0,9999,0
1715655906331,CLRE 259,A00,507211,Patel; Hemal,9996,0,9999,3
1715655907357,CLRE 260,A00,507221,Cuomo; Raphael Eduardo,9999,0,9999,0
1715655908385,CLRE 297,001,507242,Cuomo; Raphael Eduardo,9999,0,9999,0
1715655909413,COGS 197,001,638244,Voytek; Bradley Thomas,9997,0,9999,2
1715655910438,CSE 191,A00,516875,Minnes Kemp; Mor Mia,9991,0,9999,8
1715655911465,CSE 197,001,637388,Minnes Kemp; Mor Mia,9992,0,9999,7
1715655912492,CSS 201S,A01,494383,Mignozzetti; Umberto,35,0,35,0
1715655913521,CSS 202S,A01,494387,Mignozzetti; Umberto,35,0,35,0
1715655914550,DSC 197,001,628532,Eldridge; Justin Matthew,9995,0,9999,4
1715655915578,EAP 100,A00,516065,Staff,9799,0,9999,200
1715655916604,ECE 45,A01,507414,Staff,32,0,60,28
1715655918656,ECE 111,A01,507420,Staff,11,0,50,39
1715655919681,ECE 197,001,548057,Sievenpiper; Daniel F.,9991,0,9999,8
1715655920711,EDS 115,A00,507243,Choi; Bailey Miyeon,6,0,28,22
1715655921737,EDS 117,A01,494379,Staff,0,6,34,35
1715655922760,EDS 125,A00,507246,Hopkins; Megan Beth,7,0,30,23
1715655923790,EDS 128A,A01,507264,Fargason; Sharon Gayle,5,0,26,21
1715655924819,EDS 128B,A01,507293,Pappas; Elizabeth,9,0,30,21
1715655925846,EDS 139,A00,507294,Fargason; Sharon Gayle,9,0,30,21
1715655925846,EDS 139,B00,507313,Pappas; Elizabeth,9,0,30,21
1715655926873,EDS 201,A00,507315,Staff,10,0,30,20
1715655927901,EDS 203,A01,507317,Halter; Christopher P.,10,0,30,20
1715655928928,EDS 204R,A01,507319,Halter; Christopher P.,0,3,30,30
1715655928928,EDS 204R,B01,507331,Heinzman; Erica M.,14,0,30,16
1715655929952,EDS 206R,A00,507332,Staff,0,4,30,30
1715655929952,EDS 206R,B00,507343,Staff,15,0,30,15
1715655930979,EDS 250,A00,507344,Hemans; Patricia Ann Benitez,20,0,40,20
1715655932003,EDS 281,A00,507345,Daly; Alan J.,18,0,18,0
1715655933028,EDS 284,A00,507350,Daly; Alan J.,16,0,16,0
1715655934057,EDS 286,A00,507359,Fine; Sarah,18,0,18,0
1715655935083,EDS 289C,A01,507361,Daly; Alan J.,18,0,18,0
1715655936113,EDS 290,A00,507366,Hofstetter; Carolyn,15,0,15,0
1715655937140,LIGM 5A,A00,507421,Fischer-Grunski; Eva K,17,0,20,3
1715655938165,LIGM 5B,A00,507423,Fischer-Grunski; Eva K,19,0,20,1
1715655939203,LIGM 5C,A00,507425,Fischer-Grunski; Eva K,19,0,20,1
1715655940229,LIIT 5AS,A00,507427,Carnelos; Chiara,20,0,20,0
1715655941253,LIIT 5BS,A00,507430,Carnelos; Chiara,20,0,20,0
1715655942278,LIIT 5CS,A00,507432,Carnelos; Chiara,20,0,20,0
1715655943302,LISP 5A,A00,507541,Munoz Sanchez; Alicia,11,0,20,9
1715655944328,LISP 5B,A00,507671,Munoz Sanchez; Alicia,8,0,20,12
1715655945357,LISP 5C,A00,507696,Munoz Sanchez; Alicia,8,0,20,12
1715655946385,MAE 197,001,528363,Boechler; Nicholas Sebastia,9998,0,9999,1
1715655947412,MATH 197,001,523477,Kedlaya; Kiran S.,9994,0,9999,5
1715655947412,MATH 197,002,563811,Zhang; Danna,9994,0,9999,5
1715655947412,MATH 197,003,628552,Dumitriu; Ioana,9998,0,9999,1
1715655947412,MATH 197,004,660885,Floyd; Eric,9998,0,9999,1
1715655948446,MCWP 40R,A00,518780,Staff,1,0,20,19
1715655948446,MCWP 40R,B00,518781,Carter; Jennifer A,9,0,20,11
1715655948446,MCWP 40R,C00,518783,Smith; Haydee Marie,5,0,20,15
1715655949474,MCWP 50R,A00,518791,Redela; Pamela Morgan,0,1,20,20
1715655949474,MCWP 50R,B00,518792,Krone; Jarret,0,2,20,20
1715655949474,MCWP 50R,C00,518793,Staff,0,4,20,20
1715655949474,MCWP 50R,D00,518794,Morshed; Michael James,0,2,20,20
1715655949474,MCWP 50R,E00,518795,Carter; Andrea L,0,2,20,20
1715655949474,MCWP 50R,F00,518796,Miller; Elizabeth Deen,0,1,20,20
1715655949474,MCWP 50R,G00,518797,Guillen; Melinda,0,1,20,20
1715655950503,MMW 12R,A01,514034,Herbst; Matthew,0,2,16,16
1715655950503,MMW 12R,A02,514035,Herbst; Matthew,0,0,16,16
1715655951538,MMW 13R,A01,514037,Staff,0,5,16,16
1715655951538,MMW 13R,A02,514039,Staff,0,5,16,16
1715655951538,MMW 13R,A03,628519,Staff,0,4,16,16
1715655953590,SIO 295LS,A00,523233,Staff,10,0,30,20
1715655954617,SIO 295S,A00,523232,Staff,10,0,30,20
1715655955643,SIOC 290S,A01,637330,Merrifield; Mark A,21,0,30,9
1715655956670,SIOC 291S,A01,637333,Gabriel; Corey John,21,0,30,9
1715655957695,SOCI 117,A01,494376,Staff,0,5,5,5
1715655958718,WES 237B,A00,494380,Staff,10,0,20,10
1715655960798,AESE 279B,A00,494370,Wade; Jon P,0,0,33,33
1715655961827,AIP 97,001,660915,Van Den Einde; Yael Dahlia,9998,0,9999,1
1715655962859,AIP 197,001,627712,Vespa; Emanuel Ignacio,9995,0,9999,4
1715655962859,AIP 197,002,650778,Amir; On,9998,0,9999,1
1715655962859,AIP 197,003,650933,Avenancio-Leon; Carlos,9998,0,9999,1
1715655962859,AIP 197,004,658530,Heyman; Gail D.,9998,0,9999,1
1715655962859,AIP 197,005,658631,Neal; Sonya E,9998,0,9999,1
1715655962859,AIP 197,006,658671,Du; Songzi,9998,0,9999,1
1715655963885,ANAR 135S,A00,494369,Braswell; Geoffrey E.,0,0,0,0
1715655964913,BENG 196,001,628496,Engler; Adam J.,9998,0,9999,1
1715655964913,BENG 196,002,660916,Watson; John Thomas,9998,0,9999,1
1715655965939,BISP 197,001,650773,Wilhelm; James E.,9994,0,9999,5
1715655965939,BISP 197,002,658904,Coleman; Aaron B.,9998,0,9999,1
1715655966965,CAT 124RS,A01,519847,Geibel; William,0,0,20,20
1715655967990,CAT 125RS,A01,515971,Geibel; William,0,0,20,20
1715655969019,CLRE 250,A00,511389,Morris; Sheldon,9992,0,9999,7
1715655970048,CLRE 251,A00,507176,Mehta; Ravindra L.,9992,0,9999,7
1715655970048,CLRE 251,B00,511410,Mehta; Ravindra L.,9998,0,9999,1
1715655971072,CLRE 252,A00,507189,Cuomo; Raphael Eduardo,9994,0,9999,5
1715655972101,CLRE 253,A00,507199,Vaida; Florin,9994,0,9999,5
1715655972101,CLRE 253,B00,507202,Vaida; Florin,9999,0,9999,0
1715655973126,CLRE 259,A00,507211,Patel; Hemal,9996,0,9999,3
1715655974151,CLRE 260,A00,507221,Cuomo; Raphael Eduardo,9999,0,9999,0
1715655975177,CLRE 297,001,507242,Cuomo; Raphael Eduardo,9999,0,9999,0
1715655976202,COGS 197,001,638244,Voytek; Bradley Thomas,9997,0,9999,2
1715655977231,CSE 191,A00,516875,Minnes Kemp; Mor Mia,9991,0,9999,8
1715655978259,CSE 197,001,637388,Minnes Kemp; Mor Mia,9992,0,9999,7
1715655979287,CSS 201S,A01,494383,Mignozzetti; Umberto,35,0,35,0
1715655980313,CSS 202S,A01,494387,Mignozzetti; Umberto,35,0,35,0
1715655981339,DSC 197,001,628532,Eldridge; Justin Matthew,9995,0,9999,4
1715655982366,EAP 100,A00,516065,Staff,9799,0,9999,200
1715655983395,ECE 45,A01,507414,Staff,32,0,60,28
1715655985446,ECE 111,A01,507420,Staff,11,0,50,39
1715655986473,ECE 197,001,548057,Sievenpiper; Daniel F.,9991,0,9999,8
1715655987499,EDS 115,A00,507243,Choi; Bailey Miyeon,6,0,28,22
1715655988528,EDS 117,A01,494379,Staff,0,6,34,35
1715655989553,EDS 125,A00,507246,Hopkins; Megan Beth,7,0,30,23
1715655990579,EDS 128A,A01,507264,Fargason; Sharon Gayle,5,0,26,21
1715655991605,EDS 128B,A01,507293,Pappas; Elizabeth,9,0,30,21
1715655992629,EDS 139,A00,507294,Fargason; Sharon Gayle,9,0,30,21
1715655992629,EDS 139,B00,507313,Pappas; Elizabeth,9,0,30,21
1715655993659,EDS 201,A00,507315,Staff,10,0,30,20
1715655994689,EDS 203,A01,507317,Halter; Christopher P.,10,0,30,20
1715655995714,EDS 204R,A01,507319,Halter; Christopher P.,0,3,30,30
1715655995714,EDS 204R,B01,507331,Heinzman; Erica M.,14,0,30,16
1715655996753,EDS 206R,A00,507332,Staff,0,4,30,30
1715655996753,EDS 206R,B00,507343,Staff,15,0,30,15
1715655997779,EDS 250,A00,507344,Hemans; Patricia Ann Benitez,20,0,40,20
1715655998804,EDS 281,A00,507345,Daly; Alan J.,18,0,18,0
1715655999832,EDS 284,A00,507350,Daly; Alan J.,16,0,16,0
1715656000862,EDS 286,A00,507359,Fine; Sarah,18,0,18,0
1715656001889,EDS 289C,A01,507361,Daly; Alan J.,18,0,18,0
1715656002917,EDS 290,A00,507366,Hofstetter; Carolyn,15,0,15,0
1715656003943,LIGM 5A,A00,507421,Fischer-Grunski; Eva K,17,0,20,3
1715656004971,LIGM 5B,A00,507423,Fischer-Grunski; Eva K,19,0,20,1
1715656005997,LIGM 5C,A00,507425,Fischer-Grunski; Eva K,19,0,20,1
1715656007025,LIIT 5AS,A00,507427,Carnelos; Chiara,20,0,20,0
1715656008054,LIIT 5BS,A00,507430,Carnelos; Chiara,20,0,20,0
1715656009080,LIIT 5CS,A00,507432,Carnelos; Chiara,20,0,20,0
1715656010109,LISP 5A,A00,507541,Munoz Sanchez; Alicia,11,0,20,9
1715656011138,LISP 5B,A00,507671,Munoz Sanchez; Alicia,8,0,20,12
1715656012170,LISP 5C,A00,507696,Munoz Sanchez; Alicia,8,0,20,12
1715656013200,MAE 197,001,528363,Boechler; Nicholas Sebastia,9998,0,9999,1
1715656014231,MATH 197,001,523477,Kedlaya; Kiran S.,9994,0,9999,5
1715656014231,MATH 197,002,563811,Zhang; Danna,9994,0,9999,5
1715656014231,MATH 197,003,628552,Dumitriu; Ioana,9998,0,9999,1
1715656014231,MATH 197,004,660885,Floyd; Eric,9998,0,9999,1
1715656015257,MCWP 40R,A00,518780,Staff,1,0,20,19
1715656015257,MCWP 40R,B00,518781,Carter; Jennifer A,9,0,20,11
1715656015257,MCWP 40R,C00,518783,Smith; Haydee Marie,5,0,20,15
1715656016290,MCWP 50R,A00,518791,Redela; Pamela Morgan,0,1,20,20
1715656016290,MCWP 50R,B00,518792,Krone; Jarret,0,2,20,20
1715656016290,MCWP 50R,C00,518793,Staff,0,4,20,20
1715656016290,MCWP 50R,D00,518794,Morshed; Michael James,0,2,20,20
1715656016290,MCWP 50R,E00,518795,Carter; Andrea L,0,2,20,20
1715656016290,MCWP 50R,F00,518796,Miller; Elizabeth Deen,0,1,20,20
1715656016290,MCWP 50R,G00,518797,Guillen; Melinda,0,1,20,20
1715656017314,MMW 12R,A01,514034,Herbst; Matthew,0,2,16,16
1715656017314,MMW 12R,A02,514035,Herbst; Matthew,0,0,16,16
1715656018342,MMW 13R,A01,514037,Staff,0,5,16,16
1715656018342,MMW 13R,A02,514039,Staff,0,5,16,16
1715656018342,MMW 13R,A03,628519,Staff,0,4,16,16
1715656020397,SIO 295LS,A00,523233,Staff,10,0,30,20
1715656021423,SIO 295S,A00,523232,Staff,10,0,30,20
1715656022450,SIOC 290S,A01,637330,Merrifield; Mark A,21,0,30,9
1715656023474,SIOC 291S,A01,637333,Gabriel; Corey John,21,0,30,9
1715656024501,SOCI 117,A01,494376,Staff,0,5,5,5
1715656025530,WES 237B,A00,494380,Staff,10,0,20,10
1715656027602,AESE 279B,A00,494370,Wade; Jon P,0,0,33,33
1715656028627,AIP 97,001,660915,Van Den Einde; Yael Dahlia,9998,0,9999,1
1715656029655,AIP 197,001,627712,Vespa; Emanuel Ignacio,9995,0,9999,4
1715656029655,AIP 197,002,650778,Amir; On,9998,0,9999,1
1715656029655,AIP 197,003,650933,Avenancio-Leon; Carlos,9998,0,9999,1
1715656029655,AIP 197,004,658530,Heyman; Gail D.,9998,0,9999,1
1715656029655,AIP 197,005,658631,Neal; Sonya E,9998,0,9999,1
1715656029655,AIP 197,006,658671,Du; Songzi,9998,0,9999,1
1715656030680,ANAR 135S,A00,494369,Braswell; Geoffrey E.,0,0,0,0
1715656031706,BENG 196,001,628496,Engler; Adam J.,9998,0,9999,1
1715656031706,BENG 196,002,660916,Watson; John Thomas,9998,0,9999,1
1715656032731,BISP 197,001,650773,Wilhelm; James E.,9994,0,9999,5
1715656032731,BISP 197,002,658904,Coleman; Aaron B.,9998,0,9999,1
1715656033756,CAT 124RS,A01,519847,Geibel; William,0,0,20,20
1715656034782,CAT 125RS,A01,515971,Geibel; William,0,0,20,20
1715656035807,CLRE 250,A00,511389,Morris; Sheldon,9992,0,9999,7
1715656036834,CLRE 251,A00,507176,Mehta; Ravindra L.,9992,0,9999,7
1715656036834,CLRE 251,B00,511410,Mehta; Ravindra L.,9998,0,9999,1
1715656037860,CLRE 252,A00,507189,Cuomo; Raphael Eduardo,9994,0,9999,5
1715656038888,CLRE 253,A00,507199,Vaida; Florin,9994,0,9999,5
1715656038888,CLRE 253,B00,507202,Vaida; Florin,9999,0,9999,0
1715656039916,CLRE 259,A00,507211,Patel; Hemal,9996,0,9999,3
1715656040941,CLRE 260,A00,507221,Cuomo; Raphael Eduardo,9999,0,9999,0
1715656041968,CLRE 297,001,507242,Cuomo; Raphael Eduardo,9999,0,9999,0
1715656042996,COGS 197,001,638244,Voytek; Bradley Thomas,9997,0,9999,2
1715656044021,CSE 191,A00,516875,Minnes Kemp; Mor Mia,9991,0,9999,8
1715656045046,CSE 197,001,637388,Minnes Kemp; Mor Mia,9992,0,9999,7
1715656046073,CSS 201S,A01,494383,Mignozzetti; Umberto,35,0,35,0
1715656047099,CSS 202S,A01,494387,Mignozzetti; Umberto,35,0,35,0
1715656048128,DSC 197,001,628532,Eldridge; Justin Matthew,9995,0,9999,4
1715656049155,EAP 100,A00,516065,Staff,9799,0,9999,200
1715656050185,ECE 45,A01,507414,Staff,32,0,60,28
1715656052238,ECE 111,A01,507420,Staff,11,0,50,39
1715656053263,ECE 197,001,548057,Sievenpiper; Daniel F.,9991,0,9999,8
1715656054290,EDS 115,A00,507243,Choi; Bailey Miyeon,6,0,28,22
1715656055318,EDS 117,A01,494379,Staff,0,6,34,35
1715656056345,EDS 125,A00,507246,Hopkins; Megan Beth,7,0,30,23
1715656057373,EDS 128A,A01,507264,Fargason; Sharon Gayle,5,0,26,21
1715656058400,EDS 128B,A01,507293,Pappas; Elizabeth,9,0,30,21
1715656059425,EDS 139,A00,507294,Fargason; Sharon Gayle,9,0,30,21
1715656059425,EDS 139,B00,507313,Pappas; Elizabeth,9,0,30,21
1715656060449,EDS 201,A00,507315,Staff,10,0,30,20
1715656061478,EDS 203,A01,507317,Halter; Christopher P.,10,0,30,20
1715656062503,EDS 204R,A01,507319,Halter; Christopher P.,0,3,30,30
1715656062503,EDS 204R,B01,507331,Heinzman; Erica M.,14,0,30,16
1715656063529,EDS 206R,A00,507332,Staff,0,4,30,30
1715656063529,EDS 206R,B00,507343,Staff,15,0,30,15
1715656064557,EDS 250,A00,507344,Hemans; Patricia Ann Benitez,20,0,40,20
1715656065583,EDS 281,A00,507345,Daly; Alan J.,18,0,18,0
1715656066609,EDS 284,A00,507350,Daly; Alan J.,16,0,16,0
1715656067637,EDS 286,A00,507359,Fine; Sarah,18,0,18,0
1715656068667,EDS 289C,A01,507361,Daly; Alan J.,18,0,18,0
1715656069776,EDS 290,A00,507366,Hofstetter; Carolyn,15,0,15,0
1715656070807,LIGM 5A,A00,507421,Fischer-Grunski; Eva K,17,0,20,3
1715656071831,LIGM 5B,A00,507423,Fischer-Grunski; Eva K,19,0,20,1
1715656072855,LIGM 5C,A00,507425,Fischer-Grunski; Eva K,19,0,20,1
1715656073885,LIIT 5AS,A00,507427,Carnelos; Chiara,20,0,20,0
1715656074916,LIIT 5BS,A00,507430,Carnelos; Chiara,20,0,20,0
1715656075942,LIIT 5CS,A00,507432,Carnelos; Chiara,20,0,20,0
1715656076971,LISP 5A,A00,507541,Munoz Sanchez; Alicia,11,0,20,9
1715656077996,LISP 5B,A00,507671,Munoz Sanchez; Alicia,8,0,20,12
1715656079026,LISP 5C,A00,507696,Munoz Sanchez; Alicia,8,0,20,12
1715656080052,MAE 197,001,528363,Boechler; Nicholas Sebastia,9998,0,9999,1
1715656081080,MATH 197,001,523477,Kedlaya; Kiran S.,9994,0,9999,5
1715656081080,MATH 197,002,563811,Zhang; Danna,9994,0,9999,5
1715656081080,MATH 197,003,628552,Dumitriu; Ioana,9998,0,9999,1
1715656081080,MATH 197,004,660885,Floyd; Eric,9998,0,9999,1
1715656082112,MCWP 40R,A00,518780,Staff,1,0,20,19
1715656082112,MCWP 40R,B00,518781,Carter; Jennifer A,9,0,20,11
1715656082112,MCWP 40R,C00,518783,Smith; Haydee Marie,5,0,20,15
1715656083141,MCWP 50R,A00,518791,Redela; Pamela Morgan,0,1,20,20
1715656083141,MCWP 50R,B00,518792,Krone; Jarret,0,2,20,20
1715656083141,MCWP 50R,C00,518793,Staff,0,4,20,20
1715656083141,MCWP 50R,D00,518794,Morshed; Michael James,0,2,20,20
1715656083141,MCWP 50R,E00,518795,Carter; Andrea L,0,2,20,20
1715656083141,MCWP 50R,F00,518796,Miller; Elizabeth Deen,0,1,20,20
1715656083141,MCWP 50R,G00,518797,Guillen; Melinda,0,1,20,20
1715656084168,MMW 12R,A01,514034,Herbst; Matthew,0,2,16,16
1715656084168,MMW 12R,A02,514035,Herbst; Matthew,0,0,16,16
1715656085194,MMW 13R,A01,514037,Staff,0,5,16,16
1715656085194,MMW 13R,A02,514039,Staff,0,5,16,16
1715656085194,MMW 13R,A03,628519,Staff,0,4,16,16
1715656087245,SIO 295LS,A00,523233,Staff,10,0,30,20
1715656088270,SIO 295S,A00,523232,Staff,10,0,30,20
1715656089300,SIOC 290S,A01,637330,Merrifield; Mark A,21,0,30,9
1715656090326,SIOC 291S,A01,637333,Gabriel; Corey John,21,0,30,9
1715656091356,SOCI 117,A01,494376,Staff,0,5,5,5
1715656092385,WES 237B,A00,494380,Staff,10,0,20,10
1715656094468,AESE 279B,A00,494370,Wade; Jon P,0,0,33,33
1715656095496,AIP 97,001,660915,Van Den Einde; Yael Dahlia,9998,0,9999,1
1715656096524,AIP 197,001,627712,Vespa; Emanuel Ignacio,9995,0,9999,4
1715656096524,AIP 197,002,650778,Amir; On,9998,0,9999,1
1715656096524,AIP 197,003,650933,Avenancio-Leon; Carlos,9998,0,9999,1
1715656096524,AIP 197,004,658530,Heyman; Gail D.,9998,0,9999,1
1715656096524,AIP 197,005,658631,Neal; Sonya E,9998,0,9999,1
1715656096524,AIP 197,006,658671,Du; Songzi,9998,0,9999,1
1715656097551,ANAR 135S,A00,494369,Braswell; Geoffrey E.,0,0,0,0
1715656098580,BENG 196,001,628496,Engler; Adam J.,9998,0,9999,1
1715656098580,BENG 196,002,660916,Watson; John Thomas,9998,0,9999,1
1715656099608,BISP 197,001,650773,Wilhelm; James E.,9994,0,9999,5
1715656099608,BISP 197,002,658904,Coleman; Aaron B.,9998,0,9999,1
1715656100633,CAT 124RS,A01,519847,Geibel; William,0,0,20,20
1715656101663,CAT 125RS,A01,515971,Geibel; William,0,0,20,20
1715656102688,CLRE 250,A00,511389,Morris; Sheldon,9992,0,9999,7
1715656103715,CLRE 251,A00,507176,Mehta; Ravindra L.,9992,0,9999,7
1715656103715,CLRE 251,B00,511410,Mehta; Ravindra L.,9998,0,9999,1
1715656104741,CLRE 252,A00,507189,Cuomo; Raphael Eduardo,9994,0,9999,5
1715656105766,CLRE 253,A00,507199,Vaida; Florin,9994,0,9999,5
1715656105766,CLRE 253,B00,507202,Vaida; Florin,9999,0,9999,0
1715656106796,CLRE 259,A00,507211,Patel; Hemal,9996,0,9999,3
1715656107823,CLRE 260,A00,507221,Cuomo; Raphael Eduardo,9999,0,9999,0
1715656108849,CLRE 297,001,507242,Cuomo; Raphael Eduardo,9999,0,9999,0
1715656109881,COGS 197,001,638244,Voytek; Bradley Thomas,9997,0,9999,2
1715656110907,CSE 191,A00,516875,Minnes Kemp; Mor Mia,9991,0,9999,8
1715656111932,CSE 197,001,637388,Minnes Kemp; Mor Mia,9992,0,9999,7
1715656112959,CSS 201S,A01,494383,Mignozzetti; Umberto,35,0,35,0
1715656113984,CSS 202S,A01,494387,Mignozzetti; Umberto,35,0,35,0
1715656115011,DSC 197,001,628532,Eldridge; Justin Matthew,9995,0,9999,4
1715656116037,EAP 100,A00,516065,Staff,9799,0,9999,200
1715656117065,ECE 45,A01,507414,Staff,32,0,60,28
1715656119118,ECE 111,A01,507420,Staff,11,0,50,39
1715656120145,ECE 197,001,548057,Sievenpiper; Daniel F.,9991,0,9999,8
1715656121172,EDS 115,A00,507243,Choi; Bailey Miyeon,6,0,28,22
1715656122198,EDS 117,A01,494379,Staff,0,6,34,35
1715656123226,EDS 125,A00,507246,Hopkins; Megan Beth,7,0,30,23
1715656124255,EDS 128A,A01,507264,Fargason; Sharon Gayle,5,0,26,21
1715656125280,EDS 128B,A01,507293,Pappas; Elizabeth,9,0,30,21
1715656126308,EDS 139,A00,507294,Fargason; Sharon Gayle,9,0,30,21
1715656126308,EDS 139,B00,507313,Pappas; Elizabeth,9,0,30,21
1715656127333,EDS 201,A00,507315,Staff,10,0,30,20
1715656128358,EDS 203,A01,507317,Halter; Christopher P.,10,0,30,20
1715656129383,EDS 204R,A01,507319,Halter; Christopher P.,0,3,30,30
1715656129383,EDS 204R,B01,507331,Heinzman; Erica M.,14,0,30,16
1715656130407,EDS 206R,A00,507332,Staff,0,4,30,30
1715656130407,EDS 206R,B00,507343,Staff,15,0,30,15
1715656131433,EDS 250,A00,507344,Hemans; Patricia Ann Benitez,20,0,40,20
1715656132458,EDS 281,A00,507345,Daly; Alan J.,18,0,18,0
1715656133481,EDS 284,A00,507350,Daly; Alan J.,16,0,16,0
1715656134508,EDS 286,A00,507359,Fine; Sarah,18,0,18,0
1715656135532,EDS 289C,A01,507361,Daly; Alan J.,18,0,18,0
1715656136559,EDS 290,A00,507366,Hofstetter; Carolyn,15,0,15,0
1715656137589,LIGM 5A,A00,507421,Fischer-Grunski; Eva K,17,0,20,3
1715656138615,LIGM 5B,A00,507423,Fischer-Grunski; Eva K,19,0,20,1
1715656139643,LIGM 5C,A00,507425,Fischer-Grunski; Eva K,19,0,20,1
1715656140670,LIIT 5AS,A00,507427,Carnelos; Chiara,20,0,20,0
1715656141695,LIIT 5BS,A00,507430,Carnelos; Chiara,20,0,20,0
1715656142725,LIIT 5CS,A00,507432,Carnelos; Chiara,20,0,20,0
1715656143752,LISP 5A,A00,507541,Munoz Sanchez; Alicia,11,0,20,9
1715656144779,LISP 5B,A00,507671,Munoz Sanchez; Alicia,8,0,20,12
1715656145807,LISP 5C,A00,507696,Munoz Sanchez; Alicia,8,0,20,12
1715656146831,MAE 197,001,528363,Boechler; Nicholas Sebastia,9998,0,9999,1
1715656147862,MATH 197,001,523477,Kedlaya; Kiran S.,9994,0,9999,5
1715656147862,MATH 197,002,563811,Zhang; Danna,9994,0,9999,5
1715656147862,MATH 197,003,628552,Dumitriu; Ioana,9998,0,9999,1
1715656147862,MATH 197,004,660885,Floyd; Eric,9998,0,9999,1
1715656148887,MCWP 40R,A00,518780,Staff,1,0,20,19
1715656148887,MCWP 40R,B00,518781,Carter; Jennifer A,9,0,20,11
1715656148887,MCWP 40R,C00,518783,Smith; Haydee Marie,5,0,20,15
1715656149914,MCWP 50R,A00,518791,Redela; Pamela Morgan,0,1,20,20
1715656149914,MCWP 50R,B00,518792,Krone; Jarret,0,2,20,20
1715656149914,MCWP 50R,C00,518793,Staff,0,4,20,20
1715656149914,MCWP 50R,D00,518794,Morshed; Michael James,0,2,20,20
1715656149914,MCWP 50R,E00,518795,Carter; Andrea L,0,2,20,20
1715656149914,MCWP 50R,F00,518796,Miller; Elizabeth Deen,0,1,20,20
1715656149914,MCWP 50R,G00,518797,Guillen; Melinda,0,1,20,20
1715656150941,MMW 12R,A01,514034,Herbst; Matthew,0,2,16,16
1715656150941,MMW 12R,A02,514035,Herbst; Matthew,0,0,16,16
1715656151983,MMW 13R,A01,514037,Staff,0,5,16,16
1715656151983,MMW 13R,A02,514039,Staff,0,5,16,16
1715656151983,MMW 13R,A03,628519,Staff,0,4,16,16
1715656154040,SIO 295LS,A00,523233,Staff,10,0,30,20
1715656155067,SIO 295S,A00,523232,Staff,10,0,30,20
1715656156093,SIOC 290S,A01,637330,Merrifield; Mark A,21,0,30,9
1715656157117,SIOC 291S,A01,637333,Gabriel; Corey John,21,0,30,9
1715656158145,SOCI 117,A01,494376,Staff,0,5,5,5
1715656159169,WES 237B,A00,494380,Staff,10,0,20,10
1715656161241,AESE 279B,A00,494370,Wade; Jon P,0,0,33,33
1715656162273,AIP 97,001,660915,Van Den Einde; Yael Dahlia,9998,0,9999,1
1715656163301,AIP 197,001,627712,Vespa; Emanuel Ignacio,9995,0,9999,4
1715656163301,AIP 197,002,650778,Amir; On,9998,0,9999,1
1715656163301,AIP 197,003,650933,Avenancio-Leon; Carlos,9998,0,9999,1
1715656163301,AIP 197,004,658530,Heyman; Gail D.,9998,0,9999,1
1715656163301,AIP 197,005,658631,Neal; Sonya E,9998,0,9999,1
1715656163301,AIP 197,006,658671,Du; Songzi,9998,0,9999,1
1715656164327,ANAR 135S,A00,494369,Braswell; Geoffrey E.,0,0,0,0
1715656165354,BENG 196,001,628496,Engler; Adam J.,9998,0,9999,1
1715656165354,BENG 196,002,660916,Watson; John Thomas,9998,0,9999,1
1715656166383,BISP 197,001,650773,Wilhelm; James E.,9994,0,9999,5
1715656166383,BISP 197,002,658904,Coleman; Aaron B.,9998,0,9999,1
1715656167407,CAT 124RS,A01,519847,Geibel; William,0,0,20,20
1715656168431,CAT 125RS,A01,515971,Geibel; William,0,0,20,20
1715656169460,CLRE 250,A00,511389,Morris; Sheldon,9992,0,9999,7
1715656170488,CLRE 251,A00,507176,Mehta; Ravindra L.,9992,0,9999,7
1715656170488,CLRE 251,B00,511410,Mehta; Ravindra L.,9998,0,9999,1
1715656171513,CLRE 252,A00,507189,Cuomo; Raphael Eduardo,9994,0,9999,5
1715656172541,CLRE 253,A00,507199,Vaida; Florin,9994,0,9999,5
1715656172541,CLRE 253,B00,507202,Vaida; Florin,9999,0,9999,0
1715656173566,CLRE 259,A00,507211,Patel; Hemal,9996,0,9999,3
1715656174593,CLRE 260,A00,507221,Cuomo; Raphael Eduardo,9999,0,9999,0
1715656175620,CLRE 297,001,507242,Cuomo; Raphael Eduardo,9999,0,9999,0
1715656176644,COGS 197,001,638244,Voytek; Bradley Thomas,9997,0,9999,2
1715656177670,CSE 191,A00,516875,Minnes Kemp; Mor Mia,9991,0,9999,8
1715656178693,CSE 197,001,637388,Minnes Kemp; Mor Mia,9992,0,9999,7
1715656179720,CSS 201S,A01,494383,Mignozzetti; Umberto,35,0,35,0
1715656180745,CSS 202S,A01,494387,Mignozzetti; Umberto,35,0,35,0
1715656181769,DSC 197,001,628532,Eldridge; Justin Matthew,9995,0,9999,4
1715656182795,EAP 100,A00,516065,Staff,9799,0,9999,200
1715656183828,ECE 45,A01,507414,Staff,32,0,60,28
1715656185877,ECE 111,A01,507420,Staff,11,0,50,39
1715656186901,ECE 197,001,548057,Sievenpiper; Daniel F.,9991,0,9999,8
1715656187931,EDS 115,A00,507243,Choi; Bailey Miyeon,6,0,28,22
1715656188958,EDS 117,A01,494379,Staff,0,6,34,35
1715656189981,EDS 125,A00,507246,Hopkins; Megan Beth,7,0,30,23
1715656191006,EDS 128A,A01,507264,Fargason; Sharon Gayle,5,0,26,21
1715656192032,EDS 128B,A01,507293,Pappas; Elizabeth,9,0,30,21
1715656193058,EDS 139,A00,507294,Fargason; Sharon Gayle,9,0,30,21
1715656193058,EDS 139,B00,507313,Pappas; Elizabeth,9,0,30,21
1715656194085,EDS 201,A00,507315,Staff,10,0,30,20
1715656195111,EDS 203,A01,507317,Halter; Christopher P.,10,0,30,20
1715656196135,EDS 204R,A01,507319,Halter; Christopher P.,0,3,30,30
1715656196135,EDS 204R,B01,507331,Heinzman; Erica M.,14,0,30,16
1715656197159,EDS 206R,A00,507332,Staff,0,4,30,30
1715656197159,EDS 206R,B00,507343,Staff,15,0,30,15
1715656198183,EDS 250,A00,507344,Hemans; Patricia Ann Benitez,20,0,40,20
1715656199207,EDS 281,A00,507345,Daly; Alan J.,18,0,18,0
1715656200235,EDS 284,A00,507350,Daly; Alan J.,16,0,16,0
1715656201265,EDS 286,A00,507359,Fine; Sarah,18,0,18,0
1715656202292,EDS 289C,A01,507361,Daly; Alan J.,18,0,18,0
1715656203317,EDS 290,A00,507366,Hofstetter; Carolyn,15,0,15,0
1715656204344,LIGM 5A,A00,507421,Fischer-Grunski; Eva K,17,0,20,3
1715656205373,LIGM 5B,A00,507423,Fischer-Grunski; Eva K,19,0,20,1
1715656206401,LIGM 5C,A00,507425,Fischer-Grunski; Eva K,19,0,20,1
1715656207430,LIIT 5AS,A00,507427,Carnelos; Chiara,20,0,20,0
1715656208458,LIIT 5BS,A00,507430,Carnelos; Chiara,20,0,20,0
1715656209484,LIIT 5CS,A00,507432,Carnelos; Chiara,20,0,20,0
1715656210510,LISP 5A,A00,507541,Munoz Sanchez; Alicia,11,0,20,9
1715656211539,LISP 5B,A00,507671,Munoz Sanchez; Alicia,8,0,20,12
1715656212563,LISP 5C,A00,507696,Munoz Sanchez; Alicia,8,0,20,12
1715656213591,MAE 197,001,528363,Boechler; Nicholas Sebastia,9998,0,9999,1
1715656214623,MATH 197,001,523477,Kedlaya; Kiran S.,9994,0,9999,5
1715656214623,MATH 197,002,563811,Zhang; Danna,9994,0,9999,5
1715656214623,MATH 197,003,628552,Dumitriu; Ioana,9998,0,9999,1
1715656214623,MATH 197,004,660885,Floyd; Eric,9998,0,9999,1
1715656215650,MCWP 40R,A00,518780,Staff,1,0,20,19
1715656215650,MCWP 40R,B00,518781,Carter; Jennifer A,9,0,20,11
1715656215650,MCWP 40R,C00,518783,Smith; Haydee Marie,5,0,20,15
1715656216678,MCWP 50R,A00,518791,Redela; Pamela Morgan,0,1,20,20
1715656216678,MCWP 50R,B00,518792,Krone; Jarret,0,2,20,20
1715656216678,MCWP 50R,C00,518793,Staff,0,4,20,20
1715656216678,MCWP 50R,D00,518794,Morshed; Michael James,0,2,20,20
1715656216678,MCWP 50R,E00,518795,Carter; Andrea L,0,2,20,20
1715656216678,MCWP 50R,F00,518796,Miller; Elizabeth Deen,0,1,20,20
1715656216678,MCWP 50R,G00,518797,Guillen; Melinda,0,1,20,20
1715656217703,MMW 12R,A01,514034,Herbst; Matthew,0,2,16,16
1715656217703,MMW 12R,A02,514035,Herbst; Matthew,0,0,16,16
1715656218729,MMW 13R,A01,514037,Staff,0,5,16,16
1715656218729,MMW 13R,A02,514039,Staff,0,5,16,16
1715656218729,MMW 13R,A03,628519,Staff,0,4,16,16
1715656220785,SIO 295LS,A00,523233,Staff,10,0,30,20
1715656221809,SIO 295S,A00,523232,Staff,10,0,30,20
1715656222833,SIOC 290S,A01,637330,Merrifield; Mark A,21,0,30,9
1715656223863,SIOC 291S,A01,637333,Gabriel; Corey John,21,0,30,9
1715656224889,SOCI 117,A01,494376,Staff,0,5,5,5
1715656225916,WES 237B,A00,494380,Staff,10,0,20,10
1715656227989,AESE 279B,A00,494370,Wade; Jon P,0,0,33,33
1715656229016,AIP 97,001,660915,Van Den Einde; Yael Dahlia,9998,0,9999,1
1715656230048,AIP 197,001,627712,Vespa; Emanuel Ignacio,9995,0,9999,4
1715656230048,AIP 197,002,650778,Amir; On,9998,0,9999,1
1715656230048,AIP 197,003,650933,Avenancio-Leon; Carlos,9998,0,9999,1
1715656230048,AIP 197,004,658530,Heyman; Gail D.,9998,0,9999,1
1715656230048,AIP 197,005,658631,Neal; Sonya E,9998,0,9999,1
1715656230048,AIP 197,006,658671,Du; Songzi,9998,0,9999,1
1715656231072,ANAR 135S,A00,494369,Braswell; Geoffrey E.,0,0,0,0
1715656232098,BENG 196,001,628496,Engler; Adam J.,9998,0,9999,1
1715656232098,BENG 196,002,660916,Watson; John Thomas,9998,0,9999,1
1715656233145,BISP 197,001,650773,Wilhelm; James E.,9994,0,9999,5
1715656233145,BISP 197,002,658904,Coleman; Aaron B.,9998,0,9999,1
1715656234170,CAT 124RS,A01,519847,Geibel; William,0,0,20,20
1715656235198,CAT 125RS,A01,515971,Geibel; William,0,0,20,20
1715656236224,CLRE 250,A00,511389,Morris; Sheldon,9992,0,9999,7
1715656237250,CLRE 251,A00,507176,Mehta; Ravindra L.,9992,0,9999,7
1715656237250,CLRE 251,B00,511410,Mehta; Ravindra L.,9998,0,9999,1
1715656238279,CLRE 252,A00,507189,Cuomo; Raphael Eduardo,9994,0,9999,5
1715656239313,CLRE 253,A00,507199,Vaida; Florin,9994,0,9999,5
1715656239313,CLRE 253,B00,507202,Vaida; Florin,9999,0,9999,0
1715656240341,CLRE 259,A00,507211,Patel; Hemal,9996,0,9999,3
1715656241367,CLRE 260,A00,507221,Cuomo; Raphael Eduardo,9999,0,9999,0
1715656242394,CLRE 297,001,507242,Cuomo; Raphael Eduardo,9999,0,9999,0
1715656243419,COGS 197,001,638244,Voytek; Bradley Thomas,9997,0,9999,2
1715656244447,CSE 191,A00,516875,Minnes Kemp; Mor Mia,9991,0,9999,8
1715656245472,CSE 197,001,637388,Minnes Kemp; Mor Mia,9992,0,9999,7
1715656246503,CSS 201S,A01,494383,Mignozzetti; Umberto,35,0,35,0
1715656247528,CSS 202S,A01,494387,Mignozzetti; Umberto,35,0,35,0
1715656248553,DSC 197,001,628532,Eldridge; Justin Matthew,9995,0,9999,4
1715656249579,EAP 100,A00,516065,Staff,9799,0,9999,200
1715656250607,ECE 45,A01,507414,Staff,32,0,60,28
1715656252656,ECE 111,A01,507420,Staff,11,0,50,39
1715656253681,ECE 197,001,548057,Sievenpiper; Daniel F.,9991,0,9999,8
1715656254708,EDS 115,A00,507243,Choi; Bailey Miyeon,6,0,28,22
1715656255738,EDS 117,A01,494379,Staff,0,6,34,35
1715656256764,EDS 125,A00,507246,Hopkins; Megan Beth,7,0,30,23
1715656257792,EDS 128A,A01,507264,Fargason; Sharon Gayle,5,0,26,21
1715656258818,EDS 128B,A01,507293,Pappas; Elizabeth,9,0,30,21
1715656259842,EDS 139,A00,507294,Fargason; Sharon Gayle,9,0,30,21
1715656259842,EDS 139,B00,507313,Pappas; Elizabeth,9,0,30,21
1715656260869,EDS 201,A00,507315,Staff,10,0,30,20
1715656261902,EDS 203,A01,507317,Halter; Christopher P.,10,0,30,20
1715656262933,EDS 204R,A01,507319,Halter; Christopher P.,0,3,30,30
1715656262933,EDS 204R,B01,507331,Heinzman; Erica M.,14,0,30,16
1715656263958,EDS 206R,A00,507332,Staff,0,4,30,30
1715656263958,EDS 206R,B00,507343,Staff,15,0,30,15
1715656264984,EDS 250,A00,507344,Hemans; Patricia Ann Benitez,20,0,40,20
1715656266010,EDS 281,A00,507345,Daly; Alan J.,18,0,18,0
1715656267047,EDS 284,A00,507350,Daly; Alan J.,16,0,16,0
1715656268073,EDS 286,A00,507359,Fine; Sarah,18,0,18,0
1715656269097,EDS 289C,A01,507361,Daly; Alan J.,18,0,18,0
1715656270122,EDS 290,A00,507366,Hofstetter; Carolyn,15,0,15,0
1715656271148,LIGM 5A,A00,507421,Fischer-Grunski; Eva K,17,0,20,3
1715656272174,LIGM 5B,A00,507423,Fischer-Grunski; Eva K,19,0,20,1
1715656273203,LIGM 5C,A00,507425,Fischer-Grunski; Eva K,19,0,20,1
1715656274228,LIIT 5AS,A00,507427,Carnelos; Chiara,20,0,20,0
1715656275253,LIIT 5BS,A00,507430,Carnelos; Chiara,20,0,20,0
1715656276278,LIIT 5CS,A00,507432,Carnelos; Chiara,20,0,20,0
1715656277308,LISP 5A,A00,507541,Munoz Sanchez; Alicia,11,0,20,9
1715656278336,LISP 5B,A00,507671,Munoz Sanchez; Alicia,8,0,20,12
1715656279368,LISP 5C,A00,507696,Munoz Sanchez; Alicia,8,0,20,12
1715656280392,MAE 197,001,528363,Boechler; Nicholas Sebastia,9998,0,9999,1
1715656281420,MATH 197,001,523477,Kedlaya; Kiran S.,9994,0,9999,5
1715656281420,MATH 197,002,563811,Zhang; Danna,9994,0,9999,5
1715656281420,MATH 197,003,628552,Dumitriu; Ioana,9998,0,9999,1
1715656281420,MATH 197,004,660885,Floyd; Eric,9998,0,9999,1
1715656282451,MCWP 40R,A00,518780,Staff,1,0,20,19
1715656282451,MCWP 40R,B00,518781,Carter; Jennifer A,9,0,20,11
1715656282451,MCWP 40R,C00,518783,Smith; Haydee Marie,5,0,20,15
1715656283477,MCWP 50R,A00,518791,Redela; Pamela Morgan,0,1,20,20
1715656283477,MCWP 50R,B00,518792,Krone; Jarret,0,2,20,20
1715656283477,MCWP 50R,C00,518793,Staff,0,4,20,20
1715656283477,MCWP 50R,D00,518794,Morshed; Michael James,0,2,20,20
1715656283477,MCWP 50R,E00,518795,Carter; Andrea L,0,2,20,20
1715656283477,MCWP 50R,F00,518796,Miller; Elizabeth Deen,0,1,20,20
1715656283477,MCWP 50R,G00,518797,Guillen; Melinda,0,1,20,20
1715656284502,MMW 12R,A01,514034,Herbst; Matthew,0,2,16,16
1715656284502,MMW 12R,A02,514035,Herbst; Matthew,0,0,16,16
1715656285527,MMW 13R,A01,514037,Staff,0,5,16,16
1715656285527,MMW 13R,A02,514039,Staff,0,5,16,16
1715656285527,MMW 13R,A03,628519,Staff,0,4,16,16
1715656287580,SIO 295LS,A00,523233,Staff,10,0,30,20
1715656288604,SIO 295S,A00,523232,Staff,10,0,30,20
1715656289633,SIOC 290S,A01,637330,Merrifield; Mark A,21,0,30,9
1715656290662,SIOC 291S,A01,637333,Gabriel; Corey John,21,0,30,9
1715656291690,SOCI 117,A01,494376,Staff,0,5,5,5
1715656292714,WES 237B,A00,494380,Staff,10,0,20,10
1715656294797,AESE 279B,A00,494370,Wade; Jon P,0,0,33,33
1715656295825,AIP 97,001,660915,Van Den Einde; Yael Dahlia,9998,0,9999,1
1715656296853,AIP 197,001,627712,Vespa; Emanuel Ignacio,9995,0,9999,4
1715656296853,AIP 197,002,650778,Amir; On,9998,0,9999,1
1715656296853,AIP 197,003,650933,Avenancio-Leon; Carlos,9998,0,9999,1
1715656296853,AIP 197,004,658530,Heyman; Gail D.,9998,0,9999,1
1715656296853,AIP 197,005,658631,Neal; Sonya E,9998,0,9999,1
1715656296853,AIP 197,006,658671,Du; Songzi,9998,0,9999,1
1715656297883,ANAR 135S,A00,494369,Braswell; Geoffrey E.,0,0,0,0
1715656298911,BENG 196,001,628496,Engler; Adam J.,9998,0,9999,1
1715656298911,BENG 196,002,660916,Watson; John Thomas,9998,0,9999,1
1715656299936,BISP 197,001,650773,Wilhelm; James E.,9994,0,9999,5
1715656299936,BISP 197,002,658904,Coleman; Aaron B.,9998,0,9999,1
1715656300961,CAT 124RS,A01,519847,Geibel; William,0,0,20,20
1715656301989,CAT 125RS,A01,515971,Geibel; William,0,0,20,20
1715656303015,CLRE 250,A00,511389,Morris; Sheldon,9992,0,9999,7
1715656304045,CLRE 251,A00,507176,Mehta; Ravindra L.,9992,0,9999,7
1715656304045,CLRE 251,B00,511410,Mehta; Ravindra L.,9998,0,9999,1
1715656305071,CLRE 252,A00,507189,Cuomo; Raphael Eduardo,9994,0,9999,5
1715656306097,CLRE 253,A00,507199,Vaida; Florin,9994,0,9999,5
1715656306097,CLRE 253,B00,507202,Vaida; Florin,9999,0,9999,0
1715656307126,CLRE 259,A00,507211,Patel; Hemal,9996,0,9999,3
1715656308150,CLRE 260,A00,507221,Cuomo; Raphael Eduardo,9999,0,9999,0
1715656309177,CLRE 297,001,507242,Cuomo; Raphael Eduardo,9999,0,9999,0
1715656310207,COGS 197,001,638244,Voytek; Bradley Thomas,9997,0,9999,2
1715656311236,CSE 191,A00,516875,Minnes Kemp; Mor Mia,9991,0,9999,8
1715656312262,CSE 197,001,637388,Minnes Kemp; Mor Mia,9992,0,9999,7
1715656313292,CSS 201S,A01,494383,Mignozzetti; Umberto,35,0,35,0
1715656314321,CSS 202S,A01,494387,Mignozzetti; Umberto,35,0,35,0
1715656315347,DSC 197,001,628532,Eldridge; Justin Matthew,9995,0,9999,4
1715656316373,EAP 100,A00,516065,Staff,9799,0,9999,200
1715656317402,ECE 45,A01,507414,Staff,32,0,60,28
1715656319457,ECE 111,A01,507420,Staff,11,0,50,39
1715656320488,ECE 197,001,548057,Sievenpiper; Daniel F.,9991,0,9999,8
1715656321515,EDS 115,A00,507243,Choi; Bailey Miyeon,6,0,28,22
1715656322544,EDS 117,A01,494379,Staff,0,6,34,35
1715656323571,EDS 125,A00,507246,Hopkins; Megan Beth,7,0,30,23
1715656324597,EDS 128A,A01,507264,Fargason; Sharon Gayle,5,0,26,21
1715656325623,EDS 128B,A01,507293,Pappas; Elizabeth,9,0,30,21
1715656326652,EDS 139,A00,507294,Fargason; Sharon Gayle,9,0,30,21
1715656326652,EDS 139,B00,507313,Pappas; Elizabeth,9,0,30,21
1715656327680,EDS 201,A00,507315,Staff,10,0,30,20
1715656328705,EDS 203,A01,507317,Halter; Christopher P.,10,0,30,20
1715656329730,EDS 204R,A01,507319,Halter; Christopher P.,0,3,30,30
1715656329730,EDS 204R,B01,507331,Heinzman; Erica M.,14,0,30,16
1715656330756,EDS 206R,A00,507332,Staff,0,4,30,30
1715656330756,EDS 206R,B00,507343,Staff,15,0,30,15
1715656331786,EDS 250,A00,507344,Hemans; Patricia Ann Benitez,20,0,40,20
1715656332815,EDS 281,A00,507345,Daly; Alan J.,18,0,18,0
1715656333842,EDS 284,A00,507350,Daly; Alan J.,16,0,16,0
1715656334868,EDS 286,A00,507359,Fine; Sarah,18,0,18,0
1715656335893,EDS 289C,A01,507361,Daly; Alan J.,18,0,18,0
1715656336917,EDS 290,A00,507366,Hofstetter; Carolyn,15,0,15,0
1715656337946,LIGM 5A,A00,507421,Fischer-Grunski; Eva K,17,0,20,3
1715656338973,LIGM 5B,A00,507423,Fischer-Grunski; Eva K,19,0,20,1
1715656340000,LIGM 5C,A00,507425,Fischer-Grunski; Eva K,19,0,20,1
1715656341025,LIIT 5AS,A00,507427,Carnelos; Chiara,20,0,20,0
1715656342053,LIIT 5BS,A00,507430,Carnelos; Chiara,20,0,20,0
1715656343078,LIIT 5CS,A00,507432,Carnelos; Chiara,20,0,20,0
1715656344103,LISP 5A,A00,507541,Munoz Sanchez; Alicia,11,0,20,9
1715656345130,LISP 5B,A00,507671,Munoz Sanchez; Alicia,8,0,20,12
1715656346155,LISP 5C,A00,507696,Munoz Sanchez; Alicia,8,0,20,12
1715656347181,MAE 197,001,528363,Boechler; Nicholas Sebastia,9998,0,9999,1
1715656348214,MATH 197,001,523477,Kedlaya; Kiran S.,9994,0,9999,5
1715656348214,MATH 197,002,563811,Zhang; Danna,9994,0,9999,5
1715656348214,MATH 197,003,628552,Dumitriu; Ioana,9998,0,9999,1
1715656348214,MATH 197,004,660885,Floyd; Eric,9998,0,9999,1
1715656349241,MCWP 40R,A00,518780,Staff,1,0,20,19
1715656349241,MCWP 40R,B00,518781,Carter; Jennifer A,9,0,20,11
1715656349241,MCWP 40R,C00,518783,Smith; Haydee Marie,5,0,20,15
1715656350271,MCWP 50R,A00,518791,Redela; Pamela Morgan,0,1,20,20
1715656350271,MCWP 50R,B00,518792,Krone; Jarret,0,2,20,20
1715656350271,MCWP 50R,C00,518793,Staff,0,4,20,20
1715656350271,MCWP 50R,D00,518794,Morshed; Michael James,0,2,20,20
1715656350271,MCWP 50R,E00,518795,Carter; Andrea L,0,2,20,20
1715656350271,MCWP 50R,F00,518796,Miller; Elizabeth Deen,0,1,20,20
1715656350271,MCWP 50R,G00,518797,Guillen; Melinda,0,1,20,20
1715656351297,MMW 12R,A01,514034,Herbst; Matthew,0,2,16,16
1715656351297,MMW 12R,A02,514035,Herbst; Matthew,0,0,16,16
1715656352322,MMW 13R,A01,514037,Staff,0,5,16,16
1715656352322,MMW 13R,A02,514039,Staff,0,5,16,16
1715656352322,MMW 13R,A03,628519,Staff,0,4,16,16
1715656354373,SIO 295LS,A00,523233,Staff,10,0,30,20
1715656355414,SIO 295S,A00,523232,Staff,10,0,30,20
1715656356442,SIOC 290S,A01,637330,Merrifield; Mark A,21,0,30,9
1715656357470,SIOC 291S,A01,637333,Gabriel; Corey John,21,0,30,9
1715656358497,SOCI 117,A01,494376,Staff,0,5,5,5
1715656359523,WES 237B,A00,494380,Staff,10,0,20,10
1715656361592,AESE 279B,A00,494370,Wade; Jon P,0,0,33,33
1715656362620,AIP 97,001,660915,Van Den Einde; Yael Dahlia,9998,0,9999,1
1715656363651,AIP 197,001,627712,Vespa; Emanuel Ignacio,9995,0,9999,4
1715656363651,AIP 197,002,650778,Amir; On,9998,0,9999,1
1715656363651,AIP 197,003,650933,Avenancio-Leon; Carlos,9998,0,9999,1
1715656363651,AIP 197,004,658530,Heyman; Gail D.,9998,0,9999,1
1715656363651,AIP 197,005,658631,Neal; Sonya E,9998,0,9999,1
1715656363651,AIP 197,006,658671,Du; Songzi,9998,0,9999,1
1715656364679,ANAR 135S,A00,494369,Braswell; Geoffrey E.,0,0,0,0
1715656365707,BENG 196,001,628496,Engler; Adam J.,9998,0,9999,1
1715656365707,BENG 196,002,660916,Watson; John Thomas,9998,0,9999,1
1715656366737,BISP 197,001,650773,Wilhelm; James E.,9994,0,9999,5
1715656366737,BISP 197,002,658904,Coleman; Aaron B.,9998,0,9999,1
1715656367763,CAT 124RS,A01,519847,Geibel; William,0,0,20,20
1715656368788,CAT 125RS,A01,515971,Geibel; William,0,0,20,20
1715656369815,CLRE 250,A00,511389,Morris; Sheldon,9992,0,9999,7
1715656370839,CLRE 251,A00,507176,Mehta; Ravindra L.,9992,0,9999,7
1715656370839,CLRE 251,B00,511410,Mehta; Ravindra L.,9998,0,9999,1
1715656371865,CLRE 252,A00,507189,Cuomo; Raphael Eduardo,9994,0,9999,5
1715656372892,CLRE 253,A00,507199,Vaida; Florin,9994,0,9999,5
1715656372892,CLRE 253,B00,507202,Vaida; Florin,9999,0,9999,0
1715656373919,CLRE 259,A00,507211,Patel; Hemal,9996,0,9999,3
1715656374945,CLRE 260,A00,507221,Cuomo; Raphael Eduardo,9999,0,9999,0
1715656375973,CLRE 297,001,507242,Cuomo; Raphael Eduardo,9999,0,9999,0
1715656376998,COGS 197,001,638244,Voytek; Bradley Thomas,9997,0,9999,2
1715656378026,CSE 191,A00,516875,Minnes Kemp; Mor Mia,9991,0,9999,8
1715656379053,CSE 197,001,637388,Minnes Kemp; Mor Mia,9992,0,9999,7
1715656380081,CSS 201S,A01,494383,Mignozzetti; Umberto,35,0,35,0
1715656381108,CSS 202S,A01,494387,Mignozzetti; Umberto,35,0,35,0
1715656382138,DSC 197,001,628532,Eldridge; Justin Matthew,9995,0,9999,4
1715656383166,EAP 100,A00,516065,Staff,9799,0,9999,200
1715656384194,ECE 45,A01,507414,Staff,32,0,60,28
1715656386247,ECE 111,A01,507420,Staff,11,0,50,39
1715656387273,ECE 197,001,548057,Sievenpiper; Daniel F.,9991,0,9999,8
1715656388301,EDS 115,A00,507243,Choi; Bailey Miyeon,6,0,28,22
1715656389331,EDS 117,A01,494379,Staff,0,6,34,35
1715656390361,EDS 125,A00,507246,Hopkins; Megan Beth,7,0,30,23
1715656391390,EDS 128A,A01,507264,Fargason; Sharon Gayle,5,0,26,21
1715656392415,EDS 128B,A01,507293,Pappas; Elizabeth,9,0,30,21
1715656393440,EDS 139,A00,507294,Fargason; Sharon Gayle,9,0,30,21
1715656393440,EDS 139,B00,507313,Pappas; Elizabeth,9,0,30,21
1715656394466,EDS 201,A00,507315,Staff,10,0,30,20
1715656395494,EDS 203,A01,507317,Halter; Christopher P.,10,0,30,20
1715656396525,EDS 204R,A01,507319,Halter; Christopher P.,0,3,30,30
1715656396525,EDS 204R,B01,507331,Heinzman; Erica M.,14,0,30,16
1715656397551,EDS 206R,A00,507332,Staff,0,4,30,30
1715656397551,EDS 206R,B00,507343,Staff,15,0,30,15
1715656398578,EDS 250,A00,507344,Hemans; Patricia Ann Benitez,20,0,40,20
1715656399607,EDS 281,A00,507345,Daly; Alan J.,18,0,18,0
1715656400634,EDS 284,A00,507350,Daly; Alan J.,16,0,16,0
1715656401663,EDS 286,A00,507359,Fine; Sarah,18,0,18,0
1715656402690,EDS 289C,A01,507361,Daly; Alan J.,18,0,18,0
1715656403725,EDS 290,A00,507366,Hofstetter; Carolyn,15,0,15,0
1715656404756,LIGM 5A,A00,507421,Fischer-Grunski; Eva K,17,0,20,3
1715656405782,LIGM 5B,A00,507423,Fischer-Grunski; Eva K,19,0,20,1
1715656406809,LIGM 5C,A00,507425,Fischer-Grunski; Eva K,19,0,20,1
1715656407834,LIIT 5AS,A00,507427,Carnelos; Chiara,20,0,20,0
1715656408864,LIIT 5BS,A00,507430,Carnelos; Chiara,20,0,20,0
1715656409893,LIIT 5CS,A00,507432,Carnelos; Chiara,20,0,20,0
1715656410918,LISP 5A,A00,507541,Munoz Sanchez; Alicia,11,0,20,9
1715656411949,LISP 5B,A00,507671,Munoz Sanchez; Alicia,8,0,20,12
1715656412974,LISP 5C,A00,507696,Munoz Sanchez; Alicia,8,0,20,12
1715656414001,MAE 197,001,528363,Boechler; Nicholas Sebastia,9998,0,9999,1
1715656415029,MATH 197,001,523477,Kedlaya; Kiran S.,9994,0,9999,5
1715656415029,MATH 197,002,563811,Zhang; Danna,9994,0,9999,5
1715656415029,MATH 197,003,628552,Dumitriu; Ioana,9998,0,9999,1
1715656415029,MATH 197,004,660885,Floyd; Eric,9998,0,9999,1
1715656416054,MCWP 40R,A00,518780,Staff,1,0,20,19
1715656416054,MCWP 40R,B00,518781,Carter; Jennifer A,9,0,20,11
1715656416054,MCWP 40R,C00,518783,Smith; Haydee Marie,5,0,20,15
1715656417081,MCWP 50R,A00,518791,Redela; Pamela Morgan,0,1,20,20
1715656417081,MCWP 50R,B00,518792,Krone; Jarret,0,2,20,20
1715656417081,MCWP 50R,C00,518793,Staff,0,4,20,20
1715656417081,MCWP 50R,D00,518794,Morshed; Michael James,0,2,20,20
1715656417081,MCWP 50R,E00,518795,Carter; Andrea L,0,2,20,20
1715656417081,MCWP 50R,F00,518796,Miller; Elizabeth Deen,0,1,20,20
1715656417081,MCWP 50R,G00,518797,Guillen; Melinda,0,1,20,20
1715656418108,MMW 12R,A01,514034,Herbst; Matthew,0,2,16,16
1715656418108,MMW 12R,A02,514035,Herbst; Matthew,0,0,16,16
1715656419132,MMW 13R,A01,514037,Staff,0,5,16,16
1715656419132,MMW 13R,A02,514039,Staff,0,5,16,16
1715656419132,MMW 13R,A03,628519,Staff,0,4,16,16
1715656421187,SIO 295LS,A00,523233,Staff,10,0,30,20
1715656422214,SIO 295S,A00,523232,Staff,10,0,30,20
1715656423265,SIOC 290S,A01,637330,Merrifield; Mark A,21,0,30,9
1715656424294,SIOC 291S,A01,637333,Gabriel; Corey John,21,0,30,9
1715656425321,SOCI 117,A01,494376,Staff,0,5,5,5
1715656426349,WES 237B,A00,494380,Staff,10,0,20,10
1715656428425,AESE 279B,A00,494370,Wade; Jon P,0,0,33,33
1715656429456,AIP 97,001,660915,Van Den Einde; Yael Dahlia,9998,0,9999,1
1715656430484,AIP 197,001,627712,Vespa; Emanuel Ignacio,9995,0,9999,4
1715656430484,AIP 197,002,650778,Amir; On,9998,0,9999,1
1715656430484,AIP 197,003,650933,Avenancio-Leon; Carlos,9998,0,9999,1
1715656430484,AIP 197,004,658530,Heyman; Gail D.,9998,0,9999,1
1715656430484,AIP 197,005,658631,Neal; Sonya E,9998,0,9999,1
1715656430484,AIP 197,006,658671,Du; Songzi,9998,0,9999,1
1715656431526,ANAR 135S,A00,494369,Braswell; Geoffrey E.,0,0,0,0
1715656432552,BENG 196,001,628496,Engler; Adam J.,9998,0,9999,1
1715656432552,BENG 196,002,660916,Watson; John Thomas,9998,0,9999,1
1715656433579,BISP 197,001,650773,Wilhelm; James E.,9994,0,9999,5
1715656433579,BISP 197,002,658904,Coleman; Aaron B.,9998,0,9999,1
1715656434604,CAT 124RS,A01,519847,Geibel; William,0,0,20,20
1715656435633,CAT 125RS,A01,515971,Geibel; William,0,0,20,20
1715656436659,CLRE 250,A00,511389,Morris; Sheldon,9992,0,9999,7
1715656437686,CLRE 251,A00,507176,Mehta; Ravindra L.,9992,0,9999,7
1715656437686,CLRE 251,B00,511410,Mehta; Ravindra L.,9998,0,9999,1
1715656438713,CLRE 252,A00,507189,Cuomo; Raphael Eduardo,9994,0,9999,5
1715656439739,CLRE 253,A00,507199,Vaida; Florin,9994,0,9999,5
1715656439739,CLRE 253,B00,507202,Vaida; Florin,9999,0,9999,0
1715656440767,CLRE 259,A00,507211,Patel; Hemal,9996,0,9999,3
1715656441795,CLRE 260,A00,507221,Cuomo; Raphael Eduardo,9999,0,9999,0
1715656442819,CLRE 297,001,507242,Cuomo; Raphael Eduardo,9999,0,9999,0
1715656443845,COGS 197,001,638244,Voytek; Bradley Thomas,9997,0,9999,2
1715656444873,CSE 191,A00,516875,Minnes Kemp; Mor Mia,9991,0,9999,8
1715656445897,CSE 197,001,637388,Minnes Kemp; Mor Mia,9992,0,9999,7
1715656446923,CSS 201S,A01,494383,Mignozzetti; Umberto,35,0,35,0
1715656447951,CSS 202S,A01,494387,Mignozzetti; Umberto,35,0,35,0
1715656448983,DSC 197,001,628532,Eldridge; Justin Matthew,9995,0,9999,4
1715656450011,EAP 100,A00,516065,Staff,9799,0,9999,200
1715656451042,ECE 45,A01,507414,Staff,32,0,60,28
1715656453096,ECE 111,A01,507420,Staff,11,0,50,39
1715656454125,ECE 197,001,548057,Sievenpiper; Daniel F.,9991,0,9999,8
1715656455155,EDS 115,A00,507243,Choi; Bailey Miyeon,6,0,28,22
1715656456184,EDS 117,A01,494379,Staff,0,6,34,35
1715656457211,EDS 125,A00,507246,Hopkins; Megan Beth,7,0,30,23
1715656458238,EDS 128A,A01,507264,Fargason; Sharon Gayle,5,0,26,21
1715656459269,EDS 128B,A01,507293,Pappas; Elizabeth,9,0,30,21
1715656460294,EDS 139,A00,507294,Fargason; Sharon Gayle,9,0,30,21
1715656460294,EDS 139,B00,507313,Pappas; Elizabeth,9,0,30,21
1715656461323,EDS 201,A00,507315,Staff,10,0,30,20
1715656462353,EDS 203,A01,507317,Halter; Christopher P.,10,0,30,20
1715656463382,EDS 204R,A01,507319,Halter; Christopher P.,0,3,30,30
1715656463382,EDS 204R,B01,507331,Heinzman; Erica M.,14,0,30,16
1715656464408,EDS 206R,A00,507332,Staff,0,4,30,30
1715656464408,EDS 206R,B00,507343,Staff,15,0,30,15
1715656465433,EDS 250,A00,507344,Hemans; Patricia Ann Benitez,20,0,40,20
1715656466458,EDS 281,A00,507345,Daly; Alan J.,18,0,18,0
1715656467483,EDS 284,A00,507350,Daly; Alan J.,16,0,16,0
1715656468511,EDS 286,A00,507359,Fine; Sarah,18,0,18,0
1715656469535,EDS 289C,A01,507361,Daly; Alan J.,18,0,18,0
1715656470561,EDS 290,A00,507366,Hofstetter; Carolyn,15,0,15,0
1715656471593,LIGM 5A,A00,507421,Fischer-Grunski; Eva K,17,0,20,3
1715656472623,LIGM 5B,A00,507423,Fischer-Grunski; Eva K,19,0,20,1
1715656473649,LIGM 5C,A00,507425,Fischer-Grunski; Eva K,19,0,20,1
1715656474674,LIIT 5AS,A00,507427,Carnelos; Chiara,20,0,20,0
1715656475700,LIIT 5BS,A00,507430,Carnelos; Chiara,20,0,20,0
1715656476725,LIIT 5CS,A00,507432,Carnelos; Chiara,20,0,20,0
1715656477751,LISP 5A,A00,507541,Munoz Sanchez; Alicia,11,0,20,9
1715656478777,LISP 5B,A00,507671,Munoz Sanchez; Alicia,8,0,20,12
1715656479802,LISP 5C,A00,507696,Munoz Sanchez; Alicia,8,0,20,12
1715656480827,MAE 197,001,528363,Boechler; Nicholas Sebastia,9998,0,9999,1
1715656481859,MATH 197,001,523477,Kedlaya; Kiran S.,9994,0,9999,5
1715656481859,MATH 197,002,563811,Zhang; Danna,9994,0,9999,5
1715656481859,MATH 197,003,628552,Dumitriu; Ioana,9998,0,9999,1
1715656481859,MATH 197,004,660885,Floyd; Eric,9998,0,9999,1
1715656482885,MCWP 40R,A00,518780,Staff,1,0,20,19
1715656482885,MCWP 40R,B00,518781,Carter; Jennifer A,9,0,20,11
1715656482885,MCWP 40R,C00,518783,Smith; Haydee Marie,5,0,20,15
1715656483915,MCWP 50R,A00,518791,Redela; Pamela Morgan,0,1,20,20
1715656483915,MCWP 50R,B00,518792,Krone; Jarret,0,2,20,20
1715656483915,MCWP 50R,C00,518793,Staff,0,4,20,20
1715656483915,MCWP 50R,D00,518794,Morshed; Michael James,0,2,20,20
1715656483915,MCWP 50R,E00,518795,Carter; Andrea L,0,2,20,20
1715656483915,MCWP 50R,F00,518796,Miller; Elizabeth Deen,0,1,20,20
1715656483915,MCWP 50R,G00,518797,Guillen; Melinda,0,1,20,20
1715656484942,MMW 12R,A01,514034,Herbst; Matthew,0,2,16,16
1715656484942,MMW 12R,A02,514035,Herbst; Matthew,0,0,16,16
1715656485967,MMW 13R,A01,514037,Staff,0,5,16,16
1715656485967,MMW 13R,A02,514039,Staff,0,5,16,16
1715656485967,MMW 13R,A03,628519,Staff,0,4,16,16
1715656488018,SIO 295LS,A00,523233,Staff,10,0,30,20
1715656489044,SIO 295S,A00,523232,Staff,10,0,30,20
1715656490074,SIOC 290S,A01,637330,Merrifield; Mark A,21,0,30,9
1715656491102,SIOC 291S,A01,637333,Gabriel; Corey John,21,0,30,9
1715656492131,SOCI 117,A01,494376,Staff,0,5,5,5
1715656493155,WES 237B,A00,494380,Staff,10,0,20,10
1715656495234,AESE 279B,A00,494370,Wade; Jon P,0,0,33,33
1715656496262,AIP 97,001,660915,Van Den Einde; Yael Dahlia,9998,0,9999,1
1715656497292,AIP 197,001,627712,Vespa; Emanuel Ignacio,9995,0,9999,4
1715656497292,AIP 197,002,650778,Amir; On,9998,0,9999,1
1715656497292,AIP 197,003,650933,Avenancio-Leon; Carlos,9998,0,9999,1
1715656497292,AIP 197,004,658530,Heyman; Gail D.,9998,0,9999,1
1715656497292,AIP 197,005,658631,Neal; Sonya E,9998,0,9999,1
1715656497292,AIP 197,006,658671,Du; Songzi,9998,0,9999,1
1715656498319,ANAR 135S,A00,494369,Braswell; Geoffrey E.,0,0,0,0
1715656499349,BENG 196,001,628496,Engler; Adam J.,9998,0,9999,1
1715656499349,BENG 196,002,660916,Watson; John Thomas,9998,0,9999,1
1715656500379,BISP 197,001,650773,Wilhelm; James E.,9994,0,9999,5
1715656500379,BISP 197,002,658904,Coleman; Aaron B.,9998,0,9999,1
1715656501412,CAT 124RS,A01,519847,Geibel; William,0,0,20,20
1715656502439,CAT 125RS,A01,515971,Geibel; William,0,0,20,20
1715656503472,CLRE 250,A00,511389,Morris; Sheldon,9992,0,9999,7
1715656504501,CLRE 251,A00,507176,Mehta; Ravindra L.,9992,0,9999,7
1715656504501,CLRE 251,B00,511410,Mehta; Ravindra L.,9998,0,9999,1
1715656505528,CLRE 252,A00,507189,Cuomo; Raphael Eduardo,9994,0,9999,5
1715656506554,CLRE 253,A00,507199,Vaida; Florin,9994,0,9999,5
1715656506554,CLRE 253,B00,507202,Vaida; Florin,9999,0,9999,0
1715656507581,CLRE 259,A00,507211,Patel; Hemal,9996,0,9999,3
1715656508607,CLRE 260,A00,507221,Cuomo; Raphael Eduardo,9999,0,9999,0
1715656509635,CLRE 297,001,507242,Cuomo; Raphael Eduardo,9999,0,9999,0
1715656510662,COGS 197,001,638244,Voytek; Bradley Thomas,9997,0,9999,2
1715656511689,CSE 191,A00,516875,Minnes Kemp; Mor Mia,9991,0,9999,8
1715656512715,CSE 197,001,637388,Minnes Kemp; Mor Mia,9992,0,9999,7
1715656513744,CSS 201S,A01,494383,Mignozzetti; Umberto,35,0,35,0
1715656514769,CSS 202S,A01,494387,Mignozzetti; Umberto,35,0,35,0
1715656515795,DSC 197,001,628532,Eldridge; Justin Matthew,9995,0,9999,4
1715656516822,EAP 100,A00,516065,Staff,9799,0,9999,200
1715656517849,ECE 45,A01,507414,Staff,32,0,60,28
1715656519898,ECE 111,A01,507420,Staff,11,0,50,39
1715656520924,ECE 197,001,548057,Sievenpiper; Daniel F.,9991,0,9999,8
1715656521952,EDS 115,A00,507243,Choi; Bailey Miyeon,6,0,28,22
1715656522977,EDS 117,A01,494379,Staff,0,6,34,35
1715656524001,EDS 125,A00,507246,Hopkins; Megan Beth,7,0,30,23
1715656525029,EDS 128A,A01,507264,Fargason; Sharon Gayle,5,0,26,21
1715656526058,EDS 128B,A01,507293,Pappas; Elizabeth,9,0,30,21
1715656527086,EDS 139,A00,507294,Fargason; Sharon Gayle,9,0,30,21
1715656527086,EDS 139,B00,507313,Pappas; Elizabeth,9,0,30,21
1715656528112,EDS 201,A00,507315,Staff,10,0,30,20
1715656529141,EDS 203,A01,507317,Halter; Christopher P.,10,0,30,20
1715656530171,EDS 204R,A01,507319,Halter; Christopher P.,0,3,30,30
1715656530171,EDS 204R,B01,507331,Heinzman; Erica M.,14,0,30,16
1715656531196,EDS 206R,A00,507332,Staff,0,4,30,30
1715656531196,EDS 206R,B00,507343,Staff,15,0,30,15
1715656532224,EDS 250,A00,507344,Hemans; Patricia Ann Benitez,20,0,40,20
1715656533251,EDS 281,A00,507345,Daly; Alan J.,18,0,18,0
1715656534278,EDS 284,A00,507350,Daly; Alan J.,16,0,16,0
1715656535303,EDS 286,A00,507359,Fine; Sarah,18,0,18,0
1715656536331,EDS 289C,A01,507361,Daly; Alan J.,18,0,18,0
1715656537355,EDS 290,A00,507366,Hofstetter; Carolyn,15,0,15,0
1715656538382,LIGM 5A,A00,507421,Fischer-Grunski; Eva K,17,0,20,3
1715656539412,LIGM 5B,A00,507423,Fischer-Grunski; Eva K,19,0,20,1
1715656540445,LIGM 5C,A00,507425,Fischer-Grunski; Eva K,19,0,20,1
1715656541471,LIIT 5AS,A00,507427,Carnelos; Chiara,20,0,20,0
1715656542498,LIIT 5BS,A00,507430,Carnelos; Chiara,20,0,20,0
1715656543527,LIIT 5CS,A00,507432,Carnelos; Chiara,20,0,20,0
1715656544553,LISP 5A,A00,507541,Munoz Sanchez; Alicia,11,0,20,9
1715656545681,LISP 5B,A00,507671,Munoz Sanchez; Alicia,8,0,20,12
1715656546707,LISP 5C,A00,507696,Munoz Sanchez; Alicia,8,0,20,12
1715656547733,MAE 197,001,528363,Boechler; Nicholas Sebastia,9998,0,9999,1
1715656548761,MATH 197,001,523477,Kedlaya; Kiran S.,9994,0,9999,5
1715656548761,MATH 197,002,563811,Zhang; Danna,9994,0,9999,5
1715656548761,MATH 197,003,628552,Dumitriu; Ioana,9998,0,9999,1
1715656548761,MATH 197,004,660885,Floyd; Eric,9998,0,9999,1
1715656549787,MCWP 40R,A00,518780,Staff,1,0,20,19
1715656549787,MCWP 40R,B00,518781,Carter; Jennifer A,9,0,20,11
1715656549787,MCWP 40R,C00,518783,Smith; Haydee Marie,5,0,20,15
1715656550815,MCWP 50R,A00,518791,Redela; Pamela Morgan,0,1,20,20
1715656550815,MCWP 50R,B00,518792,Krone; Jarret,0,2,20,20
1715656550815,MCWP 50R,C00,518793,Staff,0,4,20,20
1715656550815,MCWP 50R,D00,518794,Morshed; Michael James,0,2,20,20
1715656550815,MCWP 50R,E00,518795,Carter; Andrea L,0,2,20,20
1715656550815,MCWP 50R,F00,518796,Miller; Elizabeth Deen,0,1,20,20
1715656550815,MCWP 50R,G00,518797,Guillen; Melinda,0,1,20,20
1715656551841,MMW 12R,A01,514034,Herbst; Matthew,0,2,16,16
1715656551841,MMW 12R,A02,514035,Herbst; Matthew,0,0,16,16
1715656552867,MMW 13R,A01,514037,Staff,0,5,16,16
1715656552867,MMW 13R,A02,514039,Staff,0,5,16,16
1715656552867,MMW 13R,A03,628519,Staff,0,4,16,16
1715656554918,SIO 295LS,A00,523233,Staff,10,0,30,20
1715656555942,SIO 295S,A00,523232,Staff,10,0,30,20
1715656556968,SIOC 290S,A01,637330,Merrifield; Mark A,21,0,30,9
1715656557993,SIOC 291S,A01,637333,Gabriel; Corey John,21,0,30,9
1715656559019,SOCI 117,A01,494376,Staff,0,5,5,5
1715656560047,WES 237B,A00,494380,Staff,10,0,20,10
1715656562121,AESE 279B,A00,494370,Wade; Jon P,0,0,33,33
1715656563146,AIP 97,001,660915,Van Den Einde; Yael Dahlia,9998,0,9999,1
1715656564176,AIP 197,001,627712,Vespa; Emanuel Ignacio,9995,0,9999,4
1715656564176,AIP 197,002,650778,Amir; On,9998,0,9999,1
1715656564176,AIP 197,003,650933,Avenancio-Leon; Carlos,9998,0,9999,1
1715656564176,AIP 197,004,658530,Heyman; Gail D.,9998,0,9999,1
1715656564176,AIP 197,005,658631,Neal; Sonya E,9998,0,9999,1
1715656564176,AIP 197,006,658671,Du; Songzi,9998,0,9999,1
1715656565203,ANAR 135S,A00,494369,Braswell; Geoffrey E.,0,0,0,0
1715656566229,BENG 196,001,628496,Engler; Adam J.,9998,0,9999,1
1715656566229,BENG 196,002,660916,Watson; John Thomas,9998,0,9999,1
1715656567256,BISP 197,001,650773,Wilhelm; James E.,9994,0,9999,5
1715656567256,BISP 197,002,658904,Coleman; Aaron B.,9998,0,9999,1
1715656568280,CAT 124RS,A01,519847,Geibel; William,0,0,20,20
1715656569305,CAT 125RS,A01,515971,Geibel; William,0,0,20,20
1715656570332,CLRE 250,A00,511389,Morris; Sheldon,9992,0,9999,7
1715656571363,CLRE 251,A00,507176,Mehta; Ravindra L.,9992,0,9999,7
1715656571363,CLRE 251,B00,511410,Mehta; Ravindra L.,9998,0,9999,1
1715656572388,CLRE 252,A00,507189,Cuomo; Raphael Eduardo,9994,0,9999,5
1715656573417,CLRE 253,A00,507199,Vaida; Florin,9994,0,9999,5
1715656573417,CLRE 253,B00,507202,Vaida; Florin,9999,0,9999,0
1715656574441,CLRE 259,A00,507211,Patel; Hemal,9996,0,9999,3
1715656575469,CLRE 260,A00,507221,Cuomo; Raphael Eduardo,9999,0,9999,0
1715656576496,CLRE 297,001,507242,Cuomo; Raphael Eduardo,9999,0,9999,0
1715656577522,COGS 197,001,638244,Voytek; Bradley Thomas,9997,0,9999,2
1715656578547,CSE 191,A00,516875,Minnes Kemp; Mor Mia,9991,0,9999,8
1715656579573,CSE 197,001,637388,Minnes Kemp; Mor Mia,9992,0,9999,7
1715656580600,CSS 201S,A01,494383,Mignozzetti; Umberto,35,0,35,0
1715656581625,CSS 202S,A01,494387,Mignozzetti; Umberto,35,0,35,0
1715656582651,DSC 197,001,628532,Eldridge; Justin Matthew,9995,0,9999,4
1715656583675,EAP 100,A00,516065,Staff,9799,0,9999,200
1715656584704,ECE 45,A01,507414,Staff,32,0,60,28
1715656586753,ECE 111,A01,507420,Staff,11,0,50,39
1715656587779,ECE 197,001,548057,Sievenpiper; Daniel F.,9991,0,9999,8
1715656588805,EDS 115,A00,507243,Choi; Bailey Miyeon,6,0,28,22
1715656589835,EDS 117,A01,494379,Staff,0,6,34,35
1715656590864,EDS 125,A00,507246,Hopkins; Megan Beth,7,0,30,23
1715656591889,EDS 128A,A01,507264,Fargason; Sharon Gayle,5,0,26,21
1715656592916,EDS 128B,A01,507293,Pappas; Elizabeth,9,0,30,21
1715656593942,EDS 139,A00,507294,Fargason; Sharon Gayle,9,0,30,21
1715656593942,EDS 139,B00,507313,Pappas; Elizabeth,9,0,30,21
1715656594968,EDS 201,A00,507315,Staff,10,0,30,20
1715656595997,EDS 203,A01,507317,Halter; Christopher P.,10,0,30,20
1715656597023,EDS 204R,A01,507319,Halter; Christopher P.,0,3,30,30
1715656597023,EDS 204R,B01,507331,Heinzman; Erica M.,14,0,30,16
1715656598046,EDS 206R,A00,507332,Staff,0,4,30,30
1715656598046,EDS 206R,B00,507343,Staff,15,0,30,15
1715656599072,EDS 250,A00,507344,Hemans; Patricia Ann Benitez,20,0,40,20
1715656600098,EDS 281,A00,507345,Daly; Alan J.,18,0,18,0
1715656601124,EDS 284,A00,507350,Daly; Alan J.,16,0,16,0
1715656602153,EDS 286,A00,507359,Fine; Sarah,18,0,18,0
1715656603179,EDS 289C,A01,507361,Daly; Alan J.,18,0,18,0
1715656604206,EDS 290,A00,507366,Hofstetter; Carolyn,15,0,15,0
1715656605231,LIGM 5A,A00,507421,Fischer-Grunski; Eva K,17,0,20,3
1715656606262,LIGM 5B,A00,507423,Fischer-Grunski; Eva K,19,0,20,1
1715656607287,LIGM 5C,A00,507425,Fischer-Grunski; Eva K,19,0,20,1
1715656608317,LIIT 5AS,A00,507427,Carnelos; Chiara,20,0,20,0
1715656609342,LIIT 5BS,A00,507430,Carnelos; Chiara,20,0,20,0
1715656610372,LIIT 5CS,A00,507432,Carnelos; Chiara,20,0,20,0
1715656611398,LISP 5A,A00,507541,Munoz Sanchez; Alicia,11,0,20,9
1715656612424,LISP 5B,A00,507671,Munoz Sanchez; Alicia,8,0,20,12
1715656613453,LISP 5C,A00,507696,Munoz Sanchez; Alicia,8,0,20,12
1715656614479,MAE 197,001,528363,Boechler; Nicholas Sebastia,9998,0,9999,1
1715656615508,MATH 197,001,523477,Kedlaya; Kiran S.,9994,0,9999,5
1715656615508,MATH 197,002,563811,Zhang; Danna,9994,0,9999,5
1715656615508,MATH 197,003,628552,Dumitriu; Ioana,9998,0,9999,1
1715656615508,MATH 197,004,660885,Floyd; Eric,9998,0,9999,1
1715656616538,MCWP 40R,A00,518780,Staff,1,0,20,19
1715656616538,MCWP 40R,B00,518781,Carter; Jennifer A,9,0,20,11
1715656616538,MCWP 40R,C00,518783,Smith; Haydee Marie,5,0,20,15
1715656617565,MCWP 50R,A00,518791,Redela; Pamela Morgan,0,1,20,20
1715656617565,MCWP 50R,B00,518792,Krone; Jarret,0,2,20,20
1715656617565,MCWP 50R,C00,518793,Staff,0,4,20,20
1715656617565,MCWP 50R,D00,518794,Morshed; Michael James,0,2,20,20
1715656617565,MCWP 50R,E00,518795,Carter; Andrea L,0,2,20,20
1715656617565,MCWP 50R,F00,518796,Miller; Elizabeth Deen,0,1,20,20
1715656617565,MCWP 50R,G00,518797,Guillen; Melinda,0,1,20,20
1715656618591,MMW 12R,A01,514034,Herbst; Matthew,0,2,16,16
1715656618591,MMW 12R,A02,514035,Herbst; Matthew,0,0,16,16
1715656619618,MMW 13R,A01,514037,Staff,0,5,16,16
1715656619618,MMW 13R,A02,514039,Staff,0,5,16,16
1715656619618,MMW 13R,A03,628519,Staff,0,4,16,16
1715656621668,SIO 295LS,A00,523233,Staff,10,0,30,20
1715656622694,SIO 295S,A00,523232,Staff,10,0,30,20
1715656623718,SIOC 290S,A01,637330,Merrifield; Mark A,21,0,30,9
1715656624742,SIOC 291S,A01,637333,Gabriel; Corey John,21,0,30,9
1715656625768,SOCI 117,A01,494376,Staff,0,5,5,5
1715656626796,WES 237B,A00,494380,Staff,10,0,20,10
1715656628870,AESE 279B,A00,494370,Wade; Jon P,0,0,33,33
1715656629897,AIP 97,001,660915,Van Den Einde; Yael Dahlia,9998,0,9999,1
1715656630927,AIP 197,001,627712,Vespa; Emanuel Ignacio,9995,0,9999,4
1715656630927,AIP 197,002,650778,Amir; On,9998,0,9999,1
1715656630927,AIP 197,003,650933,Avenancio-Leon; Carlos,9998,0,9999,1
1715656630927,AIP 197,004,658530,Heyman; Gail D.,9998,0,9999,1
1715656630927,AIP 197,005,658631,Neal; Sonya E,9998,0,9999,1
1715656630927,AIP 197,006,658671,Du; Songzi,9998,0,9999,1
1715656631952,ANAR 135S,A00,494369,Braswell; Geoffrey E.,0,0,0,0
1715656632977,BENG 196,001,628496,Engler; Adam J.,9998,0,9999,1
1715656632977,BENG 196,002,660916,Watson; John Thomas,9998,0,9999,1
1715656634002,BISP 197,001,650773,Wilhelm; James E.,9994,0,9999,5
1715656634002,BISP 197,002,658904,Coleman; Aaron B.,9998,0,9999,1
1715656635028,CAT 124RS,A01,519847,Geibel; William,0,0,20,20
1715656636052,CAT 125RS,A01,515971,Geibel; William,0,0,20,20
1715656637082,CLRE 250,A00,511389,Morris; Sheldon,9992,0,9999,7
1715656638109,CLRE 251,A00,507176,Mehta; Ravindra L.,9992,0,9999,7
1715656638109,CLRE 251,B00,511410,Mehta; Ravindra L.,9998,0,9999,1
1715656639138,CLRE 252,A00,507189,Cuomo; Raphael Eduardo,9994,0,9999,5
1715656640164,CLRE 253,A00,507199,Vaida; Florin,9994,0,9999,5
1715656640164,CLRE 253,B00,507202,Vaida; Florin,9999,0,9999,0
1715656641190,CLRE 259,A00,507211,Patel; Hemal,9996,0,9999,3
1715656642216,CLRE 260,A00,507221,Cuomo; Raphael Eduardo,9999,0,9999,0
1715656643241,CLRE 297,001,507242,Cuomo; Raphael Eduardo,9999,0,9999,0
1715656644268,COGS 197,001,638244,Voytek; Bradley Thomas,9997,0,9999,2
1715656645295,CSE 191,A00,516875,Minnes Kemp; Mor Mia,9991,0,9999,8
1715656646321,CSE 197,001,637388,Minnes Kemp; Mor Mia,9992,0,9999,7
1715656647346,CSS 201S,A01,494383,Mignozzetti; Umberto,35,0,35,0
1715656648371,CSS 202S,A01,494387,Mignozzetti; Umberto,35,0,35,0
1715656649399,DSC 197,001,628532,Eldridge; Justin Matthew,9995,0,9999,4
1715656650425,EAP 100,A00,516065,Staff,9799,0,9999,200
1715656651452,ECE 45,A01,507414,Staff,32,0,60,28
1715656653503,ECE 111,A01,507420,Staff,11,0,50,39
1715656654528,ECE 197,001,548057,Sievenpiper; Daniel F.,9991,0,9999,8
1715656655555,EDS 115,A00,507243,Choi; Bailey Miyeon,6,0,28,22
1715656656580,EDS 117,A01,494379,Staff,0,6,34,35
1715656657605,EDS 125,A00,507246,Hopkins; Megan Beth,7,0,30,23
1715656658630,EDS 128A,A01,507264,Fargason; Sharon Gayle,5,0,26,21
1715656659656,EDS 128B,A01,507293,Pappas; Elizabeth,9,0,30,21
1715656660684,EDS 139,A00,507294,Fargason; Sharon Gayle,9,0,30,21
1715656660684,EDS 139,B00,507313,Pappas; Elizabeth,9,0,30,21
1715656661712,EDS 201,A00,507315,Staff,10,0,30,20
1715656662738,EDS 203,A01,507317,Halter; Christopher P.,10,0,30,20
1715656663763,EDS 204R,A01,507319,Halter; Christopher P.,0,3,30,30
1715656663763,EDS 204R,B01,507331,Heinzman; Erica M.,14,0,30,16
1715656664791,EDS 206R,A00,507332,Staff,0,4,30,30
1715656664791,EDS 206R,B00,507343,Staff,15,0,30,15
1715656665817,EDS 250,A00,507344,Hemans; Patricia Ann Benitez,20,0,40,20
1715656666841,EDS 281,A00,507345,Daly; Alan J.,18,0,18,0
1715656667864,EDS 284,A00,507350,Daly; Alan J.,16,0,16,0
1715656668895,EDS 286,A00,507359,Fine; Sarah,18,0,18,0
1715656669919,EDS 289C,A01,507361,Daly; Alan J.,18,0,18,0
1715656670945,EDS 290,A00,507366,Hofstetter; Carolyn,15,0,15,0
1715656671972,LIGM 5A,A00,507421,Fischer-Grunski; Eva K,17,0,20,3
1715656672997,LIGM 5B,A00,507423,Fischer-Grunski; Eva K,19,0,20,1
1715656674025,LIGM 5C,A00,507425,Fischer-Grunski; Eva K,19,0,20,1
1715656675052,LIIT 5AS,A00,507427,Carnelos; Chiara,20,0,20,0
1715656676080,LIIT 5BS,A00,507430,Carnelos; Chiara,20,0,20,0
1715656677104,LIIT 5CS,A00,507432,Carnelos; Chiara,20,0,20,0
1715656678129,LISP 5A,A00,507541,Munoz Sanchez; Alicia,11,0,20,9
1715656679157,LISP 5B,A00,507671,Munoz Sanchez; Alicia,8,0,20,12
1715656680181,LISP 5C,A00,507696,Munoz Sanchez; Alicia,7,0,20,13
1715656681208,MAE 197,001,528363,Boechler; Nicholas Sebastia,9998,0,9999,1
1715656682238,MATH 197,001,523477,Kedlaya; Kiran S.,9994,0,9999,5
1715656682238,MATH 197,002,563811,Zhang; Danna,9994,0,9999,5
1715656682238,MATH 197,003,628552,Dumitriu; Ioana,9998,0,9999,1
1715656682238,MATH 197,004,660885,Floyd; Eric,9998,0,9999,1
1715656683268,MCWP 40R,A00,518780,Staff,1,0,20,19
1715656683268,MCWP 40R,B00,518781,Carter; Jennifer A,9,0,20,11
1715656683268,MCWP 40R,C00,518783,Smith; Haydee Marie,5,0,20,15
1715656684301,MCWP 50R,A00,518791,Redela; Pamela Morgan,0,1,20,20
1715656684301,MCWP 50R,B00,518792,Krone; Jarret,0,2,20,20
1715656684301,MCWP 50R,C00,518793,Staff,0,4,20,20
1715656684301,MCWP 50R,D00,518794,Morshed; Michael James,0,2,20,20
1715656684301,MCWP 50R,E00,518795,Carter; Andrea L,0,2,20,20
1715656684301,MCWP 50R,F00,518796,Miller; Elizabeth Deen,0,1,20,20
1715656684301,MCWP 50R,G00,518797,Guillen; Melinda,0,1,20,20
1715656685327,MMW 12R,A01,514034,Herbst; Matthew,0,2,16,16
1715656685327,MMW 12R,A02,514035,Herbst; Matthew,0,0,16,16
1715656686352,MMW 13R,A01,514037,Staff,0,5,16,16
1715656686352,MMW 13R,A02,514039,Staff,0,5,16,16
1715656686352,MMW 13R,A03,628519,Staff,0,4,16,16
1715656688402,SIO 295LS,A00,523233,Staff,10,0,30,20
1715656689426,SIO 295S,A00,523232,Staff,10,0,30,20
1715656690451,SIOC 290S,A01,637330,Merrifield; Mark A,21,0,30,9
1715656691483,SIOC 291S,A01,637333,Gabriel; Corey John,21,0,30,9
1715656692510,SOCI 117,A01,494376,Staff,0,5,5,5
1715656693536,WES 237B,A00,494380,Staff,10,0,20,10
1715656695607,AESE 279B,A00,494370,Wade; Jon P,0,0,33,33
1715656696631,AIP 97,001,660915,Van Den Einde; Yael Dahlia,9998,0,9999,1
1715656697659,AIP 197,001,627712,Vespa; Emanuel Ignacio,9995,0,9999,4
1715656697659,AIP 197,002,650778,Amir; On,9998,0,9999,1
1715656697659,AIP 197,003,650933,Avenancio-Leon; Carlos,9998,0,9999,1
1715656697659,AIP 197,004,658530,Heyman; Gail D.,9998,0,9999,1
1715656697659,AIP 197,005,658631,Neal; Sonya E,9998,0,9999,1
1715656697659,AIP 197,006,658671,Du; Songzi,9998,0,9999,1
1715656698688,ANAR 135S,A00,494369,Braswell; Geoffrey E.,0,0,0,0
1715656699719,BENG 196,001,628496,Engler; Adam J.,9998,0,9999,1
1715656699719,BENG 196,002,660916,Watson; John Thomas,9998,0,9999,1
1715656700745,BISP 197,001,650773,Wilhelm; James E.,9994,0,9999,5
1715656700745,BISP 197,002,658904,Coleman; Aaron B.,9998,0,9999,1
1715656701773,CAT 124RS,A01,519847,Geibel; William,0,0,20,20
1715656702797,CAT 125RS,A01,515971,Geibel; William,0,0,20,20
1715656703822,CLRE 250,A00,511389,Morris; Sheldon,9992,0,9999,7
1715656704848,CLRE 251,A00,507176,Mehta; Ravindra L.,9992,0,9999,7
1715656704848,CLRE 251,B00,511410,Mehta; Ravindra L.,9998,0,9999,1
1715656705872,CLRE 252,A00,507189,Cuomo; Raphael Eduardo,9994,0,9999,5
1715656706901,CLRE 253,A00,507199,Vaida; Florin,9994,0,9999,5
1715656706901,CLRE 253,B00,507202,Vaida; Florin,9999,0,9999,0
1715656707928,CLRE 259,A00,507211,Patel; Hemal,9996,0,9999,3
1715656708955,CLRE 260,A00,507221,Cuomo; Raphael Eduardo,9999,0,9999,0
1715656709982,CLRE 297,001,507242,Cuomo; Raphael Eduardo,9999,0,9999,0
1715656711013,COGS 197,001,638244,Voytek; Bradley Thomas,9997,0,9999,2
1715656712041,CSE 191,A00,516875,Minnes Kemp; Mor Mia,9991,0,9999,8
1715656713065,CSE 197,001,637388,Minnes Kemp; Mor Mia,9992,0,9999,7
1715656714092,CSS 201S,A01,494383,Mignozzetti; Umberto,35,0,35,0
1715656715116,CSS 202S,A01,494387,Mignozzetti; Umberto,35,0,35,0
1715656716142,DSC 197,001,628532,Eldridge; Justin Matthew,9995,0,9999,4
1715656717170,EAP 100,A00,516065,Staff,9799,0,9999,200
1715656718197,ECE 45,A01,507414,Staff,32,0,60,28
1715656720252,ECE 111,A01,507420,Staff,11,0,50,39
1715656721276,ECE 197,001,548057,Sievenpiper; Daniel F.,9991,0,9999,8
1715656722308,EDS 115,A00,507243,Choi; Bailey Miyeon,6,0,28,22
1715656723335,EDS 117,A01,494379,Staff,0,6,34,35
1715656724364,EDS 125,A00,507246,Hopkins; Megan Beth,7,0,30,23
1715656725393,EDS 128A,A01,507264,Fargason; Sharon Gayle,5,0,26,21
1715656726418,EDS 128B,A01,507293,Pappas; Elizabeth,9,0,30,21
1715656727446,EDS 139,A00,507294,Fargason; Sharon Gayle,9,0,30,21
1715656727446,EDS 139,B00,507313,Pappas; Elizabeth,9,0,30,21
1715656728471,EDS 201,A00,507315,Staff,10,0,30,20
1715656729496,EDS 203,A01,507317,Halter; Christopher P.,10,0,30,20
1715656730521,EDS 204R,A01,507319,Halter; Christopher P.,0,3,30,30
1715656730521,EDS 204R,B01,507331,Heinzman; Erica M.,14,0,30,16
1715656731547,EDS 206R,A00,507332,Staff,0,4,30,30
1715656731547,EDS 206R,B00,507343,Staff,15,0,30,15
1715656732572,EDS 250,A00,507344,Hemans; Patricia Ann Benitez,20,0,40,20
1715656733598,EDS 281,A00,507345,Daly; Alan J.,18,0,18,0
1715656734625,EDS 284,A00,507350,Daly; Alan J.,16,0,16,0
1715656735653,EDS 286,A00,507359,Fine; Sarah,18,0,18,0
1715656736682,EDS 289C,A01,507361,Daly; Alan J.,18,0,18,0
1715656737712,EDS 290,A00,507366,Hofstetter; Carolyn,15,0,15,0
1715656738741,LIGM 5A,A00,507421,Fischer-Grunski; Eva K,17,0,20,3
1715656739768,LIGM 5B,A00,507423,Fischer-Grunski; Eva K,19,0,20,1
1715656740795,LIGM 5C,A00,507425,Fischer-Grunski; Eva K,19,0,20,1
1715656741823,LIIT 5AS,A00,507427,Carnelos; Chiara,20,0,20,0
1715656742852,LIIT 5BS,A00,507430,Carnelos; Chiara,20,0,20,0
1715656743879,LIIT 5CS,A00,507432,Carnelos; Chiara,20,0,20,0
1715656744905,LISP 5A,A00,507541,Munoz Sanchez; Alicia,11,0,20,9
1715656745934,LISP 5B,A00,507671,Munoz Sanchez; Alicia,8,0,20,12
1715656746962,LISP 5C,A00,507696,Munoz Sanchez; Alicia,7,0,20,13
1715656747990,MAE 197,001,528363,Boechler; Nicholas Sebastia,9998,0,9999,1
1715656749017,MATH 197,001,523477,Kedlaya; Kiran S.,9994,0,9999,5
1715656749017,MATH 197,002,563811,Zhang; Danna,9994,0,9999,5
1715656749017,MATH 197,003,628552,Dumitriu; Ioana,9998,0,9999,1
1715656749017,MATH 197,004,660885,Floyd; Eric,9998,0,9999,1
1715656750047,MCWP 40R,A00,518780,Staff,1,0,20,19
1715656750047,MCWP 40R,B00,518781,Carter; Jennifer A,9,0,20,11
1715656750047,MCWP 40R,C00,518783,Smith; Haydee Marie,5,0,20,15
1715656751080,MCWP 50R,A00,518791,Redela; Pamela Morgan,0,1,20,20
1715656751080,MCWP 50R,B00,518792,Krone; Jarret,0,2,20,20
1715656751080,MCWP 50R,C00,518793,Staff,0,4,20,20
1715656751080,MCWP 50R,D00,518794,Morshed; Michael James,0,2,20,20
1715656751080,MCWP 50R,E00,518795,Carter; Andrea L,0,2,20,20
1715656751080,MCWP 50R,F00,518796,Miller; Elizabeth Deen,0,1,20,20
1715656751080,MCWP 50R,G00,518797,Guillen; Melinda,0,1,20,20
1715656752108,MMW 12R,A01,514034,Herbst; Matthew,0,2,16,16
1715656752108,MMW 12R,A02,514035,Herbst; Matthew,0,0,16,16
1715656753136,MMW 13R,A01,514037,Staff,0,5,16,16
1715656753136,MMW 13R,A02,514039,Staff,0,5,16,16
1715656753136,MMW 13R,A03,628519,Staff,0,4,16,16
1715656755186,SIO 295LS,A00,523233,Staff,10,0,30,20
1715656756210,SIO 295S,A00,523232,Staff,10,0,30,20
1715656757239,SIOC 290S,A01,637330,Merrifield; Mark A,21,0,30,9
1715656758277,SIOC 291S,A01,637333,Gabriel; Corey John,21,0,30,9
1715656759307,SOCI 117,A01,494376,Staff,0,5,5,5
1715656760334,WES 237B,A00,494380,Staff,10,0,20,10
1715656762409,AESE 279B,A00,494370,Wade; Jon P,0,0,33,33
1715656763434,AIP 97,001,660915,Van Den Einde; Yael Dahlia,9998,0,9999,1
1715656764463,AIP 197,001,627712,Vespa; Emanuel Ignacio,9995,0,9999,4
1715656764463,AIP 197,002,650778,Amir; On,9998,0,9999,1
1715656764463,AIP 197,003,650933,Avenancio-Leon; Carlos,9998,0,9999,1
1715656764463,AIP 197,004,658530,Heyman; Gail D.,9998,0,9999,1
1715656764463,AIP 197,005,658631,Neal; Sonya E,9998,0,9999,1
1715656764463,AIP 197,006,658671,Du; Songzi,9998,0,9999,1
1715656765490,ANAR 135S,A00,494369,Braswell; Geoffrey E.,0,0,0,0
1715656766515,BENG 196,001,628496,Engler; Adam J.,9998,0,9999,1
1715656766515,BENG 196,002,660916,Watson; John Thomas,9998,0,9999,1
1715656767543,BISP 197,001,650773,Wilhelm; James E.,9994,0,9999,5
1715656767543,BISP 197,002,658904,Coleman; Aaron B.,9998,0,9999,1
1715656768569,CAT 124RS,A01,519847,Geibel; William,0,0,20,20
1715656769596,CAT 125RS,A01,515971,Geibel; William,0,0,20,20
1715656770623,CLRE 250,A00,511389,Morris; Sheldon,9992,0,9999,7
1715656771649,CLRE 251,A00,507176,Mehta; Ravindra L.,9992,0,9999,7
1715656771649,CLRE 251,B00,511410,Mehta; Ravindra L.,9998,0,9999,1
1715656772675,CLRE 252,A00,507189,Cuomo; Raphael Eduardo,9994,0,9999,5
1715656773702,CLRE 253,A00,507199,Vaida; Florin,9994,0,9999,5
1715656773702,CLRE 253,B00,507202,Vaida; Florin,9999,0,9999,0
1715656774727,CLRE 259,A00,507211,Patel; Hemal,9996,0,9999,3
1715656775751,CLRE 260,A00,507221,Cuomo; Raphael Eduardo,9999,0,9999,0
1715656776775,CLRE 297,001,507242,Cuomo; Raphael Eduardo,9999,0,9999,0
1715656777802,COGS 197,001,638244,Voytek; Bradley Thomas,9997,0,9999,2
1715656778829,CSE 191,A00,516875,Minnes Kemp; Mor Mia,9991,0,9999,8
1715656779854,CSE 197,001,637388,Minnes Kemp; Mor Mia,9992,0,9999,7
1715656780879,CSS 201S,A01,494383,Mignozzetti; Umberto,35,0,35,0
1715656781908,CSS 202S,A01,494387,Mignozzetti; Umberto,35,0,35,0
1715656782939,DSC 197,001,628532,Eldridge; Justin Matthew,9995,0,9999,4
1715656783962,EAP 100,A00,516065,Staff,9799,0,9999,200
1715656784990,ECE 45,A01,507414,Staff,32,0,60,28
1715656787038,ECE 111,A01,507420,Staff,11,0,50,39
1715656788063,ECE 197,001,548057,Sievenpiper; Daniel F.,9991,0,9999,8
1715656789090,EDS 115,A00,507243,Choi; Bailey Miyeon,6,0,28,22
1715656790115,EDS 117,A01,494379,Staff,0,6,34,35
1715656791141,EDS 125,A00,507246,Hopkins; Megan Beth,7,0,30,23
1715656792169,EDS 128A,A01,507264,Fargason; Sharon Gayle,5,0,26,21
1715656793194,EDS 128B,A01,507293,Pappas; Elizabeth,9,0,30,21
1715656794225,EDS 139,A00,507294,Fargason; Sharon Gayle,9,0,30,21
1715656794225,EDS 139,B00,507313,Pappas; Elizabeth,9,0,30,21
1715656795249,EDS 201,A00,507315,Staff,10,0,30,20
1715656796277,EDS 203,A01,507317,Halter; Christopher P.,10,0,30,20
1715656797301,EDS 204R,A01,507319,Halter; Christopher P.,0,3,30,30
1715656797301,EDS 204R,B01,507331,Heinzman; Erica M.,14,0,30,16
1715656798324,EDS 206R,A00,507332,Staff,0,4,30,30
1715656798324,EDS 206R,B00,507343,Staff,15,0,30,15
1715656799353,EDS 250,A00,507344,Hemans; Patricia Ann Benitez,20,0,40,20
1715656800378,EDS 281,A00,507345,Daly; Alan J.,18,0,18,0
1715656801406,EDS 284,A00,507350,Daly; Alan J.,16,0,16,0
1715656802434,EDS 286,A00,507359,Fine; Sarah,18,0,18,0
1715656803457,EDS 289C,A01,507361,Daly; Alan J.,18,0,18,0
1715656804484,EDS 290,A00,507366,Hofstetter; Carolyn,15,0,15,0
1715656805512,LIGM 5A,A00,507421,Fischer-Grunski; Eva K,17,0,20,3
1715656806536,LIGM 5B,A00,507423,Fischer-Grunski; Eva K,19,0,20,1
1715656807566,LIGM 5C,A00,507425,Fischer-Grunski; Eva K,19,0,20,1
1715656808590,LIIT 5AS,A00,507427,Carnelos; Chiara,20,0,20,0
1715656809615,LIIT 5BS,A00,507430,Carnelos; Chiara,20,0,20,0
1715656810639,LIIT 5CS,A00,507432,Carnelos; Chiara,20,0,20,0
1715656811669,LISP 5A,A00,507541,Munoz Sanchez; Alicia,11,0,20,9
1715656812694,LISP 5B,A00,507671,Munoz Sanchez; Alicia,8,0,20,12
1715656813723,LISP 5C,A00,507696,Munoz Sanchez; Alicia,7,0,20,13
1715656814753,MAE 197,001,528363,Boechler; Nicholas Sebastia,9998,0,9999,1
1715656815784,MATH 197,001,523477,Kedlaya; Kiran S.,9994,0,9999,5
1715656815784,MATH 197,002,563811,Zhang; Danna,9994,0,9999,5
1715656815784,MATH 197,003,628552,Dumitriu; Ioana,9998,0,9999,1
1715656815784,MATH 197,004,660885,Floyd; Eric,9998,0,9999,1
1715656816816,MCWP 40R,A00,518780,Staff,1,0,20,19
1715656816816,MCWP 40R,B00,518781,Carter; Jennifer A,9,0,20,11
1715656816816,MCWP 40R,C00,518783,Smith; Haydee Marie,5,0,20,15
1715656817843,MCWP 50R,A00,518791,Redela; Pamela Morgan,0,1,20,20
1715656817843,MCWP 50R,B00,518792,Krone; Jarret,0,2,20,20
1715656817843,MCWP 50R,C00,518793,Staff,0,4,20,20
1715656817843,MCWP 50R,D00,518794,Morshed; Michael James,0,2,20,20
1715656817843,MCWP 50R,E00,518795,Carter; Andrea L,0,2,20,20
1715656817843,MCWP 50R,F00,518796,Miller; Elizabeth Deen,0,1,20,20
1715656817843,MCWP 50R,G00,518797,Guillen; Melinda,0,1,20,20
1715656818873,MMW 12R,A01,514034,Herbst; Matthew,0,2,16,16
1715656818873,MMW 12R,A02,514035,Herbst; Matthew,0,0,16,16
1715656819898,MMW 13R,A01,514037,Staff,0,5,16,16
1715656819898,MMW 13R,A02,514039,Staff,0,5,16,16
1715656819898,MMW 13R,A03,628519,Staff,0,4,16,16
1715656821948,SIO 295LS,A00,523233,Staff,10,0,30,20
1715656822973,SIO 295S,A00,523232,Staff,10,0,30,20
1715656824000,SIOC 290S,A01,637330,Merrifield; Mark A,21,0,30,9
1715656825025,SIOC 291S,A01,637333,Gabriel; Corey John,21,0,30,9
1715656826050,SOCI 117,A01,494376,Staff,0,5,5,5
1715656827077,WES 237B,A00,494380,Staff,10,0,20,10
1715656829155,AESE 279B,A00,494370,Wade; Jon P,0,0,33,33
1715656830181,AIP 97,001,660915,Van Den Einde; Yael Dahlia,9998,0,9999,1
1715656831212,AIP 197,001,627712,Vespa; Emanuel Ignacio,9995,0,9999,4
1715656831212,AIP 197,002,650778,Amir; On,9998,0,9999,1
1715656831212,AIP 197,003,650933,Avenancio-Leon; Carlos,9998,0,9999,1
1715656831212,AIP 197,004,658530,Heyman; Gail D.,9998,0,9999,1
1715656831212,AIP 197,005,658631,Neal; Sonya E,9998,0,9999,1
1715656831212,AIP 197,006,658671,Du; Songzi,9998,0,9999,1
1715656832237,ANAR 135S,A00,494369,Braswell; Geoffrey E.,0,0,0,0
1715656833266,BENG 196,001,628496,Engler; Adam J.,9998,0,9999,1
1715656833266,BENG 196,002,660916,Watson; John Thomas,9998,0,9999,1
1715656834290,BISP 197,001,650773,Wilhelm; James E.,9994,0,9999,5
1715656834290,BISP 197,002,658904,Coleman; Aaron B.,9998,0,9999,1
1715656835320,CAT 124RS,A01,519847,Geibel; William,0,0,20,20
1715656836344,CAT 125RS,A01,515971,Geibel; William,0,0,20,20
1715656837373,CLRE 250,A00,511389,Morris; Sheldon,9992,0,9999,7
1715656838398,CLRE 251,A00,507176,Mehta; Ravindra L.,9992,0,9999,7
1715656838398,CLRE 251,B00,511410,Mehta; Ravindra L.,9998,0,9999,1
1715656839424,CLRE 252,A00,507189,Cuomo; Raphael Eduardo,9994,0,9999,5
1715656840448,CLRE 253,A00,507199,Vaida; Florin,9994,0,9999,5
1715656840448,CLRE 253,B00,507202,Vaida; Florin,9999,0,9999,0
1715656841479,CLRE 259,A00,507211,Patel; Hemal,9996,0,9999,3
1715656842504,CLRE 260,A00,507221,Cuomo; Raphael Eduardo,9999,0,9999,0
1715656843550,CLRE 297,001,507242,Cuomo; Raphael Eduardo,9999,0,9999,0
1715656844578,COGS 197,001,638244,Voytek; Bradley Thomas,9997,0,9999,2
1715656845605,CSE 191,A00,516875,Minnes Kemp; Mor Mia,9991,0,9999,8
1715656846629,CSE 197,001,637388,Minnes Kemp; Mor Mia,9992,0,9999,7
1715656847655,CSS 201S,A01,494383,Mignozzetti; Umberto,35,0,35,0
1715656848683,CSS 202S,A01,494387,Mignozzetti; Umberto,35,0,35,0
1715656849709,DSC 197,001,628532,Eldridge; Justin Matthew,9995,0,9999,4
1715656850734,EAP 100,A00,516065,Staff,9799,0,9999,200
1715656851761,ECE 45,A01,507414,Staff,32,0,60,28
1715656853813,ECE 111,A01,507420,Staff,11,0,50,39
1715656854839,ECE 197,001,548057,Sievenpiper; Daniel F.,9991,0,9999,8
1715656855867,EDS 115,A00,507243,Choi; Bailey Miyeon,6,0,28,22
1715656856893,EDS 117,A01,494379,Staff,0,6,34,35
1715656857918,EDS 125,A00,507246,Hopkins; Megan Beth,7,0,30,23
1715656858947,EDS 128A,A01,507264,Fargason; Sharon Gayle,5,0,26,21
1715656859974,EDS 128B,A01,507293,Pappas; Elizabeth,9,0,30,21
1715656861001,EDS 139,A00,507294,Fargason; Sharon Gayle,9,0,30,21
1715656861001,EDS 139,B00,507313,Pappas; Elizabeth,9,0,30,21
1715656862026,EDS 201,A00,507315,Staff,10,0,30,20
1715656863052,EDS 203,A01,507317,Halter; Christopher P.,10,0,30,20
1715656864081,EDS 204R,A01,507319,Halter; Christopher P.,0,3,30,30
1715656864081,EDS 204R,B01,507331,Heinzman; Erica M.,14,0,30,16
1715656865107,EDS 206R,A00,507332,Staff,0,4,30,30
1715656865107,EDS 206R,B00,507343,Staff,15,0,30,15
1715656866134,EDS 250,A00,507344,Hemans; Patricia Ann Benitez,20,0,40,20
1715656867164,EDS 281,A00,507345,Daly; Alan J.,18,0,18,0
1715656868191,EDS 284,A00,507350,Daly; Alan J.,16,0,16,0
1715656869219,EDS 286,A00,507359,Fine; Sarah,18,0,18,0
1715656870246,EDS 289C,A01,507361,Daly; Alan J.,18,0,18,0
1715656871274,EDS 290,A00,507366,Hofstetter; Carolyn,15,0,15,0
1715656872304,LIGM 5A,A00,507421,Fischer-Grunski; Eva K,17,0,20,3
1715656873330,LIGM 5B,A00,507423,Fischer-Grunski; Eva K,19,0,20,1
1715656874358,LIGM 5C,A00,507425,Fischer-Grunski; Eva K,19,0,20,1
1715656875383,LIIT 5AS,A00,507427,Carnelos; Chiara,20,0,20,0
1715656876411,LIIT 5BS,A00,507430,Carnelos; Chiara,20,0,20,0
1715656877437,LIIT 5CS,A00,507432,Carnelos; Chiara,20,0,20,0
1715656878467,LISP 5A,A00,507541,Munoz Sanchez; Alicia,11,0,20,9
1715656879491,LISP 5B,A00,507671,Munoz Sanchez; Alicia,8,0,20,12
1715656880516,LISP 5C,A00,507696,Munoz Sanchez; Alicia,7,0,20,13
1715656881541,MAE 197,001,528363,Boechler; Nicholas Sebastia,9998,0,9999,1
1715656882570,MATH 197,001,523477,Kedlaya; Kiran S.,9994,0,9999,5
1715656882570,MATH 197,002,563811,Zhang; Danna,9994,0,9999,5
1715656882570,MATH 197,003,628552,Dumitriu; Ioana,9998,0,9999,1
1715656882570,MATH 197,004,660885,Floyd; Eric,9998,0,9999,1
1715656883599,MCWP 40R,A00,518780,Staff,1,0,20,19
1715656883599,MCWP 40R,B00,518781,Carter; Jennifer A,9,0,20,11
1715656883599,MCWP 40R,C00,518783,Smith; Haydee Marie,5,0,20,15
1715656884634,MCWP 50R,A00,518791,Redela; Pamela Morgan,0,1,20,20
1715656884634,MCWP 50R,B00,518792,Krone; Jarret,0,2,20,20
1715656884634,MCWP 50R,C00,518793,Staff,0,4,20,20
1715656884634,MCWP 50R,D00,518794,Morshed; Michael James,0,2,20,20
1715656884634,MCWP 50R,E00,518795,Carter; Andrea L,0,2,20,20
1715656884634,MCWP 50R,F00,518796,Miller; Elizabeth Deen,0,1,20,20
1715656884634,MCWP 50R,G00,518797,Guillen; Melinda,0,1,20,20
1715656885660,MMW 12R,A01,514034,Herbst; Matthew,0,2,16,16
1715656885660,MMW 12R,A02,514035,Herbst; Matthew,0,0,16,16
1715656886688,MMW 13R,A01,514037,Staff,0,5,16,16
1715656886688,MMW 13R,A02,514039,Staff,0,5,16,16
1715656886688,MMW 13R,A03,628519,Staff,0,4,16,16
1715656888740,SIO 295LS,A00,523233,Staff,10,0,30,20
1715656889767,SIO 295S,A00,523232,Staff,10,0,30,20
1715656890795,SIOC 290S,A01,637330,Merrifield; Mark A,21,0,30,9
1715656891822,SIOC 291S,A01,637333,Gabriel; Corey John,21,0,30,9
1715656892849,SOCI 117,A01,494376,Staff,0,5,5,5
1715656893874,WES 237B,A00,494380,Staff,10,0,20,10
1715656895953,AESE 279B,A00,494370,Wade; Jon P,0,0,33,33
1715656896982,AIP 97,001,660915,Van Den Einde; Yael Dahlia,9998,0,9999,1
1715656898009,AIP 197,001,627712,Vespa; Emanuel Ignacio,9995,0,9999,4
1715656898009,AIP 197,002,650778,Amir; On,9998,0,9999,1
1715656898009,AIP 197,003,650933,Avenancio-Leon; Carlos,9998,0,9999,1
1715656898009,AIP 197,004,658530,Heyman; Gail D.,9998,0,9999,1
1715656898009,AIP 197,005,658631,Neal; Sonya E,9998,0,9999,1
1715656898009,AIP 197,006,658671,Du; Songzi,9998,0,9999,1
1715656899037,ANAR 135S,A00,494369,Braswell; Geoffrey E.,0,0,0,0
1715656900067,BENG 196,001,628496,Engler; Adam J.,9998,0,9999,1
1715656900067,BENG 196,002,660916,Watson; John Thomas,9998,0,9999,1
1715656901094,BISP 197,001,650773,Wilhelm; James E.,9994,0,9999,5
1715656901094,BISP 197,002,658904,Coleman; Aaron B.,9998,0,9999,1
1715656902121,CAT 124RS,A01,519847,Geibel; William,0,0,20,20
1715656903146,CAT 125RS,A01,515971,Geibel; William,0,0,20,20
1715656904174,CLRE 250,A00,511389,Morris; Sheldon,9992,0,9999,7
1715656905204,CLRE 251,A00,507176,Mehta; Ravindra L.,9992,0,9999,7
1715656905204,CLRE 251,B00,511410,Mehta; Ravindra L.,9998,0,9999,1
1715656906234,CLRE 252,A00,507189,Cuomo; Raphael Eduardo,9994,0,9999,5
1715656907263,CLRE 253,A00,507199,Vaida; Florin,9994,0,9999,5
1715656907263,CLRE 253,B00,507202,Vaida; Florin,9999,0,9999,0
1715656908290,CLRE 259,A00,507211,Patel; Hemal,9996,0,9999,3
1715656909318,CLRE 260,A00,507221,Cuomo; Raphael Eduardo,9999,0,9999,0
1715656910343,CLRE 297,001,507242,Cuomo; Raphael Eduardo,9999,0,9999,0
1715656911368,COGS 197,001,638244,Voytek; Bradley Thomas,9997,0,9999,2
1715656912394,CSE 191,A00,516875,Minnes Kemp; Mor Mia,9991,0,9999,8
1715656913427,CSE 197,001,637388,Minnes Kemp; Mor Mia,9992,0,9999,7
1715656914453,CSS 201S,A01,494383,Mignozzetti; Umberto,35,0,35,0
1715656915481,CSS 202S,A01,494387,Mignozzetti; Umberto,35,0,35,0
1715656916507,DSC 197,001,628532,Eldridge; Justin Matthew,9995,0,9999,4
1715656917534,EAP 100,A00,516065,Staff,9799,0,9999,200
1715656918584,ECE 45,A01,507414,Staff,32,0,60,28
1715656920633,ECE 111,A01,507420,Staff,11,0,50,39
1715656921658,ECE 197,001,548057,Sievenpiper; Daniel F.,9991,0,9999,8
1715656922689,EDS 115,A00,507243,Choi; Bailey Miyeon,6,0,28,22
1715656923718,EDS 117,A01,494379,Staff,0,6,34,35
1715656924748,EDS 125,A00,507246,Hopkins; Megan Beth,7,0,30,23
1715656925779,EDS 128A,A01,507264,Fargason; Sharon Gayle,5,0,26,21
1715656926804,EDS 128B,A01,507293,Pappas; Elizabeth,9,0,30,21
1715656927832,EDS 139,A00,507294,Fargason; Sharon Gayle,9,0,30,21
1715656927832,EDS 139,B00,507313,Pappas; Elizabeth,9,0,30,21
1715656928858,EDS 201,A00,507315,Staff,10,0,30,20
1715656929886,EDS 203,A01,507317,Halter; Christopher P.,10,0,30,20
1715656930913,EDS 204R,A01,507319,Halter; Christopher P.,0,3,30,30
1715656930913,EDS 204R,B01,507331,Heinzman; Erica M.,14,0,30,16
1715656931938,EDS 206R,A00,507332,Staff,0,4,30,30
1715656931938,EDS 206R,B00,507343,Staff,15,0,30,15
1715656932962,EDS 250,A00,507344,Hemans; Patricia Ann Benitez,20,0,40,20
1715656933987,EDS 281,A00,507345,Daly; Alan J.,18,0,18,0
1715656935013,EDS 284,A00,507350,Daly; Alan J.,16,0,16,0
1715656936039,EDS 286,A00,507359,Fine; Sarah,18,0,18,0
1715656937066,EDS 289C,A01,507361,Daly; Alan J.,18,0,18,0
1715656938091,EDS 290,A00,507366,Hofstetter; Carolyn,15,0,15,0
1715656939120,LIGM 5A,A00,507421,Fischer-Grunski; Eva K,17,0,20,3
1715656940149,LIGM 5B,A00,507423,Fischer-Grunski; Eva K,19,0,20,1
1715656941174,LIGM 5C,A00,507425,Fischer-Grunski; Eva K,19,0,20,1
1715656942203,LIIT 5AS,A00,507427,Carnelos; Chiara,20,0,20,0
1715656943230,LIIT 5BS,A00,507430,Carnelos; Chiara,20,0,20,0
1715656944259,LIIT 5CS,A00,507432,Carnelos; Chiara,20,0,20,0
1715656945287,LISP 5A,A00,507541,Munoz Sanchez; Alicia,11,0,20,9
1715656946312,LISP 5B,A00,507671,Munoz Sanchez; Alicia,8,0,20,12
1715656947342,LISP 5C,A00,507696,Munoz Sanchez; Alicia,7,0,20,13
1715656948370,MAE 197,001,528363,Boechler; Nicholas Sebastia,9998,0,9999,1
1715656949401,MATH 197,001,523477,Kedlaya; Kiran S.,9994,0,9999,5
1715656949401,MATH 197,002,563811,Zhang; Danna,9994,0,9999,5
1715656949401,MATH 197,003,628552,Dumitriu; Ioana,9998,0,9999,1
1715656949401,MATH 197,004,660885,Floyd; Eric,9998,0,9999,1
1715656950429,MCWP 40R,A00,518780,Staff,1,0,20,19
1715656950429,MCWP 40R,B00,518781,Carter; Jennifer A,9,0,20,11
1715656950429,MCWP 40R,C00,518783,Smith; Haydee Marie,5,0,20,15
1715656951460,MCWP 50R,A00,518791,Redela; Pamela Morgan,0,1,20,20
1715656951460,MCWP 50R,B00,518792,Krone; Jarret,0,2,20,20
1715656951460,MCWP 50R,C00,518793,Staff,0,4,20,20
1715656951460,MCWP 50R,D00,518794,Morshed; Michael James,0,2,20,20
1715656951460,MCWP 50R,E00,518795,Carter; Andrea L,0,2,20,20
1715656951460,MCWP 50R,F00,518796,Miller; Elizabeth Deen,0,1,20,20
1715656951460,MCWP 50R,G00,518797,Guillen; Melinda,0,1,20,20
1715656952485,MMW 12R,A01,514034,Herbst; Matthew,0,2,16,16
1715656952485,MMW 12R,A02,514035,Herbst; Matthew,0,0,16,16
1715656953510,MMW 13R,A01,514037,Staff,0,5,16,16
1715656953510,MMW 13R,A02,514039,Staff,0,5,16,16
1715656953510,MMW 13R,A03,628519,Staff,0,4,16,16
1715656955560,SIO 295LS,A00,523233,Staff,10,0,30,20
1715656956585,SIO 295S,A00,523232,Staff,10,0,30,20
1715656957610,SIOC 290S,A01,637330,Merrifield; Mark A,21,0,30,9
1715656958636,SIOC 291S,A01,637333,Gabriel; Corey John,21,0,30,9
1715656959661,SOCI 117,A01,494376,Staff,0,5,5,5
1715656960686,WES 237B,A00,494380,Staff,10,0,20,10
1715656962758,AESE 279B,A00,494370,Wade; Jon P,0,0,33,33
1715656963784,AIP 97,001,660915,Van Den Einde; Yael Dahlia,9998,0,9999,1
1715656964812,AIP 197,001,627712,Vespa; Emanuel Ignacio,9995,0,9999,4
1715656964812,AIP 197,002,650778,Amir; On,9998,0,9999,1
1715656964812,AIP 197,003,650933,Avenancio-Leon; Carlos,9998,0,9999,1
1715656964812,AIP 197,004,658530,Heyman; Gail D.,9998,0,9999,1
1715656964812,AIP 197,005,658631,Neal; Sonya E,9998,0,9999,1
1715656964812,AIP 197,006,658671,Du; Songzi,9998,0,9999,1
1715656965840,ANAR 135S,A00,494369,Braswell; Geoffrey E.,0,0,0,0
1715656966867,BENG 196,001,628496,Engler; Adam J.,9998,0,9999,1
1715656966867,BENG 196,002,660916,Watson; John Thomas,9998,0,9999,1
1715656967897,BISP 197,001,650773,Wilhelm; James E.,9994,0,9999,5
1715656967897,BISP 197,002,658904,Coleman; Aaron B.,9998,0,9999,1
1715656968927,CAT 124RS,A01,519847,Geibel; William,0,0,20,20
1715656969950,CAT 125RS,A01,515971,Geibel; William,0,0,20,20
1715656970976,CLRE 250,A00,511389,Morris; Sheldon,9992,0,9999,7
1715656972025,CLRE 251,A00,507176,Mehta; Ravindra L.,9992,0,9999,7
1715656972025,CLRE 251,B00,511410,Mehta; Ravindra L.,9998,0,9999,1
1715656973053,CLRE 252,A00,507189,Cuomo; Raphael Eduardo,9994,0,9999,5
1715656974077,CLRE 253,A00,507199,Vaida; Florin,9994,0,9999,5
1715656974077,CLRE 253,B00,507202,Vaida; Florin,9999,0,9999,0
1715656975103,CLRE 259,A00,507211,Patel; Hemal,9996,0,9999,3
1715656976128,CLRE 260,A00,507221,Cuomo; Raphael Eduardo,9999,0,9999,0
1715656977151,CLRE 297,001,507242,Cuomo; Raphael Eduardo,9999,0,9999,0
1715656978179,COGS 197,001,638244,Voytek; Bradley Thomas,9997,0,9999,2
1715656979204,CSE 191,A00,516875,Minnes Kemp; Mor Mia,9991,0,9999,8
1715656980231,CSE 197,001,637388,Minnes Kemp; Mor Mia,9992,0,9999,7
1715656981263,CSS 201S,A01,494383,Mignozzetti; Umberto,35,0,35,0
1715656982288,CSS 202S,A01,494387,Mignozzetti; Umberto,35,0,35,0
1715656983320,DSC 197,001,628532,Eldridge; Justin Matthew,9995,0,9999,4
1715656984346,EAP 100,A00,516065,Staff,9799,0,9999,200
1715656985375,ECE 45,A01,507414,Staff,32,0,60,28
1715656987424,ECE 111,A01,507420,Staff,11,0,50,39
1715656988447,ECE 197,001,548057,Sievenpiper; Daniel F.,9991,0,9999,8
1715656989475,EDS 115,A00,507243,Choi; Bailey Miyeon,6,0,28,22
1715656990502,EDS 117,A01,494379,Staff,0,6,34,35
1715656991526,EDS 125,A00,507246,Hopkins; Megan Beth,7,0,30,23
1715656992554,EDS 128A,A01,507264,Fargason; Sharon Gayle,5,0,26,21
1715656993597,EDS 128B,A01,507293,Pappas; Elizabeth,9,0,30,21
1715656994625,EDS 139,A00,507294,Fargason; Sharon Gayle,9,0,30,21
1715656994625,EDS 139,B00,507313,Pappas; Elizabeth,9,0,30,21
1715656995652,EDS 201,A00,507315,Staff,10,0,30,20
1715656996682,EDS 203,A01,507317,Halter; Christopher P.,10,0,30,20
1715656997710,EDS 204R,A01,507319,Halter; Christopher P.,0,3,30,30
1715656997710,EDS 204R,B01,507331,Heinzman; Erica M.,14,0,30,16
1715656998739,EDS 206R,A00,507332,Staff,0,4,30,30
1715656998739,EDS 206R,B00,507343,Staff,15,0,30,15
1715656999768,EDS 250,A00,507344,Hemans; Patricia Ann Benitez,20,0,40,20
1715657000793,EDS 281,A00,507345,Daly; Alan J.,18,0,18,0
1715657001823,EDS 284,A00,507350,Daly; Alan J.,16,0,16,0
1715657002849,EDS 286,A00,507359,Fine; Sarah,18,0,18,0
1715657003877,EDS 289C,A01,507361,Daly; Alan J.,18,0,18,0
1715657004907,EDS 290,A00,507366,Hofstetter; Carolyn,15,0,15,0
1715657005937,LIGM 5A,A00,507421,Fischer-Grunski; Eva K,17,0,20,3
1715657006965,LIGM 5B,A00,507423,Fischer-Grunski; Eva K,19,0,20,1
1715657007993,LIGM 5C,A00,507425,Fischer-Grunski; Eva K,19,0,20,1
1715657009018,LIIT 5AS,A00,507427,Carnelos; Chiara,20,0,20,0
1715657010043,LIIT 5BS,A00,507430,Carnelos; Chiara,20,0,20,0
1715657011067,LIIT 5CS,A00,507432,Carnelos; Chiara,20,0,20,0
1715657012098,LISP 5A,A00,507541,Munoz Sanchez; Alicia,11,0,20,9
1715657013126,LISP 5B,A00,507671,Munoz Sanchez; Alicia,8,0,20,12
1715657014150,LISP 5C,A00,507696,Munoz Sanchez; Alicia,7,0,20,13
1715657015174,MAE 197,001,528363,Boechler; Nicholas Sebastia,9998,0,9999,1
1715657016202,MATH 197,001,523477,Kedlaya; Kiran S.,9994,0,9999,5
1715657016202,MATH 197,002,563811,Zhang; Danna,9994,0,9999,5
1715657016202,MATH 197,003,628552,Dumitriu; Ioana,9998,0,9999,1
1715657016202,MATH 197,004,660885,Floyd; Eric,9998,0,9999,1
1715657017232,MCWP 40R,A00,518780,Staff,1,0,20,19
1715657017232,MCWP 40R,B00,518781,Carter; Jennifer A,9,0,20,11
1715657017232,MCWP 40R,C00,518783,Smith; Haydee Marie,5,0,20,15
1715657018262,MCWP 50R,A00,518791,Redela; Pamela Morgan,0,1,20,20
1715657018262,MCWP 50R,B00,518792,Krone; Jarret,0,2,20,20
1715657018262,MCWP 50R,C00,518793,Staff,0,4,20,20
1715657018262,MCWP 50R,D00,518794,Morshed; Michael James,0,2,20,20
1715657018262,MCWP 50R,E00,518795,Carter; Andrea L,0,2,20,20
1715657018262,MCWP 50R,F00,518796,Miller; Elizabeth Deen,0,1,20,20
1715657018262,MCWP 50R,G00,518797,Guillen; Melinda,0,1,20,20
1715657019288,MMW 12R,A01,514034,Herbst; Matthew,0,2,16,16
1715657019288,MMW 12R,A02,514035,Herbst; Matthew,0,0,16,16
1715657020316,MMW 13R,A01,514037,Staff,0,5,16,16
1715657020316,MMW 13R,A02,514039,Staff,0,5,16,16
1715657020316,MMW 13R,A03,628519,Staff,0,4,16,16
1715657022374,SIO 295LS,A00,523233,Staff,10,0,30,20
1715657023399,SIO 295S,A00,523232,Staff,10,0,30,20
1715657024426,SIOC 290S,A01,637330,Merrifield; Mark A,21,0,30,9
1715657025455,SIOC 291S,A01,637333,Gabriel; Corey John,21,0,30,9
1715657026480,SOCI 117,A01,494376,Staff,0,5,5,5
1715657027507,WES 237B,A00,494380,Staff,10,0,20,10
1715657029584,AESE 279B,A00,494370,Wade; Jon P,0,0,33,33
1715657030610,AIP 97,001,660915,Van Den Einde; Yael Dahlia,9998,0,9999,1
1715657031640,AIP 197,001,627712,Vespa; Emanuel Ignacio,9995,0,9999,4
1715657031640,AIP 197,002,650778,Amir; On,9998,0,9999,1
1715657031640,AIP 197,003,650933,Avenancio-Leon; Carlos,9998,0,9999,1
1715657031640,AIP 197,004,658530,Heyman; Gail D.,9998,0,9999,1
1715657031640,AIP 197,005,658631,Neal; Sonya E,9998,0,9999,1
1715657031640,AIP 197,006,658671,Du; Songzi,9998,0,9999,1
1715657032666,ANAR 135S,A00,494369,Braswell; Geoffrey E.,0,0,0,0
1715657033690,BENG 196,001,628496,Engler; Adam J.,9998,0,9999,1
1715657033690,BENG 196,002,660916,Watson; John Thomas,9998,0,9999,1
1715657034716,BISP 197,001,650773,Wilhelm; James E.,9994,0,9999,5
1715657034716,BISP 197,002,658904,Coleman; Aaron B.,9998,0,9999,1
1715657035746,CAT 124RS,A01,519847,Geibel; William,0,0,20,20
1715657036774,CAT 125RS,A01,515971,Geibel; William,0,0,20,20
1715657037810,CLRE 250,A00,511389,Morris; Sheldon,9992,0,9999,7
1715657038840,CLRE 251,A00,507176,Mehta; Ravindra L.,9992,0,9999,7
1715657038840,CLRE 251,B00,511410,Mehta; Ravindra L.,9998,0,9999,1
1715657039874,CLRE 252,A00,507189,Cuomo; Raphael Eduardo,9994,0,9999,5
1715657040956,CLRE 253,A00,507199,Vaida; Florin,9994,0,9999,5
1715657040956,CLRE 253,B00,507202,Vaida; Florin,9999,0,9999,0
1715657041982,CLRE 259,A00,507211,Patel; Hemal,9996,0,9999,3
1715657043008,CLRE 260,A00,507221,Cuomo; Raphael Eduardo,9999,0,9999,0
1715657044037,CLRE 297,001,507242,Cuomo; Raphael Eduardo,9999,0,9999,0
1715657045065,COGS 197,001,638244,Voytek; Bradley Thomas,9997,0,9999,2
1715657046091,CSE 191,A00,516875,Minnes Kemp; Mor Mia,9991,0,9999,8
1715657047118,CSE 197,001,637388,Minnes Kemp; Mor Mia,9992,0,9999,7
1715657048148,CSS 201S,A01,494383,Mignozzetti; Umberto,35,0,35,0
1715657049177,CSS 202S,A01,494387,Mignozzetti; Umberto,35,0,35,0
1715657050204,DSC 197,001,628532,Eldridge; Justin Matthew,9995,0,9999,4
1715657051230,EAP 100,A00,516065,Staff,9799,0,9999,200
1715657052259,ECE 45,A01,507414,Staff,32,0,60,28
1715657054311,ECE 111,A01,507420,Staff,11,0,50,39
1715657055338,ECE 197,001,548057,Sievenpiper; Daniel F.,9991,0,9999,8
1715657056366,EDS 115,A00,507243,Choi; Bailey Miyeon,6,0,28,22
1715657057393,EDS 117,A01,494379,Staff,0,6,34,35
1715657058419,EDS 125,A00,507246,Hopkins; Megan Beth,7,0,30,23
1715657059446,EDS 128A,A01,507264,Fargason; Sharon Gayle,5,0,26,21
1715657060478,EDS 128B,A01,507293,Pappas; Elizabeth,9,0,30,21
1715657061506,EDS 139,A00,507294,Fargason; Sharon Gayle,9,0,30,21
1715657061506,EDS 139,B00,507313,Pappas; Elizabeth,9,0,30,21
1715657062531,EDS 201,A00,507315,Staff,10,0,30,20
1715657063557,EDS 203,A01,507317,Halter; Christopher P.,10,0,30,20
1715657064583,EDS 204R,A01,507319,Halter; Christopher P.,0,3,30,30
1715657064583,EDS 204R,B01,507331,Heinzman; Erica M.,14,0,30,16
1715657065611,EDS 206R,A00,507332,Staff,0,4,30,30
1715657065611,EDS 206R,B00,507343,Staff,15,0,30,15
1715657066639,EDS 250,A00,507344,Hemans; Patricia Ann Benitez,20,0,40,20
1715657067668,EDS 281,A00,507345,Daly; Alan J.,18,0,18,0
1715657068693,EDS 284,A00,507350,Daly; Alan J.,16,0,16,0
1715657069720,EDS 286,A00,507359,Fine; Sarah,18,0,18,0
1715657070745,EDS 289C,A01,507361,Daly; Alan J.,18,0,18,0
1715657071770,EDS 290,A00,507366,Hofstetter; Carolyn,15,0,15,0
1715657072800,LIGM 5A,A00,507421,Fischer-Grunski; Eva K,17,0,20,3
1715657073826,LIGM 5B,A00,507423,Fischer-Grunski; Eva K,19,0,20,1
1715657074851,LIGM 5C,A00,507425,Fischer-Grunski; Eva K,19,0,20,1
1715657075879,LIIT 5AS,A00,507427,Carnelos; Chiara,20,0,20,0
1715657076907,LIIT 5BS,A00,507430,Carnelos; Chiara,20,0,20,0
1715657077932,LIIT 5CS,A00,507432,Carnelos; Chiara,20,0,20,0
1715657078957,LISP 5A,A00,507541,Munoz Sanchez; Alicia,11,0,20,9
1715657079986,LISP 5B,A00,507671,Munoz Sanchez; Alicia,8,0,20,12
1715657081015,LISP 5C,A00,507696,Munoz Sanchez; Alicia,7,0,20,13
1715657082040,MAE 197,001,528363,Boechler; Nicholas Sebastia,9998,0,9999,1
1715657083067,MATH 197,001,523477,Kedlaya; Kiran S.,9994,0,9999,5
1715657083067,MATH 197,002,563811,Zhang; Danna,9994,0,9999,5
1715657083067,MATH 197,003,628552,Dumitriu; Ioana,9998,0,9999,1
1715657083067,MATH 197,004,660885,Floyd; Eric,9998,0,9999,1
1715657084098,MCWP 40R,A00,518780,Staff,1,0,20,19
1715657084098,MCWP 40R,B00,518781,Carter; Jennifer A,9,0,20,11
1715657084098,MCWP 40R,C00,518783,Smith; Haydee Marie,5,0,20,15
1715657085131,MCWP 50R,A00,518791,Redela; Pamela Morgan,0,1,20,20
1715657085131,MCWP 50R,B00,518792,Krone; Jarret,0,2,20,20
1715657085131,MCWP 50R,C00,518793,Staff,0,4,20,20
1715657085131,MCWP 50R,D00,518794,Morshed; Michael James,0,2,20,20
1715657085131,MCWP 50R,E00,518795,Carter; Andrea L,0,2,20,20
1715657085131,MCWP 50R,F00,518796,Miller; Elizabeth Deen,0,1,20,20
1715657085131,MCWP 50R,G00,518797,Guillen; Melinda,0,1,20,20
1715657086160,MMW 12R,A01,514034,Herbst; Matthew,0,2,16,16
1715657086160,MMW 12R,A02,514035,Herbst; Matthew,0,0,16,16
1715657087186,MMW 13R,A01,514037,Staff,0,5,16,16
1715657087186,MMW 13R,A02,514039,Staff,0,5,16,16
1715657087186,MMW 13R,A03,628519,Staff,0,4,16,16
1715657089237,SIO 295LS,A00,523233,Staff,10,0,30,20
1715657090264,SIO 295S,A00,523232,Staff,10,0,30,20
1715657091294,SIOC 290S,A01,637330,Merrifield; Mark A,21,0,30,9
1715657092322,SIOC 291S,A01,637333,Gabriel; Corey John,21,0,30,9
1715657093350,SOCI 117,A01,494376,Staff,0,5,5,5
1715657094378,WES 237B,A00,494380,Staff,10,0,20,10
1715657096446,AESE 279B,A00,494370,Wade; Jon P,0,0,33,33
1715657097470,AIP 97,001,660915,Van Den Einde; Yael Dahlia,9998,0,9999,1
1715657098502,AIP 197,001,627712,Vespa; Emanuel Ignacio,9995,0,9999,4
1715657098502,AIP 197,002,650778,Amir; On,9998,0,9999,1
1715657098502,AIP 197,003,650933,Avenancio-Leon; Carlos,9998,0,9999,1
1715657098502,AIP 197,004,658530,Heyman; Gail D.,9998,0,9999,1
1715657098502,AIP 197,005,658631,Neal; Sonya E,9998,0,9999,1
1715657098502,AIP 197,006,658671,Du; Songzi,9998,0,9999,1
1715657099527,ANAR 135S,A00,494369,Braswell; Geoffrey E.,0,0,0,0
1715657100556,BENG 196,001,628496,Engler; Adam J.,9998,0,9999,1
1715657100556,BENG 196,002,660916,Watson; John Thomas,9998,0,9999,1
1715657101588,BISP 197,001,650773,Wilhelm; James E.,9994,0,9999,5
1715657101588,BISP 197,002,658904,Coleman; Aaron B.,9998,0,9999,1
1715657102616,CAT 124RS,A01,519847,Geibel; William,0,0,20,20
1715657103640,CAT 125RS,A01,515971,Geibel; William,0,0,20,20
1715657104669,CLRE 250,A00,511389,Morris; Sheldon,9992,0,9999,7
1715657105697,CLRE 251,A00,507176,Mehta; Ravindra L.,9992,0,9999,7
1715657105697,CLRE 251,B00,511410,Mehta; Ravindra L.,9998,0,9999,1
1715657106730,CLRE 252,A00,507189,Cuomo; Raphael Eduardo,9994,0,9999,5
1715657107759,CLRE 253,A00,507199,Vaida; Florin,9994,0,9999,5
1715657107759,CLRE 253,B00,507202,Vaida; Florin,9999,0,9999,0
1715657108788,CLRE 259,A00,507211,Patel; Hemal,9996,0,9999,3
1715657109814,CLRE 260,A00,507221,Cuomo; Raphael Eduardo,9999,0,9999,0
1715657110839,CLRE 297,001,507242,Cuomo; Raphael Eduardo,9999,0,9999,0
1715657111869,COGS 197,001,638244,Voytek; Bradley Thomas,9997,0,9999,2
1715657112897,CSE 191,A00,516875,Minnes Kemp; Mor Mia,9991,0,9999,8
1715657113921,CSE 197,001,637388,Minnes Kemp; Mor Mia,9992,0,9999,7
1715657114952,CSS 201S,A01,494383,Mignozzetti; Umberto,35,0,35,0
1715657115982,CSS 202S,A01,494387,Mignozzetti; Umberto,35,0,35,0
1715657117010,DSC 197,001,628532,Eldridge; Justin Matthew,9995,0,9999,4
1715657118034,EAP 100,A00,516065,Staff,9799,0,9999,200
1715657119062,ECE 45,A01,507414,Staff,32,0,60,28
1715657121114,ECE 111,A01,507420,Staff,11,0,50,39
1715657122142,ECE 197,001,548057,Sievenpiper; Daniel F.,9991,0,9999,8
1715657123172,EDS 115,A00,507243,Choi; Bailey Miyeon,6,0,28,22
1715657124198,EDS 117,A01,494379,Staff,0,6,34,35
1715657125224,EDS 125,A00,507246,Hopkins; Megan Beth,7,0,30,23
1715657126251,EDS 128A,A01,507264,Fargason; Sharon Gayle,5,0,26,21
1715657127278,EDS 128B,A01,507293,Pappas; Elizabeth,9,0,30,21
1715657128304,EDS 139,A00,507294,Fargason; Sharon Gayle,9,0,30,21
1715657128304,EDS 139,B00,507313,Pappas; Elizabeth,9,0,30,21
1715657129332,EDS 201,A00,507315,Staff,10,0,30,20
1715657130359,EDS 203,A01,507317,Halter; Christopher P.,10,0,30,20
1715657131385,EDS 204R,A01,507319,Halter; Christopher P.,0,3,30,30
1715657131385,EDS 204R,B01,507331,Heinzman; Erica M.,14,0,30,16
1715657132410,EDS 206R,A00,507332,Staff,0,4,30,30
1715657132410,EDS 206R,B00,507343,Staff,15,0,30,15
1715657133435,EDS 250,A00,507344,Hemans; Patricia Ann Benitez,20,0,40,20
1715657134463,EDS 281,A00,507345,Daly; Alan J.,18,0,18,0
1715657135488,EDS 284,A00,507350,Daly; Alan J.,16,0,16,0
1715657136518,EDS 286,A00,507359,Fine; Sarah,18,0,18,0
1715657137543,EDS 289C,A01,507361,Daly; Alan J.,18,0,18,0
1715657138570,EDS 290,A00,507366,Hofstetter; Carolyn,15,0,15,0
1715657139596,LIGM 5A,A00,507421,Fischer-Grunski; Eva K,17,0,20,3
1715657140625,LIGM 5B,A00,507423,Fischer-Grunski; Eva K,19,0,20,1
1715657141651,LIGM 5C,A00,507425,Fischer-Grunski; Eva K,19,0,20,1
1715657142680,LIIT 5AS,A00,507427,Carnelos; Chiara,20,0,20,0
1715657143707,LIIT 5BS,A00,507430,Carnelos; Chiara,20,0,20,0
1715657144787,LIIT 5CS,A00,507432,Carnelos; Chiara,20,0,20,0
1715657145812,LISP 5A,A00,507541,Munoz Sanchez; Alicia,11,0,20,9
1715657146840,LISP 5B,A00,507671,Munoz Sanchez; Alicia,8,0,20,12
1715657147866,LISP 5C,A00,507696,Munoz Sanchez; Alicia,7,0,20,13
1715657148893,MAE 197,001,528363,Boechler; Nicholas Sebastia,9998,0,9999,1
1715657149921,MATH 197,001,523477,Kedlaya; Kiran S.,9994,0,9999,5
1715657149921,MATH 197,002,563811,Zhang; Danna,9994,0,9999,5
1715657149921,MATH 197,003,628552,Dumitriu; Ioana,9998,0,9999,1
1715657149921,MATH 197,004,660885,Floyd; Eric,9998,0,9999,1
1715657150951,MCWP 40R,A00,518780,Staff,1,0,20,19
1715657150951,MCWP 40R,B00,518781,Carter; Jennifer A,9,0,20,11
1715657150951,MCWP 40R,C00,518783,Smith; Haydee Marie,5,0,20,15
1715657151978,MCWP 50R,A00,518791,Redela; Pamela Morgan,0,1,20,20
1715657151978,MCWP 50R,B00,518792,Krone; Jarret,0,2,20,20
1715657151978,MCWP 50R,C00,518793,Staff,0,4,20,20
1715657151978,MCWP 50R,D00,518794,Morshed; Michael James,0,2,20,20
1715657151978,MCWP 50R,E00,518795,Carter; Andrea L,0,2,20,20
1715657151978,MCWP 50R,F00,518796,Miller; Elizabeth Deen,0,1,20,20
1715657151978,MCWP 50R,G00,518797,Guillen; Melinda,0,1,20,20
1715657153005,MMW 12R,A01,514034,Herbst; Matthew,0,2,16,16
1715657153005,MMW 12R,A02,514035,Herbst; Matthew,0,0,16,16
1715657154031,MMW 13R,A01,514037,Staff,0,5,16,16
1715657154031,MMW 13R,A02,514039,Staff,0,5,16,16
1715657154031,MMW 13R,A03,628519,Staff,0,4,16,16
1715657156084,SIO 295LS,A00,523233,Staff,10,0,30,20
1715657157112,SIO 295S,A00,523232,Staff,10,0,30,20
1715657158142,SIOC 290S,A01,637330,Merrifield; Mark A,21,0,30,9
1715657159170,SIOC 291S,A01,637333,Gabriel; Corey John,21,0,30,9
1715657160198,SOCI 117,A01,494376,Staff,0,5,5,5
1715657161226,WES 237B,A00,494380,Staff,10,0,20,10
1715657163296,AESE 279B,A00,494370,Wade; Jon P,0,0,33,33
1715657164324,AIP 97,001,660915,Van Den Einde; Yael Dahlia,9998,0,9999,1
1715657165354,AIP 197,001,627712,Vespa; Emanuel Ignacio,9995,0,9999,4
1715657165354,AIP 197,002,650778,Amir; On,9998,0,9999,1
1715657165354,AIP 197,003,650933,Avenancio-Leon; Carlos,9998,0,9999,1
1715657165354,AIP 197,004,658530,Heyman; Gail D.,9998,0,9999,1
1715657165354,AIP 197,005,658631,Neal; Sonya E,9998,0,9999,1
1715657165354,AIP 197,006,658671,Du; Songzi,9998,0,9999,1
1715657166381,ANAR 135S,A00,494369,Braswell; Geoffrey E.,0,0,0,0
1715657167407,BENG 196,001,628496,Engler; Adam J.,9998,0,9999,1
1715657167407,BENG 196,002,660916,Watson; John Thomas,9998,0,9999,1
1715657168438,BISP 197,001,650773,Wilhelm; James E.,9994,0,9999,5
1715657168438,BISP 197,002,658904,Coleman; Aaron B.,9998,0,9999,1
1715657169465,CAT 124RS,A01,519847,Geibel; William,0,0,20,20
1715657170491,CAT 125RS,A01,515971,Geibel; William,0,0,20,20
1715657171517,CLRE 250,A00,511389,Morris; Sheldon,9992,0,9999,7
1715657172543,CLRE 251,A00,507176,Mehta; Ravindra L.,9992,0,9999,7
1715657172543,CLRE 251,B00,511410,Mehta; Ravindra L.,9998,0,9999,1
1715657173570,CLRE 252,A00,507189,Cuomo; Raphael Eduardo,9994,0,9999,5
1715657174597,CLRE 253,A00,507199,Vaida; Florin,9994,0,9999,5
1715657174597,CLRE 253,B00,507202,Vaida; Florin,9999,0,9999,0
1715657175626,CLRE 259,A00,507211,Patel; Hemal,9996,0,9999,3
1715657176652,CLRE 260,A00,507221,Cuomo; Raphael Eduardo,9999,0,9999,0
1715657177681,CLRE 297,001,507242,Cuomo; Raphael Eduardo,9999,0,9999,0
1715657178706,COGS 197,001,638244,Voytek; Bradley Thomas,9997,0,9999,2
1715657179732,CSE 191,A00,516875,Minnes Kemp; Mor Mia,9991,0,9999,8
1715657180758,CSE 197,001,637388,Minnes Kemp; Mor Mia,9992,0,9999,7
1715657181786,CSS 201S,A01,494383,Mignozzetti; Umberto,35,0,35,0
1715657182811,CSS 202S,A01,494387,Mignozzetti; Umberto,35,0,35,0
1715657183839,DSC 197,001,628532,Eldridge; Justin Matthew,9995,0,9999,4
1715657184864,EAP 100,A00,516065,Staff,9799,0,9999,200
1715657185891,ECE 45,A01,507414,Staff,32,0,60,28
1715657187944,ECE 111,A01,507420,Staff,11,0,50,39
1715657188968,ECE 197,001,548057,Sievenpiper; Daniel F.,9991,0,9999,8
1715657189998,EDS 115,A00,507243,Choi; Bailey Miyeon,6,0,28,22
1715657191023,EDS 117,A01,494379,Staff,0,6,34,35
1715657192049,EDS 125,A00,507246,Hopkins; Megan Beth,7,0,30,23
1715657193074,EDS 128A,A01,507264,Fargason; Sharon Gayle,5,0,26,21
1715657194100,EDS 128B,A01,507293,Pappas; Elizabeth,9,0,30,21
1715657195126,EDS 139,A00,507294,Fargason; Sharon Gayle,9,0,30,21
1715657195126,EDS 139,B00,507313,Pappas; Elizabeth,9,0,30,21
1715657196152,EDS 201,A00,507315,Staff,10,0,30,20
1715657197177,EDS 203,A01,507317,Halter; Christopher P.,10,0,30,20
1715657198207,EDS 204R,A01,507319,Halter; Christopher P.,0,3,30,30
1715657198207,EDS 204R,B01,507331,Heinzman; Erica M.,14,0,30,16
1715657199231,EDS 206R,A00,507332,Staff,0,4,30,30
1715657199231,EDS 206R,B00,507343,Staff,15,0,30,15
1715657200260,EDS 250,A00,507344,Hemans; Patricia Ann Benitez,20,0,40,20
1715657201286,EDS 281,A00,507345,Daly; Alan J.,18,0,18,0
1715657202312,EDS 284,A00,507350,Daly; Alan J.,16,0,16,0
1715657203340,EDS 286,A00,507359,Fine; Sarah,18,0,18,0
1715657204365,EDS 289C,A01,507361,Daly; Alan J.,18,0,18,0
1715657205392,EDS 290,A00,507366,Hofstetter; Carolyn,15,0,15,0
1715657206424,LIGM 5A,A00,507421,Fischer-Grunski; Eva K,17,0,20,3
1715657207448,LIGM 5B,A00,507423,Fischer-Grunski; Eva K,19,0,20,1
1715657208477,LIGM 5C,A00,507425,Fischer-Grunski; Eva K,19,0,20,1
1715657209505,LIIT 5AS,A00,507427,Carnelos; Chiara,20,0,20,0
1715657210530,LIIT 5BS,A00,507430,Carnelos; Chiara,20,0,20,0
1715657211554,LIIT 5CS,A00,507432,Carnelos; Chiara,20,0,20,0
1715657212580,LISP 5A,A00,507541,Munoz Sanchez; Alicia,11,0,20,9
1715657213604,LISP 5B,A00,507671,Munoz Sanchez; Alicia,8,0,20,12
1715657214633,LISP 5C,A00,507696,Munoz Sanchez; Alicia,7,0,20,13
1715657215712,MAE 197,001,528363,Boechler; Nicholas Sebastia,9998,0,9999,1
1715657216740,MATH 197,001,523477,Kedlaya; Kiran S.,9994,0,9999,5
1715657216740,MATH 197,002,563811,Zhang; Danna,9994,0,9999,5
1715657216740,MATH 197,003,628552,Dumitriu; Ioana,9998,0,9999,1
1715657216740,MATH 197,004,660885,Floyd; Eric,9998,0,9999,1
1715657217772,MCWP 40R,A00,518780,Staff,1,0,20,19
1715657217772,MCWP 40R,B00,518781,Carter; Jennifer A,9,0,20,11
1715657217772,MCWP 40R,C00,518783,Smith; Haydee Marie,5,0,20,15
1715657218799,MCWP 50R,A00,518791,Redela; Pamela Morgan,0,1,20,20
1715657218799,MCWP 50R,B00,518792,Krone; Jarret,0,2,20,20
1715657218799,MCWP 50R,C00,518793,Staff,0,4,20,20
1715657218799,MCWP 50R,D00,518794,Morshed; Michael James,0,2,20,20
1715657218799,MCWP 50R,E00,518795,Carter; Andrea L,0,2,20,20
1715657218799,MCWP 50R,F00,518796,Miller; Elizabeth Deen,0,1,20,20
1715657218799,MCWP 50R,G00,518797,Guillen; Melinda,0,1,20,20
1715657219824,MMW 12R,A01,514034,Herbst; Matthew,0,2,16,16
1715657219824,MMW 12R,A02,514035,Herbst; Matthew,0,0,16,16
1715657220849,MMW 13R,A01,514037,Staff,0,5,16,16
1715657220849,MMW 13R,A02,514039,Staff,0,5,16,16
1715657220849,MMW 13R,A03,628519,Staff,0,4,16,16
1715657222900,SIO 295LS,A00,523233,Staff,10,0,30,20
1715657223927,SIO 295S,A00,523232,Staff,10,0,30,20
1715657224954,SIOC 290S,A01,637330,Merrifield; Mark A,21,0,30,9
1715657225980,SIOC 291S,A01,637333,Gabriel; Corey John,21,0,30,9
1715657227011,SOCI 117,A01,494376,Staff,0,5,5,5
1715657228037,WES 237B,A00,494380,Staff,10,0,20,10
1715657230108,AESE 279B,A00,494370,Wade; Jon P,0,0,33,33
1715657231133,AIP 97,001,660915,Van Den Einde; Yael Dahlia,9998,0,9999,1
1715657232165,AIP 197,001,627712,Vespa; Emanuel Ignacio,9995,0,9999,4
1715657232165,AIP 197,002,650778,Amir; On,9998,0,9999,1
1715657232165,AIP 197,003,650933,Avenancio-Leon; Carlos,9998,0,9999,1
1715657232165,AIP 197,004,658530,Heyman; Gail D.,9998,0,9999,1
1715657232165,AIP 197,005,658631,Neal; Sonya E,9998,0,9999,1
1715657232165,AIP 197,006,658671,Du; Songzi,9998,0,9999,1
1715657233192,ANAR 135S,A00,494369,Braswell; Geoffrey E.,0,0,0,0
1715657234220,BENG 196,001,628496,Engler; Adam J.,9998,0,9999,1
1715657234220,BENG 196,002,660916,Watson; John Thomas,9998,0,9999,1
1715657235247,BISP 197,001,650773,Wilhelm; James E.,9994,0,9999,5
1715657235247,BISP 197,002,658904,Coleman; Aaron B.,9998,0,9999,1
1715657236276,CAT 124RS,A01,519847,Geibel; William,0,0,20,20
1715657237302,CAT 125RS,A01,515971,Geibel; William,0,0,20,20
1715657238329,CLRE 250,A00,511389,Morris; Sheldon,9992,0,9999,7
1715657239359,CLRE 251,A00,507176,Mehta; Ravindra L.,9992,0,9999,7
1715657239359,CLRE 251,B00,511410,Mehta; Ravindra L.,9998,0,9999,1
1715657240387,CLRE 252,A00,507189,Cuomo; Raphael Eduardo,9994,0,9999,5
1715657241417,CLRE 253,A00,507199,Vaida; Florin,9994,0,9999,5
1715657241417,CLRE 253,B00,507202,Vaida; Florin,9999,0,9999,0
1715657242442,CLRE 259,A00,507211,Patel; Hemal,9996,0,9999,3
1715657243469,CLRE 260,A00,507221,Cuomo; Raphael Eduardo,9999,0,9999,0
1715657244494,CLRE 297,001,507242,Cuomo; Raphael Eduardo,9999,0,9999,0
1715657245524,COGS 197,001,638244,Voytek; Bradley Thomas,9997,0,9999,2
1715657246550,CSE 191,A00,516875,Minnes Kemp; Mor Mia,9991,0,9999,8
1715657247578,CSE 197,001,637388,Minnes Kemp; Mor Mia,9992,0,9999,7
1715657248606,CSS 201S,A01,494383,Mignozzetti; Umberto,35,0,35,0
1715657249630,CSS 202S,A01,494387,Mignozzetti; Umberto,35,0,35,0
1715657250655,DSC 197,001,628532,Eldridge; Justin Matthew,9995,0,9999,4
1715657251679,EAP 100,A00,516065,Staff,9799,0,9999,200
1715657252706,ECE 45,A01,507414,Staff,32,0,60,28
1715657254759,ECE 111,A01,507420,Staff,11,0,50,39
1715657255787,ECE 197,001,548057,Sievenpiper; Daniel F.,9991,0,9999,8
1715657256813,EDS 115,A00,507243,Choi; Bailey Miyeon,6,0,28,22
1715657257893,EDS 117,A01,494379,Staff,0,6,34,35
1715657258919,EDS 125,A00,507246,Hopkins; Megan Beth,7,0,30,23
1715657259945,EDS 128A,A01,507264,Fargason; Sharon Gayle,5,0,26,21
1715657260969,EDS 128B,A01,507293,Pappas; Elizabeth,9,0,30,21
1715657261994,EDS 139,A00,507294,Fargason; Sharon Gayle,9,0,30,21
1715657261994,EDS 139,B00,507313,Pappas; Elizabeth,9,0,30,21
1715657263020,EDS 201,A00,507315,Staff,10,0,30,20
1715657264049,EDS 203,A01,507317,Halter; Christopher P.,10,0,30,20
1715657265074,EDS 204R,A01,507319,Halter; Christopher P.,0,3,30,30
1715657265074,EDS 204R,B01,507331,Heinzman; Erica M.,14,0,30,16
1715657266100,EDS 206R,A00,507332,Staff,0,4,30,30
1715657266100,EDS 206R,B00,507343,Staff,15,0,30,15
1715657267126,EDS 250,A00,507344,Hemans; Patricia Ann Benitez,20,0,40,20
1715657268151,EDS 281,A00,507345,Daly; Alan J.,18,0,18,0
1715657269175,EDS 284,A00,507350,Daly; Alan J.,16,0,16,0
1715657270201,EDS 286,A00,507359,Fine; Sarah,18,0,18,0
1715657271230,EDS 289C,A01,507361,Daly; Alan J.,18,0,18,0
1715657272255,EDS 290,A00,507366,Hofstetter; Carolyn,15,0,15,0
1715657273286,LIGM 5A,A00,507421,Fischer-Grunski; Eva K,17,0,20,3
1715657274314,LIGM 5B,A00,507423,Fischer-Grunski; Eva K,19,0,20,1
1715657275343,LIGM 5C,A00,507425,Fischer-Grunski; Eva K,19,0,20,1
1715657276369,LIIT 5AS,A00,507427,Carnelos; Chiara,20,0,20,0
1715657277395,LIIT 5BS,A00,507430,Carnelos; Chiara,20,0,20,0
1715657278420,LIIT 5CS,A00,507432,Carnelos; Chiara,20,0,20,0
1715657279450,LISP 5A,A00,507541,Munoz Sanchez; Alicia,11,0,20,9
1715657280479,LISP 5B,A00,507671,Munoz Sanchez; Alicia,8,0,20,12
1715657281534,LISP 5C,A00,507696,Munoz Sanchez; Alicia,7,0,20,13
1715657282562,MAE 197,001,528363,Boechler; Nicholas Sebastia,9998,0,9999,1
1715657283593,MATH 197,001,523477,Kedlaya; Kiran S.,9994,0,9999,5
1715657283593,MATH 197,002,563811,Zhang; Danna,9994,0,9999,5
1715657283593,MATH 197,003,628552,Dumitriu; Ioana,9998,0,9999,1
1715657283593,MATH 197,004,660885,Floyd; Eric,9998,0,9999,1
1715657284622,MCWP 40R,A00,518780,Staff,1,0,20,19
1715657284622,MCWP 40R,B00,518781,Carter; Jennifer A,9,0,20,11
1715657284622,MCWP 40R,C00,518783,Smith; Haydee Marie,5,0,20,15
1715657285650,MCWP 50R,A00,518791,Redela; Pamela Morgan,0,1,20,20
1715657285650,MCWP 50R,B00,518792,Krone; Jarret,0,2,20,20
1715657285650,MCWP 50R,C00,518793,Staff,0,4,20,20
1715657285650,MCWP 50R,D00,518794,Morshed; Michael James,0,2,20,20
1715657285650,MCWP 50R,E00,518795,Carter; Andrea L,0,2,20,20
1715657285650,MCWP 50R,F00,518796,Miller; Elizabeth Deen,0,1,20,20
1715657285650,MCWP 50R,G00,518797,Guillen; Melinda,0,1,20,20
1715657286678,MMW 12R,A01,514034,Herbst; Matthew,0,2,16,16
1715657286678,MMW 12R,A02,514035,Herbst; Matthew,0,0,16,16
1715657287703,MMW 13R,A01,514037,Staff,0,5,16,16
1715657287703,MMW 13R,A02,514039,Staff,0,5,16,16
1715657287703,MMW 13R,A03,628519,Staff,0,4,16,16
1715657289756,SIO 295LS,A00,523233,Staff,10,0,30,20
1715657290780,SIO 295S,A00,523232,Staff,10,0,30,20
1715657291811,SIOC 290S,A01,637330,Merrifield; Mark A,21,0,30,9
1715657292836,SIOC 291S,A01,637333,Gabriel; Corey John,21,0,30,9
1715657293870,SOCI 117,A01,494376,Staff,0,5,5,5
1715657294898,WES 237B,A00,494380,Staff,10,0,20,10
1715657296968,AESE 279B,A00,494370,Wade; Jon P,0,0,33,33
1715657297992,AIP 97,001,660915,Van Den Einde; Yael Dahlia,9998,0,9999,1
1715657299020,AIP 197,001,627712,Vespa; Emanuel Ignacio,9995,0,9999,4
1715657299020,AIP 197,002,650778,Amir; On,9998,0,9999,1
1715657299020,AIP 197,003,650933,Avenancio-Leon; Carlos,9998,0,9999,1
1715657299020,AIP 197,004,658530,Heyman; Gail D.,9998,0,9999,1
1715657299020,AIP 197,005,658631,Neal; Sonya E,9998,0,9999,1
1715657299020,AIP 197,006,658671,Du; Songzi,9998,0,9999,1
1715657300045,ANAR 135S,A00,494369,Braswell; Geoffrey E.,0,0,0,0
1715657301070,BENG 196,001,628496,Engler; Adam J.,9998,0,9999,1
1715657301070,BENG 196,002,660916,Watson; John Thomas,9998,0,9999,1
1715657302098,BISP 197,001,650773,Wilhelm; James E.,9994,0,9999,5
1715657302098,BISP 197,002,658904,Coleman; Aaron B.,9998,0,9999,1
1715657303127,CAT 124RS,A01,519847,Geibel; William,0,0,20,20
1715657304152,CAT 125RS,A01,515971,Geibel; William,0,0,20,20
1715657305182,CLRE 250,A00,511389,Morris; Sheldon,9992,0,9999,7
1715657306208,CLRE 251,A00,507176,Mehta; Ravindra L.,9992,0,9999,7
1715657306208,CLRE 251,B00,511410,Mehta; Ravindra L.,9998,0,9999,1
1715657307234,CLRE 252,A00,507189,Cuomo; Raphael Eduardo,9994,0,9999,5
1715657308264,CLRE 253,A00,507199,Vaida; Florin,9994,0,9999,5
1715657308264,CLRE 253,B00,507202,Vaida; Florin,9999,0,9999,0
1715657309289,CLRE 259,A00,507211,Patel; Hemal,9996,0,9999,3
1715657310314,CLRE 260,A00,507221,Cuomo; Raphael Eduardo,9999,0,9999,0
1715657311338,CLRE 297,001,507242,Cuomo; Raphael Eduardo,9999,0,9999,0
1715657312367,COGS 197,001,638244,Voytek; Bradley Thomas,9997,0,9999,2
1715657313393,CSE 191,A00,516875,Minnes Kemp; Mor Mia,9991,0,9999,8
1715657314418,CSE 197,001,637388,Minnes Kemp; Mor Mia,9992,0,9999,7
1715657315444,CSS 201S,A01,494383,Mignozzetti; Umberto,35,0,35,0
1715657316470,CSS 202S,A01,494387,Mignozzetti; Umberto,35,0,35,0
1715657317498,DSC 197,001,628532,Eldridge; Justin Matthew,9995,0,9999,4
1715657318527,EAP 100,A00,516065,Staff,9799,0,9999,200
1715657319554,ECE 45,A01,507414,Staff,32,0,60,28
1715657321609,ECE 111,A01,507420,Staff,11,0,50,39
1715657322636,ECE 197,001,548057,Sievenpiper; Daniel F.,9991,0,9999,8
1715657323664,EDS 115,A00,507243,Choi; Bailey Miyeon,6,0,28,22
1715657324697,EDS 117,A01,494379,Staff,0,6,34,35
1715657325723,EDS 125,A00,507246,Hopkins; Megan Beth,7,0,30,23
1715657326747,EDS 128A,A01,507264,Fargason; Sharon Gayle,5,0,26,21
1715657327774,EDS 128B,A01,507293,Pappas; Elizabeth,9,0,30,21
1715657328803,EDS 139,A00,507294,Fargason; Sharon Gayle,9,0,30,21
1715657328803,EDS 139,B00,507313,Pappas; Elizabeth,9,0,30,21
1715657329827,EDS 201,A00,507315,Staff,10,0,30,20
1715657330851,EDS 203,A01,507317,Halter; Christopher P.,10,0,30,20
1715657331877,EDS 204R,A01,507319,Halter; Christopher P.,0,3,30,30
1715657331877,EDS 204R,B01,507331,Heinzman; Erica M.,14,0,30,16
1715657332903,EDS 206R,A00,507332,Staff,0,4,30,30
1715657332903,EDS 206R,B00,507343,Staff,15,0,30,15
1715657333930,EDS 250,A00,507344,Hemans; Patricia Ann Benitez,20,0,40,20
1715657334958,EDS 281,A00,507345,Daly; Alan J.,18,0,18,0
1715657335984,EDS 284,A00,507350,Daly; Alan J.,16,0,16,0
1715657337013,EDS 286,A00,507359,Fine; Sarah,18,0,18,0
1715657338042,EDS 289C,A01,507361,Daly; Alan J.,18,0,18,0
1715657339071,EDS 290,A00,507366,Hofstetter; Carolyn,15,0,15,0
1715657340099,LIGM 5A,A00,507421,Fischer-Grunski; Eva K,17,0,20,3
1715657341124,LIGM 5B,A00,507423,Fischer-Grunski; Eva K,19,0,20,1
1715657342152,LIGM 5C,A00,507425,Fischer-Grunski; Eva K,19,0,20,1
1715657343178,LIIT 5AS,A00,507427,Carnelos; Chiara,20,0,20,0
1715657344204,LIIT 5BS,A00,507430,Carnelos; Chiara,20,0,20,0
1715657345231,LIIT 5CS,A00,507432,Carnelos; Chiara,20,0,20,0
1715657346262,LISP 5A,A00,507541,Munoz Sanchez; Alicia,11,0,20,9
1715657347289,LISP 5B,A00,507671,Munoz Sanchez; Alicia,8,0,20,12
1715657348315,LISP 5C,A00,507696,Munoz Sanchez; Alicia,7,0,20,13
1715657349341,MAE 197,001,528363,Boechler; Nicholas Sebastia,9998,0,9999,1
1715657350371,MATH 197,001,523477,Kedlaya; Kiran S.,9994,0,9999,5
1715657350371,MATH 197,002,563811,Zhang; Danna,9994,0,9999,5
1715657350371,MATH 197,003,628552,Dumitriu; Ioana,9998,0,9999,1
1715657350371,MATH 197,004,660885,Floyd; Eric,9998,0,9999,1
1715657351403,MCWP 40R,A00,518780,Staff,1,0,20,19
1715657351403,MCWP 40R,B00,518781,Carter; Jennifer A,9,0,20,11
1715657351403,MCWP 40R,C00,518783,Smith; Haydee Marie,5,0,20,15
1715657352431,MCWP 50R,A00,518791,Redela; Pamela Morgan,0,1,20,20
1715657352431,MCWP 50R,B00,518792,Krone; Jarret,0,2,20,20
1715657352431,MCWP 50R,C00,518793,Staff,0,4,20,20
1715657352431,MCWP 50R,D00,518794,Morshed; Michael James,0,2,20,20
1715657352431,MCWP 50R,E00,518795,Carter; Andrea L,0,2,20,20
1715657352431,MCWP 50R,F00,518796,Miller; Elizabeth Deen,0,1,20,20
1715657352431,MCWP 50R,G00,518797,Guillen; Melinda,0,1,20,20
1715657353456,MMW 12R,A01,514034,Herbst; Matthew,0,2,16,16
1715657353456,MMW 12R,A02,514035,Herbst; Matthew,0,0,16,16
1715657354482,MMW 13R,A01,514037,Staff,0,5,16,16
1715657354482,MMW 13R,A02,514039,Staff,0,5,16,16
1715657354482,MMW 13R,A03,628519,Staff,0,4,16,16
1715657356537,SIO 295LS,A00,523233,Staff,10,0,30,20
1715657357562,SIO 295S,A00,523232,Staff,10,0,30,20
1715657358587,SIOC 290S,A01,637330,Merrifield; Mark A,21,0,30,9
1715657359615,SIOC 291S,A01,637333,Gabriel; Corey John,21,0,30,9
1715657360643,SOCI 117,A01,494376,Staff,0,5,5,5
1715657361723,WES 237B,A00,494380,Staff,10,0,20,10
1715657363798,AESE 279B,A00,494370,Wade; Jon P,0,0,33,33
1715657364826,AIP 97,001,660915,Van Den Einde; Yael Dahlia,9998,0,9999,1
1715657365855,AIP 197,001,627712,Vespa; Emanuel Ignacio,9995,0,9999,4
1715657365855,AIP 197,002,650778,Amir; On,9998,0,9999,1
1715657365855,AIP 197,003,650933,Avenancio-Leon; Carlos,9998,0,9999,1
1715657365855,AIP 197,004,658530,Heyman; Gail D.,9998,0,9999,1
1715657365855,AIP 197,005,658631,Neal; Sonya E,9998,0,9999,1
1715657365855,AIP 197,006,658671,Du; Songzi,9998,0,9999,1
1715657366885,ANAR 135S,A00,494369,Braswell; Geoffrey E.,0,0,0,0
1715657367914,BENG 196,001,628496,Engler; Adam J.,9998,0,9999,1
1715657367914,BENG 196,002,660916,Watson; John Thomas,9998,0,9999,1
1715657368941,BISP 197,001,650773,Wilhelm; James E.,9994,0,9999,5
1715657368941,BISP 197,002,658904,Coleman; Aaron B.,9998,0,9999,1
1715657369967,CAT 124RS,A01,519847,Geibel; William,0,0,20,20
1715657370992,CAT 125RS,A01,515971,Geibel; William,0,0,20,20
1715657372017,CLRE 250,A00,511389,Morris; Sheldon,9992,0,9999,7
1715657373043,CLRE 251,A00,507176,Mehta; Ravindra L.,9992,0,9999,7
1715657373043,CLRE 251,B00,511410,Mehta; Ravindra L.,9998,0,9999,1
1715657374072,CLRE 252,A00,507189,Cuomo; Raphael Eduardo,9994,0,9999,5
1715657375098,CLRE 253,A00,507199,Vaida; Florin,9994,0,9999,5
1715657375098,CLRE 253,B00,507202,Vaida; Florin,9999,0,9999,0
1715657376123,CLRE 259,A00,507211,Patel; Hemal,9996,0,9999,3
1715657377147,CLRE 260,A00,507221,Cuomo; Raphael Eduardo,9999,0,9999,0
1715657378175,CLRE 297,001,507242,Cuomo; Raphael Eduardo,9999,0,9999,0
1715657379200,COGS 197,001,638244,Voytek; Bradley Thomas,9997,0,9999,2
1715657380226,CSE 191,A00,516875,Minnes Kemp; Mor Mia,9991,0,9999,8
1715657381252,CSE 197,001,637388,Minnes Kemp; Mor Mia,9992,0,9999,7
1715657382283,CSS 201S,A01,494383,Mignozzetti; Umberto,35,0,35,0
1715657383310,CSS 202S,A01,494387,Mignozzetti; Umberto,35,0,35,0
1715657384338,DSC 197,001,628532,Eldridge; Justin Matthew,9995,0,9999,4
1715657385366,EAP 100,A00,516065,Staff,9799,0,9999,200
1715657386393,ECE 45,A01,507414,Staff,32,0,60,28
1715657388448,ECE 111,A01,507420,Staff,11,0,50,39
1715657389475,ECE 197,001,548057,Sievenpiper; Daniel F.,9991,0,9999,8
1715657390506,EDS 115,A00,507243,Choi; Bailey Miyeon,6,0,28,22
1715657391532,EDS 117,A01,494379,Staff,0,6,34,35
1715657392557,EDS 125,A00,507246,Hopkins; Megan Beth,7,0,30,23
1715657393586,EDS 128A,A01,507264,Fargason; Sharon Gayle,5,0,26,21
1715657394611,EDS 128B,A01,507293,Pappas; Elizabeth,9,0,30,21
1715657395636,EDS 139,A00,507294,Fargason; Sharon Gayle,9,0,30,21
1715657395636,EDS 139,B00,507313,Pappas; Elizabeth,9,0,30,21
1715657396663,EDS 201,A00,507315,Staff,10,0,30,20
1715657397689,EDS 203,A01,507317,Halter; Christopher P.,10,0,30,20
1715657398714,EDS 204R,A01,507319,Halter; Christopher P.,0,3,30,30
1715657398714,EDS 204R,B01,507331,Heinzman; Erica M.,14,0,30,16
1715657399742,EDS 206R,A00,507332,Staff,0,4,30,30
1715657399742,EDS 206R,B00,507343,Staff,15,0,30,15
1715657400770,EDS 250,A00,507344,Hemans; Patricia Ann Benitez,20,0,40,20
1715657401797,EDS 281,A00,507345,Daly; Alan J.,18,0,18,0
1715657402828,EDS 284,A00,507350,Daly; Alan J.,16,0,16,0
1715657403855,EDS 286,A00,507359,Fine; Sarah,18,0,18,0
1715657404878,EDS 289C,A01,507361,Daly; Alan J.,18,0,18,0
1715657405903,EDS 290,A00,507366,Hofstetter; Carolyn,15,0,15,0
1715657406930,LIGM 5A,A00,507421,Fischer-Grunski; Eva K,17,0,20,3
1715657407954,LIGM 5B,A00,507423,Fischer-Grunski; Eva K,19,0,20,1
1715657408979,LIGM 5C,A00,507425,Fischer-Grunski; Eva K,19,0,20,1
1715657410004,LIIT 5AS,A00,507427,Carnelos; Chiara,20,0,20,0
1715657411032,LIIT 5BS,A00,507430,Carnelos; Chiara,20,0,20,0
1715657412057,LIIT 5CS,A00,507432,Carnelos; Chiara,20,0,20,0
1715657413089,LISP 5A,A00,507541,Munoz Sanchez; Alicia,11,0,20,9
1715657414114,LISP 5B,A00,507671,Munoz Sanchez; Alicia,8,0,20,12
1715657415141,LISP 5C,A00,507696,Munoz Sanchez; Alicia,7,0,20,13
1715657416169,MAE 197,001,528363,Boechler; Nicholas Sebastia,9998,0,9999,1
1715657417195,MATH 197,001,523477,Kedlaya; Kiran S.,9994,0,9999,5
1715657417195,MATH 197,002,563811,Zhang; Danna,9994,0,9999,5
1715657417195,MATH 197,003,628552,Dumitriu; Ioana,9998,0,9999,1
1715657417195,MATH 197,004,660885,Floyd; Eric,9998,0,9999,1
1715657418226,MCWP 40R,A00,518780,Staff,1,0,20,19
1715657418226,MCWP 40R,B00,518781,Carter; Jennifer A,9,0,20,11
1715657418226,MCWP 40R,C00,518783,Smith; Haydee Marie,5,0,20,15
1715657419255,MCWP 50R,A00,518791,Redela; Pamela Morgan,0,1,20,20
1715657419255,MCWP 50R,B00,518792,Krone; Jarret,0,2,20,20
1715657419255,MCWP 50R,C00,518793,Staff,0,4,20,20
1715657419255,MCWP 50R,D00,518794,Morshed; Michael James,0,2,20,20
1715657419255,MCWP 50R,E00,518795,Carter; Andrea L,0,2,20,20
1715657419255,MCWP 50R,F00,518796,Miller; Elizabeth Deen,0,1,20,20
1715657419255,MCWP 50R,G00,518797,Guillen; Melinda,0,1,20,20
1715657420280,MMW 12R,A01,514034,Herbst; Matthew,0,2,16,16
1715657420280,MMW 12R,A02,514035,Herbst; Matthew,0,0,16,16
1715657421306,MMW 13R,A01,514037,Staff,0,5,16,16
1715657421306,MMW 13R,A02,514039,Staff,0,5,16,16
1715657421306,MMW 13R,A03,628519,Staff,0,4,16,16
1715657423356,SIO 295LS,A00,523233,Staff,10,0,30,20
1715657424381,SIO 295S,A00,523232,Staff,10,0,30,20
1715657425408,SIOC 290S,A01,637330,Merrifield; Mark A,21,0,30,9
1715657426435,SIOC 291S,A01,637333,Gabriel; Corey John,21,0,30,9
1715657427464,SOCI 117,A01,494376,Staff,0,5,5,5
1715657428488,WES 237B,A00,494380,Staff,10,0,20,10
1715657430551,AESE 279B,A00,494370,Wade; Jon P,0,0,33,33
1715657431576,AIP 97,001,660915,Van Den Einde; Yael Dahlia,9998,0,9999,1
1715657432602,AIP 197,001,627712,Vespa; Emanuel Ignacio,9995,0,9999,4
1715657432602,AIP 197,002,650778,Amir; On,9998,0,9999,1
1715657432602,AIP 197,003,650933,Avenancio-Leon; Carlos,9998,0,9999,1
1715657432602,AIP 197,004,658530,Heyman; Gail D.,9998,0,9999,1
1715657432602,AIP 197,005,658631,Neal; Sonya E,9998,0,9999,1
1715657432602,AIP 197,006,658671,Du; Songzi,9998,0,9999,1
1715657433631,ANAR 135S,A00,494369,Braswell; Geoffrey E.,0,0,0,0
1715657434659,BENG 196,001,628496,Engler; Adam J.,9998,0,9999,1
1715657434659,BENG 196,002,660916,Watson; John Thomas,9998,0,9999,1
1715657435685,BISP 197,001,650773,Wilhelm; James E.,9994,0,9999,5
1715657435685,BISP 197,002,658904,Coleman; Aaron B.,9998,0,9999,1
1715657436712,CAT 124RS,A01,519847,Geibel; William,0,0,20,20
1715657437738,CAT 125RS,A01,515971,Geibel; William,0,0,20,20
1715657438768,CLRE 250,A00,511389,Morris; Sheldon,9992,0,9999,7
1715657439795,CLRE 251,A00,507176,Mehta; Ravindra L.,9992,0,9999,7
1715657439795,CLRE 251,B00,511410,Mehta; Ravindra L.,9998,0,9999,1
1715657440823,CLRE 252,A00,507189,Cuomo; Raphael Eduardo,9994,0,9999,5
1715657441848,CLRE 253,A00,507199,Vaida; Florin,9994,0,9999,5
1715657441848,CLRE 253,B00,507202,Vaida; Florin,9999,0,9999,0
1715657442874,CLRE 259,A00,507211,Patel; Hemal,9996,0,9999,3
1715657443953,CLRE 260,A00,507221,Cuomo; Raphael Eduardo,9999,0,9999,0
1715657444982,CLRE 297,001,507242,Cuomo; Raphael Eduardo,9999,0,9999,0
1715657446007,COGS 197,001,638244,Voytek; Bradley Thomas,9997,0,9999,2
1715657447032,CSE 191,A00,516875,Minnes Kemp; Mor Mia,9991,0,9999,8
1715657448058,CSE 197,001,637388,Minnes Kemp; Mor Mia,9992,0,9999,7
1715657449084,CSS 201S,A01,494383,Mignozzetti; Umberto,35,0,35,0
1715657450114,CSS 202S,A01,494387,Mignozzetti; Umberto,35,0,35,0
1715657451139,DSC 197,001,628532,Eldridge; Justin Matthew,9995,0,9999,4
1715657452167,EAP 100,A00,516065,Staff,9799,0,9999,200
1715657453199,ECE 45,A01,507414,Staff,32,0,60,28
1715657455252,ECE 111,A01,507420,Staff,11,0,50,39
1715657456279,ECE 197,001,548057,Sievenpiper; Daniel F.,9991,0,9999,8
1715657457308,EDS 115,A00,507243,Choi; Bailey Miyeon,6,0,28,22
1715657458334,EDS 117,A01,494379,Staff,0,6,34,35
1715657459363,EDS 125,A00,507246,Hopkins; Megan Beth,7,0,30,23
1715657460391,EDS 128A,A01,507264,Fargason; Sharon Gayle,5,0,26,21
1715657461416,EDS 128B,A01,507293,Pappas; Elizabeth,9,0,30,21
1715657462440,EDS 139,A00,507294,Fargason; Sharon Gayle,9,0,30,21
1715657462440,EDS 139,B00,507313,Pappas; Elizabeth,9,0,30,21
1715657463466,EDS 201,A00,507315,Staff,10,0,30,20
1715657464490,EDS 203,A01,507317,Halter; Christopher P.,10,0,30,20
1715657465571,EDS 204R,A01,507319,Halter; Christopher P.,0,3,30,30
1715657465571,EDS 204R,B01,507331,Heinzman; Erica M.,14,0,30,16
1715657466595,EDS 206R,A00,507332,Staff,0,4,30,30
1715657466595,EDS 206R,B00,507343,Staff,15,0,30,15
1715657467623,EDS 250,A00,507344,Hemans; Patricia Ann Benitez,20,0,40,20
1715657468647,EDS 281,A00,507345,Daly; Alan J.,18,0,18,0
1715657469675,EDS 284,A00,507350,Daly; Alan J.,16,0,16,0
1715657470704,EDS 286,A00,507359,Fine; Sarah,18,0,18,0
1715657471728,EDS 289C,A01,507361,Daly; Alan J.,18,0,18,0
1715657472755,EDS 290,A00,507366,Hofstetter; Carolyn,15,0,15,0
1715657473783,LIGM 5A,A00,507421,Fischer-Grunski; Eva K,17,0,20,3
1715657474810,LIGM 5B,A00,507423,Fischer-Grunski; Eva K,19,0,20,1
1715657475838,LIGM 5C,A00,507425,Fischer-Grunski; Eva K,19,0,20,1
1715657476863,LIIT 5AS,A00,507427,Carnelos; Chiara,20,0,20,0
1715657477889,LIIT 5BS,A00,507430,Carnelos; Chiara,20,0,20,0
1715657478917,LIIT 5CS,A00,507432,Carnelos; Chiara,20,0,20,0
1715657479947,LISP 5A,A00,507541,Munoz Sanchez; Alicia,11,0,20,9
1715657480977,LISP 5B,A00,507671,Munoz Sanchez; Alicia,8,0,20,12
1715657482001,LISP 5C,A00,507696,Munoz Sanchez; Alicia,7,0,20,13
1715657483026,MAE 197,001,528363,Boechler; Nicholas Sebastia,9998,0,9999,1
1715657484056,MATH 197,001,523477,Kedlaya; Kiran S.,9994,0,9999,5
1715657484056,MATH 197,002,563811,Zhang; Danna,9994,0,9999,5
1715657484056,MATH 197,003,628552,Dumitriu; Ioana,9998,0,9999,1
1715657484056,MATH 197,004,660885,Floyd; Eric,9998,0,9999,1
1715657485087,MCWP 40R,A00,518780,Staff,1,0,20,19
1715657485087,MCWP 40R,B00,518781,Carter; Jennifer A,9,0,20,11
1715657485087,MCWP 40R,C00,518783,Smith; Haydee Marie,5,0,20,15
1715657486116,MCWP 50R,A00,518791,Redela; Pamela Morgan,0,1,20,20
1715657486116,MCWP 50R,B00,518792,Krone; Jarret,0,2,20,20
1715657486116,MCWP 50R,C00,518793,Staff,0,4,20,20
1715657486116,MCWP 50R,D00,518794,Morshed; Michael James,0,2,20,20
1715657486116,MCWP 50R,E00,518795,Carter; Andrea L,0,2,20,20
1715657486116,MCWP 50R,F00,518796,Miller; Elizabeth Deen,0,1,20,20
1715657486116,MCWP 50R,G00,518797,Guillen; Melinda,0,1,20,20
1715657487147,MMW 12R,A01,514034,Herbst; Matthew,0,2,16,16
1715657487147,MMW 12R,A02,514035,Herbst; Matthew,0,0,16,16
1715657488172,MMW 13R,A01,514037,Staff,0,5,16,16
1715657488172,MMW 13R,A02,514039,Staff,0,5,16,16
1715657488172,MMW 13R,A03,628519,Staff,0,4,16,16
1715657490224,SIO 295LS,A00,523233,Staff,10,0,30,20
1715657491249,SIO 295S,A00,523232,Staff,10,0,30,20
1715657492275,SIOC 290S,A01,637330,Merrifield; Mark A,21,0,30,9
1715657493305,SIOC 291S,A01,637333,Gabriel; Corey John,21,0,30,9
1715657494335,SOCI 117,A01,494376,Staff,0,5,5,5
1715657495361,WES 237B,A00,494380,Staff,10,0,20,10
1715657497434,AESE 279B,A00,494370,Wade; Jon P,0,0,33,33
1715657498466,AIP 97,001,660915,Van Den Einde; Yael Dahlia,9998,0,9999,1
1715657499494,AIP 197,001,627712,Vespa; Emanuel Ignacio,9995,0,9999,4
1715657499494,AIP 197,002,650778,Amir; On,9998,0,9999,1
1715657499494,AIP 197,003,650933,Avenancio-Leon; Carlos,9998,0,9999,1
1715657499494,AIP 197,004,658530,Heyman; Gail D.,9998,0,9999,1
1715657499494,AIP 197,005,658631,Neal; Sonya E,9998,0,9999,1
1715657499494,AIP 197,006,658671,Du; Songzi,9998,0,9999,1
1715657500523,ANAR 135S,A00,494369,Braswell; Geoffrey E.,0,0,0,0
1715657501550,BENG 196,001,628496,Engler; Adam J.,9998,0,9999,1
1715657501550,BENG 196,002,660916,Watson; John Thomas,9998,0,9999,1
1715657502575,BISP 197,001,650773,Wilhelm; James E.,9994,0,9999,5
1715657502575,BISP 197,002,658904,Coleman; Aaron B.,9998,0,9999,1
1715657503601,CAT 124RS,A01,519847,Geibel; William,0,0,20,20
1715657504627,CAT 125RS,A01,515971,Geibel; William,0,0,20,20
1715657505653,CLRE 250,A00,511389,Morris; Sheldon,9992,0,9999,7
1715657506680,CLRE 251,A00,507176,Mehta; Ravindra L.,9992,0,9999,7
1715657506680,CLRE 251,B00,511410,Mehta; Ravindra L.,9998,0,9999,1
1715657507706,CLRE 252,A00,507189,Cuomo; Raphael Eduardo,9994,0,9999,5
1715657508732,CLRE 253,A00,507199,Vaida; Florin,9994,0,9999,5
1715657508732,CLRE 253,B00,507202,Vaida; Florin,9999,0,9999,0
1715657509756,CLRE 259,A00,507211,Patel; Hemal,9996,0,9999,3
1715657510785,CLRE 260,A00,507221,Cuomo; Raphael Eduardo,9999,0,9999,0
1715657511813,CLRE 297,001,507242,Cuomo; Raphael Eduardo,9999,0,9999,0
1715657512838,COGS 197,001,638244,Voytek; Bradley Thomas,9997,0,9999,2
1715657513865,CSE 191,A00,516875,Minnes Kemp; Mor Mia,9991,0,9999,8
1715657514891,CSE 197,001,637388,Minnes Kemp; Mor Mia,9992,0,9999,7
1715657515920,CSS 201S,A01,494383,Mignozzetti; Umberto,35,0,35,0
1715657516950,CSS 202S,A01,494387,Mignozzetti; Umberto,35,0,35,0
1715657517975,DSC 197,001,628532,Eldridge; Justin Matthew,9995,0,9999,4
1715657518999,EAP 100,A00,516065,Staff,9799,0,9999,200
1715657520028,ECE 45,A01,507414,Staff,32,0,60,28
1715657522082,ECE 111,A01,507420,Staff,11,0,50,39
1715657523110,ECE 197,001,548057,Sievenpiper; Daniel F.,9991,0,9999,8
1715657524140,EDS 115,A00,507243,Choi; Bailey Miyeon,6,0,28,22
1715657525168,EDS 117,A01,494379,Staff,0,6,34,35
1715657526193,EDS 125,A00,507246,Hopkins; Megan Beth,7,0,30,23
1715657527222,EDS 128A,A01,507264,Fargason; Sharon Gayle,5,0,26,21
1715657528252,EDS 128B,A01,507293,Pappas; Elizabeth,9,0,30,21
1715657529281,EDS 139,A00,507294,Fargason; Sharon Gayle,9,0,30,21
1715657529281,EDS 139,B00,507313,Pappas; Elizabeth,9,0,30,21
1715657530307,EDS 201,A00,507315,Staff,10,0,30,20
1715657531332,EDS 203,A01,507317,Halter; Christopher P.,10,0,30,20
1715657532358,EDS 204R,A01,507319,Halter; Christopher P.,0,3,30,30
1715657532358,EDS 204R,B01,507331,Heinzman; Erica M.,14,0,30,16
1715657533383,EDS 206R,A00,507332,Staff,0,4,30,30
1715657533383,EDS 206R,B00,507343,Staff,15,0,30,15
1715657534408,EDS 250,A00,507344,Hemans; Patricia Ann Benitez,20,0,40,20
1715657535435,EDS 281,A00,507345,Daly; Alan J.,18,0,18,0
1715657536461,EDS 284,A00,507350,Daly; Alan J.,16,0,16,0
1715657537485,EDS 286,A00,507359,Fine; Sarah,18,0,18,0
1715657538513,EDS 289C,A01,507361,Daly; Alan J.,18,0,18,0
1715657539542,EDS 290,A00,507366,Hofstetter; Carolyn,15,0,15,0
1715657540569,LIGM 5A,A00,507421,Fischer-Grunski; Eva K,17,0,20,3
1715657541596,LIGM 5B,A00,507423,Fischer-Grunski; Eva K,19,0,20,1
1715657542624,LIGM 5C,A00,507425,Fischer-Grunski; Eva K,19,0,20,1
1715657543648,LIIT 5AS,A00,507427,Carnelos; Chiara,20,0,20,0
1715657544674,LIIT 5BS,A00,507430,Carnelos; Chiara,20,0,20,0
1715657545698,LIIT 5CS,A00,507432,Carnelos; Chiara,20,0,20,0
1715657546725,LISP 5A,A00,507541,Munoz Sanchez; Alicia,11,0,20,9
1715657547752,LISP 5B,A00,507671,Munoz Sanchez; Alicia,8,0,20,12
1715657548777,LISP 5C,A00,507696,Munoz Sanchez; Alicia,7,0,20,13
1715657549802,MAE 197,001,528363,Boechler; Nicholas Sebastia,9998,0,9999,1
1715657550829,MATH 197,001,523477,Kedlaya; Kiran S.,9994,0,9999,5
1715657550829,MATH 197,002,563811,Zhang; Danna,9994,0,9999,5
1715657550829,MATH 197,003,628552,Dumitriu; Ioana,9998,0,9999,1
1715657550829,MATH 197,004,660885,Floyd; Eric,9998,0,9999,1
1715657551855,MCWP 40R,A00,518780,Staff,1,0,20,19
1715657551855,MCWP 40R,B00,518781,Carter; Jennifer A,9,0,20,11
1715657551855,MCWP 40R,C00,518783,Smith; Haydee Marie,5,0,20,15
1715657552887,MCWP 50R,A00,518791,Redela; Pamela Morgan,0,1,20,20
1715657552887,MCWP 50R,B00,518792,Krone; Jarret,0,2,20,20
1715657552887,MCWP 50R,C00,518793,Staff,0,4,20,20
1715657552887,MCWP 50R,D00,518794,Morshed; Michael James,0,2,20,20
1715657552887,MCWP 50R,E00,518795,Carter; Andrea L,0,2,20,20
1715657552887,MCWP 50R,F00,518796,Miller; Elizabeth Deen,0,1,20,20
1715657552887,MCWP 50R,G00,518797,Guillen; Melinda,0,1,20,20
1715657553912,MMW 12R,A01,514034,Herbst; Matthew,0,2,16,16
1715657553912,MMW 12R,A02,514035,Herbst; Matthew,0,0,16,16
1715657554936,MMW 13R,A01,514037,Staff,0,5,16,16
1715657554936,MMW 13R,A02,514039,Staff,0,5,16,16
1715657554936,MMW 13R,A03,628519,Staff,0,4,16,16
1715657556987,SIO 295LS,A00,523233,Staff,10,0,30,20
1715657558011,SIO 295S,A00,523232,Staff,10,0,30,20
1715657559040,SIOC 290S,A01,637330,Merrifield; Mark A,21,0,30,9
1715657560067,SIOC 291S,A01,637333,Gabriel; Corey John,21,0,30,9
1715657561092,SOCI 117,A01,494376,Staff,0,5,5,5
1715657562118,WES 237B,A00,494380,Staff,10,0,20,10
1715657564188,AESE 279B,A00,494370,Wade; Jon P,0,0,33,33
1715657565212,AIP 97,001,660915,Van Den Einde; Yael Dahlia,9998,0,9999,1
1715657566242,AIP 197,001,627712,Vespa; Emanuel Ignacio,9995,0,9999,4
1715657566242,AIP 197,002,650778,Amir; On,9998,0,9999,1
1715657566242,AIP 197,003,650933,Avenancio-Leon; Carlos,9998,0,9999,1
1715657566242,AIP 197,004,658530,Heyman; Gail D.,9998,0,9999,1
1715657566242,AIP 197,005,658631,Neal; Sonya E,9998,0,9999,1
1715657566242,AIP 197,006,658671,Du; Songzi,9998,0,9999,1
1715657567270,ANAR 135S,A00,494369,Braswell; Geoffrey E.,0,0,0,0
1715657568296,BENG 196,001,628496,Engler; Adam J.,9998,0,9999,1
1715657568296,BENG 196,002,660916,Watson; John Thomas,9998,0,9999,1
1715657569325,BISP 197,001,650773,Wilhelm; James E.,9994,0,9999,5
1715657569325,BISP 197,002,658904,Coleman; Aaron B.,9998,0,9999,1
1715657570356,CAT 124RS,A01,519847,Geibel; William,0,0,20,20
1715657571384,CAT 125RS,A01,515971,Geibel; William,0,0,20,20
1715657572410,CLRE 250,A00,511389,Morris; Sheldon,9992,0,9999,7
1715657573436,CLRE 251,A00,507176,Mehta; Ravindra L.,9992,0,9999,7
1715657573436,CLRE 251,B00,511410,Mehta; Ravindra L.,9998,0,9999,1
1715657574461,CLRE 252,A00,507189,Cuomo; Raphael Eduardo,9994,0,9999,5
1715657575487,CLRE 253,A00,507199,Vaida; Florin,9994,0,9999,5
1715657575487,CLRE 253,B00,507202,Vaida; Florin,9999,0,9999,0
1715657576512,CLRE 259,A00,507211,Patel; Hemal,9996,0,9999,3
1715657577540,CLRE 260,A00,507221,Cuomo; Raphael Eduardo,9999,0,9999,0
1715657578566,CLRE 297,001,507242,Cuomo; Raphael Eduardo,9999,0,9999,0
1715657579593,COGS 197,001,638244,Voytek; Bradley Thomas,9997,0,9999,2
1715657580623,CSE 191,A00,516875,Minnes Kemp; Mor Mia,9991,0,9999,8
1715657581652,CSE 197,001,637388,Minnes Kemp; Mor Mia,9992,0,9999,7
1715657582679,CSS 201S,A01,494383,Mignozzetti; Umberto,35,0,35,0
1715657583705,CSS 202S,A01,494387,Mignozzetti; Umberto,35,0,35,0
1715657584730,DSC 197,001,628532,Eldridge; Justin Matthew,9995,0,9999,4
1715657585754,EAP 100,A00,516065,Staff,9799,0,9999,200
1715657586783,ECE 45,A01,507414,Staff,32,0,60,28
1715657588832,ECE 111,A01,507420,Staff,11,0,50,39
1715657589857,ECE 197,001,548057,Sievenpiper; Daniel F.,9991,0,9999,8
1715657590883,EDS 115,A00,507243,Choi; Bailey Miyeon,6,0,28,22
1715657591912,EDS 117,A01,494379,Staff,0,6,34,35
1715657592941,EDS 125,A00,507246,Hopkins; Megan Beth,7,0,30,23
1715657593966,EDS 128A,A01,507264,Fargason; Sharon Gayle,5,0,26,21
1715657594994,EDS 128B,A01,507293,Pappas; Elizabeth,9,0,30,21
1715657596018,EDS 139,A00,507294,Fargason; Sharon Gayle,9,0,30,21
1715657596018,EDS 139,B00,507313,Pappas; Elizabeth,9,0,30,21
1715657597044,EDS 201,A00,507315,Staff,10,0,30,20
1715657598070,EDS 203,A01,507317,Halter; Christopher P.,10,0,30,20
1715657599097,EDS 204R,A01,507319,Halter; Christopher P.,0,3,30,30
1715657599097,EDS 204R,B01,507331,Heinzman; Erica M.,14,0,30,16
1715657600124,EDS 206R,A00,507332,Staff,0,4,30,30
1715657600124,EDS 206R,B00,507343,Staff,15,0,30,15
1715657601150,EDS 250,A00,507344,Hemans; Patricia Ann Benitez,20,0,40,20
1715657602179,EDS 281,A00,507345,Daly; Alan J.,18,0,18,0
1715657603205,EDS 284,A00,507350,Daly; Alan J.,16,0,16,0
1715657604229,EDS 286,A00,507359,Fine; Sarah,18,0,18,0
1715657605254,EDS 289C,A01,507361,Daly; Alan J.,18,0,18,0
1715657606282,EDS 290,A00,507366,Hofstetter; Carolyn,15,0,15,0
1715657607308,LIGM 5A,A00,507421,Fischer-Grunski; Eva K,17,0,20,3
1715657608336,LIGM 5B,A00,507423,Fischer-Grunski; Eva K,19,0,20,1
1715657609360,LIGM 5C,A00,507425,Fischer-Grunski; Eva K,19,0,20,1
1715657610387,LIIT 5AS,A00,507427,Carnelos; Chiara,20,0,20,0
1715657611413,LIIT 5BS,A00,507430,Carnelos; Chiara,20,0,20,0
1715657612440,LIIT 5CS,A00,507432,Carnelos; Chiara,20,0,20,0
1715657613468,LISP 5A,A00,507541,Munoz Sanchez; Alicia,11,0,20,9
1715657614497,LISP 5B,A00,507671,Munoz Sanchez; Alicia,8,0,20,12
1715657615522,LISP 5C,A00,507696,Munoz Sanchez; Alicia,7,0,20,13
1715657616552,MAE 197,001,528363,Boechler; Nicholas Sebastia,9998,0,9999,1
1715657617583,MATH 197,001,523477,Kedlaya; Kiran S.,9994,0,9999,5
1715657617583,MATH 197,002,563811,Zhang; Danna,9994,0,9999,5
1715657617583,MATH 197,003,628552,Dumitriu; Ioana,9998,0,9999,1
1715657617583,MATH 197,004,660885,Floyd; Eric,9998,0,9999,1
1715657618607,MCWP 40R,A00,518780,Staff,1,0,20,19
1715657618607,MCWP 40R,B00,518781,Carter; Jennifer A,9,0,20,11
1715657618607,MCWP 40R,C00,518783,Smith; Haydee Marie,5,0,20,15
1715657619636,MCWP 50R,A00,518791,Redela; Pamela Morgan,0,1,20,20
1715657619636,MCWP 50R,B00,518792,Krone; Jarret,0,2,20,20
1715657619636,MCWP 50R,C00,518793,Staff,0,4,20,20
1715657619636,MCWP 50R,D00,518794,Morshed; Michael James,0,2,20,20
1715657619636,MCWP 50R,E00,518795,Carter; Andrea L,0,2,20,20
1715657619636,MCWP 50R,F00,518796,Miller; Elizabeth Deen,0,1,20,20
1715657619636,MCWP 50R,G00,518797,Guillen; Melinda,0,1,20,20
1715657620662,MMW 12R,A01,514034,Herbst; Matthew,0,2,16,16
1715657620662,MMW 12R,A02,514035,Herbst; Matthew,0,0,16,16
1715657621691,MMW 13R,A01,514037,Staff,0,5,16,16
1715657621691,MMW 13R,A02,514039,Staff,0,5,16,16
1715657621691,MMW 13R,A03,628519,Staff,0,4,16,16
1715657623746,SIO 295LS,A00,523233,Staff,10,0,30,20
1715657624775,SIO 295S,A00,523232,Staff,10,0,30,20
1715657625803,SIOC 290S,A01,637330,Merrifield; Mark A,21,0,30,9
1715657626833,SIOC 291S,A01,637333,Gabriel; Corey John,21,0,30,9
1715657627864,SOCI 117,A01,494376,Staff,0,5,5,5
1715657628890,WES 237B,A00,494380,Staff,10,0,20,10
1715657630967,AESE 279B,A00,494370,Wade; Jon P,0,0,33,33
1715657631992,AIP 97,001,660915,Van Den Einde; Yael Dahlia,9998,0,9999,1
1715657633020,AIP 197,001,627712,Vespa; Emanuel Ignacio,9995,0,9999,4
1715657633020,AIP 197,002,650778,Amir; On,9998,0,9999,1
1715657633020,AIP 197,003,650933,Avenancio-Leon; Carlos,9998,0,9999,1
1715657633020,AIP 197,004,658530,Heyman; Gail D.,9998,0,9999,1
1715657633020,AIP 197,005,658631,Neal; Sonya E,9998,0,9999,1
1715657633020,AIP 197,006,658671,Du; Songzi,9998,0,9999,1
1715657634045,ANAR 135S,A00,494369,Braswell; Geoffrey E.,0,0,0,0
1715657635076,BENG 196,001,628496,Engler; Adam J.,9998,0,9999,1
1715657635076,BENG 196,002,660916,Watson; John Thomas,9998,0,9999,1
1715657636103,BISP 197,001,650773,Wilhelm; James E.,9994,0,9999,5
1715657636103,BISP 197,002,658904,Coleman; Aaron B.,9998,0,9999,1
1715657637131,CAT 124RS,A01,519847,Geibel; William,0,0,20,20
1715657638155,CAT 125RS,A01,515971,Geibel; William,0,0,20,20
1715657639180,CLRE 250,A00,511389,Morris; Sheldon,9992,0,9999,7
1715657640209,CLRE 251,A00,507176,Mehta; Ravindra L.,9992,0,9999,7
1715657640209,CLRE 251,B00,511410,Mehta; Ravindra L.,9998,0,9999,1
1715657641237,CLRE 252,A00,507189,Cuomo; Raphael Eduardo,9994,0,9999,5
1715657642261,CLRE 253,A00,507199,Vaida; Florin,9994,0,9999,5
1715657642261,CLRE 253,B00,507202,Vaida; Florin,9999,0,9999,0
1715657643287,CLRE 259,A00,507211,Patel; Hemal,9996,0,9999,3
1715657644316,CLRE 260,A00,507221,Cuomo; Raphael Eduardo,9999,0,9999,0
1715657645345,CLRE 297,001,507242,Cuomo; Raphael Eduardo,9999,0,9999,0
1715657646372,COGS 197,001,638244,Voytek; Bradley Thomas,9997,0,9999,2
1715657647400,CSE 191,A00,516875,Minnes Kemp; Mor Mia,9991,0,9999,8
1715657648427,CSE 197,001,637388,Minnes Kemp; Mor Mia,9992,0,9999,7
1715657649462,CSS 201S,A01,494383,Mignozzetti; Umberto,35,0,35,0
1715657650488,CSS 202S,A01,494387,Mignozzetti; Umberto,35,0,35,0
1715657651520,DSC 197,001,628532,Eldridge; Justin Matthew,9995,0,9999,4
1715657652548,EAP 100,A00,516065,Staff,9799,0,9999,200
1715657653584,ECE 45,A01,507414,Staff,32,0,60,28
1715657655638,ECE 111,A01,507420,Staff,11,0,50,39
1715657656662,ECE 197,001,548057,Sievenpiper; Daniel F.,9991,0,9999,8
1715657657688,EDS 115,A00,507243,Choi; Bailey Miyeon,6,0,28,22
1715657658714,EDS 117,A01,494379,Staff,0,6,34,35
1715657659738,EDS 125,A00,507246,Hopkins; Megan Beth,7,0,30,23
1715657660766,EDS 128A,A01,507264,Fargason; Sharon Gayle,5,0,26,21
1715657661792,EDS 128B,A01,507293,Pappas; Elizabeth,9,0,30,21
1715657662817,EDS 139,A00,507294,Fargason; Sharon Gayle,9,0,30,21
1715657662817,EDS 139,B00,507313,Pappas; Elizabeth,9,0,30,21
1715657663841,EDS 201,A00,507315,Staff,10,0,30,20
1715657664870,EDS 203,A01,507317,Halter; Christopher P.,10,0,30,20
1715657665901,EDS 204R,A01,507319,Halter; Christopher P.,0,3,30,30
1715657665901,EDS 204R,B01,507331,Heinzman; Erica M.,14,0,30,16
1715657666925,EDS 206R,A00,507332,Staff,0,4,30,30
1715657666925,EDS 206R,B00,507343,Staff,15,0,30,15
1715657667952,EDS 250,A00,507344,Hemans; Patricia Ann Benitez,20,0,40,20
1715657668978,EDS 281,A00,507345,Daly; Alan J.,18,0,18,0
1715657670003,EDS 284,A00,507350,Daly; Alan J.,16,0,16,0
1715657671028,EDS 286,A00,507359,Fine; Sarah,18,0,18,0
1715657672054,EDS 289C,A01,507361,Daly; Alan J.,18,0,18,0
1715657673135,EDS 290,A00,507366,Hofstetter; Carolyn,15,0,15,0
1715657674165,LIGM 5A,A00,507421,Fischer-Grunski; Eva K,17,0,20,3
1715657675194,LIGM 5B,A00,507423,Fischer-Grunski; Eva K,19,0,20,1
1715657676218,LIGM 5C,A00,507425,Fischer-Grunski; Eva K,19,0,20,1
1715657677250,LIIT 5AS,A00,507427,Carnelos; Chiara,20,0,20,0
1715657678275,LIIT 5BS,A00,507430,Carnelos; Chiara,20,0,20,0
1715657679304,LIIT 5CS,A00,507432,Carnelos; Chiara,20,0,20,0
1715657680330,LISP 5A,A00,507541,Munoz Sanchez; Alicia,11,0,20,9
1715657681357,LISP 5B,A00,507671,Munoz Sanchez; Alicia,8,0,20,12
1715657682382,LISP 5C,A00,507696,Munoz Sanchez; Alicia,7,0,20,13
1715657683411,MAE 197,001,528363,Boechler; Nicholas Sebastia,9998,0,9999,1
1715657684440,MATH 197,001,523477,Kedlaya; Kiran S.,9994,0,9999,5
1715657684440,MATH 197,002,563811,Zhang; Danna,9994,0,9999,5
1715657684440,MATH 197,003,628552,Dumitriu; Ioana,9998,0,9999,1
1715657684440,MATH 197,004,660885,Floyd; Eric,9998,0,9999,1
1715657685469,MCWP 40R,A00,518780,Staff,1,0,20,19
1715657685469,MCWP 40R,B00,518781,Carter; Jennifer A,9,0,20,11
1715657685469,MCWP 40R,C00,518783,Smith; Haydee Marie,5,0,20,15
1715657686503,MCWP 50R,A00,518791,Redela; Pamela Morgan,0,1,20,20
1715657686503,MCWP 50R,B00,518792,Krone; Jarret,0,2,20,20
1715657686503,MCWP 50R,C00,518793,Staff,0,4,20,20
1715657686503,MCWP 50R,D00,518794,Morshed; Michael James,0,2,20,20
1715657686503,MCWP 50R,E00,518795,Carter; Andrea L,0,2,20,20
1715657686503,MCWP 50R,F00,518796,Miller; Elizabeth Deen,0,1,20,20
1715657686503,MCWP 50R,G00,518797,Guillen; Melinda,0,1,20,20
1715657687530,MMW 12R,A01,514034,Herbst; Matthew,0,2,16,16
1715657687530,MMW 12R,A02,514035,Herbst; Matthew,0,0,16,16
1715657688559,MMW 13R,A01,514037,Staff,0,5,16,16
1715657688559,MMW 13R,A02,514039,Staff,0,5,16,16
1715657688559,MMW 13R,A03,628519,Staff,0,4,16,16
1715657690611,SIO 295LS,A00,523233,Staff,10,0,30,20
1715657691642,SIO 295S,A00,523232,Staff,10,0,30,20
1715657692674,SIOC 290S,A01,637330,Merrifield; Mark A,21,0,30,9
1715657693701,SIOC 291S,A01,637333,Gabriel; Corey John,21,0,30,9
1715657694728,SOCI 117,A01,494376,Staff,0,5,5,5
1715657695757,WES 237B,A00,494380,Staff,10,0,20,10
1715657697832,AESE 279B,A00,494370,Wade; Jon P,0,0,33,33
1715657698858,AIP 97,001,660915,Van Den Einde; Yael Dahlia,9998,0,9999,1
1715657699887,AIP 197,001,627712,Vespa; Emanuel Ignacio,9995,0,9999,4
1715657699887,AIP 197,002,650778,Amir; On,9998,0,9999,1
1715657699887,AIP 197,003,650933,Avenancio-Leon; Carlos,9998,0,9999,1
1715657699887,AIP 197,004,658530,Heyman; Gail D.,9998,0,9999,1
1715657699887,AIP 197,005,658631,Neal; Sonya E,9998,0,9999,1
1715657699887,AIP 197,006,658671,Du; Songzi,9998,0,9999,1
1715657700915,ANAR 135S,A00,494369,Braswell; Geoffrey E.,0,0,0,0
1715657701941,BENG 196,001,628496,Engler; Adam J.,9998,0,9999,1
1715657701941,BENG 196,002,660916,Watson; John Thomas,9998,0,9999,1
1715657702973,BISP 197,001,650773,Wilhelm; James E.,9994,0,9999,5
1715657702973,BISP 197,002,658904,Coleman; Aaron B.,9998,0,9999,1
1715657704000,CAT 124RS,A01,519847,Geibel; William,0,0,20,20
1715657705027,CAT 125RS,A01,515971,Geibel; William,0,0,20,20
1715657706054,CLRE 250,A00,511389,Morris; Sheldon,9992,0,9999,7
1715657707082,CLRE 251,A00,507176,Mehta; Ravindra L.,9992,0,9999,7
1715657707082,CLRE 251,B00,511410,Mehta; Ravindra L.,9998,0,9999,1
1715657708111,CLRE 252,A00,507189,Cuomo; Raphael Eduardo,9994,0,9999,5
1715657709136,CLRE 253,A00,507199,Vaida; Florin,9994,0,9999,5
1715657709136,CLRE 253,B00,507202,Vaida; Florin,9999,0,9999,0
1715657710164,CLRE 259,A00,507211,Patel; Hemal,9996,0,9999,3
1715657711189,CLRE 260,A00,507221,Cuomo; Raphael Eduardo,9999,0,9999,0
1715657712215,CLRE 297,001,507242,Cuomo; Raphael Eduardo,9999,0,9999,0
1715657713241,COGS 197,001,638244,Voytek; Bradley Thomas,9997,0,9999,2
1715657714267,CSE 191,A00,516875,Minnes Kemp; Mor Mia,9991,0,9999,8
1715657715294,CSE 197,001,637388,Minnes Kemp; Mor Mia,9992,0,9999,7
1715657716326,CSS 201S,A01,494383,Mignozzetti; Umberto,35,0,35,0
1715657717353,CSS 202S,A01,494387,Mignozzetti; Umberto,35,0,35,0
1715657718382,DSC 197,001,628532,Eldridge; Justin Matthew,9995,0,9999,4
1715657719409,EAP 100,A00,516065,Staff,9799,0,9999,200
1715657720442,ECE 45,A01,507414,Staff,32,0,60,28
1715657722496,ECE 111,A01,507420,Staff,11,0,50,39
1715657723525,ECE 197,001,548057,Sievenpiper; Daniel F.,9991,0,9999,8
1715657724553,EDS 115,A00,507243,Choi; Bailey Miyeon,6,0,28,22
1715657725578,EDS 117,A01,494379,Staff,0,6,34,35
1715657726604,EDS 125,A00,507246,Hopkins; Megan Beth,7,0,30,23
1715657727634,EDS 128A,A01,507264,Fargason; Sharon Gayle,5,0,26,21
1715657728659,EDS 128B,A01,507293,Pappas; Elizabeth,9,0,30,21
1715657729687,EDS 139,A00,507294,Fargason; Sharon Gayle,9,0,30,21
1715657729687,EDS 139,B00,507313,Pappas; Elizabeth,9,0,30,21
1715657730712,EDS 201,A00,507315,Staff,10,0,30,20
1715657731742,EDS 203,A01,507317,Halter; Christopher P.,10,0,30,20
1715657732771,EDS 204R,A01,507319,Halter; Christopher P.,0,3,30,30
1715657732771,EDS 204R,B01,507331,Heinzman; Erica M.,14,0,30,16
1715657733795,EDS 206R,A00,507332,Staff,0,4,30,30
1715657733795,EDS 206R,B00,507343,Staff,15,0,30,15
1715657734820,EDS 250,A00,507344,Hemans; Patricia Ann Benitez,20,0,40,20
1715657735849,EDS 281,A00,507345,Daly; Alan J.,18,0,18,0
1715657736875,EDS 284,A00,507350,Daly; Alan J.,16,0,16,0
1715657737899,EDS 286,A00,507359,Fine; Sarah,18,0,18,0
1715657738924,EDS 289C,A01,507361,Daly; Alan J.,18,0,18,0
1715657739952,EDS 290,A00,507366,Hofstetter; Carolyn,15,0,15,0
1715657740979,LIGM 5A,A00,507421,Fischer-Grunski; Eva K,17,0,20,3
1715657742003,LIGM 5B,A00,507423,Fischer-Grunski; Eva K,19,0,20,1
1715657743029,LIGM 5C,A00,507425,Fischer-Grunski; Eva K,19,0,20,1
1715657744055,LIIT 5AS,A00,507427,Carnelos; Chiara,20,0,20,0
1715657745080,LIIT 5BS,A00,507430,Carnelos; Chiara,20,0,20,0
1715657746109,LIIT 5CS,A00,507432,Carnelos; Chiara,20,0,20,0
1715657747137,LISP 5A,A00,507541,Munoz Sanchez; Alicia,11,0,20,9
1715657748162,LISP 5B,A00,507671,Munoz Sanchez; Alicia,8,0,20,12
1715657749190,LISP 5C,A00,507696,Munoz Sanchez; Alicia,7,0,20,13
1715657750216,MAE 197,001,528363,Boechler; Nicholas Sebastia,9998,0,9999,1
1715657751247,MATH 197,001,523477,Kedlaya; Kiran S.,9994,0,9999,5
1715657751247,MATH 197,002,563811,Zhang; Danna,9994,0,9999,5
1715657751247,MATH 197,003,628552,Dumitriu; Ioana,9998,0,9999,1
1715657751247,MATH 197,004,660885,Floyd; Eric,9998,0,9999,1
1715657752273,MCWP 40R,A00,518780,Staff,1,0,20,19
1715657752273,MCWP 40R,B00,518781,Carter; Jennifer A,9,0,20,11
1715657752273,MCWP 40R,C00,518783,Smith; Haydee Marie,5,0,20,15
1715657753302,MCWP 50R,A00,518791,Redela; Pamela Morgan,0,1,20,20
1715657753302,MCWP 50R,B00,518792,Krone; Jarret,0,2,20,20
1715657753302,MCWP 50R,C00,518793,Staff,0,4,20,20
1715657753302,MCWP 50R,D00,518794,Morshed; Michael James,0,2,20,20
1715657753302,MCWP 50R,E00,518795,Carter; Andrea L,0,2,20,20
1715657753302,MCWP 50R,F00,518796,Miller; Elizabeth Deen,0,1,20,20
1715657753302,MCWP 50R,G00,518797,Guillen; Melinda,0,1,20,20
1715657754328,MMW 12R,A01,514034,Herbst; Matthew,0,2,16,16
1715657754328,MMW 12R,A02,514035,Herbst; Matthew,0,0,16,16
1715657755353,MMW 13R,A01,514037,Staff,0,5,16,16
1715657755353,MMW 13R,A02,514039,Staff,0,5,16,16
1715657755353,MMW 13R,A03,628519,Staff,0,4,16,16
1715657757404,SIO 295LS,A00,523233,Staff,10,0,30,20
1715657758429,SIO 295S,A00,523232,Staff,10,0,30,20
1715657759460,SIOC 290S,A01,637330,Merrifield; Mark A,21,0,30,9
1715657760489,SIOC 291S,A01,637333,Gabriel; Corey John,21,0,30,9
1715657761515,SOCI 117,A01,494376,Staff,0,5,5,5
1715657762543,WES 237B,A00,494380,Staff,10,0,20,10
1715657764613,AESE 279B,A00,494370,Wade; Jon P,0,0,33,33
1715657765638,AIP 97,001,660915,Van Den Einde; Yael Dahlia,9998,0,9999,1
1715657766665,AIP 197,001,627712,Vespa; Emanuel Ignacio,9995,0,9999,4
1715657766665,AIP 197,002,650778,Amir; On,9998,0,9999,1
1715657766665,AIP 197,003,650933,Avenancio-Leon; Carlos,9998,0,9999,1
1715657766665,AIP 197,004,658530,Heyman; Gail D.,9998,0,9999,1
1715657766665,AIP 197,005,658631,Neal; Sonya E,9998,0,9999,1
1715657766665,AIP 197,006,658671,Du; Songzi,9998,0,9999,1
1715657767695,ANAR 135S,A00,494369,Braswell; Geoffrey E.,0,0,0,0
1715657768721,BENG 196,001,628496,Engler; Adam J.,9998,0,9999,1
1715657768721,BENG 196,002,660916,Watson; John Thomas,9998,0,9999,1
1715657769748,BISP 197,001,650773,Wilhelm; James E.,9994,0,9999,5
1715657769748,BISP 197,002,658904,Coleman; Aaron B.,9998,0,9999,1
1715657770777,CAT 124RS,A01,519847,Geibel; William,0,0,20,20
1715657771802,CAT 125RS,A01,515971,Geibel; William,0,0,20,20
1715657772830,CLRE 250,A00,511389,Morris; Sheldon,9992,0,9999,7
1715657773859,CLRE 251,A00,507176,Mehta; Ravindra L.,9992,0,9999,7
1715657773859,CLRE 251,B00,511410,Mehta; Ravindra L.,9998,0,9999,1
1715657774883,CLRE 252,A00,507189,Cuomo; Raphael Eduardo,9994,0,9999,5
1715657775910,CLRE 253,A00,507199,Vaida; Florin,9994,0,9999,5
1715657775910,CLRE 253,B00,507202,Vaida; Florin,9999,0,9999,0
1715657776990,CLRE 259,A00,507211,Patel; Hemal,9996,0,9999,3
1715657778015,CLRE 260,A00,507221,Cuomo; Raphael Eduardo,9999,0,9999,0
1715657779041,CLRE 297,001,507242,Cuomo; Raphael Eduardo,9999,0,9999,0
1715657780065,COGS 197,001,638244,Voytek; Bradley Thomas,9997,0,9999,2
1715657781091,CSE 191,A00,516875,Minnes Kemp; Mor Mia,9991,0,9999,8
1715657782115,CSE 197,001,637388,Minnes Kemp; Mor Mia,9992,0,9999,7
1715657783145,CSS 201S,A01,494383,Mignozzetti; Umberto,35,0,35,0
1715657784174,CSS 202S,A01,494387,Mignozzetti; Umberto,35,0,35,0
1715657785202,DSC 197,001,628532,Eldridge; Justin Matthew,9995,0,9999,4
1715657786226,EAP 100,A00,516065,Staff,9799,0,9999,200
1715657787252,ECE 45,A01,507414,Staff,32,0,60,28
1715657789302,ECE 111,A01,507420,Staff,11,0,50,39
1715657790327,ECE 197,001,548057,Sievenpiper; Daniel F.,9991,0,9999,8
1715657791355,EDS 115,A00,507243,Choi; Bailey Miyeon,6,0,28,22
1715657792381,EDS 117,A01,494379,Staff,0,6,34,35
1715657793409,EDS 125,A00,507246,Hopkins; Megan Beth,7,0,30,23
1715657794436,EDS 128A,A01,507264,Fargason; Sharon Gayle,5,0,26,21
1715657795462,EDS 128B,A01,507293,Pappas; Elizabeth,9,0,30,21
1715657796486,EDS 139,A00,507294,Fargason; Sharon Gayle,9,0,30,21
1715657796486,EDS 139,B00,507313,Pappas; Elizabeth,9,0,30,21
1715657797511,EDS 201,A00,507315,Staff,10,0,30,20
1715657798541,EDS 203,A01,507317,Halter; Christopher P.,10,0,30,20
1715657799568,EDS 204R,A01,507319,Halter; Christopher P.,0,3,30,30
1715657799568,EDS 204R,B01,507331,Heinzman; Erica M.,14,0,30,16
1715657800595,EDS 206R,A00,507332,Staff,0,4,30,30
1715657800595,EDS 206R,B00,507343,Staff,15,0,30,15
1715657801624,EDS 250,A00,507344,Hemans; Patricia Ann Benitez,20,0,40,20
1715657802651,EDS 281,A00,507345,Daly; Alan J.,18,0,18,0
1715657803677,EDS 284,A00,507350,Daly; Alan J.,16,0,16,0
1715657804707,EDS 286,A00,507359,Fine; Sarah,18,0,18,0
1715657805731,EDS 289C,A01,507361,Daly; Alan J.,18,0,18,0
1715657806754,EDS 290,A00,507366,Hofstetter; Carolyn,15,0,15,0
1715657807786,LIGM 5A,A00,507421,Fischer-Grunski; Eva K,17,0,20,3
1715657808810,LIGM 5B,A00,507423,Fischer-Grunski; Eva K,19,0,20,1
1715657809838,LIGM 5C,A00,507425,Fischer-Grunski; Eva K,19,0,20,1
1715657810864,LIIT 5AS,A00,507427,Carnelos; Chiara,20,0,20,0
1715657811889,LIIT 5BS,A00,507430,Carnelos; Chiara,20,0,20,0
1715657812918,LIIT 5CS,A00,507432,Carnelos; Chiara,20,0,20,0
1715657813947,LISP 5A,A00,507541,Munoz Sanchez; Alicia,11,0,20,9
1715657814972,LISP 5B,A00,507671,Munoz Sanchez; Alicia,8,0,20,12
1715657816003,LISP 5C,A00,507696,Munoz Sanchez; Alicia,7,0,20,13
1715657817028,MAE 197,001,528363,Boechler; Nicholas Sebastia,9998,0,9999,1
1715657818061,MATH 197,001,523477,Kedlaya; Kiran S.,9994,0,9999,5
1715657818061,MATH 197,002,563811,Zhang; Danna,9994,0,9999,5
1715657818061,MATH 197,003,628552,Dumitriu; Ioana,9998,0,9999,1
1715657818061,MATH 197,004,660885,Floyd; Eric,9998,0,9999,1
1715657819086,MCWP 40R,A00,518780,Staff,1,0,20,19
1715657819086,MCWP 40R,B00,518781,Carter; Jennifer A,9,0,20,11
1715657819086,MCWP 40R,C00,518783,Smith; Haydee Marie,5,0,20,15
1715657820125,MCWP 50R,A00,518791,Redela; Pamela Morgan,0,1,20,20
1715657820125,MCWP 50R,B00,518792,Krone; Jarret,0,2,20,20
1715657820125,MCWP 50R,C00,518793,Staff,0,4,20,20
1715657820125,MCWP 50R,D00,518794,Morshed; Michael James,0,2,20,20
1715657820125,MCWP 50R,E00,518795,Carter; Andrea L,0,2,20,20
1715657820125,MCWP 50R,F00,518796,Miller; Elizabeth Deen,0,1,20,20
1715657820125,MCWP 50R,G00,518797,Guillen; Melinda,0,1,20,20
1715657821152,MMW 12R,A01,514034,Herbst; Matthew,0,2,16,16
1715657821152,MMW 12R,A02,514035,Herbst; Matthew,0,0,16,16
1715657822178,MMW 13R,A01,514037,Staff,0,5,16,16
1715657822178,MMW 13R,A02,514039,Staff,0,5,16,16
1715657822178,MMW 13R,A03,628519,Staff,0,4,16,16
1715657824234,SIO 295LS,A00,523233,Staff,10,0,30,20
1715657825258,SIO 295S,A00,523232,Staff,10,0,30,20
1715657826283,SIOC 290S,A01,637330,Merrifield; Mark A,21,0,30,9
1715657827311,SIOC 291S,A01,637333,Gabriel; Corey John,21,0,30,9
1715657828338,SOCI 117,A01,494376,Staff,0,5,5,5
1715657829366,WES 237B,A00,494380,Staff,10,0,20,10
1715657831448,AESE 279B,A00,494370,Wade; Jon P,0,0,33,33
1715657832475,AIP 97,001,660915,Van Den Einde; Yael Dahlia,9998,0,9999,1
1715657833508,AIP 197,001,627712,Vespa; Emanuel Ignacio,9995,0,9999,4
1715657833508,AIP 197,002,650778,Amir; On,9998,0,9999,1
1715657833508,AIP 197,003,650933,Avenancio-Leon; Carlos,9998,0,9999,1
1715657833508,AIP 197,004,658530,Heyman; Gail D.,9998,0,9999,1
1715657833508,AIP 197,005,658631,Neal; Sonya E,9998,0,9999,1
1715657833508,AIP 197,006,658671,Du; Songzi,9998,0,9999,1
1715657834534,ANAR 135S,A00,494369,Braswell; Geoffrey E.,0,0,0,0
1715657835563,BENG 196,001,628496,Engler; Adam J.,9998,0,9999,1
1715657835563,BENG 196,002,660916,Watson; John Thomas,9998,0,9999,1
1715657836594,BISP 197,001,650773,Wilhelm; James E.,9994,0,9999,5
1715657836594,BISP 197,002,658904,Coleman; Aaron B.,9998,0,9999,1
1715657837619,CAT 124RS,A01,519847,Geibel; William,0,0,20,20
1715657838644,CAT 125RS,A01,515971,Geibel; William,0,0,20,20
1715657839673,CLRE 250,A00,511389,Morris; Sheldon,9992,0,9999,7
1715657840703,CLRE 251,A00,507176,Mehta; Ravindra L.,9992,0,9999,7
1715657840703,CLRE 251,B00,511410,Mehta; Ravindra L.,9998,0,9999,1
1715657841728,CLRE 252,A00,507189,Cuomo; Raphael Eduardo,9994,0,9999,5
1715657842758,CLRE 253,A00,507199,Vaida; Florin,9994,0,9999,5
1715657842758,CLRE 253,B00,507202,Vaida; Florin,9999,0,9999,0
1715657843783,CLRE 259,A00,507211,Patel; Hemal,9996,0,9999,3
1715657844808,CLRE 260,A00,507221,Cuomo; Raphael Eduardo,9999,0,9999,0
1715657845833,CLRE 297,001,507242,Cuomo; Raphael Eduardo,9999,0,9999,0
1715657846859,COGS 197,001,638244,Voytek; Bradley Thomas,9997,0,9999,2
1715657847882,CSE 191,A00,516875,Minnes Kemp; Mor Mia,9991,0,9999,8
1715657848904,CSE 197,001,637388,Minnes Kemp; Mor Mia,9992,0,9999,7
1715657849929,CSS 201S,A01,494383,Mignozzetti; Umberto,35,0,35,0
1715657850957,CSS 202S,A01,494387,Mignozzetti; Umberto,35,0,35,0
1715657851981,DSC 197,001,628532,Eldridge; Justin Matthew,9995,0,9999,4
1715657853008,EAP 100,A00,516065,Staff,9799,0,9999,200
1715657854035,ECE 45,A01,507414,Staff,32,0,60,28
1715657856088,ECE 111,A01,507420,Staff,11,0,50,39
1715657857118,ECE 197,001,548057,Sievenpiper; Daniel F.,9991,0,9999,8
1715657858146,EDS 115,A00,507243,Choi; Bailey Miyeon,6,0,28,22
1715657859175,EDS 117,A01,494379,Staff,0,6,34,35
1715657860202,EDS 125,A00,507246,Hopkins; Megan Beth,7,0,30,23
1715657861227,EDS 128A,A01,507264,Fargason; Sharon Gayle,5,0,26,21
1715657862254,EDS 128B,A01,507293,Pappas; Elizabeth,9,0,30,21
1715657863283,EDS 139,A00,507294,Fargason; Sharon Gayle,9,0,30,21
1715657863283,EDS 139,B00,507313,Pappas; Elizabeth,9,0,30,21
1715657864310,EDS 201,A00,507315,Staff,10,0,30,20
1715657865337,EDS 203,A01,507317,Halter; Christopher P.,10,0,30,20
1715657866363,EDS 204R,A01,507319,Halter; Christopher P.,0,3,30,30
1715657866363,EDS 204R,B01,507331,Heinzman; Erica M.,14,0,30,16
1715657867388,EDS 206R,A00,507332,Staff,0,4,30,30
1715657867388,EDS 206R,B00,507343,Staff,15,0,30,15
1715657868417,EDS 250,A00,507344,Hemans; Patricia Ann Benitez,20,0,40,20
1715657869442,EDS 281,A00,507345,Daly; Alan J.,18,0,18,0
1715657870466,EDS 284,A00,507350,Daly; Alan J.,16,0,16,0
1715657871495,EDS 286,A00,507359,Fine; Sarah,18,0,18,0
1715657872520,EDS 289C,A01,507361,Daly; Alan J.,18,0,18,0
1715657873544,EDS 290,A00,507366,Hofstetter; Carolyn,15,0,15,0
1715657874570,LIGM 5A,A00,507421,Fischer-Grunski; Eva K,17,0,20,3
1715657875594,LIGM 5B,A00,507423,Fischer-Grunski; Eva K,19,0,20,1
1715657876618,LIGM 5C,A00,507425,Fischer-Grunski; Eva K,19,0,20,1
1715657877643,LIIT 5AS,A00,507427,Carnelos; Chiara,20,0,20,0
1715657878669,LIIT 5BS,A00,507430,Carnelos; Chiara,20,0,20,0
1715657879694,LIIT 5CS,A00,507432,Carnelos; Chiara,20,0,20,0
1715657880777,LISP 5A,A00,507541,Munoz Sanchez; Alicia,11,0,20,9
1715657881807,LISP 5B,A00,507671,Munoz Sanchez; Alicia,8,0,20,12
1715657882831,LISP 5C,A00,507696,Munoz Sanchez; Alicia,7,0,20,13
1715657883857,MAE 197,001,528363,Boechler; Nicholas Sebastia,9998,0,9999,1
1715657884884,MATH 197,001,523477,Kedlaya; Kiran S.,9994,0,9999,5
1715657884884,MATH 197,002,563811,Zhang; Danna,9994,0,9999,5
1715657884884,MATH 197,003,628552,Dumitriu; Ioana,9998,0,9999,1
1715657884884,MATH 197,004,660885,Floyd; Eric,9998,0,9999,1
1715657885914,MCWP 40R,A00,518780,Staff,1,0,20,19
1715657885914,MCWP 40R,B00,518781,Carter; Jennifer A,9,0,20,11
1715657885914,MCWP 40R,C00,518783,Smith; Haydee Marie,5,0,20,15
1715657886950,MCWP 50R,A00,518791,Redela; Pamela Morgan,0,1,20,20
1715657886950,MCWP 50R,B00,518792,Krone; Jarret,0,2,20,20
1715657886950,MCWP 50R,C00,518793,Staff,0,4,20,20
1715657886950,MCWP 50R,D00,518794,Morshed; Michael James,0,2,20,20
1715657886950,MCWP 50R,E00,518795,Carter; Andrea L,0,2,20,20
1715657886950,MCWP 50R,F00,518796,Miller; Elizabeth Deen,0,1,20,20
1715657886950,MCWP 50R,G00,518797,Guillen; Melinda,0,1,20,20
1715657887975,MMW 12R,A01,514034,Herbst; Matthew,0,2,16,16
1715657887975,MMW 12R,A02,514035,Herbst; Matthew,0,0,16,16
1715657889002,MMW 13R,A01,514037,Staff,0,5,16,16
1715657889002,MMW 13R,A02,514039,Staff,0,5,16,16
1715657889002,MMW 13R,A03,628519,Staff,0,4,16,16
1715657891055,SIO 295LS,A00,523233,Staff,10,0,30,20
1715657892084,SIO 295S,A00,523232,Staff,10,0,30,20
1715657893128,SIOC 290S,A01,637330,Merrifield; Mark A,21,0,30,9
1715657894153,SIOC 291S,A01,637333,Gabriel; Corey John,21,0,30,9
1715657895181,SOCI 117,A01,494376,Staff,0,5,5,5
1715657896207,WES 237B,A00,494380,Staff,10,0,20,10
1715657898277,AESE 279B,A00,494370,Wade; Jon P,0,0,33,33
1715657899303,AIP 97,001,660915,Van Den Einde; Yael Dahlia,9998,0,9999,1
1715657900331,AIP 197,001,627712,Vespa; Emanuel Ignacio,9995,0,9999,4
1715657900331,AIP 197,002,650778,Amir; On,9998,0,9999,1
1715657900331,AIP 197,003,650933,Avenancio-Leon; Carlos,9998,0,9999,1
1715657900331,AIP 197,004,658530,Heyman; Gail D.,9998,0,9999,1
1715657900331,AIP 197,005,658631,Neal; Sonya E,9998,0,9999,1
1715657900331,AIP 197,006,658671,Du; Songzi,9998,0,9999,1
1715657901357,ANAR 135S,A00,494369,Braswell; Geoffrey E.,0,0,0,0
1715657902386,BENG 196,001,628496,Engler; Adam J.,9998,0,9999,1
1715657902386,BENG 196,002,660916,Watson; John Thomas,9998,0,9999,1
1715657903416,BISP 197,001,650773,Wilhelm; James E.,9994,0,9999,5
1715657903416,BISP 197,002,658904,Coleman; Aaron B.,9998,0,9999,1
1715657904446,CAT 124RS,A01,519847,Geibel; William,0,0,20,20
1715657905475,CAT 125RS,A01,515971,Geibel; William,0,0,20,20
1715657906502,CLRE 250,A00,511389,Morris; Sheldon,9992,0,9999,7
1715657907529,CLRE 251,A00,507176,Mehta; Ravindra L.,9992,0,9999,7
1715657907529,CLRE 251,B00,511410,Mehta; Ravindra L.,9998,0,9999,1
1715657908559,CLRE 252,A00,507189,Cuomo; Raphael Eduardo,9994,0,9999,5
1715657909586,CLRE 253,A00,507199,Vaida; Florin,9994,0,9999,5
1715657909586,CLRE 253,B00,507202,Vaida; Florin,9999,0,9999,0
1715657910615,CLRE 259,A00,507211,Patel; Hemal,9996,0,9999,3
1715657911645,CLRE 260,A00,507221,Cuomo; Raphael Eduardo,9999,0,9999,0
1715657912671,CLRE 297,001,507242,Cuomo; Raphael Eduardo,9999,0,9999,0
1715657913701,COGS 197,001,638244,Voytek; Bradley Thomas,9997,0,9999,2
1715657914727,CSE 191,A00,516875,Minnes Kemp; Mor Mia,9991,0,9999,8
1715657915751,CSE 197,001,637388,Minnes Kemp; Mor Mia,9992,0,9999,7
1715657916783,CSS 201S,A01,494383,Mignozzetti; Umberto,35,0,35,0
1715657917808,CSS 202S,A01,494387,Mignozzetti; Umberto,35,0,35,0
1715657918838,DSC 197,001,628532,Eldridge; Justin Matthew,9995,0,9999,4
1715657919863,EAP 100,A00,516065,Staff,9799,0,9999,200
1715657920891,ECE 45,A01,507414,Staff,32,0,60,28
1715657922944,ECE 111,A01,507420,Staff,11,0,50,39
1715657923974,ECE 197,001,548057,Sievenpiper; Daniel F.,9991,0,9999,8
1715657925006,EDS 115,A00,507243,Choi; Bailey Miyeon,6,0,28,22
1715657926031,EDS 117,A01,494379,Staff,0,6,34,35
1715657927061,EDS 125,A00,507246,Hopkins; Megan Beth,7,0,30,23
1715657928086,EDS 128A,A01,507264,Fargason; Sharon Gayle,5,0,26,21
1715657929113,EDS 128B,A01,507293,Pappas; Elizabeth,9,0,30,21
1715657930140,EDS 139,A00,507294,Fargason; Sharon Gayle,9,0,30,21
1715657930140,EDS 139,B00,507313,Pappas; Elizabeth,9,0,30,21
1715657931167,EDS 201,A00,507315,Staff,10,0,30,20
1715657932193,EDS 203,A01,507317,Halter; Christopher P.,10,0,30,20
1715657933220,EDS 204R,A01,507319,Halter; Christopher P.,0,3,30,30
1715657933220,EDS 204R,B01,507331,Heinzman; Erica M.,14,0,30,16
1715657934247,EDS 206R,A00,507332,Staff,0,4,30,30
1715657934247,EDS 206R,B00,507343,Staff,15,0,30,15
1715657935273,EDS 250,A00,507344,Hemans; Patricia Ann Benitez,20,0,40,20
1715657936298,EDS 281,A00,507345,Daly; Alan J.,18,0,18,0
1715657937325,EDS 284,A00,507350,Daly; Alan J.,16,0,16,0
1715657938354,EDS 286,A00,507359,Fine; Sarah,18,0,18,0
1715657939387,EDS 289C,A01,507361,Daly; Alan J.,18,0,18,0
1715657940412,EDS 290,A00,507366,Hofstetter; Carolyn,15,0,15,0
1715657941444,LIGM 5A,A00,507421,Fischer-Grunski; Eva K,17,0,20,3
1715657942472,LIGM 5B,A00,507423,Fischer-Grunski; Eva K,19,0,20,1
1715657943502,LIGM 5C,A00,507425,Fischer-Grunski; Eva K,19,0,20,1
1715657944530,LIIT 5AS,A00,507427,Carnelos; Chiara,20,0,20,0
1715657945561,LIIT 5BS,A00,507430,Carnelos; Chiara,20,0,20,0
1715657946589,LIIT 5CS,A00,507432,Carnelos; Chiara,20,0,20,0
1715657947620,LISP 5A,A00,507541,Munoz Sanchez; Alicia,11,0,20,9
1715657948649,LISP 5B,A00,507671,Munoz Sanchez; Alicia,8,0,20,12
1715657949674,LISP 5C,A00,507696,Munoz Sanchez; Alicia,7,0,20,13
1715657950705,MAE 197,001,528363,Boechler; Nicholas Sebastia,9998,0,9999,1
1715657951734,MATH 197,001,523477,Kedlaya; Kiran S.,9994,0,9999,5
1715657951734,MATH 197,002,563811,Zhang; Danna,9994,0,9999,5
1715657951734,MATH 197,003,628552,Dumitriu; Ioana,9998,0,9999,1
1715657951734,MATH 197,004,660885,Floyd; Eric,9998,0,9999,1
1715657952767,MCWP 40R,A00,518780,Staff,1,0,20,19
1715657952767,MCWP 40R,B00,518781,Carter; Jennifer A,9,0,20,11
1715657952767,MCWP 40R,C00,518783,Smith; Haydee Marie,5,0,20,15
1715657953797,MCWP 50R,A00,518791,Redela; Pamela Morgan,0,1,20,20
1715657953797,MCWP 50R,B00,518792,Krone; Jarret,0,2,20,20
1715657953797,MCWP 50R,C00,518793,Staff,0,4,20,20
1715657953797,MCWP 50R,D00,518794,Morshed; Michael James,0,2,20,20
1715657953797,MCWP 50R,E00,518795,Carter; Andrea L,0,2,20,20
1715657953797,MCWP 50R,F00,518796,Miller; Elizabeth Deen,0,1,20,20
1715657953797,MCWP 50R,G00,518797,Guillen; Melinda,0,1,20,20
1715657954823,MMW 12R,A01,514034,Herbst; Matthew,0,2,16,16
1715657954823,MMW 12R,A02,514035,Herbst; Matthew,0,0,16,16
1715657955849,MMW 13R,A01,514037,Staff,0,5,16,16
1715657955849,MMW 13R,A02,514039,Staff,0,5,16,16
1715657955849,MMW 13R,A03,628519,Staff,0,4,16,16
1715657957903,SIO 295LS,A00,523233,Staff,10,0,30,20
1715657958928,SIO 295S,A00,523232,Staff,10,0,30,20
1715657959956,SIOC 290S,A01,637330,Merrifield; Mark A,21,0,30,9
1715657960985,SIOC 291S,A01,637333,Gabriel; Corey John,21,0,30,9
1715657962012,SOCI 117,A01,494376,Staff,0,5,5,5
1715657963038,WES 237B,A00,494380,Staff,10,0,20,10
1715657965117,AESE 279B,A00,494370,Wade; Jon P,0,0,33,33
1715657966143,AIP 97,001,660915,Van Den Einde; Yael Dahlia,9998,0,9999,1
1715657967175,AIP 197,001,627712,Vespa; Emanuel Ignacio,9995,0,9999,4
1715657967175,AIP 197,002,650778,Amir; On,9998,0,9999,1
1715657967175,AIP 197,003,650933,Avenancio-Leon; Carlos,9998,0,9999,1
1715657967175,AIP 197,004,658530,Heyman; Gail D.,9998,0,9999,1
1715657967175,AIP 197,005,658631,Neal; Sonya E,9998,0,9999,1
1715657967175,AIP 197,006,658671,Du; Songzi,9998,0,9999,1
1715657968206,ANAR 135S,A00,494369,Braswell; Geoffrey E.,0,0,0,0
1715657969237,BENG 196,001,628496,Engler; Adam J.,9998,0,9999,1
1715657969237,BENG 196,002,660916,Watson; John Thomas,9998,0,9999,1
1715657970263,BISP 197,001,650773,Wilhelm; James E.,9994,0,9999,5
1715657970263,BISP 197,002,658904,Coleman; Aaron B.,9998,0,9999,1
1715657971292,CAT 124RS,A01,519847,Geibel; William,0,0,20,20
1715657972317,CAT 125RS,A01,515971,Geibel; William,0,0,20,20
1715657973346,CLRE 250,A00,511389,Morris; Sheldon,9992,0,9999,7
1715657974378,CLRE 251,A00,507176,Mehta; Ravindra L.,9992,0,9999,7
1715657974378,CLRE 251,B00,511410,Mehta; Ravindra L.,9998,0,9999,1
1715657975403,CLRE 252,A00,507189,Cuomo; Raphael Eduardo,9994,0,9999,5
1715657976430,CLRE 253,A00,507199,Vaida; Florin,9994,0,9999,5
1715657976430,CLRE 253,B00,507202,Vaida; Florin,9999,0,9999,0
1715657977456,CLRE 259,A00,507211,Patel; Hemal,9996,0,9999,3
1715657978485,CLRE 260,A00,507221,Cuomo; Raphael Eduardo,9999,0,9999,0
1715657979508,CLRE 297,001,507242,Cuomo; Raphael Eduardo,9999,0,9999,0
1715657980535,COGS 197,001,638244,Voytek; Bradley Thomas,9997,0,9999,2
1715657981562,CSE 191,A00,516875,Minnes Kemp; Mor Mia,9991,0,9999,8
1715657982587,CSE 197,001,637388,Minnes Kemp; Mor Mia,9992,0,9999,7
1715657983618,CSS 201S,A01,494383,Mignozzetti; Umberto,35,0,35,0
1715657984646,CSS 202S,A01,494387,Mignozzetti; Umberto,35,0,35,0
1715657985671,DSC 197,001,628532,Eldridge; Justin Matthew,9995,0,9999,4
1715657986696,EAP 100,A00,516065,Staff,9799,0,9999,200
1715657987727,ECE 45,A01,507414,Staff,32,0,60,28
1715657989779,ECE 111,A01,507420,Staff,11,0,50,39
1715657990808,ECE 197,001,548057,Sievenpiper; Daniel F.,9991,0,9999,8
1715657991838,EDS 115,A00,507243,Choi; Bailey Miyeon,6,0,28,22
1715657992868,EDS 117,A01,494379,Staff,0,6,34,35
1715657993893,EDS 125,A00,507246,Hopkins; Megan Beth,7,0,30,23
1715657994922,EDS 128A,A01,507264,Fargason; Sharon Gayle,5,0,26,21
1715657995951,EDS 128B,A01,507293,Pappas; Elizabeth,9,0,30,21
1715657996979,EDS 139,A00,507294,Fargason; Sharon Gayle,9,0,30,21
1715657996979,EDS 139,B00,507313,Pappas; Elizabeth,9,0,30,21
1715657998007,EDS 201,A00,507315,Staff,10,0,30,20
1715657999031,EDS 203,A01,507317,Halter; Christopher P.,10,0,30,20
1715658000057,EDS 204R,A01,507319,Halter; Christopher P.,0,3,30,30
1715658000057,EDS 204R,B01,507331,Heinzman; Erica M.,14,0,30,16
1715658001083,EDS 206R,A00,507332,Staff,0,4,30,30
1715658001083,EDS 206R,B00,507343,Staff,15,0,30,15
1715658002110,EDS 250,A00,507344,Hemans; Patricia Ann Benitez,20,0,40,20
1715658003135,EDS 281,A00,507345,Daly; Alan J.,18,0,18,0
1715658004160,EDS 284,A00,507350,Daly; Alan J.,16,0,16,0
1715658005187,EDS 286,A00,507359,Fine; Sarah,18,0,18,0
1715658006214,EDS 289C,A01,507361,Daly; Alan J.,18,0,18,0
1715658007240,EDS 290,A00,507366,Hofstetter; Carolyn,15,0,15,0
1715658008272,LIGM 5A,A00,507421,Fischer-Grunski; Eva K,17,0,20,3
1715658009299,LIGM 5B,A00,507423,Fischer-Grunski; Eva K,19,0,20,1
1715658010329,LIGM 5C,A00,507425,Fischer-Grunski; Eva K,19,0,20,1
1715658011357,LIIT 5AS,A00,507427,Carnelos; Chiara,20,0,20,0
1715658012383,LIIT 5BS,A00,507430,Carnelos; Chiara,20,0,20,0
1715658013408,LIIT 5CS,A00,507432,Carnelos; Chiara,20,0,20,0
1715658014435,LISP 5A,A00,507541,Munoz Sanchez; Alicia,11,0,20,9
1715658015463,LISP 5B,A00,507671,Munoz Sanchez; Alicia,8,0,20,12
1715658016488,LISP 5C,A00,507696,Munoz Sanchez; Alicia,7,0,20,13
1715658017516,MAE 197,001,528363,Boechler; Nicholas Sebastia,9998,0,9999,1
1715658018546,MATH 197,001,523477,Kedlaya; Kiran S.,9994,0,9999,5
1715658018546,MATH 197,002,563811,Zhang; Danna,9994,0,9999,5
1715658018546,MATH 197,003,628552,Dumitriu; Ioana,9998,0,9999,1
1715658018546,MATH 197,004,660885,Floyd; Eric,9998,0,9999,1
1715658019577,MCWP 40R,A00,518780,Staff,1,0,20,19
1715658019577,MCWP 40R,B00,518781,Carter; Jennifer A,9,0,20,11
1715658019577,MCWP 40R,C00,518783,Smith; Haydee Marie,5,0,20,15
1715658020608,MCWP 50R,A00,518791,Redela; Pamela Morgan,0,1,20,20
1715658020608,MCWP 50R,B00,518792,Krone; Jarret,0,2,20,20
1715658020608,MCWP 50R,C00,518793,Staff,0,4,20,20
1715658020608,MCWP 50R,D00,518794,Morshed; Michael James,0,2,20,20
1715658020608,MCWP 50R,E00,518795,Carter; Andrea L,0,2,20,20
1715658020608,MCWP 50R,F00,518796,Miller; Elizabeth Deen,0,1,20,20
1715658020608,MCWP 50R,G00,518797,Guillen; Melinda,0,1,20,20
1715658022235,MMW 12R,A01,514034,Herbst; Matthew,0,2,16,16
1715658022235,MMW 12R,A02,514035,Herbst; Matthew,0,0,16,16
1715658023262,MMW 13R,A01,514037,Staff,0,5,16,16
1715658023262,MMW 13R,A02,514039,Staff,0,5,16,16
1715658023262,MMW 13R,A03,628519,Staff,0,4,16,16
1715658025346,SIO 295LS,A00,523233,Staff,10,0,30,20
1715658026375,SIO 295S,A00,523232,Staff,10,0,30,20
1715658027403,SIOC 290S,A01,637330,Merrifield; Mark A,21,0,30,9
1715658028429,SIOC 291S,A01,637333,Gabriel; Corey John,21,0,30,9
1715658029459,SOCI 117,A01,494376,Staff,0,5,5,5
1715658030485,WES 237B,A00,494380,Staff,10,0,20,10
1715658032566,AESE 279B,A00,494370,Wade; Jon P,0,0,33,33
1715658033591,AIP 97,001,660915,Van Den Einde; Yael Dahlia,9998,0,9999,1
1715658034619,AIP 197,001,627712,Vespa; Emanuel Ignacio,9995,0,9999,4
1715658034619,AIP 197,002,650778,Amir; On,9998,0,9999,1
1715658034619,AIP 197,003,650933,Avenancio-Leon; Carlos,9998,0,9999,1
1715658034619,AIP 197,004,658530,Heyman; Gail D.,9998,0,9999,1
1715658034619,AIP 197,005,658631,Neal; Sonya E,9998,0,9999,1
1715658034619,AIP 197,006,658671,Du; Songzi,9998,0,9999,1
1715658035644,ANAR 135S,A00,494369,Braswell; Geoffrey E.,0,0,0,0
1715658036671,BENG 196,001,628496,Engler; Adam J.,9998,0,9999,1
1715658036671,BENG 196,002,660916,Watson; John Thomas,9998,0,9999,1
1715658037706,BISP 197,001,650773,Wilhelm; James E.,9994,0,9999,5
1715658037706,BISP 197,002,658904,Coleman; Aaron B.,9998,0,9999,1
1715658038736,CAT 124RS,A01,519847,Geibel; William,0,0,20,20
1715658039764,CAT 125RS,A01,515971,Geibel; William,0,0,20,20
1715658040791,CLRE 250,A00,511389,Morris; Sheldon,9992,0,9999,7
1715658041822,CLRE 251,A00,507176,Mehta; Ravindra L.,9992,0,9999,7
1715658041822,CLRE 251,B00,511410,Mehta; Ravindra L.,9998,0,9999,1
1715658042850,CLRE 252,A00,507189,Cuomo; Raphael Eduardo,9994,0,9999,5
1715658043881,CLRE 253,A00,507199,Vaida; Florin,9994,0,9999,5
1715658043881,CLRE 253,B00,507202,Vaida; Florin,9999,0,9999,0
1715658044908,CLRE 259,A00,507211,Patel; Hemal,9996,0,9999,3
1715658045935,CLRE 260,A00,507221,Cuomo; Raphael Eduardo,9999,0,9999,0
1715658046960,CLRE 297,001,507242,Cuomo; Raphael Eduardo,9999,0,9999,0
1715658047986,COGS 197,001,638244,Voytek; Bradley Thomas,9997,0,9999,2
1715658049015,CSE 191,A00,516875,Minnes Kemp; Mor Mia,9991,0,9999,8
1715658050040,CSE 197,001,637388,Minnes Kemp; Mor Mia,9992,0,9999,7
1715658051067,CSS 201S,A01,494383,Mignozzetti; Umberto,35,0,35,0
1715658052094,CSS 202S,A01,494387,Mignozzetti; Umberto,35,0,35,0
1715658053119,DSC 197,001,628532,Eldridge; Justin Matthew,9995,0,9999,4
1715658054142,EAP 100,A00,516065,Staff,9799,0,9999,200
1715658055169,ECE 45,A01,507414,Staff,32,0,60,28
1715658057220,ECE 111,A01,507420,Staff,11,0,50,39
1715658058248,ECE 197,001,548057,Sievenpiper; Daniel F.,9991,0,9999,8
1715658059275,EDS 115,A00,507243,Choi; Bailey Miyeon,6,0,28,22
1715658060308,EDS 117,A01,494379,Staff,0,6,34,35
1715658061337,EDS 125,A00,507246,Hopkins; Megan Beth,7,0,30,23
1715658062367,EDS 128A,A01,507264,Fargason; Sharon Gayle,5,0,26,21
1715658063396,EDS 128B,A01,507293,Pappas; Elizabeth,9,0,30,21
1715658064422,EDS 139,A00,507294,Fargason; Sharon Gayle,9,0,30,21
1715658064422,EDS 139,B00,507313,Pappas; Elizabeth,9,0,30,21
1715658065450,EDS 201,A00,507315,Staff,10,0,30,20
1715658066479,EDS 203,A01,507317,Halter; Christopher P.,10,0,30,20
1715658067508,EDS 204R,A01,507319,Halter; Christopher P.,0,3,30,30
1715658067508,EDS 204R,B01,507331,Heinzman; Erica M.,14,0,30,16
1715658068537,EDS 206R,A00,507332,Staff,0,4,30,30
1715658068537,EDS 206R,B00,507343,Staff,15,0,30,15
1715658069563,EDS 250,A00,507344,Hemans; Patricia Ann Benitez,20,0,40,20
1715658070592,EDS 281,A00,507345,Daly; Alan J.,18,0,18,0
1715658071616,EDS 284,A00,507350,Daly; Alan J.,16,0,16,0
1715658072641,EDS 286,A00,507359,Fine; Sarah,18,0,18,0
1715658073667,EDS 289C,A01,507361,Daly; Alan J.,18,0,18,0
1715658074698,EDS 290,A00,507366,Hofstetter; Carolyn,15,0,15,0
1715658075725,LIGM 5A,A00,507421,Fischer-Grunski; Eva K,17,0,20,3
1715658076753,LIGM 5B,A00,507423,Fischer-Grunski; Eva K,19,0,20,1
1715658077783,LIGM 5C,A00,507425,Fischer-Grunski; Eva K,19,0,20,1
1715658078810,LIIT 5AS,A00,507427,Carnelos; Chiara,20,0,20,0
1715658079834,LIIT 5BS,A00,507430,Carnelos; Chiara,20,0,20,0
1715658080864,LIIT 5CS,A00,507432,Carnelos; Chiara,20,0,20,0
1715658081891,LISP 5A,A00,507541,Munoz Sanchez; Alicia,11,0,20,9
1715658082915,LISP 5B,A00,507671,Munoz Sanchez; Alicia,8,0,20,12
1715658083941,LISP 5C,A00,507696,Munoz Sanchez; Alicia,7,0,20,13
1715658084969,MAE 197,001,528363,Boechler; Nicholas Sebastia,9998,0,9999,1
1715658085996,MATH 197,001,523477,Kedlaya; Kiran S.,9994,0,9999,5
1715658085996,MATH 197,002,563811,Zhang; Danna,9994,0,9999,5
1715658085996,MATH 197,003,628552,Dumitriu; Ioana,9998,0,9999,1
1715658085996,MATH 197,004,660885,Floyd; Eric,9998,0,9999,1
1715658087027,MCWP 40R,A00,518780,Staff,1,0,20,19
1715658087027,MCWP 40R,B00,518781,Carter; Jennifer A,9,0,20,11
1715658087027,MCWP 40R,C00,518783,Smith; Haydee Marie,5,0,20,15
1715658088057,MCWP 50R,A00,518791,Redela; Pamela Morgan,0,1,20,20
1715658088057,MCWP 50R,B00,518792,Krone; Jarret,0,2,20,20
1715658088057,MCWP 50R,C00,518793,Staff,0,4,20,20
1715658088057,MCWP 50R,D00,518794,Morshed; Michael James,0,2,20,20
1715658088057,MCWP 50R,E00,518795,Carter; Andrea L,0,2,20,20
1715658088057,MCWP 50R,F00,518796,Miller; Elizabeth Deen,0,1,20,20
1715658088057,MCWP 50R,G00,518797,Guillen; Melinda,0,1,20,20
1715658089083,MMW 12R,A01,514034,Herbst; Matthew,0,2,16,16
1715658089083,MMW 12R,A02,514035,Herbst; Matthew,0,0,16,16
1715658090109,MMW 13R,A01,514037,Staff,0,5,16,16
1715658090109,MMW 13R,A02,514039,Staff,0,5,16,16
1715658090109,MMW 13R,A03,628519,Staff,0,4,16,16
1715658092159,SIO 295LS,A00,523233,Staff,10,0,30,20
1715658093184,SIO 295S,A00,523232,Staff,10,0,30,20
1715658094215,SIOC 290S,A01,637330,Merrifield; Mark A,21,0,30,9
1715658095242,SIOC 291S,A01,637333,Gabriel; Corey John,21,0,30,9
1715658096267,SOCI 117,A01,494376,Staff,0,5,5,5
1715658097297,WES 237B,A00,494380,Staff,10,0,20,10
1715658099372,AESE 279B,A00,494370,Wade; Jon P,0,0,33,33
1715658100403,AIP 97,001,660915,Van Den Einde; Yael Dahlia,9998,0,9999,1
1715658101439,AIP 197,001,627712,Vespa; Emanuel Ignacio,9995,0,9999,4
1715658101439,AIP 197,002,650778,Amir; On,9998,0,9999,1
1715658101439,AIP 197,003,650933,Avenancio-Leon; Carlos,9998,0,9999,1
1715658101439,AIP 197,004,658530,Heyman; Gail D.,9998,0,9999,1
1715658101439,AIP 197,005,658631,Neal; Sonya E,9998,0,9999,1
1715658101439,AIP 197,006,658671,Du; Songzi,9998,0,9999,1
1715658102468,ANAR 135S,A00,494369,Braswell; Geoffrey E.,0,0,0,0
1715658103497,BENG 196,001,628496,Engler; Adam J.,9998,0,9999,1
1715658103497,BENG 196,002,660916,Watson; John Thomas,9998,0,9999,1
1715658104522,BISP 197,001,650773,Wilhelm; James E.,9994,0,9999,5
1715658104522,BISP 197,002,658904,Coleman; Aaron B.,9998,0,9999,1
1715658105550,CAT 124RS,A01,519847,Geibel; William,0,0,20,20
1715658106575,CAT 125RS,A01,515971,Geibel; William,0,0,20,20
1715658107601,CLRE 250,A00,511389,Morris; Sheldon,9992,0,9999,7
1715658108626,CLRE 251,A00,507176,Mehta; Ravindra L.,9992,0,9999,7
1715658108626,CLRE 251,B00,511410,Mehta; Ravindra L.,9998,0,9999,1
1715658109653,CLRE 252,A00,507189,Cuomo; Raphael Eduardo,9994,0,9999,5
1715658110679,CLRE 253,A00,507199,Vaida; Florin,9994,0,9999,5
1715658110679,CLRE 253,B00,507202,Vaida; Florin,9999,0,9999,0
1715658111706,CLRE 259,A00,507211,Patel; Hemal,9996,0,9999,3
1715658112729,CLRE 260,A00,507221,Cuomo; Raphael Eduardo,9999,0,9999,0
1715658113760,CLRE 297,001,507242,Cuomo; Raphael Eduardo,9999,0,9999,0
1715658114784,COGS 197,001,638244,Voytek; Bradley Thomas,9997,0,9999,2
1715658115813,CSE 191,A00,516875,Minnes Kemp; Mor Mia,9991,0,9999,8
1715658116842,CSE 197,001,637388,Minnes Kemp; Mor Mia,9992,0,9999,7
1715658117873,CSS 201S,A01,494383,Mignozzetti; Umberto,35,0,35,0
1715658118898,CSS 202S,A01,494387,Mignozzetti; Umberto,35,0,35,0
1715658119922,DSC 197,001,628532,Eldridge; Justin Matthew,9995,0,9999,4
1715658120950,EAP 100,A00,516065,Staff,9799,0,9999,200
1715658121984,ECE 45,A01,507414,Staff,32,0,60,28
1715658124034,ECE 111,A01,507420,Staff,11,0,50,39
1715658125066,ECE 197,001,548057,Sievenpiper; Daniel F.,9991,0,9999,8
1715658126095,EDS 115,A00,507243,Choi; Bailey Miyeon,6,0,28,22
1715658127122,EDS 117,A01,494379,Staff,0,6,34,35
1715658128147,EDS 125,A00,507246,Hopkins; Megan Beth,7,0,30,23
1715658129172,EDS 128A,A01,507264,Fargason; Sharon Gayle,5,0,26,21
1715658130197,EDS 128B,A01,507293,Pappas; Elizabeth,9,0,30,21
1715658131222,EDS 139,A00,507294,Fargason; Sharon Gayle,9,0,30,21
1715658131222,EDS 139,B00,507313,Pappas; Elizabeth,9,0,30,21
1715658132248,EDS 201,A00,507315,Staff,10,0,30,20
1715658133274,EDS 203,A01,507317,Halter; Christopher P.,10,0,30,20
1715658134299,EDS 204R,A01,507319,Halter; Christopher P.,0,3,30,30
1715658134299,EDS 204R,B01,507331,Heinzman; Erica M.,14,0,30,16
1715658135325,EDS 206R,A00,507332,Staff,0,4,30,30
1715658135325,EDS 206R,B00,507343,Staff,15,0,30,15
1715658136366,EDS 250,A00,507344,Hemans; Patricia Ann Benitez,20,0,40,20
1715658137390,EDS 281,A00,507345,Daly; Alan J.,18,0,18,0
1715658138414,EDS 284,A00,507350,Daly; Alan J.,16,0,16,0
1715658139439,EDS 286,A00,507359,Fine; Sarah,18,0,18,0
1715658140466,EDS 289C,A01,507361,Daly; Alan J.,18,0,18,0
1715658141494,EDS 290,A00,507366,Hofstetter; Carolyn,15,0,15,0
1715658142519,LIGM 5A,A00,507421,Fischer-Grunski; Eva K,17,0,20,3
1715658143547,LIGM 5B,A00,507423,Fischer-Grunski; Eva K,19,0,20,1
1715658144574,LIGM 5C,A00,507425,Fischer-Grunski; Eva K,19,0,20,1
1715658145604,LIIT 5AS,A00,507427,Carnelos; Chiara,20,0,20,0
1715658146629,LIIT 5BS,A00,507430,Carnelos; Chiara,20,0,20,0
1715658147654,LIIT 5CS,A00,507432,Carnelos; Chiara,20,0,20,0
1715658148678,LISP 5A,A00,507541,Munoz Sanchez; Alicia,11,0,20,9
1715658149702,LISP 5B,A00,507671,Munoz Sanchez; Alicia,8,0,20,12
1715658150726,LISP 5C,A00,507696,Munoz Sanchez; Alicia,7,0,20,13
1715658151748,MAE 197,001,528363,Boechler; Nicholas Sebastia,9998,0,9999,1
1715658152780,MATH 197,001,523477,Kedlaya; Kiran S.,9994,0,9999,5
1715658152780,MATH 197,002,563811,Zhang; Danna,9994,0,9999,5
1715658152780,MATH 197,003,628552,Dumitriu; Ioana,9998,0,9999,1
1715658152780,MATH 197,004,660885,Floyd; Eric,9998,0,9999,1
1715658153812,MCWP 40R,A00,518780,Staff,1,0,20,19
1715658153812,MCWP 40R,B00,518781,Carter; Jennifer A,9,0,20,11
1715658153812,MCWP 40R,C00,518783,Smith; Haydee Marie,5,0,20,15
1715658154842,MCWP 50R,A00,518791,Redela; Pamela Morgan,0,1,20,20
1715658154842,MCWP 50R,B00,518792,Krone; Jarret,0,2,20,20
1715658154842,MCWP 50R,C00,518793,Staff,0,4,20,20
1715658154842,MCWP 50R,D00,518794,Morshed; Michael James,0,2,20,20
1715658154842,MCWP 50R,E00,518795,Carter; Andrea L,0,2,20,20
1715658154842,MCWP 50R,F00,518796,Miller; Elizabeth Deen,0,1,20,20
1715658154842,MCWP 50R,G00,518797,Guillen; Melinda,0,1,20,20
1715658155872,MMW 12R,A01,514034,Herbst; Matthew,0,2,16,16
1715658155872,MMW 12R,A02,514035,Herbst; Matthew,0,0,16,16
1715658156896,MMW 13R,A01,514037,Staff,0,5,16,16
1715658156896,MMW 13R,A02,514039,Staff,0,5,16,16
1715658156896,MMW 13R,A03,628519,Staff,0,4,16,16
1715658158956,SIO 295LS,A00,523233,Staff,10,0,30,20
1715658159982,SIO 295S,A00,523232,Staff,10,0,30,20
1715658161007,SIOC 290S,A01,637330,Merrifield; Mark A,21,0,30,9
1715658162036,SIOC 291S,A01,637333,Gabriel; Corey John,21,0,30,9
1715658163063,SOCI 117,A01,494376,Staff,0,5,5,5
1715658164087,WES 237B,A00,494380,Staff,10,0,20,10
1715658166161,AESE 279B,A00,494370,Wade; Jon P,0,0,33,33
1715658167187,AIP 97,001,660915,Van Den Einde; Yael Dahlia,9998,0,9999,1
1715658168215,AIP 197,001,627712,Vespa; Emanuel Ignacio,9995,0,9999,4
1715658168215,AIP 197,002,650778,Amir; On,9998,0,9999,1
1715658168215,AIP 197,003,650933,Avenancio-Leon; Carlos,9998,0,9999,1
1715658168215,AIP 197,004,658530,Heyman; Gail D.,9998,0,9999,1
1715658168215,AIP 197,005,658631,Neal; Sonya E,9998,0,9999,1
1715658168215,AIP 197,006,658671,Du; Songzi,9998,0,9999,1
1715658169239,ANAR 135S,A00,494369,Braswell; Geoffrey E.,0,0,0,0
1715658170264,BENG 196,001,628496,Engler; Adam J.,9998,0,9999,1
1715658170264,BENG 196,002,660916,Watson; John Thomas,9998,0,9999,1
1715658171291,BISP 197,001,650773,Wilhelm; James E.,9994,0,9999,5
1715658171291,BISP 197,002,658904,Coleman; Aaron B.,9998,0,9999,1
1715658172317,CAT 124RS,A01,519847,Geibel; William,0,0,20,20
1715658173341,CAT 125RS,A01,515971,Geibel; William,0,0,20,20
1715658174369,CLRE 250,A00,511389,Morris; Sheldon,9992,0,9999,7
1715658175397,CLRE 251,A00,507176,Mehta; Ravindra L.,9992,0,9999,7
1715658175397,CLRE 251,B00,511410,Mehta; Ravindra L.,9998,0,9999,1
1715658176422,CLRE 252,A00,507189,Cuomo; Raphael Eduardo,9994,0,9999,5
1715658177451,CLRE 253,A00,507199,Vaida; Florin,9994,0,9999,5
1715658177451,CLRE 253,B00,507202,Vaida; Florin,9999,0,9999,0
1715658178479,CLRE 259,A00,507211,Patel; Hemal,9996,0,9999,3
1715658179506,CLRE 260,A00,507221,Cuomo; Raphael Eduardo,9999,0,9999,0
1715658180532,CLRE 297,001,507242,Cuomo; Raphael Eduardo,9999,0,9999,0
1715658181558,COGS 197,001,638244,Voytek; Bradley Thomas,9997,0,9999,2
1715658182583,CSE 191,A00,516875,Minnes Kemp; Mor Mia,9991,0,9999,8
1715658183607,CSE 197,001,637388,Minnes Kemp; Mor Mia,9992,0,9999,7
1715658184634,CSS 201S,A01,494383,Mignozzetti; Umberto,35,0,35,0
1715658185665,CSS 202S,A01,494387,Mignozzetti; Umberto,35,0,35,0
1715658186693,DSC 197,001,628532,Eldridge; Justin Matthew,9995,0,9999,4
1715658187720,EAP 100,A00,516065,Staff,9799,0,9999,200
1715658188748,ECE 45,A01,507414,Staff,32,0,60,28
1715658190797,ECE 111,A01,507420,Staff,11,0,50,39
1715658191823,ECE 197,001,548057,Sievenpiper; Daniel F.,9991,0,9999,8
1715658192856,EDS 115,A00,507243,Choi; Bailey Miyeon,6,0,28,22
1715658193883,EDS 117,A01,494379,Staff,0,6,34,35
1715658194907,EDS 125,A00,507246,Hopkins; Megan Beth,7,0,30,23
1715658195930,EDS 128A,A01,507264,Fargason; Sharon Gayle,5,0,26,21
1715658196958,EDS 128B,A01,507293,Pappas; Elizabeth,9,0,30,21
1715658197985,EDS 139,A00,507294,Fargason; Sharon Gayle,9,0,30,21
1715658197985,EDS 139,B00,507313,Pappas; Elizabeth,9,0,30,21
1715658199013,EDS 201,A00,507315,Staff,10,0,30,20
1715658200044,EDS 203,A01,507317,Halter; Christopher P.,10,0,30,20
1715658201069,EDS 204R,A01,507319,Halter; Christopher P.,0,3,30,30
1715658201069,EDS 204R,B01,507331,Heinzman; Erica M.,14,0,30,16
1715658202096,EDS 206R,A00,507332,Staff,0,4,30,30
1715658202096,EDS 206R,B00,507343,Staff,15,0,30,15
1715658203124,EDS 250,A00,507344,Hemans; Patricia Ann Benitez,20,0,40,20
1715658204149,EDS 281,A00,507345,Daly; Alan J.,18,0,18,0
1715658205176,EDS 284,A00,507350,Daly; Alan J.,16,0,16,0
1715658206205,EDS 286,A00,507359,Fine; Sarah,18,0,18,0
1715658207234,EDS 289C,A01,507361,Daly; Alan J.,18,0,18,0
1715658208264,EDS 290,A00,507366,Hofstetter; Carolyn,15,0,15,0
1715658209295,LIGM 5A,A00,507421,Fischer-Grunski; Eva K,17,0,20,3
1715658210326,LIGM 5B,A00,507423,Fischer-Grunski; Eva K,19,0,20,1
1715658211354,LIGM 5C,A00,507425,Fischer-Grunski; Eva K,19,0,20,1
1715658212380,LIIT 5AS,A00,507427,Carnelos; Chiara,20,0,20,0
1715658213411,LIIT 5BS,A00,507430,Carnelos; Chiara,20,0,20,0
1715658214437,LIIT 5CS,A00,507432,Carnelos; Chiara,20,0,20,0
1715658215463,LISP 5A,A00,507541,Munoz Sanchez; Alicia,11,0,20,9
1715658216489,LISP 5B,A00,507671,Munoz Sanchez; Alicia,8,0,20,12
1715658217514,LISP 5C,A00,507696,Munoz Sanchez; Alicia,7,0,20,13
1715658218539,MAE 197,001,528363,Boechler; Nicholas Sebastia,9998,0,9999,1
1715658219568,MATH 197,001,523477,Kedlaya; Kiran S.,9994,0,9999,5
1715658219568,MATH 197,002,563811,Zhang; Danna,9994,0,9999,5
1715658219568,MATH 197,003,628552,Dumitriu; Ioana,9998,0,9999,1
1715658219568,MATH 197,004,660885,Floyd; Eric,9998,0,9999,1
1715658220595,MCWP 40R,A00,518780,Staff,1,0,20,19
1715658220595,MCWP 40R,B00,518781,Carter; Jennifer A,9,0,20,11
1715658220595,MCWP 40R,C00,518783,Smith; Haydee Marie,5,0,20,15
1715658221623,MCWP 50R,A00,518791,Redela; Pamela Morgan,0,1,20,20
1715658221623,MCWP 50R,B00,518792,Krone; Jarret,0,2,20,20
1715658221623,MCWP 50R,C00,518793,Staff,0,4,20,20
1715658221623,MCWP 50R,D00,518794,Morshed; Michael James,0,2,20,20
1715658221623,MCWP 50R,E00,518795,Carter; Andrea L,0,2,20,20
1715658221623,MCWP 50R,F00,518796,Miller; Elizabeth Deen,0,1,20,20
1715658221623,MCWP 50R,G00,518797,Guillen; Melinda,0,1,20,20
1715658222650,MMW 12R,A01,514034,Herbst; Matthew,0,2,16,16
1715658222650,MMW 12R,A02,514035,Herbst; Matthew,0,0,16,16
1715658223676,MMW 13R,A01,514037,Staff,0,5,16,16
1715658223676,MMW 13R,A02,514039,Staff,0,5,16,16
1715658223676,MMW 13R,A03,628519,Staff,0,4,16,16
1715658225731,SIO 295LS,A00,523233,Staff,10,0,30,20
1715658226756,SIO 295S,A00,523232,Staff,10,0,30,20
1715658227788,SIOC 290S,A01,637330,Merrifield; Mark A,21,0,30,9
1715658228818,SIOC 291S,A01,637333,Gabriel; Corey John,21,0,30,9
1715658229843,SOCI 117,A01,494376,Staff,0,5,5,5
1715658230868,WES 237B,A00,494380,Staff,10,0,20,10
1715658232942,AESE 279B,A00,494370,Wade; Jon P,0,0,33,33
1715658233970,AIP 97,001,660915,Van Den Einde; Yael Dahlia,9998,0,9999,1
1715658234998,AIP 197,001,627712,Vespa; Emanuel Ignacio,9995,0,9999,4
1715658234998,AIP 197,002,650778,Amir; On,9998,0,9999,1
1715658234998,AIP 197,003,650933,Avenancio-Leon; Carlos,9998,0,9999,1
1715658234998,AIP 197,004,658530,Heyman; Gail D.,9998,0,9999,1
1715658234998,AIP 197,005,658631,Neal; Sonya E,9998,0,9999,1
1715658234998,AIP 197,006,658671,Du; Songzi,9998,0,9999,1
1715658236023,ANAR 135S,A00,494369,Braswell; Geoffrey E.,0,0,0,0
1715658237049,BENG 196,001,628496,Engler; Adam J.,9998,0,9999,1
1715658237049,BENG 196,002,660916,Watson; John Thomas,9998,0,9999,1
1715658238078,BISP 197,001,650773,Wilhelm; James E.,9994,0,9999,5
1715658238078,BISP 197,002,658904,Coleman; Aaron B.,9998,0,9999,1
1715658239108,CAT 124RS,A01,519847,Geibel; William,0,0,20,20
1715658240133,CAT 125RS,A01,515971,Geibel; William,0,0,20,20
1715658241159,CLRE 250,A00,511389,Morris; Sheldon,9992,0,9999,7
1715658242190,CLRE 251,A00,507176,Mehta; Ravindra L.,9992,0,9999,7
1715658242190,CLRE 251,B00,511410,Mehta; Ravindra L.,9998,0,9999,1
1715658243220,CLRE 252,A00,507189,Cuomo; Raphael Eduardo,9994,0,9999,5
1715658244245,CLRE 253,A00,507199,Vaida; Florin,9994,0,9999,5
1715658244245,CLRE 253,B00,507202,Vaida; Florin,9999,0,9999,0
1715658245271,CLRE 259,A00,507211,Patel; Hemal,9996,0,9999,3
1715658246299,CLRE 260,A00,507221,Cuomo; Raphael Eduardo,9999,0,9999,0
1715658247326,CLRE 297,001,507242,Cuomo; Raphael Eduardo,9999,0,9999,0
1715658248355,COGS 197,001,638244,Voytek; Bradley Thomas,9997,0,9999,2
1715658249380,CSE 191,A00,516875,Minnes Kemp; Mor Mia,9991,0,9999,8
1715658250406,CSE 197,001,637388,Minnes Kemp; Mor Mia,9992,0,9999,7
1715658251433,CSS 201S,A01,494383,Mignozzetti; Umberto,35,0,35,0
1715658252463,CSS 202S,A01,494387,Mignozzetti; Umberto,35,0,35,0
1715658253490,DSC 197,001,628532,Eldridge; Justin Matthew,9995,0,9999,4
1715658254513,EAP 100,A00,516065,Staff,9799,0,9999,200
1715658255541,ECE 45,A01,507414,Staff,32,0,60,28
1715658257597,ECE 111,A01,507420,Staff,11,0,50,39
1715658258622,ECE 197,001,548057,Sievenpiper; Daniel F.,9991,0,9999,8
1715658259706,EDS 115,A00,507243,Choi; Bailey Miyeon,6,0,28,22
1715658260734,EDS 117,A01,494379,Staff,0,6,34,35
1715658261761,EDS 125,A00,507246,Hopkins; Megan Beth,7,0,30,23
1715658262787,EDS 128A,A01,507264,Fargason; Sharon Gayle,5,0,26,21
1715658263813,EDS 128B,A01,507293,Pappas; Elizabeth,9,0,30,21
1715658264837,EDS 139,A00,507294,Fargason; Sharon Gayle,9,0,30,21
1715658264837,EDS 139,B00,507313,Pappas; Elizabeth,9,0,30,21
1715658265863,EDS 201,A00,507315,Staff,10,0,30,20
1715658266891,EDS 203,A01,507317,Halter; Christopher P.,10,0,30,20
1715658267920,EDS 204R,A01,507319,Halter; Christopher P.,0,3,30,30
1715658267920,EDS 204R,B01,507331,Heinzman; Erica M.,14,0,30,16
1715658268948,EDS 206R,A00,507332,Staff,0,4,30,30
1715658268948,EDS 206R,B00,507343,Staff,15,0,30,15
1715658269973,EDS 250,A00,507344,Hemans; Patricia Ann Benitez,20,0,40,20
1715658271001,EDS 281,A00,507345,Daly; Alan J.,18,0,18,0
1715658272027,EDS 284,A00,507350,Daly; Alan J.,16,0,16,0
1715658273052,EDS 286,A00,507359,Fine; Sarah,18,0,18,0
1715658274077,EDS 289C,A01,507361,Daly; Alan J.,18,0,18,0
1715658275104,EDS 290,A00,507366,Hofstetter; Carolyn,15,0,15,0
1715658276131,LIGM 5A,A00,507421,Fischer-Grunski; Eva K,17,0,20,3
1715658277158,LIGM 5B,A00,507423,Fischer-Grunski; Eva K,19,0,20,1
1715658278184,LIGM 5C,A00,507425,Fischer-Grunski; Eva K,19,0,20,1
1715658279214,LIIT 5AS,A00,507427,Carnelos; Chiara,20,0,20,0
1715658280238,LIIT 5BS,A00,507430,Carnelos; Chiara,20,0,20,0
1715658281263,LIIT 5CS,A00,507432,Carnelos; Chiara,20,0,20,0
1715658282290,LISP 5A,A00,507541,Munoz Sanchez; Alicia,11,0,20,9
1715658283318,LISP 5B,A00,507671,Munoz Sanchez; Alicia,8,0,20,12
1715658284343,LISP 5C,A00,507696,Munoz Sanchez; Alicia,7,0,20,13
1715658285372,MAE 197,001,528363,Boechler; Nicholas Sebastia,9998,0,9999,1
1715658286400,MATH 197,001,523477,Kedlaya; Kiran S.,9994,0,9999,5
1715658286400,MATH 197,002,563811,Zhang; Danna,9994,0,9999,5
1715658286400,MATH 197,003,628552,Dumitriu; Ioana,9998,0,9999,1
1715658286400,MATH 197,004,660885,Floyd; Eric,9998,0,9999,1
1715658287425,MCWP 40R,A00,518780,Staff,1,0,20,19
1715658287425,MCWP 40R,B00,518781,Carter; Jennifer A,9,0,20,11
1715658287425,MCWP 40R,C00,518783,Smith; Haydee Marie,5,0,20,15
1715658288455,MCWP 50R,A00,518791,Redela; Pamela Morgan,0,1,20,20
1715658288455,MCWP 50R,B00,518792,Krone; Jarret,0,2,20,20
1715658288455,MCWP 50R,C00,518793,Staff,0,4,20,20
1715658288455,MCWP 50R,D00,518794,Morshed; Michael James,0,2,20,20
1715658288455,MCWP 50R,E00,518795,Carter; Andrea L,0,2,20,20
1715658288455,MCWP 50R,F00,518796,Miller; Elizabeth Deen,0,1,20,20
1715658288455,MCWP 50R,G00,518797,Guillen; Melinda,0,1,20,20
1715658289483,MMW 12R,A01,514034,Herbst; Matthew,0,2,16,16
1715658289483,MMW 12R,A02,514035,Herbst; Matthew,0,0,16,16
1715658290511,MMW 13R,A01,514037,Staff,0,5,16,16
1715658290511,MMW 13R,A02,514039,Staff,0,5,16,16
1715658290511,MMW 13R,A03,628519,Staff,0,4,16,16
1715658292565,SIO 295LS,A00,523233,Staff,10,0,30,20
1715658293592,SIO 295S,A00,523232,Staff,10,0,30,20
1715658294618,SIOC 290S,A01,637330,Merrifield; Mark A,21,0,30,9
1715658295644,SIOC 291S,A01,637333,Gabriel; Corey John,21,0,30,9
1715658296674,SOCI 117,A01,494376,Staff,0,5,5,5
1715658297698,WES 237B,A00,494380,Staff,10,0,20,10
1715658299769,AESE 279B,A00,494370,Wade; Jon P,0,0,33,33
1715658300794,AIP 97,001,660915,Van Den Einde; Yael Dahlia,9998,0,9999,1
1715658301822,AIP 197,001,627712,Vespa; Emanuel Ignacio,9995,0,9999,4
1715658301822,AIP 197,002,650778,Amir; On,9998,0,9999,1
1715658301822,AIP 197,003,650933,Avenancio-Leon; Carlos,9998,0,9999,1
1715658301822,AIP 197,004,658530,Heyman; Gail D.,9998,0,9999,1
1715658301822,AIP 197,005,658631,Neal; Sonya E,9998,0,9999,1
1715658301822,AIP 197,006,658671,Du; Songzi,9998,0,9999,1
1715658302846,ANAR 135S,A00,494369,Braswell; Geoffrey E.,0,0,0,0
1715658303881,BENG 196,001,628496,Engler; Adam J.,9998,0,9999,1
1715658303881,BENG 196,002,660916,Watson; John Thomas,9998,0,9999,1
1715658304907,BISP 197,001,650773,Wilhelm; James E.,9994,0,9999,5
1715658304907,BISP 197,002,658904,Coleman; Aaron B.,9998,0,9999,1
1715658305934,CAT 124RS,A01,519847,Geibel; William,0,0,20,20
1715658306964,CAT 125RS,A01,515971,Geibel; William,0,0,20,20
1715658307989,CLRE 250,A00,511389,Morris; Sheldon,9992,0,9999,7
1715658309016,CLRE 251,A00,507176,Mehta; Ravindra L.,9992,0,9999,7
1715658309016,CLRE 251,B00,511410,Mehta; Ravindra L.,9998,0,9999,1
1715658310045,CLRE 252,A00,507189,Cuomo; Raphael Eduardo,9994,0,9999,5
1715658311071,CLRE 253,A00,507199,Vaida; Florin,9994,0,9999,5
1715658311071,CLRE 253,B00,507202,Vaida; Florin,9999,0,9999,0
1715658312097,CLRE 259,A00,507211,Patel; Hemal,9996,0,9999,3
1715658313120,CLRE 260,A00,507221,Cuomo; Raphael Eduardo,9999,0,9999,0
1715658314146,CLRE 297,001,507242,Cuomo; Raphael Eduardo,9999,0,9999,0
1715658315172,COGS 197,001,638244,Voytek; Bradley Thomas,9997,0,9999,2
1715658316197,CSE 191,A00,516875,Minnes Kemp; Mor Mia,9991,0,9999,8
1715658317222,CSE 197,001,637388,Minnes Kemp; Mor Mia,9992,0,9999,7
1715658318247,CSS 201S,A01,494383,Mignozzetti; Umberto,35,0,35,0
1715658319272,CSS 202S,A01,494387,Mignozzetti; Umberto,35,0,35,0
1715658320298,DSC 197,001,628532,Eldridge; Justin Matthew,9995,0,9999,4
1715658321323,EAP 100,A00,516065,Staff,9799,0,9999,200
1715658322350,ECE 45,A01,507414,Staff,32,0,60,28
1715658324408,ECE 111,A01,507420,Staff,11,0,50,39
1715658325438,ECE 197,001,548057,Sievenpiper; Daniel F.,9991,0,9999,8
1715658326464,EDS 115,A00,507243,Choi; Bailey Miyeon,6,0,28,22
1715658327490,EDS 117,A01,494379,Staff,0,6,34,35
1715658328516,EDS 125,A00,507246,Hopkins; Megan Beth,7,0,30,23
1715658329545,EDS 128A,A01,507264,Fargason; Sharon Gayle,5,0,26,21
1715658330570,EDS 128B,A01,507293,Pappas; Elizabeth,9,0,30,21
1715658331599,EDS 139,A00,507294,Fargason; Sharon Gayle,9,0,30,21
1715658331599,EDS 139,B00,507313,Pappas; Elizabeth,9,0,30,21
1715658332624,EDS 201,A00,507315,Staff,10,0,30,20
1715658333649,EDS 203,A01,507317,Halter; Christopher P.,10,0,30,20
1715658334675,EDS 204R,A01,507319,Halter; Christopher P.,0,3,30,30
1715658334675,EDS 204R,B01,507331,Heinzman; Erica M.,14,0,30,16
1715658335703,EDS 206R,A00,507332,Staff,0,4,30,30
1715658335703,EDS 206R,B00,507343,Staff,15,0,30,15
1715658336729,EDS 250,A00,507344,Hemans; Patricia Ann Benitez,20,0,40,20
1715658337758,EDS 281,A00,507345,Daly; Alan J.,18,0,18,0
1715658338783,EDS 284,A00,507350,Daly; Alan J.,16,0,16,0
1715658339808,EDS 286,A00,507359,Fine; Sarah,18,0,18,0
1715658340833,EDS 289C,A01,507361,Daly; Alan J.,18,0,18,0
1715658341858,EDS 290,A00,507366,Hofstetter; Carolyn,15,0,15,0
1715658342890,LIGM 5A,A00,507421,Fischer-Grunski; Eva K,17,0,20,3
1715658343913,LIGM 5B,A00,507423,Fischer-Grunski; Eva K,19,0,20,1
1715658344944,LIGM 5C,A00,507425,Fischer-Grunski; Eva K,19,0,20,1
1715658345969,LIIT 5AS,A00,507427,Carnelos; Chiara,20,0,20,0
1715658346993,LIIT 5BS,A00,507430,Carnelos; Chiara,20,0,20,0
1715658348023,LIIT 5CS,A00,507432,Carnelos; Chiara,20,0,20,0
1715658349053,LISP 5A,A00,507541,Munoz Sanchez; Alicia,11,0,20,9
1715658350079,LISP 5B,A00,507671,Munoz Sanchez; Alicia,8,0,20,12
1715658351105,LISP 5C,A00,507696,Munoz Sanchez; Alicia,7,0,20,13
1715658352131,MAE 197,001,528363,Boechler; Nicholas Sebastia,9998,0,9999,1
1715658353159,MATH 197,001,523477,Kedlaya; Kiran S.,9994,0,9999,5
1715658353159,MATH 197,002,563811,Zhang; Danna,9994,0,9999,5
1715658353159,MATH 197,003,628552,Dumitriu; Ioana,9998,0,9999,1
1715658353159,MATH 197,004,660885,Floyd; Eric,9998,0,9999,1
1715658354191,MCWP 40R,A00,518780,Staff,1,0,20,19
1715658354191,MCWP 40R,B00,518781,Carter; Jennifer A,9,0,20,11
1715658354191,MCWP 40R,C00,518783,Smith; Haydee Marie,5,0,20,15
1715658355223,MCWP 50R,A00,518791,Redela; Pamela Morgan,0,1,20,20
1715658355223,MCWP 50R,B00,518792,Krone; Jarret,0,2,20,20
1715658355223,MCWP 50R,C00,518793,Staff,0,4,20,20
1715658355223,MCWP 50R,D00,518794,Morshed; Michael James,0,2,20,20
1715658355223,MCWP 50R,E00,518795,Carter; Andrea L,0,2,20,20
1715658355223,MCWP 50R,F00,518796,Miller; Elizabeth Deen,0,1,20,20
1715658355223,MCWP 50R,G00,518797,Guillen; Melinda,0,1,20,20
1715658356249,MMW 12R,A01,514034,Herbst; Matthew,0,2,16,16
1715658356249,MMW 12R,A02,514035,Herbst; Matthew,0,0,16,16
1715658357275,MMW 13R,A01,514037,Staff,0,5,16,16
1715658357275,MMW 13R,A02,514039,Staff,0,5,16,16
1715658357275,MMW 13R,A03,628519,Staff,0,4,16,16
1715658359328,SIO 295LS,A00,523233,Staff,10,0,30,20
1715658360355,SIO 295S,A00,523232,Staff,10,0,30,20
1715658361381,SIOC 290S,A01,637330,Merrifield; Mark A,21,0,30,9
1715658362405,SIOC 291S,A01,637333,Gabriel; Corey John,21,0,30,9
1715658363485,SOCI 117,A01,494376,Staff,0,5,5,5
1715658364509,WES 237B,A00,494380,Staff,10,0,20,10
1715658366587,AESE 279B,A00,494370,Wade; Jon P,0,0,33,33
1715658367619,AIP 97,001,660915,Van Den Einde; Yael Dahlia,9998,0,9999,1
1715658368646,AIP 197,001,627712,Vespa; Emanuel Ignacio,9995,0,9999,4
1715658368646,AIP 197,002,650778,Amir; On,9998,0,9999,1
1715658368646,AIP 197,003,650933,Avenancio-Leon; Carlos,9998,0,9999,1
1715658368646,AIP 197,004,658530,Heyman; Gail D.,9998,0,9999,1
1715658368646,AIP 197,005,658631,Neal; Sonya E,9998,0,9999,1
1715658368646,AIP 197,006,658671,Du; Songzi,9998,0,9999,1
1715658369675,ANAR 135S,A00,494369,Braswell; Geoffrey E.,0,0,0,0
1715658370700,BENG 196,001,628496,Engler; Adam J.,9998,0,9999,1
1715658370700,BENG 196,002,660916,Watson; John Thomas,9998,0,9999,1
1715658371726,BISP 197,001,650773,Wilhelm; James E.,9994,0,9999,5
1715658371726,BISP 197,002,658904,Coleman; Aaron B.,9998,0,9999,1
1715658372750,CAT 124RS,A01,519847,Geibel; William,0,0,20,20
1715658373774,CAT 125RS,A01,515971,Geibel; William,0,0,20,20
1715658374799,CLRE 250,A00,511389,Morris; Sheldon,9992,0,9999,7
1715658375827,CLRE 251,A00,507176,Mehta; Ravindra L.,9992,0,9999,7
1715658375827,CLRE 251,B00,511410,Mehta; Ravindra L.,9998,0,9999,1
1715658376854,CLRE 252,A00,507189,Cuomo; Raphael Eduardo,9994,0,9999,5
1715658377882,CLRE 253,A00,507199,Vaida; Florin,9994,0,9999,5
1715658377882,CLRE 253,B00,507202,Vaida; Florin,9999,0,9999,0
1715658378907,CLRE 259,A00,507211,Patel; Hemal,9996,0,9999,3
1715658379933,CLRE 260,A00,507221,Cuomo; Raphael Eduardo,9999,0,9999,0
1715658380959,CLRE 297,001,507242,Cuomo; Raphael Eduardo,9999,0,9999,0
1715658381986,COGS 197,001,638244,Voytek; Bradley Thomas,9997,0,9999,2
1715658383011,CSE 191,A00,516875,Minnes Kemp; Mor Mia,9991,0,9999,8
1715658384036,CSE 197,001,637388,Minnes Kemp; Mor Mia,9992,0,9999,7
1715658385068,CSS 201S,A01,494383,Mignozzetti; Umberto,35,0,35,0
1715658386099,CSS 202S,A01,494387,Mignozzetti; Umberto,35,0,35,0
1715658387128,DSC 197,001,628532,Eldridge; Justin Matthew,9995,0,9999,4
1715658388155,EAP 100,A00,516065,Staff,9799,0,9999,200
1715658389185,ECE 45,A01,507414,Staff,32,0,60,28
1715658391239,ECE 111,A01,507420,Staff,11,0,50,39
1715658392268,ECE 197,001,548057,Sievenpiper; Daniel F.,9991,0,9999,8
1715658393298,EDS 115,A00,507243,Choi; Bailey Miyeon,6,0,28,22
1715658394328,EDS 117,A01,494379,Staff,0,6,34,35
1715658395355,EDS 125,A00,507246,Hopkins; Megan Beth,7,0,30,23
1715658396382,EDS 128A,A01,507264,Fargason; Sharon Gayle,5,0,26,21
1715658397414,EDS 128B,A01,507293,Pappas; Elizabeth,9,0,30,21
1715658398440,EDS 139,A00,507294,Fargason; Sharon Gayle,9,0,30,21
1715658398440,EDS 139,B00,507313,Pappas; Elizabeth,9,0,30,21
1715658399468,EDS 201,A00,507315,Staff,10,0,30,20
1715658400499,EDS 203,A01,507317,Halter; Christopher P.,10,0,30,20
1715658401528,EDS 204R,A01,507319,Halter; Christopher P.,0,3,30,30
1715658401528,EDS 204R,B01,507331,Heinzman; Erica M.,14,0,30,16
1715658402554,EDS 206R,A00,507332,Staff,0,4,30,30
1715658402554,EDS 206R,B00,507343,Staff,15,0,30,15
1715658403581,EDS 250,A00,507344,Hemans; Patricia Ann Benitez,20,0,40,20
1715658404607,EDS 281,A00,507345,Daly; Alan J.,18,0,18,0
1715658405636,EDS 284,A00,507350,Daly; Alan J.,16,0,16,0
1715658406666,EDS 286,A00,507359,Fine; Sarah,18,0,18,0
1715658407695,EDS 289C,A01,507361,Daly; Alan J.,18,0,18,0
1715658408720,EDS 290,A00,507366,Hofstetter; Carolyn,15,0,15,0
1715658409744,LIGM 5A,A00,507421,Fischer-Grunski; Eva K,17,0,20,3
1715658410769,LIGM 5B,A00,507423,Fischer-Grunski; Eva K,19,0,20,1
1715658411797,LIGM 5C,A00,507425,Fischer-Grunski; Eva K,19,0,20,1
1715658412826,LIIT 5AS,A00,507427,Carnelos; Chiara,20,0,20,0
1715658413851,LIIT 5BS,A00,507430,Carnelos; Chiara,20,0,20,0
1715658414878,LIIT 5CS,A00,507432,Carnelos; Chiara,20,0,20,0
1715658416010,LISP 5A,A00,507541,Munoz Sanchez; Alicia,11,0,20,9
1715658417035,LISP 5B,A00,507671,Munoz Sanchez; Alicia,8,0,20,12
1715658418064,LISP 5C,A00,507696,Munoz Sanchez; Alicia,7,0,20,13
1715658419090,MAE 197,001,528363,Boechler; Nicholas Sebastia,9998,0,9999,1
1715658420118,MATH 197,001,523477,Kedlaya; Kiran S.,9994,0,9999,5
1715658420118,MATH 197,002,563811,Zhang; Danna,9994,0,9999,5
1715658420118,MATH 197,003,628552,Dumitriu; Ioana,9998,0,9999,1
1715658420118,MATH 197,004,660885,Floyd; Eric,9998,0,9999,1
1715658421143,MCWP 40R,A00,518780,Staff,1,0,20,19
1715658421143,MCWP 40R,B00,518781,Carter; Jennifer A,9,0,20,11
1715658421143,MCWP 40R,C00,518783,Smith; Haydee Marie,5,0,20,15
1715658422178,MCWP 50R,A00,518791,Redela; Pamela Morgan,0,1,20,20
1715658422178,MCWP 50R,B00,518792,Krone; Jarret,0,2,20,20
1715658422178,MCWP 50R,C00,518793,Staff,0,4,20,20
1715658422178,MCWP 50R,D00,518794,Morshed; Michael James,0,2,20,20
1715658422178,MCWP 50R,E00,518795,Carter; Andrea L,0,2,20,20
1715658422178,MCWP 50R,F00,518796,Miller; Elizabeth Deen,0,1,20,20
1715658422178,MCWP 50R,G00,518797,Guillen; Melinda,0,1,20,20
1715658423202,MMW 12R,A01,514034,Herbst; Matthew,0,2,16,16
1715658423202,MMW 12R,A02,514035,Herbst; Matthew,0,0,16,16
1715658424227,MMW 13R,A01,514037,Staff,0,5,16,16
1715658424227,MMW 13R,A02,514039,Staff,0,5,16,16
1715658424227,MMW 13R,A03,628519,Staff,0,4,16,16
1715658426284,SIO 295LS,A00,523233,Staff,10,0,30,20
1715658427309,SIO 295S,A00,523232,Staff,10,0,30,20
1715658428335,SIOC 290S,A01,637330,Merrifield; Mark A,21,0,30,9
1715658429364,SIOC 291S,A01,637333,Gabriel; Corey John,21,0,30,9
1715658430388,SOCI 117,A01,494376,Staff,0,5,5,5
1715658431418,WES 237B,A00,494380,Staff,10,0,20,10
1715658433490,AESE 279B,A00,494370,Wade; Jon P,0,0,33,33
1715658434515,AIP 97,001,660915,Van Den Einde; Yael Dahlia,9998,0,9999,1
1715658435548,AIP 197,001,627712,Vespa; Emanuel Ignacio,9995,0,9999,4
1715658435548,AIP 197,002,650778,Amir; On,9998,0,9999,1
1715658435548,AIP 197,003,650933,Avenancio-Leon; Carlos,9998,0,9999,1
1715658435548,AIP 197,004,658530,Heyman; Gail D.,9998,0,9999,1
1715658435548,AIP 197,005,658631,Neal; Sonya E,9998,0,9999,1
1715658435548,AIP 197,006,658671,Du; Songzi,9998,0,9999,1
1715658436574,ANAR 135S,A00,494369,Braswell; Geoffrey E.,0,0,0,0
1715658437604,BENG 196,001,628496,Engler; Adam J.,9998,0,9999,1
1715658437604,BENG 196,002,660916,Watson; John Thomas,9998,0,9999,1
1715658438633,BISP 197,001,650773,Wilhelm; James E.,9994,0,9999,5
1715658438633,BISP 197,002,658904,Coleman; Aaron B.,9998,0,9999,1
1715658439665,CAT 124RS,A01,519847,Geibel; William,0,0,20,20
1715658440690,CAT 125RS,A01,515971,Geibel; William,0,0,20,20
1715658441720,CLRE 250,A00,511389,Morris; Sheldon,9992,0,9999,7
1715658442750,CLRE 251,A00,507176,Mehta; Ravindra L.,9992,0,9999,7
1715658442750,CLRE 251,B00,511410,Mehta; Ravindra L.,9998,0,9999,1
1715658443776,CLRE 252,A00,507189,Cuomo; Raphael Eduardo,9994,0,9999,5
1715658444802,CLRE 253,A00,507199,Vaida; Florin,9994,0,9999,5
1715658444802,CLRE 253,B00,507202,Vaida; Florin,9999,0,9999,0
1715658445828,CLRE 259,A00,507211,Patel; Hemal,9996,0,9999,3
1715658446852,CLRE 260,A00,507221,Cuomo; Raphael Eduardo,9999,0,9999,0
1715658447877,CLRE 297,001,507242,Cuomo; Raphael Eduardo,9999,0,9999,0
1715658448902,COGS 197,001,638244,Voytek; Bradley Thomas,9997,0,9999,2
1715658449933,CSE 191,A00,516875,Minnes Kemp; Mor Mia,9991,0,9999,8
1715658450958,CSE 197,001,637388,Minnes Kemp; Mor Mia,9992,0,9999,7
1715658451984,CSS 201S,A01,494383,Mignozzetti; Umberto,35,0,35,0
1715658453010,CSS 202S,A01,494387,Mignozzetti; Umberto,35,0,35,0
1715658454038,DSC 197,001,628532,Eldridge; Justin Matthew,9995,0,9999,4
1715658455063,EAP 100,A00,516065,Staff,9799,0,9999,200
1715658456095,ECE 45,A01,507414,Staff,32,0,60,28
1715658458148,ECE 111,A01,507420,Staff,11,0,50,39
1715658459177,ECE 197,001,548057,Sievenpiper; Daniel F.,9991,0,9999,8
1715658460203,EDS 115,A00,507243,Choi; Bailey Miyeon,6,0,28,22
1715658461232,EDS 117,A01,494379,Staff,0,6,34,35
1715658462258,EDS 125,A00,507246,Hopkins; Megan Beth,7,0,30,23
1715658463285,EDS 128A,A01,507264,Fargason; Sharon Gayle,5,0,26,21
1715658464309,EDS 128B,A01,507293,Pappas; Elizabeth,9,0,30,21
1715658465337,EDS 139,A00,507294,Fargason; Sharon Gayle,9,0,30,21
1715658465337,EDS 139,B00,507313,Pappas; Elizabeth,9,0,30,21
1715658466364,EDS 201,A00,507315,Staff,10,0,30,20
1715658467447,EDS 203,A01,507317,Halter; Christopher P.,10,0,30,20
1715658468473,EDS 204R,A01,507319,Halter; Christopher P.,0,3,30,30
1715658468473,EDS 204R,B01,507331,Heinzman; Erica M.,14,0,30,16
1715658469497,EDS 206R,A00,507332,Staff,0,4,30,30
1715658469497,EDS 206R,B00,507343,Staff,15,0,30,15
1715658470522,EDS 250,A00,507344,Hemans; Patricia Ann Benitez,20,0,40,20
1715658471549,EDS 281,A00,507345,Daly; Alan J.,18,0,18,0
1715658472576,EDS 284,A00,507350,Daly; Alan J.,16,0,16,0
1715658473602,EDS 286,A00,507359,Fine; Sarah,18,0,18,0
1715658474630,EDS 289C,A01,507361,Daly; Alan J.,18,0,18,0
1715658475658,EDS 290,A00,507366,Hofstetter; Carolyn,15,0,15,0
1715658476688,LIGM 5A,A00,507421,Fischer-Grunski; Eva K,17,0,20,3
1715658477715,LIGM 5B,A00,507423,Fischer-Grunski; Eva K,19,0,20,1
1715658478743,LIGM 5C,A00,507425,Fischer-Grunski; Eva K,19,0,20,1
1715658479771,LIIT 5AS,A00,507427,Carnelos; Chiara,20,0,20,0
1715658480798,LIIT 5BS,A00,507430,Carnelos; Chiara,20,0,20,0
1715658481822,LIIT 5CS,A00,507432,Carnelos; Chiara,20,0,20,0
1715658482848,LISP 5A,A00,507541,Munoz Sanchez; Alicia,11,0,20,9
1715658483878,LISP 5B,A00,507671,Munoz Sanchez; Alicia,8,0,20,12
1715658484904,LISP 5C,A00,507696,Munoz Sanchez; Alicia,7,0,20,13
1715658485929,MAE 197,001,528363,Boechler; Nicholas Sebastia,9998,0,9999,1
1715658486956,MATH 197,001,523477,Kedlaya; Kiran S.,9994,0,9999,5
1715658486956,MATH 197,002,563811,Zhang; Danna,9994,0,9999,5
1715658486956,MATH 197,003,628552,Dumitriu; Ioana,9998,0,9999,1
1715658486956,MATH 197,004,660885,Floyd; Eric,9998,0,9999,1
1715658487986,MCWP 40R,A00,518780,Staff,1,0,20,19
1715658487986,MCWP 40R,B00,518781,Carter; Jennifer A,9,0,20,11
1715658487986,MCWP 40R,C00,518783,Smith; Haydee Marie,5,0,20,15
1715658489016,MCWP 50R,A00,518791,Redela; Pamela Morgan,0,1,20,20
1715658489016,MCWP 50R,B00,518792,Krone; Jarret,0,2,20,20
1715658489016,MCWP 50R,C00,518793,Staff,0,4,20,20
1715658489016,MCWP 50R,D00,518794,Morshed; Michael James,0,2,20,20
1715658489016,MCWP 50R,E00,518795,Carter; Andrea L,0,2,20,20
1715658489016,MCWP 50R,F00,518796,Miller; Elizabeth Deen,0,1,20,20
1715658489016,MCWP 50R,G00,518797,Guillen; Melinda,0,1,20,20
1715658490042,MMW 12R,A01,514034,Herbst; Matthew,0,2,16,16
1715658490042,MMW 12R,A02,514035,Herbst; Matthew,0,0,16,16
1715658491071,MMW 13R,A01,514037,Staff,0,5,16,16
1715658491071,MMW 13R,A02,514039,Staff,0,5,16,16
1715658491071,MMW 13R,A03,628519,Staff,0,4,16,16
1715658493127,SIO 295LS,A00,523233,Staff,10,0,30,20
1715658494156,SIO 295S,A00,523232,Staff,10,0,30,20
1715658495181,SIOC 290S,A01,637330,Merrifield; Mark A,21,0,30,9
1715658496206,SIOC 291S,A01,637333,Gabriel; Corey John,21,0,30,9
1715658497230,SOCI 117,A01,494376,Staff,0,5,5,5
1715658498256,WES 237B,A00,494380,Staff,10,0,20,10
1715658500334,AESE 279B,A00,494370,Wade; Jon P,0,0,33,33
1715658501359,AIP 97,001,660915,Van Den Einde; Yael Dahlia,9998,0,9999,1
1715658502391,AIP 197,001,627712,Vespa; Emanuel Ignacio,9995,0,9999,4
1715658502391,AIP 197,002,650778,Amir; On,9998,0,9999,1
1715658502391,AIP 197,003,650933,Avenancio-Leon; Carlos,9998,0,9999,1
1715658502391,AIP 197,004,658530,Heyman; Gail D.,9998,0,9999,1
1715658502391,AIP 197,005,658631,Neal; Sonya E,9998,0,9999,1
1715658502391,AIP 197,006,658671,Du; Songzi,9998,0,9999,1
1715658503416,ANAR 135S,A00,494369,Braswell; Geoffrey E.,0,0,0,0
1715658504443,BENG 196,001,628496,Engler; Adam J.,9998,0,9999,1
1715658504443,BENG 196,002,660916,Watson; John Thomas,9998,0,9999,1
1715658505474,BISP 197,001,650773,Wilhelm; James E.,9994,0,9999,5
1715658505474,BISP 197,002,658904,Coleman; Aaron B.,9998,0,9999,1
1715658506502,CAT 124RS,A01,519847,Geibel; William,0,0,20,20
1715658507527,CAT 125RS,A01,515971,Geibel; William,0,0,20,20
1715658508554,CLRE 250,A00,511389,Morris; Sheldon,9992,0,9999,7
1715658509584,CLRE 251,A00,507176,Mehta; Ravindra L.,9992,0,9999,7
1715658509584,CLRE 251,B00,511410,Mehta; Ravindra L.,9998,0,9999,1
1715658510610,CLRE 252,A00,507189,Cuomo; Raphael Eduardo,9994,0,9999,5
1715658511637,CLRE 253,A00,507199,Vaida; Florin,9994,0,9999,5
1715658511637,CLRE 253,B00,507202,Vaida; Florin,9999,0,9999,0
1715658512662,CLRE 259,A00,507211,Patel; Hemal,9996,0,9999,3
1715658513686,CLRE 260,A00,507221,Cuomo; Raphael Eduardo,9999,0,9999,0
1715658514712,CLRE 297,001,507242,Cuomo; Raphael Eduardo,9999,0,9999,0
1715658515740,COGS 197,001,638244,Voytek; Bradley Thomas,9997,0,9999,2
1715658516769,CSE 191,A00,516875,Minnes Kemp; Mor Mia,9991,0,9999,8
1715658517795,CSE 197,001,637388,Minnes Kemp; Mor Mia,9992,0,9999,7
1715658518826,CSS 201S,A01,494383,Mignozzetti; Umberto,35,0,35,0
1715658519850,CSS 202S,A01,494387,Mignozzetti; Umberto,35,0,35,0
1715658520875,DSC 197,001,628532,Eldridge; Justin Matthew,9995,0,9999,4
1715658521903,EAP 100,A00,516065,Staff,9799,0,9999,200
1715658522933,ECE 45,A01,507414,Staff,32,0,60,28
1715658524987,ECE 111,A01,507420,Staff,11,0,50,39
1715658526016,ECE 197,001,548057,Sievenpiper; Daniel F.,9991,0,9999,8
1715658527043,EDS 115,A00,507243,Choi; Bailey Miyeon,6,0,28,22
1715658528070,EDS 117,A01,494379,Staff,0,6,34,35
1715658529098,EDS 125,A00,507246,Hopkins; Megan Beth,7,0,30,23
1715658530125,EDS 128A,A01,507264,Fargason; Sharon Gayle,5,0,26,21
1715658531154,EDS 128B,A01,507293,Pappas; Elizabeth,9,0,30,21
1715658532185,EDS 139,A00,507294,Fargason; Sharon Gayle,9,0,30,21
1715658532185,EDS 139,B00,507313,Pappas; Elizabeth,9,0,30,21
1715658533212,EDS 201,A00,507315,Staff,10,0,30,20
1715658534242,EDS 203,A01,507317,Halter; Christopher P.,10,0,30,20
1715658535274,EDS 204R,A01,507319,Halter; Christopher P.,0,3,30,30
1715658535274,EDS 204R,B01,507331,Heinzman; Erica M.,14,0,30,16
1715658536303,EDS 206R,A00,507332,Staff,0,4,30,30
1715658536303,EDS 206R,B00,507343,Staff,15,0,30,15
1715658537329,EDS 250,A00,507344,Hemans; Patricia Ann Benitez,20,0,40,20
1715658538359,EDS 281,A00,507345,Daly; Alan J.,18,0,18,0
1715658539385,EDS 284,A00,507350,Daly; Alan J.,16,0,16,0
1715658540411,EDS 286,A00,507359,Fine; Sarah,18,0,18,0
1715658541437,EDS 289C,A01,507361,Daly; Alan J.,18,0,18,0
1715658542462,EDS 290,A00,507366,Hofstetter; Carolyn,15,0,15,0
1715658543496,LIGM 5A,A00,507421,Fischer-Grunski; Eva K,17,0,20,3
1715658544528,LIGM 5B,A00,507423,Fischer-Grunski; Eva K,19,0,20,1
1715658545557,LIGM 5C,A00,507425,Fischer-Grunski; Eva K,19,0,20,1
1715658546588,LIIT 5AS,A00,507427,Carnelos; Chiara,20,0,20,0
1715658547620,LIIT 5BS,A00,507430,Carnelos; Chiara,20,0,20,0
1715658548646,LIIT 5CS,A00,507432,Carnelos; Chiara,20,0,20,0
1715658549676,LISP 5A,A00,507541,Munoz Sanchez; Alicia,11,0,20,9
1715658550704,LISP 5B,A00,507671,Munoz Sanchez; Alicia,8,0,20,12
1715658551729,LISP 5C,A00,507696,Munoz Sanchez; Alicia,7,0,20,13
1715658552755,MAE 197,001,528363,Boechler; Nicholas Sebastia,9998,0,9999,1
1715658553781,MATH 197,001,523477,Kedlaya; Kiran S.,9994,0,9999,5
1715658553781,MATH 197,002,563811,Zhang; Danna,9994,0,9999,5
1715658553781,MATH 197,003,628552,Dumitriu; Ioana,9998,0,9999,1
1715658553781,MATH 197,004,660885,Floyd; Eric,9998,0,9999,1
1715658554809,MCWP 40R,A00,518780,Staff,1,0,20,19
1715658554809,MCWP 40R,B00,518781,Carter; Jennifer A,9,0,20,11
1715658554809,MCWP 40R,C00,518783,Smith; Haydee Marie,5,0,20,15
1715658555838,MCWP 50R,A00,518791,Redela; Pamela Morgan,0,1,20,20
1715658555838,MCWP 50R,B00,518792,Krone; Jarret,0,2,20,20
1715658555838,MCWP 50R,C00,518793,Staff,0,4,20,20
1715658555838,MCWP 50R,D00,518794,Morshed; Michael James,0,2,20,20
1715658555838,MCWP 50R,E00,518795,Carter; Andrea L,0,2,20,20
1715658555838,MCWP 50R,F00,518796,Miller; Elizabeth Deen,0,1,20,20
1715658555838,MCWP 50R,G00,518797,Guillen; Melinda,0,1,20,20
1715658556862,MMW 12R,A01,514034,Herbst; Matthew,0,2,16,16
1715658556862,MMW 12R,A02,514035,Herbst; Matthew,0,0,16,16
1715658557891,MMW 13R,A01,514037,Staff,0,5,16,16
1715658557891,MMW 13R,A02,514039,Staff,0,5,16,16
1715658557891,MMW 13R,A03,628519,Staff,0,4,16,16
1715658559944,SIO 295LS,A00,523233,Staff,10,0,30,20
1715658560970,SIO 295S,A00,523232,Staff,10,0,30,20
1715658561997,SIOC 290S,A01,637330,Merrifield; Mark A,21,0,30,9
1715658563026,SIOC 291S,A01,637333,Gabriel; Corey John,21,0,30,9
1715658564055,SOCI 117,A01,494376,Staff,0,5,5,5
1715658565083,WES 237B,A00,494380,Staff,10,0,20,10
1715658567161,AESE 279B,A00,494370,Wade; Jon P,0,0,33,33
1715658568188,AIP 97,001,660915,Van Den Einde; Yael Dahlia,9998,0,9999,1
1715658569217,AIP 197,001,627712,Vespa; Emanuel Ignacio,9995,0,9999,4
1715658569217,AIP 197,002,650778,Amir; On,9998,0,9999,1
1715658569217,AIP 197,003,650933,Avenancio-Leon; Carlos,9998,0,9999,1
1715658569217,AIP 197,004,658530,Heyman; Gail D.,9998,0,9999,1
1715658569217,AIP 197,005,658631,Neal; Sonya E,9998,0,9999,1
1715658569217,AIP 197,006,658671,Du; Songzi,9998,0,9999,1
1715658570243,ANAR 135S,A00,494369,Braswell; Geoffrey E.,0,0,0,0
1715658571324,BENG 196,001,628496,Engler; Adam J.,9998,0,9999,1
1715658571324,BENG 196,002,660916,Watson; John Thomas,9998,0,9999,1
1715658572353,BISP 197,001,650773,Wilhelm; James E.,9994,0,9999,5
1715658572353,BISP 197,002,658904,Coleman; Aaron B.,9998,0,9999,1
1715658573384,CAT 124RS,A01,519847,Geibel; William,0,0,20,20
1715658574412,CAT 125RS,A01,515971,Geibel; William,0,0,20,20
1715658575441,CLRE 250,A00,511389,Morris; Sheldon,9992,0,9999,7
1715658576468,CLRE 251,A00,507176,Mehta; Ravindra L.,9992,0,9999,7
1715658576468,CLRE 251,B00,511410,Mehta; Ravindra L.,9998,0,9999,1
1715658577496,CLRE 252,A00,507189,Cuomo; Raphael Eduardo,9994,0,9999,5
1715658578525,CLRE 253,A00,507199,Vaida; Florin,9994,0,9999,5
1715658578525,CLRE 253,B00,507202,Vaida; Florin,9999,0,9999,0
1715658579550,CLRE 259,A00,507211,Patel; Hemal,9996,0,9999,3
1715658580576,CLRE 260,A00,507221,Cuomo; Raphael Eduardo,9999,0,9999,0
1715658581601,CLRE 297,001,507242,Cuomo; Raphael Eduardo,9999,0,9999,0
1715658582631,COGS 197,001,638244,Voytek; Bradley Thomas,9997,0,9999,2
1715658583657,CSE 191,A00,516875,Minnes Kemp; Mor Mia,9991,0,9999,8
1715658584682,CSE 197,001,637388,Minnes Kemp; Mor Mia,9992,0,9999,7
1715658585717,CSS 201S,A01,494383,Mignozzetti; Umberto,35,0,35,0
1715658586741,CSS 202S,A01,494387,Mignozzetti; Umberto,35,0,35,0
1715658587766,DSC 197,001,628532,Eldridge; Justin Matthew,9995,0,9999,4
1715658588795,EAP 100,A00,516065,Staff,9799,0,9999,200
1715658589826,ECE 45,A01,507414,Staff,32,0,60,28
1715658591879,ECE 111,A01,507420,Staff,11,0,50,39
1715658592905,ECE 197,001,548057,Sievenpiper; Daniel F.,9991,0,9999,8
1715658593931,EDS 115,A00,507243,Choi; Bailey Miyeon,6,0,28,22
1715658594956,EDS 117,A01,494379,Staff,0,6,34,35
1715658595985,EDS 125,A00,507246,Hopkins; Megan Beth,7,0,30,23
1715658597010,EDS 128A,A01,507264,Fargason; Sharon Gayle,5,0,26,21
1715658598036,EDS 128B,A01,507293,Pappas; Elizabeth,9,0,30,21
1715658599065,EDS 139,A00,507294,Fargason; Sharon Gayle,9,0,30,21
1715658599065,EDS 139,B00,507313,Pappas; Elizabeth,9,0,30,21
1715658600090,EDS 201,A00,507315,Staff,10,0,30,20
1715658601119,EDS 203,A01,507317,Halter; Christopher P.,10,0,30,20
1715658602145,EDS 204R,A01,507319,Halter; Christopher P.,0,3,30,30
1715658602145,EDS 204R,B01,507331,Heinzman; Erica M.,14,0,30,16
1715658603174,EDS 206R,A00,507332,Staff,0,4,30,30
1715658603174,EDS 206R,B00,507343,Staff,15,0,30,15
1715658604203,EDS 250,A00,507344,Hemans; Patricia Ann Benitez,20,0,40,20
1715658605228,EDS 281,A00,507345,Daly; Alan J.,18,0,18,0
1715658606254,EDS 284,A00,507350,Daly; Alan J.,16,0,16,0
1715658607285,EDS 286,A00,507359,Fine; Sarah,18,0,18,0
1715658608311,EDS 289C,A01,507361,Daly; Alan J.,18,0,18,0
1715658609340,EDS 290,A00,507366,Hofstetter; Carolyn,15,0,15,0
1715658610367,LIGM 5A,A00,507421,Fischer-Grunski; Eva K,17,0,20,3
1715658611393,LIGM 5B,A00,507423,Fischer-Grunski; Eva K,19,0,20,1
1715658612421,LIGM 5C,A00,507425,Fischer-Grunski; Eva K,19,0,20,1
1715658613451,LIIT 5AS,A00,507427,Carnelos; Chiara,20,0,20,0
1715658614477,LIIT 5BS,A00,507430,Carnelos; Chiara,20,0,20,0
1715658615504,LIIT 5CS,A00,507432,Carnelos; Chiara,20,0,20,0
1715658616529,LISP 5A,A00,507541,Munoz Sanchez; Alicia,11,0,20,9
1715658617557,LISP 5B,A00,507671,Munoz Sanchez; Alicia,8,0,20,12
1715658618582,LISP 5C,A00,507696,Munoz Sanchez; Alicia,7,0,20,13
1715658619609,MAE 197,001,528363,Boechler; Nicholas Sebastia,9998,0,9999,1
1715658620637,MATH 197,001,523477,Kedlaya; Kiran S.,9994,0,9999,5
1715658620637,MATH 197,002,563811,Zhang; Danna,9994,0,9999,5
1715658620637,MATH 197,003,628552,Dumitriu; Ioana,9998,0,9999,1
1715658620637,MATH 197,004,660885,Floyd; Eric,9998,0,9999,1
1715658621665,MCWP 40R,A00,518780,Staff,1,0,20,19
1715658621665,MCWP 40R,B00,518781,Carter; Jennifer A,9,0,20,11
1715658621665,MCWP 40R,C00,518783,Smith; Haydee Marie,5,0,20,15
1715658622694,MCWP 50R,A00,518791,Redela; Pamela Morgan,0,1,20,20
1715658622694,MCWP 50R,B00,518792,Krone; Jarret,0,2,20,20
1715658622694,MCWP 50R,C00,518793,Staff,0,4,20,20
1715658622694,MCWP 50R,D00,518794,Morshed; Michael James,0,2,20,20
1715658622694,MCWP 50R,E00,518795,Carter; Andrea L,0,2,20,20
1715658622694,MCWP 50R,F00,518796,Miller; Elizabeth Deen,0,1,20,20
1715658622694,MCWP 50R,G00,518797,Guillen; Melinda,0,1,20,20
1715658623720,MMW 12R,A01,514034,Herbst; Matthew,0,2,16,16
1715658623720,MMW 12R,A02,514035,Herbst; Matthew,0,0,16,16
1715658624746,MMW 13R,A01,514037,Staff,0,5,16,16
1715658624746,MMW 13R,A02,514039,Staff,0,5,16,16
1715658624746,MMW 13R,A03,628519,Staff,0,4,16,16
1715658626800,SIO 295LS,A00,523233,Staff,10,0,30,20
1715658627824,SIO 295S,A00,523232,Staff,10,0,30,20
1715658628849,SIOC 290S,A01,637330,Merrifield; Mark A,21,0,30,9
1715658629875,SIOC 291S,A01,637333,Gabriel; Corey John,21,0,30,9
1715658630905,SOCI 117,A01,494376,Staff,0,5,5,5
1715658631933,WES 237B,A00,494380,Staff,10,0,20,10
1715658633993,AESE 279B,A00,494370,Wade; Jon P,0,0,33,33
1715658635018,AIP 97,001,660915,Van Den Einde; Yael Dahlia,9998,0,9999,1
1715658636047,AIP 197,001,627712,Vespa; Emanuel Ignacio,9995,0,9999,4
1715658636047,AIP 197,002,650778,Amir; On,9998,0,9999,1
1715658636047,AIP 197,003,650933,Avenancio-Leon; Carlos,9998,0,9999,1
1715658636047,AIP 197,004,658530,Heyman; Gail D.,9998,0,9999,1
1715658636047,AIP 197,005,658631,Neal; Sonya E,9998,0,9999,1
1715658636047,AIP 197,006,658671,Du; Songzi,9998,0,9999,1
1715658637072,ANAR 135S,A00,494369,Braswell; Geoffrey E.,0,0,0,0
1715658638100,BENG 196,001,628496,Engler; Adam J.,9998,0,9999,1
1715658638100,BENG 196,002,660916,Watson; John Thomas,9998,0,9999,1
1715658639127,BISP 197,001,650773,Wilhelm; James E.,9994,0,9999,5
1715658639127,BISP 197,002,658904,Coleman; Aaron B.,9998,0,9999,1
1715658640157,CAT 124RS,A01,519847,Geibel; William,0,0,20,20
1715658641183,CAT 125RS,A01,515971,Geibel; William,0,0,20,20
1715658642209,CLRE 250,A00,511389,Morris; Sheldon,9992,0,9999,7
1715658643242,CLRE 251,A00,507176,Mehta; Ravindra L.,9992,0,9999,7
1715658643242,CLRE 251,B00,511410,Mehta; Ravindra L.,9998,0,9999,1
1715658644270,CLRE 252,A00,507189,Cuomo; Raphael Eduardo,9994,0,9999,5
1715658645296,CLRE 253,A00,507199,Vaida; Florin,9994,0,9999,5
1715658645296,CLRE 253,B00,507202,Vaida; Florin,9999,0,9999,0
1715658646321,CLRE 259,A00,507211,Patel; Hemal,9996,0,9999,3
1715658647347,CLRE 260,A00,507221,Cuomo; Raphael Eduardo,9999,0,9999,0
1715658648374,CLRE 297,001,507242,Cuomo; Raphael Eduardo,9999,0,9999,0
1715658649404,COGS 197,001,638244,Voytek; Bradley Thomas,9997,0,9999,2
1715658650433,CSE 191,A00,516875,Minnes Kemp; Mor Mia,9991,0,9999,8
1715658651458,CSE 197,001,637388,Minnes Kemp; Mor Mia,9992,0,9999,7
1715658652491,CSS 201S,A01,494383,Mignozzetti; Umberto,35,0,35,0
1715658653515,CSS 202S,A01,494387,Mignozzetti; Umberto,35,0,35,0
1715658654543,DSC 197,001,628532,Eldridge; Justin Matthew,9995,0,9999,4
1715658655568,EAP 100,A00,516065,Staff,9799,0,9999,200
1715658656600,ECE 45,A01,507414,Staff,32,0,60,28
1715658658651,ECE 111,A01,507420,Staff,11,0,50,39
1715658659676,ECE 197,001,548057,Sievenpiper; Daniel F.,9991,0,9999,8
1715658660702,EDS 115,A00,507243,Choi; Bailey Miyeon,6,0,28,22
1715658661727,EDS 117,A01,494379,Staff,0,6,34,35
1715658662757,EDS 125,A00,507246,Hopkins; Megan Beth,7,0,30,23
1715658663784,EDS 128A,A01,507264,Fargason; Sharon Gayle,5,0,26,21
1715658664811,EDS 128B,A01,507293,Pappas; Elizabeth,9,0,30,21
1715658665835,EDS 139,A00,507294,Fargason; Sharon Gayle,9,0,30,21
1715658665835,EDS 139,B00,507313,Pappas; Elizabeth,9,0,30,21
1715658666864,EDS 201,A00,507315,Staff,10,0,30,20
1715658667892,EDS 203,A01,507317,Halter; Christopher P.,10,0,30,20
1715658668923,EDS 204R,A01,507319,Halter; Christopher P.,0,3,30,30
1715658668923,EDS 204R,B01,507331,Heinzman; Erica M.,14,0,30,16
1715658669949,EDS 206R,A00,507332,Staff,0,4,30,30
1715658669949,EDS 206R,B00,507343,Staff,15,0,30,15
1715658670975,EDS 250,A00,507344,Hemans; Patricia Ann Benitez,20,0,40,20
1715658672003,EDS 281,A00,507345,Daly; Alan J.,18,0,18,0
1715658673028,EDS 284,A00,507350,Daly; Alan J.,16,0,16,0
1715658674053,EDS 286,A00,507359,Fine; Sarah,18,0,18,0
1715658675134,EDS 289C,A01,507361,Daly; Alan J.,18,0,18,0
1715658676160,EDS 290,A00,507366,Hofstetter; Carolyn,15,0,15,0
1715658677187,LIGM 5A,A00,507421,Fischer-Grunski; Eva K,17,0,20,3
1715658678213,LIGM 5B,A00,507423,Fischer-Grunski; Eva K,19,0,20,1
1715658679242,LIGM 5C,A00,507425,Fischer-Grunski; Eva K,19,0,20,1
1715658680270,LIIT 5AS,A00,507427,Carnelos; Chiara,20,0,20,0
1715658681296,LIIT 5BS,A00,507430,Carnelos; Chiara,20,0,20,0
1715658682322,LIIT 5CS,A00,507432,Carnelos; Chiara,20,0,20,0
1715658683348,LISP 5A,A00,507541,Munoz Sanchez; Alicia,11,0,20,9
1715658684378,LISP 5B,A00,507671,Munoz Sanchez; Alicia,8,0,20,12
1715658685403,LISP 5C,A00,507696,Munoz Sanchez; Alicia,7,0,20,13
1715658686429,MAE 197,001,528363,Boechler; Nicholas Sebastia,9998,0,9999,1
1715658687457,MATH 197,001,523477,Kedlaya; Kiran S.,9994,0,9999,5
1715658687457,MATH 197,002,563811,Zhang; Danna,9994,0,9999,5
1715658687457,MATH 197,003,628552,Dumitriu; Ioana,9998,0,9999,1
1715658687457,MATH 197,004,660885,Floyd; Eric,9998,0,9999,1
1715658688483,MCWP 40R,A00,518780,Staff,1,0,20,19
1715658688483,MCWP 40R,B00,518781,Carter; Jennifer A,9,0,20,11
1715658688483,MCWP 40R,C00,518783,Smith; Haydee Marie,5,0,20,15
1715658689510,MCWP 50R,A00,518791,Redela; Pamela Morgan,0,1,20,20
1715658689510,MCWP 50R,B00,518792,Krone; Jarret,0,2,20,20
1715658689510,MCWP 50R,C00,518793,Staff,0,4,20,20
1715658689510,MCWP 50R,D00,518794,Morshed; Michael James,0,2,20,20
1715658689510,MCWP 50R,E00,518795,Carter; Andrea L,0,2,20,20
1715658689510,MCWP 50R,F00,518796,Miller; Elizabeth Deen,0,1,20,20
1715658689510,MCWP 50R,G00,518797,Guillen; Melinda,0,1,20,20
1715658690537,MMW 12R,A01,514034,Herbst; Matthew,0,2,16,16
1715658690537,MMW 12R,A02,514035,Herbst; Matthew,0,0,16,16
1715658691562,MMW 13R,A01,514037,Staff,0,5,16,16
1715658691562,MMW 13R,A02,514039,Staff,0,5,16,16
1715658691562,MMW 13R,A03,628519,Staff,0,4,16,16
1715658693618,SIO 295LS,A00,523233,Staff,10,0,30,20
1715658694656,SIO 295S,A00,523232,Staff,10,0,30,20
1715658695685,SIOC 290S,A01,637330,Merrifield; Mark A,21,0,30,9
1715658696711,SIOC 291S,A01,637333,Gabriel; Corey John,21,0,30,9
1715658697740,SOCI 117,A01,494376,Staff,0,5,5,5
1715658698765,WES 237B,A00,494380,Staff,10,0,20,10
1715658700843,AESE 279B,A00,494370,Wade; Jon P,0,0,33,33
1715658701871,AIP 97,001,660915,Van Den Einde; Yael Dahlia,9998,0,9999,1
1715658702905,AIP 197,001,627712,Vespa; Emanuel Ignacio,9995,0,9999,4
1715658702905,AIP 197,002,650778,Amir; On,9998,0,9999,1
1715658702905,AIP 197,003,650933,Avenancio-Leon; Carlos,9998,0,9999,1
1715658702905,AIP 197,004,658530,Heyman; Gail D.,9998,0,9999,1
1715658702905,AIP 197,005,658631,Neal; Sonya E,9998,0,9999,1
1715658702905,AIP 197,006,658671,Du; Songzi,9998,0,9999,1
1715658703932,ANAR 135S,A00,494369,Braswell; Geoffrey E.,0,0,0,0
1715658704960,BENG 196,001,628496,Engler; Adam J.,9998,0,9999,1
1715658704960,BENG 196,002,660916,Watson; John Thomas,9998,0,9999,1
1715658705985,BISP 197,001,650773,Wilhelm; James E.,9994,0,9999,5
1715658705985,BISP 197,002,658904,Coleman; Aaron B.,9998,0,9999,1
1715658707010,CAT 124RS,A01,519847,Geibel; William,0,0,20,20
1715658708039,CAT 125RS,A01,515971,Geibel; William,0,0,20,20
1715658709065,CLRE 250,A00,511389,Morris; Sheldon,9992,0,9999,7
1715658710092,CLRE 251,A00,507176,Mehta; Ravindra L.,9992,0,9999,7
1715658710092,CLRE 251,B00,511410,Mehta; Ravindra L.,9998,0,9999,1
1715658711117,CLRE 252,A00,507189,Cuomo; Raphael Eduardo,9994,0,9999,5
1715658712145,CLRE 253,A00,507199,Vaida; Florin,9994,0,9999,5
1715658712145,CLRE 253,B00,507202,Vaida; Florin,9999,0,9999,0
1715658713172,CLRE 259,A00,507211,Patel; Hemal,9996,0,9999,3
1715658714197,CLRE 260,A00,507221,Cuomo; Raphael Eduardo,9999,0,9999,0
1715658715223,CLRE 297,001,507242,Cuomo; Raphael Eduardo,9999,0,9999,0
1715658716252,COGS 197,001,638244,Voytek; Bradley Thomas,9997,0,9999,2
1715658717280,CSE 191,A00,516875,Minnes Kemp; Mor Mia,9991,0,9999,8
1715658718306,CSE 197,001,637388,Minnes Kemp; Mor Mia,9992,0,9999,7
1715658719334,CSS 201S,A01,494383,Mignozzetti; Umberto,35,0,35,0
1715658720367,CSS 202S,A01,494387,Mignozzetti; Umberto,35,0,35,0
1715658721393,DSC 197,001,628532,Eldridge; Justin Matthew,9995,0,9999,4
1715658722422,EAP 100,A00,516065,Staff,9799,0,9999,200
1715658723451,ECE 45,A01,507414,Staff,32,0,60,28
1715658725503,ECE 111,A01,507420,Staff,11,0,50,39
1715658726534,ECE 197,001,548057,Sievenpiper; Daniel F.,9991,0,9999,8
1715658727566,EDS 115,A00,507243,Choi; Bailey Miyeon,6,0,28,22
1715658728594,EDS 117,A01,494379,Staff,0,6,34,35
1715658729621,EDS 125,A00,507246,Hopkins; Megan Beth,7,0,30,23
1715658730649,EDS 128A,A01,507264,Fargason; Sharon Gayle,5,0,26,21
1715658731679,EDS 128B,A01,507293,Pappas; Elizabeth,9,0,30,21
1715658732708,EDS 139,A00,507294,Fargason; Sharon Gayle,9,0,30,21
1715658732708,EDS 139,B00,507313,Pappas; Elizabeth,9,0,30,21
1715658733733,EDS 201,A00,507315,Staff,10,0,30,20
1715658734761,EDS 203,A01,507317,Halter; Christopher P.,10,0,30,20
1715658735786,EDS 204R,A01,507319,Halter; Christopher P.,0,3,30,30
1715658735786,EDS 204R,B01,507331,Heinzman; Erica M.,14,0,30,16
1715658736811,EDS 206R,A00,507332,Staff,0,4,30,30
1715658736811,EDS 206R,B00,507343,Staff,15,0,30,15
1715658737836,EDS 250,A00,507344,Hemans; Patricia Ann Benitez,20,0,40,20
1715658738862,EDS 281,A00,507345,Daly; Alan J.,18,0,18,0
1715658739889,EDS 284,A00,507350,Daly; Alan J.,16,0,16,0
1715658740917,EDS 286,A00,507359,Fine; Sarah,18,0,18,0
1715658741942,EDS 289C,A01,507361,Daly; Alan J.,18,0,18,0
1715658742968,EDS 290,A00,507366,Hofstetter; Carolyn,15,0,15,0
1715658743998,LIGM 5A,A00,507421,Fischer-Grunski; Eva K,17,0,20,3
1715658745027,LIGM 5B,A00,507423,Fischer-Grunski; Eva K,19,0,20,1
1715658746051,LIGM 5C,A00,507425,Fischer-Grunski; Eva K,19,0,20,1
1715658747076,LIIT 5AS,A00,507427,Carnelos; Chiara,20,0,20,0
1715658748102,LIIT 5BS,A00,507430,Carnelos; Chiara,20,0,20,0
1715658749128,LIIT 5CS,A00,507432,Carnelos; Chiara,20,0,20,0
1715658750155,LISP 5A,A00,507541,Munoz Sanchez; Alicia,11,0,20,9
1715658751181,LISP 5B,A00,507671,Munoz Sanchez; Alicia,8,0,20,12
1715658752206,LISP 5C,A00,507696,Munoz Sanchez; Alicia,7,0,20,13
1715658753237,MAE 197,001,528363,Boechler; Nicholas Sebastia,9998,0,9999,1
1715658754265,MATH 197,001,523477,Kedlaya; Kiran S.,9994,0,9999,5
1715658754265,MATH 197,002,563811,Zhang; Danna,9994,0,9999,5
1715658754265,MATH 197,003,628552,Dumitriu; Ioana,9998,0,9999,1
1715658754265,MATH 197,004,660885,Floyd; Eric,9998,0,9999,1
1715658755292,MCWP 40R,A00,518780,Staff,1,0,20,19
1715658755292,MCWP 40R,B00,518781,Carter; Jennifer A,9,0,20,11
1715658755292,MCWP 40R,C00,518783,Smith; Haydee Marie,5,0,20,15
1715658756327,MCWP 50R,A00,518791,Redela; Pamela Morgan,0,1,20,20
1715658756327,MCWP 50R,B00,518792,Krone; Jarret,0,2,20,20
1715658756327,MCWP 50R,C00,518793,Staff,0,4,20,20
1715658756327,MCWP 50R,D00,518794,Morshed; Michael James,0,2,20,20
1715658756327,MCWP 50R,E00,518795,Carter; Andrea L,0,2,20,20
1715658756327,MCWP 50R,F00,518796,Miller; Elizabeth Deen,0,1,20,20
1715658756327,MCWP 50R,G00,518797,Guillen; Melinda,0,1,20,20
1715658757357,MMW 12R,A01,514034,Herbst; Matthew,0,2,16,16
1715658757357,MMW 12R,A02,514035,Herbst; Matthew,0,0,16,16
1715658758386,MMW 13R,A01,514037,Staff,0,5,16,16
1715658758386,MMW 13R,A02,514039,Staff,0,5,16,16
1715658758386,MMW 13R,A03,628519,Staff,0,4,16,16
1715658760441,SIO 295LS,A00,523233,Staff,10,0,30,20
1715658761466,SIO 295S,A00,523232,Staff,10,0,30,20
1715658762498,SIOC 290S,A01,637330,Merrifield; Mark A,21,0,30,9
1715658763524,SIOC 291S,A01,637333,Gabriel; Corey John,21,0,30,9
1715658764550,SOCI 117,A01,494376,Staff,0,5,5,5
1715658765578,WES 237B,A00,494380,Staff,10,0,20,10
1715658767648,AESE 279B,A00,494370,Wade; Jon P,0,0,33,33
1715658768672,AIP 97,001,660915,Van Den Einde; Yael Dahlia,9998,0,9999,1
1715658769702,AIP 197,001,627712,Vespa; Emanuel Ignacio,9995,0,9999,4
1715658769702,AIP 197,002,650778,Amir; On,9998,0,9999,1
1715658769702,AIP 197,003,650933,Avenancio-Leon; Carlos,9998,0,9999,1
1715658769702,AIP 197,004,658530,Heyman; Gail D.,9998,0,9999,1
1715658769702,AIP 197,005,658631,Neal; Sonya E,9998,0,9999,1
1715658769702,AIP 197,006,658671,Du; Songzi,9998,0,9999,1
1715658770728,ANAR 135S,A00,494369,Braswell; Geoffrey E.,0,0,0,0
1715658771753,BENG 196,001,628496,Engler; Adam J.,9998,0,9999,1
1715658771753,BENG 196,002,660916,Watson; John Thomas,9998,0,9999,1
1715658772779,BISP 197,001,650773,Wilhelm; James E.,9994,0,9999,5
1715658772779,BISP 197,002,658904,Coleman; Aaron B.,9998,0,9999,1
1715658773805,CAT 124RS,A01,519847,Geibel; William,0,0,20,20
1715658774831,CAT 125RS,A01,515971,Geibel; William,0,0,20,20
1715658775856,CLRE 250,A00,511389,Morris; Sheldon,9992,0,9999,7
1715658776887,CLRE 251,A00,507176,Mehta; Ravindra L.,9992,0,9999,7
1715658776887,CLRE 251,B00,511410,Mehta; Ravindra L.,9998,0,9999,1
1715658777914,CLRE 252,A00,507189,Cuomo; Raphael Eduardo,9994,0,9999,5
1715658778995,CLRE 253,A00,507199,Vaida; Florin,9994,0,9999,5
1715658778995,CLRE 253,B00,507202,Vaida; Florin,9999,0,9999,0
1715658780023,CLRE 259,A00,507211,Patel; Hemal,9996,0,9999,3
1715658781049,CLRE 260,A00,507221,Cuomo; Raphael Eduardo,9999,0,9999,0
1715658782074,CLRE 297,001,507242,Cuomo; Raphael Eduardo,9999,0,9999,0
1715658783104,COGS 197,001,638244,Voytek; Bradley Thomas,9997,0,9999,2
1715658784129,CSE 191,A00,516875,Minnes Kemp; Mor Mia,9991,0,9999,8
1715658785159,CSE 197,001,637388,Minnes Kemp; Mor Mia,9992,0,9999,7
1715658786190,CSS 201S,A01,494383,Mignozzetti; Umberto,35,0,35,0
1715658787216,CSS 202S,A01,494387,Mignozzetti; Umberto,35,0,35,0
1715658788243,DSC 197,001,628532,Eldridge; Justin Matthew,9995,0,9999,4
1715658789268,EAP 100,A00,516065,Staff,9799,0,9999,200
1715658790294,ECE 45,A01,507414,Staff,32,0,60,28
1715658792344,ECE 111,A01,507420,Staff,11,0,50,39
1715658793370,ECE 197,001,548057,Sievenpiper; Daniel F.,9991,0,9999,8
1715658794403,EDS 115,A00,507243,Choi; Bailey Miyeon,6,0,28,22
1715658795427,EDS 117,A01,494379,Staff,0,6,34,35
1715658796453,EDS 125,A00,507246,Hopkins; Megan Beth,7,0,30,23
1715658797483,EDS 128A,A01,507264,Fargason; Sharon Gayle,5,0,26,21
1715658798511,EDS 128B,A01,507293,Pappas; Elizabeth,9,0,30,21
1715658799536,EDS 139,A00,507294,Fargason; Sharon Gayle,9,0,30,21
1715658799536,EDS 139,B00,507313,Pappas; Elizabeth,9,0,30,21
1715658800561,EDS 201,A00,507315,Staff,10,0,30,20
1715658801587,EDS 203,A01,507317,Halter; Christopher P.,10,0,30,20
1715658802616,EDS 204R,A01,507319,Halter; Christopher P.,0,3,30,30
1715658802616,EDS 204R,B01,507331,Heinzman; Erica M.,14,0,30,16
1715658803641,EDS 206R,A00,507332,Staff,0,4,30,30
1715658803641,EDS 206R,B00,507343,Staff,15,0,30,15
1715658804695,EDS 250,A00,507344,Hemans; Patricia Ann Benitez,20,0,40,20
1715658805722,EDS 281,A00,507345,Daly; Alan J.,18,0,18,0
1715658806746,EDS 284,A00,507350,Daly; Alan J.,16,0,16,0
1715658807772,EDS 286,A00,507359,Fine; Sarah,18,0,18,0
1715658808796,EDS 289C,A01,507361,Daly; Alan J.,18,0,18,0
1715658809823,EDS 290,A00,507366,Hofstetter; Carolyn,15,0,15,0
1715658810854,LIGM 5A,A00,507421,Fischer-Grunski; Eva K,17,0,20,3
1715658811879,LIGM 5B,A00,507423,Fischer-Grunski; Eva K,19,0,20,1
1715658812905,LIGM 5C,A00,507425,Fischer-Grunski; Eva K,19,0,20,1
1715658813931,LIIT 5AS,A00,507427,Carnelos; Chiara,20,0,20,0
1715658814956,LIIT 5BS,A00,507430,Carnelos; Chiara,20,0,20,0
1715658815985,LIIT 5CS,A00,507432,Carnelos; Chiara,20,0,20,0
1715658817015,LISP 5A,A00,507541,Munoz Sanchez; Alicia,11,0,20,9
1715658818041,LISP 5B,A00,507671,Munoz Sanchez; Alicia,8,0,20,12
1715658819069,LISP 5C,A00,507696,Munoz Sanchez; Alicia,7,0,20,13
1715658820094,MAE 197,001,528363,Boechler; Nicholas Sebastia,9998,0,9999,1
1715658821127,MATH 197,001,523477,Kedlaya; Kiran S.,9994,0,9999,5
1715658821127,MATH 197,002,563811,Zhang; Danna,9994,0,9999,5
1715658821127,MATH 197,003,628552,Dumitriu; Ioana,9998,0,9999,1
1715658821127,MATH 197,004,660885,Floyd; Eric,9998,0,9999,1
1715658822155,MCWP 40R,A00,518780,Staff,1,0,20,19
1715658822155,MCWP 40R,B00,518781,Carter; Jennifer A,9,0,20,11
1715658822155,MCWP 40R,C00,518783,Smith; Haydee Marie,5,0,20,15
1715658823184,MCWP 50R,A00,518791,Redela; Pamela Morgan,0,1,20,20
1715658823184,MCWP 50R,B00,518792,Krone; Jarret,0,2,20,20
1715658823184,MCWP 50R,C00,518793,Staff,0,4,20,20
1715658823184,MCWP 50R,D00,518794,Morshed; Michael James,0,2,20,20
1715658823184,MCWP 50R,E00,518795,Carter; Andrea L,0,2,20,20
1715658823184,MCWP 50R,F00,518796,Miller; Elizabeth Deen,0,1,20,20
1715658823184,MCWP 50R,G00,518797,Guillen; Melinda,0,1,20,20
1715658824212,MMW 12R,A01,514034,Herbst; Matthew,0,2,16,16
1715658824212,MMW 12R,A02,514035,Herbst; Matthew,0,0,16,16
1715658825239,MMW 13R,A01,514037,Staff,0,5,16,16
1715658825239,MMW 13R,A02,514039,Staff,0,5,16,16
1715658825239,MMW 13R,A03,628519,Staff,0,4,16,16
1715658827291,SIO 295LS,A00,523233,Staff,10,0,30,20
1715658828320,SIO 295S,A00,523232,Staff,10,0,30,20
1715658829347,SIOC 290S,A01,637330,Merrifield; Mark A,21,0,30,9
1715658830374,SIOC 291S,A01,637333,Gabriel; Corey John,21,0,30,9
1715658831403,SOCI 117,A01,494376,Staff,0,5,5,5
1715658832428,WES 237B,A00,494380,Staff,10,0,20,10
1715658834509,AESE 279B,A00,494370,Wade; Jon P,0,0,33,33
1715658835535,AIP 97,001,660915,Van Den Einde; Yael Dahlia,9998,0,9999,1
1715658836565,AIP 197,001,627712,Vespa; Emanuel Ignacio,9995,0,9999,4
1715658836565,AIP 197,002,650778,Amir; On,9998,0,9999,1
1715658836565,AIP 197,003,650933,Avenancio-Leon; Carlos,9998,0,9999,1
1715658836565,AIP 197,004,658530,Heyman; Gail D.,9998,0,9999,1
1715658836565,AIP 197,005,658631,Neal; Sonya E,9998,0,9999,1
1715658836565,AIP 197,006,658671,Du; Songzi,9998,0,9999,1
1715658837594,ANAR 135S,A00,494369,Braswell; Geoffrey E.,0,0,0,0
1715658838625,BENG 196,001,628496,Engler; Adam J.,9998,0,9999,1
1715658838625,BENG 196,002,660916,Watson; John Thomas,9998,0,9999,1
1715658839651,BISP 197,001,650773,Wilhelm; James E.,9994,0,9999,5
1715658839651,BISP 197,002,658904,Coleman; Aaron B.,9998,0,9999,1
1715658840681,CAT 124RS,A01,519847,Geibel; William,0,0,20,20
1715658841710,CAT 125RS,A01,515971,Geibel; William,0,0,20,20
1715658842738,CLRE 250,A00,511389,Morris; Sheldon,9992,0,9999,7
1715658843766,CLRE 251,A00,507176,Mehta; Ravindra L.,9992,0,9999,7
1715658843766,CLRE 251,B00,511410,Mehta; Ravindra L.,9998,0,9999,1
1715658844792,CLRE 252,A00,507189,Cuomo; Raphael Eduardo,9994,0,9999,5
1715658845823,CLRE 253,A00,507199,Vaida; Florin,9994,0,9999,5
1715658845823,CLRE 253,B00,507202,Vaida; Florin,9999,0,9999,0
1715658846849,CLRE 259,A00,507211,Patel; Hemal,9996,0,9999,3
1715658847873,CLRE 260,A00,507221,Cuomo; Raphael Eduardo,9999,0,9999,0
1715658848900,CLRE 297,001,507242,Cuomo; Raphael Eduardo,9999,0,9999,0
1715658849930,COGS 197,001,638244,Voytek; Bradley Thomas,9997,0,9999,2
1715658850955,CSE 191,A00,516875,Minnes Kemp; Mor Mia,9991,0,9999,8
1715658851980,CSE 197,001,637388,Minnes Kemp; Mor Mia,9992,0,9999,7
1715658853006,CSS 201S,A01,494383,Mignozzetti; Umberto,35,0,35,0
1715658854036,CSS 202S,A01,494387,Mignozzetti; Umberto,35,0,35,0
1715658855065,DSC 197,001,628532,Eldridge; Justin Matthew,9995,0,9999,4
1715658856090,EAP 100,A00,516065,Staff,9799,0,9999,200
1715658857117,ECE 45,A01,507414,Staff,32,0,60,28
1715658859168,ECE 111,A01,507420,Staff,11,0,50,39
1715658860193,ECE 197,001,548057,Sievenpiper; Daniel F.,9991,0,9999,8
1715658861218,EDS 115,A00,507243,Choi; Bailey Miyeon,6,0,28,22
1715658862243,EDS 117,A01,494379,Staff,0,6,34,35
1715658863274,EDS 125,A00,507246,Hopkins; Megan Beth,7,0,30,23
1715658864303,EDS 128A,A01,507264,Fargason; Sharon Gayle,5,0,26,21
1715658865333,EDS 128B,A01,507293,Pappas; Elizabeth,9,0,30,21
1715658866360,EDS 139,A00,507294,Fargason; Sharon Gayle,9,0,30,21
1715658866360,EDS 139,B00,507313,Pappas; Elizabeth,9,0,30,21
1715658867388,EDS 201,A00,507315,Staff,10,0,30,20
1715658868418,EDS 203,A01,507317,Halter; Christopher P.,10,0,30,20
1715658869445,EDS 204R,A01,507319,Halter; Christopher P.,0,3,30,30
1715658869445,EDS 204R,B01,507331,Heinzman; Erica M.,14,0,30,16
1715658870469,EDS 206R,A00,507332,Staff,0,4,30,30
1715658870469,EDS 206R,B00,507343,Staff,15,0,30,15
1715658871498,EDS 250,A00,507344,Hemans; Patricia Ann Benitez,20,0,40,20
1715658872523,EDS 281,A00,507345,Daly; Alan J.,18,0,18,0
1715658873548,EDS 284,A00,507350,Daly; Alan J.,16,0,16,0
1715658874573,EDS 286,A00,507359,Fine; Sarah,18,0,18,0
1715658875599,EDS 289C,A01,507361,Daly; Alan J.,18,0,18,0
1715658876628,EDS 290,A00,507366,Hofstetter; Carolyn,15,0,15,0
1715658877655,LIGM 5A,A00,507421,Fischer-Grunski; Eva K,17,0,20,3
1715658878680,LIGM 5B,A00,507423,Fischer-Grunski; Eva K,19,0,20,1
1715658879706,LIGM 5C,A00,507425,Fischer-Grunski; Eva K,19,0,20,1
1715658880735,LIIT 5AS,A00,507427,Carnelos; Chiara,20,0,20,0
1715658881760,LIIT 5BS,A00,507430,Carnelos; Chiara,20,0,20,0
1715658882840,LIIT 5CS,A00,507432,Carnelos; Chiara,20,0,20,0
1715658883882,LISP 5A,A00,507541,Munoz Sanchez; Alicia,11,0,20,9
1715658884908,LISP 5B,A00,507671,Munoz Sanchez; Alicia,8,0,20,12
1715658885934,LISP 5C,A00,507696,Munoz Sanchez; Alicia,7,0,20,13
1715658886963,MAE 197,001,528363,Boechler; Nicholas Sebastia,9998,0,9999,1
1715658887991,MATH 197,001,523477,Kedlaya; Kiran S.,9994,0,9999,5
1715658887991,MATH 197,002,563811,Zhang; Danna,9994,0,9999,5
1715658887991,MATH 197,003,628552,Dumitriu; Ioana,9998,0,9999,1
1715658887991,MATH 197,004,660885,Floyd; Eric,9998,0,9999,1
1715658889017,MCWP 40R,A00,518780,Staff,1,0,20,19
1715658889017,MCWP 40R,B00,518781,Carter; Jennifer A,9,0,20,11
1715658889017,MCWP 40R,C00,518783,Smith; Haydee Marie,5,0,20,15
1715658890050,MCWP 50R,A00,518791,Redela; Pamela Morgan,0,1,20,20
1715658890050,MCWP 50R,B00,518792,Krone; Jarret,0,2,20,20
1715658890050,MCWP 50R,C00,518793,Staff,0,4,20,20
1715658890050,MCWP 50R,D00,518794,Morshed; Michael James,0,2,20,20
1715658890050,MCWP 50R,E00,518795,Carter; Andrea L,0,2,20,20
1715658890050,MCWP 50R,F00,518796,Miller; Elizabeth Deen,0,1,20,20
1715658890050,MCWP 50R,G00,518797,Guillen; Melinda,0,1,20,20
1715658891074,MMW 12R,A01,514034,Herbst; Matthew,0,2,16,16
1715658891074,MMW 12R,A02,514035,Herbst; Matthew,0,0,16,16
1715658892100,MMW 13R,A01,514037,Staff,0,5,16,16
1715658892100,MMW 13R,A02,514039,Staff,0,5,16,16
1715658892100,MMW 13R,A03,628519,Staff,0,4,16,16
1715658894158,SIO 295LS,A00,523233,Staff,10,0,30,20
1715658895187,SIO 295S,A00,523232,Staff,10,0,30,20
1715658896214,SIOC 290S,A01,637330,Merrifield; Mark A,21,0,30,9
1715658897246,SIOC 291S,A01,637333,Gabriel; Corey John,21,0,30,9
1715658898272,SOCI 117,A01,494376,Staff,0,5,5,5
1715658899299,WES 237B,A00,494380,Staff,10,0,20,10
1715658901369,AESE 279B,A00,494370,Wade; Jon P,0,0,33,33
1715658902397,AIP 97,001,660915,Van Den Einde; Yael Dahlia,9998,0,9999,1
1715658903426,AIP 197,001,627712,Vespa; Emanuel Ignacio,9995,0,9999,4
1715658903426,AIP 197,002,650778,Amir; On,9998,0,9999,1
1715658903426,AIP 197,003,650933,Avenancio-Leon; Carlos,9998,0,9999,1
1715658903426,AIP 197,004,658530,Heyman; Gail D.,9998,0,9999,1
1715658903426,AIP 197,005,658631,Neal; Sonya E,9998,0,9999,1
1715658903426,AIP 197,006,658671,Du; Songzi,9998,0,9999,1
1715658904457,ANAR 135S,A00,494369,Braswell; Geoffrey E.,0,0,0,0
1715658905491,BENG 196,001,628496,Engler; Adam J.,9998,0,9999,1
1715658905491,BENG 196,002,660916,Watson; John Thomas,9998,0,9999,1
1715658906517,BISP 197,001,650773,Wilhelm; James E.,9994,0,9999,5
1715658906517,BISP 197,002,658904,Coleman; Aaron B.,9998,0,9999,1
1715658907545,CAT 124RS,A01,519847,Geibel; William,0,0,20,20
1715658908571,CAT 125RS,A01,515971,Geibel; William,0,0,20,20
1715658909598,CLRE 250,A00,511389,Morris; Sheldon,9992,0,9999,7
1715658910625,CLRE 251,A00,507176,Mehta; Ravindra L.,9992,0,9999,7
1715658910625,CLRE 251,B00,511410,Mehta; Ravindra L.,9998,0,9999,1
1715658911652,CLRE 252,A00,507189,Cuomo; Raphael Eduardo,9994,0,9999,5
1715658912679,CLRE 253,A00,507199,Vaida; Florin,9994,0,9999,5
1715658912679,CLRE 253,B00,507202,Vaida; Florin,9999,0,9999,0
1715658913704,CLRE 259,A00,507211,Patel; Hemal,9996,0,9999,3
1715658914728,CLRE 260,A00,507221,Cuomo; Raphael Eduardo,9999,0,9999,0
1715658915754,CLRE 297,001,507242,Cuomo; Raphael Eduardo,9999,0,9999,0
1715658916782,COGS 197,001,638244,Voytek; Bradley Thomas,9997,0,9999,2
1715658917807,CSE 191,A00,516875,Minnes Kemp; Mor Mia,9991,0,9999,8
1715658918833,CSE 197,001,637388,Minnes Kemp; Mor Mia,9992,0,9999,7
1715658919858,CSS 201S,A01,494383,Mignozzetti; Umberto,35,0,35,0
1715658920884,CSS 202S,A01,494387,Mignozzetti; Umberto,35,0,35,0
1715658921920,DSC 197,001,628532,Eldridge; Justin Matthew,9995,0,9999,4
1715658922945,EAP 100,A00,516065,Staff,9799,0,9999,200
1715658923975,ECE 45,A01,507414,Staff,32,0,60,28
1715658926026,ECE 111,A01,507420,Staff,11,0,50,39
1715658927052,ECE 197,001,548057,Sievenpiper; Daniel F.,9991,0,9999,8
1715658928080,EDS 115,A00,507243,Choi; Bailey Miyeon,6,0,28,22
1715658929109,EDS 117,A01,494379,Staff,0,6,34,35
1715658930132,EDS 125,A00,507246,Hopkins; Megan Beth,7,0,30,23
1715658931158,EDS 128A,A01,507264,Fargason; Sharon Gayle,5,0,26,21
1715658932187,EDS 128B,A01,507293,Pappas; Elizabeth,9,0,30,21
1715658933214,EDS 139,A00,507294,Fargason; Sharon Gayle,9,0,30,21
1715658933214,EDS 139,B00,507313,Pappas; Elizabeth,9,0,30,21
1715658934241,EDS 201,A00,507315,Staff,10,0,30,20
1715658935267,EDS 203,A01,507317,Halter; Christopher P.,10,0,30,20
1715658936293,EDS 204R,A01,507319,Halter; Christopher P.,0,3,30,30
1715658936293,EDS 204R,B01,507331,Heinzman; Erica M.,14,0,30,16
1715658937318,EDS 206R,A00,507332,Staff,0,4,30,30
1715658937318,EDS 206R,B00,507343,Staff,15,0,30,15
1715658938345,EDS 250,A00,507344,Hemans; Patricia Ann Benitez,20,0,40,20
1715658939372,EDS 281,A00,507345,Daly; Alan J.,18,0,18,0
1715658940398,EDS 284,A00,507350,Daly; Alan J.,16,0,16,0
1715658941423,EDS 286,A00,507359,Fine; Sarah,18,0,18,0
1715658942448,EDS 289C,A01,507361,Daly; Alan J.,18,0,18,0
1715658943478,EDS 290,A00,507366,Hofstetter; Carolyn,15,0,15,0
1715658944504,LIGM 5A,A00,507421,Fischer-Grunski; Eva K,17,0,20,3
1715658945530,LIGM 5B,A00,507423,Fischer-Grunski; Eva K,19,0,20,1
1715658946560,LIGM 5C,A00,507425,Fischer-Grunski; Eva K,19,0,20,1
1715658947586,LIIT 5AS,A00,507427,Carnelos; Chiara,20,0,20,0
1715658948612,LIIT 5BS,A00,507430,Carnelos; Chiara,20,0,20,0
1715658949641,LIIT 5CS,A00,507432,Carnelos; Chiara,20,0,20,0
1715658950668,LISP 5A,A00,507541,Munoz Sanchez; Alicia,11,0,20,9
1715658951695,LISP 5B,A00,507671,Munoz Sanchez; Alicia,8,0,20,12
1715658952720,LISP 5C,A00,507696,Munoz Sanchez; Alicia,7,0,20,13
1715658953746,MAE 197,001,528363,Boechler; Nicholas Sebastia,9998,0,9999,1
1715658954780,MATH 197,001,523477,Kedlaya; Kiran S.,9994,0,9999,5
1715658954780,MATH 197,002,563811,Zhang; Danna,9994,0,9999,5
1715658954780,MATH 197,003,628552,Dumitriu; Ioana,9998,0,9999,1
1715658954780,MATH 197,004,660885,Floyd; Eric,9998,0,9999,1
1715658955810,MCWP 40R,A00,518780,Staff,1,0,20,19
1715658955810,MCWP 40R,B00,518781,Carter; Jennifer A,9,0,20,11
1715658955810,MCWP 40R,C00,518783,Smith; Haydee Marie,5,0,20,15
1715658956841,MCWP 50R,A00,518791,Redela; Pamela Morgan,0,1,20,20
1715658956841,MCWP 50R,B00,518792,Krone; Jarret,0,2,20,20
1715658956841,MCWP 50R,C00,518793,Staff,0,4,20,20
1715658956841,MCWP 50R,D00,518794,Morshed; Michael James,0,2,20,20
1715658956841,MCWP 50R,E00,518795,Carter; Andrea L,0,2,20,20
1715658956841,MCWP 50R,F00,518796,Miller; Elizabeth Deen,0,1,20,20
1715658956841,MCWP 50R,G00,518797,Guillen; Melinda,0,1,20,20
1715658957871,MMW 12R,A01,514034,Herbst; Matthew,0,2,16,16
1715658957871,MMW 12R,A02,514035,Herbst; Matthew,0,0,16,16
1715658958897,MMW 13R,A01,514037,Staff,0,5,16,16
1715658958897,MMW 13R,A02,514039,Staff,0,5,16,16
1715658958897,MMW 13R,A03,628519,Staff,0,4,16,16
1715658961155,SIO 295LS,A00,523233,Staff,10,0,30,20
1715658962183,SIO 295S,A00,523232,Staff,10,0,30,20
1715658963215,SIOC 290S,A01,637330,Merrifield; Mark A,21,0,30,9
1715658964245,SIOC 291S,A01,637333,Gabriel; Corey John,21,0,30,9
1715658965272,SOCI 117,A01,494376,Staff,0,5,5,5
1715658966300,WES 237B,A00,494380,Staff,10,0,20,10
1715658968376,AESE 279B,A00,494370,Wade; Jon P,0,0,33,33
1715658969402,AIP 97,001,660915,Van Den Einde; Yael Dahlia,9998,0,9999,1
1715658970433,AIP 197,001,627712,Vespa; Emanuel Ignacio,9995,0,9999,4
1715658970433,AIP 197,002,650778,Amir; On,9998,0,9999,1
1715658970433,AIP 197,003,650933,Avenancio-Leon; Carlos,9998,0,9999,1
1715658970433,AIP 197,004,658530,Heyman; Gail D.,9998,0,9999,1
1715658970433,AIP 197,005,658631,Neal; Sonya E,9998,0,9999,1
1715658970433,AIP 197,006,658671,Du; Songzi,9998,0,9999,1
1715658971460,ANAR 135S,A00,494369,Braswell; Geoffrey E.,0,0,0,0
1715658972487,BENG 196,001,628496,Engler; Adam J.,9998,0,9999,1
1715658972487,BENG 196,002,660916,Watson; John Thomas,9998,0,9999,1
1715658973517,BISP 197,001,650773,Wilhelm; James E.,9994,0,9999,5
1715658973517,BISP 197,002,658904,Coleman; Aaron B.,9998,0,9999,1
1715658974542,CAT 124RS,A01,519847,Geibel; William,0,0,20,20
1715658975567,CAT 125RS,A01,515971,Geibel; William,0,0,20,20
1715658976593,CLRE 250,A00,511389,Morris; Sheldon,9992,0,9999,7
1715658977624,CLRE 251,A00,507176,Mehta; Ravindra L.,9992,0,9999,7
1715658977624,CLRE 251,B00,511410,Mehta; Ravindra L.,9998,0,9999,1
1715658978651,CLRE 252,A00,507189,Cuomo; Raphael Eduardo,9994,0,9999,5
1715658979677,CLRE 253,A00,507199,Vaida; Florin,9994,0,9999,5
1715658979677,CLRE 253,B00,507202,Vaida; Florin,9999,0,9999,0
1715658980707,CLRE 259,A00,507211,Patel; Hemal,9996,0,9999,3
1715658981732,CLRE 260,A00,507221,Cuomo; Raphael Eduardo,9999,0,9999,0
1715658982758,CLRE 297,001,507242,Cuomo; Raphael Eduardo,9999,0,9999,0
1715658983784,COGS 197,001,638244,Voytek; Bradley Thomas,9997,0,9999,2
1715658984816,CSE 191,A00,516875,Minnes Kemp; Mor Mia,9991,0,9999,8
1715658985843,CSE 197,001,637388,Minnes Kemp; Mor Mia,9992,0,9999,7
1715658986929,CSS 201S,A01,494383,Mignozzetti; Umberto,35,0,35,0
1715658987956,CSS 202S,A01,494387,Mignozzetti; Umberto,35,0,35,0
1715658988981,DSC 197,001,628532,Eldridge; Justin Matthew,9995,0,9999,4
1715658990005,EAP 100,A00,516065,Staff,9799,0,9999,200
1715658991034,ECE 45,A01,507414,Staff,32,0,60,28
1715658993087,ECE 111,A01,507420,Staff,11,0,50,39
1715658994113,ECE 197,001,548057,Sievenpiper; Daniel F.,9991,0,9999,8
1715658995142,EDS 115,A00,507243,Choi; Bailey Miyeon,6,0,28,22
1715658996167,EDS 117,A01,494379,Staff,0,6,34,35
1715658997192,EDS 125,A00,507246,Hopkins; Megan Beth,7,0,30,23
1715658998218,EDS 128A,A01,507264,Fargason; Sharon Gayle,5,0,26,21
1715658999244,EDS 128B,A01,507293,Pappas; Elizabeth,9,0,30,21
1715659000270,EDS 139,A00,507294,Fargason; Sharon Gayle,9,0,30,21
1715659000270,EDS 139,B00,507313,Pappas; Elizabeth,9,0,30,21
1715659001296,EDS 201,A00,507315,Staff,10,0,30,20
1715659002322,EDS 203,A01,507317,Halter; Christopher P.,10,0,30,20
1715659003347,EDS 204R,A01,507319,Halter; Christopher P.,0,3,30,30
1715659003347,EDS 204R,B01,507331,Heinzman; Erica M.,14,0,30,16
1715659004373,EDS 206R,A00,507332,Staff,0,4,30,30
1715659004373,EDS 206R,B00,507343,Staff,15,0,30,15
1715659005405,EDS 250,A00,507344,Hemans; Patricia Ann Benitez,20,0,40,20
1715659006431,EDS 281,A00,507345,Daly; Alan J.,18,0,18,0
1715659007456,EDS 284,A00,507350,Daly; Alan J.,16,0,16,0
1715659008483,EDS 286,A00,507359,Fine; Sarah,18,0,18,0
1715659009508,EDS 289C,A01,507361,Daly; Alan J.,18,0,18,0
1715659010535,EDS 290,A00,507366,Hofstetter; Carolyn,15,0,15,0
1715659011565,LIGM 5A,A00,507421,Fischer-Grunski; Eva K,17,0,20,3
1715659012594,LIGM 5B,A00,507423,Fischer-Grunski; Eva K,19,0,20,1
1715659013619,LIGM 5C,A00,507425,Fischer-Grunski; Eva K,19,0,20,1
1715659014650,LIIT 5AS,A00,507427,Carnelos; Chiara,20,0,20,0
1715659015679,LIIT 5BS,A00,507430,Carnelos; Chiara,20,0,20,0
1715659016707,LIIT 5CS,A00,507432,Carnelos; Chiara,20,0,20,0
1715659017739,LISP 5A,A00,507541,Munoz Sanchez; Alicia,11,0,20,9
1715659018770,LISP 5B,A00,507671,Munoz Sanchez; Alicia,8,0,20,12
1715659019798,LISP 5C,A00,507696,Munoz Sanchez; Alicia,7,0,20,13
1715659020823,MAE 197,001,528363,Boechler; Nicholas Sebastia,9998,0,9999,1
1715659021852,MATH 197,001,523477,Kedlaya; Kiran S.,9994,0,9999,5
1715659021852,MATH 197,002,563811,Zhang; Danna,9994,0,9999,5
1715659021852,MATH 197,003,628552,Dumitriu; Ioana,9998,0,9999,1
1715659021852,MATH 197,004,660885,Floyd; Eric,9998,0,9999,1
1715659022880,MCWP 40R,A00,518780,Staff,1,0,20,19
1715659022880,MCWP 40R,B00,518781,Carter; Jennifer A,9,0,20,11
1715659022880,MCWP 40R,C00,518783,Smith; Haydee Marie,5,0,20,15
1715659023915,MCWP 50R,A00,518791,Redela; Pamela Morgan,0,1,20,20
1715659023915,MCWP 50R,B00,518792,Krone; Jarret,0,2,20,20
1715659023915,MCWP 50R,C00,518793,Staff,0,4,20,20
1715659023915,MCWP 50R,D00,518794,Morshed; Michael James,0,2,20,20
1715659023915,MCWP 50R,E00,518795,Carter; Andrea L,0,2,20,20
1715659023915,MCWP 50R,F00,518796,Miller; Elizabeth Deen,0,1,20,20
1715659023915,MCWP 50R,G00,518797,Guillen; Melinda,0,1,20,20
1715659024939,MMW 12R,A01,514034,Herbst; Matthew,0,2,16,16
1715659024939,MMW 12R,A02,514035,Herbst; Matthew,0,0,16,16
1715659025963,MMW 13R,A01,514037,Staff,0,5,16,16
1715659025963,MMW 13R,A02,514039,Staff,0,5,16,16
1715659025963,MMW 13R,A03,628519,Staff,0,4,16,16
1715659028016,SIO 295LS,A00,523233,Staff,10,0,30,20
1715659029042,SIO 295S,A00,523232,Staff,10,0,30,20
1715659030073,SIOC 290S,A01,637330,Merrifield; Mark A,21,0,30,9
1715659031101,SIOC 291S,A01,637333,Gabriel; Corey John,21,0,30,9
1715659032128,SOCI 117,A01,494376,Staff,0,5,5,5
1715659033153,WES 237B,A00,494380,Staff,10,0,20,10
1715659035229,AESE 279B,A00,494370,Wade; Jon P,0,0,33,33
1715659036257,AIP 97,001,660915,Van Den Einde; Yael Dahlia,9998,0,9999,1
1715659037286,AIP 197,001,627712,Vespa; Emanuel Ignacio,9995,0,9999,4
1715659037286,AIP 197,002,650778,Amir; On,9998,0,9999,1
1715659037286,AIP 197,003,650933,Avenancio-Leon; Carlos,9998,0,9999,1
1715659037286,AIP 197,004,658530,Heyman; Gail D.,9998,0,9999,1
1715659037286,AIP 197,005,658631,Neal; Sonya E,9998,0,9999,1
1715659037286,AIP 197,006,658671,Du; Songzi,9998,0,9999,1
1715659038313,ANAR 135S,A00,494369,Braswell; Geoffrey E.,0,0,0,0
1715659039339,BENG 196,001,628496,Engler; Adam J.,9998,0,9999,1
1715659039339,BENG 196,002,660916,Watson; John Thomas,9998,0,9999,1
1715659040368,BISP 197,001,650773,Wilhelm; James E.,9994,0,9999,5
1715659040368,BISP 197,002,658904,Coleman; Aaron B.,9998,0,9999,1
1715659041395,CAT 124RS,A01,519847,Geibel; William,0,0,20,20
1715659042422,CAT 125RS,A01,515971,Geibel; William,0,0,20,20
1715659043450,CLRE 250,A00,511389,Morris; Sheldon,9992,0,9999,7
1715659044484,CLRE 251,A00,507176,Mehta; Ravindra L.,9992,0,9999,7
1715659044484,CLRE 251,B00,511410,Mehta; Ravindra L.,9998,0,9999,1
1715659045508,CLRE 252,A00,507189,Cuomo; Raphael Eduardo,9994,0,9999,5
1715659046532,CLRE 253,A00,507199,Vaida; Florin,9994,0,9999,5
1715659046532,CLRE 253,B00,507202,Vaida; Florin,9999,0,9999,0
1715659047558,CLRE 259,A00,507211,Patel; Hemal,9996,0,9999,3
1715659048583,CLRE 260,A00,507221,Cuomo; Raphael Eduardo,9999,0,9999,0
1715659049607,CLRE 297,001,507242,Cuomo; Raphael Eduardo,9999,0,9999,0
1715659050634,COGS 197,001,638244,Voytek; Bradley Thomas,9997,0,9999,2
1715659051662,CSE 191,A00,516875,Minnes Kemp; Mor Mia,9991,0,9999,8
1715659052687,CSE 197,001,637388,Minnes Kemp; Mor Mia,9992,0,9999,7
1715659053719,CSS 201S,A01,494383,Mignozzetti; Umberto,35,0,35,0
1715659054747,CSS 202S,A01,494387,Mignozzetti; Umberto,35,0,35,0
1715659055773,DSC 197,001,628532,Eldridge; Justin Matthew,9995,0,9999,4
1715659056800,EAP 100,A00,516065,Staff,9799,0,9999,200
1715659057826,ECE 45,A01,507414,Staff,32,0,60,28
1715659059877,ECE 111,A01,507420,Staff,11,0,50,39
1715659060903,ECE 197,001,548057,Sievenpiper; Daniel F.,9991,0,9999,8
1715659061932,EDS 115,A00,507243,Choi; Bailey Miyeon,6,0,28,22
1715659062957,EDS 117,A01,494379,Staff,0,6,34,35
1715659064092,EDS 125,A00,507246,Hopkins; Megan Beth,7,0,30,23
1715659065118,EDS 128A,A01,507264,Fargason; Sharon Gayle,5,0,26,21
1715659066145,EDS 128B,A01,507293,Pappas; Elizabeth,9,0,30,21
1715659067173,EDS 139,A00,507294,Fargason; Sharon Gayle,9,0,30,21
1715659067173,EDS 139,B00,507313,Pappas; Elizabeth,9,0,30,21
1715659068198,EDS 201,A00,507315,Staff,10,0,30,20
1715659069222,EDS 203,A01,507317,Halter; Christopher P.,10,0,30,20
1715659070253,EDS 204R,A01,507319,Halter; Christopher P.,0,3,30,30
1715659070253,EDS 204R,B01,507331,Heinzman; Erica M.,14,0,30,16
1715659071283,EDS 206R,A00,507332,Staff,0,4,30,30
1715659071283,EDS 206R,B00,507343,Staff,15,0,30,15
1715659072310,EDS 250,A00,507344,Hemans; Patricia Ann Benitez,20,0,40,20
1715659073338,EDS 281,A00,507345,Daly; Alan J.,18,0,18,0
1715659074367,EDS 284,A00,507350,Daly; Alan J.,16,0,16,0
1715659075392,EDS 286,A00,507359,Fine; Sarah,18,0,18,0
1715659076422,EDS 289C,A01,507361,Daly; Alan J.,18,0,18,0
1715659077449,EDS 290,A00,507366,Hofstetter; Carolyn,15,0,15,0
1715659078479,LIGM 5A,A00,507421,Fischer-Grunski; Eva K,17,0,20,3
1715659079504,LIGM 5B,A00,507423,Fischer-Grunski; Eva K,19,0,20,1
1715659080534,LIGM 5C,A00,507425,Fischer-Grunski; Eva K,19,0,20,1
1715659081560,LIIT 5AS,A00,507427,Carnelos; Chiara,20,0,20,0
1715659082589,LIIT 5BS,A00,507430,Carnelos; Chiara,20,0,20,0
1715659083617,LIIT 5CS,A00,507432,Carnelos; Chiara,20,0,20,0
1715659084647,LISP 5A,A00,507541,Munoz Sanchez; Alicia,11,0,20,9
1715659085673,LISP 5B,A00,507671,Munoz Sanchez; Alicia,8,0,20,12
1715659086703,LISP 5C,A00,507696,Munoz Sanchez; Alicia,7,0,20,13
1715659087730,MAE 197,001,528363,Boechler; Nicholas Sebastia,9998,0,9999,1
1715659088761,MATH 197,001,523477,Kedlaya; Kiran S.,9994,0,9999,5
1715659088761,MATH 197,002,563811,Zhang; Danna,9994,0,9999,5
1715659088761,MATH 197,003,628552,Dumitriu; Ioana,9998,0,9999,1
1715659088761,MATH 197,004,660885,Floyd; Eric,9998,0,9999,1
1715659089792,MCWP 40R,A00,518780,Staff,1,0,20,19
1715659089792,MCWP 40R,B00,518781,Carter; Jennifer A,9,0,20,11
1715659089792,MCWP 40R,C00,518783,Smith; Haydee Marie,5,0,20,15
1715659090819,MCWP 50R,A00,518791,Redela; Pamela Morgan,0,1,20,20
1715659090819,MCWP 50R,B00,518792,Krone; Jarret,0,2,20,20
1715659090819,MCWP 50R,C00,518793,Staff,0,4,20,20
1715659090819,MCWP 50R,D00,518794,Morshed; Michael James,0,2,20,20
1715659090819,MCWP 50R,E00,518795,Carter; Andrea L,0,2,20,20
1715659090819,MCWP 50R,F00,518796,Miller; Elizabeth Deen,0,1,20,20
1715659090819,MCWP 50R,G00,518797,Guillen; Melinda,0,1,20,20
1715659091845,MMW 12R,A01,514034,Herbst; Matthew,0,2,16,16
1715659091845,MMW 12R,A02,514035,Herbst; Matthew,0,0,16,16
1715659092872,MMW 13R,A01,514037,Staff,0,5,16,16
1715659092872,MMW 13R,A02,514039,Staff,0,5,16,16
1715659092872,MMW 13R,A03,628519,Staff,0,4,16,16
1715659094921,SIO 295LS,A00,523233,Staff,10,0,30,20
1715659095948,SIO 295S,A00,523232,Staff,10,0,30,20
1715659096974,SIOC 290S,A01,637330,Merrifield; Mark A,21,0,30,9
1715659097999,SIOC 291S,A01,637333,Gabriel; Corey John,21,0,30,9
1715659099028,SOCI 117,A01,494376,Staff,0,5,5,5
1715659100055,WES 237B,A00,494380,Staff,10,0,20,10
1715659102127,AESE 279B,A00,494370,Wade; Jon P,0,0,33,33
1715659103156,AIP 97,001,660915,Van Den Einde; Yael Dahlia,9998,0,9999,1
1715659104187,AIP 197,001,627712,Vespa; Emanuel Ignacio,9995,0,9999,4
1715659104187,AIP 197,002,650778,Amir; On,9998,0,9999,1
1715659104187,AIP 197,003,650933,Avenancio-Leon; Carlos,9998,0,9999,1
1715659104187,AIP 197,004,658530,Heyman; Gail D.,9998,0,9999,1
1715659104187,AIP 197,005,658631,Neal; Sonya E,9998,0,9999,1
1715659104187,AIP 197,006,658671,Du; Songzi,9998,0,9999,1
1715659105215,ANAR 135S,A00,494369,Braswell; Geoffrey E.,0,0,0,0
1715659106241,BENG 196,001,628496,Engler; Adam J.,9998,0,9999,1
1715659106241,BENG 196,002,660916,Watson; John Thomas,9998,0,9999,1
1715659107273,BISP 197,001,650773,Wilhelm; James E.,9994,0,9999,5
1715659107273,BISP 197,002,658904,Coleman; Aaron B.,9998,0,9999,1
1715659108300,CAT 124RS,A01,519847,Geibel; William,0,0,20,20
1715659109325,CAT 125RS,A01,515971,Geibel; William,0,0,20,20
1715659110353,CLRE 250,A00,511389,Morris; Sheldon,9992,0,9999,7
1715659111381,CLRE 251,A00,507176,Mehta; Ravindra L.,9992,0,9999,7
1715659111381,CLRE 251,B00,511410,Mehta; Ravindra L.,9998,0,9999,1
1715659112406,CLRE 252,A00,507189,Cuomo; Raphael Eduardo,9994,0,9999,5
1715659113434,CLRE 253,A00,507199,Vaida; Florin,9994,0,9999,5
1715659113434,CLRE 253,B00,507202,Vaida; Florin,9999,0,9999,0
1715659114461,CLRE 259,A00,507211,Patel; Hemal,9996,0,9999,3
1715659115487,CLRE 260,A00,507221,Cuomo; Raphael Eduardo,9999,0,9999,0
1715659116512,CLRE 297,001,507242,Cuomo; Raphael Eduardo,9999,0,9999,0
1715659117539,COGS 197,001,638244,Voytek; Bradley Thomas,9997,0,9999,2
1715659118568,CSE 191,A00,516875,Minnes Kemp; Mor Mia,9991,0,9999,8
1715659119592,CSE 197,001,637388,Minnes Kemp; Mor Mia,9992,0,9999,7
1715659120621,CSS 201S,A01,494383,Mignozzetti; Umberto,35,0,35,0
1715659121648,CSS 202S,A01,494387,Mignozzetti; Umberto,35,0,35,0
1715659122676,DSC 197,001,628532,Eldridge; Justin Matthew,9995,0,9999,4
1715659123700,EAP 100,A00,516065,Staff,9799,0,9999,200
1715659124729,ECE 45,A01,507414,Staff,32,0,60,28
1715659126779,ECE 111,A01,507420,Staff,11,0,50,39
1715659127804,ECE 197,001,548057,Sievenpiper; Daniel F.,9991,0,9999,8
1715659128834,EDS 115,A00,507243,Choi; Bailey Miyeon,6,0,28,22
1715659129860,EDS 117,A01,494379,Staff,0,6,34,35
1715659130886,EDS 125,A00,507246,Hopkins; Megan Beth,7,0,30,23
1715659131916,EDS 128A,A01,507264,Fargason; Sharon Gayle,5,0,26,21
1715659132941,EDS 128B,A01,507293,Pappas; Elizabeth,9,0,30,21
1715659133965,EDS 139,A00,507294,Fargason; Sharon Gayle,9,0,30,21
1715659133965,EDS 139,B00,507313,Pappas; Elizabeth,9,0,30,21
1715659134995,EDS 201,A00,507315,Staff,10,0,30,20
1715659136087,EDS 203,A01,507317,Halter; Christopher P.,10,0,30,20
1715659137117,EDS 204R,A01,507319,Halter; Christopher P.,0,3,30,30
1715659137117,EDS 204R,B01,507331,Heinzman; Erica M.,14,0,30,16
1715659138141,EDS 206R,A00,507332,Staff,0,4,30,30
1715659138141,EDS 206R,B00,507343,Staff,15,0,30,15
1715659139167,EDS 250,A00,507344,Hemans; Patricia Ann Benitez,20,0,40,20
1715659140193,EDS 281,A00,507345,Daly; Alan J.,18,0,18,0
1715659141218,EDS 284,A00,507350,Daly; Alan J.,16,0,16,0
1715659142248,EDS 286,A00,507359,Fine; Sarah,18,0,18,0
1715659143274,EDS 289C,A01,507361,Daly; Alan J.,18,0,18,0
1715659144300,EDS 290,A00,507366,Hofstetter; Carolyn,15,0,15,0
1715659145330,LIGM 5A,A00,507421,Fischer-Grunski; Eva K,17,0,20,3
1715659146358,LIGM 5B,A00,507423,Fischer-Grunski; Eva K,19,0,20,1
1715659147384,LIGM 5C,A00,507425,Fischer-Grunski; Eva K,19,0,20,1
1715659148412,LIIT 5AS,A00,507427,Carnelos; Chiara,20,0,20,0
1715659149441,LIIT 5BS,A00,507430,Carnelos; Chiara,20,0,20,0
1715659150467,LIIT 5CS,A00,507432,Carnelos; Chiara,20,0,20,0
1715659151498,LISP 5A,A00,507541,Munoz Sanchez; Alicia,11,0,20,9
1715659152528,LISP 5B,A00,507671,Munoz Sanchez; Alicia,8,0,20,12
1715659153554,LISP 5C,A00,507696,Munoz Sanchez; Alicia,7,0,20,13
1715659154579,MAE 197,001,528363,Boechler; Nicholas Sebastia,9998,0,9999,1
1715659155609,MATH 197,001,523477,Kedlaya; Kiran S.,9994,0,9999,5
1715659155609,MATH 197,002,563811,Zhang; Danna,9994,0,9999,5
1715659155609,MATH 197,003,628552,Dumitriu; Ioana,9998,0,9999,1
1715659155609,MATH 197,004,660885,Floyd; Eric,9998,0,9999,1
1715659156641,MCWP 40R,A00,518780,Staff,1,0,20,19
1715659156641,MCWP 40R,B00,518781,Carter; Jennifer A,9,0,20,11
1715659156641,MCWP 40R,C00,518783,Smith; Haydee Marie,5,0,20,15
1715659157672,MCWP 50R,A00,518791,Redela; Pamela Morgan,0,1,20,20
1715659157672,MCWP 50R,B00,518792,Krone; Jarret,0,2,20,20
1715659157672,MCWP 50R,C00,518793,Staff,0,4,20,20
1715659157672,MCWP 50R,D00,518794,Morshed; Michael James,0,2,20,20
1715659157672,MCWP 50R,E00,518795,Carter; Andrea L,0,2,20,20
1715659157672,MCWP 50R,F00,518796,Miller; Elizabeth Deen,0,1,20,20
1715659157672,MCWP 50R,G00,518797,Guillen; Melinda,0,1,20,20
1715659158697,MMW 12R,A01,514034,Herbst; Matthew,0,2,16,16
1715659158697,MMW 12R,A02,514035,Herbst; Matthew,0,0,16,16
1715659159723,MMW 13R,A01,514037,Staff,0,5,16,16
1715659159723,MMW 13R,A02,514039,Staff,0,5,16,16
1715659159723,MMW 13R,A03,628519,Staff,0,4,16,16
1715659161772,SIO 295LS,A00,523233,Staff,10,0,30,20
1715659162797,SIO 295S,A00,523232,Staff,10,0,30,20
1715659163824,SIOC 290S,A01,637330,Merrifield; Mark A,21,0,30,9
1715659164869,SIOC 291S,A01,637333,Gabriel; Corey John,21,0,30,9
1715659165919,SOCI 117,A01,494376,Staff,0,5,5,5
1715659166944,WES 237B,A00,494380,Staff,10,0,20,10
1715659169017,AESE 279B,A00,494370,Wade; Jon P,0,0,33,33
1715659170042,AIP 97,001,660915,Van Den Einde; Yael Dahlia,9998,0,9999,1
1715659171072,AIP 197,001,627712,Vespa; Emanuel Ignacio,9995,0,9999,4
1715659171072,AIP 197,002,650778,Amir; On,9998,0,9999,1
1715659171072,AIP 197,003,650933,Avenancio-Leon; Carlos,9998,0,9999,1
1715659171072,AIP 197,004,658530,Heyman; Gail D.,9998,0,9999,1
1715659171072,AIP 197,005,658631,Neal; Sonya E,9998,0,9999,1
1715659171072,AIP 197,006,658671,Du; Songzi,9998,0,9999,1
1715659172098,ANAR 135S,A00,494369,Braswell; Geoffrey E.,0,0,0,0
1715659173125,BENG 196,001,628496,Engler; Adam J.,9998,0,9999,1
1715659173125,BENG 196,002,660916,Watson; John Thomas,9998,0,9999,1
1715659174156,BISP 197,001,650773,Wilhelm; James E.,9994,0,9999,5
1715659174156,BISP 197,002,658904,Coleman; Aaron B.,9998,0,9999,1
1715659175182,CAT 124RS,A01,519847,Geibel; William,0,0,20,20
1715659176206,CAT 125RS,A01,515971,Geibel; William,0,0,20,20
1715659177233,CLRE 250,A00,511389,Morris; Sheldon,9992,0,9999,7
1715659178262,CLRE 251,A00,507176,Mehta; Ravindra L.,9992,0,9999,7
1715659178262,CLRE 251,B00,511410,Mehta; Ravindra L.,9998,0,9999,1
1715659179292,CLRE 252,A00,507189,Cuomo; Raphael Eduardo,9994,0,9999,5
1715659180318,CLRE 253,A00,507199,Vaida; Florin,9994,0,9999,5
1715659180318,CLRE 253,B00,507202,Vaida; Florin,9999,0,9999,0
1715659181347,CLRE 259,A00,507211,Patel; Hemal,9996,0,9999,3
1715659182375,CLRE 260,A00,507221,Cuomo; Raphael Eduardo,9999,0,9999,0
1715659183403,CLRE 297,001,507242,Cuomo; Raphael Eduardo,9999,0,9999,0
1715659184428,COGS 197,001,638244,Voytek; Bradley Thomas,9997,0,9999,2
1715659185457,CSE 191,A00,516875,Minnes Kemp; Mor Mia,9991,0,9999,8
1715659186482,CSE 197,001,637388,Minnes Kemp; Mor Mia,9992,0,9999,7
1715659187512,CSS 201S,A01,494383,Mignozzetti; Umberto,35,0,35,0
1715659188539,CSS 202S,A01,494387,Mignozzetti; Umberto,35,0,35,0
1715659189565,DSC 197,001,628532,Eldridge; Justin Matthew,9995,0,9999,4
1715659190592,EAP 100,A00,516065,Staff,9799,0,9999,200
1715659191622,ECE 45,A01,507414,Staff,32,0,60,28
1715659193675,ECE 111,A01,507420,Staff,11,0,50,39
1715659194706,ECE 197,001,548057,Sievenpiper; Daniel F.,9991,0,9999,8
1715659195735,EDS 115,A00,507243,Choi; Bailey Miyeon,6,0,28,22
1715659196761,EDS 117,A01,494379,Staff,0,6,34,35
1715659197789,EDS 125,A00,507246,Hopkins; Megan Beth,7,0,30,23
1715659198815,EDS 128A,A01,507264,Fargason; Sharon Gayle,5,0,26,21
1715659199847,EDS 128B,A01,507293,Pappas; Elizabeth,9,0,30,21
1715659200873,EDS 139,A00,507294,Fargason; Sharon Gayle,9,0,30,21
1715659200873,EDS 139,B00,507313,Pappas; Elizabeth,9,0,30,21
1715659201899,EDS 201,A00,507315,Staff,10,0,30,20
1715659202929,EDS 203,A01,507317,Halter; Christopher P.,10,0,30,20
1715659203955,EDS 204R,A01,507319,Halter; Christopher P.,0,3,30,30
1715659203955,EDS 204R,B01,507331,Heinzman; Erica M.,14,0,30,16
1715659204985,EDS 206R,A00,507332,Staff,0,4,30,30
1715659204985,EDS 206R,B00,507343,Staff,15,0,30,15
1715659206011,EDS 250,A00,507344,Hemans; Patricia Ann Benitez,20,0,40,20
1715659207037,EDS 281,A00,507345,Daly; Alan J.,18,0,18,0
1715659208067,EDS 284,A00,507350,Daly; Alan J.,16,0,16,0
1715659209093,EDS 286,A00,507359,Fine; Sarah,18,0,18,0
1715659210121,EDS 289C,A01,507361,Daly; Alan J.,18,0,18,0
1715659211148,EDS 290,A00,507366,Hofstetter; Carolyn,15,0,15,0
1715659212179,LIGM 5A,A00,507421,Fischer-Grunski; Eva K,17,0,20,3
1715659213203,LIGM 5B,A00,507423,Fischer-Grunski; Eva K,19,0,20,1
1715659214228,LIGM 5C,A00,507425,Fischer-Grunski; Eva K,19,0,20,1
1715659215261,LIIT 5AS,A00,507427,Carnelos; Chiara,20,0,20,0
1715659216289,LIIT 5BS,A00,507430,Carnelos; Chiara,20,0,20,0
1715659217316,LIIT 5CS,A00,507432,Carnelos; Chiara,20,0,20,0
1715659218344,LISP 5A,A00,507541,Munoz Sanchez; Alicia,11,0,20,9
1715659219371,LISP 5B,A00,507671,Munoz Sanchez; Alicia,8,0,20,12
1715659220401,LISP 5C,A00,507696,Munoz Sanchez; Alicia,7,0,20,13
1715659221429,MAE 197,001,528363,Boechler; Nicholas Sebastia,9998,0,9999,1
1715659222457,MATH 197,001,523477,Kedlaya; Kiran S.,9994,0,9999,5
1715659222457,MATH 197,002,563811,Zhang; Danna,9994,0,9999,5
1715659222457,MATH 197,003,628552,Dumitriu; Ioana,9998,0,9999,1
1715659222457,MATH 197,004,660885,Floyd; Eric,9998,0,9999,1
1715659223485,MCWP 40R,A00,518780,Staff,1,0,20,19
1715659223485,MCWP 40R,B00,518781,Carter; Jennifer A,9,0,20,11
1715659223485,MCWP 40R,C00,518783,Smith; Haydee Marie,5,0,20,15
1715659224523,MCWP 50R,A00,518791,Redela; Pamela Morgan,0,1,20,20
1715659224523,MCWP 50R,B00,518792,Krone; Jarret,0,2,20,20
1715659224523,MCWP 50R,C00,518793,Staff,0,4,20,20
1715659224523,MCWP 50R,D00,518794,Morshed; Michael James,0,2,20,20
1715659224523,MCWP 50R,E00,518795,Carter; Andrea L,0,2,20,20
1715659224523,MCWP 50R,F00,518796,Miller; Elizabeth Deen,0,1,20,20
1715659224523,MCWP 50R,G00,518797,Guillen; Melinda,0,1,20,20
1715659225552,MMW 12R,A01,514034,Herbst; Matthew,0,2,16,16
1715659225552,MMW 12R,A02,514035,Herbst; Matthew,0,0,16,16
1715659226578,MMW 13R,A01,514037,Staff,0,5,16,16
1715659226578,MMW 13R,A02,514039,Staff,0,5,16,16
1715659226578,MMW 13R,A03,628519,Staff,0,4,16,16
1715659228632,SIO 295LS,A00,523233,Staff,10,0,30,20
1715659229716,SIO 295S,A00,523232,Staff,10,0,30,20
1715659230748,SIOC 290S,A01,637330,Merrifield; Mark A,21,0,30,9
1715659231780,SIOC 291S,A01,637333,Gabriel; Corey John,21,0,30,9
1715659232809,SOCI 117,A01,494376,Staff,0,5,5,5
1715659233836,WES 237B,A00,494380,Staff,10,0,20,10
1715659235922,AESE 279B,A00,494370,Wade; Jon P,0,0,33,33
1715659236951,AIP 97,001,660915,Van Den Einde; Yael Dahlia,9998,0,9999,1
1715659237979,AIP 197,001,627712,Vespa; Emanuel Ignacio,9995,0,9999,4
1715659237979,AIP 197,002,650778,Amir; On,9998,0,9999,1
1715659237979,AIP 197,003,650933,Avenancio-Leon; Carlos,9998,0,9999,1
1715659237979,AIP 197,004,658530,Heyman; Gail D.,9998,0,9999,1
1715659237979,AIP 197,005,658631,Neal; Sonya E,9998,0,9999,1
1715659237979,AIP 197,006,658671,Du; Songzi,9998,0,9999,1
1715659239005,ANAR 135S,A00,494369,Braswell; Geoffrey E.,0,0,0,0
1715659240035,BENG 196,001,628496,Engler; Adam J.,9998,0,9999,1
1715659240035,BENG 196,002,660916,Watson; John Thomas,9998,0,9999,1
1715659241065,BISP 197,001,650773,Wilhelm; James E.,9994,0,9999,5
1715659241065,BISP 197,002,658904,Coleman; Aaron B.,9998,0,9999,1
1715659242092,CAT 124RS,A01,519847,Geibel; William,0,0,20,20
1715659243119,CAT 125RS,A01,515971,Geibel; William,0,0,20,20
1715659244146,CLRE 250,A00,511389,Morris; Sheldon,9992,0,9999,7
1715659245177,CLRE 251,A00,507176,Mehta; Ravindra L.,9992,0,9999,7
1715659245177,CLRE 251,B00,511410,Mehta; Ravindra L.,9998,0,9999,1
1715659246207,CLRE 252,A00,507189,Cuomo; Raphael Eduardo,9994,0,9999,5
1715659247235,CLRE 253,A00,507199,Vaida; Florin,9994,0,9999,5
1715659247235,CLRE 253,B00,507202,Vaida; Florin,9999,0,9999,0
1715659248265,CLRE 259,A00,507211,Patel; Hemal,9996,0,9999,3
1715659249291,CLRE 260,A00,507221,Cuomo; Raphael Eduardo,9999,0,9999,0
1715659250318,CLRE 297,001,507242,Cuomo; Raphael Eduardo,9999,0,9999,0
1715659251344,COGS 197,001,638244,Voytek; Bradley Thomas,9997,0,9999,2
1715659252372,CSE 191,A00,516875,Minnes Kemp; Mor Mia,9991,0,9999,8
1715659253398,CSE 197,001,637388,Minnes Kemp; Mor Mia,9992,0,9999,7
1715659254432,CSS 201S,A01,494383,Mignozzetti; Umberto,35,0,35,0
1715659255457,CSS 202S,A01,494387,Mignozzetti; Umberto,35,0,35,0
1715659256488,DSC 197,001,628532,Eldridge; Justin Matthew,9995,0,9999,4
1715659257512,EAP 100,A00,516065,Staff,9799,0,9999,200
1715659258540,ECE 45,A01,507414,Staff,32,0,60,28
1715659260591,ECE 111,A01,507420,Staff,11,0,50,39
1715659261620,ECE 197,001,548057,Sievenpiper; Daniel F.,9991,0,9999,8
1715659262650,EDS 115,A00,507243,Choi; Bailey Miyeon,6,0,28,22
1715659263678,EDS 117,A01,494379,Staff,0,6,34,35
1715659264703,EDS 125,A00,507246,Hopkins; Megan Beth,7,0,30,23
1715659265730,EDS 128A,A01,507264,Fargason; Sharon Gayle,5,0,26,21
1715659266758,EDS 128B,A01,507293,Pappas; Elizabeth,9,0,30,21
1715659267785,EDS 139,A00,507294,Fargason; Sharon Gayle,9,0,30,21
1715659267785,EDS 139,B00,507313,Pappas; Elizabeth,9,0,30,21
1715659268811,EDS 201,A00,507315,Staff,10,0,30,20
1715659269845,EDS 203,A01,507317,Halter; Christopher P.,10,0,30,20
1715659270876,EDS 204R,A01,507319,Halter; Christopher P.,0,3,30,30
1715659270876,EDS 204R,B01,507331,Heinzman; Erica M.,14,0,30,16
1715659271903,EDS 206R,A00,507332,Staff,0,4,30,30
1715659271903,EDS 206R,B00,507343,Staff,15,0,30,15
1715659272934,EDS 250,A00,507344,Hemans; Patricia Ann Benitez,20,0,40,20
1715659273960,EDS 281,A00,507345,Daly; Alan J.,18,0,18,0
1715659274990,EDS 284,A00,507350,Daly; Alan J.,16,0,16,0
1715659276018,EDS 286,A00,507359,Fine; Sarah,18,0,18,0
1715659277046,EDS 289C,A01,507361,Daly; Alan J.,18,0,18,0
1715659278071,EDS 290,A00,507366,Hofstetter; Carolyn,15,0,15,0
1715659279099,LIGM 5A,A00,507421,Fischer-Grunski; Eva K,17,0,20,3
1715659280131,LIGM 5B,A00,507423,Fischer-Grunski; Eva K,19,0,20,1
1715659281163,LIGM 5C,A00,507425,Fischer-Grunski; Eva K,19,0,20,1
1715659282189,LIIT 5AS,A00,507427,Carnelos; Chiara,20,0,20,0
1715659283214,LIIT 5BS,A00,507430,Carnelos; Chiara,20,0,20,0
1715659284239,LIIT 5CS,A00,507432,Carnelos; Chiara,20,0,20,0
1715659285266,LISP 5A,A00,507541,Munoz Sanchez; Alicia,11,0,20,9
1715659286292,LISP 5B,A00,507671,Munoz Sanchez; Alicia,8,0,20,12
1715659287321,LISP 5C,A00,507696,Munoz Sanchez; Alicia,7,0,20,13
1715659288345,MAE 197,001,528363,Boechler; Nicholas Sebastia,9998,0,9999,1
1715659289376,MATH 197,001,523477,Kedlaya; Kiran S.,9994,0,9999,5
1715659289376,MATH 197,002,563811,Zhang; Danna,9994,0,9999,5
1715659289376,MATH 197,003,628552,Dumitriu; Ioana,9998,0,9999,1
1715659289376,MATH 197,004,660885,Floyd; Eric,9998,0,9999,1
1715659290404,MCWP 40R,A00,518780,Staff,1,0,20,19
1715659290404,MCWP 40R,B00,518781,Carter; Jennifer A,9,0,20,11
1715659290404,MCWP 40R,C00,518783,Smith; Haydee Marie,5,0,20,15
1715659291439,MCWP 50R,A00,518791,Redela; Pamela Morgan,0,1,20,20
1715659291439,MCWP 50R,B00,518792,Krone; Jarret,0,2,20,20
1715659291439,MCWP 50R,C00,518793,Staff,0,4,20,20
1715659291439,MCWP 50R,D00,518794,Morshed; Michael James,0,2,20,20
1715659291439,MCWP 50R,E00,518795,Carter; Andrea L,0,2,20,20
1715659291439,MCWP 50R,F00,518796,Miller; Elizabeth Deen,0,1,20,20
1715659291439,MCWP 50R,G00,518797,Guillen; Melinda,0,1,20,20
1715659292467,MMW 12R,A01,514034,Herbst; Matthew,0,2,16,16
1715659292467,MMW 12R,A02,514035,Herbst; Matthew,0,0,16,16
1715659293497,MMW 13R,A01,514037,Staff,0,5,16,16
1715659293497,MMW 13R,A02,514039,Staff,0,5,16,16
1715659293497,MMW 13R,A03,628519,Staff,0,4,16,16
1715659295550,SIO 295LS,A00,523233,Staff,10,0,30,20
1715659296575,SIO 295S,A00,523232,Staff,10,0,30,20
1715659297602,SIOC 290S,A01,637330,Merrifield; Mark A,21,0,30,9
1715659298628,SIOC 291S,A01,637333,Gabriel; Corey John,21,0,30,9
1715659299654,SOCI 117,A01,494376,Staff,0,5,5,5
1715659300683,WES 237B,A00,494380,Staff,10,0,20,10
1715659302768,AESE 279B,A00,494370,Wade; Jon P,0,0,33,33
1715659303796,AIP 97,001,660915,Van Den Einde; Yael Dahlia,9998,0,9999,1
1715659304823,AIP 197,001,627712,Vespa; Emanuel Ignacio,9995,0,9999,4
1715659304823,AIP 197,002,650778,Amir; On,9998,0,9999,1
1715659304823,AIP 197,003,650933,Avenancio-Leon; Carlos,9998,0,9999,1
1715659304823,AIP 197,004,658530,Heyman; Gail D.,9998,0,9999,1
1715659304823,AIP 197,005,658631,Neal; Sonya E,9998,0,9999,1
1715659304823,AIP 197,006,658671,Du; Songzi,9998,0,9999,1
1715659305852,ANAR 135S,A00,494369,Braswell; Geoffrey E.,0,0,0,0
1715659306883,BENG 196,001,628496,Engler; Adam J.,9998,0,9999,1
1715659306883,BENG 196,002,660916,Watson; John Thomas,9998,0,9999,1
1715659307914,BISP 197,001,650773,Wilhelm; James E.,9994,0,9999,5
1715659307914,BISP 197,002,658904,Coleman; Aaron B.,9998,0,9999,1
1715659308944,CAT 124RS,A01,519847,Geibel; William,0,0,20,20
1715659309977,CAT 125RS,A01,515971,Geibel; William,0,0,20,20
1715659311005,CLRE 250,A00,511389,Morris; Sheldon,9992,0,9999,7
1715659312036,CLRE 251,A00,507176,Mehta; Ravindra L.,9992,0,9999,7
1715659312036,CLRE 251,B00,511410,Mehta; Ravindra L.,9998,0,9999,1
1715659313063,CLRE 252,A00,507189,Cuomo; Raphael Eduardo,9994,0,9999,5
1715659314092,CLRE 253,A00,507199,Vaida; Florin,9994,0,9999,5
1715659314092,CLRE 253,B00,507202,Vaida; Florin,9999,0,9999,0
1715659315121,CLRE 259,A00,507211,Patel; Hemal,9996,0,9999,3
1715659316150,CLRE 260,A00,507221,Cuomo; Raphael Eduardo,9999,0,9999,0
1715659317178,CLRE 297,001,507242,Cuomo; Raphael Eduardo,9999,0,9999,0
1715659318206,COGS 197,001,638244,Voytek; Bradley Thomas,9997,0,9999,2
1715659319237,CSE 191,A00,516875,Minnes Kemp; Mor Mia,9991,0,9999,8
1715659320265,CSE 197,001,637388,Minnes Kemp; Mor Mia,9992,0,9999,7
1715659321297,CSS 201S,A01,494383,Mignozzetti; Umberto,35,0,35,0
1715659322322,CSS 202S,A01,494387,Mignozzetti; Umberto,35,0,35,0
1715659323352,DSC 197,001,628532,Eldridge; Justin Matthew,9995,0,9999,4
1715659324376,EAP 100,A00,516065,Staff,9799,0,9999,200
1715659325409,ECE 45,A01,507414,Staff,32,0,60,28
1715659327467,ECE 111,A01,507420,Staff,11,0,50,39
1715659328493,ECE 197,001,548057,Sievenpiper; Daniel F.,9991,0,9999,8
1715659329520,EDS 115,A00,507243,Choi; Bailey Miyeon,6,0,28,22
1715659330546,EDS 117,A01,494379,Staff,0,6,34,35
1715659331571,EDS 125,A00,507246,Hopkins; Megan Beth,7,0,30,23
1715659332601,EDS 128A,A01,507264,Fargason; Sharon Gayle,5,0,26,21
1715659333628,EDS 128B,A01,507293,Pappas; Elizabeth,9,0,30,21
1715659334653,EDS 139,A00,507294,Fargason; Sharon Gayle,9,0,30,21
1715659334653,EDS 139,B00,507313,Pappas; Elizabeth,9,0,30,21
1715659335679,EDS 201,A00,507315,Staff,10,0,30,20
1715659336704,EDS 203,A01,507317,Halter; Christopher P.,10,0,30,20
1715659337730,EDS 204R,A01,507319,Halter; Christopher P.,0,3,30,30
1715659337730,EDS 204R,B01,507331,Heinzman; Erica M.,14,0,30,16
1715659338755,EDS 206R,A00,507332,Staff,0,4,30,30
1715659338755,EDS 206R,B00,507343,Staff,15,0,30,15
1715659339782,EDS 250,A00,507344,Hemans; Patricia Ann Benitez,20,0,40,20
1715659340809,EDS 281,A00,507345,Daly; Alan J.,18,0,18,0
1715659341835,EDS 284,A00,507350,Daly; Alan J.,16,0,16,0
1715659342865,EDS 286,A00,507359,Fine; Sarah,18,0,18,0
1715659343905,EDS 289C,A01,507361,Daly; Alan J.,18,0,18,0
1715659344963,EDS 290,A00,507366,Hofstetter; Carolyn,15,0,15,0
1715659345989,LIGM 5A,A00,507421,Fischer-Grunski; Eva K,17,0,20,3
1715659347013,LIGM 5B,A00,507423,Fischer-Grunski; Eva K,19,0,20,1
1715659348046,LIGM 5C,A00,507425,Fischer-Grunski; Eva K,19,0,20,1
1715659349072,LIIT 5AS,A00,507427,Carnelos; Chiara,20,0,20,0
1715659350096,LIIT 5BS,A00,507430,Carnelos; Chiara,20,0,20,0
1715659351120,LIIT 5CS,A00,507432,Carnelos; Chiara,20,0,20,0
1715659352146,LISP 5A,A00,507541,Munoz Sanchez; Alicia,11,0,20,9
1715659353172,LISP 5B,A00,507671,Munoz Sanchez; Alicia,8,0,20,12
1715659354201,LISP 5C,A00,507696,Munoz Sanchez; Alicia,7,0,20,13
1715659355227,MAE 197,001,528363,Boechler; Nicholas Sebastia,9998,0,9999,1
1715659356261,MATH 197,001,523477,Kedlaya; Kiran S.,9994,0,9999,5
1715659356261,MATH 197,002,563811,Zhang; Danna,9994,0,9999,5
1715659356261,MATH 197,003,628552,Dumitriu; Ioana,9998,0,9999,1
1715659356261,MATH 197,004,660885,Floyd; Eric,9998,0,9999,1
1715659357292,MCWP 40R,A00,518780,Staff,1,0,20,19
1715659357292,MCWP 40R,B00,518781,Carter; Jennifer A,9,0,20,11
1715659357292,MCWP 40R,C00,518783,Smith; Haydee Marie,5,0,20,15
1715659358322,MCWP 50R,A00,518791,Redela; Pamela Morgan,0,1,20,20
1715659358322,MCWP 50R,B00,518792,Krone; Jarret,0,2,20,20
1715659358322,MCWP 50R,C00,518793,Staff,0,4,20,20
1715659358322,MCWP 50R,D00,518794,Morshed; Michael James,0,2,20,20
1715659358322,MCWP 50R,E00,518795,Carter; Andrea L,0,2,20,20
1715659358322,MCWP 50R,F00,518796,Miller; Elizabeth Deen,0,1,20,20
1715659358322,MCWP 50R,G00,518797,Guillen; Melinda,0,1,20,20
1715659359345,MMW 12R,A01,514034,Herbst; Matthew,0,2,16,16
1715659359345,MMW 12R,A02,514035,Herbst; Matthew,0,0,16,16
1715659360371,MMW 13R,A01,514037,Staff,0,5,16,16
1715659360371,MMW 13R,A02,514039,Staff,0,5,16,16
1715659360371,MMW 13R,A03,628519,Staff,0,4,16,16
1715659362424,SIO 295LS,A00,523233,Staff,10,0,30,20
1715659363450,SIO 295S,A00,523232,Staff,10,0,30,20
1715659364478,SIOC 290S,A01,637330,Merrifield; Mark A,21,0,30,9
1715659365509,SIOC 291S,A01,637333,Gabriel; Corey John,21,0,30,9
1715659366535,SOCI 117,A01,494376,Staff,0,5,5,5
1715659367564,WES 237B,A00,494380,Staff,10,0,20,10
1715659369647,AESE 279B,A00,494370,Wade; Jon P,0,0,33,33
1715659370673,AIP 97,001,660915,Van Den Einde; Yael Dahlia,9998,0,9999,1
1715659371701,AIP 197,001,627712,Vespa; Emanuel Ignacio,9995,0,9999,4
1715659371701,AIP 197,002,650778,Amir; On,9998,0,9999,1
1715659371701,AIP 197,003,650933,Avenancio-Leon; Carlos,9998,0,9999,1
1715659371701,AIP 197,004,658530,Heyman; Gail D.,9998,0,9999,1
1715659371701,AIP 197,005,658631,Neal; Sonya E,9998,0,9999,1
1715659371701,AIP 197,006,658671,Du; Songzi,9998,0,9999,1
1715659372727,ANAR 135S,A00,494369,Braswell; Geoffrey E.,0,0,0,0
1715659373754,BENG 196,001,628496,Engler; Adam J.,9998,0,9999,1
1715659373754,BENG 196,002,660916,Watson; John Thomas,9998,0,9999,1
1715659374784,BISP 197,001,650773,Wilhelm; James E.,9994,0,9999,5
1715659374784,BISP 197,002,658904,Coleman; Aaron B.,9998,0,9999,1
1715659375810,CAT 124RS,A01,519847,Geibel; William,0,0,20,20
1715659376836,CAT 125RS,A01,515971,Geibel; William,0,0,20,20
1715659377865,CLRE 250,A00,511389,Morris; Sheldon,9992,0,9999,7
1715659378894,CLRE 251,A00,507176,Mehta; Ravindra L.,9992,0,9999,7
1715659378894,CLRE 251,B00,511410,Mehta; Ravindra L.,9998,0,9999,1
1715659379919,CLRE 252,A00,507189,Cuomo; Raphael Eduardo,9994,0,9999,5
1715659380945,CLRE 253,A00,507199,Vaida; Florin,9994,0,9999,5
1715659380945,CLRE 253,B00,507202,Vaida; Florin,9999,0,9999,0
1715659381969,CLRE 259,A00,507211,Patel; Hemal,9996,0,9999,3
1715659382998,CLRE 260,A00,507221,Cuomo; Raphael Eduardo,9999,0,9999,0
1715659384022,CLRE 297,001,507242,Cuomo; Raphael Eduardo,9999,0,9999,0
1715659385051,COGS 197,001,638244,Voytek; Bradley Thomas,9997,0,9999,2
1715659386080,CSE 191,A00,516875,Minnes Kemp; Mor Mia,9991,0,9999,8
1715659387105,CSE 197,001,637388,Minnes Kemp; Mor Mia,9992,0,9999,7
1715659388131,CSS 201S,A01,494383,Mignozzetti; Umberto,35,0,35,0
1715659389155,CSS 202S,A01,494387,Mignozzetti; Umberto,35,0,35,0
1715659390181,DSC 197,001,628532,Eldridge; Justin Matthew,9995,0,9999,4
1715659391207,EAP 100,A00,516065,Staff,9799,0,9999,200
1715659392234,ECE 45,A01,507414,Staff,32,0,60,28
1715659394290,ECE 111,A01,507420,Staff,11,0,50,39
1715659395317,ECE 197,001,548057,Sievenpiper; Daniel F.,9991,0,9999,8
1715659396342,EDS 115,A00,507243,Choi; Bailey Miyeon,6,0,28,22
1715659397376,EDS 117,A01,494379,Staff,0,6,34,35
1715659398401,EDS 125,A00,507246,Hopkins; Megan Beth,7,0,30,23
1715659399428,EDS 128A,A01,507264,Fargason; Sharon Gayle,5,0,26,21
1715659400453,EDS 128B,A01,507293,Pappas; Elizabeth,9,0,30,21
1715659401478,EDS 139,A00,507294,Fargason; Sharon Gayle,9,0,30,21
1715659401478,EDS 139,B00,507313,Pappas; Elizabeth,9,0,30,21
1715659402507,EDS 201,A00,507315,Staff,10,0,30,20
1715659403538,EDS 203,A01,507317,Halter; Christopher P.,10,0,30,20
1715659404564,EDS 204R,A01,507319,Halter; Christopher P.,0,3,30,30
1715659404564,EDS 204R,B01,507331,Heinzman; Erica M.,14,0,30,16
1715659405588,EDS 206R,A00,507332,Staff,0,4,30,30
1715659405588,EDS 206R,B00,507343,Staff,15,0,30,15
1715659406613,EDS 250,A00,507344,Hemans; Patricia Ann Benitez,20,0,40,20
1715659407643,EDS 281,A00,507345,Daly; Alan J.,18,0,18,0
1715659408669,EDS 284,A00,507350,Daly; Alan J.,16,0,16,0
1715659409694,EDS 286,A00,507359,Fine; Sarah,18,0,18,0
1715659410722,EDS 289C,A01,507361,Daly; Alan J.,18,0,18,0
1715659411747,EDS 290,A00,507366,Hofstetter; Carolyn,15,0,15,0
1715659412772,LIGM 5A,A00,507421,Fischer-Grunski; Eva K,17,0,20,3
1715659413797,LIGM 5B,A00,507423,Fischer-Grunski; Eva K,19,0,20,1
1715659414821,LIGM 5C,A00,507425,Fischer-Grunski; Eva K,19,0,20,1
1715659415852,LIIT 5AS,A00,507427,Carnelos; Chiara,20,0,20,0
1715659416877,LIIT 5BS,A00,507430,Carnelos; Chiara,20,0,20,0
1715659417900,LIIT 5CS,A00,507432,Carnelos; Chiara,20,0,20,0
1715659418928,LISP 5A,A00,507541,Munoz Sanchez; Alicia,11,0,20,9
1715659419953,LISP 5B,A00,507671,Munoz Sanchez; Alicia,8,0,20,12
1715659420979,LISP 5C,A00,507696,Munoz Sanchez; Alicia,7,0,20,13
1715659422006,MAE 197,001,528363,Boechler; Nicholas Sebastia,9998,0,9999,1
1715659423033,MATH 197,001,523477,Kedlaya; Kiran S.,9994,0,9999,5
1715659423033,MATH 197,002,563811,Zhang; Danna,9994,0,9999,5
1715659423033,MATH 197,003,628552,Dumitriu; Ioana,9998,0,9999,1
1715659423033,MATH 197,004,660885,Floyd; Eric,9998,0,9999,1
1715659424059,MCWP 40R,A00,518780,Staff,1,0,20,19
1715659424059,MCWP 40R,B00,518781,Carter; Jennifer A,9,0,20,11
1715659424059,MCWP 40R,C00,518783,Smith; Haydee Marie,5,0,20,15
1715659425092,MCWP 50R,A00,518791,Redela; Pamela Morgan,0,1,20,20
1715659425092,MCWP 50R,B00,518792,Krone; Jarret,0,2,20,20
1715659425092,MCWP 50R,C00,518793,Staff,0,4,20,20
1715659425092,MCWP 50R,D00,518794,Morshed; Michael James,0,2,20,20
1715659425092,MCWP 50R,E00,518795,Carter; Andrea L,0,2,20,20
1715659425092,MCWP 50R,F00,518796,Miller; Elizabeth Deen,0,1,20,20
1715659425092,MCWP 50R,G00,518797,Guillen; Melinda,0,1,20,20
1715659426120,MMW 12R,A01,514034,Herbst; Matthew,0,2,16,16
1715659426120,MMW 12R,A02,514035,Herbst; Matthew,0,0,16,16
1715659427147,MMW 13R,A01,514037,Staff,0,5,16,16
1715659427147,MMW 13R,A02,514039,Staff,0,5,16,16
1715659427147,MMW 13R,A03,628519,Staff,0,4,16,16
1715659429200,SIO 295LS,A00,523233,Staff,10,0,30,20
1715659430229,SIO 295S,A00,523232,Staff,10,0,30,20
1715659431254,SIOC 290S,A01,637330,Merrifield; Mark A,21,0,30,9
1715659432280,SIOC 291S,A01,637333,Gabriel; Corey John,21,0,30,9
1715659433305,SOCI 117,A01,494376,Staff,0,5,5,5
1715659434332,WES 237B,A00,494380,Staff,10,0,20,10
1715659436404,AESE 279B,A00,494370,Wade; Jon P,0,0,33,33
1715659437433,AIP 97,001,660915,Van Den Einde; Yael Dahlia,9998,0,9999,1
1715659438463,AIP 197,001,627712,Vespa; Emanuel Ignacio,9995,0,9999,4
1715659438463,AIP 197,002,650778,Amir; On,9998,0,9999,1
1715659438463,AIP 197,003,650933,Avenancio-Leon; Carlos,9998,0,9999,1
1715659438463,AIP 197,004,658530,Heyman; Gail D.,9998,0,9999,1
1715659438463,AIP 197,005,658631,Neal; Sonya E,9998,0,9999,1
1715659438463,AIP 197,006,658671,Du; Songzi,9998,0,9999,1
1715659439489,ANAR 135S,A00,494369,Braswell; Geoffrey E.,0,0,0,0
1715659440518,BENG 196,001,628496,Engler; Adam J.,9998,0,9999,1
1715659440518,BENG 196,002,660916,Watson; John Thomas,9998,0,9999,1
1715659441558,BISP 197,001,650773,Wilhelm; James E.,9994,0,9999,5
1715659441558,BISP 197,002,658904,Coleman; Aaron B.,9998,0,9999,1
1715659442584,CAT 124RS,A01,519847,Geibel; William,0,0,20,20
1715659443614,CAT 125RS,A01,515971,Geibel; William,0,0,20,20
1715659444645,CLRE 250,A00,511389,Morris; Sheldon,9992,0,9999,7
1715659445672,CLRE 251,A00,507176,Mehta; Ravindra L.,9992,0,9999,7
1715659445672,CLRE 251,B00,511410,Mehta; Ravindra L.,9998,0,9999,1
1715659446697,CLRE 252,A00,507189,Cuomo; Raphael Eduardo,9994,0,9999,5
1715659447723,CLRE 253,A00,507199,Vaida; Florin,9994,0,9999,5
1715659447723,CLRE 253,B00,507202,Vaida; Florin,9999,0,9999,0
1715659448753,CLRE 259,A00,507211,Patel; Hemal,9996,0,9999,3
1715659449778,CLRE 260,A00,507221,Cuomo; Raphael Eduardo,9999,0,9999,0
1715659450804,CLRE 297,001,507242,Cuomo; Raphael Eduardo,9999,0,9999,0
1715659451833,COGS 197,001,638244,Voytek; Bradley Thomas,9997,0,9999,2
1715659452863,CSE 191,A00,516875,Minnes Kemp; Mor Mia,9991,0,9999,8
1715659453891,CSE 197,001,637388,Minnes Kemp; Mor Mia,9992,0,9999,7
1715659454917,CSS 201S,A01,494383,Mignozzetti; Umberto,35,0,35,0
1715659455941,CSS 202S,A01,494387,Mignozzetti; Umberto,35,0,35,0
1715659456965,DSC 197,001,628532,Eldridge; Justin Matthew,9995,0,9999,4
1715659457990,EAP 100,A00,516065,Staff,9799,0,9999,200
1715659459017,ECE 45,A01,507414,Staff,32,0,60,28
1715659461066,ECE 111,A01,507420,Staff,11,0,50,39
1715659462095,ECE 197,001,548057,Sievenpiper; Daniel F.,9991,0,9999,8
1715659463127,EDS 115,A00,507243,Choi; Bailey Miyeon,6,0,28,22
1715659464155,EDS 117,A01,494379,Staff,0,6,34,35
1715659465179,EDS 125,A00,507246,Hopkins; Megan Beth,7,0,30,23
1715659466206,EDS 128A,A01,507264,Fargason; Sharon Gayle,5,0,26,21
1715659467232,EDS 128B,A01,507293,Pappas; Elizabeth,9,0,30,21
1715659468257,EDS 139,A00,507294,Fargason; Sharon Gayle,9,0,30,21
1715659468257,EDS 139,B00,507313,Pappas; Elizabeth,9,0,30,21
1715659469282,EDS 201,A00,507315,Staff,10,0,30,20
1715659470310,EDS 203,A01,507317,Halter; Christopher P.,10,0,30,20
1715659471335,EDS 204R,A01,507319,Halter; Christopher P.,0,3,30,30
1715659471335,EDS 204R,B01,507331,Heinzman; Erica M.,14,0,30,16
1715659472359,EDS 206R,A00,507332,Staff,0,4,30,30
1715659472359,EDS 206R,B00,507343,Staff,15,0,30,15
1715659473387,EDS 250,A00,507344,Hemans; Patricia Ann Benitez,20,0,40,20
1715659474415,EDS 281,A00,507345,Daly; Alan J.,18,0,18,0
1715659475443,EDS 284,A00,507350,Daly; Alan J.,16,0,16,0
1715659476470,EDS 286,A00,507359,Fine; Sarah,18,0,18,0
1715659477499,EDS 289C,A01,507361,Daly; Alan J.,18,0,18,0
1715659478524,EDS 290,A00,507366,Hofstetter; Carolyn,15,0,15,0
1715659479554,LIGM 5A,A00,507421,Fischer-Grunski; Eva K,17,0,20,3
1715659480580,LIGM 5B,A00,507423,Fischer-Grunski; Eva K,19,0,20,1
1715659481608,LIGM 5C,A00,507425,Fischer-Grunski; Eva K,19,0,20,1
1715659482634,LIIT 5AS,A00,507427,Carnelos; Chiara,20,0,20,0
1715659483658,LIIT 5BS,A00,507430,Carnelos; Chiara,20,0,20,0
1715659484683,LIIT 5CS,A00,507432,Carnelos; Chiara,20,0,20,0
1715659485708,LISP 5A,A00,507541,Munoz Sanchez; Alicia,11,0,20,9
1715659486736,LISP 5B,A00,507671,Munoz Sanchez; Alicia,8,0,20,12
1715659487765,LISP 5C,A00,507696,Munoz Sanchez; Alicia,7,0,20,13
1715659488791,MAE 197,001,528363,Boechler; Nicholas Sebastia,9998,0,9999,1
1715659489822,MATH 197,001,523477,Kedlaya; Kiran S.,9994,0,9999,5
1715659489822,MATH 197,002,563811,Zhang; Danna,9994,0,9999,5
1715659489822,MATH 197,003,628552,Dumitriu; Ioana,9998,0,9999,1
1715659489822,MATH 197,004,660885,Floyd; Eric,9998,0,9999,1
1715659490851,MCWP 40R,A00,518780,Staff,1,0,20,19
1715659490851,MCWP 40R,B00,518781,Carter; Jennifer A,9,0,20,11
1715659490851,MCWP 40R,C00,518783,Smith; Haydee Marie,5,0,20,15
1715659491879,MCWP 50R,A00,518791,Redela; Pamela Morgan,0,1,20,20
1715659491879,MCWP 50R,B00,518792,Krone; Jarret,0,2,20,20
1715659491879,MCWP 50R,C00,518793,Staff,0,4,20,20
1715659491879,MCWP 50R,D00,518794,Morshed; Michael James,0,2,20,20
1715659491879,MCWP 50R,E00,518795,Carter; Andrea L,0,2,20,20
1715659491879,MCWP 50R,F00,518796,Miller; Elizabeth Deen,0,1,20,20
1715659491879,MCWP 50R,G00,518797,Guillen; Melinda,0,1,20,20
1715659492903,MMW 12R,A01,514034,Herbst; Matthew,0,2,16,16
1715659492903,MMW 12R,A02,514035,Herbst; Matthew,0,0,16,16
1715659493932,MMW 13R,A01,514037,Staff,0,5,16,16
1715659493932,MMW 13R,A02,514039,Staff,0,5,16,16
1715659493932,MMW 13R,A03,628519,Staff,0,4,16,16
1715659495986,SIO 295LS,A00,523233,Staff,10,0,30,20
1715659497011,SIO 295S,A00,523232,Staff,10,0,30,20
1715659498042,SIOC 290S,A01,637330,Merrifield; Mark A,21,0,30,9
1715659499072,SIOC 291S,A01,637333,Gabriel; Corey John,21,0,30,9
1715659500098,SOCI 117,A01,494376,Staff,0,5,5,5
1715659501125,WES 237B,A00,494380,Staff,10,0,20,10
1715659503197,AESE 279B,A00,494370,Wade; Jon P,0,0,33,33
1715659504224,AIP 97,001,660915,Van Den Einde; Yael Dahlia,9998,0,9999,1
1715659505258,AIP 197,001,627712,Vespa; Emanuel Ignacio,9995,0,9999,4
1715659505258,AIP 197,002,650778,Amir; On,9998,0,9999,1
1715659505258,AIP 197,003,650933,Avenancio-Leon; Carlos,9998,0,9999,1
1715659505258,AIP 197,004,658530,Heyman; Gail D.,9998,0,9999,1
1715659505258,AIP 197,005,658631,Neal; Sonya E,9998,0,9999,1
1715659505258,AIP 197,006,658671,Du; Songzi,9998,0,9999,1
1715659506287,ANAR 135S,A00,494369,Braswell; Geoffrey E.,0,0,0,0
1715659507313,BENG 196,001,628496,Engler; Adam J.,9998,0,9999,1
1715659507313,BENG 196,002,660916,Watson; John Thomas,9998,0,9999,1
1715659508349,BISP 197,001,650773,Wilhelm; James E.,9994,0,9999,5
1715659508349,BISP 197,002,658904,Coleman; Aaron B.,9998,0,9999,1
1715659509379,CAT 124RS,A01,519847,Geibel; William,0,0,20,20
1715659510405,CAT 125RS,A01,515971,Geibel; William,0,0,20,20
1715659511435,CLRE 250,A00,511389,Morris; Sheldon,9992,0,9999,7
1715659512465,CLRE 251,A00,507176,Mehta; Ravindra L.,9992,0,9999,7
1715659512465,CLRE 251,B00,511410,Mehta; Ravindra L.,9998,0,9999,1
1715659513493,CLRE 252,A00,507189,Cuomo; Raphael Eduardo,9994,0,9999,5
1715659514520,CLRE 253,A00,507199,Vaida; Florin,9994,0,9999,5
1715659514520,CLRE 253,B00,507202,Vaida; Florin,9999,0,9999,0
1715659515545,CLRE 259,A00,507211,Patel; Hemal,9996,0,9999,3
1715659516573,CLRE 260,A00,507221,Cuomo; Raphael Eduardo,9999,0,9999,0
1715659517598,CLRE 297,001,507242,Cuomo; Raphael Eduardo,9999,0,9999,0
1715659518624,COGS 197,001,638244,Voytek; Bradley Thomas,9997,0,9999,2
1715659519654,CSE 191,A00,516875,Minnes Kemp; Mor Mia,9991,0,9999,8
1715659520681,CSE 197,001,637388,Minnes Kemp; Mor Mia,9992,0,9999,7
1715659521712,CSS 201S,A01,494383,Mignozzetti; Umberto,35,0,35,0
1715659522738,CSS 202S,A01,494387,Mignozzetti; Umberto,35,0,35,0
1715659523765,DSC 197,001,628532,Eldridge; Justin Matthew,9995,0,9999,4
1715659524789,EAP 100,A00,516065,Staff,9799,0,9999,200
1715659525822,ECE 45,A01,507414,Staff,32,0,60,28
1715659527873,ECE 111,A01,507420,Staff,11,0,50,39
1715659528898,ECE 197,001,548057,Sievenpiper; Daniel F.,9991,0,9999,8
1715659529924,EDS 115,A00,507243,Choi; Bailey Miyeon,6,0,28,22
1715659530952,EDS 117,A01,494379,Staff,0,6,34,35
1715659531980,EDS 125,A00,507246,Hopkins; Megan Beth,7,0,30,23
1715659533005,EDS 128A,A01,507264,Fargason; Sharon Gayle,5,0,26,21
1715659534035,EDS 128B,A01,507293,Pappas; Elizabeth,9,0,30,21
1715659535062,EDS 139,A00,507294,Fargason; Sharon Gayle,9,0,30,21
1715659535062,EDS 139,B00,507313,Pappas; Elizabeth,9,0,30,21
1715659536087,EDS 201,A00,507315,Staff,10,0,30,20
1715659537118,EDS 203,A01,507317,Halter; Christopher P.,10,0,30,20
1715659538146,EDS 204R,A01,507319,Halter; Christopher P.,0,3,30,30
1715659538146,EDS 204R,B01,507331,Heinzman; Erica M.,14,0,30,16
1715659539171,EDS 206R,A00,507332,Staff,0,4,30,30
1715659539171,EDS 206R,B00,507343,Staff,15,0,30,15
1715659540195,EDS 250,A00,507344,Hemans; Patricia Ann Benitez,20,0,40,20
1715659541220,EDS 281,A00,507345,Daly; Alan J.,18,0,18,0
1715659542247,EDS 284,A00,507350,Daly; Alan J.,16,0,16,0
1715659543276,EDS 286,A00,507359,Fine; Sarah,18,0,18,0
1715659544300,EDS 289C,A01,507361,Daly; Alan J.,18,0,18,0
1715659545330,EDS 290,A00,507366,Hofstetter; Carolyn,15,0,15,0
1715659546360,LIGM 5A,A00,507421,Fischer-Grunski; Eva K,17,0,20,3
1715659547386,LIGM 5B,A00,507423,Fischer-Grunski; Eva K,19,0,20,1
1715659548417,LIGM 5C,A00,507425,Fischer-Grunski; Eva K,19,0,20,1
1715659549446,LIIT 5AS,A00,507427,Carnelos; Chiara,20,0,20,0
1715659550475,LIIT 5BS,A00,507430,Carnelos; Chiara,20,0,20,0
1715659551504,LIIT 5CS,A00,507432,Carnelos; Chiara,20,0,20,0
1715659552535,LISP 5A,A00,507541,Munoz Sanchez; Alicia,11,0,20,9
1715659553563,LISP 5B,A00,507671,Munoz Sanchez; Alicia,8,0,20,12
1715659554588,LISP 5C,A00,507696,Munoz Sanchez; Alicia,7,0,20,13
1715659555618,MAE 197,001,528363,Boechler; Nicholas Sebastia,9998,0,9999,1
1715659556647,MATH 197,001,523477,Kedlaya; Kiran S.,9994,0,9999,5
1715659556647,MATH 197,002,563811,Zhang; Danna,9994,0,9999,5
1715659556647,MATH 197,003,628552,Dumitriu; Ioana,9998,0,9999,1
1715659556647,MATH 197,004,660885,Floyd; Eric,9998,0,9999,1
1715659557679,MCWP 40R,A00,518780,Staff,1,0,20,19
1715659557679,MCWP 40R,B00,518781,Carter; Jennifer A,9,0,20,11
1715659557679,MCWP 40R,C00,518783,Smith; Haydee Marie,5,0,20,15
1715659558707,MCWP 50R,A00,518791,Redela; Pamela Morgan,0,1,20,20
1715659558707,MCWP 50R,B00,518792,Krone; Jarret,0,2,20,20
1715659558707,MCWP 50R,C00,518793,Staff,0,4,20,20
1715659558707,MCWP 50R,D00,518794,Morshed; Michael James,0,2,20,20
1715659558707,MCWP 50R,E00,518795,Carter; Andrea L,0,2,20,20
1715659558707,MCWP 50R,F00,518796,Miller; Elizabeth Deen,0,1,20,20
1715659558707,MCWP 50R,G00,518797,Guillen; Melinda,0,1,20,20
1715659559737,MMW 12R,A01,514034,Herbst; Matthew,0,2,16,16
1715659559737,MMW 12R,A02,514035,Herbst; Matthew,0,0,16,16
1715659560763,MMW 13R,A01,514037,Staff,0,5,16,16
1715659560763,MMW 13R,A02,514039,Staff,0,5,16,16
1715659560763,MMW 13R,A03,628519,Staff,0,4,16,16
1715659562814,SIO 295LS,A00,523233,Staff,10,0,30,20
1715659563844,SIO 295S,A00,523232,Staff,10,0,30,20
1715659564868,SIOC 290S,A01,637330,Merrifield; Mark A,21,0,30,9
1715659565892,SIOC 291S,A01,637333,Gabriel; Corey John,21,0,30,9
1715659566917,SOCI 117,A01,494376,Staff,0,5,5,5
1715659567941,WES 237B,A00,494380,Staff,10,0,20,10
1715659570011,AESE 279B,A00,494370,Wade; Jon P,0,0,33,33
1715659571037,AIP 97,001,660915,Van Den Einde; Yael Dahlia,9998,0,9999,1
1715659572070,AIP 197,001,627712,Vespa; Emanuel Ignacio,9995,0,9999,4
1715659572070,AIP 197,002,650778,Amir; On,9998,0,9999,1
1715659572070,AIP 197,003,650933,Avenancio-Leon; Carlos,9998,0,9999,1
1715659572070,AIP 197,004,658530,Heyman; Gail D.,9998,0,9999,1
1715659572070,AIP 197,005,658631,Neal; Sonya E,9998,0,9999,1
1715659572070,AIP 197,006,658671,Du; Songzi,9998,0,9999,1
1715659573095,ANAR 135S,A00,494369,Braswell; Geoffrey E.,0,0,0,0
1715659574125,BENG 196,001,628496,Engler; Adam J.,9998,0,9999,1
1715659574125,BENG 196,002,660916,Watson; John Thomas,9998,0,9999,1
1715659575151,BISP 197,001,650773,Wilhelm; James E.,9994,0,9999,5
1715659575151,BISP 197,002,658904,Coleman; Aaron B.,9998,0,9999,1
1715659576178,CAT 124RS,A01,519847,Geibel; William,0,0,20,20
1715659577203,CAT 125RS,A01,515971,Geibel; William,0,0,20,20
1715659578229,CLRE 250,A00,511389,Morris; Sheldon,9992,0,9999,7
1715659579256,CLRE 251,A00,507176,Mehta; Ravindra L.,9992,0,9999,7
1715659579256,CLRE 251,B00,511410,Mehta; Ravindra L.,9998,0,9999,1
1715659580284,CLRE 252,A00,507189,Cuomo; Raphael Eduardo,9994,0,9999,5
1715659581310,CLRE 253,A00,507199,Vaida; Florin,9994,0,9999,5
1715659581310,CLRE 253,B00,507202,Vaida; Florin,9999,0,9999,0
1715659582339,CLRE 259,A00,507211,Patel; Hemal,9996,0,9999,3
1715659583365,CLRE 260,A00,507221,Cuomo; Raphael Eduardo,9999,0,9999,0
1715659584390,CLRE 297,001,507242,Cuomo; Raphael Eduardo,9999,0,9999,0
1715659585415,COGS 197,001,638244,Voytek; Bradley Thomas,9997,0,9999,2
1715659586443,CSE 191,A00,516875,Minnes Kemp; Mor Mia,9991,0,9999,8
1715659587470,CSE 197,001,637388,Minnes Kemp; Mor Mia,9992,0,9999,7
1715659588497,CSS 201S,A01,494383,Mignozzetti; Umberto,35,0,35,0
1715659589522,CSS 202S,A01,494387,Mignozzetti; Umberto,35,0,35,0
1715659590546,DSC 197,001,628532,Eldridge; Justin Matthew,9995,0,9999,4
1715659591571,EAP 100,A00,516065,Staff,9799,0,9999,200
1715659592599,ECE 45,A01,507414,Staff,32,0,60,28
1715659594649,ECE 111,A01,507420,Staff,11,0,50,39
1715659595677,ECE 197,001,548057,Sievenpiper; Daniel F.,9991,0,9999,8
1715659596704,EDS 115,A00,507243,Choi; Bailey Miyeon,6,0,28,22
1715659597729,EDS 117,A01,494379,Staff,0,6,34,35
1715659598755,EDS 125,A00,507246,Hopkins; Megan Beth,7,0,30,23
1715659599783,EDS 128A,A01,507264,Fargason; Sharon Gayle,5,0,26,21
1715659600812,EDS 128B,A01,507293,Pappas; Elizabeth,9,0,30,21
1715659601842,EDS 139,A00,507294,Fargason; Sharon Gayle,9,0,30,21
1715659601842,EDS 139,B00,507313,Pappas; Elizabeth,9,0,30,21
1715659602867,EDS 201,A00,507315,Staff,10,0,30,20
1715659603892,EDS 203,A01,507317,Halter; Christopher P.,10,0,30,20
1715659604920,EDS 204R,A01,507319,Halter; Christopher P.,0,3,30,30
1715659604920,EDS 204R,B01,507331,Heinzman; Erica M.,14,0,30,16
1715659605945,EDS 206R,A00,507332,Staff,0,4,30,30
1715659605945,EDS 206R,B00,507343,Staff,15,0,30,15
1715659606971,EDS 250,A00,507344,Hemans; Patricia Ann Benitez,20,0,40,20
1715659607996,EDS 281,A00,507345,Daly; Alan J.,18,0,18,0
1715659609023,EDS 284,A00,507350,Daly; Alan J.,16,0,16,0
1715659610051,EDS 286,A00,507359,Fine; Sarah,18,0,18,0
1715659611076,EDS 289C,A01,507361,Daly; Alan J.,18,0,18,0
1715659612102,EDS 290,A00,507366,Hofstetter; Carolyn,15,0,15,0
1715659613132,LIGM 5A,A00,507421,Fischer-Grunski; Eva K,17,0,20,3
1715659614157,LIGM 5B,A00,507423,Fischer-Grunski; Eva K,19,0,20,1
1715659615183,LIGM 5C,A00,507425,Fischer-Grunski; Eva K,19,0,20,1
1715659616212,LIIT 5AS,A00,507427,Carnelos; Chiara,20,0,20,0
1715659617238,LIIT 5BS,A00,507430,Carnelos; Chiara,20,0,20,0
1715659618263,LIIT 5CS,A00,507432,Carnelos; Chiara,20,0,20,0
1715659619288,LISP 5A,A00,507541,Munoz Sanchez; Alicia,11,0,20,9
1715659620314,LISP 5B,A00,507671,Munoz Sanchez; Alicia,8,0,20,12
1715659621342,LISP 5C,A00,507696,Munoz Sanchez; Alicia,7,0,20,13
1715659622366,MAE 197,001,528363,Boechler; Nicholas Sebastia,9998,0,9999,1
1715659623398,MATH 197,001,523477,Kedlaya; Kiran S.,9994,0,9999,5
1715659623398,MATH 197,002,563811,Zhang; Danna,9994,0,9999,5
1715659623398,MATH 197,003,628552,Dumitriu; Ioana,9998,0,9999,1
1715659623398,MATH 197,004,660885,Floyd; Eric,9998,0,9999,1
1715659624426,MCWP 40R,A00,518780,Staff,1,0,20,19
1715659624426,MCWP 40R,B00,518781,Carter; Jennifer A,9,0,20,11
1715659624426,MCWP 40R,C00,518783,Smith; Haydee Marie,5,0,20,15
1715659625461,MCWP 50R,A00,518791,Redela; Pamela Morgan,0,1,20,20
1715659625461,MCWP 50R,B00,518792,Krone; Jarret,0,2,20,20
1715659625461,MCWP 50R,C00,518793,Staff,0,4,20,20
1715659625461,MCWP 50R,D00,518794,Morshed; Michael James,0,2,20,20
1715659625461,MCWP 50R,E00,518795,Carter; Andrea L,0,2,20,20
1715659625461,MCWP 50R,F00,518796,Miller; Elizabeth Deen,0,1,20,20
1715659625461,MCWP 50R,G00,518797,Guillen; Melinda,0,1,20,20
1715659626488,MMW 12R,A01,514034,Herbst; Matthew,0,2,16,16
1715659626488,MMW 12R,A02,514035,Herbst; Matthew,0,0,16,16
1715659627514,MMW 13R,A01,514037,Staff,0,5,16,16
1715659627514,MMW 13R,A02,514039,Staff,0,5,16,16
1715659627514,MMW 13R,A03,628519,Staff,0,4,16,16
1715659629565,SIO 295LS,A00,523233,Staff,10,0,30,20
1715659630591,SIO 295S,A00,523232,Staff,10,0,30,20
1715659631621,SIOC 290S,A01,637330,Merrifield; Mark A,21,0,30,9
1715659632649,SIOC 291S,A01,637333,Gabriel; Corey John,21,0,30,9
1715659633679,SOCI 117,A01,494376,Staff,0,5,5,5
1715659634710,WES 237B,A00,494380,Staff,10,0,20,10
1715659636781,AESE 279B,A00,494370,Wade; Jon P,0,0,33,33
1715659637808,AIP 97,001,660915,Van Den Einde; Yael Dahlia,9998,0,9999,1
1715659638844,AIP 197,001,627712,Vespa; Emanuel Ignacio,9995,0,9999,4
1715659638844,AIP 197,002,650778,Amir; On,9998,0,9999,1
1715659638844,AIP 197,003,650933,Avenancio-Leon; Carlos,9998,0,9999,1
1715659638844,AIP 197,004,658530,Heyman; Gail D.,9998,0,9999,1
1715659638844,AIP 197,005,658631,Neal; Sonya E,9998,0,9999,1
1715659638844,AIP 197,006,658671,Du; Songzi,9998,0,9999,1
1715659639872,ANAR 135S,A00,494369,Braswell; Geoffrey E.,0,0,0,0
1715659640902,BENG 196,001,628496,Engler; Adam J.,9998,0,9999,1
1715659640902,BENG 196,002,660916,Watson; John Thomas,9998,0,9999,1
1715659641931,BISP 197,001,650773,Wilhelm; James E.,9994,0,9999,5
1715659641931,BISP 197,002,658904,Coleman; Aaron B.,9998,0,9999,1
1715659642961,CAT 124RS,A01,519847,Geibel; William,0,0,20,20
1715659643985,CAT 125RS,A01,515971,Geibel; William,0,0,20,20
1715659645014,CLRE 250,A00,511389,Morris; Sheldon,9992,0,9999,7
1715659646042,CLRE 251,A00,507176,Mehta; Ravindra L.,9992,0,9999,7
1715659646042,CLRE 251,B00,511410,Mehta; Ravindra L.,9998,0,9999,1
1715659647070,CLRE 252,A00,507189,Cuomo; Raphael Eduardo,9994,0,9999,5
1715659648095,CLRE 253,A00,507199,Vaida; Florin,9994,0,9999,5
1715659648095,CLRE 253,B00,507202,Vaida; Florin,9999,0,9999,0
1715659649121,CLRE 259,A00,507211,Patel; Hemal,9996,0,9999,3
1715659650203,CLRE 260,A00,507221,Cuomo; Raphael Eduardo,9999,0,9999,0
1715659651227,CLRE 297,001,507242,Cuomo; Raphael Eduardo,9999,0,9999,0
1715659652253,COGS 197,001,638244,Voytek; Bradley Thomas,9997,0,9999,2
1715659653279,CSE 191,A00,516875,Minnes Kemp; Mor Mia,9991,0,9999,8
1715659654305,CSE 197,001,637388,Minnes Kemp; Mor Mia,9992,0,9999,7
1715659655388,CSS 201S,A01,494383,Mignozzetti; Umberto,35,0,35,0
1715659656415,CSS 202S,A01,494387,Mignozzetti; Umberto,35,0,35,0
1715659657444,DSC 197,001,628532,Eldridge; Justin Matthew,9995,0,9999,4
1715659658472,EAP 100,A00,516065,Staff,9799,0,9999,200
1715659659505,ECE 45,A01,507414,Staff,32,0,60,28
1715659661563,ECE 111,A01,507420,Staff,11,0,50,39
1715659662592,ECE 197,001,548057,Sievenpiper; Daniel F.,9991,0,9999,8
1715659663620,EDS 115,A00,507243,Choi; Bailey Miyeon,6,0,28,22
1715659664649,EDS 117,A01,494379,Staff,0,6,34,35
1715659665675,EDS 125,A00,507246,Hopkins; Megan Beth,7,0,30,23
1715659666704,EDS 128A,A01,507264,Fargason; Sharon Gayle,5,0,26,21
1715659667729,EDS 128B,A01,507293,Pappas; Elizabeth,9,0,30,21
1715659668757,EDS 139,A00,507294,Fargason; Sharon Gayle,9,0,30,21
1715659668757,EDS 139,B00,507313,Pappas; Elizabeth,9,0,30,21
1715659669780,EDS 201,A00,507315,Staff,10,0,30,20
1715659670808,EDS 203,A01,507317,Halter; Christopher P.,10,0,30,20
1715659671838,EDS 204R,A01,507319,Halter; Christopher P.,0,3,30,30
1715659671838,EDS 204R,B01,507331,Heinzman; Erica M.,14,0,30,16
1715659672865,EDS 206R,A00,507332,Staff,0,4,30,30
1715659672865,EDS 206R,B00,507343,Staff,15,0,30,15
1715659673895,EDS 250,A00,507344,Hemans; Patricia Ann Benitez,20,0,40,20
1715659674922,EDS 281,A00,507345,Daly; Alan J.,18,0,18,0
1715659675950,EDS 284,A00,507350,Daly; Alan J.,16,0,16,0
1715659676978,EDS 286,A00,507359,Fine; Sarah,18,0,18,0
1715659678003,EDS 289C,A01,507361,Daly; Alan J.,18,0,18,0
1715659679030,EDS 290,A00,507366,Hofstetter; Carolyn,15,0,15,0
1715659680054,LIGM 5A,A00,507421,Fischer-Grunski; Eva K,17,0,20,3
1715659681079,LIGM 5B,A00,507423,Fischer-Grunski; Eva K,19,0,20,1
1715659682105,LIGM 5C,A00,507425,Fischer-Grunski; Eva K,19,0,20,1
1715659683140,LIIT 5AS,A00,507427,Carnelos; Chiara,20,0,20,0
1715659684170,LIIT 5BS,A00,507430,Carnelos; Chiara,20,0,20,0
1715659685199,LIIT 5CS,A00,507432,Carnelos; Chiara,20,0,20,0
1715659686224,LISP 5A,A00,507541,Munoz Sanchez; Alicia,11,0,20,9
1715659687247,LISP 5B,A00,507671,Munoz Sanchez; Alicia,8,0,20,12
1715659688272,LISP 5C,A00,507696,Munoz Sanchez; Alicia,7,0,20,13
1715659689302,MAE 197,001,528363,Boechler; Nicholas Sebastia,9998,0,9999,1
1715659690335,MATH 197,001,523477,Kedlaya; Kiran S.,9994,0,9999,5
1715659690335,MATH 197,002,563811,Zhang; Danna,9994,0,9999,5
1715659690335,MATH 197,003,628552,Dumitriu; Ioana,9998,0,9999,1
1715659690335,MATH 197,004,660885,Floyd; Eric,9998,0,9999,1
1715659691360,MCWP 40R,A00,518780,Staff,1,0,20,19
1715659691360,MCWP 40R,B00,518781,Carter; Jennifer A,9,0,20,11
1715659691360,MCWP 40R,C00,518783,Smith; Haydee Marie,5,0,20,15
1715659692388,MCWP 50R,A00,518791,Redela; Pamela Morgan,0,1,20,20
1715659692388,MCWP 50R,B00,518792,Krone; Jarret,0,2,20,20
1715659692388,MCWP 50R,C00,518793,Staff,0,4,20,20
1715659692388,MCWP 50R,D00,518794,Morshed; Michael James,0,2,20,20
1715659692388,MCWP 50R,E00,518795,Carter; Andrea L,0,2,20,20
1715659692388,MCWP 50R,F00,518796,Miller; Elizabeth Deen,0,1,20,20
1715659692388,MCWP 50R,G00,518797,Guillen; Melinda,0,1,20,20
1715659693414,MMW 12R,A01,514034,Herbst; Matthew,0,2,16,16
1715659693414,MMW 12R,A02,514035,Herbst; Matthew,0,0,16,16
1715659694441,MMW 13R,A01,514037,Staff,0,5,16,16
1715659694441,MMW 13R,A02,514039,Staff,0,5,16,16
1715659694441,MMW 13R,A03,628519,Staff,0,4,16,16
1715659696496,SIO 295LS,A00,523233,Staff,10,0,30,20
1715659697524,SIO 295S,A00,523232,Staff,10,0,30,20
1715659698552,SIOC 290S,A01,637330,Merrifield; Mark A,21,0,30,9
1715659699579,SIOC 291S,A01,637333,Gabriel; Corey John,21,0,30,9
1715659700605,SOCI 117,A01,494376,Staff,0,5,5,5
1715659701631,WES 237B,A00,494380,Staff,10,0,20,10
1715659703717,AESE 279B,A00,494370,Wade; Jon P,0,0,33,33
1715659704741,AIP 97,001,660915,Van Den Einde; Yael Dahlia,9998,0,9999,1
1715659705768,AIP 197,001,627712,Vespa; Emanuel Ignacio,9995,0,9999,4
1715659705768,AIP 197,002,650778,Amir; On,9998,0,9999,1
1715659705768,AIP 197,003,650933,Avenancio-Leon; Carlos,9998,0,9999,1
1715659705768,AIP 197,004,658530,Heyman; Gail D.,9998,0,9999,1
1715659705768,AIP 197,005,658631,Neal; Sonya E,9998,0,9999,1
1715659705768,AIP 197,006,658671,Du; Songzi,9998,0,9999,1
1715659706793,ANAR 135S,A00,494369,Braswell; Geoffrey E.,0,0,0,0
1715659707822,BENG 196,001,628496,Engler; Adam J.,9998,0,9999,1
1715659707822,BENG 196,002,660916,Watson; John Thomas,9998,0,9999,1
1715659708846,BISP 197,001,650773,Wilhelm; James E.,9994,0,9999,5
1715659708846,BISP 197,002,658904,Coleman; Aaron B.,9998,0,9999,1
1715659709873,CAT 124RS,A01,519847,Geibel; William,0,0,20,20
1715659710901,CAT 125RS,A01,515971,Geibel; William,0,0,20,20
1715659711929,CLRE 250,A00,511389,Morris; Sheldon,9992,0,9999,7
1715659712955,CLRE 251,A00,507176,Mehta; Ravindra L.,9992,0,9999,7
1715659712955,CLRE 251,B00,511410,Mehta; Ravindra L.,9998,0,9999,1
1715659713980,CLRE 252,A00,507189,Cuomo; Raphael Eduardo,9994,0,9999,5
1715659715008,CLRE 253,A00,507199,Vaida; Florin,9994,0,9999,5
1715659715008,CLRE 253,B00,507202,Vaida; Florin,9999,0,9999,0
1715659716032,CLRE 259,A00,507211,Patel; Hemal,9996,0,9999,3
1715659717059,CLRE 260,A00,507221,Cuomo; Raphael Eduardo,9999,0,9999,0
1715659718084,CLRE 297,001,507242,Cuomo; Raphael Eduardo,9999,0,9999,0
1715659719113,COGS 197,001,638244,Voytek; Bradley Thomas,9997,0,9999,2
1715659720138,CSE 191,A00,516875,Minnes Kemp; Mor Mia,9991,0,9999,8
1715659721180,CSE 197,001,637388,Minnes Kemp; Mor Mia,9992,0,9999,7
1715659722211,CSS 201S,A01,494383,Mignozzetti; Umberto,35,0,35,0
1715659723244,CSS 202S,A01,494387,Mignozzetti; Umberto,35,0,35,0
1715659724267,DSC 197,001,628532,Eldridge; Justin Matthew,9995,0,9999,4
1715659725297,EAP 100,A00,516065,Staff,9799,0,9999,200
1715659726331,ECE 45,A01,507414,Staff,32,0,60,28
1715659728385,ECE 111,A01,507420,Staff,11,0,50,39
1715659729411,ECE 197,001,548057,Sievenpiper; Daniel F.,9991,0,9999,8
1715659730444,EDS 115,A00,507243,Choi; Bailey Miyeon,6,0,28,22
1715659731474,EDS 117,A01,494379,Staff,0,6,34,35
1715659732500,EDS 125,A00,507246,Hopkins; Megan Beth,7,0,30,23
1715659733525,EDS 128A,A01,507264,Fargason; Sharon Gayle,5,0,26,21
1715659734550,EDS 128B,A01,507293,Pappas; Elizabeth,9,0,30,21
1715659735574,EDS 139,A00,507294,Fargason; Sharon Gayle,9,0,30,21
1715659735574,EDS 139,B00,507313,Pappas; Elizabeth,9,0,30,21
1715659736601,EDS 201,A00,507315,Staff,10,0,30,20
1715659737625,EDS 203,A01,507317,Halter; Christopher P.,10,0,30,20
1715659738649,EDS 204R,A01,507319,Halter; Christopher P.,0,3,30,30
1715659738649,EDS 204R,B01,507331,Heinzman; Erica M.,14,0,30,16
1715659739673,EDS 206R,A00,507332,Staff,0,4,30,30
1715659739673,EDS 206R,B00,507343,Staff,15,0,30,15
1715659740700,EDS 250,A00,507344,Hemans; Patricia Ann Benitez,20,0,40,20
1715659741726,EDS 281,A00,507345,Daly; Alan J.,18,0,18,0
1715659742750,EDS 284,A00,507350,Daly; Alan J.,16,0,16,0
1715659743775,EDS 286,A00,507359,Fine; Sarah,18,0,18,0
1715659744803,EDS 289C,A01,507361,Daly; Alan J.,18,0,18,0
1715659745833,EDS 290,A00,507366,Hofstetter; Carolyn,15,0,15,0
1715659746860,LIGM 5A,A00,507421,Fischer-Grunski; Eva K,17,0,20,3
1715659747884,LIGM 5B,A00,507423,Fischer-Grunski; Eva K,19,0,20,1
1715659748910,LIGM 5C,A00,507425,Fischer-Grunski; Eva K,19,0,20,1
1715659749939,LIIT 5AS,A00,507427,Carnelos; Chiara,20,0,20,0
1715659750966,LIIT 5BS,A00,507430,Carnelos; Chiara,20,0,20,0
1715659751996,LIIT 5CS,A00,507432,Carnelos; Chiara,20,0,20,0
1715659753022,LISP 5A,A00,507541,Munoz Sanchez; Alicia,11,0,20,9
1715659754046,LISP 5B,A00,507671,Munoz Sanchez; Alicia,8,0,20,12
1715659755075,LISP 5C,A00,507696,Munoz Sanchez; Alicia,7,0,20,13
1715659756103,MAE 197,001,528363,Boechler; Nicholas Sebastia,9998,0,9999,1
1715659757135,MATH 197,001,523477,Kedlaya; Kiran S.,9994,0,9999,5
1715659757135,MATH 197,002,563811,Zhang; Danna,9994,0,9999,5
1715659757135,MATH 197,003,628552,Dumitriu; Ioana,9998,0,9999,1
1715659757135,MATH 197,004,660885,Floyd; Eric,9998,0,9999,1
1715659758165,MCWP 40R,A00,518780,Staff,1,0,20,19
1715659758165,MCWP 40R,B00,518781,Carter; Jennifer A,9,0,20,11
1715659758165,MCWP 40R,C00,518783,Smith; Haydee Marie,5,0,20,15
1715659759193,MCWP 50R,A00,518791,Redela; Pamela Morgan,0,1,20,20
1715659759193,MCWP 50R,B00,518792,Krone; Jarret,0,2,20,20
1715659759193,MCWP 50R,C00,518793,Staff,0,4,20,20
1715659759193,MCWP 50R,D00,518794,Morshed; Michael James,0,2,20,20
1715659759193,MCWP 50R,E00,518795,Carter; Andrea L,0,2,20,20
1715659759193,MCWP 50R,F00,518796,Miller; Elizabeth Deen,0,1,20,20
1715659759193,MCWP 50R,G00,518797,Guillen; Melinda,0,1,20,20
1715659760220,MMW 12R,A01,514034,Herbst; Matthew,0,2,16,16
1715659760220,MMW 12R,A02,514035,Herbst; Matthew,0,0,16,16
1715659761250,MMW 13R,A01,514037,Staff,0,5,16,16
1715659761250,MMW 13R,A02,514039,Staff,0,5,16,16
1715659761250,MMW 13R,A03,628519,Staff,0,4,16,16
1715659763304,SIO 295LS,A00,523233,Staff,10,0,30,20
1715659764329,SIO 295S,A00,523232,Staff,10,0,30,20
1715659765355,SIOC 290S,A01,637330,Merrifield; Mark A,21,0,30,9
1715659766379,SIOC 291S,A01,637333,Gabriel; Corey John,21,0,30,9
1715659767405,SOCI 117,A01,494376,Staff,0,5,5,5
1715659768430,WES 237B,A00,494380,Staff,10,0,20,10
1715659770503,AESE 279B,A00,494370,Wade; Jon P,0,0,33,33
1715659771527,AIP 97,001,660915,Van Den Einde; Yael Dahlia,9998,0,9999,1
1715659772556,AIP 197,001,627712,Vespa; Emanuel Ignacio,9995,0,9999,4
1715659772556,AIP 197,002,650778,Amir; On,9998,0,9999,1
1715659772556,AIP 197,003,650933,Avenancio-Leon; Carlos,9998,0,9999,1
1715659772556,AIP 197,004,658530,Heyman; Gail D.,9998,0,9999,1
1715659772556,AIP 197,005,658631,Neal; Sonya E,9998,0,9999,1
1715659772556,AIP 197,006,658671,Du; Songzi,9998,0,9999,1
1715659773582,ANAR 135S,A00,494369,Braswell; Geoffrey E.,0,0,0,0
1715659774608,BENG 196,001,628496,Engler; Adam J.,9998,0,9999,1
1715659774608,BENG 196,002,660916,Watson; John Thomas,9998,0,9999,1
1715659775633,BISP 197,001,650773,Wilhelm; James E.,9994,0,9999,5
1715659775633,BISP 197,002,658904,Coleman; Aaron B.,9998,0,9999,1
1715659776660,CAT 124RS,A01,519847,Geibel; William,0,0,20,20
1715659777687,CAT 125RS,A01,515971,Geibel; William,0,0,20,20
1715659778715,CLRE 250,A00,511389,Morris; Sheldon,9992,0,9999,7
1715659779742,CLRE 251,A00,507176,Mehta; Ravindra L.,9992,0,9999,7
1715659779742,CLRE 251,B00,511410,Mehta; Ravindra L.,9998,0,9999,1
1715659780771,CLRE 252,A00,507189,Cuomo; Raphael Eduardo,9994,0,9999,5
1715659781801,CLRE 253,A00,507199,Vaida; Florin,9994,0,9999,5
1715659781801,CLRE 253,B00,507202,Vaida; Florin,9999,0,9999,0
1715659782825,CLRE 259,A00,507211,Patel; Hemal,9996,0,9999,3
1715659783854,CLRE 260,A00,507221,Cuomo; Raphael Eduardo,9999,0,9999,0
1715659784879,CLRE 297,001,507242,Cuomo; Raphael Eduardo,9999,0,9999,0
1715659785905,COGS 197,001,638244,Voytek; Bradley Thomas,9997,0,9999,2
1715659786931,CSE 191,A00,516875,Minnes Kemp; Mor Mia,9991,0,9999,8
1715659787956,CSE 197,001,637388,Minnes Kemp; Mor Mia,9992,0,9999,7
1715659788987,CSS 201S,A01,494383,Mignozzetti; Umberto,35,0,35,0
1715659790014,CSS 202S,A01,494387,Mignozzetti; Umberto,35,0,35,0
1715659791038,DSC 197,001,628532,Eldridge; Justin Matthew,9995,0,9999,4
1715659792063,EAP 100,A00,516065,Staff,9799,0,9999,200
1715659793094,ECE 45,A01,507414,Staff,32,0,60,28
1715659795146,ECE 111,A01,507420,Staff,11,0,50,39
1715659796174,ECE 197,001,548057,Sievenpiper; Daniel F.,9991,0,9999,8
1715659797200,EDS 115,A00,507243,Choi; Bailey Miyeon,6,0,28,22
1715659798227,EDS 117,A01,494379,Staff,0,6,34,35
1715659799280,EDS 125,A00,507246,Hopkins; Megan Beth,7,0,30,23
1715659800305,EDS 128A,A01,507264,Fargason; Sharon Gayle,5,0,26,21
1715659801331,EDS 128B,A01,507293,Pappas; Elizabeth,9,0,30,21
1715659802357,EDS 139,A00,507294,Fargason; Sharon Gayle,9,0,30,21
1715659802357,EDS 139,B00,507313,Pappas; Elizabeth,9,0,30,21
1715659803383,EDS 201,A00,507315,Staff,10,0,30,20
1715659804409,EDS 203,A01,507317,Halter; Christopher P.,10,0,30,20
1715659805434,EDS 204R,A01,507319,Halter; Christopher P.,0,3,30,30
1715659805434,EDS 204R,B01,507331,Heinzman; Erica M.,14,0,30,16
1715659806458,EDS 206R,A00,507332,Staff,0,4,30,30
1715659806458,EDS 206R,B00,507343,Staff,15,0,30,15
1715659807487,EDS 250,A00,507344,Hemans; Patricia Ann Benitez,20,0,40,20
1715659808514,EDS 281,A00,507345,Daly; Alan J.,18,0,18,0
1715659809539,EDS 284,A00,507350,Daly; Alan J.,16,0,16,0
1715659810565,EDS 286,A00,507359,Fine; Sarah,18,0,18,0
1715659811593,EDS 289C,A01,507361,Daly; Alan J.,18,0,18,0
1715659812617,EDS 290,A00,507366,Hofstetter; Carolyn,15,0,15,0
1715659813644,LIGM 5A,A00,507421,Fischer-Grunski; Eva K,17,0,20,3
1715659814674,LIGM 5B,A00,507423,Fischer-Grunski; Eva K,19,0,20,1
1715659815702,LIGM 5C,A00,507425,Fischer-Grunski; Eva K,19,0,20,1
1715659816729,LIIT 5AS,A00,507427,Carnelos; Chiara,20,0,20,0
1715659817758,LIIT 5BS,A00,507430,Carnelos; Chiara,20,0,20,0
1715659818784,LIIT 5CS,A00,507432,Carnelos; Chiara,20,0,20,0
1715659819808,LISP 5A,A00,507541,Munoz Sanchez; Alicia,11,0,20,9
1715659820839,LISP 5B,A00,507671,Munoz Sanchez; Alicia,8,0,20,12
1715659821865,LISP 5C,A00,507696,Munoz Sanchez; Alicia,7,0,20,13
1715659822889,MAE 197,001,528363,Boechler; Nicholas Sebastia,9998,0,9999,1
1715659823916,MATH 197,001,523477,Kedlaya; Kiran S.,9994,0,9999,5
1715659823916,MATH 197,002,563811,Zhang; Danna,9994,0,9999,5
1715659823916,MATH 197,003,628552,Dumitriu; Ioana,9998,0,9999,1
1715659823916,MATH 197,004,660885,Floyd; Eric,9998,0,9999,1
1715659824946,MCWP 40R,A00,518780,Staff,1,0,20,19
1715659824946,MCWP 40R,B00,518781,Carter; Jennifer A,9,0,20,11
1715659824946,MCWP 40R,C00,518783,Smith; Haydee Marie,5,0,20,15
1715659825974,MCWP 50R,A00,518791,Redela; Pamela Morgan,0,1,20,20
1715659825974,MCWP 50R,B00,518792,Krone; Jarret,0,2,20,20
1715659825974,MCWP 50R,C00,518793,Staff,0,4,20,20
1715659825974,MCWP 50R,D00,518794,Morshed; Michael James,0,2,20,20
1715659825974,MCWP 50R,E00,518795,Carter; Andrea L,0,2,20,20
1715659825974,MCWP 50R,F00,518796,Miller; Elizabeth Deen,0,1,20,20
1715659825974,MCWP 50R,G00,518797,Guillen; Melinda,0,1,20,20
1715659826999,MMW 12R,A01,514034,Herbst; Matthew,0,2,16,16
1715659826999,MMW 12R,A02,514035,Herbst; Matthew,0,0,16,16
1715659828027,MMW 13R,A01,514037,Staff,0,5,16,16
1715659828027,MMW 13R,A02,514039,Staff,0,5,16,16
1715659828027,MMW 13R,A03,628519,Staff,0,4,16,16
1715659830078,SIO 295LS,A00,523233,Staff,10,0,30,20
1715659831106,SIO 295S,A00,523232,Staff,10,0,30,20
1715659832133,SIOC 290S,A01,637330,Merrifield; Mark A,21,0,30,9
1715659833162,SIOC 291S,A01,637333,Gabriel; Corey John,21,0,30,9
1715659834187,SOCI 117,A01,494376,Staff,0,5,5,5
1715659835213,WES 237B,A00,494380,Staff,10,0,20,10
1715659837280,AESE 279B,A00,494370,Wade; Jon P,0,0,33,33
1715659838308,AIP 97,001,660915,Van Den Einde; Yael Dahlia,9998,0,9999,1
1715659839341,AIP 197,001,627712,Vespa; Emanuel Ignacio,9995,0,9999,4
1715659839341,AIP 197,002,650778,Amir; On,9998,0,9999,1
1715659839341,AIP 197,003,650933,Avenancio-Leon; Carlos,9998,0,9999,1
1715659839341,AIP 197,004,658530,Heyman; Gail D.,9998,0,9999,1
1715659839341,AIP 197,005,658631,Neal; Sonya E,9998,0,9999,1
1715659839341,AIP 197,006,658671,Du; Songzi,9998,0,9999,1
1715659840369,ANAR 135S,A00,494369,Braswell; Geoffrey E.,0,0,0,0
1715659841395,BENG 196,001,628496,Engler; Adam J.,9998,0,9999,1
1715659841395,BENG 196,002,660916,Watson; John Thomas,9998,0,9999,1
1715659842421,BISP 197,001,650773,Wilhelm; James E.,9994,0,9999,5
1715659842421,BISP 197,002,658904,Coleman; Aaron B.,9998,0,9999,1
1715659843446,CAT 124RS,A01,519847,Geibel; William,0,0,20,20
1715659844475,CAT 125RS,A01,515971,Geibel; William,0,0,20,20
1715659845499,CLRE 250,A00,511389,Morris; Sheldon,9992,0,9999,7
1715659846526,CLRE 251,A00,507176,Mehta; Ravindra L.,9992,0,9999,7
1715659846526,CLRE 251,B00,511410,Mehta; Ravindra L.,9998,0,9999,1
1715659847555,CLRE 252,A00,507189,Cuomo; Raphael Eduardo,9994,0,9999,5
1715659848599,CLRE 253,A00,507199,Vaida; Florin,9994,0,9999,5
1715659848599,CLRE 253,B00,507202,Vaida; Florin,9999,0,9999,0
1715659849627,CLRE 259,A00,507211,Patel; Hemal,9996,0,9999,3
1715659850650,CLRE 260,A00,507221,Cuomo; Raphael Eduardo,9999,0,9999,0
1715659851678,CLRE 297,001,507242,Cuomo; Raphael Eduardo,9999,0,9999,0
1715659852706,COGS 197,001,638244,Voytek; Bradley Thomas,9997,0,9999,2
1715659853730,CSE 191,A00,516875,Minnes Kemp; Mor Mia,9991,0,9999,8
1715659854754,CSE 197,001,637388,Minnes Kemp; Mor Mia,9992,0,9999,7
1715659855781,CSS 201S,A01,494383,Mignozzetti; Umberto,35,0,35,0
1715659856811,CSS 202S,A01,494387,Mignozzetti; Umberto,35,0,35,0
1715659857843,DSC 197,001,628532,Eldridge; Justin Matthew,9995,0,9999,4
1715659858868,EAP 100,A00,516065,Staff,9799,0,9999,200
1715659859898,ECE 45,A01,507414,Staff,32,0,60,28
1715659861953,ECE 111,A01,507420,Staff,11,0,50,39
1715659862978,ECE 197,001,548057,Sievenpiper; Daniel F.,9991,0,9999,8
1715659864007,EDS 115,A00,507243,Choi; Bailey Miyeon,6,0,28,22
1715659865033,EDS 117,A01,494379,Staff,0,6,34,35
1715659866059,EDS 125,A00,507246,Hopkins; Megan Beth,7,0,30,23
1715659867084,EDS 128A,A01,507264,Fargason; Sharon Gayle,5,0,26,21
1715659868111,EDS 128B,A01,507293,Pappas; Elizabeth,9,0,30,21
1715659869137,EDS 139,A00,507294,Fargason; Sharon Gayle,9,0,30,21
1715659869137,EDS 139,B00,507313,Pappas; Elizabeth,9,0,30,21
1715659870161,EDS 201,A00,507315,Staff,10,0,30,20
1715659871205,EDS 203,A01,507317,Halter; Christopher P.,10,0,30,20
1715659872229,EDS 204R,A01,507319,Halter; Christopher P.,0,3,30,30
1715659872229,EDS 204R,B01,507331,Heinzman; Erica M.,14,0,30,16
1715659873254,EDS 206R,A00,507332,Staff,0,4,30,30
1715659873254,EDS 206R,B00,507343,Staff,15,0,30,15
1715659874280,EDS 250,A00,507344,Hemans; Patricia Ann Benitez,20,0,40,20
1715659875305,EDS 281,A00,507345,Daly; Alan J.,18,0,18,0
1715659876332,EDS 284,A00,507350,Daly; Alan J.,16,0,16,0
1715659877358,EDS 286,A00,507359,Fine; Sarah,18,0,18,0
1715659878384,EDS 289C,A01,507361,Daly; Alan J.,18,0,18,0
1715659879409,EDS 290,A00,507366,Hofstetter; Carolyn,15,0,15,0
1715659880436,LIGM 5A,A00,507421,Fischer-Grunski; Eva K,17,0,20,3
1715659881464,LIGM 5B,A00,507423,Fischer-Grunski; Eva K,19,0,20,1
1715659882493,LIGM 5C,A00,507425,Fischer-Grunski; Eva K,19,0,20,1
1715659883517,LIIT 5AS,A00,507427,Carnelos; Chiara,20,0,20,0
1715659884543,LIIT 5BS,A00,507430,Carnelos; Chiara,20,0,20,0
1715659885572,LIIT 5CS,A00,507432,Carnelos; Chiara,20,0,20,0
1715659886599,LISP 5A,A00,507541,Munoz Sanchez; Alicia,11,0,20,9
1715659887624,LISP 5B,A00,507671,Munoz Sanchez; Alicia,8,0,20,12
1715659888653,LISP 5C,A00,507696,Munoz Sanchez; Alicia,7,0,20,13
1715659889681,MAE 197,001,528363,Boechler; Nicholas Sebastia,9998,0,9999,1
1715659890709,MATH 197,001,523477,Kedlaya; Kiran S.,9994,0,9999,5
1715659890709,MATH 197,002,563811,Zhang; Danna,9994,0,9999,5
1715659890709,MATH 197,003,628552,Dumitriu; Ioana,9998,0,9999,1
1715659890709,MATH 197,004,660885,Floyd; Eric,9998,0,9999,1
1715659891743,MCWP 40R,A00,518780,Staff,1,0,20,19
1715659891743,MCWP 40R,B00,518781,Carter; Jennifer A,9,0,20,11
1715659891743,MCWP 40R,C00,518783,Smith; Haydee Marie,5,0,20,15
1715659892777,MCWP 50R,A00,518791,Redela; Pamela Morgan,0,1,20,20
1715659892777,MCWP 50R,B00,518792,Krone; Jarret,0,2,20,20
1715659892777,MCWP 50R,C00,518793,Staff,0,4,20,20
1715659892777,MCWP 50R,D00,518794,Morshed; Michael James,0,2,20,20
1715659892777,MCWP 50R,E00,518795,Carter; Andrea L,0,2,20,20
1715659892777,MCWP 50R,F00,518796,Miller; Elizabeth Deen,0,1,20,20
1715659892777,MCWP 50R,G00,518797,Guillen; Melinda,0,1,20,20
1715659893805,MMW 12R,A01,514034,Herbst; Matthew,0,2,16,16
1715659893805,MMW 12R,A02,514035,Herbst; Matthew,0,0,16,16
1715659894833,MMW 13R,A01,514037,Staff,0,5,16,16
1715659894833,MMW 13R,A02,514039,Staff,0,5,16,16
1715659894833,MMW 13R,A03,628519,Staff,0,4,16,16
1715659896888,SIO 295LS,A00,523233,Staff,10,0,30,20
1715659897914,SIO 295S,A00,523232,Staff,10,0,30,20
1715659898999,SIOC 290S,A01,637330,Merrifield; Mark A,21,0,30,9
1715659900028,SIOC 291S,A01,637333,Gabriel; Corey John,21,0,30,9
1715659901052,SOCI 117,A01,494376,Staff,0,5,5,5
1715659902080,WES 237B,A00,494380,Staff,10,0,20,10
1715659904153,AESE 279B,A00,494370,Wade; Jon P,0,0,33,33
1715659905179,AIP 97,001,660915,Van Den Einde; Yael Dahlia,9998,0,9999,1
1715659906207,AIP 197,001,627712,Vespa; Emanuel Ignacio,9995,0,9999,4
1715659906207,AIP 197,002,650778,Amir; On,9998,0,9999,1
1715659906207,AIP 197,003,650933,Avenancio-Leon; Carlos,9998,0,9999,1
1715659906207,AIP 197,004,658530,Heyman; Gail D.,9998,0,9999,1
1715659906207,AIP 197,005,658631,Neal; Sonya E,9998,0,9999,1
1715659906207,AIP 197,006,658671,Du; Songzi,9998,0,9999,1
1715659907235,ANAR 135S,A00,494369,Braswell; Geoffrey E.,0,0,0,0
1715659908262,BENG 196,001,628496,Engler; Adam J.,9998,0,9999,1
1715659908262,BENG 196,002,660916,Watson; John Thomas,9998,0,9999,1
1715659909290,BISP 197,001,650773,Wilhelm; James E.,9994,0,9999,5
1715659909290,BISP 197,002,658904,Coleman; Aaron B.,9998,0,9999,1
1715659910317,CAT 124RS,A01,519847,Geibel; William,0,0,20,20
1715659911343,CAT 125RS,A01,515971,Geibel; William,0,0,20,20
1715659912372,CLRE 250,A00,511389,Morris; Sheldon,9992,0,9999,7
1715659913402,CLRE 251,A00,507176,Mehta; Ravindra L.,9992,0,9999,7
1715659913402,CLRE 251,B00,511410,Mehta; Ravindra L.,9998,0,9999,1
1715659914432,CLRE 252,A00,507189,Cuomo; Raphael Eduardo,9994,0,9999,5
1715659915457,CLRE 253,A00,507199,Vaida; Florin,9994,0,9999,5
1715659915457,CLRE 253,B00,507202,Vaida; Florin,9999,0,9999,0
1715659916482,CLRE 259,A00,507211,Patel; Hemal,9996,0,9999,3
1715659917507,CLRE 260,A00,507221,Cuomo; Raphael Eduardo,9999,0,9999,0
1715659918531,CLRE 297,001,507242,Cuomo; Raphael Eduardo,9999,0,9999,0
1715659919560,COGS 197,001,638244,Voytek; Bradley Thomas,9997,0,9999,2
1715659920589,CSE 191,A00,516875,Minnes Kemp; Mor Mia,9991,0,9999,8
1715659921614,CSE 197,001,637388,Minnes Kemp; Mor Mia,9992,0,9999,7
1715659922642,CSS 201S,A01,494383,Mignozzetti; Umberto,35,0,35,0
1715659923666,CSS 202S,A01,494387,Mignozzetti; Umberto,35,0,35,0
1715659924696,DSC 197,001,628532,Eldridge; Justin Matthew,9995,0,9999,4
1715659925721,EAP 100,A00,516065,Staff,9799,0,9999,200
1715659926753,ECE 45,A01,507414,Staff,32,0,60,28
1715659928807,ECE 111,A01,507420,Staff,11,0,50,39
1715659929831,ECE 197,001,548057,Sievenpiper; Daniel F.,9991,0,9999,8
1715659930861,EDS 115,A00,507243,Choi; Bailey Miyeon,6,0,28,22
1715659931888,EDS 117,A01,494379,Staff,0,6,34,35
1715659932918,EDS 125,A00,507246,Hopkins; Megan Beth,7,0,30,23
1715659933946,EDS 128A,A01,507264,Fargason; Sharon Gayle,5,0,26,21
1715659934973,EDS 128B,A01,507293,Pappas; Elizabeth,9,0,30,21
1715659935997,EDS 139,A00,507294,Fargason; Sharon Gayle,9,0,30,21
1715659935997,EDS 139,B00,507313,Pappas; Elizabeth,9,0,30,21
1715659937020,EDS 201,A00,507315,Staff,10,0,30,20
1715659938047,EDS 203,A01,507317,Halter; Christopher P.,10,0,30,20
1715659939073,EDS 204R,A01,507319,Halter; Christopher P.,0,3,30,30
1715659939073,EDS 204R,B01,507331,Heinzman; Erica M.,14,0,30,16
1715659940100,EDS 206R,A00,507332,Staff,0,4,30,30
1715659940100,EDS 206R,B00,507343,Staff,15,0,30,15
1715659941128,EDS 250,A00,507344,Hemans; Patricia Ann Benitez,20,0,40,20
1715659942153,EDS 281,A00,507345,Daly; Alan J.,18,0,18,0
1715659943178,EDS 284,A00,507350,Daly; Alan J.,16,0,16,0
1715659944203,EDS 286,A00,507359,Fine; Sarah,18,0,18,0
1715659945234,EDS 289C,A01,507361,Daly; Alan J.,18,0,18,0
1715659946260,EDS 290,A00,507366,Hofstetter; Carolyn,15,0,15,0
1715659947290,LIGM 5A,A00,507421,Fischer-Grunski; Eva K,17,0,20,3
1715659948314,LIGM 5B,A00,507423,Fischer-Grunski; Eva K,19,0,20,1
1715659949344,LIGM 5C,A00,507425,Fischer-Grunski; Eva K,19,0,20,1
1715659950369,LIIT 5AS,A00,507427,Carnelos; Chiara,20,0,20,0
1715659951394,LIIT 5BS,A00,507430,Carnelos; Chiara,20,0,20,0
1715659952418,LIIT 5CS,A00,507432,Carnelos; Chiara,20,0,20,0
1715659953448,LISP 5A,A00,507541,Munoz Sanchez; Alicia,11,0,20,9
1715659954480,LISP 5B,A00,507671,Munoz Sanchez; Alicia,8,0,20,12
1715659955508,LISP 5C,A00,507696,Munoz Sanchez; Alicia,7,0,20,13
1715659956537,MAE 197,001,528363,Boechler; Nicholas Sebastia,9998,0,9999,1
1715659957563,MATH 197,001,523477,Kedlaya; Kiran S.,9994,0,9999,5
1715659957563,MATH 197,002,563811,Zhang; Danna,9994,0,9999,5
1715659957563,MATH 197,003,628552,Dumitriu; Ioana,9998,0,9999,1
1715659957563,MATH 197,004,660885,Floyd; Eric,9998,0,9999,1
1715659958590,MCWP 40R,A00,518780,Staff,1,0,20,19
1715659958590,MCWP 40R,B00,518781,Carter; Jennifer A,9,0,20,11
1715659958590,MCWP 40R,C00,518783,Smith; Haydee Marie,5,0,20,15
1715659959618,MCWP 50R,A00,518791,Redela; Pamela Morgan,0,1,20,20
1715659959618,MCWP 50R,B00,518792,Krone; Jarret,0,2,20,20
1715659959618,MCWP 50R,C00,518793,Staff,0,4,20,20
1715659959618,MCWP 50R,D00,518794,Morshed; Michael James,0,2,20,20
1715659959618,MCWP 50R,E00,518795,Carter; Andrea L,0,2,20,20
1715659959618,MCWP 50R,F00,518796,Miller; Elizabeth Deen,0,1,20,20
1715659959618,MCWP 50R,G00,518797,Guillen; Melinda,0,1,20,20
1715659960644,MMW 12R,A01,514034,Herbst; Matthew,0,2,16,16
1715659960644,MMW 12R,A02,514035,Herbst; Matthew,0,0,16,16
1715659961672,MMW 13R,A01,514037,Staff,0,5,16,16
1715659961672,MMW 13R,A02,514039,Staff,0,5,16,16
1715659961672,MMW 13R,A03,628519,Staff,0,4,16,16
1715659963726,SIO 295LS,A00,523233,Staff,10,0,30,20
1715659964749,SIO 295S,A00,523232,Staff,10,0,30,20
1715659965775,SIOC 290S,A01,637330,Merrifield; Mark A,21,0,30,9
1715659966804,SIOC 291S,A01,637333,Gabriel; Corey John,21,0,30,9
1715659967833,SOCI 117,A01,494376,Staff,0,5,5,5
1715659968858,WES 237B,A00,494380,Staff,10,0,20,10
1715659970933,AESE 279B,A00,494370,Wade; Jon P,0,0,33,33
1715659971964,AIP 97,001,660915,Van Den Einde; Yael Dahlia,9998,0,9999,1
1715659972998,AIP 197,001,627712,Vespa; Emanuel Ignacio,9995,0,9999,4
1715659972998,AIP 197,002,650778,Amir; On,9998,0,9999,1
1715659972998,AIP 197,003,650933,Avenancio-Leon; Carlos,9998,0,9999,1
1715659972998,AIP 197,004,658530,Heyman; Gail D.,9998,0,9999,1
1715659972998,AIP 197,005,658631,Neal; Sonya E,9998,0,9999,1
1715659972998,AIP 197,006,658671,Du; Songzi,9998,0,9999,1
1715659974024,ANAR 135S,A00,494369,Braswell; Geoffrey E.,0,0,0,0
1715659975051,BENG 196,001,628496,Engler; Adam J.,9998,0,9999,1
1715659975051,BENG 196,002,660916,Watson; John Thomas,9998,0,9999,1
1715659976081,BISP 197,001,650773,Wilhelm; James E.,9994,0,9999,5
1715659976081,BISP 197,002,658904,Coleman; Aaron B.,9998,0,9999,1
1715659977107,CAT 124RS,A01,519847,Geibel; William,0,0,20,20
1715659978138,CAT 125RS,A01,515971,Geibel; William,0,0,20,20
1715659979165,CLRE 250,A00,511389,Morris; Sheldon,9992,0,9999,7
1715659980192,CLRE 251,A00,507176,Mehta; Ravindra L.,9992,0,9999,7
1715659980192,CLRE 251,B00,511410,Mehta; Ravindra L.,9998,0,9999,1
1715659981224,CLRE 252,A00,507189,Cuomo; Raphael Eduardo,9994,0,9999,5
1715659982252,CLRE 253,A00,507199,Vaida; Florin,9994,0,9999,5
1715659982252,CLRE 253,B00,507202,Vaida; Florin,9999,0,9999,0
1715659983278,CLRE 259,A00,507211,Patel; Hemal,9996,0,9999,3
1715659984311,CLRE 260,A00,507221,Cuomo; Raphael Eduardo,9999,0,9999,0
1715659985340,CLRE 297,001,507242,Cuomo; Raphael Eduardo,9999,0,9999,0
1715659986368,COGS 197,001,638244,Voytek; Bradley Thomas,9997,0,9999,2
1715659987396,CSE 191,A00,516875,Minnes Kemp; Mor Mia,9991,0,9999,8
1715659988424,CSE 197,001,637388,Minnes Kemp; Mor Mia,9992,0,9999,7
1715659989634,CSS 201S,A01,494383,Mignozzetti; Umberto,35,0,35,0
1715659990662,CSS 202S,A01,494387,Mignozzetti; Umberto,35,0,35,0
1715659991690,DSC 197,001,628532,Eldridge; Justin Matthew,9995,0,9999,4
1715659992718,EAP 100,A00,516065,Staff,9799,0,9999,200
1715659993744,ECE 45,A01,507414,Staff,32,0,60,28
1715659995795,ECE 111,A01,507420,Staff,11,0,50,39
1715659996824,ECE 197,001,548057,Sievenpiper; Daniel F.,9991,0,9999,8
1715659997850,EDS 115,A00,507243,Choi; Bailey Miyeon,6,0,28,22
1715659998878,EDS 117,A01,494379,Staff,0,6,34,35
1715659999904,EDS 125,A00,507246,Hopkins; Megan Beth,7,0,30,23
1715660000934,EDS 128A,A01,507264,Fargason; Sharon Gayle,5,0,26,21
1715660001963,EDS 128B,A01,507293,Pappas; Elizabeth,9,0,30,21
1715660003046,EDS 139,A00,507294,Fargason; Sharon Gayle,9,0,30,21
1715660003046,EDS 139,B00,507313,Pappas; Elizabeth,9,0,30,21
1715660004071,EDS 201,A00,507315,Staff,10,0,30,20
1715660005203,EDS 203,A01,507317,Halter; Christopher P.,10,0,30,20
1715660006233,EDS 204R,A01,507319,Halter; Christopher P.,0,3,30,30
1715660006233,EDS 204R,B01,507331,Heinzman; Erica M.,14,0,30,16
1715660007264,EDS 206R,A00,507332,Staff,0,4,30,30
1715660007264,EDS 206R,B00,507343,Staff,15,0,30,15
1715660008294,EDS 250,A00,507344,Hemans; Patricia Ann Benitez,20,0,40,20
1715660009329,EDS 281,A00,507345,Daly; Alan J.,18,0,18,0
1715660010355,EDS 284,A00,507350,Daly; Alan J.,16,0,16,0
1715660011385,EDS 286,A00,507359,Fine; Sarah,18,0,18,0
1715660012412,EDS 289C,A01,507361,Daly; Alan J.,18,0,18,0
1715660013442,EDS 290,A00,507366,Hofstetter; Carolyn,15,0,15,0
1715660014473,LIGM 5A,A00,507421,Fischer-Grunski; Eva K,17,0,20,3
1715660015499,LIGM 5B,A00,507423,Fischer-Grunski; Eva K,19,0,20,1
1715660016528,LIGM 5C,A00,507425,Fischer-Grunski; Eva K,19,0,20,1
1715660017554,LIIT 5AS,A00,507427,Carnelos; Chiara,20,0,20,0
1715660018584,LIIT 5BS,A00,507430,Carnelos; Chiara,20,0,20,0
1715660019610,LIIT 5CS,A00,507432,Carnelos; Chiara,20,0,20,0
1715660020701,LISP 5A,A00,507541,Munoz Sanchez; Alicia,11,0,20,9
1715660021727,LISP 5B,A00,507671,Munoz Sanchez; Alicia,8,0,20,12
1715660022756,LISP 5C,A00,507696,Munoz Sanchez; Alicia,7,0,20,13
1715660023781,MAE 197,001,528363,Boechler; Nicholas Sebastia,9998,0,9999,1
1715660024813,MATH 197,001,523477,Kedlaya; Kiran S.,9994,0,9999,5
1715660024813,MATH 197,002,563811,Zhang; Danna,9994,0,9999,5
1715660024813,MATH 197,003,628552,Dumitriu; Ioana,9998,0,9999,1
1715660024813,MATH 197,004,660885,Floyd; Eric,9998,0,9999,1
1715660025841,MCWP 40R,A00,518780,Staff,1,0,20,19
1715660025841,MCWP 40R,B00,518781,Carter; Jennifer A,9,0,20,11
1715660025841,MCWP 40R,C00,518783,Smith; Haydee Marie,5,0,20,15
1715660026870,MCWP 50R,A00,518791,Redela; Pamela Morgan,0,1,20,20
1715660026870,MCWP 50R,B00,518792,Krone; Jarret,0,2,20,20
1715660026870,MCWP 50R,C00,518793,Staff,0,4,20,20
1715660026870,MCWP 50R,D00,518794,Morshed; Michael James,0,2,20,20
1715660026870,MCWP 50R,E00,518795,Carter; Andrea L,0,2,20,20
1715660026870,MCWP 50R,F00,518796,Miller; Elizabeth Deen,0,1,20,20
1715660026870,MCWP 50R,G00,518797,Guillen; Melinda,0,1,20,20
1715660027900,MMW 12R,A01,514034,Herbst; Matthew,0,2,16,16
1715660027900,MMW 12R,A02,514035,Herbst; Matthew,0,0,16,16
1715660028926,MMW 13R,A01,514037,Staff,0,5,16,16
1715660028926,MMW 13R,A02,514039,Staff,0,5,16,16
1715660028926,MMW 13R,A03,628519,Staff,0,4,16,16
1715660030982,SIO 295LS,A00,523233,Staff,10,0,30,20
1715660032006,SIO 295S,A00,523232,Staff,10,0,30,20
1715660033040,SIOC 290S,A01,637330,Merrifield; Mark A,21,0,30,9
1715660034072,SIOC 291S,A01,637333,Gabriel; Corey John,21,0,30,9
1715660035099,SOCI 117,A01,494376,Staff,0,5,5,5
1715660036128,WES 237B,A00,494380,Staff,10,0,20,10
1715660038195,AESE 279B,A00,494370,Wade; Jon P,0,0,33,33
1715660039227,AIP 97,001,660915,Van Den Einde; Yael Dahlia,9998,0,9999,1
1715660040258,AIP 197,001,627712,Vespa; Emanuel Ignacio,9995,0,9999,4
1715660040258,AIP 197,002,650778,Amir; On,9998,0,9999,1
1715660040258,AIP 197,003,650933,Avenancio-Leon; Carlos,9998,0,9999,1
1715660040258,AIP 197,004,658530,Heyman; Gail D.,9998,0,9999,1
1715660040258,AIP 197,005,658631,Neal; Sonya E,9998,0,9999,1
1715660040258,AIP 197,006,658671,Du; Songzi,9998,0,9999,1
1715660041285,ANAR 135S,A00,494369,Braswell; Geoffrey E.,0,0,0,0
1715660042313,BENG 196,001,628496,Engler; Adam J.,9998,0,9999,1
1715660042313,BENG 196,002,660916,Watson; John Thomas,9998,0,9999,1
1715660043343,BISP 197,001,650773,Wilhelm; James E.,9994,0,9999,5
1715660043343,BISP 197,002,658904,Coleman; Aaron B.,9998,0,9999,1
1715660044372,CAT 124RS,A01,519847,Geibel; William,0,0,20,20
1715660045397,CAT 125RS,A01,515971,Geibel; William,0,0,20,20
1715660046425,CLRE 250,A00,511389,Morris; Sheldon,9992,0,9999,7
1715660047458,CLRE 251,A00,507176,Mehta; Ravindra L.,9992,0,9999,7
1715660047458,CLRE 251,B00,511410,Mehta; Ravindra L.,9998,0,9999,1
1715660048485,CLRE 252,A00,507189,Cuomo; Raphael Eduardo,9994,0,9999,5
1715660049508,CLRE 253,A00,507199,Vaida; Florin,9994,0,9999,5
1715660049508,CLRE 253,B00,507202,Vaida; Florin,9999,0,9999,0
1715660050535,CLRE 259,A00,507211,Patel; Hemal,9996,0,9999,3
1715660051559,CLRE 260,A00,507221,Cuomo; Raphael Eduardo,9999,0,9999,0
1715660052586,CLRE 297,001,507242,Cuomo; Raphael Eduardo,9999,0,9999,0
1715660053615,COGS 197,001,638244,Voytek; Bradley Thomas,9997,0,9999,2
1715660054644,CSE 191,A00,516875,Minnes Kemp; Mor Mia,9991,0,9999,8
1715660055670,CSE 197,001,637388,Minnes Kemp; Mor Mia,9992,0,9999,7
1715660056696,CSS 201S,A01,494383,Mignozzetti; Umberto,35,0,35,0
1715660057722,CSS 202S,A01,494387,Mignozzetti; Umberto,35,0,35,0
1715660058751,DSC 197,001,628532,Eldridge; Justin Matthew,9995,0,9999,4
1715660059779,EAP 100,A00,516065,Staff,9799,0,9999,200
1715660060811,ECE 45,A01,507414,Staff,32,0,60,28
1715660062862,ECE 111,A01,507420,Staff,11,0,50,39
1715660063889,ECE 197,001,548057,Sievenpiper; Daniel F.,9991,0,9999,8
1715660064916,EDS 115,A00,507243,Choi; Bailey Miyeon,6,0,28,22
1715660065943,EDS 117,A01,494379,Staff,0,6,34,35
1715660066972,EDS 125,A00,507246,Hopkins; Megan Beth,7,0,30,23
1715660067998,EDS 128A,A01,507264,Fargason; Sharon Gayle,5,0,26,21
1715660069027,EDS 128B,A01,507293,Pappas; Elizabeth,9,0,30,21
1715660070052,EDS 139,A00,507294,Fargason; Sharon Gayle,9,0,30,21
1715660070052,EDS 139,B00,507313,Pappas; Elizabeth,9,0,30,21
1715660071082,EDS 201,A00,507315,Staff,10,0,30,20
1715660072109,EDS 203,A01,507317,Halter; Christopher P.,10,0,30,20
1715660073138,EDS 204R,A01,507319,Halter; Christopher P.,0,3,30,30
1715660073138,EDS 204R,B01,507331,Heinzman; Erica M.,14,0,30,16
1715660074164,EDS 206R,A00,507332,Staff,0,4,30,30
1715660074164,EDS 206R,B00,507343,Staff,15,0,30,15
1715660075191,EDS 250,A00,507344,Hemans; Patricia Ann Benitez,20,0,40,20
1715660076218,EDS 281,A00,507345,Daly; Alan J.,18,0,18,0
1715660077248,EDS 284,A00,507350,Daly; Alan J.,16,0,16,0
1715660078277,EDS 286,A00,507359,Fine; Sarah,18,0,18,0
1715660079302,EDS 289C,A01,507361,Daly; Alan J.,18,0,18,0
1715660080331,EDS 290,A00,507366,Hofstetter; Carolyn,15,0,15,0
1715660081361,LIGM 5A,A00,507421,Fischer-Grunski; Eva K,17,0,20,3
1715660082386,LIGM 5B,A00,507423,Fischer-Grunski; Eva K,19,0,20,1
1715660083412,LIGM 5C,A00,507425,Fischer-Grunski; Eva K,19,0,20,1
1715660084438,LIIT 5AS,A00,507427,Carnelos; Chiara,20,0,20,0
1715660085468,LIIT 5BS,A00,507430,Carnelos; Chiara,20,0,20,0
1715660086493,LIIT 5CS,A00,507432,Carnelos; Chiara,20,0,20,0
1715660087526,LISP 5A,A00,507541,Munoz Sanchez; Alicia,11,0,20,9
1715660088551,LISP 5B,A00,507671,Munoz Sanchez; Alicia,8,0,20,12
1715660089576,LISP 5C,A00,507696,Munoz Sanchez; Alicia,7,0,20,13
1715660090603,MAE 197,001,528363,Boechler; Nicholas Sebastia,9998,0,9999,1
1715660091637,MATH 197,001,523477,Kedlaya; Kiran S.,9994,0,9999,5
1715660091637,MATH 197,002,563811,Zhang; Danna,9994,0,9999,5
1715660091637,MATH 197,003,628552,Dumitriu; Ioana,9998,0,9999,1
1715660091637,MATH 197,004,660885,Floyd; Eric,9998,0,9999,1
1715660092666,MCWP 40R,A00,518780,Staff,1,0,20,19
1715660092666,MCWP 40R,B00,518781,Carter; Jennifer A,9,0,20,11
1715660092666,MCWP 40R,C00,518783,Smith; Haydee Marie,5,0,20,15
1715660093696,MCWP 50R,A00,518791,Redela; Pamela Morgan,0,1,20,20
1715660093696,MCWP 50R,B00,518792,Krone; Jarret,0,2,20,20
1715660093696,MCWP 50R,C00,518793,Staff,0,4,20,20
1715660093696,MCWP 50R,D00,518794,Morshed; Michael James,0,2,20,20
1715660093696,MCWP 50R,E00,518795,Carter; Andrea L,0,2,20,20
1715660093696,MCWP 50R,F00,518796,Miller; Elizabeth Deen,0,1,20,20
1715660093696,MCWP 50R,G00,518797,Guillen; Melinda,0,1,20,20
1715660094722,MMW 12R,A01,514034,Herbst; Matthew,0,2,16,16
1715660094722,MMW 12R,A02,514035,Herbst; Matthew,0,0,16,16
1715660095750,MMW 13R,A01,514037,Staff,0,5,16,16
1715660095750,MMW 13R,A02,514039,Staff,0,5,16,16
1715660095750,MMW 13R,A03,628519,Staff,0,4,16,16
1715660097801,SIO 295LS,A00,523233,Staff,10,0,30,20
1715660098828,SIO 295S,A00,523232,Staff,10,0,30,20
1715660099857,SIOC 290S,A01,637330,Merrifield; Mark A,21,0,30,9
1715660100888,SIOC 291S,A01,637333,Gabriel; Corey John,21,0,30,9
1715660101913,SOCI 117,A01,494376,Staff,0,5,5,5
1715660102941,WES 237B,A00,494380,Staff,10,0,20,10
1715660105024,AESE 279B,A00,494370,Wade; Jon P,0,0,33,33
1715660106052,AIP 97,001,660915,Van Den Einde; Yael Dahlia,9998,0,9999,1
1715660107160,AIP 197,001,627712,Vespa; Emanuel Ignacio,9995,0,9999,4
1715660107160,AIP 197,002,650778,Amir; On,9998,0,9999,1
1715660107160,AIP 197,003,650933,Avenancio-Leon; Carlos,9998,0,9999,1
1715660107160,AIP 197,004,658530,Heyman; Gail D.,9998,0,9999,1
1715660107160,AIP 197,005,658631,Neal; Sonya E,9998,0,9999,1
1715660107160,AIP 197,006,658671,Du; Songzi,9998,0,9999,1
1715660108185,ANAR 135S,A00,494369,Braswell; Geoffrey E.,0,0,0,0
1715660109211,BENG 196,001,628496,Engler; Adam J.,9998,0,9999,1
1715660109211,BENG 196,002,660916,Watson; John Thomas,9998,0,9999,1
1715660110240,BISP 197,001,650773,Wilhelm; James E.,9994,0,9999,5
1715660110240,BISP 197,002,658904,Coleman; Aaron B.,9998,0,9999,1
1715660111267,CAT 124RS,A01,519847,Geibel; William,0,0,20,20
1715660112294,CAT 125RS,A01,515971,Geibel; William,0,0,20,20
1715660113320,CLRE 250,A00,511389,Morris; Sheldon,9992,0,9999,7
1715660114353,CLRE 251,A00,507176,Mehta; Ravindra L.,9992,0,9999,7
1715660114353,CLRE 251,B00,511410,Mehta; Ravindra L.,9998,0,9999,1
1715660115376,CLRE 252,A00,507189,Cuomo; Raphael Eduardo,9994,0,9999,5
1715660116405,CLRE 253,A00,507199,Vaida; Florin,9994,0,9999,5
1715660116405,CLRE 253,B00,507202,Vaida; Florin,9999,0,9999,0
1715660117433,CLRE 259,A00,507211,Patel; Hemal,9996,0,9999,3
1715660118460,CLRE 260,A00,507221,Cuomo; Raphael Eduardo,9999,0,9999,0
1715660119486,CLRE 297,001,507242,Cuomo; Raphael Eduardo,9999,0,9999,0
1715660120514,COGS 197,001,638244,Voytek; Bradley Thomas,9997,0,9999,2
1715660121543,CSE 191,A00,516875,Minnes Kemp; Mor Mia,9991,0,9999,8
1715660122569,CSE 197,001,637388,Minnes Kemp; Mor Mia,9992,0,9999,7
1715660123595,CSS 201S,A01,494383,Mignozzetti; Umberto,35,0,35,0
1715660124621,CSS 202S,A01,494387,Mignozzetti; Umberto,35,0,35,0
1715660125646,DSC 197,001,628532,Eldridge; Justin Matthew,9995,0,9999,4
1715660126675,EAP 100,A00,516065,Staff,9799,0,9999,200
1715660127702,ECE 45,A01,507414,Staff,32,0,60,28
1715660129760,ECE 111,A01,507420,Staff,11,0,50,39
1715660130792,ECE 197,001,548057,Sievenpiper; Daniel F.,9991,0,9999,8
1715660131818,EDS 115,A00,507243,Choi; Bailey Miyeon,6,0,28,22
1715660132848,EDS 117,A01,494379,Staff,0,6,34,35
1715660133882,EDS 125,A00,507246,Hopkins; Megan Beth,7,0,30,23
1715660134913,EDS 128A,A01,507264,Fargason; Sharon Gayle,5,0,26,21
1715660135938,EDS 128B,A01,507293,Pappas; Elizabeth,9,0,30,21
1715660136965,EDS 139,A00,507294,Fargason; Sharon Gayle,9,0,30,21
1715660136965,EDS 139,B00,507313,Pappas; Elizabeth,9,0,30,21
1715660137991,EDS 201,A00,507315,Staff,10,0,30,20
1715660139022,EDS 203,A01,507317,Halter; Christopher P.,10,0,30,20
1715660140048,EDS 204R,A01,507319,Halter; Christopher P.,0,3,30,30
1715660140048,EDS 204R,B01,507331,Heinzman; Erica M.,14,0,30,16
1715660141077,EDS 206R,A00,507332,Staff,0,4,30,30
1715660141077,EDS 206R,B00,507343,Staff,15,0,30,15
1715660142104,EDS 250,A00,507344,Hemans; Patricia Ann Benitez,20,0,40,20
1715660143130,EDS 281,A00,507345,Daly; Alan J.,18,0,18,0
1715660144158,EDS 284,A00,507350,Daly; Alan J.,16,0,16,0
1715660145188,EDS 286,A00,507359,Fine; Sarah,18,0,18,0
1715660146216,EDS 289C,A01,507361,Daly; Alan J.,18,0,18,0
1715660147243,EDS 290,A00,507366,Hofstetter; Carolyn,15,0,15,0
1715660148269,LIGM 5A,A00,507421,Fischer-Grunski; Eva K,17,0,20,3
1715660149297,LIGM 5B,A00,507423,Fischer-Grunski; Eva K,19,0,20,1
1715660150326,LIGM 5C,A00,507425,Fischer-Grunski; Eva K,19,0,20,1
1715660151355,LIIT 5AS,A00,507427,Carnelos; Chiara,20,0,20,0
1715660152381,LIIT 5BS,A00,507430,Carnelos; Chiara,20,0,20,0
1715660153405,LIIT 5CS,A00,507432,Carnelos; Chiara,20,0,20,0
1715660154436,LISP 5A,A00,507541,Munoz Sanchez; Alicia,11,0,20,9
1715660155467,LISP 5B,A00,507671,Munoz Sanchez; Alicia,8,0,20,12
1715660156497,LISP 5C,A00,507696,Munoz Sanchez; Alicia,7,0,20,13
1715660157526,MAE 197,001,528363,Boechler; Nicholas Sebastia,9998,0,9999,1
1715660158554,MATH 197,001,523477,Kedlaya; Kiran S.,9994,0,9999,5
1715660158554,MATH 197,002,563811,Zhang; Danna,9994,0,9999,5
1715660158554,MATH 197,003,628552,Dumitriu; Ioana,9998,0,9999,1
1715660158554,MATH 197,004,660885,Floyd; Eric,9998,0,9999,1
1715660159585,MCWP 40R,A00,518780,Staff,1,0,20,19
1715660159585,MCWP 40R,B00,518781,Carter; Jennifer A,9,0,20,11
1715660159585,MCWP 40R,C00,518783,Smith; Haydee Marie,5,0,20,15
1715660160612,MCWP 50R,A00,518791,Redela; Pamela Morgan,0,1,20,20
1715660160612,MCWP 50R,B00,518792,Krone; Jarret,0,2,20,20
1715660160612,MCWP 50R,C00,518793,Staff,0,4,20,20
1715660160612,MCWP 50R,D00,518794,Morshed; Michael James,0,2,20,20
1715660160612,MCWP 50R,E00,518795,Carter; Andrea L,0,2,20,20
1715660160612,MCWP 50R,F00,518796,Miller; Elizabeth Deen,0,1,20,20
1715660160612,MCWP 50R,G00,518797,Guillen; Melinda,0,1,20,20
1715660161645,MMW 12R,A01,514034,Herbst; Matthew,0,2,16,16
1715660161645,MMW 12R,A02,514035,Herbst; Matthew,0,0,16,16
1715660162673,MMW 13R,A01,514037,Staff,0,5,16,16
1715660162673,MMW 13R,A02,514039,Staff,0,5,16,16
1715660162673,MMW 13R,A03,628519,Staff,0,4,16,16
1715660164727,SIO 295LS,A00,523233,Staff,10,0,30,20
1715660165754,SIO 295S,A00,523232,Staff,10,0,30,20
1715660166783,SIOC 290S,A01,637330,Merrifield; Mark A,21,0,30,9
1715660167808,SIOC 291S,A01,637333,Gabriel; Corey John,21,0,30,9
1715660168838,SOCI 117,A01,494376,Staff,0,5,5,5
1715660169868,WES 237B,A00,494380,Staff,10,0,20,10
1715660171940,AESE 279B,A00,494370,Wade; Jon P,0,0,33,33
1715660172967,AIP 97,001,660915,Van Den Einde; Yael Dahlia,9998,0,9999,1
1715660174002,AIP 197,001,627712,Vespa; Emanuel Ignacio,9995,0,9999,4
1715660174002,AIP 197,002,650778,Amir; On,9998,0,9999,1
1715660174002,AIP 197,003,650933,Avenancio-Leon; Carlos,9998,0,9999,1
1715660174002,AIP 197,004,658530,Heyman; Gail D.,9998,0,9999,1
1715660174002,AIP 197,005,658631,Neal; Sonya E,9998,0,9999,1
1715660174002,AIP 197,006,658671,Du; Songzi,9998,0,9999,1
1715660175030,ANAR 135S,A00,494369,Braswell; Geoffrey E.,0,0,0,0
1715660176057,BENG 196,001,628496,Engler; Adam J.,9998,0,9999,1
1715660176057,BENG 196,002,660916,Watson; John Thomas,9998,0,9999,1
1715660177083,BISP 197,001,650773,Wilhelm; James E.,9994,0,9999,5
1715660177083,BISP 197,002,658904,Coleman; Aaron B.,9998,0,9999,1
1715660178110,CAT 124RS,A01,519847,Geibel; William,0,0,20,20
1715660179137,CAT 125RS,A01,515971,Geibel; William,0,0,20,20
1715660180162,CLRE 250,A00,511389,Morris; Sheldon,9992,0,9999,7
1715660181188,CLRE 251,A00,507176,Mehta; Ravindra L.,9992,0,9999,7
1715660181188,CLRE 251,B00,511410,Mehta; Ravindra L.,9998,0,9999,1
1715660182213,CLRE 252,A00,507189,Cuomo; Raphael Eduardo,9994,0,9999,5
1715660183239,CLRE 253,A00,507199,Vaida; Florin,9994,0,9999,5
1715660183239,CLRE 253,B00,507202,Vaida; Florin,9999,0,9999,0
1715660184265,CLRE 259,A00,507211,Patel; Hemal,9996,0,9999,3
1715660185292,CLRE 260,A00,507221,Cuomo; Raphael Eduardo,9999,0,9999,0
1715660186319,CLRE 297,001,507242,Cuomo; Raphael Eduardo,9999,0,9999,0
1715660187344,COGS 197,001,638244,Voytek; Bradley Thomas,9997,0,9999,2
1715660188371,CSE 191,A00,516875,Minnes Kemp; Mor Mia,9991,0,9999,8
1715660189398,CSE 197,001,637388,Minnes Kemp; Mor Mia,9992,0,9999,7
1715660190424,CSS 201S,A01,494383,Mignozzetti; Umberto,35,0,35,0
1715660191449,CSS 202S,A01,494387,Mignozzetti; Umberto,35,0,35,0
1715660192475,DSC 197,001,628532,Eldridge; Justin Matthew,9995,0,9999,4
1715660193500,EAP 100,A00,516065,Staff,9799,0,9999,200
1715660194529,ECE 45,A01,507414,Staff,32,0,60,28
1715660196580,ECE 111,A01,507420,Staff,11,0,50,39
1715660197610,ECE 197,001,548057,Sievenpiper; Daniel F.,9991,0,9999,8
1715660198636,EDS 115,A00,507243,Choi; Bailey Miyeon,6,0,28,22
1715660199661,EDS 117,A01,494379,Staff,0,6,34,35
1715660200691,EDS 125,A00,507246,Hopkins; Megan Beth,7,0,30,23
1715660201717,EDS 128A,A01,507264,Fargason; Sharon Gayle,5,0,26,21
1715660202742,EDS 128B,A01,507293,Pappas; Elizabeth,9,0,30,21
1715660203766,EDS 139,A00,507294,Fargason; Sharon Gayle,9,0,30,21
1715660203766,EDS 139,B00,507313,Pappas; Elizabeth,9,0,30,21
1715660204793,EDS 201,A00,507315,Staff,10,0,30,20
1715660205823,EDS 203,A01,507317,Halter; Christopher P.,10,0,30,20
1715660206848,EDS 204R,A01,507319,Halter; Christopher P.,0,3,30,30
1715660206848,EDS 204R,B01,507331,Heinzman; Erica M.,14,0,30,16
1715660207874,EDS 206R,A00,507332,Staff,0,4,30,30
1715660207874,EDS 206R,B00,507343,Staff,15,0,30,15
1715660208900,EDS 250,A00,507344,Hemans; Patricia Ann Benitez,20,0,40,20
1715660209928,EDS 281,A00,507345,Daly; Alan J.,18,0,18,0
1715660211007,EDS 284,A00,507350,Daly; Alan J.,16,0,16,0
1715660212034,EDS 286,A00,507359,Fine; Sarah,18,0,18,0
1715660213058,EDS 289C,A01,507361,Daly; Alan J.,18,0,18,0
1715660214084,EDS 290,A00,507366,Hofstetter; Carolyn,15,0,15,0
1715660215111,LIGM 5A,A00,507421,Fischer-Grunski; Eva K,17,0,20,3
1715660216137,LIGM 5B,A00,507423,Fischer-Grunski; Eva K,19,0,20,1
1715660217161,LIGM 5C,A00,507425,Fischer-Grunski; Eva K,19,0,20,1
1715660218187,LIIT 5AS,A00,507427,Carnelos; Chiara,20,0,20,0
1715660219215,LIIT 5BS,A00,507430,Carnelos; Chiara,20,0,20,0
1715660220241,LIIT 5CS,A00,507432,Carnelos; Chiara,20,0,20,0
1715660221266,LISP 5A,A00,507541,Munoz Sanchez; Alicia,11,0,20,9
1715660222293,LISP 5B,A00,507671,Munoz Sanchez; Alicia,8,0,20,12
1715660223322,LISP 5C,A00,507696,Munoz Sanchez; Alicia,7,0,20,13
1715660224349,MAE 197,001,528363,Boechler; Nicholas Sebastia,9998,0,9999,1
1715660225376,MATH 197,001,523477,Kedlaya; Kiran S.,9994,0,9999,5
1715660225376,MATH 197,002,563811,Zhang; Danna,9994,0,9999,5
1715660225376,MATH 197,003,628552,Dumitriu; Ioana,9998,0,9999,1
1715660225376,MATH 197,004,660885,Floyd; Eric,9998,0,9999,1
1715660226403,MCWP 40R,A00,518780,Staff,1,0,20,19
1715660226403,MCWP 40R,B00,518781,Carter; Jennifer A,9,0,20,11
1715660226403,MCWP 40R,C00,518783,Smith; Haydee Marie,5,0,20,15
1715660227436,MCWP 50R,A00,518791,Redela; Pamela Morgan,0,1,20,20
1715660227436,MCWP 50R,B00,518792,Krone; Jarret,0,2,20,20
1715660227436,MCWP 50R,C00,518793,Staff,0,4,20,20
1715660227436,MCWP 50R,D00,518794,Morshed; Michael James,0,2,20,20
1715660227436,MCWP 50R,E00,518795,Carter; Andrea L,0,2,20,20
1715660227436,MCWP 50R,F00,518796,Miller; Elizabeth Deen,0,1,20,20
1715660227436,MCWP 50R,G00,518797,Guillen; Melinda,0,1,20,20
1715660228463,MMW 12R,A01,514034,Herbst; Matthew,0,2,16,16
1715660228463,MMW 12R,A02,514035,Herbst; Matthew,0,0,16,16
1715660229489,MMW 13R,A01,514037,Staff,0,5,16,16
1715660229489,MMW 13R,A02,514039,Staff,0,5,16,16
1715660229489,MMW 13R,A03,628519,Staff,0,4,16,16
1715660231542,SIO 295LS,A00,523233,Staff,10,0,30,20
1715660232568,SIO 295S,A00,523232,Staff,10,0,30,20
1715660233596,SIOC 290S,A01,637330,Merrifield; Mark A,21,0,30,9
1715660234623,SIOC 291S,A01,637333,Gabriel; Corey John,21,0,30,9
1715660235653,SOCI 117,A01,494376,Staff,0,5,5,5
1715660236680,WES 237B,A00,494380,Staff,10,0,20,10
1715660238761,AESE 279B,A00,494370,Wade; Jon P,0,0,33,33
1715660239788,AIP 97,001,660915,Van Den Einde; Yael Dahlia,9998,0,9999,1
1715660240819,AIP 197,001,627712,Vespa; Emanuel Ignacio,9995,0,9999,4
1715660240819,AIP 197,002,650778,Amir; On,9998,0,9999,1
1715660240819,AIP 197,003,650933,Avenancio-Leon; Carlos,9998,0,9999,1
1715660240819,AIP 197,004,658530,Heyman; Gail D.,9998,0,9999,1
1715660240819,AIP 197,005,658631,Neal; Sonya E,9998,0,9999,1
1715660240819,AIP 197,006,658671,Du; Songzi,9998,0,9999,1
1715660241844,ANAR 135S,A00,494369,Braswell; Geoffrey E.,0,0,0,0
1715660242870,BENG 196,001,628496,Engler; Adam J.,9998,0,9999,1
1715660242870,BENG 196,002,660916,Watson; John Thomas,9998,0,9999,1
1715660243908,BISP 197,001,650773,Wilhelm; James E.,9994,0,9999,5
1715660243908,BISP 197,002,658904,Coleman; Aaron B.,9998,0,9999,1
1715660244934,CAT 124RS,A01,519847,Geibel; William,0,0,20,20
1715660245960,CAT 125RS,A01,515971,Geibel; William,0,0,20,20
1715660246985,CLRE 250,A00,511389,Morris; Sheldon,9992,0,9999,7
1715660248016,CLRE 251,A00,507176,Mehta; Ravindra L.,9992,0,9999,7
1715660248016,CLRE 251,B00,511410,Mehta; Ravindra L.,9998,0,9999,1
1715660249047,CLRE 252,A00,507189,Cuomo; Raphael Eduardo,9994,0,9999,5
1715660250073,CLRE 253,A00,507199,Vaida; Florin,9994,0,9999,5
1715660250073,CLRE 253,B00,507202,Vaida; Florin,9999,0,9999,0
1715660251102,CLRE 259,A00,507211,Patel; Hemal,9996,0,9999,3
1715660252128,CLRE 260,A00,507221,Cuomo; Raphael Eduardo,9999,0,9999,0
1715660253154,CLRE 297,001,507242,Cuomo; Raphael Eduardo,9999,0,9999,0
1715660254182,COGS 197,001,638244,Voytek; Bradley Thomas,9997,0,9999,2
1715660255211,CSE 191,A00,516875,Minnes Kemp; Mor Mia,9991,0,9999,8
1715660256236,CSE 197,001,637388,Minnes Kemp; Mor Mia,9992,0,9999,7
1715660257262,CSS 201S,A01,494383,Mignozzetti; Umberto,35,0,35,0
1715660258287,CSS 202S,A01,494387,Mignozzetti; Umberto,35,0,35,0
1715660259314,DSC 197,001,628532,Eldridge; Justin Matthew,9995,0,9999,4
1715660260338,EAP 100,A00,516065,Staff,9799,0,9999,200
1715660261366,ECE 45,A01,507414,Staff,32,0,60,28
1715660263422,ECE 111,A01,507420,Staff,11,0,50,39
1715660264448,ECE 197,001,548057,Sievenpiper; Daniel F.,9991,0,9999,8
1715660265475,EDS 115,A00,507243,Choi; Bailey Miyeon,6,0,28,22
1715660266501,EDS 117,A01,494379,Staff,0,6,34,35
1715660267539,EDS 125,A00,507246,Hopkins; Megan Beth,7,0,30,23
1715660268568,EDS 128A,A01,507264,Fargason; Sharon Gayle,5,0,26,21
1715660269592,EDS 128B,A01,507293,Pappas; Elizabeth,9,0,30,21
1715660270620,EDS 139,A00,507294,Fargason; Sharon Gayle,9,0,30,21
1715660270620,EDS 139,B00,507313,Pappas; Elizabeth,9,0,30,21
1715660271647,EDS 201,A00,507315,Staff,10,0,30,20
1715660272674,EDS 203,A01,507317,Halter; Christopher P.,10,0,30,20
1715660273702,EDS 204R,A01,507319,Halter; Christopher P.,0,3,30,30
1715660273702,EDS 204R,B01,507331,Heinzman; Erica M.,14,0,30,16
1715660274728,EDS 206R,A00,507332,Staff,0,4,30,30
1715660274728,EDS 206R,B00,507343,Staff,15,0,30,15
1715660275756,EDS 250,A00,507344,Hemans; Patricia Ann Benitez,20,0,40,20
1715660276784,EDS 281,A00,507345,Daly; Alan J.,18,0,18,0
1715660277810,EDS 284,A00,507350,Daly; Alan J.,16,0,16,0
1715660278835,EDS 286,A00,507359,Fine; Sarah,18,0,18,0
1715660279863,EDS 289C,A01,507361,Daly; Alan J.,18,0,18,0
1715660280888,EDS 290,A00,507366,Hofstetter; Carolyn,15,0,15,0
1715660281914,LIGM 5A,A00,507421,Fischer-Grunski; Eva K,17,0,20,3
1715660282944,LIGM 5B,A00,507423,Fischer-Grunski; Eva K,19,0,20,1
1715660283969,LIGM 5C,A00,507425,Fischer-Grunski; Eva K,19,0,20,1
1715660284998,LIIT 5AS,A00,507427,Carnelos; Chiara,20,0,20,0
1715660286024,LIIT 5BS,A00,507430,Carnelos; Chiara,20,0,20,0
1715660287052,LIIT 5CS,A00,507432,Carnelos; Chiara,20,0,20,0
1715660288083,LISP 5A,A00,507541,Munoz Sanchez; Alicia,11,0,20,9
1715660289112,LISP 5B,A00,507671,Munoz Sanchez; Alicia,8,0,20,12
1715660290139,LISP 5C,A00,507696,Munoz Sanchez; Alicia,7,0,20,13
1715660291164,MAE 197,001,528363,Boechler; Nicholas Sebastia,9998,0,9999,1
1715660292193,MATH 197,001,523477,Kedlaya; Kiran S.,9994,0,9999,5
1715660292193,MATH 197,002,563811,Zhang; Danna,9994,0,9999,5
1715660292193,MATH 197,003,628552,Dumitriu; Ioana,9998,0,9999,1
1715660292193,MATH 197,004,660885,Floyd; Eric,9998,0,9999,1
1715660293223,MCWP 40R,A00,518780,Staff,1,0,20,19
1715660293223,MCWP 40R,B00,518781,Carter; Jennifer A,9,0,20,11
1715660293223,MCWP 40R,C00,518783,Smith; Haydee Marie,5,0,20,15
1715660294251,MCWP 50R,A00,518791,Redela; Pamela Morgan,0,1,20,20
1715660294251,MCWP 50R,B00,518792,Krone; Jarret,0,2,20,20
1715660294251,MCWP 50R,C00,518793,Staff,0,4,20,20
1715660294251,MCWP 50R,D00,518794,Morshed; Michael James,0,2,20,20
1715660294251,MCWP 50R,E00,518795,Carter; Andrea L,0,2,20,20
1715660294251,MCWP 50R,F00,518796,Miller; Elizabeth Deen,0,1,20,20
1715660294251,MCWP 50R,G00,518797,Guillen; Melinda,0,1,20,20
1715660295278,MMW 12R,A01,514034,Herbst; Matthew,0,2,16,16
1715660295278,MMW 12R,A02,514035,Herbst; Matthew,0,0,16,16
1715660296307,MMW 13R,A01,514037,Staff,0,5,16,16
1715660296307,MMW 13R,A02,514039,Staff,0,5,16,16
1715660296307,MMW 13R,A03,628519,Staff,0,4,16,16
1715660298359,SIO 295LS,A00,523233,Staff,10,0,30,20
1715660299384,SIO 295S,A00,523232,Staff,10,0,30,20
1715660300410,SIOC 290S,A01,637330,Merrifield; Mark A,21,0,30,9
1715660301440,SIOC 291S,A01,637333,Gabriel; Corey John,21,0,30,9
1715660302465,SOCI 117,A01,494376,Staff,0,5,5,5
1715660303489,WES 237B,A00,494380,Staff,10,0,20,10
1715660305564,AESE 279B,A00,494370,Wade; Jon P,0,0,33,33
1715660306590,AIP 97,001,660915,Van Den Einde; Yael Dahlia,9998,0,9999,1
1715660307618,AIP 197,001,627712,Vespa; Emanuel Ignacio,9995,0,9999,4
1715660307618,AIP 197,002,650778,Amir; On,9998,0,9999,1
1715660307618,AIP 197,003,650933,Avenancio-Leon; Carlos,9998,0,9999,1
1715660307618,AIP 197,004,658530,Heyman; Gail D.,9998,0,9999,1
1715660307618,AIP 197,005,658631,Neal; Sonya E,9998,0,9999,1
1715660307618,AIP 197,006,658671,Du; Songzi,9998,0,9999,1
1715660308647,ANAR 135S,A00,494369,Braswell; Geoffrey E.,0,0,0,0
1715660309677,BENG 196,001,628496,Engler; Adam J.,9998,0,9999,1
1715660309677,BENG 196,002,660916,Watson; John Thomas,9998,0,9999,1
1715660310706,BISP 197,001,650773,Wilhelm; James E.,9994,0,9999,5
1715660310706,BISP 197,002,658904,Coleman; Aaron B.,9998,0,9999,1
1715660311731,CAT 124RS,A01,519847,Geibel; William,0,0,20,20
1715660312759,CAT 125RS,A01,515971,Geibel; William,0,0,20,20
1715660313785,CLRE 250,A00,511389,Morris; Sheldon,9992,0,9999,7
1715660314869,CLRE 251,A00,507176,Mehta; Ravindra L.,9992,0,9999,7
1715660314869,CLRE 251,B00,511410,Mehta; Ravindra L.,9998,0,9999,1
1715660315893,CLRE 252,A00,507189,Cuomo; Raphael Eduardo,9994,0,9999,5
1715660316924,CLRE 253,A00,507199,Vaida; Florin,9994,0,9999,5
1715660316924,CLRE 253,B00,507202,Vaida; Florin,9999,0,9999,0
1715660317955,CLRE 259,A00,507211,Patel; Hemal,9996,0,9999,3
1715660318986,CLRE 260,A00,507221,Cuomo; Raphael Eduardo,9999,0,9999,0
1715660320011,CLRE 297,001,507242,Cuomo; Raphael Eduardo,9999,0,9999,0
1715660321037,COGS 197,001,638244,Voytek; Bradley Thomas,9997,0,9999,2
1715660322062,CSE 191,A00,516875,Minnes Kemp; Mor Mia,9991,0,9999,8
1715660323089,CSE 197,001,637388,Minnes Kemp; Mor Mia,9992,0,9999,7
1715660324120,CSS 201S,A01,494383,Mignozzetti; Umberto,35,0,35,0
1715660325150,CSS 202S,A01,494387,Mignozzetti; Umberto,35,0,35,0
1715660326175,DSC 197,001,628532,Eldridge; Justin Matthew,9995,0,9999,4
1715660327204,EAP 100,A00,516065,Staff,9799,0,9999,200
1715660328233,ECE 45,A01,507414,Staff,32,0,60,28
1715660330285,ECE 111,A01,507420,Staff,11,0,50,39
1715660331314,ECE 197,001,548057,Sievenpiper; Daniel F.,9991,0,9999,8
1715660332343,EDS 115,A00,507243,Choi; Bailey Miyeon,6,0,28,22
1715660333370,EDS 117,A01,494379,Staff,0,6,34,35
1715660334395,EDS 125,A00,507246,Hopkins; Megan Beth,7,0,30,23
1715660335425,EDS 128A,A01,507264,Fargason; Sharon Gayle,5,0,26,21
1715660336451,EDS 128B,A01,507293,Pappas; Elizabeth,9,0,30,21
1715660337479,EDS 139,A00,507294,Fargason; Sharon Gayle,9,0,30,21
1715660337479,EDS 139,B00,507313,Pappas; Elizabeth,9,0,30,21
1715660338506,EDS 201,A00,507315,Staff,10,0,30,20
1715660339534,EDS 203,A01,507317,Halter; Christopher P.,10,0,30,20
1715660340562,EDS 204R,A01,507319,Halter; Christopher P.,0,3,30,30
1715660340562,EDS 204R,B01,507331,Heinzman; Erica M.,14,0,30,16
1715660341588,EDS 206R,A00,507332,Staff,0,4,30,30
1715660341588,EDS 206R,B00,507343,Staff,15,0,30,15
1715660342614,EDS 250,A00,507344,Hemans; Patricia Ann Benitez,20,0,40,20
1715660343640,EDS 281,A00,507345,Daly; Alan J.,18,0,18,0
1715660344666,EDS 284,A00,507350,Daly; Alan J.,16,0,16,0
1715660345692,EDS 286,A00,507359,Fine; Sarah,18,0,18,0
1715660346718,EDS 289C,A01,507361,Daly; Alan J.,18,0,18,0
1715660347743,EDS 290,A00,507366,Hofstetter; Carolyn,15,0,15,0
1715660348774,LIGM 5A,A00,507421,Fischer-Grunski; Eva K,17,0,20,3
1715660349799,LIGM 5B,A00,507423,Fischer-Grunski; Eva K,19,0,20,1
1715660350824,LIGM 5C,A00,507425,Fischer-Grunski; Eva K,19,0,20,1
1715660351853,LIIT 5AS,A00,507427,Carnelos; Chiara,20,0,20,0
1715660352878,LIIT 5BS,A00,507430,Carnelos; Chiara,20,0,20,0
1715660353918,LIIT 5CS,A00,507432,Carnelos; Chiara,20,0,20,0
1715660354944,LISP 5A,A00,507541,Munoz Sanchez; Alicia,11,0,20,9
1715660355970,LISP 5B,A00,507671,Munoz Sanchez; Alicia,8,0,20,12
1715660356996,LISP 5C,A00,507696,Munoz Sanchez; Alicia,7,0,20,13
1715660358022,MAE 197,001,528363,Boechler; Nicholas Sebastia,9998,0,9999,1
1715660359057,MATH 197,001,523477,Kedlaya; Kiran S.,9994,0,9999,5
1715660359057,MATH 197,002,563811,Zhang; Danna,9994,0,9999,5
1715660359057,MATH 197,003,628552,Dumitriu; Ioana,9998,0,9999,1
1715660359057,MATH 197,004,660885,Floyd; Eric,9998,0,9999,1
1715660360089,MCWP 40R,A00,518780,Staff,1,0,20,19
1715660360089,MCWP 40R,B00,518781,Carter; Jennifer A,9,0,20,11
1715660360089,MCWP 40R,C00,518783,Smith; Haydee Marie,5,0,20,15
1715660361117,MCWP 50R,A00,518791,Redela; Pamela Morgan,0,1,20,20
1715660361117,MCWP 50R,B00,518792,Krone; Jarret,0,2,20,20
1715660361117,MCWP 50R,C00,518793,Staff,0,4,20,20
1715660361117,MCWP 50R,D00,518794,Morshed; Michael James,0,2,20,20
1715660361117,MCWP 50R,E00,518795,Carter; Andrea L,0,2,20,20
1715660361117,MCWP 50R,F00,518796,Miller; Elizabeth Deen,0,1,20,20
1715660361117,MCWP 50R,G00,518797,Guillen; Melinda,0,1,20,20
1715660362169,MMW 12R,A01,514034,Herbst; Matthew,0,2,16,16
1715660362169,MMW 12R,A02,514035,Herbst; Matthew,0,0,16,16
1715660363198,MMW 13R,A01,514037,Staff,0,5,16,16
1715660363198,MMW 13R,A02,514039,Staff,0,5,16,16
1715660363198,MMW 13R,A03,628519,Staff,0,4,16,16
1715660365250,SIO 295LS,A00,523233,Staff,10,0,30,20
1715660366274,SIO 295S,A00,523232,Staff,10,0,30,20
1715660367300,SIOC 290S,A01,637330,Merrifield; Mark A,21,0,30,9
1715660368328,SIOC 291S,A01,637333,Gabriel; Corey John,21,0,30,9
1715660369354,SOCI 117,A01,494376,Staff,0,5,5,5
1715660370379,WES 237B,A00,494380,Staff,10,0,20,10
1715660372451,AESE 279B,A00,494370,Wade; Jon P,0,0,33,33
1715660373479,AIP 97,001,660915,Van Den Einde; Yael Dahlia,9998,0,9999,1
1715660374507,AIP 197,001,627712,Vespa; Emanuel Ignacio,9995,0,9999,4
1715660374507,AIP 197,002,650778,Amir; On,9998,0,9999,1
1715660374507,AIP 197,003,650933,Avenancio-Leon; Carlos,9998,0,9999,1
1715660374507,AIP 197,004,658530,Heyman; Gail D.,9998,0,9999,1
1715660374507,AIP 197,005,658631,Neal; Sonya E,9998,0,9999,1
1715660374507,AIP 197,006,658671,Du; Songzi,9998,0,9999,1
1715660375535,ANAR 135S,A00,494369,Braswell; Geoffrey E.,0,0,0,0
1715660376564,BENG 196,001,628496,Engler; Adam J.,9998,0,9999,1
1715660376564,BENG 196,002,660916,Watson; John Thomas,9998,0,9999,1
1715660377590,BISP 197,001,650773,Wilhelm; James E.,9994,0,9999,5
1715660377590,BISP 197,002,658904,Coleman; Aaron B.,9998,0,9999,1
1715660378617,CAT 124RS,A01,519847,Geibel; William,0,0,20,20
1715660379642,CAT 125RS,A01,515971,Geibel; William,0,0,20,20
1715660380666,CLRE 250,A00,511389,Morris; Sheldon,9992,0,9999,7
1715660381693,CLRE 251,A00,507176,Mehta; Ravindra L.,9992,0,9999,7
1715660381693,CLRE 251,B00,511410,Mehta; Ravindra L.,9998,0,9999,1
1715660382717,CLRE 252,A00,507189,Cuomo; Raphael Eduardo,9994,0,9999,5
1715660383744,CLRE 253,A00,507199,Vaida; Florin,9994,0,9999,5
1715660383744,CLRE 253,B00,507202,Vaida; Florin,9999,0,9999,0
1715660384770,CLRE 259,A00,507211,Patel; Hemal,9996,0,9999,3
1715660385797,CLRE 260,A00,507221,Cuomo; Raphael Eduardo,9999,0,9999,0
1715660386821,CLRE 297,001,507242,Cuomo; Raphael Eduardo,9999,0,9999,0
1715660387847,COGS 197,001,638244,Voytek; Bradley Thomas,9997,0,9999,2
1715660388874,CSE 191,A00,516875,Minnes Kemp; Mor Mia,9991,0,9999,8
1715660389900,CSE 197,001,637388,Minnes Kemp; Mor Mia,9992,0,9999,7
1715660390927,CSS 201S,A01,494383,Mignozzetti; Umberto,35,0,35,0
1715660391952,CSS 202S,A01,494387,Mignozzetti; Umberto,35,0,35,0
1715660392978,DSC 197,001,628532,Eldridge; Justin Matthew,9995,0,9999,4
1715660394002,EAP 100,A00,516065,Staff,9799,0,9999,200
1715660395031,ECE 45,A01,507414,Staff,32,0,60,28
1715660397088,ECE 111,A01,507420,Staff,11,0,50,39
1715660398112,ECE 197,001,548057,Sievenpiper; Daniel F.,9991,0,9999,8
1715660399141,EDS 115,A00,507243,Choi; Bailey Miyeon,6,0,28,22
1715660400166,EDS 117,A01,494379,Staff,0,6,34,35
1715660401189,EDS 125,A00,507246,Hopkins; Megan Beth,7,0,30,23
1715660402221,EDS 128A,A01,507264,Fargason; Sharon Gayle,5,0,26,21
1715660403246,EDS 128B,A01,507293,Pappas; Elizabeth,9,0,30,21
1715660404288,EDS 139,A00,507294,Fargason; Sharon Gayle,9,0,30,21
1715660404288,EDS 139,B00,507313,Pappas; Elizabeth,9,0,30,21
1715660405316,EDS 201,A00,507315,Staff,10,0,30,20
1715660406341,EDS 203,A01,507317,Halter; Christopher P.,10,0,30,20
1715660407370,EDS 204R,A01,507319,Halter; Christopher P.,0,3,30,30
1715660407370,EDS 204R,B01,507331,Heinzman; Erica M.,14,0,30,16
1715660408396,EDS 206R,A00,507332,Staff,0,4,30,30
1715660408396,EDS 206R,B00,507343,Staff,15,0,30,15
1715660409425,EDS 250,A00,507344,Hemans; Patricia Ann Benitez,20,0,40,20
1715660410451,EDS 281,A00,507345,Daly; Alan J.,18,0,18,0
1715660411478,EDS 284,A00,507350,Daly; Alan J.,16,0,16,0
1715660412504,EDS 286,A00,507359,Fine; Sarah,18,0,18,0
1715660413528,EDS 289C,A01,507361,Daly; Alan J.,18,0,18,0
1715660414554,EDS 290,A00,507366,Hofstetter; Carolyn,15,0,15,0
1715660415584,LIGM 5A,A00,507421,Fischer-Grunski; Eva K,17,0,20,3
1715660416610,LIGM 5B,A00,507423,Fischer-Grunski; Eva K,19,0,20,1
1715660417635,LIGM 5C,A00,507425,Fischer-Grunski; Eva K,19,0,20,1
1715660418661,LIIT 5AS,A00,507427,Carnelos; Chiara,20,0,20,0
1715660419688,LIIT 5BS,A00,507430,Carnelos; Chiara,20,0,20,0
1715660420717,LIIT 5CS,A00,507432,Carnelos; Chiara,20,0,20,0
1715660421741,LISP 5A,A00,507541,Munoz Sanchez; Alicia,11,0,20,9
1715660422768,LISP 5B,A00,507671,Munoz Sanchez; Alicia,8,0,20,12
1715660423796,LISP 5C,A00,507696,Munoz Sanchez; Alicia,7,0,20,13
1715660424821,MAE 197,001,528363,Boechler; Nicholas Sebastia,9998,0,9999,1
1715660425851,MATH 197,001,523477,Kedlaya; Kiran S.,9994,0,9999,5
1715660425851,MATH 197,002,563811,Zhang; Danna,9994,0,9999,5
1715660425851,MATH 197,003,628552,Dumitriu; Ioana,9998,0,9999,1
1715660425851,MATH 197,004,660885,Floyd; Eric,9998,0,9999,1
1715660426877,MCWP 40R,A00,518780,Staff,1,0,20,19
1715660426877,MCWP 40R,B00,518781,Carter; Jennifer A,9,0,20,11
1715660426877,MCWP 40R,C00,518783,Smith; Haydee Marie,5,0,20,15
1715660427907,MCWP 50R,A00,518791,Redela; Pamela Morgan,0,1,20,20
1715660427907,MCWP 50R,B00,518792,Krone; Jarret,0,2,20,20
1715660427907,MCWP 50R,C00,518793,Staff,0,4,20,20
1715660427907,MCWP 50R,D00,518794,Morshed; Michael James,0,2,20,20
1715660427907,MCWP 50R,E00,518795,Carter; Andrea L,0,2,20,20
1715660427907,MCWP 50R,F00,518796,Miller; Elizabeth Deen,0,1,20,20
1715660427907,MCWP 50R,G00,518797,Guillen; Melinda,0,1,20,20
1715660428930,MMW 12R,A01,514034,Herbst; Matthew,0,2,16,16
1715660428930,MMW 12R,A02,514035,Herbst; Matthew,0,0,16,16
1715660429955,MMW 13R,A01,514037,Staff,0,5,16,16
1715660429955,MMW 13R,A02,514039,Staff,0,5,16,16
1715660429955,MMW 13R,A03,628519,Staff,0,4,16,16
1715660432019,SIO 295LS,A00,523233,Staff,10,0,30,20
1715660433044,SIO 295S,A00,523232,Staff,10,0,30,20
1715660434070,SIOC 290S,A01,637330,Merrifield; Mark A,21,0,30,9
1715660435097,SIOC 291S,A01,637333,Gabriel; Corey John,21,0,30,9
1715660436123,SOCI 117,A01,494376,Staff,0,5,5,5
1715660437149,WES 237B,A00,494380,Staff,10,0,20,10
1715660439217,AESE 279B,A00,494370,Wade; Jon P,0,0,33,33
1715660440248,AIP 97,001,660915,Van Den Einde; Yael Dahlia,9998,0,9999,1
1715660441276,AIP 197,001,627712,Vespa; Emanuel Ignacio,9995,0,9999,4
1715660441276,AIP 197,002,650778,Amir; On,9998,0,9999,1
1715660441276,AIP 197,003,650933,Avenancio-Leon; Carlos,9998,0,9999,1
1715660441276,AIP 197,004,658530,Heyman; Gail D.,9998,0,9999,1
1715660441276,AIP 197,005,658631,Neal; Sonya E,9998,0,9999,1
1715660441276,AIP 197,006,658671,Du; Songzi,9998,0,9999,1
1715660442302,ANAR 135S,A00,494369,Braswell; Geoffrey E.,0,0,0,0
1715660443328,BENG 196,001,628496,Engler; Adam J.,9998,0,9999,1
1715660443328,BENG 196,002,660916,Watson; John Thomas,9998,0,9999,1
1715660444354,BISP 197,001,650773,Wilhelm; James E.,9994,0,9999,5
1715660444354,BISP 197,002,658904,Coleman; Aaron B.,9998,0,9999,1
1715660445395,CAT 124RS,A01,519847,Geibel; William,0,0,20,20
1715660446422,CAT 125RS,A01,515971,Geibel; William,0,0,20,20
1715660447451,CLRE 250,A00,511389,Morris; Sheldon,9992,0,9999,7
1715660448481,CLRE 251,A00,507176,Mehta; Ravindra L.,9992,0,9999,7
1715660448481,CLRE 251,B00,511410,Mehta; Ravindra L.,9998,0,9999,1
1715660449506,CLRE 252,A00,507189,Cuomo; Raphael Eduardo,9994,0,9999,5
1715660450531,CLRE 253,A00,507199,Vaida; Florin,9994,0,9999,5
1715660450531,CLRE 253,B00,507202,Vaida; Florin,9999,0,9999,0
1715660451556,CLRE 259,A00,507211,Patel; Hemal,9996,0,9999,3
1715660452581,CLRE 260,A00,507221,Cuomo; Raphael Eduardo,9999,0,9999,0
1715660453607,CLRE 297,001,507242,Cuomo; Raphael Eduardo,9999,0,9999,0
1715660454638,COGS 197,001,638244,Voytek; Bradley Thomas,9997,0,9999,2
1715660455663,CSE 191,A00,516875,Minnes Kemp; Mor Mia,9991,0,9999,8
1715660456692,CSE 197,001,637388,Minnes Kemp; Mor Mia,9992,0,9999,7
1715660457717,CSS 201S,A01,494383,Mignozzetti; Umberto,35,0,35,0
1715660458741,CSS 202S,A01,494387,Mignozzetti; Umberto,35,0,35,0
1715660459766,DSC 197,001,628532,Eldridge; Justin Matthew,9995,0,9999,4
1715660460793,EAP 100,A00,516065,Staff,9799,0,9999,200
1715660461821,ECE 45,A01,507414,Staff,32,0,60,28
1715660463871,ECE 111,A01,507420,Staff,11,0,50,39
1715660464899,ECE 197,001,548057,Sievenpiper; Daniel F.,9991,0,9999,8
1715660465928,EDS 115,A00,507243,Choi; Bailey Miyeon,6,0,28,22
1715660466955,EDS 117,A01,494379,Staff,0,6,34,35
1715660467981,EDS 125,A00,507246,Hopkins; Megan Beth,7,0,30,23
1715660469008,EDS 128A,A01,507264,Fargason; Sharon Gayle,5,0,26,21
1715660470037,EDS 128B,A01,507293,Pappas; Elizabeth,9,0,30,21
1715660471065,EDS 139,A00,507294,Fargason; Sharon Gayle,9,0,30,21
1715660471065,EDS 139,B00,507313,Pappas; Elizabeth,9,0,30,21
1715660472093,EDS 201,A00,507315,Staff,10,0,30,20
1715660473119,EDS 203,A01,507317,Halter; Christopher P.,10,0,30,20
1715660474146,EDS 204R,A01,507319,Halter; Christopher P.,0,3,30,30
1715660474146,EDS 204R,B01,507331,Heinzman; Erica M.,14,0,30,16
1715660475170,EDS 206R,A00,507332,Staff,0,4,30,30
1715660475170,EDS 206R,B00,507343,Staff,15,0,30,15
1715660476194,EDS 250,A00,507344,Hemans; Patricia Ann Benitez,20,0,40,20
1715660477220,EDS 281,A00,507345,Daly; Alan J.,18,0,18,0
1715660478246,EDS 284,A00,507350,Daly; Alan J.,16,0,16,0
1715660479270,EDS 286,A00,507359,Fine; Sarah,18,0,18,0
1715660480296,EDS 289C,A01,507361,Daly; Alan J.,18,0,18,0
1715660481326,EDS 290,A00,507366,Hofstetter; Carolyn,15,0,15,0
1715660482352,LIGM 5A,A00,507421,Fischer-Grunski; Eva K,17,0,20,3
1715660483377,LIGM 5B,A00,507423,Fischer-Grunski; Eva K,19,0,20,1
1715660484402,LIGM 5C,A00,507425,Fischer-Grunski; Eva K,19,0,20,1
1715660485439,LIIT 5AS,A00,507427,Carnelos; Chiara,20,0,20,0
1715660486467,LIIT 5BS,A00,507430,Carnelos; Chiara,20,0,20,0
1715660487492,LIIT 5CS,A00,507432,Carnelos; Chiara,20,0,20,0
1715660488518,LISP 5A,A00,507541,Munoz Sanchez; Alicia,11,0,20,9
1715660489546,LISP 5B,A00,507671,Munoz Sanchez; Alicia,8,0,20,12
1715660490576,LISP 5C,A00,507696,Munoz Sanchez; Alicia,7,0,20,13
1715660491606,MAE 197,001,528363,Boechler; Nicholas Sebastia,9998,0,9999,1
1715660492633,MATH 197,001,523477,Kedlaya; Kiran S.,9994,0,9999,5
1715660492633,MATH 197,002,563811,Zhang; Danna,9994,0,9999,5
1715660492633,MATH 197,003,628552,Dumitriu; Ioana,9998,0,9999,1
1715660492633,MATH 197,004,660885,Floyd; Eric,9998,0,9999,1
1715660493663,MCWP 40R,A00,518780,Staff,1,0,20,19
1715660493663,MCWP 40R,B00,518781,Carter; Jennifer A,9,0,20,11
1715660493663,MCWP 40R,C00,518783,Smith; Haydee Marie,5,0,20,15
1715660494695,MCWP 50R,A00,518791,Redela; Pamela Morgan,0,1,20,20
1715660494695,MCWP 50R,B00,518792,Krone; Jarret,0,2,20,20
1715660494695,MCWP 50R,C00,518793,Staff,0,4,20,20
1715660494695,MCWP 50R,D00,518794,Morshed; Michael James,0,2,20,20
1715660494695,MCWP 50R,E00,518795,Carter; Andrea L,0,2,20,20
1715660494695,MCWP 50R,F00,518796,Miller; Elizabeth Deen,0,1,20,20
1715660494695,MCWP 50R,G00,518797,Guillen; Melinda,0,1,20,20
1715660495721,MMW 12R,A01,514034,Herbst; Matthew,0,2,16,16
1715660495721,MMW 12R,A02,514035,Herbst; Matthew,0,0,16,16
1715660496746,MMW 13R,A01,514037,Staff,0,5,16,16
1715660496746,MMW 13R,A02,514039,Staff,0,5,16,16
1715660496746,MMW 13R,A03,628519,Staff,0,4,16,16
1715660498798,SIO 295LS,A00,523233,Staff,10,0,30,20
1715660499826,SIO 295S,A00,523232,Staff,10,0,30,20
1715660500854,SIOC 290S,A01,637330,Merrifield; Mark A,21,0,30,9
1715660501879,SIOC 291S,A01,637333,Gabriel; Corey John,21,0,30,9
1715660502904,SOCI 117,A01,494376,Staff,0,5,5,5
1715660503928,WES 237B,A00,494380,Staff,10,0,20,10
1715660505992,AESE 279B,A00,494370,Wade; Jon P,0,0,33,33
1715660507020,AIP 97,001,660915,Van Den Einde; Yael Dahlia,9998,0,9999,1
1715660508057,AIP 197,001,627712,Vespa; Emanuel Ignacio,9995,0,9999,4
1715660508057,AIP 197,002,650778,Amir; On,9998,0,9999,1
1715660508057,AIP 197,003,650933,Avenancio-Leon; Carlos,9998,0,9999,1
1715660508057,AIP 197,004,658530,Heyman; Gail D.,9998,0,9999,1
1715660508057,AIP 197,005,658631,Neal; Sonya E,9998,0,9999,1
1715660508057,AIP 197,006,658671,Du; Songzi,9998,0,9999,1
1715660509083,ANAR 135S,A00,494369,Braswell; Geoffrey E.,0,0,0,0
1715660510110,BENG 196,001,628496,Engler; Adam J.,9998,0,9999,1
1715660510110,BENG 196,002,660916,Watson; John Thomas,9998,0,9999,1
1715660511135,BISP 197,001,650773,Wilhelm; James E.,9994,0,9999,5
1715660511135,BISP 197,002,658904,Coleman; Aaron B.,9998,0,9999,1
1715660512162,CAT 124RS,A01,519847,Geibel; William,0,0,20,20
1715660513189,CAT 125RS,A01,515971,Geibel; William,0,0,20,20
1715660514215,CLRE 250,A00,511389,Morris; Sheldon,9992,0,9999,7
1715660515241,CLRE 251,A00,507176,Mehta; Ravindra L.,9992,0,9999,7
1715660515241,CLRE 251,B00,511410,Mehta; Ravindra L.,9998,0,9999,1
1715660516268,CLRE 252,A00,507189,Cuomo; Raphael Eduardo,9994,0,9999,5
1715660517296,CLRE 253,A00,507199,Vaida; Florin,9994,0,9999,5
1715660517296,CLRE 253,B00,507202,Vaida; Florin,9999,0,9999,0
1715660518321,CLRE 259,A00,507211,Patel; Hemal,9996,0,9999,3
1715660519346,CLRE 260,A00,507221,Cuomo; Raphael Eduardo,9999,0,9999,0
1715660520371,CLRE 297,001,507242,Cuomo; Raphael Eduardo,9999,0,9999,0
1715660521396,COGS 197,001,638244,Voytek; Bradley Thomas,9997,0,9999,2
1715660522477,CSE 191,A00,516875,Minnes Kemp; Mor Mia,9991,0,9999,8
1715660523504,CSE 197,001,637388,Minnes Kemp; Mor Mia,9992,0,9999,7
1715660524531,CSS 201S,A01,494383,Mignozzetti; Umberto,35,0,35,0
1715660525557,CSS 202S,A01,494387,Mignozzetti; Umberto,35,0,35,0
1715660526584,DSC 197,001,628532,Eldridge; Justin Matthew,9995,0,9999,4
1715660527610,EAP 100,A00,516065,Staff,9799,0,9999,200
1715660528643,ECE 45,A01,507414,Staff,32,0,60,28
1715660530699,ECE 111,A01,507420,Staff,11,0,50,39
1715660531725,ECE 197,001,548057,Sievenpiper; Daniel F.,9991,0,9999,8
1715660532750,EDS 115,A00,507243,Choi; Bailey Miyeon,6,0,28,22
1715660533775,EDS 117,A01,494379,Staff,0,6,34,35
1715660534801,EDS 125,A00,507246,Hopkins; Megan Beth,7,0,30,23
1715660535826,EDS 128A,A01,507264,Fargason; Sharon Gayle,5,0,26,21
1715660536852,EDS 128B,A01,507293,Pappas; Elizabeth,9,0,30,21
1715660537876,EDS 139,A00,507294,Fargason; Sharon Gayle,9,0,30,21
1715660537876,EDS 139,B00,507313,Pappas; Elizabeth,9,0,30,21
1715660538906,EDS 201,A00,507315,Staff,10,0,30,20
1715660539929,EDS 203,A01,507317,Halter; Christopher P.,10,0,30,20
1715660540956,EDS 204R,A01,507319,Halter; Christopher P.,0,3,30,30
1715660540956,EDS 204R,B01,507331,Heinzman; Erica M.,14,0,30,16
1715660541981,EDS 206R,A00,507332,Staff,0,4,30,30
1715660541981,EDS 206R,B00,507343,Staff,15,0,30,15
1715660543005,EDS 250,A00,507344,Hemans; Patricia Ann Benitez,20,0,40,20
1715660544029,EDS 281,A00,507345,Daly; Alan J.,18,0,18,0
1715660545057,EDS 284,A00,507350,Daly; Alan J.,16,0,16,0
1715660546083,EDS 286,A00,507359,Fine; Sarah,18,0,18,0
1715660547111,EDS 289C,A01,507361,Daly; Alan J.,18,0,18,0
1715660548138,EDS 290,A00,507366,Hofstetter; Carolyn,15,0,15,0
1715660549163,LIGM 5A,A00,507421,Fischer-Grunski; Eva K,17,0,20,3
1715660550193,LIGM 5B,A00,507423,Fischer-Grunski; Eva K,19,0,20,1
1715660551218,LIGM 5C,A00,507425,Fischer-Grunski; Eva K,19,0,20,1
1715660552247,LIIT 5AS,A00,507427,Carnelos; Chiara,20,0,20,0
1715660553271,LIIT 5BS,A00,507430,Carnelos; Chiara,20,0,20,0
1715660554296,LIIT 5CS,A00,507432,Carnelos; Chiara,20,0,20,0
1715660555322,LISP 5A,A00,507541,Munoz Sanchez; Alicia,11,0,20,9
1715660556347,LISP 5B,A00,507671,Munoz Sanchez; Alicia,8,0,20,12
1715660557375,LISP 5C,A00,507696,Munoz Sanchez; Alicia,7,0,20,13
1715660558404,MAE 197,001,528363,Boechler; Nicholas Sebastia,9998,0,9999,1
1715660559437,MATH 197,001,523477,Kedlaya; Kiran S.,9994,0,9999,5
1715660559437,MATH 197,002,563811,Zhang; Danna,9994,0,9999,5
1715660559437,MATH 197,003,628552,Dumitriu; Ioana,9998,0,9999,1
1715660559437,MATH 197,004,660885,Floyd; Eric,9998,0,9999,1
1715660560463,MCWP 40R,A00,518780,Staff,1,0,20,19
1715660560463,MCWP 40R,B00,518781,Carter; Jennifer A,9,0,20,11
1715660560463,MCWP 40R,C00,518783,Smith; Haydee Marie,5,0,20,15
1715660561490,MCWP 50R,A00,518791,Redela; Pamela Morgan,0,1,20,20
1715660561490,MCWP 50R,B00,518792,Krone; Jarret,0,2,20,20
1715660561490,MCWP 50R,C00,518793,Staff,0,4,20,20
1715660561490,MCWP 50R,D00,518794,Morshed; Michael James,0,2,20,20
1715660561490,MCWP 50R,E00,518795,Carter; Andrea L,0,2,20,20
1715660561490,MCWP 50R,F00,518796,Miller; Elizabeth Deen,0,1,20,20
1715660561490,MCWP 50R,G00,518797,Guillen; Melinda,0,1,20,20
1715660562516,MMW 12R,A01,514034,Herbst; Matthew,0,2,16,16
1715660562516,MMW 12R,A02,514035,Herbst; Matthew,0,0,16,16
1715660563545,MMW 13R,A01,514037,Staff,0,5,16,16
1715660563545,MMW 13R,A02,514039,Staff,0,5,16,16
1715660563545,MMW 13R,A03,628519,Staff,0,4,16,16
1715660565596,SIO 295LS,A00,523233,Staff,10,0,30,20
1715660566621,SIO 295S,A00,523232,Staff,10,0,30,20
1715660567652,SIOC 290S,A01,637330,Merrifield; Mark A,21,0,30,9
1715660568681,SIOC 291S,A01,637333,Gabriel; Corey John,21,0,30,9
1715660569710,SOCI 117,A01,494376,Staff,0,5,5,5
1715660570738,WES 237B,A00,494380,Staff,10,0,20,10
1715660572809,AESE 279B,A00,494370,Wade; Jon P,0,0,33,33
1715660573834,AIP 97,001,660915,Van Den Einde; Yael Dahlia,9998,0,9999,1
1715660574862,AIP 197,001,627712,Vespa; Emanuel Ignacio,9995,0,9999,4
1715660574862,AIP 197,002,650778,Amir; On,9998,0,9999,1
1715660574862,AIP 197,003,650933,Avenancio-Leon; Carlos,9998,0,9999,1
1715660574862,AIP 197,004,658530,Heyman; Gail D.,9998,0,9999,1
1715660574862,AIP 197,005,658631,Neal; Sonya E,9998,0,9999,1
1715660574862,AIP 197,006,658671,Du; Songzi,9998,0,9999,1
1715660575888,ANAR 135S,A00,494369,Braswell; Geoffrey E.,0,0,0,0
1715660576915,BENG 196,001,628496,Engler; Adam J.,9998,0,9999,1
1715660576915,BENG 196,002,660916,Watson; John Thomas,9998,0,9999,1
1715660577942,BISP 197,001,650773,Wilhelm; James E.,9994,0,9999,5
1715660577942,BISP 197,002,658904,Coleman; Aaron B.,9998,0,9999,1
1715660578967,CAT 124RS,A01,519847,Geibel; William,0,0,20,20
1715660580001,CAT 125RS,A01,515971,Geibel; William,0,0,20,20
1715660581031,CLRE 250,A00,511389,Morris; Sheldon,9992,0,9999,7
1715660582058,CLRE 251,A00,507176,Mehta; Ravindra L.,9992,0,9999,7
1715660582058,CLRE 251,B00,511410,Mehta; Ravindra L.,9998,0,9999,1
1715660583083,CLRE 252,A00,507189,Cuomo; Raphael Eduardo,9994,0,9999,5
1715660584110,CLRE 253,A00,507199,Vaida; Florin,9994,0,9999,5
1715660584110,CLRE 253,B00,507202,Vaida; Florin,9999,0,9999,0
1715660585141,CLRE 259,A00,507211,Patel; Hemal,9996,0,9999,3
1715660595895,CLRE 260,A00,507221,Cuomo; Raphael Eduardo,9999,0,9999,0
1715660596922,CLRE 297,001,507242,Cuomo; Raphael Eduardo,9999,0,9999,0
1715660597956,COGS 197,001,638244,Voytek; Bradley Thomas,9997,0,9999,2
1715660598983,CSE 191,A00,516875,Minnes Kemp; Mor Mia,9991,0,9999,8
1715660600007,CSE 197,001,637388,Minnes Kemp; Mor Mia,9992,0,9999,7
1715660601035,CSS 201S,A01,494383,Mignozzetti; Umberto,35,0,35,0
1715660602064,CSS 202S,A01,494387,Mignozzetti; Umberto,35,0,35,0
1715660603093,DSC 197,001,628532,Eldridge; Justin Matthew,9995,0,9999,4
1715660604117,EAP 100,A00,516065,Staff,9799,0,9999,200
1715660605157,ECE 45,A01,507414,Staff,32,0,60,28
1715660607210,ECE 111,A01,507420,Staff,11,0,50,39
1715660608233,ECE 197,001,548057,Sievenpiper; Daniel F.,9991,0,9999,8
1715660609259,EDS 115,A00,507243,Choi; Bailey Miyeon,6,0,28,22
1715660610284,EDS 117,A01,494379,Staff,0,6,34,35
1715660611310,EDS 125,A00,507246,Hopkins; Megan Beth,7,0,30,23
1715660612343,EDS 128A,A01,507264,Fargason; Sharon Gayle,5,0,26,21
1715660613372,EDS 128B,A01,507293,Pappas; Elizabeth,9,0,30,21
1715660614398,EDS 139,A00,507294,Fargason; Sharon Gayle,9,0,30,21
1715660614398,EDS 139,B00,507313,Pappas; Elizabeth,9,0,30,21
1715660615425,EDS 201,A00,507315,Staff,10,0,30,20
1715660616450,EDS 203,A01,507317,Halter; Christopher P.,10,0,30,20
1715660617477,EDS 204R,A01,507319,Halter; Christopher P.,0,3,30,30
1715660617477,EDS 204R,B01,507331,Heinzman; Erica M.,14,0,30,16
1715660618506,EDS 206R,A00,507332,Staff,0,4,30,30
1715660618506,EDS 206R,B00,507343,Staff,15,0,30,15
1715660619532,EDS 250,A00,507344,Hemans; Patricia Ann Benitez,20,0,40,20
1715660620563,EDS 281,A00,507345,Daly; Alan J.,18,0,18,0
1715660621592,EDS 284,A00,507350,Daly; Alan J.,16,0,16,0
1715660622618,EDS 286,A00,507359,Fine; Sarah,18,0,18,0
1715660623647,EDS 289C,A01,507361,Daly; Alan J.,18,0,18,0
1715660624678,EDS 290,A00,507366,Hofstetter; Carolyn,15,0,15,0
1715660625704,LIGM 5A,A00,507421,Fischer-Grunski; Eva K,17,0,20,3
1715660626729,LIGM 5B,A00,507423,Fischer-Grunski; Eva K,19,0,20,1
1715660627755,LIGM 5C,A00,507425,Fischer-Grunski; Eva K,19,0,20,1
1715660628782,LIIT 5AS,A00,507427,Carnelos; Chiara,20,0,20,0
1715660629806,LIIT 5BS,A00,507430,Carnelos; Chiara,20,0,20,0
1715660630833,LIIT 5CS,A00,507432,Carnelos; Chiara,20,0,20,0
1715660631859,LISP 5A,A00,507541,Munoz Sanchez; Alicia,11,0,20,9
1715660632886,LISP 5B,A00,507671,Munoz Sanchez; Alicia,8,0,20,12
1715660633911,LISP 5C,A00,507696,Munoz Sanchez; Alicia,7,0,20,13
1715660634938,MAE 197,001,528363,Boechler; Nicholas Sebastia,9998,0,9999,1
1715660635966,MATH 197,001,523477,Kedlaya; Kiran S.,9994,0,9999,5
1715660635966,MATH 197,002,563811,Zhang; Danna,9994,0,9999,5
1715660635966,MATH 197,003,628552,Dumitriu; Ioana,9998,0,9999,1
1715660635966,MATH 197,004,660885,Floyd; Eric,9998,0,9999,1
1715660636994,MCWP 40R,A00,518780,Staff,1,0,20,19
1715660636994,MCWP 40R,B00,518781,Carter; Jennifer A,9,0,20,11
1715660636994,MCWP 40R,C00,518783,Smith; Haydee Marie,5,0,20,15
1715660638021,MCWP 50R,A00,518791,Redela; Pamela Morgan,0,1,20,20
1715660638021,MCWP 50R,B00,518792,Krone; Jarret,0,2,20,20
1715660638021,MCWP 50R,C00,518793,Staff,0,4,20,20
1715660638021,MCWP 50R,D00,518794,Morshed; Michael James,0,2,20,20
1715660638021,MCWP 50R,E00,518795,Carter; Andrea L,0,2,20,20
1715660638021,MCWP 50R,F00,518796,Miller; Elizabeth Deen,0,1,20,20
1715660638021,MCWP 50R,G00,518797,Guillen; Melinda,0,1,20,20
1715660639048,MMW 12R,A01,514034,Herbst; Matthew,0,2,16,16
1715660639048,MMW 12R,A02,514035,Herbst; Matthew,0,0,16,16
1715660640076,MMW 13R,A01,514037,Staff,0,5,16,16
1715660640076,MMW 13R,A02,514039,Staff,0,5,16,16
1715660640076,MMW 13R,A03,628519,Staff,0,4,16,16
1715660642128,SIO 295LS,A00,523233,Staff,10,0,30,20
1715660643157,SIO 295S,A00,523232,Staff,10,0,30,20
1715660644185,SIOC 290S,A01,637330,Merrifield; Mark A,21,0,30,9
1715660645215,SIOC 291S,A01,637333,Gabriel; Corey John,21,0,30,9
1715660646243,SOCI 117,A01,494376,Staff,0,5,5,5
1715660647269,WES 237B,A00,494380,Staff,10,0,20,10
1715660649346,AESE 279B,A00,494370,Wade; Jon P,0,0,33,33
1715660650373,AIP 97,001,660915,Van Den Einde; Yael Dahlia,9998,0,9999,1
1715660651400,AIP 197,001,627712,Vespa; Emanuel Ignacio,9995,0,9999,4
1715660651400,AIP 197,002,650778,Amir; On,9998,0,9999,1
1715660651400,AIP 197,003,650933,Avenancio-Leon; Carlos,9998,0,9999,1
1715660651400,AIP 197,004,658530,Heyman; Gail D.,9998,0,9999,1
1715660651400,AIP 197,005,658631,Neal; Sonya E,9998,0,9999,1
1715660651400,AIP 197,006,658671,Du; Songzi,9998,0,9999,1
1715660652428,ANAR 135S,A00,494369,Braswell; Geoffrey E.,0,0,0,0
1715660653458,BENG 196,001,628496,Engler; Adam J.,9998,0,9999,1
1715660653458,BENG 196,002,660916,Watson; John Thomas,9998,0,9999,1
1715660654487,BISP 197,001,650773,Wilhelm; James E.,9994,0,9999,5
1715660654487,BISP 197,002,658904,Coleman; Aaron B.,9998,0,9999,1
1715660655511,CAT 124RS,A01,519847,Geibel; William,0,0,20,20
1715660656534,CAT 125RS,A01,515971,Geibel; William,0,0,20,20
1715660657560,CLRE 250,A00,511389,Morris; Sheldon,9992,0,9999,7
1715660658591,CLRE 251,A00,507176,Mehta; Ravindra L.,9992,0,9999,7
1715660658591,CLRE 251,B00,511410,Mehta; Ravindra L.,9998,0,9999,1
1715660659616,CLRE 252,A00,507189,Cuomo; Raphael Eduardo,9994,0,9999,5
1715660660645,CLRE 253,A00,507199,Vaida; Florin,9994,0,9999,5
1715660660645,CLRE 253,B00,507202,Vaida; Florin,9999,0,9999,0
1715660661673,CLRE 259,A00,507211,Patel; Hemal,9996,0,9999,3
1715660662696,CLRE 260,A00,507221,Cuomo; Raphael Eduardo,9999,0,9999,0
1715660663726,CLRE 297,001,507242,Cuomo; Raphael Eduardo,9999,0,9999,0
1715660664752,COGS 197,001,638244,Voytek; Bradley Thomas,9997,0,9999,2
1715660665777,CSE 191,A00,516875,Minnes Kemp; Mor Mia,9991,0,9999,8
1715660666800,CSE 197,001,637388,Minnes Kemp; Mor Mia,9992,0,9999,7
1715660667824,CSS 201S,A01,494383,Mignozzetti; Umberto,35,0,35,0
1715660668848,CSS 202S,A01,494387,Mignozzetti; Umberto,35,0,35,0
1715660669873,DSC 197,001,628532,Eldridge; Justin Matthew,9995,0,9999,4
1715660670896,EAP 100,A00,516065,Staff,9799,0,9999,200
1715660671928,ECE 45,A01,507414,Staff,32,0,60,28
1715660673983,ECE 111,A01,507420,Staff,11,0,50,39
1715660675007,ECE 197,001,548057,Sievenpiper; Daniel F.,9991,0,9999,8
1715660676040,EDS 115,A00,507243,Choi; Bailey Miyeon,6,0,28,22
1715660677071,EDS 117,A01,494379,Staff,0,6,34,35
1715660678096,EDS 125,A00,507246,Hopkins; Megan Beth,7,0,30,23
1715660679121,EDS 128A,A01,507264,Fargason; Sharon Gayle,5,0,26,21
1715660680146,EDS 128B,A01,507293,Pappas; Elizabeth,9,0,30,21
1715660681172,EDS 139,A00,507294,Fargason; Sharon Gayle,9,0,30,21
1715660681172,EDS 139,B00,507313,Pappas; Elizabeth,9,0,30,21
1715660682199,EDS 201,A00,507315,Staff,10,0,30,20
1715660683229,EDS 203,A01,507317,Halter; Christopher P.,10,0,30,20
1715660684255,EDS 204R,A01,507319,Halter; Christopher P.,0,3,30,30
1715660684255,EDS 204R,B01,507331,Heinzman; Erica M.,14,0,30,16
1715660685280,EDS 206R,A00,507332,Staff,0,4,30,30
1715660685280,EDS 206R,B00,507343,Staff,15,0,30,15
1715660686307,EDS 250,A00,507344,Hemans; Patricia Ann Benitez,20,0,40,20
1715660687333,EDS 281,A00,507345,Daly; Alan J.,18,0,18,0
1715660688359,EDS 284,A00,507350,Daly; Alan J.,16,0,16,0
1715660689386,EDS 286,A00,507359,Fine; Sarah,18,0,18,0
1715660690412,EDS 289C,A01,507361,Daly; Alan J.,18,0,18,0
1715660691436,EDS 290,A00,507366,Hofstetter; Carolyn,15,0,15,0
1715660692468,LIGM 5A,A00,507421,Fischer-Grunski; Eva K,17,0,20,3
1715660693494,LIGM 5B,A00,507423,Fischer-Grunski; Eva K,19,0,20,1
1715660694520,LIGM 5C,A00,507425,Fischer-Grunski; Eva K,19,0,20,1
1715660695548,LIIT 5AS,A00,507427,Carnelos; Chiara,20,0,20,0
1715660696580,LIIT 5BS,A00,507430,Carnelos; Chiara,20,0,20,0
1715660697609,LIIT 5CS,A00,507432,Carnelos; Chiara,20,0,20,0
1715660698637,LISP 5A,A00,507541,Munoz Sanchez; Alicia,11,0,20,9
1715660699665,LISP 5B,A00,507671,Munoz Sanchez; Alicia,8,0,20,12
1715660700694,LISP 5C,A00,507696,Munoz Sanchez; Alicia,7,0,20,13
1715660701725,MAE 197,001,528363,Boechler; Nicholas Sebastia,9998,0,9999,1
1715660702760,MATH 197,001,523477,Kedlaya; Kiran S.,9994,0,9999,5
1715660702760,MATH 197,002,563811,Zhang; Danna,9994,0,9999,5
1715660702760,MATH 197,003,628552,Dumitriu; Ioana,9998,0,9999,1
1715660702760,MATH 197,004,660885,Floyd; Eric,9998,0,9999,1
1715660703793,MCWP 40R,A00,518780,Staff,1,0,20,19
1715660703793,MCWP 40R,B00,518781,Carter; Jennifer A,9,0,20,11
1715660703793,MCWP 40R,C00,518783,Smith; Haydee Marie,5,0,20,15
1715660704824,MCWP 50R,A00,518791,Redela; Pamela Morgan,0,1,20,20
1715660704824,MCWP 50R,B00,518792,Krone; Jarret,0,2,20,20
1715660704824,MCWP 50R,C00,518793,Staff,0,4,20,20
1715660704824,MCWP 50R,D00,518794,Morshed; Michael James,0,2,20,20
1715660704824,MCWP 50R,E00,518795,Carter; Andrea L,0,2,20,20
1715660704824,MCWP 50R,F00,518796,Miller; Elizabeth Deen,0,1,20,20
1715660704824,MCWP 50R,G00,518797,Guillen; Melinda,0,1,20,20
1715660705852,MMW 12R,A01,514034,Herbst; Matthew,0,2,16,16
1715660705852,MMW 12R,A02,514035,Herbst; Matthew,0,0,16,16
1715660706878,MMW 13R,A01,514037,Staff,0,5,16,16
1715660706878,MMW 13R,A02,514039,Staff,0,5,16,16
1715660706878,MMW 13R,A03,628519,Staff,0,4,16,16
1715660708929,SIO 295LS,A00,523233,Staff,10,0,30,20
1715660709955,SIO 295S,A00,523232,Staff,10,0,30,20
1715660710984,SIOC 290S,A01,637330,Merrifield; Mark A,21,0,30,9
1715660712013,SIOC 291S,A01,637333,Gabriel; Corey John,21,0,30,9
1715660713037,SOCI 117,A01,494376,Staff,0,5,5,5
1715660714063,WES 237B,A00,494380,Staff,10,0,20,10
1715660716135,AESE 279B,A00,494370,Wade; Jon P,0,0,33,33
1715660717163,AIP 97,001,660915,Van Den Einde; Yael Dahlia,9998,0,9999,1
1715660718190,AIP 197,001,627712,Vespa; Emanuel Ignacio,9995,0,9999,4
1715660718190,AIP 197,002,650778,Amir; On,9998,0,9999,1
1715660718190,AIP 197,003,650933,Avenancio-Leon; Carlos,9998,0,9999,1
1715660718190,AIP 197,004,658530,Heyman; Gail D.,9998,0,9999,1
1715660718190,AIP 197,005,658631,Neal; Sonya E,9998,0,9999,1
1715660718190,AIP 197,006,658671,Du; Songzi,9998,0,9999,1
1715660719214,ANAR 135S,A00,494369,Braswell; Geoffrey E.,0,0,0,0
1715660720241,BENG 196,001,628496,Engler; Adam J.,9998,0,9999,1
1715660720241,BENG 196,002,660916,Watson; John Thomas,9998,0,9999,1
1715660721266,BISP 197,001,650773,Wilhelm; James E.,9994,0,9999,5
1715660721266,BISP 197,002,658904,Coleman; Aaron B.,9998,0,9999,1
1715660722292,CAT 124RS,A01,519847,Geibel; William,0,0,20,20
1715660723317,CAT 125RS,A01,515971,Geibel; William,0,0,20,20
1715660724339,CLRE 250,A00,511389,Morris; Sheldon,9992,0,9999,7
1715660725369,CLRE 251,A00,507176,Mehta; Ravindra L.,9992,0,9999,7
1715660725369,CLRE 251,B00,511410,Mehta; Ravindra L.,9998,0,9999,1
1715660726398,CLRE 252,A00,507189,Cuomo; Raphael Eduardo,9994,0,9999,5
1715660727427,CLRE 253,A00,507199,Vaida; Florin,9994,0,9999,5
1715660727427,CLRE 253,B00,507202,Vaida; Florin,9999,0,9999,0
1715660728455,CLRE 259,A00,507211,Patel; Hemal,9996,0,9999,3
1715660729483,CLRE 260,A00,507221,Cuomo; Raphael Eduardo,9999,0,9999,0
1715660730511,CLRE 297,001,507242,Cuomo; Raphael Eduardo,9999,0,9999,0
1715660731542,COGS 197,001,638244,Voytek; Bradley Thomas,9997,0,9999,2
1715660732567,CSE 191,A00,516875,Minnes Kemp; Mor Mia,9991,0,9999,8
1715660733596,CSE 197,001,637388,Minnes Kemp; Mor Mia,9992,0,9999,7
1715660734621,CSS 201S,A01,494383,Mignozzetti; Umberto,35,0,35,0
1715660735650,CSS 202S,A01,494387,Mignozzetti; Umberto,35,0,35,0
1715660736675,DSC 197,001,628532,Eldridge; Justin Matthew,9995,0,9999,4
1715660737700,EAP 100,A00,516065,Staff,9799,0,9999,200
1715660738729,ECE 45,A01,507414,Staff,32,0,60,28
1715660740781,ECE 111,A01,507420,Staff,11,0,50,39
1715660741806,ECE 197,001,548057,Sievenpiper; Daniel F.,9991,0,9999,8
1715660742832,EDS 115,A00,507243,Choi; Bailey Miyeon,6,0,28,22
1715660743856,EDS 117,A01,494379,Staff,0,6,34,35
1715660744882,EDS 125,A00,507246,Hopkins; Megan Beth,7,0,30,23
1715660745907,EDS 128A,A01,507264,Fargason; Sharon Gayle,5,0,26,21
1715660746930,EDS 128B,A01,507293,Pappas; Elizabeth,9,0,30,21
1715660747959,EDS 139,A00,507294,Fargason; Sharon Gayle,9,0,30,21
1715660747959,EDS 139,B00,507313,Pappas; Elizabeth,9,0,30,21
1715660748982,EDS 201,A00,507315,Staff,10,0,30,20
1715660750008,EDS 203,A01,507317,Halter; Christopher P.,10,0,30,20
1715660751034,EDS 204R,A01,507319,Halter; Christopher P.,0,3,30,30
1715660751034,EDS 204R,B01,507331,Heinzman; Erica M.,14,0,30,16
1715660752060,EDS 206R,A00,507332,Staff,0,4,30,30
1715660752060,EDS 206R,B00,507343,Staff,15,0,30,15
1715660753086,EDS 250,A00,507344,Hemans; Patricia Ann Benitez,20,0,40,20
1715660754112,EDS 281,A00,507345,Daly; Alan J.,18,0,18,0
1715660755137,EDS 284,A00,507350,Daly; Alan J.,16,0,16,0
1715660756164,EDS 286,A00,507359,Fine; Sarah,18,0,18,0
1715660757192,EDS 289C,A01,507361,Daly; Alan J.,18,0,18,0
1715660758217,EDS 290,A00,507366,Hofstetter; Carolyn,15,0,15,0
1715660759245,LIGM 5A,A00,507421,Fischer-Grunski; Eva K,17,0,20,3
1715660760274,LIGM 5B,A00,507423,Fischer-Grunski; Eva K,19,0,20,1
1715660761312,LIGM 5C,A00,507425,Fischer-Grunski; Eva K,19,0,20,1
1715660762337,LIIT 5AS,A00,507427,Carnelos; Chiara,20,0,20,0
1715660763362,LIIT 5BS,A00,507430,Carnelos; Chiara,20,0,20,0
1715660764392,LIIT 5CS,A00,507432,Carnelos; Chiara,20,0,20,0
1715660765418,LISP 5A,A00,507541,Munoz Sanchez; Alicia,11,0,20,9
1715660766444,LISP 5B,A00,507671,Munoz Sanchez; Alicia,8,0,20,12
1715660767477,LISP 5C,A00,507696,Munoz Sanchez; Alicia,7,0,20,13
1715660768506,MAE 197,001,528363,Boechler; Nicholas Sebastia,9998,0,9999,1
1715660769532,MATH 197,001,523477,Kedlaya; Kiran S.,9994,0,9999,5
1715660769532,MATH 197,002,563811,Zhang; Danna,9994,0,9999,5
1715660769532,MATH 197,003,628552,Dumitriu; Ioana,9998,0,9999,1
1715660769532,MATH 197,004,660885,Floyd; Eric,9998,0,9999,1
1715660770561,MCWP 40R,A00,518780,Staff,1,0,20,19
1715660770561,MCWP 40R,B00,518781,Carter; Jennifer A,9,0,20,11
1715660770561,MCWP 40R,C00,518783,Smith; Haydee Marie,5,0,20,15
1715660771589,MCWP 50R,A00,518791,Redela; Pamela Morgan,0,1,20,20
1715660771589,MCWP 50R,B00,518792,Krone; Jarret,0,2,20,20
1715660771589,MCWP 50R,C00,518793,Staff,0,4,20,20
1715660771589,MCWP 50R,D00,518794,Morshed; Michael James,0,2,20,20
1715660771589,MCWP 50R,E00,518795,Carter; Andrea L,0,2,20,20
1715660771589,MCWP 50R,F00,518796,Miller; Elizabeth Deen,0,1,20,20
1715660771589,MCWP 50R,G00,518797,Guillen; Melinda,0,1,20,20
1715660772614,MMW 12R,A01,514034,Herbst; Matthew,0,2,16,16
1715660772614,MMW 12R,A02,514035,Herbst; Matthew,0,0,16,16
1715660773640,MMW 13R,A01,514037,Staff,0,5,16,16
1715660773640,MMW 13R,A02,514039,Staff,0,5,16,16
1715660773640,MMW 13R,A03,628519,Staff,0,4,16,16
1715660775694,SIO 295LS,A00,523233,Staff,10,0,30,20
1715660776718,SIO 295S,A00,523232,Staff,10,0,30,20
1715660777743,SIOC 290S,A01,637330,Merrifield; Mark A,21,0,30,9
1715660778772,SIOC 291S,A01,637333,Gabriel; Corey John,21,0,30,9
1715660779796,SOCI 117,A01,494376,Staff,0,5,5,5
1715660780820,WES 237B,A00,494380,Staff,10,0,20,10
1715660782905,AESE 279B,A00,494370,Wade; Jon P,0,0,33,33
1715660783928,AIP 97,001,660915,Van Den Einde; Yael Dahlia,9998,0,9999,1
1715660784960,AIP 197,001,627712,Vespa; Emanuel Ignacio,9995,0,9999,4
1715660784960,AIP 197,002,650778,Amir; On,9998,0,9999,1
1715660784960,AIP 197,003,650933,Avenancio-Leon; Carlos,9998,0,9999,1
1715660784960,AIP 197,004,658530,Heyman; Gail D.,9998,0,9999,1
1715660784960,AIP 197,005,658631,Neal; Sonya E,9998,0,9999,1
1715660784960,AIP 197,006,658671,Du; Songzi,9998,0,9999,1
1715660785985,ANAR 135S,A00,494369,Braswell; Geoffrey E.,0,0,0,0
1715660787012,BENG 196,001,628496,Engler; Adam J.,9998,0,9999,1
1715660787012,BENG 196,002,660916,Watson; John Thomas,9998,0,9999,1
1715660788040,BISP 197,001,650773,Wilhelm; James E.,9994,0,9999,5
1715660788040,BISP 197,002,658904,Coleman; Aaron B.,9998,0,9999,1
1715660789065,CAT 124RS,A01,519847,Geibel; William,0,0,20,20
1715660790088,CAT 125RS,A01,515971,Geibel; William,0,0,20,20
1715660791113,CLRE 250,A00,511389,Morris; Sheldon,9992,0,9999,7
1715660792138,CLRE 251,A00,507176,Mehta; Ravindra L.,9992,0,9999,7
1715660792138,CLRE 251,B00,511410,Mehta; Ravindra L.,9998,0,9999,1
1715660793168,CLRE 252,A00,507189,Cuomo; Raphael Eduardo,9994,0,9999,5
1715660794199,CLRE 253,A00,507199,Vaida; Florin,9994,0,9999,5
1715660794199,CLRE 253,B00,507202,Vaida; Florin,9999,0,9999,0
1715660795224,CLRE 259,A00,507211,Patel; Hemal,9996,0,9999,3
1715660796247,CLRE 260,A00,507221,Cuomo; Raphael Eduardo,9999,0,9999,0
1715660797271,CLRE 297,001,507242,Cuomo; Raphael Eduardo,9999,0,9999,0
1715660798298,COGS 197,001,638244,Voytek; Bradley Thomas,9997,0,9999,2
1715660799322,CSE 191,A00,516875,Minnes Kemp; Mor Mia,9991,0,9999,8
1715660800346,CSE 197,001,637388,Minnes Kemp; Mor Mia,9992,0,9999,7
1715660801373,CSS 201S,A01,494383,Mignozzetti; Umberto,35,0,35,0
1715660802400,CSS 202S,A01,494387,Mignozzetti; Umberto,35,0,35,0
1715660803430,DSC 197,001,628532,Eldridge; Justin Matthew,9995,0,9999,4
1715660804457,EAP 100,A00,516065,Staff,9799,0,9999,200
1715660805485,ECE 45,A01,507414,Staff,32,0,60,28
1715660807538,ECE 111,A01,507420,Staff,11,0,50,39
1715660808570,ECE 197,001,548057,Sievenpiper; Daniel F.,9991,0,9999,8
1715660809603,EDS 115,A00,507243,Choi; Bailey Miyeon,6,0,28,22
1715660810628,EDS 117,A01,494379,Staff,0,6,34,35
1715660811657,EDS 125,A00,507246,Hopkins; Megan Beth,7,0,30,23
1715660812682,EDS 128A,A01,507264,Fargason; Sharon Gayle,5,0,26,21
1715660813711,EDS 128B,A01,507293,Pappas; Elizabeth,9,0,30,21
1715660814738,EDS 139,A00,507294,Fargason; Sharon Gayle,9,0,30,21
1715660814738,EDS 139,B00,507313,Pappas; Elizabeth,9,0,30,21
1715660815762,EDS 201,A00,507315,Staff,10,0,30,20
1715660816855,EDS 203,A01,507317,Halter; Christopher P.,10,0,30,20
1715660817884,EDS 204R,A01,507319,Halter; Christopher P.,0,3,30,30
1715660817884,EDS 204R,B01,507331,Heinzman; Erica M.,14,0,30,16
1715660818917,EDS 206R,A00,507332,Staff,0,4,30,30
1715660818917,EDS 206R,B00,507343,Staff,15,0,30,15
1715660819942,EDS 250,A00,507344,Hemans; Patricia Ann Benitez,20,0,40,20
1715660820988,EDS 281,A00,507345,Daly; Alan J.,18,0,18,0
1715660822013,EDS 284,A00,507350,Daly; Alan J.,16,0,16,0
1715660823038,EDS 286,A00,507359,Fine; Sarah,18,0,18,0
1715660824064,EDS 289C,A01,507361,Daly; Alan J.,18,0,18,0
1715660825091,EDS 290,A00,507366,Hofstetter; Carolyn,15,0,15,0
1715660826117,LIGM 5A,A00,507421,Fischer-Grunski; Eva K,17,0,20,3
1715660827145,LIGM 5B,A00,507423,Fischer-Grunski; Eva K,19,0,20,1
1715660828169,LIGM 5C,A00,507425,Fischer-Grunski; Eva K,19,0,20,1
1715660829196,LIIT 5AS,A00,507427,Carnelos; Chiara,20,0,20,0
1715660830220,LIIT 5BS,A00,507430,Carnelos; Chiara,20,0,20,0
1715660831245,LIIT 5CS,A00,507432,Carnelos; Chiara,20,0,20,0
1715660832275,LISP 5A,A00,507541,Munoz Sanchez; Alicia,11,0,20,9
1715660833305,LISP 5B,A00,507671,Munoz Sanchez; Alicia,8,0,20,12
1715660834335,LISP 5C,A00,507696,Munoz Sanchez; Alicia,7,0,20,13
1715660835362,MAE 197,001,528363,Boechler; Nicholas Sebastia,9998,0,9999,1
1715660836392,MATH 197,001,523477,Kedlaya; Kiran S.,9994,0,9999,5
1715660836392,MATH 197,002,563811,Zhang; Danna,9994,0,9999,5
1715660836392,MATH 197,003,628552,Dumitriu; Ioana,9998,0,9999,1
1715660836392,MATH 197,004,660885,Floyd; Eric,9998,0,9999,1
1715660837420,MCWP 40R,A00,518780,Staff,1,0,20,19
1715660837420,MCWP 40R,B00,518781,Carter; Jennifer A,9,0,20,11
1715660837420,MCWP 40R,C00,518783,Smith; Haydee Marie,5,0,20,15
1715660838447,MCWP 50R,A00,518791,Redela; Pamela Morgan,0,1,20,20
1715660838447,MCWP 50R,B00,518792,Krone; Jarret,0,2,20,20
1715660838447,MCWP 50R,C00,518793,Staff,0,4,20,20
1715660838447,MCWP 50R,D00,518794,Morshed; Michael James,0,2,20,20
1715660838447,MCWP 50R,E00,518795,Carter; Andrea L,0,2,20,20
1715660838447,MCWP 50R,F00,518796,Miller; Elizabeth Deen,0,1,20,20
1715660838447,MCWP 50R,G00,518797,Guillen; Melinda,0,1,20,20
1715660839474,MMW 12R,A01,514034,Herbst; Matthew,0,2,16,16
1715660839474,MMW 12R,A02,514035,Herbst; Matthew,0,0,16,16
1715660840498,MMW 13R,A01,514037,Staff,0,5,16,16
1715660840498,MMW 13R,A02,514039,Staff,0,5,16,16
1715660840498,MMW 13R,A03,628519,Staff,0,4,16,16
1715660842575,SIO 295LS,A00,523233,Staff,10,0,30,20
1715660843602,SIO 295S,A00,523232,Staff,10,0,30,20
1715660844631,SIOC 290S,A01,637330,Merrifield; Mark A,21,0,30,9
1715660845658,SIOC 291S,A01,637333,Gabriel; Corey John,21,0,30,9
1715660846689,SOCI 117,A01,494376,Staff,0,5,5,5
1715660847715,WES 237B,A00,494380,Staff,10,0,20,10
1715660849787,AESE 279B,A00,494370,Wade; Jon P,0,0,33,33
1715660850812,AIP 97,001,660915,Van Den Einde; Yael Dahlia,9998,0,9999,1
1715660851844,AIP 197,001,627712,Vespa; Emanuel Ignacio,9995,0,9999,4
1715660851844,AIP 197,002,650778,Amir; On,9998,0,9999,1
1715660851844,AIP 197,003,650933,Avenancio-Leon; Carlos,9998,0,9999,1
1715660851844,AIP 197,004,658530,Heyman; Gail D.,9998,0,9999,1
1715660851844,AIP 197,005,658631,Neal; Sonya E,9998,0,9999,1
1715660851844,AIP 197,006,658671,Du; Songzi,9998,0,9999,1
1715660852874,ANAR 135S,A00,494369,Braswell; Geoffrey E.,0,0,0,0
1715660853906,BENG 196,001,628496,Engler; Adam J.,9998,0,9999,1
1715660853906,BENG 196,002,660916,Watson; John Thomas,9998,0,9999,1
1715660854930,BISP 197,001,650773,Wilhelm; James E.,9994,0,9999,5
1715660854930,BISP 197,002,658904,Coleman; Aaron B.,9998,0,9999,1
1715660855956,CAT 124RS,A01,519847,Geibel; William,0,0,20,20
1715660856983,CAT 125RS,A01,515971,Geibel; William,0,0,20,20
1715660858009,CLRE 250,A00,511389,Morris; Sheldon,9992,0,9999,7
1715660859037,CLRE 251,A00,507176,Mehta; Ravindra L.,9992,0,9999,7
1715660859037,CLRE 251,B00,511410,Mehta; Ravindra L.,9998,0,9999,1
1715660860062,CLRE 252,A00,507189,Cuomo; Raphael Eduardo,9994,0,9999,5
1715660861087,CLRE 253,A00,507199,Vaida; Florin,9994,0,9999,5
1715660861087,CLRE 253,B00,507202,Vaida; Florin,9999,0,9999,0
1715660862117,CLRE 259,A00,507211,Patel; Hemal,9996,0,9999,3
1715660863141,CLRE 260,A00,507221,Cuomo; Raphael Eduardo,9999,0,9999,0
1715660864165,CLRE 297,001,507242,Cuomo; Raphael Eduardo,9999,0,9999,0
1715660865194,COGS 197,001,638244,Voytek; Bradley Thomas,9997,0,9999,2
1715660866223,CSE 191,A00,516875,Minnes Kemp; Mor Mia,9991,0,9999,8
1715660867246,CSE 197,001,637388,Minnes Kemp; Mor Mia,9992,0,9999,7
1715660868272,CSS 201S,A01,494383,Mignozzetti; Umberto,35,0,35,0
1715660869301,CSS 202S,A01,494387,Mignozzetti; Umberto,35,0,35,0
1715660870326,DSC 197,001,628532,Eldridge; Justin Matthew,9995,0,9999,4
1715660871354,EAP 100,A00,516065,Staff,9799,0,9999,200
1715660872383,ECE 45,A01,507414,Staff,32,0,60,28
1715660874437,ECE 111,A01,507420,Staff,11,0,50,39
1715660875464,ECE 197,001,548057,Sievenpiper; Daniel F.,9991,0,9999,8
1715660876490,EDS 115,A00,507243,Choi; Bailey Miyeon,6,0,28,22
1715660877524,EDS 117,A01,494379,Staff,0,6,34,35
1715660878554,EDS 125,A00,507246,Hopkins; Megan Beth,7,0,30,23
1715660879579,EDS 128A,A01,507264,Fargason; Sharon Gayle,5,0,26,21
1715660880607,EDS 128B,A01,507293,Pappas; Elizabeth,9,0,30,21
1715660881635,EDS 139,A00,507294,Fargason; Sharon Gayle,9,0,30,21
1715660881635,EDS 139,B00,507313,Pappas; Elizabeth,9,0,30,21
1715660882659,EDS 201,A00,507315,Staff,10,0,30,20
1715660883684,EDS 203,A01,507317,Halter; Christopher P.,10,0,30,20
1715660884712,EDS 204R,A01,507319,Halter; Christopher P.,0,3,30,30
1715660884712,EDS 204R,B01,507331,Heinzman; Erica M.,14,0,30,16
1715660885737,EDS 206R,A00,507332,Staff,0,4,30,30
1715660885737,EDS 206R,B00,507343,Staff,15,0,30,15
1715660886762,EDS 250,A00,507344,Hemans; Patricia Ann Benitez,20,0,40,20
1715660887790,EDS 281,A00,507345,Daly; Alan J.,18,0,18,0
1715660888816,EDS 284,A00,507350,Daly; Alan J.,16,0,16,0
1715660889847,EDS 286,A00,507359,Fine; Sarah,18,0,18,0
1715660890874,EDS 289C,A01,507361,Daly; Alan J.,18,0,18,0
1715660891901,EDS 290,A00,507366,Hofstetter; Carolyn,15,0,15,0
1715660892932,LIGM 5A,A00,507421,Fischer-Grunski; Eva K,17,0,20,3
1715660893960,LIGM 5B,A00,507423,Fischer-Grunski; Eva K,19,0,20,1
1715660894985,LIGM 5C,A00,507425,Fischer-Grunski; Eva K,19,0,20,1
1715660896011,LIIT 5AS,A00,507427,Carnelos; Chiara,20,0,20,0
1715660897034,LIIT 5BS,A00,507430,Carnelos; Chiara,20,0,20,0
1715660898062,LIIT 5CS,A00,507432,Carnelos; Chiara,20,0,20,0
1715660899091,LISP 5A,A00,507541,Munoz Sanchez; Alicia,11,0,20,9
1715660900119,LISP 5B,A00,507671,Munoz Sanchez; Alicia,8,0,20,12
1715660901144,LISP 5C,A00,507696,Munoz Sanchez; Alicia,7,0,20,13
1715660902173,MAE 197,001,528363,Boechler; Nicholas Sebastia,9998,0,9999,1
1715660903203,MATH 197,001,523477,Kedlaya; Kiran S.,9994,0,9999,5
1715660903203,MATH 197,002,563811,Zhang; Danna,9994,0,9999,5
1715660903203,MATH 197,003,628552,Dumitriu; Ioana,9998,0,9999,1
1715660903203,MATH 197,004,660885,Floyd; Eric,9998,0,9999,1
1715660904228,MCWP 40R,A00,518780,Staff,1,0,20,19
1715660904228,MCWP 40R,B00,518781,Carter; Jennifer A,9,0,20,11
1715660904228,MCWP 40R,C00,518783,Smith; Haydee Marie,5,0,20,15
1715660905256,MCWP 50R,A00,518791,Redela; Pamela Morgan,0,1,20,20
1715660905256,MCWP 50R,B00,518792,Krone; Jarret,0,2,20,20
1715660905256,MCWP 50R,C00,518793,Staff,0,4,20,20
1715660905256,MCWP 50R,D00,518794,Morshed; Michael James,0,2,20,20
1715660905256,MCWP 50R,E00,518795,Carter; Andrea L,0,2,20,20
1715660905256,MCWP 50R,F00,518796,Miller; Elizabeth Deen,0,1,20,20
1715660905256,MCWP 50R,G00,518797,Guillen; Melinda,0,1,20,20
1715660906285,MMW 12R,A01,514034,Herbst; Matthew,0,2,16,16
1715660906285,MMW 12R,A02,514035,Herbst; Matthew,0,0,16,16
1715660907313,MMW 13R,A01,514037,Staff,0,5,16,16
1715660907313,MMW 13R,A02,514039,Staff,0,5,16,16
1715660907313,MMW 13R,A03,628519,Staff,0,4,16,16
1715660909364,SIO 295LS,A00,523233,Staff,10,0,30,20
1715660910391,SIO 295S,A00,523232,Staff,10,0,30,20
1715660911415,SIOC 290S,A01,637330,Merrifield; Mark A,21,0,30,9
1715660912443,SIOC 291S,A01,637333,Gabriel; Corey John,21,0,30,9
1715660913470,SOCI 117,A01,494376,Staff,0,5,5,5
1715660914497,WES 237B,A00,494380,Staff,10,0,20,10
1715660916568,AESE 279B,A00,494370,Wade; Jon P,0,0,33,33
1715660917596,AIP 97,001,660915,Van Den Einde; Yael Dahlia,9998,0,9999,1
1715660918624,AIP 197,001,627712,Vespa; Emanuel Ignacio,9995,0,9999,4
1715660918624,AIP 197,002,650778,Amir; On,9998,0,9999,1
1715660918624,AIP 197,003,650933,Avenancio-Leon; Carlos,9998,0,9999,1
1715660918624,AIP 197,004,658530,Heyman; Gail D.,9998,0,9999,1
1715660918624,AIP 197,005,658631,Neal; Sonya E,9998,0,9999,1
1715660918624,AIP 197,006,658671,Du; Songzi,9998,0,9999,1
1715660919649,ANAR 135S,A00,494369,Braswell; Geoffrey E.,0,0,0,0
1715660920679,BENG 196,001,628496,Engler; Adam J.,9998,0,9999,1
1715660920679,BENG 196,002,660916,Watson; John Thomas,9998,0,9999,1
1715660921707,BISP 197,001,650773,Wilhelm; James E.,9994,0,9999,5
1715660921707,BISP 197,002,658904,Coleman; Aaron B.,9998,0,9999,1
1715660922733,CAT 124RS,A01,519847,Geibel; William,0,0,20,20
1715660923758,CAT 125RS,A01,515971,Geibel; William,0,0,20,20
1715660924787,CLRE 250,A00,511389,Morris; Sheldon,9992,0,9999,7
1715660925813,CLRE 251,A00,507176,Mehta; Ravindra L.,9992,0,9999,7
1715660925813,CLRE 251,B00,511410,Mehta; Ravindra L.,9998,0,9999,1
1715660926840,CLRE 252,A00,507189,Cuomo; Raphael Eduardo,9994,0,9999,5
1715660927866,CLRE 253,A00,507199,Vaida; Florin,9994,0,9999,5
1715660927866,CLRE 253,B00,507202,Vaida; Florin,9999,0,9999,0
1715660928889,CLRE 259,A00,507211,Patel; Hemal,9996,0,9999,3
1715660929917,CLRE 260,A00,507221,Cuomo; Raphael Eduardo,9999,0,9999,0
1715660930999,CLRE 297,001,507242,Cuomo; Raphael Eduardo,9999,0,9999,0
1715660932025,COGS 197,001,638244,Voytek; Bradley Thomas,9997,0,9999,2
1715660933053,CSE 191,A00,516875,Minnes Kemp; Mor Mia,9991,0,9999,8
1715660934079,CSE 197,001,637388,Minnes Kemp; Mor Mia,9992,0,9999,7
1715660935110,CSS 201S,A01,494383,Mignozzetti; Umberto,35,0,35,0
1715660936140,CSS 202S,A01,494387,Mignozzetti; Umberto,35,0,35,0
1715660937166,DSC 197,001,628532,Eldridge; Justin Matthew,9995,0,9999,4
1715660938190,EAP 100,A00,516065,Staff,9799,0,9999,200
1715660939222,ECE 45,A01,507414,Staff,32,0,60,28
1715660941276,ECE 111,A01,507420,Staff,11,0,50,39
1715660942304,ECE 197,001,548057,Sievenpiper; Daniel F.,9991,0,9999,8
1715660943331,EDS 115,A00,507243,Choi; Bailey Miyeon,6,0,28,22
1715660944359,EDS 117,A01,494379,Staff,0,6,34,35
1715660945388,EDS 125,A00,507246,Hopkins; Megan Beth,7,0,30,23
1715660946415,EDS 128A,A01,507264,Fargason; Sharon Gayle,5,0,26,21
1715660947441,EDS 128B,A01,507293,Pappas; Elizabeth,9,0,30,21
1715660948468,EDS 139,A00,507294,Fargason; Sharon Gayle,9,0,30,21
1715660948468,EDS 139,B00,507313,Pappas; Elizabeth,9,0,30,21
1715660949493,EDS 201,A00,507315,Staff,10,0,30,20
1715660950520,EDS 203,A01,507317,Halter; Christopher P.,10,0,30,20
1715660951549,EDS 204R,A01,507319,Halter; Christopher P.,0,3,30,30
1715660951549,EDS 204R,B01,507331,Heinzman; Erica M.,14,0,30,16
1715660952579,EDS 206R,A00,507332,Staff,0,4,30,30
1715660952579,EDS 206R,B00,507343,Staff,15,0,30,15
1715660953606,EDS 250,A00,507344,Hemans; Patricia Ann Benitez,20,0,40,20
1715660954633,EDS 281,A00,507345,Daly; Alan J.,18,0,18,0
1715660955660,EDS 284,A00,507350,Daly; Alan J.,16,0,16,0
1715660956684,EDS 286,A00,507359,Fine; Sarah,18,0,18,0
1715660957710,EDS 289C,A01,507361,Daly; Alan J.,18,0,18,0
1715660958738,EDS 290,A00,507366,Hofstetter; Carolyn,15,0,15,0
1715660959763,LIGM 5A,A00,507421,Fischer-Grunski; Eva K,17,0,20,3
1715660960789,LIGM 5B,A00,507423,Fischer-Grunski; Eva K,19,0,20,1
1715660961820,LIGM 5C,A00,507425,Fischer-Grunski; Eva K,19,0,20,1
1715660962844,LIIT 5AS,A00,507427,Carnelos; Chiara,20,0,20,0
1715660963884,LIIT 5BS,A00,507430,Carnelos; Chiara,20,0,20,0
1715660964912,LIIT 5CS,A00,507432,Carnelos; Chiara,20,0,20,0
1715660965937,LISP 5A,A00,507541,Munoz Sanchez; Alicia,11,0,20,9
1715660966967,LISP 5B,A00,507671,Munoz Sanchez; Alicia,8,0,20,12
1715660967996,LISP 5C,A00,507696,Munoz Sanchez; Alicia,7,0,20,13
1715660969024,MAE 197,001,528363,Boechler; Nicholas Sebastia,9998,0,9999,1
1715660970057,MATH 197,001,523477,Kedlaya; Kiran S.,9994,0,9999,5
1715660970057,MATH 197,002,563811,Zhang; Danna,9994,0,9999,5
1715660970057,MATH 197,003,628552,Dumitriu; Ioana,9998,0,9999,1
1715660970057,MATH 197,004,660885,Floyd; Eric,9998,0,9999,1
1715660971084,MCWP 40R,A00,518780,Staff,1,0,20,19
1715660971084,MCWP 40R,B00,518781,Carter; Jennifer A,9,0,20,11
1715660971084,MCWP 40R,C00,518783,Smith; Haydee Marie,5,0,20,15
1715660972117,MCWP 50R,A00,518791,Redela; Pamela Morgan,0,1,20,20
1715660972117,MCWP 50R,B00,518792,Krone; Jarret,0,2,20,20
1715660972117,MCWP 50R,C00,518793,Staff,0,4,20,20
1715660972117,MCWP 50R,D00,518794,Morshed; Michael James,0,2,20,20
1715660972117,MCWP 50R,E00,518795,Carter; Andrea L,0,2,20,20
1715660972117,MCWP 50R,F00,518796,Miller; Elizabeth Deen,0,1,20,20
1715660972117,MCWP 50R,G00,518797,Guillen; Melinda,0,1,20,20
1715660973146,MMW 12R,A01,514034,Herbst; Matthew,0,2,16,16
1715660973146,MMW 12R,A02,514035,Herbst; Matthew,0,0,16,16
1715660974174,MMW 13R,A01,514037,Staff,0,5,16,16
1715660974174,MMW 13R,A02,514039,Staff,0,5,16,16
1715660974174,MMW 13R,A03,628519,Staff,0,4,16,16
1715660976229,SIO 295LS,A00,523233,Staff,10,0,30,20
1715660977254,SIO 295S,A00,523232,Staff,10,0,30,20
1715660978278,SIOC 290S,A01,637330,Merrifield; Mark A,21,0,30,9
1715660979305,SIOC 291S,A01,637333,Gabriel; Corey John,21,0,30,9
1715660980331,SOCI 117,A01,494376,Staff,0,5,5,5
1715660981359,WES 237B,A00,494380,Staff,10,0,20,10
1715660983440,AESE 279B,A00,494370,Wade; Jon P,0,0,33,33
1715660984469,AIP 97,001,660915,Van Den Einde; Yael Dahlia,9998,0,9999,1
1715660985498,AIP 197,001,627712,Vespa; Emanuel Ignacio,9995,0,9999,4
1715660985498,AIP 197,002,650778,Amir; On,9998,0,9999,1
1715660985498,AIP 197,003,650933,Avenancio-Leon; Carlos,9998,0,9999,1
1715660985498,AIP 197,004,658530,Heyman; Gail D.,9998,0,9999,1
1715660985498,AIP 197,005,658631,Neal; Sonya E,9998,0,9999,1
1715660985498,AIP 197,006,658671,Du; Songzi,9998,0,9999,1
1715660986527,ANAR 135S,A00,494369,Braswell; Geoffrey E.,0,0,0,0
1715660987558,BENG 196,001,628496,Engler; Adam J.,9998,0,9999,1
1715660987558,BENG 196,002,660916,Watson; John Thomas,9998,0,9999,1
1715660988590,BISP 197,001,650773,Wilhelm; James E.,9994,0,9999,5
1715660988590,BISP 197,002,658904,Coleman; Aaron B.,9998,0,9999,1
1715660989617,CAT 124RS,A01,519847,Geibel; William,0,0,20,20
1715660990646,CAT 125RS,A01,515971,Geibel; William,0,0,20,20
1715660991672,CLRE 250,A00,511389,Morris; Sheldon,9992,0,9999,7
1715660992704,CLRE 251,A00,507176,Mehta; Ravindra L.,9992,0,9999,7
1715660992704,CLRE 251,B00,511410,Mehta; Ravindra L.,9998,0,9999,1
1715660993729,CLRE 252,A00,507189,Cuomo; Raphael Eduardo,9994,0,9999,5
1715660994754,CLRE 253,A00,507199,Vaida; Florin,9994,0,9999,5
1715660994754,CLRE 253,B00,507202,Vaida; Florin,9999,0,9999,0
1715660995782,CLRE 259,A00,507211,Patel; Hemal,9996,0,9999,3
1715660996808,CLRE 260,A00,507221,Cuomo; Raphael Eduardo,9999,0,9999,0
1715660997833,CLRE 297,001,507242,Cuomo; Raphael Eduardo,9999,0,9999,0
1715660998860,COGS 197,001,638244,Voytek; Bradley Thomas,9997,0,9999,2
1715660999886,CSE 191,A00,516875,Minnes Kemp; Mor Mia,9991,0,9999,8
1715661000911,CSE 197,001,637388,Minnes Kemp; Mor Mia,9992,0,9999,7
1715661001943,CSS 201S,A01,494383,Mignozzetti; Umberto,35,0,35,0
1715661002984,CSS 202S,A01,494387,Mignozzetti; Umberto,35,0,35,0
1715661004013,DSC 197,001,628532,Eldridge; Justin Matthew,9995,0,9999,4
1715661005041,EAP 100,A00,516065,Staff,9799,0,9999,200
1715661006072,ECE 45,A01,507414,Staff,32,0,60,28
1715661008123,ECE 111,A01,507420,Staff,11,0,50,39
1715661009152,ECE 197,001,548057,Sievenpiper; Daniel F.,9991,0,9999,8
1715661010178,EDS 115,A00,507243,Choi; Bailey Miyeon,6,0,28,22
1715661011203,EDS 117,A01,494379,Staff,0,6,34,35
1715661012236,EDS 125,A00,507246,Hopkins; Megan Beth,7,0,30,23
1715661013263,EDS 128A,A01,507264,Fargason; Sharon Gayle,5,0,26,21
1715661014289,EDS 128B,A01,507293,Pappas; Elizabeth,9,0,30,21
1715661015316,EDS 139,A00,507294,Fargason; Sharon Gayle,9,0,30,21
1715661015316,EDS 139,B00,507313,Pappas; Elizabeth,9,0,30,21
1715661016343,EDS 201,A00,507315,Staff,10,0,30,20
1715661017370,EDS 203,A01,507317,Halter; Christopher P.,10,0,30,20
1715661018399,EDS 204R,A01,507319,Halter; Christopher P.,0,3,30,30
1715661018399,EDS 204R,B01,507331,Heinzman; Erica M.,14,0,30,16
1715661019426,EDS 206R,A00,507332,Staff,0,4,30,30
1715661019426,EDS 206R,B00,507343,Staff,15,0,30,15
1715661020450,EDS 250,A00,507344,Hemans; Patricia Ann Benitez,20,0,40,20
1715661021476,EDS 281,A00,507345,Daly; Alan J.,18,0,18,0
1715661022501,EDS 284,A00,507350,Daly; Alan J.,16,0,16,0
1715661023530,EDS 286,A00,507359,Fine; Sarah,18,0,18,0
1715661024555,EDS 289C,A01,507361,Daly; Alan J.,18,0,18,0
1715661025584,EDS 290,A00,507366,Hofstetter; Carolyn,15,0,15,0
1715661026609,LIGM 5A,A00,507421,Fischer-Grunski; Eva K,17,0,20,3
1715661027638,LIGM 5B,A00,507423,Fischer-Grunski; Eva K,19,0,20,1
1715661028662,LIGM 5C,A00,507425,Fischer-Grunski; Eva K,19,0,20,1
1715661029688,LIIT 5AS,A00,507427,Carnelos; Chiara,20,0,20,0
1715661030718,LIIT 5BS,A00,507430,Carnelos; Chiara,20,0,20,0
1715661031743,LIIT 5CS,A00,507432,Carnelos; Chiara,20,0,20,0
1715661032769,LISP 5A,A00,507541,Munoz Sanchez; Alicia,11,0,20,9
1715661033793,LISP 5B,A00,507671,Munoz Sanchez; Alicia,8,0,20,12
1715661034873,LISP 5C,A00,507696,Munoz Sanchez; Alicia,7,0,20,13
1715661035902,MAE 197,001,528363,Boechler; Nicholas Sebastia,9998,0,9999,1
1715661036933,MATH 197,001,523477,Kedlaya; Kiran S.,9994,0,9999,5
1715661036933,MATH 197,002,563811,Zhang; Danna,9994,0,9999,5
1715661036933,MATH 197,003,628552,Dumitriu; Ioana,9998,0,9999,1
1715661036933,MATH 197,004,660885,Floyd; Eric,9998,0,9999,1
1715661037959,MCWP 40R,A00,518780,Staff,1,0,20,19
1715661037959,MCWP 40R,B00,518781,Carter; Jennifer A,9,0,20,11
1715661037959,MCWP 40R,C00,518783,Smith; Haydee Marie,5,0,20,15
1715661038986,MCWP 50R,A00,518791,Redela; Pamela Morgan,0,1,20,20
1715661038986,MCWP 50R,B00,518792,Krone; Jarret,0,2,20,20
1715661038986,MCWP 50R,C00,518793,Staff,0,4,20,20
1715661038986,MCWP 50R,D00,518794,Morshed; Michael James,0,2,20,20
1715661038986,MCWP 50R,E00,518795,Carter; Andrea L,0,2,20,20
1715661038986,MCWP 50R,F00,518796,Miller; Elizabeth Deen,0,1,20,20
1715661038986,MCWP 50R,G00,518797,Guillen; Melinda,0,1,20,20
1715661040014,MMW 12R,A01,514034,Herbst; Matthew,0,2,16,16
1715661040014,MMW 12R,A02,514035,Herbst; Matthew,0,0,16,16
1715661041044,MMW 13R,A01,514037,Staff,0,5,16,16
1715661041044,MMW 13R,A02,514039,Staff,0,5,16,16
1715661041044,MMW 13R,A03,628519,Staff,0,4,16,16
1715661043097,SIO 295LS,A00,523233,Staff,10,0,30,20
1715661044121,SIO 295S,A00,523232,Staff,10,0,30,20
1715661045149,SIOC 290S,A01,637330,Merrifield; Mark A,21,0,30,9
1715661046176,SIOC 291S,A01,637333,Gabriel; Corey John,21,0,30,9
1715661047204,SOCI 117,A01,494376,Staff,0,5,5,5
1715661048232,WES 237B,A00,494380,Staff,10,0,20,10
1715661050313,AESE 279B,A00,494370,Wade; Jon P,0,0,33,33
1715661051341,AIP 97,001,660915,Van Den Einde; Yael Dahlia,9998,0,9999,1
1715661052369,AIP 197,001,627712,Vespa; Emanuel Ignacio,9995,0,9999,4
1715661052369,AIP 197,002,650778,Amir; On,9998,0,9999,1
1715661052369,AIP 197,003,650933,Avenancio-Leon; Carlos,9998,0,9999,1
1715661052369,AIP 197,004,658530,Heyman; Gail D.,9998,0,9999,1
1715661052369,AIP 197,005,658631,Neal; Sonya E,9998,0,9999,1
1715661052369,AIP 197,006,658671,Du; Songzi,9998,0,9999,1
1715661053394,ANAR 135S,A00,494369,Braswell; Geoffrey E.,0,0,0,0
1715661054422,BENG 196,001,628496,Engler; Adam J.,9998,0,9999,1
1715661054422,BENG 196,002,660916,Watson; John Thomas,9998,0,9999,1
1715661055452,BISP 197,001,650773,Wilhelm; James E.,9994,0,9999,5
1715661055452,BISP 197,002,658904,Coleman; Aaron B.,9998,0,9999,1
1715661056479,CAT 124RS,A01,519847,Geibel; William,0,0,20,20
1715661057505,CAT 125RS,A01,515971,Geibel; William,0,0,20,20
1715661058532,CLRE 250,A00,511389,Morris; Sheldon,9992,0,9999,7
1715661059565,CLRE 251,A00,507176,Mehta; Ravindra L.,9992,0,9999,7
1715661059565,CLRE 251,B00,511410,Mehta; Ravindra L.,9998,0,9999,1
1715661060590,CLRE 252,A00,507189,Cuomo; Raphael Eduardo,9994,0,9999,5
1715661061616,CLRE 253,A00,507199,Vaida; Florin,9994,0,9999,5
1715661061616,CLRE 253,B00,507202,Vaida; Florin,9999,0,9999,0
1715661062645,CLRE 259,A00,507211,Patel; Hemal,9996,0,9999,3
1715661063672,CLRE 260,A00,507221,Cuomo; Raphael Eduardo,9999,0,9999,0
1715661064697,CLRE 297,001,507242,Cuomo; Raphael Eduardo,9999,0,9999,0
1715661065736,COGS 197,001,638244,Voytek; Bradley Thomas,9997,0,9999,2
1715661066761,CSE 191,A00,516875,Minnes Kemp; Mor Mia,9991,0,9999,8
1715661067786,CSE 197,001,637388,Minnes Kemp; Mor Mia,9992,0,9999,7
1715661068817,CSS 201S,A01,494383,Mignozzetti; Umberto,35,0,35,0
1715661069848,CSS 202S,A01,494387,Mignozzetti; Umberto,35,0,35,0
1715661070877,DSC 197,001,628532,Eldridge; Justin Matthew,9995,0,9999,4
1715661071902,EAP 100,A00,516065,Staff,9799,0,9999,200
1715661072933,ECE 45,A01,507414,Staff,32,0,60,28
1715661074991,ECE 111,A01,507420,Staff,11,0,50,39
1715661076024,ECE 197,001,548057,Sievenpiper; Daniel F.,9991,0,9999,8
1715661077051,EDS 115,A00,507243,Choi; Bailey Miyeon,6,0,28,22
1715661078080,EDS 117,A01,494379,Staff,0,6,34,35
1715661079106,EDS 125,A00,507246,Hopkins; Megan Beth,7,0,30,23
1715661080132,EDS 128A,A01,507264,Fargason; Sharon Gayle,5,0,26,21
1715661081160,EDS 128B,A01,507293,Pappas; Elizabeth,9,0,30,21
1715661082186,EDS 139,A00,507294,Fargason; Sharon Gayle,9,0,30,21
1715661082186,EDS 139,B00,507313,Pappas; Elizabeth,9,0,30,21
1715661083212,EDS 201,A00,507315,Staff,10,0,30,20
1715661084238,EDS 203,A01,507317,Halter; Christopher P.,10,0,30,20
1715661085270,EDS 204R,A01,507319,Halter; Christopher P.,0,3,30,30
1715661085270,EDS 204R,B01,507331,Heinzman; Erica M.,14,0,30,16
1715661086296,EDS 206R,A00,507332,Staff,0,4,30,30
1715661086296,EDS 206R,B00,507343,Staff,15,0,30,15
1715661087322,EDS 250,A00,507344,Hemans; Patricia Ann Benitez,20,0,40,20
1715661088350,EDS 281,A00,507345,Daly; Alan J.,18,0,18,0
1715661089376,EDS 284,A00,507350,Daly; Alan J.,16,0,16,0
1715661090400,EDS 286,A00,507359,Fine; Sarah,18,0,18,0
1715661091428,EDS 289C,A01,507361,Daly; Alan J.,18,0,18,0
1715661092453,EDS 290,A00,507366,Hofstetter; Carolyn,15,0,15,0
1715661093483,LIGM 5A,A00,507421,Fischer-Grunski; Eva K,17,0,20,3
1715661094512,LIGM 5B,A00,507423,Fischer-Grunski; Eva K,19,0,20,1
1715661095538,LIGM 5C,A00,507425,Fischer-Grunski; Eva K,19,0,20,1
1715661096567,LIIT 5AS,A00,507427,Carnelos; Chiara,20,0,20,0
1715661097595,LIIT 5BS,A00,507430,Carnelos; Chiara,20,0,20,0
1715661098623,LIIT 5CS,A00,507432,Carnelos; Chiara,20,0,20,0
1715661099650,LISP 5A,A00,507541,Munoz Sanchez; Alicia,11,0,20,9
1715661100675,LISP 5B,A00,507671,Munoz Sanchez; Alicia,8,0,20,12
1715661101702,LISP 5C,A00,507696,Munoz Sanchez; Alicia,7,0,20,13
1715661102728,MAE 197,001,528363,Boechler; Nicholas Sebastia,9998,0,9999,1
1715661103762,MATH 197,001,523477,Kedlaya; Kiran S.,9994,0,9999,5
1715661103762,MATH 197,002,563811,Zhang; Danna,9994,0,9999,5
1715661103762,MATH 197,003,628552,Dumitriu; Ioana,9998,0,9999,1
1715661103762,MATH 197,004,660885,Floyd; Eric,9998,0,9999,1
1715661104791,MCWP 40R,A00,518780,Staff,1,0,20,19
1715661104791,MCWP 40R,B00,518781,Carter; Jennifer A,9,0,20,11
1715661104791,MCWP 40R,C00,518783,Smith; Haydee Marie,5,0,20,15
1715661105827,MCWP 50R,A00,518791,Redela; Pamela Morgan,0,1,20,20
1715661105827,MCWP 50R,B00,518792,Krone; Jarret,0,2,20,20
1715661105827,MCWP 50R,C00,518793,Staff,0,4,20,20
1715661105827,MCWP 50R,D00,518794,Morshed; Michael James,0,2,20,20
1715661105827,MCWP 50R,E00,518795,Carter; Andrea L,0,2,20,20
1715661105827,MCWP 50R,F00,518796,Miller; Elizabeth Deen,0,1,20,20
1715661105827,MCWP 50R,G00,518797,Guillen; Melinda,0,1,20,20
1715661106852,MMW 12R,A01,514034,Herbst; Matthew,0,2,16,16
1715661106852,MMW 12R,A02,514035,Herbst; Matthew,0,0,16,16
1715661107883,MMW 13R,A01,514037,Staff,0,5,16,16
1715661107883,MMW 13R,A02,514039,Staff,0,5,16,16
1715661107883,MMW 13R,A03,628519,Staff,0,4,16,16
1715661109932,SIO 295LS,A00,523233,Staff,10,0,30,20
1715661110960,SIO 295S,A00,523232,Staff,10,0,30,20
1715661111991,SIOC 290S,A01,637330,Merrifield; Mark A,21,0,30,9
1715661113021,SIOC 291S,A01,637333,Gabriel; Corey John,21,0,30,9
1715661114048,SOCI 117,A01,494376,Staff,0,5,5,5
1715661115074,WES 237B,A00,494380,Staff,10,0,20,10
1715661117143,AESE 279B,A00,494370,Wade; Jon P,0,0,33,33
1715661118172,AIP 97,001,660915,Van Den Einde; Yael Dahlia,9998,0,9999,1
1715661119201,AIP 197,001,627712,Vespa; Emanuel Ignacio,9995,0,9999,4
1715661119201,AIP 197,002,650778,Amir; On,9998,0,9999,1
1715661119201,AIP 197,003,650933,Avenancio-Leon; Carlos,9998,0,9999,1
1715661119201,AIP 197,004,658530,Heyman; Gail D.,9998,0,9999,1
1715661119201,AIP 197,005,658631,Neal; Sonya E,9998,0,9999,1
1715661119201,AIP 197,006,658671,Du; Songzi,9998,0,9999,1
1715661120228,ANAR 135S,A00,494369,Braswell; Geoffrey E.,0,0,0,0
1715661121259,BENG 196,001,628496,Engler; Adam J.,9998,0,9999,1
1715661121259,BENG 196,002,660916,Watson; John Thomas,9998,0,9999,1
1715661122284,BISP 197,001,650773,Wilhelm; James E.,9994,0,9999,5
1715661122284,BISP 197,002,658904,Coleman; Aaron B.,9998,0,9999,1
1715661123316,CAT 124RS,A01,519847,Geibel; William,0,0,20,20
1715661124341,CAT 125RS,A01,515971,Geibel; William,0,0,20,20
1715661125372,CLRE 250,A00,511389,Morris; Sheldon,9992,0,9999,7
1715661126400,CLRE 251,A00,507176,Mehta; Ravindra L.,9992,0,9999,7
1715661126400,CLRE 251,B00,511410,Mehta; Ravindra L.,9998,0,9999,1
1715661127430,CLRE 252,A00,507189,Cuomo; Raphael Eduardo,9994,0,9999,5
1715661128460,CLRE 253,A00,507199,Vaida; Florin,9994,0,9999,5
1715661128460,CLRE 253,B00,507202,Vaida; Florin,9999,0,9999,0
1715661129485,CLRE 259,A00,507211,Patel; Hemal,9996,0,9999,3
1715661130515,CLRE 260,A00,507221,Cuomo; Raphael Eduardo,9999,0,9999,0
1715661131543,CLRE 297,001,507242,Cuomo; Raphael Eduardo,9999,0,9999,0
1715661132574,COGS 197,001,638244,Voytek; Bradley Thomas,9997,0,9999,2
1715661133600,CSE 191,A00,516875,Minnes Kemp; Mor Mia,9991,0,9999,8
1715661134630,CSE 197,001,637388,Minnes Kemp; Mor Mia,9992,0,9999,7
1715661135657,CSS 201S,A01,494383,Mignozzetti; Umberto,35,0,35,0
1715661136682,CSS 202S,A01,494387,Mignozzetti; Umberto,35,0,35,0
1715661137710,DSC 197,001,628532,Eldridge; Justin Matthew,9995,0,9999,4
1715661138800,EAP 100,A00,516065,Staff,9799,0,9999,200
1715661139832,ECE 45,A01,507414,Staff,32,0,60,28
1715661141882,ECE 111,A01,507420,Staff,11,0,50,39
1715661142909,ECE 197,001,548057,Sievenpiper; Daniel F.,9991,0,9999,8
1715661143937,EDS 115,A00,507243,Choi; Bailey Miyeon,6,0,28,22
1715661144965,EDS 117,A01,494379,Staff,0,6,34,35
1715661145992,EDS 125,A00,507246,Hopkins; Megan Beth,7,0,30,23
1715661147022,EDS 128A,A01,507264,Fargason; Sharon Gayle,5,0,26,21
1715661148050,EDS 128B,A01,507293,Pappas; Elizabeth,9,0,30,21
1715661149078,EDS 139,A00,507294,Fargason; Sharon Gayle,9,0,30,21
1715661149078,EDS 139,B00,507313,Pappas; Elizabeth,9,0,30,21
1715661150106,EDS 201,A00,507315,Staff,10,0,30,20
1715661151136,EDS 203,A01,507317,Halter; Christopher P.,10,0,30,20
1715661152161,EDS 204R,A01,507319,Halter; Christopher P.,0,3,30,30
1715661152161,EDS 204R,B01,507331,Heinzman; Erica M.,14,0,30,16
1715661153188,EDS 206R,A00,507332,Staff,0,4,30,30
1715661153188,EDS 206R,B00,507343,Staff,15,0,30,15
1715661154217,EDS 250,A00,507344,Hemans; Patricia Ann Benitez,20,0,40,20
1715661155244,EDS 281,A00,507345,Daly; Alan J.,18,0,18,0
1715661156269,EDS 284,A00,507350,Daly; Alan J.,16,0,16,0
1715661157298,EDS 286,A00,507359,Fine; Sarah,18,0,18,0
1715661158323,EDS 289C,A01,507361,Daly; Alan J.,18,0,18,0
1715661159355,EDS 290,A00,507366,Hofstetter; Carolyn,15,0,15,0
1715661160382,LIGM 5A,A00,507421,Fischer-Grunski; Eva K,17,0,20,3
1715661161407,LIGM 5B,A00,507423,Fischer-Grunski; Eva K,19,0,20,1
1715661162436,LIGM 5C,A00,507425,Fischer-Grunski; Eva K,19,0,20,1
1715661163466,LIIT 5AS,A00,507427,Carnelos; Chiara,20,0,20,0
1715661164492,LIIT 5BS,A00,507430,Carnelos; Chiara,20,0,20,0
1715661165521,LIIT 5CS,A00,507432,Carnelos; Chiara,20,0,20,0
1715661166547,LISP 5A,A00,507541,Munoz Sanchez; Alicia,11,0,20,9
1715661167572,LISP 5B,A00,507671,Munoz Sanchez; Alicia,8,0,20,12
1715661168601,LISP 5C,A00,507696,Munoz Sanchez; Alicia,7,0,20,13
1715661169628,MAE 197,001,528363,Boechler; Nicholas Sebastia,9998,0,9999,1
1715661170656,MATH 197,001,523477,Kedlaya; Kiran S.,9994,0,9999,5
1715661170656,MATH 197,002,563811,Zhang; Danna,9994,0,9999,5
1715661170656,MATH 197,003,628552,Dumitriu; Ioana,9998,0,9999,1
1715661170656,MATH 197,004,660885,Floyd; Eric,9998,0,9999,1
1715661171683,MCWP 40R,A00,518780,Staff,1,0,20,19
1715661171683,MCWP 40R,B00,518781,Carter; Jennifer A,9,0,20,11
1715661171683,MCWP 40R,C00,518783,Smith; Haydee Marie,5,0,20,15
1715661172715,MCWP 50R,A00,518791,Redela; Pamela Morgan,0,1,20,20
1715661172715,MCWP 50R,B00,518792,Krone; Jarret,0,2,20,20
1715661172715,MCWP 50R,C00,518793,Staff,0,4,20,20
1715661172715,MCWP 50R,D00,518794,Morshed; Michael James,0,2,20,20
1715661172715,MCWP 50R,E00,518795,Carter; Andrea L,0,2,20,20
1715661172715,MCWP 50R,F00,518796,Miller; Elizabeth Deen,0,1,20,20
1715661172715,MCWP 50R,G00,518797,Guillen; Melinda,0,1,20,20
1715661173742,MMW 12R,A01,514034,Herbst; Matthew,0,2,16,16
1715661173742,MMW 12R,A02,514035,Herbst; Matthew,0,0,16,16
1715661174768,MMW 13R,A01,514037,Staff,0,5,16,16
1715661174768,MMW 13R,A02,514039,Staff,0,5,16,16
1715661174768,MMW 13R,A03,628519,Staff,0,4,16,16
1715661176819,SIO 295LS,A00,523233,Staff,10,0,30,20
1715661177845,SIO 295S,A00,523232,Staff,10,0,30,20
1715661178873,SIOC 290S,A01,637330,Merrifield; Mark A,21,0,30,9
1715661179904,SIOC 291S,A01,637333,Gabriel; Corey John,21,0,30,9
1715661180931,SOCI 117,A01,494376,Staff,0,5,5,5
1715661181958,WES 237B,A00,494380,Staff,10,0,20,10
1715661184028,AESE 279B,A00,494370,Wade; Jon P,0,0,33,33
1715661185054,AIP 97,001,660915,Van Den Einde; Yael Dahlia,9998,0,9999,1
1715661186083,AIP 197,001,627712,Vespa; Emanuel Ignacio,9995,0,9999,4
1715661186083,AIP 197,002,650778,Amir; On,9998,0,9999,1
1715661186083,AIP 197,003,650933,Avenancio-Leon; Carlos,9998,0,9999,1
1715661186083,AIP 197,004,658530,Heyman; Gail D.,9998,0,9999,1
1715661186083,AIP 197,005,658631,Neal; Sonya E,9998,0,9999,1
1715661186083,AIP 197,006,658671,Du; Songzi,9998,0,9999,1
1715661187113,ANAR 135S,A00,494369,Braswell; Geoffrey E.,0,0,0,0
1715661188140,BENG 196,001,628496,Engler; Adam J.,9998,0,9999,1
1715661188140,BENG 196,002,660916,Watson; John Thomas,9998,0,9999,1
1715661189167,BISP 197,001,650773,Wilhelm; James E.,9994,0,9999,5
1715661189167,BISP 197,002,658904,Coleman; Aaron B.,9998,0,9999,1
1715661190194,CAT 124RS,A01,519847,Geibel; William,0,0,20,20
1715661191218,CAT 125RS,A01,515971,Geibel; William,0,0,20,20
1715661192244,CLRE 250,A00,511389,Morris; Sheldon,9992,0,9999,7
1715661193276,CLRE 251,A00,507176,Mehta; Ravindra L.,9992,0,9999,7
1715661193276,CLRE 251,B00,511410,Mehta; Ravindra L.,9998,0,9999,1
1715661194302,CLRE 252,A00,507189,Cuomo; Raphael Eduardo,9994,0,9999,5
1715661195327,CLRE 253,A00,507199,Vaida; Florin,9994,0,9999,5
1715661195327,CLRE 253,B00,507202,Vaida; Florin,9999,0,9999,0
1715661196352,CLRE 259,A00,507211,Patel; Hemal,9996,0,9999,3
1715661197375,CLRE 260,A00,507221,Cuomo; Raphael Eduardo,9999,0,9999,0
1715661198399,CLRE 297,001,507242,Cuomo; Raphael Eduardo,9999,0,9999,0
1715661199428,COGS 197,001,638244,Voytek; Bradley Thomas,9997,0,9999,2
1715661200454,CSE 191,A00,516875,Minnes Kemp; Mor Mia,9991,0,9999,8
1715661201481,CSE 197,001,637388,Minnes Kemp; Mor Mia,9992,0,9999,7
1715661202508,CSS 201S,A01,494383,Mignozzetti; Umberto,35,0,35,0
1715661203531,CSS 202S,A01,494387,Mignozzetti; Umberto,35,0,35,0
1715661204556,DSC 197,001,628532,Eldridge; Justin Matthew,9995,0,9999,4
1715661205580,EAP 100,A00,516065,Staff,9799,0,9999,200
1715661206607,ECE 45,A01,507414,Staff,32,0,60,28
1715661208664,ECE 111,A01,507420,Staff,11,0,50,39
1715661209690,ECE 197,001,548057,Sievenpiper; Daniel F.,9991,0,9999,8
1715661210716,EDS 115,A00,507243,Choi; Bailey Miyeon,6,0,28,22
1715661211743,EDS 117,A01,494379,Staff,0,6,34,35
1715661212773,EDS 125,A00,507246,Hopkins; Megan Beth,7,0,30,23
1715661213802,EDS 128A,A01,507264,Fargason; Sharon Gayle,5,0,26,21
1715661214828,EDS 128B,A01,507293,Pappas; Elizabeth,9,0,30,21
1715661215853,EDS 139,A00,507294,Fargason; Sharon Gayle,9,0,30,21
1715661215853,EDS 139,B00,507313,Pappas; Elizabeth,9,0,30,21
1715661216878,EDS 201,A00,507315,Staff,10,0,30,20
1715661217906,EDS 203,A01,507317,Halter; Christopher P.,10,0,30,20
1715661218936,EDS 204R,A01,507319,Halter; Christopher P.,0,3,30,30
1715661218936,EDS 204R,B01,507331,Heinzman; Erica M.,14,0,30,16
1715661219964,EDS 206R,A00,507332,Staff,0,4,30,30
1715661219964,EDS 206R,B00,507343,Staff,15,0,30,15
1715661220995,EDS 250,A00,507344,Hemans; Patricia Ann Benitez,20,0,40,20
1715661222024,EDS 281,A00,507345,Daly; Alan J.,18,0,18,0
1715661223050,EDS 284,A00,507350,Daly; Alan J.,16,0,16,0
1715661224076,EDS 286,A00,507359,Fine; Sarah,18,0,18,0
1715661225158,EDS 289C,A01,507361,Daly; Alan J.,18,0,18,0
1715661226186,EDS 290,A00,507366,Hofstetter; Carolyn,15,0,15,0
1715661227213,LIGM 5A,A00,507421,Fischer-Grunski; Eva K,17,0,20,3
1715661228240,LIGM 5B,A00,507423,Fischer-Grunski; Eva K,19,0,20,1
1715661229265,LIGM 5C,A00,507425,Fischer-Grunski; Eva K,19,0,20,1
1715661230294,LIIT 5AS,A00,507427,Carnelos; Chiara,20,0,20,0
1715661231321,LIIT 5BS,A00,507430,Carnelos; Chiara,20,0,20,0
1715661232347,LIIT 5CS,A00,507432,Carnelos; Chiara,20,0,20,0
1715661233417,LISP 5A,A00,507541,Munoz Sanchez; Alicia,11,0,20,9
1715661234442,LISP 5B,A00,507671,Munoz Sanchez; Alicia,8,0,20,12
1715661235474,LISP 5C,A00,507696,Munoz Sanchez; Alicia,7,0,20,13
1715661236502,MAE 197,001,528363,Boechler; Nicholas Sebastia,9998,0,9999,1
1715661237536,MATH 197,001,523477,Kedlaya; Kiran S.,9994,0,9999,5
1715661237536,MATH 197,002,563811,Zhang; Danna,9994,0,9999,5
1715661237536,MATH 197,003,628552,Dumitriu; Ioana,9998,0,9999,1
1715661237536,MATH 197,004,660885,Floyd; Eric,9998,0,9999,1
1715661238561,MCWP 40R,A00,518780,Staff,1,0,20,19
1715661238561,MCWP 40R,B00,518781,Carter; Jennifer A,9,0,20,11
1715661238561,MCWP 40R,C00,518783,Smith; Haydee Marie,5,0,20,15
1715661239592,MCWP 50R,A00,518791,Redela; Pamela Morgan,0,1,20,20
1715661239592,MCWP 50R,B00,518792,Krone; Jarret,0,2,20,20
1715661239592,MCWP 50R,C00,518793,Staff,0,4,20,20
1715661239592,MCWP 50R,D00,518794,Morshed; Michael James,0,2,20,20
1715661239592,MCWP 50R,E00,518795,Carter; Andrea L,0,2,20,20
1715661239592,MCWP 50R,F00,518796,Miller; Elizabeth Deen,0,1,20,20
1715661239592,MCWP 50R,G00,518797,Guillen; Melinda,0,1,20,20
1715661240620,MMW 12R,A01,514034,Herbst; Matthew,0,2,16,16
1715661240620,MMW 12R,A02,514035,Herbst; Matthew,0,0,16,16
1715661241649,MMW 13R,A01,514037,Staff,0,5,16,16
1715661241649,MMW 13R,A02,514039,Staff,0,5,16,16
1715661241649,MMW 13R,A03,628519,Staff,0,4,16,16
1715661243701,SIO 295LS,A00,523233,Staff,10,0,30,20
1715661244726,SIO 295S,A00,523232,Staff,10,0,30,20
1715661245756,SIOC 290S,A01,637330,Merrifield; Mark A,21,0,30,9
1715661246784,SIOC 291S,A01,637333,Gabriel; Corey John,21,0,30,9
1715661247809,SOCI 117,A01,494376,Staff,0,5,5,5
1715661248835,WES 237B,A00,494380,Staff,10,0,20,10
1715661250913,AESE 279B,A00,494370,Wade; Jon P,0,0,33,33
1715661251939,AIP 97,001,660915,Van Den Einde; Yael Dahlia,9998,0,9999,1
1715661252972,AIP 197,001,627712,Vespa; Emanuel Ignacio,9995,0,9999,4
1715661252972,AIP 197,002,650778,Amir; On,9998,0,9999,1
1715661252972,AIP 197,003,650933,Avenancio-Leon; Carlos,9998,0,9999,1
1715661252972,AIP 197,004,658530,Heyman; Gail D.,9998,0,9999,1
1715661252972,AIP 197,005,658631,Neal; Sonya E,9998,0,9999,1
1715661252972,AIP 197,006,658671,Du; Songzi,9998,0,9999,1
1715661253997,ANAR 135S,A00,494369,Braswell; Geoffrey E.,0,0,0,0
1715661255027,BENG 196,001,628496,Engler; Adam J.,9998,0,9999,1
1715661255027,BENG 196,002,660916,Watson; John Thomas,9998,0,9999,1
1715661256068,BISP 197,001,650773,Wilhelm; James E.,9994,0,9999,5
1715661256068,BISP 197,002,658904,Coleman; Aaron B.,9998,0,9999,1
1715661257098,CAT 124RS,A01,519847,Geibel; William,0,0,20,20
1715661258124,CAT 125RS,A01,515971,Geibel; William,0,0,20,20
1715661259149,CLRE 250,A00,511389,Morris; Sheldon,9992,0,9999,7
1715661260179,CLRE 251,A00,507176,Mehta; Ravindra L.,9992,0,9999,7
1715661260179,CLRE 251,B00,511410,Mehta; Ravindra L.,9998,0,9999,1
1715661261209,CLRE 252,A00,507189,Cuomo; Raphael Eduardo,9994,0,9999,5
1715661262237,CLRE 253,A00,507199,Vaida; Florin,9994,0,9999,5
1715661262237,CLRE 253,B00,507202,Vaida; Florin,9999,0,9999,0
1715661263262,CLRE 259,A00,507211,Patel; Hemal,9996,0,9999,3
1715661264287,CLRE 260,A00,507221,Cuomo; Raphael Eduardo,9999,0,9999,0
1715661265312,CLRE 297,001,507242,Cuomo; Raphael Eduardo,9999,0,9999,0
1715661266338,COGS 197,001,638244,Voytek; Bradley Thomas,9997,0,9999,2
1715661267364,CSE 191,A00,516875,Minnes Kemp; Mor Mia,9991,0,9999,8
1715661268389,CSE 197,001,637388,Minnes Kemp; Mor Mia,9992,0,9999,7
1715661269420,CSS 201S,A01,494383,Mignozzetti; Umberto,35,0,35,0
1715661270447,CSS 202S,A01,494387,Mignozzetti; Umberto,35,0,35,0
1715661271471,DSC 197,001,628532,Eldridge; Justin Matthew,9995,0,9999,4
1715661272499,EAP 100,A00,516065,Staff,9799,0,9999,200
1715661273527,ECE 45,A01,507414,Staff,32,0,60,28
1715661275577,ECE 111,A01,507420,Staff,11,0,50,39
1715661276605,ECE 197,001,548057,Sievenpiper; Daniel F.,9991,0,9999,8
1715661277636,EDS 115,A00,507243,Choi; Bailey Miyeon,6,0,28,22
1715661278664,EDS 117,A01,494379,Staff,0,6,34,35
1715661279693,EDS 125,A00,507246,Hopkins; Megan Beth,7,0,30,23
1715661280723,EDS 128A,A01,507264,Fargason; Sharon Gayle,5,0,26,21
1715661281750,EDS 128B,A01,507293,Pappas; Elizabeth,9,0,30,21
1715661282776,EDS 139,A00,507294,Fargason; Sharon Gayle,9,0,30,21
1715661282776,EDS 139,B00,507313,Pappas; Elizabeth,9,0,30,21
1715661283800,EDS 201,A00,507315,Staff,10,0,30,20
1715661284826,EDS 203,A01,507317,Halter; Christopher P.,10,0,30,20
1715661285852,EDS 204R,A01,507319,Halter; Christopher P.,0,3,30,30
1715661285852,EDS 204R,B01,507331,Heinzman; Erica M.,14,0,30,16
1715661286877,EDS 206R,A00,507332,Staff,0,4,30,30
1715661286877,EDS 206R,B00,507343,Staff,15,0,30,15
1715661287906,EDS 250,A00,507344,Hemans; Patricia Ann Benitez,20,0,40,20
1715661288931,EDS 281,A00,507345,Daly; Alan J.,18,0,18,0
1715661289956,EDS 284,A00,507350,Daly; Alan J.,16,0,16,0
1715661290981,EDS 286,A00,507359,Fine; Sarah,18,0,18,0
1715661292006,EDS 289C,A01,507361,Daly; Alan J.,18,0,18,0
1715661293030,EDS 290,A00,507366,Hofstetter; Carolyn,15,0,15,0
1715661294061,LIGM 5A,A00,507421,Fischer-Grunski; Eva K,17,0,20,3
1715661295088,LIGM 5B,A00,507423,Fischer-Grunski; Eva K,19,0,20,1
1715661296112,LIGM 5C,A00,507425,Fischer-Grunski; Eva K,19,0,20,1
1715661297137,LIIT 5AS,A00,507427,Carnelos; Chiara,20,0,20,0
1715661298166,LIIT 5BS,A00,507430,Carnelos; Chiara,20,0,20,0
1715661299191,LIIT 5CS,A00,507432,Carnelos; Chiara,20,0,20,0
1715661300217,LISP 5A,A00,507541,Munoz Sanchez; Alicia,11,0,20,9
1715661301242,LISP 5B,A00,507671,Munoz Sanchez; Alicia,8,0,20,12
1715661302271,LISP 5C,A00,507696,Munoz Sanchez; Alicia,7,0,20,13
1715661303301,MAE 197,001,528363,Boechler; Nicholas Sebastia,9998,0,9999,1
1715661304328,MATH 197,001,523477,Kedlaya; Kiran S.,9994,0,9999,5
1715661304328,MATH 197,002,563811,Zhang; Danna,9994,0,9999,5
1715661304328,MATH 197,003,628552,Dumitriu; Ioana,9998,0,9999,1
1715661304328,MATH 197,004,660885,Floyd; Eric,9998,0,9999,1
1715661305360,MCWP 40R,A00,518780,Staff,1,0,20,19
1715661305360,MCWP 40R,B00,518781,Carter; Jennifer A,9,0,20,11
1715661305360,MCWP 40R,C00,518783,Smith; Haydee Marie,5,0,20,15
1715661306389,MCWP 50R,A00,518791,Redela; Pamela Morgan,0,1,20,20
1715661306389,MCWP 50R,B00,518792,Krone; Jarret,0,2,20,20
1715661306389,MCWP 50R,C00,518793,Staff,0,4,20,20
1715661306389,MCWP 50R,D00,518794,Morshed; Michael James,0,2,20,20
1715661306389,MCWP 50R,E00,518795,Carter; Andrea L,0,2,20,20
1715661306389,MCWP 50R,F00,518796,Miller; Elizabeth Deen,0,1,20,20
1715661306389,MCWP 50R,G00,518797,Guillen; Melinda,0,1,20,20
1715661307413,MMW 12R,A01,514034,Herbst; Matthew,0,2,16,16
1715661307413,MMW 12R,A02,514035,Herbst; Matthew,0,0,16,16
1715661308444,MMW 13R,A01,514037,Staff,0,5,16,16
1715661308444,MMW 13R,A02,514039,Staff,0,5,16,16
1715661308444,MMW 13R,A03,628519,Staff,0,4,16,16
1715661310499,SIO 295LS,A00,523233,Staff,10,0,30,20
1715661311522,SIO 295S,A00,523232,Staff,10,0,30,20
1715661312551,SIOC 290S,A01,637330,Merrifield; Mark A,21,0,30,9
1715661313577,SIOC 291S,A01,637333,Gabriel; Corey John,21,0,30,9
1715661314602,SOCI 117,A01,494376,Staff,0,5,5,5
1715661315625,WES 237B,A00,494380,Staff,10,0,20,10
1715661317707,AESE 279B,A00,494370,Wade; Jon P,0,0,33,33
1715661318732,AIP 97,001,660915,Van Den Einde; Yael Dahlia,9998,0,9999,1
1715661319765,AIP 197,001,627712,Vespa; Emanuel Ignacio,9995,0,9999,4
1715661319765,AIP 197,002,650778,Amir; On,9998,0,9999,1
1715661319765,AIP 197,003,650933,Avenancio-Leon; Carlos,9998,0,9999,1
1715661319765,AIP 197,004,658530,Heyman; Gail D.,9998,0,9999,1
1715661319765,AIP 197,005,658631,Neal; Sonya E,9998,0,9999,1
1715661319765,AIP 197,006,658671,Du; Songzi,9998,0,9999,1
1715661320796,ANAR 135S,A00,494369,Braswell; Geoffrey E.,0,0,0,0
1715661321826,BENG 196,001,628496,Engler; Adam J.,9998,0,9999,1
1715661321826,BENG 196,002,660916,Watson; John Thomas,9998,0,9999,1
1715661322851,BISP 197,001,650773,Wilhelm; James E.,9994,0,9999,5
1715661322851,BISP 197,002,658904,Coleman; Aaron B.,9998,0,9999,1
1715661323879,CAT 124RS,A01,519847,Geibel; William,0,0,20,20
1715661324907,CAT 125RS,A01,515971,Geibel; William,0,0,20,20
1715661325932,CLRE 250,A00,511389,Morris; Sheldon,9992,0,9999,7
1715661326962,CLRE 251,A00,507176,Mehta; Ravindra L.,9992,0,9999,7
1715661326962,CLRE 251,B00,511410,Mehta; Ravindra L.,9998,0,9999,1
1715661327987,CLRE 252,A00,507189,Cuomo; Raphael Eduardo,9994,0,9999,5
1715661329012,CLRE 253,A00,507199,Vaida; Florin,9994,0,9999,5
1715661329012,CLRE 253,B00,507202,Vaida; Florin,9999,0,9999,0
1715661330037,CLRE 259,A00,507211,Patel; Hemal,9996,0,9999,3
1715661331068,CLRE 260,A00,507221,Cuomo; Raphael Eduardo,9999,0,9999,0
1715661332092,CLRE 297,001,507242,Cuomo; Raphael Eduardo,9999,0,9999,0
1715661333117,COGS 197,001,638244,Voytek; Bradley Thomas,9997,0,9999,2
1715661334142,CSE 191,A00,516875,Minnes Kemp; Mor Mia,9991,0,9999,8
1715661335165,CSE 197,001,637388,Minnes Kemp; Mor Mia,9992,0,9999,7
1715661336195,CSS 201S,A01,494383,Mignozzetti; Umberto,35,0,35,0
1715661337220,CSS 202S,A01,494387,Mignozzetti; Umberto,35,0,35,0
1715661338245,DSC 197,001,628532,Eldridge; Justin Matthew,9995,0,9999,4
1715661339270,EAP 100,A00,516065,Staff,9799,0,9999,200
1715661340302,ECE 45,A01,507414,Staff,32,0,60,28
1715661342355,ECE 111,A01,507420,Staff,11,0,50,39
1715661343382,ECE 197,001,548057,Sievenpiper; Daniel F.,9991,0,9999,8
1715661344408,EDS 115,A00,507243,Choi; Bailey Miyeon,6,0,28,22
1715661345433,EDS 117,A01,494379,Staff,0,6,34,35
1715661346460,EDS 125,A00,507246,Hopkins; Megan Beth,7,0,30,23
1715661347489,EDS 128A,A01,507264,Fargason; Sharon Gayle,5,0,26,21
1715661348515,EDS 128B,A01,507293,Pappas; Elizabeth,9,0,30,21
1715661349545,EDS 139,A00,507294,Fargason; Sharon Gayle,9,0,30,21
1715661349545,EDS 139,B00,507313,Pappas; Elizabeth,9,0,30,21
1715661350570,EDS 201,A00,507315,Staff,10,0,30,20
1715661351600,EDS 203,A01,507317,Halter; Christopher P.,10,0,30,20
1715661352626,EDS 204R,A01,507319,Halter; Christopher P.,0,3,30,30
1715661352626,EDS 204R,B01,507331,Heinzman; Erica M.,14,0,30,16
1715661353652,EDS 206R,A00,507332,Staff,0,4,30,30
1715661353652,EDS 206R,B00,507343,Staff,15,0,30,15
1715661354676,EDS 250,A00,507344,Hemans; Patricia Ann Benitez,20,0,40,20
1715661355704,EDS 281,A00,507345,Daly; Alan J.,18,0,18,0
1715661356728,EDS 284,A00,507350,Daly; Alan J.,16,0,16,0
1715661357753,EDS 286,A00,507359,Fine; Sarah,18,0,18,0
1715661358777,EDS 289C,A01,507361,Daly; Alan J.,18,0,18,0
1715661359804,EDS 290,A00,507366,Hofstetter; Carolyn,15,0,15,0
1715661360829,LIGM 5A,A00,507421,Fischer-Grunski; Eva K,17,0,20,3
1715661361854,LIGM 5B,A00,507423,Fischer-Grunski; Eva K,19,0,20,1
1715661362882,LIGM 5C,A00,507425,Fischer-Grunski; Eva K,19,0,20,1
1715661363911,LIIT 5AS,A00,507427,Carnelos; Chiara,20,0,20,0
1715661364935,LIIT 5BS,A00,507430,Carnelos; Chiara,20,0,20,0
1715661365959,LIIT 5CS,A00,507432,Carnelos; Chiara,20,0,20,0
1715661367010,LISP 5A,A00,507541,Munoz Sanchez; Alicia,11,0,20,9
1715661368036,LISP 5B,A00,507671,Munoz Sanchez; Alicia,8,0,20,12
1715661369063,LISP 5C,A00,507696,Munoz Sanchez; Alicia,7,0,20,13
1715661370089,MAE 197,001,528363,Boechler; Nicholas Sebastia,9998,0,9999,1
1715661371122,MATH 197,001,523477,Kedlaya; Kiran S.,9994,0,9999,5
1715661371122,MATH 197,002,563811,Zhang; Danna,9994,0,9999,5
1715661371122,MATH 197,003,628552,Dumitriu; Ioana,9998,0,9999,1
1715661371122,MATH 197,004,660885,Floyd; Eric,9998,0,9999,1
1715661372155,MCWP 40R,A00,518780,Staff,1,0,20,19
1715661372155,MCWP 40R,B00,518781,Carter; Jennifer A,9,0,20,11
1715661372155,MCWP 40R,C00,518783,Smith; Haydee Marie,5,0,20,15
1715661373182,MCWP 50R,A00,518791,Redela; Pamela Morgan,0,1,20,20
1715661373182,MCWP 50R,B00,518792,Krone; Jarret,0,2,20,20
1715661373182,MCWP 50R,C00,518793,Staff,0,4,20,20
1715661373182,MCWP 50R,D00,518794,Morshed; Michael James,0,2,20,20
1715661373182,MCWP 50R,E00,518795,Carter; Andrea L,0,2,20,20
1715661373182,MCWP 50R,F00,518796,Miller; Elizabeth Deen,0,1,20,20
1715661373182,MCWP 50R,G00,518797,Guillen; Melinda,0,1,20,20
1715661374207,MMW 12R,A01,514034,Herbst; Matthew,0,2,16,16
1715661374207,MMW 12R,A02,514035,Herbst; Matthew,0,0,16,16
1715661375232,MMW 13R,A01,514037,Staff,0,5,16,16
1715661375232,MMW 13R,A02,514039,Staff,0,5,16,16
1715661375232,MMW 13R,A03,628519,Staff,0,4,16,16
1715661377287,SIO 295LS,A00,523233,Staff,10,0,30,20
1715661378316,SIO 295S,A00,523232,Staff,10,0,30,20
1715661379341,SIOC 290S,A01,637330,Merrifield; Mark A,21,0,30,9
1715661380365,SIOC 291S,A01,637333,Gabriel; Corey John,21,0,30,9
1715661381389,SOCI 117,A01,494376,Staff,0,5,5,5
1715661382414,WES 237B,A00,494380,Staff,10,0,20,10
1715661384482,AESE 279B,A00,494370,Wade; Jon P,0,0,33,33
1715661385510,AIP 97,001,660915,Van Den Einde; Yael Dahlia,9998,0,9999,1
1715661386541,AIP 197,001,627712,Vespa; Emanuel Ignacio,9995,0,9999,4
1715661386541,AIP 197,002,650778,Amir; On,9998,0,9999,1
1715661386541,AIP 197,003,650933,Avenancio-Leon; Carlos,9998,0,9999,1
1715661386541,AIP 197,004,658530,Heyman; Gail D.,9998,0,9999,1
1715661386541,AIP 197,005,658631,Neal; Sonya E,9998,0,9999,1
1715661386541,AIP 197,006,658671,Du; Songzi,9998,0,9999,1
1715661387566,ANAR 135S,A00,494369,Braswell; Geoffrey E.,0,0,0,0
1715661388591,BENG 196,001,628496,Engler; Adam J.,9998,0,9999,1
1715661388591,BENG 196,002,660916,Watson; John Thomas,9998,0,9999,1
1715661389618,BISP 197,001,650773,Wilhelm; James E.,9994,0,9999,5
1715661389618,BISP 197,002,658904,Coleman; Aaron B.,9998,0,9999,1
1715661390654,CAT 124RS,A01,519847,Geibel; William,0,0,20,20
1715661391680,CAT 125RS,A01,515971,Geibel; William,0,0,20,20
1715661392713,CLRE 250,A00,511389,Morris; Sheldon,9992,0,9999,7
1715661393740,CLRE 251,A00,507176,Mehta; Ravindra L.,9992,0,9999,7
1715661393740,CLRE 251,B00,511410,Mehta; Ravindra L.,9998,0,9999,1
1715661394769,CLRE 252,A00,507189,Cuomo; Raphael Eduardo,9994,0,9999,5
1715661395798,CLRE 253,A00,507199,Vaida; Florin,9994,0,9999,5
1715661395798,CLRE 253,B00,507202,Vaida; Florin,9999,0,9999,0
1715661396825,CLRE 259,A00,507211,Patel; Hemal,9996,0,9999,3
1715661397850,CLRE 260,A00,507221,Cuomo; Raphael Eduardo,9999,0,9999,0
1715661398878,CLRE 297,001,507242,Cuomo; Raphael Eduardo,9999,0,9999,0
1715661399903,COGS 197,001,638244,Voytek; Bradley Thomas,9997,0,9999,2
1715661400928,CSE 191,A00,516875,Minnes Kemp; Mor Mia,9991,0,9999,8
1715661401952,CSE 197,001,637388,Minnes Kemp; Mor Mia,9992,0,9999,7
1715661402979,CSS 201S,A01,494383,Mignozzetti; Umberto,35,0,35,0
1715661404010,CSS 202S,A01,494387,Mignozzetti; Umberto,35,0,35,0
1715661405034,DSC 197,001,628532,Eldridge; Justin Matthew,9995,0,9999,4
1715661406059,EAP 100,A00,516065,Staff,9799,0,9999,200
1715661407093,ECE 45,A01,507414,Staff,32,0,60,28
1715661409142,ECE 111,A01,507420,Staff,11,0,50,39
1715661410166,ECE 197,001,548057,Sievenpiper; Daniel F.,9991,0,9999,8
1715661411192,EDS 115,A00,507243,Choi; Bailey Miyeon,6,0,28,22
1715661412218,EDS 117,A01,494379,Staff,0,6,34,35
1715661413247,EDS 125,A00,507246,Hopkins; Megan Beth,7,0,30,23
1715661414273,EDS 128A,A01,507264,Fargason; Sharon Gayle,5,0,26,21
1715661415298,EDS 128B,A01,507293,Pappas; Elizabeth,9,0,30,21
1715661416323,EDS 139,A00,507294,Fargason; Sharon Gayle,9,0,30,21
1715661416323,EDS 139,B00,507313,Pappas; Elizabeth,9,0,30,21
1715661417348,EDS 201,A00,507315,Staff,10,0,30,20
1715661418374,EDS 203,A01,507317,Halter; Christopher P.,10,0,30,20
1715661419399,EDS 204R,A01,507319,Halter; Christopher P.,0,3,30,30
1715661419399,EDS 204R,B01,507331,Heinzman; Erica M.,14,0,30,16
1715661420428,EDS 206R,A00,507332,Staff,0,4,30,30
1715661420428,EDS 206R,B00,507343,Staff,15,0,30,15
1715661421452,EDS 250,A00,507344,Hemans; Patricia Ann Benitez,20,0,40,20
1715661422478,EDS 281,A00,507345,Daly; Alan J.,18,0,18,0
1715661423509,EDS 284,A00,507350,Daly; Alan J.,16,0,16,0
1715661424535,EDS 286,A00,507359,Fine; Sarah,18,0,18,0
1715661425616,EDS 289C,A01,507361,Daly; Alan J.,18,0,18,0
1715661426697,EDS 290,A00,507366,Hofstetter; Carolyn,15,0,15,0
1715661427722,LIGM 5A,A00,507421,Fischer-Grunski; Eva K,17,0,20,3
1715661428751,LIGM 5B,A00,507423,Fischer-Grunski; Eva K,19,0,20,1
1715661429778,LIGM 5C,A00,507425,Fischer-Grunski; Eva K,19,0,20,1
1715661430806,LIIT 5AS,A00,507427,Carnelos; Chiara,20,0,20,0
1715661431836,LIIT 5BS,A00,507430,Carnelos; Chiara,20,0,20,0
1715661432860,LIIT 5CS,A00,507432,Carnelos; Chiara,20,0,20,0
1715661433898,LISP 5A,A00,507541,Munoz Sanchez; Alicia,11,0,20,9
1715661434927,LISP 5B,A00,507671,Munoz Sanchez; Alicia,8,0,20,12
1715661435955,LISP 5C,A00,507696,Munoz Sanchez; Alicia,7,0,20,13
1715661436980,MAE 197,001,528363,Boechler; Nicholas Sebastia,9998,0,9999,1
1715661438009,MATH 197,001,523477,Kedlaya; Kiran S.,9994,0,9999,5
1715661438009,MATH 197,002,563811,Zhang; Danna,9994,0,9999,5
1715661438009,MATH 197,003,628552,Dumitriu; Ioana,9998,0,9999,1
1715661438009,MATH 197,004,660885,Floyd; Eric,9998,0,9999,1
1715661439035,MCWP 40R,A00,518780,Staff,1,0,20,19
1715661439035,MCWP 40R,B00,518781,Carter; Jennifer A,9,0,20,11
1715661439035,MCWP 40R,C00,518783,Smith; Haydee Marie,5,0,20,15
1715661440064,MCWP 50R,A00,518791,Redela; Pamela Morgan,0,1,20,20
1715661440064,MCWP 50R,B00,518792,Krone; Jarret,0,2,20,20
1715661440064,MCWP 50R,C00,518793,Staff,0,4,20,20
1715661440064,MCWP 50R,D00,518794,Morshed; Michael James,0,2,20,20
1715661440064,MCWP 50R,E00,518795,Carter; Andrea L,0,2,20,20
1715661440064,MCWP 50R,F00,518796,Miller; Elizabeth Deen,0,1,20,20
1715661440064,MCWP 50R,G00,518797,Guillen; Melinda,0,1,20,20
1715661441093,MMW 12R,A01,514034,Herbst; Matthew,0,2,16,16
1715661441093,MMW 12R,A02,514035,Herbst; Matthew,0,0,16,16
1715661442119,MMW 13R,A01,514037,Staff,0,5,16,16
1715661442119,MMW 13R,A02,514039,Staff,0,5,16,16
1715661442119,MMW 13R,A03,628519,Staff,0,4,16,16
1715661444173,SIO 295LS,A00,523233,Staff,10,0,30,20
1715661445198,SIO 295S,A00,523232,Staff,10,0,30,20
1715661446224,SIOC 290S,A01,637330,Merrifield; Mark A,21,0,30,9
1715661447252,SIOC 291S,A01,637333,Gabriel; Corey John,21,0,30,9
1715661448278,SOCI 117,A01,494376,Staff,0,5,5,5
1715661449304,WES 237B,A00,494380,Staff,10,0,20,10
1715661451375,AESE 279B,A00,494370,Wade; Jon P,0,0,33,33
1715661452402,AIP 97,001,660915,Van Den Einde; Yael Dahlia,9998,0,9999,1
1715661453430,AIP 197,001,627712,Vespa; Emanuel Ignacio,9995,0,9999,4
1715661453430,AIP 197,002,650778,Amir; On,9998,0,9999,1
1715661453430,AIP 197,003,650933,Avenancio-Leon; Carlos,9998,0,9999,1
1715661453430,AIP 197,004,658530,Heyman; Gail D.,9998,0,9999,1
1715661453430,AIP 197,005,658631,Neal; Sonya E,9998,0,9999,1
1715661453430,AIP 197,006,658671,Du; Songzi,9998,0,9999,1
1715661454456,ANAR 135S,A00,494369,Braswell; Geoffrey E.,0,0,0,0
1715661455486,BENG 196,001,628496,Engler; Adam J.,9998,0,9999,1
1715661455486,BENG 196,002,660916,Watson; John Thomas,9998,0,9999,1
1715661456511,BISP 197,001,650773,Wilhelm; James E.,9994,0,9999,5
1715661456511,BISP 197,002,658904,Coleman; Aaron B.,9998,0,9999,1
1715661457538,CAT 124RS,A01,519847,Geibel; William,0,0,20,20
1715661458564,CAT 125RS,A01,515971,Geibel; William,0,0,20,20
1715661459590,CLRE 250,A00,511389,Morris; Sheldon,9992,0,9999,7
1715661460616,CLRE 251,A00,507176,Mehta; Ravindra L.,9992,0,9999,7
1715661460616,CLRE 251,B00,511410,Mehta; Ravindra L.,9998,0,9999,1
1715661461645,CLRE 252,A00,507189,Cuomo; Raphael Eduardo,9994,0,9999,5
1715661462675,CLRE 253,A00,507199,Vaida; Florin,9994,0,9999,5
1715661462675,CLRE 253,B00,507202,Vaida; Florin,9999,0,9999,0
1715661463699,CLRE 259,A00,507211,Patel; Hemal,9996,0,9999,3
1715661464728,CLRE 260,A00,507221,Cuomo; Raphael Eduardo,9999,0,9999,0
1715661465754,CLRE 297,001,507242,Cuomo; Raphael Eduardo,9999,0,9999,0
1715661466781,COGS 197,001,638244,Voytek; Bradley Thomas,9997,0,9999,2
1715661467807,CSE 191,A00,516875,Minnes Kemp; Mor Mia,9991,0,9999,8
1715661468836,CSE 197,001,637388,Minnes Kemp; Mor Mia,9992,0,9999,7
1715661469866,CSS 201S,A01,494383,Mignozzetti; Umberto,35,0,35,0
1715661470896,CSS 202S,A01,494387,Mignozzetti; Umberto,35,0,35,0
1715661471922,DSC 197,001,628532,Eldridge; Justin Matthew,9995,0,9999,4
1715661472946,EAP 100,A00,516065,Staff,9799,0,9999,200
1715661473974,ECE 45,A01,507414,Staff,32,0,60,28
1715661476026,ECE 111,A01,507420,Staff,11,0,50,39
1715661477050,ECE 197,001,548057,Sievenpiper; Daniel F.,9991,0,9999,8
1715661478076,EDS 115,A00,507243,Choi; Bailey Miyeon,6,0,28,22
1715661479104,EDS 117,A01,494379,Staff,0,6,34,35
1715661480131,EDS 125,A00,507246,Hopkins; Megan Beth,7,0,30,23
1715661481156,EDS 128A,A01,507264,Fargason; Sharon Gayle,5,0,26,21
1715661482181,EDS 128B,A01,507293,Pappas; Elizabeth,9,0,30,21
1715661483207,EDS 139,A00,507294,Fargason; Sharon Gayle,9,0,30,21
1715661483207,EDS 139,B00,507313,Pappas; Elizabeth,9,0,30,21
1715661484234,EDS 201,A00,507315,Staff,10,0,30,20
1715661485260,EDS 203,A01,507317,Halter; Christopher P.,10,0,30,20
1715661486286,EDS 204R,A01,507319,Halter; Christopher P.,0,3,30,30
1715661486286,EDS 204R,B01,507331,Heinzman; Erica M.,14,0,30,16
1715661487315,EDS 206R,A00,507332,Staff,0,4,30,30
1715661487315,EDS 206R,B00,507343,Staff,15,0,30,15
1715661488343,EDS 250,A00,507344,Hemans; Patricia Ann Benitez,20,0,40,20
1715661489369,EDS 281,A00,507345,Daly; Alan J.,18,0,18,0
1715661490396,EDS 284,A00,507350,Daly; Alan J.,16,0,16,0
1715661491425,EDS 286,A00,507359,Fine; Sarah,18,0,18,0
1715661492449,EDS 289C,A01,507361,Daly; Alan J.,18,0,18,0
1715661493476,EDS 290,A00,507366,Hofstetter; Carolyn,15,0,15,0
1715661494500,LIGM 5A,A00,507421,Fischer-Grunski; Eva K,17,0,20,3
1715661495525,LIGM 5B,A00,507423,Fischer-Grunski; Eva K,19,0,20,1
1715661496555,LIGM 5C,A00,507425,Fischer-Grunski; Eva K,19,0,20,1
1715661497582,LIIT 5AS,A00,507427,Carnelos; Chiara,20,0,20,0
1715661498611,LIIT 5BS,A00,507430,Carnelos; Chiara,20,0,20,0
1715661499637,LIIT 5CS,A00,507432,Carnelos; Chiara,20,0,20,0
1715661500668,LISP 5A,A00,507541,Munoz Sanchez; Alicia,11,0,20,9
1715661501693,LISP 5B,A00,507671,Munoz Sanchez; Alicia,8,0,20,12
1715661502720,LISP 5C,A00,507696,Munoz Sanchez; Alicia,7,0,20,13
1715661503746,MAE 197,001,528363,Boechler; Nicholas Sebastia,9998,0,9999,1
1715661504773,MATH 197,001,523477,Kedlaya; Kiran S.,9994,0,9999,5
1715661504773,MATH 197,002,563811,Zhang; Danna,9994,0,9999,5
1715661504773,MATH 197,003,628552,Dumitriu; Ioana,9998,0,9999,1
1715661504773,MATH 197,004,660885,Floyd; Eric,9998,0,9999,1
1715661505799,MCWP 40R,A00,518780,Staff,1,0,20,19
1715661505799,MCWP 40R,B00,518781,Carter; Jennifer A,9,0,20,11
1715661505799,MCWP 40R,C00,518783,Smith; Haydee Marie,5,0,20,15
1715661506830,MCWP 50R,A00,518791,Redela; Pamela Morgan,0,1,20,20
1715661506830,MCWP 50R,B00,518792,Krone; Jarret,0,2,20,20
1715661506830,MCWP 50R,C00,518793,Staff,0,4,20,20
1715661506830,MCWP 50R,D00,518794,Morshed; Michael James,0,2,20,20
1715661506830,MCWP 50R,E00,518795,Carter; Andrea L,0,2,20,20
1715661506830,MCWP 50R,F00,518796,Miller; Elizabeth Deen,0,1,20,20
1715661506830,MCWP 50R,G00,518797,Guillen; Melinda,0,1,20,20
1715661507858,MMW 12R,A01,514034,Herbst; Matthew,0,2,16,16
1715661507858,MMW 12R,A02,514035,Herbst; Matthew,0,0,16,16
1715661508883,MMW 13R,A01,514037,Staff,0,5,16,16
1715661508883,MMW 13R,A02,514039,Staff,0,5,16,16
1715661508883,MMW 13R,A03,628519,Staff,0,4,16,16
1715661510936,SIO 295LS,A00,523233,Staff,10,0,30,20
1715661511959,SIO 295S,A00,523232,Staff,10,0,30,20
1715661512990,SIOC 290S,A01,637330,Merrifield; Mark A,21,0,30,9
1715661514015,SIOC 291S,A01,637333,Gabriel; Corey John,21,0,30,9
1715661515040,SOCI 117,A01,494376,Staff,0,5,5,5
1715661516067,WES 237B,A00,494380,Staff,10,0,20,10
1715661518145,AESE 279B,A00,494370,Wade; Jon P,0,0,33,33
1715661519170,AIP 97,001,660915,Van Den Einde; Yael Dahlia,9998,0,9999,1
1715661520198,AIP 197,001,627712,Vespa; Emanuel Ignacio,9995,0,9999,4
1715661520198,AIP 197,002,650778,Amir; On,9998,0,9999,1
1715661520198,AIP 197,003,650933,Avenancio-Leon; Carlos,9998,0,9999,1
1715661520198,AIP 197,004,658530,Heyman; Gail D.,9998,0,9999,1
1715661520198,AIP 197,005,658631,Neal; Sonya E,9998,0,9999,1
1715661520198,AIP 197,006,658671,Du; Songzi,9998,0,9999,1
1715661521227,ANAR 135S,A00,494369,Braswell; Geoffrey E.,0,0,0,0
1715661522255,BENG 196,001,628496,Engler; Adam J.,9998,0,9999,1
1715661522255,BENG 196,002,660916,Watson; John Thomas,9998,0,9999,1
1715661523280,BISP 197,001,650773,Wilhelm; James E.,9994,0,9999,5
1715661523280,BISP 197,002,658904,Coleman; Aaron B.,9998,0,9999,1
1715661524308,CAT 124RS,A01,519847,Geibel; William,0,0,20,20
1715661525333,CAT 125RS,A01,515971,Geibel; William,0,0,20,20
1715661526362,CLRE 250,A00,511389,Morris; Sheldon,9992,0,9999,7
1715661527388,CLRE 251,A00,507176,Mehta; Ravindra L.,9992,0,9999,7
1715661527388,CLRE 251,B00,511410,Mehta; Ravindra L.,9998,0,9999,1
1715661528413,CLRE 252,A00,507189,Cuomo; Raphael Eduardo,9994,0,9999,5
1715661529441,CLRE 253,A00,507199,Vaida; Florin,9994,0,9999,5
1715661529441,CLRE 253,B00,507202,Vaida; Florin,9999,0,9999,0
1715661530468,CLRE 259,A00,507211,Patel; Hemal,9996,0,9999,3
1715661531496,CLRE 260,A00,507221,Cuomo; Raphael Eduardo,9999,0,9999,0
1715661532520,CLRE 297,001,507242,Cuomo; Raphael Eduardo,9999,0,9999,0
1715661533549,COGS 197,001,638244,Voytek; Bradley Thomas,9997,0,9999,2
1715661534574,CSE 191,A00,516875,Minnes Kemp; Mor Mia,9991,0,9999,8
1715661535602,CSE 197,001,637388,Minnes Kemp; Mor Mia,9992,0,9999,7
1715661536635,CSS 201S,A01,494383,Mignozzetti; Umberto,35,0,35,0
1715661537660,CSS 202S,A01,494387,Mignozzetti; Umberto,35,0,35,0
1715661538684,DSC 197,001,628532,Eldridge; Justin Matthew,9995,0,9999,4
1715661539711,EAP 100,A00,516065,Staff,9799,0,9999,200
1715661540738,ECE 45,A01,507414,Staff,32,0,60,28
1715661542792,ECE 111,A01,507420,Staff,11,0,50,39
1715661543818,ECE 197,001,548057,Sievenpiper; Daniel F.,9991,0,9999,8
1715661544843,EDS 115,A00,507243,Choi; Bailey Miyeon,6,0,28,22
1715661545871,EDS 117,A01,494379,Staff,0,6,34,35
1715661546897,EDS 125,A00,507246,Hopkins; Megan Beth,7,0,30,23
1715661547927,EDS 128A,A01,507264,Fargason; Sharon Gayle,5,0,26,21
1715661548956,EDS 128B,A01,507293,Pappas; Elizabeth,9,0,30,21
1715661549984,EDS 139,A00,507294,Fargason; Sharon Gayle,9,0,30,21
1715661549984,EDS 139,B00,507313,Pappas; Elizabeth,9,0,30,21
1715661551008,EDS 201,A00,507315,Staff,10,0,30,20
1715661552036,EDS 203,A01,507317,Halter; Christopher P.,10,0,30,20
1715661553061,EDS 204R,A01,507319,Halter; Christopher P.,0,3,30,30
1715661553061,EDS 204R,B01,507331,Heinzman; Erica M.,14,0,30,16
1715661554091,EDS 206R,A00,507332,Staff,0,4,30,30
1715661554091,EDS 206R,B00,507343,Staff,15,0,30,15
1715661555117,EDS 250,A00,507344,Hemans; Patricia Ann Benitez,20,0,40,20
1715661556146,EDS 281,A00,507345,Daly; Alan J.,18,0,18,0
1715661557171,EDS 284,A00,507350,Daly; Alan J.,16,0,16,0
1715661558196,EDS 286,A00,507359,Fine; Sarah,18,0,18,0
1715661559220,EDS 289C,A01,507361,Daly; Alan J.,18,0,18,0
1715661560246,EDS 290,A00,507366,Hofstetter; Carolyn,15,0,15,0
1715661561272,LIGM 5A,A00,507421,Fischer-Grunski; Eva K,17,0,20,3
1715661562297,LIGM 5B,A00,507423,Fischer-Grunski; Eva K,19,0,20,1
1715661563323,LIGM 5C,A00,507425,Fischer-Grunski; Eva K,19,0,20,1
1715661564351,LIIT 5AS,A00,507427,Carnelos; Chiara,20,0,20,0
1715661565380,LIIT 5BS,A00,507430,Carnelos; Chiara,20,0,20,0
1715661566405,LIIT 5CS,A00,507432,Carnelos; Chiara,20,0,20,0
1715661567430,LISP 5A,A00,507541,Munoz Sanchez; Alicia,11,0,20,9
1715661568457,LISP 5B,A00,507671,Munoz Sanchez; Alicia,8,0,20,12
1715661569482,LISP 5C,A00,507696,Munoz Sanchez; Alicia,7,0,20,13
1715661570512,MAE 197,001,528363,Boechler; Nicholas Sebastia,9998,0,9999,1
1715661571540,MATH 197,001,523477,Kedlaya; Kiran S.,9994,0,9999,5
1715661571540,MATH 197,002,563811,Zhang; Danna,9994,0,9999,5
1715661571540,MATH 197,003,628552,Dumitriu; Ioana,9998,0,9999,1
1715661571540,MATH 197,004,660885,Floyd; Eric,9998,0,9999,1
1715661572570,MCWP 40R,A00,518780,Staff,1,0,20,19
1715661572570,MCWP 40R,B00,518781,Carter; Jennifer A,9,0,20,11
1715661572570,MCWP 40R,C00,518783,Smith; Haydee Marie,5,0,20,15
1715661573599,MCWP 50R,A00,518791,Redela; Pamela Morgan,0,1,20,20
1715661573599,MCWP 50R,B00,518792,Krone; Jarret,0,2,20,20
1715661573599,MCWP 50R,C00,518793,Staff,0,4,20,20
1715661573599,MCWP 50R,D00,518794,Morshed; Michael James,0,2,20,20
1715661573599,MCWP 50R,E00,518795,Carter; Andrea L,0,2,20,20
1715661573599,MCWP 50R,F00,518796,Miller; Elizabeth Deen,0,1,20,20
1715661573599,MCWP 50R,G00,518797,Guillen; Melinda,0,1,20,20
1715661574625,MMW 12R,A01,514034,Herbst; Matthew,0,2,16,16
1715661574625,MMW 12R,A02,514035,Herbst; Matthew,0,0,16,16
1715661575653,MMW 13R,A01,514037,Staff,0,5,16,16
1715661575653,MMW 13R,A02,514039,Staff,0,5,16,16
1715661575653,MMW 13R,A03,628519,Staff,0,4,16,16
1715661577706,SIO 295LS,A00,523233,Staff,10,0,30,20
1715661578733,SIO 295S,A00,523232,Staff,10,0,30,20
1715661579762,SIOC 290S,A01,637330,Merrifield; Mark A,21,0,30,9
1715661580791,SIOC 291S,A01,637333,Gabriel; Corey John,21,0,30,9
1715661581818,SOCI 117,A01,494376,Staff,0,5,5,5
1715661582844,WES 237B,A00,494380,Staff,10,0,20,10
1715661584923,AESE 279B,A00,494370,Wade; Jon P,0,0,33,33
1715661585948,AIP 97,001,660915,Van Den Einde; Yael Dahlia,9998,0,9999,1
1715661586981,AIP 197,001,627712,Vespa; Emanuel Ignacio,9995,0,9999,4
1715661586981,AIP 197,002,650778,Amir; On,9998,0,9999,1
1715661586981,AIP 197,003,650933,Avenancio-Leon; Carlos,9998,0,9999,1
1715661586981,AIP 197,004,658530,Heyman; Gail D.,9998,0,9999,1
1715661586981,AIP 197,005,658631,Neal; Sonya E,9998,0,9999,1
1715661586981,AIP 197,006,658671,Du; Songzi,9998,0,9999,1
1715661588010,ANAR 135S,A00,494369,Braswell; Geoffrey E.,0,0,0,0
1715661589039,BENG 196,001,628496,Engler; Adam J.,9998,0,9999,1
1715661589039,BENG 196,002,660916,Watson; John Thomas,9998,0,9999,1
1715661590065,BISP 197,001,650773,Wilhelm; James E.,9994,0,9999,5
1715661590065,BISP 197,002,658904,Coleman; Aaron B.,9998,0,9999,1
1715661591094,CAT 124RS,A01,519847,Geibel; William,0,0,20,20
1715661592120,CAT 125RS,A01,515971,Geibel; William,0,0,20,20
1715661593146,CLRE 250,A00,511389,Morris; Sheldon,9992,0,9999,7
1715661594174,CLRE 251,A00,507176,Mehta; Ravindra L.,9992,0,9999,7
1715661594174,CLRE 251,B00,511410,Mehta; Ravindra L.,9998,0,9999,1
1715661595199,CLRE 252,A00,507189,Cuomo; Raphael Eduardo,9994,0,9999,5
1715661596227,CLRE 253,A00,507199,Vaida; Florin,9994,0,9999,5
1715661596227,CLRE 253,B00,507202,Vaida; Florin,9999,0,9999,0
1715661597252,CLRE 259,A00,507211,Patel; Hemal,9996,0,9999,3
1715661598275,CLRE 260,A00,507221,Cuomo; Raphael Eduardo,9999,0,9999,0
1715661599303,CLRE 297,001,507242,Cuomo; Raphael Eduardo,9999,0,9999,0
1715661600332,COGS 197,001,638244,Voytek; Bradley Thomas,9997,0,9999,2
1715661601360,CSE 191,A00,516875,Minnes Kemp; Mor Mia,9991,0,9999,8
1715661602386,CSE 197,001,637388,Minnes Kemp; Mor Mia,9992,0,9999,7
1715661603418,CSS 201S,A01,494383,Mignozzetti; Umberto,35,0,35,0
1715661604445,CSS 202S,A01,494387,Mignozzetti; Umberto,35,0,35,0
1715661605475,DSC 197,001,628532,Eldridge; Justin Matthew,9995,0,9999,4
1715661606499,EAP 100,A00,516065,Staff,9799,0,9999,200
1715661607529,ECE 45,A01,507414,Staff,32,0,60,28
1715661609585,ECE 111,A01,507420,Staff,11,0,50,39
1715661610611,ECE 197,001,548057,Sievenpiper; Daniel F.,9991,0,9999,8
1715661611701,EDS 115,A00,507243,Choi; Bailey Miyeon,6,0,28,22
1715661612728,EDS 117,A01,494379,Staff,0,6,34,35
1715661613757,EDS 125,A00,507246,Hopkins; Megan Beth,7,0,30,23
1715661614788,EDS 128A,A01,507264,Fargason; Sharon Gayle,5,0,26,21
1715661615814,EDS 128B,A01,507293,Pappas; Elizabeth,9,0,30,21
1715661616839,EDS 139,A00,507294,Fargason; Sharon Gayle,9,0,30,21
1715661616839,EDS 139,B00,507313,Pappas; Elizabeth,9,0,30,21
1715661617863,EDS 201,A00,507315,Staff,10,0,30,20
1715661618890,EDS 203,A01,507317,Halter; Christopher P.,10,0,30,20
1715661619915,EDS 204R,A01,507319,Halter; Christopher P.,0,3,30,30
1715661619915,EDS 204R,B01,507331,Heinzman; Erica M.,14,0,30,16
1715661620940,EDS 206R,A00,507332,Staff,0,4,30,30
1715661620940,EDS 206R,B00,507343,Staff,15,0,30,15
1715661621966,EDS 250,A00,507344,Hemans; Patricia Ann Benitez,20,0,40,20
1715661622990,EDS 281,A00,507345,Daly; Alan J.,18,0,18,0
1715661624015,EDS 284,A00,507350,Daly; Alan J.,16,0,16,0
1715661625044,EDS 286,A00,507359,Fine; Sarah,18,0,18,0
1715661626069,EDS 289C,A01,507361,Daly; Alan J.,18,0,18,0
1715661627097,EDS 290,A00,507366,Hofstetter; Carolyn,15,0,15,0
1715661628122,LIGM 5A,A00,507421,Fischer-Grunski; Eva K,17,0,20,3
1715661629148,LIGM 5B,A00,507423,Fischer-Grunski; Eva K,19,0,20,1
1715661630173,LIGM 5C,A00,507425,Fischer-Grunski; Eva K,19,0,20,1
1715661631202,LIIT 5AS,A00,507427,Carnelos; Chiara,20,0,20,0
1715661632227,LIIT 5BS,A00,507430,Carnelos; Chiara,20,0,20,0
1715661633256,LIIT 5CS,A00,507432,Carnelos; Chiara,20,0,20,0
1715661634286,LISP 5A,A00,507541,Munoz Sanchez; Alicia,11,0,20,9
1715661635312,LISP 5B,A00,507671,Munoz Sanchez; Alicia,8,0,20,12
1715661636340,LISP 5C,A00,507696,Munoz Sanchez; Alicia,7,0,20,13
1715661637368,MAE 197,001,528363,Boechler; Nicholas Sebastia,9998,0,9999,1
1715661638398,MATH 197,001,523477,Kedlaya; Kiran S.,9994,0,9999,5
1715661638398,MATH 197,002,563811,Zhang; Danna,9994,0,9999,5
1715661638398,MATH 197,003,628552,Dumitriu; Ioana,9998,0,9999,1
1715661638398,MATH 197,004,660885,Floyd; Eric,9998,0,9999,1
1715661639425,MCWP 40R,A00,518780,Staff,1,0,20,19
1715661639425,MCWP 40R,B00,518781,Carter; Jennifer A,9,0,20,11
1715661639425,MCWP 40R,C00,518783,Smith; Haydee Marie,5,0,20,15
1715661640454,MCWP 50R,A00,518791,Redela; Pamela Morgan,0,1,20,20
1715661640454,MCWP 50R,B00,518792,Krone; Jarret,0,2,20,20
1715661640454,MCWP 50R,C00,518793,Staff,0,4,20,20
1715661640454,MCWP 50R,D00,518794,Morshed; Michael James,0,2,20,20
1715661640454,MCWP 50R,E00,518795,Carter; Andrea L,0,2,20,20
1715661640454,MCWP 50R,F00,518796,Miller; Elizabeth Deen,0,1,20,20
1715661640454,MCWP 50R,G00,518797,Guillen; Melinda,0,1,20,20
1715661641480,MMW 12R,A01,514034,Herbst; Matthew,0,2,16,16
1715661641480,MMW 12R,A02,514035,Herbst; Matthew,0,0,16,16
1715661642506,MMW 13R,A01,514037,Staff,0,5,16,16
1715661642506,MMW 13R,A02,514039,Staff,0,5,16,16
1715661642506,MMW 13R,A03,628519,Staff,0,4,16,16
1715661644558,SIO 295LS,A00,523233,Staff,10,0,30,20
1715661645584,SIO 295S,A00,523232,Staff,10,0,30,20
1715661646613,SIOC 290S,A01,637330,Merrifield; Mark A,21,0,30,9
1715661647642,SIOC 291S,A01,637333,Gabriel; Corey John,21,0,30,9
1715661648668,SOCI 117,A01,494376,Staff,0,5,5,5
1715661649695,WES 237B,A00,494380,Staff,10,0,20,10
1715661651767,AESE 279B,A00,494370,Wade; Jon P,0,0,33,33
1715661652792,AIP 97,001,660915,Van Den Einde; Yael Dahlia,9998,0,9999,1
1715661653820,AIP 197,001,627712,Vespa; Emanuel Ignacio,9995,0,9999,4
1715661653820,AIP 197,002,650778,Amir; On,9998,0,9999,1
1715661653820,AIP 197,003,650933,Avenancio-Leon; Carlos,9998,0,9999,1
1715661653820,AIP 197,004,658530,Heyman; Gail D.,9998,0,9999,1
1715661653820,AIP 197,005,658631,Neal; Sonya E,9998,0,9999,1
1715661653820,AIP 197,006,658671,Du; Songzi,9998,0,9999,1
1715661654848,ANAR 135S,A00,494369,Braswell; Geoffrey E.,0,0,0,0
1715661655875,BENG 196,001,628496,Engler; Adam J.,9998,0,9999,1
1715661655875,BENG 196,002,660916,Watson; John Thomas,9998,0,9999,1
1715661656901,BISP 197,001,650773,Wilhelm; James E.,9994,0,9999,5
1715661656901,BISP 197,002,658904,Coleman; Aaron B.,9998,0,9999,1
1715661657930,CAT 124RS,A01,519847,Geibel; William,0,0,20,20
1715661658956,CAT 125RS,A01,515971,Geibel; William,0,0,20,20
1715661659982,CLRE 250,A00,511389,Morris; Sheldon,9992,0,9999,7
1715661661009,CLRE 251,A00,507176,Mehta; Ravindra L.,9992,0,9999,7
1715661661009,CLRE 251,B00,511410,Mehta; Ravindra L.,9998,0,9999,1
1715661662034,CLRE 252,A00,507189,Cuomo; Raphael Eduardo,9994,0,9999,5
1715661663066,CLRE 253,A00,507199,Vaida; Florin,9994,0,9999,5
1715661663066,CLRE 253,B00,507202,Vaida; Florin,9999,0,9999,0
1715661664093,CLRE 259,A00,507211,Patel; Hemal,9996,0,9999,3
1715661665118,CLRE 260,A00,507221,Cuomo; Raphael Eduardo,9999,0,9999,0
1715661666146,CLRE 297,001,507242,Cuomo; Raphael Eduardo,9999,0,9999,0
1715661667172,COGS 197,001,638244,Voytek; Bradley Thomas,9997,0,9999,2
1715661668200,CSE 191,A00,516875,Minnes Kemp; Mor Mia,9991,0,9999,8
1715661669231,CSE 197,001,637388,Minnes Kemp; Mor Mia,9992,0,9999,7
1715661670260,CSS 201S,A01,494383,Mignozzetti; Umberto,35,0,35,0
1715661671286,CSS 202S,A01,494387,Mignozzetti; Umberto,35,0,35,0
1715661672314,DSC 197,001,628532,Eldridge; Justin Matthew,9995,0,9999,4
1715661673339,EAP 100,A00,516065,Staff,9799,0,9999,200
1715661674371,ECE 45,A01,507414,Staff,32,0,60,28
1715661676424,ECE 111,A01,507420,Staff,11,0,50,39
1715661677450,ECE 197,001,548057,Sievenpiper; Daniel F.,9991,0,9999,8
1715661678476,EDS 115,A00,507243,Choi; Bailey Miyeon,6,0,28,22
1715661679504,EDS 117,A01,494379,Staff,0,6,34,35
1715661680532,EDS 125,A00,507246,Hopkins; Megan Beth,7,0,30,23
1715661681558,EDS 128A,A01,507264,Fargason; Sharon Gayle,5,0,26,21
1715661682583,EDS 128B,A01,507293,Pappas; Elizabeth,9,0,30,21
1715661683610,EDS 139,A00,507294,Fargason; Sharon Gayle,9,0,30,21
1715661683610,EDS 139,B00,507313,Pappas; Elizabeth,9,0,30,21
1715661684636,EDS 201,A00,507315,Staff,10,0,30,20
1715661685661,EDS 203,A01,507317,Halter; Christopher P.,10,0,30,20
1715661686692,EDS 204R,A01,507319,Halter; Christopher P.,0,3,30,30
1715661686692,EDS 204R,B01,507331,Heinzman; Erica M.,14,0,30,16
1715661687718,EDS 206R,A00,507332,Staff,0,4,30,30
1715661687718,EDS 206R,B00,507343,Staff,15,0,30,15
1715661688744,EDS 250,A00,507344,Hemans; Patricia Ann Benitez,20,0,40,20
1715661689773,EDS 281,A00,507345,Daly; Alan J.,18,0,18,0
1715661690798,EDS 284,A00,507350,Daly; Alan J.,16,0,16,0
1715661691830,EDS 286,A00,507359,Fine; Sarah,18,0,18,0
1715661692857,EDS 289C,A01,507361,Daly; Alan J.,18,0,18,0
1715661693883,EDS 290,A00,507366,Hofstetter; Carolyn,15,0,15,0
1715661694911,LIGM 5A,A00,507421,Fischer-Grunski; Eva K,17,0,20,3
1715661695938,LIGM 5B,A00,507423,Fischer-Grunski; Eva K,19,0,20,1
1715661696966,LIGM 5C,A00,507425,Fischer-Grunski; Eva K,19,0,20,1
1715661697992,LIIT 5AS,A00,507427,Carnelos; Chiara,20,0,20,0
1715661699019,LIIT 5BS,A00,507430,Carnelos; Chiara,20,0,20,0
1715661700047,LIIT 5CS,A00,507432,Carnelos; Chiara,20,0,20,0
1715661701077,LISP 5A,A00,507541,Munoz Sanchez; Alicia,11,0,20,9
1715661702107,LISP 5B,A00,507671,Munoz Sanchez; Alicia,8,0,20,12
1715661703133,LISP 5C,A00,507696,Munoz Sanchez; Alicia,7,0,20,13
1715661704158,MAE 197,001,528363,Boechler; Nicholas Sebastia,9998,0,9999,1
1715661705184,MATH 197,001,523477,Kedlaya; Kiran S.,9994,0,9999,5
1715661705184,MATH 197,002,563811,Zhang; Danna,9994,0,9999,5
1715661705184,MATH 197,003,628552,Dumitriu; Ioana,9998,0,9999,1
1715661705184,MATH 197,004,660885,Floyd; Eric,9998,0,9999,1
1715661706217,MCWP 40R,A00,518780,Staff,1,0,20,19
1715661706217,MCWP 40R,B00,518781,Carter; Jennifer A,9,0,20,11
1715661706217,MCWP 40R,C00,518783,Smith; Haydee Marie,5,0,20,15
1715661707251,MCWP 50R,A00,518791,Redela; Pamela Morgan,0,1,20,20
1715661707251,MCWP 50R,B00,518792,Krone; Jarret,0,2,20,20
1715661707251,MCWP 50R,C00,518793,Staff,0,4,20,20
1715661707251,MCWP 50R,D00,518794,Morshed; Michael James,0,2,20,20
1715661707251,MCWP 50R,E00,518795,Carter; Andrea L,0,2,20,20
1715661707251,MCWP 50R,F00,518796,Miller; Elizabeth Deen,0,1,20,20
1715661707251,MCWP 50R,G00,518797,Guillen; Melinda,0,1,20,20
1715661708280,MMW 12R,A01,514034,Herbst; Matthew,0,2,16,16
1715661708280,MMW 12R,A02,514035,Herbst; Matthew,0,0,16,16
1715661709310,MMW 13R,A01,514037,Staff,0,5,16,16
1715661709310,MMW 13R,A02,514039,Staff,0,5,16,16
1715661709310,MMW 13R,A03,628519,Staff,0,4,16,16
1715661711361,SIO 295LS,A00,523233,Staff,10,0,30,20
1715661712391,SIO 295S,A00,523232,Staff,10,0,30,20
1715661713421,SIOC 290S,A01,637330,Merrifield; Mark A,21,0,30,9
1715661714448,SIOC 291S,A01,637333,Gabriel; Corey John,21,0,30,9
1715661715534,SOCI 117,A01,494376,Staff,0,5,5,5
1715661716561,WES 237B,A00,494380,Staff,10,0,20,10
1715661718626,AESE 279B,A00,494370,Wade; Jon P,0,0,33,33
1715661719655,AIP 97,001,660915,Van Den Einde; Yael Dahlia,9998,0,9999,1
1715661720682,AIP 197,001,627712,Vespa; Emanuel Ignacio,9995,0,9999,4
1715661720682,AIP 197,002,650778,Amir; On,9998,0,9999,1
1715661720682,AIP 197,003,650933,Avenancio-Leon; Carlos,9998,0,9999,1
1715661720682,AIP 197,004,658530,Heyman; Gail D.,9998,0,9999,1
1715661720682,AIP 197,005,658631,Neal; Sonya E,9998,0,9999,1
1715661720682,AIP 197,006,658671,Du; Songzi,9998,0,9999,1
1715661721708,ANAR 135S,A00,494369,Braswell; Geoffrey E.,0,0,0,0
1715661722733,BENG 196,001,628496,Engler; Adam J.,9998,0,9999,1
1715661722733,BENG 196,002,660916,Watson; John Thomas,9998,0,9999,1
1715661723759,BISP 197,001,650773,Wilhelm; James E.,9994,0,9999,5
1715661723759,BISP 197,002,658904,Coleman; Aaron B.,9998,0,9999,1
1715661724787,CAT 124RS,A01,519847,Geibel; William,0,0,20,20
1715661725812,CAT 125RS,A01,515971,Geibel; William,0,0,20,20
1715661726843,CLRE 250,A00,511389,Morris; Sheldon,9992,0,9999,7
1715661727870,CLRE 251,A00,507176,Mehta; Ravindra L.,9992,0,9999,7
1715661727870,CLRE 251,B00,511410,Mehta; Ravindra L.,9998,0,9999,1
1715661728903,CLRE 252,A00,507189,Cuomo; Raphael Eduardo,9994,0,9999,5
1715661729929,CLRE 253,A00,507199,Vaida; Florin,9994,0,9999,5
1715661729929,CLRE 253,B00,507202,Vaida; Florin,9999,0,9999,0
1715661730955,CLRE 259,A00,507211,Patel; Hemal,9996,0,9999,3
1715661731982,CLRE 260,A00,507221,Cuomo; Raphael Eduardo,9999,0,9999,0
1715661733008,CLRE 297,001,507242,Cuomo; Raphael Eduardo,9999,0,9999,0
1715661734037,COGS 197,001,638244,Voytek; Bradley Thomas,9997,0,9999,2
1715661735065,CSE 191,A00,516875,Minnes Kemp; Mor Mia,9991,0,9999,8
1715661736092,CSE 197,001,637388,Minnes Kemp; Mor Mia,9992,0,9999,7
1715661737119,CSS 201S,A01,494383,Mignozzetti; Umberto,35,0,35,0
1715661738145,CSS 202S,A01,494387,Mignozzetti; Umberto,35,0,35,0
1715661739170,DSC 197,001,628532,Eldridge; Justin Matthew,9995,0,9999,4
1715661740197,EAP 100,A00,516065,Staff,9799,0,9999,200
1715661741225,ECE 45,A01,507414,Staff,32,0,60,28
1715661743280,ECE 111,A01,507420,Staff,11,0,50,39
1715661744306,ECE 197,001,548057,Sievenpiper; Daniel F.,9991,0,9999,8
1715661745335,EDS 115,A00,507243,Choi; Bailey Miyeon,6,0,28,22
1715661747039,EDS 117,A01,494379,Staff,0,6,34,35
1715661748064,EDS 125,A00,507246,Hopkins; Megan Beth,7,0,30,23
1715661749093,EDS 128A,A01,507264,Fargason; Sharon Gayle,5,0,26,21
1715661750120,EDS 128B,A01,507293,Pappas; Elizabeth,9,0,30,21
1715661751148,EDS 139,A00,507294,Fargason; Sharon Gayle,9,0,30,21
1715661751148,EDS 139,B00,507313,Pappas; Elizabeth,9,0,30,21
1715661752175,EDS 201,A00,507315,Staff,10,0,30,20
1715661753206,EDS 203,A01,507317,Halter; Christopher P.,10,0,30,20
1715661754232,EDS 204R,A01,507319,Halter; Christopher P.,0,3,30,30
1715661754232,EDS 204R,B01,507331,Heinzman; Erica M.,14,0,30,16
1715661755258,EDS 206R,A00,507332,Staff,0,4,30,30
1715661755258,EDS 206R,B00,507343,Staff,15,0,30,15
1715661756285,EDS 250,A00,507344,Hemans; Patricia Ann Benitez,20,0,40,20
1715661757319,EDS 281,A00,507345,Daly; Alan J.,18,0,18,0
1715661758345,EDS 284,A00,507350,Daly; Alan J.,16,0,16,0
1715661759375,EDS 286,A00,507359,Fine; Sarah,18,0,18,0
1715661760401,EDS 289C,A01,507361,Daly; Alan J.,18,0,18,0
1715661761428,EDS 290,A00,507366,Hofstetter; Carolyn,15,0,15,0
1715661762456,LIGM 5A,A00,507421,Fischer-Grunski; Eva K,17,0,20,3
1715661763486,LIGM 5B,A00,507423,Fischer-Grunski; Eva K,19,0,20,1
1715661764512,LIGM 5C,A00,507425,Fischer-Grunski; Eva K,19,0,20,1
1715661765541,LIIT 5AS,A00,507427,Carnelos; Chiara,20,0,20,0
1715661766569,LIIT 5BS,A00,507430,Carnelos; Chiara,20,0,20,0
1715661767595,LIIT 5CS,A00,507432,Carnelos; Chiara,20,0,20,0
1715661768621,LISP 5A,A00,507541,Munoz Sanchez; Alicia,11,0,20,9
1715661769647,LISP 5B,A00,507671,Munoz Sanchez; Alicia,8,0,20,12
1715661770675,LISP 5C,A00,507696,Munoz Sanchez; Alicia,7,0,20,13
1715661771702,MAE 197,001,528363,Boechler; Nicholas Sebastia,9998,0,9999,1
1715661772729,MATH 197,001,523477,Kedlaya; Kiran S.,9994,0,9999,5
1715661772729,MATH 197,002,563811,Zhang; Danna,9994,0,9999,5
1715661772729,MATH 197,003,628552,Dumitriu; Ioana,9998,0,9999,1
1715661772729,MATH 197,004,660885,Floyd; Eric,9998,0,9999,1
1715661773756,MCWP 40R,A00,518780,Staff,1,0,20,19
1715661773756,MCWP 40R,B00,518781,Carter; Jennifer A,9,0,20,11
1715661773756,MCWP 40R,C00,518783,Smith; Haydee Marie,5,0,20,15
1715661774785,MCWP 50R,A00,518791,Redela; Pamela Morgan,0,1,20,20
1715661774785,MCWP 50R,B00,518792,Krone; Jarret,0,2,20,20
1715661774785,MCWP 50R,C00,518793,Staff,0,4,20,20
1715661774785,MCWP 50R,D00,518794,Morshed; Michael James,0,2,20,20
1715661774785,MCWP 50R,E00,518795,Carter; Andrea L,0,2,20,20
1715661774785,MCWP 50R,F00,518796,Miller; Elizabeth Deen,0,1,20,20
1715661774785,MCWP 50R,G00,518797,Guillen; Melinda,0,1,20,20
1715661775813,MMW 12R,A01,514034,Herbst; Matthew,0,2,16,16
1715661775813,MMW 12R,A02,514035,Herbst; Matthew,0,0,16,16
1715661776843,MMW 13R,A01,514037,Staff,0,5,16,16
1715661776843,MMW 13R,A02,514039,Staff,0,5,16,16
1715661776843,MMW 13R,A03,628519,Staff,0,4,16,16
1715661778902,SIO 295LS,A00,523233,Staff,10,0,30,20
1715661779926,SIO 295S,A00,523232,Staff,10,0,30,20
1715661780954,SIOC 290S,A01,637330,Merrifield; Mark A,21,0,30,9
1715661782037,SIOC 291S,A01,637333,Gabriel; Corey John,21,0,30,9
1715661783062,SOCI 117,A01,494376,Staff,0,5,5,5
1715661784088,WES 237B,A00,494380,Staff,10,0,20,10
1715661786203,AESE 279B,A00,494370,Wade; Jon P,0,0,33,33
1715661787232,AIP 97,001,660915,Van Den Einde; Yael Dahlia,9998,0,9999,1
1715661789319,AIP 197,001,627712,Vespa; Emanuel Ignacio,9995,0,9999,4
1715661789319,AIP 197,002,650778,Amir; On,9998,0,9999,1
1715661789319,AIP 197,003,650933,Avenancio-Leon; Carlos,9998,0,9999,1
1715661789319,AIP 197,004,658530,Heyman; Gail D.,9998,0,9999,1
1715661789319,AIP 197,005,658631,Neal; Sonya E,9998,0,9999,1
1715661789319,AIP 197,006,658671,Du; Songzi,9998,0,9999,1
1715661790350,ANAR 135S,A00,494369,Braswell; Geoffrey E.,0,0,0,0
1715661791377,BENG 196,001,628496,Engler; Adam J.,9998,0,9999,1
1715661791377,BENG 196,002,660916,Watson; John Thomas,9998,0,9999,1
1715661792404,BISP 197,001,650773,Wilhelm; James E.,9994,0,9999,5
1715661792404,BISP 197,002,658904,Coleman; Aaron B.,9998,0,9999,1
1715661793428,CAT 124RS,A01,519847,Geibel; William,0,0,20,20
1715661794455,CAT 125RS,A01,515971,Geibel; William,0,0,20,20
1715661795485,CLRE 250,A00,511389,Morris; Sheldon,9992,0,9999,7
1715661796513,CLRE 251,A00,507176,Mehta; Ravindra L.,9992,0,9999,7
1715661796513,CLRE 251,B00,511410,Mehta; Ravindra L.,9998,0,9999,1
1715661797539,CLRE 252,A00,507189,Cuomo; Raphael Eduardo,9994,0,9999,5
1715661798569,CLRE 253,A00,507199,Vaida; Florin,9994,0,9999,5
1715661798569,CLRE 253,B00,507202,Vaida; Florin,9999,0,9999,0
1715661799596,CLRE 259,A00,507211,Patel; Hemal,9996,0,9999,3
1715661800625,CLRE 260,A00,507221,Cuomo; Raphael Eduardo,9999,0,9999,0
1715661801654,CLRE 297,001,507242,Cuomo; Raphael Eduardo,9999,0,9999,0
1715661802683,COGS 197,001,638244,Voytek; Bradley Thomas,9997,0,9999,2
1715661803709,CSE 191,A00,516875,Minnes Kemp; Mor Mia,9991,0,9999,8
1715661804734,CSE 197,001,637388,Minnes Kemp; Mor Mia,9992,0,9999,7
1715661805761,CSS 201S,A01,494383,Mignozzetti; Umberto,35,0,35,0
1715661806786,CSS 202S,A01,494387,Mignozzetti; Umberto,35,0,35,0
1715661807816,DSC 197,001,628532,Eldridge; Justin Matthew,9995,0,9999,4
1715661808845,EAP 100,A00,516065,Staff,9799,0,9999,200
1715661809875,ECE 45,A01,507414,Staff,32,0,60,28
1715661811925,ECE 111,A01,507420,Staff,11,0,50,39
1715661812951,ECE 197,001,548057,Sievenpiper; Daniel F.,9991,0,9999,8
1715661813978,EDS 115,A00,507243,Choi; Bailey Miyeon,6,0,28,22
1715661815008,EDS 117,A01,494379,Staff,0,6,34,35
1715661816037,EDS 125,A00,507246,Hopkins; Megan Beth,7,0,30,23
1715661817064,EDS 128A,A01,507264,Fargason; Sharon Gayle,5,0,26,21
1715661818089,EDS 128B,A01,507293,Pappas; Elizabeth,9,0,30,21
1715661819115,EDS 139,A00,507294,Fargason; Sharon Gayle,9,0,30,21
1715661819115,EDS 139,B00,507313,Pappas; Elizabeth,9,0,30,21
1715661820141,EDS 201,A00,507315,Staff,10,0,30,20
1715661821170,EDS 203,A01,507317,Halter; Christopher P.,10,0,30,20
1715661822198,EDS 204R,A01,507319,Halter; Christopher P.,0,3,30,30
1715661822198,EDS 204R,B01,507331,Heinzman; Erica M.,14,0,30,16
1715661823226,EDS 206R,A00,507332,Staff,0,4,30,30
1715661823226,EDS 206R,B00,507343,Staff,15,0,30,15
1715661824309,EDS 250,A00,507344,Hemans; Patricia Ann Benitez,20,0,40,20
1715661825335,EDS 281,A00,507345,Daly; Alan J.,18,0,18,0
1715661826360,EDS 284,A00,507350,Daly; Alan J.,16,0,16,0
1715661827389,EDS 286,A00,507359,Fine; Sarah,18,0,18,0
1715661828416,EDS 289C,A01,507361,Daly; Alan J.,18,0,18,0
1715661829444,EDS 290,A00,507366,Hofstetter; Carolyn,15,0,15,0
1715661830474,LIGM 5A,A00,507421,Fischer-Grunski; Eva K,17,0,20,3
1715661831504,LIGM 5B,A00,507423,Fischer-Grunski; Eva K,19,0,20,1
1715661832536,LIGM 5C,A00,507425,Fischer-Grunski; Eva K,19,0,20,1
1715661833564,LIIT 5AS,A00,507427,Carnelos; Chiara,20,0,20,0
1715661834589,LIIT 5BS,A00,507430,Carnelos; Chiara,20,0,20,0
1715661835614,LIIT 5CS,A00,507432,Carnelos; Chiara,20,0,20,0
1715661836642,LISP 5A,A00,507541,Munoz Sanchez; Alicia,11,0,20,9
1715661837669,LISP 5B,A00,507671,Munoz Sanchez; Alicia,8,0,20,12
1715661838697,LISP 5C,A00,507696,Munoz Sanchez; Alicia,7,0,20,13
1715661839724,MAE 197,001,528363,Boechler; Nicholas Sebastia,9998,0,9999,1
1715661840761,MATH 197,001,523477,Kedlaya; Kiran S.,9994,0,9999,5
1715661840761,MATH 197,002,563811,Zhang; Danna,9994,0,9999,5
1715661840761,MATH 197,003,628552,Dumitriu; Ioana,9998,0,9999,1
1715661840761,MATH 197,004,660885,Floyd; Eric,9998,0,9999,1
1715661841790,MCWP 40R,A00,518780,Staff,1,0,20,19
1715661841790,MCWP 40R,B00,518781,Carter; Jennifer A,9,0,20,11
1715661841790,MCWP 40R,C00,518783,Smith; Haydee Marie,5,0,20,15
1715661842822,MCWP 50R,A00,518791,Redela; Pamela Morgan,0,1,20,20
1715661842822,MCWP 50R,B00,518792,Krone; Jarret,0,2,20,20
1715661842822,MCWP 50R,C00,518793,Staff,0,4,20,20
1715661842822,MCWP 50R,D00,518794,Morshed; Michael James,0,2,20,20
1715661842822,MCWP 50R,E00,518795,Carter; Andrea L,0,2,20,20
1715661842822,MCWP 50R,F00,518796,Miller; Elizabeth Deen,0,1,20,20
1715661842822,MCWP 50R,G00,518797,Guillen; Melinda,0,1,20,20
1715661843848,MMW 12R,A01,514034,Herbst; Matthew,0,2,16,16
1715661843848,MMW 12R,A02,514035,Herbst; Matthew,0,0,16,16
1715661844873,MMW 13R,A01,514037,Staff,0,5,16,16
1715661844873,MMW 13R,A02,514039,Staff,0,5,16,16
1715661844873,MMW 13R,A03,628519,Staff,0,4,16,16
1715661846926,SIO 295LS,A00,523233,Staff,10,0,30,20
1715661847952,SIO 295S,A00,523232,Staff,10,0,30,20
1715661848984,SIOC 290S,A01,637330,Merrifield; Mark A,21,0,30,9
1715661850012,SIOC 291S,A01,637333,Gabriel; Corey John,21,0,30,9
1715661851041,SOCI 117,A01,494376,Staff,0,5,5,5
1715661852070,WES 237B,A00,494380,Staff,10,0,20,10
1715661854133,AESE 279B,A00,494370,Wade; Jon P,0,0,33,33
1715661855159,AIP 97,001,660915,Van Den Einde; Yael Dahlia,9998,0,9999,1
1715661856190,AIP 197,001,627712,Vespa; Emanuel Ignacio,9995,0,9999,4
1715661856190,AIP 197,002,650778,Amir; On,9998,0,9999,1
1715661856190,AIP 197,003,650933,Avenancio-Leon; Carlos,9998,0,9999,1
1715661856190,AIP 197,004,658530,Heyman; Gail D.,9998,0,9999,1
1715661856190,AIP 197,005,658631,Neal; Sonya E,9998,0,9999,1
1715661856190,AIP 197,006,658671,Du; Songzi,9998,0,9999,1
1715661857216,ANAR 135S,A00,494369,Braswell; Geoffrey E.,0,0,0,0
1715661858244,BENG 196,001,628496,Engler; Adam J.,9998,0,9999,1
1715661858244,BENG 196,002,660916,Watson; John Thomas,9998,0,9999,1
1715661859271,BISP 197,001,650773,Wilhelm; James E.,9994,0,9999,5
1715661859271,BISP 197,002,658904,Coleman; Aaron B.,9998,0,9999,1
1715661860297,CAT 124RS,A01,519847,Geibel; William,0,0,20,20
1715661861323,CAT 125RS,A01,515971,Geibel; William,0,0,20,20
1715661862349,CLRE 250,A00,511389,Morris; Sheldon,9992,0,9999,7
1715661863376,CLRE 251,A00,507176,Mehta; Ravindra L.,9992,0,9999,7
1715661863376,CLRE 251,B00,511410,Mehta; Ravindra L.,9998,0,9999,1
1715661864401,CLRE 252,A00,507189,Cuomo; Raphael Eduardo,9994,0,9999,5
1715661865429,CLRE 253,A00,507199,Vaida; Florin,9994,0,9999,5
1715661865429,CLRE 253,B00,507202,Vaida; Florin,9999,0,9999,0
1715661866458,CLRE 259,A00,507211,Patel; Hemal,9996,0,9999,3
1715661867484,CLRE 260,A00,507221,Cuomo; Raphael Eduardo,9999,0,9999,0
1715661868512,CLRE 297,001,507242,Cuomo; Raphael Eduardo,9999,0,9999,0
1715661869537,COGS 197,001,638244,Voytek; Bradley Thomas,9997,0,9999,2
1715661870563,CSE 191,A00,516875,Minnes Kemp; Mor Mia,9991,0,9999,8
1715661871589,CSE 197,001,637388,Minnes Kemp; Mor Mia,9992,0,9999,7
1715661872615,CSS 201S,A01,494383,Mignozzetti; Umberto,35,0,35,0
1715661873644,CSS 202S,A01,494387,Mignozzetti; Umberto,35,0,35,0
1715661874670,DSC 197,001,628532,Eldridge; Justin Matthew,9995,0,9999,4
1715661875696,EAP 100,A00,516065,Staff,9799,0,9999,200
1715661876723,ECE 45,A01,507414,Staff,32,0,60,28
1715661878778,ECE 111,A01,507420,Staff,11,0,50,39
1715661879804,ECE 197,001,548057,Sievenpiper; Daniel F.,9991,0,9999,8
1715661880834,EDS 115,A00,507243,Choi; Bailey Miyeon,6,0,28,22
1715661881865,EDS 117,A01,494379,Staff,0,6,34,35
1715661882894,EDS 125,A00,507246,Hopkins; Megan Beth,7,0,30,23
1715661883918,EDS 128A,A01,507264,Fargason; Sharon Gayle,5,0,26,21
1715661884944,EDS 128B,A01,507293,Pappas; Elizabeth,9,0,30,21
1715661885968,EDS 139,A00,507294,Fargason; Sharon Gayle,9,0,30,21
1715661885968,EDS 139,B00,507313,Pappas; Elizabeth,9,0,30,21
1715661886992,EDS 201,A00,507315,Staff,10,0,30,20
1715661888022,EDS 203,A01,507317,Halter; Christopher P.,10,0,30,20
1715661889047,EDS 204R,A01,507319,Halter; Christopher P.,0,3,30,30
1715661889047,EDS 204R,B01,507331,Heinzman; Erica M.,14,0,30,16
1715661890073,EDS 206R,A00,507332,Staff,0,4,30,30
1715661890073,EDS 206R,B00,507343,Staff,15,0,30,15
1715661891101,EDS 250,A00,507344,Hemans; Patricia Ann Benitez,20,0,40,20
1715661892127,EDS 281,A00,507345,Daly; Alan J.,18,0,18,0
1715661893154,EDS 284,A00,507350,Daly; Alan J.,16,0,16,0
1715661894184,EDS 286,A00,507359,Fine; Sarah,18,0,18,0
1715661895212,EDS 289C,A01,507361,Daly; Alan J.,18,0,18,0
1715661896241,EDS 290,A00,507366,Hofstetter; Carolyn,15,0,15,0
1715661897269,LIGM 5A,A00,507421,Fischer-Grunski; Eva K,17,0,20,3
1715661898294,LIGM 5B,A00,507423,Fischer-Grunski; Eva K,19,0,20,1
1715661899319,LIGM 5C,A00,507425,Fischer-Grunski; Eva K,19,0,20,1
1715661900350,LIIT 5AS,A00,507427,Carnelos; Chiara,20,0,20,0
1715661901378,LIIT 5BS,A00,507430,Carnelos; Chiara,20,0,20,0
1715661902406,LIIT 5CS,A00,507432,Carnelos; Chiara,20,0,20,0
1715661903432,LISP 5A,A00,507541,Munoz Sanchez; Alicia,11,0,20,9
1715661904463,LISP 5B,A00,507671,Munoz Sanchez; Alicia,8,0,20,12
1715661905489,LISP 5C,A00,507696,Munoz Sanchez; Alicia,7,0,20,13
1715661906517,MAE 197,001,528363,Boechler; Nicholas Sebastia,9998,0,9999,1
1715661907549,MATH 197,001,523477,Kedlaya; Kiran S.,9994,0,9999,5
1715661907549,MATH 197,002,563811,Zhang; Danna,9994,0,9999,5
1715661907549,MATH 197,003,628552,Dumitriu; Ioana,9998,0,9999,1
1715661907549,MATH 197,004,660885,Floyd; Eric,9998,0,9999,1
1715661908580,MCWP 40R,A00,518780,Staff,1,0,20,19
1715661908580,MCWP 40R,B00,518781,Carter; Jennifer A,9,0,20,11
1715661908580,MCWP 40R,C00,518783,Smith; Haydee Marie,5,0,20,15
1715661909610,MCWP 50R,A00,518791,Redela; Pamela Morgan,0,1,20,20
1715661909610,MCWP 50R,B00,518792,Krone; Jarret,0,2,20,20
1715661909610,MCWP 50R,C00,518793,Staff,0,4,20,20
1715661909610,MCWP 50R,D00,518794,Morshed; Michael James,0,2,20,20
1715661909610,MCWP 50R,E00,518795,Carter; Andrea L,0,2,20,20
1715661909610,MCWP 50R,F00,518796,Miller; Elizabeth Deen,0,1,20,20
1715661909610,MCWP 50R,G00,518797,Guillen; Melinda,0,1,20,20
1715661910635,MMW 12R,A01,514034,Herbst; Matthew,0,2,16,16
1715661910635,MMW 12R,A02,514035,Herbst; Matthew,0,0,16,16
1715661911663,MMW 13R,A01,514037,Staff,0,5,16,16
1715661911663,MMW 13R,A02,514039,Staff,0,5,16,16
1715661911663,MMW 13R,A03,628519,Staff,0,4,16,16
1715661913719,SIO 295LS,A00,523233,Staff,10,0,30,20
1715661914747,SIO 295S,A00,523232,Staff,10,0,30,20
1715661915774,SIOC 290S,A01,637330,Merrifield; Mark A,21,0,30,9
1715661916800,SIOC 291S,A01,637333,Gabriel; Corey John,21,0,30,9
1715661917830,SOCI 117,A01,494376,Staff,0,5,5,5
1715661918855,WES 237B,A00,494380,Staff,10,0,20,10
1715661920921,AESE 279B,A00,494370,Wade; Jon P,0,0,33,33
1715661922005,AIP 97,001,660915,Van Den Einde; Yael Dahlia,9998,0,9999,1
1715661923032,AIP 197,001,627712,Vespa; Emanuel Ignacio,9995,0,9999,4
1715661923032,AIP 197,002,650778,Amir; On,9998,0,9999,1
1715661923032,AIP 197,003,650933,Avenancio-Leon; Carlos,9998,0,9999,1
1715661923032,AIP 197,004,658530,Heyman; Gail D.,9998,0,9999,1
1715661923032,AIP 197,005,658631,Neal; Sonya E,9998,0,9999,1
1715661923032,AIP 197,006,658671,Du; Songzi,9998,0,9999,1
1715661924058,ANAR 135S,A00,494369,Braswell; Geoffrey E.,0,0,0,0
1715661925086,BENG 196,001,628496,Engler; Adam J.,9998,0,9999,1
1715661925086,BENG 196,002,660916,Watson; John Thomas,9998,0,9999,1
1715661926112,BISP 197,001,650773,Wilhelm; James E.,9994,0,9999,5
1715661926112,BISP 197,002,658904,Coleman; Aaron B.,9998,0,9999,1
1715661927139,CAT 124RS,A01,519847,Geibel; William,0,0,20,20
1715661928167,CAT 125RS,A01,515971,Geibel; William,0,0,20,20
1715661929192,CLRE 250,A00,511389,Morris; Sheldon,9992,0,9999,7
1715661930225,CLRE 251,A00,507176,Mehta; Ravindra L.,9992,0,9999,7
1715661930225,CLRE 251,B00,511410,Mehta; Ravindra L.,9998,0,9999,1
1715661931253,CLRE 252,A00,507189,Cuomo; Raphael Eduardo,9994,0,9999,5
1715661932282,CLRE 253,A00,507199,Vaida; Florin,9994,0,9999,5
1715661932282,CLRE 253,B00,507202,Vaida; Florin,9999,0,9999,0
1715661933308,CLRE 259,A00,507211,Patel; Hemal,9996,0,9999,3
1715661934332,CLRE 260,A00,507221,Cuomo; Raphael Eduardo,9999,0,9999,0
1715661935358,CLRE 297,001,507242,Cuomo; Raphael Eduardo,9999,0,9999,0
1715661936384,COGS 197,001,638244,Voytek; Bradley Thomas,9997,0,9999,2
1715661937413,CSE 191,A00,516875,Minnes Kemp; Mor Mia,9991,0,9999,8
1715661938439,CSE 197,001,637388,Minnes Kemp; Mor Mia,9992,0,9999,7
1715661939471,CSS 201S,A01,494383,Mignozzetti; Umberto,35,0,35,0
1715661940497,CSS 202S,A01,494387,Mignozzetti; Umberto,35,0,35,0
1715661941522,DSC 197,001,628532,Eldridge; Justin Matthew,9995,0,9999,4
1715661942550,EAP 100,A00,516065,Staff,9799,0,9999,200
1715661943578,ECE 45,A01,507414,Staff,32,0,60,28
1715661945630,ECE 111,A01,507420,Staff,11,0,50,39
1715661946657,ECE 197,001,548057,Sievenpiper; Daniel F.,9991,0,9999,8
1715661947688,EDS 115,A00,507243,Choi; Bailey Miyeon,6,0,28,22
1715661948713,EDS 117,A01,494379,Staff,0,6,34,35
1715661949738,EDS 125,A00,507246,Hopkins; Megan Beth,7,0,30,23
1715661950766,EDS 128A,A01,507264,Fargason; Sharon Gayle,5,0,26,21
1715661951949,EDS 128B,A01,507293,Pappas; Elizabeth,9,0,30,21
1715661952975,EDS 139,A00,507294,Fargason; Sharon Gayle,9,0,30,21
1715661952975,EDS 139,B00,507313,Pappas; Elizabeth,9,0,30,21
1715661954004,EDS 201,A00,507315,Staff,10,0,30,20
1715661955033,EDS 203,A01,507317,Halter; Christopher P.,10,0,30,20
1715661956060,EDS 204R,A01,507319,Halter; Christopher P.,0,3,30,30
1715661956060,EDS 204R,B01,507331,Heinzman; Erica M.,14,0,30,16
1715661957085,EDS 206R,A00,507332,Staff,0,4,30,30
1715661957085,EDS 206R,B00,507343,Staff,15,0,30,15
1715661958112,EDS 250,A00,507344,Hemans; Patricia Ann Benitez,20,0,40,20
1715661959137,EDS 281,A00,507345,Daly; Alan J.,18,0,18,0
1715661960164,EDS 284,A00,507350,Daly; Alan J.,16,0,16,0
1715661961192,EDS 286,A00,507359,Fine; Sarah,18,0,18,0
1715661962220,EDS 289C,A01,507361,Daly; Alan J.,18,0,18,0
1715661963248,EDS 290,A00,507366,Hofstetter; Carolyn,15,0,15,0
1715661964276,LIGM 5A,A00,507421,Fischer-Grunski; Eva K,17,0,20,3
1715661965306,LIGM 5B,A00,507423,Fischer-Grunski; Eva K,19,0,20,1
1715661966334,LIGM 5C,A00,507425,Fischer-Grunski; Eva K,19,0,20,1
1715661967365,LIIT 5AS,A00,507427,Carnelos; Chiara,20,0,20,0
1715661968391,LIIT 5BS,A00,507430,Carnelos; Chiara,20,0,20,0
1715661969423,LIIT 5CS,A00,507432,Carnelos; Chiara,20,0,20,0
1715661970454,LISP 5A,A00,507541,Munoz Sanchez; Alicia,11,0,20,9
1715661971480,LISP 5B,A00,507671,Munoz Sanchez; Alicia,8,0,20,12
1715661972506,LISP 5C,A00,507696,Munoz Sanchez; Alicia,7,0,20,13
1715661973532,MAE 197,001,528363,Boechler; Nicholas Sebastia,9998,0,9999,1
1715661974565,MATH 197,001,523477,Kedlaya; Kiran S.,9994,0,9999,5
1715661974565,MATH 197,002,563811,Zhang; Danna,9994,0,9999,5
1715661974565,MATH 197,003,628552,Dumitriu; Ioana,9998,0,9999,1
1715661974565,MATH 197,004,660885,Floyd; Eric,9998,0,9999,1
1715661975593,MCWP 40R,A00,518780,Staff,1,0,20,19
1715661975593,MCWP 40R,B00,518781,Carter; Jennifer A,9,0,20,11
1715661975593,MCWP 40R,C00,518783,Smith; Haydee Marie,5,0,20,15
1715661980046,MCWP 50R,A00,518791,Redela; Pamela Morgan,0,1,20,20
1715661980046,MCWP 50R,B00,518792,Krone; Jarret,0,2,20,20
1715661980046,MCWP 50R,C00,518793,Staff,0,4,20,20
1715661980046,MCWP 50R,D00,518794,Morshed; Michael James,0,2,20,20
1715661980046,MCWP 50R,E00,518795,Carter; Andrea L,0,2,20,20
1715661980046,MCWP 50R,F00,518796,Miller; Elizabeth Deen,0,1,20,20
1715661980046,MCWP 50R,G00,518797,Guillen; Melinda,0,1,20,20
1715661981073,MMW 12R,A01,514034,Herbst; Matthew,0,2,16,16
1715661981073,MMW 12R,A02,514035,Herbst; Matthew,0,0,16,16
1715661982102,MMW 13R,A01,514037,Staff,0,5,16,16
1715661982102,MMW 13R,A02,514039,Staff,0,5,16,16
1715661982102,MMW 13R,A03,628519,Staff,0,4,16,16
1715661984156,SIO 295LS,A00,523233,Staff,10,0,30,20
1715661985185,SIO 295S,A00,523232,Staff,10,0,30,20
1715661986216,SIOC 290S,A01,637330,Merrifield; Mark A,21,0,30,9
1715661987243,SIOC 291S,A01,637333,Gabriel; Corey John,21,0,30,9
1715661988269,SOCI 117,A01,494376,Staff,0,5,5,5
1715661989295,WES 237B,A00,494380,Staff,10,0,20,10
1715661991367,AESE 279B,A00,494370,Wade; Jon P,0,0,33,33
1715661992394,AIP 97,001,660915,Van Den Einde; Yael Dahlia,9998,0,9999,1
1715661993424,AIP 197,001,627712,Vespa; Emanuel Ignacio,9995,0,9999,4
1715661993424,AIP 197,002,650778,Amir; On,9998,0,9999,1
1715661993424,AIP 197,003,650933,Avenancio-Leon; Carlos,9998,0,9999,1
1715661993424,AIP 197,004,658530,Heyman; Gail D.,9998,0,9999,1
1715661993424,AIP 197,005,658631,Neal; Sonya E,9998,0,9999,1
1715661993424,AIP 197,006,658671,Du; Songzi,9998,0,9999,1
1715661994450,ANAR 135S,A00,494369,Braswell; Geoffrey E.,0,0,0,0
1715661996887,BISP 197,001,650773,Wilhelm; James E.,9994,0,9999,5
1715661996887,BISP 197,002,658904,Coleman; Aaron B.,9998,0,9999,1
1715661997914,CAT 124RS,A01,519847,Geibel; William,0,0,20,20
1715661998942,CAT 125RS,A01,515971,Geibel; William,0,0,20,20
1715661999970,CLRE 250,A00,511389,Morris; Sheldon,9992,0,9999,7
1715662001000,CLRE 251,A00,507176,Mehta; Ravindra L.,9992,0,9999,7
1715662001000,CLRE 251,B00,511410,Mehta; Ravindra L.,9998,0,9999,1
1715662002024,CLRE 252,A00,507189,Cuomo; Raphael Eduardo,9994,0,9999,5
1715662003051,CLRE 253,A00,507199,Vaida; Florin,9994,0,9999,5
1715662003051,CLRE 253,B00,507202,Vaida; Florin,9999,0,9999,0
1715662004075,CLRE 259,A00,507211,Patel; Hemal,9996,0,9999,3
1715662005101,CLRE 260,A00,507221,Cuomo; Raphael Eduardo,9999,0,9999,0
1715662006127,CLRE 297,001,507242,Cuomo; Raphael Eduardo,9999,0,9999,0
1715662007154,COGS 197,001,638244,Voytek; Bradley Thomas,9997,0,9999,2
1715662008180,CSE 191,A00,516875,Minnes Kemp; Mor Mia,9991,0,9999,8
1715662009205,CSE 197,001,637388,Minnes Kemp; Mor Mia,9992,0,9999,7
1715662010231,CSS 201S,A01,494383,Mignozzetti; Umberto,35,0,35,0
1715662011257,CSS 202S,A01,494387,Mignozzetti; Umberto,35,0,35,0
1715662012287,DSC 197,001,628532,Eldridge; Justin Matthew,9995,0,9999,4
1715662013312,EAP 100,A00,516065,Staff,9799,0,9999,200
1715662014338,ECE 45,A01,507414,Staff,32,0,60,28
1715662016393,ECE 111,A01,507420,Staff,11,0,50,39
1715662017418,ECE 197,001,548057,Sievenpiper; Daniel F.,9991,0,9999,8
1715662018449,EDS 115,A00,507243,Choi; Bailey Miyeon,6,0,28,22
1715662019478,EDS 117,A01,494379,Staff,0,6,34,35
1715662020506,EDS 125,A00,507246,Hopkins; Megan Beth,7,0,30,23
1715662021537,EDS 128A,A01,507264,Fargason; Sharon Gayle,5,0,26,21
1715662022564,EDS 128B,A01,507293,Pappas; Elizabeth,9,0,30,21
1715662023592,EDS 139,A00,507294,Fargason; Sharon Gayle,9,0,30,21
1715662023592,EDS 139,B00,507313,Pappas; Elizabeth,9,0,30,21
1715662024617,EDS 201,A00,507315,Staff,10,0,30,20
1715662025643,EDS 203,A01,507317,Halter; Christopher P.,10,0,30,20
1715662026668,EDS 204R,A01,507319,Halter; Christopher P.,0,3,30,30
1715662026668,EDS 204R,B01,507331,Heinzman; Erica M.,14,0,30,16
1715662027693,EDS 206R,A00,507332,Staff,0,4,30,30
1715662027693,EDS 206R,B00,507343,Staff,15,0,30,15
1715662028719,EDS 250,A00,507344,Hemans; Patricia Ann Benitez,20,0,40,20
1715662029748,EDS 281,A00,507345,Daly; Alan J.,18,0,18,0
1715662030772,EDS 284,A00,507350,Daly; Alan J.,16,0,16,0
1715662031799,EDS 286,A00,507359,Fine; Sarah,18,0,18,0
1715662032824,EDS 289C,A01,507361,Daly; Alan J.,18,0,18,0
1715662033853,EDS 290,A00,507366,Hofstetter; Carolyn,15,0,15,0
1715662034879,LIGM 5A,A00,507421,Fischer-Grunski; Eva K,17,0,20,3
1715662035904,LIGM 5B,A00,507423,Fischer-Grunski; Eva K,19,0,20,1
1715662036930,LIGM 5C,A00,507425,Fischer-Grunski; Eva K,19,0,20,1
1715662037957,LIIT 5AS,A00,507427,Carnelos; Chiara,20,0,20,0
1715662038982,LIIT 5BS,A00,507430,Carnelos; Chiara,20,0,20,0
1715662040007,LIIT 5CS,A00,507432,Carnelos; Chiara,20,0,20,0
1715662041035,LISP 5A,A00,507541,Munoz Sanchez; Alicia,11,0,20,9
1715662042061,LISP 5B,A00,507671,Munoz Sanchez; Alicia,8,0,20,12
1715662043087,LISP 5C,A00,507696,Munoz Sanchez; Alicia,7,0,20,13
1715662044115,MAE 197,001,528363,Boechler; Nicholas Sebastia,9998,0,9999,1
1715662045142,MATH 197,001,523477,Kedlaya; Kiran S.,9994,0,9999,5
1715662045142,MATH 197,002,563811,Zhang; Danna,9994,0,9999,5
1715662045142,MATH 197,003,628552,Dumitriu; Ioana,9998,0,9999,1
1715662045142,MATH 197,004,660885,Floyd; Eric,9998,0,9999,1
1715662046168,MCWP 40R,A00,518780,Staff,1,0,20,19
1715662046168,MCWP 40R,B00,518781,Carter; Jennifer A,9,0,20,11
1715662046168,MCWP 40R,C00,518783,Smith; Haydee Marie,5,0,20,15
1715662047195,MCWP 50R,A00,518791,Redela; Pamela Morgan,0,1,20,20
1715662047195,MCWP 50R,B00,518792,Krone; Jarret,0,2,20,20
1715662047195,MCWP 50R,C00,518793,Staff,0,4,20,20
1715662047195,MCWP 50R,D00,518794,Morshed; Michael James,0,2,20,20
1715662047195,MCWP 50R,E00,518795,Carter; Andrea L,0,2,20,20
1715662047195,MCWP 50R,F00,518796,Miller; Elizabeth Deen,0,1,20,20
1715662047195,MCWP 50R,G00,518797,Guillen; Melinda,0,1,20,20
1715662048224,MMW 12R,A01,514034,Herbst; Matthew,0,2,16,16
1715662048224,MMW 12R,A02,514035,Herbst; Matthew,0,0,16,16
1715662049248,MMW 13R,A01,514037,Staff,0,5,16,16
1715662049248,MMW 13R,A02,514039,Staff,0,5,16,16
1715662049248,MMW 13R,A03,628519,Staff,0,4,16,16
1715662051377,SIO 295LS,A00,523233,Staff,10,0,30,20
1715662052402,SIO 295S,A00,523232,Staff,10,0,30,20
1715662053432,SIOC 290S,A01,637330,Merrifield; Mark A,21,0,30,9
1715662054458,SIOC 291S,A01,637333,Gabriel; Corey John,21,0,30,9
1715662055483,SOCI 117,A01,494376,Staff,0,5,5,5
1715662056508,WES 237B,A00,494380,Staff,10,0,20,10
1715662058576,AESE 279B,A00,494370,Wade; Jon P,0,0,33,33
1715662059601,AIP 97,001,660915,Van Den Einde; Yael Dahlia,9998,0,9999,1
1715662060631,AIP 197,001,627712,Vespa; Emanuel Ignacio,9995,0,9999,4
1715662060631,AIP 197,002,650778,Amir; On,9998,0,9999,1
1715662060631,AIP 197,003,650933,Avenancio-Leon; Carlos,9998,0,9999,1
1715662060631,AIP 197,004,658530,Heyman; Gail D.,9998,0,9999,1
1715662060631,AIP 197,005,658631,Neal; Sonya E,9998,0,9999,1
1715662060631,AIP 197,006,658671,Du; Songzi,9998,0,9999,1
1715662061657,ANAR 135S,A00,494369,Braswell; Geoffrey E.,0,0,0,0
1715662062685,BENG 196,001,628496,Engler; Adam J.,9998,0,9999,1
1715662062685,BENG 196,002,660916,Watson; John Thomas,9998,0,9999,1
1715662063709,BISP 197,001,650773,Wilhelm; James E.,9994,0,9999,5
1715662063709,BISP 197,002,658904,Coleman; Aaron B.,9998,0,9999,1
1715662064734,CAT 124RS,A01,519847,Geibel; William,0,0,20,20
1715662065761,CAT 125RS,A01,515971,Geibel; William,0,0,20,20
1715662066786,CLRE 250,A00,511389,Morris; Sheldon,9992,0,9999,7
1715662067812,CLRE 251,A00,507176,Mehta; Ravindra L.,9992,0,9999,7
1715662067812,CLRE 251,B00,511410,Mehta; Ravindra L.,9998,0,9999,1
1715662068841,CLRE 252,A00,507189,Cuomo; Raphael Eduardo,9994,0,9999,5
1715662069865,CLRE 253,A00,507199,Vaida; Florin,9994,0,9999,5
1715662069865,CLRE 253,B00,507202,Vaida; Florin,9999,0,9999,0
1715662070890,CLRE 259,A00,507211,Patel; Hemal,9996,0,9999,3
1715662071916,CLRE 260,A00,507221,Cuomo; Raphael Eduardo,9999,0,9999,0
1715662072943,CLRE 297,001,507242,Cuomo; Raphael Eduardo,9999,0,9999,0
1715662073969,COGS 197,001,638244,Voytek; Bradley Thomas,9997,0,9999,2
1715662075000,CSE 191,A00,516875,Minnes Kemp; Mor Mia,9991,0,9999,8
1715662076030,CSE 197,001,637388,Minnes Kemp; Mor Mia,9992,0,9999,7
1715662077058,CSS 201S,A01,494383,Mignozzetti; Umberto,35,0,35,0
1715662078085,CSS 202S,A01,494387,Mignozzetti; Umberto,35,0,35,0
1715662079111,DSC 197,001,628532,Eldridge; Justin Matthew,9995,0,9999,4
1715662080136,EAP 100,A00,516065,Staff,9799,0,9999,200
1715662081164,ECE 45,A01,507414,Staff,32,0,60,28
1715662083218,ECE 111,A01,507420,Staff,11,0,50,39
1715662084248,ECE 197,001,548057,Sievenpiper; Daniel F.,9991,0,9999,8
1715662085279,EDS 115,A00,507243,Choi; Bailey Miyeon,6,0,28,22
1715662086307,EDS 117,A01,494379,Staff,0,6,34,35
1715662087335,EDS 125,A00,507246,Hopkins; Megan Beth,7,0,30,23
1715662088361,EDS 128A,A01,507264,Fargason; Sharon Gayle,5,0,26,21
1715662089390,EDS 128B,A01,507293,Pappas; Elizabeth,9,0,30,21
1715662090416,EDS 139,A00,507294,Fargason; Sharon Gayle,9,0,30,21
1715662090416,EDS 139,B00,507313,Pappas; Elizabeth,9,0,30,21
1715662091443,EDS 201,A00,507315,Staff,10,0,30,20
1715662092475,EDS 203,A01,507317,Halter; Christopher P.,10,0,30,20
1715662093501,EDS 204R,A01,507319,Halter; Christopher P.,0,3,30,30
1715662093501,EDS 204R,B01,507331,Heinzman; Erica M.,14,0,30,16
1715662094528,EDS 206R,A00,507332,Staff,0,4,30,30
1715662094528,EDS 206R,B00,507343,Staff,15,0,30,15
1715662095557,EDS 250,A00,507344,Hemans; Patricia Ann Benitez,20,0,40,20
1715662096582,EDS 281,A00,507345,Daly; Alan J.,18,0,18,0
1715662097607,EDS 284,A00,507350,Daly; Alan J.,16,0,16,0
1715662098632,EDS 286,A00,507359,Fine; Sarah,18,0,18,0
1715662099656,EDS 289C,A01,507361,Daly; Alan J.,18,0,18,0
1715662100682,EDS 290,A00,507366,Hofstetter; Carolyn,15,0,15,0
1715662101717,LIGM 5A,A00,507421,Fischer-Grunski; Eva K,17,0,20,3
1715662102743,LIGM 5B,A00,507423,Fischer-Grunski; Eva K,19,0,20,1
1715662103769,LIGM 5C,A00,507425,Fischer-Grunski; Eva K,19,0,20,1
1715662104795,LIIT 5AS,A00,507427,Carnelos; Chiara,20,0,20,0
1715662105824,LIIT 5BS,A00,507430,Carnelos; Chiara,20,0,20,0
1715662106853,LIIT 5CS,A00,507432,Carnelos; Chiara,20,0,20,0
1715662107882,LISP 5A,A00,507541,Munoz Sanchez; Alicia,11,0,20,9
1715662108911,LISP 5B,A00,507671,Munoz Sanchez; Alicia,8,0,20,12
1715662109939,LISP 5C,A00,507696,Munoz Sanchez; Alicia,7,0,20,13
1715662110966,MAE 197,001,528363,Boechler; Nicholas Sebastia,9998,0,9999,1
1715662111992,MATH 197,001,523477,Kedlaya; Kiran S.,9994,0,9999,5
1715662111992,MATH 197,002,563811,Zhang; Danna,9994,0,9999,5
1715662111992,MATH 197,003,628552,Dumitriu; Ioana,9998,0,9999,1
1715662111992,MATH 197,004,660885,Floyd; Eric,9998,0,9999,1
1715662113020,MCWP 40R,A00,518780,Staff,1,0,20,19
1715662113020,MCWP 40R,B00,518781,Carter; Jennifer A,9,0,20,11
1715662113020,MCWP 40R,C00,518783,Smith; Haydee Marie,5,0,20,15
1715662114049,MCWP 50R,A00,518791,Redela; Pamela Morgan,0,1,20,20
1715662114049,MCWP 50R,B00,518792,Krone; Jarret,0,2,20,20
1715662114049,MCWP 50R,C00,518793,Staff,0,4,20,20
1715662114049,MCWP 50R,D00,518794,Morshed; Michael James,0,2,20,20
1715662114049,MCWP 50R,E00,518795,Carter; Andrea L,0,2,20,20
1715662114049,MCWP 50R,F00,518796,Miller; Elizabeth Deen,0,1,20,20
1715662114049,MCWP 50R,G00,518797,Guillen; Melinda,0,1,20,20
1715662115074,MMW 12R,A01,514034,Herbst; Matthew,0,2,16,16
1715662115074,MMW 12R,A02,514035,Herbst; Matthew,0,0,16,16
1715662116099,MMW 13R,A01,514037,Staff,0,5,16,16
1715662116099,MMW 13R,A02,514039,Staff,0,5,16,16
1715662116099,MMW 13R,A03,628519,Staff,0,4,16,16
1715662118155,SIO 295LS,A00,523233,Staff,10,0,30,20
1715662119180,SIO 295S,A00,523232,Staff,10,0,30,20
1715662120210,SIOC 290S,A01,637330,Merrifield; Mark A,21,0,30,9
1715662121238,SIOC 291S,A01,637333,Gabriel; Corey John,21,0,30,9
1715662122264,SOCI 117,A01,494376,Staff,0,5,5,5
1715662123292,WES 237B,A00,494380,Staff,10,0,20,10
1715662125363,AESE 279B,A00,494370,Wade; Jon P,0,0,33,33
1715662126389,AIP 97,001,660915,Van Den Einde; Yael Dahlia,9998,0,9999,1
1715662127417,AIP 197,001,627712,Vespa; Emanuel Ignacio,9995,0,9999,4
1715662127417,AIP 197,002,650778,Amir; On,9998,0,9999,1
1715662127417,AIP 197,003,650933,Avenancio-Leon; Carlos,9998,0,9999,1
1715662127417,AIP 197,004,658530,Heyman; Gail D.,9998,0,9999,1
1715662127417,AIP 197,005,658631,Neal; Sonya E,9998,0,9999,1
1715662127417,AIP 197,006,658671,Du; Songzi,9998,0,9999,1
1715662128444,ANAR 135S,A00,494369,Braswell; Geoffrey E.,0,0,0,0
1715662129474,BENG 196,001,628496,Engler; Adam J.,9998,0,9999,1
1715662129474,BENG 196,002,660916,Watson; John Thomas,9998,0,9999,1
1715662130504,BISP 197,001,650773,Wilhelm; James E.,9994,0,9999,5
1715662130504,BISP 197,002,658904,Coleman; Aaron B.,9998,0,9999,1
1715662131532,CAT 124RS,A01,519847,Geibel; William,0,0,20,20
1715662132560,CAT 125RS,A01,515971,Geibel; William,0,0,20,20
1715662133588,CLRE 250,A00,511389,Morris; Sheldon,9992,0,9999,7
1715662134617,CLRE 251,A00,507176,Mehta; Ravindra L.,9992,0,9999,7
1715662134617,CLRE 251,B00,511410,Mehta; Ravindra L.,9998,0,9999,1
1715662135642,CLRE 252,A00,507189,Cuomo; Raphael Eduardo,9994,0,9999,5
1715662136670,CLRE 253,A00,507199,Vaida; Florin,9994,0,9999,5
1715662136670,CLRE 253,B00,507202,Vaida; Florin,9999,0,9999,0
1715662137694,CLRE 259,A00,507211,Patel; Hemal,9996,0,9999,3
1715662138719,CLRE 260,A00,507221,Cuomo; Raphael Eduardo,9999,0,9999,0
1715662139745,CLRE 297,001,507242,Cuomo; Raphael Eduardo,9999,0,9999,0
1715662140774,COGS 197,001,638244,Voytek; Bradley Thomas,9997,0,9999,2
1715662141800,CSE 191,A00,516875,Minnes Kemp; Mor Mia,9991,0,9999,8
1715662142825,CSE 197,001,637388,Minnes Kemp; Mor Mia,9992,0,9999,7
1715662143853,CSS 201S,A01,494383,Mignozzetti; Umberto,35,0,35,0
1715662144878,CSS 202S,A01,494387,Mignozzetti; Umberto,35,0,35,0
1715662145904,DSC 197,001,628532,Eldridge; Justin Matthew,9995,0,9999,4
1715662146932,EAP 100,A00,516065,Staff,9799,0,9999,200
1715662147959,ECE 45,A01,507414,Staff,32,0,60,28
1715662150015,ECE 111,A01,507420,Staff,11,0,50,39
1715662151040,ECE 197,001,548057,Sievenpiper; Daniel F.,9991,0,9999,8
1715662152068,EDS 115,A00,507243,Choi; Bailey Miyeon,6,0,28,22
1715662153096,EDS 117,A01,494379,Staff,0,6,34,35
1715662154122,EDS 125,A00,507246,Hopkins; Megan Beth,7,0,30,23
1715662155204,EDS 128A,A01,507264,Fargason; Sharon Gayle,5,0,26,21
1715662156230,EDS 128B,A01,507293,Pappas; Elizabeth,9,0,30,21
1715662157257,EDS 139,A00,507294,Fargason; Sharon Gayle,9,0,30,21
1715662157257,EDS 139,B00,507313,Pappas; Elizabeth,9,0,30,21
1715662158282,EDS 201,A00,507315,Staff,10,0,30,20
1715662159308,EDS 203,A01,507317,Halter; Christopher P.,10,0,30,20
1715662160333,EDS 204R,A01,507319,Halter; Christopher P.,0,3,30,30
1715662160333,EDS 204R,B01,507331,Heinzman; Erica M.,14,0,30,16
1715662161360,EDS 206R,A00,507332,Staff,0,4,30,30
1715662161360,EDS 206R,B00,507343,Staff,15,0,30,15
1715662162385,EDS 250,A00,507344,Hemans; Patricia Ann Benitez,20,0,40,20
1715662163410,EDS 281,A00,507345,Daly; Alan J.,18,0,18,0
1715662164437,EDS 284,A00,507350,Daly; Alan J.,16,0,16,0
1715662165466,EDS 286,A00,507359,Fine; Sarah,18,0,18,0
1715662166494,EDS 289C,A01,507361,Daly; Alan J.,18,0,18,0
1715662167519,EDS 290,A00,507366,Hofstetter; Carolyn,15,0,15,0
1715662168545,LIGM 5A,A00,507421,Fischer-Grunski; Eva K,17,0,20,3
1715662169575,LIGM 5B,A00,507423,Fischer-Grunski; Eva K,19,0,20,1
1715662170605,LIGM 5C,A00,507425,Fischer-Grunski; Eva K,19,0,20,1
1715662171634,LIIT 5AS,A00,507427,Carnelos; Chiara,20,0,20,0
1715662172661,LIIT 5BS,A00,507430,Carnelos; Chiara,20,0,20,0
1715662173688,LIIT 5CS,A00,507432,Carnelos; Chiara,20,0,20,0
1715662174717,LISP 5A,A00,507541,Munoz Sanchez; Alicia,11,0,20,9
1715662175745,LISP 5B,A00,507671,Munoz Sanchez; Alicia,8,0,20,12
1715662176770,LISP 5C,A00,507696,Munoz Sanchez; Alicia,7,0,20,13
1715662177796,MAE 197,001,528363,Boechler; Nicholas Sebastia,9998,0,9999,1
1715662178831,MATH 197,001,523477,Kedlaya; Kiran S.,9994,0,9999,5
1715662178831,MATH 197,002,563811,Zhang; Danna,9994,0,9999,5
1715662178831,MATH 197,003,628552,Dumitriu; Ioana,9998,0,9999,1
1715662178831,MATH 197,004,660885,Floyd; Eric,9998,0,9999,1
1715662179859,MCWP 40R,A00,518780,Staff,1,0,20,19
1715662179859,MCWP 40R,B00,518781,Carter; Jennifer A,9,0,20,11
1715662179859,MCWP 40R,C00,518783,Smith; Haydee Marie,5,0,20,15
1715662180889,MCWP 50R,A00,518791,Redela; Pamela Morgan,0,1,20,20
1715662180889,MCWP 50R,B00,518792,Krone; Jarret,0,2,20,20
1715662180889,MCWP 50R,C00,518793,Staff,0,4,20,20
1715662180889,MCWP 50R,D00,518794,Morshed; Michael James,0,2,20,20
1715662180889,MCWP 50R,E00,518795,Carter; Andrea L,0,2,20,20
1715662180889,MCWP 50R,F00,518796,Miller; Elizabeth Deen,0,1,20,20
1715662180889,MCWP 50R,G00,518797,Guillen; Melinda,0,1,20,20
1715662181915,MMW 12R,A01,514034,Herbst; Matthew,0,2,16,16
1715662181915,MMW 12R,A02,514035,Herbst; Matthew,0,0,16,16
1715662182943,MMW 13R,A01,514037,Staff,0,5,16,16
1715662182943,MMW 13R,A02,514039,Staff,0,5,16,16
1715662182943,MMW 13R,A03,628519,Staff,0,4,16,16
1715662184998,SIO 295LS,A00,523233,Staff,10,0,30,20
1715662186023,SIO 295S,A00,523232,Staff,10,0,30,20
1715662187048,SIOC 290S,A01,637330,Merrifield; Mark A,21,0,30,9
1715662188079,SIOC 291S,A01,637333,Gabriel; Corey John,21,0,30,9
1715662189106,SOCI 117,A01,494376,Staff,0,5,5,5
1715662190131,WES 237B,A00,494380,Staff,10,0,20,10
1715662192219,AESE 279B,A00,494370,Wade; Jon P,0,0,33,33
1715662193246,AIP 97,001,660915,Van Den Einde; Yael Dahlia,9998,0,9999,1
1715662194277,AIP 197,001,627712,Vespa; Emanuel Ignacio,9995,0,9999,4
1715662194277,AIP 197,002,650778,Amir; On,9998,0,9999,1
1715662194277,AIP 197,003,650933,Avenancio-Leon; Carlos,9998,0,9999,1
1715662194277,AIP 197,004,658530,Heyman; Gail D.,9998,0,9999,1
1715662194277,AIP 197,005,658631,Neal; Sonya E,9998,0,9999,1
1715662194277,AIP 197,006,658671,Du; Songzi,9998,0,9999,1
1715662195302,ANAR 135S,A00,494369,Braswell; Geoffrey E.,0,0,0,0
1715662196332,BENG 196,001,628496,Engler; Adam J.,9998,0,9999,1
1715662196332,BENG 196,002,660916,Watson; John Thomas,9998,0,9999,1
1715662197361,BISP 197,001,650773,Wilhelm; James E.,9994,0,9999,5
1715662197361,BISP 197,002,658904,Coleman; Aaron B.,9998,0,9999,1
1715662198388,CAT 124RS,A01,519847,Geibel; William,0,0,20,20
1715662199414,CAT 125RS,A01,515971,Geibel; William,0,0,20,20
1715662200442,CLRE 250,A00,511389,Morris; Sheldon,9992,0,9999,7
1715662201472,CLRE 251,A00,507176,Mehta; Ravindra L.,9992,0,9999,7
1715662201472,CLRE 251,B00,511410,Mehta; Ravindra L.,9998,0,9999,1
1715662202499,CLRE 252,A00,507189,Cuomo; Raphael Eduardo,9994,0,9999,5
1715662203529,CLRE 253,A00,507199,Vaida; Florin,9994,0,9999,5
1715662203529,CLRE 253,B00,507202,Vaida; Florin,9999,0,9999,0
1715662204554,CLRE 259,A00,507211,Patel; Hemal,9996,0,9999,3
1715662205580,CLRE 260,A00,507221,Cuomo; Raphael Eduardo,9999,0,9999,0
1715662206605,CLRE 297,001,507242,Cuomo; Raphael Eduardo,9999,0,9999,0
1715662207630,COGS 197,001,638244,Voytek; Bradley Thomas,9997,0,9999,2
1715662208658,CSE 191,A00,516875,Minnes Kemp; Mor Mia,9991,0,9999,8
1715662209684,CSE 197,001,637388,Minnes Kemp; Mor Mia,9992,0,9999,7
1715662210710,CSS 201S,A01,494383,Mignozzetti; Umberto,35,0,35,0
1715662211734,CSS 202S,A01,494387,Mignozzetti; Umberto,35,0,35,0
1715662212761,DSC 197,001,628532,Eldridge; Justin Matthew,9995,0,9999,4
1715662213788,EAP 100,A00,516065,Staff,9799,0,9999,200
1715662214820,ECE 45,A01,507414,Staff,32,0,60,28
1715662216872,ECE 111,A01,507420,Staff,11,0,50,39
1715662217896,ECE 197,001,548057,Sievenpiper; Daniel F.,9991,0,9999,8
1715662218926,EDS 115,A00,507243,Choi; Bailey Miyeon,6,0,28,22
1715662219952,EDS 117,A01,494379,Staff,0,6,34,35
1715662220977,EDS 125,A00,507246,Hopkins; Megan Beth,7,0,30,23
1715662222004,EDS 128A,A01,507264,Fargason; Sharon Gayle,5,0,26,21
1715662223030,EDS 128B,A01,507293,Pappas; Elizabeth,9,0,30,21
1715662224056,EDS 139,A00,507294,Fargason; Sharon Gayle,9,0,30,21
1715662224056,EDS 139,B00,507313,Pappas; Elizabeth,9,0,30,21
1715662225084,EDS 201,A00,507315,Staff,10,0,30,20
1715662226115,EDS 203,A01,507317,Halter; Christopher P.,10,0,30,20
1715662227140,EDS 204R,A01,507319,Halter; Christopher P.,0,3,30,30
1715662227140,EDS 204R,B01,507331,Heinzman; Erica M.,14,0,30,16
1715662228170,EDS 206R,A00,507332,Staff,0,4,30,30
1715662228170,EDS 206R,B00,507343,Staff,15,0,30,15
1715662229198,EDS 250,A00,507344,Hemans; Patricia Ann Benitez,20,0,40,20
1715662230223,EDS 281,A00,507345,Daly; Alan J.,18,0,18,0
1715662231249,EDS 284,A00,507350,Daly; Alan J.,16,0,16,0
1715662232277,EDS 286,A00,507359,Fine; Sarah,18,0,18,0
1715662233301,EDS 289C,A01,507361,Daly; Alan J.,18,0,18,0
1715662234327,EDS 290,A00,507366,Hofstetter; Carolyn,15,0,15,0
1715662235352,LIGM 5A,A00,507421,Fischer-Grunski; Eva K,17,0,20,3
1715662236381,LIGM 5B,A00,507423,Fischer-Grunski; Eva K,19,0,20,1
1715662237406,LIGM 5C,A00,507425,Fischer-Grunski; Eva K,19,0,20,1
1715662238439,LIIT 5AS,A00,507427,Carnelos; Chiara,20,0,20,0
1715662239465,LIIT 5BS,A00,507430,Carnelos; Chiara,20,0,20,0
1715662240491,LIIT 5CS,A00,507432,Carnelos; Chiara,20,0,20,0
1715662241517,LISP 5A,A00,507541,Munoz Sanchez; Alicia,11,0,20,9
1715662242545,LISP 5B,A00,507671,Munoz Sanchez; Alicia,8,0,20,12
1715662243573,LISP 5C,A00,507696,Munoz Sanchez; Alicia,7,0,20,13
1715662244599,MAE 197,001,528363,Boechler; Nicholas Sebastia,9998,0,9999,1
1715662245629,MATH 197,001,523477,Kedlaya; Kiran S.,9994,0,9999,5
1715662245629,MATH 197,002,563811,Zhang; Danna,9994,0,9999,5
1715662245629,MATH 197,003,628552,Dumitriu; Ioana,9998,0,9999,1
1715662245629,MATH 197,004,660885,Floyd; Eric,9998,0,9999,1
1715662246656,MCWP 40R,A00,518780,Staff,1,0,20,19
1715662246656,MCWP 40R,B00,518781,Carter; Jennifer A,9,0,20,11
1715662246656,MCWP 40R,C00,518783,Smith; Haydee Marie,5,0,20,15
1715662247684,MCWP 50R,A00,518791,Redela; Pamela Morgan,0,1,20,20
1715662247684,MCWP 50R,B00,518792,Krone; Jarret,0,2,20,20
1715662247684,MCWP 50R,C00,518793,Staff,0,4,20,20
1715662247684,MCWP 50R,D00,518794,Morshed; Michael James,0,2,20,20
1715662247684,MCWP 50R,E00,518795,Carter; Andrea L,0,2,20,20
1715662247684,MCWP 50R,F00,518796,Miller; Elizabeth Deen,0,1,20,20
1715662247684,MCWP 50R,G00,518797,Guillen; Melinda,0,1,20,20
1715662248713,MMW 12R,A01,514034,Herbst; Matthew,0,2,16,16
1715662248713,MMW 12R,A02,514035,Herbst; Matthew,0,0,16,16
1715662249739,MMW 13R,A01,514037,Staff,0,5,16,16
1715662249739,MMW 13R,A02,514039,Staff,0,5,16,16
1715662249739,MMW 13R,A03,628519,Staff,0,4,16,16
1715662251792,SIO 295LS,A00,523233,Staff,10,0,30,20
1715662252817,SIO 295S,A00,523232,Staff,10,0,30,20
1715662253844,SIOC 290S,A01,637330,Merrifield; Mark A,21,0,30,9
1715662254873,SIOC 291S,A01,637333,Gabriel; Corey John,21,0,30,9
1715662255903,SOCI 117,A01,494376,Staff,0,5,5,5
1715662256930,WES 237B,A00,494380,Staff,10,0,20,10
1715662259054,AESE 279B,A00,494370,Wade; Jon P,0,0,33,33
1715662260080,AIP 97,001,660915,Van Den Einde; Yael Dahlia,9998,0,9999,1
1715662261110,AIP 197,001,627712,Vespa; Emanuel Ignacio,9995,0,9999,4
1715662261110,AIP 197,002,650778,Amir; On,9998,0,9999,1
1715662261110,AIP 197,003,650933,Avenancio-Leon; Carlos,9998,0,9999,1
1715662261110,AIP 197,004,658530,Heyman; Gail D.,9998,0,9999,1
1715662261110,AIP 197,005,658631,Neal; Sonya E,9998,0,9999,1
1715662261110,AIP 197,006,658671,Du; Songzi,9998,0,9999,1
1715662262142,ANAR 135S,A00,494369,Braswell; Geoffrey E.,0,0,0,0
1715662263173,BENG 196,001,628496,Engler; Adam J.,9998,0,9999,1
1715662263173,BENG 196,002,660916,Watson; John Thomas,9998,0,9999,1
1715662264203,BISP 197,001,650773,Wilhelm; James E.,9994,0,9999,5
1715662264203,BISP 197,002,658904,Coleman; Aaron B.,9998,0,9999,1
1715662265230,CAT 124RS,A01,519847,Geibel; William,0,0,20,20
1715662266257,CAT 125RS,A01,515971,Geibel; William,0,0,20,20
1715662267283,CLRE 250,A00,511389,Morris; Sheldon,9992,0,9999,7
1715662268311,CLRE 251,A00,507176,Mehta; Ravindra L.,9992,0,9999,7
1715662268311,CLRE 251,B00,511410,Mehta; Ravindra L.,9998,0,9999,1
1715662269337,CLRE 252,A00,507189,Cuomo; Raphael Eduardo,9994,0,9999,5
1715662270363,CLRE 253,A00,507199,Vaida; Florin,9994,0,9999,5
1715662270363,CLRE 253,B00,507202,Vaida; Florin,9999,0,9999,0
1715662271387,CLRE 259,A00,507211,Patel; Hemal,9996,0,9999,3
1715662272412,CLRE 260,A00,507221,Cuomo; Raphael Eduardo,9999,0,9999,0
1715662273439,CLRE 297,001,507242,Cuomo; Raphael Eduardo,9999,0,9999,0
1715662274465,COGS 197,001,638244,Voytek; Bradley Thomas,9997,0,9999,2
1715662275490,CSE 191,A00,516875,Minnes Kemp; Mor Mia,9991,0,9999,8
1715662276515,CSE 197,001,637388,Minnes Kemp; Mor Mia,9992,0,9999,7
1715662277548,CSS 201S,A01,494383,Mignozzetti; Umberto,35,0,35,0
1715662278577,CSS 202S,A01,494387,Mignozzetti; Umberto,35,0,35,0
1715662279602,DSC 197,001,628532,Eldridge; Justin Matthew,9995,0,9999,4
1715662280626,EAP 100,A00,516065,Staff,9799,0,9999,200
1715662281655,ECE 45,A01,507414,Staff,32,0,60,28
1715662283707,ECE 111,A01,507420,Staff,11,0,50,39
1715662284732,ECE 197,001,548057,Sievenpiper; Daniel F.,9991,0,9999,8
1715662285764,EDS 115,A00,507243,Choi; Bailey Miyeon,6,0,28,22
1715662286792,EDS 117,A01,494379,Staff,0,6,34,35
1715662287816,EDS 125,A00,507246,Hopkins; Megan Beth,7,0,30,23
1715662288847,EDS 128A,A01,507264,Fargason; Sharon Gayle,5,0,26,21
1715662289873,EDS 128B,A01,507293,Pappas; Elizabeth,9,0,30,21
1715662290900,EDS 139,A00,507294,Fargason; Sharon Gayle,9,0,30,21
1715662290900,EDS 139,B00,507313,Pappas; Elizabeth,9,0,30,21
1715662291924,EDS 201,A00,507315,Staff,10,0,30,20
1715662292952,EDS 203,A01,507317,Halter; Christopher P.,10,0,30,20
1715662293983,EDS 204R,A01,507319,Halter; Christopher P.,0,3,30,30
1715662293983,EDS 204R,B01,507331,Heinzman; Erica M.,14,0,30,16
1715662295008,EDS 206R,A00,507332,Staff,0,4,30,30
1715662295008,EDS 206R,B00,507343,Staff,15,0,30,15
1715662296037,EDS 250,A00,507344,Hemans; Patricia Ann Benitez,20,0,40,20
1715662297065,EDS 281,A00,507345,Daly; Alan J.,18,0,18,0
1715662298093,EDS 284,A00,507350,Daly; Alan J.,16,0,16,0
1715662299120,EDS 286,A00,507359,Fine; Sarah,18,0,18,0
1715662300145,EDS 289C,A01,507361,Daly; Alan J.,18,0,18,0
1715662301175,EDS 290,A00,507366,Hofstetter; Carolyn,15,0,15,0
1715662302201,LIGM 5A,A00,507421,Fischer-Grunski; Eva K,17,0,20,3
1715662303226,LIGM 5B,A00,507423,Fischer-Grunski; Eva K,19,0,20,1
1715662304253,LIGM 5C,A00,507425,Fischer-Grunski; Eva K,19,0,20,1
1715662305279,LIIT 5AS,A00,507427,Carnelos; Chiara,20,0,20,0
1715662306309,LIIT 5BS,A00,507430,Carnelos; Chiara,20,0,20,0
1715662307335,LIIT 5CS,A00,507432,Carnelos; Chiara,20,0,20,0
1715662308364,LISP 5A,A00,507541,Munoz Sanchez; Alicia,11,0,20,9
1715662309389,LISP 5B,A00,507671,Munoz Sanchez; Alicia,8,0,20,12
1715662310416,LISP 5C,A00,507696,Munoz Sanchez; Alicia,7,0,20,13
1715662311441,MAE 197,001,528363,Boechler; Nicholas Sebastia,9998,0,9999,1
1715662312469,MATH 197,001,523477,Kedlaya; Kiran S.,9994,0,9999,5
1715662312469,MATH 197,002,563811,Zhang; Danna,9994,0,9999,5
1715662312469,MATH 197,003,628552,Dumitriu; Ioana,9998,0,9999,1
1715662312469,MATH 197,004,660885,Floyd; Eric,9998,0,9999,1
1715662313499,MCWP 40R,A00,518780,Staff,1,0,20,19
1715662313499,MCWP 40R,B00,518781,Carter; Jennifer A,9,0,20,11
1715662313499,MCWP 40R,C00,518783,Smith; Haydee Marie,5,0,20,15
1715662314528,MCWP 50R,A00,518791,Redela; Pamela Morgan,0,1,20,20
1715662314528,MCWP 50R,B00,518792,Krone; Jarret,0,2,20,20
1715662314528,MCWP 50R,C00,518793,Staff,0,4,20,20
1715662314528,MCWP 50R,D00,518794,Morshed; Michael James,0,2,20,20
1715662314528,MCWP 50R,E00,518795,Carter; Andrea L,0,2,20,20
1715662314528,MCWP 50R,F00,518796,Miller; Elizabeth Deen,0,1,20,20
1715662314528,MCWP 50R,G00,518797,Guillen; Melinda,0,1,20,20
1715662315557,MMW 12R,A01,514034,Herbst; Matthew,0,2,16,16
1715662315557,MMW 12R,A02,514035,Herbst; Matthew,0,0,16,16
1715662316584,MMW 13R,A01,514037,Staff,0,5,16,16
1715662316584,MMW 13R,A02,514039,Staff,0,5,16,16
1715662316584,MMW 13R,A03,628519,Staff,0,4,16,16
1715662318637,SIO 295LS,A00,523233,Staff,10,0,30,20
1715662319665,SIO 295S,A00,523232,Staff,10,0,30,20
1715662320693,SIOC 290S,A01,637330,Merrifield; Mark A,21,0,30,9
1715662321720,SIOC 291S,A01,637333,Gabriel; Corey John,21,0,30,9
1715662322745,SOCI 117,A01,494376,Staff,0,5,5,5
1715662323772,WES 237B,A00,494380,Staff,10,0,20,10
1715662325841,AESE 279B,A00,494370,Wade; Jon P,0,0,33,33
1715662326869,AIP 97,001,660915,Van Den Einde; Yael Dahlia,9998,0,9999,1
1715662327898,AIP 197,001,627712,Vespa; Emanuel Ignacio,9995,0,9999,4
1715662327898,AIP 197,002,650778,Amir; On,9998,0,9999,1
1715662327898,AIP 197,003,650933,Avenancio-Leon; Carlos,9998,0,9999,1
1715662327898,AIP 197,004,658530,Heyman; Gail D.,9998,0,9999,1
1715662327898,AIP 197,005,658631,Neal; Sonya E,9998,0,9999,1
1715662327898,AIP 197,006,658671,Du; Songzi,9998,0,9999,1
1715662328927,ANAR 135S,A00,494369,Braswell; Geoffrey E.,0,0,0,0
1715662329956,BENG 196,001,628496,Engler; Adam J.,9998,0,9999,1
1715662329956,BENG 196,002,660916,Watson; John Thomas,9998,0,9999,1
1715662330981,BISP 197,001,650773,Wilhelm; James E.,9994,0,9999,5
1715662330981,BISP 197,002,658904,Coleman; Aaron B.,9998,0,9999,1
1715662332012,CAT 124RS,A01,519847,Geibel; William,0,0,20,20
1715662333038,CAT 125RS,A01,515971,Geibel; William,0,0,20,20
1715662334065,CLRE 250,A00,511389,Morris; Sheldon,9992,0,9999,7
1715662335093,CLRE 251,A00,507176,Mehta; Ravindra L.,9992,0,9999,7
1715662335093,CLRE 251,B00,511410,Mehta; Ravindra L.,9998,0,9999,1
1715662336119,CLRE 252,A00,507189,Cuomo; Raphael Eduardo,9994,0,9999,5
1715662337145,CLRE 253,A00,507199,Vaida; Florin,9994,0,9999,5
1715662337145,CLRE 253,B00,507202,Vaida; Florin,9999,0,9999,0
1715662338170,CLRE 259,A00,507211,Patel; Hemal,9996,0,9999,3
1715662339194,CLRE 260,A00,507221,Cuomo; Raphael Eduardo,9999,0,9999,0
1715662340217,CLRE 297,001,507242,Cuomo; Raphael Eduardo,9999,0,9999,0
1715662341243,COGS 197,001,638244,Voytek; Bradley Thomas,9997,0,9999,2
1715662342272,CSE 191,A00,516875,Minnes Kemp; Mor Mia,9991,0,9999,8
1715662343297,CSE 197,001,637388,Minnes Kemp; Mor Mia,9992,0,9999,7
1715662344328,CSS 201S,A01,494383,Mignozzetti; Umberto,35,0,35,0
1715662345354,CSS 202S,A01,494387,Mignozzetti; Umberto,35,0,35,0
1715662346380,DSC 197,001,628532,Eldridge; Justin Matthew,9995,0,9999,4
1715662347406,EAP 100,A00,516065,Staff,9799,0,9999,200
1715662348434,ECE 45,A01,507414,Staff,32,0,60,28
1715662350484,ECE 111,A01,507420,Staff,11,0,50,39
1715662351512,ECE 197,001,548057,Sievenpiper; Daniel F.,9991,0,9999,8
1715662352544,EDS 115,A00,507243,Choi; Bailey Miyeon,6,0,28,22
1715662353569,EDS 117,A01,494379,Staff,0,6,34,35
1715662354598,EDS 125,A00,507246,Hopkins; Megan Beth,7,0,30,23
1715662355625,EDS 128A,A01,507264,Fargason; Sharon Gayle,5,0,26,21
1715662356656,EDS 128B,A01,507293,Pappas; Elizabeth,9,0,30,21
1715662357681,EDS 139,A00,507294,Fargason; Sharon Gayle,9,0,30,21
1715662357681,EDS 139,B00,507313,Pappas; Elizabeth,9,0,30,21
1715662358705,EDS 201,A00,507315,Staff,10,0,30,20
1715662359735,EDS 203,A01,507317,Halter; Christopher P.,10,0,30,20
1715662360759,EDS 204R,A01,507319,Halter; Christopher P.,0,3,30,30
1715662360759,EDS 204R,B01,507331,Heinzman; Erica M.,14,0,30,16
1715662361785,EDS 206R,A00,507332,Staff,0,4,30,30
1715662361785,EDS 206R,B00,507343,Staff,15,0,30,15
1715662362867,EDS 250,A00,507344,Hemans; Patricia Ann Benitez,20,0,40,20
1715662363891,EDS 281,A00,507345,Daly; Alan J.,18,0,18,0
1715662364918,EDS 284,A00,507350,Daly; Alan J.,16,0,16,0
1715662365946,EDS 286,A00,507359,Fine; Sarah,18,0,18,0
1715662366970,EDS 289C,A01,507361,Daly; Alan J.,18,0,18,0
1715662368000,EDS 290,A00,507366,Hofstetter; Carolyn,15,0,15,0
1715662369032,LIGM 5A,A00,507421,Fischer-Grunski; Eva K,17,0,20,3
1715662370060,LIGM 5B,A00,507423,Fischer-Grunski; Eva K,19,0,20,1
1715662371087,LIGM 5C,A00,507425,Fischer-Grunski; Eva K,19,0,20,1
1715662372113,LIIT 5AS,A00,507427,Carnelos; Chiara,20,0,20,0
1715662373138,LIIT 5BS,A00,507430,Carnelos; Chiara,20,0,20,0
1715662374168,LIIT 5CS,A00,507432,Carnelos; Chiara,20,0,20,0
1715662375194,LISP 5A,A00,507541,Munoz Sanchez; Alicia,11,0,20,9
1715662376223,LISP 5B,A00,507671,Munoz Sanchez; Alicia,8,0,20,12
1715662377253,LISP 5C,A00,507696,Munoz Sanchez; Alicia,7,0,20,13
1715662378282,MAE 197,001,528363,Boechler; Nicholas Sebastia,9998,0,9999,1
1715662379308,MATH 197,001,523477,Kedlaya; Kiran S.,9994,0,9999,5
1715662379308,MATH 197,002,563811,Zhang; Danna,9994,0,9999,5
1715662379308,MATH 197,003,628552,Dumitriu; Ioana,9998,0,9999,1
1715662379308,MATH 197,004,660885,Floyd; Eric,9998,0,9999,1
1715662380336,MCWP 40R,A00,518780,Staff,1,0,20,19
1715662380336,MCWP 40R,B00,518781,Carter; Jennifer A,9,0,20,11
1715662380336,MCWP 40R,C00,518783,Smith; Haydee Marie,5,0,20,15
1715662381364,MCWP 50R,A00,518791,Redela; Pamela Morgan,0,1,20,20
1715662381364,MCWP 50R,B00,518792,Krone; Jarret,0,2,20,20
1715662381364,MCWP 50R,C00,518793,Staff,0,4,20,20
1715662381364,MCWP 50R,D00,518794,Morshed; Michael James,0,2,20,20
1715662381364,MCWP 50R,E00,518795,Carter; Andrea L,0,2,20,20
1715662381364,MCWP 50R,F00,518796,Miller; Elizabeth Deen,0,1,20,20
1715662381364,MCWP 50R,G00,518797,Guillen; Melinda,0,1,20,20
1715662382388,MMW 12R,A01,514034,Herbst; Matthew,0,2,16,16
1715662382388,MMW 12R,A02,514035,Herbst; Matthew,0,0,16,16
1715662383415,MMW 13R,A01,514037,Staff,0,5,16,16
1715662383415,MMW 13R,A02,514039,Staff,0,5,16,16
1715662383415,MMW 13R,A03,628519,Staff,0,4,16,16
1715662385470,SIO 295LS,A00,523233,Staff,10,0,30,20
1715662386498,SIO 295S,A00,523232,Staff,10,0,30,20
1715662387524,SIOC 290S,A01,637330,Merrifield; Mark A,21,0,30,9
1715662388553,SIOC 291S,A01,637333,Gabriel; Corey John,21,0,30,9
1715662389581,SOCI 117,A01,494376,Staff,0,5,5,5
1715662390608,WES 237B,A00,494380,Staff,10,0,20,10
1715662392684,AESE 279B,A00,494370,Wade; Jon P,0,0,33,33
1715662393708,AIP 97,001,660915,Van Den Einde; Yael Dahlia,9998,0,9999,1
1715662394737,AIP 197,001,627712,Vespa; Emanuel Ignacio,9995,0,9999,4
1715662394737,AIP 197,002,650778,Amir; On,9998,0,9999,1
1715662394737,AIP 197,003,650933,Avenancio-Leon; Carlos,9998,0,9999,1
1715662394737,AIP 197,004,658530,Heyman; Gail D.,9998,0,9999,1
1715662394737,AIP 197,005,658631,Neal; Sonya E,9998,0,9999,1
1715662394737,AIP 197,006,658671,Du; Songzi,9998,0,9999,1
1715662395764,ANAR 135S,A00,494369,Braswell; Geoffrey E.,0,0,0,0
1715662396792,BENG 196,001,628496,Engler; Adam J.,9998,0,9999,1
1715662396792,BENG 196,002,660916,Watson; John Thomas,9998,0,9999,1
1715662397818,BISP 197,001,650773,Wilhelm; James E.,9994,0,9999,5
1715662397818,BISP 197,002,658904,Coleman; Aaron B.,9998,0,9999,1
1715662398845,CAT 124RS,A01,519847,Geibel; William,0,0,20,20
1715662399871,CAT 125RS,A01,515971,Geibel; William,0,0,20,20
1715662400901,CLRE 250,A00,511389,Morris; Sheldon,9992,0,9999,7
1715662401929,CLRE 251,A00,507176,Mehta; Ravindra L.,9992,0,9999,7
1715662401929,CLRE 251,B00,511410,Mehta; Ravindra L.,9998,0,9999,1
1715662402954,CLRE 252,A00,507189,Cuomo; Raphael Eduardo,9994,0,9999,5
1715662403979,CLRE 253,A00,507199,Vaida; Florin,9994,0,9999,5
1715662403979,CLRE 253,B00,507202,Vaida; Florin,9999,0,9999,0
1715662405009,CLRE 259,A00,507211,Patel; Hemal,9996,0,9999,3
1715662406037,CLRE 260,A00,507221,Cuomo; Raphael Eduardo,9999,0,9999,0
1715662407065,CLRE 297,001,507242,Cuomo; Raphael Eduardo,9999,0,9999,0
1715662408090,COGS 197,001,638244,Voytek; Bradley Thomas,9997,0,9999,2
1715662409116,CSE 191,A00,516875,Minnes Kemp; Mor Mia,9991,0,9999,8
1715662410145,CSE 197,001,637388,Minnes Kemp; Mor Mia,9992,0,9999,7
1715662411171,CSS 201S,A01,494383,Mignozzetti; Umberto,35,0,35,0
1715662412200,CSS 202S,A01,494387,Mignozzetti; Umberto,35,0,35,0
1715662413227,DSC 197,001,628532,Eldridge; Justin Matthew,9995,0,9999,4
1715662414252,EAP 100,A00,516065,Staff,9799,0,9999,200
1715662415282,ECE 45,A01,507414,Staff,32,0,60,28
1715662417337,ECE 111,A01,507420,Staff,11,0,50,39
1715662418362,ECE 197,001,548057,Sievenpiper; Daniel F.,9991,0,9999,8
1715662419393,EDS 115,A00,507243,Choi; Bailey Miyeon,6,0,28,22
1715662420423,EDS 117,A01,494379,Staff,0,6,34,35
1715662421454,EDS 125,A00,507246,Hopkins; Megan Beth,7,0,30,23
1715662422480,EDS 128A,A01,507264,Fargason; Sharon Gayle,5,0,26,21
1715662423512,EDS 128B,A01,507293,Pappas; Elizabeth,9,0,30,21
1715662424536,EDS 139,A00,507294,Fargason; Sharon Gayle,9,0,30,21
1715662424536,EDS 139,B00,507313,Pappas; Elizabeth,9,0,30,21
1715662425564,EDS 201,A00,507315,Staff,10,0,30,20
1715662426589,EDS 203,A01,507317,Halter; Christopher P.,10,0,30,20
1715662427615,EDS 204R,A01,507319,Halter; Christopher P.,0,3,30,30
1715662427615,EDS 204R,B01,507331,Heinzman; Erica M.,14,0,30,16
1715662428643,EDS 206R,A00,507332,Staff,0,4,30,30
1715662428643,EDS 206R,B00,507343,Staff,15,0,30,15
1715662429672,EDS 250,A00,507344,Hemans; Patricia Ann Benitez,20,0,40,20
1715662430700,EDS 281,A00,507345,Daly; Alan J.,18,0,18,0
1715662431728,EDS 284,A00,507350,Daly; Alan J.,16,0,16,0
1715662432752,EDS 286,A00,507359,Fine; Sarah,18,0,18,0
1715662433781,EDS 289C,A01,507361,Daly; Alan J.,18,0,18,0
1715662434805,EDS 290,A00,507366,Hofstetter; Carolyn,15,0,15,0
1715662435830,LIGM 5A,A00,507421,Fischer-Grunski; Eva K,17,0,20,3
1715662436859,LIGM 5B,A00,507423,Fischer-Grunski; Eva K,19,0,20,1
1715662437886,LIGM 5C,A00,507425,Fischer-Grunski; Eva K,19,0,20,1
1715662438917,LIIT 5AS,A00,507427,Carnelos; Chiara,20,0,20,0
1715662439946,LIIT 5BS,A00,507430,Carnelos; Chiara,20,0,20,0
1715662440972,LIIT 5CS,A00,507432,Carnelos; Chiara,20,0,20,0
1715662441997,LISP 5A,A00,507541,Munoz Sanchez; Alicia,11,0,20,9
1715662443025,LISP 5B,A00,507671,Munoz Sanchez; Alicia,8,0,20,12
1715662444054,LISP 5C,A00,507696,Munoz Sanchez; Alicia,7,0,20,13
1715662445082,MAE 197,001,528363,Boechler; Nicholas Sebastia,9998,0,9999,1
1715662446116,MATH 197,001,523477,Kedlaya; Kiran S.,9994,0,9999,5
1715662446116,MATH 197,002,563811,Zhang; Danna,9994,0,9999,5
1715662446116,MATH 197,003,628552,Dumitriu; Ioana,9998,0,9999,1
1715662446116,MATH 197,004,660885,Floyd; Eric,9998,0,9999,1
1715662447142,MCWP 40R,A00,518780,Staff,1,0,20,19
1715662447142,MCWP 40R,B00,518781,Carter; Jennifer A,9,0,20,11
1715662447142,MCWP 40R,C00,518783,Smith; Haydee Marie,5,0,20,15
1715662448174,MCWP 50R,A00,518791,Redela; Pamela Morgan,0,1,20,20
1715662448174,MCWP 50R,B00,518792,Krone; Jarret,0,2,20,20
1715662448174,MCWP 50R,C00,518793,Staff,0,4,20,20
1715662448174,MCWP 50R,D00,518794,Morshed; Michael James,0,2,20,20
1715662448174,MCWP 50R,E00,518795,Carter; Andrea L,0,2,20,20
1715662448174,MCWP 50R,F00,518796,Miller; Elizabeth Deen,0,1,20,20
1715662448174,MCWP 50R,G00,518797,Guillen; Melinda,0,1,20,20
1715662449204,MMW 12R,A01,514034,Herbst; Matthew,0,2,16,16
1715662449204,MMW 12R,A02,514035,Herbst; Matthew,0,0,16,16
1715662450230,MMW 13R,A01,514037,Staff,0,5,16,16
1715662450230,MMW 13R,A02,514039,Staff,0,5,16,16
1715662450230,MMW 13R,A03,628519,Staff,0,4,16,16
1715662452285,SIO 295LS,A00,523233,Staff,10,0,30,20
1715662453312,SIO 295S,A00,523232,Staff,10,0,30,20
1715662454339,SIOC 290S,A01,637330,Merrifield; Mark A,21,0,30,9
1715662455370,SIOC 291S,A01,637333,Gabriel; Corey John,21,0,30,9
1715662456396,SOCI 117,A01,494376,Staff,0,5,5,5
1715662457422,WES 237B,A00,494380,Staff,10,0,20,10
1715662459503,AESE 279B,A00,494370,Wade; Jon P,0,0,33,33
1715662460529,AIP 97,001,660915,Van Den Einde; Yael Dahlia,9998,0,9999,1
1715662461562,AIP 197,001,627712,Vespa; Emanuel Ignacio,9995,0,9999,4
1715662461562,AIP 197,002,650778,Amir; On,9998,0,9999,1
1715662461562,AIP 197,003,650933,Avenancio-Leon; Carlos,9998,0,9999,1
1715662461562,AIP 197,004,658530,Heyman; Gail D.,9998,0,9999,1
1715662461562,AIP 197,005,658631,Neal; Sonya E,9998,0,9999,1
1715662461562,AIP 197,006,658671,Du; Songzi,9998,0,9999,1
1715662462589,ANAR 135S,A00,494369,Braswell; Geoffrey E.,0,0,0,0
1715662463615,BENG 196,001,628496,Engler; Adam J.,9998,0,9999,1
1715662463615,BENG 196,002,660916,Watson; John Thomas,9998,0,9999,1
1715662464641,BISP 197,001,650773,Wilhelm; James E.,9994,0,9999,5
1715662464641,BISP 197,002,658904,Coleman; Aaron B.,9998,0,9999,1
1715662465668,CAT 124RS,A01,519847,Geibel; William,0,0,20,20
1715662466770,CAT 125RS,A01,515971,Geibel; William,0,0,20,20
1715662467797,CLRE 250,A00,511389,Morris; Sheldon,9992,0,9999,7
1715662468825,CLRE 251,A00,507176,Mehta; Ravindra L.,9992,0,9999,7
1715662468825,CLRE 251,B00,511410,Mehta; Ravindra L.,9998,0,9999,1
1715662469852,CLRE 252,A00,507189,Cuomo; Raphael Eduardo,9994,0,9999,5
1715662470878,CLRE 253,A00,507199,Vaida; Florin,9994,0,9999,5
1715662470878,CLRE 253,B00,507202,Vaida; Florin,9999,0,9999,0
1715662471906,CLRE 259,A00,507211,Patel; Hemal,9996,0,9999,3
1715662472934,CLRE 260,A00,507221,Cuomo; Raphael Eduardo,9999,0,9999,0
1715662473960,CLRE 297,001,507242,Cuomo; Raphael Eduardo,9999,0,9999,0
1715662474989,COGS 197,001,638244,Voytek; Bradley Thomas,9997,0,9999,2
1715662476014,CSE 191,A00,516875,Minnes Kemp; Mor Mia,9991,0,9999,8
1715662477039,CSE 197,001,637388,Minnes Kemp; Mor Mia,9992,0,9999,7
1715662478066,CSS 201S,A01,494383,Mignozzetti; Umberto,35,0,35,0
1715662479092,CSS 202S,A01,494387,Mignozzetti; Umberto,35,0,35,0
1715662480120,DSC 197,001,628532,Eldridge; Justin Matthew,9995,0,9999,4
1715662481145,EAP 100,A00,516065,Staff,9799,0,9999,200
1715662482172,ECE 45,A01,507414,Staff,32,0,60,28
1715662484220,ECE 111,A01,507420,Staff,11,0,50,39
1715662485246,ECE 197,001,548057,Sievenpiper; Daniel F.,9991,0,9999,8
1715662486273,EDS 115,A00,507243,Choi; Bailey Miyeon,6,0,28,22
1715662487301,EDS 117,A01,494379,Staff,0,6,34,35
1715662488332,EDS 125,A00,507246,Hopkins; Megan Beth,7,0,30,23
1715662489358,EDS 128A,A01,507264,Fargason; Sharon Gayle,5,0,26,21
1715662490384,EDS 128B,A01,507293,Pappas; Elizabeth,9,0,30,21
1715662491408,EDS 139,A00,507294,Fargason; Sharon Gayle,9,0,30,21
1715662491408,EDS 139,B00,507313,Pappas; Elizabeth,9,0,30,21
1715662492432,EDS 201,A00,507315,Staff,10,0,30,20
1715662493460,EDS 203,A01,507317,Halter; Christopher P.,10,0,30,20
1715662494485,EDS 204R,A01,507319,Halter; Christopher P.,0,3,30,30
1715662494485,EDS 204R,B01,507331,Heinzman; Erica M.,14,0,30,16
1715662495511,EDS 206R,A00,507332,Staff,0,4,30,30
1715662495511,EDS 206R,B00,507343,Staff,15,0,30,15
1715662496538,EDS 250,A00,507344,Hemans; Patricia Ann Benitez,20,0,40,20
1715662497565,EDS 281,A00,507345,Daly; Alan J.,18,0,18,0
1715662498590,EDS 284,A00,507350,Daly; Alan J.,16,0,16,0
1715662499616,EDS 286,A00,507359,Fine; Sarah,18,0,18,0
1715662500642,EDS 289C,A01,507361,Daly; Alan J.,18,0,18,0
1715662501669,EDS 290,A00,507366,Hofstetter; Carolyn,15,0,15,0
1715662502698,LIGM 5A,A00,507421,Fischer-Grunski; Eva K,17,0,20,3
1715662503723,LIGM 5B,A00,507423,Fischer-Grunski; Eva K,19,0,20,1
1715662504748,LIGM 5C,A00,507425,Fischer-Grunski; Eva K,19,0,20,1
1715662505772,LIIT 5AS,A00,507427,Carnelos; Chiara,20,0,20,0
1715662506802,LIIT 5BS,A00,507430,Carnelos; Chiara,20,0,20,0
1715662507829,LIIT 5CS,A00,507432,Carnelos; Chiara,20,0,20,0
1715662508855,LISP 5A,A00,507541,Munoz Sanchez; Alicia,11,0,20,9
1715662509880,LISP 5B,A00,507671,Munoz Sanchez; Alicia,8,0,20,12
1715662510908,LISP 5C,A00,507696,Munoz Sanchez; Alicia,7,0,20,13
1715662511934,MAE 197,001,528363,Boechler; Nicholas Sebastia,9998,0,9999,1
1715662512965,MATH 197,001,523477,Kedlaya; Kiran S.,9994,0,9999,5
1715662512965,MATH 197,002,563811,Zhang; Danna,9994,0,9999,5
1715662512965,MATH 197,003,628552,Dumitriu; Ioana,9998,0,9999,1
1715662512965,MATH 197,004,660885,Floyd; Eric,9998,0,9999,1
1715662513996,MCWP 40R,A00,518780,Staff,1,0,20,19
1715662513996,MCWP 40R,B00,518781,Carter; Jennifer A,9,0,20,11
1715662513996,MCWP 40R,C00,518783,Smith; Haydee Marie,5,0,20,15
1715662515033,MCWP 50R,A00,518791,Redela; Pamela Morgan,0,1,20,20
1715662515033,MCWP 50R,B00,518792,Krone; Jarret,0,2,20,20
1715662515033,MCWP 50R,C00,518793,Staff,0,4,20,20
1715662515033,MCWP 50R,D00,518794,Morshed; Michael James,0,2,20,20
1715662515033,MCWP 50R,E00,518795,Carter; Andrea L,0,2,20,20
1715662515033,MCWP 50R,F00,518796,Miller; Elizabeth Deen,0,1,20,20
1715662515033,MCWP 50R,G00,518797,Guillen; Melinda,0,1,20,20
1715662516062,MMW 12R,A01,514034,Herbst; Matthew,0,2,16,16
1715662516062,MMW 12R,A02,514035,Herbst; Matthew,0,0,16,16
1715662517092,MMW 13R,A01,514037,Staff,0,5,16,16
1715662517092,MMW 13R,A02,514039,Staff,0,5,16,16
1715662517092,MMW 13R,A03,628519,Staff,0,4,16,16
1715662519146,SIO 295LS,A00,523233,Staff,10,0,30,20
1715662520175,SIO 295S,A00,523232,Staff,10,0,30,20
1715662521203,SIOC 290S,A01,637330,Merrifield; Mark A,21,0,30,9
1715662522229,SIOC 291S,A01,637333,Gabriel; Corey John,21,0,30,9
1715662523256,SOCI 117,A01,494376,Staff,0,5,5,5
1715662524282,WES 237B,A00,494380,Staff,10,0,20,10
1715662526356,AESE 279B,A00,494370,Wade; Jon P,0,0,33,33
1715662527381,AIP 97,001,660915,Van Den Einde; Yael Dahlia,9998,0,9999,1
1715662528412,AIP 197,001,627712,Vespa; Emanuel Ignacio,9995,0,9999,4
1715662528412,AIP 197,002,650778,Amir; On,9998,0,9999,1
1715662528412,AIP 197,003,650933,Avenancio-Leon; Carlos,9998,0,9999,1
1715662528412,AIP 197,004,658530,Heyman; Gail D.,9998,0,9999,1
1715662528412,AIP 197,005,658631,Neal; Sonya E,9998,0,9999,1
1715662528412,AIP 197,006,658671,Du; Songzi,9998,0,9999,1
1715662529439,ANAR 135S,A00,494369,Braswell; Geoffrey E.,0,0,0,0
1715662530467,BENG 196,001,628496,Engler; Adam J.,9998,0,9999,1
1715662530467,BENG 196,002,660916,Watson; John Thomas,9998,0,9999,1
1715662531492,BISP 197,001,650773,Wilhelm; James E.,9994,0,9999,5
1715662531492,BISP 197,002,658904,Coleman; Aaron B.,9998,0,9999,1
1715662532517,CAT 124RS,A01,519847,Geibel; William,0,0,20,20
1715662533544,CAT 125RS,A01,515971,Geibel; William,0,0,20,20
1715662534573,CLRE 250,A00,511389,Morris; Sheldon,9992,0,9999,7
1715662535601,CLRE 251,A00,507176,Mehta; Ravindra L.,9992,0,9999,7
1715662535601,CLRE 251,B00,511410,Mehta; Ravindra L.,9998,0,9999,1
1715662536632,CLRE 252,A00,507189,Cuomo; Raphael Eduardo,9994,0,9999,5
1715662537656,CLRE 253,A00,507199,Vaida; Florin,9994,0,9999,5
1715662537656,CLRE 253,B00,507202,Vaida; Florin,9999,0,9999,0
1715662538682,CLRE 259,A00,507211,Patel; Hemal,9996,0,9999,3
1715662539709,CLRE 260,A00,507221,Cuomo; Raphael Eduardo,9999,0,9999,0
1715662540733,CLRE 297,001,507242,Cuomo; Raphael Eduardo,9999,0,9999,0
1715662541756,COGS 197,001,638244,Voytek; Bradley Thomas,9997,0,9999,2
1715662542784,CSE 191,A00,516875,Minnes Kemp; Mor Mia,9991,0,9999,8
1715662543809,CSE 197,001,637388,Minnes Kemp; Mor Mia,9992,0,9999,7
1715662544837,CSS 201S,A01,494383,Mignozzetti; Umberto,35,0,35,0
1715662545862,CSS 202S,A01,494387,Mignozzetti; Umberto,35,0,35,0
1715662546889,DSC 197,001,628532,Eldridge; Justin Matthew,9995,0,9999,4
1715662547913,EAP 100,A00,516065,Staff,9799,0,9999,200
1715662548941,ECE 45,A01,507414,Staff,32,0,60,28
1715662550992,ECE 111,A01,507420,Staff,11,0,50,39
1715662552018,ECE 197,001,548057,Sievenpiper; Daniel F.,9991,0,9999,8
1715662553044,EDS 115,A00,507243,Choi; Bailey Miyeon,6,0,28,22
1715662554069,EDS 117,A01,494379,Staff,0,6,34,35
1715662555097,EDS 125,A00,507246,Hopkins; Megan Beth,7,0,30,23
1715662556124,EDS 128A,A01,507264,Fargason; Sharon Gayle,5,0,26,21
1715662557152,EDS 128B,A01,507293,Pappas; Elizabeth,9,0,30,21
1715662558180,EDS 139,A00,507294,Fargason; Sharon Gayle,9,0,30,21
1715662558180,EDS 139,B00,507313,Pappas; Elizabeth,9,0,30,21
1715662559206,EDS 201,A00,507315,Staff,10,0,30,20
1715662560235,EDS 203,A01,507317,Halter; Christopher P.,10,0,30,20
1715662561268,EDS 204R,A01,507319,Halter; Christopher P.,0,3,30,30
1715662561268,EDS 204R,B01,507331,Heinzman; Erica M.,14,0,30,16
1715662562294,EDS 206R,A00,507332,Staff,0,4,30,30
1715662562294,EDS 206R,B00,507343,Staff,15,0,30,15
1715662563324,EDS 250,A00,507344,Hemans; Patricia Ann Benitez,20,0,40,20
1715662564349,EDS 281,A00,507345,Daly; Alan J.,18,0,18,0
1715662565375,EDS 284,A00,507350,Daly; Alan J.,16,0,16,0
1715662566404,EDS 286,A00,507359,Fine; Sarah,18,0,18,0
1715662567429,EDS 289C,A01,507361,Daly; Alan J.,18,0,18,0
1715662568457,EDS 290,A00,507366,Hofstetter; Carolyn,15,0,15,0
1715662569485,LIGM 5A,A00,507421,Fischer-Grunski; Eva K,17,0,20,3
1715662570568,LIGM 5B,A00,507423,Fischer-Grunski; Eva K,19,0,20,1
1715662571593,LIGM 5C,A00,507425,Fischer-Grunski; Eva K,19,0,20,1
1715662572618,LIIT 5AS,A00,507427,Carnelos; Chiara,20,0,20,0
1715662573644,LIIT 5BS,A00,507430,Carnelos; Chiara,20,0,20,0
1715662574668,LIIT 5CS,A00,507432,Carnelos; Chiara,20,0,20,0
1715662575695,LISP 5A,A00,507541,Munoz Sanchez; Alicia,11,0,20,9
1715662576722,LISP 5B,A00,507671,Munoz Sanchez; Alicia,8,0,20,12
1715662577749,LISP 5C,A00,507696,Munoz Sanchez; Alicia,7,0,20,13
1715662578778,MAE 197,001,528363,Boechler; Nicholas Sebastia,9998,0,9999,1
1715662579807,MATH 197,001,523477,Kedlaya; Kiran S.,9994,0,9999,5
1715662579807,MATH 197,002,563811,Zhang; Danna,9994,0,9999,5
1715662579807,MATH 197,003,628552,Dumitriu; Ioana,9998,0,9999,1
1715662579807,MATH 197,004,660885,Floyd; Eric,9998,0,9999,1
1715662580836,MCWP 40R,A00,518780,Staff,1,0,20,19
1715662580836,MCWP 40R,B00,518781,Carter; Jennifer A,9,0,20,11
1715662580836,MCWP 40R,C00,518783,Smith; Haydee Marie,5,0,20,15
1715662581863,MCWP 50R,A00,518791,Redela; Pamela Morgan,0,1,20,20
1715662581863,MCWP 50R,B00,518792,Krone; Jarret,0,2,20,20
1715662581863,MCWP 50R,C00,518793,Staff,0,4,20,20
1715662581863,MCWP 50R,D00,518794,Morshed; Michael James,0,2,20,20
1715662581863,MCWP 50R,E00,518795,Carter; Andrea L,0,2,20,20
1715662581863,MCWP 50R,F00,518796,Miller; Elizabeth Deen,0,1,20,20
1715662581863,MCWP 50R,G00,518797,Guillen; Melinda,0,1,20,20
1715662582889,MMW 12R,A01,514034,Herbst; Matthew,0,2,16,16
1715662582889,MMW 12R,A02,514035,Herbst; Matthew,0,0,16,16
1715662583914,MMW 13R,A01,514037,Staff,0,5,16,16
1715662583914,MMW 13R,A02,514039,Staff,0,5,16,16
1715662583914,MMW 13R,A03,628519,Staff,0,4,16,16
1715662585971,SIO 295LS,A00,523233,Staff,10,0,30,20
1715662586999,SIO 295S,A00,523232,Staff,10,0,30,20
1715662588029,SIOC 290S,A01,637330,Merrifield; Mark A,21,0,30,9
1715662589057,SIOC 291S,A01,637333,Gabriel; Corey John,21,0,30,9
1715662590083,SOCI 117,A01,494376,Staff,0,5,5,5
1715662591114,WES 237B,A00,494380,Staff,10,0,20,10
1715662593186,AESE 279B,A00,494370,Wade; Jon P,0,0,33,33
1715662594215,AIP 97,001,660915,Van Den Einde; Yael Dahlia,9998,0,9999,1
1715662595246,AIP 197,001,627712,Vespa; Emanuel Ignacio,9995,0,9999,4
1715662595246,AIP 197,002,650778,Amir; On,9998,0,9999,1
1715662595246,AIP 197,003,650933,Avenancio-Leon; Carlos,9998,0,9999,1
1715662595246,AIP 197,004,658530,Heyman; Gail D.,9998,0,9999,1
1715662595246,AIP 197,005,658631,Neal; Sonya E,9998,0,9999,1
1715662595246,AIP 197,006,658671,Du; Songzi,9998,0,9999,1
1715662596270,ANAR 135S,A00,494369,Braswell; Geoffrey E.,0,0,0,0
1715662597296,BENG 196,001,628496,Engler; Adam J.,9998,0,9999,1
1715662597296,BENG 196,002,660916,Watson; John Thomas,9998,0,9999,1
1715662598323,BISP 197,001,650773,Wilhelm; James E.,9994,0,9999,5
1715662598323,BISP 197,002,658904,Coleman; Aaron B.,9998,0,9999,1
1715662599351,CAT 124RS,A01,519847,Geibel; William,0,0,20,20
1715662600380,CAT 125RS,A01,515971,Geibel; William,0,0,20,20
1715662601405,CLRE 250,A00,511389,Morris; Sheldon,9992,0,9999,7
1715662602435,CLRE 251,A00,507176,Mehta; Ravindra L.,9992,0,9999,7
1715662602435,CLRE 251,B00,511410,Mehta; Ravindra L.,9998,0,9999,1
1715662603464,CLRE 252,A00,507189,Cuomo; Raphael Eduardo,9994,0,9999,5
1715662604489,CLRE 253,A00,507199,Vaida; Florin,9994,0,9999,5
1715662604489,CLRE 253,B00,507202,Vaida; Florin,9999,0,9999,0
1715662605516,CLRE 259,A00,507211,Patel; Hemal,9996,0,9999,3
1715662606541,CLRE 260,A00,507221,Cuomo; Raphael Eduardo,9999,0,9999,0
1715662607570,CLRE 297,001,507242,Cuomo; Raphael Eduardo,9999,0,9999,0
1715662608597,COGS 197,001,638244,Voytek; Bradley Thomas,9997,0,9999,2
1715662609627,CSE 191,A00,516875,Minnes Kemp; Mor Mia,9991,0,9999,8
1715662610653,CSE 197,001,637388,Minnes Kemp; Mor Mia,9992,0,9999,7
1715662611686,CSS 201S,A01,494383,Mignozzetti; Umberto,35,0,35,0
1715662612710,CSS 202S,A01,494387,Mignozzetti; Umberto,35,0,35,0
1715662613741,DSC 197,001,628532,Eldridge; Justin Matthew,9995,0,9999,4
1715662614764,EAP 100,A00,516065,Staff,9799,0,9999,200
1715662615792,ECE 45,A01,507414,Staff,32,0,60,28
1715662617842,ECE 111,A01,507420,Staff,11,0,50,39
1715662618868,ECE 197,001,548057,Sievenpiper; Daniel F.,9991,0,9999,8
1715662619894,EDS 115,A00,507243,Choi; Bailey Miyeon,6,0,28,22
1715662620920,EDS 117,A01,494379,Staff,0,6,34,35
1715662621950,EDS 125,A00,507246,Hopkins; Megan Beth,7,0,30,23
1715662622976,EDS 128A,A01,507264,Fargason; Sharon Gayle,5,0,26,21
1715662624002,EDS 128B,A01,507293,Pappas; Elizabeth,9,0,30,21
1715662625025,EDS 139,A00,507294,Fargason; Sharon Gayle,9,0,30,21
1715662625025,EDS 139,B00,507313,Pappas; Elizabeth,9,0,30,21
1715662626053,EDS 201,A00,507315,Staff,10,0,30,20
1715662627082,EDS 203,A01,507317,Halter; Christopher P.,10,0,30,20
1715662628107,EDS 204R,A01,507319,Halter; Christopher P.,0,3,30,30
1715662628107,EDS 204R,B01,507331,Heinzman; Erica M.,14,0,30,16
1715662629133,EDS 206R,A00,507332,Staff,0,4,30,30
1715662629133,EDS 206R,B00,507343,Staff,15,0,30,15
1715662630159,EDS 250,A00,507344,Hemans; Patricia Ann Benitez,20,0,40,20
1715662631187,EDS 281,A00,507345,Daly; Alan J.,18,0,18,0
1715662632229,EDS 284,A00,507350,Daly; Alan J.,16,0,16,0
1715662633255,EDS 286,A00,507359,Fine; Sarah,18,0,18,0
1715662634281,EDS 289C,A01,507361,Daly; Alan J.,18,0,18,0
1715662635306,EDS 290,A00,507366,Hofstetter; Carolyn,15,0,15,0
1715662636337,LIGM 5A,A00,507421,Fischer-Grunski; Eva K,17,0,20,3
1715662637361,LIGM 5B,A00,507423,Fischer-Grunski; Eva K,19,0,20,1
1715662638385,LIGM 5C,A00,507425,Fischer-Grunski; Eva K,19,0,20,1
1715662639414,LIIT 5AS,A00,507427,Carnelos; Chiara,20,0,20,0
1715662640441,LIIT 5BS,A00,507430,Carnelos; Chiara,20,0,20,0
1715662641465,LIIT 5CS,A00,507432,Carnelos; Chiara,20,0,20,0
1715662642491,LISP 5A,A00,507541,Munoz Sanchez; Alicia,11,0,20,9
1715662643519,LISP 5B,A00,507671,Munoz Sanchez; Alicia,8,0,20,12
1715662644545,LISP 5C,A00,507696,Munoz Sanchez; Alicia,7,0,20,13
1715662645573,MAE 197,001,528363,Boechler; Nicholas Sebastia,9998,0,9999,1
1715662646607,MATH 197,001,523477,Kedlaya; Kiran S.,9994,0,9999,5
1715662646607,MATH 197,002,563811,Zhang; Danna,9994,0,9999,5
1715662646607,MATH 197,003,628552,Dumitriu; Ioana,9998,0,9999,1
1715662646607,MATH 197,004,660885,Floyd; Eric,9998,0,9999,1
1715662647638,MCWP 40R,A00,518780,Staff,1,0,20,19
1715662647638,MCWP 40R,B00,518781,Carter; Jennifer A,9,0,20,11
1715662647638,MCWP 40R,C00,518783,Smith; Haydee Marie,5,0,20,15
1715662648675,MCWP 50R,A00,518791,Redela; Pamela Morgan,0,1,20,20
1715662648675,MCWP 50R,B00,518792,Krone; Jarret,0,2,20,20
1715662648675,MCWP 50R,C00,518793,Staff,0,4,20,20
1715662648675,MCWP 50R,D00,518794,Morshed; Michael James,0,2,20,20
1715662648675,MCWP 50R,E00,518795,Carter; Andrea L,0,2,20,20
1715662648675,MCWP 50R,F00,518796,Miller; Elizabeth Deen,0,1,20,20
1715662648675,MCWP 50R,G00,518797,Guillen; Melinda,0,1,20,20
1715662649701,MMW 12R,A01,514034,Herbst; Matthew,0,2,16,16
1715662649701,MMW 12R,A02,514035,Herbst; Matthew,0,0,16,16
1715662650725,MMW 13R,A01,514037,Staff,0,5,16,16
1715662650725,MMW 13R,A02,514039,Staff,0,5,16,16
1715662650725,MMW 13R,A03,628519,Staff,0,4,16,16
1715662652779,SIO 295LS,A00,523233,Staff,10,0,30,20
1715662653804,SIO 295S,A00,523232,Staff,10,0,30,20
1715662654836,SIOC 290S,A01,637330,Merrifield; Mark A,21,0,30,9
1715662655863,SIOC 291S,A01,637333,Gabriel; Corey John,21,0,30,9
1715662656889,SOCI 117,A01,494376,Staff,0,5,5,5
1715662657914,WES 237B,A00,494380,Staff,10,0,20,10
1715662659986,AESE 279B,A00,494370,Wade; Jon P,0,0,33,33
1715662661014,AIP 97,001,660915,Van Den Einde; Yael Dahlia,9998,0,9999,1
1715662662043,AIP 197,001,627712,Vespa; Emanuel Ignacio,9995,0,9999,4
1715662662043,AIP 197,002,650778,Amir; On,9998,0,9999,1
1715662662043,AIP 197,003,650933,Avenancio-Leon; Carlos,9998,0,9999,1
1715662662043,AIP 197,004,658530,Heyman; Gail D.,9998,0,9999,1
1715662662043,AIP 197,005,658631,Neal; Sonya E,9998,0,9999,1
1715662662043,AIP 197,006,658671,Du; Songzi,9998,0,9999,1
1715662663068,ANAR 135S,A00,494369,Braswell; Geoffrey E.,0,0,0,0
1715662664095,BENG 196,001,628496,Engler; Adam J.,9998,0,9999,1
1715662664095,BENG 196,002,660916,Watson; John Thomas,9998,0,9999,1
1715662665123,BISP 197,001,650773,Wilhelm; James E.,9994,0,9999,5
1715662665123,BISP 197,002,658904,Coleman; Aaron B.,9998,0,9999,1
1715662666153,CAT 124RS,A01,519847,Geibel; William,0,0,20,20
1715662667180,CAT 125RS,A01,515971,Geibel; William,0,0,20,20
1715662668212,CLRE 250,A00,511389,Morris; Sheldon,9992,0,9999,7
1715662669244,CLRE 251,A00,507176,Mehta; Ravindra L.,9992,0,9999,7
1715662669244,CLRE 251,B00,511410,Mehta; Ravindra L.,9998,0,9999,1
1715662670270,CLRE 252,A00,507189,Cuomo; Raphael Eduardo,9994,0,9999,5
1715662671298,CLRE 253,A00,507199,Vaida; Florin,9994,0,9999,5
1715662671298,CLRE 253,B00,507202,Vaida; Florin,9999,0,9999,0
1715662672322,CLRE 259,A00,507211,Patel; Hemal,9996,0,9999,3
1715662673348,CLRE 260,A00,507221,Cuomo; Raphael Eduardo,9999,0,9999,0
1715662674434,CLRE 297,001,507242,Cuomo; Raphael Eduardo,9999,0,9999,0
1715662675462,COGS 197,001,638244,Voytek; Bradley Thomas,9997,0,9999,2
1715662676493,CSE 191,A00,516875,Minnes Kemp; Mor Mia,9991,0,9999,8
1715662677521,CSE 197,001,637388,Minnes Kemp; Mor Mia,9992,0,9999,7
1715662678548,CSS 201S,A01,494383,Mignozzetti; Umberto,35,0,35,0
1715662679575,CSS 202S,A01,494387,Mignozzetti; Umberto,35,0,35,0
1715662680602,DSC 197,001,628532,Eldridge; Justin Matthew,9995,0,9999,4
1715662681629,EAP 100,A00,516065,Staff,9799,0,9999,200
1715662682657,ECE 45,A01,507414,Staff,32,0,60,28
1715662684712,ECE 111,A01,507420,Staff,11,0,50,39
1715662685738,ECE 197,001,548057,Sievenpiper; Daniel F.,9991,0,9999,8
1715662686767,EDS 115,A00,507243,Choi; Bailey Miyeon,6,0,28,22
1715662687796,EDS 117,A01,494379,Staff,0,6,34,35
1715662688822,EDS 125,A00,507246,Hopkins; Megan Beth,7,0,30,23
1715662689848,EDS 128A,A01,507264,Fargason; Sharon Gayle,5,0,26,21
1715662690872,EDS 128B,A01,507293,Pappas; Elizabeth,9,0,30,21
1715662691900,EDS 139,A00,507294,Fargason; Sharon Gayle,9,0,30,21
1715662691900,EDS 139,B00,507313,Pappas; Elizabeth,9,0,30,21
1715662692927,EDS 201,A00,507315,Staff,10,0,30,20
1715662693956,EDS 203,A01,507317,Halter; Christopher P.,10,0,30,20
1715662694981,EDS 204R,A01,507319,Halter; Christopher P.,0,3,30,30
1715662694981,EDS 204R,B01,507331,Heinzman; Erica M.,14,0,30,16
1715662696009,EDS 206R,A00,507332,Staff,0,4,30,30
1715662696009,EDS 206R,B00,507343,Staff,15,0,30,15
1715662697034,EDS 250,A00,507344,Hemans; Patricia Ann Benitez,20,0,40,20
1715662698060,EDS 281,A00,507345,Daly; Alan J.,18,0,18,0
1715662699085,EDS 284,A00,507350,Daly; Alan J.,16,0,16,0
1715662700109,EDS 286,A00,507359,Fine; Sarah,18,0,18,0
1715662701134,EDS 289C,A01,507361,Daly; Alan J.,18,0,18,0
1715662702160,EDS 290,A00,507366,Hofstetter; Carolyn,15,0,15,0
1715662703191,LIGM 5A,A00,507421,Fischer-Grunski; Eva K,17,0,20,3
1715662704220,LIGM 5B,A00,507423,Fischer-Grunski; Eva K,19,0,20,1
1715662705247,LIGM 5C,A00,507425,Fischer-Grunski; Eva K,19,0,20,1
1715662706276,LIIT 5AS,A00,507427,Carnelos; Chiara,20,0,20,0
1715662707303,LIIT 5BS,A00,507430,Carnelos; Chiara,20,0,20,0
1715662708333,LIIT 5CS,A00,507432,Carnelos; Chiara,20,0,20,0
1715662709364,LISP 5A,A00,507541,Munoz Sanchez; Alicia,11,0,20,9
1715662710390,LISP 5B,A00,507671,Munoz Sanchez; Alicia,8,0,20,12
1715662711416,LISP 5C,A00,507696,Munoz Sanchez; Alicia,7,0,20,13
1715662712445,MAE 197,001,528363,Boechler; Nicholas Sebastia,9998,0,9999,1
1715662713477,MATH 197,001,523477,Kedlaya; Kiran S.,9994,0,9999,5
1715662713477,MATH 197,002,563811,Zhang; Danna,9994,0,9999,5
1715662713477,MATH 197,003,628552,Dumitriu; Ioana,9998,0,9999,1
1715662713477,MATH 197,004,660885,Floyd; Eric,9998,0,9999,1
1715662714504,MCWP 40R,A00,518780,Staff,1,0,20,19
1715662714504,MCWP 40R,B00,518781,Carter; Jennifer A,9,0,20,11
1715662714504,MCWP 40R,C00,518783,Smith; Haydee Marie,5,0,20,15
1715662715536,MCWP 50R,A00,518791,Redela; Pamela Morgan,0,1,20,20
1715662715536,MCWP 50R,B00,518792,Krone; Jarret,0,2,20,20
1715662715536,MCWP 50R,C00,518793,Staff,0,4,20,20
1715662715536,MCWP 50R,D00,518794,Morshed; Michael James,0,2,20,20
1715662715536,MCWP 50R,E00,518795,Carter; Andrea L,0,2,20,20
1715662715536,MCWP 50R,F00,518796,Miller; Elizabeth Deen,0,1,20,20
1715662715536,MCWP 50R,G00,518797,Guillen; Melinda,0,1,20,20
1715662716564,MMW 12R,A01,514034,Herbst; Matthew,0,2,16,16
1715662716564,MMW 12R,A02,514035,Herbst; Matthew,0,0,16,16
1715662717590,MMW 13R,A01,514037,Staff,0,5,16,16
1715662717590,MMW 13R,A02,514039,Staff,0,5,16,16
1715662717590,MMW 13R,A03,628519,Staff,0,4,16,16
1715662719641,SIO 295LS,A00,523233,Staff,10,0,30,20
1715662720665,SIO 295S,A00,523232,Staff,10,0,30,20
1715662721693,SIOC 290S,A01,637330,Merrifield; Mark A,21,0,30,9
1715662722718,SIOC 291S,A01,637333,Gabriel; Corey John,21,0,30,9
1715662723747,SOCI 117,A01,494376,Staff,0,5,5,5
1715662724773,WES 237B,A00,494380,Staff,10,0,20,10
1715662726849,AESE 279B,A00,494370,Wade; Jon P,0,0,33,33
1715662727877,AIP 97,001,660915,Van Den Einde; Yael Dahlia,9998,0,9999,1
1715662728908,AIP 197,001,627712,Vespa; Emanuel Ignacio,9995,0,9999,4
1715662728908,AIP 197,002,650778,Amir; On,9998,0,9999,1
1715662728908,AIP 197,003,650933,Avenancio-Leon; Carlos,9998,0,9999,1
1715662728908,AIP 197,004,658530,Heyman; Gail D.,9998,0,9999,1
1715662728908,AIP 197,005,658631,Neal; Sonya E,9998,0,9999,1
1715662728908,AIP 197,006,658671,Du; Songzi,9998,0,9999,1
1715662729934,ANAR 135S,A00,494369,Braswell; Geoffrey E.,0,0,0,0
1715662730961,BENG 196,001,628496,Engler; Adam J.,9998,0,9999,1
1715662730961,BENG 196,002,660916,Watson; John Thomas,9998,0,9999,1
1715662731986,BISP 197,001,650773,Wilhelm; James E.,9994,0,9999,5
1715662731986,BISP 197,002,658904,Coleman; Aaron B.,9998,0,9999,1
1715662733015,CAT 124RS,A01,519847,Geibel; William,0,0,20,20
1715662734042,CAT 125RS,A01,515971,Geibel; William,0,0,20,20
1715662735071,CLRE 250,A00,511389,Morris; Sheldon,9992,0,9999,7
1715662736099,CLRE 251,A00,507176,Mehta; Ravindra L.,9992,0,9999,7
1715662736099,CLRE 251,B00,511410,Mehta; Ravindra L.,9998,0,9999,1
1715662737129,CLRE 252,A00,507189,Cuomo; Raphael Eduardo,9994,0,9999,5
1715662738155,CLRE 253,A00,507199,Vaida; Florin,9994,0,9999,5
1715662738155,CLRE 253,B00,507202,Vaida; Florin,9999,0,9999,0
1715662739182,CLRE 259,A00,507211,Patel; Hemal,9996,0,9999,3
1715662740206,CLRE 260,A00,507221,Cuomo; Raphael Eduardo,9999,0,9999,0
1715662741231,CLRE 297,001,507242,Cuomo; Raphael Eduardo,9999,0,9999,0
1715662742258,COGS 197,001,638244,Voytek; Bradley Thomas,9997,0,9999,2
1715662743285,CSE 191,A00,516875,Minnes Kemp; Mor Mia,9991,0,9999,8
1715662744309,CSE 197,001,637388,Minnes Kemp; Mor Mia,9992,0,9999,7
1715662745337,CSS 201S,A01,494383,Mignozzetti; Umberto,35,0,35,0
1715662746368,CSS 202S,A01,494387,Mignozzetti; Umberto,35,0,35,0
1715662747393,DSC 197,001,628532,Eldridge; Justin Matthew,9995,0,9999,4
1715662748421,EAP 100,A00,516065,Staff,9799,0,9999,200
1715662749451,ECE 45,A01,507414,Staff,32,0,60,28
1715662751502,ECE 111,A01,507420,Staff,11,0,50,39
1715662752528,ECE 197,001,548057,Sievenpiper; Daniel F.,9991,0,9999,8
1715662753555,EDS 115,A00,507243,Choi; Bailey Miyeon,6,0,28,22
1715662754584,EDS 117,A01,494379,Staff,0,6,34,35
1715662755608,EDS 125,A00,507246,Hopkins; Megan Beth,7,0,30,23
1715662756634,EDS 128A,A01,507264,Fargason; Sharon Gayle,5,0,26,21
1715662757659,EDS 128B,A01,507293,Pappas; Elizabeth,9,0,30,21
1715662758683,EDS 139,A00,507294,Fargason; Sharon Gayle,9,0,30,21
1715662758683,EDS 139,B00,507313,Pappas; Elizabeth,9,0,30,21
1715662759706,EDS 201,A00,507315,Staff,10,0,30,20
1715662760732,EDS 203,A01,507317,Halter; Christopher P.,10,0,30,20
1715662761756,EDS 204R,A01,507319,Halter; Christopher P.,0,3,30,30
1715662761756,EDS 204R,B01,507331,Heinzman; Erica M.,14,0,30,16
1715662762782,EDS 206R,A00,507332,Staff,0,4,30,30
1715662762782,EDS 206R,B00,507343,Staff,15,0,30,15
1715662763811,EDS 250,A00,507344,Hemans; Patricia Ann Benitez,20,0,40,20
1715662764837,EDS 281,A00,507345,Daly; Alan J.,18,0,18,0
1715662765866,EDS 284,A00,507350,Daly; Alan J.,16,0,16,0
1715662766893,EDS 286,A00,507359,Fine; Sarah,18,0,18,0
1715662767918,EDS 289C,A01,507361,Daly; Alan J.,18,0,18,0
1715662768946,EDS 290,A00,507366,Hofstetter; Carolyn,15,0,15,0
1715662769975,LIGM 5A,A00,507421,Fischer-Grunski; Eva K,17,0,20,3
1715662771003,LIGM 5B,A00,507423,Fischer-Grunski; Eva K,19,0,20,1
1715662772028,LIGM 5C,A00,507425,Fischer-Grunski; Eva K,19,0,20,1
1715662773115,LIIT 5AS,A00,507427,Carnelos; Chiara,20,0,20,0
1715662774141,LIIT 5BS,A00,507430,Carnelos; Chiara,20,0,20,0
1715662775166,LIIT 5CS,A00,507432,Carnelos; Chiara,20,0,20,0
1715662776197,LISP 5A,A00,507541,Munoz Sanchez; Alicia,11,0,20,9
1715662777225,LISP 5B,A00,507671,Munoz Sanchez; Alicia,8,0,20,12
1715662778251,LISP 5C,A00,507696,Munoz Sanchez; Alicia,7,0,20,13
1715662779276,MAE 197,001,528363,Boechler; Nicholas Sebastia,9998,0,9999,1
1715662780310,MATH 197,001,523477,Kedlaya; Kiran S.,9994,0,9999,5
1715662780310,MATH 197,002,563811,Zhang; Danna,9994,0,9999,5
1715662780310,MATH 197,003,628552,Dumitriu; Ioana,9998,0,9999,1
1715662780310,MATH 197,004,660885,Floyd; Eric,9998,0,9999,1
1715662781337,MCWP 40R,A00,518780,Staff,1,0,20,19
1715662781337,MCWP 40R,B00,518781,Carter; Jennifer A,9,0,20,11
1715662781337,MCWP 40R,C00,518783,Smith; Haydee Marie,5,0,20,15
1715662782370,MCWP 50R,A00,518791,Redela; Pamela Morgan,0,1,20,20
1715662782370,MCWP 50R,B00,518792,Krone; Jarret,0,2,20,20
1715662782370,MCWP 50R,C00,518793,Staff,0,4,20,20
1715662782370,MCWP 50R,D00,518794,Morshed; Michael James,0,2,20,20
1715662782370,MCWP 50R,E00,518795,Carter; Andrea L,0,2,20,20
1715662782370,MCWP 50R,F00,518796,Miller; Elizabeth Deen,0,1,20,20
1715662782370,MCWP 50R,G00,518797,Guillen; Melinda,0,1,20,20
1715662783398,MMW 12R,A01,514034,Herbst; Matthew,0,2,16,16
1715662783398,MMW 12R,A02,514035,Herbst; Matthew,0,0,16,16
1715662784423,MMW 13R,A01,514037,Staff,0,5,16,16
1715662784423,MMW 13R,A02,514039,Staff,0,5,16,16
1715662784423,MMW 13R,A03,628519,Staff,0,4,16,16
1715662786481,SIO 295LS,A00,523233,Staff,10,0,30,20
1715662787506,SIO 295S,A00,523232,Staff,10,0,30,20
1715662788536,SIOC 290S,A01,637330,Merrifield; Mark A,21,0,30,9
1715662789566,SIOC 291S,A01,637333,Gabriel; Corey John,21,0,30,9
1715662790593,SOCI 117,A01,494376,Staff,0,5,5,5
1715662791623,WES 237B,A00,494380,Staff,10,0,20,10
1715662793695,AESE 279B,A00,494370,Wade; Jon P,0,0,33,33
1715662794722,AIP 97,001,660915,Van Den Einde; Yael Dahlia,9998,0,9999,1
1715662795750,AIP 197,001,627712,Vespa; Emanuel Ignacio,9995,0,9999,4
1715662795750,AIP 197,002,650778,Amir; On,9998,0,9999,1
1715662795750,AIP 197,003,650933,Avenancio-Leon; Carlos,9998,0,9999,1
1715662795750,AIP 197,004,658530,Heyman; Gail D.,9998,0,9999,1
1715662795750,AIP 197,005,658631,Neal; Sonya E,9998,0,9999,1
1715662795750,AIP 197,006,658671,Du; Songzi,9998,0,9999,1
1715662796778,ANAR 135S,A00,494369,Braswell; Geoffrey E.,0,0,0,0
1715662797804,BENG 196,001,628496,Engler; Adam J.,9998,0,9999,1
1715662797804,BENG 196,002,660916,Watson; John Thomas,9998,0,9999,1
1715662798833,BISP 197,001,650773,Wilhelm; James E.,9994,0,9999,5
1715662798833,BISP 197,002,658904,Coleman; Aaron B.,9998,0,9999,1
1715662799862,CAT 124RS,A01,519847,Geibel; William,0,0,20,20
1715662800889,CAT 125RS,A01,515971,Geibel; William,0,0,20,20
1715662801916,CLRE 250,A00,511389,Morris; Sheldon,9992,0,9999,7
1715662802943,CLRE 251,A00,507176,Mehta; Ravindra L.,9992,0,9999,7
1715662802943,CLRE 251,B00,511410,Mehta; Ravindra L.,9998,0,9999,1
1715662803974,CLRE 252,A00,507189,Cuomo; Raphael Eduardo,9994,0,9999,5
1715662805001,CLRE 253,A00,507199,Vaida; Florin,9994,0,9999,5
1715662805001,CLRE 253,B00,507202,Vaida; Florin,9999,0,9999,0
1715662806026,CLRE 259,A00,507211,Patel; Hemal,9996,0,9999,3
1715662807052,CLRE 260,A00,507221,Cuomo; Raphael Eduardo,9999,0,9999,0
1715662808080,CLRE 297,001,507242,Cuomo; Raphael Eduardo,9999,0,9999,0
1715662809106,COGS 197,001,638244,Voytek; Bradley Thomas,9997,0,9999,2
1715662810136,CSE 191,A00,516875,Minnes Kemp; Mor Mia,9991,0,9999,8
1715662811161,CSE 197,001,637388,Minnes Kemp; Mor Mia,9992,0,9999,7
1715662812187,CSS 201S,A01,494383,Mignozzetti; Umberto,35,0,35,0
1715662813212,CSS 202S,A01,494387,Mignozzetti; Umberto,35,0,35,0
1715662814241,DSC 197,001,628532,Eldridge; Justin Matthew,9995,0,9999,4
1715662815265,EAP 100,A00,516065,Staff,9799,0,9999,200
1715662816292,ECE 45,A01,507414,Staff,32,0,60,28
1715662818346,ECE 111,A01,507420,Staff,11,0,50,39
1715662819372,ECE 197,001,548057,Sievenpiper; Daniel F.,9991,0,9999,8
1715662820397,EDS 115,A00,507243,Choi; Bailey Miyeon,6,0,28,22
1715662821422,EDS 117,A01,494379,Staff,0,6,34,35
1715662822452,EDS 125,A00,507246,Hopkins; Megan Beth,7,0,30,23
1715662823480,EDS 128A,A01,507264,Fargason; Sharon Gayle,5,0,26,21
1715662824508,EDS 128B,A01,507293,Pappas; Elizabeth,9,0,30,21
1715662825536,EDS 139,A00,507294,Fargason; Sharon Gayle,9,0,30,21
1715662825536,EDS 139,B00,507313,Pappas; Elizabeth,9,0,30,21
1715662826562,EDS 201,A00,507315,Staff,10,0,30,20
1715662827592,EDS 203,A01,507317,Halter; Christopher P.,10,0,30,20
1715662828617,EDS 204R,A01,507319,Halter; Christopher P.,0,3,30,30
1715662828617,EDS 204R,B01,507331,Heinzman; Erica M.,14,0,30,16
1715662829646,EDS 206R,A00,507332,Staff,0,4,30,30
1715662829646,EDS 206R,B00,507343,Staff,15,0,30,15
1715662830674,EDS 250,A00,507344,Hemans; Patricia Ann Benitez,20,0,40,20
1715662831698,EDS 281,A00,507345,Daly; Alan J.,18,0,18,0
1715662832725,EDS 284,A00,507350,Daly; Alan J.,16,0,16,0
1715662833867,EDS 286,A00,507359,Fine; Sarah,18,0,18,0
1715662834895,EDS 289C,A01,507361,Daly; Alan J.,18,0,18,0
1715662835921,EDS 290,A00,507366,Hofstetter; Carolyn,15,0,15,0
1715662836948,LIGM 5A,A00,507421,Fischer-Grunski; Eva K,17,0,20,3
1715662837977,LIGM 5B,A00,507423,Fischer-Grunski; Eva K,19,0,20,1
1715662839003,LIGM 5C,A00,507425,Fischer-Grunski; Eva K,19,0,20,1
1715662840029,LIIT 5AS,A00,507427,Carnelos; Chiara,20,0,20,0
1715662841057,LIIT 5BS,A00,507430,Carnelos; Chiara,20,0,20,0
1715662842086,LIIT 5CS,A00,507432,Carnelos; Chiara,20,0,20,0
1715662843116,LISP 5A,A00,507541,Munoz Sanchez; Alicia,11,0,20,9
1715662844144,LISP 5B,A00,507671,Munoz Sanchez; Alicia,8,0,20,12
1715662845168,LISP 5C,A00,507696,Munoz Sanchez; Alicia,7,0,20,13
1715662846198,MAE 197,001,528363,Boechler; Nicholas Sebastia,9998,0,9999,1
1715662847226,MATH 197,001,523477,Kedlaya; Kiran S.,9994,0,9999,5
1715662847226,MATH 197,002,563811,Zhang; Danna,9994,0,9999,5
1715662847226,MATH 197,003,628552,Dumitriu; Ioana,9998,0,9999,1
1715662847226,MATH 197,004,660885,Floyd; Eric,9998,0,9999,1
1715662848256,MCWP 40R,A00,518780,Staff,1,0,20,19
1715662848256,MCWP 40R,B00,518781,Carter; Jennifer A,9,0,20,11
1715662848256,MCWP 40R,C00,518783,Smith; Haydee Marie,5,0,20,15
1715662849285,MCWP 50R,A00,518791,Redela; Pamela Morgan,0,1,20,20
1715662849285,MCWP 50R,B00,518792,Krone; Jarret,0,2,20,20
1715662849285,MCWP 50R,C00,518793,Staff,0,4,20,20
1715662849285,MCWP 50R,D00,518794,Morshed; Michael James,0,2,20,20
1715662849285,MCWP 50R,E00,518795,Carter; Andrea L,0,2,20,20
1715662849285,MCWP 50R,F00,518796,Miller; Elizabeth Deen,0,1,20,20
1715662849285,MCWP 50R,G00,518797,Guillen; Melinda,0,1,20,20
1715662850309,MMW 12R,A01,514034,Herbst; Matthew,0,2,16,16
1715662850309,MMW 12R,A02,514035,Herbst; Matthew,0,0,16,16
1715662851333,MMW 13R,A01,514037,Staff,0,5,16,16
1715662851333,MMW 13R,A02,514039,Staff,0,5,16,16
1715662851333,MMW 13R,A03,628519,Staff,0,4,16,16
1715662853387,SIO 295LS,A00,523233,Staff,10,0,30,20
1715662854412,SIO 295S,A00,523232,Staff,10,0,30,20
1715662855440,SIOC 290S,A01,637330,Merrifield; Mark A,21,0,30,9
1715662856466,SIOC 291S,A01,637333,Gabriel; Corey John,21,0,30,9
1715662857492,SOCI 117,A01,494376,Staff,0,5,5,5
1715662858524,WES 237B,A00,494380,Staff,10,0,20,10
1715662860596,AESE 279B,A00,494370,Wade; Jon P,0,0,33,33
1715662861624,AIP 97,001,660915,Van Den Einde; Yael Dahlia,9998,0,9999,1
1715662862653,AIP 197,001,627712,Vespa; Emanuel Ignacio,9995,0,9999,4
1715662862653,AIP 197,002,650778,Amir; On,9998,0,9999,1
1715662862653,AIP 197,003,650933,Avenancio-Leon; Carlos,9998,0,9999,1
1715662862653,AIP 197,004,658530,Heyman; Gail D.,9998,0,9999,1
1715662862653,AIP 197,005,658631,Neal; Sonya E,9998,0,9999,1
1715662862653,AIP 197,006,658671,Du; Songzi,9998,0,9999,1
1715662863684,ANAR 135S,A00,494369,Braswell; Geoffrey E.,0,0,0,0
1715662864711,BENG 196,001,628496,Engler; Adam J.,9998,0,9999,1
1715662864711,BENG 196,002,660916,Watson; John Thomas,9998,0,9999,1
1715662865737,BISP 197,001,650773,Wilhelm; James E.,9994,0,9999,5
1715662865737,BISP 197,002,658904,Coleman; Aaron B.,9998,0,9999,1
1715662866764,CAT 124RS,A01,519847,Geibel; William,0,0,20,20
1715662867793,CAT 125RS,A01,515971,Geibel; William,0,0,20,20
1715662868820,CLRE 250,A00,511389,Morris; Sheldon,9992,0,9999,7
1715662869847,CLRE 251,A00,507176,Mehta; Ravindra L.,9992,0,9999,7
1715662869847,CLRE 251,B00,511410,Mehta; Ravindra L.,9998,0,9999,1
1715662870879,CLRE 252,A00,507189,Cuomo; Raphael Eduardo,9994,0,9999,5
1715662871906,CLRE 253,A00,507199,Vaida; Florin,9994,0,9999,5
1715662871906,CLRE 253,B00,507202,Vaida; Florin,9999,0,9999,0
1715662872935,CLRE 259,A00,507211,Patel; Hemal,9996,0,9999,3
1715662873960,CLRE 260,A00,507221,Cuomo; Raphael Eduardo,9999,0,9999,0
1715662874989,CLRE 297,001,507242,Cuomo; Raphael Eduardo,9999,0,9999,0
1715662876015,COGS 197,001,638244,Voytek; Bradley Thomas,9997,0,9999,2
1715662877041,CSE 191,A00,516875,Minnes Kemp; Mor Mia,9991,0,9999,8
1715662878070,CSE 197,001,637388,Minnes Kemp; Mor Mia,9992,0,9999,7
1715662879096,CSS 201S,A01,494383,Mignozzetti; Umberto,35,0,35,0
1715662880127,CSS 202S,A01,494387,Mignozzetti; Umberto,35,0,35,0
1715662881153,DSC 197,001,628532,Eldridge; Justin Matthew,9995,0,9999,4
1715662882180,EAP 100,A00,516065,Staff,9799,0,9999,200
1715662883212,ECE 45,A01,507414,Staff,32,0,60,28
1715662885269,ECE 111,A01,507420,Staff,11,0,50,39
1715662886299,ECE 197,001,548057,Sievenpiper; Daniel F.,9991,0,9999,8
1715662887326,EDS 115,A00,507243,Choi; Bailey Miyeon,6,0,28,22
1715662888352,EDS 117,A01,494379,Staff,0,6,34,35
1715662889379,EDS 125,A00,507246,Hopkins; Megan Beth,7,0,30,23
1715662890406,EDS 128A,A01,507264,Fargason; Sharon Gayle,5,0,26,21
1715662891434,EDS 128B,A01,507293,Pappas; Elizabeth,9,0,30,21
1715662892462,EDS 139,A00,507294,Fargason; Sharon Gayle,9,0,30,21
1715662892462,EDS 139,B00,507313,Pappas; Elizabeth,9,0,30,21
1715662893489,EDS 201,A00,507315,Staff,10,0,30,20
1715662894520,EDS 203,A01,507317,Halter; Christopher P.,10,0,30,20
1715662895553,EDS 204R,A01,507319,Halter; Christopher P.,0,3,30,30
1715662895553,EDS 204R,B01,507331,Heinzman; Erica M.,14,0,30,16
1715662896577,EDS 206R,A00,507332,Staff,0,4,30,30
1715662896577,EDS 206R,B00,507343,Staff,15,0,30,15
1715662897625,EDS 250,A00,507344,Hemans; Patricia Ann Benitez,20,0,40,20
1715662898653,EDS 281,A00,507345,Daly; Alan J.,18,0,18,0
1715662899678,EDS 284,A00,507350,Daly; Alan J.,16,0,16,0
1715662900704,EDS 286,A00,507359,Fine; Sarah,18,0,18,0
1715662901731,EDS 289C,A01,507361,Daly; Alan J.,18,0,18,0
1715662902757,EDS 290,A00,507366,Hofstetter; Carolyn,15,0,15,0
1715662903783,LIGM 5A,A00,507421,Fischer-Grunski; Eva K,17,0,20,3
1715662904812,LIGM 5B,A00,507423,Fischer-Grunski; Eva K,19,0,20,1
1715662905841,LIGM 5C,A00,507425,Fischer-Grunski; Eva K,19,0,20,1
1715662906868,LIIT 5AS,A00,507427,Carnelos; Chiara,20,0,20,0
1715662907897,LIIT 5BS,A00,507430,Carnelos; Chiara,20,0,20,0
1715662908924,LIIT 5CS,A00,507432,Carnelos; Chiara,20,0,20,0
1715662909950,LISP 5A,A00,507541,Munoz Sanchez; Alicia,11,0,20,9
1715662910976,LISP 5B,A00,507671,Munoz Sanchez; Alicia,8,0,20,12
1715662912002,LISP 5C,A00,507696,Munoz Sanchez; Alicia,7,0,20,13
1715662913028,MAE 197,001,528363,Boechler; Nicholas Sebastia,9998,0,9999,1
1715662914055,MATH 197,001,523477,Kedlaya; Kiran S.,9994,0,9999,5
1715662914055,MATH 197,002,563811,Zhang; Danna,9994,0,9999,5
1715662914055,MATH 197,003,628552,Dumitriu; Ioana,9998,0,9999,1
1715662914055,MATH 197,004,660885,Floyd; Eric,9998,0,9999,1
1715662915082,MCWP 40R,A00,518780,Staff,1,0,20,19
1715662915082,MCWP 40R,B00,518781,Carter; Jennifer A,9,0,20,11
1715662915082,MCWP 40R,C00,518783,Smith; Haydee Marie,5,0,20,15
1715662916116,MCWP 50R,A00,518791,Redela; Pamela Morgan,0,1,20,20
1715662916116,MCWP 50R,B00,518792,Krone; Jarret,0,2,20,20
1715662916116,MCWP 50R,C00,518793,Staff,0,4,20,20
1715662916116,MCWP 50R,D00,518794,Morshed; Michael James,0,2,20,20
1715662916116,MCWP 50R,E00,518795,Carter; Andrea L,0,2,20,20
1715662916116,MCWP 50R,F00,518796,Miller; Elizabeth Deen,0,1,20,20
1715662916116,MCWP 50R,G00,518797,Guillen; Melinda,0,1,20,20
1715662917142,MMW 12R,A01,514034,Herbst; Matthew,0,2,16,16
1715662917142,MMW 12R,A02,514035,Herbst; Matthew,0,0,16,16
1715662918171,MMW 13R,A01,514037,Staff,0,5,16,16
1715662918171,MMW 13R,A02,514039,Staff,0,5,16,16
1715662918171,MMW 13R,A03,628519,Staff,0,4,16,16
1715662920227,SIO 295LS,A00,523233,Staff,10,0,30,20
1715662921255,SIO 295S,A00,523232,Staff,10,0,30,20
1715662922286,SIOC 290S,A01,637330,Merrifield; Mark A,21,0,30,9
1715662923311,SIOC 291S,A01,637333,Gabriel; Corey John,21,0,30,9
1715662924337,SOCI 117,A01,494376,Staff,0,5,5,5
1715662925361,WES 237B,A00,494380,Staff,10,0,20,10
1715662927438,AESE 279B,A00,494370,Wade; Jon P,0,0,33,33
1715662928463,AIP 97,001,660915,Van Den Einde; Yael Dahlia,9998,0,9999,1
1715662929498,AIP 197,001,627712,Vespa; Emanuel Ignacio,9995,0,9999,4
1715662929498,AIP 197,002,650778,Amir; On,9998,0,9999,1
1715662929498,AIP 197,003,650933,Avenancio-Leon; Carlos,9998,0,9999,1
1715662929498,AIP 197,004,658530,Heyman; Gail D.,9998,0,9999,1
1715662929498,AIP 197,005,658631,Neal; Sonya E,9998,0,9999,1
1715662929498,AIP 197,006,658671,Du; Songzi,9998,0,9999,1
1715662930524,ANAR 135S,A00,494369,Braswell; Geoffrey E.,0,0,0,0
1715662931555,BENG 196,001,628496,Engler; Adam J.,9998,0,9999,1
1715662931555,BENG 196,002,660916,Watson; John Thomas,9998,0,9999,1
1715662932581,BISP 197,001,650773,Wilhelm; James E.,9994,0,9999,5
1715662932581,BISP 197,002,658904,Coleman; Aaron B.,9998,0,9999,1
1715662933607,CAT 124RS,A01,519847,Geibel; William,0,0,20,20
1715662934632,CAT 125RS,A01,515971,Geibel; William,0,0,20,20
1715662935659,CLRE 250,A00,511389,Morris; Sheldon,9992,0,9999,7
1715662936689,CLRE 251,A00,507176,Mehta; Ravindra L.,9992,0,9999,7
1715662936689,CLRE 251,B00,511410,Mehta; Ravindra L.,9998,0,9999,1
1715662937720,CLRE 252,A00,507189,Cuomo; Raphael Eduardo,9994,0,9999,5
1715662938750,CLRE 253,A00,507199,Vaida; Florin,9994,0,9999,5
1715662938750,CLRE 253,B00,507202,Vaida; Florin,9999,0,9999,0
1715662939778,CLRE 259,A00,507211,Patel; Hemal,9996,0,9999,3
1715662940802,CLRE 260,A00,507221,Cuomo; Raphael Eduardo,9999,0,9999,0
1715662941828,CLRE 297,001,507242,Cuomo; Raphael Eduardo,9999,0,9999,0
1715662942853,COGS 197,001,638244,Voytek; Bradley Thomas,9997,0,9999,2
1715662943882,CSE 191,A00,516875,Minnes Kemp; Mor Mia,9991,0,9999,8
1715662944910,CSE 197,001,637388,Minnes Kemp; Mor Mia,9992,0,9999,7
1715662945936,CSS 201S,A01,494383,Mignozzetti; Umberto,35,0,35,0
1715662947032,CSS 202S,A01,494387,Mignozzetti; Umberto,35,0,35,0
1715662948058,DSC 197,001,628532,Eldridge; Justin Matthew,9995,0,9999,4
1715662949084,EAP 100,A00,516065,Staff,9799,0,9999,200
1715662950111,ECE 45,A01,507414,Staff,32,0,60,28
1715662952164,ECE 111,A01,507420,Staff,11,0,50,39
1715662953189,ECE 197,001,548057,Sievenpiper; Daniel F.,9991,0,9999,8
1715662954219,EDS 115,A00,507243,Choi; Bailey Miyeon,6,0,28,22
1715662955245,EDS 117,A01,494379,Staff,0,6,34,35
1715662956271,EDS 125,A00,507246,Hopkins; Megan Beth,7,0,30,23
1715662957299,EDS 128A,A01,507264,Fargason; Sharon Gayle,5,0,26,21
1715662958330,EDS 128B,A01,507293,Pappas; Elizabeth,9,0,30,21
1715662959357,EDS 139,A00,507294,Fargason; Sharon Gayle,9,0,30,21
1715662959357,EDS 139,B00,507313,Pappas; Elizabeth,9,0,30,21
1715662960385,EDS 201,A00,507315,Staff,10,0,30,20
1715662961413,EDS 203,A01,507317,Halter; Christopher P.,10,0,30,20
1715662962438,EDS 204R,A01,507319,Halter; Christopher P.,0,3,30,30
1715662962438,EDS 204R,B01,507331,Heinzman; Erica M.,14,0,30,16
1715662963470,EDS 206R,A00,507332,Staff,0,4,30,30
1715662963470,EDS 206R,B00,507343,Staff,15,0,30,15
1715662964496,EDS 250,A00,507344,Hemans; Patricia Ann Benitez,20,0,40,20
1715662965520,EDS 281,A00,507345,Daly; Alan J.,18,0,18,0
1715662966546,EDS 284,A00,507350,Daly; Alan J.,16,0,16,0
1715662967576,EDS 286,A00,507359,Fine; Sarah,18,0,18,0
1715662968601,EDS 289C,A01,507361,Daly; Alan J.,18,0,18,0
1715662969627,EDS 290,A00,507366,Hofstetter; Carolyn,15,0,15,0
1715662970658,LIGM 5A,A00,507421,Fischer-Grunski; Eva K,17,0,20,3
1715662971688,LIGM 5B,A00,507423,Fischer-Grunski; Eva K,19,0,20,1
1715662972714,LIGM 5C,A00,507425,Fischer-Grunski; Eva K,19,0,20,1
1715662973740,LIIT 5AS,A00,507427,Carnelos; Chiara,20,0,20,0
1715662974766,LIIT 5BS,A00,507430,Carnelos; Chiara,20,0,20,0
1715662975794,LIIT 5CS,A00,507432,Carnelos; Chiara,20,0,20,0
1715662976820,LISP 5A,A00,507541,Munoz Sanchez; Alicia,11,0,20,9
1715662977848,LISP 5B,A00,507671,Munoz Sanchez; Alicia,8,0,20,12
1715662978876,LISP 5C,A00,507696,Munoz Sanchez; Alicia,7,0,20,13
1715662979901,MAE 197,001,528363,Boechler; Nicholas Sebastia,9998,0,9999,1
1715662980934,MATH 197,001,523477,Kedlaya; Kiran S.,9994,0,9999,5
1715662980934,MATH 197,002,563811,Zhang; Danna,9994,0,9999,5
1715662980934,MATH 197,003,628552,Dumitriu; Ioana,9998,0,9999,1
1715662980934,MATH 197,004,660885,Floyd; Eric,9998,0,9999,1
1715662981968,MCWP 40R,A00,518780,Staff,1,0,20,19
1715662981968,MCWP 40R,B00,518781,Carter; Jennifer A,9,0,20,11
1715662981968,MCWP 40R,C00,518783,Smith; Haydee Marie,5,0,20,15
1715662982998,MCWP 50R,A00,518791,Redela; Pamela Morgan,0,1,20,20
1715662982998,MCWP 50R,B00,518792,Krone; Jarret,0,2,20,20
1715662982998,MCWP 50R,C00,518793,Staff,0,4,20,20
1715662982998,MCWP 50R,D00,518794,Morshed; Michael James,0,2,20,20
1715662982998,MCWP 50R,E00,518795,Carter; Andrea L,0,2,20,20
1715662982998,MCWP 50R,F00,518796,Miller; Elizabeth Deen,0,1,20,20
1715662982998,MCWP 50R,G00,518797,Guillen; Melinda,0,1,20,20
1715662984023,MMW 12R,A01,514034,Herbst; Matthew,0,2,16,16
1715662984023,MMW 12R,A02,514035,Herbst; Matthew,0,0,16,16
1715662985053,MMW 13R,A01,514037,Staff,0,5,16,16
1715662985053,MMW 13R,A02,514039,Staff,0,5,16,16
1715662985053,MMW 13R,A03,628519,Staff,0,4,16,16
1715662987108,SIO 295LS,A00,523233,Staff,10,0,30,20
1715662988133,SIO 295S,A00,523232,Staff,10,0,30,20
1715662989158,SIOC 290S,A01,637330,Merrifield; Mark A,21,0,30,9
1715662990184,SIOC 291S,A01,637333,Gabriel; Corey John,21,0,30,9
1715662991209,SOCI 117,A01,494376,Staff,0,5,5,5
1715662992238,WES 237B,A00,494380,Staff,10,0,20,10
1715662994317,AESE 279B,A00,494370,Wade; Jon P,0,0,33,33
1715662995343,AIP 97,001,660915,Van Den Einde; Yael Dahlia,9998,0,9999,1
1715662996371,AIP 197,001,627712,Vespa; Emanuel Ignacio,9995,0,9999,4
1715662996371,AIP 197,002,650778,Amir; On,9998,0,9999,1
1715662996371,AIP 197,003,650933,Avenancio-Leon; Carlos,9998,0,9999,1
1715662996371,AIP 197,004,658530,Heyman; Gail D.,9998,0,9999,1
1715662996371,AIP 197,005,658631,Neal; Sonya E,9998,0,9999,1
1715662996371,AIP 197,006,658671,Du; Songzi,9998,0,9999,1
1715662997399,ANAR 135S,A00,494369,Braswell; Geoffrey E.,0,0,0,0
1715662998425,BENG 196,001,628496,Engler; Adam J.,9998,0,9999,1
1715662998425,BENG 196,002,660916,Watson; John Thomas,9998,0,9999,1
1715662999452,BISP 197,001,650773,Wilhelm; James E.,9994,0,9999,5
1715662999452,BISP 197,002,658904,Coleman; Aaron B.,9998,0,9999,1
1715663000477,CAT 124RS,A01,519847,Geibel; William,0,0,20,20
1715663001502,CAT 125RS,A01,515971,Geibel; William,0,0,20,20
1715663002526,CLRE 250,A00,511389,Morris; Sheldon,9992,0,9999,7
1715663003556,CLRE 251,A00,507176,Mehta; Ravindra L.,9992,0,9999,7
1715663003556,CLRE 251,B00,511410,Mehta; Ravindra L.,9998,0,9999,1
1715663004584,CLRE 252,A00,507189,Cuomo; Raphael Eduardo,9994,0,9999,5
1715663005613,CLRE 253,A00,507199,Vaida; Florin,9994,0,9999,5
1715663005613,CLRE 253,B00,507202,Vaida; Florin,9999,0,9999,0
1715663006645,CLRE 259,A00,507211,Patel; Hemal,9996,0,9999,3
1715663007673,CLRE 260,A00,507221,Cuomo; Raphael Eduardo,9999,0,9999,0
1715663008698,CLRE 297,001,507242,Cuomo; Raphael Eduardo,9999,0,9999,0
1715663009727,COGS 197,001,638244,Voytek; Bradley Thomas,9997,0,9999,2
1715663010752,CSE 191,A00,516875,Minnes Kemp; Mor Mia,9991,0,9999,8
1715663011776,CSE 197,001,637388,Minnes Kemp; Mor Mia,9992,0,9999,7
1715663012801,CSS 201S,A01,494383,Mignozzetti; Umberto,35,0,35,0
1715663013832,CSS 202S,A01,494387,Mignozzetti; Umberto,35,0,35,0
1715663014857,DSC 197,001,628532,Eldridge; Justin Matthew,9995,0,9999,4
1715663015882,EAP 100,A00,516065,Staff,9799,0,9999,200
1715663016928,ECE 45,A01,507414,Staff,32,0,60,28
1715663018984,ECE 111,A01,507420,Staff,11,0,50,39
1715663020012,ECE 197,001,548057,Sievenpiper; Daniel F.,9991,0,9999,8
1715663021038,EDS 115,A00,507243,Choi; Bailey Miyeon,6,0,28,22
1715663022065,EDS 117,A01,494379,Staff,0,6,34,35
1715663023090,EDS 125,A00,507246,Hopkins; Megan Beth,7,0,30,23
1715663024115,EDS 128A,A01,507264,Fargason; Sharon Gayle,5,0,26,21
1715663025140,EDS 128B,A01,507293,Pappas; Elizabeth,9,0,30,21
1715663026168,EDS 139,A00,507294,Fargason; Sharon Gayle,9,0,30,21
1715663026168,EDS 139,B00,507313,Pappas; Elizabeth,9,0,30,21
1715663027193,EDS 201,A00,507315,Staff,10,0,30,20
1715663028222,EDS 203,A01,507317,Halter; Christopher P.,10,0,30,20
1715663029250,EDS 204R,A01,507319,Halter; Christopher P.,0,3,30,30
1715663029250,EDS 204R,B01,507331,Heinzman; Erica M.,14,0,30,16
1715663030279,EDS 206R,A00,507332,Staff,0,4,30,30
1715663030279,EDS 206R,B00,507343,Staff,15,0,30,15
1715663031304,EDS 250,A00,507344,Hemans; Patricia Ann Benitez,20,0,40,20
1715663032333,EDS 281,A00,507345,Daly; Alan J.,18,0,18,0
1715663033362,EDS 284,A00,507350,Daly; Alan J.,16,0,16,0
1715663034386,EDS 286,A00,507359,Fine; Sarah,18,0,18,0
1715663035413,EDS 289C,A01,507361,Daly; Alan J.,18,0,18,0
1715663036441,EDS 290,A00,507366,Hofstetter; Carolyn,15,0,15,0
1715663037468,LIGM 5A,A00,507421,Fischer-Grunski; Eva K,17,0,20,3
1715663038494,LIGM 5B,A00,507423,Fischer-Grunski; Eva K,19,0,20,1
1715663039520,LIGM 5C,A00,507425,Fischer-Grunski; Eva K,19,0,20,1
1715663040545,LIIT 5AS,A00,507427,Carnelos; Chiara,20,0,20,0
1715663041571,LIIT 5BS,A00,507430,Carnelos; Chiara,20,0,20,0
1715663042596,LIIT 5CS,A00,507432,Carnelos; Chiara,20,0,20,0
1715663043620,LISP 5A,A00,507541,Munoz Sanchez; Alicia,11,0,20,9
1715663044644,LISP 5B,A00,507671,Munoz Sanchez; Alicia,8,0,20,12
1715663045673,LISP 5C,A00,507696,Munoz Sanchez; Alicia,7,0,20,13
1715663046698,MAE 197,001,528363,Boechler; Nicholas Sebastia,9998,0,9999,1
1715663047725,MATH 197,001,523477,Kedlaya; Kiran S.,9994,0,9999,5
1715663047725,MATH 197,002,563811,Zhang; Danna,9994,0,9999,5
1715663047725,MATH 197,003,628552,Dumitriu; Ioana,9998,0,9999,1
1715663047725,MATH 197,004,660885,Floyd; Eric,9998,0,9999,1
1715663048752,MCWP 40R,A00,518780,Staff,1,0,20,19
1715663048752,MCWP 40R,B00,518781,Carter; Jennifer A,9,0,20,11
1715663048752,MCWP 40R,C00,518783,Smith; Haydee Marie,5,0,20,15
1715663049780,MCWP 50R,A00,518791,Redela; Pamela Morgan,0,1,20,20
1715663049780,MCWP 50R,B00,518792,Krone; Jarret,0,2,20,20
1715663049780,MCWP 50R,C00,518793,Staff,0,4,20,20
1715663049780,MCWP 50R,D00,518794,Morshed; Michael James,0,2,20,20
1715663049780,MCWP 50R,E00,518795,Carter; Andrea L,0,2,20,20
1715663049780,MCWP 50R,F00,518796,Miller; Elizabeth Deen,0,1,20,20
1715663049780,MCWP 50R,G00,518797,Guillen; Melinda,0,1,20,20
1715663050863,MMW 12R,A01,514034,Herbst; Matthew,0,2,16,16
1715663050863,MMW 12R,A02,514035,Herbst; Matthew,0,0,16,16
1715663051888,MMW 13R,A01,514037,Staff,0,5,16,16
1715663051888,MMW 13R,A02,514039,Staff,0,5,16,16
1715663051888,MMW 13R,A03,628519,Staff,0,4,16,16
1715663053938,SIO 295LS,A00,523233,Staff,10,0,30,20
1715663054968,SIO 295S,A00,523232,Staff,10,0,30,20
1715663055995,SIOC 290S,A01,637330,Merrifield; Mark A,21,0,30,9
1715663057029,SIOC 291S,A01,637333,Gabriel; Corey John,21,0,30,9
1715663058056,SOCI 117,A01,494376,Staff,0,5,5,5
1715663059090,WES 237B,A00,494380,Staff,10,0,20,10
1715663061169,AESE 279B,A00,494370,Wade; Jon P,0,0,33,33
1715663062197,AIP 97,001,660915,Van Den Einde; Yael Dahlia,9998,0,9999,1
1715663063226,AIP 197,001,627712,Vespa; Emanuel Ignacio,9995,0,9999,4
1715663063226,AIP 197,002,650778,Amir; On,9998,0,9999,1
1715663063226,AIP 197,003,650933,Avenancio-Leon; Carlos,9998,0,9999,1
1715663063226,AIP 197,004,658530,Heyman; Gail D.,9998,0,9999,1
1715663063226,AIP 197,005,658631,Neal; Sonya E,9998,0,9999,1
1715663063226,AIP 197,006,658671,Du; Songzi,9998,0,9999,1
1715663064256,ANAR 135S,A00,494369,Braswell; Geoffrey E.,0,0,0,0
1715663065282,BENG 196,001,628496,Engler; Adam J.,9998,0,9999,1
1715663065282,BENG 196,002,660916,Watson; John Thomas,9998,0,9999,1
1715663066306,BISP 197,001,650773,Wilhelm; James E.,9994,0,9999,5
1715663066306,BISP 197,002,658904,Coleman; Aaron B.,9998,0,9999,1
1715663067333,CAT 124RS,A01,519847,Geibel; William,0,0,20,20
1715663068361,CAT 125RS,A01,515971,Geibel; William,0,0,20,20
1715663069390,CLRE 250,A00,511389,Morris; Sheldon,9992,0,9999,7
1715663070424,CLRE 251,A00,507176,Mehta; Ravindra L.,9992,0,9999,7
1715663070424,CLRE 251,B00,511410,Mehta; Ravindra L.,9998,0,9999,1
1715663071449,CLRE 252,A00,507189,Cuomo; Raphael Eduardo,9994,0,9999,5
1715663072476,CLRE 253,A00,507199,Vaida; Florin,9994,0,9999,5
1715663072476,CLRE 253,B00,507202,Vaida; Florin,9999,0,9999,0
1715663073502,CLRE 259,A00,507211,Patel; Hemal,9996,0,9999,3
1715663074529,CLRE 260,A00,507221,Cuomo; Raphael Eduardo,9999,0,9999,0
1715663075554,CLRE 297,001,507242,Cuomo; Raphael Eduardo,9999,0,9999,0
1715663076581,COGS 197,001,638244,Voytek; Bradley Thomas,9997,0,9999,2
1715663077607,CSE 191,A00,516875,Minnes Kemp; Mor Mia,9991,0,9999,8
1715663078632,CSE 197,001,637388,Minnes Kemp; Mor Mia,9992,0,9999,7
1715663079676,CSS 201S,A01,494383,Mignozzetti; Umberto,35,0,35,0
1715663080706,CSS 202S,A01,494387,Mignozzetti; Umberto,35,0,35,0
1715663081733,DSC 197,001,628532,Eldridge; Justin Matthew,9995,0,9999,4
1715663082758,EAP 100,A00,516065,Staff,9799,0,9999,200
1715663083794,ECE 45,A01,507414,Staff,32,0,60,28
1715663085844,ECE 111,A01,507420,Staff,11,0,50,39
1715663086874,ECE 197,001,548057,Sievenpiper; Daniel F.,9991,0,9999,8
1715663087902,EDS 115,A00,507243,Choi; Bailey Miyeon,6,0,28,22
1715663088929,EDS 117,A01,494379,Staff,0,6,34,35
1715663089953,EDS 125,A00,507246,Hopkins; Megan Beth,7,0,30,23
1715663090980,EDS 128A,A01,507264,Fargason; Sharon Gayle,5,0,26,21
1715663092009,EDS 128B,A01,507293,Pappas; Elizabeth,9,0,30,21
1715663093035,EDS 139,A00,507294,Fargason; Sharon Gayle,9,0,30,21
1715663093035,EDS 139,B00,507313,Pappas; Elizabeth,9,0,30,21
1715663094063,EDS 201,A00,507315,Staff,10,0,30,20
1715663095089,EDS 203,A01,507317,Halter; Christopher P.,10,0,30,20
1715663096118,EDS 204R,A01,507319,Halter; Christopher P.,0,3,30,30
1715663096118,EDS 204R,B01,507331,Heinzman; Erica M.,14,0,30,16
1715663097145,EDS 206R,A00,507332,Staff,0,4,30,30
1715663097145,EDS 206R,B00,507343,Staff,15,0,30,15
1715663098173,EDS 250,A00,507344,Hemans; Patricia Ann Benitez,20,0,40,20
1715663099203,EDS 281,A00,507345,Daly; Alan J.,18,0,18,0
1715663100231,EDS 284,A00,507350,Daly; Alan J.,16,0,16,0
1715663101259,EDS 286,A00,507359,Fine; Sarah,18,0,18,0
1715663102286,EDS 289C,A01,507361,Daly; Alan J.,18,0,18,0
1715663103317,EDS 290,A00,507366,Hofstetter; Carolyn,15,0,15,0
1715663104376,LIGM 5A,A00,507421,Fischer-Grunski; Eva K,17,0,20,3
1715663105402,LIGM 5B,A00,507423,Fischer-Grunski; Eva K,19,0,20,1
1715663106430,LIGM 5C,A00,507425,Fischer-Grunski; Eva K,19,0,20,1
1715663107456,LIIT 5AS,A00,507427,Carnelos; Chiara,20,0,20,0
1715663108483,LIIT 5BS,A00,507430,Carnelos; Chiara,20,0,20,0
1715663109511,LIIT 5CS,A00,507432,Carnelos; Chiara,20,0,20,0
1715663110538,LISP 5A,A00,507541,Munoz Sanchez; Alicia,11,0,20,9
1715663111567,LISP 5B,A00,507671,Munoz Sanchez; Alicia,8,0,20,12
1715663112592,LISP 5C,A00,507696,Munoz Sanchez; Alicia,7,0,20,13
1715663113619,MAE 197,001,528363,Boechler; Nicholas Sebastia,9998,0,9999,1
1715663114647,MATH 197,001,523477,Kedlaya; Kiran S.,9994,0,9999,5
1715663114647,MATH 197,002,563811,Zhang; Danna,9994,0,9999,5
1715663114647,MATH 197,003,628552,Dumitriu; Ioana,9998,0,9999,1
1715663114647,MATH 197,004,660885,Floyd; Eric,9998,0,9999,1
1715663115676,MCWP 40R,A00,518780,Staff,1,0,20,19
1715663115676,MCWP 40R,B00,518781,Carter; Jennifer A,9,0,20,11
1715663115676,MCWP 40R,C00,518783,Smith; Haydee Marie,5,0,20,15
1715663116705,MCWP 50R,A00,518791,Redela; Pamela Morgan,0,1,20,20
1715663116705,MCWP 50R,B00,518792,Krone; Jarret,0,2,20,20
1715663116705,MCWP 50R,C00,518793,Staff,0,4,20,20
1715663116705,MCWP 50R,D00,518794,Morshed; Michael James,0,2,20,20
1715663116705,MCWP 50R,E00,518795,Carter; Andrea L,0,2,20,20
1715663116705,MCWP 50R,F00,518796,Miller; Elizabeth Deen,0,1,20,20
1715663116705,MCWP 50R,G00,518797,Guillen; Melinda,0,1,20,20
1715663117732,MMW 12R,A01,514034,Herbst; Matthew,0,2,16,16
1715663117732,MMW 12R,A02,514035,Herbst; Matthew,0,0,16,16
1715663118760,MMW 13R,A01,514037,Staff,0,5,16,16
1715663118760,MMW 13R,A02,514039,Staff,0,5,16,16
1715663118760,MMW 13R,A03,628519,Staff,0,4,16,16
1715663120811,SIO 295LS,A00,523233,Staff,10,0,30,20
1715663121836,SIO 295S,A00,523232,Staff,10,0,30,20
1715663122869,SIOC 290S,A01,637330,Merrifield; Mark A,21,0,30,9
1715663123906,SIOC 291S,A01,637333,Gabriel; Corey John,21,0,30,9
1715663124934,SOCI 117,A01,494376,Staff,0,5,5,5
1715663125958,WES 237B,A00,494380,Staff,10,0,20,10
1715663128024,AESE 279B,A00,494370,Wade; Jon P,0,0,33,33
1715663129051,AIP 97,001,660915,Van Den Einde; Yael Dahlia,9998,0,9999,1
1715663130081,AIP 197,001,627712,Vespa; Emanuel Ignacio,9995,0,9999,4
1715663130081,AIP 197,002,650778,Amir; On,9998,0,9999,1
1715663130081,AIP 197,003,650933,Avenancio-Leon; Carlos,9998,0,9999,1
1715663130081,AIP 197,004,658530,Heyman; Gail D.,9998,0,9999,1
1715663130081,AIP 197,005,658631,Neal; Sonya E,9998,0,9999,1
1715663130081,AIP 197,006,658671,Du; Songzi,9998,0,9999,1
1715663131106,ANAR 135S,A00,494369,Braswell; Geoffrey E.,0,0,0,0
1715663132132,BENG 196,001,628496,Engler; Adam J.,9998,0,9999,1
1715663132132,BENG 196,002,660916,Watson; John Thomas,9998,0,9999,1
1715663133159,BISP 197,001,650773,Wilhelm; James E.,9994,0,9999,5
1715663133159,BISP 197,002,658904,Coleman; Aaron B.,9998,0,9999,1
1715663134184,CAT 124RS,A01,519847,Geibel; William,0,0,20,20
1715663135209,CAT 125RS,A01,515971,Geibel; William,0,0,20,20
1715663136240,CLRE 250,A00,511389,Morris; Sheldon,9992,0,9999,7
1715663137266,CLRE 251,A00,507176,Mehta; Ravindra L.,9992,0,9999,7
1715663137266,CLRE 251,B00,511410,Mehta; Ravindra L.,9998,0,9999,1
1715663138294,CLRE 252,A00,507189,Cuomo; Raphael Eduardo,9994,0,9999,5
1715663139321,CLRE 253,A00,507199,Vaida; Florin,9994,0,9999,5
1715663139321,CLRE 253,B00,507202,Vaida; Florin,9999,0,9999,0
1715663140346,CLRE 259,A00,507211,Patel; Hemal,9996,0,9999,3
1715663141373,CLRE 260,A00,507221,Cuomo; Raphael Eduardo,9999,0,9999,0
1715663142398,CLRE 297,001,507242,Cuomo; Raphael Eduardo,9999,0,9999,0
1715663143424,COGS 197,001,638244,Voytek; Bradley Thomas,9997,0,9999,2
1715663144454,CSE 191,A00,516875,Minnes Kemp; Mor Mia,9991,0,9999,8
1715663145482,CSE 197,001,637388,Minnes Kemp; Mor Mia,9992,0,9999,7
1715663146510,CSS 201S,A01,494383,Mignozzetti; Umberto,35,0,35,0
1715663147540,CSS 202S,A01,494387,Mignozzetti; Umberto,35,0,35,0
1715663148568,DSC 197,001,628532,Eldridge; Justin Matthew,9995,0,9999,4
1715663149592,EAP 100,A00,516065,Staff,9799,0,9999,200
1715663150621,ECE 45,A01,507414,Staff,32,0,60,28
1715663152675,ECE 111,A01,507420,Staff,11,0,50,39
1715663153701,ECE 197,001,548057,Sievenpiper; Daniel F.,9991,0,9999,8
1715663154804,EDS 115,A00,507243,Choi; Bailey Miyeon,6,0,28,22
1715663155830,EDS 117,A01,494379,Staff,0,6,34,35
1715663156855,EDS 125,A00,507246,Hopkins; Megan Beth,7,0,30,23
1715663157885,EDS 128A,A01,507264,Fargason; Sharon Gayle,5,0,26,21
1715663158913,EDS 128B,A01,507293,Pappas; Elizabeth,9,0,30,21
1715663159938,EDS 139,A00,507294,Fargason; Sharon Gayle,9,0,30,21
1715663159938,EDS 139,B00,507313,Pappas; Elizabeth,9,0,30,21
1715663160965,EDS 201,A00,507315,Staff,10,0,30,20
1715663161992,EDS 203,A01,507317,Halter; Christopher P.,10,0,30,20
1715663163018,EDS 204R,A01,507319,Halter; Christopher P.,0,3,30,30
1715663163018,EDS 204R,B01,507331,Heinzman; Erica M.,14,0,30,16
1715663164047,EDS 206R,A00,507332,Staff,0,4,30,30
1715663164047,EDS 206R,B00,507343,Staff,15,0,30,15
1715663165075,EDS 250,A00,507344,Hemans; Patricia Ann Benitez,20,0,40,20
1715663166104,EDS 281,A00,507345,Daly; Alan J.,18,0,18,0
1715663167129,EDS 284,A00,507350,Daly; Alan J.,16,0,16,0
1715663168157,EDS 286,A00,507359,Fine; Sarah,18,0,18,0
1715663169182,EDS 289C,A01,507361,Daly; Alan J.,18,0,18,0
1715663170206,EDS 290,A00,507366,Hofstetter; Carolyn,15,0,15,0
1715663171237,LIGM 5A,A00,507421,Fischer-Grunski; Eva K,17,0,20,3
1715663172262,LIGM 5B,A00,507423,Fischer-Grunski; Eva K,19,0,20,1
1715663173291,LIGM 5C,A00,507425,Fischer-Grunski; Eva K,19,0,20,1
1715663174316,LIIT 5AS,A00,507427,Carnelos; Chiara,20,0,20,0
1715663175341,LIIT 5BS,A00,507430,Carnelos; Chiara,20,0,20,0
1715663176370,LIIT 5CS,A00,507432,Carnelos; Chiara,20,0,20,0
1715663177397,LISP 5A,A00,507541,Munoz Sanchez; Alicia,11,0,20,9
1715663178425,LISP 5B,A00,507671,Munoz Sanchez; Alicia,8,0,20,12
1715663179454,LISP 5C,A00,507696,Munoz Sanchez; Alicia,7,0,20,13
1715663180479,MAE 197,001,528363,Boechler; Nicholas Sebastia,9998,0,9999,1
1715663181508,MATH 197,001,523477,Kedlaya; Kiran S.,9994,0,9999,5
1715663181508,MATH 197,002,563811,Zhang; Danna,9994,0,9999,5
1715663181508,MATH 197,003,628552,Dumitriu; Ioana,9998,0,9999,1
1715663181508,MATH 197,004,660885,Floyd; Eric,9998,0,9999,1
1715663182535,MCWP 40R,A00,518780,Staff,1,0,20,19
1715663182535,MCWP 40R,B00,518781,Carter; Jennifer A,9,0,20,11
1715663182535,MCWP 40R,C00,518783,Smith; Haydee Marie,5,0,20,15
1715663183564,MCWP 50R,A00,518791,Redela; Pamela Morgan,0,1,20,20
1715663183564,MCWP 50R,B00,518792,Krone; Jarret,0,2,20,20
1715663183564,MCWP 50R,C00,518793,Staff,0,4,20,20
1715663183564,MCWP 50R,D00,518794,Morshed; Michael James,0,2,20,20
1715663183564,MCWP 50R,E00,518795,Carter; Andrea L,0,2,20,20
1715663183564,MCWP 50R,F00,518796,Miller; Elizabeth Deen,0,1,20,20
1715663183564,MCWP 50R,G00,518797,Guillen; Melinda,0,1,20,20
1715663184589,MMW 12R,A01,514034,Herbst; Matthew,0,2,16,16
1715663184589,MMW 12R,A02,514035,Herbst; Matthew,0,0,16,16
1715663185614,MMW 13R,A01,514037,Staff,0,5,16,16
1715663185614,MMW 13R,A02,514039,Staff,0,5,16,16
1715663185614,MMW 13R,A03,628519,Staff,0,4,16,16
1715663187670,SIO 295LS,A00,523233,Staff,10,0,30,20
1715663188693,SIO 295S,A00,523232,Staff,10,0,30,20
1715663189720,SIOC 290S,A01,637330,Merrifield; Mark A,21,0,30,9
1715663190748,SIOC 291S,A01,637333,Gabriel; Corey John,21,0,30,9
1715663191776,SOCI 117,A01,494376,Staff,0,5,5,5
1715663192801,WES 237B,A00,494380,Staff,10,0,20,10
1715663194872,AESE 279B,A00,494370,Wade; Jon P,0,0,33,33
1715663195897,AIP 97,001,660915,Van Den Einde; Yael Dahlia,9998,0,9999,1
1715663196925,AIP 197,001,627712,Vespa; Emanuel Ignacio,9995,0,9999,4
1715663196925,AIP 197,002,650778,Amir; On,9998,0,9999,1
1715663196925,AIP 197,003,650933,Avenancio-Leon; Carlos,9998,0,9999,1
1715663196925,AIP 197,004,658530,Heyman; Gail D.,9998,0,9999,1
1715663196925,AIP 197,005,658631,Neal; Sonya E,9998,0,9999,1
1715663196925,AIP 197,006,658671,Du; Songzi,9998,0,9999,1
1715663197950,ANAR 135S,A00,494369,Braswell; Geoffrey E.,0,0,0,0
1715663198978,BENG 196,001,628496,Engler; Adam J.,9998,0,9999,1
1715663198978,BENG 196,002,660916,Watson; John Thomas,9998,0,9999,1
1715663200003,BISP 197,001,650773,Wilhelm; James E.,9994,0,9999,5
1715663200003,BISP 197,002,658904,Coleman; Aaron B.,9998,0,9999,1
1715663201030,CAT 124RS,A01,519847,Geibel; William,0,0,20,20
1715663202057,CAT 125RS,A01,515971,Geibel; William,0,0,20,20
1715663203083,CLRE 250,A00,511389,Morris; Sheldon,9992,0,9999,7
1715663204119,CLRE 251,A00,507176,Mehta; Ravindra L.,9992,0,9999,7
1715663204119,CLRE 251,B00,511410,Mehta; Ravindra L.,9998,0,9999,1
1715663205147,CLRE 252,A00,507189,Cuomo; Raphael Eduardo,9994,0,9999,5
1715663206176,CLRE 253,A00,507199,Vaida; Florin,9994,0,9999,5
1715663206176,CLRE 253,B00,507202,Vaida; Florin,9999,0,9999,0
1715663207206,CLRE 259,A00,507211,Patel; Hemal,9996,0,9999,3
1715663208231,CLRE 260,A00,507221,Cuomo; Raphael Eduardo,9999,0,9999,0
1715663209258,CLRE 297,001,507242,Cuomo; Raphael Eduardo,9999,0,9999,0
1715663210284,COGS 197,001,638244,Voytek; Bradley Thomas,9997,0,9999,2
1715663211309,CSE 191,A00,516875,Minnes Kemp; Mor Mia,9991,0,9999,8
1715663212335,CSE 197,001,637388,Minnes Kemp; Mor Mia,9992,0,9999,7
1715663213561,CSS 201S,A01,494383,Mignozzetti; Umberto,35,0,35,0
1715663214586,CSS 202S,A01,494387,Mignozzetti; Umberto,35,0,35,0
1715663215616,DSC 197,001,628532,Eldridge; Justin Matthew,9995,0,9999,4
1715663216640,EAP 100,A00,516065,Staff,9799,0,9999,200
1715663217667,ECE 45,A01,507414,Staff,32,0,60,28
1715663219719,ECE 111,A01,507420,Staff,11,0,50,39
1715663220745,ECE 197,001,548057,Sievenpiper; Daniel F.,9991,0,9999,8
1715663221774,EDS 115,A00,507243,Choi; Bailey Miyeon,6,0,28,22
1715663222801,EDS 117,A01,494379,Staff,0,6,34,35
1715663223831,EDS 125,A00,507246,Hopkins; Megan Beth,7,0,30,23
1715663224859,EDS 128A,A01,507264,Fargason; Sharon Gayle,5,0,26,21
1715663225886,EDS 128B,A01,507293,Pappas; Elizabeth,9,0,30,21
1715663226910,EDS 139,A00,507294,Fargason; Sharon Gayle,9,0,30,21
1715663226910,EDS 139,B00,507313,Pappas; Elizabeth,9,0,30,21
1715663227937,EDS 201,A00,507315,Staff,10,0,30,20
1715663228964,EDS 203,A01,507317,Halter; Christopher P.,10,0,30,20
1715663229990,EDS 204R,A01,507319,Halter; Christopher P.,0,3,30,30
1715663229990,EDS 204R,B01,507331,Heinzman; Erica M.,14,0,30,16
1715663231017,EDS 206R,A00,507332,Staff,0,4,30,30
1715663231017,EDS 206R,B00,507343,Staff,15,0,30,15
1715663232044,EDS 250,A00,507344,Hemans; Patricia Ann Benitez,20,0,40,20
1715663233073,EDS 281,A00,507345,Daly; Alan J.,18,0,18,0
1715663234101,EDS 284,A00,507350,Daly; Alan J.,16,0,16,0
1715663235126,EDS 286,A00,507359,Fine; Sarah,18,0,18,0
1715663236155,EDS 289C,A01,507361,Daly; Alan J.,18,0,18,0
1715663237180,EDS 290,A00,507366,Hofstetter; Carolyn,15,0,15,0
1715663238211,LIGM 5A,A00,507421,Fischer-Grunski; Eva K,17,0,20,3
1715663239237,LIGM 5B,A00,507423,Fischer-Grunski; Eva K,19,0,20,1
1715663240262,LIGM 5C,A00,507425,Fischer-Grunski; Eva K,19,0,20,1
1715663241288,LIIT 5AS,A00,507427,Carnelos; Chiara,20,0,20,0
1715663242316,LIIT 5BS,A00,507430,Carnelos; Chiara,20,0,20,0
1715663243341,LIIT 5CS,A00,507432,Carnelos; Chiara,20,0,20,0
1715663244372,LISP 5A,A00,507541,Munoz Sanchez; Alicia,11,0,20,9
1715663245398,LISP 5B,A00,507671,Munoz Sanchez; Alicia,8,0,20,12
1715663246424,LISP 5C,A00,507696,Munoz Sanchez; Alicia,7,0,20,13
1715663247450,MAE 197,001,528363,Boechler; Nicholas Sebastia,9998,0,9999,1
1715663248479,MATH 197,001,523477,Kedlaya; Kiran S.,9994,0,9999,5
1715663248479,MATH 197,002,563811,Zhang; Danna,9994,0,9999,5
1715663248479,MATH 197,003,628552,Dumitriu; Ioana,9998,0,9999,1
1715663248479,MATH 197,004,660885,Floyd; Eric,9998,0,9999,1
1715663249507,MCWP 40R,A00,518780,Staff,1,0,20,19
1715663249507,MCWP 40R,B00,518781,Carter; Jennifer A,9,0,20,11
1715663249507,MCWP 40R,C00,518783,Smith; Haydee Marie,5,0,20,15
1715663250540,MCWP 50R,A00,518791,Redela; Pamela Morgan,0,1,20,20
1715663250540,MCWP 50R,B00,518792,Krone; Jarret,0,2,20,20
1715663250540,MCWP 50R,C00,518793,Staff,0,4,20,20
1715663250540,MCWP 50R,D00,518794,Morshed; Michael James,0,2,20,20
1715663250540,MCWP 50R,E00,518795,Carter; Andrea L,0,2,20,20
1715663250540,MCWP 50R,F00,518796,Miller; Elizabeth Deen,0,1,20,20
1715663250540,MCWP 50R,G00,518797,Guillen; Melinda,0,1,20,20
1715663251568,MMW 12R,A01,514034,Herbst; Matthew,0,2,16,16
1715663251568,MMW 12R,A02,514035,Herbst; Matthew,0,0,16,16
1715663252597,MMW 13R,A01,514037,Staff,0,5,16,16
1715663252597,MMW 13R,A02,514039,Staff,0,5,16,16
1715663252597,MMW 13R,A03,628519,Staff,0,4,16,16
1715663254648,SIO 295LS,A00,523233,Staff,10,0,30,20
1715663255673,SIO 295S,A00,523232,Staff,10,0,30,20
1715663256700,SIOC 290S,A01,637330,Merrifield; Mark A,21,0,30,9
1715663257730,SIOC 291S,A01,637333,Gabriel; Corey John,21,0,30,9
1715663258756,SOCI 117,A01,494376,Staff,0,5,5,5
1715663259781,WES 237B,A00,494380,Staff,10,0,20,10
1715663261861,AESE 279B,A00,494370,Wade; Jon P,0,0,33,33
1715663262888,AIP 97,001,660915,Van Den Einde; Yael Dahlia,9998,0,9999,1
1715663263915,AIP 197,001,627712,Vespa; Emanuel Ignacio,9995,0,9999,4
1715663263915,AIP 197,002,650778,Amir; On,9998,0,9999,1
1715663263915,AIP 197,003,650933,Avenancio-Leon; Carlos,9998,0,9999,1
1715663263915,AIP 197,004,658530,Heyman; Gail D.,9998,0,9999,1
1715663263915,AIP 197,005,658631,Neal; Sonya E,9998,0,9999,1
1715663263915,AIP 197,006,658671,Du; Songzi,9998,0,9999,1
1715663264941,ANAR 135S,A00,494369,Braswell; Geoffrey E.,0,0,0,0
1715663265969,BENG 196,001,628496,Engler; Adam J.,9998,0,9999,1
1715663265969,BENG 196,002,660916,Watson; John Thomas,9998,0,9999,1
1715663267002,BISP 197,001,650773,Wilhelm; James E.,9994,0,9999,5
1715663267002,BISP 197,002,658904,Coleman; Aaron B.,9998,0,9999,1
1715663268028,CAT 124RS,A01,519847,Geibel; William,0,0,20,20
1715663269056,CAT 125RS,A01,515971,Geibel; William,0,0,20,20
1715663270081,CLRE 250,A00,511389,Morris; Sheldon,9992,0,9999,7
1715663271111,CLRE 251,A00,507176,Mehta; Ravindra L.,9992,0,9999,7
1715663271111,CLRE 251,B00,511410,Mehta; Ravindra L.,9998,0,9999,1
1715663272136,CLRE 252,A00,507189,Cuomo; Raphael Eduardo,9994,0,9999,5
1715663273165,CLRE 253,A00,507199,Vaida; Florin,9994,0,9999,5
1715663273165,CLRE 253,B00,507202,Vaida; Florin,9999,0,9999,0
1715663274192,CLRE 259,A00,507211,Patel; Hemal,9996,0,9999,3
1715663275216,CLRE 260,A00,507221,Cuomo; Raphael Eduardo,9999,0,9999,0
1715663276241,CLRE 297,001,507242,Cuomo; Raphael Eduardo,9999,0,9999,0
1715663277270,COGS 197,001,638244,Voytek; Bradley Thomas,9997,0,9999,2
1715663278299,CSE 191,A00,516875,Minnes Kemp; Mor Mia,9991,0,9999,8
1715663279325,CSE 197,001,637388,Minnes Kemp; Mor Mia,9992,0,9999,7
1715663280355,CSS 201S,A01,494383,Mignozzetti; Umberto,35,0,35,0
1715663281382,CSS 202S,A01,494387,Mignozzetti; Umberto,35,0,35,0
1715663282408,DSC 197,001,628532,Eldridge; Justin Matthew,9995,0,9999,4
1715663283432,EAP 100,A00,516065,Staff,9799,0,9999,200
1715663284459,ECE 45,A01,507414,Staff,32,0,60,28
1715663286512,ECE 111,A01,507420,Staff,11,0,50,39
1715663287536,ECE 197,001,548057,Sievenpiper; Daniel F.,9991,0,9999,8
1715663288563,EDS 115,A00,507243,Choi; Bailey Miyeon,6,0,28,22
1715663289592,EDS 117,A01,494379,Staff,0,6,34,35
1715663290617,EDS 125,A00,507246,Hopkins; Megan Beth,7,0,30,23
1715663291646,EDS 128A,A01,507264,Fargason; Sharon Gayle,5,0,26,21
1715663292673,EDS 128B,A01,507293,Pappas; Elizabeth,9,0,30,21
1715663293696,EDS 139,A00,507294,Fargason; Sharon Gayle,9,0,30,21
1715663293696,EDS 139,B00,507313,Pappas; Elizabeth,9,0,30,21
1715663294721,EDS 201,A00,507315,Staff,10,0,30,20
1715663295749,EDS 203,A01,507317,Halter; Christopher P.,10,0,30,20
1715663296775,EDS 204R,A01,507319,Halter; Christopher P.,0,3,30,30
1715663296775,EDS 204R,B01,507331,Heinzman; Erica M.,14,0,30,16
1715663297799,EDS 206R,A00,507332,Staff,0,4,30,30
1715663297799,EDS 206R,B00,507343,Staff,15,0,30,15
1715663298825,EDS 250,A00,507344,Hemans; Patricia Ann Benitez,20,0,40,20
1715663299853,EDS 281,A00,507345,Daly; Alan J.,18,0,18,0
1715663300880,EDS 284,A00,507350,Daly; Alan J.,16,0,16,0
1715663301906,EDS 286,A00,507359,Fine; Sarah,18,0,18,0
1715663302930,EDS 289C,A01,507361,Daly; Alan J.,18,0,18,0
1715663303954,EDS 290,A00,507366,Hofstetter; Carolyn,15,0,15,0
1715663304982,LIGM 5A,A00,507421,Fischer-Grunski; Eva K,17,0,20,3
1715663306008,LIGM 5B,A00,507423,Fischer-Grunski; Eva K,19,0,20,1
1715663307035,LIGM 5C,A00,507425,Fischer-Grunski; Eva K,19,0,20,1
1715663308061,LIIT 5AS,A00,507427,Carnelos; Chiara,20,0,20,0
1715663309089,LIIT 5BS,A00,507430,Carnelos; Chiara,20,0,20,0
1715663310131,LIIT 5CS,A00,507432,Carnelos; Chiara,20,0,20,0
1715663311157,LISP 5A,A00,507541,Munoz Sanchez; Alicia,11,0,20,9
1715663312182,LISP 5B,A00,507671,Munoz Sanchez; Alicia,8,0,20,12
1715663313209,LISP 5C,A00,507696,Munoz Sanchez; Alicia,7,0,20,13
1715663314237,MAE 197,001,528363,Boechler; Nicholas Sebastia,9998,0,9999,1
1715663315270,MATH 197,001,523477,Kedlaya; Kiran S.,9994,0,9999,5
1715663315270,MATH 197,002,563811,Zhang; Danna,9994,0,9999,5
1715663315270,MATH 197,003,628552,Dumitriu; Ioana,9998,0,9999,1
1715663315270,MATH 197,004,660885,Floyd; Eric,9998,0,9999,1
1715663316299,MCWP 40R,A00,518780,Staff,1,0,20,19
1715663316299,MCWP 40R,B00,518781,Carter; Jennifer A,9,0,20,11
1715663316299,MCWP 40R,C00,518783,Smith; Haydee Marie,5,0,20,15
1715663317327,MCWP 50R,A00,518791,Redela; Pamela Morgan,0,1,20,20
1715663317327,MCWP 50R,B00,518792,Krone; Jarret,0,2,20,20
1715663317327,MCWP 50R,C00,518793,Staff,0,4,20,20
1715663317327,MCWP 50R,D00,518794,Morshed; Michael James,0,2,20,20
1715663317327,MCWP 50R,E00,518795,Carter; Andrea L,0,2,20,20
1715663317327,MCWP 50R,F00,518796,Miller; Elizabeth Deen,0,1,20,20
1715663317327,MCWP 50R,G00,518797,Guillen; Melinda,0,1,20,20
1715663318352,MMW 12R,A01,514034,Herbst; Matthew,0,2,16,16
1715663318352,MMW 12R,A02,514035,Herbst; Matthew,0,0,16,16
1715663319380,MMW 13R,A01,514037,Staff,0,5,16,16
1715663319380,MMW 13R,A02,514039,Staff,0,5,16,16
1715663319380,MMW 13R,A03,628519,Staff,0,4,16,16
1715663321434,SIO 295LS,A00,523233,Staff,10,0,30,20
1715663322458,SIO 295S,A00,523232,Staff,10,0,30,20
1715663323485,SIOC 290S,A01,637330,Merrifield; Mark A,21,0,30,9
1715663324514,SIOC 291S,A01,637333,Gabriel; Corey John,21,0,30,9
1715663325542,SOCI 117,A01,494376,Staff,0,5,5,5
1715663326570,WES 237B,A00,494380,Staff,10,0,20,10
1715663328640,AESE 279B,A00,494370,Wade; Jon P,0,0,33,33
1715663329665,AIP 97,001,660915,Van Den Einde; Yael Dahlia,9998,0,9999,1
1715663330692,AIP 197,001,627712,Vespa; Emanuel Ignacio,9995,0,9999,4
1715663330692,AIP 197,002,650778,Amir; On,9998,0,9999,1
1715663330692,AIP 197,003,650933,Avenancio-Leon; Carlos,9998,0,9999,1
1715663330692,AIP 197,004,658530,Heyman; Gail D.,9998,0,9999,1
1715663330692,AIP 197,005,658631,Neal; Sonya E,9998,0,9999,1
1715663330692,AIP 197,006,658671,Du; Songzi,9998,0,9999,1
1715663331716,ANAR 135S,A00,494369,Braswell; Geoffrey E.,0,0,0,0
1715663332742,BENG 196,001,628496,Engler; Adam J.,9998,0,9999,1
1715663332742,BENG 196,002,660916,Watson; John Thomas,9998,0,9999,1
1715663333772,BISP 197,001,650773,Wilhelm; James E.,9994,0,9999,5
1715663333772,BISP 197,002,658904,Coleman; Aaron B.,9998,0,9999,1
1715663334800,CAT 124RS,A01,519847,Geibel; William,0,0,20,20
1715663335826,CAT 125RS,A01,515971,Geibel; William,0,0,20,20
1715663336852,CLRE 250,A00,511389,Morris; Sheldon,9992,0,9999,7
1715663337877,CLRE 251,A00,507176,Mehta; Ravindra L.,9992,0,9999,7
1715663337877,CLRE 251,B00,511410,Mehta; Ravindra L.,9998,0,9999,1
1715663338903,CLRE 252,A00,507189,Cuomo; Raphael Eduardo,9994,0,9999,5
1715663339930,CLRE 253,A00,507199,Vaida; Florin,9994,0,9999,5
1715663339930,CLRE 253,B00,507202,Vaida; Florin,9999,0,9999,0
1715663340956,CLRE 259,A00,507211,Patel; Hemal,9996,0,9999,3
1715663341982,CLRE 260,A00,507221,Cuomo; Raphael Eduardo,9999,0,9999,0
1715663343007,CLRE 297,001,507242,Cuomo; Raphael Eduardo,9999,0,9999,0
1715663344033,COGS 197,001,638244,Voytek; Bradley Thomas,9997,0,9999,2
1715663345058,CSE 191,A00,516875,Minnes Kemp; Mor Mia,9991,0,9999,8
1715663346082,CSE 197,001,637388,Minnes Kemp; Mor Mia,9992,0,9999,7
1715663347125,CSS 201S,A01,494383,Mignozzetti; Umberto,35,0,35,0
1715663348150,CSS 202S,A01,494387,Mignozzetti; Umberto,35,0,35,0
1715663349174,DSC 197,001,628532,Eldridge; Justin Matthew,9995,0,9999,4
1715663350201,EAP 100,A00,516065,Staff,9799,0,9999,200
1715663351233,ECE 45,A01,507414,Staff,32,0,60,28
1715663353284,ECE 111,A01,507420,Staff,11,0,50,39
1715663354310,ECE 197,001,548057,Sievenpiper; Daniel F.,9991,0,9999,8
1715663355344,EDS 115,A00,507243,Choi; Bailey Miyeon,6,0,28,22
1715663356369,EDS 117,A01,494379,Staff,0,6,34,35
1715663357397,EDS 125,A00,507246,Hopkins; Megan Beth,7,0,30,23
1715663358421,EDS 128A,A01,507264,Fargason; Sharon Gayle,5,0,26,21
1715663359447,EDS 128B,A01,507293,Pappas; Elizabeth,9,0,30,21
1715663360472,EDS 139,A00,507294,Fargason; Sharon Gayle,9,0,30,21
1715663360472,EDS 139,B00,507313,Pappas; Elizabeth,9,0,30,21
1715663361496,EDS 201,A00,507315,Staff,10,0,30,20
1715663362525,EDS 203,A01,507317,Halter; Christopher P.,10,0,30,20
1715663363550,EDS 204R,A01,507319,Halter; Christopher P.,0,3,30,30
1715663363550,EDS 204R,B01,507331,Heinzman; Erica M.,14,0,30,16
1715663364573,EDS 206R,A00,507332,Staff,0,4,30,30
1715663364573,EDS 206R,B00,507343,Staff,15,0,30,15
1715663365601,EDS 250,A00,507344,Hemans; Patricia Ann Benitez,20,0,40,20
1715663366629,EDS 281,A00,507345,Daly; Alan J.,18,0,18,0
1715663367654,EDS 284,A00,507350,Daly; Alan J.,16,0,16,0
1715663368679,EDS 286,A00,507359,Fine; Sarah,18,0,18,0
1715663369705,EDS 289C,A01,507361,Daly; Alan J.,18,0,18,0
1715663370731,EDS 290,A00,507366,Hofstetter; Carolyn,15,0,15,0
1715663371760,LIGM 5A,A00,507421,Fischer-Grunski; Eva K,17,0,20,3
1715663372790,LIGM 5B,A00,507423,Fischer-Grunski; Eva K,19,0,20,1
1715663373816,LIGM 5C,A00,507425,Fischer-Grunski; Eva K,19,0,20,1
1715663374842,LIIT 5AS,A00,507427,Carnelos; Chiara,20,0,20,0
1715663375872,LIIT 5BS,A00,507430,Carnelos; Chiara,20,0,20,0
1715663376899,LIIT 5CS,A00,507432,Carnelos; Chiara,20,0,20,0
1715663377928,LISP 5A,A00,507541,Munoz Sanchez; Alicia,11,0,20,9
1715663378953,LISP 5B,A00,507671,Munoz Sanchez; Alicia,8,0,20,12
1715663379982,LISP 5C,A00,507696,Munoz Sanchez; Alicia,7,0,20,13
1715663381005,MAE 197,001,528363,Boechler; Nicholas Sebastia,9998,0,9999,1
1715663382031,MATH 197,001,523477,Kedlaya; Kiran S.,9994,0,9999,5
1715663382031,MATH 197,002,563811,Zhang; Danna,9994,0,9999,5
1715663382031,MATH 197,003,628552,Dumitriu; Ioana,9998,0,9999,1
1715663382031,MATH 197,004,660885,Floyd; Eric,9998,0,9999,1
1715663383057,MCWP 40R,A00,518780,Staff,1,0,20,19
1715663383057,MCWP 40R,B00,518781,Carter; Jennifer A,9,0,20,11
1715663383057,MCWP 40R,C00,518783,Smith; Haydee Marie,5,0,20,15
1715663384087,MCWP 50R,A00,518791,Redela; Pamela Morgan,0,1,20,20
1715663384087,MCWP 50R,B00,518792,Krone; Jarret,0,2,20,20
1715663384087,MCWP 50R,C00,518793,Staff,0,4,20,20
1715663384087,MCWP 50R,D00,518794,Morshed; Michael James,0,2,20,20
1715663384087,MCWP 50R,E00,518795,Carter; Andrea L,0,2,20,20
1715663384087,MCWP 50R,F00,518796,Miller; Elizabeth Deen,0,1,20,20
1715663384087,MCWP 50R,G00,518797,Guillen; Melinda,0,1,20,20
1715663385116,MMW 12R,A01,514034,Herbst; Matthew,0,2,16,16
1715663385116,MMW 12R,A02,514035,Herbst; Matthew,0,0,16,16
1715663386142,MMW 13R,A01,514037,Staff,0,5,16,16
1715663386142,MMW 13R,A02,514039,Staff,0,5,16,16
1715663386142,MMW 13R,A03,628519,Staff,0,4,16,16
1715663388208,SIO 295LS,A00,523233,Staff,10,0,30,20
1715663389233,SIO 295S,A00,523232,Staff,10,0,30,20
1715663390263,SIOC 290S,A01,637330,Merrifield; Mark A,21,0,30,9
1715663391290,SIOC 291S,A01,637333,Gabriel; Corey John,21,0,30,9
1715663392315,SOCI 117,A01,494376,Staff,0,5,5,5
1715663393343,WES 237B,A00,494380,Staff,10,0,20,10
1715663395418,AESE 279B,A00,494370,Wade; Jon P,0,0,33,33
1715663396443,AIP 97,001,660915,Van Den Einde; Yael Dahlia,9998,0,9999,1
1715663397477,AIP 197,001,627712,Vespa; Emanuel Ignacio,9995,0,9999,4
1715663397477,AIP 197,002,650778,Amir; On,9998,0,9999,1
1715663397477,AIP 197,003,650933,Avenancio-Leon; Carlos,9998,0,9999,1
1715663397477,AIP 197,004,658530,Heyman; Gail D.,9998,0,9999,1
1715663397477,AIP 197,005,658631,Neal; Sonya E,9998,0,9999,1
1715663397477,AIP 197,006,658671,Du; Songzi,9998,0,9999,1
1715663398502,ANAR 135S,A00,494369,Braswell; Geoffrey E.,0,0,0,0
1715663399528,BENG 196,001,628496,Engler; Adam J.,9998,0,9999,1
1715663399528,BENG 196,002,660916,Watson; John Thomas,9998,0,9999,1
1715663400554,BISP 197,001,650773,Wilhelm; James E.,9994,0,9999,5
1715663400554,BISP 197,002,658904,Coleman; Aaron B.,9998,0,9999,1
1715663401589,CAT 124RS,A01,519847,Geibel; William,0,0,20,20
1715663402616,CAT 125RS,A01,515971,Geibel; William,0,0,20,20
1715663403646,CLRE 250,A00,511389,Morris; Sheldon,9992,0,9999,7
1715663404678,CLRE 251,A00,507176,Mehta; Ravindra L.,9992,0,9999,7
1715663404678,CLRE 251,B00,511410,Mehta; Ravindra L.,9998,0,9999,1
1715663405704,CLRE 252,A00,507189,Cuomo; Raphael Eduardo,9994,0,9999,5
1715663406729,CLRE 253,A00,507199,Vaida; Florin,9994,0,9999,5
1715663406729,CLRE 253,B00,507202,Vaida; Florin,9999,0,9999,0
1715663407754,CLRE 259,A00,507211,Patel; Hemal,9996,0,9999,3
1715663408781,CLRE 260,A00,507221,Cuomo; Raphael Eduardo,9999,0,9999,0
1715663409805,CLRE 297,001,507242,Cuomo; Raphael Eduardo,9999,0,9999,0
1715663410832,COGS 197,001,638244,Voytek; Bradley Thomas,9997,0,9999,2
1715663411864,CSE 191,A00,516875,Minnes Kemp; Mor Mia,9991,0,9999,8
1715663412891,CSE 197,001,637388,Minnes Kemp; Mor Mia,9992,0,9999,7
1715663413918,CSS 201S,A01,494383,Mignozzetti; Umberto,35,0,35,0
1715663414943,CSS 202S,A01,494387,Mignozzetti; Umberto,35,0,35,0
1715663415969,DSC 197,001,628532,Eldridge; Justin Matthew,9995,0,9999,4
1715663416995,EAP 100,A00,516065,Staff,9799,0,9999,200
1715663418022,ECE 45,A01,507414,Staff,32,0,60,28
1715663420070,ECE 111,A01,507420,Staff,11,0,50,39
1715663421096,ECE 197,001,548057,Sievenpiper; Daniel F.,9991,0,9999,8
1715663422126,EDS 115,A00,507243,Choi; Bailey Miyeon,6,0,28,22
1715663423151,EDS 117,A01,494379,Staff,0,6,34,35
1715663424180,EDS 125,A00,507246,Hopkins; Megan Beth,7,0,30,23
1715663425204,EDS 128A,A01,507264,Fargason; Sharon Gayle,5,0,26,21
1715663426228,EDS 128B,A01,507293,Pappas; Elizabeth,9,0,30,21
1715663427255,EDS 139,A00,507294,Fargason; Sharon Gayle,9,0,30,21
1715663427255,EDS 139,B00,507313,Pappas; Elizabeth,9,0,30,21
1715663428280,EDS 201,A00,507315,Staff,10,0,30,20
1715663429304,EDS 203,A01,507317,Halter; Christopher P.,10,0,30,20
1715663430329,EDS 204R,A01,507319,Halter; Christopher P.,0,3,30,30
1715663430329,EDS 204R,B01,507331,Heinzman; Erica M.,14,0,30,16
1715663431353,EDS 206R,A00,507332,Staff,0,4,30,30
1715663431353,EDS 206R,B00,507343,Staff,15,0,30,15
1715663432381,EDS 250,A00,507344,Hemans; Patricia Ann Benitez,20,0,40,20
1715663433408,EDS 281,A00,507345,Daly; Alan J.,18,0,18,0
1715663434434,EDS 284,A00,507350,Daly; Alan J.,16,0,16,0
1715663435461,EDS 286,A00,507359,Fine; Sarah,18,0,18,0
1715663436490,EDS 289C,A01,507361,Daly; Alan J.,18,0,18,0
1715663437514,EDS 290,A00,507366,Hofstetter; Carolyn,15,0,15,0
1715663438551,LIGM 5A,A00,507421,Fischer-Grunski; Eva K,17,0,20,3
1715663439582,LIGM 5B,A00,507423,Fischer-Grunski; Eva K,19,0,20,1
1715663440612,LIGM 5C,A00,507425,Fischer-Grunski; Eva K,19,0,20,1
1715663441641,LIIT 5AS,A00,507427,Carnelos; Chiara,20,0,20,0
1715663442669,LIIT 5BS,A00,507430,Carnelos; Chiara,20,0,20,0
1715663443696,LIIT 5CS,A00,507432,Carnelos; Chiara,20,0,20,0
1715663444723,LISP 5A,A00,507541,Munoz Sanchez; Alicia,11,0,20,9
1715663445749,LISP 5B,A00,507671,Munoz Sanchez; Alicia,8,0,20,12
1715663446774,LISP 5C,A00,507696,Munoz Sanchez; Alicia,7,0,20,13
1715663447802,MAE 197,001,528363,Boechler; Nicholas Sebastia,9998,0,9999,1
1715663448828,MATH 197,001,523477,Kedlaya; Kiran S.,9994,0,9999,5
1715663448828,MATH 197,002,563811,Zhang; Danna,9994,0,9999,5
1715663448828,MATH 197,003,628552,Dumitriu; Ioana,9998,0,9999,1
1715663448828,MATH 197,004,660885,Floyd; Eric,9998,0,9999,1
1715663449856,MCWP 40R,A00,518780,Staff,1,0,20,19
1715663449856,MCWP 40R,B00,518781,Carter; Jennifer A,9,0,20,11
1715663449856,MCWP 40R,C00,518783,Smith; Haydee Marie,5,0,20,15
1715663450886,MCWP 50R,A00,518791,Redela; Pamela Morgan,0,1,20,20
1715663450886,MCWP 50R,B00,518792,Krone; Jarret,0,2,20,20
1715663450886,MCWP 50R,C00,518793,Staff,0,4,20,20
1715663450886,MCWP 50R,D00,518794,Morshed; Michael James,0,2,20,20
1715663450886,MCWP 50R,E00,518795,Carter; Andrea L,0,2,20,20
1715663450886,MCWP 50R,F00,518796,Miller; Elizabeth Deen,0,1,20,20
1715663450886,MCWP 50R,G00,518797,Guillen; Melinda,0,1,20,20
1715663451911,MMW 12R,A01,514034,Herbst; Matthew,0,2,16,16
1715663451911,MMW 12R,A02,514035,Herbst; Matthew,0,0,16,16
1715663452937,MMW 13R,A01,514037,Staff,0,5,16,16
1715663452937,MMW 13R,A02,514039,Staff,0,5,16,16
1715663452937,MMW 13R,A03,628519,Staff,0,4,16,16
1715663454989,SIO 295LS,A00,523233,Staff,10,0,30,20
1715663456025,SIO 295S,A00,523232,Staff,10,0,30,20
1715663457051,SIOC 290S,A01,637330,Merrifield; Mark A,21,0,30,9
1715663458077,SIOC 291S,A01,637333,Gabriel; Corey John,21,0,30,9
1715663459102,SOCI 117,A01,494376,Staff,0,5,5,5
1715663460129,WES 237B,A00,494380,Staff,10,0,20,10
1715663462196,AESE 279B,A00,494370,Wade; Jon P,0,0,33,33
1715663463222,AIP 97,001,660915,Van Den Einde; Yael Dahlia,9998,0,9999,1
1715663464250,AIP 197,001,627712,Vespa; Emanuel Ignacio,9995,0,9999,4
1715663464250,AIP 197,002,650778,Amir; On,9998,0,9999,1
1715663464250,AIP 197,003,650933,Avenancio-Leon; Carlos,9998,0,9999,1
1715663464250,AIP 197,004,658530,Heyman; Gail D.,9998,0,9999,1
1715663464250,AIP 197,005,658631,Neal; Sonya E,9998,0,9999,1
1715663464250,AIP 197,006,658671,Du; Songzi,9998,0,9999,1
1715663465278,ANAR 135S,A00,494369,Braswell; Geoffrey E.,0,0,0,0
1715663466304,BENG 196,001,628496,Engler; Adam J.,9998,0,9999,1
1715663466304,BENG 196,002,660916,Watson; John Thomas,9998,0,9999,1
1715663467330,BISP 197,001,650773,Wilhelm; James E.,9994,0,9999,5
1715663467330,BISP 197,002,658904,Coleman; Aaron B.,9998,0,9999,1
1715663468357,CAT 124RS,A01,519847,Geibel; William,0,0,20,20
1715663469382,CAT 125RS,A01,515971,Geibel; William,0,0,20,20
1715663470413,CLRE 250,A00,511389,Morris; Sheldon,9992,0,9999,7
1715663471444,CLRE 251,A00,507176,Mehta; Ravindra L.,9992,0,9999,7
1715663471444,CLRE 251,B00,511410,Mehta; Ravindra L.,9998,0,9999,1
1715663472472,CLRE 252,A00,507189,Cuomo; Raphael Eduardo,9994,0,9999,5
1715663473552,CLRE 253,A00,507199,Vaida; Florin,9994,0,9999,5
1715663473552,CLRE 253,B00,507202,Vaida; Florin,9999,0,9999,0
1715663474580,CLRE 259,A00,507211,Patel; Hemal,9996,0,9999,3
1715663475607,CLRE 260,A00,507221,Cuomo; Raphael Eduardo,9999,0,9999,0
1715663476631,CLRE 297,001,507242,Cuomo; Raphael Eduardo,9999,0,9999,0
1715663477657,COGS 197,001,638244,Voytek; Bradley Thomas,9997,0,9999,2
1715663478683,CSE 191,A00,516875,Minnes Kemp; Mor Mia,9991,0,9999,8
1715663479708,CSE 197,001,637388,Minnes Kemp; Mor Mia,9992,0,9999,7
1715663480740,CSS 201S,A01,494383,Mignozzetti; Umberto,35,0,35,0
1715663481765,CSS 202S,A01,494387,Mignozzetti; Umberto,35,0,35,0
1715663482789,DSC 197,001,628532,Eldridge; Justin Matthew,9995,0,9999,4
1715663483814,EAP 100,A00,516065,Staff,9799,0,9999,200
1715663484840,ECE 45,A01,507414,Staff,32,0,60,28
1715663486892,ECE 111,A01,507420,Staff,11,0,50,39
1715663487920,ECE 197,001,548057,Sievenpiper; Daniel F.,9991,0,9999,8
1715663488949,EDS 115,A00,507243,Choi; Bailey Miyeon,6,0,28,22
1715663489975,EDS 117,A01,494379,Staff,0,6,34,35
1715663491000,EDS 125,A00,507246,Hopkins; Megan Beth,7,0,30,23
1715663492025,EDS 128A,A01,507264,Fargason; Sharon Gayle,5,0,26,21
1715663493056,EDS 128B,A01,507293,Pappas; Elizabeth,9,0,30,21
1715663494174,EDS 139,A00,507294,Fargason; Sharon Gayle,9,0,30,21
1715663494174,EDS 139,B00,507313,Pappas; Elizabeth,9,0,30,21
1715663495202,EDS 201,A00,507315,Staff,10,0,30,20
1715663496230,EDS 203,A01,507317,Halter; Christopher P.,10,0,30,20
1715663497258,EDS 204R,A01,507319,Halter; Christopher P.,0,3,30,30
1715663497258,EDS 204R,B01,507331,Heinzman; Erica M.,14,0,30,16
1715663498283,EDS 206R,A00,507332,Staff,0,4,30,30
1715663498283,EDS 206R,B00,507343,Staff,15,0,30,15
1715663499309,EDS 250,A00,507344,Hemans; Patricia Ann Benitez,20,0,40,20
1715663500335,EDS 281,A00,507345,Daly; Alan J.,18,0,18,0
1715663501362,EDS 284,A00,507350,Daly; Alan J.,16,0,16,0
1715663502388,EDS 286,A00,507359,Fine; Sarah,18,0,18,0
1715663503415,EDS 289C,A01,507361,Daly; Alan J.,18,0,18,0
1715663504442,EDS 290,A00,507366,Hofstetter; Carolyn,15,0,15,0
1715663505473,LIGM 5A,A00,507421,Fischer-Grunski; Eva K,17,0,20,3
1715663506501,LIGM 5B,A00,507423,Fischer-Grunski; Eva K,19,0,20,1
1715663507526,LIGM 5C,A00,507425,Fischer-Grunski; Eva K,19,0,20,1
1715663508555,LIIT 5AS,A00,507427,Carnelos; Chiara,20,0,20,0
1715663509581,LIIT 5BS,A00,507430,Carnelos; Chiara,20,0,20,0
1715663510609,LIIT 5CS,A00,507432,Carnelos; Chiara,20,0,20,0
1715663511636,LISP 5A,A00,507541,Munoz Sanchez; Alicia,11,0,20,9
1715663512664,LISP 5B,A00,507671,Munoz Sanchez; Alicia,8,0,20,12
1715663513688,LISP 5C,A00,507696,Munoz Sanchez; Alicia,7,0,20,13
1715663514713,MAE 197,001,528363,Boechler; Nicholas Sebastia,9998,0,9999,1
1715663515741,MATH 197,001,523477,Kedlaya; Kiran S.,9994,0,9999,5
1715663515741,MATH 197,002,563811,Zhang; Danna,9994,0,9999,5
1715663515741,MATH 197,003,628552,Dumitriu; Ioana,9998,0,9999,1
1715663515741,MATH 197,004,660885,Floyd; Eric,9998,0,9999,1
1715663516767,MCWP 40R,A00,518780,Staff,1,0,20,19
1715663516767,MCWP 40R,B00,518781,Carter; Jennifer A,9,0,20,11
1715663516767,MCWP 40R,C00,518783,Smith; Haydee Marie,5,0,20,15
1715663517795,MCWP 50R,A00,518791,Redela; Pamela Morgan,0,1,20,20
1715663517795,MCWP 50R,B00,518792,Krone; Jarret,0,2,20,20
1715663517795,MCWP 50R,C00,518793,Staff,0,4,20,20
1715663517795,MCWP 50R,D00,518794,Morshed; Michael James,0,2,20,20
1715663517795,MCWP 50R,E00,518795,Carter; Andrea L,0,2,20,20
1715663517795,MCWP 50R,F00,518796,Miller; Elizabeth Deen,0,1,20,20
1715663517795,MCWP 50R,G00,518797,Guillen; Melinda,0,1,20,20
1715663518822,MMW 12R,A01,514034,Herbst; Matthew,0,2,16,16
1715663518822,MMW 12R,A02,514035,Herbst; Matthew,0,0,16,16
1715663519850,MMW 13R,A01,514037,Staff,0,5,16,16
1715663519850,MMW 13R,A02,514039,Staff,0,5,16,16
1715663519850,MMW 13R,A03,628519,Staff,0,4,16,16
1715663521906,SIO 295LS,A00,523233,Staff,10,0,30,20
1715663522935,SIO 295S,A00,523232,Staff,10,0,30,20
1715663523965,SIOC 290S,A01,637330,Merrifield; Mark A,21,0,30,9
1715663524993,SIOC 291S,A01,637333,Gabriel; Corey John,21,0,30,9
1715663526018,SOCI 117,A01,494376,Staff,0,5,5,5
1715663527046,WES 237B,A00,494380,Staff,10,0,20,10
1715663529129,AESE 279B,A00,494370,Wade; Jon P,0,0,33,33
1715663530157,AIP 97,001,660915,Van Den Einde; Yael Dahlia,9998,0,9999,1
1715663531186,AIP 197,001,627712,Vespa; Emanuel Ignacio,9995,0,9999,4
1715663531186,AIP 197,002,650778,Amir; On,9998,0,9999,1
1715663531186,AIP 197,003,650933,Avenancio-Leon; Carlos,9998,0,9999,1
1715663531186,AIP 197,004,658530,Heyman; Gail D.,9998,0,9999,1
1715663531186,AIP 197,005,658631,Neal; Sonya E,9998,0,9999,1
1715663531186,AIP 197,006,658671,Du; Songzi,9998,0,9999,1
1715663532219,ANAR 135S,A00,494369,Braswell; Geoffrey E.,0,0,0,0
1715663533247,BENG 196,001,628496,Engler; Adam J.,9998,0,9999,1
1715663533247,BENG 196,002,660916,Watson; John Thomas,9998,0,9999,1
1715663534273,BISP 197,001,650773,Wilhelm; James E.,9994,0,9999,5
1715663534273,BISP 197,002,658904,Coleman; Aaron B.,9998,0,9999,1
1715663535297,CAT 124RS,A01,519847,Geibel; William,0,0,20,20
1715663536324,CAT 125RS,A01,515971,Geibel; William,0,0,20,20
1715663537353,CLRE 250,A00,511389,Morris; Sheldon,9992,0,9999,7
1715663538385,CLRE 251,A00,507176,Mehta; Ravindra L.,9992,0,9999,7
1715663538385,CLRE 251,B00,511410,Mehta; Ravindra L.,9998,0,9999,1
1715663539413,CLRE 252,A00,507189,Cuomo; Raphael Eduardo,9994,0,9999,5
1715663540438,CLRE 253,A00,507199,Vaida; Florin,9994,0,9999,5
1715663540438,CLRE 253,B00,507202,Vaida; Florin,9999,0,9999,0
1715663541465,CLRE 259,A00,507211,Patel; Hemal,9996,0,9999,3
1715663542490,CLRE 260,A00,507221,Cuomo; Raphael Eduardo,9999,0,9999,0
1715663543518,CLRE 297,001,507242,Cuomo; Raphael Eduardo,9999,0,9999,0
1715663544546,COGS 197,001,638244,Voytek; Bradley Thomas,9997,0,9999,2
1715663545571,CSE 191,A00,516875,Minnes Kemp; Mor Mia,9991,0,9999,8
1715663546599,CSE 197,001,637388,Minnes Kemp; Mor Mia,9992,0,9999,7
1715663547625,CSS 201S,A01,494383,Mignozzetti; Umberto,35,0,35,0
1715663548655,CSS 202S,A01,494387,Mignozzetti; Umberto,35,0,35,0
1715663549680,DSC 197,001,628532,Eldridge; Justin Matthew,9995,0,9999,4
1715663550708,EAP 100,A00,516065,Staff,9799,0,9999,200
1715663551734,ECE 45,A01,507414,Staff,32,0,60,28
1715663553789,ECE 111,A01,507420,Staff,11,0,50,39
1715663554817,ECE 197,001,548057,Sievenpiper; Daniel F.,9991,0,9999,8
1715663555844,EDS 115,A00,507243,Choi; Bailey Miyeon,6,0,28,22
1715663556875,EDS 117,A01,494379,Staff,0,6,34,35
1715663557901,EDS 125,A00,507246,Hopkins; Megan Beth,7,0,30,23
1715663558931,EDS 128A,A01,507264,Fargason; Sharon Gayle,5,0,26,21
1715663559961,EDS 128B,A01,507293,Pappas; Elizabeth,9,0,30,21
1715663560988,EDS 139,A00,507294,Fargason; Sharon Gayle,9,0,30,21
1715663560988,EDS 139,B00,507313,Pappas; Elizabeth,9,0,30,21
1715663562015,EDS 201,A00,507315,Staff,10,0,30,20
1715663563041,EDS 203,A01,507317,Halter; Christopher P.,10,0,30,20
1715663564070,EDS 204R,A01,507319,Halter; Christopher P.,0,3,30,30
1715663564070,EDS 204R,B01,507331,Heinzman; Erica M.,14,0,30,16
1715663565100,EDS 206R,A00,507332,Staff,0,4,30,30
1715663565100,EDS 206R,B00,507343,Staff,15,0,30,15
1715663566126,EDS 250,A00,507344,Hemans; Patricia Ann Benitez,20,0,40,20
1715663567154,EDS 281,A00,507345,Daly; Alan J.,18,0,18,0
1715663568178,EDS 284,A00,507350,Daly; Alan J.,16,0,16,0
1715663569203,EDS 286,A00,507359,Fine; Sarah,18,0,18,0
1715663570228,EDS 289C,A01,507361,Daly; Alan J.,18,0,18,0
1715663571254,EDS 290,A00,507366,Hofstetter; Carolyn,15,0,15,0
1715663572278,LIGM 5A,A00,507421,Fischer-Grunski; Eva K,17,0,20,3
1715663573310,LIGM 5B,A00,507423,Fischer-Grunski; Eva K,19,0,20,1
1715663574335,LIGM 5C,A00,507425,Fischer-Grunski; Eva K,19,0,20,1
1715663575361,LIIT 5AS,A00,507427,Carnelos; Chiara,20,0,20,0
1715663576386,LIIT 5BS,A00,507430,Carnelos; Chiara,20,0,20,0
1715663577468,LIIT 5CS,A00,507432,Carnelos; Chiara,20,0,20,0
1715663578495,LISP 5A,A00,507541,Munoz Sanchez; Alicia,11,0,20,9
1715663579523,LISP 5B,A00,507671,Munoz Sanchez; Alicia,8,0,20,12
1715663580550,LISP 5C,A00,507696,Munoz Sanchez; Alicia,7,0,20,13
1715663581582,MAE 197,001,528363,Boechler; Nicholas Sebastia,9998,0,9999,1
1715663582615,MATH 197,001,523477,Kedlaya; Kiran S.,9994,0,9999,5
1715663582615,MATH 197,002,563811,Zhang; Danna,9994,0,9999,5
1715663582615,MATH 197,003,628552,Dumitriu; Ioana,9998,0,9999,1
1715663582615,MATH 197,004,660885,Floyd; Eric,9998,0,9999,1
1715663583645,MCWP 40R,A00,518780,Staff,1,0,20,19
1715663583645,MCWP 40R,B00,518781,Carter; Jennifer A,9,0,20,11
1715663583645,MCWP 40R,C00,518783,Smith; Haydee Marie,5,0,20,15
1715663584675,MCWP 50R,A00,518791,Redela; Pamela Morgan,0,1,20,20
1715663584675,MCWP 50R,B00,518792,Krone; Jarret,0,2,20,20
1715663584675,MCWP 50R,C00,518793,Staff,0,4,20,20
1715663584675,MCWP 50R,D00,518794,Morshed; Michael James,0,2,20,20
1715663584675,MCWP 50R,E00,518795,Carter; Andrea L,0,2,20,20
1715663584675,MCWP 50R,F00,518796,Miller; Elizabeth Deen,0,1,20,20
1715663584675,MCWP 50R,G00,518797,Guillen; Melinda,0,1,20,20
1715663585701,MMW 12R,A01,514034,Herbst; Matthew,0,2,16,16
1715663585701,MMW 12R,A02,514035,Herbst; Matthew,0,0,16,16
1715663586730,MMW 13R,A01,514037,Staff,0,5,16,16
1715663586730,MMW 13R,A02,514039,Staff,0,5,16,16
1715663586730,MMW 13R,A03,628519,Staff,0,4,16,16
1715663588782,SIO 295LS,A00,523233,Staff,10,0,30,20
1715663589808,SIO 295S,A00,523232,Staff,10,0,30,20
1715663590837,SIOC 290S,A01,637330,Merrifield; Mark A,21,0,30,9
1715663591866,SIOC 291S,A01,637333,Gabriel; Corey John,21,0,30,9
1715663592894,SOCI 117,A01,494376,Staff,0,5,5,5
1715663593918,WES 237B,A00,494380,Staff,10,0,20,10
1715663596004,AESE 279B,A00,494370,Wade; Jon P,0,0,33,33
1715663597030,AIP 97,001,660915,Van Den Einde; Yael Dahlia,9998,0,9999,1
1715663598059,AIP 197,001,627712,Vespa; Emanuel Ignacio,9995,0,9999,4
1715663598059,AIP 197,002,650778,Amir; On,9998,0,9999,1
1715663598059,AIP 197,003,650933,Avenancio-Leon; Carlos,9998,0,9999,1
1715663598059,AIP 197,004,658530,Heyman; Gail D.,9998,0,9999,1
1715663598059,AIP 197,005,658631,Neal; Sonya E,9998,0,9999,1
1715663598059,AIP 197,006,658671,Du; Songzi,9998,0,9999,1
1715663599085,ANAR 135S,A00,494369,Braswell; Geoffrey E.,0,0,0,0
1715663600113,BENG 196,001,628496,Engler; Adam J.,9998,0,9999,1
1715663600113,BENG 196,002,660916,Watson; John Thomas,9998,0,9999,1
1715663601141,BISP 197,001,650773,Wilhelm; James E.,9994,0,9999,5
1715663601141,BISP 197,002,658904,Coleman; Aaron B.,9998,0,9999,1
1715663602170,CAT 124RS,A01,519847,Geibel; William,0,0,20,20
1715663603195,CAT 125RS,A01,515971,Geibel; William,0,0,20,20
1715663604224,CLRE 250,A00,511389,Morris; Sheldon,9992,0,9999,7
1715663605251,CLRE 251,A00,507176,Mehta; Ravindra L.,9992,0,9999,7
1715663605251,CLRE 251,B00,511410,Mehta; Ravindra L.,9998,0,9999,1
1715663606283,CLRE 252,A00,507189,Cuomo; Raphael Eduardo,9994,0,9999,5
1715663607312,CLRE 253,A00,507199,Vaida; Florin,9994,0,9999,5
1715663607312,CLRE 253,B00,507202,Vaida; Florin,9999,0,9999,0
1715663608344,CLRE 259,A00,507211,Patel; Hemal,9996,0,9999,3
1715663609369,CLRE 260,A00,507221,Cuomo; Raphael Eduardo,9999,0,9999,0
1715663610396,CLRE 297,001,507242,Cuomo; Raphael Eduardo,9999,0,9999,0
1715663611424,COGS 197,001,638244,Voytek; Bradley Thomas,9997,0,9999,2
1715663612451,CSE 191,A00,516875,Minnes Kemp; Mor Mia,9991,0,9999,8
1715663613479,CSE 197,001,637388,Minnes Kemp; Mor Mia,9992,0,9999,7
1715663614507,CSS 201S,A01,494383,Mignozzetti; Umberto,35,0,35,0
1715663615532,CSS 202S,A01,494387,Mignozzetti; Umberto,35,0,35,0
1715663616558,DSC 197,001,628532,Eldridge; Justin Matthew,9995,0,9999,4
1715663617584,EAP 100,A00,516065,Staff,9799,0,9999,200
1715663618615,ECE 45,A01,507414,Staff,32,0,60,28
1715663620670,ECE 111,A01,507420,Staff,11,0,50,39
1715663621696,ECE 197,001,548057,Sievenpiper; Daniel F.,9991,0,9999,8
1715663622723,EDS 115,A00,507243,Choi; Bailey Miyeon,6,0,28,22
1715663623746,EDS 117,A01,494379,Staff,0,6,34,35
1715663624774,EDS 125,A00,507246,Hopkins; Megan Beth,7,0,30,23
1715663625800,EDS 128A,A01,507264,Fargason; Sharon Gayle,5,0,26,21
1715663626828,EDS 128B,A01,507293,Pappas; Elizabeth,9,0,30,21
1715663627855,EDS 139,A00,507294,Fargason; Sharon Gayle,9,0,30,21
1715663627855,EDS 139,B00,507313,Pappas; Elizabeth,9,0,30,21
1715663628883,EDS 201,A00,507315,Staff,10,0,30,20
1715663629912,EDS 203,A01,507317,Halter; Christopher P.,10,0,30,20
1715663630940,EDS 204R,A01,507319,Halter; Christopher P.,0,3,30,30
1715663630940,EDS 204R,B01,507331,Heinzman; Erica M.,14,0,30,16
1715663631966,EDS 206R,A00,507332,Staff,0,4,30,30
1715663631966,EDS 206R,B00,507343,Staff,15,0,30,15
1715663632990,EDS 250,A00,507344,Hemans; Patricia Ann Benitez,20,0,40,20
1715663634016,EDS 281,A00,507345,Daly; Alan J.,18,0,18,0
1715663635043,EDS 284,A00,507350,Daly; Alan J.,16,0,16,0
1715663636068,EDS 286,A00,507359,Fine; Sarah,18,0,18,0
1715663637096,EDS 289C,A01,507361,Daly; Alan J.,18,0,18,0
1715663638123,EDS 290,A00,507366,Hofstetter; Carolyn,15,0,15,0
1715663639150,LIGM 5A,A00,507421,Fischer-Grunski; Eva K,17,0,20,3
1715663640176,LIGM 5B,A00,507423,Fischer-Grunski; Eva K,19,0,20,1
1715663641200,LIGM 5C,A00,507425,Fischer-Grunski; Eva K,19,0,20,1
1715663642226,LIIT 5AS,A00,507427,Carnelos; Chiara,20,0,20,0
1715663643252,LIIT 5BS,A00,507430,Carnelos; Chiara,20,0,20,0
1715663644277,LIIT 5CS,A00,507432,Carnelos; Chiara,20,0,20,0
1715663645312,LISP 5A,A00,507541,Munoz Sanchez; Alicia,11,0,20,9
1715663646337,LISP 5B,A00,507671,Munoz Sanchez; Alicia,8,0,20,12
1715663647366,LISP 5C,A00,507696,Munoz Sanchez; Alicia,7,0,20,13
1715663648396,MAE 197,001,528363,Boechler; Nicholas Sebastia,9998,0,9999,1
1715663649424,MATH 197,001,523477,Kedlaya; Kiran S.,9994,0,9999,5
1715663649424,MATH 197,002,563811,Zhang; Danna,9994,0,9999,5
1715663649424,MATH 197,003,628552,Dumitriu; Ioana,9998,0,9999,1
1715663649424,MATH 197,004,660885,Floyd; Eric,9998,0,9999,1
1715663650451,MCWP 40R,A00,518780,Staff,1,0,20,19
1715663650451,MCWP 40R,B00,518781,Carter; Jennifer A,9,0,20,11
1715663650451,MCWP 40R,C00,518783,Smith; Haydee Marie,5,0,20,15
1715663651479,MCWP 50R,A00,518791,Redela; Pamela Morgan,0,1,20,20
1715663651479,MCWP 50R,B00,518792,Krone; Jarret,0,2,20,20
1715663651479,MCWP 50R,C00,518793,Staff,0,4,20,20
1715663651479,MCWP 50R,D00,518794,Morshed; Michael James,0,2,20,20
1715663651479,MCWP 50R,E00,518795,Carter; Andrea L,0,2,20,20
1715663651479,MCWP 50R,F00,518796,Miller; Elizabeth Deen,0,1,20,20
1715663651479,MCWP 50R,G00,518797,Guillen; Melinda,0,1,20,20
1715663652505,MMW 12R,A01,514034,Herbst; Matthew,0,2,16,16
1715663652505,MMW 12R,A02,514035,Herbst; Matthew,0,0,16,16
1715663653530,MMW 13R,A01,514037,Staff,0,5,16,16
1715663653530,MMW 13R,A02,514039,Staff,0,5,16,16
1715663653530,MMW 13R,A03,628519,Staff,0,4,16,16
1715663655586,SIO 295LS,A00,523233,Staff,10,0,30,20
1715663656614,SIO 295S,A00,523232,Staff,10,0,30,20
1715663657641,SIOC 290S,A01,637330,Merrifield; Mark A,21,0,30,9
1715663658668,SIOC 291S,A01,637333,Gabriel; Corey John,21,0,30,9
1715663659693,SOCI 117,A01,494376,Staff,0,5,5,5
1715663660721,WES 237B,A00,494380,Staff,10,0,20,10
1715663662801,AESE 279B,A00,494370,Wade; Jon P,0,0,33,33
1715663663826,AIP 97,001,660915,Van Den Einde; Yael Dahlia,9998,0,9999,1
1715663664855,AIP 197,001,627712,Vespa; Emanuel Ignacio,9995,0,9999,4
1715663664855,AIP 197,002,650778,Amir; On,9998,0,9999,1
1715663664855,AIP 197,003,650933,Avenancio-Leon; Carlos,9998,0,9999,1
1715663664855,AIP 197,004,658530,Heyman; Gail D.,9998,0,9999,1
1715663664855,AIP 197,005,658631,Neal; Sonya E,9998,0,9999,1
1715663664855,AIP 197,006,658671,Du; Songzi,9998,0,9999,1
1715663665882,ANAR 135S,A00,494369,Braswell; Geoffrey E.,0,0,0,0
1715663666913,BENG 196,001,628496,Engler; Adam J.,9998,0,9999,1
1715663666913,BENG 196,002,660916,Watson; John Thomas,9998,0,9999,1
1715663667940,BISP 197,001,650773,Wilhelm; James E.,9994,0,9999,5
1715663667940,BISP 197,002,658904,Coleman; Aaron B.,9998,0,9999,1
1715663668967,CAT 124RS,A01,519847,Geibel; William,0,0,20,20
1715663669992,CAT 125RS,A01,515971,Geibel; William,0,0,20,20
1715663671017,CLRE 250,A00,511389,Morris; Sheldon,9992,0,9999,7
1715663672051,CLRE 251,A00,507176,Mehta; Ravindra L.,9992,0,9999,7
1715663672051,CLRE 251,B00,511410,Mehta; Ravindra L.,9998,0,9999,1
1715663673080,CLRE 252,A00,507189,Cuomo; Raphael Eduardo,9994,0,9999,5
1715663674106,CLRE 253,A00,507199,Vaida; Florin,9994,0,9999,5
1715663674106,CLRE 253,B00,507202,Vaida; Florin,9999,0,9999,0
1715663675136,CLRE 259,A00,507211,Patel; Hemal,9996,0,9999,3
1715663676164,CLRE 260,A00,507221,Cuomo; Raphael Eduardo,9999,0,9999,0
1715663677193,CLRE 297,001,507242,Cuomo; Raphael Eduardo,9999,0,9999,0
1715663678222,COGS 197,001,638244,Voytek; Bradley Thomas,9997,0,9999,2
1715663679250,CSE 191,A00,516875,Minnes Kemp; Mor Mia,9991,0,9999,8
1715663680280,CSE 197,001,637388,Minnes Kemp; Mor Mia,9992,0,9999,7
1715663681361,CSS 201S,A01,494383,Mignozzetti; Umberto,35,0,35,0
1715663682385,CSS 202S,A01,494387,Mignozzetti; Umberto,35,0,35,0
1715663683414,DSC 197,001,628532,Eldridge; Justin Matthew,9995,0,9999,4
1715663684441,EAP 100,A00,516065,Staff,9799,0,9999,200
1715663685468,ECE 45,A01,507414,Staff,32,0,60,28
1715663687520,ECE 111,A01,507420,Staff,11,0,50,39
1715663688545,ECE 197,001,548057,Sievenpiper; Daniel F.,9991,0,9999,8
1715663689574,EDS 115,A00,507243,Choi; Bailey Miyeon,6,0,28,22
1715663690600,EDS 117,A01,494379,Staff,0,6,34,35
1715663691626,EDS 125,A00,507246,Hopkins; Megan Beth,7,0,30,23
1715663692653,EDS 128A,A01,507264,Fargason; Sharon Gayle,5,0,26,21
1715663693678,EDS 128B,A01,507293,Pappas; Elizabeth,9,0,30,21
1715663694704,EDS 139,A00,507294,Fargason; Sharon Gayle,9,0,30,21
1715663694704,EDS 139,B00,507313,Pappas; Elizabeth,9,0,30,21
1715663695729,EDS 201,A00,507315,Staff,10,0,30,20
1715663696755,EDS 203,A01,507317,Halter; Christopher P.,10,0,30,20
1715663697778,EDS 204R,A01,507319,Halter; Christopher P.,0,3,30,30
1715663697778,EDS 204R,B01,507331,Heinzman; Erica M.,14,0,30,16
1715663698803,EDS 206R,A00,507332,Staff,0,4,30,30
1715663698803,EDS 206R,B00,507343,Staff,15,0,30,15
1715663699828,EDS 250,A00,507344,Hemans; Patricia Ann Benitez,20,0,40,20
1715663700856,EDS 281,A00,507345,Daly; Alan J.,18,0,18,0
1715663701885,EDS 284,A00,507350,Daly; Alan J.,16,0,16,0
1715663702909,EDS 286,A00,507359,Fine; Sarah,18,0,18,0
1715663703933,EDS 289C,A01,507361,Daly; Alan J.,18,0,18,0
1715663704959,EDS 290,A00,507366,Hofstetter; Carolyn,15,0,15,0
1715663705984,LIGM 5A,A00,507421,Fischer-Grunski; Eva K,17,0,20,3
1715663707013,LIGM 5B,A00,507423,Fischer-Grunski; Eva K,19,0,20,1
1715663708038,LIGM 5C,A00,507425,Fischer-Grunski; Eva K,19,0,20,1
1715663709064,LIIT 5AS,A00,507427,Carnelos; Chiara,20,0,20,0
1715663710094,LIIT 5BS,A00,507430,Carnelos; Chiara,20,0,20,0
1715663711119,LIIT 5CS,A00,507432,Carnelos; Chiara,20,0,20,0
1715663712145,LISP 5A,A00,507541,Munoz Sanchez; Alicia,11,0,20,9
1715663713174,LISP 5B,A00,507671,Munoz Sanchez; Alicia,8,0,20,12
1715663714199,LISP 5C,A00,507696,Munoz Sanchez; Alicia,7,0,20,13
1715663715224,MAE 197,001,528363,Boechler; Nicholas Sebastia,9998,0,9999,1
1715663716256,MATH 197,001,523477,Kedlaya; Kiran S.,9994,0,9999,5
1715663716256,MATH 197,002,563811,Zhang; Danna,9994,0,9999,5
1715663716256,MATH 197,003,628552,Dumitriu; Ioana,9998,0,9999,1
1715663716256,MATH 197,004,660885,Floyd; Eric,9998,0,9999,1
1715663717282,MCWP 40R,A00,518780,Staff,1,0,20,19
1715663717282,MCWP 40R,B00,518781,Carter; Jennifer A,9,0,20,11
1715663717282,MCWP 40R,C00,518783,Smith; Haydee Marie,5,0,20,15
1715663718310,MCWP 50R,A00,518791,Redela; Pamela Morgan,0,1,20,20
1715663718310,MCWP 50R,B00,518792,Krone; Jarret,0,2,20,20
1715663718310,MCWP 50R,C00,518793,Staff,0,4,20,20
1715663718310,MCWP 50R,D00,518794,Morshed; Michael James,0,2,20,20
1715663718310,MCWP 50R,E00,518795,Carter; Andrea L,0,2,20,20
1715663718310,MCWP 50R,F00,518796,Miller; Elizabeth Deen,0,1,20,20
1715663718310,MCWP 50R,G00,518797,Guillen; Melinda,0,1,20,20
1715663719335,MMW 12R,A01,514034,Herbst; Matthew,0,2,16,16
1715663719335,MMW 12R,A02,514035,Herbst; Matthew,0,0,16,16
1715663720360,MMW 13R,A01,514037,Staff,0,5,16,16
1715663720360,MMW 13R,A02,514039,Staff,0,5,16,16
1715663720360,MMW 13R,A03,628519,Staff,0,4,16,16
1715663722413,SIO 295LS,A00,523233,Staff,10,0,30,20
1715663723440,SIO 295S,A00,523232,Staff,10,0,30,20
1715663724467,SIOC 290S,A01,637330,Merrifield; Mark A,21,0,30,9
1715663725497,SIOC 291S,A01,637333,Gabriel; Corey John,21,0,30,9
1715663726521,SOCI 117,A01,494376,Staff,0,5,5,5
1715663727548,WES 237B,A00,494380,Staff,10,0,20,10
1715663729619,AESE 279B,A00,494370,Wade; Jon P,0,0,33,33
1715663730644,AIP 97,001,660915,Van Den Einde; Yael Dahlia,9998,0,9999,1
1715663731670,AIP 197,001,627712,Vespa; Emanuel Ignacio,9995,0,9999,4
1715663731670,AIP 197,002,650778,Amir; On,9998,0,9999,1
1715663731670,AIP 197,003,650933,Avenancio-Leon; Carlos,9998,0,9999,1
1715663731670,AIP 197,004,658530,Heyman; Gail D.,9998,0,9999,1
1715663731670,AIP 197,005,658631,Neal; Sonya E,9998,0,9999,1
1715663731670,AIP 197,006,658671,Du; Songzi,9998,0,9999,1
1715663732696,ANAR 135S,A00,494369,Braswell; Geoffrey E.,0,0,0,0
1715663733725,BENG 196,001,628496,Engler; Adam J.,9998,0,9999,1
1715663733725,BENG 196,002,660916,Watson; John Thomas,9998,0,9999,1
1715663734749,BISP 197,001,650773,Wilhelm; James E.,9994,0,9999,5
1715663734749,BISP 197,002,658904,Coleman; Aaron B.,9998,0,9999,1
1715663735776,CAT 124RS,A01,519847,Geibel; William,0,0,20,20
1715663736801,CAT 125RS,A01,515971,Geibel; William,0,0,20,20
1715663737825,CLRE 250,A00,511389,Morris; Sheldon,9992,0,9999,7
1715663738855,CLRE 251,A00,507176,Mehta; Ravindra L.,9992,0,9999,7
1715663738855,CLRE 251,B00,511410,Mehta; Ravindra L.,9998,0,9999,1
1715663739880,CLRE 252,A00,507189,Cuomo; Raphael Eduardo,9994,0,9999,5
1715663740906,CLRE 253,A00,507199,Vaida; Florin,9994,0,9999,5
1715663740906,CLRE 253,B00,507202,Vaida; Florin,9999,0,9999,0
1715663741933,CLRE 259,A00,507211,Patel; Hemal,9996,0,9999,3
1715663742961,CLRE 260,A00,507221,Cuomo; Raphael Eduardo,9999,0,9999,0
1715663743984,CLRE 297,001,507242,Cuomo; Raphael Eduardo,9999,0,9999,0
1715663745013,COGS 197,001,638244,Voytek; Bradley Thomas,9997,0,9999,2
1715663746039,CSE 191,A00,516875,Minnes Kemp; Mor Mia,9991,0,9999,8
1715663747067,CSE 197,001,637388,Minnes Kemp; Mor Mia,9992,0,9999,7
1715663748094,CSS 201S,A01,494383,Mignozzetti; Umberto,35,0,35,0
1715663749121,CSS 202S,A01,494387,Mignozzetti; Umberto,35,0,35,0
1715663750149,DSC 197,001,628532,Eldridge; Justin Matthew,9995,0,9999,4
1715663751179,EAP 100,A00,516065,Staff,9799,0,9999,200
1715663752212,ECE 45,A01,507414,Staff,32,0,60,28
1715663754263,ECE 111,A01,507420,Staff,11,0,50,39
1715663755292,ECE 197,001,548057,Sievenpiper; Daniel F.,9991,0,9999,8
1715663756319,EDS 115,A00,507243,Choi; Bailey Miyeon,6,0,28,22
1715663757345,EDS 117,A01,494379,Staff,0,6,34,35
1715663758371,EDS 125,A00,507246,Hopkins; Megan Beth,7,0,30,23
1715663759399,EDS 128A,A01,507264,Fargason; Sharon Gayle,5,0,26,21
1715663760430,EDS 128B,A01,507293,Pappas; Elizabeth,9,0,30,21
1715663761456,EDS 139,A00,507294,Fargason; Sharon Gayle,9,0,30,21
1715663761456,EDS 139,B00,507313,Pappas; Elizabeth,9,0,30,21
1715663762481,EDS 201,A00,507315,Staff,10,0,30,20
1715663763507,EDS 203,A01,507317,Halter; Christopher P.,10,0,30,20
1715663764535,EDS 204R,A01,507319,Halter; Christopher P.,0,3,30,30
1715663764535,EDS 204R,B01,507331,Heinzman; Erica M.,14,0,30,16
1715663765560,EDS 206R,A00,507332,Staff,0,4,30,30
1715663765560,EDS 206R,B00,507343,Staff,15,0,30,15
1715663766585,EDS 250,A00,507344,Hemans; Patricia Ann Benitez,20,0,40,20
1715663767610,EDS 281,A00,507345,Daly; Alan J.,18,0,18,0
1715663768634,EDS 284,A00,507350,Daly; Alan J.,16,0,16,0
1715663769660,EDS 286,A00,507359,Fine; Sarah,18,0,18,0
1715663770685,EDS 289C,A01,507361,Daly; Alan J.,18,0,18,0
1715663771709,EDS 290,A00,507366,Hofstetter; Carolyn,15,0,15,0
1715663772737,LIGM 5A,A00,507421,Fischer-Grunski; Eva K,17,0,20,3
1715663773763,LIGM 5B,A00,507423,Fischer-Grunski; Eva K,19,0,20,1
1715663774789,LIGM 5C,A00,507425,Fischer-Grunski; Eva K,19,0,20,1
1715663775815,LIIT 5AS,A00,507427,Carnelos; Chiara,20,0,20,0
1715663776850,LIIT 5BS,A00,507430,Carnelos; Chiara,20,0,20,0
1715663777876,LIIT 5CS,A00,507432,Carnelos; Chiara,20,0,20,0
1715663778902,LISP 5A,A00,507541,Munoz Sanchez; Alicia,11,0,20,9
1715663779925,LISP 5B,A00,507671,Munoz Sanchez; Alicia,8,0,20,12
1715663780951,LISP 5C,A00,507696,Munoz Sanchez; Alicia,7,0,20,13
1715663781980,MAE 197,001,528363,Boechler; Nicholas Sebastia,9998,0,9999,1
1715663783005,MATH 197,001,523477,Kedlaya; Kiran S.,9994,0,9999,5
1715663783005,MATH 197,002,563811,Zhang; Danna,9994,0,9999,5
1715663783005,MATH 197,003,628552,Dumitriu; Ioana,9998,0,9999,1
1715663783005,MATH 197,004,660885,Floyd; Eric,9998,0,9999,1
1715663784037,MCWP 40R,A00,518780,Staff,1,0,20,19
1715663784037,MCWP 40R,B00,518781,Carter; Jennifer A,9,0,20,11
1715663784037,MCWP 40R,C00,518783,Smith; Haydee Marie,5,0,20,15
1715663785118,MCWP 50R,A00,518791,Redela; Pamela Morgan,0,1,20,20
1715663785118,MCWP 50R,B00,518792,Krone; Jarret,0,2,20,20
1715663785118,MCWP 50R,C00,518793,Staff,0,4,20,20
1715663785118,MCWP 50R,D00,518794,Morshed; Michael James,0,2,20,20
1715663785118,MCWP 50R,E00,518795,Carter; Andrea L,0,2,20,20
1715663785118,MCWP 50R,F00,518796,Miller; Elizabeth Deen,0,1,20,20
1715663785118,MCWP 50R,G00,518797,Guillen; Melinda,0,1,20,20
1715663786148,MMW 12R,A01,514034,Herbst; Matthew,0,2,16,16
1715663786148,MMW 12R,A02,514035,Herbst; Matthew,0,0,16,16
1715663787172,MMW 13R,A01,514037,Staff,0,5,16,16
1715663787172,MMW 13R,A02,514039,Staff,0,5,16,16
1715663787172,MMW 13R,A03,628519,Staff,0,4,16,16
1715663789229,SIO 295LS,A00,523233,Staff,10,0,30,20
1715663790256,SIO 295S,A00,523232,Staff,10,0,30,20
1715663791284,SIOC 290S,A01,637330,Merrifield; Mark A,21,0,30,9
1715663792315,SIOC 291S,A01,637333,Gabriel; Corey John,21,0,30,9
1715663793339,SOCI 117,A01,494376,Staff,0,5,5,5
1715663794368,WES 237B,A00,494380,Staff,10,0,20,10
1715663796438,AESE 279B,A00,494370,Wade; Jon P,0,0,33,33
1715663797465,AIP 97,001,660915,Van Den Einde; Yael Dahlia,9998,0,9999,1
1715663798502,AIP 197,001,627712,Vespa; Emanuel Ignacio,9995,0,9999,4
1715663798502,AIP 197,002,650778,Amir; On,9998,0,9999,1
1715663798502,AIP 197,003,650933,Avenancio-Leon; Carlos,9998,0,9999,1
1715663798502,AIP 197,004,658530,Heyman; Gail D.,9998,0,9999,1
1715663798502,AIP 197,005,658631,Neal; Sonya E,9998,0,9999,1
1715663798502,AIP 197,006,658671,Du; Songzi,9998,0,9999,1
1715663799532,ANAR 135S,A00,494369,Braswell; Geoffrey E.,0,0,0,0
1715663800560,BENG 196,001,628496,Engler; Adam J.,9998,0,9999,1
1715663800560,BENG 196,002,660916,Watson; John Thomas,9998,0,9999,1
1715663801585,BISP 197,001,650773,Wilhelm; James E.,9994,0,9999,5
1715663801585,BISP 197,002,658904,Coleman; Aaron B.,9998,0,9999,1
1715663802612,CAT 124RS,A01,519847,Geibel; William,0,0,20,20
1715663803638,CAT 125RS,A01,515971,Geibel; William,0,0,20,20
1715663804665,CLRE 250,A00,511389,Morris; Sheldon,9992,0,9999,7
1715663805692,CLRE 251,A00,507176,Mehta; Ravindra L.,9992,0,9999,7
1715663805692,CLRE 251,B00,511410,Mehta; Ravindra L.,9998,0,9999,1
1715663806720,CLRE 252,A00,507189,Cuomo; Raphael Eduardo,9994,0,9999,5
1715663807746,CLRE 253,A00,507199,Vaida; Florin,9994,0,9999,5
1715663807746,CLRE 253,B00,507202,Vaida; Florin,9999,0,9999,0
1715663808771,CLRE 259,A00,507211,Patel; Hemal,9996,0,9999,3
1715663809794,CLRE 260,A00,507221,Cuomo; Raphael Eduardo,9999,0,9999,0
1715663810819,CLRE 297,001,507242,Cuomo; Raphael Eduardo,9999,0,9999,0
1715663811845,COGS 197,001,638244,Voytek; Bradley Thomas,9997,0,9999,2
1715663812871,CSE 191,A00,516875,Minnes Kemp; Mor Mia,9991,0,9999,8
1715663813901,CSE 197,001,637388,Minnes Kemp; Mor Mia,9992,0,9999,7
1715663814927,CSS 201S,A01,494383,Mignozzetti; Umberto,35,0,35,0
1715663815953,CSS 202S,A01,494387,Mignozzetti; Umberto,35,0,35,0
1715663816980,DSC 197,001,628532,Eldridge; Justin Matthew,9995,0,9999,4
1715663818006,EAP 100,A00,516065,Staff,9799,0,9999,200
1715663819032,ECE 45,A01,507414,Staff,32,0,60,28
1715663821089,ECE 111,A01,507420,Staff,11,0,50,39
1715663822116,ECE 197,001,548057,Sievenpiper; Daniel F.,9991,0,9999,8
1715663823143,EDS 115,A00,507243,Choi; Bailey Miyeon,6,0,28,22
1715663824172,EDS 117,A01,494379,Staff,0,6,34,35
1715663825201,EDS 125,A00,507246,Hopkins; Megan Beth,7,0,30,23
1715663826226,EDS 128A,A01,507264,Fargason; Sharon Gayle,5,0,26,21
1715663827250,EDS 128B,A01,507293,Pappas; Elizabeth,9,0,30,21
1715663828281,EDS 139,A00,507294,Fargason; Sharon Gayle,9,0,30,21
1715663828281,EDS 139,B00,507313,Pappas; Elizabeth,9,0,30,21
1715663829305,EDS 201,A00,507315,Staff,10,0,30,20
1715663830330,EDS 203,A01,507317,Halter; Christopher P.,10,0,30,20
1715663831355,EDS 204R,A01,507319,Halter; Christopher P.,0,3,30,30
1715663831355,EDS 204R,B01,507331,Heinzman; Erica M.,14,0,30,16
1715663832381,EDS 206R,A00,507332,Staff,0,4,30,30
1715663832381,EDS 206R,B00,507343,Staff,15,0,30,15
1715663833405,EDS 250,A00,507344,Hemans; Patricia Ann Benitez,20,0,40,20
1715663834429,EDS 281,A00,507345,Daly; Alan J.,18,0,18,0
1715663835456,EDS 284,A00,507350,Daly; Alan J.,16,0,16,0
1715663836576,EDS 286,A00,507359,Fine; Sarah,18,0,18,0
1715663837603,EDS 289C,A01,507361,Daly; Alan J.,18,0,18,0
1715663838626,EDS 290,A00,507366,Hofstetter; Carolyn,15,0,15,0
1715663839656,LIGM 5A,A00,507421,Fischer-Grunski; Eva K,17,0,20,3
1715663840679,LIGM 5B,A00,507423,Fischer-Grunski; Eva K,19,0,20,1
1715663841703,LIGM 5C,A00,507425,Fischer-Grunski; Eva K,19,0,20,1
1715663842728,LIIT 5AS,A00,507427,Carnelos; Chiara,20,0,20,0
1715663843753,LIIT 5BS,A00,507430,Carnelos; Chiara,20,0,20,0
1715663844779,LIIT 5CS,A00,507432,Carnelos; Chiara,20,0,20,0
1715663845810,LISP 5A,A00,507541,Munoz Sanchez; Alicia,11,0,20,9
1715663846835,LISP 5B,A00,507671,Munoz Sanchez; Alicia,8,0,20,12
1715663847865,LISP 5C,A00,507696,Munoz Sanchez; Alicia,7,0,20,13
1715663848891,MAE 197,001,528363,Boechler; Nicholas Sebastia,9998,0,9999,1
1715663849922,MATH 197,001,523477,Kedlaya; Kiran S.,9994,0,9999,5
1715663849922,MATH 197,002,563811,Zhang; Danna,9994,0,9999,5
1715663849922,MATH 197,003,628552,Dumitriu; Ioana,9998,0,9999,1
1715663849922,MATH 197,004,660885,Floyd; Eric,9998,0,9999,1
1715663850947,MCWP 40R,A00,518780,Staff,1,0,20,19
1715663850947,MCWP 40R,B00,518781,Carter; Jennifer A,9,0,20,11
1715663850947,MCWP 40R,C00,518783,Smith; Haydee Marie,5,0,20,15
1715663851974,MCWP 50R,A00,518791,Redela; Pamela Morgan,0,1,20,20
1715663851974,MCWP 50R,B00,518792,Krone; Jarret,0,2,20,20
1715663851974,MCWP 50R,C00,518793,Staff,0,4,20,20
1715663851974,MCWP 50R,D00,518794,Morshed; Michael James,0,2,20,20
1715663851974,MCWP 50R,E00,518795,Carter; Andrea L,0,2,20,20
1715663851974,MCWP 50R,F00,518796,Miller; Elizabeth Deen,0,1,20,20
1715663851974,MCWP 50R,G00,518797,Guillen; Melinda,0,1,20,20
1715663853000,MMW 12R,A01,514034,Herbst; Matthew,0,2,16,16
1715663853000,MMW 12R,A02,514035,Herbst; Matthew,0,0,16,16
1715663854026,MMW 13R,A01,514037,Staff,0,5,16,16
1715663854026,MMW 13R,A02,514039,Staff,0,5,16,16
1715663854026,MMW 13R,A03,628519,Staff,0,4,16,16
1715663856079,SIO 295LS,A00,523233,Staff,10,0,30,20
1715663857108,SIO 295S,A00,523232,Staff,10,0,30,20
1715663858135,SIOC 290S,A01,637330,Merrifield; Mark A,21,0,30,9
1715663859160,SIOC 291S,A01,637333,Gabriel; Corey John,21,0,30,9
1715663860188,SOCI 117,A01,494376,Staff,0,5,5,5
1715663861215,WES 237B,A00,494380,Staff,10,0,20,10
1715663863299,AESE 279B,A00,494370,Wade; Jon P,0,0,33,33
1715663864326,AIP 97,001,660915,Van Den Einde; Yael Dahlia,9998,0,9999,1
1715663865354,AIP 197,001,627712,Vespa; Emanuel Ignacio,9995,0,9999,4
1715663865354,AIP 197,002,650778,Amir; On,9998,0,9999,1
1715663865354,AIP 197,003,650933,Avenancio-Leon; Carlos,9998,0,9999,1
1715663865354,AIP 197,004,658530,Heyman; Gail D.,9998,0,9999,1
1715663865354,AIP 197,005,658631,Neal; Sonya E,9998,0,9999,1
1715663865354,AIP 197,006,658671,Du; Songzi,9998,0,9999,1
1715663866381,ANAR 135S,A00,494369,Braswell; Geoffrey E.,0,0,0,0
1715663867406,BENG 196,001,628496,Engler; Adam J.,9998,0,9999,1
1715663867406,BENG 196,002,660916,Watson; John Thomas,9998,0,9999,1
1715663868434,BISP 197,001,650773,Wilhelm; James E.,9994,0,9999,5
1715663868434,BISP 197,002,658904,Coleman; Aaron B.,9998,0,9999,1
1715663869459,CAT 124RS,A01,519847,Geibel; William,0,0,20,20
1715663870483,CAT 125RS,A01,515971,Geibel; William,0,0,20,20
1715663871508,CLRE 250,A00,511389,Morris; Sheldon,9992,0,9999,7
1715663872533,CLRE 251,A00,507176,Mehta; Ravindra L.,9992,0,9999,7
1715663872533,CLRE 251,B00,511410,Mehta; Ravindra L.,9998,0,9999,1
1715663873561,CLRE 252,A00,507189,Cuomo; Raphael Eduardo,9994,0,9999,5
1715663874717,CLRE 253,A00,507199,Vaida; Florin,9994,0,9999,5
1715663874717,CLRE 253,B00,507202,Vaida; Florin,9999,0,9999,0
1715663875742,CLRE 259,A00,507211,Patel; Hemal,9996,0,9999,3
1715663876770,CLRE 260,A00,507221,Cuomo; Raphael Eduardo,9999,0,9999,0
1715663877798,CLRE 297,001,507242,Cuomo; Raphael Eduardo,9999,0,9999,0
1715663878828,COGS 197,001,638244,Voytek; Bradley Thomas,9997,0,9999,2
1715663879853,CSE 191,A00,516875,Minnes Kemp; Mor Mia,9991,0,9999,8
1715663880880,CSE 197,001,637388,Minnes Kemp; Mor Mia,9992,0,9999,7
1715663881912,CSS 201S,A01,494383,Mignozzetti; Umberto,35,0,35,0
1715663882941,CSS 202S,A01,494387,Mignozzetti; Umberto,35,0,35,0
1715663883971,DSC 197,001,628532,Eldridge; Justin Matthew,9995,0,9999,4
1715663884994,EAP 100,A00,516065,Staff,9799,0,9999,200
1715663886023,ECE 45,A01,507414,Staff,32,0,60,28
1715663888076,ECE 111,A01,507420,Staff,11,0,50,39
1715663889102,ECE 197,001,548057,Sievenpiper; Daniel F.,9991,0,9999,8
1715663890129,EDS 115,A00,507243,Choi; Bailey Miyeon,6,0,28,22
1715663891155,EDS 117,A01,494379,Staff,0,6,34,35
1715663892183,EDS 125,A00,507246,Hopkins; Megan Beth,7,0,30,23
1715663893215,EDS 128A,A01,507264,Fargason; Sharon Gayle,5,0,26,21
1715663894242,EDS 128B,A01,507293,Pappas; Elizabeth,9,0,30,21
1715663895268,EDS 139,A00,507294,Fargason; Sharon Gayle,9,0,30,21
1715663895268,EDS 139,B00,507313,Pappas; Elizabeth,9,0,30,21
1715663896296,EDS 201,A00,507315,Staff,10,0,30,20
1715663897325,EDS 203,A01,507317,Halter; Christopher P.,10,0,30,20
1715663898352,EDS 204R,A01,507319,Halter; Christopher P.,0,3,30,30
1715663898352,EDS 204R,B01,507331,Heinzman; Erica M.,14,0,30,16
1715663899377,EDS 206R,A00,507332,Staff,0,4,30,30
1715663899377,EDS 206R,B00,507343,Staff,15,0,30,15
1715663900404,EDS 250,A00,507344,Hemans; Patricia Ann Benitez,20,0,40,20
1715663901431,EDS 281,A00,507345,Daly; Alan J.,18,0,18,0
1715663902458,EDS 284,A00,507350,Daly; Alan J.,16,0,16,0
1715663903484,EDS 286,A00,507359,Fine; Sarah,18,0,18,0
1715663904509,EDS 289C,A01,507361,Daly; Alan J.,18,0,18,0
1715663905535,EDS 290,A00,507366,Hofstetter; Carolyn,15,0,15,0
1715663906561,LIGM 5A,A00,507421,Fischer-Grunski; Eva K,17,0,20,3
1715663907587,LIGM 5B,A00,507423,Fischer-Grunski; Eva K,19,0,20,1
1715663908612,LIGM 5C,A00,507425,Fischer-Grunski; Eva K,19,0,20,1
1715663909642,LIIT 5AS,A00,507427,Carnelos; Chiara,20,0,20,0
1715663910668,LIIT 5BS,A00,507430,Carnelos; Chiara,20,0,20,0
1715663911694,LIIT 5CS,A00,507432,Carnelos; Chiara,20,0,20,0
1715663912724,LISP 5A,A00,507541,Munoz Sanchez; Alicia,11,0,20,9
1715663913749,LISP 5B,A00,507671,Munoz Sanchez; Alicia,8,0,20,12
1715663914775,LISP 5C,A00,507696,Munoz Sanchez; Alicia,7,0,20,13
1715663915802,MAE 197,001,528363,Boechler; Nicholas Sebastia,9998,0,9999,1
1715663916829,MATH 197,001,523477,Kedlaya; Kiran S.,9994,0,9999,5
1715663916829,MATH 197,002,563811,Zhang; Danna,9994,0,9999,5
1715663916829,MATH 197,003,628552,Dumitriu; Ioana,9998,0,9999,1
1715663916829,MATH 197,004,660885,Floyd; Eric,9998,0,9999,1
1715663917856,MCWP 40R,A00,518780,Staff,1,0,20,19
1715663917856,MCWP 40R,B00,518781,Carter; Jennifer A,9,0,20,11
1715663917856,MCWP 40R,C00,518783,Smith; Haydee Marie,5,0,20,15
1715663918888,MCWP 50R,A00,518791,Redela; Pamela Morgan,0,1,20,20
1715663918888,MCWP 50R,B00,518792,Krone; Jarret,0,2,20,20
1715663918888,MCWP 50R,C00,518793,Staff,0,4,20,20
1715663918888,MCWP 50R,D00,518794,Morshed; Michael James,0,2,20,20
1715663918888,MCWP 50R,E00,518795,Carter; Andrea L,0,2,20,20
1715663918888,MCWP 50R,F00,518796,Miller; Elizabeth Deen,0,1,20,20
1715663918888,MCWP 50R,G00,518797,Guillen; Melinda,0,1,20,20
1715663919915,MMW 12R,A01,514034,Herbst; Matthew,0,2,16,16
1715663919915,MMW 12R,A02,514035,Herbst; Matthew,0,0,16,16
1715663920939,MMW 13R,A01,514037,Staff,0,5,16,16
1715663920939,MMW 13R,A02,514039,Staff,0,5,16,16
1715663920939,MMW 13R,A03,628519,Staff,0,4,16,16
1715663922994,SIO 295LS,A00,523233,Staff,10,0,30,20
1715663924020,SIO 295S,A00,523232,Staff,10,0,30,20
1715663925052,SIOC 290S,A01,637330,Merrifield; Mark A,21,0,30,9
1715663926083,SIOC 291S,A01,637333,Gabriel; Corey John,21,0,30,9
1715663927111,SOCI 117,A01,494376,Staff,0,5,5,5
1715663928137,WES 237B,A00,494380,Staff,10,0,20,10
1715663930222,AESE 279B,A00,494370,Wade; Jon P,0,0,33,33
1715663931250,AIP 97,001,660915,Van Den Einde; Yael Dahlia,9998,0,9999,1
1715663932280,AIP 197,001,627712,Vespa; Emanuel Ignacio,9995,0,9999,4
1715663932280,AIP 197,002,650778,Amir; On,9998,0,9999,1
1715663932280,AIP 197,003,650933,Avenancio-Leon; Carlos,9998,0,9999,1
1715663932280,AIP 197,004,658530,Heyman; Gail D.,9998,0,9999,1
1715663932280,AIP 197,005,658631,Neal; Sonya E,9998,0,9999,1
1715663932280,AIP 197,006,658671,Du; Songzi,9998,0,9999,1
1715663933306,ANAR 135S,A00,494369,Braswell; Geoffrey E.,0,0,0,0
1715663934333,BENG 196,001,628496,Engler; Adam J.,9998,0,9999,1
1715663934333,BENG 196,002,660916,Watson; John Thomas,9998,0,9999,1
1715663935363,BISP 197,001,650773,Wilhelm; James E.,9994,0,9999,5
1715663935363,BISP 197,002,658904,Coleman; Aaron B.,9998,0,9999,1
1715663936394,CAT 124RS,A01,519847,Geibel; William,0,0,20,20
1715663937424,CAT 125RS,A01,515971,Geibel; William,0,0,20,20
1715663938454,CLRE 250,A00,511389,Morris; Sheldon,9992,0,9999,7
1715663939480,CLRE 251,A00,507176,Mehta; Ravindra L.,9992,0,9999,7
1715663939480,CLRE 251,B00,511410,Mehta; Ravindra L.,9998,0,9999,1
1715663940512,CLRE 252,A00,507189,Cuomo; Raphael Eduardo,9994,0,9999,5
1715663941542,CLRE 253,A00,507199,Vaida; Florin,9994,0,9999,5
1715663941542,CLRE 253,B00,507202,Vaida; Florin,9999,0,9999,0
1715663942578,CLRE 259,A00,507211,Patel; Hemal,9996,0,9999,3
1715663943607,CLRE 260,A00,507221,Cuomo; Raphael Eduardo,9999,0,9999,0
1715663944633,CLRE 297,001,507242,Cuomo; Raphael Eduardo,9999,0,9999,0
1715663945660,COGS 197,001,638244,Voytek; Bradley Thomas,9997,0,9999,2
1715663946686,CSE 191,A00,516875,Minnes Kemp; Mor Mia,9991,0,9999,8
1715663947711,CSE 197,001,637388,Minnes Kemp; Mor Mia,9992,0,9999,7
1715663948739,CSS 201S,A01,494383,Mignozzetti; Umberto,35,0,35,0
1715663949767,CSS 202S,A01,494387,Mignozzetti; Umberto,35,0,35,0
1715663950793,DSC 197,001,628532,Eldridge; Justin Matthew,9995,0,9999,4
1715663951819,EAP 100,A00,516065,Staff,9799,0,9999,200
1715663952850,ECE 45,A01,507414,Staff,32,0,60,28
1715663954907,ECE 111,A01,507420,Staff,11,0,50,39
1715663955936,ECE 197,001,548057,Sievenpiper; Daniel F.,9991,0,9999,8
1715663956971,EDS 115,A00,507243,Choi; Bailey Miyeon,6,0,28,22
1715663958002,EDS 117,A01,494379,Staff,0,6,34,35
1715663959029,EDS 125,A00,507246,Hopkins; Megan Beth,7,0,30,23
1715663960056,EDS 128A,A01,507264,Fargason; Sharon Gayle,5,0,26,21
1715663961084,EDS 128B,A01,507293,Pappas; Elizabeth,9,0,30,21
1715663962108,EDS 139,A00,507294,Fargason; Sharon Gayle,9,0,30,21
1715663962108,EDS 139,B00,507313,Pappas; Elizabeth,9,0,30,21
1715663963133,EDS 201,A00,507315,Staff,10,0,30,20
1715663964162,EDS 203,A01,507317,Halter; Christopher P.,10,0,30,20
1715663965186,EDS 204R,A01,507319,Halter; Christopher P.,0,3,30,30
1715663965186,EDS 204R,B01,507331,Heinzman; Erica M.,14,0,30,16
1715663966217,EDS 206R,A00,507332,Staff,0,4,30,30
1715663966217,EDS 206R,B00,507343,Staff,15,0,30,15
1715663967247,EDS 250,A00,507344,Hemans; Patricia Ann Benitez,20,0,40,20
1715663968272,EDS 281,A00,507345,Daly; Alan J.,18,0,18,0
1715663969298,EDS 284,A00,507350,Daly; Alan J.,16,0,16,0
1715663970324,EDS 286,A00,507359,Fine; Sarah,18,0,18,0
1715663971349,EDS 289C,A01,507361,Daly; Alan J.,18,0,18,0
1715663972375,EDS 290,A00,507366,Hofstetter; Carolyn,15,0,15,0
1715663973402,LIGM 5A,A00,507421,Fischer-Grunski; Eva K,17,0,20,3
1715663974428,LIGM 5B,A00,507423,Fischer-Grunski; Eva K,19,0,20,1
1715663975456,LIGM 5C,A00,507425,Fischer-Grunski; Eva K,19,0,20,1
1715663976485,LIIT 5AS,A00,507427,Carnelos; Chiara,20,0,20,0
1715663977521,LIIT 5BS,A00,507430,Carnelos; Chiara,20,0,20,0
1715663978551,LIIT 5CS,A00,507432,Carnelos; Chiara,20,0,20,0
1715663979578,LISP 5A,A00,507541,Munoz Sanchez; Alicia,11,0,20,9
1715663980606,LISP 5B,A00,507671,Munoz Sanchez; Alicia,8,0,20,12
1715663981633,LISP 5C,A00,507696,Munoz Sanchez; Alicia,7,0,20,13
1715663982660,MAE 197,001,528363,Boechler; Nicholas Sebastia,9998,0,9999,1
1715663983690,MATH 197,001,523477,Kedlaya; Kiran S.,9994,0,9999,5
1715663983690,MATH 197,002,563811,Zhang; Danna,9994,0,9999,5
1715663983690,MATH 197,003,628552,Dumitriu; Ioana,9998,0,9999,1
1715663983690,MATH 197,004,660885,Floyd; Eric,9998,0,9999,1
1715663984718,MCWP 40R,A00,518780,Staff,1,0,20,19
1715663984718,MCWP 40R,B00,518781,Carter; Jennifer A,9,0,20,11
1715663984718,MCWP 40R,C00,518783,Smith; Haydee Marie,5,0,20,15
1715663985748,MCWP 50R,A00,518791,Redela; Pamela Morgan,0,1,20,20
1715663985748,MCWP 50R,B00,518792,Krone; Jarret,0,2,20,20
1715663985748,MCWP 50R,C00,518793,Staff,0,4,20,20
1715663985748,MCWP 50R,D00,518794,Morshed; Michael James,0,2,20,20
1715663985748,MCWP 50R,E00,518795,Carter; Andrea L,0,2,20,20
1715663985748,MCWP 50R,F00,518796,Miller; Elizabeth Deen,0,1,20,20
1715663985748,MCWP 50R,G00,518797,Guillen; Melinda,0,1,20,20
1715663986773,MMW 12R,A01,514034,Herbst; Matthew,0,2,16,16
1715663986773,MMW 12R,A02,514035,Herbst; Matthew,0,0,16,16
1715663987799,MMW 13R,A01,514037,Staff,0,5,16,16
1715663987799,MMW 13R,A02,514039,Staff,0,5,16,16
1715663987799,MMW 13R,A03,628519,Staff,0,4,16,16
1715663989852,SIO 295LS,A00,523233,Staff,10,0,30,20
1715663990882,SIO 295S,A00,523232,Staff,10,0,30,20
1715663991908,SIOC 290S,A01,637330,Merrifield; Mark A,21,0,30,9
1715663992933,SIOC 291S,A01,637333,Gabriel; Corey John,21,0,30,9
1715663993962,SOCI 117,A01,494376,Staff,0,5,5,5
1715663994987,WES 237B,A00,494380,Staff,10,0,20,10
1715663997056,AESE 279B,A00,494370,Wade; Jon P,0,0,33,33
1715663998082,AIP 97,001,660915,Van Den Einde; Yael Dahlia,9998,0,9999,1
1715663999110,AIP 197,001,627712,Vespa; Emanuel Ignacio,9995,0,9999,4
1715663999110,AIP 197,002,650778,Amir; On,9998,0,9999,1
1715663999110,AIP 197,003,650933,Avenancio-Leon; Carlos,9998,0,9999,1
1715663999110,AIP 197,004,658530,Heyman; Gail D.,9998,0,9999,1
1715663999110,AIP 197,005,658631,Neal; Sonya E,9998,0,9999,1
1715663999110,AIP 197,006,658671,Du; Songzi,9998,0,9999,1
1715664000137,ANAR 135S,A00,494369,Braswell; Geoffrey E.,0,0,0,0
1715664001165,BENG 196,001,628496,Engler; Adam J.,9998,0,9999,1
1715664001165,BENG 196,002,660916,Watson; John Thomas,9998,0,9999,1
1715664002195,BISP 197,001,650773,Wilhelm; James E.,9994,0,9999,5
1715664002195,BISP 197,002,658904,Coleman; Aaron B.,9998,0,9999,1
1715664003227,CAT 124RS,A01,519847,Geibel; William,0,0,20,20
1715664004252,CAT 125RS,A01,515971,Geibel; William,0,0,20,20
1715664005281,CLRE 250,A00,511389,Morris; Sheldon,9992,0,9999,7
1715664006310,CLRE 251,A00,507176,Mehta; Ravindra L.,9992,0,9999,7
1715664006310,CLRE 251,B00,511410,Mehta; Ravindra L.,9998,0,9999,1
1715664007342,CLRE 252,A00,507189,Cuomo; Raphael Eduardo,9994,0,9999,5
1715664008368,CLRE 253,A00,507199,Vaida; Florin,9994,0,9999,5
1715664008368,CLRE 253,B00,507202,Vaida; Florin,9999,0,9999,0
1715664009397,CLRE 259,A00,507211,Patel; Hemal,9996,0,9999,3
1715664010425,CLRE 260,A00,507221,Cuomo; Raphael Eduardo,9999,0,9999,0
1715664011450,CLRE 297,001,507242,Cuomo; Raphael Eduardo,9999,0,9999,0
1715664012480,COGS 197,001,638244,Voytek; Bradley Thomas,9997,0,9999,2
1715664013508,CSE 191,A00,516875,Minnes Kemp; Mor Mia,9991,0,9999,8
1715664014532,CSE 197,001,637388,Minnes Kemp; Mor Mia,9992,0,9999,7
1715664015561,CSS 201S,A01,494383,Mignozzetti; Umberto,35,0,35,0
1715664016587,CSS 202S,A01,494387,Mignozzetti; Umberto,35,0,35,0
1715664017612,DSC 197,001,628532,Eldridge; Justin Matthew,9995,0,9999,4
1715664018638,EAP 100,A00,516065,Staff,9799,0,9999,200
1715664019672,ECE 45,A01,507414,Staff,32,0,60,28
1715664021723,ECE 111,A01,507420,Staff,11,0,50,39
1715664022749,ECE 197,001,548057,Sievenpiper; Daniel F.,9991,0,9999,8
1715664023775,EDS 115,A00,507243,Choi; Bailey Miyeon,6,0,28,22
1715664024801,EDS 117,A01,494379,Staff,0,6,34,35
1715664025827,EDS 125,A00,507246,Hopkins; Megan Beth,7,0,30,23
1715664026856,EDS 128A,A01,507264,Fargason; Sharon Gayle,5,0,26,21
1715664027882,EDS 128B,A01,507293,Pappas; Elizabeth,9,0,30,21
1715664028905,EDS 139,A00,507294,Fargason; Sharon Gayle,9,0,30,21
1715664028905,EDS 139,B00,507313,Pappas; Elizabeth,9,0,30,21
1715664029933,EDS 201,A00,507315,Staff,10,0,30,20
1715664030962,EDS 203,A01,507317,Halter; Christopher P.,10,0,30,20
1715664031988,EDS 204R,A01,507319,Halter; Christopher P.,0,3,30,30
1715664031988,EDS 204R,B01,507331,Heinzman; Erica M.,14,0,30,16
1715664033014,EDS 206R,A00,507332,Staff,0,4,30,30
1715664033014,EDS 206R,B00,507343,Staff,15,0,30,15
1715664034040,EDS 250,A00,507344,Hemans; Patricia Ann Benitez,20,0,40,20
1715664035068,EDS 281,A00,507345,Daly; Alan J.,18,0,18,0
1715664036094,EDS 284,A00,507350,Daly; Alan J.,16,0,16,0
1715664037122,EDS 286,A00,507359,Fine; Sarah,18,0,18,0
1715664038146,EDS 289C,A01,507361,Daly; Alan J.,18,0,18,0
1715664039173,EDS 290,A00,507366,Hofstetter; Carolyn,15,0,15,0
1715664040200,LIGM 5A,A00,507421,Fischer-Grunski; Eva K,17,0,20,3
1715664041225,LIGM 5B,A00,507423,Fischer-Grunski; Eva K,19,0,20,1
1715664042251,LIGM 5C,A00,507425,Fischer-Grunski; Eva K,19,0,20,1
1715664043275,LIIT 5AS,A00,507427,Carnelos; Chiara,20,0,20,0
1715664044298,LIIT 5BS,A00,507430,Carnelos; Chiara,20,0,20,0
1715664045434,LIIT 5CS,A00,507432,Carnelos; Chiara,20,0,20,0
1715664046462,LISP 5A,A00,507541,Munoz Sanchez; Alicia,11,0,20,9
1715664047485,LISP 5B,A00,507671,Munoz Sanchez; Alicia,8,0,20,12
1715664048513,LISP 5C,A00,507696,Munoz Sanchez; Alicia,7,0,20,13
1715664049543,MAE 197,001,528363,Boechler; Nicholas Sebastia,9998,0,9999,1
1715664050568,MATH 197,001,523477,Kedlaya; Kiran S.,9994,0,9999,5
1715664050568,MATH 197,002,563811,Zhang; Danna,9994,0,9999,5
1715664050568,MATH 197,003,628552,Dumitriu; Ioana,9998,0,9999,1
1715664050568,MATH 197,004,660885,Floyd; Eric,9998,0,9999,1
1715664051600,MCWP 40R,A00,518780,Staff,1,0,20,19
1715664051600,MCWP 40R,B00,518781,Carter; Jennifer A,9,0,20,11
1715664051600,MCWP 40R,C00,518783,Smith; Haydee Marie,5,0,20,15
1715664052628,MCWP 50R,A00,518791,Redela; Pamela Morgan,0,1,20,20
1715664052628,MCWP 50R,B00,518792,Krone; Jarret,0,2,20,20
1715664052628,MCWP 50R,C00,518793,Staff,0,4,20,20
1715664052628,MCWP 50R,D00,518794,Morshed; Michael James,0,2,20,20
1715664052628,MCWP 50R,E00,518795,Carter; Andrea L,0,2,20,20
1715664052628,MCWP 50R,F00,518796,Miller; Elizabeth Deen,0,1,20,20
1715664052628,MCWP 50R,G00,518797,Guillen; Melinda,0,1,20,20
1715664053653,MMW 12R,A01,514034,Herbst; Matthew,0,2,16,16
1715664053653,MMW 12R,A02,514035,Herbst; Matthew,0,0,16,16
1715664054679,MMW 13R,A01,514037,Staff,0,5,16,16
1715664054679,MMW 13R,A02,514039,Staff,0,5,16,16
1715664054679,MMW 13R,A03,628519,Staff,0,4,16,16
1715664056730,SIO 295LS,A00,523233,Staff,10,0,30,20
1715664057755,SIO 295S,A00,523232,Staff,10,0,30,20
1715664058785,SIOC 290S,A01,637330,Merrifield; Mark A,21,0,30,9
1715664059810,SIOC 291S,A01,637333,Gabriel; Corey John,21,0,30,9
1715664060834,SOCI 117,A01,494376,Staff,0,5,5,5
1715664061861,WES 237B,A00,494380,Staff,10,0,20,10
1715664063932,AESE 279B,A00,494370,Wade; Jon P,0,0,33,33
1715664064956,AIP 97,001,660915,Van Den Einde; Yael Dahlia,9998,0,9999,1
1715664065986,AIP 197,001,627712,Vespa; Emanuel Ignacio,9995,0,9999,4
1715664065986,AIP 197,002,650778,Amir; On,9998,0,9999,1
1715664065986,AIP 197,003,650933,Avenancio-Leon; Carlos,9998,0,9999,1
1715664065986,AIP 197,004,658530,Heyman; Gail D.,9998,0,9999,1
1715664065986,AIP 197,005,658631,Neal; Sonya E,9998,0,9999,1
1715664065986,AIP 197,006,658671,Du; Songzi,9998,0,9999,1
1715664067010,ANAR 135S,A00,494369,Braswell; Geoffrey E.,0,0,0,0
1715664068040,BENG 196,001,628496,Engler; Adam J.,9998,0,9999,1
1715664068040,BENG 196,002,660916,Watson; John Thomas,9998,0,9999,1
1715664069066,BISP 197,001,650773,Wilhelm; James E.,9994,0,9999,5
1715664069066,BISP 197,002,658904,Coleman; Aaron B.,9998,0,9999,1
1715664070092,CAT 124RS,A01,519847,Geibel; William,0,0,20,20
1715664071120,CAT 125RS,A01,515971,Geibel; William,0,0,20,20
1715664072146,CLRE 250,A00,511389,Morris; Sheldon,9992,0,9999,7
1715664073173,CLRE 251,A00,507176,Mehta; Ravindra L.,9992,0,9999,7
1715664073173,CLRE 251,B00,511410,Mehta; Ravindra L.,9998,0,9999,1
1715664074201,CLRE 252,A00,507189,Cuomo; Raphael Eduardo,9994,0,9999,5
1715664075225,CLRE 253,A00,507199,Vaida; Florin,9994,0,9999,5
1715664075225,CLRE 253,B00,507202,Vaida; Florin,9999,0,9999,0
1715664076255,CLRE 259,A00,507211,Patel; Hemal,9996,0,9999,3
1715664077279,CLRE 260,A00,507221,Cuomo; Raphael Eduardo,9999,0,9999,0
1715664078306,CLRE 297,001,507242,Cuomo; Raphael Eduardo,9999,0,9999,0
1715664079333,COGS 197,001,638244,Voytek; Bradley Thomas,9997,0,9999,2
1715664080360,CSE 191,A00,516875,Minnes Kemp; Mor Mia,9991,0,9999,8
1715664081385,CSE 197,001,637388,Minnes Kemp; Mor Mia,9992,0,9999,7
1715664082412,CSS 201S,A01,494383,Mignozzetti; Umberto,35,0,35,0
1715664083442,CSS 202S,A01,494387,Mignozzetti; Umberto,35,0,35,0
1715664084470,DSC 197,001,628532,Eldridge; Justin Matthew,9995,0,9999,4
1715664085497,EAP 100,A00,516065,Staff,9799,0,9999,200
1715664086526,ECE 45,A01,507414,Staff,32,0,60,28
1715664088583,ECE 111,A01,507420,Staff,11,0,50,39
1715664089606,ECE 197,001,548057,Sievenpiper; Daniel F.,9991,0,9999,8
1715664090637,EDS 115,A00,507243,Choi; Bailey Miyeon,6,0,28,22
1715664091662,EDS 117,A01,494379,Staff,0,6,34,35
1715664092689,EDS 125,A00,507246,Hopkins; Megan Beth,7,0,30,23
1715664093715,EDS 128A,A01,507264,Fargason; Sharon Gayle,5,0,26,21
1715664094741,EDS 128B,A01,507293,Pappas; Elizabeth,9,0,30,21
1715664095766,EDS 139,A00,507294,Fargason; Sharon Gayle,9,0,30,21
1715664095766,EDS 139,B00,507313,Pappas; Elizabeth,9,0,30,21
1715664096790,EDS 201,A00,507315,Staff,10,0,30,20
1715664097817,EDS 203,A01,507317,Halter; Christopher P.,10,0,30,20
1715664098844,EDS 204R,A01,507319,Halter; Christopher P.,0,3,30,30
1715664098844,EDS 204R,B01,507331,Heinzman; Erica M.,14,0,30,16
1715664099871,EDS 206R,A00,507332,Staff,0,4,30,30
1715664099871,EDS 206R,B00,507343,Staff,15,0,30,15
1715664100898,EDS 250,A00,507344,Hemans; Patricia Ann Benitez,20,0,40,20
1715664101924,EDS 281,A00,507345,Daly; Alan J.,18,0,18,0
1715664102949,EDS 284,A00,507350,Daly; Alan J.,16,0,16,0
1715664103979,EDS 286,A00,507359,Fine; Sarah,18,0,18,0
1715664105006,EDS 289C,A01,507361,Daly; Alan J.,18,0,18,0
1715664106034,EDS 290,A00,507366,Hofstetter; Carolyn,15,0,15,0
1715664107106,LIGM 5A,A00,507421,Fischer-Grunski; Eva K,17,0,20,3
1715664108132,LIGM 5B,A00,507423,Fischer-Grunski; Eva K,19,0,20,1
1715664109162,LIGM 5C,A00,507425,Fischer-Grunski; Eva K,19,0,20,1
1715664110187,LIIT 5AS,A00,507427,Carnelos; Chiara,20,0,20,0
1715664111213,LIIT 5BS,A00,507430,Carnelos; Chiara,20,0,20,0
1715664112241,LIIT 5CS,A00,507432,Carnelos; Chiara,20,0,20,0
1715664113272,LISP 5A,A00,507541,Munoz Sanchez; Alicia,11,0,20,9
1715664114296,LISP 5B,A00,507671,Munoz Sanchez; Alicia,8,0,20,12
1715664115324,LISP 5C,A00,507696,Munoz Sanchez; Alicia,7,0,20,13
1715664116349,MAE 197,001,528363,Boechler; Nicholas Sebastia,9998,0,9999,1
1715664117377,MATH 197,001,523477,Kedlaya; Kiran S.,9994,0,9999,5
1715664117377,MATH 197,002,563811,Zhang; Danna,9994,0,9999,5
1715664117377,MATH 197,003,628552,Dumitriu; Ioana,9998,0,9999,1
1715664117377,MATH 197,004,660885,Floyd; Eric,9998,0,9999,1
1715664118407,MCWP 40R,A00,518780,Staff,1,0,20,19
1715664118407,MCWP 40R,B00,518781,Carter; Jennifer A,9,0,20,11
1715664118407,MCWP 40R,C00,518783,Smith; Haydee Marie,5,0,20,15
1715664119436,MCWP 50R,A00,518791,Redela; Pamela Morgan,0,1,20,20
1715664119436,MCWP 50R,B00,518792,Krone; Jarret,0,2,20,20
1715664119436,MCWP 50R,C00,518793,Staff,0,4,20,20
1715664119436,MCWP 50R,D00,518794,Morshed; Michael James,0,2,20,20
1715664119436,MCWP 50R,E00,518795,Carter; Andrea L,0,2,20,20
1715664119436,MCWP 50R,F00,518796,Miller; Elizabeth Deen,0,1,20,20
1715664119436,MCWP 50R,G00,518797,Guillen; Melinda,0,1,20,20
1715664120461,MMW 12R,A01,514034,Herbst; Matthew,0,2,16,16
1715664120461,MMW 12R,A02,514035,Herbst; Matthew,0,0,16,16
1715664121486,MMW 13R,A01,514037,Staff,0,5,16,16
1715664121486,MMW 13R,A02,514039,Staff,0,5,16,16
1715664121486,MMW 13R,A03,628519,Staff,0,4,16,16
1715664123542,SIO 295LS,A00,523233,Staff,10,0,30,20
1715664124566,SIO 295S,A00,523232,Staff,10,0,30,20
1715664125596,SIOC 290S,A01,637330,Merrifield; Mark A,21,0,30,9
1715664126624,SIOC 291S,A01,637333,Gabriel; Corey John,21,0,30,9
1715664127649,SOCI 117,A01,494376,Staff,0,5,5,5
1715664128676,WES 237B,A00,494380,Staff,10,0,20,10
1715664130759,AESE 279B,A00,494370,Wade; Jon P,0,0,33,33
1715664131787,AIP 97,001,660915,Van Den Einde; Yael Dahlia,9998,0,9999,1
1715664132814,AIP 197,001,627712,Vespa; Emanuel Ignacio,9995,0,9999,4
1715664132814,AIP 197,002,650778,Amir; On,9998,0,9999,1
1715664132814,AIP 197,003,650933,Avenancio-Leon; Carlos,9998,0,9999,1
1715664132814,AIP 197,004,658530,Heyman; Gail D.,9998,0,9999,1
1715664132814,AIP 197,005,658631,Neal; Sonya E,9998,0,9999,1
1715664132814,AIP 197,006,658671,Du; Songzi,9998,0,9999,1
1715664133839,ANAR 135S,A00,494369,Braswell; Geoffrey E.,0,0,0,0
1715664134864,BENG 196,001,628496,Engler; Adam J.,9998,0,9999,1
1715664134864,BENG 196,002,660916,Watson; John Thomas,9998,0,9999,1
1715664135890,BISP 197,001,650773,Wilhelm; James E.,9994,0,9999,5
1715664135890,BISP 197,002,658904,Coleman; Aaron B.,9998,0,9999,1
1715664136917,CAT 124RS,A01,519847,Geibel; William,0,0,20,20
1715664137943,CAT 125RS,A01,515971,Geibel; William,0,0,20,20
1715664138969,CLRE 250,A00,511389,Morris; Sheldon,9992,0,9999,7
1715664139995,CLRE 251,A00,507176,Mehta; Ravindra L.,9992,0,9999,7
1715664139995,CLRE 251,B00,511410,Mehta; Ravindra L.,9998,0,9999,1
1715664141020,CLRE 252,A00,507189,Cuomo; Raphael Eduardo,9994,0,9999,5
1715664142048,CLRE 253,A00,507199,Vaida; Florin,9994,0,9999,5
1715664142048,CLRE 253,B00,507202,Vaida; Florin,9999,0,9999,0
1715664143076,CLRE 259,A00,507211,Patel; Hemal,9996,0,9999,3
1715664144112,CLRE 260,A00,507221,Cuomo; Raphael Eduardo,9999,0,9999,0
1715664145136,CLRE 297,001,507242,Cuomo; Raphael Eduardo,9999,0,9999,0
1715664146162,COGS 197,001,638244,Voytek; Bradley Thomas,9997,0,9999,2
1715664147186,CSE 191,A00,516875,Minnes Kemp; Mor Mia,9991,0,9999,8
1715664148210,CSE 197,001,637388,Minnes Kemp; Mor Mia,9992,0,9999,7
1715664149238,CSS 201S,A01,494383,Mignozzetti; Umberto,35,0,35,0
1715664150270,CSS 202S,A01,494387,Mignozzetti; Umberto,35,0,35,0
1715664151294,DSC 197,001,628532,Eldridge; Justin Matthew,9995,0,9999,4
1715664152321,EAP 100,A00,516065,Staff,9799,0,9999,200
1715664153353,ECE 45,A01,507414,Staff,32,0,60,28
1715664155404,ECE 111,A01,507420,Staff,11,0,50,39
1715664156429,ECE 197,001,548057,Sievenpiper; Daniel F.,9991,0,9999,8
1715664157457,EDS 115,A00,507243,Choi; Bailey Miyeon,6,0,28,22
1715664158510,EDS 117,A01,494379,Staff,0,6,34,35
1715664159537,EDS 125,A00,507246,Hopkins; Megan Beth,7,0,30,23
1715664160566,EDS 128A,A01,507264,Fargason; Sharon Gayle,5,0,26,21
1715664161594,EDS 128B,A01,507293,Pappas; Elizabeth,9,0,30,21
1715664162620,EDS 139,A00,507294,Fargason; Sharon Gayle,9,0,30,21
1715664162620,EDS 139,B00,507313,Pappas; Elizabeth,9,0,30,21
1715664163644,EDS 201,A00,507315,Staff,10,0,30,20
1715664164672,EDS 203,A01,507317,Halter; Christopher P.,10,0,30,20
1715664165696,EDS 204R,A01,507319,Halter; Christopher P.,0,3,30,30
1715664165696,EDS 204R,B01,507331,Heinzman; Erica M.,14,0,30,16
1715664166719,EDS 206R,A00,507332,Staff,0,4,30,30
1715664166719,EDS 206R,B00,507343,Staff,15,0,30,15
1715664167745,EDS 250,A00,507344,Hemans; Patricia Ann Benitez,20,0,40,20
1715664168772,EDS 281,A00,507345,Daly; Alan J.,18,0,18,0
1715664169800,EDS 284,A00,507350,Daly; Alan J.,16,0,16,0
1715664170828,EDS 286,A00,507359,Fine; Sarah,18,0,18,0
1715664171856,EDS 289C,A01,507361,Daly; Alan J.,18,0,18,0
1715664172882,EDS 290,A00,507366,Hofstetter; Carolyn,15,0,15,0
1715664173910,LIGM 5A,A00,507421,Fischer-Grunski; Eva K,17,0,20,3
1715664174935,LIGM 5B,A00,507423,Fischer-Grunski; Eva K,19,0,20,1
1715664175959,LIGM 5C,A00,507425,Fischer-Grunski; Eva K,19,0,20,1
1715664176985,LIIT 5AS,A00,507427,Carnelos; Chiara,20,0,20,0
1715664178009,LIIT 5BS,A00,507430,Carnelos; Chiara,20,0,20,0
1715664179037,LIIT 5CS,A00,507432,Carnelos; Chiara,20,0,20,0
1715664180068,LISP 5A,A00,507541,Munoz Sanchez; Alicia,11,0,20,9
1715664181096,LISP 5B,A00,507671,Munoz Sanchez; Alicia,8,0,20,12
1715664182122,LISP 5C,A00,507696,Munoz Sanchez; Alicia,7,0,20,13
1715664183148,MAE 197,001,528363,Boechler; Nicholas Sebastia,9998,0,9999,1
1715664184177,MATH 197,001,523477,Kedlaya; Kiran S.,9994,0,9999,5
1715664184177,MATH 197,002,563811,Zhang; Danna,9994,0,9999,5
1715664184177,MATH 197,003,628552,Dumitriu; Ioana,9998,0,9999,1
1715664184177,MATH 197,004,660885,Floyd; Eric,9998,0,9999,1
1715664185209,MCWP 40R,A00,518780,Staff,1,0,20,19
1715664185209,MCWP 40R,B00,518781,Carter; Jennifer A,9,0,20,11
1715664185209,MCWP 40R,C00,518783,Smith; Haydee Marie,5,0,20,15
1715664186237,MCWP 50R,A00,518791,Redela; Pamela Morgan,0,1,20,20
1715664186237,MCWP 50R,B00,518792,Krone; Jarret,0,2,20,20
1715664186237,MCWP 50R,C00,518793,Staff,0,4,20,20
1715664186237,MCWP 50R,D00,518794,Morshed; Michael James,0,2,20,20
1715664186237,MCWP 50R,E00,518795,Carter; Andrea L,0,2,20,20
1715664186237,MCWP 50R,F00,518796,Miller; Elizabeth Deen,0,1,20,20
1715664186237,MCWP 50R,G00,518797,Guillen; Melinda,0,1,20,20
1715664187266,MMW 12R,A01,514034,Herbst; Matthew,0,2,16,16
1715664187266,MMW 12R,A02,514035,Herbst; Matthew,0,0,16,16
1715664188292,MMW 13R,A01,514037,Staff,0,5,16,16
1715664188292,MMW 13R,A02,514039,Staff,0,5,16,16
1715664188292,MMW 13R,A03,628519,Staff,0,4,16,16
1715664190348,SIO 295LS,A00,523233,Staff,10,0,30,20
1715664191372,SIO 295S,A00,523232,Staff,10,0,30,20
1715664192399,SIOC 290S,A01,637330,Merrifield; Mark A,21,0,30,9
1715664193426,SIOC 291S,A01,637333,Gabriel; Corey John,21,0,30,9
1715664194452,SOCI 117,A01,494376,Staff,0,5,5,5
1715664195477,WES 237B,A00,494380,Staff,10,0,20,10
1715664197545,AESE 279B,A00,494370,Wade; Jon P,0,0,33,33
1715664198570,AIP 97,001,660915,Van Den Einde; Yael Dahlia,9998,0,9999,1
1715664199597,AIP 197,001,627712,Vespa; Emanuel Ignacio,9995,0,9999,4
1715664199597,AIP 197,002,650778,Amir; On,9998,0,9999,1
1715664199597,AIP 197,003,650933,Avenancio-Leon; Carlos,9998,0,9999,1
1715664199597,AIP 197,004,658530,Heyman; Gail D.,9998,0,9999,1
1715664199597,AIP 197,005,658631,Neal; Sonya E,9998,0,9999,1
1715664199597,AIP 197,006,658671,Du; Songzi,9998,0,9999,1
1715664200622,ANAR 135S,A00,494369,Braswell; Geoffrey E.,0,0,0,0
1715664201648,BENG 196,001,628496,Engler; Adam J.,9998,0,9999,1
1715664201648,BENG 196,002,660916,Watson; John Thomas,9998,0,9999,1
1715664202677,BISP 197,001,650773,Wilhelm; James E.,9994,0,9999,5
1715664202677,BISP 197,002,658904,Coleman; Aaron B.,9998,0,9999,1
1715664203704,CAT 124RS,A01,519847,Geibel; William,0,0,20,20
1715664204729,CAT 125RS,A01,515971,Geibel; William,0,0,20,20
1715664205757,CLRE 250,A00,511389,Morris; Sheldon,9992,0,9999,7
1715664206785,CLRE 251,A00,507176,Mehta; Ravindra L.,9992,0,9999,7
1715664206785,CLRE 251,B00,511410,Mehta; Ravindra L.,9998,0,9999,1
1715664207815,CLRE 252,A00,507189,Cuomo; Raphael Eduardo,9994,0,9999,5
1715664208841,CLRE 253,A00,507199,Vaida; Florin,9994,0,9999,5
1715664208841,CLRE 253,B00,507202,Vaida; Florin,9999,0,9999,0
1715664209869,CLRE 259,A00,507211,Patel; Hemal,9996,0,9999,3
1715664210895,CLRE 260,A00,507221,Cuomo; Raphael Eduardo,9999,0,9999,0
1715664211920,CLRE 297,001,507242,Cuomo; Raphael Eduardo,9999,0,9999,0
1715664212946,COGS 197,001,638244,Voytek; Bradley Thomas,9997,0,9999,2
1715664213971,CSE 191,A00,516875,Minnes Kemp; Mor Mia,9991,0,9999,8
1715664214995,CSE 197,001,637388,Minnes Kemp; Mor Mia,9992,0,9999,7
1715664216023,CSS 201S,A01,494383,Mignozzetti; Umberto,35,0,35,0
1715664217048,CSS 202S,A01,494387,Mignozzetti; Umberto,35,0,35,0
1715664218078,DSC 197,001,628532,Eldridge; Justin Matthew,9995,0,9999,4
1715664219105,EAP 100,A00,516065,Staff,9799,0,9999,200
1715664220131,ECE 45,A01,507414,Staff,32,0,60,28
1715664222184,ECE 111,A01,507420,Staff,11,0,50,39
1715664223212,ECE 197,001,548057,Sievenpiper; Daniel F.,9991,0,9999,8
1715664224238,EDS 115,A00,507243,Choi; Bailey Miyeon,6,0,28,22
1715664225265,EDS 117,A01,494379,Staff,0,6,34,35
1715664226290,EDS 125,A00,507246,Hopkins; Megan Beth,7,0,30,23
1715664227321,EDS 128A,A01,507264,Fargason; Sharon Gayle,5,0,26,21
1715664228404,EDS 128B,A01,507293,Pappas; Elizabeth,9,0,30,21
1715664229429,EDS 139,A00,507294,Fargason; Sharon Gayle,9,0,30,21
1715664229429,EDS 139,B00,507313,Pappas; Elizabeth,9,0,30,21
1715664230456,EDS 201,A00,507315,Staff,10,0,30,20
1715664231481,EDS 203,A01,507317,Halter; Christopher P.,10,0,30,20
1715664232511,EDS 204R,A01,507319,Halter; Christopher P.,0,3,30,30
1715664232511,EDS 204R,B01,507331,Heinzman; Erica M.,14,0,30,16
1715664233537,EDS 206R,A00,507332,Staff,0,4,30,30
1715664233537,EDS 206R,B00,507343,Staff,15,0,30,15
1715664234568,EDS 250,A00,507344,Hemans; Patricia Ann Benitez,20,0,40,20
1715664235594,EDS 281,A00,507345,Daly; Alan J.,18,0,18,0
1715664236618,EDS 284,A00,507350,Daly; Alan J.,16,0,16,0
1715664237648,EDS 286,A00,507359,Fine; Sarah,18,0,18,0
1715664238673,EDS 289C,A01,507361,Daly; Alan J.,18,0,18,0
1715664239697,EDS 290,A00,507366,Hofstetter; Carolyn,15,0,15,0
1715664240724,LIGM 5A,A00,507421,Fischer-Grunski; Eva K,17,0,20,3
1715664241752,LIGM 5B,A00,507423,Fischer-Grunski; Eva K,19,0,20,1
1715664242783,LIGM 5C,A00,507425,Fischer-Grunski; Eva K,19,0,20,1
1715664243814,LIIT 5AS,A00,507427,Carnelos; Chiara,20,0,20,0
1715664244839,LIIT 5BS,A00,507430,Carnelos; Chiara,20,0,20,0
1715664245864,LIIT 5CS,A00,507432,Carnelos; Chiara,20,0,20,0
1715664246891,LISP 5A,A00,507541,Munoz Sanchez; Alicia,11,0,20,9
1715664247916,LISP 5B,A00,507671,Munoz Sanchez; Alicia,8,0,20,12
1715664248943,LISP 5C,A00,507696,Munoz Sanchez; Alicia,7,0,20,13
1715664249972,MAE 197,001,528363,Boechler; Nicholas Sebastia,9998,0,9999,1
1715664251002,MATH 197,001,523477,Kedlaya; Kiran S.,9994,0,9999,5
1715664251002,MATH 197,002,563811,Zhang; Danna,9994,0,9999,5
1715664251002,MATH 197,003,628552,Dumitriu; Ioana,9998,0,9999,1
1715664251002,MATH 197,004,660885,Floyd; Eric,9998,0,9999,1
1715664252036,MCWP 40R,A00,518780,Staff,1,0,20,19
1715664252036,MCWP 40R,B00,518781,Carter; Jennifer A,9,0,20,11
1715664252036,MCWP 40R,C00,518783,Smith; Haydee Marie,5,0,20,15
1715664253065,MCWP 50R,A00,518791,Redela; Pamela Morgan,0,1,20,20
1715664253065,MCWP 50R,B00,518792,Krone; Jarret,0,2,20,20
1715664253065,MCWP 50R,C00,518793,Staff,0,4,20,20
1715664253065,MCWP 50R,D00,518794,Morshed; Michael James,0,2,20,20
1715664253065,MCWP 50R,E00,518795,Carter; Andrea L,0,2,20,20
1715664253065,MCWP 50R,F00,518796,Miller; Elizabeth Deen,0,1,20,20
1715664253065,MCWP 50R,G00,518797,Guillen; Melinda,0,1,20,20
1715664254094,MMW 12R,A01,514034,Herbst; Matthew,0,2,16,16
1715664254094,MMW 12R,A02,514035,Herbst; Matthew,0,0,16,16
1715664255121,MMW 13R,A01,514037,Staff,0,5,16,16
1715664255121,MMW 13R,A02,514039,Staff,0,5,16,16
1715664255121,MMW 13R,A03,628519,Staff,0,4,16,16
1715664257178,SIO 295LS,A00,523233,Staff,10,0,30,20
1715664258206,SIO 295S,A00,523232,Staff,10,0,30,20
1715664259232,SIOC 290S,A01,637330,Merrifield; Mark A,21,0,30,9
1715664260262,SIOC 291S,A01,637333,Gabriel; Corey John,21,0,30,9
1715664261291,SOCI 117,A01,494376,Staff,0,5,5,5
1715664262317,WES 237B,A00,494380,Staff,10,0,20,10
1715664264390,AESE 279B,A00,494370,Wade; Jon P,0,0,33,33
1715664265419,AIP 97,001,660915,Van Den Einde; Yael Dahlia,9998,0,9999,1
1715664266448,AIP 197,001,627712,Vespa; Emanuel Ignacio,9995,0,9999,4
1715664266448,AIP 197,002,650778,Amir; On,9998,0,9999,1
1715664266448,AIP 197,003,650933,Avenancio-Leon; Carlos,9998,0,9999,1
1715664266448,AIP 197,004,658530,Heyman; Gail D.,9998,0,9999,1
1715664266448,AIP 197,005,658631,Neal; Sonya E,9998,0,9999,1
1715664266448,AIP 197,006,658671,Du; Songzi,9998,0,9999,1
1715664267474,ANAR 135S,A00,494369,Braswell; Geoffrey E.,0,0,0,0
1715664268501,BENG 196,001,628496,Engler; Adam J.,9998,0,9999,1
1715664268501,BENG 196,002,660916,Watson; John Thomas,9998,0,9999,1
1715664269527,BISP 197,001,650773,Wilhelm; James E.,9994,0,9999,5
1715664269527,BISP 197,002,658904,Coleman; Aaron B.,9998,0,9999,1
1715664270551,CAT 124RS,A01,519847,Geibel; William,0,0,20,20
1715664271578,CAT 125RS,A01,515971,Geibel; William,0,0,20,20
1715664272607,CLRE 250,A00,511389,Morris; Sheldon,9992,0,9999,7
1715664273633,CLRE 251,A00,507176,Mehta; Ravindra L.,9992,0,9999,7
1715664273633,CLRE 251,B00,511410,Mehta; Ravindra L.,9998,0,9999,1
1715664274663,CLRE 252,A00,507189,Cuomo; Raphael Eduardo,9994,0,9999,5
1715664275689,CLRE 253,A00,507199,Vaida; Florin,9994,0,9999,5
1715664275689,CLRE 253,B00,507202,Vaida; Florin,9999,0,9999,0
1715664276714,CLRE 259,A00,507211,Patel; Hemal,9996,0,9999,3
1715664277740,CLRE 260,A00,507221,Cuomo; Raphael Eduardo,9999,0,9999,0
1715664278765,CLRE 297,001,507242,Cuomo; Raphael Eduardo,9999,0,9999,0
1715664279790,COGS 197,001,638244,Voytek; Bradley Thomas,9997,0,9999,2
1715664280817,CSE 191,A00,516875,Minnes Kemp; Mor Mia,9991,0,9999,8
1715664281842,CSE 197,001,637388,Minnes Kemp; Mor Mia,9992,0,9999,7
1715664282869,CSS 201S,A01,494383,Mignozzetti; Umberto,35,0,35,0
1715664283895,CSS 202S,A01,494387,Mignozzetti; Umberto,35,0,35,0
1715664284924,DSC 197,001,628532,Eldridge; Justin Matthew,9995,0,9999,4
1715664285949,EAP 100,A00,516065,Staff,9799,0,9999,200
1715664286977,ECE 45,A01,507414,Staff,32,0,60,28
1715664289027,ECE 111,A01,507420,Staff,11,0,50,39
1715664290057,ECE 197,001,548057,Sievenpiper; Daniel F.,9991,0,9999,8
1715664291087,EDS 115,A00,507243,Choi; Bailey Miyeon,6,0,28,22
1715664292116,EDS 117,A01,494379,Staff,0,6,34,35
1715664293142,EDS 125,A00,507246,Hopkins; Megan Beth,7,0,30,23
1715664294170,EDS 128A,A01,507264,Fargason; Sharon Gayle,5,0,26,21
1715664295198,EDS 128B,A01,507293,Pappas; Elizabeth,9,0,30,21
1715664296225,EDS 139,A00,507294,Fargason; Sharon Gayle,9,0,30,21
1715664296225,EDS 139,B00,507313,Pappas; Elizabeth,9,0,30,21
1715664297250,EDS 201,A00,507315,Staff,10,0,30,20
1715664298275,EDS 203,A01,507317,Halter; Christopher P.,10,0,30,20
1715664299300,EDS 204R,A01,507319,Halter; Christopher P.,0,3,30,30
1715664299300,EDS 204R,B01,507331,Heinzman; Erica M.,14,0,30,16
1715664300326,EDS 206R,A00,507332,Staff,0,4,30,30
1715664300326,EDS 206R,B00,507343,Staff,15,0,30,15
1715664301357,EDS 250,A00,507344,Hemans; Patricia Ann Benitez,20,0,40,20
1715664302384,EDS 281,A00,507345,Daly; Alan J.,18,0,18,0
1715664303412,EDS 284,A00,507350,Daly; Alan J.,16,0,16,0
1715664304440,EDS 286,A00,507359,Fine; Sarah,18,0,18,0
1715664305470,EDS 289C,A01,507361,Daly; Alan J.,18,0,18,0
1715664306497,EDS 290,A00,507366,Hofstetter; Carolyn,15,0,15,0
1715664307524,LIGM 5A,A00,507421,Fischer-Grunski; Eva K,17,0,20,3
1715664308549,LIGM 5B,A00,507423,Fischer-Grunski; Eva K,19,0,20,1
1715664309574,LIGM 5C,A00,507425,Fischer-Grunski; Eva K,19,0,20,1
1715664310604,LIIT 5AS,A00,507427,Carnelos; Chiara,20,0,20,0
1715664311629,LIIT 5BS,A00,507430,Carnelos; Chiara,20,0,20,0
1715664312659,LIIT 5CS,A00,507432,Carnelos; Chiara,20,0,20,0
1715664313686,LISP 5A,A00,507541,Munoz Sanchez; Alicia,11,0,20,9
1715664314714,LISP 5B,A00,507671,Munoz Sanchez; Alicia,8,0,20,12
1715664315743,LISP 5C,A00,507696,Munoz Sanchez; Alicia,7,0,20,13
1715664316772,MAE 197,001,528363,Boechler; Nicholas Sebastia,9998,0,9999,1
1715664317807,MATH 197,001,523477,Kedlaya; Kiran S.,9994,0,9999,5
1715664317807,MATH 197,002,563811,Zhang; Danna,9994,0,9999,5
1715664317807,MATH 197,003,628552,Dumitriu; Ioana,9998,0,9999,1
1715664317807,MATH 197,004,660885,Floyd; Eric,9998,0,9999,1
1715664318837,MCWP 40R,A00,518780,Staff,1,0,20,19
1715664318837,MCWP 40R,B00,518781,Carter; Jennifer A,9,0,20,11
1715664318837,MCWP 40R,C00,518783,Smith; Haydee Marie,5,0,20,15
1715664319872,MCWP 50R,A00,518791,Redela; Pamela Morgan,0,1,20,20
1715664319872,MCWP 50R,B00,518792,Krone; Jarret,0,2,20,20
1715664319872,MCWP 50R,C00,518793,Staff,0,4,20,20
1715664319872,MCWP 50R,D00,518794,Morshed; Michael James,0,2,20,20
1715664319872,MCWP 50R,E00,518795,Carter; Andrea L,0,2,20,20
1715664319872,MCWP 50R,F00,518796,Miller; Elizabeth Deen,0,1,20,20
1715664319872,MCWP 50R,G00,518797,Guillen; Melinda,0,1,20,20
1715664320898,MMW 12R,A01,514034,Herbst; Matthew,0,2,16,16
1715664320898,MMW 12R,A02,514035,Herbst; Matthew,0,0,16,16
1715664321923,MMW 13R,A01,514037,Staff,0,5,16,16
1715664321923,MMW 13R,A02,514039,Staff,0,5,16,16
1715664321923,MMW 13R,A03,628519,Staff,0,4,16,16
1715664323977,SIO 295LS,A00,523233,Staff,10,0,30,20
1715664325001,SIO 295S,A00,523232,Staff,10,0,30,20
1715664326028,SIOC 290S,A01,637330,Merrifield; Mark A,21,0,30,9
1715664327058,SIOC 291S,A01,637333,Gabriel; Corey John,21,0,30,9
1715664328083,SOCI 117,A01,494376,Staff,0,5,5,5
1715664329109,WES 237B,A00,494380,Staff,10,0,20,10
1715664331178,AESE 279B,A00,494370,Wade; Jon P,0,0,33,33
1715664332204,AIP 97,001,660915,Van Den Einde; Yael Dahlia,9998,0,9999,1
1715664333232,AIP 197,001,627712,Vespa; Emanuel Ignacio,9995,0,9999,4
1715664333232,AIP 197,002,650778,Amir; On,9998,0,9999,1
1715664333232,AIP 197,003,650933,Avenancio-Leon; Carlos,9998,0,9999,1
1715664333232,AIP 197,004,658530,Heyman; Gail D.,9998,0,9999,1
1715664333232,AIP 197,005,658631,Neal; Sonya E,9998,0,9999,1
1715664333232,AIP 197,006,658671,Du; Songzi,9998,0,9999,1
1715664334260,ANAR 135S,A00,494369,Braswell; Geoffrey E.,0,0,0,0
1715664335287,BENG 196,001,628496,Engler; Adam J.,9998,0,9999,1
1715664335287,BENG 196,002,660916,Watson; John Thomas,9998,0,9999,1
1715664336318,BISP 197,001,650773,Wilhelm; James E.,9994,0,9999,5
1715664336318,BISP 197,002,658904,Coleman; Aaron B.,9998,0,9999,1
1715664337346,CAT 124RS,A01,519847,Geibel; William,0,0,20,20
1715664338373,CAT 125RS,A01,515971,Geibel; William,0,0,20,20
1715664339399,CLRE 250,A00,511389,Morris; Sheldon,9992,0,9999,7
1715664340430,CLRE 251,A00,507176,Mehta; Ravindra L.,9992,0,9999,7
1715664340430,CLRE 251,B00,511410,Mehta; Ravindra L.,9998,0,9999,1
1715664341460,CLRE 252,A00,507189,Cuomo; Raphael Eduardo,9994,0,9999,5
1715664342489,CLRE 253,A00,507199,Vaida; Florin,9994,0,9999,5
1715664342489,CLRE 253,B00,507202,Vaida; Florin,9999,0,9999,0
1715664343515,CLRE 259,A00,507211,Patel; Hemal,9996,0,9999,3
1715664344539,CLRE 260,A00,507221,Cuomo; Raphael Eduardo,9999,0,9999,0
1715664345565,CLRE 297,001,507242,Cuomo; Raphael Eduardo,9999,0,9999,0
1715664346590,COGS 197,001,638244,Voytek; Bradley Thomas,9997,0,9999,2
1715664347616,CSE 191,A00,516875,Minnes Kemp; Mor Mia,9991,0,9999,8
1715664348641,CSE 197,001,637388,Minnes Kemp; Mor Mia,9992,0,9999,7
1715664349668,CSS 201S,A01,494383,Mignozzetti; Umberto,35,0,35,0
1715664350700,CSS 202S,A01,494387,Mignozzetti; Umberto,35,0,35,0
1715664351726,DSC 197,001,628532,Eldridge; Justin Matthew,9995,0,9999,4
1715664352750,EAP 100,A00,516065,Staff,9799,0,9999,200
1715664353776,ECE 45,A01,507414,Staff,32,0,60,28
1715664355829,ECE 111,A01,507420,Staff,11,0,50,39
1715664356854,ECE 197,001,548057,Sievenpiper; Daniel F.,9991,0,9999,8
1715664357880,EDS 115,A00,507243,Choi; Bailey Miyeon,6,0,28,22
1715664358904,EDS 117,A01,494379,Staff,0,6,34,35
1715664359931,EDS 125,A00,507246,Hopkins; Megan Beth,7,0,30,23
1715664360959,EDS 128A,A01,507264,Fargason; Sharon Gayle,5,0,26,21
1715664361993,EDS 128B,A01,507293,Pappas; Elizabeth,9,0,30,21
1715664363023,EDS 139,A00,507294,Fargason; Sharon Gayle,9,0,30,21
1715664363023,EDS 139,B00,507313,Pappas; Elizabeth,9,0,30,21
1715664364048,EDS 201,A00,507315,Staff,10,0,30,20
1715664365074,EDS 203,A01,507317,Halter; Christopher P.,10,0,30,20
1715664366100,EDS 204R,A01,507319,Halter; Christopher P.,0,3,30,30
1715664366100,EDS 204R,B01,507331,Heinzman; Erica M.,14,0,30,16
1715664367129,EDS 206R,A00,507332,Staff,0,4,30,30
1715664367129,EDS 206R,B00,507343,Staff,15,0,30,15
1715664368163,EDS 250,A00,507344,Hemans; Patricia Ann Benitez,20,0,40,20
1715664369244,EDS 281,A00,507345,Daly; Alan J.,18,0,18,0
1715664370270,EDS 284,A00,507350,Daly; Alan J.,16,0,16,0
1715664371296,EDS 286,A00,507359,Fine; Sarah,18,0,18,0
1715664372322,EDS 289C,A01,507361,Daly; Alan J.,18,0,18,0
1715664373351,EDS 290,A00,507366,Hofstetter; Carolyn,15,0,15,0
1715664374381,LIGM 5A,A00,507421,Fischer-Grunski; Eva K,17,0,20,3
1715664375408,LIGM 5B,A00,507423,Fischer-Grunski; Eva K,19,0,20,1
1715664376433,LIGM 5C,A00,507425,Fischer-Grunski; Eva K,19,0,20,1
1715664377460,LIIT 5AS,A00,507427,Carnelos; Chiara,20,0,20,0
1715664378486,LIIT 5BS,A00,507430,Carnelos; Chiara,20,0,20,0
1715664379512,LIIT 5CS,A00,507432,Carnelos; Chiara,20,0,20,0
1715664380543,LISP 5A,A00,507541,Munoz Sanchez; Alicia,11,0,20,9
1715664381573,LISP 5B,A00,507671,Munoz Sanchez; Alicia,8,0,20,12
1715664382599,LISP 5C,A00,507696,Munoz Sanchez; Alicia,7,0,20,13
1715664383627,MAE 197,001,528363,Boechler; Nicholas Sebastia,9998,0,9999,1
1715664384662,MATH 197,001,523477,Kedlaya; Kiran S.,9994,0,9999,5
1715664384662,MATH 197,002,563811,Zhang; Danna,9994,0,9999,5
1715664384662,MATH 197,003,628552,Dumitriu; Ioana,9998,0,9999,1
1715664384662,MATH 197,004,660885,Floyd; Eric,9998,0,9999,1
1715664385690,MCWP 40R,A00,518780,Staff,1,0,20,19
1715664385690,MCWP 40R,B00,518781,Carter; Jennifer A,9,0,20,11
1715664385690,MCWP 40R,C00,518783,Smith; Haydee Marie,5,0,20,15
1715664386725,MCWP 50R,A00,518791,Redela; Pamela Morgan,0,1,20,20
1715664386725,MCWP 50R,B00,518792,Krone; Jarret,0,2,20,20
1715664386725,MCWP 50R,C00,518793,Staff,0,4,20,20
1715664386725,MCWP 50R,D00,518794,Morshed; Michael James,0,2,20,20
1715664386725,MCWP 50R,E00,518795,Carter; Andrea L,0,2,20,20
1715664386725,MCWP 50R,F00,518796,Miller; Elizabeth Deen,0,1,20,20
1715664386725,MCWP 50R,G00,518797,Guillen; Melinda,0,1,20,20
1715664387750,MMW 12R,A01,514034,Herbst; Matthew,0,2,16,16
1715664387750,MMW 12R,A02,514035,Herbst; Matthew,0,0,16,16
1715664388778,MMW 13R,A01,514037,Staff,0,5,16,16
1715664388778,MMW 13R,A02,514039,Staff,0,5,16,16
1715664388778,MMW 13R,A03,628519,Staff,0,4,16,16
1715664390830,SIO 295LS,A00,523233,Staff,10,0,30,20
1715664391855,SIO 295S,A00,523232,Staff,10,0,30,20
1715664392882,SIOC 290S,A01,637330,Merrifield; Mark A,21,0,30,9
1715664393910,SIOC 291S,A01,637333,Gabriel; Corey John,21,0,30,9
1715664394936,SOCI 117,A01,494376,Staff,0,5,5,5
1715664395961,WES 237B,A00,494380,Staff,10,0,20,10
1715664398034,AESE 279B,A00,494370,Wade; Jon P,0,0,33,33
1715664399061,AIP 97,001,660915,Van Den Einde; Yael Dahlia,9998,0,9999,1
1715664400095,AIP 197,001,627712,Vespa; Emanuel Ignacio,9995,0,9999,4
1715664400095,AIP 197,002,650778,Amir; On,9998,0,9999,1
1715664400095,AIP 197,003,650933,Avenancio-Leon; Carlos,9998,0,9999,1
1715664400095,AIP 197,004,658530,Heyman; Gail D.,9998,0,9999,1
1715664400095,AIP 197,005,658631,Neal; Sonya E,9998,0,9999,1
1715664400095,AIP 197,006,658671,Du; Songzi,9998,0,9999,1
1715664401120,ANAR 135S,A00,494369,Braswell; Geoffrey E.,0,0,0,0
1715664402148,BENG 196,001,628496,Engler; Adam J.,9998,0,9999,1
1715664402148,BENG 196,002,660916,Watson; John Thomas,9998,0,9999,1
1715664403175,BISP 197,001,650773,Wilhelm; James E.,9994,0,9999,5
1715664403175,BISP 197,002,658904,Coleman; Aaron B.,9998,0,9999,1
1715664404201,CAT 124RS,A01,519847,Geibel; William,0,0,20,20
1715664405229,CAT 125RS,A01,515971,Geibel; William,0,0,20,20
1715664406256,CLRE 250,A00,511389,Morris; Sheldon,9992,0,9999,7
1715664407289,CLRE 251,A00,507176,Mehta; Ravindra L.,9992,0,9999,7
1715664407289,CLRE 251,B00,511410,Mehta; Ravindra L.,9998,0,9999,1
1715664408315,CLRE 252,A00,507189,Cuomo; Raphael Eduardo,9994,0,9999,5
1715664409342,CLRE 253,A00,507199,Vaida; Florin,9994,0,9999,5
1715664409342,CLRE 253,B00,507202,Vaida; Florin,9999,0,9999,0
1715664410368,CLRE 259,A00,507211,Patel; Hemal,9996,0,9999,3
1715664411396,CLRE 260,A00,507221,Cuomo; Raphael Eduardo,9999,0,9999,0
1715664412425,CLRE 297,001,507242,Cuomo; Raphael Eduardo,9999,0,9999,0
1715664413453,COGS 197,001,638244,Voytek; Bradley Thomas,9997,0,9999,2
1715664414482,CSE 191,A00,516875,Minnes Kemp; Mor Mia,9991,0,9999,8
1715664415507,CSE 197,001,637388,Minnes Kemp; Mor Mia,9992,0,9999,7
1715664416533,CSS 201S,A01,494383,Mignozzetti; Umberto,35,0,35,0
1715664417558,CSS 202S,A01,494387,Mignozzetti; Umberto,35,0,35,0
1715664418586,DSC 197,001,628532,Eldridge; Justin Matthew,9995,0,9999,4
1715664419614,EAP 100,A00,516065,Staff,9799,0,9999,200
1715664420648,ECE 45,A01,507414,Staff,32,0,60,28
1715664422708,ECE 111,A01,507420,Staff,11,0,50,39
1715664423739,ECE 197,001,548057,Sievenpiper; Daniel F.,9991,0,9999,8
1715664424767,EDS 115,A00,507243,Choi; Bailey Miyeon,6,0,28,22
1715664425792,EDS 117,A01,494379,Staff,0,6,34,35
1715664426819,EDS 125,A00,507246,Hopkins; Megan Beth,7,0,30,23
1715664427848,EDS 128A,A01,507264,Fargason; Sharon Gayle,5,0,26,21
1715664428873,EDS 128B,A01,507293,Pappas; Elizabeth,9,0,30,21
1715664429899,EDS 139,A00,507294,Fargason; Sharon Gayle,9,0,30,21
1715664429899,EDS 139,B00,507313,Pappas; Elizabeth,9,0,30,21
1715664430923,EDS 201,A00,507315,Staff,10,0,30,20
1715664431954,EDS 203,A01,507317,Halter; Christopher P.,10,0,30,20
1715664432985,EDS 204R,A01,507319,Halter; Christopher P.,0,3,30,30
1715664432985,EDS 204R,B01,507331,Heinzman; Erica M.,14,0,30,16
1715664434011,EDS 206R,A00,507332,Staff,0,4,30,30
1715664434011,EDS 206R,B00,507343,Staff,15,0,30,15
1715664435038,EDS 250,A00,507344,Hemans; Patricia Ann Benitez,20,0,40,20
1715664436065,EDS 281,A00,507345,Daly; Alan J.,18,0,18,0
1715664437091,EDS 284,A00,507350,Daly; Alan J.,16,0,16,0
1715664438117,EDS 286,A00,507359,Fine; Sarah,18,0,18,0
1715664439145,EDS 289C,A01,507361,Daly; Alan J.,18,0,18,0
1715664440170,EDS 290,A00,507366,Hofstetter; Carolyn,15,0,15,0
1715664441197,LIGM 5A,A00,507421,Fischer-Grunski; Eva K,17,0,20,3
1715664442227,LIGM 5B,A00,507423,Fischer-Grunski; Eva K,19,0,20,1
1715664443252,LIGM 5C,A00,507425,Fischer-Grunski; Eva K,19,0,20,1
1715664444281,LIIT 5AS,A00,507427,Carnelos; Chiara,20,0,20,0
1715664445308,LIIT 5BS,A00,507430,Carnelos; Chiara,20,0,20,0
1715664446336,LIIT 5CS,A00,507432,Carnelos; Chiara,20,0,20,0
1715664447362,LISP 5A,A00,507541,Munoz Sanchez; Alicia,11,0,20,9
1715664448388,LISP 5B,A00,507671,Munoz Sanchez; Alicia,8,0,20,12
1715664449417,LISP 5C,A00,507696,Munoz Sanchez; Alicia,7,0,20,13
1715664450445,MAE 197,001,528363,Boechler; Nicholas Sebastia,9998,0,9999,1
1715664451472,MATH 197,001,523477,Kedlaya; Kiran S.,9994,0,9999,5
1715664451472,MATH 197,002,563811,Zhang; Danna,9994,0,9999,5
1715664451472,MATH 197,003,628552,Dumitriu; Ioana,9998,0,9999,1
1715664451472,MATH 197,004,660885,Floyd; Eric,9998,0,9999,1
1715664452499,MCWP 40R,A00,518780,Staff,1,0,20,19
1715664452499,MCWP 40R,B00,518781,Carter; Jennifer A,9,0,20,11
1715664452499,MCWP 40R,C00,518783,Smith; Haydee Marie,5,0,20,15
1715664453534,MCWP 50R,A00,518791,Redela; Pamela Morgan,0,1,20,20
1715664453534,MCWP 50R,B00,518792,Krone; Jarret,0,2,20,20
1715664453534,MCWP 50R,C00,518793,Staff,0,4,20,20
1715664453534,MCWP 50R,D00,518794,Morshed; Michael James,0,2,20,20
1715664453534,MCWP 50R,E00,518795,Carter; Andrea L,0,2,20,20
1715664453534,MCWP 50R,F00,518796,Miller; Elizabeth Deen,0,1,20,20
1715664453534,MCWP 50R,G00,518797,Guillen; Melinda,0,1,20,20
1715664454560,MMW 12R,A01,514034,Herbst; Matthew,0,2,16,16
1715664454560,MMW 12R,A02,514035,Herbst; Matthew,0,0,16,16
1715664455585,MMW 13R,A01,514037,Staff,0,5,16,16
1715664455585,MMW 13R,A02,514039,Staff,0,5,16,16
1715664455585,MMW 13R,A03,628519,Staff,0,4,16,16
1715664457649,SIO 295LS,A00,523233,Staff,10,0,30,20
1715664458676,SIO 295S,A00,523232,Staff,10,0,30,20
1715664459706,SIOC 290S,A01,637330,Merrifield; Mark A,21,0,30,9
1715664460735,SIOC 291S,A01,637333,Gabriel; Corey John,21,0,30,9
1715664461761,SOCI 117,A01,494376,Staff,0,5,5,5
1715664462788,WES 237B,A00,494380,Staff,10,0,20,10
1715664464866,AESE 279B,A00,494370,Wade; Jon P,0,0,33,33
1715664465891,AIP 97,001,660915,Van Den Einde; Yael Dahlia,9998,0,9999,1
1715664466919,AIP 197,001,627712,Vespa; Emanuel Ignacio,9995,0,9999,4
1715664466919,AIP 197,002,650778,Amir; On,9998,0,9999,1
1715664466919,AIP 197,003,650933,Avenancio-Leon; Carlos,9998,0,9999,1
1715664466919,AIP 197,004,658530,Heyman; Gail D.,9998,0,9999,1
1715664466919,AIP 197,005,658631,Neal; Sonya E,9998,0,9999,1
1715664466919,AIP 197,006,658671,Du; Songzi,9998,0,9999,1
1715664467946,ANAR 135S,A00,494369,Braswell; Geoffrey E.,0,0,0,0
1715664468977,BENG 196,001,628496,Engler; Adam J.,9998,0,9999,1
1715664468977,BENG 196,002,660916,Watson; John Thomas,9998,0,9999,1
1715664470007,BISP 197,001,650773,Wilhelm; James E.,9994,0,9999,5
1715664470007,BISP 197,002,658904,Coleman; Aaron B.,9998,0,9999,1
1715664471034,CAT 124RS,A01,519847,Geibel; William,0,0,20,20
1715664472060,CAT 125RS,A01,515971,Geibel; William,0,0,20,20
1715664473145,CLRE 250,A00,511389,Morris; Sheldon,9992,0,9999,7
1715664474178,CLRE 251,A00,507176,Mehta; Ravindra L.,9992,0,9999,7
1715664474178,CLRE 251,B00,511410,Mehta; Ravindra L.,9998,0,9999,1
1715664475202,CLRE 252,A00,507189,Cuomo; Raphael Eduardo,9994,0,9999,5
1715664476228,CLRE 253,A00,507199,Vaida; Florin,9994,0,9999,5
1715664476228,CLRE 253,B00,507202,Vaida; Florin,9999,0,9999,0
1715664477253,CLRE 259,A00,507211,Patel; Hemal,9996,0,9999,3
1715664478280,CLRE 260,A00,507221,Cuomo; Raphael Eduardo,9999,0,9999,0
1715664479305,CLRE 297,001,507242,Cuomo; Raphael Eduardo,9999,0,9999,0
1715664480333,COGS 197,001,638244,Voytek; Bradley Thomas,9997,0,9999,2
1715664481361,CSE 191,A00,516875,Minnes Kemp; Mor Mia,9991,0,9999,8
1715664482386,CSE 197,001,637388,Minnes Kemp; Mor Mia,9992,0,9999,7
1715664483416,CSS 201S,A01,494383,Mignozzetti; Umberto,35,0,35,0
1715664484447,CSS 202S,A01,494387,Mignozzetti; Umberto,35,0,35,0
1715664485472,DSC 197,001,628532,Eldridge; Justin Matthew,9995,0,9999,4
1715664486499,EAP 100,A00,516065,Staff,9799,0,9999,200
1715664487526,ECE 45,A01,507414,Staff,32,0,60,28
1715664489576,ECE 111,A01,507420,Staff,11,0,50,39
1715664490602,ECE 197,001,548057,Sievenpiper; Daniel F.,9991,0,9999,8
1715664491632,EDS 115,A00,507243,Choi; Bailey Miyeon,6,0,28,22
1715664492658,EDS 117,A01,494379,Staff,0,6,34,35
1715664493683,EDS 125,A00,507246,Hopkins; Megan Beth,7,0,30,23
1715664494713,EDS 128A,A01,507264,Fargason; Sharon Gayle,5,0,26,21
1715664495741,EDS 128B,A01,507293,Pappas; Elizabeth,9,0,30,21
1715664496769,EDS 139,A00,507294,Fargason; Sharon Gayle,9,0,30,21
1715664496769,EDS 139,B00,507313,Pappas; Elizabeth,9,0,30,21
1715664497798,EDS 201,A00,507315,Staff,10,0,30,20
1715664498828,EDS 203,A01,507317,Halter; Christopher P.,10,0,30,20
1715664499852,EDS 204R,A01,507319,Halter; Christopher P.,0,3,30,30
1715664499852,EDS 204R,B01,507331,Heinzman; Erica M.,14,0,30,16
1715664500877,EDS 206R,A00,507332,Staff,0,4,30,30
1715664500877,EDS 206R,B00,507343,Staff,15,0,30,15
1715664501905,EDS 250,A00,507344,Hemans; Patricia Ann Benitez,20,0,40,20
1715664502930,EDS 281,A00,507345,Daly; Alan J.,18,0,18,0
1715664503955,EDS 284,A00,507350,Daly; Alan J.,16,0,16,0
1715664504986,EDS 286,A00,507359,Fine; Sarah,18,0,18,0
1715664506013,EDS 289C,A01,507361,Daly; Alan J.,18,0,18,0
1715664507038,EDS 290,A00,507366,Hofstetter; Carolyn,15,0,15,0
1715664508064,LIGM 5A,A00,507421,Fischer-Grunski; Eva K,17,0,20,3
1715664509093,LIGM 5B,A00,507423,Fischer-Grunski; Eva K,19,0,20,1
1715664510121,LIGM 5C,A00,507425,Fischer-Grunski; Eva K,19,0,20,1
1715664511146,LIIT 5AS,A00,507427,Carnelos; Chiara,20,0,20,0
1715664512172,LIIT 5BS,A00,507430,Carnelos; Chiara,20,0,20,0
1715664513197,LIIT 5CS,A00,507432,Carnelos; Chiara,20,0,20,0
1715664514228,LISP 5A,A00,507541,Munoz Sanchez; Alicia,11,0,20,9
1715664515255,LISP 5B,A00,507671,Munoz Sanchez; Alicia,8,0,20,12
1715664516283,LISP 5C,A00,507696,Munoz Sanchez; Alicia,7,0,20,13
1715664517312,MAE 197,001,528363,Boechler; Nicholas Sebastia,9998,0,9999,1
1715664518341,MATH 197,001,523477,Kedlaya; Kiran S.,9994,0,9999,5
1715664518341,MATH 197,002,563811,Zhang; Danna,9994,0,9999,5
1715664518341,MATH 197,003,628552,Dumitriu; Ioana,9998,0,9999,1
1715664518341,MATH 197,004,660885,Floyd; Eric,9998,0,9999,1
1715664519368,MCWP 40R,A00,518780,Staff,1,0,20,19
1715664519368,MCWP 40R,B00,518781,Carter; Jennifer A,9,0,20,11
1715664519368,MCWP 40R,C00,518783,Smith; Haydee Marie,5,0,20,15
1715664520399,MCWP 50R,A00,518791,Redela; Pamela Morgan,0,1,20,20
1715664520399,MCWP 50R,B00,518792,Krone; Jarret,0,2,20,20
1715664520399,MCWP 50R,C00,518793,Staff,0,4,20,20
1715664520399,MCWP 50R,D00,518794,Morshed; Michael James,0,2,20,20
1715664520399,MCWP 50R,E00,518795,Carter; Andrea L,0,2,20,20
1715664520399,MCWP 50R,F00,518796,Miller; Elizabeth Deen,0,1,20,20
1715664520399,MCWP 50R,G00,518797,Guillen; Melinda,0,1,20,20
1715664521428,MMW 12R,A01,514034,Herbst; Matthew,0,2,16,16
1715664521428,MMW 12R,A02,514035,Herbst; Matthew,0,0,16,16
1715664522460,MMW 13R,A01,514037,Staff,0,5,16,16
1715664522460,MMW 13R,A02,514039,Staff,0,5,16,16
1715664522460,MMW 13R,A03,628519,Staff,0,4,16,16
1715664524513,SIO 295LS,A00,523233,Staff,10,0,30,20
1715664525537,SIO 295S,A00,523232,Staff,10,0,30,20
1715664526570,SIOC 290S,A01,637330,Merrifield; Mark A,21,0,30,9
1715664527596,SIOC 291S,A01,637333,Gabriel; Corey John,21,0,30,9
1715664528624,SOCI 117,A01,494376,Staff,0,5,5,5
1715664529652,WES 237B,A00,494380,Staff,10,0,20,10
1715664531735,AESE 279B,A00,494370,Wade; Jon P,0,0,33,33
1715664532762,AIP 97,001,660915,Van Den Einde; Yael Dahlia,9998,0,9999,1
1715664533795,AIP 197,001,627712,Vespa; Emanuel Ignacio,9995,0,9999,4
1715664533795,AIP 197,002,650778,Amir; On,9998,0,9999,1
1715664533795,AIP 197,003,650933,Avenancio-Leon; Carlos,9998,0,9999,1
1715664533795,AIP 197,004,658530,Heyman; Gail D.,9998,0,9999,1
1715664533795,AIP 197,005,658631,Neal; Sonya E,9998,0,9999,1
1715664533795,AIP 197,006,658671,Du; Songzi,9998,0,9999,1
1715664534821,ANAR 135S,A00,494369,Braswell; Geoffrey E.,0,0,0,0
1715664535847,BENG 196,001,628496,Engler; Adam J.,9998,0,9999,1
1715664535847,BENG 196,002,660916,Watson; John Thomas,9998,0,9999,1
1715664536876,BISP 197,001,650773,Wilhelm; James E.,9994,0,9999,5
1715664536876,BISP 197,002,658904,Coleman; Aaron B.,9998,0,9999,1
1715664537904,CAT 124RS,A01,519847,Geibel; William,0,0,20,20
1715664538931,CAT 125RS,A01,515971,Geibel; William,0,0,20,20
1715664539956,CLRE 250,A00,511389,Morris; Sheldon,9992,0,9999,7
1715664540987,CLRE 251,A00,507176,Mehta; Ravindra L.,9992,0,9999,7
1715664540987,CLRE 251,B00,511410,Mehta; Ravindra L.,9998,0,9999,1
1715664542015,CLRE 252,A00,507189,Cuomo; Raphael Eduardo,9994,0,9999,5
1715664543042,CLRE 253,A00,507199,Vaida; Florin,9994,0,9999,5
1715664543042,CLRE 253,B00,507202,Vaida; Florin,9999,0,9999,0
1715664544067,CLRE 259,A00,507211,Patel; Hemal,9996,0,9999,3
1715664545093,CLRE 260,A00,507221,Cuomo; Raphael Eduardo,9999,0,9999,0
1715664546123,CLRE 297,001,507242,Cuomo; Raphael Eduardo,9999,0,9999,0
1715664547150,COGS 197,001,638244,Voytek; Bradley Thomas,9997,0,9999,2
1715664548177,CSE 191,A00,516875,Minnes Kemp; Mor Mia,9991,0,9999,8
1715664549203,CSE 197,001,637388,Minnes Kemp; Mor Mia,9992,0,9999,7
1715664550232,CSS 201S,A01,494383,Mignozzetti; Umberto,35,0,35,0
1715664551258,CSS 202S,A01,494387,Mignozzetti; Umberto,35,0,35,0
1715664552288,DSC 197,001,628532,Eldridge; Justin Matthew,9995,0,9999,4
1715664553313,EAP 100,A00,516065,Staff,9799,0,9999,200
1715664554341,ECE 45,A01,507414,Staff,32,0,60,28
1715664556446,ECE 111,A01,507420,Staff,11,0,50,39
1715664557473,ECE 197,001,548057,Sievenpiper; Daniel F.,9991,0,9999,8
1715664558501,EDS 115,A00,507243,Choi; Bailey Miyeon,6,0,28,22
1715664559526,EDS 117,A01,494379,Staff,0,6,34,35
1715664560551,EDS 125,A00,507246,Hopkins; Megan Beth,7,0,30,23
1715664561575,EDS 128A,A01,507264,Fargason; Sharon Gayle,5,0,26,21
1715664562602,EDS 128B,A01,507293,Pappas; Elizabeth,9,0,30,21
1715664563629,EDS 139,A00,507294,Fargason; Sharon Gayle,9,0,30,21
1715664563629,EDS 139,B00,507313,Pappas; Elizabeth,9,0,30,21
1715664564655,EDS 201,A00,507315,Staff,10,0,30,20
1715664565681,EDS 203,A01,507317,Halter; Christopher P.,10,0,30,20
1715664566710,EDS 204R,A01,507319,Halter; Christopher P.,0,3,30,30
1715664566710,EDS 204R,B01,507331,Heinzman; Erica M.,14,0,30,16
1715664567734,EDS 206R,A00,507332,Staff,0,4,30,30
1715664567734,EDS 206R,B00,507343,Staff,15,0,30,15
1715664568759,EDS 250,A00,507344,Hemans; Patricia Ann Benitez,20,0,40,20
1715664569784,EDS 281,A00,507345,Daly; Alan J.,18,0,18,0
1715664570809,EDS 284,A00,507350,Daly; Alan J.,16,0,16,0
1715664571834,EDS 286,A00,507359,Fine; Sarah,18,0,18,0
1715664572858,EDS 289C,A01,507361,Daly; Alan J.,18,0,18,0
1715664573901,EDS 290,A00,507366,Hofstetter; Carolyn,15,0,15,0
1715664574937,LIGM 5A,A00,507421,Fischer-Grunski; Eva K,17,0,20,3
1715664575968,LIGM 5B,A00,507423,Fischer-Grunski; Eva K,19,0,20,1
1715664577000,LIGM 5C,A00,507425,Fischer-Grunski; Eva K,19,0,20,1
1715664578080,LIIT 5AS,A00,507427,Carnelos; Chiara,20,0,20,0
1715664579105,LIIT 5BS,A00,507430,Carnelos; Chiara,20,0,20,0
1715664580134,LIIT 5CS,A00,507432,Carnelos; Chiara,20,0,20,0
1715664581161,LISP 5A,A00,507541,Munoz Sanchez; Alicia,11,0,20,9
1715664582185,LISP 5B,A00,507671,Munoz Sanchez; Alicia,8,0,20,12
1715664583213,LISP 5C,A00,507696,Munoz Sanchez; Alicia,7,0,20,13
1715664584242,MAE 197,001,528363,Boechler; Nicholas Sebastia,9998,0,9999,1
1715664585272,MATH 197,001,523477,Kedlaya; Kiran S.,9994,0,9999,5
1715664585272,MATH 197,002,563811,Zhang; Danna,9994,0,9999,5
1715664585272,MATH 197,003,628552,Dumitriu; Ioana,9998,0,9999,1
1715664585272,MATH 197,004,660885,Floyd; Eric,9998,0,9999,1
1715664586299,MCWP 40R,A00,518780,Staff,1,0,20,19
1715664586299,MCWP 40R,B00,518781,Carter; Jennifer A,9,0,20,11
1715664586299,MCWP 40R,C00,518783,Smith; Haydee Marie,5,0,20,15
1715664587328,MCWP 50R,A00,518791,Redela; Pamela Morgan,0,1,20,20
1715664587328,MCWP 50R,B00,518792,Krone; Jarret,0,2,20,20
1715664587328,MCWP 50R,C00,518793,Staff,0,4,20,20
1715664587328,MCWP 50R,D00,518794,Morshed; Michael James,0,2,20,20
1715664587328,MCWP 50R,E00,518795,Carter; Andrea L,0,2,20,20
1715664587328,MCWP 50R,F00,518796,Miller; Elizabeth Deen,0,1,20,20
1715664587328,MCWP 50R,G00,518797,Guillen; Melinda,0,1,20,20
1715664588352,MMW 12R,A01,514034,Herbst; Matthew,0,2,16,16
1715664588352,MMW 12R,A02,514035,Herbst; Matthew,0,0,16,16
1715664589378,MMW 13R,A01,514037,Staff,0,5,16,16
1715664589378,MMW 13R,A02,514039,Staff,0,5,16,16
1715664589378,MMW 13R,A03,628519,Staff,0,4,16,16
1715664591432,SIO 295LS,A00,523233,Staff,10,0,30,20
1715664592457,SIO 295S,A00,523232,Staff,10,0,30,20
1715664593483,SIOC 290S,A01,637330,Merrifield; Mark A,21,0,30,9
1715664594509,SIOC 291S,A01,637333,Gabriel; Corey John,21,0,30,9
1715664595533,SOCI 117,A01,494376,Staff,0,5,5,5
1715664596561,WES 237B,A00,494380,Staff,10,0,20,10
1715664598632,AESE 279B,A00,494370,Wade; Jon P,0,0,33,33
1715664599657,AIP 97,001,660915,Van Den Einde; Yael Dahlia,9998,0,9999,1
1715664600684,AIP 197,001,627712,Vespa; Emanuel Ignacio,9995,0,9999,4
1715664600684,AIP 197,002,650778,Amir; On,9998,0,9999,1
1715664600684,AIP 197,003,650933,Avenancio-Leon; Carlos,9998,0,9999,1
1715664600684,AIP 197,004,658530,Heyman; Gail D.,9998,0,9999,1
1715664600684,AIP 197,005,658631,Neal; Sonya E,9998,0,9999,1
1715664600684,AIP 197,006,658671,Du; Songzi,9998,0,9999,1
1715664601709,ANAR 135S,A00,494369,Braswell; Geoffrey E.,0,0,0,0
1715664602737,BENG 196,001,628496,Engler; Adam J.,9998,0,9999,1
1715664602737,BENG 196,002,660916,Watson; John Thomas,9998,0,9999,1
1715664603770,BISP 197,001,650773,Wilhelm; James E.,9994,0,9999,5
1715664603770,BISP 197,002,658904,Coleman; Aaron B.,9998,0,9999,1
1715664604796,CAT 124RS,A01,519847,Geibel; William,0,0,20,20
1715664605821,CAT 125RS,A01,515971,Geibel; William,0,0,20,20
1715664606846,CLRE 250,A00,511389,Morris; Sheldon,9992,0,9999,7
1715664607876,CLRE 251,A00,507176,Mehta; Ravindra L.,9992,0,9999,7
1715664607876,CLRE 251,B00,511410,Mehta; Ravindra L.,9998,0,9999,1
1715664608902,CLRE 252,A00,507189,Cuomo; Raphael Eduardo,9994,0,9999,5
1715664609932,CLRE 253,A00,507199,Vaida; Florin,9994,0,9999,5
1715664609932,CLRE 253,B00,507202,Vaida; Florin,9999,0,9999,0
1715664610957,CLRE 259,A00,507211,Patel; Hemal,9996,0,9999,3
1715664611982,CLRE 260,A00,507221,Cuomo; Raphael Eduardo,9999,0,9999,0
1715664613008,CLRE 297,001,507242,Cuomo; Raphael Eduardo,9999,0,9999,0
1715664614033,COGS 197,001,638244,Voytek; Bradley Thomas,9997,0,9999,2
1715664615060,CSE 191,A00,516875,Minnes Kemp; Mor Mia,9991,0,9999,8
1715664616086,CSE 197,001,637388,Minnes Kemp; Mor Mia,9992,0,9999,7
1715664617112,CSS 201S,A01,494383,Mignozzetti; Umberto,35,0,35,0
1715664618138,CSS 202S,A01,494387,Mignozzetti; Umberto,35,0,35,0
1715664619166,DSC 197,001,628532,Eldridge; Justin Matthew,9995,0,9999,4
1715664620190,EAP 100,A00,516065,Staff,9799,0,9999,200
1715664621216,ECE 45,A01,507414,Staff,32,0,60,28
1715664623272,ECE 111,A01,507420,Staff,11,0,50,39
1715664624299,ECE 197,001,548057,Sievenpiper; Daniel F.,9991,0,9999,8
1715664625330,EDS 115,A00,507243,Choi; Bailey Miyeon,6,0,28,22
1715664626360,EDS 117,A01,494379,Staff,0,6,34,35
1715664627388,EDS 125,A00,507246,Hopkins; Megan Beth,7,0,30,23
1715664628417,EDS 128A,A01,507264,Fargason; Sharon Gayle,5,0,26,21
1715664629444,EDS 128B,A01,507293,Pappas; Elizabeth,9,0,30,21
1715664630470,EDS 139,A00,507294,Fargason; Sharon Gayle,9,0,30,21
1715664630470,EDS 139,B00,507313,Pappas; Elizabeth,9,0,30,21
1715664631498,EDS 201,A00,507315,Staff,10,0,30,20
1715664632527,EDS 203,A01,507317,Halter; Christopher P.,10,0,30,20
1715664633556,EDS 204R,A01,507319,Halter; Christopher P.,0,3,30,30
1715664633556,EDS 204R,B01,507331,Heinzman; Erica M.,14,0,30,16
1715664634580,EDS 206R,A00,507332,Staff,0,4,30,30
1715664634580,EDS 206R,B00,507343,Staff,15,0,30,15
1715664635604,EDS 250,A00,507344,Hemans; Patricia Ann Benitez,20,0,40,20
1715664636634,EDS 281,A00,507345,Daly; Alan J.,18,0,18,0
1715664637659,EDS 284,A00,507350,Daly; Alan J.,16,0,16,0
1715664638686,EDS 286,A00,507359,Fine; Sarah,18,0,18,0
1715664639714,EDS 289C,A01,507361,Daly; Alan J.,18,0,18,0
1715664640739,EDS 290,A00,507366,Hofstetter; Carolyn,15,0,15,0
1715664641767,LIGM 5A,A00,507421,Fischer-Grunski; Eva K,17,0,20,3
1715664642792,LIGM 5B,A00,507423,Fischer-Grunski; Eva K,19,0,20,1
1715664643818,LIGM 5C,A00,507425,Fischer-Grunski; Eva K,19,0,20,1
1715664644848,LIIT 5AS,A00,507427,Carnelos; Chiara,20,0,20,0
1715664645874,LIIT 5BS,A00,507430,Carnelos; Chiara,20,0,20,0
1715664646900,LIIT 5CS,A00,507432,Carnelos; Chiara,20,0,20,0
1715664647925,LISP 5A,A00,507541,Munoz Sanchez; Alicia,11,0,20,9
1715664648951,LISP 5B,A00,507671,Munoz Sanchez; Alicia,8,0,20,12
1715664649977,LISP 5C,A00,507696,Munoz Sanchez; Alicia,7,0,20,13
1715664651005,MAE 197,001,528363,Boechler; Nicholas Sebastia,9998,0,9999,1
1715664652034,MATH 197,001,523477,Kedlaya; Kiran S.,9994,0,9999,5
1715664652034,MATH 197,002,563811,Zhang; Danna,9994,0,9999,5
1715664652034,MATH 197,003,628552,Dumitriu; Ioana,9998,0,9999,1
1715664652034,MATH 197,004,660885,Floyd; Eric,9998,0,9999,1
1715664653061,MCWP 40R,A00,518780,Staff,1,0,20,19
1715664653061,MCWP 40R,B00,518781,Carter; Jennifer A,9,0,20,11
1715664653061,MCWP 40R,C00,518783,Smith; Haydee Marie,5,0,20,15
1715664654090,MCWP 50R,A00,518791,Redela; Pamela Morgan,0,1,20,20
1715664654090,MCWP 50R,B00,518792,Krone; Jarret,0,2,20,20
1715664654090,MCWP 50R,C00,518793,Staff,0,4,20,20
1715664654090,MCWP 50R,D00,518794,Morshed; Michael James,0,2,20,20
1715664654090,MCWP 50R,E00,518795,Carter; Andrea L,0,2,20,20
1715664654090,MCWP 50R,F00,518796,Miller; Elizabeth Deen,0,1,20,20
1715664654090,MCWP 50R,G00,518797,Guillen; Melinda,0,1,20,20
1715664655116,MMW 12R,A01,514034,Herbst; Matthew,0,2,16,16
1715664655116,MMW 12R,A02,514035,Herbst; Matthew,0,0,16,16
1715664656144,MMW 13R,A01,514037,Staff,0,5,16,16
1715664656144,MMW 13R,A02,514039,Staff,0,5,16,16
1715664656144,MMW 13R,A03,628519,Staff,0,4,16,16
1715664658196,SIO 295LS,A00,523233,Staff,10,0,30,20
1715664659220,SIO 295S,A00,523232,Staff,10,0,30,20
1715664660252,SIOC 290S,A01,637330,Merrifield; Mark A,21,0,30,9
1715664661281,SIOC 291S,A01,637333,Gabriel; Corey John,21,0,30,9
1715664662310,SOCI 117,A01,494376,Staff,0,5,5,5
1715664663336,WES 237B,A00,494380,Staff,10,0,20,10
1715664665405,AESE 279B,A00,494370,Wade; Jon P,0,0,33,33
1715664666431,AIP 97,001,660915,Van Den Einde; Yael Dahlia,9998,0,9999,1
1715664667469,AIP 197,001,627712,Vespa; Emanuel Ignacio,9995,0,9999,4
1715664667469,AIP 197,002,650778,Amir; On,9998,0,9999,1
1715664667469,AIP 197,003,650933,Avenancio-Leon; Carlos,9998,0,9999,1
1715664667469,AIP 197,004,658530,Heyman; Gail D.,9998,0,9999,1
1715664667469,AIP 197,005,658631,Neal; Sonya E,9998,0,9999,1
1715664667469,AIP 197,006,658671,Du; Songzi,9998,0,9999,1
1715664668494,ANAR 135S,A00,494369,Braswell; Geoffrey E.,0,0,0,0
1715664669528,BENG 196,001,628496,Engler; Adam J.,9998,0,9999,1
1715664669528,BENG 196,002,660916,Watson; John Thomas,9998,0,9999,1
1715664670558,BISP 197,001,650773,Wilhelm; James E.,9994,0,9999,5
1715664670558,BISP 197,002,658904,Coleman; Aaron B.,9998,0,9999,1
1715664671582,CAT 124RS,A01,519847,Geibel; William,0,0,20,20
1715664672607,CAT 125RS,A01,515971,Geibel; William,0,0,20,20
1715664673632,CLRE 250,A00,511389,Morris; Sheldon,9992,0,9999,7
1715664674659,CLRE 251,A00,507176,Mehta; Ravindra L.,9992,0,9999,7
1715664674659,CLRE 251,B00,511410,Mehta; Ravindra L.,9998,0,9999,1
1715664675683,CLRE 252,A00,507189,Cuomo; Raphael Eduardo,9994,0,9999,5
1715664676712,CLRE 253,A00,507199,Vaida; Florin,9994,0,9999,5
1715664676712,CLRE 253,B00,507202,Vaida; Florin,9999,0,9999,0
1715664677740,CLRE 259,A00,507211,Patel; Hemal,9996,0,9999,3
1715664678768,CLRE 260,A00,507221,Cuomo; Raphael Eduardo,9999,0,9999,0
1715664679792,CLRE 297,001,507242,Cuomo; Raphael Eduardo,9999,0,9999,0
1715664680818,COGS 197,001,638244,Voytek; Bradley Thomas,9997,0,9999,2
1715664681899,CSE 191,A00,516875,Minnes Kemp; Mor Mia,9991,0,9999,8
1715664682924,CSE 197,001,637388,Minnes Kemp; Mor Mia,9992,0,9999,7
1715664683949,CSS 201S,A01,494383,Mignozzetti; Umberto,35,0,35,0
1715664684974,CSS 202S,A01,494387,Mignozzetti; Umberto,35,0,35,0
1715664686000,DSC 197,001,628532,Eldridge; Justin Matthew,9995,0,9999,4
1715664687028,EAP 100,A00,516065,Staff,9799,0,9999,200
1715664688060,ECE 45,A01,507414,Staff,32,0,60,28
1715664690117,ECE 111,A01,507420,Staff,11,0,50,39
1715664691147,ECE 197,001,548057,Sievenpiper; Daniel F.,9991,0,9999,8
1715664692173,EDS 115,A00,507243,Choi; Bailey Miyeon,6,0,28,22
1715664693199,EDS 117,A01,494379,Staff,0,6,34,35
1715664694224,EDS 125,A00,507246,Hopkins; Megan Beth,7,0,30,23
1715664695253,EDS 128A,A01,507264,Fargason; Sharon Gayle,5,0,26,21
1715664696382,EDS 128B,A01,507293,Pappas; Elizabeth,9,0,30,21
1715664697409,EDS 139,A00,507294,Fargason; Sharon Gayle,9,0,30,21
1715664697409,EDS 139,B00,507313,Pappas; Elizabeth,9,0,30,21
1715664698434,EDS 201,A00,507315,Staff,10,0,30,20
1715664699460,EDS 203,A01,507317,Halter; Christopher P.,10,0,30,20
1715664700486,EDS 204R,A01,507319,Halter; Christopher P.,0,3,30,30
1715664700486,EDS 204R,B01,507331,Heinzman; Erica M.,14,0,30,16
1715664701512,EDS 206R,A00,507332,Staff,0,4,30,30
1715664701512,EDS 206R,B00,507343,Staff,15,0,30,15
1715664702542,EDS 250,A00,507344,Hemans; Patricia Ann Benitez,20,0,40,20
1715664703568,EDS 281,A00,507345,Daly; Alan J.,18,0,18,0
1715664704596,EDS 284,A00,507350,Daly; Alan J.,16,0,16,0
1715664705623,EDS 286,A00,507359,Fine; Sarah,18,0,18,0
1715664706649,EDS 289C,A01,507361,Daly; Alan J.,18,0,18,0
1715664707674,EDS 290,A00,507366,Hofstetter; Carolyn,15,0,15,0
1715664708701,LIGM 5A,A00,507421,Fischer-Grunski; Eva K,17,0,20,3
1715664709728,LIGM 5B,A00,507423,Fischer-Grunski; Eva K,19,0,20,1
1715664710757,LIGM 5C,A00,507425,Fischer-Grunski; Eva K,19,0,20,1
1715664711784,LIIT 5AS,A00,507427,Carnelos; Chiara,20,0,20,0
1715664712813,LIIT 5BS,A00,507430,Carnelos; Chiara,20,0,20,0
1715664713837,LIIT 5CS,A00,507432,Carnelos; Chiara,20,0,20,0
1715664714862,LISP 5A,A00,507541,Munoz Sanchez; Alicia,11,0,20,9
1715664715890,LISP 5B,A00,507671,Munoz Sanchez; Alicia,8,0,20,12
1715664716916,LISP 5C,A00,507696,Munoz Sanchez; Alicia,7,0,20,13
1715664717943,MAE 197,001,528363,Boechler; Nicholas Sebastia,9998,0,9999,1
1715664718972,MATH 197,001,523477,Kedlaya; Kiran S.,9994,0,9999,5
1715664718972,MATH 197,002,563811,Zhang; Danna,9994,0,9999,5
1715664718972,MATH 197,003,628552,Dumitriu; Ioana,9998,0,9999,1
1715664718972,MATH 197,004,660885,Floyd; Eric,9998,0,9999,1
1715664720005,MCWP 40R,A00,518780,Staff,1,0,20,19
1715664720005,MCWP 40R,B00,518781,Carter; Jennifer A,9,0,20,11
1715664720005,MCWP 40R,C00,518783,Smith; Haydee Marie,5,0,20,15
1715664721033,MCWP 50R,A00,518791,Redela; Pamela Morgan,0,1,20,20
1715664721033,MCWP 50R,B00,518792,Krone; Jarret,0,2,20,20
1715664721033,MCWP 50R,C00,518793,Staff,0,4,20,20
1715664721033,MCWP 50R,D00,518794,Morshed; Michael James,0,2,20,20
1715664721033,MCWP 50R,E00,518795,Carter; Andrea L,0,2,20,20
1715664721033,MCWP 50R,F00,518796,Miller; Elizabeth Deen,0,1,20,20
1715664721033,MCWP 50R,G00,518797,Guillen; Melinda,0,1,20,20
1715664722058,MMW 12R,A01,514034,Herbst; Matthew,0,2,16,16
1715664722058,MMW 12R,A02,514035,Herbst; Matthew,0,0,16,16
1715664723084,MMW 13R,A01,514037,Staff,0,5,16,16
1715664723084,MMW 13R,A02,514039,Staff,0,5,16,16
1715664723084,MMW 13R,A03,628519,Staff,0,4,16,16
1715664725137,SIO 295LS,A00,523233,Staff,10,0,30,20
1715664726165,SIO 295S,A00,523232,Staff,10,0,30,20
1715664727196,SIOC 290S,A01,637330,Merrifield; Mark A,21,0,30,9
1715664728221,SIOC 291S,A01,637333,Gabriel; Corey John,21,0,30,9
1715664729252,SOCI 117,A01,494376,Staff,0,5,5,5
1715664730278,WES 237B,A00,494380,Staff,10,0,20,10
1715664732347,AESE 279B,A00,494370,Wade; Jon P,0,0,33,33
1715664733377,AIP 97,001,660915,Van Den Einde; Yael Dahlia,9998,0,9999,1
1715664734404,AIP 197,001,627712,Vespa; Emanuel Ignacio,9995,0,9999,4
1715664734404,AIP 197,002,650778,Amir; On,9998,0,9999,1
1715664734404,AIP 197,003,650933,Avenancio-Leon; Carlos,9998,0,9999,1
1715664734404,AIP 197,004,658530,Heyman; Gail D.,9998,0,9999,1
1715664734404,AIP 197,005,658631,Neal; Sonya E,9998,0,9999,1
1715664734404,AIP 197,006,658671,Du; Songzi,9998,0,9999,1
1715664735432,ANAR 135S,A00,494369,Braswell; Geoffrey E.,0,0,0,0
1715664736456,BENG 196,001,628496,Engler; Adam J.,9998,0,9999,1
1715664736456,BENG 196,002,660916,Watson; John Thomas,9998,0,9999,1
1715664737482,BISP 197,001,650773,Wilhelm; James E.,9994,0,9999,5
1715664737482,BISP 197,002,658904,Coleman; Aaron B.,9998,0,9999,1
1715664738509,CAT 124RS,A01,519847,Geibel; William,0,0,20,20
1715664739533,CAT 125RS,A01,515971,Geibel; William,0,0,20,20
1715664740558,CLRE 250,A00,511389,Morris; Sheldon,9992,0,9999,7
1715664741588,CLRE 251,A00,507176,Mehta; Ravindra L.,9992,0,9999,7
1715664741588,CLRE 251,B00,511410,Mehta; Ravindra L.,9998,0,9999,1
1715664742615,CLRE 252,A00,507189,Cuomo; Raphael Eduardo,9994,0,9999,5
1715664743640,CLRE 253,A00,507199,Vaida; Florin,9994,0,9999,5
1715664743640,CLRE 253,B00,507202,Vaida; Florin,9999,0,9999,0
1715664744728,CLRE 259,A00,507211,Patel; Hemal,9996,0,9999,3
1715664745752,CLRE 260,A00,507221,Cuomo; Raphael Eduardo,9999,0,9999,0
1715664746780,CLRE 297,001,507242,Cuomo; Raphael Eduardo,9999,0,9999,0
1715664747806,COGS 197,001,638244,Voytek; Bradley Thomas,9997,0,9999,2
1715664748832,CSE 191,A00,516875,Minnes Kemp; Mor Mia,9991,0,9999,8
1715664749862,CSE 197,001,637388,Minnes Kemp; Mor Mia,9992,0,9999,7
1715664750892,CSS 201S,A01,494383,Mignozzetti; Umberto,35,0,35,0
1715664751921,CSS 202S,A01,494387,Mignozzetti; Umberto,35,0,35,0
1715664752950,DSC 197,001,628532,Eldridge; Justin Matthew,9995,0,9999,4
1715664753975,EAP 100,A00,516065,Staff,9799,0,9999,200
1715664755002,ECE 45,A01,507414,Staff,32,0,60,28
1715664757054,ECE 111,A01,507420,Staff,11,0,50,39
1715664758094,ECE 197,001,548057,Sievenpiper; Daniel F.,9991,0,9999,8
1715664759121,EDS 115,A00,507243,Choi; Bailey Miyeon,6,0,28,22
1715664760150,EDS 117,A01,494379,Staff,0,6,34,35
1715664761175,EDS 125,A00,507246,Hopkins; Megan Beth,7,0,30,23
1715664762201,EDS 128A,A01,507264,Fargason; Sharon Gayle,5,0,26,21
1715664763230,EDS 128B,A01,507293,Pappas; Elizabeth,9,0,30,21
1715664764258,EDS 139,A00,507294,Fargason; Sharon Gayle,9,0,30,21
1715664764258,EDS 139,B00,507313,Pappas; Elizabeth,9,0,30,21
1715664765286,EDS 201,A00,507315,Staff,10,0,30,20
1715664766312,EDS 203,A01,507317,Halter; Christopher P.,10,0,30,20
1715664767339,EDS 204R,A01,507319,Halter; Christopher P.,0,3,30,30
1715664767339,EDS 204R,B01,507331,Heinzman; Erica M.,14,0,30,16
1715664768367,EDS 206R,A00,507332,Staff,0,4,30,30
1715664768367,EDS 206R,B00,507343,Staff,15,0,30,15
1715664769397,EDS 250,A00,507344,Hemans; Patricia Ann Benitez,20,0,40,20
1715664770422,EDS 281,A00,507345,Daly; Alan J.,18,0,18,0
1715664771447,EDS 284,A00,507350,Daly; Alan J.,16,0,16,0
1715664772475,EDS 286,A00,507359,Fine; Sarah,18,0,18,0
1715664773500,EDS 289C,A01,507361,Daly; Alan J.,18,0,18,0
1715664774525,EDS 290,A00,507366,Hofstetter; Carolyn,15,0,15,0
1715664775553,LIGM 5A,A00,507421,Fischer-Grunski; Eva K,17,0,20,3
1715664776580,LIGM 5B,A00,507423,Fischer-Grunski; Eva K,19,0,20,1
1715664777607,LIGM 5C,A00,507425,Fischer-Grunski; Eva K,19,0,20,1
1715664778634,LIIT 5AS,A00,507427,Carnelos; Chiara,20,0,20,0
1715664779660,LIIT 5BS,A00,507430,Carnelos; Chiara,20,0,20,0
1715664780690,LIIT 5CS,A00,507432,Carnelos; Chiara,20,0,20,0
1715664781718,LISP 5A,A00,507541,Munoz Sanchez; Alicia,11,0,20,9
1715664782744,LISP 5B,A00,507671,Munoz Sanchez; Alicia,8,0,20,12
1715664783769,LISP 5C,A00,507696,Munoz Sanchez; Alicia,7,0,20,13
1715664784795,MAE 197,001,528363,Boechler; Nicholas Sebastia,9998,0,9999,1
1715664785879,MATH 197,001,523477,Kedlaya; Kiran S.,9994,0,9999,5
1715664785879,MATH 197,002,563811,Zhang; Danna,9994,0,9999,5
1715664785879,MATH 197,003,628552,Dumitriu; Ioana,9998,0,9999,1
1715664785879,MATH 197,004,660885,Floyd; Eric,9998,0,9999,1
1715664786905,MCWP 40R,A00,518780,Staff,1,0,20,19
1715664786905,MCWP 40R,B00,518781,Carter; Jennifer A,9,0,20,11
1715664786905,MCWP 40R,C00,518783,Smith; Haydee Marie,5,0,20,15
1715664787934,MCWP 50R,A00,518791,Redela; Pamela Morgan,0,1,20,20
1715664787934,MCWP 50R,B00,518792,Krone; Jarret,0,2,20,20
1715664787934,MCWP 50R,C00,518793,Staff,0,4,20,20
1715664787934,MCWP 50R,D00,518794,Morshed; Michael James,0,2,20,20
1715664787934,MCWP 50R,E00,518795,Carter; Andrea L,0,2,20,20
1715664787934,MCWP 50R,F00,518796,Miller; Elizabeth Deen,0,1,20,20
1715664787934,MCWP 50R,G00,518797,Guillen; Melinda,0,1,20,20
1715664788964,MMW 12R,A01,514034,Herbst; Matthew,0,2,16,16
1715664788964,MMW 12R,A02,514035,Herbst; Matthew,0,0,16,16
1715664789988,MMW 13R,A01,514037,Staff,0,5,16,16
1715664789988,MMW 13R,A02,514039,Staff,0,5,16,16
1715664789988,MMW 13R,A03,628519,Staff,0,4,16,16
1715664792039,SIO 295LS,A00,523233,Staff,10,0,30,20
1715664793067,SIO 295S,A00,523232,Staff,10,0,30,20
1715664794097,SIOC 290S,A01,637330,Merrifield; Mark A,21,0,30,9
1715664795127,SIOC 291S,A01,637333,Gabriel; Corey John,21,0,30,9
1715664796153,SOCI 117,A01,494376,Staff,0,5,5,5
1715664797178,WES 237B,A00,494380,Staff,10,0,20,10
1715664799261,AESE 279B,A00,494370,Wade; Jon P,0,0,33,33
1715664800286,AIP 97,001,660915,Van Den Einde; Yael Dahlia,9998,0,9999,1
1715664801320,AIP 197,001,627712,Vespa; Emanuel Ignacio,9995,0,9999,4
1715664801320,AIP 197,002,650778,Amir; On,9998,0,9999,1
1715664801320,AIP 197,003,650933,Avenancio-Leon; Carlos,9998,0,9999,1
1715664801320,AIP 197,004,658530,Heyman; Gail D.,9998,0,9999,1
1715664801320,AIP 197,005,658631,Neal; Sonya E,9998,0,9999,1
1715664801320,AIP 197,006,658671,Du; Songzi,9998,0,9999,1
1715664802348,ANAR 135S,A00,494369,Braswell; Geoffrey E.,0,0,0,0
1715664803374,BENG 196,001,628496,Engler; Adam J.,9998,0,9999,1
1715664803374,BENG 196,002,660916,Watson; John Thomas,9998,0,9999,1
1715664804400,BISP 197,001,650773,Wilhelm; James E.,9994,0,9999,5
1715664804400,BISP 197,002,658904,Coleman; Aaron B.,9998,0,9999,1
1715664805425,CAT 124RS,A01,519847,Geibel; William,0,0,20,20
1715664806450,CAT 125RS,A01,515971,Geibel; William,0,0,20,20
1715664807478,CLRE 250,A00,511389,Morris; Sheldon,9992,0,9999,7
1715664808509,CLRE 251,A00,507176,Mehta; Ravindra L.,9992,0,9999,7
1715664808509,CLRE 251,B00,511410,Mehta; Ravindra L.,9998,0,9999,1
1715664809535,CLRE 252,A00,507189,Cuomo; Raphael Eduardo,9994,0,9999,5
1715664810563,CLRE 253,A00,507199,Vaida; Florin,9994,0,9999,5
1715664810563,CLRE 253,B00,507202,Vaida; Florin,9999,0,9999,0
1715664811592,CLRE 259,A00,507211,Patel; Hemal,9996,0,9999,3
1715664812616,CLRE 260,A00,507221,Cuomo; Raphael Eduardo,9999,0,9999,0
1715664813641,CLRE 297,001,507242,Cuomo; Raphael Eduardo,9999,0,9999,0
1715664814668,COGS 197,001,638244,Voytek; Bradley Thomas,9997,0,9999,2
1715664815693,CSE 191,A00,516875,Minnes Kemp; Mor Mia,9991,0,9999,8
1715664816718,CSE 197,001,637388,Minnes Kemp; Mor Mia,9992,0,9999,7
1715664818062,CSS 201S,A01,494383,Mignozzetti; Umberto,35,0,35,0
1715664819089,CSS 202S,A01,494387,Mignozzetti; Umberto,35,0,35,0
1715664820117,DSC 197,001,628532,Eldridge; Justin Matthew,9995,0,9999,4
1715664821142,EAP 100,A00,516065,Staff,9799,0,9999,200
1715664822170,ECE 45,A01,507414,Staff,32,0,60,28
1715664824221,ECE 111,A01,507420,Staff,11,0,50,39
1715664825247,ECE 197,001,548057,Sievenpiper; Daniel F.,9991,0,9999,8
1715664826275,EDS 115,A00,507243,Choi; Bailey Miyeon,6,0,28,22
1715664827306,EDS 117,A01,494379,Staff,0,6,34,35
1715664828332,EDS 125,A00,507246,Hopkins; Megan Beth,7,0,30,23
1715664829359,EDS 128A,A01,507264,Fargason; Sharon Gayle,5,0,26,21
1715664830385,EDS 128B,A01,507293,Pappas; Elizabeth,9,0,30,21
1715664831410,EDS 139,A00,507294,Fargason; Sharon Gayle,9,0,30,21
1715664831410,EDS 139,B00,507313,Pappas; Elizabeth,9,0,30,21
1715664832435,EDS 201,A00,507315,Staff,10,0,30,20
1715664833462,EDS 203,A01,507317,Halter; Christopher P.,10,0,30,20
1715664834491,EDS 204R,A01,507319,Halter; Christopher P.,0,3,30,30
1715664834491,EDS 204R,B01,507331,Heinzman; Erica M.,14,0,30,16
1715664835515,EDS 206R,A00,507332,Staff,0,4,30,30
1715664835515,EDS 206R,B00,507343,Staff,15,0,30,15
1715664836542,EDS 250,A00,507344,Hemans; Patricia Ann Benitez,20,0,40,20
1715664837568,EDS 281,A00,507345,Daly; Alan J.,18,0,18,0
1715664838594,EDS 284,A00,507350,Daly; Alan J.,16,0,16,0
1715664839625,EDS 286,A00,507359,Fine; Sarah,18,0,18,0
1715664840650,EDS 289C,A01,507361,Daly; Alan J.,18,0,18,0
1715664841674,EDS 290,A00,507366,Hofstetter; Carolyn,15,0,15,0
1715664842705,LIGM 5A,A00,507421,Fischer-Grunski; Eva K,17,0,20,3
1715664843734,LIGM 5B,A00,507423,Fischer-Grunski; Eva K,19,0,20,1
1715664844761,LIGM 5C,A00,507425,Fischer-Grunski; Eva K,19,0,20,1
1715664845790,LIIT 5AS,A00,507427,Carnelos; Chiara,20,0,20,0
1715664846816,LIIT 5BS,A00,507430,Carnelos; Chiara,20,0,20,0
1715664847841,LIIT 5CS,A00,507432,Carnelos; Chiara,20,0,20,0
1715664848871,LISP 5A,A00,507541,Munoz Sanchez; Alicia,11,0,20,9
1715664849896,LISP 5B,A00,507671,Munoz Sanchez; Alicia,8,0,20,12
1715664850922,LISP 5C,A00,507696,Munoz Sanchez; Alicia,7,0,20,13
1715664851949,MAE 197,001,528363,Boechler; Nicholas Sebastia,9998,0,9999,1
1715664852981,MATH 197,001,523477,Kedlaya; Kiran S.,9994,0,9999,5
1715664852981,MATH 197,002,563811,Zhang; Danna,9994,0,9999,5
1715664852981,MATH 197,003,628552,Dumitriu; Ioana,9998,0,9999,1
1715664852981,MATH 197,004,660885,Floyd; Eric,9998,0,9999,1
1715664854009,MCWP 40R,A00,518780,Staff,1,0,20,19
1715664854009,MCWP 40R,B00,518781,Carter; Jennifer A,9,0,20,11
1715664854009,MCWP 40R,C00,518783,Smith; Haydee Marie,5,0,20,15
1715664855038,MCWP 50R,A00,518791,Redela; Pamela Morgan,0,1,20,20
1715664855038,MCWP 50R,B00,518792,Krone; Jarret,0,2,20,20
1715664855038,MCWP 50R,C00,518793,Staff,0,4,20,20
1715664855038,MCWP 50R,D00,518794,Morshed; Michael James,0,2,20,20
1715664855038,MCWP 50R,E00,518795,Carter; Andrea L,0,2,20,20
1715664855038,MCWP 50R,F00,518796,Miller; Elizabeth Deen,0,1,20,20
1715664855038,MCWP 50R,G00,518797,Guillen; Melinda,0,1,20,20
1715664856065,MMW 12R,A01,514034,Herbst; Matthew,0,2,16,16
1715664856065,MMW 12R,A02,514035,Herbst; Matthew,0,0,16,16
1715664857091,MMW 13R,A01,514037,Staff,0,5,16,16
1715664857091,MMW 13R,A02,514039,Staff,0,5,16,16
1715664857091,MMW 13R,A03,628519,Staff,0,4,16,16
1715664859141,SIO 295LS,A00,523233,Staff,10,0,30,20
1715664860167,SIO 295S,A00,523232,Staff,10,0,30,20
1715664861194,SIOC 290S,A01,637330,Merrifield; Mark A,21,0,30,9
1715664862220,SIOC 291S,A01,637333,Gabriel; Corey John,21,0,30,9
1715664863248,SOCI 117,A01,494376,Staff,0,5,5,5
1715664864277,WES 237B,A00,494380,Staff,10,0,20,10
1715664866355,AESE 279B,A00,494370,Wade; Jon P,0,0,33,33
1715664867381,AIP 97,001,660915,Van Den Einde; Yael Dahlia,9998,0,9999,1
1715664868410,AIP 197,001,627712,Vespa; Emanuel Ignacio,9995,0,9999,4
1715664868410,AIP 197,002,650778,Amir; On,9998,0,9999,1
1715664868410,AIP 197,003,650933,Avenancio-Leon; Carlos,9998,0,9999,1
1715664868410,AIP 197,004,658530,Heyman; Gail D.,9998,0,9999,1
1715664868410,AIP 197,005,658631,Neal; Sonya E,9998,0,9999,1
1715664868410,AIP 197,006,658671,Du; Songzi,9998,0,9999,1
1715664869439,ANAR 135S,A00,494369,Braswell; Geoffrey E.,0,0,0,0
1715664870466,BENG 196,001,628496,Engler; Adam J.,9998,0,9999,1
1715664870466,BENG 196,002,660916,Watson; John Thomas,9998,0,9999,1
1715664871492,BISP 197,001,650773,Wilhelm; James E.,9994,0,9999,5
1715664871492,BISP 197,002,658904,Coleman; Aaron B.,9998,0,9999,1
1715664872518,CAT 124RS,A01,519847,Geibel; William,0,0,20,20
1715664873546,CAT 125RS,A01,515971,Geibel; William,0,0,20,20
1715664874576,CLRE 250,A00,511389,Morris; Sheldon,9992,0,9999,7
1715664875607,CLRE 251,A00,507176,Mehta; Ravindra L.,9992,0,9999,7
1715664875607,CLRE 251,B00,511410,Mehta; Ravindra L.,9998,0,9999,1
1715664876633,CLRE 252,A00,507189,Cuomo; Raphael Eduardo,9994,0,9999,5
1715664877663,CLRE 253,A00,507199,Vaida; Florin,9994,0,9999,5
1715664877663,CLRE 253,B00,507202,Vaida; Florin,9999,0,9999,0
1715664878692,CLRE 259,A00,507211,Patel; Hemal,9996,0,9999,3
1715664879720,CLRE 260,A00,507221,Cuomo; Raphael Eduardo,9999,0,9999,0
1715664880746,CLRE 297,001,507242,Cuomo; Raphael Eduardo,9999,0,9999,0
1715664881772,COGS 197,001,638244,Voytek; Bradley Thomas,9997,0,9999,2
1715664882802,CSE 191,A00,516875,Minnes Kemp; Mor Mia,9991,0,9999,8
1715664883827,CSE 197,001,637388,Minnes Kemp; Mor Mia,9992,0,9999,7
1715664884855,CSS 201S,A01,494383,Mignozzetti; Umberto,35,0,35,0
1715664885886,CSS 202S,A01,494387,Mignozzetti; Umberto,35,0,35,0
1715664886912,DSC 197,001,628532,Eldridge; Justin Matthew,9995,0,9999,4
1715664887935,EAP 100,A00,516065,Staff,9799,0,9999,200
1715664888969,ECE 45,A01,507414,Staff,32,0,60,28
1715664891075,ECE 111,A01,507420,Staff,11,0,50,39
1715664892100,ECE 197,001,548057,Sievenpiper; Daniel F.,9991,0,9999,8
1715664893132,EDS 115,A00,507243,Choi; Bailey Miyeon,6,0,28,22
1715664894157,EDS 117,A01,494379,Staff,0,6,34,35
1715664895187,EDS 125,A00,507246,Hopkins; Megan Beth,7,0,30,23
1715664896213,EDS 128A,A01,507264,Fargason; Sharon Gayle,5,0,26,21
1715664897240,EDS 128B,A01,507293,Pappas; Elizabeth,9,0,30,21
1715664898268,EDS 139,A00,507294,Fargason; Sharon Gayle,9,0,30,21
1715664898268,EDS 139,B00,507313,Pappas; Elizabeth,9,0,30,21
1715664899293,EDS 201,A00,507315,Staff,10,0,30,20
1715664900322,EDS 203,A01,507317,Halter; Christopher P.,10,0,30,20
1715664901349,EDS 204R,A01,507319,Halter; Christopher P.,0,3,30,30
1715664901349,EDS 204R,B01,507331,Heinzman; Erica M.,14,0,30,16
1715664902373,EDS 206R,A00,507332,Staff,0,4,30,30
1715664902373,EDS 206R,B00,507343,Staff,15,0,30,15
1715664903399,EDS 250,A00,507344,Hemans; Patricia Ann Benitez,20,0,40,20
1715664904428,EDS 281,A00,507345,Daly; Alan J.,18,0,18,0
1715664905453,EDS 284,A00,507350,Daly; Alan J.,16,0,16,0
1715664906479,EDS 286,A00,507359,Fine; Sarah,18,0,18,0
1715664907505,EDS 289C,A01,507361,Daly; Alan J.,18,0,18,0
1715664908532,EDS 290,A00,507366,Hofstetter; Carolyn,15,0,15,0
1715664909562,LIGM 5A,A00,507421,Fischer-Grunski; Eva K,17,0,20,3
1715664910591,LIGM 5B,A00,507423,Fischer-Grunski; Eva K,19,0,20,1
1715664911617,LIGM 5C,A00,507425,Fischer-Grunski; Eva K,19,0,20,1
1715664912643,LIIT 5AS,A00,507427,Carnelos; Chiara,20,0,20,0
1715664913672,LIIT 5BS,A00,507430,Carnelos; Chiara,20,0,20,0
1715664914698,LIIT 5CS,A00,507432,Carnelos; Chiara,20,0,20,0
1715664915724,LISP 5A,A00,507541,Munoz Sanchez; Alicia,11,0,20,9
1715664916754,LISP 5B,A00,507671,Munoz Sanchez; Alicia,8,0,20,12
1715664917784,LISP 5C,A00,507696,Munoz Sanchez; Alicia,7,0,20,13
1715664918813,MAE 197,001,528363,Boechler; Nicholas Sebastia,9998,0,9999,1
1715664919840,MATH 197,001,523477,Kedlaya; Kiran S.,9994,0,9999,5
1715664919840,MATH 197,002,563811,Zhang; Danna,9994,0,9999,5
1715664919840,MATH 197,003,628552,Dumitriu; Ioana,9998,0,9999,1
1715664919840,MATH 197,004,660885,Floyd; Eric,9998,0,9999,1
1715664920869,MCWP 40R,A00,518780,Staff,1,0,20,19
1715664920869,MCWP 40R,B00,518781,Carter; Jennifer A,9,0,20,11
1715664920869,MCWP 40R,C00,518783,Smith; Haydee Marie,5,0,20,15
1715664921896,MCWP 50R,A00,518791,Redela; Pamela Morgan,0,1,20,20
1715664921896,MCWP 50R,B00,518792,Krone; Jarret,0,2,20,20
1715664921896,MCWP 50R,C00,518793,Staff,0,4,20,20
1715664921896,MCWP 50R,D00,518794,Morshed; Michael James,0,2,20,20
1715664921896,MCWP 50R,E00,518795,Carter; Andrea L,0,2,20,20
1715664921896,MCWP 50R,F00,518796,Miller; Elizabeth Deen,0,1,20,20
1715664921896,MCWP 50R,G00,518797,Guillen; Melinda,0,1,20,20
1715664922922,MMW 12R,A01,514034,Herbst; Matthew,0,2,16,16
1715664922922,MMW 12R,A02,514035,Herbst; Matthew,0,0,16,16
1715664923947,MMW 13R,A01,514037,Staff,0,5,16,16
1715664923947,MMW 13R,A02,514039,Staff,0,5,16,16
1715664923947,MMW 13R,A03,628519,Staff,0,4,16,16
1715664926001,SIO 295LS,A00,523233,Staff,10,0,30,20
1715664927029,SIO 295S,A00,523232,Staff,10,0,30,20
1715664928060,SIOC 290S,A01,637330,Merrifield; Mark A,21,0,30,9
1715664929090,SIOC 291S,A01,637333,Gabriel; Corey John,21,0,30,9
1715664930119,SOCI 117,A01,494376,Staff,0,5,5,5
1715664931144,WES 237B,A00,494380,Staff,10,0,20,10
1715664933218,AESE 279B,A00,494370,Wade; Jon P,0,0,33,33
1715664934245,AIP 97,001,660915,Van Den Einde; Yael Dahlia,9998,0,9999,1
1715664935272,AIP 197,001,627712,Vespa; Emanuel Ignacio,9995,0,9999,4
1715664935272,AIP 197,002,650778,Amir; On,9998,0,9999,1
1715664935272,AIP 197,003,650933,Avenancio-Leon; Carlos,9998,0,9999,1
1715664935272,AIP 197,004,658530,Heyman; Gail D.,9998,0,9999,1
1715664935272,AIP 197,005,658631,Neal; Sonya E,9998,0,9999,1
1715664935272,AIP 197,006,658671,Du; Songzi,9998,0,9999,1
1715664936298,ANAR 135S,A00,494369,Braswell; Geoffrey E.,0,0,0,0
1715664937329,BENG 196,001,628496,Engler; Adam J.,9998,0,9999,1
1715664937329,BENG 196,002,660916,Watson; John Thomas,9998,0,9999,1
1715664938355,BISP 197,001,650773,Wilhelm; James E.,9994,0,9999,5
1715664938355,BISP 197,002,658904,Coleman; Aaron B.,9998,0,9999,1
1715664939379,CAT 124RS,A01,519847,Geibel; William,0,0,20,20
1715664940406,CAT 125RS,A01,515971,Geibel; William,0,0,20,20
1715664941432,CLRE 250,A00,511389,Morris; Sheldon,9992,0,9999,7
1715664942461,CLRE 251,A00,507176,Mehta; Ravindra L.,9992,0,9999,7
1715664942461,CLRE 251,B00,511410,Mehta; Ravindra L.,9998,0,9999,1
1715664943485,CLRE 252,A00,507189,Cuomo; Raphael Eduardo,9994,0,9999,5
1715664944511,CLRE 253,A00,507199,Vaida; Florin,9994,0,9999,5
1715664944511,CLRE 253,B00,507202,Vaida; Florin,9999,0,9999,0
1715664945538,CLRE 259,A00,507211,Patel; Hemal,9996,0,9999,3
1715664946564,CLRE 260,A00,507221,Cuomo; Raphael Eduardo,9999,0,9999,0
1715664947588,CLRE 297,001,507242,Cuomo; Raphael Eduardo,9999,0,9999,0
1715664948613,COGS 197,001,638244,Voytek; Bradley Thomas,9997,0,9999,2
1715664949639,CSE 191,A00,516875,Minnes Kemp; Mor Mia,9991,0,9999,8
1715664950665,CSE 197,001,637388,Minnes Kemp; Mor Mia,9992,0,9999,7
1715664951696,CSS 201S,A01,494383,Mignozzetti; Umberto,35,0,35,0
1715664952720,CSS 202S,A01,494387,Mignozzetti; Umberto,35,0,35,0
1715664953745,DSC 197,001,628532,Eldridge; Justin Matthew,9995,0,9999,4
1715664954770,EAP 100,A00,516065,Staff,9799,0,9999,200
1715664955801,ECE 45,A01,507414,Staff,32,0,60,28
1715664957850,ECE 111,A01,507420,Staff,11,0,50,39
1715664958875,ECE 197,001,548057,Sievenpiper; Daniel F.,9991,0,9999,8
1715664959901,EDS 115,A00,507243,Choi; Bailey Miyeon,6,0,28,22
1715664960927,EDS 117,A01,494379,Staff,0,6,34,35
1715664961954,EDS 125,A00,507246,Hopkins; Megan Beth,7,0,30,23
1715664962982,EDS 128A,A01,507264,Fargason; Sharon Gayle,5,0,26,21
1715664964011,EDS 128B,A01,507293,Pappas; Elizabeth,9,0,30,21
1715664965038,EDS 139,A00,507294,Fargason; Sharon Gayle,9,0,30,21
1715664965038,EDS 139,B00,507313,Pappas; Elizabeth,9,0,30,21
1715664966063,EDS 201,A00,507315,Staff,10,0,30,20
1715664967089,EDS 203,A01,507317,Halter; Christopher P.,10,0,30,20
1715664968115,EDS 204R,A01,507319,Halter; Christopher P.,0,3,30,30
1715664968115,EDS 204R,B01,507331,Heinzman; Erica M.,14,0,30,16
1715664969143,EDS 206R,A00,507332,Staff,0,4,30,30
1715664969143,EDS 206R,B00,507343,Staff,15,0,30,15
1715664970168,EDS 250,A00,507344,Hemans; Patricia Ann Benitez,20,0,40,20
1715664971195,EDS 281,A00,507345,Daly; Alan J.,18,0,18,0
1715664972223,EDS 284,A00,507350,Daly; Alan J.,16,0,16,0
1715664973249,EDS 286,A00,507359,Fine; Sarah,18,0,18,0
1715664974273,EDS 289C,A01,507361,Daly; Alan J.,18,0,18,0
1715664975303,EDS 290,A00,507366,Hofstetter; Carolyn,15,0,15,0
1715664976328,LIGM 5A,A00,507421,Fischer-Grunski; Eva K,17,0,20,3
1715664977352,LIGM 5B,A00,507423,Fischer-Grunski; Eva K,19,0,20,1
1715664978379,LIGM 5C,A00,507425,Fischer-Grunski; Eva K,19,0,20,1
1715664979405,LIIT 5AS,A00,507427,Carnelos; Chiara,20,0,20,0
1715664980433,LIIT 5BS,A00,507430,Carnelos; Chiara,20,0,20,0
1715664981461,LIIT 5CS,A00,507432,Carnelos; Chiara,20,0,20,0
1715664982552,LISP 5A,A00,507541,Munoz Sanchez; Alicia,11,0,20,9
1715664983577,LISP 5B,A00,507671,Munoz Sanchez; Alicia,8,0,20,12
1715664984605,LISP 5C,A00,507696,Munoz Sanchez; Alicia,7,0,20,13
1715664985633,MAE 197,001,528363,Boechler; Nicholas Sebastia,9998,0,9999,1
1715664986662,MATH 197,001,523477,Kedlaya; Kiran S.,9994,0,9999,5
1715664986662,MATH 197,002,563811,Zhang; Danna,9994,0,9999,5
1715664986662,MATH 197,003,628552,Dumitriu; Ioana,9998,0,9999,1
1715664986662,MATH 197,004,660885,Floyd; Eric,9998,0,9999,1
1715664987692,MCWP 40R,A00,518780,Staff,1,0,20,19
1715664987692,MCWP 40R,B00,518781,Carter; Jennifer A,9,0,20,11
1715664987692,MCWP 40R,C00,518783,Smith; Haydee Marie,5,0,20,15
1715664988721,MCWP 50R,A00,518791,Redela; Pamela Morgan,0,1,20,20
1715664988721,MCWP 50R,B00,518792,Krone; Jarret,0,2,20,20
1715664988721,MCWP 50R,C00,518793,Staff,0,4,20,20
1715664988721,MCWP 50R,D00,518794,Morshed; Michael James,0,2,20,20
1715664988721,MCWP 50R,E00,518795,Carter; Andrea L,0,2,20,20
1715664988721,MCWP 50R,F00,518796,Miller; Elizabeth Deen,0,1,20,20
1715664988721,MCWP 50R,G00,518797,Guillen; Melinda,0,1,20,20
1715664989749,MMW 12R,A01,514034,Herbst; Matthew,0,2,16,16
1715664989749,MMW 12R,A02,514035,Herbst; Matthew,0,0,16,16
1715664990775,MMW 13R,A01,514037,Staff,0,5,16,16
1715664990775,MMW 13R,A02,514039,Staff,0,5,16,16
1715664990775,MMW 13R,A03,628519,Staff,0,4,16,16
1715664992828,SIO 295LS,A00,523233,Staff,10,0,30,20
1715664993857,SIO 295S,A00,523232,Staff,10,0,30,20
1715664994883,SIOC 290S,A01,637330,Merrifield; Mark A,21,0,30,9
1715664995909,SIOC 291S,A01,637333,Gabriel; Corey John,21,0,30,9
1715664996935,SOCI 117,A01,494376,Staff,0,5,5,5
1715664997959,WES 237B,A00,494380,Staff,10,0,20,10
1715665000030,AESE 279B,A00,494370,Wade; Jon P,0,0,33,33
1715665001058,AIP 97,001,660915,Van Den Einde; Yael Dahlia,9998,0,9999,1
1715665002088,AIP 197,001,627712,Vespa; Emanuel Ignacio,9995,0,9999,4
1715665002088,AIP 197,002,650778,Amir; On,9998,0,9999,1
1715665002088,AIP 197,003,650933,Avenancio-Leon; Carlos,9998,0,9999,1
1715665002088,AIP 197,004,658530,Heyman; Gail D.,9998,0,9999,1
1715665002088,AIP 197,005,658631,Neal; Sonya E,9998,0,9999,1
1715665002088,AIP 197,006,658671,Du; Songzi,9998,0,9999,1
1715665003120,ANAR 135S,A00,494369,Braswell; Geoffrey E.,0,0,0,0
1715665004143,BENG 196,001,628496,Engler; Adam J.,9998,0,9999,1
1715665004143,BENG 196,002,660916,Watson; John Thomas,9998,0,9999,1
1715665005168,BISP 197,001,650773,Wilhelm; James E.,9994,0,9999,5
1715665005168,BISP 197,002,658904,Coleman; Aaron B.,9998,0,9999,1
1715665006193,CAT 124RS,A01,519847,Geibel; William,0,0,20,20
1715665007217,CAT 125RS,A01,515971,Geibel; William,0,0,20,20
1715665008243,CLRE 250,A00,511389,Morris; Sheldon,9992,0,9999,7
1715665009271,CLRE 251,A00,507176,Mehta; Ravindra L.,9992,0,9999,7
1715665009271,CLRE 251,B00,511410,Mehta; Ravindra L.,9998,0,9999,1
1715665010296,CLRE 252,A00,507189,Cuomo; Raphael Eduardo,9994,0,9999,5
1715665011343,CLRE 253,A00,507199,Vaida; Florin,9994,0,9999,5
1715665011343,CLRE 253,B00,507202,Vaida; Florin,9999,0,9999,0
1715665012369,CLRE 259,A00,507211,Patel; Hemal,9996,0,9999,3
1715665013396,CLRE 260,A00,507221,Cuomo; Raphael Eduardo,9999,0,9999,0
1715665014423,CLRE 297,001,507242,Cuomo; Raphael Eduardo,9999,0,9999,0
1715665015453,COGS 197,001,638244,Voytek; Bradley Thomas,9997,0,9999,2
1715665016477,CSE 191,A00,516875,Minnes Kemp; Mor Mia,9991,0,9999,8
1715665017502,CSE 197,001,637388,Minnes Kemp; Mor Mia,9992,0,9999,7
1715665018534,CSS 201S,A01,494383,Mignozzetti; Umberto,35,0,35,0
1715665019559,CSS 202S,A01,494387,Mignozzetti; Umberto,35,0,35,0
1715665020584,DSC 197,001,628532,Eldridge; Justin Matthew,9995,0,9999,4
1715665021611,EAP 100,A00,516065,Staff,9799,0,9999,200
1715665022639,ECE 45,A01,507414,Staff,32,0,60,28
1715665024691,ECE 111,A01,507420,Staff,11,0,50,39
1715665025719,ECE 197,001,548057,Sievenpiper; Daniel F.,9991,0,9999,8
1715665026748,EDS 115,A00,507243,Choi; Bailey Miyeon,6,0,28,22
1715665027774,EDS 117,A01,494379,Staff,0,6,34,35
1715665028799,EDS 125,A00,507246,Hopkins; Megan Beth,7,0,30,23
1715665029828,EDS 128A,A01,507264,Fargason; Sharon Gayle,5,0,26,21
1715665030852,EDS 128B,A01,507293,Pappas; Elizabeth,9,0,30,21
1715665031879,EDS 139,A00,507294,Fargason; Sharon Gayle,9,0,30,21
1715665031879,EDS 139,B00,507313,Pappas; Elizabeth,9,0,30,21
1715665032906,EDS 201,A00,507315,Staff,10,0,30,20
1715665033933,EDS 203,A01,507317,Halter; Christopher P.,10,0,30,20
1715665034960,EDS 204R,A01,507319,Halter; Christopher P.,0,3,30,30
1715665034960,EDS 204R,B01,507331,Heinzman; Erica M.,14,0,30,16
1715665035987,EDS 206R,A00,507332,Staff,0,4,30,30
1715665035987,EDS 206R,B00,507343,Staff,15,0,30,15
1715665037013,EDS 250,A00,507344,Hemans; Patricia Ann Benitez,20,0,40,20
1715665038041,EDS 281,A00,507345,Daly; Alan J.,18,0,18,0
1715665039065,EDS 284,A00,507350,Daly; Alan J.,16,0,16,0
1715665040092,EDS 286,A00,507359,Fine; Sarah,18,0,18,0
1715665041116,EDS 289C,A01,507361,Daly; Alan J.,18,0,18,0
1715665042143,EDS 290,A00,507366,Hofstetter; Carolyn,15,0,15,0
1715665043169,LIGM 5A,A00,507421,Fischer-Grunski; Eva K,17,0,20,3
1715665044194,LIGM 5B,A00,507423,Fischer-Grunski; Eva K,19,0,20,1
1715665045219,LIGM 5C,A00,507425,Fischer-Grunski; Eva K,19,0,20,1
1715665046246,LIIT 5AS,A00,507427,Carnelos; Chiara,20,0,20,0
1715665047273,LIIT 5BS,A00,507430,Carnelos; Chiara,20,0,20,0
1715665048298,LIIT 5CS,A00,507432,Carnelos; Chiara,20,0,20,0
1715665049324,LISP 5A,A00,507541,Munoz Sanchez; Alicia,11,0,20,9
1715665050354,LISP 5B,A00,507671,Munoz Sanchez; Alicia,8,0,20,12
1715665051377,LISP 5C,A00,507696,Munoz Sanchez; Alicia,7,0,20,13
1715665052402,MAE 197,001,528363,Boechler; Nicholas Sebastia,9998,0,9999,1
1715665053427,MATH 197,001,523477,Kedlaya; Kiran S.,9994,0,9999,5
1715665053427,MATH 197,002,563811,Zhang; Danna,9994,0,9999,5
1715665053427,MATH 197,003,628552,Dumitriu; Ioana,9998,0,9999,1
1715665053427,MATH 197,004,660885,Floyd; Eric,9998,0,9999,1
1715665054460,MCWP 40R,A00,518780,Staff,1,0,20,19
1715665054460,MCWP 40R,B00,518781,Carter; Jennifer A,9,0,20,11
1715665054460,MCWP 40R,C00,518783,Smith; Haydee Marie,5,0,20,15
1715665055488,MCWP 50R,A00,518791,Redela; Pamela Morgan,0,1,20,20
1715665055488,MCWP 50R,B00,518792,Krone; Jarret,0,2,20,20
1715665055488,MCWP 50R,C00,518793,Staff,0,4,20,20
1715665055488,MCWP 50R,D00,518794,Morshed; Michael James,0,2,20,20
1715665055488,MCWP 50R,E00,518795,Carter; Andrea L,0,2,20,20
1715665055488,MCWP 50R,F00,518796,Miller; Elizabeth Deen,0,1,20,20
1715665055488,MCWP 50R,G00,518797,Guillen; Melinda,0,1,20,20
1715665056513,MMW 12R,A01,514034,Herbst; Matthew,0,2,16,16
1715665056513,MMW 12R,A02,514035,Herbst; Matthew,0,0,16,16
1715665057539,MMW 13R,A01,514037,Staff,0,5,16,16
1715665057539,MMW 13R,A02,514039,Staff,0,5,16,16
1715665057539,MMW 13R,A03,628519,Staff,0,4,16,16
1715665059588,SIO 295LS,A00,523233,Staff,10,0,30,20
1715665060612,SIO 295S,A00,523232,Staff,10,0,30,20
1715665061643,SIOC 290S,A01,637330,Merrifield; Mark A,21,0,30,9
1715665062670,SIOC 291S,A01,637333,Gabriel; Corey John,21,0,30,9
1715665063694,SOCI 117,A01,494376,Staff,0,5,5,5
1715665064733,WES 237B,A00,494380,Staff,10,0,20,10
1715665066804,AESE 279B,A00,494370,Wade; Jon P,0,0,33,33
1715665067833,AIP 97,001,660915,Van Den Einde; Yael Dahlia,9998,0,9999,1
1715665068862,AIP 197,001,627712,Vespa; Emanuel Ignacio,9995,0,9999,4
1715665068862,AIP 197,002,650778,Amir; On,9998,0,9999,1
1715665068862,AIP 197,003,650933,Avenancio-Leon; Carlos,9998,0,9999,1
1715665068862,AIP 197,004,658530,Heyman; Gail D.,9998,0,9999,1
1715665068862,AIP 197,005,658631,Neal; Sonya E,9998,0,9999,1
1715665068862,AIP 197,006,658671,Du; Songzi,9998,0,9999,1
1715665069886,ANAR 135S,A00,494369,Braswell; Geoffrey E.,0,0,0,0
1715665070914,BENG 196,001,628496,Engler; Adam J.,9998,0,9999,1
1715665070914,BENG 196,002,660916,Watson; John Thomas,9998,0,9999,1
1715665071940,BISP 197,001,650773,Wilhelm; James E.,9994,0,9999,5
1715665071940,BISP 197,002,658904,Coleman; Aaron B.,9998,0,9999,1
1715665072967,CAT 124RS,A01,519847,Geibel; William,0,0,20,20
1715665073992,CAT 125RS,A01,515971,Geibel; William,0,0,20,20
1715665075021,CLRE 250,A00,511389,Morris; Sheldon,9992,0,9999,7
1715665076052,CLRE 251,A00,507176,Mehta; Ravindra L.,9992,0,9999,7
1715665076052,CLRE 251,B00,511410,Mehta; Ravindra L.,9998,0,9999,1
1715665077077,CLRE 252,A00,507189,Cuomo; Raphael Eduardo,9994,0,9999,5
1715665078103,CLRE 253,A00,507199,Vaida; Florin,9994,0,9999,5
1715665078103,CLRE 253,B00,507202,Vaida; Florin,9999,0,9999,0
1715665079129,CLRE 259,A00,507211,Patel; Hemal,9996,0,9999,3
1715665080154,CLRE 260,A00,507221,Cuomo; Raphael Eduardo,9999,0,9999,0
1715665081182,CLRE 297,001,507242,Cuomo; Raphael Eduardo,9999,0,9999,0
1715665082210,COGS 197,001,638244,Voytek; Bradley Thomas,9997,0,9999,2
1715665083235,CSE 191,A00,516875,Minnes Kemp; Mor Mia,9991,0,9999,8
1715665084261,CSE 197,001,637388,Minnes Kemp; Mor Mia,9992,0,9999,7
1715665085291,CSS 201S,A01,494383,Mignozzetti; Umberto,35,0,35,0
1715665086314,CSS 202S,A01,494387,Mignozzetti; Umberto,35,0,35,0
1715665087343,DSC 197,001,628532,Eldridge; Justin Matthew,9995,0,9999,4
1715665088367,EAP 100,A00,516065,Staff,9799,0,9999,200
1715665089398,ECE 45,A01,507414,Staff,32,0,60,28
1715665091452,ECE 111,A01,507420,Staff,11,0,50,39
1715665092477,ECE 197,001,548057,Sievenpiper; Daniel F.,9991,0,9999,8
1715665093507,EDS 115,A00,507243,Choi; Bailey Miyeon,6,0,28,22
1715665094533,EDS 117,A01,494379,Staff,0,6,34,35
1715665095558,EDS 125,A00,507246,Hopkins; Megan Beth,7,0,30,23
1715665096585,EDS 128A,A01,507264,Fargason; Sharon Gayle,5,0,26,21
1715665097610,EDS 128B,A01,507293,Pappas; Elizabeth,9,0,30,21
1715665098634,EDS 139,A00,507294,Fargason; Sharon Gayle,9,0,30,21
1715665098634,EDS 139,B00,507313,Pappas; Elizabeth,9,0,30,21
1715665099660,EDS 201,A00,507315,Staff,10,0,30,20
1715665100687,EDS 203,A01,507317,Halter; Christopher P.,10,0,30,20
1715665101711,EDS 204R,A01,507319,Halter; Christopher P.,0,3,30,30
1715665101711,EDS 204R,B01,507331,Heinzman; Erica M.,14,0,30,16
1715665102739,EDS 206R,A00,507332,Staff,0,4,30,30
1715665102739,EDS 206R,B00,507343,Staff,15,0,30,15
1715665103768,EDS 250,A00,507344,Hemans; Patricia Ann Benitez,20,0,40,20
1715665104797,EDS 281,A00,507345,Daly; Alan J.,18,0,18,0
1715665105824,EDS 284,A00,507350,Daly; Alan J.,16,0,16,0
1715665106850,EDS 286,A00,507359,Fine; Sarah,18,0,18,0
1715665107874,EDS 289C,A01,507361,Daly; Alan J.,18,0,18,0
1715665108899,EDS 290,A00,507366,Hofstetter; Carolyn,15,0,15,0
1715665109925,LIGM 5A,A00,507421,Fischer-Grunski; Eva K,17,0,20,3
1715665110953,LIGM 5B,A00,507423,Fischer-Grunski; Eva K,19,0,20,1
1715665111978,LIGM 5C,A00,507425,Fischer-Grunski; Eva K,19,0,20,1
1715665113004,LIIT 5AS,A00,507427,Carnelos; Chiara,20,0,20,0
1715665114033,LIIT 5BS,A00,507430,Carnelos; Chiara,20,0,20,0
1715665115059,LIIT 5CS,A00,507432,Carnelos; Chiara,20,0,20,0
1715665116085,LISP 5A,A00,507541,Munoz Sanchez; Alicia,11,0,20,9
1715665117109,LISP 5B,A00,507671,Munoz Sanchez; Alicia,8,0,20,12
1715665118133,LISP 5C,A00,507696,Munoz Sanchez; Alicia,7,0,20,13
1715665119161,MAE 197,001,528363,Boechler; Nicholas Sebastia,9998,0,9999,1
1715665120188,MATH 197,001,523477,Kedlaya; Kiran S.,9994,0,9999,5
1715665120188,MATH 197,002,563811,Zhang; Danna,9994,0,9999,5
1715665120188,MATH 197,003,628552,Dumitriu; Ioana,9998,0,9999,1
1715665120188,MATH 197,004,660885,Floyd; Eric,9998,0,9999,1
1715665121230,MCWP 40R,A00,518780,Staff,1,0,20,19
1715665121230,MCWP 40R,B00,518781,Carter; Jennifer A,9,0,20,11
1715665121230,MCWP 40R,C00,518783,Smith; Haydee Marie,5,0,20,15
1715665122262,MCWP 50R,A00,518791,Redela; Pamela Morgan,0,1,20,20
1715665122262,MCWP 50R,B00,518792,Krone; Jarret,0,2,20,20
1715665122262,MCWP 50R,C00,518793,Staff,0,4,20,20
1715665122262,MCWP 50R,D00,518794,Morshed; Michael James,0,2,20,20
1715665122262,MCWP 50R,E00,518795,Carter; Andrea L,0,2,20,20
1715665122262,MCWP 50R,F00,518796,Miller; Elizabeth Deen,0,1,20,20
1715665122262,MCWP 50R,G00,518797,Guillen; Melinda,0,1,20,20
1715665123292,MMW 12R,A01,514034,Herbst; Matthew,0,2,16,16
1715665123292,MMW 12R,A02,514035,Herbst; Matthew,0,0,16,16
1715665124319,MMW 13R,A01,514037,Staff,0,5,16,16
1715665124319,MMW 13R,A02,514039,Staff,0,5,16,16
1715665124319,MMW 13R,A03,628519,Staff,0,4,16,16
1715665126372,SIO 295LS,A00,523233,Staff,10,0,30,20
1715665127400,SIO 295S,A00,523232,Staff,10,0,30,20
1715665128427,SIOC 290S,A01,637330,Merrifield; Mark A,21,0,30,9
1715665129457,SIOC 291S,A01,637333,Gabriel; Corey John,21,0,30,9
1715665130483,SOCI 117,A01,494376,Staff,0,5,5,5
1715665131509,WES 237B,A00,494380,Staff,10,0,20,10
1715665133597,AESE 279B,A00,494370,Wade; Jon P,0,0,33,33
1715665134621,AIP 97,001,660915,Van Den Einde; Yael Dahlia,9998,0,9999,1
1715665135651,AIP 197,001,627712,Vespa; Emanuel Ignacio,9995,0,9999,4
1715665135651,AIP 197,002,650778,Amir; On,9998,0,9999,1
1715665135651,AIP 197,003,650933,Avenancio-Leon; Carlos,9998,0,9999,1
1715665135651,AIP 197,004,658530,Heyman; Gail D.,9998,0,9999,1
1715665135651,AIP 197,005,658631,Neal; Sonya E,9998,0,9999,1
1715665135651,AIP 197,006,658671,Du; Songzi,9998,0,9999,1
1715665136679,ANAR 135S,A00,494369,Braswell; Geoffrey E.,0,0,0,0
1715665137725,BENG 196,001,628496,Engler; Adam J.,9998,0,9999,1
1715665137725,BENG 196,002,660916,Watson; John Thomas,9998,0,9999,1
1715665138755,BISP 197,001,650773,Wilhelm; James E.,9994,0,9999,5
1715665138755,BISP 197,002,658904,Coleman; Aaron B.,9998,0,9999,1
1715665139783,CAT 124RS,A01,519847,Geibel; William,0,0,20,20
1715665140810,CAT 125RS,A01,515971,Geibel; William,0,0,20,20
1715665141836,CLRE 250,A00,511389,Morris; Sheldon,9992,0,9999,7
1715665142863,CLRE 251,A00,507176,Mehta; Ravindra L.,9992,0,9999,7
1715665142863,CLRE 251,B00,511410,Mehta; Ravindra L.,9998,0,9999,1
1715665143890,CLRE 252,A00,507189,Cuomo; Raphael Eduardo,9994,0,9999,5
1715665144915,CLRE 253,A00,507199,Vaida; Florin,9994,0,9999,5
1715665144915,CLRE 253,B00,507202,Vaida; Florin,9999,0,9999,0
1715665145945,CLRE 259,A00,507211,Patel; Hemal,9996,0,9999,3
1715665146973,CLRE 260,A00,507221,Cuomo; Raphael Eduardo,9999,0,9999,0
1715665147996,CLRE 297,001,507242,Cuomo; Raphael Eduardo,9999,0,9999,0
1715665149022,COGS 197,001,638244,Voytek; Bradley Thomas,9997,0,9999,2
1715665150047,CSE 191,A00,516875,Minnes Kemp; Mor Mia,9991,0,9999,8
1715665151072,CSE 197,001,637388,Minnes Kemp; Mor Mia,9992,0,9999,7
1715665152099,CSS 201S,A01,494383,Mignozzetti; Umberto,35,0,35,0
1715665153123,CSS 202S,A01,494387,Mignozzetti; Umberto,35,0,35,0
1715665154149,DSC 197,001,628532,Eldridge; Justin Matthew,9995,0,9999,4
1715665155175,EAP 100,A00,516065,Staff,9799,0,9999,200
1715665156205,ECE 45,A01,507414,Staff,32,0,60,28
1715665158258,ECE 111,A01,507420,Staff,11,0,50,39
1715665159285,ECE 197,001,548057,Sievenpiper; Daniel F.,9991,0,9999,8
1715665160311,EDS 115,A00,507243,Choi; Bailey Miyeon,6,0,28,22
1715665161338,EDS 117,A01,494379,Staff,0,6,34,35
1715665162364,EDS 125,A00,507246,Hopkins; Megan Beth,7,0,30,23
1715665163389,EDS 128A,A01,507264,Fargason; Sharon Gayle,5,0,26,21
1715665164421,EDS 128B,A01,507293,Pappas; Elizabeth,9,0,30,21
1715665165447,EDS 139,A00,507294,Fargason; Sharon Gayle,9,0,30,21
1715665165447,EDS 139,B00,507313,Pappas; Elizabeth,9,0,30,21
1715665166474,EDS 201,A00,507315,Staff,10,0,30,20
1715665167503,EDS 203,A01,507317,Halter; Christopher P.,10,0,30,20
1715665168529,EDS 204R,A01,507319,Halter; Christopher P.,0,3,30,30
1715665168529,EDS 204R,B01,507331,Heinzman; Erica M.,14,0,30,16
1715665169556,EDS 206R,A00,507332,Staff,0,4,30,30
1715665169556,EDS 206R,B00,507343,Staff,15,0,30,15
1715665170584,EDS 250,A00,507344,Hemans; Patricia Ann Benitez,20,0,40,20
1715665171608,EDS 281,A00,507345,Daly; Alan J.,18,0,18,0
1715665172634,EDS 284,A00,507350,Daly; Alan J.,16,0,16,0
1715665173668,EDS 286,A00,507359,Fine; Sarah,18,0,18,0
1715665174694,EDS 289C,A01,507361,Daly; Alan J.,18,0,18,0
1715665175720,EDS 290,A00,507366,Hofstetter; Carolyn,15,0,15,0
1715665176745,LIGM 5A,A00,507421,Fischer-Grunski; Eva K,17,0,20,3
1715665177770,LIGM 5B,A00,507423,Fischer-Grunski; Eva K,19,0,20,1
1715665178798,LIGM 5C,A00,507425,Fischer-Grunski; Eva K,19,0,20,1
1715665179823,LIIT 5AS,A00,507427,Carnelos; Chiara,20,0,20,0
1715665180855,LIIT 5BS,A00,507430,Carnelos; Chiara,20,0,20,0
1715665181881,LIIT 5CS,A00,507432,Carnelos; Chiara,20,0,20,0
1715665182907,LISP 5A,A00,507541,Munoz Sanchez; Alicia,11,0,20,9
1715665183932,LISP 5B,A00,507671,Munoz Sanchez; Alicia,8,0,20,12
1715665184957,LISP 5C,A00,507696,Munoz Sanchez; Alicia,7,0,20,13
1715665185987,MAE 197,001,528363,Boechler; Nicholas Sebastia,9998,0,9999,1
1715665187019,MATH 197,001,523477,Kedlaya; Kiran S.,9994,0,9999,5
1715665187019,MATH 197,002,563811,Zhang; Danna,9994,0,9999,5
1715665187019,MATH 197,003,628552,Dumitriu; Ioana,9998,0,9999,1
1715665187019,MATH 197,004,660885,Floyd; Eric,9998,0,9999,1
1715665188045,MCWP 40R,A00,518780,Staff,1,0,20,19
1715665188045,MCWP 40R,B00,518781,Carter; Jennifer A,9,0,20,11
1715665188045,MCWP 40R,C00,518783,Smith; Haydee Marie,5,0,20,15
1715665189077,MCWP 50R,A00,518791,Redela; Pamela Morgan,0,1,20,20
1715665189077,MCWP 50R,B00,518792,Krone; Jarret,0,2,20,20
1715665189077,MCWP 50R,C00,518793,Staff,0,4,20,20
1715665189077,MCWP 50R,D00,518794,Morshed; Michael James,0,2,20,20
1715665189077,MCWP 50R,E00,518795,Carter; Andrea L,0,2,20,20
1715665189077,MCWP 50R,F00,518796,Miller; Elizabeth Deen,0,1,20,20
1715665189077,MCWP 50R,G00,518797,Guillen; Melinda,0,1,20,20
1715665190103,MMW 12R,A01,514034,Herbst; Matthew,0,2,16,16
1715665190103,MMW 12R,A02,514035,Herbst; Matthew,0,0,16,16
1715665191128,MMW 13R,A01,514037,Staff,0,5,16,16
1715665191128,MMW 13R,A02,514039,Staff,0,5,16,16
1715665191128,MMW 13R,A03,628519,Staff,0,4,16,16
1715665193179,SIO 295LS,A00,523233,Staff,10,0,30,20
1715665194207,SIO 295S,A00,523232,Staff,10,0,30,20
1715665195237,SIOC 290S,A01,637330,Merrifield; Mark A,21,0,30,9
1715665196263,SIOC 291S,A01,637333,Gabriel; Corey John,21,0,30,9
1715665197290,SOCI 117,A01,494376,Staff,0,5,5,5
1715665198319,WES 237B,A00,494380,Staff,10,0,20,10
1715665200389,AESE 279B,A00,494370,Wade; Jon P,0,0,33,33
1715665201415,AIP 97,001,660915,Van Den Einde; Yael Dahlia,9998,0,9999,1
1715665202443,AIP 197,001,627712,Vespa; Emanuel Ignacio,9995,0,9999,4
1715665202443,AIP 197,002,650778,Amir; On,9998,0,9999,1
1715665202443,AIP 197,003,650933,Avenancio-Leon; Carlos,9998,0,9999,1
1715665202443,AIP 197,004,658530,Heyman; Gail D.,9998,0,9999,1
1715665202443,AIP 197,005,658631,Neal; Sonya E,9998,0,9999,1
1715665202443,AIP 197,006,658671,Du; Songzi,9998,0,9999,1
1715665203470,ANAR 135S,A00,494369,Braswell; Geoffrey E.,0,0,0,0
1715665204499,BENG 196,001,628496,Engler; Adam J.,9998,0,9999,1
1715665204499,BENG 196,002,660916,Watson; John Thomas,9998,0,9999,1
1715665205524,BISP 197,001,650773,Wilhelm; James E.,9994,0,9999,5
1715665205524,BISP 197,002,658904,Coleman; Aaron B.,9998,0,9999,1
1715665206549,CAT 124RS,A01,519847,Geibel; William,0,0,20,20
1715665207575,CAT 125RS,A01,515971,Geibel; William,0,0,20,20
1715665208601,CLRE 250,A00,511389,Morris; Sheldon,9992,0,9999,7
1715665209631,CLRE 251,A00,507176,Mehta; Ravindra L.,9992,0,9999,7
1715665209631,CLRE 251,B00,511410,Mehta; Ravindra L.,9998,0,9999,1
1715665210654,CLRE 252,A00,507189,Cuomo; Raphael Eduardo,9994,0,9999,5
1715665211681,CLRE 253,A00,507199,Vaida; Florin,9994,0,9999,5
1715665211681,CLRE 253,B00,507202,Vaida; Florin,9999,0,9999,0
1715665212706,CLRE 259,A00,507211,Patel; Hemal,9996,0,9999,3
1715665213731,CLRE 260,A00,507221,Cuomo; Raphael Eduardo,9999,0,9999,0
1715665214759,CLRE 297,001,507242,Cuomo; Raphael Eduardo,9999,0,9999,0
1715665215785,COGS 197,001,638244,Voytek; Bradley Thomas,9997,0,9999,2
1715665216815,CSE 191,A00,516875,Minnes Kemp; Mor Mia,9991,0,9999,8
1715665217843,CSE 197,001,637388,Minnes Kemp; Mor Mia,9992,0,9999,7
1715665218870,CSS 201S,A01,494383,Mignozzetti; Umberto,35,0,35,0
1715665219895,CSS 202S,A01,494387,Mignozzetti; Umberto,35,0,35,0
1715665220925,DSC 197,001,628532,Eldridge; Justin Matthew,9995,0,9999,4
1715665221953,EAP 100,A00,516065,Staff,9799,0,9999,200
1715665222984,ECE 45,A01,507414,Staff,32,0,60,28
1715665225037,ECE 111,A01,507420,Staff,11,0,50,39
1715665226062,ECE 197,001,548057,Sievenpiper; Daniel F.,9991,0,9999,8
1715665227087,EDS 115,A00,507243,Choi; Bailey Miyeon,6,0,28,22
1715665228113,EDS 117,A01,494379,Staff,0,6,34,35
1715665229142,EDS 125,A00,507246,Hopkins; Megan Beth,7,0,30,23
1715665230168,EDS 128A,A01,507264,Fargason; Sharon Gayle,5,0,26,21
1715665231192,EDS 128B,A01,507293,Pappas; Elizabeth,9,0,30,21
1715665232218,EDS 139,A00,507294,Fargason; Sharon Gayle,9,0,30,21
1715665232218,EDS 139,B00,507313,Pappas; Elizabeth,9,0,30,21
1715665233244,EDS 201,A00,507315,Staff,10,0,30,20
1715665234272,EDS 203,A01,507317,Halter; Christopher P.,10,0,30,20
1715665235301,EDS 204R,A01,507319,Halter; Christopher P.,0,3,30,30
1715665235301,EDS 204R,B01,507331,Heinzman; Erica M.,14,0,30,16
1715665236329,EDS 206R,A00,507332,Staff,0,4,30,30
1715665236329,EDS 206R,B00,507343,Staff,15,0,30,15
1715665237358,EDS 250,A00,507344,Hemans; Patricia Ann Benitez,20,0,40,20
1715665238384,EDS 281,A00,507345,Daly; Alan J.,18,0,18,0
1715665239413,EDS 284,A00,507350,Daly; Alan J.,16,0,16,0
1715665240439,EDS 286,A00,507359,Fine; Sarah,18,0,18,0
1715665241466,EDS 289C,A01,507361,Daly; Alan J.,18,0,18,0
1715665242494,EDS 290,A00,507366,Hofstetter; Carolyn,15,0,15,0
1715665243524,LIGM 5A,A00,507421,Fischer-Grunski; Eva K,17,0,20,3
1715665244551,LIGM 5B,A00,507423,Fischer-Grunski; Eva K,19,0,20,1
1715665245581,LIGM 5C,A00,507425,Fischer-Grunski; Eva K,19,0,20,1
1715665246606,LIIT 5AS,A00,507427,Carnelos; Chiara,20,0,20,0
1715665247634,LIIT 5BS,A00,507430,Carnelos; Chiara,20,0,20,0
1715665248659,LIIT 5CS,A00,507432,Carnelos; Chiara,20,0,20,0
1715665249683,LISP 5A,A00,507541,Munoz Sanchez; Alicia,11,0,20,9
1715665250710,LISP 5B,A00,507671,Munoz Sanchez; Alicia,8,0,20,12
1715665251738,LISP 5C,A00,507696,Munoz Sanchez; Alicia,7,0,20,13
1715665252767,MAE 197,001,528363,Boechler; Nicholas Sebastia,9998,0,9999,1
1715665253797,MATH 197,001,523477,Kedlaya; Kiran S.,9994,0,9999,5
1715665253797,MATH 197,002,563811,Zhang; Danna,9994,0,9999,5
1715665253797,MATH 197,003,628552,Dumitriu; Ioana,9998,0,9999,1
1715665253797,MATH 197,004,660885,Floyd; Eric,9998,0,9999,1
1715665254825,MCWP 40R,A00,518780,Staff,1,0,20,19
1715665254825,MCWP 40R,B00,518781,Carter; Jennifer A,9,0,20,11
1715665254825,MCWP 40R,C00,518783,Smith; Haydee Marie,5,0,20,15
1715665255852,MCWP 50R,A00,518791,Redela; Pamela Morgan,0,1,20,20
1715665255852,MCWP 50R,B00,518792,Krone; Jarret,0,2,20,20
1715665255852,MCWP 50R,C00,518793,Staff,0,4,20,20
1715665255852,MCWP 50R,D00,518794,Morshed; Michael James,0,2,20,20
1715665255852,MCWP 50R,E00,518795,Carter; Andrea L,0,2,20,20
1715665255852,MCWP 50R,F00,518796,Miller; Elizabeth Deen,0,1,20,20
1715665255852,MCWP 50R,G00,518797,Guillen; Melinda,0,1,20,20
1715665256882,MMW 12R,A01,514034,Herbst; Matthew,0,2,16,16
1715665256882,MMW 12R,A02,514035,Herbst; Matthew,0,0,16,16
1715665257907,MMW 13R,A01,514037,Staff,0,5,16,16
1715665257907,MMW 13R,A02,514039,Staff,0,5,16,16
1715665257907,MMW 13R,A03,628519,Staff,0,4,16,16
1715665259960,SIO 295LS,A00,523233,Staff,10,0,30,20
1715665260984,SIO 295S,A00,523232,Staff,10,0,30,20
1715665262010,SIOC 290S,A01,637330,Merrifield; Mark A,21,0,30,9
1715665263039,SIOC 291S,A01,637333,Gabriel; Corey John,21,0,30,9
1715665264063,SOCI 117,A01,494376,Staff,0,5,5,5
1715665265089,WES 237B,A00,494380,Staff,10,0,20,10
1715665267172,AESE 279B,A00,494370,Wade; Jon P,0,0,33,33
1715665268196,AIP 97,001,660915,Van Den Einde; Yael Dahlia,9998,0,9999,1
1715665269229,AIP 197,001,627712,Vespa; Emanuel Ignacio,9995,0,9999,4
1715665269229,AIP 197,002,650778,Amir; On,9998,0,9999,1
1715665269229,AIP 197,003,650933,Avenancio-Leon; Carlos,9998,0,9999,1
1715665269229,AIP 197,004,658530,Heyman; Gail D.,9998,0,9999,1
1715665269229,AIP 197,005,658631,Neal; Sonya E,9998,0,9999,1
1715665269229,AIP 197,006,658671,Du; Songzi,9998,0,9999,1
1715665270255,ANAR 135S,A00,494369,Braswell; Geoffrey E.,0,0,0,0
1715665271280,BENG 196,001,628496,Engler; Adam J.,9998,0,9999,1
1715665271280,BENG 196,002,660916,Watson; John Thomas,9998,0,9999,1
1715665272308,BISP 197,001,650773,Wilhelm; James E.,9994,0,9999,5
1715665272308,BISP 197,002,658904,Coleman; Aaron B.,9998,0,9999,1
1715665273334,CAT 124RS,A01,519847,Geibel; William,0,0,20,20
1715665274371,CAT 125RS,A01,515971,Geibel; William,0,0,20,20
1715665275397,CLRE 250,A00,511389,Morris; Sheldon,9992,0,9999,7
1715665276426,CLRE 251,A00,507176,Mehta; Ravindra L.,9992,0,9999,7
1715665276426,CLRE 251,B00,511410,Mehta; Ravindra L.,9998,0,9999,1
1715665277452,CLRE 252,A00,507189,Cuomo; Raphael Eduardo,9994,0,9999,5
1715665278479,CLRE 253,A00,507199,Vaida; Florin,9994,0,9999,5
1715665278479,CLRE 253,B00,507202,Vaida; Florin,9999,0,9999,0
1715665279505,CLRE 259,A00,507211,Patel; Hemal,9996,0,9999,3
1715665280534,CLRE 260,A00,507221,Cuomo; Raphael Eduardo,9999,0,9999,0
1715665281558,CLRE 297,001,507242,Cuomo; Raphael Eduardo,9999,0,9999,0
1715665282586,COGS 197,001,638244,Voytek; Bradley Thomas,9997,0,9999,2
1715665283611,CSE 191,A00,516875,Minnes Kemp; Mor Mia,9991,0,9999,8
1715665284638,CSE 197,001,637388,Minnes Kemp; Mor Mia,9992,0,9999,7
1715665285665,CSS 201S,A01,494383,Mignozzetti; Umberto,35,0,35,0
1715665286694,CSS 202S,A01,494387,Mignozzetti; Umberto,35,0,35,0
1715665287717,DSC 197,001,628532,Eldridge; Justin Matthew,9995,0,9999,4
1715665288742,EAP 100,A00,516065,Staff,9799,0,9999,200
1715665289769,ECE 45,A01,507414,Staff,32,0,60,28
1715665291820,ECE 111,A01,507420,Staff,11,0,50,39
1715665292848,ECE 197,001,548057,Sievenpiper; Daniel F.,9991,0,9999,8
1715665293882,EDS 115,A00,507243,Choi; Bailey Miyeon,6,0,28,22
1715665294910,EDS 117,A01,494379,Staff,0,6,34,35
1715665295937,EDS 125,A00,507246,Hopkins; Megan Beth,7,0,30,23
1715665296963,EDS 128A,A01,507264,Fargason; Sharon Gayle,5,0,26,21
1715665297988,EDS 128B,A01,507293,Pappas; Elizabeth,9,0,30,21
1715665299015,EDS 139,A00,507294,Fargason; Sharon Gayle,9,0,30,21
1715665299015,EDS 139,B00,507313,Pappas; Elizabeth,9,0,30,21
1715665300039,EDS 201,A00,507315,Staff,10,0,30,20
1715665301064,EDS 203,A01,507317,Halter; Christopher P.,10,0,30,20
1715665302092,EDS 204R,A01,507319,Halter; Christopher P.,0,3,30,30
1715665302092,EDS 204R,B01,507331,Heinzman; Erica M.,14,0,30,16
1715665303118,EDS 206R,A00,507332,Staff,0,4,30,30
1715665303118,EDS 206R,B00,507343,Staff,15,0,30,15
1715665304141,EDS 250,A00,507344,Hemans; Patricia Ann Benitez,20,0,40,20
1715665305167,EDS 281,A00,507345,Daly; Alan J.,18,0,18,0
1715665306192,EDS 284,A00,507350,Daly; Alan J.,16,0,16,0
1715665307217,EDS 286,A00,507359,Fine; Sarah,18,0,18,0
1715665308242,EDS 289C,A01,507361,Daly; Alan J.,18,0,18,0
1715665309278,EDS 290,A00,507366,Hofstetter; Carolyn,15,0,15,0
1715665310304,LIGM 5A,A00,507421,Fischer-Grunski; Eva K,17,0,20,3
1715665311330,LIGM 5B,A00,507423,Fischer-Grunski; Eva K,19,0,20,1
1715665312356,LIGM 5C,A00,507425,Fischer-Grunski; Eva K,19,0,20,1
1715665313382,LIIT 5AS,A00,507427,Carnelos; Chiara,20,0,20,0
1715665314409,LIIT 5BS,A00,507430,Carnelos; Chiara,20,0,20,0
1715665315433,LIIT 5CS,A00,507432,Carnelos; Chiara,20,0,20,0
1715665316463,LISP 5A,A00,507541,Munoz Sanchez; Alicia,11,0,20,9
1715665317492,LISP 5B,A00,507671,Munoz Sanchez; Alicia,8,0,20,12
1715665318517,LISP 5C,A00,507696,Munoz Sanchez; Alicia,7,0,20,13
1715665319542,MAE 197,001,528363,Boechler; Nicholas Sebastia,9998,0,9999,1
1715665320574,MATH 197,001,523477,Kedlaya; Kiran S.,9994,0,9999,5
1715665320574,MATH 197,002,563811,Zhang; Danna,9994,0,9999,5
1715665320574,MATH 197,003,628552,Dumitriu; Ioana,9998,0,9999,1
1715665320574,MATH 197,004,660885,Floyd; Eric,9998,0,9999,1
1715665321604,MCWP 40R,A00,518780,Staff,1,0,20,19
1715665321604,MCWP 40R,B00,518781,Carter; Jennifer A,9,0,20,11
1715665321604,MCWP 40R,C00,518783,Smith; Haydee Marie,5,0,20,15
1715665322636,MCWP 50R,A00,518791,Redela; Pamela Morgan,0,1,20,20
1715665322636,MCWP 50R,B00,518792,Krone; Jarret,0,2,20,20
1715665322636,MCWP 50R,C00,518793,Staff,0,4,20,20
1715665322636,MCWP 50R,D00,518794,Morshed; Michael James,0,2,20,20
1715665322636,MCWP 50R,E00,518795,Carter; Andrea L,0,2,20,20
1715665322636,MCWP 50R,F00,518796,Miller; Elizabeth Deen,0,1,20,20
1715665322636,MCWP 50R,G00,518797,Guillen; Melinda,0,1,20,20
1715665323661,MMW 12R,A01,514034,Herbst; Matthew,0,2,16,16
1715665323661,MMW 12R,A02,514035,Herbst; Matthew,0,0,16,16
1715665324684,MMW 13R,A01,514037,Staff,0,5,16,16
1715665324684,MMW 13R,A02,514039,Staff,0,5,16,16
1715665324684,MMW 13R,A03,628519,Staff,0,4,16,16
1715665326736,SIO 295LS,A00,523233,Staff,10,0,30,20
1715665327763,SIO 295S,A00,523232,Staff,10,0,30,20
1715665328790,SIOC 290S,A01,637330,Merrifield; Mark A,21,0,30,9
1715665329816,SIOC 291S,A01,637333,Gabriel; Corey John,21,0,30,9
1715665330843,SOCI 117,A01,494376,Staff,0,5,5,5
1715665331868,WES 237B,A00,494380,Staff,10,0,20,10
1715665333945,AESE 279B,A00,494370,Wade; Jon P,0,0,33,33
1715665334970,AIP 97,001,660915,Van Den Einde; Yael Dahlia,9998,0,9999,1
1715665335998,AIP 197,001,627712,Vespa; Emanuel Ignacio,9995,0,9999,4
1715665335998,AIP 197,002,650778,Amir; On,9998,0,9999,1
1715665335998,AIP 197,003,650933,Avenancio-Leon; Carlos,9998,0,9999,1
1715665335998,AIP 197,004,658530,Heyman; Gail D.,9998,0,9999,1
1715665335998,AIP 197,005,658631,Neal; Sonya E,9998,0,9999,1
1715665335998,AIP 197,006,658671,Du; Songzi,9998,0,9999,1
1715665337023,ANAR 135S,A00,494369,Braswell; Geoffrey E.,0,0,0,0
1715665338053,BENG 196,001,628496,Engler; Adam J.,9998,0,9999,1
1715665338053,BENG 196,002,660916,Watson; John Thomas,9998,0,9999,1
1715665339078,BISP 197,001,650773,Wilhelm; James E.,9994,0,9999,5
1715665339078,BISP 197,002,658904,Coleman; Aaron B.,9998,0,9999,1
1715665340104,CAT 124RS,A01,519847,Geibel; William,0,0,20,20
1715665341128,CAT 125RS,A01,515971,Geibel; William,0,0,20,20
1715665342154,CLRE 250,A00,511389,Morris; Sheldon,9992,0,9999,7
1715665343180,CLRE 251,A00,507176,Mehta; Ravindra L.,9992,0,9999,7
1715665343180,CLRE 251,B00,511410,Mehta; Ravindra L.,9998,0,9999,1
1715665344207,CLRE 252,A00,507189,Cuomo; Raphael Eduardo,9994,0,9999,5
1715665345233,CLRE 253,A00,507199,Vaida; Florin,9994,0,9999,5
1715665345233,CLRE 253,B00,507202,Vaida; Florin,9999,0,9999,0
1715665346260,CLRE 259,A00,507211,Patel; Hemal,9996,0,9999,3
1715665347286,CLRE 260,A00,507221,Cuomo; Raphael Eduardo,9999,0,9999,0
1715665348310,CLRE 297,001,507242,Cuomo; Raphael Eduardo,9999,0,9999,0
1715665349340,COGS 197,001,638244,Voytek; Bradley Thomas,9997,0,9999,2
1715665350365,CSE 191,A00,516875,Minnes Kemp; Mor Mia,9991,0,9999,8
1715665351392,CSE 197,001,637388,Minnes Kemp; Mor Mia,9992,0,9999,7
1715665352418,CSS 201S,A01,494383,Mignozzetti; Umberto,35,0,35,0
1715665353448,CSS 202S,A01,494387,Mignozzetti; Umberto,35,0,35,0
1715665354474,DSC 197,001,628532,Eldridge; Justin Matthew,9995,0,9999,4
1715665355501,EAP 100,A00,516065,Staff,9799,0,9999,200
1715665356528,ECE 45,A01,507414,Staff,32,0,60,28
1715665358577,ECE 111,A01,507420,Staff,11,0,50,39
1715665359604,ECE 197,001,548057,Sievenpiper; Daniel F.,9991,0,9999,8
1715665360633,EDS 115,A00,507243,Choi; Bailey Miyeon,6,0,28,22
1715665361660,EDS 117,A01,494379,Staff,0,6,34,35
1715665362686,EDS 125,A00,507246,Hopkins; Megan Beth,7,0,30,23
1715665363710,EDS 128A,A01,507264,Fargason; Sharon Gayle,5,0,26,21
1715665364739,EDS 128B,A01,507293,Pappas; Elizabeth,9,0,30,21
1715665365764,EDS 139,A00,507294,Fargason; Sharon Gayle,9,0,30,21
1715665365764,EDS 139,B00,507313,Pappas; Elizabeth,9,0,30,21
1715665366787,EDS 201,A00,507315,Staff,10,0,30,20
1715665367813,EDS 203,A01,507317,Halter; Christopher P.,10,0,30,20
1715665368836,EDS 204R,A01,507319,Halter; Christopher P.,0,3,30,30
1715665368836,EDS 204R,B01,507331,Heinzman; Erica M.,14,0,30,16
1715665369862,EDS 206R,A00,507332,Staff,0,4,30,30
1715665369862,EDS 206R,B00,507343,Staff,15,0,30,15
1715665370891,EDS 250,A00,507344,Hemans; Patricia Ann Benitez,20,0,40,20
1715665371931,EDS 281,A00,507345,Daly; Alan J.,18,0,18,0
1715665372958,EDS 284,A00,507350,Daly; Alan J.,16,0,16,0
1715665373988,EDS 286,A00,507359,Fine; Sarah,18,0,18,0
1715665375013,EDS 289C,A01,507361,Daly; Alan J.,18,0,18,0
1715665376038,EDS 290,A00,507366,Hofstetter; Carolyn,15,0,15,0
1715665377064,LIGM 5A,A00,507421,Fischer-Grunski; Eva K,17,0,20,3
1715665378093,LIGM 5B,A00,507423,Fischer-Grunski; Eva K,19,0,20,1
1715665379121,LIGM 5C,A00,507425,Fischer-Grunski; Eva K,19,0,20,1
1715665380145,LIIT 5AS,A00,507427,Carnelos; Chiara,20,0,20,0
1715665381173,LIIT 5BS,A00,507430,Carnelos; Chiara,20,0,20,0
1715665382199,LIIT 5CS,A00,507432,Carnelos; Chiara,20,0,20,0
1715665383230,LISP 5A,A00,507541,Munoz Sanchez; Alicia,11,0,20,9
1715665384256,LISP 5B,A00,507671,Munoz Sanchez; Alicia,8,0,20,12
1715665385283,LISP 5C,A00,507696,Munoz Sanchez; Alicia,7,0,20,13
1715665386309,MAE 197,001,528363,Boechler; Nicholas Sebastia,9998,0,9999,1
1715665387336,MATH 197,001,523477,Kedlaya; Kiran S.,9994,0,9999,5
1715665387336,MATH 197,002,563811,Zhang; Danna,9994,0,9999,5
1715665387336,MATH 197,003,628552,Dumitriu; Ioana,9998,0,9999,1
1715665387336,MATH 197,004,660885,Floyd; Eric,9998,0,9999,1
1715665388363,MCWP 40R,A00,518780,Staff,1,0,20,19
1715665388363,MCWP 40R,B00,518781,Carter; Jennifer A,9,0,20,11
1715665388363,MCWP 40R,C00,518783,Smith; Haydee Marie,5,0,20,15
1715665389390,MCWP 50R,A00,518791,Redela; Pamela Morgan,0,1,20,20
1715665389390,MCWP 50R,B00,518792,Krone; Jarret,0,2,20,20
1715665389390,MCWP 50R,C00,518793,Staff,0,4,20,20
1715665389390,MCWP 50R,D00,518794,Morshed; Michael James,0,2,20,20
1715665389390,MCWP 50R,E00,518795,Carter; Andrea L,0,2,20,20
1715665389390,MCWP 50R,F00,518796,Miller; Elizabeth Deen,0,1,20,20
1715665389390,MCWP 50R,G00,518797,Guillen; Melinda,0,1,20,20
1715665390416,MMW 12R,A01,514034,Herbst; Matthew,0,2,16,16
1715665390416,MMW 12R,A02,514035,Herbst; Matthew,0,0,16,16
1715665391442,MMW 13R,A01,514037,Staff,0,5,16,16
1715665391442,MMW 13R,A02,514039,Staff,0,5,16,16
1715665391442,MMW 13R,A03,628519,Staff,0,4,16,16
1715665393495,SIO 295LS,A00,523233,Staff,10,0,30,20
1715665394522,SIO 295S,A00,523232,Staff,10,0,30,20
1715665395548,SIOC 290S,A01,637330,Merrifield; Mark A,21,0,30,9
1715665396574,SIOC 291S,A01,637333,Gabriel; Corey John,21,0,30,9
1715665397602,SOCI 117,A01,494376,Staff,0,5,5,5
1715665398629,WES 237B,A00,494380,Staff,10,0,20,10
1715665400712,AESE 279B,A00,494370,Wade; Jon P,0,0,33,33
1715665401739,AIP 97,001,660915,Van Den Einde; Yael Dahlia,9998,0,9999,1
1715665402771,AIP 197,001,627712,Vespa; Emanuel Ignacio,9995,0,9999,4
1715665402771,AIP 197,002,650778,Amir; On,9998,0,9999,1
1715665402771,AIP 197,003,650933,Avenancio-Leon; Carlos,9998,0,9999,1
1715665402771,AIP 197,004,658530,Heyman; Gail D.,9998,0,9999,1
1715665402771,AIP 197,005,658631,Neal; Sonya E,9998,0,9999,1
1715665402771,AIP 197,006,658671,Du; Songzi,9998,0,9999,1
1715665403797,ANAR 135S,A00,494369,Braswell; Geoffrey E.,0,0,0,0
1715665404826,BENG 196,001,628496,Engler; Adam J.,9998,0,9999,1
1715665404826,BENG 196,002,660916,Watson; John Thomas,9998,0,9999,1
1715665405851,BISP 197,001,650773,Wilhelm; James E.,9994,0,9999,5
1715665405851,BISP 197,002,658904,Coleman; Aaron B.,9998,0,9999,1
1715665406877,CAT 124RS,A01,519847,Geibel; William,0,0,20,20
1715665407905,CAT 125RS,A01,515971,Geibel; William,0,0,20,20
1715665408930,CLRE 250,A00,511389,Morris; Sheldon,9992,0,9999,7
1715665409957,CLRE 251,A00,507176,Mehta; Ravindra L.,9992,0,9999,7
1715665409957,CLRE 251,B00,511410,Mehta; Ravindra L.,9998,0,9999,1
1715665410985,CLRE 252,A00,507189,Cuomo; Raphael Eduardo,9994,0,9999,5
1715665412010,CLRE 253,A00,507199,Vaida; Florin,9994,0,9999,5
1715665412010,CLRE 253,B00,507202,Vaida; Florin,9999,0,9999,0
1715665413034,CLRE 259,A00,507211,Patel; Hemal,9996,0,9999,3
1715665414061,CLRE 260,A00,507221,Cuomo; Raphael Eduardo,9999,0,9999,0
1715665415089,CLRE 297,001,507242,Cuomo; Raphael Eduardo,9999,0,9999,0
1715665416114,COGS 197,001,638244,Voytek; Bradley Thomas,9997,0,9999,2
1715665417140,CSE 191,A00,516875,Minnes Kemp; Mor Mia,9991,0,9999,8
1715665418165,CSE 197,001,637388,Minnes Kemp; Mor Mia,9992,0,9999,7
1715665419191,CSS 201S,A01,494383,Mignozzetti; Umberto,35,0,35,0
1715665420216,CSS 202S,A01,494387,Mignozzetti; Umberto,35,0,35,0
1715665421295,DSC 197,001,628532,Eldridge; Justin Matthew,9995,0,9999,4
1715665422319,EAP 100,A00,516065,Staff,9799,0,9999,200
1715665423351,ECE 45,A01,507414,Staff,32,0,60,28
1715665425399,ECE 111,A01,507420,Staff,11,0,50,39
1715665426424,ECE 197,001,548057,Sievenpiper; Daniel F.,9991,0,9999,8
1715665427453,EDS 115,A00,507243,Choi; Bailey Miyeon,6,0,28,22
1715665428478,EDS 117,A01,494379,Staff,0,6,34,35
1715665429506,EDS 125,A00,507246,Hopkins; Megan Beth,7,0,30,23
1715665430532,EDS 128A,A01,507264,Fargason; Sharon Gayle,5,0,26,21
1715665431557,EDS 128B,A01,507293,Pappas; Elizabeth,9,0,30,21
1715665432582,EDS 139,A00,507294,Fargason; Sharon Gayle,9,0,30,21
1715665432582,EDS 139,B00,507313,Pappas; Elizabeth,9,0,30,21
1715665433607,EDS 201,A00,507315,Staff,10,0,30,20
1715665434633,EDS 203,A01,507317,Halter; Christopher P.,10,0,30,20
1715665435662,EDS 204R,A01,507319,Halter; Christopher P.,0,3,30,30
1715665435662,EDS 204R,B01,507331,Heinzman; Erica M.,14,0,30,16
1715665436694,EDS 206R,A00,507332,Staff,0,4,30,30
1715665436694,EDS 206R,B00,507343,Staff,15,0,30,15
1715665437721,EDS 250,A00,507344,Hemans; Patricia Ann Benitez,20,0,40,20
1715665438749,EDS 281,A00,507345,Daly; Alan J.,18,0,18,0
1715665439772,EDS 284,A00,507350,Daly; Alan J.,16,0,16,0
1715665440798,EDS 286,A00,507359,Fine; Sarah,18,0,18,0
1715665441822,EDS 289C,A01,507361,Daly; Alan J.,18,0,18,0
1715665442849,EDS 290,A00,507366,Hofstetter; Carolyn,15,0,15,0
1715665443880,LIGM 5A,A00,507421,Fischer-Grunski; Eva K,17,0,20,3
1715665444908,LIGM 5B,A00,507423,Fischer-Grunski; Eva K,19,0,20,1
1715665445934,LIGM 5C,A00,507425,Fischer-Grunski; Eva K,19,0,20,1
1715665446965,LIIT 5AS,A00,507427,Carnelos; Chiara,20,0,20,0
1715665447992,LIIT 5BS,A00,507430,Carnelos; Chiara,20,0,20,0
1715665449018,LIIT 5CS,A00,507432,Carnelos; Chiara,20,0,20,0
1715665450048,LISP 5A,A00,507541,Munoz Sanchez; Alicia,11,0,20,9
1715665451077,LISP 5B,A00,507671,Munoz Sanchez; Alicia,8,0,20,12
1715665452104,LISP 5C,A00,507696,Munoz Sanchez; Alicia,7,0,20,13
1715665453131,MAE 197,001,528363,Boechler; Nicholas Sebastia,9998,0,9999,1
1715665454158,MATH 197,001,523477,Kedlaya; Kiran S.,9994,0,9999,5
1715665454158,MATH 197,002,563811,Zhang; Danna,9994,0,9999,5
1715665454158,MATH 197,003,628552,Dumitriu; Ioana,9998,0,9999,1
1715665454158,MATH 197,004,660885,Floyd; Eric,9998,0,9999,1
1715665455183,MCWP 40R,A00,518780,Staff,1,0,20,19
1715665455183,MCWP 40R,B00,518781,Carter; Jennifer A,9,0,20,11
1715665455183,MCWP 40R,C00,518783,Smith; Haydee Marie,5,0,20,15
1715665456212,MCWP 50R,A00,518791,Redela; Pamela Morgan,0,1,20,20
1715665456212,MCWP 50R,B00,518792,Krone; Jarret,0,2,20,20
1715665456212,MCWP 50R,C00,518793,Staff,0,4,20,20
1715665456212,MCWP 50R,D00,518794,Morshed; Michael James,0,2,20,20
1715665456212,MCWP 50R,E00,518795,Carter; Andrea L,0,2,20,20
1715665456212,MCWP 50R,F00,518796,Miller; Elizabeth Deen,0,1,20,20
1715665456212,MCWP 50R,G00,518797,Guillen; Melinda,0,1,20,20
1715665457237,MMW 12R,A01,514034,Herbst; Matthew,0,2,16,16
1715665457237,MMW 12R,A02,514035,Herbst; Matthew,0,0,16,16
1715665458262,MMW 13R,A01,514037,Staff,0,5,16,16
1715665458262,MMW 13R,A02,514039,Staff,0,5,16,16
1715665458262,MMW 13R,A03,628519,Staff,0,4,16,16
1715665460313,SIO 295LS,A00,523233,Staff,10,0,30,20
1715665461341,SIO 295S,A00,523232,Staff,10,0,30,20
1715665462371,SIOC 290S,A01,637330,Merrifield; Mark A,21,0,30,9
1715665463397,SIOC 291S,A01,637333,Gabriel; Corey John,21,0,30,9
1715665464426,SOCI 117,A01,494376,Staff,0,5,5,5
1715665465450,WES 237B,A00,494380,Staff,10,0,20,10
1715665467519,AESE 279B,A00,494370,Wade; Jon P,0,0,33,33
1715665468545,AIP 97,001,660915,Van Den Einde; Yael Dahlia,9998,0,9999,1
1715665469573,AIP 197,001,627712,Vespa; Emanuel Ignacio,9995,0,9999,4
1715665469573,AIP 197,002,650778,Amir; On,9998,0,9999,1
1715665469573,AIP 197,003,650933,Avenancio-Leon; Carlos,9998,0,9999,1
1715665469573,AIP 197,004,658530,Heyman; Gail D.,9998,0,9999,1
1715665469573,AIP 197,005,658631,Neal; Sonya E,9998,0,9999,1
1715665469573,AIP 197,006,658671,Du; Songzi,9998,0,9999,1
1715665470598,ANAR 135S,A00,494369,Braswell; Geoffrey E.,0,0,0,0
1715665471623,BENG 196,001,628496,Engler; Adam J.,9998,0,9999,1
1715665471623,BENG 196,002,660916,Watson; John Thomas,9998,0,9999,1
1715665472649,BISP 197,001,650773,Wilhelm; James E.,9994,0,9999,5
1715665472649,BISP 197,002,658904,Coleman; Aaron B.,9998,0,9999,1
1715665473677,CAT 124RS,A01,519847,Geibel; William,0,0,20,20
1715665474705,CAT 125RS,A01,515971,Geibel; William,0,0,20,20
1715665475734,CLRE 250,A00,511389,Morris; Sheldon,9992,0,9999,7
1715665476762,CLRE 251,A00,507176,Mehta; Ravindra L.,9992,0,9999,7
1715665476762,CLRE 251,B00,511410,Mehta; Ravindra L.,9998,0,9999,1
1715665477788,CLRE 252,A00,507189,Cuomo; Raphael Eduardo,9994,0,9999,5
1715665478818,CLRE 253,A00,507199,Vaida; Florin,9994,0,9999,5
1715665478818,CLRE 253,B00,507202,Vaida; Florin,9999,0,9999,0
1715665479847,CLRE 259,A00,507211,Patel; Hemal,9996,0,9999,3
1715665480872,CLRE 260,A00,507221,Cuomo; Raphael Eduardo,9999,0,9999,0
1715665481897,CLRE 297,001,507242,Cuomo; Raphael Eduardo,9999,0,9999,0
1715665482924,COGS 197,001,638244,Voytek; Bradley Thomas,9997,0,9999,2
1715665483949,CSE 191,A00,516875,Minnes Kemp; Mor Mia,9991,0,9999,8
1715665484975,CSE 197,001,637388,Minnes Kemp; Mor Mia,9992,0,9999,7
1715665486002,CSS 201S,A01,494383,Mignozzetti; Umberto,35,0,35,0
1715665487229,CSS 202S,A01,494387,Mignozzetti; Umberto,35,0,35,0
1715665488256,DSC 197,001,628532,Eldridge; Justin Matthew,9995,0,9999,4
1715665489283,EAP 100,A00,516065,Staff,9799,0,9999,200
1715665490365,ECE 45,A01,507414,Staff,32,0,60,28
1715665492417,ECE 111,A01,507420,Staff,11,0,50,39
1715665493442,ECE 197,001,548057,Sievenpiper; Daniel F.,9991,0,9999,8
1715665494469,EDS 115,A00,507243,Choi; Bailey Miyeon,6,0,28,22
1715665495497,EDS 117,A01,494379,Staff,0,6,34,35
1715665496522,EDS 125,A00,507246,Hopkins; Megan Beth,7,0,30,23
1715665497548,EDS 128A,A01,507264,Fargason; Sharon Gayle,5,0,26,21
1715665498572,EDS 128B,A01,507293,Pappas; Elizabeth,9,0,30,21
1715665499597,EDS 139,A00,507294,Fargason; Sharon Gayle,9,0,30,21
1715665499597,EDS 139,B00,507313,Pappas; Elizabeth,9,0,30,21
1715665500624,EDS 201,A00,507315,Staff,10,0,30,20
1715665501656,EDS 203,A01,507317,Halter; Christopher P.,10,0,30,20
1715665502683,EDS 204R,A01,507319,Halter; Christopher P.,0,3,30,30
1715665502683,EDS 204R,B01,507331,Heinzman; Erica M.,14,0,30,16
1715665503710,EDS 206R,A00,507332,Staff,0,4,30,30
1715665503710,EDS 206R,B00,507343,Staff,15,0,30,15
1715665504737,EDS 250,A00,507344,Hemans; Patricia Ann Benitez,20,0,40,20
1715665505762,EDS 281,A00,507345,Daly; Alan J.,18,0,18,0
1715665506787,EDS 284,A00,507350,Daly; Alan J.,16,0,16,0
1715665507811,EDS 286,A00,507359,Fine; Sarah,18,0,18,0
1715665508839,EDS 289C,A01,507361,Daly; Alan J.,18,0,18,0
1715665509865,EDS 290,A00,507366,Hofstetter; Carolyn,15,0,15,0
1715665510891,LIGM 5A,A00,507421,Fischer-Grunski; Eva K,17,0,20,3
1715665511915,LIGM 5B,A00,507423,Fischer-Grunski; Eva K,19,0,20,1
1715665512941,LIGM 5C,A00,507425,Fischer-Grunski; Eva K,19,0,20,1
1715665513970,LIIT 5AS,A00,507427,Carnelos; Chiara,20,0,20,0
1715665514995,LIIT 5BS,A00,507430,Carnelos; Chiara,20,0,20,0
1715665516022,LIIT 5CS,A00,507432,Carnelos; Chiara,20,0,20,0
1715665517046,LISP 5A,A00,507541,Munoz Sanchez; Alicia,11,0,20,9
1715665518072,LISP 5B,A00,507671,Munoz Sanchez; Alicia,8,0,20,12
1715665519099,LISP 5C,A00,507696,Munoz Sanchez; Alicia,7,0,20,13
1715665520128,MAE 197,001,528363,Boechler; Nicholas Sebastia,9998,0,9999,1
1715665521158,MATH 197,001,523477,Kedlaya; Kiran S.,9994,0,9999,5
1715665521158,MATH 197,002,563811,Zhang; Danna,9994,0,9999,5
1715665521158,MATH 197,003,628552,Dumitriu; Ioana,9998,0,9999,1
1715665521158,MATH 197,004,660885,Floyd; Eric,9998,0,9999,1
1715665522183,MCWP 40R,A00,518780,Staff,1,0,20,19
1715665522183,MCWP 40R,B00,518781,Carter; Jennifer A,9,0,20,11
1715665522183,MCWP 40R,C00,518783,Smith; Haydee Marie,5,0,20,15
1715665523214,MCWP 50R,A00,518791,Redela; Pamela Morgan,0,1,20,20
1715665523214,MCWP 50R,B00,518792,Krone; Jarret,0,2,20,20
1715665523214,MCWP 50R,C00,518793,Staff,0,4,20,20
1715665523214,MCWP 50R,D00,518794,Morshed; Michael James,0,2,20,20
1715665523214,MCWP 50R,E00,518795,Carter; Andrea L,0,2,20,20
1715665523214,MCWP 50R,F00,518796,Miller; Elizabeth Deen,0,1,20,20
1715665523214,MCWP 50R,G00,518797,Guillen; Melinda,0,1,20,20
1715665524242,MMW 12R,A01,514034,Herbst; Matthew,0,2,16,16
1715665524242,MMW 12R,A02,514035,Herbst; Matthew,0,0,16,16
1715665525269,MMW 13R,A01,514037,Staff,0,5,16,16
1715665525269,MMW 13R,A02,514039,Staff,0,5,16,16
1715665525269,MMW 13R,A03,628519,Staff,0,4,16,16
1715665527323,SIO 295LS,A00,523233,Staff,10,0,30,20
1715665528346,SIO 295S,A00,523232,Staff,10,0,30,20
1715665529374,SIOC 290S,A01,637330,Merrifield; Mark A,21,0,30,9
1715665530400,SIOC 291S,A01,637333,Gabriel; Corey John,21,0,30,9
1715665531429,SOCI 117,A01,494376,Staff,0,5,5,5
1715665532457,WES 237B,A00,494380,Staff,10,0,20,10
1715665534528,AESE 279B,A00,494370,Wade; Jon P,0,0,33,33
1715665535553,AIP 97,001,660915,Van Den Einde; Yael Dahlia,9998,0,9999,1
1715665536581,AIP 197,001,627712,Vespa; Emanuel Ignacio,9995,0,9999,4
1715665536581,AIP 197,002,650778,Amir; On,9998,0,9999,1
1715665536581,AIP 197,003,650933,Avenancio-Leon; Carlos,9998,0,9999,1
1715665536581,AIP 197,004,658530,Heyman; Gail D.,9998,0,9999,1
1715665536581,AIP 197,005,658631,Neal; Sonya E,9998,0,9999,1
1715665536581,AIP 197,006,658671,Du; Songzi,9998,0,9999,1
1715665537610,ANAR 135S,A00,494369,Braswell; Geoffrey E.,0,0,0,0
1715665538637,BENG 196,001,628496,Engler; Adam J.,9998,0,9999,1
1715665538637,BENG 196,002,660916,Watson; John Thomas,9998,0,9999,1
1715665539668,BISP 197,001,650773,Wilhelm; James E.,9994,0,9999,5
1715665539668,BISP 197,002,658904,Coleman; Aaron B.,9998,0,9999,1
1715665540693,CAT 124RS,A01,519847,Geibel; William,0,0,20,20
1715665541719,CAT 125RS,A01,515971,Geibel; William,0,0,20,20
1715665542745,CLRE 250,A00,511389,Morris; Sheldon,9992,0,9999,7
1715665543770,CLRE 251,A00,507176,Mehta; Ravindra L.,9992,0,9999,7
1715665543770,CLRE 251,B00,511410,Mehta; Ravindra L.,9998,0,9999,1
1715665544797,CLRE 252,A00,507189,Cuomo; Raphael Eduardo,9994,0,9999,5
1715665545825,CLRE 253,A00,507199,Vaida; Florin,9994,0,9999,5
1715665545825,CLRE 253,B00,507202,Vaida; Florin,9999,0,9999,0
1715665546851,CLRE 259,A00,507211,Patel; Hemal,9996,0,9999,3
1715665547877,CLRE 260,A00,507221,Cuomo; Raphael Eduardo,9999,0,9999,0
1715665548904,CLRE 297,001,507242,Cuomo; Raphael Eduardo,9999,0,9999,0
1715665549932,COGS 197,001,638244,Voytek; Bradley Thomas,9997,0,9999,2
1715665550957,CSE 191,A00,516875,Minnes Kemp; Mor Mia,9991,0,9999,8
1715665551983,CSE 197,001,637388,Minnes Kemp; Mor Mia,9992,0,9999,7
1715665553009,CSS 201S,A01,494383,Mignozzetti; Umberto,35,0,35,0
1715665554035,CSS 202S,A01,494387,Mignozzetti; Umberto,35,0,35,0
1715665555065,DSC 197,001,628532,Eldridge; Justin Matthew,9995,0,9999,4
1715665556093,EAP 100,A00,516065,Staff,9799,0,9999,200
1715665557120,ECE 45,A01,507414,Staff,32,0,60,28
1715665559179,ECE 111,A01,507420,Staff,11,0,50,39
1715665560204,ECE 197,001,548057,Sievenpiper; Daniel F.,9991,0,9999,8
1715665561229,EDS 115,A00,507243,Choi; Bailey Miyeon,6,0,28,22
1715665562254,EDS 117,A01,494379,Staff,0,6,34,35
1715665563279,EDS 125,A00,507246,Hopkins; Megan Beth,7,0,30,23
1715665564311,EDS 128A,A01,507264,Fargason; Sharon Gayle,5,0,26,21
1715665565340,EDS 128B,A01,507293,Pappas; Elizabeth,9,0,30,21
1715665566364,EDS 139,A00,507294,Fargason; Sharon Gayle,9,0,30,21
1715665566364,EDS 139,B00,507313,Pappas; Elizabeth,9,0,30,21
1715665567389,EDS 201,A00,507315,Staff,10,0,30,20
1715665568419,EDS 203,A01,507317,Halter; Christopher P.,10,0,30,20
1715665569450,EDS 204R,A01,507319,Halter; Christopher P.,0,3,30,30
1715665569450,EDS 204R,B01,507331,Heinzman; Erica M.,14,0,30,16
1715665570474,EDS 206R,A00,507332,Staff,0,4,30,30
1715665570474,EDS 206R,B00,507343,Staff,15,0,30,15
1715665571501,EDS 250,A00,507344,Hemans; Patricia Ann Benitez,20,0,40,20
1715665572527,EDS 281,A00,507345,Daly; Alan J.,18,0,18,0
1715665573555,EDS 284,A00,507350,Daly; Alan J.,16,0,16,0
1715665574583,EDS 286,A00,507359,Fine; Sarah,18,0,18,0
1715665575607,EDS 289C,A01,507361,Daly; Alan J.,18,0,18,0
1715665576633,EDS 290,A00,507366,Hofstetter; Carolyn,15,0,15,0
1715665577660,LIGM 5A,A00,507421,Fischer-Grunski; Eva K,17,0,20,3
1715665578686,LIGM 5B,A00,507423,Fischer-Grunski; Eva K,19,0,20,1
1715665579709,LIGM 5C,A00,507425,Fischer-Grunski; Eva K,19,0,20,1
1715665580734,LIIT 5AS,A00,507427,Carnelos; Chiara,20,0,20,0
1715665581764,LIIT 5BS,A00,507430,Carnelos; Chiara,20,0,20,0
1715665582788,LIIT 5CS,A00,507432,Carnelos; Chiara,20,0,20,0
1715665583817,LISP 5A,A00,507541,Munoz Sanchez; Alicia,11,0,20,9
1715665584845,LISP 5B,A00,507671,Munoz Sanchez; Alicia,8,0,20,12
1715665585870,LISP 5C,A00,507696,Munoz Sanchez; Alicia,7,0,20,13
1715665586896,MAE 197,001,528363,Boechler; Nicholas Sebastia,9998,0,9999,1
1715665587928,MATH 197,001,523477,Kedlaya; Kiran S.,9994,0,9999,5
1715665587928,MATH 197,002,563811,Zhang; Danna,9994,0,9999,5
1715665587928,MATH 197,003,628552,Dumitriu; Ioana,9998,0,9999,1
1715665587928,MATH 197,004,660885,Floyd; Eric,9998,0,9999,1
1715665588956,MCWP 40R,A00,518780,Staff,1,0,20,19
1715665588956,MCWP 40R,B00,518781,Carter; Jennifer A,9,0,20,11
1715665588956,MCWP 40R,C00,518783,Smith; Haydee Marie,5,0,20,15
1715665589990,MCWP 50R,A00,518791,Redela; Pamela Morgan,0,1,20,20
1715665589990,MCWP 50R,B00,518792,Krone; Jarret,0,2,20,20
1715665589990,MCWP 50R,C00,518793,Staff,0,4,20,20
1715665589990,MCWP 50R,D00,518794,Morshed; Michael James,0,2,20,20
1715665589990,MCWP 50R,E00,518795,Carter; Andrea L,0,2,20,20
1715665589990,MCWP 50R,F00,518796,Miller; Elizabeth Deen,0,1,20,20
1715665589990,MCWP 50R,G00,518797,Guillen; Melinda,0,1,20,20
1715665591015,MMW 12R,A01,514034,Herbst; Matthew,0,2,16,16
1715665591015,MMW 12R,A02,514035,Herbst; Matthew,0,0,16,16
1715665592044,MMW 13R,A01,514037,Staff,0,5,16,16
1715665592044,MMW 13R,A02,514039,Staff,0,5,16,16
1715665592044,MMW 13R,A03,628519,Staff,0,4,16,16
1715665594147,SIO 295LS,A00,523233,Staff,10,0,30,20
1715665595173,SIO 295S,A00,523232,Staff,10,0,30,20
1715665596199,SIOC 290S,A01,637330,Merrifield; Mark A,21,0,30,9
1715665597224,SIOC 291S,A01,637333,Gabriel; Corey John,21,0,30,9
1715665598251,SOCI 117,A01,494376,Staff,0,5,5,5
1715665599279,WES 237B,A00,494380,Staff,10,0,20,10
1715665601336,AESE 279B,A00,494370,Wade; Jon P,0,0,33,33
1715665602366,AIP 97,001,660915,Van Den Einde; Yael Dahlia,9998,0,9999,1
1715665603400,AIP 197,001,627712,Vespa; Emanuel Ignacio,9995,0,9999,4
1715665603400,AIP 197,002,650778,Amir; On,9998,0,9999,1
1715665603400,AIP 197,003,650933,Avenancio-Leon; Carlos,9998,0,9999,1
1715665603400,AIP 197,004,658530,Heyman; Gail D.,9998,0,9999,1
1715665603400,AIP 197,005,658631,Neal; Sonya E,9998,0,9999,1
1715665603400,AIP 197,006,658671,Du; Songzi,9998,0,9999,1
1715665604425,ANAR 135S,A00,494369,Braswell; Geoffrey E.,0,0,0,0
1715665605451,BENG 196,001,628496,Engler; Adam J.,9998,0,9999,1
1715665605451,BENG 196,002,660916,Watson; John Thomas,9998,0,9999,1
1715665606478,BISP 197,001,650773,Wilhelm; James E.,9994,0,9999,5
1715665606478,BISP 197,002,658904,Coleman; Aaron B.,9998,0,9999,1
1715665607504,CAT 124RS,A01,519847,Geibel; William,0,0,20,20
1715665608530,CAT 125RS,A01,515971,Geibel; William,0,0,20,20
1715665609556,CLRE 250,A00,511389,Morris; Sheldon,9992,0,9999,7
1715665610587,CLRE 251,A00,507176,Mehta; Ravindra L.,9992,0,9999,7
1715665610587,CLRE 251,B00,511410,Mehta; Ravindra L.,9998,0,9999,1
1715665611614,CLRE 252,A00,507189,Cuomo; Raphael Eduardo,9994,0,9999,5
1715665612640,CLRE 253,A00,507199,Vaida; Florin,9994,0,9999,5
1715665612640,CLRE 253,B00,507202,Vaida; Florin,9999,0,9999,0
1715665613669,CLRE 259,A00,507211,Patel; Hemal,9996,0,9999,3
1715665614693,CLRE 260,A00,507221,Cuomo; Raphael Eduardo,9999,0,9999,0
1715665615723,CLRE 297,001,507242,Cuomo; Raphael Eduardo,9999,0,9999,0
1715665616749,COGS 197,001,638244,Voytek; Bradley Thomas,9997,0,9999,2
1715665617774,CSE 191,A00,516875,Minnes Kemp; Mor Mia,9991,0,9999,8
1715665618798,CSE 197,001,637388,Minnes Kemp; Mor Mia,9992,0,9999,7
1715665619828,CSS 201S,A01,494383,Mignozzetti; Umberto,35,0,35,0
1715665620854,CSS 202S,A01,494387,Mignozzetti; Umberto,35,0,35,0
1715665621879,DSC 197,001,628532,Eldridge; Justin Matthew,9995,0,9999,4
1715665622907,EAP 100,A00,516065,Staff,9799,0,9999,200
1715665623937,ECE 45,A01,507414,Staff,32,0,60,28
1715665625988,ECE 111,A01,507420,Staff,11,0,50,39
1715665627014,ECE 197,001,548057,Sievenpiper; Daniel F.,9991,0,9999,8
1715665628042,EDS 115,A00,507243,Choi; Bailey Miyeon,6,0,28,22
1715665629069,EDS 117,A01,494379,Staff,0,6,34,35
1715665630098,EDS 125,A00,507246,Hopkins; Megan Beth,7,0,30,23
1715665631127,EDS 128A,A01,507264,Fargason; Sharon Gayle,5,0,26,21
1715665632152,EDS 128B,A01,507293,Pappas; Elizabeth,9,0,30,21
1715665633177,EDS 139,A00,507294,Fargason; Sharon Gayle,9,0,30,21
1715665633177,EDS 139,B00,507313,Pappas; Elizabeth,9,0,30,21
1715665634202,EDS 201,A00,507315,Staff,10,0,30,20
1715665635229,EDS 203,A01,507317,Halter; Christopher P.,10,0,30,20
1715665636254,EDS 204R,A01,507319,Halter; Christopher P.,0,3,30,30
1715665636254,EDS 204R,B01,507331,Heinzman; Erica M.,14,0,30,16
1715665637282,EDS 206R,A00,507332,Staff,0,4,30,30
1715665637282,EDS 206R,B00,507343,Staff,15,0,30,15
1715665638311,EDS 250,A00,507344,Hemans; Patricia Ann Benitez,20,0,40,20
1715665639340,EDS 281,A00,507345,Daly; Alan J.,18,0,18,0
1715665640366,EDS 284,A00,507350,Daly; Alan J.,16,0,16,0
1715665641395,EDS 286,A00,507359,Fine; Sarah,18,0,18,0
1715665642421,EDS 289C,A01,507361,Daly; Alan J.,18,0,18,0
1715665643447,EDS 290,A00,507366,Hofstetter; Carolyn,15,0,15,0
1715665644478,LIGM 5A,A00,507421,Fischer-Grunski; Eva K,17,0,20,3
1715665645503,LIGM 5B,A00,507423,Fischer-Grunski; Eva K,19,0,20,1
1715665646529,LIGM 5C,A00,507425,Fischer-Grunski; Eva K,19,0,20,1
1715665647559,LIIT 5AS,A00,507427,Carnelos; Chiara,20,0,20,0
1715665648594,LIIT 5BS,A00,507430,Carnelos; Chiara,20,0,20,0
1715665649620,LIIT 5CS,A00,507432,Carnelos; Chiara,20,0,20,0
1715665650646,LISP 5A,A00,507541,Munoz Sanchez; Alicia,11,0,20,9
1715665651671,LISP 5B,A00,507671,Munoz Sanchez; Alicia,8,0,20,12
1715665652701,LISP 5C,A00,507696,Munoz Sanchez; Alicia,7,0,20,13
1715665653726,MAE 197,001,528363,Boechler; Nicholas Sebastia,9998,0,9999,1
1715665654754,MATH 197,001,523477,Kedlaya; Kiran S.,9994,0,9999,5
1715665654754,MATH 197,002,563811,Zhang; Danna,9994,0,9999,5
1715665654754,MATH 197,003,628552,Dumitriu; Ioana,9998,0,9999,1
1715665654754,MATH 197,004,660885,Floyd; Eric,9998,0,9999,1
1715665655780,MCWP 40R,A00,518780,Staff,1,0,20,19
1715665655780,MCWP 40R,B00,518781,Carter; Jennifer A,9,0,20,11
1715665655780,MCWP 40R,C00,518783,Smith; Haydee Marie,5,0,20,15
1715665656806,MCWP 50R,A00,518791,Redela; Pamela Morgan,0,1,20,20
1715665656806,MCWP 50R,B00,518792,Krone; Jarret,0,2,20,20
1715665656806,MCWP 50R,C00,518793,Staff,0,4,20,20
1715665656806,MCWP 50R,D00,518794,Morshed; Michael James,0,2,20,20
1715665656806,MCWP 50R,E00,518795,Carter; Andrea L,0,2,20,20
1715665656806,MCWP 50R,F00,518796,Miller; Elizabeth Deen,0,1,20,20
1715665656806,MCWP 50R,G00,518797,Guillen; Melinda,0,1,20,20
1715665657835,MMW 12R,A01,514034,Herbst; Matthew,0,2,16,16
1715665657835,MMW 12R,A02,514035,Herbst; Matthew,0,0,16,16
1715665658858,MMW 13R,A01,514037,Staff,0,5,16,16
1715665658858,MMW 13R,A02,514039,Staff,0,5,16,16
1715665658858,MMW 13R,A03,628519,Staff,0,4,16,16
1715665660912,SIO 295LS,A00,523233,Staff,10,0,30,20
1715665661939,SIO 295S,A00,523232,Staff,10,0,30,20
1715665662971,SIOC 290S,A01,637330,Merrifield; Mark A,21,0,30,9
1715665663998,SIOC 291S,A01,637333,Gabriel; Corey John,21,0,30,9
1715665665024,SOCI 117,A01,494376,Staff,0,5,5,5
1715665666050,WES 237B,A00,494380,Staff,10,0,20,10
1715665668132,AESE 279B,A00,494370,Wade; Jon P,0,0,33,33
1715665669161,AIP 97,001,660915,Van Den Einde; Yael Dahlia,9998,0,9999,1
1715665670187,AIP 197,001,627712,Vespa; Emanuel Ignacio,9995,0,9999,4
1715665670187,AIP 197,002,650778,Amir; On,9998,0,9999,1
1715665670187,AIP 197,003,650933,Avenancio-Leon; Carlos,9998,0,9999,1
1715665670187,AIP 197,004,658530,Heyman; Gail D.,9998,0,9999,1
1715665670187,AIP 197,005,658631,Neal; Sonya E,9998,0,9999,1
1715665670187,AIP 197,006,658671,Du; Songzi,9998,0,9999,1
1715665671214,ANAR 135S,A00,494369,Braswell; Geoffrey E.,0,0,0,0
1715665672240,BENG 196,001,628496,Engler; Adam J.,9998,0,9999,1
1715665672240,BENG 196,002,660916,Watson; John Thomas,9998,0,9999,1
1715665673270,BISP 197,001,650773,Wilhelm; James E.,9994,0,9999,5
1715665673270,BISP 197,002,658904,Coleman; Aaron B.,9998,0,9999,1
1715665674296,CAT 124RS,A01,519847,Geibel; William,0,0,20,20
1715665675321,CAT 125RS,A01,515971,Geibel; William,0,0,20,20
1715665676347,CLRE 250,A00,511389,Morris; Sheldon,9992,0,9999,7
1715665677380,CLRE 251,A00,507176,Mehta; Ravindra L.,9992,0,9999,7
1715665677380,CLRE 251,B00,511410,Mehta; Ravindra L.,9998,0,9999,1
1715665678409,CLRE 252,A00,507189,Cuomo; Raphael Eduardo,9994,0,9999,5
1715665679435,CLRE 253,A00,507199,Vaida; Florin,9994,0,9999,5
1715665679435,CLRE 253,B00,507202,Vaida; Florin,9999,0,9999,0
1715665680460,CLRE 259,A00,507211,Patel; Hemal,9996,0,9999,3
1715665681488,CLRE 260,A00,507221,Cuomo; Raphael Eduardo,9999,0,9999,0
1715665682513,CLRE 297,001,507242,Cuomo; Raphael Eduardo,9999,0,9999,0
1715665683541,COGS 197,001,638244,Voytek; Bradley Thomas,9997,0,9999,2
1715665684566,CSE 191,A00,516875,Minnes Kemp; Mor Mia,9991,0,9999,8
1715665685590,CSE 197,001,637388,Minnes Kemp; Mor Mia,9992,0,9999,7
1715665686621,CSS 201S,A01,494383,Mignozzetti; Umberto,35,0,35,0
1715665687650,CSS 202S,A01,494387,Mignozzetti; Umberto,35,0,35,0
1715665688677,DSC 197,001,628532,Eldridge; Justin Matthew,9995,0,9999,4
1715665689703,EAP 100,A00,516065,Staff,9799,0,9999,200
1715665690733,ECE 45,A01,507414,Staff,32,0,60,28
1715665692939,ECE 111,A01,507420,Staff,11,0,50,39
1715665693964,ECE 197,001,548057,Sievenpiper; Daniel F.,9991,0,9999,8
1715665694993,EDS 115,A00,507243,Choi; Bailey Miyeon,6,0,28,22
1715665696019,EDS 117,A01,494379,Staff,0,6,34,35
1715665697047,EDS 125,A00,507246,Hopkins; Megan Beth,7,0,30,23
1715665698127,EDS 128A,A01,507264,Fargason; Sharon Gayle,5,0,26,21
1715665699153,EDS 128B,A01,507293,Pappas; Elizabeth,9,0,30,21
1715665700181,EDS 139,A00,507294,Fargason; Sharon Gayle,9,0,30,21
1715665700181,EDS 139,B00,507313,Pappas; Elizabeth,9,0,30,21
1715665701210,EDS 201,A00,507315,Staff,10,0,30,20
1715665702238,EDS 203,A01,507317,Halter; Christopher P.,10,0,30,20
1715665703263,EDS 204R,A01,507319,Halter; Christopher P.,0,3,30,30
1715665703263,EDS 204R,B01,507331,Heinzman; Erica M.,14,0,30,16
1715665704289,EDS 206R,A00,507332,Staff,0,4,30,30
1715665704289,EDS 206R,B00,507343,Staff,15,0,30,15
1715665705314,EDS 250,A00,507344,Hemans; Patricia Ann Benitez,20,0,40,20
1715665706343,EDS 281,A00,507345,Daly; Alan J.,18,0,18,0
1715665707369,EDS 284,A00,507350,Daly; Alan J.,16,0,16,0
1715665708394,EDS 286,A00,507359,Fine; Sarah,18,0,18,0
1715665709422,EDS 289C,A01,507361,Daly; Alan J.,18,0,18,0
1715665710448,EDS 290,A00,507366,Hofstetter; Carolyn,15,0,15,0
1715665711480,LIGM 5A,A00,507421,Fischer-Grunski; Eva K,17,0,20,3
1715665712511,LIGM 5B,A00,507423,Fischer-Grunski; Eva K,19,0,20,1
1715665713540,LIGM 5C,A00,507425,Fischer-Grunski; Eva K,19,0,20,1
1715665714567,LIIT 5AS,A00,507427,Carnelos; Chiara,20,0,20,0
1715665715591,LIIT 5BS,A00,507430,Carnelos; Chiara,20,0,20,0
1715665716622,LIIT 5CS,A00,507432,Carnelos; Chiara,20,0,20,0
1715665717653,LISP 5A,A00,507541,Munoz Sanchez; Alicia,11,0,20,9
1715665718683,LISP 5B,A00,507671,Munoz Sanchez; Alicia,8,0,20,12
1715665719710,LISP 5C,A00,507696,Munoz Sanchez; Alicia,7,0,20,13
1715665720735,MAE 197,001,528363,Boechler; Nicholas Sebastia,9998,0,9999,1
1715665721764,MATH 197,001,523477,Kedlaya; Kiran S.,9994,0,9999,5
1715665721764,MATH 197,002,563811,Zhang; Danna,9994,0,9999,5
1715665721764,MATH 197,003,628552,Dumitriu; Ioana,9998,0,9999,1
1715665721764,MATH 197,004,660885,Floyd; Eric,9998,0,9999,1
1715665722795,MCWP 40R,A00,518780,Staff,1,0,20,19
1715665722795,MCWP 40R,B00,518781,Carter; Jennifer A,9,0,20,11
1715665722795,MCWP 40R,C00,518783,Smith; Haydee Marie,5,0,20,15
1715665723824,MCWP 50R,A00,518791,Redela; Pamela Morgan,0,1,20,20
1715665723824,MCWP 50R,B00,518792,Krone; Jarret,0,2,20,20
1715665723824,MCWP 50R,C00,518793,Staff,0,4,20,20
1715665723824,MCWP 50R,D00,518794,Morshed; Michael James,0,2,20,20
1715665723824,MCWP 50R,E00,518795,Carter; Andrea L,0,2,20,20
1715665723824,MCWP 50R,F00,518796,Miller; Elizabeth Deen,0,1,20,20
1715665723824,MCWP 50R,G00,518797,Guillen; Melinda,0,1,20,20
1715665724852,MMW 12R,A01,514034,Herbst; Matthew,0,2,16,16
1715665724852,MMW 12R,A02,514035,Herbst; Matthew,0,0,16,16
1715665725878,MMW 13R,A01,514037,Staff,0,5,16,16
1715665725878,MMW 13R,A02,514039,Staff,0,5,16,16
1715665725878,MMW 13R,A03,628519,Staff,0,4,16,16
1715665727932,SIO 295LS,A00,523233,Staff,10,0,30,20
1715665728963,SIO 295S,A00,523232,Staff,10,0,30,20
1715665729993,SIOC 290S,A01,637330,Merrifield; Mark A,21,0,30,9
1715665731020,SIOC 291S,A01,637333,Gabriel; Corey John,21,0,30,9
1715665732045,SOCI 117,A01,494376,Staff,0,5,5,5
1715665733071,WES 237B,A00,494380,Staff,10,0,20,10
1715665735147,AESE 279B,A00,494370,Wade; Jon P,0,0,33,33
1715665736176,AIP 97,001,660915,Van Den Einde; Yael Dahlia,9998,0,9999,1
1715665737205,AIP 197,001,627712,Vespa; Emanuel Ignacio,9995,0,9999,4
1715665737205,AIP 197,002,650778,Amir; On,9998,0,9999,1
1715665737205,AIP 197,003,650933,Avenancio-Leon; Carlos,9998,0,9999,1
1715665737205,AIP 197,004,658530,Heyman; Gail D.,9998,0,9999,1
1715665737205,AIP 197,005,658631,Neal; Sonya E,9998,0,9999,1
1715665737205,AIP 197,006,658671,Du; Songzi,9998,0,9999,1
1715665738233,ANAR 135S,A00,494369,Braswell; Geoffrey E.,0,0,0,0
1715665739262,BENG 196,001,628496,Engler; Adam J.,9998,0,9999,1
1715665739262,BENG 196,002,660916,Watson; John Thomas,9998,0,9999,1
1715665740293,BISP 197,001,650773,Wilhelm; James E.,9994,0,9999,5
1715665740293,BISP 197,002,658904,Coleman; Aaron B.,9998,0,9999,1
1715665741322,CAT 124RS,A01,519847,Geibel; William,0,0,20,20
1715665742353,CAT 125RS,A01,515971,Geibel; William,0,0,20,20
1715665743386,CLRE 250,A00,511389,Morris; Sheldon,9992,0,9999,7
1715665744414,CLRE 251,A00,507176,Mehta; Ravindra L.,9992,0,9999,7
1715665744414,CLRE 251,B00,511410,Mehta; Ravindra L.,9998,0,9999,1
1715665745441,CLRE 252,A00,507189,Cuomo; Raphael Eduardo,9994,0,9999,5
1715665746471,CLRE 253,A00,507199,Vaida; Florin,9994,0,9999,5
1715665746471,CLRE 253,B00,507202,Vaida; Florin,9999,0,9999,0
1715665747501,CLRE 259,A00,507211,Patel; Hemal,9996,0,9999,3
1715665748527,CLRE 260,A00,507221,Cuomo; Raphael Eduardo,9999,0,9999,0
1715665749550,CLRE 297,001,507242,Cuomo; Raphael Eduardo,9999,0,9999,0
1715665750578,COGS 197,001,638244,Voytek; Bradley Thomas,9997,0,9999,2
1715665751604,CSE 191,A00,516875,Minnes Kemp; Mor Mia,9991,0,9999,8
1715665752633,CSE 197,001,637388,Minnes Kemp; Mor Mia,9992,0,9999,7
1715665753660,CSS 201S,A01,494383,Mignozzetti; Umberto,35,0,35,0
1715665754686,CSS 202S,A01,494387,Mignozzetti; Umberto,35,0,35,0
1715665755711,DSC 197,001,628532,Eldridge; Justin Matthew,9995,0,9999,4
1715665756737,EAP 100,A00,516065,Staff,9799,0,9999,200
1715665757767,ECE 45,A01,507414,Staff,32,0,60,28
1715665759818,ECE 111,A01,507420,Staff,11,0,50,39
1715665760843,ECE 197,001,548057,Sievenpiper; Daniel F.,9991,0,9999,8
1715665761870,EDS 115,A00,507243,Choi; Bailey Miyeon,6,0,28,22
1715665762901,EDS 117,A01,494379,Staff,0,6,34,35
1715665763931,EDS 125,A00,507246,Hopkins; Megan Beth,7,0,30,23
1715665764962,EDS 128A,A01,507264,Fargason; Sharon Gayle,5,0,26,21
1715665765990,EDS 128B,A01,507293,Pappas; Elizabeth,9,0,30,21
1715665767015,EDS 139,A00,507294,Fargason; Sharon Gayle,9,0,30,21
1715665767015,EDS 139,B00,507313,Pappas; Elizabeth,9,0,30,21
1715665768042,EDS 201,A00,507315,Staff,10,0,30,20
1715665769071,EDS 203,A01,507317,Halter; Christopher P.,10,0,30,20
1715665770097,EDS 204R,A01,507319,Halter; Christopher P.,0,3,30,30
1715665770097,EDS 204R,B01,507331,Heinzman; Erica M.,14,0,30,16
1715665771125,EDS 206R,A00,507332,Staff,0,4,30,30
1715665771125,EDS 206R,B00,507343,Staff,15,0,30,15
1715665772151,EDS 250,A00,507344,Hemans; Patricia Ann Benitez,20,0,40,20
1715665773177,EDS 281,A00,507345,Daly; Alan J.,18,0,18,0
1715665774202,EDS 284,A00,507350,Daly; Alan J.,16,0,16,0
1715665775231,EDS 286,A00,507359,Fine; Sarah,18,0,18,0
1715665776255,EDS 289C,A01,507361,Daly; Alan J.,18,0,18,0
1715665777281,EDS 290,A00,507366,Hofstetter; Carolyn,15,0,15,0
1715665778311,LIGM 5A,A00,507421,Fischer-Grunski; Eva K,17,0,20,3
1715665779343,LIGM 5B,A00,507423,Fischer-Grunski; Eva K,19,0,20,1
1715665780372,LIGM 5C,A00,507425,Fischer-Grunski; Eva K,19,0,20,1
1715665781398,LIIT 5AS,A00,507427,Carnelos; Chiara,20,0,20,0
1715665782427,LIIT 5BS,A00,507430,Carnelos; Chiara,20,0,20,0
1715665783456,LIIT 5CS,A00,507432,Carnelos; Chiara,20,0,20,0
1715665784481,LISP 5A,A00,507541,Munoz Sanchez; Alicia,11,0,20,9
1715665785511,LISP 5B,A00,507671,Munoz Sanchez; Alicia,8,0,20,12
1715665786536,LISP 5C,A00,507696,Munoz Sanchez; Alicia,7,0,20,13
1715665787565,MAE 197,001,528363,Boechler; Nicholas Sebastia,9998,0,9999,1
1715665788595,MATH 197,001,523477,Kedlaya; Kiran S.,9994,0,9999,5
1715665788595,MATH 197,002,563811,Zhang; Danna,9994,0,9999,5
1715665788595,MATH 197,003,628552,Dumitriu; Ioana,9998,0,9999,1
1715665788595,MATH 197,004,660885,Floyd; Eric,9998,0,9999,1
1715665789622,MCWP 40R,A00,518780,Staff,1,0,20,19
1715665789622,MCWP 40R,B00,518781,Carter; Jennifer A,9,0,20,11
1715665789622,MCWP 40R,C00,518783,Smith; Haydee Marie,5,0,20,15
1715665790649,MCWP 50R,A00,518791,Redela; Pamela Morgan,0,1,20,20
1715665790649,MCWP 50R,B00,518792,Krone; Jarret,0,2,20,20
1715665790649,MCWP 50R,C00,518793,Staff,0,4,20,20
1715665790649,MCWP 50R,D00,518794,Morshed; Michael James,0,2,20,20
1715665790649,MCWP 50R,E00,518795,Carter; Andrea L,0,2,20,20
1715665790649,MCWP 50R,F00,518796,Miller; Elizabeth Deen,0,1,20,20
1715665790649,MCWP 50R,G00,518797,Guillen; Melinda,0,1,20,20
1715665791675,MMW 12R,A01,514034,Herbst; Matthew,0,2,16,16
1715665791675,MMW 12R,A02,514035,Herbst; Matthew,0,0,16,16
1715665792700,MMW 13R,A01,514037,Staff,0,5,16,16
1715665792700,MMW 13R,A02,514039,Staff,0,5,16,16
1715665792700,MMW 13R,A03,628519,Staff,0,4,16,16
1715665794766,SIO 295LS,A00,523233,Staff,10,0,30,20
1715665795790,SIO 295S,A00,523232,Staff,10,0,30,20
1715665796819,SIOC 290S,A01,637330,Merrifield; Mark A,21,0,30,9
1715665797844,SIOC 291S,A01,637333,Gabriel; Corey John,21,0,30,9
1715665798871,SOCI 117,A01,494376,Staff,0,5,5,5
1715665799896,WES 237B,A00,494380,Staff,10,0,20,10
1715665802040,AESE 279B,A00,494370,Wade; Jon P,0,0,33,33
1715665803064,AIP 97,001,660915,Van Den Einde; Yael Dahlia,9998,0,9999,1
1715665804094,AIP 197,001,627712,Vespa; Emanuel Ignacio,9995,0,9999,4
1715665804094,AIP 197,002,650778,Amir; On,9998,0,9999,1
1715665804094,AIP 197,003,650933,Avenancio-Leon; Carlos,9998,0,9999,1
1715665804094,AIP 197,004,658530,Heyman; Gail D.,9998,0,9999,1
1715665804094,AIP 197,005,658631,Neal; Sonya E,9998,0,9999,1
1715665804094,AIP 197,006,658671,Du; Songzi,9998,0,9999,1
1715665805122,ANAR 135S,A00,494369,Braswell; Geoffrey E.,0,0,0,0
1715665806148,BENG 196,001,628496,Engler; Adam J.,9998,0,9999,1
1715665806148,BENG 196,002,660916,Watson; John Thomas,9998,0,9999,1
1715665807178,BISP 197,001,650773,Wilhelm; James E.,9994,0,9999,5
1715665807178,BISP 197,002,658904,Coleman; Aaron B.,9998,0,9999,1
1715665808204,CAT 124RS,A01,519847,Geibel; William,0,0,20,20
1715665809233,CAT 125RS,A01,515971,Geibel; William,0,0,20,20
1715665810259,CLRE 250,A00,511389,Morris; Sheldon,9992,0,9999,7
1715665811291,CLRE 251,A00,507176,Mehta; Ravindra L.,9992,0,9999,7
1715665811291,CLRE 251,B00,511410,Mehta; Ravindra L.,9998,0,9999,1
1715665812319,CLRE 252,A00,507189,Cuomo; Raphael Eduardo,9994,0,9999,5
1715665813346,CLRE 253,A00,507199,Vaida; Florin,9994,0,9999,5
1715665813346,CLRE 253,B00,507202,Vaida; Florin,9999,0,9999,0
1715665814372,CLRE 259,A00,507211,Patel; Hemal,9996,0,9999,3
1715665815401,CLRE 260,A00,507221,Cuomo; Raphael Eduardo,9999,0,9999,0
1715665816428,CLRE 297,001,507242,Cuomo; Raphael Eduardo,9999,0,9999,0
1715665817458,COGS 197,001,638244,Voytek; Bradley Thomas,9997,0,9999,2
1715665818484,CSE 191,A00,516875,Minnes Kemp; Mor Mia,9991,0,9999,8
1715665819511,CSE 197,001,637388,Minnes Kemp; Mor Mia,9992,0,9999,7
1715665820538,CSS 201S,A01,494383,Mignozzetti; Umberto,35,0,35,0
1715665821568,CSS 202S,A01,494387,Mignozzetti; Umberto,35,0,35,0
1715665822593,DSC 197,001,628532,Eldridge; Justin Matthew,9995,0,9999,4
1715665823620,EAP 100,A00,516065,Staff,9799,0,9999,200
1715665824696,ECE 45,A01,507414,Staff,32,0,60,28
1715665826750,ECE 111,A01,507420,Staff,11,0,50,39
1715665827776,ECE 197,001,548057,Sievenpiper; Daniel F.,9991,0,9999,8
1715665828807,EDS 115,A00,507243,Choi; Bailey Miyeon,6,0,28,22
1715665829832,EDS 117,A01,494379,Staff,0,6,34,35
1715665830861,EDS 125,A00,507246,Hopkins; Megan Beth,7,0,30,23
1715665831886,EDS 128A,A01,507264,Fargason; Sharon Gayle,5,0,26,21
1715665832911,EDS 128B,A01,507293,Pappas; Elizabeth,9,0,30,21
1715665833937,EDS 139,A00,507294,Fargason; Sharon Gayle,9,0,30,21
1715665833937,EDS 139,B00,507313,Pappas; Elizabeth,9,0,30,21
1715665834965,EDS 201,A00,507315,Staff,10,0,30,20
1715665835991,EDS 203,A01,507317,Halter; Christopher P.,10,0,30,20
1715665837017,EDS 204R,A01,507319,Halter; Christopher P.,0,3,30,30
1715665837017,EDS 204R,B01,507331,Heinzman; Erica M.,14,0,30,16
1715665838045,EDS 206R,A00,507332,Staff,0,4,30,30
1715665838045,EDS 206R,B00,507343,Staff,15,0,30,15
1715665839071,EDS 250,A00,507344,Hemans; Patricia Ann Benitez,20,0,40,20
1715665840098,EDS 281,A00,507345,Daly; Alan J.,18,0,18,0
1715665841124,EDS 284,A00,507350,Daly; Alan J.,16,0,16,0
1715665842156,EDS 286,A00,507359,Fine; Sarah,18,0,18,0
1715665843185,EDS 289C,A01,507361,Daly; Alan J.,18,0,18,0
1715665844213,EDS 290,A00,507366,Hofstetter; Carolyn,15,0,15,0
1715665845244,LIGM 5A,A00,507421,Fischer-Grunski; Eva K,17,0,20,3
1715665846273,LIGM 5B,A00,507423,Fischer-Grunski; Eva K,19,0,20,1
1715665847299,LIGM 5C,A00,507425,Fischer-Grunski; Eva K,19,0,20,1
1715665848325,LIIT 5AS,A00,507427,Carnelos; Chiara,20,0,20,0
1715665849355,LIIT 5BS,A00,507430,Carnelos; Chiara,20,0,20,0
1715665850380,LIIT 5CS,A00,507432,Carnelos; Chiara,20,0,20,0
1715665851406,LISP 5A,A00,507541,Munoz Sanchez; Alicia,11,0,20,9
1715665852430,LISP 5B,A00,507671,Munoz Sanchez; Alicia,8,0,20,12
1715665853459,LISP 5C,A00,507696,Munoz Sanchez; Alicia,7,0,20,13
1715665854486,MAE 197,001,528363,Boechler; Nicholas Sebastia,9998,0,9999,1
1715665855516,MATH 197,001,523477,Kedlaya; Kiran S.,9994,0,9999,5
1715665855516,MATH 197,002,563811,Zhang; Danna,9994,0,9999,5
1715665855516,MATH 197,003,628552,Dumitriu; Ioana,9998,0,9999,1
1715665855516,MATH 197,004,660885,Floyd; Eric,9998,0,9999,1
1715665856548,MCWP 40R,A00,518780,Staff,1,0,20,19
1715665856548,MCWP 40R,B00,518781,Carter; Jennifer A,9,0,20,11
1715665856548,MCWP 40R,C00,518783,Smith; Haydee Marie,5,0,20,15
1715665857575,MCWP 50R,A00,518791,Redela; Pamela Morgan,0,1,20,20
1715665857575,MCWP 50R,B00,518792,Krone; Jarret,0,2,20,20
1715665857575,MCWP 50R,C00,518793,Staff,0,4,20,20
1715665857575,MCWP 50R,D00,518794,Morshed; Michael James,0,2,20,20
1715665857575,MCWP 50R,E00,518795,Carter; Andrea L,0,2,20,20
1715665857575,MCWP 50R,F00,518796,Miller; Elizabeth Deen,0,1,20,20
1715665857575,MCWP 50R,G00,518797,Guillen; Melinda,0,1,20,20
1715665858602,MMW 12R,A01,514034,Herbst; Matthew,0,2,16,16
1715665858602,MMW 12R,A02,514035,Herbst; Matthew,0,0,16,16
1715665859634,MMW 13R,A01,514037,Staff,0,5,16,16
1715665859634,MMW 13R,A02,514039,Staff,0,5,16,16
1715665859634,MMW 13R,A03,628519,Staff,0,4,16,16
1715665861687,SIO 295LS,A00,523233,Staff,10,0,30,20
1715665862716,SIO 295S,A00,523232,Staff,10,0,30,20
1715665863745,SIOC 290S,A01,637330,Merrifield; Mark A,21,0,30,9
1715665864769,SIOC 291S,A01,637333,Gabriel; Corey John,21,0,30,9
1715665865794,SOCI 117,A01,494376,Staff,0,5,5,5
1715665866821,WES 237B,A00,494380,Staff,10,0,20,10
1715665868894,AESE 279B,A00,494370,Wade; Jon P,0,0,33,33
1715665869920,AIP 97,001,660915,Van Den Einde; Yael Dahlia,9998,0,9999,1
1715665870947,AIP 197,001,627712,Vespa; Emanuel Ignacio,9995,0,9999,4
1715665870947,AIP 197,002,650778,Amir; On,9998,0,9999,1
1715665870947,AIP 197,003,650933,Avenancio-Leon; Carlos,9998,0,9999,1
1715665870947,AIP 197,004,658530,Heyman; Gail D.,9998,0,9999,1
1715665870947,AIP 197,005,658631,Neal; Sonya E,9998,0,9999,1
1715665870947,AIP 197,006,658671,Du; Songzi,9998,0,9999,1
1715665871972,ANAR 135S,A00,494369,Braswell; Geoffrey E.,0,0,0,0
1715665872997,BENG 196,001,628496,Engler; Adam J.,9998,0,9999,1
1715665872997,BENG 196,002,660916,Watson; John Thomas,9998,0,9999,1
1715665874023,BISP 197,001,650773,Wilhelm; James E.,9994,0,9999,5
1715665874023,BISP 197,002,658904,Coleman; Aaron B.,9998,0,9999,1
1715665875051,CAT 124RS,A01,519847,Geibel; William,0,0,20,20
1715665876079,CAT 125RS,A01,515971,Geibel; William,0,0,20,20
1715665877110,CLRE 250,A00,511389,Morris; Sheldon,9992,0,9999,7
1715665878139,CLRE 251,A00,507176,Mehta; Ravindra L.,9992,0,9999,7
1715665878139,CLRE 251,B00,511410,Mehta; Ravindra L.,9998,0,9999,1
1715665879168,CLRE 252,A00,507189,Cuomo; Raphael Eduardo,9994,0,9999,5
1715665880195,CLRE 253,A00,507199,Vaida; Florin,9994,0,9999,5
1715665880195,CLRE 253,B00,507202,Vaida; Florin,9999,0,9999,0
1715665881224,CLRE 259,A00,507211,Patel; Hemal,9996,0,9999,3
1715665882249,CLRE 260,A00,507221,Cuomo; Raphael Eduardo,9999,0,9999,0
1715665883277,CLRE 297,001,507242,Cuomo; Raphael Eduardo,9999,0,9999,0
1715665884306,COGS 197,001,638244,Voytek; Bradley Thomas,9997,0,9999,2
1715665885333,CSE 191,A00,516875,Minnes Kemp; Mor Mia,9991,0,9999,8
1715665886359,CSE 197,001,637388,Minnes Kemp; Mor Mia,9992,0,9999,7
1715665887386,CSS 201S,A01,494383,Mignozzetti; Umberto,35,0,35,0
1715665888410,CSS 202S,A01,494387,Mignozzetti; Umberto,35,0,35,0
1715665889435,DSC 197,001,628532,Eldridge; Justin Matthew,9995,0,9999,4
1715665890461,EAP 100,A00,516065,Staff,9799,0,9999,200
1715665891489,ECE 45,A01,507414,Staff,32,0,60,28
1715665893539,ECE 111,A01,507420,Staff,11,0,50,39
1715665894564,ECE 197,001,548057,Sievenpiper; Daniel F.,9991,0,9999,8
1715665895592,EDS 115,A00,507243,Choi; Bailey Miyeon,6,0,28,22
1715665896618,EDS 117,A01,494379,Staff,0,6,34,35
1715665897644,EDS 125,A00,507246,Hopkins; Megan Beth,7,0,30,23
1715665898670,EDS 128A,A01,507264,Fargason; Sharon Gayle,5,0,26,21
1715665899696,EDS 128B,A01,507293,Pappas; Elizabeth,9,0,30,21
1715665900724,EDS 139,A00,507294,Fargason; Sharon Gayle,9,0,30,21
1715665900724,EDS 139,B00,507313,Pappas; Elizabeth,9,0,30,21
1715665901752,EDS 201,A00,507315,Staff,10,0,30,20
1715665902781,EDS 203,A01,507317,Halter; Christopher P.,10,0,30,20
1715665903810,EDS 204R,A01,507319,Halter; Christopher P.,0,3,30,30
1715665903810,EDS 204R,B01,507331,Heinzman; Erica M.,14,0,30,16
1715665904835,EDS 206R,A00,507332,Staff,0,4,30,30
1715665904835,EDS 206R,B00,507343,Staff,15,0,30,15
1715665905933,EDS 250,A00,507344,Hemans; Patricia Ann Benitez,20,0,40,20
1715665906959,EDS 281,A00,507345,Daly; Alan J.,18,0,18,0
1715665907986,EDS 284,A00,507350,Daly; Alan J.,16,0,16,0
1715665909021,EDS 286,A00,507359,Fine; Sarah,18,0,18,0
1715665910045,EDS 289C,A01,507361,Daly; Alan J.,18,0,18,0
1715665911069,EDS 290,A00,507366,Hofstetter; Carolyn,15,0,15,0
1715665912093,LIGM 5A,A00,507421,Fischer-Grunski; Eva K,17,0,20,3
1715665913120,LIGM 5B,A00,507423,Fischer-Grunski; Eva K,19,0,20,1
1715665914146,LIGM 5C,A00,507425,Fischer-Grunski; Eva K,19,0,20,1
1715665915172,LIIT 5AS,A00,507427,Carnelos; Chiara,20,0,20,0
1715665916200,LIIT 5BS,A00,507430,Carnelos; Chiara,20,0,20,0
1715665917228,LIIT 5CS,A00,507432,Carnelos; Chiara,20,0,20,0
1715665918254,LISP 5A,A00,507541,Munoz Sanchez; Alicia,11,0,20,9
1715665919279,LISP 5B,A00,507671,Munoz Sanchez; Alicia,8,0,20,12
1715665920304,LISP 5C,A00,507696,Munoz Sanchez; Alicia,7,0,20,13
1715665921330,MAE 197,001,528363,Boechler; Nicholas Sebastia,9998,0,9999,1
1715665922356,MATH 197,001,523477,Kedlaya; Kiran S.,9994,0,9999,5
1715665922356,MATH 197,002,563811,Zhang; Danna,9994,0,9999,5
1715665922356,MATH 197,003,628552,Dumitriu; Ioana,9998,0,9999,1
1715665922356,MATH 197,004,660885,Floyd; Eric,9998,0,9999,1
1715665923382,MCWP 40R,A00,518780,Staff,1,0,20,19
1715665923382,MCWP 40R,B00,518781,Carter; Jennifer A,9,0,20,11
1715665923382,MCWP 40R,C00,518783,Smith; Haydee Marie,5,0,20,15
1715665924416,MCWP 50R,A00,518791,Redela; Pamela Morgan,0,1,20,20
1715665924416,MCWP 50R,B00,518792,Krone; Jarret,0,2,20,20
1715665924416,MCWP 50R,C00,518793,Staff,0,4,20,20
1715665924416,MCWP 50R,D00,518794,Morshed; Michael James,0,2,20,20
1715665924416,MCWP 50R,E00,518795,Carter; Andrea L,0,2,20,20
1715665924416,MCWP 50R,F00,518796,Miller; Elizabeth Deen,0,1,20,20
1715665924416,MCWP 50R,G00,518797,Guillen; Melinda,0,1,20,20
1715665925442,MMW 12R,A01,514034,Herbst; Matthew,0,2,16,16
1715665925442,MMW 12R,A02,514035,Herbst; Matthew,0,0,16,16
1715665926467,MMW 13R,A01,514037,Staff,0,5,16,16
1715665926467,MMW 13R,A02,514039,Staff,0,5,16,16
1715665926467,MMW 13R,A03,628519,Staff,0,4,16,16
1715665928517,SIO 295LS,A00,523233,Staff,10,0,30,20
1715665929542,SIO 295S,A00,523232,Staff,10,0,30,20
1715665930571,SIOC 290S,A01,637330,Merrifield; Mark A,21,0,30,9
1715665931597,SIOC 291S,A01,637333,Gabriel; Corey John,21,0,30,9
1715665932624,SOCI 117,A01,494376,Staff,0,5,5,5
1715665933649,WES 237B,A00,494380,Staff,10,0,20,10
1715665935716,AESE 279B,A00,494370,Wade; Jon P,0,0,33,33
1715665936741,AIP 97,001,660915,Van Den Einde; Yael Dahlia,9998,0,9999,1
1715665937774,AIP 197,001,627712,Vespa; Emanuel Ignacio,9995,0,9999,4
1715665937774,AIP 197,002,650778,Amir; On,9998,0,9999,1
1715665937774,AIP 197,003,650933,Avenancio-Leon; Carlos,9998,0,9999,1
1715665937774,AIP 197,004,658530,Heyman; Gail D.,9998,0,9999,1
1715665937774,AIP 197,005,658631,Neal; Sonya E,9998,0,9999,1
1715665937774,AIP 197,006,658671,Du; Songzi,9998,0,9999,1
1715665938802,ANAR 135S,A00,494369,Braswell; Geoffrey E.,0,0,0,0
1715665939827,BENG 196,001,628496,Engler; Adam J.,9998,0,9999,1
1715665939827,BENG 196,002,660916,Watson; John Thomas,9998,0,9999,1
1715665940854,BISP 197,001,650773,Wilhelm; James E.,9994,0,9999,5
1715665940854,BISP 197,002,658904,Coleman; Aaron B.,9998,0,9999,1
1715665941882,CAT 124RS,A01,519847,Geibel; William,0,0,20,20
1715665942907,CAT 125RS,A01,515971,Geibel; William,0,0,20,20
1715665943934,CLRE 250,A00,511389,Morris; Sheldon,9992,0,9999,7
1715665944960,CLRE 251,A00,507176,Mehta; Ravindra L.,9992,0,9999,7
1715665944960,CLRE 251,B00,511410,Mehta; Ravindra L.,9998,0,9999,1
1715665945985,CLRE 252,A00,507189,Cuomo; Raphael Eduardo,9994,0,9999,5
1715665947011,CLRE 253,A00,507199,Vaida; Florin,9994,0,9999,5
1715665947011,CLRE 253,B00,507202,Vaida; Florin,9999,0,9999,0
1715665948040,CLRE 259,A00,507211,Patel; Hemal,9996,0,9999,3
1715665949064,CLRE 260,A00,507221,Cuomo; Raphael Eduardo,9999,0,9999,0
1715665950093,CLRE 297,001,507242,Cuomo; Raphael Eduardo,9999,0,9999,0
1715665951119,COGS 197,001,638244,Voytek; Bradley Thomas,9997,0,9999,2
1715665952144,CSE 191,A00,516875,Minnes Kemp; Mor Mia,9991,0,9999,8
1715665953169,CSE 197,001,637388,Minnes Kemp; Mor Mia,9992,0,9999,7
1715665954202,CSS 201S,A01,494383,Mignozzetti; Umberto,35,0,35,0
1715665955233,CSS 202S,A01,494387,Mignozzetti; Umberto,35,0,35,0
1715665956261,DSC 197,001,628532,Eldridge; Justin Matthew,9995,0,9999,4
1715665957286,EAP 100,A00,516065,Staff,9799,0,9999,200
1715665958318,ECE 45,A01,507414,Staff,32,0,60,28
1715665960373,ECE 111,A01,507420,Staff,11,0,50,39
1715665961400,ECE 197,001,548057,Sievenpiper; Daniel F.,9991,0,9999,8
1715665962427,EDS 115,A00,507243,Choi; Bailey Miyeon,6,0,28,22
1715665963456,EDS 117,A01,494379,Staff,0,6,34,35
1715665964484,EDS 125,A00,507246,Hopkins; Megan Beth,7,0,30,23
1715665965516,EDS 128A,A01,507264,Fargason; Sharon Gayle,5,0,26,21
1715665966542,EDS 128B,A01,507293,Pappas; Elizabeth,9,0,30,21
1715665967566,EDS 139,A00,507294,Fargason; Sharon Gayle,9,0,30,21
1715665967566,EDS 139,B00,507313,Pappas; Elizabeth,9,0,30,21
1715665968591,EDS 201,A00,507315,Staff,10,0,30,20
1715665969617,EDS 203,A01,507317,Halter; Christopher P.,10,0,30,20
1715665970643,EDS 204R,A01,507319,Halter; Christopher P.,0,3,30,30
1715665970643,EDS 204R,B01,507331,Heinzman; Erica M.,14,0,30,16
1715665971669,EDS 206R,A00,507332,Staff,0,4,30,30
1715665971669,EDS 206R,B00,507343,Staff,15,0,30,15
1715665972694,EDS 250,A00,507344,Hemans; Patricia Ann Benitez,20,0,40,20
1715665973719,EDS 281,A00,507345,Daly; Alan J.,18,0,18,0
1715665974746,EDS 284,A00,507350,Daly; Alan J.,16,0,16,0
1715665975771,EDS 286,A00,507359,Fine; Sarah,18,0,18,0
1715665976796,EDS 289C,A01,507361,Daly; Alan J.,18,0,18,0
1715665977821,EDS 290,A00,507366,Hofstetter; Carolyn,15,0,15,0
1715665978850,LIGM 5A,A00,507421,Fischer-Grunski; Eva K,17,0,20,3
1715665979875,LIGM 5B,A00,507423,Fischer-Grunski; Eva K,19,0,20,1
1715665980899,LIGM 5C,A00,507425,Fischer-Grunski; Eva K,19,0,20,1
1715665981925,LIIT 5AS,A00,507427,Carnelos; Chiara,20,0,20,0
1715665982953,LIIT 5BS,A00,507430,Carnelos; Chiara,20,0,20,0
1715665983979,LIIT 5CS,A00,507432,Carnelos; Chiara,20,0,20,0
1715665985005,LISP 5A,A00,507541,Munoz Sanchez; Alicia,11,0,20,9
1715665986035,LISP 5B,A00,507671,Munoz Sanchez; Alicia,8,0,20,12
1715665987064,LISP 5C,A00,507696,Munoz Sanchez; Alicia,7,0,20,13
1715665988094,MAE 197,001,528363,Boechler; Nicholas Sebastia,9998,0,9999,1
1715665989128,MATH 197,001,523477,Kedlaya; Kiran S.,9994,0,9999,5
1715665989128,MATH 197,002,563811,Zhang; Danna,9994,0,9999,5
1715665989128,MATH 197,003,628552,Dumitriu; Ioana,9998,0,9999,1
1715665989128,MATH 197,004,660885,Floyd; Eric,9998,0,9999,1
1715665990156,MCWP 40R,A00,518780,Staff,1,0,20,19
1715665990156,MCWP 40R,B00,518781,Carter; Jennifer A,9,0,20,11
1715665990156,MCWP 40R,C00,518783,Smith; Haydee Marie,5,0,20,15
1715665991292,MCWP 50R,A00,518791,Redela; Pamela Morgan,0,1,20,20
1715665991292,MCWP 50R,B00,518792,Krone; Jarret,0,2,20,20
1715665991292,MCWP 50R,C00,518793,Staff,0,4,20,20
1715665991292,MCWP 50R,D00,518794,Morshed; Michael James,0,2,20,20
1715665991292,MCWP 50R,E00,518795,Carter; Andrea L,0,2,20,20
1715665991292,MCWP 50R,F00,518796,Miller; Elizabeth Deen,0,1,20,20
1715665991292,MCWP 50R,G00,518797,Guillen; Melinda,0,1,20,20
1715665992322,MMW 12R,A01,514034,Herbst; Matthew,0,2,16,16
1715665992322,MMW 12R,A02,514035,Herbst; Matthew,0,0,16,16
1715665993350,MMW 13R,A01,514037,Staff,0,5,16,16
1715665993350,MMW 13R,A02,514039,Staff,0,5,16,16
1715665993350,MMW 13R,A03,628519,Staff,0,4,16,16
1715665995405,SIO 295LS,A00,523233,Staff,10,0,30,20
1715665996431,SIO 295S,A00,523232,Staff,10,0,30,20
1715665997463,SIOC 290S,A01,637330,Merrifield; Mark A,21,0,30,9
1715665998489,SIOC 291S,A01,637333,Gabriel; Corey John,21,0,30,9
1715665999513,SOCI 117,A01,494376,Staff,0,5,5,5
1715666000543,WES 237B,A00,494380,Staff,10,0,20,10
1715666002619,AESE 279B,A00,494370,Wade; Jon P,0,0,33,33
1715666003652,AIP 97,001,660915,Van Den Einde; Yael Dahlia,9998,0,9999,1
1715666004679,AIP 197,001,627712,Vespa; Emanuel Ignacio,9995,0,9999,4
1715666004679,AIP 197,002,650778,Amir; On,9998,0,9999,1
1715666004679,AIP 197,003,650933,Avenancio-Leon; Carlos,9998,0,9999,1
1715666004679,AIP 197,004,658530,Heyman; Gail D.,9998,0,9999,1
1715666004679,AIP 197,005,658631,Neal; Sonya E,9998,0,9999,1
1715666004679,AIP 197,006,658671,Du; Songzi,9998,0,9999,1
1715666005708,ANAR 135S,A00,494369,Braswell; Geoffrey E.,0,0,0,0
1715666006734,BENG 196,001,628496,Engler; Adam J.,9998,0,9999,1
1715666006734,BENG 196,002,660916,Watson; John Thomas,9998,0,9999,1
1715666007762,BISP 197,001,650773,Wilhelm; James E.,9994,0,9999,5
1715666007762,BISP 197,002,658904,Coleman; Aaron B.,9998,0,9999,1
1715666008790,CAT 124RS,A01,519847,Geibel; William,0,0,20,20
1715666009870,CAT 125RS,A01,515971,Geibel; William,0,0,20,20
1715666010979,CLRE 250,A00,511389,Morris; Sheldon,9992,0,9999,7
1715666012007,CLRE 251,A00,507176,Mehta; Ravindra L.,9992,0,9999,7
1715666012007,CLRE 251,B00,511410,Mehta; Ravindra L.,9998,0,9999,1
1715666013032,CLRE 252,A00,507189,Cuomo; Raphael Eduardo,9994,0,9999,5
1715666014061,CLRE 253,A00,507199,Vaida; Florin,9994,0,9999,5
1715666014061,CLRE 253,B00,507202,Vaida; Florin,9999,0,9999,0
1715666015088,CLRE 259,A00,507211,Patel; Hemal,9996,0,9999,3
1715666016117,CLRE 260,A00,507221,Cuomo; Raphael Eduardo,9999,0,9999,0
1715666017147,CLRE 297,001,507242,Cuomo; Raphael Eduardo,9999,0,9999,0
1715666018177,COGS 197,001,638244,Voytek; Bradley Thomas,9997,0,9999,2
1715666019206,CSE 191,A00,516875,Minnes Kemp; Mor Mia,9991,0,9999,8
1715666020236,CSE 197,001,637388,Minnes Kemp; Mor Mia,9992,0,9999,7
1715666021270,CSS 201S,A01,494383,Mignozzetti; Umberto,35,0,35,0
1715666022297,CSS 202S,A01,494387,Mignozzetti; Umberto,35,0,35,0
1715666023324,DSC 197,001,628532,Eldridge; Justin Matthew,9995,0,9999,4
1715666024349,EAP 100,A00,516065,Staff,9799,0,9999,200
1715666025378,ECE 45,A01,507414,Staff,32,0,60,28
1715666027433,ECE 111,A01,507420,Staff,11,0,50,39
1715666028461,ECE 197,001,548057,Sievenpiper; Daniel F.,9991,0,9999,8
1715666029489,EDS 115,A00,507243,Choi; Bailey Miyeon,6,0,28,22
1715666030517,EDS 117,A01,494379,Staff,0,6,34,35
1715666031544,EDS 125,A00,507246,Hopkins; Megan Beth,7,0,30,23
1715666032575,EDS 128A,A01,507264,Fargason; Sharon Gayle,5,0,26,21
1715666033604,EDS 128B,A01,507293,Pappas; Elizabeth,9,0,30,21
1715666034630,EDS 139,A00,507294,Fargason; Sharon Gayle,9,0,30,21
1715666034630,EDS 139,B00,507313,Pappas; Elizabeth,9,0,30,21
1715666035657,EDS 201,A00,507315,Staff,10,0,30,20
1715666036685,EDS 203,A01,507317,Halter; Christopher P.,10,0,30,20
1715666037712,EDS 204R,A01,507319,Halter; Christopher P.,0,3,30,30
1715666037712,EDS 204R,B01,507331,Heinzman; Erica M.,14,0,30,16
1715666038741,EDS 206R,A00,507332,Staff,0,4,30,30
1715666038741,EDS 206R,B00,507343,Staff,15,0,30,15
1715666039767,EDS 250,A00,507344,Hemans; Patricia Ann Benitez,20,0,40,20
1715666040798,EDS 281,A00,507345,Daly; Alan J.,18,0,18,0
1715666041828,EDS 284,A00,507350,Daly; Alan J.,16,0,16,0
1715666042857,EDS 286,A00,507359,Fine; Sarah,18,0,18,0
1715666043883,EDS 289C,A01,507361,Daly; Alan J.,18,0,18,0
1715666044912,EDS 290,A00,507366,Hofstetter; Carolyn,15,0,15,0
1715666045939,LIGM 5A,A00,507421,Fischer-Grunski; Eva K,17,0,20,3
1715666046965,LIGM 5B,A00,507423,Fischer-Grunski; Eva K,19,0,20,1
1715666047994,LIGM 5C,A00,507425,Fischer-Grunski; Eva K,19,0,20,1
1715666049019,LIIT 5AS,A00,507427,Carnelos; Chiara,20,0,20,0
1715666050049,LIIT 5BS,A00,507430,Carnelos; Chiara,20,0,20,0
1715666051077,LIIT 5CS,A00,507432,Carnelos; Chiara,20,0,20,0
1715666052103,LISP 5A,A00,507541,Munoz Sanchez; Alicia,11,0,20,9
1715666053131,LISP 5B,A00,507671,Munoz Sanchez; Alicia,8,0,20,12
1715666054157,LISP 5C,A00,507696,Munoz Sanchez; Alicia,7,0,20,13
1715666055182,MAE 197,001,528363,Boechler; Nicholas Sebastia,9998,0,9999,1
1715666056210,MATH 197,001,523477,Kedlaya; Kiran S.,9994,0,9999,5
1715666056210,MATH 197,002,563811,Zhang; Danna,9994,0,9999,5
1715666056210,MATH 197,003,628552,Dumitriu; Ioana,9998,0,9999,1
1715666056210,MATH 197,004,660885,Floyd; Eric,9998,0,9999,1
1715666057240,MCWP 40R,A00,518780,Staff,1,0,20,19
1715666057240,MCWP 40R,B00,518781,Carter; Jennifer A,9,0,20,11
1715666057240,MCWP 40R,C00,518783,Smith; Haydee Marie,5,0,20,15
1715666058275,MCWP 50R,A00,518791,Redela; Pamela Morgan,0,1,20,20
1715666058275,MCWP 50R,B00,518792,Krone; Jarret,0,2,20,20
1715666058275,MCWP 50R,C00,518793,Staff,0,4,20,20
1715666058275,MCWP 50R,D00,518794,Morshed; Michael James,0,2,20,20
1715666058275,MCWP 50R,E00,518795,Carter; Andrea L,0,2,20,20
1715666058275,MCWP 50R,F00,518796,Miller; Elizabeth Deen,0,1,20,20
1715666058275,MCWP 50R,G00,518797,Guillen; Melinda,0,1,20,20
1715666059302,MMW 12R,A01,514034,Herbst; Matthew,0,2,16,16
1715666059302,MMW 12R,A02,514035,Herbst; Matthew,0,0,16,16
1715666060327,MMW 13R,A01,514037,Staff,0,5,16,16
1715666060327,MMW 13R,A02,514039,Staff,0,5,16,16
1715666060327,MMW 13R,A03,628519,Staff,0,4,16,16
1715666062381,SIO 295LS,A00,523233,Staff,10,0,30,20
1715666063406,SIO 295S,A00,523232,Staff,10,0,30,20
1715666064435,SIOC 290S,A01,637330,Merrifield; Mark A,21,0,30,9
1715666065462,SIOC 291S,A01,637333,Gabriel; Corey John,21,0,30,9
1715666066488,SOCI 117,A01,494376,Staff,0,5,5,5
1715666067515,WES 237B,A00,494380,Staff,10,0,20,10
1715666069597,AESE 279B,A00,494370,Wade; Jon P,0,0,33,33
1715666070625,AIP 97,001,660915,Van Den Einde; Yael Dahlia,9998,0,9999,1
1715666071655,AIP 197,001,627712,Vespa; Emanuel Ignacio,9995,0,9999,4
1715666071655,AIP 197,002,650778,Amir; On,9998,0,9999,1
1715666071655,AIP 197,003,650933,Avenancio-Leon; Carlos,9998,0,9999,1
1715666071655,AIP 197,004,658530,Heyman; Gail D.,9998,0,9999,1
1715666071655,AIP 197,005,658631,Neal; Sonya E,9998,0,9999,1
1715666071655,AIP 197,006,658671,Du; Songzi,9998,0,9999,1
1715666072683,ANAR 135S,A00,494369,Braswell; Geoffrey E.,0,0,0,0
1715666073713,BENG 196,001,628496,Engler; Adam J.,9998,0,9999,1
1715666073713,BENG 196,002,660916,Watson; John Thomas,9998,0,9999,1
1715666074742,BISP 197,001,650773,Wilhelm; James E.,9994,0,9999,5
1715666074742,BISP 197,002,658904,Coleman; Aaron B.,9998,0,9999,1
1715666075767,CAT 124RS,A01,519847,Geibel; William,0,0,20,20
1715666076794,CAT 125RS,A01,515971,Geibel; William,0,0,20,20
1715666077819,CLRE 250,A00,511389,Morris; Sheldon,9992,0,9999,7
1715666078847,CLRE 251,A00,507176,Mehta; Ravindra L.,9992,0,9999,7
1715666078847,CLRE 251,B00,511410,Mehta; Ravindra L.,9998,0,9999,1
1715666079877,CLRE 252,A00,507189,Cuomo; Raphael Eduardo,9994,0,9999,5
1715666080906,CLRE 253,A00,507199,Vaida; Florin,9994,0,9999,5
1715666080906,CLRE 253,B00,507202,Vaida; Florin,9999,0,9999,0
1715666081934,CLRE 259,A00,507211,Patel; Hemal,9996,0,9999,3
1715666082958,CLRE 260,A00,507221,Cuomo; Raphael Eduardo,9999,0,9999,0
1715666083983,CLRE 297,001,507242,Cuomo; Raphael Eduardo,9999,0,9999,0
1715666085009,COGS 197,001,638244,Voytek; Bradley Thomas,9997,0,9999,2
1715666086034,CSE 191,A00,516875,Minnes Kemp; Mor Mia,9991,0,9999,8
1715666087058,CSE 197,001,637388,Minnes Kemp; Mor Mia,9992,0,9999,7
1715666088084,CSS 201S,A01,494383,Mignozzetti; Umberto,35,0,35,0
1715666089110,CSS 202S,A01,494387,Mignozzetti; Umberto,35,0,35,0
1715666090138,DSC 197,001,628532,Eldridge; Justin Matthew,9995,0,9999,4
1715666091163,EAP 100,A00,516065,Staff,9799,0,9999,200
1715666092190,ECE 45,A01,507414,Staff,32,0,60,28
1715666094246,ECE 111,A01,507420,Staff,11,0,50,39
1715666095272,ECE 197,001,548057,Sievenpiper; Daniel F.,9991,0,9999,8
1715666096300,EDS 115,A00,507243,Choi; Bailey Miyeon,6,0,28,22
1715666097324,EDS 117,A01,494379,Staff,0,6,34,35
1715666098350,EDS 125,A00,507246,Hopkins; Megan Beth,7,0,30,23
1715666099375,EDS 128A,A01,507264,Fargason; Sharon Gayle,5,0,26,21
1715666100404,EDS 128B,A01,507293,Pappas; Elizabeth,9,0,30,21
1715666101428,EDS 139,A00,507294,Fargason; Sharon Gayle,9,0,30,21
1715666101428,EDS 139,B00,507313,Pappas; Elizabeth,9,0,30,21
1715666102454,EDS 201,A00,507315,Staff,10,0,30,20
1715666103483,EDS 203,A01,507317,Halter; Christopher P.,10,0,30,20
1715666104509,EDS 204R,A01,507319,Halter; Christopher P.,0,3,30,30
1715666104509,EDS 204R,B01,507331,Heinzman; Erica M.,14,0,30,16
1715666105534,EDS 206R,A00,507332,Staff,0,4,30,30
1715666105534,EDS 206R,B00,507343,Staff,15,0,30,15
1715666106560,EDS 250,A00,507344,Hemans; Patricia Ann Benitez,20,0,40,20
1715666107584,EDS 281,A00,507345,Daly; Alan J.,18,0,18,0
1715666108612,EDS 284,A00,507350,Daly; Alan J.,16,0,16,0
1715666109796,EDS 286,A00,507359,Fine; Sarah,18,0,18,0
1715666110820,EDS 289C,A01,507361,Daly; Alan J.,18,0,18,0
1715666111845,EDS 290,A00,507366,Hofstetter; Carolyn,15,0,15,0
1715666112876,LIGM 5A,A00,507421,Fischer-Grunski; Eva K,17,0,20,3
1715666113901,LIGM 5B,A00,507423,Fischer-Grunski; Eva K,19,0,20,1
1715666114925,LIGM 5C,A00,507425,Fischer-Grunski; Eva K,19,0,20,1
1715666115950,LIIT 5AS,A00,507427,Carnelos; Chiara,20,0,20,0
1715666116974,LIIT 5BS,A00,507430,Carnelos; Chiara,20,0,20,0
1715666118003,LIIT 5CS,A00,507432,Carnelos; Chiara,20,0,20,0
1715666119030,LISP 5A,A00,507541,Munoz Sanchez; Alicia,11,0,20,9
1715666120055,LISP 5B,A00,507671,Munoz Sanchez; Alicia,8,0,20,12
1715666121086,LISP 5C,A00,507696,Munoz Sanchez; Alicia,7,0,20,13
1715666122112,MAE 197,001,528363,Boechler; Nicholas Sebastia,9998,0,9999,1
1715666123144,MATH 197,001,523477,Kedlaya; Kiran S.,9994,0,9999,5
1715666123144,MATH 197,002,563811,Zhang; Danna,9994,0,9999,5
1715666123144,MATH 197,003,628552,Dumitriu; Ioana,9998,0,9999,1
1715666123144,MATH 197,004,660885,Floyd; Eric,9998,0,9999,1
1715666124171,MCWP 40R,A00,518780,Staff,1,0,20,19
1715666124171,MCWP 40R,B00,518781,Carter; Jennifer A,9,0,20,11
1715666124171,MCWP 40R,C00,518783,Smith; Haydee Marie,5,0,20,15
1715666125203,MCWP 50R,A00,518791,Redela; Pamela Morgan,0,1,20,20
1715666125203,MCWP 50R,B00,518792,Krone; Jarret,0,2,20,20
1715666125203,MCWP 50R,C00,518793,Staff,0,4,20,20
1715666125203,MCWP 50R,D00,518794,Morshed; Michael James,0,2,20,20
1715666125203,MCWP 50R,E00,518795,Carter; Andrea L,0,2,20,20
1715666125203,MCWP 50R,F00,518796,Miller; Elizabeth Deen,0,1,20,20
1715666125203,MCWP 50R,G00,518797,Guillen; Melinda,0,1,20,20
1715666126226,MMW 12R,A01,514034,Herbst; Matthew,0,2,16,16
1715666126226,MMW 12R,A02,514035,Herbst; Matthew,0,0,16,16
1715666127253,MMW 13R,A01,514037,Staff,0,5,16,16
1715666127253,MMW 13R,A02,514039,Staff,0,5,16,16
1715666127253,MMW 13R,A03,628519,Staff,0,4,16,16
1715666129304,SIO 295LS,A00,523233,Staff,10,0,30,20
1715666130332,SIO 295S,A00,523232,Staff,10,0,30,20
1715666131363,SIOC 290S,A01,637330,Merrifield; Mark A,21,0,30,9
1715666132390,SIOC 291S,A01,637333,Gabriel; Corey John,21,0,30,9
1715666133419,SOCI 117,A01,494376,Staff,0,5,5,5
1715666134445,WES 237B,A00,494380,Staff,10,0,20,10
1715666136526,AESE 279B,A00,494370,Wade; Jon P,0,0,33,33
1715666137551,AIP 97,001,660915,Van Den Einde; Yael Dahlia,9998,0,9999,1
1715666138579,AIP 197,001,627712,Vespa; Emanuel Ignacio,9995,0,9999,4
1715666138579,AIP 197,002,650778,Amir; On,9998,0,9999,1
1715666138579,AIP 197,003,650933,Avenancio-Leon; Carlos,9998,0,9999,1
1715666138579,AIP 197,004,658530,Heyman; Gail D.,9998,0,9999,1
1715666138579,AIP 197,005,658631,Neal; Sonya E,9998,0,9999,1
1715666138579,AIP 197,006,658671,Du; Songzi,9998,0,9999,1
1715666139605,ANAR 135S,A00,494369,Braswell; Geoffrey E.,0,0,0,0
1715666140631,BENG 196,001,628496,Engler; Adam J.,9998,0,9999,1
1715666140631,BENG 196,002,660916,Watson; John Thomas,9998,0,9999,1
1715666141657,BISP 197,001,650773,Wilhelm; James E.,9994,0,9999,5
1715666141657,BISP 197,002,658904,Coleman; Aaron B.,9998,0,9999,1
1715666142682,CAT 124RS,A01,519847,Geibel; William,0,0,20,20
1715666143711,CAT 125RS,A01,515971,Geibel; William,0,0,20,20
1715666144738,CLRE 250,A00,511389,Morris; Sheldon,9992,0,9999,7
1715666145770,CLRE 251,A00,507176,Mehta; Ravindra L.,9992,0,9999,7
1715666145770,CLRE 251,B00,511410,Mehta; Ravindra L.,9998,0,9999,1
1715666146795,CLRE 252,A00,507189,Cuomo; Raphael Eduardo,9994,0,9999,5
1715666147824,CLRE 253,A00,507199,Vaida; Florin,9994,0,9999,5
1715666147824,CLRE 253,B00,507202,Vaida; Florin,9999,0,9999,0
1715666148862,CLRE 259,A00,507211,Patel; Hemal,9996,0,9999,3
1715666149886,CLRE 260,A00,507221,Cuomo; Raphael Eduardo,9999,0,9999,0
1715666150911,CLRE 297,001,507242,Cuomo; Raphael Eduardo,9999,0,9999,0
1715666151937,COGS 197,001,638244,Voytek; Bradley Thomas,9997,0,9999,2
1715666152961,CSE 191,A00,516875,Minnes Kemp; Mor Mia,9991,0,9999,8
1715666153989,CSE 197,001,637388,Minnes Kemp; Mor Mia,9992,0,9999,7
1715666155015,CSS 201S,A01,494383,Mignozzetti; Umberto,35,0,35,0
1715666156040,CSS 202S,A01,494387,Mignozzetti; Umberto,35,0,35,0
1715666157069,DSC 197,001,628532,Eldridge; Justin Matthew,9995,0,9999,4
1715666158094,EAP 100,A00,516065,Staff,9799,0,9999,200
1715666159123,ECE 45,A01,507414,Staff,32,0,60,28
1715666161172,ECE 111,A01,507420,Staff,11,0,50,39
1715666162254,ECE 197,001,548057,Sievenpiper; Daniel F.,9991,0,9999,8
1715666163282,EDS 115,A00,507243,Choi; Bailey Miyeon,6,0,28,22
1715666164311,EDS 117,A01,494379,Staff,0,6,34,35
1715666165339,EDS 125,A00,507246,Hopkins; Megan Beth,7,0,30,23
1715666166365,EDS 128A,A01,507264,Fargason; Sharon Gayle,5,0,26,21
1715666167395,EDS 128B,A01,507293,Pappas; Elizabeth,9,0,30,21
1715666168421,EDS 139,A00,507294,Fargason; Sharon Gayle,9,0,30,21
1715666168421,EDS 139,B00,507313,Pappas; Elizabeth,9,0,30,21
1715666169446,EDS 201,A00,507315,Staff,10,0,30,20
1715666170471,EDS 203,A01,507317,Halter; Christopher P.,10,0,30,20
1715666171496,EDS 204R,A01,507319,Halter; Christopher P.,0,3,30,30
1715666171496,EDS 204R,B01,507331,Heinzman; Erica M.,14,0,30,16
1715666172520,EDS 206R,A00,507332,Staff,0,4,30,30
1715666172520,EDS 206R,B00,507343,Staff,15,0,30,15
1715666173546,EDS 250,A00,507344,Hemans; Patricia Ann Benitez,20,0,40,20
1715666174571,EDS 281,A00,507345,Daly; Alan J.,18,0,18,0
1715666175595,EDS 284,A00,507350,Daly; Alan J.,16,0,16,0
1715666176623,EDS 286,A00,507359,Fine; Sarah,18,0,18,0
1715666177649,EDS 289C,A01,507361,Daly; Alan J.,18,0,18,0
1715666178674,EDS 290,A00,507366,Hofstetter; Carolyn,15,0,15,0
1715666179703,LIGM 5A,A00,507421,Fischer-Grunski; Eva K,17,0,20,3
1715666180731,LIGM 5B,A00,507423,Fischer-Grunski; Eva K,19,0,20,1
1715666181760,LIGM 5C,A00,507425,Fischer-Grunski; Eva K,19,0,20,1
1715666182786,LIIT 5AS,A00,507427,Carnelos; Chiara,20,0,20,0
1715666183811,LIIT 5BS,A00,507430,Carnelos; Chiara,20,0,20,0
1715666184837,LIIT 5CS,A00,507432,Carnelos; Chiara,20,0,20,0
1715666185868,LISP 5A,A00,507541,Munoz Sanchez; Alicia,11,0,20,9
1715666186897,LISP 5B,A00,507671,Munoz Sanchez; Alicia,8,0,20,12
1715666187925,LISP 5C,A00,507696,Munoz Sanchez; Alicia,7,0,20,13
1715666188949,MAE 197,001,528363,Boechler; Nicholas Sebastia,9998,0,9999,1
1715666189977,MATH 197,001,523477,Kedlaya; Kiran S.,9994,0,9999,5
1715666189977,MATH 197,002,563811,Zhang; Danna,9994,0,9999,5
1715666189977,MATH 197,003,628552,Dumitriu; Ioana,9998,0,9999,1
1715666189977,MATH 197,004,660885,Floyd; Eric,9998,0,9999,1
1715666191005,MCWP 40R,A00,518780,Staff,1,0,20,19
1715666191005,MCWP 40R,B00,518781,Carter; Jennifer A,9,0,20,11
1715666191005,MCWP 40R,C00,518783,Smith; Haydee Marie,5,0,20,15
1715666192034,MCWP 50R,A00,518791,Redela; Pamela Morgan,0,1,20,20
1715666192034,MCWP 50R,B00,518792,Krone; Jarret,0,2,20,20
1715666192034,MCWP 50R,C00,518793,Staff,0,4,20,20
1715666192034,MCWP 50R,D00,518794,Morshed; Michael James,0,2,20,20
1715666192034,MCWP 50R,E00,518795,Carter; Andrea L,0,2,20,20
1715666192034,MCWP 50R,F00,518796,Miller; Elizabeth Deen,0,1,20,20
1715666192034,MCWP 50R,G00,518797,Guillen; Melinda,0,1,20,20
1715666193060,MMW 12R,A01,514034,Herbst; Matthew,0,2,16,16
1715666193060,MMW 12R,A02,514035,Herbst; Matthew,0,0,16,16
1715666194089,MMW 13R,A01,514037,Staff,0,5,16,16
1715666194089,MMW 13R,A02,514039,Staff,0,5,16,16
1715666194089,MMW 13R,A03,628519,Staff,0,4,16,16
1715666196141,SIO 295LS,A00,523233,Staff,10,0,30,20
1715666197165,SIO 295S,A00,523232,Staff,10,0,30,20
1715666198193,SIOC 290S,A01,637330,Merrifield; Mark A,21,0,30,9
1715666199221,SIOC 291S,A01,637333,Gabriel; Corey John,21,0,30,9
1715666200246,SOCI 117,A01,494376,Staff,0,5,5,5
1715666201274,WES 237B,A00,494380,Staff,10,0,20,10
1715666203356,AESE 279B,A00,494370,Wade; Jon P,0,0,33,33
1715666204382,AIP 97,001,660915,Van Den Einde; Yael Dahlia,9998,0,9999,1
1715666205412,AIP 197,001,627712,Vespa; Emanuel Ignacio,9995,0,9999,4
1715666205412,AIP 197,002,650778,Amir; On,9998,0,9999,1
1715666205412,AIP 197,003,650933,Avenancio-Leon; Carlos,9998,0,9999,1
1715666205412,AIP 197,004,658530,Heyman; Gail D.,9998,0,9999,1
1715666205412,AIP 197,005,658631,Neal; Sonya E,9998,0,9999,1
1715666205412,AIP 197,006,658671,Du; Songzi,9998,0,9999,1
1715666206438,ANAR 135S,A00,494369,Braswell; Geoffrey E.,0,0,0,0
1715666207465,BENG 196,001,628496,Engler; Adam J.,9998,0,9999,1
1715666207465,BENG 196,002,660916,Watson; John Thomas,9998,0,9999,1
1715666208493,BISP 197,001,650773,Wilhelm; James E.,9994,0,9999,5
1715666208493,BISP 197,002,658904,Coleman; Aaron B.,9998,0,9999,1
1715666209522,CAT 124RS,A01,519847,Geibel; William,0,0,20,20
1715666210546,CAT 125RS,A01,515971,Geibel; William,0,0,20,20
1715666211575,CLRE 250,A00,511389,Morris; Sheldon,9992,0,9999,7
1715666212602,CLRE 251,A00,507176,Mehta; Ravindra L.,9992,0,9999,7
1715666212602,CLRE 251,B00,511410,Mehta; Ravindra L.,9998,0,9999,1
1715666213628,CLRE 252,A00,507189,Cuomo; Raphael Eduardo,9994,0,9999,5
1715666214655,CLRE 253,A00,507199,Vaida; Florin,9994,0,9999,5
1715666214655,CLRE 253,B00,507202,Vaida; Florin,9999,0,9999,0
1715666215678,CLRE 259,A00,507211,Patel; Hemal,9996,0,9999,3
1715666216703,CLRE 260,A00,507221,Cuomo; Raphael Eduardo,9999,0,9999,0
1715666217729,CLRE 297,001,507242,Cuomo; Raphael Eduardo,9999,0,9999,0
1715666218753,COGS 197,001,638244,Voytek; Bradley Thomas,9997,0,9999,2
1715666219779,CSE 191,A00,516875,Minnes Kemp; Mor Mia,9991,0,9999,8
1715666220804,CSE 197,001,637388,Minnes Kemp; Mor Mia,9992,0,9999,7
1715666221835,CSS 201S,A01,494383,Mignozzetti; Umberto,35,0,35,0
1715666222860,CSS 202S,A01,494387,Mignozzetti; Umberto,35,0,35,0
1715666223899,DSC 197,001,628532,Eldridge; Justin Matthew,9995,0,9999,4
1715666224924,EAP 100,A00,516065,Staff,9799,0,9999,200
1715666225952,ECE 45,A01,507414,Staff,32,0,60,28
1715666228006,ECE 111,A01,507420,Staff,11,0,50,39
1715666229031,ECE 197,001,548057,Sievenpiper; Daniel F.,9991,0,9999,8
1715666230058,EDS 115,A00,507243,Choi; Bailey Miyeon,6,0,28,22
1715666231087,EDS 117,A01,494379,Staff,0,6,34,35
1715666232116,EDS 125,A00,507246,Hopkins; Megan Beth,7,0,30,23
1715666233141,EDS 128A,A01,507264,Fargason; Sharon Gayle,5,0,26,21
1715666234169,EDS 128B,A01,507293,Pappas; Elizabeth,9,0,30,21
1715666235197,EDS 139,A00,507294,Fargason; Sharon Gayle,9,0,30,21
1715666235197,EDS 139,B00,507313,Pappas; Elizabeth,9,0,30,21
1715666236224,EDS 201,A00,507315,Staff,10,0,30,20
1715666237251,EDS 203,A01,507317,Halter; Christopher P.,10,0,30,20
1715666238278,EDS 204R,A01,507319,Halter; Christopher P.,0,3,30,30
1715666238278,EDS 204R,B01,507331,Heinzman; Erica M.,14,0,30,16
1715666239303,EDS 206R,A00,507332,Staff,0,4,30,30
1715666239303,EDS 206R,B00,507343,Staff,15,0,30,15
1715666240331,EDS 250,A00,507344,Hemans; Patricia Ann Benitez,20,0,40,20
1715666241358,EDS 281,A00,507345,Daly; Alan J.,18,0,18,0
1715666242383,EDS 284,A00,507350,Daly; Alan J.,16,0,16,0
1715666243412,EDS 286,A00,507359,Fine; Sarah,18,0,18,0
1715666244438,EDS 289C,A01,507361,Daly; Alan J.,18,0,18,0
1715666245468,EDS 290,A00,507366,Hofstetter; Carolyn,15,0,15,0
1715666246495,LIGM 5A,A00,507421,Fischer-Grunski; Eva K,17,0,20,3
1715666247519,LIGM 5B,A00,507423,Fischer-Grunski; Eva K,19,0,20,1
1715666248549,LIGM 5C,A00,507425,Fischer-Grunski; Eva K,19,0,20,1
1715666249575,LIIT 5AS,A00,507427,Carnelos; Chiara,20,0,20,0
1715666250601,LIIT 5BS,A00,507430,Carnelos; Chiara,20,0,20,0
1715666251625,LIIT 5CS,A00,507432,Carnelos; Chiara,20,0,20,0
1715666252652,LISP 5A,A00,507541,Munoz Sanchez; Alicia,11,0,20,9
1715666253682,LISP 5B,A00,507671,Munoz Sanchez; Alicia,8,0,20,12
1715666254707,LISP 5C,A00,507696,Munoz Sanchez; Alicia,7,0,20,13
1715666255733,MAE 197,001,528363,Boechler; Nicholas Sebastia,9998,0,9999,1
1715666256764,MATH 197,001,523477,Kedlaya; Kiran S.,9994,0,9999,5
1715666256764,MATH 197,002,563811,Zhang; Danna,9994,0,9999,5
1715666256764,MATH 197,003,628552,Dumitriu; Ioana,9998,0,9999,1
1715666256764,MATH 197,004,660885,Floyd; Eric,9998,0,9999,1
1715666257791,MCWP 40R,A00,518780,Staff,1,0,20,19
1715666257791,MCWP 40R,B00,518781,Carter; Jennifer A,9,0,20,11
1715666257791,MCWP 40R,C00,518783,Smith; Haydee Marie,5,0,20,15
1715666258820,MCWP 50R,A00,518791,Redela; Pamela Morgan,0,1,20,20
1715666258820,MCWP 50R,B00,518792,Krone; Jarret,0,2,20,20
1715666258820,MCWP 50R,C00,518793,Staff,0,4,20,20
1715666258820,MCWP 50R,D00,518794,Morshed; Michael James,0,2,20,20
1715666258820,MCWP 50R,E00,518795,Carter; Andrea L,0,2,20,20
1715666258820,MCWP 50R,F00,518796,Miller; Elizabeth Deen,0,1,20,20
1715666258820,MCWP 50R,G00,518797,Guillen; Melinda,0,1,20,20
1715666259848,MMW 12R,A01,514034,Herbst; Matthew,0,2,16,16
1715666259848,MMW 12R,A02,514035,Herbst; Matthew,0,0,16,16
1715666260876,MMW 13R,A01,514037,Staff,0,5,16,16
1715666260876,MMW 13R,A02,514039,Staff,0,5,16,16
1715666260876,MMW 13R,A03,628519,Staff,0,4,16,16
1715666262930,SIO 295LS,A00,523233,Staff,10,0,30,20
1715666263954,SIO 295S,A00,523232,Staff,10,0,30,20
1715666264981,SIOC 290S,A01,637330,Merrifield; Mark A,21,0,30,9
1715666266062,SIOC 291S,A01,637333,Gabriel; Corey John,21,0,30,9
1715666267090,SOCI 117,A01,494376,Staff,0,5,5,5
1715666268118,WES 237B,A00,494380,Staff,10,0,20,10
1715666270194,AESE 279B,A00,494370,Wade; Jon P,0,0,33,33
1715666271224,AIP 97,001,660915,Van Den Einde; Yael Dahlia,9998,0,9999,1
1715666272256,AIP 197,001,627712,Vespa; Emanuel Ignacio,9995,0,9999,4
1715666272256,AIP 197,002,650778,Amir; On,9998,0,9999,1
1715666272256,AIP 197,003,650933,Avenancio-Leon; Carlos,9998,0,9999,1
1715666272256,AIP 197,004,658530,Heyman; Gail D.,9998,0,9999,1
1715666272256,AIP 197,005,658631,Neal; Sonya E,9998,0,9999,1
1715666272256,AIP 197,006,658671,Du; Songzi,9998,0,9999,1
1715666273281,ANAR 135S,A00,494369,Braswell; Geoffrey E.,0,0,0,0
1715666274307,BENG 196,001,628496,Engler; Adam J.,9998,0,9999,1
1715666274307,BENG 196,002,660916,Watson; John Thomas,9998,0,9999,1
1715666275334,BISP 197,001,650773,Wilhelm; James E.,9994,0,9999,5
1715666275334,BISP 197,002,658904,Coleman; Aaron B.,9998,0,9999,1
1715666276360,CAT 124RS,A01,519847,Geibel; William,0,0,20,20
1715666277385,CAT 125RS,A01,515971,Geibel; William,0,0,20,20
1715666278409,CLRE 250,A00,511389,Morris; Sheldon,9992,0,9999,7
1715666279438,CLRE 251,A00,507176,Mehta; Ravindra L.,9992,0,9999,7
1715666279438,CLRE 251,B00,511410,Mehta; Ravindra L.,9998,0,9999,1
1715666280465,CLRE 252,A00,507189,Cuomo; Raphael Eduardo,9994,0,9999,5
1715666281492,CLRE 253,A00,507199,Vaida; Florin,9994,0,9999,5
1715666281492,CLRE 253,B00,507202,Vaida; Florin,9999,0,9999,0
1715666282518,CLRE 259,A00,507211,Patel; Hemal,9996,0,9999,3
1715666283543,CLRE 260,A00,507221,Cuomo; Raphael Eduardo,9999,0,9999,0
1715666284569,CLRE 297,001,507242,Cuomo; Raphael Eduardo,9999,0,9999,0
1715666285595,COGS 197,001,638244,Voytek; Bradley Thomas,9997,0,9999,2
1715666286623,CSE 191,A00,516875,Minnes Kemp; Mor Mia,9991,0,9999,8
1715666287651,CSE 197,001,637388,Minnes Kemp; Mor Mia,9992,0,9999,7
1715666288681,CSS 201S,A01,494383,Mignozzetti; Umberto,35,0,35,0
1715666289706,CSS 202S,A01,494387,Mignozzetti; Umberto,35,0,35,0
1715666290730,DSC 197,001,628532,Eldridge; Justin Matthew,9995,0,9999,4
1715666291755,EAP 100,A00,516065,Staff,9799,0,9999,200
1715666292786,ECE 45,A01,507414,Staff,32,0,60,28
1715666294835,ECE 111,A01,507420,Staff,11,0,50,39
1715666295863,ECE 197,001,548057,Sievenpiper; Daniel F.,9991,0,9999,8
1715666296894,EDS 115,A00,507243,Choi; Bailey Miyeon,6,0,28,22
1715666297918,EDS 117,A01,494379,Staff,0,6,34,35
1715666298943,EDS 125,A00,507246,Hopkins; Megan Beth,7,0,30,23
1715666299972,EDS 128A,A01,507264,Fargason; Sharon Gayle,5,0,26,21
1715666300999,EDS 128B,A01,507293,Pappas; Elizabeth,9,0,30,21
1715666302029,EDS 139,A00,507294,Fargason; Sharon Gayle,9,0,30,21
1715666302029,EDS 139,B00,507313,Pappas; Elizabeth,9,0,30,21
1715666303054,EDS 201,A00,507315,Staff,10,0,30,20
1715666304081,EDS 203,A01,507317,Halter; Christopher P.,10,0,30,20
1715666305108,EDS 204R,A01,507319,Halter; Christopher P.,0,3,30,30
1715666305108,EDS 204R,B01,507331,Heinzman; Erica M.,14,0,30,16
1715666306135,EDS 206R,A00,507332,Staff,0,4,30,30
1715666306135,EDS 206R,B00,507343,Staff,15,0,30,15
1715666307160,EDS 250,A00,507344,Hemans; Patricia Ann Benitez,20,0,40,20
1715666308185,EDS 281,A00,507345,Daly; Alan J.,18,0,18,0
1715666309210,EDS 284,A00,507350,Daly; Alan J.,16,0,16,0
1715666310235,EDS 286,A00,507359,Fine; Sarah,18,0,18,0
1715666311262,EDS 289C,A01,507361,Daly; Alan J.,18,0,18,0
1715666312291,EDS 290,A00,507366,Hofstetter; Carolyn,15,0,15,0
1715666313319,LIGM 5A,A00,507421,Fischer-Grunski; Eva K,17,0,20,3
1715666314346,LIGM 5B,A00,507423,Fischer-Grunski; Eva K,19,0,20,1
1715666315372,LIGM 5C,A00,507425,Fischer-Grunski; Eva K,19,0,20,1
1715666316397,LIIT 5AS,A00,507427,Carnelos; Chiara,20,0,20,0
1715666317425,LIIT 5BS,A00,507430,Carnelos; Chiara,20,0,20,0
1715666318454,LIIT 5CS,A00,507432,Carnelos; Chiara,20,0,20,0
1715666319481,LISP 5A,A00,507541,Munoz Sanchez; Alicia,11,0,20,9
1715666320505,LISP 5B,A00,507671,Munoz Sanchez; Alicia,8,0,20,12
1715666321532,LISP 5C,A00,507696,Munoz Sanchez; Alicia,7,0,20,13
1715666322562,MAE 197,001,528363,Boechler; Nicholas Sebastia,9998,0,9999,1
1715666323591,MATH 197,001,523477,Kedlaya; Kiran S.,9994,0,9999,5
1715666323591,MATH 197,002,563811,Zhang; Danna,9994,0,9999,5
1715666323591,MATH 197,003,628552,Dumitriu; Ioana,9998,0,9999,1
1715666323591,MATH 197,004,660885,Floyd; Eric,9998,0,9999,1
1715666324618,MCWP 40R,A00,518780,Staff,1,0,20,19
1715666324618,MCWP 40R,B00,518781,Carter; Jennifer A,9,0,20,11
1715666324618,MCWP 40R,C00,518783,Smith; Haydee Marie,5,0,20,15
1715666325651,MCWP 50R,A00,518791,Redela; Pamela Morgan,0,1,20,20
1715666325651,MCWP 50R,B00,518792,Krone; Jarret,0,2,20,20
1715666325651,MCWP 50R,C00,518793,Staff,0,4,20,20
1715666325651,MCWP 50R,D00,518794,Morshed; Michael James,0,2,20,20
1715666325651,MCWP 50R,E00,518795,Carter; Andrea L,0,2,20,20
1715666325651,MCWP 50R,F00,518796,Miller; Elizabeth Deen,0,1,20,20
1715666325651,MCWP 50R,G00,518797,Guillen; Melinda,0,1,20,20
1715666326678,MMW 12R,A01,514034,Herbst; Matthew,0,2,16,16
1715666326678,MMW 12R,A02,514035,Herbst; Matthew,0,0,16,16
1715666327703,MMW 13R,A01,514037,Staff,0,5,16,16
1715666327703,MMW 13R,A02,514039,Staff,0,5,16,16
1715666327703,MMW 13R,A03,628519,Staff,0,4,16,16
1715666329760,SIO 295LS,A00,523233,Staff,10,0,30,20
1715666330789,SIO 295S,A00,523232,Staff,10,0,30,20
1715666331818,SIOC 290S,A01,637330,Merrifield; Mark A,21,0,30,9
1715666332843,SIOC 291S,A01,637333,Gabriel; Corey John,21,0,30,9
1715666333881,SOCI 117,A01,494376,Staff,0,5,5,5
1715666334907,WES 237B,A00,494380,Staff,10,0,20,10
1715666336990,AESE 279B,A00,494370,Wade; Jon P,0,0,33,33
1715666338017,AIP 97,001,660915,Van Den Einde; Yael Dahlia,9998,0,9999,1
1715666339044,AIP 197,001,627712,Vespa; Emanuel Ignacio,9995,0,9999,4
1715666339044,AIP 197,002,650778,Amir; On,9998,0,9999,1
1715666339044,AIP 197,003,650933,Avenancio-Leon; Carlos,9998,0,9999,1
1715666339044,AIP 197,004,658530,Heyman; Gail D.,9998,0,9999,1
1715666339044,AIP 197,005,658631,Neal; Sonya E,9998,0,9999,1
1715666339044,AIP 197,006,658671,Du; Songzi,9998,0,9999,1
1715666340072,ANAR 135S,A00,494369,Braswell; Geoffrey E.,0,0,0,0
1715666341101,BENG 196,001,628496,Engler; Adam J.,9998,0,9999,1
1715666341101,BENG 196,002,660916,Watson; John Thomas,9998,0,9999,1
1715666342129,BISP 197,001,650773,Wilhelm; James E.,9994,0,9999,5
1715666342129,BISP 197,002,658904,Coleman; Aaron B.,9998,0,9999,1
1715666343158,CAT 124RS,A01,519847,Geibel; William,0,0,20,20
1715666344185,CAT 125RS,A01,515971,Geibel; William,0,0,20,20
1715666345213,CLRE 250,A00,511389,Morris; Sheldon,9992,0,9999,7
1715666346246,CLRE 251,A00,507176,Mehta; Ravindra L.,9992,0,9999,7
1715666346246,CLRE 251,B00,511410,Mehta; Ravindra L.,9998,0,9999,1
1715666347273,CLRE 252,A00,507189,Cuomo; Raphael Eduardo,9994,0,9999,5
1715666348302,CLRE 253,A00,507199,Vaida; Florin,9994,0,9999,5
1715666348302,CLRE 253,B00,507202,Vaida; Florin,9999,0,9999,0
1715666349328,CLRE 259,A00,507211,Patel; Hemal,9996,0,9999,3
1715666350353,CLRE 260,A00,507221,Cuomo; Raphael Eduardo,9999,0,9999,0
1715666351378,CLRE 297,001,507242,Cuomo; Raphael Eduardo,9999,0,9999,0
1715666352407,COGS 197,001,638244,Voytek; Bradley Thomas,9997,0,9999,2
1715666353435,CSE 191,A00,516875,Minnes Kemp; Mor Mia,9991,0,9999,8
1715666354459,CSE 197,001,637388,Minnes Kemp; Mor Mia,9992,0,9999,7
1715666355493,CSS 201S,A01,494383,Mignozzetti; Umberto,35,0,35,0
1715666356518,CSS 202S,A01,494387,Mignozzetti; Umberto,35,0,35,0
1715666357548,DSC 197,001,628532,Eldridge; Justin Matthew,9995,0,9999,4
1715666358575,EAP 100,A00,516065,Staff,9799,0,9999,200
1715666359603,ECE 45,A01,507414,Staff,32,0,60,28
1715666361652,ECE 111,A01,507420,Staff,11,0,50,39
1715666362681,ECE 197,001,548057,Sievenpiper; Daniel F.,9991,0,9999,8
1715666363708,EDS 115,A00,507243,Choi; Bailey Miyeon,6,0,28,22
1715666364733,EDS 117,A01,494379,Staff,0,6,34,35
1715666365758,EDS 125,A00,507246,Hopkins; Megan Beth,7,0,30,23
1715666366788,EDS 128A,A01,507264,Fargason; Sharon Gayle,5,0,26,21
1715666367816,EDS 128B,A01,507293,Pappas; Elizabeth,9,0,30,21
1715666368841,EDS 139,A00,507294,Fargason; Sharon Gayle,9,0,30,21
1715666368841,EDS 139,B00,507313,Pappas; Elizabeth,9,0,30,21
1715666369937,EDS 201,A00,507315,Staff,10,0,30,20
1715666370966,EDS 203,A01,507317,Halter; Christopher P.,10,0,30,20
1715666371995,EDS 204R,A01,507319,Halter; Christopher P.,0,3,30,30
1715666371995,EDS 204R,B01,507331,Heinzman; Erica M.,14,0,30,16
1715666373021,EDS 206R,A00,507332,Staff,0,4,30,30
1715666373021,EDS 206R,B00,507343,Staff,15,0,30,15
1715666374050,EDS 250,A00,507344,Hemans; Patricia Ann Benitez,20,0,40,20
1715666375075,EDS 281,A00,507345,Daly; Alan J.,18,0,18,0
1715666376099,EDS 284,A00,507350,Daly; Alan J.,16,0,16,0
1715666377129,EDS 286,A00,507359,Fine; Sarah,18,0,18,0
1715666378153,EDS 289C,A01,507361,Daly; Alan J.,18,0,18,0
1715666379180,EDS 290,A00,507366,Hofstetter; Carolyn,15,0,15,0
1715666380207,LIGM 5A,A00,507421,Fischer-Grunski; Eva K,17,0,20,3
1715666381233,LIGM 5B,A00,507423,Fischer-Grunski; Eva K,19,0,20,1
1715666382257,LIGM 5C,A00,507425,Fischer-Grunski; Eva K,19,0,20,1
1715666383283,LIIT 5AS,A00,507427,Carnelos; Chiara,20,0,20,0
1715666384309,LIIT 5BS,A00,507430,Carnelos; Chiara,20,0,20,0
1715666385335,LIIT 5CS,A00,507432,Carnelos; Chiara,20,0,20,0
1715666386363,LISP 5A,A00,507541,Munoz Sanchez; Alicia,11,0,20,9
1715666387390,LISP 5B,A00,507671,Munoz Sanchez; Alicia,8,0,20,12
1715666388418,LISP 5C,A00,507696,Munoz Sanchez; Alicia,7,0,20,13
1715666389443,MAE 197,001,528363,Boechler; Nicholas Sebastia,9998,0,9999,1
1715666390470,MATH 197,001,523477,Kedlaya; Kiran S.,9994,0,9999,5
1715666390470,MATH 197,002,563811,Zhang; Danna,9994,0,9999,5
1715666390470,MATH 197,003,628552,Dumitriu; Ioana,9998,0,9999,1
1715666390470,MATH 197,004,660885,Floyd; Eric,9998,0,9999,1
1715666391498,MCWP 40R,A00,518780,Staff,1,0,20,19
1715666391498,MCWP 40R,B00,518781,Carter; Jennifer A,9,0,20,11
1715666391498,MCWP 40R,C00,518783,Smith; Haydee Marie,5,0,20,15
1715666392534,MCWP 50R,A00,518791,Redela; Pamela Morgan,0,1,20,20
1715666392534,MCWP 50R,B00,518792,Krone; Jarret,0,2,20,20
1715666392534,MCWP 50R,C00,518793,Staff,0,4,20,20
1715666392534,MCWP 50R,D00,518794,Morshed; Michael James,0,2,20,20
1715666392534,MCWP 50R,E00,518795,Carter; Andrea L,0,2,20,20
1715666392534,MCWP 50R,F00,518796,Miller; Elizabeth Deen,0,1,20,20
1715666392534,MCWP 50R,G00,518797,Guillen; Melinda,0,1,20,20
1715666393559,MMW 12R,A01,514034,Herbst; Matthew,0,2,16,16
1715666393559,MMW 12R,A02,514035,Herbst; Matthew,0,0,16,16
1715666394585,MMW 13R,A01,514037,Staff,0,5,16,16
1715666394585,MMW 13R,A02,514039,Staff,0,5,16,16
1715666394585,MMW 13R,A03,628519,Staff,0,4,16,16
1715666396637,SIO 295LS,A00,523233,Staff,10,0,30,20
1715666397663,SIO 295S,A00,523232,Staff,10,0,30,20
1715666398689,SIOC 290S,A01,637330,Merrifield; Mark A,21,0,30,9
1715666399715,SIOC 291S,A01,637333,Gabriel; Corey John,21,0,30,9
1715666400745,SOCI 117,A01,494376,Staff,0,5,5,5
1715666401773,WES 237B,A00,494380,Staff,10,0,20,10
1715666403848,AESE 279B,A00,494370,Wade; Jon P,0,0,33,33
1715666404876,AIP 97,001,660915,Van Den Einde; Yael Dahlia,9998,0,9999,1
1715666406459,AIP 197,001,627712,Vespa; Emanuel Ignacio,9995,0,9999,4
1715666406459,AIP 197,002,650778,Amir; On,9998,0,9999,1
1715666406459,AIP 197,003,650933,Avenancio-Leon; Carlos,9998,0,9999,1
1715666406459,AIP 197,004,658530,Heyman; Gail D.,9998,0,9999,1
1715666406459,AIP 197,005,658631,Neal; Sonya E,9998,0,9999,1
1715666406459,AIP 197,006,658671,Du; Songzi,9998,0,9999,1
1715666407486,ANAR 135S,A00,494369,Braswell; Geoffrey E.,0,0,0,0
1715666408513,BENG 196,001,628496,Engler; Adam J.,9998,0,9999,1
1715666408513,BENG 196,002,660916,Watson; John Thomas,9998,0,9999,1
1715666409542,BISP 197,001,650773,Wilhelm; James E.,9994,0,9999,5
1715666409542,BISP 197,002,658904,Coleman; Aaron B.,9998,0,9999,1
1715666410572,CAT 124RS,A01,519847,Geibel; William,0,0,20,20
1715666411602,CAT 125RS,A01,515971,Geibel; William,0,0,20,20
1715666412628,CLRE 250,A00,511389,Morris; Sheldon,9992,0,9999,7
1715666413657,CLRE 251,A00,507176,Mehta; Ravindra L.,9992,0,9999,7
1715666413657,CLRE 251,B00,511410,Mehta; Ravindra L.,9998,0,9999,1
1715666414683,CLRE 252,A00,507189,Cuomo; Raphael Eduardo,9994,0,9999,5
1715666415709,CLRE 253,A00,507199,Vaida; Florin,9994,0,9999,5
1715666415709,CLRE 253,B00,507202,Vaida; Florin,9999,0,9999,0
1715666416733,CLRE 259,A00,507211,Patel; Hemal,9996,0,9999,3
1715666417762,CLRE 260,A00,507221,Cuomo; Raphael Eduardo,9999,0,9999,0
1715666418786,CLRE 297,001,507242,Cuomo; Raphael Eduardo,9999,0,9999,0
1715666419813,COGS 197,001,638244,Voytek; Bradley Thomas,9997,0,9999,2
1715666420841,CSE 191,A00,516875,Minnes Kemp; Mor Mia,9991,0,9999,8
1715666421868,CSE 197,001,637388,Minnes Kemp; Mor Mia,9992,0,9999,7
1715666422898,CSS 201S,A01,494383,Mignozzetti; Umberto,35,0,35,0
1715666423924,CSS 202S,A01,494387,Mignozzetti; Umberto,35,0,35,0
1715666424954,DSC 197,001,628532,Eldridge; Justin Matthew,9995,0,9999,4
1715666425981,EAP 100,A00,516065,Staff,9799,0,9999,200
1715666427009,ECE 45,A01,507414,Staff,32,0,60,28
1715666429069,ECE 111,A01,507420,Staff,11,0,50,39
1715666430094,ECE 197,001,548057,Sievenpiper; Daniel F.,9991,0,9999,8
1715666431121,EDS 115,A00,507243,Choi; Bailey Miyeon,6,0,28,22
1715666432150,EDS 117,A01,494379,Staff,0,6,34,35
1715666433180,EDS 125,A00,507246,Hopkins; Megan Beth,7,0,30,23
1715666434211,EDS 128A,A01,507264,Fargason; Sharon Gayle,5,0,26,21
1715666435237,EDS 128B,A01,507293,Pappas; Elizabeth,9,0,30,21
1715666436265,EDS 139,A00,507294,Fargason; Sharon Gayle,9,0,30,21
1715666436265,EDS 139,B00,507313,Pappas; Elizabeth,9,0,30,21
1715666437288,EDS 201,A00,507315,Staff,10,0,30,20
1715666438315,EDS 203,A01,507317,Halter; Christopher P.,10,0,30,20
1715666439342,EDS 204R,A01,507319,Halter; Christopher P.,0,3,30,30
1715666439342,EDS 204R,B01,507331,Heinzman; Erica M.,14,0,30,16
1715666440369,EDS 206R,A00,507332,Staff,0,4,30,30
1715666440369,EDS 206R,B00,507343,Staff,15,0,30,15
1715666441400,EDS 250,A00,507344,Hemans; Patricia Ann Benitez,20,0,40,20
1715666442429,EDS 281,A00,507345,Daly; Alan J.,18,0,18,0
1715666443453,EDS 284,A00,507350,Daly; Alan J.,16,0,16,0
1715666444481,EDS 286,A00,507359,Fine; Sarah,18,0,18,0
1715666445511,EDS 289C,A01,507361,Daly; Alan J.,18,0,18,0
1715666446605,EDS 290,A00,507366,Hofstetter; Carolyn,15,0,15,0
1715666447633,LIGM 5A,A00,507421,Fischer-Grunski; Eva K,17,0,20,3
1715666448661,LIGM 5B,A00,507423,Fischer-Grunski; Eva K,19,0,20,1
1715666449687,LIGM 5C,A00,507425,Fischer-Grunski; Eva K,19,0,20,1
1715666450714,LIIT 5AS,A00,507427,Carnelos; Chiara,20,0,20,0
1715666451740,LIIT 5BS,A00,507430,Carnelos; Chiara,20,0,20,0
1715666452768,LIIT 5CS,A00,507432,Carnelos; Chiara,20,0,20,0
1715666453793,LISP 5A,A00,507541,Munoz Sanchez; Alicia,11,0,20,9
1715666454822,LISP 5B,A00,507671,Munoz Sanchez; Alicia,8,0,20,12
1715666455846,LISP 5C,A00,507696,Munoz Sanchez; Alicia,7,0,20,13
1715666456871,MAE 197,001,528363,Boechler; Nicholas Sebastia,9998,0,9999,1
1715666457898,MATH 197,001,523477,Kedlaya; Kiran S.,9994,0,9999,5
1715666457898,MATH 197,002,563811,Zhang; Danna,9994,0,9999,5
1715666457898,MATH 197,003,628552,Dumitriu; Ioana,9998,0,9999,1
1715666457898,MATH 197,004,660885,Floyd; Eric,9998,0,9999,1
1715666458927,MCWP 40R,A00,518780,Staff,1,0,20,19
1715666458927,MCWP 40R,B00,518781,Carter; Jennifer A,9,0,20,11
1715666458927,MCWP 40R,C00,518783,Smith; Haydee Marie,5,0,20,15
1715666459958,MCWP 50R,A00,518791,Redela; Pamela Morgan,0,1,20,20
1715666459958,MCWP 50R,B00,518792,Krone; Jarret,0,2,20,20
1715666459958,MCWP 50R,C00,518793,Staff,0,4,20,20
1715666459958,MCWP 50R,D00,518794,Morshed; Michael James,0,2,20,20
1715666459958,MCWP 50R,E00,518795,Carter; Andrea L,0,2,20,20
1715666459958,MCWP 50R,F00,518796,Miller; Elizabeth Deen,0,1,20,20
1715666459958,MCWP 50R,G00,518797,Guillen; Melinda,0,1,20,20
1715666460988,MMW 12R,A01,514034,Herbst; Matthew,0,2,16,16
1715666460988,MMW 12R,A02,514035,Herbst; Matthew,0,0,16,16
1715666462015,MMW 13R,A01,514037,Staff,0,5,16,16
1715666462015,MMW 13R,A02,514039,Staff,0,5,16,16
1715666462015,MMW 13R,A03,628519,Staff,0,4,16,16
1715666464072,SIO 295LS,A00,523233,Staff,10,0,30,20
1715666465102,SIO 295S,A00,523232,Staff,10,0,30,20
1715666466133,SIOC 290S,A01,637330,Merrifield; Mark A,21,0,30,9
1715666467163,SIOC 291S,A01,637333,Gabriel; Corey John,21,0,30,9
1715666468194,SOCI 117,A01,494376,Staff,0,5,5,5
1715666469227,WES 237B,A00,494380,Staff,10,0,20,10
1715666471311,AESE 279B,A00,494370,Wade; Jon P,0,0,33,33
1715666472337,AIP 97,001,660915,Van Den Einde; Yael Dahlia,9998,0,9999,1
1715666473364,AIP 197,001,627712,Vespa; Emanuel Ignacio,9995,0,9999,4
1715666473364,AIP 197,002,650778,Amir; On,9998,0,9999,1
1715666473364,AIP 197,003,650933,Avenancio-Leon; Carlos,9998,0,9999,1
1715666473364,AIP 197,004,658530,Heyman; Gail D.,9998,0,9999,1
1715666473364,AIP 197,005,658631,Neal; Sonya E,9998,0,9999,1
1715666473364,AIP 197,006,658671,Du; Songzi,9998,0,9999,1
1715666474395,ANAR 135S,A00,494369,Braswell; Geoffrey E.,0,0,0,0
1715666475421,BENG 196,001,628496,Engler; Adam J.,9998,0,9999,1
1715666475421,BENG 196,002,660916,Watson; John Thomas,9998,0,9999,1
1715666476446,BISP 197,001,650773,Wilhelm; James E.,9994,0,9999,5
1715666476446,BISP 197,002,658904,Coleman; Aaron B.,9998,0,9999,1
1715666477473,CAT 124RS,A01,519847,Geibel; William,0,0,20,20
1715666478499,CAT 125RS,A01,515971,Geibel; William,0,0,20,20
1715666479524,CLRE 250,A00,511389,Morris; Sheldon,9992,0,9999,7
1715666480561,CLRE 251,A00,507176,Mehta; Ravindra L.,9992,0,9999,7
1715666480561,CLRE 251,B00,511410,Mehta; Ravindra L.,9998,0,9999,1
1715666481590,CLRE 252,A00,507189,Cuomo; Raphael Eduardo,9994,0,9999,5
1715666482615,CLRE 253,A00,507199,Vaida; Florin,9994,0,9999,5
1715666482615,CLRE 253,B00,507202,Vaida; Florin,9999,0,9999,0
1715666483641,CLRE 259,A00,507211,Patel; Hemal,9996,0,9999,3
1715666484666,CLRE 260,A00,507221,Cuomo; Raphael Eduardo,9999,0,9999,0
1715666485693,CLRE 297,001,507242,Cuomo; Raphael Eduardo,9999,0,9999,0
1715666486718,COGS 197,001,638244,Voytek; Bradley Thomas,9997,0,9999,2
1715666487769,CSE 191,A00,516875,Minnes Kemp; Mor Mia,9991,0,9999,8
1715666488792,CSE 197,001,637388,Minnes Kemp; Mor Mia,9992,0,9999,7
1715666489819,CSS 201S,A01,494383,Mignozzetti; Umberto,35,0,35,0
1715666490845,CSS 202S,A01,494387,Mignozzetti; Umberto,35,0,35,0
1715666491872,DSC 197,001,628532,Eldridge; Justin Matthew,9995,0,9999,4
1715666492898,EAP 100,A00,516065,Staff,9799,0,9999,200
1715666493927,ECE 45,A01,507414,Staff,32,0,60,28
1715666495982,ECE 111,A01,507420,Staff,11,0,50,39
1715666497011,ECE 197,001,548057,Sievenpiper; Daniel F.,9991,0,9999,8
1715666498043,EDS 115,A00,507243,Choi; Bailey Miyeon,6,0,28,22
1715666499072,EDS 117,A01,494379,Staff,0,6,34,35
1715666500097,EDS 125,A00,507246,Hopkins; Megan Beth,7,0,30,23
1715666501124,EDS 128A,A01,507264,Fargason; Sharon Gayle,5,0,26,21
1715666502149,EDS 128B,A01,507293,Pappas; Elizabeth,9,0,30,21
1715666503173,EDS 139,A00,507294,Fargason; Sharon Gayle,9,0,30,21
1715666503173,EDS 139,B00,507313,Pappas; Elizabeth,9,0,30,21
1715666504197,EDS 201,A00,507315,Staff,10,0,30,20
1715666505226,EDS 203,A01,507317,Halter; Christopher P.,10,0,30,20
1715666506250,EDS 204R,A01,507319,Halter; Christopher P.,0,3,30,30
1715666506250,EDS 204R,B01,507331,Heinzman; Erica M.,14,0,30,16
1715666507275,EDS 206R,A00,507332,Staff,0,4,30,30
1715666507275,EDS 206R,B00,507343,Staff,15,0,30,15
1715666508299,EDS 250,A00,507344,Hemans; Patricia Ann Benitez,20,0,40,20
1715666509327,EDS 281,A00,507345,Daly; Alan J.,18,0,18,0
1715666510351,EDS 284,A00,507350,Daly; Alan J.,16,0,16,0
1715666511377,EDS 286,A00,507359,Fine; Sarah,18,0,18,0
1715666512402,EDS 289C,A01,507361,Daly; Alan J.,18,0,18,0
1715666513427,EDS 290,A00,507366,Hofstetter; Carolyn,15,0,15,0
1715666514456,LIGM 5A,A00,507421,Fischer-Grunski; Eva K,17,0,20,3
1715666515481,LIGM 5B,A00,507423,Fischer-Grunski; Eva K,19,0,20,1
1715666516507,LIGM 5C,A00,507425,Fischer-Grunski; Eva K,19,0,20,1
1715666517533,LIIT 5AS,A00,507427,Carnelos; Chiara,20,0,20,0
1715666518558,LIIT 5BS,A00,507430,Carnelos; Chiara,20,0,20,0
1715666519584,LIIT 5CS,A00,507432,Carnelos; Chiara,20,0,20,0
1715666520610,LISP 5A,A00,507541,Munoz Sanchez; Alicia,11,0,20,9
1715666521638,LISP 5B,A00,507671,Munoz Sanchez; Alicia,8,0,20,12
1715666522663,LISP 5C,A00,507696,Munoz Sanchez; Alicia,7,0,20,13
1715666523689,MAE 197,001,528363,Boechler; Nicholas Sebastia,9998,0,9999,1
1715666524715,MATH 197,001,523477,Kedlaya; Kiran S.,9994,0,9999,5
1715666524715,MATH 197,002,563811,Zhang; Danna,9994,0,9999,5
1715666524715,MATH 197,003,628552,Dumitriu; Ioana,9998,0,9999,1
1715666524715,MATH 197,004,660885,Floyd; Eric,9998,0,9999,1
1715666525744,MCWP 40R,A00,518780,Staff,1,0,20,19
1715666525744,MCWP 40R,B00,518781,Carter; Jennifer A,9,0,20,11
1715666525744,MCWP 40R,C00,518783,Smith; Haydee Marie,5,0,20,15
1715666526771,MCWP 50R,A00,518791,Redela; Pamela Morgan,0,1,20,20
1715666526771,MCWP 50R,B00,518792,Krone; Jarret,0,2,20,20
1715666526771,MCWP 50R,C00,518793,Staff,0,4,20,20
1715666526771,MCWP 50R,D00,518794,Morshed; Michael James,0,2,20,20
1715666526771,MCWP 50R,E00,518795,Carter; Andrea L,0,2,20,20
1715666526771,MCWP 50R,F00,518796,Miller; Elizabeth Deen,0,1,20,20
1715666526771,MCWP 50R,G00,518797,Guillen; Melinda,0,1,20,20
1715666527797,MMW 12R,A01,514034,Herbst; Matthew,0,2,16,16
1715666527797,MMW 12R,A02,514035,Herbst; Matthew,0,0,16,16
1715666528821,MMW 13R,A01,514037,Staff,0,5,16,16
1715666528821,MMW 13R,A02,514039,Staff,0,5,16,16
1715666528821,MMW 13R,A03,628519,Staff,0,4,16,16
1715666530874,SIO 295LS,A00,523233,Staff,10,0,30,20
1715666531899,SIO 295S,A00,523232,Staff,10,0,30,20
1715666532928,SIOC 290S,A01,637330,Merrifield; Mark A,21,0,30,9
1715666533954,SIOC 291S,A01,637333,Gabriel; Corey John,21,0,30,9
1715666534981,SOCI 117,A01,494376,Staff,0,5,5,5
1715666536006,WES 237B,A00,494380,Staff,10,0,20,10
1715666538073,AESE 279B,A00,494370,Wade; Jon P,0,0,33,33
1715666539100,AIP 97,001,660915,Van Den Einde; Yael Dahlia,9998,0,9999,1
1715666540134,AIP 197,001,627712,Vespa; Emanuel Ignacio,9995,0,9999,4
1715666540134,AIP 197,002,650778,Amir; On,9998,0,9999,1
1715666540134,AIP 197,003,650933,Avenancio-Leon; Carlos,9998,0,9999,1
1715666540134,AIP 197,004,658530,Heyman; Gail D.,9998,0,9999,1
1715666540134,AIP 197,005,658631,Neal; Sonya E,9998,0,9999,1
1715666540134,AIP 197,006,658671,Du; Songzi,9998,0,9999,1
1715666541159,ANAR 135S,A00,494369,Braswell; Geoffrey E.,0,0,0,0
1715666542190,BENG 196,001,628496,Engler; Adam J.,9998,0,9999,1
1715666542190,BENG 196,002,660916,Watson; John Thomas,9998,0,9999,1
1715666543220,BISP 197,001,650773,Wilhelm; James E.,9994,0,9999,5
1715666543220,BISP 197,002,658904,Coleman; Aaron B.,9998,0,9999,1
1715666544251,CAT 124RS,A01,519847,Geibel; William,0,0,20,20
1715666545279,CAT 125RS,A01,515971,Geibel; William,0,0,20,20
1715666546306,CLRE 250,A00,511389,Morris; Sheldon,9992,0,9999,7
1715666547333,CLRE 251,A00,507176,Mehta; Ravindra L.,9992,0,9999,7
1715666547333,CLRE 251,B00,511410,Mehta; Ravindra L.,9998,0,9999,1
1715666548362,CLRE 252,A00,507189,Cuomo; Raphael Eduardo,9994,0,9999,5
1715666549391,CLRE 253,A00,507199,Vaida; Florin,9994,0,9999,5
1715666549391,CLRE 253,B00,507202,Vaida; Florin,9999,0,9999,0
1715666550420,CLRE 259,A00,507211,Patel; Hemal,9996,0,9999,3
1715666551445,CLRE 260,A00,507221,Cuomo; Raphael Eduardo,9999,0,9999,0
1715666552473,CLRE 297,001,507242,Cuomo; Raphael Eduardo,9999,0,9999,0
1715666553499,COGS 197,001,638244,Voytek; Bradley Thomas,9997,0,9999,2
1715666554524,CSE 191,A00,516875,Minnes Kemp; Mor Mia,9991,0,9999,8
1715666555550,CSE 197,001,637388,Minnes Kemp; Mor Mia,9992,0,9999,7
1715666556577,CSS 201S,A01,494383,Mignozzetti; Umberto,35,0,35,0
1715666557602,CSS 202S,A01,494387,Mignozzetti; Umberto,35,0,35,0
1715666558626,DSC 197,001,628532,Eldridge; Justin Matthew,9995,0,9999,4
1715666559652,EAP 100,A00,516065,Staff,9799,0,9999,200
1715666560679,ECE 45,A01,507414,Staff,32,0,60,28
1715666562732,ECE 111,A01,507420,Staff,11,0,50,39
1715666563756,ECE 197,001,548057,Sievenpiper; Daniel F.,9991,0,9999,8
1715666564788,EDS 115,A00,507243,Choi; Bailey Miyeon,6,0,28,22
1715666565814,EDS 117,A01,494379,Staff,0,6,34,35
1715666566842,EDS 125,A00,507246,Hopkins; Megan Beth,7,0,30,23
1715666567869,EDS 128A,A01,507264,Fargason; Sharon Gayle,5,0,26,21
1715666568895,EDS 128B,A01,507293,Pappas; Elizabeth,9,0,30,21
1715666569918,EDS 139,A00,507294,Fargason; Sharon Gayle,9,0,30,21
1715666569918,EDS 139,B00,507313,Pappas; Elizabeth,9,0,30,21
1715666570946,EDS 201,A00,507315,Staff,10,0,30,20
1715666571971,EDS 203,A01,507317,Halter; Christopher P.,10,0,30,20
1715666572999,EDS 204R,A01,507319,Halter; Christopher P.,0,3,30,30
1715666572999,EDS 204R,B01,507331,Heinzman; Erica M.,14,0,30,16
1715666574024,EDS 206R,A00,507332,Staff,0,4,30,30
1715666574024,EDS 206R,B00,507343,Staff,15,0,30,15
1715666575053,EDS 250,A00,507344,Hemans; Patricia Ann Benitez,20,0,40,20
1715666576081,EDS 281,A00,507345,Daly; Alan J.,18,0,18,0
1715666577105,EDS 284,A00,507350,Daly; Alan J.,16,0,16,0
1715666578130,EDS 286,A00,507359,Fine; Sarah,18,0,18,0
1715666579154,EDS 289C,A01,507361,Daly; Alan J.,18,0,18,0
1715666580179,EDS 290,A00,507366,Hofstetter; Carolyn,15,0,15,0
1715666581208,LIGM 5A,A00,507421,Fischer-Grunski; Eva K,17,0,20,3
1715666582238,LIGM 5B,A00,507423,Fischer-Grunski; Eva K,19,0,20,1
1715666583262,LIGM 5C,A00,507425,Fischer-Grunski; Eva K,19,0,20,1
1715666584290,LIIT 5AS,A00,507427,Carnelos; Chiara,20,0,20,0
1715666585318,LIIT 5BS,A00,507430,Carnelos; Chiara,20,0,20,0
1715666586347,LIIT 5CS,A00,507432,Carnelos; Chiara,20,0,20,0
1715666587377,LISP 5A,A00,507541,Munoz Sanchez; Alicia,11,0,20,9
1715666588402,LISP 5B,A00,507671,Munoz Sanchez; Alicia,8,0,20,12
1715666589429,LISP 5C,A00,507696,Munoz Sanchez; Alicia,7,0,20,13
1715666590457,MAE 197,001,528363,Boechler; Nicholas Sebastia,9998,0,9999,1
1715666591483,MATH 197,001,523477,Kedlaya; Kiran S.,9994,0,9999,5
1715666591483,MATH 197,002,563811,Zhang; Danna,9994,0,9999,5
1715666591483,MATH 197,003,628552,Dumitriu; Ioana,9998,0,9999,1
1715666591483,MATH 197,004,660885,Floyd; Eric,9998,0,9999,1
1715666592509,MCWP 40R,A00,518780,Staff,1,0,20,19
1715666592509,MCWP 40R,B00,518781,Carter; Jennifer A,9,0,20,11
1715666592509,MCWP 40R,C00,518783,Smith; Haydee Marie,5,0,20,15
1715666593544,MCWP 50R,A00,518791,Redela; Pamela Morgan,0,1,20,20
1715666593544,MCWP 50R,B00,518792,Krone; Jarret,0,2,20,20
1715666593544,MCWP 50R,C00,518793,Staff,0,4,20,20
1715666593544,MCWP 50R,D00,518794,Morshed; Michael James,0,2,20,20
1715666593544,MCWP 50R,E00,518795,Carter; Andrea L,0,2,20,20
1715666593544,MCWP 50R,F00,518796,Miller; Elizabeth Deen,0,1,20,20
1715666593544,MCWP 50R,G00,518797,Guillen; Melinda,0,1,20,20
1715666594576,MMW 12R,A01,514034,Herbst; Matthew,0,2,16,16
1715666594576,MMW 12R,A02,514035,Herbst; Matthew,0,0,16,16
1715666595601,MMW 13R,A01,514037,Staff,0,5,16,16
1715666595601,MMW 13R,A02,514039,Staff,0,5,16,16
1715666595601,MMW 13R,A03,628519,Staff,0,4,16,16
1715666597652,SIO 295LS,A00,523233,Staff,10,0,30,20
1715666598680,SIO 295S,A00,523232,Staff,10,0,30,20
1715666599708,SIOC 290S,A01,637330,Merrifield; Mark A,21,0,30,9
1715666600735,SIOC 291S,A01,637333,Gabriel; Corey John,21,0,30,9
1715666601764,SOCI 117,A01,494376,Staff,0,5,5,5
1715666602790,WES 237B,A00,494380,Staff,10,0,20,10
1715666604861,AESE 279B,A00,494370,Wade; Jon P,0,0,33,33
1715666605888,AIP 97,001,660915,Van Den Einde; Yael Dahlia,9998,0,9999,1
1715666606919,AIP 197,001,627712,Vespa; Emanuel Ignacio,9995,0,9999,4
1715666606919,AIP 197,002,650778,Amir; On,9998,0,9999,1
1715666606919,AIP 197,003,650933,Avenancio-Leon; Carlos,9998,0,9999,1
1715666606919,AIP 197,004,658530,Heyman; Gail D.,9998,0,9999,1
1715666606919,AIP 197,005,658631,Neal; Sonya E,9998,0,9999,1
1715666606919,AIP 197,006,658671,Du; Songzi,9998,0,9999,1
1715666607945,ANAR 135S,A00,494369,Braswell; Geoffrey E.,0,0,0,0
1715666608970,BENG 196,001,628496,Engler; Adam J.,9998,0,9999,1
1715666608970,BENG 196,002,660916,Watson; John Thomas,9998,0,9999,1
1715666609997,BISP 197,001,650773,Wilhelm; James E.,9994,0,9999,5
1715666609997,BISP 197,002,658904,Coleman; Aaron B.,9998,0,9999,1
1715666611025,CAT 124RS,A01,519847,Geibel; William,0,0,20,20
1715666612048,CAT 125RS,A01,515971,Geibel; William,0,0,20,20
1715666613074,CLRE 250,A00,511389,Morris; Sheldon,9992,0,9999,7
1715666614107,CLRE 251,A00,507176,Mehta; Ravindra L.,9992,0,9999,7
1715666614107,CLRE 251,B00,511410,Mehta; Ravindra L.,9998,0,9999,1
1715666615135,CLRE 252,A00,507189,Cuomo; Raphael Eduardo,9994,0,9999,5
1715666616163,CLRE 253,A00,507199,Vaida; Florin,9994,0,9999,5
1715666616163,CLRE 253,B00,507202,Vaida; Florin,9999,0,9999,0
1715666617192,CLRE 259,A00,507211,Patel; Hemal,9996,0,9999,3
1715666618217,CLRE 260,A00,507221,Cuomo; Raphael Eduardo,9999,0,9999,0
1715666619242,CLRE 297,001,507242,Cuomo; Raphael Eduardo,9999,0,9999,0
1715666620269,COGS 197,001,638244,Voytek; Bradley Thomas,9997,0,9999,2
1715666621297,CSE 191,A00,516875,Minnes Kemp; Mor Mia,9991,0,9999,8
1715666622322,CSE 197,001,637388,Minnes Kemp; Mor Mia,9992,0,9999,7
1715666623350,CSS 201S,A01,494383,Mignozzetti; Umberto,35,0,35,0
1715666624374,CSS 202S,A01,494387,Mignozzetti; Umberto,35,0,35,0
1715666625399,DSC 197,001,628532,Eldridge; Justin Matthew,9995,0,9999,4
1715666626433,EAP 100,A00,516065,Staff,9799,0,9999,200
1715666627464,ECE 45,A01,507414,Staff,32,0,60,28
1715666629515,ECE 111,A01,507420,Staff,11,0,50,39
1715666630543,ECE 197,001,548057,Sievenpiper; Daniel F.,9991,0,9999,8
1715666631571,EDS 115,A00,507243,Choi; Bailey Miyeon,6,0,28,22
1715666632601,EDS 117,A01,494379,Staff,0,6,34,35
1715666633626,EDS 125,A00,507246,Hopkins; Megan Beth,7,0,30,23
1715666634653,EDS 128A,A01,507264,Fargason; Sharon Gayle,5,0,26,21
1715666635677,EDS 128B,A01,507293,Pappas; Elizabeth,9,0,30,21
1715666636704,EDS 139,A00,507294,Fargason; Sharon Gayle,9,0,30,21
1715666636704,EDS 139,B00,507313,Pappas; Elizabeth,9,0,30,21
1715666637732,EDS 201,A00,507315,Staff,10,0,30,20
1715666638757,EDS 203,A01,507317,Halter; Christopher P.,10,0,30,20
1715666639786,EDS 204R,A01,507319,Halter; Christopher P.,0,3,30,30
1715666639786,EDS 204R,B01,507331,Heinzman; Erica M.,14,0,30,16
1715666640814,EDS 206R,A00,507332,Staff,0,4,30,30
1715666640814,EDS 206R,B00,507343,Staff,15,0,30,15
1715666641839,EDS 250,A00,507344,Hemans; Patricia Ann Benitez,20,0,40,20
1715666642866,EDS 281,A00,507345,Daly; Alan J.,18,0,18,0
1715666643905,EDS 284,A00,507350,Daly; Alan J.,16,0,16,0
1715666644932,EDS 286,A00,507359,Fine; Sarah,18,0,18,0
1715666645957,EDS 289C,A01,507361,Daly; Alan J.,18,0,18,0
1715666646986,EDS 290,A00,507366,Hofstetter; Carolyn,15,0,15,0
1715666648014,LIGM 5A,A00,507421,Fischer-Grunski; Eva K,17,0,20,3
1715666649044,LIGM 5B,A00,507423,Fischer-Grunski; Eva K,19,0,20,1
1715666650069,LIGM 5C,A00,507425,Fischer-Grunski; Eva K,19,0,20,1
1715666651094,LIIT 5AS,A00,507427,Carnelos; Chiara,20,0,20,0
1715666652120,LIIT 5BS,A00,507430,Carnelos; Chiara,20,0,20,0
1715666653145,LIIT 5CS,A00,507432,Carnelos; Chiara,20,0,20,0
1715666654170,LISP 5A,A00,507541,Munoz Sanchez; Alicia,11,0,20,9
1715666655195,LISP 5B,A00,507671,Munoz Sanchez; Alicia,8,0,20,12
1715666656220,LISP 5C,A00,507696,Munoz Sanchez; Alicia,7,0,20,13
1715666657249,MAE 197,001,528363,Boechler; Nicholas Sebastia,9998,0,9999,1
1715666658275,MATH 197,001,523477,Kedlaya; Kiran S.,9994,0,9999,5
1715666658275,MATH 197,002,563811,Zhang; Danna,9994,0,9999,5
1715666658275,MATH 197,003,628552,Dumitriu; Ioana,9998,0,9999,1
1715666658275,MATH 197,004,660885,Floyd; Eric,9998,0,9999,1
1715666659362,MCWP 40R,A00,518780,Staff,1,0,20,19
1715666659362,MCWP 40R,B00,518781,Carter; Jennifer A,9,0,20,11
1715666659362,MCWP 40R,C00,518783,Smith; Haydee Marie,5,0,20,15
1715666660391,MCWP 50R,A00,518791,Redela; Pamela Morgan,0,1,20,20
1715666660391,MCWP 50R,B00,518792,Krone; Jarret,0,2,20,20
1715666660391,MCWP 50R,C00,518793,Staff,0,4,20,20
1715666660391,MCWP 50R,D00,518794,Morshed; Michael James,0,2,20,20
1715666660391,MCWP 50R,E00,518795,Carter; Andrea L,0,2,20,20
1715666660391,MCWP 50R,F00,518796,Miller; Elizabeth Deen,0,1,20,20
1715666660391,MCWP 50R,G00,518797,Guillen; Melinda,0,1,20,20
1715666661421,MMW 12R,A01,514034,Herbst; Matthew,0,2,16,16
1715666661421,MMW 12R,A02,514035,Herbst; Matthew,0,0,16,16
1715666662445,MMW 13R,A01,514037,Staff,0,5,16,16
1715666662445,MMW 13R,A02,514039,Staff,0,5,16,16
1715666662445,MMW 13R,A03,628519,Staff,0,4,16,16
1715666664511,SIO 295LS,A00,523233,Staff,10,0,30,20
1715666665539,SIO 295S,A00,523232,Staff,10,0,30,20
1715666666567,SIOC 290S,A01,637330,Merrifield; Mark A,21,0,30,9
1715666667593,SIOC 291S,A01,637333,Gabriel; Corey John,21,0,30,9
1715666668617,SOCI 117,A01,494376,Staff,0,5,5,5
1715666669643,WES 237B,A00,494380,Staff,10,0,20,10
1715666671713,AESE 279B,A00,494370,Wade; Jon P,0,0,33,33
1715666672738,AIP 97,001,660915,Van Den Einde; Yael Dahlia,9998,0,9999,1
1715666673766,AIP 197,001,627712,Vespa; Emanuel Ignacio,9995,0,9999,4
1715666673766,AIP 197,002,650778,Amir; On,9998,0,9999,1
1715666673766,AIP 197,003,650933,Avenancio-Leon; Carlos,9998,0,9999,1
1715666673766,AIP 197,004,658530,Heyman; Gail D.,9998,0,9999,1
1715666673766,AIP 197,005,658631,Neal; Sonya E,9998,0,9999,1
1715666673766,AIP 197,006,658671,Du; Songzi,9998,0,9999,1
1715666674792,ANAR 135S,A00,494369,Braswell; Geoffrey E.,0,0,0,0
1715666675819,BENG 196,001,628496,Engler; Adam J.,9998,0,9999,1
1715666675819,BENG 196,002,660916,Watson; John Thomas,9998,0,9999,1
1715666676849,BISP 197,001,650773,Wilhelm; James E.,9994,0,9999,5
1715666676849,BISP 197,002,658904,Coleman; Aaron B.,9998,0,9999,1
1715666677876,CAT 124RS,A01,519847,Geibel; William,0,0,20,20
1715666678906,CAT 125RS,A01,515971,Geibel; William,0,0,20,20
1715666679932,CLRE 250,A00,511389,Morris; Sheldon,9992,0,9999,7
1715666680961,CLRE 251,A00,507176,Mehta; Ravindra L.,9992,0,9999,7
1715666680961,CLRE 251,B00,511410,Mehta; Ravindra L.,9998,0,9999,1
1715666681991,CLRE 252,A00,507189,Cuomo; Raphael Eduardo,9994,0,9999,5
1715666683016,CLRE 253,A00,507199,Vaida; Florin,9994,0,9999,5
1715666683016,CLRE 253,B00,507202,Vaida; Florin,9999,0,9999,0
1715666684048,CLRE 259,A00,507211,Patel; Hemal,9996,0,9999,3
1715666685081,CLRE 260,A00,507221,Cuomo; Raphael Eduardo,9999,0,9999,0
1715666686108,CLRE 297,001,507242,Cuomo; Raphael Eduardo,9999,0,9999,0
1715666687133,COGS 197,001,638244,Voytek; Bradley Thomas,9997,0,9999,2
1715666688161,CSE 191,A00,516875,Minnes Kemp; Mor Mia,9991,0,9999,8
1715666689188,CSE 197,001,637388,Minnes Kemp; Mor Mia,9992,0,9999,7
1715666690214,CSS 201S,A01,494383,Mignozzetti; Umberto,35,0,35,0
1715666691239,CSS 202S,A01,494387,Mignozzetti; Umberto,35,0,35,0
1715666692266,DSC 197,001,628532,Eldridge; Justin Matthew,9995,0,9999,4
1715666693290,EAP 100,A00,516065,Staff,9799,0,9999,200
1715666694321,ECE 45,A01,507414,Staff,32,0,60,28
1715666696377,ECE 111,A01,507420,Staff,11,0,50,39
1715666697405,ECE 197,001,548057,Sievenpiper; Daniel F.,9991,0,9999,8
1715666698433,EDS 115,A00,507243,Choi; Bailey Miyeon,6,0,28,22
1715666699466,EDS 117,A01,494379,Staff,0,6,34,35
1715666700495,EDS 125,A00,507246,Hopkins; Megan Beth,7,0,30,23
1715666701525,EDS 128A,A01,507264,Fargason; Sharon Gayle,5,0,26,21
1715666702557,EDS 128B,A01,507293,Pappas; Elizabeth,9,0,30,21
1715666703588,EDS 139,A00,507294,Fargason; Sharon Gayle,9,0,30,21
1715666703588,EDS 139,B00,507313,Pappas; Elizabeth,9,0,30,21
1715666704613,EDS 201,A00,507315,Staff,10,0,30,20
1715666705653,EDS 203,A01,507317,Halter; Christopher P.,10,0,30,20
1715666706679,EDS 204R,A01,507319,Halter; Christopher P.,0,3,30,30
1715666706679,EDS 204R,B01,507331,Heinzman; Erica M.,14,0,30,16
1715666707705,EDS 206R,A00,507332,Staff,0,4,30,30
1715666707705,EDS 206R,B00,507343,Staff,15,0,30,15
1715666708731,EDS 250,A00,507344,Hemans; Patricia Ann Benitez,20,0,40,20
1715666709759,EDS 281,A00,507345,Daly; Alan J.,18,0,18,0
1715666710783,EDS 284,A00,507350,Daly; Alan J.,16,0,16,0
1715666711813,EDS 286,A00,507359,Fine; Sarah,18,0,18,0
1715666712839,EDS 289C,A01,507361,Daly; Alan J.,18,0,18,0
1715666713869,EDS 290,A00,507366,Hofstetter; Carolyn,15,0,15,0
1715666714900,LIGM 5A,A00,507421,Fischer-Grunski; Eva K,17,0,20,3
1715666715925,LIGM 5B,A00,507423,Fischer-Grunski; Eva K,19,0,20,1
1715666717157,LIGM 5C,A00,507425,Fischer-Grunski; Eva K,19,0,20,1
1715666718190,LIIT 5AS,A00,507427,Carnelos; Chiara,20,0,20,0
1715666719221,LIIT 5BS,A00,507430,Carnelos; Chiara,20,0,20,0
1715666720252,LIIT 5CS,A00,507432,Carnelos; Chiara,20,0,20,0
1715666721282,LISP 5A,A00,507541,Munoz Sanchez; Alicia,11,0,20,9
1715666722308,LISP 5B,A00,507671,Munoz Sanchez; Alicia,8,0,20,12
1715666723334,LISP 5C,A00,507696,Munoz Sanchez; Alicia,7,0,20,13
1715666724363,MAE 197,001,528363,Boechler; Nicholas Sebastia,9998,0,9999,1
1715666725402,MATH 197,001,523477,Kedlaya; Kiran S.,9994,0,9999,5
1715666725402,MATH 197,002,563811,Zhang; Danna,9994,0,9999,5
1715666725402,MATH 197,003,628552,Dumitriu; Ioana,9998,0,9999,1
1715666725402,MATH 197,004,660885,Floyd; Eric,9998,0,9999,1
1715666726429,MCWP 40R,A00,518780,Staff,1,0,20,19
1715666726429,MCWP 40R,B00,518781,Carter; Jennifer A,9,0,20,11
1715666726429,MCWP 40R,C00,518783,Smith; Haydee Marie,5,0,20,15
1715666727460,MCWP 50R,A00,518791,Redela; Pamela Morgan,0,1,20,20
1715666727460,MCWP 50R,B00,518792,Krone; Jarret,0,2,20,20
1715666727460,MCWP 50R,C00,518793,Staff,0,4,20,20
1715666727460,MCWP 50R,D00,518794,Morshed; Michael James,0,2,20,20
1715666727460,MCWP 50R,E00,518795,Carter; Andrea L,0,2,20,20
1715666727460,MCWP 50R,F00,518796,Miller; Elizabeth Deen,0,1,20,20
1715666727460,MCWP 50R,G00,518797,Guillen; Melinda,0,1,20,20
1715666728494,MMW 12R,A01,514034,Herbst; Matthew,0,2,16,16
1715666728494,MMW 12R,A02,514035,Herbst; Matthew,0,0,16,16
1715666729527,MMW 13R,A01,514037,Staff,0,5,16,16
1715666729527,MMW 13R,A02,514039,Staff,0,5,16,16
1715666729527,MMW 13R,A03,628519,Staff,0,4,16,16
1715666731581,SIO 295LS,A00,523233,Staff,10,0,30,20
1715666732606,SIO 295S,A00,523232,Staff,10,0,30,20
1715666733638,SIOC 290S,A01,637330,Merrifield; Mark A,21,0,30,9
1715666734664,SIOC 291S,A01,637333,Gabriel; Corey John,21,0,30,9
1715666735690,SOCI 117,A01,494376,Staff,0,5,5,5
1715666736714,WES 237B,A00,494380,Staff,10,0,20,10
1715666738783,AESE 279B,A00,494370,Wade; Jon P,0,0,33,33
1715666739818,AIP 97,001,660915,Van Den Einde; Yael Dahlia,9998,0,9999,1
1715666740848,AIP 197,001,627712,Vespa; Emanuel Ignacio,9995,0,9999,4
1715666740848,AIP 197,002,650778,Amir; On,9998,0,9999,1
1715666740848,AIP 197,003,650933,Avenancio-Leon; Carlos,9998,0,9999,1
1715666740848,AIP 197,004,658530,Heyman; Gail D.,9998,0,9999,1
1715666740848,AIP 197,005,658631,Neal; Sonya E,9998,0,9999,1
1715666740848,AIP 197,006,658671,Du; Songzi,9998,0,9999,1
1715666741877,ANAR 135S,A00,494369,Braswell; Geoffrey E.,0,0,0,0
1715666742904,BENG 196,001,628496,Engler; Adam J.,9998,0,9999,1
1715666742904,BENG 196,002,660916,Watson; John Thomas,9998,0,9999,1
1715666743930,BISP 197,001,650773,Wilhelm; James E.,9994,0,9999,5
1715666743930,BISP 197,002,658904,Coleman; Aaron B.,9998,0,9999,1
1715666744964,CAT 124RS,A01,519847,Geibel; William,0,0,20,20
1715666745989,CAT 125RS,A01,515971,Geibel; William,0,0,20,20
1715666747017,CLRE 250,A00,511389,Morris; Sheldon,9992,0,9999,7
1715666748043,CLRE 251,A00,507176,Mehta; Ravindra L.,9992,0,9999,7
1715666748043,CLRE 251,B00,511410,Mehta; Ravindra L.,9998,0,9999,1
1715666749070,CLRE 252,A00,507189,Cuomo; Raphael Eduardo,9994,0,9999,5
1715666750101,CLRE 253,A00,507199,Vaida; Florin,9994,0,9999,5
1715666750101,CLRE 253,B00,507202,Vaida; Florin,9999,0,9999,0
1715666751126,CLRE 259,A00,507211,Patel; Hemal,9996,0,9999,3
1715666752152,CLRE 260,A00,507221,Cuomo; Raphael Eduardo,9999,0,9999,0
1715666753179,CLRE 297,001,507242,Cuomo; Raphael Eduardo,9999,0,9999,0
1715666754203,COGS 197,001,638244,Voytek; Bradley Thomas,9997,0,9999,2
1715666755242,CSE 191,A00,516875,Minnes Kemp; Mor Mia,9991,0,9999,8
1715666756270,CSE 197,001,637388,Minnes Kemp; Mor Mia,9992,0,9999,7
1715666757297,CSS 201S,A01,494383,Mignozzetti; Umberto,35,0,35,0
1715666758325,CSS 202S,A01,494387,Mignozzetti; Umberto,35,0,35,0
1715666759354,DSC 197,001,628532,Eldridge; Justin Matthew,9995,0,9999,4
1715666760383,EAP 100,A00,516065,Staff,9799,0,9999,200
1715666761422,ECE 45,A01,507414,Staff,32,0,60,28
1715666763478,ECE 111,A01,507420,Staff,11,0,50,39
1715666764505,ECE 197,001,548057,Sievenpiper; Daniel F.,9991,0,9999,8
1715666765534,EDS 115,A00,507243,Choi; Bailey Miyeon,6,0,28,22
1715666766561,EDS 117,A01,494379,Staff,0,6,34,35
1715666767586,EDS 125,A00,507246,Hopkins; Megan Beth,7,0,30,23
1715666768611,EDS 128A,A01,507264,Fargason; Sharon Gayle,5,0,26,21
1715666769637,EDS 128B,A01,507293,Pappas; Elizabeth,9,0,30,21
1715666770665,EDS 139,A00,507294,Fargason; Sharon Gayle,9,0,30,21
1715666770665,EDS 139,B00,507313,Pappas; Elizabeth,9,0,30,21
1715666771697,EDS 201,A00,507315,Staff,10,0,30,20
1715666772722,EDS 203,A01,507317,Halter; Christopher P.,10,0,30,20
1715666773753,EDS 204R,A01,507319,Halter; Christopher P.,0,3,30,30
1715666773753,EDS 204R,B01,507331,Heinzman; Erica M.,14,0,30,16
1715666774779,EDS 206R,A00,507332,Staff,0,4,30,30
1715666774779,EDS 206R,B00,507343,Staff,15,0,30,15
1715666775807,EDS 250,A00,507344,Hemans; Patricia Ann Benitez,20,0,40,20
1715666776855,EDS 281,A00,507345,Daly; Alan J.,18,0,18,0
1715666777881,EDS 284,A00,507350,Daly; Alan J.,16,0,16,0
1715666778907,EDS 286,A00,507359,Fine; Sarah,18,0,18,0
1715666779930,EDS 289C,A01,507361,Daly; Alan J.,18,0,18,0
1715666780957,EDS 290,A00,507366,Hofstetter; Carolyn,15,0,15,0
1715666781987,LIGM 5A,A00,507421,Fischer-Grunski; Eva K,17,0,20,3
1715666783017,LIGM 5B,A00,507423,Fischer-Grunski; Eva K,19,0,20,1
1715666784041,LIGM 5C,A00,507425,Fischer-Grunski; Eva K,19,0,20,1
1715666785069,LIIT 5AS,A00,507427,Carnelos; Chiara,20,0,20,0
1715666786123,LIIT 5BS,A00,507430,Carnelos; Chiara,20,0,20,0
1715666787155,LIIT 5CS,A00,507432,Carnelos; Chiara,20,0,20,0
1715666788180,LISP 5A,A00,507541,Munoz Sanchez; Alicia,11,0,20,9
1715666789252,LISP 5B,A00,507671,Munoz Sanchez; Alicia,8,0,20,12
1715666790280,LISP 5C,A00,507696,Munoz Sanchez; Alicia,7,0,20,13
1715666791309,MAE 197,001,528363,Boechler; Nicholas Sebastia,9998,0,9999,1
1715666792337,MATH 197,001,523477,Kedlaya; Kiran S.,9994,0,9999,5
1715666792337,MATH 197,002,563811,Zhang; Danna,9994,0,9999,5
1715666792337,MATH 197,003,628552,Dumitriu; Ioana,9998,0,9999,1
1715666792337,MATH 197,004,660885,Floyd; Eric,9998,0,9999,1
1715666793363,MCWP 40R,A00,518780,Staff,1,0,20,19
1715666793363,MCWP 40R,B00,518781,Carter; Jennifer A,9,0,20,11
1715666793363,MCWP 40R,C00,518783,Smith; Haydee Marie,5,0,20,15
1715666794392,MCWP 50R,A00,518791,Redela; Pamela Morgan,0,1,20,20
1715666794392,MCWP 50R,B00,518792,Krone; Jarret,0,2,20,20
1715666794392,MCWP 50R,C00,518793,Staff,0,4,20,20
1715666794392,MCWP 50R,D00,518794,Morshed; Michael James,0,2,20,20
1715666794392,MCWP 50R,E00,518795,Carter; Andrea L,0,2,20,20
1715666794392,MCWP 50R,F00,518796,Miller; Elizabeth Deen,0,1,20,20
1715666794392,MCWP 50R,G00,518797,Guillen; Melinda,0,1,20,20
1715666795426,MMW 12R,A01,514034,Herbst; Matthew,0,2,16,16
1715666795426,MMW 12R,A02,514035,Herbst; Matthew,0,0,16,16
1715666796450,MMW 13R,A01,514037,Staff,0,5,16,16
1715666796450,MMW 13R,A02,514039,Staff,0,5,16,16
1715666796450,MMW 13R,A03,628519,Staff,0,4,16,16
1715666798508,SIO 295LS,A00,523233,Staff,10,0,30,20
1715666799535,SIO 295S,A00,523232,Staff,10,0,30,20
1715666800562,SIOC 290S,A01,637330,Merrifield; Mark A,21,0,30,9
1715666801593,SIOC 291S,A01,637333,Gabriel; Corey John,21,0,30,9
1715666802619,SOCI 117,A01,494376,Staff,0,5,5,5
1715666803650,WES 237B,A00,494380,Staff,10,0,20,10
1715666805723,AESE 279B,A00,494370,Wade; Jon P,0,0,33,33
1715666806750,AIP 97,001,660915,Van Den Einde; Yael Dahlia,9998,0,9999,1
1715666807785,AIP 197,001,627712,Vespa; Emanuel Ignacio,9995,0,9999,4
1715666807785,AIP 197,002,650778,Amir; On,9998,0,9999,1
1715666807785,AIP 197,003,650933,Avenancio-Leon; Carlos,9998,0,9999,1
1715666807785,AIP 197,004,658530,Heyman; Gail D.,9998,0,9999,1
1715666807785,AIP 197,005,658631,Neal; Sonya E,9998,0,9999,1
1715666807785,AIP 197,006,658671,Du; Songzi,9998,0,9999,1
1715666808811,ANAR 135S,A00,494369,Braswell; Geoffrey E.,0,0,0,0
1715666809836,BENG 196,001,628496,Engler; Adam J.,9998,0,9999,1
1715666809836,BENG 196,002,660916,Watson; John Thomas,9998,0,9999,1
1715666810863,BISP 197,001,650773,Wilhelm; James E.,9994,0,9999,5
1715666810863,BISP 197,002,658904,Coleman; Aaron B.,9998,0,9999,1
1715666811890,CAT 124RS,A01,519847,Geibel; William,0,0,20,20
1715666812917,CAT 125RS,A01,515971,Geibel; William,0,0,20,20
1715666813947,CLRE 250,A00,511389,Morris; Sheldon,9992,0,9999,7
1715666814974,CLRE 251,A00,507176,Mehta; Ravindra L.,9992,0,9999,7
1715666814974,CLRE 251,B00,511410,Mehta; Ravindra L.,9998,0,9999,1
1715666816000,CLRE 252,A00,507189,Cuomo; Raphael Eduardo,9994,0,9999,5
1715666817027,CLRE 253,A00,507199,Vaida; Florin,9994,0,9999,5
1715666817027,CLRE 253,B00,507202,Vaida; Florin,9999,0,9999,0
1715666818056,CLRE 259,A00,507211,Patel; Hemal,9996,0,9999,3
1715666819083,CLRE 260,A00,507221,Cuomo; Raphael Eduardo,9999,0,9999,0
1715666820108,CLRE 297,001,507242,Cuomo; Raphael Eduardo,9999,0,9999,0
1715666821134,COGS 197,001,638244,Voytek; Bradley Thomas,9997,0,9999,2
1715666822159,CSE 191,A00,516875,Minnes Kemp; Mor Mia,9991,0,9999,8
1715666823187,CSE 197,001,637388,Minnes Kemp; Mor Mia,9992,0,9999,7
1715666824214,CSS 201S,A01,494383,Mignozzetti; Umberto,35,0,35,0
1715666825239,CSS 202S,A01,494387,Mignozzetti; Umberto,35,0,35,0
1715666826263,DSC 197,001,628532,Eldridge; Justin Matthew,9995,0,9999,4
1715666827291,EAP 100,A00,516065,Staff,9799,0,9999,200
1715666828317,ECE 45,A01,507414,Staff,32,0,60,28
1715666830369,ECE 111,A01,507420,Staff,11,0,50,39
1715666831397,ECE 197,001,548057,Sievenpiper; Daniel F.,9991,0,9999,8
1715666832427,EDS 115,A00,507243,Choi; Bailey Miyeon,6,0,28,22
1715666833453,EDS 117,A01,494379,Staff,0,6,34,35
1715666834482,EDS 125,A00,507246,Hopkins; Megan Beth,7,0,30,23
1715666835508,EDS 128A,A01,507264,Fargason; Sharon Gayle,5,0,26,21
1715666836538,EDS 128B,A01,507293,Pappas; Elizabeth,9,0,30,21
1715666837567,EDS 139,A00,507294,Fargason; Sharon Gayle,9,0,30,21
1715666837567,EDS 139,B00,507313,Pappas; Elizabeth,9,0,30,21
1715666838597,EDS 201,A00,507315,Staff,10,0,30,20
1715666839623,EDS 203,A01,507317,Halter; Christopher P.,10,0,30,20
1715666840655,EDS 204R,A01,507319,Halter; Christopher P.,0,3,30,30
1715666840655,EDS 204R,B01,507331,Heinzman; Erica M.,14,0,30,16
1715666841687,EDS 206R,A00,507332,Staff,0,4,30,30
1715666841687,EDS 206R,B00,507343,Staff,15,0,30,15
1715666842719,EDS 250,A00,507344,Hemans; Patricia Ann Benitez,20,0,40,20
1715666843745,EDS 281,A00,507345,Daly; Alan J.,18,0,18,0
1715666844775,EDS 284,A00,507350,Daly; Alan J.,16,0,16,0
1715666845801,EDS 286,A00,507359,Fine; Sarah,18,0,18,0
1715666846826,EDS 289C,A01,507361,Daly; Alan J.,18,0,18,0
1715666847853,EDS 290,A00,507366,Hofstetter; Carolyn,15,0,15,0
1715666848881,LIGM 5A,A00,507421,Fischer-Grunski; Eva K,17,0,20,3
1715666849905,LIGM 5B,A00,507423,Fischer-Grunski; Eva K,19,0,20,1
1715666850939,LIGM 5C,A00,507425,Fischer-Grunski; Eva K,19,0,20,1
1715666851967,LIIT 5AS,A00,507427,Carnelos; Chiara,20,0,20,0
1715666853056,LIIT 5BS,A00,507430,Carnelos; Chiara,20,0,20,0
1715666854082,LIIT 5CS,A00,507432,Carnelos; Chiara,20,0,20,0
1715666855114,LISP 5A,A00,507541,Munoz Sanchez; Alicia,11,0,20,9
1715666856145,LISP 5B,A00,507671,Munoz Sanchez; Alicia,8,0,20,12
1715666857177,LISP 5C,A00,507696,Munoz Sanchez; Alicia,7,0,20,13
1715666858202,MAE 197,001,528363,Boechler; Nicholas Sebastia,9998,0,9999,1
1715666859236,MATH 197,001,523477,Kedlaya; Kiran S.,9994,0,9999,5
1715666859236,MATH 197,002,563811,Zhang; Danna,9994,0,9999,5
1715666859236,MATH 197,003,628552,Dumitriu; Ioana,9998,0,9999,1
1715666859236,MATH 197,004,660885,Floyd; Eric,9998,0,9999,1
1715666860263,MCWP 40R,A00,518780,Staff,1,0,20,19
1715666860263,MCWP 40R,B00,518781,Carter; Jennifer A,9,0,20,11
1715666860263,MCWP 40R,C00,518783,Smith; Haydee Marie,5,0,20,15
1715666861291,MCWP 50R,A00,518791,Redela; Pamela Morgan,0,1,20,20
1715666861291,MCWP 50R,B00,518792,Krone; Jarret,0,2,20,20
1715666861291,MCWP 50R,C00,518793,Staff,0,4,20,20
1715666861291,MCWP 50R,D00,518794,Morshed; Michael James,0,2,20,20
1715666861291,MCWP 50R,E00,518795,Carter; Andrea L,0,2,20,20
1715666861291,MCWP 50R,F00,518796,Miller; Elizabeth Deen,0,1,20,20
1715666861291,MCWP 50R,G00,518797,Guillen; Melinda,0,1,20,20
1715666862318,MMW 12R,A01,514034,Herbst; Matthew,0,2,16,16
1715666862318,MMW 12R,A02,514035,Herbst; Matthew,0,0,16,16
1715666863347,MMW 13R,A01,514037,Staff,0,5,16,16
1715666863347,MMW 13R,A02,514039,Staff,0,5,16,16
1715666863347,MMW 13R,A03,628519,Staff,0,4,16,16
1715666865401,SIO 295LS,A00,523233,Staff,10,0,30,20
1715666866427,SIO 295S,A00,523232,Staff,10,0,30,20
1715666867453,SIOC 290S,A01,637330,Merrifield; Mark A,21,0,30,9
1715666868485,SIOC 291S,A01,637333,Gabriel; Corey John,21,0,30,9
1715666869513,SOCI 117,A01,494376,Staff,0,5,5,5
1715666870538,WES 237B,A00,494380,Staff,10,0,20,10
1715666872614,AESE 279B,A00,494370,Wade; Jon P,0,0,33,33
1715666873642,AIP 97,001,660915,Van Den Einde; Yael Dahlia,9998,0,9999,1
1715666874677,AIP 197,001,627712,Vespa; Emanuel Ignacio,9995,0,9999,4
1715666874677,AIP 197,002,650778,Amir; On,9998,0,9999,1
1715666874677,AIP 197,003,650933,Avenancio-Leon; Carlos,9998,0,9999,1
1715666874677,AIP 197,004,658530,Heyman; Gail D.,9998,0,9999,1
1715666874677,AIP 197,005,658631,Neal; Sonya E,9998,0,9999,1
1715666874677,AIP 197,006,658671,Du; Songzi,9998,0,9999,1
1715666875704,ANAR 135S,A00,494369,Braswell; Geoffrey E.,0,0,0,0
1715666876736,BENG 196,001,628496,Engler; Adam J.,9998,0,9999,1
1715666876736,BENG 196,002,660916,Watson; John Thomas,9998,0,9999,1
1715666877762,BISP 197,001,650773,Wilhelm; James E.,9994,0,9999,5
1715666877762,BISP 197,002,658904,Coleman; Aaron B.,9998,0,9999,1
1715666878788,CAT 124RS,A01,519847,Geibel; William,0,0,20,20
1715666879814,CAT 125RS,A01,515971,Geibel; William,0,0,20,20
1715666880840,CLRE 250,A00,511389,Morris; Sheldon,9992,0,9999,7
1715666881867,CLRE 251,A00,507176,Mehta; Ravindra L.,9992,0,9999,7
1715666881867,CLRE 251,B00,511410,Mehta; Ravindra L.,9998,0,9999,1
1715666882898,CLRE 252,A00,507189,Cuomo; Raphael Eduardo,9994,0,9999,5
1715666883924,CLRE 253,A00,507199,Vaida; Florin,9994,0,9999,5
1715666883924,CLRE 253,B00,507202,Vaida; Florin,9999,0,9999,0
1715666884950,CLRE 259,A00,507211,Patel; Hemal,9996,0,9999,3
1715666885980,CLRE 260,A00,507221,Cuomo; Raphael Eduardo,9999,0,9999,0
1715666887008,CLRE 297,001,507242,Cuomo; Raphael Eduardo,9999,0,9999,0
1715666888034,COGS 197,001,638244,Voytek; Bradley Thomas,9997,0,9999,2
1715666889064,CSE 191,A00,516875,Minnes Kemp; Mor Mia,9991,0,9999,8
1715666890088,CSE 197,001,637388,Minnes Kemp; Mor Mia,9992,0,9999,7
1715666891116,CSS 201S,A01,494383,Mignozzetti; Umberto,35,0,35,0
1715666892144,CSS 202S,A01,494387,Mignozzetti; Umberto,35,0,35,0
1715666893171,DSC 197,001,628532,Eldridge; Justin Matthew,9995,0,9999,4
1715666894199,EAP 100,A00,516065,Staff,9799,0,9999,200
1715666895236,ECE 45,A01,507414,Staff,32,0,60,28
1715666897301,ECE 111,A01,507420,Staff,11,0,50,39
1715666898329,ECE 197,001,548057,Sievenpiper; Daniel F.,9991,0,9999,8
1715666899361,EDS 115,A00,507243,Choi; Bailey Miyeon,6,0,28,22
1715666900387,EDS 117,A01,494379,Staff,0,6,34,35
1715666901413,EDS 125,A00,507246,Hopkins; Megan Beth,7,0,30,23
1715666902443,EDS 128A,A01,507264,Fargason; Sharon Gayle,5,0,26,21
1715666903468,EDS 128B,A01,507293,Pappas; Elizabeth,9,0,30,21
1715666904494,EDS 139,A00,507294,Fargason; Sharon Gayle,9,0,30,21
1715666904494,EDS 139,B00,507313,Pappas; Elizabeth,9,0,30,21
1715666905522,EDS 201,A00,507315,Staff,10,0,30,20
1715666906553,EDS 203,A01,507317,Halter; Christopher P.,10,0,30,20
1715666907583,EDS 204R,A01,507319,Halter; Christopher P.,0,3,30,30
1715666907583,EDS 204R,B01,507331,Heinzman; Erica M.,14,0,30,16
1715666908611,EDS 206R,A00,507332,Staff,0,4,30,30
1715666908611,EDS 206R,B00,507343,Staff,15,0,30,15
1715666909641,EDS 250,A00,507344,Hemans; Patricia Ann Benitez,20,0,40,20
1715666910666,EDS 281,A00,507345,Daly; Alan J.,18,0,18,0
1715666911689,EDS 284,A00,507350,Daly; Alan J.,16,0,16,0
1715666912715,EDS 286,A00,507359,Fine; Sarah,18,0,18,0
1715666913740,EDS 289C,A01,507361,Daly; Alan J.,18,0,18,0
1715666914769,EDS 290,A00,507366,Hofstetter; Carolyn,15,0,15,0
1715666915795,LIGM 5A,A00,507421,Fischer-Grunski; Eva K,17,0,20,3
1715666916820,LIGM 5B,A00,507423,Fischer-Grunski; Eva K,19,0,20,1
1715666917849,LIGM 5C,A00,507425,Fischer-Grunski; Eva K,19,0,20,1
1715666918878,LIIT 5AS,A00,507427,Carnelos; Chiara,20,0,20,0
1715666919908,LIIT 5BS,A00,507430,Carnelos; Chiara,20,0,20,0
1715666920937,LIIT 5CS,A00,507432,Carnelos; Chiara,20,0,20,0
1715666921970,LISP 5A,A00,507541,Munoz Sanchez; Alicia,11,0,20,9
1715666922996,LISP 5B,A00,507671,Munoz Sanchez; Alicia,8,0,20,12
1715666924024,LISP 5C,A00,507696,Munoz Sanchez; Alicia,7,0,20,13
1715666925054,MAE 197,001,528363,Boechler; Nicholas Sebastia,9998,0,9999,1
1715666926087,MATH 197,001,523477,Kedlaya; Kiran S.,9994,0,9999,5
1715666926087,MATH 197,002,563811,Zhang; Danna,9994,0,9999,5
1715666926087,MATH 197,003,628552,Dumitriu; Ioana,9998,0,9999,1
1715666926087,MATH 197,004,660885,Floyd; Eric,9998,0,9999,1
1715666927117,MCWP 40R,A00,518780,Staff,1,0,20,19
1715666927117,MCWP 40R,B00,518781,Carter; Jennifer A,9,0,20,11
1715666927117,MCWP 40R,C00,518783,Smith; Haydee Marie,5,0,20,15
1715666928154,MCWP 50R,A00,518791,Redela; Pamela Morgan,0,1,20,20
1715666928154,MCWP 50R,B00,518792,Krone; Jarret,0,2,20,20
1715666928154,MCWP 50R,C00,518793,Staff,0,4,20,20
1715666928154,MCWP 50R,D00,518794,Morshed; Michael James,0,2,20,20
1715666928154,MCWP 50R,E00,518795,Carter; Andrea L,0,2,20,20
1715666928154,MCWP 50R,F00,518796,Miller; Elizabeth Deen,0,1,20,20
1715666928154,MCWP 50R,G00,518797,Guillen; Melinda,0,1,20,20
1715666929189,MMW 12R,A01,514034,Herbst; Matthew,0,2,16,16
1715666929189,MMW 12R,A02,514035,Herbst; Matthew,0,0,16,16
1715666930215,MMW 13R,A01,514037,Staff,0,5,16,16
1715666930215,MMW 13R,A02,514039,Staff,0,5,16,16
1715666930215,MMW 13R,A03,628519,Staff,0,4,16,16
1715666932269,SIO 295LS,A00,523233,Staff,10,0,30,20
1715666933297,SIO 295S,A00,523232,Staff,10,0,30,20
1715666934321,SIOC 290S,A01,637330,Merrifield; Mark A,21,0,30,9
1715666935349,SIOC 291S,A01,637333,Gabriel; Corey John,21,0,30,9
1715666936379,SOCI 117,A01,494376,Staff,0,5,5,5
1715666937403,WES 237B,A00,494380,Staff,10,0,20,10
1715666939469,AESE 279B,A00,494370,Wade; Jon P,0,0,33,33
1715666940498,AIP 97,001,660915,Van Den Einde; Yael Dahlia,9998,0,9999,1
1715666941529,AIP 197,001,627712,Vespa; Emanuel Ignacio,9995,0,9999,4
1715666941529,AIP 197,002,650778,Amir; On,9998,0,9999,1
1715666941529,AIP 197,003,650933,Avenancio-Leon; Carlos,9998,0,9999,1
1715666941529,AIP 197,004,658530,Heyman; Gail D.,9998,0,9999,1
1715666941529,AIP 197,005,658631,Neal; Sonya E,9998,0,9999,1
1715666941529,AIP 197,006,658671,Du; Songzi,9998,0,9999,1
1715666942560,ANAR 135S,A00,494369,Braswell; Geoffrey E.,0,0,0,0
1715666943583,BENG 196,001,628496,Engler; Adam J.,9998,0,9999,1
1715666943583,BENG 196,002,660916,Watson; John Thomas,9998,0,9999,1
1715666944609,BISP 197,001,650773,Wilhelm; James E.,9994,0,9999,5
1715666944609,BISP 197,002,658904,Coleman; Aaron B.,9998,0,9999,1
1715666945635,CAT 124RS,A01,519847,Geibel; William,0,0,20,20
1715666946663,CAT 125RS,A01,515971,Geibel; William,0,0,20,20
1715666947704,CLRE 250,A00,511389,Morris; Sheldon,9992,0,9999,7
1715666948738,CLRE 251,A00,507176,Mehta; Ravindra L.,9992,0,9999,7
1715666948738,CLRE 251,B00,511410,Mehta; Ravindra L.,9998,0,9999,1
1715666949767,CLRE 252,A00,507189,Cuomo; Raphael Eduardo,9994,0,9999,5
1715666950793,CLRE 253,A00,507199,Vaida; Florin,9994,0,9999,5
1715666950793,CLRE 253,B00,507202,Vaida; Florin,9999,0,9999,0
1715666951818,CLRE 259,A00,507211,Patel; Hemal,9996,0,9999,3
1715666952843,CLRE 260,A00,507221,Cuomo; Raphael Eduardo,9999,0,9999,0
1715666953882,CLRE 297,001,507242,Cuomo; Raphael Eduardo,9999,0,9999,0
1715666954909,COGS 197,001,638244,Voytek; Bradley Thomas,9997,0,9999,2
1715666955937,CSE 191,A00,516875,Minnes Kemp; Mor Mia,9991,0,9999,8
1715666956966,CSE 197,001,637388,Minnes Kemp; Mor Mia,9992,0,9999,7
1715666957993,CSS 201S,A01,494383,Mignozzetti; Umberto,35,0,35,0
1715666959017,CSS 202S,A01,494387,Mignozzetti; Umberto,35,0,35,0
1715666960040,DSC 197,001,628532,Eldridge; Justin Matthew,9995,0,9999,4
1715666961064,EAP 100,A00,516065,Staff,9799,0,9999,200
1715666962102,ECE 45,A01,507414,Staff,32,0,60,28
1715666964154,ECE 111,A01,507420,Staff,11,0,50,39
1715666965181,ECE 197,001,548057,Sievenpiper; Daniel F.,9991,0,9999,8
1715666966208,EDS 115,A00,507243,Choi; Bailey Miyeon,6,0,28,22
1715666967235,EDS 117,A01,494379,Staff,0,6,34,35
1715666968260,EDS 125,A00,507246,Hopkins; Megan Beth,7,0,30,23
1715666969286,EDS 128A,A01,507264,Fargason; Sharon Gayle,5,0,26,21
1715666970312,EDS 128B,A01,507293,Pappas; Elizabeth,9,0,30,21
1715666971339,EDS 139,A00,507294,Fargason; Sharon Gayle,9,0,30,21
1715666971339,EDS 139,B00,507313,Pappas; Elizabeth,9,0,30,21
1715666972364,EDS 201,A00,507315,Staff,10,0,30,20
1715666973391,EDS 203,A01,507317,Halter; Christopher P.,10,0,30,20
1715666974418,EDS 204R,A01,507319,Halter; Christopher P.,0,3,30,30
1715666974418,EDS 204R,B01,507331,Heinzman; Erica M.,14,0,30,16
1715666975442,EDS 206R,A00,507332,Staff,0,4,30,30
1715666975442,EDS 206R,B00,507343,Staff,15,0,30,15
1715666976470,EDS 250,A00,507344,Hemans; Patricia Ann Benitez,20,0,40,20
1715666977495,EDS 281,A00,507345,Daly; Alan J.,18,0,18,0
1715666978522,EDS 284,A00,507350,Daly; Alan J.,16,0,16,0
1715666979550,EDS 286,A00,507359,Fine; Sarah,18,0,18,0
1715666980576,EDS 289C,A01,507361,Daly; Alan J.,18,0,18,0
1715666981602,EDS 290,A00,507366,Hofstetter; Carolyn,15,0,15,0
1715666982630,LIGM 5A,A00,507421,Fischer-Grunski; Eva K,17,0,20,3
1715666983657,LIGM 5B,A00,507423,Fischer-Grunski; Eva K,19,0,20,1
1715666984684,LIGM 5C,A00,507425,Fischer-Grunski; Eva K,19,0,20,1
1715666985711,LIIT 5AS,A00,507427,Carnelos; Chiara,20,0,20,0
1715666986741,LIIT 5BS,A00,507430,Carnelos; Chiara,20,0,20,0
1715666987771,LIIT 5CS,A00,507432,Carnelos; Chiara,20,0,20,0
1715666988800,LISP 5A,A00,507541,Munoz Sanchez; Alicia,11,0,20,9
1715666989829,LISP 5B,A00,507671,Munoz Sanchez; Alicia,8,0,20,12
1715666990852,LISP 5C,A00,507696,Munoz Sanchez; Alicia,7,0,20,13
1715666991882,MAE 197,001,528363,Boechler; Nicholas Sebastia,9998,0,9999,1
1715666992910,MATH 197,001,523477,Kedlaya; Kiran S.,9994,0,9999,5
1715666992910,MATH 197,002,563811,Zhang; Danna,9994,0,9999,5
1715666992910,MATH 197,003,628552,Dumitriu; Ioana,9998,0,9999,1
1715666992910,MATH 197,004,660885,Floyd; Eric,9998,0,9999,1
1715666993944,MCWP 40R,A00,518780,Staff,1,0,20,19
1715666993944,MCWP 40R,B00,518781,Carter; Jennifer A,9,0,20,11
1715666993944,MCWP 40R,C00,518783,Smith; Haydee Marie,5,0,20,15
1715666994973,MCWP 50R,A00,518791,Redela; Pamela Morgan,0,1,20,20
1715666994973,MCWP 50R,B00,518792,Krone; Jarret,0,2,20,20
1715666994973,MCWP 50R,C00,518793,Staff,0,4,20,20
1715666994973,MCWP 50R,D00,518794,Morshed; Michael James,0,2,20,20
1715666994973,MCWP 50R,E00,518795,Carter; Andrea L,0,2,20,20
1715666994973,MCWP 50R,F00,518796,Miller; Elizabeth Deen,0,1,20,20
1715666994973,MCWP 50R,G00,518797,Guillen; Melinda,0,1,20,20
1715666996001,MMW 12R,A01,514034,Herbst; Matthew,0,2,16,16
1715666996001,MMW 12R,A02,514035,Herbst; Matthew,0,0,16,16
1715666997026,MMW 13R,A01,514037,Staff,0,5,16,16
1715666997026,MMW 13R,A02,514039,Staff,0,5,16,16
1715666997026,MMW 13R,A03,628519,Staff,0,4,16,16
1715666999080,SIO 295LS,A00,523233,Staff,10,0,30,20
1715667000105,SIO 295S,A00,523232,Staff,10,0,30,20
1715667001131,SIOC 290S,A01,637330,Merrifield; Mark A,21,0,30,9
1715667002162,SIOC 291S,A01,637333,Gabriel; Corey John,21,0,30,9
1715667003191,SOCI 117,A01,494376,Staff,0,5,5,5
1715667004217,WES 237B,A00,494380,Staff,10,0,20,10
1715667006290,AESE 279B,A00,494370,Wade; Jon P,0,0,33,33
1715667007315,AIP 97,001,660915,Van Den Einde; Yael Dahlia,9998,0,9999,1
1715667008350,AIP 197,001,627712,Vespa; Emanuel Ignacio,9995,0,9999,4
1715667008350,AIP 197,002,650778,Amir; On,9998,0,9999,1
1715667008350,AIP 197,003,650933,Avenancio-Leon; Carlos,9998,0,9999,1
1715667008350,AIP 197,004,658530,Heyman; Gail D.,9998,0,9999,1
1715667008350,AIP 197,005,658631,Neal; Sonya E,9998,0,9999,1
1715667008350,AIP 197,006,658671,Du; Songzi,9998,0,9999,1
1715667009374,ANAR 135S,A00,494369,Braswell; Geoffrey E.,0,0,0,0
1715667010404,BENG 196,001,628496,Engler; Adam J.,9998,0,9999,1
1715667010404,BENG 196,002,660916,Watson; John Thomas,9998,0,9999,1
1715667011430,BISP 197,001,650773,Wilhelm; James E.,9994,0,9999,5
1715667011430,BISP 197,002,658904,Coleman; Aaron B.,9998,0,9999,1
1715667012524,CAT 124RS,A01,519847,Geibel; William,0,0,20,20
1715667013548,CAT 125RS,A01,515971,Geibel; William,0,0,20,20
1715667014577,CLRE 250,A00,511389,Morris; Sheldon,9992,0,9999,7
1715667015604,CLRE 251,A00,507176,Mehta; Ravindra L.,9992,0,9999,7
1715667015604,CLRE 251,B00,511410,Mehta; Ravindra L.,9998,0,9999,1
1715667016630,CLRE 252,A00,507189,Cuomo; Raphael Eduardo,9994,0,9999,5
1715667017658,CLRE 253,A00,507199,Vaida; Florin,9994,0,9999,5
1715667017658,CLRE 253,B00,507202,Vaida; Florin,9999,0,9999,0
1715667018686,CLRE 259,A00,507211,Patel; Hemal,9996,0,9999,3
1715667019713,CLRE 260,A00,507221,Cuomo; Raphael Eduardo,9999,0,9999,0
1715667020738,CLRE 297,001,507242,Cuomo; Raphael Eduardo,9999,0,9999,0
1715667021764,COGS 197,001,638244,Voytek; Bradley Thomas,9997,0,9999,2
1715667022789,CSE 191,A00,516875,Minnes Kemp; Mor Mia,9991,0,9999,8
1715667023815,CSE 197,001,637388,Minnes Kemp; Mor Mia,9992,0,9999,7
1715667024847,CSS 201S,A01,494383,Mignozzetti; Umberto,35,0,35,0
1715667025925,CSS 202S,A01,494387,Mignozzetti; Umberto,35,0,35,0
1715667026952,DSC 197,001,628532,Eldridge; Justin Matthew,9995,0,9999,4
1715667027979,EAP 100,A00,516065,Staff,9799,0,9999,200
1715667029007,ECE 45,A01,507414,Staff,32,0,60,28
1715667031062,ECE 111,A01,507420,Staff,11,0,50,39
1715667032088,ECE 197,001,548057,Sievenpiper; Daniel F.,9991,0,9999,8
1715667033114,EDS 115,A00,507243,Choi; Bailey Miyeon,6,0,28,22
1715667034139,EDS 117,A01,494379,Staff,0,6,34,35
1715667035163,EDS 125,A00,507246,Hopkins; Megan Beth,7,0,30,23
1715667036188,EDS 128A,A01,507264,Fargason; Sharon Gayle,5,0,26,21
1715667037218,EDS 128B,A01,507293,Pappas; Elizabeth,9,0,30,21
1715667038243,EDS 139,A00,507294,Fargason; Sharon Gayle,9,0,30,21
1715667038243,EDS 139,B00,507313,Pappas; Elizabeth,9,0,30,21
1715667039268,EDS 201,A00,507315,Staff,10,0,30,20
1715667040293,EDS 203,A01,507317,Halter; Christopher P.,10,0,30,20
1715667041319,EDS 204R,A01,507319,Halter; Christopher P.,0,3,30,30
1715667041319,EDS 204R,B01,507331,Heinzman; Erica M.,14,0,30,16
1715667042347,EDS 206R,A00,507332,Staff,0,4,30,30
1715667042347,EDS 206R,B00,507343,Staff,15,0,30,15
1715667043372,EDS 250,A00,507344,Hemans; Patricia Ann Benitez,20,0,40,20
1715667044400,EDS 281,A00,507345,Daly; Alan J.,18,0,18,0
1715667045424,EDS 284,A00,507350,Daly; Alan J.,16,0,16,0
1715667046447,EDS 286,A00,507359,Fine; Sarah,18,0,18,0
1715667047476,EDS 289C,A01,507361,Daly; Alan J.,18,0,18,0
1715667048500,EDS 290,A00,507366,Hofstetter; Carolyn,15,0,15,0
1715667049527,LIGM 5A,A00,507421,Fischer-Grunski; Eva K,17,0,20,3
1715667050552,LIGM 5B,A00,507423,Fischer-Grunski; Eva K,19,0,20,1
1715667051578,LIGM 5C,A00,507425,Fischer-Grunski; Eva K,19,0,20,1
1715667052602,LIIT 5AS,A00,507427,Carnelos; Chiara,20,0,20,0
1715667053629,LIIT 5BS,A00,507430,Carnelos; Chiara,20,0,20,0
1715667054655,LIIT 5CS,A00,507432,Carnelos; Chiara,20,0,20,0
1715667055685,LISP 5A,A00,507541,Munoz Sanchez; Alicia,11,0,20,9
1715667056709,LISP 5B,A00,507671,Munoz Sanchez; Alicia,8,0,20,12
1715667057733,LISP 5C,A00,507696,Munoz Sanchez; Alicia,7,0,20,13
1715667058758,MAE 197,001,528363,Boechler; Nicholas Sebastia,9998,0,9999,1
1715667059789,MATH 197,001,523477,Kedlaya; Kiran S.,9994,0,9999,5
1715667059789,MATH 197,002,563811,Zhang; Danna,9994,0,9999,5
1715667059789,MATH 197,003,628552,Dumitriu; Ioana,9998,0,9999,1
1715667059789,MATH 197,004,660885,Floyd; Eric,9998,0,9999,1
1715667060821,MCWP 40R,A00,518780,Staff,1,0,20,19
1715667060821,MCWP 40R,B00,518781,Carter; Jennifer A,9,0,20,11
1715667060821,MCWP 40R,C00,518783,Smith; Haydee Marie,5,0,20,15
1715667061847,MCWP 50R,A00,518791,Redela; Pamela Morgan,0,1,20,20
1715667061847,MCWP 50R,B00,518792,Krone; Jarret,0,2,20,20
1715667061847,MCWP 50R,C00,518793,Staff,0,4,20,20
1715667061847,MCWP 50R,D00,518794,Morshed; Michael James,0,2,20,20
1715667061847,MCWP 50R,E00,518795,Carter; Andrea L,0,2,20,20
1715667061847,MCWP 50R,F00,518796,Miller; Elizabeth Deen,0,1,20,20
1715667061847,MCWP 50R,G00,518797,Guillen; Melinda,0,1,20,20
1715667062872,MMW 12R,A01,514034,Herbst; Matthew,0,2,16,16
1715667062872,MMW 12R,A02,514035,Herbst; Matthew,0,0,16,16
1715667063896,MMW 13R,A01,514037,Staff,0,5,16,16
1715667063896,MMW 13R,A02,514039,Staff,0,5,16,16
1715667063896,MMW 13R,A03,628519,Staff,0,4,16,16
1715667065948,SIO 295LS,A00,523233,Staff,10,0,30,20
1715667066979,SIO 295S,A00,523232,Staff,10,0,30,20
1715667068006,SIOC 290S,A01,637330,Merrifield; Mark A,21,0,30,9
1715667069037,SIOC 291S,A01,637333,Gabriel; Corey John,21,0,30,9
1715667070066,SOCI 117,A01,494376,Staff,0,5,5,5
1715667071093,WES 237B,A00,494380,Staff,10,0,20,10
1715667073160,AESE 279B,A00,494370,Wade; Jon P,0,0,33,33
1715667074186,AIP 97,001,660915,Van Den Einde; Yael Dahlia,9998,0,9999,1
1715667075217,AIP 197,001,627712,Vespa; Emanuel Ignacio,9995,0,9999,4
1715667075217,AIP 197,002,650778,Amir; On,9998,0,9999,1
1715667075217,AIP 197,003,650933,Avenancio-Leon; Carlos,9998,0,9999,1
1715667075217,AIP 197,004,658530,Heyman; Gail D.,9998,0,9999,1
1715667075217,AIP 197,005,658631,Neal; Sonya E,9998,0,9999,1
1715667075217,AIP 197,006,658671,Du; Songzi,9998,0,9999,1
1715667076245,ANAR 135S,A00,494369,Braswell; Geoffrey E.,0,0,0,0
1715667077275,BENG 196,001,628496,Engler; Adam J.,9998,0,9999,1
1715667077275,BENG 196,002,660916,Watson; John Thomas,9998,0,9999,1
1715667078305,BISP 197,001,650773,Wilhelm; James E.,9994,0,9999,5
1715667078305,BISP 197,002,658904,Coleman; Aaron B.,9998,0,9999,1
1715667079332,CAT 124RS,A01,519847,Geibel; William,0,0,20,20
1715667080357,CAT 125RS,A01,515971,Geibel; William,0,0,20,20
1715667081384,CLRE 250,A00,511389,Morris; Sheldon,9992,0,9999,7
1715667082410,CLRE 251,A00,507176,Mehta; Ravindra L.,9992,0,9999,7
1715667082410,CLRE 251,B00,511410,Mehta; Ravindra L.,9998,0,9999,1
1715667083438,CLRE 252,A00,507189,Cuomo; Raphael Eduardo,9994,0,9999,5
1715667084469,CLRE 253,A00,507199,Vaida; Florin,9994,0,9999,5
1715667084469,CLRE 253,B00,507202,Vaida; Florin,9999,0,9999,0
1715667085496,CLRE 259,A00,507211,Patel; Hemal,9996,0,9999,3
1715667086525,CLRE 260,A00,507221,Cuomo; Raphael Eduardo,9999,0,9999,0
1715667087549,CLRE 297,001,507242,Cuomo; Raphael Eduardo,9999,0,9999,0
1715667088576,COGS 197,001,638244,Voytek; Bradley Thomas,9997,0,9999,2
1715667089605,CSE 191,A00,516875,Minnes Kemp; Mor Mia,9991,0,9999,8
1715667090629,CSE 197,001,637388,Minnes Kemp; Mor Mia,9992,0,9999,7
1715667091657,CSS 201S,A01,494383,Mignozzetti; Umberto,35,0,35,0
1715667092683,CSS 202S,A01,494387,Mignozzetti; Umberto,35,0,35,0
1715667093709,DSC 197,001,628532,Eldridge; Justin Matthew,9995,0,9999,4
1715667094739,EAP 100,A00,516065,Staff,9799,0,9999,200
1715667095766,ECE 45,A01,507414,Staff,32,0,60,28
1715667097817,ECE 111,A01,507420,Staff,11,0,50,39
1715667098842,ECE 197,001,548057,Sievenpiper; Daniel F.,9991,0,9999,8
1715667099869,EDS 115,A00,507243,Choi; Bailey Miyeon,6,0,28,22
1715667100895,EDS 117,A01,494379,Staff,0,6,34,35
1715667101921,EDS 125,A00,507246,Hopkins; Megan Beth,7,0,30,23
1715667102950,EDS 128A,A01,507264,Fargason; Sharon Gayle,5,0,26,21
1715667103978,EDS 128B,A01,507293,Pappas; Elizabeth,9,0,30,21
1715667105005,EDS 139,A00,507294,Fargason; Sharon Gayle,9,0,30,21
1715667105005,EDS 139,B00,507313,Pappas; Elizabeth,9,0,30,21
1715667106029,EDS 201,A00,507315,Staff,10,0,30,20
1715667107053,EDS 203,A01,507317,Halter; Christopher P.,10,0,30,20
1715667108084,EDS 204R,A01,507319,Halter; Christopher P.,0,3,30,30
1715667108084,EDS 204R,B01,507331,Heinzman; Erica M.,14,0,30,16
1715667109108,EDS 206R,A00,507332,Staff,0,4,30,30
1715667109108,EDS 206R,B00,507343,Staff,15,0,30,15
1715667110137,EDS 250,A00,507344,Hemans; Patricia Ann Benitez,20,0,40,20
1715667111162,EDS 281,A00,507345,Daly; Alan J.,18,0,18,0
1715667112186,EDS 284,A00,507350,Daly; Alan J.,16,0,16,0
1715667113215,EDS 286,A00,507359,Fine; Sarah,18,0,18,0
1715667114240,EDS 289C,A01,507361,Daly; Alan J.,18,0,18,0
1715667115267,EDS 290,A00,507366,Hofstetter; Carolyn,15,0,15,0
1715667116294,LIGM 5A,A00,507421,Fischer-Grunski; Eva K,17,0,20,3
1715667117319,LIGM 5B,A00,507423,Fischer-Grunski; Eva K,19,0,20,1
1715667118348,LIGM 5C,A00,507425,Fischer-Grunski; Eva K,19,0,20,1
1715667119378,LIIT 5AS,A00,507427,Carnelos; Chiara,20,0,20,0
1715667120406,LIIT 5BS,A00,507430,Carnelos; Chiara,20,0,20,0
1715667121431,LIIT 5CS,A00,507432,Carnelos; Chiara,20,0,20,0
1715667122457,LISP 5A,A00,507541,Munoz Sanchez; Alicia,11,0,20,9
1715667123481,LISP 5B,A00,507671,Munoz Sanchez; Alicia,8,0,20,12
1715667124511,LISP 5C,A00,507696,Munoz Sanchez; Alicia,7,0,20,13
1715667125538,MAE 197,001,528363,Boechler; Nicholas Sebastia,9998,0,9999,1
1715667126573,MATH 197,001,523477,Kedlaya; Kiran S.,9994,0,9999,5
1715667126573,MATH 197,002,563811,Zhang; Danna,9994,0,9999,5
1715667126573,MATH 197,003,628552,Dumitriu; Ioana,9998,0,9999,1
1715667126573,MATH 197,004,660885,Floyd; Eric,9998,0,9999,1
1715667127604,MCWP 40R,A00,518780,Staff,1,0,20,19
1715667127604,MCWP 40R,B00,518781,Carter; Jennifer A,9,0,20,11
1715667127604,MCWP 40R,C00,518783,Smith; Haydee Marie,5,0,20,15
1715667128639,MCWP 50R,A00,518791,Redela; Pamela Morgan,0,1,20,20
1715667128639,MCWP 50R,B00,518792,Krone; Jarret,0,2,20,20
1715667128639,MCWP 50R,C00,518793,Staff,0,4,20,20
1715667128639,MCWP 50R,D00,518794,Morshed; Michael James,0,2,20,20
1715667128639,MCWP 50R,E00,518795,Carter; Andrea L,0,2,20,20
1715667128639,MCWP 50R,F00,518796,Miller; Elizabeth Deen,0,1,20,20
1715667128639,MCWP 50R,G00,518797,Guillen; Melinda,0,1,20,20
1715667129668,MMW 12R,A01,514034,Herbst; Matthew,0,2,16,16
1715667129668,MMW 12R,A02,514035,Herbst; Matthew,0,0,16,16
1715667130694,MMW 13R,A01,514037,Staff,0,5,16,16
1715667130694,MMW 13R,A02,514039,Staff,0,5,16,16
1715667130694,MMW 13R,A03,628519,Staff,0,4,16,16
1715667132753,SIO 295LS,A00,523233,Staff,10,0,30,20
1715667133778,SIO 295S,A00,523232,Staff,10,0,30,20
1715667134804,SIOC 290S,A01,637330,Merrifield; Mark A,21,0,30,9
1715667135834,SIOC 291S,A01,637333,Gabriel; Corey John,21,0,30,9
1715667136860,SOCI 117,A01,494376,Staff,0,5,5,5
1715667137886,WES 237B,A00,494380,Staff,10,0,20,10
1715667139965,AESE 279B,A00,494370,Wade; Jon P,0,0,33,33
1715667140993,AIP 97,001,660915,Van Den Einde; Yael Dahlia,9998,0,9999,1
1715667142027,AIP 197,001,627712,Vespa; Emanuel Ignacio,9995,0,9999,4
1715667142027,AIP 197,002,650778,Amir; On,9998,0,9999,1
1715667142027,AIP 197,003,650933,Avenancio-Leon; Carlos,9998,0,9999,1
1715667142027,AIP 197,004,658530,Heyman; Gail D.,9998,0,9999,1
1715667142027,AIP 197,005,658631,Neal; Sonya E,9998,0,9999,1
1715667142027,AIP 197,006,658671,Du; Songzi,9998,0,9999,1
1715667143053,ANAR 135S,A00,494369,Braswell; Geoffrey E.,0,0,0,0
1715667144078,BENG 196,001,628496,Engler; Adam J.,9998,0,9999,1
1715667144078,BENG 196,002,660916,Watson; John Thomas,9998,0,9999,1
1715667145104,BISP 197,001,650773,Wilhelm; James E.,9994,0,9999,5
1715667145104,BISP 197,002,658904,Coleman; Aaron B.,9998,0,9999,1
1715667146130,CAT 124RS,A01,519847,Geibel; William,0,0,20,20
1715667147159,CAT 125RS,A01,515971,Geibel; William,0,0,20,20
1715667148185,CLRE 250,A00,511389,Morris; Sheldon,9992,0,9999,7
1715667149213,CLRE 251,A00,507176,Mehta; Ravindra L.,9992,0,9999,7
1715667149213,CLRE 251,B00,511410,Mehta; Ravindra L.,9998,0,9999,1
1715667150244,CLRE 252,A00,507189,Cuomo; Raphael Eduardo,9994,0,9999,5
1715667151270,CLRE 253,A00,507199,Vaida; Florin,9994,0,9999,5
1715667151270,CLRE 253,B00,507202,Vaida; Florin,9999,0,9999,0
1715667152295,CLRE 259,A00,507211,Patel; Hemal,9996,0,9999,3
1715667153322,CLRE 260,A00,507221,Cuomo; Raphael Eduardo,9999,0,9999,0
1715667154346,CLRE 297,001,507242,Cuomo; Raphael Eduardo,9999,0,9999,0
1715667155376,COGS 197,001,638244,Voytek; Bradley Thomas,9997,0,9999,2
1715667156400,CSE 191,A00,516875,Minnes Kemp; Mor Mia,9991,0,9999,8
1715667157431,CSE 197,001,637388,Minnes Kemp; Mor Mia,9992,0,9999,7
1715667158462,CSS 201S,A01,494383,Mignozzetti; Umberto,35,0,35,0
1715667159487,CSS 202S,A01,494387,Mignozzetti; Umberto,35,0,35,0
1715667160515,DSC 197,001,628532,Eldridge; Justin Matthew,9995,0,9999,4
1715667161542,EAP 100,A00,516065,Staff,9799,0,9999,200
1715667162568,ECE 45,A01,507414,Staff,32,0,60,28
1715667164626,ECE 111,A01,507420,Staff,11,0,50,39
1715667165650,ECE 197,001,548057,Sievenpiper; Daniel F.,9991,0,9999,8
1715667166676,EDS 115,A00,507243,Choi; Bailey Miyeon,6,0,28,22
1715667167702,EDS 117,A01,494379,Staff,0,6,34,35
1715667168728,EDS 125,A00,507246,Hopkins; Megan Beth,7,0,30,23
1715667169753,EDS 128A,A01,507264,Fargason; Sharon Gayle,5,0,26,21
1715667170777,EDS 128B,A01,507293,Pappas; Elizabeth,9,0,30,21
1715667171806,EDS 139,A00,507294,Fargason; Sharon Gayle,9,0,30,21
1715667171806,EDS 139,B00,507313,Pappas; Elizabeth,9,0,30,21
1715667172831,EDS 201,A00,507315,Staff,10,0,30,20
1715667173857,EDS 203,A01,507317,Halter; Christopher P.,10,0,30,20
1715667174883,EDS 204R,A01,507319,Halter; Christopher P.,0,3,30,30
1715667174883,EDS 204R,B01,507331,Heinzman; Erica M.,14,0,30,16
1715667175908,EDS 206R,A00,507332,Staff,0,4,30,30
1715667175908,EDS 206R,B00,507343,Staff,15,0,30,15
1715667176935,EDS 250,A00,507344,Hemans; Patricia Ann Benitez,20,0,40,20
1715667177963,EDS 281,A00,507345,Daly; Alan J.,18,0,18,0
1715667178988,EDS 284,A00,507350,Daly; Alan J.,16,0,16,0
1715667180015,EDS 286,A00,507359,Fine; Sarah,18,0,18,0
1715667181041,EDS 289C,A01,507361,Daly; Alan J.,18,0,18,0
1715667182072,EDS 290,A00,507366,Hofstetter; Carolyn,15,0,15,0
1715667183205,LIGM 5A,A00,507421,Fischer-Grunski; Eva K,17,0,20,3
1715667184235,LIGM 5B,A00,507423,Fischer-Grunski; Eva K,19,0,20,1
1715667185266,LIGM 5C,A00,507425,Fischer-Grunski; Eva K,19,0,20,1
1715667186297,LIIT 5AS,A00,507427,Carnelos; Chiara,20,0,20,0
1715667187333,LIIT 5BS,A00,507430,Carnelos; Chiara,20,0,20,0
1715667188363,LIIT 5CS,A00,507432,Carnelos; Chiara,20,0,20,0
1715667189397,LISP 5A,A00,507541,Munoz Sanchez; Alicia,11,0,20,9
1715667190424,LISP 5B,A00,507671,Munoz Sanchez; Alicia,8,0,20,12
1715667191450,LISP 5C,A00,507696,Munoz Sanchez; Alicia,7,0,20,13
1715667192479,MAE 197,001,528363,Boechler; Nicholas Sebastia,9998,0,9999,1
1715667193507,MATH 197,001,523477,Kedlaya; Kiran S.,9994,0,9999,5
1715667193507,MATH 197,002,563811,Zhang; Danna,9994,0,9999,5
1715667193507,MATH 197,003,628552,Dumitriu; Ioana,9998,0,9999,1
1715667193507,MATH 197,004,660885,Floyd; Eric,9998,0,9999,1
1715667194535,MCWP 40R,A00,518780,Staff,1,0,20,19
1715667194535,MCWP 40R,B00,518781,Carter; Jennifer A,9,0,20,11
1715667194535,MCWP 40R,C00,518783,Smith; Haydee Marie,5,0,20,15
1715667195566,MCWP 50R,A00,518791,Redela; Pamela Morgan,0,1,20,20
1715667195566,MCWP 50R,B00,518792,Krone; Jarret,0,2,20,20
1715667195566,MCWP 50R,C00,518793,Staff,0,4,20,20
1715667195566,MCWP 50R,D00,518794,Morshed; Michael James,0,2,20,20
1715667195566,MCWP 50R,E00,518795,Carter; Andrea L,0,2,20,20
1715667195566,MCWP 50R,F00,518796,Miller; Elizabeth Deen,0,1,20,20
1715667195566,MCWP 50R,G00,518797,Guillen; Melinda,0,1,20,20
1715667196593,MMW 12R,A01,514034,Herbst; Matthew,0,2,16,16
1715667196593,MMW 12R,A02,514035,Herbst; Matthew,0,0,16,16
1715667197625,MMW 13R,A01,514037,Staff,0,5,16,16
1715667197625,MMW 13R,A02,514039,Staff,0,5,16,16
1715667197625,MMW 13R,A03,628519,Staff,0,4,16,16
1715667199678,SIO 295LS,A00,523233,Staff,10,0,30,20
1715667200706,SIO 295S,A00,523232,Staff,10,0,30,20
1715667201732,SIOC 290S,A01,637330,Merrifield; Mark A,21,0,30,9
1715667202757,SIOC 291S,A01,637333,Gabriel; Corey John,21,0,30,9
1715667203786,SOCI 117,A01,494376,Staff,0,5,5,5
1715667204811,WES 237B,A00,494380,Staff,10,0,20,10
1715667206896,AESE 279B,A00,494370,Wade; Jon P,0,0,33,33
1715667207924,AIP 97,001,660915,Van Den Einde; Yael Dahlia,9998,0,9999,1
1715667208955,AIP 197,001,627712,Vespa; Emanuel Ignacio,9995,0,9999,4
1715667208955,AIP 197,002,650778,Amir; On,9998,0,9999,1
1715667208955,AIP 197,003,650933,Avenancio-Leon; Carlos,9998,0,9999,1
1715667208955,AIP 197,004,658530,Heyman; Gail D.,9998,0,9999,1
1715667208955,AIP 197,005,658631,Neal; Sonya E,9998,0,9999,1
1715667208955,AIP 197,006,658671,Du; Songzi,9998,0,9999,1
1715667209996,ANAR 135S,A00,494369,Braswell; Geoffrey E.,0,0,0,0
1715667211028,BENG 196,001,628496,Engler; Adam J.,9998,0,9999,1
1715667211028,BENG 196,002,660916,Watson; John Thomas,9998,0,9999,1
1715667212058,BISP 197,001,650773,Wilhelm; James E.,9994,0,9999,5
1715667212058,BISP 197,002,658904,Coleman; Aaron B.,9998,0,9999,1
1715667213087,CAT 124RS,A01,519847,Geibel; William,0,0,20,20
1715667214113,CAT 125RS,A01,515971,Geibel; William,0,0,20,20
1715667215143,CLRE 250,A00,511389,Morris; Sheldon,9992,0,9999,7
1715667216178,CLRE 251,A00,507176,Mehta; Ravindra L.,9992,0,9999,7
1715667216178,CLRE 251,B00,511410,Mehta; Ravindra L.,9998,0,9999,1
1715667217207,CLRE 252,A00,507189,Cuomo; Raphael Eduardo,9994,0,9999,5
1715667218238,CLRE 253,A00,507199,Vaida; Florin,9994,0,9999,5
1715667218238,CLRE 253,B00,507202,Vaida; Florin,9999,0,9999,0
1715667219265,CLRE 259,A00,507211,Patel; Hemal,9996,0,9999,3
1715667220290,CLRE 260,A00,507221,Cuomo; Raphael Eduardo,9999,0,9999,0
1715667221317,CLRE 297,001,507242,Cuomo; Raphael Eduardo,9999,0,9999,0
1715667222344,COGS 197,001,638244,Voytek; Bradley Thomas,9997,0,9999,2
1715667223372,CSE 191,A00,516875,Minnes Kemp; Mor Mia,9991,0,9999,8
1715667224400,CSE 197,001,637388,Minnes Kemp; Mor Mia,9992,0,9999,7
1715667225431,CSS 201S,A01,494383,Mignozzetti; Umberto,35,0,35,0
1715667226457,CSS 202S,A01,494387,Mignozzetti; Umberto,35,0,35,0
1715667227480,DSC 197,001,628532,Eldridge; Justin Matthew,9995,0,9999,4
1715667228506,EAP 100,A00,516065,Staff,9799,0,9999,200
1715667229540,ECE 45,A01,507414,Staff,32,0,60,28
1715667231594,ECE 111,A01,507420,Staff,11,0,50,39
1715667232619,ECE 197,001,548057,Sievenpiper; Daniel F.,9991,0,9999,8
1715667233646,EDS 115,A00,507243,Choi; Bailey Miyeon,6,0,28,22
1715667234671,EDS 117,A01,494379,Staff,0,6,34,35
1715667235696,EDS 125,A00,507246,Hopkins; Megan Beth,7,0,30,23
1715667236722,EDS 128A,A01,507264,Fargason; Sharon Gayle,5,0,26,21
1715667237747,EDS 128B,A01,507293,Pappas; Elizabeth,9,0,30,21
1715667238776,EDS 139,A00,507294,Fargason; Sharon Gayle,9,0,30,21
1715667238776,EDS 139,B00,507313,Pappas; Elizabeth,9,0,30,21
1715667239804,EDS 201,A00,507315,Staff,10,0,30,20
1715667240833,EDS 203,A01,507317,Halter; Christopher P.,10,0,30,20
1715667241863,EDS 204R,A01,507319,Halter; Christopher P.,0,3,30,30
1715667241863,EDS 204R,B01,507331,Heinzman; Erica M.,14,0,30,16
1715667242891,EDS 206R,A00,507332,Staff,0,4,30,30
1715667242891,EDS 206R,B00,507343,Staff,15,0,30,15
1715667243922,EDS 250,A00,507344,Hemans; Patricia Ann Benitez,20,0,40,20
1715667244950,EDS 281,A00,507345,Daly; Alan J.,18,0,18,0
1715667245976,EDS 284,A00,507350,Daly; Alan J.,16,0,16,0
1715667247003,EDS 286,A00,507359,Fine; Sarah,18,0,18,0
1715667248028,EDS 289C,A01,507361,Daly; Alan J.,18,0,18,0
1715667249056,EDS 290,A00,507366,Hofstetter; Carolyn,15,0,15,0
1715667250082,LIGM 5A,A00,507421,Fischer-Grunski; Eva K,17,0,20,3
1715667251109,LIGM 5B,A00,507423,Fischer-Grunski; Eva K,19,0,20,1
1715667252133,LIGM 5C,A00,507425,Fischer-Grunski; Eva K,19,0,20,1
1715667253174,LIIT 5AS,A00,507427,Carnelos; Chiara,20,0,20,0
1715667254198,LIIT 5BS,A00,507430,Carnelos; Chiara,20,0,20,0
1715667255227,LIIT 5CS,A00,507432,Carnelos; Chiara,20,0,20,0
1715667256252,LISP 5A,A00,507541,Munoz Sanchez; Alicia,11,0,20,9
1715667257278,LISP 5B,A00,507671,Munoz Sanchez; Alicia,8,0,20,12
1715667258305,LISP 5C,A00,507696,Munoz Sanchez; Alicia,7,0,20,13
1715667259334,MAE 197,001,528363,Boechler; Nicholas Sebastia,9998,0,9999,1
1715667260361,MATH 197,001,523477,Kedlaya; Kiran S.,9994,0,9999,5
1715667260361,MATH 197,002,563811,Zhang; Danna,9994,0,9999,5
1715667260361,MATH 197,003,628552,Dumitriu; Ioana,9998,0,9999,1
1715667260361,MATH 197,004,660885,Floyd; Eric,9998,0,9999,1
1715667261389,MCWP 40R,A00,518780,Staff,1,0,20,19
1715667261389,MCWP 40R,B00,518781,Carter; Jennifer A,9,0,20,11
1715667261389,MCWP 40R,C00,518783,Smith; Haydee Marie,5,0,20,15
1715667262420,MCWP 50R,A00,518791,Redela; Pamela Morgan,0,1,20,20
1715667262420,MCWP 50R,B00,518792,Krone; Jarret,0,2,20,20
1715667262420,MCWP 50R,C00,518793,Staff,0,4,20,20
1715667262420,MCWP 50R,D00,518794,Morshed; Michael James,0,2,20,20
1715667262420,MCWP 50R,E00,518795,Carter; Andrea L,0,2,20,20
1715667262420,MCWP 50R,F00,518796,Miller; Elizabeth Deen,0,1,20,20
1715667262420,MCWP 50R,G00,518797,Guillen; Melinda,0,1,20,20
1715667263446,MMW 12R,A01,514034,Herbst; Matthew,0,2,16,16
1715667263446,MMW 12R,A02,514035,Herbst; Matthew,0,0,16,16
1715667264471,MMW 13R,A01,514037,Staff,0,5,16,16
1715667264471,MMW 13R,A02,514039,Staff,0,5,16,16
1715667264471,MMW 13R,A03,628519,Staff,0,4,16,16
1715667266525,SIO 295LS,A00,523233,Staff,10,0,30,20
1715667267554,SIO 295S,A00,523232,Staff,10,0,30,20
1715667268579,SIOC 290S,A01,637330,Merrifield; Mark A,21,0,30,9
1715667269607,SIOC 291S,A01,637333,Gabriel; Corey John,21,0,30,9
1715667270631,SOCI 117,A01,494376,Staff,0,5,5,5
1715667271654,WES 237B,A00,494380,Staff,10,0,20,10
1715667273718,AESE 279B,A00,494370,Wade; Jon P,0,0,33,33
1715667274745,AIP 97,001,660915,Van Den Einde; Yael Dahlia,9998,0,9999,1
1715667275771,AIP 197,001,627712,Vespa; Emanuel Ignacio,9995,0,9999,4
1715667275771,AIP 197,002,650778,Amir; On,9998,0,9999,1
1715667275771,AIP 197,003,650933,Avenancio-Leon; Carlos,9998,0,9999,1
1715667275771,AIP 197,004,658530,Heyman; Gail D.,9998,0,9999,1
1715667275771,AIP 197,005,658631,Neal; Sonya E,9998,0,9999,1
1715667275771,AIP 197,006,658671,Du; Songzi,9998,0,9999,1
1715667276795,ANAR 135S,A00,494369,Braswell; Geoffrey E.,0,0,0,0
1715667277826,BENG 196,001,628496,Engler; Adam J.,9998,0,9999,1
1715667277826,BENG 196,002,660916,Watson; John Thomas,9998,0,9999,1
1715667278852,BISP 197,001,650773,Wilhelm; James E.,9994,0,9999,5
1715667278852,BISP 197,002,658904,Coleman; Aaron B.,9998,0,9999,1
1715667279877,CAT 124RS,A01,519847,Geibel; William,0,0,20,20
1715667280902,CAT 125RS,A01,515971,Geibel; William,0,0,20,20
1715667281930,CLRE 250,A00,511389,Morris; Sheldon,9992,0,9999,7
1715667282958,CLRE 251,A00,507176,Mehta; Ravindra L.,9992,0,9999,7
1715667282958,CLRE 251,B00,511410,Mehta; Ravindra L.,9998,0,9999,1
1715667283991,CLRE 252,A00,507189,Cuomo; Raphael Eduardo,9994,0,9999,5
1715667285017,CLRE 253,A00,507199,Vaida; Florin,9994,0,9999,5
1715667285017,CLRE 253,B00,507202,Vaida; Florin,9999,0,9999,0
1715667286046,CLRE 259,A00,507211,Patel; Hemal,9996,0,9999,3
1715667287075,CLRE 260,A00,507221,Cuomo; Raphael Eduardo,9999,0,9999,0
1715667288104,CLRE 297,001,507242,Cuomo; Raphael Eduardo,9999,0,9999,0
1715667289192,COGS 197,001,638244,Voytek; Bradley Thomas,9997,0,9999,2
1715667290220,CSE 191,A00,516875,Minnes Kemp; Mor Mia,9991,0,9999,8
1715667291248,CSE 197,001,637388,Minnes Kemp; Mor Mia,9992,0,9999,7
1715667292281,CSS 201S,A01,494383,Mignozzetti; Umberto,35,0,35,0
1715667293305,CSS 202S,A01,494387,Mignozzetti; Umberto,35,0,35,0
1715667294334,DSC 197,001,628532,Eldridge; Justin Matthew,9995,0,9999,4
1715667295361,EAP 100,A00,516065,Staff,9799,0,9999,200
1715667296387,ECE 45,A01,507414,Staff,32,0,60,28
1715667298438,ECE 111,A01,507420,Staff,11,0,50,39
1715667299471,ECE 197,001,548057,Sievenpiper; Daniel F.,9991,0,9999,8
1715667300503,EDS 115,A00,507243,Choi; Bailey Miyeon,6,0,28,22
1715667301529,EDS 117,A01,494379,Staff,0,6,34,35
1715667302555,EDS 125,A00,507246,Hopkins; Megan Beth,7,0,30,23
1715667303583,EDS 128A,A01,507264,Fargason; Sharon Gayle,5,0,26,21
1715667304611,EDS 128B,A01,507293,Pappas; Elizabeth,9,0,30,21
1715667305637,EDS 139,A00,507294,Fargason; Sharon Gayle,9,0,30,21
1715667305637,EDS 139,B00,507313,Pappas; Elizabeth,9,0,30,21
1715667306663,EDS 201,A00,507315,Staff,10,0,30,20
1715667307689,EDS 203,A01,507317,Halter; Christopher P.,10,0,30,20
1715667308722,EDS 204R,A01,507319,Halter; Christopher P.,0,3,30,30
1715667308722,EDS 204R,B01,507331,Heinzman; Erica M.,14,0,30,16
1715667309748,EDS 206R,A00,507332,Staff,0,4,30,30
1715667309748,EDS 206R,B00,507343,Staff,15,0,30,15
1715667310775,EDS 250,A00,507344,Hemans; Patricia Ann Benitez,20,0,40,20
1715667311804,EDS 281,A00,507345,Daly; Alan J.,18,0,18,0
1715667312831,EDS 284,A00,507350,Daly; Alan J.,16,0,16,0
1715667313862,EDS 286,A00,507359,Fine; Sarah,18,0,18,0
1715667314887,EDS 289C,A01,507361,Daly; Alan J.,18,0,18,0
1715667315913,EDS 290,A00,507366,Hofstetter; Carolyn,15,0,15,0
1715667316942,LIGM 5A,A00,507421,Fischer-Grunski; Eva K,17,0,20,3
1715667317972,LIGM 5B,A00,507423,Fischer-Grunski; Eva K,19,0,20,1
1715667319002,LIGM 5C,A00,507425,Fischer-Grunski; Eva K,19,0,20,1
1715667320029,LIIT 5AS,A00,507427,Carnelos; Chiara,20,0,20,0
1715667321055,LIIT 5BS,A00,507430,Carnelos; Chiara,20,0,20,0
1715667322081,LIIT 5CS,A00,507432,Carnelos; Chiara,20,0,20,0
1715667323108,LISP 5A,A00,507541,Munoz Sanchez; Alicia,11,0,20,9
1715667324134,LISP 5B,A00,507671,Munoz Sanchez; Alicia,8,0,20,12
1715667325159,LISP 5C,A00,507696,Munoz Sanchez; Alicia,7,0,20,13
1715667326186,MAE 197,001,528363,Boechler; Nicholas Sebastia,9998,0,9999,1
1715667327215,MATH 197,001,523477,Kedlaya; Kiran S.,9994,0,9999,5
1715667327215,MATH 197,002,563811,Zhang; Danna,9994,0,9999,5
1715667327215,MATH 197,003,628552,Dumitriu; Ioana,9998,0,9999,1
1715667327215,MATH 197,004,660885,Floyd; Eric,9998,0,9999,1
1715667328242,MCWP 40R,A00,518780,Staff,1,0,20,19
1715667328242,MCWP 40R,B00,518781,Carter; Jennifer A,9,0,20,11
1715667328242,MCWP 40R,C00,518783,Smith; Haydee Marie,5,0,20,15
1715667329271,MCWP 50R,A00,518791,Redela; Pamela Morgan,0,1,20,20
1715667329271,MCWP 50R,B00,518792,Krone; Jarret,0,2,20,20
1715667329271,MCWP 50R,C00,518793,Staff,0,4,20,20
1715667329271,MCWP 50R,D00,518794,Morshed; Michael James,0,2,20,20
1715667329271,MCWP 50R,E00,518795,Carter; Andrea L,0,2,20,20
1715667329271,MCWP 50R,F00,518796,Miller; Elizabeth Deen,0,1,20,20
1715667329271,MCWP 50R,G00,518797,Guillen; Melinda,0,1,20,20
1715667330300,MMW 12R,A01,514034,Herbst; Matthew,0,2,16,16
1715667330300,MMW 12R,A02,514035,Herbst; Matthew,0,0,16,16
1715667331325,MMW 13R,A01,514037,Staff,0,5,16,16
1715667331325,MMW 13R,A02,514039,Staff,0,5,16,16
1715667331325,MMW 13R,A03,628519,Staff,0,4,16,16
1715667333379,SIO 295LS,A00,523233,Staff,10,0,30,20
1715667334408,SIO 295S,A00,523232,Staff,10,0,30,20
1715667335435,SIOC 290S,A01,637330,Merrifield; Mark A,21,0,30,9
1715667336461,SIOC 291S,A01,637333,Gabriel; Corey John,21,0,30,9
1715667337486,SOCI 117,A01,494376,Staff,0,5,5,5
1715667338512,WES 237B,A00,494380,Staff,10,0,20,10
1715667340587,AESE 279B,A00,494370,Wade; Jon P,0,0,33,33
1715667341614,AIP 97,001,660915,Van Den Einde; Yael Dahlia,9998,0,9999,1
1715667342645,AIP 197,001,627712,Vespa; Emanuel Ignacio,9995,0,9999,4
1715667342645,AIP 197,002,650778,Amir; On,9998,0,9999,1
1715667342645,AIP 197,003,650933,Avenancio-Leon; Carlos,9998,0,9999,1
1715667342645,AIP 197,004,658530,Heyman; Gail D.,9998,0,9999,1
1715667342645,AIP 197,005,658631,Neal; Sonya E,9998,0,9999,1
1715667342645,AIP 197,006,658671,Du; Songzi,9998,0,9999,1
1715667343670,ANAR 135S,A00,494369,Braswell; Geoffrey E.,0,0,0,0
1715667344700,BENG 196,001,628496,Engler; Adam J.,9998,0,9999,1
1715667344700,BENG 196,002,660916,Watson; John Thomas,9998,0,9999,1
1715667345727,BISP 197,001,650773,Wilhelm; James E.,9994,0,9999,5
1715667345727,BISP 197,002,658904,Coleman; Aaron B.,9998,0,9999,1
1715667346762,CAT 124RS,A01,519847,Geibel; William,0,0,20,20
1715667347787,CAT 125RS,A01,515971,Geibel; William,0,0,20,20
1715667348813,CLRE 250,A00,511389,Morris; Sheldon,9992,0,9999,7
1715667349846,CLRE 251,A00,507176,Mehta; Ravindra L.,9992,0,9999,7
1715667349846,CLRE 251,B00,511410,Mehta; Ravindra L.,9998,0,9999,1
1715667350872,CLRE 252,A00,507189,Cuomo; Raphael Eduardo,9994,0,9999,5
1715667351899,CLRE 253,A00,507199,Vaida; Florin,9994,0,9999,5
1715667351899,CLRE 253,B00,507202,Vaida; Florin,9999,0,9999,0
1715667352928,CLRE 259,A00,507211,Patel; Hemal,9996,0,9999,3
1715667353953,CLRE 260,A00,507221,Cuomo; Raphael Eduardo,9999,0,9999,0
1715667354981,CLRE 297,001,507242,Cuomo; Raphael Eduardo,9999,0,9999,0
1715667356008,COGS 197,001,638244,Voytek; Bradley Thomas,9997,0,9999,2
1715667357034,CSE 191,A00,516875,Minnes Kemp; Mor Mia,9991,0,9999,8
1715667358069,CSE 197,001,637388,Minnes Kemp; Mor Mia,9992,0,9999,7
1715667359098,CSS 201S,A01,494383,Mignozzetti; Umberto,35,0,35,0
1715667360125,CSS 202S,A01,494387,Mignozzetti; Umberto,35,0,35,0
1715667361154,DSC 197,001,628532,Eldridge; Justin Matthew,9995,0,9999,4
1715667362182,EAP 100,A00,516065,Staff,9799,0,9999,200
1715667363209,ECE 45,A01,507414,Staff,32,0,60,28
1715667365259,ECE 111,A01,507420,Staff,11,0,50,39
1715667366288,ECE 197,001,548057,Sievenpiper; Daniel F.,9991,0,9999,8
1715667367316,EDS 115,A00,507243,Choi; Bailey Miyeon,6,0,28,22
1715667368343,EDS 117,A01,494379,Staff,0,6,34,35
1715667369371,EDS 125,A00,507246,Hopkins; Megan Beth,7,0,30,23
1715667370398,EDS 128A,A01,507264,Fargason; Sharon Gayle,5,0,26,21
1715667371431,EDS 128B,A01,507293,Pappas; Elizabeth,9,0,30,21
1715667372455,EDS 139,A00,507294,Fargason; Sharon Gayle,9,0,30,21
1715667372455,EDS 139,B00,507313,Pappas; Elizabeth,9,0,30,21
1715667373480,EDS 201,A00,507315,Staff,10,0,30,20
1715667374507,EDS 203,A01,507317,Halter; Christopher P.,10,0,30,20
1715667375533,EDS 204R,A01,507319,Halter; Christopher P.,0,3,30,30
1715667375533,EDS 204R,B01,507331,Heinzman; Erica M.,14,0,30,16
1715667376559,EDS 206R,A00,507332,Staff,0,4,30,30
1715667376559,EDS 206R,B00,507343,Staff,15,0,30,15
1715667377584,EDS 250,A00,507344,Hemans; Patricia Ann Benitez,20,0,40,20
1715667378610,EDS 281,A00,507345,Daly; Alan J.,18,0,18,0
1715667379637,EDS 284,A00,507350,Daly; Alan J.,16,0,16,0
1715667380663,EDS 286,A00,507359,Fine; Sarah,18,0,18,0
1715667381688,EDS 289C,A01,507361,Daly; Alan J.,18,0,18,0
1715667382717,EDS 290,A00,507366,Hofstetter; Carolyn,15,0,15,0
1715667383742,LIGM 5A,A00,507421,Fischer-Grunski; Eva K,17,0,20,3
1715667384769,LIGM 5B,A00,507423,Fischer-Grunski; Eva K,19,0,20,1
1715667385793,LIGM 5C,A00,507425,Fischer-Grunski; Eva K,19,0,20,1
1715667386822,LIIT 5AS,A00,507427,Carnelos; Chiara,20,0,20,0
1715667387851,LIIT 5BS,A00,507430,Carnelos; Chiara,20,0,20,0
1715667388880,LIIT 5CS,A00,507432,Carnelos; Chiara,20,0,20,0
1715667389910,LISP 5A,A00,507541,Munoz Sanchez; Alicia,11,0,20,9
1715667390937,LISP 5B,A00,507671,Munoz Sanchez; Alicia,8,0,20,12
1715667391966,LISP 5C,A00,507696,Munoz Sanchez; Alicia,7,0,20,13
1715667392993,MAE 197,001,528363,Boechler; Nicholas Sebastia,9998,0,9999,1
1715667394021,MATH 197,001,523477,Kedlaya; Kiran S.,9994,0,9999,5
1715667394021,MATH 197,002,563811,Zhang; Danna,9994,0,9999,5
1715667394021,MATH 197,003,628552,Dumitriu; Ioana,9998,0,9999,1
1715667394021,MATH 197,004,660885,Floyd; Eric,9998,0,9999,1
1715667395048,MCWP 40R,A00,518780,Staff,1,0,20,19
1715667395048,MCWP 40R,B00,518781,Carter; Jennifer A,9,0,20,11
1715667395048,MCWP 40R,C00,518783,Smith; Haydee Marie,5,0,20,15
1715667396082,MCWP 50R,A00,518791,Redela; Pamela Morgan,0,1,20,20
1715667396082,MCWP 50R,B00,518792,Krone; Jarret,0,2,20,20
1715667396082,MCWP 50R,C00,518793,Staff,0,4,20,20
1715667396082,MCWP 50R,D00,518794,Morshed; Michael James,0,2,20,20
1715667396082,MCWP 50R,E00,518795,Carter; Andrea L,0,2,20,20
1715667396082,MCWP 50R,F00,518796,Miller; Elizabeth Deen,0,1,20,20
1715667396082,MCWP 50R,G00,518797,Guillen; Melinda,0,1,20,20
1715667397107,MMW 12R,A01,514034,Herbst; Matthew,0,2,16,16
1715667397107,MMW 12R,A02,514035,Herbst; Matthew,0,0,16,16
1715667398133,MMW 13R,A01,514037,Staff,0,5,16,16
1715667398133,MMW 13R,A02,514039,Staff,0,5,16,16
1715667398133,MMW 13R,A03,628519,Staff,0,4,16,16
1715667400184,SIO 295LS,A00,523233,Staff,10,0,30,20
1715667401208,SIO 295S,A00,523232,Staff,10,0,30,20
1715667402243,SIOC 290S,A01,637330,Merrifield; Mark A,21,0,30,9
1715667403269,SIOC 291S,A01,637333,Gabriel; Corey John,21,0,30,9
1715667404295,SOCI 117,A01,494376,Staff,0,5,5,5
1715667405320,WES 237B,A00,494380,Staff,10,0,20,10
1715667407394,AESE 279B,A00,494370,Wade; Jon P,0,0,33,33
1715667408418,AIP 97,001,660915,Van Den Einde; Yael Dahlia,9998,0,9999,1
1715667409446,AIP 197,001,627712,Vespa; Emanuel Ignacio,9995,0,9999,4
1715667409446,AIP 197,002,650778,Amir; On,9998,0,9999,1
1715667409446,AIP 197,003,650933,Avenancio-Leon; Carlos,9998,0,9999,1
1715667409446,AIP 197,004,658530,Heyman; Gail D.,9998,0,9999,1
1715667409446,AIP 197,005,658631,Neal; Sonya E,9998,0,9999,1
1715667409446,AIP 197,006,658671,Du; Songzi,9998,0,9999,1
1715667410470,ANAR 135S,A00,494369,Braswell; Geoffrey E.,0,0,0,0
1715667411495,BENG 196,001,628496,Engler; Adam J.,9998,0,9999,1
1715667411495,BENG 196,002,660916,Watson; John Thomas,9998,0,9999,1
1715667412525,BISP 197,001,650773,Wilhelm; James E.,9994,0,9999,5
1715667412525,BISP 197,002,658904,Coleman; Aaron B.,9998,0,9999,1
1715667413549,CAT 124RS,A01,519847,Geibel; William,0,0,20,20
1715667414577,CAT 125RS,A01,515971,Geibel; William,0,0,20,20
1715667415604,CLRE 250,A00,511389,Morris; Sheldon,9992,0,9999,7
1715667416639,CLRE 251,A00,507176,Mehta; Ravindra L.,9992,0,9999,7
1715667416639,CLRE 251,B00,511410,Mehta; Ravindra L.,9998,0,9999,1
1715667417665,CLRE 252,A00,507189,Cuomo; Raphael Eduardo,9994,0,9999,5
1715667418691,CLRE 253,A00,507199,Vaida; Florin,9994,0,9999,5
1715667418691,CLRE 253,B00,507202,Vaida; Florin,9999,0,9999,0
1715667419716,CLRE 259,A00,507211,Patel; Hemal,9996,0,9999,3
1715667420747,CLRE 260,A00,507221,Cuomo; Raphael Eduardo,9999,0,9999,0
1715667421774,CLRE 297,001,507242,Cuomo; Raphael Eduardo,9999,0,9999,0
1715667422801,COGS 197,001,638244,Voytek; Bradley Thomas,9997,0,9999,2
1715667423828,CSE 191,A00,516875,Minnes Kemp; Mor Mia,9991,0,9999,8
1715667424858,CSE 197,001,637388,Minnes Kemp; Mor Mia,9992,0,9999,7
1715667425889,CSS 201S,A01,494383,Mignozzetti; Umberto,35,0,35,0
1715667426918,CSS 202S,A01,494387,Mignozzetti; Umberto,35,0,35,0
1715667427943,DSC 197,001,628532,Eldridge; Justin Matthew,9995,0,9999,4
1715667428970,EAP 100,A00,516065,Staff,9799,0,9999,200
1715667430003,ECE 45,A01,507414,Staff,32,0,60,28
1715667432062,ECE 111,A01,507420,Staff,11,0,50,39
1715667433098,ECE 197,001,548057,Sievenpiper; Daniel F.,9991,0,9999,8
1715667434125,EDS 115,A00,507243,Choi; Bailey Miyeon,6,0,28,22
1715667435155,EDS 117,A01,494379,Staff,0,6,34,35
1715667436185,EDS 125,A00,507246,Hopkins; Megan Beth,7,0,30,23
1715667437211,EDS 128A,A01,507264,Fargason; Sharon Gayle,5,0,26,21
1715667438236,EDS 128B,A01,507293,Pappas; Elizabeth,9,0,30,21
1715667439267,EDS 139,A00,507294,Fargason; Sharon Gayle,9,0,30,21
1715667439267,EDS 139,B00,507313,Pappas; Elizabeth,9,0,30,21
1715667440293,EDS 201,A00,507315,Staff,10,0,30,20
1715667441317,EDS 203,A01,507317,Halter; Christopher P.,10,0,30,20
1715667442342,EDS 204R,A01,507319,Halter; Christopher P.,0,3,30,30
1715667442342,EDS 204R,B01,507331,Heinzman; Erica M.,14,0,30,16
1715667443372,EDS 206R,A00,507332,Staff,0,4,30,30
1715667443372,EDS 206R,B00,507343,Staff,15,0,30,15
1715667444401,EDS 250,A00,507344,Hemans; Patricia Ann Benitez,20,0,40,20
1715667445425,EDS 281,A00,507345,Daly; Alan J.,18,0,18,0
1715667446449,EDS 284,A00,507350,Daly; Alan J.,16,0,16,0
1715667447479,EDS 286,A00,507359,Fine; Sarah,18,0,18,0
1715667448508,EDS 289C,A01,507361,Daly; Alan J.,18,0,18,0
1715667449537,EDS 290,A00,507366,Hofstetter; Carolyn,15,0,15,0
1715667450569,LIGM 5A,A00,507421,Fischer-Grunski; Eva K,17,0,20,3
1715667451593,LIGM 5B,A00,507423,Fischer-Grunski; Eva K,19,0,20,1
1715667452622,LIGM 5C,A00,507425,Fischer-Grunski; Eva K,19,0,20,1
1715667453648,LIIT 5AS,A00,507427,Carnelos; Chiara,20,0,20,0
1715667454677,LIIT 5BS,A00,507430,Carnelos; Chiara,20,0,20,0
1715667455707,LIIT 5CS,A00,507432,Carnelos; Chiara,20,0,20,0
1715667456733,LISP 5A,A00,507541,Munoz Sanchez; Alicia,11,0,20,9
1715667457758,LISP 5B,A00,507671,Munoz Sanchez; Alicia,8,0,20,12
1715667458785,LISP 5C,A00,507696,Munoz Sanchez; Alicia,7,0,20,13
1715667459813,MAE 197,001,528363,Boechler; Nicholas Sebastia,9998,0,9999,1
1715667460846,MATH 197,001,523477,Kedlaya; Kiran S.,9994,0,9999,5
1715667460846,MATH 197,002,563811,Zhang; Danna,9994,0,9999,5
1715667460846,MATH 197,003,628552,Dumitriu; Ioana,9998,0,9999,1
1715667460846,MATH 197,004,660885,Floyd; Eric,9998,0,9999,1
1715667461878,MCWP 40R,A00,518780,Staff,1,0,20,19
1715667461878,MCWP 40R,B00,518781,Carter; Jennifer A,9,0,20,11
1715667461878,MCWP 40R,C00,518783,Smith; Haydee Marie,5,0,20,15
1715667462910,MCWP 50R,A00,518791,Redela; Pamela Morgan,0,1,20,20
1715667462910,MCWP 50R,B00,518792,Krone; Jarret,0,2,20,20
1715667462910,MCWP 50R,C00,518793,Staff,0,4,20,20
1715667462910,MCWP 50R,D00,518794,Morshed; Michael James,0,2,20,20
1715667462910,MCWP 50R,E00,518795,Carter; Andrea L,0,2,20,20
1715667462910,MCWP 50R,F00,518796,Miller; Elizabeth Deen,0,1,20,20
1715667462910,MCWP 50R,G00,518797,Guillen; Melinda,0,1,20,20
1715667463935,MMW 12R,A01,514034,Herbst; Matthew,0,2,16,16
1715667463935,MMW 12R,A02,514035,Herbst; Matthew,0,0,16,16
1715667464961,MMW 13R,A01,514037,Staff,0,5,16,16
1715667464961,MMW 13R,A02,514039,Staff,0,5,16,16
1715667464961,MMW 13R,A03,628519,Staff,0,4,16,16
1715667467012,SIO 295LS,A00,523233,Staff,10,0,30,20
1715667468037,SIO 295S,A00,523232,Staff,10,0,30,20
1715667469064,SIOC 290S,A01,637330,Merrifield; Mark A,21,0,30,9
1715667470095,SIOC 291S,A01,637333,Gabriel; Corey John,21,0,30,9
1715667471124,SOCI 117,A01,494376,Staff,0,5,5,5
1715667472150,WES 237B,A00,494380,Staff,10,0,20,10
1715667474218,AESE 279B,A00,494370,Wade; Jon P,0,0,33,33
1715667475245,AIP 97,001,660915,Van Den Einde; Yael Dahlia,9998,0,9999,1
1715667476277,AIP 197,001,627712,Vespa; Emanuel Ignacio,9995,0,9999,4
1715667476277,AIP 197,002,650778,Amir; On,9998,0,9999,1
1715667476277,AIP 197,003,650933,Avenancio-Leon; Carlos,9998,0,9999,1
1715667476277,AIP 197,004,658530,Heyman; Gail D.,9998,0,9999,1
1715667476277,AIP 197,005,658631,Neal; Sonya E,9998,0,9999,1
1715667476277,AIP 197,006,658671,Du; Songzi,9998,0,9999,1
1715667477307,ANAR 135S,A00,494369,Braswell; Geoffrey E.,0,0,0,0
1715667478337,BENG 196,001,628496,Engler; Adam J.,9998,0,9999,1
1715667478337,BENG 196,002,660916,Watson; John Thomas,9998,0,9999,1
1715667479362,BISP 197,001,650773,Wilhelm; James E.,9994,0,9999,5
1715667479362,BISP 197,002,658904,Coleman; Aaron B.,9998,0,9999,1
1715667480397,CAT 124RS,A01,519847,Geibel; William,0,0,20,20
1715667481422,CAT 125RS,A01,515971,Geibel; William,0,0,20,20
1715667482447,CLRE 250,A00,511389,Morris; Sheldon,9992,0,9999,7
1715667483478,CLRE 251,A00,507176,Mehta; Ravindra L.,9992,0,9999,7
1715667483478,CLRE 251,B00,511410,Mehta; Ravindra L.,9998,0,9999,1
1715667484504,CLRE 252,A00,507189,Cuomo; Raphael Eduardo,9994,0,9999,5
1715667485529,CLRE 253,A00,507199,Vaida; Florin,9994,0,9999,5
1715667485529,CLRE 253,B00,507202,Vaida; Florin,9999,0,9999,0
1715667486553,CLRE 259,A00,507211,Patel; Hemal,9996,0,9999,3
1715667487581,CLRE 260,A00,507221,Cuomo; Raphael Eduardo,9999,0,9999,0
1715667488607,CLRE 297,001,507242,Cuomo; Raphael Eduardo,9999,0,9999,0
1715667489635,COGS 197,001,638244,Voytek; Bradley Thomas,9997,0,9999,2
1715667490662,CSE 191,A00,516875,Minnes Kemp; Mor Mia,9991,0,9999,8
1715667491690,CSE 197,001,637388,Minnes Kemp; Mor Mia,9992,0,9999,7
1715667492716,CSS 201S,A01,494383,Mignozzetti; Umberto,35,0,35,0
1715667493741,CSS 202S,A01,494387,Mignozzetti; Umberto,35,0,35,0
1715667494769,DSC 197,001,628532,Eldridge; Justin Matthew,9995,0,9999,4
1715667495794,EAP 100,A00,516065,Staff,9799,0,9999,200
1715667496819,ECE 45,A01,507414,Staff,32,0,60,28
1715667498872,ECE 111,A01,507420,Staff,11,0,50,39
1715667499896,ECE 197,001,548057,Sievenpiper; Daniel F.,9991,0,9999,8
1715667500921,EDS 115,A00,507243,Choi; Bailey Miyeon,6,0,28,22
1715667501947,EDS 117,A01,494379,Staff,0,6,34,35
1715667502977,EDS 125,A00,507246,Hopkins; Megan Beth,7,0,30,23
1715667504003,EDS 128A,A01,507264,Fargason; Sharon Gayle,5,0,26,21
1715667505030,EDS 128B,A01,507293,Pappas; Elizabeth,9,0,30,21
1715667506057,EDS 139,A00,507294,Fargason; Sharon Gayle,9,0,30,21
1715667506057,EDS 139,B00,507313,Pappas; Elizabeth,9,0,30,21
1715667507082,EDS 201,A00,507315,Staff,10,0,30,20
1715667508108,EDS 203,A01,507317,Halter; Christopher P.,10,0,30,20
1715667509134,EDS 204R,A01,507319,Halter; Christopher P.,0,3,30,30
1715667509134,EDS 204R,B01,507331,Heinzman; Erica M.,14,0,30,16
1715667510162,EDS 206R,A00,507332,Staff,0,4,30,30
1715667510162,EDS 206R,B00,507343,Staff,15,0,30,15
1715667511188,EDS 250,A00,507344,Hemans; Patricia Ann Benitez,20,0,40,20
1715667512216,EDS 281,A00,507345,Daly; Alan J.,18,0,18,0
1715667513242,EDS 284,A00,507350,Daly; Alan J.,16,0,16,0
1715667514268,EDS 286,A00,507359,Fine; Sarah,18,0,18,0
1715667515296,EDS 289C,A01,507361,Daly; Alan J.,18,0,18,0
1715667516324,EDS 290,A00,507366,Hofstetter; Carolyn,15,0,15,0
1715667517350,LIGM 5A,A00,507421,Fischer-Grunski; Eva K,17,0,20,3
1715667518378,LIGM 5B,A00,507423,Fischer-Grunski; Eva K,19,0,20,1
1715667519404,LIGM 5C,A00,507425,Fischer-Grunski; Eva K,19,0,20,1
1715667520432,LIIT 5AS,A00,507427,Carnelos; Chiara,20,0,20,0
1715667521459,LIIT 5BS,A00,507430,Carnelos; Chiara,20,0,20,0
1715667522485,LIIT 5CS,A00,507432,Carnelos; Chiara,20,0,20,0
1715667523511,LISP 5A,A00,507541,Munoz Sanchez; Alicia,11,0,20,9
1715667524539,LISP 5B,A00,507671,Munoz Sanchez; Alicia,8,0,20,12
1715667525565,LISP 5C,A00,507696,Munoz Sanchez; Alicia,7,0,20,13
1715667526589,MAE 197,001,528363,Boechler; Nicholas Sebastia,9998,0,9999,1
1715667527623,MATH 197,001,523477,Kedlaya; Kiran S.,9994,0,9999,5
1715667527623,MATH 197,002,563811,Zhang; Danna,9994,0,9999,5
1715667527623,MATH 197,003,628552,Dumitriu; Ioana,9998,0,9999,1
1715667527623,MATH 197,004,660885,Floyd; Eric,9998,0,9999,1
1715667528650,MCWP 40R,A00,518780,Staff,1,0,20,19
1715667528650,MCWP 40R,B00,518781,Carter; Jennifer A,9,0,20,11
1715667528650,MCWP 40R,C00,518783,Smith; Haydee Marie,5,0,20,15
1715667529683,MCWP 50R,A00,518791,Redela; Pamela Morgan,0,1,20,20
1715667529683,MCWP 50R,B00,518792,Krone; Jarret,0,2,20,20
1715667529683,MCWP 50R,C00,518793,Staff,0,4,20,20
1715667529683,MCWP 50R,D00,518794,Morshed; Michael James,0,2,20,20
1715667529683,MCWP 50R,E00,518795,Carter; Andrea L,0,2,20,20
1715667529683,MCWP 50R,F00,518796,Miller; Elizabeth Deen,0,1,20,20
1715667529683,MCWP 50R,G00,518797,Guillen; Melinda,0,1,20,20
1715667530712,MMW 12R,A01,514034,Herbst; Matthew,0,2,16,16
1715667530712,MMW 12R,A02,514035,Herbst; Matthew,0,0,16,16
1715667531740,MMW 13R,A01,514037,Staff,0,5,16,16
1715667531740,MMW 13R,A02,514039,Staff,0,5,16,16
1715667531740,MMW 13R,A03,628519,Staff,0,4,16,16
1715667533794,SIO 295LS,A00,523233,Staff,10,0,30,20
1715667534822,SIO 295S,A00,523232,Staff,10,0,30,20
1715667535849,SIOC 290S,A01,637330,Merrifield; Mark A,21,0,30,9
1715667536879,SIOC 291S,A01,637333,Gabriel; Corey John,21,0,30,9
1715667537907,SOCI 117,A01,494376,Staff,0,5,5,5
1715667538931,WES 237B,A00,494380,Staff,10,0,20,10
1715667541007,AESE 279B,A00,494370,Wade; Jon P,0,0,33,33
1715667542037,AIP 97,001,660915,Van Den Einde; Yael Dahlia,9998,0,9999,1
1715667543067,AIP 197,001,627712,Vespa; Emanuel Ignacio,9995,0,9999,4
1715667543067,AIP 197,002,650778,Amir; On,9998,0,9999,1
1715667543067,AIP 197,003,650933,Avenancio-Leon; Carlos,9998,0,9999,1
1715667543067,AIP 197,004,658530,Heyman; Gail D.,9998,0,9999,1
1715667543067,AIP 197,005,658631,Neal; Sonya E,9998,0,9999,1
1715667543067,AIP 197,006,658671,Du; Songzi,9998,0,9999,1
1715667544098,ANAR 135S,A00,494369,Braswell; Geoffrey E.,0,0,0,0
1715667545125,BENG 196,001,628496,Engler; Adam J.,9998,0,9999,1
1715667545125,BENG 196,002,660916,Watson; John Thomas,9998,0,9999,1
1715667546154,BISP 197,001,650773,Wilhelm; James E.,9994,0,9999,5
1715667546154,BISP 197,002,658904,Coleman; Aaron B.,9998,0,9999,1
1715667547180,CAT 124RS,A01,519847,Geibel; William,0,0,20,20
1715667548206,CAT 125RS,A01,515971,Geibel; William,0,0,20,20
1715667549233,CLRE 250,A00,511389,Morris; Sheldon,9992,0,9999,7
1715667550265,CLRE 251,A00,507176,Mehta; Ravindra L.,9992,0,9999,7
1715667550265,CLRE 251,B00,511410,Mehta; Ravindra L.,9998,0,9999,1
1715667551292,CLRE 252,A00,507189,Cuomo; Raphael Eduardo,9994,0,9999,5
1715667552317,CLRE 253,A00,507199,Vaida; Florin,9994,0,9999,5
1715667552317,CLRE 253,B00,507202,Vaida; Florin,9999,0,9999,0
1715667553342,CLRE 259,A00,507211,Patel; Hemal,9996,0,9999,3
1715667554370,CLRE 260,A00,507221,Cuomo; Raphael Eduardo,9999,0,9999,0
1715667555394,CLRE 297,001,507242,Cuomo; Raphael Eduardo,9999,0,9999,0
1715667556418,COGS 197,001,638244,Voytek; Bradley Thomas,9997,0,9999,2
1715667557449,CSE 191,A00,516875,Minnes Kemp; Mor Mia,9991,0,9999,8
1715667558478,CSE 197,001,637388,Minnes Kemp; Mor Mia,9992,0,9999,7
1715667559504,CSS 201S,A01,494383,Mignozzetti; Umberto,35,0,35,0
1715667560530,CSS 202S,A01,494387,Mignozzetti; Umberto,35,0,35,0
1715667561559,DSC 197,001,628532,Eldridge; Justin Matthew,9995,0,9999,4
1715667562586,EAP 100,A00,516065,Staff,9799,0,9999,200
1715667563614,ECE 45,A01,507414,Staff,32,0,60,28
1715667565664,ECE 111,A01,507420,Staff,11,0,50,39
1715667566692,ECE 197,001,548057,Sievenpiper; Daniel F.,9991,0,9999,8
1715667567718,EDS 115,A00,507243,Choi; Bailey Miyeon,6,0,28,22
1715667568745,EDS 117,A01,494379,Staff,0,6,34,35
1715667569775,EDS 125,A00,507246,Hopkins; Megan Beth,7,0,30,23
1715667570801,EDS 128A,A01,507264,Fargason; Sharon Gayle,5,0,26,21
1715667571826,EDS 128B,A01,507293,Pappas; Elizabeth,9,0,30,21
1715667572850,EDS 139,A00,507294,Fargason; Sharon Gayle,9,0,30,21
1715667572850,EDS 139,B00,507313,Pappas; Elizabeth,9,0,30,21
1715667573880,EDS 201,A00,507315,Staff,10,0,30,20
1715667574911,EDS 203,A01,507317,Halter; Christopher P.,10,0,30,20
1715667575940,EDS 204R,A01,507319,Halter; Christopher P.,0,3,30,30
1715667575940,EDS 204R,B01,507331,Heinzman; Erica M.,14,0,30,16
1715667576969,EDS 206R,A00,507332,Staff,0,4,30,30
1715667576969,EDS 206R,B00,507343,Staff,15,0,30,15
1715667577993,EDS 250,A00,507344,Hemans; Patricia Ann Benitez,20,0,40,20
1715667579021,EDS 281,A00,507345,Daly; Alan J.,18,0,18,0
1715667580046,EDS 284,A00,507350,Daly; Alan J.,16,0,16,0
1715667581097,EDS 286,A00,507359,Fine; Sarah,18,0,18,0
1715667582123,EDS 289C,A01,507361,Daly; Alan J.,18,0,18,0
1715667583148,EDS 290,A00,507366,Hofstetter; Carolyn,15,0,15,0
1715667584174,LIGM 5A,A00,507421,Fischer-Grunski; Eva K,17,0,20,3
1715667585204,LIGM 5B,A00,507423,Fischer-Grunski; Eva K,19,0,20,1
1715667586230,LIGM 5C,A00,507425,Fischer-Grunski; Eva K,19,0,20,1
1715667587255,LIIT 5AS,A00,507427,Carnelos; Chiara,20,0,20,0
1715667588287,LIIT 5BS,A00,507430,Carnelos; Chiara,20,0,20,0
1715667589313,LIIT 5CS,A00,507432,Carnelos; Chiara,20,0,20,0
1715667590339,LISP 5A,A00,507541,Munoz Sanchez; Alicia,11,0,20,9
1715667591364,LISP 5B,A00,507671,Munoz Sanchez; Alicia,8,0,20,12
1715667592394,LISP 5C,A00,507696,Munoz Sanchez; Alicia,7,0,20,13
1715667593418,MAE 197,001,528363,Boechler; Nicholas Sebastia,9998,0,9999,1
1715667594450,MATH 197,001,523477,Kedlaya; Kiran S.,9994,0,9999,5
1715667594450,MATH 197,002,563811,Zhang; Danna,9994,0,9999,5
1715667594450,MATH 197,003,628552,Dumitriu; Ioana,9998,0,9999,1
1715667594450,MATH 197,004,660885,Floyd; Eric,9998,0,9999,1
1715667595477,MCWP 40R,A00,518780,Staff,1,0,20,19
1715667595477,MCWP 40R,B00,518781,Carter; Jennifer A,9,0,20,11
1715667595477,MCWP 40R,C00,518783,Smith; Haydee Marie,5,0,20,15
1715667596516,MCWP 50R,A00,518791,Redela; Pamela Morgan,0,1,20,20
1715667596516,MCWP 50R,B00,518792,Krone; Jarret,0,2,20,20
1715667596516,MCWP 50R,C00,518793,Staff,0,4,20,20
1715667596516,MCWP 50R,D00,518794,Morshed; Michael James,0,2,20,20
1715667596516,MCWP 50R,E00,518795,Carter; Andrea L,0,2,20,20
1715667596516,MCWP 50R,F00,518796,Miller; Elizabeth Deen,0,1,20,20
1715667596516,MCWP 50R,G00,518797,Guillen; Melinda,0,1,20,20
1715667597542,MMW 12R,A01,514034,Herbst; Matthew,0,2,16,16
1715667597542,MMW 12R,A02,514035,Herbst; Matthew,0,0,16,16
1715667598567,MMW 13R,A01,514037,Staff,0,5,16,16
1715667598567,MMW 13R,A02,514039,Staff,0,5,16,16
1715667598567,MMW 13R,A03,628519,Staff,0,4,16,16
1715667600617,SIO 295LS,A00,523233,Staff,10,0,30,20
1715667601647,SIO 295S,A00,523232,Staff,10,0,30,20
1715667602678,SIOC 290S,A01,637330,Merrifield; Mark A,21,0,30,9
1715667603704,SIOC 291S,A01,637333,Gabriel; Corey John,21,0,30,9
1715667604731,SOCI 117,A01,494376,Staff,0,5,5,5
1715667605759,WES 237B,A00,494380,Staff,10,0,20,10
1715667607830,AESE 279B,A00,494370,Wade; Jon P,0,0,33,33
1715667608855,AIP 97,001,660915,Van Den Einde; Yael Dahlia,9998,0,9999,1
1715667609889,AIP 197,001,627712,Vespa; Emanuel Ignacio,9995,0,9999,4
1715667609889,AIP 197,002,650778,Amir; On,9998,0,9999,1
1715667609889,AIP 197,003,650933,Avenancio-Leon; Carlos,9998,0,9999,1
1715667609889,AIP 197,004,658530,Heyman; Gail D.,9998,0,9999,1
1715667609889,AIP 197,005,658631,Neal; Sonya E,9998,0,9999,1
1715667609889,AIP 197,006,658671,Du; Songzi,9998,0,9999,1
1715667610917,ANAR 135S,A00,494369,Braswell; Geoffrey E.,0,0,0,0
1715667611943,BENG 196,001,628496,Engler; Adam J.,9998,0,9999,1
1715667611943,BENG 196,002,660916,Watson; John Thomas,9998,0,9999,1
1715667612969,BISP 197,001,650773,Wilhelm; James E.,9994,0,9999,5
1715667612969,BISP 197,002,658904,Coleman; Aaron B.,9998,0,9999,1
1715667613993,CAT 124RS,A01,519847,Geibel; William,0,0,20,20
1715667615021,CAT 125RS,A01,515971,Geibel; William,0,0,20,20
1715667616044,CLRE 250,A00,511389,Morris; Sheldon,9992,0,9999,7
1715667617071,CLRE 251,A00,507176,Mehta; Ravindra L.,9992,0,9999,7
1715667617071,CLRE 251,B00,511410,Mehta; Ravindra L.,9998,0,9999,1
1715667618100,CLRE 252,A00,507189,Cuomo; Raphael Eduardo,9994,0,9999,5
1715667619127,CLRE 253,A00,507199,Vaida; Florin,9994,0,9999,5
1715667619127,CLRE 253,B00,507202,Vaida; Florin,9999,0,9999,0
1715667620158,CLRE 259,A00,507211,Patel; Hemal,9996,0,9999,3
1715667621240,CLRE 260,A00,507221,Cuomo; Raphael Eduardo,9999,0,9999,0
1715667622265,CLRE 297,001,507242,Cuomo; Raphael Eduardo,9999,0,9999,0
1715667623290,COGS 197,001,638244,Voytek; Bradley Thomas,9997,0,9999,2
1715667624316,CSE 191,A00,516875,Minnes Kemp; Mor Mia,9991,0,9999,8
1715667625343,CSE 197,001,637388,Minnes Kemp; Mor Mia,9992,0,9999,7
1715667626374,CSS 201S,A01,494383,Mignozzetti; Umberto,35,0,35,0
1715667627399,CSS 202S,A01,494387,Mignozzetti; Umberto,35,0,35,0
1715667628426,DSC 197,001,628532,Eldridge; Justin Matthew,9995,0,9999,4
1715667629451,EAP 100,A00,516065,Staff,9799,0,9999,200
1715667630481,ECE 45,A01,507414,Staff,32,0,60,28
1715667632530,ECE 111,A01,507420,Staff,11,0,50,39
1715667633557,ECE 197,001,548057,Sievenpiper; Daniel F.,9991,0,9999,8
1715667634583,EDS 115,A00,507243,Choi; Bailey Miyeon,6,0,28,22
1715667635607,EDS 117,A01,494379,Staff,0,6,34,35
1715667636636,EDS 125,A00,507246,Hopkins; Megan Beth,7,0,30,23
1715667637661,EDS 128A,A01,507264,Fargason; Sharon Gayle,5,0,26,21
1715667638685,EDS 128B,A01,507293,Pappas; Elizabeth,9,0,30,21
1715667639709,EDS 139,A00,507294,Fargason; Sharon Gayle,9,0,30,21
1715667639709,EDS 139,B00,507313,Pappas; Elizabeth,9,0,30,21
1715667640736,EDS 201,A00,507315,Staff,10,0,30,20
1715667641765,EDS 203,A01,507317,Halter; Christopher P.,10,0,30,20
1715667642796,EDS 204R,A01,507319,Halter; Christopher P.,0,3,30,30
1715667642796,EDS 204R,B01,507331,Heinzman; Erica M.,14,0,30,16
1715667643821,EDS 206R,A00,507332,Staff,0,4,30,30
1715667643821,EDS 206R,B00,507343,Staff,15,0,30,15
1715667644849,EDS 250,A00,507344,Hemans; Patricia Ann Benitez,20,0,40,20
1715667645875,EDS 281,A00,507345,Daly; Alan J.,18,0,18,0
1715667646903,EDS 284,A00,507350,Daly; Alan J.,16,0,16,0
1715667647932,EDS 286,A00,507359,Fine; Sarah,18,0,18,0
1715667648959,EDS 289C,A01,507361,Daly; Alan J.,18,0,18,0
1715667649997,EDS 290,A00,507366,Hofstetter; Carolyn,15,0,15,0
1715667651029,LIGM 5A,A00,507421,Fischer-Grunski; Eva K,17,0,20,3
1715667652055,LIGM 5B,A00,507423,Fischer-Grunski; Eva K,19,0,20,1
1715667653080,LIGM 5C,A00,507425,Fischer-Grunski; Eva K,19,0,20,1
1715667654109,LIIT 5AS,A00,507427,Carnelos; Chiara,20,0,20,0
1715667655135,LIIT 5BS,A00,507430,Carnelos; Chiara,20,0,20,0
1715667656176,LIIT 5CS,A00,507432,Carnelos; Chiara,20,0,20,0
1715667657202,LISP 5A,A00,507541,Munoz Sanchez; Alicia,11,0,20,9
1715667658228,LISP 5B,A00,507671,Munoz Sanchez; Alicia,8,0,20,12
1715667659254,LISP 5C,A00,507696,Munoz Sanchez; Alicia,7,0,20,13
1715667660285,MAE 197,001,528363,Boechler; Nicholas Sebastia,9998,0,9999,1
1715667661319,MATH 197,001,523477,Kedlaya; Kiran S.,9994,0,9999,5
1715667661319,MATH 197,002,563811,Zhang; Danna,9994,0,9999,5
1715667661319,MATH 197,003,628552,Dumitriu; Ioana,9998,0,9999,1
1715667661319,MATH 197,004,660885,Floyd; Eric,9998,0,9999,1
1715667662349,MCWP 40R,A00,518780,Staff,1,0,20,19
1715667662349,MCWP 40R,B00,518781,Carter; Jennifer A,9,0,20,11
1715667662349,MCWP 40R,C00,518783,Smith; Haydee Marie,5,0,20,15
1715667663376,MCWP 50R,A00,518791,Redela; Pamela Morgan,0,1,20,20
1715667663376,MCWP 50R,B00,518792,Krone; Jarret,0,2,20,20
1715667663376,MCWP 50R,C00,518793,Staff,0,4,20,20
1715667663376,MCWP 50R,D00,518794,Morshed; Michael James,0,2,20,20
1715667663376,MCWP 50R,E00,518795,Carter; Andrea L,0,2,20,20
1715667663376,MCWP 50R,F00,518796,Miller; Elizabeth Deen,0,1,20,20
1715667663376,MCWP 50R,G00,518797,Guillen; Melinda,0,1,20,20
1715667664402,MMW 12R,A01,514034,Herbst; Matthew,0,2,16,16
1715667664402,MMW 12R,A02,514035,Herbst; Matthew,0,0,16,16
1715667665428,MMW 13R,A01,514037,Staff,0,5,16,16
1715667665428,MMW 13R,A02,514039,Staff,0,5,16,16
1715667665428,MMW 13R,A03,628519,Staff,0,4,16,16
1715667667477,SIO 295LS,A00,523233,Staff,10,0,30,20
1715667668506,SIO 295S,A00,523232,Staff,10,0,30,20
1715667669534,SIOC 290S,A01,637330,Merrifield; Mark A,21,0,30,9
1715667670565,SIOC 291S,A01,637333,Gabriel; Corey John,21,0,30,9
1715667671595,SOCI 117,A01,494376,Staff,0,5,5,5
1715667672625,WES 237B,A00,494380,Staff,10,0,20,10
1715667674697,AESE 279B,A00,494370,Wade; Jon P,0,0,33,33
1715667675722,AIP 97,001,660915,Van Den Einde; Yael Dahlia,9998,0,9999,1
1715667676750,AIP 197,001,627712,Vespa; Emanuel Ignacio,9995,0,9999,4
1715667676750,AIP 197,002,650778,Amir; On,9998,0,9999,1
1715667676750,AIP 197,003,650933,Avenancio-Leon; Carlos,9998,0,9999,1
1715667676750,AIP 197,004,658530,Heyman; Gail D.,9998,0,9999,1
1715667676750,AIP 197,005,658631,Neal; Sonya E,9998,0,9999,1
1715667676750,AIP 197,006,658671,Du; Songzi,9998,0,9999,1
1715667677777,ANAR 135S,A00,494369,Braswell; Geoffrey E.,0,0,0,0
1715667678805,BENG 196,001,628496,Engler; Adam J.,9998,0,9999,1
1715667678805,BENG 196,002,660916,Watson; John Thomas,9998,0,9999,1
1715667679837,BISP 197,001,650773,Wilhelm; James E.,9994,0,9999,5
1715667679837,BISP 197,002,658904,Coleman; Aaron B.,9998,0,9999,1
1715667680866,CAT 124RS,A01,519847,Geibel; William,0,0,20,20
1715667681890,CAT 125RS,A01,515971,Geibel; William,0,0,20,20
1715667682915,CLRE 250,A00,511389,Morris; Sheldon,9992,0,9999,7
1715667683948,CLRE 251,A00,507176,Mehta; Ravindra L.,9992,0,9999,7
1715667683948,CLRE 251,B00,511410,Mehta; Ravindra L.,9998,0,9999,1
1715667684974,CLRE 252,A00,507189,Cuomo; Raphael Eduardo,9994,0,9999,5
1715667686002,CLRE 253,A00,507199,Vaida; Florin,9994,0,9999,5
1715667686002,CLRE 253,B00,507202,Vaida; Florin,9999,0,9999,0
1715667687027,CLRE 259,A00,507211,Patel; Hemal,9996,0,9999,3
1715667688053,CLRE 260,A00,507221,Cuomo; Raphael Eduardo,9999,0,9999,0
1715667689081,CLRE 297,001,507242,Cuomo; Raphael Eduardo,9999,0,9999,0
1715667690111,COGS 197,001,638244,Voytek; Bradley Thomas,9997,0,9999,2
1715667691139,CSE 191,A00,516875,Minnes Kemp; Mor Mia,9991,0,9999,8
1715667692176,CSE 197,001,637388,Minnes Kemp; Mor Mia,9992,0,9999,7
1715667693206,CSS 201S,A01,494383,Mignozzetti; Umberto,35,0,35,0
1715667694239,CSS 202S,A01,494387,Mignozzetti; Umberto,35,0,35,0
1715667695268,DSC 197,001,628532,Eldridge; Justin Matthew,9995,0,9999,4
1715667696297,EAP 100,A00,516065,Staff,9799,0,9999,200
1715667697330,ECE 45,A01,507414,Staff,32,0,60,28
1715667699385,ECE 111,A01,507420,Staff,11,0,50,39
1715667700411,ECE 197,001,548057,Sievenpiper; Daniel F.,9991,0,9999,8
1715667701440,EDS 115,A00,507243,Choi; Bailey Miyeon,6,0,28,22
1715667702465,EDS 117,A01,494379,Staff,0,6,34,35
1715667703492,EDS 125,A00,507246,Hopkins; Megan Beth,7,0,30,23
1715667704517,EDS 128A,A01,507264,Fargason; Sharon Gayle,5,0,26,21
1715667705548,EDS 128B,A01,507293,Pappas; Elizabeth,9,0,30,21
1715667706574,EDS 139,A00,507294,Fargason; Sharon Gayle,9,0,30,21
1715667706574,EDS 139,B00,507313,Pappas; Elizabeth,9,0,30,21
1715667707599,EDS 201,A00,507315,Staff,10,0,30,20
1715667708623,EDS 203,A01,507317,Halter; Christopher P.,10,0,30,20
1715667709659,EDS 204R,A01,507319,Halter; Christopher P.,0,3,30,30
1715667709659,EDS 204R,B01,507331,Heinzman; Erica M.,14,0,30,16
1715667710687,EDS 206R,A00,507332,Staff,0,4,30,30
1715667710687,EDS 206R,B00,507343,Staff,15,0,30,15
1715667711716,EDS 250,A00,507344,Hemans; Patricia Ann Benitez,20,0,40,20
1715667712741,EDS 281,A00,507345,Daly; Alan J.,18,0,18,0
1715667713768,EDS 284,A00,507350,Daly; Alan J.,16,0,16,0
1715667714794,EDS 286,A00,507359,Fine; Sarah,18,0,18,0
1715667715822,EDS 289C,A01,507361,Daly; Alan J.,18,0,18,0
1715667716851,EDS 290,A00,507366,Hofstetter; Carolyn,15,0,15,0
1715667717878,LIGM 5A,A00,507421,Fischer-Grunski; Eva K,17,0,20,3
1715667718906,LIGM 5B,A00,507423,Fischer-Grunski; Eva K,19,0,20,1
1715667719931,LIGM 5C,A00,507425,Fischer-Grunski; Eva K,19,0,20,1
1715667720956,LIIT 5AS,A00,507427,Carnelos; Chiara,20,0,20,0
1715667721986,LIIT 5BS,A00,507430,Carnelos; Chiara,20,0,20,0
1715667723016,LIIT 5CS,A00,507432,Carnelos; Chiara,20,0,20,0
1715667724047,LISP 5A,A00,507541,Munoz Sanchez; Alicia,11,0,20,9
1715667725072,LISP 5B,A00,507671,Munoz Sanchez; Alicia,8,0,20,12
1715667726101,LISP 5C,A00,507696,Munoz Sanchez; Alicia,7,0,20,13
1715667727131,MAE 197,001,528363,Boechler; Nicholas Sebastia,9998,0,9999,1
1715667728166,MATH 197,001,523477,Kedlaya; Kiran S.,9994,0,9999,5
1715667728166,MATH 197,002,563811,Zhang; Danna,9994,0,9999,5
1715667728166,MATH 197,003,628552,Dumitriu; Ioana,9998,0,9999,1
1715667728166,MATH 197,004,660885,Floyd; Eric,9998,0,9999,1
1715667729198,MCWP 40R,A00,518780,Staff,1,0,20,19
1715667729198,MCWP 40R,B00,518781,Carter; Jennifer A,9,0,20,11
1715667729198,MCWP 40R,C00,518783,Smith; Haydee Marie,5,0,20,15
1715667730227,MCWP 50R,A00,518791,Redela; Pamela Morgan,0,1,20,20
1715667730227,MCWP 50R,B00,518792,Krone; Jarret,0,2,20,20
1715667730227,MCWP 50R,C00,518793,Staff,0,4,20,20
1715667730227,MCWP 50R,D00,518794,Morshed; Michael James,0,2,20,20
1715667730227,MCWP 50R,E00,518795,Carter; Andrea L,0,2,20,20
1715667730227,MCWP 50R,F00,518796,Miller; Elizabeth Deen,0,1,20,20
1715667730227,MCWP 50R,G00,518797,Guillen; Melinda,0,1,20,20
1715667731252,MMW 12R,A01,514034,Herbst; Matthew,0,2,16,16
1715667731252,MMW 12R,A02,514035,Herbst; Matthew,0,0,16,16
1715667732282,MMW 13R,A01,514037,Staff,0,5,16,16
1715667732282,MMW 13R,A02,514039,Staff,0,5,16,16
1715667732282,MMW 13R,A03,628519,Staff,0,4,16,16
1715667734336,SIO 295LS,A00,523233,Staff,10,0,30,20
1715667735364,SIO 295S,A00,523232,Staff,10,0,30,20
1715667736393,SIOC 290S,A01,637330,Merrifield; Mark A,21,0,30,9
1715667737419,SIOC 291S,A01,637333,Gabriel; Corey John,21,0,30,9
1715667738443,SOCI 117,A01,494376,Staff,0,5,5,5
1715667739467,WES 237B,A00,494380,Staff,10,0,20,10
1715667741546,AESE 279B,A00,494370,Wade; Jon P,0,0,33,33
1715667742572,AIP 97,001,660915,Van Den Einde; Yael Dahlia,9998,0,9999,1
1715667743610,AIP 197,001,627712,Vespa; Emanuel Ignacio,9995,0,9999,4
1715667743610,AIP 197,002,650778,Amir; On,9998,0,9999,1
1715667743610,AIP 197,003,650933,Avenancio-Leon; Carlos,9998,0,9999,1
1715667743610,AIP 197,004,658530,Heyman; Gail D.,9998,0,9999,1
1715667743610,AIP 197,005,658631,Neal; Sonya E,9998,0,9999,1
1715667743610,AIP 197,006,658671,Du; Songzi,9998,0,9999,1
1715667744638,ANAR 135S,A00,494369,Braswell; Geoffrey E.,0,0,0,0
1715667745663,BENG 196,001,628496,Engler; Adam J.,9998,0,9999,1
1715667745663,BENG 196,002,660916,Watson; John Thomas,9998,0,9999,1
1715667746688,BISP 197,001,650773,Wilhelm; James E.,9994,0,9999,5
1715667746688,BISP 197,002,658904,Coleman; Aaron B.,9998,0,9999,1
1715667747718,CAT 124RS,A01,519847,Geibel; William,0,0,20,20
1715667748747,CAT 125RS,A01,515971,Geibel; William,0,0,20,20
1715667749774,CLRE 250,A00,511389,Morris; Sheldon,9992,0,9999,7
1715667750801,CLRE 251,A00,507176,Mehta; Ravindra L.,9992,0,9999,7
1715667750801,CLRE 251,B00,511410,Mehta; Ravindra L.,9998,0,9999,1
1715667751828,CLRE 252,A00,507189,Cuomo; Raphael Eduardo,9994,0,9999,5
1715667752857,CLRE 253,A00,507199,Vaida; Florin,9994,0,9999,5
1715667752857,CLRE 253,B00,507202,Vaida; Florin,9999,0,9999,0
1715667753881,CLRE 259,A00,507211,Patel; Hemal,9996,0,9999,3
1715667754908,CLRE 260,A00,507221,Cuomo; Raphael Eduardo,9999,0,9999,0
1715667755934,CLRE 297,001,507242,Cuomo; Raphael Eduardo,9999,0,9999,0
1715667756964,COGS 197,001,638244,Voytek; Bradley Thomas,9997,0,9999,2
1715667757988,CSE 191,A00,516875,Minnes Kemp; Mor Mia,9991,0,9999,8
1715667759016,CSE 197,001,637388,Minnes Kemp; Mor Mia,9992,0,9999,7
1715667760041,CSS 201S,A01,494383,Mignozzetti; Umberto,35,0,35,0
1715667761065,CSS 202S,A01,494387,Mignozzetti; Umberto,35,0,35,0
1715667762092,DSC 197,001,628532,Eldridge; Justin Matthew,9995,0,9999,4
1715667763116,EAP 100,A00,516065,Staff,9799,0,9999,200
1715667764148,ECE 45,A01,507414,Staff,32,0,60,28
1715667766199,ECE 111,A01,507420,Staff,11,0,50,39
1715667767225,ECE 197,001,548057,Sievenpiper; Daniel F.,9991,0,9999,8
1715667768255,EDS 115,A00,507243,Choi; Bailey Miyeon,6,0,28,22
1715667769283,EDS 117,A01,494379,Staff,0,6,34,35
1715667770311,EDS 125,A00,507246,Hopkins; Megan Beth,7,0,30,23
1715667771337,EDS 128A,A01,507264,Fargason; Sharon Gayle,5,0,26,21
1715667772365,EDS 128B,A01,507293,Pappas; Elizabeth,9,0,30,21
1715667773391,EDS 139,A00,507294,Fargason; Sharon Gayle,9,0,30,21
1715667773391,EDS 139,B00,507313,Pappas; Elizabeth,9,0,30,21
1715667774418,EDS 201,A00,507315,Staff,10,0,30,20
1715667775442,EDS 203,A01,507317,Halter; Christopher P.,10,0,30,20
1715667776475,EDS 204R,A01,507319,Halter; Christopher P.,0,3,30,30
1715667776475,EDS 204R,B01,507331,Heinzman; Erica M.,14,0,30,16
1715667777508,EDS 206R,A00,507332,Staff,0,4,30,30
1715667777508,EDS 206R,B00,507343,Staff,15,0,30,15
1715667778538,EDS 250,A00,507344,Hemans; Patricia Ann Benitez,20,0,40,20
1715667779574,EDS 281,A00,507345,Daly; Alan J.,18,0,18,0
1715667780600,EDS 284,A00,507350,Daly; Alan J.,16,0,16,0
1715667781632,EDS 286,A00,507359,Fine; Sarah,18,0,18,0
1715667782659,EDS 289C,A01,507361,Daly; Alan J.,18,0,18,0
1715667783703,EDS 290,A00,507366,Hofstetter; Carolyn,15,0,15,0
1715667784735,LIGM 5A,A00,507421,Fischer-Grunski; Eva K,17,0,20,3
1715667785774,LIGM 5B,A00,507423,Fischer-Grunski; Eva K,19,0,20,1
1715667786800,LIGM 5C,A00,507425,Fischer-Grunski; Eva K,19,0,20,1
1715667787827,LIIT 5AS,A00,507427,Carnelos; Chiara,20,0,20,0
1715667788855,LIIT 5BS,A00,507430,Carnelos; Chiara,20,0,20,0
1715667789880,LIIT 5CS,A00,507432,Carnelos; Chiara,20,0,20,0
1715667790907,LISP 5A,A00,507541,Munoz Sanchez; Alicia,11,0,20,9
1715667791933,LISP 5B,A00,507671,Munoz Sanchez; Alicia,8,0,20,12
1715667792959,LISP 5C,A00,507696,Munoz Sanchez; Alicia,7,0,20,13
1715667793991,MAE 197,001,528363,Boechler; Nicholas Sebastia,9998,0,9999,1
1715667795041,MATH 197,001,523477,Kedlaya; Kiran S.,9994,0,9999,5
1715667795041,MATH 197,002,563811,Zhang; Danna,9994,0,9999,5
1715667795041,MATH 197,003,628552,Dumitriu; Ioana,9998,0,9999,1
1715667795041,MATH 197,004,660885,Floyd; Eric,9998,0,9999,1
1715667796069,MCWP 40R,A00,518780,Staff,1,0,20,19
1715667796069,MCWP 40R,B00,518781,Carter; Jennifer A,9,0,20,11
1715667796069,MCWP 40R,C00,518783,Smith; Haydee Marie,5,0,20,15
1715667797099,MCWP 50R,A00,518791,Redela; Pamela Morgan,0,1,20,20
1715667797099,MCWP 50R,B00,518792,Krone; Jarret,0,2,20,20
1715667797099,MCWP 50R,C00,518793,Staff,0,4,20,20
1715667797099,MCWP 50R,D00,518794,Morshed; Michael James,0,2,20,20
1715667797099,MCWP 50R,E00,518795,Carter; Andrea L,0,2,20,20
1715667797099,MCWP 50R,F00,518796,Miller; Elizabeth Deen,0,1,20,20
1715667797099,MCWP 50R,G00,518797,Guillen; Melinda,0,1,20,20
1715667798123,MMW 12R,A01,514034,Herbst; Matthew,0,2,16,16
1715667798123,MMW 12R,A02,514035,Herbst; Matthew,0,0,16,16
1715667799147,MMW 13R,A01,514037,Staff,0,5,16,16
1715667799147,MMW 13R,A02,514039,Staff,0,5,16,16
1715667799147,MMW 13R,A03,628519,Staff,0,4,16,16
1715667801201,SIO 295LS,A00,523233,Staff,10,0,30,20
1715667802230,SIO 295S,A00,523232,Staff,10,0,30,20
1715667803261,SIOC 290S,A01,637330,Merrifield; Mark A,21,0,30,9
1715667804289,SIOC 291S,A01,637333,Gabriel; Corey John,21,0,30,9
1715667805315,SOCI 117,A01,494376,Staff,0,5,5,5
1715667806343,WES 237B,A00,494380,Staff,10,0,20,10
1715667808414,AESE 279B,A00,494370,Wade; Jon P,0,0,33,33
1715667809440,AIP 97,001,660915,Van Den Einde; Yael Dahlia,9998,0,9999,1
1715667810469,AIP 197,001,627712,Vespa; Emanuel Ignacio,9995,0,9999,4
1715667810469,AIP 197,002,650778,Amir; On,9998,0,9999,1
1715667810469,AIP 197,003,650933,Avenancio-Leon; Carlos,9998,0,9999,1
1715667810469,AIP 197,004,658530,Heyman; Gail D.,9998,0,9999,1
1715667810469,AIP 197,005,658631,Neal; Sonya E,9998,0,9999,1
1715667810469,AIP 197,006,658671,Du; Songzi,9998,0,9999,1
1715667811495,ANAR 135S,A00,494369,Braswell; Geoffrey E.,0,0,0,0
1715667812521,BENG 196,001,628496,Engler; Adam J.,9998,0,9999,1
1715667812521,BENG 196,002,660916,Watson; John Thomas,9998,0,9999,1
1715667813548,BISP 197,001,650773,Wilhelm; James E.,9994,0,9999,5
1715667813548,BISP 197,002,658904,Coleman; Aaron B.,9998,0,9999,1
1715667814574,CAT 124RS,A01,519847,Geibel; William,0,0,20,20
1715667815599,CAT 125RS,A01,515971,Geibel; William,0,0,20,20
1715667816624,CLRE 250,A00,511389,Morris; Sheldon,9992,0,9999,7
1715667817650,CLRE 251,A00,507176,Mehta; Ravindra L.,9992,0,9999,7
1715667817650,CLRE 251,B00,511410,Mehta; Ravindra L.,9998,0,9999,1
1715667818680,CLRE 252,A00,507189,Cuomo; Raphael Eduardo,9994,0,9999,5
1715667819708,CLRE 253,A00,507199,Vaida; Florin,9994,0,9999,5
1715667819708,CLRE 253,B00,507202,Vaida; Florin,9999,0,9999,0
1715667820733,CLRE 259,A00,507211,Patel; Hemal,9996,0,9999,3
1715667821759,CLRE 260,A00,507221,Cuomo; Raphael Eduardo,9999,0,9999,0
1715667822792,CLRE 297,001,507242,Cuomo; Raphael Eduardo,9999,0,9999,0
1715667823819,COGS 197,001,638244,Voytek; Bradley Thomas,9997,0,9999,2
1715667824846,CSE 191,A00,516875,Minnes Kemp; Mor Mia,9991,0,9999,8
1715667825873,CSE 197,001,637388,Minnes Kemp; Mor Mia,9992,0,9999,7
1715667826902,CSS 201S,A01,494383,Mignozzetti; Umberto,35,0,35,0
1715667827934,CSS 202S,A01,494387,Mignozzetti; Umberto,35,0,35,0
1715667828960,DSC 197,001,628532,Eldridge; Justin Matthew,9995,0,9999,4
1715667829985,EAP 100,A00,516065,Staff,9799,0,9999,200
1715667831023,ECE 45,A01,507414,Staff,32,0,60,28
1715667833080,ECE 111,A01,507420,Staff,11,0,50,39
1715667834106,ECE 197,001,548057,Sievenpiper; Daniel F.,9991,0,9999,8
1715667835134,EDS 115,A00,507243,Choi; Bailey Miyeon,6,0,28,22
1715667836170,EDS 117,A01,494379,Staff,0,6,34,35
1715667837197,EDS 125,A00,507246,Hopkins; Megan Beth,7,0,30,23
1715667838232,EDS 128A,A01,507264,Fargason; Sharon Gayle,5,0,26,21
1715667839258,EDS 128B,A01,507293,Pappas; Elizabeth,9,0,30,21
1715667840292,EDS 139,A00,507294,Fargason; Sharon Gayle,9,0,30,21
1715667840292,EDS 139,B00,507313,Pappas; Elizabeth,9,0,30,21
1715667841318,EDS 201,A00,507315,Staff,10,0,30,20
1715667842350,EDS 203,A01,507317,Halter; Christopher P.,10,0,30,20
1715667843378,EDS 204R,A01,507319,Halter; Christopher P.,0,3,30,30
1715667843378,EDS 204R,B01,507331,Heinzman; Erica M.,14,0,30,16
1715667844407,EDS 206R,A00,507332,Staff,0,4,30,30
1715667844407,EDS 206R,B00,507343,Staff,15,0,30,15
1715667845434,EDS 250,A00,507344,Hemans; Patricia Ann Benitez,20,0,40,20
1715667846467,EDS 281,A00,507345,Daly; Alan J.,18,0,18,0
1715667847493,EDS 284,A00,507350,Daly; Alan J.,16,0,16,0
1715667848519,EDS 286,A00,507359,Fine; Sarah,18,0,18,0
1715667849548,EDS 289C,A01,507361,Daly; Alan J.,18,0,18,0
1715667850574,EDS 290,A00,507366,Hofstetter; Carolyn,15,0,15,0
1715667851605,LIGM 5A,A00,507421,Fischer-Grunski; Eva K,17,0,20,3
1715667852633,LIGM 5B,A00,507423,Fischer-Grunski; Eva K,19,0,20,1
1715667853667,LIGM 5C,A00,507425,Fischer-Grunski; Eva K,19,0,20,1
1715667854701,LIIT 5AS,A00,507427,Carnelos; Chiara,20,0,20,0
1715667855731,LIIT 5BS,A00,507430,Carnelos; Chiara,20,0,20,0
1715667856758,LIIT 5CS,A00,507432,Carnelos; Chiara,20,0,20,0
1715667857800,LISP 5A,A00,507541,Munoz Sanchez; Alicia,11,0,20,9
1715667858830,LISP 5B,A00,507671,Munoz Sanchez; Alicia,8,0,20,12
1715667859870,LISP 5C,A00,507696,Munoz Sanchez; Alicia,7,0,20,13
1715667860896,MAE 197,001,528363,Boechler; Nicholas Sebastia,9998,0,9999,1
1715667861935,MATH 197,001,523477,Kedlaya; Kiran S.,9994,0,9999,5
1715667861935,MATH 197,002,563811,Zhang; Danna,9994,0,9999,5
1715667861935,MATH 197,003,628552,Dumitriu; Ioana,9998,0,9999,1
1715667861935,MATH 197,004,660885,Floyd; Eric,9998,0,9999,1
1715667862960,MCWP 40R,A00,518780,Staff,1,0,20,19
1715667862960,MCWP 40R,B00,518781,Carter; Jennifer A,9,0,20,11
1715667862960,MCWP 40R,C00,518783,Smith; Haydee Marie,5,0,20,15
1715667863985,MCWP 50R,A00,518791,Redela; Pamela Morgan,0,1,20,20
1715667863985,MCWP 50R,B00,518792,Krone; Jarret,0,2,20,20
1715667863985,MCWP 50R,C00,518793,Staff,0,4,20,20
1715667863985,MCWP 50R,D00,518794,Morshed; Michael James,0,2,20,20
1715667863985,MCWP 50R,E00,518795,Carter; Andrea L,0,2,20,20
1715667863985,MCWP 50R,F00,518796,Miller; Elizabeth Deen,0,1,20,20
1715667863985,MCWP 50R,G00,518797,Guillen; Melinda,0,1,20,20
1715667865010,MMW 12R,A01,514034,Herbst; Matthew,0,2,16,16
1715667865010,MMW 12R,A02,514035,Herbst; Matthew,0,0,16,16
1715667866042,MMW 13R,A01,514037,Staff,0,5,16,16
1715667866042,MMW 13R,A02,514039,Staff,0,5,16,16
1715667866042,MMW 13R,A03,628519,Staff,0,4,16,16
1715667868095,SIO 295LS,A00,523233,Staff,10,0,30,20
1715667869121,SIO 295S,A00,523232,Staff,10,0,30,20
1715667870148,SIOC 290S,A01,637330,Merrifield; Mark A,21,0,30,9
1715667871177,SIOC 291S,A01,637333,Gabriel; Corey John,21,0,30,9
1715667872215,SOCI 117,A01,494376,Staff,0,5,5,5
1715667873240,WES 237B,A00,494380,Staff,10,0,20,10
1715667875307,AESE 279B,A00,494370,Wade; Jon P,0,0,33,33
1715667876332,AIP 97,001,660915,Van Den Einde; Yael Dahlia,9998,0,9999,1
1715667877367,AIP 197,001,627712,Vespa; Emanuel Ignacio,9995,0,9999,4
1715667877367,AIP 197,002,650778,Amir; On,9998,0,9999,1
1715667877367,AIP 197,003,650933,Avenancio-Leon; Carlos,9998,0,9999,1
1715667877367,AIP 197,004,658530,Heyman; Gail D.,9998,0,9999,1
1715667877367,AIP 197,005,658631,Neal; Sonya E,9998,0,9999,1
1715667877367,AIP 197,006,658671,Du; Songzi,9998,0,9999,1
1715667878393,ANAR 135S,A00,494369,Braswell; Geoffrey E.,0,0,0,0
1715667879428,BENG 196,001,628496,Engler; Adam J.,9998,0,9999,1
1715667879428,BENG 196,002,660916,Watson; John Thomas,9998,0,9999,1
1715667880452,BISP 197,001,650773,Wilhelm; James E.,9994,0,9999,5
1715667880452,BISP 197,002,658904,Coleman; Aaron B.,9998,0,9999,1
1715667881483,CAT 124RS,A01,519847,Geibel; William,0,0,20,20
1715667882513,CAT 125RS,A01,515971,Geibel; William,0,0,20,20
1715667883543,CLRE 250,A00,511389,Morris; Sheldon,9992,0,9999,7
1715667884577,CLRE 251,A00,507176,Mehta; Ravindra L.,9992,0,9999,7
1715667884577,CLRE 251,B00,511410,Mehta; Ravindra L.,9998,0,9999,1
1715667885603,CLRE 252,A00,507189,Cuomo; Raphael Eduardo,9994,0,9999,5
1715667886632,CLRE 253,A00,507199,Vaida; Florin,9994,0,9999,5
1715667886632,CLRE 253,B00,507202,Vaida; Florin,9999,0,9999,0
1715667887660,CLRE 259,A00,507211,Patel; Hemal,9996,0,9999,3
1715667888686,CLRE 260,A00,507221,Cuomo; Raphael Eduardo,9999,0,9999,0
1715667889712,CLRE 297,001,507242,Cuomo; Raphael Eduardo,9999,0,9999,0
1715667890743,COGS 197,001,638244,Voytek; Bradley Thomas,9997,0,9999,2
1715667891769,CSE 191,A00,516875,Minnes Kemp; Mor Mia,9991,0,9999,8
1715667892795,CSE 197,001,637388,Minnes Kemp; Mor Mia,9992,0,9999,7
1715667893825,CSS 201S,A01,494383,Mignozzetti; Umberto,35,0,35,0
1715667894850,CSS 202S,A01,494387,Mignozzetti; Umberto,35,0,35,0
1715667895874,DSC 197,001,628532,Eldridge; Justin Matthew,9995,0,9999,4
1715667896901,EAP 100,A00,516065,Staff,9799,0,9999,200
1715667897935,ECE 45,A01,507414,Staff,32,0,60,28
1715667899986,ECE 111,A01,507420,Staff,11,0,50,39
1715667901014,ECE 197,001,548057,Sievenpiper; Daniel F.,9991,0,9999,8
1715667902046,EDS 115,A00,507243,Choi; Bailey Miyeon,6,0,28,22
1715667903078,EDS 117,A01,494379,Staff,0,6,34,35
1715667904101,EDS 125,A00,507246,Hopkins; Megan Beth,7,0,30,23
1715667905127,EDS 128A,A01,507264,Fargason; Sharon Gayle,5,0,26,21
1715667906153,EDS 128B,A01,507293,Pappas; Elizabeth,9,0,30,21
1715667907180,EDS 139,A00,507294,Fargason; Sharon Gayle,9,0,30,21
1715667907180,EDS 139,B00,507313,Pappas; Elizabeth,9,0,30,21
1715667908208,EDS 201,A00,507315,Staff,10,0,30,20
1715667909234,EDS 203,A01,507317,Halter; Christopher P.,10,0,30,20
1715667910260,EDS 204R,A01,507319,Halter; Christopher P.,0,3,30,30
1715667910260,EDS 204R,B01,507331,Heinzman; Erica M.,14,0,30,16
1715667911293,EDS 206R,A00,507332,Staff,0,4,30,30
1715667911293,EDS 206R,B00,507343,Staff,15,0,30,15
1715667912322,EDS 250,A00,507344,Hemans; Patricia Ann Benitez,20,0,40,20
1715667913349,EDS 281,A00,507345,Daly; Alan J.,18,0,18,0
1715667914376,EDS 284,A00,507350,Daly; Alan J.,16,0,16,0
1715667915405,EDS 286,A00,507359,Fine; Sarah,18,0,18,0
1715667916429,EDS 289C,A01,507361,Daly; Alan J.,18,0,18,0
1715667917459,EDS 290,A00,507366,Hofstetter; Carolyn,15,0,15,0
1715667918491,LIGM 5A,A00,507421,Fischer-Grunski; Eva K,17,0,20,3
1715667919538,LIGM 5B,A00,507423,Fischer-Grunski; Eva K,19,0,20,1
1715667920565,LIGM 5C,A00,507425,Fischer-Grunski; Eva K,19,0,20,1
1715667921589,LIIT 5AS,A00,507427,Carnelos; Chiara,20,0,20,0
1715667922616,LIIT 5BS,A00,507430,Carnelos; Chiara,20,0,20,0
1715667923644,LIIT 5CS,A00,507432,Carnelos; Chiara,20,0,20,0
1715667924674,LISP 5A,A00,507541,Munoz Sanchez; Alicia,11,0,20,9
1715667925699,LISP 5B,A00,507671,Munoz Sanchez; Alicia,8,0,20,12
1715667926729,LISP 5C,A00,507696,Munoz Sanchez; Alicia,7,0,20,13
1715667927755,MAE 197,001,528363,Boechler; Nicholas Sebastia,9998,0,9999,1
1715667928785,MATH 197,001,523477,Kedlaya; Kiran S.,9994,0,9999,5
1715667928785,MATH 197,002,563811,Zhang; Danna,9994,0,9999,5
1715667928785,MATH 197,003,628552,Dumitriu; Ioana,9998,0,9999,1
1715667928785,MATH 197,004,660885,Floyd; Eric,9998,0,9999,1
1715667929812,MCWP 40R,A00,518780,Staff,1,0,20,19
1715667929812,MCWP 40R,B00,518781,Carter; Jennifer A,9,0,20,11
1715667929812,MCWP 40R,C00,518783,Smith; Haydee Marie,5,0,20,15
1715667930840,MCWP 50R,A00,518791,Redela; Pamela Morgan,0,1,20,20
1715667930840,MCWP 50R,B00,518792,Krone; Jarret,0,2,20,20
1715667930840,MCWP 50R,C00,518793,Staff,0,4,20,20
1715667930840,MCWP 50R,D00,518794,Morshed; Michael James,0,2,20,20
1715667930840,MCWP 50R,E00,518795,Carter; Andrea L,0,2,20,20
1715667930840,MCWP 50R,F00,518796,Miller; Elizabeth Deen,0,1,20,20
1715667930840,MCWP 50R,G00,518797,Guillen; Melinda,0,1,20,20
1715667931868,MMW 12R,A01,514034,Herbst; Matthew,0,2,16,16
1715667931868,MMW 12R,A02,514035,Herbst; Matthew,0,0,16,16
1715667932894,MMW 13R,A01,514037,Staff,0,5,16,16
1715667932894,MMW 13R,A02,514039,Staff,0,5,16,16
1715667932894,MMW 13R,A03,628519,Staff,0,4,16,16
1715667934948,SIO 295LS,A00,523233,Staff,10,0,30,20
1715667935971,SIO 295S,A00,523232,Staff,10,0,30,20
1715667937004,SIOC 290S,A01,637330,Merrifield; Mark A,21,0,30,9
1715667938033,SIOC 291S,A01,637333,Gabriel; Corey John,21,0,30,9
1715667939063,SOCI 117,A01,494376,Staff,0,5,5,5
1715667940088,WES 237B,A00,494380,Staff,10,0,20,10
1715667942159,AESE 279B,A00,494370,Wade; Jon P,0,0,33,33
1715667943189,AIP 97,001,660915,Van Den Einde; Yael Dahlia,9998,0,9999,1
1715667944221,AIP 197,001,627712,Vespa; Emanuel Ignacio,9995,0,9999,4
1715667944221,AIP 197,002,650778,Amir; On,9998,0,9999,1
1715667944221,AIP 197,003,650933,Avenancio-Leon; Carlos,9998,0,9999,1
1715667944221,AIP 197,004,658530,Heyman; Gail D.,9998,0,9999,1
1715667944221,AIP 197,005,658631,Neal; Sonya E,9998,0,9999,1
1715667944221,AIP 197,006,658671,Du; Songzi,9998,0,9999,1
1715667945252,ANAR 135S,A00,494369,Braswell; Geoffrey E.,0,0,0,0
1715667946278,BENG 196,001,628496,Engler; Adam J.,9998,0,9999,1
1715667946278,BENG 196,002,660916,Watson; John Thomas,9998,0,9999,1
1715667947303,BISP 197,001,650773,Wilhelm; James E.,9994,0,9999,5
1715667947303,BISP 197,002,658904,Coleman; Aaron B.,9998,0,9999,1
1715667948328,CAT 124RS,A01,519847,Geibel; William,0,0,20,20
1715667949355,CAT 125RS,A01,515971,Geibel; William,0,0,20,20
1715667950380,CLRE 250,A00,511389,Morris; Sheldon,9992,0,9999,7
1715667951408,CLRE 251,A00,507176,Mehta; Ravindra L.,9992,0,9999,7
1715667951408,CLRE 251,B00,511410,Mehta; Ravindra L.,9998,0,9999,1
1715667952434,CLRE 252,A00,507189,Cuomo; Raphael Eduardo,9994,0,9999,5
1715667953459,CLRE 253,A00,507199,Vaida; Florin,9994,0,9999,5
1715667953459,CLRE 253,B00,507202,Vaida; Florin,9999,0,9999,0
1715667954490,CLRE 259,A00,507211,Patel; Hemal,9996,0,9999,3
1715667955518,CLRE 260,A00,507221,Cuomo; Raphael Eduardo,9999,0,9999,0
1715667956545,CLRE 297,001,507242,Cuomo; Raphael Eduardo,9999,0,9999,0
1715667957571,COGS 197,001,638244,Voytek; Bradley Thomas,9997,0,9999,2
1715667958600,CSE 191,A00,516875,Minnes Kemp; Mor Mia,9991,0,9999,8
1715667959630,CSE 197,001,637388,Minnes Kemp; Mor Mia,9992,0,9999,7
1715667960657,CSS 201S,A01,494383,Mignozzetti; Umberto,35,0,35,0
1715667961683,CSS 202S,A01,494387,Mignozzetti; Umberto,35,0,35,0
1715667962708,DSC 197,001,628532,Eldridge; Justin Matthew,9995,0,9999,4
1715667963735,EAP 100,A00,516065,Staff,9799,0,9999,200
1715667964763,ECE 45,A01,507414,Staff,32,0,60,28
1715667966815,ECE 111,A01,507420,Staff,11,0,50,39
1715667967846,ECE 197,001,548057,Sievenpiper; Daniel F.,9991,0,9999,8
1715667968873,EDS 115,A00,507243,Choi; Bailey Miyeon,6,0,28,22
1715667969900,EDS 117,A01,494379,Staff,0,6,34,35
1715667970926,EDS 125,A00,507246,Hopkins; Megan Beth,7,0,30,23
1715667971958,EDS 128A,A01,507264,Fargason; Sharon Gayle,5,0,26,21
1715667972988,EDS 128B,A01,507293,Pappas; Elizabeth,9,0,30,21
1715667974014,EDS 139,A00,507294,Fargason; Sharon Gayle,9,0,30,21
1715667974014,EDS 139,B00,507313,Pappas; Elizabeth,9,0,30,21
1715667975041,EDS 201,A00,507315,Staff,10,0,30,20
1715667976067,EDS 203,A01,507317,Halter; Christopher P.,10,0,30,20
1715667977093,EDS 204R,A01,507319,Halter; Christopher P.,0,3,30,30
1715667977093,EDS 204R,B01,507331,Heinzman; Erica M.,14,0,30,16
1715667978120,EDS 206R,A00,507332,Staff,0,4,30,30
1715667978120,EDS 206R,B00,507343,Staff,15,0,30,15
1715667979146,EDS 250,A00,507344,Hemans; Patricia Ann Benitez,20,0,40,20
1715667980175,EDS 281,A00,507345,Daly; Alan J.,18,0,18,0
1715667981203,EDS 284,A00,507350,Daly; Alan J.,16,0,16,0
1715667982230,EDS 286,A00,507359,Fine; Sarah,18,0,18,0
1715667983256,EDS 289C,A01,507361,Daly; Alan J.,18,0,18,0
1715667984281,EDS 290,A00,507366,Hofstetter; Carolyn,15,0,15,0
1715667985307,LIGM 5A,A00,507421,Fischer-Grunski; Eva K,17,0,20,3
1715667986336,LIGM 5B,A00,507423,Fischer-Grunski; Eva K,19,0,20,1
1715667987361,LIGM 5C,A00,507425,Fischer-Grunski; Eva K,19,0,20,1
1715667988387,LIIT 5AS,A00,507427,Carnelos; Chiara,20,0,20,0
1715667989415,LIIT 5BS,A00,507430,Carnelos; Chiara,20,0,20,0
1715667990441,LIIT 5CS,A00,507432,Carnelos; Chiara,20,0,20,0
1715667991469,LISP 5A,A00,507541,Munoz Sanchez; Alicia,11,0,20,9
1715667992497,LISP 5B,A00,507671,Munoz Sanchez; Alicia,8,0,20,12
1715667993523,LISP 5C,A00,507696,Munoz Sanchez; Alicia,7,0,20,13
1715667994549,MAE 197,001,528363,Boechler; Nicholas Sebastia,9998,0,9999,1
1715667995584,MATH 197,001,523477,Kedlaya; Kiran S.,9994,0,9999,5
1715667995584,MATH 197,002,563811,Zhang; Danna,9994,0,9999,5
1715667995584,MATH 197,003,628552,Dumitriu; Ioana,9998,0,9999,1
1715667995584,MATH 197,004,660885,Floyd; Eric,9998,0,9999,1
1715667996610,MCWP 40R,A00,518780,Staff,1,0,20,19
1715667996610,MCWP 40R,B00,518781,Carter; Jennifer A,9,0,20,11
1715667996610,MCWP 40R,C00,518783,Smith; Haydee Marie,5,0,20,15
1715667997638,MCWP 50R,A00,518791,Redela; Pamela Morgan,0,1,20,20
1715667997638,MCWP 50R,B00,518792,Krone; Jarret,0,2,20,20
1715667997638,MCWP 50R,C00,518793,Staff,0,4,20,20
1715667997638,MCWP 50R,D00,518794,Morshed; Michael James,0,2,20,20
1715667997638,MCWP 50R,E00,518795,Carter; Andrea L,0,2,20,20
1715667997638,MCWP 50R,F00,518796,Miller; Elizabeth Deen,0,1,20,20
1715667997638,MCWP 50R,G00,518797,Guillen; Melinda,0,1,20,20
1715667998666,MMW 12R,A01,514034,Herbst; Matthew,0,2,16,16
1715667998666,MMW 12R,A02,514035,Herbst; Matthew,0,0,16,16
1715667999693,MMW 13R,A01,514037,Staff,0,5,16,16
1715667999693,MMW 13R,A02,514039,Staff,0,5,16,16
1715667999693,MMW 13R,A03,628519,Staff,0,4,16,16
1715668001745,SIO 295LS,A00,523233,Staff,10,0,30,20
1715668002770,SIO 295S,A00,523232,Staff,10,0,30,20
1715668003797,SIOC 290S,A01,637330,Merrifield; Mark A,21,0,30,9
1715668004823,SIOC 291S,A01,637333,Gabriel; Corey John,21,0,30,9
1715668005852,SOCI 117,A01,494376,Staff,0,5,5,5
1715668006881,WES 237B,A00,494380,Staff,10,0,20,10
1715668008978,AESE 279B,A00,494370,Wade; Jon P,0,0,33,33
1715668010006,AIP 97,001,660915,Van Den Einde; Yael Dahlia,9998,0,9999,1
1715668011035,AIP 197,001,627712,Vespa; Emanuel Ignacio,9995,0,9999,4
1715668011035,AIP 197,002,650778,Amir; On,9998,0,9999,1
1715668011035,AIP 197,003,650933,Avenancio-Leon; Carlos,9998,0,9999,1
1715668011035,AIP 197,004,658530,Heyman; Gail D.,9998,0,9999,1
1715668011035,AIP 197,005,658631,Neal; Sonya E,9998,0,9999,1
1715668011035,AIP 197,006,658671,Du; Songzi,9998,0,9999,1
1715668012065,ANAR 135S,A00,494369,Braswell; Geoffrey E.,0,0,0,0
1715668013092,BENG 196,001,628496,Engler; Adam J.,9998,0,9999,1
1715668013092,BENG 196,002,660916,Watson; John Thomas,9998,0,9999,1
1715668014119,BISP 197,001,650773,Wilhelm; James E.,9994,0,9999,5
1715668014119,BISP 197,002,658904,Coleman; Aaron B.,9998,0,9999,1
1715668015151,CAT 124RS,A01,519847,Geibel; William,0,0,20,20
1715668016178,CAT 125RS,A01,515971,Geibel; William,0,0,20,20
1715668017206,CLRE 250,A00,511389,Morris; Sheldon,9992,0,9999,7
1715668018234,CLRE 251,A00,507176,Mehta; Ravindra L.,9992,0,9999,7
1715668018234,CLRE 251,B00,511410,Mehta; Ravindra L.,9998,0,9999,1
1715668019264,CLRE 252,A00,507189,Cuomo; Raphael Eduardo,9994,0,9999,5
1715668020290,CLRE 253,A00,507199,Vaida; Florin,9994,0,9999,5
1715668020290,CLRE 253,B00,507202,Vaida; Florin,9999,0,9999,0
1715668021318,CLRE 259,A00,507211,Patel; Hemal,9996,0,9999,3
1715668022343,CLRE 260,A00,507221,Cuomo; Raphael Eduardo,9999,0,9999,0
1715668023368,CLRE 297,001,507242,Cuomo; Raphael Eduardo,9999,0,9999,0
1715668024392,COGS 197,001,638244,Voytek; Bradley Thomas,9997,0,9999,2
1715668025419,CSE 191,A00,516875,Minnes Kemp; Mor Mia,9991,0,9999,8
1715668026447,CSE 197,001,637388,Minnes Kemp; Mor Mia,9992,0,9999,7
1715668027480,CSS 201S,A01,494383,Mignozzetti; Umberto,35,0,35,0
1715668028512,CSS 202S,A01,494387,Mignozzetti; Umberto,35,0,35,0
1715668029537,DSC 197,001,628532,Eldridge; Justin Matthew,9995,0,9999,4
1715668030562,EAP 100,A00,516065,Staff,9799,0,9999,200
1715668031592,ECE 45,A01,507414,Staff,32,0,60,28
1715668033641,ECE 111,A01,507420,Staff,11,0,50,39
1715668034670,ECE 197,001,548057,Sievenpiper; Daniel F.,9991,0,9999,8
1715668035696,EDS 115,A00,507243,Choi; Bailey Miyeon,6,0,28,22
1715668036721,EDS 117,A01,494379,Staff,0,6,34,35
1715668037745,EDS 125,A00,507246,Hopkins; Megan Beth,7,0,30,23
1715668038771,EDS 128A,A01,507264,Fargason; Sharon Gayle,5,0,26,21
1715668039794,EDS 128B,A01,507293,Pappas; Elizabeth,9,0,30,21
1715668040820,EDS 139,A00,507294,Fargason; Sharon Gayle,9,0,30,21
1715668040820,EDS 139,B00,507313,Pappas; Elizabeth,9,0,30,21
1715668041845,EDS 201,A00,507315,Staff,10,0,30,20
1715668042872,EDS 203,A01,507317,Halter; Christopher P.,10,0,30,20
1715668043898,EDS 204R,A01,507319,Halter; Christopher P.,0,3,30,30
1715668043898,EDS 204R,B01,507331,Heinzman; Erica M.,14,0,30,16
1715668044923,EDS 206R,A00,507332,Staff,0,4,30,30
1715668044923,EDS 206R,B00,507343,Staff,15,0,30,15
1715668045948,EDS 250,A00,507344,Hemans; Patricia Ann Benitez,20,0,40,20
1715668046979,EDS 281,A00,507345,Daly; Alan J.,18,0,18,0
1715668048006,EDS 284,A00,507350,Daly; Alan J.,16,0,16,0
1715668049032,EDS 286,A00,507359,Fine; Sarah,18,0,18,0
1715668050057,EDS 289C,A01,507361,Daly; Alan J.,18,0,18,0
1715668051087,EDS 290,A00,507366,Hofstetter; Carolyn,15,0,15,0
1715668052115,LIGM 5A,A00,507421,Fischer-Grunski; Eva K,17,0,20,3
1715668053140,LIGM 5B,A00,507423,Fischer-Grunski; Eva K,19,0,20,1
1715668054165,LIGM 5C,A00,507425,Fischer-Grunski; Eva K,19,0,20,1
1715668055195,LIIT 5AS,A00,507427,Carnelos; Chiara,20,0,20,0
1715668056224,LIIT 5BS,A00,507430,Carnelos; Chiara,20,0,20,0
1715668057257,LIIT 5CS,A00,507432,Carnelos; Chiara,20,0,20,0
1715668058283,LISP 5A,A00,507541,Munoz Sanchez; Alicia,11,0,20,9
1715668059309,LISP 5B,A00,507671,Munoz Sanchez; Alicia,8,0,20,12
1715668060337,LISP 5C,A00,507696,Munoz Sanchez; Alicia,7,0,20,13
1715668061363,MAE 197,001,528363,Boechler; Nicholas Sebastia,9998,0,9999,1
1715668062400,MATH 197,001,523477,Kedlaya; Kiran S.,9994,0,9999,5
1715668062400,MATH 197,002,563811,Zhang; Danna,9994,0,9999,5
1715668062400,MATH 197,003,628552,Dumitriu; Ioana,9998,0,9999,1
1715668062400,MATH 197,004,660885,Floyd; Eric,9998,0,9999,1
1715668063433,MCWP 40R,A00,518780,Staff,1,0,20,19
1715668063433,MCWP 40R,B00,518781,Carter; Jennifer A,9,0,20,11
1715668063433,MCWP 40R,C00,518783,Smith; Haydee Marie,5,0,20,15
1715668064470,MCWP 50R,A00,518791,Redela; Pamela Morgan,0,1,20,20
1715668064470,MCWP 50R,B00,518792,Krone; Jarret,0,2,20,20
1715668064470,MCWP 50R,C00,518793,Staff,0,4,20,20
1715668064470,MCWP 50R,D00,518794,Morshed; Michael James,0,2,20,20
1715668064470,MCWP 50R,E00,518795,Carter; Andrea L,0,2,20,20
1715668064470,MCWP 50R,F00,518796,Miller; Elizabeth Deen,0,1,20,20
1715668064470,MCWP 50R,G00,518797,Guillen; Melinda,0,1,20,20
1715668065500,MMW 12R,A01,514034,Herbst; Matthew,0,2,16,16
1715668065500,MMW 12R,A02,514035,Herbst; Matthew,0,0,16,16
1715668066525,MMW 13R,A01,514037,Staff,0,5,16,16
1715668066525,MMW 13R,A02,514039,Staff,0,5,16,16
1715668066525,MMW 13R,A03,628519,Staff,0,4,16,16
1715668068577,SIO 295LS,A00,523233,Staff,10,0,30,20
1715668069601,SIO 295S,A00,523232,Staff,10,0,30,20
1715668070626,SIOC 290S,A01,637330,Merrifield; Mark A,21,0,30,9
1715668071651,SIOC 291S,A01,637333,Gabriel; Corey John,21,0,30,9
1715668072674,SOCI 117,A01,494376,Staff,0,5,5,5
1715668073700,WES 237B,A00,494380,Staff,10,0,20,10
1715668075771,AESE 279B,A00,494370,Wade; Jon P,0,0,33,33
1715668076801,AIP 97,001,660915,Van Den Einde; Yael Dahlia,9998,0,9999,1
1715668077831,AIP 197,001,627712,Vespa; Emanuel Ignacio,9995,0,9999,4
1715668077831,AIP 197,002,650778,Amir; On,9998,0,9999,1
1715668077831,AIP 197,003,650933,Avenancio-Leon; Carlos,9998,0,9999,1
1715668077831,AIP 197,004,658530,Heyman; Gail D.,9998,0,9999,1
1715668077831,AIP 197,005,658631,Neal; Sonya E,9998,0,9999,1
1715668077831,AIP 197,006,658671,Du; Songzi,9998,0,9999,1
1715668078856,ANAR 135S,A00,494369,Braswell; Geoffrey E.,0,0,0,0
1715668079882,BENG 196,001,628496,Engler; Adam J.,9998,0,9999,1
1715668079882,BENG 196,002,660916,Watson; John Thomas,9998,0,9999,1
1715668080909,BISP 197,001,650773,Wilhelm; James E.,9994,0,9999,5
1715668080909,BISP 197,002,658904,Coleman; Aaron B.,9998,0,9999,1
1715668081940,CAT 124RS,A01,519847,Geibel; William,0,0,20,20
1715668082970,CAT 125RS,A01,515971,Geibel; William,0,0,20,20
1715668083999,CLRE 250,A00,511389,Morris; Sheldon,9992,0,9999,7
1715668085026,CLRE 251,A00,507176,Mehta; Ravindra L.,9992,0,9999,7
1715668085026,CLRE 251,B00,511410,Mehta; Ravindra L.,9998,0,9999,1
1715668086056,CLRE 252,A00,507189,Cuomo; Raphael Eduardo,9994,0,9999,5
1715668087085,CLRE 253,A00,507199,Vaida; Florin,9994,0,9999,5
1715668087085,CLRE 253,B00,507202,Vaida; Florin,9999,0,9999,0
1715668088110,CLRE 259,A00,507211,Patel; Hemal,9996,0,9999,3
1715668089138,CLRE 260,A00,507221,Cuomo; Raphael Eduardo,9999,0,9999,0
1715668090165,CLRE 297,001,507242,Cuomo; Raphael Eduardo,9999,0,9999,0
1715668091194,COGS 197,001,638244,Voytek; Bradley Thomas,9997,0,9999,2
1715668092220,CSE 191,A00,516875,Minnes Kemp; Mor Mia,9991,0,9999,8
1715668093247,CSE 197,001,637388,Minnes Kemp; Mor Mia,9992,0,9999,7
1715668094278,CSS 201S,A01,494383,Mignozzetti; Umberto,35,0,35,0
1715668095308,CSS 202S,A01,494387,Mignozzetti; Umberto,35,0,35,0
1715668096335,DSC 197,001,628532,Eldridge; Justin Matthew,9995,0,9999,4
1715668097364,EAP 100,A00,516065,Staff,9799,0,9999,200
1715668098391,ECE 45,A01,507414,Staff,32,0,60,28
1715668100448,ECE 111,A01,507420,Staff,11,0,50,39
1715668101478,ECE 197,001,548057,Sievenpiper; Daniel F.,9991,0,9999,8
1715668102508,EDS 115,A00,507243,Choi; Bailey Miyeon,6,0,28,22
1715668103534,EDS 117,A01,494379,Staff,0,6,34,35
1715668104560,EDS 125,A00,507246,Hopkins; Megan Beth,7,0,30,23
1715668105586,EDS 128A,A01,507264,Fargason; Sharon Gayle,5,0,26,21
1715668106615,EDS 128B,A01,507293,Pappas; Elizabeth,9,0,30,21
1715668107641,EDS 139,A00,507294,Fargason; Sharon Gayle,9,0,30,21
1715668107641,EDS 139,B00,507313,Pappas; Elizabeth,9,0,30,21
1715668108668,EDS 201,A00,507315,Staff,10,0,30,20
1715668109693,EDS 203,A01,507317,Halter; Christopher P.,10,0,30,20
1715668110724,EDS 204R,A01,507319,Halter; Christopher P.,0,3,30,30
1715668110724,EDS 204R,B01,507331,Heinzman; Erica M.,14,0,30,16
1715668111749,EDS 206R,A00,507332,Staff,0,4,30,30
1715668111749,EDS 206R,B00,507343,Staff,15,0,30,15
1715668112780,EDS 250,A00,507344,Hemans; Patricia Ann Benitez,20,0,40,20
1715668113805,EDS 281,A00,507345,Daly; Alan J.,18,0,18,0
1715668114830,EDS 284,A00,507350,Daly; Alan J.,16,0,16,0
1715668115857,EDS 286,A00,507359,Fine; Sarah,18,0,18,0
1715668116881,EDS 289C,A01,507361,Daly; Alan J.,18,0,18,0
1715668117905,EDS 290,A00,507366,Hofstetter; Carolyn,15,0,15,0
1715668118937,LIGM 5A,A00,507421,Fischer-Grunski; Eva K,17,0,20,3
1715668119963,LIGM 5B,A00,507423,Fischer-Grunski; Eva K,19,0,20,1
1715668120993,LIGM 5C,A00,507425,Fischer-Grunski; Eva K,19,0,20,1
1715668122018,LIIT 5AS,A00,507427,Carnelos; Chiara,20,0,20,0
1715668123046,LIIT 5BS,A00,507430,Carnelos; Chiara,20,0,20,0
1715668124075,LIIT 5CS,A00,507432,Carnelos; Chiara,20,0,20,0
1715668125104,LISP 5A,A00,507541,Munoz Sanchez; Alicia,11,0,20,9
1715668126130,LISP 5B,A00,507671,Munoz Sanchez; Alicia,8,0,20,12
1715668127155,LISP 5C,A00,507696,Munoz Sanchez; Alicia,7,0,20,13
1715668128184,MAE 197,001,528363,Boechler; Nicholas Sebastia,9998,0,9999,1
1715668129214,MATH 197,001,523477,Kedlaya; Kiran S.,9994,0,9999,5
1715668129214,MATH 197,002,563811,Zhang; Danna,9994,0,9999,5
1715668129214,MATH 197,003,628552,Dumitriu; Ioana,9998,0,9999,1
1715668129214,MATH 197,004,660885,Floyd; Eric,9998,0,9999,1
1715668130240,MCWP 40R,A00,518780,Staff,1,0,20,19
1715668130240,MCWP 40R,B00,518781,Carter; Jennifer A,9,0,20,11
1715668130240,MCWP 40R,C00,518783,Smith; Haydee Marie,5,0,20,15
1715668131274,MCWP 50R,A00,518791,Redela; Pamela Morgan,0,1,20,20
1715668131274,MCWP 50R,B00,518792,Krone; Jarret,0,2,20,20
1715668131274,MCWP 50R,C00,518793,Staff,0,4,20,20
1715668131274,MCWP 50R,D00,518794,Morshed; Michael James,0,2,20,20
1715668131274,MCWP 50R,E00,518795,Carter; Andrea L,0,2,20,20
1715668131274,MCWP 50R,F00,518796,Miller; Elizabeth Deen,0,1,20,20
1715668131274,MCWP 50R,G00,518797,Guillen; Melinda,0,1,20,20
1715668132301,MMW 12R,A01,514034,Herbst; Matthew,0,2,16,16
1715668132301,MMW 12R,A02,514035,Herbst; Matthew,0,0,16,16
1715668133326,MMW 13R,A01,514037,Staff,0,5,16,16
1715668133326,MMW 13R,A02,514039,Staff,0,5,16,16
1715668133326,MMW 13R,A03,628519,Staff,0,4,16,16
1715668135382,SIO 295LS,A00,523233,Staff,10,0,30,20
1715668136409,SIO 295S,A00,523232,Staff,10,0,30,20
1715668137435,SIOC 290S,A01,637330,Merrifield; Mark A,21,0,30,9
1715668138464,SIOC 291S,A01,637333,Gabriel; Corey John,21,0,30,9
1715668139495,SOCI 117,A01,494376,Staff,0,5,5,5
1715668140522,WES 237B,A00,494380,Staff,10,0,20,10
1715668142602,AESE 279B,A00,494370,Wade; Jon P,0,0,33,33
1715668143627,AIP 97,001,660915,Van Den Einde; Yael Dahlia,9998,0,9999,1
1715668144655,AIP 197,001,627712,Vespa; Emanuel Ignacio,9995,0,9999,4
1715668144655,AIP 197,002,650778,Amir; On,9998,0,9999,1
1715668144655,AIP 197,003,650933,Avenancio-Leon; Carlos,9998,0,9999,1
1715668144655,AIP 197,004,658530,Heyman; Gail D.,9998,0,9999,1
1715668144655,AIP 197,005,658631,Neal; Sonya E,9998,0,9999,1
1715668144655,AIP 197,006,658671,Du; Songzi,9998,0,9999,1
1715668145683,ANAR 135S,A00,494369,Braswell; Geoffrey E.,0,0,0,0
1715668146711,BENG 196,001,628496,Engler; Adam J.,9998,0,9999,1
1715668146711,BENG 196,002,660916,Watson; John Thomas,9998,0,9999,1
1715668147738,BISP 197,001,650773,Wilhelm; James E.,9994,0,9999,5
1715668147738,BISP 197,002,658904,Coleman; Aaron B.,9998,0,9999,1
1715668148767,CAT 124RS,A01,519847,Geibel; William,0,0,20,20
1715668149797,CAT 125RS,A01,515971,Geibel; William,0,0,20,20
1715668150831,CLRE 250,A00,511389,Morris; Sheldon,9992,0,9999,7
1715668151864,CLRE 251,A00,507176,Mehta; Ravindra L.,9992,0,9999,7
1715668151864,CLRE 251,B00,511410,Mehta; Ravindra L.,9998,0,9999,1
1715668152895,CLRE 252,A00,507189,Cuomo; Raphael Eduardo,9994,0,9999,5
1715668153919,CLRE 253,A00,507199,Vaida; Florin,9994,0,9999,5
1715668153919,CLRE 253,B00,507202,Vaida; Florin,9999,0,9999,0
1715668154948,CLRE 259,A00,507211,Patel; Hemal,9996,0,9999,3
1715668155974,CLRE 260,A00,507221,Cuomo; Raphael Eduardo,9999,0,9999,0
1715668157001,CLRE 297,001,507242,Cuomo; Raphael Eduardo,9999,0,9999,0
1715668158027,COGS 197,001,638244,Voytek; Bradley Thomas,9997,0,9999,2
1715668159053,CSE 191,A00,516875,Minnes Kemp; Mor Mia,9991,0,9999,8
1715668160079,CSE 197,001,637388,Minnes Kemp; Mor Mia,9992,0,9999,7
1715668161106,CSS 201S,A01,494383,Mignozzetti; Umberto,35,0,35,0
1715668162137,CSS 202S,A01,494387,Mignozzetti; Umberto,35,0,35,0
1715668163163,DSC 197,001,628532,Eldridge; Justin Matthew,9995,0,9999,4
1715668164192,EAP 100,A00,516065,Staff,9799,0,9999,200
1715668165219,ECE 45,A01,507414,Staff,32,0,60,28
1715668167274,ECE 111,A01,507420,Staff,11,0,50,39
1715668168301,ECE 197,001,548057,Sievenpiper; Daniel F.,9991,0,9999,8
1715668169328,EDS 115,A00,507243,Choi; Bailey Miyeon,6,0,28,22
1715668170352,EDS 117,A01,494379,Staff,0,6,34,35
1715668171379,EDS 125,A00,507246,Hopkins; Megan Beth,7,0,30,23
1715668172412,EDS 128A,A01,507264,Fargason; Sharon Gayle,5,0,26,21
1715668173442,EDS 128B,A01,507293,Pappas; Elizabeth,9,0,30,21
1715668174470,EDS 139,A00,507294,Fargason; Sharon Gayle,9,0,30,21
1715668174470,EDS 139,B00,507313,Pappas; Elizabeth,9,0,30,21
1715668175494,EDS 201,A00,507315,Staff,10,0,30,20
1715668176523,EDS 203,A01,507317,Halter; Christopher P.,10,0,30,20
1715668177550,EDS 204R,A01,507319,Halter; Christopher P.,0,3,30,30
1715668177550,EDS 204R,B01,507331,Heinzman; Erica M.,14,0,30,16
1715668178574,EDS 206R,A00,507332,Staff,0,4,30,30
1715668178574,EDS 206R,B00,507343,Staff,15,0,30,15
1715668179603,EDS 250,A00,507344,Hemans; Patricia Ann Benitez,20,0,40,20
1715668180632,EDS 281,A00,507345,Daly; Alan J.,18,0,18,0
1715668181659,EDS 284,A00,507350,Daly; Alan J.,16,0,16,0
1715668182685,EDS 286,A00,507359,Fine; Sarah,18,0,18,0
1715668183710,EDS 289C,A01,507361,Daly; Alan J.,18,0,18,0
1715668184738,EDS 290,A00,507366,Hofstetter; Carolyn,15,0,15,0
1715668185770,LIGM 5A,A00,507421,Fischer-Grunski; Eva K,17,0,20,3
1715668186799,LIGM 5B,A00,507423,Fischer-Grunski; Eva K,19,0,20,1
1715668187829,LIGM 5C,A00,507425,Fischer-Grunski; Eva K,19,0,20,1
1715668188854,LIIT 5AS,A00,507427,Carnelos; Chiara,20,0,20,0
1715668189881,LIIT 5BS,A00,507430,Carnelos; Chiara,20,0,20,0
1715668190910,LIIT 5CS,A00,507432,Carnelos; Chiara,20,0,20,0
1715668191943,LISP 5A,A00,507541,Munoz Sanchez; Alicia,11,0,20,9
1715668192969,LISP 5B,A00,507671,Munoz Sanchez; Alicia,8,0,20,12
1715668193994,LISP 5C,A00,507696,Munoz Sanchez; Alicia,7,0,20,13
1715668195021,MAE 197,001,528363,Boechler; Nicholas Sebastia,9998,0,9999,1
1715668196049,MATH 197,001,523477,Kedlaya; Kiran S.,9994,0,9999,5
1715668196049,MATH 197,002,563811,Zhang; Danna,9994,0,9999,5
1715668196049,MATH 197,003,628552,Dumitriu; Ioana,9998,0,9999,1
1715668196049,MATH 197,004,660885,Floyd; Eric,9998,0,9999,1
1715668197076,MCWP 40R,A00,518780,Staff,1,0,20,19
1715668197076,MCWP 40R,B00,518781,Carter; Jennifer A,9,0,20,11
1715668197076,MCWP 40R,C00,518783,Smith; Haydee Marie,5,0,20,15
1715668198110,MCWP 50R,A00,518791,Redela; Pamela Morgan,0,1,20,20
1715668198110,MCWP 50R,B00,518792,Krone; Jarret,0,2,20,20
1715668198110,MCWP 50R,C00,518793,Staff,0,4,20,20
1715668198110,MCWP 50R,D00,518794,Morshed; Michael James,0,2,20,20
1715668198110,MCWP 50R,E00,518795,Carter; Andrea L,0,2,20,20
1715668198110,MCWP 50R,F00,518796,Miller; Elizabeth Deen,0,1,20,20
1715668198110,MCWP 50R,G00,518797,Guillen; Melinda,0,1,20,20
1715668199136,MMW 12R,A01,514034,Herbst; Matthew,0,2,16,16
1715668199136,MMW 12R,A02,514035,Herbst; Matthew,0,0,16,16
1715668200160,MMW 13R,A01,514037,Staff,0,5,16,16
1715668200160,MMW 13R,A02,514039,Staff,0,5,16,16
1715668200160,MMW 13R,A03,628519,Staff,0,4,16,16
1715668202220,SIO 295LS,A00,523233,Staff,10,0,30,20
1715668203248,SIO 295S,A00,523232,Staff,10,0,30,20
1715668204281,SIOC 290S,A01,637330,Merrifield; Mark A,21,0,30,9
1715668205310,SIOC 291S,A01,637333,Gabriel; Corey John,21,0,30,9
1715668206338,SOCI 117,A01,494376,Staff,0,5,5,5
1715668207364,WES 237B,A00,494380,Staff,10,0,20,10
1715668209437,AESE 279B,A00,494370,Wade; Jon P,0,0,33,33
1715668210466,AIP 97,001,660915,Van Den Einde; Yael Dahlia,9998,0,9999,1
1715668211493,AIP 197,001,627712,Vespa; Emanuel Ignacio,9995,0,9999,4
1715668211493,AIP 197,002,650778,Amir; On,9998,0,9999,1
1715668211493,AIP 197,003,650933,Avenancio-Leon; Carlos,9998,0,9999,1
1715668211493,AIP 197,004,658530,Heyman; Gail D.,9998,0,9999,1
1715668211493,AIP 197,005,658631,Neal; Sonya E,9998,0,9999,1
1715668211493,AIP 197,006,658671,Du; Songzi,9998,0,9999,1
1715668212518,ANAR 135S,A00,494369,Braswell; Geoffrey E.,0,0,0,0
1715668213549,BENG 196,001,628496,Engler; Adam J.,9998,0,9999,1
1715668213549,BENG 196,002,660916,Watson; John Thomas,9998,0,9999,1
1715668214580,BISP 197,001,650773,Wilhelm; James E.,9994,0,9999,5
1715668214580,BISP 197,002,658904,Coleman; Aaron B.,9998,0,9999,1
1715668215606,CAT 124RS,A01,519847,Geibel; William,0,0,20,20
1715668216630,CAT 125RS,A01,515971,Geibel; William,0,0,20,20
1715668217655,CLRE 250,A00,511389,Morris; Sheldon,9992,0,9999,7
1715668218682,CLRE 251,A00,507176,Mehta; Ravindra L.,9992,0,9999,7
1715668218682,CLRE 251,B00,511410,Mehta; Ravindra L.,9998,0,9999,1
1715668219707,CLRE 252,A00,507189,Cuomo; Raphael Eduardo,9994,0,9999,5
1715668220736,CLRE 253,A00,507199,Vaida; Florin,9994,0,9999,5
1715668220736,CLRE 253,B00,507202,Vaida; Florin,9999,0,9999,0
1715668221762,CLRE 259,A00,507211,Patel; Hemal,9996,0,9999,3
1715668222786,CLRE 260,A00,507221,Cuomo; Raphael Eduardo,9999,0,9999,0
1715668223810,CLRE 297,001,507242,Cuomo; Raphael Eduardo,9999,0,9999,0
1715668224838,COGS 197,001,638244,Voytek; Bradley Thomas,9997,0,9999,2
1715668225868,CSE 191,A00,516875,Minnes Kemp; Mor Mia,9991,0,9999,8
1715668226897,CSE 197,001,637388,Minnes Kemp; Mor Mia,9992,0,9999,7
1715668227925,CSS 201S,A01,494383,Mignozzetti; Umberto,35,0,35,0
1715668228948,CSS 202S,A01,494387,Mignozzetti; Umberto,35,0,35,0
1715668229981,DSC 197,001,628532,Eldridge; Justin Matthew,9995,0,9999,4
1715668231008,EAP 100,A00,516065,Staff,9799,0,9999,200
1715668232038,ECE 45,A01,507414,Staff,32,0,60,28
1715668234087,ECE 111,A01,507420,Staff,11,0,50,39
1715668235116,ECE 197,001,548057,Sievenpiper; Daniel F.,9991,0,9999,8
1715668236142,EDS 115,A00,507243,Choi; Bailey Miyeon,6,0,28,22
1715668237166,EDS 117,A01,494379,Staff,0,6,34,35
1715668238197,EDS 125,A00,507246,Hopkins; Megan Beth,7,0,30,23
1715668239226,EDS 128A,A01,507264,Fargason; Sharon Gayle,5,0,26,21
1715668240254,EDS 128B,A01,507293,Pappas; Elizabeth,9,0,30,21
1715668241282,EDS 139,A00,507294,Fargason; Sharon Gayle,9,0,30,21
1715668241282,EDS 139,B00,507313,Pappas; Elizabeth,9,0,30,21
1715668242307,EDS 201,A00,507315,Staff,10,0,30,20
1715668243339,EDS 203,A01,507317,Halter; Christopher P.,10,0,30,20
1715668244364,EDS 204R,A01,507319,Halter; Christopher P.,0,3,30,30
1715668244364,EDS 204R,B01,507331,Heinzman; Erica M.,14,0,30,16
1715668245390,EDS 206R,A00,507332,Staff,0,4,30,30
1715668245390,EDS 206R,B00,507343,Staff,15,0,30,15
1715668246419,EDS 250,A00,507344,Hemans; Patricia Ann Benitez,20,0,40,20
1715668247448,EDS 281,A00,507345,Daly; Alan J.,18,0,18,0
1715668248479,EDS 284,A00,507350,Daly; Alan J.,16,0,16,0
1715668249508,EDS 286,A00,507359,Fine; Sarah,18,0,18,0
1715668250533,EDS 289C,A01,507361,Daly; Alan J.,18,0,18,0
1715668251566,EDS 290,A00,507366,Hofstetter; Carolyn,15,0,15,0
1715668252593,LIGM 5A,A00,507421,Fischer-Grunski; Eva K,17,0,20,3
1715668253619,LIGM 5B,A00,507423,Fischer-Grunski; Eva K,19,0,20,1
1715668254651,LIGM 5C,A00,507425,Fischer-Grunski; Eva K,19,0,20,1
1715668255682,LIIT 5AS,A00,507427,Carnelos; Chiara,20,0,20,0
1715668256708,LIIT 5BS,A00,507430,Carnelos; Chiara,20,0,20,0
1715668257738,LIIT 5CS,A00,507432,Carnelos; Chiara,20,0,20,0
1715668258768,LISP 5A,A00,507541,Munoz Sanchez; Alicia,11,0,20,9
1715668259798,LISP 5B,A00,507671,Munoz Sanchez; Alicia,8,0,20,12
1715668260826,LISP 5C,A00,507696,Munoz Sanchez; Alicia,7,0,20,13
1715668261853,MAE 197,001,528363,Boechler; Nicholas Sebastia,9998,0,9999,1
1715668262886,MATH 197,001,523477,Kedlaya; Kiran S.,9994,0,9999,5
1715668262886,MATH 197,002,563811,Zhang; Danna,9994,0,9999,5
1715668262886,MATH 197,003,628552,Dumitriu; Ioana,9998,0,9999,1
1715668262886,MATH 197,004,660885,Floyd; Eric,9998,0,9999,1
1715668263920,MCWP 40R,A00,518780,Staff,1,0,20,19
1715668263920,MCWP 40R,B00,518781,Carter; Jennifer A,9,0,20,11
1715668263920,MCWP 40R,C00,518783,Smith; Haydee Marie,5,0,20,15
1715668264949,MCWP 50R,A00,518791,Redela; Pamela Morgan,0,1,20,20
1715668264949,MCWP 50R,B00,518792,Krone; Jarret,0,2,20,20
1715668264949,MCWP 50R,C00,518793,Staff,0,4,20,20
1715668264949,MCWP 50R,D00,518794,Morshed; Michael James,0,2,20,20
1715668264949,MCWP 50R,E00,518795,Carter; Andrea L,0,2,20,20
1715668264949,MCWP 50R,F00,518796,Miller; Elizabeth Deen,0,1,20,20
1715668264949,MCWP 50R,G00,518797,Guillen; Melinda,0,1,20,20
1715668265974,MMW 12R,A01,514034,Herbst; Matthew,0,2,16,16
1715668265974,MMW 12R,A02,514035,Herbst; Matthew,0,0,16,16
1715668267001,MMW 13R,A01,514037,Staff,0,5,16,16
1715668267001,MMW 13R,A02,514039,Staff,0,5,16,16
1715668267001,MMW 13R,A03,628519,Staff,0,4,16,16
1715668269060,SIO 295LS,A00,523233,Staff,10,0,30,20
1715668270086,SIO 295S,A00,523232,Staff,10,0,30,20
1715668271113,SIOC 290S,A01,637330,Merrifield; Mark A,21,0,30,9
1715668272138,SIOC 291S,A01,637333,Gabriel; Corey John,21,0,30,9
1715668273163,SOCI 117,A01,494376,Staff,0,5,5,5
1715668274190,WES 237B,A00,494380,Staff,10,0,20,10
1715668276259,AESE 279B,A00,494370,Wade; Jon P,0,0,33,33
1715668277285,AIP 97,001,660915,Van Den Einde; Yael Dahlia,9998,0,9999,1
1715668278318,AIP 197,001,627712,Vespa; Emanuel Ignacio,9995,0,9999,4
1715668278318,AIP 197,002,650778,Amir; On,9998,0,9999,1
1715668278318,AIP 197,003,650933,Avenancio-Leon; Carlos,9998,0,9999,1
1715668278318,AIP 197,004,658530,Heyman; Gail D.,9998,0,9999,1
1715668278318,AIP 197,005,658631,Neal; Sonya E,9998,0,9999,1
1715668278318,AIP 197,006,658671,Du; Songzi,9998,0,9999,1
1715668279345,ANAR 135S,A00,494369,Braswell; Geoffrey E.,0,0,0,0
1715668280374,BENG 196,001,628496,Engler; Adam J.,9998,0,9999,1
1715668280374,BENG 196,002,660916,Watson; John Thomas,9998,0,9999,1
1715668281400,BISP 197,001,650773,Wilhelm; James E.,9994,0,9999,5
1715668281400,BISP 197,002,658904,Coleman; Aaron B.,9998,0,9999,1
1715668282430,CAT 124RS,A01,519847,Geibel; William,0,0,20,20
1715668283455,CAT 125RS,A01,515971,Geibel; William,0,0,20,20
1715668284479,CLRE 250,A00,511389,Morris; Sheldon,9992,0,9999,7
1715668285507,CLRE 251,A00,507176,Mehta; Ravindra L.,9992,0,9999,7
1715668285507,CLRE 251,B00,511410,Mehta; Ravindra L.,9998,0,9999,1
1715668286533,CLRE 252,A00,507189,Cuomo; Raphael Eduardo,9994,0,9999,5
1715668287560,CLRE 253,A00,507199,Vaida; Florin,9994,0,9999,5
1715668287560,CLRE 253,B00,507202,Vaida; Florin,9999,0,9999,0
1715668288585,CLRE 259,A00,507211,Patel; Hemal,9996,0,9999,3
1715668289611,CLRE 260,A00,507221,Cuomo; Raphael Eduardo,9999,0,9999,0
1715668290638,CLRE 297,001,507242,Cuomo; Raphael Eduardo,9999,0,9999,0
1715668291663,COGS 197,001,638244,Voytek; Bradley Thomas,9997,0,9999,2
1715668292690,CSE 191,A00,516875,Minnes Kemp; Mor Mia,9991,0,9999,8
1715668293714,CSE 197,001,637388,Minnes Kemp; Mor Mia,9992,0,9999,7
1715668294743,CSS 201S,A01,494383,Mignozzetti; Umberto,35,0,35,0
1715668295772,CSS 202S,A01,494387,Mignozzetti; Umberto,35,0,35,0
1715668296799,DSC 197,001,628532,Eldridge; Justin Matthew,9995,0,9999,4
1715668297826,EAP 100,A00,516065,Staff,9799,0,9999,200
1715668298854,ECE 45,A01,507414,Staff,32,0,60,28
1715668300910,ECE 111,A01,507420,Staff,11,0,50,39
1715668301935,ECE 197,001,548057,Sievenpiper; Daniel F.,9991,0,9999,8
1715668302963,EDS 115,A00,507243,Choi; Bailey Miyeon,6,0,28,22
1715668303988,EDS 117,A01,494379,Staff,0,6,34,35
1715668305014,EDS 125,A00,507246,Hopkins; Megan Beth,7,0,30,23
1715668306039,EDS 128A,A01,507264,Fargason; Sharon Gayle,5,0,26,21
1715668307062,EDS 128B,A01,507293,Pappas; Elizabeth,9,0,30,21
1715668308090,EDS 139,A00,507294,Fargason; Sharon Gayle,9,0,30,21
1715668308090,EDS 139,B00,507313,Pappas; Elizabeth,9,0,30,21
1715668309114,EDS 201,A00,507315,Staff,10,0,30,20
1715668310142,EDS 203,A01,507317,Halter; Christopher P.,10,0,30,20
1715668311170,EDS 204R,A01,507319,Halter; Christopher P.,0,3,30,30
1715668311170,EDS 204R,B01,507331,Heinzman; Erica M.,14,0,30,16
1715668312197,EDS 206R,A00,507332,Staff,0,4,30,30
1715668312197,EDS 206R,B00,507343,Staff,15,0,30,15
1715668313224,EDS 250,A00,507344,Hemans; Patricia Ann Benitez,20,0,40,20
1715668314248,EDS 281,A00,507345,Daly; Alan J.,18,0,18,0
1715668315273,EDS 284,A00,507350,Daly; Alan J.,16,0,16,0
1715668316298,EDS 286,A00,507359,Fine; Sarah,18,0,18,0
1715668317325,EDS 289C,A01,507361,Daly; Alan J.,18,0,18,0
1715668318354,EDS 290,A00,507366,Hofstetter; Carolyn,15,0,15,0
1715668319381,LIGM 5A,A00,507421,Fischer-Grunski; Eva K,17,0,20,3
1715668320406,LIGM 5B,A00,507423,Fischer-Grunski; Eva K,19,0,20,1
1715668321433,LIGM 5C,A00,507425,Fischer-Grunski; Eva K,19,0,20,1
1715668322457,LIIT 5AS,A00,507427,Carnelos; Chiara,20,0,20,0
1715668323485,LIIT 5BS,A00,507430,Carnelos; Chiara,20,0,20,0
1715668324512,LIIT 5CS,A00,507432,Carnelos; Chiara,20,0,20,0
1715668325536,LISP 5A,A00,507541,Munoz Sanchez; Alicia,11,0,20,9
1715668326565,LISP 5B,A00,507671,Munoz Sanchez; Alicia,8,0,20,12
1715668327590,LISP 5C,A00,507696,Munoz Sanchez; Alicia,7,0,20,13
1715668328618,MAE 197,001,528363,Boechler; Nicholas Sebastia,9998,0,9999,1
1715668329646,MATH 197,001,523477,Kedlaya; Kiran S.,9994,0,9999,5
1715668329646,MATH 197,002,563811,Zhang; Danna,9994,0,9999,5
1715668329646,MATH 197,003,628552,Dumitriu; Ioana,9998,0,9999,1
1715668329646,MATH 197,004,660885,Floyd; Eric,9998,0,9999,1
1715668330673,MCWP 40R,A00,518780,Staff,1,0,20,19
1715668330673,MCWP 40R,B00,518781,Carter; Jennifer A,9,0,20,11
1715668330673,MCWP 40R,C00,518783,Smith; Haydee Marie,5,0,20,15
1715668331757,MCWP 50R,A00,518791,Redela; Pamela Morgan,0,1,20,20
1715668331757,MCWP 50R,B00,518792,Krone; Jarret,0,2,20,20
1715668331757,MCWP 50R,C00,518793,Staff,0,4,20,20
1715668331757,MCWP 50R,D00,518794,Morshed; Michael James,0,2,20,20
1715668331757,MCWP 50R,E00,518795,Carter; Andrea L,0,2,20,20
1715668331757,MCWP 50R,F00,518796,Miller; Elizabeth Deen,0,1,20,20
1715668331757,MCWP 50R,G00,518797,Guillen; Melinda,0,1,20,20
1715668332786,MMW 12R,A01,514034,Herbst; Matthew,0,2,16,16
1715668332786,MMW 12R,A02,514035,Herbst; Matthew,0,0,16,16
1715668333810,MMW 13R,A01,514037,Staff,0,5,16,16
1715668333810,MMW 13R,A02,514039,Staff,0,5,16,16
1715668333810,MMW 13R,A03,628519,Staff,0,4,16,16
1715668335864,SIO 295LS,A00,523233,Staff,10,0,30,20
1715668336889,SIO 295S,A00,523232,Staff,10,0,30,20
1715668337914,SIOC 290S,A01,637330,Merrifield; Mark A,21,0,30,9
1715668338940,SIOC 291S,A01,637333,Gabriel; Corey John,21,0,30,9
1715668339965,SOCI 117,A01,494376,Staff,0,5,5,5
1715668340988,WES 237B,A00,494380,Staff,10,0,20,10
1715668343056,AESE 279B,A00,494370,Wade; Jon P,0,0,33,33
1715668344086,AIP 97,001,660915,Van Den Einde; Yael Dahlia,9998,0,9999,1
1715668345209,AIP 197,001,627712,Vespa; Emanuel Ignacio,9995,0,9999,4
1715668345209,AIP 197,002,650778,Amir; On,9998,0,9999,1
1715668345209,AIP 197,003,650933,Avenancio-Leon; Carlos,9998,0,9999,1
1715668345209,AIP 197,004,658530,Heyman; Gail D.,9998,0,9999,1
1715668345209,AIP 197,005,658631,Neal; Sonya E,9998,0,9999,1
1715668345209,AIP 197,006,658671,Du; Songzi,9998,0,9999,1
1715668346240,ANAR 135S,A00,494369,Braswell; Geoffrey E.,0,0,0,0
1715668347266,BENG 196,001,628496,Engler; Adam J.,9998,0,9999,1
1715668347266,BENG 196,002,660916,Watson; John Thomas,9998,0,9999,1
1715668348293,BISP 197,001,650773,Wilhelm; James E.,9994,0,9999,5
1715668348293,BISP 197,002,658904,Coleman; Aaron B.,9998,0,9999,1
1715668349322,CAT 124RS,A01,519847,Geibel; William,0,0,20,20
1715668350347,CAT 125RS,A01,515971,Geibel; William,0,0,20,20
1715668351377,CLRE 250,A00,511389,Morris; Sheldon,9992,0,9999,7
1715668352411,CLRE 251,A00,507176,Mehta; Ravindra L.,9992,0,9999,7
1715668352411,CLRE 251,B00,511410,Mehta; Ravindra L.,9998,0,9999,1
1715668353439,CLRE 252,A00,507189,Cuomo; Raphael Eduardo,9994,0,9999,5
1715668354470,CLRE 253,A00,507199,Vaida; Florin,9994,0,9999,5
1715668354470,CLRE 253,B00,507202,Vaida; Florin,9999,0,9999,0
1715668355494,CLRE 259,A00,507211,Patel; Hemal,9996,0,9999,3
1715668356522,CLRE 260,A00,507221,Cuomo; Raphael Eduardo,9999,0,9999,0
1715668357548,CLRE 297,001,507242,Cuomo; Raphael Eduardo,9999,0,9999,0
1715668358574,COGS 197,001,638244,Voytek; Bradley Thomas,9997,0,9999,2
1715668359601,CSE 191,A00,516875,Minnes Kemp; Mor Mia,9991,0,9999,8
1715668360629,CSE 197,001,637388,Minnes Kemp; Mor Mia,9992,0,9999,7
1715668361660,CSS 201S,A01,494383,Mignozzetti; Umberto,35,0,35,0
1715668362686,CSS 202S,A01,494387,Mignozzetti; Umberto,35,0,35,0
1715668363716,DSC 197,001,628532,Eldridge; Justin Matthew,9995,0,9999,4
1715668364741,EAP 100,A00,516065,Staff,9799,0,9999,200
1715668365776,ECE 45,A01,507414,Staff,32,0,60,28
1715668367827,ECE 111,A01,507420,Staff,11,0,50,39
1715668368861,ECE 197,001,548057,Sievenpiper; Daniel F.,9991,0,9999,8
1715668369888,EDS 115,A00,507243,Choi; Bailey Miyeon,6,0,28,22
1715668370914,EDS 117,A01,494379,Staff,0,6,34,35
1715668371938,EDS 125,A00,507246,Hopkins; Megan Beth,7,0,30,23
1715668372964,EDS 128A,A01,507264,Fargason; Sharon Gayle,5,0,26,21
1715668373994,EDS 128B,A01,507293,Pappas; Elizabeth,9,0,30,21
1715668375021,EDS 139,A00,507294,Fargason; Sharon Gayle,9,0,30,21
1715668375021,EDS 139,B00,507313,Pappas; Elizabeth,9,0,30,21
1715668376046,EDS 201,A00,507315,Staff,10,0,30,20
1715668377070,EDS 203,A01,507317,Halter; Christopher P.,10,0,30,20
1715668378101,EDS 204R,A01,507319,Halter; Christopher P.,0,3,30,30
1715668378101,EDS 204R,B01,507331,Heinzman; Erica M.,14,0,30,16
1715668379130,EDS 206R,A00,507332,Staff,0,4,30,30
1715668379130,EDS 206R,B00,507343,Staff,15,0,30,15
1715668380161,EDS 250,A00,507344,Hemans; Patricia Ann Benitez,20,0,40,20
1715668381189,EDS 281,A00,507345,Daly; Alan J.,18,0,18,0
1715668382219,EDS 284,A00,507350,Daly; Alan J.,16,0,16,0
1715668383394,EDS 286,A00,507359,Fine; Sarah,18,0,18,0
1715668384420,EDS 289C,A01,507361,Daly; Alan J.,18,0,18,0
1715668385450,EDS 290,A00,507366,Hofstetter; Carolyn,15,0,15,0
1715668386477,LIGM 5A,A00,507421,Fischer-Grunski; Eva K,17,0,20,3
1715668387504,LIGM 5B,A00,507423,Fischer-Grunski; Eva K,19,0,20,1
1715668388532,LIGM 5C,A00,507425,Fischer-Grunski; Eva K,19,0,20,1
1715668389559,LIIT 5AS,A00,507427,Carnelos; Chiara,20,0,20,0
1715668390584,LIIT 5BS,A00,507430,Carnelos; Chiara,20,0,20,0
1715668391612,LIIT 5CS,A00,507432,Carnelos; Chiara,20,0,20,0
1715668392642,LISP 5A,A00,507541,Munoz Sanchez; Alicia,11,0,20,9
1715668393671,LISP 5B,A00,507671,Munoz Sanchez; Alicia,8,0,20,12
1715668394700,LISP 5C,A00,507696,Munoz Sanchez; Alicia,7,0,20,13
1715668395725,MAE 197,001,528363,Boechler; Nicholas Sebastia,9998,0,9999,1
1715668396753,MATH 197,001,523477,Kedlaya; Kiran S.,9994,0,9999,5
1715668396753,MATH 197,002,563811,Zhang; Danna,9994,0,9999,5
1715668396753,MATH 197,003,628552,Dumitriu; Ioana,9998,0,9999,1
1715668396753,MATH 197,004,660885,Floyd; Eric,9998,0,9999,1
1715668397783,MCWP 40R,A00,518780,Staff,1,0,20,19
1715668397783,MCWP 40R,B00,518781,Carter; Jennifer A,9,0,20,11
1715668397783,MCWP 40R,C00,518783,Smith; Haydee Marie,5,0,20,15
1715668398815,MCWP 50R,A00,518791,Redela; Pamela Morgan,0,1,20,20
1715668398815,MCWP 50R,B00,518792,Krone; Jarret,0,2,20,20
1715668398815,MCWP 50R,C00,518793,Staff,0,4,20,20
1715668398815,MCWP 50R,D00,518794,Morshed; Michael James,0,2,20,20
1715668398815,MCWP 50R,E00,518795,Carter; Andrea L,0,2,20,20
1715668398815,MCWP 50R,F00,518796,Miller; Elizabeth Deen,0,1,20,20
1715668398815,MCWP 50R,G00,518797,Guillen; Melinda,0,1,20,20
1715668399840,MMW 12R,A01,514034,Herbst; Matthew,0,2,16,16
1715668399840,MMW 12R,A02,514035,Herbst; Matthew,0,0,16,16
1715668400923,MMW 13R,A01,514037,Staff,0,5,16,16
1715668400923,MMW 13R,A02,514039,Staff,0,5,16,16
1715668400923,MMW 13R,A03,628519,Staff,0,4,16,16
1715668402974,SIO 295LS,A00,523233,Staff,10,0,30,20
1715668403999,SIO 295S,A00,523232,Staff,10,0,30,20
1715668405026,SIOC 290S,A01,637330,Merrifield; Mark A,21,0,30,9
1715668406052,SIOC 291S,A01,637333,Gabriel; Corey John,21,0,30,9
1715668407078,SOCI 117,A01,494376,Staff,0,5,5,5
1715668408103,WES 237B,A00,494380,Staff,10,0,20,10
1715668410181,AESE 279B,A00,494370,Wade; Jon P,0,0,33,33
1715668411206,AIP 97,001,660915,Van Den Einde; Yael Dahlia,9998,0,9999,1
1715668412233,AIP 197,001,627712,Vespa; Emanuel Ignacio,9995,0,9999,4
1715668412233,AIP 197,002,650778,Amir; On,9998,0,9999,1
1715668412233,AIP 197,003,650933,Avenancio-Leon; Carlos,9998,0,9999,1
1715668412233,AIP 197,004,658530,Heyman; Gail D.,9998,0,9999,1
1715668412233,AIP 197,005,658631,Neal; Sonya E,9998,0,9999,1
1715668412233,AIP 197,006,658671,Du; Songzi,9998,0,9999,1
1715668413264,ANAR 135S,A00,494369,Braswell; Geoffrey E.,0,0,0,0
1715668414289,BENG 196,001,628496,Engler; Adam J.,9998,0,9999,1
1715668414289,BENG 196,002,660916,Watson; John Thomas,9998,0,9999,1
1715668415316,BISP 197,001,650773,Wilhelm; James E.,9994,0,9999,5
1715668415316,BISP 197,002,658904,Coleman; Aaron B.,9998,0,9999,1
1715668416342,CAT 124RS,A01,519847,Geibel; William,0,0,20,20
1715668417369,CAT 125RS,A01,515971,Geibel; William,0,0,20,20
1715668418395,CLRE 250,A00,511389,Morris; Sheldon,9992,0,9999,7
1715668419423,CLRE 251,A00,507176,Mehta; Ravindra L.,9992,0,9999,7
1715668419423,CLRE 251,B00,511410,Mehta; Ravindra L.,9998,0,9999,1
1715668420452,CLRE 252,A00,507189,Cuomo; Raphael Eduardo,9994,0,9999,5
1715668421477,CLRE 253,A00,507199,Vaida; Florin,9994,0,9999,5
1715668421477,CLRE 253,B00,507202,Vaida; Florin,9999,0,9999,0
1715668422503,CLRE 259,A00,507211,Patel; Hemal,9996,0,9999,3
1715668423529,CLRE 260,A00,507221,Cuomo; Raphael Eduardo,9999,0,9999,0
1715668424556,CLRE 297,001,507242,Cuomo; Raphael Eduardo,9999,0,9999,0
1715668425583,COGS 197,001,638244,Voytek; Bradley Thomas,9997,0,9999,2
1715668426614,CSE 191,A00,516875,Minnes Kemp; Mor Mia,9991,0,9999,8
1715668427640,CSE 197,001,637388,Minnes Kemp; Mor Mia,9992,0,9999,7
1715668428670,CSS 201S,A01,494383,Mignozzetti; Umberto,35,0,35,0
1715668429694,CSS 202S,A01,494387,Mignozzetti; Umberto,35,0,35,0
1715668430724,DSC 197,001,628532,Eldridge; Justin Matthew,9995,0,9999,4
1715668431749,EAP 100,A00,516065,Staff,9799,0,9999,200
1715668432774,ECE 45,A01,507414,Staff,32,0,60,28
1715668434832,ECE 111,A01,507420,Staff,11,0,50,39
1715668435856,ECE 197,001,548057,Sievenpiper; Daniel F.,9991,0,9999,8
1715668436890,EDS 115,A00,507243,Choi; Bailey Miyeon,6,0,28,22
1715668437914,EDS 117,A01,494379,Staff,0,6,34,35
1715668438938,EDS 125,A00,507246,Hopkins; Megan Beth,7,0,30,23
1715668439967,EDS 128A,A01,507264,Fargason; Sharon Gayle,5,0,26,21
1715668440998,EDS 128B,A01,507293,Pappas; Elizabeth,9,0,30,21
1715668442026,EDS 139,A00,507294,Fargason; Sharon Gayle,9,0,30,21
1715668442026,EDS 139,B00,507313,Pappas; Elizabeth,9,0,30,21
1715668443082,EDS 201,A00,507315,Staff,10,0,30,20
1715668444114,EDS 203,A01,507317,Halter; Christopher P.,10,0,30,20
1715668445140,EDS 204R,A01,507319,Halter; Christopher P.,0,3,30,30
1715668445140,EDS 204R,B01,507331,Heinzman; Erica M.,14,0,30,16
1715668446166,EDS 206R,A00,507332,Staff,0,4,30,30
1715668446166,EDS 206R,B00,507343,Staff,15,0,30,15
1715668447193,EDS 250,A00,507344,Hemans; Patricia Ann Benitez,20,0,40,20
1715668448218,EDS 281,A00,507345,Daly; Alan J.,18,0,18,0
1715668449247,EDS 284,A00,507350,Daly; Alan J.,16,0,16,0
1715668450291,EDS 286,A00,507359,Fine; Sarah,18,0,18,0
1715668451317,EDS 289C,A01,507361,Daly; Alan J.,18,0,18,0
1715668452344,EDS 290,A00,507366,Hofstetter; Carolyn,15,0,15,0
1715668453369,LIGM 5A,A00,507421,Fischer-Grunski; Eva K,17,0,20,3
1715668454399,LIGM 5B,A00,507423,Fischer-Grunski; Eva K,19,0,20,1
1715668455423,LIGM 5C,A00,507425,Fischer-Grunski; Eva K,19,0,20,1
1715668456448,LIIT 5AS,A00,507427,Carnelos; Chiara,20,0,20,0
1715668457474,LIIT 5BS,A00,507430,Carnelos; Chiara,20,0,20,0
1715668458499,LIIT 5CS,A00,507432,Carnelos; Chiara,20,0,20,0
1715668459526,LISP 5A,A00,507541,Munoz Sanchez; Alicia,11,0,20,9
1715668460551,LISP 5B,A00,507671,Munoz Sanchez; Alicia,8,0,20,12
1715668461577,LISP 5C,A00,507696,Munoz Sanchez; Alicia,7,0,20,13
1715668462606,MAE 197,001,528363,Boechler; Nicholas Sebastia,9998,0,9999,1
1715668463636,MATH 197,001,523477,Kedlaya; Kiran S.,9994,0,9999,5
1715668463636,MATH 197,002,563811,Zhang; Danna,9994,0,9999,5
1715668463636,MATH 197,003,628552,Dumitriu; Ioana,9998,0,9999,1
1715668463636,MATH 197,004,660885,Floyd; Eric,9998,0,9999,1
1715668464662,MCWP 40R,A00,518780,Staff,1,0,20,19
1715668464662,MCWP 40R,B00,518781,Carter; Jennifer A,9,0,20,11
1715668464662,MCWP 40R,C00,518783,Smith; Haydee Marie,5,0,20,15
1715668465690,MCWP 50R,A00,518791,Redela; Pamela Morgan,0,1,20,20
1715668465690,MCWP 50R,B00,518792,Krone; Jarret,0,2,20,20
1715668465690,MCWP 50R,C00,518793,Staff,0,4,20,20
1715668465690,MCWP 50R,D00,518794,Morshed; Michael James,0,2,20,20
1715668465690,MCWP 50R,E00,518795,Carter; Andrea L,0,2,20,20
1715668465690,MCWP 50R,F00,518796,Miller; Elizabeth Deen,0,1,20,20
1715668465690,MCWP 50R,G00,518797,Guillen; Melinda,0,1,20,20
1715668466715,MMW 12R,A01,514034,Herbst; Matthew,0,2,16,16
1715668466715,MMW 12R,A02,514035,Herbst; Matthew,0,0,16,16
1715668467744,MMW 13R,A01,514037,Staff,0,5,16,16
1715668467744,MMW 13R,A02,514039,Staff,0,5,16,16
1715668467744,MMW 13R,A03,628519,Staff,0,4,16,16
1715668469797,SIO 295LS,A00,523233,Staff,10,0,30,20
1715668470823,SIO 295S,A00,523232,Staff,10,0,30,20
1715668471854,SIOC 290S,A01,637330,Merrifield; Mark A,21,0,30,9
1715668472880,SIOC 291S,A01,637333,Gabriel; Corey John,21,0,30,9
1715668473905,SOCI 117,A01,494376,Staff,0,5,5,5
1715668474933,WES 237B,A00,494380,Staff,10,0,20,10
1715668477008,AESE 279B,A00,494370,Wade; Jon P,0,0,33,33
1715668478034,AIP 97,001,660915,Van Den Einde; Yael Dahlia,9998,0,9999,1
1715668479068,AIP 197,001,627712,Vespa; Emanuel Ignacio,9995,0,9999,4
1715668479068,AIP 197,002,650778,Amir; On,9998,0,9999,1
1715668479068,AIP 197,003,650933,Avenancio-Leon; Carlos,9998,0,9999,1
1715668479068,AIP 197,004,658530,Heyman; Gail D.,9998,0,9999,1
1715668479068,AIP 197,005,658631,Neal; Sonya E,9998,0,9999,1
1715668479068,AIP 197,006,658671,Du; Songzi,9998,0,9999,1
1715668480096,ANAR 135S,A00,494369,Braswell; Geoffrey E.,0,0,0,0
1715668481122,BENG 196,001,628496,Engler; Adam J.,9998,0,9999,1
1715668481122,BENG 196,002,660916,Watson; John Thomas,9998,0,9999,1
1715668482150,BISP 197,001,650773,Wilhelm; James E.,9994,0,9999,5
1715668482150,BISP 197,002,658904,Coleman; Aaron B.,9998,0,9999,1
1715668483175,CAT 124RS,A01,519847,Geibel; William,0,0,20,20
1715668484201,CAT 125RS,A01,515971,Geibel; William,0,0,20,20
1715668485230,CLRE 250,A00,511389,Morris; Sheldon,9992,0,9999,7
1715668486260,CLRE 251,A00,507176,Mehta; Ravindra L.,9992,0,9999,7
1715668486260,CLRE 251,B00,511410,Mehta; Ravindra L.,9998,0,9999,1
1715668487285,CLRE 252,A00,507189,Cuomo; Raphael Eduardo,9994,0,9999,5
1715668488315,CLRE 253,A00,507199,Vaida; Florin,9994,0,9999,5
1715668488315,CLRE 253,B00,507202,Vaida; Florin,9999,0,9999,0
1715668489341,CLRE 259,A00,507211,Patel; Hemal,9996,0,9999,3
1715668490365,CLRE 260,A00,507221,Cuomo; Raphael Eduardo,9999,0,9999,0
1715668491390,CLRE 297,001,507242,Cuomo; Raphael Eduardo,9999,0,9999,0
1715668492420,COGS 197,001,638244,Voytek; Bradley Thomas,9997,0,9999,2
1715668493445,CSE 191,A00,516875,Minnes Kemp; Mor Mia,9991,0,9999,8
1715668494470,CSE 197,001,637388,Minnes Kemp; Mor Mia,9992,0,9999,7
1715668495497,CSS 201S,A01,494383,Mignozzetti; Umberto,35,0,35,0
1715668496526,CSS 202S,A01,494387,Mignozzetti; Umberto,35,0,35,0
1715668497553,DSC 197,001,628532,Eldridge; Justin Matthew,9995,0,9999,4
1715668498580,EAP 100,A00,516065,Staff,9799,0,9999,200
1715668499609,ECE 45,A01,507414,Staff,32,0,60,28
1715668501660,ECE 111,A01,507420,Staff,11,0,50,39
1715668502689,ECE 197,001,548057,Sievenpiper; Daniel F.,9991,0,9999,8
1715668503718,EDS 115,A00,507243,Choi; Bailey Miyeon,6,0,28,22
1715668504803,EDS 117,A01,494379,Staff,0,6,34,35
1715668505830,EDS 125,A00,507246,Hopkins; Megan Beth,7,0,30,23
1715668506860,EDS 128A,A01,507264,Fargason; Sharon Gayle,5,0,26,21
1715668507890,EDS 128B,A01,507293,Pappas; Elizabeth,9,0,30,21
1715668508918,EDS 139,A00,507294,Fargason; Sharon Gayle,9,0,30,21
1715668508918,EDS 139,B00,507313,Pappas; Elizabeth,9,0,30,21
1715668509948,EDS 201,A00,507315,Staff,10,0,30,20
1715668510974,EDS 203,A01,507317,Halter; Christopher P.,10,0,30,20
1715668512003,EDS 204R,A01,507319,Halter; Christopher P.,0,3,30,30
1715668512003,EDS 204R,B01,507331,Heinzman; Erica M.,14,0,30,16
1715668513028,EDS 206R,A00,507332,Staff,0,4,30,30
1715668513028,EDS 206R,B00,507343,Staff,15,0,30,15
1715668514052,EDS 250,A00,507344,Hemans; Patricia Ann Benitez,20,0,40,20
1715668515078,EDS 281,A00,507345,Daly; Alan J.,18,0,18,0
1715668516107,EDS 284,A00,507350,Daly; Alan J.,16,0,16,0
1715668517136,EDS 286,A00,507359,Fine; Sarah,18,0,18,0
1715668518163,EDS 289C,A01,507361,Daly; Alan J.,18,0,18,0
1715668519189,EDS 290,A00,507366,Hofstetter; Carolyn,15,0,15,0
1715668520216,LIGM 5A,A00,507421,Fischer-Grunski; Eva K,17,0,20,3
1715668521246,LIGM 5B,A00,507423,Fischer-Grunski; Eva K,19,0,20,1
1715668522273,LIGM 5C,A00,507425,Fischer-Grunski; Eva K,19,0,20,1
1715668523303,LIIT 5AS,A00,507427,Carnelos; Chiara,20,0,20,0
1715668524332,LIIT 5BS,A00,507430,Carnelos; Chiara,20,0,20,0
1715668525358,LIIT 5CS,A00,507432,Carnelos; Chiara,20,0,20,0
1715668526384,LISP 5A,A00,507541,Munoz Sanchez; Alicia,11,0,20,9
1715668527409,LISP 5B,A00,507671,Munoz Sanchez; Alicia,8,0,20,12
1715668528434,LISP 5C,A00,507696,Munoz Sanchez; Alicia,7,0,20,13
1715668529460,MAE 197,001,528363,Boechler; Nicholas Sebastia,9998,0,9999,1
1715668530494,MATH 197,001,523477,Kedlaya; Kiran S.,9994,0,9999,5
1715668530494,MATH 197,002,563811,Zhang; Danna,9994,0,9999,5
1715668530494,MATH 197,003,628552,Dumitriu; Ioana,9998,0,9999,1
1715668530494,MATH 197,004,660885,Floyd; Eric,9998,0,9999,1
1715668531526,MCWP 40R,A00,518780,Staff,1,0,20,19
1715668531526,MCWP 40R,B00,518781,Carter; Jennifer A,9,0,20,11
1715668531526,MCWP 40R,C00,518783,Smith; Haydee Marie,5,0,20,15
1715668532554,MCWP 50R,A00,518791,Redela; Pamela Morgan,0,1,20,20
1715668532554,MCWP 50R,B00,518792,Krone; Jarret,0,2,20,20
1715668532554,MCWP 50R,C00,518793,Staff,0,4,20,20
1715668532554,MCWP 50R,D00,518794,Morshed; Michael James,0,2,20,20
1715668532554,MCWP 50R,E00,518795,Carter; Andrea L,0,2,20,20
1715668532554,MCWP 50R,F00,518796,Miller; Elizabeth Deen,0,1,20,20
1715668532554,MCWP 50R,G00,518797,Guillen; Melinda,0,1,20,20
1715668533578,MMW 12R,A01,514034,Herbst; Matthew,0,2,16,16
1715668533578,MMW 12R,A02,514035,Herbst; Matthew,0,0,16,16
1715668534603,MMW 13R,A01,514037,Staff,0,5,16,16
1715668534603,MMW 13R,A02,514039,Staff,0,5,16,16
1715668534603,MMW 13R,A03,628519,Staff,0,4,16,16
1715668536661,SIO 295LS,A00,523233,Staff,10,0,30,20
1715668537686,SIO 295S,A00,523232,Staff,10,0,30,20
1715668538716,SIOC 290S,A01,637330,Merrifield; Mark A,21,0,30,9
1715668539740,SIOC 291S,A01,637333,Gabriel; Corey John,21,0,30,9
1715668540766,SOCI 117,A01,494376,Staff,0,5,5,5
1715668541791,WES 237B,A00,494380,Staff,10,0,20,10
1715668543861,AESE 279B,A00,494370,Wade; Jon P,0,0,33,33
1715668544886,AIP 97,001,660915,Van Den Einde; Yael Dahlia,9998,0,9999,1
1715668545916,AIP 197,001,627712,Vespa; Emanuel Ignacio,9995,0,9999,4
1715668545916,AIP 197,002,650778,Amir; On,9998,0,9999,1
1715668545916,AIP 197,003,650933,Avenancio-Leon; Carlos,9998,0,9999,1
1715668545916,AIP 197,004,658530,Heyman; Gail D.,9998,0,9999,1
1715668545916,AIP 197,005,658631,Neal; Sonya E,9998,0,9999,1
1715668545916,AIP 197,006,658671,Du; Songzi,9998,0,9999,1
1715668546946,ANAR 135S,A00,494369,Braswell; Geoffrey E.,0,0,0,0
1715668547972,BENG 196,001,628496,Engler; Adam J.,9998,0,9999,1
1715668547972,BENG 196,002,660916,Watson; John Thomas,9998,0,9999,1
1715668549002,BISP 197,001,650773,Wilhelm; James E.,9994,0,9999,5
1715668549002,BISP 197,002,658904,Coleman; Aaron B.,9998,0,9999,1
1715668550031,CAT 124RS,A01,519847,Geibel; William,0,0,20,20
1715668551059,CAT 125RS,A01,515971,Geibel; William,0,0,20,20
1715668552091,CLRE 250,A00,511389,Morris; Sheldon,9992,0,9999,7
1715668553117,CLRE 251,A00,507176,Mehta; Ravindra L.,9992,0,9999,7
1715668553117,CLRE 251,B00,511410,Mehta; Ravindra L.,9998,0,9999,1
1715668554146,CLRE 252,A00,507189,Cuomo; Raphael Eduardo,9994,0,9999,5
1715668555174,CLRE 253,A00,507199,Vaida; Florin,9994,0,9999,5
1715668555174,CLRE 253,B00,507202,Vaida; Florin,9999,0,9999,0
1715668556200,CLRE 259,A00,507211,Patel; Hemal,9996,0,9999,3
1715668557228,CLRE 260,A00,507221,Cuomo; Raphael Eduardo,9999,0,9999,0
1715668558254,CLRE 297,001,507242,Cuomo; Raphael Eduardo,9999,0,9999,0
1715668559283,COGS 197,001,638244,Voytek; Bradley Thomas,9997,0,9999,2
1715668560308,CSE 191,A00,516875,Minnes Kemp; Mor Mia,9991,0,9999,8
1715668561333,CSE 197,001,637388,Minnes Kemp; Mor Mia,9992,0,9999,7
1715668562365,CSS 201S,A01,494383,Mignozzetti; Umberto,35,0,35,0
1715668563390,CSS 202S,A01,494387,Mignozzetti; Umberto,35,0,35,0
1715668564416,DSC 197,001,628532,Eldridge; Justin Matthew,9995,0,9999,4
1715668565442,EAP 100,A00,516065,Staff,9799,0,9999,200
1715668566468,ECE 45,A01,507414,Staff,32,0,60,28
1715668568521,ECE 111,A01,507420,Staff,11,0,50,39
1715668569546,ECE 197,001,548057,Sievenpiper; Daniel F.,9991,0,9999,8
1715668570571,EDS 115,A00,507243,Choi; Bailey Miyeon,6,0,28,22
1715668571600,EDS 117,A01,494379,Staff,0,6,34,35
1715668572625,EDS 125,A00,507246,Hopkins; Megan Beth,7,0,30,23
1715668573676,EDS 128A,A01,507264,Fargason; Sharon Gayle,5,0,26,21
1715668574706,EDS 128B,A01,507293,Pappas; Elizabeth,9,0,30,21
1715668575731,EDS 139,A00,507294,Fargason; Sharon Gayle,9,0,30,21
1715668575731,EDS 139,B00,507313,Pappas; Elizabeth,9,0,30,21
1715668576755,EDS 201,A00,507315,Staff,10,0,30,20
1715668577783,EDS 203,A01,507317,Halter; Christopher P.,10,0,30,20
1715668578810,EDS 204R,A01,507319,Halter; Christopher P.,0,3,30,30
1715668578810,EDS 204R,B01,507331,Heinzman; Erica M.,14,0,30,16
1715668579835,EDS 206R,A00,507332,Staff,0,4,30,30
1715668579835,EDS 206R,B00,507343,Staff,15,0,30,15
1715668580860,EDS 250,A00,507344,Hemans; Patricia Ann Benitez,20,0,40,20
1715668581884,EDS 281,A00,507345,Daly; Alan J.,18,0,18,0
1715668582912,EDS 284,A00,507350,Daly; Alan J.,16,0,16,0
1715668583944,EDS 286,A00,507359,Fine; Sarah,18,0,18,0
1715668584971,EDS 289C,A01,507361,Daly; Alan J.,18,0,18,0
1715668585998,EDS 290,A00,507366,Hofstetter; Carolyn,15,0,15,0
1715668587027,LIGM 5A,A00,507421,Fischer-Grunski; Eva K,17,0,20,3
1715668588055,LIGM 5B,A00,507423,Fischer-Grunski; Eva K,19,0,20,1
1715668589084,LIGM 5C,A00,507425,Fischer-Grunski; Eva K,19,0,20,1
1715668590115,LIIT 5AS,A00,507427,Carnelos; Chiara,20,0,20,0
1715668591143,LIIT 5BS,A00,507430,Carnelos; Chiara,20,0,20,0
1715668592170,LIIT 5CS,A00,507432,Carnelos; Chiara,20,0,20,0
1715668593195,LISP 5A,A00,507541,Munoz Sanchez; Alicia,11,0,20,9
1715668594226,LISP 5B,A00,507671,Munoz Sanchez; Alicia,8,0,20,12
1715668595251,LISP 5C,A00,507696,Munoz Sanchez; Alicia,7,0,20,13
1715668596280,MAE 197,001,528363,Boechler; Nicholas Sebastia,9998,0,9999,1
1715668597309,MATH 197,001,523477,Kedlaya; Kiran S.,9994,0,9999,5
1715668597309,MATH 197,002,563811,Zhang; Danna,9994,0,9999,5
1715668597309,MATH 197,003,628552,Dumitriu; Ioana,9998,0,9999,1
1715668597309,MATH 197,004,660885,Floyd; Eric,9998,0,9999,1
1715668598335,MCWP 40R,A00,518780,Staff,1,0,20,19
1715668598335,MCWP 40R,B00,518781,Carter; Jennifer A,9,0,20,11
1715668598335,MCWP 40R,C00,518783,Smith; Haydee Marie,5,0,20,15
1715668599367,MCWP 50R,A00,518791,Redela; Pamela Morgan,0,1,20,20
1715668599367,MCWP 50R,B00,518792,Krone; Jarret,0,2,20,20
1715668599367,MCWP 50R,C00,518793,Staff,0,4,20,20
1715668599367,MCWP 50R,D00,518794,Morshed; Michael James,0,2,20,20
1715668599367,MCWP 50R,E00,518795,Carter; Andrea L,0,2,20,20
1715668599367,MCWP 50R,F00,518796,Miller; Elizabeth Deen,0,1,20,20
1715668599367,MCWP 50R,G00,518797,Guillen; Melinda,0,1,20,20
1715668600407,MMW 12R,A01,514034,Herbst; Matthew,0,2,16,16
1715668600407,MMW 12R,A02,514035,Herbst; Matthew,0,0,16,16
1715668601434,MMW 13R,A01,514037,Staff,0,5,16,16
1715668601434,MMW 13R,A02,514039,Staff,0,5,16,16
1715668601434,MMW 13R,A03,628519,Staff,0,4,16,16
1715668603487,SIO 295LS,A00,523233,Staff,10,0,30,20
1715668604512,SIO 295S,A00,523232,Staff,10,0,30,20
1715668605536,SIOC 290S,A01,637330,Merrifield; Mark A,21,0,30,9
1715668606562,SIOC 291S,A01,637333,Gabriel; Corey John,21,0,30,9
1715668607587,SOCI 117,A01,494376,Staff,0,5,5,5
1715668608669,WES 237B,A00,494380,Staff,10,0,20,10
1715668610745,AESE 279B,A00,494370,Wade; Jon P,0,0,33,33
1715668611773,AIP 97,001,660915,Van Den Einde; Yael Dahlia,9998,0,9999,1
1715668612805,AIP 197,001,627712,Vespa; Emanuel Ignacio,9995,0,9999,4
1715668612805,AIP 197,002,650778,Amir; On,9998,0,9999,1
1715668612805,AIP 197,003,650933,Avenancio-Leon; Carlos,9998,0,9999,1
1715668612805,AIP 197,004,658530,Heyman; Gail D.,9998,0,9999,1
1715668612805,AIP 197,005,658631,Neal; Sonya E,9998,0,9999,1
1715668612805,AIP 197,006,658671,Du; Songzi,9998,0,9999,1
1715668613831,ANAR 135S,A00,494369,Braswell; Geoffrey E.,0,0,0,0
1715668614859,BENG 196,001,628496,Engler; Adam J.,9998,0,9999,1
1715668614859,BENG 196,002,660916,Watson; John Thomas,9998,0,9999,1
1715668615885,BISP 197,001,650773,Wilhelm; James E.,9994,0,9999,5
1715668615885,BISP 197,002,658904,Coleman; Aaron B.,9998,0,9999,1
1715668616912,CAT 124RS,A01,519847,Geibel; William,0,0,20,20
1715668617938,CAT 125RS,A01,515971,Geibel; William,0,0,20,20
1715668618963,CLRE 250,A00,511389,Morris; Sheldon,9992,0,9999,7
1715668619991,CLRE 251,A00,507176,Mehta; Ravindra L.,9992,0,9999,7
1715668619991,CLRE 251,B00,511410,Mehta; Ravindra L.,9998,0,9999,1
1715668621017,CLRE 252,A00,507189,Cuomo; Raphael Eduardo,9994,0,9999,5
1715668622047,CLRE 253,A00,507199,Vaida; Florin,9994,0,9999,5
1715668622047,CLRE 253,B00,507202,Vaida; Florin,9999,0,9999,0
1715668623077,CLRE 259,A00,507211,Patel; Hemal,9996,0,9999,3
1715668624103,CLRE 260,A00,507221,Cuomo; Raphael Eduardo,9999,0,9999,0
1715668625131,CLRE 297,001,507242,Cuomo; Raphael Eduardo,9999,0,9999,0
1715668626159,COGS 197,001,638244,Voytek; Bradley Thomas,9997,0,9999,2
1715668627185,CSE 191,A00,516875,Minnes Kemp; Mor Mia,9991,0,9999,8
1715668628211,CSE 197,001,637388,Minnes Kemp; Mor Mia,9992,0,9999,7
1715668629239,CSS 201S,A01,494383,Mignozzetti; Umberto,35,0,35,0
1715668630263,CSS 202S,A01,494387,Mignozzetti; Umberto,35,0,35,0
1715668631291,DSC 197,001,628532,Eldridge; Justin Matthew,9995,0,9999,4
1715668632315,EAP 100,A00,516065,Staff,9799,0,9999,200
1715668633349,ECE 45,A01,507414,Staff,32,0,60,28
1715668635399,ECE 111,A01,507420,Staff,11,0,50,39
1715668636424,ECE 197,001,548057,Sievenpiper; Daniel F.,9991,0,9999,8
1715668637449,EDS 115,A00,507243,Choi; Bailey Miyeon,6,0,28,22
1715668638474,EDS 117,A01,494379,Staff,0,6,34,35
1715668639505,EDS 125,A00,507246,Hopkins; Megan Beth,7,0,30,23
1715668640536,EDS 128A,A01,507264,Fargason; Sharon Gayle,5,0,26,21
1715668641561,EDS 128B,A01,507293,Pappas; Elizabeth,9,0,30,21
1715668642600,EDS 139,A00,507294,Fargason; Sharon Gayle,9,0,30,21
1715668642600,EDS 139,B00,507313,Pappas; Elizabeth,9,0,30,21
1715668643627,EDS 201,A00,507315,Staff,10,0,30,20
1715668644657,EDS 203,A01,507317,Halter; Christopher P.,10,0,30,20
1715668645685,EDS 204R,A01,507319,Halter; Christopher P.,0,3,30,30
1715668645685,EDS 204R,B01,507331,Heinzman; Erica M.,14,0,30,16
1715668646712,EDS 206R,A00,507332,Staff,0,4,30,30
1715668646712,EDS 206R,B00,507343,Staff,15,0,30,15
1715668647738,EDS 250,A00,507344,Hemans; Patricia Ann Benitez,20,0,40,20
1715668648764,EDS 281,A00,507345,Daly; Alan J.,18,0,18,0
1715668649789,EDS 284,A00,507350,Daly; Alan J.,16,0,16,0
1715668650819,EDS 286,A00,507359,Fine; Sarah,18,0,18,0
1715668651844,EDS 289C,A01,507361,Daly; Alan J.,18,0,18,0
1715668652870,EDS 290,A00,507366,Hofstetter; Carolyn,15,0,15,0
1715668653901,LIGM 5A,A00,507421,Fischer-Grunski; Eva K,17,0,20,3
1715668654925,LIGM 5B,A00,507423,Fischer-Grunski; Eva K,19,0,20,1
1715668655950,LIGM 5C,A00,507425,Fischer-Grunski; Eva K,19,0,20,1
1715668656975,LIIT 5AS,A00,507427,Carnelos; Chiara,20,0,20,0
1715668657999,LIIT 5BS,A00,507430,Carnelos; Chiara,20,0,20,0
1715668659025,LIIT 5CS,A00,507432,Carnelos; Chiara,20,0,20,0
1715668660054,LISP 5A,A00,507541,Munoz Sanchez; Alicia,11,0,20,9
1715668661081,LISP 5B,A00,507671,Munoz Sanchez; Alicia,8,0,20,12
1715668662109,LISP 5C,A00,507696,Munoz Sanchez; Alicia,7,0,20,13
1715668663134,MAE 197,001,528363,Boechler; Nicholas Sebastia,9998,0,9999,1
1715668664161,MATH 197,001,523477,Kedlaya; Kiran S.,9994,0,9999,5
1715668664161,MATH 197,002,563811,Zhang; Danna,9994,0,9999,5
1715668664161,MATH 197,003,628552,Dumitriu; Ioana,9998,0,9999,1
1715668664161,MATH 197,004,660885,Floyd; Eric,9998,0,9999,1
1715668665193,MCWP 40R,A00,518780,Staff,1,0,20,19
1715668665193,MCWP 40R,B00,518781,Carter; Jennifer A,9,0,20,11
1715668665193,MCWP 40R,C00,518783,Smith; Haydee Marie,5,0,20,15
1715668666232,MCWP 50R,A00,518791,Redela; Pamela Morgan,0,1,20,20
1715668666232,MCWP 50R,B00,518792,Krone; Jarret,0,2,20,20
1715668666232,MCWP 50R,C00,518793,Staff,0,4,20,20
1715668666232,MCWP 50R,D00,518794,Morshed; Michael James,0,2,20,20
1715668666232,MCWP 50R,E00,518795,Carter; Andrea L,0,2,20,20
1715668666232,MCWP 50R,F00,518796,Miller; Elizabeth Deen,0,1,20,20
1715668666232,MCWP 50R,G00,518797,Guillen; Melinda,0,1,20,20
1715668667263,MMW 12R,A01,514034,Herbst; Matthew,0,2,16,16
1715668667263,MMW 12R,A02,514035,Herbst; Matthew,0,0,16,16
1715668668292,MMW 13R,A01,514037,Staff,0,5,16,16
1715668668292,MMW 13R,A02,514039,Staff,0,5,16,16
1715668668292,MMW 13R,A03,628519,Staff,0,4,16,16
1715668670346,SIO 295LS,A00,523233,Staff,10,0,30,20
1715668671372,SIO 295S,A00,523232,Staff,10,0,30,20
1715668672399,SIOC 290S,A01,637330,Merrifield; Mark A,21,0,30,9
1715668673425,SIOC 291S,A01,637333,Gabriel; Corey John,21,0,30,9
1715668674454,SOCI 117,A01,494376,Staff,0,5,5,5
1715668675481,WES 237B,A00,494380,Staff,10,0,20,10
1715668677551,AESE 279B,A00,494370,Wade; Jon P,0,0,33,33
1715668678577,AIP 97,001,660915,Van Den Einde; Yael Dahlia,9998,0,9999,1
1715668679611,AIP 197,001,627712,Vespa; Emanuel Ignacio,9995,0,9999,4
1715668679611,AIP 197,002,650778,Amir; On,9998,0,9999,1
1715668679611,AIP 197,003,650933,Avenancio-Leon; Carlos,9998,0,9999,1
1715668679611,AIP 197,004,658530,Heyman; Gail D.,9998,0,9999,1
1715668679611,AIP 197,005,658631,Neal; Sonya E,9998,0,9999,1
1715668679611,AIP 197,006,658671,Du; Songzi,9998,0,9999,1
1715668680637,ANAR 135S,A00,494369,Braswell; Geoffrey E.,0,0,0,0
1715668681661,BENG 196,001,628496,Engler; Adam J.,9998,0,9999,1
1715668681661,BENG 196,002,660916,Watson; John Thomas,9998,0,9999,1
1715668682687,BISP 197,001,650773,Wilhelm; James E.,9994,0,9999,5
1715668682687,BISP 197,002,658904,Coleman; Aaron B.,9998,0,9999,1
1715668683713,CAT 124RS,A01,519847,Geibel; William,0,0,20,20
1715668684741,CAT 125RS,A01,515971,Geibel; William,0,0,20,20
1715668685768,CLRE 250,A00,511389,Morris; Sheldon,9992,0,9999,7
1715668686795,CLRE 251,A00,507176,Mehta; Ravindra L.,9992,0,9999,7
1715668686795,CLRE 251,B00,511410,Mehta; Ravindra L.,9998,0,9999,1
1715668687825,CLRE 252,A00,507189,Cuomo; Raphael Eduardo,9994,0,9999,5
1715668688852,CLRE 253,A00,507199,Vaida; Florin,9994,0,9999,5
1715668688852,CLRE 253,B00,507202,Vaida; Florin,9999,0,9999,0
1715668689882,CLRE 259,A00,507211,Patel; Hemal,9996,0,9999,3
1715668690907,CLRE 260,A00,507221,Cuomo; Raphael Eduardo,9999,0,9999,0
1715668691933,CLRE 297,001,507242,Cuomo; Raphael Eduardo,9999,0,9999,0
1715668692961,COGS 197,001,638244,Voytek; Bradley Thomas,9997,0,9999,2
1715668693989,CSE 191,A00,516875,Minnes Kemp; Mor Mia,9991,0,9999,8
1715668695017,CSE 197,001,637388,Minnes Kemp; Mor Mia,9992,0,9999,7
1715668696046,CSS 201S,A01,494383,Mignozzetti; Umberto,35,0,35,0
1715668697072,CSS 202S,A01,494387,Mignozzetti; Umberto,35,0,35,0
1715668698100,DSC 197,001,628532,Eldridge; Justin Matthew,9995,0,9999,4
1715668699127,EAP 100,A00,516065,Staff,9799,0,9999,200
1715668700161,ECE 45,A01,507414,Staff,32,0,60,28
1715668702213,ECE 111,A01,507420,Staff,11,0,50,39
1715668703241,ECE 197,001,548057,Sievenpiper; Daniel F.,9991,0,9999,8
1715668704272,EDS 115,A00,507243,Choi; Bailey Miyeon,6,0,28,22
1715668705298,EDS 117,A01,494379,Staff,0,6,34,35
1715668706327,EDS 125,A00,507246,Hopkins; Megan Beth,7,0,30,23
1715668707352,EDS 128A,A01,507264,Fargason; Sharon Gayle,5,0,26,21
1715668708381,EDS 128B,A01,507293,Pappas; Elizabeth,9,0,30,21
1715668709406,EDS 139,A00,507294,Fargason; Sharon Gayle,9,0,30,21
1715668709406,EDS 139,B00,507313,Pappas; Elizabeth,9,0,30,21
1715668710431,EDS 201,A00,507315,Staff,10,0,30,20
1715668711457,EDS 203,A01,507317,Halter; Christopher P.,10,0,30,20
1715668712542,EDS 204R,A01,507319,Halter; Christopher P.,0,3,30,30
1715668712542,EDS 204R,B01,507331,Heinzman; Erica M.,14,0,30,16
1715668713592,EDS 206R,A00,507332,Staff,0,4,30,30
1715668713592,EDS 206R,B00,507343,Staff,15,0,30,15
1715668714619,EDS 250,A00,507344,Hemans; Patricia Ann Benitez,20,0,40,20
1715668715648,EDS 281,A00,507345,Daly; Alan J.,18,0,18,0
1715668716677,EDS 284,A00,507350,Daly; Alan J.,16,0,16,0
1715668717702,EDS 286,A00,507359,Fine; Sarah,18,0,18,0
1715668718732,EDS 289C,A01,507361,Daly; Alan J.,18,0,18,0
1715668719762,EDS 290,A00,507366,Hofstetter; Carolyn,15,0,15,0
1715668720792,LIGM 5A,A00,507421,Fischer-Grunski; Eva K,17,0,20,3
1715668721817,LIGM 5B,A00,507423,Fischer-Grunski; Eva K,19,0,20,1
1715668722846,LIGM 5C,A00,507425,Fischer-Grunski; Eva K,19,0,20,1
1715668723875,LIIT 5AS,A00,507427,Carnelos; Chiara,20,0,20,0
1715668724901,LIIT 5BS,A00,507430,Carnelos; Chiara,20,0,20,0
1715668725925,LIIT 5CS,A00,507432,Carnelos; Chiara,20,0,20,0
1715668726951,LISP 5A,A00,507541,Munoz Sanchez; Alicia,11,0,20,9
1715668727980,LISP 5B,A00,507671,Munoz Sanchez; Alicia,8,0,20,12
1715668729006,LISP 5C,A00,507696,Munoz Sanchez; Alicia,7,0,20,13
1715668730034,MAE 197,001,528363,Boechler; Nicholas Sebastia,9998,0,9999,1
1715668731066,MATH 197,001,523477,Kedlaya; Kiran S.,9994,0,9999,5
1715668731066,MATH 197,002,563811,Zhang; Danna,9994,0,9999,5
1715668731066,MATH 197,003,628552,Dumitriu; Ioana,9998,0,9999,1
1715668731066,MATH 197,004,660885,Floyd; Eric,9998,0,9999,1
1715668732102,MCWP 40R,A00,518780,Staff,1,0,20,19
1715668732102,MCWP 40R,B00,518781,Carter; Jennifer A,9,0,20,11
1715668732102,MCWP 40R,C00,518783,Smith; Haydee Marie,5,0,20,15
1715668733129,MCWP 50R,A00,518791,Redela; Pamela Morgan,0,1,20,20
1715668733129,MCWP 50R,B00,518792,Krone; Jarret,0,2,20,20
1715668733129,MCWP 50R,C00,518793,Staff,0,4,20,20
1715668733129,MCWP 50R,D00,518794,Morshed; Michael James,0,2,20,20
1715668733129,MCWP 50R,E00,518795,Carter; Andrea L,0,2,20,20
1715668733129,MCWP 50R,F00,518796,Miller; Elizabeth Deen,0,1,20,20
1715668733129,MCWP 50R,G00,518797,Guillen; Melinda,0,1,20,20
1715668734156,MMW 12R,A01,514034,Herbst; Matthew,0,2,16,16
1715668734156,MMW 12R,A02,514035,Herbst; Matthew,0,0,16,16
1715668735184,MMW 13R,A01,514037,Staff,0,5,16,16
1715668735184,MMW 13R,A02,514039,Staff,0,5,16,16
1715668735184,MMW 13R,A03,628519,Staff,0,4,16,16
1715668737237,SIO 295LS,A00,523233,Staff,10,0,30,20
1715668738262,SIO 295S,A00,523232,Staff,10,0,30,20
1715668739288,SIOC 290S,A01,637330,Merrifield; Mark A,21,0,30,9
1715668740317,SIOC 291S,A01,637333,Gabriel; Corey John,21,0,30,9
1715668741342,SOCI 117,A01,494376,Staff,0,5,5,5
1715668742369,WES 237B,A00,494380,Staff,10,0,20,10
1715668744436,AESE 279B,A00,494370,Wade; Jon P,0,0,33,33
1715668745466,AIP 97,001,660915,Van Den Einde; Yael Dahlia,9998,0,9999,1
1715668746495,AIP 197,001,627712,Vespa; Emanuel Ignacio,9995,0,9999,4
1715668746495,AIP 197,002,650778,Amir; On,9998,0,9999,1
1715668746495,AIP 197,003,650933,Avenancio-Leon; Carlos,9998,0,9999,1
1715668746495,AIP 197,004,658530,Heyman; Gail D.,9998,0,9999,1
1715668746495,AIP 197,005,658631,Neal; Sonya E,9998,0,9999,1
1715668746495,AIP 197,006,658671,Du; Songzi,9998,0,9999,1
1715668747522,ANAR 135S,A00,494369,Braswell; Geoffrey E.,0,0,0,0
1715668748547,BENG 196,001,628496,Engler; Adam J.,9998,0,9999,1
1715668748547,BENG 196,002,660916,Watson; John Thomas,9998,0,9999,1
1715668749574,BISP 197,001,650773,Wilhelm; James E.,9994,0,9999,5
1715668749574,BISP 197,002,658904,Coleman; Aaron B.,9998,0,9999,1
1715668750599,CAT 124RS,A01,519847,Geibel; William,0,0,20,20
1715668751624,CAT 125RS,A01,515971,Geibel; William,0,0,20,20
1715668752649,CLRE 250,A00,511389,Morris; Sheldon,9992,0,9999,7
1715668753674,CLRE 251,A00,507176,Mehta; Ravindra L.,9992,0,9999,7
1715668753674,CLRE 251,B00,511410,Mehta; Ravindra L.,9998,0,9999,1
1715668754700,CLRE 252,A00,507189,Cuomo; Raphael Eduardo,9994,0,9999,5
1715668755725,CLRE 253,A00,507199,Vaida; Florin,9994,0,9999,5
1715668755725,CLRE 253,B00,507202,Vaida; Florin,9999,0,9999,0
1715668756750,CLRE 259,A00,507211,Patel; Hemal,9996,0,9999,3
1715668757778,CLRE 260,A00,507221,Cuomo; Raphael Eduardo,9999,0,9999,0
1715668758806,CLRE 297,001,507242,Cuomo; Raphael Eduardo,9999,0,9999,0
1715668759833,COGS 197,001,638244,Voytek; Bradley Thomas,9997,0,9999,2
1715668760860,CSE 191,A00,516875,Minnes Kemp; Mor Mia,9991,0,9999,8
1715668761887,CSE 197,001,637388,Minnes Kemp; Mor Mia,9992,0,9999,7
1715668762919,CSS 201S,A01,494383,Mignozzetti; Umberto,35,0,35,0
1715668763945,CSS 202S,A01,494387,Mignozzetti; Umberto,35,0,35,0
1715668764976,DSC 197,001,628532,Eldridge; Justin Matthew,9995,0,9999,4
1715668766004,EAP 100,A00,516065,Staff,9799,0,9999,200
1715668767033,ECE 45,A01,507414,Staff,32,0,60,28
1715668769082,ECE 111,A01,507420,Staff,11,0,50,39
1715668770115,ECE 197,001,548057,Sievenpiper; Daniel F.,9991,0,9999,8
1715668771141,EDS 115,A00,507243,Choi; Bailey Miyeon,6,0,28,22
1715668772166,EDS 117,A01,494379,Staff,0,6,34,35
1715668773193,EDS 125,A00,507246,Hopkins; Megan Beth,7,0,30,23
1715668774218,EDS 128A,A01,507264,Fargason; Sharon Gayle,5,0,26,21
1715668775243,EDS 128B,A01,507293,Pappas; Elizabeth,9,0,30,21
1715668776272,EDS 139,A00,507294,Fargason; Sharon Gayle,9,0,30,21
1715668776272,EDS 139,B00,507313,Pappas; Elizabeth,9,0,30,21
1715668777299,EDS 201,A00,507315,Staff,10,0,30,20
1715668778326,EDS 203,A01,507317,Halter; Christopher P.,10,0,30,20
1715668779352,EDS 204R,A01,507319,Halter; Christopher P.,0,3,30,30
1715668779352,EDS 204R,B01,507331,Heinzman; Erica M.,14,0,30,16
1715668780377,EDS 206R,A00,507332,Staff,0,4,30,30
1715668780377,EDS 206R,B00,507343,Staff,15,0,30,15
1715668781405,EDS 250,A00,507344,Hemans; Patricia Ann Benitez,20,0,40,20
1715668782430,EDS 281,A00,507345,Daly; Alan J.,18,0,18,0
1715668783460,EDS 284,A00,507350,Daly; Alan J.,16,0,16,0
1715668784490,EDS 286,A00,507359,Fine; Sarah,18,0,18,0
1715668785514,EDS 289C,A01,507361,Daly; Alan J.,18,0,18,0
1715668786543,EDS 290,A00,507366,Hofstetter; Carolyn,15,0,15,0
1715668787570,LIGM 5A,A00,507421,Fischer-Grunski; Eva K,17,0,20,3
1715668788600,LIGM 5B,A00,507423,Fischer-Grunski; Eva K,19,0,20,1
1715668789629,LIGM 5C,A00,507425,Fischer-Grunski; Eva K,19,0,20,1
1715668790653,LIIT 5AS,A00,507427,Carnelos; Chiara,20,0,20,0
1715668791678,LIIT 5BS,A00,507430,Carnelos; Chiara,20,0,20,0
1715668792702,LIIT 5CS,A00,507432,Carnelos; Chiara,20,0,20,0
1715668793727,LISP 5A,A00,507541,Munoz Sanchez; Alicia,11,0,20,9
1715668794755,LISP 5B,A00,507671,Munoz Sanchez; Alicia,8,0,20,12
1715668795784,LISP 5C,A00,507696,Munoz Sanchez; Alicia,7,0,20,13
1715668796809,MAE 197,001,528363,Boechler; Nicholas Sebastia,9998,0,9999,1
1715668797841,MATH 197,001,523477,Kedlaya; Kiran S.,9994,0,9999,5
1715668797841,MATH 197,002,563811,Zhang; Danna,9994,0,9999,5
1715668797841,MATH 197,003,628552,Dumitriu; Ioana,9998,0,9999,1
1715668797841,MATH 197,004,660885,Floyd; Eric,9998,0,9999,1
1715668798868,MCWP 40R,A00,518780,Staff,1,0,20,19
1715668798868,MCWP 40R,B00,518781,Carter; Jennifer A,9,0,20,11
1715668798868,MCWP 40R,C00,518783,Smith; Haydee Marie,5,0,20,15
1715668799925,MCWP 50R,A00,518791,Redela; Pamela Morgan,0,1,20,20
1715668799925,MCWP 50R,B00,518792,Krone; Jarret,0,2,20,20
1715668799925,MCWP 50R,C00,518793,Staff,0,4,20,20
1715668799925,MCWP 50R,D00,518794,Morshed; Michael James,0,2,20,20
1715668799925,MCWP 50R,E00,518795,Carter; Andrea L,0,2,20,20
1715668799925,MCWP 50R,F00,518796,Miller; Elizabeth Deen,0,1,20,20
1715668799925,MCWP 50R,G00,518797,Guillen; Melinda,0,1,20,20
1715668800951,MMW 12R,A01,514034,Herbst; Matthew,0,2,16,16
1715668800951,MMW 12R,A02,514035,Herbst; Matthew,0,0,16,16
1715668801979,MMW 13R,A01,514037,Staff,0,5,16,16
1715668801979,MMW 13R,A02,514039,Staff,0,5,16,16
1715668801979,MMW 13R,A03,628519,Staff,0,4,16,16
1715668804033,SIO 295LS,A00,523233,Staff,10,0,30,20
1715668805062,SIO 295S,A00,523232,Staff,10,0,30,20
1715668806094,SIOC 290S,A01,637330,Merrifield; Mark A,21,0,30,9
1715668807125,SIOC 291S,A01,637333,Gabriel; Corey John,21,0,30,9
1715668808150,SOCI 117,A01,494376,Staff,0,5,5,5
1715668809178,WES 237B,A00,494380,Staff,10,0,20,10
1715668811249,AESE 279B,A00,494370,Wade; Jon P,0,0,33,33
1715668812279,AIP 97,001,660915,Van Den Einde; Yael Dahlia,9998,0,9999,1
1715668813319,AIP 197,001,627712,Vespa; Emanuel Ignacio,9995,0,9999,4
1715668813319,AIP 197,002,650778,Amir; On,9998,0,9999,1
1715668813319,AIP 197,003,650933,Avenancio-Leon; Carlos,9998,0,9999,1
1715668813319,AIP 197,004,658530,Heyman; Gail D.,9998,0,9999,1
1715668813319,AIP 197,005,658631,Neal; Sonya E,9998,0,9999,1
1715668813319,AIP 197,006,658671,Du; Songzi,9998,0,9999,1
1715668814347,ANAR 135S,A00,494369,Braswell; Geoffrey E.,0,0,0,0
1715668815374,BENG 196,001,628496,Engler; Adam J.,9998,0,9999,1
1715668815374,BENG 196,002,660916,Watson; John Thomas,9998,0,9999,1
1715668816401,BISP 197,001,650773,Wilhelm; James E.,9994,0,9999,5
1715668816401,BISP 197,002,658904,Coleman; Aaron B.,9998,0,9999,1
1715668817426,CAT 124RS,A01,519847,Geibel; William,0,0,20,20
1715668818454,CAT 125RS,A01,515971,Geibel; William,0,0,20,20
1715668819485,CLRE 250,A00,511389,Morris; Sheldon,9992,0,9999,7
1715668820510,CLRE 251,A00,507176,Mehta; Ravindra L.,9992,0,9999,7
1715668820510,CLRE 251,B00,511410,Mehta; Ravindra L.,9998,0,9999,1
1715668821536,CLRE 252,A00,507189,Cuomo; Raphael Eduardo,9994,0,9999,5
1715668822568,CLRE 253,A00,507199,Vaida; Florin,9994,0,9999,5
1715668822568,CLRE 253,B00,507202,Vaida; Florin,9999,0,9999,0
1715668823596,CLRE 259,A00,507211,Patel; Hemal,9996,0,9999,3
1715668824621,CLRE 260,A00,507221,Cuomo; Raphael Eduardo,9999,0,9999,0
1715668825646,CLRE 297,001,507242,Cuomo; Raphael Eduardo,9999,0,9999,0
1715668826675,COGS 197,001,638244,Voytek; Bradley Thomas,9997,0,9999,2
1715668827701,CSE 191,A00,516875,Minnes Kemp; Mor Mia,9991,0,9999,8
1715668828726,CSE 197,001,637388,Minnes Kemp; Mor Mia,9992,0,9999,7
1715668829752,CSS 201S,A01,494383,Mignozzetti; Umberto,35,0,35,0
1715668830784,CSS 202S,A01,494387,Mignozzetti; Umberto,35,0,35,0
1715668831813,DSC 197,001,628532,Eldridge; Justin Matthew,9995,0,9999,4
1715668832839,EAP 100,A00,516065,Staff,9799,0,9999,200
1715668833869,ECE 45,A01,507414,Staff,32,0,60,28
1715668835929,ECE 111,A01,507420,Staff,11,0,50,39
1715668836959,ECE 197,001,548057,Sievenpiper; Daniel F.,9991,0,9999,8
1715668837989,EDS 115,A00,507243,Choi; Bailey Miyeon,6,0,28,22
1715668839014,EDS 117,A01,494379,Staff,0,6,34,35
1715668840040,EDS 125,A00,507246,Hopkins; Megan Beth,7,0,30,23
1715668841067,EDS 128A,A01,507264,Fargason; Sharon Gayle,5,0,26,21
1715668842093,EDS 128B,A01,507293,Pappas; Elizabeth,9,0,30,21
1715668843123,EDS 139,A00,507294,Fargason; Sharon Gayle,9,0,30,21
1715668843123,EDS 139,B00,507313,Pappas; Elizabeth,9,0,30,21
1715668844148,EDS 201,A00,507315,Staff,10,0,30,20
1715668845177,EDS 203,A01,507317,Halter; Christopher P.,10,0,30,20
1715668846205,EDS 204R,A01,507319,Halter; Christopher P.,0,3,30,30
1715668846205,EDS 204R,B01,507331,Heinzman; Erica M.,14,0,30,16
1715668847231,EDS 206R,A00,507332,Staff,0,4,30,30
1715668847231,EDS 206R,B00,507343,Staff,15,0,30,15
1715668848257,EDS 250,A00,507344,Hemans; Patricia Ann Benitez,20,0,40,20
1715668849285,EDS 281,A00,507345,Daly; Alan J.,18,0,18,0
1715668850311,EDS 284,A00,507350,Daly; Alan J.,16,0,16,0
1715668851337,EDS 286,A00,507359,Fine; Sarah,18,0,18,0
1715668852367,EDS 289C,A01,507361,Daly; Alan J.,18,0,18,0
1715668853398,EDS 290,A00,507366,Hofstetter; Carolyn,15,0,15,0
1715668854429,LIGM 5A,A00,507421,Fischer-Grunski; Eva K,17,0,20,3
1715668855460,LIGM 5B,A00,507423,Fischer-Grunski; Eva K,19,0,20,1
1715668856487,LIGM 5C,A00,507425,Fischer-Grunski; Eva K,19,0,20,1
1715668857517,LIIT 5AS,A00,507427,Carnelos; Chiara,20,0,20,0
1715668858542,LIIT 5BS,A00,507430,Carnelos; Chiara,20,0,20,0
1715668859569,LIIT 5CS,A00,507432,Carnelos; Chiara,20,0,20,0
1715668860595,LISP 5A,A00,507541,Munoz Sanchez; Alicia,11,0,20,9
1715668861623,LISP 5B,A00,507671,Munoz Sanchez; Alicia,8,0,20,12
1715668862650,LISP 5C,A00,507696,Munoz Sanchez; Alicia,7,0,20,13
1715668863679,MAE 197,001,528363,Boechler; Nicholas Sebastia,9998,0,9999,1
1715668864717,MATH 197,001,523477,Kedlaya; Kiran S.,9994,0,9999,5
1715668864717,MATH 197,002,563811,Zhang; Danna,9994,0,9999,5
1715668864717,MATH 197,003,628552,Dumitriu; Ioana,9998,0,9999,1
1715668864717,MATH 197,004,660885,Floyd; Eric,9998,0,9999,1
1715668865744,MCWP 40R,A00,518780,Staff,1,0,20,19
1715668865744,MCWP 40R,B00,518781,Carter; Jennifer A,9,0,20,11
1715668865744,MCWP 40R,C00,518783,Smith; Haydee Marie,5,0,20,15
1715668866773,MCWP 50R,A00,518791,Redela; Pamela Morgan,0,1,20,20
1715668866773,MCWP 50R,B00,518792,Krone; Jarret,0,2,20,20
1715668866773,MCWP 50R,C00,518793,Staff,0,4,20,20
1715668866773,MCWP 50R,D00,518794,Morshed; Michael James,0,2,20,20
1715668866773,MCWP 50R,E00,518795,Carter; Andrea L,0,2,20,20
1715668866773,MCWP 50R,F00,518796,Miller; Elizabeth Deen,0,1,20,20
1715668866773,MCWP 50R,G00,518797,Guillen; Melinda,0,1,20,20
1715668867799,MMW 12R,A01,514034,Herbst; Matthew,0,2,16,16
1715668867799,MMW 12R,A02,514035,Herbst; Matthew,0,0,16,16
1715668868829,MMW 13R,A01,514037,Staff,0,5,16,16
1715668868829,MMW 13R,A02,514039,Staff,0,5,16,16
1715668868829,MMW 13R,A03,628519,Staff,0,4,16,16
1715668870880,SIO 295LS,A00,523233,Staff,10,0,30,20
1715668871906,SIO 295S,A00,523232,Staff,10,0,30,20
1715668872931,SIOC 290S,A01,637330,Merrifield; Mark A,21,0,30,9
1715668873959,SIOC 291S,A01,637333,Gabriel; Corey John,21,0,30,9
1715668874986,SOCI 117,A01,494376,Staff,0,5,5,5
1715668876012,WES 237B,A00,494380,Staff,10,0,20,10
1715668878088,AESE 279B,A00,494370,Wade; Jon P,0,0,33,33
1715668879114,AIP 97,001,660915,Van Den Einde; Yael Dahlia,9998,0,9999,1
1715668880143,AIP 197,001,627712,Vespa; Emanuel Ignacio,9995,0,9999,4
1715668880143,AIP 197,002,650778,Amir; On,9998,0,9999,1
1715668880143,AIP 197,003,650933,Avenancio-Leon; Carlos,9998,0,9999,1
1715668880143,AIP 197,004,658530,Heyman; Gail D.,9998,0,9999,1
1715668880143,AIP 197,005,658631,Neal; Sonya E,9998,0,9999,1
1715668880143,AIP 197,006,658671,Du; Songzi,9998,0,9999,1
1715668881171,ANAR 135S,A00,494369,Braswell; Geoffrey E.,0,0,0,0
1715668882200,BENG 196,001,628496,Engler; Adam J.,9998,0,9999,1
1715668882200,BENG 196,002,660916,Watson; John Thomas,9998,0,9999,1
1715668883230,BISP 197,001,650773,Wilhelm; James E.,9994,0,9999,5
1715668883230,BISP 197,002,658904,Coleman; Aaron B.,9998,0,9999,1
1715668884259,CAT 124RS,A01,519847,Geibel; William,0,0,20,20
1715668885284,CAT 125RS,A01,515971,Geibel; William,0,0,20,20
1715668886310,CLRE 250,A00,511389,Morris; Sheldon,9992,0,9999,7
1715668887342,CLRE 251,A00,507176,Mehta; Ravindra L.,9992,0,9999,7
1715668887342,CLRE 251,B00,511410,Mehta; Ravindra L.,9998,0,9999,1
1715668888373,CLRE 252,A00,507189,Cuomo; Raphael Eduardo,9994,0,9999,5
1715668889404,CLRE 253,A00,507199,Vaida; Florin,9994,0,9999,5
1715668889404,CLRE 253,B00,507202,Vaida; Florin,9999,0,9999,0
1715668890430,CLRE 259,A00,507211,Patel; Hemal,9996,0,9999,3
1715668891459,CLRE 260,A00,507221,Cuomo; Raphael Eduardo,9999,0,9999,0
1715668892483,CLRE 297,001,507242,Cuomo; Raphael Eduardo,9999,0,9999,0
1715668893512,COGS 197,001,638244,Voytek; Bradley Thomas,9997,0,9999,2
1715668894540,CSE 191,A00,516875,Minnes Kemp; Mor Mia,9991,0,9999,8
1715668895567,CSE 197,001,637388,Minnes Kemp; Mor Mia,9992,0,9999,7
1715668896593,CSS 201S,A01,494383,Mignozzetti; Umberto,35,0,35,0
1715668897621,CSS 202S,A01,494387,Mignozzetti; Umberto,35,0,35,0
1715668898648,DSC 197,001,628532,Eldridge; Justin Matthew,9995,0,9999,4
1715668899678,EAP 100,A00,516065,Staff,9799,0,9999,200
1715668900710,ECE 45,A01,507414,Staff,32,0,60,28
1715668902766,ECE 111,A01,507420,Staff,11,0,50,39
1715668903797,ECE 197,001,548057,Sievenpiper; Daniel F.,9991,0,9999,8
1715668904829,EDS 115,A00,507243,Choi; Bailey Miyeon,6,0,28,22
1715668905855,EDS 117,A01,494379,Staff,0,6,34,35
1715668906883,EDS 125,A00,507246,Hopkins; Megan Beth,7,0,30,23
1715668907911,EDS 128A,A01,507264,Fargason; Sharon Gayle,5,0,26,21
1715668908976,EDS 128B,A01,507293,Pappas; Elizabeth,9,0,30,21
1715668910004,EDS 139,A00,507294,Fargason; Sharon Gayle,9,0,30,21
1715668910004,EDS 139,B00,507313,Pappas; Elizabeth,9,0,30,21
1715668911032,EDS 201,A00,507315,Staff,10,0,30,20
1715668912060,EDS 203,A01,507317,Halter; Christopher P.,10,0,30,20
1715668913091,EDS 204R,A01,507319,Halter; Christopher P.,0,3,30,30
1715668913091,EDS 204R,B01,507331,Heinzman; Erica M.,14,0,30,16
1715668914120,EDS 206R,A00,507332,Staff,0,4,30,30
1715668914120,EDS 206R,B00,507343,Staff,15,0,30,15
1715668915147,EDS 250,A00,507344,Hemans; Patricia Ann Benitez,20,0,40,20
1715668916174,EDS 281,A00,507345,Daly; Alan J.,18,0,18,0
1715668917199,EDS 284,A00,507350,Daly; Alan J.,16,0,16,0
1715668918226,EDS 286,A00,507359,Fine; Sarah,18,0,18,0
1715668919252,EDS 289C,A01,507361,Daly; Alan J.,18,0,18,0
1715668920277,EDS 290,A00,507366,Hofstetter; Carolyn,15,0,15,0
1715668921303,LIGM 5A,A00,507421,Fischer-Grunski; Eva K,17,0,20,3
1715668922332,LIGM 5B,A00,507423,Fischer-Grunski; Eva K,19,0,20,1
1715668923364,LIGM 5C,A00,507425,Fischer-Grunski; Eva K,19,0,20,1
1715668924393,LIIT 5AS,A00,507427,Carnelos; Chiara,20,0,20,0
1715668925420,LIIT 5BS,A00,507430,Carnelos; Chiara,20,0,20,0
1715668926449,LIIT 5CS,A00,507432,Carnelos; Chiara,20,0,20,0
1715668927476,LISP 5A,A00,507541,Munoz Sanchez; Alicia,11,0,20,9
1715668928505,LISP 5B,A00,507671,Munoz Sanchez; Alicia,8,0,20,12
1715668929538,LISP 5C,A00,507696,Munoz Sanchez; Alicia,7,0,20,13
1715668930602,MAE 197,001,528363,Boechler; Nicholas Sebastia,9998,0,9999,1
1715668931629,MATH 197,001,523477,Kedlaya; Kiran S.,9994,0,9999,5
1715668931629,MATH 197,002,563811,Zhang; Danna,9994,0,9999,5
1715668931629,MATH 197,003,628552,Dumitriu; Ioana,9998,0,9999,1
1715668931629,MATH 197,004,660885,Floyd; Eric,9998,0,9999,1
1715668932655,MCWP 40R,A00,518780,Staff,1,0,20,19
1715668932655,MCWP 40R,B00,518781,Carter; Jennifer A,9,0,20,11
1715668932655,MCWP 40R,C00,518783,Smith; Haydee Marie,5,0,20,15
1715668933682,MCWP 50R,A00,518791,Redela; Pamela Morgan,0,1,20,20
1715668933682,MCWP 50R,B00,518792,Krone; Jarret,0,2,20,20
1715668933682,MCWP 50R,C00,518793,Staff,0,4,20,20
1715668933682,MCWP 50R,D00,518794,Morshed; Michael James,0,2,20,20
1715668933682,MCWP 50R,E00,518795,Carter; Andrea L,0,2,20,20
1715668933682,MCWP 50R,F00,518796,Miller; Elizabeth Deen,0,1,20,20
1715668933682,MCWP 50R,G00,518797,Guillen; Melinda,0,1,20,20
1715668934712,MMW 12R,A01,514034,Herbst; Matthew,0,2,16,16
1715668934712,MMW 12R,A02,514035,Herbst; Matthew,0,0,16,16
1715668935738,MMW 13R,A01,514037,Staff,0,5,16,16
1715668935738,MMW 13R,A02,514039,Staff,0,5,16,16
1715668935738,MMW 13R,A03,628519,Staff,0,4,16,16
1715668937790,SIO 295LS,A00,523233,Staff,10,0,30,20
1715668938816,SIO 295S,A00,523232,Staff,10,0,30,20
1715668939841,SIOC 290S,A01,637330,Merrifield; Mark A,21,0,30,9
1715668940867,SIOC 291S,A01,637333,Gabriel; Corey John,21,0,30,9
1715668941897,SOCI 117,A01,494376,Staff,0,5,5,5
1715668942924,WES 237B,A00,494380,Staff,10,0,20,10
1715668945000,AESE 279B,A00,494370,Wade; Jon P,0,0,33,33
1715668946029,AIP 97,001,660915,Van Den Einde; Yael Dahlia,9998,0,9999,1
1715668947069,AIP 197,001,627712,Vespa; Emanuel Ignacio,9995,0,9999,4
1715668947069,AIP 197,002,650778,Amir; On,9998,0,9999,1
1715668947069,AIP 197,003,650933,Avenancio-Leon; Carlos,9998,0,9999,1
1715668947069,AIP 197,004,658530,Heyman; Gail D.,9998,0,9999,1
1715668947069,AIP 197,005,658631,Neal; Sonya E,9998,0,9999,1
1715668947069,AIP 197,006,658671,Du; Songzi,9998,0,9999,1
1715668948097,ANAR 135S,A00,494369,Braswell; Geoffrey E.,0,0,0,0
1715668949124,BENG 196,001,628496,Engler; Adam J.,9998,0,9999,1
1715668949124,BENG 196,002,660916,Watson; John Thomas,9998,0,9999,1
1715668950157,BISP 197,001,650773,Wilhelm; James E.,9994,0,9999,5
1715668950157,BISP 197,002,658904,Coleman; Aaron B.,9998,0,9999,1
1715668951186,CAT 124RS,A01,519847,Geibel; William,0,0,20,20
1715668952211,CAT 125RS,A01,515971,Geibel; William,0,0,20,20
1715668953238,CLRE 250,A00,511389,Morris; Sheldon,9992,0,9999,7
1715668954265,CLRE 251,A00,507176,Mehta; Ravindra L.,9992,0,9999,7
1715668954265,CLRE 251,B00,511410,Mehta; Ravindra L.,9998,0,9999,1
1715668955296,CLRE 252,A00,507189,Cuomo; Raphael Eduardo,9994,0,9999,5
1715668956321,CLRE 253,A00,507199,Vaida; Florin,9994,0,9999,5
1715668956321,CLRE 253,B00,507202,Vaida; Florin,9999,0,9999,0
1715668957348,CLRE 259,A00,507211,Patel; Hemal,9996,0,9999,3
1715668958376,CLRE 260,A00,507221,Cuomo; Raphael Eduardo,9999,0,9999,0
1715668959404,CLRE 297,001,507242,Cuomo; Raphael Eduardo,9999,0,9999,0
1715668960434,COGS 197,001,638244,Voytek; Bradley Thomas,9997,0,9999,2
1715668961464,CSE 191,A00,516875,Minnes Kemp; Mor Mia,9991,0,9999,8
1715668962492,CSE 197,001,637388,Minnes Kemp; Mor Mia,9992,0,9999,7
1715668963519,CSS 201S,A01,494383,Mignozzetti; Umberto,35,0,35,0
1715668964544,CSS 202S,A01,494387,Mignozzetti; Umberto,35,0,35,0
1715668965574,DSC 197,001,628532,Eldridge; Justin Matthew,9995,0,9999,4
1715668966601,EAP 100,A00,516065,Staff,9799,0,9999,200
1715668967629,ECE 45,A01,507414,Staff,32,0,60,28
1715668969682,ECE 111,A01,507420,Staff,11,0,50,39
1715668970711,ECE 197,001,548057,Sievenpiper; Daniel F.,9991,0,9999,8
1715668971737,EDS 115,A00,507243,Choi; Bailey Miyeon,6,0,28,22
1715668972766,EDS 117,A01,494379,Staff,0,6,34,35
1715668973794,EDS 125,A00,507246,Hopkins; Megan Beth,7,0,30,23
1715668974819,EDS 128A,A01,507264,Fargason; Sharon Gayle,5,0,26,21
1715668975849,EDS 128B,A01,507293,Pappas; Elizabeth,9,0,30,21
1715668976874,EDS 139,A00,507294,Fargason; Sharon Gayle,9,0,30,21
1715668976874,EDS 139,B00,507313,Pappas; Elizabeth,9,0,30,21
1715668977899,EDS 201,A00,507315,Staff,10,0,30,20
1715668978925,EDS 203,A01,507317,Halter; Christopher P.,10,0,30,20
1715668979951,EDS 204R,A01,507319,Halter; Christopher P.,0,3,30,30
1715668979951,EDS 204R,B01,507331,Heinzman; Erica M.,14,0,30,16
1715668980977,EDS 206R,A00,507332,Staff,0,4,30,30
1715668980977,EDS 206R,B00,507343,Staff,15,0,30,15
1715668982008,EDS 250,A00,507344,Hemans; Patricia Ann Benitez,20,0,40,20
1715668983042,EDS 281,A00,507345,Daly; Alan J.,18,0,18,0
1715668984069,EDS 284,A00,507350,Daly; Alan J.,16,0,16,0
1715668985098,EDS 286,A00,507359,Fine; Sarah,18,0,18,0
1715668986123,EDS 289C,A01,507361,Daly; Alan J.,18,0,18,0
1715668987151,EDS 290,A00,507366,Hofstetter; Carolyn,15,0,15,0
1715668988178,LIGM 5A,A00,507421,Fischer-Grunski; Eva K,17,0,20,3
1715668989208,LIGM 5B,A00,507423,Fischer-Grunski; Eva K,19,0,20,1
1715668990234,LIGM 5C,A00,507425,Fischer-Grunski; Eva K,19,0,20,1
1715668991265,LIIT 5AS,A00,507427,Carnelos; Chiara,20,0,20,0
1715668992292,LIIT 5BS,A00,507430,Carnelos; Chiara,20,0,20,0
1715668993322,LIIT 5CS,A00,507432,Carnelos; Chiara,20,0,20,0
1715668994348,LISP 5A,A00,507541,Munoz Sanchez; Alicia,11,0,20,9
1715668995375,LISP 5B,A00,507671,Munoz Sanchez; Alicia,8,0,20,12
1715668996403,LISP 5C,A00,507696,Munoz Sanchez; Alicia,7,0,20,13
1715668997429,MAE 197,001,528363,Boechler; Nicholas Sebastia,9998,0,9999,1
1715668998455,MATH 197,001,523477,Kedlaya; Kiran S.,9994,0,9999,5
1715668998455,MATH 197,002,563811,Zhang; Danna,9994,0,9999,5
1715668998455,MATH 197,003,628552,Dumitriu; Ioana,9998,0,9999,1
1715668998455,MATH 197,004,660885,Floyd; Eric,9998,0,9999,1
1715668999484,MCWP 40R,A00,518780,Staff,1,0,20,19
1715668999484,MCWP 40R,B00,518781,Carter; Jennifer A,9,0,20,11
1715668999484,MCWP 40R,C00,518783,Smith; Haydee Marie,5,0,20,15
1715669000513,MCWP 50R,A00,518791,Redela; Pamela Morgan,0,1,20,20
1715669000513,MCWP 50R,B00,518792,Krone; Jarret,0,2,20,20
1715669000513,MCWP 50R,C00,518793,Staff,0,4,20,20
1715669000513,MCWP 50R,D00,518794,Morshed; Michael James,0,2,20,20
1715669000513,MCWP 50R,E00,518795,Carter; Andrea L,0,2,20,20
1715669000513,MCWP 50R,F00,518796,Miller; Elizabeth Deen,0,1,20,20
1715669000513,MCWP 50R,G00,518797,Guillen; Melinda,0,1,20,20
1715669001542,MMW 12R,A01,514034,Herbst; Matthew,0,2,16,16
1715669001542,MMW 12R,A02,514035,Herbst; Matthew,0,0,16,16
1715669002569,MMW 13R,A01,514037,Staff,0,5,16,16
1715669002569,MMW 13R,A02,514039,Staff,0,5,16,16
1715669002569,MMW 13R,A03,628519,Staff,0,4,16,16
1715669004624,SIO 295LS,A00,523233,Staff,10,0,30,20
1715669005650,SIO 295S,A00,523232,Staff,10,0,30,20
1715669006677,SIOC 290S,A01,637330,Merrifield; Mark A,21,0,30,9
1715669007709,SIOC 291S,A01,637333,Gabriel; Corey John,21,0,30,9
1715669008739,SOCI 117,A01,494376,Staff,0,5,5,5
1715669009765,WES 237B,A00,494380,Staff,10,0,20,10
1715669011835,AESE 279B,A00,494370,Wade; Jon P,0,0,33,33
1715669012865,AIP 97,001,660915,Van Den Einde; Yael Dahlia,9998,0,9999,1
1715669013892,AIP 197,001,627712,Vespa; Emanuel Ignacio,9995,0,9999,4
1715669013892,AIP 197,002,650778,Amir; On,9998,0,9999,1
1715669013892,AIP 197,003,650933,Avenancio-Leon; Carlos,9998,0,9999,1
1715669013892,AIP 197,004,658530,Heyman; Gail D.,9998,0,9999,1
1715669013892,AIP 197,005,658631,Neal; Sonya E,9998,0,9999,1
1715669013892,AIP 197,006,658671,Du; Songzi,9998,0,9999,1
1715669014919,ANAR 135S,A00,494369,Braswell; Geoffrey E.,0,0,0,0
1715669015944,BENG 196,001,628496,Engler; Adam J.,9998,0,9999,1
1715669015944,BENG 196,002,660916,Watson; John Thomas,9998,0,9999,1
1715669016975,BISP 197,001,650773,Wilhelm; James E.,9994,0,9999,5
1715669016975,BISP 197,002,658904,Coleman; Aaron B.,9998,0,9999,1
1715669017999,CAT 124RS,A01,519847,Geibel; William,0,0,20,20
1715669019028,CAT 125RS,A01,515971,Geibel; William,0,0,20,20
1715669020057,CLRE 250,A00,511389,Morris; Sheldon,9992,0,9999,7
1715669021083,CLRE 251,A00,507176,Mehta; Ravindra L.,9992,0,9999,7
1715669021083,CLRE 251,B00,511410,Mehta; Ravindra L.,9998,0,9999,1
1715669022108,CLRE 252,A00,507189,Cuomo; Raphael Eduardo,9994,0,9999,5
1715669023134,CLRE 253,A00,507199,Vaida; Florin,9994,0,9999,5
1715669023134,CLRE 253,B00,507202,Vaida; Florin,9999,0,9999,0
1715669024162,CLRE 259,A00,507211,Patel; Hemal,9996,0,9999,3
1715669025194,CLRE 260,A00,507221,Cuomo; Raphael Eduardo,9999,0,9999,0
1715669026219,CLRE 297,001,507242,Cuomo; Raphael Eduardo,9999,0,9999,0
1715669027251,COGS 197,001,638244,Voytek; Bradley Thomas,9997,0,9999,2
1715669028280,CSE 191,A00,516875,Minnes Kemp; Mor Mia,9991,0,9999,8
1715669029307,CSE 197,001,637388,Minnes Kemp; Mor Mia,9992,0,9999,7
1715669030334,CSS 201S,A01,494383,Mignozzetti; Umberto,35,0,35,0
1715669031359,CSS 202S,A01,494387,Mignozzetti; Umberto,35,0,35,0
1715669032388,DSC 197,001,628532,Eldridge; Justin Matthew,9995,0,9999,4
1715669033417,EAP 100,A00,516065,Staff,9799,0,9999,200
1715669034449,ECE 45,A01,507414,Staff,32,0,60,28
1715669036510,ECE 111,A01,507420,Staff,11,0,50,39
1715669037541,ECE 197,001,548057,Sievenpiper; Daniel F.,9991,0,9999,8
1715669038567,EDS 115,A00,507243,Choi; Bailey Miyeon,6,0,28,22
1715669039596,EDS 117,A01,494379,Staff,0,6,34,35
1715669040630,EDS 125,A00,507246,Hopkins; Megan Beth,7,0,30,23
1715669041660,EDS 128A,A01,507264,Fargason; Sharon Gayle,5,0,26,21
1715669042687,EDS 128B,A01,507293,Pappas; Elizabeth,9,0,30,21
1715669043717,EDS 139,A00,507294,Fargason; Sharon Gayle,9,0,30,21
1715669043717,EDS 139,B00,507313,Pappas; Elizabeth,9,0,30,21
1715669044745,EDS 201,A00,507315,Staff,10,0,30,20
1715669045772,EDS 203,A01,507317,Halter; Christopher P.,10,0,30,20
1715669046803,EDS 204R,A01,507319,Halter; Christopher P.,0,3,30,30
1715669046803,EDS 204R,B01,507331,Heinzman; Erica M.,14,0,30,16
1715669047829,EDS 206R,A00,507332,Staff,0,4,30,30
1715669047829,EDS 206R,B00,507343,Staff,15,0,30,15
1715669048857,EDS 250,A00,507344,Hemans; Patricia Ann Benitez,20,0,40,20
1715669049884,EDS 281,A00,507345,Daly; Alan J.,18,0,18,0
1715669050914,EDS 284,A00,507350,Daly; Alan J.,16,0,16,0
1715669051940,EDS 286,A00,507359,Fine; Sarah,18,0,18,0
1715669052967,EDS 289C,A01,507361,Daly; Alan J.,18,0,18,0
1715669053997,EDS 290,A00,507366,Hofstetter; Carolyn,15,0,15,0
1715669055030,LIGM 5A,A00,507421,Fischer-Grunski; Eva K,17,0,20,3
1715669056055,LIGM 5B,A00,507423,Fischer-Grunski; Eva K,19,0,20,1
1715669057086,LIGM 5C,A00,507425,Fischer-Grunski; Eva K,19,0,20,1
1715669058112,LIIT 5AS,A00,507427,Carnelos; Chiara,20,0,20,0
1715669059137,LIIT 5BS,A00,507430,Carnelos; Chiara,20,0,20,0
1715669060167,LIIT 5CS,A00,507432,Carnelos; Chiara,20,0,20,0
1715669061195,LISP 5A,A00,507541,Munoz Sanchez; Alicia,11,0,20,9
1715669062222,LISP 5B,A00,507671,Munoz Sanchez; Alicia,8,0,20,12
1715669063248,LISP 5C,A00,507696,Munoz Sanchez; Alicia,7,0,20,13
1715669064280,MAE 197,001,528363,Boechler; Nicholas Sebastia,9998,0,9999,1
1715669065312,MATH 197,001,523477,Kedlaya; Kiran S.,9994,0,9999,5
1715669065312,MATH 197,002,563811,Zhang; Danna,9994,0,9999,5
1715669065312,MATH 197,003,628552,Dumitriu; Ioana,9998,0,9999,1
1715669065312,MATH 197,004,660885,Floyd; Eric,9998,0,9999,1
1715669066343,MCWP 40R,A00,518780,Staff,1,0,20,19
1715669066343,MCWP 40R,B00,518781,Carter; Jennifer A,9,0,20,11
1715669066343,MCWP 40R,C00,518783,Smith; Haydee Marie,5,0,20,15
1715669067370,MCWP 50R,A00,518791,Redela; Pamela Morgan,0,1,20,20
1715669067370,MCWP 50R,B00,518792,Krone; Jarret,0,2,20,20
1715669067370,MCWP 50R,C00,518793,Staff,0,4,20,20
1715669067370,MCWP 50R,D00,518794,Morshed; Michael James,0,2,20,20
1715669067370,MCWP 50R,E00,518795,Carter; Andrea L,0,2,20,20
1715669067370,MCWP 50R,F00,518796,Miller; Elizabeth Deen,0,1,20,20
1715669067370,MCWP 50R,G00,518797,Guillen; Melinda,0,1,20,20
1715669068397,MMW 12R,A01,514034,Herbst; Matthew,0,2,16,16
1715669068397,MMW 12R,A02,514035,Herbst; Matthew,0,0,16,16
1715669069423,MMW 13R,A01,514037,Staff,0,5,16,16
1715669069423,MMW 13R,A02,514039,Staff,0,5,16,16
1715669069423,MMW 13R,A03,628519,Staff,0,4,16,16
1715669071477,SIO 295LS,A00,523233,Staff,10,0,30,20
1715669072507,SIO 295S,A00,523232,Staff,10,0,30,20
1715669073534,SIOC 290S,A01,637330,Merrifield; Mark A,21,0,30,9
1715669074561,SIOC 291S,A01,637333,Gabriel; Corey John,21,0,30,9
1715669075589,SOCI 117,A01,494376,Staff,0,5,5,5
1715669076614,WES 237B,A00,494380,Staff,10,0,20,10
1715669078685,AESE 279B,A00,494370,Wade; Jon P,0,0,33,33
1715669079711,AIP 97,001,660915,Van Den Einde; Yael Dahlia,9998,0,9999,1
1715669080739,AIP 197,001,627712,Vespa; Emanuel Ignacio,9995,0,9999,4
1715669080739,AIP 197,002,650778,Amir; On,9998,0,9999,1
1715669080739,AIP 197,003,650933,Avenancio-Leon; Carlos,9998,0,9999,1
1715669080739,AIP 197,004,658530,Heyman; Gail D.,9998,0,9999,1
1715669080739,AIP 197,005,658631,Neal; Sonya E,9998,0,9999,1
1715669080739,AIP 197,006,658671,Du; Songzi,9998,0,9999,1
1715669081771,ANAR 135S,A00,494369,Braswell; Geoffrey E.,0,0,0,0
1715669082803,BENG 196,001,628496,Engler; Adam J.,9998,0,9999,1
1715669082803,BENG 196,002,660916,Watson; John Thomas,9998,0,9999,1
1715669083829,BISP 197,001,650773,Wilhelm; James E.,9994,0,9999,5
1715669083829,BISP 197,002,658904,Coleman; Aaron B.,9998,0,9999,1
1715669084859,CAT 124RS,A01,519847,Geibel; William,0,0,20,20
1715669085887,CAT 125RS,A01,515971,Geibel; William,0,0,20,20
1715669086914,CLRE 250,A00,511389,Morris; Sheldon,9992,0,9999,7
1715669087949,CLRE 251,A00,507176,Mehta; Ravindra L.,9992,0,9999,7
1715669087949,CLRE 251,B00,511410,Mehta; Ravindra L.,9998,0,9999,1
1715669088973,CLRE 252,A00,507189,Cuomo; Raphael Eduardo,9994,0,9999,5
1715669089996,CLRE 253,A00,507199,Vaida; Florin,9994,0,9999,5
1715669089996,CLRE 253,B00,507202,Vaida; Florin,9999,0,9999,0
1715669091023,CLRE 259,A00,507211,Patel; Hemal,9996,0,9999,3
1715669092049,CLRE 260,A00,507221,Cuomo; Raphael Eduardo,9999,0,9999,0
1715669093077,CLRE 297,001,507242,Cuomo; Raphael Eduardo,9999,0,9999,0
1715669094102,COGS 197,001,638244,Voytek; Bradley Thomas,9997,0,9999,2
1715669095129,CSE 191,A00,516875,Minnes Kemp; Mor Mia,9991,0,9999,8
1715669096159,CSE 197,001,637388,Minnes Kemp; Mor Mia,9992,0,9999,7
1715669097192,CSS 201S,A01,494383,Mignozzetti; Umberto,35,0,35,0
1715669098221,CSS 202S,A01,494387,Mignozzetti; Umberto,35,0,35,0
1715669099247,DSC 197,001,628532,Eldridge; Justin Matthew,9995,0,9999,4
1715669100275,EAP 100,A00,516065,Staff,9799,0,9999,200
1715669101303,ECE 45,A01,507414,Staff,32,0,60,28
1715669103358,ECE 111,A01,507420,Staff,11,0,50,39
1715669104383,ECE 197,001,548057,Sievenpiper; Daniel F.,9991,0,9999,8
1715669105408,EDS 115,A00,507243,Choi; Bailey Miyeon,6,0,28,22
1715669106434,EDS 117,A01,494379,Staff,0,6,34,35
1715669107461,EDS 125,A00,507246,Hopkins; Megan Beth,7,0,30,23
1715669108487,EDS 128A,A01,507264,Fargason; Sharon Gayle,5,0,26,21
1715669109515,EDS 128B,A01,507293,Pappas; Elizabeth,9,0,30,21
1715669110544,EDS 139,A00,507294,Fargason; Sharon Gayle,9,0,30,21
1715669110544,EDS 139,B00,507313,Pappas; Elizabeth,9,0,30,21
1715669111574,EDS 201,A00,507315,Staff,10,0,30,20
1715669112601,EDS 203,A01,507317,Halter; Christopher P.,10,0,30,20
1715669113633,EDS 204R,A01,507319,Halter; Christopher P.,0,3,30,30
1715669113633,EDS 204R,B01,507331,Heinzman; Erica M.,14,0,30,16
1715669114658,EDS 206R,A00,507332,Staff,0,4,30,30
1715669114658,EDS 206R,B00,507343,Staff,15,0,30,15
1715669115688,EDS 250,A00,507344,Hemans; Patricia Ann Benitez,20,0,40,20
1715669116712,EDS 281,A00,507345,Daly; Alan J.,18,0,18,0
1715669117743,EDS 284,A00,507350,Daly; Alan J.,16,0,16,0
1715669118768,EDS 286,A00,507359,Fine; Sarah,18,0,18,0
1715669119797,EDS 289C,A01,507361,Daly; Alan J.,18,0,18,0
1715669120822,EDS 290,A00,507366,Hofstetter; Carolyn,15,0,15,0
1715669121851,LIGM 5A,A00,507421,Fischer-Grunski; Eva K,17,0,20,3
1715669122876,LIGM 5B,A00,507423,Fischer-Grunski; Eva K,19,0,20,1
1715669123902,LIGM 5C,A00,507425,Fischer-Grunski; Eva K,19,0,20,1
1715669124929,LIIT 5AS,A00,507427,Carnelos; Chiara,20,0,20,0
1715669125954,LIIT 5BS,A00,507430,Carnelos; Chiara,20,0,20,0
1715669126984,LIIT 5CS,A00,507432,Carnelos; Chiara,20,0,20,0
1715669128012,LISP 5A,A00,507541,Munoz Sanchez; Alicia,11,0,20,9
1715669129040,LISP 5B,A00,507671,Munoz Sanchez; Alicia,8,0,20,12
1715669130067,LISP 5C,A00,507696,Munoz Sanchez; Alicia,7,0,20,13
1715669131102,MAE 197,001,528363,Boechler; Nicholas Sebastia,9998,0,9999,1
1715669132131,MATH 197,001,523477,Kedlaya; Kiran S.,9994,0,9999,5
1715669132131,MATH 197,002,563811,Zhang; Danna,9994,0,9999,5
1715669132131,MATH 197,003,628552,Dumitriu; Ioana,9998,0,9999,1
1715669132131,MATH 197,004,660885,Floyd; Eric,9998,0,9999,1
1715669133159,MCWP 40R,A00,518780,Staff,1,0,20,19
1715669133159,MCWP 40R,B00,518781,Carter; Jennifer A,9,0,20,11
1715669133159,MCWP 40R,C00,518783,Smith; Haydee Marie,5,0,20,15
1715669134189,MCWP 50R,A00,518791,Redela; Pamela Morgan,0,1,20,20
1715669134189,MCWP 50R,B00,518792,Krone; Jarret,0,2,20,20
1715669134189,MCWP 50R,C00,518793,Staff,0,4,20,20
1715669134189,MCWP 50R,D00,518794,Morshed; Michael James,0,2,20,20
1715669134189,MCWP 50R,E00,518795,Carter; Andrea L,0,2,20,20
1715669134189,MCWP 50R,F00,518796,Miller; Elizabeth Deen,0,1,20,20
1715669134189,MCWP 50R,G00,518797,Guillen; Melinda,0,1,20,20
1715669135214,MMW 12R,A01,514034,Herbst; Matthew,0,2,16,16
1715669135214,MMW 12R,A02,514035,Herbst; Matthew,0,0,16,16
1715669136243,MMW 13R,A01,514037,Staff,0,5,16,16
1715669136243,MMW 13R,A02,514039,Staff,0,5,16,16
1715669136243,MMW 13R,A03,628519,Staff,0,4,16,16
1715669138296,SIO 295LS,A00,523233,Staff,10,0,30,20
1715669139321,SIO 295S,A00,523232,Staff,10,0,30,20
1715669140348,SIOC 290S,A01,637330,Merrifield; Mark A,21,0,30,9
1715669141380,SIOC 291S,A01,637333,Gabriel; Corey John,21,0,30,9
1715669142409,SOCI 117,A01,494376,Staff,0,5,5,5
1715669143437,WES 237B,A00,494380,Staff,10,0,20,10
1715669145508,AESE 279B,A00,494370,Wade; Jon P,0,0,33,33
1715669146534,AIP 97,001,660915,Van Den Einde; Yael Dahlia,9998,0,9999,1
1715669147570,AIP 197,001,627712,Vespa; Emanuel Ignacio,9995,0,9999,4
1715669147570,AIP 197,002,650778,Amir; On,9998,0,9999,1
1715669147570,AIP 197,003,650933,Avenancio-Leon; Carlos,9998,0,9999,1
1715669147570,AIP 197,004,658530,Heyman; Gail D.,9998,0,9999,1
1715669147570,AIP 197,005,658631,Neal; Sonya E,9998,0,9999,1
1715669147570,AIP 197,006,658671,Du; Songzi,9998,0,9999,1
1715669148604,ANAR 135S,A00,494369,Braswell; Geoffrey E.,0,0,0,0
1715669149634,BENG 196,001,628496,Engler; Adam J.,9998,0,9999,1
1715669149634,BENG 196,002,660916,Watson; John Thomas,9998,0,9999,1
1715669150670,BISP 197,001,650773,Wilhelm; James E.,9994,0,9999,5
1715669150670,BISP 197,002,658904,Coleman; Aaron B.,9998,0,9999,1
1715669151697,CAT 124RS,A01,519847,Geibel; William,0,0,20,20
1715669152722,CAT 125RS,A01,515971,Geibel; William,0,0,20,20
1715669153755,CLRE 250,A00,511389,Morris; Sheldon,9992,0,9999,7
1715669154785,CLRE 251,A00,507176,Mehta; Ravindra L.,9992,0,9999,7
1715669154785,CLRE 251,B00,511410,Mehta; Ravindra L.,9998,0,9999,1
1715669155810,CLRE 252,A00,507189,Cuomo; Raphael Eduardo,9994,0,9999,5
1715669156836,CLRE 253,A00,507199,Vaida; Florin,9994,0,9999,5
1715669156836,CLRE 253,B00,507202,Vaida; Florin,9999,0,9999,0
1715669157865,CLRE 259,A00,507211,Patel; Hemal,9996,0,9999,3
1715669158889,CLRE 260,A00,507221,Cuomo; Raphael Eduardo,9999,0,9999,0
1715669159913,CLRE 297,001,507242,Cuomo; Raphael Eduardo,9999,0,9999,0
1715669160938,COGS 197,001,638244,Voytek; Bradley Thomas,9997,0,9999,2
1715669161966,CSE 191,A00,516875,Minnes Kemp; Mor Mia,9991,0,9999,8
1715669163000,CSE 197,001,637388,Minnes Kemp; Mor Mia,9992,0,9999,7
1715669164026,CSS 201S,A01,494383,Mignozzetti; Umberto,35,0,35,0
1715669165056,CSS 202S,A01,494387,Mignozzetti; Umberto,35,0,35,0
1715669166085,DSC 197,001,628532,Eldridge; Justin Matthew,9995,0,9999,4
1715669167111,EAP 100,A00,516065,Staff,9799,0,9999,200
1715669168137,ECE 45,A01,507414,Staff,32,0,60,28
1715669170191,ECE 111,A01,507420,Staff,11,0,50,39
1715669171215,ECE 197,001,548057,Sievenpiper; Daniel F.,9991,0,9999,8
1715669172243,EDS 115,A00,507243,Choi; Bailey Miyeon,6,0,28,22
1715669173271,EDS 117,A01,494379,Staff,0,6,34,35
1715669174301,EDS 125,A00,507246,Hopkins; Megan Beth,7,0,30,23
1715669175327,EDS 128A,A01,507264,Fargason; Sharon Gayle,5,0,26,21
1715669176354,EDS 128B,A01,507293,Pappas; Elizabeth,9,0,30,21
1715669177385,EDS 139,A00,507294,Fargason; Sharon Gayle,9,0,30,21
1715669177385,EDS 139,B00,507313,Pappas; Elizabeth,9,0,30,21
1715669178413,EDS 201,A00,507315,Staff,10,0,30,20
1715669179444,EDS 203,A01,507317,Halter; Christopher P.,10,0,30,20
1715669180468,EDS 204R,A01,507319,Halter; Christopher P.,0,3,30,30
1715669180468,EDS 204R,B01,507331,Heinzman; Erica M.,14,0,30,16
1715669181492,EDS 206R,A00,507332,Staff,0,4,30,30
1715669181492,EDS 206R,B00,507343,Staff,15,0,30,15
1715669182518,EDS 250,A00,507344,Hemans; Patricia Ann Benitez,20,0,40,20
1715669183543,EDS 281,A00,507345,Daly; Alan J.,18,0,18,0
1715669184567,EDS 284,A00,507350,Daly; Alan J.,16,0,16,0
1715669185592,EDS 286,A00,507359,Fine; Sarah,18,0,18,0
1715669186621,EDS 289C,A01,507361,Daly; Alan J.,18,0,18,0
1715669187650,EDS 290,A00,507366,Hofstetter; Carolyn,15,0,15,0
1715669188677,LIGM 5A,A00,507421,Fischer-Grunski; Eva K,17,0,20,3
1715669189703,LIGM 5B,A00,507423,Fischer-Grunski; Eva K,19,0,20,1
1715669190739,LIGM 5C,A00,507425,Fischer-Grunski; Eva K,19,0,20,1
1715669191764,LIIT 5AS,A00,507427,Carnelos; Chiara,20,0,20,0
1715669192797,LIIT 5BS,A00,507430,Carnelos; Chiara,20,0,20,0
1715669193824,LIIT 5CS,A00,507432,Carnelos; Chiara,20,0,20,0
1715669194851,LISP 5A,A00,507541,Munoz Sanchez; Alicia,11,0,20,9
1715669195875,LISP 5B,A00,507671,Munoz Sanchez; Alicia,8,0,20,12
1715669196902,LISP 5C,A00,507696,Munoz Sanchez; Alicia,7,0,20,13
1715669197928,MAE 197,001,528363,Boechler; Nicholas Sebastia,9998,0,9999,1
1715669198955,MATH 197,001,523477,Kedlaya; Kiran S.,9994,0,9999,5
1715669198955,MATH 197,002,563811,Zhang; Danna,9994,0,9999,5
1715669198955,MATH 197,003,628552,Dumitriu; Ioana,9998,0,9999,1
1715669198955,MATH 197,004,660885,Floyd; Eric,9998,0,9999,1
1715669199990,MCWP 40R,A00,518780,Staff,1,0,20,19
1715669199990,MCWP 40R,B00,518781,Carter; Jennifer A,9,0,20,11
1715669199990,MCWP 40R,C00,518783,Smith; Haydee Marie,5,0,20,15
1715669201015,MCWP 50R,A00,518791,Redela; Pamela Morgan,0,1,20,20
1715669201015,MCWP 50R,B00,518792,Krone; Jarret,0,2,20,20
1715669201015,MCWP 50R,C00,518793,Staff,0,4,20,20
1715669201015,MCWP 50R,D00,518794,Morshed; Michael James,0,2,20,20
1715669201015,MCWP 50R,E00,518795,Carter; Andrea L,0,2,20,20
1715669201015,MCWP 50R,F00,518796,Miller; Elizabeth Deen,0,1,20,20
1715669201015,MCWP 50R,G00,518797,Guillen; Melinda,0,1,20,20
1715669202046,MMW 12R,A01,514034,Herbst; Matthew,0,2,16,16
1715669202046,MMW 12R,A02,514035,Herbst; Matthew,0,0,16,16
1715669203074,MMW 13R,A01,514037,Staff,0,5,16,16
1715669203074,MMW 13R,A02,514039,Staff,0,5,16,16
1715669203074,MMW 13R,A03,628519,Staff,0,4,16,16
1715669205133,SIO 295LS,A00,523233,Staff,10,0,30,20
1715669206158,SIO 295S,A00,523232,Staff,10,0,30,20
1715669207184,SIOC 290S,A01,637330,Merrifield; Mark A,21,0,30,9
1715669208213,SIOC 291S,A01,637333,Gabriel; Corey John,21,0,30,9
1715669209239,SOCI 117,A01,494376,Staff,0,5,5,5
1715669210266,WES 237B,A00,494380,Staff,10,0,20,10
1715669212337,AESE 279B,A00,494370,Wade; Jon P,0,0,33,33
1715669213364,AIP 97,001,660915,Van Den Einde; Yael Dahlia,9998,0,9999,1
1715669214391,AIP 197,001,627712,Vespa; Emanuel Ignacio,9995,0,9999,4
1715669214391,AIP 197,002,650778,Amir; On,9998,0,9999,1
1715669214391,AIP 197,003,650933,Avenancio-Leon; Carlos,9998,0,9999,1
1715669214391,AIP 197,004,658530,Heyman; Gail D.,9998,0,9999,1
1715669214391,AIP 197,005,658631,Neal; Sonya E,9998,0,9999,1
1715669214391,AIP 197,006,658671,Du; Songzi,9998,0,9999,1
1715669215417,ANAR 135S,A00,494369,Braswell; Geoffrey E.,0,0,0,0
1715669216443,BENG 196,001,628496,Engler; Adam J.,9998,0,9999,1
1715669216443,BENG 196,002,660916,Watson; John Thomas,9998,0,9999,1
1715669217468,BISP 197,001,650773,Wilhelm; James E.,9994,0,9999,5
1715669217468,BISP 197,002,658904,Coleman; Aaron B.,9998,0,9999,1
1715669218493,CAT 124RS,A01,519847,Geibel; William,0,0,20,20
1715669219518,CAT 125RS,A01,515971,Geibel; William,0,0,20,20
1715669220549,CLRE 250,A00,511389,Morris; Sheldon,9992,0,9999,7
1715669221581,CLRE 251,A00,507176,Mehta; Ravindra L.,9992,0,9999,7
1715669221581,CLRE 251,B00,511410,Mehta; Ravindra L.,9998,0,9999,1
1715669222611,CLRE 252,A00,507189,Cuomo; Raphael Eduardo,9994,0,9999,5
1715669223645,CLRE 253,A00,507199,Vaida; Florin,9994,0,9999,5
1715669223645,CLRE 253,B00,507202,Vaida; Florin,9999,0,9999,0
1715669224670,CLRE 259,A00,507211,Patel; Hemal,9996,0,9999,3
1715669225699,CLRE 260,A00,507221,Cuomo; Raphael Eduardo,9999,0,9999,0
1715669226728,CLRE 297,001,507242,Cuomo; Raphael Eduardo,9999,0,9999,0
1715669227758,COGS 197,001,638244,Voytek; Bradley Thomas,9997,0,9999,2
1715669228784,CSE 191,A00,516875,Minnes Kemp; Mor Mia,9991,0,9999,8
1715669229809,CSE 197,001,637388,Minnes Kemp; Mor Mia,9992,0,9999,7
1715669230836,CSS 201S,A01,494383,Mignozzetti; Umberto,35,0,35,0
1715669231863,CSS 202S,A01,494387,Mignozzetti; Umberto,35,0,35,0
1715669232888,DSC 197,001,628532,Eldridge; Justin Matthew,9995,0,9999,4
1715669233915,EAP 100,A00,516065,Staff,9799,0,9999,200
1715669234942,ECE 45,A01,507414,Staff,32,0,60,28
1715669236992,ECE 111,A01,507420,Staff,11,0,50,39
1715669238022,ECE 197,001,548057,Sievenpiper; Daniel F.,9991,0,9999,8
1715669239053,EDS 115,A00,507243,Choi; Bailey Miyeon,6,0,28,22
1715669240084,EDS 117,A01,494379,Staff,0,6,34,35
1715669241110,EDS 125,A00,507246,Hopkins; Megan Beth,7,0,30,23
1715669242137,EDS 128A,A01,507264,Fargason; Sharon Gayle,5,0,26,21
1715669243164,EDS 128B,A01,507293,Pappas; Elizabeth,9,0,30,21
1715669244189,EDS 139,A00,507294,Fargason; Sharon Gayle,9,0,30,21
1715669244189,EDS 139,B00,507313,Pappas; Elizabeth,9,0,30,21
1715669245216,EDS 201,A00,507315,Staff,10,0,30,20
1715669246246,EDS 203,A01,507317,Halter; Christopher P.,10,0,30,20
1715669247272,EDS 204R,A01,507319,Halter; Christopher P.,0,3,30,30
1715669247272,EDS 204R,B01,507331,Heinzman; Erica M.,14,0,30,16
1715669248300,EDS 206R,A00,507332,Staff,0,4,30,30
1715669248300,EDS 206R,B00,507343,Staff,15,0,30,15
1715669249323,EDS 250,A00,507344,Hemans; Patricia Ann Benitez,20,0,40,20
1715669250349,EDS 281,A00,507345,Daly; Alan J.,18,0,18,0
1715669251374,EDS 284,A00,507350,Daly; Alan J.,16,0,16,0
1715669252403,EDS 286,A00,507359,Fine; Sarah,18,0,18,0
1715669253429,EDS 289C,A01,507361,Daly; Alan J.,18,0,18,0
1715669254457,EDS 290,A00,507366,Hofstetter; Carolyn,15,0,15,0
1715669255482,LIGM 5A,A00,507421,Fischer-Grunski; Eva K,17,0,20,3
1715669256509,LIGM 5B,A00,507423,Fischer-Grunski; Eva K,19,0,20,1
1715669257535,LIGM 5C,A00,507425,Fischer-Grunski; Eva K,19,0,20,1
1715669258565,LIIT 5AS,A00,507427,Carnelos; Chiara,20,0,20,0
1715669259594,LIIT 5BS,A00,507430,Carnelos; Chiara,20,0,20,0
1715669260621,LIIT 5CS,A00,507432,Carnelos; Chiara,20,0,20,0
1715669261648,LISP 5A,A00,507541,Munoz Sanchez; Alicia,11,0,20,9
1715669262673,LISP 5B,A00,507671,Munoz Sanchez; Alicia,8,0,20,12
1715669263699,LISP 5C,A00,507696,Munoz Sanchez; Alicia,7,0,20,13
1715669264729,MAE 197,001,528363,Boechler; Nicholas Sebastia,9998,0,9999,1
1715669265760,MATH 197,001,523477,Kedlaya; Kiran S.,9994,0,9999,5
1715669265760,MATH 197,002,563811,Zhang; Danna,9994,0,9999,5
1715669265760,MATH 197,003,628552,Dumitriu; Ioana,9998,0,9999,1
1715669265760,MATH 197,004,660885,Floyd; Eric,9998,0,9999,1
1715669266784,MCWP 40R,A00,518780,Staff,1,0,20,19
1715669266784,MCWP 40R,B00,518781,Carter; Jennifer A,9,0,20,11
1715669266784,MCWP 40R,C00,518783,Smith; Haydee Marie,5,0,20,15
1715669267817,MCWP 50R,A00,518791,Redela; Pamela Morgan,0,1,20,20
1715669267817,MCWP 50R,B00,518792,Krone; Jarret,0,2,20,20
1715669267817,MCWP 50R,C00,518793,Staff,0,4,20,20
1715669267817,MCWP 50R,D00,518794,Morshed; Michael James,0,2,20,20
1715669267817,MCWP 50R,E00,518795,Carter; Andrea L,0,2,20,20
1715669267817,MCWP 50R,F00,518796,Miller; Elizabeth Deen,0,1,20,20
1715669267817,MCWP 50R,G00,518797,Guillen; Melinda,0,1,20,20
1715669268845,MMW 12R,A01,514034,Herbst; Matthew,0,2,16,16
1715669268845,MMW 12R,A02,514035,Herbst; Matthew,0,0,16,16
1715669269874,MMW 13R,A01,514037,Staff,0,5,16,16
1715669269874,MMW 13R,A02,514039,Staff,0,5,16,16
1715669269874,MMW 13R,A03,628519,Staff,0,4,16,16
1715669271924,SIO 295LS,A00,523233,Staff,10,0,30,20
1715669272951,SIO 295S,A00,523232,Staff,10,0,30,20
1715669273977,SIOC 290S,A01,637330,Merrifield; Mark A,21,0,30,9
1715669275009,SIOC 291S,A01,637333,Gabriel; Corey John,21,0,30,9
1715669276036,SOCI 117,A01,494376,Staff,0,5,5,5
1715669277061,WES 237B,A00,494380,Staff,10,0,20,10
1715669279138,AESE 279B,A00,494370,Wade; Jon P,0,0,33,33
1715669280163,AIP 97,001,660915,Van Den Einde; Yael Dahlia,9998,0,9999,1
1715669281190,AIP 197,001,627712,Vespa; Emanuel Ignacio,9995,0,9999,4
1715669281190,AIP 197,002,650778,Amir; On,9998,0,9999,1
1715669281190,AIP 197,003,650933,Avenancio-Leon; Carlos,9998,0,9999,1
1715669281190,AIP 197,004,658530,Heyman; Gail D.,9998,0,9999,1
1715669281190,AIP 197,005,658631,Neal; Sonya E,9998,0,9999,1
1715669281190,AIP 197,006,658671,Du; Songzi,9998,0,9999,1
1715669282214,ANAR 135S,A00,494369,Braswell; Geoffrey E.,0,0,0,0
1715669283248,BENG 196,001,628496,Engler; Adam J.,9998,0,9999,1
1715669283248,BENG 196,002,660916,Watson; John Thomas,9998,0,9999,1
1715669284274,BISP 197,001,650773,Wilhelm; James E.,9994,0,9999,5
1715669284274,BISP 197,002,658904,Coleman; Aaron B.,9998,0,9999,1
1715669285303,CAT 124RS,A01,519847,Geibel; William,0,0,20,20
1715669286332,CAT 125RS,A01,515971,Geibel; William,0,0,20,20
1715669287357,CLRE 250,A00,511389,Morris; Sheldon,9992,0,9999,7
1715669288382,CLRE 251,A00,507176,Mehta; Ravindra L.,9992,0,9999,7
1715669288382,CLRE 251,B00,511410,Mehta; Ravindra L.,9998,0,9999,1
1715669289410,CLRE 252,A00,507189,Cuomo; Raphael Eduardo,9994,0,9999,5
1715669290435,CLRE 253,A00,507199,Vaida; Florin,9994,0,9999,5
1715669290435,CLRE 253,B00,507202,Vaida; Florin,9999,0,9999,0
1715669291460,CLRE 259,A00,507211,Patel; Hemal,9996,0,9999,3
1715669292484,CLRE 260,A00,507221,Cuomo; Raphael Eduardo,9999,0,9999,0
1715669293516,CLRE 297,001,507242,Cuomo; Raphael Eduardo,9999,0,9999,0
1715669294541,COGS 197,001,638244,Voytek; Bradley Thomas,9997,0,9999,2
1715669295566,CSE 191,A00,516875,Minnes Kemp; Mor Mia,9991,0,9999,8
1715669296591,CSE 197,001,637388,Minnes Kemp; Mor Mia,9992,0,9999,7
1715669297616,CSS 201S,A01,494383,Mignozzetti; Umberto,35,0,35,0
1715669298647,CSS 202S,A01,494387,Mignozzetti; Umberto,35,0,35,0
1715669299671,DSC 197,001,628532,Eldridge; Justin Matthew,9995,0,9999,4
1715669300695,EAP 100,A00,516065,Staff,9799,0,9999,200
1715669301722,ECE 45,A01,507414,Staff,32,0,60,28
1715669303775,ECE 111,A01,507420,Staff,11,0,50,39
1715669304800,ECE 197,001,548057,Sievenpiper; Daniel F.,9991,0,9999,8
1715669305826,EDS 115,A00,507243,Choi; Bailey Miyeon,6,0,28,22
1715669306852,EDS 117,A01,494379,Staff,0,6,34,35
1715669307880,EDS 125,A00,507246,Hopkins; Megan Beth,7,0,30,23
1715669308906,EDS 128A,A01,507264,Fargason; Sharon Gayle,5,0,26,21
1715669309931,EDS 128B,A01,507293,Pappas; Elizabeth,9,0,30,21
1715669310957,EDS 139,A00,507294,Fargason; Sharon Gayle,9,0,30,21
1715669310957,EDS 139,B00,507313,Pappas; Elizabeth,9,0,30,21
1715669311982,EDS 201,A00,507315,Staff,10,0,30,20
1715669313011,EDS 203,A01,507317,Halter; Christopher P.,10,0,30,20
1715669314042,EDS 204R,A01,507319,Halter; Christopher P.,0,3,30,30
1715669314042,EDS 204R,B01,507331,Heinzman; Erica M.,14,0,30,16
1715669315073,EDS 206R,A00,507332,Staff,0,4,30,30
1715669315073,EDS 206R,B00,507343,Staff,15,0,30,15
1715669316099,EDS 250,A00,507344,Hemans; Patricia Ann Benitez,20,0,40,20
1715669317128,EDS 281,A00,507345,Daly; Alan J.,18,0,18,0
1715669318153,EDS 284,A00,507350,Daly; Alan J.,16,0,16,0
1715669319179,EDS 286,A00,507359,Fine; Sarah,18,0,18,0
1715669320203,EDS 289C,A01,507361,Daly; Alan J.,18,0,18,0
1715669321230,EDS 290,A00,507366,Hofstetter; Carolyn,15,0,15,0
1715669322371,LIGM 5A,A00,507421,Fischer-Grunski; Eva K,17,0,20,3
1715669323394,LIGM 5B,A00,507423,Fischer-Grunski; Eva K,19,0,20,1
1715669324420,LIGM 5C,A00,507425,Fischer-Grunski; Eva K,19,0,20,1
1715669325447,LIIT 5AS,A00,507427,Carnelos; Chiara,20,0,20,0
1715669326477,LIIT 5BS,A00,507430,Carnelos; Chiara,20,0,20,0
1715669327502,LIIT 5CS,A00,507432,Carnelos; Chiara,20,0,20,0
1715669328528,LISP 5A,A00,507541,Munoz Sanchez; Alicia,11,0,20,9
1715669329559,LISP 5B,A00,507671,Munoz Sanchez; Alicia,8,0,20,12
1715669330587,LISP 5C,A00,507696,Munoz Sanchez; Alicia,7,0,20,13
1715669331611,MAE 197,001,528363,Boechler; Nicholas Sebastia,9998,0,9999,1
1715669332642,MATH 197,001,523477,Kedlaya; Kiran S.,9994,0,9999,5
1715669332642,MATH 197,002,563811,Zhang; Danna,9994,0,9999,5
1715669332642,MATH 197,003,628552,Dumitriu; Ioana,9998,0,9999,1
1715669332642,MATH 197,004,660885,Floyd; Eric,9998,0,9999,1
1715669333673,MCWP 40R,A00,518780,Staff,1,0,20,19
1715669333673,MCWP 40R,B00,518781,Carter; Jennifer A,9,0,20,11
1715669333673,MCWP 40R,C00,518783,Smith; Haydee Marie,5,0,20,15
1715669334699,MCWP 50R,A00,518791,Redela; Pamela Morgan,0,1,20,20
1715669334699,MCWP 50R,B00,518792,Krone; Jarret,0,2,20,20
1715669334699,MCWP 50R,C00,518793,Staff,0,4,20,20
1715669334699,MCWP 50R,D00,518794,Morshed; Michael James,0,2,20,20
1715669334699,MCWP 50R,E00,518795,Carter; Andrea L,0,2,20,20
1715669334699,MCWP 50R,F00,518796,Miller; Elizabeth Deen,0,1,20,20
1715669334699,MCWP 50R,G00,518797,Guillen; Melinda,0,1,20,20
1715669335722,MMW 12R,A01,514034,Herbst; Matthew,0,2,16,16
1715669335722,MMW 12R,A02,514035,Herbst; Matthew,0,0,16,16
1715669336748,MMW 13R,A01,514037,Staff,0,5,16,16
1715669336748,MMW 13R,A02,514039,Staff,0,5,16,16
1715669336748,MMW 13R,A03,628519,Staff,0,4,16,16
1715669338799,SIO 295LS,A00,523233,Staff,10,0,30,20
1715669339828,SIO 295S,A00,523232,Staff,10,0,30,20
1715669340855,SIOC 290S,A01,637330,Merrifield; Mark A,21,0,30,9
1715669341882,SIOC 291S,A01,637333,Gabriel; Corey John,21,0,30,9
1715669342914,SOCI 117,A01,494376,Staff,0,5,5,5
1715669343944,WES 237B,A00,494380,Staff,10,0,20,10
1715669346030,AESE 279B,A00,494370,Wade; Jon P,0,0,33,33
1715669347056,AIP 97,001,660915,Van Den Einde; Yael Dahlia,9998,0,9999,1
1715669348085,AIP 197,001,627712,Vespa; Emanuel Ignacio,9995,0,9999,4
1715669348085,AIP 197,002,650778,Amir; On,9998,0,9999,1
1715669348085,AIP 197,003,650933,Avenancio-Leon; Carlos,9998,0,9999,1
1715669348085,AIP 197,004,658530,Heyman; Gail D.,9998,0,9999,1
1715669348085,AIP 197,005,658631,Neal; Sonya E,9998,0,9999,1
1715669348085,AIP 197,006,658671,Du; Songzi,9998,0,9999,1
1715669349110,ANAR 135S,A00,494369,Braswell; Geoffrey E.,0,0,0,0
1715669350136,BENG 196,001,628496,Engler; Adam J.,9998,0,9999,1
1715669350136,BENG 196,002,660916,Watson; John Thomas,9998,0,9999,1
1715669351161,BISP 197,001,650773,Wilhelm; James E.,9994,0,9999,5
1715669351161,BISP 197,002,658904,Coleman; Aaron B.,9998,0,9999,1
1715669352185,CAT 124RS,A01,519847,Geibel; William,0,0,20,20
1715669353210,CAT 125RS,A01,515971,Geibel; William,0,0,20,20
1715669354240,CLRE 250,A00,511389,Morris; Sheldon,9992,0,9999,7
1715669355272,CLRE 251,A00,507176,Mehta; Ravindra L.,9992,0,9999,7
1715669355272,CLRE 251,B00,511410,Mehta; Ravindra L.,9998,0,9999,1
1715669356298,CLRE 252,A00,507189,Cuomo; Raphael Eduardo,9994,0,9999,5
1715669357323,CLRE 253,A00,507199,Vaida; Florin,9994,0,9999,5
1715669357323,CLRE 253,B00,507202,Vaida; Florin,9999,0,9999,0
1715669358348,CLRE 259,A00,507211,Patel; Hemal,9996,0,9999,3
1715669359375,CLRE 260,A00,507221,Cuomo; Raphael Eduardo,9999,0,9999,0
1715669360400,CLRE 297,001,507242,Cuomo; Raphael Eduardo,9999,0,9999,0
1715669361427,COGS 197,001,638244,Voytek; Bradley Thomas,9997,0,9999,2
1715669362457,CSE 191,A00,516875,Minnes Kemp; Mor Mia,9991,0,9999,8
1715669363488,CSE 197,001,637388,Minnes Kemp; Mor Mia,9992,0,9999,7
1715669364515,CSS 201S,A01,494383,Mignozzetti; Umberto,35,0,35,0
1715669365544,CSS 202S,A01,494387,Mignozzetti; Umberto,35,0,35,0
1715669366569,DSC 197,001,628532,Eldridge; Justin Matthew,9995,0,9999,4
1715669367594,EAP 100,A00,516065,Staff,9799,0,9999,200
1715669368622,ECE 45,A01,507414,Staff,32,0,60,28
1715669370677,ECE 111,A01,507420,Staff,11,0,50,39
1715669371706,ECE 197,001,548057,Sievenpiper; Daniel F.,9991,0,9999,8
1715669372733,EDS 115,A00,507243,Choi; Bailey Miyeon,6,0,28,22
1715669373763,EDS 117,A01,494379,Staff,0,6,34,35
1715669374793,EDS 125,A00,507246,Hopkins; Megan Beth,7,0,30,23
1715669375822,EDS 128A,A01,507264,Fargason; Sharon Gayle,5,0,26,21
1715669376848,EDS 128B,A01,507293,Pappas; Elizabeth,9,0,30,21
1715669377872,EDS 139,A00,507294,Fargason; Sharon Gayle,9,0,30,21
1715669377872,EDS 139,B00,507313,Pappas; Elizabeth,9,0,30,21
1715669378899,EDS 201,A00,507315,Staff,10,0,30,20
1715669379926,EDS 203,A01,507317,Halter; Christopher P.,10,0,30,20
1715669380951,EDS 204R,A01,507319,Halter; Christopher P.,0,3,30,30
1715669380951,EDS 204R,B01,507331,Heinzman; Erica M.,14,0,30,16
1715669381980,EDS 206R,A00,507332,Staff,0,4,30,30
1715669381980,EDS 206R,B00,507343,Staff,15,0,30,15
1715669383006,EDS 250,A00,507344,Hemans; Patricia Ann Benitez,20,0,40,20
1715669384055,EDS 281,A00,507345,Daly; Alan J.,18,0,18,0
1715669385080,EDS 284,A00,507350,Daly; Alan J.,16,0,16,0
1715669386106,EDS 286,A00,507359,Fine; Sarah,18,0,18,0
1715669387133,EDS 289C,A01,507361,Daly; Alan J.,18,0,18,0
1715669388160,EDS 290,A00,507366,Hofstetter; Carolyn,15,0,15,0
1715669389371,LIGM 5A,A00,507421,Fischer-Grunski; Eva K,17,0,20,3
1715669390403,LIGM 5B,A00,507423,Fischer-Grunski; Eva K,19,0,20,1
1715669391428,LIGM 5C,A00,507425,Fischer-Grunski; Eva K,19,0,20,1
1715669392454,LIIT 5AS,A00,507427,Carnelos; Chiara,20,0,20,0
1715669393486,LIIT 5BS,A00,507430,Carnelos; Chiara,20,0,20,0
1715669394512,LIIT 5CS,A00,507432,Carnelos; Chiara,20,0,20,0
1715669395538,LISP 5A,A00,507541,Munoz Sanchez; Alicia,11,0,20,9
1715669396563,LISP 5B,A00,507671,Munoz Sanchez; Alicia,8,0,20,12
1715669397588,LISP 5C,A00,507696,Munoz Sanchez; Alicia,7,0,20,13
1715669398618,MAE 197,001,528363,Boechler; Nicholas Sebastia,9998,0,9999,1
1715669399644,MATH 197,001,523477,Kedlaya; Kiran S.,9994,0,9999,5
1715669399644,MATH 197,002,563811,Zhang; Danna,9994,0,9999,5
1715669399644,MATH 197,003,628552,Dumitriu; Ioana,9998,0,9999,1
1715669399644,MATH 197,004,660885,Floyd; Eric,9998,0,9999,1
1715669400682,MCWP 40R,A00,518780,Staff,1,0,20,19
1715669400682,MCWP 40R,B00,518781,Carter; Jennifer A,9,0,20,11
1715669400682,MCWP 40R,C00,518783,Smith; Haydee Marie,5,0,20,15
1715669401717,MCWP 50R,A00,518791,Redela; Pamela Morgan,0,1,20,20
1715669401717,MCWP 50R,B00,518792,Krone; Jarret,0,2,20,20
1715669401717,MCWP 50R,C00,518793,Staff,0,4,20,20
1715669401717,MCWP 50R,D00,518794,Morshed; Michael James,0,2,20,20
1715669401717,MCWP 50R,E00,518795,Carter; Andrea L,0,2,20,20
1715669401717,MCWP 50R,F00,518796,Miller; Elizabeth Deen,0,1,20,20
1715669401717,MCWP 50R,G00,518797,Guillen; Melinda,0,1,20,20
1715669402747,MMW 12R,A01,514034,Herbst; Matthew,0,2,16,16
1715669402747,MMW 12R,A02,514035,Herbst; Matthew,0,0,16,16
1715669403772,MMW 13R,A01,514037,Staff,0,5,16,16
1715669403772,MMW 13R,A02,514039,Staff,0,5,16,16
1715669403772,MMW 13R,A03,628519,Staff,0,4,16,16
1715669405824,SIO 295LS,A00,523233,Staff,10,0,30,20
1715669406855,SIO 295S,A00,523232,Staff,10,0,30,20
1715669407887,SIOC 290S,A01,637330,Merrifield; Mark A,21,0,30,9
1715669408918,SIOC 291S,A01,637333,Gabriel; Corey John,21,0,30,9
1715669409944,SOCI 117,A01,494376,Staff,0,5,5,5
1715669410974,WES 237B,A00,494380,Staff,10,0,20,10
1715669413049,AESE 279B,A00,494370,Wade; Jon P,0,0,33,33
1715669414076,AIP 97,001,660915,Van Den Einde; Yael Dahlia,9998,0,9999,1
1715669415111,AIP 197,001,627712,Vespa; Emanuel Ignacio,9995,0,9999,4
1715669415111,AIP 197,002,650778,Amir; On,9998,0,9999,1
1715669415111,AIP 197,003,650933,Avenancio-Leon; Carlos,9998,0,9999,1
1715669415111,AIP 197,004,658530,Heyman; Gail D.,9998,0,9999,1
1715669415111,AIP 197,005,658631,Neal; Sonya E,9998,0,9999,1
1715669415111,AIP 197,006,658671,Du; Songzi,9998,0,9999,1
1715669416136,ANAR 135S,A00,494369,Braswell; Geoffrey E.,0,0,0,0
1715669417163,BENG 196,001,628496,Engler; Adam J.,9998,0,9999,1
1715669417163,BENG 196,002,660916,Watson; John Thomas,9998,0,9999,1
1715669418194,BISP 197,001,650773,Wilhelm; James E.,9994,0,9999,5
1715669418194,BISP 197,002,658904,Coleman; Aaron B.,9998,0,9999,1
1715669419224,CAT 124RS,A01,519847,Geibel; William,0,0,20,20
1715669420249,CAT 125RS,A01,515971,Geibel; William,0,0,20,20
1715669421281,CLRE 250,A00,511389,Morris; Sheldon,9992,0,9999,7
1715669422307,CLRE 251,A00,507176,Mehta; Ravindra L.,9992,0,9999,7
1715669422307,CLRE 251,B00,511410,Mehta; Ravindra L.,9998,0,9999,1
1715669423333,CLRE 252,A00,507189,Cuomo; Raphael Eduardo,9994,0,9999,5
1715669424359,CLRE 253,A00,507199,Vaida; Florin,9994,0,9999,5
1715669424359,CLRE 253,B00,507202,Vaida; Florin,9999,0,9999,0
1715669425389,CLRE 259,A00,507211,Patel; Hemal,9996,0,9999,3
1715669426414,CLRE 260,A00,507221,Cuomo; Raphael Eduardo,9999,0,9999,0
1715669427440,CLRE 297,001,507242,Cuomo; Raphael Eduardo,9999,0,9999,0
1715669428466,COGS 197,001,638244,Voytek; Bradley Thomas,9997,0,9999,2
1715669429491,CSE 191,A00,516875,Minnes Kemp; Mor Mia,9991,0,9999,8
1715669430520,CSE 197,001,637388,Minnes Kemp; Mor Mia,9992,0,9999,7
1715669431548,CSS 201S,A01,494383,Mignozzetti; Umberto,35,0,35,0
1715669432578,CSS 202S,A01,494387,Mignozzetti; Umberto,35,0,35,0
1715669433607,DSC 197,001,628532,Eldridge; Justin Matthew,9995,0,9999,4
1715669434631,EAP 100,A00,516065,Staff,9799,0,9999,200
1715669435665,ECE 45,A01,507414,Staff,32,0,60,28
1715669437715,ECE 111,A01,507420,Staff,11,0,50,39
1715669438744,ECE 197,001,548057,Sievenpiper; Daniel F.,9991,0,9999,8
1715669439777,EDS 115,A00,507243,Choi; Bailey Miyeon,6,0,28,22
1715669440803,EDS 117,A01,494379,Staff,0,6,34,35
1715669441828,EDS 125,A00,507246,Hopkins; Megan Beth,7,0,30,23
1715669442855,EDS 128A,A01,507264,Fargason; Sharon Gayle,5,0,26,21
1715669443881,EDS 128B,A01,507293,Pappas; Elizabeth,9,0,30,21
1715669444910,EDS 139,A00,507294,Fargason; Sharon Gayle,9,0,30,21
1715669444910,EDS 139,B00,507313,Pappas; Elizabeth,9,0,30,21
1715669445935,EDS 201,A00,507315,Staff,10,0,30,20
1715669446959,EDS 203,A01,507317,Halter; Christopher P.,10,0,30,20
1715669447990,EDS 204R,A01,507319,Halter; Christopher P.,0,3,30,30
1715669447990,EDS 204R,B01,507331,Heinzman; Erica M.,14,0,30,16
1715669449020,EDS 206R,A00,507332,Staff,0,4,30,30
1715669449020,EDS 206R,B00,507343,Staff,15,0,30,15
1715669450046,EDS 250,A00,507344,Hemans; Patricia Ann Benitez,20,0,40,20
1715669451072,EDS 281,A00,507345,Daly; Alan J.,18,0,18,0
1715669452098,EDS 284,A00,507350,Daly; Alan J.,16,0,16,0
1715669453125,EDS 286,A00,507359,Fine; Sarah,18,0,18,0
1715669454151,EDS 289C,A01,507361,Daly; Alan J.,18,0,18,0
1715669455176,EDS 290,A00,507366,Hofstetter; Carolyn,15,0,15,0
1715669456208,LIGM 5A,A00,507421,Fischer-Grunski; Eva K,17,0,20,3
1715669457238,LIGM 5B,A00,507423,Fischer-Grunski; Eva K,19,0,20,1
1715669458268,LIGM 5C,A00,507425,Fischer-Grunski; Eva K,19,0,20,1
1715669459298,LIIT 5AS,A00,507427,Carnelos; Chiara,20,0,20,0
1715669460324,LIIT 5BS,A00,507430,Carnelos; Chiara,20,0,20,0
1715669461354,LIIT 5CS,A00,507432,Carnelos; Chiara,20,0,20,0
1715669462379,LISP 5A,A00,507541,Munoz Sanchez; Alicia,11,0,20,9
1715669463406,LISP 5B,A00,507671,Munoz Sanchez; Alicia,8,0,20,12
1715669464431,LISP 5C,A00,507696,Munoz Sanchez; Alicia,7,0,20,13
1715669465462,MAE 197,001,528363,Boechler; Nicholas Sebastia,9998,0,9999,1
1715669466494,MATH 197,001,523477,Kedlaya; Kiran S.,9994,0,9999,5
1715669466494,MATH 197,002,563811,Zhang; Danna,9994,0,9999,5
1715669466494,MATH 197,003,628552,Dumitriu; Ioana,9998,0,9999,1
1715669466494,MATH 197,004,660885,Floyd; Eric,9998,0,9999,1
1715669467521,MCWP 40R,A00,518780,Staff,1,0,20,19
1715669467521,MCWP 40R,B00,518781,Carter; Jennifer A,9,0,20,11
1715669467521,MCWP 40R,C00,518783,Smith; Haydee Marie,5,0,20,15
1715669468549,MCWP 50R,A00,518791,Redela; Pamela Morgan,0,1,20,20
1715669468549,MCWP 50R,B00,518792,Krone; Jarret,0,2,20,20
1715669468549,MCWP 50R,C00,518793,Staff,0,4,20,20
1715669468549,MCWP 50R,D00,518794,Morshed; Michael James,0,2,20,20
1715669468549,MCWP 50R,E00,518795,Carter; Andrea L,0,2,20,20
1715669468549,MCWP 50R,F00,518796,Miller; Elizabeth Deen,0,1,20,20
1715669468549,MCWP 50R,G00,518797,Guillen; Melinda,0,1,20,20
1715669469575,MMW 12R,A01,514034,Herbst; Matthew,0,2,16,16
1715669469575,MMW 12R,A02,514035,Herbst; Matthew,0,0,16,16
1715669470601,MMW 13R,A01,514037,Staff,0,5,16,16
1715669470601,MMW 13R,A02,514039,Staff,0,5,16,16
1715669470601,MMW 13R,A03,628519,Staff,0,4,16,16
1715669472651,SIO 295LS,A00,523233,Staff,10,0,30,20
1715669473679,SIO 295S,A00,523232,Staff,10,0,30,20
1715669474706,SIOC 290S,A01,637330,Merrifield; Mark A,21,0,30,9
1715669475731,SIOC 291S,A01,637333,Gabriel; Corey John,21,0,30,9
1715669476760,SOCI 117,A01,494376,Staff,0,5,5,5
1715669477789,WES 237B,A00,494380,Staff,10,0,20,10
1715669479869,AESE 279B,A00,494370,Wade; Jon P,0,0,33,33
1715669480896,AIP 97,001,660915,Van Den Einde; Yael Dahlia,9998,0,9999,1
1715669481925,AIP 197,001,627712,Vespa; Emanuel Ignacio,9995,0,9999,4
1715669481925,AIP 197,002,650778,Amir; On,9998,0,9999,1
1715669481925,AIP 197,003,650933,Avenancio-Leon; Carlos,9998,0,9999,1
1715669481925,AIP 197,004,658530,Heyman; Gail D.,9998,0,9999,1
1715669481925,AIP 197,005,658631,Neal; Sonya E,9998,0,9999,1
1715669481925,AIP 197,006,658671,Du; Songzi,9998,0,9999,1
1715669482954,ANAR 135S,A00,494369,Braswell; Geoffrey E.,0,0,0,0
1715669483981,BENG 196,001,628496,Engler; Adam J.,9998,0,9999,1
1715669483981,BENG 196,002,660916,Watson; John Thomas,9998,0,9999,1
1715669485011,BISP 197,001,650773,Wilhelm; James E.,9994,0,9999,5
1715669485011,BISP 197,002,658904,Coleman; Aaron B.,9998,0,9999,1
1715669486038,CAT 124RS,A01,519847,Geibel; William,0,0,20,20
1715669487068,CAT 125RS,A01,515971,Geibel; William,0,0,20,20
1715669488096,CLRE 250,A00,511389,Morris; Sheldon,9992,0,9999,7
1715669489128,CLRE 251,A00,507176,Mehta; Ravindra L.,9992,0,9999,7
1715669489128,CLRE 251,B00,511410,Mehta; Ravindra L.,9998,0,9999,1
1715669490158,CLRE 252,A00,507189,Cuomo; Raphael Eduardo,9994,0,9999,5
1715669491243,CLRE 253,A00,507199,Vaida; Florin,9994,0,9999,5
1715669491243,CLRE 253,B00,507202,Vaida; Florin,9999,0,9999,0
1715669492269,CLRE 259,A00,507211,Patel; Hemal,9996,0,9999,3
1715669493298,CLRE 260,A00,507221,Cuomo; Raphael Eduardo,9999,0,9999,0
1715669494326,CLRE 297,001,507242,Cuomo; Raphael Eduardo,9999,0,9999,0
1715669495354,COGS 197,001,638244,Voytek; Bradley Thomas,9997,0,9999,2
1715669496379,CSE 191,A00,516875,Minnes Kemp; Mor Mia,9991,0,9999,8
1715669497407,CSE 197,001,637388,Minnes Kemp; Mor Mia,9992,0,9999,7
1715669498434,CSS 201S,A01,494383,Mignozzetti; Umberto,35,0,35,0
1715669499460,CSS 202S,A01,494387,Mignozzetti; Umberto,35,0,35,0
1715669500485,DSC 197,001,628532,Eldridge; Justin Matthew,9995,0,9999,4
1715669501512,EAP 100,A00,516065,Staff,9799,0,9999,200
1715669502543,ECE 45,A01,507414,Staff,32,0,60,28
1715669504596,ECE 111,A01,507420,Staff,11,0,50,39
1715669505621,ECE 197,001,548057,Sievenpiper; Daniel F.,9991,0,9999,8
1715669506650,EDS 115,A00,507243,Choi; Bailey Miyeon,6,0,28,22
1715669507681,EDS 117,A01,494379,Staff,0,6,34,35
1715669508714,EDS 125,A00,507246,Hopkins; Megan Beth,7,0,30,23
1715669509744,EDS 128A,A01,507264,Fargason; Sharon Gayle,5,0,26,21
1715669510771,EDS 128B,A01,507293,Pappas; Elizabeth,9,0,30,21
1715669511797,EDS 139,A00,507294,Fargason; Sharon Gayle,9,0,30,21
1715669511797,EDS 139,B00,507313,Pappas; Elizabeth,9,0,30,21
1715669512825,EDS 201,A00,507315,Staff,10,0,30,20
1715669513852,EDS 203,A01,507317,Halter; Christopher P.,10,0,30,20
1715669514879,EDS 204R,A01,507319,Halter; Christopher P.,0,3,30,30
1715669514879,EDS 204R,B01,507331,Heinzman; Erica M.,14,0,30,16
1715669515904,EDS 206R,A00,507332,Staff,0,4,30,30
1715669515904,EDS 206R,B00,507343,Staff,15,0,30,15
1715669516930,EDS 250,A00,507344,Hemans; Patricia Ann Benitez,20,0,40,20
1715669517955,EDS 281,A00,507345,Daly; Alan J.,18,0,18,0
1715669518983,EDS 284,A00,507350,Daly; Alan J.,16,0,16,0
1715669520009,EDS 286,A00,507359,Fine; Sarah,18,0,18,0
1715669521037,EDS 289C,A01,507361,Daly; Alan J.,18,0,18,0
1715669522065,EDS 290,A00,507366,Hofstetter; Carolyn,15,0,15,0
1715669523093,LIGM 5A,A00,507421,Fischer-Grunski; Eva K,17,0,20,3
1715669524122,LIGM 5B,A00,507423,Fischer-Grunski; Eva K,19,0,20,1
1715669525153,LIGM 5C,A00,507425,Fischer-Grunski; Eva K,19,0,20,1
1715669526179,LIIT 5AS,A00,507427,Carnelos; Chiara,20,0,20,0
1715669527209,LIIT 5BS,A00,507430,Carnelos; Chiara,20,0,20,0
1715669528235,LIIT 5CS,A00,507432,Carnelos; Chiara,20,0,20,0
1715669529260,LISP 5A,A00,507541,Munoz Sanchez; Alicia,11,0,20,9
1715669530289,LISP 5B,A00,507671,Munoz Sanchez; Alicia,8,0,20,12
1715669531316,LISP 5C,A00,507696,Munoz Sanchez; Alicia,7,0,20,13
1715669532342,MAE 197,001,528363,Boechler; Nicholas Sebastia,9998,0,9999,1
1715669533375,MATH 197,001,523477,Kedlaya; Kiran S.,9994,0,9999,5
1715669533375,MATH 197,002,563811,Zhang; Danna,9994,0,9999,5
1715669533375,MATH 197,003,628552,Dumitriu; Ioana,9998,0,9999,1
1715669533375,MATH 197,004,660885,Floyd; Eric,9998,0,9999,1
1715669534405,MCWP 40R,A00,518780,Staff,1,0,20,19
1715669534405,MCWP 40R,B00,518781,Carter; Jennifer A,9,0,20,11
1715669534405,MCWP 40R,C00,518783,Smith; Haydee Marie,5,0,20,15
1715669535440,MCWP 50R,A00,518791,Redela; Pamela Morgan,0,1,20,20
1715669535440,MCWP 50R,B00,518792,Krone; Jarret,0,2,20,20
1715669535440,MCWP 50R,C00,518793,Staff,0,4,20,20
1715669535440,MCWP 50R,D00,518794,Morshed; Michael James,0,2,20,20
1715669535440,MCWP 50R,E00,518795,Carter; Andrea L,0,2,20,20
1715669535440,MCWP 50R,F00,518796,Miller; Elizabeth Deen,0,1,20,20
1715669535440,MCWP 50R,G00,518797,Guillen; Melinda,0,1,20,20
1715669536466,MMW 12R,A01,514034,Herbst; Matthew,0,2,16,16
1715669536466,MMW 12R,A02,514035,Herbst; Matthew,0,0,16,16
1715669537494,MMW 13R,A01,514037,Staff,0,5,16,16
1715669537494,MMW 13R,A02,514039,Staff,0,5,16,16
1715669537494,MMW 13R,A03,628519,Staff,0,4,16,16
1715669539552,SIO 295LS,A00,523233,Staff,10,0,30,20
1715669540577,SIO 295S,A00,523232,Staff,10,0,30,20
1715669541606,SIOC 290S,A01,637330,Merrifield; Mark A,21,0,30,9
1715669542636,SIOC 291S,A01,637333,Gabriel; Corey John,21,0,30,9
1715669543662,SOCI 117,A01,494376,Staff,0,5,5,5
1715669544689,WES 237B,A00,494380,Staff,10,0,20,10
1715669546764,AESE 279B,A00,494370,Wade; Jon P,0,0,33,33
1715669547791,AIP 97,001,660915,Van Den Einde; Yael Dahlia,9998,0,9999,1
1715669548819,AIP 197,001,627712,Vespa; Emanuel Ignacio,9995,0,9999,4
1715669548819,AIP 197,002,650778,Amir; On,9998,0,9999,1
1715669548819,AIP 197,003,650933,Avenancio-Leon; Carlos,9998,0,9999,1
1715669548819,AIP 197,004,658530,Heyman; Gail D.,9998,0,9999,1
1715669548819,AIP 197,005,658631,Neal; Sonya E,9998,0,9999,1
1715669548819,AIP 197,006,658671,Du; Songzi,9998,0,9999,1
1715669549844,ANAR 135S,A00,494369,Braswell; Geoffrey E.,0,0,0,0
1715669550873,BENG 196,001,628496,Engler; Adam J.,9998,0,9999,1
1715669550873,BENG 196,002,660916,Watson; John Thomas,9998,0,9999,1
1715669551901,BISP 197,001,650773,Wilhelm; James E.,9994,0,9999,5
1715669551901,BISP 197,002,658904,Coleman; Aaron B.,9998,0,9999,1
1715669552927,CAT 124RS,A01,519847,Geibel; William,0,0,20,20
1715669553955,CAT 125RS,A01,515971,Geibel; William,0,0,20,20
1715669554980,CLRE 250,A00,511389,Morris; Sheldon,9992,0,9999,7
1715669556007,CLRE 251,A00,507176,Mehta; Ravindra L.,9992,0,9999,7
1715669556007,CLRE 251,B00,511410,Mehta; Ravindra L.,9998,0,9999,1
1715669557036,CLRE 252,A00,507189,Cuomo; Raphael Eduardo,9994,0,9999,5
1715669558065,CLRE 253,A00,507199,Vaida; Florin,9994,0,9999,5
1715669558065,CLRE 253,B00,507202,Vaida; Florin,9999,0,9999,0
1715669559090,CLRE 259,A00,507211,Patel; Hemal,9996,0,9999,3
1715669560116,CLRE 260,A00,507221,Cuomo; Raphael Eduardo,9999,0,9999,0
1715669561144,CLRE 297,001,507242,Cuomo; Raphael Eduardo,9999,0,9999,0
1715669562175,COGS 197,001,638244,Voytek; Bradley Thomas,9997,0,9999,2
1715669563199,CSE 191,A00,516875,Minnes Kemp; Mor Mia,9991,0,9999,8
1715669564227,CSE 197,001,637388,Minnes Kemp; Mor Mia,9992,0,9999,7
1715669565258,CSS 201S,A01,494383,Mignozzetti; Umberto,35,0,35,0
1715669566284,CSS 202S,A01,494387,Mignozzetti; Umberto,35,0,35,0
1715669567310,DSC 197,001,628532,Eldridge; Justin Matthew,9995,0,9999,4
1715669568337,EAP 100,A00,516065,Staff,9799,0,9999,200
1715669569372,ECE 45,A01,507414,Staff,32,0,60,28
1715669571422,ECE 111,A01,507420,Staff,11,0,50,39
1715669572451,ECE 197,001,548057,Sievenpiper; Daniel F.,9991,0,9999,8
1715669573477,EDS 115,A00,507243,Choi; Bailey Miyeon,6,0,28,22
1715669574508,EDS 117,A01,494379,Staff,0,6,34,35
1715669575533,EDS 125,A00,507246,Hopkins; Megan Beth,7,0,30,23
1715669576560,EDS 128A,A01,507264,Fargason; Sharon Gayle,5,0,26,21
1715669577586,EDS 128B,A01,507293,Pappas; Elizabeth,9,0,30,21
1715669578617,EDS 139,A00,507294,Fargason; Sharon Gayle,9,0,30,21
1715669578617,EDS 139,B00,507313,Pappas; Elizabeth,9,0,30,21
1715669579644,EDS 201,A00,507315,Staff,10,0,30,20
1715669580672,EDS 203,A01,507317,Halter; Christopher P.,10,0,30,20
1715669581701,EDS 204R,A01,507319,Halter; Christopher P.,0,3,30,30
1715669581701,EDS 204R,B01,507331,Heinzman; Erica M.,14,0,30,16
1715669582727,EDS 206R,A00,507332,Staff,0,4,30,30
1715669582727,EDS 206R,B00,507343,Staff,15,0,30,15
1715669583753,EDS 250,A00,507344,Hemans; Patricia Ann Benitez,20,0,40,20
1715669584778,EDS 281,A00,507345,Daly; Alan J.,18,0,18,0
1715669585805,EDS 284,A00,507350,Daly; Alan J.,16,0,16,0
1715669586836,EDS 286,A00,507359,Fine; Sarah,18,0,18,0
1715669587864,EDS 289C,A01,507361,Daly; Alan J.,18,0,18,0
1715669588890,EDS 290,A00,507366,Hofstetter; Carolyn,15,0,15,0
1715669589917,LIGM 5A,A00,507421,Fischer-Grunski; Eva K,17,0,20,3
1715669590943,LIGM 5B,A00,507423,Fischer-Grunski; Eva K,19,0,20,1
1715669591971,LIGM 5C,A00,507425,Fischer-Grunski; Eva K,19,0,20,1
1715669593001,LIIT 5AS,A00,507427,Carnelos; Chiara,20,0,20,0
1715669594028,LIIT 5BS,A00,507430,Carnelos; Chiara,20,0,20,0
1715669595108,LIIT 5CS,A00,507432,Carnelos; Chiara,20,0,20,0
1715669596134,LISP 5A,A00,507541,Munoz Sanchez; Alicia,11,0,20,9
1715669597161,LISP 5B,A00,507671,Munoz Sanchez; Alicia,8,0,20,12
1715669598186,LISP 5C,A00,507696,Munoz Sanchez; Alicia,7,0,20,13
1715669599215,MAE 197,001,528363,Boechler; Nicholas Sebastia,9998,0,9999,1
1715669600242,MATH 197,001,523477,Kedlaya; Kiran S.,9994,0,9999,5
1715669600242,MATH 197,002,563811,Zhang; Danna,9994,0,9999,5
1715669600242,MATH 197,003,628552,Dumitriu; Ioana,9998,0,9999,1
1715669600242,MATH 197,004,660885,Floyd; Eric,9998,0,9999,1
1715669601272,MCWP 40R,A00,518780,Staff,1,0,20,19
1715669601272,MCWP 40R,B00,518781,Carter; Jennifer A,9,0,20,11
1715669601272,MCWP 40R,C00,518783,Smith; Haydee Marie,5,0,20,15
1715669602306,MCWP 50R,A00,518791,Redela; Pamela Morgan,0,1,20,20
1715669602306,MCWP 50R,B00,518792,Krone; Jarret,0,2,20,20
1715669602306,MCWP 50R,C00,518793,Staff,0,4,20,20
1715669602306,MCWP 50R,D00,518794,Morshed; Michael James,0,2,20,20
1715669602306,MCWP 50R,E00,518795,Carter; Andrea L,0,2,20,20
1715669602306,MCWP 50R,F00,518796,Miller; Elizabeth Deen,0,1,20,20
1715669602306,MCWP 50R,G00,518797,Guillen; Melinda,0,1,20,20
1715669603331,MMW 12R,A01,514034,Herbst; Matthew,0,2,16,16
1715669603331,MMW 12R,A02,514035,Herbst; Matthew,0,0,16,16
1715669604355,MMW 13R,A01,514037,Staff,0,5,16,16
1715669604355,MMW 13R,A02,514039,Staff,0,5,16,16
1715669604355,MMW 13R,A03,628519,Staff,0,4,16,16
1715669606406,SIO 295LS,A00,523233,Staff,10,0,30,20
1715669607437,SIO 295S,A00,523232,Staff,10,0,30,20
1715669608464,SIOC 290S,A01,637330,Merrifield; Mark A,21,0,30,9
1715669609494,SIOC 291S,A01,637333,Gabriel; Corey John,21,0,30,9
1715669610522,SOCI 117,A01,494376,Staff,0,5,5,5
1715669611550,WES 237B,A00,494380,Staff,10,0,20,10
1715669613622,AESE 279B,A00,494370,Wade; Jon P,0,0,33,33
1715669614645,AIP 97,001,660915,Van Den Einde; Yael Dahlia,9998,0,9999,1
1715669615672,AIP 197,001,627712,Vespa; Emanuel Ignacio,9995,0,9999,4
1715669615672,AIP 197,002,650778,Amir; On,9998,0,9999,1
1715669615672,AIP 197,003,650933,Avenancio-Leon; Carlos,9998,0,9999,1
1715669615672,AIP 197,004,658530,Heyman; Gail D.,9998,0,9999,1
1715669615672,AIP 197,005,658631,Neal; Sonya E,9998,0,9999,1
1715669615672,AIP 197,006,658671,Du; Songzi,9998,0,9999,1
1715669616703,ANAR 135S,A00,494369,Braswell; Geoffrey E.,0,0,0,0
1715669617728,BENG 196,001,628496,Engler; Adam J.,9998,0,9999,1
1715669617728,BENG 196,002,660916,Watson; John Thomas,9998,0,9999,1
1715669618760,BISP 197,001,650773,Wilhelm; James E.,9994,0,9999,5
1715669618760,BISP 197,002,658904,Coleman; Aaron B.,9998,0,9999,1
1715669619788,CAT 124RS,A01,519847,Geibel; William,0,0,20,20
1715669620814,CAT 125RS,A01,515971,Geibel; William,0,0,20,20
1715669621838,CLRE 250,A00,511389,Morris; Sheldon,9992,0,9999,7
1715669622870,CLRE 251,A00,507176,Mehta; Ravindra L.,9992,0,9999,7
1715669622870,CLRE 251,B00,511410,Mehta; Ravindra L.,9998,0,9999,1
1715669623894,CLRE 252,A00,507189,Cuomo; Raphael Eduardo,9994,0,9999,5
1715669624921,CLRE 253,A00,507199,Vaida; Florin,9994,0,9999,5
1715669624921,CLRE 253,B00,507202,Vaida; Florin,9999,0,9999,0
1715669625947,CLRE 259,A00,507211,Patel; Hemal,9996,0,9999,3
1715669626973,CLRE 260,A00,507221,Cuomo; Raphael Eduardo,9999,0,9999,0
1715669628000,CLRE 297,001,507242,Cuomo; Raphael Eduardo,9999,0,9999,0
1715669629030,COGS 197,001,638244,Voytek; Bradley Thomas,9997,0,9999,2
1715669630060,CSE 191,A00,516875,Minnes Kemp; Mor Mia,9991,0,9999,8
1715669631089,CSE 197,001,637388,Minnes Kemp; Mor Mia,9992,0,9999,7
1715669632120,CSS 201S,A01,494383,Mignozzetti; Umberto,35,0,35,0
1715669633152,CSS 202S,A01,494387,Mignozzetti; Umberto,35,0,35,0
1715669634180,DSC 197,001,628532,Eldridge; Justin Matthew,9995,0,9999,4
1715669635206,EAP 100,A00,516065,Staff,9799,0,9999,200
1715669636234,ECE 45,A01,507414,Staff,32,0,60,28
1715669638287,ECE 111,A01,507420,Staff,11,0,50,39
1715669639315,ECE 197,001,548057,Sievenpiper; Daniel F.,9991,0,9999,8
1715669640346,EDS 115,A00,507243,Choi; Bailey Miyeon,6,0,28,22
1715669641372,EDS 117,A01,494379,Staff,0,6,34,35
1715669642400,EDS 125,A00,507246,Hopkins; Megan Beth,7,0,30,23
1715669643431,EDS 128A,A01,507264,Fargason; Sharon Gayle,5,0,26,21
1715669644456,EDS 128B,A01,507293,Pappas; Elizabeth,9,0,30,21
1715669645480,EDS 139,A00,507294,Fargason; Sharon Gayle,9,0,30,21
1715669645480,EDS 139,B00,507313,Pappas; Elizabeth,9,0,30,21
1715669646508,EDS 201,A00,507315,Staff,10,0,30,20
1715669647539,EDS 203,A01,507317,Halter; Christopher P.,10,0,30,20
1715669648565,EDS 204R,A01,507319,Halter; Christopher P.,0,3,30,30
1715669648565,EDS 204R,B01,507331,Heinzman; Erica M.,14,0,30,16
1715669649591,EDS 206R,A00,507332,Staff,0,4,30,30
1715669649591,EDS 206R,B00,507343,Staff,15,0,30,15
1715669650617,EDS 250,A00,507344,Hemans; Patricia Ann Benitez,20,0,40,20
1715669651646,EDS 281,A00,507345,Daly; Alan J.,18,0,18,0
1715669652672,EDS 284,A00,507350,Daly; Alan J.,16,0,16,0
1715669653697,EDS 286,A00,507359,Fine; Sarah,18,0,18,0
1715669654725,EDS 289C,A01,507361,Daly; Alan J.,18,0,18,0
1715669655751,EDS 290,A00,507366,Hofstetter; Carolyn,15,0,15,0
1715669656777,LIGM 5A,A00,507421,Fischer-Grunski; Eva K,17,0,20,3
1715669657802,LIGM 5B,A00,507423,Fischer-Grunski; Eva K,19,0,20,1
1715669658831,LIGM 5C,A00,507425,Fischer-Grunski; Eva K,19,0,20,1
1715669659855,LIIT 5AS,A00,507427,Carnelos; Chiara,20,0,20,0
1715669660881,LIIT 5BS,A00,507430,Carnelos; Chiara,20,0,20,0
1715669661912,LIIT 5CS,A00,507432,Carnelos; Chiara,20,0,20,0
1715669662938,LISP 5A,A00,507541,Munoz Sanchez; Alicia,11,0,20,9
1715669663963,LISP 5B,A00,507671,Munoz Sanchez; Alicia,8,0,20,12
1715669664996,LISP 5C,A00,507696,Munoz Sanchez; Alicia,7,0,20,13
1715669666021,MAE 197,001,528363,Boechler; Nicholas Sebastia,9998,0,9999,1
1715669667056,MATH 197,001,523477,Kedlaya; Kiran S.,9994,0,9999,5
1715669667056,MATH 197,002,563811,Zhang; Danna,9994,0,9999,5
1715669667056,MATH 197,003,628552,Dumitriu; Ioana,9998,0,9999,1
1715669667056,MATH 197,004,660885,Floyd; Eric,9998,0,9999,1
1715669668084,MCWP 40R,A00,518780,Staff,1,0,20,19
1715669668084,MCWP 40R,B00,518781,Carter; Jennifer A,9,0,20,11
1715669668084,MCWP 40R,C00,518783,Smith; Haydee Marie,5,0,20,15
1715669669113,MCWP 50R,A00,518791,Redela; Pamela Morgan,0,1,20,20
1715669669113,MCWP 50R,B00,518792,Krone; Jarret,0,2,20,20
1715669669113,MCWP 50R,C00,518793,Staff,0,4,20,20
1715669669113,MCWP 50R,D00,518794,Morshed; Michael James,0,2,20,20
1715669669113,MCWP 50R,E00,518795,Carter; Andrea L,0,2,20,20
1715669669113,MCWP 50R,F00,518796,Miller; Elizabeth Deen,0,1,20,20
1715669669113,MCWP 50R,G00,518797,Guillen; Melinda,0,1,20,20
1715669670140,MMW 12R,A01,514034,Herbst; Matthew,0,2,16,16
1715669670140,MMW 12R,A02,514035,Herbst; Matthew,0,0,16,16
1715669671176,MMW 13R,A01,514037,Staff,0,5,16,16
1715669671176,MMW 13R,A02,514039,Staff,0,5,16,16
1715669671176,MMW 13R,A03,628519,Staff,0,4,16,16
1715669673234,SIO 295LS,A00,523233,Staff,10,0,30,20
1715669674260,SIO 295S,A00,523232,Staff,10,0,30,20
1715669675286,SIOC 290S,A01,637330,Merrifield; Mark A,21,0,30,9
1715669676314,SIOC 291S,A01,637333,Gabriel; Corey John,21,0,30,9
1715669677349,SOCI 117,A01,494376,Staff,0,5,5,5
1715669678376,WES 237B,A00,494380,Staff,10,0,20,10
1715669680474,AESE 279B,A00,494370,Wade; Jon P,0,0,33,33
1715669681499,AIP 97,001,660915,Van Den Einde; Yael Dahlia,9998,0,9999,1
1715669682535,AIP 197,001,627712,Vespa; Emanuel Ignacio,9995,0,9999,4
1715669682535,AIP 197,002,650778,Amir; On,9998,0,9999,1
1715669682535,AIP 197,003,650933,Avenancio-Leon; Carlos,9998,0,9999,1
1715669682535,AIP 197,004,658530,Heyman; Gail D.,9998,0,9999,1
1715669682535,AIP 197,005,658631,Neal; Sonya E,9998,0,9999,1
1715669682535,AIP 197,006,658671,Du; Songzi,9998,0,9999,1
1715669683569,ANAR 135S,A00,494369,Braswell; Geoffrey E.,0,0,0,0
1715669684606,BENG 196,001,628496,Engler; Adam J.,9998,0,9999,1
1715669684606,BENG 196,002,660916,Watson; John Thomas,9998,0,9999,1
1715669685657,BISP 197,001,650773,Wilhelm; James E.,9994,0,9999,5
1715669685657,BISP 197,002,658904,Coleman; Aaron B.,9998,0,9999,1
1715669686688,CAT 124RS,A01,519847,Geibel; William,0,0,20,20
1715669687714,CAT 125RS,A01,515971,Geibel; William,0,0,20,20
1715669688746,CLRE 250,A00,511389,Morris; Sheldon,9992,0,9999,7
1715669689772,CLRE 251,A00,507176,Mehta; Ravindra L.,9992,0,9999,7
1715669689772,CLRE 251,B00,511410,Mehta; Ravindra L.,9998,0,9999,1
1715669690798,CLRE 252,A00,507189,Cuomo; Raphael Eduardo,9994,0,9999,5
1715669691845,CLRE 253,A00,507199,Vaida; Florin,9994,0,9999,5
1715669691845,CLRE 253,B00,507202,Vaida; Florin,9999,0,9999,0
1715669692872,CLRE 259,A00,507211,Patel; Hemal,9996,0,9999,3
1715669693902,CLRE 260,A00,507221,Cuomo; Raphael Eduardo,9999,0,9999,0
1715669694934,CLRE 297,001,507242,Cuomo; Raphael Eduardo,9999,0,9999,0
1715669695959,COGS 197,001,638244,Voytek; Bradley Thomas,9997,0,9999,2
1715669696985,CSE 191,A00,516875,Minnes Kemp; Mor Mia,9991,0,9999,8
1715669698023,CSE 197,001,637388,Minnes Kemp; Mor Mia,9992,0,9999,7
1715669699112,CSS 201S,A01,494383,Mignozzetti; Umberto,35,0,35,0
1715669700145,CSS 202S,A01,494387,Mignozzetti; Umberto,35,0,35,0
1715669701177,DSC 197,001,628532,Eldridge; Justin Matthew,9995,0,9999,4
1715669702203,EAP 100,A00,516065,Staff,9799,0,9999,200
1715669703232,ECE 45,A01,507414,Staff,32,0,60,28
1715669705285,ECE 111,A01,507420,Staff,11,0,50,39
1715669706316,ECE 197,001,548057,Sievenpiper; Daniel F.,9991,0,9999,8
1715669707362,EDS 115,A00,507243,Choi; Bailey Miyeon,6,0,28,22
1715669708391,EDS 117,A01,494379,Staff,0,6,34,35
1715669709444,EDS 125,A00,507246,Hopkins; Megan Beth,7,0,30,23
1715669710471,EDS 128A,A01,507264,Fargason; Sharon Gayle,5,0,26,21
1715669711495,EDS 128B,A01,507293,Pappas; Elizabeth,9,0,30,21
1715669712524,EDS 139,A00,507294,Fargason; Sharon Gayle,9,0,30,21
1715669712524,EDS 139,B00,507313,Pappas; Elizabeth,9,0,30,21
1715669713549,EDS 201,A00,507315,Staff,10,0,30,20
1715669714575,EDS 203,A01,507317,Halter; Christopher P.,10,0,30,20
1715669715605,EDS 204R,A01,507319,Halter; Christopher P.,0,3,30,30
1715669715605,EDS 204R,B01,507331,Heinzman; Erica M.,14,0,30,16
1715669716630,EDS 206R,A00,507332,Staff,0,4,30,30
1715669716630,EDS 206R,B00,507343,Staff,15,0,30,15
1715669717656,EDS 250,A00,507344,Hemans; Patricia Ann Benitez,20,0,40,20
1715669718682,EDS 281,A00,507345,Daly; Alan J.,18,0,18,0
1715669719707,EDS 284,A00,507350,Daly; Alan J.,16,0,16,0
1715669720737,EDS 286,A00,507359,Fine; Sarah,18,0,18,0
1715669721762,EDS 289C,A01,507361,Daly; Alan J.,18,0,18,0
1715669722787,EDS 290,A00,507366,Hofstetter; Carolyn,15,0,15,0
1715669723813,LIGM 5A,A00,507421,Fischer-Grunski; Eva K,17,0,20,3
1715669724840,LIGM 5B,A00,507423,Fischer-Grunski; Eva K,19,0,20,1
1715669725866,LIGM 5C,A00,507425,Fischer-Grunski; Eva K,19,0,20,1
1715669726898,LIIT 5AS,A00,507427,Carnelos; Chiara,20,0,20,0
1715669727927,LIIT 5BS,A00,507430,Carnelos; Chiara,20,0,20,0
1715669728950,LIIT 5CS,A00,507432,Carnelos; Chiara,20,0,20,0
1715669729981,LISP 5A,A00,507541,Munoz Sanchez; Alicia,11,0,20,9
1715669731006,LISP 5B,A00,507671,Munoz Sanchez; Alicia,8,0,20,12
1715669732036,LISP 5C,A00,507696,Munoz Sanchez; Alicia,7,0,20,13
1715669733062,MAE 197,001,528363,Boechler; Nicholas Sebastia,9998,0,9999,1
1715669734089,MATH 197,001,523477,Kedlaya; Kiran S.,9994,0,9999,5
1715669734089,MATH 197,002,563811,Zhang; Danna,9994,0,9999,5
1715669734089,MATH 197,003,628552,Dumitriu; Ioana,9998,0,9999,1
1715669734089,MATH 197,004,660885,Floyd; Eric,9998,0,9999,1
1715669735119,MCWP 40R,A00,518780,Staff,1,0,20,19
1715669735119,MCWP 40R,B00,518781,Carter; Jennifer A,9,0,20,11
1715669735119,MCWP 40R,C00,518783,Smith; Haydee Marie,5,0,20,15
1715669736147,MCWP 50R,A00,518791,Redela; Pamela Morgan,0,1,20,20
1715669736147,MCWP 50R,B00,518792,Krone; Jarret,0,2,20,20
1715669736147,MCWP 50R,C00,518793,Staff,0,4,20,20
1715669736147,MCWP 50R,D00,518794,Morshed; Michael James,0,2,20,20
1715669736147,MCWP 50R,E00,518795,Carter; Andrea L,0,2,20,20
1715669736147,MCWP 50R,F00,518796,Miller; Elizabeth Deen,0,1,20,20
1715669736147,MCWP 50R,G00,518797,Guillen; Melinda,0,1,20,20
1715669737174,MMW 12R,A01,514034,Herbst; Matthew,0,2,16,16
1715669737174,MMW 12R,A02,514035,Herbst; Matthew,0,0,16,16
1715669738201,MMW 13R,A01,514037,Staff,0,5,16,16
1715669738201,MMW 13R,A02,514039,Staff,0,5,16,16
1715669738201,MMW 13R,A03,628519,Staff,0,4,16,16
1715669740255,SIO 295LS,A00,523233,Staff,10,0,30,20
1715669741280,SIO 295S,A00,523232,Staff,10,0,30,20
1715669742307,SIOC 290S,A01,637330,Merrifield; Mark A,21,0,30,9
1715669743335,SIOC 291S,A01,637333,Gabriel; Corey John,21,0,30,9
1715669744359,SOCI 117,A01,494376,Staff,0,5,5,5
1715669745387,WES 237B,A00,494380,Staff,10,0,20,10
1715669747465,AESE 279B,A00,494370,Wade; Jon P,0,0,33,33
1715669748490,AIP 97,001,660915,Van Den Einde; Yael Dahlia,9998,0,9999,1
1715669749518,AIP 197,001,627712,Vespa; Emanuel Ignacio,9995,0,9999,4
1715669749518,AIP 197,002,650778,Amir; On,9998,0,9999,1
1715669749518,AIP 197,003,650933,Avenancio-Leon; Carlos,9998,0,9999,1
1715669749518,AIP 197,004,658530,Heyman; Gail D.,9998,0,9999,1
1715669749518,AIP 197,005,658631,Neal; Sonya E,9998,0,9999,1
1715669749518,AIP 197,006,658671,Du; Songzi,9998,0,9999,1
1715669750545,ANAR 135S,A00,494369,Braswell; Geoffrey E.,0,0,0,0
1715669751576,BENG 196,001,628496,Engler; Adam J.,9998,0,9999,1
1715669751576,BENG 196,002,660916,Watson; John Thomas,9998,0,9999,1
1715669752607,BISP 197,001,650773,Wilhelm; James E.,9994,0,9999,5
1715669752607,BISP 197,002,658904,Coleman; Aaron B.,9998,0,9999,1
1715669753638,CAT 124RS,A01,519847,Geibel; William,0,0,20,20
1715669754663,CAT 125RS,A01,515971,Geibel; William,0,0,20,20
1715669755691,CLRE 250,A00,511389,Morris; Sheldon,9992,0,9999,7
1715669756717,CLRE 251,A00,507176,Mehta; Ravindra L.,9992,0,9999,7
1715669756717,CLRE 251,B00,511410,Mehta; Ravindra L.,9998,0,9999,1
1715669757745,CLRE 252,A00,507189,Cuomo; Raphael Eduardo,9994,0,9999,5
1715669758769,CLRE 253,A00,507199,Vaida; Florin,9994,0,9999,5
1715669758769,CLRE 253,B00,507202,Vaida; Florin,9999,0,9999,0
1715669759796,CLRE 259,A00,507211,Patel; Hemal,9996,0,9999,3
1715669760825,CLRE 260,A00,507221,Cuomo; Raphael Eduardo,9999,0,9999,0
1715669761851,CLRE 297,001,507242,Cuomo; Raphael Eduardo,9999,0,9999,0
1715669762878,COGS 197,001,638244,Voytek; Bradley Thomas,9997,0,9999,2
1715669763909,CSE 191,A00,516875,Minnes Kemp; Mor Mia,9991,0,9999,8
1715669764936,CSE 197,001,637388,Minnes Kemp; Mor Mia,9992,0,9999,7
1715669765962,CSS 201S,A01,494383,Mignozzetti; Umberto,35,0,35,0
1715669766992,CSS 202S,A01,494387,Mignozzetti; Umberto,35,0,35,0
1715669768019,DSC 197,001,628532,Eldridge; Justin Matthew,9995,0,9999,4
1715669769047,EAP 100,A00,516065,Staff,9799,0,9999,200
1715669770077,ECE 45,A01,507414,Staff,32,0,60,28
1715669772131,ECE 111,A01,507420,Staff,11,0,50,39
1715669773158,ECE 197,001,548057,Sievenpiper; Daniel F.,9991,0,9999,8
1715669774188,EDS 115,A00,507243,Choi; Bailey Miyeon,6,0,28,22
1715669775213,EDS 117,A01,494379,Staff,0,6,34,35
1715669776238,EDS 125,A00,507246,Hopkins; Megan Beth,7,0,30,23
1715669777266,EDS 128A,A01,507264,Fargason; Sharon Gayle,5,0,26,21
1715669778292,EDS 128B,A01,507293,Pappas; Elizabeth,9,0,30,21
1715669779321,EDS 139,A00,507294,Fargason; Sharon Gayle,9,0,30,21
1715669779321,EDS 139,B00,507313,Pappas; Elizabeth,9,0,30,21
1715669780345,EDS 201,A00,507315,Staff,10,0,30,20
1715669781370,EDS 203,A01,507317,Halter; Christopher P.,10,0,30,20
1715669782398,EDS 204R,A01,507319,Halter; Christopher P.,0,3,30,30
1715669782398,EDS 204R,B01,507331,Heinzman; Erica M.,14,0,30,16
1715669783426,EDS 206R,A00,507332,Staff,0,4,30,30
1715669783426,EDS 206R,B00,507343,Staff,15,0,30,15
1715669784455,EDS 250,A00,507344,Hemans; Patricia Ann Benitez,20,0,40,20
1715669785486,EDS 281,A00,507345,Daly; Alan J.,18,0,18,0
1715669786513,EDS 284,A00,507350,Daly; Alan J.,16,0,16,0
1715669787539,EDS 286,A00,507359,Fine; Sarah,18,0,18,0
1715669788563,EDS 289C,A01,507361,Daly; Alan J.,18,0,18,0
1715669789589,EDS 290,A00,507366,Hofstetter; Carolyn,15,0,15,0
1715669790617,LIGM 5A,A00,507421,Fischer-Grunski; Eva K,17,0,20,3
1715669791645,LIGM 5B,A00,507423,Fischer-Grunski; Eva K,19,0,20,1
1715669792671,LIGM 5C,A00,507425,Fischer-Grunski; Eva K,19,0,20,1
1715669793697,LIIT 5AS,A00,507427,Carnelos; Chiara,20,0,20,0
1715669794725,LIIT 5BS,A00,507430,Carnelos; Chiara,20,0,20,0
1715669795755,LIIT 5CS,A00,507432,Carnelos; Chiara,20,0,20,0
1715669796782,LISP 5A,A00,507541,Munoz Sanchez; Alicia,11,0,20,9
1715669797808,LISP 5B,A00,507671,Munoz Sanchez; Alicia,8,0,20,12
1715669798835,LISP 5C,A00,507696,Munoz Sanchez; Alicia,7,0,20,13
1715669799865,MAE 197,001,528363,Boechler; Nicholas Sebastia,9998,0,9999,1
1715669800892,MATH 197,001,523477,Kedlaya; Kiran S.,9994,0,9999,5
1715669800892,MATH 197,002,563811,Zhang; Danna,9994,0,9999,5
1715669800892,MATH 197,003,628552,Dumitriu; Ioana,9998,0,9999,1
1715669800892,MATH 197,004,660885,Floyd; Eric,9998,0,9999,1
1715669801919,MCWP 40R,A00,518780,Staff,1,0,20,19
1715669801919,MCWP 40R,B00,518781,Carter; Jennifer A,9,0,20,11
1715669801919,MCWP 40R,C00,518783,Smith; Haydee Marie,5,0,20,15
1715669803017,MCWP 50R,A00,518791,Redela; Pamela Morgan,0,1,20,20
1715669803017,MCWP 50R,B00,518792,Krone; Jarret,0,2,20,20
1715669803017,MCWP 50R,C00,518793,Staff,0,4,20,20
1715669803017,MCWP 50R,D00,518794,Morshed; Michael James,0,2,20,20
1715669803017,MCWP 50R,E00,518795,Carter; Andrea L,0,2,20,20
1715669803017,MCWP 50R,F00,518796,Miller; Elizabeth Deen,0,1,20,20
1715669803017,MCWP 50R,G00,518797,Guillen; Melinda,0,1,20,20
1715669804043,MMW 12R,A01,514034,Herbst; Matthew,0,2,16,16
1715669804043,MMW 12R,A02,514035,Herbst; Matthew,0,0,16,16
1715669805069,MMW 13R,A01,514037,Staff,0,5,16,16
1715669805069,MMW 13R,A02,514039,Staff,0,5,16,16
1715669805069,MMW 13R,A03,628519,Staff,0,4,16,16
1715669807124,SIO 295LS,A00,523233,Staff,10,0,30,20
1715669808148,SIO 295S,A00,523232,Staff,10,0,30,20
1715669809175,SIOC 290S,A01,637330,Merrifield; Mark A,21,0,30,9
1715669810205,SIOC 291S,A01,637333,Gabriel; Corey John,21,0,30,9
1715669811231,SOCI 117,A01,494376,Staff,0,5,5,5
1715669812256,WES 237B,A00,494380,Staff,10,0,20,10
1715669814330,AESE 279B,A00,494370,Wade; Jon P,0,0,33,33
1715669815355,AIP 97,001,660915,Van Den Einde; Yael Dahlia,9998,0,9999,1
1715669816385,AIP 197,001,627712,Vespa; Emanuel Ignacio,9995,0,9999,4
1715669816385,AIP 197,002,650778,Amir; On,9998,0,9999,1
1715669816385,AIP 197,003,650933,Avenancio-Leon; Carlos,9998,0,9999,1
1715669816385,AIP 197,004,658530,Heyman; Gail D.,9998,0,9999,1
1715669816385,AIP 197,005,658631,Neal; Sonya E,9998,0,9999,1
1715669816385,AIP 197,006,658671,Du; Songzi,9998,0,9999,1
1715669817413,ANAR 135S,A00,494369,Braswell; Geoffrey E.,0,0,0,0
1715669818444,BENG 196,001,628496,Engler; Adam J.,9998,0,9999,1
1715669818444,BENG 196,002,660916,Watson; John Thomas,9998,0,9999,1
1715669819474,BISP 197,001,650773,Wilhelm; James E.,9994,0,9999,5
1715669819474,BISP 197,002,658904,Coleman; Aaron B.,9998,0,9999,1
1715669820501,CAT 124RS,A01,519847,Geibel; William,0,0,20,20
1715669821528,CAT 125RS,A01,515971,Geibel; William,0,0,20,20
1715669822558,CLRE 250,A00,511389,Morris; Sheldon,9992,0,9999,7
1715669823585,CLRE 251,A00,507176,Mehta; Ravindra L.,9992,0,9999,7
1715669823585,CLRE 251,B00,511410,Mehta; Ravindra L.,9998,0,9999,1
1715669824615,CLRE 252,A00,507189,Cuomo; Raphael Eduardo,9994,0,9999,5
1715669825645,CLRE 253,A00,507199,Vaida; Florin,9994,0,9999,5
1715669825645,CLRE 253,B00,507202,Vaida; Florin,9999,0,9999,0
1715669826670,CLRE 259,A00,507211,Patel; Hemal,9996,0,9999,3
1715669827700,CLRE 260,A00,507221,Cuomo; Raphael Eduardo,9999,0,9999,0
1715669828724,CLRE 297,001,507242,Cuomo; Raphael Eduardo,9999,0,9999,0
1715669829751,COGS 197,001,638244,Voytek; Bradley Thomas,9997,0,9999,2
1715669830778,CSE 191,A00,516875,Minnes Kemp; Mor Mia,9991,0,9999,8
1715669831803,CSE 197,001,637388,Minnes Kemp; Mor Mia,9992,0,9999,7
1715669832836,CSS 201S,A01,494383,Mignozzetti; Umberto,35,0,35,0
1715669833864,CSS 202S,A01,494387,Mignozzetti; Umberto,35,0,35,0
1715669834889,DSC 197,001,628532,Eldridge; Justin Matthew,9995,0,9999,4
1715669835916,EAP 100,A00,516065,Staff,9799,0,9999,200
1715669836949,ECE 45,A01,507414,Staff,32,0,60,28
1715669839003,ECE 111,A01,507420,Staff,11,0,50,39
1715669840027,ECE 197,001,548057,Sievenpiper; Daniel F.,9991,0,9999,8
1715669841053,EDS 115,A00,507243,Choi; Bailey Miyeon,6,0,28,22
1715669842080,EDS 117,A01,494379,Staff,0,6,34,35
1715669843105,EDS 125,A00,507246,Hopkins; Megan Beth,7,0,30,23
1715669844135,EDS 128A,A01,507264,Fargason; Sharon Gayle,5,0,26,21
1715669845162,EDS 128B,A01,507293,Pappas; Elizabeth,9,0,30,21
1715669846189,EDS 139,A00,507294,Fargason; Sharon Gayle,9,0,30,21
1715669846189,EDS 139,B00,507313,Pappas; Elizabeth,9,0,30,21
1715669847217,EDS 201,A00,507315,Staff,10,0,30,20
1715669848246,EDS 203,A01,507317,Halter; Christopher P.,10,0,30,20
1715669849277,EDS 204R,A01,507319,Halter; Christopher P.,0,3,30,30
1715669849277,EDS 204R,B01,507331,Heinzman; Erica M.,14,0,30,16
1715669850303,EDS 206R,A00,507332,Staff,0,4,30,30
1715669850303,EDS 206R,B00,507343,Staff,15,0,30,15
1715669851329,EDS 250,A00,507344,Hemans; Patricia Ann Benitez,20,0,40,20
1715669852355,EDS 281,A00,507345,Daly; Alan J.,18,0,18,0
1715669853386,EDS 284,A00,507350,Daly; Alan J.,16,0,16,0
1715669854411,EDS 286,A00,507359,Fine; Sarah,18,0,18,0
1715669855437,EDS 289C,A01,507361,Daly; Alan J.,18,0,18,0
1715669856462,EDS 290,A00,507366,Hofstetter; Carolyn,15,0,15,0
1715669857488,LIGM 5A,A00,507421,Fischer-Grunski; Eva K,17,0,20,3
1715669858513,LIGM 5B,A00,507423,Fischer-Grunski; Eva K,19,0,20,1
1715669859538,LIGM 5C,A00,507425,Fischer-Grunski; Eva K,19,0,20,1
1715669860565,LIIT 5AS,A00,507427,Carnelos; Chiara,20,0,20,0
1715669861594,LIIT 5BS,A00,507430,Carnelos; Chiara,20,0,20,0
1715669862621,LIIT 5CS,A00,507432,Carnelos; Chiara,20,0,20,0
1715669863650,LISP 5A,A00,507541,Munoz Sanchez; Alicia,11,0,20,9
1715669864676,LISP 5B,A00,507671,Munoz Sanchez; Alicia,8,0,20,12
1715669865706,LISP 5C,A00,507696,Munoz Sanchez; Alicia,6,0,20,14
1715669866735,MAE 197,001,528363,Boechler; Nicholas Sebastia,9998,0,9999,1
1715669867762,MATH 197,001,523477,Kedlaya; Kiran S.,9994,0,9999,5
1715669867762,MATH 197,002,563811,Zhang; Danna,9994,0,9999,5
1715669867762,MATH 197,003,628552,Dumitriu; Ioana,9998,0,9999,1
1715669867762,MATH 197,004,660885,Floyd; Eric,9998,0,9999,1
1715669868793,MCWP 40R,A00,518780,Staff,1,0,20,19
1715669868793,MCWP 40R,B00,518781,Carter; Jennifer A,9,0,20,11
1715669868793,MCWP 40R,C00,518783,Smith; Haydee Marie,5,0,20,15
1715669869824,MCWP 50R,A00,518791,Redela; Pamela Morgan,0,1,20,20
1715669869824,MCWP 50R,B00,518792,Krone; Jarret,0,2,20,20
1715669869824,MCWP 50R,C00,518793,Staff,0,4,20,20
1715669869824,MCWP 50R,D00,518794,Morshed; Michael James,0,2,20,20
1715669869824,MCWP 50R,E00,518795,Carter; Andrea L,0,2,20,20
1715669869824,MCWP 50R,F00,518796,Miller; Elizabeth Deen,0,1,20,20
1715669869824,MCWP 50R,G00,518797,Guillen; Melinda,0,1,20,20
1715669870850,MMW 12R,A01,514034,Herbst; Matthew,0,2,16,16
1715669870850,MMW 12R,A02,514035,Herbst; Matthew,0,0,16,16
1715669871879,MMW 13R,A01,514037,Staff,0,5,16,16
1715669871879,MMW 13R,A02,514039,Staff,0,5,16,16
1715669871879,MMW 13R,A03,628519,Staff,0,4,16,16
1715669873932,SIO 295LS,A00,523233,Staff,10,0,30,20
1715669874958,SIO 295S,A00,523232,Staff,10,0,30,20
1715669875987,SIOC 290S,A01,637330,Merrifield; Mark A,21,0,30,9
1715669877013,SIOC 291S,A01,637333,Gabriel; Corey John,21,0,30,9
1715669878042,SOCI 117,A01,494376,Staff,0,5,5,5
1715669879066,WES 237B,A00,494380,Staff,10,0,20,10
1715669881148,AESE 279B,A00,494370,Wade; Jon P,0,0,33,33
1715669882175,AIP 97,001,660915,Van Den Einde; Yael Dahlia,9998,0,9999,1
1715669883212,AIP 197,001,627712,Vespa; Emanuel Ignacio,9995,0,9999,4
1715669883212,AIP 197,002,650778,Amir; On,9998,0,9999,1
1715669883212,AIP 197,003,650933,Avenancio-Leon; Carlos,9998,0,9999,1
1715669883212,AIP 197,004,658530,Heyman; Gail D.,9998,0,9999,1
1715669883212,AIP 197,005,658631,Neal; Sonya E,9998,0,9999,1
1715669883212,AIP 197,006,658671,Du; Songzi,9998,0,9999,1
1715669884240,ANAR 135S,A00,494369,Braswell; Geoffrey E.,0,0,0,0
1715669885266,BENG 196,001,628496,Engler; Adam J.,9998,0,9999,1
1715669885266,BENG 196,002,660916,Watson; John Thomas,9998,0,9999,1
1715669886293,BISP 197,001,650773,Wilhelm; James E.,9994,0,9999,5
1715669886293,BISP 197,002,658904,Coleman; Aaron B.,9998,0,9999,1
1715669887322,CAT 124RS,A01,519847,Geibel; William,0,0,20,20
1715669888346,CAT 125RS,A01,515971,Geibel; William,0,0,20,20
1715669889376,CLRE 250,A00,511389,Morris; Sheldon,9992,0,9999,7
1715669890405,CLRE 251,A00,507176,Mehta; Ravindra L.,9992,0,9999,7
1715669890405,CLRE 251,B00,511410,Mehta; Ravindra L.,9998,0,9999,1
1715669891431,CLRE 252,A00,507189,Cuomo; Raphael Eduardo,9994,0,9999,5
1715669892461,CLRE 253,A00,507199,Vaida; Florin,9994,0,9999,5
1715669892461,CLRE 253,B00,507202,Vaida; Florin,9999,0,9999,0
1715669893488,CLRE 259,A00,507211,Patel; Hemal,9996,0,9999,3
1715669894514,CLRE 260,A00,507221,Cuomo; Raphael Eduardo,9999,0,9999,0
1715669895538,CLRE 297,001,507242,Cuomo; Raphael Eduardo,9999,0,9999,0
1715669896568,COGS 197,001,638244,Voytek; Bradley Thomas,9997,0,9999,2
1715669897594,CSE 191,A00,516875,Minnes Kemp; Mor Mia,9991,0,9999,8
1715669898621,CSE 197,001,637388,Minnes Kemp; Mor Mia,9992,0,9999,7
1715669899652,CSS 201S,A01,494383,Mignozzetti; Umberto,35,0,35,0
1715669900678,CSS 202S,A01,494387,Mignozzetti; Umberto,35,0,35,0
1715669901706,DSC 197,001,628532,Eldridge; Justin Matthew,9995,0,9999,4
1715669902731,EAP 100,A00,516065,Staff,9799,0,9999,200
1715669903759,ECE 45,A01,507414,Staff,32,0,60,28
1715669905813,ECE 111,A01,507420,Staff,11,0,50,39
1715669906893,ECE 197,001,548057,Sievenpiper; Daniel F.,9991,0,9999,8
1715669907923,EDS 115,A00,507243,Choi; Bailey Miyeon,6,0,28,22
1715669908948,EDS 117,A01,494379,Staff,0,6,34,35
1715669909976,EDS 125,A00,507246,Hopkins; Megan Beth,7,0,30,23
1715669911009,EDS 128A,A01,507264,Fargason; Sharon Gayle,5,0,26,21
1715669912038,EDS 128B,A01,507293,Pappas; Elizabeth,9,0,30,21
1715669913063,EDS 139,A00,507294,Fargason; Sharon Gayle,9,0,30,21
1715669913063,EDS 139,B00,507313,Pappas; Elizabeth,9,0,30,21
1715669914091,EDS 201,A00,507315,Staff,10,0,30,20
1715669915117,EDS 203,A01,507317,Halter; Christopher P.,10,0,30,20
1715669916146,EDS 204R,A01,507319,Halter; Christopher P.,0,3,30,30
1715669916146,EDS 204R,B01,507331,Heinzman; Erica M.,14,0,30,16
1715669917177,EDS 206R,A00,507332,Staff,0,4,30,30
1715669917177,EDS 206R,B00,507343,Staff,15,0,30,15
1715669918203,EDS 250,A00,507344,Hemans; Patricia Ann Benitez,20,0,40,20
1715669919228,EDS 281,A00,507345,Daly; Alan J.,18,0,18,0
1715669920257,EDS 284,A00,507350,Daly; Alan J.,16,0,16,0
1715669921282,EDS 286,A00,507359,Fine; Sarah,18,0,18,0
1715669922309,EDS 289C,A01,507361,Daly; Alan J.,18,0,18,0
1715669923334,EDS 290,A00,507366,Hofstetter; Carolyn,15,0,15,0
1715669924364,LIGM 5A,A00,507421,Fischer-Grunski; Eva K,17,0,20,3
1715669925390,LIGM 5B,A00,507423,Fischer-Grunski; Eva K,19,0,20,1
1715669926419,LIGM 5C,A00,507425,Fischer-Grunski; Eva K,19,0,20,1
1715669927450,LIIT 5AS,A00,507427,Carnelos; Chiara,20,0,20,0
1715669928480,LIIT 5BS,A00,507430,Carnelos; Chiara,20,0,20,0
1715669929504,LIIT 5CS,A00,507432,Carnelos; Chiara,20,0,20,0
1715669930531,LISP 5A,A00,507541,Munoz Sanchez; Alicia,11,0,20,9
1715669931562,LISP 5B,A00,507671,Munoz Sanchez; Alicia,8,0,20,12
1715669932587,LISP 5C,A00,507696,Munoz Sanchez; Alicia,6,0,20,14
1715669933612,MAE 197,001,528363,Boechler; Nicholas Sebastia,9998,0,9999,1
1715669934649,MATH 197,001,523477,Kedlaya; Kiran S.,9994,0,9999,5
1715669934649,MATH 197,002,563811,Zhang; Danna,9994,0,9999,5
1715669934649,MATH 197,003,628552,Dumitriu; Ioana,9998,0,9999,1
1715669934649,MATH 197,004,660885,Floyd; Eric,9998,0,9999,1
1715669935674,MCWP 40R,A00,518780,Staff,1,0,20,19
1715669935674,MCWP 40R,B00,518781,Carter; Jennifer A,9,0,20,11
1715669935674,MCWP 40R,C00,518783,Smith; Haydee Marie,5,0,20,15
1715669936704,MCWP 50R,A00,518791,Redela; Pamela Morgan,0,1,20,20
1715669936704,MCWP 50R,B00,518792,Krone; Jarret,0,2,20,20
1715669936704,MCWP 50R,C00,518793,Staff,0,4,20,20
1715669936704,MCWP 50R,D00,518794,Morshed; Michael James,0,2,20,20
1715669936704,MCWP 50R,E00,518795,Carter; Andrea L,0,2,20,20
1715669936704,MCWP 50R,F00,518796,Miller; Elizabeth Deen,0,1,20,20
1715669936704,MCWP 50R,G00,518797,Guillen; Melinda,0,1,20,20
1715669937733,MMW 12R,A01,514034,Herbst; Matthew,0,2,16,16
1715669937733,MMW 12R,A02,514035,Herbst; Matthew,0,0,16,16
1715669938758,MMW 13R,A01,514037,Staff,0,5,16,16
1715669938758,MMW 13R,A02,514039,Staff,0,5,16,16
1715669938758,MMW 13R,A03,628519,Staff,0,4,16,16
1715669940812,SIO 295LS,A00,523233,Staff,10,0,30,20
1715669941850,SIO 295S,A00,523232,Staff,10,0,30,20
1715669942879,SIOC 290S,A01,637330,Merrifield; Mark A,21,0,30,9
1715669943906,SIOC 291S,A01,637333,Gabriel; Corey John,21,0,30,9
1715669944934,SOCI 117,A01,494376,Staff,0,5,5,5
1715669945961,WES 237B,A00,494380,Staff,10,0,20,10
1715669948030,AESE 279B,A00,494370,Wade; Jon P,0,0,33,33
1715669949061,AIP 97,001,660915,Van Den Einde; Yael Dahlia,9998,0,9999,1
1715669950095,AIP 197,001,627712,Vespa; Emanuel Ignacio,9995,0,9999,4
1715669950095,AIP 197,002,650778,Amir; On,9998,0,9999,1
1715669950095,AIP 197,003,650933,Avenancio-Leon; Carlos,9998,0,9999,1
1715669950095,AIP 197,004,658530,Heyman; Gail D.,9998,0,9999,1
1715669950095,AIP 197,005,658631,Neal; Sonya E,9998,0,9999,1
1715669950095,AIP 197,006,658671,Du; Songzi,9998,0,9999,1
1715669951122,ANAR 135S,A00,494369,Braswell; Geoffrey E.,0,0,0,0
1715669952148,BENG 196,001,628496,Engler; Adam J.,9998,0,9999,1
1715669952148,BENG 196,002,660916,Watson; John Thomas,9998,0,9999,1
1715669953173,BISP 197,001,650773,Wilhelm; James E.,9994,0,9999,5
1715669953173,BISP 197,002,658904,Coleman; Aaron B.,9998,0,9999,1
1715669954202,CAT 124RS,A01,519847,Geibel; William,0,0,20,20
1715669955231,CAT 125RS,A01,515971,Geibel; William,0,0,20,20
1715669956255,CLRE 250,A00,511389,Morris; Sheldon,9992,0,9999,7
1715669957284,CLRE 251,A00,507176,Mehta; Ravindra L.,9992,0,9999,7
1715669957284,CLRE 251,B00,511410,Mehta; Ravindra L.,9998,0,9999,1
1715669958311,CLRE 252,A00,507189,Cuomo; Raphael Eduardo,9994,0,9999,5
1715669959337,CLRE 253,A00,507199,Vaida; Florin,9994,0,9999,5
1715669959337,CLRE 253,B00,507202,Vaida; Florin,9999,0,9999,0
1715669960365,CLRE 259,A00,507211,Patel; Hemal,9996,0,9999,3
1715669961395,CLRE 260,A00,507221,Cuomo; Raphael Eduardo,9999,0,9999,0
1715669962420,CLRE 297,001,507242,Cuomo; Raphael Eduardo,9999,0,9999,0
1715669963450,COGS 197,001,638244,Voytek; Bradley Thomas,9997,0,9999,2
1715669964480,CSE 191,A00,516875,Minnes Kemp; Mor Mia,9991,0,9999,8
1715669965506,CSE 197,001,637388,Minnes Kemp; Mor Mia,9992,0,9999,7
1715669966531,CSS 201S,A01,494383,Mignozzetti; Umberto,35,0,35,0
1715669967561,CSS 202S,A01,494387,Mignozzetti; Umberto,35,0,35,0
1715669968586,DSC 197,001,628532,Eldridge; Justin Matthew,9995,0,9999,4
1715669969613,EAP 100,A00,516065,Staff,9799,0,9999,200
1715669970644,ECE 45,A01,507414,Staff,32,0,60,28
1715669972699,ECE 111,A01,507420,Staff,11,0,50,39
1715669973725,ECE 197,001,548057,Sievenpiper; Daniel F.,9991,0,9999,8
1715669974750,EDS 115,A00,507243,Choi; Bailey Miyeon,6,0,28,22
1715669975775,EDS 117,A01,494379,Staff,0,6,34,35
1715669976800,EDS 125,A00,507246,Hopkins; Megan Beth,7,0,30,23
1715669977829,EDS 128A,A01,507264,Fargason; Sharon Gayle,5,0,26,21
1715669978858,EDS 128B,A01,507293,Pappas; Elizabeth,9,0,30,21
1715669979887,EDS 139,A00,507294,Fargason; Sharon Gayle,9,0,30,21
1715669979887,EDS 139,B00,507313,Pappas; Elizabeth,9,0,30,21
1715669980912,EDS 201,A00,507315,Staff,10,0,30,20
1715669981940,EDS 203,A01,507317,Halter; Christopher P.,10,0,30,20
1715669982967,EDS 204R,A01,507319,Halter; Christopher P.,0,3,30,30
1715669982967,EDS 204R,B01,507331,Heinzman; Erica M.,14,0,30,16
1715669983992,EDS 206R,A00,507332,Staff,0,4,30,30
1715669983992,EDS 206R,B00,507343,Staff,15,0,30,15
1715669985019,EDS 250,A00,507344,Hemans; Patricia Ann Benitez,20,0,40,20
1715669986045,EDS 281,A00,507345,Daly; Alan J.,18,0,18,0
1715669987076,EDS 284,A00,507350,Daly; Alan J.,16,0,16,0
1715669988107,EDS 286,A00,507359,Fine; Sarah,18,0,18,0
1715669989132,EDS 289C,A01,507361,Daly; Alan J.,18,0,18,0
1715669990158,EDS 290,A00,507366,Hofstetter; Carolyn,15,0,15,0
1715669991185,LIGM 5A,A00,507421,Fischer-Grunski; Eva K,17,0,20,3
1715669992210,LIGM 5B,A00,507423,Fischer-Grunski; Eva K,19,0,20,1
1715669993236,LIGM 5C,A00,507425,Fischer-Grunski; Eva K,19,0,20,1
1715669994263,LIIT 5AS,A00,507427,Carnelos; Chiara,20,0,20,0
1715669995292,LIIT 5BS,A00,507430,Carnelos; Chiara,20,0,20,0
1715669996319,LIIT 5CS,A00,507432,Carnelos; Chiara,20,0,20,0
1715669997345,LISP 5A,A00,507541,Munoz Sanchez; Alicia,11,0,20,9
1715669998371,LISP 5B,A00,507671,Munoz Sanchez; Alicia,8,0,20,12
1715669999402,LISP 5C,A00,507696,Munoz Sanchez; Alicia,6,0,20,14
1715670000433,MAE 197,001,528363,Boechler; Nicholas Sebastia,9998,0,9999,1
1715670001469,MATH 197,001,523477,Kedlaya; Kiran S.,9994,0,9999,5
1715670001469,MATH 197,002,563811,Zhang; Danna,9994,0,9999,5
1715670001469,MATH 197,003,628552,Dumitriu; Ioana,9998,0,9999,1
1715670001469,MATH 197,004,660885,Floyd; Eric,9998,0,9999,1
1715670002500,MCWP 40R,A00,518780,Staff,1,0,20,19
1715670002500,MCWP 40R,B00,518781,Carter; Jennifer A,9,0,20,11
1715670002500,MCWP 40R,C00,518783,Smith; Haydee Marie,5,0,20,15
1715670003538,MCWP 50R,A00,518791,Redela; Pamela Morgan,0,1,20,20
1715670003538,MCWP 50R,B00,518792,Krone; Jarret,0,2,20,20
1715670003538,MCWP 50R,C00,518793,Staff,0,4,20,20
1715670003538,MCWP 50R,D00,518794,Morshed; Michael James,0,2,20,20
1715670003538,MCWP 50R,E00,518795,Carter; Andrea L,0,2,20,20
1715670003538,MCWP 50R,F00,518796,Miller; Elizabeth Deen,0,1,20,20
1715670003538,MCWP 50R,G00,518797,Guillen; Melinda,0,1,20,20
1715670004563,MMW 12R,A01,514034,Herbst; Matthew,0,2,16,16
1715670004563,MMW 12R,A02,514035,Herbst; Matthew,0,0,16,16
1715670005589,MMW 13R,A01,514037,Staff,0,5,16,16
1715670005589,MMW 13R,A02,514039,Staff,0,5,16,16
1715670005589,MMW 13R,A03,628519,Staff,0,4,16,16
1715670007639,SIO 295LS,A00,523233,Staff,10,0,30,20
1715670008665,SIO 295S,A00,523232,Staff,10,0,30,20
1715670009692,SIOC 290S,A01,637330,Merrifield; Mark A,21,0,30,9
1715670010799,SIOC 291S,A01,637333,Gabriel; Corey John,21,0,30,9
1715670011828,SOCI 117,A01,494376,Staff,0,5,5,5
1715670012859,WES 237B,A00,494380,Staff,10,0,20,10
1715670014940,AESE 279B,A00,494370,Wade; Jon P,0,0,33,33
1715670015969,AIP 97,001,660915,Van Den Einde; Yael Dahlia,9998,0,9999,1
1715670016998,AIP 197,001,627712,Vespa; Emanuel Ignacio,9995,0,9999,4
1715670016998,AIP 197,002,650778,Amir; On,9998,0,9999,1
1715670016998,AIP 197,003,650933,Avenancio-Leon; Carlos,9998,0,9999,1
1715670016998,AIP 197,004,658530,Heyman; Gail D.,9998,0,9999,1
1715670016998,AIP 197,005,658631,Neal; Sonya E,9998,0,9999,1
1715670016998,AIP 197,006,658671,Du; Songzi,9998,0,9999,1
1715670018024,ANAR 135S,A00,494369,Braswell; Geoffrey E.,0,0,0,0
1715670019049,BENG 196,001,628496,Engler; Adam J.,9998,0,9999,1
1715670019049,BENG 196,002,660916,Watson; John Thomas,9998,0,9999,1
1715670020075,BISP 197,001,650773,Wilhelm; James E.,9994,0,9999,5
1715670020075,BISP 197,002,658904,Coleman; Aaron B.,9998,0,9999,1
1715670021100,CAT 124RS,A01,519847,Geibel; William,0,0,20,20
1715670022128,CAT 125RS,A01,515971,Geibel; William,0,0,20,20
1715670023153,CLRE 250,A00,511389,Morris; Sheldon,9992,0,9999,7
1715670024185,CLRE 251,A00,507176,Mehta; Ravindra L.,9992,0,9999,7
1715670024185,CLRE 251,B00,511410,Mehta; Ravindra L.,9998,0,9999,1
1715670025214,CLRE 252,A00,507189,Cuomo; Raphael Eduardo,9994,0,9999,5
1715670026241,CLRE 253,A00,507199,Vaida; Florin,9994,0,9999,5
1715670026241,CLRE 253,B00,507202,Vaida; Florin,9999,0,9999,0
1715670027270,CLRE 259,A00,507211,Patel; Hemal,9996,0,9999,3
1715670028297,CLRE 260,A00,507221,Cuomo; Raphael Eduardo,9999,0,9999,0
1715670029324,CLRE 297,001,507242,Cuomo; Raphael Eduardo,9999,0,9999,0
1715670030355,COGS 197,001,638244,Voytek; Bradley Thomas,9997,0,9999,2
1715670031385,CSE 191,A00,516875,Minnes Kemp; Mor Mia,9991,0,9999,8
1715670032414,CSE 197,001,637388,Minnes Kemp; Mor Mia,9992,0,9999,7
1715670033441,CSS 201S,A01,494383,Mignozzetti; Umberto,35,0,35,0
1715670034466,CSS 202S,A01,494387,Mignozzetti; Umberto,35,0,35,0
1715670035496,DSC 197,001,628532,Eldridge; Justin Matthew,9995,0,9999,4
1715670036521,EAP 100,A00,516065,Staff,9799,0,9999,200
1715670037555,ECE 45,A01,507414,Staff,32,0,60,28
1715670039610,ECE 111,A01,507420,Staff,11,0,50,39
1715670040640,ECE 197,001,548057,Sievenpiper; Daniel F.,9991,0,9999,8
1715670041667,EDS 115,A00,507243,Choi; Bailey Miyeon,6,0,28,22
1715670042697,EDS 117,A01,494379,Staff,0,6,34,35
1715670043728,EDS 125,A00,507246,Hopkins; Megan Beth,7,0,30,23
1715670044754,EDS 128A,A01,507264,Fargason; Sharon Gayle,5,0,26,21
1715670045785,EDS 128B,A01,507293,Pappas; Elizabeth,9,0,30,21
1715670046810,EDS 139,A00,507294,Fargason; Sharon Gayle,9,0,30,21
1715670046810,EDS 139,B00,507313,Pappas; Elizabeth,9,0,30,21
1715670047835,EDS 201,A00,507315,Staff,10,0,30,20
1715670048861,EDS 203,A01,507317,Halter; Christopher P.,10,0,30,20
1715670049886,EDS 204R,A01,507319,Halter; Christopher P.,0,3,30,30
1715670049886,EDS 204R,B01,507331,Heinzman; Erica M.,14,0,30,16
1715670050912,EDS 206R,A00,507332,Staff,0,4,30,30
1715670050912,EDS 206R,B00,507343,Staff,15,0,30,15
1715670051943,EDS 250,A00,507344,Hemans; Patricia Ann Benitez,20,0,40,20
1715670052972,EDS 281,A00,507345,Daly; Alan J.,18,0,18,0
1715670053999,EDS 284,A00,507350,Daly; Alan J.,16,0,16,0
1715670055024,EDS 286,A00,507359,Fine; Sarah,18,0,18,0
1715670056050,EDS 289C,A01,507361,Daly; Alan J.,18,0,18,0
1715670057076,EDS 290,A00,507366,Hofstetter; Carolyn,15,0,15,0
1715670058103,LIGM 5A,A00,507421,Fischer-Grunski; Eva K,17,0,20,3
1715670059134,LIGM 5B,A00,507423,Fischer-Grunski; Eva K,19,0,20,1
1715670060161,LIGM 5C,A00,507425,Fischer-Grunski; Eva K,19,0,20,1
1715670061189,LIIT 5AS,A00,507427,Carnelos; Chiara,20,0,20,0
1715670062216,LIIT 5BS,A00,507430,Carnelos; Chiara,20,0,20,0
1715670063244,LIIT 5CS,A00,507432,Carnelos; Chiara,20,0,20,0
1715670064271,LISP 5A,A00,507541,Munoz Sanchez; Alicia,11,0,20,9
1715670065301,LISP 5B,A00,507671,Munoz Sanchez; Alicia,8,0,20,12
1715670066329,LISP 5C,A00,507696,Munoz Sanchez; Alicia,6,0,20,14
1715670067355,MAE 197,001,528363,Boechler; Nicholas Sebastia,9998,0,9999,1
1715670068395,MATH 197,001,523477,Kedlaya; Kiran S.,9994,0,9999,5
1715670068395,MATH 197,002,563811,Zhang; Danna,9994,0,9999,5
1715670068395,MATH 197,003,628552,Dumitriu; Ioana,9998,0,9999,1
1715670068395,MATH 197,004,660885,Floyd; Eric,9998,0,9999,1
1715670069423,MCWP 40R,A00,518780,Staff,1,0,20,19
1715670069423,MCWP 40R,B00,518781,Carter; Jennifer A,9,0,20,11
1715670069423,MCWP 40R,C00,518783,Smith; Haydee Marie,5,0,20,15
1715670070469,MCWP 50R,A00,518791,Redela; Pamela Morgan,0,1,20,20
1715670070469,MCWP 50R,B00,518792,Krone; Jarret,0,2,20,20
1715670070469,MCWP 50R,C00,518793,Staff,0,4,20,20
1715670070469,MCWP 50R,D00,518794,Morshed; Michael James,0,2,20,20
1715670070469,MCWP 50R,E00,518795,Carter; Andrea L,0,2,20,20
1715670070469,MCWP 50R,F00,518796,Miller; Elizabeth Deen,0,1,20,20
1715670070469,MCWP 50R,G00,518797,Guillen; Melinda,0,1,20,20
1715670071494,MMW 12R,A01,514034,Herbst; Matthew,0,2,16,16
1715670071494,MMW 12R,A02,514035,Herbst; Matthew,0,0,16,16
1715670072520,MMW 13R,A01,514037,Staff,0,5,16,16
1715670072520,MMW 13R,A02,514039,Staff,0,5,16,16
1715670072520,MMW 13R,A03,628519,Staff,0,4,16,16
1715670074588,SIO 295LS,A00,523233,Staff,10,0,30,20
1715670075614,SIO 295S,A00,523232,Staff,10,0,30,20
1715670076642,SIOC 290S,A01,637330,Merrifield; Mark A,21,0,30,9
1715670077669,SIOC 291S,A01,637333,Gabriel; Corey John,21,0,30,9
1715670078695,SOCI 117,A01,494376,Staff,0,5,5,5
1715670079737,WES 237B,A00,494380,Staff,10,0,20,10
1715670081818,AESE 279B,A00,494370,Wade; Jon P,0,0,33,33
1715670082844,AIP 97,001,660915,Van Den Einde; Yael Dahlia,9998,0,9999,1
1715670083882,AIP 197,001,627712,Vespa; Emanuel Ignacio,9995,0,9999,4
1715670083882,AIP 197,002,650778,Amir; On,9998,0,9999,1
1715670083882,AIP 197,003,650933,Avenancio-Leon; Carlos,9998,0,9999,1
1715670083882,AIP 197,004,658530,Heyman; Gail D.,9998,0,9999,1
1715670083882,AIP 197,005,658631,Neal; Sonya E,9998,0,9999,1
1715670083882,AIP 197,006,658671,Du; Songzi,9998,0,9999,1
1715670084909,ANAR 135S,A00,494369,Braswell; Geoffrey E.,0,0,0,0
1715670085937,BENG 196,001,628496,Engler; Adam J.,9998,0,9999,1
1715670085937,BENG 196,002,660916,Watson; John Thomas,9998,0,9999,1
1715670086963,BISP 197,001,650773,Wilhelm; James E.,9994,0,9999,5
1715670086963,BISP 197,002,658904,Coleman; Aaron B.,9998,0,9999,1
1715670087990,CAT 124RS,A01,519847,Geibel; William,0,0,20,20
1715670089027,CAT 125RS,A01,515971,Geibel; William,0,0,20,20
1715670090053,CLRE 250,A00,511389,Morris; Sheldon,9992,0,9999,7
1715670091080,CLRE 251,A00,507176,Mehta; Ravindra L.,9992,0,9999,7
1715670091080,CLRE 251,B00,511410,Mehta; Ravindra L.,9998,0,9999,1
1715670092105,CLRE 252,A00,507189,Cuomo; Raphael Eduardo,9994,0,9999,5
1715670093131,CLRE 253,A00,507199,Vaida; Florin,9994,0,9999,5
1715670093131,CLRE 253,B00,507202,Vaida; Florin,9999,0,9999,0
1715670094157,CLRE 259,A00,507211,Patel; Hemal,9996,0,9999,3
1715670095183,CLRE 260,A00,507221,Cuomo; Raphael Eduardo,9999,0,9999,0
1715670096209,CLRE 297,001,507242,Cuomo; Raphael Eduardo,9999,0,9999,0
1715670097237,COGS 197,001,638244,Voytek; Bradley Thomas,9997,0,9999,2
1715670098272,CSE 191,A00,516875,Minnes Kemp; Mor Mia,9991,0,9999,8
1715670099297,CSE 197,001,637388,Minnes Kemp; Mor Mia,9992,0,9999,7
1715670100337,CSS 201S,A01,494383,Mignozzetti; Umberto,35,0,35,0
1715670101372,CSS 202S,A01,494387,Mignozzetti; Umberto,35,0,35,0
1715670102409,DSC 197,001,628532,Eldridge; Justin Matthew,9995,0,9999,4
1715670103433,EAP 100,A00,516065,Staff,9799,0,9999,200
1715670104459,ECE 45,A01,507414,Staff,32,0,60,28
1715670106511,ECE 111,A01,507420,Staff,11,0,50,39
1715670107535,ECE 197,001,548057,Sievenpiper; Daniel F.,9991,0,9999,8
1715670108573,EDS 115,A00,507243,Choi; Bailey Miyeon,6,0,28,22
1715670109598,EDS 117,A01,494379,Staff,0,6,34,35
1715670110625,EDS 125,A00,507246,Hopkins; Megan Beth,7,0,30,23
1715670111653,EDS 128A,A01,507264,Fargason; Sharon Gayle,5,0,26,21
1715670112679,EDS 128B,A01,507293,Pappas; Elizabeth,9,0,30,21
1715670113703,EDS 139,A00,507294,Fargason; Sharon Gayle,9,0,30,21
1715670113703,EDS 139,B00,507313,Pappas; Elizabeth,9,0,30,21
1715670114789,EDS 201,A00,507315,Staff,10,0,30,20
1715670115814,EDS 203,A01,507317,Halter; Christopher P.,10,0,30,20
1715670116843,EDS 204R,A01,507319,Halter; Christopher P.,0,3,30,30
1715670116843,EDS 204R,B01,507331,Heinzman; Erica M.,14,0,30,16
1715670117867,EDS 206R,A00,507332,Staff,0,4,30,30
1715670117867,EDS 206R,B00,507343,Staff,15,0,30,15
1715670118892,EDS 250,A00,507344,Hemans; Patricia Ann Benitez,20,0,40,20
1715670119922,EDS 281,A00,507345,Daly; Alan J.,18,0,18,0
1715670120948,EDS 284,A00,507350,Daly; Alan J.,16,0,16,0
1715670121977,EDS 286,A00,507359,Fine; Sarah,18,0,18,0
1715670123002,EDS 289C,A01,507361,Daly; Alan J.,18,0,18,0
1715670124029,EDS 290,A00,507366,Hofstetter; Carolyn,15,0,15,0
1715670125056,LIGM 5A,A00,507421,Fischer-Grunski; Eva K,17,0,20,3
1715670126087,LIGM 5B,A00,507423,Fischer-Grunski; Eva K,19,0,20,1
1715670127117,LIGM 5C,A00,507425,Fischer-Grunski; Eva K,19,0,20,1
1715670128142,LIIT 5AS,A00,507427,Carnelos; Chiara,20,0,20,0
1715670129168,LIIT 5BS,A00,507430,Carnelos; Chiara,20,0,20,0
1715670130201,LIIT 5CS,A00,507432,Carnelos; Chiara,20,0,20,0
1715670131228,LISP 5A,A00,507541,Munoz Sanchez; Alicia,11,0,20,9
1715670132256,LISP 5B,A00,507671,Munoz Sanchez; Alicia,8,0,20,12
1715670133288,LISP 5C,A00,507696,Munoz Sanchez; Alicia,6,0,20,14
1715670134322,MAE 197,001,528363,Boechler; Nicholas Sebastia,9998,0,9999,1
1715670135353,MATH 197,001,523477,Kedlaya; Kiran S.,9994,0,9999,5
1715670135353,MATH 197,002,563811,Zhang; Danna,9994,0,9999,5
1715670135353,MATH 197,003,628552,Dumitriu; Ioana,9998,0,9999,1
1715670135353,MATH 197,004,660885,Floyd; Eric,9998,0,9999,1
1715670136390,MCWP 40R,A00,518780,Staff,1,0,20,19
1715670136390,MCWP 40R,B00,518781,Carter; Jennifer A,9,0,20,11
1715670136390,MCWP 40R,C00,518783,Smith; Haydee Marie,5,0,20,15
1715670137419,MCWP 50R,A00,518791,Redela; Pamela Morgan,0,1,20,20
1715670137419,MCWP 50R,B00,518792,Krone; Jarret,0,2,20,20
1715670137419,MCWP 50R,C00,518793,Staff,0,4,20,20
1715670137419,MCWP 50R,D00,518794,Morshed; Michael James,0,2,20,20
1715670137419,MCWP 50R,E00,518795,Carter; Andrea L,0,2,20,20
1715670137419,MCWP 50R,F00,518796,Miller; Elizabeth Deen,0,1,20,20
1715670137419,MCWP 50R,G00,518797,Guillen; Melinda,0,1,20,20
1715670138446,MMW 12R,A01,514034,Herbst; Matthew,0,2,16,16
1715670138446,MMW 12R,A02,514035,Herbst; Matthew,0,0,16,16
1715670139475,MMW 13R,A01,514037,Staff,0,5,16,16
1715670139475,MMW 13R,A02,514039,Staff,0,5,16,16
1715670139475,MMW 13R,A03,628519,Staff,0,4,16,16
1715670141536,SIO 295LS,A00,523233,Staff,10,0,30,20
1715670142561,SIO 295S,A00,523232,Staff,10,0,30,20
1715670143589,SIOC 290S,A01,637330,Merrifield; Mark A,21,0,30,9
1715670144620,SIOC 291S,A01,637333,Gabriel; Corey John,21,0,30,9
1715670145649,SOCI 117,A01,494376,Staff,0,5,5,5
1715670146678,WES 237B,A00,494380,Staff,10,0,20,10
1715670148757,AESE 279B,A00,494370,Wade; Jon P,0,0,33,33
1715670149786,AIP 97,001,660915,Van Den Einde; Yael Dahlia,9998,0,9999,1
1715670150818,AIP 197,001,627712,Vespa; Emanuel Ignacio,9995,0,9999,4
1715670150818,AIP 197,002,650778,Amir; On,9998,0,9999,1
1715670150818,AIP 197,003,650933,Avenancio-Leon; Carlos,9998,0,9999,1
1715670150818,AIP 197,004,658530,Heyman; Gail D.,9998,0,9999,1
1715670150818,AIP 197,005,658631,Neal; Sonya E,9998,0,9999,1
1715670150818,AIP 197,006,658671,Du; Songzi,9998,0,9999,1
1715670151853,ANAR 135S,A00,494369,Braswell; Geoffrey E.,0,0,0,0
1715670152878,BENG 196,001,628496,Engler; Adam J.,9998,0,9999,1
1715670152878,BENG 196,002,660916,Watson; John Thomas,9998,0,9999,1
1715670153905,BISP 197,001,650773,Wilhelm; James E.,9994,0,9999,5
1715670153905,BISP 197,002,658904,Coleman; Aaron B.,9998,0,9999,1
1715670154935,CAT 124RS,A01,519847,Geibel; William,0,0,20,20
1715670155965,CAT 125RS,A01,515971,Geibel; William,0,0,20,20
1715670156992,CLRE 250,A00,511389,Morris; Sheldon,9992,0,9999,7
1715670158020,CLRE 251,A00,507176,Mehta; Ravindra L.,9992,0,9999,7
1715670158020,CLRE 251,B00,511410,Mehta; Ravindra L.,9998,0,9999,1
1715670159054,CLRE 252,A00,507189,Cuomo; Raphael Eduardo,9994,0,9999,5
1715670160080,CLRE 253,A00,507199,Vaida; Florin,9994,0,9999,5
1715670160080,CLRE 253,B00,507202,Vaida; Florin,9999,0,9999,0
1715670161113,CLRE 259,A00,507211,Patel; Hemal,9996,0,9999,3
1715670162142,CLRE 260,A00,507221,Cuomo; Raphael Eduardo,9999,0,9999,0
1715670163171,CLRE 297,001,507242,Cuomo; Raphael Eduardo,9999,0,9999,0
1715670164203,COGS 197,001,638244,Voytek; Bradley Thomas,9997,0,9999,2
1715670165229,CSE 191,A00,516875,Minnes Kemp; Mor Mia,9991,0,9999,8
1715670166263,CSE 197,001,637388,Minnes Kemp; Mor Mia,9992,0,9999,7
1715670167290,CSS 201S,A01,494383,Mignozzetti; Umberto,35,0,35,0
1715670168314,CSS 202S,A01,494387,Mignozzetti; Umberto,35,0,35,0
1715670169341,DSC 197,001,628532,Eldridge; Justin Matthew,9995,0,9999,4
1715670170366,EAP 100,A00,516065,Staff,9799,0,9999,200
1715670171401,ECE 45,A01,507414,Staff,32,0,60,28
1715670173464,ECE 111,A01,507420,Staff,11,0,50,39
1715670174490,ECE 197,001,548057,Sievenpiper; Daniel F.,9991,0,9999,8
1715670175518,EDS 115,A00,507243,Choi; Bailey Miyeon,6,0,28,22
1715670176550,EDS 117,A01,494379,Staff,0,6,34,35
1715670177576,EDS 125,A00,507246,Hopkins; Megan Beth,7,0,30,23
1715670178607,EDS 128A,A01,507264,Fargason; Sharon Gayle,5,0,26,21
1715670179633,EDS 128B,A01,507293,Pappas; Elizabeth,9,0,30,21
1715670180666,EDS 139,A00,507294,Fargason; Sharon Gayle,9,0,30,21
1715670180666,EDS 139,B00,507313,Pappas; Elizabeth,9,0,30,21
1715670181695,EDS 201,A00,507315,Staff,10,0,30,20
1715670182722,EDS 203,A01,507317,Halter; Christopher P.,10,0,30,20
1715670183750,EDS 204R,A01,507319,Halter; Christopher P.,0,3,30,30
1715670183750,EDS 204R,B01,507331,Heinzman; Erica M.,14,0,30,16
1715670184776,EDS 206R,A00,507332,Staff,0,4,30,30
1715670184776,EDS 206R,B00,507343,Staff,15,0,30,15
1715670185802,EDS 250,A00,507344,Hemans; Patricia Ann Benitez,20,0,40,20
1715670186827,EDS 281,A00,507345,Daly; Alan J.,18,0,18,0
1715670187853,EDS 284,A00,507350,Daly; Alan J.,16,0,16,0
1715670188883,EDS 286,A00,507359,Fine; Sarah,18,0,18,0
1715670189908,EDS 289C,A01,507361,Daly; Alan J.,18,0,18,0
1715670190934,EDS 290,A00,507366,Hofstetter; Carolyn,15,0,15,0
1715670191960,LIGM 5A,A00,507421,Fischer-Grunski; Eva K,17,0,20,3
1715670192987,LIGM 5B,A00,507423,Fischer-Grunski; Eva K,19,0,20,1
1715670194015,LIGM 5C,A00,507425,Fischer-Grunski; Eva K,19,0,20,1
1715670195048,LIIT 5AS,A00,507427,Carnelos; Chiara,20,0,20,0
1715670196075,LIIT 5BS,A00,507430,Carnelos; Chiara,20,0,20,0
1715670197102,LIIT 5CS,A00,507432,Carnelos; Chiara,20,0,20,0
1715670198128,LISP 5A,A00,507541,Munoz Sanchez; Alicia,11,0,20,9
1715670199159,LISP 5B,A00,507671,Munoz Sanchez; Alicia,8,0,20,12
1715670200191,LISP 5C,A00,507696,Munoz Sanchez; Alicia,6,0,20,14
1715670201221,MAE 197,001,528363,Boechler; Nicholas Sebastia,9998,0,9999,1
1715670202249,MATH 197,001,523477,Kedlaya; Kiran S.,9994,0,9999,5
1715670202249,MATH 197,002,563811,Zhang; Danna,9994,0,9999,5
1715670202249,MATH 197,003,628552,Dumitriu; Ioana,9998,0,9999,1
1715670202249,MATH 197,004,660885,Floyd; Eric,9998,0,9999,1
1715670203275,MCWP 40R,A00,518780,Staff,1,0,20,19
1715670203275,MCWP 40R,B00,518781,Carter; Jennifer A,9,0,20,11
1715670203275,MCWP 40R,C00,518783,Smith; Haydee Marie,5,0,20,15
1715670204317,MCWP 50R,A00,518791,Redela; Pamela Morgan,0,1,20,20
1715670204317,MCWP 50R,B00,518792,Krone; Jarret,0,2,20,20
1715670204317,MCWP 50R,C00,518793,Staff,0,4,20,20
1715670204317,MCWP 50R,D00,518794,Morshed; Michael James,0,2,20,20
1715670204317,MCWP 50R,E00,518795,Carter; Andrea L,0,2,20,20
1715670204317,MCWP 50R,F00,518796,Miller; Elizabeth Deen,0,1,20,20
1715670204317,MCWP 50R,G00,518797,Guillen; Melinda,0,1,20,20
1715670205344,MMW 12R,A01,514034,Herbst; Matthew,0,2,16,16
1715670205344,MMW 12R,A02,514035,Herbst; Matthew,0,0,16,16
1715670206378,MMW 13R,A01,514037,Staff,0,5,16,16
1715670206378,MMW 13R,A02,514039,Staff,0,5,16,16
1715670206378,MMW 13R,A03,628519,Staff,0,4,16,16
1715670208443,SIO 295LS,A00,523233,Staff,10,0,30,20
1715670209476,SIO 295S,A00,523232,Staff,10,0,30,20
1715670210502,SIOC 290S,A01,637330,Merrifield; Mark A,21,0,30,9
1715670211529,SIOC 291S,A01,637333,Gabriel; Corey John,21,0,30,9
1715670212556,SOCI 117,A01,494376,Staff,0,5,5,5
1715670213582,WES 237B,A00,494380,Staff,10,0,20,10
1715670215655,AESE 279B,A00,494370,Wade; Jon P,0,0,33,33
1715670216683,AIP 97,001,660915,Van Den Einde; Yael Dahlia,9998,0,9999,1
1715670217714,AIP 197,001,627712,Vespa; Emanuel Ignacio,9995,0,9999,4
1715670217714,AIP 197,002,650778,Amir; On,9998,0,9999,1
1715670217714,AIP 197,003,650933,Avenancio-Leon; Carlos,9998,0,9999,1
1715670217714,AIP 197,004,658530,Heyman; Gail D.,9998,0,9999,1
1715670217714,AIP 197,005,658631,Neal; Sonya E,9998,0,9999,1
1715670217714,AIP 197,006,658671,Du; Songzi,9998,0,9999,1
1715670218817,ANAR 135S,A00,494369,Braswell; Geoffrey E.,0,0,0,0
1715670219845,BENG 196,001,628496,Engler; Adam J.,9998,0,9999,1
1715670219845,BENG 196,002,660916,Watson; John Thomas,9998,0,9999,1
1715670220876,BISP 197,001,650773,Wilhelm; James E.,9994,0,9999,5
1715670220876,BISP 197,002,658904,Coleman; Aaron B.,9998,0,9999,1
1715670221905,CAT 124RS,A01,519847,Geibel; William,0,0,20,20
1715670222931,CAT 125RS,A01,515971,Geibel; William,0,0,20,20
1715670223958,CLRE 250,A00,511389,Morris; Sheldon,9992,0,9999,7
1715670224990,CLRE 251,A00,507176,Mehta; Ravindra L.,9992,0,9999,7
1715670224990,CLRE 251,B00,511410,Mehta; Ravindra L.,9998,0,9999,1
1715670226015,CLRE 252,A00,507189,Cuomo; Raphael Eduardo,9994,0,9999,5
1715670227042,CLRE 253,A00,507199,Vaida; Florin,9994,0,9999,5
1715670227042,CLRE 253,B00,507202,Vaida; Florin,9999,0,9999,0
1715670228073,CLRE 259,A00,507211,Patel; Hemal,9996,0,9999,3
1715670229104,CLRE 260,A00,507221,Cuomo; Raphael Eduardo,9999,0,9999,0
1715670230131,CLRE 297,001,507242,Cuomo; Raphael Eduardo,9999,0,9999,0
1715670231156,COGS 197,001,638244,Voytek; Bradley Thomas,9997,0,9999,2
1715670232182,CSE 191,A00,516875,Minnes Kemp; Mor Mia,9991,0,9999,8
1715670233210,CSE 197,001,637388,Minnes Kemp; Mor Mia,9992,0,9999,7
1715670234236,CSS 201S,A01,494383,Mignozzetti; Umberto,35,0,35,0
1715670235263,CSS 202S,A01,494387,Mignozzetti; Umberto,35,0,35,0
1715670236295,DSC 197,001,628532,Eldridge; Justin Matthew,9995,0,9999,4
1715670237323,EAP 100,A00,516065,Staff,9799,0,9999,200
1715670238359,ECE 45,A01,507414,Staff,32,0,60,28
1715670240417,ECE 111,A01,507420,Staff,11,0,50,39
1715670241461,ECE 197,001,548057,Sievenpiper; Daniel F.,9991,0,9999,8
1715670242486,EDS 115,A00,507243,Choi; Bailey Miyeon,6,0,28,22
1715670243514,EDS 117,A01,494379,Staff,0,6,34,35
1715670244541,EDS 125,A00,507246,Hopkins; Megan Beth,7,0,30,23
1715670245568,EDS 128A,A01,507264,Fargason; Sharon Gayle,5,0,26,21
1715670246594,EDS 128B,A01,507293,Pappas; Elizabeth,9,0,30,21
1715670247626,EDS 139,A00,507294,Fargason; Sharon Gayle,9,0,30,21
1715670247626,EDS 139,B00,507313,Pappas; Elizabeth,9,0,30,21
1715670248652,EDS 201,A00,507315,Staff,10,0,30,20
1715670249677,EDS 203,A01,507317,Halter; Christopher P.,10,0,30,20
1715670250702,EDS 204R,A01,507319,Halter; Christopher P.,0,3,30,30
1715670250702,EDS 204R,B01,507331,Heinzman; Erica M.,14,0,30,16
1715670251727,EDS 206R,A00,507332,Staff,0,4,30,30
1715670251727,EDS 206R,B00,507343,Staff,15,0,30,15
1715670252754,EDS 250,A00,507344,Hemans; Patricia Ann Benitez,20,0,40,20
1715670253783,EDS 281,A00,507345,Daly; Alan J.,18,0,18,0
1715670254810,EDS 284,A00,507350,Daly; Alan J.,16,0,16,0
1715670255836,EDS 286,A00,507359,Fine; Sarah,18,0,18,0
1715670256867,EDS 289C,A01,507361,Daly; Alan J.,18,0,18,0
1715670257901,EDS 290,A00,507366,Hofstetter; Carolyn,15,0,15,0
1715670258934,LIGM 5A,A00,507421,Fischer-Grunski; Eva K,17,0,20,3
1715670259965,LIGM 5B,A00,507423,Fischer-Grunski; Eva K,19,0,20,1
1715670260995,LIGM 5C,A00,507425,Fischer-Grunski; Eva K,19,0,20,1
1715670262022,LIIT 5AS,A00,507427,Carnelos; Chiara,20,0,20,0
1715670263049,LIIT 5BS,A00,507430,Carnelos; Chiara,20,0,20,0
1715670264076,LIIT 5CS,A00,507432,Carnelos; Chiara,20,0,20,0
1715670265102,LISP 5A,A00,507541,Munoz Sanchez; Alicia,11,0,20,9
1715670266127,LISP 5B,A00,507671,Munoz Sanchez; Alicia,8,0,20,12
1715670267154,LISP 5C,A00,507696,Munoz Sanchez; Alicia,6,0,20,14
1715670268181,MAE 197,001,528363,Boechler; Nicholas Sebastia,9998,0,9999,1
1715670269206,MATH 197,001,523477,Kedlaya; Kiran S.,9994,0,9999,5
1715670269206,MATH 197,002,563811,Zhang; Danna,9994,0,9999,5
1715670269206,MATH 197,003,628552,Dumitriu; Ioana,9998,0,9999,1
1715670269206,MATH 197,004,660885,Floyd; Eric,9998,0,9999,1
1715670270233,MCWP 40R,A00,518780,Staff,1,0,20,19
1715670270233,MCWP 40R,B00,518781,Carter; Jennifer A,9,0,20,11
1715670270233,MCWP 40R,C00,518783,Smith; Haydee Marie,5,0,20,15
1715670271259,MCWP 50R,A00,518791,Redela; Pamela Morgan,0,1,20,20
1715670271259,MCWP 50R,B00,518792,Krone; Jarret,0,2,20,20
1715670271259,MCWP 50R,C00,518793,Staff,0,4,20,20
1715670271259,MCWP 50R,D00,518794,Morshed; Michael James,0,2,20,20
1715670271259,MCWP 50R,E00,518795,Carter; Andrea L,0,2,20,20
1715670271259,MCWP 50R,F00,518796,Miller; Elizabeth Deen,0,1,20,20
1715670271259,MCWP 50R,G00,518797,Guillen; Melinda,0,1,20,20
1715670272285,MMW 12R,A01,514034,Herbst; Matthew,0,2,16,16
1715670272285,MMW 12R,A02,514035,Herbst; Matthew,0,0,16,16
1715670273315,MMW 13R,A01,514037,Staff,0,5,16,16
1715670273315,MMW 13R,A02,514039,Staff,0,5,16,16
1715670273315,MMW 13R,A03,628519,Staff,0,4,16,16
1715670275372,SIO 295LS,A00,523233,Staff,10,0,30,20
1715670276397,SIO 295S,A00,523232,Staff,10,0,30,20
1715670277425,SIOC 290S,A01,637330,Merrifield; Mark A,21,0,30,9
1715670278453,SIOC 291S,A01,637333,Gabriel; Corey John,21,0,30,9
1715670279479,SOCI 117,A01,494376,Staff,0,5,5,5
1715670280504,WES 237B,A00,494380,Staff,10,0,20,10
1715670282585,AESE 279B,A00,494370,Wade; Jon P,0,0,33,33
1715670283617,AIP 97,001,660915,Van Den Einde; Yael Dahlia,9998,0,9999,1
1715670284647,AIP 197,001,627712,Vespa; Emanuel Ignacio,9995,0,9999,4
1715670284647,AIP 197,002,650778,Amir; On,9998,0,9999,1
1715670284647,AIP 197,003,650933,Avenancio-Leon; Carlos,9998,0,9999,1
1715670284647,AIP 197,004,658530,Heyman; Gail D.,9998,0,9999,1
1715670284647,AIP 197,005,658631,Neal; Sonya E,9998,0,9999,1
1715670284647,AIP 197,006,658671,Du; Songzi,9998,0,9999,1
1715670285677,ANAR 135S,A00,494369,Braswell; Geoffrey E.,0,0,0,0
1715670286710,BENG 196,001,628496,Engler; Adam J.,9998,0,9999,1
1715670286710,BENG 196,002,660916,Watson; John Thomas,9998,0,9999,1
1715670287736,BISP 197,001,650773,Wilhelm; James E.,9994,0,9999,5
1715670287736,BISP 197,002,658904,Coleman; Aaron B.,9998,0,9999,1
1715670288764,CAT 124RS,A01,519847,Geibel; William,0,0,20,20
1715670289841,CAT 125RS,A01,515971,Geibel; William,0,0,20,20
1715670290866,CLRE 250,A00,511389,Morris; Sheldon,9992,0,9999,7
1715670291893,CLRE 251,A00,507176,Mehta; Ravindra L.,9992,0,9999,7
1715670291893,CLRE 251,B00,511410,Mehta; Ravindra L.,9998,0,9999,1
1715670292925,CLRE 252,A00,507189,Cuomo; Raphael Eduardo,9994,0,9999,5
1715670293957,CLRE 253,A00,507199,Vaida; Florin,9994,0,9999,5
1715670293957,CLRE 253,B00,507202,Vaida; Florin,9999,0,9999,0
1715670294988,CLRE 259,A00,507211,Patel; Hemal,9996,0,9999,3
1715670296013,CLRE 260,A00,507221,Cuomo; Raphael Eduardo,9999,0,9999,0
1715670297042,CLRE 297,001,507242,Cuomo; Raphael Eduardo,9999,0,9999,0
1715670298073,COGS 197,001,638244,Voytek; Bradley Thomas,9997,0,9999,2
1715670299100,CSE 191,A00,516875,Minnes Kemp; Mor Mia,9991,0,9999,8
1715670300125,CSE 197,001,637388,Minnes Kemp; Mor Mia,9992,0,9999,7
1715670301162,CSS 201S,A01,494383,Mignozzetti; Umberto,35,0,35,0
1715670302194,CSS 202S,A01,494387,Mignozzetti; Umberto,35,0,35,0
1715670303225,DSC 197,001,628532,Eldridge; Justin Matthew,9995,0,9999,4
1715670304249,EAP 100,A00,516065,Staff,9799,0,9999,200
1715670305283,ECE 45,A01,507414,Staff,32,0,60,28
1715670307339,ECE 111,A01,507420,Staff,11,0,50,39
1715670308369,ECE 197,001,548057,Sievenpiper; Daniel F.,9991,0,9999,8
1715670309394,EDS 115,A00,507243,Choi; Bailey Miyeon,6,0,28,22
1715670310426,EDS 117,A01,494379,Staff,0,6,34,35
1715670311452,EDS 125,A00,507246,Hopkins; Megan Beth,7,0,30,23
1715670312478,EDS 128A,A01,507264,Fargason; Sharon Gayle,5,0,26,21
1715670313512,EDS 128B,A01,507293,Pappas; Elizabeth,9,0,30,21
1715670314541,EDS 139,A00,507294,Fargason; Sharon Gayle,9,0,30,21
1715670314541,EDS 139,B00,507313,Pappas; Elizabeth,9,0,30,21
1715670315570,EDS 201,A00,507315,Staff,10,0,30,20
1715670316596,EDS 203,A01,507317,Halter; Christopher P.,10,0,30,20
1715670317627,EDS 204R,A01,507319,Halter; Christopher P.,0,3,30,30
1715670317627,EDS 204R,B01,507331,Heinzman; Erica M.,14,0,30,16
1715670318653,EDS 206R,A00,507332,Staff,0,4,30,30
1715670318653,EDS 206R,B00,507343,Staff,15,0,30,15
1715670319678,EDS 250,A00,507344,Hemans; Patricia Ann Benitez,20,0,40,20
1715670320703,EDS 281,A00,507345,Daly; Alan J.,18,0,18,0
1715670321731,EDS 284,A00,507350,Daly; Alan J.,16,0,16,0
1715670322758,EDS 286,A00,507359,Fine; Sarah,18,0,18,0
1715670323782,EDS 289C,A01,507361,Daly; Alan J.,18,0,18,0
1715670324817,EDS 290,A00,507366,Hofstetter; Carolyn,15,0,15,0
1715670325852,LIGM 5A,A00,507421,Fischer-Grunski; Eva K,17,0,20,3
1715670326882,LIGM 5B,A00,507423,Fischer-Grunski; Eva K,19,0,20,1
1715670327909,LIGM 5C,A00,507425,Fischer-Grunski; Eva K,19,0,20,1
1715670328936,LIIT 5AS,A00,507427,Carnelos; Chiara,20,0,20,0
1715670330015,LIIT 5BS,A00,507430,Carnelos; Chiara,20,0,20,0
1715670331050,LIIT 5CS,A00,507432,Carnelos; Chiara,20,0,20,0
1715670332078,LISP 5A,A00,507541,Munoz Sanchez; Alicia,11,0,20,9
1715670333112,LISP 5B,A00,507671,Munoz Sanchez; Alicia,8,0,20,12
1715670334141,LISP 5C,A00,507696,Munoz Sanchez; Alicia,6,0,20,14
1715670335170,MAE 197,001,528363,Boechler; Nicholas Sebastia,9998,0,9999,1
1715670336200,MATH 197,001,523477,Kedlaya; Kiran S.,9994,0,9999,5
1715670336200,MATH 197,002,563811,Zhang; Danna,9994,0,9999,5
1715670336200,MATH 197,003,628552,Dumitriu; Ioana,9998,0,9999,1
1715670336200,MATH 197,004,660885,Floyd; Eric,9998,0,9999,1
1715670337227,MCWP 40R,A00,518780,Staff,1,0,20,19
1715670337227,MCWP 40R,B00,518781,Carter; Jennifer A,9,0,20,11
1715670337227,MCWP 40R,C00,518783,Smith; Haydee Marie,5,0,20,15
1715670338257,MCWP 50R,A00,518791,Redela; Pamela Morgan,0,1,20,20
1715670338257,MCWP 50R,B00,518792,Krone; Jarret,0,2,20,20
1715670338257,MCWP 50R,C00,518793,Staff,0,4,20,20
1715670338257,MCWP 50R,D00,518794,Morshed; Michael James,0,2,20,20
1715670338257,MCWP 50R,E00,518795,Carter; Andrea L,0,2,20,20
1715670338257,MCWP 50R,F00,518796,Miller; Elizabeth Deen,0,1,20,20
1715670338257,MCWP 50R,G00,518797,Guillen; Melinda,0,1,20,20
1715670339288,MMW 12R,A01,514034,Herbst; Matthew,0,2,16,16
1715670339288,MMW 12R,A02,514035,Herbst; Matthew,0,0,16,16
1715670340315,MMW 13R,A01,514037,Staff,0,5,16,16
1715670340315,MMW 13R,A02,514039,Staff,0,5,16,16
1715670340315,MMW 13R,A03,628519,Staff,0,4,16,16
1715670342369,SIO 295LS,A00,523233,Staff,10,0,30,20
1715670343395,SIO 295S,A00,523232,Staff,10,0,30,20
1715670344428,SIOC 290S,A01,637330,Merrifield; Mark A,21,0,30,9
1715670345455,SIOC 291S,A01,637333,Gabriel; Corey John,21,0,30,9
1715670346487,SOCI 117,A01,494376,Staff,0,5,5,5
1715670347515,WES 237B,A00,494380,Staff,10,0,20,10
1715670349609,AESE 279B,A00,494370,Wade; Jon P,0,0,33,33
1715670350638,AIP 97,001,660915,Van Den Einde; Yael Dahlia,9998,0,9999,1
1715670351670,AIP 197,001,627712,Vespa; Emanuel Ignacio,9995,0,9999,4
1715670351670,AIP 197,002,650778,Amir; On,9998,0,9999,1
1715670351670,AIP 197,003,650933,Avenancio-Leon; Carlos,9998,0,9999,1
1715670351670,AIP 197,004,658530,Heyman; Gail D.,9998,0,9999,1
1715670351670,AIP 197,005,658631,Neal; Sonya E,9998,0,9999,1
1715670351670,AIP 197,006,658671,Du; Songzi,9998,0,9999,1
1715670352696,ANAR 135S,A00,494369,Braswell; Geoffrey E.,0,0,0,0
1715670353731,BENG 196,001,628496,Engler; Adam J.,9998,0,9999,1
1715670353731,BENG 196,002,660916,Watson; John Thomas,9998,0,9999,1
1715670354759,BISP 197,001,650773,Wilhelm; James E.,9994,0,9999,5
1715670354759,BISP 197,002,658904,Coleman; Aaron B.,9998,0,9999,1
1715670355785,CAT 124RS,A01,519847,Geibel; William,0,0,20,20
1715670356811,CAT 125RS,A01,515971,Geibel; William,0,0,20,20
1715670357839,CLRE 250,A00,511389,Morris; Sheldon,9992,0,9999,7
1715670358872,CLRE 251,A00,507176,Mehta; Ravindra L.,9992,0,9999,7
1715670358872,CLRE 251,B00,511410,Mehta; Ravindra L.,9998,0,9999,1
1715670359900,CLRE 252,A00,507189,Cuomo; Raphael Eduardo,9994,0,9999,5
1715670360928,CLRE 253,A00,507199,Vaida; Florin,9994,0,9999,5
1715670360928,CLRE 253,B00,507202,Vaida; Florin,9999,0,9999,0
1715670361953,CLRE 259,A00,507211,Patel; Hemal,9996,0,9999,3
1715670362986,CLRE 260,A00,507221,Cuomo; Raphael Eduardo,9999,0,9999,0
1715670364012,CLRE 297,001,507242,Cuomo; Raphael Eduardo,9999,0,9999,0
1715670365039,COGS 197,001,638244,Voytek; Bradley Thomas,9997,0,9999,2
1715670366066,CSE 191,A00,516875,Minnes Kemp; Mor Mia,9991,0,9999,8
1715670367094,CSE 197,001,637388,Minnes Kemp; Mor Mia,9992,0,9999,7
1715670368130,CSS 201S,A01,494383,Mignozzetti; Umberto,35,0,35,0
1715670369157,CSS 202S,A01,494387,Mignozzetti; Umberto,35,0,35,0
1715670370182,DSC 197,001,628532,Eldridge; Justin Matthew,9995,0,9999,4
1715670371208,EAP 100,A00,516065,Staff,9799,0,9999,200
1715670372613,ECE 45,A01,507414,Staff,32,0,60,28
1715670374669,ECE 111,A01,507420,Staff,11,0,50,39
1715670375696,ECE 197,001,548057,Sievenpiper; Daniel F.,9991,0,9999,8
1715670376733,EDS 115,A00,507243,Choi; Bailey Miyeon,6,0,28,22
1715670377764,EDS 117,A01,494379,Staff,0,6,34,35
1715670378792,EDS 125,A00,507246,Hopkins; Megan Beth,7,0,30,23
1715670379825,EDS 128A,A01,507264,Fargason; Sharon Gayle,5,0,26,21
1715670380852,EDS 128B,A01,507293,Pappas; Elizabeth,9,0,30,21
1715670381877,EDS 139,A00,507294,Fargason; Sharon Gayle,9,0,30,21
1715670381877,EDS 139,B00,507313,Pappas; Elizabeth,9,0,30,21
1715670382908,EDS 201,A00,507315,Staff,10,0,30,20
1715670383933,EDS 203,A01,507317,Halter; Christopher P.,10,0,30,20
1715670384963,EDS 204R,A01,507319,Halter; Christopher P.,0,3,30,30
1715670384963,EDS 204R,B01,507331,Heinzman; Erica M.,14,0,30,16
1715670385988,EDS 206R,A00,507332,Staff,0,4,30,30
1715670385988,EDS 206R,B00,507343,Staff,15,0,30,15
1715670387012,EDS 250,A00,507344,Hemans; Patricia Ann Benitez,20,0,40,20
1715670388042,EDS 281,A00,507345,Daly; Alan J.,18,0,18,0
1715670389067,EDS 284,A00,507350,Daly; Alan J.,16,0,16,0
1715670390104,EDS 286,A00,507359,Fine; Sarah,18,0,18,0
1715670391133,EDS 289C,A01,507361,Daly; Alan J.,18,0,18,0
1715670392169,EDS 290,A00,507366,Hofstetter; Carolyn,15,0,15,0
1715670393199,LIGM 5A,A00,507421,Fischer-Grunski; Eva K,17,0,20,3
1715670394232,LIGM 5B,A00,507423,Fischer-Grunski; Eva K,19,0,20,1
1715670395259,LIGM 5C,A00,507425,Fischer-Grunski; Eva K,19,0,20,1
1715670396291,LIIT 5AS,A00,507427,Carnelos; Chiara,20,0,20,0
1715670397320,LIIT 5BS,A00,507430,Carnelos; Chiara,20,0,20,0
1715670398346,LIIT 5CS,A00,507432,Carnelos; Chiara,20,0,20,0
1715670399375,LISP 5A,A00,507541,Munoz Sanchez; Alicia,11,0,20,9
1715670400400,LISP 5B,A00,507671,Munoz Sanchez; Alicia,8,0,20,12
1715670401426,LISP 5C,A00,507696,Munoz Sanchez; Alicia,6,0,20,14
1715670402478,MAE 197,001,528363,Boechler; Nicholas Sebastia,9998,0,9999,1
1715670403513,MATH 197,001,523477,Kedlaya; Kiran S.,9994,0,9999,5
1715670403513,MATH 197,002,563811,Zhang; Danna,9994,0,9999,5
1715670403513,MATH 197,003,628552,Dumitriu; Ioana,9998,0,9999,1
1715670403513,MATH 197,004,660885,Floyd; Eric,9998,0,9999,1
1715670404548,MCWP 40R,A00,518780,Staff,1,0,20,19
1715670404548,MCWP 40R,B00,518781,Carter; Jennifer A,9,0,20,11
1715670404548,MCWP 40R,C00,518783,Smith; Haydee Marie,5,0,20,15
1715670405576,MCWP 50R,A00,518791,Redela; Pamela Morgan,0,1,20,20
1715670405576,MCWP 50R,B00,518792,Krone; Jarret,0,2,20,20
1715670405576,MCWP 50R,C00,518793,Staff,0,4,20,20
1715670405576,MCWP 50R,D00,518794,Morshed; Michael James,0,2,20,20
1715670405576,MCWP 50R,E00,518795,Carter; Andrea L,0,2,20,20
1715670405576,MCWP 50R,F00,518796,Miller; Elizabeth Deen,0,1,20,20
1715670405576,MCWP 50R,G00,518797,Guillen; Melinda,0,1,20,20
1715670406609,MMW 12R,A01,514034,Herbst; Matthew,0,2,16,16
1715670406609,MMW 12R,A02,514035,Herbst; Matthew,0,0,16,16
1715670407639,MMW 13R,A01,514037,Staff,0,5,16,16
1715670407639,MMW 13R,A02,514039,Staff,0,5,16,16
1715670407639,MMW 13R,A03,628519,Staff,0,4,16,16
1715670409695,SIO 295LS,A00,523233,Staff,10,0,30,20
1715670410720,SIO 295S,A00,523232,Staff,10,0,30,20
1715670411759,SIOC 290S,A01,637330,Merrifield; Mark A,21,0,30,9
1715670412791,SIOC 291S,A01,637333,Gabriel; Corey John,21,0,30,9
1715670413815,SOCI 117,A01,494376,Staff,0,5,5,5
1715670414841,WES 237B,A00,494380,Staff,10,0,20,10
1715670416934,AESE 279B,A00,494370,Wade; Jon P,0,0,33,33
1715670417964,AIP 97,001,660915,Van Den Einde; Yael Dahlia,9998,0,9999,1
1715670418989,AIP 197,001,627712,Vespa; Emanuel Ignacio,9995,0,9999,4
1715670418989,AIP 197,002,650778,Amir; On,9998,0,9999,1
1715670418989,AIP 197,003,650933,Avenancio-Leon; Carlos,9998,0,9999,1
1715670418989,AIP 197,004,658530,Heyman; Gail D.,9998,0,9999,1
1715670418989,AIP 197,005,658631,Neal; Sonya E,9998,0,9999,1
1715670418989,AIP 197,006,658671,Du; Songzi,9998,0,9999,1
1715670420054,ANAR 135S,A00,494369,Braswell; Geoffrey E.,0,0,0,0
1715670421080,BENG 196,001,628496,Engler; Adam J.,9998,0,9999,1
1715670421080,BENG 196,002,660916,Watson; John Thomas,9998,0,9999,1
1715670422108,BISP 197,001,650773,Wilhelm; James E.,9994,0,9999,5
1715670422108,BISP 197,002,658904,Coleman; Aaron B.,9998,0,9999,1
1715670423139,CAT 124RS,A01,519847,Geibel; William,0,0,20,20
1715670424165,CAT 125RS,A01,515971,Geibel; William,0,0,20,20
1715670425191,CLRE 250,A00,511389,Morris; Sheldon,9992,0,9999,7
1715670426223,CLRE 251,A00,507176,Mehta; Ravindra L.,9992,0,9999,7
1715670426223,CLRE 251,B00,511410,Mehta; Ravindra L.,9998,0,9999,1
1715670427249,CLRE 252,A00,507189,Cuomo; Raphael Eduardo,9994,0,9999,5
1715670428283,CLRE 253,A00,507199,Vaida; Florin,9994,0,9999,5
1715670428283,CLRE 253,B00,507202,Vaida; Florin,9999,0,9999,0
1715670429307,CLRE 259,A00,507211,Patel; Hemal,9996,0,9999,3
1715670430334,CLRE 260,A00,507221,Cuomo; Raphael Eduardo,9999,0,9999,0
1715670431361,CLRE 297,001,507242,Cuomo; Raphael Eduardo,9999,0,9999,0
1715670432387,COGS 197,001,638244,Voytek; Bradley Thomas,9997,0,9999,2
1715670433418,CSE 191,A00,516875,Minnes Kemp; Mor Mia,9991,0,9999,8
1715670434445,CSE 197,001,637388,Minnes Kemp; Mor Mia,9992,0,9999,7
1715670435479,CSS 201S,A01,494383,Mignozzetti; Umberto,35,0,35,0
1715670436510,CSS 202S,A01,494387,Mignozzetti; Umberto,35,0,35,0
1715670437537,DSC 197,001,628532,Eldridge; Justin Matthew,9995,0,9999,4
1715670438561,EAP 100,A00,516065,Staff,9799,0,9999,200
1715670439587,ECE 45,A01,507414,Staff,32,0,60,28
1715670441637,ECE 111,A01,507420,Staff,11,0,50,39
1715670442663,ECE 197,001,548057,Sievenpiper; Daniel F.,9991,0,9999,8
1715670443691,EDS 115,A00,507243,Choi; Bailey Miyeon,6,0,28,22
1715670444721,EDS 117,A01,494379,Staff,0,6,34,35
1715670445745,EDS 125,A00,507246,Hopkins; Megan Beth,7,0,30,23
1715670446772,EDS 128A,A01,507264,Fargason; Sharon Gayle,5,0,26,21
1715670447803,EDS 128B,A01,507293,Pappas; Elizabeth,9,0,30,21
1715670448833,EDS 139,A00,507294,Fargason; Sharon Gayle,9,0,30,21
1715670448833,EDS 139,B00,507313,Pappas; Elizabeth,9,0,30,21
1715670449862,EDS 201,A00,507315,Staff,10,0,30,20
1715670450888,EDS 203,A01,507317,Halter; Christopher P.,10,0,30,20
1715670451913,EDS 204R,A01,507319,Halter; Christopher P.,0,3,30,30
1715670451913,EDS 204R,B01,507331,Heinzman; Erica M.,14,0,30,16
1715670452939,EDS 206R,A00,507332,Staff,0,4,30,30
1715670452939,EDS 206R,B00,507343,Staff,15,0,30,15
1715670453969,EDS 250,A00,507344,Hemans; Patricia Ann Benitez,20,0,40,20
1715670454994,EDS 281,A00,507345,Daly; Alan J.,18,0,18,0
1715670456018,EDS 284,A00,507350,Daly; Alan J.,16,0,16,0
1715670457044,EDS 286,A00,507359,Fine; Sarah,18,0,18,0
1715670458069,EDS 289C,A01,507361,Daly; Alan J.,18,0,18,0
1715670459099,EDS 290,A00,507366,Hofstetter; Carolyn,15,0,15,0
1715670460127,LIGM 5A,A00,507421,Fischer-Grunski; Eva K,17,0,20,3
1715670461154,LIGM 5B,A00,507423,Fischer-Grunski; Eva K,19,0,20,1
1715670462180,LIGM 5C,A00,507425,Fischer-Grunski; Eva K,19,0,20,1
1715670463207,LIIT 5AS,A00,507427,Carnelos; Chiara,20,0,20,0
1715670464232,LIIT 5BS,A00,507430,Carnelos; Chiara,20,0,20,0
1715670465258,LIIT 5CS,A00,507432,Carnelos; Chiara,20,0,20,0
1715670466290,LISP 5A,A00,507541,Munoz Sanchez; Alicia,11,0,20,9
1715670467315,LISP 5B,A00,507671,Munoz Sanchez; Alicia,8,0,20,12
1715670468346,LISP 5C,A00,507696,Munoz Sanchez; Alicia,6,0,20,14
1715670469376,MAE 197,001,528363,Boechler; Nicholas Sebastia,9998,0,9999,1
1715670470403,MATH 197,001,523477,Kedlaya; Kiran S.,9994,0,9999,5
1715670470403,MATH 197,002,563811,Zhang; Danna,9994,0,9999,5
1715670470403,MATH 197,003,628552,Dumitriu; Ioana,9998,0,9999,1
1715670470403,MATH 197,004,660885,Floyd; Eric,9998,0,9999,1
1715670471432,MCWP 40R,A00,518780,Staff,1,0,20,19
1715670471432,MCWP 40R,B00,518781,Carter; Jennifer A,9,0,20,11
1715670471432,MCWP 40R,C00,518783,Smith; Haydee Marie,5,0,20,15
1715670472466,MCWP 50R,A00,518791,Redela; Pamela Morgan,0,1,20,20
1715670472466,MCWP 50R,B00,518792,Krone; Jarret,0,2,20,20
1715670472466,MCWP 50R,C00,518793,Staff,0,4,20,20
1715670472466,MCWP 50R,D00,518794,Morshed; Michael James,0,2,20,20
1715670472466,MCWP 50R,E00,518795,Carter; Andrea L,0,2,20,20
1715670472466,MCWP 50R,F00,518796,Miller; Elizabeth Deen,0,1,20,20
1715670472466,MCWP 50R,G00,518797,Guillen; Melinda,0,1,20,20
1715670473491,MMW 12R,A01,514034,Herbst; Matthew,0,2,16,16
1715670473491,MMW 12R,A02,514035,Herbst; Matthew,0,0,16,16
1715670474518,MMW 13R,A01,514037,Staff,0,5,16,16
1715670474518,MMW 13R,A02,514039,Staff,0,5,16,16
1715670474518,MMW 13R,A03,628519,Staff,0,4,16,16
1715670476577,SIO 295LS,A00,523233,Staff,10,0,30,20
1715670477602,SIO 295S,A00,523232,Staff,10,0,30,20
1715670478684,SIOC 290S,A01,637330,Merrifield; Mark A,21,0,30,9
1715670479709,SIOC 291S,A01,637333,Gabriel; Corey John,21,0,30,9
1715670480745,SOCI 117,A01,494376,Staff,0,5,5,5
1715670481770,WES 237B,A00,494380,Staff,10,0,20,10
1715670483858,AESE 279B,A00,494370,Wade; Jon P,0,0,33,33
1715670484883,AIP 97,001,660915,Van Den Einde; Yael Dahlia,9998,0,9999,1
1715670485912,AIP 197,001,627712,Vespa; Emanuel Ignacio,9995,0,9999,4
1715670485912,AIP 197,002,650778,Amir; On,9998,0,9999,1
1715670485912,AIP 197,003,650933,Avenancio-Leon; Carlos,9998,0,9999,1
1715670485912,AIP 197,004,658530,Heyman; Gail D.,9998,0,9999,1
1715670485912,AIP 197,005,658631,Neal; Sonya E,9998,0,9999,1
1715670485912,AIP 197,006,658671,Du; Songzi,9998,0,9999,1
1715670486940,ANAR 135S,A00,494369,Braswell; Geoffrey E.,0,0,0,0
1715670487971,BENG 196,001,628496,Engler; Adam J.,9998,0,9999,1
1715670487971,BENG 196,002,660916,Watson; John Thomas,9998,0,9999,1
1715670488998,BISP 197,001,650773,Wilhelm; James E.,9994,0,9999,5
1715670488998,BISP 197,002,658904,Coleman; Aaron B.,9998,0,9999,1
1715670490559,CAT 124RS,A01,519847,Geibel; William,0,0,20,20
1715670491588,CAT 125RS,A01,515971,Geibel; William,0,0,20,20
1715670492619,CLRE 250,A00,511389,Morris; Sheldon,9992,0,9999,7
1715670493653,CLRE 251,A00,507176,Mehta; Ravindra L.,9992,0,9999,7
1715670493653,CLRE 251,B00,511410,Mehta; Ravindra L.,9998,0,9999,1
1715670494685,CLRE 252,A00,507189,Cuomo; Raphael Eduardo,9994,0,9999,5
1715670495710,CLRE 253,A00,507199,Vaida; Florin,9994,0,9999,5
1715670495710,CLRE 253,B00,507202,Vaida; Florin,9999,0,9999,0
1715670496737,CLRE 259,A00,507211,Patel; Hemal,9996,0,9999,3
1715670497763,CLRE 260,A00,507221,Cuomo; Raphael Eduardo,9999,0,9999,0
1715670498791,CLRE 297,001,507242,Cuomo; Raphael Eduardo,9999,0,9999,0
1715670499816,COGS 197,001,638244,Voytek; Bradley Thomas,9997,0,9999,2
1715670500841,CSE 191,A00,516875,Minnes Kemp; Mor Mia,9991,0,9999,8
1715670501869,CSE 197,001,637388,Minnes Kemp; Mor Mia,9992,0,9999,7
1715670502897,CSS 201S,A01,494383,Mignozzetti; Umberto,35,0,35,0
1715670503924,CSS 202S,A01,494387,Mignozzetti; Umberto,35,0,35,0
1715670504950,DSC 197,001,628532,Eldridge; Justin Matthew,9995,0,9999,4
1715670505975,EAP 100,A00,516065,Staff,9799,0,9999,200
1715670507009,ECE 45,A01,507414,Staff,32,0,60,28
1715670509062,ECE 111,A01,507420,Staff,11,0,50,39
1715670510092,ECE 197,001,548057,Sievenpiper; Daniel F.,9991,0,9999,8
1715670511125,EDS 115,A00,507243,Choi; Bailey Miyeon,6,0,28,22
1715670512154,EDS 117,A01,494379,Staff,0,6,34,35
1715670513185,EDS 125,A00,507246,Hopkins; Megan Beth,7,0,30,23
1715670514215,EDS 128A,A01,507264,Fargason; Sharon Gayle,5,0,26,21
1715670515246,EDS 128B,A01,507293,Pappas; Elizabeth,9,0,30,21
1715670516278,EDS 139,A00,507294,Fargason; Sharon Gayle,9,0,30,21
1715670516278,EDS 139,B00,507313,Pappas; Elizabeth,9,0,30,21
1715670517306,EDS 201,A00,507315,Staff,10,0,30,20
1715670518333,EDS 203,A01,507317,Halter; Christopher P.,10,0,30,20
1715670519359,EDS 204R,A01,507319,Halter; Christopher P.,0,3,30,30
1715670519359,EDS 204R,B01,507331,Heinzman; Erica M.,14,0,30,16
1715670520390,EDS 206R,A00,507332,Staff,0,4,30,30
1715670520390,EDS 206R,B00,507343,Staff,15,0,30,15
1715670521422,EDS 250,A00,507344,Hemans; Patricia Ann Benitez,20,0,40,20
1715670522454,EDS 281,A00,507345,Daly; Alan J.,18,0,18,0
1715670523481,EDS 284,A00,507350,Daly; Alan J.,16,0,16,0
1715670524513,EDS 286,A00,507359,Fine; Sarah,18,0,18,0
1715670525537,EDS 289C,A01,507361,Daly; Alan J.,18,0,18,0
1715670526569,EDS 290,A00,507366,Hofstetter; Carolyn,15,0,15,0
1715670527600,LIGM 5A,A00,507421,Fischer-Grunski; Eva K,17,0,20,3
1715670528627,LIGM 5B,A00,507423,Fischer-Grunski; Eva K,19,0,20,1
1715670529652,LIGM 5C,A00,507425,Fischer-Grunski; Eva K,19,0,20,1
1715670530678,LIIT 5AS,A00,507427,Carnelos; Chiara,20,0,20,0
1715670531704,LIIT 5BS,A00,507430,Carnelos; Chiara,20,0,20,0
1715670532739,LIIT 5CS,A00,507432,Carnelos; Chiara,20,0,20,0
1715670533770,LISP 5A,A00,507541,Munoz Sanchez; Alicia,11,0,20,9
1715670534796,LISP 5B,A00,507671,Munoz Sanchez; Alicia,8,0,20,12
1715670535821,LISP 5C,A00,507696,Munoz Sanchez; Alicia,6,0,20,14
1715670536846,MAE 197,001,528363,Boechler; Nicholas Sebastia,9998,0,9999,1
1715670537881,MATH 197,001,523477,Kedlaya; Kiran S.,9994,0,9999,5
1715670537881,MATH 197,002,563811,Zhang; Danna,9994,0,9999,5
1715670537881,MATH 197,003,628552,Dumitriu; Ioana,9998,0,9999,1
1715670537881,MATH 197,004,660885,Floyd; Eric,9998,0,9999,1
1715670538906,MCWP 40R,A00,518780,Staff,1,0,20,19
1715670538906,MCWP 40R,B00,518781,Carter; Jennifer A,9,0,20,11
1715670538906,MCWP 40R,C00,518783,Smith; Haydee Marie,5,0,20,15
1715670539933,MCWP 50R,A00,518791,Redela; Pamela Morgan,0,1,20,20
1715670539933,MCWP 50R,B00,518792,Krone; Jarret,0,2,20,20
1715670539933,MCWP 50R,C00,518793,Staff,0,4,20,20
1715670539933,MCWP 50R,D00,518794,Morshed; Michael James,0,2,20,20
1715670539933,MCWP 50R,E00,518795,Carter; Andrea L,0,2,20,20
1715670539933,MCWP 50R,F00,518796,Miller; Elizabeth Deen,0,1,20,20
1715670539933,MCWP 50R,G00,518797,Guillen; Melinda,0,1,20,20
1715670540959,MMW 12R,A01,514034,Herbst; Matthew,0,2,16,16
1715670540959,MMW 12R,A02,514035,Herbst; Matthew,0,0,16,16
1715670541986,MMW 13R,A01,514037,Staff,0,5,16,16
1715670541986,MMW 13R,A02,514039,Staff,0,5,16,16
1715670541986,MMW 13R,A03,628519,Staff,0,4,16,16
1715670544052,SIO 295LS,A00,523233,Staff,10,0,30,20
1715670545077,SIO 295S,A00,523232,Staff,10,0,30,20
1715670546105,SIOC 290S,A01,637330,Merrifield; Mark A,21,0,30,9
1715670547134,SIOC 291S,A01,637333,Gabriel; Corey John,21,0,30,9
1715670548187,SOCI 117,A01,494376,Staff,0,5,5,5
1715670549216,WES 237B,A00,494380,Staff,10,0,20,10
1715670551297,AESE 279B,A00,494370,Wade; Jon P,0,0,33,33
1715670552327,AIP 97,001,660915,Van Den Einde; Yael Dahlia,9998,0,9999,1
1715670553363,AIP 197,001,627712,Vespa; Emanuel Ignacio,9995,0,9999,4
1715670553363,AIP 197,002,650778,Amir; On,9998,0,9999,1
1715670553363,AIP 197,003,650933,Avenancio-Leon; Carlos,9998,0,9999,1
1715670553363,AIP 197,004,658530,Heyman; Gail D.,9998,0,9999,1
1715670553363,AIP 197,005,658631,Neal; Sonya E,9998,0,9999,1
1715670553363,AIP 197,006,658671,Du; Songzi,9998,0,9999,1
1715670554388,ANAR 135S,A00,494369,Braswell; Geoffrey E.,0,0,0,0
1715670555414,BENG 196,001,628496,Engler; Adam J.,9998,0,9999,1
1715670555414,BENG 196,002,660916,Watson; John Thomas,9998,0,9999,1
1715670556439,BISP 197,001,650773,Wilhelm; James E.,9994,0,9999,5
1715670556439,BISP 197,002,658904,Coleman; Aaron B.,9998,0,9999,1
1715670557465,CAT 124RS,A01,519847,Geibel; William,0,0,20,20
1715670558490,CAT 125RS,A01,515971,Geibel; William,0,0,20,20
1715670559516,CLRE 250,A00,511389,Morris; Sheldon,9992,0,9999,7
1715670560547,CLRE 251,A00,507176,Mehta; Ravindra L.,9992,0,9999,7
1715670560547,CLRE 251,B00,511410,Mehta; Ravindra L.,9998,0,9999,1
1715670561577,CLRE 252,A00,507189,Cuomo; Raphael Eduardo,9994,0,9999,5
1715670562604,CLRE 253,A00,507199,Vaida; Florin,9994,0,9999,5
1715670562604,CLRE 253,B00,507202,Vaida; Florin,9999,0,9999,0
1715670563632,CLRE 259,A00,507211,Patel; Hemal,9996,0,9999,3
1715670564658,CLRE 260,A00,507221,Cuomo; Raphael Eduardo,9999,0,9999,0
1715670565683,CLRE 297,001,507242,Cuomo; Raphael Eduardo,9999,0,9999,0
1715670566713,COGS 197,001,638244,Voytek; Bradley Thomas,9997,0,9999,2
1715670567739,CSE 191,A00,516875,Minnes Kemp; Mor Mia,9991,0,9999,8
1715670568768,CSE 197,001,637388,Minnes Kemp; Mor Mia,9992,0,9999,7
1715670569796,CSS 201S,A01,494383,Mignozzetti; Umberto,35,0,35,0
1715670570823,CSS 202S,A01,494387,Mignozzetti; Umberto,35,0,35,0
1715670571849,DSC 197,001,628532,Eldridge; Justin Matthew,9995,0,9999,4
1715670572875,EAP 100,A00,516065,Staff,9799,0,9999,200
1715670573916,ECE 45,A01,507414,Staff,32,0,60,28
1715670575970,ECE 111,A01,507420,Staff,11,0,50,39
1715670576996,ECE 197,001,548057,Sievenpiper; Daniel F.,9991,0,9999,8
1715670578023,EDS 115,A00,507243,Choi; Bailey Miyeon,6,0,28,22
1715670579050,EDS 117,A01,494379,Staff,0,6,34,35
1715670580081,EDS 125,A00,507246,Hopkins; Megan Beth,7,0,30,23
1715670581113,EDS 128A,A01,507264,Fargason; Sharon Gayle,5,0,26,21
1715670582144,EDS 128B,A01,507293,Pappas; Elizabeth,9,0,30,21
1715670583224,EDS 139,A00,507294,Fargason; Sharon Gayle,9,0,30,21
1715670583224,EDS 139,B00,507313,Pappas; Elizabeth,9,0,30,21
1715670584251,EDS 201,A00,507315,Staff,10,0,30,20
1715670585277,EDS 203,A01,507317,Halter; Christopher P.,10,0,30,20
1715670586304,EDS 204R,A01,507319,Halter; Christopher P.,0,3,30,30
1715670586304,EDS 204R,B01,507331,Heinzman; Erica M.,14,0,30,16
1715670587332,EDS 206R,A00,507332,Staff,0,4,30,30
1715670587332,EDS 206R,B00,507343,Staff,15,0,30,15
1715670588360,EDS 250,A00,507344,Hemans; Patricia Ann Benitez,20,0,40,20
1715670589388,EDS 281,A00,507345,Daly; Alan J.,18,0,18,0
1715670590412,EDS 284,A00,507350,Daly; Alan J.,16,0,16,0
1715670591439,EDS 286,A00,507359,Fine; Sarah,18,0,18,0
1715670592466,EDS 289C,A01,507361,Daly; Alan J.,18,0,18,0
1715670593492,EDS 290,A00,507366,Hofstetter; Carolyn,15,0,15,0
1715670594526,LIGM 5A,A00,507421,Fischer-Grunski; Eva K,17,0,20,3
1715670595552,LIGM 5B,A00,507423,Fischer-Grunski; Eva K,19,0,20,1
1715670596580,LIGM 5C,A00,507425,Fischer-Grunski; Eva K,19,0,20,1
1715670597610,LIIT 5AS,A00,507427,Carnelos; Chiara,20,0,20,0
1715670598637,LIIT 5BS,A00,507430,Carnelos; Chiara,20,0,20,0
1715670599664,LIIT 5CS,A00,507432,Carnelos; Chiara,20,0,20,0
1715670600691,LISP 5A,A00,507541,Munoz Sanchez; Alicia,11,0,20,9
1715670601722,LISP 5B,A00,507671,Munoz Sanchez; Alicia,8,0,20,12
1715670602749,LISP 5C,A00,507696,Munoz Sanchez; Alicia,6,0,20,14
1715670603778,MAE 197,001,528363,Boechler; Nicholas Sebastia,9998,0,9999,1
1715670604808,MATH 197,001,523477,Kedlaya; Kiran S.,9994,0,9999,5
1715670604808,MATH 197,002,563811,Zhang; Danna,9994,0,9999,5
1715670604808,MATH 197,003,628552,Dumitriu; Ioana,9998,0,9999,1
1715670604808,MATH 197,004,660885,Floyd; Eric,9998,0,9999,1
1715670605837,MCWP 40R,A00,518780,Staff,1,0,20,19
1715670605837,MCWP 40R,B00,518781,Carter; Jennifer A,9,0,20,11
1715670605837,MCWP 40R,C00,518783,Smith; Haydee Marie,5,0,20,15
1715670606871,MCWP 50R,A00,518791,Redela; Pamela Morgan,0,1,20,20
1715670606871,MCWP 50R,B00,518792,Krone; Jarret,0,2,20,20
1715670606871,MCWP 50R,C00,518793,Staff,0,4,20,20
1715670606871,MCWP 50R,D00,518794,Morshed; Michael James,0,2,20,20
1715670606871,MCWP 50R,E00,518795,Carter; Andrea L,0,2,20,20
1715670606871,MCWP 50R,F00,518796,Miller; Elizabeth Deen,0,1,20,20
1715670606871,MCWP 50R,G00,518797,Guillen; Melinda,0,1,20,20
1715670607898,MMW 12R,A01,514034,Herbst; Matthew,0,2,16,16
1715670607898,MMW 12R,A02,514035,Herbst; Matthew,0,0,16,16
1715670608925,MMW 13R,A01,514037,Staff,0,5,16,16
1715670608925,MMW 13R,A02,514039,Staff,0,5,16,16
1715670608925,MMW 13R,A03,628519,Staff,0,4,16,16
1715670610979,SIO 295LS,A00,523233,Staff,10,0,30,20
1715670612005,SIO 295S,A00,523232,Staff,10,0,30,20
1715670613036,SIOC 290S,A01,637330,Merrifield; Mark A,21,0,30,9
1715670614067,SIOC 291S,A01,637333,Gabriel; Corey John,21,0,30,9
1715670615093,SOCI 117,A01,494376,Staff,0,5,5,5
1715670616120,WES 237B,A00,494380,Staff,10,0,20,10
1715670618194,AESE 279B,A00,494370,Wade; Jon P,0,0,33,33
1715670619233,AIP 97,001,660915,Van Den Einde; Yael Dahlia,9998,0,9999,1
1715670620261,AIP 197,001,627712,Vespa; Emanuel Ignacio,9995,0,9999,4
1715670620261,AIP 197,002,650778,Amir; On,9998,0,9999,1
1715670620261,AIP 197,003,650933,Avenancio-Leon; Carlos,9998,0,9999,1
1715670620261,AIP 197,004,658530,Heyman; Gail D.,9998,0,9999,1
1715670620261,AIP 197,005,658631,Neal; Sonya E,9998,0,9999,1
1715670620261,AIP 197,006,658671,Du; Songzi,9998,0,9999,1
1715670621291,ANAR 135S,A00,494369,Braswell; Geoffrey E.,0,0,0,0
1715670622316,BENG 196,001,628496,Engler; Adam J.,9998,0,9999,1
1715670622316,BENG 196,002,660916,Watson; John Thomas,9998,0,9999,1
1715670623343,BISP 197,001,650773,Wilhelm; James E.,9994,0,9999,5
1715670623343,BISP 197,002,658904,Coleman; Aaron B.,9998,0,9999,1
1715670624376,CAT 124RS,A01,519847,Geibel; William,0,0,20,20
1715670625401,CAT 125RS,A01,515971,Geibel; William,0,0,20,20
1715670626432,CLRE 250,A00,511389,Morris; Sheldon,9992,0,9999,7
1715670627461,CLRE 251,A00,507176,Mehta; Ravindra L.,9992,0,9999,7
1715670627461,CLRE 251,B00,511410,Mehta; Ravindra L.,9998,0,9999,1
1715670628490,CLRE 252,A00,507189,Cuomo; Raphael Eduardo,9994,0,9999,5
1715670629517,CLRE 253,A00,507199,Vaida; Florin,9994,0,9999,5
1715670629517,CLRE 253,B00,507202,Vaida; Florin,9999,0,9999,0
1715670630548,CLRE 259,A00,507211,Patel; Hemal,9996,0,9999,3
1715670631579,CLRE 260,A00,507221,Cuomo; Raphael Eduardo,9999,0,9999,0
1715670632606,CLRE 297,001,507242,Cuomo; Raphael Eduardo,9999,0,9999,0
1715670633632,COGS 197,001,638244,Voytek; Bradley Thomas,9997,0,9999,2
1715670634658,CSE 191,A00,516875,Minnes Kemp; Mor Mia,9991,0,9999,8
1715670635683,CSE 197,001,637388,Minnes Kemp; Mor Mia,9992,0,9999,7
1715670636712,CSS 201S,A01,494383,Mignozzetti; Umberto,35,0,35,0
1715670637742,CSS 202S,A01,494387,Mignozzetti; Umberto,35,0,35,0
1715670638767,DSC 197,001,628532,Eldridge; Justin Matthew,9995,0,9999,4
1715670639798,EAP 100,A00,516065,Staff,9799,0,9999,200
1715670640838,ECE 45,A01,507414,Staff,32,0,60,28
1715670642895,ECE 111,A01,507420,Staff,11,0,50,39
1715670643922,ECE 197,001,548057,Sievenpiper; Daniel F.,9991,0,9999,8
1715670644955,EDS 115,A00,507243,Choi; Bailey Miyeon,6,0,28,22
1715670645985,EDS 117,A01,494379,Staff,0,6,34,35
1715670647016,EDS 125,A00,507246,Hopkins; Megan Beth,7,0,30,23
1715670648042,EDS 128A,A01,507264,Fargason; Sharon Gayle,5,0,26,21
1715670649070,EDS 128B,A01,507293,Pappas; Elizabeth,9,0,30,21
1715670650111,EDS 139,A00,507294,Fargason; Sharon Gayle,9,0,30,21
1715670650111,EDS 139,B00,507313,Pappas; Elizabeth,9,0,30,21
1715670651154,EDS 201,A00,507315,Staff,10,0,30,20
1715670652199,EDS 203,A01,507317,Halter; Christopher P.,10,0,30,20
1715670653226,EDS 204R,A01,507319,Halter; Christopher P.,0,3,30,30
1715670653226,EDS 204R,B01,507331,Heinzman; Erica M.,14,0,30,16
1715670654258,EDS 206R,A00,507332,Staff,0,4,30,30
1715670654258,EDS 206R,B00,507343,Staff,15,0,30,15
1715670655289,EDS 250,A00,507344,Hemans; Patricia Ann Benitez,20,0,40,20
1715670656314,EDS 281,A00,507345,Daly; Alan J.,18,0,18,0
1715670657338,EDS 284,A00,507350,Daly; Alan J.,16,0,16,0
1715670658377,EDS 286,A00,507359,Fine; Sarah,18,0,18,0
1715670659411,EDS 289C,A01,507361,Daly; Alan J.,18,0,18,0
1715670660460,EDS 290,A00,507366,Hofstetter; Carolyn,15,0,15,0
1715670661493,LIGM 5A,A00,507421,Fischer-Grunski; Eva K,17,0,20,3
1715670662559,LIGM 5B,A00,507423,Fischer-Grunski; Eva K,19,0,20,1
1715670663647,LIGM 5C,A00,507425,Fischer-Grunski; Eva K,19,0,20,1
1715670664677,LIIT 5AS,A00,507427,Carnelos; Chiara,20,0,20,0
1715670665702,LIIT 5BS,A00,507430,Carnelos; Chiara,20,0,20,0
1715670666731,LIIT 5CS,A00,507432,Carnelos; Chiara,20,0,20,0
1715670667757,LISP 5A,A00,507541,Munoz Sanchez; Alicia,11,0,20,9
1715670668814,LISP 5B,A00,507671,Munoz Sanchez; Alicia,8,0,20,12
1715670669865,LISP 5C,A00,507696,Munoz Sanchez; Alicia,6,0,20,14
1715670670898,MAE 197,001,528363,Boechler; Nicholas Sebastia,9998,0,9999,1
1715670671961,MATH 197,001,523477,Kedlaya; Kiran S.,9994,0,9999,5
1715670671961,MATH 197,002,563811,Zhang; Danna,9994,0,9999,5
1715670671961,MATH 197,003,628552,Dumitriu; Ioana,9998,0,9999,1
1715670671961,MATH 197,004,660885,Floyd; Eric,9998,0,9999,1
1715670672989,MCWP 40R,A00,518780,Staff,1,0,20,19
1715670672989,MCWP 40R,B00,518781,Carter; Jennifer A,9,0,20,11
1715670672989,MCWP 40R,C00,518783,Smith; Haydee Marie,5,0,20,15
1715670674028,MCWP 50R,A00,518791,Redela; Pamela Morgan,0,1,20,20
1715670674028,MCWP 50R,B00,518792,Krone; Jarret,0,2,20,20
1715670674028,MCWP 50R,C00,518793,Staff,0,4,20,20
1715670674028,MCWP 50R,D00,518794,Morshed; Michael James,0,2,20,20
1715670674028,MCWP 50R,E00,518795,Carter; Andrea L,0,2,20,20
1715670674028,MCWP 50R,F00,518796,Miller; Elizabeth Deen,0,1,20,20
1715670674028,MCWP 50R,G00,518797,Guillen; Melinda,0,1,20,20
1715670675060,MMW 12R,A01,514034,Herbst; Matthew,0,2,16,16
1715670675060,MMW 12R,A02,514035,Herbst; Matthew,0,0,16,16
1715670676086,MMW 13R,A01,514037,Staff,0,5,16,16
1715670676086,MMW 13R,A02,514039,Staff,0,5,16,16
1715670676086,MMW 13R,A03,628519,Staff,0,4,16,16
1715670678149,SIO 295LS,A00,523233,Staff,10,0,30,20
1715670679174,SIO 295S,A00,523232,Staff,10,0,30,20
1715670680225,SIOC 290S,A01,637330,Merrifield; Mark A,21,0,30,9
1715670681295,SIOC 291S,A01,637333,Gabriel; Corey John,21,0,30,9
1715670682371,SOCI 117,A01,494376,Staff,0,5,5,5
1715670683405,WES 237B,A00,494380,Staff,10,0,20,10
1715670685504,AESE 279B,A00,494370,Wade; Jon P,0,0,33,33
1715670686538,AIP 97,001,660915,Van Den Einde; Yael Dahlia,9998,0,9999,1
1715670687584,AIP 197,001,627712,Vespa; Emanuel Ignacio,9995,0,9999,4
1715670687584,AIP 197,002,650778,Amir; On,9998,0,9999,1
1715670687584,AIP 197,003,650933,Avenancio-Leon; Carlos,9998,0,9999,1
1715670687584,AIP 197,004,658530,Heyman; Gail D.,9998,0,9999,1
1715670687584,AIP 197,005,658631,Neal; Sonya E,9998,0,9999,1
1715670687584,AIP 197,006,658671,Du; Songzi,9998,0,9999,1
1715670688620,ANAR 135S,A00,494369,Braswell; Geoffrey E.,0,0,0,0
1715670689655,BENG 196,001,628496,Engler; Adam J.,9998,0,9999,1
1715670689655,BENG 196,002,660916,Watson; John Thomas,9998,0,9999,1
1715670690681,BISP 197,001,650773,Wilhelm; James E.,9994,0,9999,5
1715670690681,BISP 197,002,658904,Coleman; Aaron B.,9998,0,9999,1
1715670691713,CAT 124RS,A01,519847,Geibel; William,0,0,20,20
1715670692738,CAT 125RS,A01,515971,Geibel; William,0,0,20,20
1715670693765,CLRE 250,A00,511389,Morris; Sheldon,9992,0,9999,7
1715670694799,CLRE 251,A00,507176,Mehta; Ravindra L.,9992,0,9999,7
1715670694799,CLRE 251,B00,511410,Mehta; Ravindra L.,9998,0,9999,1
1715670695832,CLRE 252,A00,507189,Cuomo; Raphael Eduardo,9994,0,9999,5
1715670696866,CLRE 253,A00,507199,Vaida; Florin,9994,0,9999,5
1715670696866,CLRE 253,B00,507202,Vaida; Florin,9999,0,9999,0
1715670697892,CLRE 259,A00,507211,Patel; Hemal,9996,0,9999,3
1715670698924,CLRE 260,A00,507221,Cuomo; Raphael Eduardo,9999,0,9999,0
1715670699951,CLRE 297,001,507242,Cuomo; Raphael Eduardo,9999,0,9999,0
1715670700984,COGS 197,001,638244,Voytek; Bradley Thomas,9997,0,9999,2
1715670702016,CSE 191,A00,516875,Minnes Kemp; Mor Mia,9991,0,9999,8
1715670703041,CSE 197,001,637388,Minnes Kemp; Mor Mia,9992,0,9999,7
1715670704076,CSS 201S,A01,494383,Mignozzetti; Umberto,35,0,35,0
1715670705102,CSS 202S,A01,494387,Mignozzetti; Umberto,35,0,35,0
1715670706128,DSC 197,001,628532,Eldridge; Justin Matthew,9995,0,9999,4
1715670707159,EAP 100,A00,516065,Staff,9799,0,9999,200
1715670708185,ECE 45,A01,507414,Staff,32,0,60,28
1715670710237,ECE 111,A01,507420,Staff,11,0,50,39
1715670711264,ECE 197,001,548057,Sievenpiper; Daniel F.,9991,0,9999,8
1715670712290,EDS 115,A00,507243,Choi; Bailey Miyeon,6,0,28,22
1715670713448,EDS 117,A01,494379,Staff,0,6,34,35
1715670714474,EDS 125,A00,507246,Hopkins; Megan Beth,7,0,30,23
1715670715502,EDS 128A,A01,507264,Fargason; Sharon Gayle,5,0,26,21
1715670716532,EDS 128B,A01,507293,Pappas; Elizabeth,9,0,30,21
1715670717558,EDS 139,A00,507294,Fargason; Sharon Gayle,9,0,30,21
1715670717558,EDS 139,B00,507313,Pappas; Elizabeth,9,0,30,21
1715670718591,EDS 201,A00,507315,Staff,10,0,30,20
1715670719618,EDS 203,A01,507317,Halter; Christopher P.,10,0,30,20
1715670720645,EDS 204R,A01,507319,Halter; Christopher P.,0,3,30,30
1715670720645,EDS 204R,B01,507331,Heinzman; Erica M.,14,0,30,16
1715670721686,EDS 206R,A00,507332,Staff,0,4,30,30
1715670721686,EDS 206R,B00,507343,Staff,15,0,30,15
1715670722719,EDS 250,A00,507344,Hemans; Patricia Ann Benitez,20,0,40,20
1715670723744,EDS 281,A00,507345,Daly; Alan J.,18,0,18,0
1715670724772,EDS 284,A00,507350,Daly; Alan J.,16,0,16,0
1715670725797,EDS 286,A00,507359,Fine; Sarah,18,0,18,0
1715670726837,EDS 289C,A01,507361,Daly; Alan J.,18,0,18,0
1715670727864,EDS 290,A00,507366,Hofstetter; Carolyn,15,0,15,0
1715670728892,LIGM 5A,A00,507421,Fischer-Grunski; Eva K,17,0,20,3
1715670729924,LIGM 5B,A00,507423,Fischer-Grunski; Eva K,19,0,20,1
1715670730954,LIGM 5C,A00,507425,Fischer-Grunski; Eva K,19,0,20,1
1715670731981,LIIT 5AS,A00,507427,Carnelos; Chiara,20,0,20,0
1715670733014,LIIT 5BS,A00,507430,Carnelos; Chiara,20,0,20,0
1715670734039,LIIT 5CS,A00,507432,Carnelos; Chiara,20,0,20,0
1715670735067,LISP 5A,A00,507541,Munoz Sanchez; Alicia,11,0,20,9
1715670736099,LISP 5B,A00,507671,Munoz Sanchez; Alicia,8,0,20,12
1715670737126,LISP 5C,A00,507696,Munoz Sanchez; Alicia,6,0,20,14
1715670738163,MAE 197,001,528363,Boechler; Nicholas Sebastia,9998,0,9999,1
1715670739194,MATH 197,001,523477,Kedlaya; Kiran S.,9994,0,9999,5
1715670739194,MATH 197,002,563811,Zhang; Danna,9994,0,9999,5
1715670739194,MATH 197,003,628552,Dumitriu; Ioana,9998,0,9999,1
1715670739194,MATH 197,004,660885,Floyd; Eric,9998,0,9999,1
1715670740234,MCWP 40R,A00,518780,Staff,1,0,20,19
1715670740234,MCWP 40R,B00,518781,Carter; Jennifer A,9,0,20,11
1715670740234,MCWP 40R,C00,518783,Smith; Haydee Marie,5,0,20,15
1715670741272,MCWP 50R,A00,518791,Redela; Pamela Morgan,0,1,20,20
1715670741272,MCWP 50R,B00,518792,Krone; Jarret,0,2,20,20
1715670741272,MCWP 50R,C00,518793,Staff,0,4,20,20
1715670741272,MCWP 50R,D00,518794,Morshed; Michael James,0,2,20,20
1715670741272,MCWP 50R,E00,518795,Carter; Andrea L,0,2,20,20
1715670741272,MCWP 50R,F00,518796,Miller; Elizabeth Deen,0,1,20,20
1715670741272,MCWP 50R,G00,518797,Guillen; Melinda,0,1,20,20
1715670742303,MMW 12R,A01,514034,Herbst; Matthew,0,2,16,16
1715670742303,MMW 12R,A02,514035,Herbst; Matthew,0,0,16,16
1715670743329,MMW 13R,A01,514037,Staff,0,5,16,16
1715670743329,MMW 13R,A02,514039,Staff,0,5,16,16
1715670743329,MMW 13R,A03,628519,Staff,0,4,16,16
1715670745388,SIO 295LS,A00,523233,Staff,10,0,30,20
1715670746414,SIO 295S,A00,523232,Staff,10,0,30,20
1715670747442,SIOC 290S,A01,637330,Merrifield; Mark A,21,0,30,9
1715670748468,SIOC 291S,A01,637333,Gabriel; Corey John,21,0,30,9
1715670749496,SOCI 117,A01,494376,Staff,0,5,5,5
1715670750527,WES 237B,A00,494380,Staff,10,0,20,10
