time,subj_course_id,sec_code,sec_id,prof,available,waitlist,total,enrolled_ct
1713477688255,AESE 279B,A00,494370,Wade; Jon P,33,0,33,0
1713477689283,AIP 197,001,627712,Vespa; Emanuel Ignacio,9999,0,9999,0
1713477690310,ANAR 135S,A00,494369,Braswell; Geoffrey E.,0,0,0,0
1713477691335,CAT 124RS,A01,519847,Geibel; William,6,0,20,14
1713477692362,CAT 125RS,A01,515971,Geibel; William,6,0,20,14
1713477693391,CLRE 250,A00,511389,Morris; Sheldon,9996,0,9999,3
1713477694416,CLRE 251,A00,507176,Mehta; Ravindra L.,9996,0,9999,3
1713477694416,CLRE 251,B00,511410,Mehta; Ravindra L.,9998,0,9999,1
1713477695441,CLRE 252,A00,507189,Cuomo; Raphael Eduardo,9998,0,9999,1
1713477696469,CLRE 253,A00,507199,Vaida; Florin,9997,0,9999,2
1713477696469,CLRE 253,B00,507202,Vaida; Florin,9999,0,9999,0
1713477697496,CLRE 259,A00,507211,Patel; Hemal,9996,0,9999,3
1713477698525,CLRE 260,A00,507221,Cuomo; Raphael Eduardo,9999,0,9999,0
1713477699555,CLRE 297,001,507242,Cuomo; Raphael Eduardo,9999,0,9999,0
1713477700580,CSE 191,A00,516875,Minnes Kemp; Mor Mia,9999,0,9999,0
1713477701605,CSS 201S,A01,494383,Staff,35,0,35,0
1713477702634,CSS 202S,A01,494387,Staff,35,0,35,0
1713477703660,EAP 100,A00,516065,Staff,9792,0,9999,207
1713477704686,ECE 45,A01,507414,Staff,40,0,60,20
1713477705733,ECE 100,A01,507416,Baghdadchi; Saharnaz,3,0,20,17
1713477705733,ECE 100,A02,507418,Baghdadchi; Saharnaz,19,0,20,1
1713477706759,ECE 111,A01,507420,Staff,28,0,50,22
1713477707783,ECE 197,001,548057,Sievenpiper; Daniel F.,9998,0,9999,1
1713477708815,EDS 115,A00,507243,Choi; Bailey Miyeon,27,0,28,1
1713477709844,EDS 117,A01,494379,Staff,16,0,25,9
1713477710873,EDS 125,A00,507246,Hopkins; Megan Beth,28,0,30,2
1713477711899,EDS 128A,A01,507264,Fargason; Sharon Gayle,26,0,26,0
1713477712925,EDS 128B,A01,507293,Pappas; Elizabeth,30,0,30,0
1713477713950,EDS 139,A00,507294,Fargason; Sharon Gayle,30,0,30,0
1713477713950,EDS 139,B00,507313,Pappas; Elizabeth,30,0,30,0
1713477714974,EDS 201,A00,507315,Staff,19,0,30,11
1713477716001,EDS 203,A01,507317,Halter; Christopher P.,18,0,30,12
1713477717040,EDS 204R,A01,507319,Halter; Christopher P.,0,1,30,30
1713477717040,EDS 204R,B01,507331,Heinzman; Erica M.,26,0,30,4
1713477718068,EDS 206R,A00,507332,Staff,0,1,30,30
1713477718068,EDS 206R,B00,507343,Staff,27,0,30,3
1713477719096,EDS 250,A00,507344,Hemans; Patricia Ann Benitez,28,0,40,12
1713477720125,EDS 281,A00,507345,Daly; Alan J.,18,0,18,0
1713477721149,EDS 284,A00,507350,Daly; Alan J.,16,0,16,0
1713477722176,EDS 286,A00,507359,Fine; Sarah,18,0,18,0
1713477723205,EDS 289C,A01,507361,Daly; Alan J.,18,0,18,0
1713477724233,EDS 290,A00,507366,Hofstetter; Carolyn,15,0,15,0
1713477725261,LIGM 5A,A00,507421,Fischer-Grunski; Eva K,20,0,20,0
1713477726289,LIGM 5B,A00,507423,Fischer-Grunski; Eva K,20,0,20,0
1713477727319,LIGM 5C,A00,507425,Fischer-Grunski; Eva K,20,0,20,0
1713477728343,LIIT 5AS,A00,507427,Carnelos; Chiara,20,0,20,0
1713477729368,LIIT 5BS,A00,507430,Carnelos; Chiara,20,0,20,0
1713477730460,LIIT 5CS,A00,507432,Carnelos; Chiara,20,0,20,0
1713477731490,LISP 5A,A00,507541,Munoz Sanchez; Alicia,15,0,20,5
1713477732518,LISP 5B,A00,507671,Munoz Sanchez; Alicia,12,0,20,8
1713477733547,LISP 5C,A00,507696,Munoz Sanchez; Alicia,11,0,20,9
1713477734572,MAE 197,001,528363,Boechler; Nicholas Sebastia,9998,0,9999,1
1713477735603,MATH 197,001,523477,Kedlaya; Kiran S.,9999,0,9999,0
1713477735603,MATH 197,002,563811,Zhang; Danna,9998,0,9999,1
1713477736631,MCWP 40R,A00,518780,Staff,17,0,20,3
1713477736631,MCWP 40R,B00,518781,Staff,14,0,20,6
1713477736631,MCWP 40R,C00,518783,Staff,13,0,20,7
1713477737665,MCWP 50R,A00,518791,Staff,10,0,20,10
1713477737665,MCWP 50R,B00,518792,Staff,8,0,20,12
1713477737665,MCWP 50R,C00,518793,Staff,7,0,20,13
1713477737665,MCWP 50R,D00,518794,Staff,4,0,20,16
1713477737665,MCWP 50R,E00,518795,Staff,6,0,20,14
1713477737665,MCWP 50R,F00,518796,Staff,15,0,20,5
1713477737665,MCWP 50R,G00,518797,Staff,13,0,20,7
1713477738691,MMW 12R,A01,514034,Herbst; Matthew,9,0,16,7
1713477738691,MMW 12R,A02,514035,Herbst; Matthew,14,0,16,2
1713477739734,MMW 13R,A01,514037,Staff,0,0,16,16
1713477739734,MMW 13R,A02,514039,Staff,1,0,16,15
1713477741781,SIO 295LS,A00,523233,Staff,16,0,30,14
1713477742805,SIO 295S,A00,523232,Staff,16,0,30,14
1713477743831,SOCI 117,A01,494376,Staff,0,2,5,5
1713477744858,WES 237B,A00,494380,Staff,19,0,20,1
1713477746951,AESE 279B,A00,494370,Wade; Jon P,33,0,33,0
1713477747975,AIP 197,001,627712,Vespa; Emanuel Ignacio,9999,0,9999,0
1713477748999,ANAR 135S,A00,494369,Braswell; Geoffrey E.,0,0,0,0
1713477750022,CAT 124RS,A01,519847,Geibel; William,6,0,20,14
1713477751050,CAT 125RS,A01,515971,Geibel; William,6,0,20,14
1713477752073,CLRE 250,A00,511389,Morris; Sheldon,9996,0,9999,3
1713477753097,CLRE 251,A00,507176,Mehta; Ravindra L.,9996,0,9999,3
1713477753097,CLRE 251,B00,511410,Mehta; Ravindra L.,9998,0,9999,1
1713477754126,CLRE 252,A00,507189,Cuomo; Raphael Eduardo,9998,0,9999,1
1713477755150,CLRE 253,A00,507199,Vaida; Florin,9997,0,9999,2
1713477755150,CLRE 253,B00,507202,Vaida; Florin,9999,0,9999,0
1713477756179,CLRE 259,A00,507211,Patel; Hemal,9996,0,9999,3
1713477757259,CLRE 260,A00,507221,Cuomo; Raphael Eduardo,9999,0,9999,0
1713477758287,CLRE 297,001,507242,Cuomo; Raphael Eduardo,9999,0,9999,0
1713477759313,CSE 191,A00,516875,Minnes Kemp; Mor Mia,9999,0,9999,0
1713477760340,CSS 201S,A01,494383,Staff,35,0,35,0
1713477761362,CSS 202S,A01,494387,Staff,35,0,35,0
1713477762391,EAP 100,A00,516065,Staff,9792,0,9999,207
1713477763423,ECE 45,A01,507414,Staff,40,0,60,20
1713477764451,ECE 100,A01,507416,Baghdadchi; Saharnaz,3,0,20,17
1713477764451,ECE 100,A02,507418,Baghdadchi; Saharnaz,19,0,20,1
1713477765475,ECE 111,A01,507420,Staff,28,0,50,22
1713477766500,ECE 197,001,548057,Sievenpiper; Daniel F.,9998,0,9999,1
1713477767526,EDS 115,A00,507243,Choi; Bailey Miyeon,27,0,28,1
1713477768552,EDS 117,A01,494379,Staff,16,0,25,9
1713477769578,EDS 125,A00,507246,Hopkins; Megan Beth,28,0,30,2
1713477770602,EDS 128A,A01,507264,Fargason; Sharon Gayle,26,0,26,0
1713477771634,EDS 128B,A01,507293,Pappas; Elizabeth,30,0,30,0
1713477772662,EDS 139,A00,507294,Fargason; Sharon Gayle,30,0,30,0
1713477772662,EDS 139,B00,507313,Pappas; Elizabeth,30,0,30,0
1713477773686,EDS 201,A00,507315,Staff,19,0,30,11
1713477774711,EDS 203,A01,507317,Halter; Christopher P.,18,0,30,12
1713477775738,EDS 204R,A01,507319,Halter; Christopher P.,0,1,30,30
1713477775738,EDS 204R,B01,507331,Heinzman; Erica M.,26,0,30,4
1713477776766,EDS 206R,A00,507332,Staff,0,1,30,30
1713477776766,EDS 206R,B00,507343,Staff,27,0,30,3
1713477777795,EDS 250,A00,507344,Hemans; Patricia Ann Benitez,28,0,40,12
1713477778876,EDS 281,A00,507345,Daly; Alan J.,18,0,18,0
1713477779905,EDS 284,A00,507350,Daly; Alan J.,16,0,16,0
1713477780938,EDS 286,A00,507359,Fine; Sarah,18,0,18,0
1713477781962,EDS 289C,A01,507361,Daly; Alan J.,18,0,18,0
1713477782987,EDS 290,A00,507366,Hofstetter; Carolyn,15,0,15,0
1713477784016,LIGM 5A,A00,507421,Fischer-Grunski; Eva K,20,0,20,0
1713477785045,LIGM 5B,A00,507423,Fischer-Grunski; Eva K,20,0,20,0
1713477786074,LIGM 5C,A00,507425,Fischer-Grunski; Eva K,20,0,20,0
1713477787100,LIIT 5AS,A00,507427,Carnelos; Chiara,20,0,20,0
1713477788126,LIIT 5BS,A00,507430,Carnelos; Chiara,20,0,20,0
1713477789151,LIIT 5CS,A00,507432,Carnelos; Chiara,20,0,20,0
1713477790181,LISP 5A,A00,507541,Munoz Sanchez; Alicia,15,0,20,5
1713477791209,LISP 5B,A00,507671,Munoz Sanchez; Alicia,12,0,20,8
1713477792236,LISP 5C,A00,507696,Munoz Sanchez; Alicia,11,0,20,9
1713477793261,MAE 197,001,528363,Boechler; Nicholas Sebastia,9998,0,9999,1
1713477794286,MATH 197,001,523477,Kedlaya; Kiran S.,9999,0,9999,0
1713477794286,MATH 197,002,563811,Zhang; Danna,9998,0,9999,1
1713477795315,MCWP 40R,A00,518780,Staff,17,0,20,3
1713477795315,MCWP 40R,B00,518781,Staff,14,0,20,6
1713477795315,MCWP 40R,C00,518783,Staff,13,0,20,7
1713477796344,MCWP 50R,A00,518791,Staff,10,0,20,10
1713477796344,MCWP 50R,B00,518792,Staff,8,0,20,12
1713477796344,MCWP 50R,C00,518793,Staff,7,0,20,13
1713477796344,MCWP 50R,D00,518794,Staff,4,0,20,16
1713477796344,MCWP 50R,E00,518795,Staff,6,0,20,14
1713477796344,MCWP 50R,F00,518796,Staff,15,0,20,5
1713477796344,MCWP 50R,G00,518797,Staff,13,0,20,7
1713477797372,MMW 12R,A01,514034,Herbst; Matthew,9,0,16,7
1713477797372,MMW 12R,A02,514035,Herbst; Matthew,14,0,16,2
1713477798397,MMW 13R,A01,514037,Staff,0,0,16,16
1713477798397,MMW 13R,A02,514039,Staff,1,0,16,15
1713477800447,SIO 295LS,A00,523233,Staff,16,0,30,14
1713477801475,SIO 295S,A00,523232,Staff,16,0,30,14
1713477802499,SOCI 117,A01,494376,Staff,0,2,5,5
1713477803528,WES 237B,A00,494380,Staff,19,0,20,1
1713477805599,AESE 279B,A00,494370,Wade; Jon P,33,0,33,0
1713477806628,AIP 197,001,627712,Vespa; Emanuel Ignacio,9999,0,9999,0
1713477807653,ANAR 135S,A00,494369,Braswell; Geoffrey E.,0,0,0,0
1713477808678,CAT 124RS,A01,519847,Geibel; William,6,0,20,14
1713477809706,CAT 125RS,A01,515971,Geibel; William,6,0,20,14
1713477810733,CLRE 250,A00,511389,Morris; Sheldon,9996,0,9999,3
1713477811759,CLRE 251,A00,507176,Mehta; Ravindra L.,9996,0,9999,3
1713477811759,CLRE 251,B00,511410,Mehta; Ravindra L.,9998,0,9999,1
1713477812790,CLRE 252,A00,507189,Cuomo; Raphael Eduardo,9998,0,9999,1
1713477813816,CLRE 253,A00,507199,Vaida; Florin,9997,0,9999,2
1713477813816,CLRE 253,B00,507202,Vaida; Florin,9999,0,9999,0
1713477814842,CLRE 259,A00,507211,Patel; Hemal,9996,0,9999,3
1713477815871,CLRE 260,A00,507221,Cuomo; Raphael Eduardo,9999,0,9999,0
1713477816896,CLRE 297,001,507242,Cuomo; Raphael Eduardo,9999,0,9999,0
1713477817926,CSE 191,A00,516875,Minnes Kemp; Mor Mia,9999,0,9999,0
1713477818951,CSS 201S,A01,494383,Staff,35,0,35,0
1713477819978,CSS 202S,A01,494387,Staff,35,0,35,0
1713477821003,EAP 100,A00,516065,Staff,9792,0,9999,207
1713477822032,ECE 45,A01,507414,Staff,40,0,60,20
1713477823057,ECE 100,A01,507416,Baghdadchi; Saharnaz,3,0,20,17
1713477823057,ECE 100,A02,507418,Baghdadchi; Saharnaz,19,0,20,1
1713477824085,ECE 111,A01,507420,Staff,28,0,50,22
1713477825111,ECE 197,001,548057,Sievenpiper; Daniel F.,9998,0,9999,1
1713477826140,EDS 115,A00,507243,Choi; Bailey Miyeon,27,0,28,1
1713477827168,EDS 117,A01,494379,Staff,16,0,25,9
1713477828195,EDS 125,A00,507246,Hopkins; Megan Beth,28,0,30,2
1713477829225,EDS 128A,A01,507264,Fargason; Sharon Gayle,26,0,26,0
1713477830253,EDS 128B,A01,507293,Pappas; Elizabeth,30,0,30,0
1713477831279,EDS 139,A00,507294,Fargason; Sharon Gayle,30,0,30,0
1713477831279,EDS 139,B00,507313,Pappas; Elizabeth,30,0,30,0
1713477832309,EDS 201,A00,507315,Staff,19,0,30,11
1713477833333,EDS 203,A01,507317,Halter; Christopher P.,18,0,30,12
1713477834365,EDS 204R,A01,507319,Halter; Christopher P.,0,1,30,30
1713477834365,EDS 204R,B01,507331,Heinzman; Erica M.,26,0,30,4
1713477835391,EDS 206R,A00,507332,Staff,0,1,30,30
1713477835391,EDS 206R,B00,507343,Staff,27,0,30,3
1713477836420,EDS 250,A00,507344,Hemans; Patricia Ann Benitez,28,0,40,12
1713477837447,EDS 281,A00,507345,Daly; Alan J.,18,0,18,0
1713477838473,EDS 284,A00,507350,Daly; Alan J.,16,0,16,0
1713477839496,EDS 286,A00,507359,Fine; Sarah,18,0,18,0
1713477840526,EDS 289C,A01,507361,Daly; Alan J.,18,0,18,0
1713477841555,EDS 290,A00,507366,Hofstetter; Carolyn,15,0,15,0
1713477842581,LIGM 5A,A00,507421,Fischer-Grunski; Eva K,20,0,20,0
1713477843608,LIGM 5B,A00,507423,Fischer-Grunski; Eva K,20,0,20,0
1713477844633,LIGM 5C,A00,507425,Fischer-Grunski; Eva K,20,0,20,0
1713477845658,LIIT 5AS,A00,507427,Carnelos; Chiara,20,0,20,0
1713477846686,LIIT 5BS,A00,507430,Carnelos; Chiara,20,0,20,0
1713477847710,LIIT 5CS,A00,507432,Carnelos; Chiara,20,0,20,0
1713477848736,LISP 5A,A00,507541,Munoz Sanchez; Alicia,15,0,20,5
1713477849761,LISP 5B,A00,507671,Munoz Sanchez; Alicia,12,0,20,8
1713477850792,LISP 5C,A00,507696,Munoz Sanchez; Alicia,11,0,20,9
1713477851818,MAE 197,001,528363,Boechler; Nicholas Sebastia,9998,0,9999,1
1713477852844,MATH 197,001,523477,Kedlaya; Kiran S.,9999,0,9999,0
1713477852844,MATH 197,002,563811,Zhang; Danna,9998,0,9999,1
1713477853873,MCWP 40R,A00,518780,Staff,17,0,20,3
1713477853873,MCWP 40R,B00,518781,Staff,14,0,20,6
1713477853873,MCWP 40R,C00,518783,Staff,13,0,20,7
1713477854900,MCWP 50R,A00,518791,Staff,10,0,20,10
1713477854900,MCWP 50R,B00,518792,Staff,8,0,20,12
1713477854900,MCWP 50R,C00,518793,Staff,7,0,20,13
1713477854900,MCWP 50R,D00,518794,Staff,4,0,20,16
1713477854900,MCWP 50R,E00,518795,Staff,6,0,20,14
1713477854900,MCWP 50R,F00,518796,Staff,15,0,20,5
1713477854900,MCWP 50R,G00,518797,Staff,13,0,20,7
1713477855925,MMW 12R,A01,514034,Herbst; Matthew,9,0,16,7
1713477855925,MMW 12R,A02,514035,Herbst; Matthew,14,0,16,2
1713477856950,MMW 13R,A01,514037,Staff,0,0,16,16
1713477856950,MMW 13R,A02,514039,Staff,1,0,16,15
1713477859010,SIO 295LS,A00,523233,Staff,16,0,30,14
1713477860037,SIO 295S,A00,523232,Staff,16,0,30,14
1713477861063,SOCI 117,A01,494376,Staff,0,2,5,5
1713477862090,WES 237B,A00,494380,Staff,19,0,20,1
1713477864155,AESE 279B,A00,494370,Wade; Jon P,33,0,33,0
1713477865182,AIP 197,001,627712,Vespa; Emanuel Ignacio,9999,0,9999,0
1713477866210,ANAR 135S,A00,494369,Braswell; Geoffrey E.,0,0,0,0
1713477867238,CAT 124RS,A01,519847,Geibel; William,6,0,20,14
1713477868265,CAT 125RS,A01,515971,Geibel; William,6,0,20,14
1713477869294,CLRE 250,A00,511389,Morris; Sheldon,9996,0,9999,3
1713477870321,CLRE 251,A00,507176,Mehta; Ravindra L.,9996,0,9999,3
1713477870321,CLRE 251,B00,511410,Mehta; Ravindra L.,9998,0,9999,1
1713477871349,CLRE 252,A00,507189,Cuomo; Raphael Eduardo,9998,0,9999,1
1713477872379,CLRE 253,A00,507199,Vaida; Florin,9997,0,9999,2
1713477872379,CLRE 253,B00,507202,Vaida; Florin,9999,0,9999,0
1713477873405,CLRE 259,A00,507211,Patel; Hemal,9996,0,9999,3
1713477874431,CLRE 260,A00,507221,Cuomo; Raphael Eduardo,9999,0,9999,0
1713477875456,CLRE 297,001,507242,Cuomo; Raphael Eduardo,9999,0,9999,0
1713477876482,CSE 191,A00,516875,Minnes Kemp; Mor Mia,9999,0,9999,0
1713477877506,CSS 201S,A01,494383,Staff,35,0,35,0
1713477878535,CSS 202S,A01,494387,Staff,35,0,35,0
1713477879562,EAP 100,A00,516065,Staff,9792,0,9999,207
1713477880591,ECE 45,A01,507414,Staff,40,0,60,20
1713477881617,ECE 100,A01,507416,Baghdadchi; Saharnaz,3,0,20,17
1713477881617,ECE 100,A02,507418,Baghdadchi; Saharnaz,19,0,20,1
1713477882699,ECE 111,A01,507420,Staff,28,0,50,22
1713477883727,ECE 197,001,548057,Sievenpiper; Daniel F.,9998,0,9999,1
1713477884755,EDS 115,A00,507243,Choi; Bailey Miyeon,27,0,28,1
1713477885781,EDS 117,A01,494379,Staff,16,0,25,9
1713477886811,EDS 125,A00,507246,Hopkins; Megan Beth,28,0,30,2
1713477887836,EDS 128A,A01,507264,Fargason; Sharon Gayle,26,0,26,0
1713477888862,EDS 128B,A01,507293,Pappas; Elizabeth,30,0,30,0
1713477889887,EDS 139,A00,507294,Fargason; Sharon Gayle,30,0,30,0
1713477889887,EDS 139,B00,507313,Pappas; Elizabeth,30,0,30,0
1713477890915,EDS 201,A00,507315,Staff,19,0,30,11
1713477891942,EDS 203,A01,507317,Halter; Christopher P.,18,0,30,12
1713477892973,EDS 204R,A01,507319,Halter; Christopher P.,0,1,30,30
1713477892973,EDS 204R,B01,507331,Heinzman; Erica M.,26,0,30,4
1713477894000,EDS 206R,A00,507332,Staff,0,1,30,30
1713477894000,EDS 206R,B00,507343,Staff,27,0,30,3
1713477895034,EDS 250,A00,507344,Hemans; Patricia Ann Benitez,28,0,40,12
1713477896064,EDS 281,A00,507345,Daly; Alan J.,18,0,18,0
1713477897091,EDS 284,A00,507350,Daly; Alan J.,16,0,16,0
1713477898115,EDS 286,A00,507359,Fine; Sarah,18,0,18,0
1713477899139,EDS 289C,A01,507361,Daly; Alan J.,18,0,18,0
1713477900169,EDS 290,A00,507366,Hofstetter; Carolyn,15,0,15,0
1713477901195,LIGM 5A,A00,507421,Fischer-Grunski; Eva K,20,0,20,0
1713477902221,LIGM 5B,A00,507423,Fischer-Grunski; Eva K,20,0,20,0
1713477903251,LIGM 5C,A00,507425,Fischer-Grunski; Eva K,20,0,20,0
1713477904282,LIIT 5AS,A00,507427,Carnelos; Chiara,20,0,20,0
1713477905307,LIIT 5BS,A00,507430,Carnelos; Chiara,20,0,20,0
1713477906331,LIIT 5CS,A00,507432,Carnelos; Chiara,20,0,20,0
1713477907355,LISP 5A,A00,507541,Munoz Sanchez; Alicia,15,0,20,5
1713477908381,LISP 5B,A00,507671,Munoz Sanchez; Alicia,12,0,20,8
1713477909406,LISP 5C,A00,507696,Munoz Sanchez; Alicia,11,0,20,9
1713477910431,MAE 197,001,528363,Boechler; Nicholas Sebastia,9998,0,9999,1
1713477911457,MATH 197,001,523477,Kedlaya; Kiran S.,9999,0,9999,0
1713477911457,MATH 197,002,563811,Zhang; Danna,9998,0,9999,1
1713477912485,MCWP 40R,A00,518780,Staff,17,0,20,3
1713477912485,MCWP 40R,B00,518781,Staff,14,0,20,6
1713477912485,MCWP 40R,C00,518783,Staff,13,0,20,7
1713477913513,MCWP 50R,A00,518791,Staff,10,0,20,10
1713477913513,MCWP 50R,B00,518792,Staff,8,0,20,12
1713477913513,MCWP 50R,C00,518793,Staff,7,0,20,13
1713477913513,MCWP 50R,D00,518794,Staff,4,0,20,16
1713477913513,MCWP 50R,E00,518795,Staff,6,0,20,14
1713477913513,MCWP 50R,F00,518796,Staff,15,0,20,5
1713477913513,MCWP 50R,G00,518797,Staff,13,0,20,7
1713477914539,MMW 12R,A01,514034,Herbst; Matthew,9,0,16,7
1713477914539,MMW 12R,A02,514035,Herbst; Matthew,14,0,16,2
1713477915567,MMW 13R,A01,514037,Staff,0,0,16,16
1713477915567,MMW 13R,A02,514039,Staff,1,0,16,15
1713477917621,SIO 295LS,A00,523233,Staff,16,0,30,14
1713477918650,SIO 295S,A00,523232,Staff,16,0,30,14
1713477919675,SOCI 117,A01,494376,Staff,0,2,5,5
1713477920705,WES 237B,A00,494380,Staff,19,0,20,1
1713477922782,AESE 279B,A00,494370,Wade; Jon P,33,0,33,0
1713477923807,AIP 197,001,627712,Vespa; Emanuel Ignacio,9999,0,9999,0
1713477924832,ANAR 135S,A00,494369,Braswell; Geoffrey E.,0,0,0,0
1713477925862,CAT 124RS,A01,519847,Geibel; William,6,0,20,14
1713477926891,CAT 125RS,A01,515971,Geibel; William,6,0,20,14
1713477927915,CLRE 250,A00,511389,Morris; Sheldon,9996,0,9999,3
1713477928942,CLRE 251,A00,507176,Mehta; Ravindra L.,9996,0,9999,3
1713477928942,CLRE 251,B00,511410,Mehta; Ravindra L.,9998,0,9999,1
1713477929968,CLRE 252,A00,507189,Cuomo; Raphael Eduardo,9998,0,9999,1
1713477930997,CLRE 253,A00,507199,Vaida; Florin,9997,0,9999,2
1713477930997,CLRE 253,B00,507202,Vaida; Florin,9999,0,9999,0
1713477932024,CLRE 259,A00,507211,Patel; Hemal,9996,0,9999,3
1713477933052,CLRE 260,A00,507221,Cuomo; Raphael Eduardo,9999,0,9999,0
1713477934077,CLRE 297,001,507242,Cuomo; Raphael Eduardo,9999,0,9999,0
1713477935105,CSE 191,A00,516875,Minnes Kemp; Mor Mia,9999,0,9999,0
1713477936134,CSS 201S,A01,494383,Staff,35,0,35,0
1713477937158,CSS 202S,A01,494387,Staff,35,0,35,0
1713477938184,EAP 100,A00,516065,Staff,9792,0,9999,207
1713477939214,ECE 45,A01,507414,Staff,40,0,60,20
1713477940237,ECE 100,A01,507416,Baghdadchi; Saharnaz,3,0,20,17
1713477940237,ECE 100,A02,507418,Baghdadchi; Saharnaz,19,0,20,1
1713477941264,ECE 111,A01,507420,Staff,28,0,50,22
1713477942290,ECE 197,001,548057,Sievenpiper; Daniel F.,9998,0,9999,1
1713477943318,EDS 115,A00,507243,Choi; Bailey Miyeon,27,0,28,1
1713477944344,EDS 117,A01,494379,Staff,16,0,25,9
1713477945374,EDS 125,A00,507246,Hopkins; Megan Beth,28,0,30,2
1713477946399,EDS 128A,A01,507264,Fargason; Sharon Gayle,26,0,26,0
1713477947428,EDS 128B,A01,507293,Pappas; Elizabeth,30,0,30,0
1713477948457,EDS 139,A00,507294,Fargason; Sharon Gayle,30,0,30,0
1713477948457,EDS 139,B00,507313,Pappas; Elizabeth,30,0,30,0
1713477949481,EDS 201,A00,507315,Staff,19,0,30,11
1713477950507,EDS 203,A01,507317,Halter; Christopher P.,18,0,30,12
1713477951537,EDS 204R,A01,507319,Halter; Christopher P.,0,1,30,30
1713477951537,EDS 204R,B01,507331,Heinzman; Erica M.,26,0,30,4
1713477952561,EDS 206R,A00,507332,Staff,0,1,30,30
1713477952561,EDS 206R,B00,507343,Staff,27,0,30,3
1713477953589,EDS 250,A00,507344,Hemans; Patricia Ann Benitez,28,0,40,12
1713477954614,EDS 281,A00,507345,Daly; Alan J.,18,0,18,0
1713477955639,EDS 284,A00,507350,Daly; Alan J.,16,0,16,0
1713477956669,EDS 286,A00,507359,Fine; Sarah,18,0,18,0
1713477957694,EDS 289C,A01,507361,Daly; Alan J.,18,0,18,0
1713477958723,EDS 290,A00,507366,Hofstetter; Carolyn,15,0,15,0
1713477959752,LIGM 5A,A00,507421,Fischer-Grunski; Eva K,20,0,20,0
1713477960779,LIGM 5B,A00,507423,Fischer-Grunski; Eva K,20,0,20,0
1713477961804,LIGM 5C,A00,507425,Fischer-Grunski; Eva K,20,0,20,0
1713477962830,LIIT 5AS,A00,507427,Carnelos; Chiara,20,0,20,0
1713477963874,LIIT 5BS,A00,507430,Carnelos; Chiara,20,0,20,0
1713477964899,LIIT 5CS,A00,507432,Carnelos; Chiara,20,0,20,0
1713477965926,LISP 5A,A00,507541,Munoz Sanchez; Alicia,15,0,20,5
1713477966951,LISP 5B,A00,507671,Munoz Sanchez; Alicia,12,0,20,8
1713477967980,LISP 5C,A00,507696,Munoz Sanchez; Alicia,11,0,20,9
1713477969006,MAE 197,001,528363,Boechler; Nicholas Sebastia,9998,0,9999,1
1713477970035,MATH 197,001,523477,Kedlaya; Kiran S.,9999,0,9999,0
1713477970035,MATH 197,002,563811,Zhang; Danna,9998,0,9999,1
1713477971061,MCWP 40R,A00,518780,Staff,17,0,20,3
1713477971061,MCWP 40R,B00,518781,Staff,14,0,20,6
1713477971061,MCWP 40R,C00,518783,Staff,13,0,20,7
1713477972087,MCWP 50R,A00,518791,Staff,10,0,20,10
1713477972087,MCWP 50R,B00,518792,Staff,8,0,20,12
1713477972087,MCWP 50R,C00,518793,Staff,7,0,20,13
1713477972087,MCWP 50R,D00,518794,Staff,4,0,20,16
1713477972087,MCWP 50R,E00,518795,Staff,6,0,20,14
1713477972087,MCWP 50R,F00,518796,Staff,15,0,20,5
1713477972087,MCWP 50R,G00,518797,Staff,13,0,20,7
1713477973115,MMW 12R,A01,514034,Herbst; Matthew,9,0,16,7
1713477973115,MMW 12R,A02,514035,Herbst; Matthew,14,0,16,2
1713477974143,MMW 13R,A01,514037,Staff,0,0,16,16
1713477974143,MMW 13R,A02,514039,Staff,1,0,16,15
1713477976194,SIO 295LS,A00,523233,Staff,16,0,30,14
1713477977218,SIO 295S,A00,523232,Staff,16,0,30,14
1713477978242,SOCI 117,A01,494376,Staff,0,2,5,5
1713477979269,WES 237B,A00,494380,Staff,19,0,20,1
1713477981340,AESE 279B,A00,494370,Wade; Jon P,33,0,33,0
1713477982365,AIP 197,001,627712,Vespa; Emanuel Ignacio,9999,0,9999,0
1713477983394,ANAR 135S,A00,494369,Braswell; Geoffrey E.,0,0,0,0
1713477984423,CAT 124RS,A01,519847,Geibel; William,6,0,20,14
1713477985446,CAT 125RS,A01,515971,Geibel; William,6,0,20,14
1713477986531,CLRE 250,A00,511389,Morris; Sheldon,9996,0,9999,3
1713477987563,CLRE 251,A00,507176,Mehta; Ravindra L.,9996,0,9999,3
1713477987563,CLRE 251,B00,511410,Mehta; Ravindra L.,9998,0,9999,1
1713477988592,CLRE 252,A00,507189,Cuomo; Raphael Eduardo,9998,0,9999,1
1713477989617,CLRE 253,A00,507199,Vaida; Florin,9997,0,9999,2
1713477989617,CLRE 253,B00,507202,Vaida; Florin,9999,0,9999,0
1713477990647,CLRE 259,A00,507211,Patel; Hemal,9996,0,9999,3
1713477991674,CLRE 260,A00,507221,Cuomo; Raphael Eduardo,9999,0,9999,0
1713477992705,CLRE 297,001,507242,Cuomo; Raphael Eduardo,9999,0,9999,0
1713477993731,CSE 191,A00,516875,Minnes Kemp; Mor Mia,9999,0,9999,0
1713477994761,CSS 201S,A01,494383,Staff,35,0,35,0
1713477995789,CSS 202S,A01,494387,Staff,35,0,35,0
1713477996815,EAP 100,A00,516065,Staff,9792,0,9999,207
1713477997849,ECE 45,A01,507414,Staff,40,0,60,20
1713477998874,ECE 100,A01,507416,Baghdadchi; Saharnaz,3,0,20,17
1713477998874,ECE 100,A02,507418,Baghdadchi; Saharnaz,19,0,20,1
1713477999901,ECE 111,A01,507420,Staff,28,0,50,22
1713478000927,ECE 197,001,548057,Sievenpiper; Daniel F.,9998,0,9999,1
1713478001955,EDS 115,A00,507243,Choi; Bailey Miyeon,27,0,28,1
1713478002979,EDS 117,A01,494379,Staff,16,0,25,9
1713478004008,EDS 125,A00,507246,Hopkins; Megan Beth,28,0,30,2
1713478005037,EDS 128A,A01,507264,Fargason; Sharon Gayle,26,0,26,0
1713478006064,EDS 128B,A01,507293,Pappas; Elizabeth,30,0,30,0
1713478007092,EDS 139,A00,507294,Fargason; Sharon Gayle,30,0,30,0
1713478007092,EDS 139,B00,507313,Pappas; Elizabeth,30,0,30,0
1713478008119,EDS 201,A00,507315,Staff,19,0,30,11
1713478009144,EDS 203,A01,507317,Halter; Christopher P.,18,0,30,12
1713478010169,EDS 204R,A01,507319,Halter; Christopher P.,0,1,30,30
1713478010169,EDS 204R,B01,507331,Heinzman; Erica M.,26,0,30,4
1713478011197,EDS 206R,A00,507332,Staff,0,1,30,30
1713478011197,EDS 206R,B00,507343,Staff,27,0,30,3
1713478012221,EDS 250,A00,507344,Hemans; Patricia Ann Benitez,28,0,40,12
1713478013286,EDS 281,A00,507345,Daly; Alan J.,18,0,18,0
1713478014311,EDS 284,A00,507350,Daly; Alan J.,16,0,16,0
1713478015342,EDS 286,A00,507359,Fine; Sarah,18,0,18,0
1713478016367,EDS 289C,A01,507361,Daly; Alan J.,18,0,18,0
1713478017396,EDS 290,A00,507366,Hofstetter; Carolyn,15,0,15,0
1713478018423,LIGM 5A,A00,507421,Fischer-Grunski; Eva K,20,0,20,0
1713478019448,LIGM 5B,A00,507423,Fischer-Grunski; Eva K,20,0,20,0
1713478020474,LIGM 5C,A00,507425,Fischer-Grunski; Eva K,20,0,20,0
1713478021504,LIIT 5AS,A00,507427,Carnelos; Chiara,20,0,20,0
1713478022533,LIIT 5BS,A00,507430,Carnelos; Chiara,20,0,20,0
1713478023558,LIIT 5CS,A00,507432,Carnelos; Chiara,20,0,20,0
1713478024587,LISP 5A,A00,507541,Munoz Sanchez; Alicia,15,0,20,5
1713478025617,LISP 5B,A00,507671,Munoz Sanchez; Alicia,12,0,20,8
1713478026649,LISP 5C,A00,507696,Munoz Sanchez; Alicia,11,0,20,9
1713478027675,MAE 197,001,528363,Boechler; Nicholas Sebastia,9998,0,9999,1
1713478028706,MATH 197,001,523477,Kedlaya; Kiran S.,9999,0,9999,0
1713478028706,MATH 197,002,563811,Zhang; Danna,9998,0,9999,1
1713478029736,MCWP 40R,A00,518780,Staff,17,0,20,3
1713478029736,MCWP 40R,B00,518781,Staff,14,0,20,6
1713478029736,MCWP 40R,C00,518783,Staff,13,0,20,7
1713478030763,MCWP 50R,A00,518791,Staff,10,0,20,10
1713478030763,MCWP 50R,B00,518792,Staff,8,0,20,12
1713478030763,MCWP 50R,C00,518793,Staff,7,0,20,13
1713478030763,MCWP 50R,D00,518794,Staff,4,0,20,16
1713478030763,MCWP 50R,E00,518795,Staff,6,0,20,14
1713478030763,MCWP 50R,F00,518796,Staff,15,0,20,5
1713478030763,MCWP 50R,G00,518797,Staff,13,0,20,7
1713478031791,MMW 12R,A01,514034,Herbst; Matthew,9,0,16,7
1713478031791,MMW 12R,A02,514035,Herbst; Matthew,14,0,16,2
1713478032818,MMW 13R,A01,514037,Staff,0,0,16,16
1713478032818,MMW 13R,A02,514039,Staff,0,0,16,16
1713478034872,SIO 295LS,A00,523233,Staff,16,0,30,14
1713478035897,SIO 295S,A00,523232,Staff,16,0,30,14
1713478036923,SOCI 117,A01,494376,Staff,0,2,5,5
1713478037948,WES 237B,A00,494380,Staff,19,0,20,1
1713478040015,AESE 279B,A00,494370,Wade; Jon P,33,0,33,0
1713478041040,AIP 197,001,627712,Vespa; Emanuel Ignacio,9999,0,9999,0
1713478042065,ANAR 135S,A00,494369,Braswell; Geoffrey E.,0,0,0,0
1713478043093,CAT 124RS,A01,519847,Geibel; William,6,0,20,14
1713478044119,CAT 125RS,A01,515971,Geibel; William,6,0,20,14
1713478045148,CLRE 250,A00,511389,Morris; Sheldon,9996,0,9999,3
1713478046178,CLRE 251,A00,507176,Mehta; Ravindra L.,9996,0,9999,3
1713478046178,CLRE 251,B00,511410,Mehta; Ravindra L.,9998,0,9999,1
1713478047207,CLRE 252,A00,507189,Cuomo; Raphael Eduardo,9998,0,9999,1
1713478048232,CLRE 253,A00,507199,Vaida; Florin,9997,0,9999,2
1713478048232,CLRE 253,B00,507202,Vaida; Florin,9999,0,9999,0
1713478049264,CLRE 259,A00,507211,Patel; Hemal,9996,0,9999,3
1713478050289,CLRE 260,A00,507221,Cuomo; Raphael Eduardo,9999,0,9999,0
1713478051316,CLRE 297,001,507242,Cuomo; Raphael Eduardo,9999,0,9999,0
1713478052344,CSE 191,A00,516875,Minnes Kemp; Mor Mia,9999,0,9999,0
1713478053369,CSS 201S,A01,494383,Staff,35,0,35,0
1713478054397,CSS 202S,A01,494387,Staff,35,0,35,0
1713478055422,EAP 100,A00,516065,Staff,9792,0,9999,207
1713478056450,ECE 45,A01,507414,Staff,40,0,60,20
1713478057479,ECE 100,A01,507416,Baghdadchi; Saharnaz,3,0,20,17
1713478057479,ECE 100,A02,507418,Baghdadchi; Saharnaz,19,0,20,1
1713478058508,ECE 111,A01,507420,Staff,28,0,50,22
1713478059534,ECE 197,001,548057,Sievenpiper; Daniel F.,9998,0,9999,1
1713478060559,EDS 115,A00,507243,Choi; Bailey Miyeon,27,0,28,1
1713478061584,EDS 117,A01,494379,Staff,16,0,25,9
1713478062608,EDS 125,A00,507246,Hopkins; Megan Beth,28,0,30,2
1713478063633,EDS 128A,A01,507264,Fargason; Sharon Gayle,26,0,26,0
1713478064659,EDS 128B,A01,507293,Pappas; Elizabeth,30,0,30,0
1713478065684,EDS 139,A00,507294,Fargason; Sharon Gayle,30,0,30,0
1713478065684,EDS 139,B00,507313,Pappas; Elizabeth,30,0,30,0
1713478066712,EDS 201,A00,507315,Staff,19,0,30,11
1713478067739,EDS 203,A01,507317,Halter; Christopher P.,18,0,30,12
1713478068765,EDS 204R,A01,507319,Halter; Christopher P.,0,1,30,30
1713478068765,EDS 204R,B01,507331,Heinzman; Erica M.,26,0,30,4
1713478069791,EDS 206R,A00,507332,Staff,0,1,30,30
1713478069791,EDS 206R,B00,507343,Staff,27,0,30,3
1713478070816,EDS 250,A00,507344,Hemans; Patricia Ann Benitez,28,0,40,12
1713478071846,EDS 281,A00,507345,Daly; Alan J.,18,0,18,0
1713478072881,EDS 284,A00,507350,Daly; Alan J.,16,0,16,0
1713478073911,EDS 286,A00,507359,Fine; Sarah,18,0,18,0
1713478074936,EDS 289C,A01,507361,Daly; Alan J.,18,0,18,0
1713478075967,EDS 290,A00,507366,Hofstetter; Carolyn,15,0,15,0
1713478076999,LIGM 5A,A00,507421,Fischer-Grunski; Eva K,20,0,20,0
1713478078026,LIGM 5B,A00,507423,Fischer-Grunski; Eva K,20,0,20,0
1713478079054,LIGM 5C,A00,507425,Fischer-Grunski; Eva K,20,0,20,0
1713478080080,LIIT 5AS,A00,507427,Carnelos; Chiara,20,0,20,0
1713478081108,LIIT 5BS,A00,507430,Carnelos; Chiara,20,0,20,0
1713478082135,LIIT 5CS,A00,507432,Carnelos; Chiara,20,0,20,0
1713478083166,LISP 5A,A00,507541,Munoz Sanchez; Alicia,15,0,20,5
1713478084199,LISP 5B,A00,507671,Munoz Sanchez; Alicia,12,0,20,8
1713478085225,LISP 5C,A00,507696,Munoz Sanchez; Alicia,11,0,20,9
1713478086269,MAE 197,001,528363,Boechler; Nicholas Sebastia,9998,0,9999,1
1713478087301,MATH 197,001,523477,Kedlaya; Kiran S.,9999,0,9999,0
1713478087301,MATH 197,002,563811,Zhang; Danna,9998,0,9999,1
1713478088327,MCWP 40R,A00,518780,Staff,17,0,20,3
1713478088327,MCWP 40R,B00,518781,Staff,14,0,20,6
1713478088327,MCWP 40R,C00,518783,Staff,13,0,20,7
1713478089357,MCWP 50R,A00,518791,Staff,10,0,20,10
1713478089357,MCWP 50R,B00,518792,Staff,8,0,20,12
1713478089357,MCWP 50R,C00,518793,Staff,7,0,20,13
1713478089357,MCWP 50R,D00,518794,Staff,4,0,20,16
1713478089357,MCWP 50R,E00,518795,Staff,6,0,20,14
1713478089357,MCWP 50R,F00,518796,Staff,15,0,20,5
1713478089357,MCWP 50R,G00,518797,Staff,13,0,20,7
1713478090436,MMW 12R,A01,514034,Herbst; Matthew,9,0,16,7
1713478090436,MMW 12R,A02,514035,Herbst; Matthew,14,0,16,2
1713478091461,MMW 13R,A01,514037,Staff,0,0,16,16
1713478091461,MMW 13R,A02,514039,Staff,0,0,16,16
1713478093512,SIO 295LS,A00,523233,Staff,16,0,30,14
1713478094535,SIO 295S,A00,523232,Staff,16,0,30,14
1713478095567,SOCI 117,A01,494376,Staff,0,2,5,5
1713478096595,WES 237B,A00,494380,Staff,19,0,20,1
1713478098676,AESE 279B,A00,494370,Wade; Jon P,33,0,33,0
1713478099702,AIP 197,001,627712,Vespa; Emanuel Ignacio,9999,0,9999,0
1713478100727,ANAR 135S,A00,494369,Braswell; Geoffrey E.,0,0,0,0
1713478101753,CAT 124RS,A01,519847,Geibel; William,6,0,20,14
1713478102783,CAT 125RS,A01,515971,Geibel; William,6,0,20,14
1713478103808,CLRE 250,A00,511389,Morris; Sheldon,9996,0,9999,3
1713478104840,CLRE 251,A00,507176,Mehta; Ravindra L.,9996,0,9999,3
1713478104840,CLRE 251,B00,511410,Mehta; Ravindra L.,9998,0,9999,1
1713478105865,CLRE 252,A00,507189,Cuomo; Raphael Eduardo,9998,0,9999,1
1713478106910,CLRE 253,A00,507199,Vaida; Florin,9997,0,9999,2
1713478106910,CLRE 253,B00,507202,Vaida; Florin,9999,0,9999,0
1713478107939,CLRE 259,A00,507211,Patel; Hemal,9996,0,9999,3
1713478108965,CLRE 260,A00,507221,Cuomo; Raphael Eduardo,9999,0,9999,0
1713478109999,CLRE 297,001,507242,Cuomo; Raphael Eduardo,9999,0,9999,0
1713478111023,CSE 191,A00,516875,Minnes Kemp; Mor Mia,9999,0,9999,0
1713478112054,CSS 201S,A01,494383,Staff,35,0,35,0
1713478113080,CSS 202S,A01,494387,Staff,35,0,35,0
1713478114104,EAP 100,A00,516065,Staff,9792,0,9999,207
1713478115132,ECE 45,A01,507414,Staff,40,0,60,20
1713478116158,ECE 100,A01,507416,Baghdadchi; Saharnaz,3,0,20,17
1713478116158,ECE 100,A02,507418,Baghdadchi; Saharnaz,19,0,20,1
1713478117181,ECE 111,A01,507420,Staff,28,0,50,22
1713478118205,ECE 197,001,548057,Sievenpiper; Daniel F.,9998,0,9999,1
1713478119231,EDS 115,A00,507243,Choi; Bailey Miyeon,27,0,28,1
1713478120256,EDS 117,A01,494379,Staff,16,0,25,9
1713478121287,EDS 125,A00,507246,Hopkins; Megan Beth,28,0,30,2
1713478122313,EDS 128A,A01,507264,Fargason; Sharon Gayle,26,0,26,0
1713478123343,EDS 128B,A01,507293,Pappas; Elizabeth,30,0,30,0
1713478124371,EDS 139,A00,507294,Fargason; Sharon Gayle,30,0,30,0
1713478124371,EDS 139,B00,507313,Pappas; Elizabeth,30,0,30,0
1713478125396,EDS 201,A00,507315,Staff,19,0,30,11
1713478126423,EDS 203,A01,507317,Halter; Christopher P.,18,0,30,12
1713478127453,EDS 204R,A01,507319,Halter; Christopher P.,0,1,30,30
1713478127453,EDS 204R,B01,507331,Heinzman; Erica M.,26,0,30,4
1713478128480,EDS 206R,A00,507332,Staff,0,1,30,30
1713478128480,EDS 206R,B00,507343,Staff,27,0,30,3
1713478129510,EDS 250,A00,507344,Hemans; Patricia Ann Benitez,28,0,40,12
1713478130534,EDS 281,A00,507345,Daly; Alan J.,18,0,18,0
1713478131562,EDS 284,A00,507350,Daly; Alan J.,16,0,16,0
1713478132587,EDS 286,A00,507359,Fine; Sarah,18,0,18,0
1713478133618,EDS 289C,A01,507361,Daly; Alan J.,18,0,18,0
1713478134652,EDS 290,A00,507366,Hofstetter; Carolyn,15,0,15,0
1713478135677,LIGM 5A,A00,507421,Fischer-Grunski; Eva K,20,0,20,0
1713478136703,LIGM 5B,A00,507423,Fischer-Grunski; Eva K,20,0,20,0
1713478137729,LIGM 5C,A00,507425,Fischer-Grunski; Eva K,20,0,20,0
1713478138761,LIIT 5AS,A00,507427,Carnelos; Chiara,20,0,20,0
1713478139786,LIIT 5BS,A00,507430,Carnelos; Chiara,20,0,20,0
1713478140819,LIIT 5CS,A00,507432,Carnelos; Chiara,20,0,20,0
1713478141846,LISP 5A,A00,507541,Munoz Sanchez; Alicia,15,0,20,5
1713478142888,LISP 5B,A00,507671,Munoz Sanchez; Alicia,12,0,20,8
1713478143917,LISP 5C,A00,507696,Munoz Sanchez; Alicia,11,0,20,9
1713478144945,MAE 197,001,528363,Boechler; Nicholas Sebastia,9998,0,9999,1
1713478145975,MATH 197,001,523477,Kedlaya; Kiran S.,9999,0,9999,0
1713478145975,MATH 197,002,563811,Zhang; Danna,9998,0,9999,1
1713478147000,MCWP 40R,A00,518780,Staff,17,0,20,3
1713478147000,MCWP 40R,B00,518781,Staff,14,0,20,6
1713478147000,MCWP 40R,C00,518783,Staff,13,0,20,7
1713478148030,MCWP 50R,A00,518791,Staff,10,0,20,10
1713478148030,MCWP 50R,B00,518792,Staff,8,0,20,12
1713478148030,MCWP 50R,C00,518793,Staff,7,0,20,13
1713478148030,MCWP 50R,D00,518794,Staff,4,0,20,16
1713478148030,MCWP 50R,E00,518795,Staff,6,0,20,14
1713478148030,MCWP 50R,F00,518796,Staff,15,0,20,5
1713478148030,MCWP 50R,G00,518797,Staff,13,0,20,7
1713478149054,MMW 12R,A01,514034,Herbst; Matthew,9,0,16,7
1713478149054,MMW 12R,A02,514035,Herbst; Matthew,14,0,16,2
1713478150079,MMW 13R,A01,514037,Staff,0,0,16,16
1713478150079,MMW 13R,A02,514039,Staff,0,0,16,16
1713478152127,SIO 295LS,A00,523233,Staff,16,0,30,14
1713478153155,SIO 295S,A00,523232,Staff,16,0,30,14
1713478154180,SOCI 117,A01,494376,Staff,0,2,5,5
1713478155205,WES 237B,A00,494380,Staff,19,0,20,1
1713478157280,AESE 279B,A00,494370,Wade; Jon P,33,0,33,0
1713478158306,AIP 197,001,627712,Vespa; Emanuel Ignacio,9999,0,9999,0
1713478159333,ANAR 135S,A00,494369,Braswell; Geoffrey E.,0,0,0,0
1713478160364,CAT 124RS,A01,519847,Geibel; William,6,0,20,14
1713478161390,CAT 125RS,A01,515971,Geibel; William,6,0,20,14
1713478162641,CLRE 250,A00,511389,Morris; Sheldon,9996,0,9999,3
1713478163672,CLRE 251,A00,507176,Mehta; Ravindra L.,9996,0,9999,3
1713478163672,CLRE 251,B00,511410,Mehta; Ravindra L.,9998,0,9999,1
1713478164698,CLRE 252,A00,507189,Cuomo; Raphael Eduardo,9998,0,9999,1
1713478165723,CLRE 253,A00,507199,Vaida; Florin,9997,0,9999,2
1713478165723,CLRE 253,B00,507202,Vaida; Florin,9999,0,9999,0
1713478166746,CLRE 259,A00,507211,Patel; Hemal,9996,0,9999,3
1713478167772,CLRE 260,A00,507221,Cuomo; Raphael Eduardo,9999,0,9999,0
1713478168797,CLRE 297,001,507242,Cuomo; Raphael Eduardo,9999,0,9999,0
1713478169823,CSE 191,A00,516875,Minnes Kemp; Mor Mia,9999,0,9999,0
1713478170852,CSS 201S,A01,494383,Staff,35,0,35,0
1713478171876,CSS 202S,A01,494387,Staff,35,0,35,0
1713478172903,EAP 100,A00,516065,Staff,9792,0,9999,207
1713478173928,ECE 45,A01,507414,Staff,40,0,60,20
1713478174953,ECE 100,A01,507416,Baghdadchi; Saharnaz,3,0,20,17
1713478174953,ECE 100,A02,507418,Baghdadchi; Saharnaz,19,0,20,1
1713478175977,ECE 111,A01,507420,Staff,28,0,50,22
1713478177004,ECE 197,001,548057,Sievenpiper; Daniel F.,9998,0,9999,1
1713478178037,EDS 115,A00,507243,Choi; Bailey Miyeon,27,0,28,1
1713478179066,EDS 117,A01,494379,Staff,16,0,25,9
1713478180096,EDS 125,A00,507246,Hopkins; Megan Beth,28,0,30,2
1713478181121,EDS 128A,A01,507264,Fargason; Sharon Gayle,26,0,26,0
1713478182150,EDS 128B,A01,507293,Pappas; Elizabeth,30,0,30,0
1713478183178,EDS 139,A00,507294,Fargason; Sharon Gayle,30,0,30,0
1713478183178,EDS 139,B00,507313,Pappas; Elizabeth,30,0,30,0
1713478184202,EDS 201,A00,507315,Staff,19,0,30,11
1713478185230,EDS 203,A01,507317,Halter; Christopher P.,18,0,30,12
1713478186260,EDS 204R,A01,507319,Halter; Christopher P.,0,1,30,30
1713478186260,EDS 204R,B01,507331,Heinzman; Erica M.,26,0,30,4
1713478187288,EDS 206R,A00,507332,Staff,0,1,30,30
1713478187288,EDS 206R,B00,507343,Staff,27,0,30,3
1713478188312,EDS 250,A00,507344,Hemans; Patricia Ann Benitez,28,0,40,12
1713478189336,EDS 281,A00,507345,Daly; Alan J.,18,0,18,0
1713478190364,EDS 284,A00,507350,Daly; Alan J.,16,0,16,0
1713478191389,EDS 286,A00,507359,Fine; Sarah,18,0,18,0
1713478192413,EDS 289C,A01,507361,Daly; Alan J.,18,0,18,0
1713478193440,EDS 290,A00,507366,Hofstetter; Carolyn,15,0,15,0
1713478194521,LIGM 5A,A00,507421,Fischer-Grunski; Eva K,20,0,20,0
1713478195546,LIGM 5B,A00,507423,Fischer-Grunski; Eva K,20,0,20,0
1713478196568,LIGM 5C,A00,507425,Fischer-Grunski; Eva K,20,0,20,0
1713478197599,LIIT 5AS,A00,507427,Carnelos; Chiara,20,0,20,0
1713478198623,LIIT 5BS,A00,507430,Carnelos; Chiara,20,0,20,0
1713478199648,LIIT 5CS,A00,507432,Carnelos; Chiara,20,0,20,0
1713478200674,LISP 5A,A00,507541,Munoz Sanchez; Alicia,15,0,20,5
1713478201707,LISP 5B,A00,507671,Munoz Sanchez; Alicia,12,0,20,8
1713478202736,LISP 5C,A00,507696,Munoz Sanchez; Alicia,11,0,20,9
1713478203762,MAE 197,001,528363,Boechler; Nicholas Sebastia,9998,0,9999,1
1713478204790,MATH 197,001,523477,Kedlaya; Kiran S.,9999,0,9999,0
1713478204790,MATH 197,002,563811,Zhang; Danna,9998,0,9999,1
1713478205823,MCWP 40R,A00,518780,Staff,17,0,20,3
1713478205823,MCWP 40R,B00,518781,Staff,14,0,20,6
1713478205823,MCWP 40R,C00,518783,Staff,13,0,20,7
1713478206850,MCWP 50R,A00,518791,Staff,10,0,20,10
1713478206850,MCWP 50R,B00,518792,Staff,8,0,20,12
1713478206850,MCWP 50R,C00,518793,Staff,7,0,20,13
1713478206850,MCWP 50R,D00,518794,Staff,4,0,20,16
1713478206850,MCWP 50R,E00,518795,Staff,6,0,20,14
1713478206850,MCWP 50R,F00,518796,Staff,15,0,20,5
1713478206850,MCWP 50R,G00,518797,Staff,13,0,20,7
1713478207877,MMW 12R,A01,514034,Herbst; Matthew,9,0,16,7
1713478207877,MMW 12R,A02,514035,Herbst; Matthew,14,0,16,2
1713478208904,MMW 13R,A01,514037,Staff,0,0,16,16
1713478208904,MMW 13R,A02,514039,Staff,0,0,16,16
1713478210963,SIO 295LS,A00,523233,Staff,16,0,30,14
1713478211991,SIO 295S,A00,523232,Staff,16,0,30,14
1713478213020,SOCI 117,A01,494376,Staff,0,2,5,5
1713478214047,WES 237B,A00,494380,Staff,19,0,20,1
1713478216126,AESE 279B,A00,494370,Wade; Jon P,33,0,33,0
1713478217151,AIP 197,001,627712,Vespa; Emanuel Ignacio,9999,0,9999,0
1713478218175,ANAR 135S,A00,494369,Braswell; Geoffrey E.,0,0,0,0
1713478219202,CAT 124RS,A01,519847,Geibel; William,6,0,20,14
1713478220226,CAT 125RS,A01,515971,Geibel; William,6,0,20,14
1713478221277,CLRE 250,A00,511389,Morris; Sheldon,9996,0,9999,3
1713478222311,CLRE 251,A00,507176,Mehta; Ravindra L.,9996,0,9999,3
1713478222311,CLRE 251,B00,511410,Mehta; Ravindra L.,9998,0,9999,1
1713478223339,CLRE 252,A00,507189,Cuomo; Raphael Eduardo,9998,0,9999,1
1713478224370,CLRE 253,A00,507199,Vaida; Florin,9997,0,9999,2
1713478224370,CLRE 253,B00,507202,Vaida; Florin,9999,0,9999,0
1713478225399,CLRE 259,A00,507211,Patel; Hemal,9996,0,9999,3
1713478226424,CLRE 260,A00,507221,Cuomo; Raphael Eduardo,9999,0,9999,0
1713478227449,CLRE 297,001,507242,Cuomo; Raphael Eduardo,9999,0,9999,0
1713478228476,CSE 191,A00,516875,Minnes Kemp; Mor Mia,9999,0,9999,0
1713478229508,CSS 201S,A01,494383,Staff,35,0,35,0
1713478230533,CSS 202S,A01,494387,Staff,35,0,35,0
1713478231560,EAP 100,A00,516065,Staff,9792,0,9999,207
1713478232585,ECE 45,A01,507414,Staff,40,0,60,20
1713478233618,ECE 100,A01,507416,Baghdadchi; Saharnaz,3,0,20,17
1713478233618,ECE 100,A02,507418,Baghdadchi; Saharnaz,19,0,20,1
1713478234644,ECE 111,A01,507420,Staff,28,0,50,22
1713478235672,ECE 197,001,548057,Sievenpiper; Daniel F.,9998,0,9999,1
1713478236698,EDS 115,A00,507243,Choi; Bailey Miyeon,27,0,28,1
1713478237724,EDS 117,A01,494379,Staff,16,0,25,9
1713478238748,EDS 125,A00,507246,Hopkins; Megan Beth,28,0,30,2
1713478239773,EDS 128A,A01,507264,Fargason; Sharon Gayle,26,0,26,0
1713478240798,EDS 128B,A01,507293,Pappas; Elizabeth,30,0,30,0
1713478241822,EDS 139,A00,507294,Fargason; Sharon Gayle,30,0,30,0
1713478241822,EDS 139,B00,507313,Pappas; Elizabeth,30,0,30,0
1713478242850,EDS 201,A00,507315,Staff,19,0,30,11
1713478243876,EDS 203,A01,507317,Halter; Christopher P.,18,0,30,12
1713478244904,EDS 204R,A01,507319,Halter; Christopher P.,0,1,30,30
1713478244904,EDS 204R,B01,507331,Heinzman; Erica M.,26,0,30,4
1713478245933,EDS 206R,A00,507332,Staff,0,1,30,30
1713478245933,EDS 206R,B00,507343,Staff,27,0,30,3
1713478246961,EDS 250,A00,507344,Hemans; Patricia Ann Benitez,28,0,40,12
1713478247985,EDS 281,A00,507345,Daly; Alan J.,18,0,18,0
1713478249011,EDS 284,A00,507350,Daly; Alan J.,16,0,16,0
1713478250036,EDS 286,A00,507359,Fine; Sarah,18,0,18,0
1713478251063,EDS 289C,A01,507361,Daly; Alan J.,18,0,18,0
1713478252091,EDS 290,A00,507366,Hofstetter; Carolyn,15,0,15,0
1713478253116,LIGM 5A,A00,507421,Fischer-Grunski; Eva K,20,0,20,0
1713478254147,LIGM 5B,A00,507423,Fischer-Grunski; Eva K,20,0,20,0
1713478255175,LIGM 5C,A00,507425,Fischer-Grunski; Eva K,20,0,20,0
1713478256199,LIIT 5AS,A00,507427,Carnelos; Chiara,20,0,20,0
1713478257225,LIIT 5BS,A00,507430,Carnelos; Chiara,20,0,20,0
1713478258252,LIIT 5CS,A00,507432,Carnelos; Chiara,20,0,20,0
1713478259277,LISP 5A,A00,507541,Munoz Sanchez; Alicia,15,0,20,5
1713478260302,LISP 5B,A00,507671,Munoz Sanchez; Alicia,12,0,20,8
1713478261328,LISP 5C,A00,507696,Munoz Sanchez; Alicia,11,0,20,9
1713478262353,MAE 197,001,528363,Boechler; Nicholas Sebastia,9998,0,9999,1
1713478263378,MATH 197,001,523477,Kedlaya; Kiran S.,9999,0,9999,0
1713478263378,MATH 197,002,563811,Zhang; Danna,9998,0,9999,1
1713478264404,MCWP 40R,A00,518780,Staff,17,0,20,3
1713478264404,MCWP 40R,B00,518781,Staff,14,0,20,6
1713478264404,MCWP 40R,C00,518783,Staff,13,0,20,7
1713478265437,MCWP 50R,A00,518791,Staff,10,0,20,10
1713478265437,MCWP 50R,B00,518792,Staff,8,0,20,12
1713478265437,MCWP 50R,C00,518793,Staff,7,0,20,13
1713478265437,MCWP 50R,D00,518794,Staff,4,0,20,16
1713478265437,MCWP 50R,E00,518795,Staff,6,0,20,14
1713478265437,MCWP 50R,F00,518796,Staff,15,0,20,5
1713478265437,MCWP 50R,G00,518797,Staff,13,0,20,7
1713478266470,MMW 12R,A01,514034,Herbst; Matthew,9,0,16,7
1713478266470,MMW 12R,A02,514035,Herbst; Matthew,14,0,16,2
1713478267495,MMW 13R,A01,514037,Staff,0,0,16,16
1713478267495,MMW 13R,A02,514039,Staff,0,0,16,16
1713478269549,SIO 295LS,A00,523233,Staff,16,0,30,14
1713478270577,SIO 295S,A00,523232,Staff,16,0,30,14
1713478271605,SOCI 117,A01,494376,Staff,0,2,5,5
1713478272632,WES 237B,A00,494380,Staff,19,0,20,1
1713478274695,AESE 279B,A00,494370,Wade; Jon P,33,0,33,0
1713478275723,AIP 197,001,627712,Vespa; Emanuel Ignacio,9999,0,9999,0
1713478276753,ANAR 135S,A00,494369,Braswell; Geoffrey E.,0,0,0,0
1713478277779,CAT 124RS,A01,519847,Geibel; William,6,0,20,14
1713478278803,CAT 125RS,A01,515971,Geibel; William,6,0,20,14
1713478279828,CLRE 250,A00,511389,Morris; Sheldon,9996,0,9999,3
1713478280854,CLRE 251,A00,507176,Mehta; Ravindra L.,9996,0,9999,3
1713478280854,CLRE 251,B00,511410,Mehta; Ravindra L.,9998,0,9999,1
1713478281879,CLRE 252,A00,507189,Cuomo; Raphael Eduardo,9998,0,9999,1
1713478282904,CLRE 253,A00,507199,Vaida; Florin,9997,0,9999,2
1713478282904,CLRE 253,B00,507202,Vaida; Florin,9999,0,9999,0
1713478283929,CLRE 259,A00,507211,Patel; Hemal,9996,0,9999,3
1713478284958,CLRE 260,A00,507221,Cuomo; Raphael Eduardo,9999,0,9999,0
1713478285986,CLRE 297,001,507242,Cuomo; Raphael Eduardo,9999,0,9999,0
1713478287010,CSE 191,A00,516875,Minnes Kemp; Mor Mia,9999,0,9999,0
1713478288110,CSS 201S,A01,494383,Staff,35,0,35,0
1713478289135,CSS 202S,A01,494387,Staff,35,0,35,0
1713478290163,EAP 100,A00,516065,Staff,9792,0,9999,207
1713478291188,ECE 45,A01,507414,Staff,40,0,60,20
1713478292213,ECE 100,A01,507416,Baghdadchi; Saharnaz,3,0,20,17
1713478292213,ECE 100,A02,507418,Baghdadchi; Saharnaz,19,0,20,1
1713478293242,ECE 111,A01,507420,Staff,28,0,50,22
1713478294266,ECE 197,001,548057,Sievenpiper; Daniel F.,9998,0,9999,1
1713478295293,EDS 115,A00,507243,Choi; Bailey Miyeon,27,0,28,1
1713478296318,EDS 117,A01,494379,Staff,16,0,25,9
1713478297345,EDS 125,A00,507246,Hopkins; Megan Beth,28,0,30,2
1713478298428,EDS 128A,A01,507264,Fargason; Sharon Gayle,26,0,26,0
1713478299453,EDS 128B,A01,507293,Pappas; Elizabeth,30,0,30,0
1713478300477,EDS 139,A00,507294,Fargason; Sharon Gayle,30,0,30,0
1713478300477,EDS 139,B00,507313,Pappas; Elizabeth,30,0,30,0
1713478301503,EDS 201,A00,507315,Staff,19,0,30,11
1713478302527,EDS 203,A01,507317,Halter; Christopher P.,18,0,30,12
1713478303554,EDS 204R,A01,507319,Halter; Christopher P.,0,1,30,30
1713478303554,EDS 204R,B01,507331,Heinzman; Erica M.,26,0,30,4
1713478304578,EDS 206R,A00,507332,Staff,0,1,30,30
1713478304578,EDS 206R,B00,507343,Staff,27,0,30,3
1713478305603,EDS 250,A00,507344,Hemans; Patricia Ann Benitez,28,0,40,12
1713478306629,EDS 281,A00,507345,Daly; Alan J.,18,0,18,0
1713478307658,EDS 284,A00,507350,Daly; Alan J.,16,0,16,0
1713478308684,EDS 286,A00,507359,Fine; Sarah,18,0,18,0
1713478309708,EDS 289C,A01,507361,Daly; Alan J.,18,0,18,0
1713478310734,EDS 290,A00,507366,Hofstetter; Carolyn,15,0,15,0
1713478311760,LIGM 5A,A00,507421,Fischer-Grunski; Eva K,20,0,20,0
1713478312794,LIGM 5B,A00,507423,Fischer-Grunski; Eva K,20,0,20,0
1713478313819,LIGM 5C,A00,507425,Fischer-Grunski; Eva K,20,0,20,0
1713478314853,LIIT 5AS,A00,507427,Carnelos; Chiara,20,0,20,0
1713478315885,LIIT 5BS,A00,507430,Carnelos; Chiara,20,0,20,0
1713478316916,LIIT 5CS,A00,507432,Carnelos; Chiara,20,0,20,0
1713478317941,LISP 5A,A00,507541,Munoz Sanchez; Alicia,15,0,20,5
1713478318968,LISP 5B,A00,507671,Munoz Sanchez; Alicia,12,0,20,8
1713478319995,LISP 5C,A00,507696,Munoz Sanchez; Alicia,11,0,20,9
1713478321023,MAE 197,001,528363,Boechler; Nicholas Sebastia,9998,0,9999,1
1713478322052,MATH 197,001,523477,Kedlaya; Kiran S.,9999,0,9999,0
1713478322052,MATH 197,002,563811,Zhang; Danna,9998,0,9999,1
1713478323081,MCWP 40R,A00,518780,Staff,17,0,20,3
1713478323081,MCWP 40R,B00,518781,Staff,14,0,20,6
1713478323081,MCWP 40R,C00,518783,Staff,13,0,20,7
1713478324107,MCWP 50R,A00,518791,Staff,9,0,20,11
1713478324107,MCWP 50R,B00,518792,Staff,8,0,20,12
1713478324107,MCWP 50R,C00,518793,Staff,7,0,20,13
1713478324107,MCWP 50R,D00,518794,Staff,3,0,20,17
1713478324107,MCWP 50R,E00,518795,Staff,6,0,20,14
1713478324107,MCWP 50R,F00,518796,Staff,15,0,20,5
1713478324107,MCWP 50R,G00,518797,Staff,13,0,20,7
1713478325132,MMW 12R,A01,514034,Herbst; Matthew,9,0,16,7
1713478325132,MMW 12R,A02,514035,Herbst; Matthew,14,0,16,2
1713478326160,MMW 13R,A01,514037,Staff,0,0,16,16
1713478326160,MMW 13R,A02,514039,Staff,0,0,16,16
1713478328216,SIO 295LS,A00,523233,Staff,16,0,30,14
1713478329240,SIO 295S,A00,523232,Staff,16,0,30,14
1713478330270,SOCI 117,A01,494376,Staff,0,2,5,5
1713478331305,WES 237B,A00,494380,Staff,19,0,20,1
1713478333437,AESE 279B,A00,494370,Wade; Jon P,33,0,33,0
1713478334462,AIP 197,001,627712,Vespa; Emanuel Ignacio,9999,0,9999,0
1713478335488,ANAR 135S,A00,494369,Braswell; Geoffrey E.,0,0,0,0
1713478336529,CAT 124RS,A01,519847,Geibel; William,6,0,20,14
1713478337555,CAT 125RS,A01,515971,Geibel; William,6,0,20,14
1713478338581,CLRE 250,A00,511389,Morris; Sheldon,9996,0,9999,3
1713478339609,CLRE 251,A00,507176,Mehta; Ravindra L.,9996,0,9999,3
1713478339609,CLRE 251,B00,511410,Mehta; Ravindra L.,9998,0,9999,1
1713478340638,CLRE 252,A00,507189,Cuomo; Raphael Eduardo,9998,0,9999,1
1713478341667,CLRE 253,A00,507199,Vaida; Florin,9997,0,9999,2
1713478341667,CLRE 253,B00,507202,Vaida; Florin,9999,0,9999,0
1713478342695,CLRE 259,A00,507211,Patel; Hemal,9996,0,9999,3
1713478343720,CLRE 260,A00,507221,Cuomo; Raphael Eduardo,9999,0,9999,0
1713478344744,CLRE 297,001,507242,Cuomo; Raphael Eduardo,9999,0,9999,0
1713478345770,CSE 191,A00,516875,Minnes Kemp; Mor Mia,9999,0,9999,0
1713478346795,CSS 201S,A01,494383,Staff,35,0,35,0
1713478347825,CSS 202S,A01,494387,Staff,35,0,35,0
1713478348849,EAP 100,A00,516065,Staff,9792,0,9999,207
1713478349875,ECE 45,A01,507414,Staff,40,0,60,20
1713478350905,ECE 100,A01,507416,Baghdadchi; Saharnaz,3,0,20,17
1713478350905,ECE 100,A02,507418,Baghdadchi; Saharnaz,19,0,20,1
1713478351930,ECE 111,A01,507420,Staff,28,0,50,22
1713478352954,ECE 197,001,548057,Sievenpiper; Daniel F.,9998,0,9999,1
1713478353980,EDS 115,A00,507243,Choi; Bailey Miyeon,27,0,28,1
1713478355004,EDS 117,A01,494379,Staff,16,0,25,9
1713478356030,EDS 125,A00,507246,Hopkins; Megan Beth,28,0,30,2
1713478357059,EDS 128A,A01,507264,Fargason; Sharon Gayle,26,0,26,0
1713478358085,EDS 128B,A01,507293,Pappas; Elizabeth,30,0,30,0
1713478359110,EDS 139,A00,507294,Fargason; Sharon Gayle,30,0,30,0
1713478359110,EDS 139,B00,507313,Pappas; Elizabeth,30,0,30,0
1713478360134,EDS 201,A00,507315,Staff,19,0,30,11
1713478361162,EDS 203,A01,507317,Halter; Christopher P.,18,0,30,12
1713478362195,EDS 204R,A01,507319,Halter; Christopher P.,0,1,30,30
1713478362195,EDS 204R,B01,507331,Heinzman; Erica M.,26,0,30,4
1713478363222,EDS 206R,A00,507332,Staff,0,1,30,30
1713478363222,EDS 206R,B00,507343,Staff,27,0,30,3
1713478364249,EDS 250,A00,507344,Hemans; Patricia Ann Benitez,28,0,40,12
1713478365274,EDS 281,A00,507345,Daly; Alan J.,18,0,18,0
1713478366300,EDS 284,A00,507350,Daly; Alan J.,16,0,16,0
1713478367327,EDS 286,A00,507359,Fine; Sarah,18,0,18,0
1713478368356,EDS 289C,A01,507361,Daly; Alan J.,18,0,18,0
1713478369380,EDS 290,A00,507366,Hofstetter; Carolyn,15,0,15,0
1713478370407,LIGM 5A,A00,507421,Fischer-Grunski; Eva K,20,0,20,0
1713478371435,LIGM 5B,A00,507423,Fischer-Grunski; Eva K,20,0,20,0
1713478372462,LIGM 5C,A00,507425,Fischer-Grunski; Eva K,20,0,20,0
1713478373491,LIIT 5AS,A00,507427,Carnelos; Chiara,20,0,20,0
1713478374514,LIIT 5BS,A00,507430,Carnelos; Chiara,20,0,20,0
1713478375543,LIIT 5CS,A00,507432,Carnelos; Chiara,20,0,20,0
1713478376568,LISP 5A,A00,507541,Munoz Sanchez; Alicia,15,0,20,5
1713478377593,LISP 5B,A00,507671,Munoz Sanchez; Alicia,12,0,20,8
1713478378618,LISP 5C,A00,507696,Munoz Sanchez; Alicia,11,0,20,9
1713478379645,MAE 197,001,528363,Boechler; Nicholas Sebastia,9998,0,9999,1
1713478380671,MATH 197,001,523477,Kedlaya; Kiran S.,9999,0,9999,0
1713478380671,MATH 197,002,563811,Zhang; Danna,9998,0,9999,1
1713478381698,MCWP 40R,A00,518780,Staff,17,0,20,3
1713478381698,MCWP 40R,B00,518781,Staff,14,0,20,6
1713478381698,MCWP 40R,C00,518783,Staff,13,0,20,7
1713478382727,MCWP 50R,A00,518791,Staff,9,0,20,11
1713478382727,MCWP 50R,B00,518792,Staff,7,0,20,13
1713478382727,MCWP 50R,C00,518793,Staff,7,0,20,13
1713478382727,MCWP 50R,D00,518794,Staff,3,0,20,17
1713478382727,MCWP 50R,E00,518795,Staff,6,0,20,14
1713478382727,MCWP 50R,F00,518796,Staff,15,0,20,5
1713478382727,MCWP 50R,G00,518797,Staff,13,0,20,7
1713478383757,MMW 12R,A01,514034,Herbst; Matthew,9,0,16,7
1713478383757,MMW 12R,A02,514035,Herbst; Matthew,14,0,16,2
1713478384789,MMW 13R,A01,514037,Staff,0,0,16,16
1713478384789,MMW 13R,A02,514039,Staff,0,0,16,16
1713478386843,SIO 295LS,A00,523233,Staff,16,0,30,14
1713478387871,SIO 295S,A00,523232,Staff,16,0,30,14
1713478388898,SOCI 117,A01,494376,Staff,0,2,5,5
1713478389923,WES 237B,A00,494380,Staff,19,0,20,1
1713478391987,AESE 279B,A00,494370,Wade; Jon P,33,0,33,0
1713478393013,AIP 197,001,627712,Vespa; Emanuel Ignacio,9999,0,9999,0
1713478394039,ANAR 135S,A00,494369,Braswell; Geoffrey E.,0,0,0,0
1713478395065,CAT 124RS,A01,519847,Geibel; William,6,0,20,14
1713478396091,CAT 125RS,A01,515971,Geibel; William,6,0,20,14
1713478397119,CLRE 250,A00,511389,Morris; Sheldon,9996,0,9999,3
1713478398150,CLRE 251,A00,507176,Mehta; Ravindra L.,9996,0,9999,3
1713478398150,CLRE 251,B00,511410,Mehta; Ravindra L.,9998,0,9999,1
1713478399176,CLRE 252,A00,507189,Cuomo; Raphael Eduardo,9998,0,9999,1
1713478400203,CLRE 253,A00,507199,Vaida; Florin,9997,0,9999,2
1713478400203,CLRE 253,B00,507202,Vaida; Florin,9999,0,9999,0
1713478401230,CLRE 259,A00,507211,Patel; Hemal,9996,0,9999,3
1713478402312,CLRE 260,A00,507221,Cuomo; Raphael Eduardo,9999,0,9999,0
1713478403340,CLRE 297,001,507242,Cuomo; Raphael Eduardo,9999,0,9999,0
1713478404366,CSE 191,A00,516875,Minnes Kemp; Mor Mia,9999,0,9999,0
1713478405394,CSS 201S,A01,494383,Staff,35,0,35,0
1713478406418,CSS 202S,A01,494387,Staff,35,0,35,0
1713478407445,EAP 100,A00,516065,Staff,9792,0,9999,207
1713478408471,ECE 45,A01,507414,Staff,40,0,60,20
1713478409497,ECE 100,A01,507416,Baghdadchi; Saharnaz,3,0,20,17
1713478409497,ECE 100,A02,507418,Baghdadchi; Saharnaz,19,0,20,1
1713478410526,ECE 111,A01,507420,Staff,28,0,50,22
1713478411551,ECE 197,001,548057,Sievenpiper; Daniel F.,9998,0,9999,1
1713478412581,EDS 115,A00,507243,Choi; Bailey Miyeon,27,0,28,1
1713478413609,EDS 117,A01,494379,Staff,16,0,25,9
1713478414634,EDS 125,A00,507246,Hopkins; Megan Beth,28,0,30,2
1713478415659,EDS 128A,A01,507264,Fargason; Sharon Gayle,26,0,26,0
1713478416683,EDS 128B,A01,507293,Pappas; Elizabeth,30,0,30,0
1713478417713,EDS 139,A00,507294,Fargason; Sharon Gayle,30,0,30,0
1713478417713,EDS 139,B00,507313,Pappas; Elizabeth,30,0,30,0
1713478418737,EDS 201,A00,507315,Staff,19,0,30,11
1713478419763,EDS 203,A01,507317,Halter; Christopher P.,18,0,30,12
1713478420789,EDS 204R,A01,507319,Halter; Christopher P.,0,1,30,30
1713478420789,EDS 204R,B01,507331,Heinzman; Erica M.,26,0,30,4
1713478421816,EDS 206R,A00,507332,Staff,0,1,30,30
1713478421816,EDS 206R,B00,507343,Staff,27,0,30,3
1713478422845,EDS 250,A00,507344,Hemans; Patricia Ann Benitez,28,0,40,12
1713478423873,EDS 281,A00,507345,Daly; Alan J.,18,0,18,0
1713478424898,EDS 284,A00,507350,Daly; Alan J.,16,0,16,0
1713478425921,EDS 286,A00,507359,Fine; Sarah,18,0,18,0
1713478426951,EDS 289C,A01,507361,Daly; Alan J.,18,0,18,0
1713478427977,EDS 290,A00,507366,Hofstetter; Carolyn,15,0,15,0
1713478429002,LIGM 5A,A00,507421,Fischer-Grunski; Eva K,20,0,20,0
1713478430028,LIGM 5B,A00,507423,Fischer-Grunski; Eva K,20,0,20,0
1713478431058,LIGM 5C,A00,507425,Fischer-Grunski; Eva K,20,0,20,0
1713478432086,LIIT 5AS,A00,507427,Carnelos; Chiara,20,0,20,0
1713478433111,LIIT 5BS,A00,507430,Carnelos; Chiara,20,0,20,0
1713478434136,LIIT 5CS,A00,507432,Carnelos; Chiara,20,0,20,0
1713478435162,LISP 5A,A00,507541,Munoz Sanchez; Alicia,15,0,20,5
1713478436187,LISP 5B,A00,507671,Munoz Sanchez; Alicia,12,0,20,8
1713478437213,LISP 5C,A00,507696,Munoz Sanchez; Alicia,11,0,20,9
1713478438238,MAE 197,001,528363,Boechler; Nicholas Sebastia,9998,0,9999,1
1713478439268,MATH 197,001,523477,Kedlaya; Kiran S.,9999,0,9999,0
1713478439268,MATH 197,002,563811,Zhang; Danna,9998,0,9999,1
1713478440297,MCWP 40R,A00,518780,Staff,17,0,20,3
1713478440297,MCWP 40R,B00,518781,Staff,14,0,20,6
1713478440297,MCWP 40R,C00,518783,Staff,13,0,20,7
1713478441324,MCWP 50R,A00,518791,Staff,9,0,20,11
1713478441324,MCWP 50R,B00,518792,Staff,7,0,20,13
1713478441324,MCWP 50R,C00,518793,Staff,7,0,20,13
1713478441324,MCWP 50R,D00,518794,Staff,3,0,20,17
1713478441324,MCWP 50R,E00,518795,Staff,6,0,20,14
1713478441324,MCWP 50R,F00,518796,Staff,15,0,20,5
1713478441324,MCWP 50R,G00,518797,Staff,13,0,20,7
1713478442353,MMW 12R,A01,514034,Herbst; Matthew,9,0,16,7
1713478442353,MMW 12R,A02,514035,Herbst; Matthew,14,0,16,2
1713478443379,MMW 13R,A01,514037,Staff,0,0,16,16
1713478443379,MMW 13R,A02,514039,Staff,0,0,16,16
1713478445427,SIO 295LS,A00,523233,Staff,16,0,30,14
1713478446453,SIO 295S,A00,523232,Staff,16,0,30,14
1713478447476,SOCI 117,A01,494376,Staff,0,2,5,5
1713478448502,WES 237B,A00,494380,Staff,19,0,20,1
1713478450578,AESE 279B,A00,494370,Wade; Jon P,33,0,33,0
1713478451602,AIP 197,001,627712,Vespa; Emanuel Ignacio,9999,0,9999,0
1713478452631,ANAR 135S,A00,494369,Braswell; Geoffrey E.,0,0,0,0
1713478453660,CAT 124RS,A01,519847,Geibel; William,6,0,20,14
1713478454687,CAT 125RS,A01,515971,Geibel; William,6,0,20,14
1713478455716,CLRE 250,A00,511389,Morris; Sheldon,9996,0,9999,3
1713478456742,CLRE 251,A00,507176,Mehta; Ravindra L.,9996,0,9999,3
1713478456742,CLRE 251,B00,511410,Mehta; Ravindra L.,9998,0,9999,1
1713478457767,CLRE 252,A00,507189,Cuomo; Raphael Eduardo,9998,0,9999,1
1713478458794,CLRE 253,A00,507199,Vaida; Florin,9997,0,9999,2
1713478458794,CLRE 253,B00,507202,Vaida; Florin,9999,0,9999,0
1713478459819,CLRE 259,A00,507211,Patel; Hemal,9996,0,9999,3
1713478460846,CLRE 260,A00,507221,Cuomo; Raphael Eduardo,9999,0,9999,0
1713478461873,CLRE 297,001,507242,Cuomo; Raphael Eduardo,9999,0,9999,0
1713478462902,CSE 191,A00,516875,Minnes Kemp; Mor Mia,9999,0,9999,0
1713478463926,CSS 201S,A01,494383,Staff,35,0,35,0
1713478464955,CSS 202S,A01,494387,Staff,35,0,35,0
1713478465980,EAP 100,A00,516065,Staff,9792,0,9999,207
1713478467007,ECE 45,A01,507414,Staff,40,0,60,20
1713478468031,ECE 100,A01,507416,Baghdadchi; Saharnaz,3,0,20,17
1713478468031,ECE 100,A02,507418,Baghdadchi; Saharnaz,19,0,20,1
1713478469059,ECE 111,A01,507420,Staff,28,0,50,22
1713478470089,ECE 197,001,548057,Sievenpiper; Daniel F.,9998,0,9999,1
1713478471115,EDS 115,A00,507243,Choi; Bailey Miyeon,27,0,28,1
1713478472145,EDS 117,A01,494379,Staff,16,0,25,9
1713478473171,EDS 125,A00,507246,Hopkins; Megan Beth,28,0,30,2
1713478474198,EDS 128A,A01,507264,Fargason; Sharon Gayle,26,0,26,0
1713478475224,EDS 128B,A01,507293,Pappas; Elizabeth,30,0,30,0
1713478476250,EDS 139,A00,507294,Fargason; Sharon Gayle,30,0,30,0
1713478476250,EDS 139,B00,507313,Pappas; Elizabeth,30,0,30,0
1713478477279,EDS 201,A00,507315,Staff,19,0,30,11
1713478478308,EDS 203,A01,507317,Halter; Christopher P.,18,0,30,12
1713478479335,EDS 204R,A01,507319,Halter; Christopher P.,0,1,30,30
1713478479335,EDS 204R,B01,507331,Heinzman; Erica M.,26,0,30,4
1713478480361,EDS 206R,A00,507332,Staff,0,1,30,30
1713478480361,EDS 206R,B00,507343,Staff,27,0,30,3
1713478481389,EDS 250,A00,507344,Hemans; Patricia Ann Benitez,28,0,40,12
1713478482419,EDS 281,A00,507345,Daly; Alan J.,18,0,18,0
1713478483444,EDS 284,A00,507350,Daly; Alan J.,16,0,16,0
1713478484470,EDS 286,A00,507359,Fine; Sarah,18,0,18,0
1713478485499,EDS 289C,A01,507361,Daly; Alan J.,18,0,18,0
1713478486525,EDS 290,A00,507366,Hofstetter; Carolyn,15,0,15,0
1713478487552,LIGM 5A,A00,507421,Fischer-Grunski; Eva K,20,0,20,0
1713478488582,LIGM 5B,A00,507423,Fischer-Grunski; Eva K,20,0,20,0
1713478489607,LIGM 5C,A00,507425,Fischer-Grunski; Eva K,20,0,20,0
1713478490637,LIIT 5AS,A00,507427,Carnelos; Chiara,20,0,20,0
1713478491666,LIIT 5BS,A00,507430,Carnelos; Chiara,20,0,20,0
1713478492695,LIIT 5CS,A00,507432,Carnelos; Chiara,20,0,20,0
1713478493722,LISP 5A,A00,507541,Munoz Sanchez; Alicia,15,0,20,5
1713478494747,LISP 5B,A00,507671,Munoz Sanchez; Alicia,12,0,20,8
1713478495773,LISP 5C,A00,507696,Munoz Sanchez; Alicia,11,0,20,9
1713478496799,MAE 197,001,528363,Boechler; Nicholas Sebastia,9998,0,9999,1
1713478497826,MATH 197,001,523477,Kedlaya; Kiran S.,9999,0,9999,0
1713478497826,MATH 197,002,563811,Zhang; Danna,9998,0,9999,1
1713478498854,MCWP 40R,A00,518780,Staff,17,0,20,3
1713478498854,MCWP 40R,B00,518781,Staff,14,0,20,6
1713478498854,MCWP 40R,C00,518783,Staff,13,0,20,7
1713478499878,MCWP 50R,A00,518791,Staff,9,0,20,11
1713478499878,MCWP 50R,B00,518792,Staff,7,0,20,13
1713478499878,MCWP 50R,C00,518793,Staff,7,0,20,13
1713478499878,MCWP 50R,D00,518794,Staff,3,0,20,17
1713478499878,MCWP 50R,E00,518795,Staff,6,0,20,14
1713478499878,MCWP 50R,F00,518796,Staff,15,0,20,5
1713478499878,MCWP 50R,G00,518797,Staff,13,0,20,7
1713478500902,MMW 12R,A01,514034,Herbst; Matthew,9,0,16,7
1713478500902,MMW 12R,A02,514035,Herbst; Matthew,14,0,16,2
1713478501930,MMW 13R,A01,514037,Staff,0,0,16,16
1713478501930,MMW 13R,A02,514039,Staff,0,0,16,16
1713478503983,SIO 295LS,A00,523233,Staff,16,0,30,14
1713478505008,SIO 295S,A00,523232,Staff,16,0,30,14
1713478506087,SOCI 117,A01,494376,Staff,0,2,5,5
1713478507113,WES 237B,A00,494380,Staff,19,0,20,1
1713478509180,AESE 279B,A00,494370,Wade; Jon P,33,0,33,0
1713478510205,AIP 197,001,627712,Vespa; Emanuel Ignacio,9999,0,9999,0
1713478511230,ANAR 135S,A00,494369,Braswell; Geoffrey E.,0,0,0,0
1713478512255,CAT 124RS,A01,519847,Geibel; William,6,0,20,14
1713478513282,CAT 125RS,A01,515971,Geibel; William,6,0,20,14
1713478514308,CLRE 250,A00,511389,Morris; Sheldon,9996,0,9999,3
1713478515334,CLRE 251,A00,507176,Mehta; Ravindra L.,9996,0,9999,3
1713478515334,CLRE 251,B00,511410,Mehta; Ravindra L.,9998,0,9999,1
1713478516358,CLRE 252,A00,507189,Cuomo; Raphael Eduardo,9998,0,9999,1
1713478517384,CLRE 253,A00,507199,Vaida; Florin,9997,0,9999,2
1713478517384,CLRE 253,B00,507202,Vaida; Florin,9999,0,9999,0
1713478518409,CLRE 259,A00,507211,Patel; Hemal,9996,0,9999,3
1713478519435,CLRE 260,A00,507221,Cuomo; Raphael Eduardo,9999,0,9999,0
1713478520465,CLRE 297,001,507242,Cuomo; Raphael Eduardo,9999,0,9999,0
1713478521490,CSE 191,A00,516875,Minnes Kemp; Mor Mia,9999,0,9999,0
1713478522518,CSS 201S,A01,494383,Staff,35,0,35,0
1713478523542,CSS 202S,A01,494387,Staff,35,0,35,0
1713478524569,EAP 100,A00,516065,Staff,9792,0,9999,207
1713478525595,ECE 45,A01,507414,Staff,40,0,60,20
1713478526621,ECE 100,A01,507416,Baghdadchi; Saharnaz,3,0,20,17
1713478526621,ECE 100,A02,507418,Baghdadchi; Saharnaz,19,0,20,1
1713478527648,ECE 111,A01,507420,Staff,28,0,50,22
1713478528674,ECE 197,001,548057,Sievenpiper; Daniel F.,9998,0,9999,1
1713478529699,EDS 115,A00,507243,Choi; Bailey Miyeon,27,0,28,1
1713478530729,EDS 117,A01,494379,Staff,16,0,25,9
1713478531754,EDS 125,A00,507246,Hopkins; Megan Beth,28,0,30,2
1713478532779,EDS 128A,A01,507264,Fargason; Sharon Gayle,26,0,26,0
1713478533809,EDS 128B,A01,507293,Pappas; Elizabeth,30,0,30,0
1713478534836,EDS 139,A00,507294,Fargason; Sharon Gayle,30,0,30,0
1713478534836,EDS 139,B00,507313,Pappas; Elizabeth,30,0,30,0
1713478535865,EDS 201,A00,507315,Staff,19,0,30,11
1713478536895,EDS 203,A01,507317,Halter; Christopher P.,18,0,30,12
1713478537926,EDS 204R,A01,507319,Halter; Christopher P.,0,1,30,30
1713478537926,EDS 204R,B01,507331,Heinzman; Erica M.,26,0,30,4
1713478538956,EDS 206R,A00,507332,Staff,0,1,30,30
1713478538956,EDS 206R,B00,507343,Staff,27,0,30,3
1713478539982,EDS 250,A00,507344,Hemans; Patricia Ann Benitez,28,0,40,12
1713478541007,EDS 281,A00,507345,Daly; Alan J.,18,0,18,0
1713478542035,EDS 284,A00,507350,Daly; Alan J.,16,0,16,0
1713478543059,EDS 286,A00,507359,Fine; Sarah,18,0,18,0
1713478544084,EDS 289C,A01,507361,Daly; Alan J.,18,0,18,0
1713478545112,EDS 290,A00,507366,Hofstetter; Carolyn,15,0,15,0
1713478546141,LIGM 5A,A00,507421,Fischer-Grunski; Eva K,20,0,20,0
1713478547171,LIGM 5B,A00,507423,Fischer-Grunski; Eva K,20,0,20,0
1713478548199,LIGM 5C,A00,507425,Fischer-Grunski; Eva K,20,0,20,0
1713478549229,LIIT 5AS,A00,507427,Carnelos; Chiara,20,0,20,0
1713478550256,LIIT 5BS,A00,507430,Carnelos; Chiara,20,0,20,0
1713478551282,LIIT 5CS,A00,507432,Carnelos; Chiara,20,0,20,0
1713478552311,LISP 5A,A00,507541,Munoz Sanchez; Alicia,15,0,20,5
1713478553342,LISP 5B,A00,507671,Munoz Sanchez; Alicia,12,0,20,8
1713478554371,LISP 5C,A00,507696,Munoz Sanchez; Alicia,11,0,20,9
1713478555396,MAE 197,001,528363,Boechler; Nicholas Sebastia,9998,0,9999,1
1713478556423,MATH 197,001,523477,Kedlaya; Kiran S.,9999,0,9999,0
1713478556423,MATH 197,002,563811,Zhang; Danna,9998,0,9999,1
1713478557449,MCWP 40R,A00,518780,Staff,17,0,20,3
1713478557449,MCWP 40R,B00,518781,Staff,14,0,20,6
1713478557449,MCWP 40R,C00,518783,Staff,13,0,20,7
1713478558475,MCWP 50R,A00,518791,Staff,9,0,20,11
1713478558475,MCWP 50R,B00,518792,Staff,7,0,20,13
1713478558475,MCWP 50R,C00,518793,Staff,7,0,20,13
1713478558475,MCWP 50R,D00,518794,Staff,3,0,20,17
1713478558475,MCWP 50R,E00,518795,Staff,6,0,20,14
1713478558475,MCWP 50R,F00,518796,Staff,15,0,20,5
1713478558475,MCWP 50R,G00,518797,Staff,13,0,20,7
1713478559504,MMW 12R,A01,514034,Herbst; Matthew,9,0,16,7
1713478559504,MMW 12R,A02,514035,Herbst; Matthew,14,0,16,2
1713478560530,MMW 13R,A01,514037,Staff,0,0,16,16
1713478560530,MMW 13R,A02,514039,Staff,0,0,16,16
1713478562589,SIO 295LS,A00,523233,Staff,16,0,30,14
1713478563616,SIO 295S,A00,523232,Staff,16,0,30,14
1713478564642,SOCI 117,A01,494376,Staff,0,2,5,5
1713478565669,WES 237B,A00,494380,Staff,19,0,20,1
1713478567740,AESE 279B,A00,494370,Wade; Jon P,33,0,33,0
1713478568765,AIP 197,001,627712,Vespa; Emanuel Ignacio,9999,0,9999,0
1713478569791,ANAR 135S,A00,494369,Braswell; Geoffrey E.,0,0,0,0
1713478570820,CAT 124RS,A01,519847,Geibel; William,6,0,20,14
1713478571846,CAT 125RS,A01,515971,Geibel; William,6,0,20,14
1713478572871,CLRE 250,A00,511389,Morris; Sheldon,9996,0,9999,3
1713478573911,CLRE 251,A00,507176,Mehta; Ravindra L.,9996,0,9999,3
1713478573911,CLRE 251,B00,511410,Mehta; Ravindra L.,9998,0,9999,1
1713478574946,CLRE 252,A00,507189,Cuomo; Raphael Eduardo,9998,0,9999,1
1713478575973,CLRE 253,A00,507199,Vaida; Florin,9997,0,9999,2
1713478575973,CLRE 253,B00,507202,Vaida; Florin,9999,0,9999,0
1713478576999,CLRE 259,A00,507211,Patel; Hemal,9996,0,9999,3
1713478578028,CLRE 260,A00,507221,Cuomo; Raphael Eduardo,9999,0,9999,0
1713478579055,CLRE 297,001,507242,Cuomo; Raphael Eduardo,9999,0,9999,0
1713478580085,CSE 191,A00,516875,Minnes Kemp; Mor Mia,9999,0,9999,0
1713478581109,CSS 201S,A01,494383,Staff,35,0,35,0
1713478582135,CSS 202S,A01,494387,Staff,35,0,35,0
1713478583160,EAP 100,A00,516065,Staff,9792,0,9999,207
1713478584188,ECE 45,A01,507414,Staff,40,0,60,20
1713478585215,ECE 100,A01,507416,Baghdadchi; Saharnaz,3,0,20,17
1713478585215,ECE 100,A02,507418,Baghdadchi; Saharnaz,19,0,20,1
1713478586243,ECE 111,A01,507420,Staff,28,0,50,22
1713478587268,ECE 197,001,548057,Sievenpiper; Daniel F.,9998,0,9999,1
1713478588295,EDS 115,A00,507243,Choi; Bailey Miyeon,27,0,28,1
1713478589323,EDS 117,A01,494379,Staff,16,0,25,9
1713478590357,EDS 125,A00,507246,Hopkins; Megan Beth,28,0,30,2
1713478591384,EDS 128A,A01,507264,Fargason; Sharon Gayle,26,0,26,0
1713478592410,EDS 128B,A01,507293,Pappas; Elizabeth,30,0,30,0
1713478593435,EDS 139,A00,507294,Fargason; Sharon Gayle,30,0,30,0
1713478593435,EDS 139,B00,507313,Pappas; Elizabeth,30,0,30,0
1713478594462,EDS 201,A00,507315,Staff,19,0,30,11
1713478595491,EDS 203,A01,507317,Halter; Christopher P.,18,0,30,12
1713478596515,EDS 204R,A01,507319,Halter; Christopher P.,0,1,30,30
1713478596515,EDS 204R,B01,507331,Heinzman; Erica M.,26,0,30,4
1713478597541,EDS 206R,A00,507332,Staff,0,1,30,30
1713478597541,EDS 206R,B00,507343,Staff,27,0,30,3
1713478598564,EDS 250,A00,507344,Hemans; Patricia Ann Benitez,28,0,40,12
1713478599593,EDS 281,A00,507345,Daly; Alan J.,18,0,18,0
1713478600621,EDS 284,A00,507350,Daly; Alan J.,16,0,16,0
1713478601646,EDS 286,A00,507359,Fine; Sarah,18,0,18,0
1713478602671,EDS 289C,A01,507361,Daly; Alan J.,18,0,18,0
1713478603697,EDS 290,A00,507366,Hofstetter; Carolyn,15,0,15,0
1713478604726,LIGM 5A,A00,507421,Fischer-Grunski; Eva K,20,0,20,0
1713478605754,LIGM 5B,A00,507423,Fischer-Grunski; Eva K,20,0,20,0
1713478606779,LIGM 5C,A00,507425,Fischer-Grunski; Eva K,20,0,20,0
1713478607806,LIIT 5AS,A00,507427,Carnelos; Chiara,20,0,20,0
1713478608833,LIIT 5BS,A00,507430,Carnelos; Chiara,20,0,20,0
1713478609912,LIIT 5CS,A00,507432,Carnelos; Chiara,20,0,20,0
1713478610943,LISP 5A,A00,507541,Munoz Sanchez; Alicia,15,0,20,5
1713478611975,LISP 5B,A00,507671,Munoz Sanchez; Alicia,12,0,20,8
1713478613001,LISP 5C,A00,507696,Munoz Sanchez; Alicia,11,0,20,9
1713478614027,MAE 197,001,528363,Boechler; Nicholas Sebastia,9998,0,9999,1
1713478615065,MATH 197,001,523477,Kedlaya; Kiran S.,9999,0,9999,0
1713478615065,MATH 197,002,563811,Zhang; Danna,9998,0,9999,1
1713478616095,MCWP 40R,A00,518780,Staff,17,0,20,3
1713478616095,MCWP 40R,B00,518781,Staff,14,0,20,6
1713478616095,MCWP 40R,C00,518783,Staff,12,0,20,8
1713478617119,MCWP 50R,A00,518791,Staff,9,0,20,11
1713478617119,MCWP 50R,B00,518792,Staff,7,0,20,13
1713478617119,MCWP 50R,C00,518793,Staff,7,0,20,13
1713478617119,MCWP 50R,D00,518794,Staff,3,0,20,17
1713478617119,MCWP 50R,E00,518795,Staff,6,0,20,14
1713478617119,MCWP 50R,F00,518796,Staff,15,0,20,5
1713478617119,MCWP 50R,G00,518797,Staff,13,0,20,7
1713478618144,MMW 12R,A01,514034,Herbst; Matthew,9,0,16,7
1713478618144,MMW 12R,A02,514035,Herbst; Matthew,14,0,16,2
1713478619171,MMW 13R,A01,514037,Staff,0,0,16,16
1713478619171,MMW 13R,A02,514039,Staff,0,0,16,16
1713478621228,SIO 295LS,A00,523233,Staff,16,0,30,14
1713478622252,SIO 295S,A00,523232,Staff,16,0,30,14
1713478623281,SOCI 117,A01,494376,Staff,0,2,5,5
1713478624307,WES 237B,A00,494380,Staff,19,0,20,1
1713478626381,AESE 279B,A00,494370,Wade; Jon P,33,0,33,0
1713478627411,AIP 197,001,627712,Vespa; Emanuel Ignacio,9999,0,9999,0
1713478628440,ANAR 135S,A00,494369,Braswell; Geoffrey E.,0,0,0,0
1713478629467,CAT 124RS,A01,519847,Geibel; William,6,0,20,14
1713478630491,CAT 125RS,A01,515971,Geibel; William,6,0,20,14
1713478631518,CLRE 250,A00,511389,Morris; Sheldon,9996,0,9999,3
1713478632547,CLRE 251,A00,507176,Mehta; Ravindra L.,9996,0,9999,3
1713478632547,CLRE 251,B00,511410,Mehta; Ravindra L.,9998,0,9999,1
1713478633572,CLRE 252,A00,507189,Cuomo; Raphael Eduardo,9998,0,9999,1
1713478634597,CLRE 253,A00,507199,Vaida; Florin,9997,0,9999,2
1713478634597,CLRE 253,B00,507202,Vaida; Florin,9999,0,9999,0
1713478635621,CLRE 259,A00,507211,Patel; Hemal,9996,0,9999,3
1713478636648,CLRE 260,A00,507221,Cuomo; Raphael Eduardo,9999,0,9999,0
1713478637673,CLRE 297,001,507242,Cuomo; Raphael Eduardo,9999,0,9999,0
1713478638704,CSE 191,A00,516875,Minnes Kemp; Mor Mia,9999,0,9999,0
1713478639734,CSS 201S,A01,494383,Staff,35,0,35,0
1713478640760,CSS 202S,A01,494387,Staff,35,0,35,0
1713478641787,EAP 100,A00,516065,Staff,9792,0,9999,207
1713478642817,ECE 45,A01,507414,Staff,40,0,60,20
1713478643843,ECE 100,A01,507416,Baghdadchi; Saharnaz,3,0,20,17
1713478643843,ECE 100,A02,507418,Baghdadchi; Saharnaz,19,0,20,1
1713478644871,ECE 111,A01,507420,Staff,28,0,50,22
1713478645905,ECE 197,001,548057,Sievenpiper; Daniel F.,9998,0,9999,1
1713478646935,EDS 115,A00,507243,Choi; Bailey Miyeon,27,0,28,1
1713478647964,EDS 117,A01,494379,Staff,16,0,25,9
1713478648990,EDS 125,A00,507246,Hopkins; Megan Beth,28,0,30,2
1713478650019,EDS 128A,A01,507264,Fargason; Sharon Gayle,26,0,26,0
1713478651048,EDS 128B,A01,507293,Pappas; Elizabeth,30,0,30,0
1713478652072,EDS 139,A00,507294,Fargason; Sharon Gayle,30,0,30,0
1713478652072,EDS 139,B00,507313,Pappas; Elizabeth,30,0,30,0
1713478653097,EDS 201,A00,507315,Staff,19,0,30,11
1713478654131,EDS 203,A01,507317,Halter; Christopher P.,18,0,30,12
1713478655161,EDS 204R,A01,507319,Halter; Christopher P.,0,1,30,30
1713478655161,EDS 204R,B01,507331,Heinzman; Erica M.,26,0,30,4
1713478656186,EDS 206R,A00,507332,Staff,0,1,30,30
1713478656186,EDS 206R,B00,507343,Staff,27,0,30,3
1713478657212,EDS 250,A00,507344,Hemans; Patricia Ann Benitez,28,0,40,12
1713478658237,EDS 281,A00,507345,Daly; Alan J.,18,0,18,0
1713478659265,EDS 284,A00,507350,Daly; Alan J.,16,0,16,0
1713478660291,EDS 286,A00,507359,Fine; Sarah,18,0,18,0
1713478661318,EDS 289C,A01,507361,Daly; Alan J.,18,0,18,0
1713478662344,EDS 290,A00,507366,Hofstetter; Carolyn,15,0,15,0
1713478663371,LIGM 5A,A00,507421,Fischer-Grunski; Eva K,20,0,20,0
1713478664398,LIGM 5B,A00,507423,Fischer-Grunski; Eva K,20,0,20,0
1713478665424,LIGM 5C,A00,507425,Fischer-Grunski; Eva K,20,0,20,0
1713478666453,LIIT 5AS,A00,507427,Carnelos; Chiara,20,0,20,0
1713478667482,LIIT 5BS,A00,507430,Carnelos; Chiara,20,0,20,0
1713478668507,LIIT 5CS,A00,507432,Carnelos; Chiara,20,0,20,0
1713478669533,LISP 5A,A00,507541,Munoz Sanchez; Alicia,15,0,20,5
1713478670560,LISP 5B,A00,507671,Munoz Sanchez; Alicia,12,0,20,8
1713478671584,LISP 5C,A00,507696,Munoz Sanchez; Alicia,11,0,20,9
1713478672610,MAE 197,001,528363,Boechler; Nicholas Sebastia,9998,0,9999,1
1713478673636,MATH 197,001,523477,Kedlaya; Kiran S.,9999,0,9999,0
1713478673636,MATH 197,002,563811,Zhang; Danna,9998,0,9999,1
1713478674668,MCWP 40R,A00,518780,Staff,17,0,20,3
1713478674668,MCWP 40R,B00,518781,Staff,14,0,20,6
1713478674668,MCWP 40R,C00,518783,Staff,12,0,20,8
1713478675694,MCWP 50R,A00,518791,Staff,9,0,20,11
1713478675694,MCWP 50R,B00,518792,Staff,7,0,20,13
1713478675694,MCWP 50R,C00,518793,Staff,7,0,20,13
1713478675694,MCWP 50R,D00,518794,Staff,3,0,20,17
1713478675694,MCWP 50R,E00,518795,Staff,6,0,20,14
1713478675694,MCWP 50R,F00,518796,Staff,15,0,20,5
1713478675694,MCWP 50R,G00,518797,Staff,13,0,20,7
1713478676719,MMW 12R,A01,514034,Herbst; Matthew,9,0,16,7
1713478676719,MMW 12R,A02,514035,Herbst; Matthew,14,0,16,2
1713478677745,MMW 13R,A01,514037,Staff,0,0,16,16
1713478677745,MMW 13R,A02,514039,Staff,0,0,16,16
1713478679793,SIO 295LS,A00,523233,Staff,16,0,30,14
1713478680821,SIO 295S,A00,523232,Staff,16,0,30,14
1713478681850,SOCI 117,A01,494376,Staff,0,2,5,5
1713478682877,WES 237B,A00,494380,Staff,19,0,20,1
1713478684943,AESE 279B,A00,494370,Wade; Jon P,33,0,33,0
1713478685970,AIP 197,001,627712,Vespa; Emanuel Ignacio,9999,0,9999,0
1713478686998,ANAR 135S,A00,494369,Braswell; Geoffrey E.,0,0,0,0
1713478688025,CAT 124RS,A01,519847,Geibel; William,6,0,20,14
1713478689050,CAT 125RS,A01,515971,Geibel; William,6,0,20,14
1713478690077,CLRE 250,A00,511389,Morris; Sheldon,9996,0,9999,3
1713478691105,CLRE 251,A00,507176,Mehta; Ravindra L.,9996,0,9999,3
1713478691105,CLRE 251,B00,511410,Mehta; Ravindra L.,9998,0,9999,1
1713478692130,CLRE 252,A00,507189,Cuomo; Raphael Eduardo,9998,0,9999,1
1713478693155,CLRE 253,A00,507199,Vaida; Florin,9997,0,9999,2
1713478693155,CLRE 253,B00,507202,Vaida; Florin,9999,0,9999,0
1713478694188,CLRE 259,A00,507211,Patel; Hemal,9996,0,9999,3
1713478695213,CLRE 260,A00,507221,Cuomo; Raphael Eduardo,9999,0,9999,0
1713478696237,CLRE 297,001,507242,Cuomo; Raphael Eduardo,9999,0,9999,0
1713478697265,CSE 191,A00,516875,Minnes Kemp; Mor Mia,9999,0,9999,0
1713478698295,CSS 201S,A01,494383,Staff,35,0,35,0
1713478699321,CSS 202S,A01,494387,Staff,35,0,35,0
1713478700348,EAP 100,A00,516065,Staff,9792,0,9999,207
1713478701376,ECE 45,A01,507414,Staff,40,0,60,20
1713478702401,ECE 100,A01,507416,Baghdadchi; Saharnaz,3,0,20,17
1713478702401,ECE 100,A02,507418,Baghdadchi; Saharnaz,19,0,20,1
1713478703427,ECE 111,A01,507420,Staff,28,0,50,22
1713478704457,ECE 197,001,548057,Sievenpiper; Daniel F.,9998,0,9999,1
1713478705484,EDS 115,A00,507243,Choi; Bailey Miyeon,27,0,28,1
1713478706514,EDS 117,A01,494379,Staff,16,0,25,9
1713478707543,EDS 125,A00,507246,Hopkins; Megan Beth,28,0,30,2
1713478708571,EDS 128A,A01,507264,Fargason; Sharon Gayle,26,0,26,0
1713478709596,EDS 128B,A01,507293,Pappas; Elizabeth,30,0,30,0
1713478710625,EDS 139,A00,507294,Fargason; Sharon Gayle,30,0,30,0
1713478710625,EDS 139,B00,507313,Pappas; Elizabeth,30,0,30,0
1713478711649,EDS 201,A00,507315,Staff,19,0,30,11
1713478712675,EDS 203,A01,507317,Halter; Christopher P.,18,0,30,12
1713478713760,EDS 204R,A01,507319,Halter; Christopher P.,0,1,30,30
1713478713760,EDS 204R,B01,507331,Heinzman; Erica M.,26,0,30,4
1713478714788,EDS 206R,A00,507332,Staff,0,1,30,30
1713478714788,EDS 206R,B00,507343,Staff,27,0,30,3
1713478715814,EDS 250,A00,507344,Hemans; Patricia Ann Benitez,28,0,40,12
1713478716839,EDS 281,A00,507345,Daly; Alan J.,18,0,18,0
1713478717867,EDS 284,A00,507350,Daly; Alan J.,16,0,16,0
1713478718893,EDS 286,A00,507359,Fine; Sarah,18,0,18,0
1713478719921,EDS 289C,A01,507361,Daly; Alan J.,18,0,18,0
1713478720948,EDS 290,A00,507366,Hofstetter; Carolyn,15,0,15,0
1713478721973,LIGM 5A,A00,507421,Fischer-Grunski; Eva K,20,0,20,0
1713478722998,LIGM 5B,A00,507423,Fischer-Grunski; Eva K,20,0,20,0
1713478724023,LIGM 5C,A00,507425,Fischer-Grunski; Eva K,20,0,20,0
1713478725048,LIIT 5AS,A00,507427,Carnelos; Chiara,20,0,20,0
1713478726072,LIIT 5BS,A00,507430,Carnelos; Chiara,20,0,20,0
1713478727099,LIIT 5CS,A00,507432,Carnelos; Chiara,20,0,20,0
1713478728126,LISP 5A,A00,507541,Munoz Sanchez; Alicia,15,0,20,5
1713478729154,LISP 5B,A00,507671,Munoz Sanchez; Alicia,12,0,20,8
1713478730178,LISP 5C,A00,507696,Munoz Sanchez; Alicia,11,0,20,9
1713478731202,MAE 197,001,528363,Boechler; Nicholas Sebastia,9998,0,9999,1
1713478732228,MATH 197,001,523477,Kedlaya; Kiran S.,9999,0,9999,0
1713478732228,MATH 197,002,563811,Zhang; Danna,9998,0,9999,1
1713478733253,MCWP 40R,A00,518780,Staff,17,0,20,3
1713478733253,MCWP 40R,B00,518781,Staff,14,0,20,6
1713478733253,MCWP 40R,C00,518783,Staff,12,0,20,8
1713478734282,MCWP 50R,A00,518791,Staff,9,0,20,11
1713478734282,MCWP 50R,B00,518792,Staff,7,0,20,13
1713478734282,MCWP 50R,C00,518793,Staff,7,0,20,13
1713478734282,MCWP 50R,D00,518794,Staff,3,0,20,17
1713478734282,MCWP 50R,E00,518795,Staff,6,0,20,14
1713478734282,MCWP 50R,F00,518796,Staff,15,0,20,5
1713478734282,MCWP 50R,G00,518797,Staff,13,0,20,7
1713478735312,MMW 12R,A01,514034,Herbst; Matthew,9,0,16,7
1713478735312,MMW 12R,A02,514035,Herbst; Matthew,14,0,16,2
1713478736340,MMW 13R,A01,514037,Staff,0,0,16,16
1713478736340,MMW 13R,A02,514039,Staff,0,0,16,16
1713478738390,SIO 295LS,A00,523233,Staff,16,0,30,14
1713478739418,SIO 295S,A00,523232,Staff,16,0,30,14
1713478740445,SOCI 117,A01,494376,Staff,0,2,5,5
1713478741470,WES 237B,A00,494380,Staff,19,0,20,1
1713478743541,AESE 279B,A00,494370,Wade; Jon P,33,0,33,0
1713478744566,AIP 197,001,627712,Vespa; Emanuel Ignacio,9999,0,9999,0
1713478745592,ANAR 135S,A00,494369,Braswell; Geoffrey E.,0,0,0,0
1713478746618,CAT 124RS,A01,519847,Geibel; William,6,0,20,14
1713478747642,CAT 125RS,A01,515971,Geibel; William,6,0,20,14
1713478748668,CLRE 250,A00,511389,Morris; Sheldon,9996,0,9999,3
1713478749700,CLRE 251,A00,507176,Mehta; Ravindra L.,9996,0,9999,3
1713478749700,CLRE 251,B00,511410,Mehta; Ravindra L.,9998,0,9999,1
1713478750733,CLRE 252,A00,507189,Cuomo; Raphael Eduardo,9998,0,9999,1
1713478751762,CLRE 253,A00,507199,Vaida; Florin,9997,0,9999,2
1713478751762,CLRE 253,B00,507202,Vaida; Florin,9999,0,9999,0
1713478752787,CLRE 259,A00,507211,Patel; Hemal,9996,0,9999,3
1713478753815,CLRE 260,A00,507221,Cuomo; Raphael Eduardo,9999,0,9999,0
1713478754843,CLRE 297,001,507242,Cuomo; Raphael Eduardo,9999,0,9999,0
1713478755867,CSE 191,A00,516875,Minnes Kemp; Mor Mia,9999,0,9999,0
1713478756895,CSS 201S,A01,494383,Staff,35,0,35,0
1713478757920,CSS 202S,A01,494387,Staff,35,0,35,0
1713478758944,EAP 100,A00,516065,Staff,9792,0,9999,207
1713478759969,ECE 45,A01,507414,Staff,40,0,60,20
1713478760998,ECE 100,A01,507416,Baghdadchi; Saharnaz,3,0,20,17
1713478760998,ECE 100,A02,507418,Baghdadchi; Saharnaz,19,0,20,1
1713478762030,ECE 111,A01,507420,Staff,28,0,50,22
1713478763058,ECE 197,001,548057,Sievenpiper; Daniel F.,9998,0,9999,1
1713478764087,EDS 115,A00,507243,Choi; Bailey Miyeon,27,0,28,1
1713478765116,EDS 117,A01,494379,Staff,16,0,25,9
1713478766142,EDS 125,A00,507246,Hopkins; Megan Beth,28,0,30,2
1713478767169,EDS 128A,A01,507264,Fargason; Sharon Gayle,26,0,26,0
1713478768195,EDS 128B,A01,507293,Pappas; Elizabeth,30,0,30,0
1713478769220,EDS 139,A00,507294,Fargason; Sharon Gayle,30,0,30,0
1713478769220,EDS 139,B00,507313,Pappas; Elizabeth,30,0,30,0
1713478770248,EDS 201,A00,507315,Staff,19,0,30,11
1713478771273,EDS 203,A01,507317,Halter; Christopher P.,18,0,30,12
1713478772298,EDS 204R,A01,507319,Halter; Christopher P.,0,1,30,30
1713478772298,EDS 204R,B01,507331,Heinzman; Erica M.,26,0,30,4
1713478773327,EDS 206R,A00,507332,Staff,0,1,30,30
1713478773327,EDS 206R,B00,507343,Staff,27,0,30,3
1713478774352,EDS 250,A00,507344,Hemans; Patricia Ann Benitez,28,0,40,12
1713478775382,EDS 281,A00,507345,Daly; Alan J.,18,0,18,0
1713478776409,EDS 284,A00,507350,Daly; Alan J.,16,0,16,0
1713478777433,EDS 286,A00,507359,Fine; Sarah,18,0,18,0
1713478778461,EDS 289C,A01,507361,Daly; Alan J.,18,0,18,0
1713478779487,EDS 290,A00,507366,Hofstetter; Carolyn,15,0,15,0
1713478780519,LIGM 5A,A00,507421,Fischer-Grunski; Eva K,20,0,20,0
1713478781548,LIGM 5B,A00,507423,Fischer-Grunski; Eva K,20,0,20,0
1713478782573,LIGM 5C,A00,507425,Fischer-Grunski; Eva K,20,0,20,0
1713478783597,LIIT 5AS,A00,507427,Carnelos; Chiara,20,0,20,0
1713478784623,LIIT 5BS,A00,507430,Carnelos; Chiara,20,0,20,0
1713478785649,LIIT 5CS,A00,507432,Carnelos; Chiara,20,0,20,0
1713478786677,LISP 5A,A00,507541,Munoz Sanchez; Alicia,15,0,20,5
1713478787703,LISP 5B,A00,507671,Munoz Sanchez; Alicia,12,0,20,8
1713478788732,LISP 5C,A00,507696,Munoz Sanchez; Alicia,11,0,20,9
1713478789761,MAE 197,001,528363,Boechler; Nicholas Sebastia,9998,0,9999,1
1713478790794,MATH 197,001,523477,Kedlaya; Kiran S.,9999,0,9999,0
1713478790794,MATH 197,002,563811,Zhang; Danna,9998,0,9999,1
1713478791897,MCWP 40R,A00,518780,Staff,17,0,20,3
1713478791897,MCWP 40R,B00,518781,Staff,14,0,20,6
1713478791897,MCWP 40R,C00,518783,Staff,12,0,20,8
1713478792926,MCWP 50R,A00,518791,Staff,9,0,20,11
1713478792926,MCWP 50R,B00,518792,Staff,7,0,20,13
1713478792926,MCWP 50R,C00,518793,Staff,7,0,20,13
1713478792926,MCWP 50R,D00,518794,Staff,3,0,20,17
1713478792926,MCWP 50R,E00,518795,Staff,5,0,20,15
1713478792926,MCWP 50R,F00,518796,Staff,15,0,20,5
1713478792926,MCWP 50R,G00,518797,Staff,13,0,20,7
1713478793951,MMW 12R,A01,514034,Herbst; Matthew,9,0,16,7
1713478793951,MMW 12R,A02,514035,Herbst; Matthew,14,0,16,2
1713478794975,MMW 13R,A01,514037,Staff,0,0,16,16
1713478794975,MMW 13R,A02,514039,Staff,0,0,16,16
1713478797027,SIO 295LS,A00,523233,Staff,16,0,30,14
1713478798055,SIO 295S,A00,523232,Staff,16,0,30,14
1713478799080,SOCI 117,A01,494376,Staff,0,2,5,5
1713478800213,WES 237B,A00,494380,Staff,19,0,20,1
1713478802284,AESE 279B,A00,494370,Wade; Jon P,33,0,33,0
1713478803312,AIP 197,001,627712,Vespa; Emanuel Ignacio,9999,0,9999,0
1713478804337,ANAR 135S,A00,494369,Braswell; Geoffrey E.,0,0,0,0
1713478805361,CAT 124RS,A01,519847,Geibel; William,6,0,20,14
1713478806386,CAT 125RS,A01,515971,Geibel; William,6,0,20,14
1713478807410,CLRE 250,A00,511389,Morris; Sheldon,9996,0,9999,3
1713478808436,CLRE 251,A00,507176,Mehta; Ravindra L.,9996,0,9999,3
1713478808436,CLRE 251,B00,511410,Mehta; Ravindra L.,9998,0,9999,1
1713478809465,CLRE 252,A00,507189,Cuomo; Raphael Eduardo,9998,0,9999,1
1713478810489,CLRE 253,A00,507199,Vaida; Florin,9997,0,9999,2
1713478810489,CLRE 253,B00,507202,Vaida; Florin,9999,0,9999,0
1713478811515,CLRE 259,A00,507211,Patel; Hemal,9996,0,9999,3
1713478812540,CLRE 260,A00,507221,Cuomo; Raphael Eduardo,9999,0,9999,0
1713478813566,CLRE 297,001,507242,Cuomo; Raphael Eduardo,9999,0,9999,0
1713478814591,CSE 191,A00,516875,Minnes Kemp; Mor Mia,9999,0,9999,0
1713478815617,CSS 201S,A01,494383,Staff,35,0,35,0
1713478816652,CSS 202S,A01,494387,Staff,35,0,35,0
1713478817736,EAP 100,A00,516065,Staff,9792,0,9999,207
1713478818765,ECE 45,A01,507414,Staff,40,0,60,20
1713478819791,ECE 100,A01,507416,Baghdadchi; Saharnaz,3,0,20,17
1713478819791,ECE 100,A02,507418,Baghdadchi; Saharnaz,19,0,20,1
1713478820815,ECE 111,A01,507420,Staff,28,0,50,22
1713478821848,ECE 197,001,548057,Sievenpiper; Daniel F.,9998,0,9999,1
1713478822877,EDS 115,A00,507243,Choi; Bailey Miyeon,27,0,28,1
1713478823905,EDS 117,A01,494379,Staff,16,0,25,9
1713478824931,EDS 125,A00,507246,Hopkins; Megan Beth,28,0,30,2
1713478825957,EDS 128A,A01,507264,Fargason; Sharon Gayle,26,0,26,0
1713478826984,EDS 128B,A01,507293,Pappas; Elizabeth,30,0,30,0
1713478828015,EDS 139,A00,507294,Fargason; Sharon Gayle,30,0,30,0
1713478828015,EDS 139,B00,507313,Pappas; Elizabeth,30,0,30,0
1713478829040,EDS 201,A00,507315,Staff,19,0,30,11
1713478830067,EDS 203,A01,507317,Halter; Christopher P.,18,0,30,12
1713478831097,EDS 204R,A01,507319,Halter; Christopher P.,0,1,30,30
1713478831097,EDS 204R,B01,507331,Heinzman; Erica M.,26,0,30,4
1713478832123,EDS 206R,A00,507332,Staff,0,1,30,30
1713478832123,EDS 206R,B00,507343,Staff,27,0,30,3
1713478833151,EDS 250,A00,507344,Hemans; Patricia Ann Benitez,28,0,40,12
1713478834176,EDS 281,A00,507345,Daly; Alan J.,18,0,18,0
1713478835200,EDS 284,A00,507350,Daly; Alan J.,16,0,16,0
1713478836225,EDS 286,A00,507359,Fine; Sarah,18,0,18,0
1713478837251,EDS 289C,A01,507361,Daly; Alan J.,18,0,18,0
1713478838277,EDS 290,A00,507366,Hofstetter; Carolyn,15,0,15,0
1713478839307,LIGM 5A,A00,507421,Fischer-Grunski; Eva K,20,0,20,0
1713478840332,LIGM 5B,A00,507423,Fischer-Grunski; Eva K,20,0,20,0
1713478841360,LIGM 5C,A00,507425,Fischer-Grunski; Eva K,20,0,20,0
1713478842392,LIIT 5AS,A00,507427,Carnelos; Chiara,20,0,20,0
1713478843419,LIIT 5BS,A00,507430,Carnelos; Chiara,20,0,20,0
1713478844444,LIIT 5CS,A00,507432,Carnelos; Chiara,20,0,20,0
1713478845469,LISP 5A,A00,507541,Munoz Sanchez; Alicia,15,0,20,5
1713478846500,LISP 5B,A00,507671,Munoz Sanchez; Alicia,12,0,20,8
1713478847527,LISP 5C,A00,507696,Munoz Sanchez; Alicia,11,0,20,9
1713478848555,MAE 197,001,528363,Boechler; Nicholas Sebastia,9998,0,9999,1
1713478849581,MATH 197,001,523477,Kedlaya; Kiran S.,9999,0,9999,0
1713478849581,MATH 197,002,563811,Zhang; Danna,9998,0,9999,1
1713478850608,MCWP 40R,A00,518780,Staff,17,0,20,3
1713478850608,MCWP 40R,B00,518781,Staff,14,0,20,6
1713478850608,MCWP 40R,C00,518783,Staff,12,0,20,8
1713478851634,MCWP 50R,A00,518791,Staff,9,0,20,11
1713478851634,MCWP 50R,B00,518792,Staff,7,0,20,13
1713478851634,MCWP 50R,C00,518793,Staff,7,0,20,13
1713478851634,MCWP 50R,D00,518794,Staff,3,0,20,17
1713478851634,MCWP 50R,E00,518795,Staff,5,0,20,15
1713478851634,MCWP 50R,F00,518796,Staff,15,0,20,5
1713478851634,MCWP 50R,G00,518797,Staff,13,0,20,7
1713478852659,MMW 12R,A01,514034,Herbst; Matthew,9,0,16,7
1713478852659,MMW 12R,A02,514035,Herbst; Matthew,14,0,16,2
1713478853684,MMW 13R,A01,514037,Staff,0,0,16,16
1713478853684,MMW 13R,A02,514039,Staff,0,0,16,16
1713478855740,SIO 295LS,A00,523233,Staff,16,0,30,14
1713478856766,SIO 295S,A00,523232,Staff,16,0,30,14
1713478857803,SOCI 117,A01,494376,Staff,0,2,5,5
1713478858831,WES 237B,A00,494380,Staff,19,0,20,1
1713478860899,AESE 279B,A00,494370,Wade; Jon P,33,0,33,0
1713478861924,AIP 197,001,627712,Vespa; Emanuel Ignacio,9999,0,9999,0
1713478862950,ANAR 135S,A00,494369,Braswell; Geoffrey E.,0,0,0,0
1713478863975,CAT 124RS,A01,519847,Geibel; William,6,0,20,14
1713478865006,CAT 125RS,A01,515971,Geibel; William,6,0,20,14
1713478876353,CLRE 250,A00,511389,Morris; Sheldon,9996,0,9999,3
1713478877397,CLRE 251,A00,507176,Mehta; Ravindra L.,9996,0,9999,3
1713478877397,CLRE 251,B00,511410,Mehta; Ravindra L.,9998,0,9999,1
1713478878424,CLRE 252,A00,507189,Cuomo; Raphael Eduardo,9998,0,9999,1
1713478879449,CLRE 253,A00,507199,Vaida; Florin,9997,0,9999,2
1713478879449,CLRE 253,B00,507202,Vaida; Florin,9999,0,9999,0
1713478880473,CLRE 259,A00,507211,Patel; Hemal,9996,0,9999,3
1713478881501,CLRE 260,A00,507221,Cuomo; Raphael Eduardo,9999,0,9999,0
1713478882529,CLRE 297,001,507242,Cuomo; Raphael Eduardo,9999,0,9999,0
1713478883554,CSE 191,A00,516875,Minnes Kemp; Mor Mia,9999,0,9999,0
1713478884581,CSS 201S,A01,494383,Staff,35,0,35,0
1713478885606,CSS 202S,A01,494387,Staff,35,0,35,0
1713478886632,EAP 100,A00,516065,Staff,9792,0,9999,207
1713478887664,ECE 45,A01,507414,Staff,40,0,60,20
1713478888689,ECE 100,A01,507416,Baghdadchi; Saharnaz,3,0,20,17
1713478888689,ECE 100,A02,507418,Baghdadchi; Saharnaz,19,0,20,1
1713478889715,ECE 111,A01,507420,Staff,28,0,50,22
1713478890745,ECE 197,001,548057,Sievenpiper; Daniel F.,9998,0,9999,1
1713478891773,EDS 115,A00,507243,Choi; Bailey Miyeon,27,0,28,1
1713478892800,EDS 117,A01,494379,Staff,16,0,25,9
1713478893828,EDS 125,A00,507246,Hopkins; Megan Beth,28,0,30,2
1713478894854,EDS 128A,A01,507264,Fargason; Sharon Gayle,26,0,26,0
1713478895879,EDS 128B,A01,507293,Pappas; Elizabeth,30,0,30,0
1713478896911,EDS 139,A00,507294,Fargason; Sharon Gayle,30,0,30,0
1713478896911,EDS 139,B00,507313,Pappas; Elizabeth,30,0,30,0
1713478897937,EDS 201,A00,507315,Staff,19,0,30,11
1713478898962,EDS 203,A01,507317,Halter; Christopher P.,18,0,30,12
1713478899991,EDS 204R,A01,507319,Halter; Christopher P.,0,1,30,30
1713478899991,EDS 204R,B01,507331,Heinzman; Erica M.,26,0,30,4
1713478901019,EDS 206R,A00,507332,Staff,0,1,30,30
1713478901019,EDS 206R,B00,507343,Staff,27,0,30,3
1713478902044,EDS 250,A00,507344,Hemans; Patricia Ann Benitez,28,0,40,12
1713478903068,EDS 281,A00,507345,Daly; Alan J.,18,0,18,0
1713478904091,EDS 284,A00,507350,Daly; Alan J.,16,0,16,0
1713478905121,EDS 286,A00,507359,Fine; Sarah,18,0,18,0
1713478906148,EDS 289C,A01,507361,Daly; Alan J.,18,0,18,0
1713478907177,EDS 290,A00,507366,Hofstetter; Carolyn,15,0,15,0
1713478908204,LIGM 5A,A00,507421,Fischer-Grunski; Eva K,20,0,20,0
1713478909232,LIGM 5B,A00,507423,Fischer-Grunski; Eva K,20,0,20,0
1713478910266,LIGM 5C,A00,507425,Fischer-Grunski; Eva K,20,0,20,0
1713478911290,LIIT 5AS,A00,507427,Carnelos; Chiara,20,0,20,0
1713478912320,LIIT 5BS,A00,507430,Carnelos; Chiara,20,0,20,0
1713478913345,LIIT 5CS,A00,507432,Carnelos; Chiara,20,0,20,0
1713478914371,LISP 5A,A00,507541,Munoz Sanchez; Alicia,15,0,20,5
1713478915397,LISP 5B,A00,507671,Munoz Sanchez; Alicia,12,0,20,8
1713478916422,LISP 5C,A00,507696,Munoz Sanchez; Alicia,11,0,20,9
1713478917448,MAE 197,001,528363,Boechler; Nicholas Sebastia,9998,0,9999,1
1713478918478,MATH 197,001,523477,Kedlaya; Kiran S.,9999,0,9999,0
1713478918478,MATH 197,002,563811,Zhang; Danna,9998,0,9999,1
1713478919504,MCWP 40R,A00,518780,Staff,17,0,20,3
1713478919504,MCWP 40R,B00,518781,Staff,14,0,20,6
1713478919504,MCWP 40R,C00,518783,Staff,12,0,20,8
1713478920532,MCWP 50R,A00,518791,Staff,9,0,20,11
1713478920532,MCWP 50R,B00,518792,Staff,7,0,20,13
1713478920532,MCWP 50R,C00,518793,Staff,7,0,20,13
1713478920532,MCWP 50R,D00,518794,Staff,3,0,20,17
1713478920532,MCWP 50R,E00,518795,Staff,5,0,20,15
1713478920532,MCWP 50R,F00,518796,Staff,15,0,20,5
1713478920532,MCWP 50R,G00,518797,Staff,13,0,20,7
1713478921561,MMW 12R,A01,514034,Herbst; Matthew,9,0,16,7
1713478921561,MMW 12R,A02,514035,Herbst; Matthew,14,0,16,2
1713478922587,MMW 13R,A01,514037,Staff,0,0,16,16
1713478922587,MMW 13R,A02,514039,Staff,0,0,16,16
1713478924642,SIO 295LS,A00,523233,Staff,16,0,30,14
1713478925667,SIO 295S,A00,523232,Staff,16,0,30,14
1713478926698,SOCI 117,A01,494376,Staff,0,2,5,5
1713478927724,WES 237B,A00,494380,Staff,19,0,20,1
1713478929805,AESE 279B,A00,494370,Wade; Jon P,33,0,33,0
1713478930830,AIP 197,001,627712,Vespa; Emanuel Ignacio,9999,0,9999,0
1713478931930,ANAR 135S,A00,494369,Braswell; Geoffrey E.,0,0,0,0
1713478932956,CAT 124RS,A01,519847,Geibel; William,6,0,20,14
1713478933984,CAT 125RS,A01,515971,Geibel; William,6,0,20,14
1713478935008,CLRE 250,A00,511389,Morris; Sheldon,9996,0,9999,3
1713478936036,CLRE 251,A00,507176,Mehta; Ravindra L.,9996,0,9999,3
1713478936036,CLRE 251,B00,511410,Mehta; Ravindra L.,9998,0,9999,1
1713478937062,CLRE 252,A00,507189,Cuomo; Raphael Eduardo,9998,0,9999,1
1713478938090,CLRE 253,A00,507199,Vaida; Florin,9997,0,9999,2
1713478938090,CLRE 253,B00,507202,Vaida; Florin,9999,0,9999,0
1713478939130,CLRE 259,A00,507211,Patel; Hemal,9996,0,9999,3
1713478940176,CLRE 260,A00,507221,Cuomo; Raphael Eduardo,9999,0,9999,0
1713478941201,CLRE 297,001,507242,Cuomo; Raphael Eduardo,9999,0,9999,0
1713478942228,CSE 191,A00,516875,Minnes Kemp; Mor Mia,9999,0,9999,0
1713478943254,CSS 201S,A01,494383,Staff,35,0,35,0
1713478944285,CSS 202S,A01,494387,Staff,35,0,35,0
1713478945310,EAP 100,A00,516065,Staff,9792,0,9999,207
1713478946338,ECE 45,A01,507414,Staff,40,0,60,20
1713478947367,ECE 100,A01,507416,Baghdadchi; Saharnaz,3,0,20,17
1713478947367,ECE 100,A02,507418,Baghdadchi; Saharnaz,19,0,20,1
1713478948395,ECE 111,A01,507420,Staff,28,0,50,22
1713478949425,ECE 197,001,548057,Sievenpiper; Daniel F.,9998,0,9999,1
1713478950466,EDS 115,A00,507243,Choi; Bailey Miyeon,27,0,28,1
1713478951492,EDS 117,A01,494379,Staff,16,0,25,9
1713478952522,EDS 125,A00,507246,Hopkins; Megan Beth,28,0,30,2
1713478953549,EDS 128A,A01,507264,Fargason; Sharon Gayle,26,0,26,0
1713478954575,EDS 128B,A01,507293,Pappas; Elizabeth,30,0,30,0
1713478955601,EDS 139,A00,507294,Fargason; Sharon Gayle,30,0,30,0
1713478955601,EDS 139,B00,507313,Pappas; Elizabeth,30,0,30,0
1713478956627,EDS 201,A00,507315,Staff,19,0,30,11
1713478957652,EDS 203,A01,507317,Halter; Christopher P.,18,0,30,12
1713478958678,EDS 204R,A01,507319,Halter; Christopher P.,0,1,30,30
1713478958678,EDS 204R,B01,507331,Heinzman; Erica M.,26,0,30,4
1713478959704,EDS 206R,A00,507332,Staff,0,1,30,30
1713478959704,EDS 206R,B00,507343,Staff,27,0,30,3
1713478960730,EDS 250,A00,507344,Hemans; Patricia Ann Benitez,28,0,40,12
1713478961755,EDS 281,A00,507345,Daly; Alan J.,18,0,18,0
1713478962783,EDS 284,A00,507350,Daly; Alan J.,16,0,16,0
1713478963809,EDS 286,A00,507359,Fine; Sarah,18,0,18,0
1713478964837,EDS 289C,A01,507361,Daly; Alan J.,18,0,18,0
1713478965865,EDS 290,A00,507366,Hofstetter; Carolyn,15,0,15,0
1713478966896,LIGM 5A,A00,507421,Fischer-Grunski; Eva K,20,0,20,0
1713478967925,LIGM 5B,A00,507423,Fischer-Grunski; Eva K,20,0,20,0
1713478968955,LIGM 5C,A00,507425,Fischer-Grunski; Eva K,20,0,20,0
1713478969980,LIIT 5AS,A00,507427,Carnelos; Chiara,20,0,20,0
1713478971006,LIIT 5BS,A00,507430,Carnelos; Chiara,20,0,20,0
1713478972031,LIIT 5CS,A00,507432,Carnelos; Chiara,20,0,20,0
1713478973057,LISP 5A,A00,507541,Munoz Sanchez; Alicia,15,0,20,5
1713478974085,LISP 5B,A00,507671,Munoz Sanchez; Alicia,12,0,20,8
1713478975112,LISP 5C,A00,507696,Munoz Sanchez; Alicia,11,0,20,9
1713478976140,MAE 197,001,528363,Boechler; Nicholas Sebastia,9998,0,9999,1
1713478977171,MATH 197,001,523477,Kedlaya; Kiran S.,9999,0,9999,0
1713478977171,MATH 197,002,563811,Zhang; Danna,9998,0,9999,1
1713478978196,MCWP 40R,A00,518780,Staff,17,0,20,3
1713478978196,MCWP 40R,B00,518781,Staff,14,0,20,6
1713478978196,MCWP 40R,C00,518783,Staff,12,0,20,8
1713478979225,MCWP 50R,A00,518791,Staff,9,0,20,11
1713478979225,MCWP 50R,B00,518792,Staff,7,0,20,13
1713478979225,MCWP 50R,C00,518793,Staff,7,0,20,13
1713478979225,MCWP 50R,D00,518794,Staff,3,0,20,17
1713478979225,MCWP 50R,E00,518795,Staff,5,0,20,15
1713478979225,MCWP 50R,F00,518796,Staff,15,0,20,5
1713478979225,MCWP 50R,G00,518797,Staff,13,0,20,7
1713478980252,MMW 12R,A01,514034,Herbst; Matthew,9,0,16,7
1713478980252,MMW 12R,A02,514035,Herbst; Matthew,14,0,16,2
1713478981281,MMW 13R,A01,514037,Staff,0,0,16,16
1713478981281,MMW 13R,A02,514039,Staff,0,0,16,16
1713478983336,SIO 295LS,A00,523233,Staff,16,0,30,14
1713478984361,SIO 295S,A00,523232,Staff,16,0,30,14
1713478985388,SOCI 117,A01,494376,Staff,0,2,5,5
1713478986413,WES 237B,A00,494380,Staff,19,0,20,1
1713478988491,AESE 279B,A00,494370,Wade; Jon P,33,0,33,0
1713478989517,AIP 197,001,627712,Vespa; Emanuel Ignacio,9999,0,9999,0
1713478990553,ANAR 135S,A00,494369,Braswell; Geoffrey E.,0,0,0,0
1713478991583,CAT 124RS,A01,519847,Geibel; William,6,0,20,14
1713478992607,CAT 125RS,A01,515971,Geibel; William,6,0,20,14
1713478993636,CLRE 250,A00,511389,Morris; Sheldon,9996,0,9999,3
1713478994663,CLRE 251,A00,507176,Mehta; Ravindra L.,9996,0,9999,3
1713478994663,CLRE 251,B00,511410,Mehta; Ravindra L.,9998,0,9999,1
1713478995693,CLRE 252,A00,507189,Cuomo; Raphael Eduardo,9998,0,9999,1
1713478996719,CLRE 253,A00,507199,Vaida; Florin,9997,0,9999,2
1713478996719,CLRE 253,B00,507202,Vaida; Florin,9999,0,9999,0
1713478997750,CLRE 259,A00,507211,Patel; Hemal,9996,0,9999,3
1713478998778,CLRE 260,A00,507221,Cuomo; Raphael Eduardo,9999,0,9999,0
1713478999807,CLRE 297,001,507242,Cuomo; Raphael Eduardo,9999,0,9999,0
1713479000831,CSE 191,A00,516875,Minnes Kemp; Mor Mia,9999,0,9999,0
1713479001858,CSS 201S,A01,494383,Staff,35,0,35,0
1713479002884,CSS 202S,A01,494387,Staff,35,0,35,0
1713479003913,EAP 100,A00,516065,Staff,9792,0,9999,207
1713479004939,ECE 45,A01,507414,Staff,40,0,60,20
1713479005965,ECE 100,A01,507416,Baghdadchi; Saharnaz,3,0,20,17
1713479005965,ECE 100,A02,507418,Baghdadchi; Saharnaz,19,0,20,1
1713479006994,ECE 111,A01,507420,Staff,28,0,50,22
1713479008021,ECE 197,001,548057,Sievenpiper; Daniel F.,9998,0,9999,1
1713479009048,EDS 115,A00,507243,Choi; Bailey Miyeon,27,0,28,1
1713479010074,EDS 117,A01,494379,Staff,16,0,25,9
1713479011100,EDS 125,A00,507246,Hopkins; Megan Beth,28,0,30,2
1713479012126,EDS 128A,A01,507264,Fargason; Sharon Gayle,26,0,26,0
1713479013151,EDS 128B,A01,507293,Pappas; Elizabeth,30,0,30,0
1713479014182,EDS 139,A00,507294,Fargason; Sharon Gayle,30,0,30,0
1713479014182,EDS 139,B00,507313,Pappas; Elizabeth,30,0,30,0
1713479015210,EDS 201,A00,507315,Staff,19,0,30,11
1713479016236,EDS 203,A01,507317,Halter; Christopher P.,18,0,30,12
1713479017264,EDS 204R,A01,507319,Halter; Christopher P.,0,1,30,30
1713479017264,EDS 204R,B01,507331,Heinzman; Erica M.,26,0,30,4
1713479018291,EDS 206R,A00,507332,Staff,0,1,30,30
1713479018291,EDS 206R,B00,507343,Staff,27,0,30,3
1713479019316,EDS 250,A00,507344,Hemans; Patricia Ann Benitez,28,0,40,12
1713479020346,EDS 281,A00,507345,Daly; Alan J.,18,0,18,0
1713479021375,EDS 284,A00,507350,Daly; Alan J.,16,0,16,0
1713479022401,EDS 286,A00,507359,Fine; Sarah,18,0,18,0
1713479023429,EDS 289C,A01,507361,Daly; Alan J.,18,0,18,0
1713479024455,EDS 290,A00,507366,Hofstetter; Carolyn,15,0,15,0
1713479025480,LIGM 5A,A00,507421,Fischer-Grunski; Eva K,20,0,20,0
1713479026505,LIGM 5B,A00,507423,Fischer-Grunski; Eva K,20,0,20,0
1713479027529,LIGM 5C,A00,507425,Fischer-Grunski; Eva K,20,0,20,0
1713479028555,LIIT 5AS,A00,507427,Carnelos; Chiara,20,0,20,0
1713479029579,LIIT 5BS,A00,507430,Carnelos; Chiara,20,0,20,0
1713479030608,LIIT 5CS,A00,507432,Carnelos; Chiara,20,0,20,0
1713479031638,LISP 5A,A00,507541,Munoz Sanchez; Alicia,15,0,20,5
1713479032666,LISP 5B,A00,507671,Munoz Sanchez; Alicia,12,0,20,8
1713479033691,LISP 5C,A00,507696,Munoz Sanchez; Alicia,11,0,20,9
1713479034717,MAE 197,001,528363,Boechler; Nicholas Sebastia,9998,0,9999,1
1713479035799,MATH 197,001,523477,Kedlaya; Kiran S.,9999,0,9999,0
1713479035799,MATH 197,002,563811,Zhang; Danna,9998,0,9999,1
1713479036828,MCWP 40R,A00,518780,Staff,17,0,20,3
1713479036828,MCWP 40R,B00,518781,Staff,14,0,20,6
1713479036828,MCWP 40R,C00,518783,Staff,12,0,20,8
1713479037854,MCWP 50R,A00,518791,Staff,9,0,20,11
1713479037854,MCWP 50R,B00,518792,Staff,7,0,20,13
1713479037854,MCWP 50R,C00,518793,Staff,7,0,20,13
1713479037854,MCWP 50R,D00,518794,Staff,3,0,20,17
1713479037854,MCWP 50R,E00,518795,Staff,5,0,20,15
1713479037854,MCWP 50R,F00,518796,Staff,15,0,20,5
1713479037854,MCWP 50R,G00,518797,Staff,13,0,20,7
1713479038880,MMW 12R,A01,514034,Herbst; Matthew,9,0,16,7
1713479038880,MMW 12R,A02,514035,Herbst; Matthew,14,0,16,2
1713479039907,MMW 13R,A01,514037,Staff,0,0,16,16
1713479039907,MMW 13R,A02,514039,Staff,0,0,16,16
1713479041961,SIO 295LS,A00,523233,Staff,16,0,30,14
1713479042986,SIO 295S,A00,523232,Staff,16,0,30,14
1713479044016,SOCI 117,A01,494376,Staff,0,2,5,5
1713479045044,WES 237B,A00,494380,Staff,19,0,20,1
1713479047118,AESE 279B,A00,494370,Wade; Jon P,33,0,33,0
1713479048144,AIP 197,001,627712,Vespa; Emanuel Ignacio,9999,0,9999,0
1713479049168,ANAR 135S,A00,494369,Braswell; Geoffrey E.,0,0,0,0
1713479050198,CAT 124RS,A01,519847,Geibel; William,6,0,20,14
1713479051223,CAT 125RS,A01,515971,Geibel; William,6,0,20,14
1713479052249,CLRE 250,A00,511389,Morris; Sheldon,9996,0,9999,3
1713479053279,CLRE 251,A00,507176,Mehta; Ravindra L.,9996,0,9999,3
1713479053279,CLRE 251,B00,511410,Mehta; Ravindra L.,9998,0,9999,1
1713479054309,CLRE 252,A00,507189,Cuomo; Raphael Eduardo,9998,0,9999,1
1713479055339,CLRE 253,A00,507199,Vaida; Florin,9997,0,9999,2
1713479055339,CLRE 253,B00,507202,Vaida; Florin,9999,0,9999,0
1713479056367,CLRE 259,A00,507211,Patel; Hemal,9996,0,9999,3
1713479057392,CLRE 260,A00,507221,Cuomo; Raphael Eduardo,9999,0,9999,0
1713479058421,CLRE 297,001,507242,Cuomo; Raphael Eduardo,9999,0,9999,0
1713479059449,CSE 191,A00,516875,Minnes Kemp; Mor Mia,9999,0,9999,0
1713479060477,CSS 201S,A01,494383,Staff,35,0,35,0
1713479061505,CSS 202S,A01,494387,Staff,35,0,35,0
1713479062531,EAP 100,A00,516065,Staff,9792,0,9999,207
1713479063559,ECE 45,A01,507414,Staff,40,0,60,20
1713479064588,ECE 100,A01,507416,Baghdadchi; Saharnaz,3,0,20,17
1713479064588,ECE 100,A02,507418,Baghdadchi; Saharnaz,19,0,20,1
1713479065617,ECE 111,A01,507420,Staff,28,0,50,22
1713479066644,ECE 197,001,548057,Sievenpiper; Daniel F.,9998,0,9999,1
1713479067675,EDS 115,A00,507243,Choi; Bailey Miyeon,27,0,28,1
1713479068698,EDS 117,A01,494379,Staff,16,0,25,9
1713479069723,EDS 125,A00,507246,Hopkins; Megan Beth,28,0,30,2
1713479070752,EDS 128A,A01,507264,Fargason; Sharon Gayle,26,0,26,0
1713479071778,EDS 128B,A01,507293,Pappas; Elizabeth,30,0,30,0
1713479072804,EDS 139,A00,507294,Fargason; Sharon Gayle,30,0,30,0
1713479072804,EDS 139,B00,507313,Pappas; Elizabeth,30,0,30,0
1713479073829,EDS 201,A00,507315,Staff,19,0,30,11
1713479074857,EDS 203,A01,507317,Halter; Christopher P.,18,0,30,12
1713479075883,EDS 204R,A01,507319,Halter; Christopher P.,0,1,30,30
1713479075883,EDS 204R,B01,507331,Heinzman; Erica M.,26,0,30,4
1713479076912,EDS 206R,A00,507332,Staff,0,1,30,30
1713479076912,EDS 206R,B00,507343,Staff,27,0,30,3
1713479077938,EDS 250,A00,507344,Hemans; Patricia Ann Benitez,28,0,40,12
1713479078963,EDS 281,A00,507345,Daly; Alan J.,18,0,18,0
1713479079989,EDS 284,A00,507350,Daly; Alan J.,16,0,16,0
1713479081019,EDS 286,A00,507359,Fine; Sarah,18,0,18,0
1713479082045,EDS 289C,A01,507361,Daly; Alan J.,18,0,18,0
1713479083071,EDS 290,A00,507366,Hofstetter; Carolyn,15,0,15,0
1713479084095,LIGM 5A,A00,507421,Fischer-Grunski; Eva K,20,0,20,0
1713479085124,LIGM 5B,A00,507423,Fischer-Grunski; Eva K,20,0,20,0
1713479086154,LIGM 5C,A00,507425,Fischer-Grunski; Eva K,20,0,20,0
1713479087181,LIIT 5AS,A00,507427,Carnelos; Chiara,20,0,20,0
1713479088207,LIIT 5BS,A00,507430,Carnelos; Chiara,20,0,20,0
1713479089235,LIIT 5CS,A00,507432,Carnelos; Chiara,20,0,20,0
1713479090259,LISP 5A,A00,507541,Munoz Sanchez; Alicia,15,0,20,5
1713479091285,LISP 5B,A00,507671,Munoz Sanchez; Alicia,12,0,20,8
1713479092311,LISP 5C,A00,507696,Munoz Sanchez; Alicia,11,0,20,9
1713479093340,MAE 197,001,528363,Boechler; Nicholas Sebastia,9998,0,9999,1
1713479094367,MATH 197,001,523477,Kedlaya; Kiran S.,9999,0,9999,0
1713479094367,MATH 197,002,563811,Zhang; Danna,9998,0,9999,1
1713479095391,MCWP 40R,A00,518780,Staff,17,0,20,3
1713479095391,MCWP 40R,B00,518781,Staff,14,0,20,6
1713479095391,MCWP 40R,C00,518783,Staff,12,0,20,8
1713479096417,MCWP 50R,A00,518791,Staff,9,0,20,11
1713479096417,MCWP 50R,B00,518792,Staff,7,0,20,13
1713479096417,MCWP 50R,C00,518793,Staff,7,0,20,13
1713479096417,MCWP 50R,D00,518794,Staff,3,0,20,17
1713479096417,MCWP 50R,E00,518795,Staff,5,0,20,15
1713479096417,MCWP 50R,F00,518796,Staff,15,0,20,5
1713479096417,MCWP 50R,G00,518797,Staff,13,0,20,7
1713479097443,MMW 12R,A01,514034,Herbst; Matthew,9,0,16,7
1713479097443,MMW 12R,A02,514035,Herbst; Matthew,14,0,16,2
1713479098468,MMW 13R,A01,514037,Staff,0,0,16,16
1713479098468,MMW 13R,A02,514039,Staff,0,0,16,16
1713479100525,SIO 295LS,A00,523233,Staff,16,0,30,14
1713479101555,SIO 295S,A00,523232,Staff,16,0,30,14
1713479102585,SOCI 117,A01,494376,Staff,0,2,5,5
1713479103613,WES 237B,A00,494380,Staff,19,0,20,1
1713479105685,AESE 279B,A00,494370,Wade; Jon P,33,0,33,0
1713479106711,AIP 197,001,627712,Vespa; Emanuel Ignacio,9999,0,9999,0
1713479107738,ANAR 135S,A00,494369,Braswell; Geoffrey E.,0,0,0,0
1713479108765,CAT 124RS,A01,519847,Geibel; William,6,0,20,14
1713479109793,CAT 125RS,A01,515971,Geibel; William,6,0,20,14
1713479110822,CLRE 250,A00,511389,Morris; Sheldon,9996,0,9999,3
1713479111849,CLRE 251,A00,507176,Mehta; Ravindra L.,9996,0,9999,3
1713479111849,CLRE 251,B00,511410,Mehta; Ravindra L.,9998,0,9999,1
1713479112876,CLRE 252,A00,507189,Cuomo; Raphael Eduardo,9998,0,9999,1
1713479113906,CLRE 253,A00,507199,Vaida; Florin,9997,0,9999,2
1713479113906,CLRE 253,B00,507202,Vaida; Florin,9999,0,9999,0
1713479114932,CLRE 259,A00,507211,Patel; Hemal,9996,0,9999,3
1713479115958,CLRE 260,A00,507221,Cuomo; Raphael Eduardo,9999,0,9999,0
1713479116982,CLRE 297,001,507242,Cuomo; Raphael Eduardo,9999,0,9999,0
1713479118008,CSE 191,A00,516875,Minnes Kemp; Mor Mia,9999,0,9999,0
1713479119046,CSS 201S,A01,494383,Staff,35,0,35,0
1713479120076,CSS 202S,A01,494387,Staff,35,0,35,0
1713479121103,EAP 100,A00,516065,Staff,9792,0,9999,207
1713479122129,ECE 45,A01,507414,Staff,40,0,60,20
1713479123155,ECE 100,A01,507416,Baghdadchi; Saharnaz,3,0,20,17
1713479123155,ECE 100,A02,507418,Baghdadchi; Saharnaz,19,0,20,1
1713479124180,ECE 111,A01,507420,Staff,28,0,50,22
1713479125205,ECE 197,001,548057,Sievenpiper; Daniel F.,9998,0,9999,1
1713479126232,EDS 115,A00,507243,Choi; Bailey Miyeon,27,0,28,1
1713479127258,EDS 117,A01,494379,Staff,16,0,25,9
1713479128286,EDS 125,A00,507246,Hopkins; Megan Beth,28,0,30,2
1713479129316,EDS 128A,A01,507264,Fargason; Sharon Gayle,26,0,26,0
1713479130343,EDS 128B,A01,507293,Pappas; Elizabeth,30,0,30,0
1713479131368,EDS 139,A00,507294,Fargason; Sharon Gayle,30,0,30,0
1713479131368,EDS 139,B00,507313,Pappas; Elizabeth,30,0,30,0
1713479132394,EDS 201,A00,507315,Staff,19,0,30,11
1713479133420,EDS 203,A01,507317,Halter; Christopher P.,18,0,30,12
1713479134461,EDS 204R,A01,507319,Halter; Christopher P.,0,1,30,30
1713479134461,EDS 204R,B01,507331,Heinzman; Erica M.,26,0,30,4
1713479135485,EDS 206R,A00,507332,Staff,0,1,30,30
1713479135485,EDS 206R,B00,507343,Staff,27,0,30,3
1713479136511,EDS 250,A00,507344,Hemans; Patricia Ann Benitez,28,0,40,12
1713479137538,EDS 281,A00,507345,Daly; Alan J.,18,0,18,0
1713479138562,EDS 284,A00,507350,Daly; Alan J.,16,0,16,0
1713479139646,EDS 286,A00,507359,Fine; Sarah,18,0,18,0
1713479140671,EDS 289C,A01,507361,Daly; Alan J.,18,0,18,0
1713479141697,EDS 290,A00,507366,Hofstetter; Carolyn,15,0,15,0
1713479142730,LIGM 5A,A00,507421,Fischer-Grunski; Eva K,20,0,20,0
1713479143755,LIGM 5B,A00,507423,Fischer-Grunski; Eva K,20,0,20,0
1713479144785,LIGM 5C,A00,507425,Fischer-Grunski; Eva K,20,0,20,0
1713479145810,LIIT 5AS,A00,507427,Carnelos; Chiara,20,0,20,0
1713479146838,LIIT 5BS,A00,507430,Carnelos; Chiara,20,0,20,0
1713479147863,LIIT 5CS,A00,507432,Carnelos; Chiara,20,0,20,0
1713479148889,LISP 5A,A00,507541,Munoz Sanchez; Alicia,15,0,20,5
1713479149915,LISP 5B,A00,507671,Munoz Sanchez; Alicia,12,0,20,8
1713479150940,LISP 5C,A00,507696,Munoz Sanchez; Alicia,11,0,20,9
1713479151968,MAE 197,001,528363,Boechler; Nicholas Sebastia,9998,0,9999,1
1713479152997,MATH 197,001,523477,Kedlaya; Kiran S.,9999,0,9999,0
1713479152997,MATH 197,002,563811,Zhang; Danna,9998,0,9999,1
1713479154026,MCWP 40R,A00,518780,Staff,17,0,20,3
1713479154026,MCWP 40R,B00,518781,Staff,14,0,20,6
1713479154026,MCWP 40R,C00,518783,Staff,12,0,20,8
1713479155055,MCWP 50R,A00,518791,Staff,9,0,20,11
1713479155055,MCWP 50R,B00,518792,Staff,7,0,20,13
1713479155055,MCWP 50R,C00,518793,Staff,7,0,20,13
1713479155055,MCWP 50R,D00,518794,Staff,3,0,20,17
1713479155055,MCWP 50R,E00,518795,Staff,5,0,20,15
1713479155055,MCWP 50R,F00,518796,Staff,15,0,20,5
1713479155055,MCWP 50R,G00,518797,Staff,13,0,20,7
1713479156083,MMW 12R,A01,514034,Herbst; Matthew,9,0,16,7
1713479156083,MMW 12R,A02,514035,Herbst; Matthew,14,0,16,2
1713479157106,MMW 13R,A01,514037,Staff,0,0,16,16
1713479157106,MMW 13R,A02,514039,Staff,0,0,16,16
1713479159157,SIO 295LS,A00,523233,Staff,16,0,30,14
1713479160183,SIO 295S,A00,523232,Staff,16,0,30,14
1713479161214,SOCI 117,A01,494376,Staff,0,2,5,5
1713479162243,WES 237B,A00,494380,Staff,19,0,20,1
1713479164311,AESE 279B,A00,494370,Wade; Jon P,33,0,33,0
1713479165335,AIP 197,001,627712,Vespa; Emanuel Ignacio,9999,0,9999,0
1713479166361,ANAR 135S,A00,494369,Braswell; Geoffrey E.,0,0,0,0
1713479167387,CAT 124RS,A01,519847,Geibel; William,6,0,20,14
1713479168413,CAT 125RS,A01,515971,Geibel; William,6,0,20,14
1713479169439,CLRE 250,A00,511389,Morris; Sheldon,9996,0,9999,3
1713479170470,CLRE 251,A00,507176,Mehta; Ravindra L.,9996,0,9999,3
1713479170470,CLRE 251,B00,511410,Mehta; Ravindra L.,9998,0,9999,1
1713479171499,CLRE 252,A00,507189,Cuomo; Raphael Eduardo,9998,0,9999,1
1713479172524,CLRE 253,A00,507199,Vaida; Florin,9997,0,9999,2
1713479172524,CLRE 253,B00,507202,Vaida; Florin,9999,0,9999,0
1713479173551,CLRE 259,A00,507211,Patel; Hemal,9996,0,9999,3
1713479174581,CLRE 260,A00,507221,Cuomo; Raphael Eduardo,9999,0,9999,0
1713479175605,CLRE 297,001,507242,Cuomo; Raphael Eduardo,9999,0,9999,0
1713479176628,CSE 191,A00,516875,Minnes Kemp; Mor Mia,9999,0,9999,0
1713479177654,CSS 201S,A01,494383,Staff,35,0,35,0
1713479178679,CSS 202S,A01,494387,Staff,35,0,35,0
1713479179705,EAP 100,A00,516065,Staff,9792,0,9999,207
1713479180730,ECE 45,A01,507414,Staff,40,0,60,20
1713479181759,ECE 100,A01,507416,Baghdadchi; Saharnaz,3,0,20,17
1713479181759,ECE 100,A02,507418,Baghdadchi; Saharnaz,19,0,20,1
1713479182784,ECE 111,A01,507420,Staff,28,0,50,22
1713479183816,ECE 197,001,548057,Sievenpiper; Daniel F.,9998,0,9999,1
1713479184842,EDS 115,A00,507243,Choi; Bailey Miyeon,27,0,28,1
1713479185868,EDS 117,A01,494379,Staff,16,0,25,9
1713479186893,EDS 125,A00,507246,Hopkins; Megan Beth,28,0,30,2
1713479187919,EDS 128A,A01,507264,Fargason; Sharon Gayle,26,0,26,0
1713479188943,EDS 128B,A01,507293,Pappas; Elizabeth,30,0,30,0
1713479189971,EDS 139,A00,507294,Fargason; Sharon Gayle,30,0,30,0
1713479189971,EDS 139,B00,507313,Pappas; Elizabeth,30,0,30,0
1713479190996,EDS 201,A00,507315,Staff,19,0,30,11
1713479192032,EDS 203,A01,507317,Halter; Christopher P.,18,0,30,12
1713479193058,EDS 204R,A01,507319,Halter; Christopher P.,0,1,30,30
1713479193058,EDS 204R,B01,507331,Heinzman; Erica M.,26,0,30,4
1713479194081,EDS 206R,A00,507332,Staff,0,1,30,30
1713479194081,EDS 206R,B00,507343,Staff,27,0,30,3
1713479195110,EDS 250,A00,507344,Hemans; Patricia Ann Benitez,28,0,40,12
1713479196139,EDS 281,A00,507345,Daly; Alan J.,18,0,18,0
1713479197163,EDS 284,A00,507350,Daly; Alan J.,16,0,16,0
1713479198187,EDS 286,A00,507359,Fine; Sarah,18,0,18,0
1713479199213,EDS 289C,A01,507361,Daly; Alan J.,18,0,18,0
1713479200237,EDS 290,A00,507366,Hofstetter; Carolyn,15,0,15,0
1713479201263,LIGM 5A,A00,507421,Fischer-Grunski; Eva K,20,0,20,0
1713479202290,LIGM 5B,A00,507423,Fischer-Grunski; Eva K,20,0,20,0
1713479203323,LIGM 5C,A00,507425,Fischer-Grunski; Eva K,20,0,20,0
1713479204347,LIIT 5AS,A00,507427,Carnelos; Chiara,20,0,20,0
1713479205377,LIIT 5BS,A00,507430,Carnelos; Chiara,20,0,20,0
1713479206405,LIIT 5CS,A00,507432,Carnelos; Chiara,20,0,20,0
1713479207431,LISP 5A,A00,507541,Munoz Sanchez; Alicia,15,0,20,5
1713479208461,LISP 5B,A00,507671,Munoz Sanchez; Alicia,12,0,20,8
1713479209486,LISP 5C,A00,507696,Munoz Sanchez; Alicia,11,0,20,9
1713479210515,MAE 197,001,528363,Boechler; Nicholas Sebastia,9998,0,9999,1
1713479211542,MATH 197,001,523477,Kedlaya; Kiran S.,9999,0,9999,0
1713479211542,MATH 197,002,563811,Zhang; Danna,9998,0,9999,1
1713479212567,MCWP 40R,A00,518780,Staff,17,0,20,3
1713479212567,MCWP 40R,B00,518781,Staff,14,0,20,6
1713479212567,MCWP 40R,C00,518783,Staff,12,0,20,8
1713479213597,MCWP 50R,A00,518791,Staff,9,0,20,11
1713479213597,MCWP 50R,B00,518792,Staff,7,0,20,13
1713479213597,MCWP 50R,C00,518793,Staff,7,0,20,13
1713479213597,MCWP 50R,D00,518794,Staff,3,0,20,17
1713479213597,MCWP 50R,E00,518795,Staff,5,0,20,15
1713479213597,MCWP 50R,F00,518796,Staff,15,0,20,5
1713479213597,MCWP 50R,G00,518797,Staff,13,0,20,7
1713479214624,MMW 12R,A01,514034,Herbst; Matthew,9,0,16,7
1713479214624,MMW 12R,A02,514035,Herbst; Matthew,14,0,16,2
1713479215651,MMW 13R,A01,514037,Staff,0,0,16,16
1713479215651,MMW 13R,A02,514039,Staff,0,0,16,16
1713479217701,SIO 295LS,A00,523233,Staff,16,0,30,14
1713479218728,SIO 295S,A00,523232,Staff,16,0,30,14
1713479219754,SOCI 117,A01,494376,Staff,0,2,5,5
1713479220806,WES 237B,A00,494380,Staff,19,0,20,1
1713479222874,AESE 279B,A00,494370,Wade; Jon P,33,0,33,0
1713479223900,AIP 197,001,627712,Vespa; Emanuel Ignacio,9999,0,9999,0
1713479224928,ANAR 135S,A00,494369,Braswell; Geoffrey E.,0,0,0,0
1713479225954,CAT 124RS,A01,519847,Geibel; William,6,0,20,14
1713479226981,CAT 125RS,A01,515971,Geibel; William,6,0,20,14
1713479228008,CLRE 250,A00,511389,Morris; Sheldon,9996,0,9999,3
1713479229035,CLRE 251,A00,507176,Mehta; Ravindra L.,9996,0,9999,3
1713479229035,CLRE 251,B00,511410,Mehta; Ravindra L.,9998,0,9999,1
1713479230061,CLRE 252,A00,507189,Cuomo; Raphael Eduardo,9998,0,9999,1
1713479231087,CLRE 253,A00,507199,Vaida; Florin,9997,0,9999,2
1713479231087,CLRE 253,B00,507202,Vaida; Florin,9999,0,9999,0
1713479232118,CLRE 259,A00,507211,Patel; Hemal,9996,0,9999,3
1713479233144,CLRE 260,A00,507221,Cuomo; Raphael Eduardo,9999,0,9999,0
1713479234170,CLRE 297,001,507242,Cuomo; Raphael Eduardo,9999,0,9999,0
1713479235199,CSE 191,A00,516875,Minnes Kemp; Mor Mia,9999,0,9999,0
1713479236225,CSS 201S,A01,494383,Staff,35,0,35,0
1713479237251,CSS 202S,A01,494387,Staff,35,0,35,0
1713479238316,EAP 100,A00,516065,Staff,9792,0,9999,207
1713479239346,ECE 45,A01,507414,Staff,40,0,60,20
1713479240371,ECE 100,A01,507416,Baghdadchi; Saharnaz,3,0,20,17
1713479240371,ECE 100,A02,507418,Baghdadchi; Saharnaz,19,0,20,1
1713479241400,ECE 111,A01,507420,Staff,28,0,50,22
1713479242430,ECE 197,001,548057,Sievenpiper; Daniel F.,9998,0,9999,1
1713479243509,EDS 115,A00,507243,Choi; Bailey Miyeon,27,0,28,1
1713479244536,EDS 117,A01,494379,Staff,16,0,25,9
1713479245560,EDS 125,A00,507246,Hopkins; Megan Beth,28,0,30,2
1713479246588,EDS 128A,A01,507264,Fargason; Sharon Gayle,26,0,26,0
1713479247615,EDS 128B,A01,507293,Pappas; Elizabeth,30,0,30,0
1713479248638,EDS 139,A00,507294,Fargason; Sharon Gayle,30,0,30,0
1713479248638,EDS 139,B00,507313,Pappas; Elizabeth,30,0,30,0
1713479249663,EDS 201,A00,507315,Staff,19,0,30,11
1713479250692,EDS 203,A01,507317,Halter; Christopher P.,18,0,30,12
1713479251716,EDS 204R,A01,507319,Halter; Christopher P.,0,1,30,30
1713479251716,EDS 204R,B01,507331,Heinzman; Erica M.,26,0,30,4
1713479252744,EDS 206R,A00,507332,Staff,0,1,30,30
1713479252744,EDS 206R,B00,507343,Staff,27,0,30,3
1713479253772,EDS 250,A00,507344,Hemans; Patricia Ann Benitez,28,0,40,12
1713479254796,EDS 281,A00,507345,Daly; Alan J.,18,0,18,0
1713479255821,EDS 284,A00,507350,Daly; Alan J.,16,0,16,0
1713479256844,EDS 286,A00,507359,Fine; Sarah,18,0,18,0
1713479257868,EDS 289C,A01,507361,Daly; Alan J.,18,0,18,0
1713479258896,EDS 290,A00,507366,Hofstetter; Carolyn,15,0,15,0
1713479259921,LIGM 5A,A00,507421,Fischer-Grunski; Eva K,20,0,20,0
1713479260950,LIGM 5B,A00,507423,Fischer-Grunski; Eva K,20,0,20,0
1713479261978,LIGM 5C,A00,507425,Fischer-Grunski; Eva K,20,0,20,0
1713479263006,LIIT 5AS,A00,507427,Carnelos; Chiara,20,0,20,0
1713479264033,LIIT 5BS,A00,507430,Carnelos; Chiara,20,0,20,0
1713479265057,LIIT 5CS,A00,507432,Carnelos; Chiara,20,0,20,0
1713479266087,LISP 5A,A00,507541,Munoz Sanchez; Alicia,15,0,20,5
1713479267115,LISP 5B,A00,507671,Munoz Sanchez; Alicia,12,0,20,8
1713479268139,LISP 5C,A00,507696,Munoz Sanchez; Alicia,11,0,20,9
1713479269165,MAE 197,001,528363,Boechler; Nicholas Sebastia,9998,0,9999,1
1713479270194,MATH 197,001,523477,Kedlaya; Kiran S.,9999,0,9999,0
1713479270194,MATH 197,002,563811,Zhang; Danna,9998,0,9999,1
1713479271219,MCWP 40R,A00,518780,Staff,17,0,20,3
1713479271219,MCWP 40R,B00,518781,Staff,14,0,20,6
1713479271219,MCWP 40R,C00,518783,Staff,12,0,20,8
1713479272246,MCWP 50R,A00,518791,Staff,9,0,20,11
1713479272246,MCWP 50R,B00,518792,Staff,7,0,20,13
1713479272246,MCWP 50R,C00,518793,Staff,7,0,20,13
1713479272246,MCWP 50R,D00,518794,Staff,3,0,20,17
1713479272246,MCWP 50R,E00,518795,Staff,5,0,20,15
1713479272246,MCWP 50R,F00,518796,Staff,15,0,20,5
1713479272246,MCWP 50R,G00,518797,Staff,13,0,20,7
1713479273271,MMW 12R,A01,514034,Herbst; Matthew,9,0,16,7
1713479273271,MMW 12R,A02,514035,Herbst; Matthew,14,0,16,2
1713479274296,MMW 13R,A01,514037,Staff,0,0,16,16
1713479274296,MMW 13R,A02,514039,Staff,0,0,16,16
1713479276354,SIO 295LS,A00,523233,Staff,16,0,30,14
1713479277378,SIO 295S,A00,523232,Staff,16,0,30,14
1713479278405,SOCI 117,A01,494376,Staff,0,2,5,5
1713479279430,WES 237B,A00,494380,Staff,19,0,20,1
1713479281594,AESE 279B,A00,494370,Wade; Jon P,33,0,33,0
1713479282620,AIP 197,001,627712,Vespa; Emanuel Ignacio,9999,0,9999,0
1713479283649,ANAR 135S,A00,494369,Braswell; Geoffrey E.,0,0,0,0
1713479284678,CAT 124RS,A01,519847,Geibel; William,6,0,20,14
1713479285703,CAT 125RS,A01,515971,Geibel; William,6,0,20,14
1713479286733,CLRE 250,A00,511389,Morris; Sheldon,9996,0,9999,3
1713479287759,CLRE 251,A00,507176,Mehta; Ravindra L.,9996,0,9999,3
1713479287759,CLRE 251,B00,511410,Mehta; Ravindra L.,9998,0,9999,1
1713479288785,CLRE 252,A00,507189,Cuomo; Raphael Eduardo,9998,0,9999,1
1713479289814,CLRE 253,A00,507199,Vaida; Florin,9997,0,9999,2
1713479289814,CLRE 253,B00,507202,Vaida; Florin,9999,0,9999,0
1713479290842,CLRE 259,A00,507211,Patel; Hemal,9996,0,9999,3
1713479291875,CLRE 260,A00,507221,Cuomo; Raphael Eduardo,9999,0,9999,0
1713479292901,CLRE 297,001,507242,Cuomo; Raphael Eduardo,9999,0,9999,0
1713479293934,CSE 191,A00,516875,Minnes Kemp; Mor Mia,9999,0,9999,0
1713479294961,CSS 201S,A01,494383,Staff,35,0,35,0
1713479295991,CSS 202S,A01,494387,Staff,35,0,35,0
1713479297016,EAP 100,A00,516065,Staff,9792,0,9999,207
1713479298042,ECE 45,A01,507414,Staff,40,0,60,20
1713479299067,ECE 100,A01,507416,Baghdadchi; Saharnaz,3,0,20,17
1713479299067,ECE 100,A02,507418,Baghdadchi; Saharnaz,19,0,20,1
1713479300097,ECE 111,A01,507420,Staff,28,0,50,22
1713479301121,ECE 197,001,548057,Sievenpiper; Daniel F.,9998,0,9999,1
1713479302145,EDS 115,A00,507243,Choi; Bailey Miyeon,27,0,28,1
1713479303172,EDS 117,A01,494379,Staff,16,0,25,9
1713479304196,EDS 125,A00,507246,Hopkins; Megan Beth,28,0,30,2
1713479305223,EDS 128A,A01,507264,Fargason; Sharon Gayle,26,0,26,0
1713479306249,EDS 128B,A01,507293,Pappas; Elizabeth,30,0,30,0
1713479307273,EDS 139,A00,507294,Fargason; Sharon Gayle,30,0,30,0
1713479307273,EDS 139,B00,507313,Pappas; Elizabeth,30,0,30,0
1713479308301,EDS 201,A00,507315,Staff,19,0,30,11
1713479309330,EDS 203,A01,507317,Halter; Christopher P.,18,0,30,12
1713479310355,EDS 204R,A01,507319,Halter; Christopher P.,0,1,30,30
1713479310355,EDS 204R,B01,507331,Heinzman; Erica M.,26,0,30,4
1713479311384,EDS 206R,A00,507332,Staff,0,1,30,30
1713479311384,EDS 206R,B00,507343,Staff,27,0,30,3
1713479312409,EDS 250,A00,507344,Hemans; Patricia Ann Benitez,28,0,40,12
1713479313433,EDS 281,A00,507345,Daly; Alan J.,18,0,18,0
1713479314458,EDS 284,A00,507350,Daly; Alan J.,16,0,16,0
1713479315485,EDS 286,A00,507359,Fine; Sarah,18,0,18,0
1713479316512,EDS 289C,A01,507361,Daly; Alan J.,18,0,18,0
1713479317536,EDS 290,A00,507366,Hofstetter; Carolyn,15,0,15,0
1713479318563,LIGM 5A,A00,507421,Fischer-Grunski; Eva K,20,0,20,0
1713479319589,LIGM 5B,A00,507423,Fischer-Grunski; Eva K,20,0,20,0
1713479320619,LIGM 5C,A00,507425,Fischer-Grunski; Eva K,20,0,20,0
1713479321646,LIIT 5AS,A00,507427,Carnelos; Chiara,20,0,20,0
1713479322672,LIIT 5BS,A00,507430,Carnelos; Chiara,20,0,20,0
1713479323696,LIIT 5CS,A00,507432,Carnelos; Chiara,20,0,20,0
1713479324726,LISP 5A,A00,507541,Munoz Sanchez; Alicia,15,0,20,5
1713479325753,LISP 5B,A00,507671,Munoz Sanchez; Alicia,12,0,20,8
1713479326786,LISP 5C,A00,507696,Munoz Sanchez; Alicia,11,0,20,9
1713479327814,MAE 197,001,528363,Boechler; Nicholas Sebastia,9998,0,9999,1
1713479328842,MATH 197,001,523477,Kedlaya; Kiran S.,9999,0,9999,0
1713479328842,MATH 197,002,563811,Zhang; Danna,9998,0,9999,1
1713479329868,MCWP 40R,A00,518780,Staff,17,0,20,3
1713479329868,MCWP 40R,B00,518781,Staff,14,0,20,6
1713479329868,MCWP 40R,C00,518783,Staff,12,0,20,8
1713479330895,MCWP 50R,A00,518791,Staff,9,0,20,11
1713479330895,MCWP 50R,B00,518792,Staff,7,0,20,13
1713479330895,MCWP 50R,C00,518793,Staff,7,0,20,13
1713479330895,MCWP 50R,D00,518794,Staff,3,0,20,17
1713479330895,MCWP 50R,E00,518795,Staff,5,0,20,15
1713479330895,MCWP 50R,F00,518796,Staff,15,0,20,5
1713479330895,MCWP 50R,G00,518797,Staff,13,0,20,7
1713479331922,MMW 12R,A01,514034,Herbst; Matthew,9,0,16,7
1713479331922,MMW 12R,A02,514035,Herbst; Matthew,14,0,16,2
1713479332947,MMW 13R,A01,514037,Staff,0,0,16,16
1713479332947,MMW 13R,A02,514039,Staff,0,0,16,16
1713479334998,SIO 295LS,A00,523233,Staff,16,0,30,14
1713479336023,SIO 295S,A00,523232,Staff,16,0,30,14
1713479337051,SOCI 117,A01,494376,Staff,0,2,5,5
1713479338076,WES 237B,A00,494380,Staff,19,0,20,1
1713479340146,AESE 279B,A00,494370,Wade; Jon P,33,0,33,0
1713479341172,AIP 197,001,627712,Vespa; Emanuel Ignacio,9999,0,9999,0
1713479342203,ANAR 135S,A00,494369,Braswell; Geoffrey E.,0,0,0,0
1713479343238,CAT 124RS,A01,519847,Geibel; William,6,0,20,14
1713479344263,CAT 125RS,A01,515971,Geibel; William,6,0,20,14
1713479345295,CLRE 250,A00,511389,Morris; Sheldon,9996,0,9999,3
1713479346325,CLRE 251,A00,507176,Mehta; Ravindra L.,9996,0,9999,3
1713479346325,CLRE 251,B00,511410,Mehta; Ravindra L.,9998,0,9999,1
1713479347409,CLRE 252,A00,507189,Cuomo; Raphael Eduardo,9998,0,9999,1
1713479348436,CLRE 253,A00,507199,Vaida; Florin,9997,0,9999,2
1713479348436,CLRE 253,B00,507202,Vaida; Florin,9999,0,9999,0
1713479349462,CLRE 259,A00,507211,Patel; Hemal,9996,0,9999,3
1713479350485,CLRE 260,A00,507221,Cuomo; Raphael Eduardo,9999,0,9999,0
1713479351512,CLRE 297,001,507242,Cuomo; Raphael Eduardo,9999,0,9999,0
1713479352542,CSE 191,A00,516875,Minnes Kemp; Mor Mia,9999,0,9999,0
1713479353573,CSS 201S,A01,494383,Staff,35,0,35,0
1713479354599,CSS 202S,A01,494387,Staff,35,0,35,0
1713479355624,EAP 100,A00,516065,Staff,9792,0,9999,207
1713479356651,ECE 45,A01,507414,Staff,40,0,60,20
1713479357676,ECE 100,A01,507416,Baghdadchi; Saharnaz,3,0,20,17
1713479357676,ECE 100,A02,507418,Baghdadchi; Saharnaz,19,0,20,1
1713479358702,ECE 111,A01,507420,Staff,28,0,50,22
1713479359727,ECE 197,001,548057,Sievenpiper; Daniel F.,9998,0,9999,1
1713479360752,EDS 115,A00,507243,Choi; Bailey Miyeon,27,0,28,1
1713479361778,EDS 117,A01,494379,Staff,16,0,25,9
1713479362808,EDS 125,A00,507246,Hopkins; Megan Beth,28,0,30,2
1713479363833,EDS 128A,A01,507264,Fargason; Sharon Gayle,26,0,26,0
1713479364860,EDS 128B,A01,507293,Pappas; Elizabeth,30,0,30,0
1713479365885,EDS 139,A00,507294,Fargason; Sharon Gayle,30,0,30,0
1713479365885,EDS 139,B00,507313,Pappas; Elizabeth,30,0,30,0
1713479366913,EDS 201,A00,507315,Staff,19,0,30,11
1713479367939,EDS 203,A01,507317,Halter; Christopher P.,18,0,30,12
1713479368967,EDS 204R,A01,507319,Halter; Christopher P.,0,1,30,30
1713479368967,EDS 204R,B01,507331,Heinzman; Erica M.,26,0,30,4
1713479369993,EDS 206R,A00,507332,Staff,0,1,30,30
1713479369993,EDS 206R,B00,507343,Staff,27,0,30,3
1713479371021,EDS 250,A00,507344,Hemans; Patricia Ann Benitez,28,0,40,12
1713479372046,EDS 281,A00,507345,Daly; Alan J.,18,0,18,0
1713479373074,EDS 284,A00,507350,Daly; Alan J.,16,0,16,0
1713479374099,EDS 286,A00,507359,Fine; Sarah,18,0,18,0
1713479375127,EDS 289C,A01,507361,Daly; Alan J.,18,0,18,0
1713479376151,EDS 290,A00,507366,Hofstetter; Carolyn,15,0,15,0
1713479377178,LIGM 5A,A00,507421,Fischer-Grunski; Eva K,20,0,20,0
1713479378205,LIGM 5B,A00,507423,Fischer-Grunski; Eva K,20,0,20,0
1713479379275,LIGM 5C,A00,507425,Fischer-Grunski; Eva K,20,0,20,0
1713479380300,LIIT 5AS,A00,507427,Carnelos; Chiara,20,0,20,0
1713479381325,LIIT 5BS,A00,507430,Carnelos; Chiara,20,0,20,0
1713479382350,LIIT 5CS,A00,507432,Carnelos; Chiara,20,0,20,0
1713479383375,LISP 5A,A00,507541,Munoz Sanchez; Alicia,15,0,20,5
1713479384403,LISP 5B,A00,507671,Munoz Sanchez; Alicia,12,0,20,8
1713479385427,LISP 5C,A00,507696,Munoz Sanchez; Alicia,11,0,20,9
1713479386453,MAE 197,001,528363,Boechler; Nicholas Sebastia,9998,0,9999,1
1713479387480,MATH 197,001,523477,Kedlaya; Kiran S.,9999,0,9999,0
1713479387480,MATH 197,002,563811,Zhang; Danna,9998,0,9999,1
1713479388507,MCWP 40R,A00,518780,Staff,17,0,20,3
1713479388507,MCWP 40R,B00,518781,Staff,14,0,20,6
1713479388507,MCWP 40R,C00,518783,Staff,12,0,20,8
1713479389535,MCWP 50R,A00,518791,Staff,9,0,20,11
1713479389535,MCWP 50R,B00,518792,Staff,7,0,20,13
1713479389535,MCWP 50R,C00,518793,Staff,7,0,20,13
1713479389535,MCWP 50R,D00,518794,Staff,3,0,20,17
1713479389535,MCWP 50R,E00,518795,Staff,5,0,20,15
1713479389535,MCWP 50R,F00,518796,Staff,15,0,20,5
1713479389535,MCWP 50R,G00,518797,Staff,13,0,20,7
1713479390562,MMW 12R,A01,514034,Herbst; Matthew,9,0,16,7
1713479390562,MMW 12R,A02,514035,Herbst; Matthew,14,0,16,2
1713479391586,MMW 13R,A01,514037,Staff,0,0,16,16
1713479391586,MMW 13R,A02,514039,Staff,0,0,16,16
1713479393640,SIO 295LS,A00,523233,Staff,16,0,30,14
1713479394666,SIO 295S,A00,523232,Staff,16,0,30,14
1713479395692,SOCI 117,A01,494376,Staff,0,2,5,5
1713479396718,WES 237B,A00,494380,Staff,19,0,20,1
1713479398795,AESE 279B,A00,494370,Wade; Jon P,33,0,33,0
1713479399820,AIP 197,001,627712,Vespa; Emanuel Ignacio,9999,0,9999,0
1713479400850,ANAR 135S,A00,494369,Braswell; Geoffrey E.,0,0,0,0
1713479401875,CAT 124RS,A01,519847,Geibel; William,6,0,20,14
1713479402903,CAT 125RS,A01,515971,Geibel; William,6,0,20,14
1713479403934,CLRE 250,A00,511389,Morris; Sheldon,9996,0,9999,3
1713479404967,CLRE 251,A00,507176,Mehta; Ravindra L.,9996,0,9999,3
1713479404967,CLRE 251,B00,511410,Mehta; Ravindra L.,9998,0,9999,1
1713479405991,CLRE 252,A00,507189,Cuomo; Raphael Eduardo,9998,0,9999,1
1713479407018,CLRE 253,A00,507199,Vaida; Florin,9997,0,9999,2
1713479407018,CLRE 253,B00,507202,Vaida; Florin,9999,0,9999,0
1713479408043,CLRE 259,A00,507211,Patel; Hemal,9996,0,9999,3
1713479409075,CLRE 260,A00,507221,Cuomo; Raphael Eduardo,9999,0,9999,0
1713479410099,CLRE 297,001,507242,Cuomo; Raphael Eduardo,9999,0,9999,0
1713479411124,CSE 191,A00,516875,Minnes Kemp; Mor Mia,9999,0,9999,0
1713479412151,CSS 201S,A01,494383,Staff,35,0,35,0
1713479413176,CSS 202S,A01,494387,Staff,35,0,35,0
1713479414201,EAP 100,A00,516065,Staff,9792,0,9999,207
1713479415236,ECE 45,A01,507414,Staff,40,0,60,20
1713479416262,ECE 100,A01,507416,Baghdadchi; Saharnaz,3,0,20,17
1713479416262,ECE 100,A02,507418,Baghdadchi; Saharnaz,19,0,20,1
1713479417287,ECE 111,A01,507420,Staff,28,0,50,22
1713479418311,ECE 197,001,548057,Sievenpiper; Daniel F.,9998,0,9999,1
1713479419338,EDS 115,A00,507243,Choi; Bailey Miyeon,27,0,28,1
1713479420368,EDS 117,A01,494379,Staff,16,0,25,9
1713479421393,EDS 125,A00,507246,Hopkins; Megan Beth,28,0,30,2
1713479422421,EDS 128A,A01,507264,Fargason; Sharon Gayle,26,0,26,0
1713479423447,EDS 128B,A01,507293,Pappas; Elizabeth,30,0,30,0
1713479424474,EDS 139,A00,507294,Fargason; Sharon Gayle,30,0,30,0
1713479424474,EDS 139,B00,507313,Pappas; Elizabeth,30,0,30,0
1713479425499,EDS 201,A00,507315,Staff,19,0,30,11
1713479426527,EDS 203,A01,507317,Halter; Christopher P.,18,0,30,12
1713479427557,EDS 204R,A01,507319,Halter; Christopher P.,0,1,30,30
1713479427557,EDS 204R,B01,507331,Heinzman; Erica M.,26,0,30,4
1713479428582,EDS 206R,A00,507332,Staff,0,1,30,30
1713479428582,EDS 206R,B00,507343,Staff,27,0,30,3
1713479429608,EDS 250,A00,507344,Hemans; Patricia Ann Benitez,28,0,40,12
1713479430646,EDS 281,A00,507345,Daly; Alan J.,18,0,18,0
1713479431679,EDS 284,A00,507350,Daly; Alan J.,16,0,16,0
1713479432706,EDS 286,A00,507359,Fine; Sarah,18,0,18,0
1713479433737,EDS 289C,A01,507361,Daly; Alan J.,18,0,18,0
1713479434766,EDS 290,A00,507366,Hofstetter; Carolyn,15,0,15,0
1713479435793,LIGM 5A,A00,507421,Fischer-Grunski; Eva K,20,0,20,0
1713479436817,LIGM 5B,A00,507423,Fischer-Grunski; Eva K,20,0,20,0
1713479437843,LIGM 5C,A00,507425,Fischer-Grunski; Eva K,20,0,20,0
1713479438869,LIIT 5AS,A00,507427,Carnelos; Chiara,20,0,20,0
1713479439894,LIIT 5BS,A00,507430,Carnelos; Chiara,20,0,20,0
1713479440919,LIIT 5CS,A00,507432,Carnelos; Chiara,20,0,20,0
1713479441945,LISP 5A,A00,507541,Munoz Sanchez; Alicia,15,0,20,5
1713479442972,LISP 5B,A00,507671,Munoz Sanchez; Alicia,12,0,20,8
1713479444003,LISP 5C,A00,507696,Munoz Sanchez; Alicia,11,0,20,9
1713479445029,MAE 197,001,528363,Boechler; Nicholas Sebastia,9998,0,9999,1
1713479446054,MATH 197,001,523477,Kedlaya; Kiran S.,9999,0,9999,0
1713479446054,MATH 197,002,563811,Zhang; Danna,9998,0,9999,1
1713479447078,MCWP 40R,A00,518780,Staff,17,0,20,3
1713479447078,MCWP 40R,B00,518781,Staff,14,0,20,6
1713479447078,MCWP 40R,C00,518783,Staff,12,0,20,8
1713479448104,MCWP 50R,A00,518791,Staff,9,0,20,11
1713479448104,MCWP 50R,B00,518792,Staff,7,0,20,13
1713479448104,MCWP 50R,C00,518793,Staff,7,0,20,13
1713479448104,MCWP 50R,D00,518794,Staff,3,0,20,17
1713479448104,MCWP 50R,E00,518795,Staff,5,0,20,15
1713479448104,MCWP 50R,F00,518796,Staff,15,0,20,5
1713479448104,MCWP 50R,G00,518797,Staff,13,0,20,7
1713479449133,MMW 12R,A01,514034,Herbst; Matthew,9,0,16,7
1713479449133,MMW 12R,A02,514035,Herbst; Matthew,14,0,16,2
1713479450158,MMW 13R,A01,514037,Staff,0,0,16,16
1713479450158,MMW 13R,A02,514039,Staff,0,0,16,16
1713479452264,SIO 295LS,A00,523233,Staff,16,0,30,14
1713479453292,SIO 295S,A00,523232,Staff,16,0,30,14
1713479454319,SOCI 117,A01,494376,Staff,0,2,5,5
1713479455343,WES 237B,A00,494380,Staff,19,0,20,1
1713479457428,AESE 279B,A00,494370,Wade; Jon P,33,0,33,0
1713479458453,AIP 197,001,627712,Vespa; Emanuel Ignacio,9999,0,9999,0
1713479459478,ANAR 135S,A00,494369,Braswell; Geoffrey E.,0,0,0,0
1713479460505,CAT 124RS,A01,519847,Geibel; William,6,0,20,14
1713479461530,CAT 125RS,A01,515971,Geibel; William,6,0,20,14
1713479462560,CLRE 250,A00,511389,Morris; Sheldon,9996,0,9999,3
1713479463595,CLRE 251,A00,507176,Mehta; Ravindra L.,9996,0,9999,3
1713479463595,CLRE 251,B00,511410,Mehta; Ravindra L.,9998,0,9999,1
1713479464621,CLRE 252,A00,507189,Cuomo; Raphael Eduardo,9998,0,9999,1
1713479465650,CLRE 253,A00,507199,Vaida; Florin,9997,0,9999,2
1713479465650,CLRE 253,B00,507202,Vaida; Florin,9999,0,9999,0
1713479466675,CLRE 259,A00,507211,Patel; Hemal,9996,0,9999,3
1713479467702,CLRE 260,A00,507221,Cuomo; Raphael Eduardo,9999,0,9999,0
1713479468727,CLRE 297,001,507242,Cuomo; Raphael Eduardo,9999,0,9999,0
1713479469756,CSE 191,A00,516875,Minnes Kemp; Mor Mia,9999,0,9999,0
1713479470786,CSS 201S,A01,494383,Staff,35,0,35,0
1713479471811,CSS 202S,A01,494387,Staff,35,0,35,0
1713479472836,EAP 100,A00,516065,Staff,9792,0,9999,207
1713479473862,ECE 45,A01,507414,Staff,40,0,60,20
1713479474887,ECE 100,A01,507416,Baghdadchi; Saharnaz,3,0,20,17
1713479474887,ECE 100,A02,507418,Baghdadchi; Saharnaz,19,0,20,1
1713479475912,ECE 111,A01,507420,Staff,28,0,50,22
1713479476937,ECE 197,001,548057,Sievenpiper; Daniel F.,9998,0,9999,1
1713479477963,EDS 115,A00,507243,Choi; Bailey Miyeon,27,0,28,1
1713479478989,EDS 117,A01,494379,Staff,16,0,25,9
1713479480019,EDS 125,A00,507246,Hopkins; Megan Beth,28,0,30,2
1713479481044,EDS 128A,A01,507264,Fargason; Sharon Gayle,26,0,26,0
1713479482069,EDS 128B,A01,507293,Pappas; Elizabeth,30,0,30,0
1713479483095,EDS 139,A00,507294,Fargason; Sharon Gayle,30,0,30,0
1713479483095,EDS 139,B00,507313,Pappas; Elizabeth,30,0,30,0
1713479484124,EDS 201,A00,507315,Staff,19,0,30,11
1713479485150,EDS 203,A01,507317,Halter; Christopher P.,18,0,30,12
1713479486176,EDS 204R,A01,507319,Halter; Christopher P.,0,1,30,30
1713479486176,EDS 204R,B01,507331,Heinzman; Erica M.,26,0,30,4
1713479487203,EDS 206R,A00,507332,Staff,0,1,30,30
1713479487203,EDS 206R,B00,507343,Staff,27,0,30,3
1713479488230,EDS 250,A00,507344,Hemans; Patricia Ann Benitez,28,0,40,12
1713479489256,EDS 281,A00,507345,Daly; Alan J.,18,0,18,0
1713479490284,EDS 284,A00,507350,Daly; Alan J.,16,0,16,0
1713479491308,EDS 286,A00,507359,Fine; Sarah,18,0,18,0
1713479492333,EDS 289C,A01,507361,Daly; Alan J.,18,0,18,0
1713479493361,EDS 290,A00,507366,Hofstetter; Carolyn,15,0,15,0
1713479494392,LIGM 5A,A00,507421,Fischer-Grunski; Eva K,20,0,20,0
1713479495416,LIGM 5B,A00,507423,Fischer-Grunski; Eva K,20,0,20,0
1713479496447,LIGM 5C,A00,507425,Fischer-Grunski; Eva K,20,0,20,0
1713479497475,LIIT 5AS,A00,507427,Carnelos; Chiara,20,0,20,0
1713479498501,LIIT 5BS,A00,507430,Carnelos; Chiara,20,0,20,0
1713479499528,LIIT 5CS,A00,507432,Carnelos; Chiara,20,0,20,0
1713479500557,LISP 5A,A00,507541,Munoz Sanchez; Alicia,15,0,20,5
1713479501581,LISP 5B,A00,507671,Munoz Sanchez; Alicia,12,0,20,8
1713479502607,LISP 5C,A00,507696,Munoz Sanchez; Alicia,11,0,20,9
1713479503632,MAE 197,001,528363,Boechler; Nicholas Sebastia,9998,0,9999,1
1713479504659,MATH 197,001,523477,Kedlaya; Kiran S.,9999,0,9999,0
1713479504659,MATH 197,002,563811,Zhang; Danna,9998,0,9999,1
1713479505689,MCWP 40R,A00,518780,Staff,17,0,20,3
1713479505689,MCWP 40R,B00,518781,Staff,14,0,20,6
1713479505689,MCWP 40R,C00,518783,Staff,12,0,20,8
1713479506713,MCWP 50R,A00,518791,Staff,9,0,20,11
1713479506713,MCWP 50R,B00,518792,Staff,7,0,20,13
1713479506713,MCWP 50R,C00,518793,Staff,7,0,20,13
1713479506713,MCWP 50R,D00,518794,Staff,3,0,20,17
1713479506713,MCWP 50R,E00,518795,Staff,5,0,20,15
1713479506713,MCWP 50R,F00,518796,Staff,15,0,20,5
1713479506713,MCWP 50R,G00,518797,Staff,13,0,20,7
1713479507743,MMW 12R,A01,514034,Herbst; Matthew,9,0,16,7
1713479507743,MMW 12R,A02,514035,Herbst; Matthew,14,0,16,2
1713479508768,MMW 13R,A01,514037,Staff,0,0,16,16
1713479508768,MMW 13R,A02,514039,Staff,0,1,16,16
1713479510819,SIO 295LS,A00,523233,Staff,16,0,30,14
1713479511847,SIO 295S,A00,523232,Staff,16,0,30,14
1713479512874,SOCI 117,A01,494376,Staff,0,2,5,5
1713479513904,WES 237B,A00,494380,Staff,19,0,20,1
1713479515986,AESE 279B,A00,494370,Wade; Jon P,33,0,33,0
1713479517011,AIP 197,001,627712,Vespa; Emanuel Ignacio,9999,0,9999,0
1713479518037,ANAR 135S,A00,494369,Braswell; Geoffrey E.,0,0,0,0
1713479519063,CAT 124RS,A01,519847,Geibel; William,6,0,20,14
1713479520092,CAT 125RS,A01,515971,Geibel; William,6,0,20,14
1713479521121,CLRE 250,A00,511389,Morris; Sheldon,9996,0,9999,3
1713479522146,CLRE 251,A00,507176,Mehta; Ravindra L.,9996,0,9999,3
1713479522146,CLRE 251,B00,511410,Mehta; Ravindra L.,9998,0,9999,1
1713479523177,CLRE 252,A00,507189,Cuomo; Raphael Eduardo,9998,0,9999,1
1713479524206,CLRE 253,A00,507199,Vaida; Florin,9997,0,9999,2
1713479524206,CLRE 253,B00,507202,Vaida; Florin,9999,0,9999,0
1713479525232,CLRE 259,A00,507211,Patel; Hemal,9996,0,9999,3
1713479526258,CLRE 260,A00,507221,Cuomo; Raphael Eduardo,9999,0,9999,0
1713479527284,CLRE 297,001,507242,Cuomo; Raphael Eduardo,9999,0,9999,0
1713479528313,CSE 191,A00,516875,Minnes Kemp; Mor Mia,9999,0,9999,0
1713479529345,CSS 201S,A01,494383,Staff,35,0,35,0
1713479530374,CSS 202S,A01,494387,Staff,35,0,35,0
1713479531400,EAP 100,A00,516065,Staff,9792,0,9999,207
1713479532425,ECE 45,A01,507414,Staff,40,0,60,20
1713479533451,ECE 100,A01,507416,Baghdadchi; Saharnaz,3,0,20,17
1713479533451,ECE 100,A02,507418,Baghdadchi; Saharnaz,19,0,20,1
1713479534477,ECE 111,A01,507420,Staff,28,0,50,22
1713479535506,ECE 197,001,548057,Sievenpiper; Daniel F.,9998,0,9999,1
1713479536535,EDS 115,A00,507243,Choi; Bailey Miyeon,27,0,28,1
1713479537559,EDS 117,A01,494379,Staff,16,0,25,9
1713479538583,EDS 125,A00,507246,Hopkins; Megan Beth,28,0,30,2
1713479539616,EDS 128A,A01,507264,Fargason; Sharon Gayle,26,0,26,0
1713479540642,EDS 128B,A01,507293,Pappas; Elizabeth,30,0,30,0
1713479541671,EDS 139,A00,507294,Fargason; Sharon Gayle,30,0,30,0
1713479541671,EDS 139,B00,507313,Pappas; Elizabeth,30,0,30,0
1713479542696,EDS 201,A00,507315,Staff,19,0,30,11
1713479543727,EDS 203,A01,507317,Halter; Christopher P.,18,0,30,12
1713479544755,EDS 204R,A01,507319,Halter; Christopher P.,0,1,30,30
1713479544755,EDS 204R,B01,507331,Heinzman; Erica M.,26,0,30,4
1713479545781,EDS 206R,A00,507332,Staff,0,1,30,30
1713479545781,EDS 206R,B00,507343,Staff,27,0,30,3
1713479546807,EDS 250,A00,507344,Hemans; Patricia Ann Benitez,28,0,40,12
1713479547834,EDS 281,A00,507345,Daly; Alan J.,18,0,18,0
1713479548863,EDS 284,A00,507350,Daly; Alan J.,16,0,16,0
1713479549892,EDS 286,A00,507359,Fine; Sarah,18,0,18,0
1713479550920,EDS 289C,A01,507361,Daly; Alan J.,18,0,18,0
1713479551948,EDS 290,A00,507366,Hofstetter; Carolyn,15,0,15,0
1713479552978,LIGM 5A,A00,507421,Fischer-Grunski; Eva K,20,0,20,0
1713479554005,LIGM 5B,A00,507423,Fischer-Grunski; Eva K,20,0,20,0
1713479555086,LIGM 5C,A00,507425,Fischer-Grunski; Eva K,20,0,20,0
1713479556112,LIIT 5AS,A00,507427,Carnelos; Chiara,20,0,20,0
1713479557140,LIIT 5BS,A00,507430,Carnelos; Chiara,20,0,20,0
1713479558166,LIIT 5CS,A00,507432,Carnelos; Chiara,20,0,20,0
1713479559192,LISP 5A,A00,507541,Munoz Sanchez; Alicia,15,0,20,5
1713479560221,LISP 5B,A00,507671,Munoz Sanchez; Alicia,12,0,20,8
1713479561246,LISP 5C,A00,507696,Munoz Sanchez; Alicia,11,0,20,9
1713479562271,MAE 197,001,528363,Boechler; Nicholas Sebastia,9998,0,9999,1
1713479563300,MATH 197,001,523477,Kedlaya; Kiran S.,9999,0,9999,0
1713479563300,MATH 197,002,563811,Zhang; Danna,9998,0,9999,1
1713479564328,MCWP 40R,A00,518780,Staff,17,0,20,3
1713479564328,MCWP 40R,B00,518781,Staff,14,0,20,6
1713479564328,MCWP 40R,C00,518783,Staff,12,0,20,8
1713479565354,MCWP 50R,A00,518791,Staff,8,0,20,12
1713479565354,MCWP 50R,B00,518792,Staff,7,0,20,13
1713479565354,MCWP 50R,C00,518793,Staff,7,0,20,13
1713479565354,MCWP 50R,D00,518794,Staff,3,0,20,17
1713479565354,MCWP 50R,E00,518795,Staff,5,0,20,15
1713479565354,MCWP 50R,F00,518796,Staff,15,0,20,5
1713479565354,MCWP 50R,G00,518797,Staff,13,0,20,7
1713479566384,MMW 12R,A01,514034,Herbst; Matthew,9,0,16,7
1713479566384,MMW 12R,A02,514035,Herbst; Matthew,14,0,16,2
1713479567412,MMW 13R,A01,514037,Staff,0,0,16,16
1713479567412,MMW 13R,A02,514039,Staff,0,1,16,16
1713479569463,SIO 295LS,A00,523233,Staff,16,0,30,14
1713479570492,SIO 295S,A00,523232,Staff,16,0,30,14
1713479571518,SOCI 117,A01,494376,Staff,0,2,5,5
1713479572544,WES 237B,A00,494380,Staff,19,0,20,1
1713479574621,AESE 279B,A00,494370,Wade; Jon P,33,0,33,0
1713479575644,AIP 197,001,627712,Vespa; Emanuel Ignacio,9999,0,9999,0
1713479576670,ANAR 135S,A00,494369,Braswell; Geoffrey E.,0,0,0,0
1713479577704,CAT 124RS,A01,519847,Geibel; William,6,0,20,14
1713479578732,CAT 125RS,A01,515971,Geibel; William,6,0,20,14
1713479579905,CLRE 250,A00,511389,Morris; Sheldon,9996,0,9999,3
1713479580932,CLRE 251,A00,507176,Mehta; Ravindra L.,9996,0,9999,3
1713479580932,CLRE 251,B00,511410,Mehta; Ravindra L.,9998,0,9999,1
1713479581962,CLRE 252,A00,507189,Cuomo; Raphael Eduardo,9998,0,9999,1
1713479582988,CLRE 253,A00,507199,Vaida; Florin,9997,0,9999,2
1713479582988,CLRE 253,B00,507202,Vaida; Florin,9999,0,9999,0
1713479584015,CLRE 259,A00,507211,Patel; Hemal,9996,0,9999,3
1713479585044,CLRE 260,A00,507221,Cuomo; Raphael Eduardo,9999,0,9999,0
1713479586069,CLRE 297,001,507242,Cuomo; Raphael Eduardo,9999,0,9999,0
1713479587093,CSE 191,A00,516875,Minnes Kemp; Mor Mia,9999,0,9999,0
1713479588118,CSS 201S,A01,494383,Staff,35,0,35,0
1713479589148,CSS 202S,A01,494387,Staff,35,0,35,0
1713479590175,EAP 100,A00,516065,Staff,9792,0,9999,207
1713479591201,ECE 45,A01,507414,Staff,40,0,60,20
1713479592232,ECE 100,A01,507416,Baghdadchi; Saharnaz,3,0,20,17
1713479592232,ECE 100,A02,507418,Baghdadchi; Saharnaz,19,0,20,1
1713479593258,ECE 111,A01,507420,Staff,28,0,50,22
1713479594286,ECE 197,001,548057,Sievenpiper; Daniel F.,9998,0,9999,1
1713479595316,EDS 115,A00,507243,Choi; Bailey Miyeon,27,0,28,1
1713479596342,EDS 117,A01,494379,Staff,16,0,25,9
1713479597370,EDS 125,A00,507246,Hopkins; Megan Beth,28,0,30,2
1713479598397,EDS 128A,A01,507264,Fargason; Sharon Gayle,26,0,26,0
1713479599421,EDS 128B,A01,507293,Pappas; Elizabeth,30,0,30,0
1713479600450,EDS 139,A00,507294,Fargason; Sharon Gayle,30,0,30,0
1713479600450,EDS 139,B00,507313,Pappas; Elizabeth,30,0,30,0
1713479601478,EDS 201,A00,507315,Staff,19,0,30,11
1713479602504,EDS 203,A01,507317,Halter; Christopher P.,18,0,30,12
1713479603530,EDS 204R,A01,507319,Halter; Christopher P.,0,1,30,30
1713479603530,EDS 204R,B01,507331,Heinzman; Erica M.,26,0,30,4
1713479604557,EDS 206R,A00,507332,Staff,0,1,30,30
1713479604557,EDS 206R,B00,507343,Staff,27,0,30,3
1713479605582,EDS 250,A00,507344,Hemans; Patricia Ann Benitez,28,0,40,12
1713479606607,EDS 281,A00,507345,Daly; Alan J.,18,0,18,0
1713479607665,EDS 284,A00,507350,Daly; Alan J.,16,0,16,0
1713479608691,EDS 286,A00,507359,Fine; Sarah,18,0,18,0
1713479609716,EDS 289C,A01,507361,Daly; Alan J.,18,0,18,0
1713479610742,EDS 290,A00,507366,Hofstetter; Carolyn,15,0,15,0
1713479611768,LIGM 5A,A00,507421,Fischer-Grunski; Eva K,20,0,20,0
1713479612799,LIGM 5B,A00,507423,Fischer-Grunski; Eva K,20,0,20,0
1713479613824,LIGM 5C,A00,507425,Fischer-Grunski; Eva K,20,0,20,0
1713479614850,LIIT 5AS,A00,507427,Carnelos; Chiara,20,0,20,0
1713479615879,LIIT 5BS,A00,507430,Carnelos; Chiara,20,0,20,0
1713479616904,LIIT 5CS,A00,507432,Carnelos; Chiara,20,0,20,0
1713479617931,LISP 5A,A00,507541,Munoz Sanchez; Alicia,15,0,20,5
1713479618960,LISP 5B,A00,507671,Munoz Sanchez; Alicia,12,0,20,8
1713479619988,LISP 5C,A00,507696,Munoz Sanchez; Alicia,11,0,20,9
1713479621013,MAE 197,001,528363,Boechler; Nicholas Sebastia,9998,0,9999,1
1713479622039,MATH 197,001,523477,Kedlaya; Kiran S.,9999,0,9999,0
1713479622039,MATH 197,002,563811,Zhang; Danna,9998,0,9999,1
1713479623064,MCWP 40R,A00,518780,Staff,17,0,20,3
1713479623064,MCWP 40R,B00,518781,Staff,14,0,20,6
1713479623064,MCWP 40R,C00,518783,Staff,12,0,20,8
1713479624089,MCWP 50R,A00,518791,Staff,8,0,20,12
1713479624089,MCWP 50R,B00,518792,Staff,7,0,20,13
1713479624089,MCWP 50R,C00,518793,Staff,7,0,20,13
1713479624089,MCWP 50R,D00,518794,Staff,3,0,20,17
1713479624089,MCWP 50R,E00,518795,Staff,5,0,20,15
1713479624089,MCWP 50R,F00,518796,Staff,15,0,20,5
1713479624089,MCWP 50R,G00,518797,Staff,13,0,20,7
1713479625115,MMW 12R,A01,514034,Herbst; Matthew,9,0,16,7
1713479625115,MMW 12R,A02,514035,Herbst; Matthew,14,0,16,2
1713479626144,MMW 13R,A01,514037,Staff,0,0,16,16
1713479626144,MMW 13R,A02,514039,Staff,0,1,16,16
1713479628203,SIO 295LS,A00,523233,Staff,16,0,30,14
1713479629230,SIO 295S,A00,523232,Staff,16,0,30,14
1713479630255,SOCI 117,A01,494376,Staff,0,2,5,5
1713479631284,WES 237B,A00,494380,Staff,19,0,20,1
1713479633352,AESE 279B,A00,494370,Wade; Jon P,33,0,33,0
1713479634377,AIP 197,001,627712,Vespa; Emanuel Ignacio,9999,0,9999,0
1713479635403,ANAR 135S,A00,494369,Braswell; Geoffrey E.,0,0,0,0
1713479636433,CAT 124RS,A01,519847,Geibel; William,6,0,20,14
1713479637460,CAT 125RS,A01,515971,Geibel; William,6,0,20,14
1713479638485,CLRE 250,A00,511389,Morris; Sheldon,9996,0,9999,3
1713479639517,CLRE 251,A00,507176,Mehta; Ravindra L.,9996,0,9999,3
1713479639517,CLRE 251,B00,511410,Mehta; Ravindra L.,9998,0,9999,1
1713479640550,CLRE 252,A00,507189,Cuomo; Raphael Eduardo,9998,0,9999,1
1713479641575,CLRE 253,A00,507199,Vaida; Florin,9997,0,9999,2
1713479641575,CLRE 253,B00,507202,Vaida; Florin,9999,0,9999,0
1713479642600,CLRE 259,A00,507211,Patel; Hemal,9996,0,9999,3
1713479643628,CLRE 260,A00,507221,Cuomo; Raphael Eduardo,9999,0,9999,0
1713479644656,CLRE 297,001,507242,Cuomo; Raphael Eduardo,9999,0,9999,0
1713479645685,CSE 191,A00,516875,Minnes Kemp; Mor Mia,9999,0,9999,0
1713479646710,CSS 201S,A01,494383,Staff,35,0,35,0
1713479647734,CSS 202S,A01,494387,Staff,35,0,35,0
1713479648761,EAP 100,A00,516065,Staff,9792,0,9999,207
1713479649788,ECE 45,A01,507414,Staff,40,0,60,20
1713479650817,ECE 100,A01,507416,Baghdadchi; Saharnaz,3,0,20,17
1713479650817,ECE 100,A02,507418,Baghdadchi; Saharnaz,19,0,20,1
1713479651847,ECE 111,A01,507420,Staff,28,0,50,22
1713479652875,ECE 197,001,548057,Sievenpiper; Daniel F.,9998,0,9999,1
1713479653905,EDS 115,A00,507243,Choi; Bailey Miyeon,27,0,28,1
1713479654933,EDS 117,A01,494379,Staff,16,0,25,9
1713479655957,EDS 125,A00,507246,Hopkins; Megan Beth,28,0,30,2
1713479656984,EDS 128A,A01,507264,Fargason; Sharon Gayle,26,0,26,0
1713479658014,EDS 128B,A01,507293,Pappas; Elizabeth,30,0,30,0
1713479659116,EDS 139,A00,507294,Fargason; Sharon Gayle,30,0,30,0
1713479659116,EDS 139,B00,507313,Pappas; Elizabeth,30,0,30,0
1713479660142,EDS 201,A00,507315,Staff,19,0,30,11
1713479661171,EDS 203,A01,507317,Halter; Christopher P.,18,0,30,12
1713479662197,EDS 204R,A01,507319,Halter; Christopher P.,0,1,30,30
1713479662197,EDS 204R,B01,507331,Heinzman; Erica M.,26,0,30,4
1713479663221,EDS 206R,A00,507332,Staff,0,1,30,30
1713479663221,EDS 206R,B00,507343,Staff,27,0,30,3
1713479664247,EDS 250,A00,507344,Hemans; Patricia Ann Benitez,28,0,40,12
1713479665278,EDS 281,A00,507345,Daly; Alan J.,18,0,18,0
1713479666303,EDS 284,A00,507350,Daly; Alan J.,16,0,16,0
1713479667329,EDS 286,A00,507359,Fine; Sarah,18,0,18,0
1713479668358,EDS 289C,A01,507361,Daly; Alan J.,18,0,18,0
1713479669387,EDS 290,A00,507366,Hofstetter; Carolyn,15,0,15,0
1713479670419,LIGM 5A,A00,507421,Fischer-Grunski; Eva K,20,0,20,0
1713479671445,LIGM 5B,A00,507423,Fischer-Grunski; Eva K,20,0,20,0
1713479672472,LIGM 5C,A00,507425,Fischer-Grunski; Eva K,20,0,20,0
1713479673498,LIIT 5AS,A00,507427,Carnelos; Chiara,20,0,20,0
1713479674526,LIIT 5BS,A00,507430,Carnelos; Chiara,20,0,20,0
1713479675552,LIIT 5CS,A00,507432,Carnelos; Chiara,20,0,20,0
1713479676583,LISP 5A,A00,507541,Munoz Sanchez; Alicia,15,0,20,5
1713479677607,LISP 5B,A00,507671,Munoz Sanchez; Alicia,12,0,20,8
1713479678631,LISP 5C,A00,507696,Munoz Sanchez; Alicia,11,0,20,9
1713479679660,MAE 197,001,528363,Boechler; Nicholas Sebastia,9998,0,9999,1
1713479680686,MATH 197,001,523477,Kedlaya; Kiran S.,9999,0,9999,0
1713479680686,MATH 197,002,563811,Zhang; Danna,9998,0,9999,1
1713479681713,MCWP 40R,A00,518780,Staff,17,0,20,3
1713479681713,MCWP 40R,B00,518781,Staff,14,0,20,6
1713479681713,MCWP 40R,C00,518783,Staff,12,0,20,8
1713479682739,MCWP 50R,A00,518791,Staff,8,0,20,12
1713479682739,MCWP 50R,B00,518792,Staff,7,0,20,13
1713479682739,MCWP 50R,C00,518793,Staff,7,0,20,13
1713479682739,MCWP 50R,D00,518794,Staff,3,0,20,17
1713479682739,MCWP 50R,E00,518795,Staff,5,0,20,15
1713479682739,MCWP 50R,F00,518796,Staff,15,0,20,5
1713479682739,MCWP 50R,G00,518797,Staff,13,0,20,7
1713479683766,MMW 12R,A01,514034,Herbst; Matthew,9,0,16,7
1713479683766,MMW 12R,A02,514035,Herbst; Matthew,14,0,16,2
1713479684793,MMW 13R,A01,514037,Staff,0,0,16,16
1713479684793,MMW 13R,A02,514039,Staff,0,1,16,16
1713479686848,SIO 295LS,A00,523233,Staff,16,0,30,14
1713479687876,SIO 295S,A00,523232,Staff,16,0,30,14
1713479688906,SOCI 117,A01,494376,Staff,0,2,5,5
1713479689935,WES 237B,A00,494380,Staff,19,0,20,1
1713479692005,AESE 279B,A00,494370,Wade; Jon P,33,0,33,0
1713479693029,AIP 197,001,627712,Vespa; Emanuel Ignacio,9999,0,9999,0
1713479694054,ANAR 135S,A00,494369,Braswell; Geoffrey E.,0,0,0,0
1713479695081,CAT 124RS,A01,519847,Geibel; William,6,0,20,14
1713479696107,CAT 125RS,A01,515971,Geibel; William,6,0,20,14
1713479697134,CLRE 250,A00,511389,Morris; Sheldon,9996,0,9999,3
1713479698161,CLRE 251,A00,507176,Mehta; Ravindra L.,9996,0,9999,3
1713479698161,CLRE 251,B00,511410,Mehta; Ravindra L.,9998,0,9999,1
1713479699186,CLRE 252,A00,507189,Cuomo; Raphael Eduardo,9998,0,9999,1
1713479700211,CLRE 253,A00,507199,Vaida; Florin,9997,0,9999,2
1713479700211,CLRE 253,B00,507202,Vaida; Florin,9999,0,9999,0
1713479701235,CLRE 259,A00,507211,Patel; Hemal,9996,0,9999,3
1713479702262,CLRE 260,A00,507221,Cuomo; Raphael Eduardo,9999,0,9999,0
1713479703286,CLRE 297,001,507242,Cuomo; Raphael Eduardo,9999,0,9999,0
1713479704314,CSE 191,A00,516875,Minnes Kemp; Mor Mia,9999,0,9999,0
1713479705344,CSS 201S,A01,494383,Staff,35,0,35,0
1713479706370,CSS 202S,A01,494387,Staff,35,0,35,0
1713479707398,EAP 100,A00,516065,Staff,9792,0,9999,207
1713479708430,ECE 45,A01,507414,Staff,40,0,60,20
1713479709455,ECE 100,A01,507416,Baghdadchi; Saharnaz,3,0,20,17
1713479709455,ECE 100,A02,507418,Baghdadchi; Saharnaz,19,0,20,1
1713479710479,ECE 111,A01,507420,Staff,28,0,50,22
1713479711507,ECE 197,001,548057,Sievenpiper; Daniel F.,9998,0,9999,1
1713479712537,EDS 115,A00,507243,Choi; Bailey Miyeon,27,0,28,1
1713479713561,EDS 117,A01,494379,Staff,16,0,25,9
1713479714589,EDS 125,A00,507246,Hopkins; Megan Beth,28,0,30,2
1713479715614,EDS 128A,A01,507264,Fargason; Sharon Gayle,26,0,26,0
1713479716642,EDS 128B,A01,507293,Pappas; Elizabeth,30,0,30,0
1713479717671,EDS 139,A00,507294,Fargason; Sharon Gayle,30,0,30,0
1713479717671,EDS 139,B00,507313,Pappas; Elizabeth,30,0,30,0
1713479718697,EDS 201,A00,507315,Staff,19,0,30,11
1713479719728,EDS 203,A01,507317,Halter; Christopher P.,18,0,30,12
1713479720754,EDS 204R,A01,507319,Halter; Christopher P.,0,1,30,30
1713479720754,EDS 204R,B01,507331,Heinzman; Erica M.,26,0,30,4
1713479721779,EDS 206R,A00,507332,Staff,0,1,30,30
1713479721779,EDS 206R,B00,507343,Staff,27,0,30,3
1713479722804,EDS 250,A00,507344,Hemans; Patricia Ann Benitez,28,0,40,12
1713479723833,EDS 281,A00,507345,Daly; Alan J.,18,0,18,0
1713479724865,EDS 284,A00,507350,Daly; Alan J.,16,0,16,0
1713479725892,EDS 286,A00,507359,Fine; Sarah,18,0,18,0
1713479726919,EDS 289C,A01,507361,Daly; Alan J.,18,0,18,0
1713479727944,EDS 290,A00,507366,Hofstetter; Carolyn,15,0,15,0
1713479728973,LIGM 5A,A00,507421,Fischer-Grunski; Eva K,20,0,20,0
1713479730003,LIGM 5B,A00,507423,Fischer-Grunski; Eva K,20,0,20,0
1713479731033,LIGM 5C,A00,507425,Fischer-Grunski; Eva K,20,0,20,0
1713479732058,LIIT 5AS,A00,507427,Carnelos; Chiara,20,0,20,0
1713479733087,LIIT 5BS,A00,507430,Carnelos; Chiara,20,0,20,0
1713479734114,LIIT 5CS,A00,507432,Carnelos; Chiara,20,0,20,0
1713479735144,LISP 5A,A00,507541,Munoz Sanchez; Alicia,15,0,20,5
1713479736173,LISP 5B,A00,507671,Munoz Sanchez; Alicia,12,0,20,8
1713479737199,LISP 5C,A00,507696,Munoz Sanchez; Alicia,11,0,20,9
1713479738225,MAE 197,001,528363,Boechler; Nicholas Sebastia,9998,0,9999,1
1713479739250,MATH 197,001,523477,Kedlaya; Kiran S.,9999,0,9999,0
1713479739250,MATH 197,002,563811,Zhang; Danna,9998,0,9999,1
1713479740277,MCWP 40R,A00,518780,Staff,17,0,20,3
1713479740277,MCWP 40R,B00,518781,Staff,14,0,20,6
1713479740277,MCWP 40R,C00,518783,Staff,12,0,20,8
1713479741302,MCWP 50R,A00,518791,Staff,8,0,20,12
1713479741302,MCWP 50R,B00,518792,Staff,7,0,20,13
1713479741302,MCWP 50R,C00,518793,Staff,7,0,20,13
1713479741302,MCWP 50R,D00,518794,Staff,3,0,20,17
1713479741302,MCWP 50R,E00,518795,Staff,5,0,20,15
1713479741302,MCWP 50R,F00,518796,Staff,15,0,20,5
1713479741302,MCWP 50R,G00,518797,Staff,13,0,20,7
1713479742329,MMW 12R,A01,514034,Herbst; Matthew,9,0,16,7
1713479742329,MMW 12R,A02,514035,Herbst; Matthew,14,0,16,2
1713479743356,MMW 13R,A01,514037,Staff,0,0,16,16
1713479743356,MMW 13R,A02,514039,Staff,0,1,16,16
1713479745412,SIO 295LS,A00,523233,Staff,16,0,30,14
1713479746440,SIO 295S,A00,523232,Staff,16,0,30,14
1713479747465,SOCI 117,A01,494376,Staff,0,2,5,5
1713479748493,WES 237B,A00,494380,Staff,19,0,20,1
1713479750564,AESE 279B,A00,494370,Wade; Jon P,33,0,33,0
1713479751595,AIP 197,001,627712,Vespa; Emanuel Ignacio,9999,0,9999,0
1713479752620,ANAR 135S,A00,494369,Braswell; Geoffrey E.,0,0,0,0
1713479753649,CAT 124RS,A01,519847,Geibel; William,6,0,20,14
1713479754675,CAT 125RS,A01,515971,Geibel; William,6,0,20,14
1713479755700,CLRE 250,A00,511389,Morris; Sheldon,9996,0,9999,3
1713479756725,CLRE 251,A00,507176,Mehta; Ravindra L.,9996,0,9999,3
1713479756725,CLRE 251,B00,511410,Mehta; Ravindra L.,9998,0,9999,1
1713479757756,CLRE 252,A00,507189,Cuomo; Raphael Eduardo,9998,0,9999,1
1713479758781,CLRE 253,A00,507199,Vaida; Florin,9997,0,9999,2
1713479758781,CLRE 253,B00,507202,Vaida; Florin,9999,0,9999,0
1713479759806,CLRE 259,A00,507211,Patel; Hemal,9996,0,9999,3
1713479760832,CLRE 260,A00,507221,Cuomo; Raphael Eduardo,9999,0,9999,0
1713479761860,CLRE 297,001,507242,Cuomo; Raphael Eduardo,9999,0,9999,0
1713479762941,CSE 191,A00,516875,Minnes Kemp; Mor Mia,9999,0,9999,0
1713479763968,CSS 201S,A01,494383,Staff,35,0,35,0
1713479764994,CSS 202S,A01,494387,Staff,35,0,35,0
1713479766021,EAP 100,A00,516065,Staff,9792,0,9999,207
1713479767046,ECE 45,A01,507414,Staff,40,0,60,20
1713479768078,ECE 100,A01,507416,Baghdadchi; Saharnaz,3,0,20,17
1713479768078,ECE 100,A02,507418,Baghdadchi; Saharnaz,19,0,20,1
1713479769104,ECE 111,A01,507420,Staff,28,0,50,22
1713479770132,ECE 197,001,548057,Sievenpiper; Daniel F.,9998,0,9999,1
1713479771164,EDS 115,A00,507243,Choi; Bailey Miyeon,27,0,28,1
1713479772192,EDS 117,A01,494379,Staff,16,0,25,9
1713479773225,EDS 125,A00,507246,Hopkins; Megan Beth,28,0,30,2
1713479774256,EDS 128A,A01,507264,Fargason; Sharon Gayle,26,0,26,0
1713479775288,EDS 128B,A01,507293,Pappas; Elizabeth,30,0,30,0
1713479776314,EDS 139,A00,507294,Fargason; Sharon Gayle,30,0,30,0
1713479776314,EDS 139,B00,507313,Pappas; Elizabeth,30,0,30,0
1713479777339,EDS 201,A00,507315,Staff,19,0,30,11
1713479778365,EDS 203,A01,507317,Halter; Christopher P.,18,0,30,12
1713479779397,EDS 204R,A01,507319,Halter; Christopher P.,0,1,30,30
1713479779397,EDS 204R,B01,507331,Heinzman; Erica M.,26,0,30,4
1713479780465,EDS 206R,A00,507332,Staff,0,1,30,30
1713479780465,EDS 206R,B00,507343,Staff,27,0,30,3
1713479781505,EDS 250,A00,507344,Hemans; Patricia Ann Benitez,28,0,40,12
1713479782534,EDS 281,A00,507345,Daly; Alan J.,18,0,18,0
1713479783562,EDS 284,A00,507350,Daly; Alan J.,16,0,16,0
1713479784585,EDS 286,A00,507359,Fine; Sarah,18,0,18,0
1713479785613,EDS 289C,A01,507361,Daly; Alan J.,18,0,18,0
1713479786656,EDS 290,A00,507366,Hofstetter; Carolyn,15,0,15,0
1713479787688,LIGM 5A,A00,507421,Fischer-Grunski; Eva K,20,0,20,0
1713479788717,LIGM 5B,A00,507423,Fischer-Grunski; Eva K,20,0,20,0
1713479789744,LIGM 5C,A00,507425,Fischer-Grunski; Eva K,20,0,20,0
1713479790774,LIIT 5AS,A00,507427,Carnelos; Chiara,20,0,20,0
1713479791800,LIIT 5BS,A00,507430,Carnelos; Chiara,20,0,20,0
1713479792825,LIIT 5CS,A00,507432,Carnelos; Chiara,20,0,20,0
1713479793862,LISP 5A,A00,507541,Munoz Sanchez; Alicia,15,0,20,5
1713479794888,LISP 5B,A00,507671,Munoz Sanchez; Alicia,12,0,20,8
1713479795914,LISP 5C,A00,507696,Munoz Sanchez; Alicia,11,0,20,9
1713479796939,MAE 197,001,528363,Boechler; Nicholas Sebastia,9998,0,9999,1
1713479797966,MATH 197,001,523477,Kedlaya; Kiran S.,9999,0,9999,0
1713479797966,MATH 197,002,563811,Zhang; Danna,9998,0,9999,1
1713479798995,MCWP 40R,A00,518780,Staff,17,0,20,3
1713479798995,MCWP 40R,B00,518781,Staff,14,0,20,6
1713479798995,MCWP 40R,C00,518783,Staff,12,0,20,8
1713479800026,MCWP 50R,A00,518791,Staff,8,0,20,12
1713479800026,MCWP 50R,B00,518792,Staff,7,0,20,13
1713479800026,MCWP 50R,C00,518793,Staff,7,0,20,13
1713479800026,MCWP 50R,D00,518794,Staff,3,0,20,17
1713479800026,MCWP 50R,E00,518795,Staff,5,0,20,15
1713479800026,MCWP 50R,F00,518796,Staff,15,0,20,5
1713479800026,MCWP 50R,G00,518797,Staff,13,0,20,7
1713479801052,MMW 12R,A01,514034,Herbst; Matthew,9,0,16,7
1713479801052,MMW 12R,A02,514035,Herbst; Matthew,14,0,16,2
1713479802078,MMW 13R,A01,514037,Staff,0,0,16,16
1713479802078,MMW 13R,A02,514039,Staff,0,1,16,16
1713479804129,SIO 295LS,A00,523233,Staff,16,0,30,14
1713479805155,SIO 295S,A00,523232,Staff,16,0,30,14
1713479806185,SOCI 117,A01,494376,Staff,0,2,5,5
1713479807213,WES 237B,A00,494380,Staff,19,0,20,1
1713479809278,AESE 279B,A00,494370,Wade; Jon P,33,0,33,0
1713479810307,AIP 197,001,627712,Vespa; Emanuel Ignacio,9999,0,9999,0
1713479811332,ANAR 135S,A00,494369,Braswell; Geoffrey E.,0,0,0,0
1713479812357,CAT 124RS,A01,519847,Geibel; William,6,0,20,14
1713479813382,CAT 125RS,A01,515971,Geibel; William,6,0,20,14
1713479814409,CLRE 250,A00,511389,Morris; Sheldon,9996,0,9999,3
1713479815435,CLRE 251,A00,507176,Mehta; Ravindra L.,9996,0,9999,3
1713479815435,CLRE 251,B00,511410,Mehta; Ravindra L.,9998,0,9999,1
1713479816464,CLRE 252,A00,507189,Cuomo; Raphael Eduardo,9998,0,9999,1
1713479817493,CLRE 253,A00,507199,Vaida; Florin,9997,0,9999,2
1713479817493,CLRE 253,B00,507202,Vaida; Florin,9999,0,9999,0
1713479818518,CLRE 259,A00,507211,Patel; Hemal,9996,0,9999,3
1713479819545,CLRE 260,A00,507221,Cuomo; Raphael Eduardo,9999,0,9999,0
1713479820578,CLRE 297,001,507242,Cuomo; Raphael Eduardo,9999,0,9999,0
1713479821604,CSE 191,A00,516875,Minnes Kemp; Mor Mia,9999,0,9999,0
1713479822629,CSS 201S,A01,494383,Staff,35,0,35,0
1713479823656,CSS 202S,A01,494387,Staff,35,0,35,0
1713479824680,EAP 100,A00,516065,Staff,9792,0,9999,207
1713479825705,ECE 45,A01,507414,Staff,40,0,60,20
1713479826733,ECE 100,A01,507416,Baghdadchi; Saharnaz,3,0,20,17
1713479826733,ECE 100,A02,507418,Baghdadchi; Saharnaz,19,0,20,1
1713479827759,ECE 111,A01,507420,Staff,28,0,50,22
1713479828786,ECE 197,001,548057,Sievenpiper; Daniel F.,9998,0,9999,1
1713479829818,EDS 115,A00,507243,Choi; Bailey Miyeon,27,0,28,1
1713479830844,EDS 117,A01,494379,Staff,16,0,25,9
1713479831874,EDS 125,A00,507246,Hopkins; Megan Beth,28,0,30,2
1713479832904,EDS 128A,A01,507264,Fargason; Sharon Gayle,26,0,26,0
1713479833932,EDS 128B,A01,507293,Pappas; Elizabeth,30,0,30,0
1713479834959,EDS 139,A00,507294,Fargason; Sharon Gayle,30,0,30,0
1713479834959,EDS 139,B00,507313,Pappas; Elizabeth,30,0,30,0
1713479835984,EDS 201,A00,507315,Staff,19,0,30,11
1713479837009,EDS 203,A01,507317,Halter; Christopher P.,18,0,30,12
1713479838038,EDS 204R,A01,507319,Halter; Christopher P.,0,1,30,30
1713479838038,EDS 204R,B01,507331,Heinzman; Erica M.,26,0,30,4
1713479839065,EDS 206R,A00,507332,Staff,0,1,30,30
1713479839065,EDS 206R,B00,507343,Staff,27,0,30,3
1713479840090,EDS 250,A00,507344,Hemans; Patricia Ann Benitez,28,0,40,12
1713479841114,EDS 281,A00,507345,Daly; Alan J.,18,0,18,0
1713479842140,EDS 284,A00,507350,Daly; Alan J.,16,0,16,0
1713479843166,EDS 286,A00,507359,Fine; Sarah,18,0,18,0
1713479844190,EDS 289C,A01,507361,Daly; Alan J.,18,0,18,0
1713479845219,EDS 290,A00,507366,Hofstetter; Carolyn,15,0,15,0
1713479846245,LIGM 5A,A00,507421,Fischer-Grunski; Eva K,20,0,20,0
1713479847276,LIGM 5B,A00,507423,Fischer-Grunski; Eva K,20,0,20,0
1713479848304,LIGM 5C,A00,507425,Fischer-Grunski; Eva K,20,0,20,0
1713479849330,LIIT 5AS,A00,507427,Carnelos; Chiara,20,0,20,0
1713479850360,LIIT 5BS,A00,507430,Carnelos; Chiara,20,0,20,0
1713479851385,LIIT 5CS,A00,507432,Carnelos; Chiara,20,0,20,0
1713479852414,LISP 5A,A00,507541,Munoz Sanchez; Alicia,15,0,20,5
1713479853440,LISP 5B,A00,507671,Munoz Sanchez; Alicia,12,0,20,8
1713479854463,LISP 5C,A00,507696,Munoz Sanchez; Alicia,11,0,20,9
1713479855490,MAE 197,001,528363,Boechler; Nicholas Sebastia,9998,0,9999,1
1713479856525,MATH 197,001,523477,Kedlaya; Kiran S.,9999,0,9999,0
1713479856525,MATH 197,002,563811,Zhang; Danna,9998,0,9999,1
1713479857550,MCWP 40R,A00,518780,Staff,17,0,20,3
1713479857550,MCWP 40R,B00,518781,Staff,14,0,20,6
1713479857550,MCWP 40R,C00,518783,Staff,12,0,20,8
1713479858576,MCWP 50R,A00,518791,Staff,8,0,20,12
1713479858576,MCWP 50R,B00,518792,Staff,7,0,20,13
1713479858576,MCWP 50R,C00,518793,Staff,7,0,20,13
1713479858576,MCWP 50R,D00,518794,Staff,3,0,20,17
1713479858576,MCWP 50R,E00,518795,Staff,5,0,20,15
1713479858576,MCWP 50R,F00,518796,Staff,15,0,20,5
1713479858576,MCWP 50R,G00,518797,Staff,13,0,20,7
1713479859602,MMW 12R,A01,514034,Herbst; Matthew,9,0,16,7
1713479859602,MMW 12R,A02,514035,Herbst; Matthew,14,0,16,2
1713479860627,MMW 13R,A01,514037,Staff,0,0,16,16
1713479860627,MMW 13R,A02,514039,Staff,0,1,16,16
1713479862676,SIO 295LS,A00,523233,Staff,16,0,30,14
1713479863704,SIO 295S,A00,523232,Staff,16,0,30,14
1713479864730,SOCI 117,A01,494376,Staff,0,2,5,5
1713479865757,WES 237B,A00,494380,Staff,19,0,20,1
1713479867879,AESE 279B,A00,494370,Wade; Jon P,33,0,33,0
1713479868904,AIP 197,001,627712,Vespa; Emanuel Ignacio,9999,0,9999,0
1713479869928,ANAR 135S,A00,494369,Braswell; Geoffrey E.,0,0,0,0
1713479870955,CAT 124RS,A01,519847,Geibel; William,6,0,20,14
1713479871980,CAT 125RS,A01,515971,Geibel; William,6,0,20,14
1713479873006,CLRE 250,A00,511389,Morris; Sheldon,9996,0,9999,3
1713479874031,CLRE 251,A00,507176,Mehta; Ravindra L.,9996,0,9999,3
1713479874031,CLRE 251,B00,511410,Mehta; Ravindra L.,9998,0,9999,1
1713479875058,CLRE 252,A00,507189,Cuomo; Raphael Eduardo,9998,0,9999,1
1713479876088,CLRE 253,A00,507199,Vaida; Florin,9997,0,9999,2
1713479876088,CLRE 253,B00,507202,Vaida; Florin,9999,0,9999,0
1713479877112,CLRE 259,A00,507211,Patel; Hemal,9996,0,9999,3
1713479878138,CLRE 260,A00,507221,Cuomo; Raphael Eduardo,9999,0,9999,0
1713479879164,CLRE 297,001,507242,Cuomo; Raphael Eduardo,9999,0,9999,0
1713479880193,CSE 191,A00,516875,Minnes Kemp; Mor Mia,9999,0,9999,0
1713479881220,CSS 201S,A01,494383,Staff,35,0,35,0
1713479882250,CSS 202S,A01,494387,Staff,35,0,35,0
1713479883274,EAP 100,A00,516065,Staff,9792,0,9999,207
1713479884299,ECE 45,A01,507414,Staff,40,0,60,20
1713479885325,ECE 100,A01,507416,Baghdadchi; Saharnaz,3,0,20,17
1713479885325,ECE 100,A02,507418,Baghdadchi; Saharnaz,19,0,20,1
1713479886350,ECE 111,A01,507420,Staff,28,0,50,22
1713479887376,ECE 197,001,548057,Sievenpiper; Daniel F.,9998,0,9999,1
1713479888405,EDS 115,A00,507243,Choi; Bailey Miyeon,27,0,28,1
1713479889430,EDS 117,A01,494379,Staff,16,0,25,9
1713479890460,EDS 125,A00,507246,Hopkins; Megan Beth,28,0,30,2
1713479891486,EDS 128A,A01,507264,Fargason; Sharon Gayle,26,0,26,0
1713479892512,EDS 128B,A01,507293,Pappas; Elizabeth,30,0,30,0
1713479893538,EDS 139,A00,507294,Fargason; Sharon Gayle,30,0,30,0
1713479893538,EDS 139,B00,507313,Pappas; Elizabeth,30,0,30,0
1713479894566,EDS 201,A00,507315,Staff,19,0,30,11
1713479895591,EDS 203,A01,507317,Halter; Christopher P.,18,0,30,12
1713479896620,EDS 204R,A01,507319,Halter; Christopher P.,0,1,30,30
1713479896620,EDS 204R,B01,507331,Heinzman; Erica M.,26,0,30,4
1713479897649,EDS 206R,A00,507332,Staff,0,1,30,30
1713479897649,EDS 206R,B00,507343,Staff,27,0,30,3
1713479898675,EDS 250,A00,507344,Hemans; Patricia Ann Benitez,28,0,40,12
1713479899702,EDS 281,A00,507345,Daly; Alan J.,18,0,18,0
1713479900727,EDS 284,A00,507350,Daly; Alan J.,16,0,16,0
1713479901754,EDS 286,A00,507359,Fine; Sarah,18,0,18,0
1713479902781,EDS 289C,A01,507361,Daly; Alan J.,18,0,18,0
1713479903810,EDS 290,A00,507366,Hofstetter; Carolyn,15,0,15,0
1713479904843,LIGM 5A,A00,507421,Fischer-Grunski; Eva K,20,0,20,0
1713479905872,LIGM 5B,A00,507423,Fischer-Grunski; Eva K,20,0,20,0
1713479906898,LIGM 5C,A00,507425,Fischer-Grunski; Eva K,20,0,20,0
1713479907929,LIIT 5AS,A00,507427,Carnelos; Chiara,20,0,20,0
1713479908958,LIIT 5BS,A00,507430,Carnelos; Chiara,20,0,20,0
1713479909988,LIIT 5CS,A00,507432,Carnelos; Chiara,20,0,20,0
1713479911013,LISP 5A,A00,507541,Munoz Sanchez; Alicia,15,0,20,5
1713479912039,LISP 5B,A00,507671,Munoz Sanchez; Alicia,12,0,20,8
1713479913066,LISP 5C,A00,507696,Munoz Sanchez; Alicia,11,0,20,9
1713479914091,MAE 197,001,528363,Boechler; Nicholas Sebastia,9998,0,9999,1
1713479915118,MATH 197,001,523477,Kedlaya; Kiran S.,9999,0,9999,0
1713479915118,MATH 197,002,563811,Zhang; Danna,9998,0,9999,1
1713479916146,MCWP 40R,A00,518780,Staff,17,0,20,3
1713479916146,MCWP 40R,B00,518781,Staff,14,0,20,6
1713479916146,MCWP 40R,C00,518783,Staff,12,0,20,8
1713479917176,MCWP 50R,A00,518791,Staff,8,0,20,12
1713479917176,MCWP 50R,B00,518792,Staff,7,0,20,13
1713479917176,MCWP 50R,C00,518793,Staff,7,0,20,13
1713479917176,MCWP 50R,D00,518794,Staff,3,0,20,17
1713479917176,MCWP 50R,E00,518795,Staff,5,0,20,15
1713479917176,MCWP 50R,F00,518796,Staff,15,0,20,5
1713479917176,MCWP 50R,G00,518797,Staff,13,0,20,7
1713479918203,MMW 12R,A01,514034,Herbst; Matthew,9,0,16,7
1713479918203,MMW 12R,A02,514035,Herbst; Matthew,14,0,16,2
1713479919228,MMW 13R,A01,514037,Staff,0,0,16,16
1713479919228,MMW 13R,A02,514039,Staff,0,1,16,16
1713479921283,SIO 295LS,A00,523233,Staff,16,0,30,14
1713479922310,SIO 295S,A00,523232,Staff,16,0,30,14
1713479923336,SOCI 117,A01,494376,Staff,0,2,5,5
1713479924363,WES 237B,A00,494380,Staff,19,0,20,1
1713479926433,AESE 279B,A00,494370,Wade; Jon P,33,0,33,0
1713479927458,AIP 197,001,627712,Vespa; Emanuel Ignacio,9999,0,9999,0
1713479928483,ANAR 135S,A00,494369,Braswell; Geoffrey E.,0,0,0,0
1713479929512,CAT 124RS,A01,519847,Geibel; William,6,0,20,14
1713479930538,CAT 125RS,A01,515971,Geibel; William,6,0,20,14
1713479931567,CLRE 250,A00,511389,Morris; Sheldon,9996,0,9999,3
1713479932597,CLRE 251,A00,507176,Mehta; Ravindra L.,9996,0,9999,3
1713479932597,CLRE 251,B00,511410,Mehta; Ravindra L.,9998,0,9999,1
1713479933624,CLRE 252,A00,507189,Cuomo; Raphael Eduardo,9998,0,9999,1
1713479934653,CLRE 253,A00,507199,Vaida; Florin,9997,0,9999,2
1713479934653,CLRE 253,B00,507202,Vaida; Florin,9999,0,9999,0
1713479935682,CLRE 259,A00,507211,Patel; Hemal,9996,0,9999,3
1713479936708,CLRE 260,A00,507221,Cuomo; Raphael Eduardo,9999,0,9999,0
1713479937738,CLRE 297,001,507242,Cuomo; Raphael Eduardo,9999,0,9999,0
1713479938764,CSE 191,A00,516875,Minnes Kemp; Mor Mia,9999,0,9999,0
1713479939789,CSS 201S,A01,494383,Staff,35,0,35,0
1713479940815,CSS 202S,A01,494387,Staff,35,0,35,0
1713479941844,EAP 100,A00,516065,Staff,9792,0,9999,207
1713479942870,ECE 45,A01,507414,Staff,40,0,60,20
1713479943895,ECE 100,A01,507416,Baghdadchi; Saharnaz,3,0,20,17
1713479943895,ECE 100,A02,507418,Baghdadchi; Saharnaz,19,0,20,1
1713479944920,ECE 111,A01,507420,Staff,28,0,50,22
1713479945945,ECE 197,001,548057,Sievenpiper; Daniel F.,9998,0,9999,1
1713479946974,EDS 115,A00,507243,Choi; Bailey Miyeon,27,0,28,1
1713479948003,EDS 117,A01,494379,Staff,16,0,25,9
1713479949027,EDS 125,A00,507246,Hopkins; Megan Beth,28,0,30,2
1713479950057,EDS 128A,A01,507264,Fargason; Sharon Gayle,26,0,26,0
1713479951086,EDS 128B,A01,507293,Pappas; Elizabeth,30,0,30,0
1713479952112,EDS 139,A00,507294,Fargason; Sharon Gayle,30,0,30,0
1713479952112,EDS 139,B00,507313,Pappas; Elizabeth,30,0,30,0
1713479953137,EDS 201,A00,507315,Staff,19,0,30,11
1713479954166,EDS 203,A01,507317,Halter; Christopher P.,18,0,30,12
1713479955193,EDS 204R,A01,507319,Halter; Christopher P.,0,1,30,30
1713479955193,EDS 204R,B01,507331,Heinzman; Erica M.,26,0,30,4
1713479956216,EDS 206R,A00,507332,Staff,0,1,30,30
1713479956216,EDS 206R,B00,507343,Staff,27,0,30,3
1713479957244,EDS 250,A00,507344,Hemans; Patricia Ann Benitez,28,0,40,12
1713479958269,EDS 281,A00,507345,Daly; Alan J.,18,0,18,0
1713479959293,EDS 284,A00,507350,Daly; Alan J.,16,0,16,0
1713479960321,EDS 286,A00,507359,Fine; Sarah,18,0,18,0
1713479961346,EDS 289C,A01,507361,Daly; Alan J.,18,0,18,0
1713479962375,EDS 290,A00,507366,Hofstetter; Carolyn,15,0,15,0
1713479963406,LIGM 5A,A00,507421,Fischer-Grunski; Eva K,20,0,20,0
1713479964434,LIGM 5B,A00,507423,Fischer-Grunski; Eva K,20,0,20,0
1713479965460,LIGM 5C,A00,507425,Fischer-Grunski; Eva K,20,0,20,0
1713479966484,LIIT 5AS,A00,507427,Carnelos; Chiara,20,0,20,0
1713479967508,LIIT 5BS,A00,507430,Carnelos; Chiara,20,0,20,0
1713479968539,LIIT 5CS,A00,507432,Carnelos; Chiara,20,0,20,0
1713479969565,LISP 5A,A00,507541,Munoz Sanchez; Alicia,15,0,20,5
1713479970645,LISP 5B,A00,507671,Munoz Sanchez; Alicia,12,0,20,8
1713479971671,LISP 5C,A00,507696,Munoz Sanchez; Alicia,11,0,20,9
1713479972696,MAE 197,001,528363,Boechler; Nicholas Sebastia,9998,0,9999,1
1713479973726,MATH 197,001,523477,Kedlaya; Kiran S.,9999,0,9999,0
1713479973726,MATH 197,002,563811,Zhang; Danna,9998,0,9999,1
1713479974753,MCWP 40R,A00,518780,Staff,17,0,20,3
1713479974753,MCWP 40R,B00,518781,Staff,14,0,20,6
1713479974753,MCWP 40R,C00,518783,Staff,12,0,20,8
1713479975778,MCWP 50R,A00,518791,Staff,8,0,20,12
1713479975778,MCWP 50R,B00,518792,Staff,7,0,20,13
1713479975778,MCWP 50R,C00,518793,Staff,7,0,20,13
1713479975778,MCWP 50R,D00,518794,Staff,3,0,20,17
1713479975778,MCWP 50R,E00,518795,Staff,5,0,20,15
1713479975778,MCWP 50R,F00,518796,Staff,15,0,20,5
1713479975778,MCWP 50R,G00,518797,Staff,13,0,20,7
1713479976805,MMW 12R,A01,514034,Herbst; Matthew,9,0,16,7
1713479976805,MMW 12R,A02,514035,Herbst; Matthew,14,0,16,2
1713479977832,MMW 13R,A01,514037,Staff,0,0,16,16
1713479977832,MMW 13R,A02,514039,Staff,0,1,16,16
1713479979885,SIO 295LS,A00,523233,Staff,16,0,30,14
1713479980911,SIO 295S,A00,523232,Staff,16,0,30,14
1713479981938,SOCI 117,A01,494376,Staff,0,2,5,5
1713479982964,WES 237B,A00,494380,Staff,19,0,20,1
1713479985029,AESE 279B,A00,494370,Wade; Jon P,33,0,33,0
1713479986056,AIP 197,001,627712,Vespa; Emanuel Ignacio,9999,0,9999,0
1713479987084,ANAR 135S,A00,494369,Braswell; Geoffrey E.,0,0,0,0
1713479988110,CAT 124RS,A01,519847,Geibel; William,6,0,20,14
1713479989138,CAT 125RS,A01,515971,Geibel; William,6,0,20,14
1713479990165,CLRE 250,A00,511389,Morris; Sheldon,9996,0,9999,3
1713479991196,CLRE 251,A00,507176,Mehta; Ravindra L.,9996,0,9999,3
1713479991196,CLRE 251,B00,511410,Mehta; Ravindra L.,9998,0,9999,1
1713479992222,CLRE 252,A00,507189,Cuomo; Raphael Eduardo,9998,0,9999,1
1713479993248,CLRE 253,A00,507199,Vaida; Florin,9997,0,9999,2
1713479993248,CLRE 253,B00,507202,Vaida; Florin,9999,0,9999,0
1713479994272,CLRE 259,A00,507211,Patel; Hemal,9996,0,9999,3
1713479995300,CLRE 260,A00,507221,Cuomo; Raphael Eduardo,9999,0,9999,0
1713479996325,CLRE 297,001,507242,Cuomo; Raphael Eduardo,9999,0,9999,0
1713479997349,CSE 191,A00,516875,Minnes Kemp; Mor Mia,9999,0,9999,0
1713479998377,CSS 201S,A01,494383,Staff,35,0,35,0
1713479999403,CSS 202S,A01,494387,Staff,35,0,35,0
1713480000432,EAP 100,A00,516065,Staff,9792,0,9999,207
1713480001458,ECE 45,A01,507414,Staff,40,0,60,20
1713480002483,ECE 100,A01,507416,Baghdadchi; Saharnaz,3,0,20,17
1713480002483,ECE 100,A02,507418,Baghdadchi; Saharnaz,19,0,20,1
1713480003508,ECE 111,A01,507420,Staff,28,0,50,22
1713480004537,ECE 197,001,548057,Sievenpiper; Daniel F.,9998,0,9999,1
1713480005563,EDS 115,A00,507243,Choi; Bailey Miyeon,27,0,28,1
1713480006588,EDS 117,A01,494379,Staff,16,0,25,9
1713480007616,EDS 125,A00,507246,Hopkins; Megan Beth,28,0,30,2
1713480008646,EDS 128A,A01,507264,Fargason; Sharon Gayle,26,0,26,0
1713480009674,EDS 128B,A01,507293,Pappas; Elizabeth,30,0,30,0
1713480010697,EDS 139,A00,507294,Fargason; Sharon Gayle,30,0,30,0
1713480010697,EDS 139,B00,507313,Pappas; Elizabeth,30,0,30,0
1713480011724,EDS 201,A00,507315,Staff,19,0,30,11
1713480012771,EDS 203,A01,507317,Halter; Christopher P.,18,0,30,12
1713480013801,EDS 204R,A01,507319,Halter; Christopher P.,0,1,30,30
1713480013801,EDS 204R,B01,507331,Heinzman; Erica M.,26,0,30,4
1713480014828,EDS 206R,A00,507332,Staff,0,1,30,30
1713480014828,EDS 206R,B00,507343,Staff,27,0,30,3
1713480015911,EDS 250,A00,507344,Hemans; Patricia Ann Benitez,28,0,40,12
1713480016939,EDS 281,A00,507345,Daly; Alan J.,18,0,18,0
1713480017965,EDS 284,A00,507350,Daly; Alan J.,16,0,16,0
1713480019001,EDS 286,A00,507359,Fine; Sarah,18,0,18,0
1713480020032,EDS 289C,A01,507361,Daly; Alan J.,18,0,18,0
1713480021063,EDS 290,A00,507366,Hofstetter; Carolyn,15,0,15,0
1713480022090,LIGM 5A,A00,507421,Fischer-Grunski; Eva K,20,0,20,0
1713480023122,LIGM 5B,A00,507423,Fischer-Grunski; Eva K,20,0,20,0
1713480024148,LIGM 5C,A00,507425,Fischer-Grunski; Eva K,20,0,20,0
1713480025177,LIIT 5AS,A00,507427,Carnelos; Chiara,20,0,20,0
1713480026208,LIIT 5BS,A00,507430,Carnelos; Chiara,20,0,20,0
1713480027234,LIIT 5CS,A00,507432,Carnelos; Chiara,20,0,20,0
1713480028274,LISP 5A,A00,507541,Munoz Sanchez; Alicia,15,0,20,5
1713480029306,LISP 5B,A00,507671,Munoz Sanchez; Alicia,12,0,20,8
1713480030333,LISP 5C,A00,507696,Munoz Sanchez; Alicia,11,0,20,9
1713480031358,MAE 197,001,528363,Boechler; Nicholas Sebastia,9998,0,9999,1
1713480032386,MATH 197,001,523477,Kedlaya; Kiran S.,9999,0,9999,0
1713480032386,MATH 197,002,563811,Zhang; Danna,9998,0,9999,1
1713480033411,MCWP 40R,A00,518780,Staff,17,0,20,3
1713480033411,MCWP 40R,B00,518781,Staff,14,0,20,6
1713480033411,MCWP 40R,C00,518783,Staff,12,0,20,8
1713480034436,MCWP 50R,A00,518791,Staff,8,0,20,12
1713480034436,MCWP 50R,B00,518792,Staff,7,0,20,13
1713480034436,MCWP 50R,C00,518793,Staff,7,0,20,13
1713480034436,MCWP 50R,D00,518794,Staff,3,0,20,17
1713480034436,MCWP 50R,E00,518795,Staff,5,0,20,15
1713480034436,MCWP 50R,F00,518796,Staff,15,0,20,5
1713480034436,MCWP 50R,G00,518797,Staff,13,0,20,7
1713480035462,MMW 12R,A01,514034,Herbst; Matthew,9,0,16,7
1713480035462,MMW 12R,A02,514035,Herbst; Matthew,14,0,16,2
1713480036489,MMW 13R,A01,514037,Staff,0,0,16,16
1713480036489,MMW 13R,A02,514039,Staff,0,1,16,16
1713480038540,SIO 295LS,A00,523233,Staff,16,0,30,14
1713480039566,SIO 295S,A00,523232,Staff,16,0,30,14
1713480040594,SOCI 117,A01,494376,Staff,0,2,5,5
1713480041623,WES 237B,A00,494380,Staff,19,0,20,1
1713480043689,AESE 279B,A00,494370,Wade; Jon P,33,0,33,0
1713480044719,AIP 197,001,627712,Vespa; Emanuel Ignacio,9999,0,9999,0
1713480045745,ANAR 135S,A00,494369,Braswell; Geoffrey E.,0,0,0,0
1713480046776,CAT 124RS,A01,519847,Geibel; William,6,0,20,14
1713480047806,CAT 125RS,A01,515971,Geibel; William,6,0,20,14
1713480048836,CLRE 250,A00,511389,Morris; Sheldon,9996,0,9999,3
1713480049861,CLRE 251,A00,507176,Mehta; Ravindra L.,9996,0,9999,3
1713480049861,CLRE 251,B00,511410,Mehta; Ravindra L.,9998,0,9999,1
1713480050887,CLRE 252,A00,507189,Cuomo; Raphael Eduardo,9998,0,9999,1
1713480051915,CLRE 253,A00,507199,Vaida; Florin,9997,0,9999,2
1713480051915,CLRE 253,B00,507202,Vaida; Florin,9999,0,9999,0
1713480052943,CLRE 259,A00,507211,Patel; Hemal,9996,0,9999,3
1713480053972,CLRE 260,A00,507221,Cuomo; Raphael Eduardo,9999,0,9999,0
1713480054998,CLRE 297,001,507242,Cuomo; Raphael Eduardo,9999,0,9999,0
1713480056023,CSE 191,A00,516875,Minnes Kemp; Mor Mia,9999,0,9999,0
1713480057048,CSS 201S,A01,494383,Staff,35,0,35,0
1713480058074,CSS 202S,A01,494387,Staff,35,0,35,0
1713480059101,EAP 100,A00,516065,Staff,9792,0,9999,207
1713480060207,ECE 45,A01,507414,Staff,40,0,60,20
1713480061238,ECE 100,A01,507416,Baghdadchi; Saharnaz,3,0,20,17
1713480061238,ECE 100,A02,507418,Baghdadchi; Saharnaz,19,0,20,1
1713480062273,ECE 111,A01,507420,Staff,28,0,50,22
1713480063300,ECE 197,001,548057,Sievenpiper; Daniel F.,9998,0,9999,1
1713480064334,EDS 115,A00,507243,Choi; Bailey Miyeon,27,0,28,1
1713480065361,EDS 117,A01,494379,Staff,16,0,25,9
1713480066391,EDS 125,A00,507246,Hopkins; Megan Beth,28,0,30,2
1713480067418,EDS 128A,A01,507264,Fargason; Sharon Gayle,26,0,26,0
1713480068448,EDS 128B,A01,507293,Pappas; Elizabeth,30,0,30,0
1713480069476,EDS 139,A00,507294,Fargason; Sharon Gayle,30,0,30,0
1713480069476,EDS 139,B00,507313,Pappas; Elizabeth,30,0,30,0
1713480070501,EDS 201,A00,507315,Staff,19,0,30,11
1713480071535,EDS 203,A01,507317,Halter; Christopher P.,18,0,30,12
1713480072566,EDS 204R,A01,507319,Halter; Christopher P.,0,1,30,30
1713480072566,EDS 204R,B01,507331,Heinzman; Erica M.,26,0,30,4
1713480073591,EDS 206R,A00,507332,Staff,0,1,30,30
1713480073591,EDS 206R,B00,507343,Staff,27,0,30,3
1713480074688,EDS 250,A00,507344,Hemans; Patricia Ann Benitez,28,0,40,12
1713480075716,EDS 281,A00,507345,Daly; Alan J.,18,0,18,0
1713480076745,EDS 284,A00,507350,Daly; Alan J.,16,0,16,0
1713480077772,EDS 286,A00,507359,Fine; Sarah,18,0,18,0
1713480078798,EDS 289C,A01,507361,Daly; Alan J.,18,0,18,0
1713480079823,EDS 290,A00,507366,Hofstetter; Carolyn,15,0,15,0
1713480080848,LIGM 5A,A00,507421,Fischer-Grunski; Eva K,20,0,20,0
1713480081877,LIGM 5B,A00,507423,Fischer-Grunski; Eva K,20,0,20,0
1713480082906,LIGM 5C,A00,507425,Fischer-Grunski; Eva K,20,0,20,0
1713480083934,LIIT 5AS,A00,507427,Carnelos; Chiara,20,0,20,0
1713480084960,LIIT 5BS,A00,507430,Carnelos; Chiara,20,0,20,0
1713480085988,LIIT 5CS,A00,507432,Carnelos; Chiara,20,0,20,0
1713480087020,LISP 5A,A00,507541,Munoz Sanchez; Alicia,15,0,20,5
1713480088051,LISP 5B,A00,507671,Munoz Sanchez; Alicia,12,0,20,8
1713480089075,LISP 5C,A00,507696,Munoz Sanchez; Alicia,11,0,20,9
1713480090100,MAE 197,001,528363,Boechler; Nicholas Sebastia,9998,0,9999,1
1713480091129,MATH 197,001,523477,Kedlaya; Kiran S.,9999,0,9999,0
1713480091129,MATH 197,002,563811,Zhang; Danna,9998,0,9999,1
1713480092154,MCWP 40R,A00,518780,Staff,17,0,20,3
1713480092154,MCWP 40R,B00,518781,Staff,14,0,20,6
1713480092154,MCWP 40R,C00,518783,Staff,12,0,20,8
1713480093178,MCWP 50R,A00,518791,Staff,8,0,20,12
1713480093178,MCWP 50R,B00,518792,Staff,7,0,20,13
1713480093178,MCWP 50R,C00,518793,Staff,7,0,20,13
1713480093178,MCWP 50R,D00,518794,Staff,3,0,20,17
1713480093178,MCWP 50R,E00,518795,Staff,5,0,20,15
1713480093178,MCWP 50R,F00,518796,Staff,15,0,20,5
1713480093178,MCWP 50R,G00,518797,Staff,13,0,20,7
1713480094207,MMW 12R,A01,514034,Herbst; Matthew,9,0,16,7
1713480094207,MMW 12R,A02,514035,Herbst; Matthew,14,0,16,2
1713480095235,MMW 13R,A01,514037,Staff,0,0,16,16
1713480095235,MMW 13R,A02,514039,Staff,0,1,16,16
1713480097290,SIO 295LS,A00,523233,Staff,16,0,30,14
1713480098316,SIO 295S,A00,523232,Staff,16,0,30,14
1713480099345,SOCI 117,A01,494376,Staff,0,2,5,5
1713480100373,WES 237B,A00,494380,Staff,19,0,20,1
1713480102441,AESE 279B,A00,494370,Wade; Jon P,33,0,33,0
1713480103468,AIP 197,001,627712,Vespa; Emanuel Ignacio,9999,0,9999,0
1713480104494,ANAR 135S,A00,494369,Braswell; Geoffrey E.,0,0,0,0
1713480105519,CAT 124RS,A01,519847,Geibel; William,6,0,20,14
1713480106545,CAT 125RS,A01,515971,Geibel; William,6,0,20,14
1713480107569,CLRE 250,A00,511389,Morris; Sheldon,9996,0,9999,3
1713480108597,CLRE 251,A00,507176,Mehta; Ravindra L.,9996,0,9999,3
1713480108597,CLRE 251,B00,511410,Mehta; Ravindra L.,9998,0,9999,1
1713480109623,CLRE 252,A00,507189,Cuomo; Raphael Eduardo,9998,0,9999,1
1713480110653,CLRE 253,A00,507199,Vaida; Florin,9997,0,9999,2
1713480110653,CLRE 253,B00,507202,Vaida; Florin,9999,0,9999,0
1713480111680,CLRE 259,A00,507211,Patel; Hemal,9996,0,9999,3
1713480112704,CLRE 260,A00,507221,Cuomo; Raphael Eduardo,9999,0,9999,0
1713480113732,CLRE 297,001,507242,Cuomo; Raphael Eduardo,9999,0,9999,0
1713480114762,CSE 191,A00,516875,Minnes Kemp; Mor Mia,9999,0,9999,0
1713480115793,CSS 201S,A01,494383,Staff,35,0,35,0
1713480116822,CSS 202S,A01,494387,Staff,35,0,35,0
1713480117850,EAP 100,A00,516065,Staff,9792,0,9999,207
1713480118880,ECE 45,A01,507414,Staff,40,0,60,20
1713480119909,ECE 100,A01,507416,Baghdadchi; Saharnaz,3,0,20,17
1713480119909,ECE 100,A02,507418,Baghdadchi; Saharnaz,19,0,20,1
1713480120934,ECE 111,A01,507420,Staff,28,0,50,22
1713480121963,ECE 197,001,548057,Sievenpiper; Daniel F.,9998,0,9999,1
1713480122988,EDS 115,A00,507243,Choi; Bailey Miyeon,27,0,28,1
1713480124017,EDS 117,A01,494379,Staff,16,0,25,9
1713480125045,EDS 125,A00,507246,Hopkins; Megan Beth,28,0,30,2
1713480126077,EDS 128A,A01,507264,Fargason; Sharon Gayle,26,0,26,0
1713480127106,EDS 128B,A01,507293,Pappas; Elizabeth,30,0,30,0
1713480128131,EDS 139,A00,507294,Fargason; Sharon Gayle,30,0,30,0
1713480128131,EDS 139,B00,507313,Pappas; Elizabeth,30,0,30,0
1713480129160,EDS 201,A00,507315,Staff,19,0,30,11
1713480130190,EDS 203,A01,507317,Halter; Christopher P.,18,0,30,12
1713480131220,EDS 204R,A01,507319,Halter; Christopher P.,0,1,30,30
1713480131220,EDS 204R,B01,507331,Heinzman; Erica M.,26,0,30,4
1713480132245,EDS 206R,A00,507332,Staff,0,1,30,30
1713480132245,EDS 206R,B00,507343,Staff,27,0,30,3
1713480133271,EDS 250,A00,507344,Hemans; Patricia Ann Benitez,28,0,40,12
1713480134297,EDS 281,A00,507345,Daly; Alan J.,18,0,18,0
1713480135324,EDS 284,A00,507350,Daly; Alan J.,16,0,16,0
1713480136352,EDS 286,A00,507359,Fine; Sarah,18,0,18,0
1713480137381,EDS 289C,A01,507361,Daly; Alan J.,18,0,18,0
1713480138407,EDS 290,A00,507366,Hofstetter; Carolyn,15,0,15,0
1713480139435,LIGM 5A,A00,507421,Fischer-Grunski; Eva K,20,0,20,0
1713480140465,LIGM 5B,A00,507423,Fischer-Grunski; Eva K,20,0,20,0
1713480141491,LIGM 5C,A00,507425,Fischer-Grunski; Eva K,20,0,20,0
1713480142519,LIIT 5AS,A00,507427,Carnelos; Chiara,20,0,20,0
1713480143548,LIIT 5BS,A00,507430,Carnelos; Chiara,20,0,20,0
1713480144578,LIIT 5CS,A00,507432,Carnelos; Chiara,20,0,20,0
1713480145603,LISP 5A,A00,507541,Munoz Sanchez; Alicia,15,0,20,5
1713480146626,LISP 5B,A00,507671,Munoz Sanchez; Alicia,12,0,20,8
1713480147653,LISP 5C,A00,507696,Munoz Sanchez; Alicia,11,0,20,9
1713480148677,MAE 197,001,528363,Boechler; Nicholas Sebastia,9998,0,9999,1
1713480149717,MATH 197,001,523477,Kedlaya; Kiran S.,9999,0,9999,0
1713480149717,MATH 197,002,563811,Zhang; Danna,9998,0,9999,1
1713480150743,MCWP 40R,A00,518780,Staff,17,0,20,3
1713480150743,MCWP 40R,B00,518781,Staff,14,0,20,6
1713480150743,MCWP 40R,C00,518783,Staff,12,0,20,8
1713480151767,MCWP 50R,A00,518791,Staff,8,0,20,12
1713480151767,MCWP 50R,B00,518792,Staff,7,0,20,13
1713480151767,MCWP 50R,C00,518793,Staff,7,0,20,13
1713480151767,MCWP 50R,D00,518794,Staff,3,0,20,17
1713480151767,MCWP 50R,E00,518795,Staff,5,0,20,15
1713480151767,MCWP 50R,F00,518796,Staff,15,0,20,5
1713480151767,MCWP 50R,G00,518797,Staff,13,0,20,7
1713480152792,MMW 12R,A01,514034,Herbst; Matthew,9,0,16,7
1713480152792,MMW 12R,A02,514035,Herbst; Matthew,14,0,16,2
1713480153818,MMW 13R,A01,514037,Staff,0,0,16,16
1713480153818,MMW 13R,A02,514039,Staff,0,1,16,16
1713480155875,SIO 295LS,A00,523233,Staff,16,0,30,14
1713480156904,SIO 295S,A00,523232,Staff,16,0,30,14
1713480157933,SOCI 117,A01,494376,Staff,0,2,5,5
1713480158963,WES 237B,A00,494380,Staff,19,0,20,1
1713480161042,AESE 279B,A00,494370,Wade; Jon P,33,0,33,0
1713480162066,AIP 197,001,627712,Vespa; Emanuel Ignacio,9999,0,9999,0
1713480163091,ANAR 135S,A00,494369,Braswell; Geoffrey E.,0,0,0,0
1713480164122,CAT 124RS,A01,519847,Geibel; William,6,0,20,14
1713480165147,CAT 125RS,A01,515971,Geibel; William,6,0,20,14
1713480166173,CLRE 250,A00,511389,Morris; Sheldon,9996,0,9999,3
1713480167199,CLRE 251,A00,507176,Mehta; Ravindra L.,9996,0,9999,3
1713480167199,CLRE 251,B00,511410,Mehta; Ravindra L.,9998,0,9999,1
1713480168224,CLRE 252,A00,507189,Cuomo; Raphael Eduardo,9998,0,9999,1
1713480169254,CLRE 253,A00,507199,Vaida; Florin,9997,0,9999,2
1713480169254,CLRE 253,B00,507202,Vaida; Florin,9999,0,9999,0
1713480170279,CLRE 259,A00,507211,Patel; Hemal,9996,0,9999,3
1713480171303,CLRE 260,A00,507221,Cuomo; Raphael Eduardo,9999,0,9999,0
1713480172327,CLRE 297,001,507242,Cuomo; Raphael Eduardo,9999,0,9999,0
1713480173356,CSE 191,A00,516875,Minnes Kemp; Mor Mia,9999,0,9999,0
1713480174387,CSS 201S,A01,494383,Staff,35,0,35,0
1713480175410,CSS 202S,A01,494387,Staff,35,0,35,0
1713480176436,EAP 100,A00,516065,Staff,9792,0,9999,207
1713480177466,ECE 45,A01,507414,Staff,40,0,60,20
1713480178553,ECE 100,A01,507416,Baghdadchi; Saharnaz,3,0,20,17
1713480178553,ECE 100,A02,507418,Baghdadchi; Saharnaz,19,0,20,1
1713480179581,ECE 111,A01,507420,Staff,28,0,50,22
1713480180607,ECE 197,001,548057,Sievenpiper; Daniel F.,9998,0,9999,1
1713480181636,EDS 115,A00,507243,Choi; Bailey Miyeon,27,0,28,1
1713480182661,EDS 117,A01,494379,Staff,16,0,25,9
1713480183689,EDS 125,A00,507246,Hopkins; Megan Beth,28,0,30,2
1713480184718,EDS 128A,A01,507264,Fargason; Sharon Gayle,26,0,26,0
1713480185743,EDS 128B,A01,507293,Pappas; Elizabeth,30,0,30,0
1713480186768,EDS 139,A00,507294,Fargason; Sharon Gayle,30,0,30,0
1713480186768,EDS 139,B00,507313,Pappas; Elizabeth,30,0,30,0
1713480187793,EDS 201,A00,507315,Staff,19,0,30,11
1713480188823,EDS 203,A01,507317,Halter; Christopher P.,18,0,30,12
1713480189865,EDS 204R,A01,507319,Halter; Christopher P.,0,1,30,30
1713480189865,EDS 204R,B01,507331,Heinzman; Erica M.,26,0,30,4
1713480190893,EDS 206R,A00,507332,Staff,0,1,30,30
1713480190893,EDS 206R,B00,507343,Staff,27,0,30,3
1713480191922,EDS 250,A00,507344,Hemans; Patricia Ann Benitez,28,0,40,12
1713480192948,EDS 281,A00,507345,Daly; Alan J.,18,0,18,0
1713480193975,EDS 284,A00,507350,Daly; Alan J.,16,0,16,0
1713480195001,EDS 286,A00,507359,Fine; Sarah,18,0,18,0
1713480196026,EDS 289C,A01,507361,Daly; Alan J.,18,0,18,0
1713480197052,EDS 290,A00,507366,Hofstetter; Carolyn,15,0,15,0
1713480198083,LIGM 5A,A00,507421,Fischer-Grunski; Eva K,20,0,20,0
1713480199108,LIGM 5B,A00,507423,Fischer-Grunski; Eva K,20,0,20,0
1713480200138,LIGM 5C,A00,507425,Fischer-Grunski; Eva K,20,0,20,0
1713480201163,LIIT 5AS,A00,507427,Carnelos; Chiara,20,0,20,0
1713480202191,LIIT 5BS,A00,507430,Carnelos; Chiara,20,0,20,0
1713480203216,LIIT 5CS,A00,507432,Carnelos; Chiara,20,0,20,0
1713480204240,LISP 5A,A00,507541,Munoz Sanchez; Alicia,15,0,20,5
1713480205269,LISP 5B,A00,507671,Munoz Sanchez; Alicia,12,0,20,8
1713480206295,LISP 5C,A00,507696,Munoz Sanchez; Alicia,11,0,20,9
1713480207320,MAE 197,001,528363,Boechler; Nicholas Sebastia,9998,0,9999,1
1713480208353,MATH 197,001,523477,Kedlaya; Kiran S.,9999,0,9999,0
1713480208353,MATH 197,002,563811,Zhang; Danna,9998,0,9999,1
1713480209379,MCWP 40R,A00,518780,Staff,17,0,20,3
1713480209379,MCWP 40R,B00,518781,Staff,14,0,20,6
1713480209379,MCWP 40R,C00,518783,Staff,12,0,20,8
1713480210405,MCWP 50R,A00,518791,Staff,8,0,20,12
1713480210405,MCWP 50R,B00,518792,Staff,7,0,20,13
1713480210405,MCWP 50R,C00,518793,Staff,7,0,20,13
1713480210405,MCWP 50R,D00,518794,Staff,3,0,20,17
1713480210405,MCWP 50R,E00,518795,Staff,5,0,20,15
1713480210405,MCWP 50R,F00,518796,Staff,15,0,20,5
1713480210405,MCWP 50R,G00,518797,Staff,13,0,20,7
1713480211433,MMW 12R,A01,514034,Herbst; Matthew,9,0,16,7
1713480211433,MMW 12R,A02,514035,Herbst; Matthew,14,0,16,2
1713480212461,MMW 13R,A01,514037,Staff,0,0,16,16
1713480212461,MMW 13R,A02,514039,Staff,0,1,16,16
1713480214510,SIO 295LS,A00,523233,Staff,16,0,30,14
1713480215538,SIO 295S,A00,523232,Staff,15,0,30,15
1713480216563,SOCI 117,A01,494376,Staff,0,2,5,5
1713480217591,WES 237B,A00,494380,Staff,19,0,20,1
1713480219665,AESE 279B,A00,494370,Wade; Jon P,33,0,33,0
1713480220695,AIP 197,001,627712,Vespa; Emanuel Ignacio,9999,0,9999,0
1713480221723,ANAR 135S,A00,494369,Braswell; Geoffrey E.,0,0,0,0
1713480222753,CAT 124RS,A01,519847,Geibel; William,6,0,20,14
1713480223778,CAT 125RS,A01,515971,Geibel; William,6,0,20,14
1713480224805,CLRE 250,A00,511389,Morris; Sheldon,9996,0,9999,3
1713480225832,CLRE 251,A00,507176,Mehta; Ravindra L.,9996,0,9999,3
1713480225832,CLRE 251,B00,511410,Mehta; Ravindra L.,9998,0,9999,1
1713480226867,CLRE 252,A00,507189,Cuomo; Raphael Eduardo,9998,0,9999,1
1713480227897,CLRE 253,A00,507199,Vaida; Florin,9997,0,9999,2
1713480227897,CLRE 253,B00,507202,Vaida; Florin,9999,0,9999,0
1713480228922,CLRE 259,A00,507211,Patel; Hemal,9996,0,9999,3
1713480229948,CLRE 260,A00,507221,Cuomo; Raphael Eduardo,9999,0,9999,0
1713480230975,CLRE 297,001,507242,Cuomo; Raphael Eduardo,9999,0,9999,0
1713480232001,CSE 191,A00,516875,Minnes Kemp; Mor Mia,9999,0,9999,0
1713480233032,CSS 201S,A01,494383,Staff,35,0,35,0
1713480234062,CSS 202S,A01,494387,Staff,35,0,35,0
1713480235087,EAP 100,A00,516065,Staff,9792,0,9999,207
1713480236112,ECE 45,A01,507414,Staff,40,0,60,20
1713480237140,ECE 100,A01,507416,Baghdadchi; Saharnaz,3,0,20,17
1713480237140,ECE 100,A02,507418,Baghdadchi; Saharnaz,19,0,20,1
1713480238166,ECE 111,A01,507420,Staff,28,0,50,22
1713480239191,ECE 197,001,548057,Sievenpiper; Daniel F.,9998,0,9999,1
1713480240219,EDS 115,A00,507243,Choi; Bailey Miyeon,27,0,28,1
1713480241246,EDS 117,A01,494379,Staff,16,0,25,9
1713480242270,EDS 125,A00,507246,Hopkins; Megan Beth,28,0,30,2
1713480243300,EDS 128A,A01,507264,Fargason; Sharon Gayle,26,0,26,0
1713480244329,EDS 128B,A01,507293,Pappas; Elizabeth,30,0,30,0
1713480245358,EDS 139,A00,507294,Fargason; Sharon Gayle,30,0,30,0
1713480245358,EDS 139,B00,507313,Pappas; Elizabeth,30,0,30,0
1713480246385,EDS 201,A00,507315,Staff,19,0,30,11
1713480247488,EDS 203,A01,507317,Halter; Christopher P.,18,0,30,12
1713480248516,EDS 204R,A01,507319,Halter; Christopher P.,0,1,30,30
1713480248516,EDS 204R,B01,507331,Heinzman; Erica M.,26,0,30,4
1713480249546,EDS 206R,A00,507332,Staff,0,1,30,30
1713480249546,EDS 206R,B00,507343,Staff,27,0,30,3
1713480250572,EDS 250,A00,507344,Hemans; Patricia Ann Benitez,28,0,40,12
1713480251601,EDS 281,A00,507345,Daly; Alan J.,18,0,18,0
1713480252627,EDS 284,A00,507350,Daly; Alan J.,16,0,16,0
1713480253652,EDS 286,A00,507359,Fine; Sarah,18,0,18,0
1713480254680,EDS 289C,A01,507361,Daly; Alan J.,18,0,18,0
1713480255705,EDS 290,A00,507366,Hofstetter; Carolyn,15,0,15,0
1713480256736,LIGM 5A,A00,507421,Fischer-Grunski; Eva K,20,0,20,0
1713480257761,LIGM 5B,A00,507423,Fischer-Grunski; Eva K,20,0,20,0
1713480258786,LIGM 5C,A00,507425,Fischer-Grunski; Eva K,20,0,20,0
1713480259811,LIIT 5AS,A00,507427,Carnelos; Chiara,20,0,20,0
1713480260840,LIIT 5BS,A00,507430,Carnelos; Chiara,20,0,20,0
1713480261866,LIIT 5CS,A00,507432,Carnelos; Chiara,20,0,20,0
1713480262891,LISP 5A,A00,507541,Munoz Sanchez; Alicia,14,0,20,6
1713480263916,LISP 5B,A00,507671,Munoz Sanchez; Alicia,12,0,20,8
1713480264942,LISP 5C,A00,507696,Munoz Sanchez; Alicia,11,0,20,9
1713480265969,MAE 197,001,528363,Boechler; Nicholas Sebastia,9998,0,9999,1
1713480266997,MATH 197,001,523477,Kedlaya; Kiran S.,9999,0,9999,0
1713480266997,MATH 197,002,563811,Zhang; Danna,9998,0,9999,1
1713480268021,MCWP 40R,A00,518780,Staff,17,0,20,3
1713480268021,MCWP 40R,B00,518781,Staff,14,0,20,6
1713480268021,MCWP 40R,C00,518783,Staff,12,0,20,8
1713480269052,MCWP 50R,A00,518791,Staff,8,0,20,12
1713480269052,MCWP 50R,B00,518792,Staff,7,0,20,13
1713480269052,MCWP 50R,C00,518793,Staff,7,0,20,13
1713480269052,MCWP 50R,D00,518794,Staff,3,0,20,17
1713480269052,MCWP 50R,E00,518795,Staff,5,0,20,15
1713480269052,MCWP 50R,F00,518796,Staff,15,0,20,5
1713480269052,MCWP 50R,G00,518797,Staff,13,0,20,7
1713480270080,MMW 12R,A01,514034,Herbst; Matthew,9,0,16,7
1713480270080,MMW 12R,A02,514035,Herbst; Matthew,14,0,16,2
1713480271106,MMW 13R,A01,514037,Staff,0,0,16,16
1713480271106,MMW 13R,A02,514039,Staff,0,1,16,16
1713480273155,SIO 295LS,A00,523233,Staff,15,0,30,15
1713480274181,SIO 295S,A00,523232,Staff,15,0,30,15
1713480275208,SOCI 117,A01,494376,Staff,0,2,5,5
1713480276236,WES 237B,A00,494380,Staff,19,0,20,1
1713480278309,AESE 279B,A00,494370,Wade; Jon P,33,0,33,0
1713480279340,AIP 197,001,627712,Vespa; Emanuel Ignacio,9999,0,9999,0
1713480280367,ANAR 135S,A00,494369,Braswell; Geoffrey E.,0,0,0,0
1713480281393,CAT 124RS,A01,519847,Geibel; William,6,0,20,14
1713480282472,CAT 125RS,A01,515971,Geibel; William,6,0,20,14
1713480283497,CLRE 250,A00,511389,Morris; Sheldon,9996,0,9999,3
1713480284524,CLRE 251,A00,507176,Mehta; Ravindra L.,9996,0,9999,3
1713480284524,CLRE 251,B00,511410,Mehta; Ravindra L.,9998,0,9999,1
1713480285549,CLRE 252,A00,507189,Cuomo; Raphael Eduardo,9998,0,9999,1
1713480286575,CLRE 253,A00,507199,Vaida; Florin,9997,0,9999,2
1713480286575,CLRE 253,B00,507202,Vaida; Florin,9999,0,9999,0
1713480287603,CLRE 259,A00,507211,Patel; Hemal,9996,0,9999,3
1713480288628,CLRE 260,A00,507221,Cuomo; Raphael Eduardo,9999,0,9999,0
1713480289653,CLRE 297,001,507242,Cuomo; Raphael Eduardo,9999,0,9999,0
1713480290680,CSE 191,A00,516875,Minnes Kemp; Mor Mia,9999,0,9999,0
1713480291706,CSS 201S,A01,494383,Staff,35,0,35,0
1713480292731,CSS 202S,A01,494387,Staff,35,0,35,0
1713480293756,EAP 100,A00,516065,Staff,9792,0,9999,207
1713480294782,ECE 45,A01,507414,Staff,40,0,60,20
1713480295812,ECE 100,A01,507416,Baghdadchi; Saharnaz,3,0,20,17
1713480295812,ECE 100,A02,507418,Baghdadchi; Saharnaz,19,0,20,1
1713480296837,ECE 111,A01,507420,Staff,28,0,50,22
1713480297867,ECE 197,001,548057,Sievenpiper; Daniel F.,9998,0,9999,1
1713480298894,EDS 115,A00,507243,Choi; Bailey Miyeon,27,0,28,1
1713480299918,EDS 117,A01,494379,Staff,16,0,25,9
1713480300945,EDS 125,A00,507246,Hopkins; Megan Beth,28,0,30,2
1713480301971,EDS 128A,A01,507264,Fargason; Sharon Gayle,26,0,26,0
1713480303000,EDS 128B,A01,507293,Pappas; Elizabeth,30,0,30,0
1713480304024,EDS 139,A00,507294,Fargason; Sharon Gayle,30,0,30,0
1713480304024,EDS 139,B00,507313,Pappas; Elizabeth,30,0,30,0
1713480305049,EDS 201,A00,507315,Staff,19,0,30,11
1713480306078,EDS 203,A01,507317,Halter; Christopher P.,18,0,30,12
1713480307102,EDS 204R,A01,507319,Halter; Christopher P.,0,1,30,30
1713480307102,EDS 204R,B01,507331,Heinzman; Erica M.,26,0,30,4
1713480308126,EDS 206R,A00,507332,Staff,0,1,30,30
1713480308126,EDS 206R,B00,507343,Staff,27,0,30,3
1713480309154,EDS 250,A00,507344,Hemans; Patricia Ann Benitez,28,0,40,12
1713480310182,EDS 281,A00,507345,Daly; Alan J.,18,0,18,0
1713480311207,EDS 284,A00,507350,Daly; Alan J.,16,0,16,0
1713480312233,EDS 286,A00,507359,Fine; Sarah,18,0,18,0
1713480313256,EDS 289C,A01,507361,Daly; Alan J.,18,0,18,0
1713480314284,EDS 290,A00,507366,Hofstetter; Carolyn,15,0,15,0
1713480315310,LIGM 5A,A00,507421,Fischer-Grunski; Eva K,20,0,20,0
1713480316338,LIGM 5B,A00,507423,Fischer-Grunski; Eva K,20,0,20,0
1713480317362,LIGM 5C,A00,507425,Fischer-Grunski; Eva K,20,0,20,0
1713480318396,LIIT 5AS,A00,507427,Carnelos; Chiara,20,0,20,0
1713480319421,LIIT 5BS,A00,507430,Carnelos; Chiara,20,0,20,0
1713480320445,LIIT 5CS,A00,507432,Carnelos; Chiara,20,0,20,0
1713480321469,LISP 5A,A00,507541,Munoz Sanchez; Alicia,14,0,20,6
1713480322499,LISP 5B,A00,507671,Munoz Sanchez; Alicia,12,0,20,8
1713480323529,LISP 5C,A00,507696,Munoz Sanchez; Alicia,11,0,20,9
1713480324560,MAE 197,001,528363,Boechler; Nicholas Sebastia,9998,0,9999,1
1713480325585,MATH 197,001,523477,Kedlaya; Kiran S.,9999,0,9999,0
1713480325585,MATH 197,002,563811,Zhang; Danna,9998,0,9999,1
1713480326613,MCWP 40R,A00,518780,Staff,17,0,20,3
1713480326613,MCWP 40R,B00,518781,Staff,14,0,20,6
1713480326613,MCWP 40R,C00,518783,Staff,12,0,20,8
1713480327647,MCWP 50R,A00,518791,Staff,8,0,20,12
1713480327647,MCWP 50R,B00,518792,Staff,7,0,20,13
1713480327647,MCWP 50R,C00,518793,Staff,7,0,20,13
1713480327647,MCWP 50R,D00,518794,Staff,3,0,20,17
1713480327647,MCWP 50R,E00,518795,Staff,5,0,20,15
1713480327647,MCWP 50R,F00,518796,Staff,15,0,20,5
1713480327647,MCWP 50R,G00,518797,Staff,13,0,20,7
1713480328673,MMW 12R,A01,514034,Herbst; Matthew,9,0,16,7
1713480328673,MMW 12R,A02,514035,Herbst; Matthew,14,0,16,2
1713480329698,MMW 13R,A01,514037,Staff,0,0,16,16
1713480329698,MMW 13R,A02,514039,Staff,0,1,16,16
1713480331748,SIO 295LS,A00,523233,Staff,15,0,30,15
1713480332776,SIO 295S,A00,523232,Staff,15,0,30,15
1713480333806,SOCI 117,A01,494376,Staff,0,2,5,5
1713480334835,WES 237B,A00,494380,Staff,19,0,20,1
1713480336927,AESE 279B,A00,494370,Wade; Jon P,33,0,33,0
1713480337952,AIP 197,001,627712,Vespa; Emanuel Ignacio,9999,0,9999,0
1713480338981,ANAR 135S,A00,494369,Braswell; Geoffrey E.,0,0,0,0
1713480340012,CAT 124RS,A01,519847,Geibel; William,6,0,20,14
1713480341037,CAT 125RS,A01,515971,Geibel; William,6,0,20,14
1713480342064,CLRE 250,A00,511389,Morris; Sheldon,9996,0,9999,3
1713480343090,CLRE 251,A00,507176,Mehta; Ravindra L.,9996,0,9999,3
1713480343090,CLRE 251,B00,511410,Mehta; Ravindra L.,9998,0,9999,1
1713480344116,CLRE 252,A00,507189,Cuomo; Raphael Eduardo,9998,0,9999,1
1713480345141,CLRE 253,A00,507199,Vaida; Florin,9997,0,9999,2
1713480345141,CLRE 253,B00,507202,Vaida; Florin,9999,0,9999,0
1713480346168,CLRE 259,A00,507211,Patel; Hemal,9996,0,9999,3
1713480347192,CLRE 260,A00,507221,Cuomo; Raphael Eduardo,9999,0,9999,0
1713480348217,CLRE 297,001,507242,Cuomo; Raphael Eduardo,9999,0,9999,0
1713480349245,CSE 191,A00,516875,Minnes Kemp; Mor Mia,9999,0,9999,0
1713480350274,CSS 201S,A01,494383,Staff,35,0,35,0
1713480351299,CSS 202S,A01,494387,Staff,35,0,35,0
1713480352324,EAP 100,A00,516065,Staff,9792,0,9999,207
1713480353354,ECE 45,A01,507414,Staff,40,0,60,20
1713480354385,ECE 100,A01,507416,Baghdadchi; Saharnaz,3,0,20,17
1713480354385,ECE 100,A02,507418,Baghdadchi; Saharnaz,19,0,20,1
1713480355411,ECE 111,A01,507420,Staff,28,0,50,22
1713480356441,ECE 197,001,548057,Sievenpiper; Daniel F.,9998,0,9999,1
1713480357467,EDS 115,A00,507243,Choi; Bailey Miyeon,27,0,28,1
1713480358496,EDS 117,A01,494379,Staff,16,0,25,9
1713480359523,EDS 125,A00,507246,Hopkins; Megan Beth,28,0,30,2
1713480360704,EDS 128A,A01,507264,Fargason; Sharon Gayle,26,0,26,0
1713480361735,EDS 128B,A01,507293,Pappas; Elizabeth,30,0,30,0
1713480362760,EDS 139,A00,507294,Fargason; Sharon Gayle,30,0,30,0
1713480362760,EDS 139,B00,507313,Pappas; Elizabeth,30,0,30,0
1713480363789,EDS 201,A00,507315,Staff,19,0,30,11
1713480364815,EDS 203,A01,507317,Halter; Christopher P.,18,0,30,12
1713480365845,EDS 204R,A01,507319,Halter; Christopher P.,0,1,30,30
1713480365845,EDS 204R,B01,507331,Heinzman; Erica M.,26,0,30,4
1713480366872,EDS 206R,A00,507332,Staff,0,1,30,30
1713480366872,EDS 206R,B00,507343,Staff,27,0,30,3
1713480367896,EDS 250,A00,507344,Hemans; Patricia Ann Benitez,28,0,40,12
1713480368923,EDS 281,A00,507345,Daly; Alan J.,18,0,18,0
1713480369951,EDS 284,A00,507350,Daly; Alan J.,16,0,16,0
1713480370981,EDS 286,A00,507359,Fine; Sarah,18,0,18,0
1713480372009,EDS 289C,A01,507361,Daly; Alan J.,18,0,18,0
1713480373038,EDS 290,A00,507366,Hofstetter; Carolyn,15,0,15,0
1713480374064,LIGM 5A,A00,507421,Fischer-Grunski; Eva K,20,0,20,0
1713480375090,LIGM 5B,A00,507423,Fischer-Grunski; Eva K,20,0,20,0
1713480376121,LIGM 5C,A00,507425,Fischer-Grunski; Eva K,20,0,20,0
1713480377152,LIIT 5AS,A00,507427,Carnelos; Chiara,20,0,20,0
1713480378177,LIIT 5BS,A00,507430,Carnelos; Chiara,20,0,20,0
1713480379202,LIIT 5CS,A00,507432,Carnelos; Chiara,20,0,20,0
1713480380229,LISP 5A,A00,507541,Munoz Sanchez; Alicia,14,0,20,6
1713480381255,LISP 5B,A00,507671,Munoz Sanchez; Alicia,12,0,20,8
1713480382280,LISP 5C,A00,507696,Munoz Sanchez; Alicia,11,0,20,9
1713480383310,MAE 197,001,528363,Boechler; Nicholas Sebastia,9998,0,9999,1
1713480384337,MATH 197,001,523477,Kedlaya; Kiran S.,9999,0,9999,0
1713480384337,MATH 197,002,563811,Zhang; Danna,9998,0,9999,1
1713480385362,MCWP 40R,A00,518780,Staff,17,0,20,3
1713480385362,MCWP 40R,B00,518781,Staff,14,0,20,6
1713480385362,MCWP 40R,C00,518783,Staff,12,0,20,8
1713480386449,MCWP 50R,A00,518791,Staff,8,0,20,12
1713480386449,MCWP 50R,B00,518792,Staff,7,0,20,13
1713480386449,MCWP 50R,C00,518793,Staff,7,0,20,13
1713480386449,MCWP 50R,D00,518794,Staff,3,0,20,17
1713480386449,MCWP 50R,E00,518795,Staff,5,0,20,15
1713480386449,MCWP 50R,F00,518796,Staff,15,0,20,5
1713480386449,MCWP 50R,G00,518797,Staff,13,0,20,7
1713480387474,MMW 12R,A01,514034,Herbst; Matthew,9,0,16,7
1713480387474,MMW 12R,A02,514035,Herbst; Matthew,14,0,16,2
1713480388499,MMW 13R,A01,514037,Staff,0,0,16,16
1713480388499,MMW 13R,A02,514039,Staff,0,1,16,16
1713480390555,SIO 295LS,A00,523233,Staff,15,0,30,15
1713480391579,SIO 295S,A00,523232,Staff,15,0,30,15
1713480392605,SOCI 117,A01,494376,Staff,0,2,5,5
1713480393630,WES 237B,A00,494380,Staff,19,0,20,1
1713480395695,AESE 279B,A00,494370,Wade; Jon P,33,0,33,0
1713480396721,AIP 197,001,627712,Vespa; Emanuel Ignacio,9999,0,9999,0
1713480397745,ANAR 135S,A00,494369,Braswell; Geoffrey E.,0,0,0,0
1713480398772,CAT 124RS,A01,519847,Geibel; William,6,0,20,14
1713480399800,CAT 125RS,A01,515971,Geibel; William,6,0,20,14
1713480400826,CLRE 250,A00,511389,Morris; Sheldon,9996,0,9999,3
1713480401853,CLRE 251,A00,507176,Mehta; Ravindra L.,9996,0,9999,3
1713480401853,CLRE 251,B00,511410,Mehta; Ravindra L.,9998,0,9999,1
1713480402879,CLRE 252,A00,507189,Cuomo; Raphael Eduardo,9998,0,9999,1
1713480403905,CLRE 253,A00,507199,Vaida; Florin,9997,0,9999,2
1713480403905,CLRE 253,B00,507202,Vaida; Florin,9999,0,9999,0
1713480404931,CLRE 259,A00,507211,Patel; Hemal,9996,0,9999,3
1713480405956,CLRE 260,A00,507221,Cuomo; Raphael Eduardo,9999,0,9999,0
1713480406981,CLRE 297,001,507242,Cuomo; Raphael Eduardo,9999,0,9999,0
1713480408005,CSE 191,A00,516875,Minnes Kemp; Mor Mia,9999,0,9999,0
1713480409032,CSS 201S,A01,494383,Staff,35,0,35,0
1713480410057,CSS 202S,A01,494387,Staff,35,0,35,0
1713480411083,EAP 100,A00,516065,Staff,9792,0,9999,207
1713480412109,ECE 45,A01,507414,Staff,40,0,60,20
1713480413134,ECE 100,A01,507416,Baghdadchi; Saharnaz,3,0,20,17
1713480413134,ECE 100,A02,507418,Baghdadchi; Saharnaz,19,0,20,1
1713480414160,ECE 111,A01,507420,Staff,28,0,50,22
1713480415184,ECE 197,001,548057,Sievenpiper; Daniel F.,9998,0,9999,1
1713480416210,EDS 115,A00,507243,Choi; Bailey Miyeon,27,0,28,1
1713480417238,EDS 117,A01,494379,Staff,16,0,25,9
1713480418266,EDS 125,A00,507246,Hopkins; Megan Beth,28,0,30,2
1713480419292,EDS 128A,A01,507264,Fargason; Sharon Gayle,26,0,26,0
1713480420318,EDS 128B,A01,507293,Pappas; Elizabeth,30,0,30,0
1713480421346,EDS 139,A00,507294,Fargason; Sharon Gayle,30,0,30,0
1713480421346,EDS 139,B00,507313,Pappas; Elizabeth,30,0,30,0
1713480422373,EDS 201,A00,507315,Staff,19,0,30,11
1713480423398,EDS 203,A01,507317,Halter; Christopher P.,18,0,30,12
1713480424427,EDS 204R,A01,507319,Halter; Christopher P.,0,1,30,30
1713480424427,EDS 204R,B01,507331,Heinzman; Erica M.,26,0,30,4
1713480425454,EDS 206R,A00,507332,Staff,0,1,30,30
1713480425454,EDS 206R,B00,507343,Staff,27,0,30,3
1713480426482,EDS 250,A00,507344,Hemans; Patricia Ann Benitez,28,0,40,12
1713480427510,EDS 281,A00,507345,Daly; Alan J.,18,0,18,0
1713480428534,EDS 284,A00,507350,Daly; Alan J.,16,0,16,0
1713480429558,EDS 286,A00,507359,Fine; Sarah,18,0,18,0
1713480430585,EDS 289C,A01,507361,Daly; Alan J.,18,0,18,0
1713480431613,EDS 290,A00,507366,Hofstetter; Carolyn,15,0,15,0
1713480432638,LIGM 5A,A00,507421,Fischer-Grunski; Eva K,20,0,20,0
1713480433662,LIGM 5B,A00,507423,Fischer-Grunski; Eva K,20,0,20,0
1713480434687,LIGM 5C,A00,507425,Fischer-Grunski; Eva K,20,0,20,0
1713480435716,LIIT 5AS,A00,507427,Carnelos; Chiara,20,0,20,0
1713480436740,LIIT 5BS,A00,507430,Carnelos; Chiara,20,0,20,0
1713480437764,LIIT 5CS,A00,507432,Carnelos; Chiara,20,0,20,0
1713480438794,LISP 5A,A00,507541,Munoz Sanchez; Alicia,14,0,20,6
1713480439817,LISP 5B,A00,507671,Munoz Sanchez; Alicia,12,0,20,8
1713480440842,LISP 5C,A00,507696,Munoz Sanchez; Alicia,11,0,20,9
1713480441868,MAE 197,001,528363,Boechler; Nicholas Sebastia,9998,0,9999,1
1713480442894,MATH 197,001,523477,Kedlaya; Kiran S.,9999,0,9999,0
1713480442894,MATH 197,002,563811,Zhang; Danna,9998,0,9999,1
1713480443924,MCWP 40R,A00,518780,Staff,17,0,20,3
1713480443924,MCWP 40R,B00,518781,Staff,14,0,20,6
1713480443924,MCWP 40R,C00,518783,Staff,12,0,20,8
1713480444949,MCWP 50R,A00,518791,Staff,8,0,20,12
1713480444949,MCWP 50R,B00,518792,Staff,7,0,20,13
1713480444949,MCWP 50R,C00,518793,Staff,7,0,20,13
1713480444949,MCWP 50R,D00,518794,Staff,3,0,20,17
1713480444949,MCWP 50R,E00,518795,Staff,5,0,20,15
1713480444949,MCWP 50R,F00,518796,Staff,15,0,20,5
1713480444949,MCWP 50R,G00,518797,Staff,13,0,20,7
1713480445974,MMW 12R,A01,514034,Herbst; Matthew,9,0,16,7
1713480445974,MMW 12R,A02,514035,Herbst; Matthew,14,0,16,2
1713480447003,MMW 13R,A01,514037,Staff,0,0,16,16
1713480447003,MMW 13R,A02,514039,Staff,0,1,16,16
1713480449059,SIO 295LS,A00,523233,Staff,15,0,30,15
1713480450085,SIO 295S,A00,523232,Staff,15,0,30,15
1713480451126,SOCI 117,A01,494376,Staff,0,2,5,5
1713480452152,WES 237B,A00,494380,Staff,19,0,20,1
1713480454214,AESE 279B,A00,494370,Wade; Jon P,33,0,33,0
1713480455240,AIP 197,001,627712,Vespa; Emanuel Ignacio,9999,0,9999,0
1713480456267,ANAR 135S,A00,494369,Braswell; Geoffrey E.,0,0,0,0
1713480457292,CAT 124RS,A01,519847,Geibel; William,6,0,20,14
1713480458317,CAT 125RS,A01,515971,Geibel; William,6,0,20,14
1713480459343,CLRE 250,A00,511389,Morris; Sheldon,9996,0,9999,3
1713480460369,CLRE 251,A00,507176,Mehta; Ravindra L.,9996,0,9999,3
1713480460369,CLRE 251,B00,511410,Mehta; Ravindra L.,9998,0,9999,1
1713480461394,CLRE 252,A00,507189,Cuomo; Raphael Eduardo,9998,0,9999,1
1713480462426,CLRE 253,A00,507199,Vaida; Florin,9997,0,9999,2
1713480462426,CLRE 253,B00,507202,Vaida; Florin,9999,0,9999,0
1713480463453,CLRE 259,A00,507211,Patel; Hemal,9996,0,9999,3
1713480464480,CLRE 260,A00,507221,Cuomo; Raphael Eduardo,9999,0,9999,0
1713480465505,CLRE 297,001,507242,Cuomo; Raphael Eduardo,9999,0,9999,0
1713480466529,CSE 191,A00,516875,Minnes Kemp; Mor Mia,9999,0,9999,0
1713480467556,CSS 201S,A01,494383,Staff,35,0,35,0
1713480468581,CSS 202S,A01,494387,Staff,35,0,35,0
1713480469608,EAP 100,A00,516065,Staff,9792,0,9999,207
1713480470632,ECE 45,A01,507414,Staff,40,0,60,20
1713480471663,ECE 100,A01,507416,Baghdadchi; Saharnaz,3,0,20,17
1713480471663,ECE 100,A02,507418,Baghdadchi; Saharnaz,19,0,20,1
1713480472688,ECE 111,A01,507420,Staff,28,0,50,22
1713480473719,ECE 197,001,548057,Sievenpiper; Daniel F.,9998,0,9999,1
1713480474748,EDS 115,A00,507243,Choi; Bailey Miyeon,27,0,28,1
1713480475772,EDS 117,A01,494379,Staff,16,0,25,9
1713480476800,EDS 125,A00,507246,Hopkins; Megan Beth,28,0,30,2
1713480477826,EDS 128A,A01,507264,Fargason; Sharon Gayle,26,0,26,0
1713480478850,EDS 128B,A01,507293,Pappas; Elizabeth,30,0,30,0
1713480479875,EDS 139,A00,507294,Fargason; Sharon Gayle,30,0,30,0
1713480479875,EDS 139,B00,507313,Pappas; Elizabeth,30,0,30,0
1713480480899,EDS 201,A00,507315,Staff,19,0,30,11
1713480481925,EDS 203,A01,507317,Halter; Christopher P.,18,0,30,12
1713480482950,EDS 204R,A01,507319,Halter; Christopher P.,0,1,30,30
1713480482950,EDS 204R,B01,507331,Heinzman; Erica M.,26,0,30,4
1713480483976,EDS 206R,A00,507332,Staff,0,1,30,30
1713480483976,EDS 206R,B00,507343,Staff,27,0,30,3
1713480485000,EDS 250,A00,507344,Hemans; Patricia Ann Benitez,28,0,40,12
1713480486030,EDS 281,A00,507345,Daly; Alan J.,18,0,18,0
1713480487054,EDS 284,A00,507350,Daly; Alan J.,16,0,16,0
1713480488079,EDS 286,A00,507359,Fine; Sarah,18,0,18,0
1713480489106,EDS 289C,A01,507361,Daly; Alan J.,18,0,18,0
1713480490186,EDS 290,A00,507366,Hofstetter; Carolyn,15,0,15,0
1713480491216,LIGM 5A,A00,507421,Fischer-Grunski; Eva K,20,0,20,0
1713480492243,LIGM 5B,A00,507423,Fischer-Grunski; Eva K,20,0,20,0
1713480493270,LIGM 5C,A00,507425,Fischer-Grunski; Eva K,20,0,20,0
1713480494298,LIIT 5AS,A00,507427,Carnelos; Chiara,20,0,20,0
1713480495325,LIIT 5BS,A00,507430,Carnelos; Chiara,20,0,20,0
1713480496355,LIIT 5CS,A00,507432,Carnelos; Chiara,20,0,20,0
1713480497379,LISP 5A,A00,507541,Munoz Sanchez; Alicia,14,0,20,6
1713480498405,LISP 5B,A00,507671,Munoz Sanchez; Alicia,12,0,20,8
1713480499432,LISP 5C,A00,507696,Munoz Sanchez; Alicia,11,0,20,9
1713480500458,MAE 197,001,528363,Boechler; Nicholas Sebastia,9998,0,9999,1
1713480501484,MATH 197,001,523477,Kedlaya; Kiran S.,9999,0,9999,0
1713480501484,MATH 197,002,563811,Zhang; Danna,9998,0,9999,1
1713480502509,MCWP 40R,A00,518780,Staff,17,0,20,3
1713480502509,MCWP 40R,B00,518781,Staff,14,0,20,6
1713480502509,MCWP 40R,C00,518783,Staff,12,0,20,8
1713480503535,MCWP 50R,A00,518791,Staff,8,0,20,12
1713480503535,MCWP 50R,B00,518792,Staff,7,0,20,13
1713480503535,MCWP 50R,C00,518793,Staff,7,0,20,13
1713480503535,MCWP 50R,D00,518794,Staff,2,0,20,18
1713480503535,MCWP 50R,E00,518795,Staff,5,0,20,15
1713480503535,MCWP 50R,F00,518796,Staff,15,0,20,5
1713480503535,MCWP 50R,G00,518797,Staff,13,0,20,7
1713480504562,MMW 12R,A01,514034,Herbst; Matthew,9,0,16,7
1713480504562,MMW 12R,A02,514035,Herbst; Matthew,14,0,16,2
1713480505586,MMW 13R,A01,514037,Staff,0,0,16,16
1713480505586,MMW 13R,A02,514039,Staff,0,1,16,16
1713480507636,SIO 295LS,A00,523233,Staff,15,0,30,15
1713480508663,SIO 295S,A00,523232,Staff,15,0,30,15
1713480509692,SOCI 117,A01,494376,Staff,0,2,5,5
1713480510717,WES 237B,A00,494380,Staff,19,0,20,1
1713480512782,AESE 279B,A00,494370,Wade; Jon P,33,0,33,0
1713480513807,AIP 197,001,627712,Vespa; Emanuel Ignacio,9999,0,9999,0
1713480514832,ANAR 135S,A00,494369,Braswell; Geoffrey E.,0,0,0,0
1713480515858,CAT 124RS,A01,519847,Geibel; William,6,0,20,14
1713480516888,CAT 125RS,A01,515971,Geibel; William,6,0,20,14
1713480517917,CLRE 250,A00,511389,Morris; Sheldon,9996,0,9999,3
1713480518947,CLRE 251,A00,507176,Mehta; Ravindra L.,9996,0,9999,3
1713480518947,CLRE 251,B00,511410,Mehta; Ravindra L.,9998,0,9999,1
1713480519978,CLRE 252,A00,507189,Cuomo; Raphael Eduardo,9998,0,9999,1
1713480521004,CLRE 253,A00,507199,Vaida; Florin,9997,0,9999,2
1713480521004,CLRE 253,B00,507202,Vaida; Florin,9999,0,9999,0
1713480522029,CLRE 259,A00,507211,Patel; Hemal,9996,0,9999,3
1713480523054,CLRE 260,A00,507221,Cuomo; Raphael Eduardo,9999,0,9999,0
1713480524080,CLRE 297,001,507242,Cuomo; Raphael Eduardo,9999,0,9999,0
1713480525109,CSE 191,A00,516875,Minnes Kemp; Mor Mia,9999,0,9999,0
1713480526134,CSS 201S,A01,494383,Staff,35,0,35,0
1713480527159,CSS 202S,A01,494387,Staff,35,0,35,0
1713480528183,EAP 100,A00,516065,Staff,9792,0,9999,207
1713480529213,ECE 45,A01,507414,Staff,40,0,60,20
1713480530239,ECE 100,A01,507416,Baghdadchi; Saharnaz,3,0,20,17
1713480530239,ECE 100,A02,507418,Baghdadchi; Saharnaz,19,0,20,1
1713480531268,ECE 111,A01,507420,Staff,28,0,50,22
1713480532297,ECE 197,001,548057,Sievenpiper; Daniel F.,9998,0,9999,1
1713480533323,EDS 115,A00,507243,Choi; Bailey Miyeon,27,0,28,1
1713480534354,EDS 117,A01,494379,Staff,16,0,25,9
1713480535382,EDS 125,A00,507246,Hopkins; Megan Beth,28,0,30,2
1713480536410,EDS 128A,A01,507264,Fargason; Sharon Gayle,26,0,26,0
1713480537440,EDS 128B,A01,507293,Pappas; Elizabeth,30,0,30,0
1713480538465,EDS 139,A00,507294,Fargason; Sharon Gayle,30,0,30,0
1713480538465,EDS 139,B00,507313,Pappas; Elizabeth,30,0,30,0
1713480539492,EDS 201,A00,507315,Staff,19,0,30,11
1713480540577,EDS 203,A01,507317,Halter; Christopher P.,18,0,30,12
1713480541607,EDS 204R,A01,507319,Halter; Christopher P.,0,1,30,30
1713480541607,EDS 204R,B01,507331,Heinzman; Erica M.,26,0,30,4
1713480542631,EDS 206R,A00,507332,Staff,0,1,30,30
1713480542631,EDS 206R,B00,507343,Staff,27,0,30,3
1713480543656,EDS 250,A00,507344,Hemans; Patricia Ann Benitez,28,0,40,12
1713480544682,EDS 281,A00,507345,Daly; Alan J.,18,0,18,0
1713480545707,EDS 284,A00,507350,Daly; Alan J.,16,0,16,0
1713480546733,EDS 286,A00,507359,Fine; Sarah,18,0,18,0
1713480547760,EDS 289C,A01,507361,Daly; Alan J.,18,0,18,0
1713480548788,EDS 290,A00,507366,Hofstetter; Carolyn,15,0,15,0
1713480549818,LIGM 5A,A00,507421,Fischer-Grunski; Eva K,20,0,20,0
1713480550842,LIGM 5B,A00,507423,Fischer-Grunski; Eva K,20,0,20,0
1713480551871,LIGM 5C,A00,507425,Fischer-Grunski; Eva K,20,0,20,0
1713480552897,LIIT 5AS,A00,507427,Carnelos; Chiara,20,0,20,0
1713480553921,LIIT 5BS,A00,507430,Carnelos; Chiara,20,0,20,0
1713480554946,LIIT 5CS,A00,507432,Carnelos; Chiara,20,0,20,0
1713480555976,LISP 5A,A00,507541,Munoz Sanchez; Alicia,14,0,20,6
1713480557001,LISP 5B,A00,507671,Munoz Sanchez; Alicia,12,0,20,8
1713480558027,LISP 5C,A00,507696,Munoz Sanchez; Alicia,11,0,20,9
1713480559057,MAE 197,001,528363,Boechler; Nicholas Sebastia,9998,0,9999,1
1713480560178,MATH 197,001,523477,Kedlaya; Kiran S.,9999,0,9999,0
1713480560178,MATH 197,002,563811,Zhang; Danna,9998,0,9999,1
1713480561204,MCWP 40R,A00,518780,Staff,17,0,20,3
1713480561204,MCWP 40R,B00,518781,Staff,14,0,20,6
1713480561204,MCWP 40R,C00,518783,Staff,12,0,20,8
1713480562236,MCWP 50R,A00,518791,Staff,8,0,20,12
1713480562236,MCWP 50R,B00,518792,Staff,7,0,20,13
1713480562236,MCWP 50R,C00,518793,Staff,7,0,20,13
1713480562236,MCWP 50R,D00,518794,Staff,2,0,20,18
1713480562236,MCWP 50R,E00,518795,Staff,5,0,20,15
1713480562236,MCWP 50R,F00,518796,Staff,14,0,20,6
1713480562236,MCWP 50R,G00,518797,Staff,13,0,20,7
1713480563266,MMW 12R,A01,514034,Herbst; Matthew,9,0,16,7
1713480563266,MMW 12R,A02,514035,Herbst; Matthew,14,0,16,2
1713480564292,MMW 13R,A01,514037,Staff,0,0,16,16
1713480564292,MMW 13R,A02,514039,Staff,0,1,16,16
1713480566343,SIO 295LS,A00,523233,Staff,15,0,30,15
1713480567367,SIO 295S,A00,523232,Staff,15,0,30,15
1713480568396,SOCI 117,A01,494376,Staff,0,2,5,5
1713480569420,WES 237B,A00,494380,Staff,19,0,20,1
1713480571477,AESE 279B,A00,494370,Wade; Jon P,33,0,33,0
1713480572504,AIP 197,001,627712,Vespa; Emanuel Ignacio,9999,0,9999,0
1713480573533,ANAR 135S,A00,494369,Braswell; Geoffrey E.,0,0,0,0
1713480574558,CAT 124RS,A01,519847,Geibel; William,6,0,20,14
1713480575586,CAT 125RS,A01,515971,Geibel; William,6,0,20,14
1713480576613,CLRE 250,A00,511389,Morris; Sheldon,9996,0,9999,3
1713480577640,CLRE 251,A00,507176,Mehta; Ravindra L.,9996,0,9999,3
1713480577640,CLRE 251,B00,511410,Mehta; Ravindra L.,9998,0,9999,1
1713480578666,CLRE 252,A00,507189,Cuomo; Raphael Eduardo,9998,0,9999,1
1713480579692,CLRE 253,A00,507199,Vaida; Florin,9997,0,9999,2
1713480579692,CLRE 253,B00,507202,Vaida; Florin,9999,0,9999,0
1713480580718,CLRE 259,A00,507211,Patel; Hemal,9996,0,9999,3
1713480581746,CLRE 260,A00,507221,Cuomo; Raphael Eduardo,9999,0,9999,0
1713480582774,CLRE 297,001,507242,Cuomo; Raphael Eduardo,9999,0,9999,0
1713480583800,CSE 191,A00,516875,Minnes Kemp; Mor Mia,9999,0,9999,0
1713480584825,CSS 201S,A01,494383,Staff,35,0,35,0
1713480585855,CSS 202S,A01,494387,Staff,35,0,35,0
1713480586879,EAP 100,A00,516065,Staff,9792,0,9999,207
1713480587905,ECE 45,A01,507414,Staff,40,0,60,20
1713480588936,ECE 100,A01,507416,Baghdadchi; Saharnaz,3,0,20,17
1713480588936,ECE 100,A02,507418,Baghdadchi; Saharnaz,19,0,20,1
1713480589961,ECE 111,A01,507420,Staff,28,0,50,22
1713480590988,ECE 197,001,548057,Sievenpiper; Daniel F.,9998,0,9999,1
1713480592019,EDS 115,A00,507243,Choi; Bailey Miyeon,27,0,28,1
1713480593044,EDS 117,A01,494379,Staff,16,0,25,9
1713480594128,EDS 125,A00,507246,Hopkins; Megan Beth,28,0,30,2
1713480595156,EDS 128A,A01,507264,Fargason; Sharon Gayle,26,0,26,0
1713480596183,EDS 128B,A01,507293,Pappas; Elizabeth,30,0,30,0
1713480597213,EDS 139,A00,507294,Fargason; Sharon Gayle,30,0,30,0
1713480597213,EDS 139,B00,507313,Pappas; Elizabeth,30,0,30,0
1713480598243,EDS 201,A00,507315,Staff,19,0,30,11
1713480599269,EDS 203,A01,507317,Halter; Christopher P.,18,0,30,12
1713480600295,EDS 204R,A01,507319,Halter; Christopher P.,0,1,30,30
1713480600295,EDS 204R,B01,507331,Heinzman; Erica M.,26,0,30,4
1713480601320,EDS 206R,A00,507332,Staff,0,1,30,30
1713480601320,EDS 206R,B00,507343,Staff,27,0,30,3
1713480602345,EDS 250,A00,507344,Hemans; Patricia Ann Benitez,28,0,40,12
1713480603370,EDS 281,A00,507345,Daly; Alan J.,18,0,18,0
1713480604395,EDS 284,A00,507350,Daly; Alan J.,16,0,16,0
1713480605424,EDS 286,A00,507359,Fine; Sarah,18,0,18,0
1713480606453,EDS 289C,A01,507361,Daly; Alan J.,18,0,18,0
1713480607480,EDS 290,A00,507366,Hofstetter; Carolyn,15,0,15,0
1713480608526,LIGM 5A,A00,507421,Fischer-Grunski; Eva K,20,0,20,0
1713480609554,LIGM 5B,A00,507423,Fischer-Grunski; Eva K,20,0,20,0
1713480610579,LIGM 5C,A00,507425,Fischer-Grunski; Eva K,20,0,20,0
1713480611609,LIIT 5AS,A00,507427,Carnelos; Chiara,20,0,20,0
1713480612635,LIIT 5BS,A00,507430,Carnelos; Chiara,20,0,20,0
1713480613667,LIIT 5CS,A00,507432,Carnelos; Chiara,20,0,20,0
1713480614693,LISP 5A,A00,507541,Munoz Sanchez; Alicia,14,0,20,6
1713480615725,LISP 5B,A00,507671,Munoz Sanchez; Alicia,12,0,20,8
1713480616754,LISP 5C,A00,507696,Munoz Sanchez; Alicia,11,0,20,9
1713480617778,MAE 197,001,528363,Boechler; Nicholas Sebastia,9998,0,9999,1
1713480618803,MATH 197,001,523477,Kedlaya; Kiran S.,9999,0,9999,0
1713480618803,MATH 197,002,563811,Zhang; Danna,9998,0,9999,1
1713480619833,MCWP 40R,A00,518780,Staff,17,0,20,3
1713480619833,MCWP 40R,B00,518781,Staff,14,0,20,6
1713480619833,MCWP 40R,C00,518783,Staff,12,0,20,8
1713480620857,MCWP 50R,A00,518791,Staff,8,0,20,12
1713480620857,MCWP 50R,B00,518792,Staff,7,0,20,13
1713480620857,MCWP 50R,C00,518793,Staff,7,0,20,13
1713480620857,MCWP 50R,D00,518794,Staff,2,0,20,18
1713480620857,MCWP 50R,E00,518795,Staff,5,0,20,15
1713480620857,MCWP 50R,F00,518796,Staff,14,0,20,6
1713480620857,MCWP 50R,G00,518797,Staff,13,0,20,7
1713480621886,MMW 12R,A01,514034,Herbst; Matthew,9,0,16,7
1713480621886,MMW 12R,A02,514035,Herbst; Matthew,14,0,16,2
1713480622911,MMW 13R,A01,514037,Staff,0,0,16,16
1713480622911,MMW 13R,A02,514039,Staff,0,1,16,16
1713480624963,SIO 295LS,A00,523233,Staff,15,0,30,15
1713480625990,SIO 295S,A00,523232,Staff,15,0,30,15
1713480627015,SOCI 117,A01,494376,Staff,0,2,5,5
1713480628041,WES 237B,A00,494380,Staff,19,0,20,1
1713480630114,AESE 279B,A00,494370,Wade; Jon P,33,0,33,0
1713480631139,AIP 197,001,627712,Vespa; Emanuel Ignacio,9999,0,9999,0
1713480632166,ANAR 135S,A00,494369,Braswell; Geoffrey E.,0,0,0,0
1713480633196,CAT 124RS,A01,519847,Geibel; William,6,0,20,14
1713480634225,CAT 125RS,A01,515971,Geibel; William,6,0,20,14
1713480635338,CLRE 250,A00,511389,Morris; Sheldon,9996,0,9999,3
1713480636371,CLRE 251,A00,507176,Mehta; Ravindra L.,9996,0,9999,3
1713480636371,CLRE 251,B00,511410,Mehta; Ravindra L.,9998,0,9999,1
1713480637396,CLRE 252,A00,507189,Cuomo; Raphael Eduardo,9998,0,9999,1
1713480638428,CLRE 253,A00,507199,Vaida; Florin,9997,0,9999,2
1713480638428,CLRE 253,B00,507202,Vaida; Florin,9999,0,9999,0
1713480639455,CLRE 259,A00,507211,Patel; Hemal,9996,0,9999,3
1713480640478,CLRE 260,A00,507221,Cuomo; Raphael Eduardo,9999,0,9999,0
1713480641503,CLRE 297,001,507242,Cuomo; Raphael Eduardo,9999,0,9999,0
1713480642528,CSE 191,A00,516875,Minnes Kemp; Mor Mia,9999,0,9999,0
1713480643553,CSS 201S,A01,494383,Staff,35,0,35,0
1713480644586,CSS 202S,A01,494387,Staff,35,0,35,0
1713480645610,EAP 100,A00,516065,Staff,9792,0,9999,207
1713480646638,ECE 45,A01,507414,Staff,40,0,60,20
1713480647661,ECE 100,A01,507416,Baghdadchi; Saharnaz,3,0,20,17
1713480647661,ECE 100,A02,507418,Baghdadchi; Saharnaz,19,0,20,1
1713480648685,ECE 111,A01,507420,Staff,28,0,50,22
1713480649710,ECE 197,001,548057,Sievenpiper; Daniel F.,9998,0,9999,1
1713480650737,EDS 115,A00,507243,Choi; Bailey Miyeon,27,0,28,1
1713480651769,EDS 117,A01,494379,Staff,16,0,25,9
1713480652794,EDS 125,A00,507246,Hopkins; Megan Beth,28,0,30,2
1713480653820,EDS 128A,A01,507264,Fargason; Sharon Gayle,26,0,26,0
1713480654851,EDS 128B,A01,507293,Pappas; Elizabeth,30,0,30,0
1713480655875,EDS 139,A00,507294,Fargason; Sharon Gayle,30,0,30,0
1713480655875,EDS 139,B00,507313,Pappas; Elizabeth,30,0,30,0
1713480656911,EDS 201,A00,507315,Staff,19,0,30,11
1713480657937,EDS 203,A01,507317,Halter; Christopher P.,18,0,30,12
1713480658963,EDS 204R,A01,507319,Halter; Christopher P.,0,1,30,30
1713480658963,EDS 204R,B01,507331,Heinzman; Erica M.,26,0,30,4
1713480659987,EDS 206R,A00,507332,Staff,0,1,30,30
1713480659987,EDS 206R,B00,507343,Staff,27,0,30,3
1713480661012,EDS 250,A00,507344,Hemans; Patricia Ann Benitez,28,0,40,12
1713480662038,EDS 281,A00,507345,Daly; Alan J.,18,0,18,0
1713480663070,EDS 284,A00,507350,Daly; Alan J.,16,0,16,0
1713480664100,EDS 286,A00,507359,Fine; Sarah,18,0,18,0
1713480665129,EDS 289C,A01,507361,Daly; Alan J.,18,0,18,0
1713480666157,EDS 290,A00,507366,Hofstetter; Carolyn,15,0,15,0
1713480667184,LIGM 5A,A00,507421,Fischer-Grunski; Eva K,20,0,20,0
1713480668212,LIGM 5B,A00,507423,Fischer-Grunski; Eva K,20,0,20,0
1713480669239,LIGM 5C,A00,507425,Fischer-Grunski; Eva K,20,0,20,0
1713480670267,LIIT 5AS,A00,507427,Carnelos; Chiara,20,0,20,0
1713480671292,LIIT 5BS,A00,507430,Carnelos; Chiara,20,0,20,0
1713480672316,LIIT 5CS,A00,507432,Carnelos; Chiara,20,0,20,0
1713480673341,LISP 5A,A00,507541,Munoz Sanchez; Alicia,14,0,20,6
1713480674366,LISP 5B,A00,507671,Munoz Sanchez; Alicia,12,0,20,8
1713480675397,LISP 5C,A00,507696,Munoz Sanchez; Alicia,11,0,20,9
1713480676423,MAE 197,001,528363,Boechler; Nicholas Sebastia,9998,0,9999,1
1713480677453,MATH 197,001,523477,Kedlaya; Kiran S.,9999,0,9999,0
1713480677453,MATH 197,002,563811,Zhang; Danna,9998,0,9999,1
1713480678482,MCWP 40R,A00,518780,Staff,17,0,20,3
1713480678482,MCWP 40R,B00,518781,Staff,14,0,20,6
1713480678482,MCWP 40R,C00,518783,Staff,12,0,20,8
1713480679512,MCWP 50R,A00,518791,Staff,8,0,20,12
1713480679512,MCWP 50R,B00,518792,Staff,7,0,20,13
1713480679512,MCWP 50R,C00,518793,Staff,7,0,20,13
1713480679512,MCWP 50R,D00,518794,Staff,2,0,20,18
1713480679512,MCWP 50R,E00,518795,Staff,5,0,20,15
1713480679512,MCWP 50R,F00,518796,Staff,14,0,20,6
1713480679512,MCWP 50R,G00,518797,Staff,13,0,20,7
1713480680541,MMW 12R,A01,514034,Herbst; Matthew,8,0,16,8
1713480680541,MMW 12R,A02,514035,Herbst; Matthew,14,0,16,2
1713480681569,MMW 13R,A01,514037,Staff,0,0,16,16
1713480681569,MMW 13R,A02,514039,Staff,0,1,16,16
1713480683617,SIO 295LS,A00,523233,Staff,15,0,30,15
1713480684644,SIO 295S,A00,523232,Staff,15,0,30,15
1713480685668,SOCI 117,A01,494376,Staff,0,2,5,5
1713480686693,WES 237B,A00,494380,Staff,19,0,20,1
1713480688757,AESE 279B,A00,494370,Wade; Jon P,33,0,33,0
1713480689781,AIP 197,001,627712,Vespa; Emanuel Ignacio,9999,0,9999,0
1713480690811,ANAR 135S,A00,494369,Braswell; Geoffrey E.,0,0,0,0
1713480691839,CAT 124RS,A01,519847,Geibel; William,6,0,20,14
1713480692864,CAT 125RS,A01,515971,Geibel; William,6,0,20,14
1713480693905,CLRE 250,A00,511389,Morris; Sheldon,9996,0,9999,3
1713480694932,CLRE 251,A00,507176,Mehta; Ravindra L.,9996,0,9999,3
1713480694932,CLRE 251,B00,511410,Mehta; Ravindra L.,9998,0,9999,1
1713480695957,CLRE 252,A00,507189,Cuomo; Raphael Eduardo,9998,0,9999,1
1713480696983,CLRE 253,A00,507199,Vaida; Florin,9997,0,9999,2
1713480696983,CLRE 253,B00,507202,Vaida; Florin,9999,0,9999,0
1713480698062,CLRE 259,A00,507211,Patel; Hemal,9996,0,9999,3
1713480699089,CLRE 260,A00,507221,Cuomo; Raphael Eduardo,9999,0,9999,0
1713480700112,CLRE 297,001,507242,Cuomo; Raphael Eduardo,9999,0,9999,0
1713480701137,CSE 191,A00,516875,Minnes Kemp; Mor Mia,9999,0,9999,0
1713480702164,CSS 201S,A01,494383,Staff,35,0,35,0
1713480703190,CSS 202S,A01,494387,Staff,35,0,35,0
1713480704218,EAP 100,A00,516065,Staff,9792,0,9999,207
1713480705247,ECE 45,A01,507414,Staff,39,0,60,21
1713480706271,ECE 100,A01,507416,Baghdadchi; Saharnaz,3,0,20,17
1713480706271,ECE 100,A02,507418,Baghdadchi; Saharnaz,19,0,20,1
1713480707297,ECE 111,A01,507420,Staff,28,0,50,22
1713480708326,ECE 197,001,548057,Sievenpiper; Daniel F.,9998,0,9999,1
1713480709355,EDS 115,A00,507243,Choi; Bailey Miyeon,27,0,28,1
1713480710380,EDS 117,A01,494379,Staff,16,0,25,9
1713480711411,EDS 125,A00,507246,Hopkins; Megan Beth,28,0,30,2
1713480712474,EDS 128A,A01,507264,Fargason; Sharon Gayle,26,0,26,0
1713480713500,EDS 128B,A01,507293,Pappas; Elizabeth,30,0,30,0
1713480714525,EDS 139,A00,507294,Fargason; Sharon Gayle,30,0,30,0
1713480714525,EDS 139,B00,507313,Pappas; Elizabeth,30,0,30,0
1713480715549,EDS 201,A00,507315,Staff,19,0,30,11
1713480716578,EDS 203,A01,507317,Halter; Christopher P.,18,0,30,12
1713480717609,EDS 204R,A01,507319,Halter; Christopher P.,0,1,30,30
1713480717609,EDS 204R,B01,507331,Heinzman; Erica M.,26,0,30,4
1713480718636,EDS 206R,A00,507332,Staff,0,1,30,30
1713480718636,EDS 206R,B00,507343,Staff,27,0,30,3
1713480719662,EDS 250,A00,507344,Hemans; Patricia Ann Benitez,28,0,40,12
1713480720685,EDS 281,A00,507345,Daly; Alan J.,18,0,18,0
1713480721710,EDS 284,A00,507350,Daly; Alan J.,16,0,16,0
1713480722738,EDS 286,A00,507359,Fine; Sarah,18,0,18,0
1713480723763,EDS 289C,A01,507361,Daly; Alan J.,18,0,18,0
1713480724789,EDS 290,A00,507366,Hofstetter; Carolyn,15,0,15,0
1713480725818,LIGM 5A,A00,507421,Fischer-Grunski; Eva K,20,0,20,0
1713480726848,LIGM 5B,A00,507423,Fischer-Grunski; Eva K,20,0,20,0
1713480727880,LIGM 5C,A00,507425,Fischer-Grunski; Eva K,20,0,20,0
1713480728915,LIIT 5AS,A00,507427,Carnelos; Chiara,20,0,20,0
1713480729941,LIIT 5BS,A00,507430,Carnelos; Chiara,20,0,20,0
1713480730968,LIIT 5CS,A00,507432,Carnelos; Chiara,20,0,20,0
1713480731994,LISP 5A,A00,507541,Munoz Sanchez; Alicia,14,0,20,6
1713480733021,LISP 5B,A00,507671,Munoz Sanchez; Alicia,12,0,20,8
1713480734048,LISP 5C,A00,507696,Munoz Sanchez; Alicia,11,0,20,9
1713480735074,MAE 197,001,528363,Boechler; Nicholas Sebastia,9998,0,9999,1
1713480736106,MATH 197,001,523477,Kedlaya; Kiran S.,9999,0,9999,0
1713480736106,MATH 197,002,563811,Zhang; Danna,9998,0,9999,1
1713480737131,MCWP 40R,A00,518780,Staff,17,0,20,3
1713480737131,MCWP 40R,B00,518781,Staff,14,0,20,6
1713480737131,MCWP 40R,C00,518783,Staff,12,0,20,8
1713480738155,MCWP 50R,A00,518791,Staff,8,0,20,12
1713480738155,MCWP 50R,B00,518792,Staff,7,0,20,13
1713480738155,MCWP 50R,C00,518793,Staff,7,0,20,13
1713480738155,MCWP 50R,D00,518794,Staff,2,0,20,18
1713480738155,MCWP 50R,E00,518795,Staff,5,0,20,15
1713480738155,MCWP 50R,F00,518796,Staff,14,0,20,6
1713480738155,MCWP 50R,G00,518797,Staff,13,0,20,7
1713480739184,MMW 12R,A01,514034,Herbst; Matthew,8,0,16,8
1713480739184,MMW 12R,A02,514035,Herbst; Matthew,14,0,16,2
1713480740212,MMW 13R,A01,514037,Staff,0,0,16,16
1713480740212,MMW 13R,A02,514039,Staff,0,1,16,16
1713480742267,SIO 295LS,A00,523233,Staff,15,0,30,15
1713480743385,SIO 295S,A00,523232,Staff,15,0,30,15
1713480744410,SOCI 117,A01,494376,Staff,0,2,5,5
1713480745433,WES 237B,A00,494380,Staff,19,0,20,1
1713480747509,AESE 279B,A00,494370,Wade; Jon P,33,0,33,0
1713480748534,AIP 197,001,627712,Vespa; Emanuel Ignacio,9999,0,9999,0
1713480749559,ANAR 135S,A00,494369,Braswell; Geoffrey E.,0,0,0,0
1713480750586,CAT 124RS,A01,519847,Geibel; William,6,0,20,14
1713480751614,CAT 125RS,A01,515971,Geibel; William,6,0,20,14
1713480752644,CLRE 250,A00,511389,Morris; Sheldon,9996,0,9999,3
1713480753675,CLRE 251,A00,507176,Mehta; Ravindra L.,9996,0,9999,3
1713480753675,CLRE 251,B00,511410,Mehta; Ravindra L.,9998,0,9999,1
1713480754704,CLRE 252,A00,507189,Cuomo; Raphael Eduardo,9998,0,9999,1
1713480755734,CLRE 253,A00,507199,Vaida; Florin,9997,0,9999,2
1713480755734,CLRE 253,B00,507202,Vaida; Florin,9999,0,9999,0
1713480756763,CLRE 259,A00,507211,Patel; Hemal,9996,0,9999,3
1713480757786,CLRE 260,A00,507221,Cuomo; Raphael Eduardo,9999,0,9999,0
1713480758815,CLRE 297,001,507242,Cuomo; Raphael Eduardo,9999,0,9999,0
1713480759842,CSE 191,A00,516875,Minnes Kemp; Mor Mia,9999,0,9999,0
1713480760871,CSS 201S,A01,494383,Staff,35,0,35,0
1713480761899,CSS 202S,A01,494387,Staff,35,0,35,0
1713480762924,EAP 100,A00,516065,Staff,9792,0,9999,207
1713480763950,ECE 45,A01,507414,Staff,39,0,60,21
1713480764976,ECE 100,A01,507416,Baghdadchi; Saharnaz,3,0,20,17
1713480764976,ECE 100,A02,507418,Baghdadchi; Saharnaz,19,0,20,1
1713480766001,ECE 111,A01,507420,Staff,28,0,50,22
1713480767027,ECE 197,001,548057,Sievenpiper; Daniel F.,9998,0,9999,1
1713480768052,EDS 115,A00,507243,Choi; Bailey Miyeon,27,0,28,1
1713480769077,EDS 117,A01,494379,Staff,16,0,25,9
1713480770109,EDS 125,A00,507246,Hopkins; Megan Beth,28,0,30,2
1713480771136,EDS 128A,A01,507264,Fargason; Sharon Gayle,26,0,26,0
1713480772166,EDS 128B,A01,507293,Pappas; Elizabeth,30,0,30,0
1713480773192,EDS 139,A00,507294,Fargason; Sharon Gayle,30,0,30,0
1713480773192,EDS 139,B00,507313,Pappas; Elizabeth,30,0,30,0
1713480774221,EDS 201,A00,507315,Staff,19,0,30,11
1713480775248,EDS 203,A01,507317,Halter; Christopher P.,18,0,30,12
1713480776274,EDS 204R,A01,507319,Halter; Christopher P.,0,1,30,30
1713480776274,EDS 204R,B01,507331,Heinzman; Erica M.,26,0,30,4
1713480777303,EDS 206R,A00,507332,Staff,0,1,30,30
1713480777303,EDS 206R,B00,507343,Staff,27,0,30,3
1713480778330,EDS 250,A00,507344,Hemans; Patricia Ann Benitez,28,0,40,12
1713480779358,EDS 281,A00,507345,Daly; Alan J.,18,0,18,0
1713480780384,EDS 284,A00,507350,Daly; Alan J.,16,0,16,0
1713480781412,EDS 286,A00,507359,Fine; Sarah,18,0,18,0
1713480782437,EDS 289C,A01,507361,Daly; Alan J.,18,0,18,0
1713480783466,EDS 290,A00,507366,Hofstetter; Carolyn,15,0,15,0
1713480784492,LIGM 5A,A00,507421,Fischer-Grunski; Eva K,20,0,20,0
1713480785518,LIGM 5B,A00,507423,Fischer-Grunski; Eva K,20,0,20,0
1713480786544,LIGM 5C,A00,507425,Fischer-Grunski; Eva K,20,0,20,0
1713480787569,LIIT 5AS,A00,507427,Carnelos; Chiara,20,0,20,0
1713480788594,LIIT 5BS,A00,507430,Carnelos; Chiara,20,0,20,0
1713480789619,LIIT 5CS,A00,507432,Carnelos; Chiara,20,0,20,0
1713480790644,LISP 5A,A00,507541,Munoz Sanchez; Alicia,14,0,20,6
1713480791674,LISP 5B,A00,507671,Munoz Sanchez; Alicia,12,0,20,8
1713480792705,LISP 5C,A00,507696,Munoz Sanchez; Alicia,11,0,20,9
1713480793731,MAE 197,001,528363,Boechler; Nicholas Sebastia,9998,0,9999,1
1713480794761,MATH 197,001,523477,Kedlaya; Kiran S.,9999,0,9999,0
1713480794761,MATH 197,002,563811,Zhang; Danna,9998,0,9999,1
1713480795790,MCWP 40R,A00,518780,Staff,17,0,20,3
1713480795790,MCWP 40R,B00,518781,Staff,14,0,20,6
1713480795790,MCWP 40R,C00,518783,Staff,12,0,20,8
1713480796814,MCWP 50R,A00,518791,Staff,8,0,20,12
1713480796814,MCWP 50R,B00,518792,Staff,7,0,20,13
1713480796814,MCWP 50R,C00,518793,Staff,7,0,20,13
1713480796814,MCWP 50R,D00,518794,Staff,2,0,20,18
1713480796814,MCWP 50R,E00,518795,Staff,5,0,20,15
1713480796814,MCWP 50R,F00,518796,Staff,14,0,20,6
1713480796814,MCWP 50R,G00,518797,Staff,13,0,20,7
1713480797844,MMW 12R,A01,514034,Herbst; Matthew,8,0,16,8
1713480797844,MMW 12R,A02,514035,Herbst; Matthew,14,0,16,2
1713480798868,MMW 13R,A01,514037,Staff,0,0,16,16
1713480798868,MMW 13R,A02,514039,Staff,0,1,16,16
1713480800920,SIO 295LS,A00,523233,Staff,15,0,30,15
1713480802004,SIO 295S,A00,523232,Staff,15,0,30,15
1713480803029,SOCI 117,A01,494376,Staff,0,2,5,5
1713480804057,WES 237B,A00,494380,Staff,19,0,20,1
1713480806124,AESE 279B,A00,494370,Wade; Jon P,33,0,33,0
1713480807151,AIP 197,001,627712,Vespa; Emanuel Ignacio,9999,0,9999,0
1713480808178,ANAR 135S,A00,494369,Braswell; Geoffrey E.,0,0,0,0
1713480809203,CAT 124RS,A01,519847,Geibel; William,6,0,20,14
1713480810228,CAT 125RS,A01,515971,Geibel; William,6,0,20,14
1713480811253,CLRE 250,A00,511389,Morris; Sheldon,9996,0,9999,3
1713480812282,CLRE 251,A00,507176,Mehta; Ravindra L.,9996,0,9999,3
1713480812282,CLRE 251,B00,511410,Mehta; Ravindra L.,9998,0,9999,1
1713480813310,CLRE 252,A00,507189,Cuomo; Raphael Eduardo,9998,0,9999,1
1713480814338,CLRE 253,A00,507199,Vaida; Florin,9997,0,9999,2
1713480814338,CLRE 253,B00,507202,Vaida; Florin,9999,0,9999,0
1713480815365,CLRE 259,A00,507211,Patel; Hemal,9996,0,9999,3
1713480816390,CLRE 260,A00,507221,Cuomo; Raphael Eduardo,9999,0,9999,0
1713480817414,CLRE 297,001,507242,Cuomo; Raphael Eduardo,9999,0,9999,0
1713480818440,CSE 191,A00,516875,Minnes Kemp; Mor Mia,9999,0,9999,0
1713480819468,CSS 201S,A01,494383,Staff,35,0,35,0
1713480820495,CSS 202S,A01,494387,Staff,35,0,35,0
1713480821521,EAP 100,A00,516065,Staff,9792,0,9999,207
1713480822551,ECE 45,A01,507414,Staff,39,0,60,21
1713480823576,ECE 100,A01,507416,Baghdadchi; Saharnaz,3,0,20,17
1713480823576,ECE 100,A02,507418,Baghdadchi; Saharnaz,19,0,20,1
1713480824606,ECE 111,A01,507420,Staff,28,0,50,22
1713480825635,ECE 197,001,548057,Sievenpiper; Daniel F.,9998,0,9999,1
1713480826662,EDS 115,A00,507243,Choi; Bailey Miyeon,27,0,28,1
1713480827690,EDS 117,A01,494379,Staff,16,0,25,9
1713480828719,EDS 125,A00,507246,Hopkins; Megan Beth,28,0,30,2
1713480829750,EDS 128A,A01,507264,Fargason; Sharon Gayle,26,0,26,0
1713480830779,EDS 128B,A01,507293,Pappas; Elizabeth,30,0,30,0
1713480831804,EDS 139,A00,507294,Fargason; Sharon Gayle,30,0,30,0
1713480831804,EDS 139,B00,507313,Pappas; Elizabeth,30,0,30,0
1713480832828,EDS 201,A00,507315,Staff,19,0,30,11
1713480833856,EDS 203,A01,507317,Halter; Christopher P.,18,0,30,12
1713480834882,EDS 204R,A01,507319,Halter; Christopher P.,0,1,30,30
1713480834882,EDS 204R,B01,507331,Heinzman; Erica M.,26,0,30,4
1713480835906,EDS 206R,A00,507332,Staff,0,1,30,30
1713480835906,EDS 206R,B00,507343,Staff,27,0,30,3
1713480836930,EDS 250,A00,507344,Hemans; Patricia Ann Benitez,28,0,40,12
1713480837959,EDS 281,A00,507345,Daly; Alan J.,18,0,18,0
1713480838984,EDS 284,A00,507350,Daly; Alan J.,16,0,16,0
1713480840013,EDS 286,A00,507359,Fine; Sarah,18,0,18,0
1713480841037,EDS 289C,A01,507361,Daly; Alan J.,18,0,18,0
1713480842063,EDS 290,A00,507366,Hofstetter; Carolyn,15,0,15,0
1713480843092,LIGM 5A,A00,507421,Fischer-Grunski; Eva K,20,0,20,0
1713480844121,LIGM 5B,A00,507423,Fischer-Grunski; Eva K,20,0,20,0
1713480845145,LIGM 5C,A00,507425,Fischer-Grunski; Eva K,20,0,20,0
1713480846170,LIIT 5AS,A00,507427,Carnelos; Chiara,20,0,20,0
1713480847197,LIIT 5BS,A00,507430,Carnelos; Chiara,20,0,20,0
1713480848224,LIIT 5CS,A00,507432,Carnelos; Chiara,20,0,20,0
1713480849250,LISP 5A,A00,507541,Munoz Sanchez; Alicia,14,0,20,6
1713480850281,LISP 5B,A00,507671,Munoz Sanchez; Alicia,12,0,20,8
1713480851314,LISP 5C,A00,507696,Munoz Sanchez; Alicia,11,0,20,9
1713480852339,MAE 197,001,528363,Boechler; Nicholas Sebastia,9998,0,9999,1
1713480853364,MATH 197,001,523477,Kedlaya; Kiran S.,9999,0,9999,0
1713480853364,MATH 197,002,563811,Zhang; Danna,9998,0,9999,1
1713480854389,MCWP 40R,A00,518780,Staff,17,0,20,3
1713480854389,MCWP 40R,B00,518781,Staff,14,0,20,6
1713480854389,MCWP 40R,C00,518783,Staff,12,0,20,8
1713480855414,MCWP 50R,A00,518791,Staff,8,0,20,12
1713480855414,MCWP 50R,B00,518792,Staff,7,0,20,13
1713480855414,MCWP 50R,C00,518793,Staff,7,0,20,13
1713480855414,MCWP 50R,D00,518794,Staff,2,0,20,18
1713480855414,MCWP 50R,E00,518795,Staff,5,0,20,15
1713480855414,MCWP 50R,F00,518796,Staff,14,0,20,6
1713480855414,MCWP 50R,G00,518797,Staff,13,0,20,7
1713480856440,MMW 12R,A01,514034,Herbst; Matthew,8,0,16,8
1713480856440,MMW 12R,A02,514035,Herbst; Matthew,14,0,16,2
1713480857465,MMW 13R,A01,514037,Staff,0,0,16,16
1713480857465,MMW 13R,A02,514039,Staff,0,1,16,16
1713480859519,SIO 295LS,A00,523233,Staff,15,0,30,15
1713480860548,SIO 295S,A00,523232,Staff,15,0,30,15
1713480861579,SOCI 117,A01,494376,Staff,0,2,5,5
1713480862605,WES 237B,A00,494380,Staff,19,0,20,1
1713480864678,AESE 279B,A00,494370,Wade; Jon P,33,0,33,0
1713480865706,AIP 197,001,627712,Vespa; Emanuel Ignacio,9999,0,9999,0
1713480866731,ANAR 135S,A00,494369,Braswell; Geoffrey E.,0,0,0,0
1713480867760,CAT 124RS,A01,519847,Geibel; William,6,0,20,14
1713480868786,CAT 125RS,A01,515971,Geibel; William,6,0,20,14
1713480869814,CLRE 250,A00,511389,Morris; Sheldon,9996,0,9999,3
1713480870840,CLRE 251,A00,507176,Mehta; Ravindra L.,9996,0,9999,3
1713480870840,CLRE 251,B00,511410,Mehta; Ravindra L.,9998,0,9999,1
1713480871866,CLRE 252,A00,507189,Cuomo; Raphael Eduardo,9998,0,9999,1
1713480872891,CLRE 253,A00,507199,Vaida; Florin,9997,0,9999,2
1713480872891,CLRE 253,B00,507202,Vaida; Florin,9999,0,9999,0
1713480873921,CLRE 259,A00,507211,Patel; Hemal,9996,0,9999,3
1713480874946,CLRE 260,A00,507221,Cuomo; Raphael Eduardo,9999,0,9999,0
1713480875974,CLRE 297,001,507242,Cuomo; Raphael Eduardo,9999,0,9999,0
1713480877002,CSE 191,A00,516875,Minnes Kemp; Mor Mia,9999,0,9999,0
1713480878032,CSS 201S,A01,494383,Staff,35,0,35,0
1713480879058,CSS 202S,A01,494387,Staff,35,0,35,0
1713480880082,EAP 100,A00,516065,Staff,9792,0,9999,207
1713480881110,ECE 45,A01,507414,Staff,39,0,60,21
1713480882137,ECE 100,A01,507416,Baghdadchi; Saharnaz,3,0,20,17
1713480882137,ECE 100,A02,507418,Baghdadchi; Saharnaz,19,0,20,1
1713480883164,ECE 111,A01,507420,Staff,28,0,50,22
1713480884188,ECE 197,001,548057,Sievenpiper; Daniel F.,9998,0,9999,1
1713480885219,EDS 115,A00,507243,Choi; Bailey Miyeon,27,0,28,1
1713480886251,EDS 117,A01,494379,Staff,16,0,25,9
1713480887277,EDS 125,A00,507246,Hopkins; Megan Beth,28,0,30,2
1713480888304,EDS 128A,A01,507264,Fargason; Sharon Gayle,26,0,26,0
1713480889333,EDS 128B,A01,507293,Pappas; Elizabeth,30,0,30,0
1713480890358,EDS 139,A00,507294,Fargason; Sharon Gayle,30,0,30,0
1713480890358,EDS 139,B00,507313,Pappas; Elizabeth,30,0,30,0
1713480891386,EDS 201,A00,507315,Staff,19,0,30,11
1713480892417,EDS 203,A01,507317,Halter; Christopher P.,18,0,30,12
1713480893443,EDS 204R,A01,507319,Halter; Christopher P.,0,1,30,30
1713480893443,EDS 204R,B01,507331,Heinzman; Erica M.,26,0,30,4
1713480894469,EDS 206R,A00,507332,Staff,0,1,30,30
1713480894469,EDS 206R,B00,507343,Staff,27,0,30,3
1713480895499,EDS 250,A00,507344,Hemans; Patricia Ann Benitez,28,0,40,12
1713480896524,EDS 281,A00,507345,Daly; Alan J.,18,0,18,0
1713480897550,EDS 284,A00,507350,Daly; Alan J.,16,0,16,0
1713480898579,EDS 286,A00,507359,Fine; Sarah,18,0,18,0
1713480899603,EDS 289C,A01,507361,Daly; Alan J.,18,0,18,0
1713480900676,EDS 290,A00,507366,Hofstetter; Carolyn,15,0,15,0
1713480901703,LIGM 5A,A00,507421,Fischer-Grunski; Eva K,20,0,20,0
1713480902788,LIGM 5B,A00,507423,Fischer-Grunski; Eva K,20,0,20,0
1713480903816,LIGM 5C,A00,507425,Fischer-Grunski; Eva K,20,0,20,0
1713480904842,LIIT 5AS,A00,507427,Carnelos; Chiara,20,0,20,0
1713480905922,LIIT 5BS,A00,507430,Carnelos; Chiara,20,0,20,0
1713480906953,LIIT 5CS,A00,507432,Carnelos; Chiara,20,0,20,0
1713480907983,LISP 5A,A00,507541,Munoz Sanchez; Alicia,14,0,20,6
1713480909011,LISP 5B,A00,507671,Munoz Sanchez; Alicia,12,0,20,8
1713480910042,LISP 5C,A00,507696,Munoz Sanchez; Alicia,11,0,20,9
1713480911070,MAE 197,001,528363,Boechler; Nicholas Sebastia,9998,0,9999,1
1713480912097,MATH 197,001,523477,Kedlaya; Kiran S.,9999,0,9999,0
1713480912097,MATH 197,002,563811,Zhang; Danna,9998,0,9999,1
1713480913122,MCWP 40R,A00,518780,Staff,17,0,20,3
1713480913122,MCWP 40R,B00,518781,Staff,14,0,20,6
1713480913122,MCWP 40R,C00,518783,Staff,12,0,20,8
1713480914149,MCWP 50R,A00,518791,Staff,8,0,20,12
1713480914149,MCWP 50R,B00,518792,Staff,7,0,20,13
1713480914149,MCWP 50R,C00,518793,Staff,7,0,20,13
1713480914149,MCWP 50R,D00,518794,Staff,2,0,20,18
1713480914149,MCWP 50R,E00,518795,Staff,5,0,20,15
1713480914149,MCWP 50R,F00,518796,Staff,14,0,20,6
1713480914149,MCWP 50R,G00,518797,Staff,13,0,20,7
1713480915175,MMW 12R,A01,514034,Herbst; Matthew,8,0,16,8
1713480915175,MMW 12R,A02,514035,Herbst; Matthew,14,0,16,2
1713480916199,MMW 13R,A01,514037,Staff,0,0,16,16
1713480916199,MMW 13R,A02,514039,Staff,0,1,16,16
1713480918251,SIO 295LS,A00,523233,Staff,15,0,30,15
1713480919276,SIO 295S,A00,523232,Staff,15,0,30,15
1713480920302,SOCI 117,A01,494376,Staff,0,2,5,5
1713480921328,WES 237B,A00,494380,Staff,19,0,20,1
1713480923413,AESE 279B,A00,494370,Wade; Jon P,33,0,33,0
1713480924439,AIP 197,001,627712,Vespa; Emanuel Ignacio,9999,0,9999,0
1713480925463,ANAR 135S,A00,494369,Braswell; Geoffrey E.,0,0,0,0
1713480926493,CAT 124RS,A01,519847,Geibel; William,6,0,20,14
1713480927521,CAT 125RS,A01,515971,Geibel; William,6,0,20,14
1713480928545,CLRE 250,A00,511389,Morris; Sheldon,9996,0,9999,3
1713480929572,CLRE 251,A00,507176,Mehta; Ravindra L.,9996,0,9999,3
1713480929572,CLRE 251,B00,511410,Mehta; Ravindra L.,9998,0,9999,1
1713480930597,CLRE 252,A00,507189,Cuomo; Raphael Eduardo,9998,0,9999,1
1713480931621,CLRE 253,A00,507199,Vaida; Florin,9997,0,9999,2
1713480931621,CLRE 253,B00,507202,Vaida; Florin,9999,0,9999,0
1713480932647,CLRE 259,A00,507211,Patel; Hemal,9996,0,9999,3
1713480933672,CLRE 260,A00,507221,Cuomo; Raphael Eduardo,9999,0,9999,0
1713480934700,CLRE 297,001,507242,Cuomo; Raphael Eduardo,9999,0,9999,0
1713480935726,CSE 191,A00,516875,Minnes Kemp; Mor Mia,9999,0,9999,0
1713480936755,CSS 201S,A01,494383,Staff,35,0,35,0
1713480937781,CSS 202S,A01,494387,Staff,35,0,35,0
1713480938806,EAP 100,A00,516065,Staff,9792,0,9999,207
1713480939834,ECE 45,A01,507414,Staff,39,0,60,21
1713480940860,ECE 100,A01,507416,Baghdadchi; Saharnaz,3,0,20,17
1713480940860,ECE 100,A02,507418,Baghdadchi; Saharnaz,19,0,20,1
1713480941888,ECE 111,A01,507420,Staff,28,0,50,22
1713480942912,ECE 197,001,548057,Sievenpiper; Daniel F.,9998,0,9999,1
1713480943941,EDS 115,A00,507243,Choi; Bailey Miyeon,27,0,28,1
1713480944966,EDS 117,A01,494379,Staff,16,0,25,9
1713480945994,EDS 125,A00,507246,Hopkins; Megan Beth,28,0,30,2
1713480947019,EDS 128A,A01,507264,Fargason; Sharon Gayle,26,0,26,0
1713480948047,EDS 128B,A01,507293,Pappas; Elizabeth,30,0,30,0
1713480949071,EDS 139,A00,507294,Fargason; Sharon Gayle,30,0,30,0
1713480949071,EDS 139,B00,507313,Pappas; Elizabeth,30,0,30,0
1713480950101,EDS 201,A00,507315,Staff,19,0,30,11
1713480951127,EDS 203,A01,507317,Halter; Christopher P.,18,0,30,12
1713480952157,EDS 204R,A01,507319,Halter; Christopher P.,0,1,30,30
1713480952157,EDS 204R,B01,507331,Heinzman; Erica M.,26,0,30,4
1713480953183,EDS 206R,A00,507332,Staff,0,1,30,30
1713480953183,EDS 206R,B00,507343,Staff,27,0,30,3
1713480954209,EDS 250,A00,507344,Hemans; Patricia Ann Benitez,28,0,40,12
1713480955233,EDS 281,A00,507345,Daly; Alan J.,18,0,18,0
1713480956258,EDS 284,A00,507350,Daly; Alan J.,16,0,16,0
1713480957286,EDS 286,A00,507359,Fine; Sarah,18,0,18,0
1713480958311,EDS 289C,A01,507361,Daly; Alan J.,18,0,18,0
1713480959336,EDS 290,A00,507366,Hofstetter; Carolyn,15,0,15,0
1713480960364,LIGM 5A,A00,507421,Fischer-Grunski; Eva K,20,0,20,0
1713480961393,LIGM 5B,A00,507423,Fischer-Grunski; Eva K,20,0,20,0
1713480962420,LIGM 5C,A00,507425,Fischer-Grunski; Eva K,20,0,20,0
1713480963452,LIIT 5AS,A00,507427,Carnelos; Chiara,20,0,20,0
1713480964476,LIIT 5BS,A00,507430,Carnelos; Chiara,20,0,20,0
1713480965506,LIIT 5CS,A00,507432,Carnelos; Chiara,20,0,20,0
1713480966531,LISP 5A,A00,507541,Munoz Sanchez; Alicia,14,0,20,6
1713480967560,LISP 5B,A00,507671,Munoz Sanchez; Alicia,12,0,20,8
1713480968586,LISP 5C,A00,507696,Munoz Sanchez; Alicia,11,0,20,9
1713480969611,MAE 197,001,528363,Boechler; Nicholas Sebastia,9998,0,9999,1
1713480970637,MATH 197,001,523477,Kedlaya; Kiran S.,9999,0,9999,0
1713480970637,MATH 197,002,563811,Zhang; Danna,9998,0,9999,1
1713480971668,MCWP 40R,A00,518780,Staff,17,0,20,3
1713480971668,MCWP 40R,B00,518781,Staff,14,0,20,6
1713480971668,MCWP 40R,C00,518783,Staff,12,0,20,8
1713480972694,MCWP 50R,A00,518791,Staff,8,0,20,12
1713480972694,MCWP 50R,B00,518792,Staff,7,0,20,13
1713480972694,MCWP 50R,C00,518793,Staff,7,0,20,13
1713480972694,MCWP 50R,D00,518794,Staff,2,0,20,18
1713480972694,MCWP 50R,E00,518795,Staff,5,0,20,15
1713480972694,MCWP 50R,F00,518796,Staff,14,0,20,6
1713480972694,MCWP 50R,G00,518797,Staff,13,0,20,7
1713480973718,MMW 12R,A01,514034,Herbst; Matthew,8,0,16,8
1713480973718,MMW 12R,A02,514035,Herbst; Matthew,14,0,16,2
1713480974741,MMW 13R,A01,514037,Staff,0,0,16,16
1713480974741,MMW 13R,A02,514039,Staff,0,1,16,16
1713480976803,SIO 295LS,A00,523233,Staff,15,0,30,15
1713480977827,SIO 295S,A00,523232,Staff,15,0,30,15
1713480978856,SOCI 117,A01,494376,Staff,0,2,5,5
1713480979880,WES 237B,A00,494380,Staff,19,0,20,1
1713480981957,AESE 279B,A00,494370,Wade; Jon P,33,0,33,0
1713480982986,AIP 197,001,627712,Vespa; Emanuel Ignacio,9999,0,9999,0
1713480984012,ANAR 135S,A00,494369,Braswell; Geoffrey E.,0,0,0,0
1713480985044,CAT 124RS,A01,519847,Geibel; William,6,0,20,14
1713480986068,CAT 125RS,A01,515971,Geibel; William,6,0,20,14
1713480987095,CLRE 250,A00,511389,Morris; Sheldon,9996,0,9999,3
1713480988122,CLRE 251,A00,507176,Mehta; Ravindra L.,9996,0,9999,3
1713480988122,CLRE 251,B00,511410,Mehta; Ravindra L.,9998,0,9999,1
1713480989147,CLRE 252,A00,507189,Cuomo; Raphael Eduardo,9998,0,9999,1
1713480990177,CLRE 253,A00,507199,Vaida; Florin,9997,0,9999,2
1713480990177,CLRE 253,B00,507202,Vaida; Florin,9999,0,9999,0
1713480991205,CLRE 259,A00,507211,Patel; Hemal,9996,0,9999,3
1713480992233,CLRE 260,A00,507221,Cuomo; Raphael Eduardo,9999,0,9999,0
1713480993258,CLRE 297,001,507242,Cuomo; Raphael Eduardo,9999,0,9999,0
1713480994284,CSE 191,A00,516875,Minnes Kemp; Mor Mia,9999,0,9999,0
1713480995311,CSS 201S,A01,494383,Staff,35,0,35,0
1713480996342,CSS 202S,A01,494387,Staff,35,0,35,0
1713480997367,EAP 100,A00,516065,Staff,9792,0,9999,207
1713480998397,ECE 45,A01,507414,Staff,39,0,60,21
1713480999421,ECE 100,A01,507416,Baghdadchi; Saharnaz,3,0,20,17
1713480999421,ECE 100,A02,507418,Baghdadchi; Saharnaz,19,0,20,1
1713481000449,ECE 111,A01,507420,Staff,28,0,50,22
1713481001477,ECE 197,001,548057,Sievenpiper; Daniel F.,9998,0,9999,1
1713481002503,EDS 115,A00,507243,Choi; Bailey Miyeon,27,0,28,1
1713481003529,EDS 117,A01,494379,Staff,16,0,25,9
1713481004559,EDS 125,A00,507246,Hopkins; Megan Beth,28,0,30,2
1713481005585,EDS 128A,A01,507264,Fargason; Sharon Gayle,26,0,26,0
1713481006614,EDS 128B,A01,507293,Pappas; Elizabeth,30,0,30,0
1713481007638,EDS 139,A00,507294,Fargason; Sharon Gayle,30,0,30,0
1713481007638,EDS 139,B00,507313,Pappas; Elizabeth,30,0,30,0
1713481008664,EDS 201,A00,507315,Staff,19,0,30,11
1713481009744,EDS 203,A01,507317,Halter; Christopher P.,18,0,30,12
1713481010772,EDS 204R,A01,507319,Halter; Christopher P.,0,1,30,30
1713481010772,EDS 204R,B01,507331,Heinzman; Erica M.,26,0,30,4
1713481011799,EDS 206R,A00,507332,Staff,0,1,30,30
1713481011799,EDS 206R,B00,507343,Staff,27,0,30,3
1713481012834,EDS 250,A00,507344,Hemans; Patricia Ann Benitez,28,0,40,12
1713481013872,EDS 281,A00,507345,Daly; Alan J.,18,0,18,0
1713481014901,EDS 284,A00,507350,Daly; Alan J.,16,0,16,0
1713481015923,EDS 286,A00,507359,Fine; Sarah,18,0,18,0
1713481016953,EDS 289C,A01,507361,Daly; Alan J.,18,0,18,0
1713481017978,EDS 290,A00,507366,Hofstetter; Carolyn,15,0,15,0
1713481019009,LIGM 5A,A00,507421,Fischer-Grunski; Eva K,20,0,20,0
1713481020033,LIGM 5B,A00,507423,Fischer-Grunski; Eva K,20,0,20,0
1713481021058,LIGM 5C,A00,507425,Fischer-Grunski; Eva K,20,0,20,0
1713481022084,LIIT 5AS,A00,507427,Carnelos; Chiara,20,0,20,0
1713481023123,LIIT 5BS,A00,507430,Carnelos; Chiara,20,0,20,0
1713481024150,LIIT 5CS,A00,507432,Carnelos; Chiara,20,0,20,0
1713481025180,LISP 5A,A00,507541,Munoz Sanchez; Alicia,14,0,20,6
1713481026208,LISP 5B,A00,507671,Munoz Sanchez; Alicia,12,0,20,8
1713481027233,LISP 5C,A00,507696,Munoz Sanchez; Alicia,11,0,20,9
1713481028258,MAE 197,001,528363,Boechler; Nicholas Sebastia,9998,0,9999,1
1713481029285,MATH 197,001,523477,Kedlaya; Kiran S.,9999,0,9999,0
1713481029285,MATH 197,002,563811,Zhang; Danna,9998,0,9999,1
1713481030313,MCWP 40R,A00,518780,Staff,17,0,20,3
1713481030313,MCWP 40R,B00,518781,Staff,14,0,20,6
1713481030313,MCWP 40R,C00,518783,Staff,12,0,20,8
1713481031341,MCWP 50R,A00,518791,Staff,8,0,20,12
1713481031341,MCWP 50R,B00,518792,Staff,7,0,20,13
1713481031341,MCWP 50R,C00,518793,Staff,7,0,20,13
1713481031341,MCWP 50R,D00,518794,Staff,2,0,20,18
1713481031341,MCWP 50R,E00,518795,Staff,5,0,20,15
1713481031341,MCWP 50R,F00,518796,Staff,13,0,20,7
1713481031341,MCWP 50R,G00,518797,Staff,13,0,20,7
1713481032461,MMW 12R,A01,514034,Herbst; Matthew,8,0,16,8
1713481032461,MMW 12R,A02,514035,Herbst; Matthew,14,0,16,2
1713481033485,MMW 13R,A01,514037,Staff,0,0,16,16
1713481033485,MMW 13R,A02,514039,Staff,0,1,16,16
1713481035543,SIO 295LS,A00,523233,Staff,15,0,30,15
1713481036569,SIO 295S,A00,523232,Staff,15,0,30,15
1713481037598,SOCI 117,A01,494376,Staff,0,2,5,5
1713481038625,WES 237B,A00,494380,Staff,19,0,20,1
1713481040689,AESE 279B,A00,494370,Wade; Jon P,33,0,33,0
1713481041717,AIP 197,001,627712,Vespa; Emanuel Ignacio,9999,0,9999,0
1713481042741,ANAR 135S,A00,494369,Braswell; Geoffrey E.,0,0,0,0
1713481043770,CAT 124RS,A01,519847,Geibel; William,6,0,20,14
1713481044798,CAT 125RS,A01,515971,Geibel; William,6,0,20,14
1713481045822,CLRE 250,A00,511389,Morris; Sheldon,9996,0,9999,3
1713481046853,CLRE 251,A00,507176,Mehta; Ravindra L.,9996,0,9999,3
1713481046853,CLRE 251,B00,511410,Mehta; Ravindra L.,9998,0,9999,1
1713481047879,CLRE 252,A00,507189,Cuomo; Raphael Eduardo,9998,0,9999,1
1713481048907,CLRE 253,A00,507199,Vaida; Florin,9997,0,9999,2
1713481048907,CLRE 253,B00,507202,Vaida; Florin,9999,0,9999,0
1713481049933,CLRE 259,A00,507211,Patel; Hemal,9996,0,9999,3
1713481050961,CLRE 260,A00,507221,Cuomo; Raphael Eduardo,9999,0,9999,0
1713481051989,CLRE 297,001,507242,Cuomo; Raphael Eduardo,9999,0,9999,0
1713481053018,CSE 191,A00,516875,Minnes Kemp; Mor Mia,9999,0,9999,0
1713481054044,CSS 201S,A01,494383,Staff,35,0,35,0
1713481055070,CSS 202S,A01,494387,Staff,35,0,35,0
1713481056098,EAP 100,A00,516065,Staff,9792,0,9999,207
1713481057129,ECE 45,A01,507414,Staff,39,0,60,21
1713481058155,ECE 100,A01,507416,Baghdadchi; Saharnaz,3,0,20,17
1713481058155,ECE 100,A02,507418,Baghdadchi; Saharnaz,19,0,20,1
1713481059182,ECE 111,A01,507420,Staff,28,0,50,22
1713481060208,ECE 197,001,548057,Sievenpiper; Daniel F.,9998,0,9999,1
1713481061238,EDS 115,A00,507243,Choi; Bailey Miyeon,27,0,28,1
1713481062265,EDS 117,A01,494379,Staff,16,0,25,9
1713481063291,EDS 125,A00,507246,Hopkins; Megan Beth,28,0,30,2
1713481064318,EDS 128A,A01,507264,Fargason; Sharon Gayle,26,0,26,0
1713481065348,EDS 128B,A01,507293,Pappas; Elizabeth,30,0,30,0
1713481066372,EDS 139,A00,507294,Fargason; Sharon Gayle,30,0,30,0
1713481066372,EDS 139,B00,507313,Pappas; Elizabeth,30,0,30,0
1713481067399,EDS 201,A00,507315,Staff,19,0,30,11
1713481068428,EDS 203,A01,507317,Halter; Christopher P.,18,0,30,12
1713481069456,EDS 204R,A01,507319,Halter; Christopher P.,0,1,30,30
1713481069456,EDS 204R,B01,507331,Heinzman; Erica M.,26,0,30,4
1713481070481,EDS 206R,A00,507332,Staff,0,1,30,30
1713481070481,EDS 206R,B00,507343,Staff,27,0,30,3
1713481071509,EDS 250,A00,507344,Hemans; Patricia Ann Benitez,28,0,40,12
1713481072533,EDS 281,A00,507345,Daly; Alan J.,18,0,18,0
1713481073557,EDS 284,A00,507350,Daly; Alan J.,16,0,16,0
1713481074582,EDS 286,A00,507359,Fine; Sarah,18,0,18,0
1713481075605,EDS 289C,A01,507361,Daly; Alan J.,18,0,18,0
1713481076635,EDS 290,A00,507366,Hofstetter; Carolyn,15,0,15,0
1713481077663,LIGM 5A,A00,507421,Fischer-Grunski; Eva K,20,0,20,0
1713481078690,LIGM 5B,A00,507423,Fischer-Grunski; Eva K,20,0,20,0
1713481079719,LIGM 5C,A00,507425,Fischer-Grunski; Eva K,20,0,20,0
1713481080748,LIIT 5AS,A00,507427,Carnelos; Chiara,20,0,20,0
1713481081777,LIIT 5BS,A00,507430,Carnelos; Chiara,20,0,20,0
1713481082801,LIIT 5CS,A00,507432,Carnelos; Chiara,20,0,20,0
1713481083827,LISP 5A,A00,507541,Munoz Sanchez; Alicia,14,0,20,6
1713481084856,LISP 5B,A00,507671,Munoz Sanchez; Alicia,12,0,20,8
1713481085882,LISP 5C,A00,507696,Munoz Sanchez; Alicia,11,0,20,9
1713481086906,MAE 197,001,528363,Boechler; Nicholas Sebastia,9998,0,9999,1
1713481087932,MATH 197,001,523477,Kedlaya; Kiran S.,9999,0,9999,0
1713481087932,MATH 197,002,563811,Zhang; Danna,9998,0,9999,1
1713481088960,MCWP 40R,A00,518780,Staff,17,0,20,3
1713481088960,MCWP 40R,B00,518781,Staff,14,0,20,6
1713481088960,MCWP 40R,C00,518783,Staff,12,0,20,8
1713481089990,MCWP 50R,A00,518791,Staff,8,0,20,12
1713481089990,MCWP 50R,B00,518792,Staff,7,0,20,13
1713481089990,MCWP 50R,C00,518793,Staff,7,0,20,13
1713481089990,MCWP 50R,D00,518794,Staff,2,0,20,18
1713481089990,MCWP 50R,E00,518795,Staff,5,0,20,15
1713481089990,MCWP 50R,F00,518796,Staff,13,0,20,7
1713481089990,MCWP 50R,G00,518797,Staff,13,0,20,7
1713481091018,MMW 12R,A01,514034,Herbst; Matthew,8,0,16,8
1713481091018,MMW 12R,A02,514035,Herbst; Matthew,14,0,16,2
1713481092047,MMW 13R,A01,514037,Staff,0,0,16,16
1713481092047,MMW 13R,A02,514039,Staff,0,1,16,16
1713481094101,SIO 295LS,A00,523233,Staff,15,0,30,15
1713481095125,SIO 295S,A00,523232,Staff,15,0,30,15
1713481096150,SOCI 117,A01,494376,Staff,0,2,5,5
1713481097178,WES 237B,A00,494380,Staff,19,0,20,1
1713481099249,AESE 279B,A00,494370,Wade; Jon P,33,0,33,0
1713481100275,AIP 197,001,627712,Vespa; Emanuel Ignacio,9999,0,9999,0
1713481101304,ANAR 135S,A00,494369,Braswell; Geoffrey E.,0,0,0,0
1713481102331,CAT 124RS,A01,519847,Geibel; William,6,0,20,14
1713481103356,CAT 125RS,A01,515971,Geibel; William,6,0,20,14
1713481104385,CLRE 250,A00,511389,Morris; Sheldon,9996,0,9999,3
1713481105419,CLRE 251,A00,507176,Mehta; Ravindra L.,9996,0,9999,3
1713481105419,CLRE 251,B00,511410,Mehta; Ravindra L.,9998,0,9999,1
1713481106443,CLRE 252,A00,507189,Cuomo; Raphael Eduardo,9998,0,9999,1
1713481107469,CLRE 253,A00,507199,Vaida; Florin,9997,0,9999,2
1713481107469,CLRE 253,B00,507202,Vaida; Florin,9999,0,9999,0
1713481108495,CLRE 259,A00,507211,Patel; Hemal,9996,0,9999,3
1713481109522,CLRE 260,A00,507221,Cuomo; Raphael Eduardo,9999,0,9999,0
1713481110546,CLRE 297,001,507242,Cuomo; Raphael Eduardo,9999,0,9999,0
1713481111572,CSE 191,A00,516875,Minnes Kemp; Mor Mia,9999,0,9999,0
1713481112597,CSS 201S,A01,494383,Staff,35,0,35,0
1713481113680,CSS 202S,A01,494387,Staff,35,0,35,0
1713481114706,EAP 100,A00,516065,Staff,9792,0,9999,207
1713481115735,ECE 45,A01,507414,Staff,39,0,60,21
1713481116761,ECE 100,A01,507416,Baghdadchi; Saharnaz,3,0,20,17
1713481116761,ECE 100,A02,507418,Baghdadchi; Saharnaz,19,0,20,1
1713481117785,ECE 111,A01,507420,Staff,28,0,50,22
1713481118812,ECE 197,001,548057,Sievenpiper; Daniel F.,9998,0,9999,1
1713481119837,EDS 115,A00,507243,Choi; Bailey Miyeon,27,0,28,1
1713481120866,EDS 117,A01,494379,Staff,16,0,25,9
1713481121893,EDS 125,A00,507246,Hopkins; Megan Beth,28,0,30,2
1713481122923,EDS 128A,A01,507264,Fargason; Sharon Gayle,26,0,26,0
1713481123948,EDS 128B,A01,507293,Pappas; Elizabeth,30,0,30,0
1713481124979,EDS 139,A00,507294,Fargason; Sharon Gayle,30,0,30,0
1713481124979,EDS 139,B00,507313,Pappas; Elizabeth,30,0,30,0
1713481126005,EDS 201,A00,507315,Staff,19,0,30,11
1713481127035,EDS 203,A01,507317,Halter; Christopher P.,18,0,30,12
1713481128065,EDS 204R,A01,507319,Halter; Christopher P.,0,1,30,30
1713481128065,EDS 204R,B01,507331,Heinzman; Erica M.,26,0,30,4
1713481129091,EDS 206R,A00,507332,Staff,0,1,30,30
1713481129091,EDS 206R,B00,507343,Staff,27,0,30,3
1713481130121,EDS 250,A00,507344,Hemans; Patricia Ann Benitez,28,0,40,12
1713481131146,EDS 281,A00,507345,Daly; Alan J.,18,0,18,0
1713481132171,EDS 284,A00,507350,Daly; Alan J.,16,0,16,0
1713481133196,EDS 286,A00,507359,Fine; Sarah,18,0,18,0
1713481134225,EDS 289C,A01,507361,Daly; Alan J.,18,0,18,0
1713481135250,EDS 290,A00,507366,Hofstetter; Carolyn,15,0,15,0
1713481136274,LIGM 5A,A00,507421,Fischer-Grunski; Eva K,20,0,20,0
1713481137300,LIGM 5B,A00,507423,Fischer-Grunski; Eva K,20,0,20,0
1713481138325,LIGM 5C,A00,507425,Fischer-Grunski; Eva K,20,0,20,0
1713481139352,LIIT 5AS,A00,507427,Carnelos; Chiara,20,0,20,0
1713481140384,LIIT 5BS,A00,507430,Carnelos; Chiara,20,0,20,0
1713481141413,LIIT 5CS,A00,507432,Carnelos; Chiara,20,0,20,0
1713481142444,LISP 5A,A00,507541,Munoz Sanchez; Alicia,14,0,20,6
1713481143468,LISP 5B,A00,507671,Munoz Sanchez; Alicia,12,0,20,8
1713481144493,LISP 5C,A00,507696,Munoz Sanchez; Alicia,11,0,20,9
1713481145519,MAE 197,001,528363,Boechler; Nicholas Sebastia,9998,0,9999,1
1713481146550,MATH 197,001,523477,Kedlaya; Kiran S.,9999,0,9999,0
1713481146550,MATH 197,002,563811,Zhang; Danna,9998,0,9999,1
1713481147573,MCWP 40R,A00,518780,Staff,17,0,20,3
1713481147573,MCWP 40R,B00,518781,Staff,14,0,20,6
1713481147573,MCWP 40R,C00,518783,Staff,12,0,20,8
1713481148604,MCWP 50R,A00,518791,Staff,8,0,20,12
1713481148604,MCWP 50R,B00,518792,Staff,7,0,20,13
1713481148604,MCWP 50R,C00,518793,Staff,7,0,20,13
1713481148604,MCWP 50R,D00,518794,Staff,2,0,20,18
1713481148604,MCWP 50R,E00,518795,Staff,5,0,20,15
1713481148604,MCWP 50R,F00,518796,Staff,13,0,20,7
1713481148604,MCWP 50R,G00,518797,Staff,13,0,20,7
1713481149631,MMW 12R,A01,514034,Herbst; Matthew,8,0,16,8
1713481149631,MMW 12R,A02,514035,Herbst; Matthew,14,0,16,2
1713481150657,MMW 13R,A01,514037,Staff,0,0,16,16
1713481150657,MMW 13R,A02,514039,Staff,0,1,16,16
1713481152710,SIO 295LS,A00,523233,Staff,15,0,30,15
1713481153738,SIO 295S,A00,523232,Staff,15,0,30,15
1713481154769,SOCI 117,A01,494376,Staff,0,2,5,5
1713481155798,WES 237B,A00,494380,Staff,19,0,20,1
1713481157868,AESE 279B,A00,494370,Wade; Jon P,33,0,33,0
1713481158898,AIP 197,001,627712,Vespa; Emanuel Ignacio,9999,0,9999,0
1713481159923,ANAR 135S,A00,494369,Braswell; Geoffrey E.,0,0,0,0
1713481160954,CAT 124RS,A01,519847,Geibel; William,6,0,20,14
1713481161982,CAT 125RS,A01,515971,Geibel; William,6,0,20,14
1713481163009,CLRE 250,A00,511389,Morris; Sheldon,9996,0,9999,3
1713481164036,CLRE 251,A00,507176,Mehta; Ravindra L.,9996,0,9999,3
1713481164036,CLRE 251,B00,511410,Mehta; Ravindra L.,9998,0,9999,1
1713481165066,CLRE 252,A00,507189,Cuomo; Raphael Eduardo,9998,0,9999,1
1713481166093,CLRE 253,A00,507199,Vaida; Florin,9997,0,9999,2
1713481166093,CLRE 253,B00,507202,Vaida; Florin,9999,0,9999,0
1713481167117,CLRE 259,A00,507211,Patel; Hemal,9996,0,9999,3
1713481168145,CLRE 260,A00,507221,Cuomo; Raphael Eduardo,9999,0,9999,0
1713481169173,CLRE 297,001,507242,Cuomo; Raphael Eduardo,9999,0,9999,0
1713481170197,CSE 191,A00,516875,Minnes Kemp; Mor Mia,9999,0,9999,0
1713481171223,CSS 201S,A01,494383,Staff,35,0,35,0
1713481172252,CSS 202S,A01,494387,Staff,35,0,35,0
1713481173277,EAP 100,A00,516065,Staff,9792,0,9999,207
1713481174307,ECE 45,A01,507414,Staff,39,0,60,21
1713481175333,ECE 100,A01,507416,Baghdadchi; Saharnaz,3,0,20,17
1713481175333,ECE 100,A02,507418,Baghdadchi; Saharnaz,19,0,20,1
1713481176357,ECE 111,A01,507420,Staff,28,0,50,22
1713481177381,ECE 197,001,548057,Sievenpiper; Daniel F.,9998,0,9999,1
1713481178411,EDS 115,A00,507243,Choi; Bailey Miyeon,27,0,28,1
1713481179436,EDS 117,A01,494379,Staff,16,0,25,9
1713481180466,EDS 125,A00,507246,Hopkins; Megan Beth,28,0,30,2
1713481181496,EDS 128A,A01,507264,Fargason; Sharon Gayle,26,0,26,0
1713481182525,EDS 128B,A01,507293,Pappas; Elizabeth,30,0,30,0
1713481183550,EDS 139,A00,507294,Fargason; Sharon Gayle,30,0,30,0
1713481183550,EDS 139,B00,507313,Pappas; Elizabeth,30,0,30,0
1713481184575,EDS 201,A00,507315,Staff,19,0,30,11
1713481185601,EDS 203,A01,507317,Halter; Christopher P.,18,0,30,12
1713481186626,EDS 204R,A01,507319,Halter; Christopher P.,0,1,30,30
1713481186626,EDS 204R,B01,507331,Heinzman; Erica M.,26,0,30,4
1713481187651,EDS 206R,A00,507332,Staff,0,1,30,30
1713481187651,EDS 206R,B00,507343,Staff,27,0,30,3
1713481188680,EDS 250,A00,507344,Hemans; Patricia Ann Benitez,28,0,40,12
1713481189709,EDS 281,A00,507345,Daly; Alan J.,18,0,18,0
1713481190734,EDS 284,A00,507350,Daly; Alan J.,16,0,16,0
1713481191762,EDS 286,A00,507359,Fine; Sarah,18,0,18,0
1713481192788,EDS 289C,A01,507361,Daly; Alan J.,18,0,18,0
1713481193818,EDS 290,A00,507366,Hofstetter; Carolyn,15,0,15,0
1713481194849,LIGM 5A,A00,507421,Fischer-Grunski; Eva K,20,0,20,0
1713481195875,LIGM 5B,A00,507423,Fischer-Grunski; Eva K,20,0,20,0
1713481196904,LIGM 5C,A00,507425,Fischer-Grunski; Eva K,20,0,20,0
1713481197931,LIIT 5AS,A00,507427,Carnelos; Chiara,20,0,20,0
1713481198961,LIIT 5BS,A00,507430,Carnelos; Chiara,20,0,20,0
1713481199991,LIIT 5CS,A00,507432,Carnelos; Chiara,20,0,20,0
1713481201025,LISP 5A,A00,507541,Munoz Sanchez; Alicia,14,0,20,6
1713481202050,LISP 5B,A00,507671,Munoz Sanchez; Alicia,12,0,20,8
1713481203079,LISP 5C,A00,507696,Munoz Sanchez; Alicia,11,0,20,9
1713481204104,MAE 197,001,528363,Boechler; Nicholas Sebastia,9998,0,9999,1
1713481205129,MATH 197,001,523477,Kedlaya; Kiran S.,9999,0,9999,0
1713481205129,MATH 197,002,563811,Zhang; Danna,9998,0,9999,1
1713481206155,MCWP 40R,A00,518780,Staff,17,0,20,3
1713481206155,MCWP 40R,B00,518781,Staff,14,0,20,6
1713481206155,MCWP 40R,C00,518783,Staff,12,0,20,8
1713481207179,MCWP 50R,A00,518791,Staff,8,0,20,12
1713481207179,MCWP 50R,B00,518792,Staff,7,0,20,13
1713481207179,MCWP 50R,C00,518793,Staff,7,0,20,13
1713481207179,MCWP 50R,D00,518794,Staff,2,0,20,18
1713481207179,MCWP 50R,E00,518795,Staff,4,0,20,16
1713481207179,MCWP 50R,F00,518796,Staff,13,0,20,7
1713481207179,MCWP 50R,G00,518797,Staff,13,0,20,7
1713481208207,MMW 12R,A01,514034,Herbst; Matthew,8,0,16,8
1713481208207,MMW 12R,A02,514035,Herbst; Matthew,14,0,16,2
1713481209234,MMW 13R,A01,514037,Staff,0,0,16,16
1713481209234,MMW 13R,A02,514039,Staff,0,1,16,16
1713481211288,SIO 295LS,A00,523233,Staff,15,0,30,15
1713481212317,SIO 295S,A00,523232,Staff,15,0,30,15
1713481213341,SOCI 117,A01,494376,Staff,0,2,5,5
1713481214367,WES 237B,A00,494380,Staff,19,0,20,1
1713481216433,AESE 279B,A00,494370,Wade; Jon P,33,0,33,0
1713481217511,AIP 197,001,627712,Vespa; Emanuel Ignacio,9999,0,9999,0
1713481218540,ANAR 135S,A00,494369,Braswell; Geoffrey E.,0,0,0,0
1713481219565,CAT 124RS,A01,519847,Geibel; William,6,0,20,14
1713481220590,CAT 125RS,A01,515971,Geibel; William,6,0,20,14
1713481221616,CLRE 250,A00,511389,Morris; Sheldon,9996,0,9999,3
1713481222648,CLRE 251,A00,507176,Mehta; Ravindra L.,9996,0,9999,3
1713481222648,CLRE 251,B00,511410,Mehta; Ravindra L.,9998,0,9999,1
1713481223679,CLRE 252,A00,507189,Cuomo; Raphael Eduardo,9998,0,9999,1
1713481224710,CLRE 253,A00,507199,Vaida; Florin,9997,0,9999,2
1713481224710,CLRE 253,B00,507202,Vaida; Florin,9999,0,9999,0
1713481225736,CLRE 259,A00,507211,Patel; Hemal,9996,0,9999,3
1713481226760,CLRE 260,A00,507221,Cuomo; Raphael Eduardo,9999,0,9999,0
1713481227787,CLRE 297,001,507242,Cuomo; Raphael Eduardo,9999,0,9999,0
1713481228814,CSE 191,A00,516875,Minnes Kemp; Mor Mia,9999,0,9999,0
1713481229841,CSS 201S,A01,494383,Staff,35,0,35,0
1713481230875,CSS 202S,A01,494387,Staff,35,0,35,0
1713481231904,EAP 100,A00,516065,Staff,9792,0,9999,207
1713481232931,ECE 45,A01,507414,Staff,39,0,60,21
1713481233956,ECE 100,A01,507416,Baghdadchi; Saharnaz,3,0,20,17
1713481233956,ECE 100,A02,507418,Baghdadchi; Saharnaz,19,0,20,1
1713481234981,ECE 111,A01,507420,Staff,28,0,50,22
1713481236007,ECE 197,001,548057,Sievenpiper; Daniel F.,9998,0,9999,1
1713481237035,EDS 115,A00,507243,Choi; Bailey Miyeon,27,0,28,1
1713481238063,EDS 117,A01,494379,Staff,16,0,25,9
1713481239090,EDS 125,A00,507246,Hopkins; Megan Beth,28,0,30,2
1713481240119,EDS 128A,A01,507264,Fargason; Sharon Gayle,26,0,26,0
1713481241143,EDS 128B,A01,507293,Pappas; Elizabeth,30,0,30,0
1713481242171,EDS 139,A00,507294,Fargason; Sharon Gayle,30,0,30,0
1713481242171,EDS 139,B00,507313,Pappas; Elizabeth,30,0,30,0
1713481243197,EDS 201,A00,507315,Staff,19,0,30,11
1713481244222,EDS 203,A01,507317,Halter; Christopher P.,18,0,30,12
1713481245252,EDS 204R,A01,507319,Halter; Christopher P.,0,1,30,30
1713481245252,EDS 204R,B01,507331,Heinzman; Erica M.,26,0,30,4
1713481246278,EDS 206R,A00,507332,Staff,0,1,30,30
1713481246278,EDS 206R,B00,507343,Staff,27,0,30,3
1713481247307,EDS 250,A00,507344,Hemans; Patricia Ann Benitez,28,0,40,12
1713481248333,EDS 281,A00,507345,Daly; Alan J.,18,0,18,0
1713481249358,EDS 284,A00,507350,Daly; Alan J.,16,0,16,0
1713481250384,EDS 286,A00,507359,Fine; Sarah,18,0,18,0
1713481251409,EDS 289C,A01,507361,Daly; Alan J.,18,0,18,0
1713481252441,EDS 290,A00,507366,Hofstetter; Carolyn,15,0,15,0
1713481253473,LIGM 5A,A00,507421,Fischer-Grunski; Eva K,20,0,20,0
1713481254501,LIGM 5B,A00,507423,Fischer-Grunski; Eva K,20,0,20,0
1713481255529,LIGM 5C,A00,507425,Fischer-Grunski; Eva K,20,0,20,0
1713481256559,LIIT 5AS,A00,507427,Carnelos; Chiara,20,0,20,0
1713481257584,LIIT 5BS,A00,507430,Carnelos; Chiara,20,0,20,0
1713481258610,LIIT 5CS,A00,507432,Carnelos; Chiara,20,0,20,0
1713481259636,LISP 5A,A00,507541,Munoz Sanchez; Alicia,14,0,20,6
1713481260662,LISP 5B,A00,507671,Munoz Sanchez; Alicia,12,0,20,8
1713481261688,LISP 5C,A00,507696,Munoz Sanchez; Alicia,11,0,20,9
1713481262719,MAE 197,001,528363,Boechler; Nicholas Sebastia,9998,0,9999,1
1713481263745,MATH 197,001,523477,Kedlaya; Kiran S.,9999,0,9999,0
1713481263745,MATH 197,002,563811,Zhang; Danna,9998,0,9999,1
1713481264771,MCWP 40R,A00,518780,Staff,17,0,20,3
1713481264771,MCWP 40R,B00,518781,Staff,14,0,20,6
1713481264771,MCWP 40R,C00,518783,Staff,12,0,20,8
1713481265803,MCWP 50R,A00,518791,Staff,8,0,20,12
1713481265803,MCWP 50R,B00,518792,Staff,7,0,20,13
1713481265803,MCWP 50R,C00,518793,Staff,7,0,20,13
1713481265803,MCWP 50R,D00,518794,Staff,2,0,20,18
1713481265803,MCWP 50R,E00,518795,Staff,4,0,20,16
1713481265803,MCWP 50R,F00,518796,Staff,13,0,20,7
1713481265803,MCWP 50R,G00,518797,Staff,13,0,20,7
1713481266828,MMW 12R,A01,514034,Herbst; Matthew,8,0,16,8
1713481266828,MMW 12R,A02,514035,Herbst; Matthew,14,0,16,2
1713481267857,MMW 13R,A01,514037,Staff,0,0,16,16
1713481267857,MMW 13R,A02,514039,Staff,0,1,16,16
1713481269913,SIO 295LS,A00,523233,Staff,15,0,30,15
1713481270944,SIO 295S,A00,523232,Staff,15,0,30,15
1713481271974,SOCI 117,A01,494376,Staff,0,2,5,5
1713481273000,WES 237B,A00,494380,Staff,19,0,20,1
1713481275066,AESE 279B,A00,494370,Wade; Jon P,33,0,33,0
1713481276095,AIP 197,001,627712,Vespa; Emanuel Ignacio,9999,0,9999,0
1713481277121,ANAR 135S,A00,494369,Braswell; Geoffrey E.,0,0,0,0
1713481278154,CAT 124RS,A01,519847,Geibel; William,6,0,20,14
1713481279183,CAT 125RS,A01,515971,Geibel; William,6,0,20,14
1713481280209,CLRE 250,A00,511389,Morris; Sheldon,9996,0,9999,3
1713481281241,CLRE 251,A00,507176,Mehta; Ravindra L.,9996,0,9999,3
1713481281241,CLRE 251,B00,511410,Mehta; Ravindra L.,9998,0,9999,1
1713481282267,CLRE 252,A00,507189,Cuomo; Raphael Eduardo,9998,0,9999,1
1713481283293,CLRE 253,A00,507199,Vaida; Florin,9997,0,9999,2
1713481283293,CLRE 253,B00,507202,Vaida; Florin,9999,0,9999,0
1713481284318,CLRE 259,A00,507211,Patel; Hemal,9996,0,9999,3
1713481285343,CLRE 260,A00,507221,Cuomo; Raphael Eduardo,9999,0,9999,0
1713481286368,CLRE 297,001,507242,Cuomo; Raphael Eduardo,9999,0,9999,0
1713481287394,CSE 191,A00,516875,Minnes Kemp; Mor Mia,9999,0,9999,0
1713481288422,CSS 201S,A01,494383,Staff,35,0,35,0
1713481289449,CSS 202S,A01,494387,Staff,35,0,35,0
1713481290476,EAP 100,A00,516065,Staff,9792,0,9999,207
1713481291500,ECE 45,A01,507414,Staff,38,0,60,22
1713481292526,ECE 100,A01,507416,Baghdadchi; Saharnaz,3,0,20,17
1713481292526,ECE 100,A02,507418,Baghdadchi; Saharnaz,19,0,20,1
1713481293554,ECE 111,A01,507420,Staff,28,0,50,22
1713481294581,ECE 197,001,548057,Sievenpiper; Daniel F.,9998,0,9999,1
1713481295607,EDS 115,A00,507243,Choi; Bailey Miyeon,27,0,28,1
1713481296636,EDS 117,A01,494379,Staff,16,0,25,9
1713481297664,EDS 125,A00,507246,Hopkins; Megan Beth,28,0,30,2
1713481298691,EDS 128A,A01,507264,Fargason; Sharon Gayle,26,0,26,0
1713481299721,EDS 128B,A01,507293,Pappas; Elizabeth,30,0,30,0
1713481300745,EDS 139,A00,507294,Fargason; Sharon Gayle,30,0,30,0
1713481300745,EDS 139,B00,507313,Pappas; Elizabeth,30,0,30,0
1713481301772,EDS 201,A00,507315,Staff,19,0,30,11
1713481302801,EDS 203,A01,507317,Halter; Christopher P.,18,0,30,12
1713481303827,EDS 204R,A01,507319,Halter; Christopher P.,0,1,30,30
1713481303827,EDS 204R,B01,507331,Heinzman; Erica M.,26,0,30,4
1713481304856,EDS 206R,A00,507332,Staff,0,1,30,30
1713481304856,EDS 206R,B00,507343,Staff,27,0,30,3
1713481305881,EDS 250,A00,507344,Hemans; Patricia Ann Benitez,28,0,40,12
1713481306906,EDS 281,A00,507345,Daly; Alan J.,18,0,18,0
1713481307935,EDS 284,A00,507350,Daly; Alan J.,16,0,16,0
1713481308961,EDS 286,A00,507359,Fine; Sarah,18,0,18,0
1713481309987,EDS 289C,A01,507361,Daly; Alan J.,18,0,18,0
1713481311015,EDS 290,A00,507366,Hofstetter; Carolyn,15,0,15,0
1713481312193,LIGM 5A,A00,507421,Fischer-Grunski; Eva K,20,0,20,0
1713481313219,LIGM 5B,A00,507423,Fischer-Grunski; Eva K,20,0,20,0
1713481314247,LIGM 5C,A00,507425,Fischer-Grunski; Eva K,20,0,20,0
1713481315273,LIIT 5AS,A00,507427,Carnelos; Chiara,20,0,20,0
1713481316299,LIIT 5BS,A00,507430,Carnelos; Chiara,20,0,20,0
1713481317328,LIIT 5CS,A00,507432,Carnelos; Chiara,20,0,20,0
1713481318354,LISP 5A,A00,507541,Munoz Sanchez; Alicia,14,0,20,6
1713481319384,LISP 5B,A00,507671,Munoz Sanchez; Alicia,12,0,20,8
1713481320412,LISP 5C,A00,507696,Munoz Sanchez; Alicia,11,0,20,9
1713481321493,MAE 197,001,528363,Boechler; Nicholas Sebastia,9998,0,9999,1
1713481322523,MATH 197,001,523477,Kedlaya; Kiran S.,9999,0,9999,0
1713481322523,MATH 197,002,563811,Zhang; Danna,9998,0,9999,1
1713481323551,MCWP 40R,A00,518780,Staff,17,0,20,3
1713481323551,MCWP 40R,B00,518781,Staff,14,0,20,6
1713481323551,MCWP 40R,C00,518783,Staff,12,0,20,8
1713481324582,MCWP 50R,A00,518791,Staff,8,0,20,12
1713481324582,MCWP 50R,B00,518792,Staff,7,0,20,13
1713481324582,MCWP 50R,C00,518793,Staff,7,0,20,13
1713481324582,MCWP 50R,D00,518794,Staff,2,0,20,18
1713481324582,MCWP 50R,E00,518795,Staff,4,0,20,16
1713481324582,MCWP 50R,F00,518796,Staff,13,0,20,7
1713481324582,MCWP 50R,G00,518797,Staff,13,0,20,7
1713481325607,MMW 12R,A01,514034,Herbst; Matthew,8,0,16,8
1713481325607,MMW 12R,A02,514035,Herbst; Matthew,14,0,16,2
1713481326632,MMW 13R,A01,514037,Staff,0,0,16,16
1713481326632,MMW 13R,A02,514039,Staff,0,1,16,16
1713481328686,SIO 295LS,A00,523233,Staff,15,0,30,15
1713481329714,SIO 295S,A00,523232,Staff,15,0,30,15
1713481330740,SOCI 117,A01,494376,Staff,0,2,5,5
1713481331768,WES 237B,A00,494380,Staff,19,0,20,1
1713481333831,AESE 279B,A00,494370,Wade; Jon P,33,0,33,0
1713481334856,AIP 197,001,627712,Vespa; Emanuel Ignacio,9999,0,9999,0
1713481335882,ANAR 135S,A00,494369,Braswell; Geoffrey E.,0,0,0,0
1713481336907,CAT 124RS,A01,519847,Geibel; William,6,0,20,14
1713481337934,CAT 125RS,A01,515971,Geibel; William,6,0,20,14
1713481338959,CLRE 250,A00,511389,Morris; Sheldon,9996,0,9999,3
1713481339985,CLRE 251,A00,507176,Mehta; Ravindra L.,9996,0,9999,3
1713481339985,CLRE 251,B00,511410,Mehta; Ravindra L.,9998,0,9999,1
1713481341011,CLRE 252,A00,507189,Cuomo; Raphael Eduardo,9998,0,9999,1
1713481342037,CLRE 253,A00,507199,Vaida; Florin,9997,0,9999,2
1713481342037,CLRE 253,B00,507202,Vaida; Florin,9999,0,9999,0
1713481343062,CLRE 259,A00,507211,Patel; Hemal,9996,0,9999,3
1713481344090,CLRE 260,A00,507221,Cuomo; Raphael Eduardo,9999,0,9999,0
1713481345116,CLRE 297,001,507242,Cuomo; Raphael Eduardo,9999,0,9999,0
1713481346150,CSE 191,A00,516875,Minnes Kemp; Mor Mia,9999,0,9999,0
1713481347176,CSS 201S,A01,494383,Staff,35,0,35,0
1713481348206,CSS 202S,A01,494387,Staff,35,0,35,0
1713481349234,EAP 100,A00,516065,Staff,9792,0,9999,207
1713481350259,ECE 45,A01,507414,Staff,38,0,60,22
1713481351290,ECE 100,A01,507416,Baghdadchi; Saharnaz,3,0,20,17
1713481351290,ECE 100,A02,507418,Baghdadchi; Saharnaz,19,0,20,1
1713481352315,ECE 111,A01,507420,Staff,28,0,50,22
1713481353344,ECE 197,001,548057,Sievenpiper; Daniel F.,9998,0,9999,1
1713481354371,EDS 115,A00,507243,Choi; Bailey Miyeon,27,0,28,1
1713481355398,EDS 117,A01,494379,Staff,16,0,25,9
1713481356424,EDS 125,A00,507246,Hopkins; Megan Beth,28,0,30,2
1713481357452,EDS 128A,A01,507264,Fargason; Sharon Gayle,26,0,26,0
1713481358481,EDS 128B,A01,507293,Pappas; Elizabeth,30,0,30,0
1713481359506,EDS 139,A00,507294,Fargason; Sharon Gayle,30,0,30,0
1713481359506,EDS 139,B00,507313,Pappas; Elizabeth,30,0,30,0
1713481360533,EDS 201,A00,507315,Staff,19,0,30,11
1713481361562,EDS 203,A01,507317,Halter; Christopher P.,18,0,30,12
1713481362591,EDS 204R,A01,507319,Halter; Christopher P.,0,1,30,30
1713481362591,EDS 204R,B01,507331,Heinzman; Erica M.,26,0,30,4
1713481363617,EDS 206R,A00,507332,Staff,0,1,30,30
1713481363617,EDS 206R,B00,507343,Staff,27,0,30,3
1713481364642,EDS 250,A00,507344,Hemans; Patricia Ann Benitez,28,0,40,12
1713481365672,EDS 281,A00,507345,Daly; Alan J.,18,0,18,0
1713481366695,EDS 284,A00,507350,Daly; Alan J.,16,0,16,0
1713481367724,EDS 286,A00,507359,Fine; Sarah,18,0,18,0
1713481368749,EDS 289C,A01,507361,Daly; Alan J.,18,0,18,0
1713481369777,EDS 290,A00,507366,Hofstetter; Carolyn,15,0,15,0
1713481370808,LIGM 5A,A00,507421,Fischer-Grunski; Eva K,20,0,20,0
1713481371833,LIGM 5B,A00,507423,Fischer-Grunski; Eva K,20,0,20,0
1713481372859,LIGM 5C,A00,507425,Fischer-Grunski; Eva K,20,0,20,0
1713481373885,LIIT 5AS,A00,507427,Carnelos; Chiara,20,0,20,0
1713481374914,LIIT 5BS,A00,507430,Carnelos; Chiara,20,0,20,0
1713481375944,LIIT 5CS,A00,507432,Carnelos; Chiara,20,0,20,0
1713481376974,LISP 5A,A00,507541,Munoz Sanchez; Alicia,14,0,20,6
1713481378003,LISP 5B,A00,507671,Munoz Sanchez; Alicia,12,0,20,8
1713481379028,LISP 5C,A00,507696,Munoz Sanchez; Alicia,11,0,20,9
1713481380053,MAE 197,001,528363,Boechler; Nicholas Sebastia,9998,0,9999,1
1713481381079,MATH 197,001,523477,Kedlaya; Kiran S.,9999,0,9999,0
1713481381079,MATH 197,002,563811,Zhang; Danna,9998,0,9999,1
1713481382104,MCWP 40R,A00,518780,Staff,17,0,20,3
1713481382104,MCWP 40R,B00,518781,Staff,14,0,20,6
1713481382104,MCWP 40R,C00,518783,Staff,12,0,20,8
1713481383132,MCWP 50R,A00,518791,Staff,8,0,20,12
1713481383132,MCWP 50R,B00,518792,Staff,7,0,20,13
1713481383132,MCWP 50R,C00,518793,Staff,7,0,20,13
1713481383132,MCWP 50R,D00,518794,Staff,2,0,20,18
1713481383132,MCWP 50R,E00,518795,Staff,4,0,20,16
1713481383132,MCWP 50R,F00,518796,Staff,13,0,20,7
1713481383132,MCWP 50R,G00,518797,Staff,13,0,20,7
1713481384158,MMW 12R,A01,514034,Herbst; Matthew,8,0,16,8
1713481384158,MMW 12R,A02,514035,Herbst; Matthew,14,0,16,2
1713481385183,MMW 13R,A01,514037,Staff,0,0,16,16
1713481385183,MMW 13R,A02,514039,Staff,0,1,16,16
1713481387235,SIO 295LS,A00,523233,Staff,15,0,30,15
1713481388262,SIO 295S,A00,523232,Staff,15,0,30,15
1713481389467,SOCI 117,A01,494376,Staff,0,2,5,5
1713481390495,WES 237B,A00,494380,Staff,19,0,20,1
1713481392557,AESE 279B,A00,494370,Wade; Jon P,33,0,33,0
1713481393584,AIP 197,001,627712,Vespa; Emanuel Ignacio,9999,0,9999,0
1713481394610,ANAR 135S,A00,494369,Braswell; Geoffrey E.,0,0,0,0
1713481395640,CAT 124RS,A01,519847,Geibel; William,6,0,20,14
1713481396664,CAT 125RS,A01,515971,Geibel; William,6,0,20,14
1713481397693,CLRE 250,A00,511389,Morris; Sheldon,9996,0,9999,3
1713481398725,CLRE 251,A00,507176,Mehta; Ravindra L.,9996,0,9999,3
1713481398725,CLRE 251,B00,511410,Mehta; Ravindra L.,9998,0,9999,1
1713481399751,CLRE 252,A00,507189,Cuomo; Raphael Eduardo,9998,0,9999,1
1713481400777,CLRE 253,A00,507199,Vaida; Florin,9997,0,9999,2
1713481400777,CLRE 253,B00,507202,Vaida; Florin,9999,0,9999,0
1713481401802,CLRE 259,A00,507211,Patel; Hemal,9996,0,9999,3
1713481402831,CLRE 260,A00,507221,Cuomo; Raphael Eduardo,9999,0,9999,0
1713481403873,CLRE 297,001,507242,Cuomo; Raphael Eduardo,9999,0,9999,0
1713481404896,CSE 191,A00,516875,Minnes Kemp; Mor Mia,9999,0,9999,0
1713481405928,CSS 201S,A01,494383,Staff,35,0,35,0
1713481406957,CSS 202S,A01,494387,Staff,35,0,35,0
1713481407984,EAP 100,A00,516065,Staff,9792,0,9999,207
1713481409012,ECE 45,A01,507414,Staff,38,0,60,22
1713481410036,ECE 100,A01,507416,Baghdadchi; Saharnaz,3,0,20,17
1713481410036,ECE 100,A02,507418,Baghdadchi; Saharnaz,19,0,20,1
1713481411062,ECE 111,A01,507420,Staff,28,0,50,22
1713481412088,ECE 197,001,548057,Sievenpiper; Daniel F.,9998,0,9999,1
1713481413114,EDS 115,A00,507243,Choi; Bailey Miyeon,27,0,28,1
1713481414139,EDS 117,A01,494379,Staff,16,0,25,9
1713481415164,EDS 125,A00,507246,Hopkins; Megan Beth,28,0,30,2
1713481416193,EDS 128A,A01,507264,Fargason; Sharon Gayle,26,0,26,0
1713481417219,EDS 128B,A01,507293,Pappas; Elizabeth,30,0,30,0
1713481418249,EDS 139,A00,507294,Fargason; Sharon Gayle,30,0,30,0
1713481418249,EDS 139,B00,507313,Pappas; Elizabeth,30,0,30,0
1713481419276,EDS 201,A00,507315,Staff,19,0,30,11
1713481420306,EDS 203,A01,507317,Halter; Christopher P.,18,0,30,12
1713481421330,EDS 204R,A01,507319,Halter; Christopher P.,0,1,30,30
1713481421330,EDS 204R,B01,507331,Heinzman; Erica M.,26,0,30,4
1713481422358,EDS 206R,A00,507332,Staff,0,1,30,30
1713481422358,EDS 206R,B00,507343,Staff,27,0,30,3
1713481423383,EDS 250,A00,507344,Hemans; Patricia Ann Benitez,28,0,40,12
1713481424413,EDS 281,A00,507345,Daly; Alan J.,18,0,18,0
1713481425497,EDS 284,A00,507350,Daly; Alan J.,16,0,16,0
1713481426522,EDS 286,A00,507359,Fine; Sarah,18,0,18,0
1713481427547,EDS 289C,A01,507361,Daly; Alan J.,18,0,18,0
1713481428576,EDS 290,A00,507366,Hofstetter; Carolyn,15,0,15,0
1713481429611,LIGM 5A,A00,507421,Fischer-Grunski; Eva K,20,0,20,0
1713481430641,LIGM 5B,A00,507423,Fischer-Grunski; Eva K,20,0,20,0
1713481431671,LIGM 5C,A00,507425,Fischer-Grunski; Eva K,20,0,20,0
1713481432698,LIIT 5AS,A00,507427,Carnelos; Chiara,20,0,20,0
1713481433727,LIIT 5BS,A00,507430,Carnelos; Chiara,20,0,20,0
1713481434758,LIIT 5CS,A00,507432,Carnelos; Chiara,20,0,20,0
1713481435785,LISP 5A,A00,507541,Munoz Sanchez; Alicia,14,0,20,6
1713481436815,LISP 5B,A00,507671,Munoz Sanchez; Alicia,12,0,20,8
1713481437841,LISP 5C,A00,507696,Munoz Sanchez; Alicia,11,0,20,9
1713481438871,MAE 197,001,528363,Boechler; Nicholas Sebastia,9998,0,9999,1
1713481439904,MATH 197,001,523477,Kedlaya; Kiran S.,9999,0,9999,0
1713481439904,MATH 197,002,563811,Zhang; Danna,9998,0,9999,1
1713481440935,MCWP 40R,A00,518780,Staff,17,0,20,3
1713481440935,MCWP 40R,B00,518781,Staff,14,0,20,6
1713481440935,MCWP 40R,C00,518783,Staff,12,0,20,8
1713481441962,MCWP 50R,A00,518791,Staff,8,0,20,12
1713481441962,MCWP 50R,B00,518792,Staff,7,0,20,13
1713481441962,MCWP 50R,C00,518793,Staff,7,0,20,13
1713481441962,MCWP 50R,D00,518794,Staff,2,0,20,18
1713481441962,MCWP 50R,E00,518795,Staff,4,0,20,16
1713481441962,MCWP 50R,F00,518796,Staff,13,0,20,7
1713481441962,MCWP 50R,G00,518797,Staff,13,0,20,7
1713481442992,MMW 12R,A01,514034,Herbst; Matthew,8,0,16,8
1713481442992,MMW 12R,A02,514035,Herbst; Matthew,14,0,16,2
1713481444019,MMW 13R,A01,514037,Staff,0,0,16,16
1713481444019,MMW 13R,A02,514039,Staff,0,1,16,16
1713481446070,SIO 295LS,A00,523233,Staff,15,0,30,15
1713481447097,SIO 295S,A00,523232,Staff,15,0,30,15
1713481448123,SOCI 117,A01,494376,Staff,0,2,5,5
1713481449148,WES 237B,A00,494380,Staff,19,0,20,1
1713481451215,AESE 279B,A00,494370,Wade; Jon P,33,0,33,0
1713481452243,AIP 197,001,627712,Vespa; Emanuel Ignacio,9999,0,9999,0
1713481453268,ANAR 135S,A00,494369,Braswell; Geoffrey E.,0,0,0,0
1713481454300,CAT 124RS,A01,519847,Geibel; William,6,0,20,14
1713481455326,CAT 125RS,A01,515971,Geibel; William,6,0,20,14
1713481456353,CLRE 250,A00,511389,Morris; Sheldon,9996,0,9999,3
1713481457384,CLRE 251,A00,507176,Mehta; Ravindra L.,9996,0,9999,3
1713481457384,CLRE 251,B00,511410,Mehta; Ravindra L.,9998,0,9999,1
1713481458413,CLRE 252,A00,507189,Cuomo; Raphael Eduardo,9998,0,9999,1
1713481459439,CLRE 253,A00,507199,Vaida; Florin,9997,0,9999,2
1713481459439,CLRE 253,B00,507202,Vaida; Florin,9999,0,9999,0
1713481460464,CLRE 259,A00,507211,Patel; Hemal,9996,0,9999,3
1713481461489,CLRE 260,A00,507221,Cuomo; Raphael Eduardo,9999,0,9999,0
1713481462514,CLRE 297,001,507242,Cuomo; Raphael Eduardo,9999,0,9999,0
1713481463543,CSE 191,A00,516875,Minnes Kemp; Mor Mia,9999,0,9999,0
1713481464571,CSS 201S,A01,494383,Staff,35,0,35,0
1713481465595,CSS 202S,A01,494387,Staff,35,0,35,0
1713481466621,EAP 100,A00,516065,Staff,9792,0,9999,207
1713481467648,ECE 45,A01,507414,Staff,38,0,60,22
1713481468677,ECE 100,A01,507416,Baghdadchi; Saharnaz,3,0,20,17
1713481468677,ECE 100,A02,507418,Baghdadchi; Saharnaz,19,0,20,1
1713481469704,ECE 111,A01,507420,Staff,28,0,50,22
1713481470734,ECE 197,001,548057,Sievenpiper; Daniel F.,9998,0,9999,1
1713481471760,EDS 115,A00,507243,Choi; Bailey Miyeon,27,0,28,1
1713481472788,EDS 117,A01,494379,Staff,16,0,25,9
1713481473813,EDS 125,A00,507246,Hopkins; Megan Beth,28,0,30,2
1713481474839,EDS 128A,A01,507264,Fargason; Sharon Gayle,26,0,26,0
1713481475866,EDS 128B,A01,507293,Pappas; Elizabeth,30,0,30,0
1713481476892,EDS 139,A00,507294,Fargason; Sharon Gayle,30,0,30,0
1713481476892,EDS 139,B00,507313,Pappas; Elizabeth,30,0,30,0
1713481477921,EDS 201,A00,507315,Staff,19,0,30,11
1713481478953,EDS 203,A01,507317,Halter; Christopher P.,18,0,30,12
1713481479978,EDS 204R,A01,507319,Halter; Christopher P.,0,1,30,30
1713481479978,EDS 204R,B01,507331,Heinzman; Erica M.,26,0,30,4
1713481481002,EDS 206R,A00,507332,Staff,0,1,30,30
1713481481002,EDS 206R,B00,507343,Staff,27,0,30,3
1713481482027,EDS 250,A00,507344,Hemans; Patricia Ann Benitez,28,0,40,12
1713481483053,EDS 281,A00,507345,Daly; Alan J.,18,0,18,0
1713481484077,EDS 284,A00,507350,Daly; Alan J.,16,0,16,0
1713481485106,EDS 286,A00,507359,Fine; Sarah,18,0,18,0
1713481486131,EDS 289C,A01,507361,Daly; Alan J.,18,0,18,0
1713481487159,EDS 290,A00,507366,Hofstetter; Carolyn,15,0,15,0
1713481488189,LIGM 5A,A00,507421,Fischer-Grunski; Eva K,20,0,20,0
1713481489214,LIGM 5B,A00,507423,Fischer-Grunski; Eva K,20,0,20,0
1713481490240,LIGM 5C,A00,507425,Fischer-Grunski; Eva K,20,0,20,0
1713481491266,LIIT 5AS,A00,507427,Carnelos; Chiara,20,0,20,0
1713481492295,LIIT 5BS,A00,507430,Carnelos; Chiara,20,0,20,0
1713481493322,LIIT 5CS,A00,507432,Carnelos; Chiara,20,0,20,0
1713481494347,LISP 5A,A00,507541,Munoz Sanchez; Alicia,14,0,20,6
1713481495372,LISP 5B,A00,507671,Munoz Sanchez; Alicia,12,0,20,8
1713481496398,LISP 5C,A00,507696,Munoz Sanchez; Alicia,11,0,20,9
1713481497425,MAE 197,001,528363,Boechler; Nicholas Sebastia,9998,0,9999,1
1713481498453,MATH 197,001,523477,Kedlaya; Kiran S.,9999,0,9999,0
1713481498453,MATH 197,002,563811,Zhang; Danna,9998,0,9999,1
1713481499479,MCWP 40R,A00,518780,Staff,17,0,20,3
1713481499479,MCWP 40R,B00,518781,Staff,14,0,20,6
1713481499479,MCWP 40R,C00,518783,Staff,12,0,20,8
1713481500504,MCWP 50R,A00,518791,Staff,8,0,20,12
1713481500504,MCWP 50R,B00,518792,Staff,7,0,20,13
1713481500504,MCWP 50R,C00,518793,Staff,7,0,20,13
1713481500504,MCWP 50R,D00,518794,Staff,2,0,20,18
1713481500504,MCWP 50R,E00,518795,Staff,4,0,20,16
1713481500504,MCWP 50R,F00,518796,Staff,13,0,20,7
1713481500504,MCWP 50R,G00,518797,Staff,13,0,20,7
1713481501531,MMW 12R,A01,514034,Herbst; Matthew,8,0,16,8
1713481501531,MMW 12R,A02,514035,Herbst; Matthew,14,0,16,2
1713481502556,MMW 13R,A01,514037,Staff,0,0,16,16
1713481502556,MMW 13R,A02,514039,Staff,0,1,16,16
1713481504614,SIO 295LS,A00,523233,Staff,15,0,30,15
1713481505640,SIO 295S,A00,523232,Staff,15,0,30,15
1713481506669,SOCI 117,A01,494376,Staff,0,2,5,5
1713481507694,WES 237B,A00,494380,Staff,19,0,20,1
1713481509768,AESE 279B,A00,494370,Wade; Jon P,33,0,33,0
1713481510793,AIP 197,001,627712,Vespa; Emanuel Ignacio,9999,0,9999,0
1713481511818,ANAR 135S,A00,494369,Braswell; Geoffrey E.,0,0,0,0
1713481512842,CAT 124RS,A01,519847,Geibel; William,6,0,20,14
1713481513867,CAT 125RS,A01,515971,Geibel; William,6,0,20,14
1713481514896,CLRE 250,A00,511389,Morris; Sheldon,9996,0,9999,3
1713481515924,CLRE 251,A00,507176,Mehta; Ravindra L.,9996,0,9999,3
1713481515924,CLRE 251,B00,511410,Mehta; Ravindra L.,9998,0,9999,1
1713481516950,CLRE 252,A00,507189,Cuomo; Raphael Eduardo,9998,0,9999,1
1713481517976,CLRE 253,A00,507199,Vaida; Florin,9997,0,9999,2
1713481517976,CLRE 253,B00,507202,Vaida; Florin,9999,0,9999,0
1713481519003,CLRE 259,A00,507211,Patel; Hemal,9996,0,9999,3
1713481520028,CLRE 260,A00,507221,Cuomo; Raphael Eduardo,9999,0,9999,0
1713481521053,CLRE 297,001,507242,Cuomo; Raphael Eduardo,9999,0,9999,0
1713481522082,CSE 191,A00,516875,Minnes Kemp; Mor Mia,9999,0,9999,0
1713481523108,CSS 201S,A01,494383,Staff,35,0,35,0
1713481524133,CSS 202S,A01,494387,Staff,35,0,35,0
1713481525159,EAP 100,A00,516065,Staff,9792,0,9999,207
1713481526185,ECE 45,A01,507414,Staff,38,0,60,22
1713481527211,ECE 100,A01,507416,Baghdadchi; Saharnaz,3,0,20,17
1713481527211,ECE 100,A02,507418,Baghdadchi; Saharnaz,19,0,20,1
1713481528240,ECE 111,A01,507420,Staff,28,0,50,22
1713481529320,ECE 197,001,548057,Sievenpiper; Daniel F.,9998,0,9999,1
1713481530346,EDS 115,A00,507243,Choi; Bailey Miyeon,27,0,28,1
1713481531373,EDS 117,A01,494379,Staff,16,0,25,9
1713481532398,EDS 125,A00,507246,Hopkins; Megan Beth,28,0,30,2
1713481533427,EDS 128A,A01,507264,Fargason; Sharon Gayle,26,0,26,0
1713481534456,EDS 128B,A01,507293,Pappas; Elizabeth,30,0,30,0
1713481535484,EDS 139,A00,507294,Fargason; Sharon Gayle,30,0,30,0
1713481535484,EDS 139,B00,507313,Pappas; Elizabeth,30,0,30,0
1713481536512,EDS 201,A00,507315,Staff,19,0,30,11
1713481537541,EDS 203,A01,507317,Halter; Christopher P.,18,0,30,12
1713481538571,EDS 204R,A01,507319,Halter; Christopher P.,0,1,30,30
1713481538571,EDS 204R,B01,507331,Heinzman; Erica M.,26,0,30,4
1713481539596,EDS 206R,A00,507332,Staff,0,1,30,30
1713481539596,EDS 206R,B00,507343,Staff,27,0,30,3
1713481540628,EDS 250,A00,507344,Hemans; Patricia Ann Benitez,28,0,40,12
1713481541659,EDS 281,A00,507345,Daly; Alan J.,18,0,18,0
1713481542687,EDS 284,A00,507350,Daly; Alan J.,16,0,16,0
1713481543713,EDS 286,A00,507359,Fine; Sarah,18,0,18,0
1713481544739,EDS 289C,A01,507361,Daly; Alan J.,18,0,18,0
1713481545765,EDS 290,A00,507366,Hofstetter; Carolyn,15,0,15,0
1713481546793,LIGM 5A,A00,507421,Fischer-Grunski; Eva K,20,0,20,0
1713481547818,LIGM 5B,A00,507423,Fischer-Grunski; Eva K,20,0,20,0
1713481548858,LIGM 5C,A00,507425,Fischer-Grunski; Eva K,20,0,20,0
1713481549887,LIIT 5AS,A00,507427,Carnelos; Chiara,20,0,20,0
1713481550917,LIIT 5BS,A00,507430,Carnelos; Chiara,20,0,20,0
1713481551943,LIIT 5CS,A00,507432,Carnelos; Chiara,20,0,20,0
1713481552973,LISP 5A,A00,507541,Munoz Sanchez; Alicia,14,0,20,6
1713481554000,LISP 5B,A00,507671,Munoz Sanchez; Alicia,12,0,20,8
1713481555028,LISP 5C,A00,507696,Munoz Sanchez; Alicia,11,0,20,9
1713481556052,MAE 197,001,528363,Boechler; Nicholas Sebastia,9998,0,9999,1
1713481557078,MATH 197,001,523477,Kedlaya; Kiran S.,9999,0,9999,0
1713481557078,MATH 197,002,563811,Zhang; Danna,9998,0,9999,1
1713481558104,MCWP 40R,A00,518780,Staff,17,0,20,3
1713481558104,MCWP 40R,B00,518781,Staff,14,0,20,6
1713481558104,MCWP 40R,C00,518783,Staff,12,0,20,8
1713481559129,MCWP 50R,A00,518791,Staff,8,0,20,12
1713481559129,MCWP 50R,B00,518792,Staff,7,0,20,13
1713481559129,MCWP 50R,C00,518793,Staff,7,0,20,13
1713481559129,MCWP 50R,D00,518794,Staff,2,0,20,18
1713481559129,MCWP 50R,E00,518795,Staff,4,0,20,16
1713481559129,MCWP 50R,F00,518796,Staff,13,0,20,7
1713481559129,MCWP 50R,G00,518797,Staff,13,0,20,7
1713481560156,MMW 12R,A01,514034,Herbst; Matthew,8,0,16,8
1713481560156,MMW 12R,A02,514035,Herbst; Matthew,14,0,16,2
1713481561182,MMW 13R,A01,514037,Staff,0,0,16,16
1713481561182,MMW 13R,A02,514039,Staff,0,1,16,16
1713481563240,SIO 295LS,A00,523233,Staff,15,0,30,15
1713481564269,SIO 295S,A00,523232,Staff,15,0,30,15
1713481565301,SOCI 117,A01,494376,Staff,0,2,5,5
1713481566326,WES 237B,A00,494380,Staff,19,0,20,1
1713481568390,AESE 279B,A00,494370,Wade; Jon P,33,0,33,0
1713481569419,AIP 197,001,627712,Vespa; Emanuel Ignacio,9999,0,9999,0
1713481570445,ANAR 135S,A00,494369,Braswell; Geoffrey E.,0,0,0,0
1713481571476,CAT 124RS,A01,519847,Geibel; William,6,0,20,14
1713481572501,CAT 125RS,A01,515971,Geibel; William,6,0,20,14
1713481573526,CLRE 250,A00,511389,Morris; Sheldon,9996,0,9999,3
1713481574556,CLRE 251,A00,507176,Mehta; Ravindra L.,9996,0,9999,3
1713481574556,CLRE 251,B00,511410,Mehta; Ravindra L.,9998,0,9999,1
1713481575581,CLRE 252,A00,507189,Cuomo; Raphael Eduardo,9998,0,9999,1
1713481576609,CLRE 253,A00,507199,Vaida; Florin,9997,0,9999,2
1713481576609,CLRE 253,B00,507202,Vaida; Florin,9999,0,9999,0
1713481577634,CLRE 259,A00,507211,Patel; Hemal,9996,0,9999,3
1713481578664,CLRE 260,A00,507221,Cuomo; Raphael Eduardo,9999,0,9999,0
1713481579688,CLRE 297,001,507242,Cuomo; Raphael Eduardo,9999,0,9999,0
1713481580718,CSE 191,A00,516875,Minnes Kemp; Mor Mia,9999,0,9999,0
1713481581748,CSS 201S,A01,494383,Staff,35,0,35,0
1713481582774,CSS 202S,A01,494387,Staff,35,0,35,0
1713481583802,EAP 100,A00,516065,Staff,9792,0,9999,207
1713481584828,ECE 45,A01,507414,Staff,38,0,60,22
1713481585853,ECE 100,A01,507416,Baghdadchi; Saharnaz,3,0,20,17
1713481585853,ECE 100,A02,507418,Baghdadchi; Saharnaz,19,0,20,1
1713481586880,ECE 111,A01,507420,Staff,28,0,50,22
1713481587908,ECE 197,001,548057,Sievenpiper; Daniel F.,9998,0,9999,1
1713481588934,EDS 115,A00,507243,Choi; Bailey Miyeon,27,0,28,1
1713481589963,EDS 117,A01,494379,Staff,16,0,25,9
1713481590989,EDS 125,A00,507246,Hopkins; Megan Beth,28,0,30,2
1713481592018,EDS 128A,A01,507264,Fargason; Sharon Gayle,26,0,26,0
1713481593044,EDS 128B,A01,507293,Pappas; Elizabeth,30,0,30,0
1713481594071,EDS 139,A00,507294,Fargason; Sharon Gayle,30,0,30,0
1713481594071,EDS 139,B00,507313,Pappas; Elizabeth,30,0,30,0
1713481595099,EDS 201,A00,507315,Staff,19,0,30,11
1713481596123,EDS 203,A01,507317,Halter; Christopher P.,18,0,30,12
1713481597151,EDS 204R,A01,507319,Halter; Christopher P.,0,1,30,30
1713481597151,EDS 204R,B01,507331,Heinzman; Erica M.,26,0,30,4
1713481598174,EDS 206R,A00,507332,Staff,0,1,30,30
1713481598174,EDS 206R,B00,507343,Staff,27,0,30,3
1713481599201,EDS 250,A00,507344,Hemans; Patricia Ann Benitez,28,0,40,12
1713481600229,EDS 281,A00,507345,Daly; Alan J.,18,0,18,0
1713481601256,EDS 284,A00,507350,Daly; Alan J.,16,0,16,0
1713481602284,EDS 286,A00,507359,Fine; Sarah,18,0,18,0
1713481603308,EDS 289C,A01,507361,Daly; Alan J.,18,0,18,0
1713481604333,EDS 290,A00,507366,Hofstetter; Carolyn,15,0,15,0
1713481605359,LIGM 5A,A00,507421,Fischer-Grunski; Eva K,20,0,20,0
1713481606387,LIGM 5B,A00,507423,Fischer-Grunski; Eva K,20,0,20,0
1713481607416,LIGM 5C,A00,507425,Fischer-Grunski; Eva K,20,0,20,0
1713481608444,LIIT 5AS,A00,507427,Carnelos; Chiara,20,0,20,0
1713481609468,LIIT 5BS,A00,507430,Carnelos; Chiara,20,0,20,0
1713481610493,LIIT 5CS,A00,507432,Carnelos; Chiara,20,0,20,0
1713481611520,LISP 5A,A00,507541,Munoz Sanchez; Alicia,14,0,20,6
1713481612549,LISP 5B,A00,507671,Munoz Sanchez; Alicia,12,0,20,8
1713481613580,LISP 5C,A00,507696,Munoz Sanchez; Alicia,11,0,20,9
1713481614606,MAE 197,001,528363,Boechler; Nicholas Sebastia,9998,0,9999,1
1713481615640,MATH 197,001,523477,Kedlaya; Kiran S.,9999,0,9999,0
1713481615640,MATH 197,002,563811,Zhang; Danna,9998,0,9999,1
1713481616670,MCWP 40R,A00,518780,Staff,17,0,20,3
1713481616670,MCWP 40R,B00,518781,Staff,14,0,20,6
1713481616670,MCWP 40R,C00,518783,Staff,12,0,20,8
1713481617696,MCWP 50R,A00,518791,Staff,8,0,20,12
1713481617696,MCWP 50R,B00,518792,Staff,7,0,20,13
1713481617696,MCWP 50R,C00,518793,Staff,7,0,20,13
1713481617696,MCWP 50R,D00,518794,Staff,2,0,20,18
1713481617696,MCWP 50R,E00,518795,Staff,4,0,20,16
1713481617696,MCWP 50R,F00,518796,Staff,13,0,20,7
1713481617696,MCWP 50R,G00,518797,Staff,13,0,20,7
1713481618721,MMW 12R,A01,514034,Herbst; Matthew,8,0,16,8
1713481618721,MMW 12R,A02,514035,Herbst; Matthew,14,0,16,2
1713481619749,MMW 13R,A01,514037,Staff,0,0,16,16
1713481619749,MMW 13R,A02,514039,Staff,0,1,16,16
1713481621801,SIO 295LS,A00,523233,Staff,15,0,30,15
1713481622827,SIO 295S,A00,523232,Staff,15,0,30,15
1713481623854,SOCI 117,A01,494376,Staff,0,2,5,5
1713481624879,WES 237B,A00,494380,Staff,19,0,20,1
1713481626948,AESE 279B,A00,494370,Wade; Jon P,33,0,33,0
1713481627974,AIP 197,001,627712,Vespa; Emanuel Ignacio,9999,0,9999,0
1713481629002,ANAR 135S,A00,494369,Braswell; Geoffrey E.,0,0,0,0
1713481630027,CAT 124RS,A01,519847,Geibel; William,6,0,20,14
1713481631051,CAT 125RS,A01,515971,Geibel; William,6,0,20,14
1713481632087,CLRE 250,A00,511389,Morris; Sheldon,9996,0,9999,3
1713481633166,CLRE 251,A00,507176,Mehta; Ravindra L.,9996,0,9999,3
1713481633166,CLRE 251,B00,511410,Mehta; Ravindra L.,9998,0,9999,1
1713481634197,CLRE 252,A00,507189,Cuomo; Raphael Eduardo,9998,0,9999,1
1713481635224,CLRE 253,A00,507199,Vaida; Florin,9997,0,9999,2
1713481635224,CLRE 253,B00,507202,Vaida; Florin,9999,0,9999,0
1713481636250,CLRE 259,A00,507211,Patel; Hemal,9996,0,9999,3
1713481637280,CLRE 260,A00,507221,Cuomo; Raphael Eduardo,9999,0,9999,0
1713481638308,CLRE 297,001,507242,Cuomo; Raphael Eduardo,9999,0,9999,0
1713481639333,CSE 191,A00,516875,Minnes Kemp; Mor Mia,9999,0,9999,0
1713481640362,CSS 201S,A01,494383,Staff,35,0,35,0
1713481641388,CSS 202S,A01,494387,Staff,35,0,35,0
1713481642411,EAP 100,A00,516065,Staff,9792,0,9999,207
1713481643436,ECE 45,A01,507414,Staff,38,0,60,22
1713481644463,ECE 100,A01,507416,Baghdadchi; Saharnaz,3,0,20,17
1713481644463,ECE 100,A02,507418,Baghdadchi; Saharnaz,19,0,20,1
1713481645488,ECE 111,A01,507420,Staff,28,0,50,22
1713481646516,ECE 197,001,548057,Sievenpiper; Daniel F.,9998,0,9999,1
1713481647544,EDS 115,A00,507243,Choi; Bailey Miyeon,27,0,28,1
1713481648569,EDS 117,A01,494379,Staff,16,0,25,9
1713481649593,EDS 125,A00,507246,Hopkins; Megan Beth,28,0,30,2
1713481650618,EDS 128A,A01,507264,Fargason; Sharon Gayle,26,0,26,0
1713481651642,EDS 128B,A01,507293,Pappas; Elizabeth,30,0,30,0
1713481652667,EDS 139,A00,507294,Fargason; Sharon Gayle,30,0,30,0
1713481652667,EDS 139,B00,507313,Pappas; Elizabeth,30,0,30,0
1713481653692,EDS 201,A00,507315,Staff,19,0,30,11
1713481654717,EDS 203,A01,507317,Halter; Christopher P.,18,0,30,12
1713481655742,EDS 204R,A01,507319,Halter; Christopher P.,0,1,30,30
1713481655742,EDS 204R,B01,507331,Heinzman; Erica M.,26,0,30,4
1713481656767,EDS 206R,A00,507332,Staff,0,1,30,30
1713481656767,EDS 206R,B00,507343,Staff,27,0,30,3
1713481657793,EDS 250,A00,507344,Hemans; Patricia Ann Benitez,28,0,40,12
1713481658822,EDS 281,A00,507345,Daly; Alan J.,18,0,18,0
1713481659848,EDS 284,A00,507350,Daly; Alan J.,16,0,16,0
1713481660873,EDS 286,A00,507359,Fine; Sarah,18,0,18,0
1713481661898,EDS 289C,A01,507361,Daly; Alan J.,18,0,18,0
1713481662923,EDS 290,A00,507366,Hofstetter; Carolyn,15,0,15,0
1713481663953,LIGM 5A,A00,507421,Fischer-Grunski; Eva K,20,0,20,0
1713481664979,LIGM 5B,A00,507423,Fischer-Grunski; Eva K,20,0,20,0
1713481666004,LIGM 5C,A00,507425,Fischer-Grunski; Eva K,20,0,20,0
1713481667030,LIIT 5AS,A00,507427,Carnelos; Chiara,20,0,20,0
1713481668057,LIIT 5BS,A00,507430,Carnelos; Chiara,20,0,20,0
1713481669082,LIIT 5CS,A00,507432,Carnelos; Chiara,20,0,20,0
1713481670113,LISP 5A,A00,507541,Munoz Sanchez; Alicia,14,0,20,6
1713481671141,LISP 5B,A00,507671,Munoz Sanchez; Alicia,12,0,20,8
1713481672172,LISP 5C,A00,507696,Munoz Sanchez; Alicia,11,0,20,9
1713481673195,MAE 197,001,528363,Boechler; Nicholas Sebastia,9998,0,9999,1
1713481674221,MATH 197,001,523477,Kedlaya; Kiran S.,9999,0,9999,0
1713481674221,MATH 197,002,563811,Zhang; Danna,9998,0,9999,1
1713481675245,MCWP 40R,A00,518780,Staff,17,0,20,3
1713481675245,MCWP 40R,B00,518781,Staff,14,0,20,6
1713481675245,MCWP 40R,C00,518783,Staff,12,0,20,8
1713481676270,MCWP 50R,A00,518791,Staff,8,0,20,12
1713481676270,MCWP 50R,B00,518792,Staff,7,0,20,13
1713481676270,MCWP 50R,C00,518793,Staff,7,0,20,13
1713481676270,MCWP 50R,D00,518794,Staff,2,0,20,18
1713481676270,MCWP 50R,E00,518795,Staff,4,0,20,16
1713481676270,MCWP 50R,F00,518796,Staff,13,0,20,7
1713481676270,MCWP 50R,G00,518797,Staff,13,0,20,7
1713481677298,MMW 12R,A01,514034,Herbst; Matthew,8,0,16,8
1713481677298,MMW 12R,A02,514035,Herbst; Matthew,14,0,16,2
1713481678324,MMW 13R,A01,514037,Staff,0,0,16,16
1713481678324,MMW 13R,A02,514039,Staff,0,1,16,16
1713481680380,SIO 295LS,A00,523233,Staff,15,0,30,15
1713481681405,SIO 295S,A00,523232,Staff,15,0,30,15
1713481682435,SOCI 117,A01,494376,Staff,0,2,5,5
1713481683461,WES 237B,A00,494380,Staff,19,0,20,1
1713481685532,AESE 279B,A00,494370,Wade; Jon P,33,0,33,0
1713481686561,AIP 197,001,627712,Vespa; Emanuel Ignacio,9999,0,9999,0
1713481687584,ANAR 135S,A00,494369,Braswell; Geoffrey E.,0,0,0,0
1713481688611,CAT 124RS,A01,519847,Geibel; William,6,0,20,14
1713481689640,CAT 125RS,A01,515971,Geibel; William,6,0,20,14
1713481690668,CLRE 250,A00,511389,Morris; Sheldon,9996,0,9999,3
1713481691693,CLRE 251,A00,507176,Mehta; Ravindra L.,9996,0,9999,3
1713481691693,CLRE 251,B00,511410,Mehta; Ravindra L.,9998,0,9999,1
1713481692718,CLRE 252,A00,507189,Cuomo; Raphael Eduardo,9998,0,9999,1
1713481693748,CLRE 253,A00,507199,Vaida; Florin,9997,0,9999,2
1713481693748,CLRE 253,B00,507202,Vaida; Florin,9999,0,9999,0
1713481694774,CLRE 259,A00,507211,Patel; Hemal,9996,0,9999,3
1713481695800,CLRE 260,A00,507221,Cuomo; Raphael Eduardo,9999,0,9999,0
1713481696825,CLRE 297,001,507242,Cuomo; Raphael Eduardo,9999,0,9999,0
1713481697853,CSE 191,A00,516875,Minnes Kemp; Mor Mia,9999,0,9999,0
1713481698879,CSS 201S,A01,494383,Staff,35,0,35,0
1713481699905,CSS 202S,A01,494387,Staff,35,0,35,0
1713481700933,EAP 100,A00,516065,Staff,9792,0,9999,207
1713481701959,ECE 45,A01,507414,Staff,38,0,60,22
1713481702990,ECE 100,A01,507416,Baghdadchi; Saharnaz,3,0,20,17
1713481702990,ECE 100,A02,507418,Baghdadchi; Saharnaz,19,0,20,1
1713481704014,ECE 111,A01,507420,Staff,28,0,50,22
1713481705048,ECE 197,001,548057,Sievenpiper; Daniel F.,9998,0,9999,1
1713481706075,EDS 115,A00,507243,Choi; Bailey Miyeon,27,0,28,1
1713481707101,EDS 117,A01,494379,Staff,16,0,25,9
1713481708127,EDS 125,A00,507246,Hopkins; Megan Beth,28,0,30,2
1713481709158,EDS 128A,A01,507264,Fargason; Sharon Gayle,26,0,26,0
1713481710187,EDS 128B,A01,507293,Pappas; Elizabeth,30,0,30,0
1713481711215,EDS 139,A00,507294,Fargason; Sharon Gayle,30,0,30,0
1713481711215,EDS 139,B00,507313,Pappas; Elizabeth,30,0,30,0
1713481712245,EDS 201,A00,507315,Staff,19,0,30,11
1713481713269,EDS 203,A01,507317,Halter; Christopher P.,18,0,30,12
1713481714295,EDS 204R,A01,507319,Halter; Christopher P.,0,1,30,30
1713481714295,EDS 204R,B01,507331,Heinzman; Erica M.,26,0,30,4
1713481715320,EDS 206R,A00,507332,Staff,0,1,30,30
1713481715320,EDS 206R,B00,507343,Staff,27,0,30,3
1713481716348,EDS 250,A00,507344,Hemans; Patricia Ann Benitez,28,0,40,12
1713481717374,EDS 281,A00,507345,Daly; Alan J.,18,0,18,0
1713481718399,EDS 284,A00,507350,Daly; Alan J.,16,0,16,0
1713481719424,EDS 286,A00,507359,Fine; Sarah,18,0,18,0
1713481720455,EDS 289C,A01,507361,Daly; Alan J.,18,0,18,0
1713481721480,EDS 290,A00,507366,Hofstetter; Carolyn,15,0,15,0
1713481722510,LIGM 5A,A00,507421,Fischer-Grunski; Eva K,20,0,20,0
1713481723536,LIGM 5B,A00,507423,Fischer-Grunski; Eva K,20,0,20,0
1713481724562,LIGM 5C,A00,507425,Fischer-Grunski; Eva K,20,0,20,0
1713481725588,LIIT 5AS,A00,507427,Carnelos; Chiara,20,0,20,0
1713481726612,LIIT 5BS,A00,507430,Carnelos; Chiara,20,0,20,0
1713481727636,LIIT 5CS,A00,507432,Carnelos; Chiara,20,0,20,0
1713481728665,LISP 5A,A00,507541,Munoz Sanchez; Alicia,14,0,20,6
1713481729694,LISP 5B,A00,507671,Munoz Sanchez; Alicia,12,0,20,8
1713481730735,LISP 5C,A00,507696,Munoz Sanchez; Alicia,11,0,20,9
1713481731761,MAE 197,001,528363,Boechler; Nicholas Sebastia,9998,0,9999,1
1713481732794,MATH 197,001,523477,Kedlaya; Kiran S.,9999,0,9999,0
1713481732794,MATH 197,002,563811,Zhang; Danna,9998,0,9999,1
1713481733823,MCWP 40R,A00,518780,Staff,17,0,20,3
1713481733823,MCWP 40R,B00,518781,Staff,14,0,20,6
1713481733823,MCWP 40R,C00,518783,Staff,12,0,20,8
1713481734848,MCWP 50R,A00,518791,Staff,8,0,20,12
1713481734848,MCWP 50R,B00,518792,Staff,7,0,20,13
1713481734848,MCWP 50R,C00,518793,Staff,7,0,20,13
1713481734848,MCWP 50R,D00,518794,Staff,2,0,20,18
1713481734848,MCWP 50R,E00,518795,Staff,4,0,20,16
1713481734848,MCWP 50R,F00,518796,Staff,13,0,20,7
1713481734848,MCWP 50R,G00,518797,Staff,13,0,20,7
1713481735879,MMW 12R,A01,514034,Herbst; Matthew,8,0,16,8
1713481735879,MMW 12R,A02,514035,Herbst; Matthew,14,0,16,2
1713481736962,MMW 13R,A01,514037,Staff,0,0,16,16
1713481736962,MMW 13R,A02,514039,Staff,0,1,16,16
1713481739017,SIO 295LS,A00,523233,Staff,15,0,30,15
1713481740044,SIO 295S,A00,523232,Staff,15,0,30,15
1713481741069,SOCI 117,A01,494376,Staff,0,2,5,5
1713481742095,WES 237B,A00,494380,Staff,19,0,20,1
1713481744163,AESE 279B,A00,494370,Wade; Jon P,33,0,33,0
1713481745193,AIP 197,001,627712,Vespa; Emanuel Ignacio,9999,0,9999,0
1713481746219,ANAR 135S,A00,494369,Braswell; Geoffrey E.,0,0,0,0
1713481747251,CAT 124RS,A01,519847,Geibel; William,6,0,20,14
1713481748279,CAT 125RS,A01,515971,Geibel; William,6,0,20,14
1713481749305,CLRE 250,A00,511389,Morris; Sheldon,9996,0,9999,3
1713481750334,CLRE 251,A00,507176,Mehta; Ravindra L.,9996,0,9999,3
1713481750334,CLRE 251,B00,511410,Mehta; Ravindra L.,9998,0,9999,1
1713481751360,CLRE 252,A00,507189,Cuomo; Raphael Eduardo,9998,0,9999,1
1713481752387,CLRE 253,A00,507199,Vaida; Florin,9997,0,9999,2
1713481752387,CLRE 253,B00,507202,Vaida; Florin,9999,0,9999,0
1713481753417,CLRE 259,A00,507211,Patel; Hemal,9996,0,9999,3
1713481754443,CLRE 260,A00,507221,Cuomo; Raphael Eduardo,9999,0,9999,0
1713481755472,CLRE 297,001,507242,Cuomo; Raphael Eduardo,9999,0,9999,0
1713481756504,CSE 191,A00,516875,Minnes Kemp; Mor Mia,9999,0,9999,0
1713481757533,CSS 201S,A01,494383,Staff,35,0,35,0
1713481758598,CSS 202S,A01,494387,Staff,35,0,35,0
1713481759626,EAP 100,A00,516065,Staff,9792,0,9999,207
1713481760654,ECE 45,A01,507414,Staff,38,0,60,22
1713481761681,ECE 100,A01,507416,Baghdadchi; Saharnaz,3,0,20,17
1713481761681,ECE 100,A02,507418,Baghdadchi; Saharnaz,19,0,20,1
1713481762706,ECE 111,A01,507420,Staff,28,0,50,22
1713481763735,ECE 197,001,548057,Sievenpiper; Daniel F.,9998,0,9999,1
1713481764769,EDS 115,A00,507243,Choi; Bailey Miyeon,27,0,28,1
1713481765797,EDS 117,A01,494379,Staff,16,0,25,9
1713481766827,EDS 125,A00,507246,Hopkins; Megan Beth,28,0,30,2
1713481767855,EDS 128A,A01,507264,Fargason; Sharon Gayle,26,0,26,0
1713481768882,EDS 128B,A01,507293,Pappas; Elizabeth,30,0,30,0
1713481769906,EDS 139,A00,507294,Fargason; Sharon Gayle,30,0,30,0
1713481769906,EDS 139,B00,507313,Pappas; Elizabeth,30,0,30,0
1713481770932,EDS 201,A00,507315,Staff,19,0,30,11
1713481771958,EDS 203,A01,507317,Halter; Christopher P.,18,0,30,12
1713481772984,EDS 204R,A01,507319,Halter; Christopher P.,0,1,30,30
1713481772984,EDS 204R,B01,507331,Heinzman; Erica M.,26,0,30,4
1713481774011,EDS 206R,A00,507332,Staff,0,1,30,30
1713481774011,EDS 206R,B00,507343,Staff,27,0,30,3
1713481775036,EDS 250,A00,507344,Hemans; Patricia Ann Benitez,28,0,40,12
1713481776066,EDS 281,A00,507345,Daly; Alan J.,18,0,18,0
1713481777091,EDS 284,A00,507350,Daly; Alan J.,16,0,16,0
1713481778121,EDS 286,A00,507359,Fine; Sarah,18,0,18,0
1713481779146,EDS 289C,A01,507361,Daly; Alan J.,18,0,18,0
1713481780175,EDS 290,A00,507366,Hofstetter; Carolyn,15,0,15,0
1713481781203,LIGM 5A,A00,507421,Fischer-Grunski; Eva K,20,0,20,0
1713481782232,LIGM 5B,A00,507423,Fischer-Grunski; Eva K,20,0,20,0
1713481783259,LIGM 5C,A00,507425,Fischer-Grunski; Eva K,20,0,20,0
1713481784285,LIIT 5AS,A00,507427,Carnelos; Chiara,20,0,20,0
1713481785313,LIIT 5BS,A00,507430,Carnelos; Chiara,20,0,20,0
1713481786340,LIIT 5CS,A00,507432,Carnelos; Chiara,20,0,20,0
1713481787366,LISP 5A,A00,507541,Munoz Sanchez; Alicia,14,0,20,6
1713481788390,LISP 5B,A00,507671,Munoz Sanchez; Alicia,12,0,20,8
1713481789420,LISP 5C,A00,507696,Munoz Sanchez; Alicia,11,0,20,9
1713481790447,MAE 197,001,528363,Boechler; Nicholas Sebastia,9998,0,9999,1
1713481791474,MATH 197,001,523477,Kedlaya; Kiran S.,9999,0,9999,0
1713481791474,MATH 197,002,563811,Zhang; Danna,9998,0,9999,1
1713481792499,MCWP 40R,A00,518780,Staff,17,0,20,3
1713481792499,MCWP 40R,B00,518781,Staff,14,0,20,6
1713481792499,MCWP 40R,C00,518783,Staff,12,0,20,8
1713481793531,MCWP 50R,A00,518791,Staff,8,0,20,12
1713481793531,MCWP 50R,B00,518792,Staff,7,0,20,13
1713481793531,MCWP 50R,C00,518793,Staff,7,0,20,13
1713481793531,MCWP 50R,D00,518794,Staff,2,0,20,18
1713481793531,MCWP 50R,E00,518795,Staff,4,0,20,16
1713481793531,MCWP 50R,F00,518796,Staff,13,0,20,7
1713481793531,MCWP 50R,G00,518797,Staff,13,0,20,7
1713481794557,MMW 12R,A01,514034,Herbst; Matthew,8,0,16,8
1713481794557,MMW 12R,A02,514035,Herbst; Matthew,14,0,16,2
1713481795581,MMW 13R,A01,514037,Staff,0,1,16,16
1713481795581,MMW 13R,A02,514039,Staff,0,1,16,16
1713481797636,SIO 295LS,A00,523233,Staff,15,0,30,15
1713481798660,SIO 295S,A00,523232,Staff,15,0,30,15
1713481799685,SOCI 117,A01,494376,Staff,0,2,5,5
1713481800711,WES 237B,A00,494380,Staff,19,0,20,1
1713481802792,AESE 279B,A00,494370,Wade; Jon P,33,0,33,0
1713481803817,AIP 197,001,627712,Vespa; Emanuel Ignacio,9999,0,9999,0
1713481804847,ANAR 135S,A00,494369,Braswell; Geoffrey E.,0,0,0,0
1713481805871,CAT 124RS,A01,519847,Geibel; William,6,0,20,14
1713481806899,CAT 125RS,A01,515971,Geibel; William,6,0,20,14
1713481807925,CLRE 250,A00,511389,Morris; Sheldon,9996,0,9999,3
1713481808955,CLRE 251,A00,507176,Mehta; Ravindra L.,9996,0,9999,3
1713481808955,CLRE 251,B00,511410,Mehta; Ravindra L.,9998,0,9999,1
1713481809981,CLRE 252,A00,507189,Cuomo; Raphael Eduardo,9998,0,9999,1
1713481811008,CLRE 253,A00,507199,Vaida; Florin,9997,0,9999,2
1713481811008,CLRE 253,B00,507202,Vaida; Florin,9999,0,9999,0
1713481812032,CLRE 259,A00,507211,Patel; Hemal,9996,0,9999,3
1713481813060,CLRE 260,A00,507221,Cuomo; Raphael Eduardo,9999,0,9999,0
1713481814087,CLRE 297,001,507242,Cuomo; Raphael Eduardo,9999,0,9999,0
1713481815116,CSE 191,A00,516875,Minnes Kemp; Mor Mia,9999,0,9999,0
1713481816144,CSS 201S,A01,494383,Staff,35,0,35,0
1713481817170,CSS 202S,A01,494387,Staff,35,0,35,0
1713481818198,EAP 100,A00,516065,Staff,9792,0,9999,207
1713481819227,ECE 45,A01,507414,Staff,38,0,60,22
1713481820253,ECE 100,A01,507416,Baghdadchi; Saharnaz,3,0,20,17
1713481820253,ECE 100,A02,507418,Baghdadchi; Saharnaz,19,0,20,1
1713481821277,ECE 111,A01,507420,Staff,28,0,50,22
1713481822307,ECE 197,001,548057,Sievenpiper; Daniel F.,9998,0,9999,1
1713481823333,EDS 115,A00,507243,Choi; Bailey Miyeon,27,0,28,1
1713481824361,EDS 117,A01,494379,Staff,16,0,25,9
1713481825389,EDS 125,A00,507246,Hopkins; Megan Beth,28,0,30,2
1713481826419,EDS 128A,A01,507264,Fargason; Sharon Gayle,26,0,26,0
1713481827444,EDS 128B,A01,507293,Pappas; Elizabeth,30,0,30,0
1713481828472,EDS 139,A00,507294,Fargason; Sharon Gayle,30,0,30,0
1713481828472,EDS 139,B00,507313,Pappas; Elizabeth,30,0,30,0
1713481829499,EDS 201,A00,507315,Staff,19,0,30,11
1713481830529,EDS 203,A01,507317,Halter; Christopher P.,18,0,30,12
1713481831555,EDS 204R,A01,507319,Halter; Christopher P.,0,1,30,30
1713481831555,EDS 204R,B01,507331,Heinzman; Erica M.,26,0,30,4
1713481832580,EDS 206R,A00,507332,Staff,0,1,30,30
1713481832580,EDS 206R,B00,507343,Staff,27,0,30,3
1713481833605,EDS 250,A00,507344,Hemans; Patricia Ann Benitez,28,0,40,12
1713481834629,EDS 281,A00,507345,Daly; Alan J.,18,0,18,0
1713481835653,EDS 284,A00,507350,Daly; Alan J.,16,0,16,0
1713481836682,EDS 286,A00,507359,Fine; Sarah,18,0,18,0
1713481837708,EDS 289C,A01,507361,Daly; Alan J.,18,0,18,0
1713481838733,EDS 290,A00,507366,Hofstetter; Carolyn,15,0,15,0
1713481839759,LIGM 5A,A00,507421,Fischer-Grunski; Eva K,20,0,20,0
1713481840841,LIGM 5B,A00,507423,Fischer-Grunski; Eva K,20,0,20,0
1713481841867,LIGM 5C,A00,507425,Fischer-Grunski; Eva K,20,0,20,0
1713481842893,LIIT 5AS,A00,507427,Carnelos; Chiara,20,0,20,0
1713481843923,LIIT 5BS,A00,507430,Carnelos; Chiara,20,0,20,0
1713481844949,LIIT 5CS,A00,507432,Carnelos; Chiara,20,0,20,0
1713481845976,LISP 5A,A00,507541,Munoz Sanchez; Alicia,14,0,20,6
1713481847005,LISP 5B,A00,507671,Munoz Sanchez; Alicia,12,0,20,8
1713481848034,LISP 5C,A00,507696,Munoz Sanchez; Alicia,11,0,20,9
1713481849063,MAE 197,001,528363,Boechler; Nicholas Sebastia,9998,0,9999,1
1713481850100,MATH 197,001,523477,Kedlaya; Kiran S.,9999,0,9999,0
1713481850100,MATH 197,002,563811,Zhang; Danna,9998,0,9999,1
1713481851132,MCWP 40R,A00,518780,Staff,17,0,20,3
1713481851132,MCWP 40R,B00,518781,Staff,14,0,20,6
1713481851132,MCWP 40R,C00,518783,Staff,12,0,20,8
1713481852159,MCWP 50R,A00,518791,Staff,8,0,20,12
1713481852159,MCWP 50R,B00,518792,Staff,7,0,20,13
1713481852159,MCWP 50R,C00,518793,Staff,7,0,20,13
1713481852159,MCWP 50R,D00,518794,Staff,2,0,20,18
1713481852159,MCWP 50R,E00,518795,Staff,4,0,20,16
1713481852159,MCWP 50R,F00,518796,Staff,13,0,20,7
1713481852159,MCWP 50R,G00,518797,Staff,13,0,20,7
1713481853196,MMW 12R,A01,514034,Herbst; Matthew,8,0,16,8
1713481853196,MMW 12R,A02,514035,Herbst; Matthew,14,0,16,2
1713481854222,MMW 13R,A01,514037,Staff,0,1,16,16
1713481854222,MMW 13R,A02,514039,Staff,0,1,16,16
1713481856278,SIO 295LS,A00,523233,Staff,15,0,30,15
1713481857303,SIO 295S,A00,523232,Staff,15,0,30,15
1713481858328,SOCI 117,A01,494376,Staff,0,2,5,5
1713481859352,WES 237B,A00,494380,Staff,19,0,20,1
1713481861419,AESE 279B,A00,494370,Wade; Jon P,33,0,33,0
1713481862447,AIP 197,001,627712,Vespa; Emanuel Ignacio,9999,0,9999,0
1713481863476,ANAR 135S,A00,494369,Braswell; Geoffrey E.,0,0,0,0
1713481864503,CAT 124RS,A01,519847,Geibel; William,6,0,20,14
1713481865528,CAT 125RS,A01,515971,Geibel; William,6,0,20,14
1713481866559,CLRE 250,A00,511389,Morris; Sheldon,9996,0,9999,3
1713481867587,CLRE 251,A00,507176,Mehta; Ravindra L.,9996,0,9999,3
1713481867587,CLRE 251,B00,511410,Mehta; Ravindra L.,9998,0,9999,1
1713481868613,CLRE 252,A00,507189,Cuomo; Raphael Eduardo,9998,0,9999,1
1713481869638,CLRE 253,A00,507199,Vaida; Florin,9997,0,9999,2
1713481869638,CLRE 253,B00,507202,Vaida; Florin,9999,0,9999,0
1713481870662,CLRE 259,A00,507211,Patel; Hemal,9996,0,9999,3
1713481871687,CLRE 260,A00,507221,Cuomo; Raphael Eduardo,9999,0,9999,0
1713481872711,CLRE 297,001,507242,Cuomo; Raphael Eduardo,9999,0,9999,0
1713481873736,CSE 191,A00,516875,Minnes Kemp; Mor Mia,9999,0,9999,0
1713481874763,CSS 201S,A01,494383,Staff,35,0,35,0
1713481875792,CSS 202S,A01,494387,Staff,35,0,35,0
1713481876819,EAP 100,A00,516065,Staff,9792,0,9999,207
1713481877846,ECE 45,A01,507414,Staff,38,0,60,22
1713481878872,ECE 100,A01,507416,Baghdadchi; Saharnaz,3,0,20,17
1713481878872,ECE 100,A02,507418,Baghdadchi; Saharnaz,19,0,20,1
1713481879897,ECE 111,A01,507420,Staff,28,0,50,22
1713481880922,ECE 197,001,548057,Sievenpiper; Daniel F.,9998,0,9999,1
1713481881946,EDS 115,A00,507243,Choi; Bailey Miyeon,27,0,28,1
1713481882972,EDS 117,A01,494379,Staff,16,0,25,9
1713481883998,EDS 125,A00,507246,Hopkins; Megan Beth,28,0,30,2
1713481885027,EDS 128A,A01,507264,Fargason; Sharon Gayle,26,0,26,0
1713481886053,EDS 128B,A01,507293,Pappas; Elizabeth,30,0,30,0
1713481887084,EDS 139,A00,507294,Fargason; Sharon Gayle,30,0,30,0
1713481887084,EDS 139,B00,507313,Pappas; Elizabeth,30,0,30,0
1713481888113,EDS 201,A00,507315,Staff,19,0,30,11
1713481889143,EDS 203,A01,507317,Halter; Christopher P.,18,0,30,12
1713481890170,EDS 204R,A01,507319,Halter; Christopher P.,0,1,30,30
1713481890170,EDS 204R,B01,507331,Heinzman; Erica M.,26,0,30,4
1713481891195,EDS 206R,A00,507332,Staff,0,1,30,30
1713481891195,EDS 206R,B00,507343,Staff,27,0,30,3
1713481892224,EDS 250,A00,507344,Hemans; Patricia Ann Benitez,28,0,40,12
1713481893251,EDS 281,A00,507345,Daly; Alan J.,18,0,18,0
1713481894276,EDS 284,A00,507350,Daly; Alan J.,16,0,16,0
1713481895304,EDS 286,A00,507359,Fine; Sarah,18,0,18,0
1713481896329,EDS 289C,A01,507361,Daly; Alan J.,18,0,18,0
1713481897359,EDS 290,A00,507366,Hofstetter; Carolyn,15,0,15,0
1713481898386,LIGM 5A,A00,507421,Fischer-Grunski; Eva K,20,0,20,0
1713481899411,LIGM 5B,A00,507423,Fischer-Grunski; Eva K,20,0,20,0
1713481900435,LIGM 5C,A00,507425,Fischer-Grunski; Eva K,20,0,20,0
1713481901460,LIIT 5AS,A00,507427,Carnelos; Chiara,20,0,20,0
1713481902485,LIIT 5BS,A00,507430,Carnelos; Chiara,20,0,20,0
1713481903509,LIIT 5CS,A00,507432,Carnelos; Chiara,20,0,20,0
1713481904535,LISP 5A,A00,507541,Munoz Sanchez; Alicia,14,0,20,6
1713481905560,LISP 5B,A00,507671,Munoz Sanchez; Alicia,12,0,20,8
1713481906585,LISP 5C,A00,507696,Munoz Sanchez; Alicia,11,0,20,9
1713481907613,MAE 197,001,528363,Boechler; Nicholas Sebastia,9998,0,9999,1
1713481908640,MATH 197,001,523477,Kedlaya; Kiran S.,9999,0,9999,0
1713481908640,MATH 197,002,563811,Zhang; Danna,9998,0,9999,1
1713481909664,MCWP 40R,A00,518780,Staff,17,0,20,3
1713481909664,MCWP 40R,B00,518781,Staff,14,0,20,6
1713481909664,MCWP 40R,C00,518783,Staff,12,0,20,8
1713481910690,MCWP 50R,A00,518791,Staff,8,0,20,12
1713481910690,MCWP 50R,B00,518792,Staff,7,0,20,13
1713481910690,MCWP 50R,C00,518793,Staff,7,0,20,13
1713481910690,MCWP 50R,D00,518794,Staff,2,0,20,18
1713481910690,MCWP 50R,E00,518795,Staff,3,0,20,17
1713481910690,MCWP 50R,F00,518796,Staff,13,0,20,7
1713481910690,MCWP 50R,G00,518797,Staff,13,0,20,7
1713481911719,MMW 12R,A01,514034,Herbst; Matthew,8,0,16,8
1713481911719,MMW 12R,A02,514035,Herbst; Matthew,14,0,16,2
1713481912744,MMW 13R,A01,514037,Staff,0,1,16,16
1713481912744,MMW 13R,A02,514039,Staff,0,1,16,16
1713481914796,SIO 295LS,A00,523233,Staff,15,0,30,15
1713481915821,SIO 295S,A00,523232,Staff,15,0,30,15
1713481916851,SOCI 117,A01,494376,Staff,0,2,5,5
1713481917876,WES 237B,A00,494380,Staff,19,0,20,1
1713481919942,AESE 279B,A00,494370,Wade; Jon P,33,0,33,0
1713481920974,AIP 197,001,627712,Vespa; Emanuel Ignacio,9999,0,9999,0
1713481921999,ANAR 135S,A00,494369,Braswell; Geoffrey E.,0,0,0,0
1713481923028,CAT 124RS,A01,519847,Geibel; William,6,0,20,14
1713481924057,CAT 125RS,A01,515971,Geibel; William,6,0,20,14
1713481925083,CLRE 250,A00,511389,Morris; Sheldon,9996,0,9999,3
1713481926110,CLRE 251,A00,507176,Mehta; Ravindra L.,9996,0,9999,3
1713481926110,CLRE 251,B00,511410,Mehta; Ravindra L.,9998,0,9999,1
1713481927136,CLRE 252,A00,507189,Cuomo; Raphael Eduardo,9998,0,9999,1
1713481928168,CLRE 253,A00,507199,Vaida; Florin,9997,0,9999,2
1713481928168,CLRE 253,B00,507202,Vaida; Florin,9999,0,9999,0
1713481929195,CLRE 259,A00,507211,Patel; Hemal,9996,0,9999,3
1713481930220,CLRE 260,A00,507221,Cuomo; Raphael Eduardo,9999,0,9999,0
1713481931249,CLRE 297,001,507242,Cuomo; Raphael Eduardo,9999,0,9999,0
1713481932278,CSE 191,A00,516875,Minnes Kemp; Mor Mia,9999,0,9999,0
1713481933303,CSS 201S,A01,494383,Staff,35,0,35,0
1713481934329,CSS 202S,A01,494387,Staff,35,0,35,0
1713481935353,EAP 100,A00,516065,Staff,9792,0,9999,207
1713481936381,ECE 45,A01,507414,Staff,38,0,60,22
1713481937412,ECE 100,A01,507416,Baghdadchi; Saharnaz,3,0,20,17
1713481937412,ECE 100,A02,507418,Baghdadchi; Saharnaz,19,0,20,1
1713481938441,ECE 111,A01,507420,Staff,28,0,50,22
1713481939465,ECE 197,001,548057,Sievenpiper; Daniel F.,9998,0,9999,1
1713481940495,EDS 115,A00,507243,Choi; Bailey Miyeon,27,0,28,1
1713481941521,EDS 117,A01,494379,Staff,16,0,25,9
1713481942546,EDS 125,A00,507246,Hopkins; Megan Beth,28,0,30,2
1713481943573,EDS 128A,A01,507264,Fargason; Sharon Gayle,26,0,26,0
1713481944670,EDS 128B,A01,507293,Pappas; Elizabeth,30,0,30,0
1713481945695,EDS 139,A00,507294,Fargason; Sharon Gayle,30,0,30,0
1713481945695,EDS 139,B00,507313,Pappas; Elizabeth,30,0,30,0
1713481946721,EDS 201,A00,507315,Staff,19,0,30,11
1713481947747,EDS 203,A01,507317,Halter; Christopher P.,18,0,30,12
1713481948777,EDS 204R,A01,507319,Halter; Christopher P.,0,1,30,30
1713481948777,EDS 204R,B01,507331,Heinzman; Erica M.,26,0,30,4
1713481949801,EDS 206R,A00,507332,Staff,0,1,30,30
1713481949801,EDS 206R,B00,507343,Staff,27,0,30,3
1713481950836,EDS 250,A00,507344,Hemans; Patricia Ann Benitez,28,0,40,12
1713481951865,EDS 281,A00,507345,Daly; Alan J.,18,0,18,0
1713481952890,EDS 284,A00,507350,Daly; Alan J.,16,0,16,0
1713481953916,EDS 286,A00,507359,Fine; Sarah,18,0,18,0
1713481954944,EDS 289C,A01,507361,Daly; Alan J.,18,0,18,0
1713481955969,EDS 290,A00,507366,Hofstetter; Carolyn,15,0,15,0
1713481956995,LIGM 5A,A00,507421,Fischer-Grunski; Eva K,20,0,20,0
1713481958019,LIGM 5B,A00,507423,Fischer-Grunski; Eva K,20,0,20,0
1713481959050,LIGM 5C,A00,507425,Fischer-Grunski; Eva K,20,0,20,0
1713481960076,LIIT 5AS,A00,507427,Carnelos; Chiara,20,0,20,0
1713481961100,LIIT 5BS,A00,507430,Carnelos; Chiara,20,0,20,0
1713481962124,LIIT 5CS,A00,507432,Carnelos; Chiara,20,0,20,0
1713481963149,LISP 5A,A00,507541,Munoz Sanchez; Alicia,14,0,20,6
1713481964178,LISP 5B,A00,507671,Munoz Sanchez; Alicia,12,0,20,8
1713481965206,LISP 5C,A00,507696,Munoz Sanchez; Alicia,11,0,20,9
1713481966231,MAE 197,001,528363,Boechler; Nicholas Sebastia,9998,0,9999,1
1713481967256,MATH 197,001,523477,Kedlaya; Kiran S.,9999,0,9999,0
1713481967256,MATH 197,002,563811,Zhang; Danna,9998,0,9999,1
1713481968281,MCWP 40R,A00,518780,Staff,17,0,20,3
1713481968281,MCWP 40R,B00,518781,Staff,14,0,20,6
1713481968281,MCWP 40R,C00,518783,Staff,12,0,20,8
1713481969307,MCWP 50R,A00,518791,Staff,8,0,20,12
1713481969307,MCWP 50R,B00,518792,Staff,7,0,20,13
1713481969307,MCWP 50R,C00,518793,Staff,7,0,20,13
1713481969307,MCWP 50R,D00,518794,Staff,2,0,20,18
1713481969307,MCWP 50R,E00,518795,Staff,3,0,20,17
1713481969307,MCWP 50R,F00,518796,Staff,13,0,20,7
1713481969307,MCWP 50R,G00,518797,Staff,13,0,20,7
1713481970332,MMW 12R,A01,514034,Herbst; Matthew,8,0,16,8
1713481970332,MMW 12R,A02,514035,Herbst; Matthew,14,0,16,2
1713481971356,MMW 13R,A01,514037,Staff,0,1,16,16
1713481971356,MMW 13R,A02,514039,Staff,0,1,16,16
1713481973413,SIO 295LS,A00,523233,Staff,15,0,30,15
1713481974438,SIO 295S,A00,523232,Staff,15,0,30,15
1713481975466,SOCI 117,A01,494376,Staff,0,2,5,5
1713481976494,WES 237B,A00,494380,Staff,19,0,20,1
1713481978564,AESE 279B,A00,494370,Wade; Jon P,33,0,33,0
1713481979595,AIP 197,001,627712,Vespa; Emanuel Ignacio,9999,0,9999,0
1713481980621,ANAR 135S,A00,494369,Braswell; Geoffrey E.,0,0,0,0
1713481981646,CAT 124RS,A01,519847,Geibel; William,6,0,20,14
1713481982670,CAT 125RS,A01,515971,Geibel; William,6,0,20,14
1713481983698,CLRE 250,A00,511389,Morris; Sheldon,9996,0,9999,3
1713481984723,CLRE 251,A00,507176,Mehta; Ravindra L.,9996,0,9999,3
1713481984723,CLRE 251,B00,511410,Mehta; Ravindra L.,9998,0,9999,1
1713481985748,CLRE 252,A00,507189,Cuomo; Raphael Eduardo,9998,0,9999,1
1713481986777,CLRE 253,A00,507199,Vaida; Florin,9997,0,9999,2
1713481986777,CLRE 253,B00,507202,Vaida; Florin,9999,0,9999,0
1713481987802,CLRE 259,A00,507211,Patel; Hemal,9996,0,9999,3
1713481988830,CLRE 260,A00,507221,Cuomo; Raphael Eduardo,9999,0,9999,0
1713481989854,CLRE 297,001,507242,Cuomo; Raphael Eduardo,9999,0,9999,0
1713481990879,CSE 191,A00,516875,Minnes Kemp; Mor Mia,9999,0,9999,0
1713481991909,CSS 201S,A01,494383,Staff,35,0,35,0
1713481992934,CSS 202S,A01,494387,Staff,35,0,35,0
1713481993959,EAP 100,A00,516065,Staff,9792,0,9999,207
1713481994985,ECE 45,A01,507414,Staff,38,0,60,22
1713481996014,ECE 100,A01,507416,Baghdadchi; Saharnaz,3,0,20,17
1713481996014,ECE 100,A02,507418,Baghdadchi; Saharnaz,19,0,20,1
1713481997041,ECE 111,A01,507420,Staff,28,0,50,22
1713481998068,ECE 197,001,548057,Sievenpiper; Daniel F.,9998,0,9999,1
1713481999096,EDS 115,A00,507243,Choi; Bailey Miyeon,27,0,28,1
1713482000123,EDS 117,A01,494379,Staff,16,0,25,9
1713482001149,EDS 125,A00,507246,Hopkins; Megan Beth,28,0,30,2
1713482002176,EDS 128A,A01,507264,Fargason; Sharon Gayle,26,0,26,0
1713482003201,EDS 128B,A01,507293,Pappas; Elizabeth,30,0,30,0
1713482004227,EDS 139,A00,507294,Fargason; Sharon Gayle,30,0,30,0
1713482004227,EDS 139,B00,507313,Pappas; Elizabeth,30,0,30,0
1713482005254,EDS 201,A00,507315,Staff,19,0,30,11
1713482006280,EDS 203,A01,507317,Halter; Christopher P.,18,0,30,12
1713482007311,EDS 204R,A01,507319,Halter; Christopher P.,0,1,30,30
1713482007311,EDS 204R,B01,507331,Heinzman; Erica M.,26,0,30,4
1713482008340,EDS 206R,A00,507332,Staff,0,1,30,30
1713482008340,EDS 206R,B00,507343,Staff,27,0,30,3
1713482009366,EDS 250,A00,507344,Hemans; Patricia Ann Benitez,28,0,40,12
1713482010395,EDS 281,A00,507345,Daly; Alan J.,18,0,18,0
1713482011423,EDS 284,A00,507350,Daly; Alan J.,16,0,16,0
1713482012447,EDS 286,A00,507359,Fine; Sarah,18,0,18,0
1713482013470,EDS 289C,A01,507361,Daly; Alan J.,18,0,18,0
1713482014498,EDS 290,A00,507366,Hofstetter; Carolyn,15,0,15,0
1713482015637,LIGM 5A,A00,507421,Fischer-Grunski; Eva K,20,0,20,0
1713482016662,LIGM 5B,A00,507423,Fischer-Grunski; Eva K,20,0,20,0
1713482017691,LIGM 5C,A00,507425,Fischer-Grunski; Eva K,20,0,20,0
1713482018719,LIIT 5AS,A00,507427,Carnelos; Chiara,20,0,20,0
1713482019752,LIIT 5BS,A00,507430,Carnelos; Chiara,20,0,20,0
1713482020777,LIIT 5CS,A00,507432,Carnelos; Chiara,20,0,20,0
1713482021809,LISP 5A,A00,507541,Munoz Sanchez; Alicia,14,0,20,6
1713482022836,LISP 5B,A00,507671,Munoz Sanchez; Alicia,12,0,20,8
1713482023866,LISP 5C,A00,507696,Munoz Sanchez; Alicia,11,0,20,9
1713482024892,MAE 197,001,528363,Boechler; Nicholas Sebastia,9998,0,9999,1
1713482025924,MATH 197,001,523477,Kedlaya; Kiran S.,9999,0,9999,0
1713482025924,MATH 197,002,563811,Zhang; Danna,9998,0,9999,1
1713482027012,MCWP 40R,A00,518780,Staff,17,0,20,3
1713482027012,MCWP 40R,B00,518781,Staff,14,0,20,6
1713482027012,MCWP 40R,C00,518783,Staff,12,0,20,8
1713482028040,MCWP 50R,A00,518791,Staff,8,0,20,12
1713482028040,MCWP 50R,B00,518792,Staff,7,0,20,13
1713482028040,MCWP 50R,C00,518793,Staff,7,0,20,13
1713482028040,MCWP 50R,D00,518794,Staff,2,0,20,18
1713482028040,MCWP 50R,E00,518795,Staff,3,0,20,17
1713482028040,MCWP 50R,F00,518796,Staff,13,0,20,7
1713482028040,MCWP 50R,G00,518797,Staff,13,0,20,7
1713482029069,MMW 12R,A01,514034,Herbst; Matthew,8,0,16,8
1713482029069,MMW 12R,A02,514035,Herbst; Matthew,14,0,16,2
1713482030095,MMW 13R,A01,514037,Staff,0,1,16,16
1713482030095,MMW 13R,A02,514039,Staff,0,1,16,16
1713482032145,SIO 295LS,A00,523233,Staff,15,0,30,15
1713482033172,SIO 295S,A00,523232,Staff,15,0,30,15
1713482034196,SOCI 117,A01,494376,Staff,0,2,5,5
1713482035221,WES 237B,A00,494380,Staff,19,0,20,1
1713482037296,AESE 279B,A00,494370,Wade; Jon P,33,0,33,0
1713482038323,AIP 197,001,627712,Vespa; Emanuel Ignacio,9999,0,9999,0
1713482039347,ANAR 135S,A00,494369,Braswell; Geoffrey E.,0,0,0,0
1713482040372,CAT 124RS,A01,519847,Geibel; William,6,0,20,14
1713482041396,CAT 125RS,A01,515971,Geibel; William,6,0,20,14
1713482042423,CLRE 250,A00,511389,Morris; Sheldon,9996,0,9999,3
1713482043452,CLRE 251,A00,507176,Mehta; Ravindra L.,9996,0,9999,3
1713482043452,CLRE 251,B00,511410,Mehta; Ravindra L.,9998,0,9999,1
1713482044477,CLRE 252,A00,507189,Cuomo; Raphael Eduardo,9998,0,9999,1
1713482045503,CLRE 253,A00,507199,Vaida; Florin,9997,0,9999,2
1713482045503,CLRE 253,B00,507202,Vaida; Florin,9999,0,9999,0
1713482046529,CLRE 259,A00,507211,Patel; Hemal,9996,0,9999,3
1713482047553,CLRE 260,A00,507221,Cuomo; Raphael Eduardo,9999,0,9999,0
1713482048637,CLRE 297,001,507242,Cuomo; Raphael Eduardo,9999,0,9999,0
1713482049663,CSE 191,A00,516875,Minnes Kemp; Mor Mia,9999,0,9999,0
1713482050689,CSS 201S,A01,494383,Staff,35,0,35,0
1713482051717,CSS 202S,A01,494387,Staff,35,0,35,0
1713482052743,EAP 100,A00,516065,Staff,9792,0,9999,207
1713482053769,ECE 45,A01,507414,Staff,38,0,60,22
1713482054800,ECE 100,A01,507416,Baghdadchi; Saharnaz,3,0,20,17
1713482054800,ECE 100,A02,507418,Baghdadchi; Saharnaz,19,0,20,1
1713482055829,ECE 111,A01,507420,Staff,28,0,50,22
1713482056855,ECE 197,001,548057,Sievenpiper; Daniel F.,9998,0,9999,1
1713482057881,EDS 115,A00,507243,Choi; Bailey Miyeon,27,0,28,1
1713482058907,EDS 117,A01,494379,Staff,16,0,25,9
1713482059933,EDS 125,A00,507246,Hopkins; Megan Beth,28,0,30,2
1713482060960,EDS 128A,A01,507264,Fargason; Sharon Gayle,26,0,26,0
1713482061986,EDS 128B,A01,507293,Pappas; Elizabeth,30,0,30,0
1713482063011,EDS 139,A00,507294,Fargason; Sharon Gayle,30,0,30,0
1713482063011,EDS 139,B00,507313,Pappas; Elizabeth,30,0,30,0
1713482064036,EDS 201,A00,507315,Staff,19,0,30,11
1713482065061,EDS 203,A01,507317,Halter; Christopher P.,18,0,30,12
1713482066086,EDS 204R,A01,507319,Halter; Christopher P.,0,1,30,30
1713482066086,EDS 204R,B01,507331,Heinzman; Erica M.,26,0,30,4
1713482067110,EDS 206R,A00,507332,Staff,0,1,30,30
1713482067110,EDS 206R,B00,507343,Staff,27,0,30,3
1713482068137,EDS 250,A00,507344,Hemans; Patricia Ann Benitez,28,0,40,12
1713482069163,EDS 281,A00,507345,Daly; Alan J.,18,0,18,0
1713482070192,EDS 284,A00,507350,Daly; Alan J.,16,0,16,0
1713482071222,EDS 286,A00,507359,Fine; Sarah,18,0,18,0
1713482072247,EDS 289C,A01,507361,Daly; Alan J.,18,0,18,0
1713482073273,EDS 290,A00,507366,Hofstetter; Carolyn,15,0,15,0
1713482074299,LIGM 5A,A00,507421,Fischer-Grunski; Eva K,20,0,20,0
1713482075325,LIGM 5B,A00,507423,Fischer-Grunski; Eva K,20,0,20,0
1713482076353,LIGM 5C,A00,507425,Fischer-Grunski; Eva K,20,0,20,0
1713482077382,LIIT 5AS,A00,507427,Carnelos; Chiara,20,0,20,0
1713482078414,LIIT 5BS,A00,507430,Carnelos; Chiara,20,0,20,0
1713482079440,LIIT 5CS,A00,507432,Carnelos; Chiara,20,0,20,0
1713482080464,LISP 5A,A00,507541,Munoz Sanchez; Alicia,14,0,20,6
1713482081489,LISP 5B,A00,507671,Munoz Sanchez; Alicia,12,0,20,8
1713482082516,LISP 5C,A00,507696,Munoz Sanchez; Alicia,11,0,20,9
1713482083540,MAE 197,001,528363,Boechler; Nicholas Sebastia,9998,0,9999,1
1713482084565,MATH 197,001,523477,Kedlaya; Kiran S.,9999,0,9999,0
1713482084565,MATH 197,002,563811,Zhang; Danna,9998,0,9999,1
1713482085591,MCWP 40R,A00,518780,Staff,17,0,20,3
1713482085591,MCWP 40R,B00,518781,Staff,14,0,20,6
1713482085591,MCWP 40R,C00,518783,Staff,12,0,20,8
1713482086621,MCWP 50R,A00,518791,Staff,8,0,20,12
1713482086621,MCWP 50R,B00,518792,Staff,7,0,20,13
1713482086621,MCWP 50R,C00,518793,Staff,7,0,20,13
1713482086621,MCWP 50R,D00,518794,Staff,2,0,20,18
1713482086621,MCWP 50R,E00,518795,Staff,3,0,20,17
1713482086621,MCWP 50R,F00,518796,Staff,13,0,20,7
1713482086621,MCWP 50R,G00,518797,Staff,13,0,20,7
1713482087647,MMW 12R,A01,514034,Herbst; Matthew,8,0,16,8
1713482087647,MMW 12R,A02,514035,Herbst; Matthew,14,0,16,2
1713482088673,MMW 13R,A01,514037,Staff,0,1,16,16
1713482088673,MMW 13R,A02,514039,Staff,0,1,16,16
1713482090723,SIO 295LS,A00,523233,Staff,15,0,30,15
1713482091752,SIO 295S,A00,523232,Staff,15,0,30,15
1713482092782,SOCI 117,A01,494376,Staff,0,2,5,5
1713482093808,WES 237B,A00,494380,Staff,19,0,20,1
1713482095884,AESE 279B,A00,494370,Wade; Jon P,33,0,33,0
1713482096910,AIP 197,001,627712,Vespa; Emanuel Ignacio,9999,0,9999,0
1713482097937,ANAR 135S,A00,494369,Braswell; Geoffrey E.,0,0,0,0
1713482098962,CAT 124RS,A01,519847,Geibel; William,6,0,20,14
1713482099987,CAT 125RS,A01,515971,Geibel; William,6,0,20,14
1713482101016,CLRE 250,A00,511389,Morris; Sheldon,9996,0,9999,3
1713482102041,CLRE 251,A00,507176,Mehta; Ravindra L.,9996,0,9999,3
1713482102041,CLRE 251,B00,511410,Mehta; Ravindra L.,9998,0,9999,1
1713482103069,CLRE 252,A00,507189,Cuomo; Raphael Eduardo,9998,0,9999,1
1713482104095,CLRE 253,A00,507199,Vaida; Florin,9997,0,9999,2
1713482104095,CLRE 253,B00,507202,Vaida; Florin,9999,0,9999,0
1713482105119,CLRE 259,A00,507211,Patel; Hemal,9996,0,9999,3
1713482106144,CLRE 260,A00,507221,Cuomo; Raphael Eduardo,9999,0,9999,0
1713482107169,CLRE 297,001,507242,Cuomo; Raphael Eduardo,9999,0,9999,0
1713482108194,CSE 191,A00,516875,Minnes Kemp; Mor Mia,9999,0,9999,0
1713482109220,CSS 201S,A01,494383,Staff,35,0,35,0
1713482110250,CSS 202S,A01,494387,Staff,35,0,35,0
1713482111275,EAP 100,A00,516065,Staff,9792,0,9999,207
1713482112301,ECE 45,A01,507414,Staff,38,0,60,22
1713482113330,ECE 100,A01,507416,Baghdadchi; Saharnaz,3,0,20,17
1713482113330,ECE 100,A02,507418,Baghdadchi; Saharnaz,19,0,20,1
1713482114355,ECE 111,A01,507420,Staff,28,0,50,22
1713482115386,ECE 197,001,548057,Sievenpiper; Daniel F.,9998,0,9999,1
1713482116412,EDS 115,A00,507243,Choi; Bailey Miyeon,27,0,28,1
1713482117443,EDS 117,A01,494379,Staff,16,0,25,9
1713482118468,EDS 125,A00,507246,Hopkins; Megan Beth,28,0,30,2
1713482119498,EDS 128A,A01,507264,Fargason; Sharon Gayle,26,0,26,0
1713482120527,EDS 128B,A01,507293,Pappas; Elizabeth,30,0,30,0
1713482121555,EDS 139,A00,507294,Fargason; Sharon Gayle,30,0,30,0
1713482121555,EDS 139,B00,507313,Pappas; Elizabeth,30,0,30,0
1713482122579,EDS 201,A00,507315,Staff,19,0,30,11
1713482123605,EDS 203,A01,507317,Halter; Christopher P.,18,0,30,12
1713482124632,EDS 204R,A01,507319,Halter; Christopher P.,0,1,30,30
1713482124632,EDS 204R,B01,507331,Heinzman; Erica M.,26,0,30,4
1713482125659,EDS 206R,A00,507332,Staff,0,1,30,30
1713482125659,EDS 206R,B00,507343,Staff,27,0,30,3
1713482126687,EDS 250,A00,507344,Hemans; Patricia Ann Benitez,28,0,40,12
1713482127713,EDS 281,A00,507345,Daly; Alan J.,18,0,18,0
1713482128738,EDS 284,A00,507350,Daly; Alan J.,16,0,16,0
1713482129764,EDS 286,A00,507359,Fine; Sarah,18,0,18,0
1713482130788,EDS 289C,A01,507361,Daly; Alan J.,18,0,18,0
1713482131815,EDS 290,A00,507366,Hofstetter; Carolyn,15,0,15,0
1713482132842,LIGM 5A,A00,507421,Fischer-Grunski; Eva K,20,0,20,0
1713482133870,LIGM 5B,A00,507423,Fischer-Grunski; Eva K,20,0,20,0
1713482134897,LIGM 5C,A00,507425,Fischer-Grunski; Eva K,20,0,20,0
1713482135927,LIIT 5AS,A00,507427,Carnelos; Chiara,20,0,20,0
1713482136959,LIIT 5BS,A00,507430,Carnelos; Chiara,20,0,20,0
1713482137985,LIIT 5CS,A00,507432,Carnelos; Chiara,20,0,20,0
1713482139016,LISP 5A,A00,507541,Munoz Sanchez; Alicia,14,0,20,6
1713482140042,LISP 5B,A00,507671,Munoz Sanchez; Alicia,12,0,20,8
1713482141072,LISP 5C,A00,507696,Munoz Sanchez; Alicia,11,0,20,9
1713482142098,MAE 197,001,528363,Boechler; Nicholas Sebastia,9998,0,9999,1
1713482143123,MATH 197,001,523477,Kedlaya; Kiran S.,9999,0,9999,0
1713482143123,MATH 197,002,563811,Zhang; Danna,9998,0,9999,1
1713482144146,MCWP 40R,A00,518780,Staff,17,0,20,3
1713482144146,MCWP 40R,B00,518781,Staff,14,0,20,6
1713482144146,MCWP 40R,C00,518783,Staff,12,0,20,8
1713482145177,MCWP 50R,A00,518791,Staff,8,0,20,12
1713482145177,MCWP 50R,B00,518792,Staff,7,0,20,13
1713482145177,MCWP 50R,C00,518793,Staff,7,0,20,13
1713482145177,MCWP 50R,D00,518794,Staff,2,0,20,18
1713482145177,MCWP 50R,E00,518795,Staff,3,0,20,17
1713482145177,MCWP 50R,F00,518796,Staff,13,0,20,7
1713482145177,MCWP 50R,G00,518797,Staff,13,0,20,7
1713482146202,MMW 12R,A01,514034,Herbst; Matthew,8,0,16,8
1713482146202,MMW 12R,A02,514035,Herbst; Matthew,14,0,16,2
1713482147228,MMW 13R,A01,514037,Staff,0,1,16,16
1713482147228,MMW 13R,A02,514039,Staff,0,1,16,16
1713482149278,SIO 295LS,A00,523233,Staff,15,0,30,15
1713482150306,SIO 295S,A00,523232,Staff,15,0,30,15
1713482151331,SOCI 117,A01,494376,Staff,0,2,5,5
1713482152412,WES 237B,A00,494380,Staff,19,0,20,1
1713482154483,AESE 279B,A00,494370,Wade; Jon P,33,0,33,0
1713482155507,AIP 197,001,627712,Vespa; Emanuel Ignacio,9999,0,9999,0
1713482156532,ANAR 135S,A00,494369,Braswell; Geoffrey E.,0,0,0,0
1713482157559,CAT 124RS,A01,519847,Geibel; William,6,0,20,14
1713482158587,CAT 125RS,A01,515971,Geibel; William,6,0,20,14
1713482159612,CLRE 250,A00,511389,Morris; Sheldon,9996,0,9999,3
1713482160640,CLRE 251,A00,507176,Mehta; Ravindra L.,9996,0,9999,3
1713482160640,CLRE 251,B00,511410,Mehta; Ravindra L.,9998,0,9999,1
1713482161673,CLRE 252,A00,507189,Cuomo; Raphael Eduardo,9998,0,9999,1
1713482162703,CLRE 253,A00,507199,Vaida; Florin,9997,0,9999,2
1713482162703,CLRE 253,B00,507202,Vaida; Florin,9999,0,9999,0
1713482163729,CLRE 259,A00,507211,Patel; Hemal,9996,0,9999,3
1713482164755,CLRE 260,A00,507221,Cuomo; Raphael Eduardo,9999,0,9999,0
1713482165781,CLRE 297,001,507242,Cuomo; Raphael Eduardo,9999,0,9999,0
1713482166806,CSE 191,A00,516875,Minnes Kemp; Mor Mia,9999,0,9999,0
1713482167832,CSS 201S,A01,494383,Staff,35,0,35,0
1713482168858,CSS 202S,A01,494387,Staff,35,0,35,0
1713482169887,EAP 100,A00,516065,Staff,9792,0,9999,207
1713482170912,ECE 45,A01,507414,Staff,38,0,60,22
1713482171942,ECE 100,A01,507416,Baghdadchi; Saharnaz,3,0,20,17
1713482171942,ECE 100,A02,507418,Baghdadchi; Saharnaz,19,0,20,1
1713482172970,ECE 111,A01,507420,Staff,28,0,50,22
1713482173998,ECE 197,001,548057,Sievenpiper; Daniel F.,9998,0,9999,1
1713482175027,EDS 115,A00,507243,Choi; Bailey Miyeon,27,0,28,1
1713482176053,EDS 117,A01,494379,Staff,16,0,25,9
1713482177083,EDS 125,A00,507246,Hopkins; Megan Beth,28,0,30,2
1713482178108,EDS 128A,A01,507264,Fargason; Sharon Gayle,26,0,26,0
1713482179137,EDS 128B,A01,507293,Pappas; Elizabeth,30,0,30,0
1713482180162,EDS 139,A00,507294,Fargason; Sharon Gayle,30,0,30,0
1713482180162,EDS 139,B00,507313,Pappas; Elizabeth,30,0,30,0
1713482181187,EDS 201,A00,507315,Staff,19,0,30,11
1713482182212,EDS 203,A01,507317,Halter; Christopher P.,18,0,30,12
1713482183238,EDS 204R,A01,507319,Halter; Christopher P.,0,1,30,30
1713482183238,EDS 204R,B01,507331,Heinzman; Erica M.,26,0,30,4
1713482184262,EDS 206R,A00,507332,Staff,0,1,30,30
1713482184262,EDS 206R,B00,507343,Staff,27,0,30,3
1713482185291,EDS 250,A00,507344,Hemans; Patricia Ann Benitez,28,0,40,12
1713482186316,EDS 281,A00,507345,Daly; Alan J.,18,0,18,0
1713482187341,EDS 284,A00,507350,Daly; Alan J.,16,0,16,0
1713482188368,EDS 286,A00,507359,Fine; Sarah,18,0,18,0
1713482189394,EDS 289C,A01,507361,Daly; Alan J.,18,0,18,0
1713482190419,EDS 290,A00,507366,Hofstetter; Carolyn,15,0,15,0
1713482191444,LIGM 5A,A00,507421,Fischer-Grunski; Eva K,20,0,20,0
1713482192470,LIGM 5B,A00,507423,Fischer-Grunski; Eva K,20,0,20,0
1713482193500,LIGM 5C,A00,507425,Fischer-Grunski; Eva K,20,0,20,0
1713482194528,LIIT 5AS,A00,507427,Carnelos; Chiara,20,0,20,0
1713482195553,LIIT 5BS,A00,507430,Carnelos; Chiara,20,0,20,0
1713482196577,LIIT 5CS,A00,507432,Carnelos; Chiara,20,0,20,0
1713482197605,LISP 5A,A00,507541,Munoz Sanchez; Alicia,14,0,20,6
1713482198632,LISP 5B,A00,507671,Munoz Sanchez; Alicia,12,0,20,8
1713482199660,LISP 5C,A00,507696,Munoz Sanchez; Alicia,11,0,20,9
1713482200685,MAE 197,001,528363,Boechler; Nicholas Sebastia,9998,0,9999,1
1713482201711,MATH 197,001,523477,Kedlaya; Kiran S.,9999,0,9999,0
1713482201711,MATH 197,002,563811,Zhang; Danna,9998,0,9999,1
1713482202736,MCWP 40R,A00,518780,Staff,17,0,20,3
1713482202736,MCWP 40R,B00,518781,Staff,14,0,20,6
1713482202736,MCWP 40R,C00,518783,Staff,12,0,20,8
1713482203766,MCWP 50R,A00,518791,Staff,8,0,20,12
1713482203766,MCWP 50R,B00,518792,Staff,7,0,20,13
1713482203766,MCWP 50R,C00,518793,Staff,7,0,20,13
1713482203766,MCWP 50R,D00,518794,Staff,2,0,20,18
1713482203766,MCWP 50R,E00,518795,Staff,3,0,20,17
1713482203766,MCWP 50R,F00,518796,Staff,13,0,20,7
1713482203766,MCWP 50R,G00,518797,Staff,13,0,20,7
1713482204792,MMW 12R,A01,514034,Herbst; Matthew,8,0,16,8
1713482204792,MMW 12R,A02,514035,Herbst; Matthew,14,0,16,2
1713482205817,MMW 13R,A01,514037,Staff,0,1,16,16
1713482205817,MMW 13R,A02,514039,Staff,0,1,16,16
1713482207869,SIO 295LS,A00,523233,Staff,15,0,30,15
1713482208894,SIO 295S,A00,523232,Staff,15,0,30,15
1713482209923,SOCI 117,A01,494376,Staff,0,2,5,5
1713482210953,WES 237B,A00,494380,Staff,19,0,20,1
1713482213036,AESE 279B,A00,494370,Wade; Jon P,33,0,33,0
1713482214066,AIP 197,001,627712,Vespa; Emanuel Ignacio,9999,0,9999,0
1713482215092,ANAR 135S,A00,494369,Braswell; Geoffrey E.,0,0,0,0
1713482216118,CAT 124RS,A01,519847,Geibel; William,6,0,20,14
1713482217142,CAT 125RS,A01,515971,Geibel; William,6,0,20,14
1713482218170,CLRE 250,A00,511389,Morris; Sheldon,9996,0,9999,3
1713482219198,CLRE 251,A00,507176,Mehta; Ravindra L.,9996,0,9999,3
1713482219198,CLRE 251,B00,511410,Mehta; Ravindra L.,9998,0,9999,1
1713482220224,CLRE 252,A00,507189,Cuomo; Raphael Eduardo,9998,0,9999,1
1713482221254,CLRE 253,A00,507199,Vaida; Florin,9997,0,9999,2
1713482221254,CLRE 253,B00,507202,Vaida; Florin,9999,0,9999,0
1713482222279,CLRE 259,A00,507211,Patel; Hemal,9996,0,9999,3
1713482223302,CLRE 260,A00,507221,Cuomo; Raphael Eduardo,9999,0,9999,0
1713482224328,CLRE 297,001,507242,Cuomo; Raphael Eduardo,9999,0,9999,0
1713482225353,CSE 191,A00,516875,Minnes Kemp; Mor Mia,9999,0,9999,0
1713482226379,CSS 201S,A01,494383,Staff,35,0,35,0
1713482227406,CSS 202S,A01,494387,Staff,35,0,35,0
1713482228432,EAP 100,A00,516065,Staff,9792,0,9999,207
1713482229458,ECE 45,A01,507414,Staff,38,0,60,22
1713482230487,ECE 100,A01,507416,Baghdadchi; Saharnaz,3,0,20,17
1713482230487,ECE 100,A02,507418,Baghdadchi; Saharnaz,19,0,20,1
1713482231512,ECE 111,A01,507420,Staff,28,0,50,22
1713482232542,ECE 197,001,548057,Sievenpiper; Daniel F.,9998,0,9999,1
1713482233571,EDS 115,A00,507243,Choi; Bailey Miyeon,27,0,28,1
1713482234595,EDS 117,A01,494379,Staff,16,0,25,9
1713482235620,EDS 125,A00,507246,Hopkins; Megan Beth,28,0,30,2
1713482236645,EDS 128A,A01,507264,Fargason; Sharon Gayle,26,0,26,0
1713482237675,EDS 128B,A01,507293,Pappas; Elizabeth,30,0,30,0
1713482238704,EDS 139,A00,507294,Fargason; Sharon Gayle,30,0,30,0
1713482238704,EDS 139,B00,507313,Pappas; Elizabeth,30,0,30,0
1713482239728,EDS 201,A00,507315,Staff,19,0,30,11
1713482240758,EDS 203,A01,507317,Halter; Christopher P.,18,0,30,12
1713482241787,EDS 204R,A01,507319,Halter; Christopher P.,0,1,30,30
1713482241787,EDS 204R,B01,507331,Heinzman; Erica M.,26,0,30,4
1713482242811,EDS 206R,A00,507332,Staff,0,1,30,30
1713482242811,EDS 206R,B00,507343,Staff,27,0,30,3
1713482243842,EDS 250,A00,507344,Hemans; Patricia Ann Benitez,28,0,40,12
1713482244867,EDS 281,A00,507345,Daly; Alan J.,18,0,18,0
1713482245895,EDS 284,A00,507350,Daly; Alan J.,16,0,16,0
1713482246920,EDS 286,A00,507359,Fine; Sarah,18,0,18,0
1713482247943,EDS 289C,A01,507361,Daly; Alan J.,18,0,18,0
1713482248971,EDS 290,A00,507366,Hofstetter; Carolyn,15,0,15,0
1713482250001,LIGM 5A,A00,507421,Fischer-Grunski; Eva K,20,0,20,0
1713482251030,LIGM 5B,A00,507423,Fischer-Grunski; Eva K,20,0,20,0
1713482252055,LIGM 5C,A00,507425,Fischer-Grunski; Eva K,20,0,20,0
1713482253080,LIIT 5AS,A00,507427,Carnelos; Chiara,20,0,20,0
1713482254103,LIIT 5BS,A00,507430,Carnelos; Chiara,20,0,20,0
1713482255129,LIIT 5CS,A00,507432,Carnelos; Chiara,20,0,20,0
1713482256208,LISP 5A,A00,507541,Munoz Sanchez; Alicia,14,0,20,6
1713482257237,LISP 5B,A00,507671,Munoz Sanchez; Alicia,12,0,20,8
1713482258267,LISP 5C,A00,507696,Munoz Sanchez; Alicia,11,0,20,9
1713482259292,MAE 197,001,528363,Boechler; Nicholas Sebastia,9998,0,9999,1
1713482260318,MATH 197,001,523477,Kedlaya; Kiran S.,9999,0,9999,0
1713482260318,MATH 197,002,563811,Zhang; Danna,9998,0,9999,1
1713482261348,MCWP 40R,A00,518780,Staff,17,0,20,3
1713482261348,MCWP 40R,B00,518781,Staff,14,0,20,6
1713482261348,MCWP 40R,C00,518783,Staff,12,0,20,8
1713482262374,MCWP 50R,A00,518791,Staff,8,0,20,12
1713482262374,MCWP 50R,B00,518792,Staff,7,0,20,13
1713482262374,MCWP 50R,C00,518793,Staff,7,0,20,13
1713482262374,MCWP 50R,D00,518794,Staff,2,0,20,18
1713482262374,MCWP 50R,E00,518795,Staff,3,0,20,17
1713482262374,MCWP 50R,F00,518796,Staff,13,0,20,7
1713482262374,MCWP 50R,G00,518797,Staff,13,0,20,7
1713482263402,MMW 12R,A01,514034,Herbst; Matthew,8,0,16,8
1713482263402,MMW 12R,A02,514035,Herbst; Matthew,14,0,16,2
1713482264428,MMW 13R,A01,514037,Staff,0,1,16,16
1713482264428,MMW 13R,A02,514039,Staff,0,1,16,16
1713482266476,SIO 295LS,A00,523233,Staff,15,0,30,15
1713482267501,SIO 295S,A00,523232,Staff,15,0,30,15
1713482268545,SOCI 117,A01,494376,Staff,0,2,5,5
1713482269571,WES 237B,A00,494380,Staff,19,0,20,1
1713482271644,AESE 279B,A00,494370,Wade; Jon P,33,0,33,0
1713482272669,AIP 197,001,627712,Vespa; Emanuel Ignacio,9999,0,9999,0
1713482273697,ANAR 135S,A00,494369,Braswell; Geoffrey E.,0,0,0,0
1713482274722,CAT 124RS,A01,519847,Geibel; William,6,0,20,14
1713482275751,CAT 125RS,A01,515971,Geibel; William,6,0,20,14
1713482276781,CLRE 250,A00,511389,Morris; Sheldon,9996,0,9999,3
1713482277807,CLRE 251,A00,507176,Mehta; Ravindra L.,9996,0,9999,3
1713482277807,CLRE 251,B00,511410,Mehta; Ravindra L.,9998,0,9999,1
1713482278834,CLRE 252,A00,507189,Cuomo; Raphael Eduardo,9998,0,9999,1
1713482279860,CLRE 253,A00,507199,Vaida; Florin,9997,0,9999,2
1713482279860,CLRE 253,B00,507202,Vaida; Florin,9999,0,9999,0
1713482280885,CLRE 259,A00,507211,Patel; Hemal,9996,0,9999,3
1713482281911,CLRE 260,A00,507221,Cuomo; Raphael Eduardo,9999,0,9999,0
1713482282937,CLRE 297,001,507242,Cuomo; Raphael Eduardo,9999,0,9999,0
1713482283961,CSE 191,A00,516875,Minnes Kemp; Mor Mia,9999,0,9999,0
1713482284987,CSS 201S,A01,494383,Staff,35,0,35,0
1713482286011,CSS 202S,A01,494387,Staff,35,0,35,0
1713482287036,EAP 100,A00,516065,Staff,9792,0,9999,207
1713482288062,ECE 45,A01,507414,Staff,38,0,60,22
1713482289091,ECE 100,A01,507416,Baghdadchi; Saharnaz,3,0,20,17
1713482289091,ECE 100,A02,507418,Baghdadchi; Saharnaz,19,0,20,1
1713482290116,ECE 111,A01,507420,Staff,28,0,50,22
1713482291140,ECE 197,001,548057,Sievenpiper; Daniel F.,9998,0,9999,1
1713482292167,EDS 115,A00,507243,Choi; Bailey Miyeon,27,0,28,1
1713482293193,EDS 117,A01,494379,Staff,16,0,25,9
1713482294218,EDS 125,A00,507246,Hopkins; Megan Beth,28,0,30,2
1713482295247,EDS 128A,A01,507264,Fargason; Sharon Gayle,26,0,26,0
1713482296274,EDS 128B,A01,507293,Pappas; Elizabeth,30,0,30,0
1713482297299,EDS 139,A00,507294,Fargason; Sharon Gayle,30,0,30,0
1713482297299,EDS 139,B00,507313,Pappas; Elizabeth,30,0,30,0
1713482298327,EDS 201,A00,507315,Staff,19,0,30,11
1713482299351,EDS 203,A01,507317,Halter; Christopher P.,18,0,30,12
1713482300376,EDS 204R,A01,507319,Halter; Christopher P.,0,1,30,30
1713482300376,EDS 204R,B01,507331,Heinzman; Erica M.,26,0,30,4
1713482301401,EDS 206R,A00,507332,Staff,0,1,30,30
1713482301401,EDS 206R,B00,507343,Staff,27,0,30,3
1713482302426,EDS 250,A00,507344,Hemans; Patricia Ann Benitez,28,0,40,12
1713482303452,EDS 281,A00,507345,Daly; Alan J.,18,0,18,0
1713482304473,EDS 284,A00,507350,Daly; Alan J.,16,0,16,0
1713482305497,EDS 286,A00,507359,Fine; Sarah,18,0,18,0
1713482306523,EDS 289C,A01,507361,Daly; Alan J.,18,0,18,0
1713482307548,EDS 290,A00,507366,Hofstetter; Carolyn,15,0,15,0
1713482308598,LIGM 5A,A00,507421,Fischer-Grunski; Eva K,20,0,20,0
1713482309626,LIGM 5B,A00,507423,Fischer-Grunski; Eva K,20,0,20,0
1713482310653,LIGM 5C,A00,507425,Fischer-Grunski; Eva K,20,0,20,0
1713482311678,LIIT 5AS,A00,507427,Carnelos; Chiara,20,0,20,0
1713482312704,LIIT 5BS,A00,507430,Carnelos; Chiara,20,0,20,0
1713482313730,LIIT 5CS,A00,507432,Carnelos; Chiara,20,0,20,0
1713482314756,LISP 5A,A00,507541,Munoz Sanchez; Alicia,14,0,20,6
1713482315783,LISP 5B,A00,507671,Munoz Sanchez; Alicia,12,0,20,8
1713482316813,LISP 5C,A00,507696,Munoz Sanchez; Alicia,11,0,20,9
1713482317838,MAE 197,001,528363,Boechler; Nicholas Sebastia,9998,0,9999,1
1713482318864,MATH 197,001,523477,Kedlaya; Kiran S.,9999,0,9999,0
1713482318864,MATH 197,002,563811,Zhang; Danna,9998,0,9999,1
1713482319897,MCWP 40R,A00,518780,Staff,17,0,20,3
1713482319897,MCWP 40R,B00,518781,Staff,14,0,20,6
1713482319897,MCWP 40R,C00,518783,Staff,12,0,20,8
1713482320925,MCWP 50R,A00,518791,Staff,8,0,20,12
1713482320925,MCWP 50R,B00,518792,Staff,7,0,20,13
1713482320925,MCWP 50R,C00,518793,Staff,7,0,20,13
1713482320925,MCWP 50R,D00,518794,Staff,2,0,20,18
1713482320925,MCWP 50R,E00,518795,Staff,3,0,20,17
1713482320925,MCWP 50R,F00,518796,Staff,13,0,20,7
1713482320925,MCWP 50R,G00,518797,Staff,13,0,20,7
1713482321950,MMW 12R,A01,514034,Herbst; Matthew,8,0,16,8
1713482321950,MMW 12R,A02,514035,Herbst; Matthew,14,0,16,2
1713482322979,MMW 13R,A01,514037,Staff,0,1,16,16
1713482322979,MMW 13R,A02,514039,Staff,0,1,16,16
1713482325032,SIO 295LS,A00,523233,Staff,15,0,30,15
1713482326057,SIO 295S,A00,523232,Staff,15,0,30,15
1713482327083,SOCI 117,A01,494376,Staff,0,2,5,5
1713482328110,WES 237B,A00,494380,Staff,19,0,20,1
1713482330178,AESE 279B,A00,494370,Wade; Jon P,33,0,33,0
1713482331203,AIP 197,001,627712,Vespa; Emanuel Ignacio,9999,0,9999,0
1713482332232,ANAR 135S,A00,494369,Braswell; Geoffrey E.,0,0,0,0
1713482333262,CAT 124RS,A01,519847,Geibel; William,6,0,20,14
1713482334290,CAT 125RS,A01,515971,Geibel; William,6,0,20,14
1713482335316,CLRE 250,A00,511389,Morris; Sheldon,9996,0,9999,3
1713482336342,CLRE 251,A00,507176,Mehta; Ravindra L.,9996,0,9999,3
1713482336342,CLRE 251,B00,511410,Mehta; Ravindra L.,9998,0,9999,1
1713482337371,CLRE 252,A00,507189,Cuomo; Raphael Eduardo,9998,0,9999,1
1713482338399,CLRE 253,A00,507199,Vaida; Florin,9997,0,9999,2
1713482338399,CLRE 253,B00,507202,Vaida; Florin,9999,0,9999,0
1713482339428,CLRE 259,A00,507211,Patel; Hemal,9996,0,9999,3
1713482340455,CLRE 260,A00,507221,Cuomo; Raphael Eduardo,9999,0,9999,0
1713482341481,CLRE 297,001,507242,Cuomo; Raphael Eduardo,9999,0,9999,0
1713482342506,CSE 191,A00,516875,Minnes Kemp; Mor Mia,9999,0,9999,0
1713482343531,CSS 201S,A01,494383,Staff,35,0,35,0
1713482344556,CSS 202S,A01,494387,Staff,35,0,35,0
1713482345583,EAP 100,A00,516065,Staff,9792,0,9999,207
1713482346608,ECE 45,A01,507414,Staff,38,0,60,22
1713482347640,ECE 100,A01,507416,Baghdadchi; Saharnaz,3,0,20,17
1713482347640,ECE 100,A02,507418,Baghdadchi; Saharnaz,19,0,20,1
1713482348665,ECE 111,A01,507420,Staff,28,0,50,22
1713482349696,ECE 197,001,548057,Sievenpiper; Daniel F.,9998,0,9999,1
1713482350723,EDS 115,A00,507243,Choi; Bailey Miyeon,27,0,28,1
1713482351749,EDS 117,A01,494379,Staff,16,0,25,9
1713482352776,EDS 125,A00,507246,Hopkins; Megan Beth,28,0,30,2
1713482353803,EDS 128A,A01,507264,Fargason; Sharon Gayle,26,0,26,0
1713482354831,EDS 128B,A01,507293,Pappas; Elizabeth,30,0,30,0
1713482355856,EDS 139,A00,507294,Fargason; Sharon Gayle,30,0,30,0
1713482355856,EDS 139,B00,507313,Pappas; Elizabeth,30,0,30,0
1713482356882,EDS 201,A00,507315,Staff,19,0,30,11
1713482357909,EDS 203,A01,507317,Halter; Christopher P.,18,0,30,12
1713482358936,EDS 204R,A01,507319,Halter; Christopher P.,0,1,30,30
1713482358936,EDS 204R,B01,507331,Heinzman; Erica M.,26,0,30,4
1713482360017,EDS 206R,A00,507332,Staff,0,1,30,30
1713482360017,EDS 206R,B00,507343,Staff,27,0,30,3
1713482361047,EDS 250,A00,507344,Hemans; Patricia Ann Benitez,28,0,40,12
1713482362072,EDS 281,A00,507345,Daly; Alan J.,18,0,18,0
1713482363095,EDS 284,A00,507350,Daly; Alan J.,16,0,16,0
1713482364119,EDS 286,A00,507359,Fine; Sarah,18,0,18,0
1713482365149,EDS 289C,A01,507361,Daly; Alan J.,18,0,18,0
1713482366179,EDS 290,A00,507366,Hofstetter; Carolyn,15,0,15,0
1713482367206,LIGM 5A,A00,507421,Fischer-Grunski; Eva K,20,0,20,0
1713482368236,LIGM 5B,A00,507423,Fischer-Grunski; Eva K,20,0,20,0
1713482369265,LIGM 5C,A00,507425,Fischer-Grunski; Eva K,20,0,20,0
1713482370292,LIIT 5AS,A00,507427,Carnelos; Chiara,20,0,20,0
1713482371318,LIIT 5BS,A00,507430,Carnelos; Chiara,20,0,20,0
1713482372342,LIIT 5CS,A00,507432,Carnelos; Chiara,20,0,20,0
1713482373366,LISP 5A,A00,507541,Munoz Sanchez; Alicia,14,0,20,6
1713482374393,LISP 5B,A00,507671,Munoz Sanchez; Alicia,12,0,20,8
1713482375421,LISP 5C,A00,507696,Munoz Sanchez; Alicia,11,0,20,9
1713482376446,MAE 197,001,528363,Boechler; Nicholas Sebastia,9998,0,9999,1
1713482377474,MATH 197,001,523477,Kedlaya; Kiran S.,9999,0,9999,0
1713482377474,MATH 197,002,563811,Zhang; Danna,9998,0,9999,1
1713482378501,MCWP 40R,A00,518780,Staff,17,0,20,3
1713482378501,MCWP 40R,B00,518781,Staff,14,0,20,6
1713482378501,MCWP 40R,C00,518783,Staff,11,0,20,9
1713482379527,MCWP 50R,A00,518791,Staff,8,0,20,12
1713482379527,MCWP 50R,B00,518792,Staff,7,0,20,13
1713482379527,MCWP 50R,C00,518793,Staff,7,0,20,13
1713482379527,MCWP 50R,D00,518794,Staff,2,0,20,18
1713482379527,MCWP 50R,E00,518795,Staff,3,0,20,17
1713482379527,MCWP 50R,F00,518796,Staff,13,0,20,7
1713482379527,MCWP 50R,G00,518797,Staff,13,0,20,7
1713482380552,MMW 12R,A01,514034,Herbst; Matthew,8,0,16,8
1713482380552,MMW 12R,A02,514035,Herbst; Matthew,14,0,16,2
1713482381577,MMW 13R,A01,514037,Staff,0,1,16,16
1713482381577,MMW 13R,A02,514039,Staff,0,1,16,16
1713482383630,SIO 295LS,A00,523233,Staff,15,0,30,15
1713482384659,SIO 295S,A00,523232,Staff,15,0,30,15
1713482385687,SOCI 117,A01,494376,Staff,0,2,5,5
1713482386711,WES 237B,A00,494380,Staff,19,0,20,1
1713482388778,AESE 279B,A00,494370,Wade; Jon P,33,0,33,0
1713482389803,AIP 197,001,627712,Vespa; Emanuel Ignacio,9999,0,9999,0
1713482390827,ANAR 135S,A00,494369,Braswell; Geoffrey E.,0,0,0,0
1713482391856,CAT 124RS,A01,519847,Geibel; William,6,0,20,14
1713482392883,CAT 125RS,A01,515971,Geibel; William,6,0,20,14
1713482393909,CLRE 250,A00,511389,Morris; Sheldon,9996,0,9999,3
1713482394934,CLRE 251,A00,507176,Mehta; Ravindra L.,9996,0,9999,3
1713482394934,CLRE 251,B00,511410,Mehta; Ravindra L.,9998,0,9999,1
1713482395965,CLRE 252,A00,507189,Cuomo; Raphael Eduardo,9998,0,9999,1
1713482396990,CLRE 253,A00,507199,Vaida; Florin,9997,0,9999,2
1713482396990,CLRE 253,B00,507202,Vaida; Florin,9999,0,9999,0
1713482398016,CLRE 259,A00,507211,Patel; Hemal,9996,0,9999,3
1713482399043,CLRE 260,A00,507221,Cuomo; Raphael Eduardo,9999,0,9999,0
1713482400076,CLRE 297,001,507242,Cuomo; Raphael Eduardo,9999,0,9999,0
1713482401100,CSE 191,A00,516875,Minnes Kemp; Mor Mia,9999,0,9999,0
1713482402126,CSS 201S,A01,494383,Staff,35,0,35,0
1713482403151,CSS 202S,A01,494387,Staff,35,0,35,0
1713482404175,EAP 100,A00,516065,Staff,9792,0,9999,207
1713482405199,ECE 45,A01,507414,Staff,38,0,60,22
1713482406224,ECE 100,A01,507416,Baghdadchi; Saharnaz,3,0,20,17
1713482406224,ECE 100,A02,507418,Baghdadchi; Saharnaz,19,0,20,1
1713482407252,ECE 111,A01,507420,Staff,28,0,50,22
1713482408282,ECE 197,001,548057,Sievenpiper; Daniel F.,9998,0,9999,1
1713482409314,EDS 115,A00,507243,Choi; Bailey Miyeon,27,0,28,1
1713482410340,EDS 117,A01,494379,Staff,16,0,25,9
1713482411366,EDS 125,A00,507246,Hopkins; Megan Beth,28,0,30,2
1713482412394,EDS 128A,A01,507264,Fargason; Sharon Gayle,26,0,26,0
1713482413423,EDS 128B,A01,507293,Pappas; Elizabeth,30,0,30,0
1713482414450,EDS 139,A00,507294,Fargason; Sharon Gayle,30,0,30,0
1713482414450,EDS 139,B00,507313,Pappas; Elizabeth,30,0,30,0
1713482415480,EDS 201,A00,507315,Staff,19,0,30,11
1713482416506,EDS 203,A01,507317,Halter; Christopher P.,18,0,30,12
1713482417531,EDS 204R,A01,507319,Halter; Christopher P.,0,1,30,30
1713482417531,EDS 204R,B01,507331,Heinzman; Erica M.,26,0,30,4
1713482418556,EDS 206R,A00,507332,Staff,0,1,30,30
1713482418556,EDS 206R,B00,507343,Staff,27,0,30,3
1713482419582,EDS 250,A00,507344,Hemans; Patricia Ann Benitez,28,0,40,12
1713482420607,EDS 281,A00,507345,Daly; Alan J.,18,0,18,0
1713482421634,EDS 284,A00,507350,Daly; Alan J.,16,0,16,0
1713482422659,EDS 286,A00,507359,Fine; Sarah,18,0,18,0
1713482423682,EDS 289C,A01,507361,Daly; Alan J.,18,0,18,0
1713482424709,EDS 290,A00,507366,Hofstetter; Carolyn,15,0,15,0
1713482425738,LIGM 5A,A00,507421,Fischer-Grunski; Eva K,20,0,20,0
1713482426768,LIGM 5B,A00,507423,Fischer-Grunski; Eva K,20,0,20,0
1713482427793,LIGM 5C,A00,507425,Fischer-Grunski; Eva K,20,0,20,0
1713482428822,LIIT 5AS,A00,507427,Carnelos; Chiara,20,0,20,0
1713482429851,LIIT 5BS,A00,507430,Carnelos; Chiara,20,0,20,0
1713482430877,LIIT 5CS,A00,507432,Carnelos; Chiara,20,0,20,0
1713482431906,LISP 5A,A00,507541,Munoz Sanchez; Alicia,14,0,20,6
1713482432932,LISP 5B,A00,507671,Munoz Sanchez; Alicia,12,0,20,8
1713482433958,LISP 5C,A00,507696,Munoz Sanchez; Alicia,11,0,20,9
1713482434988,MAE 197,001,528363,Boechler; Nicholas Sebastia,9998,0,9999,1
1713482436014,MATH 197,001,523477,Kedlaya; Kiran S.,9999,0,9999,0
1713482436014,MATH 197,002,563811,Zhang; Danna,9998,0,9999,1
1713482437040,MCWP 40R,A00,518780,Staff,17,0,20,3
1713482437040,MCWP 40R,B00,518781,Staff,14,0,20,6
1713482437040,MCWP 40R,C00,518783,Staff,11,0,20,9
1713482438068,MCWP 50R,A00,518791,Staff,8,0,20,12
1713482438068,MCWP 50R,B00,518792,Staff,7,0,20,13
1713482438068,MCWP 50R,C00,518793,Staff,7,0,20,13
1713482438068,MCWP 50R,D00,518794,Staff,2,0,20,18
1713482438068,MCWP 50R,E00,518795,Staff,3,0,20,17
1713482438068,MCWP 50R,F00,518796,Staff,13,0,20,7
1713482438068,MCWP 50R,G00,518797,Staff,13,0,20,7
1713482439094,MMW 12R,A01,514034,Herbst; Matthew,8,0,16,8
1713482439094,MMW 12R,A02,514035,Herbst; Matthew,14,0,16,2
1713482440119,MMW 13R,A01,514037,Staff,0,1,16,16
1713482440119,MMW 13R,A02,514039,Staff,0,1,16,16
1713482442171,SIO 295LS,A00,523233,Staff,15,0,30,15
1713482443196,SIO 295S,A00,523232,Staff,15,0,30,15
1713482444224,SOCI 117,A01,494376,Staff,0,2,5,5
1713482445249,WES 237B,A00,494380,Staff,19,0,20,1
1713482447326,AESE 279B,A00,494370,Wade; Jon P,33,0,33,0
1713482448355,AIP 197,001,627712,Vespa; Emanuel Ignacio,9999,0,9999,0
1713482449383,ANAR 135S,A00,494369,Braswell; Geoffrey E.,0,0,0,0
1713482450408,CAT 124RS,A01,519847,Geibel; William,6,0,20,14
1713482451439,CAT 125RS,A01,515971,Geibel; William,6,0,20,14
1713482452468,CLRE 250,A00,511389,Morris; Sheldon,9996,0,9999,3
1713482453495,CLRE 251,A00,507176,Mehta; Ravindra L.,9996,0,9999,3
1713482453495,CLRE 251,B00,511410,Mehta; Ravindra L.,9998,0,9999,1
1713482454523,CLRE 252,A00,507189,Cuomo; Raphael Eduardo,9998,0,9999,1
1713482455551,CLRE 253,A00,507199,Vaida; Florin,9997,0,9999,2
1713482455551,CLRE 253,B00,507202,Vaida; Florin,9999,0,9999,0
1713482456577,CLRE 259,A00,507211,Patel; Hemal,9996,0,9999,3
1713482457604,CLRE 260,A00,507221,Cuomo; Raphael Eduardo,9999,0,9999,0
1713482458629,CLRE 297,001,507242,Cuomo; Raphael Eduardo,9999,0,9999,0
1713482459654,CSE 191,A00,516875,Minnes Kemp; Mor Mia,9999,0,9999,0
1713482460686,CSS 201S,A01,494383,Staff,35,0,35,0
1713482461714,CSS 202S,A01,494387,Staff,35,0,35,0
1713482462738,EAP 100,A00,516065,Staff,9792,0,9999,207
1713482463820,ECE 45,A01,507414,Staff,38,0,60,22
1713482464850,ECE 100,A01,507416,Baghdadchi; Saharnaz,3,0,20,17
1713482464850,ECE 100,A02,507418,Baghdadchi; Saharnaz,19,0,20,1
1713482465876,ECE 111,A01,507420,Staff,28,0,50,22
1713482466905,ECE 197,001,548057,Sievenpiper; Daniel F.,9998,0,9999,1
1713482467930,EDS 115,A00,507243,Choi; Bailey Miyeon,27,0,28,1
1713482468964,EDS 117,A01,494379,Staff,16,0,25,9
1713482469989,EDS 125,A00,507246,Hopkins; Megan Beth,28,0,30,2
1713482471013,EDS 128A,A01,507264,Fargason; Sharon Gayle,26,0,26,0
1713482472042,EDS 128B,A01,507293,Pappas; Elizabeth,30,0,30,0
1713482473066,EDS 139,A00,507294,Fargason; Sharon Gayle,30,0,30,0
1713482473066,EDS 139,B00,507313,Pappas; Elizabeth,30,0,30,0
1713482474090,EDS 201,A00,507315,Staff,19,0,30,11
1713482475126,EDS 203,A01,507317,Halter; Christopher P.,18,0,30,12
1713482476152,EDS 204R,A01,507319,Halter; Christopher P.,0,1,30,30
1713482476152,EDS 204R,B01,507331,Heinzman; Erica M.,26,0,30,4
1713482477178,EDS 206R,A00,507332,Staff,0,1,30,30
1713482477178,EDS 206R,B00,507343,Staff,27,0,30,3
1713482478202,EDS 250,A00,507344,Hemans; Patricia Ann Benitez,28,0,40,12
1713482479229,EDS 281,A00,507345,Daly; Alan J.,18,0,18,0
1713482480254,EDS 284,A00,507350,Daly; Alan J.,16,0,16,0
1713482481280,EDS 286,A00,507359,Fine; Sarah,18,0,18,0
1713482482304,EDS 289C,A01,507361,Daly; Alan J.,18,0,18,0
1713482483333,EDS 290,A00,507366,Hofstetter; Carolyn,15,0,15,0
1713482484359,LIGM 5A,A00,507421,Fischer-Grunski; Eva K,20,0,20,0
1713482485387,LIGM 5B,A00,507423,Fischer-Grunski; Eva K,20,0,20,0
1713482486416,LIGM 5C,A00,507425,Fischer-Grunski; Eva K,20,0,20,0
1713482487441,LIIT 5AS,A00,507427,Carnelos; Chiara,20,0,20,0
1713482488470,LIIT 5BS,A00,507430,Carnelos; Chiara,20,0,20,0
1713482489495,LIIT 5CS,A00,507432,Carnelos; Chiara,20,0,20,0
1713482490522,LISP 5A,A00,507541,Munoz Sanchez; Alicia,14,0,20,6
1713482491551,LISP 5B,A00,507671,Munoz Sanchez; Alicia,12,0,20,8
1713482492578,LISP 5C,A00,507696,Munoz Sanchez; Alicia,11,0,20,9
1713482493608,MAE 197,001,528363,Boechler; Nicholas Sebastia,9998,0,9999,1
1713482494638,MATH 197,001,523477,Kedlaya; Kiran S.,9999,0,9999,0
1713482494638,MATH 197,002,563811,Zhang; Danna,9998,0,9999,1
1713482495663,MCWP 40R,A00,518780,Staff,17,0,20,3
1713482495663,MCWP 40R,B00,518781,Staff,14,0,20,6
1713482495663,MCWP 40R,C00,518783,Staff,11,0,20,9
1713482496689,MCWP 50R,A00,518791,Staff,8,0,20,12
1713482496689,MCWP 50R,B00,518792,Staff,7,0,20,13
1713482496689,MCWP 50R,C00,518793,Staff,7,0,20,13
1713482496689,MCWP 50R,D00,518794,Staff,2,0,20,18
1713482496689,MCWP 50R,E00,518795,Staff,3,0,20,17
1713482496689,MCWP 50R,F00,518796,Staff,13,0,20,7
1713482496689,MCWP 50R,G00,518797,Staff,12,0,20,8
1713482497714,MMW 12R,A01,514034,Herbst; Matthew,8,0,16,8
1713482497714,MMW 12R,A02,514035,Herbst; Matthew,14,0,16,2
1713482498743,MMW 13R,A01,514037,Staff,0,1,16,16
1713482498743,MMW 13R,A02,514039,Staff,0,1,16,16
1713482500799,SIO 295LS,A00,523233,Staff,15,0,30,15
1713482501824,SIO 295S,A00,523232,Staff,15,0,30,15
1713482502848,SOCI 117,A01,494376,Staff,0,2,5,5
1713482503875,WES 237B,A00,494380,Staff,19,0,20,1
1713482505941,AESE 279B,A00,494370,Wade; Jon P,33,0,33,0
1713482506966,AIP 197,001,627712,Vespa; Emanuel Ignacio,9999,0,9999,0
1713482507993,ANAR 135S,A00,494369,Braswell; Geoffrey E.,0,0,0,0
1713482509019,CAT 124RS,A01,519847,Geibel; William,6,0,20,14
1713482510047,CAT 125RS,A01,515971,Geibel; William,6,0,20,14
1713482511073,CLRE 250,A00,511389,Morris; Sheldon,9996,0,9999,3
1713482512100,CLRE 251,A00,507176,Mehta; Ravindra L.,9996,0,9999,3
1713482512100,CLRE 251,B00,511410,Mehta; Ravindra L.,9998,0,9999,1
1713482513127,CLRE 252,A00,507189,Cuomo; Raphael Eduardo,9998,0,9999,1
1713482514156,CLRE 253,A00,507199,Vaida; Florin,9997,0,9999,2
1713482514156,CLRE 253,B00,507202,Vaida; Florin,9999,0,9999,0
1713482515182,CLRE 259,A00,507211,Patel; Hemal,9996,0,9999,3
1713482516213,CLRE 260,A00,507221,Cuomo; Raphael Eduardo,9999,0,9999,0
1713482517236,CLRE 297,001,507242,Cuomo; Raphael Eduardo,9999,0,9999,0
1713482518261,CSE 191,A00,516875,Minnes Kemp; Mor Mia,9999,0,9999,0
1713482519286,CSS 201S,A01,494383,Staff,35,0,35,0
1713482520315,CSS 202S,A01,494387,Staff,35,0,35,0
1713482521340,EAP 100,A00,516065,Staff,9792,0,9999,207
1713482522369,ECE 45,A01,507414,Staff,38,0,60,22
1713482523398,ECE 100,A01,507416,Baghdadchi; Saharnaz,3,0,20,17
1713482523398,ECE 100,A02,507418,Baghdadchi; Saharnaz,19,0,20,1
1713482524425,ECE 111,A01,507420,Staff,28,0,50,22
1713482525450,ECE 197,001,548057,Sievenpiper; Daniel F.,9998,0,9999,1
1713482526475,EDS 115,A00,507243,Choi; Bailey Miyeon,27,0,28,1
1713482527499,EDS 117,A01,494379,Staff,16,0,25,9
1713482528525,EDS 125,A00,507246,Hopkins; Megan Beth,28,0,30,2
1713482529554,EDS 128A,A01,507264,Fargason; Sharon Gayle,26,0,26,0
1713482530584,EDS 128B,A01,507293,Pappas; Elizabeth,30,0,30,0
1713482531610,EDS 139,A00,507294,Fargason; Sharon Gayle,30,0,30,0
1713482531610,EDS 139,B00,507313,Pappas; Elizabeth,30,0,30,0
1713482532636,EDS 201,A00,507315,Staff,19,0,30,11
1713482533659,EDS 203,A01,507317,Halter; Christopher P.,18,0,30,12
1713482534684,EDS 204R,A01,507319,Halter; Christopher P.,0,1,30,30
1713482534684,EDS 204R,B01,507331,Heinzman; Erica M.,26,0,30,4
1713482535712,EDS 206R,A00,507332,Staff,0,1,30,30
1713482535712,EDS 206R,B00,507343,Staff,27,0,30,3
1713482536737,EDS 250,A00,507344,Hemans; Patricia Ann Benitez,28,0,40,12
1713482537763,EDS 281,A00,507345,Daly; Alan J.,18,0,18,0
1713482538787,EDS 284,A00,507350,Daly; Alan J.,16,0,16,0
1713482539813,EDS 286,A00,507359,Fine; Sarah,18,0,18,0
1713482540838,EDS 289C,A01,507361,Daly; Alan J.,18,0,18,0
1713482541864,EDS 290,A00,507366,Hofstetter; Carolyn,15,0,15,0
1713482542894,LIGM 5A,A00,507421,Fischer-Grunski; Eva K,20,0,20,0
1713482543919,LIGM 5B,A00,507423,Fischer-Grunski; Eva K,20,0,20,0
1713482544945,LIGM 5C,A00,507425,Fischer-Grunski; Eva K,20,0,20,0
1713482545973,LIIT 5AS,A00,507427,Carnelos; Chiara,20,0,20,0
1713482547002,LIIT 5BS,A00,507430,Carnelos; Chiara,20,0,20,0
1713482548031,LIIT 5CS,A00,507432,Carnelos; Chiara,20,0,20,0
1713482549057,LISP 5A,A00,507541,Munoz Sanchez; Alicia,14,0,20,6
1713482550083,LISP 5B,A00,507671,Munoz Sanchez; Alicia,12,0,20,8
1713482551113,LISP 5C,A00,507696,Munoz Sanchez; Alicia,11,0,20,9
1713482552138,MAE 197,001,528363,Boechler; Nicholas Sebastia,9998,0,9999,1
1713482553169,MATH 197,001,523477,Kedlaya; Kiran S.,9999,0,9999,0
1713482553169,MATH 197,002,563811,Zhang; Danna,9998,0,9999,1
1713482554197,MCWP 40R,A00,518780,Staff,17,0,20,3
1713482554197,MCWP 40R,B00,518781,Staff,14,0,20,6
1713482554197,MCWP 40R,C00,518783,Staff,11,0,20,9
1713482555223,MCWP 50R,A00,518791,Staff,8,0,20,12
1713482555223,MCWP 50R,B00,518792,Staff,7,0,20,13
1713482555223,MCWP 50R,C00,518793,Staff,7,0,20,13
1713482555223,MCWP 50R,D00,518794,Staff,2,0,20,18
1713482555223,MCWP 50R,E00,518795,Staff,3,0,20,17
1713482555223,MCWP 50R,F00,518796,Staff,13,0,20,7
1713482555223,MCWP 50R,G00,518797,Staff,12,0,20,8
1713482556254,MMW 12R,A01,514034,Herbst; Matthew,8,0,16,8
1713482556254,MMW 12R,A02,514035,Herbst; Matthew,14,0,16,2
1713482557279,MMW 13R,A01,514037,Staff,0,1,16,16
1713482557279,MMW 13R,A02,514039,Staff,0,1,16,16
1713482559332,SIO 295LS,A00,523233,Staff,15,0,30,15
1713482560357,SIO 295S,A00,523232,Staff,15,0,30,15
1713482561382,SOCI 117,A01,494376,Staff,0,2,5,5
1713482562407,WES 237B,A00,494380,Staff,19,0,20,1
1713482564468,AESE 279B,A00,494370,Wade; Jon P,33,0,33,0
1713482565493,AIP 197,001,627712,Vespa; Emanuel Ignacio,9999,0,9999,0
1713482566518,ANAR 135S,A00,494369,Braswell; Geoffrey E.,0,0,0,0
1713482567598,CAT 124RS,A01,519847,Geibel; William,6,0,20,14
1713482568627,CAT 125RS,A01,515971,Geibel; William,6,0,20,14
1713482569652,CLRE 250,A00,511389,Morris; Sheldon,9996,0,9999,3
1713482570679,CLRE 251,A00,507176,Mehta; Ravindra L.,9996,0,9999,3
1713482570679,CLRE 251,B00,511410,Mehta; Ravindra L.,9998,0,9999,1
1713482571707,CLRE 252,A00,507189,Cuomo; Raphael Eduardo,9998,0,9999,1
1713482572738,CLRE 253,A00,507199,Vaida; Florin,9997,0,9999,2
1713482572738,CLRE 253,B00,507202,Vaida; Florin,9999,0,9999,0
1713482573766,CLRE 259,A00,507211,Patel; Hemal,9996,0,9999,3
1713482574794,CLRE 260,A00,507221,Cuomo; Raphael Eduardo,9999,0,9999,0
1713482575819,CLRE 297,001,507242,Cuomo; Raphael Eduardo,9999,0,9999,0
1713482576845,CSE 191,A00,516875,Minnes Kemp; Mor Mia,9999,0,9999,0
1713482577872,CSS 201S,A01,494383,Staff,35,0,35,0
1713482578901,CSS 202S,A01,494387,Staff,35,0,35,0
1713482579928,EAP 100,A00,516065,Staff,9792,0,9999,207
1713482580953,ECE 45,A01,507414,Staff,38,0,60,22
1713482581982,ECE 100,A01,507416,Baghdadchi; Saharnaz,3,0,20,17
1713482581982,ECE 100,A02,507418,Baghdadchi; Saharnaz,19,0,20,1
1713482583010,ECE 111,A01,507420,Staff,28,0,50,22
1713482584038,ECE 197,001,548057,Sievenpiper; Daniel F.,9998,0,9999,1
1713482585065,EDS 115,A00,507243,Choi; Bailey Miyeon,27,0,28,1
1713482586090,EDS 117,A01,494379,Staff,16,0,25,9
1713482587115,EDS 125,A00,507246,Hopkins; Megan Beth,28,0,30,2
1713482588141,EDS 128A,A01,507264,Fargason; Sharon Gayle,26,0,26,0
1713482589169,EDS 128B,A01,507293,Pappas; Elizabeth,30,0,30,0
1713482590194,EDS 139,A00,507294,Fargason; Sharon Gayle,30,0,30,0
1713482590194,EDS 139,B00,507313,Pappas; Elizabeth,30,0,30,0
1713482591219,EDS 201,A00,507315,Staff,19,0,30,11
1713482592245,EDS 203,A01,507317,Halter; Christopher P.,18,0,30,12
1713482593275,EDS 204R,A01,507319,Halter; Christopher P.,0,1,30,30
1713482593275,EDS 204R,B01,507331,Heinzman; Erica M.,26,0,30,4
1713482594304,EDS 206R,A00,507332,Staff,0,1,30,30
1713482594304,EDS 206R,B00,507343,Staff,27,0,30,3
1713482595331,EDS 250,A00,507344,Hemans; Patricia Ann Benitez,28,0,40,12
1713482596356,EDS 281,A00,507345,Daly; Alan J.,18,0,18,0
1713482597386,EDS 284,A00,507350,Daly; Alan J.,16,0,16,0
1713482598412,EDS 286,A00,507359,Fine; Sarah,18,0,18,0
1713482599437,EDS 289C,A01,507361,Daly; Alan J.,18,0,18,0
1713482600464,EDS 290,A00,507366,Hofstetter; Carolyn,15,0,15,0
1713482601494,LIGM 5A,A00,507421,Fischer-Grunski; Eva K,20,0,20,0
1713482602524,LIGM 5B,A00,507423,Fischer-Grunski; Eva K,20,0,20,0
1713482603553,LIGM 5C,A00,507425,Fischer-Grunski; Eva K,20,0,20,0
1713482604578,LIIT 5AS,A00,507427,Carnelos; Chiara,20,0,20,0
1713482605604,LIIT 5BS,A00,507430,Carnelos; Chiara,20,0,20,0
1713482606629,LIIT 5CS,A00,507432,Carnelos; Chiara,20,0,20,0
1713482607655,LISP 5A,A00,507541,Munoz Sanchez; Alicia,14,0,20,6
1713482608680,LISP 5B,A00,507671,Munoz Sanchez; Alicia,12,0,20,8
1713482609706,LISP 5C,A00,507696,Munoz Sanchez; Alicia,11,0,20,9
1713482610732,MAE 197,001,528363,Boechler; Nicholas Sebastia,9998,0,9999,1
1713482611760,MATH 197,001,523477,Kedlaya; Kiran S.,9999,0,9999,0
1713482611760,MATH 197,002,563811,Zhang; Danna,9998,0,9999,1
1713482612786,MCWP 40R,A00,518780,Staff,17,0,20,3
1713482612786,MCWP 40R,B00,518781,Staff,14,0,20,6
1713482612786,MCWP 40R,C00,518783,Staff,11,0,20,9
1713482613815,MCWP 50R,A00,518791,Staff,8,0,20,12
1713482613815,MCWP 50R,B00,518792,Staff,7,0,20,13
1713482613815,MCWP 50R,C00,518793,Staff,7,0,20,13
1713482613815,MCWP 50R,D00,518794,Staff,2,0,20,18
1713482613815,MCWP 50R,E00,518795,Staff,3,0,20,17
1713482613815,MCWP 50R,F00,518796,Staff,13,0,20,7
1713482613815,MCWP 50R,G00,518797,Staff,12,0,20,8
1713482614846,MMW 12R,A01,514034,Herbst; Matthew,8,0,16,8
1713482614846,MMW 12R,A02,514035,Herbst; Matthew,14,0,16,2
1713482615871,MMW 13R,A01,514037,Staff,0,1,16,16
1713482615871,MMW 13R,A02,514039,Staff,0,1,16,16
1713482617925,SIO 295LS,A00,523233,Staff,15,0,30,15
1713482618953,SIO 295S,A00,523232,Staff,15,0,30,15
1713482619982,SOCI 117,A01,494376,Staff,0,2,5,5
1713482621009,WES 237B,A00,494380,Staff,19,0,20,1
1713482623081,AESE 279B,A00,494370,Wade; Jon P,33,0,33,0
1713482624106,AIP 197,001,627712,Vespa; Emanuel Ignacio,9999,0,9999,0
1713482625132,ANAR 135S,A00,494369,Braswell; Geoffrey E.,0,0,0,0
1713482626162,CAT 124RS,A01,519847,Geibel; William,6,0,20,14
1713482627187,CAT 125RS,A01,515971,Geibel; William,6,0,20,14
1713482628214,CLRE 250,A00,511389,Morris; Sheldon,9996,0,9999,3
1713482629240,CLRE 251,A00,507176,Mehta; Ravindra L.,9996,0,9999,3
1713482629240,CLRE 251,B00,511410,Mehta; Ravindra L.,9998,0,9999,1
1713482630269,CLRE 252,A00,507189,Cuomo; Raphael Eduardo,9998,0,9999,1
1713482631302,CLRE 253,A00,507199,Vaida; Florin,9997,0,9999,2
1713482631302,CLRE 253,B00,507202,Vaida; Florin,9999,0,9999,0
1713482632327,CLRE 259,A00,507211,Patel; Hemal,9996,0,9999,3
1713482633354,CLRE 260,A00,507221,Cuomo; Raphael Eduardo,9999,0,9999,0
1713482634378,CLRE 297,001,507242,Cuomo; Raphael Eduardo,9999,0,9999,0
1713482635406,CSE 191,A00,516875,Minnes Kemp; Mor Mia,9999,0,9999,0
1713482636435,CSS 201S,A01,494383,Staff,35,0,35,0
1713482637464,CSS 202S,A01,494387,Staff,35,0,35,0
1713482638488,EAP 100,A00,516065,Staff,9792,0,9999,207
1713482639513,ECE 45,A01,507414,Staff,38,0,60,22
1713482640543,ECE 100,A01,507416,Baghdadchi; Saharnaz,3,0,20,17
1713482640543,ECE 100,A02,507418,Baghdadchi; Saharnaz,19,0,20,1
1713482641573,ECE 111,A01,507420,Staff,28,0,50,22
1713482642599,ECE 197,001,548057,Sievenpiper; Daniel F.,9998,0,9999,1
1713482643625,EDS 115,A00,507243,Choi; Bailey Miyeon,27,0,28,1
1713482644654,EDS 117,A01,494379,Staff,16,0,25,9
1713482645679,EDS 125,A00,507246,Hopkins; Megan Beth,28,0,30,2
1713482646708,EDS 128A,A01,507264,Fargason; Sharon Gayle,26,0,26,0
1713482647733,EDS 128B,A01,507293,Pappas; Elizabeth,30,0,30,0
1713482648762,EDS 139,A00,507294,Fargason; Sharon Gayle,30,0,30,0
1713482648762,EDS 139,B00,507313,Pappas; Elizabeth,30,0,30,0
1713482649790,EDS 201,A00,507315,Staff,19,0,30,11
1713482650820,EDS 203,A01,507317,Halter; Christopher P.,18,0,30,12
1713482651846,EDS 204R,A01,507319,Halter; Christopher P.,0,1,30,30
1713482651846,EDS 204R,B01,507331,Heinzman; Erica M.,26,0,30,4
1713482652874,EDS 206R,A00,507332,Staff,0,1,30,30
1713482652874,EDS 206R,B00,507343,Staff,27,0,30,3
1713482653904,EDS 250,A00,507344,Hemans; Patricia Ann Benitez,28,0,40,12
1713482654941,EDS 281,A00,507345,Daly; Alan J.,18,0,18,0
1713482655967,EDS 284,A00,507350,Daly; Alan J.,16,0,16,0
1713482656999,EDS 286,A00,507359,Fine; Sarah,18,0,18,0
1713482658026,EDS 289C,A01,507361,Daly; Alan J.,18,0,18,0
1713482659053,EDS 290,A00,507366,Hofstetter; Carolyn,15,0,15,0
1713482660079,LIGM 5A,A00,507421,Fischer-Grunski; Eva K,20,0,20,0
1713482661109,LIGM 5B,A00,507423,Fischer-Grunski; Eva K,20,0,20,0
1713482662135,LIGM 5C,A00,507425,Fischer-Grunski; Eva K,20,0,20,0
1713482663163,LIIT 5AS,A00,507427,Carnelos; Chiara,20,0,20,0
1713482664192,LIIT 5BS,A00,507430,Carnelos; Chiara,20,0,20,0
1713482665218,LIIT 5CS,A00,507432,Carnelos; Chiara,20,0,20,0
1713482666244,LISP 5A,A00,507541,Munoz Sanchez; Alicia,14,0,20,6
1713482667271,LISP 5B,A00,507671,Munoz Sanchez; Alicia,12,0,20,8
1713482668297,LISP 5C,A00,507696,Munoz Sanchez; Alicia,11,0,20,9
1713482669323,MAE 197,001,528363,Boechler; Nicholas Sebastia,9998,0,9999,1
1713482670349,MATH 197,001,523477,Kedlaya; Kiran S.,9999,0,9999,0
1713482670349,MATH 197,002,563811,Zhang; Danna,9998,0,9999,1
1713482671432,MCWP 40R,A00,518780,Staff,17,0,20,3
1713482671432,MCWP 40R,B00,518781,Staff,14,0,20,6
1713482671432,MCWP 40R,C00,518783,Staff,11,0,20,9
1713482672459,MCWP 50R,A00,518791,Staff,8,0,20,12
1713482672459,MCWP 50R,B00,518792,Staff,7,0,20,13
1713482672459,MCWP 50R,C00,518793,Staff,7,0,20,13
1713482672459,MCWP 50R,D00,518794,Staff,2,0,20,18
1713482672459,MCWP 50R,E00,518795,Staff,3,0,20,17
1713482672459,MCWP 50R,F00,518796,Staff,13,0,20,7
1713482672459,MCWP 50R,G00,518797,Staff,12,0,20,8
1713482673488,MMW 12R,A01,514034,Herbst; Matthew,8,0,16,8
1713482673488,MMW 12R,A02,514035,Herbst; Matthew,14,0,16,2
1713482674512,MMW 13R,A01,514037,Staff,0,1,16,16
1713482674512,MMW 13R,A02,514039,Staff,0,1,16,16
1713482676566,SIO 295LS,A00,523233,Staff,15,0,30,15
1713482677590,SIO 295S,A00,523232,Staff,15,0,30,15
1713482678617,SOCI 117,A01,494376,Staff,0,2,5,5
1713482679645,WES 237B,A00,494380,Staff,19,0,20,1
1713482681721,AESE 279B,A00,494370,Wade; Jon P,33,0,33,0
1713482682747,AIP 197,001,627712,Vespa; Emanuel Ignacio,9999,0,9999,0
1713482683771,ANAR 135S,A00,494369,Braswell; Geoffrey E.,0,0,0,0
1713482684797,CAT 124RS,A01,519847,Geibel; William,6,0,20,14
1713482685822,CAT 125RS,A01,515971,Geibel; William,6,0,20,14
1713482686847,CLRE 250,A00,511389,Morris; Sheldon,9996,0,9999,3
1713482687877,CLRE 251,A00,507176,Mehta; Ravindra L.,9996,0,9999,3
1713482687877,CLRE 251,B00,511410,Mehta; Ravindra L.,9998,0,9999,1
1713482688902,CLRE 252,A00,507189,Cuomo; Raphael Eduardo,9998,0,9999,1
1713482689927,CLRE 253,A00,507199,Vaida; Florin,9997,0,9999,2
1713482689927,CLRE 253,B00,507202,Vaida; Florin,9999,0,9999,0
1713482690953,CLRE 259,A00,507211,Patel; Hemal,9996,0,9999,3
1713482691978,CLRE 260,A00,507221,Cuomo; Raphael Eduardo,9999,0,9999,0
1713482693006,CLRE 297,001,507242,Cuomo; Raphael Eduardo,9999,0,9999,0
1713482694035,CSE 191,A00,516875,Minnes Kemp; Mor Mia,9999,0,9999,0
1713482695061,CSS 201S,A01,494383,Staff,35,0,35,0
1713482696090,CSS 202S,A01,494387,Staff,35,0,35,0
1713482697115,EAP 100,A00,516065,Staff,9792,0,9999,207
1713482698142,ECE 45,A01,507414,Staff,38,0,60,22
1713482699172,ECE 100,A01,507416,Baghdadchi; Saharnaz,3,0,20,17
1713482699172,ECE 100,A02,507418,Baghdadchi; Saharnaz,19,0,20,1
1713482700196,ECE 111,A01,507420,Staff,28,0,50,22
1713482701222,ECE 197,001,548057,Sievenpiper; Daniel F.,9998,0,9999,1
1713482702248,EDS 115,A00,507243,Choi; Bailey Miyeon,27,0,28,1
1713482703274,EDS 117,A01,494379,Staff,16,0,25,9
1713482704302,EDS 125,A00,507246,Hopkins; Megan Beth,28,0,30,2
1713482705327,EDS 128A,A01,507264,Fargason; Sharon Gayle,26,0,26,0
1713482706354,EDS 128B,A01,507293,Pappas; Elizabeth,30,0,30,0
1713482707381,EDS 139,A00,507294,Fargason; Sharon Gayle,30,0,30,0
1713482707381,EDS 139,B00,507313,Pappas; Elizabeth,30,0,30,0
1713482708409,EDS 201,A00,507315,Staff,19,0,30,11
1713482709435,EDS 203,A01,507317,Halter; Christopher P.,18,0,30,12
1713482710461,EDS 204R,A01,507319,Halter; Christopher P.,0,1,30,30
1713482710461,EDS 204R,B01,507331,Heinzman; Erica M.,26,0,30,4
1713482711487,EDS 206R,A00,507332,Staff,0,1,30,30
1713482711487,EDS 206R,B00,507343,Staff,27,0,30,3
1713482712512,EDS 250,A00,507344,Hemans; Patricia Ann Benitez,28,0,40,12
1713482713538,EDS 281,A00,507345,Daly; Alan J.,18,0,18,0
1713482714566,EDS 284,A00,507350,Daly; Alan J.,16,0,16,0
1713482715590,EDS 286,A00,507359,Fine; Sarah,18,0,18,0
1713482716614,EDS 289C,A01,507361,Daly; Alan J.,18,0,18,0
1713482717638,EDS 290,A00,507366,Hofstetter; Carolyn,15,0,15,0
1713482718664,LIGM 5A,A00,507421,Fischer-Grunski; Eva K,20,0,20,0
1713482719692,LIGM 5B,A00,507423,Fischer-Grunski; Eva K,20,0,20,0
1713482720721,LIGM 5C,A00,507425,Fischer-Grunski; Eva K,20,0,20,0
1713482721746,LIIT 5AS,A00,507427,Carnelos; Chiara,20,0,20,0
1713482722776,LIIT 5BS,A00,507430,Carnelos; Chiara,20,0,20,0
1713482723801,LIIT 5CS,A00,507432,Carnelos; Chiara,20,0,20,0
1713482724827,LISP 5A,A00,507541,Munoz Sanchez; Alicia,14,0,20,6
1713482725852,LISP 5B,A00,507671,Munoz Sanchez; Alicia,12,0,20,8
1713482726878,LISP 5C,A00,507696,Munoz Sanchez; Alicia,11,0,20,9
1713482727907,MAE 197,001,528363,Boechler; Nicholas Sebastia,9998,0,9999,1
1713482728933,MATH 197,001,523477,Kedlaya; Kiran S.,9999,0,9999,0
1713482728933,MATH 197,002,563811,Zhang; Danna,9998,0,9999,1
1713482729959,MCWP 40R,A00,518780,Staff,17,0,20,3
1713482729959,MCWP 40R,B00,518781,Staff,14,0,20,6
1713482729959,MCWP 40R,C00,518783,Staff,11,0,20,9
1713482730984,MCWP 50R,A00,518791,Staff,8,0,20,12
1713482730984,MCWP 50R,B00,518792,Staff,7,0,20,13
1713482730984,MCWP 50R,C00,518793,Staff,7,0,20,13
1713482730984,MCWP 50R,D00,518794,Staff,1,0,20,19
1713482730984,MCWP 50R,E00,518795,Staff,3,0,20,17
1713482730984,MCWP 50R,F00,518796,Staff,13,0,20,7
1713482730984,MCWP 50R,G00,518797,Staff,12,0,20,8
1713482732013,MMW 12R,A01,514034,Herbst; Matthew,8,0,16,8
1713482732013,MMW 12R,A02,514035,Herbst; Matthew,14,0,16,2
1713482733038,MMW 13R,A01,514037,Staff,0,1,16,16
1713482733038,MMW 13R,A02,514039,Staff,0,1,16,16
1713482735088,SIO 295LS,A00,523233,Staff,15,0,30,15
1713482736113,SIO 295S,A00,523232,Staff,15,0,30,15
1713482737142,SOCI 117,A01,494376,Staff,0,2,5,5
1713482738170,WES 237B,A00,494380,Staff,19,0,20,1
1713482740243,AESE 279B,A00,494370,Wade; Jon P,33,0,33,0
1713482741270,AIP 197,001,627712,Vespa; Emanuel Ignacio,9999,0,9999,0
1713482742294,ANAR 135S,A00,494369,Braswell; Geoffrey E.,0,0,0,0
1713482743321,CAT 124RS,A01,519847,Geibel; William,6,0,20,14
1713482744346,CAT 125RS,A01,515971,Geibel; William,6,0,20,14
1713482745372,CLRE 250,A00,511389,Morris; Sheldon,9996,0,9999,3
1713482746395,CLRE 251,A00,507176,Mehta; Ravindra L.,9996,0,9999,3
1713482746395,CLRE 251,B00,511410,Mehta; Ravindra L.,9998,0,9999,1
1713482747421,CLRE 252,A00,507189,Cuomo; Raphael Eduardo,9998,0,9999,1
1713482748450,CLRE 253,A00,507199,Vaida; Florin,9997,0,9999,2
1713482748450,CLRE 253,B00,507202,Vaida; Florin,9999,0,9999,0
1713482749474,CLRE 259,A00,507211,Patel; Hemal,9996,0,9999,3
1713482750499,CLRE 260,A00,507221,Cuomo; Raphael Eduardo,9999,0,9999,0
1713482751523,CLRE 297,001,507242,Cuomo; Raphael Eduardo,9999,0,9999,0
1713482752549,CSE 191,A00,516875,Minnes Kemp; Mor Mia,9999,0,9999,0
1713482753579,CSS 201S,A01,494383,Staff,35,0,35,0
1713482754603,CSS 202S,A01,494387,Staff,35,0,35,0
1713482755630,EAP 100,A00,516065,Staff,9792,0,9999,207
1713482756655,ECE 45,A01,507414,Staff,38,0,60,22
1713482757684,ECE 100,A01,507416,Baghdadchi; Saharnaz,3,0,20,17
1713482757684,ECE 100,A02,507418,Baghdadchi; Saharnaz,19,0,20,1
1713482758707,ECE 111,A01,507420,Staff,28,0,50,22
1713482759734,ECE 197,001,548057,Sievenpiper; Daniel F.,9998,0,9999,1
1713482760760,EDS 115,A00,507243,Choi; Bailey Miyeon,27,0,28,1
1713482761787,EDS 117,A01,494379,Staff,16,0,25,9
1713482762816,EDS 125,A00,507246,Hopkins; Megan Beth,28,0,30,2
1713482763844,EDS 128A,A01,507264,Fargason; Sharon Gayle,26,0,26,0
1713482764876,EDS 128B,A01,507293,Pappas; Elizabeth,30,0,30,0
1713482765907,EDS 139,A00,507294,Fargason; Sharon Gayle,30,0,30,0
1713482765907,EDS 139,B00,507313,Pappas; Elizabeth,30,0,30,0
1713482766936,EDS 201,A00,507315,Staff,19,0,30,11
1713482767962,EDS 203,A01,507317,Halter; Christopher P.,18,0,30,12
1713482768989,EDS 204R,A01,507319,Halter; Christopher P.,0,1,30,30
1713482768989,EDS 204R,B01,507331,Heinzman; Erica M.,26,0,30,4
1713482770017,EDS 206R,A00,507332,Staff,0,1,30,30
1713482770017,EDS 206R,B00,507343,Staff,27,0,30,3
1713482771043,EDS 250,A00,507344,Hemans; Patricia Ann Benitez,28,0,40,12
1713482772073,EDS 281,A00,507345,Daly; Alan J.,18,0,18,0
1713482773110,EDS 284,A00,507350,Daly; Alan J.,16,0,16,0
1713482774134,EDS 286,A00,507359,Fine; Sarah,18,0,18,0
1713482775212,EDS 289C,A01,507361,Daly; Alan J.,18,0,18,0
1713482776238,EDS 290,A00,507366,Hofstetter; Carolyn,15,0,15,0
1713482777265,LIGM 5A,A00,507421,Fischer-Grunski; Eva K,20,0,20,0
1713482778291,LIGM 5B,A00,507423,Fischer-Grunski; Eva K,20,0,20,0
1713482779317,LIGM 5C,A00,507425,Fischer-Grunski; Eva K,20,0,20,0
1713482780342,LIIT 5AS,A00,507427,Carnelos; Chiara,20,0,20,0
1713482781408,LIIT 5BS,A00,507430,Carnelos; Chiara,20,0,20,0
1713482782431,LIIT 5CS,A00,507432,Carnelos; Chiara,20,0,20,0
1713482783457,LISP 5A,A00,507541,Munoz Sanchez; Alicia,14,0,20,6
1713482784483,LISP 5B,A00,507671,Munoz Sanchez; Alicia,12,0,20,8
1713482785511,LISP 5C,A00,507696,Munoz Sanchez; Alicia,11,0,20,9
1713482786538,MAE 197,001,528363,Boechler; Nicholas Sebastia,9998,0,9999,1
1713482787564,MATH 197,001,523477,Kedlaya; Kiran S.,9999,0,9999,0
1713482787564,MATH 197,002,563811,Zhang; Danna,9998,0,9999,1
1713482788590,MCWP 40R,A00,518780,Staff,17,0,20,3
1713482788590,MCWP 40R,B00,518781,Staff,14,0,20,6
1713482788590,MCWP 40R,C00,518783,Staff,11,0,20,9
1713482789616,MCWP 50R,A00,518791,Staff,8,0,20,12
1713482789616,MCWP 50R,B00,518792,Staff,7,0,20,13
1713482789616,MCWP 50R,C00,518793,Staff,7,0,20,13
1713482789616,MCWP 50R,D00,518794,Staff,1,0,20,19
1713482789616,MCWP 50R,E00,518795,Staff,3,0,20,17
1713482789616,MCWP 50R,F00,518796,Staff,13,0,20,7
1713482789616,MCWP 50R,G00,518797,Staff,12,0,20,8
1713482790642,MMW 12R,A01,514034,Herbst; Matthew,8,0,16,8
1713482790642,MMW 12R,A02,514035,Herbst; Matthew,14,0,16,2
1713482791666,MMW 13R,A01,514037,Staff,0,1,16,16
1713482791666,MMW 13R,A02,514039,Staff,0,1,16,16
1713482793719,SIO 295LS,A00,523233,Staff,15,0,30,15
1713482794744,SIO 295S,A00,523232,Staff,15,0,30,15
1713482795773,SOCI 117,A01,494376,Staff,0,2,5,5
1713482796801,WES 237B,A00,494380,Staff,19,0,20,1
1713482798876,AESE 279B,A00,494370,Wade; Jon P,33,0,33,0
1713482799904,AIP 197,001,627712,Vespa; Emanuel Ignacio,9999,0,9999,0
1713482800930,ANAR 135S,A00,494369,Braswell; Geoffrey E.,0,0,0,0
1713482801956,CAT 124RS,A01,519847,Geibel; William,6,0,20,14
1713482802981,CAT 125RS,A01,515971,Geibel; William,6,0,20,14
1713482804007,CLRE 250,A00,511389,Morris; Sheldon,9996,0,9999,3
1713482805034,CLRE 251,A00,507176,Mehta; Ravindra L.,9996,0,9999,3
1713482805034,CLRE 251,B00,511410,Mehta; Ravindra L.,9998,0,9999,1
1713482806067,CLRE 252,A00,507189,Cuomo; Raphael Eduardo,9998,0,9999,1
1713482807092,CLRE 253,A00,507199,Vaida; Florin,9997,0,9999,2
1713482807092,CLRE 253,B00,507202,Vaida; Florin,9999,0,9999,0
1713482808117,CLRE 259,A00,507211,Patel; Hemal,9996,0,9999,3
1713482809143,CLRE 260,A00,507221,Cuomo; Raphael Eduardo,9999,0,9999,0
1713482810171,CLRE 297,001,507242,Cuomo; Raphael Eduardo,9999,0,9999,0
1713482811200,CSE 191,A00,516875,Minnes Kemp; Mor Mia,9999,0,9999,0
1713482812226,CSS 201S,A01,494383,Staff,35,0,35,0
1713482813253,CSS 202S,A01,494387,Staff,35,0,35,0
1713482814282,EAP 100,A00,516065,Staff,9792,0,9999,207
1713482815308,ECE 45,A01,507414,Staff,38,0,60,22
1713482816333,ECE 100,A01,507416,Baghdadchi; Saharnaz,3,0,20,17
1713482816333,ECE 100,A02,507418,Baghdadchi; Saharnaz,19,0,20,1
1713482817361,ECE 111,A01,507420,Staff,28,0,50,22
1713482818389,ECE 197,001,548057,Sievenpiper; Daniel F.,9998,0,9999,1
1713482819416,EDS 115,A00,507243,Choi; Bailey Miyeon,27,0,28,1
1713482820441,EDS 117,A01,494379,Staff,16,0,25,9
1713482821466,EDS 125,A00,507246,Hopkins; Megan Beth,28,0,30,2
1713482822490,EDS 128A,A01,507264,Fargason; Sharon Gayle,26,0,26,0
1713482823516,EDS 128B,A01,507293,Pappas; Elizabeth,30,0,30,0
1713482824544,EDS 139,A00,507294,Fargason; Sharon Gayle,30,0,30,0
1713482824544,EDS 139,B00,507313,Pappas; Elizabeth,30,0,30,0
1713482825571,EDS 201,A00,507315,Staff,19,0,30,11
1713482826597,EDS 203,A01,507317,Halter; Christopher P.,18,0,30,12
1713482827628,EDS 204R,A01,507319,Halter; Christopher P.,0,1,30,30
1713482827628,EDS 204R,B01,507331,Heinzman; Erica M.,26,0,30,4
1713482828655,EDS 206R,A00,507332,Staff,0,1,30,30
1713482828655,EDS 206R,B00,507343,Staff,27,0,30,3
1713482829680,EDS 250,A00,507344,Hemans; Patricia Ann Benitez,28,0,40,12
1713482830709,EDS 281,A00,507345,Daly; Alan J.,18,0,18,0
1713482831733,EDS 284,A00,507350,Daly; Alan J.,16,0,16,0
1713482832763,EDS 286,A00,507359,Fine; Sarah,18,0,18,0
1713482833791,EDS 289C,A01,507361,Daly; Alan J.,18,0,18,0
1713482834817,EDS 290,A00,507366,Hofstetter; Carolyn,15,0,15,0
1713482835847,LIGM 5A,A00,507421,Fischer-Grunski; Eva K,20,0,20,0
1713482836872,LIGM 5B,A00,507423,Fischer-Grunski; Eva K,20,0,20,0
1713482837897,LIGM 5C,A00,507425,Fischer-Grunski; Eva K,20,0,20,0
1713482838922,LIIT 5AS,A00,507427,Carnelos; Chiara,20,0,20,0
1713482839951,LIIT 5BS,A00,507430,Carnelos; Chiara,20,0,20,0
1713482840976,LIIT 5CS,A00,507432,Carnelos; Chiara,20,0,20,0
1713482842002,LISP 5A,A00,507541,Munoz Sanchez; Alicia,14,0,20,6
1713482843031,LISP 5B,A00,507671,Munoz Sanchez; Alicia,12,0,20,8
1713482844060,LISP 5C,A00,507696,Munoz Sanchez; Alicia,11,0,20,9
1713482845087,MAE 197,001,528363,Boechler; Nicholas Sebastia,9998,0,9999,1
1713482846112,MATH 197,001,523477,Kedlaya; Kiran S.,9999,0,9999,0
1713482846112,MATH 197,002,563811,Zhang; Danna,9998,0,9999,1
1713482847140,MCWP 40R,A00,518780,Staff,17,0,20,3
1713482847140,MCWP 40R,B00,518781,Staff,14,0,20,6
1713482847140,MCWP 40R,C00,518783,Staff,11,0,20,9
1713482848165,MCWP 50R,A00,518791,Staff,8,0,20,12
1713482848165,MCWP 50R,B00,518792,Staff,7,0,20,13
1713482848165,MCWP 50R,C00,518793,Staff,7,0,20,13
1713482848165,MCWP 50R,D00,518794,Staff,1,0,20,19
1713482848165,MCWP 50R,E00,518795,Staff,3,0,20,17
1713482848165,MCWP 50R,F00,518796,Staff,13,0,20,7
1713482848165,MCWP 50R,G00,518797,Staff,12,0,20,8
1713482849194,MMW 12R,A01,514034,Herbst; Matthew,8,0,16,8
1713482849194,MMW 12R,A02,514035,Herbst; Matthew,14,0,16,2
1713482850219,MMW 13R,A01,514037,Staff,0,1,16,16
1713482850219,MMW 13R,A02,514039,Staff,0,1,16,16
1713482852268,SIO 295LS,A00,523233,Staff,15,0,30,15
1713482853294,SIO 295S,A00,523232,Staff,15,0,30,15
1713482854320,SOCI 117,A01,494376,Staff,0,2,5,5
1713482855349,WES 237B,A00,494380,Staff,19,0,20,1
1713482857428,AESE 279B,A00,494370,Wade; Jon P,33,0,33,0
1713482858456,AIP 197,001,627712,Vespa; Emanuel Ignacio,9999,0,9999,0
1713482859484,ANAR 135S,A00,494369,Braswell; Geoffrey E.,0,0,0,0
1713482860509,CAT 124RS,A01,519847,Geibel; William,6,0,20,14
1713482861534,CAT 125RS,A01,515971,Geibel; William,6,0,20,14
1713482862559,CLRE 250,A00,511389,Morris; Sheldon,9996,0,9999,3
1713482863585,CLRE 251,A00,507176,Mehta; Ravindra L.,9996,0,9999,3
1713482863585,CLRE 251,B00,511410,Mehta; Ravindra L.,9998,0,9999,1
1713482864610,CLRE 252,A00,507189,Cuomo; Raphael Eduardo,9998,0,9999,1
1713482865637,CLRE 253,A00,507199,Vaida; Florin,9997,0,9999,2
1713482865637,CLRE 253,B00,507202,Vaida; Florin,9999,0,9999,0
1713482866662,CLRE 259,A00,507211,Patel; Hemal,9996,0,9999,3
1713482867687,CLRE 260,A00,507221,Cuomo; Raphael Eduardo,9999,0,9999,0
1713482868715,CLRE 297,001,507242,Cuomo; Raphael Eduardo,9999,0,9999,0
1713482869742,CSE 191,A00,516875,Minnes Kemp; Mor Mia,9999,0,9999,0
1713482870773,CSS 201S,A01,494383,Staff,35,0,35,0
1713482871800,CSS 202S,A01,494387,Staff,35,0,35,0
1713482872825,EAP 100,A00,516065,Staff,9792,0,9999,207
1713482873852,ECE 45,A01,507414,Staff,38,0,60,22
1713482874879,ECE 100,A01,507416,Baghdadchi; Saharnaz,3,0,20,17
1713482874879,ECE 100,A02,507418,Baghdadchi; Saharnaz,19,0,20,1
1713482875905,ECE 111,A01,507420,Staff,28,0,50,22
1713482876935,ECE 197,001,548057,Sievenpiper; Daniel F.,9998,0,9999,1
1713482877961,EDS 115,A00,507243,Choi; Bailey Miyeon,27,0,28,1
1713482879046,EDS 117,A01,494379,Staff,16,0,25,9
1713482880078,EDS 125,A00,507246,Hopkins; Megan Beth,28,0,30,2
1713482881107,EDS 128A,A01,507264,Fargason; Sharon Gayle,26,0,26,0
1713482882131,EDS 128B,A01,507293,Pappas; Elizabeth,30,0,30,0
1713482883156,EDS 139,A00,507294,Fargason; Sharon Gayle,30,0,30,0
1713482883156,EDS 139,B00,507313,Pappas; Elizabeth,30,0,30,0
1713482884180,EDS 201,A00,507315,Staff,19,0,30,11
1713482885205,EDS 203,A01,507317,Halter; Christopher P.,18,0,30,12
1713482886234,EDS 204R,A01,507319,Halter; Christopher P.,0,1,30,30
1713482886234,EDS 204R,B01,507331,Heinzman; Erica M.,26,0,30,4
1713482887263,EDS 206R,A00,507332,Staff,0,1,30,30
1713482887263,EDS 206R,B00,507343,Staff,27,0,30,3
1713482888290,EDS 250,A00,507344,Hemans; Patricia Ann Benitez,28,0,40,12
1713482889315,EDS 281,A00,507345,Daly; Alan J.,18,0,18,0
1713482890341,EDS 284,A00,507350,Daly; Alan J.,16,0,16,0
1713482891369,EDS 286,A00,507359,Fine; Sarah,18,0,18,0
1713482892408,EDS 289C,A01,507361,Daly; Alan J.,18,0,18,0
1713482893435,EDS 290,A00,507366,Hofstetter; Carolyn,15,0,15,0
1713482894462,LIGM 5A,A00,507421,Fischer-Grunski; Eva K,20,0,20,0
1713482895491,LIGM 5B,A00,507423,Fischer-Grunski; Eva K,20,0,20,0
1713482896516,LIGM 5C,A00,507425,Fischer-Grunski; Eva K,20,0,20,0
1713482897543,LIIT 5AS,A00,507427,Carnelos; Chiara,20,0,20,0
1713482898572,LIIT 5BS,A00,507430,Carnelos; Chiara,20,0,20,0
1713482899601,LIIT 5CS,A00,507432,Carnelos; Chiara,20,0,20,0
1713482900632,LISP 5A,A00,507541,Munoz Sanchez; Alicia,14,0,20,6
1713482901658,LISP 5B,A00,507671,Munoz Sanchez; Alicia,12,0,20,8
1713482902687,LISP 5C,A00,507696,Munoz Sanchez; Alicia,11,0,20,9
1713482903712,MAE 197,001,528363,Boechler; Nicholas Sebastia,9998,0,9999,1
1713482904737,MATH 197,001,523477,Kedlaya; Kiran S.,9999,0,9999,0
1713482904737,MATH 197,002,563811,Zhang; Danna,9998,0,9999,1
1713482905770,MCWP 40R,A00,518780,Staff,17,0,20,3
1713482905770,MCWP 40R,B00,518781,Staff,14,0,20,6
1713482905770,MCWP 40R,C00,518783,Staff,11,0,20,9
1713482906795,MCWP 50R,A00,518791,Staff,8,0,20,12
1713482906795,MCWP 50R,B00,518792,Staff,7,0,20,13
1713482906795,MCWP 50R,C00,518793,Staff,7,0,20,13
1713482906795,MCWP 50R,D00,518794,Staff,1,0,20,19
1713482906795,MCWP 50R,E00,518795,Staff,3,0,20,17
1713482906795,MCWP 50R,F00,518796,Staff,13,0,20,7
1713482906795,MCWP 50R,G00,518797,Staff,12,0,20,8
1713482907823,MMW 12R,A01,514034,Herbst; Matthew,8,0,16,8
1713482907823,MMW 12R,A02,514035,Herbst; Matthew,14,0,16,2
1713482908849,MMW 13R,A01,514037,Staff,0,1,16,16
1713482908849,MMW 13R,A02,514039,Staff,0,1,16,16
1713482910902,SIO 295LS,A00,523233,Staff,15,0,30,15
1713482911928,SIO 295S,A00,523232,Staff,15,0,30,15
1713482912956,SOCI 117,A01,494376,Staff,0,2,5,5
1713482913983,WES 237B,A00,494380,Staff,19,0,20,1
1713482916058,AESE 279B,A00,494370,Wade; Jon P,33,0,33,0
1713482917086,AIP 197,001,627712,Vespa; Emanuel Ignacio,9999,0,9999,0
1713482918110,ANAR 135S,A00,494369,Braswell; Geoffrey E.,0,0,0,0
1713482919137,CAT 124RS,A01,519847,Geibel; William,6,0,20,14
1713482920163,CAT 125RS,A01,515971,Geibel; William,6,0,20,14
1713482921190,CLRE 250,A00,511389,Morris; Sheldon,9996,0,9999,3
1713482922222,CLRE 251,A00,507176,Mehta; Ravindra L.,9996,0,9999,3
1713482922222,CLRE 251,B00,511410,Mehta; Ravindra L.,9998,0,9999,1
1713482923247,CLRE 252,A00,507189,Cuomo; Raphael Eduardo,9998,0,9999,1
1713482924272,CLRE 253,A00,507199,Vaida; Florin,9997,0,9999,2
1713482924272,CLRE 253,B00,507202,Vaida; Florin,9999,0,9999,0
1713482925298,CLRE 259,A00,507211,Patel; Hemal,9996,0,9999,3
1713482926320,CLRE 260,A00,507221,Cuomo; Raphael Eduardo,9999,0,9999,0
1713482927345,CLRE 297,001,507242,Cuomo; Raphael Eduardo,9999,0,9999,0
1713482928373,CSE 191,A00,516875,Minnes Kemp; Mor Mia,9999,0,9999,0
1713482929402,CSS 201S,A01,494383,Staff,35,0,35,0
1713482930427,CSS 202S,A01,494387,Staff,35,0,35,0
1713482931452,EAP 100,A00,516065,Staff,9792,0,9999,207
1713482932476,ECE 45,A01,507414,Staff,38,0,60,22
1713482933503,ECE 100,A01,507416,Baghdadchi; Saharnaz,3,0,20,17
1713482933503,ECE 100,A02,507418,Baghdadchi; Saharnaz,19,0,20,1
1713482934533,ECE 111,A01,507420,Staff,28,0,50,22
1713482935558,ECE 197,001,548057,Sievenpiper; Daniel F.,9998,0,9999,1
1713482936587,EDS 115,A00,507243,Choi; Bailey Miyeon,27,0,28,1
1713482937613,EDS 117,A01,494379,Staff,16,0,25,9
1713482938637,EDS 125,A00,507246,Hopkins; Megan Beth,28,0,30,2
1713482939666,EDS 128A,A01,507264,Fargason; Sharon Gayle,26,0,26,0
1713482940695,EDS 128B,A01,507293,Pappas; Elizabeth,30,0,30,0
1713482941723,EDS 139,A00,507294,Fargason; Sharon Gayle,30,0,30,0
1713482941723,EDS 139,B00,507313,Pappas; Elizabeth,30,0,30,0
1713482942750,EDS 201,A00,507315,Staff,19,0,30,11
1713482943779,EDS 203,A01,507317,Halter; Christopher P.,18,0,30,12
1713482944808,EDS 204R,A01,507319,Halter; Christopher P.,0,1,30,30
1713482944808,EDS 204R,B01,507331,Heinzman; Erica M.,26,0,30,4
1713482945835,EDS 206R,A00,507332,Staff,0,1,30,30
1713482945835,EDS 206R,B00,507343,Staff,27,0,30,3
1713482946860,EDS 250,A00,507344,Hemans; Patricia Ann Benitez,28,0,40,12
1713482947885,EDS 281,A00,507345,Daly; Alan J.,18,0,18,0
1713482948909,EDS 284,A00,507350,Daly; Alan J.,16,0,16,0
1713482949935,EDS 286,A00,507359,Fine; Sarah,18,0,18,0
1713482950962,EDS 289C,A01,507361,Daly; Alan J.,18,0,18,0
1713482951990,EDS 290,A00,507366,Hofstetter; Carolyn,15,0,15,0
1713482953015,LIGM 5A,A00,507421,Fischer-Grunski; Eva K,20,0,20,0
1713482954040,LIGM 5B,A00,507423,Fischer-Grunski; Eva K,20,0,20,0
1713482955067,LIGM 5C,A00,507425,Fischer-Grunski; Eva K,20,0,20,0
1713482956098,LIIT 5AS,A00,507427,Carnelos; Chiara,20,0,20,0
1713482957126,LIIT 5BS,A00,507430,Carnelos; Chiara,20,0,20,0
1713482958156,LIIT 5CS,A00,507432,Carnelos; Chiara,20,0,20,0
1713482959182,LISP 5A,A00,507541,Munoz Sanchez; Alicia,14,0,20,6
1713482960208,LISP 5B,A00,507671,Munoz Sanchez; Alicia,12,0,20,8
1713482961234,LISP 5C,A00,507696,Munoz Sanchez; Alicia,11,0,20,9
1713482962260,MAE 197,001,528363,Boechler; Nicholas Sebastia,9998,0,9999,1
1713482963288,MATH 197,001,523477,Kedlaya; Kiran S.,9999,0,9999,0
1713482963288,MATH 197,002,563811,Zhang; Danna,9998,0,9999,1
1713482964317,MCWP 40R,A00,518780,Staff,17,0,20,3
1713482964317,MCWP 40R,B00,518781,Staff,14,0,20,6
1713482964317,MCWP 40R,C00,518783,Staff,11,0,20,9
1713482965347,MCWP 50R,A00,518791,Staff,8,0,20,12
1713482965347,MCWP 50R,B00,518792,Staff,7,0,20,13
1713482965347,MCWP 50R,C00,518793,Staff,7,0,20,13
1713482965347,MCWP 50R,D00,518794,Staff,1,0,20,19
1713482965347,MCWP 50R,E00,518795,Staff,3,0,20,17
1713482965347,MCWP 50R,F00,518796,Staff,13,0,20,7
1713482965347,MCWP 50R,G00,518797,Staff,12,0,20,8
1713482966374,MMW 12R,A01,514034,Herbst; Matthew,8,0,16,8
1713482966374,MMW 12R,A02,514035,Herbst; Matthew,13,0,16,3
1713482967399,MMW 13R,A01,514037,Staff,0,1,16,16
1713482967399,MMW 13R,A02,514039,Staff,0,1,16,16
1713482969449,SIO 295LS,A00,523233,Staff,15,0,30,15
1713482970474,SIO 295S,A00,523232,Staff,15,0,30,15
1713482971508,SOCI 117,A01,494376,Staff,0,2,5,5
1713482972537,WES 237B,A00,494380,Staff,19,0,20,1
1713482974603,AESE 279B,A00,494370,Wade; Jon P,33,0,33,0
1713482975629,AIP 197,001,627712,Vespa; Emanuel Ignacio,9999,0,9999,0
1713482976659,ANAR 135S,A00,494369,Braswell; Geoffrey E.,0,0,0,0
1713482977687,CAT 124RS,A01,519847,Geibel; William,6,0,20,14
1713482978712,CAT 125RS,A01,515971,Geibel; William,6,0,20,14
1713482979738,CLRE 250,A00,511389,Morris; Sheldon,9996,0,9999,3
1713482980766,CLRE 251,A00,507176,Mehta; Ravindra L.,9996,0,9999,3
1713482980766,CLRE 251,B00,511410,Mehta; Ravindra L.,9998,0,9999,1
1713482981792,CLRE 252,A00,507189,Cuomo; Raphael Eduardo,9998,0,9999,1
1713482982874,CLRE 253,A00,507199,Vaida; Florin,9997,0,9999,2
1713482982874,CLRE 253,B00,507202,Vaida; Florin,9999,0,9999,0
1713482983900,CLRE 259,A00,507211,Patel; Hemal,9996,0,9999,3
1713482984928,CLRE 260,A00,507221,Cuomo; Raphael Eduardo,9999,0,9999,0
1713482985953,CLRE 297,001,507242,Cuomo; Raphael Eduardo,9999,0,9999,0
1713482986979,CSE 191,A00,516875,Minnes Kemp; Mor Mia,9999,0,9999,0
1713482988005,CSS 201S,A01,494383,Staff,35,0,35,0
1713482989030,CSS 202S,A01,494387,Staff,35,0,35,0
1713482990055,EAP 100,A00,516065,Staff,9792,0,9999,207
1713482991081,ECE 45,A01,507414,Staff,38,0,60,22
1713482992110,ECE 100,A01,507416,Baghdadchi; Saharnaz,3,0,20,17
1713482992110,ECE 100,A02,507418,Baghdadchi; Saharnaz,19,0,20,1
1713482993138,ECE 111,A01,507420,Staff,28,0,50,22
1713482994164,ECE 197,001,548057,Sievenpiper; Daniel F.,9998,0,9999,1
1713482995196,EDS 115,A00,507243,Choi; Bailey Miyeon,27,0,28,1
1713482996226,EDS 117,A01,494379,Staff,16,0,25,9
1713482997255,EDS 125,A00,507246,Hopkins; Megan Beth,28,0,30,2
1713482998282,EDS 128A,A01,507264,Fargason; Sharon Gayle,26,0,26,0
1713482999310,EDS 128B,A01,507293,Pappas; Elizabeth,30,0,30,0
1713483000335,EDS 139,A00,507294,Fargason; Sharon Gayle,30,0,30,0
1713483000335,EDS 139,B00,507313,Pappas; Elizabeth,30,0,30,0
1713483001359,EDS 201,A00,507315,Staff,19,0,30,11
1713483002390,EDS 203,A01,507317,Halter; Christopher P.,18,0,30,12
1713483003420,EDS 204R,A01,507319,Halter; Christopher P.,0,1,30,30
1713483003420,EDS 204R,B01,507331,Heinzman; Erica M.,26,0,30,4
1713483004446,EDS 206R,A00,507332,Staff,0,1,30,30
1713483004446,EDS 206R,B00,507343,Staff,27,0,30,3
1713483005472,EDS 250,A00,507344,Hemans; Patricia Ann Benitez,28,0,40,12
1713483006499,EDS 281,A00,507345,Daly; Alan J.,18,0,18,0
1713483007527,EDS 284,A00,507350,Daly; Alan J.,16,0,16,0
1713483008553,EDS 286,A00,507359,Fine; Sarah,18,0,18,0
1713483009581,EDS 289C,A01,507361,Daly; Alan J.,18,0,18,0
1713483010606,EDS 290,A00,507366,Hofstetter; Carolyn,15,0,15,0
1713483011642,LIGM 5A,A00,507421,Fischer-Grunski; Eva K,20,0,20,0
1713483012666,LIGM 5B,A00,507423,Fischer-Grunski; Eva K,20,0,20,0
1713483013701,LIGM 5C,A00,507425,Fischer-Grunski; Eva K,20,0,20,0
1713483014731,LIIT 5AS,A00,507427,Carnelos; Chiara,20,0,20,0
1713483015758,LIIT 5BS,A00,507430,Carnelos; Chiara,20,0,20,0
1713483016786,LIIT 5CS,A00,507432,Carnelos; Chiara,20,0,20,0
1713483017816,LISP 5A,A00,507541,Munoz Sanchez; Alicia,14,0,20,6
1713483018846,LISP 5B,A00,507671,Munoz Sanchez; Alicia,12,0,20,8
1713483019877,LISP 5C,A00,507696,Munoz Sanchez; Alicia,11,0,20,9
1713483020909,MAE 197,001,528363,Boechler; Nicholas Sebastia,9998,0,9999,1
1713483021941,MATH 197,001,523477,Kedlaya; Kiran S.,9999,0,9999,0
1713483021941,MATH 197,002,563811,Zhang; Danna,9998,0,9999,1
1713483022967,MCWP 40R,A00,518780,Staff,17,0,20,3
1713483022967,MCWP 40R,B00,518781,Staff,14,0,20,6
1713483022967,MCWP 40R,C00,518783,Staff,11,0,20,9
1713483023992,MCWP 50R,A00,518791,Staff,8,0,20,12
1713483023992,MCWP 50R,B00,518792,Staff,7,0,20,13
1713483023992,MCWP 50R,C00,518793,Staff,7,0,20,13
1713483023992,MCWP 50R,D00,518794,Staff,1,0,20,19
1713483023992,MCWP 50R,E00,518795,Staff,3,0,20,17
1713483023992,MCWP 50R,F00,518796,Staff,13,0,20,7
1713483023992,MCWP 50R,G00,518797,Staff,12,0,20,8
1713483025017,MMW 12R,A01,514034,Herbst; Matthew,8,0,16,8
1713483025017,MMW 12R,A02,514035,Herbst; Matthew,13,0,16,3
1713483026042,MMW 13R,A01,514037,Staff,0,1,16,16
1713483026042,MMW 13R,A02,514039,Staff,0,1,16,16
1713483028091,SIO 295LS,A00,523233,Staff,15,0,30,15
1713483029115,SIO 295S,A00,523232,Staff,15,0,30,15
1713483030141,SOCI 117,A01,494376,Staff,0,2,5,5
1713483031166,WES 237B,A00,494380,Staff,19,0,20,1
1713483033242,AESE 279B,A00,494370,Wade; Jon P,33,0,33,0
1713483034270,AIP 197,001,627712,Vespa; Emanuel Ignacio,9999,0,9999,0
1713483035294,ANAR 135S,A00,494369,Braswell; Geoffrey E.,0,0,0,0
1713483036320,CAT 124RS,A01,519847,Geibel; William,6,0,20,14
1713483037344,CAT 125RS,A01,515971,Geibel; William,6,0,20,14
1713483038369,CLRE 250,A00,511389,Morris; Sheldon,9996,0,9999,3
1713483039396,CLRE 251,A00,507176,Mehta; Ravindra L.,9996,0,9999,3
1713483039396,CLRE 251,B00,511410,Mehta; Ravindra L.,9998,0,9999,1
1713483040423,CLRE 252,A00,507189,Cuomo; Raphael Eduardo,9998,0,9999,1
1713483041450,CLRE 253,A00,507199,Vaida; Florin,9997,0,9999,2
1713483041450,CLRE 253,B00,507202,Vaida; Florin,9999,0,9999,0
1713483042480,CLRE 259,A00,507211,Patel; Hemal,9996,0,9999,3
1713483043504,CLRE 260,A00,507221,Cuomo; Raphael Eduardo,9999,0,9999,0
1713483044530,CLRE 297,001,507242,Cuomo; Raphael Eduardo,9999,0,9999,0
1713483045554,CSE 191,A00,516875,Minnes Kemp; Mor Mia,9999,0,9999,0
1713483046578,CSS 201S,A01,494383,Staff,35,0,35,0
1713483047607,CSS 202S,A01,494387,Staff,35,0,35,0
1713483048633,EAP 100,A00,516065,Staff,9792,0,9999,207
1713483049662,ECE 45,A01,507414,Staff,38,0,60,22
1713483050691,ECE 100,A01,507416,Baghdadchi; Saharnaz,3,0,20,17
1713483050691,ECE 100,A02,507418,Baghdadchi; Saharnaz,19,0,20,1
1713483051722,ECE 111,A01,507420,Staff,28,0,50,22
1713483052748,ECE 197,001,548057,Sievenpiper; Daniel F.,9998,0,9999,1
1713483053778,EDS 115,A00,507243,Choi; Bailey Miyeon,27,0,28,1
1713483054807,EDS 117,A01,494379,Staff,16,0,25,9
1713483055833,EDS 125,A00,507246,Hopkins; Megan Beth,28,0,30,2
1713483056862,EDS 128A,A01,507264,Fargason; Sharon Gayle,26,0,26,0
1713483057888,EDS 128B,A01,507293,Pappas; Elizabeth,30,0,30,0
1713483058913,EDS 139,A00,507294,Fargason; Sharon Gayle,30,0,30,0
1713483058913,EDS 139,B00,507313,Pappas; Elizabeth,30,0,30,0
1713483059938,EDS 201,A00,507315,Staff,19,0,30,11
1713483060963,EDS 203,A01,507317,Halter; Christopher P.,18,0,30,12
1713483061990,EDS 204R,A01,507319,Halter; Christopher P.,0,1,30,30
1713483061990,EDS 204R,B01,507331,Heinzman; Erica M.,26,0,30,4
1713483063016,EDS 206R,A00,507332,Staff,0,1,30,30
1713483063016,EDS 206R,B00,507343,Staff,27,0,30,3
1713483064048,EDS 250,A00,507344,Hemans; Patricia Ann Benitez,28,0,40,12
1713483065080,EDS 281,A00,507345,Daly; Alan J.,18,0,18,0
1713483066106,EDS 284,A00,507350,Daly; Alan J.,16,0,16,0
1713483067132,EDS 286,A00,507359,Fine; Sarah,18,0,18,0
1713483068158,EDS 289C,A01,507361,Daly; Alan J.,18,0,18,0
1713483069186,EDS 290,A00,507366,Hofstetter; Carolyn,15,0,15,0
1713483070218,LIGM 5A,A00,507421,Fischer-Grunski; Eva K,20,0,20,0
1713483071243,LIGM 5B,A00,507423,Fischer-Grunski; Eva K,20,0,20,0
1713483072269,LIGM 5C,A00,507425,Fischer-Grunski; Eva K,20,0,20,0
1713483073318,LIIT 5AS,A00,507427,Carnelos; Chiara,20,0,20,0
1713483074344,LIIT 5BS,A00,507430,Carnelos; Chiara,20,0,20,0
1713483075376,LIIT 5CS,A00,507432,Carnelos; Chiara,20,0,20,0
1713483076408,LISP 5A,A00,507541,Munoz Sanchez; Alicia,14,0,20,6
1713483077435,LISP 5B,A00,507671,Munoz Sanchez; Alicia,12,0,20,8
1713483078459,LISP 5C,A00,507696,Munoz Sanchez; Alicia,11,0,20,9
1713483079483,MAE 197,001,528363,Boechler; Nicholas Sebastia,9998,0,9999,1
1713483080509,MATH 197,001,523477,Kedlaya; Kiran S.,9999,0,9999,0
1713483080509,MATH 197,002,563811,Zhang; Danna,9998,0,9999,1
1713483081535,MCWP 40R,A00,518780,Staff,17,0,20,3
1713483081535,MCWP 40R,B00,518781,Staff,14,0,20,6
1713483081535,MCWP 40R,C00,518783,Staff,11,0,20,9
1713483082563,MCWP 50R,A00,518791,Staff,8,0,20,12
1713483082563,MCWP 50R,B00,518792,Staff,7,0,20,13
1713483082563,MCWP 50R,C00,518793,Staff,7,0,20,13
1713483082563,MCWP 50R,D00,518794,Staff,1,0,20,19
1713483082563,MCWP 50R,E00,518795,Staff,3,0,20,17
1713483082563,MCWP 50R,F00,518796,Staff,13,0,20,7
1713483082563,MCWP 50R,G00,518797,Staff,12,0,20,8
1713483083588,MMW 12R,A01,514034,Herbst; Matthew,8,0,16,8
1713483083588,MMW 12R,A02,514035,Herbst; Matthew,13,0,16,3
1713483084616,MMW 13R,A01,514037,Staff,0,1,16,16
1713483084616,MMW 13R,A02,514039,Staff,0,1,16,16
1713483086719,SIO 295LS,A00,523233,Staff,15,0,30,15
1713483087745,SIO 295S,A00,523232,Staff,15,0,30,15
1713483088774,SOCI 117,A01,494376,Staff,0,2,5,5
1713483089802,WES 237B,A00,494380,Staff,19,0,20,1
1713483091866,AESE 279B,A00,494370,Wade; Jon P,33,0,33,0
1713483092892,AIP 197,001,627712,Vespa; Emanuel Ignacio,9999,0,9999,0
1713483093919,ANAR 135S,A00,494369,Braswell; Geoffrey E.,0,0,0,0
1713483094944,CAT 124RS,A01,519847,Geibel; William,6,0,20,14
1713483095973,CAT 125RS,A01,515971,Geibel; William,6,0,20,14
1713483096998,CLRE 250,A00,511389,Morris; Sheldon,9996,0,9999,3
1713483098031,CLRE 251,A00,507176,Mehta; Ravindra L.,9996,0,9999,3
1713483098031,CLRE 251,B00,511410,Mehta; Ravindra L.,9998,0,9999,1
1713483099062,CLRE 252,A00,507189,Cuomo; Raphael Eduardo,9998,0,9999,1
1713483100092,CLRE 253,A00,507199,Vaida; Florin,9997,0,9999,2
1713483100092,CLRE 253,B00,507202,Vaida; Florin,9999,0,9999,0
1713483101118,CLRE 259,A00,507211,Patel; Hemal,9996,0,9999,3
1713483102144,CLRE 260,A00,507221,Cuomo; Raphael Eduardo,9999,0,9999,0
1713483103168,CLRE 297,001,507242,Cuomo; Raphael Eduardo,9999,0,9999,0
1713483104193,CSE 191,A00,516875,Minnes Kemp; Mor Mia,9999,0,9999,0
1713483105218,CSS 201S,A01,494383,Staff,35,0,35,0
1713483106246,CSS 202S,A01,494387,Staff,35,0,35,0
1713483107274,EAP 100,A00,516065,Staff,9792,0,9999,207
1713483108300,ECE 45,A01,507414,Staff,38,0,60,22
1713483109329,ECE 100,A01,507416,Baghdadchi; Saharnaz,3,0,20,17
1713483109329,ECE 100,A02,507418,Baghdadchi; Saharnaz,19,0,20,1
1713483110353,ECE 111,A01,507420,Staff,28,0,50,22
1713483111378,ECE 197,001,548057,Sievenpiper; Daniel F.,9998,0,9999,1
1713483112410,EDS 115,A00,507243,Choi; Bailey Miyeon,27,0,28,1
1713483113447,EDS 117,A01,494379,Staff,16,0,25,9
1713483114477,EDS 125,A00,507246,Hopkins; Megan Beth,28,0,30,2
1713483115507,EDS 128A,A01,507264,Fargason; Sharon Gayle,26,0,26,0
1713483116532,EDS 128B,A01,507293,Pappas; Elizabeth,30,0,30,0
1713483117561,EDS 139,A00,507294,Fargason; Sharon Gayle,30,0,30,0
1713483117561,EDS 139,B00,507313,Pappas; Elizabeth,30,0,30,0
1713483118586,EDS 201,A00,507315,Staff,19,0,30,11
1713483119617,EDS 203,A01,507317,Halter; Christopher P.,18,0,30,12
1713483120645,EDS 204R,A01,507319,Halter; Christopher P.,0,1,30,30
1713483120645,EDS 204R,B01,507331,Heinzman; Erica M.,26,0,30,4
1713483121670,EDS 206R,A00,507332,Staff,0,1,30,30
1713483121670,EDS 206R,B00,507343,Staff,27,0,30,3
1713483122701,EDS 250,A00,507344,Hemans; Patricia Ann Benitez,28,0,40,12
1713483123729,EDS 281,A00,507345,Daly; Alan J.,18,0,18,0
1713483124755,EDS 284,A00,507350,Daly; Alan J.,16,0,16,0
1713483125782,EDS 286,A00,507359,Fine; Sarah,18,0,18,0
1713483126808,EDS 289C,A01,507361,Daly; Alan J.,18,0,18,0
1713483127834,EDS 290,A00,507366,Hofstetter; Carolyn,15,0,15,0
1713483128860,LIGM 5A,A00,507421,Fischer-Grunski; Eva K,20,0,20,0
1713483129886,LIGM 5B,A00,507423,Fischer-Grunski; Eva K,20,0,20,0
1713483130917,LIGM 5C,A00,507425,Fischer-Grunski; Eva K,20,0,20,0
1713483131951,LIIT 5AS,A00,507427,Carnelos; Chiara,20,0,20,0
1713483132979,LIIT 5BS,A00,507430,Carnelos; Chiara,20,0,20,0
1713483134004,LIIT 5CS,A00,507432,Carnelos; Chiara,20,0,20,0
1713483135030,LISP 5A,A00,507541,Munoz Sanchez; Alicia,14,0,20,6
1713483136055,LISP 5B,A00,507671,Munoz Sanchez; Alicia,12,0,20,8
1713483137081,LISP 5C,A00,507696,Munoz Sanchez; Alicia,11,0,20,9
1713483138107,MAE 197,001,528363,Boechler; Nicholas Sebastia,9998,0,9999,1
1713483139131,MATH 197,001,523477,Kedlaya; Kiran S.,9999,0,9999,0
1713483139131,MATH 197,002,563811,Zhang; Danna,9998,0,9999,1
1713483140160,MCWP 40R,A00,518780,Staff,17,0,20,3
1713483140160,MCWP 40R,B00,518781,Staff,14,0,20,6
1713483140160,MCWP 40R,C00,518783,Staff,11,0,20,9
1713483141186,MCWP 50R,A00,518791,Staff,8,0,20,12
1713483141186,MCWP 50R,B00,518792,Staff,7,0,20,13
1713483141186,MCWP 50R,C00,518793,Staff,7,0,20,13
1713483141186,MCWP 50R,D00,518794,Staff,1,0,20,19
1713483141186,MCWP 50R,E00,518795,Staff,3,0,20,17
1713483141186,MCWP 50R,F00,518796,Staff,13,0,20,7
1713483141186,MCWP 50R,G00,518797,Staff,12,0,20,8
1713483142211,MMW 12R,A01,514034,Herbst; Matthew,8,0,16,8
1713483142211,MMW 12R,A02,514035,Herbst; Matthew,13,0,16,3
1713483143237,MMW 13R,A01,514037,Staff,0,1,16,16
1713483143237,MMW 13R,A02,514039,Staff,0,1,16,16
1713483145298,SIO 295LS,A00,523233,Staff,15,0,30,15
1713483146324,SIO 295S,A00,523232,Staff,15,0,30,15
1713483147354,SOCI 117,A01,494376,Staff,0,2,5,5
1713483148383,WES 237B,A00,494380,Staff,19,0,20,1
1713483150449,AESE 279B,A00,494370,Wade; Jon P,33,0,33,0
1713483151477,AIP 197,001,627712,Vespa; Emanuel Ignacio,9999,0,9999,0
1713483152507,ANAR 135S,A00,494369,Braswell; Geoffrey E.,0,0,0,0
1713483153534,CAT 124RS,A01,519847,Geibel; William,6,0,20,14
1713483154560,CAT 125RS,A01,515971,Geibel; William,6,0,20,14
1713483155589,CLRE 250,A00,511389,Morris; Sheldon,9996,0,9999,3
1713483156621,CLRE 251,A00,507176,Mehta; Ravindra L.,9996,0,9999,3
1713483156621,CLRE 251,B00,511410,Mehta; Ravindra L.,9998,0,9999,1
1713483157646,CLRE 252,A00,507189,Cuomo; Raphael Eduardo,9998,0,9999,1
1713483158676,CLRE 253,A00,507199,Vaida; Florin,9997,0,9999,2
1713483158676,CLRE 253,B00,507202,Vaida; Florin,9999,0,9999,0
1713483159707,CLRE 259,A00,507211,Patel; Hemal,9996,0,9999,3
1713483160732,CLRE 260,A00,507221,Cuomo; Raphael Eduardo,9999,0,9999,0
1713483161762,CLRE 297,001,507242,Cuomo; Raphael Eduardo,9999,0,9999,0
1713483162790,CSE 191,A00,516875,Minnes Kemp; Mor Mia,9999,0,9999,0
1713483163820,CSS 201S,A01,494383,Staff,35,0,35,0
1713483164844,CSS 202S,A01,494387,Staff,35,0,35,0
1713483165869,EAP 100,A00,516065,Staff,9792,0,9999,207
1713483166894,ECE 45,A01,507414,Staff,38,0,60,22
1713483167934,ECE 100,A01,507416,Baghdadchi; Saharnaz,3,0,20,17
1713483167934,ECE 100,A02,507418,Baghdadchi; Saharnaz,19,0,20,1
1713483168959,ECE 111,A01,507420,Staff,28,0,50,22
1713483169986,ECE 197,001,548057,Sievenpiper; Daniel F.,9998,0,9999,1
1713483171012,EDS 115,A00,507243,Choi; Bailey Miyeon,27,0,28,1
1713483172040,EDS 117,A01,494379,Staff,16,0,25,9
1713483173066,EDS 125,A00,507246,Hopkins; Megan Beth,28,0,30,2
1713483174094,EDS 128A,A01,507264,Fargason; Sharon Gayle,26,0,26,0
1713483175120,EDS 128B,A01,507293,Pappas; Elizabeth,30,0,30,0
1713483176149,EDS 139,A00,507294,Fargason; Sharon Gayle,30,0,30,0
1713483176149,EDS 139,B00,507313,Pappas; Elizabeth,30,0,30,0
1713483177177,EDS 201,A00,507315,Staff,19,0,30,11
1713483178204,EDS 203,A01,507317,Halter; Christopher P.,18,0,30,12
1713483179231,EDS 204R,A01,507319,Halter; Christopher P.,0,1,30,30
1713483179231,EDS 204R,B01,507331,Heinzman; Erica M.,26,0,30,4
1713483180261,EDS 206R,A00,507332,Staff,0,1,30,30
1713483180261,EDS 206R,B00,507343,Staff,27,0,30,3
1713483181292,EDS 250,A00,507344,Hemans; Patricia Ann Benitez,28,0,40,12
1713483182318,EDS 281,A00,507345,Daly; Alan J.,18,0,18,0
1713483183346,EDS 284,A00,507350,Daly; Alan J.,16,0,16,0
1713483184372,EDS 286,A00,507359,Fine; Sarah,18,0,18,0
1713483185397,EDS 289C,A01,507361,Daly; Alan J.,18,0,18,0
1713483186426,EDS 290,A00,507366,Hofstetter; Carolyn,15,0,15,0
1713483187453,LIGM 5A,A00,507421,Fischer-Grunski; Eva K,20,0,20,0
1713483188477,LIGM 5B,A00,507423,Fischer-Grunski; Eva K,20,0,20,0
1713483189502,LIGM 5C,A00,507425,Fischer-Grunski; Eva K,20,0,20,0
1713483190599,LIIT 5AS,A00,507427,Carnelos; Chiara,20,0,20,0
1713483191626,LIIT 5BS,A00,507430,Carnelos; Chiara,20,0,20,0
1713483192655,LIIT 5CS,A00,507432,Carnelos; Chiara,20,0,20,0
1713483193680,LISP 5A,A00,507541,Munoz Sanchez; Alicia,14,0,20,6
1713483194705,LISP 5B,A00,507671,Munoz Sanchez; Alicia,12,0,20,8
1713483195729,LISP 5C,A00,507696,Munoz Sanchez; Alicia,11,0,20,9
1713483196755,MAE 197,001,528363,Boechler; Nicholas Sebastia,9998,0,9999,1
1713483197786,MATH 197,001,523477,Kedlaya; Kiran S.,9999,0,9999,0
1713483197786,MATH 197,002,563811,Zhang; Danna,9998,0,9999,1
1713483198814,MCWP 40R,A00,518780,Staff,17,0,20,3
1713483198814,MCWP 40R,B00,518781,Staff,14,0,20,6
1713483198814,MCWP 40R,C00,518783,Staff,11,0,20,9
1713483199844,MCWP 50R,A00,518791,Staff,8,0,20,12
1713483199844,MCWP 50R,B00,518792,Staff,7,0,20,13
1713483199844,MCWP 50R,C00,518793,Staff,7,0,20,13
1713483199844,MCWP 50R,D00,518794,Staff,1,0,20,19
1713483199844,MCWP 50R,E00,518795,Staff,3,0,20,17
1713483199844,MCWP 50R,F00,518796,Staff,13,0,20,7
1713483199844,MCWP 50R,G00,518797,Staff,12,0,20,8
1713483200869,MMW 12R,A01,514034,Herbst; Matthew,8,0,16,8
1713483200869,MMW 12R,A02,514035,Herbst; Matthew,13,0,16,3
1713483201895,MMW 13R,A01,514037,Staff,0,1,16,16
1713483201895,MMW 13R,A02,514039,Staff,0,1,16,16
1713483203948,SIO 295LS,A00,523233,Staff,15,0,30,15
1713483204975,SIO 295S,A00,523232,Staff,15,0,30,15
1713483206002,SOCI 117,A01,494376,Staff,0,2,5,5
1713483207026,WES 237B,A00,494380,Staff,19,0,20,1
1713483209091,AESE 279B,A00,494370,Wade; Jon P,33,0,33,0
1713483210118,AIP 197,001,627712,Vespa; Emanuel Ignacio,9999,0,9999,0
1713483211144,ANAR 135S,A00,494369,Braswell; Geoffrey E.,0,0,0,0
1713483212173,CAT 124RS,A01,519847,Geibel; William,6,0,20,14
1713483213198,CAT 125RS,A01,515971,Geibel; William,6,0,20,14
1713483214226,CLRE 250,A00,511389,Morris; Sheldon,9996,0,9999,3
1713483215259,CLRE 251,A00,507176,Mehta; Ravindra L.,9996,0,9999,3
1713483215259,CLRE 251,B00,511410,Mehta; Ravindra L.,9998,0,9999,1
1713483216286,CLRE 252,A00,507189,Cuomo; Raphael Eduardo,9998,0,9999,1
1713483217317,CLRE 253,A00,507199,Vaida; Florin,9997,0,9999,2
1713483217317,CLRE 253,B00,507202,Vaida; Florin,9999,0,9999,0
1713483218344,CLRE 259,A00,507211,Patel; Hemal,9996,0,9999,3
1713483219371,CLRE 260,A00,507221,Cuomo; Raphael Eduardo,9999,0,9999,0
1713483220397,CLRE 297,001,507242,Cuomo; Raphael Eduardo,9999,0,9999,0
1713483221424,CSE 191,A00,516875,Minnes Kemp; Mor Mia,9999,0,9999,0
1713483222450,CSS 201S,A01,494383,Staff,35,0,35,0
1713483223477,CSS 202S,A01,494387,Staff,35,0,35,0
1713483224505,EAP 100,A00,516065,Staff,9792,0,9999,207
1713483225531,ECE 45,A01,507414,Staff,38,0,60,22
1713483226557,ECE 100,A01,507416,Baghdadchi; Saharnaz,3,0,20,17
1713483226557,ECE 100,A02,507418,Baghdadchi; Saharnaz,19,0,20,1
1713483227585,ECE 111,A01,507420,Staff,28,0,50,22
1713483228615,ECE 197,001,548057,Sievenpiper; Daniel F.,9998,0,9999,1
1713483229641,EDS 115,A00,507243,Choi; Bailey Miyeon,27,0,28,1
1713483230665,EDS 117,A01,494379,Staff,16,0,25,9
1713483231694,EDS 125,A00,507246,Hopkins; Megan Beth,28,0,30,2
1713483232722,EDS 128A,A01,507264,Fargason; Sharon Gayle,26,0,26,0
1713483233748,EDS 128B,A01,507293,Pappas; Elizabeth,30,0,30,0
1713483234773,EDS 139,A00,507294,Fargason; Sharon Gayle,30,0,30,0
1713483234773,EDS 139,B00,507313,Pappas; Elizabeth,30,0,30,0
1713483235799,EDS 201,A00,507315,Staff,19,0,30,11
1713483236829,EDS 203,A01,507317,Halter; Christopher P.,18,0,30,12
1713483237855,EDS 204R,A01,507319,Halter; Christopher P.,0,1,30,30
1713483237855,EDS 204R,B01,507331,Heinzman; Erica M.,26,0,30,4
1713483238881,EDS 206R,A00,507332,Staff,0,1,30,30
1713483238881,EDS 206R,B00,507343,Staff,27,0,30,3
1713483239905,EDS 250,A00,507344,Hemans; Patricia Ann Benitez,28,0,40,12
1713483240935,EDS 281,A00,507345,Daly; Alan J.,18,0,18,0
1713483241961,EDS 284,A00,507350,Daly; Alan J.,16,0,16,0
1713483242987,EDS 286,A00,507359,Fine; Sarah,18,0,18,0
1713483244013,EDS 289C,A01,507361,Daly; Alan J.,18,0,18,0
1713483245041,EDS 290,A00,507366,Hofstetter; Carolyn,15,0,15,0
1713483246080,LIGM 5A,A00,507421,Fischer-Grunski; Eva K,20,0,20,0
1713483247104,LIGM 5B,A00,507423,Fischer-Grunski; Eva K,20,0,20,0
1713483248134,LIGM 5C,A00,507425,Fischer-Grunski; Eva K,20,0,20,0
1713483249164,LIIT 5AS,A00,507427,Carnelos; Chiara,20,0,20,0
1713483250194,LIIT 5BS,A00,507430,Carnelos; Chiara,20,0,20,0
1713483251224,LIIT 5CS,A00,507432,Carnelos; Chiara,20,0,20,0
1713483252248,LISP 5A,A00,507541,Munoz Sanchez; Alicia,14,0,20,6
1713483253272,LISP 5B,A00,507671,Munoz Sanchez; Alicia,12,0,20,8
1713483254302,LISP 5C,A00,507696,Munoz Sanchez; Alicia,11,0,20,9
1713483255330,MAE 197,001,528363,Boechler; Nicholas Sebastia,9998,0,9999,1
1713483256355,MATH 197,001,523477,Kedlaya; Kiran S.,9999,0,9999,0
1713483256355,MATH 197,002,563811,Zhang; Danna,9998,0,9999,1
1713483257381,MCWP 40R,A00,518780,Staff,17,0,20,3
1713483257381,MCWP 40R,B00,518781,Staff,14,0,20,6
1713483257381,MCWP 40R,C00,518783,Staff,11,0,20,9
1713483258409,MCWP 50R,A00,518791,Staff,8,0,20,12
1713483258409,MCWP 50R,B00,518792,Staff,7,0,20,13
1713483258409,MCWP 50R,C00,518793,Staff,7,0,20,13
1713483258409,MCWP 50R,D00,518794,Staff,1,0,20,19
1713483258409,MCWP 50R,E00,518795,Staff,3,0,20,17
1713483258409,MCWP 50R,F00,518796,Staff,13,0,20,7
1713483258409,MCWP 50R,G00,518797,Staff,12,0,20,8
1713483259434,MMW 12R,A01,514034,Herbst; Matthew,8,0,16,8
1713483259434,MMW 12R,A02,514035,Herbst; Matthew,13,0,16,3
1713483260463,MMW 13R,A01,514037,Staff,0,1,16,16
1713483260463,MMW 13R,A02,514039,Staff,0,1,16,16
1713483262514,SIO 295LS,A00,523233,Staff,15,0,30,15
1713483263543,SIO 295S,A00,523232,Staff,15,0,30,15
1713483264573,SOCI 117,A01,494376,Staff,0,2,5,5
1713483265598,WES 237B,A00,494380,Staff,19,0,20,1
1713483267672,AESE 279B,A00,494370,Wade; Jon P,33,0,33,0
1713483268697,AIP 197,001,627712,Vespa; Emanuel Ignacio,9999,0,9999,0
1713483269725,ANAR 135S,A00,494369,Braswell; Geoffrey E.,0,0,0,0
1713483270757,CAT 124RS,A01,519847,Geibel; William,6,0,20,14
1713483271784,CAT 125RS,A01,515971,Geibel; William,6,0,20,14
1713483272809,CLRE 250,A00,511389,Morris; Sheldon,9996,0,9999,3
1713483273837,CLRE 251,A00,507176,Mehta; Ravindra L.,9996,0,9999,3
1713483273837,CLRE 251,B00,511410,Mehta; Ravindra L.,9998,0,9999,1
1713483274867,CLRE 252,A00,507189,Cuomo; Raphael Eduardo,9998,0,9999,1
1713483275894,CLRE 253,A00,507199,Vaida; Florin,9997,0,9999,2
1713483275894,CLRE 253,B00,507202,Vaida; Florin,9999,0,9999,0
1713483276919,CLRE 259,A00,507211,Patel; Hemal,9996,0,9999,3
1713483277944,CLRE 260,A00,507221,Cuomo; Raphael Eduardo,9999,0,9999,0
1713483278969,CLRE 297,001,507242,Cuomo; Raphael Eduardo,9999,0,9999,0
1713483279994,CSE 191,A00,516875,Minnes Kemp; Mor Mia,9999,0,9999,0
1713483281019,CSS 201S,A01,494383,Staff,35,0,35,0
1713483282045,CSS 202S,A01,494387,Staff,35,0,35,0
1713483283069,EAP 100,A00,516065,Staff,9792,0,9999,207
1713483284099,ECE 45,A01,507414,Staff,38,0,60,22
1713483285129,ECE 100,A01,507416,Baghdadchi; Saharnaz,3,0,20,17
1713483285129,ECE 100,A02,507418,Baghdadchi; Saharnaz,19,0,20,1
1713483286153,ECE 111,A01,507420,Staff,28,0,50,22
1713483287179,ECE 197,001,548057,Sievenpiper; Daniel F.,9998,0,9999,1
1713483288206,EDS 115,A00,507243,Choi; Bailey Miyeon,27,0,28,1
1713483289234,EDS 117,A01,494379,Staff,16,0,25,9
1713483290260,EDS 125,A00,507246,Hopkins; Megan Beth,28,0,30,2
1713483291286,EDS 128A,A01,507264,Fargason; Sharon Gayle,26,0,26,0
1713483292311,EDS 128B,A01,507293,Pappas; Elizabeth,30,0,30,0
1713483293335,EDS 139,A00,507294,Fargason; Sharon Gayle,30,0,30,0
1713483293335,EDS 139,B00,507313,Pappas; Elizabeth,30,0,30,0
1713483294418,EDS 201,A00,507315,Staff,19,0,30,11
1713483295446,EDS 203,A01,507317,Halter; Christopher P.,18,0,30,12
1713483296472,EDS 204R,A01,507319,Halter; Christopher P.,0,1,30,30
1713483296472,EDS 204R,B01,507331,Heinzman; Erica M.,26,0,30,4
1713483297497,EDS 206R,A00,507332,Staff,0,1,30,30
1713483297497,EDS 206R,B00,507343,Staff,27,0,30,3
1713483298523,EDS 250,A00,507344,Hemans; Patricia Ann Benitez,28,0,40,12
1713483299550,EDS 281,A00,507345,Daly; Alan J.,18,0,18,0
1713483300573,EDS 284,A00,507350,Daly; Alan J.,16,0,16,0
1713483301603,EDS 286,A00,507359,Fine; Sarah,18,0,18,0
1713483302628,EDS 289C,A01,507361,Daly; Alan J.,18,0,18,0
1713483303656,EDS 290,A00,507366,Hofstetter; Carolyn,15,0,15,0
1713483304681,LIGM 5A,A00,507421,Fischer-Grunski; Eva K,20,0,20,0
1713483305709,LIGM 5B,A00,507423,Fischer-Grunski; Eva K,20,0,20,0
1713483306734,LIGM 5C,A00,507425,Fischer-Grunski; Eva K,20,0,20,0
1713483307782,LIIT 5AS,A00,507427,Carnelos; Chiara,20,0,20,0
1713483308812,LIIT 5BS,A00,507430,Carnelos; Chiara,20,0,20,0
1713483309836,LIIT 5CS,A00,507432,Carnelos; Chiara,20,0,20,0
1713483310861,LISP 5A,A00,507541,Munoz Sanchez; Alicia,14,0,20,6
1713483311890,LISP 5B,A00,507671,Munoz Sanchez; Alicia,12,0,20,8
1713483312920,LISP 5C,A00,507696,Munoz Sanchez; Alicia,11,0,20,9
1713483313946,MAE 197,001,528363,Boechler; Nicholas Sebastia,9998,0,9999,1
1713483314977,MATH 197,001,523477,Kedlaya; Kiran S.,9999,0,9999,0
1713483314977,MATH 197,002,563811,Zhang; Danna,9998,0,9999,1
1713483316007,MCWP 40R,A00,518780,Staff,17,0,20,3
1713483316007,MCWP 40R,B00,518781,Staff,14,0,20,6
1713483316007,MCWP 40R,C00,518783,Staff,11,0,20,9
1713483317035,MCWP 50R,A00,518791,Staff,8,0,20,12
1713483317035,MCWP 50R,B00,518792,Staff,7,0,20,13
1713483317035,MCWP 50R,C00,518793,Staff,7,0,20,13
1713483317035,MCWP 50R,D00,518794,Staff,1,0,20,19
1713483317035,MCWP 50R,E00,518795,Staff,3,0,20,17
1713483317035,MCWP 50R,F00,518796,Staff,13,0,20,7
1713483317035,MCWP 50R,G00,518797,Staff,12,0,20,8
1713483318066,MMW 12R,A01,514034,Herbst; Matthew,8,0,16,8
1713483318066,MMW 12R,A02,514035,Herbst; Matthew,13,0,16,3
1713483319096,MMW 13R,A01,514037,Staff,0,1,16,16
1713483319096,MMW 13R,A02,514039,Staff,0,1,16,16
1713483321153,SIO 295LS,A00,523233,Staff,15,0,30,15
1713483322179,SIO 295S,A00,523232,Staff,15,0,30,15
1713483323204,SOCI 117,A01,494376,Staff,0,2,5,5
1713483324233,WES 237B,A00,494380,Staff,19,0,20,1
1713483326307,AESE 279B,A00,494370,Wade; Jon P,33,0,33,0
1713483327333,AIP 197,001,627712,Vespa; Emanuel Ignacio,9999,0,9999,0
1713483328363,ANAR 135S,A00,494369,Braswell; Geoffrey E.,0,0,0,0
1713483329388,CAT 124RS,A01,519847,Geibel; William,6,0,20,14
1713483330413,CAT 125RS,A01,515971,Geibel; William,6,0,20,14
1713483331443,CLRE 250,A00,511389,Morris; Sheldon,9996,0,9999,3
1713483332475,CLRE 251,A00,507176,Mehta; Ravindra L.,9996,0,9999,3
1713483332475,CLRE 251,B00,511410,Mehta; Ravindra L.,9998,0,9999,1
1713483333502,CLRE 252,A00,507189,Cuomo; Raphael Eduardo,9998,0,9999,1
1713483334532,CLRE 253,A00,507199,Vaida; Florin,9997,0,9999,2
1713483334532,CLRE 253,B00,507202,Vaida; Florin,9999,0,9999,0
1713483335558,CLRE 259,A00,507211,Patel; Hemal,9996,0,9999,3
1713483336583,CLRE 260,A00,507221,Cuomo; Raphael Eduardo,9999,0,9999,0
1713483337609,CLRE 297,001,507242,Cuomo; Raphael Eduardo,9999,0,9999,0
1713483338638,CSE 191,A00,516875,Minnes Kemp; Mor Mia,9999,0,9999,0
1713483339664,CSS 201S,A01,494383,Staff,35,0,35,0
1713483340690,CSS 202S,A01,494387,Staff,35,0,35,0
1713483341717,EAP 100,A00,516065,Staff,9792,0,9999,207
1713483342745,ECE 45,A01,507414,Staff,38,0,60,22
1713483343772,ECE 100,A01,507416,Baghdadchi; Saharnaz,3,0,20,17
1713483343772,ECE 100,A02,507418,Baghdadchi; Saharnaz,19,0,20,1
1713483344800,ECE 111,A01,507420,Staff,28,0,50,22
1713483345827,ECE 197,001,548057,Sievenpiper; Daniel F.,9998,0,9999,1
1713483346858,EDS 115,A00,507243,Choi; Bailey Miyeon,27,0,28,1
1713483347888,EDS 117,A01,494379,Staff,16,0,25,9
1713483348914,EDS 125,A00,507246,Hopkins; Megan Beth,28,0,30,2
1713483349941,EDS 128A,A01,507264,Fargason; Sharon Gayle,26,0,26,0
1713483350967,EDS 128B,A01,507293,Pappas; Elizabeth,30,0,30,0
1713483351992,EDS 139,A00,507294,Fargason; Sharon Gayle,30,0,30,0
1713483351992,EDS 139,B00,507313,Pappas; Elizabeth,30,0,30,0
1713483353022,EDS 201,A00,507315,Staff,19,0,30,11
1713483354115,EDS 203,A01,507317,Halter; Christopher P.,18,0,30,12
1713483355142,EDS 204R,A01,507319,Halter; Christopher P.,0,1,30,30
1713483355142,EDS 204R,B01,507331,Heinzman; Erica M.,26,0,30,4
1713483356172,EDS 206R,A00,507332,Staff,0,1,30,30
1713483356172,EDS 206R,B00,507343,Staff,27,0,30,3
1713483357198,EDS 250,A00,507344,Hemans; Patricia Ann Benitez,28,0,40,12
1713483358223,EDS 281,A00,507345,Daly; Alan J.,18,0,18,0
1713483359250,EDS 284,A00,507350,Daly; Alan J.,16,0,16,0
1713483360275,EDS 286,A00,507359,Fine; Sarah,18,0,18,0
1713483361301,EDS 289C,A01,507361,Daly; Alan J.,18,0,18,0
1713483362327,EDS 290,A00,507366,Hofstetter; Carolyn,15,0,15,0
1713483363353,LIGM 5A,A00,507421,Fischer-Grunski; Eva K,20,0,20,0
1713483364380,LIGM 5B,A00,507423,Fischer-Grunski; Eva K,20,0,20,0
1713483365406,LIGM 5C,A00,507425,Fischer-Grunski; Eva K,20,0,20,0
1713483366436,LIIT 5AS,A00,507427,Carnelos; Chiara,20,0,20,0
1713483367463,LIIT 5BS,A00,507430,Carnelos; Chiara,20,0,20,0
1713483368488,LIIT 5CS,A00,507432,Carnelos; Chiara,20,0,20,0
1713483369514,LISP 5A,A00,507541,Munoz Sanchez; Alicia,14,0,20,6
1713483370545,LISP 5B,A00,507671,Munoz Sanchez; Alicia,12,0,20,8
1713483371570,LISP 5C,A00,507696,Munoz Sanchez; Alicia,11,0,20,9
1713483372601,MAE 197,001,528363,Boechler; Nicholas Sebastia,9998,0,9999,1
1713483373627,MATH 197,001,523477,Kedlaya; Kiran S.,9999,0,9999,0
1713483373627,MATH 197,002,563811,Zhang; Danna,9998,0,9999,1
1713483374655,MCWP 40R,A00,518780,Staff,17,0,20,3
1713483374655,MCWP 40R,B00,518781,Staff,14,0,20,6
1713483374655,MCWP 40R,C00,518783,Staff,11,0,20,9
1713483375682,MCWP 50R,A00,518791,Staff,8,0,20,12
1713483375682,MCWP 50R,B00,518792,Staff,7,0,20,13
1713483375682,MCWP 50R,C00,518793,Staff,7,0,20,13
1713483375682,MCWP 50R,D00,518794,Staff,1,0,20,19
1713483375682,MCWP 50R,E00,518795,Staff,3,0,20,17
1713483375682,MCWP 50R,F00,518796,Staff,13,0,20,7
1713483375682,MCWP 50R,G00,518797,Staff,12,0,20,8
1713483376707,MMW 12R,A01,514034,Herbst; Matthew,8,0,16,8
1713483376707,MMW 12R,A02,514035,Herbst; Matthew,13,0,16,3
1713483377736,MMW 13R,A01,514037,Staff,0,1,16,16
1713483377736,MMW 13R,A02,514039,Staff,0,1,16,16
1713483379791,SIO 295LS,A00,523233,Staff,15,0,30,15
1713483380821,SIO 295S,A00,523232,Staff,15,0,30,15
1713483381848,SOCI 117,A01,494376,Staff,0,2,5,5
1713483382873,WES 237B,A00,494380,Staff,19,0,20,1
1713483384949,AESE 279B,A00,494370,Wade; Jon P,33,0,33,0
1713483385975,AIP 197,001,627712,Vespa; Emanuel Ignacio,9999,0,9999,0
1713483387004,ANAR 135S,A00,494369,Braswell; Geoffrey E.,0,0,0,0
1713483388031,CAT 124RS,A01,519847,Geibel; William,6,0,20,14
1713483389055,CAT 125RS,A01,515971,Geibel; William,6,0,20,14
1713483390084,CLRE 250,A00,511389,Morris; Sheldon,9996,0,9999,3
1713483391110,CLRE 251,A00,507176,Mehta; Ravindra L.,9996,0,9999,3
1713483391110,CLRE 251,B00,511410,Mehta; Ravindra L.,9998,0,9999,1
1713483392140,CLRE 252,A00,507189,Cuomo; Raphael Eduardo,9998,0,9999,1
1713483393166,CLRE 253,A00,507199,Vaida; Florin,9997,0,9999,2
1713483393166,CLRE 253,B00,507202,Vaida; Florin,9999,0,9999,0
1713483394191,CLRE 259,A00,507211,Patel; Hemal,9996,0,9999,3
1713483395214,CLRE 260,A00,507221,Cuomo; Raphael Eduardo,9999,0,9999,0
1713483396243,CLRE 297,001,507242,Cuomo; Raphael Eduardo,9999,0,9999,0
1713483397269,CSE 191,A00,516875,Minnes Kemp; Mor Mia,9999,0,9999,0
1713483398350,CSS 201S,A01,494383,Staff,35,0,35,0
1713483399375,CSS 202S,A01,494387,Staff,35,0,35,0
1713483400406,EAP 100,A00,516065,Staff,9792,0,9999,207
1713483401434,ECE 45,A01,507414,Staff,38,0,60,22
1713483402460,ECE 100,A01,507416,Baghdadchi; Saharnaz,3,0,20,17
1713483402460,ECE 100,A02,507418,Baghdadchi; Saharnaz,19,0,20,1
1713483403486,ECE 111,A01,507420,Staff,28,0,50,22
1713483404516,ECE 197,001,548057,Sievenpiper; Daniel F.,9998,0,9999,1
1713483405543,EDS 115,A00,507243,Choi; Bailey Miyeon,27,0,28,1
1713483406568,EDS 117,A01,494379,Staff,16,0,25,9
1713483407595,EDS 125,A00,507246,Hopkins; Megan Beth,28,0,30,2
1713483408619,EDS 128A,A01,507264,Fargason; Sharon Gayle,26,0,26,0
1713483409645,EDS 128B,A01,507293,Pappas; Elizabeth,30,0,30,0
1713483410670,EDS 139,A00,507294,Fargason; Sharon Gayle,30,0,30,0
1713483410670,EDS 139,B00,507313,Pappas; Elizabeth,30,0,30,0
1713483411696,EDS 201,A00,507315,Staff,19,0,30,11
1713483412729,EDS 203,A01,507317,Halter; Christopher P.,18,0,30,12
1713483413760,EDS 204R,A01,507319,Halter; Christopher P.,0,1,30,30
1713483413760,EDS 204R,B01,507331,Heinzman; Erica M.,26,0,30,4
1713483414789,EDS 206R,A00,507332,Staff,0,1,30,30
1713483414789,EDS 206R,B00,507343,Staff,27,0,30,3
1713483415815,EDS 250,A00,507344,Hemans; Patricia Ann Benitez,28,0,40,12
1713483416839,EDS 281,A00,507345,Daly; Alan J.,18,0,18,0
1713483417867,EDS 284,A00,507350,Daly; Alan J.,16,0,16,0
1713483418892,EDS 286,A00,507359,Fine; Sarah,18,0,18,0
1713483419923,EDS 289C,A01,507361,Daly; Alan J.,18,0,18,0
1713483420947,EDS 290,A00,507366,Hofstetter; Carolyn,15,0,15,0
1713483421973,LIGM 5A,A00,507421,Fischer-Grunski; Eva K,20,0,20,0
1713483422998,LIGM 5B,A00,507423,Fischer-Grunski; Eva K,20,0,20,0
1713483424023,LIGM 5C,A00,507425,Fischer-Grunski; Eva K,20,0,20,0
1713483425053,LIIT 5AS,A00,507427,Carnelos; Chiara,20,0,20,0
1713483426077,LIIT 5BS,A00,507430,Carnelos; Chiara,20,0,20,0
1713483427101,LIIT 5CS,A00,507432,Carnelos; Chiara,20,0,20,0
1713483428132,LISP 5A,A00,507541,Munoz Sanchez; Alicia,14,0,20,6
1713483429160,LISP 5B,A00,507671,Munoz Sanchez; Alicia,12,0,20,8
1713483430184,LISP 5C,A00,507696,Munoz Sanchez; Alicia,11,0,20,9
1713483431209,MAE 197,001,528363,Boechler; Nicholas Sebastia,9998,0,9999,1
1713483432235,MATH 197,001,523477,Kedlaya; Kiran S.,9999,0,9999,0
1713483432235,MATH 197,002,563811,Zhang; Danna,9998,0,9999,1
1713483433260,MCWP 40R,A00,518780,Staff,17,0,20,3
1713483433260,MCWP 40R,B00,518781,Staff,14,0,20,6
1713483433260,MCWP 40R,C00,518783,Staff,11,0,20,9
1713483434288,MCWP 50R,A00,518791,Staff,8,0,20,12
1713483434288,MCWP 50R,B00,518792,Staff,7,0,20,13
1713483434288,MCWP 50R,C00,518793,Staff,7,0,20,13
1713483434288,MCWP 50R,D00,518794,Staff,1,0,20,19
1713483434288,MCWP 50R,E00,518795,Staff,3,0,20,17
1713483434288,MCWP 50R,F00,518796,Staff,13,0,20,7
1713483434288,MCWP 50R,G00,518797,Staff,12,0,20,8
1713483435318,MMW 12R,A01,514034,Herbst; Matthew,8,0,16,8
1713483435318,MMW 12R,A02,514035,Herbst; Matthew,13,0,16,3
1713483436342,MMW 13R,A01,514037,Staff,0,1,16,16
1713483436342,MMW 13R,A02,514039,Staff,0,2,16,16
1713483438396,SIO 295LS,A00,523233,Staff,15,0,30,15
1713483439426,SIO 295S,A00,523232,Staff,15,0,30,15
1713483440456,SOCI 117,A01,494376,Staff,0,2,5,5
1713483441485,WES 237B,A00,494380,Staff,19,0,20,1
1713483443553,AESE 279B,A00,494370,Wade; Jon P,33,0,33,0
1713483444582,AIP 197,001,627712,Vespa; Emanuel Ignacio,9999,0,9999,0
1713483445613,ANAR 135S,A00,494369,Braswell; Geoffrey E.,0,0,0,0
1713483446642,CAT 124RS,A01,519847,Geibel; William,6,0,20,14
1713483447670,CAT 125RS,A01,515971,Geibel; William,6,0,20,14
1713483448696,CLRE 250,A00,511389,Morris; Sheldon,9996,0,9999,3
1713483449728,CLRE 251,A00,507176,Mehta; Ravindra L.,9996,0,9999,3
1713483449728,CLRE 251,B00,511410,Mehta; Ravindra L.,9998,0,9999,1
1713483450754,CLRE 252,A00,507189,Cuomo; Raphael Eduardo,9998,0,9999,1
1713483451782,CLRE 253,A00,507199,Vaida; Florin,9997,0,9999,2
1713483451782,CLRE 253,B00,507202,Vaida; Florin,9999,0,9999,0
1713483452807,CLRE 259,A00,507211,Patel; Hemal,9996,0,9999,3
1713483453831,CLRE 260,A00,507221,Cuomo; Raphael Eduardo,9999,0,9999,0
1713483454857,CLRE 297,001,507242,Cuomo; Raphael Eduardo,9999,0,9999,0
1713483455886,CSE 191,A00,516875,Minnes Kemp; Mor Mia,9999,0,9999,0
1713483456912,CSS 201S,A01,494383,Staff,35,0,35,0
1713483457940,CSS 202S,A01,494387,Staff,35,0,35,0
1713483458964,EAP 100,A00,516065,Staff,9792,0,9999,207
1713483459993,ECE 45,A01,507414,Staff,38,0,60,22
1713483461025,ECE 100,A01,507416,Baghdadchi; Saharnaz,3,0,20,17
1713483461025,ECE 100,A02,507418,Baghdadchi; Saharnaz,19,0,20,1
1713483462052,ECE 111,A01,507420,Staff,28,0,50,22
1713483463077,ECE 197,001,548057,Sievenpiper; Daniel F.,9998,0,9999,1
1713483464106,EDS 115,A00,507243,Choi; Bailey Miyeon,27,0,28,1
1713483465135,EDS 117,A01,494379,Staff,16,0,25,9
1713483466162,EDS 125,A00,507246,Hopkins; Megan Beth,28,0,30,2
1713483467190,EDS 128A,A01,507264,Fargason; Sharon Gayle,26,0,26,0
1713483468215,EDS 128B,A01,507293,Pappas; Elizabeth,30,0,30,0
1713483469240,EDS 139,A00,507294,Fargason; Sharon Gayle,30,0,30,0
1713483469240,EDS 139,B00,507313,Pappas; Elizabeth,30,0,30,0
1713483470265,EDS 201,A00,507315,Staff,19,0,30,11
1713483471294,EDS 203,A01,507317,Halter; Christopher P.,18,0,30,12
1713483472321,EDS 204R,A01,507319,Halter; Christopher P.,0,1,30,30
1713483472321,EDS 204R,B01,507331,Heinzman; Erica M.,26,0,30,4
1713483473347,EDS 206R,A00,507332,Staff,0,1,30,30
1713483473347,EDS 206R,B00,507343,Staff,27,0,30,3
1713483474373,EDS 250,A00,507344,Hemans; Patricia Ann Benitez,28,0,40,12
1713483475400,EDS 281,A00,507345,Daly; Alan J.,18,0,18,0
1713483476486,EDS 284,A00,507350,Daly; Alan J.,16,0,16,0
1713483477515,EDS 286,A00,507359,Fine; Sarah,18,0,18,0
1713483478541,EDS 289C,A01,507361,Daly; Alan J.,18,0,18,0
1713483479567,EDS 290,A00,507366,Hofstetter; Carolyn,15,0,15,0
1713483480795,LIGM 5A,A00,507421,Fischer-Grunski; Eva K,20,0,20,0
1713483481825,LIGM 5B,A00,507423,Fischer-Grunski; Eva K,20,0,20,0
1713483482850,LIGM 5C,A00,507425,Fischer-Grunski; Eva K,20,0,20,0
1713483483876,LIIT 5AS,A00,507427,Carnelos; Chiara,20,0,20,0
1713483484905,LIIT 5BS,A00,507430,Carnelos; Chiara,20,0,20,0
1713483485930,LIIT 5CS,A00,507432,Carnelos; Chiara,20,0,20,0
1713483486958,LISP 5A,A00,507541,Munoz Sanchez; Alicia,14,0,20,6
1713483487986,LISP 5B,A00,507671,Munoz Sanchez; Alicia,12,0,20,8
1713483489014,LISP 5C,A00,507696,Munoz Sanchez; Alicia,11,0,20,9
1713483490045,MAE 197,001,528363,Boechler; Nicholas Sebastia,9998,0,9999,1
1713483491077,MATH 197,001,523477,Kedlaya; Kiran S.,9999,0,9999,0
1713483491077,MATH 197,002,563811,Zhang; Danna,9998,0,9999,1
1713483492103,MCWP 40R,A00,518780,Staff,17,0,20,3
1713483492103,MCWP 40R,B00,518781,Staff,14,0,20,6
1713483492103,MCWP 40R,C00,518783,Staff,11,0,20,9
1713483493130,MCWP 50R,A00,518791,Staff,8,0,20,12
1713483493130,MCWP 50R,B00,518792,Staff,7,0,20,13
1713483493130,MCWP 50R,C00,518793,Staff,7,0,20,13
1713483493130,MCWP 50R,D00,518794,Staff,1,0,20,19
1713483493130,MCWP 50R,E00,518795,Staff,3,0,20,17
1713483493130,MCWP 50R,F00,518796,Staff,13,0,20,7
1713483493130,MCWP 50R,G00,518797,Staff,12,0,20,8
1713483494156,MMW 12R,A01,514034,Herbst; Matthew,8,0,16,8
1713483494156,MMW 12R,A02,514035,Herbst; Matthew,13,0,16,3
1713483495182,MMW 13R,A01,514037,Staff,0,1,16,16
1713483495182,MMW 13R,A02,514039,Staff,0,2,16,16
1713483497234,SIO 295LS,A00,523233,Staff,15,0,30,15
1713483498264,SIO 295S,A00,523232,Staff,15,0,30,15
1713483499290,SOCI 117,A01,494376,Staff,0,2,5,5
1713483500317,WES 237B,A00,494380,Staff,19,0,20,1
1713483502445,AESE 279B,A00,494370,Wade; Jon P,33,0,33,0
1713483503469,AIP 197,001,627712,Vespa; Emanuel Ignacio,9999,0,9999,0
1713483504494,ANAR 135S,A00,494369,Braswell; Geoffrey E.,0,0,0,0
1713483505519,CAT 124RS,A01,519847,Geibel; William,6,0,20,14
1713483506545,CAT 125RS,A01,515971,Geibel; William,6,0,20,14
1713483507572,CLRE 250,A00,511389,Morris; Sheldon,9996,0,9999,3
1713483508600,CLRE 251,A00,507176,Mehta; Ravindra L.,9996,0,9999,3
1713483508600,CLRE 251,B00,511410,Mehta; Ravindra L.,9998,0,9999,1
1713483509625,CLRE 252,A00,507189,Cuomo; Raphael Eduardo,9998,0,9999,1
1713483510652,CLRE 253,A00,507199,Vaida; Florin,9997,0,9999,2
1713483510652,CLRE 253,B00,507202,Vaida; Florin,9999,0,9999,0
1713483511680,CLRE 259,A00,507211,Patel; Hemal,9996,0,9999,3
1713483512705,CLRE 260,A00,507221,Cuomo; Raphael Eduardo,9999,0,9999,0
1713483513730,CLRE 297,001,507242,Cuomo; Raphael Eduardo,9999,0,9999,0
1713483514760,CSE 191,A00,516875,Minnes Kemp; Mor Mia,9999,0,9999,0
1713483515787,CSS 201S,A01,494383,Staff,35,0,35,0
1713483516816,CSS 202S,A01,494387,Staff,35,0,35,0
1713483517847,EAP 100,A00,516065,Staff,9792,0,9999,207
1713483518872,ECE 45,A01,507414,Staff,38,0,60,22
1713483519897,ECE 100,A01,507416,Baghdadchi; Saharnaz,3,0,20,17
1713483519897,ECE 100,A02,507418,Baghdadchi; Saharnaz,19,0,20,1
1713483520926,ECE 111,A01,507420,Staff,28,0,50,22
1713483521952,ECE 197,001,548057,Sievenpiper; Daniel F.,9998,0,9999,1
1713483522981,EDS 115,A00,507243,Choi; Bailey Miyeon,27,0,28,1
1713483524007,EDS 117,A01,494379,Staff,16,0,25,9
1713483525032,EDS 125,A00,507246,Hopkins; Megan Beth,28,0,30,2
1713483526063,EDS 128A,A01,507264,Fargason; Sharon Gayle,26,0,26,0
1713483527090,EDS 128B,A01,507293,Pappas; Elizabeth,30,0,30,0
1713483528115,EDS 139,A00,507294,Fargason; Sharon Gayle,30,0,30,0
1713483528115,EDS 139,B00,507313,Pappas; Elizabeth,30,0,30,0
1713483529143,EDS 201,A00,507315,Staff,19,0,30,11
1713483530169,EDS 203,A01,507317,Halter; Christopher P.,18,0,30,12
1713483531197,EDS 204R,A01,507319,Halter; Christopher P.,0,1,30,30
1713483531197,EDS 204R,B01,507331,Heinzman; Erica M.,26,0,30,4
1713483532222,EDS 206R,A00,507332,Staff,0,1,30,30
1713483532222,EDS 206R,B00,507343,Staff,27,0,30,3
1713483533249,EDS 250,A00,507344,Hemans; Patricia Ann Benitez,28,0,40,12
1713483534281,EDS 281,A00,507345,Daly; Alan J.,18,0,18,0
1713483535307,EDS 284,A00,507350,Daly; Alan J.,16,0,16,0
1713483536338,EDS 286,A00,507359,Fine; Sarah,18,0,18,0
1713483537367,EDS 289C,A01,507361,Daly; Alan J.,18,0,18,0
1713483538391,EDS 290,A00,507366,Hofstetter; Carolyn,15,0,15,0
1713483539422,LIGM 5A,A00,507421,Fischer-Grunski; Eva K,20,0,20,0
1713483540448,LIGM 5B,A00,507423,Fischer-Grunski; Eva K,20,0,20,0
1713483541482,LIGM 5C,A00,507425,Fischer-Grunski; Eva K,20,0,20,0
1713483542513,LIIT 5AS,A00,507427,Carnelos; Chiara,20,0,20,0
1713483543539,LIIT 5BS,A00,507430,Carnelos; Chiara,20,0,20,0
1713483544570,LIIT 5CS,A00,507432,Carnelos; Chiara,20,0,20,0
1713483545601,LISP 5A,A00,507541,Munoz Sanchez; Alicia,14,0,20,6
1713483546633,LISP 5B,A00,507671,Munoz Sanchez; Alicia,12,0,20,8
1713483547661,LISP 5C,A00,507696,Munoz Sanchez; Alicia,11,0,20,9
1713483548687,MAE 197,001,528363,Boechler; Nicholas Sebastia,9998,0,9999,1
1713483549713,MATH 197,001,523477,Kedlaya; Kiran S.,9999,0,9999,0
1713483549713,MATH 197,002,563811,Zhang; Danna,9998,0,9999,1
1713483550742,MCWP 40R,A00,518780,Staff,17,0,20,3
1713483550742,MCWP 40R,B00,518781,Staff,14,0,20,6
1713483550742,MCWP 40R,C00,518783,Staff,11,0,20,9
1713483551770,MCWP 50R,A00,518791,Staff,8,0,20,12
1713483551770,MCWP 50R,B00,518792,Staff,7,0,20,13
1713483551770,MCWP 50R,C00,518793,Staff,7,0,20,13
1713483551770,MCWP 50R,D00,518794,Staff,1,0,20,19
1713483551770,MCWP 50R,E00,518795,Staff,3,0,20,17
1713483551770,MCWP 50R,F00,518796,Staff,13,0,20,7
1713483551770,MCWP 50R,G00,518797,Staff,12,0,20,8
1713483552796,MMW 12R,A01,514034,Herbst; Matthew,8,0,16,8
1713483552796,MMW 12R,A02,514035,Herbst; Matthew,13,0,16,3
1713483553824,MMW 13R,A01,514037,Staff,0,1,16,16
1713483553824,MMW 13R,A02,514039,Staff,0,2,16,16
1713483555880,SIO 295LS,A00,523233,Staff,15,0,30,15
1713483556906,SIO 295S,A00,523232,Staff,15,0,30,15
1713483557931,SOCI 117,A01,494376,Staff,0,2,5,5
1713483558957,WES 237B,A00,494380,Staff,19,0,20,1
1713483561023,AESE 279B,A00,494370,Wade; Jon P,33,0,33,0
1713483562048,AIP 197,001,627712,Vespa; Emanuel Ignacio,9999,0,9999,0
1713483563075,ANAR 135S,A00,494369,Braswell; Geoffrey E.,0,0,0,0
1713483564101,CAT 124RS,A01,519847,Geibel; William,6,0,20,14
1713483565130,CAT 125RS,A01,515971,Geibel; William,6,0,20,14
1713483566160,CLRE 250,A00,511389,Morris; Sheldon,9996,0,9999,3
1713483567188,CLRE 251,A00,507176,Mehta; Ravindra L.,9996,0,9999,3
1713483567188,CLRE 251,B00,511410,Mehta; Ravindra L.,9998,0,9999,1
1713483568224,CLRE 252,A00,507189,Cuomo; Raphael Eduardo,9998,0,9999,1
1713483569254,CLRE 253,A00,507199,Vaida; Florin,9997,0,9999,2
1713483569254,CLRE 253,B00,507202,Vaida; Florin,9999,0,9999,0
1713483570284,CLRE 259,A00,507211,Patel; Hemal,9996,0,9999,3
1713483571313,CLRE 260,A00,507221,Cuomo; Raphael Eduardo,9999,0,9999,0
1713483572338,CLRE 297,001,507242,Cuomo; Raphael Eduardo,9999,0,9999,0
1713483573364,CSE 191,A00,516875,Minnes Kemp; Mor Mia,9999,0,9999,0
1713483574391,CSS 201S,A01,494383,Staff,35,0,35,0
1713483575422,CSS 202S,A01,494387,Staff,35,0,35,0
1713483576447,EAP 100,A00,516065,Staff,9792,0,9999,207
1713483577475,ECE 45,A01,507414,Staff,38,0,60,22
1713483578503,ECE 100,A01,507416,Baghdadchi; Saharnaz,3,0,20,17
1713483578503,ECE 100,A02,507418,Baghdadchi; Saharnaz,19,0,20,1
1713483579532,ECE 111,A01,507420,Staff,28,0,50,22
1713483580558,ECE 197,001,548057,Sievenpiper; Daniel F.,9998,0,9999,1
1713483581589,EDS 115,A00,507243,Choi; Bailey Miyeon,27,0,28,1
1713483582615,EDS 117,A01,494379,Staff,16,0,25,9
1713483583640,EDS 125,A00,507246,Hopkins; Megan Beth,28,0,30,2
1713483584666,EDS 128A,A01,507264,Fargason; Sharon Gayle,26,0,26,0
1713483585729,EDS 128B,A01,507293,Pappas; Elizabeth,30,0,30,0
1713483586756,EDS 139,A00,507294,Fargason; Sharon Gayle,30,0,30,0
1713483586756,EDS 139,B00,507313,Pappas; Elizabeth,30,0,30,0
1713483587784,EDS 201,A00,507315,Staff,19,0,30,11
1713483588812,EDS 203,A01,507317,Halter; Christopher P.,18,0,30,12
1713483589837,EDS 204R,A01,507319,Halter; Christopher P.,0,1,30,30
1713483589837,EDS 204R,B01,507331,Heinzman; Erica M.,26,0,30,4
1713483590862,EDS 206R,A00,507332,Staff,0,1,30,30
1713483590862,EDS 206R,B00,507343,Staff,27,0,30,3
1713483591891,EDS 250,A00,507344,Hemans; Patricia Ann Benitez,28,0,40,12
1713483592916,EDS 281,A00,507345,Daly; Alan J.,18,0,18,0
1713483593944,EDS 284,A00,507350,Daly; Alan J.,16,0,16,0
1713483594970,EDS 286,A00,507359,Fine; Sarah,18,0,18,0
1713483595995,EDS 289C,A01,507361,Daly; Alan J.,18,0,18,0
1713483597024,EDS 290,A00,507366,Hofstetter; Carolyn,15,0,15,0
1713483598051,LIGM 5A,A00,507421,Fischer-Grunski; Eva K,20,0,20,0
1713483599075,LIGM 5B,A00,507423,Fischer-Grunski; Eva K,20,0,20,0
1713483600099,LIGM 5C,A00,507425,Fischer-Grunski; Eva K,20,0,20,0
1713483601126,LIIT 5AS,A00,507427,Carnelos; Chiara,20,0,20,0
1713483602151,LIIT 5BS,A00,507430,Carnelos; Chiara,20,0,20,0
1713483603176,LIIT 5CS,A00,507432,Carnelos; Chiara,20,0,20,0
1713483604207,LISP 5A,A00,507541,Munoz Sanchez; Alicia,14,0,20,6
1713483605233,LISP 5B,A00,507671,Munoz Sanchez; Alicia,12,0,20,8
1713483606313,LISP 5C,A00,507696,Munoz Sanchez; Alicia,11,0,20,9
1713483607341,MAE 197,001,528363,Boechler; Nicholas Sebastia,9998,0,9999,1
1713483608368,MATH 197,001,523477,Kedlaya; Kiran S.,9999,0,9999,0
1713483608368,MATH 197,002,563811,Zhang; Danna,9998,0,9999,1
1713483609398,MCWP 40R,A00,518780,Staff,17,0,20,3
1713483609398,MCWP 40R,B00,518781,Staff,14,0,20,6
1713483609398,MCWP 40R,C00,518783,Staff,11,0,20,9
1713483610425,MCWP 50R,A00,518791,Staff,8,0,20,12
1713483610425,MCWP 50R,B00,518792,Staff,7,0,20,13
1713483610425,MCWP 50R,C00,518793,Staff,7,0,20,13
1713483610425,MCWP 50R,D00,518794,Staff,1,0,20,19
1713483610425,MCWP 50R,E00,518795,Staff,3,0,20,17
1713483610425,MCWP 50R,F00,518796,Staff,13,0,20,7
1713483610425,MCWP 50R,G00,518797,Staff,12,0,20,8
1713483611455,MMW 12R,A01,514034,Herbst; Matthew,8,0,16,8
1713483611455,MMW 12R,A02,514035,Herbst; Matthew,13,0,16,3
1713483612481,MMW 13R,A01,514037,Staff,0,1,16,16
1713483612481,MMW 13R,A02,514039,Staff,0,2,16,16
1713483614530,SIO 295LS,A00,523233,Staff,15,0,30,15
1713483615555,SIO 295S,A00,523232,Staff,15,0,30,15
1713483616585,SOCI 117,A01,494376,Staff,0,2,5,5
1713483617612,WES 237B,A00,494380,Staff,19,0,20,1
1713483619691,AESE 279B,A00,494370,Wade; Jon P,33,0,33,0
1713483620716,AIP 197,001,627712,Vespa; Emanuel Ignacio,9999,0,9999,0
1713483621742,ANAR 135S,A00,494369,Braswell; Geoffrey E.,0,0,0,0
1713483622772,CAT 124RS,A01,519847,Geibel; William,6,0,20,14
1713483623801,CAT 125RS,A01,515971,Geibel; William,6,0,20,14
1713483624826,CLRE 250,A00,511389,Morris; Sheldon,9996,0,9999,3
1713483625858,CLRE 251,A00,507176,Mehta; Ravindra L.,9996,0,9999,3
1713483625858,CLRE 251,B00,511410,Mehta; Ravindra L.,9998,0,9999,1
1713483626887,CLRE 252,A00,507189,Cuomo; Raphael Eduardo,9998,0,9999,1
1713483627914,CLRE 253,A00,507199,Vaida; Florin,9997,0,9999,2
1713483627914,CLRE 253,B00,507202,Vaida; Florin,9999,0,9999,0
1713483628939,CLRE 259,A00,507211,Patel; Hemal,9996,0,9999,3
1713483629964,CLRE 260,A00,507221,Cuomo; Raphael Eduardo,9999,0,9999,0
1713483630988,CLRE 297,001,507242,Cuomo; Raphael Eduardo,9999,0,9999,0
1713483632018,CSE 191,A00,516875,Minnes Kemp; Mor Mia,9999,0,9999,0
1713483633042,CSS 201S,A01,494383,Staff,35,0,35,0
1713483634070,CSS 202S,A01,494387,Staff,35,0,35,0
1713483635093,EAP 100,A00,516065,Staff,9792,0,9999,207
1713483636130,ECE 45,A01,507414,Staff,38,0,60,22
1713483637157,ECE 100,A01,507416,Baghdadchi; Saharnaz,3,0,20,17
1713483637157,ECE 100,A02,507418,Baghdadchi; Saharnaz,19,0,20,1
1713483638183,ECE 111,A01,507420,Staff,28,0,50,22
1713483639208,ECE 197,001,548057,Sievenpiper; Daniel F.,9998,0,9999,1
1713483640239,EDS 115,A00,507243,Choi; Bailey Miyeon,27,0,28,1
1713483641264,EDS 117,A01,494379,Staff,16,0,25,9
1713483642293,EDS 125,A00,507246,Hopkins; Megan Beth,28,0,30,2
1713483643318,EDS 128A,A01,507264,Fargason; Sharon Gayle,26,0,26,0
1713483644348,EDS 128B,A01,507293,Pappas; Elizabeth,30,0,30,0
1713483645374,EDS 139,A00,507294,Fargason; Sharon Gayle,30,0,30,0
1713483645374,EDS 139,B00,507313,Pappas; Elizabeth,30,0,30,0
1713483646400,EDS 201,A00,507315,Staff,19,0,30,11
1713483647424,EDS 203,A01,507317,Halter; Christopher P.,18,0,30,12
1713483648450,EDS 204R,A01,507319,Halter; Christopher P.,0,1,30,30
1713483648450,EDS 204R,B01,507331,Heinzman; Erica M.,26,0,30,4
1713483649476,EDS 206R,A00,507332,Staff,0,1,30,30
1713483649476,EDS 206R,B00,507343,Staff,27,0,30,3
1713483650501,EDS 250,A00,507344,Hemans; Patricia Ann Benitez,28,0,40,12
1713483651526,EDS 281,A00,507345,Daly; Alan J.,18,0,18,0
1713483652551,EDS 284,A00,507350,Daly; Alan J.,16,0,16,0
1713483653579,EDS 286,A00,507359,Fine; Sarah,18,0,18,0
1713483654603,EDS 289C,A01,507361,Daly; Alan J.,18,0,18,0
1713483655632,EDS 290,A00,507366,Hofstetter; Carolyn,15,0,15,0
1713483656659,LIGM 5A,A00,507421,Fischer-Grunski; Eva K,20,0,20,0
1713483657690,LIGM 5B,A00,507423,Fischer-Grunski; Eva K,20,0,20,0
1713483658714,LIGM 5C,A00,507425,Fischer-Grunski; Eva K,20,0,20,0
1713483659741,LIIT 5AS,A00,507427,Carnelos; Chiara,20,0,20,0
1713483660771,LIIT 5BS,A00,507430,Carnelos; Chiara,20,0,20,0
1713483661799,LIIT 5CS,A00,507432,Carnelos; Chiara,20,0,20,0
1713483662826,LISP 5A,A00,507541,Munoz Sanchez; Alicia,14,0,20,6
1713483663862,LISP 5B,A00,507671,Munoz Sanchez; Alicia,12,0,20,8
1713483664891,LISP 5C,A00,507696,Munoz Sanchez; Alicia,11,0,20,9
1713483665917,MAE 197,001,528363,Boechler; Nicholas Sebastia,9998,0,9999,1
1713483666944,MATH 197,001,523477,Kedlaya; Kiran S.,9999,0,9999,0
1713483666944,MATH 197,002,563811,Zhang; Danna,9998,0,9999,1
1713483667970,MCWP 40R,A00,518780,Staff,17,0,20,3
1713483667970,MCWP 40R,B00,518781,Staff,14,0,20,6
1713483667970,MCWP 40R,C00,518783,Staff,11,0,20,9
1713483668996,MCWP 50R,A00,518791,Staff,8,0,20,12
1713483668996,MCWP 50R,B00,518792,Staff,7,0,20,13
1713483668996,MCWP 50R,C00,518793,Staff,7,0,20,13
1713483668996,MCWP 50R,D00,518794,Staff,1,0,20,19
1713483668996,MCWP 50R,E00,518795,Staff,3,0,20,17
1713483668996,MCWP 50R,F00,518796,Staff,13,0,20,7
1713483668996,MCWP 50R,G00,518797,Staff,12,0,20,8
1713483670024,MMW 12R,A01,514034,Herbst; Matthew,8,0,16,8
1713483670024,MMW 12R,A02,514035,Herbst; Matthew,13,0,16,3
1713483671053,MMW 13R,A01,514037,Staff,0,1,16,16
1713483671053,MMW 13R,A02,514039,Staff,0,2,16,16
1713483673108,SIO 295LS,A00,523233,Staff,15,0,30,15
1713483674133,SIO 295S,A00,523232,Staff,15,0,30,15
1713483675162,SOCI 117,A01,494376,Staff,0,2,5,5
1713483676188,WES 237B,A00,494380,Staff,19,0,20,1
1713483678255,AESE 279B,A00,494370,Wade; Jon P,33,0,33,0
1713483679289,AIP 197,001,627712,Vespa; Emanuel Ignacio,9999,0,9999,0
1713483680315,ANAR 135S,A00,494369,Braswell; Geoffrey E.,0,0,0,0
1713483681341,CAT 124RS,A01,519847,Geibel; William,6,0,20,14
1713483682369,CAT 125RS,A01,515971,Geibel; William,6,0,20,14
1713483683395,CLRE 250,A00,511389,Morris; Sheldon,9996,0,9999,3
1713483684430,CLRE 251,A00,507176,Mehta; Ravindra L.,9996,0,9999,3
1713483684430,CLRE 251,B00,511410,Mehta; Ravindra L.,9998,0,9999,1
1713483685454,CLRE 252,A00,507189,Cuomo; Raphael Eduardo,9998,0,9999,1
1713483686481,CLRE 253,A00,507199,Vaida; Florin,9997,0,9999,2
1713483686481,CLRE 253,B00,507202,Vaida; Florin,9999,0,9999,0
1713483687512,CLRE 259,A00,507211,Patel; Hemal,9996,0,9999,3
1713483688540,CLRE 260,A00,507221,Cuomo; Raphael Eduardo,9999,0,9999,0
1713483689566,CLRE 297,001,507242,Cuomo; Raphael Eduardo,9999,0,9999,0
1713483690592,CSE 191,A00,516875,Minnes Kemp; Mor Mia,9999,0,9999,0
1713483691616,CSS 201S,A01,494383,Staff,35,0,35,0
1713483692643,CSS 202S,A01,494387,Staff,35,0,35,0
1713483693672,EAP 100,A00,516065,Staff,9792,0,9999,207
1713483694697,ECE 45,A01,507414,Staff,38,0,60,22
1713483695729,ECE 100,A01,507416,Baghdadchi; Saharnaz,3,0,20,17
1713483695729,ECE 100,A02,507418,Baghdadchi; Saharnaz,19,0,20,1
1713483696752,ECE 111,A01,507420,Staff,28,0,50,22
1713483697780,ECE 197,001,548057,Sievenpiper; Daniel F.,9998,0,9999,1
1713483698812,EDS 115,A00,507243,Choi; Bailey Miyeon,27,0,28,1
1713483699841,EDS 117,A01,494379,Staff,16,0,25,9
1713483700869,EDS 125,A00,507246,Hopkins; Megan Beth,28,0,30,2
1713483701896,EDS 128A,A01,507264,Fargason; Sharon Gayle,26,0,26,0
1713483702921,EDS 128B,A01,507293,Pappas; Elizabeth,30,0,30,0
1713483703949,EDS 139,A00,507294,Fargason; Sharon Gayle,30,0,30,0
1713483703949,EDS 139,B00,507313,Pappas; Elizabeth,30,0,30,0
1713483704975,EDS 201,A00,507315,Staff,19,0,30,11
1713483706001,EDS 203,A01,507317,Halter; Christopher P.,18,0,30,12
1713483707032,EDS 204R,A01,507319,Halter; Christopher P.,0,1,30,30
1713483707032,EDS 204R,B01,507331,Heinzman; Erica M.,26,0,30,4
1713483708060,EDS 206R,A00,507332,Staff,0,1,30,30
1713483708060,EDS 206R,B00,507343,Staff,27,0,30,3
1713483709086,EDS 250,A00,507344,Hemans; Patricia Ann Benitez,28,0,40,12
1713483710171,EDS 281,A00,507345,Daly; Alan J.,18,0,18,0
1713483711196,EDS 284,A00,507350,Daly; Alan J.,16,0,16,0
1713483712226,EDS 286,A00,507359,Fine; Sarah,18,0,18,0
1713483713252,EDS 289C,A01,507361,Daly; Alan J.,18,0,18,0
1713483714281,EDS 290,A00,507366,Hofstetter; Carolyn,15,0,15,0
1713483715308,LIGM 5A,A00,507421,Fischer-Grunski; Eva K,20,0,20,0
1713483716336,LIGM 5B,A00,507423,Fischer-Grunski; Eva K,20,0,20,0
1713483717367,LIGM 5C,A00,507425,Fischer-Grunski; Eva K,20,0,20,0
1713483718392,LIIT 5AS,A00,507427,Carnelos; Chiara,20,0,20,0
1713483719418,LIIT 5BS,A00,507430,Carnelos; Chiara,20,0,20,0
1713483720450,LIIT 5CS,A00,507432,Carnelos; Chiara,20,0,20,0
1713483721479,LISP 5A,A00,507541,Munoz Sanchez; Alicia,14,0,20,6
1713483722504,LISP 5B,A00,507671,Munoz Sanchez; Alicia,12,0,20,8
1713483723531,LISP 5C,A00,507696,Munoz Sanchez; Alicia,11,0,20,9
1713483724562,MAE 197,001,528363,Boechler; Nicholas Sebastia,9998,0,9999,1
1713483725587,MATH 197,001,523477,Kedlaya; Kiran S.,9999,0,9999,0
1713483725587,MATH 197,002,563811,Zhang; Danna,9998,0,9999,1
1713483726613,MCWP 40R,A00,518780,Staff,17,0,20,3
1713483726613,MCWP 40R,B00,518781,Staff,14,0,20,6
1713483726613,MCWP 40R,C00,518783,Staff,11,0,20,9
1713483727651,MCWP 50R,A00,518791,Staff,8,0,20,12
1713483727651,MCWP 50R,B00,518792,Staff,7,0,20,13
1713483727651,MCWP 50R,C00,518793,Staff,7,0,20,13
1713483727651,MCWP 50R,D00,518794,Staff,1,0,20,19
1713483727651,MCWP 50R,E00,518795,Staff,3,0,20,17
1713483727651,MCWP 50R,F00,518796,Staff,13,0,20,7
1713483727651,MCWP 50R,G00,518797,Staff,12,0,20,8
1713483728681,MMW 12R,A01,514034,Herbst; Matthew,8,0,16,8
1713483728681,MMW 12R,A02,514035,Herbst; Matthew,13,0,16,3
1713483729709,MMW 13R,A01,514037,Staff,0,1,16,16
1713483729709,MMW 13R,A02,514039,Staff,0,2,16,16
1713483731770,SIO 295LS,A00,523233,Staff,15,0,30,15
1713483732794,SIO 295S,A00,523232,Staff,15,0,30,15
1713483733823,SOCI 117,A01,494376,Staff,0,2,5,5
1713483734849,WES 237B,A00,494380,Staff,19,0,20,1
1713483736935,AESE 279B,A00,494370,Wade; Jon P,33,0,33,0
1713483737961,AIP 197,001,627712,Vespa; Emanuel Ignacio,9999,0,9999,0
1713483738986,ANAR 135S,A00,494369,Braswell; Geoffrey E.,0,0,0,0
1713483740021,CAT 124RS,A01,519847,Geibel; William,6,0,20,14
1713483741049,CAT 125RS,A01,515971,Geibel; William,6,0,20,14
1713483742074,CLRE 250,A00,511389,Morris; Sheldon,9996,0,9999,3
1713483743099,CLRE 251,A00,507176,Mehta; Ravindra L.,9996,0,9999,3
1713483743099,CLRE 251,B00,511410,Mehta; Ravindra L.,9998,0,9999,1
1713483744124,CLRE 252,A00,507189,Cuomo; Raphael Eduardo,9998,0,9999,1
1713483745150,CLRE 253,A00,507199,Vaida; Florin,9997,0,9999,2
1713483745150,CLRE 253,B00,507202,Vaida; Florin,9999,0,9999,0
1713483746179,CLRE 259,A00,507211,Patel; Hemal,9996,0,9999,3
1713483747207,CLRE 260,A00,507221,Cuomo; Raphael Eduardo,9999,0,9999,0
1713483748231,CLRE 297,001,507242,Cuomo; Raphael Eduardo,9999,0,9999,0
1713483749261,CSE 191,A00,516875,Minnes Kemp; Mor Mia,9999,0,9999,0
1713483750287,CSS 201S,A01,494383,Staff,35,0,35,0
1713483751316,CSS 202S,A01,494387,Staff,35,0,35,0
1713483752341,EAP 100,A00,516065,Staff,9792,0,9999,207
1713483753370,ECE 45,A01,507414,Staff,38,0,60,22
1713483754393,ECE 100,A01,507416,Baghdadchi; Saharnaz,3,0,20,17
1713483754393,ECE 100,A02,507418,Baghdadchi; Saharnaz,19,0,20,1
1713483755419,ECE 111,A01,507420,Staff,28,0,50,22
1713483756443,ECE 197,001,548057,Sievenpiper; Daniel F.,9998,0,9999,1
1713483757471,EDS 115,A00,507243,Choi; Bailey Miyeon,27,0,28,1
1713483758498,EDS 117,A01,494379,Staff,16,0,25,9
1713483759528,EDS 125,A00,507246,Hopkins; Megan Beth,28,0,30,2
1713483760557,EDS 128A,A01,507264,Fargason; Sharon Gayle,26,0,26,0
1713483761587,EDS 128B,A01,507293,Pappas; Elizabeth,30,0,30,0
1713483762612,EDS 139,A00,507294,Fargason; Sharon Gayle,30,0,30,0
1713483762612,EDS 139,B00,507313,Pappas; Elizabeth,30,0,30,0
1713483763635,EDS 201,A00,507315,Staff,19,0,30,11
1713483764661,EDS 203,A01,507317,Halter; Christopher P.,18,0,30,12
1713483765693,EDS 204R,A01,507319,Halter; Christopher P.,0,1,30,30
1713483765693,EDS 204R,B01,507331,Heinzman; Erica M.,26,0,30,4
1713483766719,EDS 206R,A00,507332,Staff,0,1,30,30
1713483766719,EDS 206R,B00,507343,Staff,27,0,30,3
1713483767748,EDS 250,A00,507344,Hemans; Patricia Ann Benitez,28,0,40,12
1713483768774,EDS 281,A00,507345,Daly; Alan J.,18,0,18,0
1713483769800,EDS 284,A00,507350,Daly; Alan J.,16,0,16,0
1713483770825,EDS 286,A00,507359,Fine; Sarah,18,0,18,0
1713483771851,EDS 289C,A01,507361,Daly; Alan J.,18,0,18,0
1713483772880,EDS 290,A00,507366,Hofstetter; Carolyn,15,0,15,0
1713483773910,LIGM 5A,A00,507421,Fischer-Grunski; Eva K,20,0,20,0
1713483774937,LIGM 5B,A00,507423,Fischer-Grunski; Eva K,20,0,20,0
1713483775962,LIGM 5C,A00,507425,Fischer-Grunski; Eva K,20,0,20,0
1713483776992,LIIT 5AS,A00,507427,Carnelos; Chiara,20,0,20,0
1713483778017,LIIT 5BS,A00,507430,Carnelos; Chiara,20,0,20,0
1713483779047,LIIT 5CS,A00,507432,Carnelos; Chiara,20,0,20,0
1713483780074,LISP 5A,A00,507541,Munoz Sanchez; Alicia,14,0,20,6
1713483781099,LISP 5B,A00,507671,Munoz Sanchez; Alicia,12,0,20,8
1713483782123,LISP 5C,A00,507696,Munoz Sanchez; Alicia,11,0,20,9
1713483783154,MAE 197,001,528363,Boechler; Nicholas Sebastia,9998,0,9999,1
1713483784179,MATH 197,001,523477,Kedlaya; Kiran S.,9999,0,9999,0
1713483784179,MATH 197,002,563811,Zhang; Danna,9998,0,9999,1
1713483785205,MCWP 40R,A00,518780,Staff,17,0,20,3
1713483785205,MCWP 40R,B00,518781,Staff,14,0,20,6
1713483785205,MCWP 40R,C00,518783,Staff,11,0,20,9
1713483786232,MCWP 50R,A00,518791,Staff,8,0,20,12
1713483786232,MCWP 50R,B00,518792,Staff,7,0,20,13
1713483786232,MCWP 50R,C00,518793,Staff,7,0,20,13
1713483786232,MCWP 50R,D00,518794,Staff,1,0,20,19
1713483786232,MCWP 50R,E00,518795,Staff,3,0,20,17
1713483786232,MCWP 50R,F00,518796,Staff,13,0,20,7
1713483786232,MCWP 50R,G00,518797,Staff,12,0,20,8
1713483787266,MMW 12R,A01,514034,Herbst; Matthew,8,0,16,8
1713483787266,MMW 12R,A02,514035,Herbst; Matthew,13,0,16,3
1713483788295,MMW 13R,A01,514037,Staff,0,1,16,16
1713483788295,MMW 13R,A02,514039,Staff,0,2,16,16
1713483790345,SIO 295LS,A00,523233,Staff,15,0,30,15
1713483791372,SIO 295S,A00,523232,Staff,15,0,30,15
1713483792398,SOCI 117,A01,494376,Staff,0,2,5,5
1713483793423,WES 237B,A00,494380,Staff,19,0,20,1
1713483795501,AESE 279B,A00,494370,Wade; Jon P,33,0,33,0
1713483796527,AIP 197,001,627712,Vespa; Emanuel Ignacio,9999,0,9999,0
1713483797554,ANAR 135S,A00,494369,Braswell; Geoffrey E.,0,0,0,0
1713483798581,CAT 124RS,A01,519847,Geibel; William,6,0,20,14
1713483799609,CAT 125RS,A01,515971,Geibel; William,6,0,20,14
1713483800639,CLRE 250,A00,511389,Morris; Sheldon,9996,0,9999,3
1713483801665,CLRE 251,A00,507176,Mehta; Ravindra L.,9996,0,9999,3
1713483801665,CLRE 251,B00,511410,Mehta; Ravindra L.,9998,0,9999,1
1713483802690,CLRE 252,A00,507189,Cuomo; Raphael Eduardo,9998,0,9999,1
1713483803723,CLRE 253,A00,507199,Vaida; Florin,9997,0,9999,2
1713483803723,CLRE 253,B00,507202,Vaida; Florin,9999,0,9999,0
1713483804751,CLRE 259,A00,507211,Patel; Hemal,9996,0,9999,3
1713483805778,CLRE 260,A00,507221,Cuomo; Raphael Eduardo,9999,0,9999,0
1713483806803,CLRE 297,001,507242,Cuomo; Raphael Eduardo,9999,0,9999,0
1713483807843,CSE 191,A00,516875,Minnes Kemp; Mor Mia,9999,0,9999,0
1713483808869,CSS 201S,A01,494383,Staff,35,0,35,0
1713483809899,CSS 202S,A01,494387,Staff,35,0,35,0
1713483810925,EAP 100,A00,516065,Staff,9792,0,9999,207
1713483811954,ECE 45,A01,507414,Staff,38,0,60,22
1713483812980,ECE 100,A01,507416,Baghdadchi; Saharnaz,3,0,20,17
1713483812980,ECE 100,A02,507418,Baghdadchi; Saharnaz,19,0,20,1
1713483814062,ECE 111,A01,507420,Staff,28,0,50,22
1713483815088,ECE 197,001,548057,Sievenpiper; Daniel F.,9998,0,9999,1
1713483816115,EDS 115,A00,507243,Choi; Bailey Miyeon,27,0,28,1
1713483817143,EDS 117,A01,494379,Staff,16,0,25,9
1713483818173,EDS 125,A00,507246,Hopkins; Megan Beth,28,0,30,2
1713483819198,EDS 128A,A01,507264,Fargason; Sharon Gayle,26,0,26,0
1713483820224,EDS 128B,A01,507293,Pappas; Elizabeth,30,0,30,0
1713483821248,EDS 139,A00,507294,Fargason; Sharon Gayle,30,0,30,0
1713483821248,EDS 139,B00,507313,Pappas; Elizabeth,30,0,30,0
1713483822278,EDS 201,A00,507315,Staff,19,0,30,11
1713483823304,EDS 203,A01,507317,Halter; Christopher P.,18,0,30,12
1713483824330,EDS 204R,A01,507319,Halter; Christopher P.,0,1,30,30
1713483824330,EDS 204R,B01,507331,Heinzman; Erica M.,26,0,30,4
1713483825359,EDS 206R,A00,507332,Staff,0,1,30,30
1713483825359,EDS 206R,B00,507343,Staff,27,0,30,3
1713483826386,EDS 250,A00,507344,Hemans; Patricia Ann Benitez,28,0,40,12
1713483827410,EDS 281,A00,507345,Daly; Alan J.,18,0,18,0
1713483828435,EDS 284,A00,507350,Daly; Alan J.,16,0,16,0
1713483829460,EDS 286,A00,507359,Fine; Sarah,18,0,18,0
1713483830487,EDS 289C,A01,507361,Daly; Alan J.,18,0,18,0
1713483831511,EDS 290,A00,507366,Hofstetter; Carolyn,15,0,15,0
1713483832541,LIGM 5A,A00,507421,Fischer-Grunski; Eva K,20,0,20,0
1713483833567,LIGM 5B,A00,507423,Fischer-Grunski; Eva K,20,0,20,0
1713483834592,LIGM 5C,A00,507425,Fischer-Grunski; Eva K,20,0,20,0
1713483835616,LIIT 5AS,A00,507427,Carnelos; Chiara,20,0,20,0
1713483836642,LIIT 5BS,A00,507430,Carnelos; Chiara,20,0,20,0
1713483837672,LIIT 5CS,A00,507432,Carnelos; Chiara,20,0,20,0
1713483838696,LISP 5A,A00,507541,Munoz Sanchez; Alicia,14,0,20,6
1713483839722,LISP 5B,A00,507671,Munoz Sanchez; Alicia,12,0,20,8
1713483840752,LISP 5C,A00,507696,Munoz Sanchez; Alicia,11,0,20,9
1713483841779,MAE 197,001,528363,Boechler; Nicholas Sebastia,9998,0,9999,1
1713483842810,MATH 197,001,523477,Kedlaya; Kiran S.,9999,0,9999,0
1713483842810,MATH 197,002,563811,Zhang; Danna,9998,0,9999,1
1713483843838,MCWP 40R,A00,518780,Staff,17,0,20,3
1713483843838,MCWP 40R,B00,518781,Staff,14,0,20,6
1713483843838,MCWP 40R,C00,518783,Staff,11,0,20,9
1713483844865,MCWP 50R,A00,518791,Staff,8,0,20,12
1713483844865,MCWP 50R,B00,518792,Staff,7,0,20,13
1713483844865,MCWP 50R,C00,518793,Staff,7,0,20,13
1713483844865,MCWP 50R,D00,518794,Staff,1,0,20,19
1713483844865,MCWP 50R,E00,518795,Staff,3,0,20,17
1713483844865,MCWP 50R,F00,518796,Staff,13,0,20,7
1713483844865,MCWP 50R,G00,518797,Staff,12,0,20,8
1713483845892,MMW 12R,A01,514034,Herbst; Matthew,8,0,16,8
1713483845892,MMW 12R,A02,514035,Herbst; Matthew,13,0,16,3
1713483846917,MMW 13R,A01,514037,Staff,0,1,16,16
1713483846917,MMW 13R,A02,514039,Staff,0,2,16,16
1713483848966,SIO 295LS,A00,523233,Staff,15,0,30,15
1713483849991,SIO 295S,A00,523232,Staff,15,0,30,15
1713483851020,SOCI 117,A01,494376,Staff,0,2,5,5
1713483852045,WES 237B,A00,494380,Staff,19,0,20,1
1713483854107,AESE 279B,A00,494370,Wade; Jon P,33,0,33,0
1713483855132,AIP 197,001,627712,Vespa; Emanuel Ignacio,9999,0,9999,0
1713483856161,ANAR 135S,A00,494369,Braswell; Geoffrey E.,0,0,0,0
1713483857190,CAT 124RS,A01,519847,Geibel; William,6,0,20,14
1713483858218,CAT 125RS,A01,515971,Geibel; William,6,0,20,14
1713483859247,CLRE 250,A00,511389,Morris; Sheldon,9996,0,9999,3
1713483860275,CLRE 251,A00,507176,Mehta; Ravindra L.,9996,0,9999,3
1713483860275,CLRE 251,B00,511410,Mehta; Ravindra L.,9998,0,9999,1
1713483861300,CLRE 252,A00,507189,Cuomo; Raphael Eduardo,9998,0,9999,1
1713483862325,CLRE 253,A00,507199,Vaida; Florin,9997,0,9999,2
1713483862325,CLRE 253,B00,507202,Vaida; Florin,9999,0,9999,0
1713483863352,CLRE 259,A00,507211,Patel; Hemal,9996,0,9999,3
1713483864377,CLRE 260,A00,507221,Cuomo; Raphael Eduardo,9999,0,9999,0
1713483865401,CLRE 297,001,507242,Cuomo; Raphael Eduardo,9999,0,9999,0
1713483866430,CSE 191,A00,516875,Minnes Kemp; Mor Mia,9999,0,9999,0
1713483867456,CSS 201S,A01,494383,Staff,35,0,35,0
1713483868481,CSS 202S,A01,494387,Staff,35,0,35,0
1713483869506,EAP 100,A00,516065,Staff,9792,0,9999,207
1713483870531,ECE 45,A01,507414,Staff,38,0,60,22
1713483871560,ECE 100,A01,507416,Baghdadchi; Saharnaz,3,0,20,17
1713483871560,ECE 100,A02,507418,Baghdadchi; Saharnaz,19,0,20,1
1713483872585,ECE 111,A01,507420,Staff,28,0,50,22
1713483873613,ECE 197,001,548057,Sievenpiper; Daniel F.,9998,0,9999,1
1713483874638,EDS 115,A00,507243,Choi; Bailey Miyeon,27,0,28,1
1713483875663,EDS 117,A01,494379,Staff,16,0,25,9
1713483876689,EDS 125,A00,507246,Hopkins; Megan Beth,28,0,30,2
1713483877718,EDS 128A,A01,507264,Fargason; Sharon Gayle,26,0,26,0
1713483878746,EDS 128B,A01,507293,Pappas; Elizabeth,30,0,30,0
1713483879773,EDS 139,A00,507294,Fargason; Sharon Gayle,30,0,30,0
1713483879773,EDS 139,B00,507313,Pappas; Elizabeth,30,0,30,0
1713483880796,EDS 201,A00,507315,Staff,19,0,30,11
1713483881821,EDS 203,A01,507317,Halter; Christopher P.,18,0,30,12
1713483882846,EDS 204R,A01,507319,Halter; Christopher P.,0,1,30,30
1713483882846,EDS 204R,B01,507331,Heinzman; Erica M.,26,0,30,4
1713483883871,EDS 206R,A00,507332,Staff,0,1,30,30
1713483883871,EDS 206R,B00,507343,Staff,27,0,30,3
1713483884896,EDS 250,A00,507344,Hemans; Patricia Ann Benitez,28,0,40,12
1713483885925,EDS 281,A00,507345,Daly; Alan J.,18,0,18,0
1713483886950,EDS 284,A00,507350,Daly; Alan J.,16,0,16,0
1713483887979,EDS 286,A00,507359,Fine; Sarah,18,0,18,0
1713483889005,EDS 289C,A01,507361,Daly; Alan J.,18,0,18,0
1713483890033,EDS 290,A00,507366,Hofstetter; Carolyn,15,0,15,0
1713483891061,LIGM 5A,A00,507421,Fischer-Grunski; Eva K,20,0,20,0
1713483892087,LIGM 5B,A00,507423,Fischer-Grunski; Eva K,20,0,20,0
1713483893114,LIGM 5C,A00,507425,Fischer-Grunski; Eva K,20,0,20,0
1713483894139,LIIT 5AS,A00,507427,Carnelos; Chiara,20,0,20,0
1713483895166,LIIT 5BS,A00,507430,Carnelos; Chiara,20,0,20,0
1713483896192,LIIT 5CS,A00,507432,Carnelos; Chiara,20,0,20,0
1713483897223,LISP 5A,A00,507541,Munoz Sanchez; Alicia,14,0,20,6
1713483898249,LISP 5B,A00,507671,Munoz Sanchez; Alicia,12,0,20,8
1713483899279,LISP 5C,A00,507696,Munoz Sanchez; Alicia,11,0,20,9
1713483900303,MAE 197,001,528363,Boechler; Nicholas Sebastia,9998,0,9999,1
1713483901335,MATH 197,001,523477,Kedlaya; Kiran S.,9999,0,9999,0
1713483901335,MATH 197,002,563811,Zhang; Danna,9998,0,9999,1
1713483902359,MCWP 40R,A00,518780,Staff,17,0,20,3
1713483902359,MCWP 40R,B00,518781,Staff,14,0,20,6
1713483902359,MCWP 40R,C00,518783,Staff,11,0,20,9
1713483903390,MCWP 50R,A00,518791,Staff,8,0,20,12
1713483903390,MCWP 50R,B00,518792,Staff,7,0,20,13
1713483903390,MCWP 50R,C00,518793,Staff,7,0,20,13
1713483903390,MCWP 50R,D00,518794,Staff,1,0,20,19
1713483903390,MCWP 50R,E00,518795,Staff,3,0,20,17
1713483903390,MCWP 50R,F00,518796,Staff,13,0,20,7
1713483903390,MCWP 50R,G00,518797,Staff,12,0,20,8
1713483904417,MMW 12R,A01,514034,Herbst; Matthew,8,0,16,8
1713483904417,MMW 12R,A02,514035,Herbst; Matthew,13,0,16,3
1713483905445,MMW 13R,A01,514037,Staff,0,2,16,16
1713483905445,MMW 13R,A02,514039,Staff,0,2,16,16
1713483907497,SIO 295LS,A00,523233,Staff,15,0,30,15
1713483908526,SIO 295S,A00,523232,Staff,15,0,30,15
1713483909550,SOCI 117,A01,494376,Staff,0,2,5,5
1713483910578,WES 237B,A00,494380,Staff,19,0,20,1
1713483912649,AESE 279B,A00,494370,Wade; Jon P,33,0,33,0
1713483913683,AIP 197,001,627712,Vespa; Emanuel Ignacio,9999,0,9999,0
1713483914709,ANAR 135S,A00,494369,Braswell; Geoffrey E.,0,0,0,0
1713483915740,CAT 124RS,A01,519847,Geibel; William,6,0,20,14
1713483916765,CAT 125RS,A01,515971,Geibel; William,6,0,20,14
1713483937421,CLRE 250,A00,511389,Morris; Sheldon,9996,0,9999,3
1713483938447,CLRE 251,A00,507176,Mehta; Ravindra L.,9996,0,9999,3
1713483938447,CLRE 251,B00,511410,Mehta; Ravindra L.,9998,0,9999,1
1713483939473,CLRE 252,A00,507189,Cuomo; Raphael Eduardo,9998,0,9999,1
1713483940498,CLRE 253,A00,507199,Vaida; Florin,9997,0,9999,2
1713483940498,CLRE 253,B00,507202,Vaida; Florin,9999,0,9999,0
1713483941523,CLRE 259,A00,507211,Patel; Hemal,9996,0,9999,3
1713483942547,CLRE 260,A00,507221,Cuomo; Raphael Eduardo,9999,0,9999,0
1713483943576,CLRE 297,001,507242,Cuomo; Raphael Eduardo,9999,0,9999,0
1713483944602,CSE 191,A00,516875,Minnes Kemp; Mor Mia,9999,0,9999,0
1713483945628,CSS 201S,A01,494383,Staff,35,0,35,0
1713483946654,CSS 202S,A01,494387,Staff,35,0,35,0
1713483947682,EAP 100,A00,516065,Staff,9792,0,9999,207
1713483948709,ECE 45,A01,507414,Staff,38,0,60,22
1713483949737,ECE 100,A01,507416,Baghdadchi; Saharnaz,3,0,20,17
1713483949737,ECE 100,A02,507418,Baghdadchi; Saharnaz,19,0,20,1
1713483950766,ECE 111,A01,507420,Staff,28,0,50,22
1713483951791,ECE 197,001,548057,Sievenpiper; Daniel F.,9998,0,9999,1
1713483952817,EDS 115,A00,507243,Choi; Bailey Miyeon,27,0,28,1
1713483953843,EDS 117,A01,494379,Staff,16,0,25,9
1713483954868,EDS 125,A00,507246,Hopkins; Megan Beth,28,0,30,2
1713483955896,EDS 128A,A01,507264,Fargason; Sharon Gayle,26,0,26,0
1713483956925,EDS 128B,A01,507293,Pappas; Elizabeth,30,0,30,0
1713483957953,EDS 139,A00,507294,Fargason; Sharon Gayle,30,0,30,0
1713483957953,EDS 139,B00,507313,Pappas; Elizabeth,30,0,30,0
1713483958982,EDS 201,A00,507315,Staff,19,0,30,11
1713483960013,EDS 203,A01,507317,Halter; Christopher P.,18,0,30,12
1713483961039,EDS 204R,A01,507319,Halter; Christopher P.,0,1,30,30
1713483961039,EDS 204R,B01,507331,Heinzman; Erica M.,26,0,30,4
1713483962065,EDS 206R,A00,507332,Staff,0,1,30,30
1713483962065,EDS 206R,B00,507343,Staff,27,0,30,3
1713483963094,EDS 250,A00,507344,Hemans; Patricia Ann Benitez,28,0,40,12
1713483964122,EDS 281,A00,507345,Daly; Alan J.,18,0,18,0
1713483965151,EDS 284,A00,507350,Daly; Alan J.,16,0,16,0
1713483966178,EDS 286,A00,507359,Fine; Sarah,18,0,18,0
1713483967205,EDS 289C,A01,507361,Daly; Alan J.,18,0,18,0
1713483968231,EDS 290,A00,507366,Hofstetter; Carolyn,15,0,15,0
1713483969263,LIGM 5A,A00,507421,Fischer-Grunski; Eva K,20,0,20,0
1713483970294,LIGM 5B,A00,507423,Fischer-Grunski; Eva K,20,0,20,0
1713483971319,LIGM 5C,A00,507425,Fischer-Grunski; Eva K,20,0,20,0
1713483972346,LIIT 5AS,A00,507427,Carnelos; Chiara,20,0,20,0
1713483973370,LIIT 5BS,A00,507430,Carnelos; Chiara,20,0,20,0
1713483974395,LIIT 5CS,A00,507432,Carnelos; Chiara,20,0,20,0
1713483975422,LISP 5A,A00,507541,Munoz Sanchez; Alicia,14,0,20,6
1713483976451,LISP 5B,A00,507671,Munoz Sanchez; Alicia,12,0,20,8
1713483977477,LISP 5C,A00,507696,Munoz Sanchez; Alicia,11,0,20,9
1713483978506,MAE 197,001,528363,Boechler; Nicholas Sebastia,9998,0,9999,1
1713483979533,MATH 197,001,523477,Kedlaya; Kiran S.,9999,0,9999,0
1713483979533,MATH 197,002,563811,Zhang; Danna,9998,0,9999,1
1713483980559,MCWP 40R,A00,518780,Staff,17,0,20,3
1713483980559,MCWP 40R,B00,518781,Staff,14,0,20,6
1713483980559,MCWP 40R,C00,518783,Staff,11,0,20,9
1713483981584,MCWP 50R,A00,518791,Staff,8,0,20,12
1713483981584,MCWP 50R,B00,518792,Staff,7,0,20,13
1713483981584,MCWP 50R,C00,518793,Staff,7,0,20,13
1713483981584,MCWP 50R,D00,518794,Staff,1,0,20,19
1713483981584,MCWP 50R,E00,518795,Staff,3,0,20,17
1713483981584,MCWP 50R,F00,518796,Staff,13,0,20,7
1713483981584,MCWP 50R,G00,518797,Staff,12,0,20,8
1713483982612,MMW 12R,A01,514034,Herbst; Matthew,8,0,16,8
1713483982612,MMW 12R,A02,514035,Herbst; Matthew,13,0,16,3
1713483983641,MMW 13R,A01,514037,Staff,0,2,16,16
1713483983641,MMW 13R,A02,514039,Staff,0,2,16,16
1713483985696,SIO 295LS,A00,523233,Staff,15,0,30,15
1713483986721,SIO 295S,A00,523232,Staff,15,0,30,15
1713483987750,SOCI 117,A01,494376,Staff,0,2,5,5
1713483988777,WES 237B,A00,494380,Staff,19,0,20,1
1713483990837,AESE 279B,A00,494370,Wade; Jon P,33,0,33,0
1713483991865,AIP 197,001,627712,Vespa; Emanuel Ignacio,9999,0,9999,0
1713483992892,ANAR 135S,A00,494369,Braswell; Geoffrey E.,0,0,0,0
1713483993916,CAT 124RS,A01,519847,Geibel; William,6,0,20,14
1713483994940,CAT 125RS,A01,515971,Geibel; William,6,0,20,14
1713483995965,CLRE 250,A00,511389,Morris; Sheldon,9996,0,9999,3
1713483996990,CLRE 251,A00,507176,Mehta; Ravindra L.,9996,0,9999,3
1713483996990,CLRE 251,B00,511410,Mehta; Ravindra L.,9998,0,9999,1
1713483998013,CLRE 252,A00,507189,Cuomo; Raphael Eduardo,9998,0,9999,1
1713483999043,CLRE 253,A00,507199,Vaida; Florin,9997,0,9999,2
1713483999043,CLRE 253,B00,507202,Vaida; Florin,9999,0,9999,0
1713484000070,CLRE 259,A00,507211,Patel; Hemal,9996,0,9999,3
1713484001096,CLRE 260,A00,507221,Cuomo; Raphael Eduardo,9999,0,9999,0
1713484002123,CLRE 297,001,507242,Cuomo; Raphael Eduardo,9999,0,9999,0
1713484003149,CSE 191,A00,516875,Minnes Kemp; Mor Mia,9999,0,9999,0
1713484004178,CSS 201S,A01,494383,Staff,35,0,35,0
1713484005204,CSS 202S,A01,494387,Staff,35,0,35,0
1713484006229,EAP 100,A00,516065,Staff,9792,0,9999,207
1713484007254,ECE 45,A01,507414,Staff,38,0,60,22
1713484008280,ECE 100,A01,507416,Baghdadchi; Saharnaz,3,0,20,17
1713484008280,ECE 100,A02,507418,Baghdadchi; Saharnaz,19,0,20,1
1713484009305,ECE 111,A01,507420,Staff,28,0,50,22
1713484010331,ECE 197,001,548057,Sievenpiper; Daniel F.,9998,0,9999,1
1713484011359,EDS 115,A00,507243,Choi; Bailey Miyeon,27,0,28,1
1713484012386,EDS 117,A01,494379,Staff,16,0,25,9
1713484013413,EDS 125,A00,507246,Hopkins; Megan Beth,28,0,30,2
1713484014438,EDS 128A,A01,507264,Fargason; Sharon Gayle,26,0,26,0
1713484015462,EDS 128B,A01,507293,Pappas; Elizabeth,30,0,30,0
1713484016490,EDS 139,A00,507294,Fargason; Sharon Gayle,30,0,30,0
1713484016490,EDS 139,B00,507313,Pappas; Elizabeth,30,0,30,0
1713484017515,EDS 201,A00,507315,Staff,19,0,30,11
1713484018542,EDS 203,A01,507317,Halter; Christopher P.,18,0,30,12
1713484019567,EDS 204R,A01,507319,Halter; Christopher P.,0,1,30,30
1713484019567,EDS 204R,B01,507331,Heinzman; Erica M.,26,0,30,4
1713484020599,EDS 206R,A00,507332,Staff,0,1,30,30
1713484020599,EDS 206R,B00,507343,Staff,27,0,30,3
1713484021624,EDS 250,A00,507344,Hemans; Patricia Ann Benitez,28,0,40,12
1713484022651,EDS 281,A00,507345,Daly; Alan J.,18,0,18,0
1713484023677,EDS 284,A00,507350,Daly; Alan J.,16,0,16,0
1713484024703,EDS 286,A00,507359,Fine; Sarah,18,0,18,0
1713484025729,EDS 289C,A01,507361,Daly; Alan J.,18,0,18,0
1713484026755,EDS 290,A00,507366,Hofstetter; Carolyn,15,0,15,0
1713484027781,LIGM 5A,A00,507421,Fischer-Grunski; Eva K,20,0,20,0
1713484028813,LIGM 5B,A00,507423,Fischer-Grunski; Eva K,20,0,20,0
1713484029841,LIGM 5C,A00,507425,Fischer-Grunski; Eva K,20,0,20,0
1713484030869,LIIT 5AS,A00,507427,Carnelos; Chiara,20,0,20,0
1713484031894,LIIT 5BS,A00,507430,Carnelos; Chiara,20,0,20,0
1713484032923,LIIT 5CS,A00,507432,Carnelos; Chiara,20,0,20,0
1713484033954,LISP 5A,A00,507541,Munoz Sanchez; Alicia,14,0,20,6
1713484034982,LISP 5B,A00,507671,Munoz Sanchez; Alicia,12,0,20,8
1713484036007,LISP 5C,A00,507696,Munoz Sanchez; Alicia,11,0,20,9
1713484037037,MAE 197,001,528363,Boechler; Nicholas Sebastia,9998,0,9999,1
1713484038063,MATH 197,001,523477,Kedlaya; Kiran S.,9999,0,9999,0
1713484038063,MATH 197,002,563811,Zhang; Danna,9998,0,9999,1
1713484039089,MCWP 40R,A00,518780,Staff,17,0,20,3
1713484039089,MCWP 40R,B00,518781,Staff,14,0,20,6
1713484039089,MCWP 40R,C00,518783,Staff,11,0,20,9
1713484040119,MCWP 50R,A00,518791,Staff,8,0,20,12
1713484040119,MCWP 50R,B00,518792,Staff,7,0,20,13
1713484040119,MCWP 50R,C00,518793,Staff,7,0,20,13
1713484040119,MCWP 50R,D00,518794,Staff,1,0,20,19
1713484040119,MCWP 50R,E00,518795,Staff,3,0,20,17
1713484040119,MCWP 50R,F00,518796,Staff,13,0,20,7
1713484040119,MCWP 50R,G00,518797,Staff,12,0,20,8
1713484041198,MMW 12R,A01,514034,Herbst; Matthew,8,0,16,8
1713484041198,MMW 12R,A02,514035,Herbst; Matthew,13,0,16,3
1713484042224,MMW 13R,A01,514037,Staff,0,2,16,16
1713484042224,MMW 13R,A02,514039,Staff,0,2,16,16
1713484044280,SIO 295LS,A00,523233,Staff,15,0,30,15
1713484045305,SIO 295S,A00,523232,Staff,15,0,30,15
1713484046331,SOCI 117,A01,494376,Staff,0,2,5,5
1713484047361,WES 237B,A00,494380,Staff,19,0,20,1
1713484049423,AESE 279B,A00,494370,Wade; Jon P,33,0,33,0
1713484050452,AIP 197,001,627712,Vespa; Emanuel Ignacio,9999,0,9999,0
1713484051477,ANAR 135S,A00,494369,Braswell; Geoffrey E.,0,0,0,0
1713484052503,CAT 124RS,A01,519847,Geibel; William,6,0,20,14
1713484053535,CAT 125RS,A01,515971,Geibel; William,6,0,20,14
1713484054563,CLRE 250,A00,511389,Morris; Sheldon,9996,0,9999,3
1713484055588,CLRE 251,A00,507176,Mehta; Ravindra L.,9996,0,9999,3
1713484055588,CLRE 251,B00,511410,Mehta; Ravindra L.,9998,0,9999,1
1713484056616,CLRE 252,A00,507189,Cuomo; Raphael Eduardo,9998,0,9999,1
1713484057641,CLRE 253,A00,507199,Vaida; Florin,9997,0,9999,2
1713484057641,CLRE 253,B00,507202,Vaida; Florin,9999,0,9999,0
1713484058667,CLRE 259,A00,507211,Patel; Hemal,9996,0,9999,3
1713484059693,CLRE 260,A00,507221,Cuomo; Raphael Eduardo,9999,0,9999,0
1713484060720,CLRE 297,001,507242,Cuomo; Raphael Eduardo,9999,0,9999,0
1713484061745,CSE 191,A00,516875,Minnes Kemp; Mor Mia,9999,0,9999,0
1713484062772,CSS 201S,A01,494383,Staff,35,0,35,0
1713484063801,CSS 202S,A01,494387,Staff,35,0,35,0
1713484064826,EAP 100,A00,516065,Staff,9792,0,9999,207
1713484065855,ECE 45,A01,507414,Staff,38,0,60,22
1713484066880,ECE 100,A01,507416,Baghdadchi; Saharnaz,3,0,20,17
1713484066880,ECE 100,A02,507418,Baghdadchi; Saharnaz,19,0,20,1
1713484067909,ECE 111,A01,507420,Staff,28,0,50,22
1713484068941,ECE 197,001,548057,Sievenpiper; Daniel F.,9998,0,9999,1
1713484069970,EDS 115,A00,507243,Choi; Bailey Miyeon,27,0,28,1
1713484070994,EDS 117,A01,494379,Staff,16,0,25,9
1713484072023,EDS 125,A00,507246,Hopkins; Megan Beth,28,0,30,2
1713484073053,EDS 128A,A01,507264,Fargason; Sharon Gayle,26,0,26,0
1713484074078,EDS 128B,A01,507293,Pappas; Elizabeth,30,0,30,0
1713484075103,EDS 139,A00,507294,Fargason; Sharon Gayle,30,0,30,0
1713484075103,EDS 139,B00,507313,Pappas; Elizabeth,30,0,30,0
1713484076130,EDS 201,A00,507315,Staff,19,0,30,11
1713484077160,EDS 203,A01,507317,Halter; Christopher P.,18,0,30,12
1713484078185,EDS 204R,A01,507319,Halter; Christopher P.,0,1,30,30
1713484078185,EDS 204R,B01,507331,Heinzman; Erica M.,26,0,30,4
1713484079210,EDS 206R,A00,507332,Staff,0,1,30,30
1713484079210,EDS 206R,B00,507343,Staff,27,0,30,3
1713484080235,EDS 250,A00,507344,Hemans; Patricia Ann Benitez,28,0,40,12
1713484081261,EDS 281,A00,507345,Daly; Alan J.,18,0,18,0
1713484082289,EDS 284,A00,507350,Daly; Alan J.,16,0,16,0
1713484083314,EDS 286,A00,507359,Fine; Sarah,18,0,18,0
1713484084342,EDS 289C,A01,507361,Daly; Alan J.,18,0,18,0
1713484085367,EDS 290,A00,507366,Hofstetter; Carolyn,15,0,15,0
1713484086392,LIGM 5A,A00,507421,Fischer-Grunski; Eva K,20,0,20,0
1713484087421,LIGM 5B,A00,507423,Fischer-Grunski; Eva K,20,0,20,0
1713484088447,LIGM 5C,A00,507425,Fischer-Grunski; Eva K,20,0,20,0
1713484089473,LIIT 5AS,A00,507427,Carnelos; Chiara,20,0,20,0
1713484090501,LIIT 5BS,A00,507430,Carnelos; Chiara,20,0,20,0
1713484091524,LIIT 5CS,A00,507432,Carnelos; Chiara,20,0,20,0
1713484092550,LISP 5A,A00,507541,Munoz Sanchez; Alicia,14,0,20,6
1713484093576,LISP 5B,A00,507671,Munoz Sanchez; Alicia,12,0,20,8
1713484094601,LISP 5C,A00,507696,Munoz Sanchez; Alicia,11,0,20,9
1713484095630,MAE 197,001,528363,Boechler; Nicholas Sebastia,9998,0,9999,1
1713484096656,MATH 197,001,523477,Kedlaya; Kiran S.,9999,0,9999,0
1713484096656,MATH 197,002,563811,Zhang; Danna,9998,0,9999,1
1713484097688,MCWP 40R,A00,518780,Staff,17,0,20,3
1713484097688,MCWP 40R,B00,518781,Staff,14,0,20,6
1713484097688,MCWP 40R,C00,518783,Staff,11,0,20,9
1713484098712,MCWP 50R,A00,518791,Staff,8,0,20,12
1713484098712,MCWP 50R,B00,518792,Staff,7,0,20,13
1713484098712,MCWP 50R,C00,518793,Staff,7,0,20,13
1713484098712,MCWP 50R,D00,518794,Staff,0,0,20,20
1713484098712,MCWP 50R,E00,518795,Staff,3,0,20,17
1713484098712,MCWP 50R,F00,518796,Staff,13,0,20,7
1713484098712,MCWP 50R,G00,518797,Staff,12,0,20,8
1713484099736,MMW 12R,A01,514034,Herbst; Matthew,8,0,16,8
1713484099736,MMW 12R,A02,514035,Herbst; Matthew,13,0,16,3
1713484100764,MMW 13R,A01,514037,Staff,0,2,16,16
1713484100764,MMW 13R,A02,514039,Staff,0,3,16,16
1713484102815,SIO 295LS,A00,523233,Staff,15,0,30,15
1713484103839,SIO 295S,A00,523232,Staff,15,0,30,15
1713484104868,SOCI 117,A01,494376,Staff,0,2,5,5
1713484105899,WES 237B,A00,494380,Staff,19,0,20,1
1713484107971,AESE 279B,A00,494370,Wade; Jon P,33,0,33,0
1713484108995,AIP 197,001,627712,Vespa; Emanuel Ignacio,9999,0,9999,0
1713484110023,ANAR 135S,A00,494369,Braswell; Geoffrey E.,0,0,0,0
1713484111048,CAT 124RS,A01,519847,Geibel; William,6,0,20,14
1713484112077,CAT 125RS,A01,515971,Geibel; William,6,0,20,14
1713484113105,CLRE 250,A00,511389,Morris; Sheldon,9996,0,9999,3
1713484114133,CLRE 251,A00,507176,Mehta; Ravindra L.,9996,0,9999,3
1713484114133,CLRE 251,B00,511410,Mehta; Ravindra L.,9998,0,9999,1
1713484115157,CLRE 252,A00,507189,Cuomo; Raphael Eduardo,9998,0,9999,1
1713484116184,CLRE 253,A00,507199,Vaida; Florin,9997,0,9999,2
1713484116184,CLRE 253,B00,507202,Vaida; Florin,9999,0,9999,0
1713484117208,CLRE 259,A00,507211,Patel; Hemal,9996,0,9999,3
1713484118233,CLRE 260,A00,507221,Cuomo; Raphael Eduardo,9999,0,9999,0
1713484119259,CLRE 297,001,507242,Cuomo; Raphael Eduardo,9999,0,9999,0
1713484120288,CSE 191,A00,516875,Minnes Kemp; Mor Mia,9999,0,9999,0
1713484121312,CSS 201S,A01,494383,Staff,35,0,35,0
1713484122337,CSS 202S,A01,494387,Staff,35,0,35,0
1713484123364,EAP 100,A00,516065,Staff,9792,0,9999,207
1713484124388,ECE 45,A01,507414,Staff,38,0,60,22
1713484125417,ECE 100,A01,507416,Baghdadchi; Saharnaz,3,0,20,17
1713484125417,ECE 100,A02,507418,Baghdadchi; Saharnaz,19,0,20,1
1713484126445,ECE 111,A01,507420,Staff,28,0,50,22
1713484127468,ECE 197,001,548057,Sievenpiper; Daniel F.,9998,0,9999,1
1713484128493,EDS 115,A00,507243,Choi; Bailey Miyeon,27,0,28,1
1713484129519,EDS 117,A01,494379,Staff,16,0,25,9
1713484130545,EDS 125,A00,507246,Hopkins; Megan Beth,28,0,30,2
1713484131576,EDS 128A,A01,507264,Fargason; Sharon Gayle,26,0,26,0
1713484132603,EDS 128B,A01,507293,Pappas; Elizabeth,30,0,30,0
1713484133631,EDS 139,A00,507294,Fargason; Sharon Gayle,30,0,30,0
1713484133631,EDS 139,B00,507313,Pappas; Elizabeth,30,0,30,0
1713484134657,EDS 201,A00,507315,Staff,19,0,30,11
1713484135685,EDS 203,A01,507317,Halter; Christopher P.,18,0,30,12
1713484136713,EDS 204R,A01,507319,Halter; Christopher P.,0,1,30,30
1713484136713,EDS 204R,B01,507331,Heinzman; Erica M.,26,0,30,4
1713484137741,EDS 206R,A00,507332,Staff,0,1,30,30
1713484137741,EDS 206R,B00,507343,Staff,27,0,30,3
1713484138768,EDS 250,A00,507344,Hemans; Patricia Ann Benitez,28,0,40,12
1713484139793,EDS 281,A00,507345,Daly; Alan J.,18,0,18,0
1713484140818,EDS 284,A00,507350,Daly; Alan J.,16,0,16,0
1713484141846,EDS 286,A00,507359,Fine; Sarah,18,0,18,0
1713484142874,EDS 289C,A01,507361,Daly; Alan J.,18,0,18,0
1713484143905,EDS 290,A00,507366,Hofstetter; Carolyn,15,0,15,0
1713484145005,LIGM 5A,A00,507421,Fischer-Grunski; Eva K,20,0,20,0
1713484146030,LIGM 5B,A00,507423,Fischer-Grunski; Eva K,20,0,20,0
1713484147055,LIGM 5C,A00,507425,Fischer-Grunski; Eva K,20,0,20,0
1713484148080,LIIT 5AS,A00,507427,Carnelos; Chiara,20,0,20,0
1713484149108,LIIT 5BS,A00,507430,Carnelos; Chiara,20,0,20,0
1713484150137,LIIT 5CS,A00,507432,Carnelos; Chiara,20,0,20,0
1713484151163,LISP 5A,A00,507541,Munoz Sanchez; Alicia,14,0,20,6
1713484152187,LISP 5B,A00,507671,Munoz Sanchez; Alicia,12,0,20,8
1713484153215,LISP 5C,A00,507696,Munoz Sanchez; Alicia,11,0,20,9
1713484154240,MAE 197,001,528363,Boechler; Nicholas Sebastia,9998,0,9999,1
1713484155269,MATH 197,001,523477,Kedlaya; Kiran S.,9999,0,9999,0
1713484155269,MATH 197,002,563811,Zhang; Danna,9998,0,9999,1
1713484156294,MCWP 40R,A00,518780,Staff,17,0,20,3
1713484156294,MCWP 40R,B00,518781,Staff,14,0,20,6
1713484156294,MCWP 40R,C00,518783,Staff,11,0,20,9
1713484157321,MCWP 50R,A00,518791,Staff,8,0,20,12
1713484157321,MCWP 50R,B00,518792,Staff,7,0,20,13
1713484157321,MCWP 50R,C00,518793,Staff,7,0,20,13
1713484157321,MCWP 50R,D00,518794,Staff,0,0,20,20
1713484157321,MCWP 50R,E00,518795,Staff,3,0,20,17
1713484157321,MCWP 50R,F00,518796,Staff,13,0,20,7
1713484157321,MCWP 50R,G00,518797,Staff,12,0,20,8
1713484158347,MMW 12R,A01,514034,Herbst; Matthew,8,0,16,8
1713484158347,MMW 12R,A02,514035,Herbst; Matthew,13,0,16,3
1713484159372,MMW 13R,A01,514037,Staff,0,2,16,16
1713484159372,MMW 13R,A02,514039,Staff,0,3,16,16
1713484161422,SIO 295LS,A00,523233,Staff,15,0,30,15
1713484162446,SIO 295S,A00,523232,Staff,15,0,30,15
1713484163472,SOCI 117,A01,494376,Staff,0,2,5,5
1713484164500,WES 237B,A00,494380,Staff,19,0,20,1
1713484166573,AESE 279B,A00,494370,Wade; Jon P,33,0,33,0
1713484167602,AIP 197,001,627712,Vespa; Emanuel Ignacio,9999,0,9999,0
1713484168625,ANAR 135S,A00,494369,Braswell; Geoffrey E.,0,0,0,0
1713484169652,CAT 124RS,A01,519847,Geibel; William,6,0,20,14
1713484170680,CAT 125RS,A01,515971,Geibel; William,6,0,20,14
1713484171706,CLRE 250,A00,511389,Morris; Sheldon,9996,0,9999,3
1713484172732,CLRE 251,A00,507176,Mehta; Ravindra L.,9996,0,9999,3
1713484172732,CLRE 251,B00,511410,Mehta; Ravindra L.,9998,0,9999,1
1713484173757,CLRE 252,A00,507189,Cuomo; Raphael Eduardo,9998,0,9999,1
1713484174784,CLRE 253,A00,507199,Vaida; Florin,9997,0,9999,2
1713484174784,CLRE 253,B00,507202,Vaida; Florin,9999,0,9999,0
1713484175809,CLRE 259,A00,507211,Patel; Hemal,9996,0,9999,3
1713484176837,CLRE 260,A00,507221,Cuomo; Raphael Eduardo,9999,0,9999,0
1713484177866,CLRE 297,001,507242,Cuomo; Raphael Eduardo,9999,0,9999,0
1713484178893,CSE 191,A00,516875,Minnes Kemp; Mor Mia,9999,0,9999,0
1713484179923,CSS 201S,A01,494383,Staff,35,0,35,0
1713484180952,CSS 202S,A01,494387,Staff,35,0,35,0
1713484181977,EAP 100,A00,516065,Staff,9792,0,9999,207
1713484183002,ECE 45,A01,507414,Staff,38,0,60,22
1713484184028,ECE 100,A01,507416,Baghdadchi; Saharnaz,3,0,20,17
1713484184028,ECE 100,A02,507418,Baghdadchi; Saharnaz,19,0,20,1
1713484185057,ECE 111,A01,507420,Staff,28,0,50,22
1713484186083,ECE 197,001,548057,Sievenpiper; Daniel F.,9998,0,9999,1
1713484187107,EDS 115,A00,507243,Choi; Bailey Miyeon,27,0,28,1
1713484188137,EDS 117,A01,494379,Staff,16,0,25,9
1713484189162,EDS 125,A00,507246,Hopkins; Megan Beth,28,0,30,2
1713484190191,EDS 128A,A01,507264,Fargason; Sharon Gayle,26,0,26,0
1713484191217,EDS 128B,A01,507293,Pappas; Elizabeth,30,0,30,0
1713484192245,EDS 139,A00,507294,Fargason; Sharon Gayle,30,0,30,0
1713484192245,EDS 139,B00,507313,Pappas; Elizabeth,30,0,30,0
1713484193270,EDS 201,A00,507315,Staff,19,0,30,11
1713484194295,EDS 203,A01,507317,Halter; Christopher P.,18,0,30,12
1713484195324,EDS 204R,A01,507319,Halter; Christopher P.,0,1,30,30
1713484195324,EDS 204R,B01,507331,Heinzman; Erica M.,26,0,30,4
1713484196349,EDS 206R,A00,507332,Staff,0,1,30,30
1713484196349,EDS 206R,B00,507343,Staff,27,0,30,3
1713484197375,EDS 250,A00,507344,Hemans; Patricia Ann Benitez,28,0,40,12
1713484198401,EDS 281,A00,507345,Daly; Alan J.,18,0,18,0
1713484199427,EDS 284,A00,507350,Daly; Alan J.,16,0,16,0
1713484200454,EDS 286,A00,507359,Fine; Sarah,18,0,18,0
1713484201479,EDS 289C,A01,507361,Daly; Alan J.,18,0,18,0
1713484202504,EDS 290,A00,507366,Hofstetter; Carolyn,15,0,15,0
1713484203533,LIGM 5A,A00,507421,Fischer-Grunski; Eva K,20,0,20,0
1713484204558,LIGM 5B,A00,507423,Fischer-Grunski; Eva K,20,0,20,0
1713484205588,LIGM 5C,A00,507425,Fischer-Grunski; Eva K,20,0,20,0
1713484206613,LIIT 5AS,A00,507427,Carnelos; Chiara,20,0,20,0
1713484207637,LIIT 5BS,A00,507430,Carnelos; Chiara,20,0,20,0
1713484208666,LIIT 5CS,A00,507432,Carnelos; Chiara,20,0,20,0
1713484209691,LISP 5A,A00,507541,Munoz Sanchez; Alicia,14,0,20,6
1713484210715,LISP 5B,A00,507671,Munoz Sanchez; Alicia,12,0,20,8
1713484211740,LISP 5C,A00,507696,Munoz Sanchez; Alicia,11,0,20,9
1713484212765,MAE 197,001,528363,Boechler; Nicholas Sebastia,9998,0,9999,1
1713484213790,MATH 197,001,523477,Kedlaya; Kiran S.,9999,0,9999,0
1713484213790,MATH 197,002,563811,Zhang; Danna,9998,0,9999,1
1713484214816,MCWP 40R,A00,518780,Staff,17,0,20,3
1713484214816,MCWP 40R,B00,518781,Staff,14,0,20,6
1713484214816,MCWP 40R,C00,518783,Staff,11,0,20,9
1713484215849,MCWP 50R,A00,518791,Staff,8,0,20,12
1713484215849,MCWP 50R,B00,518792,Staff,7,0,20,13
1713484215849,MCWP 50R,C00,518793,Staff,7,0,20,13
1713484215849,MCWP 50R,D00,518794,Staff,0,0,20,20
1713484215849,MCWP 50R,E00,518795,Staff,3,0,20,17
1713484215849,MCWP 50R,F00,518796,Staff,13,0,20,7
1713484215849,MCWP 50R,G00,518797,Staff,12,0,20,8
1713484216880,MMW 12R,A01,514034,Herbst; Matthew,8,0,16,8
1713484216880,MMW 12R,A02,514035,Herbst; Matthew,13,0,16,3
1713484217906,MMW 13R,A01,514037,Staff,0,2,16,16
1713484217906,MMW 13R,A02,514039,Staff,0,3,16,16
1713484219984,SIO 295LS,A00,523233,Staff,15,0,30,15
1713484221013,SIO 295S,A00,523232,Staff,15,0,30,15
1713484222043,SOCI 117,A01,494376,Staff,0,2,5,5
1713484223070,WES 237B,A00,494380,Staff,19,0,20,1
1713484225133,AESE 279B,A00,494370,Wade; Jon P,33,0,33,0
1713484226159,AIP 197,001,627712,Vespa; Emanuel Ignacio,9999,0,9999,0
1713484227185,ANAR 135S,A00,494369,Braswell; Geoffrey E.,0,0,0,0
1713484228213,CAT 124RS,A01,519847,Geibel; William,6,0,20,14
1713484229242,CAT 125RS,A01,515971,Geibel; William,6,0,20,14
1713484230267,CLRE 250,A00,511389,Morris; Sheldon,9996,0,9999,3
1713484231294,CLRE 251,A00,507176,Mehta; Ravindra L.,9996,0,9999,3
1713484231294,CLRE 251,B00,511410,Mehta; Ravindra L.,9998,0,9999,1
1713484232321,CLRE 252,A00,507189,Cuomo; Raphael Eduardo,9998,0,9999,1
1713484233350,CLRE 253,A00,507199,Vaida; Florin,9997,0,9999,2
1713484233350,CLRE 253,B00,507202,Vaida; Florin,9999,0,9999,0
1713484234376,CLRE 259,A00,507211,Patel; Hemal,9996,0,9999,3
1713484235401,CLRE 260,A00,507221,Cuomo; Raphael Eduardo,9999,0,9999,0
1713484236425,CLRE 297,001,507242,Cuomo; Raphael Eduardo,9999,0,9999,0
1713484237450,CSE 191,A00,516875,Minnes Kemp; Mor Mia,9999,0,9999,0
1713484238475,CSS 201S,A01,494383,Staff,35,0,35,0
1713484239505,CSS 202S,A01,494387,Staff,35,0,35,0
1713484240529,EAP 100,A00,516065,Staff,9792,0,9999,207
1713484241555,ECE 45,A01,507414,Staff,38,0,60,22
1713484242581,ECE 100,A01,507416,Baghdadchi; Saharnaz,3,0,20,17
1713484242581,ECE 100,A02,507418,Baghdadchi; Saharnaz,19,0,20,1
1713484243606,ECE 111,A01,507420,Staff,28,0,50,22
1713484244630,ECE 197,001,548057,Sievenpiper; Daniel F.,9998,0,9999,1
1713484245656,EDS 115,A00,507243,Choi; Bailey Miyeon,27,0,28,1
1713484246683,EDS 117,A01,494379,Staff,16,0,25,9
1713484247708,EDS 125,A00,507246,Hopkins; Megan Beth,28,0,30,2
1713484248793,EDS 128A,A01,507264,Fargason; Sharon Gayle,26,0,26,0
1713484249825,EDS 128B,A01,507293,Pappas; Elizabeth,30,0,30,0
1713484250851,EDS 139,A00,507294,Fargason; Sharon Gayle,30,0,30,0
1713484250851,EDS 139,B00,507313,Pappas; Elizabeth,30,0,30,0
1713484251879,EDS 201,A00,507315,Staff,19,0,30,11
1713484252908,EDS 203,A01,507317,Halter; Christopher P.,18,0,30,12
1713484253939,EDS 204R,A01,507319,Halter; Christopher P.,0,1,30,30
1713484253939,EDS 204R,B01,507331,Heinzman; Erica M.,26,0,30,4
1713484254963,EDS 206R,A00,507332,Staff,0,1,30,30
1713484254963,EDS 206R,B00,507343,Staff,27,0,30,3
1713484255989,EDS 250,A00,507344,Hemans; Patricia Ann Benitez,28,0,40,12
1713484257015,EDS 281,A00,507345,Daly; Alan J.,18,0,18,0
1713484258043,EDS 284,A00,507350,Daly; Alan J.,16,0,16,0
1713484259067,EDS 286,A00,507359,Fine; Sarah,18,0,18,0
1713484260092,EDS 289C,A01,507361,Daly; Alan J.,18,0,18,0
1713484261121,EDS 290,A00,507366,Hofstetter; Carolyn,15,0,15,0
1713484262147,LIGM 5A,A00,507421,Fischer-Grunski; Eva K,20,0,20,0
1713484263200,LIGM 5B,A00,507423,Fischer-Grunski; Eva K,20,0,20,0
1713484264224,LIGM 5C,A00,507425,Fischer-Grunski; Eva K,20,0,20,0
1713484265249,LIIT 5AS,A00,507427,Carnelos; Chiara,20,0,20,0
1713484266277,LIIT 5BS,A00,507430,Carnelos; Chiara,20,0,20,0
1713484267303,LIIT 5CS,A00,507432,Carnelos; Chiara,20,0,20,0
1713484268334,LISP 5A,A00,507541,Munoz Sanchez; Alicia,14,0,20,6
1713484269358,LISP 5B,A00,507671,Munoz Sanchez; Alicia,12,0,20,8
1713484270384,LISP 5C,A00,507696,Munoz Sanchez; Alicia,11,0,20,9
1713484271409,MAE 197,001,528363,Boechler; Nicholas Sebastia,9998,0,9999,1
1713484272436,MATH 197,001,523477,Kedlaya; Kiran S.,9999,0,9999,0
1713484272436,MATH 197,002,563811,Zhang; Danna,9998,0,9999,1
1713484273461,MCWP 40R,A00,518780,Staff,17,0,20,3
1713484273461,MCWP 40R,B00,518781,Staff,14,0,20,6
1713484273461,MCWP 40R,C00,518783,Staff,11,0,20,9
1713484274486,MCWP 50R,A00,518791,Staff,8,0,20,12
1713484274486,MCWP 50R,B00,518792,Staff,7,0,20,13
1713484274486,MCWP 50R,C00,518793,Staff,7,0,20,13
1713484274486,MCWP 50R,D00,518794,Staff,0,0,20,20
1713484274486,MCWP 50R,E00,518795,Staff,3,0,20,17
1713484274486,MCWP 50R,F00,518796,Staff,13,0,20,7
1713484274486,MCWP 50R,G00,518797,Staff,12,0,20,8
1713484275520,MMW 12R,A01,514034,Herbst; Matthew,8,0,16,8
1713484275520,MMW 12R,A02,514035,Herbst; Matthew,13,0,16,3
1713484276552,MMW 13R,A01,514037,Staff,0,2,16,16
1713484276552,MMW 13R,A02,514039,Staff,0,3,16,16
1713484278605,SIO 295LS,A00,523233,Staff,15,0,30,15
1713484279632,SIO 295S,A00,523232,Staff,15,0,30,15
1713484280658,SOCI 117,A01,494376,Staff,0,2,5,5
1713484281682,WES 237B,A00,494380,Staff,19,0,20,1
1713484283746,AESE 279B,A00,494370,Wade; Jon P,33,0,33,0
1713484284771,AIP 197,001,627712,Vespa; Emanuel Ignacio,9999,0,9999,0
1713484285796,ANAR 135S,A00,494369,Braswell; Geoffrey E.,0,0,0,0
1713484286825,CAT 124RS,A01,519847,Geibel; William,6,0,20,14
1713484287852,CAT 125RS,A01,515971,Geibel; William,6,0,20,14
1713484288878,CLRE 250,A00,511389,Morris; Sheldon,9996,0,9999,3
1713484289907,CLRE 251,A00,507176,Mehta; Ravindra L.,9996,0,9999,3
1713484289907,CLRE 251,B00,511410,Mehta; Ravindra L.,9998,0,9999,1
1713484290933,CLRE 252,A00,507189,Cuomo; Raphael Eduardo,9998,0,9999,1
1713484291958,CLRE 253,A00,507199,Vaida; Florin,9997,0,9999,2
1713484291958,CLRE 253,B00,507202,Vaida; Florin,9999,0,9999,0
1713484292986,CLRE 259,A00,507211,Patel; Hemal,9996,0,9999,3
1713484294012,CLRE 260,A00,507221,Cuomo; Raphael Eduardo,9999,0,9999,0
1713484295039,CLRE 297,001,507242,Cuomo; Raphael Eduardo,9999,0,9999,0
1713484296068,CSE 191,A00,516875,Minnes Kemp; Mor Mia,9999,0,9999,0
1713484297094,CSS 201S,A01,494383,Staff,35,0,35,0
1713484298119,CSS 202S,A01,494387,Staff,35,0,35,0
1713484299143,EAP 100,A00,516065,Staff,9792,0,9999,207
1713484300171,ECE 45,A01,507414,Staff,38,0,60,22
1713484301197,ECE 100,A01,507416,Baghdadchi; Saharnaz,3,0,20,17
1713484301197,ECE 100,A02,507418,Baghdadchi; Saharnaz,19,0,20,1
1713484302225,ECE 111,A01,507420,Staff,28,0,50,22
1713484303250,ECE 197,001,548057,Sievenpiper; Daniel F.,9998,0,9999,1
1713484304278,EDS 115,A00,507243,Choi; Bailey Miyeon,27,0,28,1
1713484305302,EDS 117,A01,494379,Staff,16,0,25,9
1713484306330,EDS 125,A00,507246,Hopkins; Megan Beth,28,0,30,2
1713484307360,EDS 128A,A01,507264,Fargason; Sharon Gayle,26,0,26,0
1713484308388,EDS 128B,A01,507293,Pappas; Elizabeth,30,0,30,0
1713484309414,EDS 139,A00,507294,Fargason; Sharon Gayle,30,0,30,0
1713484309414,EDS 139,B00,507313,Pappas; Elizabeth,30,0,30,0
1713484310442,EDS 201,A00,507315,Staff,19,0,30,11
1713484311466,EDS 203,A01,507317,Halter; Christopher P.,18,0,30,12
1713484312491,EDS 204R,A01,507319,Halter; Christopher P.,0,1,30,30
1713484312491,EDS 204R,B01,507331,Heinzman; Erica M.,26,0,30,4
1713484313519,EDS 206R,A00,507332,Staff,0,1,30,30
1713484313519,EDS 206R,B00,507343,Staff,27,0,30,3
1713484314544,EDS 250,A00,507344,Hemans; Patricia Ann Benitez,28,0,40,12
1713484315571,EDS 281,A00,507345,Daly; Alan J.,18,0,18,0
1713484316601,EDS 284,A00,507350,Daly; Alan J.,16,0,16,0
1713484317627,EDS 286,A00,507359,Fine; Sarah,18,0,18,0
1713484318654,EDS 289C,A01,507361,Daly; Alan J.,18,0,18,0
1713484319680,EDS 290,A00,507366,Hofstetter; Carolyn,15,0,15,0
1713484320706,LIGM 5A,A00,507421,Fischer-Grunski; Eva K,20,0,20,0
1713484321731,LIGM 5B,A00,507423,Fischer-Grunski; Eva K,20,0,20,0
1713484322756,LIGM 5C,A00,507425,Fischer-Grunski; Eva K,20,0,20,0
1713484323782,LIIT 5AS,A00,507427,Carnelos; Chiara,20,0,20,0
1713484324807,LIIT 5BS,A00,507430,Carnelos; Chiara,20,0,20,0
1713484325832,LIIT 5CS,A00,507432,Carnelos; Chiara,20,0,20,0
1713484326866,LISP 5A,A00,507541,Munoz Sanchez; Alicia,14,0,20,6
1713484327894,LISP 5B,A00,507671,Munoz Sanchez; Alicia,12,0,20,8
1713484328926,LISP 5C,A00,507696,Munoz Sanchez; Alicia,11,0,20,9
1713484329951,MAE 197,001,528363,Boechler; Nicholas Sebastia,9998,0,9999,1
1713484330975,MATH 197,001,523477,Kedlaya; Kiran S.,9999,0,9999,0
1713484330975,MATH 197,002,563811,Zhang; Danna,9998,0,9999,1
1713484332001,MCWP 40R,A00,518780,Staff,17,0,20,3
1713484332001,MCWP 40R,B00,518781,Staff,14,0,20,6
1713484332001,MCWP 40R,C00,518783,Staff,11,0,20,9
1713484333032,MCWP 50R,A00,518791,Staff,8,0,20,12
1713484333032,MCWP 50R,B00,518792,Staff,7,0,20,13
1713484333032,MCWP 50R,C00,518793,Staff,7,0,20,13
1713484333032,MCWP 50R,D00,518794,Staff,0,0,20,20
1713484333032,MCWP 50R,E00,518795,Staff,3,0,20,17
1713484333032,MCWP 50R,F00,518796,Staff,13,0,20,7
1713484333032,MCWP 50R,G00,518797,Staff,12,0,20,8
1713484334058,MMW 12R,A01,514034,Herbst; Matthew,8,0,16,8
1713484334058,MMW 12R,A02,514035,Herbst; Matthew,13,0,16,3
1713484335083,MMW 13R,A01,514037,Staff,0,2,16,16
1713484335083,MMW 13R,A02,514039,Staff,0,3,16,16
1713484337138,SIO 295LS,A00,523233,Staff,15,0,30,15
1713484338166,SIO 295S,A00,523232,Staff,15,0,30,15
1713484339196,SOCI 117,A01,494376,Staff,0,2,5,5
1713484340222,WES 237B,A00,494380,Staff,19,0,20,1
1713484342287,AESE 279B,A00,494370,Wade; Jon P,33,0,33,0
1713484343313,AIP 197,001,627712,Vespa; Emanuel Ignacio,9999,0,9999,0
1713484344341,ANAR 135S,A00,494369,Braswell; Geoffrey E.,0,0,0,0
1713484345370,CAT 124RS,A01,519847,Geibel; William,6,0,20,14
1713484346395,CAT 125RS,A01,515971,Geibel; William,6,0,20,14
1713484347421,CLRE 250,A00,511389,Morris; Sheldon,9996,0,9999,3
1713484348450,CLRE 251,A00,507176,Mehta; Ravindra L.,9996,0,9999,3
1713484348450,CLRE 251,B00,511410,Mehta; Ravindra L.,9998,0,9999,1
1713484349478,CLRE 252,A00,507189,Cuomo; Raphael Eduardo,9998,0,9999,1
1713484350506,CLRE 253,A00,507199,Vaida; Florin,9997,0,9999,2
1713484350506,CLRE 253,B00,507202,Vaida; Florin,9999,0,9999,0
1713484351537,CLRE 259,A00,507211,Patel; Hemal,9996,0,9999,3
1713484352617,CLRE 260,A00,507221,Cuomo; Raphael Eduardo,9999,0,9999,0
1713484353647,CLRE 297,001,507242,Cuomo; Raphael Eduardo,9999,0,9999,0
1713484354672,CSE 191,A00,516875,Minnes Kemp; Mor Mia,9999,0,9999,0
1713484355697,CSS 201S,A01,494383,Staff,35,0,35,0
1713484356725,CSS 202S,A01,494387,Staff,35,0,35,0
1713484357748,EAP 100,A00,516065,Staff,9792,0,9999,207
1713484358774,ECE 45,A01,507414,Staff,38,0,60,22
1713484359802,ECE 100,A01,507416,Baghdadchi; Saharnaz,3,0,20,17
1713484359802,ECE 100,A02,507418,Baghdadchi; Saharnaz,19,0,20,1
1713484360828,ECE 111,A01,507420,Staff,28,0,50,22
1713484361856,ECE 197,001,548057,Sievenpiper; Daniel F.,9998,0,9999,1
1713484362883,EDS 115,A00,507243,Choi; Bailey Miyeon,27,0,28,1
1713484363912,EDS 117,A01,494379,Staff,16,0,25,9
1713484364936,EDS 125,A00,507246,Hopkins; Megan Beth,28,0,30,2
1713484365965,EDS 128A,A01,507264,Fargason; Sharon Gayle,26,0,26,0
1713484366993,EDS 128B,A01,507293,Pappas; Elizabeth,30,0,30,0
1713484368018,EDS 139,A00,507294,Fargason; Sharon Gayle,30,0,30,0
1713484368018,EDS 139,B00,507313,Pappas; Elizabeth,30,0,30,0
1713484369044,EDS 201,A00,507315,Staff,19,0,30,11
1713484370069,EDS 203,A01,507317,Halter; Christopher P.,18,0,30,12
1713484371094,EDS 204R,A01,507319,Halter; Christopher P.,0,1,30,30
1713484371094,EDS 204R,B01,507331,Heinzman; Erica M.,26,0,30,4
1713484372118,EDS 206R,A00,507332,Staff,0,1,30,30
1713484372118,EDS 206R,B00,507343,Staff,27,0,30,3
1713484373146,EDS 250,A00,507344,Hemans; Patricia Ann Benitez,28,0,40,12
1713484374171,EDS 281,A00,507345,Daly; Alan J.,18,0,18,0
1713484375197,EDS 284,A00,507350,Daly; Alan J.,16,0,16,0
1713484376224,EDS 286,A00,507359,Fine; Sarah,18,0,18,0
1713484377251,EDS 289C,A01,507361,Daly; Alan J.,18,0,18,0
1713484378278,EDS 290,A00,507366,Hofstetter; Carolyn,15,0,15,0
1713484379307,LIGM 5A,A00,507421,Fischer-Grunski; Eva K,20,0,20,0
1713484380333,LIGM 5B,A00,507423,Fischer-Grunski; Eva K,20,0,20,0
1713484381362,LIGM 5C,A00,507425,Fischer-Grunski; Eva K,20,0,20,0
1713484382395,LIIT 5AS,A00,507427,Carnelos; Chiara,20,0,20,0
1713484383420,LIIT 5BS,A00,507430,Carnelos; Chiara,20,0,20,0
1713484384448,LIIT 5CS,A00,507432,Carnelos; Chiara,20,0,20,0
1713484385474,LISP 5A,A00,507541,Munoz Sanchez; Alicia,14,0,20,6
1713484386499,LISP 5B,A00,507671,Munoz Sanchez; Alicia,12,0,20,8
1713484387526,LISP 5C,A00,507696,Munoz Sanchez; Alicia,11,0,20,9
1713484388554,MAE 197,001,528363,Boechler; Nicholas Sebastia,9998,0,9999,1
1713484389580,MATH 197,001,523477,Kedlaya; Kiran S.,9999,0,9999,0
1713484389580,MATH 197,002,563811,Zhang; Danna,9998,0,9999,1
1713484390605,MCWP 40R,A00,518780,Staff,17,0,20,3
1713484390605,MCWP 40R,B00,518781,Staff,14,0,20,6
1713484390605,MCWP 40R,C00,518783,Staff,11,0,20,9
1713484391631,MCWP 50R,A00,518791,Staff,8,0,20,12
1713484391631,MCWP 50R,B00,518792,Staff,7,0,20,13
1713484391631,MCWP 50R,C00,518793,Staff,7,0,20,13
1713484391631,MCWP 50R,D00,518794,Staff,0,0,20,20
1713484391631,MCWP 50R,E00,518795,Staff,3,0,20,17
1713484391631,MCWP 50R,F00,518796,Staff,13,0,20,7
1713484391631,MCWP 50R,G00,518797,Staff,12,0,20,8
1713484392656,MMW 12R,A01,514034,Herbst; Matthew,8,0,16,8
1713484392656,MMW 12R,A02,514035,Herbst; Matthew,13,0,16,3
1713484393680,MMW 13R,A01,514037,Staff,0,2,16,16
1713484393680,MMW 13R,A02,514039,Staff,0,3,16,16
1713484395729,SIO 295LS,A00,523233,Staff,15,0,30,15
1713484396757,SIO 295S,A00,523232,Staff,15,0,30,15
1713484397784,SOCI 117,A01,494376,Staff,0,2,5,5
1713484398813,WES 237B,A00,494380,Staff,19,0,20,1
1713484400874,AESE 279B,A00,494370,Wade; Jon P,33,0,33,0
1713484401899,AIP 197,001,627712,Vespa; Emanuel Ignacio,9999,0,9999,0
1713484402923,ANAR 135S,A00,494369,Braswell; Geoffrey E.,0,0,0,0
1713484403948,CAT 124RS,A01,519847,Geibel; William,6,0,20,14
1713484404973,CAT 125RS,A01,515971,Geibel; William,6,0,20,14
1713484406001,CLRE 250,A00,511389,Morris; Sheldon,9996,0,9999,3
1713484407026,CLRE 251,A00,507176,Mehta; Ravindra L.,9996,0,9999,3
1713484407026,CLRE 251,B00,511410,Mehta; Ravindra L.,9998,0,9999,1
1713484408053,CLRE 252,A00,507189,Cuomo; Raphael Eduardo,9998,0,9999,1
1713484409082,CLRE 253,A00,507199,Vaida; Florin,9997,0,9999,2
1713484409082,CLRE 253,B00,507202,Vaida; Florin,9999,0,9999,0
1713484410108,CLRE 259,A00,507211,Patel; Hemal,9996,0,9999,3
1713484411133,CLRE 260,A00,507221,Cuomo; Raphael Eduardo,9999,0,9999,0
1713484412158,CLRE 297,001,507242,Cuomo; Raphael Eduardo,9999,0,9999,0
1713484413188,CSE 191,A00,516875,Minnes Kemp; Mor Mia,9999,0,9999,0
1713484414216,CSS 201S,A01,494383,Staff,35,0,35,0
1713484415242,CSS 202S,A01,494387,Staff,35,0,35,0
1713484416267,EAP 100,A00,516065,Staff,9792,0,9999,207
1713484417293,ECE 45,A01,507414,Staff,38,0,60,22
1713484418318,ECE 100,A01,507416,Baghdadchi; Saharnaz,3,0,20,17
1713484418318,ECE 100,A02,507418,Baghdadchi; Saharnaz,19,0,20,1
1713484419343,ECE 111,A01,507420,Staff,28,0,50,22
1713484420368,ECE 197,001,548057,Sievenpiper; Daniel F.,9998,0,9999,1
1713484421396,EDS 115,A00,507243,Choi; Bailey Miyeon,27,0,28,1
1713484422424,EDS 117,A01,494379,Staff,16,0,25,9
1713484423453,EDS 125,A00,507246,Hopkins; Megan Beth,28,0,30,2
1713484424481,EDS 128A,A01,507264,Fargason; Sharon Gayle,26,0,26,0
1713484425506,EDS 128B,A01,507293,Pappas; Elizabeth,30,0,30,0
1713484426529,EDS 139,A00,507294,Fargason; Sharon Gayle,30,0,30,0
1713484426529,EDS 139,B00,507313,Pappas; Elizabeth,30,0,30,0
1713484427552,EDS 201,A00,507315,Staff,19,0,30,11
1713484428582,EDS 203,A01,507317,Halter; Christopher P.,18,0,30,12
1713484429610,EDS 204R,A01,507319,Halter; Christopher P.,0,1,30,30
1713484429610,EDS 204R,B01,507331,Heinzman; Erica M.,26,0,30,4
1713484430635,EDS 206R,A00,507332,Staff,0,1,30,30
1713484430635,EDS 206R,B00,507343,Staff,27,0,30,3
1713484431664,EDS 250,A00,507344,Hemans; Patricia Ann Benitez,28,0,40,12
1713484432688,EDS 281,A00,507345,Daly; Alan J.,18,0,18,0
1713484433713,EDS 284,A00,507350,Daly; Alan J.,16,0,16,0
1713484434738,EDS 286,A00,507359,Fine; Sarah,18,0,18,0
1713484435766,EDS 289C,A01,507361,Daly; Alan J.,18,0,18,0
1713484436793,EDS 290,A00,507366,Hofstetter; Carolyn,15,0,15,0
1713484437819,LIGM 5A,A00,507421,Fischer-Grunski; Eva K,20,0,20,0
1713484438845,LIGM 5B,A00,507423,Fischer-Grunski; Eva K,20,0,20,0
1713484439871,LIGM 5C,A00,507425,Fischer-Grunski; Eva K,20,0,20,0
1713484440902,LIIT 5AS,A00,507427,Carnelos; Chiara,20,0,20,0
1713484441931,LIIT 5BS,A00,507430,Carnelos; Chiara,20,0,20,0
1713484442957,LIIT 5CS,A00,507432,Carnelos; Chiara,20,0,20,0
1713484443983,LISP 5A,A00,507541,Munoz Sanchez; Alicia,14,0,20,6
1713484445008,LISP 5B,A00,507671,Munoz Sanchez; Alicia,12,0,20,8
1713484446034,LISP 5C,A00,507696,Munoz Sanchez; Alicia,11,0,20,9
1713484447060,MAE 197,001,528363,Boechler; Nicholas Sebastia,9998,0,9999,1
1713484448090,MATH 197,001,523477,Kedlaya; Kiran S.,9999,0,9999,0
1713484448090,MATH 197,002,563811,Zhang; Danna,9998,0,9999,1
1713484449116,MCWP 40R,A00,518780,Staff,17,0,20,3
1713484449116,MCWP 40R,B00,518781,Staff,14,0,20,6
1713484449116,MCWP 40R,C00,518783,Staff,11,0,20,9
1713484450147,MCWP 50R,A00,518791,Staff,8,0,20,12
1713484450147,MCWP 50R,B00,518792,Staff,7,0,20,13
1713484450147,MCWP 50R,C00,518793,Staff,7,0,20,13
1713484450147,MCWP 50R,D00,518794,Staff,0,0,20,20
1713484450147,MCWP 50R,E00,518795,Staff,3,0,20,17
1713484450147,MCWP 50R,F00,518796,Staff,13,0,20,7
1713484450147,MCWP 50R,G00,518797,Staff,12,0,20,8
1713484451187,MMW 12R,A01,514034,Herbst; Matthew,8,0,16,8
1713484451187,MMW 12R,A02,514035,Herbst; Matthew,13,0,16,3
1713484452212,MMW 13R,A01,514037,Staff,0,2,16,16
1713484452212,MMW 13R,A02,514039,Staff,0,3,16,16
1713484454266,SIO 295LS,A00,523233,Staff,15,0,30,15
1713484455291,SIO 295S,A00,523232,Staff,15,0,30,15
1713484456388,SOCI 117,A01,494376,Staff,0,2,5,5
1713484457413,WES 237B,A00,494380,Staff,19,0,20,1
1713484459476,AESE 279B,A00,494370,Wade; Jon P,33,0,33,0
1713484460503,AIP 197,001,627712,Vespa; Emanuel Ignacio,9999,0,9999,0
1713484461528,ANAR 135S,A00,494369,Braswell; Geoffrey E.,0,0,0,0
1713484462554,CAT 124RS,A01,519847,Geibel; William,6,0,20,14
1713484463579,CAT 125RS,A01,515971,Geibel; William,6,0,20,14
1713484464606,CLRE 250,A00,511389,Morris; Sheldon,9996,0,9999,3
1713484465635,CLRE 251,A00,507176,Mehta; Ravindra L.,9996,0,9999,3
1713484465635,CLRE 251,B00,511410,Mehta; Ravindra L.,9998,0,9999,1
1713484466664,CLRE 252,A00,507189,Cuomo; Raphael Eduardo,9998,0,9999,1
1713484467693,CLRE 253,A00,507199,Vaida; Florin,9997,0,9999,2
1713484467693,CLRE 253,B00,507202,Vaida; Florin,9999,0,9999,0
1713484468723,CLRE 259,A00,507211,Patel; Hemal,9996,0,9999,3
1713484469747,CLRE 260,A00,507221,Cuomo; Raphael Eduardo,9999,0,9999,0
1713484470771,CLRE 297,001,507242,Cuomo; Raphael Eduardo,9999,0,9999,0
1713484471799,CSE 191,A00,516875,Minnes Kemp; Mor Mia,9999,0,9999,0
1713484472824,CSS 201S,A01,494383,Staff,35,0,35,0
1713484473848,CSS 202S,A01,494387,Staff,35,0,35,0
1713484474873,EAP 100,A00,516065,Staff,9792,0,9999,207
1713484475901,ECE 45,A01,507414,Staff,38,0,60,22
1713484476924,ECE 100,A01,507416,Baghdadchi; Saharnaz,3,0,20,17
1713484476924,ECE 100,A02,507418,Baghdadchi; Saharnaz,19,0,20,1
1713484477952,ECE 111,A01,507420,Staff,28,0,50,22
1713484478980,ECE 197,001,548057,Sievenpiper; Daniel F.,9998,0,9999,1
1713484480005,EDS 115,A00,507243,Choi; Bailey Miyeon,27,0,28,1
1713484481031,EDS 117,A01,494379,Staff,16,0,25,9
1713484482057,EDS 125,A00,507246,Hopkins; Megan Beth,28,0,30,2
1713484483081,EDS 128A,A01,507264,Fargason; Sharon Gayle,26,0,26,0
1713484484107,EDS 128B,A01,507293,Pappas; Elizabeth,30,0,30,0
1713484485135,EDS 139,A00,507294,Fargason; Sharon Gayle,30,0,30,0
1713484485135,EDS 139,B00,507313,Pappas; Elizabeth,30,0,30,0
1713484486160,EDS 201,A00,507315,Staff,19,0,30,11
1713484487190,EDS 203,A01,507317,Halter; Christopher P.,18,0,30,12
1713484488220,EDS 204R,A01,507319,Halter; Christopher P.,0,1,30,30
1713484488220,EDS 204R,B01,507331,Heinzman; Erica M.,26,0,30,4
1713484489245,EDS 206R,A00,507332,Staff,0,1,30,30
1713484489245,EDS 206R,B00,507343,Staff,27,0,30,3
1713484490275,EDS 250,A00,507344,Hemans; Patricia Ann Benitez,28,0,40,12
1713484491304,EDS 281,A00,507345,Daly; Alan J.,18,0,18,0
1713484492332,EDS 284,A00,507350,Daly; Alan J.,16,0,16,0
1713484493360,EDS 286,A00,507359,Fine; Sarah,18,0,18,0
1713484494388,EDS 289C,A01,507361,Daly; Alan J.,18,0,18,0
1713484495413,EDS 290,A00,507366,Hofstetter; Carolyn,15,0,15,0
1713484496441,LIGM 5A,A00,507421,Fischer-Grunski; Eva K,20,0,20,0
1713484497471,LIGM 5B,A00,507423,Fischer-Grunski; Eva K,20,0,20,0
1713484498496,LIGM 5C,A00,507425,Fischer-Grunski; Eva K,20,0,20,0
1713484499522,LIIT 5AS,A00,507427,Carnelos; Chiara,20,0,20,0
1713484500554,LIIT 5BS,A00,507430,Carnelos; Chiara,20,0,20,0
1713484501579,LIIT 5CS,A00,507432,Carnelos; Chiara,20,0,20,0
1713484502603,LISP 5A,A00,507541,Munoz Sanchez; Alicia,14,0,20,6
1713484503631,LISP 5B,A00,507671,Munoz Sanchez; Alicia,12,0,20,8
1713484504657,LISP 5C,A00,507696,Munoz Sanchez; Alicia,11,0,20,9
1713484505681,MAE 197,001,528363,Boechler; Nicholas Sebastia,9998,0,9999,1
1713484506708,MATH 197,001,523477,Kedlaya; Kiran S.,9999,0,9999,0
1713484506708,MATH 197,002,563811,Zhang; Danna,9998,0,9999,1
1713484507733,MCWP 40R,A00,518780,Staff,17,0,20,3
1713484507733,MCWP 40R,B00,518781,Staff,14,0,20,6
1713484507733,MCWP 40R,C00,518783,Staff,11,0,20,9
1713484508764,MCWP 50R,A00,518791,Staff,8,0,20,12
1713484508764,MCWP 50R,B00,518792,Staff,7,0,20,13
1713484508764,MCWP 50R,C00,518793,Staff,7,0,20,13
1713484508764,MCWP 50R,D00,518794,Staff,0,0,20,20
1713484508764,MCWP 50R,E00,518795,Staff,3,0,20,17
1713484508764,MCWP 50R,F00,518796,Staff,13,0,20,7
1713484508764,MCWP 50R,G00,518797,Staff,12,0,20,8
1713484509793,MMW 12R,A01,514034,Herbst; Matthew,8,0,16,8
1713484509793,MMW 12R,A02,514035,Herbst; Matthew,13,0,16,3
1713484510823,MMW 13R,A01,514037,Staff,0,2,16,16
1713484510823,MMW 13R,A02,514039,Staff,0,3,16,16
1713484512875,SIO 295LS,A00,523233,Staff,15,0,30,15
1713484513906,SIO 295S,A00,523232,Staff,15,0,30,15
1713484514932,SOCI 117,A01,494376,Staff,0,2,5,5
1713484515956,WES 237B,A00,494380,Staff,19,0,20,1
1713484518024,AESE 279B,A00,494370,Wade; Jon P,33,0,33,0
1713484519049,AIP 197,001,627712,Vespa; Emanuel Ignacio,9999,0,9999,0
1713484520075,ANAR 135S,A00,494369,Braswell; Geoffrey E.,0,0,0,0
1713484521104,CAT 124RS,A01,519847,Geibel; William,6,0,20,14
1713484522134,CAT 125RS,A01,515971,Geibel; William,6,0,20,14
1713484523163,CLRE 250,A00,511389,Morris; Sheldon,9996,0,9999,3
1713484524188,CLRE 251,A00,507176,Mehta; Ravindra L.,9996,0,9999,3
1713484524188,CLRE 251,B00,511410,Mehta; Ravindra L.,9998,0,9999,1
1713484525218,CLRE 252,A00,507189,Cuomo; Raphael Eduardo,9998,0,9999,1
1713484526247,CLRE 253,A00,507199,Vaida; Florin,9997,0,9999,2
1713484526247,CLRE 253,B00,507202,Vaida; Florin,9999,0,9999,0
1713484527275,CLRE 259,A00,507211,Patel; Hemal,9996,0,9999,3
1713484528298,CLRE 260,A00,507221,Cuomo; Raphael Eduardo,9999,0,9999,0
1713484529326,CLRE 297,001,507242,Cuomo; Raphael Eduardo,9999,0,9999,0
1713484530353,CSE 191,A00,516875,Minnes Kemp; Mor Mia,9999,0,9999,0
1713484531377,CSS 201S,A01,494383,Staff,35,0,35,0
1713484532402,CSS 202S,A01,494387,Staff,35,0,35,0
1713484533426,EAP 100,A00,516065,Staff,9792,0,9999,207
1713484534450,ECE 45,A01,507414,Staff,38,0,60,22
1713484535476,ECE 100,A01,507416,Baghdadchi; Saharnaz,3,0,20,17
1713484535476,ECE 100,A02,507418,Baghdadchi; Saharnaz,19,0,20,1
1713484536501,ECE 111,A01,507420,Staff,28,0,50,22
1713484537526,ECE 197,001,548057,Sievenpiper; Daniel F.,9998,0,9999,1
1713484538555,EDS 115,A00,507243,Choi; Bailey Miyeon,27,0,28,1
1713484539580,EDS 117,A01,494379,Staff,16,0,25,9
1713484540604,EDS 125,A00,507246,Hopkins; Megan Beth,28,0,30,2
1713484541629,EDS 128A,A01,507264,Fargason; Sharon Gayle,26,0,26,0
1713484542653,EDS 128B,A01,507293,Pappas; Elizabeth,30,0,30,0
1713484543679,EDS 139,A00,507294,Fargason; Sharon Gayle,30,0,30,0
1713484543679,EDS 139,B00,507313,Pappas; Elizabeth,30,0,30,0
1713484544704,EDS 201,A00,507315,Staff,19,0,30,11
1713484545732,EDS 203,A01,507317,Halter; Christopher P.,18,0,30,12
1713484546763,EDS 204R,A01,507319,Halter; Christopher P.,0,1,30,30
1713484546763,EDS 204R,B01,507331,Heinzman; Erica M.,26,0,30,4
1713484547788,EDS 206R,A00,507332,Staff,0,1,30,30
1713484547788,EDS 206R,B00,507343,Staff,27,0,30,3
1713484548815,EDS 250,A00,507344,Hemans; Patricia Ann Benitez,28,0,40,12
1713484549840,EDS 281,A00,507345,Daly; Alan J.,18,0,18,0
1713484550868,EDS 284,A00,507350,Daly; Alan J.,16,0,16,0
1713484551893,EDS 286,A00,507359,Fine; Sarah,18,0,18,0
1713484552922,EDS 289C,A01,507361,Daly; Alan J.,18,0,18,0
1713484553951,EDS 290,A00,507366,Hofstetter; Carolyn,15,0,15,0
1713484554978,LIGM 5A,A00,507421,Fischer-Grunski; Eva K,20,0,20,0
1713484556004,LIGM 5B,A00,507423,Fischer-Grunski; Eva K,20,0,20,0
1713484557033,LIGM 5C,A00,507425,Fischer-Grunski; Eva K,20,0,20,0
1713484558060,LIIT 5AS,A00,507427,Carnelos; Chiara,20,0,20,0
1713484559089,LIIT 5BS,A00,507430,Carnelos; Chiara,20,0,20,0
1713484560169,LIIT 5CS,A00,507432,Carnelos; Chiara,20,0,20,0
1713484561199,LISP 5A,A00,507541,Munoz Sanchez; Alicia,14,0,20,6
1713484562229,LISP 5B,A00,507671,Munoz Sanchez; Alicia,12,0,20,8
1713484563253,LISP 5C,A00,507696,Munoz Sanchez; Alicia,11,0,20,9
1713484564281,MAE 197,001,528363,Boechler; Nicholas Sebastia,9998,0,9999,1
1713484565307,MATH 197,001,523477,Kedlaya; Kiran S.,9999,0,9999,0
1713484565307,MATH 197,002,563811,Zhang; Danna,9998,0,9999,1
1713484566333,MCWP 40R,A00,518780,Staff,17,0,20,3
1713484566333,MCWP 40R,B00,518781,Staff,14,0,20,6
1713484566333,MCWP 40R,C00,518783,Staff,11,0,20,9
1713484567358,MCWP 50R,A00,518791,Staff,8,0,20,12
1713484567358,MCWP 50R,B00,518792,Staff,7,0,20,13
1713484567358,MCWP 50R,C00,518793,Staff,7,0,20,13
1713484567358,MCWP 50R,D00,518794,Staff,0,0,20,20
1713484567358,MCWP 50R,E00,518795,Staff,3,0,20,17
1713484567358,MCWP 50R,F00,518796,Staff,13,0,20,7
1713484567358,MCWP 50R,G00,518797,Staff,12,0,20,8
1713484568388,MMW 12R,A01,514034,Herbst; Matthew,8,0,16,8
1713484568388,MMW 12R,A02,514035,Herbst; Matthew,13,0,16,3
1713484569413,MMW 13R,A01,514037,Staff,0,2,16,16
1713484569413,MMW 13R,A02,514039,Staff,0,3,16,16
1713484571464,SIO 295LS,A00,523233,Staff,15,0,30,15
1713484572492,SIO 295S,A00,523232,Staff,15,0,30,15
1713484573516,SOCI 117,A01,494376,Staff,0,2,5,5
1713484574540,WES 237B,A00,494380,Staff,19,0,20,1
1713484576609,AESE 279B,A00,494370,Wade; Jon P,33,0,33,0
1713484577638,AIP 197,001,627712,Vespa; Emanuel Ignacio,9999,0,9999,0
1713484578668,ANAR 135S,A00,494369,Braswell; Geoffrey E.,0,0,0,0
1713484579696,CAT 124RS,A01,519847,Geibel; William,6,0,20,14
1713484580723,CAT 125RS,A01,515971,Geibel; William,6,0,20,14
1713484581772,CLRE 250,A00,511389,Morris; Sheldon,9996,0,9999,3
1713484582799,CLRE 251,A00,507176,Mehta; Ravindra L.,9996,0,9999,3
1713484582799,CLRE 251,B00,511410,Mehta; Ravindra L.,9998,0,9999,1
1713484583827,CLRE 252,A00,507189,Cuomo; Raphael Eduardo,9998,0,9999,1
1713484584852,CLRE 253,A00,507199,Vaida; Florin,9997,0,9999,2
1713484584852,CLRE 253,B00,507202,Vaida; Florin,9999,0,9999,0
1713484585877,CLRE 259,A00,507211,Patel; Hemal,9996,0,9999,3
1713484586905,CLRE 260,A00,507221,Cuomo; Raphael Eduardo,9999,0,9999,0
1713484587932,CLRE 297,001,507242,Cuomo; Raphael Eduardo,9999,0,9999,0
1713484588961,CSE 191,A00,516875,Minnes Kemp; Mor Mia,9999,0,9999,0
1713484589989,CSS 201S,A01,494383,Staff,35,0,35,0
1713484591014,CSS 202S,A01,494387,Staff,35,0,35,0
1713484592041,EAP 100,A00,516065,Staff,9792,0,9999,207
1713484593066,ECE 45,A01,507414,Staff,38,0,60,22
1713484594091,ECE 100,A01,507416,Baghdadchi; Saharnaz,3,0,20,17
1713484594091,ECE 100,A02,507418,Baghdadchi; Saharnaz,19,0,20,1
1713484595115,ECE 111,A01,507420,Staff,28,0,50,22
1713484596140,ECE 197,001,548057,Sievenpiper; Daniel F.,9998,0,9999,1
1713484597169,EDS 115,A00,507243,Choi; Bailey Miyeon,27,0,28,1
1713484598199,EDS 117,A01,494379,Staff,16,0,25,9
1713484599223,EDS 125,A00,507246,Hopkins; Megan Beth,28,0,30,2
1713484600248,EDS 128A,A01,507264,Fargason; Sharon Gayle,26,0,26,0
1713484601274,EDS 128B,A01,507293,Pappas; Elizabeth,30,0,30,0
1713484602300,EDS 139,A00,507294,Fargason; Sharon Gayle,30,0,30,0
1713484602300,EDS 139,B00,507313,Pappas; Elizabeth,30,0,30,0
1713484603325,EDS 201,A00,507315,Staff,19,0,30,11
1713484604354,EDS 203,A01,507317,Halter; Christopher P.,18,0,30,12
1713484605384,EDS 204R,A01,507319,Halter; Christopher P.,0,1,30,30
1713484605384,EDS 204R,B01,507331,Heinzman; Erica M.,26,0,30,4
1713484606408,EDS 206R,A00,507332,Staff,0,1,30,30
1713484606408,EDS 206R,B00,507343,Staff,27,0,30,3
1713484607437,EDS 250,A00,507344,Hemans; Patricia Ann Benitez,28,0,40,12
1713484608463,EDS 281,A00,507345,Daly; Alan J.,18,0,18,0
1713484609490,EDS 284,A00,507350,Daly; Alan J.,16,0,16,0
1713484610515,EDS 286,A00,507359,Fine; Sarah,18,0,18,0
1713484611543,EDS 289C,A01,507361,Daly; Alan J.,18,0,18,0
1713484612569,EDS 290,A00,507366,Hofstetter; Carolyn,15,0,15,0
1713484613598,LIGM 5A,A00,507421,Fischer-Grunski; Eva K,20,0,20,0
1713484614632,LIGM 5B,A00,507423,Fischer-Grunski; Eva K,20,0,20,0
1713484615660,LIGM 5C,A00,507425,Fischer-Grunski; Eva K,20,0,20,0
1713484616687,LIIT 5AS,A00,507427,Carnelos; Chiara,20,0,20,0
1713484617712,LIIT 5BS,A00,507430,Carnelos; Chiara,20,0,20,0
1713484618741,LIIT 5CS,A00,507432,Carnelos; Chiara,20,0,20,0
1713484619766,LISP 5A,A00,507541,Munoz Sanchez; Alicia,14,0,20,6
1713484620792,LISP 5B,A00,507671,Munoz Sanchez; Alicia,12,0,20,8
1713484621818,LISP 5C,A00,507696,Munoz Sanchez; Alicia,11,0,20,9
1713484622848,MAE 197,001,528363,Boechler; Nicholas Sebastia,9998,0,9999,1
1713484623873,MATH 197,001,523477,Kedlaya; Kiran S.,9999,0,9999,0
1713484623873,MATH 197,002,563811,Zhang; Danna,9998,0,9999,1
1713484624897,MCWP 40R,A00,518780,Staff,17,0,20,3
1713484624897,MCWP 40R,B00,518781,Staff,14,0,20,6
1713484624897,MCWP 40R,C00,518783,Staff,11,0,20,9
1713484625921,MCWP 50R,A00,518791,Staff,8,0,20,12
1713484625921,MCWP 50R,B00,518792,Staff,7,0,20,13
1713484625921,MCWP 50R,C00,518793,Staff,7,0,20,13
1713484625921,MCWP 50R,D00,518794,Staff,0,0,20,20
1713484625921,MCWP 50R,E00,518795,Staff,3,0,20,17
1713484625921,MCWP 50R,F00,518796,Staff,13,0,20,7
1713484625921,MCWP 50R,G00,518797,Staff,12,0,20,8
1713484626946,MMW 12R,A01,514034,Herbst; Matthew,8,0,16,8
1713484626946,MMW 12R,A02,514035,Herbst; Matthew,13,0,16,3
1713484627975,MMW 13R,A01,514037,Staff,0,2,16,16
1713484627975,MMW 13R,A02,514039,Staff,0,3,16,16
1713484630025,SIO 295LS,A00,523233,Staff,15,0,30,15
1713484631049,SIO 295S,A00,523232,Staff,15,0,30,15
1713484632080,SOCI 117,A01,494376,Staff,0,2,5,5
1713484633107,WES 237B,A00,494380,Staff,19,0,20,1
1713484635173,AESE 279B,A00,494370,Wade; Jon P,33,0,33,0
1713484636201,AIP 197,001,627712,Vespa; Emanuel Ignacio,9999,0,9999,0
1713484637225,ANAR 135S,A00,494369,Braswell; Geoffrey E.,0,0,0,0
1713484638251,CAT 124RS,A01,519847,Geibel; William,6,0,20,14
1713484639276,CAT 125RS,A01,515971,Geibel; William,6,0,20,14
1713484640302,CLRE 250,A00,511389,Morris; Sheldon,9996,0,9999,3
1713484641327,CLRE 251,A00,507176,Mehta; Ravindra L.,9996,0,9999,3
1713484641327,CLRE 251,B00,511410,Mehta; Ravindra L.,9998,0,9999,1
1713484642352,CLRE 252,A00,507189,Cuomo; Raphael Eduardo,9998,0,9999,1
1713484643381,CLRE 253,A00,507199,Vaida; Florin,9997,0,9999,2
1713484643381,CLRE 253,B00,507202,Vaida; Florin,9999,0,9999,0
1713484644407,CLRE 259,A00,507211,Patel; Hemal,9996,0,9999,3
1713484645436,CLRE 260,A00,507221,Cuomo; Raphael Eduardo,9999,0,9999,0
1713484646465,CLRE 297,001,507242,Cuomo; Raphael Eduardo,9999,0,9999,0
1713484647494,CSE 191,A00,516875,Minnes Kemp; Mor Mia,9999,0,9999,0
1713484648524,CSS 201S,A01,494383,Staff,35,0,35,0
1713484649551,CSS 202S,A01,494387,Staff,35,0,35,0
1713484650579,EAP 100,A00,516065,Staff,9792,0,9999,207
1713484651606,ECE 45,A01,507414,Staff,38,0,60,22
1713484652634,ECE 100,A01,507416,Baghdadchi; Saharnaz,3,0,20,17
1713484652634,ECE 100,A02,507418,Baghdadchi; Saharnaz,19,0,20,1
1713484653660,ECE 111,A01,507420,Staff,28,0,50,22
1713484654686,ECE 197,001,548057,Sievenpiper; Daniel F.,9998,0,9999,1
1713484655713,EDS 115,A00,507243,Choi; Bailey Miyeon,27,0,28,1
1713484656742,EDS 117,A01,494379,Staff,16,0,25,9
1713484657766,EDS 125,A00,507246,Hopkins; Megan Beth,28,0,30,2
1713484658791,EDS 128A,A01,507264,Fargason; Sharon Gayle,26,0,26,0
1713484659815,EDS 128B,A01,507293,Pappas; Elizabeth,30,0,30,0
1713484660844,EDS 139,A00,507294,Fargason; Sharon Gayle,30,0,30,0
1713484660844,EDS 139,B00,507313,Pappas; Elizabeth,30,0,30,0
1713484661873,EDS 201,A00,507315,Staff,19,0,30,11
1713484662898,EDS 203,A01,507317,Halter; Christopher P.,18,0,30,12
1713484663978,EDS 204R,A01,507319,Halter; Christopher P.,0,1,30,30
1713484663978,EDS 204R,B01,507331,Heinzman; Erica M.,26,0,30,4
1713484665002,EDS 206R,A00,507332,Staff,0,1,30,30
1713484665002,EDS 206R,B00,507343,Staff,27,0,30,3
1713484666029,EDS 250,A00,507344,Hemans; Patricia Ann Benitez,28,0,40,12
1713484667053,EDS 281,A00,507345,Daly; Alan J.,18,0,18,0
1713484668077,EDS 284,A00,507350,Daly; Alan J.,16,0,16,0
1713484669106,EDS 286,A00,507359,Fine; Sarah,18,0,18,0
1713484670136,EDS 289C,A01,507361,Daly; Alan J.,18,0,18,0
1713484671164,EDS 290,A00,507366,Hofstetter; Carolyn,15,0,15,0
1713484672190,LIGM 5A,A00,507421,Fischer-Grunski; Eva K,20,0,20,0
1713484673218,LIGM 5B,A00,507423,Fischer-Grunski; Eva K,20,0,20,0
1713484674244,LIGM 5C,A00,507425,Fischer-Grunski; Eva K,20,0,20,0
1713484675274,LIIT 5AS,A00,507427,Carnelos; Chiara,20,0,20,0
1713484676303,LIIT 5BS,A00,507430,Carnelos; Chiara,20,0,20,0
1713484677328,LIIT 5CS,A00,507432,Carnelos; Chiara,20,0,20,0
1713484678356,LISP 5A,A00,507541,Munoz Sanchez; Alicia,14,0,20,6
1713484679380,LISP 5B,A00,507671,Munoz Sanchez; Alicia,12,0,20,8
1713484680404,LISP 5C,A00,507696,Munoz Sanchez; Alicia,11,0,20,9
1713484681433,MAE 197,001,528363,Boechler; Nicholas Sebastia,9998,0,9999,1
1713484682464,MATH 197,001,523477,Kedlaya; Kiran S.,9999,0,9999,0
1713484682464,MATH 197,002,563811,Zhang; Danna,9998,0,9999,1
1713484683489,MCWP 40R,A00,518780,Staff,17,0,20,3
1713484683489,MCWP 40R,B00,518781,Staff,14,0,20,6
1713484683489,MCWP 40R,C00,518783,Staff,11,0,20,9
1713484684518,MCWP 50R,A00,518791,Staff,8,0,20,12
1713484684518,MCWP 50R,B00,518792,Staff,7,0,20,13
1713484684518,MCWP 50R,C00,518793,Staff,7,0,20,13
1713484684518,MCWP 50R,D00,518794,Staff,0,0,20,20
1713484684518,MCWP 50R,E00,518795,Staff,3,0,20,17
1713484684518,MCWP 50R,F00,518796,Staff,13,0,20,7
1713484684518,MCWP 50R,G00,518797,Staff,12,0,20,8
1713484685543,MMW 12R,A01,514034,Herbst; Matthew,8,0,16,8
1713484685543,MMW 12R,A02,514035,Herbst; Matthew,13,0,16,3
1713484686568,MMW 13R,A01,514037,Staff,0,2,16,16
1713484686568,MMW 13R,A02,514039,Staff,0,3,16,16
1713484688619,SIO 295LS,A00,523233,Staff,15,0,30,15
1713484689643,SIO 295S,A00,523232,Staff,15,0,30,15
1713484690668,SOCI 117,A01,494376,Staff,0,2,5,5
1713484691694,WES 237B,A00,494380,Staff,19,0,20,1
1713484693768,AESE 279B,A00,494370,Wade; Jon P,33,0,33,0
1713484694797,AIP 197,001,627712,Vespa; Emanuel Ignacio,9999,0,9999,0
1713484695827,ANAR 135S,A00,494369,Braswell; Geoffrey E.,0,0,0,0
1713484696857,CAT 124RS,A01,519847,Geibel; William,6,0,20,14
1713484697884,CAT 125RS,A01,515971,Geibel; William,6,0,20,14
1713484698910,CLRE 250,A00,511389,Morris; Sheldon,9996,0,9999,3
1713484699937,CLRE 251,A00,507176,Mehta; Ravindra L.,9996,0,9999,3
1713484699937,CLRE 251,B00,511410,Mehta; Ravindra L.,9998,0,9999,1
1713484700967,CLRE 252,A00,507189,Cuomo; Raphael Eduardo,9998,0,9999,1
1713484701992,CLRE 253,A00,507199,Vaida; Florin,9997,0,9999,2
1713484701992,CLRE 253,B00,507202,Vaida; Florin,9999,0,9999,0
1713484703016,CLRE 259,A00,507211,Patel; Hemal,9996,0,9999,3
1713484704045,CLRE 260,A00,507221,Cuomo; Raphael Eduardo,9999,0,9999,0
1713484705073,CLRE 297,001,507242,Cuomo; Raphael Eduardo,9999,0,9999,0
1713484706098,CSE 191,A00,516875,Minnes Kemp; Mor Mia,9999,0,9999,0
1713484707129,CSS 201S,A01,494383,Staff,35,0,35,0
1713484708157,CSS 202S,A01,494387,Staff,35,0,35,0
1713484709181,EAP 100,A00,516065,Staff,9792,0,9999,207
1713484710206,ECE 45,A01,507414,Staff,38,0,60,22
1713484711233,ECE 100,A01,507416,Baghdadchi; Saharnaz,3,0,20,17
1713484711233,ECE 100,A02,507418,Baghdadchi; Saharnaz,19,0,20,1
1713484712257,ECE 111,A01,507420,Staff,28,0,50,22
1713484713282,ECE 197,001,548057,Sievenpiper; Daniel F.,9998,0,9999,1
1713484714308,EDS 115,A00,507243,Choi; Bailey Miyeon,27,0,28,1
1713484715338,EDS 117,A01,494379,Staff,16,0,25,9
1713484716363,EDS 125,A00,507246,Hopkins; Megan Beth,28,0,30,2
1713484717388,EDS 128A,A01,507264,Fargason; Sharon Gayle,26,0,26,0
1713484718413,EDS 128B,A01,507293,Pappas; Elizabeth,30,0,30,0
1713484719442,EDS 139,A00,507294,Fargason; Sharon Gayle,30,0,30,0
1713484719442,EDS 139,B00,507313,Pappas; Elizabeth,30,0,30,0
1713484720465,EDS 201,A00,507315,Staff,19,0,30,11
1713484721490,EDS 203,A01,507317,Halter; Christopher P.,18,0,30,12
1713484722519,EDS 204R,A01,507319,Halter; Christopher P.,0,1,30,30
1713484722519,EDS 204R,B01,507331,Heinzman; Erica M.,26,0,30,4
1713484723545,EDS 206R,A00,507332,Staff,0,1,30,30
1713484723545,EDS 206R,B00,507343,Staff,27,0,30,3
1713484724568,EDS 250,A00,507344,Hemans; Patricia Ann Benitez,28,0,40,12
1713484725593,EDS 281,A00,507345,Daly; Alan J.,18,0,18,0
1713484726619,EDS 284,A00,507350,Daly; Alan J.,16,0,16,0
1713484727647,EDS 286,A00,507359,Fine; Sarah,18,0,18,0
1713484728675,EDS 289C,A01,507361,Daly; Alan J.,18,0,18,0
1713484729702,EDS 290,A00,507366,Hofstetter; Carolyn,15,0,15,0
1713484730728,LIGM 5A,A00,507421,Fischer-Grunski; Eva K,20,0,20,0
1713484731756,LIGM 5B,A00,507423,Fischer-Grunski; Eva K,20,0,20,0
1713484732780,LIGM 5C,A00,507425,Fischer-Grunski; Eva K,20,0,20,0
1713484733809,LIIT 5AS,A00,507427,Carnelos; Chiara,20,0,20,0
1713484734839,LIIT 5BS,A00,507430,Carnelos; Chiara,20,0,20,0
1713484735865,LIIT 5CS,A00,507432,Carnelos; Chiara,20,0,20,0
1713484736891,LISP 5A,A00,507541,Munoz Sanchez; Alicia,14,0,20,6
1713484737917,LISP 5B,A00,507671,Munoz Sanchez; Alicia,12,0,20,8
1713484738944,LISP 5C,A00,507696,Munoz Sanchez; Alicia,11,0,20,9
1713484739969,MAE 197,001,528363,Boechler; Nicholas Sebastia,9998,0,9999,1
1713484740998,MATH 197,001,523477,Kedlaya; Kiran S.,9999,0,9999,0
1713484740998,MATH 197,002,563811,Zhang; Danna,9998,0,9999,1
1713484742027,MCWP 40R,A00,518780,Staff,17,0,20,3
1713484742027,MCWP 40R,B00,518781,Staff,14,0,20,6
1713484742027,MCWP 40R,C00,518783,Staff,11,0,20,9
1713484743060,MCWP 50R,A00,518791,Staff,8,0,20,12
1713484743060,MCWP 50R,B00,518792,Staff,7,0,20,13
1713484743060,MCWP 50R,C00,518793,Staff,7,0,20,13
1713484743060,MCWP 50R,D00,518794,Staff,0,0,20,20
1713484743060,MCWP 50R,E00,518795,Staff,3,0,20,17
1713484743060,MCWP 50R,F00,518796,Staff,13,0,20,7
1713484743060,MCWP 50R,G00,518797,Staff,12,0,20,8
1713484744088,MMW 12R,A01,514034,Herbst; Matthew,8,0,16,8
1713484744088,MMW 12R,A02,514035,Herbst; Matthew,13,0,16,3
1713484745114,MMW 13R,A01,514037,Staff,0,2,16,16
1713484745114,MMW 13R,A02,514039,Staff,0,3,16,16
1713484747167,SIO 295LS,A00,523233,Staff,15,0,30,15
1713484748191,SIO 295S,A00,523232,Staff,15,0,30,15
1713484749217,SOCI 117,A01,494376,Staff,0,2,5,5
1713484750245,WES 237B,A00,494380,Staff,19,0,20,1
1713484752308,AESE 279B,A00,494370,Wade; Jon P,33,0,33,0
1713484753333,AIP 197,001,627712,Vespa; Emanuel Ignacio,9999,0,9999,0
1713484754361,ANAR 135S,A00,494369,Braswell; Geoffrey E.,0,0,0,0
1713484755387,CAT 124RS,A01,519847,Geibel; William,6,0,20,14
1713484756412,CAT 125RS,A01,515971,Geibel; William,6,0,20,14
1713484757437,CLRE 250,A00,511389,Morris; Sheldon,9996,0,9999,3
1713484758460,CLRE 251,A00,507176,Mehta; Ravindra L.,9996,0,9999,3
1713484758460,CLRE 251,B00,511410,Mehta; Ravindra L.,9998,0,9999,1
1713484759484,CLRE 252,A00,507189,Cuomo; Raphael Eduardo,9998,0,9999,1
1713484760509,CLRE 253,A00,507199,Vaida; Florin,9997,0,9999,2
1713484760509,CLRE 253,B00,507202,Vaida; Florin,9999,0,9999,0
1713484761538,CLRE 259,A00,507211,Patel; Hemal,9996,0,9999,3
1713484762565,CLRE 260,A00,507221,Cuomo; Raphael Eduardo,9999,0,9999,0
1713484763590,CLRE 297,001,507242,Cuomo; Raphael Eduardo,9999,0,9999,0
1713484764619,CSE 191,A00,516875,Minnes Kemp; Mor Mia,9999,0,9999,0
1713484765642,CSS 201S,A01,494383,Staff,35,0,35,0
1713484766668,CSS 202S,A01,494387,Staff,35,0,35,0
1713484767765,EAP 100,A00,516065,Staff,9792,0,9999,207
1713484768792,ECE 45,A01,507414,Staff,38,0,60,22
1713484769817,ECE 100,A01,507416,Baghdadchi; Saharnaz,3,0,20,17
1713484769817,ECE 100,A02,507418,Baghdadchi; Saharnaz,19,0,20,1
1713484770845,ECE 111,A01,507420,Staff,28,0,50,22
1713484771869,ECE 197,001,548057,Sievenpiper; Daniel F.,9998,0,9999,1
1713484772898,EDS 115,A00,507243,Choi; Bailey Miyeon,27,0,28,1
1713484773926,EDS 117,A01,494379,Staff,16,0,25,9
1713484774952,EDS 125,A00,507246,Hopkins; Megan Beth,28,0,30,2
1713484775978,EDS 128A,A01,507264,Fargason; Sharon Gayle,26,0,26,0
1713484777003,EDS 128B,A01,507293,Pappas; Elizabeth,30,0,30,0
1713484778034,EDS 139,A00,507294,Fargason; Sharon Gayle,30,0,30,0
1713484778034,EDS 139,B00,507313,Pappas; Elizabeth,30,0,30,0
1713484779058,EDS 201,A00,507315,Staff,19,0,30,11
1713484780084,EDS 203,A01,507317,Halter; Christopher P.,18,0,30,12
1713484781112,EDS 204R,A01,507319,Halter; Christopher P.,0,1,30,30
1713484781112,EDS 204R,B01,507331,Heinzman; Erica M.,26,0,30,4
1713484782137,EDS 206R,A00,507332,Staff,0,1,30,30
1713484782137,EDS 206R,B00,507343,Staff,27,0,30,3
1713484783162,EDS 250,A00,507344,Hemans; Patricia Ann Benitez,28,0,40,12
1713484784190,EDS 281,A00,507345,Daly; Alan J.,18,0,18,0
1713484785218,EDS 284,A00,507350,Daly; Alan J.,16,0,16,0
1713484786244,EDS 286,A00,507359,Fine; Sarah,18,0,18,0
1713484787269,EDS 289C,A01,507361,Daly; Alan J.,18,0,18,0
1713484788294,EDS 290,A00,507366,Hofstetter; Carolyn,15,0,15,0
1713484789324,LIGM 5A,A00,507421,Fischer-Grunski; Eva K,20,0,20,0
1713484790350,LIGM 5B,A00,507423,Fischer-Grunski; Eva K,20,0,20,0
1713484791377,LIGM 5C,A00,507425,Fischer-Grunski; Eva K,20,0,20,0
1713484792406,LIIT 5AS,A00,507427,Carnelos; Chiara,20,0,20,0
1713484793428,LIIT 5BS,A00,507430,Carnelos; Chiara,20,0,20,0
1713484794457,LIIT 5CS,A00,507432,Carnelos; Chiara,20,0,20,0
1713484795482,LISP 5A,A00,507541,Munoz Sanchez; Alicia,14,0,20,6
1713484796508,LISP 5B,A00,507671,Munoz Sanchez; Alicia,12,0,20,8
1713484797537,LISP 5C,A00,507696,Munoz Sanchez; Alicia,11,0,20,9
1713484798562,MAE 197,001,528363,Boechler; Nicholas Sebastia,9998,0,9999,1
1713484799591,MATH 197,001,523477,Kedlaya; Kiran S.,9999,0,9999,0
1713484799591,MATH 197,002,563811,Zhang; Danna,9998,0,9999,1
1713484800618,MCWP 40R,A00,518780,Staff,17,0,20,3
1713484800618,MCWP 40R,B00,518781,Staff,14,0,20,6
1713484800618,MCWP 40R,C00,518783,Staff,11,0,20,9
1713484801643,MCWP 50R,A00,518791,Staff,8,0,20,12
1713484801643,MCWP 50R,B00,518792,Staff,7,0,20,13
1713484801643,MCWP 50R,C00,518793,Staff,7,0,20,13
1713484801643,MCWP 50R,D00,518794,Staff,0,0,20,20
1713484801643,MCWP 50R,E00,518795,Staff,3,0,20,17
1713484801643,MCWP 50R,F00,518796,Staff,13,0,20,7
1713484801643,MCWP 50R,G00,518797,Staff,12,0,20,8
1713484802670,MMW 12R,A01,514034,Herbst; Matthew,7,0,16,9
1713484802670,MMW 12R,A02,514035,Herbst; Matthew,13,0,16,3
1713484803698,MMW 13R,A01,514037,Staff,0,2,16,16
1713484803698,MMW 13R,A02,514039,Staff,0,3,16,16
1713484805763,SIO 295LS,A00,523233,Staff,15,0,30,15
1713484806788,SIO 295S,A00,523232,Staff,15,0,30,15
1713484807817,SOCI 117,A01,494376,Staff,0,2,5,5
1713484808842,WES 237B,A00,494380,Staff,19,0,20,1
1713484810925,AESE 279B,A00,494370,Wade; Jon P,33,0,33,0
1713484811953,AIP 197,001,627712,Vespa; Emanuel Ignacio,9999,0,9999,0
1713484812981,ANAR 135S,A00,494369,Braswell; Geoffrey E.,0,0,0,0
1713484814005,CAT 124RS,A01,519847,Geibel; William,6,0,20,14
1713484815031,CAT 125RS,A01,515971,Geibel; William,6,0,20,14
1713484816061,CLRE 250,A00,511389,Morris; Sheldon,9996,0,9999,3
1713484817087,CLRE 251,A00,507176,Mehta; Ravindra L.,9996,0,9999,3
1713484817087,CLRE 251,B00,511410,Mehta; Ravindra L.,9998,0,9999,1
1713484818112,CLRE 252,A00,507189,Cuomo; Raphael Eduardo,9998,0,9999,1
1713484819136,CLRE 253,A00,507199,Vaida; Florin,9997,0,9999,2
1713484819136,CLRE 253,B00,507202,Vaida; Florin,9999,0,9999,0
1713484820164,CLRE 259,A00,507211,Patel; Hemal,9996,0,9999,3
1713484821203,CLRE 260,A00,507221,Cuomo; Raphael Eduardo,9999,0,9999,0
1713484822231,CLRE 297,001,507242,Cuomo; Raphael Eduardo,9999,0,9999,0
1713484823255,CSE 191,A00,516875,Minnes Kemp; Mor Mia,9999,0,9999,0
1713484824281,CSS 201S,A01,494383,Staff,35,0,35,0
1713484825305,CSS 202S,A01,494387,Staff,35,0,35,0
1713484826333,EAP 100,A00,516065,Staff,9792,0,9999,207
1713484827361,ECE 45,A01,507414,Staff,38,0,60,22
1713484828386,ECE 100,A01,507416,Baghdadchi; Saharnaz,3,0,20,17
1713484828386,ECE 100,A02,507418,Baghdadchi; Saharnaz,19,0,20,1
1713484829415,ECE 111,A01,507420,Staff,28,0,50,22
1713484830443,ECE 197,001,548057,Sievenpiper; Daniel F.,9998,0,9999,1
1713484831470,EDS 115,A00,507243,Choi; Bailey Miyeon,27,0,28,1
1713484832500,EDS 117,A01,494379,Staff,16,0,25,9
1713484833523,EDS 125,A00,507246,Hopkins; Megan Beth,28,0,30,2
1713484834548,EDS 128A,A01,507264,Fargason; Sharon Gayle,26,0,26,0
1713484835578,EDS 128B,A01,507293,Pappas; Elizabeth,30,0,30,0
1713484836606,EDS 139,A00,507294,Fargason; Sharon Gayle,30,0,30,0
1713484836606,EDS 139,B00,507313,Pappas; Elizabeth,30,0,30,0
1713484837632,EDS 201,A00,507315,Staff,19,0,30,11
1713484838656,EDS 203,A01,507317,Halter; Christopher P.,18,0,30,12
1713484839682,EDS 204R,A01,507319,Halter; Christopher P.,0,1,30,30
1713484839682,EDS 204R,B01,507331,Heinzman; Erica M.,26,0,30,4
1713484840709,EDS 206R,A00,507332,Staff,0,1,30,30
1713484840709,EDS 206R,B00,507343,Staff,27,0,30,3
1713484841734,EDS 250,A00,507344,Hemans; Patricia Ann Benitez,28,0,40,12
1713484842760,EDS 281,A00,507345,Daly; Alan J.,18,0,18,0
1713484843785,EDS 284,A00,507350,Daly; Alan J.,16,0,16,0
1713484844814,EDS 286,A00,507359,Fine; Sarah,18,0,18,0
1713484845840,EDS 289C,A01,507361,Daly; Alan J.,18,0,18,0
1713484846868,EDS 290,A00,507366,Hofstetter; Carolyn,15,0,15,0
1713484847894,LIGM 5A,A00,507421,Fischer-Grunski; Eva K,20,0,20,0
1713484848919,LIGM 5B,A00,507423,Fischer-Grunski; Eva K,20,0,20,0
1713484849948,LIGM 5C,A00,507425,Fischer-Grunski; Eva K,20,0,20,0
1713484850983,LIIT 5AS,A00,507427,Carnelos; Chiara,20,0,20,0
1713484852008,LIIT 5BS,A00,507430,Carnelos; Chiara,20,0,20,0
1713484853033,LIIT 5CS,A00,507432,Carnelos; Chiara,20,0,20,0
1713484854060,LISP 5A,A00,507541,Munoz Sanchez; Alicia,14,0,20,6
1713484855087,LISP 5B,A00,507671,Munoz Sanchez; Alicia,12,0,20,8
1713484856117,LISP 5C,A00,507696,Munoz Sanchez; Alicia,11,0,20,9
1713484857142,MAE 197,001,528363,Boechler; Nicholas Sebastia,9998,0,9999,1
1713484858168,MATH 197,001,523477,Kedlaya; Kiran S.,9999,0,9999,0
1713484858168,MATH 197,002,563811,Zhang; Danna,9998,0,9999,1
1713484859197,MCWP 40R,A00,518780,Staff,17,0,20,3
1713484859197,MCWP 40R,B00,518781,Staff,14,0,20,6
1713484859197,MCWP 40R,C00,518783,Staff,11,0,20,9
1713484860225,MCWP 50R,A00,518791,Staff,8,0,20,12
1713484860225,MCWP 50R,B00,518792,Staff,7,0,20,13
1713484860225,MCWP 50R,C00,518793,Staff,7,0,20,13
1713484860225,MCWP 50R,D00,518794,Staff,0,0,20,20
1713484860225,MCWP 50R,E00,518795,Staff,3,0,20,17
1713484860225,MCWP 50R,F00,518796,Staff,13,0,20,7
1713484860225,MCWP 50R,G00,518797,Staff,12,0,20,8
1713484861252,MMW 12R,A01,514034,Herbst; Matthew,7,0,16,9
1713484861252,MMW 12R,A02,514035,Herbst; Matthew,13,0,16,3
1713484862277,MMW 13R,A01,514037,Staff,0,2,16,16
1713484862277,MMW 13R,A02,514039,Staff,0,3,16,16
1713484864331,SIO 295LS,A00,523233,Staff,15,0,30,15
1713484865356,SIO 295S,A00,523232,Staff,15,0,30,15
1713484866382,SOCI 117,A01,494376,Staff,0,2,5,5
1713484867407,WES 237B,A00,494380,Staff,19,0,20,1
1713484869469,AESE 279B,A00,494370,Wade; Jon P,33,0,33,0
1713484870496,AIP 197,001,627712,Vespa; Emanuel Ignacio,9999,0,9999,0
1713484871578,ANAR 135S,A00,494369,Braswell; Geoffrey E.,0,0,0,0
1713484872606,CAT 124RS,A01,519847,Geibel; William,6,0,20,14
1713484873634,CAT 125RS,A01,515971,Geibel; William,6,0,20,14
1713484874659,CLRE 250,A00,511389,Morris; Sheldon,9996,0,9999,3
1713484875686,CLRE 251,A00,507176,Mehta; Ravindra L.,9996,0,9999,3
1713484875686,CLRE 251,B00,511410,Mehta; Ravindra L.,9998,0,9999,1
1713484876712,CLRE 252,A00,507189,Cuomo; Raphael Eduardo,9998,0,9999,1
1713484877739,CLRE 253,A00,507199,Vaida; Florin,9997,0,9999,2
1713484877739,CLRE 253,B00,507202,Vaida; Florin,9999,0,9999,0
1713484878764,CLRE 259,A00,507211,Patel; Hemal,9996,0,9999,3
1713484879787,CLRE 260,A00,507221,Cuomo; Raphael Eduardo,9999,0,9999,0
1713484880814,CLRE 297,001,507242,Cuomo; Raphael Eduardo,9999,0,9999,0
1713484881838,CSE 191,A00,516875,Minnes Kemp; Mor Mia,9999,0,9999,0
1713484882864,CSS 201S,A01,494383,Staff,35,0,35,0
1713484883906,CSS 202S,A01,494387,Staff,35,0,35,0
1713484884935,EAP 100,A00,516065,Staff,9792,0,9999,207
1713484885960,ECE 45,A01,507414,Staff,38,0,60,22
1713484886984,ECE 100,A01,507416,Baghdadchi; Saharnaz,3,0,20,17
1713484886984,ECE 100,A02,507418,Baghdadchi; Saharnaz,19,0,20,1
1713484888009,ECE 111,A01,507420,Staff,28,0,50,22
1713484889033,ECE 197,001,548057,Sievenpiper; Daniel F.,9998,0,9999,1
1713484890064,EDS 115,A00,507243,Choi; Bailey Miyeon,27,0,28,1
1713484891089,EDS 117,A01,494379,Staff,16,0,25,9
1713484892115,EDS 125,A00,507246,Hopkins; Megan Beth,28,0,30,2
1713484893140,EDS 128A,A01,507264,Fargason; Sharon Gayle,26,0,26,0
1713484894169,EDS 128B,A01,507293,Pappas; Elizabeth,30,0,30,0
1713484895200,EDS 139,A00,507294,Fargason; Sharon Gayle,30,0,30,0
1713484895200,EDS 139,B00,507313,Pappas; Elizabeth,30,0,30,0
1713484896228,EDS 201,A00,507315,Staff,19,0,30,11
1713484897253,EDS 203,A01,507317,Halter; Christopher P.,18,0,30,12
1713484898279,EDS 204R,A01,507319,Halter; Christopher P.,0,1,30,30
1713484898279,EDS 204R,B01,507331,Heinzman; Erica M.,26,0,30,4
1713484899304,EDS 206R,A00,507332,Staff,0,1,30,30
1713484899304,EDS 206R,B00,507343,Staff,27,0,30,3
1713484900331,EDS 250,A00,507344,Hemans; Patricia Ann Benitez,28,0,40,12
1713484901356,EDS 281,A00,507345,Daly; Alan J.,18,0,18,0
1713484902385,EDS 284,A00,507350,Daly; Alan J.,16,0,16,0
1713484903409,EDS 286,A00,507359,Fine; Sarah,18,0,18,0
1713484904435,EDS 289C,A01,507361,Daly; Alan J.,18,0,18,0
1713484905460,EDS 290,A00,507366,Hofstetter; Carolyn,15,0,15,0
1713484906483,LIGM 5A,A00,507421,Fischer-Grunski; Eva K,20,0,20,0
1713484907508,LIGM 5B,A00,507423,Fischer-Grunski; Eva K,20,0,20,0
1713484908538,LIGM 5C,A00,507425,Fischer-Grunski; Eva K,20,0,20,0
1713484909563,LIIT 5AS,A00,507427,Carnelos; Chiara,20,0,20,0
1713484910592,LIIT 5BS,A00,507430,Carnelos; Chiara,20,0,20,0
1713484911618,LIIT 5CS,A00,507432,Carnelos; Chiara,20,0,20,0
1713484912646,LISP 5A,A00,507541,Munoz Sanchez; Alicia,14,0,20,6
1713484913675,LISP 5B,A00,507671,Munoz Sanchez; Alicia,12,0,20,8
1713484914700,LISP 5C,A00,507696,Munoz Sanchez; Alicia,11,0,20,9
1713484915728,MAE 197,001,528363,Boechler; Nicholas Sebastia,9998,0,9999,1
1713484916753,MATH 197,001,523477,Kedlaya; Kiran S.,9999,0,9999,0
1713484916753,MATH 197,002,563811,Zhang; Danna,9998,0,9999,1
1713484917785,MCWP 40R,A00,518780,Staff,17,0,20,3
1713484917785,MCWP 40R,B00,518781,Staff,14,0,20,6
1713484917785,MCWP 40R,C00,518783,Staff,11,0,20,9
1713484918812,MCWP 50R,A00,518791,Staff,8,0,20,12
1713484918812,MCWP 50R,B00,518792,Staff,7,0,20,13
1713484918812,MCWP 50R,C00,518793,Staff,7,0,20,13
1713484918812,MCWP 50R,D00,518794,Staff,0,0,20,20
1713484918812,MCWP 50R,E00,518795,Staff,3,0,20,17
1713484918812,MCWP 50R,F00,518796,Staff,13,0,20,7
1713484918812,MCWP 50R,G00,518797,Staff,12,0,20,8
1713484919836,MMW 12R,A01,514034,Herbst; Matthew,6,0,16,10
1713484919836,MMW 12R,A02,514035,Herbst; Matthew,13,0,16,3
1713484920861,MMW 13R,A01,514037,Staff,0,3,16,16
1713484920861,MMW 13R,A02,514039,Staff,0,3,16,16
1713484922911,SIO 295LS,A00,523233,Staff,15,0,30,15
1713484923936,SIO 295S,A00,523232,Staff,15,0,30,15
1713484924964,SOCI 117,A01,494376,Staff,0,2,5,5
1713484925990,WES 237B,A00,494380,Staff,19,0,20,1
1713484928073,AESE 279B,A00,494370,Wade; Jon P,33,0,33,0
1713484929104,AIP 197,001,627712,Vespa; Emanuel Ignacio,9999,0,9999,0
1713484930129,ANAR 135S,A00,494369,Braswell; Geoffrey E.,0,0,0,0
1713484931161,CAT 124RS,A01,519847,Geibel; William,6,0,20,14
1713484932188,CAT 125RS,A01,515971,Geibel; William,6,0,20,14
1713484933214,CLRE 250,A00,511389,Morris; Sheldon,9996,0,9999,3
1713484934238,CLRE 251,A00,507176,Mehta; Ravindra L.,9996,0,9999,3
1713484934238,CLRE 251,B00,511410,Mehta; Ravindra L.,9998,0,9999,1
1713484935263,CLRE 252,A00,507189,Cuomo; Raphael Eduardo,9998,0,9999,1
1713484936289,CLRE 253,A00,507199,Vaida; Florin,9997,0,9999,2
1713484936289,CLRE 253,B00,507202,Vaida; Florin,9999,0,9999,0
1713484937313,CLRE 259,A00,507211,Patel; Hemal,9996,0,9999,3
1713484938342,CLRE 260,A00,507221,Cuomo; Raphael Eduardo,9999,0,9999,0
1713484939368,CLRE 297,001,507242,Cuomo; Raphael Eduardo,9999,0,9999,0
1713484940394,CSE 191,A00,516875,Minnes Kemp; Mor Mia,9999,0,9999,0
1713484941419,CSS 201S,A01,494383,Staff,35,0,35,0
1713484942447,CSS 202S,A01,494387,Staff,35,0,35,0
1713484943475,EAP 100,A00,516065,Staff,9792,0,9999,207
1713484944503,ECE 45,A01,507414,Staff,38,0,60,22
1713484945528,ECE 100,A01,507416,Baghdadchi; Saharnaz,2,0,20,18
1713484945528,ECE 100,A02,507418,Baghdadchi; Saharnaz,19,0,20,1
1713484946554,ECE 111,A01,507420,Staff,28,0,50,22
1713484947582,ECE 197,001,548057,Sievenpiper; Daniel F.,9998,0,9999,1
1713484948605,EDS 115,A00,507243,Choi; Bailey Miyeon,27,0,28,1
1713484949634,EDS 117,A01,494379,Staff,16,0,25,9
1713484950660,EDS 125,A00,507246,Hopkins; Megan Beth,28,0,30,2
1713484951684,EDS 128A,A01,507264,Fargason; Sharon Gayle,26,0,26,0
1713484952711,EDS 128B,A01,507293,Pappas; Elizabeth,30,0,30,0
1713484953736,EDS 139,A00,507294,Fargason; Sharon Gayle,30,0,30,0
1713484953736,EDS 139,B00,507313,Pappas; Elizabeth,30,0,30,0
1713484954762,EDS 201,A00,507315,Staff,19,0,30,11
1713484955787,EDS 203,A01,507317,Halter; Christopher P.,18,0,30,12
1713484956814,EDS 204R,A01,507319,Halter; Christopher P.,0,1,30,30
1713484956814,EDS 204R,B01,507331,Heinzman; Erica M.,26,0,30,4
1713484957840,EDS 206R,A00,507332,Staff,0,1,30,30
1713484957840,EDS 206R,B00,507343,Staff,27,0,30,3
1713484958865,EDS 250,A00,507344,Hemans; Patricia Ann Benitez,28,0,40,12
1713484959891,EDS 281,A00,507345,Daly; Alan J.,18,0,18,0
1713484960920,EDS 284,A00,507350,Daly; Alan J.,16,0,16,0
1713484961948,EDS 286,A00,507359,Fine; Sarah,18,0,18,0
1713484962973,EDS 289C,A01,507361,Daly; Alan J.,18,0,18,0
1713484964001,EDS 290,A00,507366,Hofstetter; Carolyn,15,0,15,0
1713484965032,LIGM 5A,A00,507421,Fischer-Grunski; Eva K,20,0,20,0
1713484966058,LIGM 5B,A00,507423,Fischer-Grunski; Eva K,20,0,20,0
1713484967082,LIGM 5C,A00,507425,Fischer-Grunski; Eva K,20,0,20,0
1713484968107,LIIT 5AS,A00,507427,Carnelos; Chiara,20,0,20,0
1713484969138,LIIT 5BS,A00,507430,Carnelos; Chiara,20,0,20,0
1713484970163,LIIT 5CS,A00,507432,Carnelos; Chiara,20,0,20,0
1713484971197,LISP 5A,A00,507541,Munoz Sanchez; Alicia,14,0,20,6
1713484972222,LISP 5B,A00,507671,Munoz Sanchez; Alicia,12,0,20,8
1713484973253,LISP 5C,A00,507696,Munoz Sanchez; Alicia,11,0,20,9
1713484974281,MAE 197,001,528363,Boechler; Nicholas Sebastia,9998,0,9999,1
1713484975362,MATH 197,001,523477,Kedlaya; Kiran S.,9999,0,9999,0
1713484975362,MATH 197,002,563811,Zhang; Danna,9998,0,9999,1
1713484976389,MCWP 40R,A00,518780,Staff,17,0,20,3
1713484976389,MCWP 40R,B00,518781,Staff,14,0,20,6
1713484976389,MCWP 40R,C00,518783,Staff,11,0,20,9
1713484977416,MCWP 50R,A00,518791,Staff,8,0,20,12
1713484977416,MCWP 50R,B00,518792,Staff,7,0,20,13
1713484977416,MCWP 50R,C00,518793,Staff,7,0,20,13
1713484977416,MCWP 50R,D00,518794,Staff,0,0,20,20
1713484977416,MCWP 50R,E00,518795,Staff,3,0,20,17
1713484977416,MCWP 50R,F00,518796,Staff,13,0,20,7
1713484977416,MCWP 50R,G00,518797,Staff,12,0,20,8
1713484978448,MMW 12R,A01,514034,Herbst; Matthew,6,0,16,10
1713484978448,MMW 12R,A02,514035,Herbst; Matthew,13,0,16,3
1713484979472,MMW 13R,A01,514037,Staff,0,3,16,16
1713484979472,MMW 13R,A02,514039,Staff,0,3,16,16
1713484981533,SIO 295LS,A00,523233,Staff,15,0,30,15
1713484982559,SIO 295S,A00,523232,Staff,15,0,30,15
1713484983590,SOCI 117,A01,494376,Staff,0,2,5,5
1713484984615,WES 237B,A00,494380,Staff,19,0,20,1
1713484986695,AESE 279B,A00,494370,Wade; Jon P,33,0,33,0
1713484987722,AIP 197,001,627712,Vespa; Emanuel Ignacio,9999,0,9999,0
1713484988748,ANAR 135S,A00,494369,Braswell; Geoffrey E.,0,0,0,0
1713484989773,CAT 124RS,A01,519847,Geibel; William,6,0,20,14
1713484990803,CAT 125RS,A01,515971,Geibel; William,6,0,20,14
1713484991834,CLRE 250,A00,511389,Morris; Sheldon,9996,0,9999,3
1713484992868,CLRE 251,A00,507176,Mehta; Ravindra L.,9996,0,9999,3
1713484992868,CLRE 251,B00,511410,Mehta; Ravindra L.,9998,0,9999,1
1713484993897,CLRE 252,A00,507189,Cuomo; Raphael Eduardo,9998,0,9999,1
1713484994925,CLRE 253,A00,507199,Vaida; Florin,9997,0,9999,2
1713484994925,CLRE 253,B00,507202,Vaida; Florin,9999,0,9999,0
1713484995951,CLRE 259,A00,507211,Patel; Hemal,9996,0,9999,3
1713484996978,CLRE 260,A00,507221,Cuomo; Raphael Eduardo,9999,0,9999,0
1713484998005,CLRE 297,001,507242,Cuomo; Raphael Eduardo,9999,0,9999,0
1713484999035,CSE 191,A00,516875,Minnes Kemp; Mor Mia,9999,0,9999,0
1713485000062,CSS 201S,A01,494383,Staff,35,0,35,0
1713485001090,CSS 202S,A01,494387,Staff,35,0,35,0
1713485002115,EAP 100,A00,516065,Staff,9792,0,9999,207
1713485003145,ECE 45,A01,507414,Staff,38,0,60,22
1713485004172,ECE 100,A01,507416,Baghdadchi; Saharnaz,2,0,20,18
1713485004172,ECE 100,A02,507418,Baghdadchi; Saharnaz,19,0,20,1
1713485005202,ECE 111,A01,507420,Staff,28,0,50,22
1713485006229,ECE 197,001,548057,Sievenpiper; Daniel F.,9998,0,9999,1
1713485007256,EDS 115,A00,507243,Choi; Bailey Miyeon,27,0,28,1
1713485008281,EDS 117,A01,494379,Staff,16,0,25,9
1713485009306,EDS 125,A00,507246,Hopkins; Megan Beth,28,0,30,2
1713485010333,EDS 128A,A01,507264,Fargason; Sharon Gayle,26,0,26,0
1713485011358,EDS 128B,A01,507293,Pappas; Elizabeth,30,0,30,0
1713485012384,EDS 139,A00,507294,Fargason; Sharon Gayle,30,0,30,0
1713485012384,EDS 139,B00,507313,Pappas; Elizabeth,30,0,30,0
1713485013408,EDS 201,A00,507315,Staff,19,0,30,11
1713485014439,EDS 203,A01,507317,Halter; Christopher P.,18,0,30,12
1713485015464,EDS 204R,A01,507319,Halter; Christopher P.,0,1,30,30
1713485015464,EDS 204R,B01,507331,Heinzman; Erica M.,26,0,30,4
1713485016489,EDS 206R,A00,507332,Staff,0,1,30,30
1713485016489,EDS 206R,B00,507343,Staff,27,0,30,3
1713485017512,EDS 250,A00,507344,Hemans; Patricia Ann Benitez,28,0,40,12
1713485018537,EDS 281,A00,507345,Daly; Alan J.,18,0,18,0
1713485019562,EDS 284,A00,507350,Daly; Alan J.,16,0,16,0
1713485020588,EDS 286,A00,507359,Fine; Sarah,18,0,18,0
1713485021614,EDS 289C,A01,507361,Daly; Alan J.,18,0,18,0
1713485022641,EDS 290,A00,507366,Hofstetter; Carolyn,15,0,15,0
1713485023670,LIGM 5A,A00,507421,Fischer-Grunski; Eva K,20,0,20,0
1713485024697,LIGM 5B,A00,507423,Fischer-Grunski; Eva K,20,0,20,0
1713485025724,LIGM 5C,A00,507425,Fischer-Grunski; Eva K,20,0,20,0
1713485026752,LIIT 5AS,A00,507427,Carnelos; Chiara,20,0,20,0
1713485027777,LIIT 5BS,A00,507430,Carnelos; Chiara,20,0,20,0
1713485028802,LIIT 5CS,A00,507432,Carnelos; Chiara,20,0,20,0
1713485029828,LISP 5A,A00,507541,Munoz Sanchez; Alicia,14,0,20,6
1713485030859,LISP 5B,A00,507671,Munoz Sanchez; Alicia,12,0,20,8
1713485031885,LISP 5C,A00,507696,Munoz Sanchez; Alicia,11,0,20,9
1713485032912,MAE 197,001,528363,Boechler; Nicholas Sebastia,9998,0,9999,1
1713485033941,MATH 197,001,523477,Kedlaya; Kiran S.,9999,0,9999,0
1713485033941,MATH 197,002,563811,Zhang; Danna,9998,0,9999,1
1713485034970,MCWP 40R,A00,518780,Staff,17,0,20,3
1713485034970,MCWP 40R,B00,518781,Staff,14,0,20,6
1713485034970,MCWP 40R,C00,518783,Staff,11,0,20,9
1713485035996,MCWP 50R,A00,518791,Staff,8,0,20,12
1713485035996,MCWP 50R,B00,518792,Staff,7,0,20,13
1713485035996,MCWP 50R,C00,518793,Staff,7,0,20,13
1713485035996,MCWP 50R,D00,518794,Staff,0,0,20,20
1713485035996,MCWP 50R,E00,518795,Staff,3,0,20,17
1713485035996,MCWP 50R,F00,518796,Staff,13,0,20,7
1713485035996,MCWP 50R,G00,518797,Staff,12,0,20,8
1713485037026,MMW 12R,A01,514034,Herbst; Matthew,6,0,16,10
1713485037026,MMW 12R,A02,514035,Herbst; Matthew,13,0,16,3
1713485038052,MMW 13R,A01,514037,Staff,0,3,16,16
1713485038052,MMW 13R,A02,514039,Staff,0,3,16,16
1713485040105,SIO 295LS,A00,523233,Staff,15,0,30,15
1713485041130,SIO 295S,A00,523232,Staff,15,0,30,15
1713485042158,SOCI 117,A01,494376,Staff,0,2,5,5
1713485043188,WES 237B,A00,494380,Staff,19,0,20,1
1713485045249,AESE 279B,A00,494370,Wade; Jon P,33,0,33,0
1713485046281,AIP 197,001,627712,Vespa; Emanuel Ignacio,9999,0,9999,0
1713485047307,ANAR 135S,A00,494369,Braswell; Geoffrey E.,0,0,0,0
1713485048333,CAT 124RS,A01,519847,Geibel; William,6,0,20,14
1713485049357,CAT 125RS,A01,515971,Geibel; William,6,0,20,14
1713485050382,CLRE 250,A00,511389,Morris; Sheldon,9996,0,9999,3
1713485051406,CLRE 251,A00,507176,Mehta; Ravindra L.,9996,0,9999,3
1713485051406,CLRE 251,B00,511410,Mehta; Ravindra L.,9998,0,9999,1
1713485052436,CLRE 252,A00,507189,Cuomo; Raphael Eduardo,9998,0,9999,1
1713485053461,CLRE 253,A00,507199,Vaida; Florin,9997,0,9999,2
1713485053461,CLRE 253,B00,507202,Vaida; Florin,9999,0,9999,0
1713485054488,CLRE 259,A00,507211,Patel; Hemal,9996,0,9999,3
1713485055513,CLRE 260,A00,507221,Cuomo; Raphael Eduardo,9999,0,9999,0
1713485056541,CLRE 297,001,507242,Cuomo; Raphael Eduardo,9999,0,9999,0
1713485057566,CSE 191,A00,516875,Minnes Kemp; Mor Mia,9999,0,9999,0
1713485058592,CSS 201S,A01,494383,Staff,35,0,35,0
1713485059622,CSS 202S,A01,494387,Staff,35,0,35,0
1713485060648,EAP 100,A00,516065,Staff,9792,0,9999,207
1713485061678,ECE 45,A01,507414,Staff,38,0,60,22
1713485062704,ECE 100,A01,507416,Baghdadchi; Saharnaz,2,0,20,18
1713485062704,ECE 100,A02,507418,Baghdadchi; Saharnaz,19,0,20,1
1713485063729,ECE 111,A01,507420,Staff,28,0,50,22
1713485064758,ECE 197,001,548057,Sievenpiper; Daniel F.,9998,0,9999,1
1713485065787,EDS 115,A00,507243,Choi; Bailey Miyeon,27,0,28,1
1713485066818,EDS 117,A01,494379,Staff,16,0,25,9
1713485067843,EDS 125,A00,507246,Hopkins; Megan Beth,28,0,30,2
1713485068871,EDS 128A,A01,507264,Fargason; Sharon Gayle,26,0,26,0
1713485069898,EDS 128B,A01,507293,Pappas; Elizabeth,30,0,30,0
1713485070922,EDS 139,A00,507294,Fargason; Sharon Gayle,30,0,30,0
1713485070922,EDS 139,B00,507313,Pappas; Elizabeth,30,0,30,0
1713485071951,EDS 201,A00,507315,Staff,19,0,30,11
1713485072977,EDS 203,A01,507317,Halter; Christopher P.,18,0,30,12
1713485074048,EDS 204R,A01,507319,Halter; Christopher P.,0,1,30,30
1713485074048,EDS 204R,B01,507331,Heinzman; Erica M.,26,0,30,4
1713485075072,EDS 206R,A00,507332,Staff,0,1,30,30
1713485075072,EDS 206R,B00,507343,Staff,27,0,30,3
1713485076097,EDS 250,A00,507344,Hemans; Patricia Ann Benitez,28,0,40,12
1713485077122,EDS 281,A00,507345,Daly; Alan J.,18,0,18,0
1713485078148,EDS 284,A00,507350,Daly; Alan J.,16,0,16,0
1713485079228,EDS 286,A00,507359,Fine; Sarah,18,0,18,0
1713485080253,EDS 289C,A01,507361,Daly; Alan J.,18,0,18,0
1713485081281,EDS 290,A00,507366,Hofstetter; Carolyn,15,0,15,0
1713485082311,LIGM 5A,A00,507421,Fischer-Grunski; Eva K,20,0,20,0
1713485083337,LIGM 5B,A00,507423,Fischer-Grunski; Eva K,20,0,20,0
1713485084370,LIGM 5C,A00,507425,Fischer-Grunski; Eva K,20,0,20,0
1713485085400,LIIT 5AS,A00,507427,Carnelos; Chiara,20,0,20,0
1713485086429,LIIT 5BS,A00,507430,Carnelos; Chiara,20,0,20,0
1713485087459,LIIT 5CS,A00,507432,Carnelos; Chiara,20,0,20,0
1713485088487,LISP 5A,A00,507541,Munoz Sanchez; Alicia,14,0,20,6
1713485089511,LISP 5B,A00,507671,Munoz Sanchez; Alicia,12,0,20,8
1713485090537,LISP 5C,A00,507696,Munoz Sanchez; Alicia,11,0,20,9
1713485091563,MAE 197,001,528363,Boechler; Nicholas Sebastia,9998,0,9999,1
1713485092589,MATH 197,001,523477,Kedlaya; Kiran S.,9999,0,9999,0
1713485092589,MATH 197,002,563811,Zhang; Danna,9998,0,9999,1
1713485093614,MCWP 40R,A00,518780,Staff,17,0,20,3
1713485093614,MCWP 40R,B00,518781,Staff,14,0,20,6
1713485093614,MCWP 40R,C00,518783,Staff,11,0,20,9
1713485094638,MCWP 50R,A00,518791,Staff,8,0,20,12
1713485094638,MCWP 50R,B00,518792,Staff,7,0,20,13
1713485094638,MCWP 50R,C00,518793,Staff,7,0,20,13
1713485094638,MCWP 50R,D00,518794,Staff,0,0,20,20
1713485094638,MCWP 50R,E00,518795,Staff,3,0,20,17
1713485094638,MCWP 50R,F00,518796,Staff,13,0,20,7
1713485094638,MCWP 50R,G00,518797,Staff,12,0,20,8
1713485095667,MMW 12R,A01,514034,Herbst; Matthew,6,0,16,10
1713485095667,MMW 12R,A02,514035,Herbst; Matthew,13,0,16,3
1713485096692,MMW 13R,A01,514037,Staff,0,3,16,16
1713485096692,MMW 13R,A02,514039,Staff,0,3,16,16
1713485098747,SIO 295LS,A00,523233,Staff,15,0,30,15
1713485099776,SIO 295S,A00,523232,Staff,15,0,30,15
1713485100804,SOCI 117,A01,494376,Staff,0,2,5,5
1713485101830,WES 237B,A00,494380,Staff,19,0,20,1
1713485103907,AESE 279B,A00,494370,Wade; Jon P,33,0,33,0
1713485104933,AIP 197,001,627712,Vespa; Emanuel Ignacio,9999,0,9999,0
1713485105958,ANAR 135S,A00,494369,Braswell; Geoffrey E.,0,0,0,0
1713485106989,CAT 124RS,A01,519847,Geibel; William,6,0,20,14
1713485108020,CAT 125RS,A01,515971,Geibel; William,6,0,20,14
1713485109048,CLRE 250,A00,511389,Morris; Sheldon,9996,0,9999,3
1713485110074,CLRE 251,A00,507176,Mehta; Ravindra L.,9996,0,9999,3
1713485110074,CLRE 251,B00,511410,Mehta; Ravindra L.,9998,0,9999,1
1713485111101,CLRE 252,A00,507189,Cuomo; Raphael Eduardo,9998,0,9999,1
1713485112130,CLRE 253,A00,507199,Vaida; Florin,9997,0,9999,2
1713485112130,CLRE 253,B00,507202,Vaida; Florin,9999,0,9999,0
1713485113159,CLRE 259,A00,507211,Patel; Hemal,9996,0,9999,3
1713485114186,CLRE 260,A00,507221,Cuomo; Raphael Eduardo,9999,0,9999,0
1713485115213,CLRE 297,001,507242,Cuomo; Raphael Eduardo,9999,0,9999,0
1713485116240,CSE 191,A00,516875,Minnes Kemp; Mor Mia,9999,0,9999,0
1713485117269,CSS 201S,A01,494383,Staff,35,0,35,0
1713485118295,CSS 202S,A01,494387,Staff,35,0,35,0
1713485119323,EAP 100,A00,516065,Staff,9792,0,9999,207
1713485120352,ECE 45,A01,507414,Staff,38,0,60,22
1713485121378,ECE 100,A01,507416,Baghdadchi; Saharnaz,1,0,20,19
1713485121378,ECE 100,A02,507418,Baghdadchi; Saharnaz,19,0,20,1
1713485122407,ECE 111,A01,507420,Staff,27,0,50,23
1713485123432,ECE 197,001,548057,Sievenpiper; Daniel F.,9998,0,9999,1
1713485124460,EDS 115,A00,507243,Choi; Bailey Miyeon,27,0,28,1
1713485125484,EDS 117,A01,494379,Staff,16,0,25,9
1713485126514,EDS 125,A00,507246,Hopkins; Megan Beth,28,0,30,2
1713485127540,EDS 128A,A01,507264,Fargason; Sharon Gayle,26,0,26,0
1713485128568,EDS 128B,A01,507293,Pappas; Elizabeth,30,0,30,0
1713485129593,EDS 139,A00,507294,Fargason; Sharon Gayle,30,0,30,0
1713485129593,EDS 139,B00,507313,Pappas; Elizabeth,30,0,30,0
1713485130618,EDS 201,A00,507315,Staff,19,0,30,11
1713485131643,EDS 203,A01,507317,Halter; Christopher P.,18,0,30,12
1713485132668,EDS 204R,A01,507319,Halter; Christopher P.,0,1,30,30
1713485132668,EDS 204R,B01,507331,Heinzman; Erica M.,26,0,30,4
1713485133693,EDS 206R,A00,507332,Staff,0,1,30,30
1713485133693,EDS 206R,B00,507343,Staff,27,0,30,3
1713485134718,EDS 250,A00,507344,Hemans; Patricia Ann Benitez,28,0,40,12
1713485135742,EDS 281,A00,507345,Daly; Alan J.,18,0,18,0
1713485136768,EDS 284,A00,507350,Daly; Alan J.,16,0,16,0
1713485137797,EDS 286,A00,507359,Fine; Sarah,18,0,18,0
1713485138822,EDS 289C,A01,507361,Daly; Alan J.,18,0,18,0
1713485139850,EDS 290,A00,507366,Hofstetter; Carolyn,15,0,15,0
1713485140876,LIGM 5A,A00,507421,Fischer-Grunski; Eva K,20,0,20,0
1713485141901,LIGM 5B,A00,507423,Fischer-Grunski; Eva K,20,0,20,0
1713485142932,LIGM 5C,A00,507425,Fischer-Grunski; Eva K,20,0,20,0
1713485143965,LIIT 5AS,A00,507427,Carnelos; Chiara,20,0,20,0
1713485144991,LIIT 5BS,A00,507430,Carnelos; Chiara,20,0,20,0
1713485146020,LIIT 5CS,A00,507432,Carnelos; Chiara,20,0,20,0
1713485147047,LISP 5A,A00,507541,Munoz Sanchez; Alicia,14,0,20,6
1713485148072,LISP 5B,A00,507671,Munoz Sanchez; Alicia,12,0,20,8
1713485149103,LISP 5C,A00,507696,Munoz Sanchez; Alicia,11,0,20,9
1713485150129,MAE 197,001,528363,Boechler; Nicholas Sebastia,9998,0,9999,1
1713485151154,MATH 197,001,523477,Kedlaya; Kiran S.,9999,0,9999,0
1713485151154,MATH 197,002,563811,Zhang; Danna,9998,0,9999,1
1713485152180,MCWP 40R,A00,518780,Staff,17,0,20,3
1713485152180,MCWP 40R,B00,518781,Staff,14,0,20,6
1713485152180,MCWP 40R,C00,518783,Staff,11,0,20,9
1713485153209,MCWP 50R,A00,518791,Staff,8,0,20,12
1713485153209,MCWP 50R,B00,518792,Staff,7,0,20,13
1713485153209,MCWP 50R,C00,518793,Staff,7,0,20,13
1713485153209,MCWP 50R,D00,518794,Staff,0,0,20,20
1713485153209,MCWP 50R,E00,518795,Staff,3,0,20,17
1713485153209,MCWP 50R,F00,518796,Staff,13,0,20,7
1713485153209,MCWP 50R,G00,518797,Staff,12,0,20,8
1713485154241,MMW 12R,A01,514034,Herbst; Matthew,6,0,16,10
1713485154241,MMW 12R,A02,514035,Herbst; Matthew,13,0,16,3
1713485155270,MMW 13R,A01,514037,Staff,0,3,16,16
1713485155270,MMW 13R,A02,514039,Staff,0,3,16,16
1713485157332,SIO 295LS,A00,523233,Staff,15,0,30,15
1713485158356,SIO 295S,A00,523232,Staff,15,0,30,15
1713485159381,SOCI 117,A01,494376,Staff,0,2,5,5
1713485160411,WES 237B,A00,494380,Staff,19,0,20,1
1713485162503,AESE 279B,A00,494370,Wade; Jon P,33,0,33,0
1713485163528,AIP 197,001,627712,Vespa; Emanuel Ignacio,9999,0,9999,0
1713485164555,ANAR 135S,A00,494369,Braswell; Geoffrey E.,0,0,0,0
1713485165580,CAT 124RS,A01,519847,Geibel; William,6,0,20,14
1713485166608,CAT 125RS,A01,515971,Geibel; William,6,0,20,14
1713485167633,CLRE 250,A00,511389,Morris; Sheldon,9996,0,9999,3
1713485168657,CLRE 251,A00,507176,Mehta; Ravindra L.,9996,0,9999,3
1713485168657,CLRE 251,B00,511410,Mehta; Ravindra L.,9998,0,9999,1
1713485169685,CLRE 252,A00,507189,Cuomo; Raphael Eduardo,9998,0,9999,1
1713485170711,CLRE 253,A00,507199,Vaida; Florin,9997,0,9999,2
1713485170711,CLRE 253,B00,507202,Vaida; Florin,9999,0,9999,0
1713485171741,CLRE 259,A00,507211,Patel; Hemal,9996,0,9999,3
1713485172769,CLRE 260,A00,507221,Cuomo; Raphael Eduardo,9999,0,9999,0
1713485173794,CLRE 297,001,507242,Cuomo; Raphael Eduardo,9999,0,9999,0
1713485174822,CSE 191,A00,516875,Minnes Kemp; Mor Mia,9999,0,9999,0
1713485175847,CSS 201S,A01,494383,Staff,35,0,35,0
1713485176878,CSS 202S,A01,494387,Staff,35,0,35,0
1713485177906,EAP 100,A00,516065,Staff,9792,0,9999,207
1713485178936,ECE 45,A01,507414,Staff,38,0,60,22
1713485179962,ECE 100,A01,507416,Baghdadchi; Saharnaz,1,0,20,19
1713485179962,ECE 100,A02,507418,Baghdadchi; Saharnaz,19,0,20,1
1713485180989,ECE 111,A01,507420,Staff,27,0,50,23
1713485182018,ECE 197,001,548057,Sievenpiper; Daniel F.,9998,0,9999,1
1713485183103,EDS 115,A00,507243,Choi; Bailey Miyeon,27,0,28,1
1713485184130,EDS 117,A01,494379,Staff,16,0,25,9
1713485185158,EDS 125,A00,507246,Hopkins; Megan Beth,28,0,30,2
1713485186191,EDS 128A,A01,507264,Fargason; Sharon Gayle,26,0,26,0
1713485187216,EDS 128B,A01,507293,Pappas; Elizabeth,30,0,30,0
1713485188245,EDS 139,A00,507294,Fargason; Sharon Gayle,30,0,30,0
1713485188245,EDS 139,B00,507313,Pappas; Elizabeth,30,0,30,0
1713485189273,EDS 201,A00,507315,Staff,19,0,30,11
1713485190304,EDS 203,A01,507317,Halter; Christopher P.,18,0,30,12
1713485191332,EDS 204R,A01,507319,Halter; Christopher P.,0,1,30,30
1713485191332,EDS 204R,B01,507331,Heinzman; Erica M.,26,0,30,4
1713485192358,EDS 206R,A00,507332,Staff,0,1,30,30
1713485192358,EDS 206R,B00,507343,Staff,27,0,30,3
1713485193382,EDS 250,A00,507344,Hemans; Patricia Ann Benitez,28,0,40,12
1713485194408,EDS 281,A00,507345,Daly; Alan J.,18,0,18,0
1713485195437,EDS 284,A00,507350,Daly; Alan J.,16,0,16,0
1713485196463,EDS 286,A00,507359,Fine; Sarah,18,0,18,0
1713485197491,EDS 289C,A01,507361,Daly; Alan J.,18,0,18,0
1713485198520,EDS 290,A00,507366,Hofstetter; Carolyn,15,0,15,0
1713485199545,LIGM 5A,A00,507421,Fischer-Grunski; Eva K,20,0,20,0
1713485200575,LIGM 5B,A00,507423,Fischer-Grunski; Eva K,20,0,20,0
1713485201599,LIGM 5C,A00,507425,Fischer-Grunski; Eva K,20,0,20,0
1713485202625,LIIT 5AS,A00,507427,Carnelos; Chiara,20,0,20,0
1713485203649,LIIT 5BS,A00,507430,Carnelos; Chiara,20,0,20,0
1713485204675,LIIT 5CS,A00,507432,Carnelos; Chiara,20,0,20,0
1713485205701,LISP 5A,A00,507541,Munoz Sanchez; Alicia,14,0,20,6
1713485206731,LISP 5B,A00,507671,Munoz Sanchez; Alicia,12,0,20,8
1713485207757,LISP 5C,A00,507696,Munoz Sanchez; Alicia,11,0,20,9
1713485208781,MAE 197,001,528363,Boechler; Nicholas Sebastia,9998,0,9999,1
1713485209806,MATH 197,001,523477,Kedlaya; Kiran S.,9999,0,9999,0
1713485209806,MATH 197,002,563811,Zhang; Danna,9998,0,9999,1
1713485210834,MCWP 40R,A00,518780,Staff,17,0,20,3
1713485210834,MCWP 40R,B00,518781,Staff,14,0,20,6
1713485210834,MCWP 40R,C00,518783,Staff,11,0,20,9
1713485211860,MCWP 50R,A00,518791,Staff,8,0,20,12
1713485211860,MCWP 50R,B00,518792,Staff,7,0,20,13
1713485211860,MCWP 50R,C00,518793,Staff,7,0,20,13
1713485211860,MCWP 50R,D00,518794,Staff,0,0,20,20
1713485211860,MCWP 50R,E00,518795,Staff,3,0,20,17
1713485211860,MCWP 50R,F00,518796,Staff,13,0,20,7
1713485211860,MCWP 50R,G00,518797,Staff,12,0,20,8
1713485212885,MMW 12R,A01,514034,Herbst; Matthew,6,0,16,10
1713485212885,MMW 12R,A02,514035,Herbst; Matthew,13,0,16,3
1713485213911,MMW 13R,A01,514037,Staff,0,3,16,16
1713485213911,MMW 13R,A02,514039,Staff,0,3,16,16
1713485215961,SIO 295LS,A00,523233,Staff,15,0,30,15
1713485216986,SIO 295S,A00,523232,Staff,15,0,30,15
1713485218017,SOCI 117,A01,494376,Staff,0,2,5,5
1713485219042,WES 237B,A00,494380,Staff,19,0,20,1
1713485221121,AESE 279B,A00,494370,Wade; Jon P,33,0,33,0
1713485222146,AIP 197,001,627712,Vespa; Emanuel Ignacio,9999,0,9999,0
1713485223172,ANAR 135S,A00,494369,Braswell; Geoffrey E.,0,0,0,0
1713485224198,CAT 124RS,A01,519847,Geibel; William,6,0,20,14
1713485225226,CAT 125RS,A01,515971,Geibel; William,6,0,20,14
1713485226260,CLRE 250,A00,511389,Morris; Sheldon,9996,0,9999,3
1713485227293,CLRE 251,A00,507176,Mehta; Ravindra L.,9996,0,9999,3
1713485227293,CLRE 251,B00,511410,Mehta; Ravindra L.,9998,0,9999,1
1713485228321,CLRE 252,A00,507189,Cuomo; Raphael Eduardo,9998,0,9999,1
1713485229346,CLRE 253,A00,507199,Vaida; Florin,9997,0,9999,2
1713485229346,CLRE 253,B00,507202,Vaida; Florin,9999,0,9999,0
1713485230371,CLRE 259,A00,507211,Patel; Hemal,9996,0,9999,3
1713485231400,CLRE 260,A00,507221,Cuomo; Raphael Eduardo,9999,0,9999,0
1713485232429,CLRE 297,001,507242,Cuomo; Raphael Eduardo,9999,0,9999,0
1713485233458,CSE 191,A00,516875,Minnes Kemp; Mor Mia,9999,0,9999,0
1713485234487,CSS 201S,A01,494383,Staff,35,0,35,0
1713485235512,CSS 202S,A01,494387,Staff,35,0,35,0
1713485236541,EAP 100,A00,516065,Staff,9792,0,9999,207
1713485237566,ECE 45,A01,507414,Staff,38,0,60,22
1713485238591,ECE 100,A01,507416,Baghdadchi; Saharnaz,1,0,20,19
1713485238591,ECE 100,A02,507418,Baghdadchi; Saharnaz,19,0,20,1
1713485239617,ECE 111,A01,507420,Staff,27,0,50,23
1713485240646,ECE 197,001,548057,Sievenpiper; Daniel F.,9998,0,9999,1
1713485241672,EDS 115,A00,507243,Choi; Bailey Miyeon,27,0,28,1
1713485242698,EDS 117,A01,494379,Staff,16,0,25,9
1713485243730,EDS 125,A00,507246,Hopkins; Megan Beth,28,0,30,2
1713485244754,EDS 128A,A01,507264,Fargason; Sharon Gayle,26,0,26,0
1713485245783,EDS 128B,A01,507293,Pappas; Elizabeth,30,0,30,0
1713485246812,EDS 139,A00,507294,Fargason; Sharon Gayle,30,0,30,0
1713485246812,EDS 139,B00,507313,Pappas; Elizabeth,30,0,30,0
1713485247839,EDS 201,A00,507315,Staff,19,0,30,11
1713485248869,EDS 203,A01,507317,Halter; Christopher P.,18,0,30,12
1713485249900,EDS 204R,A01,507319,Halter; Christopher P.,0,1,30,30
1713485249900,EDS 204R,B01,507331,Heinzman; Erica M.,26,0,30,4
1713485250927,EDS 206R,A00,507332,Staff,0,1,30,30
1713485250927,EDS 206R,B00,507343,Staff,27,0,30,3
1713485251953,EDS 250,A00,507344,Hemans; Patricia Ann Benitez,28,0,40,12
1713485252978,EDS 281,A00,507345,Daly; Alan J.,18,0,18,0
1713485254005,EDS 284,A00,507350,Daly; Alan J.,16,0,16,0
1713485255031,EDS 286,A00,507359,Fine; Sarah,18,0,18,0
1713485256057,EDS 289C,A01,507361,Daly; Alan J.,18,0,18,0
1713485257082,EDS 290,A00,507366,Hofstetter; Carolyn,15,0,15,0
1713485258109,LIGM 5A,A00,507421,Fischer-Grunski; Eva K,20,0,20,0
1713485259135,LIGM 5B,A00,507423,Fischer-Grunski; Eva K,20,0,20,0
1713485260162,LIGM 5C,A00,507425,Fischer-Grunski; Eva K,20,0,20,0
1713485261193,LIIT 5AS,A00,507427,Carnelos; Chiara,20,0,20,0
1713485262221,LIIT 5BS,A00,507430,Carnelos; Chiara,20,0,20,0
1713485263254,LIIT 5CS,A00,507432,Carnelos; Chiara,20,0,20,0
1713485264280,LISP 5A,A00,507541,Munoz Sanchez; Alicia,14,0,20,6
1713485265308,LISP 5B,A00,507671,Munoz Sanchez; Alicia,12,0,20,8
1713485266332,LISP 5C,A00,507696,Munoz Sanchez; Alicia,11,0,20,9
1713485267361,MAE 197,001,528363,Boechler; Nicholas Sebastia,9998,0,9999,1
1713485268391,MATH 197,001,523477,Kedlaya; Kiran S.,9999,0,9999,0
1713485268391,MATH 197,002,563811,Zhang; Danna,9998,0,9999,1
1713485269417,MCWP 40R,A00,518780,Staff,17,0,20,3
1713485269417,MCWP 40R,B00,518781,Staff,14,0,20,6
1713485269417,MCWP 40R,C00,518783,Staff,11,0,20,9
1713485270442,MCWP 50R,A00,518791,Staff,8,0,20,12
1713485270442,MCWP 50R,B00,518792,Staff,7,0,20,13
1713485270442,MCWP 50R,C00,518793,Staff,7,0,20,13
1713485270442,MCWP 50R,D00,518794,Staff,0,0,20,20
1713485270442,MCWP 50R,E00,518795,Staff,3,0,20,17
1713485270442,MCWP 50R,F00,518796,Staff,13,0,20,7
1713485270442,MCWP 50R,G00,518797,Staff,12,0,20,8
1713485271476,MMW 12R,A01,514034,Herbst; Matthew,6,0,16,10
1713485271476,MMW 12R,A02,514035,Herbst; Matthew,13,0,16,3
1713485272505,MMW 13R,A01,514037,Staff,0,3,16,16
1713485272505,MMW 13R,A02,514039,Staff,0,3,16,16
1713485274563,SIO 295LS,A00,523233,Staff,15,0,30,15
1713485275588,SIO 295S,A00,523232,Staff,15,0,30,15
1713485276613,SOCI 117,A01,494376,Staff,0,2,5,5
1713485277638,WES 237B,A00,494380,Staff,19,0,20,1
1713485279734,AESE 279B,A00,494370,Wade; Jon P,33,0,33,0
1713485280762,AIP 197,001,627712,Vespa; Emanuel Ignacio,9999,0,9999,0
1713485281794,ANAR 135S,A00,494369,Braswell; Geoffrey E.,0,0,0,0
1713485282820,CAT 124RS,A01,519847,Geibel; William,6,0,20,14
1713485283846,CAT 125RS,A01,515971,Geibel; William,6,0,20,14
1713485284872,CLRE 250,A00,511389,Morris; Sheldon,9996,0,9999,3
1713485285901,CLRE 251,A00,507176,Mehta; Ravindra L.,9996,0,9999,3
1713485285901,CLRE 251,B00,511410,Mehta; Ravindra L.,9998,0,9999,1
1713485286986,CLRE 252,A00,507189,Cuomo; Raphael Eduardo,9998,0,9999,1
1713485288014,CLRE 253,A00,507199,Vaida; Florin,9997,0,9999,2
1713485288014,CLRE 253,B00,507202,Vaida; Florin,9999,0,9999,0
1713485289045,CLRE 259,A00,507211,Patel; Hemal,9996,0,9999,3
1713485290076,CLRE 260,A00,507221,Cuomo; Raphael Eduardo,9999,0,9999,0
1713485291102,CLRE 297,001,507242,Cuomo; Raphael Eduardo,9999,0,9999,0
1713485292127,CSE 191,A00,516875,Minnes Kemp; Mor Mia,9999,0,9999,0
1713485293155,CSS 201S,A01,494383,Staff,35,0,35,0
1713485294185,CSS 202S,A01,494387,Staff,35,0,35,0
1713485295210,EAP 100,A00,516065,Staff,9792,0,9999,207
1713485296235,ECE 45,A01,507414,Staff,38,0,60,22
1713485297260,ECE 100,A01,507416,Baghdadchi; Saharnaz,1,0,20,19
1713485297260,ECE 100,A02,507418,Baghdadchi; Saharnaz,19,0,20,1
1713485298289,ECE 111,A01,507420,Staff,27,0,50,23
1713485299313,ECE 197,001,548057,Sievenpiper; Daniel F.,9998,0,9999,1
1713485300385,EDS 115,A00,507243,Choi; Bailey Miyeon,27,0,28,1
1713485301416,EDS 117,A01,494379,Staff,16,0,25,9
1713485302441,EDS 125,A00,507246,Hopkins; Megan Beth,28,0,30,2
1713485303472,EDS 128A,A01,507264,Fargason; Sharon Gayle,26,0,26,0
1713485304502,EDS 128B,A01,507293,Pappas; Elizabeth,30,0,30,0
1713485305526,EDS 139,A00,507294,Fargason; Sharon Gayle,30,0,30,0
1713485305526,EDS 139,B00,507313,Pappas; Elizabeth,30,0,30,0
1713485306553,EDS 201,A00,507315,Staff,19,0,30,11
1713485307586,EDS 203,A01,507317,Halter; Christopher P.,18,0,30,12
1713485308617,EDS 204R,A01,507319,Halter; Christopher P.,0,1,30,30
1713485308617,EDS 204R,B01,507331,Heinzman; Erica M.,26,0,30,4
1713485309643,EDS 206R,A00,507332,Staff,0,1,30,30
1713485309643,EDS 206R,B00,507343,Staff,27,0,30,3
1713485310675,EDS 250,A00,507344,Hemans; Patricia Ann Benitez,28,0,40,12
1713485311703,EDS 281,A00,507345,Daly; Alan J.,18,0,18,0
1713485312728,EDS 284,A00,507350,Daly; Alan J.,16,0,16,0
1713485313756,EDS 286,A00,507359,Fine; Sarah,18,0,18,0
1713485314784,EDS 289C,A01,507361,Daly; Alan J.,18,0,18,0
1713485315810,EDS 290,A00,507366,Hofstetter; Carolyn,15,0,15,0
1713485316836,LIGM 5A,A00,507421,Fischer-Grunski; Eva K,20,0,20,0
1713485317865,LIGM 5B,A00,507423,Fischer-Grunski; Eva K,20,0,20,0
1713485318890,LIGM 5C,A00,507425,Fischer-Grunski; Eva K,20,0,20,0
1713485319916,LIIT 5AS,A00,507427,Carnelos; Chiara,20,0,20,0
1713485320946,LIIT 5BS,A00,507430,Carnelos; Chiara,20,0,20,0
1713485321971,LIIT 5CS,A00,507432,Carnelos; Chiara,20,0,20,0
1713485322998,LISP 5A,A00,507541,Munoz Sanchez; Alicia,14,0,20,6
1713485324028,LISP 5B,A00,507671,Munoz Sanchez; Alicia,12,0,20,8
1713485325055,LISP 5C,A00,507696,Munoz Sanchez; Alicia,11,0,20,9
1713485326081,MAE 197,001,528363,Boechler; Nicholas Sebastia,9998,0,9999,1
1713485327106,MATH 197,001,523477,Kedlaya; Kiran S.,9999,0,9999,0
1713485327106,MATH 197,002,563811,Zhang; Danna,9998,0,9999,1
1713485328137,MCWP 40R,A00,518780,Staff,17,0,20,3
1713485328137,MCWP 40R,B00,518781,Staff,14,0,20,6
1713485328137,MCWP 40R,C00,518783,Staff,11,0,20,9
1713485329164,MCWP 50R,A00,518791,Staff,8,0,20,12
1713485329164,MCWP 50R,B00,518792,Staff,7,0,20,13
1713485329164,MCWP 50R,C00,518793,Staff,7,0,20,13
1713485329164,MCWP 50R,D00,518794,Staff,0,0,20,20
1713485329164,MCWP 50R,E00,518795,Staff,3,0,20,17
1713485329164,MCWP 50R,F00,518796,Staff,13,0,20,7
1713485329164,MCWP 50R,G00,518797,Staff,12,0,20,8
1713485330190,MMW 12R,A01,514034,Herbst; Matthew,6,0,16,10
1713485330190,MMW 12R,A02,514035,Herbst; Matthew,13,0,16,3
1713485331215,MMW 13R,A01,514037,Staff,0,3,16,16
1713485331215,MMW 13R,A02,514039,Staff,0,3,16,16
1713485333270,SIO 295LS,A00,523233,Staff,15,0,30,15
1713485334298,SIO 295S,A00,523232,Staff,15,0,30,15
1713485335325,SOCI 117,A01,494376,Staff,0,2,5,5
1713485336352,WES 237B,A00,494380,Staff,19,0,20,1
1713485338422,AESE 279B,A00,494370,Wade; Jon P,33,0,33,0
1713485339447,AIP 197,001,627712,Vespa; Emanuel Ignacio,9999,0,9999,0
1713485340473,ANAR 135S,A00,494369,Braswell; Geoffrey E.,0,0,0,0
1713485341497,CAT 124RS,A01,519847,Geibel; William,6,0,20,14
1713485342522,CAT 125RS,A01,515971,Geibel; William,6,0,20,14
1713485343547,CLRE 250,A00,511389,Morris; Sheldon,9996,0,9999,3
1713485344573,CLRE 251,A00,507176,Mehta; Ravindra L.,9996,0,9999,3
1713485344573,CLRE 251,B00,511410,Mehta; Ravindra L.,9998,0,9999,1
1713485345598,CLRE 252,A00,507189,Cuomo; Raphael Eduardo,9998,0,9999,1
1713485346624,CLRE 253,A00,507199,Vaida; Florin,9997,0,9999,2
1713485346624,CLRE 253,B00,507202,Vaida; Florin,9999,0,9999,0
1713485347647,CLRE 259,A00,507211,Patel; Hemal,9996,0,9999,3
1713485348672,CLRE 260,A00,507221,Cuomo; Raphael Eduardo,9999,0,9999,0
1713485349701,CLRE 297,001,507242,Cuomo; Raphael Eduardo,9999,0,9999,0
1713485350729,CSE 191,A00,516875,Minnes Kemp; Mor Mia,9999,0,9999,0
1713485351759,CSS 201S,A01,494383,Staff,35,0,35,0
1713485352792,CSS 202S,A01,494387,Staff,35,0,35,0
1713485353819,EAP 100,A00,516065,Staff,9792,0,9999,207
1713485354847,ECE 45,A01,507414,Staff,38,0,60,22
1713485355871,ECE 100,A01,507416,Baghdadchi; Saharnaz,1,0,20,19
1713485355871,ECE 100,A02,507418,Baghdadchi; Saharnaz,19,0,20,1
1713485356897,ECE 111,A01,507420,Staff,27,0,50,23
1713485357926,ECE 197,001,548057,Sievenpiper; Daniel F.,9998,0,9999,1
1713485358953,EDS 115,A00,507243,Choi; Bailey Miyeon,27,0,28,1
1713485359981,EDS 117,A01,494379,Staff,16,0,25,9
1713485361011,EDS 125,A00,507246,Hopkins; Megan Beth,28,0,30,2
1713485362041,EDS 128A,A01,507264,Fargason; Sharon Gayle,26,0,26,0
1713485363065,EDS 128B,A01,507293,Pappas; Elizabeth,30,0,30,0
1713485364091,EDS 139,A00,507294,Fargason; Sharon Gayle,30,0,30,0
1713485364091,EDS 139,B00,507313,Pappas; Elizabeth,30,0,30,0
1713485365122,EDS 201,A00,507315,Staff,19,0,30,11
1713485366148,EDS 203,A01,507317,Halter; Christopher P.,18,0,30,12
1713485367178,EDS 204R,A01,507319,Halter; Christopher P.,0,1,30,30
1713485367178,EDS 204R,B01,507331,Heinzman; Erica M.,26,0,30,4
1713485368203,EDS 206R,A00,507332,Staff,0,1,30,30
1713485368203,EDS 206R,B00,507343,Staff,27,0,30,3
1713485369228,EDS 250,A00,507344,Hemans; Patricia Ann Benitez,28,0,40,12
1713485370254,EDS 281,A00,507345,Daly; Alan J.,18,0,18,0
1713485371282,EDS 284,A00,507350,Daly; Alan J.,16,0,16,0
1713485372312,EDS 286,A00,507359,Fine; Sarah,18,0,18,0
1713485373340,EDS 289C,A01,507361,Daly; Alan J.,18,0,18,0
1713485374365,EDS 290,A00,507366,Hofstetter; Carolyn,15,0,15,0
1713485375393,LIGM 5A,A00,507421,Fischer-Grunski; Eva K,20,0,20,0
1713485376416,LIGM 5B,A00,507423,Fischer-Grunski; Eva K,20,0,20,0
1713485377445,LIGM 5C,A00,507425,Fischer-Grunski; Eva K,20,0,20,0
1713485378475,LIIT 5AS,A00,507427,Carnelos; Chiara,20,0,20,0
1713485379500,LIIT 5BS,A00,507430,Carnelos; Chiara,20,0,20,0
1713485380530,LIIT 5CS,A00,507432,Carnelos; Chiara,20,0,20,0
1713485381559,LISP 5A,A00,507541,Munoz Sanchez; Alicia,14,0,20,6
1713485382585,LISP 5B,A00,507671,Munoz Sanchez; Alicia,12,0,20,8
1713485383609,LISP 5C,A00,507696,Munoz Sanchez; Alicia,11,0,20,9
1713485384639,MAE 197,001,528363,Boechler; Nicholas Sebastia,9998,0,9999,1
1713485385665,MATH 197,001,523477,Kedlaya; Kiran S.,9999,0,9999,0
1713485385665,MATH 197,002,563811,Zhang; Danna,9998,0,9999,1
1713485386692,MCWP 40R,A00,518780,Staff,17,0,20,3
1713485386692,MCWP 40R,B00,518781,Staff,14,0,20,6
1713485386692,MCWP 40R,C00,518783,Staff,11,0,20,9
1713485387719,MCWP 50R,A00,518791,Staff,8,0,20,12
1713485387719,MCWP 50R,B00,518792,Staff,7,0,20,13
1713485387719,MCWP 50R,C00,518793,Staff,7,0,20,13
1713485387719,MCWP 50R,D00,518794,Staff,0,0,20,20
1713485387719,MCWP 50R,E00,518795,Staff,3,0,20,17
1713485387719,MCWP 50R,F00,518796,Staff,13,0,20,7
1713485387719,MCWP 50R,G00,518797,Staff,12,0,20,8
1713485388746,MMW 12R,A01,514034,Herbst; Matthew,6,0,16,10
1713485388746,MMW 12R,A02,514035,Herbst; Matthew,13,0,16,3
1713485389771,MMW 13R,A01,514037,Staff,0,3,16,16
1713485389771,MMW 13R,A02,514039,Staff,0,3,16,16
1713485391877,SIO 295LS,A00,523233,Staff,15,0,30,15
1713485392904,SIO 295S,A00,523232,Staff,15,0,30,15
1713485394005,SOCI 117,A01,494376,Staff,0,2,5,5
1713485395032,WES 237B,A00,494380,Staff,19,0,20,1
1713485397096,AESE 279B,A00,494370,Wade; Jon P,33,0,33,0
1713485398125,AIP 197,001,627712,Vespa; Emanuel Ignacio,9999,0,9999,0
1713485399151,ANAR 135S,A00,494369,Braswell; Geoffrey E.,0,0,0,0
1713485400179,CAT 124RS,A01,519847,Geibel; William,6,0,20,14
1713485401204,CAT 125RS,A01,515971,Geibel; William,6,0,20,14
1713485402229,CLRE 250,A00,511389,Morris; Sheldon,9996,0,9999,3
1713485403256,CLRE 251,A00,507176,Mehta; Ravindra L.,9996,0,9999,3
1713485403256,CLRE 251,B00,511410,Mehta; Ravindra L.,9998,0,9999,1
1713485404284,CLRE 252,A00,507189,Cuomo; Raphael Eduardo,9998,0,9999,1
1713485405312,CLRE 253,A00,507199,Vaida; Florin,9997,0,9999,2
1713485405312,CLRE 253,B00,507202,Vaida; Florin,9999,0,9999,0
1713485406340,CLRE 259,A00,507211,Patel; Hemal,9996,0,9999,3
1713485407368,CLRE 260,A00,507221,Cuomo; Raphael Eduardo,9999,0,9999,0
1713485408397,CLRE 297,001,507242,Cuomo; Raphael Eduardo,9999,0,9999,0
1713485409426,CSE 191,A00,516875,Minnes Kemp; Mor Mia,9999,0,9999,0
1713485410454,CSS 201S,A01,494383,Staff,35,0,35,0
1713485411484,CSS 202S,A01,494387,Staff,35,0,35,0
1713485412510,EAP 100,A00,516065,Staff,9792,0,9999,207
1713485413536,ECE 45,A01,507414,Staff,38,0,60,22
1713485414565,ECE 100,A01,507416,Baghdadchi; Saharnaz,1,0,20,19
1713485414565,ECE 100,A02,507418,Baghdadchi; Saharnaz,19,0,20,1
1713485415591,ECE 111,A01,507420,Staff,27,0,50,23
1713485416619,ECE 197,001,548057,Sievenpiper; Daniel F.,9998,0,9999,1
1713485417644,EDS 115,A00,507243,Choi; Bailey Miyeon,27,0,28,1
1713485418671,EDS 117,A01,494379,Staff,16,0,25,9
1713485419696,EDS 125,A00,507246,Hopkins; Megan Beth,28,0,30,2
1713485420725,EDS 128A,A01,507264,Fargason; Sharon Gayle,26,0,26,0
1713485421754,EDS 128B,A01,507293,Pappas; Elizabeth,30,0,30,0
1713485422780,EDS 139,A00,507294,Fargason; Sharon Gayle,30,0,30,0
1713485422780,EDS 139,B00,507313,Pappas; Elizabeth,30,0,30,0
1713485423807,EDS 201,A00,507315,Staff,19,0,30,11
1713485424832,EDS 203,A01,507317,Halter; Christopher P.,18,0,30,12
1713485425857,EDS 204R,A01,507319,Halter; Christopher P.,0,1,30,30
1713485425857,EDS 204R,B01,507331,Heinzman; Erica M.,26,0,30,4
1713485426886,EDS 206R,A00,507332,Staff,0,1,30,30
1713485426886,EDS 206R,B00,507343,Staff,27,0,30,3
1713485427911,EDS 250,A00,507344,Hemans; Patricia Ann Benitez,28,0,40,12
1713485428936,EDS 281,A00,507345,Daly; Alan J.,18,0,18,0
1713485429964,EDS 284,A00,507350,Daly; Alan J.,16,0,16,0
1713485430989,EDS 286,A00,507359,Fine; Sarah,18,0,18,0
1713485432018,EDS 289C,A01,507361,Daly; Alan J.,18,0,18,0
1713485433043,EDS 290,A00,507366,Hofstetter; Carolyn,15,0,15,0
1713485434070,LIGM 5A,A00,507421,Fischer-Grunski; Eva K,20,0,20,0
1713485435097,LIGM 5B,A00,507423,Fischer-Grunski; Eva K,20,0,20,0
1713485436127,LIGM 5C,A00,507425,Fischer-Grunski; Eva K,20,0,20,0
1713485437153,LIIT 5AS,A00,507427,Carnelos; Chiara,20,0,20,0
1713485438182,LIIT 5BS,A00,507430,Carnelos; Chiara,20,0,20,0
1713485439207,LIIT 5CS,A00,507432,Carnelos; Chiara,20,0,20,0
1713485440233,LISP 5A,A00,507541,Munoz Sanchez; Alicia,14,0,20,6
1713485441258,LISP 5B,A00,507671,Munoz Sanchez; Alicia,12,0,20,8
1713485442283,LISP 5C,A00,507696,Munoz Sanchez; Alicia,11,0,20,9
1713485443308,MAE 197,001,528363,Boechler; Nicholas Sebastia,9998,0,9999,1
1713485444338,MATH 197,001,523477,Kedlaya; Kiran S.,9999,0,9999,0
1713485444338,MATH 197,002,563811,Zhang; Danna,9998,0,9999,1
1713485445364,MCWP 40R,A00,518780,Staff,17,0,20,3
1713485445364,MCWP 40R,B00,518781,Staff,14,0,20,6
1713485445364,MCWP 40R,C00,518783,Staff,11,0,20,9
1713485446392,MCWP 50R,A00,518791,Staff,8,0,20,12
1713485446392,MCWP 50R,B00,518792,Staff,7,0,20,13
1713485446392,MCWP 50R,C00,518793,Staff,7,0,20,13
1713485446392,MCWP 50R,D00,518794,Staff,0,0,20,20
1713485446392,MCWP 50R,E00,518795,Staff,3,0,20,17
1713485446392,MCWP 50R,F00,518796,Staff,13,0,20,7
1713485446392,MCWP 50R,G00,518797,Staff,12,0,20,8
1713485447419,MMW 12R,A01,514034,Herbst; Matthew,6,0,16,10
1713485447419,MMW 12R,A02,514035,Herbst; Matthew,13,0,16,3
1713485448448,MMW 13R,A01,514037,Staff,0,3,16,16
1713485448448,MMW 13R,A02,514039,Staff,0,3,16,16
1713485450499,SIO 295LS,A00,523233,Staff,15,0,30,15
1713485451529,SIO 295S,A00,523232,Staff,15,0,30,15
1713485452553,SOCI 117,A01,494376,Staff,0,2,5,5
1713485453582,WES 237B,A00,494380,Staff,19,0,20,1
1713485455650,AESE 279B,A00,494370,Wade; Jon P,33,0,33,0
1713485456677,AIP 197,001,627712,Vespa; Emanuel Ignacio,9999,0,9999,0
1713485457702,ANAR 135S,A00,494369,Braswell; Geoffrey E.,0,0,0,0
1713485458727,CAT 124RS,A01,519847,Geibel; William,6,0,20,14
1713485459756,CAT 125RS,A01,515971,Geibel; William,6,0,20,14
1713485460781,CLRE 250,A00,511389,Morris; Sheldon,9996,0,9999,3
1713485461812,CLRE 251,A00,507176,Mehta; Ravindra L.,9996,0,9999,3
1713485461812,CLRE 251,B00,511410,Mehta; Ravindra L.,9998,0,9999,1
1713485462838,CLRE 252,A00,507189,Cuomo; Raphael Eduardo,9998,0,9999,1
1713485463863,CLRE 253,A00,507199,Vaida; Florin,9997,0,9999,2
1713485463863,CLRE 253,B00,507202,Vaida; Florin,9999,0,9999,0
1713485464889,CLRE 259,A00,507211,Patel; Hemal,9996,0,9999,3
1713485465917,CLRE 260,A00,507221,Cuomo; Raphael Eduardo,9999,0,9999,0
1713485466945,CLRE 297,001,507242,Cuomo; Raphael Eduardo,9999,0,9999,0
1713485467972,CSE 191,A00,516875,Minnes Kemp; Mor Mia,9999,0,9999,0
1713485468998,CSS 201S,A01,494383,Staff,35,0,35,0
1713485470024,CSS 202S,A01,494387,Staff,35,0,35,0
1713485471052,EAP 100,A00,516065,Staff,9792,0,9999,207
1713485472076,ECE 45,A01,507414,Staff,38,0,60,22
1713485473106,ECE 100,A01,507416,Baghdadchi; Saharnaz,1,0,20,19
1713485473106,ECE 100,A02,507418,Baghdadchi; Saharnaz,19,0,20,1
1713485474136,ECE 111,A01,507420,Staff,27,0,50,23
1713485475161,ECE 197,001,548057,Sievenpiper; Daniel F.,9998,0,9999,1
1713485476189,EDS 115,A00,507243,Choi; Bailey Miyeon,27,0,28,1
1713485477214,EDS 117,A01,494379,Staff,16,0,25,9
1713485478240,EDS 125,A00,507246,Hopkins; Megan Beth,28,0,30,2
1713485479266,EDS 128A,A01,507264,Fargason; Sharon Gayle,26,0,26,0
1713485480292,EDS 128B,A01,507293,Pappas; Elizabeth,30,0,30,0
1713485481317,EDS 139,A00,507294,Fargason; Sharon Gayle,30,0,30,0
1713485481317,EDS 139,B00,507313,Pappas; Elizabeth,30,0,30,0
1713485482342,EDS 201,A00,507315,Staff,19,0,30,11
1713485483368,EDS 203,A01,507317,Halter; Christopher P.,18,0,30,12
1713485484394,EDS 204R,A01,507319,Halter; Christopher P.,0,1,30,30
1713485484394,EDS 204R,B01,507331,Heinzman; Erica M.,26,0,30,4
1713485485418,EDS 206R,A00,507332,Staff,0,1,30,30
1713485485418,EDS 206R,B00,507343,Staff,27,0,30,3
1713485486446,EDS 250,A00,507344,Hemans; Patricia Ann Benitez,28,0,40,12
1713485487477,EDS 281,A00,507345,Daly; Alan J.,18,0,18,0
1713485488505,EDS 284,A00,507350,Daly; Alan J.,16,0,16,0
1713485489531,EDS 286,A00,507359,Fine; Sarah,18,0,18,0
1713485490559,EDS 289C,A01,507361,Daly; Alan J.,18,0,18,0
1713485491584,EDS 290,A00,507366,Hofstetter; Carolyn,15,0,15,0
1713485492612,LIGM 5A,A00,507421,Fischer-Grunski; Eva K,20,0,20,0
1713485493646,LIGM 5B,A00,507423,Fischer-Grunski; Eva K,20,0,20,0
1713485494728,LIGM 5C,A00,507425,Fischer-Grunski; Eva K,20,0,20,0
1713485495760,LIIT 5AS,A00,507427,Carnelos; Chiara,20,0,20,0
1713485496786,LIIT 5BS,A00,507430,Carnelos; Chiara,20,0,20,0
1713485497812,LIIT 5CS,A00,507432,Carnelos; Chiara,20,0,20,0
1713485498839,LISP 5A,A00,507541,Munoz Sanchez; Alicia,14,0,20,6
1713485499865,LISP 5B,A00,507671,Munoz Sanchez; Alicia,12,0,20,8
1713485500896,LISP 5C,A00,507696,Munoz Sanchez; Alicia,11,0,20,9
1713485501925,MAE 197,001,528363,Boechler; Nicholas Sebastia,9998,0,9999,1
1713485502954,MATH 197,001,523477,Kedlaya; Kiran S.,9999,0,9999,0
1713485502954,MATH 197,002,563811,Zhang; Danna,9998,0,9999,1
1713485503982,MCWP 40R,A00,518780,Staff,17,0,20,3
1713485503982,MCWP 40R,B00,518781,Staff,14,0,20,6
1713485503982,MCWP 40R,C00,518783,Staff,11,0,20,9
1713485505013,MCWP 50R,A00,518791,Staff,8,0,20,12
1713485505013,MCWP 50R,B00,518792,Staff,7,0,20,13
1713485505013,MCWP 50R,C00,518793,Staff,7,0,20,13
1713485505013,MCWP 50R,D00,518794,Staff,0,0,20,20
1713485505013,MCWP 50R,E00,518795,Staff,3,0,20,17
1713485505013,MCWP 50R,F00,518796,Staff,13,0,20,7
1713485505013,MCWP 50R,G00,518797,Staff,12,0,20,8
1713485506037,MMW 12R,A01,514034,Herbst; Matthew,6,0,16,10
1713485506037,MMW 12R,A02,514035,Herbst; Matthew,13,0,16,3
1713485507065,MMW 13R,A01,514037,Staff,0,3,16,16
1713485507065,MMW 13R,A02,514039,Staff,0,3,16,16
1713485509119,SIO 295LS,A00,523233,Staff,15,0,30,15
1713485510146,SIO 295S,A00,523232,Staff,15,0,30,15
1713485511171,SOCI 117,A01,494376,Staff,0,2,5,5
1713485512199,WES 237B,A00,494380,Staff,19,0,20,1
1713485514259,AESE 279B,A00,494370,Wade; Jon P,33,0,33,0
1713485515285,AIP 197,001,627712,Vespa; Emanuel Ignacio,9999,0,9999,0
1713485516315,ANAR 135S,A00,494369,Braswell; Geoffrey E.,0,0,0,0
1713485517344,CAT 124RS,A01,519847,Geibel; William,6,0,20,14
1713485518372,CAT 125RS,A01,515971,Geibel; William,6,0,20,14
1713485519399,CLRE 250,A00,511389,Morris; Sheldon,9996,0,9999,3
1713485520424,CLRE 251,A00,507176,Mehta; Ravindra L.,9996,0,9999,3
1713485520424,CLRE 251,B00,511410,Mehta; Ravindra L.,9998,0,9999,1
1713485521453,CLRE 252,A00,507189,Cuomo; Raphael Eduardo,9998,0,9999,1
1713485522481,CLRE 253,A00,507199,Vaida; Florin,9997,0,9999,2
1713485522481,CLRE 253,B00,507202,Vaida; Florin,9999,0,9999,0
1713485523506,CLRE 259,A00,507211,Patel; Hemal,9996,0,9999,3
1713485524536,CLRE 260,A00,507221,Cuomo; Raphael Eduardo,9999,0,9999,0
1713485525562,CLRE 297,001,507242,Cuomo; Raphael Eduardo,9999,0,9999,0
1713485526585,CSE 191,A00,516875,Minnes Kemp; Mor Mia,9999,0,9999,0
1713485527616,CSS 201S,A01,494383,Staff,35,0,35,0
1713485528643,CSS 202S,A01,494387,Staff,35,0,35,0
1713485529669,EAP 100,A00,516065,Staff,9792,0,9999,207
1713485530694,ECE 45,A01,507414,Staff,38,0,60,22
1713485531720,ECE 100,A01,507416,Baghdadchi; Saharnaz,1,0,20,19
1713485531720,ECE 100,A02,507418,Baghdadchi; Saharnaz,19,0,20,1
1713485532746,ECE 111,A01,507420,Staff,27,0,50,23
1713485533771,ECE 197,001,548057,Sievenpiper; Daniel F.,9998,0,9999,1
1713485534795,EDS 115,A00,507243,Choi; Bailey Miyeon,27,0,28,1
1713485535820,EDS 117,A01,494379,Staff,16,0,25,9
1713485536846,EDS 125,A00,507246,Hopkins; Megan Beth,28,0,30,2
1713485537872,EDS 128A,A01,507264,Fargason; Sharon Gayle,26,0,26,0
1713485538899,EDS 128B,A01,507293,Pappas; Elizabeth,30,0,30,0
1713485539925,EDS 139,A00,507294,Fargason; Sharon Gayle,30,0,30,0
1713485539925,EDS 139,B00,507313,Pappas; Elizabeth,30,0,30,0
1713485540948,EDS 201,A00,507315,Staff,19,0,30,11
1713485541973,EDS 203,A01,507317,Halter; Christopher P.,18,0,30,12
1713485542998,EDS 204R,A01,507319,Halter; Christopher P.,0,1,30,30
1713485542998,EDS 204R,B01,507331,Heinzman; Erica M.,26,0,30,4
1713485544028,EDS 206R,A00,507332,Staff,0,1,30,30
1713485544028,EDS 206R,B00,507343,Staff,27,0,30,3
1713485545052,EDS 250,A00,507344,Hemans; Patricia Ann Benitez,28,0,40,12
1713485546080,EDS 281,A00,507345,Daly; Alan J.,18,0,18,0
1713485547106,EDS 284,A00,507350,Daly; Alan J.,16,0,16,0
1713485548131,EDS 286,A00,507359,Fine; Sarah,18,0,18,0
1713485549156,EDS 289C,A01,507361,Daly; Alan J.,18,0,18,0
1713485550186,EDS 290,A00,507366,Hofstetter; Carolyn,15,0,15,0
1713485551212,LIGM 5A,A00,507421,Fischer-Grunski; Eva K,20,0,20,0
1713485552237,LIGM 5B,A00,507423,Fischer-Grunski; Eva K,20,0,20,0
1713485553265,LIGM 5C,A00,507425,Fischer-Grunski; Eva K,20,0,20,0
1713485554292,LIIT 5AS,A00,507427,Carnelos; Chiara,20,0,20,0
1713485555318,LIIT 5BS,A00,507430,Carnelos; Chiara,20,0,20,0
1713485556345,LIIT 5CS,A00,507432,Carnelos; Chiara,20,0,20,0
1713485557369,LISP 5A,A00,507541,Munoz Sanchez; Alicia,14,0,20,6
1713485558395,LISP 5B,A00,507671,Munoz Sanchez; Alicia,12,0,20,8
1713485559420,LISP 5C,A00,507696,Munoz Sanchez; Alicia,11,0,20,9
1713485560445,MAE 197,001,528363,Boechler; Nicholas Sebastia,9998,0,9999,1
1713485561471,MATH 197,001,523477,Kedlaya; Kiran S.,9999,0,9999,0
1713485561471,MATH 197,002,563811,Zhang; Danna,9998,0,9999,1
1713485562497,MCWP 40R,A00,518780,Staff,17,0,20,3
1713485562497,MCWP 40R,B00,518781,Staff,14,0,20,6
1713485562497,MCWP 40R,C00,518783,Staff,11,0,20,9
1713485563523,MCWP 50R,A00,518791,Staff,8,0,20,12
1713485563523,MCWP 50R,B00,518792,Staff,7,0,20,13
1713485563523,MCWP 50R,C00,518793,Staff,7,0,20,13
1713485563523,MCWP 50R,D00,518794,Staff,0,0,20,20
1713485563523,MCWP 50R,E00,518795,Staff,3,0,20,17
1713485563523,MCWP 50R,F00,518796,Staff,13,0,20,7
1713485563523,MCWP 50R,G00,518797,Staff,12,0,20,8
1713485564549,MMW 12R,A01,514034,Herbst; Matthew,6,0,16,10
1713485564549,MMW 12R,A02,514035,Herbst; Matthew,13,0,16,3
1713485565577,MMW 13R,A01,514037,Staff,0,3,16,16
1713485565577,MMW 13R,A02,514039,Staff,0,3,16,16
1713485567632,SIO 295LS,A00,523233,Staff,15,0,30,15
1713485568657,SIO 295S,A00,523232,Staff,15,0,30,15
1713485569681,SOCI 117,A01,494376,Staff,0,2,5,5
1713485570709,WES 237B,A00,494380,Staff,19,0,20,1
1713485572771,AESE 279B,A00,494370,Wade; Jon P,33,0,33,0
1713485573797,AIP 197,001,627712,Vespa; Emanuel Ignacio,9999,0,9999,0
1713485574821,ANAR 135S,A00,494369,Braswell; Geoffrey E.,0,0,0,0
1713485575848,CAT 124RS,A01,519847,Geibel; William,6,0,20,14
1713485576874,CAT 125RS,A01,515971,Geibel; William,6,0,20,14
1713485577899,CLRE 250,A00,511389,Morris; Sheldon,9996,0,9999,3
1713485578925,CLRE 251,A00,507176,Mehta; Ravindra L.,9996,0,9999,3
1713485578925,CLRE 251,B00,511410,Mehta; Ravindra L.,9998,0,9999,1
1713485579951,CLRE 252,A00,507189,Cuomo; Raphael Eduardo,9998,0,9999,1
1713485580976,CLRE 253,A00,507199,Vaida; Florin,9997,0,9999,2
1713485580976,CLRE 253,B00,507202,Vaida; Florin,9999,0,9999,0
1713485582000,CLRE 259,A00,507211,Patel; Hemal,9996,0,9999,3
1713485583026,CLRE 260,A00,507221,Cuomo; Raphael Eduardo,9999,0,9999,0
1713485584055,CLRE 297,001,507242,Cuomo; Raphael Eduardo,9999,0,9999,0
1713485585085,CSE 191,A00,516875,Minnes Kemp; Mor Mia,9999,0,9999,0
1713485586111,CSS 201S,A01,494383,Staff,35,0,35,0
1713485587143,CSS 202S,A01,494387,Staff,35,0,35,0
1713485588169,EAP 100,A00,516065,Staff,9792,0,9999,207
1713485589196,ECE 45,A01,507414,Staff,38,0,60,22
1713485590311,ECE 100,A01,507416,Baghdadchi; Saharnaz,1,0,20,19
1713485590311,ECE 100,A02,507418,Baghdadchi; Saharnaz,19,0,20,1
1713485591335,ECE 111,A01,507420,Staff,27,0,50,23
1713485592364,ECE 197,001,548057,Sievenpiper; Daniel F.,9998,0,9999,1
1713485593390,EDS 115,A00,507243,Choi; Bailey Miyeon,27,0,28,1
1713485594415,EDS 117,A01,494379,Staff,16,0,25,9
1713485595442,EDS 125,A00,507246,Hopkins; Megan Beth,28,0,30,2
1713485596472,EDS 128A,A01,507264,Fargason; Sharon Gayle,26,0,26,0
1713485597496,EDS 128B,A01,507293,Pappas; Elizabeth,30,0,30,0
1713485598575,EDS 139,A00,507294,Fargason; Sharon Gayle,30,0,30,0
1713485598575,EDS 139,B00,507313,Pappas; Elizabeth,30,0,30,0
1713485599601,EDS 201,A00,507315,Staff,19,0,30,11
1713485600627,EDS 203,A01,507317,Halter; Christopher P.,18,0,30,12
1713485601658,EDS 204R,A01,507319,Halter; Christopher P.,0,1,30,30
1713485601658,EDS 204R,B01,507331,Heinzman; Erica M.,26,0,30,4
1713485602683,EDS 206R,A00,507332,Staff,0,1,30,30
1713485602683,EDS 206R,B00,507343,Staff,27,0,30,3
1713485603709,EDS 250,A00,507344,Hemans; Patricia Ann Benitez,28,0,40,12
1713485604735,EDS 281,A00,507345,Daly; Alan J.,18,0,18,0
1713485605769,EDS 284,A00,507350,Daly; Alan J.,16,0,16,0
1713485606798,EDS 286,A00,507359,Fine; Sarah,18,0,18,0
1713485607830,EDS 289C,A01,507361,Daly; Alan J.,18,0,18,0
1713485608856,EDS 290,A00,507366,Hofstetter; Carolyn,15,0,15,0
1713485609882,LIGM 5A,A00,507421,Fischer-Grunski; Eva K,20,0,20,0
1713485610912,LIGM 5B,A00,507423,Fischer-Grunski; Eva K,20,0,20,0
1713485611937,LIGM 5C,A00,507425,Fischer-Grunski; Eva K,20,0,20,0
1713485612968,LIIT 5AS,A00,507427,Carnelos; Chiara,20,0,20,0
1713485613999,LIIT 5BS,A00,507430,Carnelos; Chiara,20,0,20,0
1713485615029,LIIT 5CS,A00,507432,Carnelos; Chiara,20,0,20,0
1713485616061,LISP 5A,A00,507541,Munoz Sanchez; Alicia,14,0,20,6
1713485617092,LISP 5B,A00,507671,Munoz Sanchez; Alicia,12,0,20,8
1713485618119,LISP 5C,A00,507696,Munoz Sanchez; Alicia,11,0,20,9
1713485619148,MAE 197,001,528363,Boechler; Nicholas Sebastia,9998,0,9999,1
1713485620172,MATH 197,001,523477,Kedlaya; Kiran S.,9999,0,9999,0
1713485620172,MATH 197,002,563811,Zhang; Danna,9998,0,9999,1
1713485621197,MCWP 40R,A00,518780,Staff,17,0,20,3
1713485621197,MCWP 40R,B00,518781,Staff,14,0,20,6
1713485621197,MCWP 40R,C00,518783,Staff,11,0,20,9
1713485622224,MCWP 50R,A00,518791,Staff,8,0,20,12
1713485622224,MCWP 50R,B00,518792,Staff,7,0,20,13
1713485622224,MCWP 50R,C00,518793,Staff,7,0,20,13
1713485622224,MCWP 50R,D00,518794,Staff,0,0,20,20
1713485622224,MCWP 50R,E00,518795,Staff,3,0,20,17
1713485622224,MCWP 50R,F00,518796,Staff,13,0,20,7
1713485622224,MCWP 50R,G00,518797,Staff,12,0,20,8
1713485623251,MMW 12R,A01,514034,Herbst; Matthew,6,0,16,10
1713485623251,MMW 12R,A02,514035,Herbst; Matthew,13,0,16,3
1713485624277,MMW 13R,A01,514037,Staff,0,3,16,16
1713485624277,MMW 13R,A02,514039,Staff,0,3,16,16
1713485626328,SIO 295LS,A00,523233,Staff,15,0,30,15
1713485627353,SIO 295S,A00,523232,Staff,15,0,30,15
1713485628379,SOCI 117,A01,494376,Staff,0,2,5,5
1713485629405,WES 237B,A00,494380,Staff,19,0,20,1
1713485631468,AESE 279B,A00,494370,Wade; Jon P,33,0,33,0
1713485632492,AIP 197,001,627712,Vespa; Emanuel Ignacio,9999,0,9999,0
1713485633518,ANAR 135S,A00,494369,Braswell; Geoffrey E.,0,0,0,0
1713485634545,CAT 124RS,A01,519847,Geibel; William,6,0,20,14
1713485635570,CAT 125RS,A01,515971,Geibel; William,6,0,20,14
1713485636595,CLRE 250,A00,511389,Morris; Sheldon,9996,0,9999,3
1713485637621,CLRE 251,A00,507176,Mehta; Ravindra L.,9996,0,9999,3
1713485637621,CLRE 251,B00,511410,Mehta; Ravindra L.,9998,0,9999,1
1713485638651,CLRE 252,A00,507189,Cuomo; Raphael Eduardo,9998,0,9999,1
1713485639683,CLRE 253,A00,507199,Vaida; Florin,9997,0,9999,2
1713485639683,CLRE 253,B00,507202,Vaida; Florin,9999,0,9999,0
1713485640713,CLRE 259,A00,507211,Patel; Hemal,9996,0,9999,3
1713485641743,CLRE 260,A00,507221,Cuomo; Raphael Eduardo,9999,0,9999,0
1713485642768,CLRE 297,001,507242,Cuomo; Raphael Eduardo,9999,0,9999,0
1713485643797,CSE 191,A00,516875,Minnes Kemp; Mor Mia,9999,0,9999,0
1713485644827,CSS 201S,A01,494383,Staff,35,0,35,0
1713485645854,CSS 202S,A01,494387,Staff,35,0,35,0
1713485646879,EAP 100,A00,516065,Staff,9792,0,9999,207
1713485647910,ECE 45,A01,507414,Staff,38,0,60,22
1713485648935,ECE 100,A01,507416,Baghdadchi; Saharnaz,1,0,20,19
1713485648935,ECE 100,A02,507418,Baghdadchi; Saharnaz,19,0,20,1
1713485649959,ECE 111,A01,507420,Staff,27,0,50,23
1713485650987,ECE 197,001,548057,Sievenpiper; Daniel F.,9998,0,9999,1
1713485652014,EDS 115,A00,507243,Choi; Bailey Miyeon,27,0,28,1
1713485653040,EDS 117,A01,494379,Staff,16,0,25,9
1713485654065,EDS 125,A00,507246,Hopkins; Megan Beth,28,0,30,2
1713485655092,EDS 128A,A01,507264,Fargason; Sharon Gayle,26,0,26,0
1713485656116,EDS 128B,A01,507293,Pappas; Elizabeth,30,0,30,0
1713485657139,EDS 139,A00,507294,Fargason; Sharon Gayle,30,0,30,0
1713485657139,EDS 139,B00,507313,Pappas; Elizabeth,30,0,30,0
1713485658164,EDS 201,A00,507315,Staff,19,0,30,11
1713485659189,EDS 203,A01,507317,Halter; Christopher P.,18,0,30,12
1713485660220,EDS 204R,A01,507319,Halter; Christopher P.,0,1,30,30
1713485660220,EDS 204R,B01,507331,Heinzman; Erica M.,26,0,30,4
1713485661247,EDS 206R,A00,507332,Staff,0,1,30,30
1713485661247,EDS 206R,B00,507343,Staff,27,0,30,3
1713485662276,EDS 250,A00,507344,Hemans; Patricia Ann Benitez,28,0,40,12
1713485663303,EDS 281,A00,507345,Daly; Alan J.,18,0,18,0
1713485664329,EDS 284,A00,507350,Daly; Alan J.,16,0,16,0
1713485665357,EDS 286,A00,507359,Fine; Sarah,18,0,18,0
1713485666382,EDS 289C,A01,507361,Daly; Alan J.,18,0,18,0
1713485667407,EDS 290,A00,507366,Hofstetter; Carolyn,15,0,15,0
1713485668439,LIGM 5A,A00,507421,Fischer-Grunski; Eva K,20,0,20,0
1713485669465,LIGM 5B,A00,507423,Fischer-Grunski; Eva K,20,0,20,0
1713485670494,LIGM 5C,A00,507425,Fischer-Grunski; Eva K,20,0,20,0
1713485671523,LIIT 5AS,A00,507427,Carnelos; Chiara,20,0,20,0
1713485672549,LIIT 5BS,A00,507430,Carnelos; Chiara,20,0,20,0
1713485673580,LIIT 5CS,A00,507432,Carnelos; Chiara,20,0,20,0
1713485674613,LISP 5A,A00,507541,Munoz Sanchez; Alicia,14,0,20,6
1713485675639,LISP 5B,A00,507671,Munoz Sanchez; Alicia,12,0,20,8
1713485676666,LISP 5C,A00,507696,Munoz Sanchez; Alicia,11,0,20,9
1713485677697,MAE 197,001,528363,Boechler; Nicholas Sebastia,9998,0,9999,1
1713485678723,MATH 197,001,523477,Kedlaya; Kiran S.,9999,0,9999,0
1713485678723,MATH 197,002,563811,Zhang; Danna,9998,0,9999,1
1713485679747,MCWP 40R,A00,518780,Staff,17,0,20,3
1713485679747,MCWP 40R,B00,518781,Staff,14,0,20,6
1713485679747,MCWP 40R,C00,518783,Staff,11,0,20,9
1713485680777,MCWP 50R,A00,518791,Staff,8,0,20,12
1713485680777,MCWP 50R,B00,518792,Staff,7,0,20,13
1713485680777,MCWP 50R,C00,518793,Staff,7,0,20,13
1713485680777,MCWP 50R,D00,518794,Staff,0,0,20,20
1713485680777,MCWP 50R,E00,518795,Staff,3,0,20,17
1713485680777,MCWP 50R,F00,518796,Staff,13,0,20,7
1713485680777,MCWP 50R,G00,518797,Staff,12,0,20,8
1713485681802,MMW 12R,A01,514034,Herbst; Matthew,6,0,16,10
1713485681802,MMW 12R,A02,514035,Herbst; Matthew,13,0,16,3
1713485682827,MMW 13R,A01,514037,Staff,0,3,16,16
1713485682827,MMW 13R,A02,514039,Staff,0,3,16,16
1713485684881,SIO 295LS,A00,523233,Staff,15,0,30,15
1713485685911,SIO 295S,A00,523232,Staff,15,0,30,15
1713485686937,SOCI 117,A01,494376,Staff,0,2,5,5
1713485687968,WES 237B,A00,494380,Staff,19,0,20,1
1713485690026,AESE 279B,A00,494370,Wade; Jon P,33,0,33,0
1713485691050,AIP 197,001,627712,Vespa; Emanuel Ignacio,9999,0,9999,0
1713485692080,ANAR 135S,A00,494369,Braswell; Geoffrey E.,0,0,0,0
1713485693105,CAT 124RS,A01,519847,Geibel; William,6,0,20,14
1713485694134,CAT 125RS,A01,515971,Geibel; William,6,0,20,14
1713485695160,CLRE 250,A00,511389,Morris; Sheldon,9996,0,9999,3
1713485696187,CLRE 251,A00,507176,Mehta; Ravindra L.,9996,0,9999,3
1713485696187,CLRE 251,B00,511410,Mehta; Ravindra L.,9998,0,9999,1
1713485697212,CLRE 252,A00,507189,Cuomo; Raphael Eduardo,9998,0,9999,1
1713485698242,CLRE 253,A00,507199,Vaida; Florin,9997,0,9999,2
1713485698242,CLRE 253,B00,507202,Vaida; Florin,9999,0,9999,0
1713485699268,CLRE 259,A00,507211,Patel; Hemal,9996,0,9999,3
1713485700294,CLRE 260,A00,507221,Cuomo; Raphael Eduardo,9999,0,9999,0
1713485701320,CLRE 297,001,507242,Cuomo; Raphael Eduardo,9999,0,9999,0
1713485702402,CSE 191,A00,516875,Minnes Kemp; Mor Mia,9999,0,9999,0
1713485703498,CSS 201S,A01,494383,Staff,35,0,35,0
1713485704521,CSS 202S,A01,494387,Staff,35,0,35,0
1713485705548,EAP 100,A00,516065,Staff,9792,0,9999,207
1713485706573,ECE 45,A01,507414,Staff,38,0,60,22
1713485707598,ECE 100,A01,507416,Baghdadchi; Saharnaz,1,0,20,19
1713485707598,ECE 100,A02,507418,Baghdadchi; Saharnaz,19,0,20,1
1713485708628,ECE 111,A01,507420,Staff,27,0,50,23
1713485709659,ECE 197,001,548057,Sievenpiper; Daniel F.,9998,0,9999,1
1713485710684,EDS 115,A00,507243,Choi; Bailey Miyeon,27,0,28,1
1713485711710,EDS 117,A01,494379,Staff,16,0,25,9
1713485712736,EDS 125,A00,507246,Hopkins; Megan Beth,28,0,30,2
1713485713761,EDS 128A,A01,507264,Fargason; Sharon Gayle,26,0,26,0
1713485714790,EDS 128B,A01,507293,Pappas; Elizabeth,30,0,30,0
1713485715817,EDS 139,A00,507294,Fargason; Sharon Gayle,30,0,30,0
1713485715817,EDS 139,B00,507313,Pappas; Elizabeth,30,0,30,0
1713485716844,EDS 201,A00,507315,Staff,19,0,30,11
1713485717869,EDS 203,A01,507317,Halter; Christopher P.,18,0,30,12
1713485718899,EDS 204R,A01,507319,Halter; Christopher P.,0,1,30,30
1713485718899,EDS 204R,B01,507331,Heinzman; Erica M.,26,0,30,4
1713485719923,EDS 206R,A00,507332,Staff,0,1,30,30
1713485719923,EDS 206R,B00,507343,Staff,27,0,30,3
1713485720953,EDS 250,A00,507344,Hemans; Patricia Ann Benitez,28,0,40,12
1713485721978,EDS 281,A00,507345,Daly; Alan J.,18,0,18,0
1713485723003,EDS 284,A00,507350,Daly; Alan J.,16,0,16,0
1713485724034,EDS 286,A00,507359,Fine; Sarah,18,0,18,0
1713485725061,EDS 289C,A01,507361,Daly; Alan J.,18,0,18,0
1713485726086,EDS 290,A00,507366,Hofstetter; Carolyn,15,0,15,0
1713485727120,LIGM 5A,A00,507421,Fischer-Grunski; Eva K,20,0,20,0
1713485728150,LIGM 5B,A00,507423,Fischer-Grunski; Eva K,20,0,20,0
1713485729180,LIGM 5C,A00,507425,Fischer-Grunski; Eva K,20,0,20,0
1713485730205,LIIT 5AS,A00,507427,Carnelos; Chiara,20,0,20,0
1713485731233,LIIT 5BS,A00,507430,Carnelos; Chiara,20,0,20,0
1713485732259,LIIT 5CS,A00,507432,Carnelos; Chiara,20,0,20,0
1713485733310,LISP 5A,A00,507541,Munoz Sanchez; Alicia,14,0,20,6
1713485734335,LISP 5B,A00,507671,Munoz Sanchez; Alicia,12,0,20,8
1713485735359,LISP 5C,A00,507696,Munoz Sanchez; Alicia,11,0,20,9
1713485736385,MAE 197,001,528363,Boechler; Nicholas Sebastia,9998,0,9999,1
1713485737413,MATH 197,001,523477,Kedlaya; Kiran S.,9999,0,9999,0
1713485737413,MATH 197,002,563811,Zhang; Danna,9998,0,9999,1
1713485738442,MCWP 40R,A00,518780,Staff,17,0,20,3
1713485738442,MCWP 40R,B00,518781,Staff,14,0,20,6
1713485738442,MCWP 40R,C00,518783,Staff,11,0,20,9
1713485739469,MCWP 50R,A00,518791,Staff,8,0,20,12
1713485739469,MCWP 50R,B00,518792,Staff,7,0,20,13
1713485739469,MCWP 50R,C00,518793,Staff,7,0,20,13
1713485739469,MCWP 50R,D00,518794,Staff,0,0,20,20
1713485739469,MCWP 50R,E00,518795,Staff,3,0,20,17
1713485739469,MCWP 50R,F00,518796,Staff,13,0,20,7
1713485739469,MCWP 50R,G00,518797,Staff,12,0,20,8
1713485740493,MMW 12R,A01,514034,Herbst; Matthew,6,0,16,10
1713485740493,MMW 12R,A02,514035,Herbst; Matthew,13,0,16,3
1713485741522,MMW 13R,A01,514037,Staff,0,3,16,16
1713485741522,MMW 13R,A02,514039,Staff,0,3,16,16
1713485743581,SIO 295LS,A00,523233,Staff,15,0,30,15
1713485744606,SIO 295S,A00,523232,Staff,15,0,30,15
1713485745631,SOCI 117,A01,494376,Staff,0,2,5,5
1713485746656,WES 237B,A00,494380,Staff,19,0,20,1
1713485748722,AESE 279B,A00,494370,Wade; Jon P,33,0,33,0
1713485749751,AIP 197,001,627712,Vespa; Emanuel Ignacio,9999,0,9999,0
1713485750777,ANAR 135S,A00,494369,Braswell; Geoffrey E.,0,0,0,0
1713485751805,CAT 124RS,A01,519847,Geibel; William,6,0,20,14
1713485752834,CAT 125RS,A01,515971,Geibel; William,6,0,20,14
1713485753862,CLRE 250,A00,511389,Morris; Sheldon,9996,0,9999,3
1713485754888,CLRE 251,A00,507176,Mehta; Ravindra L.,9996,0,9999,3
1713485754888,CLRE 251,B00,511410,Mehta; Ravindra L.,9998,0,9999,1
1713485755914,CLRE 252,A00,507189,Cuomo; Raphael Eduardo,9998,0,9999,1
1713485756938,CLRE 253,A00,507199,Vaida; Florin,9997,0,9999,2
1713485756938,CLRE 253,B00,507202,Vaida; Florin,9999,0,9999,0
1713485757962,CLRE 259,A00,507211,Patel; Hemal,9996,0,9999,3
1713485758987,CLRE 260,A00,507221,Cuomo; Raphael Eduardo,9999,0,9999,0
1713485760014,CLRE 297,001,507242,Cuomo; Raphael Eduardo,9999,0,9999,0
1713485761038,CSE 191,A00,516875,Minnes Kemp; Mor Mia,9999,0,9999,0
1713485762065,CSS 201S,A01,494383,Staff,35,0,35,0
1713485763091,CSS 202S,A01,494387,Staff,35,0,35,0
1713485764117,EAP 100,A00,516065,Staff,9792,0,9999,207
1713485765143,ECE 45,A01,507414,Staff,38,0,60,22
1713485766168,ECE 100,A01,507416,Baghdadchi; Saharnaz,1,0,20,19
1713485766168,ECE 100,A02,507418,Baghdadchi; Saharnaz,19,0,20,1
1713485767194,ECE 111,A01,507420,Staff,27,0,50,23
1713485768223,ECE 197,001,548057,Sievenpiper; Daniel F.,9998,0,9999,1
1713485769247,EDS 115,A00,507243,Choi; Bailey Miyeon,27,0,28,1
1713485770276,EDS 117,A01,494379,Staff,16,0,25,9
1713485771303,EDS 125,A00,507246,Hopkins; Megan Beth,28,0,30,2
1713485772329,EDS 128A,A01,507264,Fargason; Sharon Gayle,26,0,26,0
1713485773355,EDS 128B,A01,507293,Pappas; Elizabeth,30,0,30,0
1713485774383,EDS 139,A00,507294,Fargason; Sharon Gayle,30,0,30,0
1713485774383,EDS 139,B00,507313,Pappas; Elizabeth,30,0,30,0
1713485775410,EDS 201,A00,507315,Staff,19,0,30,11
1713485776442,EDS 203,A01,507317,Halter; Christopher P.,18,0,30,12
1713485777468,EDS 204R,A01,507319,Halter; Christopher P.,0,1,30,30
1713485777468,EDS 204R,B01,507331,Heinzman; Erica M.,26,0,30,4
1713485778497,EDS 206R,A00,507332,Staff,0,1,30,30
1713485778497,EDS 206R,B00,507343,Staff,27,0,30,3
1713485779523,EDS 250,A00,507344,Hemans; Patricia Ann Benitez,28,0,40,12
1713485780548,EDS 281,A00,507345,Daly; Alan J.,18,0,18,0
1713485781578,EDS 284,A00,507350,Daly; Alan J.,16,0,16,0
1713485782607,EDS 286,A00,507359,Fine; Sarah,18,0,18,0
1713485783632,EDS 289C,A01,507361,Daly; Alan J.,18,0,18,0
1713485784661,EDS 290,A00,507366,Hofstetter; Carolyn,15,0,15,0
1713485785687,LIGM 5A,A00,507421,Fischer-Grunski; Eva K,20,0,20,0
1713485786712,LIGM 5B,A00,507423,Fischer-Grunski; Eva K,20,0,20,0
1713485787738,LIGM 5C,A00,507425,Fischer-Grunski; Eva K,20,0,20,0
1713485788768,LIIT 5AS,A00,507427,Carnelos; Chiara,20,0,20,0
1713485789799,LIIT 5BS,A00,507430,Carnelos; Chiara,20,0,20,0
1713485790824,LIIT 5CS,A00,507432,Carnelos; Chiara,20,0,20,0
1713485791848,LISP 5A,A00,507541,Munoz Sanchez; Alicia,14,0,20,6
1713485792877,LISP 5B,A00,507671,Munoz Sanchez; Alicia,12,0,20,8
1713485793907,LISP 5C,A00,507696,Munoz Sanchez; Alicia,11,0,20,9
1713485794932,MAE 197,001,528363,Boechler; Nicholas Sebastia,9998,0,9999,1
1713485795962,MATH 197,001,523477,Kedlaya; Kiran S.,9999,0,9999,0
1713485795962,MATH 197,002,563811,Zhang; Danna,9998,0,9999,1
1713485796992,MCWP 40R,A00,518780,Staff,17,0,20,3
1713485796992,MCWP 40R,B00,518781,Staff,14,0,20,6
1713485796992,MCWP 40R,C00,518783,Staff,11,0,20,9
1713485798019,MCWP 50R,A00,518791,Staff,8,0,20,12
1713485798019,MCWP 50R,B00,518792,Staff,7,0,20,13
1713485798019,MCWP 50R,C00,518793,Staff,7,0,20,13
1713485798019,MCWP 50R,D00,518794,Staff,0,0,20,20
1713485798019,MCWP 50R,E00,518795,Staff,3,0,20,17
1713485798019,MCWP 50R,F00,518796,Staff,13,0,20,7
1713485798019,MCWP 50R,G00,518797,Staff,12,0,20,8
1713485799045,MMW 12R,A01,514034,Herbst; Matthew,6,0,16,10
1713485799045,MMW 12R,A02,514035,Herbst; Matthew,13,0,16,3
1713485800071,MMW 13R,A01,514037,Staff,0,3,16,16
1713485800071,MMW 13R,A02,514039,Staff,0,3,16,16
1713485802130,SIO 295LS,A00,523233,Staff,15,0,30,15
1713485803160,SIO 295S,A00,523232,Staff,15,0,30,15
1713485804184,SOCI 117,A01,494376,Staff,0,2,5,5
1713485805210,WES 237B,A00,494380,Staff,19,0,20,1
1713485807341,AESE 279B,A00,494370,Wade; Jon P,33,0,33,0
1713485808370,AIP 197,001,627712,Vespa; Emanuel Ignacio,9999,0,9999,0
1713485809394,ANAR 135S,A00,494369,Braswell; Geoffrey E.,0,0,0,0
1713485810421,CAT 124RS,A01,519847,Geibel; William,6,0,20,14
1713485811448,CAT 125RS,A01,515971,Geibel; William,6,0,20,14
1713485812485,CLRE 250,A00,511389,Morris; Sheldon,9996,0,9999,3
1713485813517,CLRE 251,A00,507176,Mehta; Ravindra L.,9996,0,9999,3
1713485813517,CLRE 251,B00,511410,Mehta; Ravindra L.,9998,0,9999,1
1713485814550,CLRE 252,A00,507189,Cuomo; Raphael Eduardo,9998,0,9999,1
1713485815575,CLRE 253,A00,507199,Vaida; Florin,9997,0,9999,2
1713485815575,CLRE 253,B00,507202,Vaida; Florin,9999,0,9999,0
1713485816601,CLRE 259,A00,507211,Patel; Hemal,9996,0,9999,3
1713485817625,CLRE 260,A00,507221,Cuomo; Raphael Eduardo,9999,0,9999,0
1713485818650,CLRE 297,001,507242,Cuomo; Raphael Eduardo,9999,0,9999,0
1713485819678,CSE 191,A00,516875,Minnes Kemp; Mor Mia,9999,0,9999,0
1713485820705,CSS 201S,A01,494383,Staff,35,0,35,0
1713485821734,CSS 202S,A01,494387,Staff,35,0,35,0
1713485822762,EAP 100,A00,516065,Staff,9792,0,9999,207
1713485823789,ECE 45,A01,507414,Staff,38,0,60,22
1713485824815,ECE 100,A01,507416,Baghdadchi; Saharnaz,1,0,20,19
1713485824815,ECE 100,A02,507418,Baghdadchi; Saharnaz,19,0,20,1
1713485825840,ECE 111,A01,507420,Staff,27,0,50,23
1713485826865,ECE 197,001,548057,Sievenpiper; Daniel F.,9998,0,9999,1
1713485827890,EDS 115,A00,507243,Choi; Bailey Miyeon,27,0,28,1
1713485828917,EDS 117,A01,494379,Staff,16,0,25,9
1713485829942,EDS 125,A00,507246,Hopkins; Megan Beth,28,0,30,2
1713485830968,EDS 128A,A01,507264,Fargason; Sharon Gayle,26,0,26,0
1713485831994,EDS 128B,A01,507293,Pappas; Elizabeth,30,0,30,0
1713485833023,EDS 139,A00,507294,Fargason; Sharon Gayle,30,0,30,0
1713485833023,EDS 139,B00,507313,Pappas; Elizabeth,30,0,30,0
1713485834049,EDS 201,A00,507315,Staff,19,0,30,11
1713485835073,EDS 203,A01,507317,Halter; Christopher P.,18,0,30,12
1713485836098,EDS 204R,A01,507319,Halter; Christopher P.,0,1,30,30
1713485836098,EDS 204R,B01,507331,Heinzman; Erica M.,26,0,30,4
1713485837125,EDS 206R,A00,507332,Staff,0,1,30,30
1713485837125,EDS 206R,B00,507343,Staff,27,0,30,3
1713485838153,EDS 250,A00,507344,Hemans; Patricia Ann Benitez,28,0,40,12
1713485839179,EDS 281,A00,507345,Daly; Alan J.,18,0,18,0
1713485840206,EDS 284,A00,507350,Daly; Alan J.,16,0,16,0
1713485841234,EDS 286,A00,507359,Fine; Sarah,18,0,18,0
1713485842259,EDS 289C,A01,507361,Daly; Alan J.,18,0,18,0
1713485843284,EDS 290,A00,507366,Hofstetter; Carolyn,15,0,15,0
1713485844308,LIGM 5A,A00,507421,Fischer-Grunski; Eva K,20,0,20,0
1713485845333,LIGM 5B,A00,507423,Fischer-Grunski; Eva K,20,0,20,0
1713485846359,LIGM 5C,A00,507425,Fischer-Grunski; Eva K,20,0,20,0
1713485847387,LIIT 5AS,A00,507427,Carnelos; Chiara,20,0,20,0
1713485848414,LIIT 5BS,A00,507430,Carnelos; Chiara,20,0,20,0
1713485849440,LIIT 5CS,A00,507432,Carnelos; Chiara,20,0,20,0
1713485850466,LISP 5A,A00,507541,Munoz Sanchez; Alicia,14,0,20,6
1713485851491,LISP 5B,A00,507671,Munoz Sanchez; Alicia,12,0,20,8
1713485852520,LISP 5C,A00,507696,Munoz Sanchez; Alicia,11,0,20,9
1713485853547,MAE 197,001,528363,Boechler; Nicholas Sebastia,9998,0,9999,1
1713485854573,MATH 197,001,523477,Kedlaya; Kiran S.,9999,0,9999,0
1713485854573,MATH 197,002,563811,Zhang; Danna,9998,0,9999,1
1713485855598,MCWP 40R,A00,518780,Staff,17,0,20,3
1713485855598,MCWP 40R,B00,518781,Staff,14,0,20,6
1713485855598,MCWP 40R,C00,518783,Staff,11,0,20,9
1713485856623,MCWP 50R,A00,518791,Staff,8,0,20,12
1713485856623,MCWP 50R,B00,518792,Staff,7,0,20,13
1713485856623,MCWP 50R,C00,518793,Staff,7,0,20,13
1713485856623,MCWP 50R,D00,518794,Staff,0,0,20,20
1713485856623,MCWP 50R,E00,518795,Staff,3,0,20,17
1713485856623,MCWP 50R,F00,518796,Staff,13,0,20,7
1713485856623,MCWP 50R,G00,518797,Staff,12,0,20,8
1713485857649,MMW 12R,A01,514034,Herbst; Matthew,6,0,16,10
1713485857649,MMW 12R,A02,514035,Herbst; Matthew,13,0,16,3
1713485858673,MMW 13R,A01,514037,Staff,0,3,16,16
1713485858673,MMW 13R,A02,514039,Staff,0,3,16,16
1713485860723,SIO 295LS,A00,523233,Staff,15,0,30,15
1713485861748,SIO 295S,A00,523232,Staff,15,0,30,15
1713485862774,SOCI 117,A01,494376,Staff,0,2,5,5
1713485863798,WES 237B,A00,494380,Staff,19,0,20,1
1713485865856,AESE 279B,A00,494370,Wade; Jon P,33,0,33,0
1713485866879,AIP 197,001,627712,Vespa; Emanuel Ignacio,9999,0,9999,0
1713485867908,ANAR 135S,A00,494369,Braswell; Geoffrey E.,0,0,0,0
1713485868935,CAT 124RS,A01,519847,Geibel; William,6,0,20,14
1713485869959,CAT 125RS,A01,515971,Geibel; William,6,0,20,14
1713485870986,CLRE 250,A00,511389,Morris; Sheldon,9996,0,9999,3
1713485872012,CLRE 251,A00,507176,Mehta; Ravindra L.,9996,0,9999,3
1713485872012,CLRE 251,B00,511410,Mehta; Ravindra L.,9998,0,9999,1
1713485873040,CLRE 252,A00,507189,Cuomo; Raphael Eduardo,9998,0,9999,1
1713485874065,CLRE 253,A00,507199,Vaida; Florin,9997,0,9999,2
1713485874065,CLRE 253,B00,507202,Vaida; Florin,9999,0,9999,0
1713485875090,CLRE 259,A00,507211,Patel; Hemal,9996,0,9999,3
1713485876118,CLRE 260,A00,507221,Cuomo; Raphael Eduardo,9999,0,9999,0
1713485877144,CLRE 297,001,507242,Cuomo; Raphael Eduardo,9999,0,9999,0
1713485878169,CSE 191,A00,516875,Minnes Kemp; Mor Mia,9999,0,9999,0
1713485879194,CSS 201S,A01,494383,Staff,35,0,35,0
1713485880220,CSS 202S,A01,494387,Staff,35,0,35,0
1713485881246,EAP 100,A00,516065,Staff,9792,0,9999,207
1713485882271,ECE 45,A01,507414,Staff,38,0,60,22
1713485883301,ECE 100,A01,507416,Baghdadchi; Saharnaz,1,0,20,19
1713485883301,ECE 100,A02,507418,Baghdadchi; Saharnaz,19,0,20,1
1713485884328,ECE 111,A01,507420,Staff,27,0,50,23
1713485885353,ECE 197,001,548057,Sievenpiper; Daniel F.,9998,0,9999,1
1713485886378,EDS 115,A00,507243,Choi; Bailey Miyeon,27,0,28,1
1713485887407,EDS 117,A01,494379,Staff,16,0,25,9
1713485888434,EDS 125,A00,507246,Hopkins; Megan Beth,28,0,30,2
1713485889459,EDS 128A,A01,507264,Fargason; Sharon Gayle,26,0,26,0
1713485890485,EDS 128B,A01,507293,Pappas; Elizabeth,30,0,30,0
1713485891513,EDS 139,A00,507294,Fargason; Sharon Gayle,30,0,30,0
1713485891513,EDS 139,B00,507313,Pappas; Elizabeth,30,0,30,0
1713485892539,EDS 201,A00,507315,Staff,19,0,30,11
1713485893564,EDS 203,A01,507317,Halter; Christopher P.,18,0,30,12
1713485894593,EDS 204R,A01,507319,Halter; Christopher P.,0,1,30,30
1713485894593,EDS 204R,B01,507331,Heinzman; Erica M.,26,0,30,4
1713485895618,EDS 206R,A00,507332,Staff,0,1,30,30
1713485895618,EDS 206R,B00,507343,Staff,27,0,30,3
1713485896647,EDS 250,A00,507344,Hemans; Patricia Ann Benitez,28,0,40,12
1713485897674,EDS 281,A00,507345,Daly; Alan J.,18,0,18,0
1713485898699,EDS 284,A00,507350,Daly; Alan J.,16,0,16,0
1713485899723,EDS 286,A00,507359,Fine; Sarah,18,0,18,0
1713485900749,EDS 289C,A01,507361,Daly; Alan J.,18,0,18,0
1713485901774,EDS 290,A00,507366,Hofstetter; Carolyn,15,0,15,0
1713485902800,LIGM 5A,A00,507421,Fischer-Grunski; Eva K,20,0,20,0
1713485903824,LIGM 5B,A00,507423,Fischer-Grunski; Eva K,20,0,20,0
1713485904853,LIGM 5C,A00,507425,Fischer-Grunski; Eva K,20,0,20,0
1713485905877,LIIT 5AS,A00,507427,Carnelos; Chiara,20,0,20,0
1713485906905,LIIT 5BS,A00,507430,Carnelos; Chiara,20,0,20,0
1713485907933,LIIT 5CS,A00,507432,Carnelos; Chiara,20,0,20,0
1713485908962,LISP 5A,A00,507541,Munoz Sanchez; Alicia,14,0,20,6
1713485910048,LISP 5B,A00,507671,Munoz Sanchez; Alicia,12,0,20,8
1713485911077,LISP 5C,A00,507696,Munoz Sanchez; Alicia,11,0,20,9
1713485912103,MAE 197,001,528363,Boechler; Nicholas Sebastia,9998,0,9999,1
1713485913129,MATH 197,001,523477,Kedlaya; Kiran S.,9999,0,9999,0
1713485913129,MATH 197,002,563811,Zhang; Danna,9998,0,9999,1
1713485914155,MCWP 40R,A00,518780,Staff,17,0,20,3
1713485914155,MCWP 40R,B00,518781,Staff,14,0,20,6
1713485914155,MCWP 40R,C00,518783,Staff,11,0,20,9
1713485915186,MCWP 50R,A00,518791,Staff,8,0,20,12
1713485915186,MCWP 50R,B00,518792,Staff,7,0,20,13
1713485915186,MCWP 50R,C00,518793,Staff,7,0,20,13
1713485915186,MCWP 50R,D00,518794,Staff,0,0,20,20
1713485915186,MCWP 50R,E00,518795,Staff,3,0,20,17
1713485915186,MCWP 50R,F00,518796,Staff,13,0,20,7
1713485915186,MCWP 50R,G00,518797,Staff,12,0,20,8
1713485916214,MMW 12R,A01,514034,Herbst; Matthew,6,0,16,10
1713485916214,MMW 12R,A02,514035,Herbst; Matthew,13,0,16,3
1713485917238,MMW 13R,A01,514037,Staff,0,3,16,16
1713485917238,MMW 13R,A02,514039,Staff,0,3,16,16
1713485919289,SIO 295LS,A00,523233,Staff,15,0,30,15
1713485920315,SIO 295S,A00,523232,Staff,15,0,30,15
1713485921345,SOCI 117,A01,494376,Staff,0,2,5,5
1713485922373,WES 237B,A00,494380,Staff,19,0,20,1
1713485924433,AESE 279B,A00,494370,Wade; Jon P,33,0,33,0
1713485925459,AIP 197,001,627712,Vespa; Emanuel Ignacio,9999,0,9999,0
1713485926483,ANAR 135S,A00,494369,Braswell; Geoffrey E.,0,0,0,0
1713485927511,CAT 124RS,A01,519847,Geibel; William,6,0,20,14
1713485928540,CAT 125RS,A01,515971,Geibel; William,6,0,20,14
1713485929569,CLRE 250,A00,511389,Morris; Sheldon,9996,0,9999,3
1713485930594,CLRE 251,A00,507176,Mehta; Ravindra L.,9996,0,9999,3
1713485930594,CLRE 251,B00,511410,Mehta; Ravindra L.,9998,0,9999,1
1713485931619,CLRE 252,A00,507189,Cuomo; Raphael Eduardo,9998,0,9999,1
1713485932642,CLRE 253,A00,507199,Vaida; Florin,9997,0,9999,2
1713485932642,CLRE 253,B00,507202,Vaida; Florin,9999,0,9999,0
1713485933668,CLRE 259,A00,507211,Patel; Hemal,9996,0,9999,3
1713485934696,CLRE 260,A00,507221,Cuomo; Raphael Eduardo,9999,0,9999,0
1713485935720,CLRE 297,001,507242,Cuomo; Raphael Eduardo,9999,0,9999,0
1713485936749,CSE 191,A00,516875,Minnes Kemp; Mor Mia,9999,0,9999,0
1713485937776,CSS 201S,A01,494383,Staff,35,0,35,0
1713485938805,CSS 202S,A01,494387,Staff,35,0,35,0
1713485939833,EAP 100,A00,516065,Staff,9792,0,9999,207
1713485940859,ECE 45,A01,507414,Staff,38,0,60,22
1713485941884,ECE 100,A01,507416,Baghdadchi; Saharnaz,1,0,20,19
1713485941884,ECE 100,A02,507418,Baghdadchi; Saharnaz,19,0,20,1
1713485942909,ECE 111,A01,507420,Staff,27,0,50,23
1713485943934,ECE 197,001,548057,Sievenpiper; Daniel F.,9998,0,9999,1
1713485944963,EDS 115,A00,507243,Choi; Bailey Miyeon,27,0,28,1
1713485945990,EDS 117,A01,494379,Staff,16,0,25,9
1713485947017,EDS 125,A00,507246,Hopkins; Megan Beth,28,0,30,2
1713485948046,EDS 128A,A01,507264,Fargason; Sharon Gayle,26,0,26,0
1713485949075,EDS 128B,A01,507293,Pappas; Elizabeth,30,0,30,0
1713485950100,EDS 139,A00,507294,Fargason; Sharon Gayle,30,0,30,0
1713485950100,EDS 139,B00,507313,Pappas; Elizabeth,30,0,30,0
1713485951128,EDS 201,A00,507315,Staff,19,0,30,11
1713485952152,EDS 203,A01,507317,Halter; Christopher P.,18,0,30,12
1713485953177,EDS 204R,A01,507319,Halter; Christopher P.,0,1,30,30
1713485953177,EDS 204R,B01,507331,Heinzman; Erica M.,26,0,30,4
1713485954201,EDS 206R,A00,507332,Staff,0,1,30,30
1713485954201,EDS 206R,B00,507343,Staff,27,0,30,3
1713485955229,EDS 250,A00,507344,Hemans; Patricia Ann Benitez,28,0,40,12
1713485956255,EDS 281,A00,507345,Daly; Alan J.,18,0,18,0
1713485957279,EDS 284,A00,507350,Daly; Alan J.,16,0,16,0
1713485958308,EDS 286,A00,507359,Fine; Sarah,18,0,18,0
1713485959331,EDS 289C,A01,507361,Daly; Alan J.,18,0,18,0
1713485960356,EDS 290,A00,507366,Hofstetter; Carolyn,15,0,15,0
1713485961381,LIGM 5A,A00,507421,Fischer-Grunski; Eva K,20,0,20,0
1713485962408,LIGM 5B,A00,507423,Fischer-Grunski; Eva K,20,0,20,0
1713485963452,LIGM 5C,A00,507425,Fischer-Grunski; Eva K,20,0,20,0
1713485964477,LIIT 5AS,A00,507427,Carnelos; Chiara,20,0,20,0
1713485965502,LIIT 5BS,A00,507430,Carnelos; Chiara,20,0,20,0
1713485966527,LIIT 5CS,A00,507432,Carnelos; Chiara,20,0,20,0
1713485967555,LISP 5A,A00,507541,Munoz Sanchez; Alicia,14,0,20,6
1713485968579,LISP 5B,A00,507671,Munoz Sanchez; Alicia,12,0,20,8
1713485969609,LISP 5C,A00,507696,Munoz Sanchez; Alicia,11,0,20,9
1713485970634,MAE 197,001,528363,Boechler; Nicholas Sebastia,9998,0,9999,1
1713485971658,MATH 197,001,523477,Kedlaya; Kiran S.,9999,0,9999,0
1713485971658,MATH 197,002,563811,Zhang; Danna,9998,0,9999,1
1713485972693,MCWP 40R,A00,518780,Staff,17,0,20,3
1713485972693,MCWP 40R,B00,518781,Staff,14,0,20,6
1713485972693,MCWP 40R,C00,518783,Staff,11,0,20,9
1713485973721,MCWP 50R,A00,518791,Staff,7,0,20,13
1713485973721,MCWP 50R,B00,518792,Staff,7,0,20,13
1713485973721,MCWP 50R,C00,518793,Staff,7,0,20,13
1713485973721,MCWP 50R,D00,518794,Staff,0,0,20,20
1713485973721,MCWP 50R,E00,518795,Staff,3,0,20,17
1713485973721,MCWP 50R,F00,518796,Staff,13,0,20,7
1713485973721,MCWP 50R,G00,518797,Staff,12,0,20,8
1713485974745,MMW 12R,A01,514034,Herbst; Matthew,6,0,16,10
1713485974745,MMW 12R,A02,514035,Herbst; Matthew,13,0,16,3
1713485975769,MMW 13R,A01,514037,Staff,0,3,16,16
1713485975769,MMW 13R,A02,514039,Staff,0,3,16,16
1713485977827,SIO 295LS,A00,523233,Staff,15,0,30,15
1713485978855,SIO 295S,A00,523232,Staff,15,0,30,15
1713485979881,SOCI 117,A01,494376,Staff,0,2,5,5
1713485980904,WES 237B,A00,494380,Staff,19,0,20,1
1713485982974,AESE 279B,A00,494370,Wade; Jon P,33,0,33,0
1713485984000,AIP 197,001,627712,Vespa; Emanuel Ignacio,9999,0,9999,0
1713485985026,ANAR 135S,A00,494369,Braswell; Geoffrey E.,0,0,0,0
1713485986053,CAT 124RS,A01,519847,Geibel; William,6,0,20,14
1713485987078,CAT 125RS,A01,515971,Geibel; William,6,0,20,14
1713485988102,CLRE 250,A00,511389,Morris; Sheldon,9996,0,9999,3
1713485989127,CLRE 251,A00,507176,Mehta; Ravindra L.,9996,0,9999,3
1713485989127,CLRE 251,B00,511410,Mehta; Ravindra L.,9998,0,9999,1
1713485990152,CLRE 252,A00,507189,Cuomo; Raphael Eduardo,9998,0,9999,1
1713485991177,CLRE 253,A00,507199,Vaida; Florin,9997,0,9999,2
1713485991177,CLRE 253,B00,507202,Vaida; Florin,9999,0,9999,0
1713485992203,CLRE 259,A00,507211,Patel; Hemal,9996,0,9999,3
1713485993228,CLRE 260,A00,507221,Cuomo; Raphael Eduardo,9999,0,9999,0
1713485994256,CLRE 297,001,507242,Cuomo; Raphael Eduardo,9999,0,9999,0
1713485995283,CSE 191,A00,516875,Minnes Kemp; Mor Mia,9999,0,9999,0
1713485996313,CSS 201S,A01,494383,Staff,35,0,35,0
1713485997339,CSS 202S,A01,494387,Staff,35,0,35,0
1713485998366,EAP 100,A00,516065,Staff,9792,0,9999,207
1713485999390,ECE 45,A01,507414,Staff,38,0,60,22
1713486000430,ECE 100,A01,507416,Baghdadchi; Saharnaz,1,0,20,19
1713486000430,ECE 100,A02,507418,Baghdadchi; Saharnaz,19,0,20,1
1713486001536,ECE 111,A01,507420,Staff,27,0,50,23
1713486002564,ECE 197,001,548057,Sievenpiper; Daniel F.,9998,0,9999,1
1713486003591,EDS 115,A00,507243,Choi; Bailey Miyeon,27,0,28,1
1713486004617,EDS 117,A01,494379,Staff,16,0,25,9
1713486005646,EDS 125,A00,507246,Hopkins; Megan Beth,28,0,30,2
1713486006674,EDS 128A,A01,507264,Fargason; Sharon Gayle,26,0,26,0
1713486007702,EDS 128B,A01,507293,Pappas; Elizabeth,30,0,30,0
1713486008730,EDS 139,A00,507294,Fargason; Sharon Gayle,30,0,30,0
1713486008730,EDS 139,B00,507313,Pappas; Elizabeth,30,0,30,0
1713486009757,EDS 201,A00,507315,Staff,19,0,30,11
1713486010785,EDS 203,A01,507317,Halter; Christopher P.,18,0,30,12
1713486011809,EDS 204R,A01,507319,Halter; Christopher P.,0,1,30,30
1713486011809,EDS 204R,B01,507331,Heinzman; Erica M.,26,0,30,4
1713486012835,EDS 206R,A00,507332,Staff,0,1,30,30
1713486012835,EDS 206R,B00,507343,Staff,27,0,30,3
1713486013917,EDS 250,A00,507344,Hemans; Patricia Ann Benitez,28,0,40,12
1713486014947,EDS 281,A00,507345,Daly; Alan J.,18,0,18,0
1713486015976,EDS 284,A00,507350,Daly; Alan J.,16,0,16,0
1713486017000,EDS 286,A00,507359,Fine; Sarah,18,0,18,0
1713486018025,EDS 289C,A01,507361,Daly; Alan J.,18,0,18,0
1713486019056,EDS 290,A00,507366,Hofstetter; Carolyn,15,0,15,0
1713486020082,LIGM 5A,A00,507421,Fischer-Grunski; Eva K,20,0,20,0
1713486021107,LIGM 5B,A00,507423,Fischer-Grunski; Eva K,20,0,20,0
1713486022133,LIGM 5C,A00,507425,Fischer-Grunski; Eva K,20,0,20,0
1713486023160,LIIT 5AS,A00,507427,Carnelos; Chiara,20,0,20,0
1713486024190,LIIT 5BS,A00,507430,Carnelos; Chiara,20,0,20,0
1713486025215,LIIT 5CS,A00,507432,Carnelos; Chiara,20,0,20,0
1713486026240,LISP 5A,A00,507541,Munoz Sanchez; Alicia,14,0,20,6
1713486027265,LISP 5B,A00,507671,Munoz Sanchez; Alicia,12,0,20,8
1713486028294,LISP 5C,A00,507696,Munoz Sanchez; Alicia,11,0,20,9
1713486029319,MAE 197,001,528363,Boechler; Nicholas Sebastia,9998,0,9999,1
1713486030345,MATH 197,001,523477,Kedlaya; Kiran S.,9999,0,9999,0
1713486030345,MATH 197,002,563811,Zhang; Danna,9998,0,9999,1
1713486031375,MCWP 40R,A00,518780,Staff,17,0,20,3
1713486031375,MCWP 40R,B00,518781,Staff,14,0,20,6
1713486031375,MCWP 40R,C00,518783,Staff,11,0,20,9
1713486032401,MCWP 50R,A00,518791,Staff,7,0,20,13
1713486032401,MCWP 50R,B00,518792,Staff,7,0,20,13
1713486032401,MCWP 50R,C00,518793,Staff,7,0,20,13
1713486032401,MCWP 50R,D00,518794,Staff,0,0,20,20
1713486032401,MCWP 50R,E00,518795,Staff,3,0,20,17
1713486032401,MCWP 50R,F00,518796,Staff,13,0,20,7
1713486032401,MCWP 50R,G00,518797,Staff,12,0,20,8
1713486033426,MMW 12R,A01,514034,Herbst; Matthew,6,0,16,10
1713486033426,MMW 12R,A02,514035,Herbst; Matthew,13,0,16,3
1713486034453,MMW 13R,A01,514037,Staff,0,3,16,16
1713486034453,MMW 13R,A02,514039,Staff,0,3,16,16
1713486036510,SIO 295LS,A00,523233,Staff,15,0,30,15
1713486037533,SIO 295S,A00,523232,Staff,15,0,30,15
1713486038563,SOCI 117,A01,494376,Staff,0,2,5,5
1713486039592,WES 237B,A00,494380,Staff,19,0,20,1
1713486041661,AESE 279B,A00,494370,Wade; Jon P,33,0,33,0
1713486042687,AIP 197,001,627712,Vespa; Emanuel Ignacio,9999,0,9999,0
1713486043713,ANAR 135S,A00,494369,Braswell; Geoffrey E.,0,0,0,0
1713486044738,CAT 124RS,A01,519847,Geibel; William,6,0,20,14
1713486045766,CAT 125RS,A01,515971,Geibel; William,6,0,20,14
1713486046796,CLRE 250,A00,511389,Morris; Sheldon,9996,0,9999,3
1713486047823,CLRE 251,A00,507176,Mehta; Ravindra L.,9996,0,9999,3
1713486047823,CLRE 251,B00,511410,Mehta; Ravindra L.,9998,0,9999,1
1713486048848,CLRE 252,A00,507189,Cuomo; Raphael Eduardo,9998,0,9999,1
1713486049879,CLRE 253,A00,507199,Vaida; Florin,9997,0,9999,2
1713486049879,CLRE 253,B00,507202,Vaida; Florin,9999,0,9999,0
1713486050908,CLRE 259,A00,507211,Patel; Hemal,9996,0,9999,3
1713486051936,CLRE 260,A00,507221,Cuomo; Raphael Eduardo,9999,0,9999,0
1713486052963,CLRE 297,001,507242,Cuomo; Raphael Eduardo,9999,0,9999,0
1713486053988,CSE 191,A00,516875,Minnes Kemp; Mor Mia,9999,0,9999,0
1713486055018,CSS 201S,A01,494383,Staff,35,0,35,0
1713486056055,CSS 202S,A01,494387,Staff,35,0,35,0
1713486057082,EAP 100,A00,516065,Staff,9792,0,9999,207
1713486058106,ECE 45,A01,507414,Staff,38,0,60,22
1713486059132,ECE 100,A01,507416,Baghdadchi; Saharnaz,1,0,20,19
1713486059132,ECE 100,A02,507418,Baghdadchi; Saharnaz,19,0,20,1
1713486060157,ECE 111,A01,507420,Staff,27,0,50,23
1713486061183,ECE 197,001,548057,Sievenpiper; Daniel F.,9998,0,9999,1
1713486062212,EDS 115,A00,507243,Choi; Bailey Miyeon,27,0,28,1
1713486063237,EDS 117,A01,494379,Staff,16,0,25,9
1713486064262,EDS 125,A00,507246,Hopkins; Megan Beth,28,0,30,2
1713486065298,EDS 128A,A01,507264,Fargason; Sharon Gayle,26,0,26,0
1713486066328,EDS 128B,A01,507293,Pappas; Elizabeth,30,0,30,0
1713486067355,EDS 139,A00,507294,Fargason; Sharon Gayle,30,0,30,0
1713486067355,EDS 139,B00,507313,Pappas; Elizabeth,30,0,30,0
1713486068380,EDS 201,A00,507315,Staff,19,0,30,11
1713486069410,EDS 203,A01,507317,Halter; Christopher P.,18,0,30,12
1713486070437,EDS 204R,A01,507319,Halter; Christopher P.,0,1,30,30
1713486070437,EDS 204R,B01,507331,Heinzman; Erica M.,26,0,30,4
1713486071464,EDS 206R,A00,507332,Staff,0,1,30,30
1713486071464,EDS 206R,B00,507343,Staff,27,0,30,3
1713486072489,EDS 250,A00,507344,Hemans; Patricia Ann Benitez,28,0,40,12
1713486073516,EDS 281,A00,507345,Daly; Alan J.,18,0,18,0
1713486074543,EDS 284,A00,507350,Daly; Alan J.,16,0,16,0
1713486075570,EDS 286,A00,507359,Fine; Sarah,18,0,18,0
1713486076593,EDS 289C,A01,507361,Daly; Alan J.,18,0,18,0
1713486077621,EDS 290,A00,507366,Hofstetter; Carolyn,15,0,15,0
1713486078651,LIGM 5A,A00,507421,Fischer-Grunski; Eva K,20,0,20,0
1713486079679,LIGM 5B,A00,507423,Fischer-Grunski; Eva K,20,0,20,0
1713486080708,LIGM 5C,A00,507425,Fischer-Grunski; Eva K,20,0,20,0
1713486081739,LIIT 5AS,A00,507427,Carnelos; Chiara,20,0,20,0
1713486082767,LIIT 5BS,A00,507430,Carnelos; Chiara,20,0,20,0
1713486083793,LIIT 5CS,A00,507432,Carnelos; Chiara,20,0,20,0
1713486084821,LISP 5A,A00,507541,Munoz Sanchez; Alicia,14,0,20,6
1713486085900,LISP 5B,A00,507671,Munoz Sanchez; Alicia,12,0,20,8
1713486086925,LISP 5C,A00,507696,Munoz Sanchez; Alicia,11,0,20,9
1713486087950,MAE 197,001,528363,Boechler; Nicholas Sebastia,9998,0,9999,1
1713486088980,MATH 197,001,523477,Kedlaya; Kiran S.,9999,0,9999,0
1713486088980,MATH 197,002,563811,Zhang; Danna,9998,0,9999,1
1713486090011,MCWP 40R,A00,518780,Staff,17,0,20,3
1713486090011,MCWP 40R,B00,518781,Staff,14,0,20,6
1713486090011,MCWP 40R,C00,518783,Staff,11,0,20,9
1713486091037,MCWP 50R,A00,518791,Staff,7,0,20,13
1713486091037,MCWP 50R,B00,518792,Staff,7,0,20,13
1713486091037,MCWP 50R,C00,518793,Staff,7,0,20,13
1713486091037,MCWP 50R,D00,518794,Staff,0,0,20,20
1713486091037,MCWP 50R,E00,518795,Staff,3,0,20,17
1713486091037,MCWP 50R,F00,518796,Staff,13,0,20,7
1713486091037,MCWP 50R,G00,518797,Staff,12,0,20,8
1713486092063,MMW 12R,A01,514034,Herbst; Matthew,6,0,16,10
1713486092063,MMW 12R,A02,514035,Herbst; Matthew,13,0,16,3
1713486093090,MMW 13R,A01,514037,Staff,0,3,16,16
1713486093090,MMW 13R,A02,514039,Staff,0,3,16,16
1713486095142,SIO 295LS,A00,523233,Staff,15,0,30,15
1713486096169,SIO 295S,A00,523232,Staff,15,0,30,15
1713486097193,SOCI 117,A01,494376,Staff,0,2,5,5
1713486098221,WES 237B,A00,494380,Staff,19,0,20,1
1713486100302,AESE 279B,A00,494370,Wade; Jon P,33,0,33,0
1713486101326,AIP 197,001,627712,Vespa; Emanuel Ignacio,9999,0,9999,0
1713486102354,ANAR 135S,A00,494369,Braswell; Geoffrey E.,0,0,0,0
1713486103380,CAT 124RS,A01,519847,Geibel; William,6,0,20,14
1713486104404,CAT 125RS,A01,515971,Geibel; William,6,0,20,14
1713486105428,CLRE 250,A00,511389,Morris; Sheldon,9996,0,9999,3
1713486106455,CLRE 251,A00,507176,Mehta; Ravindra L.,9996,0,9999,3
1713486106455,CLRE 251,B00,511410,Mehta; Ravindra L.,9998,0,9999,1
1713486107488,CLRE 252,A00,507189,Cuomo; Raphael Eduardo,9998,0,9999,1
1713486108517,CLRE 253,A00,507199,Vaida; Florin,9997,0,9999,2
1713486108517,CLRE 253,B00,507202,Vaida; Florin,9999,0,9999,0
1713486109547,CLRE 259,A00,507211,Patel; Hemal,9996,0,9999,3
1713486110572,CLRE 260,A00,507221,Cuomo; Raphael Eduardo,9999,0,9999,0
1713486111598,CLRE 297,001,507242,Cuomo; Raphael Eduardo,9999,0,9999,0
1713486112627,CSE 191,A00,516875,Minnes Kemp; Mor Mia,9999,0,9999,0
1713486113658,CSS 201S,A01,494383,Staff,35,0,35,0
1713486114683,CSS 202S,A01,494387,Staff,35,0,35,0
1713486115708,EAP 100,A00,516065,Staff,9792,0,9999,207
1713486116737,ECE 45,A01,507414,Staff,38,0,60,22
1713486117817,ECE 100,A01,507416,Baghdadchi; Saharnaz,1,0,20,19
1713486117817,ECE 100,A02,507418,Baghdadchi; Saharnaz,19,0,20,1
1713486118843,ECE 111,A01,507420,Staff,27,0,50,23
1713486119867,ECE 197,001,548057,Sievenpiper; Daniel F.,9998,0,9999,1
1713486120892,EDS 115,A00,507243,Choi; Bailey Miyeon,27,0,28,1
1713486121917,EDS 117,A01,494379,Staff,16,0,25,9
1713486122949,EDS 125,A00,507246,Hopkins; Megan Beth,28,0,30,2
1713486123976,EDS 128A,A01,507264,Fargason; Sharon Gayle,26,0,26,0
1713486125008,EDS 128B,A01,507293,Pappas; Elizabeth,30,0,30,0
1713486126037,EDS 139,A00,507294,Fargason; Sharon Gayle,30,0,30,0
1713486126037,EDS 139,B00,507313,Pappas; Elizabeth,30,0,30,0
1713486127062,EDS 201,A00,507315,Staff,19,0,30,11
1713486128093,EDS 203,A01,507317,Halter; Christopher P.,18,0,30,12
1713486129118,EDS 204R,A01,507319,Halter; Christopher P.,0,1,30,30
1713486129118,EDS 204R,B01,507331,Heinzman; Erica M.,26,0,30,4
1713486130145,EDS 206R,A00,507332,Staff,0,1,30,30
1713486130145,EDS 206R,B00,507343,Staff,27,0,30,3
1713486131170,EDS 250,A00,507344,Hemans; Patricia Ann Benitez,28,0,40,12
1713486132195,EDS 281,A00,507345,Daly; Alan J.,18,0,18,0
1713486133222,EDS 284,A00,507350,Daly; Alan J.,16,0,16,0
1713486134251,EDS 286,A00,507359,Fine; Sarah,18,0,18,0
1713486135275,EDS 289C,A01,507361,Daly; Alan J.,18,0,18,0
1713486136300,EDS 290,A00,507366,Hofstetter; Carolyn,15,0,15,0
1713486137326,LIGM 5A,A00,507421,Fischer-Grunski; Eva K,20,0,20,0
1713486138353,LIGM 5B,A00,507423,Fischer-Grunski; Eva K,20,0,20,0
1713486139377,LIGM 5C,A00,507425,Fischer-Grunski; Eva K,20,0,20,0
1713486140406,LIIT 5AS,A00,507427,Carnelos; Chiara,20,0,20,0
1713486141431,LIIT 5BS,A00,507430,Carnelos; Chiara,20,0,20,0
1713486142457,LIIT 5CS,A00,507432,Carnelos; Chiara,20,0,20,0
1713486143490,LISP 5A,A00,507541,Munoz Sanchez; Alicia,14,0,20,6
1713486144519,LISP 5B,A00,507671,Munoz Sanchez; Alicia,12,0,20,8
1713486145543,LISP 5C,A00,507696,Munoz Sanchez; Alicia,11,0,20,9
1713486146573,MAE 197,001,528363,Boechler; Nicholas Sebastia,9998,0,9999,1
1713486147598,MATH 197,001,523477,Kedlaya; Kiran S.,9999,0,9999,0
1713486147598,MATH 197,002,563811,Zhang; Danna,9998,0,9999,1
1713486148624,MCWP 40R,A00,518780,Staff,17,0,20,3
1713486148624,MCWP 40R,B00,518781,Staff,14,0,20,6
1713486148624,MCWP 40R,C00,518783,Staff,11,0,20,9
1713486149649,MCWP 50R,A00,518791,Staff,7,0,20,13
1713486149649,MCWP 50R,B00,518792,Staff,7,0,20,13
1713486149649,MCWP 50R,C00,518793,Staff,7,0,20,13
1713486149649,MCWP 50R,D00,518794,Staff,0,0,20,20
1713486149649,MCWP 50R,E00,518795,Staff,3,0,20,17
1713486149649,MCWP 50R,F00,518796,Staff,13,0,20,7
1713486149649,MCWP 50R,G00,518797,Staff,12,0,20,8
1713486150673,MMW 12R,A01,514034,Herbst; Matthew,6,0,16,10
1713486150673,MMW 12R,A02,514035,Herbst; Matthew,13,0,16,3
1713486151701,MMW 13R,A01,514037,Staff,0,3,16,16
1713486151701,MMW 13R,A02,514039,Staff,0,4,16,16
1713486153757,SIO 295LS,A00,523233,Staff,15,0,30,15
1713486154782,SIO 295S,A00,523232,Staff,15,0,30,15
1713486155808,SOCI 117,A01,494376,Staff,0,2,5,5
1713486156832,WES 237B,A00,494380,Staff,19,0,20,1
1713486158899,AESE 279B,A00,494370,Wade; Jon P,33,0,33,0
1713486159929,AIP 197,001,627712,Vespa; Emanuel Ignacio,9999,0,9999,0
1713486160953,ANAR 135S,A00,494369,Braswell; Geoffrey E.,0,0,0,0
1713486161987,CAT 124RS,A01,519847,Geibel; William,6,0,20,14
1713486163014,CAT 125RS,A01,515971,Geibel; William,6,0,20,14
1713486164038,CLRE 250,A00,511389,Morris; Sheldon,9996,0,9999,3
1713486165068,CLRE 251,A00,507176,Mehta; Ravindra L.,9996,0,9999,3
1713486165068,CLRE 251,B00,511410,Mehta; Ravindra L.,9998,0,9999,1
1713486166097,CLRE 252,A00,507189,Cuomo; Raphael Eduardo,9998,0,9999,1
1713486167122,CLRE 253,A00,507199,Vaida; Florin,9997,0,9999,2
1713486167122,CLRE 253,B00,507202,Vaida; Florin,9999,0,9999,0
1713486168147,CLRE 259,A00,507211,Patel; Hemal,9996,0,9999,3
1713486169174,CLRE 260,A00,507221,Cuomo; Raphael Eduardo,9999,0,9999,0
1713486170205,CLRE 297,001,507242,Cuomo; Raphael Eduardo,9999,0,9999,0
1713486171234,CSE 191,A00,516875,Minnes Kemp; Mor Mia,9999,0,9999,0
1713486172265,CSS 201S,A01,494383,Staff,35,0,35,0
1713486173290,CSS 202S,A01,494387,Staff,35,0,35,0
1713486174312,EAP 100,A00,516065,Staff,9792,0,9999,207
1713486175415,ECE 45,A01,507414,Staff,38,0,60,22
1713486176440,ECE 100,A01,507416,Baghdadchi; Saharnaz,1,0,20,19
1713486176440,ECE 100,A02,507418,Baghdadchi; Saharnaz,19,0,20,1
1713486177467,ECE 111,A01,507420,Staff,27,0,50,23
1713486178494,ECE 197,001,548057,Sievenpiper; Daniel F.,9998,0,9999,1
1713486179525,EDS 115,A00,507243,Choi; Bailey Miyeon,27,0,28,1
1713486180553,EDS 117,A01,494379,Staff,16,0,25,9
1713486181578,EDS 125,A00,507246,Hopkins; Megan Beth,28,0,30,2
1713486182602,EDS 128A,A01,507264,Fargason; Sharon Gayle,26,0,26,0
1713486183629,EDS 128B,A01,507293,Pappas; Elizabeth,30,0,30,0
1713486184651,EDS 139,A00,507294,Fargason; Sharon Gayle,30,0,30,0
1713486184651,EDS 139,B00,507313,Pappas; Elizabeth,30,0,30,0
1713486185674,EDS 201,A00,507315,Staff,19,0,30,11
1713486186702,EDS 203,A01,507317,Halter; Christopher P.,18,0,30,12
1713486187728,EDS 204R,A01,507319,Halter; Christopher P.,0,1,30,30
1713486187728,EDS 204R,B01,507331,Heinzman; Erica M.,26,0,30,4
1713486188752,EDS 206R,A00,507332,Staff,0,1,30,30
1713486188752,EDS 206R,B00,507343,Staff,27,0,30,3
1713486189780,EDS 250,A00,507344,Hemans; Patricia Ann Benitez,28,0,40,12
1713486190804,EDS 281,A00,507345,Daly; Alan J.,18,0,18,0
1713486191832,EDS 284,A00,507350,Daly; Alan J.,16,0,16,0
1713486192862,EDS 286,A00,507359,Fine; Sarah,18,0,18,0
1713486193902,EDS 289C,A01,507361,Daly; Alan J.,18,0,18,0
1713486194928,EDS 290,A00,507366,Hofstetter; Carolyn,15,0,15,0
1713486195955,LIGM 5A,A00,507421,Fischer-Grunski; Eva K,20,0,20,0
1713486196980,LIGM 5B,A00,507423,Fischer-Grunski; Eva K,20,0,20,0
1713486198004,LIGM 5C,A00,507425,Fischer-Grunski; Eva K,20,0,20,0
1713486199031,LIIT 5AS,A00,507427,Carnelos; Chiara,20,0,20,0
1713486200059,LIIT 5BS,A00,507430,Carnelos; Chiara,20,0,20,0
1713486201088,LIIT 5CS,A00,507432,Carnelos; Chiara,20,0,20,0
1713486202113,LISP 5A,A00,507541,Munoz Sanchez; Alicia,14,0,20,6
1713486203142,LISP 5B,A00,507671,Munoz Sanchez; Alicia,12,0,20,8
1713486204170,LISP 5C,A00,507696,Munoz Sanchez; Alicia,11,0,20,9
1713486205194,MAE 197,001,528363,Boechler; Nicholas Sebastia,9998,0,9999,1
1713486206224,MATH 197,001,523477,Kedlaya; Kiran S.,9999,0,9999,0
1713486206224,MATH 197,002,563811,Zhang; Danna,9998,0,9999,1
1713486207251,MCWP 40R,A00,518780,Staff,17,0,20,3
1713486207251,MCWP 40R,B00,518781,Staff,14,0,20,6
1713486207251,MCWP 40R,C00,518783,Staff,11,0,20,9
1713486208283,MCWP 50R,A00,518791,Staff,7,0,20,13
1713486208283,MCWP 50R,B00,518792,Staff,7,0,20,13
1713486208283,MCWP 50R,C00,518793,Staff,7,0,20,13
1713486208283,MCWP 50R,D00,518794,Staff,0,0,20,20
1713486208283,MCWP 50R,E00,518795,Staff,3,0,20,17
1713486208283,MCWP 50R,F00,518796,Staff,13,0,20,7
1713486208283,MCWP 50R,G00,518797,Staff,12,0,20,8
1713486209310,MMW 12R,A01,514034,Herbst; Matthew,6,0,16,10
1713486209310,MMW 12R,A02,514035,Herbst; Matthew,13,0,16,3
1713486210336,MMW 13R,A01,514037,Staff,0,3,16,16
1713486210336,MMW 13R,A02,514039,Staff,0,4,16,16
1713486212387,SIO 295LS,A00,523233,Staff,15,0,30,15
1713486213412,SIO 295S,A00,523232,Staff,15,0,30,15
1713486214439,SOCI 117,A01,494376,Staff,0,2,5,5
1713486215464,WES 237B,A00,494380,Staff,19,0,20,1
1713486217531,AESE 279B,A00,494370,Wade; Jon P,33,0,33,0
1713486218560,AIP 197,001,627712,Vespa; Emanuel Ignacio,9999,0,9999,0
1713486219591,ANAR 135S,A00,494369,Braswell; Geoffrey E.,0,0,0,0
1713486220618,CAT 124RS,A01,519847,Geibel; William,6,0,20,14
1713486221697,CAT 125RS,A01,515971,Geibel; William,6,0,20,14
1713486222723,CLRE 250,A00,511389,Morris; Sheldon,9996,0,9999,3
1713486223749,CLRE 251,A00,507176,Mehta; Ravindra L.,9996,0,9999,3
1713486223749,CLRE 251,B00,511410,Mehta; Ravindra L.,9998,0,9999,1
1713486224778,CLRE 252,A00,507189,Cuomo; Raphael Eduardo,9998,0,9999,1
1713486225802,CLRE 253,A00,507199,Vaida; Florin,9997,0,9999,2
1713486225802,CLRE 253,B00,507202,Vaida; Florin,9999,0,9999,0
1713486226828,CLRE 259,A00,507211,Patel; Hemal,9996,0,9999,3
1713486227857,CLRE 260,A00,507221,Cuomo; Raphael Eduardo,9999,0,9999,0
1713486228885,CLRE 297,001,507242,Cuomo; Raphael Eduardo,9999,0,9999,0
1713486229910,CSE 191,A00,516875,Minnes Kemp; Mor Mia,9999,0,9999,0
1713486230943,CSS 201S,A01,494383,Staff,35,0,35,0
1713486231969,CSS 202S,A01,494387,Staff,35,0,35,0
1713486232995,EAP 100,A00,516065,Staff,9792,0,9999,207
1713486234020,ECE 45,A01,507414,Staff,38,0,60,22
1713486235049,ECE 100,A01,507416,Baghdadchi; Saharnaz,1,0,20,19
1713486235049,ECE 100,A02,507418,Baghdadchi; Saharnaz,19,0,20,1
1713486236074,ECE 111,A01,507420,Staff,27,0,50,23
1713486237100,ECE 197,001,548057,Sievenpiper; Daniel F.,9998,0,9999,1
1713486238129,EDS 115,A00,507243,Choi; Bailey Miyeon,27,0,28,1
1713486239158,EDS 117,A01,494379,Staff,16,0,25,9
1713486240187,EDS 125,A00,507246,Hopkins; Megan Beth,28,0,30,2
1713486241216,EDS 128A,A01,507264,Fargason; Sharon Gayle,26,0,26,0
1713486242246,EDS 128B,A01,507293,Pappas; Elizabeth,30,0,30,0
1713486243271,EDS 139,A00,507294,Fargason; Sharon Gayle,30,0,30,0
1713486243271,EDS 139,B00,507313,Pappas; Elizabeth,30,0,30,0
1713486244296,EDS 201,A00,507315,Staff,19,0,30,11
1713486245323,EDS 203,A01,507317,Halter; Christopher P.,18,0,30,12
1713486246348,EDS 204R,A01,507319,Halter; Christopher P.,0,1,30,30
1713486246348,EDS 204R,B01,507331,Heinzman; Erica M.,26,0,30,4
1713486247375,EDS 206R,A00,507332,Staff,0,1,30,30
1713486247375,EDS 206R,B00,507343,Staff,27,0,30,3
1713486248403,EDS 250,A00,507344,Hemans; Patricia Ann Benitez,28,0,40,12
1713486249429,EDS 281,A00,507345,Daly; Alan J.,18,0,18,0
1713486250453,EDS 284,A00,507350,Daly; Alan J.,16,0,16,0
1713486251484,EDS 286,A00,507359,Fine; Sarah,18,0,18,0
1713486252512,EDS 289C,A01,507361,Daly; Alan J.,18,0,18,0
1713486253540,EDS 290,A00,507366,Hofstetter; Carolyn,15,0,15,0
1713486254571,LIGM 5A,A00,507421,Fischer-Grunski; Eva K,20,0,20,0
1713486255599,LIGM 5B,A00,507423,Fischer-Grunski; Eva K,20,0,20,0
1713486256625,LIGM 5C,A00,507425,Fischer-Grunski; Eva K,20,0,20,0
1713486257650,LIIT 5AS,A00,507427,Carnelos; Chiara,20,0,20,0
1713486258679,LIIT 5BS,A00,507430,Carnelos; Chiara,20,0,20,0
1713486259704,LIIT 5CS,A00,507432,Carnelos; Chiara,20,0,20,0
1713486260734,LISP 5A,A00,507541,Munoz Sanchez; Alicia,14,0,20,6
1713486261760,LISP 5B,A00,507671,Munoz Sanchez; Alicia,12,0,20,8
1713486262785,LISP 5C,A00,507696,Munoz Sanchez; Alicia,11,0,20,9
1713486263811,MAE 197,001,528363,Boechler; Nicholas Sebastia,9998,0,9999,1
1713486264844,MATH 197,001,523477,Kedlaya; Kiran S.,9999,0,9999,0
1713486264844,MATH 197,002,563811,Zhang; Danna,9998,0,9999,1
1713486265873,MCWP 40R,A00,518780,Staff,17,0,20,3
1713486265873,MCWP 40R,B00,518781,Staff,14,0,20,6
1713486265873,MCWP 40R,C00,518783,Staff,11,0,20,9
1713486266902,MCWP 50R,A00,518791,Staff,7,0,20,13
1713486266902,MCWP 50R,B00,518792,Staff,7,0,20,13
1713486266902,MCWP 50R,C00,518793,Staff,7,0,20,13
1713486266902,MCWP 50R,D00,518794,Staff,0,0,20,20
1713486266902,MCWP 50R,E00,518795,Staff,3,0,20,17
1713486266902,MCWP 50R,F00,518796,Staff,13,0,20,7
1713486266902,MCWP 50R,G00,518797,Staff,12,0,20,8
1713486267928,MMW 12R,A01,514034,Herbst; Matthew,6,0,16,10
1713486267928,MMW 12R,A02,514035,Herbst; Matthew,13,0,16,3
1713486268954,MMW 13R,A01,514037,Staff,0,3,16,16
1713486268954,MMW 13R,A02,514039,Staff,0,4,16,16
1713486271004,SIO 295LS,A00,523233,Staff,15,0,30,15
1713486272033,SIO 295S,A00,523232,Staff,15,0,30,15
1713486273059,SOCI 117,A01,494376,Staff,0,2,5,5
1713486274086,WES 237B,A00,494380,Staff,19,0,20,1
1713486276167,AESE 279B,A00,494370,Wade; Jon P,33,0,33,0
1713486277191,AIP 197,001,627712,Vespa; Emanuel Ignacio,9999,0,9999,0
1713486278221,ANAR 135S,A00,494369,Braswell; Geoffrey E.,0,0,0,0
1713486279248,CAT 124RS,A01,519847,Geibel; William,6,0,20,14
1713486280276,CAT 125RS,A01,515971,Geibel; William,6,0,20,14
1713486281308,CLRE 250,A00,511389,Morris; Sheldon,9996,0,9999,3
1713486282335,CLRE 251,A00,507176,Mehta; Ravindra L.,9996,0,9999,3
1713486282335,CLRE 251,B00,511410,Mehta; Ravindra L.,9998,0,9999,1
1713486283360,CLRE 252,A00,507189,Cuomo; Raphael Eduardo,9998,0,9999,1
1713486284386,CLRE 253,A00,507199,Vaida; Florin,9997,0,9999,2
1713486284386,CLRE 253,B00,507202,Vaida; Florin,9999,0,9999,0
1713486285415,CLRE 259,A00,507211,Patel; Hemal,9996,0,9999,3
1713486286439,CLRE 260,A00,507221,Cuomo; Raphael Eduardo,9999,0,9999,0
1713486287463,CLRE 297,001,507242,Cuomo; Raphael Eduardo,9999,0,9999,0
1713486288493,CSE 191,A00,516875,Minnes Kemp; Mor Mia,9999,0,9999,0
1713486289520,CSS 201S,A01,494383,Staff,35,0,35,0
1713486290544,CSS 202S,A01,494387,Staff,35,0,35,0
1713486291572,EAP 100,A00,516065,Staff,9792,0,9999,207
1713486292599,ECE 45,A01,507414,Staff,38,0,60,22
1713486293625,ECE 100,A01,507416,Baghdadchi; Saharnaz,1,0,20,19
1713486293625,ECE 100,A02,507418,Baghdadchi; Saharnaz,19,0,20,1
1713486294654,ECE 111,A01,507420,Staff,27,0,50,23
1713486295679,ECE 197,001,548057,Sievenpiper; Daniel F.,9998,0,9999,1
1713486296705,EDS 115,A00,507243,Choi; Bailey Miyeon,27,0,28,1
1713486297733,EDS 117,A01,494379,Staff,16,0,25,9
1713486298761,EDS 125,A00,507246,Hopkins; Megan Beth,28,0,30,2
1713486299789,EDS 128A,A01,507264,Fargason; Sharon Gayle,26,0,26,0
1713486300819,EDS 128B,A01,507293,Pappas; Elizabeth,30,0,30,0
1713486301848,EDS 139,A00,507294,Fargason; Sharon Gayle,30,0,30,0
1713486301848,EDS 139,B00,507313,Pappas; Elizabeth,30,0,30,0
1713486302875,EDS 201,A00,507315,Staff,19,0,30,11
1713486303900,EDS 203,A01,507317,Halter; Christopher P.,18,0,30,12
1713486304928,EDS 204R,A01,507319,Halter; Christopher P.,0,1,30,30
1713486304928,EDS 204R,B01,507331,Heinzman; Erica M.,26,0,30,4
1713486305954,EDS 206R,A00,507332,Staff,0,1,30,30
1713486305954,EDS 206R,B00,507343,Staff,27,0,30,3
1713486306980,EDS 250,A00,507344,Hemans; Patricia Ann Benitez,28,0,40,12
1713486308007,EDS 281,A00,507345,Daly; Alan J.,18,0,18,0
1713486309034,EDS 284,A00,507350,Daly; Alan J.,16,0,16,0
1713486310065,EDS 286,A00,507359,Fine; Sarah,18,0,18,0
1713486311089,EDS 289C,A01,507361,Daly; Alan J.,18,0,18,0
1713486312115,EDS 290,A00,507366,Hofstetter; Carolyn,15,0,15,0
1713486313145,LIGM 5A,A00,507421,Fischer-Grunski; Eva K,20,0,20,0
1713486314170,LIGM 5B,A00,507423,Fischer-Grunski; Eva K,20,0,20,0
1713486315198,LIGM 5C,A00,507425,Fischer-Grunski; Eva K,20,0,20,0
1713486316224,LIIT 5AS,A00,507427,Carnelos; Chiara,20,0,20,0
1713486317252,LIIT 5BS,A00,507430,Carnelos; Chiara,20,0,20,0
1713486318278,LIIT 5CS,A00,507432,Carnelos; Chiara,20,0,20,0
1713486319303,LISP 5A,A00,507541,Munoz Sanchez; Alicia,14,0,20,6
1713486320329,LISP 5B,A00,507671,Munoz Sanchez; Alicia,12,0,20,8
1713486321354,LISP 5C,A00,507696,Munoz Sanchez; Alicia,11,0,20,9
1713486322381,MAE 197,001,528363,Boechler; Nicholas Sebastia,9998,0,9999,1
1713486323411,MATH 197,001,523477,Kedlaya; Kiran S.,9999,0,9999,0
1713486323411,MATH 197,002,563811,Zhang; Danna,9998,0,9999,1
1713486324438,MCWP 40R,A00,518780,Staff,17,0,20,3
1713486324438,MCWP 40R,B00,518781,Staff,14,0,20,6
1713486324438,MCWP 40R,C00,518783,Staff,11,0,20,9
1713486325518,MCWP 50R,A00,518791,Staff,7,0,20,13
1713486325518,MCWP 50R,B00,518792,Staff,7,0,20,13
1713486325518,MCWP 50R,C00,518793,Staff,7,0,20,13
1713486325518,MCWP 50R,D00,518794,Staff,0,0,20,20
1713486325518,MCWP 50R,E00,518795,Staff,3,0,20,17
1713486325518,MCWP 50R,F00,518796,Staff,13,0,20,7
1713486325518,MCWP 50R,G00,518797,Staff,12,0,20,8
1713486326543,MMW 12R,A01,514034,Herbst; Matthew,6,0,16,10
1713486326543,MMW 12R,A02,514035,Herbst; Matthew,13,0,16,3
1713486327566,MMW 13R,A01,514037,Staff,0,3,16,16
1713486327566,MMW 13R,A02,514039,Staff,0,4,16,16
1713486329617,SIO 295LS,A00,523233,Staff,15,0,30,15
1713486330642,SIO 295S,A00,523232,Staff,15,0,30,15
1713486331667,SOCI 117,A01,494376,Staff,0,2,5,5
1713486332692,WES 237B,A00,494380,Staff,19,0,20,1
1713486334760,AESE 279B,A00,494370,Wade; Jon P,33,0,33,0
1713486335790,AIP 197,001,627712,Vespa; Emanuel Ignacio,9999,0,9999,0
1713486336823,ANAR 135S,A00,494369,Braswell; Geoffrey E.,0,0,0,0
1713486337853,CAT 124RS,A01,519847,Geibel; William,6,0,20,14
1713486338879,CAT 125RS,A01,515971,Geibel; William,6,0,20,14
1713486339906,CLRE 250,A00,511389,Morris; Sheldon,9996,0,9999,3
1713486340933,CLRE 251,A00,507176,Mehta; Ravindra L.,9996,0,9999,3
1713486340933,CLRE 251,B00,511410,Mehta; Ravindra L.,9998,0,9999,1
1713486341958,CLRE 252,A00,507189,Cuomo; Raphael Eduardo,9998,0,9999,1
1713486342987,CLRE 253,A00,507199,Vaida; Florin,9997,0,9999,2
1713486342987,CLRE 253,B00,507202,Vaida; Florin,9999,0,9999,0
1713486344016,CLRE 259,A00,507211,Patel; Hemal,9996,0,9999,3
1713486345041,CLRE 260,A00,507221,Cuomo; Raphael Eduardo,9999,0,9999,0
1713486346066,CLRE 297,001,507242,Cuomo; Raphael Eduardo,9999,0,9999,0
1713486347102,CSE 191,A00,516875,Minnes Kemp; Mor Mia,9999,0,9999,0
1713486348128,CSS 201S,A01,494383,Staff,35,0,35,0
1713486349154,CSS 202S,A01,494387,Staff,35,0,35,0
1713486350178,EAP 100,A00,516065,Staff,9792,0,9999,207
1713486351202,ECE 45,A01,507414,Staff,38,0,60,22
1713486352232,ECE 100,A01,507416,Baghdadchi; Saharnaz,1,0,20,19
1713486352232,ECE 100,A02,507418,Baghdadchi; Saharnaz,19,0,20,1
1713486353362,ECE 111,A01,507420,Staff,27,0,50,23
1713486354388,ECE 197,001,548057,Sievenpiper; Daniel F.,9998,0,9999,1
1713486355414,EDS 115,A00,507243,Choi; Bailey Miyeon,27,0,28,1
1713486356438,EDS 117,A01,494379,Staff,16,0,25,9
1713486357463,EDS 125,A00,507246,Hopkins; Megan Beth,28,0,30,2
1713486358488,EDS 128A,A01,507264,Fargason; Sharon Gayle,26,0,26,0
1713486359513,EDS 128B,A01,507293,Pappas; Elizabeth,30,0,30,0
1713486360540,EDS 139,A00,507294,Fargason; Sharon Gayle,30,0,30,0
1713486360540,EDS 139,B00,507313,Pappas; Elizabeth,30,0,30,0
1713486361564,EDS 201,A00,507315,Staff,19,0,30,11
1713486362594,EDS 203,A01,507317,Halter; Christopher P.,18,0,30,12
1713486363623,EDS 204R,A01,507319,Halter; Christopher P.,0,1,30,30
1713486363623,EDS 204R,B01,507331,Heinzman; Erica M.,26,0,30,4
1713486364647,EDS 206R,A00,507332,Staff,0,1,30,30
1713486364647,EDS 206R,B00,507343,Staff,27,0,30,3
1713486365675,EDS 250,A00,507344,Hemans; Patricia Ann Benitez,28,0,40,12
1713486366701,EDS 281,A00,507345,Daly; Alan J.,18,0,18,0
1713486367728,EDS 284,A00,507350,Daly; Alan J.,16,0,16,0
1713486368753,EDS 286,A00,507359,Fine; Sarah,18,0,18,0
1713486369783,EDS 289C,A01,507361,Daly; Alan J.,18,0,18,0
1713486370812,EDS 290,A00,507366,Hofstetter; Carolyn,15,0,15,0
1713486371843,LIGM 5A,A00,507421,Fischer-Grunski; Eva K,20,0,20,0
1713486372871,LIGM 5B,A00,507423,Fischer-Grunski; Eva K,20,0,20,0
1713486373902,LIGM 5C,A00,507425,Fischer-Grunski; Eva K,20,0,20,0
1713486374930,LIIT 5AS,A00,507427,Carnelos; Chiara,20,0,20,0
1713486375958,LIIT 5BS,A00,507430,Carnelos; Chiara,20,0,20,0
1713486376983,LIIT 5CS,A00,507432,Carnelos; Chiara,20,0,20,0
1713486378009,LISP 5A,A00,507541,Munoz Sanchez; Alicia,14,0,20,6
1713486379036,LISP 5B,A00,507671,Munoz Sanchez; Alicia,12,0,20,8
1713486380064,LISP 5C,A00,507696,Munoz Sanchez; Alicia,11,0,20,9
1713486381090,MAE 197,001,528363,Boechler; Nicholas Sebastia,9998,0,9999,1
1713486382116,MATH 197,001,523477,Kedlaya; Kiran S.,9999,0,9999,0
1713486382116,MATH 197,002,563811,Zhang; Danna,9998,0,9999,1
1713486383145,MCWP 40R,A00,518780,Staff,17,0,20,3
1713486383145,MCWP 40R,B00,518781,Staff,14,0,20,6
1713486383145,MCWP 40R,C00,518783,Staff,11,0,20,9
1713486384176,MCWP 50R,A00,518791,Staff,7,0,20,13
1713486384176,MCWP 50R,B00,518792,Staff,7,0,20,13
1713486384176,MCWP 50R,C00,518793,Staff,7,0,20,13
1713486384176,MCWP 50R,D00,518794,Staff,0,0,20,20
1713486384176,MCWP 50R,E00,518795,Staff,3,0,20,17
1713486384176,MCWP 50R,F00,518796,Staff,13,0,20,7
1713486384176,MCWP 50R,G00,518797,Staff,12,0,20,8
1713486385203,MMW 12R,A01,514034,Herbst; Matthew,6,0,16,10
1713486385203,MMW 12R,A02,514035,Herbst; Matthew,13,0,16,3
1713486386228,MMW 13R,A01,514037,Staff,0,3,16,16
1713486386228,MMW 13R,A02,514039,Staff,0,4,16,16
1713486388280,SIO 295LS,A00,523233,Staff,15,0,30,15
1713486389307,SIO 295S,A00,523232,Staff,15,0,30,15
1713486390339,SOCI 117,A01,494376,Staff,0,2,5,5
1713486391367,WES 237B,A00,494380,Staff,19,0,20,1
1713486393425,AESE 279B,A00,494370,Wade; Jon P,33,0,33,0
1713486394451,AIP 197,001,627712,Vespa; Emanuel Ignacio,9999,0,9999,0
1713486395476,ANAR 135S,A00,494369,Braswell; Geoffrey E.,0,0,0,0
1713486396507,CAT 124RS,A01,519847,Geibel; William,6,0,20,14
1713486397530,CAT 125RS,A01,515971,Geibel; William,6,0,20,14
1713486398560,CLRE 250,A00,511389,Morris; Sheldon,9996,0,9999,3
1713486399588,CLRE 251,A00,507176,Mehta; Ravindra L.,9996,0,9999,3
1713486399588,CLRE 251,B00,511410,Mehta; Ravindra L.,9998,0,9999,1
1713486400616,CLRE 252,A00,507189,Cuomo; Raphael Eduardo,9998,0,9999,1
1713486401646,CLRE 253,A00,507199,Vaida; Florin,9997,0,9999,2
1713486401646,CLRE 253,B00,507202,Vaida; Florin,9999,0,9999,0
1713486402675,CLRE 259,A00,507211,Patel; Hemal,9996,0,9999,3
1713486403702,CLRE 260,A00,507221,Cuomo; Raphael Eduardo,9999,0,9999,0
1713486404731,CLRE 297,001,507242,Cuomo; Raphael Eduardo,9999,0,9999,0
1713486405757,CSE 191,A00,516875,Minnes Kemp; Mor Mia,9999,0,9999,0
1713486406790,CSS 201S,A01,494383,Staff,35,0,35,0
1713486407816,CSS 202S,A01,494387,Staff,35,0,35,0
1713486408841,EAP 100,A00,516065,Staff,9792,0,9999,207
1713486409868,ECE 45,A01,507414,Staff,38,0,60,22
1713486410895,ECE 100,A01,507416,Baghdadchi; Saharnaz,1,0,20,19
1713486410895,ECE 100,A02,507418,Baghdadchi; Saharnaz,19,0,20,1
1713486411923,ECE 111,A01,507420,Staff,27,0,50,23
1713486412949,ECE 197,001,548057,Sievenpiper; Daniel F.,9998,0,9999,1
1713486413976,EDS 115,A00,507243,Choi; Bailey Miyeon,27,0,28,1
1713486415003,EDS 117,A01,494379,Staff,16,0,25,9
1713486416029,EDS 125,A00,507246,Hopkins; Megan Beth,28,0,30,2
1713486417059,EDS 128A,A01,507264,Fargason; Sharon Gayle,26,0,26,0
1713486418084,EDS 128B,A01,507293,Pappas; Elizabeth,30,0,30,0
1713486419113,EDS 139,A00,507294,Fargason; Sharon Gayle,30,0,30,0
1713486419113,EDS 139,B00,507313,Pappas; Elizabeth,30,0,30,0
1713486420144,EDS 201,A00,507315,Staff,19,0,30,11
1713486421172,EDS 203,A01,507317,Halter; Christopher P.,18,0,30,12
1713486422201,EDS 204R,A01,507319,Halter; Christopher P.,0,1,30,30
1713486422201,EDS 204R,B01,507331,Heinzman; Erica M.,26,0,30,4
1713486423232,EDS 206R,A00,507332,Staff,0,1,30,30
1713486423232,EDS 206R,B00,507343,Staff,27,0,30,3
1713486424261,EDS 250,A00,507344,Hemans; Patricia Ann Benitez,28,0,40,12
1713486425287,EDS 281,A00,507345,Daly; Alan J.,18,0,18,0
1713486426311,EDS 284,A00,507350,Daly; Alan J.,16,0,16,0
1713486427339,EDS 286,A00,507359,Fine; Sarah,18,0,18,0
1713486428364,EDS 289C,A01,507361,Daly; Alan J.,18,0,18,0
1713486429446,EDS 290,A00,507366,Hofstetter; Carolyn,15,0,15,0
1713486430471,LIGM 5A,A00,507421,Fischer-Grunski; Eva K,20,0,20,0
1713486431499,LIGM 5B,A00,507423,Fischer-Grunski; Eva K,20,0,20,0
1713486432524,LIGM 5C,A00,507425,Fischer-Grunski; Eva K,20,0,20,0
1713486433549,LIIT 5AS,A00,507427,Carnelos; Chiara,20,0,20,0
1713486434576,LIIT 5BS,A00,507430,Carnelos; Chiara,20,0,20,0
1713486435605,LIIT 5CS,A00,507432,Carnelos; Chiara,20,0,20,0
1713486436632,LISP 5A,A00,507541,Munoz Sanchez; Alicia,14,0,20,6
1713486437657,LISP 5B,A00,507671,Munoz Sanchez; Alicia,12,0,20,8
1713486438684,LISP 5C,A00,507696,Munoz Sanchez; Alicia,11,0,20,9
1713486439710,MAE 197,001,528363,Boechler; Nicholas Sebastia,9998,0,9999,1
1713486440740,MATH 197,001,523477,Kedlaya; Kiran S.,9999,0,9999,0
1713486440740,MATH 197,002,563811,Zhang; Danna,9998,0,9999,1
1713486441765,MCWP 40R,A00,518780,Staff,17,0,20,3
1713486441765,MCWP 40R,B00,518781,Staff,14,0,20,6
1713486441765,MCWP 40R,C00,518783,Staff,11,0,20,9
1713486442797,MCWP 50R,A00,518791,Staff,7,0,20,13
1713486442797,MCWP 50R,B00,518792,Staff,7,0,20,13
1713486442797,MCWP 50R,C00,518793,Staff,7,0,20,13
1713486442797,MCWP 50R,D00,518794,Staff,0,0,20,20
1713486442797,MCWP 50R,E00,518795,Staff,3,0,20,17
1713486442797,MCWP 50R,F00,518796,Staff,13,0,20,7
1713486442797,MCWP 50R,G00,518797,Staff,12,0,20,8
1713486443825,MMW 12R,A01,514034,Herbst; Matthew,6,0,16,10
1713486443825,MMW 12R,A02,514035,Herbst; Matthew,13,0,16,3
1713486444853,MMW 13R,A01,514037,Staff,0,3,16,16
1713486444853,MMW 13R,A02,514039,Staff,0,4,16,16
1713486446912,SIO 295LS,A00,523233,Staff,15,0,30,15
1713486447938,SIO 295S,A00,523232,Staff,15,0,30,15
1713486448965,SOCI 117,A01,494376,Staff,0,2,5,5
1713486449993,WES 237B,A00,494380,Staff,19,0,20,1
1713486452068,AESE 279B,A00,494370,Wade; Jon P,33,0,33,0
1713486453092,AIP 197,001,627712,Vespa; Emanuel Ignacio,9999,0,9999,0
1713486454118,ANAR 135S,A00,494369,Braswell; Geoffrey E.,0,0,0,0
1713486455147,CAT 124RS,A01,519847,Geibel; William,6,0,20,14
1713486456176,CAT 125RS,A01,515971,Geibel; William,6,0,20,14
1713486457204,CLRE 250,A00,511389,Morris; Sheldon,9996,0,9999,3
1713486458234,CLRE 251,A00,507176,Mehta; Ravindra L.,9996,0,9999,3
1713486458234,CLRE 251,B00,511410,Mehta; Ravindra L.,9998,0,9999,1
1713486459265,CLRE 252,A00,507189,Cuomo; Raphael Eduardo,9998,0,9999,1
1713486460294,CLRE 253,A00,507199,Vaida; Florin,9997,0,9999,2
1713486460294,CLRE 253,B00,507202,Vaida; Florin,9999,0,9999,0
1713486461322,CLRE 259,A00,507211,Patel; Hemal,9996,0,9999,3
1713486462346,CLRE 260,A00,507221,Cuomo; Raphael Eduardo,9999,0,9999,0
1713486463369,CLRE 297,001,507242,Cuomo; Raphael Eduardo,9999,0,9999,0
1713486464394,CSE 191,A00,516875,Minnes Kemp; Mor Mia,9999,0,9999,0
1713486465424,CSS 201S,A01,494383,Staff,35,0,35,0
1713486466452,CSS 202S,A01,494387,Staff,35,0,35,0
1713486467480,EAP 100,A00,516065,Staff,9792,0,9999,207
1713486468504,ECE 45,A01,507414,Staff,38,0,60,22
1713486469529,ECE 100,A01,507416,Baghdadchi; Saharnaz,1,0,20,19
1713486469529,ECE 100,A02,507418,Baghdadchi; Saharnaz,19,0,20,1
1713486470554,ECE 111,A01,507420,Staff,27,0,50,23
1713486471584,ECE 197,001,548057,Sievenpiper; Daniel F.,9998,0,9999,1
1713486472612,EDS 115,A00,507243,Choi; Bailey Miyeon,27,0,28,1
1713486473638,EDS 117,A01,494379,Staff,16,0,25,9
1713486474664,EDS 125,A00,507246,Hopkins; Megan Beth,28,0,30,2
1713486475688,EDS 128A,A01,507264,Fargason; Sharon Gayle,26,0,26,0
1713486476717,EDS 128B,A01,507293,Pappas; Elizabeth,30,0,30,0
1713486477747,EDS 139,A00,507294,Fargason; Sharon Gayle,30,0,30,0
1713486477747,EDS 139,B00,507313,Pappas; Elizabeth,30,0,30,0
1713486478777,EDS 201,A00,507315,Staff,19,0,30,11
1713486479802,EDS 203,A01,507317,Halter; Christopher P.,18,0,30,12
1713486480826,EDS 204R,A01,507319,Halter; Christopher P.,0,1,30,30
1713486480826,EDS 204R,B01,507331,Heinzman; Erica M.,26,0,30,4
1713486481856,EDS 206R,A00,507332,Staff,0,1,30,30
1713486481856,EDS 206R,B00,507343,Staff,27,0,30,3
1713486482882,EDS 250,A00,507344,Hemans; Patricia Ann Benitez,28,0,40,12
1713486483910,EDS 281,A00,507345,Daly; Alan J.,18,0,18,0
1713486484935,EDS 284,A00,507350,Daly; Alan J.,16,0,16,0
1713486485962,EDS 286,A00,507359,Fine; Sarah,18,0,18,0
1713486486987,EDS 289C,A01,507361,Daly; Alan J.,18,0,18,0
1713486488017,EDS 290,A00,507366,Hofstetter; Carolyn,15,0,15,0
1713486489042,LIGM 5A,A00,507421,Fischer-Grunski; Eva K,20,0,20,0
1713486490068,LIGM 5B,A00,507423,Fischer-Grunski; Eva K,20,0,20,0
1713486491094,LIGM 5C,A00,507425,Fischer-Grunski; Eva K,20,0,20,0
1713486492124,LIIT 5AS,A00,507427,Carnelos; Chiara,20,0,20,0
1713486493152,LIIT 5BS,A00,507430,Carnelos; Chiara,20,0,20,0
1713486494212,LIIT 5CS,A00,507432,Carnelos; Chiara,20,0,20,0
1713486495237,LISP 5A,A00,507541,Munoz Sanchez; Alicia,14,0,20,6
1713486496263,LISP 5B,A00,507671,Munoz Sanchez; Alicia,12,0,20,8
1713486497293,LISP 5C,A00,507696,Munoz Sanchez; Alicia,11,0,20,9
1713486498319,MAE 197,001,528363,Boechler; Nicholas Sebastia,9998,0,9999,1
1713486499343,MATH 197,001,523477,Kedlaya; Kiran S.,9999,0,9999,0
1713486499343,MATH 197,002,563811,Zhang; Danna,9998,0,9999,1
1713486500368,MCWP 40R,A00,518780,Staff,17,0,20,3
1713486500368,MCWP 40R,B00,518781,Staff,14,0,20,6
1713486500368,MCWP 40R,C00,518783,Staff,11,0,20,9
1713486501395,MCWP 50R,A00,518791,Staff,7,0,20,13
1713486501395,MCWP 50R,B00,518792,Staff,7,0,20,13
1713486501395,MCWP 50R,C00,518793,Staff,7,0,20,13
1713486501395,MCWP 50R,D00,518794,Staff,0,0,20,20
1713486501395,MCWP 50R,E00,518795,Staff,3,0,20,17
1713486501395,MCWP 50R,F00,518796,Staff,13,0,20,7
1713486501395,MCWP 50R,G00,518797,Staff,12,0,20,8
1713486502424,MMW 12R,A01,514034,Herbst; Matthew,6,0,16,10
1713486502424,MMW 12R,A02,514035,Herbst; Matthew,13,0,16,3
1713486503450,MMW 13R,A01,514037,Staff,0,3,16,16
1713486503450,MMW 13R,A02,514039,Staff,0,4,16,16
1713486505508,SIO 295LS,A00,523233,Staff,15,0,30,15
1713486506533,SIO 295S,A00,523232,Staff,15,0,30,15
1713486507561,SOCI 117,A01,494376,Staff,0,2,5,5
1713486508586,WES 237B,A00,494380,Staff,19,0,20,1
1713486510658,AESE 279B,A00,494370,Wade; Jon P,33,0,33,0
1713486511685,AIP 197,001,627712,Vespa; Emanuel Ignacio,9999,0,9999,0
1713486512711,ANAR 135S,A00,494369,Braswell; Geoffrey E.,0,0,0,0
1713486513737,CAT 124RS,A01,519847,Geibel; William,6,0,20,14
1713486514768,CAT 125RS,A01,515971,Geibel; William,6,0,20,14
1713486515794,CLRE 250,A00,511389,Morris; Sheldon,9996,0,9999,3
1713486516822,CLRE 251,A00,507176,Mehta; Ravindra L.,9996,0,9999,3
1713486516822,CLRE 251,B00,511410,Mehta; Ravindra L.,9998,0,9999,1
1713486517852,CLRE 252,A00,507189,Cuomo; Raphael Eduardo,9998,0,9999,1
1713486518877,CLRE 253,A00,507199,Vaida; Florin,9997,0,9999,2
1713486518877,CLRE 253,B00,507202,Vaida; Florin,9999,0,9999,0
1713486519903,CLRE 259,A00,507211,Patel; Hemal,9996,0,9999,3
1713486520936,CLRE 260,A00,507221,Cuomo; Raphael Eduardo,9999,0,9999,0
1713486521964,CLRE 297,001,507242,Cuomo; Raphael Eduardo,9999,0,9999,0
1713486522989,CSE 191,A00,516875,Minnes Kemp; Mor Mia,9999,0,9999,0
1713486524015,CSS 201S,A01,494383,Staff,35,0,35,0
1713486525046,CSS 202S,A01,494387,Staff,35,0,35,0
1713486526074,EAP 100,A00,516065,Staff,9792,0,9999,207
1713486527103,ECE 45,A01,507414,Staff,38,0,60,22
1713486528130,ECE 100,A01,507416,Baghdadchi; Saharnaz,1,0,20,19
1713486528130,ECE 100,A02,507418,Baghdadchi; Saharnaz,19,0,20,1
1713486529156,ECE 111,A01,507420,Staff,27,0,50,23
1713486530182,ECE 197,001,548057,Sievenpiper; Daniel F.,9998,0,9999,1
1713486531208,EDS 115,A00,507243,Choi; Bailey Miyeon,27,0,28,1
1713486532240,EDS 117,A01,494379,Staff,16,0,25,9
1713486533323,EDS 125,A00,507246,Hopkins; Megan Beth,28,0,30,2
1713486534349,EDS 128A,A01,507264,Fargason; Sharon Gayle,26,0,26,0
1713486535383,EDS 128B,A01,507293,Pappas; Elizabeth,30,0,30,0
1713486536408,EDS 139,A00,507294,Fargason; Sharon Gayle,30,0,30,0
1713486536408,EDS 139,B00,507313,Pappas; Elizabeth,30,0,30,0
1713486537432,EDS 201,A00,507315,Staff,19,0,30,11
1713486538456,EDS 203,A01,507317,Halter; Christopher P.,18,0,30,12
1713486539486,EDS 204R,A01,507319,Halter; Christopher P.,0,1,30,30
1713486539486,EDS 204R,B01,507331,Heinzman; Erica M.,26,0,30,4
1713486540511,EDS 206R,A00,507332,Staff,0,1,30,30
1713486540511,EDS 206R,B00,507343,Staff,27,0,30,3
1713486541536,EDS 250,A00,507344,Hemans; Patricia Ann Benitez,28,0,40,12
1713486542562,EDS 281,A00,507345,Daly; Alan J.,18,0,18,0
1713486543586,EDS 284,A00,507350,Daly; Alan J.,16,0,16,0
1713486544614,EDS 286,A00,507359,Fine; Sarah,18,0,18,0
1713486545638,EDS 289C,A01,507361,Daly; Alan J.,18,0,18,0
1713486546668,EDS 290,A00,507366,Hofstetter; Carolyn,15,0,15,0
1713486547694,LIGM 5A,A00,507421,Fischer-Grunski; Eva K,20,0,20,0
1713486548718,LIGM 5B,A00,507423,Fischer-Grunski; Eva K,20,0,20,0
1713486549745,LIGM 5C,A00,507425,Fischer-Grunski; Eva K,20,0,20,0
1713486550772,LIIT 5AS,A00,507427,Carnelos; Chiara,20,0,20,0
1713486551802,LIIT 5BS,A00,507430,Carnelos; Chiara,20,0,20,0
1713486552828,LIIT 5CS,A00,507432,Carnelos; Chiara,20,0,20,0
1713486553866,LISP 5A,A00,507541,Munoz Sanchez; Alicia,14,0,20,6
1713486554896,LISP 5B,A00,507671,Munoz Sanchez; Alicia,12,0,20,8
1713486555924,LISP 5C,A00,507696,Munoz Sanchez; Alicia,11,0,20,9
1713486556953,MAE 197,001,528363,Boechler; Nicholas Sebastia,9998,0,9999,1
1713486557979,MATH 197,001,523477,Kedlaya; Kiran S.,9999,0,9999,0
1713486557979,MATH 197,002,563811,Zhang; Danna,9998,0,9999,1
1713486559008,MCWP 40R,A00,518780,Staff,17,0,20,3
1713486559008,MCWP 40R,B00,518781,Staff,14,0,20,6
1713486559008,MCWP 40R,C00,518783,Staff,11,0,20,9
1713486560037,MCWP 50R,A00,518791,Staff,7,0,20,13
1713486560037,MCWP 50R,B00,518792,Staff,7,0,20,13
1713486560037,MCWP 50R,C00,518793,Staff,7,0,20,13
1713486560037,MCWP 50R,D00,518794,Staff,0,0,20,20
1713486560037,MCWP 50R,E00,518795,Staff,3,0,20,17
1713486560037,MCWP 50R,F00,518796,Staff,13,0,20,7
1713486560037,MCWP 50R,G00,518797,Staff,12,0,20,8
1713486561061,MMW 12R,A01,514034,Herbst; Matthew,6,0,16,10
1713486561061,MMW 12R,A02,514035,Herbst; Matthew,13,0,16,3
1713486562087,MMW 13R,A01,514037,Staff,0,3,16,16
1713486562087,MMW 13R,A02,514039,Staff,0,4,16,16
1713486564137,SIO 295LS,A00,523233,Staff,15,0,30,15
1713486565163,SIO 295S,A00,523232,Staff,15,0,30,15
1713486566192,SOCI 117,A01,494376,Staff,0,2,5,5
1713486567218,WES 237B,A00,494380,Staff,19,0,20,1
1713486569286,AESE 279B,A00,494370,Wade; Jon P,33,0,33,0
1713486570315,AIP 197,001,627712,Vespa; Emanuel Ignacio,9999,0,9999,0
1713486571341,ANAR 135S,A00,494369,Braswell; Geoffrey E.,0,0,0,0
1713486572366,CAT 124RS,A01,519847,Geibel; William,6,0,20,14
1713486573392,CAT 125RS,A01,515971,Geibel; William,6,0,20,14
1713486574420,CLRE 250,A00,511389,Morris; Sheldon,9996,0,9999,3
1713486575450,CLRE 251,A00,507176,Mehta; Ravindra L.,9996,0,9999,3
1713486575450,CLRE 251,B00,511410,Mehta; Ravindra L.,9998,0,9999,1
1713486576477,CLRE 252,A00,507189,Cuomo; Raphael Eduardo,9998,0,9999,1
1713486577502,CLRE 253,A00,507199,Vaida; Florin,9997,0,9999,2
1713486577502,CLRE 253,B00,507202,Vaida; Florin,9999,0,9999,0
1713486578531,CLRE 259,A00,507211,Patel; Hemal,9996,0,9999,3
1713486579557,CLRE 260,A00,507221,Cuomo; Raphael Eduardo,9999,0,9999,0
1713486580587,CLRE 297,001,507242,Cuomo; Raphael Eduardo,9999,0,9999,0
1713486581616,CSE 191,A00,516875,Minnes Kemp; Mor Mia,9999,0,9999,0
1713486582696,CSS 201S,A01,494383,Staff,35,0,35,0
1713486583725,CSS 202S,A01,494387,Staff,35,0,35,0
1713486584751,EAP 100,A00,516065,Staff,9792,0,9999,207
1713486585778,ECE 45,A01,507414,Staff,38,0,60,22
1713486586810,ECE 100,A01,507416,Baghdadchi; Saharnaz,1,0,20,19
1713486586810,ECE 100,A02,507418,Baghdadchi; Saharnaz,19,0,20,1
1713486587835,ECE 111,A01,507420,Staff,27,0,50,23
1713486588859,ECE 197,001,548057,Sievenpiper; Daniel F.,9998,0,9999,1
1713486589889,EDS 115,A00,507243,Choi; Bailey Miyeon,27,0,28,1
1713486590915,EDS 117,A01,494379,Staff,16,0,25,9
1713486591944,EDS 125,A00,507246,Hopkins; Megan Beth,28,0,30,2
1713486592969,EDS 128A,A01,507264,Fargason; Sharon Gayle,26,0,26,0
1713486593998,EDS 128B,A01,507293,Pappas; Elizabeth,30,0,30,0
1713486595026,EDS 139,A00,507294,Fargason; Sharon Gayle,30,0,30,0
1713486595026,EDS 139,B00,507313,Pappas; Elizabeth,30,0,30,0
1713486596053,EDS 201,A00,507315,Staff,19,0,30,11
1713486597083,EDS 203,A01,507317,Halter; Christopher P.,18,0,30,12
1713486598108,EDS 204R,A01,507319,Halter; Christopher P.,0,1,30,30
1713486598108,EDS 204R,B01,507331,Heinzman; Erica M.,26,0,30,4
1713486599137,EDS 206R,A00,507332,Staff,0,1,30,30
1713486599137,EDS 206R,B00,507343,Staff,27,0,30,3
1713486600263,EDS 250,A00,507344,Hemans; Patricia Ann Benitez,28,0,40,12
1713486601288,EDS 281,A00,507345,Daly; Alan J.,18,0,18,0
1713486602312,EDS 284,A00,507350,Daly; Alan J.,16,0,16,0
1713486603345,EDS 286,A00,507359,Fine; Sarah,18,0,18,0
1713486604372,EDS 289C,A01,507361,Daly; Alan J.,18,0,18,0
1713486605396,EDS 290,A00,507366,Hofstetter; Carolyn,15,0,15,0
1713486606421,LIGM 5A,A00,507421,Fischer-Grunski; Eva K,20,0,20,0
1713486607448,LIGM 5B,A00,507423,Fischer-Grunski; Eva K,20,0,20,0
1713486608473,LIGM 5C,A00,507425,Fischer-Grunski; Eva K,20,0,20,0
1713486609503,LIIT 5AS,A00,507427,Carnelos; Chiara,20,0,20,0
1713486610562,LIIT 5BS,A00,507430,Carnelos; Chiara,20,0,20,0
1713486611587,LIIT 5CS,A00,507432,Carnelos; Chiara,20,0,20,0
1713486612613,LISP 5A,A00,507541,Munoz Sanchez; Alicia,14,0,20,6
1713486613638,LISP 5B,A00,507671,Munoz Sanchez; Alicia,12,0,20,8
1713486614666,LISP 5C,A00,507696,Munoz Sanchez; Alicia,11,0,20,9
1713486615694,MAE 197,001,528363,Boechler; Nicholas Sebastia,9998,0,9999,1
1713486616718,MATH 197,001,523477,Kedlaya; Kiran S.,9999,0,9999,0
1713486616718,MATH 197,002,563811,Zhang; Danna,9998,0,9999,1
1713486617746,MCWP 40R,A00,518780,Staff,17,0,20,3
1713486617746,MCWP 40R,B00,518781,Staff,14,0,20,6
1713486617746,MCWP 40R,C00,518783,Staff,11,0,20,9
1713486618775,MCWP 50R,A00,518791,Staff,7,0,20,13
1713486618775,MCWP 50R,B00,518792,Staff,7,0,20,13
1713486618775,MCWP 50R,C00,518793,Staff,7,0,20,13
1713486618775,MCWP 50R,D00,518794,Staff,0,0,20,20
1713486618775,MCWP 50R,E00,518795,Staff,3,0,20,17
1713486618775,MCWP 50R,F00,518796,Staff,13,0,20,7
1713486618775,MCWP 50R,G00,518797,Staff,12,0,20,8
1713486619806,MMW 12R,A01,514034,Herbst; Matthew,6,0,16,10
1713486619806,MMW 12R,A02,514035,Herbst; Matthew,13,0,16,3
1713486620835,MMW 13R,A01,514037,Staff,0,3,16,16
1713486620835,MMW 13R,A02,514039,Staff,0,4,16,16
1713486622912,SIO 295LS,A00,523233,Staff,15,0,30,15
1713486623941,SIO 295S,A00,523232,Staff,15,0,30,15
1713486624966,SOCI 117,A01,494376,Staff,0,2,5,5
1713486625991,WES 237B,A00,494380,Staff,19,0,20,1
1713486628056,AESE 279B,A00,494370,Wade; Jon P,33,0,33,0
1713486629084,AIP 197,001,627712,Vespa; Emanuel Ignacio,9999,0,9999,0
1713486630110,ANAR 135S,A00,494369,Braswell; Geoffrey E.,0,0,0,0
1713486631141,CAT 124RS,A01,519847,Geibel; William,6,0,20,14
1713486632167,CAT 125RS,A01,515971,Geibel; William,6,0,20,14
1713486633195,CLRE 250,A00,511389,Morris; Sheldon,9996,0,9999,3
1713486634222,CLRE 251,A00,507176,Mehta; Ravindra L.,9996,0,9999,3
1713486634222,CLRE 251,B00,511410,Mehta; Ravindra L.,9998,0,9999,1
1713486635250,CLRE 252,A00,507189,Cuomo; Raphael Eduardo,9998,0,9999,1
1713486636276,CLRE 253,A00,507199,Vaida; Florin,9997,0,9999,2
1713486636276,CLRE 253,B00,507202,Vaida; Florin,9999,0,9999,0
1713486637357,CLRE 259,A00,507211,Patel; Hemal,9996,0,9999,3
1713486638387,CLRE 260,A00,507221,Cuomo; Raphael Eduardo,9999,0,9999,0
1713486639414,CLRE 297,001,507242,Cuomo; Raphael Eduardo,9999,0,9999,0
1713486640439,CSE 191,A00,516875,Minnes Kemp; Mor Mia,9999,0,9999,0
1713486641466,CSS 201S,A01,494383,Staff,35,0,35,0
1713486642499,CSS 202S,A01,494387,Staff,35,0,35,0
1713486643528,EAP 100,A00,516065,Staff,9792,0,9999,207
1713486644554,ECE 45,A01,507414,Staff,38,0,60,22
1713486645580,ECE 100,A01,507416,Baghdadchi; Saharnaz,1,0,20,19
1713486645580,ECE 100,A02,507418,Baghdadchi; Saharnaz,19,0,20,1
1713486646603,ECE 111,A01,507420,Staff,27,0,50,23
1713486647630,ECE 197,001,548057,Sievenpiper; Daniel F.,9998,0,9999,1
1713486648660,EDS 115,A00,507243,Choi; Bailey Miyeon,27,0,28,1
1713486649684,EDS 117,A01,494379,Staff,16,0,25,9
1713486650714,EDS 125,A00,507246,Hopkins; Megan Beth,28,0,30,2
1713486651742,EDS 128A,A01,507264,Fargason; Sharon Gayle,26,0,26,0
1713486652767,EDS 128B,A01,507293,Pappas; Elizabeth,30,0,30,0
1713486653792,EDS 139,A00,507294,Fargason; Sharon Gayle,30,0,30,0
1713486653792,EDS 139,B00,507313,Pappas; Elizabeth,30,0,30,0
1713486654820,EDS 201,A00,507315,Staff,19,0,30,11
1713486655850,EDS 203,A01,507317,Halter; Christopher P.,18,0,30,12
1713486656873,EDS 204R,A01,507319,Halter; Christopher P.,0,1,30,30
1713486656873,EDS 204R,B01,507331,Heinzman; Erica M.,26,0,30,4
1713486657898,EDS 206R,A00,507332,Staff,0,1,30,30
1713486657898,EDS 206R,B00,507343,Staff,27,0,30,3
1713486658924,EDS 250,A00,507344,Hemans; Patricia Ann Benitez,28,0,40,12
1713486659950,EDS 281,A00,507345,Daly; Alan J.,18,0,18,0
1713486660978,EDS 284,A00,507350,Daly; Alan J.,16,0,16,0
1713486662006,EDS 286,A00,507359,Fine; Sarah,18,0,18,0
1713486663034,EDS 289C,A01,507361,Daly; Alan J.,18,0,18,0
1713486664064,EDS 290,A00,507366,Hofstetter; Carolyn,15,0,15,0
1713486665090,LIGM 5A,A00,507421,Fischer-Grunski; Eva K,20,0,20,0
1713486666119,LIGM 5B,A00,507423,Fischer-Grunski; Eva K,20,0,20,0
1713486667145,LIGM 5C,A00,507425,Fischer-Grunski; Eva K,20,0,20,0
1713486668177,LIIT 5AS,A00,507427,Carnelos; Chiara,20,0,20,0
1713486669205,LIIT 5BS,A00,507430,Carnelos; Chiara,20,0,20,0
1713486670232,LIIT 5CS,A00,507432,Carnelos; Chiara,20,0,20,0
1713486671262,LISP 5A,A00,507541,Munoz Sanchez; Alicia,14,0,20,6
1713486672287,LISP 5B,A00,507671,Munoz Sanchez; Alicia,12,0,20,8
1713486673312,LISP 5C,A00,507696,Munoz Sanchez; Alicia,11,0,20,9
1713486674338,MAE 197,001,528363,Boechler; Nicholas Sebastia,9998,0,9999,1
1713486675364,MATH 197,001,523477,Kedlaya; Kiran S.,9999,0,9999,0
1713486675364,MATH 197,002,563811,Zhang; Danna,9998,0,9999,1
1713486676388,MCWP 40R,A00,518780,Staff,17,0,20,3
1713486676388,MCWP 40R,B00,518781,Staff,14,0,20,6
1713486676388,MCWP 40R,C00,518783,Staff,11,0,20,9
1713486677417,MCWP 50R,A00,518791,Staff,7,0,20,13
1713486677417,MCWP 50R,B00,518792,Staff,7,0,20,13
1713486677417,MCWP 50R,C00,518793,Staff,7,0,20,13
1713486677417,MCWP 50R,D00,518794,Staff,0,0,20,20
1713486677417,MCWP 50R,E00,518795,Staff,3,0,20,17
1713486677417,MCWP 50R,F00,518796,Staff,13,0,20,7
1713486677417,MCWP 50R,G00,518797,Staff,12,0,20,8
1713486678443,MMW 12R,A01,514034,Herbst; Matthew,6,0,16,10
1713486678443,MMW 12R,A02,514035,Herbst; Matthew,13,0,16,3
1713486679467,MMW 13R,A01,514037,Staff,0,3,16,16
1713486679467,MMW 13R,A02,514039,Staff,0,4,16,16
1713486681517,SIO 295LS,A00,523233,Staff,15,0,30,15
1713486682542,SIO 295S,A00,523232,Staff,15,0,30,15
1713486683567,SOCI 117,A01,494376,Staff,0,2,5,5
1713486684594,WES 237B,A00,494380,Staff,19,0,20,1
1713486686667,AESE 279B,A00,494370,Wade; Jon P,33,0,33,0
1713486687691,AIP 197,001,627712,Vespa; Emanuel Ignacio,9999,0,9999,0
1713486688719,ANAR 135S,A00,494369,Braswell; Geoffrey E.,0,0,0,0
1713486689749,CAT 124RS,A01,519847,Geibel; William,6,0,20,14
1713486690774,CAT 125RS,A01,515971,Geibel; William,6,0,20,14
1713486691803,CLRE 250,A00,511389,Morris; Sheldon,9996,0,9999,3
1713486692835,CLRE 251,A00,507176,Mehta; Ravindra L.,9996,0,9999,3
1713486692835,CLRE 251,B00,511410,Mehta; Ravindra L.,9998,0,9999,1
1713486693864,CLRE 252,A00,507189,Cuomo; Raphael Eduardo,9998,0,9999,1
1713486694890,CLRE 253,A00,507199,Vaida; Florin,9997,0,9999,2
1713486694890,CLRE 253,B00,507202,Vaida; Florin,9999,0,9999,0
1713486695916,CLRE 259,A00,507211,Patel; Hemal,9996,0,9999,3
1713486696942,CLRE 260,A00,507221,Cuomo; Raphael Eduardo,9999,0,9999,0
1713486697967,CLRE 297,001,507242,Cuomo; Raphael Eduardo,9999,0,9999,0
1713486698995,CSE 191,A00,516875,Minnes Kemp; Mor Mia,9999,0,9999,0
1713486700024,CSS 201S,A01,494383,Staff,35,0,35,0
1713486701048,CSS 202S,A01,494387,Staff,35,0,35,0
1713486702077,EAP 100,A00,516065,Staff,9792,0,9999,207
1713486703105,ECE 45,A01,507414,Staff,38,0,60,22
1713486704133,ECE 100,A01,507416,Baghdadchi; Saharnaz,1,0,20,19
1713486704133,ECE 100,A02,507418,Baghdadchi; Saharnaz,19,0,20,1
1713486705162,ECE 111,A01,507420,Staff,27,0,50,23
1713486706188,ECE 197,001,548057,Sievenpiper; Daniel F.,9998,0,9999,1
1713486707214,EDS 115,A00,507243,Choi; Bailey Miyeon,27,0,28,1
1713486708244,EDS 117,A01,494379,Staff,16,0,25,9
1713486709273,EDS 125,A00,507246,Hopkins; Megan Beth,28,0,30,2
1713486710301,EDS 128A,A01,507264,Fargason; Sharon Gayle,26,0,26,0
1713486711327,EDS 128B,A01,507293,Pappas; Elizabeth,30,0,30,0
1713486712357,EDS 139,A00,507294,Fargason; Sharon Gayle,30,0,30,0
1713486712357,EDS 139,B00,507313,Pappas; Elizabeth,30,0,30,0
1713486713386,EDS 201,A00,507315,Staff,19,0,30,11
1713486714415,EDS 203,A01,507317,Halter; Christopher P.,18,0,30,12
1713486715441,EDS 204R,A01,507319,Halter; Christopher P.,0,1,30,30
1713486715441,EDS 204R,B01,507331,Heinzman; Erica M.,26,0,30,4
1713486716471,EDS 206R,A00,507332,Staff,0,2,30,30
1713486716471,EDS 206R,B00,507343,Staff,27,0,30,3
1713486717499,EDS 250,A00,507344,Hemans; Patricia Ann Benitez,28,0,40,12
1713486718523,EDS 281,A00,507345,Daly; Alan J.,18,0,18,0
1713486719551,EDS 284,A00,507350,Daly; Alan J.,16,0,16,0
1713486720577,EDS 286,A00,507359,Fine; Sarah,18,0,18,0
1713486721600,EDS 289C,A01,507361,Daly; Alan J.,18,0,18,0
1713486722628,EDS 290,A00,507366,Hofstetter; Carolyn,15,0,15,0
1713486723658,LIGM 5A,A00,507421,Fischer-Grunski; Eva K,20,0,20,0
1713486724682,LIGM 5B,A00,507423,Fischer-Grunski; Eva K,20,0,20,0
1713486725708,LIGM 5C,A00,507425,Fischer-Grunski; Eva K,20,0,20,0
1713486726733,LIIT 5AS,A00,507427,Carnelos; Chiara,20,0,20,0
1713486727762,LIIT 5BS,A00,507430,Carnelos; Chiara,20,0,20,0
1713486728787,LIIT 5CS,A00,507432,Carnelos; Chiara,20,0,20,0
1713486729816,LISP 5A,A00,507541,Munoz Sanchez; Alicia,14,0,20,6
1713486730841,LISP 5B,A00,507671,Munoz Sanchez; Alicia,12,0,20,8
1713486731867,LISP 5C,A00,507696,Munoz Sanchez; Alicia,11,0,20,9
1713486732892,MAE 197,001,528363,Boechler; Nicholas Sebastia,9998,0,9999,1
1713486733918,MATH 197,001,523477,Kedlaya; Kiran S.,9999,0,9999,0
1713486733918,MATH 197,002,563811,Zhang; Danna,9998,0,9999,1
1713486734948,MCWP 40R,A00,518780,Staff,17,0,20,3
1713486734948,MCWP 40R,B00,518781,Staff,14,0,20,6
1713486734948,MCWP 40R,C00,518783,Staff,11,0,20,9
1713486735974,MCWP 50R,A00,518791,Staff,7,0,20,13
1713486735974,MCWP 50R,B00,518792,Staff,7,0,20,13
1713486735974,MCWP 50R,C00,518793,Staff,7,0,20,13
1713486735974,MCWP 50R,D00,518794,Staff,0,0,20,20
1713486735974,MCWP 50R,E00,518795,Staff,3,0,20,17
1713486735974,MCWP 50R,F00,518796,Staff,13,0,20,7
1713486735974,MCWP 50R,G00,518797,Staff,12,0,20,8
1713486737002,MMW 12R,A01,514034,Herbst; Matthew,6,0,16,10
1713486737002,MMW 12R,A02,514035,Herbst; Matthew,13,0,16,3
1713486738034,MMW 13R,A01,514037,Staff,0,3,16,16
1713486738034,MMW 13R,A02,514039,Staff,0,4,16,16
1713486740085,SIO 295LS,A00,523233,Staff,15,0,30,15
1713486741166,SIO 295S,A00,523232,Staff,15,0,30,15
1713486742191,SOCI 117,A01,494376,Staff,0,2,5,5
1713486743220,WES 237B,A00,494380,Staff,19,0,20,1
1713486745282,AESE 279B,A00,494370,Wade; Jon P,33,0,33,0
1713486746313,AIP 197,001,627712,Vespa; Emanuel Ignacio,9999,0,9999,0
1713486747337,ANAR 135S,A00,494369,Braswell; Geoffrey E.,0,0,0,0
1713486748362,CAT 124RS,A01,519847,Geibel; William,6,0,20,14
1713486749390,CAT 125RS,A01,515971,Geibel; William,6,0,20,14
1713486750419,CLRE 250,A00,511389,Morris; Sheldon,9996,0,9999,3
1713486751446,CLRE 251,A00,507176,Mehta; Ravindra L.,9996,0,9999,3
1713486751446,CLRE 251,B00,511410,Mehta; Ravindra L.,9998,0,9999,1
1713486752475,CLRE 252,A00,507189,Cuomo; Raphael Eduardo,9998,0,9999,1
1713486753504,CLRE 253,A00,507199,Vaida; Florin,9997,0,9999,2
1713486753504,CLRE 253,B00,507202,Vaida; Florin,9999,0,9999,0
1713486754529,CLRE 259,A00,507211,Patel; Hemal,9996,0,9999,3
1713486755556,CLRE 260,A00,507221,Cuomo; Raphael Eduardo,9999,0,9999,0
1713486756585,CLRE 297,001,507242,Cuomo; Raphael Eduardo,9999,0,9999,0
1713486757612,CSE 191,A00,516875,Minnes Kemp; Mor Mia,9999,0,9999,0
1713486758644,CSS 201S,A01,494383,Staff,35,0,35,0
1713486759669,CSS 202S,A01,494387,Staff,35,0,35,0
1713486760692,EAP 100,A00,516065,Staff,9792,0,9999,207
1713486761720,ECE 45,A01,507414,Staff,38,0,60,22
1713486762749,ECE 100,A01,507416,Baghdadchi; Saharnaz,1,0,20,19
1713486762749,ECE 100,A02,507418,Baghdadchi; Saharnaz,19,0,20,1
1713486763782,ECE 111,A01,507420,Staff,27,0,50,23
1713486764810,ECE 197,001,548057,Sievenpiper; Daniel F.,9998,0,9999,1
1713486765836,EDS 115,A00,507243,Choi; Bailey Miyeon,27,0,28,1
1713486766861,EDS 117,A01,494379,Staff,16,0,25,9
1713486767887,EDS 125,A00,507246,Hopkins; Megan Beth,28,0,30,2
1713486768913,EDS 128A,A01,507264,Fargason; Sharon Gayle,26,0,26,0
1713486769938,EDS 128B,A01,507293,Pappas; Elizabeth,30,0,30,0
1713486770964,EDS 139,A00,507294,Fargason; Sharon Gayle,30,0,30,0
1713486770964,EDS 139,B00,507313,Pappas; Elizabeth,30,0,30,0
1713486771992,EDS 201,A00,507315,Staff,19,0,30,11
1713486773017,EDS 203,A01,507317,Halter; Christopher P.,18,0,30,12
1713486774042,EDS 204R,A01,507319,Halter; Christopher P.,0,1,30,30
1713486774042,EDS 204R,B01,507331,Heinzman; Erica M.,26,0,30,4
1713486775069,EDS 206R,A00,507332,Staff,0,2,30,30
1713486775069,EDS 206R,B00,507343,Staff,27,0,30,3
1713486776094,EDS 250,A00,507344,Hemans; Patricia Ann Benitez,28,0,40,12
1713486777122,EDS 281,A00,507345,Daly; Alan J.,18,0,18,0
1713486778149,EDS 284,A00,507350,Daly; Alan J.,16,0,16,0
1713486779174,EDS 286,A00,507359,Fine; Sarah,18,0,18,0
1713486780203,EDS 289C,A01,507361,Daly; Alan J.,18,0,18,0
1713486781231,EDS 290,A00,507366,Hofstetter; Carolyn,15,0,15,0
1713486782257,LIGM 5A,A00,507421,Fischer-Grunski; Eva K,20,0,20,0
1713486783283,LIGM 5B,A00,507423,Fischer-Grunski; Eva K,20,0,20,0
1713486784314,LIGM 5C,A00,507425,Fischer-Grunski; Eva K,20,0,20,0
1713486785341,LIIT 5AS,A00,507427,Carnelos; Chiara,20,0,20,0
1713486786367,LIIT 5BS,A00,507430,Carnelos; Chiara,20,0,20,0
1713486787393,LIIT 5CS,A00,507432,Carnelos; Chiara,20,0,20,0
1713486788419,LISP 5A,A00,507541,Munoz Sanchez; Alicia,14,0,20,6
1713486789446,LISP 5B,A00,507671,Munoz Sanchez; Alicia,12,0,20,8
1713486790470,LISP 5C,A00,507696,Munoz Sanchez; Alicia,11,0,20,9
1713486791497,MAE 197,001,528363,Boechler; Nicholas Sebastia,9998,0,9999,1
1713486792523,MATH 197,001,523477,Kedlaya; Kiran S.,9999,0,9999,0
1713486792523,MATH 197,002,563811,Zhang; Danna,9998,0,9999,1
1713486793548,MCWP 40R,A00,518780,Staff,17,0,20,3
1713486793548,MCWP 40R,B00,518781,Staff,14,0,20,6
1713486793548,MCWP 40R,C00,518783,Staff,11,0,20,9
1713486794578,MCWP 50R,A00,518791,Staff,7,0,20,13
1713486794578,MCWP 50R,B00,518792,Staff,7,0,20,13
1713486794578,MCWP 50R,C00,518793,Staff,7,0,20,13
1713486794578,MCWP 50R,D00,518794,Staff,0,0,20,20
1713486794578,MCWP 50R,E00,518795,Staff,3,0,20,17
1713486794578,MCWP 50R,F00,518796,Staff,13,0,20,7
1713486794578,MCWP 50R,G00,518797,Staff,12,0,20,8
1713486795606,MMW 12R,A01,514034,Herbst; Matthew,6,0,16,10
1713486795606,MMW 12R,A02,514035,Herbst; Matthew,13,0,16,3
1713486796631,MMW 13R,A01,514037,Staff,0,3,16,16
1713486796631,MMW 13R,A02,514039,Staff,0,4,16,16
1713486798691,SIO 295LS,A00,523233,Staff,15,0,30,15
1713486799718,SIO 295S,A00,523232,Staff,15,0,30,15
1713486800746,SOCI 117,A01,494376,Staff,0,2,5,5
1713486801771,WES 237B,A00,494380,Staff,19,0,20,1
1713486803843,AESE 279B,A00,494370,Wade; Jon P,33,0,33,0
1713486804867,AIP 197,001,627712,Vespa; Emanuel Ignacio,9999,0,9999,0
1713486805896,ANAR 135S,A00,494369,Braswell; Geoffrey E.,0,0,0,0
1713486806920,CAT 124RS,A01,519847,Geibel; William,6,0,20,14
1713486807949,CAT 125RS,A01,515971,Geibel; William,6,0,20,14
1713486808975,CLRE 250,A00,511389,Morris; Sheldon,9996,0,9999,3
1713486810004,CLRE 251,A00,507176,Mehta; Ravindra L.,9996,0,9999,3
1713486810004,CLRE 251,B00,511410,Mehta; Ravindra L.,9998,0,9999,1
1713486811030,CLRE 252,A00,507189,Cuomo; Raphael Eduardo,9998,0,9999,1
1713486812057,CLRE 253,A00,507199,Vaida; Florin,9997,0,9999,2
1713486812057,CLRE 253,B00,507202,Vaida; Florin,9999,0,9999,0
1713486813083,CLRE 259,A00,507211,Patel; Hemal,9996,0,9999,3
1713486814107,CLRE 260,A00,507221,Cuomo; Raphael Eduardo,9999,0,9999,0
1713486815133,CLRE 297,001,507242,Cuomo; Raphael Eduardo,9999,0,9999,0
1713486816158,CSE 191,A00,516875,Minnes Kemp; Mor Mia,9999,0,9999,0
1713486817186,CSS 201S,A01,494383,Staff,35,0,35,0
1713486818211,CSS 202S,A01,494387,Staff,35,0,35,0
1713486819239,EAP 100,A00,516065,Staff,9792,0,9999,207
1713486820266,ECE 45,A01,507414,Staff,38,0,60,22
1713486821292,ECE 100,A01,507416,Baghdadchi; Saharnaz,1,0,20,19
1713486821292,ECE 100,A02,507418,Baghdadchi; Saharnaz,19,0,20,1
1713486822323,ECE 111,A01,507420,Staff,27,0,50,23
1713486823352,ECE 197,001,548057,Sievenpiper; Daniel F.,9998,0,9999,1
1713486824377,EDS 115,A00,507243,Choi; Bailey Miyeon,27,0,28,1
1713486825406,EDS 117,A01,494379,Staff,16,0,25,9
1713486826435,EDS 125,A00,507246,Hopkins; Megan Beth,28,0,30,2
1713486827461,EDS 128A,A01,507264,Fargason; Sharon Gayle,26,0,26,0
1713486828487,EDS 128B,A01,507293,Pappas; Elizabeth,30,0,30,0
1713486829515,EDS 139,A00,507294,Fargason; Sharon Gayle,30,0,30,0
1713486829515,EDS 139,B00,507313,Pappas; Elizabeth,30,0,30,0
1713486830548,EDS 201,A00,507315,Staff,19,0,30,11
1713486831574,EDS 203,A01,507317,Halter; Christopher P.,18,0,30,12
1713486832599,EDS 204R,A01,507319,Halter; Christopher P.,0,1,30,30
1713486832599,EDS 204R,B01,507331,Heinzman; Erica M.,26,0,30,4
1713486833624,EDS 206R,A00,507332,Staff,0,2,30,30
1713486833624,EDS 206R,B00,507343,Staff,27,0,30,3
1713486834654,EDS 250,A00,507344,Hemans; Patricia Ann Benitez,28,0,40,12
1713486835678,EDS 281,A00,507345,Daly; Alan J.,18,0,18,0
1713486836706,EDS 284,A00,507350,Daly; Alan J.,16,0,16,0
1713486837735,EDS 286,A00,507359,Fine; Sarah,18,0,18,0
1713486838762,EDS 289C,A01,507361,Daly; Alan J.,18,0,18,0
1713486839787,EDS 290,A00,507366,Hofstetter; Carolyn,15,0,15,0
1713486840813,LIGM 5A,A00,507421,Fischer-Grunski; Eva K,20,0,20,0
1713486841839,LIGM 5B,A00,507423,Fischer-Grunski; Eva K,20,0,20,0
1713486842867,LIGM 5C,A00,507425,Fischer-Grunski; Eva K,20,0,20,0
1713486843896,LIIT 5AS,A00,507427,Carnelos; Chiara,20,0,20,0
1713486844981,LIIT 5BS,A00,507430,Carnelos; Chiara,20,0,20,0
1713486846007,LIIT 5CS,A00,507432,Carnelos; Chiara,20,0,20,0
1713486847039,LISP 5A,A00,507541,Munoz Sanchez; Alicia,14,0,20,6
1713486848067,LISP 5B,A00,507671,Munoz Sanchez; Alicia,12,0,20,8
1713486849097,LISP 5C,A00,507696,Munoz Sanchez; Alicia,11,0,20,9
1713486850125,MAE 197,001,528363,Boechler; Nicholas Sebastia,9998,0,9999,1
1713486851150,MATH 197,001,523477,Kedlaya; Kiran S.,9999,0,9999,0
1713486851150,MATH 197,002,563811,Zhang; Danna,9998,0,9999,1
1713486852178,MCWP 40R,A00,518780,Staff,17,0,20,3
1713486852178,MCWP 40R,B00,518781,Staff,14,0,20,6
1713486852178,MCWP 40R,C00,518783,Staff,11,0,20,9
1713486853209,MCWP 50R,A00,518791,Staff,7,0,20,13
1713486853209,MCWP 50R,B00,518792,Staff,7,0,20,13
1713486853209,MCWP 50R,C00,518793,Staff,7,0,20,13
1713486853209,MCWP 50R,D00,518794,Staff,0,0,20,20
1713486853209,MCWP 50R,E00,518795,Staff,3,0,20,17
1713486853209,MCWP 50R,F00,518796,Staff,13,0,20,7
1713486853209,MCWP 50R,G00,518797,Staff,12,0,20,8
1713486854269,MMW 12R,A01,514034,Herbst; Matthew,6,0,16,10
1713486854269,MMW 12R,A02,514035,Herbst; Matthew,13,0,16,3
1713486855295,MMW 13R,A01,514037,Staff,0,3,16,16
1713486855295,MMW 13R,A02,514039,Staff,0,4,16,16
1713486857345,SIO 295LS,A00,523233,Staff,15,0,30,15
1713486858374,SIO 295S,A00,523232,Staff,15,0,30,15
1713486859398,SOCI 117,A01,494376,Staff,0,2,5,5
1713486860423,WES 237B,A00,494380,Staff,19,0,20,1
1713486862496,AESE 279B,A00,494370,Wade; Jon P,33,0,33,0
1713486863524,AIP 197,001,627712,Vespa; Emanuel Ignacio,9999,0,9999,0
1713486864550,ANAR 135S,A00,494369,Braswell; Geoffrey E.,0,0,0,0
1713486865578,CAT 124RS,A01,519847,Geibel; William,6,0,20,14
1713486866603,CAT 125RS,A01,515971,Geibel; William,6,0,20,14
1713486867629,CLRE 250,A00,511389,Morris; Sheldon,9996,0,9999,3
1713486868655,CLRE 251,A00,507176,Mehta; Ravindra L.,9996,0,9999,3
1713486868655,CLRE 251,B00,511410,Mehta; Ravindra L.,9998,0,9999,1
1713486869682,CLRE 252,A00,507189,Cuomo; Raphael Eduardo,9998,0,9999,1
1713486870707,CLRE 253,A00,507199,Vaida; Florin,9997,0,9999,2
1713486870707,CLRE 253,B00,507202,Vaida; Florin,9999,0,9999,0
1713486871732,CLRE 259,A00,507211,Patel; Hemal,9996,0,9999,3
1713486872756,CLRE 260,A00,507221,Cuomo; Raphael Eduardo,9999,0,9999,0
1713486873787,CLRE 297,001,507242,Cuomo; Raphael Eduardo,9999,0,9999,0
1713486874816,CSE 191,A00,516875,Minnes Kemp; Mor Mia,9999,0,9999,0
1713486875846,CSS 201S,A01,494383,Staff,35,0,35,0
1713486876872,CSS 202S,A01,494387,Staff,35,0,35,0
1713486877898,EAP 100,A00,516065,Staff,9792,0,9999,207
1713486878924,ECE 45,A01,507414,Staff,38,0,60,22
1713486879950,ECE 100,A01,507416,Baghdadchi; Saharnaz,1,0,20,19
1713486879950,ECE 100,A02,507418,Baghdadchi; Saharnaz,19,0,20,1
1713486880974,ECE 111,A01,507420,Staff,27,0,50,23
1713486881999,ECE 197,001,548057,Sievenpiper; Daniel F.,9998,0,9999,1
1713486883024,EDS 115,A00,507243,Choi; Bailey Miyeon,27,0,28,1
1713486884049,EDS 117,A01,494379,Staff,16,0,25,9
1713486885077,EDS 125,A00,507246,Hopkins; Megan Beth,28,0,30,2
1713486886102,EDS 128A,A01,507264,Fargason; Sharon Gayle,26,0,26,0
1713486887128,EDS 128B,A01,507293,Pappas; Elizabeth,30,0,30,0
1713486888197,EDS 139,A00,507294,Fargason; Sharon Gayle,30,0,30,0
1713486888197,EDS 139,B00,507313,Pappas; Elizabeth,30,0,30,0
1713486889223,EDS 201,A00,507315,Staff,19,0,30,11
1713486890253,EDS 203,A01,507317,Halter; Christopher P.,18,0,30,12
1713486891285,EDS 204R,A01,507319,Halter; Christopher P.,0,1,30,30
1713486891285,EDS 204R,B01,507331,Heinzman; Erica M.,26,0,30,4
1713486892311,EDS 206R,A00,507332,Staff,0,2,30,30
1713486892311,EDS 206R,B00,507343,Staff,27,0,30,3
1713486893336,EDS 250,A00,507344,Hemans; Patricia Ann Benitez,28,0,40,12
1713486894362,EDS 281,A00,507345,Daly; Alan J.,18,0,18,0
1713486895387,EDS 284,A00,507350,Daly; Alan J.,16,0,16,0
1713486896418,EDS 286,A00,507359,Fine; Sarah,18,0,18,0
1713486897442,EDS 289C,A01,507361,Daly; Alan J.,18,0,18,0
1713486898471,EDS 290,A00,507366,Hofstetter; Carolyn,15,0,15,0
1713486899502,LIGM 5A,A00,507421,Fischer-Grunski; Eva K,20,0,20,0
1713486900526,LIGM 5B,A00,507423,Fischer-Grunski; Eva K,20,0,20,0
1713486901551,LIGM 5C,A00,507425,Fischer-Grunski; Eva K,20,0,20,0
1713486902581,LIIT 5AS,A00,507427,Carnelos; Chiara,20,0,20,0
1713486903607,LIIT 5BS,A00,507430,Carnelos; Chiara,20,0,20,0
1713486904633,LIIT 5CS,A00,507432,Carnelos; Chiara,20,0,20,0
1713486905658,LISP 5A,A00,507541,Munoz Sanchez; Alicia,14,0,20,6
1713486906687,LISP 5B,A00,507671,Munoz Sanchez; Alicia,12,0,20,8
1713486907715,LISP 5C,A00,507696,Munoz Sanchez; Alicia,11,0,20,9
1713486908745,MAE 197,001,528363,Boechler; Nicholas Sebastia,9998,0,9999,1
1713486909774,MATH 197,001,523477,Kedlaya; Kiran S.,9999,0,9999,0
1713486909774,MATH 197,002,563811,Zhang; Danna,9998,0,9999,1
1713486910803,MCWP 40R,A00,518780,Staff,17,0,20,3
1713486910803,MCWP 40R,B00,518781,Staff,14,0,20,6
1713486910803,MCWP 40R,C00,518783,Staff,11,0,20,9
1713486911833,MCWP 50R,A00,518791,Staff,7,0,20,13
1713486911833,MCWP 50R,B00,518792,Staff,7,0,20,13
1713486911833,MCWP 50R,C00,518793,Staff,7,0,20,13
1713486911833,MCWP 50R,D00,518794,Staff,0,0,20,20
1713486911833,MCWP 50R,E00,518795,Staff,3,0,20,17
1713486911833,MCWP 50R,F00,518796,Staff,13,0,20,7
1713486911833,MCWP 50R,G00,518797,Staff,12,0,20,8
1713486912857,MMW 12R,A01,514034,Herbst; Matthew,6,0,16,10
1713486912857,MMW 12R,A02,514035,Herbst; Matthew,13,0,16,3
1713486913887,MMW 13R,A01,514037,Staff,0,3,16,16
1713486913887,MMW 13R,A02,514039,Staff,0,4,16,16
1713486915946,SIO 295LS,A00,523233,Staff,15,0,30,15
1713486916971,SIO 295S,A00,523232,Staff,15,0,30,15
1713486918000,SOCI 117,A01,494376,Staff,0,2,5,5
1713486919027,WES 237B,A00,494380,Staff,19,0,20,1
1713486921099,AESE 279B,A00,494370,Wade; Jon P,33,0,33,0
1713486922125,AIP 197,001,627712,Vespa; Emanuel Ignacio,9999,0,9999,0
1713486923151,ANAR 135S,A00,494369,Braswell; Geoffrey E.,0,0,0,0
1713486924177,CAT 124RS,A01,519847,Geibel; William,6,0,20,14
1713486925224,CAT 125RS,A01,515971,Geibel; William,6,0,20,14
1713486926255,CLRE 250,A00,511389,Morris; Sheldon,9996,0,9999,3
1713486927288,CLRE 251,A00,507176,Mehta; Ravindra L.,9996,0,9999,3
1713486927288,CLRE 251,B00,511410,Mehta; Ravindra L.,9998,0,9999,1
1713486928318,CLRE 252,A00,507189,Cuomo; Raphael Eduardo,9998,0,9999,1
1713486929348,CLRE 253,A00,507199,Vaida; Florin,9997,0,9999,2
1713486929348,CLRE 253,B00,507202,Vaida; Florin,9999,0,9999,0
1713486930378,CLRE 259,A00,507211,Patel; Hemal,9996,0,9999,3
1713486931401,CLRE 260,A00,507221,Cuomo; Raphael Eduardo,9999,0,9999,0
1713486932430,CLRE 297,001,507242,Cuomo; Raphael Eduardo,9999,0,9999,0
1713486933456,CSE 191,A00,516875,Minnes Kemp; Mor Mia,9999,0,9999,0
1713486934480,CSS 201S,A01,494383,Staff,35,0,35,0
1713486935507,CSS 202S,A01,494387,Staff,35,0,35,0
1713486936535,EAP 100,A00,516065,Staff,9792,0,9999,207
1713486937563,ECE 45,A01,507414,Staff,38,0,60,22
1713486938589,ECE 100,A01,507416,Baghdadchi; Saharnaz,1,0,20,19
1713486938589,ECE 100,A02,507418,Baghdadchi; Saharnaz,19,0,20,1
1713486939615,ECE 111,A01,507420,Staff,27,0,50,23
1713486940640,ECE 197,001,548057,Sievenpiper; Daniel F.,9998,0,9999,1
1713486941665,EDS 115,A00,507243,Choi; Bailey Miyeon,27,0,28,1
1713486942791,EDS 117,A01,494379,Staff,16,0,25,9
1713486943818,EDS 125,A00,507246,Hopkins; Megan Beth,28,0,30,2
1713486944845,EDS 128A,A01,507264,Fargason; Sharon Gayle,26,0,26,0
1713486945876,EDS 128B,A01,507293,Pappas; Elizabeth,30,0,30,0
1713486946904,EDS 139,A00,507294,Fargason; Sharon Gayle,30,0,30,0
1713486946904,EDS 139,B00,507313,Pappas; Elizabeth,30,0,30,0
1713486947928,EDS 201,A00,507315,Staff,19,0,30,11
1713486949011,EDS 203,A01,507317,Halter; Christopher P.,18,0,30,12
1713486950052,EDS 204R,A01,507319,Halter; Christopher P.,0,1,30,30
1713486950052,EDS 204R,B01,507331,Heinzman; Erica M.,26,0,30,4
1713486951077,EDS 206R,A00,507332,Staff,0,2,30,30
1713486951077,EDS 206R,B00,507343,Staff,27,0,30,3
1713486952103,EDS 250,A00,507344,Hemans; Patricia Ann Benitez,28,0,40,12
1713486953129,EDS 281,A00,507345,Daly; Alan J.,18,0,18,0
1713486954160,EDS 284,A00,507350,Daly; Alan J.,16,0,16,0
1713486955190,EDS 286,A00,507359,Fine; Sarah,18,0,18,0
1713486956216,EDS 289C,A01,507361,Daly; Alan J.,18,0,18,0
1713486957240,EDS 290,A00,507366,Hofstetter; Carolyn,15,0,15,0
1713486958273,LIGM 5A,A00,507421,Fischer-Grunski; Eva K,20,0,20,0
1713486959298,LIGM 5B,A00,507423,Fischer-Grunski; Eva K,20,0,20,0
1713486960328,LIGM 5C,A00,507425,Fischer-Grunski; Eva K,20,0,20,0
1713486961353,LIIT 5AS,A00,507427,Carnelos; Chiara,20,0,20,0
1713486962378,LIIT 5BS,A00,507430,Carnelos; Chiara,20,0,20,0
1713486963408,LIIT 5CS,A00,507432,Carnelos; Chiara,20,0,20,0
1713486964432,LISP 5A,A00,507541,Munoz Sanchez; Alicia,14,0,20,6
1713486965457,LISP 5B,A00,507671,Munoz Sanchez; Alicia,12,0,20,8
1713486966482,LISP 5C,A00,507696,Munoz Sanchez; Alicia,11,0,20,9
1713486967509,MAE 197,001,528363,Boechler; Nicholas Sebastia,9998,0,9999,1
1713486968537,MATH 197,001,523477,Kedlaya; Kiran S.,9999,0,9999,0
1713486968537,MATH 197,002,563811,Zhang; Danna,9998,0,9999,1
1713486969566,MCWP 40R,A00,518780,Staff,17,0,20,3
1713486969566,MCWP 40R,B00,518781,Staff,14,0,20,6
1713486969566,MCWP 40R,C00,518783,Staff,11,0,20,9
1713486970595,MCWP 50R,A00,518791,Staff,7,0,20,13
1713486970595,MCWP 50R,B00,518792,Staff,7,0,20,13
1713486970595,MCWP 50R,C00,518793,Staff,7,0,20,13
1713486970595,MCWP 50R,D00,518794,Staff,0,0,20,20
1713486970595,MCWP 50R,E00,518795,Staff,3,0,20,17
1713486970595,MCWP 50R,F00,518796,Staff,13,0,20,7
1713486970595,MCWP 50R,G00,518797,Staff,12,0,20,8
1713486971623,MMW 12R,A01,514034,Herbst; Matthew,6,0,16,10
1713486971623,MMW 12R,A02,514035,Herbst; Matthew,13,0,16,3
1713486972648,MMW 13R,A01,514037,Staff,0,3,16,16
1713486972648,MMW 13R,A02,514039,Staff,0,4,16,16
1713486974699,SIO 295LS,A00,523233,Staff,15,0,30,15
1713486975725,SIO 295S,A00,523232,Staff,15,0,30,15
1713486976752,SOCI 117,A01,494376,Staff,0,2,5,5
1713486977780,WES 237B,A00,494380,Staff,19,0,20,1
1713486979852,AESE 279B,A00,494370,Wade; Jon P,33,0,33,0
1713486980881,AIP 197,001,627712,Vespa; Emanuel Ignacio,9999,0,9999,0
1713486981918,ANAR 135S,A00,494369,Braswell; Geoffrey E.,0,0,0,0
1713486982944,CAT 124RS,A01,519847,Geibel; William,6,0,20,14
1713486983973,CAT 125RS,A01,515971,Geibel; William,6,0,20,14
1713486985002,CLRE 250,A00,511389,Morris; Sheldon,9996,0,9999,3
1713486986032,CLRE 251,A00,507176,Mehta; Ravindra L.,9996,0,9999,3
1713486986032,CLRE 251,B00,511410,Mehta; Ravindra L.,9998,0,9999,1
1713486987062,CLRE 252,A00,507189,Cuomo; Raphael Eduardo,9998,0,9999,1
1713486988105,CLRE 253,A00,507199,Vaida; Florin,9997,0,9999,2
1713486988105,CLRE 253,B00,507202,Vaida; Florin,9999,0,9999,0
1713486989133,CLRE 259,A00,507211,Patel; Hemal,9996,0,9999,3
1713486990162,CLRE 260,A00,507221,Cuomo; Raphael Eduardo,9999,0,9999,0
1713486991187,CLRE 297,001,507242,Cuomo; Raphael Eduardo,9999,0,9999,0
1713486992216,CSE 191,A00,516875,Minnes Kemp; Mor Mia,9999,0,9999,0
1713486993242,CSS 201S,A01,494383,Staff,35,0,35,0
1713486994270,CSS 202S,A01,494387,Staff,35,0,35,0
1713486995297,EAP 100,A00,516065,Staff,9792,0,9999,207
1713486996329,ECE 45,A01,507414,Staff,38,0,60,22
1713486997358,ECE 100,A01,507416,Baghdadchi; Saharnaz,1,0,20,19
1713486997358,ECE 100,A02,507418,Baghdadchi; Saharnaz,19,0,20,1
1713486998384,ECE 111,A01,507420,Staff,27,0,50,23
1713486999418,ECE 197,001,548057,Sievenpiper; Daniel F.,9998,0,9999,1
1713487000448,EDS 115,A00,507243,Choi; Bailey Miyeon,27,0,28,1
1713487001477,EDS 117,A01,494379,Staff,16,0,25,9
1713487002505,EDS 125,A00,507246,Hopkins; Megan Beth,28,0,30,2
1713487003530,EDS 128A,A01,507264,Fargason; Sharon Gayle,26,0,26,0
1713487004556,EDS 128B,A01,507293,Pappas; Elizabeth,30,0,30,0
1713487005584,EDS 139,A00,507294,Fargason; Sharon Gayle,30,0,30,0
1713487005584,EDS 139,B00,507313,Pappas; Elizabeth,30,0,30,0
1713487006608,EDS 201,A00,507315,Staff,19,0,30,11
1713487007635,EDS 203,A01,507317,Halter; Christopher P.,18,0,30,12
1713487008661,EDS 204R,A01,507319,Halter; Christopher P.,0,1,30,30
1713487008661,EDS 204R,B01,507331,Heinzman; Erica M.,26,0,30,4
1713487009685,EDS 206R,A00,507332,Staff,0,2,30,30
1713487009685,EDS 206R,B00,507343,Staff,27,0,30,3
1713487010714,EDS 250,A00,507344,Hemans; Patricia Ann Benitez,28,0,40,12
1713487011740,EDS 281,A00,507345,Daly; Alan J.,18,0,18,0
1713487012765,EDS 284,A00,507350,Daly; Alan J.,16,0,16,0
1713487013791,EDS 286,A00,507359,Fine; Sarah,18,0,18,0
1713487014819,EDS 289C,A01,507361,Daly; Alan J.,18,0,18,0
1713487015923,EDS 290,A00,507366,Hofstetter; Carolyn,15,0,15,0
1713487016954,LIGM 5A,A00,507421,Fischer-Grunski; Eva K,20,0,20,0
1713487017982,LIGM 5B,A00,507423,Fischer-Grunski; Eva K,20,0,20,0
1713487019007,LIGM 5C,A00,507425,Fischer-Grunski; Eva K,20,0,20,0
1713487020033,LIIT 5AS,A00,507427,Carnelos; Chiara,20,0,20,0
1713487021058,LIIT 5BS,A00,507430,Carnelos; Chiara,20,0,20,0
1713487022089,LIIT 5CS,A00,507432,Carnelos; Chiara,20,0,20,0
1713487023123,LISP 5A,A00,507541,Munoz Sanchez; Alicia,14,0,20,6
1713487024151,LISP 5B,A00,507671,Munoz Sanchez; Alicia,12,0,20,8
1713487025184,LISP 5C,A00,507696,Munoz Sanchez; Alicia,11,0,20,9
1713487026209,MAE 197,001,528363,Boechler; Nicholas Sebastia,9998,0,9999,1
1713487027235,MATH 197,001,523477,Kedlaya; Kiran S.,9999,0,9999,0
1713487027235,MATH 197,002,563811,Zhang; Danna,9998,0,9999,1
1713487028261,MCWP 40R,A00,518780,Staff,17,0,20,3
1713487028261,MCWP 40R,B00,518781,Staff,14,0,20,6
1713487028261,MCWP 40R,C00,518783,Staff,10,0,20,10
1713487029286,MCWP 50R,A00,518791,Staff,7,0,20,13
1713487029286,MCWP 50R,B00,518792,Staff,7,0,20,13
1713487029286,MCWP 50R,C00,518793,Staff,7,0,20,13
1713487029286,MCWP 50R,D00,518794,Staff,0,0,20,20
1713487029286,MCWP 50R,E00,518795,Staff,3,0,20,17
1713487029286,MCWP 50R,F00,518796,Staff,13,0,20,7
1713487029286,MCWP 50R,G00,518797,Staff,12,0,20,8
1713487030316,MMW 12R,A01,514034,Herbst; Matthew,6,0,16,10
1713487030316,MMW 12R,A02,514035,Herbst; Matthew,13,0,16,3
1713487031350,MMW 13R,A01,514037,Staff,0,3,16,16
1713487031350,MMW 13R,A02,514039,Staff,0,4,16,16
1713487033407,SIO 295LS,A00,523233,Staff,15,0,30,15
1713487034440,SIO 295S,A00,523232,Staff,15,0,30,15
1713487035467,SOCI 117,A01,494376,Staff,0,2,5,5
1713487036492,WES 237B,A00,494380,Staff,19,0,20,1
1713487038571,AESE 279B,A00,494370,Wade; Jon P,33,0,33,0
1713487039600,AIP 197,001,627712,Vespa; Emanuel Ignacio,9999,0,9999,0
1713487040625,ANAR 135S,A00,494369,Braswell; Geoffrey E.,0,0,0,0
1713487041651,CAT 124RS,A01,519847,Geibel; William,6,0,20,14
1713487042674,CAT 125RS,A01,515971,Geibel; William,6,0,20,14
1713487043706,CLRE 250,A00,511389,Morris; Sheldon,9996,0,9999,3
1713487044731,CLRE 251,A00,507176,Mehta; Ravindra L.,9996,0,9999,3
1713487044731,CLRE 251,B00,511410,Mehta; Ravindra L.,9998,0,9999,1
1713487045756,CLRE 252,A00,507189,Cuomo; Raphael Eduardo,9998,0,9999,1
1713487046785,CLRE 253,A00,507199,Vaida; Florin,9997,0,9999,2
1713487046785,CLRE 253,B00,507202,Vaida; Florin,9999,0,9999,0
1713487047811,CLRE 259,A00,507211,Patel; Hemal,9996,0,9999,3
1713487048836,CLRE 260,A00,507221,Cuomo; Raphael Eduardo,9999,0,9999,0
1713487049860,CLRE 297,001,507242,Cuomo; Raphael Eduardo,9999,0,9999,0
1713487050885,CSE 191,A00,516875,Minnes Kemp; Mor Mia,9999,0,9999,0
1713487051911,CSS 201S,A01,494383,Staff,35,0,35,0
1713487052989,CSS 202S,A01,494387,Staff,35,0,35,0
1713487054015,EAP 100,A00,516065,Staff,9792,0,9999,207
1713487055044,ECE 45,A01,507414,Staff,38,0,60,22
1713487056070,ECE 100,A01,507416,Baghdadchi; Saharnaz,1,0,20,19
1713487056070,ECE 100,A02,507418,Baghdadchi; Saharnaz,19,0,20,1
1713487057095,ECE 111,A01,507420,Staff,27,0,50,23
1713487058124,ECE 197,001,548057,Sievenpiper; Daniel F.,9998,0,9999,1
1713487059148,EDS 115,A00,507243,Choi; Bailey Miyeon,27,0,28,1
1713487060173,EDS 117,A01,494379,Staff,16,0,25,9
1713487061203,EDS 125,A00,507246,Hopkins; Megan Beth,28,0,30,2
1713487062228,EDS 128A,A01,507264,Fargason; Sharon Gayle,26,0,26,0
1713487063256,EDS 128B,A01,507293,Pappas; Elizabeth,30,0,30,0
1713487064282,EDS 139,A00,507294,Fargason; Sharon Gayle,30,0,30,0
1713487064282,EDS 139,B00,507313,Pappas; Elizabeth,30,0,30,0
1713487065307,EDS 201,A00,507315,Staff,19,0,30,11
1713487066336,EDS 203,A01,507317,Halter; Christopher P.,18,0,30,12
1713487067365,EDS 204R,A01,507319,Halter; Christopher P.,0,1,30,30
1713487067365,EDS 204R,B01,507331,Heinzman; Erica M.,26,0,30,4
1713487068388,EDS 206R,A00,507332,Staff,0,2,30,30
1713487068388,EDS 206R,B00,507343,Staff,27,0,30,3
1713487069414,EDS 250,A00,507344,Hemans; Patricia Ann Benitez,28,0,40,12
1713487070439,EDS 281,A00,507345,Daly; Alan J.,18,0,18,0
1713487071466,EDS 284,A00,507350,Daly; Alan J.,16,0,16,0
1713487072491,EDS 286,A00,507359,Fine; Sarah,18,0,18,0
1713487073518,EDS 289C,A01,507361,Daly; Alan J.,18,0,18,0
1713487074543,EDS 290,A00,507366,Hofstetter; Carolyn,15,0,15,0
1713487075571,LIGM 5A,A00,507421,Fischer-Grunski; Eva K,20,0,20,0
1713487076602,LIGM 5B,A00,507423,Fischer-Grunski; Eva K,20,0,20,0
1713487077628,LIGM 5C,A00,507425,Fischer-Grunski; Eva K,20,0,20,0
1713487078657,LIIT 5AS,A00,507427,Carnelos; Chiara,20,0,20,0
1713487079683,LIIT 5BS,A00,507430,Carnelos; Chiara,20,0,20,0
1713487080712,LIIT 5CS,A00,507432,Carnelos; Chiara,20,0,20,0
1713487081737,LISP 5A,A00,507541,Munoz Sanchez; Alicia,14,0,20,6
1713487082767,LISP 5B,A00,507671,Munoz Sanchez; Alicia,12,0,20,8
1713487083795,LISP 5C,A00,507696,Munoz Sanchez; Alicia,11,0,20,9
1713487084824,MAE 197,001,528363,Boechler; Nicholas Sebastia,9998,0,9999,1
1713487085854,MATH 197,001,523477,Kedlaya; Kiran S.,9999,0,9999,0
1713487085854,MATH 197,002,563811,Zhang; Danna,9998,0,9999,1
1713487086883,MCWP 40R,A00,518780,Staff,17,0,20,3
1713487086883,MCWP 40R,B00,518781,Staff,14,0,20,6
1713487086883,MCWP 40R,C00,518783,Staff,11,0,20,9
1713487087917,MCWP 50R,A00,518791,Staff,8,0,20,12
1713487087917,MCWP 50R,B00,518792,Staff,6,0,20,14
1713487087917,MCWP 50R,C00,518793,Staff,7,0,20,13
1713487087917,MCWP 50R,D00,518794,Staff,0,0,20,20
1713487087917,MCWP 50R,E00,518795,Staff,3,0,20,17
1713487087917,MCWP 50R,F00,518796,Staff,13,0,20,7
1713487087917,MCWP 50R,G00,518797,Staff,12,0,20,8
1713487088948,MMW 12R,A01,514034,Herbst; Matthew,6,0,16,10
1713487088948,MMW 12R,A02,514035,Herbst; Matthew,13,0,16,3
1713487089977,MMW 13R,A01,514037,Staff,0,3,16,16
1713487089977,MMW 13R,A02,514039,Staff,0,4,16,16
1713487092031,SIO 295LS,A00,523233,Staff,15,0,30,15
1713487093057,SIO 295S,A00,523232,Staff,15,0,30,15
1713487094083,SOCI 117,A01,494376,Staff,0,2,5,5
1713487095118,WES 237B,A00,494380,Staff,19,0,20,1
1713487097200,AESE 279B,A00,494370,Wade; Jon P,33,0,33,0
1713487098228,AIP 197,001,627712,Vespa; Emanuel Ignacio,9999,0,9999,0
1713487099253,ANAR 135S,A00,494369,Braswell; Geoffrey E.,0,0,0,0
1713487100283,CAT 124RS,A01,519847,Geibel; William,6,0,20,14
1713487101307,CAT 125RS,A01,515971,Geibel; William,6,0,20,14
1713487102332,CLRE 250,A00,511389,Morris; Sheldon,9996,0,9999,3
1713487103362,CLRE 251,A00,507176,Mehta; Ravindra L.,9996,0,9999,3
1713487103362,CLRE 251,B00,511410,Mehta; Ravindra L.,9998,0,9999,1
1713487104396,CLRE 252,A00,507189,Cuomo; Raphael Eduardo,9998,0,9999,1
1713487105421,CLRE 253,A00,507199,Vaida; Florin,9997,0,9999,2
1713487105421,CLRE 253,B00,507202,Vaida; Florin,9999,0,9999,0
1713487106445,CLRE 259,A00,507211,Patel; Hemal,9996,0,9999,3
1713487107472,CLRE 260,A00,507221,Cuomo; Raphael Eduardo,9999,0,9999,0
1713487108495,CLRE 297,001,507242,Cuomo; Raphael Eduardo,9999,0,9999,0
1713487109521,CSE 191,A00,516875,Minnes Kemp; Mor Mia,9999,0,9999,0
1713487110547,CSS 201S,A01,494383,Staff,35,0,35,0
1713487111572,CSS 202S,A01,494387,Staff,35,0,35,0
1713487112599,EAP 100,A00,516065,Staff,9792,0,9999,207
1713487113623,ECE 45,A01,507414,Staff,38,0,60,22
1713487114647,ECE 100,A01,507416,Baghdadchi; Saharnaz,1,0,20,19
1713487114647,ECE 100,A02,507418,Baghdadchi; Saharnaz,19,0,20,1
1713487115672,ECE 111,A01,507420,Staff,27,0,50,23
1713487116703,ECE 197,001,548057,Sievenpiper; Daniel F.,9998,0,9999,1
1713487117731,EDS 115,A00,507243,Choi; Bailey Miyeon,27,0,28,1
1713487118824,EDS 117,A01,494379,Staff,16,0,25,9
1713487119852,EDS 125,A00,507246,Hopkins; Megan Beth,28,0,30,2
1713487120876,EDS 128A,A01,507264,Fargason; Sharon Gayle,26,0,26,0
1713487121903,EDS 128B,A01,507293,Pappas; Elizabeth,30,0,30,0
1713487122931,EDS 139,A00,507294,Fargason; Sharon Gayle,30,0,30,0
1713487122931,EDS 139,B00,507313,Pappas; Elizabeth,30,0,30,0
1713487123958,EDS 201,A00,507315,Staff,19,0,30,11
1713487124982,EDS 203,A01,507317,Halter; Christopher P.,18,0,30,12
1713487126011,EDS 204R,A01,507319,Halter; Christopher P.,0,1,30,30
1713487126011,EDS 204R,B01,507331,Heinzman; Erica M.,26,0,30,4
1713487127037,EDS 206R,A00,507332,Staff,0,2,30,30
1713487127037,EDS 206R,B00,507343,Staff,27,0,30,3
1713487128065,EDS 250,A00,507344,Hemans; Patricia Ann Benitez,28,0,40,12
1713487129090,EDS 281,A00,507345,Daly; Alan J.,18,0,18,0
1713487130117,EDS 284,A00,507350,Daly; Alan J.,16,0,16,0
1713487131141,EDS 286,A00,507359,Fine; Sarah,18,0,18,0
1713487132165,EDS 289C,A01,507361,Daly; Alan J.,18,0,18,0
1713487133191,EDS 290,A00,507366,Hofstetter; Carolyn,15,0,15,0
1713487134217,LIGM 5A,A00,507421,Fischer-Grunski; Eva K,20,0,20,0
1713487135243,LIGM 5B,A00,507423,Fischer-Grunski; Eva K,20,0,20,0
1713487136268,LIGM 5C,A00,507425,Fischer-Grunski; Eva K,20,0,20,0
1713487137294,LIIT 5AS,A00,507427,Carnelos; Chiara,20,0,20,0
1713487138319,LIIT 5BS,A00,507430,Carnelos; Chiara,20,0,20,0
1713487139346,LIIT 5CS,A00,507432,Carnelos; Chiara,20,0,20,0
1713487140370,LISP 5A,A00,507541,Munoz Sanchez; Alicia,14,0,20,6
1713487141395,LISP 5B,A00,507671,Munoz Sanchez; Alicia,12,0,20,8
1713487142421,LISP 5C,A00,507696,Munoz Sanchez; Alicia,11,0,20,9
1713487143448,MAE 197,001,528363,Boechler; Nicholas Sebastia,9998,0,9999,1
1713487144475,MATH 197,001,523477,Kedlaya; Kiran S.,9999,0,9999,0
1713487144475,MATH 197,002,563811,Zhang; Danna,9998,0,9999,1
1713487145500,MCWP 40R,A00,518780,Staff,17,0,20,3
1713487145500,MCWP 40R,B00,518781,Staff,14,0,20,6
1713487145500,MCWP 40R,C00,518783,Staff,11,0,20,9
1713487146525,MCWP 50R,A00,518791,Staff,8,0,20,12
1713487146525,MCWP 50R,B00,518792,Staff,6,0,20,14
1713487146525,MCWP 50R,C00,518793,Staff,7,0,20,13
1713487146525,MCWP 50R,D00,518794,Staff,0,0,20,20
1713487146525,MCWP 50R,E00,518795,Staff,3,0,20,17
1713487146525,MCWP 50R,F00,518796,Staff,13,0,20,7
1713487146525,MCWP 50R,G00,518797,Staff,12,0,20,8
1713487147550,MMW 12R,A01,514034,Herbst; Matthew,6,0,16,10
1713487147550,MMW 12R,A02,514035,Herbst; Matthew,13,0,16,3
1713487148576,MMW 13R,A01,514037,Staff,0,3,16,16
1713487148576,MMW 13R,A02,514039,Staff,0,4,16,16
1713487150629,SIO 295LS,A00,523233,Staff,15,0,30,15
1713487151654,SIO 295S,A00,523232,Staff,15,0,30,15
1713487152677,SOCI 117,A01,494376,Staff,0,2,5,5
1713487153701,WES 237B,A00,494380,Staff,19,0,20,1
1713487155774,AESE 279B,A00,494370,Wade; Jon P,33,0,33,0
1713487156855,AIP 197,001,627712,Vespa; Emanuel Ignacio,9999,0,9999,0
1713487157884,ANAR 135S,A00,494369,Braswell; Geoffrey E.,0,0,0,0
1713487158913,CAT 124RS,A01,519847,Geibel; William,6,0,20,14
1713487159940,CAT 125RS,A01,515971,Geibel; William,6,0,20,14
1713487160964,CLRE 250,A00,511389,Morris; Sheldon,9996,0,9999,3
1713487161989,CLRE 251,A00,507176,Mehta; Ravindra L.,9996,0,9999,3
1713487161989,CLRE 251,B00,511410,Mehta; Ravindra L.,9998,0,9999,1
1713487163018,CLRE 252,A00,507189,Cuomo; Raphael Eduardo,9998,0,9999,1
1713487164043,CLRE 253,A00,507199,Vaida; Florin,9997,0,9999,2
1713487164043,CLRE 253,B00,507202,Vaida; Florin,9999,0,9999,0
1713487165070,CLRE 259,A00,507211,Patel; Hemal,9996,0,9999,3
1713487166095,CLRE 260,A00,507221,Cuomo; Raphael Eduardo,9999,0,9999,0
1713487167123,CLRE 297,001,507242,Cuomo; Raphael Eduardo,9999,0,9999,0
1713487168151,CSE 191,A00,516875,Minnes Kemp; Mor Mia,9999,0,9999,0
1713487169180,CSS 201S,A01,494383,Staff,35,0,35,0
1713487170205,CSS 202S,A01,494387,Staff,35,0,35,0
1713487171229,EAP 100,A00,516065,Staff,9792,0,9999,207
1713487172259,ECE 45,A01,507414,Staff,38,0,60,22
1713487173285,ECE 100,A01,507416,Baghdadchi; Saharnaz,1,0,20,19
1713487173285,ECE 100,A02,507418,Baghdadchi; Saharnaz,19,0,20,1
1713487174313,ECE 111,A01,507420,Staff,27,0,50,23
1713487175339,ECE 197,001,548057,Sievenpiper; Daniel F.,9998,0,9999,1
1713487176369,EDS 115,A00,507243,Choi; Bailey Miyeon,27,0,28,1
1713487177393,EDS 117,A01,494379,Staff,16,0,25,9
1713487178421,EDS 125,A00,507246,Hopkins; Megan Beth,28,0,30,2
1713487179449,EDS 128A,A01,507264,Fargason; Sharon Gayle,26,0,26,0
1713487180478,EDS 128B,A01,507293,Pappas; Elizabeth,30,0,30,0
1713487181503,EDS 139,A00,507294,Fargason; Sharon Gayle,30,0,30,0
1713487181503,EDS 139,B00,507313,Pappas; Elizabeth,30,0,30,0
1713487182528,EDS 201,A00,507315,Staff,19,0,30,11
1713487183557,EDS 203,A01,507317,Halter; Christopher P.,18,0,30,12
1713487184581,EDS 204R,A01,507319,Halter; Christopher P.,0,1,30,30
1713487184581,EDS 204R,B01,507331,Heinzman; Erica M.,26,0,30,4
1713487185609,EDS 206R,A00,507332,Staff,0,2,30,30
1713487185609,EDS 206R,B00,507343,Staff,27,0,30,3
1713487186639,EDS 250,A00,507344,Hemans; Patricia Ann Benitez,28,0,40,12
1713487187664,EDS 281,A00,507345,Daly; Alan J.,18,0,18,0
1713487188692,EDS 284,A00,507350,Daly; Alan J.,16,0,16,0
1713487189716,EDS 286,A00,507359,Fine; Sarah,18,0,18,0
1713487190741,EDS 289C,A01,507361,Daly; Alan J.,18,0,18,0
1713487191768,EDS 290,A00,507366,Hofstetter; Carolyn,15,0,15,0
1713487192794,LIGM 5A,A00,507421,Fischer-Grunski; Eva K,20,0,20,0
1713487193823,LIGM 5B,A00,507423,Fischer-Grunski; Eva K,20,0,20,0
1713487194848,LIGM 5C,A00,507425,Fischer-Grunski; Eva K,20,0,20,0
1713487195873,LIIT 5AS,A00,507427,Carnelos; Chiara,20,0,20,0
1713487196899,LIIT 5BS,A00,507430,Carnelos; Chiara,20,0,20,0
1713487197925,LIIT 5CS,A00,507432,Carnelos; Chiara,20,0,20,0
1713487198952,LISP 5A,A00,507541,Munoz Sanchez; Alicia,14,0,20,6
1713487199977,LISP 5B,A00,507671,Munoz Sanchez; Alicia,12,0,20,8
1713487201004,LISP 5C,A00,507696,Munoz Sanchez; Alicia,11,0,20,9
1713487202029,MAE 197,001,528363,Boechler; Nicholas Sebastia,9998,0,9999,1
1713487203060,MATH 197,001,523477,Kedlaya; Kiran S.,9999,0,9999,0
1713487203060,MATH 197,002,563811,Zhang; Danna,9998,0,9999,1
1713487204085,MCWP 40R,A00,518780,Staff,17,0,20,3
1713487204085,MCWP 40R,B00,518781,Staff,14,0,20,6
1713487204085,MCWP 40R,C00,518783,Staff,11,0,20,9
1713487205114,MCWP 50R,A00,518791,Staff,8,0,20,12
1713487205114,MCWP 50R,B00,518792,Staff,6,0,20,14
1713487205114,MCWP 50R,C00,518793,Staff,7,0,20,13
1713487205114,MCWP 50R,D00,518794,Staff,0,0,20,20
1713487205114,MCWP 50R,E00,518795,Staff,3,0,20,17
1713487205114,MCWP 50R,F00,518796,Staff,13,0,20,7
1713487205114,MCWP 50R,G00,518797,Staff,12,0,20,8
1713487206142,MMW 12R,A01,514034,Herbst; Matthew,6,0,16,10
1713487206142,MMW 12R,A02,514035,Herbst; Matthew,13,0,16,3
1713487207171,MMW 13R,A01,514037,Staff,0,3,16,16
1713487207171,MMW 13R,A02,514039,Staff,0,4,16,16
1713487209223,SIO 295LS,A00,523233,Staff,15,0,30,15
1713487210248,SIO 295S,A00,523232,Staff,15,0,30,15
1713487211276,SOCI 117,A01,494376,Staff,0,2,5,5
1713487212304,WES 237B,A00,494380,Staff,19,0,20,1
1713487214376,AESE 279B,A00,494370,Wade; Jon P,33,0,33,0
1713487215404,AIP 197,001,627712,Vespa; Emanuel Ignacio,9999,0,9999,0
1713487216429,ANAR 135S,A00,494369,Braswell; Geoffrey E.,0,0,0,0
1713487217459,CAT 124RS,A01,519847,Geibel; William,6,0,20,14
1713487218485,CAT 125RS,A01,515971,Geibel; William,6,0,20,14
1713487219510,CLRE 250,A00,511389,Morris; Sheldon,9996,0,9999,3
1713487220535,CLRE 251,A00,507176,Mehta; Ravindra L.,9996,0,9999,3
1713487220535,CLRE 251,B00,511410,Mehta; Ravindra L.,9998,0,9999,1
1713487221560,CLRE 252,A00,507189,Cuomo; Raphael Eduardo,9998,0,9999,1
1713487222587,CLRE 253,A00,507199,Vaida; Florin,9997,0,9999,2
1713487222587,CLRE 253,B00,507202,Vaida; Florin,9999,0,9999,0
1713487223615,CLRE 259,A00,507211,Patel; Hemal,9996,0,9999,3
1713487224643,CLRE 260,A00,507221,Cuomo; Raphael Eduardo,9999,0,9999,0
1713487225670,CLRE 297,001,507242,Cuomo; Raphael Eduardo,9999,0,9999,0
1713487226694,CSE 191,A00,516875,Minnes Kemp; Mor Mia,9999,0,9999,0
1713487227725,CSS 201S,A01,494383,Staff,35,0,35,0
1713487228750,CSS 202S,A01,494387,Staff,35,0,35,0
1713487229777,EAP 100,A00,516065,Staff,9792,0,9999,207
1713487230802,ECE 45,A01,507414,Staff,38,0,60,22
1713487231828,ECE 100,A01,507416,Baghdadchi; Saharnaz,1,0,20,19
1713487231828,ECE 100,A02,507418,Baghdadchi; Saharnaz,19,0,20,1
1713487232856,ECE 111,A01,507420,Staff,27,0,50,23
1713487233889,ECE 197,001,548057,Sievenpiper; Daniel F.,9998,0,9999,1
1713487234916,EDS 115,A00,507243,Choi; Bailey Miyeon,27,0,28,1
1713487235941,EDS 117,A01,494379,Staff,16,0,25,9
1713487236966,EDS 125,A00,507246,Hopkins; Megan Beth,28,0,30,2
1713487237990,EDS 128A,A01,507264,Fargason; Sharon Gayle,26,0,26,0
1713487239015,EDS 128B,A01,507293,Pappas; Elizabeth,30,0,30,0
1713487240042,EDS 139,A00,507294,Fargason; Sharon Gayle,30,0,30,0
1713487240042,EDS 139,B00,507313,Pappas; Elizabeth,30,0,30,0
1713487241067,EDS 201,A00,507315,Staff,19,0,30,11
1713487242093,EDS 203,A01,507317,Halter; Christopher P.,18,0,30,12
1713487243121,EDS 204R,A01,507319,Halter; Christopher P.,0,1,30,30
1713487243121,EDS 204R,B01,507331,Heinzman; Erica M.,26,0,30,4
1713487244150,EDS 206R,A00,507332,Staff,0,2,30,30
1713487244150,EDS 206R,B00,507343,Staff,27,0,30,3
1713487245175,EDS 250,A00,507344,Hemans; Patricia Ann Benitez,28,0,40,12
1713487246200,EDS 281,A00,507345,Daly; Alan J.,18,0,18,0
1713487247228,EDS 284,A00,507350,Daly; Alan J.,16,0,16,0
1713487248253,EDS 286,A00,507359,Fine; Sarah,18,0,18,0
1713487249284,EDS 289C,A01,507361,Daly; Alan J.,18,0,18,0
1713487250311,EDS 290,A00,507366,Hofstetter; Carolyn,15,0,15,0
1713487251342,LIGM 5A,A00,507421,Fischer-Grunski; Eva K,20,0,20,0
1713487252370,LIGM 5B,A00,507423,Fischer-Grunski; Eva K,20,0,20,0
1713487253396,LIGM 5C,A00,507425,Fischer-Grunski; Eva K,20,0,20,0
1713487254422,LIIT 5AS,A00,507427,Carnelos; Chiara,20,0,20,0
1713487255447,LIIT 5BS,A00,507430,Carnelos; Chiara,20,0,20,0
1713487256473,LIIT 5CS,A00,507432,Carnelos; Chiara,20,0,20,0
1713487257498,LISP 5A,A00,507541,Munoz Sanchez; Alicia,14,0,20,6
1713487258524,LISP 5B,A00,507671,Munoz Sanchez; Alicia,12,0,20,8
1713487259550,LISP 5C,A00,507696,Munoz Sanchez; Alicia,11,0,20,9
1713487260629,MAE 197,001,528363,Boechler; Nicholas Sebastia,9998,0,9999,1
1713487261655,MATH 197,001,523477,Kedlaya; Kiran S.,9999,0,9999,0
1713487261655,MATH 197,002,563811,Zhang; Danna,9998,0,9999,1
1713487262681,MCWP 40R,A00,518780,Staff,17,0,20,3
1713487262681,MCWP 40R,B00,518781,Staff,14,0,20,6
1713487262681,MCWP 40R,C00,518783,Staff,11,0,20,9
1713487263705,MCWP 50R,A00,518791,Staff,8,0,20,12
1713487263705,MCWP 50R,B00,518792,Staff,5,0,20,15
1713487263705,MCWP 50R,C00,518793,Staff,7,0,20,13
1713487263705,MCWP 50R,D00,518794,Staff,0,0,20,20
1713487263705,MCWP 50R,E00,518795,Staff,3,0,20,17
1713487263705,MCWP 50R,F00,518796,Staff,13,0,20,7
1713487263705,MCWP 50R,G00,518797,Staff,12,0,20,8
1713487264735,MMW 12R,A01,514034,Herbst; Matthew,6,0,16,10
1713487264735,MMW 12R,A02,514035,Herbst; Matthew,13,0,16,3
1713487265759,MMW 13R,A01,514037,Staff,0,3,16,16
1713487265759,MMW 13R,A02,514039,Staff,0,4,16,16
1713487267816,SIO 295LS,A00,523233,Staff,15,0,30,15
1713487268845,SIO 295S,A00,523232,Staff,15,0,30,15
1713487269872,SOCI 117,A01,494376,Staff,0,2,5,5
1713487270899,WES 237B,A00,494380,Staff,19,0,20,1
1713487272964,AESE 279B,A00,494370,Wade; Jon P,33,0,33,0
1713487273991,AIP 197,001,627712,Vespa; Emanuel Ignacio,9999,0,9999,0
1713487275019,ANAR 135S,A00,494369,Braswell; Geoffrey E.,0,0,0,0
1713487276049,CAT 124RS,A01,519847,Geibel; William,6,0,20,14
1713487277073,CAT 125RS,A01,515971,Geibel; William,6,0,20,14
1713487278102,CLRE 250,A00,511389,Morris; Sheldon,9996,0,9999,3
1713487279127,CLRE 251,A00,507176,Mehta; Ravindra L.,9996,0,9999,3
1713487279127,CLRE 251,B00,511410,Mehta; Ravindra L.,9998,0,9999,1
1713487280152,CLRE 252,A00,507189,Cuomo; Raphael Eduardo,9998,0,9999,1
1713487281181,CLRE 253,A00,507199,Vaida; Florin,9997,0,9999,2
1713487281181,CLRE 253,B00,507202,Vaida; Florin,9999,0,9999,0
1713487282209,CLRE 259,A00,507211,Patel; Hemal,9996,0,9999,3
1713487283240,CLRE 260,A00,507221,Cuomo; Raphael Eduardo,9999,0,9999,0
1713487284264,CLRE 297,001,507242,Cuomo; Raphael Eduardo,9999,0,9999,0
1713487285288,CSE 191,A00,516875,Minnes Kemp; Mor Mia,9999,0,9999,0
1713487286313,CSS 201S,A01,494383,Staff,35,0,35,0
1713487287337,CSS 202S,A01,494387,Staff,35,0,35,0
1713487288365,EAP 100,A00,516065,Staff,9792,0,9999,207
1713487289393,ECE 45,A01,507414,Staff,38,0,60,22
1713487290418,ECE 100,A01,507416,Baghdadchi; Saharnaz,1,0,20,19
1713487290418,ECE 100,A02,507418,Baghdadchi; Saharnaz,19,0,20,1
1713487291444,ECE 111,A01,507420,Staff,27,0,50,23
1713487292469,ECE 197,001,548057,Sievenpiper; Daniel F.,9998,0,9999,1
1713487293495,EDS 115,A00,507243,Choi; Bailey Miyeon,27,0,28,1
1713487294518,EDS 117,A01,494379,Staff,16,0,25,9
1713487295551,EDS 125,A00,507246,Hopkins; Megan Beth,28,0,30,2
1713487296576,EDS 128A,A01,507264,Fargason; Sharon Gayle,26,0,26,0
1713487297600,EDS 128B,A01,507293,Pappas; Elizabeth,30,0,30,0
1713487298628,EDS 139,A00,507294,Fargason; Sharon Gayle,30,0,30,0
1713487298628,EDS 139,B00,507313,Pappas; Elizabeth,30,0,30,0
1713487299653,EDS 201,A00,507315,Staff,19,0,30,11
1713487300682,EDS 203,A01,507317,Halter; Christopher P.,18,0,30,12
1713487301707,EDS 204R,A01,507319,Halter; Christopher P.,0,1,30,30
1713487301707,EDS 204R,B01,507331,Heinzman; Erica M.,26,0,30,4
1713487302731,EDS 206R,A00,507332,Staff,0,2,30,30
1713487302731,EDS 206R,B00,507343,Staff,27,0,30,3
1713487303756,EDS 250,A00,507344,Hemans; Patricia Ann Benitez,28,0,40,12
1713487304785,EDS 281,A00,507345,Daly; Alan J.,18,0,18,0
1713487305813,EDS 284,A00,507350,Daly; Alan J.,16,0,16,0
1713487306840,EDS 286,A00,507359,Fine; Sarah,18,0,18,0
1713487307865,EDS 289C,A01,507361,Daly; Alan J.,18,0,18,0
1713487308890,EDS 290,A00,507366,Hofstetter; Carolyn,15,0,15,0
1713487309920,LIGM 5A,A00,507421,Fischer-Grunski; Eva K,20,0,20,0
1713487310943,LIGM 5B,A00,507423,Fischer-Grunski; Eva K,20,0,20,0
1713487311969,LIGM 5C,A00,507425,Fischer-Grunski; Eva K,20,0,20,0
1713487312995,LIIT 5AS,A00,507427,Carnelos; Chiara,20,0,20,0
1713487314021,LIIT 5BS,A00,507430,Carnelos; Chiara,20,0,20,0
1713487315046,LIIT 5CS,A00,507432,Carnelos; Chiara,20,0,20,0
1713487316071,LISP 5A,A00,507541,Munoz Sanchez; Alicia,14,0,20,6
1713487317100,LISP 5B,A00,507671,Munoz Sanchez; Alicia,12,0,20,8
1713487318126,LISP 5C,A00,507696,Munoz Sanchez; Alicia,11,0,20,9
1713487319155,MAE 197,001,528363,Boechler; Nicholas Sebastia,9998,0,9999,1
1713487320182,MATH 197,001,523477,Kedlaya; Kiran S.,9999,0,9999,0
1713487320182,MATH 197,002,563811,Zhang; Danna,9998,0,9999,1
1713487321211,MCWP 40R,A00,518780,Staff,16,0,20,4
1713487321211,MCWP 40R,B00,518781,Staff,14,0,20,6
1713487321211,MCWP 40R,C00,518783,Staff,11,0,20,9
1713487322238,MCWP 50R,A00,518791,Staff,8,0,20,12
1713487322238,MCWP 50R,B00,518792,Staff,5,0,20,15
1713487322238,MCWP 50R,C00,518793,Staff,7,0,20,13
1713487322238,MCWP 50R,D00,518794,Staff,0,0,20,20
1713487322238,MCWP 50R,E00,518795,Staff,3,0,20,17
1713487322238,MCWP 50R,F00,518796,Staff,13,0,20,7
1713487322238,MCWP 50R,G00,518797,Staff,12,0,20,8
1713487323266,MMW 12R,A01,514034,Herbst; Matthew,6,0,16,10
1713487323266,MMW 12R,A02,514035,Herbst; Matthew,13,0,16,3
1713487324292,MMW 13R,A01,514037,Staff,0,3,16,16
1713487324292,MMW 13R,A02,514039,Staff,0,4,16,16
1713487326347,SIO 295LS,A00,523233,Staff,15,0,30,15
1713487327373,SIO 295S,A00,523232,Staff,15,0,30,15
1713487328401,SOCI 117,A01,494376,Staff,0,2,5,5
1713487329431,WES 237B,A00,494380,Staff,19,0,20,1
1713487331505,AESE 279B,A00,494370,Wade; Jon P,33,0,33,0
1713487332530,AIP 197,001,627712,Vespa; Emanuel Ignacio,9999,0,9999,0
1713487333559,ANAR 135S,A00,494369,Braswell; Geoffrey E.,0,0,0,0
1713487334589,CAT 124RS,A01,519847,Geibel; William,6,0,20,14
1713487335614,CAT 125RS,A01,515971,Geibel; William,6,0,20,14
1713487336639,CLRE 250,A00,511389,Morris; Sheldon,9996,0,9999,3
1713487337665,CLRE 251,A00,507176,Mehta; Ravindra L.,9996,0,9999,3
1713487337665,CLRE 251,B00,511410,Mehta; Ravindra L.,9998,0,9999,1
1713487338688,CLRE 252,A00,507189,Cuomo; Raphael Eduardo,9998,0,9999,1
1713487339716,CLRE 253,A00,507199,Vaida; Florin,9997,0,9999,2
1713487339716,CLRE 253,B00,507202,Vaida; Florin,9999,0,9999,0
1713487340746,CLRE 259,A00,507211,Patel; Hemal,9996,0,9999,3
1713487341772,CLRE 260,A00,507221,Cuomo; Raphael Eduardo,9999,0,9999,0
1713487342801,CLRE 297,001,507242,Cuomo; Raphael Eduardo,9999,0,9999,0
1713487343829,CSE 191,A00,516875,Minnes Kemp; Mor Mia,9999,0,9999,0
1713487344858,CSS 201S,A01,494383,Staff,35,0,35,0
1713487345884,CSS 202S,A01,494387,Staff,35,0,35,0
1713487346909,EAP 100,A00,516065,Staff,9792,0,9999,207
1713487347935,ECE 45,A01,507414,Staff,38,0,60,22
1713487348967,ECE 100,A01,507416,Baghdadchi; Saharnaz,1,0,20,19
1713487348967,ECE 100,A02,507418,Baghdadchi; Saharnaz,19,0,20,1
1713487349997,ECE 111,A01,507420,Staff,27,0,50,23
1713487351024,ECE 197,001,548057,Sievenpiper; Daniel F.,9998,0,9999,1
1713487352049,EDS 115,A00,507243,Choi; Bailey Miyeon,27,0,28,1
1713487353077,EDS 117,A01,494379,Staff,16,0,25,9
1713487354102,EDS 125,A00,507246,Hopkins; Megan Beth,28,0,30,2
1713487355127,EDS 128A,A01,507264,Fargason; Sharon Gayle,26,0,26,0
1713487356154,EDS 128B,A01,507293,Pappas; Elizabeth,30,0,30,0
1713487357180,EDS 139,A00,507294,Fargason; Sharon Gayle,30,0,30,0
1713487357180,EDS 139,B00,507313,Pappas; Elizabeth,30,0,30,0
1713487358205,EDS 201,A00,507315,Staff,19,0,30,11
1713487359231,EDS 203,A01,507317,Halter; Christopher P.,18,0,30,12
1713487360256,EDS 204R,A01,507319,Halter; Christopher P.,0,1,30,30
1713487360256,EDS 204R,B01,507331,Heinzman; Erica M.,26,0,30,4
1713487361281,EDS 206R,A00,507332,Staff,0,2,30,30
1713487361281,EDS 206R,B00,507343,Staff,27,0,30,3
1713487362305,EDS 250,A00,507344,Hemans; Patricia Ann Benitez,28,0,40,12
1713487363330,EDS 281,A00,507345,Daly; Alan J.,18,0,18,0
1713487364422,EDS 284,A00,507350,Daly; Alan J.,16,0,16,0
1713487365448,EDS 286,A00,507359,Fine; Sarah,18,0,18,0
1713487366475,EDS 289C,A01,507361,Daly; Alan J.,18,0,18,0
1713487367502,EDS 290,A00,507366,Hofstetter; Carolyn,15,0,15,0
1713487368529,LIGM 5A,A00,507421,Fischer-Grunski; Eva K,20,0,20,0
1713487369560,LIGM 5B,A00,507423,Fischer-Grunski; Eva K,20,0,20,0
1713487370585,LIGM 5C,A00,507425,Fischer-Grunski; Eva K,20,0,20,0
1713487371610,LIIT 5AS,A00,507427,Carnelos; Chiara,20,0,20,0
1713487372639,LIIT 5BS,A00,507430,Carnelos; Chiara,20,0,20,0
1713487373664,LIIT 5CS,A00,507432,Carnelos; Chiara,20,0,20,0
1713487374694,LISP 5A,A00,507541,Munoz Sanchez; Alicia,14,0,20,6
1713487375724,LISP 5B,A00,507671,Munoz Sanchez; Alicia,12,0,20,8
1713487376749,LISP 5C,A00,507696,Munoz Sanchez; Alicia,11,0,20,9
1713487377778,MAE 197,001,528363,Boechler; Nicholas Sebastia,9998,0,9999,1
1713487378804,MATH 197,001,523477,Kedlaya; Kiran S.,9999,0,9999,0
1713487378804,MATH 197,002,563811,Zhang; Danna,9998,0,9999,1
1713487379829,MCWP 40R,A00,518780,Staff,16,0,20,4
1713487379829,MCWP 40R,B00,518781,Staff,14,0,20,6
1713487379829,MCWP 40R,C00,518783,Staff,11,0,20,9
1713487380854,MCWP 50R,A00,518791,Staff,8,0,20,12
1713487380854,MCWP 50R,B00,518792,Staff,5,0,20,15
1713487380854,MCWP 50R,C00,518793,Staff,7,0,20,13
1713487380854,MCWP 50R,D00,518794,Staff,0,0,20,20
1713487380854,MCWP 50R,E00,518795,Staff,3,0,20,17
1713487380854,MCWP 50R,F00,518796,Staff,13,0,20,7
1713487380854,MCWP 50R,G00,518797,Staff,12,0,20,8
1713487381880,MMW 12R,A01,514034,Herbst; Matthew,5,0,16,11
1713487381880,MMW 12R,A02,514035,Herbst; Matthew,13,0,16,3
1713487382906,MMW 13R,A01,514037,Staff,0,4,16,16
1713487382906,MMW 13R,A02,514039,Staff,0,4,16,16
1713487384960,SIO 295LS,A00,523233,Staff,15,0,30,15
1713487385987,SIO 295S,A00,523232,Staff,15,0,30,15
1713487387013,SOCI 117,A01,494376,Staff,0,2,5,5
1713487388038,WES 237B,A00,494380,Staff,19,0,20,1
1713487390107,AESE 279B,A00,494370,Wade; Jon P,33,0,33,0
1713487391133,AIP 197,001,627712,Vespa; Emanuel Ignacio,9999,0,9999,0
1713487392158,ANAR 135S,A00,494369,Braswell; Geoffrey E.,0,0,0,0
1713487393184,CAT 124RS,A01,519847,Geibel; William,6,0,20,14
1713487394212,CAT 125RS,A01,515971,Geibel; William,6,0,20,14
1713487395239,CLRE 250,A00,511389,Morris; Sheldon,9996,0,9999,3
1713487396269,CLRE 251,A00,507176,Mehta; Ravindra L.,9996,0,9999,3
1713487396269,CLRE 251,B00,511410,Mehta; Ravindra L.,9998,0,9999,1
1713487397295,CLRE 252,A00,507189,Cuomo; Raphael Eduardo,9998,0,9999,1
1713487398321,CLRE 253,A00,507199,Vaida; Florin,9997,0,9999,2
1713487398321,CLRE 253,B00,507202,Vaida; Florin,9999,0,9999,0
1713487399347,CLRE 259,A00,507211,Patel; Hemal,9996,0,9999,3
1713487400375,CLRE 260,A00,507221,Cuomo; Raphael Eduardo,9999,0,9999,0
1713487401400,CLRE 297,001,507242,Cuomo; Raphael Eduardo,9999,0,9999,0
1713487402430,CSE 191,A00,516875,Minnes Kemp; Mor Mia,9999,0,9999,0
1713487403462,CSS 201S,A01,494383,Staff,35,0,35,0
1713487404489,CSS 202S,A01,494387,Staff,35,0,35,0
1713487405516,EAP 100,A00,516065,Staff,9792,0,9999,207
1713487406542,ECE 45,A01,507414,Staff,38,0,60,22
1713487407571,ECE 100,A01,507416,Baghdadchi; Saharnaz,1,0,20,19
1713487407571,ECE 100,A02,507418,Baghdadchi; Saharnaz,19,0,20,1
1713487408596,ECE 111,A01,507420,Staff,27,0,50,23
1713487409659,ECE 197,001,548057,Sievenpiper; Daniel F.,9998,0,9999,1
1713487410686,EDS 115,A00,507243,Choi; Bailey Miyeon,27,0,28,1
1713487411719,EDS 117,A01,494379,Staff,16,0,25,9
1713487412752,EDS 125,A00,507246,Hopkins; Megan Beth,28,0,30,2
1713487413778,EDS 128A,A01,507264,Fargason; Sharon Gayle,26,0,26,0
1713487414804,EDS 128B,A01,507293,Pappas; Elizabeth,30,0,30,0
1713487415830,EDS 139,A00,507294,Fargason; Sharon Gayle,30,0,30,0
1713487415830,EDS 139,B00,507313,Pappas; Elizabeth,30,0,30,0
1713487416856,EDS 201,A00,507315,Staff,19,0,30,11
1713487417884,EDS 203,A01,507317,Halter; Christopher P.,18,0,30,12
1713487418910,EDS 204R,A01,507319,Halter; Christopher P.,0,1,30,30
1713487418910,EDS 204R,B01,507331,Heinzman; Erica M.,26,0,30,4
1713487419936,EDS 206R,A00,507332,Staff,0,2,30,30
1713487419936,EDS 206R,B00,507343,Staff,27,0,30,3
1713487420961,EDS 250,A00,507344,Hemans; Patricia Ann Benitez,28,0,40,12
1713487421986,EDS 281,A00,507345,Daly; Alan J.,18,0,18,0
1713487423012,EDS 284,A00,507350,Daly; Alan J.,16,0,16,0
1713487424040,EDS 286,A00,507359,Fine; Sarah,18,0,18,0
1713487425063,EDS 289C,A01,507361,Daly; Alan J.,18,0,18,0
1713487426088,EDS 290,A00,507366,Hofstetter; Carolyn,15,0,15,0
1713487427118,LIGM 5A,A00,507421,Fischer-Grunski; Eva K,20,0,20,0
1713487428147,LIGM 5B,A00,507423,Fischer-Grunski; Eva K,20,0,20,0
1713487429174,LIGM 5C,A00,507425,Fischer-Grunski; Eva K,20,0,20,0
1713487430199,LIIT 5AS,A00,507427,Carnelos; Chiara,20,0,20,0
1713487431225,LIIT 5BS,A00,507430,Carnelos; Chiara,20,0,20,0
1713487432250,LIIT 5CS,A00,507432,Carnelos; Chiara,20,0,20,0
1713487433277,LISP 5A,A00,507541,Munoz Sanchez; Alicia,14,0,20,6
1713487434305,LISP 5B,A00,507671,Munoz Sanchez; Alicia,12,0,20,8
1713487435331,LISP 5C,A00,507696,Munoz Sanchez; Alicia,11,0,20,9
1713487436360,MAE 197,001,528363,Boechler; Nicholas Sebastia,9998,0,9999,1
1713487437392,MATH 197,001,523477,Kedlaya; Kiran S.,9999,0,9999,0
1713487437392,MATH 197,002,563811,Zhang; Danna,9998,0,9999,1
1713487438418,MCWP 40R,A00,518780,Staff,16,0,20,4
1713487438418,MCWP 40R,B00,518781,Staff,14,0,20,6
1713487438418,MCWP 40R,C00,518783,Staff,11,0,20,9
1713487439450,MCWP 50R,A00,518791,Staff,8,0,20,12
1713487439450,MCWP 50R,B00,518792,Staff,5,0,20,15
1713487439450,MCWP 50R,C00,518793,Staff,7,0,20,13
1713487439450,MCWP 50R,D00,518794,Staff,0,0,20,20
1713487439450,MCWP 50R,E00,518795,Staff,3,0,20,17
1713487439450,MCWP 50R,F00,518796,Staff,13,0,20,7
1713487439450,MCWP 50R,G00,518797,Staff,12,0,20,8
1713487440475,MMW 12R,A01,514034,Herbst; Matthew,5,0,16,11
1713487440475,MMW 12R,A02,514035,Herbst; Matthew,13,0,16,3
1713487441502,MMW 13R,A01,514037,Staff,0,4,16,16
1713487441502,MMW 13R,A02,514039,Staff,0,4,16,16
1713487443555,SIO 295LS,A00,523233,Staff,15,0,30,15
1713487444581,SIO 295S,A00,523232,Staff,15,0,30,15
1713487445606,SOCI 117,A01,494376,Staff,0,2,5,5
1713487446632,WES 237B,A00,494380,Staff,19,0,20,1
1713487448707,AESE 279B,A00,494370,Wade; Jon P,33,0,33,0
1713487449732,AIP 197,001,627712,Vespa; Emanuel Ignacio,9999,0,9999,0
1713487450760,ANAR 135S,A00,494369,Braswell; Geoffrey E.,0,0,0,0
1713487451788,CAT 124RS,A01,519847,Geibel; William,6,0,20,14
1713487452813,CAT 125RS,A01,515971,Geibel; William,6,0,20,14
1713487453842,CLRE 250,A00,511389,Morris; Sheldon,9996,0,9999,3
1713487454876,CLRE 251,A00,507176,Mehta; Ravindra L.,9996,0,9999,3
1713487454876,CLRE 251,B00,511410,Mehta; Ravindra L.,9998,0,9999,1
1713487455903,CLRE 252,A00,507189,Cuomo; Raphael Eduardo,9998,0,9999,1
1713487456930,CLRE 253,A00,507199,Vaida; Florin,9997,0,9999,2
1713487456930,CLRE 253,B00,507202,Vaida; Florin,9999,0,9999,0
1713487457960,CLRE 259,A00,507211,Patel; Hemal,9996,0,9999,3
1713487458988,CLRE 260,A00,507221,Cuomo; Raphael Eduardo,9999,0,9999,0
1713487460013,CLRE 297,001,507242,Cuomo; Raphael Eduardo,9999,0,9999,0
1713487461039,CSE 191,A00,516875,Minnes Kemp; Mor Mia,9999,0,9999,0
1713487462064,CSS 201S,A01,494383,Staff,35,0,35,0
1713487463089,CSS 202S,A01,494387,Staff,35,0,35,0
1713487464114,EAP 100,A00,516065,Staff,9792,0,9999,207
1713487465143,ECE 45,A01,507414,Staff,38,0,60,22
1713487466172,ECE 100,A01,507416,Baghdadchi; Saharnaz,1,0,20,19
1713487466172,ECE 100,A02,507418,Baghdadchi; Saharnaz,19,0,20,1
1713487467197,ECE 111,A01,507420,Staff,27,0,50,23
1713487468293,ECE 197,001,548057,Sievenpiper; Daniel F.,9998,0,9999,1
1713487469320,EDS 115,A00,507243,Choi; Bailey Miyeon,27,0,28,1
1713487470346,EDS 117,A01,494379,Staff,16,0,25,9
1713487471376,EDS 125,A00,507246,Hopkins; Megan Beth,28,0,30,2
1713487472401,EDS 128A,A01,507264,Fargason; Sharon Gayle,26,0,26,0
1713487473427,EDS 128B,A01,507293,Pappas; Elizabeth,30,0,30,0
1713487474453,EDS 139,A00,507294,Fargason; Sharon Gayle,30,0,30,0
1713487474453,EDS 139,B00,507313,Pappas; Elizabeth,30,0,30,0
1713487475478,EDS 201,A00,507315,Staff,19,0,30,11
1713487476504,EDS 203,A01,507317,Halter; Christopher P.,18,0,30,12
1713487477533,EDS 204R,A01,507319,Halter; Christopher P.,0,1,30,30
1713487477533,EDS 204R,B01,507331,Heinzman; Erica M.,26,0,30,4
1713487478558,EDS 206R,A00,507332,Staff,0,2,30,30
1713487478558,EDS 206R,B00,507343,Staff,27,0,30,3
1713487479588,EDS 250,A00,507344,Hemans; Patricia Ann Benitez,28,0,40,12
1713487480614,EDS 281,A00,507345,Daly; Alan J.,18,0,18,0
1713487481639,EDS 284,A00,507350,Daly; Alan J.,16,0,16,0
1713487482668,EDS 286,A00,507359,Fine; Sarah,18,0,18,0
1713487483697,EDS 289C,A01,507361,Daly; Alan J.,18,0,18,0
1713487484727,EDS 290,A00,507366,Hofstetter; Carolyn,15,0,15,0
1713487485756,LIGM 5A,A00,507421,Fischer-Grunski; Eva K,20,0,20,0
1713487486784,LIGM 5B,A00,507423,Fischer-Grunski; Eva K,20,0,20,0
1713487487811,LIGM 5C,A00,507425,Fischer-Grunski; Eva K,20,0,20,0
1713487488838,LIIT 5AS,A00,507427,Carnelos; Chiara,20,0,20,0
1713487489867,LIIT 5BS,A00,507430,Carnelos; Chiara,20,0,20,0
1713487490893,LIIT 5CS,A00,507432,Carnelos; Chiara,20,0,20,0
1713487491919,LISP 5A,A00,507541,Munoz Sanchez; Alicia,14,0,20,6
1713487492945,LISP 5B,A00,507671,Munoz Sanchez; Alicia,12,0,20,8
1713487493971,LISP 5C,A00,507696,Munoz Sanchez; Alicia,11,0,20,9
1713487494999,MAE 197,001,528363,Boechler; Nicholas Sebastia,9998,0,9999,1
1713487496025,MATH 197,001,523477,Kedlaya; Kiran S.,9999,0,9999,0
1713487496025,MATH 197,002,563811,Zhang; Danna,9998,0,9999,1
1713487497056,MCWP 40R,A00,518780,Staff,16,0,20,4
1713487497056,MCWP 40R,B00,518781,Staff,14,0,20,6
1713487497056,MCWP 40R,C00,518783,Staff,11,0,20,9
1713487498082,MCWP 50R,A00,518791,Staff,8,0,20,12
1713487498082,MCWP 50R,B00,518792,Staff,5,0,20,15
1713487498082,MCWP 50R,C00,518793,Staff,7,0,20,13
1713487498082,MCWP 50R,D00,518794,Staff,0,0,20,20
1713487498082,MCWP 50R,E00,518795,Staff,3,0,20,17
1713487498082,MCWP 50R,F00,518796,Staff,13,0,20,7
1713487498082,MCWP 50R,G00,518797,Staff,12,0,20,8
1713487499113,MMW 12R,A01,514034,Herbst; Matthew,5,0,16,11
1713487499113,MMW 12R,A02,514035,Herbst; Matthew,13,0,16,3
1713487500139,MMW 13R,A01,514037,Staff,0,4,16,16
1713487500139,MMW 13R,A02,514039,Staff,0,4,16,16
1713487502192,SIO 295LS,A00,523233,Staff,15,0,30,15
1713487503217,SIO 295S,A00,523232,Staff,15,0,30,15
1713487504242,SOCI 117,A01,494376,Staff,0,2,5,5
1713487505271,WES 237B,A00,494380,Staff,19,0,20,1
1713487507337,AESE 279B,A00,494370,Wade; Jon P,33,0,33,0
1713487508366,AIP 197,001,627712,Vespa; Emanuel Ignacio,9999,0,9999,0
1713487509391,ANAR 135S,A00,494369,Braswell; Geoffrey E.,0,0,0,0
1713487510421,CAT 124RS,A01,519847,Geibel; William,6,0,20,14
1713487511450,CAT 125RS,A01,515971,Geibel; William,6,0,20,14
1713487512476,CLRE 250,A00,511389,Morris; Sheldon,9996,0,9999,3
1713487513504,CLRE 251,A00,507176,Mehta; Ravindra L.,9996,0,9999,3
1713487513504,CLRE 251,B00,511410,Mehta; Ravindra L.,9998,0,9999,1
1713487514529,CLRE 252,A00,507189,Cuomo; Raphael Eduardo,9998,0,9999,1
1713487515557,CLRE 253,A00,507199,Vaida; Florin,9997,0,9999,2
1713487515557,CLRE 253,B00,507202,Vaida; Florin,9999,0,9999,0
1713487516585,CLRE 259,A00,507211,Patel; Hemal,9996,0,9999,3
1713487517609,CLRE 260,A00,507221,Cuomo; Raphael Eduardo,9999,0,9999,0
1713487518634,CLRE 297,001,507242,Cuomo; Raphael Eduardo,9999,0,9999,0
1713487519659,CSE 191,A00,516875,Minnes Kemp; Mor Mia,9999,0,9999,0
1713487520684,CSS 201S,A01,494383,Staff,35,0,35,0
1713487521711,CSS 202S,A01,494387,Staff,35,0,35,0
1713487522738,EAP 100,A00,516065,Staff,9792,0,9999,207
1713487523763,ECE 45,A01,507414,Staff,38,0,60,22
1713487524789,ECE 100,A01,507416,Baghdadchi; Saharnaz,1,0,20,19
1713487524789,ECE 100,A02,507418,Baghdadchi; Saharnaz,19,0,20,1
1713487525814,ECE 111,A01,507420,Staff,27,0,50,23
1713487526839,ECE 197,001,548057,Sievenpiper; Daniel F.,9998,0,9999,1
1713487527865,EDS 115,A00,507243,Choi; Bailey Miyeon,27,0,28,1
1713487528892,EDS 117,A01,494379,Staff,16,0,25,9
1713487529917,EDS 125,A00,507246,Hopkins; Megan Beth,28,0,30,2
1713487530947,EDS 128A,A01,507264,Fargason; Sharon Gayle,26,0,26,0
1713487531975,EDS 128B,A01,507293,Pappas; Elizabeth,30,0,30,0
1713487533000,EDS 139,A00,507294,Fargason; Sharon Gayle,30,0,30,0
1713487533000,EDS 139,B00,507313,Pappas; Elizabeth,30,0,30,0
1713487534027,EDS 201,A00,507315,Staff,19,0,30,11
1713487535053,EDS 203,A01,507317,Halter; Christopher P.,18,0,30,12
1713487536082,EDS 204R,A01,507319,Halter; Christopher P.,0,1,30,30
1713487536082,EDS 204R,B01,507331,Heinzman; Erica M.,26,0,30,4
1713487537111,EDS 206R,A00,507332,Staff,0,2,30,30
1713487537111,EDS 206R,B00,507343,Staff,27,0,30,3
1713487538140,EDS 250,A00,507344,Hemans; Patricia Ann Benitez,28,0,40,12
1713487539165,EDS 281,A00,507345,Daly; Alan J.,18,0,18,0
1713487540191,EDS 284,A00,507350,Daly; Alan J.,16,0,16,0
1713487541215,EDS 286,A00,507359,Fine; Sarah,18,0,18,0
1713487542242,EDS 289C,A01,507361,Daly; Alan J.,18,0,18,0
1713487543272,EDS 290,A00,507366,Hofstetter; Carolyn,15,0,15,0
1713487544303,LIGM 5A,A00,507421,Fischer-Grunski; Eva K,20,0,20,0
1713487545333,LIGM 5B,A00,507423,Fischer-Grunski; Eva K,20,0,20,0
1713487546360,LIGM 5C,A00,507425,Fischer-Grunski; Eva K,20,0,20,0
1713487547386,LIIT 5AS,A00,507427,Carnelos; Chiara,20,0,20,0
1713487548411,LIIT 5BS,A00,507430,Carnelos; Chiara,20,0,20,0
1713487549434,LIIT 5CS,A00,507432,Carnelos; Chiara,20,0,20,0
1713487550461,LISP 5A,A00,507541,Munoz Sanchez; Alicia,14,0,20,6
1713487551489,LISP 5B,A00,507671,Munoz Sanchez; Alicia,12,0,20,8
1713487552514,LISP 5C,A00,507696,Munoz Sanchez; Alicia,11,0,20,9
1713487553543,MAE 197,001,528363,Boechler; Nicholas Sebastia,9998,0,9999,1
1713487554570,MATH 197,001,523477,Kedlaya; Kiran S.,9999,0,9999,0
1713487554570,MATH 197,002,563811,Zhang; Danna,9998,0,9999,1
1713487555595,MCWP 40R,A00,518780,Staff,16,0,20,4
1713487555595,MCWP 40R,B00,518781,Staff,14,0,20,6
1713487555595,MCWP 40R,C00,518783,Staff,11,0,20,9
1713487556621,MCWP 50R,A00,518791,Staff,8,0,20,12
1713487556621,MCWP 50R,B00,518792,Staff,5,0,20,15
1713487556621,MCWP 50R,C00,518793,Staff,7,0,20,13
1713487556621,MCWP 50R,D00,518794,Staff,0,0,20,20
1713487556621,MCWP 50R,E00,518795,Staff,3,0,20,17
1713487556621,MCWP 50R,F00,518796,Staff,13,0,20,7
1713487556621,MCWP 50R,G00,518797,Staff,12,0,20,8
1713487557645,MMW 12R,A01,514034,Herbst; Matthew,5,0,16,11
1713487557645,MMW 12R,A02,514035,Herbst; Matthew,13,0,16,3
1713487558669,MMW 13R,A01,514037,Staff,0,4,16,16
1713487558669,MMW 13R,A02,514039,Staff,0,4,16,16
1713487560721,SIO 295LS,A00,523233,Staff,15,0,30,15
1713487561747,SIO 295S,A00,523232,Staff,15,0,30,15
1713487562772,SOCI 117,A01,494376,Staff,0,2,5,5
1713487563797,WES 237B,A00,494380,Staff,19,0,20,1
1713487565860,AESE 279B,A00,494370,Wade; Jon P,33,0,33,0
1713487566885,AIP 197,001,627712,Vespa; Emanuel Ignacio,9999,0,9999,0
1713487567910,ANAR 135S,A00,494369,Braswell; Geoffrey E.,0,0,0,0
1713487568937,CAT 124RS,A01,519847,Geibel; William,6,0,20,14
1713487569962,CAT 125RS,A01,515971,Geibel; William,6,0,20,14
1713487570987,CLRE 250,A00,511389,Morris; Sheldon,9996,0,9999,3
1713487572071,CLRE 251,A00,507176,Mehta; Ravindra L.,9996,0,9999,3
1713487572071,CLRE 251,B00,511410,Mehta; Ravindra L.,9998,0,9999,1
1713487573102,CLRE 252,A00,507189,Cuomo; Raphael Eduardo,9998,0,9999,1
1713487574132,CLRE 253,A00,507199,Vaida; Florin,9997,0,9999,2
1713487574132,CLRE 253,B00,507202,Vaida; Florin,9999,0,9999,0
1713487575156,CLRE 259,A00,507211,Patel; Hemal,9996,0,9999,3
1713487576181,CLRE 260,A00,507221,Cuomo; Raphael Eduardo,9999,0,9999,0
1713487577208,CLRE 297,001,507242,Cuomo; Raphael Eduardo,9999,0,9999,0
1713487578237,CSE 191,A00,516875,Minnes Kemp; Mor Mia,9999,0,9999,0
1713487579267,CSS 201S,A01,494383,Staff,35,0,35,0
1713487580294,CSS 202S,A01,494387,Staff,35,0,35,0
1713487581318,EAP 100,A00,516065,Staff,9792,0,9999,207
1713487582346,ECE 45,A01,507414,Staff,38,0,60,22
1713487583375,ECE 100,A01,507416,Baghdadchi; Saharnaz,1,0,20,19
1713487583375,ECE 100,A02,507418,Baghdadchi; Saharnaz,19,0,20,1
1713487584403,ECE 111,A01,507420,Staff,27,0,50,23
1713487585433,ECE 197,001,548057,Sievenpiper; Daniel F.,9998,0,9999,1
1713487586460,EDS 115,A00,507243,Choi; Bailey Miyeon,27,0,28,1
1713487587485,EDS 117,A01,494379,Staff,16,0,25,9
1713487588510,EDS 125,A00,507246,Hopkins; Megan Beth,28,0,30,2
1713487589535,EDS 128A,A01,507264,Fargason; Sharon Gayle,26,0,26,0
1713487590564,EDS 128B,A01,507293,Pappas; Elizabeth,30,0,30,0
1713487591590,EDS 139,A00,507294,Fargason; Sharon Gayle,30,0,30,0
1713487591590,EDS 139,B00,507313,Pappas; Elizabeth,30,0,30,0
1713487592615,EDS 201,A00,507315,Staff,19,0,30,11
1713487593640,EDS 203,A01,507317,Halter; Christopher P.,18,0,30,12
1713487594665,EDS 204R,A01,507319,Halter; Christopher P.,0,1,30,30
1713487594665,EDS 204R,B01,507331,Heinzman; Erica M.,26,0,30,4
1713487595698,EDS 206R,A00,507332,Staff,0,2,30,30
1713487595698,EDS 206R,B00,507343,Staff,27,0,30,3
1713487596727,EDS 250,A00,507344,Hemans; Patricia Ann Benitez,28,0,40,12
1713487597751,EDS 281,A00,507345,Daly; Alan J.,18,0,18,0
1713487598776,EDS 284,A00,507350,Daly; Alan J.,16,0,16,0
1713487599802,EDS 286,A00,507359,Fine; Sarah,18,0,18,0
1713487600830,EDS 289C,A01,507361,Daly; Alan J.,18,0,18,0
1713487601859,EDS 290,A00,507366,Hofstetter; Carolyn,15,0,15,0
1713487602885,LIGM 5A,A00,507421,Fischer-Grunski; Eva K,20,0,20,0
1713487603908,LIGM 5B,A00,507423,Fischer-Grunski; Eva K,20,0,20,0
1713487604933,LIGM 5C,A00,507425,Fischer-Grunski; Eva K,20,0,20,0
1713487605959,LIIT 5AS,A00,507427,Carnelos; Chiara,20,0,20,0
1713487606984,LIIT 5BS,A00,507430,Carnelos; Chiara,20,0,20,0
1713487608009,LIIT 5CS,A00,507432,Carnelos; Chiara,20,0,20,0
1713487609035,LISP 5A,A00,507541,Munoz Sanchez; Alicia,14,0,20,6
1713487610063,LISP 5B,A00,507671,Munoz Sanchez; Alicia,12,0,20,8
1713487611094,LISP 5C,A00,507696,Munoz Sanchez; Alicia,11,0,20,9
1713487612119,MAE 197,001,528363,Boechler; Nicholas Sebastia,9998,0,9999,1
1713487613149,MATH 197,001,523477,Kedlaya; Kiran S.,9999,0,9999,0
1713487613149,MATH 197,002,563811,Zhang; Danna,9998,0,9999,1
1713487614178,MCWP 40R,A00,518780,Staff,16,0,20,4
1713487614178,MCWP 40R,B00,518781,Staff,14,0,20,6
1713487614178,MCWP 40R,C00,518783,Staff,11,0,20,9
1713487615206,MCWP 50R,A00,518791,Staff,8,0,20,12
1713487615206,MCWP 50R,B00,518792,Staff,5,0,20,15
1713487615206,MCWP 50R,C00,518793,Staff,7,0,20,13
1713487615206,MCWP 50R,D00,518794,Staff,0,0,20,20
1713487615206,MCWP 50R,E00,518795,Staff,3,0,20,17
1713487615206,MCWP 50R,F00,518796,Staff,13,0,20,7
1713487615206,MCWP 50R,G00,518797,Staff,12,0,20,8
1713487616231,MMW 12R,A01,514034,Herbst; Matthew,5,0,16,11
1713487616231,MMW 12R,A02,514035,Herbst; Matthew,13,0,16,3
1713487617258,MMW 13R,A01,514037,Staff,0,4,16,16
1713487617258,MMW 13R,A02,514039,Staff,0,4,16,16
1713487619314,SIO 295LS,A00,523233,Staff,15,0,30,15
1713487620340,SIO 295S,A00,523232,Staff,15,0,30,15
1713487621368,SOCI 117,A01,494376,Staff,0,2,5,5
1713487622396,WES 237B,A00,494380,Staff,19,0,20,1
1713487624475,AESE 279B,A00,494370,Wade; Jon P,33,0,33,0
1713487625501,AIP 197,001,627712,Vespa; Emanuel Ignacio,9999,0,9999,0
1713487626530,ANAR 135S,A00,494369,Braswell; Geoffrey E.,0,0,0,0
1713487627554,CAT 124RS,A01,519847,Geibel; William,6,0,20,14
1713487628580,CAT 125RS,A01,515971,Geibel; William,6,0,20,14
1713487629605,CLRE 250,A00,511389,Morris; Sheldon,9996,0,9999,3
1713487630630,CLRE 251,A00,507176,Mehta; Ravindra L.,9996,0,9999,3
1713487630630,CLRE 251,B00,511410,Mehta; Ravindra L.,9998,0,9999,1
1713487631659,CLRE 252,A00,507189,Cuomo; Raphael Eduardo,9998,0,9999,1
1713487632688,CLRE 253,A00,507199,Vaida; Florin,9997,0,9999,2
1713487632688,CLRE 253,B00,507202,Vaida; Florin,9999,0,9999,0
1713487633713,CLRE 259,A00,507211,Patel; Hemal,9996,0,9999,3
1713487634739,CLRE 260,A00,507221,Cuomo; Raphael Eduardo,9999,0,9999,0
1713487635763,CLRE 297,001,507242,Cuomo; Raphael Eduardo,9999,0,9999,0
1713487636795,CSE 191,A00,516875,Minnes Kemp; Mor Mia,9999,0,9999,0
1713487637820,CSS 201S,A01,494383,Staff,35,0,35,0
1713487638847,CSS 202S,A01,494387,Staff,35,0,35,0
1713487639871,EAP 100,A00,516065,Staff,9792,0,9999,207
1713487640898,ECE 45,A01,507414,Staff,38,0,60,22
1713487641924,ECE 100,A01,507416,Baghdadchi; Saharnaz,1,0,20,19
1713487641924,ECE 100,A02,507418,Baghdadchi; Saharnaz,19,0,20,1
1713487642955,ECE 111,A01,507420,Staff,27,0,50,23
1713487643983,ECE 197,001,548057,Sievenpiper; Daniel F.,9998,0,9999,1
1713487645011,EDS 115,A00,507243,Choi; Bailey Miyeon,27,0,28,1
1713487646037,EDS 117,A01,494379,Staff,16,0,25,9
1713487647066,EDS 125,A00,507246,Hopkins; Megan Beth,28,0,30,2
1713487648094,EDS 128A,A01,507264,Fargason; Sharon Gayle,26,0,26,0
1713487649123,EDS 128B,A01,507293,Pappas; Elizabeth,30,0,30,0
1713487650148,EDS 139,A00,507294,Fargason; Sharon Gayle,30,0,30,0
1713487650148,EDS 139,B00,507313,Pappas; Elizabeth,30,0,30,0
1713487651175,EDS 201,A00,507315,Staff,19,0,30,11
1713487652200,EDS 203,A01,507317,Halter; Christopher P.,18,0,30,12
1713487653228,EDS 204R,A01,507319,Halter; Christopher P.,0,1,30,30
1713487653228,EDS 204R,B01,507331,Heinzman; Erica M.,26,0,30,4
1713487654252,EDS 206R,A00,507332,Staff,0,2,30,30
1713487654252,EDS 206R,B00,507343,Staff,27,0,30,3
1713487655276,EDS 250,A00,507344,Hemans; Patricia Ann Benitez,28,0,40,12
1713487656304,EDS 281,A00,507345,Daly; Alan J.,18,0,18,0
1713487657331,EDS 284,A00,507350,Daly; Alan J.,16,0,16,0
1713487658356,EDS 286,A00,507359,Fine; Sarah,18,0,18,0
1713487659384,EDS 289C,A01,507361,Daly; Alan J.,18,0,18,0
1713487660408,EDS 290,A00,507366,Hofstetter; Carolyn,15,0,15,0
1713487661435,LIGM 5A,A00,507421,Fischer-Grunski; Eva K,20,0,20,0
1713487662464,LIGM 5B,A00,507423,Fischer-Grunski; Eva K,20,0,20,0
1713487663489,LIGM 5C,A00,507425,Fischer-Grunski; Eva K,20,0,20,0
1713487664515,LIIT 5AS,A00,507427,Carnelos; Chiara,20,0,20,0
1713487665541,LIIT 5BS,A00,507430,Carnelos; Chiara,20,0,20,0
1713487666565,LIIT 5CS,A00,507432,Carnelos; Chiara,20,0,20,0
1713487667595,LISP 5A,A00,507541,Munoz Sanchez; Alicia,14,0,20,6
1713487668624,LISP 5B,A00,507671,Munoz Sanchez; Alicia,12,0,20,8
1713487669652,LISP 5C,A00,507696,Munoz Sanchez; Alicia,11,0,20,9
1713487670681,MAE 197,001,528363,Boechler; Nicholas Sebastia,9998,0,9999,1
1713487671711,MATH 197,001,523477,Kedlaya; Kiran S.,9999,0,9999,0
1713487671711,MATH 197,002,563811,Zhang; Danna,9998,0,9999,1
1713487672736,MCWP 40R,A00,518780,Staff,16,0,20,4
1713487672736,MCWP 40R,B00,518781,Staff,14,0,20,6
1713487672736,MCWP 40R,C00,518783,Staff,11,0,20,9
1713487673767,MCWP 50R,A00,518791,Staff,8,0,20,12
1713487673767,MCWP 50R,B00,518792,Staff,5,0,20,15
1713487673767,MCWP 50R,C00,518793,Staff,7,0,20,13
1713487673767,MCWP 50R,D00,518794,Staff,0,0,20,20
1713487673767,MCWP 50R,E00,518795,Staff,3,0,20,17
1713487673767,MCWP 50R,F00,518796,Staff,13,0,20,7
1713487673767,MCWP 50R,G00,518797,Staff,12,0,20,8
1713487674797,MMW 12R,A01,514034,Herbst; Matthew,5,0,16,11
1713487674797,MMW 12R,A02,514035,Herbst; Matthew,13,0,16,3
1713487675880,MMW 13R,A01,514037,Staff,0,4,16,16
1713487675880,MMW 13R,A02,514039,Staff,0,4,16,16
1713487677932,SIO 295LS,A00,523233,Staff,15,0,30,15
1713487678958,SIO 295S,A00,523232,Staff,15,0,30,15
1713487679987,SOCI 117,A01,494376,Staff,0,2,5,5
1713487681015,WES 237B,A00,494380,Staff,19,0,20,1
1713487683084,AESE 279B,A00,494370,Wade; Jon P,33,0,33,0
1713487684108,AIP 197,001,627712,Vespa; Emanuel Ignacio,9999,0,9999,0
1713487685134,ANAR 135S,A00,494369,Braswell; Geoffrey E.,0,0,0,0
1713487686164,CAT 124RS,A01,519847,Geibel; William,6,0,20,14
1713487687189,CAT 125RS,A01,515971,Geibel; William,6,0,20,14
1713487688215,CLRE 250,A00,511389,Morris; Sheldon,9996,0,9999,3
1713487689245,CLRE 251,A00,507176,Mehta; Ravindra L.,9996,0,9999,3
1713487689245,CLRE 251,B00,511410,Mehta; Ravindra L.,9998,0,9999,1
1713487690276,CLRE 252,A00,507189,Cuomo; Raphael Eduardo,9998,0,9999,1
1713487691307,CLRE 253,A00,507199,Vaida; Florin,9997,0,9999,2
1713487691307,CLRE 253,B00,507202,Vaida; Florin,9999,0,9999,0
1713487692332,CLRE 259,A00,507211,Patel; Hemal,9996,0,9999,3
1713487693360,CLRE 260,A00,507221,Cuomo; Raphael Eduardo,9999,0,9999,0
1713487694389,CLRE 297,001,507242,Cuomo; Raphael Eduardo,9999,0,9999,0
1713487695417,CSE 191,A00,516875,Minnes Kemp; Mor Mia,9999,0,9999,0
1713487696445,CSS 201S,A01,494383,Staff,35,0,35,0
1713487697476,CSS 202S,A01,494387,Staff,35,0,35,0
1713487698502,EAP 100,A00,516065,Staff,9792,0,9999,207
1713487699532,ECE 45,A01,507414,Staff,38,0,60,22
1713487700560,ECE 100,A01,507416,Baghdadchi; Saharnaz,1,0,20,19
1713487700560,ECE 100,A02,507418,Baghdadchi; Saharnaz,19,0,20,1
1713487701588,ECE 111,A01,507420,Staff,27,0,50,23
1713487702616,ECE 197,001,548057,Sievenpiper; Daniel F.,9998,0,9999,1
1713487703647,EDS 115,A00,507243,Choi; Bailey Miyeon,27,0,28,1
1713487704672,EDS 117,A01,494379,Staff,16,0,25,9
1713487705701,EDS 125,A00,507246,Hopkins; Megan Beth,28,0,30,2
1713487706728,EDS 128A,A01,507264,Fargason; Sharon Gayle,26,0,26,0
1713487707754,EDS 128B,A01,507293,Pappas; Elizabeth,30,0,30,0
1713487708780,EDS 139,A00,507294,Fargason; Sharon Gayle,30,0,30,0
1713487708780,EDS 139,B00,507313,Pappas; Elizabeth,30,0,30,0
1713487709804,EDS 201,A00,507315,Staff,19,0,30,11
1713487710830,EDS 203,A01,507317,Halter; Christopher P.,18,0,30,12
1713487711854,EDS 204R,A01,507319,Halter; Christopher P.,0,1,30,30
1713487711854,EDS 204R,B01,507331,Heinzman; Erica M.,26,0,30,4
1713487712879,EDS 206R,A00,507332,Staff,0,2,30,30
1713487712879,EDS 206R,B00,507343,Staff,27,0,30,3
1713487713910,EDS 250,A00,507344,Hemans; Patricia Ann Benitez,28,0,40,12
1713487714935,EDS 281,A00,507345,Daly; Alan J.,18,0,18,0
1713487715959,EDS 284,A00,507350,Daly; Alan J.,16,0,16,0
1713487716986,EDS 286,A00,507359,Fine; Sarah,18,0,18,0
1713487718012,EDS 289C,A01,507361,Daly; Alan J.,18,0,18,0
1713487719036,EDS 290,A00,507366,Hofstetter; Carolyn,15,0,15,0
1713487720068,LIGM 5A,A00,507421,Fischer-Grunski; Eva K,20,0,20,0
1713487721094,LIGM 5B,A00,507423,Fischer-Grunski; Eva K,20,0,20,0
1713487722119,LIGM 5C,A00,507425,Fischer-Grunski; Eva K,20,0,20,0
1713487723144,LIIT 5AS,A00,507427,Carnelos; Chiara,20,0,20,0
1713487724169,LIIT 5BS,A00,507430,Carnelos; Chiara,20,0,20,0
1713487725199,LIIT 5CS,A00,507432,Carnelos; Chiara,20,0,20,0
1713487726226,LISP 5A,A00,507541,Munoz Sanchez; Alicia,14,0,20,6
1713487727258,LISP 5B,A00,507671,Munoz Sanchez; Alicia,12,0,20,8
1713487728284,LISP 5C,A00,507696,Munoz Sanchez; Alicia,11,0,20,9
1713487729312,MAE 197,001,528363,Boechler; Nicholas Sebastia,9998,0,9999,1
1713487730342,MATH 197,001,523477,Kedlaya; Kiran S.,9999,0,9999,0
1713487730342,MATH 197,002,563811,Zhang; Danna,9998,0,9999,1
1713487731375,MCWP 40R,A00,518780,Staff,16,0,20,4
1713487731375,MCWP 40R,B00,518781,Staff,14,0,20,6
1713487731375,MCWP 40R,C00,518783,Staff,11,0,20,9
1713487732401,MCWP 50R,A00,518791,Staff,8,0,20,12
1713487732401,MCWP 50R,B00,518792,Staff,5,0,20,15
1713487732401,MCWP 50R,C00,518793,Staff,7,0,20,13
1713487732401,MCWP 50R,D00,518794,Staff,0,0,20,20
1713487732401,MCWP 50R,E00,518795,Staff,3,0,20,17
1713487732401,MCWP 50R,F00,518796,Staff,13,0,20,7
1713487732401,MCWP 50R,G00,518797,Staff,12,0,20,8
1713487733430,MMW 12R,A01,514034,Herbst; Matthew,5,0,16,11
1713487733430,MMW 12R,A02,514035,Herbst; Matthew,13,0,16,3
1713487734458,MMW 13R,A01,514037,Staff,0,4,16,16
1713487734458,MMW 13R,A02,514039,Staff,0,4,16,16
1713487736511,SIO 295LS,A00,523233,Staff,15,0,30,15
1713487737537,SIO 295S,A00,523232,Staff,15,0,30,15
1713487738566,SOCI 117,A01,494376,Staff,0,2,5,5
1713487739594,WES 237B,A00,494380,Staff,19,0,20,1
1713487741664,AESE 279B,A00,494370,Wade; Jon P,33,0,33,0
1713487742692,AIP 197,001,627712,Vespa; Emanuel Ignacio,9999,0,9999,0
1713487743721,ANAR 135S,A00,494369,Braswell; Geoffrey E.,0,0,0,0
1713487744747,CAT 124RS,A01,519847,Geibel; William,6,0,20,14
1713487745771,CAT 125RS,A01,515971,Geibel; William,6,0,20,14
1713487746799,CLRE 250,A00,511389,Morris; Sheldon,9996,0,9999,3
1713487747826,CLRE 251,A00,507176,Mehta; Ravindra L.,9996,0,9999,3
1713487747826,CLRE 251,B00,511410,Mehta; Ravindra L.,9998,0,9999,1
1713487748856,CLRE 252,A00,507189,Cuomo; Raphael Eduardo,9998,0,9999,1
1713487749882,CLRE 253,A00,507199,Vaida; Florin,9997,0,9999,2
1713487749882,CLRE 253,B00,507202,Vaida; Florin,9999,0,9999,0
1713487750911,CLRE 259,A00,507211,Patel; Hemal,9996,0,9999,3
1713487751937,CLRE 260,A00,507221,Cuomo; Raphael Eduardo,9999,0,9999,0
1713487752962,CLRE 297,001,507242,Cuomo; Raphael Eduardo,9999,0,9999,0
1713487753990,CSE 191,A00,516875,Minnes Kemp; Mor Mia,9999,0,9999,0
1713487755017,CSS 201S,A01,494383,Staff,35,0,35,0
1713487756044,CSS 202S,A01,494387,Staff,35,0,35,0
1713487757069,EAP 100,A00,516065,Staff,9792,0,9999,207
1713487758284,ECE 45,A01,507414,Staff,38,0,60,22
1713487759313,ECE 100,A01,507416,Baghdadchi; Saharnaz,1,0,20,19
1713487759313,ECE 100,A02,507418,Baghdadchi; Saharnaz,19,0,20,1
1713487760338,ECE 111,A01,507420,Staff,27,0,50,23
1713487761365,ECE 197,001,548057,Sievenpiper; Daniel F.,9998,0,9999,1
1713487762394,EDS 115,A00,507243,Choi; Bailey Miyeon,27,0,28,1
1713487763421,EDS 117,A01,494379,Staff,16,0,25,9
1713487764452,EDS 125,A00,507246,Hopkins; Megan Beth,28,0,30,2
1713487765479,EDS 128A,A01,507264,Fargason; Sharon Gayle,26,0,26,0
1713487766504,EDS 128B,A01,507293,Pappas; Elizabeth,30,0,30,0
1713487767532,EDS 139,A00,507294,Fargason; Sharon Gayle,30,0,30,0
1713487767532,EDS 139,B00,507313,Pappas; Elizabeth,30,0,30,0
1713487768561,EDS 201,A00,507315,Staff,19,0,30,11
1713487769587,EDS 203,A01,507317,Halter; Christopher P.,18,0,30,12
1713487770610,EDS 204R,A01,507319,Halter; Christopher P.,0,1,30,30
1713487770610,EDS 204R,B01,507331,Heinzman; Erica M.,26,0,30,4
1713487771634,EDS 206R,A00,507332,Staff,0,2,30,30
1713487771634,EDS 206R,B00,507343,Staff,27,0,30,3
1713487772660,EDS 250,A00,507344,Hemans; Patricia Ann Benitez,28,0,40,12
1713487773689,EDS 281,A00,507345,Daly; Alan J.,18,0,18,0
1713487774713,EDS 284,A00,507350,Daly; Alan J.,16,0,16,0
1713487775738,EDS 286,A00,507359,Fine; Sarah,18,0,18,0
1713487776767,EDS 289C,A01,507361,Daly; Alan J.,18,0,18,0
1713487777796,EDS 290,A00,507366,Hofstetter; Carolyn,15,0,15,0
1713487778823,LIGM 5A,A00,507421,Fischer-Grunski; Eva K,20,0,20,0
1713487779902,LIGM 5B,A00,507423,Fischer-Grunski; Eva K,20,0,20,0
1713487780927,LIGM 5C,A00,507425,Fischer-Grunski; Eva K,20,0,20,0
1713487781955,LIIT 5AS,A00,507427,Carnelos; Chiara,20,0,20,0
1713487782984,LIIT 5BS,A00,507430,Carnelos; Chiara,20,0,20,0
1713487784009,LIIT 5CS,A00,507432,Carnelos; Chiara,20,0,20,0
1713487785042,LISP 5A,A00,507541,Munoz Sanchez; Alicia,14,0,20,6
1713487786068,LISP 5B,A00,507671,Munoz Sanchez; Alicia,12,0,20,8
1713487787097,LISP 5C,A00,507696,Munoz Sanchez; Alicia,11,0,20,9
1713487788125,MAE 197,001,528363,Boechler; Nicholas Sebastia,9998,0,9999,1
1713487789157,MATH 197,001,523477,Kedlaya; Kiran S.,9999,0,9999,0
1713487789157,MATH 197,002,563811,Zhang; Danna,9998,0,9999,1
1713487790182,MCWP 40R,A00,518780,Staff,16,0,20,4
1713487790182,MCWP 40R,B00,518781,Staff,14,0,20,6
1713487790182,MCWP 40R,C00,518783,Staff,11,0,20,9
1713487791208,MCWP 50R,A00,518791,Staff,8,0,20,12
1713487791208,MCWP 50R,B00,518792,Staff,5,0,20,15
1713487791208,MCWP 50R,C00,518793,Staff,7,0,20,13
1713487791208,MCWP 50R,D00,518794,Staff,0,0,20,20
1713487791208,MCWP 50R,E00,518795,Staff,3,0,20,17
1713487791208,MCWP 50R,F00,518796,Staff,13,0,20,7
1713487791208,MCWP 50R,G00,518797,Staff,12,0,20,8
1713487792238,MMW 12R,A01,514034,Herbst; Matthew,5,0,16,11
1713487792238,MMW 12R,A02,514035,Herbst; Matthew,13,0,16,3
1713487793266,MMW 13R,A01,514037,Staff,0,4,16,16
1713487793266,MMW 13R,A02,514039,Staff,0,4,16,16
1713487795318,SIO 295LS,A00,523233,Staff,15,0,30,15
1713487796346,SIO 295S,A00,523232,Staff,15,0,30,15
1713487797372,SOCI 117,A01,494376,Staff,0,2,5,5
1713487798399,WES 237B,A00,494380,Staff,19,0,20,1
1713487800481,AESE 279B,A00,494370,Wade; Jon P,33,0,33,0
1713487801509,AIP 197,001,627712,Vespa; Emanuel Ignacio,9999,0,9999,0
1713487802534,ANAR 135S,A00,494369,Braswell; Geoffrey E.,0,0,0,0
1713487803562,CAT 124RS,A01,519847,Geibel; William,6,0,20,14
1713487804590,CAT 125RS,A01,515971,Geibel; William,6,0,20,14
1713487805619,CLRE 250,A00,511389,Morris; Sheldon,9996,0,9999,3
1713487806645,CLRE 251,A00,507176,Mehta; Ravindra L.,9996,0,9999,3
1713487806645,CLRE 251,B00,511410,Mehta; Ravindra L.,9998,0,9999,1
1713487807673,CLRE 252,A00,507189,Cuomo; Raphael Eduardo,9998,0,9999,1
1713487808698,CLRE 253,A00,507199,Vaida; Florin,9997,0,9999,2
1713487808698,CLRE 253,B00,507202,Vaida; Florin,9999,0,9999,0
1713487809727,CLRE 259,A00,507211,Patel; Hemal,9996,0,9999,3
1713487810751,CLRE 260,A00,507221,Cuomo; Raphael Eduardo,9999,0,9999,0
1713487811775,CLRE 297,001,507242,Cuomo; Raphael Eduardo,9999,0,9999,0
1713487812802,CSE 191,A00,516875,Minnes Kemp; Mor Mia,9999,0,9999,0
1713487813827,CSS 201S,A01,494383,Staff,35,0,35,0
1713487814852,CSS 202S,A01,494387,Staff,35,0,35,0
1713487815875,EAP 100,A00,516065,Staff,9792,0,9999,207
1713487816907,ECE 45,A01,507414,Staff,38,0,60,22
1713487817933,ECE 100,A01,507416,Baghdadchi; Saharnaz,1,0,20,19
1713487817933,ECE 100,A02,507418,Baghdadchi; Saharnaz,19,0,20,1
1713487818959,ECE 111,A01,507420,Staff,27,0,50,23
1713487819986,ECE 197,001,548057,Sievenpiper; Daniel F.,9998,0,9999,1
1713487821013,EDS 115,A00,507243,Choi; Bailey Miyeon,27,0,28,1
1713487822045,EDS 117,A01,494379,Staff,16,0,25,9
1713487823071,EDS 125,A00,507246,Hopkins; Megan Beth,28,0,30,2
1713487824100,EDS 128A,A01,507264,Fargason; Sharon Gayle,26,0,26,0
1713487825130,EDS 128B,A01,507293,Pappas; Elizabeth,30,0,30,0
1713487826158,EDS 139,A00,507294,Fargason; Sharon Gayle,30,0,30,0
1713487826158,EDS 139,B00,507313,Pappas; Elizabeth,30,0,30,0
1713487827184,EDS 201,A00,507315,Staff,18,0,30,12
1713487828210,EDS 203,A01,507317,Halter; Christopher P.,17,0,30,13
1713487829239,EDS 204R,A01,507319,Halter; Christopher P.,0,1,30,30
1713487829239,EDS 204R,B01,507331,Heinzman; Erica M.,26,0,30,4
1713487830263,EDS 206R,A00,507332,Staff,0,2,30,30
1713487830263,EDS 206R,B00,507343,Staff,27,0,30,3
1713487831288,EDS 250,A00,507344,Hemans; Patricia Ann Benitez,28,0,40,12
1713487832314,EDS 281,A00,507345,Daly; Alan J.,18,0,18,0
1713487833341,EDS 284,A00,507350,Daly; Alan J.,16,0,16,0
1713487834366,EDS 286,A00,507359,Fine; Sarah,18,0,18,0
1713487835391,EDS 289C,A01,507361,Daly; Alan J.,18,0,18,0
1713487836417,EDS 290,A00,507366,Hofstetter; Carolyn,15,0,15,0
1713487837443,LIGM 5A,A00,507421,Fischer-Grunski; Eva K,20,0,20,0
1713487838472,LIGM 5B,A00,507423,Fischer-Grunski; Eva K,20,0,20,0
1713487839501,LIGM 5C,A00,507425,Fischer-Grunski; Eva K,20,0,20,0
1713487840531,LIIT 5AS,A00,507427,Carnelos; Chiara,20,0,20,0
1713487841557,LIIT 5BS,A00,507430,Carnelos; Chiara,20,0,20,0
1713487842581,LIIT 5CS,A00,507432,Carnelos; Chiara,20,0,20,0
1713487843607,LISP 5A,A00,507541,Munoz Sanchez; Alicia,14,0,20,6
1713487844636,LISP 5B,A00,507671,Munoz Sanchez; Alicia,12,0,20,8
1713487845660,LISP 5C,A00,507696,Munoz Sanchez; Alicia,11,0,20,9
1713487846687,MAE 197,001,528363,Boechler; Nicholas Sebastia,9998,0,9999,1
1713487847718,MATH 197,001,523477,Kedlaya; Kiran S.,9999,0,9999,0
1713487847718,MATH 197,002,563811,Zhang; Danna,9998,0,9999,1
1713487848746,MCWP 40R,A00,518780,Staff,16,0,20,4
1713487848746,MCWP 40R,B00,518781,Staff,14,0,20,6
1713487848746,MCWP 40R,C00,518783,Staff,11,0,20,9
1713487849775,MCWP 50R,A00,518791,Staff,8,0,20,12
1713487849775,MCWP 50R,B00,518792,Staff,5,0,20,15
1713487849775,MCWP 50R,C00,518793,Staff,7,0,20,13
1713487849775,MCWP 50R,D00,518794,Staff,0,0,20,20
1713487849775,MCWP 50R,E00,518795,Staff,3,0,20,17
1713487849775,MCWP 50R,F00,518796,Staff,13,0,20,7
1713487849775,MCWP 50R,G00,518797,Staff,12,0,20,8
1713487850803,MMW 12R,A01,514034,Herbst; Matthew,5,0,16,11
1713487850803,MMW 12R,A02,514035,Herbst; Matthew,13,0,16,3
1713487851835,MMW 13R,A01,514037,Staff,0,4,16,16
1713487851835,MMW 13R,A02,514039,Staff,0,4,16,16
1713487853898,SIO 295LS,A00,523233,Staff,15,0,30,15
1713487854923,SIO 295S,A00,523232,Staff,15,0,30,15
1713487855947,SOCI 117,A01,494376,Staff,0,2,5,5
1713487856971,WES 237B,A00,494380,Staff,19,0,20,1
1713487859040,AESE 279B,A00,494370,Wade; Jon P,33,0,33,0
1713487860066,AIP 197,001,627712,Vespa; Emanuel Ignacio,9999,0,9999,0
1713487861093,ANAR 135S,A00,494369,Braswell; Geoffrey E.,0,0,0,0
1713487862122,CAT 124RS,A01,519847,Geibel; William,6,0,20,14
1713487863150,CAT 125RS,A01,515971,Geibel; William,6,0,20,14
1713487864175,CLRE 250,A00,511389,Morris; Sheldon,9996,0,9999,3
1713487865207,CLRE 251,A00,507176,Mehta; Ravindra L.,9996,0,9999,3
1713487865207,CLRE 251,B00,511410,Mehta; Ravindra L.,9998,0,9999,1
1713487866232,CLRE 252,A00,507189,Cuomo; Raphael Eduardo,9998,0,9999,1
1713487867257,CLRE 253,A00,507199,Vaida; Florin,9997,0,9999,2
1713487867257,CLRE 253,B00,507202,Vaida; Florin,9999,0,9999,0
1713487868282,CLRE 259,A00,507211,Patel; Hemal,9996,0,9999,3
1713487869307,CLRE 260,A00,507221,Cuomo; Raphael Eduardo,9999,0,9999,0
1713487870332,CLRE 297,001,507242,Cuomo; Raphael Eduardo,9999,0,9999,0
1713487871360,CSE 191,A00,516875,Minnes Kemp; Mor Mia,9999,0,9999,0
1713487872389,CSS 201S,A01,494383,Staff,35,0,35,0
1713487873416,CSS 202S,A01,494387,Staff,35,0,35,0
1713487874445,EAP 100,A00,516065,Staff,9792,0,9999,207
1713487875470,ECE 45,A01,507414,Staff,38,0,60,22
1713487876495,ECE 100,A01,507416,Baghdadchi; Saharnaz,1,0,20,19
1713487876495,ECE 100,A02,507418,Baghdadchi; Saharnaz,19,0,20,1
1713487877520,ECE 111,A01,507420,Staff,27,0,50,23
1713487878549,ECE 197,001,548057,Sievenpiper; Daniel F.,9998,0,9999,1
1713487879577,EDS 115,A00,507243,Choi; Bailey Miyeon,27,0,28,1
1713487880605,EDS 117,A01,494379,Staff,16,0,25,9
1713487881634,EDS 125,A00,507246,Hopkins; Megan Beth,28,0,30,2
1713487882660,EDS 128A,A01,507264,Fargason; Sharon Gayle,26,0,26,0
1713487883758,EDS 128B,A01,507293,Pappas; Elizabeth,30,0,30,0
1713487884783,EDS 139,A00,507294,Fargason; Sharon Gayle,30,0,30,0
1713487884783,EDS 139,B00,507313,Pappas; Elizabeth,30,0,30,0
1713487885812,EDS 201,A00,507315,Staff,18,0,30,12
1713487886840,EDS 203,A01,507317,Halter; Christopher P.,17,0,30,13
1713487887865,EDS 204R,A01,507319,Halter; Christopher P.,0,1,30,30
1713487887865,EDS 204R,B01,507331,Heinzman; Erica M.,26,0,30,4
1713487888893,EDS 206R,A00,507332,Staff,0,2,30,30
1713487888893,EDS 206R,B00,507343,Staff,27,0,30,3
1713487889919,EDS 250,A00,507344,Hemans; Patricia Ann Benitez,27,0,40,13
1713487890947,EDS 281,A00,507345,Daly; Alan J.,18,0,18,0
1713487891972,EDS 284,A00,507350,Daly; Alan J.,16,0,16,0
1713487892997,EDS 286,A00,507359,Fine; Sarah,18,0,18,0
1713487894025,EDS 289C,A01,507361,Daly; Alan J.,18,0,18,0
1713487895051,EDS 290,A00,507366,Hofstetter; Carolyn,15,0,15,0
1713487896081,LIGM 5A,A00,507421,Fischer-Grunski; Eva K,20,0,20,0
1713487897107,LIGM 5B,A00,507423,Fischer-Grunski; Eva K,20,0,20,0
1713487898131,LIGM 5C,A00,507425,Fischer-Grunski; Eva K,20,0,20,0
1713487899156,LIIT 5AS,A00,507427,Carnelos; Chiara,20,0,20,0
1713487900185,LIIT 5BS,A00,507430,Carnelos; Chiara,20,0,20,0
1713487901278,LIIT 5CS,A00,507432,Carnelos; Chiara,20,0,20,0
1713487902307,LISP 5A,A00,507541,Munoz Sanchez; Alicia,14,0,20,6
1713487903336,LISP 5B,A00,507671,Munoz Sanchez; Alicia,12,0,20,8
1713487904361,LISP 5C,A00,507696,Munoz Sanchez; Alicia,11,0,20,9
1713487905386,MAE 197,001,528363,Boechler; Nicholas Sebastia,9998,0,9999,1
1713487906414,MATH 197,001,523477,Kedlaya; Kiran S.,9999,0,9999,0
1713487906414,MATH 197,002,563811,Zhang; Danna,9998,0,9999,1
1713487907438,MCWP 40R,A00,518780,Staff,16,0,20,4
1713487907438,MCWP 40R,B00,518781,Staff,14,0,20,6
1713487907438,MCWP 40R,C00,518783,Staff,11,0,20,9
1713487908463,MCWP 50R,A00,518791,Staff,8,0,20,12
1713487908463,MCWP 50R,B00,518792,Staff,5,0,20,15
1713487908463,MCWP 50R,C00,518793,Staff,7,0,20,13
1713487908463,MCWP 50R,D00,518794,Staff,0,0,20,20
1713487908463,MCWP 50R,E00,518795,Staff,3,0,20,17
1713487908463,MCWP 50R,F00,518796,Staff,13,0,20,7
1713487908463,MCWP 50R,G00,518797,Staff,11,0,20,9
1713487909489,MMW 12R,A01,514034,Herbst; Matthew,5,0,16,11
1713487909489,MMW 12R,A02,514035,Herbst; Matthew,13,0,16,3
1713487910517,MMW 13R,A01,514037,Staff,0,4,16,16
1713487910517,MMW 13R,A02,514039,Staff,0,4,16,16
1713487912572,SIO 295LS,A00,523233,Staff,15,0,30,15
1713487913597,SIO 295S,A00,523232,Staff,15,0,30,15
1713487914626,SOCI 117,A01,494376,Staff,0,2,5,5
1713487915653,WES 237B,A00,494380,Staff,19,0,20,1
1713487917722,AESE 279B,A00,494370,Wade; Jon P,33,0,33,0
1713487918748,AIP 197,001,627712,Vespa; Emanuel Ignacio,9999,0,9999,0
1713487919772,ANAR 135S,A00,494369,Braswell; Geoffrey E.,0,0,0,0
1713487920799,CAT 124RS,A01,519847,Geibel; William,6,0,20,14
1713487921826,CAT 125RS,A01,515971,Geibel; William,6,0,20,14
1713487922853,CLRE 250,A00,511389,Morris; Sheldon,9996,0,9999,3
1713487923879,CLRE 251,A00,507176,Mehta; Ravindra L.,9996,0,9999,3
1713487923879,CLRE 251,B00,511410,Mehta; Ravindra L.,9998,0,9999,1
1713487924908,CLRE 252,A00,507189,Cuomo; Raphael Eduardo,9998,0,9999,1
1713487925933,CLRE 253,A00,507199,Vaida; Florin,9997,0,9999,2
1713487925933,CLRE 253,B00,507202,Vaida; Florin,9999,0,9999,0
1713487926960,CLRE 259,A00,507211,Patel; Hemal,9996,0,9999,3
1713487927985,CLRE 260,A00,507221,Cuomo; Raphael Eduardo,9999,0,9999,0
1713487929014,CLRE 297,001,507242,Cuomo; Raphael Eduardo,9999,0,9999,0
1713487930039,CSE 191,A00,516875,Minnes Kemp; Mor Mia,9999,0,9999,0
1713487931070,CSS 201S,A01,494383,Staff,35,0,35,0
1713487932097,CSS 202S,A01,494387,Staff,35,0,35,0
1713487933128,EAP 100,A00,516065,Staff,9792,0,9999,207
1713487934152,ECE 45,A01,507414,Staff,38,0,60,22
1713487935182,ECE 100,A01,507416,Baghdadchi; Saharnaz,1,0,20,19
1713487935182,ECE 100,A02,507418,Baghdadchi; Saharnaz,19,0,20,1
1713487936210,ECE 111,A01,507420,Staff,27,0,50,23
1713487937236,ECE 197,001,548057,Sievenpiper; Daniel F.,9998,0,9999,1
1713487938264,EDS 115,A00,507243,Choi; Bailey Miyeon,27,0,28,1
1713487939295,EDS 117,A01,494379,Staff,16,0,25,9
1713487940323,EDS 125,A00,507246,Hopkins; Megan Beth,28,0,30,2
1713487941349,EDS 128A,A01,507264,Fargason; Sharon Gayle,26,0,26,0
1713487942375,EDS 128B,A01,507293,Pappas; Elizabeth,30,0,30,0
1713487943401,EDS 139,A00,507294,Fargason; Sharon Gayle,30,0,30,0
1713487943401,EDS 139,B00,507313,Pappas; Elizabeth,30,0,30,0
1713487944431,EDS 201,A00,507315,Staff,18,0,30,12
1713487945462,EDS 203,A01,507317,Halter; Christopher P.,17,0,30,13
1713487946487,EDS 204R,A01,507319,Halter; Christopher P.,0,1,30,30
1713487946487,EDS 204R,B01,507331,Heinzman; Erica M.,26,0,30,4
1713487947513,EDS 206R,A00,507332,Staff,0,2,30,30
1713487947513,EDS 206R,B00,507343,Staff,27,0,30,3
1713487948539,EDS 250,A00,507344,Hemans; Patricia Ann Benitez,27,0,40,13
1713487949568,EDS 281,A00,507345,Daly; Alan J.,18,0,18,0
1713487950592,EDS 284,A00,507350,Daly; Alan J.,16,0,16,0
1713487951618,EDS 286,A00,507359,Fine; Sarah,18,0,18,0
1713487952643,EDS 289C,A01,507361,Daly; Alan J.,18,0,18,0
1713487953669,EDS 290,A00,507366,Hofstetter; Carolyn,15,0,15,0
1713487954700,LIGM 5A,A00,507421,Fischer-Grunski; Eva K,20,0,20,0
1713487955726,LIGM 5B,A00,507423,Fischer-Grunski; Eva K,20,0,20,0
1713487956752,LIGM 5C,A00,507425,Fischer-Grunski; Eva K,20,0,20,0
1713487957778,LIIT 5AS,A00,507427,Carnelos; Chiara,20,0,20,0
1713487958804,LIIT 5BS,A00,507430,Carnelos; Chiara,20,0,20,0
1713487959834,LIIT 5CS,A00,507432,Carnelos; Chiara,20,0,20,0
1713487960860,LISP 5A,A00,507541,Munoz Sanchez; Alicia,14,0,20,6
1713487961886,LISP 5B,A00,507671,Munoz Sanchez; Alicia,12,0,20,8
1713487962916,LISP 5C,A00,507696,Munoz Sanchez; Alicia,11,0,20,9
1713487963942,MAE 197,001,528363,Boechler; Nicholas Sebastia,9998,0,9999,1
1713487964968,MATH 197,001,523477,Kedlaya; Kiran S.,9999,0,9999,0
1713487964968,MATH 197,002,563811,Zhang; Danna,9998,0,9999,1
1713487965993,MCWP 40R,A00,518780,Staff,16,0,20,4
1713487965993,MCWP 40R,B00,518781,Staff,14,0,20,6
1713487965993,MCWP 40R,C00,518783,Staff,11,0,20,9
1713487967023,MCWP 50R,A00,518791,Staff,8,0,20,12
1713487967023,MCWP 50R,B00,518792,Staff,5,0,20,15
1713487967023,MCWP 50R,C00,518793,Staff,7,0,20,13
1713487967023,MCWP 50R,D00,518794,Staff,0,0,20,20
1713487967023,MCWP 50R,E00,518795,Staff,3,0,20,17
1713487967023,MCWP 50R,F00,518796,Staff,13,0,20,7
1713487967023,MCWP 50R,G00,518797,Staff,11,0,20,9
1713487968051,MMW 12R,A01,514034,Herbst; Matthew,5,0,16,11
1713487968051,MMW 12R,A02,514035,Herbst; Matthew,13,0,16,3
1713487969079,MMW 13R,A01,514037,Staff,0,4,16,16
1713487969079,MMW 13R,A02,514039,Staff,0,4,16,16
1713487971132,SIO 295LS,A00,523233,Staff,15,0,30,15
1713487972159,SIO 295S,A00,523232,Staff,15,0,30,15
1713487973184,SOCI 117,A01,494376,Staff,0,2,5,5
1713487974213,WES 237B,A00,494380,Staff,19,0,20,1
1713487976269,AESE 279B,A00,494370,Wade; Jon P,33,0,33,0
1713487977294,AIP 197,001,627712,Vespa; Emanuel Ignacio,9999,0,9999,0
1713487978320,ANAR 135S,A00,494369,Braswell; Geoffrey E.,0,0,0,0
1713487979349,CAT 124RS,A01,519847,Geibel; William,6,0,20,14
1713487980380,CAT 125RS,A01,515971,Geibel; William,6,0,20,14
1713487981405,CLRE 250,A00,511389,Morris; Sheldon,9996,0,9999,3
1713487982438,CLRE 251,A00,507176,Mehta; Ravindra L.,9996,0,9999,3
1713487982438,CLRE 251,B00,511410,Mehta; Ravindra L.,9998,0,9999,1
1713487983462,CLRE 252,A00,507189,Cuomo; Raphael Eduardo,9998,0,9999,1
1713487984489,CLRE 253,A00,507199,Vaida; Florin,9997,0,9999,2
1713487984489,CLRE 253,B00,507202,Vaida; Florin,9999,0,9999,0
1713487985516,CLRE 259,A00,507211,Patel; Hemal,9996,0,9999,3
1713487986544,CLRE 260,A00,507221,Cuomo; Raphael Eduardo,9999,0,9999,0
1713487987623,CLRE 297,001,507242,Cuomo; Raphael Eduardo,9999,0,9999,0
1713487988647,CSE 191,A00,516875,Minnes Kemp; Mor Mia,9999,0,9999,0
1713487989673,CSS 201S,A01,494383,Staff,35,0,35,0
1713487990702,CSS 202S,A01,494387,Staff,35,0,35,0
1713487991727,EAP 100,A00,516065,Staff,9792,0,9999,207
1713487992756,ECE 45,A01,507414,Staff,38,0,60,22
1713487993782,ECE 100,A01,507416,Baghdadchi; Saharnaz,1,0,20,19
1713487993782,ECE 100,A02,507418,Baghdadchi; Saharnaz,19,0,20,1
1713487994807,ECE 111,A01,507420,Staff,27,0,50,23
1713487995835,ECE 197,001,548057,Sievenpiper; Daniel F.,9998,0,9999,1
1713487996861,EDS 115,A00,507243,Choi; Bailey Miyeon,27,0,28,1
1713487997890,EDS 117,A01,494379,Staff,16,0,25,9
1713487998916,EDS 125,A00,507246,Hopkins; Megan Beth,28,0,30,2
1713487999942,EDS 128A,A01,507264,Fargason; Sharon Gayle,26,0,26,0
1713488000971,EDS 128B,A01,507293,Pappas; Elizabeth,30,0,30,0
1713488001996,EDS 139,A00,507294,Fargason; Sharon Gayle,30,0,30,0
1713488001996,EDS 139,B00,507313,Pappas; Elizabeth,30,0,30,0
1713488003022,EDS 201,A00,507315,Staff,18,0,30,12
1713488004054,EDS 203,A01,507317,Halter; Christopher P.,17,0,30,13
1713488005080,EDS 204R,A01,507319,Halter; Christopher P.,0,1,30,30
1713488005080,EDS 204R,B01,507331,Heinzman; Erica M.,26,0,30,4
1713488006105,EDS 206R,A00,507332,Staff,0,2,30,30
1713488006105,EDS 206R,B00,507343,Staff,27,0,30,3
1713488007130,EDS 250,A00,507344,Hemans; Patricia Ann Benitez,27,0,40,13
1713488008156,EDS 281,A00,507345,Daly; Alan J.,18,0,18,0
1713488009183,EDS 284,A00,507350,Daly; Alan J.,16,0,16,0
1713488010206,EDS 286,A00,507359,Fine; Sarah,18,0,18,0
1713488011231,EDS 289C,A01,507361,Daly; Alan J.,18,0,18,0
1713488012256,EDS 290,A00,507366,Hofstetter; Carolyn,15,0,15,0
1713488013282,LIGM 5A,A00,507421,Fischer-Grunski; Eva K,20,0,20,0
1713488014308,LIGM 5B,A00,507423,Fischer-Grunski; Eva K,20,0,20,0
1713488015338,LIGM 5C,A00,507425,Fischer-Grunski; Eva K,20,0,20,0
1713488016367,LIIT 5AS,A00,507427,Carnelos; Chiara,20,0,20,0
1713488017398,LIIT 5BS,A00,507430,Carnelos; Chiara,20,0,20,0
1713488018423,LIIT 5CS,A00,507432,Carnelos; Chiara,20,0,20,0
1713488019454,LISP 5A,A00,507541,Munoz Sanchez; Alicia,14,0,20,6
1713488020479,LISP 5B,A00,507671,Munoz Sanchez; Alicia,12,0,20,8
1713488021504,LISP 5C,A00,507696,Munoz Sanchez; Alicia,11,0,20,9
1713488022533,MAE 197,001,528363,Boechler; Nicholas Sebastia,9998,0,9999,1
1713488023562,MATH 197,001,523477,Kedlaya; Kiran S.,9999,0,9999,0
1713488023562,MATH 197,002,563811,Zhang; Danna,9998,0,9999,1
1713488024588,MCWP 40R,A00,518780,Staff,16,0,20,4
1713488024588,MCWP 40R,B00,518781,Staff,14,0,20,6
1713488024588,MCWP 40R,C00,518783,Staff,11,0,20,9
1713488025614,MCWP 50R,A00,518791,Staff,8,0,20,12
1713488025614,MCWP 50R,B00,518792,Staff,5,0,20,15
1713488025614,MCWP 50R,C00,518793,Staff,7,0,20,13
1713488025614,MCWP 50R,D00,518794,Staff,0,0,20,20
1713488025614,MCWP 50R,E00,518795,Staff,3,0,20,17
1713488025614,MCWP 50R,F00,518796,Staff,13,0,20,7
1713488025614,MCWP 50R,G00,518797,Staff,11,0,20,9
1713488026638,MMW 12R,A01,514034,Herbst; Matthew,5,0,16,11
1713488026638,MMW 12R,A02,514035,Herbst; Matthew,13,0,16,3
1713488027663,MMW 13R,A01,514037,Staff,0,4,16,16
1713488027663,MMW 13R,A02,514039,Staff,0,4,16,16
1713488029715,SIO 295LS,A00,523233,Staff,15,0,30,15
1713488030740,SIO 295S,A00,523232,Staff,15,0,30,15
1713488031766,SOCI 117,A01,494376,Staff,0,2,5,5
1713488032795,WES 237B,A00,494380,Staff,19,0,20,1
1713488034864,AESE 279B,A00,494370,Wade; Jon P,33,0,33,0
1713488035891,AIP 197,001,627712,Vespa; Emanuel Ignacio,9999,0,9999,0
1713488036920,ANAR 135S,A00,494369,Braswell; Geoffrey E.,0,0,0,0
1713488037946,CAT 124RS,A01,519847,Geibel; William,6,0,20,14
1713488038972,CAT 125RS,A01,515971,Geibel; William,6,0,20,14
1713488039997,CLRE 250,A00,511389,Morris; Sheldon,9996,0,9999,3
1713488041027,CLRE 251,A00,507176,Mehta; Ravindra L.,9996,0,9999,3
1713488041027,CLRE 251,B00,511410,Mehta; Ravindra L.,9998,0,9999,1
1713488042056,CLRE 252,A00,507189,Cuomo; Raphael Eduardo,9998,0,9999,1
1713488043086,CLRE 253,A00,507199,Vaida; Florin,9997,0,9999,2
1713488043086,CLRE 253,B00,507202,Vaida; Florin,9999,0,9999,0
1713488044111,CLRE 259,A00,507211,Patel; Hemal,9996,0,9999,3
1713488045140,CLRE 260,A00,507221,Cuomo; Raphael Eduardo,9999,0,9999,0
1713488046165,CLRE 297,001,507242,Cuomo; Raphael Eduardo,9999,0,9999,0
1713488047190,CSE 191,A00,516875,Minnes Kemp; Mor Mia,9999,0,9999,0
1713488048216,CSS 201S,A01,494383,Staff,35,0,35,0
1713488049241,CSS 202S,A01,494387,Staff,35,0,35,0
1713488050265,EAP 100,A00,516065,Staff,9792,0,9999,207
1713488051290,ECE 45,A01,507414,Staff,38,0,60,22
1713488052319,ECE 100,A01,507416,Baghdadchi; Saharnaz,0,0,20,20
1713488052319,ECE 100,A02,507418,Baghdadchi; Saharnaz,19,0,20,1
1713488053344,ECE 111,A01,507420,Staff,27,0,50,23
1713488054368,ECE 197,001,548057,Sievenpiper; Daniel F.,9998,0,9999,1
1713488055399,EDS 115,A00,507243,Choi; Bailey Miyeon,27,0,28,1
1713488056424,EDS 117,A01,494379,Staff,16,0,25,9
1713488057454,EDS 125,A00,507246,Hopkins; Megan Beth,28,0,30,2
1713488058480,EDS 128A,A01,507264,Fargason; Sharon Gayle,26,0,26,0
1713488059506,EDS 128B,A01,507293,Pappas; Elizabeth,30,0,30,0
1713488060532,EDS 139,A00,507294,Fargason; Sharon Gayle,30,0,30,0
1713488060532,EDS 139,B00,507313,Pappas; Elizabeth,30,0,30,0
1713488061560,EDS 201,A00,507315,Staff,18,0,30,12
1713488062585,EDS 203,A01,507317,Halter; Christopher P.,17,0,30,13
1713488063614,EDS 204R,A01,507319,Halter; Christopher P.,0,1,30,30
1713488063614,EDS 204R,B01,507331,Heinzman; Erica M.,26,0,30,4
1713488064642,EDS 206R,A00,507332,Staff,0,2,30,30
1713488064642,EDS 206R,B00,507343,Staff,27,0,30,3
1713488065668,EDS 250,A00,507344,Hemans; Patricia Ann Benitez,27,0,40,13
1713488066696,EDS 281,A00,507345,Daly; Alan J.,18,0,18,0
1713488067720,EDS 284,A00,507350,Daly; Alan J.,16,0,16,0
1713488068748,EDS 286,A00,507359,Fine; Sarah,18,0,18,0
1713488069776,EDS 289C,A01,507361,Daly; Alan J.,18,0,18,0
1713488070803,EDS 290,A00,507366,Hofstetter; Carolyn,15,0,15,0
1713488071829,LIGM 5A,A00,507421,Fischer-Grunski; Eva K,20,0,20,0
1713488072858,LIGM 5B,A00,507423,Fischer-Grunski; Eva K,20,0,20,0
1713488073887,LIGM 5C,A00,507425,Fischer-Grunski; Eva K,20,0,20,0
1713488074913,LIIT 5AS,A00,507427,Carnelos; Chiara,20,0,20,0
1713488075938,LIIT 5BS,A00,507430,Carnelos; Chiara,20,0,20,0
1713488076963,LIIT 5CS,A00,507432,Carnelos; Chiara,20,0,20,0
1713488077989,LISP 5A,A00,507541,Munoz Sanchez; Alicia,14,0,20,6
1713488079013,LISP 5B,A00,507671,Munoz Sanchez; Alicia,12,0,20,8
1713488080038,LISP 5C,A00,507696,Munoz Sanchez; Alicia,11,0,20,9
1713488081064,MAE 197,001,528363,Boechler; Nicholas Sebastia,9998,0,9999,1
1713488082091,MATH 197,001,523477,Kedlaya; Kiran S.,9999,0,9999,0
1713488082091,MATH 197,002,563811,Zhang; Danna,9998,0,9999,1
1713488083119,MCWP 40R,A00,518780,Staff,16,0,20,4
1713488083119,MCWP 40R,B00,518781,Staff,14,0,20,6
1713488083119,MCWP 40R,C00,518783,Staff,11,0,20,9
1713488084151,MCWP 50R,A00,518791,Staff,8,0,20,12
1713488084151,MCWP 50R,B00,518792,Staff,5,0,20,15
1713488084151,MCWP 50R,C00,518793,Staff,7,0,20,13
1713488084151,MCWP 50R,D00,518794,Staff,0,0,20,20
1713488084151,MCWP 50R,E00,518795,Staff,3,0,20,17
1713488084151,MCWP 50R,F00,518796,Staff,13,0,20,7
1713488084151,MCWP 50R,G00,518797,Staff,11,0,20,9
1713488085178,MMW 12R,A01,514034,Herbst; Matthew,5,0,16,11
1713488085178,MMW 12R,A02,514035,Herbst; Matthew,13,0,16,3
1713488086206,MMW 13R,A01,514037,Staff,0,4,16,16
1713488086206,MMW 13R,A02,514039,Staff,0,4,16,16
1713488088258,SIO 295LS,A00,523233,Staff,15,0,30,15
1713488089285,SIO 295S,A00,523232,Staff,15,0,30,15
1713488090311,SOCI 117,A01,494376,Staff,0,2,5,5
1713488091395,WES 237B,A00,494380,Staff,19,0,20,1
1713488093475,AESE 279B,A00,494370,Wade; Jon P,33,0,33,0
1713488094500,AIP 197,001,627712,Vespa; Emanuel Ignacio,9999,0,9999,0
1713488095526,ANAR 135S,A00,494369,Braswell; Geoffrey E.,0,0,0,0
1713488096552,CAT 124RS,A01,519847,Geibel; William,6,0,20,14
1713488097577,CAT 125RS,A01,515971,Geibel; William,6,0,20,14
1713488098603,CLRE 250,A00,511389,Morris; Sheldon,9996,0,9999,3
1713488099634,CLRE 251,A00,507176,Mehta; Ravindra L.,9996,0,9999,3
1713488099634,CLRE 251,B00,511410,Mehta; Ravindra L.,9998,0,9999,1
1713488100666,CLRE 252,A00,507189,Cuomo; Raphael Eduardo,9998,0,9999,1
1713488101695,CLRE 253,A00,507199,Vaida; Florin,9997,0,9999,2
1713488101695,CLRE 253,B00,507202,Vaida; Florin,9999,0,9999,0
1713488102727,CLRE 259,A00,507211,Patel; Hemal,9996,0,9999,3
1713488103752,CLRE 260,A00,507221,Cuomo; Raphael Eduardo,9999,0,9999,0
1713488104777,CLRE 297,001,507242,Cuomo; Raphael Eduardo,9999,0,9999,0
1713488105802,CSE 191,A00,516875,Minnes Kemp; Mor Mia,9999,0,9999,0
1713488106828,CSS 201S,A01,494383,Staff,35,0,35,0
1713488107854,CSS 202S,A01,494387,Staff,35,0,35,0
1713488108881,EAP 100,A00,516065,Staff,9792,0,9999,207
1713488109911,ECE 45,A01,507414,Staff,38,0,60,22
1713488110940,ECE 100,A01,507416,Baghdadchi; Saharnaz,0,0,20,20
1713488110940,ECE 100,A02,507418,Baghdadchi; Saharnaz,19,0,20,1
1713488111969,ECE 111,A01,507420,Staff,27,0,50,23
1713488112997,ECE 197,001,548057,Sievenpiper; Daniel F.,9998,0,9999,1
1713488114023,EDS 115,A00,507243,Choi; Bailey Miyeon,27,0,28,1
1713488115047,EDS 117,A01,494379,Staff,16,0,25,9
1713488116071,EDS 125,A00,507246,Hopkins; Megan Beth,28,0,30,2
1713488117106,EDS 128A,A01,507264,Fargason; Sharon Gayle,26,0,26,0
1713488118131,EDS 128B,A01,507293,Pappas; Elizabeth,30,0,30,0
1713488119158,EDS 139,A00,507294,Fargason; Sharon Gayle,30,0,30,0
1713488119158,EDS 139,B00,507313,Pappas; Elizabeth,30,0,30,0
1713488120183,EDS 201,A00,507315,Staff,18,0,30,12
1713488121208,EDS 203,A01,507317,Halter; Christopher P.,17,0,30,13
1713488122235,EDS 204R,A01,507319,Halter; Christopher P.,0,1,30,30
1713488122235,EDS 204R,B01,507331,Heinzman; Erica M.,26,0,30,4
1713488123263,EDS 206R,A00,507332,Staff,0,2,30,30
1713488123263,EDS 206R,B00,507343,Staff,27,0,30,3
1713488124288,EDS 250,A00,507344,Hemans; Patricia Ann Benitez,27,0,40,13
1713488125314,EDS 281,A00,507345,Daly; Alan J.,18,0,18,0
1713488126342,EDS 284,A00,507350,Daly; Alan J.,16,0,16,0
1713488127372,EDS 286,A00,507359,Fine; Sarah,18,0,18,0
1713488128397,EDS 289C,A01,507361,Daly; Alan J.,18,0,18,0
1713488129426,EDS 290,A00,507366,Hofstetter; Carolyn,15,0,15,0
1713488130452,LIGM 5A,A00,507421,Fischer-Grunski; Eva K,20,0,20,0
1713488131478,LIGM 5B,A00,507423,Fischer-Grunski; Eva K,20,0,20,0
1713488132503,LIGM 5C,A00,507425,Fischer-Grunski; Eva K,20,0,20,0
1713488133532,LIIT 5AS,A00,507427,Carnelos; Chiara,20,0,20,0
1713488134558,LIIT 5BS,A00,507430,Carnelos; Chiara,20,0,20,0
1713488135583,LIIT 5CS,A00,507432,Carnelos; Chiara,20,0,20,0
1713488136608,LISP 5A,A00,507541,Munoz Sanchez; Alicia,14,0,20,6
1713488137632,LISP 5B,A00,507671,Munoz Sanchez; Alicia,12,0,20,8
1713488138658,LISP 5C,A00,507696,Munoz Sanchez; Alicia,11,0,20,9
1713488139684,MAE 197,001,528363,Boechler; Nicholas Sebastia,9998,0,9999,1
1713488140713,MATH 197,001,523477,Kedlaya; Kiran S.,9999,0,9999,0
1713488140713,MATH 197,002,563811,Zhang; Danna,9998,0,9999,1
1713488141737,MCWP 40R,A00,518780,Staff,16,0,20,4
1713488141737,MCWP 40R,B00,518781,Staff,14,0,20,6
1713488141737,MCWP 40R,C00,518783,Staff,11,0,20,9
1713488142767,MCWP 50R,A00,518791,Staff,8,0,20,12
1713488142767,MCWP 50R,B00,518792,Staff,5,0,20,15
1713488142767,MCWP 50R,C00,518793,Staff,7,0,20,13
1713488142767,MCWP 50R,D00,518794,Staff,0,0,20,20
1713488142767,MCWP 50R,E00,518795,Staff,3,0,20,17
1713488142767,MCWP 50R,F00,518796,Staff,13,0,20,7
1713488142767,MCWP 50R,G00,518797,Staff,11,0,20,9
1713488143795,MMW 12R,A01,514034,Herbst; Matthew,5,0,16,11
1713488143795,MMW 12R,A02,514035,Herbst; Matthew,13,0,16,3
1713488144821,MMW 13R,A01,514037,Staff,0,4,16,16
1713488144821,MMW 13R,A02,514039,Staff,0,4,16,16
1713488146876,SIO 295LS,A00,523233,Staff,15,0,30,15
1713488147900,SIO 295S,A00,523232,Staff,15,0,30,15
1713488148926,SOCI 117,A01,494376,Staff,0,2,5,5
1713488149956,WES 237B,A00,494380,Staff,19,0,20,1
1713488152033,AESE 279B,A00,494370,Wade; Jon P,33,0,33,0
1713488153059,AIP 197,001,627712,Vespa; Emanuel Ignacio,9999,0,9999,0
1713488154091,ANAR 135S,A00,494369,Braswell; Geoffrey E.,0,0,0,0
1713488155123,CAT 124RS,A01,519847,Geibel; William,6,0,20,14
1713488156148,CAT 125RS,A01,515971,Geibel; William,6,0,20,14
1713488157174,CLRE 250,A00,511389,Morris; Sheldon,9996,0,9999,3
1713488158200,CLRE 251,A00,507176,Mehta; Ravindra L.,9996,0,9999,3
1713488158200,CLRE 251,B00,511410,Mehta; Ravindra L.,9998,0,9999,1
1713488159231,CLRE 252,A00,507189,Cuomo; Raphael Eduardo,9998,0,9999,1
1713488160262,CLRE 253,A00,507199,Vaida; Florin,9997,0,9999,2
1713488160262,CLRE 253,B00,507202,Vaida; Florin,9999,0,9999,0
1713488161292,CLRE 259,A00,507211,Patel; Hemal,9996,0,9999,3
1713488162317,CLRE 260,A00,507221,Cuomo; Raphael Eduardo,9999,0,9999,0
1713488163343,CLRE 297,001,507242,Cuomo; Raphael Eduardo,9999,0,9999,0
1713488164369,CSE 191,A00,516875,Minnes Kemp; Mor Mia,9999,0,9999,0
1713488165398,CSS 201S,A01,494383,Staff,35,0,35,0
1713488166425,CSS 202S,A01,494387,Staff,35,0,35,0
1713488167452,EAP 100,A00,516065,Staff,9792,0,9999,207
1713488168479,ECE 45,A01,507414,Staff,38,0,60,22
1713488169505,ECE 100,A01,507416,Baghdadchi; Saharnaz,0,0,20,20
1713488169505,ECE 100,A02,507418,Baghdadchi; Saharnaz,19,0,20,1
1713488170530,ECE 111,A01,507420,Staff,27,0,50,23
1713488171559,ECE 197,001,548057,Sievenpiper; Daniel F.,9998,0,9999,1
1713488172589,EDS 115,A00,507243,Choi; Bailey Miyeon,27,0,28,1
1713488173614,EDS 117,A01,494379,Staff,16,0,25,9
1713488174643,EDS 125,A00,507246,Hopkins; Megan Beth,28,0,30,2
1713488175669,EDS 128A,A01,507264,Fargason; Sharon Gayle,26,0,26,0
1713488176695,EDS 128B,A01,507293,Pappas; Elizabeth,30,0,30,0
1713488177719,EDS 139,A00,507294,Fargason; Sharon Gayle,30,0,30,0
1713488177719,EDS 139,B00,507313,Pappas; Elizabeth,30,0,30,0
1713488178745,EDS 201,A00,507315,Staff,18,0,30,12
1713488179773,EDS 203,A01,507317,Halter; Christopher P.,17,0,30,13
1713488180804,EDS 204R,A01,507319,Halter; Christopher P.,0,1,30,30
1713488180804,EDS 204R,B01,507331,Heinzman; Erica M.,26,0,30,4
1713488181829,EDS 206R,A00,507332,Staff,0,2,30,30
1713488181829,EDS 206R,B00,507343,Staff,27,0,30,3
1713488182863,EDS 250,A00,507344,Hemans; Patricia Ann Benitez,27,0,40,13
1713488183898,EDS 281,A00,507345,Daly; Alan J.,18,0,18,0
1713488184922,EDS 284,A00,507350,Daly; Alan J.,16,0,16,0
1713488185948,EDS 286,A00,507359,Fine; Sarah,18,0,18,0
1713488186976,EDS 289C,A01,507361,Daly; Alan J.,18,0,18,0
1713488188004,EDS 290,A00,507366,Hofstetter; Carolyn,15,0,15,0
1713488189036,LIGM 5A,A00,507421,Fischer-Grunski; Eva K,20,0,20,0
1713488190061,LIGM 5B,A00,507423,Fischer-Grunski; Eva K,20,0,20,0
1713488191086,LIGM 5C,A00,507425,Fischer-Grunski; Eva K,20,0,20,0
1713488192115,LIIT 5AS,A00,507427,Carnelos; Chiara,20,0,20,0
1713488193139,LIIT 5BS,A00,507430,Carnelos; Chiara,20,0,20,0
1713488194171,LIIT 5CS,A00,507432,Carnelos; Chiara,20,0,20,0
1713488195253,LISP 5A,A00,507541,Munoz Sanchez; Alicia,14,0,20,6
1713488196285,LISP 5B,A00,507671,Munoz Sanchez; Alicia,12,0,20,8
1713488197314,LISP 5C,A00,507696,Munoz Sanchez; Alicia,11,0,20,9
1713488198340,MAE 197,001,528363,Boechler; Nicholas Sebastia,9998,0,9999,1
1713488199366,MATH 197,001,523477,Kedlaya; Kiran S.,9999,0,9999,0
1713488199366,MATH 197,002,563811,Zhang; Danna,9998,0,9999,1
1713488200391,MCWP 40R,A00,518780,Staff,16,0,20,4
1713488200391,MCWP 40R,B00,518781,Staff,14,0,20,6
1713488200391,MCWP 40R,C00,518783,Staff,11,0,20,9
1713488201422,MCWP 50R,A00,518791,Staff,8,0,20,12
1713488201422,MCWP 50R,B00,518792,Staff,5,0,20,15
1713488201422,MCWP 50R,C00,518793,Staff,7,0,20,13
1713488201422,MCWP 50R,D00,518794,Staff,0,0,20,20
1713488201422,MCWP 50R,E00,518795,Staff,3,0,20,17
1713488201422,MCWP 50R,F00,518796,Staff,13,0,20,7
1713488201422,MCWP 50R,G00,518797,Staff,11,0,20,9
1713488202452,MMW 12R,A01,514034,Herbst; Matthew,5,0,16,11
1713488202452,MMW 12R,A02,514035,Herbst; Matthew,13,0,16,3
1713488203479,MMW 13R,A01,514037,Staff,0,4,16,16
1713488203479,MMW 13R,A02,514039,Staff,0,4,16,16
1713488205532,SIO 295LS,A00,523233,Staff,15,0,30,15
1713488206556,SIO 295S,A00,523232,Staff,15,0,30,15
1713488207583,SOCI 117,A01,494376,Staff,0,2,5,5
1713488208608,WES 237B,A00,494380,Staff,19,0,20,1
1713488210692,AESE 279B,A00,494370,Wade; Jon P,33,0,33,0
1713488211718,AIP 197,001,627712,Vespa; Emanuel Ignacio,9999,0,9999,0
1713488212744,ANAR 135S,A00,494369,Braswell; Geoffrey E.,0,0,0,0
1713488213770,CAT 124RS,A01,519847,Geibel; William,6,0,20,14
1713488214798,CAT 125RS,A01,515971,Geibel; William,6,0,20,14
1713488215822,CLRE 250,A00,511389,Morris; Sheldon,9996,0,9999,3
1713488216849,CLRE 251,A00,507176,Mehta; Ravindra L.,9996,0,9999,3
1713488216849,CLRE 251,B00,511410,Mehta; Ravindra L.,9998,0,9999,1
1713488217879,CLRE 252,A00,507189,Cuomo; Raphael Eduardo,9998,0,9999,1
1713488218905,CLRE 253,A00,507199,Vaida; Florin,9997,0,9999,2
1713488218905,CLRE 253,B00,507202,Vaida; Florin,9999,0,9999,0
1713488219932,CLRE 259,A00,507211,Patel; Hemal,9996,0,9999,3
1713488220960,CLRE 260,A00,507221,Cuomo; Raphael Eduardo,9999,0,9999,0
1713488221989,CLRE 297,001,507242,Cuomo; Raphael Eduardo,9999,0,9999,0
1713488223015,CSE 191,A00,516875,Minnes Kemp; Mor Mia,9999,0,9999,0
1713488224039,CSS 201S,A01,494383,Staff,35,0,35,0
1713488225065,CSS 202S,A01,494387,Staff,35,0,35,0
1713488226096,EAP 100,A00,516065,Staff,9792,0,9999,207
1713488227124,ECE 45,A01,507414,Staff,38,0,60,22
1713488228150,ECE 100,A01,507416,Baghdadchi; Saharnaz,0,0,20,20
1713488228150,ECE 100,A02,507418,Baghdadchi; Saharnaz,19,0,20,1
1713488229176,ECE 111,A01,507420,Staff,27,0,50,23
1713488230206,ECE 197,001,548057,Sievenpiper; Daniel F.,9998,0,9999,1
1713488231231,EDS 115,A00,507243,Choi; Bailey Miyeon,27,0,28,1
1713488232260,EDS 117,A01,494379,Staff,16,0,25,9
1713488233286,EDS 125,A00,507246,Hopkins; Megan Beth,28,0,30,2
1713488234317,EDS 128A,A01,507264,Fargason; Sharon Gayle,26,0,26,0
1713488235346,EDS 128B,A01,507293,Pappas; Elizabeth,30,0,30,0
1713488236374,EDS 139,A00,507294,Fargason; Sharon Gayle,30,0,30,0
1713488236374,EDS 139,B00,507313,Pappas; Elizabeth,30,0,30,0
1713488237398,EDS 201,A00,507315,Staff,18,0,30,12
1713488238423,EDS 203,A01,507317,Halter; Christopher P.,17,0,30,13
1713488239449,EDS 204R,A01,507319,Halter; Christopher P.,0,1,30,30
1713488239449,EDS 204R,B01,507331,Heinzman; Erica M.,26,0,30,4
1713488240476,EDS 206R,A00,507332,Staff,0,2,30,30
1713488240476,EDS 206R,B00,507343,Staff,27,0,30,3
1713488241505,EDS 250,A00,507344,Hemans; Patricia Ann Benitez,27,0,40,13
1713488242531,EDS 281,A00,507345,Daly; Alan J.,18,0,18,0
1713488243554,EDS 284,A00,507350,Daly; Alan J.,16,0,16,0
1713488244581,EDS 286,A00,507359,Fine; Sarah,18,0,18,0
1713488245609,EDS 289C,A01,507361,Daly; Alan J.,18,0,18,0
1713488246635,EDS 290,A00,507366,Hofstetter; Carolyn,15,0,15,0
1713488247661,LIGM 5A,A00,507421,Fischer-Grunski; Eva K,20,0,20,0
1713488248686,LIGM 5B,A00,507423,Fischer-Grunski; Eva K,20,0,20,0
1713488249710,LIGM 5C,A00,507425,Fischer-Grunski; Eva K,20,0,20,0
1713488250735,LIIT 5AS,A00,507427,Carnelos; Chiara,20,0,20,0
1713488251765,LIIT 5BS,A00,507430,Carnelos; Chiara,20,0,20,0
1713488252794,LIIT 5CS,A00,507432,Carnelos; Chiara,20,0,20,0
1713488253820,LISP 5A,A00,507541,Munoz Sanchez; Alicia,14,0,20,6
1713488254845,LISP 5B,A00,507671,Munoz Sanchez; Alicia,12,0,20,8
1713488255870,LISP 5C,A00,507696,Munoz Sanchez; Alicia,11,0,20,9
1713488256895,MAE 197,001,528363,Boechler; Nicholas Sebastia,9998,0,9999,1
1713488257925,MATH 197,001,523477,Kedlaya; Kiran S.,9999,0,9999,0
1713488257925,MATH 197,002,563811,Zhang; Danna,9998,0,9999,1
1713488258956,MCWP 40R,A00,518780,Staff,16,0,20,4
1713488258956,MCWP 40R,B00,518781,Staff,14,0,20,6
1713488258956,MCWP 40R,C00,518783,Staff,11,0,20,9
1713488259981,MCWP 50R,A00,518791,Staff,8,0,20,12
1713488259981,MCWP 50R,B00,518792,Staff,5,0,20,15
1713488259981,MCWP 50R,C00,518793,Staff,7,0,20,13
1713488259981,MCWP 50R,D00,518794,Staff,0,0,20,20
1713488259981,MCWP 50R,E00,518795,Staff,3,0,20,17
1713488259981,MCWP 50R,F00,518796,Staff,13,0,20,7
1713488259981,MCWP 50R,G00,518797,Staff,11,0,20,9
1713488261007,MMW 12R,A01,514034,Herbst; Matthew,5,0,16,11
1713488261007,MMW 12R,A02,514035,Herbst; Matthew,13,0,16,3
1713488262031,MMW 13R,A01,514037,Staff,0,4,16,16
1713488262031,MMW 13R,A02,514039,Staff,0,4,16,16
1713488264086,SIO 295LS,A00,523233,Staff,15,0,30,15
1713488265114,SIO 295S,A00,523232,Staff,15,0,30,15
1713488266143,SOCI 117,A01,494376,Staff,0,2,5,5
1713488267172,WES 237B,A00,494380,Staff,19,0,20,1
1713488269255,AESE 279B,A00,494370,Wade; Jon P,33,0,33,0
1713488270286,AIP 197,001,627712,Vespa; Emanuel Ignacio,9999,0,9999,0
1713488271311,ANAR 135S,A00,494369,Braswell; Geoffrey E.,0,0,0,0
1713488272339,CAT 124RS,A01,519847,Geibel; William,6,0,20,14
1713488273365,CAT 125RS,A01,515971,Geibel; William,6,0,20,14
1713488274390,CLRE 250,A00,511389,Morris; Sheldon,9996,0,9999,3
1713488275416,CLRE 251,A00,507176,Mehta; Ravindra L.,9996,0,9999,3
1713488275416,CLRE 251,B00,511410,Mehta; Ravindra L.,9998,0,9999,1
1713488276442,CLRE 252,A00,507189,Cuomo; Raphael Eduardo,9998,0,9999,1
1713488277470,CLRE 253,A00,507199,Vaida; Florin,9997,0,9999,2
1713488277470,CLRE 253,B00,507202,Vaida; Florin,9999,0,9999,0
1713488278502,CLRE 259,A00,507211,Patel; Hemal,9996,0,9999,3
1713488279528,CLRE 260,A00,507221,Cuomo; Raphael Eduardo,9999,0,9999,0
1713488280555,CLRE 297,001,507242,Cuomo; Raphael Eduardo,9999,0,9999,0
1713488281580,CSE 191,A00,516875,Minnes Kemp; Mor Mia,9999,0,9999,0
1713488282607,CSS 201S,A01,494383,Staff,35,0,35,0
1713488283635,CSS 202S,A01,494387,Staff,35,0,35,0
1713488284661,EAP 100,A00,516065,Staff,9792,0,9999,207
1713488285686,ECE 45,A01,507414,Staff,38,0,60,22
1713488286712,ECE 100,A01,507416,Baghdadchi; Saharnaz,0,0,20,20
1713488286712,ECE 100,A02,507418,Baghdadchi; Saharnaz,19,0,20,1
1713488287736,ECE 111,A01,507420,Staff,27,0,50,23
1713488288763,ECE 197,001,548057,Sievenpiper; Daniel F.,9998,0,9999,1
1713488289793,EDS 115,A00,507243,Choi; Bailey Miyeon,27,0,28,1
1713488290819,EDS 117,A01,494379,Staff,16,0,25,9
1713488291851,EDS 125,A00,507246,Hopkins; Megan Beth,28,0,30,2
1713488292877,EDS 128A,A01,507264,Fargason; Sharon Gayle,26,0,26,0
1713488293903,EDS 128B,A01,507293,Pappas; Elizabeth,30,0,30,0
1713488294926,EDS 139,A00,507294,Fargason; Sharon Gayle,30,0,30,0
1713488294926,EDS 139,B00,507313,Pappas; Elizabeth,30,0,30,0
1713488295952,EDS 201,A00,507315,Staff,18,0,30,12
1713488296977,EDS 203,A01,507317,Halter; Christopher P.,17,0,30,13
1713488298003,EDS 204R,A01,507319,Halter; Christopher P.,0,1,30,30
1713488298003,EDS 204R,B01,507331,Heinzman; Erica M.,26,0,30,4
1713488299085,EDS 206R,A00,507332,Staff,0,2,30,30
1713488299085,EDS 206R,B00,507343,Staff,27,0,30,3
1713488300112,EDS 250,A00,507344,Hemans; Patricia Ann Benitez,27,0,40,13
1713488301136,EDS 281,A00,507345,Daly; Alan J.,18,0,18,0
1713488302161,EDS 284,A00,507350,Daly; Alan J.,16,0,16,0
1713488303191,EDS 286,A00,507359,Fine; Sarah,18,0,18,0
1713488304217,EDS 289C,A01,507361,Daly; Alan J.,18,0,18,0
1713488305240,EDS 290,A00,507366,Hofstetter; Carolyn,15,0,15,0
1713488306266,LIGM 5A,A00,507421,Fischer-Grunski; Eva K,20,0,20,0
1713488307292,LIGM 5B,A00,507423,Fischer-Grunski; Eva K,20,0,20,0
1713488308320,LIGM 5C,A00,507425,Fischer-Grunski; Eva K,20,0,20,0
1713488309350,LIIT 5AS,A00,507427,Carnelos; Chiara,20,0,20,0
1713488310376,LIIT 5BS,A00,507430,Carnelos; Chiara,20,0,20,0
1713488311405,LIIT 5CS,A00,507432,Carnelos; Chiara,20,0,20,0
1713488312431,LISP 5A,A00,507541,Munoz Sanchez; Alicia,14,0,20,6
1713488313457,LISP 5B,A00,507671,Munoz Sanchez; Alicia,12,0,20,8
1713488314486,LISP 5C,A00,507696,Munoz Sanchez; Alicia,11,0,20,9
1713488315510,MAE 197,001,528363,Boechler; Nicholas Sebastia,9998,0,9999,1
1713488316537,MATH 197,001,523477,Kedlaya; Kiran S.,9999,0,9999,0
1713488316537,MATH 197,002,563811,Zhang; Danna,9998,0,9999,1
1713488317621,MCWP 40R,A00,518780,Staff,16,0,20,4
1713488317621,MCWP 40R,B00,518781,Staff,14,0,20,6
1713488317621,MCWP 40R,C00,518783,Staff,11,0,20,9
1713488318647,MCWP 50R,A00,518791,Staff,8,0,20,12
1713488318647,MCWP 50R,B00,518792,Staff,5,0,20,15
1713488318647,MCWP 50R,C00,518793,Staff,7,0,20,13
1713488318647,MCWP 50R,D00,518794,Staff,0,0,20,20
1713488318647,MCWP 50R,E00,518795,Staff,3,0,20,17
1713488318647,MCWP 50R,F00,518796,Staff,13,0,20,7
1713488318647,MCWP 50R,G00,518797,Staff,11,0,20,9
1713488319677,MMW 12R,A01,514034,Herbst; Matthew,5,0,16,11
1713488319677,MMW 12R,A02,514035,Herbst; Matthew,13,0,16,3
1713488320705,MMW 13R,A01,514037,Staff,0,4,16,16
1713488320705,MMW 13R,A02,514039,Staff,0,4,16,16
1713488322760,SIO 295LS,A00,523233,Staff,15,0,30,15
1713488323786,SIO 295S,A00,523232,Staff,15,0,30,15
1713488324818,SOCI 117,A01,494376,Staff,0,2,5,5
1713488325843,WES 237B,A00,494380,Staff,19,0,20,1
1713488327917,AESE 279B,A00,494370,Wade; Jon P,33,0,33,0
1713488328946,AIP 197,001,627712,Vespa; Emanuel Ignacio,9999,0,9999,0
1713488329971,ANAR 135S,A00,494369,Braswell; Geoffrey E.,0,0,0,0
1713488331000,CAT 124RS,A01,519847,Geibel; William,6,0,20,14
1713488332026,CAT 125RS,A01,515971,Geibel; William,6,0,20,14
1713488333056,CLRE 250,A00,511389,Morris; Sheldon,9996,0,9999,3
1713488334083,CLRE 251,A00,507176,Mehta; Ravindra L.,9996,0,9999,3
1713488334083,CLRE 251,B00,511410,Mehta; Ravindra L.,9998,0,9999,1
1713488335109,CLRE 252,A00,507189,Cuomo; Raphael Eduardo,9998,0,9999,1
1713488336134,CLRE 253,A00,507199,Vaida; Florin,9997,0,9999,2
1713488336134,CLRE 253,B00,507202,Vaida; Florin,9999,0,9999,0
1713488337159,CLRE 259,A00,507211,Patel; Hemal,9996,0,9999,3
1713488338188,CLRE 260,A00,507221,Cuomo; Raphael Eduardo,9999,0,9999,0
1713488339213,CLRE 297,001,507242,Cuomo; Raphael Eduardo,9999,0,9999,0
1713488340240,CSE 191,A00,516875,Minnes Kemp; Mor Mia,9999,0,9999,0
1713488341265,CSS 201S,A01,494383,Staff,35,0,35,0
1713488342290,CSS 202S,A01,494387,Staff,35,0,35,0
1713488343317,EAP 100,A00,516065,Staff,9792,0,9999,207
1713488344346,ECE 45,A01,507414,Staff,38,0,60,22
1713488345372,ECE 100,A01,507416,Baghdadchi; Saharnaz,0,0,20,20
1713488345372,ECE 100,A02,507418,Baghdadchi; Saharnaz,19,0,20,1
1713488346407,ECE 111,A01,507420,Staff,27,0,50,23
1713488347437,ECE 197,001,548057,Sievenpiper; Daniel F.,9998,0,9999,1
1713488348463,EDS 115,A00,507243,Choi; Bailey Miyeon,27,0,28,1
1713488349489,EDS 117,A01,494379,Staff,16,0,25,9
1713488350518,EDS 125,A00,507246,Hopkins; Megan Beth,28,0,30,2
1713488351544,EDS 128A,A01,507264,Fargason; Sharon Gayle,26,0,26,0
1713488352570,EDS 128B,A01,507293,Pappas; Elizabeth,30,0,30,0
1713488353598,EDS 139,A00,507294,Fargason; Sharon Gayle,30,0,30,0
1713488353598,EDS 139,B00,507313,Pappas; Elizabeth,30,0,30,0
1713488354623,EDS 201,A00,507315,Staff,18,0,30,12
1713488355648,EDS 203,A01,507317,Halter; Christopher P.,17,0,30,13
1713488356674,EDS 204R,A01,507319,Halter; Christopher P.,0,1,30,30
1713488356674,EDS 204R,B01,507331,Heinzman; Erica M.,26,0,30,4
1713488357701,EDS 206R,A00,507332,Staff,0,2,30,30
1713488357701,EDS 206R,B00,507343,Staff,27,0,30,3
1713488358727,EDS 250,A00,507344,Hemans; Patricia Ann Benitez,27,0,40,13
1713488359753,EDS 281,A00,507345,Daly; Alan J.,18,0,18,0
1713488360781,EDS 284,A00,507350,Daly; Alan J.,16,0,16,0
1713488361809,EDS 286,A00,507359,Fine; Sarah,18,0,18,0
1713488362832,EDS 289C,A01,507361,Daly; Alan J.,18,0,18,0
1713488363856,EDS 290,A00,507366,Hofstetter; Carolyn,15,0,15,0
1713488364883,LIGM 5A,A00,507421,Fischer-Grunski; Eva K,20,0,20,0
1713488365908,LIGM 5B,A00,507423,Fischer-Grunski; Eva K,20,0,20,0
1713488366932,LIGM 5C,A00,507425,Fischer-Grunski; Eva K,20,0,20,0
1713488367962,LIIT 5AS,A00,507427,Carnelos; Chiara,20,0,20,0
1713488368988,LIIT 5BS,A00,507430,Carnelos; Chiara,20,0,20,0
1713488370012,LIIT 5CS,A00,507432,Carnelos; Chiara,20,0,20,0
1713488376488,LISP 5A,A00,507541,Munoz Sanchez; Alicia,14,0,20,6
1713488381647,LISP 5B,A00,507671,Munoz Sanchez; Alicia,12,0,20,8
1713488382676,LISP 5C,A00,507696,Munoz Sanchez; Alicia,11,0,20,9
1713488383706,MAE 197,001,528363,Boechler; Nicholas Sebastia,9998,0,9999,1
1713488384731,MATH 197,001,523477,Kedlaya; Kiran S.,9999,0,9999,0
1713488384731,MATH 197,002,563811,Zhang; Danna,9998,0,9999,1
1713488385761,MCWP 40R,A00,518780,Staff,16,0,20,4
1713488385761,MCWP 40R,B00,518781,Staff,14,0,20,6
1713488385761,MCWP 40R,C00,518783,Staff,11,0,20,9
1713488386788,MCWP 50R,A00,518791,Staff,8,0,20,12
1713488386788,MCWP 50R,B00,518792,Staff,5,0,20,15
1713488386788,MCWP 50R,C00,518793,Staff,7,0,20,13
1713488386788,MCWP 50R,D00,518794,Staff,0,0,20,20
1713488386788,MCWP 50R,E00,518795,Staff,3,0,20,17
1713488386788,MCWP 50R,F00,518796,Staff,13,0,20,7
1713488386788,MCWP 50R,G00,518797,Staff,11,0,20,9
1713488387812,MMW 12R,A01,514034,Herbst; Matthew,5,0,16,11
1713488387812,MMW 12R,A02,514035,Herbst; Matthew,13,0,16,3
1713488388839,MMW 13R,A01,514037,Staff,0,4,16,16
1713488388839,MMW 13R,A02,514039,Staff,0,4,16,16
1713488390891,SIO 295LS,A00,523233,Staff,15,0,30,15
1713488391919,SIO 295S,A00,523232,Staff,15,0,30,15
1713488392946,SOCI 117,A01,494376,Staff,0,2,5,5
1713488393969,WES 237B,A00,494380,Staff,19,0,20,1
1713488396029,AESE 279B,A00,494370,Wade; Jon P,33,0,33,0
1713488397054,AIP 197,001,627712,Vespa; Emanuel Ignacio,9999,0,9999,0
1713488398080,ANAR 135S,A00,494369,Braswell; Geoffrey E.,0,0,0,0
1713488399104,CAT 124RS,A01,519847,Geibel; William,6,0,20,14
1713488400129,CAT 125RS,A01,515971,Geibel; William,6,0,20,14
1713488401156,CLRE 250,A00,511389,Morris; Sheldon,9996,0,9999,3
1713488402182,CLRE 251,A00,507176,Mehta; Ravindra L.,9996,0,9999,3
1713488402182,CLRE 251,B00,511410,Mehta; Ravindra L.,9998,0,9999,1
1713488403211,CLRE 252,A00,507189,Cuomo; Raphael Eduardo,9998,0,9999,1
1713488404237,CLRE 253,A00,507199,Vaida; Florin,9997,0,9999,2
1713488404237,CLRE 253,B00,507202,Vaida; Florin,9999,0,9999,0
1713488405261,CLRE 259,A00,507211,Patel; Hemal,9996,0,9999,3
1713488406284,CLRE 260,A00,507221,Cuomo; Raphael Eduardo,9999,0,9999,0
1713488407312,CLRE 297,001,507242,Cuomo; Raphael Eduardo,9999,0,9999,0
1713488408339,CSE 191,A00,516875,Minnes Kemp; Mor Mia,9999,0,9999,0
1713488409367,CSS 201S,A01,494383,Staff,35,0,35,0
1713488410397,CSS 202S,A01,494387,Staff,35,0,35,0
1713488411423,EAP 100,A00,516065,Staff,9792,0,9999,207
1713488412504,ECE 45,A01,507414,Staff,38,0,60,22
1713488413528,ECE 100,A01,507416,Baghdadchi; Saharnaz,0,0,20,20
1713488413528,ECE 100,A02,507418,Baghdadchi; Saharnaz,19,0,20,1
1713488414559,ECE 111,A01,507420,Staff,27,0,50,23
1713488415584,ECE 197,001,548057,Sievenpiper; Daniel F.,9998,0,9999,1
1713488416612,EDS 115,A00,507243,Choi; Bailey Miyeon,27,0,28,1
1713488417636,EDS 117,A01,494379,Staff,16,0,25,9
1713488418661,EDS 125,A00,507246,Hopkins; Megan Beth,28,0,30,2
1713488419686,EDS 128A,A01,507264,Fargason; Sharon Gayle,26,0,26,0
1713488420711,EDS 128B,A01,507293,Pappas; Elizabeth,30,0,30,0
1713488421739,EDS 139,A00,507294,Fargason; Sharon Gayle,30,0,30,0
1713488421739,EDS 139,B00,507313,Pappas; Elizabeth,30,0,30,0
1713488422763,EDS 201,A00,507315,Staff,18,0,30,12
1713488423790,EDS 203,A01,507317,Halter; Christopher P.,17,0,30,13
1713488424816,EDS 204R,A01,507319,Halter; Christopher P.,0,1,30,30
1713488424816,EDS 204R,B01,507331,Heinzman; Erica M.,26,0,30,4
1713488425840,EDS 206R,A00,507332,Staff,0,2,30,30
1713488425840,EDS 206R,B00,507343,Staff,27,0,30,3
1713488426866,EDS 250,A00,507344,Hemans; Patricia Ann Benitez,27,0,40,13
1713488427894,EDS 281,A00,507345,Daly; Alan J.,18,0,18,0
1713488428919,EDS 284,A00,507350,Daly; Alan J.,16,0,16,0
1713488429945,EDS 286,A00,507359,Fine; Sarah,18,0,18,0
1713488430971,EDS 289C,A01,507361,Daly; Alan J.,18,0,18,0
1713488431995,EDS 290,A00,507366,Hofstetter; Carolyn,15,0,15,0
1713488433020,LIGM 5A,A00,507421,Fischer-Grunski; Eva K,20,0,20,0
1713488434046,LIGM 5B,A00,507423,Fischer-Grunski; Eva K,20,0,20,0
1713488435069,LIGM 5C,A00,507425,Fischer-Grunski; Eva K,20,0,20,0
1713488436099,LIIT 5AS,A00,507427,Carnelos; Chiara,20,0,20,0
1713488437126,LIIT 5BS,A00,507430,Carnelos; Chiara,20,0,20,0
1713488438153,LIIT 5CS,A00,507432,Carnelos; Chiara,20,0,20,0
1713488439178,LISP 5A,A00,507541,Munoz Sanchez; Alicia,14,0,20,6
1713488440206,LISP 5B,A00,507671,Munoz Sanchez; Alicia,12,0,20,8
1713488441235,LISP 5C,A00,507696,Munoz Sanchez; Alicia,11,0,20,9
1713488442261,MAE 197,001,528363,Boechler; Nicholas Sebastia,9998,0,9999,1
1713488443285,MATH 197,001,523477,Kedlaya; Kiran S.,9999,0,9999,0
1713488443285,MATH 197,002,563811,Zhang; Danna,9998,0,9999,1
1713488444309,MCWP 40R,A00,518780,Staff,16,0,20,4
1713488444309,MCWP 40R,B00,518781,Staff,14,0,20,6
1713488444309,MCWP 40R,C00,518783,Staff,11,0,20,9
1713488445334,MCWP 50R,A00,518791,Staff,8,0,20,12
1713488445334,MCWP 50R,B00,518792,Staff,5,0,20,15
1713488445334,MCWP 50R,C00,518793,Staff,7,0,20,13
1713488445334,MCWP 50R,D00,518794,Staff,0,0,20,20
1713488445334,MCWP 50R,E00,518795,Staff,3,0,20,17
1713488445334,MCWP 50R,F00,518796,Staff,13,0,20,7
1713488445334,MCWP 50R,G00,518797,Staff,11,0,20,9
1713488446358,MMW 12R,A01,514034,Herbst; Matthew,5,0,16,11
1713488446358,MMW 12R,A02,514035,Herbst; Matthew,13,0,16,3
1713488447383,MMW 13R,A01,514037,Staff,0,4,16,16
1713488447383,MMW 13R,A02,514039,Staff,0,4,16,16
1713488449436,SIO 295LS,A00,523233,Staff,15,0,30,15
1713488450466,SIO 295S,A00,523232,Staff,15,0,30,15
1713488451491,SOCI 117,A01,494376,Staff,0,2,5,5
1713488452516,WES 237B,A00,494380,Staff,19,0,20,1
1713488454592,AESE 279B,A00,494370,Wade; Jon P,33,0,33,0
1713488455619,AIP 197,001,627712,Vespa; Emanuel Ignacio,9999,0,9999,0
1713488456644,ANAR 135S,A00,494369,Braswell; Geoffrey E.,0,0,0,0
1713488457672,CAT 124RS,A01,519847,Geibel; William,6,0,20,14
1713488458697,CAT 125RS,A01,515971,Geibel; William,6,0,20,14
1713488459721,CLRE 250,A00,511389,Morris; Sheldon,9996,0,9999,3
1713488460745,CLRE 251,A00,507176,Mehta; Ravindra L.,9996,0,9999,3
1713488460745,CLRE 251,B00,511410,Mehta; Ravindra L.,9998,0,9999,1
1713488461772,CLRE 252,A00,507189,Cuomo; Raphael Eduardo,9998,0,9999,1
1713488462797,CLRE 253,A00,507199,Vaida; Florin,9997,0,9999,2
1713488462797,CLRE 253,B00,507202,Vaida; Florin,9999,0,9999,0
1713488463826,CLRE 259,A00,507211,Patel; Hemal,9996,0,9999,3
1713488464852,CLRE 260,A00,507221,Cuomo; Raphael Eduardo,9999,0,9999,0
1713488465882,CLRE 297,001,507242,Cuomo; Raphael Eduardo,9999,0,9999,0
1713488466912,CSE 191,A00,516875,Minnes Kemp; Mor Mia,9999,0,9999,0
1713488467942,CSS 201S,A01,494383,Staff,35,0,35,0
1713488468970,CSS 202S,A01,494387,Staff,35,0,35,0
1713488469995,EAP 100,A00,516065,Staff,9792,0,9999,207
1713488471021,ECE 45,A01,507414,Staff,38,0,60,22
1713488472047,ECE 100,A01,507416,Baghdadchi; Saharnaz,0,0,20,20
1713488472047,ECE 100,A02,507418,Baghdadchi; Saharnaz,19,0,20,1
1713488473072,ECE 111,A01,507420,Staff,27,0,50,23
1713488474098,ECE 197,001,548057,Sievenpiper; Daniel F.,9998,0,9999,1
1713488475123,EDS 115,A00,507243,Choi; Bailey Miyeon,27,0,28,1
1713488476148,EDS 117,A01,494379,Staff,16,0,25,9
1713488477176,EDS 125,A00,507246,Hopkins; Megan Beth,28,0,30,2
1713488478202,EDS 128A,A01,507264,Fargason; Sharon Gayle,26,0,26,0
1713488479225,EDS 128B,A01,507293,Pappas; Elizabeth,30,0,30,0
1713488480286,EDS 139,A00,507294,Fargason; Sharon Gayle,30,0,30,0
1713488480286,EDS 139,B00,507313,Pappas; Elizabeth,30,0,30,0
1713488481315,EDS 201,A00,507315,Staff,18,0,30,12
1713488482339,EDS 203,A01,507317,Halter; Christopher P.,17,0,30,13
1713488483368,EDS 204R,A01,507319,Halter; Christopher P.,0,1,30,30
1713488483368,EDS 204R,B01,507331,Heinzman; Erica M.,26,0,30,4
1713488484394,EDS 206R,A00,507332,Staff,0,2,30,30
1713488484394,EDS 206R,B00,507343,Staff,27,0,30,3
1713488485419,EDS 250,A00,507344,Hemans; Patricia Ann Benitez,27,0,40,13
1713488486448,EDS 281,A00,507345,Daly; Alan J.,18,0,18,0
1713488487475,EDS 284,A00,507350,Daly; Alan J.,16,0,16,0
1713488488503,EDS 286,A00,507359,Fine; Sarah,18,0,18,0
1713488489533,EDS 289C,A01,507361,Daly; Alan J.,18,0,18,0
1713488490562,EDS 290,A00,507366,Hofstetter; Carolyn,15,0,15,0
1713488491585,LIGM 5A,A00,507421,Fischer-Grunski; Eva K,20,0,20,0
1713488492614,LIGM 5B,A00,507423,Fischer-Grunski; Eva K,20,0,20,0
1713488493639,LIGM 5C,A00,507425,Fischer-Grunski; Eva K,20,0,20,0
1713488494664,LIIT 5AS,A00,507427,Carnelos; Chiara,20,0,20,0
1713488495689,LIIT 5BS,A00,507430,Carnelos; Chiara,20,0,20,0
1713488496714,LIIT 5CS,A00,507432,Carnelos; Chiara,20,0,20,0
1713488497738,LISP 5A,A00,507541,Munoz Sanchez; Alicia,14,0,20,6
1713488498763,LISP 5B,A00,507671,Munoz Sanchez; Alicia,12,0,20,8
1713488499790,LISP 5C,A00,507696,Munoz Sanchez; Alicia,11,0,20,9
1713488500815,MAE 197,001,528363,Boechler; Nicholas Sebastia,9998,0,9999,1
1713488501843,MATH 197,001,523477,Kedlaya; Kiran S.,9999,0,9999,0
1713488501843,MATH 197,002,563811,Zhang; Danna,9998,0,9999,1
1713488502872,MCWP 40R,A00,518780,Staff,16,0,20,4
1713488502872,MCWP 40R,B00,518781,Staff,14,0,20,6
1713488502872,MCWP 40R,C00,518783,Staff,10,0,20,10
1713488503903,MCWP 50R,A00,518791,Staff,8,0,20,12
1713488503903,MCWP 50R,B00,518792,Staff,5,0,20,15
1713488503903,MCWP 50R,C00,518793,Staff,7,0,20,13
1713488503903,MCWP 50R,D00,518794,Staff,0,0,20,20
1713488503903,MCWP 50R,E00,518795,Staff,3,0,20,17
1713488503903,MCWP 50R,F00,518796,Staff,13,0,20,7
1713488503903,MCWP 50R,G00,518797,Staff,11,0,20,9
1713488504930,MMW 12R,A01,514034,Herbst; Matthew,5,0,16,11
1713488504930,MMW 12R,A02,514035,Herbst; Matthew,13,0,16,3
1713488505955,MMW 13R,A01,514037,Staff,0,4,16,16
1713488505955,MMW 13R,A02,514039,Staff,0,4,16,16
1713488508011,SIO 295LS,A00,523233,Staff,15,0,30,15
1713488509037,SIO 295S,A00,523232,Staff,15,0,30,15
1713488510063,SOCI 117,A01,494376,Staff,0,2,5,5
1713488511092,WES 237B,A00,494380,Staff,19,0,20,1
1713488513155,AESE 279B,A00,494370,Wade; Jon P,33,0,33,0
1713488514181,AIP 197,001,627712,Vespa; Emanuel Ignacio,9999,0,9999,0
1713488515206,ANAR 135S,A00,494369,Braswell; Geoffrey E.,0,0,0,0
1713488516288,CAT 124RS,A01,519847,Geibel; William,6,0,20,14
1713488517313,CAT 125RS,A01,515971,Geibel; William,6,0,20,14
1713488518340,CLRE 250,A00,511389,Morris; Sheldon,9996,0,9999,3
1713488519455,CLRE 251,A00,507176,Mehta; Ravindra L.,9996,0,9999,3
1713488519455,CLRE 251,B00,511410,Mehta; Ravindra L.,9998,0,9999,1
1713488520479,CLRE 252,A00,507189,Cuomo; Raphael Eduardo,9998,0,9999,1
1713488521507,CLRE 253,A00,507199,Vaida; Florin,9997,0,9999,2
1713488521507,CLRE 253,B00,507202,Vaida; Florin,9999,0,9999,0
1713488522534,CLRE 259,A00,507211,Patel; Hemal,9996,0,9999,3
1713488523562,CLRE 260,A00,507221,Cuomo; Raphael Eduardo,9999,0,9999,0
1713488524590,CLRE 297,001,507242,Cuomo; Raphael Eduardo,9999,0,9999,0
1713488525615,CSE 191,A00,516875,Minnes Kemp; Mor Mia,9999,0,9999,0
1713488526652,CSS 201S,A01,494383,Staff,35,0,35,0
1713488527680,CSS 202S,A01,494387,Staff,35,0,35,0
1713488528707,EAP 100,A00,516065,Staff,9792,0,9999,207
1713488529732,ECE 45,A01,507414,Staff,38,0,60,22
1713488530761,ECE 100,A01,507416,Baghdadchi; Saharnaz,0,0,20,20
1713488530761,ECE 100,A02,507418,Baghdadchi; Saharnaz,19,0,20,1
1713488531786,ECE 111,A01,507420,Staff,27,0,50,23
1713488532813,ECE 197,001,548057,Sievenpiper; Daniel F.,9998,0,9999,1
1713488533840,EDS 115,A00,507243,Choi; Bailey Miyeon,27,0,28,1
1713488534864,EDS 117,A01,494379,Staff,16,0,25,9
1713488535893,EDS 125,A00,507246,Hopkins; Megan Beth,28,0,30,2
1713488536918,EDS 128A,A01,507264,Fargason; Sharon Gayle,26,0,26,0
1713488537948,EDS 128B,A01,507293,Pappas; Elizabeth,30,0,30,0
1713488538974,EDS 139,A00,507294,Fargason; Sharon Gayle,30,0,30,0
1713488538974,EDS 139,B00,507313,Pappas; Elizabeth,30,0,30,0
1713488540002,EDS 201,A00,507315,Staff,18,0,30,12
1713488541030,EDS 203,A01,507317,Halter; Christopher P.,17,0,30,13
1713488542060,EDS 204R,A01,507319,Halter; Christopher P.,0,1,30,30
1713488542060,EDS 204R,B01,507331,Heinzman; Erica M.,26,0,30,4
1713488543086,EDS 206R,A00,507332,Staff,0,2,30,30
1713488543086,EDS 206R,B00,507343,Staff,27,0,30,3
1713488544115,EDS 250,A00,507344,Hemans; Patricia Ann Benitez,27,0,40,13
1713488545142,EDS 281,A00,507345,Daly; Alan J.,18,0,18,0
1713488546165,EDS 284,A00,507350,Daly; Alan J.,16,0,16,0
1713488547193,EDS 286,A00,507359,Fine; Sarah,18,0,18,0
1713488548220,EDS 289C,A01,507361,Daly; Alan J.,18,0,18,0
1713488549248,EDS 290,A00,507366,Hofstetter; Carolyn,15,0,15,0
1713488550276,LIGM 5A,A00,507421,Fischer-Grunski; Eva K,20,0,20,0
1713488551305,LIGM 5B,A00,507423,Fischer-Grunski; Eva K,20,0,20,0
1713488552333,LIGM 5C,A00,507425,Fischer-Grunski; Eva K,20,0,20,0
1713488553362,LIIT 5AS,A00,507427,Carnelos; Chiara,20,0,20,0
1713488554393,LIIT 5BS,A00,507430,Carnelos; Chiara,20,0,20,0
1713488555417,LIIT 5CS,A00,507432,Carnelos; Chiara,20,0,20,0
1713488556447,LISP 5A,A00,507541,Munoz Sanchez; Alicia,14,0,20,6
1713488557471,LISP 5B,A00,507671,Munoz Sanchez; Alicia,12,0,20,8
1713488558499,LISP 5C,A00,507696,Munoz Sanchez; Alicia,11,0,20,9
1713488559524,MAE 197,001,528363,Boechler; Nicholas Sebastia,9998,0,9999,1
1713488560549,MATH 197,001,523477,Kedlaya; Kiran S.,9999,0,9999,0
1713488560549,MATH 197,002,563811,Zhang; Danna,9998,0,9999,1
1713488561577,MCWP 40R,A00,518780,Staff,16,0,20,4
1713488561577,MCWP 40R,B00,518781,Staff,14,0,20,6
1713488561577,MCWP 40R,C00,518783,Staff,10,0,20,10
1713488562603,MCWP 50R,A00,518791,Staff,8,0,20,12
1713488562603,MCWP 50R,B00,518792,Staff,5,0,20,15
1713488562603,MCWP 50R,C00,518793,Staff,7,0,20,13
1713488562603,MCWP 50R,D00,518794,Staff,0,0,20,20
1713488562603,MCWP 50R,E00,518795,Staff,3,0,20,17
1713488562603,MCWP 50R,F00,518796,Staff,13,0,20,7
1713488562603,MCWP 50R,G00,518797,Staff,11,0,20,9
1713488563632,MMW 12R,A01,514034,Herbst; Matthew,5,0,16,11
1713488563632,MMW 12R,A02,514035,Herbst; Matthew,13,0,16,3
1713488564660,MMW 13R,A01,514037,Staff,0,4,16,16
1713488564660,MMW 13R,A02,514039,Staff,0,4,16,16
1713488566713,SIO 295LS,A00,523233,Staff,15,0,30,15
1713488567738,SIO 295S,A00,523232,Staff,15,0,30,15
1713488568763,SOCI 117,A01,494376,Staff,0,2,5,5
1713488569790,WES 237B,A00,494380,Staff,19,0,20,1
1713488571859,AESE 279B,A00,494370,Wade; Jon P,33,0,33,0
1713488572887,AIP 197,001,627712,Vespa; Emanuel Ignacio,9999,0,9999,0
1713488573914,ANAR 135S,A00,494369,Braswell; Geoffrey E.,0,0,0,0
1713488574943,CAT 124RS,A01,519847,Geibel; William,6,0,20,14
1713488575968,CAT 125RS,A01,515971,Geibel; William,6,0,20,14
1713488576992,CLRE 250,A00,511389,Morris; Sheldon,9996,0,9999,3
1713488578022,CLRE 251,A00,507176,Mehta; Ravindra L.,9996,0,9999,3
1713488578022,CLRE 251,B00,511410,Mehta; Ravindra L.,9998,0,9999,1
1713488579046,CLRE 252,A00,507189,Cuomo; Raphael Eduardo,9998,0,9999,1
1713488580072,CLRE 253,A00,507199,Vaida; Florin,9997,0,9999,2
1713488580072,CLRE 253,B00,507202,Vaida; Florin,9999,0,9999,0
1713488581109,CLRE 259,A00,507211,Patel; Hemal,9996,0,9999,3
1713488582137,CLRE 260,A00,507221,Cuomo; Raphael Eduardo,9999,0,9999,0
1713488583167,CLRE 297,001,507242,Cuomo; Raphael Eduardo,9999,0,9999,0
1713488584193,CSE 191,A00,516875,Minnes Kemp; Mor Mia,9999,0,9999,0
1713488585234,CSS 201S,A01,494383,Staff,35,0,35,0
1713488586261,CSS 202S,A01,494387,Staff,35,0,35,0
1713488587287,EAP 100,A00,516065,Staff,9792,0,9999,207
1713488588316,ECE 45,A01,507414,Staff,38,0,60,22
1713488589345,ECE 100,A01,507416,Baghdadchi; Saharnaz,0,0,20,20
1713488589345,ECE 100,A02,507418,Baghdadchi; Saharnaz,19,0,20,1
1713488590373,ECE 111,A01,507420,Staff,27,0,50,23
1713488591401,ECE 197,001,548057,Sievenpiper; Daniel F.,9998,0,9999,1
1713488592433,EDS 115,A00,507243,Choi; Bailey Miyeon,27,0,28,1
1713488593719,EDS 117,A01,494379,Staff,16,0,25,9
1713488594744,EDS 125,A00,507246,Hopkins; Megan Beth,28,0,30,2
1713488595770,EDS 128A,A01,507264,Fargason; Sharon Gayle,26,0,26,0
1713488596796,EDS 128B,A01,507293,Pappas; Elizabeth,30,0,30,0
1713488597821,EDS 139,A00,507294,Fargason; Sharon Gayle,30,0,30,0
1713488597821,EDS 139,B00,507313,Pappas; Elizabeth,30,0,30,0
1713488598847,EDS 201,A00,507315,Staff,18,0,30,12
1713488599875,EDS 203,A01,507317,Halter; Christopher P.,17,0,30,13
1713488600900,EDS 204R,A01,507319,Halter; Christopher P.,0,1,30,30
1713488600900,EDS 204R,B01,507331,Heinzman; Erica M.,26,0,30,4
1713488601929,EDS 206R,A00,507332,Staff,0,2,30,30
1713488601929,EDS 206R,B00,507343,Staff,27,0,30,3
1713488602953,EDS 250,A00,507344,Hemans; Patricia Ann Benitez,27,0,40,13
1713488603978,EDS 281,A00,507345,Daly; Alan J.,18,0,18,0
1713488605003,EDS 284,A00,507350,Daly; Alan J.,16,0,16,0
1713488606028,EDS 286,A00,507359,Fine; Sarah,18,0,18,0
1713488607057,EDS 289C,A01,507361,Daly; Alan J.,18,0,18,0
1713488608083,EDS 290,A00,507366,Hofstetter; Carolyn,15,0,15,0
1713488609109,LIGM 5A,A00,507421,Fischer-Grunski; Eva K,20,0,20,0
1713488610138,LIGM 5B,A00,507423,Fischer-Grunski; Eva K,20,0,20,0
1713488611163,LIGM 5C,A00,507425,Fischer-Grunski; Eva K,20,0,20,0
1713488612189,LIIT 5AS,A00,507427,Carnelos; Chiara,20,0,20,0
1713488613215,LIIT 5BS,A00,507430,Carnelos; Chiara,20,0,20,0
1713488614243,LIIT 5CS,A00,507432,Carnelos; Chiara,20,0,20,0
1713488615268,LISP 5A,A00,507541,Munoz Sanchez; Alicia,14,0,20,6
1713488616294,LISP 5B,A00,507671,Munoz Sanchez; Alicia,12,0,20,8
1713488617320,LISP 5C,A00,507696,Munoz Sanchez; Alicia,11,0,20,9
1713488618347,MAE 197,001,528363,Boechler; Nicholas Sebastia,9998,0,9999,1
1713488619372,MATH 197,001,523477,Kedlaya; Kiran S.,9999,0,9999,0
1713488619372,MATH 197,002,563811,Zhang; Danna,9998,0,9999,1
1713488620456,MCWP 40R,A00,518780,Staff,16,0,20,4
1713488620456,MCWP 40R,B00,518781,Staff,14,0,20,6
1713488620456,MCWP 40R,C00,518783,Staff,10,0,20,10
1713488621486,MCWP 50R,A00,518791,Staff,8,0,20,12
1713488621486,MCWP 50R,B00,518792,Staff,5,0,20,15
1713488621486,MCWP 50R,C00,518793,Staff,7,0,20,13
1713488621486,MCWP 50R,D00,518794,Staff,0,0,20,20
1713488621486,MCWP 50R,E00,518795,Staff,3,0,20,17
1713488621486,MCWP 50R,F00,518796,Staff,13,0,20,7
1713488621486,MCWP 50R,G00,518797,Staff,11,0,20,9
1713488622508,MMW 12R,A01,514034,Herbst; Matthew,5,0,16,11
1713488622508,MMW 12R,A02,514035,Herbst; Matthew,13,0,16,3
1713488623536,MMW 13R,A01,514037,Staff,0,4,16,16
1713488623536,MMW 13R,A02,514039,Staff,0,4,16,16
1713488625588,SIO 295LS,A00,523233,Staff,15,0,30,15
1713488626612,SIO 295S,A00,523232,Staff,15,0,30,15
1713488627639,SOCI 117,A01,494376,Staff,0,2,5,5
1713488628664,WES 237B,A00,494380,Staff,19,0,20,1
1713488630741,AESE 279B,A00,494370,Wade; Jon P,33,0,33,0
1713488631769,AIP 197,001,627712,Vespa; Emanuel Ignacio,9999,0,9999,0
1713488632794,ANAR 135S,A00,494369,Braswell; Geoffrey E.,0,0,0,0
1713488633820,CAT 124RS,A01,519847,Geibel; William,6,0,20,14
1713488634848,CAT 125RS,A01,515971,Geibel; William,6,0,20,14
1713488635875,CLRE 250,A00,511389,Morris; Sheldon,9996,0,9999,3
1713488636900,CLRE 251,A00,507176,Mehta; Ravindra L.,9996,0,9999,3
1713488636900,CLRE 251,B00,511410,Mehta; Ravindra L.,9998,0,9999,1
1713488637926,CLRE 252,A00,507189,Cuomo; Raphael Eduardo,9998,0,9999,1
1713488638955,CLRE 253,A00,507199,Vaida; Florin,9997,0,9999,2
1713488638955,CLRE 253,B00,507202,Vaida; Florin,9999,0,9999,0
1713488639980,CLRE 259,A00,507211,Patel; Hemal,9996,0,9999,3
1713488641004,CLRE 260,A00,507221,Cuomo; Raphael Eduardo,9999,0,9999,0
1713488642031,CLRE 297,001,507242,Cuomo; Raphael Eduardo,9999,0,9999,0
1713488643057,CSE 191,A00,516875,Minnes Kemp; Mor Mia,9999,0,9999,0
1713488644084,CSS 201S,A01,494383,Staff,35,0,35,0
1713488645114,CSS 202S,A01,494387,Staff,35,0,35,0
1713488646142,EAP 100,A00,516065,Staff,9792,0,9999,207
1713488647166,ECE 45,A01,507414,Staff,38,0,60,22
1713488648194,ECE 100,A01,507416,Baghdadchi; Saharnaz,0,0,20,20
1713488648194,ECE 100,A02,507418,Baghdadchi; Saharnaz,19,0,20,1
1713488649219,ECE 111,A01,507420,Staff,27,0,50,23
1713488650247,ECE 197,001,548057,Sievenpiper; Daniel F.,9998,0,9999,1
1713488651275,EDS 115,A00,507243,Choi; Bailey Miyeon,27,0,28,1
1713488652300,EDS 117,A01,494379,Staff,16,0,25,9
1713488653329,EDS 125,A00,507246,Hopkins; Megan Beth,28,0,30,2
1713488654354,EDS 128A,A01,507264,Fargason; Sharon Gayle,26,0,26,0
1713488655382,EDS 128B,A01,507293,Pappas; Elizabeth,30,0,30,0
1713488656407,EDS 139,A00,507294,Fargason; Sharon Gayle,30,0,30,0
1713488656407,EDS 139,B00,507313,Pappas; Elizabeth,30,0,30,0
1713488657437,EDS 201,A00,507315,Staff,18,0,30,12
1713488658462,EDS 203,A01,507317,Halter; Christopher P.,17,0,30,13
1713488659487,EDS 204R,A01,507319,Halter; Christopher P.,0,1,30,30
1713488659487,EDS 204R,B01,507331,Heinzman; Erica M.,26,0,30,4
1713488660516,EDS 206R,A00,507332,Staff,0,2,30,30
1713488660516,EDS 206R,B00,507343,Staff,27,0,30,3
1713488661541,EDS 250,A00,507344,Hemans; Patricia Ann Benitez,27,0,40,13
1713488662569,EDS 281,A00,507345,Daly; Alan J.,18,0,18,0
1713488663598,EDS 284,A00,507350,Daly; Alan J.,16,0,16,0
1713488664624,EDS 286,A00,507359,Fine; Sarah,18,0,18,0
1713488665651,EDS 289C,A01,507361,Daly; Alan J.,18,0,18,0
1713488666676,EDS 290,A00,507366,Hofstetter; Carolyn,15,0,15,0
1713488667701,LIGM 5A,A00,507421,Fischer-Grunski; Eva K,20,0,20,0
1713488668726,LIGM 5B,A00,507423,Fischer-Grunski; Eva K,20,0,20,0
1713488669751,LIGM 5C,A00,507425,Fischer-Grunski; Eva K,20,0,20,0
1713488670776,LIIT 5AS,A00,507427,Carnelos; Chiara,20,0,20,0
1713488671807,LIIT 5BS,A00,507430,Carnelos; Chiara,20,0,20,0
1713488672833,LIIT 5CS,A00,507432,Carnelos; Chiara,20,0,20,0
1713488673857,LISP 5A,A00,507541,Munoz Sanchez; Alicia,14,0,20,6
1713488674882,LISP 5B,A00,507671,Munoz Sanchez; Alicia,12,0,20,8
1713488675907,LISP 5C,A00,507696,Munoz Sanchez; Alicia,11,0,20,9
1713488676932,MAE 197,001,528363,Boechler; Nicholas Sebastia,9998,0,9999,1
1713488677957,MATH 197,001,523477,Kedlaya; Kiran S.,9999,0,9999,0
1713488677957,MATH 197,002,563811,Zhang; Danna,9998,0,9999,1
1713488678985,MCWP 40R,A00,518780,Staff,16,0,20,4
1713488678985,MCWP 40R,B00,518781,Staff,14,0,20,6
1713488678985,MCWP 40R,C00,518783,Staff,10,0,20,10
1713488680011,MCWP 50R,A00,518791,Staff,8,0,20,12
1713488680011,MCWP 50R,B00,518792,Staff,5,0,20,15
1713488680011,MCWP 50R,C00,518793,Staff,7,0,20,13
1713488680011,MCWP 50R,D00,518794,Staff,0,0,20,20
1713488680011,MCWP 50R,E00,518795,Staff,3,0,20,17
1713488680011,MCWP 50R,F00,518796,Staff,13,0,20,7
1713488680011,MCWP 50R,G00,518797,Staff,11,0,20,9
1713488681037,MMW 12R,A01,514034,Herbst; Matthew,5,0,16,11
1713488681037,MMW 12R,A02,514035,Herbst; Matthew,13,0,16,3
1713488682065,MMW 13R,A01,514037,Staff,0,4,16,16
1713488682065,MMW 13R,A02,514039,Staff,0,4,16,16
1713488684117,SIO 295LS,A00,523233,Staff,15,0,30,15
1713488685145,SIO 295S,A00,523232,Staff,15,0,30,15
1713488686169,SOCI 117,A01,494376,Staff,0,2,5,5
1713488687195,WES 237B,A00,494380,Staff,19,0,20,1
1713488689310,AESE 279B,A00,494370,Wade; Jon P,33,0,33,0
1713488690335,AIP 197,001,627712,Vespa; Emanuel Ignacio,9999,0,9999,0
1713488691361,ANAR 135S,A00,494369,Braswell; Geoffrey E.,0,0,0,0
1713488692384,CAT 124RS,A01,519847,Geibel; William,6,0,20,14
1713488693410,CAT 125RS,A01,515971,Geibel; William,6,0,20,14
1713488694434,CLRE 250,A00,511389,Morris; Sheldon,9996,0,9999,3
1713488695458,CLRE 251,A00,507176,Mehta; Ravindra L.,9996,0,9999,3
1713488695458,CLRE 251,B00,511410,Mehta; Ravindra L.,9998,0,9999,1
1713488696488,CLRE 252,A00,507189,Cuomo; Raphael Eduardo,9998,0,9999,1
1713488697515,CLRE 253,A00,507199,Vaida; Florin,9997,0,9999,2
1713488697515,CLRE 253,B00,507202,Vaida; Florin,9999,0,9999,0
1713488698540,CLRE 259,A00,507211,Patel; Hemal,9996,0,9999,3
1713488699568,CLRE 260,A00,507221,Cuomo; Raphael Eduardo,9999,0,9999,0
1713488700596,CLRE 297,001,507242,Cuomo; Raphael Eduardo,9999,0,9999,0
1713488701621,CSE 191,A00,516875,Minnes Kemp; Mor Mia,9999,0,9999,0
1713488702647,CSS 201S,A01,494383,Staff,35,0,35,0
1713488703672,CSS 202S,A01,494387,Staff,35,0,35,0
1713488704697,EAP 100,A00,516065,Staff,9792,0,9999,207
1713488705725,ECE 45,A01,507414,Staff,38,0,60,22
1713488706751,ECE 100,A01,507416,Baghdadchi; Saharnaz,0,0,20,20
1713488706751,ECE 100,A02,507418,Baghdadchi; Saharnaz,19,0,20,1
1713488707775,ECE 111,A01,507420,Staff,27,0,50,23
1713488708800,ECE 197,001,548057,Sievenpiper; Daniel F.,9998,0,9999,1
1713488709830,EDS 115,A00,507243,Choi; Bailey Miyeon,27,0,28,1
1713488710856,EDS 117,A01,494379,Staff,16,0,25,9
1713488711884,EDS 125,A00,507246,Hopkins; Megan Beth,28,0,30,2
1713488712910,EDS 128A,A01,507264,Fargason; Sharon Gayle,26,0,26,0
1713488713935,EDS 128B,A01,507293,Pappas; Elizabeth,30,0,30,0
1713488714960,EDS 139,A00,507294,Fargason; Sharon Gayle,30,0,30,0
1713488714960,EDS 139,B00,507313,Pappas; Elizabeth,30,0,30,0
1713488715987,EDS 201,A00,507315,Staff,18,0,30,12
1713488717014,EDS 203,A01,507317,Halter; Christopher P.,17,0,30,13
1713488718039,EDS 204R,A01,507319,Halter; Christopher P.,0,1,30,30
1713488718039,EDS 204R,B01,507331,Heinzman; Erica M.,26,0,30,4
1713488719066,EDS 206R,A00,507332,Staff,0,2,30,30
1713488719066,EDS 206R,B00,507343,Staff,27,0,30,3
1713488720094,EDS 250,A00,507344,Hemans; Patricia Ann Benitez,27,0,40,13
1713488721121,EDS 281,A00,507345,Daly; Alan J.,18,0,18,0
1713488722146,EDS 284,A00,507350,Daly; Alan J.,16,0,16,0
1713488723172,EDS 286,A00,507359,Fine; Sarah,18,0,18,0
1713488724258,EDS 289C,A01,507361,Daly; Alan J.,18,0,18,0
1713488725286,EDS 290,A00,507366,Hofstetter; Carolyn,15,0,15,0
1713488726312,LIGM 5A,A00,507421,Fischer-Grunski; Eva K,20,0,20,0
1713488727341,LIGM 5B,A00,507423,Fischer-Grunski; Eva K,20,0,20,0
1713488728366,LIGM 5C,A00,507425,Fischer-Grunski; Eva K,20,0,20,0
1713488729395,LIIT 5AS,A00,507427,Carnelos; Chiara,20,0,20,0
1713488730425,LIIT 5BS,A00,507430,Carnelos; Chiara,20,0,20,0
1713488731451,LIIT 5CS,A00,507432,Carnelos; Chiara,20,0,20,0
1713488732480,LISP 5A,A00,507541,Munoz Sanchez; Alicia,14,0,20,6
1713488733526,LISP 5B,A00,507671,Munoz Sanchez; Alicia,12,0,20,8
1713488734551,LISP 5C,A00,507696,Munoz Sanchez; Alicia,11,0,20,9
1713488735576,MAE 197,001,528363,Boechler; Nicholas Sebastia,9998,0,9999,1
1713488736601,MATH 197,001,523477,Kedlaya; Kiran S.,9999,0,9999,0
1713488736601,MATH 197,002,563811,Zhang; Danna,9998,0,9999,1
1713488737628,MCWP 40R,A00,518780,Staff,16,0,20,4
1713488737628,MCWP 40R,B00,518781,Staff,14,0,20,6
1713488737628,MCWP 40R,C00,518783,Staff,10,0,20,10
1713488738655,MCWP 50R,A00,518791,Staff,8,0,20,12
1713488738655,MCWP 50R,B00,518792,Staff,5,0,20,15
1713488738655,MCWP 50R,C00,518793,Staff,7,0,20,13
1713488738655,MCWP 50R,D00,518794,Staff,0,0,20,20
1713488738655,MCWP 50R,E00,518795,Staff,3,0,20,17
1713488738655,MCWP 50R,F00,518796,Staff,13,0,20,7
1713488738655,MCWP 50R,G00,518797,Staff,11,0,20,9
1713488739678,MMW 12R,A01,514034,Herbst; Matthew,5,0,16,11
1713488739678,MMW 12R,A02,514035,Herbst; Matthew,13,0,16,3
1713488740706,MMW 13R,A01,514037,Staff,0,4,16,16
1713488740706,MMW 13R,A02,514039,Staff,0,4,16,16
1713488742755,SIO 295LS,A00,523233,Staff,15,0,30,15
1713488743785,SIO 295S,A00,523232,Staff,15,0,30,15
1713488744809,SOCI 117,A01,494376,Staff,0,2,5,5
1713488745834,WES 237B,A00,494380,Staff,19,0,20,1
1713488747897,AESE 279B,A00,494370,Wade; Jon P,33,0,33,0
1713488748921,AIP 197,001,627712,Vespa; Emanuel Ignacio,9999,0,9999,0
1713488749946,ANAR 135S,A00,494369,Braswell; Geoffrey E.,0,0,0,0
1713488750970,CAT 124RS,A01,519847,Geibel; William,6,0,20,14
1713488751995,CAT 125RS,A01,515971,Geibel; William,6,0,20,14
1713488753020,CLRE 250,A00,511389,Morris; Sheldon,9996,0,9999,3
1713488754046,CLRE 251,A00,507176,Mehta; Ravindra L.,9996,0,9999,3
1713488754046,CLRE 251,B00,511410,Mehta; Ravindra L.,9998,0,9999,1
1713488755074,CLRE 252,A00,507189,Cuomo; Raphael Eduardo,9998,0,9999,1
1713488756103,CLRE 253,A00,507199,Vaida; Florin,9997,0,9999,2
1713488756103,CLRE 253,B00,507202,Vaida; Florin,9999,0,9999,0
1713488757128,CLRE 259,A00,507211,Patel; Hemal,9996,0,9999,3
1713488758155,CLRE 260,A00,507221,Cuomo; Raphael Eduardo,9999,0,9999,0
1713488759184,CLRE 297,001,507242,Cuomo; Raphael Eduardo,9999,0,9999,0
1713488760210,CSE 191,A00,516875,Minnes Kemp; Mor Mia,9999,0,9999,0
1713488761238,CSS 201S,A01,494383,Staff,35,0,35,0
1713488762265,CSS 202S,A01,494387,Staff,35,0,35,0
1713488763290,EAP 100,A00,516065,Staff,9792,0,9999,207
1713488764315,ECE 45,A01,507414,Staff,38,0,60,22
1713488765342,ECE 100,A01,507416,Baghdadchi; Saharnaz,0,0,20,20
1713488765342,ECE 100,A02,507418,Baghdadchi; Saharnaz,19,0,20,1
1713488766368,ECE 111,A01,507420,Staff,27,0,50,23
1713488767395,ECE 197,001,548057,Sievenpiper; Daniel F.,9998,0,9999,1
1713488768420,EDS 115,A00,507243,Choi; Bailey Miyeon,27,0,28,1
1713488769445,EDS 117,A01,494379,Staff,16,0,25,9
1713488770476,EDS 125,A00,507246,Hopkins; Megan Beth,28,0,30,2
1713488771503,EDS 128A,A01,507264,Fargason; Sharon Gayle,26,0,26,0
1713488772529,EDS 128B,A01,507293,Pappas; Elizabeth,30,0,30,0
1713488773554,EDS 139,A00,507294,Fargason; Sharon Gayle,30,0,30,0
1713488773554,EDS 139,B00,507313,Pappas; Elizabeth,30,0,30,0
1713488774579,EDS 201,A00,507315,Staff,18,0,30,12
1713488775603,EDS 203,A01,507317,Halter; Christopher P.,17,0,30,13
1713488776634,EDS 204R,A01,507319,Halter; Christopher P.,0,1,30,30
1713488776634,EDS 204R,B01,507331,Heinzman; Erica M.,26,0,30,4
1713488777662,EDS 206R,A00,507332,Staff,0,2,30,30
1713488777662,EDS 206R,B00,507343,Staff,27,0,30,3
1713488778687,EDS 250,A00,507344,Hemans; Patricia Ann Benitez,27,0,40,13
1713488779711,EDS 281,A00,507345,Daly; Alan J.,18,0,18,0
1713488780735,EDS 284,A00,507350,Daly; Alan J.,16,0,16,0
1713488781761,EDS 286,A00,507359,Fine; Sarah,18,0,18,0
1713488782791,EDS 289C,A01,507361,Daly; Alan J.,18,0,18,0
1713488783820,EDS 290,A00,507366,Hofstetter; Carolyn,15,0,15,0
1713488784846,LIGM 5A,A00,507421,Fischer-Grunski; Eva K,20,0,20,0
1713488785870,LIGM 5B,A00,507423,Fischer-Grunski; Eva K,20,0,20,0
1713488786900,LIGM 5C,A00,507425,Fischer-Grunski; Eva K,20,0,20,0
1713488787926,LIIT 5AS,A00,507427,Carnelos; Chiara,20,0,20,0
1713488788952,LIIT 5BS,A00,507430,Carnelos; Chiara,20,0,20,0
1713488789978,LIIT 5CS,A00,507432,Carnelos; Chiara,20,0,20,0
1713488791008,LISP 5A,A00,507541,Munoz Sanchez; Alicia,14,0,20,6
1713488792034,LISP 5B,A00,507671,Munoz Sanchez; Alicia,12,0,20,8
1713488793062,LISP 5C,A00,507696,Munoz Sanchez; Alicia,11,0,20,9
1713488794087,MAE 197,001,528363,Boechler; Nicholas Sebastia,9998,0,9999,1
1713488795114,MATH 197,001,523477,Kedlaya; Kiran S.,9999,0,9999,0
1713488795114,MATH 197,002,563811,Zhang; Danna,9998,0,9999,1
1713488796143,MCWP 40R,A00,518780,Staff,16,0,20,4
1713488796143,MCWP 40R,B00,518781,Staff,14,0,20,6
1713488796143,MCWP 40R,C00,518783,Staff,10,0,20,10
1713488797169,MCWP 50R,A00,518791,Staff,8,0,20,12
1713488797169,MCWP 50R,B00,518792,Staff,5,0,20,15
1713488797169,MCWP 50R,C00,518793,Staff,7,0,20,13
1713488797169,MCWP 50R,D00,518794,Staff,0,0,20,20
1713488797169,MCWP 50R,E00,518795,Staff,2,0,20,18
1713488797169,MCWP 50R,F00,518796,Staff,13,0,20,7
1713488797169,MCWP 50R,G00,518797,Staff,11,0,20,9
1713488798195,MMW 12R,A01,514034,Herbst; Matthew,5,0,16,11
1713488798195,MMW 12R,A02,514035,Herbst; Matthew,13,0,16,3
1713488799219,MMW 13R,A01,514037,Staff,0,4,16,16
1713488799219,MMW 13R,A02,514039,Staff,0,4,16,16
1713488801272,SIO 295LS,A00,523233,Staff,15,0,30,15
1713488802300,SIO 295S,A00,523232,Staff,15,0,30,15
1713488803328,SOCI 117,A01,494376,Staff,0,2,5,5
1713488804353,WES 237B,A00,494380,Staff,19,0,20,1
1713488806412,AESE 279B,A00,494370,Wade; Jon P,33,0,33,0
1713488807438,AIP 197,001,627712,Vespa; Emanuel Ignacio,9999,0,9999,0
1713488808465,ANAR 135S,A00,494369,Braswell; Geoffrey E.,0,0,0,0
1713488809490,CAT 124RS,A01,519847,Geibel; William,6,0,20,14
1713488810516,CAT 125RS,A01,515971,Geibel; William,6,0,20,14
1713488811545,CLRE 250,A00,511389,Morris; Sheldon,9996,0,9999,3
1713488812571,CLRE 251,A00,507176,Mehta; Ravindra L.,9996,0,9999,3
1713488812571,CLRE 251,B00,511410,Mehta; Ravindra L.,9998,0,9999,1
1713488813596,CLRE 252,A00,507189,Cuomo; Raphael Eduardo,9998,0,9999,1
1713488814622,CLRE 253,A00,507199,Vaida; Florin,9997,0,9999,2
1713488814622,CLRE 253,B00,507202,Vaida; Florin,9999,0,9999,0
1713488815651,CLRE 259,A00,507211,Patel; Hemal,9996,0,9999,3
1713488816680,CLRE 260,A00,507221,Cuomo; Raphael Eduardo,9999,0,9999,0
1713488817705,CLRE 297,001,507242,Cuomo; Raphael Eduardo,9999,0,9999,0
1713488818734,CSE 191,A00,516875,Minnes Kemp; Mor Mia,9999,0,9999,0
1713488819761,CSS 201S,A01,494383,Staff,35,0,35,0
1713488820790,CSS 202S,A01,494387,Staff,35,0,35,0
1713488821816,EAP 100,A00,516065,Staff,9792,0,9999,207
1713488822845,ECE 45,A01,507414,Staff,38,0,60,22
1713488823874,ECE 100,A01,507416,Baghdadchi; Saharnaz,0,0,20,20
1713488823874,ECE 100,A02,507418,Baghdadchi; Saharnaz,19,0,20,1
1713488824903,ECE 111,A01,507420,Staff,27,0,50,23
1713488825928,ECE 197,001,548057,Sievenpiper; Daniel F.,9998,0,9999,1
1713488826953,EDS 115,A00,507243,Choi; Bailey Miyeon,27,0,28,1
1713488828031,EDS 117,A01,494379,Staff,16,0,25,9
1713488829057,EDS 125,A00,507246,Hopkins; Megan Beth,28,0,30,2
1713488830082,EDS 128A,A01,507264,Fargason; Sharon Gayle,26,0,26,0
1713488831107,EDS 128B,A01,507293,Pappas; Elizabeth,30,0,30,0
1713488832131,EDS 139,A00,507294,Fargason; Sharon Gayle,30,0,30,0
1713488832131,EDS 139,B00,507313,Pappas; Elizabeth,30,0,30,0
1713488833157,EDS 201,A00,507315,Staff,18,0,30,12
1713488834183,EDS 203,A01,507317,Halter; Christopher P.,17,0,30,13
1713488835209,EDS 204R,A01,507319,Halter; Christopher P.,0,1,30,30
1713488835209,EDS 204R,B01,507331,Heinzman; Erica M.,26,0,30,4
1713488836234,EDS 206R,A00,507332,Staff,0,2,30,30
1713488836234,EDS 206R,B00,507343,Staff,27,0,30,3
1713488837258,EDS 250,A00,507344,Hemans; Patricia Ann Benitez,27,0,40,13
1713488838281,EDS 281,A00,507345,Daly; Alan J.,18,0,18,0
1713488839310,EDS 284,A00,507350,Daly; Alan J.,16,0,16,0
1713488840339,EDS 286,A00,507359,Fine; Sarah,18,0,18,0
1713488841365,EDS 289C,A01,507361,Daly; Alan J.,18,0,18,0
1713488842393,EDS 290,A00,507366,Hofstetter; Carolyn,15,0,15,0
1713488843419,LIGM 5A,A00,507421,Fischer-Grunski; Eva K,20,0,20,0
1713488844445,LIGM 5B,A00,507423,Fischer-Grunski; Eva K,20,0,20,0
1713488845469,LIGM 5C,A00,507425,Fischer-Grunski; Eva K,20,0,20,0
1713488846498,LIIT 5AS,A00,507427,Carnelos; Chiara,20,0,20,0
1713488847523,LIIT 5BS,A00,507430,Carnelos; Chiara,20,0,20,0
1713488848549,LIIT 5CS,A00,507432,Carnelos; Chiara,20,0,20,0
1713488849579,LISP 5A,A00,507541,Munoz Sanchez; Alicia,14,0,20,6
1713488850603,LISP 5B,A00,507671,Munoz Sanchez; Alicia,12,0,20,8
1713488851627,LISP 5C,A00,507696,Munoz Sanchez; Alicia,11,0,20,9
1713488852653,MAE 197,001,528363,Boechler; Nicholas Sebastia,9998,0,9999,1
1713488853680,MATH 197,001,523477,Kedlaya; Kiran S.,9999,0,9999,0
1713488853680,MATH 197,002,563811,Zhang; Danna,9998,0,9999,1
1713488854706,MCWP 40R,A00,518780,Staff,16,0,20,4
1713488854706,MCWP 40R,B00,518781,Staff,14,0,20,6
1713488854706,MCWP 40R,C00,518783,Staff,10,0,20,10
1713488855730,MCWP 50R,A00,518791,Staff,8,0,20,12
1713488855730,MCWP 50R,B00,518792,Staff,5,0,20,15
1713488855730,MCWP 50R,C00,518793,Staff,7,0,20,13
1713488855730,MCWP 50R,D00,518794,Staff,0,0,20,20
1713488855730,MCWP 50R,E00,518795,Staff,2,0,20,18
1713488855730,MCWP 50R,F00,518796,Staff,13,0,20,7
1713488855730,MCWP 50R,G00,518797,Staff,11,0,20,9
1713488856759,MMW 12R,A01,514034,Herbst; Matthew,5,0,16,11
1713488856759,MMW 12R,A02,514035,Herbst; Matthew,13,0,16,3
1713488857788,MMW 13R,A01,514037,Staff,0,4,16,16
1713488857788,MMW 13R,A02,514039,Staff,0,4,16,16
1713488859842,SIO 295LS,A00,523233,Staff,15,0,30,15
1713488860867,SIO 295S,A00,523232,Staff,15,0,30,15
1713488861892,SOCI 117,A01,494376,Staff,0,2,5,5
1713488862919,WES 237B,A00,494380,Staff,19,0,20,1
1713488864978,AESE 279B,A00,494370,Wade; Jon P,33,0,33,0
1713488866006,AIP 197,001,627712,Vespa; Emanuel Ignacio,9999,0,9999,0
1713488867030,ANAR 135S,A00,494369,Braswell; Geoffrey E.,0,0,0,0
1713488868056,CAT 124RS,A01,519847,Geibel; William,6,0,20,14
1713488869080,CAT 125RS,A01,515971,Geibel; William,6,0,20,14
1713488870105,CLRE 250,A00,511389,Morris; Sheldon,9996,0,9999,3
1713488871130,CLRE 251,A00,507176,Mehta; Ravindra L.,9996,0,9999,3
1713488871130,CLRE 251,B00,511410,Mehta; Ravindra L.,9998,0,9999,1
1713488872155,CLRE 252,A00,507189,Cuomo; Raphael Eduardo,9998,0,9999,1
1713488873180,CLRE 253,A00,507199,Vaida; Florin,9997,0,9999,2
1713488873180,CLRE 253,B00,507202,Vaida; Florin,9999,0,9999,0
1713488874208,CLRE 259,A00,507211,Patel; Hemal,9996,0,9999,3
1713488875232,CLRE 260,A00,507221,Cuomo; Raphael Eduardo,9999,0,9999,0
1713488876259,CLRE 297,001,507242,Cuomo; Raphael Eduardo,9999,0,9999,0
1713488877287,CSE 191,A00,516875,Minnes Kemp; Mor Mia,9999,0,9999,0
1713488878311,CSS 201S,A01,494383,Staff,35,0,35,0
1713488879340,CSS 202S,A01,494387,Staff,35,0,35,0
1713488880367,EAP 100,A00,516065,Staff,9792,0,9999,207
1713488881393,ECE 45,A01,507414,Staff,38,0,60,22
1713488882419,ECE 100,A01,507416,Baghdadchi; Saharnaz,0,0,20,20
1713488882419,ECE 100,A02,507418,Baghdadchi; Saharnaz,19,0,20,1
1713488883445,ECE 111,A01,507420,Staff,27,0,50,23
1713488884469,ECE 197,001,548057,Sievenpiper; Daniel F.,9998,0,9999,1
1713488885494,EDS 115,A00,507243,Choi; Bailey Miyeon,27,0,28,1
1713488886519,EDS 117,A01,494379,Staff,16,0,25,9
1713488887543,EDS 125,A00,507246,Hopkins; Megan Beth,28,0,30,2
1713488888567,EDS 128A,A01,507264,Fargason; Sharon Gayle,26,0,26,0
1713488889592,EDS 128B,A01,507293,Pappas; Elizabeth,30,0,30,0
1713488890617,EDS 139,A00,507294,Fargason; Sharon Gayle,30,0,30,0
1713488890617,EDS 139,B00,507313,Pappas; Elizabeth,30,0,30,0
1713488891644,EDS 201,A00,507315,Staff,18,0,30,12
1713488892675,EDS 203,A01,507317,Halter; Christopher P.,17,0,30,13
1713488893705,EDS 204R,A01,507319,Halter; Christopher P.,0,1,30,30
1713488893705,EDS 204R,B01,507331,Heinzman; Erica M.,26,0,30,4
1713488894730,EDS 206R,A00,507332,Staff,0,2,30,30
1713488894730,EDS 206R,B00,507343,Staff,27,0,30,3
1713488895754,EDS 250,A00,507344,Hemans; Patricia Ann Benitez,27,0,40,13
1713488896781,EDS 281,A00,507345,Daly; Alan J.,18,0,18,0
1713488897806,EDS 284,A00,507350,Daly; Alan J.,16,0,16,0
1713488898833,EDS 286,A00,507359,Fine; Sarah,18,0,18,0
1713488899863,EDS 289C,A01,507361,Daly; Alan J.,18,0,18,0
1713488900892,EDS 290,A00,507366,Hofstetter; Carolyn,15,0,15,0
1713488901918,LIGM 5A,A00,507421,Fischer-Grunski; Eva K,20,0,20,0
1713488902943,LIGM 5B,A00,507423,Fischer-Grunski; Eva K,20,0,20,0
1713488903968,LIGM 5C,A00,507425,Fischer-Grunski; Eva K,20,0,20,0
1713488904998,LIIT 5AS,A00,507427,Carnelos; Chiara,20,0,20,0
1713488906025,LIIT 5BS,A00,507430,Carnelos; Chiara,20,0,20,0
1713488907058,LIIT 5CS,A00,507432,Carnelos; Chiara,20,0,20,0
1713488908086,LISP 5A,A00,507541,Munoz Sanchez; Alicia,14,0,20,6
1713488909114,LISP 5B,A00,507671,Munoz Sanchez; Alicia,12,0,20,8
1713488910143,LISP 5C,A00,507696,Munoz Sanchez; Alicia,11,0,20,9
1713488911173,MAE 197,001,528363,Boechler; Nicholas Sebastia,9998,0,9999,1
1713488912198,MATH 197,001,523477,Kedlaya; Kiran S.,9999,0,9999,0
1713488912198,MATH 197,002,563811,Zhang; Danna,9998,0,9999,1
1713488913225,MCWP 40R,A00,518780,Staff,16,0,20,4
1713488913225,MCWP 40R,B00,518781,Staff,14,0,20,6
1713488913225,MCWP 40R,C00,518783,Staff,10,0,20,10
1713488914251,MCWP 50R,A00,518791,Staff,8,0,20,12
1713488914251,MCWP 50R,B00,518792,Staff,5,0,20,15
1713488914251,MCWP 50R,C00,518793,Staff,7,0,20,13
1713488914251,MCWP 50R,D00,518794,Staff,0,0,20,20
1713488914251,MCWP 50R,E00,518795,Staff,2,0,20,18
1713488914251,MCWP 50R,F00,518796,Staff,13,0,20,7
1713488914251,MCWP 50R,G00,518797,Staff,11,0,20,9
1713488915282,MMW 12R,A01,514034,Herbst; Matthew,5,0,16,11
1713488915282,MMW 12R,A02,514035,Herbst; Matthew,13,0,16,3
1713488916307,MMW 13R,A01,514037,Staff,0,4,16,16
1713488916307,MMW 13R,A02,514039,Staff,0,4,16,16
1713488918361,SIO 295LS,A00,523233,Staff,15,0,30,15
1713488919389,SIO 295S,A00,523232,Staff,15,0,30,15
1713488920416,SOCI 117,A01,494376,Staff,0,2,5,5
1713488921441,WES 237B,A00,494380,Staff,19,0,20,1
1713488923509,AESE 279B,A00,494370,Wade; Jon P,33,0,33,0
1713488924534,AIP 197,001,627712,Vespa; Emanuel Ignacio,9999,0,9999,0
1713488925560,ANAR 135S,A00,494369,Braswell; Geoffrey E.,0,0,0,0
1713488926586,CAT 124RS,A01,519847,Geibel; William,6,0,20,14
1713488927611,CAT 125RS,A01,515971,Geibel; William,6,0,20,14
1713488928636,CLRE 250,A00,511389,Morris; Sheldon,9996,0,9999,3
1713488929665,CLRE 251,A00,507176,Mehta; Ravindra L.,9996,0,9999,3
1713488929665,CLRE 251,B00,511410,Mehta; Ravindra L.,9998,0,9999,1
1713488930693,CLRE 252,A00,507189,Cuomo; Raphael Eduardo,9998,0,9999,1
1713488931778,CLRE 253,A00,507199,Vaida; Florin,9997,0,9999,2
1713488931778,CLRE 253,B00,507202,Vaida; Florin,9999,0,9999,0
1713488932805,CLRE 259,A00,507211,Patel; Hemal,9996,0,9999,3
1713488933829,CLRE 260,A00,507221,Cuomo; Raphael Eduardo,9999,0,9999,0
1713488934854,CLRE 297,001,507242,Cuomo; Raphael Eduardo,9999,0,9999,0
1713488935882,CSE 191,A00,516875,Minnes Kemp; Mor Mia,9999,0,9999,0
1713488936911,CSS 201S,A01,494383,Staff,35,0,35,0
1713488937940,CSS 202S,A01,494387,Staff,35,0,35,0
1713488938970,EAP 100,A00,516065,Staff,9792,0,9999,207
1713488939996,ECE 45,A01,507414,Staff,38,0,60,22
1713488941025,ECE 100,A01,507416,Baghdadchi; Saharnaz,0,0,20,20
1713488941025,ECE 100,A02,507418,Baghdadchi; Saharnaz,19,0,20,1
1713488942051,ECE 111,A01,507420,Staff,27,0,50,23
1713488943080,ECE 197,001,548057,Sievenpiper; Daniel F.,9998,0,9999,1
1713488944106,EDS 115,A00,507243,Choi; Bailey Miyeon,27,0,28,1
1713488945129,EDS 117,A01,494379,Staff,16,0,25,9
1713488946158,EDS 125,A00,507246,Hopkins; Megan Beth,28,0,30,2
1713488947185,EDS 128A,A01,507264,Fargason; Sharon Gayle,26,0,26,0
1713488948210,EDS 128B,A01,507293,Pappas; Elizabeth,30,0,30,0
1713488949235,EDS 139,A00,507294,Fargason; Sharon Gayle,30,0,30,0
1713488949235,EDS 139,B00,507313,Pappas; Elizabeth,30,0,30,0
1713488950259,EDS 201,A00,507315,Staff,18,0,30,12
1713488951285,EDS 203,A01,507317,Halter; Christopher P.,17,0,30,13
1713488952315,EDS 204R,A01,507319,Halter; Christopher P.,0,1,30,30
1713488952315,EDS 204R,B01,507331,Heinzman; Erica M.,26,0,30,4
1713488953344,EDS 206R,A00,507332,Staff,0,2,30,30
1713488953344,EDS 206R,B00,507343,Staff,27,0,30,3
1713488954373,EDS 250,A00,507344,Hemans; Patricia Ann Benitez,27,0,40,13
1713488955398,EDS 281,A00,507345,Daly; Alan J.,18,0,18,0
1713488956425,EDS 284,A00,507350,Daly; Alan J.,16,0,16,0
1713488957455,EDS 286,A00,507359,Fine; Sarah,18,0,18,0
1713488958479,EDS 289C,A01,507361,Daly; Alan J.,18,0,18,0
1713488959507,EDS 290,A00,507366,Hofstetter; Carolyn,15,0,15,0
1713488960536,LIGM 5A,A00,507421,Fischer-Grunski; Eva K,20,0,20,0
1713488961570,LIGM 5B,A00,507423,Fischer-Grunski; Eva K,20,0,20,0
1713488962600,LIGM 5C,A00,507425,Fischer-Grunski; Eva K,20,0,20,0
1713488963629,LIIT 5AS,A00,507427,Carnelos; Chiara,20,0,20,0
1713488964657,LIIT 5BS,A00,507430,Carnelos; Chiara,20,0,20,0
1713488965686,LIIT 5CS,A00,507432,Carnelos; Chiara,20,0,20,0
1713488966712,LISP 5A,A00,507541,Munoz Sanchez; Alicia,14,0,20,6
1713488967737,LISP 5B,A00,507671,Munoz Sanchez; Alicia,12,0,20,8
1713488968763,LISP 5C,A00,507696,Munoz Sanchez; Alicia,11,0,20,9
1713488969790,MAE 197,001,528363,Boechler; Nicholas Sebastia,9998,0,9999,1
1713488970815,MATH 197,001,523477,Kedlaya; Kiran S.,9999,0,9999,0
1713488970815,MATH 197,002,563811,Zhang; Danna,9998,0,9999,1
1713488971844,MCWP 40R,A00,518780,Staff,16,0,20,4
1713488971844,MCWP 40R,B00,518781,Staff,14,0,20,6
1713488971844,MCWP 40R,C00,518783,Staff,10,0,20,10
1713488972871,MCWP 50R,A00,518791,Staff,8,0,20,12
1713488972871,MCWP 50R,B00,518792,Staff,5,0,20,15
1713488972871,MCWP 50R,C00,518793,Staff,7,0,20,13
1713488972871,MCWP 50R,D00,518794,Staff,0,0,20,20
1713488972871,MCWP 50R,E00,518795,Staff,2,0,20,18
1713488972871,MCWP 50R,F00,518796,Staff,13,0,20,7
1713488972871,MCWP 50R,G00,518797,Staff,11,0,20,9
1713488973896,MMW 12R,A01,514034,Herbst; Matthew,5,0,16,11
1713488973896,MMW 12R,A02,514035,Herbst; Matthew,13,0,16,3
1713488974922,MMW 13R,A01,514037,Staff,0,4,16,16
1713488974922,MMW 13R,A02,514039,Staff,0,4,16,16
1713488976972,SIO 295LS,A00,523233,Staff,15,0,30,15
1713488978003,SIO 295S,A00,523232,Staff,15,0,30,15
1713488979029,SOCI 117,A01,494376,Staff,0,2,5,5
1713488980054,WES 237B,A00,494380,Staff,19,0,20,1
1713488982119,AESE 279B,A00,494370,Wade; Jon P,33,0,33,0
1713488983146,AIP 197,001,627712,Vespa; Emanuel Ignacio,9999,0,9999,0
1713488984171,ANAR 135S,A00,494369,Braswell; Geoffrey E.,0,0,0,0
1713488985197,CAT 124RS,A01,519847,Geibel; William,6,0,20,14
1713488986225,CAT 125RS,A01,515971,Geibel; William,6,0,20,14
1713488987250,CLRE 250,A00,511389,Morris; Sheldon,9996,0,9999,3
1713488988281,CLRE 251,A00,507176,Mehta; Ravindra L.,9996,0,9999,3
1713488988281,CLRE 251,B00,511410,Mehta; Ravindra L.,9998,0,9999,1
1713488989308,CLRE 252,A00,507189,Cuomo; Raphael Eduardo,9998,0,9999,1
1713488990334,CLRE 253,A00,507199,Vaida; Florin,9997,0,9999,2
1713488990334,CLRE 253,B00,507202,Vaida; Florin,9999,0,9999,0
1713488991360,CLRE 259,A00,507211,Patel; Hemal,9996,0,9999,3
1713488992386,CLRE 260,A00,507221,Cuomo; Raphael Eduardo,9999,0,9999,0
1713488993411,CLRE 297,001,507242,Cuomo; Raphael Eduardo,9999,0,9999,0
1713488994438,CSE 191,A00,516875,Minnes Kemp; Mor Mia,9999,0,9999,0
1713488995475,CSS 201S,A01,494383,Staff,35,0,35,0
1713488996501,CSS 202S,A01,494387,Staff,35,0,35,0
1713488997529,EAP 100,A00,516065,Staff,9792,0,9999,207
1713488998554,ECE 45,A01,507414,Staff,38,0,60,22
1713488999583,ECE 100,A01,507416,Baghdadchi; Saharnaz,0,0,20,20
1713488999583,ECE 100,A02,507418,Baghdadchi; Saharnaz,19,0,20,1
1713489000615,ECE 111,A01,507420,Staff,27,0,50,23
1713489001640,ECE 197,001,548057,Sievenpiper; Daniel F.,9998,0,9999,1
1713489002669,EDS 115,A00,507243,Choi; Bailey Miyeon,27,0,28,1
1713489003697,EDS 117,A01,494379,Staff,16,0,25,9
1713489004725,EDS 125,A00,507246,Hopkins; Megan Beth,28,0,30,2
1713489005754,EDS 128A,A01,507264,Fargason; Sharon Gayle,26,0,26,0
1713489006779,EDS 128B,A01,507293,Pappas; Elizabeth,30,0,30,0
1713489007804,EDS 139,A00,507294,Fargason; Sharon Gayle,30,0,30,0
1713489007804,EDS 139,B00,507313,Pappas; Elizabeth,30,0,30,0
1713489008828,EDS 201,A00,507315,Staff,18,0,30,12
1713489009854,EDS 203,A01,507317,Halter; Christopher P.,17,0,30,13
1713489010883,EDS 204R,A01,507319,Halter; Christopher P.,0,1,30,30
1713489010883,EDS 204R,B01,507331,Heinzman; Erica M.,26,0,30,4
1713489011908,EDS 206R,A00,507332,Staff,0,2,30,30
1713489011908,EDS 206R,B00,507343,Staff,27,0,30,3
1713489012933,EDS 250,A00,507344,Hemans; Patricia Ann Benitez,27,0,40,13
1713489013957,EDS 281,A00,507345,Daly; Alan J.,18,0,18,0
1713489014986,EDS 284,A00,507350,Daly; Alan J.,16,0,16,0
1713489016015,EDS 286,A00,507359,Fine; Sarah,18,0,18,0
1713489017039,EDS 289C,A01,507361,Daly; Alan J.,18,0,18,0
1713489018063,EDS 290,A00,507366,Hofstetter; Carolyn,15,0,15,0
1713489019089,LIGM 5A,A00,507421,Fischer-Grunski; Eva K,20,0,20,0
1713489020114,LIGM 5B,A00,507423,Fischer-Grunski; Eva K,20,0,20,0
1713489021145,LIGM 5C,A00,507425,Fischer-Grunski; Eva K,20,0,20,0
1713489022175,LIIT 5AS,A00,507427,Carnelos; Chiara,20,0,20,0
1713489023199,LIIT 5BS,A00,507430,Carnelos; Chiara,20,0,20,0
1713489024230,LIIT 5CS,A00,507432,Carnelos; Chiara,20,0,20,0
1713489025258,LISP 5A,A00,507541,Munoz Sanchez; Alicia,14,0,20,6
1713489026283,LISP 5B,A00,507671,Munoz Sanchez; Alicia,12,0,20,8
1713489027309,LISP 5C,A00,507696,Munoz Sanchez; Alicia,11,0,20,9
1713489028333,MAE 197,001,528363,Boechler; Nicholas Sebastia,9998,0,9999,1
1713489029358,MATH 197,001,523477,Kedlaya; Kiran S.,9999,0,9999,0
1713489029358,MATH 197,002,563811,Zhang; Danna,9998,0,9999,1
1713489030385,MCWP 40R,A00,518780,Staff,16,0,20,4
1713489030385,MCWP 40R,B00,518781,Staff,14,0,20,6
1713489030385,MCWP 40R,C00,518783,Staff,10,0,20,10
1713489031410,MCWP 50R,A00,518791,Staff,8,0,20,12
1713489031410,MCWP 50R,B00,518792,Staff,5,0,20,15
1713489031410,MCWP 50R,C00,518793,Staff,7,0,20,13
1713489031410,MCWP 50R,D00,518794,Staff,0,0,20,20
1713489031410,MCWP 50R,E00,518795,Staff,2,0,20,18
1713489031410,MCWP 50R,F00,518796,Staff,13,0,20,7
1713489031410,MCWP 50R,G00,518797,Staff,11,0,20,9
1713489032435,MMW 12R,A01,514034,Herbst; Matthew,5,0,16,11
1713489032435,MMW 12R,A02,514035,Herbst; Matthew,13,0,16,3
1713489033464,MMW 13R,A01,514037,Staff,0,4,16,16
1713489033464,MMW 13R,A02,514039,Staff,0,4,16,16
1713489035572,SIO 295LS,A00,523233,Staff,15,0,30,15
1713489036597,SIO 295S,A00,523232,Staff,15,0,30,15
1713489037624,SOCI 117,A01,494376,Staff,0,2,5,5
1713489038649,WES 237B,A00,494380,Staff,19,0,20,1
1713489040705,AESE 279B,A00,494370,Wade; Jon P,33,0,33,0
1713489041729,AIP 197,001,627712,Vespa; Emanuel Ignacio,9999,0,9999,0
1713489042757,ANAR 135S,A00,494369,Braswell; Geoffrey E.,0,0,0,0
1713489043783,CAT 124RS,A01,519847,Geibel; William,6,0,20,14
1713489044808,CAT 125RS,A01,515971,Geibel; William,6,0,20,14
1713489045833,CLRE 250,A00,511389,Morris; Sheldon,9996,0,9999,3
1713489046858,CLRE 251,A00,507176,Mehta; Ravindra L.,9996,0,9999,3
1713489046858,CLRE 251,B00,511410,Mehta; Ravindra L.,9998,0,9999,1
1713489047888,CLRE 252,A00,507189,Cuomo; Raphael Eduardo,9998,0,9999,1
1713489048917,CLRE 253,A00,507199,Vaida; Florin,9997,0,9999,2
1713489048917,CLRE 253,B00,507202,Vaida; Florin,9999,0,9999,0
1713489049942,CLRE 259,A00,507211,Patel; Hemal,9996,0,9999,3
1713489050967,CLRE 260,A00,507221,Cuomo; Raphael Eduardo,9999,0,9999,0
1713489051993,CLRE 297,001,507242,Cuomo; Raphael Eduardo,9999,0,9999,0
1713489053023,CSE 191,A00,516875,Minnes Kemp; Mor Mia,9999,0,9999,0
1713489054055,CSS 201S,A01,494383,Staff,35,0,35,0
1713489055082,CSS 202S,A01,494387,Staff,35,0,35,0
1713489056106,EAP 100,A00,516065,Staff,9792,0,9999,207
1713489057132,ECE 45,A01,507414,Staff,38,0,60,22
1713489058163,ECE 100,A01,507416,Baghdadchi; Saharnaz,0,0,20,20
1713489058163,ECE 100,A02,507418,Baghdadchi; Saharnaz,19,0,20,1
1713489059189,ECE 111,A01,507420,Staff,27,0,50,23
1713489060218,ECE 197,001,548057,Sievenpiper; Daniel F.,9998,0,9999,1
1713489061243,EDS 115,A00,507243,Choi; Bailey Miyeon,27,0,28,1
1713489062268,EDS 117,A01,494379,Staff,16,0,25,9
1713489063301,EDS 125,A00,507246,Hopkins; Megan Beth,28,0,30,2
1713489064329,EDS 128A,A01,507264,Fargason; Sharon Gayle,26,0,26,0
1713489065355,EDS 128B,A01,507293,Pappas; Elizabeth,30,0,30,0
1713489066379,EDS 139,A00,507294,Fargason; Sharon Gayle,30,0,30,0
1713489066379,EDS 139,B00,507313,Pappas; Elizabeth,30,0,30,0
1713489067405,EDS 201,A00,507315,Staff,18,0,30,12
1713489068434,EDS 203,A01,507317,Halter; Christopher P.,17,0,30,13
1713489069459,EDS 204R,A01,507319,Halter; Christopher P.,0,1,30,30
1713489069459,EDS 204R,B01,507331,Heinzman; Erica M.,26,0,30,4
1713489070483,EDS 206R,A00,507332,Staff,0,2,30,30
1713489070483,EDS 206R,B00,507343,Staff,27,0,30,3
1713489071507,EDS 250,A00,507344,Hemans; Patricia Ann Benitez,27,0,40,13
1713489072536,EDS 281,A00,507345,Daly; Alan J.,18,0,18,0
1713489073564,EDS 284,A00,507350,Daly; Alan J.,16,0,16,0
1713489074589,EDS 286,A00,507359,Fine; Sarah,18,0,18,0
1713489075617,EDS 289C,A01,507361,Daly; Alan J.,18,0,18,0
1713489076642,EDS 290,A00,507366,Hofstetter; Carolyn,15,0,15,0
1713489077671,LIGM 5A,A00,507421,Fischer-Grunski; Eva K,20,0,20,0
1713489078697,LIGM 5B,A00,507423,Fischer-Grunski; Eva K,20,0,20,0
1713489079721,LIGM 5C,A00,507425,Fischer-Grunski; Eva K,20,0,20,0
1713489080747,LIIT 5AS,A00,507427,Carnelos; Chiara,20,0,20,0
1713489081773,LIIT 5BS,A00,507430,Carnelos; Chiara,20,0,20,0
1713489082800,LIIT 5CS,A00,507432,Carnelos; Chiara,20,0,20,0
1713489083825,LISP 5A,A00,507541,Munoz Sanchez; Alicia,14,0,20,6
1713489084855,LISP 5B,A00,507671,Munoz Sanchez; Alicia,12,0,20,8
1713489085881,LISP 5C,A00,507696,Munoz Sanchez; Alicia,11,0,20,9
1713489086906,MAE 197,001,528363,Boechler; Nicholas Sebastia,9998,0,9999,1
1713489087931,MATH 197,001,523477,Kedlaya; Kiran S.,9999,0,9999,0
1713489087931,MATH 197,002,563811,Zhang; Danna,9998,0,9999,1
1713489088958,MCWP 40R,A00,518780,Staff,16,0,20,4
1713489088958,MCWP 40R,B00,518781,Staff,14,0,20,6
1713489088958,MCWP 40R,C00,518783,Staff,10,0,20,10
1713489089987,MCWP 50R,A00,518791,Staff,8,0,20,12
1713489089987,MCWP 50R,B00,518792,Staff,5,0,20,15
1713489089987,MCWP 50R,C00,518793,Staff,7,0,20,13
1713489089987,MCWP 50R,D00,518794,Staff,0,0,20,20
1713489089987,MCWP 50R,E00,518795,Staff,2,0,20,18
1713489089987,MCWP 50R,F00,518796,Staff,13,0,20,7
1713489089987,MCWP 50R,G00,518797,Staff,11,0,20,9
1713489091011,MMW 12R,A01,514034,Herbst; Matthew,5,0,16,11
1713489091011,MMW 12R,A02,514035,Herbst; Matthew,13,0,16,3
1713489092039,MMW 13R,A01,514037,Staff,0,4,16,16
1713489092039,MMW 13R,A02,514039,Staff,0,4,16,16
1713489094088,SIO 295LS,A00,523233,Staff,15,0,30,15
1713489095113,SIO 295S,A00,523232,Staff,15,0,30,15
1713489096138,SOCI 117,A01,494376,Staff,0,2,5,5
1713489097163,WES 237B,A00,494380,Staff,19,0,20,1
1713489099218,AESE 279B,A00,494370,Wade; Jon P,33,0,33,0
1713489100242,AIP 197,001,627712,Vespa; Emanuel Ignacio,9999,0,9999,0
1713489101267,ANAR 135S,A00,494369,Braswell; Geoffrey E.,0,0,0,0
1713489102300,CAT 124RS,A01,519847,Geibel; William,6,0,20,14
1713489103324,CAT 125RS,A01,515971,Geibel; William,6,0,20,14
1713489104349,CLRE 250,A00,511389,Morris; Sheldon,9996,0,9999,3
1713489105380,CLRE 251,A00,507176,Mehta; Ravindra L.,9996,0,9999,3
1713489105380,CLRE 251,B00,511410,Mehta; Ravindra L.,9998,0,9999,1
1713489106409,CLRE 252,A00,507189,Cuomo; Raphael Eduardo,9998,0,9999,1
1713489107433,CLRE 253,A00,507199,Vaida; Florin,9997,0,9999,2
1713489107433,CLRE 253,B00,507202,Vaida; Florin,9999,0,9999,0
1713489108462,CLRE 259,A00,507211,Patel; Hemal,9996,0,9999,3
1713489109486,CLRE 260,A00,507221,Cuomo; Raphael Eduardo,9999,0,9999,0
1713489110511,CLRE 297,001,507242,Cuomo; Raphael Eduardo,9999,0,9999,0
1713489111537,CSE 191,A00,516875,Minnes Kemp; Mor Mia,9999,0,9999,0
1713489112566,CSS 201S,A01,494383,Staff,35,0,35,0
1713489113593,CSS 202S,A01,494387,Staff,35,0,35,0
1713489114618,EAP 100,A00,516065,Staff,9792,0,9999,207
1713489115643,ECE 45,A01,507414,Staff,38,0,60,22
1713489116673,ECE 100,A01,507416,Baghdadchi; Saharnaz,0,0,20,20
1713489116673,ECE 100,A02,507418,Baghdadchi; Saharnaz,19,0,20,1
1713489117702,ECE 111,A01,507420,Staff,27,0,50,23
1713489118730,ECE 197,001,548057,Sievenpiper; Daniel F.,9998,0,9999,1
1713489119755,EDS 115,A00,507243,Choi; Bailey Miyeon,27,0,28,1
1713489120785,EDS 117,A01,494379,Staff,16,0,25,9
1713489121811,EDS 125,A00,507246,Hopkins; Megan Beth,28,0,30,2
1713489122841,EDS 128A,A01,507264,Fargason; Sharon Gayle,26,0,26,0
1713489123870,EDS 128B,A01,507293,Pappas; Elizabeth,30,0,30,0
1713489124898,EDS 139,A00,507294,Fargason; Sharon Gayle,30,0,30,0
1713489124898,EDS 139,B00,507313,Pappas; Elizabeth,30,0,30,0
1713489125927,EDS 201,A00,507315,Staff,18,0,30,12
1713489126957,EDS 203,A01,507317,Halter; Christopher P.,17,0,30,13
1713489127982,EDS 204R,A01,507319,Halter; Christopher P.,0,1,30,30
1713489127982,EDS 204R,B01,507331,Heinzman; Erica M.,26,0,30,4
1713489129008,EDS 206R,A00,507332,Staff,0,2,30,30
1713489129008,EDS 206R,B00,507343,Staff,27,0,30,3
1713489130038,EDS 250,A00,507344,Hemans; Patricia Ann Benitez,27,0,40,13
1713489131062,EDS 281,A00,507345,Daly; Alan J.,18,0,18,0
1713489132090,EDS 284,A00,507350,Daly; Alan J.,16,0,16,0
1713489133119,EDS 286,A00,507359,Fine; Sarah,18,0,18,0
1713489134148,EDS 289C,A01,507361,Daly; Alan J.,18,0,18,0
1713489135171,EDS 290,A00,507366,Hofstetter; Carolyn,15,0,15,0
1713489136196,LIGM 5A,A00,507421,Fischer-Grunski; Eva K,20,0,20,0
1713489137225,LIGM 5B,A00,507423,Fischer-Grunski; Eva K,20,0,20,0
1713489138251,LIGM 5C,A00,507425,Fischer-Grunski; Eva K,20,0,20,0
1713489139346,LIIT 5AS,A00,507427,Carnelos; Chiara,20,0,20,0
1713489140372,LIIT 5BS,A00,507430,Carnelos; Chiara,20,0,20,0
1713489141402,LIIT 5CS,A00,507432,Carnelos; Chiara,20,0,20,0
1713489142429,LISP 5A,A00,507541,Munoz Sanchez; Alicia,14,0,20,6
1713489143454,LISP 5B,A00,507671,Munoz Sanchez; Alicia,12,0,20,8
1713489144480,LISP 5C,A00,507696,Munoz Sanchez; Alicia,11,0,20,9
1713489145507,MAE 197,001,528363,Boechler; Nicholas Sebastia,9998,0,9999,1
1713489146533,MATH 197,001,523477,Kedlaya; Kiran S.,9999,0,9999,0
1713489146533,MATH 197,002,563811,Zhang; Danna,9998,0,9999,1
1713489147561,MCWP 40R,A00,518780,Staff,16,0,20,4
1713489147561,MCWP 40R,B00,518781,Staff,14,0,20,6
1713489147561,MCWP 40R,C00,518783,Staff,10,0,20,10
1713489148589,MCWP 50R,A00,518791,Staff,8,0,20,12
1713489148589,MCWP 50R,B00,518792,Staff,5,0,20,15
1713489148589,MCWP 50R,C00,518793,Staff,7,0,20,13
1713489148589,MCWP 50R,D00,518794,Staff,0,0,20,20
1713489148589,MCWP 50R,E00,518795,Staff,2,0,20,18
1713489148589,MCWP 50R,F00,518796,Staff,13,0,20,7
1713489148589,MCWP 50R,G00,518797,Staff,11,0,20,9
1713489149613,MMW 12R,A01,514034,Herbst; Matthew,5,0,16,11
1713489149613,MMW 12R,A02,514035,Herbst; Matthew,13,0,16,3
1713489150638,MMW 13R,A01,514037,Staff,0,4,16,16
1713489150638,MMW 13R,A02,514039,Staff,0,4,16,16
1713489152687,SIO 295LS,A00,523233,Staff,15,0,30,15
1713489153711,SIO 295S,A00,523232,Staff,15,0,30,15
1713489154740,SOCI 117,A01,494376,Staff,0,2,5,5
1713489155770,WES 237B,A00,494380,Staff,19,0,20,1
1713489157838,AESE 279B,A00,494370,Wade; Jon P,33,0,33,0
1713489158863,AIP 197,001,627712,Vespa; Emanuel Ignacio,9999,0,9999,0
1713489159890,ANAR 135S,A00,494369,Braswell; Geoffrey E.,0,0,0,0
1713489160914,CAT 124RS,A01,519847,Geibel; William,6,0,20,14
1713489161938,CAT 125RS,A01,515971,Geibel; William,6,0,20,14
1713489162967,CLRE 250,A00,511389,Morris; Sheldon,9996,0,9999,3
1713489163993,CLRE 251,A00,507176,Mehta; Ravindra L.,9996,0,9999,3
1713489163993,CLRE 251,B00,511410,Mehta; Ravindra L.,9998,0,9999,1
1713489165022,CLRE 252,A00,507189,Cuomo; Raphael Eduardo,9998,0,9999,1
1713489166047,CLRE 253,A00,507199,Vaida; Florin,9997,0,9999,2
1713489166047,CLRE 253,B00,507202,Vaida; Florin,9999,0,9999,0
1713489167072,CLRE 259,A00,507211,Patel; Hemal,9996,0,9999,3
1713489168100,CLRE 260,A00,507221,Cuomo; Raphael Eduardo,9999,0,9999,0
1713489169125,CLRE 297,001,507242,Cuomo; Raphael Eduardo,9999,0,9999,0
1713489170153,CSE 191,A00,516875,Minnes Kemp; Mor Mia,9999,0,9999,0
1713489171180,CSS 201S,A01,494383,Staff,35,0,35,0
1713489172205,CSS 202S,A01,494387,Staff,35,0,35,0
1713489173233,EAP 100,A00,516065,Staff,9792,0,9999,207
1713489174262,ECE 45,A01,507414,Staff,38,0,60,22
1713489175293,ECE 100,A01,507416,Baghdadchi; Saharnaz,0,0,20,20
1713489175293,ECE 100,A02,507418,Baghdadchi; Saharnaz,19,0,20,1
1713489176318,ECE 111,A01,507420,Staff,27,0,50,23
1713489177343,ECE 197,001,548057,Sievenpiper; Daniel F.,9998,0,9999,1
1713489178366,EDS 115,A00,507243,Choi; Bailey Miyeon,27,0,28,1
1713489179392,EDS 117,A01,494379,Staff,16,0,25,9
1713489180417,EDS 125,A00,507246,Hopkins; Megan Beth,28,0,30,2
1713489181441,EDS 128A,A01,507264,Fargason; Sharon Gayle,26,0,26,0
1713489182465,EDS 128B,A01,507293,Pappas; Elizabeth,30,0,30,0
1713489183491,EDS 139,A00,507294,Fargason; Sharon Gayle,30,0,30,0
1713489183491,EDS 139,B00,507313,Pappas; Elizabeth,30,0,30,0
1713489184519,EDS 201,A00,507315,Staff,18,0,30,12
1713489185549,EDS 203,A01,507317,Halter; Christopher P.,17,0,30,13
1713489186573,EDS 204R,A01,507319,Halter; Christopher P.,0,1,30,30
1713489186573,EDS 204R,B01,507331,Heinzman; Erica M.,26,0,30,4
1713489187598,EDS 206R,A00,507332,Staff,0,2,30,30
1713489187598,EDS 206R,B00,507343,Staff,27,0,30,3
1713489188626,EDS 250,A00,507344,Hemans; Patricia Ann Benitez,27,0,40,13
1713489189652,EDS 281,A00,507345,Daly; Alan J.,18,0,18,0
1713489190679,EDS 284,A00,507350,Daly; Alan J.,16,0,16,0
1713489191705,EDS 286,A00,507359,Fine; Sarah,18,0,18,0
1713489192731,EDS 289C,A01,507361,Daly; Alan J.,18,0,18,0
1713489193756,EDS 290,A00,507366,Hofstetter; Carolyn,15,0,15,0
1713489194782,LIGM 5A,A00,507421,Fischer-Grunski; Eva K,20,0,20,0
1713489195811,LIGM 5B,A00,507423,Fischer-Grunski; Eva K,20,0,20,0
1713489196842,LIGM 5C,A00,507425,Fischer-Grunski; Eva K,20,0,20,0
1713489197867,LIIT 5AS,A00,507427,Carnelos; Chiara,20,0,20,0
1713489198893,LIIT 5BS,A00,507430,Carnelos; Chiara,20,0,20,0
1713489199917,LIIT 5CS,A00,507432,Carnelos; Chiara,20,0,20,0
1713489200947,LISP 5A,A00,507541,Munoz Sanchez; Alicia,14,0,20,6
1713489201972,LISP 5B,A00,507671,Munoz Sanchez; Alicia,12,0,20,8
1713489202998,LISP 5C,A00,507696,Munoz Sanchez; Alicia,11,0,20,9
1713489204026,MAE 197,001,528363,Boechler; Nicholas Sebastia,9998,0,9999,1
1713489205050,MATH 197,001,523477,Kedlaya; Kiran S.,9999,0,9999,0
1713489205050,MATH 197,002,563811,Zhang; Danna,9998,0,9999,1
1713489206075,MCWP 40R,A00,518780,Staff,16,0,20,4
1713489206075,MCWP 40R,B00,518781,Staff,14,0,20,6
1713489206075,MCWP 40R,C00,518783,Staff,10,0,20,10
1713489207105,MCWP 50R,A00,518791,Staff,8,0,20,12
1713489207105,MCWP 50R,B00,518792,Staff,5,0,20,15
1713489207105,MCWP 50R,C00,518793,Staff,7,0,20,13
1713489207105,MCWP 50R,D00,518794,Staff,0,0,20,20
1713489207105,MCWP 50R,E00,518795,Staff,2,0,20,18
1713489207105,MCWP 50R,F00,518796,Staff,13,0,20,7
1713489207105,MCWP 50R,G00,518797,Staff,11,0,20,9
1713489208130,MMW 12R,A01,514034,Herbst; Matthew,5,0,16,11
1713489208130,MMW 12R,A02,514035,Herbst; Matthew,13,0,16,3
1713489209159,MMW 13R,A01,514037,Staff,0,4,16,16
1713489209159,MMW 13R,A02,514039,Staff,0,4,16,16
1713489211212,SIO 295LS,A00,523233,Staff,15,0,30,15
1713489212241,SIO 295S,A00,523232,Staff,15,0,30,15
1713489213268,SOCI 117,A01,494376,Staff,0,2,5,5
1713489214294,WES 237B,A00,494380,Staff,19,0,20,1
1713489216363,AESE 279B,A00,494370,Wade; Jon P,33,0,33,0
1713489217389,AIP 197,001,627712,Vespa; Emanuel Ignacio,9999,0,9999,0
1713489218417,ANAR 135S,A00,494369,Braswell; Geoffrey E.,0,0,0,0
1713489219441,CAT 124RS,A01,519847,Geibel; William,6,0,20,14
1713489220467,CAT 125RS,A01,515971,Geibel; William,6,0,20,14
1713489221492,CLRE 250,A00,511389,Morris; Sheldon,9996,0,9999,3
1713489222522,CLRE 251,A00,507176,Mehta; Ravindra L.,9996,0,9999,3
1713489222522,CLRE 251,B00,511410,Mehta; Ravindra L.,9998,0,9999,1
1713489223546,CLRE 252,A00,507189,Cuomo; Raphael Eduardo,9998,0,9999,1
1713489224575,CLRE 253,A00,507199,Vaida; Florin,9997,0,9999,2
1713489224575,CLRE 253,B00,507202,Vaida; Florin,9999,0,9999,0
1713489225610,CLRE 259,A00,507211,Patel; Hemal,9996,0,9999,3
1713489226637,CLRE 260,A00,507221,Cuomo; Raphael Eduardo,9999,0,9999,0
1713489227663,CLRE 297,001,507242,Cuomo; Raphael Eduardo,9999,0,9999,0
1713489228688,CSE 191,A00,516875,Minnes Kemp; Mor Mia,9999,0,9999,0
1713489229713,CSS 201S,A01,494383,Staff,35,0,35,0
1713489230739,CSS 202S,A01,494387,Staff,35,0,35,0
1713489231764,EAP 100,A00,516065,Staff,9792,0,9999,207
1713489232795,ECE 45,A01,507414,Staff,38,0,60,22
1713489233822,ECE 100,A01,507416,Baghdadchi; Saharnaz,0,0,20,20
1713489233822,ECE 100,A02,507418,Baghdadchi; Saharnaz,19,0,20,1
1713489234846,ECE 111,A01,507420,Staff,27,0,50,23
1713489235873,ECE 197,001,548057,Sievenpiper; Daniel F.,9998,0,9999,1
1713489236899,EDS 115,A00,507243,Choi; Bailey Miyeon,27,0,28,1
1713489237928,EDS 117,A01,494379,Staff,16,0,25,9
1713489238953,EDS 125,A00,507246,Hopkins; Megan Beth,28,0,30,2
1713489239978,EDS 128A,A01,507264,Fargason; Sharon Gayle,26,0,26,0
1713489241009,EDS 128B,A01,507293,Pappas; Elizabeth,30,0,30,0
1713489242040,EDS 139,A00,507294,Fargason; Sharon Gayle,30,0,30,0
1713489242040,EDS 139,B00,507313,Pappas; Elizabeth,30,0,30,0
1713489243119,EDS 201,A00,507315,Staff,18,0,30,12
1713489244147,EDS 203,A01,507317,Halter; Christopher P.,17,0,30,13
1713489245174,EDS 204R,A01,507319,Halter; Christopher P.,0,1,30,30
1713489245174,EDS 204R,B01,507331,Heinzman; Erica M.,26,0,30,4
1713489246199,EDS 206R,A00,507332,Staff,0,2,30,30
1713489246199,EDS 206R,B00,507343,Staff,27,0,30,3
1713489247228,EDS 250,A00,507344,Hemans; Patricia Ann Benitez,27,0,40,13
1713489248257,EDS 281,A00,507345,Daly; Alan J.,18,0,18,0
1713489249282,EDS 284,A00,507350,Daly; Alan J.,16,0,16,0
1713489250311,EDS 286,A00,507359,Fine; Sarah,18,0,18,0
1713489251342,EDS 289C,A01,507361,Daly; Alan J.,18,0,18,0
1713489252367,EDS 290,A00,507366,Hofstetter; Carolyn,15,0,15,0
1713489253396,LIGM 5A,A00,507421,Fischer-Grunski; Eva K,20,0,20,0
1713489254426,LIGM 5B,A00,507423,Fischer-Grunski; Eva K,20,0,20,0
1713489255454,LIGM 5C,A00,507425,Fischer-Grunski; Eva K,20,0,20,0
1713489256478,LIIT 5AS,A00,507427,Carnelos; Chiara,20,0,20,0
1713489257504,LIIT 5BS,A00,507430,Carnelos; Chiara,20,0,20,0
1713489258529,LIIT 5CS,A00,507432,Carnelos; Chiara,20,0,20,0
1713489259558,LISP 5A,A00,507541,Munoz Sanchez; Alicia,14,0,20,6
1713489260588,LISP 5B,A00,507671,Munoz Sanchez; Alicia,12,0,20,8
1713489261613,LISP 5C,A00,507696,Munoz Sanchez; Alicia,11,0,20,9
1713489262642,MAE 197,001,528363,Boechler; Nicholas Sebastia,9998,0,9999,1
1713489263667,MATH 197,001,523477,Kedlaya; Kiran S.,9999,0,9999,0
1713489263667,MATH 197,002,563811,Zhang; Danna,9998,0,9999,1
1713489264693,MCWP 40R,A00,518780,Staff,16,0,20,4
1713489264693,MCWP 40R,B00,518781,Staff,14,0,20,6
1713489264693,MCWP 40R,C00,518783,Staff,10,0,20,10
1713489265722,MCWP 50R,A00,518791,Staff,8,0,20,12
1713489265722,MCWP 50R,B00,518792,Staff,5,0,20,15
1713489265722,MCWP 50R,C00,518793,Staff,7,0,20,13
1713489265722,MCWP 50R,D00,518794,Staff,0,0,20,20
1713489265722,MCWP 50R,E00,518795,Staff,2,0,20,18
1713489265722,MCWP 50R,F00,518796,Staff,13,0,20,7
1713489265722,MCWP 50R,G00,518797,Staff,11,0,20,9
1713489266747,MMW 12R,A01,514034,Herbst; Matthew,5,0,16,11
1713489266747,MMW 12R,A02,514035,Herbst; Matthew,13,0,16,3
1713489267774,MMW 13R,A01,514037,Staff,0,5,16,16
1713489267774,MMW 13R,A02,514039,Staff,0,4,16,16
1713489269823,SIO 295LS,A00,523233,Staff,15,0,30,15
1713489270849,SIO 295S,A00,523232,Staff,15,0,30,15
1713489271877,SOCI 117,A01,494376,Staff,0,2,5,5
1713489272902,WES 237B,A00,494380,Staff,19,0,20,1
1713489274961,AESE 279B,A00,494370,Wade; Jon P,33,0,33,0
1713489275989,AIP 197,001,627712,Vespa; Emanuel Ignacio,9999,0,9999,0
1713489277016,ANAR 135S,A00,494369,Braswell; Geoffrey E.,0,0,0,0
1713489278042,CAT 124RS,A01,519847,Geibel; William,6,0,20,14
1713489279067,CAT 125RS,A01,515971,Geibel; William,6,0,20,14
1713489280094,CLRE 250,A00,511389,Morris; Sheldon,9996,0,9999,3
1713489281119,CLRE 251,A00,507176,Mehta; Ravindra L.,9996,0,9999,3
1713489281119,CLRE 251,B00,511410,Mehta; Ravindra L.,9998,0,9999,1
1713489282147,CLRE 252,A00,507189,Cuomo; Raphael Eduardo,9998,0,9999,1
1713489283180,CLRE 253,A00,507199,Vaida; Florin,9997,0,9999,2
1713489283180,CLRE 253,B00,507202,Vaida; Florin,9999,0,9999,0
1713489284209,CLRE 259,A00,507211,Patel; Hemal,9996,0,9999,3
1713489285238,CLRE 260,A00,507221,Cuomo; Raphael Eduardo,9999,0,9999,0
1713489286267,CLRE 297,001,507242,Cuomo; Raphael Eduardo,9999,0,9999,0
1713489287295,CSE 191,A00,516875,Minnes Kemp; Mor Mia,9999,0,9999,0
1713489288320,CSS 201S,A01,494383,Staff,35,0,35,0
1713489289349,CSS 202S,A01,494387,Staff,35,0,35,0
1713489290378,EAP 100,A00,516065,Staff,9792,0,9999,207
1713489291402,ECE 45,A01,507414,Staff,38,0,60,22
1713489292426,ECE 100,A01,507416,Baghdadchi; Saharnaz,0,0,20,20
1713489292426,ECE 100,A02,507418,Baghdadchi; Saharnaz,19,0,20,1
1713489293451,ECE 111,A01,507420,Staff,27,0,50,23
1713489294477,ECE 197,001,548057,Sievenpiper; Daniel F.,9998,0,9999,1
1713489295505,EDS 115,A00,507243,Choi; Bailey Miyeon,27,0,28,1
1713489296531,EDS 117,A01,494379,Staff,16,0,25,9
1713489297555,EDS 125,A00,507246,Hopkins; Megan Beth,28,0,30,2
1713489298582,EDS 128A,A01,507264,Fargason; Sharon Gayle,26,0,26,0
1713489299609,EDS 128B,A01,507293,Pappas; Elizabeth,30,0,30,0
1713489300634,EDS 139,A00,507294,Fargason; Sharon Gayle,30,0,30,0
1713489300634,EDS 139,B00,507313,Pappas; Elizabeth,30,0,30,0
1713489301661,EDS 201,A00,507315,Staff,18,0,30,12
1713489302690,EDS 203,A01,507317,Halter; Christopher P.,17,0,30,13
1713489303714,EDS 204R,A01,507319,Halter; Christopher P.,0,1,30,30
1713489303714,EDS 204R,B01,507331,Heinzman; Erica M.,26,0,30,4
1713489304739,EDS 206R,A00,507332,Staff,0,2,30,30
1713489304739,EDS 206R,B00,507343,Staff,27,0,30,3
1713489305765,EDS 250,A00,507344,Hemans; Patricia Ann Benitez,27,0,40,13
1713489306792,EDS 281,A00,507345,Daly; Alan J.,18,0,18,0
1713489307817,EDS 284,A00,507350,Daly; Alan J.,16,0,16,0
1713489308845,EDS 286,A00,507359,Fine; Sarah,18,0,18,0
1713489309870,EDS 289C,A01,507361,Daly; Alan J.,18,0,18,0
1713489310897,EDS 290,A00,507366,Hofstetter; Carolyn,15,0,15,0
1713489311926,LIGM 5A,A00,507421,Fischer-Grunski; Eva K,20,0,20,0
1713489312952,LIGM 5B,A00,507423,Fischer-Grunski; Eva K,20,0,20,0
1713489313978,LIGM 5C,A00,507425,Fischer-Grunski; Eva K,20,0,20,0
1713489315004,LIIT 5AS,A00,507427,Carnelos; Chiara,20,0,20,0
1713489316033,LIIT 5BS,A00,507430,Carnelos; Chiara,20,0,20,0
1713489317059,LIIT 5CS,A00,507432,Carnelos; Chiara,20,0,20,0
1713489318088,LISP 5A,A00,507541,Munoz Sanchez; Alicia,14,0,20,6
1713489319113,LISP 5B,A00,507671,Munoz Sanchez; Alicia,12,0,20,8
1713489320142,LISP 5C,A00,507696,Munoz Sanchez; Alicia,11,0,20,9
1713489321167,MAE 197,001,528363,Boechler; Nicholas Sebastia,9998,0,9999,1
1713489322192,MATH 197,001,523477,Kedlaya; Kiran S.,9999,0,9999,0
1713489322192,MATH 197,002,563811,Zhang; Danna,9998,0,9999,1
1713489323217,MCWP 40R,A00,518780,Staff,16,0,20,4
1713489323217,MCWP 40R,B00,518781,Staff,14,0,20,6
1713489323217,MCWP 40R,C00,518783,Staff,10,0,20,10
1713489324242,MCWP 50R,A00,518791,Staff,8,0,20,12
1713489324242,MCWP 50R,B00,518792,Staff,5,0,20,15
1713489324242,MCWP 50R,C00,518793,Staff,7,0,20,13
1713489324242,MCWP 50R,D00,518794,Staff,0,0,20,20
1713489324242,MCWP 50R,E00,518795,Staff,2,0,20,18
1713489324242,MCWP 50R,F00,518796,Staff,13,0,20,7
1713489324242,MCWP 50R,G00,518797,Staff,11,0,20,9
1713489325267,MMW 12R,A01,514034,Herbst; Matthew,5,0,16,11
1713489325267,MMW 12R,A02,514035,Herbst; Matthew,13,0,16,3
1713489326292,MMW 13R,A01,514037,Staff,0,5,16,16
1713489326292,MMW 13R,A02,514039,Staff,0,4,16,16
1713489328343,SIO 295LS,A00,523233,Staff,15,0,30,15
1713489329368,SIO 295S,A00,523232,Staff,15,0,30,15
1713489330396,SOCI 117,A01,494376,Staff,0,2,5,5
1713489331421,WES 237B,A00,494380,Staff,19,0,20,1
1713489333482,AESE 279B,A00,494370,Wade; Jon P,33,0,33,0
1713489334507,AIP 197,001,627712,Vespa; Emanuel Ignacio,9999,0,9999,0
1713489335533,ANAR 135S,A00,494369,Braswell; Geoffrey E.,0,0,0,0
1713489336558,CAT 124RS,A01,519847,Geibel; William,6,0,20,14
1713489337584,CAT 125RS,A01,515971,Geibel; William,6,0,20,14
1713489338612,CLRE 250,A00,511389,Morris; Sheldon,9996,0,9999,3
1713489339637,CLRE 251,A00,507176,Mehta; Ravindra L.,9996,0,9999,3
1713489339637,CLRE 251,B00,511410,Mehta; Ravindra L.,9998,0,9999,1
1713489340663,CLRE 252,A00,507189,Cuomo; Raphael Eduardo,9998,0,9999,1
1713489341692,CLRE 253,A00,507199,Vaida; Florin,9997,0,9999,2
1713489341692,CLRE 253,B00,507202,Vaida; Florin,9999,0,9999,0
1713489342722,CLRE 259,A00,507211,Patel; Hemal,9996,0,9999,3
1713489343747,CLRE 260,A00,507221,Cuomo; Raphael Eduardo,9999,0,9999,0
1713489344776,CLRE 297,001,507242,Cuomo; Raphael Eduardo,9999,0,9999,0
1713489345803,CSE 191,A00,516875,Minnes Kemp; Mor Mia,9999,0,9999,0
1713489346906,CSS 201S,A01,494383,Staff,35,0,35,0
1713489347933,CSS 202S,A01,494387,Staff,35,0,35,0
1713489348957,EAP 100,A00,516065,Staff,9792,0,9999,207
1713489349981,ECE 45,A01,507414,Staff,38,0,60,22
1713489351010,ECE 100,A01,507416,Baghdadchi; Saharnaz,0,0,20,20
1713489351010,ECE 100,A02,507418,Baghdadchi; Saharnaz,19,0,20,1
1713489352039,ECE 111,A01,507420,Staff,27,0,50,23
1713489353064,ECE 197,001,548057,Sievenpiper; Daniel F.,9998,0,9999,1
1713489354093,EDS 115,A00,507243,Choi; Bailey Miyeon,27,0,28,1
1713489355119,EDS 117,A01,494379,Staff,16,0,25,9
1713489356143,EDS 125,A00,507246,Hopkins; Megan Beth,28,0,30,2
1713489357168,EDS 128A,A01,507264,Fargason; Sharon Gayle,26,0,26,0
1713489358198,EDS 128B,A01,507293,Pappas; Elizabeth,30,0,30,0
1713489359223,EDS 139,A00,507294,Fargason; Sharon Gayle,30,0,30,0
1713489359223,EDS 139,B00,507313,Pappas; Elizabeth,30,0,30,0
1713489360251,EDS 201,A00,507315,Staff,18,0,30,12
1713489361276,EDS 203,A01,507317,Halter; Christopher P.,17,0,30,13
1713489362304,EDS 204R,A01,507319,Halter; Christopher P.,0,1,30,30
1713489362304,EDS 204R,B01,507331,Heinzman; Erica M.,26,0,30,4
1713489363336,EDS 206R,A00,507332,Staff,0,2,30,30
1713489363336,EDS 206R,B00,507343,Staff,27,0,30,3
1713489364361,EDS 250,A00,507344,Hemans; Patricia Ann Benitez,27,0,40,13
1713489365388,EDS 281,A00,507345,Daly; Alan J.,18,0,18,0
1713489366413,EDS 284,A00,507350,Daly; Alan J.,16,0,16,0
1713489367438,EDS 286,A00,507359,Fine; Sarah,18,0,18,0
1713489368463,EDS 289C,A01,507361,Daly; Alan J.,18,0,18,0
1713489369491,EDS 290,A00,507366,Hofstetter; Carolyn,15,0,15,0
1713489370515,LIGM 5A,A00,507421,Fischer-Grunski; Eva K,20,0,20,0
1713489371544,LIGM 5B,A00,507423,Fischer-Grunski; Eva K,20,0,20,0
1713489372570,LIGM 5C,A00,507425,Fischer-Grunski; Eva K,20,0,20,0
1713489373595,LIIT 5AS,A00,507427,Carnelos; Chiara,20,0,20,0
1713489374621,LIIT 5BS,A00,507430,Carnelos; Chiara,20,0,20,0
1713489375652,LIIT 5CS,A00,507432,Carnelos; Chiara,20,0,20,0
1713489376678,LISP 5A,A00,507541,Munoz Sanchez; Alicia,14,0,20,6
1713489377703,LISP 5B,A00,507671,Munoz Sanchez; Alicia,12,0,20,8
1713489378733,LISP 5C,A00,507696,Munoz Sanchez; Alicia,11,0,20,9
1713489379757,MAE 197,001,528363,Boechler; Nicholas Sebastia,9998,0,9999,1
1713489380783,MATH 197,001,523477,Kedlaya; Kiran S.,9999,0,9999,0
1713489380783,MATH 197,002,563811,Zhang; Danna,9998,0,9999,1
1713489381812,MCWP 40R,A00,518780,Staff,16,0,20,4
1713489381812,MCWP 40R,B00,518781,Staff,14,0,20,6
1713489381812,MCWP 40R,C00,518783,Staff,10,0,20,10
1713489382837,MCWP 50R,A00,518791,Staff,8,0,20,12
1713489382837,MCWP 50R,B00,518792,Staff,5,0,20,15
1713489382837,MCWP 50R,C00,518793,Staff,7,0,20,13
1713489382837,MCWP 50R,D00,518794,Staff,0,0,20,20
1713489382837,MCWP 50R,E00,518795,Staff,2,0,20,18
1713489382837,MCWP 50R,F00,518796,Staff,13,0,20,7
1713489382837,MCWP 50R,G00,518797,Staff,11,0,20,9
1713489383868,MMW 12R,A01,514034,Herbst; Matthew,5,0,16,11
1713489383868,MMW 12R,A02,514035,Herbst; Matthew,13,0,16,3
1713489384894,MMW 13R,A01,514037,Staff,0,5,16,16
1713489384894,MMW 13R,A02,514039,Staff,0,4,16,16
1713489386948,SIO 295LS,A00,523233,Staff,15,0,30,15
1713489387974,SIO 295S,A00,523232,Staff,15,0,30,15
1713489389002,SOCI 117,A01,494376,Staff,0,2,5,5
1713489390027,WES 237B,A00,494380,Staff,19,0,20,1
1713489392083,AESE 279B,A00,494370,Wade; Jon P,33,0,33,0
1713489393108,AIP 197,001,627712,Vespa; Emanuel Ignacio,9999,0,9999,0
1713489394134,ANAR 135S,A00,494369,Braswell; Geoffrey E.,0,0,0,0
1713489395162,CAT 124RS,A01,519847,Geibel; William,6,0,20,14
1713489396189,CAT 125RS,A01,515971,Geibel; William,6,0,20,14
1713489397214,CLRE 250,A00,511389,Morris; Sheldon,9996,0,9999,3
1713489398243,CLRE 251,A00,507176,Mehta; Ravindra L.,9996,0,9999,3
1713489398243,CLRE 251,B00,511410,Mehta; Ravindra L.,9998,0,9999,1
1713489399271,CLRE 252,A00,507189,Cuomo; Raphael Eduardo,9998,0,9999,1
1713489400300,CLRE 253,A00,507199,Vaida; Florin,9997,0,9999,2
1713489400300,CLRE 253,B00,507202,Vaida; Florin,9999,0,9999,0
1713489401323,CLRE 259,A00,507211,Patel; Hemal,9996,0,9999,3
1713489402352,CLRE 260,A00,507221,Cuomo; Raphael Eduardo,9999,0,9999,0
1713489403377,CLRE 297,001,507242,Cuomo; Raphael Eduardo,9999,0,9999,0
1713489404402,CSE 191,A00,516875,Minnes Kemp; Mor Mia,9999,0,9999,0
1713489405430,CSS 201S,A01,494383,Staff,35,0,35,0
1713489406455,CSS 202S,A01,494387,Staff,35,0,35,0
1713489407483,EAP 100,A00,516065,Staff,9792,0,9999,207
1713489408511,ECE 45,A01,507414,Staff,38,0,60,22
1713489409541,ECE 100,A01,507416,Baghdadchi; Saharnaz,0,0,20,20
1713489409541,ECE 100,A02,507418,Baghdadchi; Saharnaz,19,0,20,1
1713489410567,ECE 111,A01,507420,Staff,27,0,50,23
1713489411596,ECE 197,001,548057,Sievenpiper; Daniel F.,9998,0,9999,1
1713489412621,EDS 115,A00,507243,Choi; Bailey Miyeon,27,0,28,1
1713489413650,EDS 117,A01,494379,Staff,16,0,25,9
1713489414676,EDS 125,A00,507246,Hopkins; Megan Beth,28,0,30,2
1713489415700,EDS 128A,A01,507264,Fargason; Sharon Gayle,26,0,26,0
1713489416732,EDS 128B,A01,507293,Pappas; Elizabeth,30,0,30,0
1713489417758,EDS 139,A00,507294,Fargason; Sharon Gayle,30,0,30,0
1713489417758,EDS 139,B00,507313,Pappas; Elizabeth,30,0,30,0
1713489418787,EDS 201,A00,507315,Staff,18,0,30,12
1713489419812,EDS 203,A01,507317,Halter; Christopher P.,17,0,30,13
1713489420840,EDS 204R,A01,507319,Halter; Christopher P.,0,1,30,30
1713489420840,EDS 204R,B01,507331,Heinzman; Erica M.,26,0,30,4
1713489421866,EDS 206R,A00,507332,Staff,0,2,30,30
1713489421866,EDS 206R,B00,507343,Staff,27,0,30,3
1713489422894,EDS 250,A00,507344,Hemans; Patricia Ann Benitez,27,0,40,13
1713489423922,EDS 281,A00,507345,Daly; Alan J.,18,0,18,0
1713489424950,EDS 284,A00,507350,Daly; Alan J.,16,0,16,0
1713489425976,EDS 286,A00,507359,Fine; Sarah,18,0,18,0
1713489427005,EDS 289C,A01,507361,Daly; Alan J.,18,0,18,0
1713489428035,EDS 290,A00,507366,Hofstetter; Carolyn,15,0,15,0
1713489429065,LIGM 5A,A00,507421,Fischer-Grunski; Eva K,20,0,20,0
1713489430094,LIGM 5B,A00,507423,Fischer-Grunski; Eva K,20,0,20,0
1713489431120,LIGM 5C,A00,507425,Fischer-Grunski; Eva K,20,0,20,0
1713489432149,LIIT 5AS,A00,507427,Carnelos; Chiara,20,0,20,0
1713489433178,LIIT 5BS,A00,507430,Carnelos; Chiara,20,0,20,0
1713489434202,LIIT 5CS,A00,507432,Carnelos; Chiara,20,0,20,0
1713489435229,LISP 5A,A00,507541,Munoz Sanchez; Alicia,14,0,20,6
1713489436254,LISP 5B,A00,507671,Munoz Sanchez; Alicia,12,0,20,8
1713489437279,LISP 5C,A00,507696,Munoz Sanchez; Alicia,11,0,20,9
1713489438307,MAE 197,001,528363,Boechler; Nicholas Sebastia,9998,0,9999,1
1713489439333,MATH 197,001,523477,Kedlaya; Kiran S.,9999,0,9999,0
1713489439333,MATH 197,002,563811,Zhang; Danna,9998,0,9999,1
1713489440358,MCWP 40R,A00,518780,Staff,16,0,20,4
1713489440358,MCWP 40R,B00,518781,Staff,14,0,20,6
1713489440358,MCWP 40R,C00,518783,Staff,10,0,20,10
1713489441383,MCWP 50R,A00,518791,Staff,8,0,20,12
1713489441383,MCWP 50R,B00,518792,Staff,5,0,20,15
1713489441383,MCWP 50R,C00,518793,Staff,7,0,20,13
1713489441383,MCWP 50R,D00,518794,Staff,0,0,20,20
1713489441383,MCWP 50R,E00,518795,Staff,2,0,20,18
1713489441383,MCWP 50R,F00,518796,Staff,13,0,20,7
1713489441383,MCWP 50R,G00,518797,Staff,11,0,20,9
1713489442410,MMW 12R,A01,514034,Herbst; Matthew,5,0,16,11
1713489442410,MMW 12R,A02,514035,Herbst; Matthew,13,0,16,3
1713489443436,MMW 13R,A01,514037,Staff,0,5,16,16
1713489443436,MMW 13R,A02,514039,Staff,0,4,16,16
1713489445484,SIO 295LS,A00,523233,Staff,15,0,30,15
1713489446513,SIO 295S,A00,523232,Staff,15,0,30,15
1713489447539,SOCI 117,A01,494376,Staff,0,2,5,5
1713489448567,WES 237B,A00,494380,Staff,19,0,20,1
1713489450688,AESE 279B,A00,494370,Wade; Jon P,33,0,33,0
1713489451716,AIP 197,001,627712,Vespa; Emanuel Ignacio,9999,0,9999,0
1713489452743,ANAR 135S,A00,494369,Braswell; Geoffrey E.,0,0,0,0
1713489453769,CAT 124RS,A01,519847,Geibel; William,6,0,20,14
1713489454798,CAT 125RS,A01,515971,Geibel; William,6,0,20,14
1713489455828,CLRE 250,A00,511389,Morris; Sheldon,9996,0,9999,3
1713489456854,CLRE 251,A00,507176,Mehta; Ravindra L.,9996,0,9999,3
1713489456854,CLRE 251,B00,511410,Mehta; Ravindra L.,9998,0,9999,1
1713489457881,CLRE 252,A00,507189,Cuomo; Raphael Eduardo,9998,0,9999,1
1713489458906,CLRE 253,A00,507199,Vaida; Florin,9997,0,9999,2
1713489458906,CLRE 253,B00,507202,Vaida; Florin,9999,0,9999,0
1713489459932,CLRE 259,A00,507211,Patel; Hemal,9996,0,9999,3
1713489460958,CLRE 260,A00,507221,Cuomo; Raphael Eduardo,9999,0,9999,0
1713489461983,CLRE 297,001,507242,Cuomo; Raphael Eduardo,9999,0,9999,0
1713489463006,CSE 191,A00,516875,Minnes Kemp; Mor Mia,9999,0,9999,0
1713489464030,CSS 201S,A01,494383,Staff,35,0,35,0
1713489465058,CSS 202S,A01,494387,Staff,35,0,35,0
1713489466083,EAP 100,A00,516065,Staff,9792,0,9999,207
1713489467108,ECE 45,A01,507414,Staff,38,0,60,22
1713489468133,ECE 100,A01,507416,Baghdadchi; Saharnaz,0,0,20,20
1713489468133,ECE 100,A02,507418,Baghdadchi; Saharnaz,19,0,20,1
1713489469164,ECE 111,A01,507420,Staff,27,0,50,23
1713489470193,ECE 197,001,548057,Sievenpiper; Daniel F.,9998,0,9999,1
1713489471219,EDS 115,A00,507243,Choi; Bailey Miyeon,27,0,28,1
1713489472244,EDS 117,A01,494379,Staff,16,0,25,9
1713489473271,EDS 125,A00,507246,Hopkins; Megan Beth,28,0,30,2
1713489474300,EDS 128A,A01,507264,Fargason; Sharon Gayle,26,0,26,0
1713489475325,EDS 128B,A01,507293,Pappas; Elizabeth,30,0,30,0
1713489476351,EDS 139,A00,507294,Fargason; Sharon Gayle,30,0,30,0
1713489476351,EDS 139,B00,507313,Pappas; Elizabeth,30,0,30,0
1713489477381,EDS 201,A00,507315,Staff,18,0,30,12
1713489478411,EDS 203,A01,507317,Halter; Christopher P.,17,0,30,13
1713489479435,EDS 204R,A01,507319,Halter; Christopher P.,0,1,30,30
1713489479435,EDS 204R,B01,507331,Heinzman; Erica M.,26,0,30,4
1713489480464,EDS 206R,A00,507332,Staff,0,2,30,30
1713489480464,EDS 206R,B00,507343,Staff,27,0,30,3
1713489481502,EDS 250,A00,507344,Hemans; Patricia Ann Benitez,27,0,40,13
1713489482530,EDS 281,A00,507345,Daly; Alan J.,18,0,18,0
1713489483555,EDS 284,A00,507350,Daly; Alan J.,16,0,16,0
1713489484579,EDS 286,A00,507359,Fine; Sarah,18,0,18,0
1713489485605,EDS 289C,A01,507361,Daly; Alan J.,18,0,18,0
1713489486635,EDS 290,A00,507366,Hofstetter; Carolyn,15,0,15,0
1713489487659,LIGM 5A,A00,507421,Fischer-Grunski; Eva K,20,0,20,0
1713489488687,LIGM 5B,A00,507423,Fischer-Grunski; Eva K,20,0,20,0
1713489489716,LIGM 5C,A00,507425,Fischer-Grunski; Eva K,20,0,20,0
1713489490739,LIIT 5AS,A00,507427,Carnelos; Chiara,20,0,20,0
1713489491769,LIIT 5BS,A00,507430,Carnelos; Chiara,20,0,20,0
1713489492799,LIIT 5CS,A00,507432,Carnelos; Chiara,20,0,20,0
1713489493825,LISP 5A,A00,507541,Munoz Sanchez; Alicia,14,0,20,6
1713489494849,LISP 5B,A00,507671,Munoz Sanchez; Alicia,12,0,20,8
1713489495875,LISP 5C,A00,507696,Munoz Sanchez; Alicia,11,0,20,9
1713489496915,MAE 197,001,528363,Boechler; Nicholas Sebastia,9998,0,9999,1
1713489497943,MATH 197,001,523477,Kedlaya; Kiran S.,9999,0,9999,0
1713489497943,MATH 197,002,563811,Zhang; Danna,9998,0,9999,1
1713489498968,MCWP 40R,A00,518780,Staff,16,0,20,4
1713489498968,MCWP 40R,B00,518781,Staff,14,0,20,6
1713489498968,MCWP 40R,C00,518783,Staff,10,0,20,10
1713489499999,MCWP 50R,A00,518791,Staff,8,0,20,12
1713489499999,MCWP 50R,B00,518792,Staff,5,0,20,15
1713489499999,MCWP 50R,C00,518793,Staff,7,0,20,13
1713489499999,MCWP 50R,D00,518794,Staff,0,0,20,20
1713489499999,MCWP 50R,E00,518795,Staff,2,0,20,18
1713489499999,MCWP 50R,F00,518796,Staff,13,0,20,7
1713489499999,MCWP 50R,G00,518797,Staff,11,0,20,9
1713489501028,MMW 12R,A01,514034,Herbst; Matthew,5,0,16,11
1713489501028,MMW 12R,A02,514035,Herbst; Matthew,13,0,16,3
1713489502053,MMW 13R,A01,514037,Staff,0,5,16,16
1713489502053,MMW 13R,A02,514039,Staff,0,4,16,16
1713489504107,SIO 295LS,A00,523233,Staff,15,0,30,15
1713489505136,SIO 295S,A00,523232,Staff,15,0,30,15
1713489506162,SOCI 117,A01,494376,Staff,0,2,5,5
1713489507188,WES 237B,A00,494380,Staff,19,0,20,1
1713489509248,AESE 279B,A00,494370,Wade; Jon P,33,0,33,0
1713489510276,AIP 197,001,627712,Vespa; Emanuel Ignacio,9999,0,9999,0
1713489511306,ANAR 135S,A00,494369,Braswell; Geoffrey E.,0,0,0,0
1713489512332,CAT 124RS,A01,519847,Geibel; William,6,0,20,14
1713489513360,CAT 125RS,A01,515971,Geibel; William,6,0,20,14
1713489514388,CLRE 250,A00,511389,Morris; Sheldon,9996,0,9999,3
1713489515417,CLRE 251,A00,507176,Mehta; Ravindra L.,9996,0,9999,3
1713489515417,CLRE 251,B00,511410,Mehta; Ravindra L.,9998,0,9999,1
1713489516441,CLRE 252,A00,507189,Cuomo; Raphael Eduardo,9998,0,9999,1
1713489517467,CLRE 253,A00,507199,Vaida; Florin,9997,0,9999,2
1713489517467,CLRE 253,B00,507202,Vaida; Florin,9999,0,9999,0
1713489518537,CLRE 259,A00,507211,Patel; Hemal,9996,0,9999,3
1713489519565,CLRE 260,A00,507221,Cuomo; Raphael Eduardo,9999,0,9999,0
1713489520593,CLRE 297,001,507242,Cuomo; Raphael Eduardo,9999,0,9999,0
1713489521621,CSE 191,A00,516875,Minnes Kemp; Mor Mia,9999,0,9999,0
1713489522648,CSS 201S,A01,494383,Staff,35,0,35,0
1713489523677,CSS 202S,A01,494387,Staff,35,0,35,0
1713489524702,EAP 100,A00,516065,Staff,9792,0,9999,207
1713489525727,ECE 45,A01,507414,Staff,38,0,60,22
1713489526756,ECE 100,A01,507416,Baghdadchi; Saharnaz,0,0,20,20
1713489526756,ECE 100,A02,507418,Baghdadchi; Saharnaz,19,0,20,1
1713489527787,ECE 111,A01,507420,Staff,27,0,50,23
1713489528815,ECE 197,001,548057,Sievenpiper; Daniel F.,9998,0,9999,1
1713489529841,EDS 115,A00,507243,Choi; Bailey Miyeon,27,0,28,1
1713489530865,EDS 117,A01,494379,Staff,16,0,25,9
1713489531895,EDS 125,A00,507246,Hopkins; Megan Beth,27,0,30,3
1713489532920,EDS 128A,A01,507264,Fargason; Sharon Gayle,26,0,26,0
1713489533946,EDS 128B,A01,507293,Pappas; Elizabeth,30,0,30,0
1713489534971,EDS 139,A00,507294,Fargason; Sharon Gayle,30,0,30,0
1713489534971,EDS 139,B00,507313,Pappas; Elizabeth,30,0,30,0
1713489535996,EDS 201,A00,507315,Staff,18,0,30,12
1713489537025,EDS 203,A01,507317,Halter; Christopher P.,17,0,30,13
1713489538050,EDS 204R,A01,507319,Halter; Christopher P.,0,1,30,30
1713489538050,EDS 204R,B01,507331,Heinzman; Erica M.,25,0,30,5
1713489539078,EDS 206R,A00,507332,Staff,0,2,30,30
1713489539078,EDS 206R,B00,507343,Staff,26,0,30,4
1713489540108,EDS 250,A00,507344,Hemans; Patricia Ann Benitez,27,0,40,13
1713489541132,EDS 281,A00,507345,Daly; Alan J.,18,0,18,0
1713489542159,EDS 284,A00,507350,Daly; Alan J.,16,0,16,0
1713489543189,EDS 286,A00,507359,Fine; Sarah,18,0,18,0
1713489544219,EDS 289C,A01,507361,Daly; Alan J.,18,0,18,0
1713489545243,EDS 290,A00,507366,Hofstetter; Carolyn,15,0,15,0
1713489546273,LIGM 5A,A00,507421,Fischer-Grunski; Eva K,20,0,20,0
1713489547301,LIGM 5B,A00,507423,Fischer-Grunski; Eva K,20,0,20,0
1713489548326,LIGM 5C,A00,507425,Fischer-Grunski; Eva K,20,0,20,0
1713489549354,LIIT 5AS,A00,507427,Carnelos; Chiara,20,0,20,0
1713489550383,LIIT 5BS,A00,507430,Carnelos; Chiara,20,0,20,0
1713489551408,LIIT 5CS,A00,507432,Carnelos; Chiara,20,0,20,0
1713489552438,LISP 5A,A00,507541,Munoz Sanchez; Alicia,14,0,20,6
1713489553465,LISP 5B,A00,507671,Munoz Sanchez; Alicia,12,0,20,8
1713489554552,LISP 5C,A00,507696,Munoz Sanchez; Alicia,11,0,20,9
1713489555580,MAE 197,001,528363,Boechler; Nicholas Sebastia,9998,0,9999,1
1713489556607,MATH 197,001,523477,Kedlaya; Kiran S.,9999,0,9999,0
1713489556607,MATH 197,002,563811,Zhang; Danna,9998,0,9999,1
1713489557635,MCWP 40R,A00,518780,Staff,16,0,20,4
1713489557635,MCWP 40R,B00,518781,Staff,14,0,20,6
1713489557635,MCWP 40R,C00,518783,Staff,10,0,20,10
1713489558662,MCWP 50R,A00,518791,Staff,8,0,20,12
1713489558662,MCWP 50R,B00,518792,Staff,5,0,20,15
1713489558662,MCWP 50R,C00,518793,Staff,7,0,20,13
1713489558662,MCWP 50R,D00,518794,Staff,0,0,20,20
1713489558662,MCWP 50R,E00,518795,Staff,2,0,20,18
1713489558662,MCWP 50R,F00,518796,Staff,13,0,20,7
1713489558662,MCWP 50R,G00,518797,Staff,11,0,20,9
1713489559687,MMW 12R,A01,514034,Herbst; Matthew,5,0,16,11
1713489559687,MMW 12R,A02,514035,Herbst; Matthew,13,0,16,3
1713489560712,MMW 13R,A01,514037,Staff,0,5,16,16
1713489560712,MMW 13R,A02,514039,Staff,0,4,16,16
1713489562765,SIO 295LS,A00,523233,Staff,15,0,30,15
1713489563795,SIO 295S,A00,523232,Staff,15,0,30,15
1713489564821,SOCI 117,A01,494376,Staff,0,2,5,5
1713489565848,WES 237B,A00,494380,Staff,19,0,20,1
1713489567912,AESE 279B,A00,494370,Wade; Jon P,33,0,33,0
1713489569142,AIP 197,001,627712,Vespa; Emanuel Ignacio,9999,0,9999,0
1713489570171,ANAR 135S,A00,494369,Braswell; Geoffrey E.,0,0,0,0
1713489571195,CAT 124RS,A01,519847,Geibel; William,6,0,20,14
1713489572224,CAT 125RS,A01,515971,Geibel; William,6,0,20,14
1713489573252,CLRE 250,A00,511389,Morris; Sheldon,9996,0,9999,3
1713489574278,CLRE 251,A00,507176,Mehta; Ravindra L.,9996,0,9999,3
1713489574278,CLRE 251,B00,511410,Mehta; Ravindra L.,9998,0,9999,1
1713489575308,CLRE 252,A00,507189,Cuomo; Raphael Eduardo,9998,0,9999,1
1713489576334,CLRE 253,A00,507199,Vaida; Florin,9997,0,9999,2
1713489576334,CLRE 253,B00,507202,Vaida; Florin,9999,0,9999,0
1713489577362,CLRE 259,A00,507211,Patel; Hemal,9996,0,9999,3
1713489578391,CLRE 260,A00,507221,Cuomo; Raphael Eduardo,9999,0,9999,0
1713489579418,CLRE 297,001,507242,Cuomo; Raphael Eduardo,9999,0,9999,0
1713489580442,CSE 191,A00,516875,Minnes Kemp; Mor Mia,9999,0,9999,0
1713489581470,CSS 201S,A01,494383,Staff,35,0,35,0
1713489582497,CSS 202S,A01,494387,Staff,35,0,35,0
1713489583525,EAP 100,A00,516065,Staff,9792,0,9999,207
1713489584555,ECE 45,A01,507414,Staff,38,0,60,22
1713489585585,ECE 100,A01,507416,Baghdadchi; Saharnaz,0,0,20,20
1713489585585,ECE 100,A02,507418,Baghdadchi; Saharnaz,19,0,20,1
1713489586608,ECE 111,A01,507420,Staff,27,0,50,23
1713489587634,ECE 197,001,548057,Sievenpiper; Daniel F.,9998,0,9999,1
1713489588659,EDS 115,A00,507243,Choi; Bailey Miyeon,27,0,28,1
1713489589683,EDS 117,A01,494379,Staff,16,0,25,9
1713489590709,EDS 125,A00,507246,Hopkins; Megan Beth,27,0,30,3
1713489591734,EDS 128A,A01,507264,Fargason; Sharon Gayle,26,0,26,0
1713489592760,EDS 128B,A01,507293,Pappas; Elizabeth,30,0,30,0
1713489593790,EDS 139,A00,507294,Fargason; Sharon Gayle,30,0,30,0
1713489593790,EDS 139,B00,507313,Pappas; Elizabeth,30,0,30,0
1713489594816,EDS 201,A00,507315,Staff,18,0,30,12
1713489595858,EDS 203,A01,507317,Halter; Christopher P.,17,0,30,13
1713489596888,EDS 204R,A01,507319,Halter; Christopher P.,0,1,30,30
1713489596888,EDS 204R,B01,507331,Heinzman; Erica M.,23,0,30,7
1713489597914,EDS 206R,A00,507332,Staff,0,2,30,30
1713489597914,EDS 206R,B00,507343,Staff,26,0,30,4
1713489598943,EDS 250,A00,507344,Hemans; Patricia Ann Benitez,27,0,40,13
1713489599967,EDS 281,A00,507345,Daly; Alan J.,18,0,18,0
1713489600995,EDS 284,A00,507350,Daly; Alan J.,16,0,16,0
1713489602023,EDS 286,A00,507359,Fine; Sarah,18,0,18,0
1713489603048,EDS 289C,A01,507361,Daly; Alan J.,18,0,18,0
1713489604078,EDS 290,A00,507366,Hofstetter; Carolyn,15,0,15,0
1713489605102,LIGM 5A,A00,507421,Fischer-Grunski; Eva K,20,0,20,0
1713489606127,LIGM 5B,A00,507423,Fischer-Grunski; Eva K,20,0,20,0
1713489607153,LIGM 5C,A00,507425,Fischer-Grunski; Eva K,20,0,20,0
1713489608178,LIIT 5AS,A00,507427,Carnelos; Chiara,20,0,20,0
1713489609203,LIIT 5BS,A00,507430,Carnelos; Chiara,20,0,20,0
1713489610228,LIIT 5CS,A00,507432,Carnelos; Chiara,20,0,20,0
1713489611253,LISP 5A,A00,507541,Munoz Sanchez; Alicia,14,0,20,6
1713489612278,LISP 5B,A00,507671,Munoz Sanchez; Alicia,12,0,20,8
1713489613303,LISP 5C,A00,507696,Munoz Sanchez; Alicia,11,0,20,9
1713489614328,MAE 197,001,528363,Boechler; Nicholas Sebastia,9998,0,9999,1
1713489615351,MATH 197,001,523477,Kedlaya; Kiran S.,9999,0,9999,0
1713489615351,MATH 197,002,563811,Zhang; Danna,9998,0,9999,1
1713489616378,MCWP 40R,A00,518780,Staff,16,0,20,4
1713489616378,MCWP 40R,B00,518781,Staff,14,0,20,6
1713489616378,MCWP 40R,C00,518783,Staff,10,0,20,10
1713489617403,MCWP 50R,A00,518791,Staff,8,0,20,12
1713489617403,MCWP 50R,B00,518792,Staff,5,0,20,15
1713489617403,MCWP 50R,C00,518793,Staff,7,0,20,13
1713489617403,MCWP 50R,D00,518794,Staff,0,0,20,20
1713489617403,MCWP 50R,E00,518795,Staff,2,0,20,18
1713489617403,MCWP 50R,F00,518796,Staff,13,0,20,7
1713489617403,MCWP 50R,G00,518797,Staff,11,0,20,9
1713489618429,MMW 12R,A01,514034,Herbst; Matthew,5,0,16,11
1713489618429,MMW 12R,A02,514035,Herbst; Matthew,13,0,16,3
1713489619453,MMW 13R,A01,514037,Staff,0,5,16,16
1713489619453,MMW 13R,A02,514039,Staff,0,4,16,16
1713489621506,SIO 295LS,A00,523233,Staff,15,0,30,15
1713489622531,SIO 295S,A00,523232,Staff,15,0,30,15
1713489623558,SOCI 117,A01,494376,Staff,0,2,5,5
1713489624582,WES 237B,A00,494380,Staff,19,0,20,1
1713489626637,AESE 279B,A00,494370,Wade; Jon P,33,0,33,0
1713489627662,AIP 197,001,627712,Vespa; Emanuel Ignacio,9999,0,9999,0
1713489628689,ANAR 135S,A00,494369,Braswell; Geoffrey E.,0,0,0,0
1713489629716,CAT 124RS,A01,519847,Geibel; William,6,0,20,14
1713489630741,CAT 125RS,A01,515971,Geibel; William,6,0,20,14
1713489631766,CLRE 250,A00,511389,Morris; Sheldon,9996,0,9999,3
1713489632791,CLRE 251,A00,507176,Mehta; Ravindra L.,9996,0,9999,3
1713489632791,CLRE 251,B00,511410,Mehta; Ravindra L.,9998,0,9999,1
1713489633815,CLRE 252,A00,507189,Cuomo; Raphael Eduardo,9998,0,9999,1
1713489634845,CLRE 253,A00,507199,Vaida; Florin,9997,0,9999,2
1713489634845,CLRE 253,B00,507202,Vaida; Florin,9999,0,9999,0
1713489635882,CLRE 259,A00,507211,Patel; Hemal,9996,0,9999,3
1713489636909,CLRE 260,A00,507221,Cuomo; Raphael Eduardo,9999,0,9999,0
1713489637934,CLRE 297,001,507242,Cuomo; Raphael Eduardo,9999,0,9999,0
1713489638959,CSE 191,A00,516875,Minnes Kemp; Mor Mia,9999,0,9999,0
1713489639990,CSS 201S,A01,494383,Staff,35,0,35,0
1713489641015,CSS 202S,A01,494387,Staff,35,0,35,0
1713489642039,EAP 100,A00,516065,Staff,9792,0,9999,207
1713489643064,ECE 45,A01,507414,Staff,38,0,60,22
1713489644090,ECE 100,A01,507416,Baghdadchi; Saharnaz,0,0,20,20
1713489644090,ECE 100,A02,507418,Baghdadchi; Saharnaz,19,0,20,1
1713489645117,ECE 111,A01,507420,Staff,27,0,50,23
1713489646142,ECE 197,001,548057,Sievenpiper; Daniel F.,9998,0,9999,1
1713489647167,EDS 115,A00,507243,Choi; Bailey Miyeon,27,0,28,1
1713489648192,EDS 117,A01,494379,Staff,16,0,25,9
1713489649217,EDS 125,A00,507246,Hopkins; Megan Beth,27,0,30,3
1713489650242,EDS 128A,A01,507264,Fargason; Sharon Gayle,26,0,26,0
1713489651271,EDS 128B,A01,507293,Pappas; Elizabeth,30,0,30,0
1713489652300,EDS 139,A00,507294,Fargason; Sharon Gayle,30,0,30,0
1713489652300,EDS 139,B00,507313,Pappas; Elizabeth,30,0,30,0
1713489653326,EDS 201,A00,507315,Staff,18,0,30,12
1713489654352,EDS 203,A01,507317,Halter; Christopher P.,17,0,30,13
1713489655377,EDS 204R,A01,507319,Halter; Christopher P.,0,1,30,30
1713489655377,EDS 204R,B01,507331,Heinzman; Erica M.,23,0,30,7
1713489656409,EDS 206R,A00,507332,Staff,0,2,30,30
1713489656409,EDS 206R,B00,507343,Staff,24,0,30,6
1713489657437,EDS 250,A00,507344,Hemans; Patricia Ann Benitez,27,0,40,13
1713489658526,EDS 281,A00,507345,Daly; Alan J.,18,0,18,0
1713489659555,EDS 284,A00,507350,Daly; Alan J.,16,0,16,0
1713489660581,EDS 286,A00,507359,Fine; Sarah,18,0,18,0
1713489661608,EDS 289C,A01,507361,Daly; Alan J.,18,0,18,0
1713489662633,EDS 290,A00,507366,Hofstetter; Carolyn,15,0,15,0
1713489663662,LIGM 5A,A00,507421,Fischer-Grunski; Eva K,20,0,20,0
1713489664688,LIGM 5B,A00,507423,Fischer-Grunski; Eva K,20,0,20,0
1713489665714,LIGM 5C,A00,507425,Fischer-Grunski; Eva K,20,0,20,0
1713489666739,LIIT 5AS,A00,507427,Carnelos; Chiara,20,0,20,0
1713489667767,LIIT 5BS,A00,507430,Carnelos; Chiara,20,0,20,0
1713489668793,LIIT 5CS,A00,507432,Carnelos; Chiara,20,0,20,0
1713489669819,LISP 5A,A00,507541,Munoz Sanchez; Alicia,14,0,20,6
1713489670844,LISP 5B,A00,507671,Munoz Sanchez; Alicia,12,0,20,8
1713489671871,LISP 5C,A00,507696,Munoz Sanchez; Alicia,11,0,20,9
1713489672896,MAE 197,001,528363,Boechler; Nicholas Sebastia,9998,0,9999,1
1713489673921,MATH 197,001,523477,Kedlaya; Kiran S.,9999,0,9999,0
1713489673921,MATH 197,002,563811,Zhang; Danna,9998,0,9999,1
1713489674949,MCWP 40R,A00,518780,Staff,15,0,20,5
1713489674949,MCWP 40R,B00,518781,Staff,14,0,20,6
1713489674949,MCWP 40R,C00,518783,Staff,10,0,20,10
1713489675976,MCWP 50R,A00,518791,Staff,8,0,20,12
1713489675976,MCWP 50R,B00,518792,Staff,5,0,20,15
1713489675976,MCWP 50R,C00,518793,Staff,7,0,20,13
1713489675976,MCWP 50R,D00,518794,Staff,0,0,20,20
1713489675976,MCWP 50R,E00,518795,Staff,1,0,20,19
1713489675976,MCWP 50R,F00,518796,Staff,13,0,20,7
1713489675976,MCWP 50R,G00,518797,Staff,11,0,20,9
1713489677003,MMW 12R,A01,514034,Herbst; Matthew,5,0,16,11
1713489677003,MMW 12R,A02,514035,Herbst; Matthew,13,0,16,3
1713489678032,MMW 13R,A01,514037,Staff,0,5,16,16
1713489678032,MMW 13R,A02,514039,Staff,0,4,16,16
1713489680083,SIO 295LS,A00,523233,Staff,15,0,30,15
1713489681109,SIO 295S,A00,523232,Staff,15,0,30,15
1713489682137,SOCI 117,A01,494376,Staff,0,2,5,5
1713489683164,WES 237B,A00,494380,Staff,19,0,20,1
1713489685234,AESE 279B,A00,494370,Wade; Jon P,33,0,33,0
1713489686261,AIP 197,001,627712,Vespa; Emanuel Ignacio,9999,0,9999,0
1713489687287,ANAR 135S,A00,494369,Braswell; Geoffrey E.,0,0,0,0
1713489688310,CAT 124RS,A01,519847,Geibel; William,6,0,20,14
1713489689336,CAT 125RS,A01,515971,Geibel; William,6,0,20,14
1713489690360,CLRE 250,A00,511389,Morris; Sheldon,9996,0,9999,3
1713489691390,CLRE 251,A00,507176,Mehta; Ravindra L.,9996,0,9999,3
1713489691390,CLRE 251,B00,511410,Mehta; Ravindra L.,9998,0,9999,1
1713489692414,CLRE 252,A00,507189,Cuomo; Raphael Eduardo,9998,0,9999,1
1713489693441,CLRE 253,A00,507199,Vaida; Florin,9997,0,9999,2
1713489693441,CLRE 253,B00,507202,Vaida; Florin,9999,0,9999,0
1713489694465,CLRE 259,A00,507211,Patel; Hemal,9996,0,9999,3
1713489695494,CLRE 260,A00,507221,Cuomo; Raphael Eduardo,9999,0,9999,0
1713489696518,CLRE 297,001,507242,Cuomo; Raphael Eduardo,9999,0,9999,0
1713489697541,CSE 191,A00,516875,Minnes Kemp; Mor Mia,9999,0,9999,0
1713489698570,CSS 201S,A01,494383,Staff,35,0,35,0
1713489699597,CSS 202S,A01,494387,Staff,35,0,35,0
1713489700624,EAP 100,A00,516065,Staff,9792,0,9999,207
1713489701651,ECE 45,A01,507414,Staff,38,0,60,22
1713489702675,ECE 100,A01,507416,Baghdadchi; Saharnaz,0,0,20,20
1713489702675,ECE 100,A02,507418,Baghdadchi; Saharnaz,19,0,20,1
1713489703699,ECE 111,A01,507420,Staff,27,0,50,23
1713489704727,ECE 197,001,548057,Sievenpiper; Daniel F.,9998,0,9999,1
1713489705754,EDS 115,A00,507243,Choi; Bailey Miyeon,27,0,28,1
1713489706785,EDS 117,A01,494379,Staff,16,0,25,9
1713489707811,EDS 125,A00,507246,Hopkins; Megan Beth,27,0,30,3
1713489708841,EDS 128A,A01,507264,Fargason; Sharon Gayle,26,0,26,0
1713489709866,EDS 128B,A01,507293,Pappas; Elizabeth,30,0,30,0
1713489710891,EDS 139,A00,507294,Fargason; Sharon Gayle,30,0,30,0
1713489710891,EDS 139,B00,507313,Pappas; Elizabeth,30,0,30,0
1713489711919,EDS 201,A00,507315,Staff,18,0,30,12
1713489712948,EDS 203,A01,507317,Halter; Christopher P.,17,0,30,13
1713489713973,EDS 204R,A01,507319,Halter; Christopher P.,0,1,30,30
1713489713973,EDS 204R,B01,507331,Heinzman; Erica M.,23,0,30,7
1713489714997,EDS 206R,A00,507332,Staff,0,2,30,30
1713489714997,EDS 206R,B00,507343,Staff,24,0,30,6
1713489716023,EDS 250,A00,507344,Hemans; Patricia Ann Benitez,27,0,40,13
1713489717051,EDS 281,A00,507345,Daly; Alan J.,18,0,18,0
1713489718076,EDS 284,A00,507350,Daly; Alan J.,16,0,16,0
1713489719101,EDS 286,A00,507359,Fine; Sarah,18,0,18,0
1713489720125,EDS 289C,A01,507361,Daly; Alan J.,18,0,18,0
1713489721149,EDS 290,A00,507366,Hofstetter; Carolyn,15,0,15,0
1713489722174,LIGM 5A,A00,507421,Fischer-Grunski; Eva K,20,0,20,0
1713489723202,LIGM 5B,A00,507423,Fischer-Grunski; Eva K,20,0,20,0
1713489724226,LIGM 5C,A00,507425,Fischer-Grunski; Eva K,20,0,20,0
1713489725250,LIIT 5AS,A00,507427,Carnelos; Chiara,20,0,20,0
1713489726275,LIIT 5BS,A00,507430,Carnelos; Chiara,20,0,20,0
1713489727303,LIIT 5CS,A00,507432,Carnelos; Chiara,20,0,20,0
1713489728329,LISP 5A,A00,507541,Munoz Sanchez; Alicia,14,0,20,6
1713489729354,LISP 5B,A00,507671,Munoz Sanchez; Alicia,12,0,20,8
1713489730381,LISP 5C,A00,507696,Munoz Sanchez; Alicia,11,0,20,9
1713489731408,MAE 197,001,528363,Boechler; Nicholas Sebastia,9998,0,9999,1
1713489732436,MATH 197,001,523477,Kedlaya; Kiran S.,9999,0,9999,0
1713489732436,MATH 197,002,563811,Zhang; Danna,9998,0,9999,1
1713489733461,MCWP 40R,A00,518780,Staff,15,0,20,5
1713489733461,MCWP 40R,B00,518781,Staff,14,0,20,6
1713489733461,MCWP 40R,C00,518783,Staff,10,0,20,10
1713489734486,MCWP 50R,A00,518791,Staff,8,0,20,12
1713489734486,MCWP 50R,B00,518792,Staff,5,0,20,15
1713489734486,MCWP 50R,C00,518793,Staff,7,0,20,13
1713489734486,MCWP 50R,D00,518794,Staff,0,0,20,20
1713489734486,MCWP 50R,E00,518795,Staff,1,0,20,19
1713489734486,MCWP 50R,F00,518796,Staff,13,0,20,7
1713489734486,MCWP 50R,G00,518797,Staff,11,0,20,9
1713489735513,MMW 12R,A01,514034,Herbst; Matthew,5,0,16,11
1713489735513,MMW 12R,A02,514035,Herbst; Matthew,13,0,16,3
1713489736541,MMW 13R,A01,514037,Staff,0,5,16,16
1713489736541,MMW 13R,A02,514039,Staff,0,4,16,16
1713489738590,SIO 295LS,A00,523233,Staff,15,0,30,15
1713489739619,SIO 295S,A00,523232,Staff,15,0,30,15
1713489740647,SOCI 117,A01,494376,Staff,0,2,5,5
1713489741671,WES 237B,A00,494380,Staff,19,0,20,1
1713489743743,AESE 279B,A00,494370,Wade; Jon P,33,0,33,0
1713489744767,AIP 197,001,627712,Vespa; Emanuel Ignacio,9999,0,9999,0
1713489745792,ANAR 135S,A00,494369,Braswell; Geoffrey E.,0,0,0,0
1713489746818,CAT 124RS,A01,519847,Geibel; William,6,0,20,14
1713489747843,CAT 125RS,A01,515971,Geibel; William,6,0,20,14
1713489748868,CLRE 250,A00,511389,Morris; Sheldon,9996,0,9999,3
1713489749897,CLRE 251,A00,507176,Mehta; Ravindra L.,9996,0,9999,3
1713489749897,CLRE 251,B00,511410,Mehta; Ravindra L.,9998,0,9999,1
1713489750925,CLRE 252,A00,507189,Cuomo; Raphael Eduardo,9998,0,9999,1
1713489751950,CLRE 253,A00,507199,Vaida; Florin,9997,0,9999,2
1713489751950,CLRE 253,B00,507202,Vaida; Florin,9999,0,9999,0
1713489752975,CLRE 259,A00,507211,Patel; Hemal,9996,0,9999,3
1713489753998,CLRE 260,A00,507221,Cuomo; Raphael Eduardo,9999,0,9999,0
1713489755024,CLRE 297,001,507242,Cuomo; Raphael Eduardo,9999,0,9999,0
1713489756049,CSE 191,A00,516875,Minnes Kemp; Mor Mia,9999,0,9999,0
1713489757075,CSS 201S,A01,494383,Staff,35,0,35,0
1713489758103,CSS 202S,A01,494387,Staff,35,0,35,0
1713489759128,EAP 100,A00,516065,Staff,9792,0,9999,207
1713489760154,ECE 45,A01,507414,Staff,38,0,60,22
1713489761181,ECE 100,A01,507416,Baghdadchi; Saharnaz,0,0,20,20
1713489761181,ECE 100,A02,507418,Baghdadchi; Saharnaz,19,0,20,1
1713489762265,ECE 111,A01,507420,Staff,27,0,50,23
1713489763291,ECE 197,001,548057,Sievenpiper; Daniel F.,9998,0,9999,1
1713489764317,EDS 115,A00,507243,Choi; Bailey Miyeon,27,0,28,1
1713489765343,EDS 117,A01,494379,Staff,16,0,25,9
1713489766372,EDS 125,A00,507246,Hopkins; Megan Beth,27,0,30,3
1713489767396,EDS 128A,A01,507264,Fargason; Sharon Gayle,26,0,26,0
1713489768423,EDS 128B,A01,507293,Pappas; Elizabeth,30,0,30,0
1713489769452,EDS 139,A00,507294,Fargason; Sharon Gayle,30,0,30,0
1713489769452,EDS 139,B00,507313,Pappas; Elizabeth,30,0,30,0
1713489770480,EDS 201,A00,507315,Staff,18,0,30,12
1713489771515,EDS 203,A01,507317,Halter; Christopher P.,17,0,30,13
1713489772543,EDS 204R,A01,507319,Halter; Christopher P.,0,1,30,30
1713489772543,EDS 204R,B01,507331,Heinzman; Erica M.,23,0,30,7
1713489773567,EDS 206R,A00,507332,Staff,0,2,30,30
1713489773567,EDS 206R,B00,507343,Staff,24,0,30,6
1713489774593,EDS 250,A00,507344,Hemans; Patricia Ann Benitez,27,0,40,13
1713489775618,EDS 281,A00,507345,Daly; Alan J.,18,0,18,0
1713489776644,EDS 284,A00,507350,Daly; Alan J.,16,0,16,0
1713489777673,EDS 286,A00,507359,Fine; Sarah,18,0,18,0
1713489778703,EDS 289C,A01,507361,Daly; Alan J.,18,0,18,0
1713489779728,EDS 290,A00,507366,Hofstetter; Carolyn,15,0,15,0
1713489780757,LIGM 5A,A00,507421,Fischer-Grunski; Eva K,20,0,20,0
1713489781787,LIGM 5B,A00,507423,Fischer-Grunski; Eva K,20,0,20,0
1713489782815,LIGM 5C,A00,507425,Fischer-Grunski; Eva K,20,0,20,0
1713489783840,LIIT 5AS,A00,507427,Carnelos; Chiara,20,0,20,0
1713489784866,LIIT 5BS,A00,507430,Carnelos; Chiara,20,0,20,0
1713489785896,LIIT 5CS,A00,507432,Carnelos; Chiara,20,0,20,0
1713489786926,LISP 5A,A00,507541,Munoz Sanchez; Alicia,14,0,20,6
1713489787952,LISP 5B,A00,507671,Munoz Sanchez; Alicia,12,0,20,8
1713489788980,LISP 5C,A00,507696,Munoz Sanchez; Alicia,11,0,20,9
1713489790009,MAE 197,001,528363,Boechler; Nicholas Sebastia,9998,0,9999,1
1713489791033,MATH 197,001,523477,Kedlaya; Kiran S.,9999,0,9999,0
1713489791033,MATH 197,002,563811,Zhang; Danna,9998,0,9999,1
1713489792058,MCWP 40R,A00,518780,Staff,15,0,20,5
1713489792058,MCWP 40R,B00,518781,Staff,14,0,20,6
1713489792058,MCWP 40R,C00,518783,Staff,10,0,20,10
1713489793085,MCWP 50R,A00,518791,Staff,8,0,20,12
1713489793085,MCWP 50R,B00,518792,Staff,5,0,20,15
1713489793085,MCWP 50R,C00,518793,Staff,7,0,20,13
1713489793085,MCWP 50R,D00,518794,Staff,0,0,20,20
1713489793085,MCWP 50R,E00,518795,Staff,1,0,20,19
1713489793085,MCWP 50R,F00,518796,Staff,13,0,20,7
1713489793085,MCWP 50R,G00,518797,Staff,11,0,20,9
1713489794113,MMW 12R,A01,514034,Herbst; Matthew,5,0,16,11
1713489794113,MMW 12R,A02,514035,Herbst; Matthew,13,0,16,3
1713489795138,MMW 13R,A01,514037,Staff,0,5,16,16
1713489795138,MMW 13R,A02,514039,Staff,0,4,16,16
1713489797187,SIO 295LS,A00,523233,Staff,15,0,30,15
1713489798215,SIO 295S,A00,523232,Staff,15,0,30,15
1713489799240,SOCI 117,A01,494376,Staff,0,2,5,5
1713489800265,WES 237B,A00,494380,Staff,19,0,20,1
1713489802335,AESE 279B,A00,494370,Wade; Jon P,33,0,33,0
1713489803364,AIP 197,001,627712,Vespa; Emanuel Ignacio,9999,0,9999,0
1713489804390,ANAR 135S,A00,494369,Braswell; Geoffrey E.,0,0,0,0
1713489805414,CAT 124RS,A01,519847,Geibel; William,6,0,20,14
1713489806443,CAT 125RS,A01,515971,Geibel; William,6,0,20,14
1713489807469,CLRE 250,A00,511389,Morris; Sheldon,9996,0,9999,3
1713489808497,CLRE 251,A00,507176,Mehta; Ravindra L.,9996,0,9999,3
1713489808497,CLRE 251,B00,511410,Mehta; Ravindra L.,9998,0,9999,1
1713489809525,CLRE 252,A00,507189,Cuomo; Raphael Eduardo,9998,0,9999,1
1713489810551,CLRE 253,A00,507199,Vaida; Florin,9997,0,9999,2
1713489810551,CLRE 253,B00,507202,Vaida; Florin,9999,0,9999,0
1713489811575,CLRE 259,A00,507211,Patel; Hemal,9996,0,9999,3
1713489812601,CLRE 260,A00,507221,Cuomo; Raphael Eduardo,9999,0,9999,0
1713489813625,CLRE 297,001,507242,Cuomo; Raphael Eduardo,9999,0,9999,0
1713489814649,CSE 191,A00,516875,Minnes Kemp; Mor Mia,9999,0,9999,0
1713489815675,CSS 201S,A01,494383,Staff,35,0,35,0
1713489816704,CSS 202S,A01,494387,Staff,35,0,35,0
1713489817731,EAP 100,A00,516065,Staff,9792,0,9999,207
1713489818757,ECE 45,A01,507414,Staff,38,0,60,22
1713489819787,ECE 100,A01,507416,Baghdadchi; Saharnaz,0,0,20,20
1713489819787,ECE 100,A02,507418,Baghdadchi; Saharnaz,19,0,20,1
1713489820815,ECE 111,A01,507420,Staff,27,0,50,23
1713489821841,ECE 197,001,548057,Sievenpiper; Daniel F.,9998,0,9999,1
1713489822870,EDS 115,A00,507243,Choi; Bailey Miyeon,27,0,28,1
1713489823895,EDS 117,A01,494379,Staff,16,0,25,9
1713489824924,EDS 125,A00,507246,Hopkins; Megan Beth,27,0,30,3
1713489825951,EDS 128A,A01,507264,Fargason; Sharon Gayle,26,0,26,0
1713489826976,EDS 128B,A01,507293,Pappas; Elizabeth,30,0,30,0
1713489828000,EDS 139,A00,507294,Fargason; Sharon Gayle,30,0,30,0
1713489828000,EDS 139,B00,507313,Pappas; Elizabeth,30,0,30,0
1713489829024,EDS 201,A00,507315,Staff,18,0,30,12
1713489830055,EDS 203,A01,507317,Halter; Christopher P.,17,0,30,13
1713489831081,EDS 204R,A01,507319,Halter; Christopher P.,0,1,30,30
1713489831081,EDS 204R,B01,507331,Heinzman; Erica M.,23,0,30,7
1713489832115,EDS 206R,A00,507332,Staff,0,2,30,30
1713489832115,EDS 206R,B00,507343,Staff,24,0,30,6
1713489833139,EDS 250,A00,507344,Hemans; Patricia Ann Benitez,27,0,40,13
1713489834164,EDS 281,A00,507345,Daly; Alan J.,18,0,18,0
1713489835190,EDS 284,A00,507350,Daly; Alan J.,16,0,16,0
1713489836217,EDS 286,A00,507359,Fine; Sarah,18,0,18,0
1713489837240,EDS 289C,A01,507361,Daly; Alan J.,18,0,18,0
1713489838269,EDS 290,A00,507366,Hofstetter; Carolyn,15,0,15,0
1713489839294,LIGM 5A,A00,507421,Fischer-Grunski; Eva K,20,0,20,0
1713489840319,LIGM 5B,A00,507423,Fischer-Grunski; Eva K,20,0,20,0
1713489841344,LIGM 5C,A00,507425,Fischer-Grunski; Eva K,20,0,20,0
1713489842369,LIIT 5AS,A00,507427,Carnelos; Chiara,20,0,20,0
1713489843405,LIIT 5BS,A00,507430,Carnelos; Chiara,20,0,20,0
1713489844430,LIIT 5CS,A00,507432,Carnelos; Chiara,20,0,20,0
1713489845459,LISP 5A,A00,507541,Munoz Sanchez; Alicia,14,0,20,6
1713489846491,LISP 5B,A00,507671,Munoz Sanchez; Alicia,12,0,20,8
1713489847516,LISP 5C,A00,507696,Munoz Sanchez; Alicia,11,0,20,9
1713489848545,MAE 197,001,528363,Boechler; Nicholas Sebastia,9998,0,9999,1
1713489849570,MATH 197,001,523477,Kedlaya; Kiran S.,9999,0,9999,0
1713489849570,MATH 197,002,563811,Zhang; Danna,9998,0,9999,1
1713489850594,MCWP 40R,A00,518780,Staff,15,0,20,5
1713489850594,MCWP 40R,B00,518781,Staff,14,0,20,6
1713489850594,MCWP 40R,C00,518783,Staff,10,0,20,10
1713489851623,MCWP 50R,A00,518791,Staff,8,0,20,12
1713489851623,MCWP 50R,B00,518792,Staff,5,0,20,15
1713489851623,MCWP 50R,C00,518793,Staff,7,0,20,13
1713489851623,MCWP 50R,D00,518794,Staff,0,0,20,20
1713489851623,MCWP 50R,E00,518795,Staff,1,0,20,19
1713489851623,MCWP 50R,F00,518796,Staff,13,0,20,7
1713489851623,MCWP 50R,G00,518797,Staff,11,0,20,9
1713489852648,MMW 12R,A01,514034,Herbst; Matthew,5,0,16,11
1713489852648,MMW 12R,A02,514035,Herbst; Matthew,13,0,16,3
1713489853675,MMW 13R,A01,514037,Staff,0,5,16,16
1713489853675,MMW 13R,A02,514039,Staff,0,4,16,16
1713489855727,SIO 295LS,A00,523233,Staff,15,0,30,15
1713489856754,SIO 295S,A00,523232,Staff,15,0,30,15
1713489857778,SOCI 117,A01,494376,Staff,0,2,5,5
1713489858806,WES 237B,A00,494380,Staff,19,0,20,1
1713489860877,AESE 279B,A00,494370,Wade; Jon P,33,0,33,0
1713489861903,AIP 197,001,627712,Vespa; Emanuel Ignacio,9999,0,9999,0
1713489862928,ANAR 135S,A00,494369,Braswell; Geoffrey E.,0,0,0,0
1713489863956,CAT 124RS,A01,519847,Geibel; William,6,0,20,14
1713489864981,CAT 125RS,A01,515971,Geibel; William,6,0,20,14
1713489866059,CLRE 250,A00,511389,Morris; Sheldon,9996,0,9999,3
1713489867085,CLRE 251,A00,507176,Mehta; Ravindra L.,9996,0,9999,3
1713489867085,CLRE 251,B00,511410,Mehta; Ravindra L.,9998,0,9999,1
1713489868112,CLRE 252,A00,507189,Cuomo; Raphael Eduardo,9998,0,9999,1
1713489869144,CLRE 253,A00,507199,Vaida; Florin,9997,0,9999,2
1713489869144,CLRE 253,B00,507202,Vaida; Florin,9999,0,9999,0
1713489870171,CLRE 259,A00,507211,Patel; Hemal,9996,0,9999,3
1713489871196,CLRE 260,A00,507221,Cuomo; Raphael Eduardo,9999,0,9999,0
1713489872221,CLRE 297,001,507242,Cuomo; Raphael Eduardo,9999,0,9999,0
1713489873249,CSE 191,A00,516875,Minnes Kemp; Mor Mia,9999,0,9999,0
1713489874278,CSS 201S,A01,494383,Staff,35,0,35,0
1713489875302,CSS 202S,A01,494387,Staff,35,0,35,0
1713489876326,EAP 100,A00,516065,Staff,9792,0,9999,207
1713489877352,ECE 45,A01,507414,Staff,38,0,60,22
1713489878379,ECE 100,A01,507416,Baghdadchi; Saharnaz,0,0,20,20
1713489878379,ECE 100,A02,507418,Baghdadchi; Saharnaz,19,0,20,1
1713489879405,ECE 111,A01,507420,Staff,27,0,50,23
1713489880430,ECE 197,001,548057,Sievenpiper; Daniel F.,9998,0,9999,1
1713489881459,EDS 115,A00,507243,Choi; Bailey Miyeon,27,0,28,1
1713489882483,EDS 117,A01,494379,Staff,16,0,25,9
1713489883512,EDS 125,A00,507246,Hopkins; Megan Beth,27,0,30,3
1713489884541,EDS 128A,A01,507264,Fargason; Sharon Gayle,26,0,26,0
1713489885567,EDS 128B,A01,507293,Pappas; Elizabeth,30,0,30,0
1713489886593,EDS 139,A00,507294,Fargason; Sharon Gayle,30,0,30,0
1713489886593,EDS 139,B00,507313,Pappas; Elizabeth,30,0,30,0
1713489887620,EDS 201,A00,507315,Staff,18,0,30,12
1713489888649,EDS 203,A01,507317,Halter; Christopher P.,17,0,30,13
1713489889677,EDS 204R,A01,507319,Halter; Christopher P.,0,1,30,30
1713489889677,EDS 204R,B01,507331,Heinzman; Erica M.,23,0,30,7
1713489890705,EDS 206R,A00,507332,Staff,0,2,30,30
1713489890705,EDS 206R,B00,507343,Staff,24,0,30,6
1713489891731,EDS 250,A00,507344,Hemans; Patricia Ann Benitez,27,0,40,13
1713489892760,EDS 281,A00,507345,Daly; Alan J.,18,0,18,0
1713489893788,EDS 284,A00,507350,Daly; Alan J.,16,0,16,0
1713489894812,EDS 286,A00,507359,Fine; Sarah,18,0,18,0
1713489895837,EDS 289C,A01,507361,Daly; Alan J.,18,0,18,0
1713489896862,EDS 290,A00,507366,Hofstetter; Carolyn,15,0,15,0
1713489897892,LIGM 5A,A00,507421,Fischer-Grunski; Eva K,20,0,20,0
1713489898922,LIGM 5B,A00,507423,Fischer-Grunski; Eva K,20,0,20,0
1713489899952,LIGM 5C,A00,507425,Fischer-Grunski; Eva K,20,0,20,0
1713489900984,LIIT 5AS,A00,507427,Carnelos; Chiara,20,0,20,0
1713489902012,LIIT 5BS,A00,507430,Carnelos; Chiara,20,0,20,0
1713489903037,LIIT 5CS,A00,507432,Carnelos; Chiara,20,0,20,0
1713489904062,LISP 5A,A00,507541,Munoz Sanchez; Alicia,14,0,20,6
1713489905088,LISP 5B,A00,507671,Munoz Sanchez; Alicia,12,0,20,8
1713489906117,LISP 5C,A00,507696,Munoz Sanchez; Alicia,11,0,20,9
1713489907142,MAE 197,001,528363,Boechler; Nicholas Sebastia,9998,0,9999,1
1713489908167,MATH 197,001,523477,Kedlaya; Kiran S.,9999,0,9999,0
1713489908167,MATH 197,002,563811,Zhang; Danna,9998,0,9999,1
1713489909190,MCWP 40R,A00,518780,Staff,15,0,20,5
1713489909190,MCWP 40R,B00,518781,Staff,14,0,20,6
1713489909190,MCWP 40R,C00,518783,Staff,10,0,20,10
1713489910215,MCWP 50R,A00,518791,Staff,8,0,20,12
1713489910215,MCWP 50R,B00,518792,Staff,5,0,20,15
1713489910215,MCWP 50R,C00,518793,Staff,7,0,20,13
1713489910215,MCWP 50R,D00,518794,Staff,0,0,20,20
1713489910215,MCWP 50R,E00,518795,Staff,1,0,20,19
1713489910215,MCWP 50R,F00,518796,Staff,13,0,20,7
1713489910215,MCWP 50R,G00,518797,Staff,11,0,20,9
1713489911239,MMW 12R,A01,514034,Herbst; Matthew,5,0,16,11
1713489911239,MMW 12R,A02,514035,Herbst; Matthew,13,0,16,3
1713489912267,MMW 13R,A01,514037,Staff,0,5,16,16
1713489912267,MMW 13R,A02,514039,Staff,0,4,16,16
1713489914319,SIO 295LS,A00,523233,Staff,15,0,30,15
1713489915345,SIO 295S,A00,523232,Staff,15,0,30,15
1713489916372,SOCI 117,A01,494376,Staff,0,2,5,5
1713489917400,WES 237B,A00,494380,Staff,19,0,20,1
1713489919461,AESE 279B,A00,494370,Wade; Jon P,33,0,33,0
1713489920485,AIP 197,001,627712,Vespa; Emanuel Ignacio,9999,0,9999,0
1713489921510,ANAR 135S,A00,494369,Braswell; Geoffrey E.,0,0,0,0
1713489922535,CAT 124RS,A01,519847,Geibel; William,6,0,20,14
1713489923564,CAT 125RS,A01,515971,Geibel; William,6,0,20,14
1713489924592,CLRE 250,A00,511389,Morris; Sheldon,9996,0,9999,3
1713489925617,CLRE 251,A00,507176,Mehta; Ravindra L.,9996,0,9999,3
1713489925617,CLRE 251,B00,511410,Mehta; Ravindra L.,9998,0,9999,1
1713489926645,CLRE 252,A00,507189,Cuomo; Raphael Eduardo,9998,0,9999,1
1713489927676,CLRE 253,A00,507199,Vaida; Florin,9997,0,9999,2
1713489927676,CLRE 253,B00,507202,Vaida; Florin,9999,0,9999,0
1713489928701,CLRE 259,A00,507211,Patel; Hemal,9996,0,9999,3
1713489929729,CLRE 260,A00,507221,Cuomo; Raphael Eduardo,9999,0,9999,0
1713489930755,CLRE 297,001,507242,Cuomo; Raphael Eduardo,9999,0,9999,0
1713489931784,CSE 191,A00,516875,Minnes Kemp; Mor Mia,9999,0,9999,0
1713489932813,CSS 201S,A01,494383,Staff,35,0,35,0
1713489933837,CSS 202S,A01,494387,Staff,35,0,35,0
1713489934862,EAP 100,A00,516065,Staff,9792,0,9999,207
1713489935888,ECE 45,A01,507414,Staff,38,0,60,22
1713489936913,ECE 100,A01,507416,Baghdadchi; Saharnaz,0,0,20,20
1713489936913,ECE 100,A02,507418,Baghdadchi; Saharnaz,19,0,20,1
1713489937942,ECE 111,A01,507420,Staff,27,0,50,23
1713489938967,ECE 197,001,548057,Sievenpiper; Daniel F.,9998,0,9999,1
1713489939993,EDS 115,A00,507243,Choi; Bailey Miyeon,27,0,28,1
1713489941018,EDS 117,A01,494379,Staff,16,0,25,9
1713489942043,EDS 125,A00,507246,Hopkins; Megan Beth,27,0,30,3
1713489943067,EDS 128A,A01,507264,Fargason; Sharon Gayle,26,0,26,0
1713489944093,EDS 128B,A01,507293,Pappas; Elizabeth,30,0,30,0
1713489945118,EDS 139,A00,507294,Fargason; Sharon Gayle,30,0,30,0
1713489945118,EDS 139,B00,507313,Pappas; Elizabeth,30,0,30,0
1713489946146,EDS 201,A00,507315,Staff,18,0,30,12
1713489947172,EDS 203,A01,507317,Halter; Christopher P.,17,0,30,13
1713489948197,EDS 204R,A01,507319,Halter; Christopher P.,0,1,30,30
1713489948197,EDS 204R,B01,507331,Heinzman; Erica M.,23,0,30,7
1713489949227,EDS 206R,A00,507332,Staff,0,2,30,30
1713489949227,EDS 206R,B00,507343,Staff,24,0,30,6
1713489950255,EDS 250,A00,507344,Hemans; Patricia Ann Benitez,27,0,40,13
1713489951281,EDS 281,A00,507345,Daly; Alan J.,18,0,18,0
1713489952309,EDS 284,A00,507350,Daly; Alan J.,16,0,16,0
1713489953334,EDS 286,A00,507359,Fine; Sarah,18,0,18,0
1713489954359,EDS 289C,A01,507361,Daly; Alan J.,18,0,18,0
1713489955383,EDS 290,A00,507366,Hofstetter; Carolyn,15,0,15,0
1713489956409,LIGM 5A,A00,507421,Fischer-Grunski; Eva K,20,0,20,0
1713489957435,LIGM 5B,A00,507423,Fischer-Grunski; Eva K,20,0,20,0
1713489958464,LIGM 5C,A00,507425,Fischer-Grunski; Eva K,20,0,20,0
1713489959493,LIIT 5AS,A00,507427,Carnelos; Chiara,20,0,20,0
1713489960519,LIIT 5BS,A00,507430,Carnelos; Chiara,20,0,20,0
1713489961542,LIIT 5CS,A00,507432,Carnelos; Chiara,20,0,20,0
1713489962567,LISP 5A,A00,507541,Munoz Sanchez; Alicia,14,0,20,6
1713489963592,LISP 5B,A00,507671,Munoz Sanchez; Alicia,12,0,20,8
1713489964621,LISP 5C,A00,507696,Munoz Sanchez; Alicia,11,0,20,9
1713489965649,MAE 197,001,528363,Boechler; Nicholas Sebastia,9998,0,9999,1
1713489966677,MATH 197,001,523477,Kedlaya; Kiran S.,9999,0,9999,0
1713489966677,MATH 197,002,563811,Zhang; Danna,9998,0,9999,1
1713489967701,MCWP 40R,A00,518780,Staff,15,0,20,5
1713489967701,MCWP 40R,B00,518781,Staff,14,0,20,6
1713489967701,MCWP 40R,C00,518783,Staff,10,0,20,10
1713489968728,MCWP 50R,A00,518791,Staff,8,0,20,12
1713489968728,MCWP 50R,B00,518792,Staff,4,0,20,16
1713489968728,MCWP 50R,C00,518793,Staff,7,0,20,13
1713489968728,MCWP 50R,D00,518794,Staff,0,0,20,20
1713489968728,MCWP 50R,E00,518795,Staff,1,0,20,19
1713489968728,MCWP 50R,F00,518796,Staff,13,0,20,7
1713489968728,MCWP 50R,G00,518797,Staff,11,0,20,9
1713489969807,MMW 12R,A01,514034,Herbst; Matthew,5,0,16,11
1713489969807,MMW 12R,A02,514035,Herbst; Matthew,13,0,16,3
1713489970832,MMW 13R,A01,514037,Staff,0,5,16,16
1713489970832,MMW 13R,A02,514039,Staff,0,4,16,16
1713489972883,SIO 295LS,A00,523233,Staff,15,0,30,15
1713489973910,SIO 295S,A00,523232,Staff,15,0,30,15
1713489974936,SOCI 117,A01,494376,Staff,0,2,5,5
1713489975961,WES 237B,A00,494380,Staff,19,0,20,1
1713489978019,AESE 279B,A00,494370,Wade; Jon P,33,0,33,0
1713489979044,AIP 197,001,627712,Vespa; Emanuel Ignacio,9999,0,9999,0
1713489980072,ANAR 135S,A00,494369,Braswell; Geoffrey E.,0,0,0,0
1713489981101,CAT 124RS,A01,519847,Geibel; William,6,0,20,14
1713489982125,CAT 125RS,A01,515971,Geibel; William,6,0,20,14
1713489983154,CLRE 250,A00,511389,Morris; Sheldon,9996,0,9999,3
1713489984183,CLRE 251,A00,507176,Mehta; Ravindra L.,9996,0,9999,3
1713489984183,CLRE 251,B00,511410,Mehta; Ravindra L.,9998,0,9999,1
1713489985210,CLRE 252,A00,507189,Cuomo; Raphael Eduardo,9998,0,9999,1
1713489986240,CLRE 253,A00,507199,Vaida; Florin,9997,0,9999,2
1713489986240,CLRE 253,B00,507202,Vaida; Florin,9999,0,9999,0
1713489987269,CLRE 259,A00,507211,Patel; Hemal,9996,0,9999,3
1713489988295,CLRE 260,A00,507221,Cuomo; Raphael Eduardo,9999,0,9999,0
1713489989323,CLRE 297,001,507242,Cuomo; Raphael Eduardo,9999,0,9999,0
1713489990350,CSE 191,A00,516875,Minnes Kemp; Mor Mia,9999,0,9999,0
1713489991375,CSS 201S,A01,494383,Staff,35,0,35,0
1713489992400,CSS 202S,A01,494387,Staff,35,0,35,0
1713489993426,EAP 100,A00,516065,Staff,9792,0,9999,207
1713489994451,ECE 45,A01,507414,Staff,38,0,60,22
1713489995476,ECE 100,A01,507416,Baghdadchi; Saharnaz,0,0,20,20
1713489995476,ECE 100,A02,507418,Baghdadchi; Saharnaz,19,0,20,1
1713489996504,ECE 111,A01,507420,Staff,27,0,50,23
1713489997528,ECE 197,001,548057,Sievenpiper; Daniel F.,9998,0,9999,1
1713489998557,EDS 115,A00,507243,Choi; Bailey Miyeon,27,0,28,1
1713489999586,EDS 117,A01,494379,Staff,16,0,25,9
1713490000615,EDS 125,A00,507246,Hopkins; Megan Beth,27,0,30,3
1713490001641,EDS 128A,A01,507264,Fargason; Sharon Gayle,26,0,26,0
1713490002666,EDS 128B,A01,507293,Pappas; Elizabeth,30,0,30,0
1713490003694,EDS 139,A00,507294,Fargason; Sharon Gayle,30,0,30,0
1713490003694,EDS 139,B00,507313,Pappas; Elizabeth,30,0,30,0
1713490004720,EDS 201,A00,507315,Staff,18,0,30,12
1713490005746,EDS 203,A01,507317,Halter; Christopher P.,17,0,30,13
1713490006771,EDS 204R,A01,507319,Halter; Christopher P.,0,1,30,30
1713490006771,EDS 204R,B01,507331,Heinzman; Erica M.,22,0,30,8
1713490007796,EDS 206R,A00,507332,Staff,0,2,30,30
1713490007796,EDS 206R,B00,507343,Staff,24,0,30,6
1713490008824,EDS 250,A00,507344,Hemans; Patricia Ann Benitez,27,0,40,13
1713490009853,EDS 281,A00,507345,Daly; Alan J.,18,0,18,0
1713490010877,EDS 284,A00,507350,Daly; Alan J.,16,0,16,0
1713490011906,EDS 286,A00,507359,Fine; Sarah,18,0,18,0
1713490012935,EDS 289C,A01,507361,Daly; Alan J.,18,0,18,0
1713490013959,EDS 290,A00,507366,Hofstetter; Carolyn,15,0,15,0
1713490014989,LIGM 5A,A00,507421,Fischer-Grunski; Eva K,20,0,20,0
1713490016015,LIGM 5B,A00,507423,Fischer-Grunski; Eva K,20,0,20,0
1713490017041,LIGM 5C,A00,507425,Fischer-Grunski; Eva K,20,0,20,0
1713490018066,LIIT 5AS,A00,507427,Carnelos; Chiara,20,0,20,0
1713490019095,LIIT 5BS,A00,507430,Carnelos; Chiara,20,0,20,0
1713490020120,LIIT 5CS,A00,507432,Carnelos; Chiara,20,0,20,0
1713490021150,LISP 5A,A00,507541,Munoz Sanchez; Alicia,14,0,20,6
1713490022176,LISP 5B,A00,507671,Munoz Sanchez; Alicia,12,0,20,8
1713490023202,LISP 5C,A00,507696,Munoz Sanchez; Alicia,11,0,20,9
1713490024227,MAE 197,001,528363,Boechler; Nicholas Sebastia,9998,0,9999,1
1713490025256,MATH 197,001,523477,Kedlaya; Kiran S.,9999,0,9999,0
1713490025256,MATH 197,002,563811,Zhang; Danna,9998,0,9999,1
1713490026284,MCWP 40R,A00,518780,Staff,15,0,20,5
1713490026284,MCWP 40R,B00,518781,Staff,14,0,20,6
1713490026284,MCWP 40R,C00,518783,Staff,10,0,20,10
1713490027312,MCWP 50R,A00,518791,Staff,8,0,20,12
1713490027312,MCWP 50R,B00,518792,Staff,4,0,20,16
1713490027312,MCWP 50R,C00,518793,Staff,7,0,20,13
1713490027312,MCWP 50R,D00,518794,Staff,0,0,20,20
1713490027312,MCWP 50R,E00,518795,Staff,1,0,20,19
1713490027312,MCWP 50R,F00,518796,Staff,13,0,20,7
1713490027312,MCWP 50R,G00,518797,Staff,11,0,20,9
1713490028341,MMW 12R,A01,514034,Herbst; Matthew,5,0,16,11
1713490028341,MMW 12R,A02,514035,Herbst; Matthew,13,0,16,3
1713490029370,MMW 13R,A01,514037,Staff,0,5,16,16
1713490029370,MMW 13R,A02,514039,Staff,0,4,16,16
1713490031421,SIO 295LS,A00,523233,Staff,15,0,30,15
1713490032446,SIO 295S,A00,523232,Staff,15,0,30,15
1713490033473,SOCI 117,A01,494376,Staff,0,2,5,5
1713490034497,WES 237B,A00,494380,Staff,19,0,20,1
1713490036559,AESE 279B,A00,494370,Wade; Jon P,33,0,33,0
1713490037588,AIP 197,001,627712,Vespa; Emanuel Ignacio,9999,0,9999,0
1713490038611,ANAR 135S,A00,494369,Braswell; Geoffrey E.,0,0,0,0
1713490039636,CAT 124RS,A01,519847,Geibel; William,6,0,20,14
1713490040661,CAT 125RS,A01,515971,Geibel; William,6,0,20,14
1713490041690,CLRE 250,A00,511389,Morris; Sheldon,9996,0,9999,3
1713490042720,CLRE 251,A00,507176,Mehta; Ravindra L.,9996,0,9999,3
1713490042720,CLRE 251,B00,511410,Mehta; Ravindra L.,9998,0,9999,1
1713490043744,CLRE 252,A00,507189,Cuomo; Raphael Eduardo,9998,0,9999,1
1713490044769,CLRE 253,A00,507199,Vaida; Florin,9997,0,9999,2
1713490044769,CLRE 253,B00,507202,Vaida; Florin,9999,0,9999,0
1713490045795,CLRE 259,A00,507211,Patel; Hemal,9996,0,9999,3
1713490046823,CLRE 260,A00,507221,Cuomo; Raphael Eduardo,9999,0,9999,0
1713490047851,CLRE 297,001,507242,Cuomo; Raphael Eduardo,9999,0,9999,0
1713490048876,CSE 191,A00,516875,Minnes Kemp; Mor Mia,9999,0,9999,0
1713490049907,CSS 201S,A01,494383,Staff,35,0,35,0
1713490050932,CSS 202S,A01,494387,Staff,35,0,35,0
1713490051957,EAP 100,A00,516065,Staff,9792,0,9999,207
1713490052983,ECE 45,A01,507414,Staff,38,0,60,22
1713490054008,ECE 100,A01,507416,Baghdadchi; Saharnaz,0,0,20,20
1713490054008,ECE 100,A02,507418,Baghdadchi; Saharnaz,19,0,20,1
1713490055038,ECE 111,A01,507420,Staff,27,0,50,23
1713490056063,ECE 197,001,548057,Sievenpiper; Daniel F.,9998,0,9999,1
1713490057094,EDS 115,A00,507243,Choi; Bailey Miyeon,27,0,28,1
1713490058119,EDS 117,A01,494379,Staff,16,0,25,9
1713490059148,EDS 125,A00,507246,Hopkins; Megan Beth,27,0,30,3
1713490060173,EDS 128A,A01,507264,Fargason; Sharon Gayle,26,0,26,0
1713490061198,EDS 128B,A01,507293,Pappas; Elizabeth,30,0,30,0
1713490062222,EDS 139,A00,507294,Fargason; Sharon Gayle,30,0,30,0
1713490062222,EDS 139,B00,507313,Pappas; Elizabeth,30,0,30,0
1713490063246,EDS 201,A00,507315,Staff,18,0,30,12
1713490064275,EDS 203,A01,507317,Halter; Christopher P.,17,0,30,13
1713490065297,EDS 204R,A01,507319,Halter; Christopher P.,0,1,30,30
1713490065297,EDS 204R,B01,507331,Heinzman; Erica M.,22,0,30,8
1713490066322,EDS 206R,A00,507332,Staff,0,2,30,30
1713490066322,EDS 206R,B00,507343,Staff,23,0,30,7
1713490067351,EDS 250,A00,507344,Hemans; Patricia Ann Benitez,27,0,40,13
1713490068376,EDS 281,A00,507345,Daly; Alan J.,18,0,18,0
1713490069401,EDS 284,A00,507350,Daly; Alan J.,16,0,16,0
1713490070426,EDS 286,A00,507359,Fine; Sarah,18,0,18,0
1713490071456,EDS 289C,A01,507361,Daly; Alan J.,18,0,18,0
1713490072480,EDS 290,A00,507366,Hofstetter; Carolyn,15,0,15,0
1713490073565,LIGM 5A,A00,507421,Fischer-Grunski; Eva K,20,0,20,0
1713490074627,LIGM 5B,A00,507423,Fischer-Grunski; Eva K,20,0,20,0
1713490075652,LIGM 5C,A00,507425,Fischer-Grunski; Eva K,20,0,20,0
1713490076681,LIIT 5AS,A00,507427,Carnelos; Chiara,20,0,20,0
1713490077710,LIIT 5BS,A00,507430,Carnelos; Chiara,20,0,20,0
1713490078740,LIIT 5CS,A00,507432,Carnelos; Chiara,20,0,20,0
1713490079769,LISP 5A,A00,507541,Munoz Sanchez; Alicia,14,0,20,6
1713490080807,LISP 5B,A00,507671,Munoz Sanchez; Alicia,12,0,20,8
1713490081836,LISP 5C,A00,507696,Munoz Sanchez; Alicia,11,0,20,9
1713490082864,MAE 197,001,528363,Boechler; Nicholas Sebastia,9998,0,9999,1
1713490083891,MATH 197,001,523477,Kedlaya; Kiran S.,9999,0,9999,0
1713490083891,MATH 197,002,563811,Zhang; Danna,9998,0,9999,1
1713490084916,MCWP 40R,A00,518780,Staff,15,0,20,5
1713490084916,MCWP 40R,B00,518781,Staff,14,0,20,6
1713490084916,MCWP 40R,C00,518783,Staff,10,0,20,10
1713490085941,MCWP 50R,A00,518791,Staff,8,0,20,12
1713490085941,MCWP 50R,B00,518792,Staff,4,0,20,16
1713490085941,MCWP 50R,C00,518793,Staff,7,0,20,13
1713490085941,MCWP 50R,D00,518794,Staff,0,0,20,20
1713490085941,MCWP 50R,E00,518795,Staff,1,0,20,19
1713490085941,MCWP 50R,F00,518796,Staff,13,0,20,7
1713490085941,MCWP 50R,G00,518797,Staff,11,0,20,9
1713490086967,MMW 12R,A01,514034,Herbst; Matthew,5,0,16,11
1713490086967,MMW 12R,A02,514035,Herbst; Matthew,13,0,16,3
1713490087992,MMW 13R,A01,514037,Staff,0,5,16,16
1713490087992,MMW 13R,A02,514039,Staff,0,4,16,16
1713490090042,SIO 295LS,A00,523233,Staff,15,0,30,15
1713490091067,SIO 295S,A00,523232,Staff,15,0,30,15
1713490092095,SOCI 117,A01,494376,Staff,0,2,5,5
1713490093122,WES 237B,A00,494380,Staff,19,0,20,1
1713490095198,AESE 279B,A00,494370,Wade; Jon P,33,0,33,0
1713490096226,AIP 197,001,627712,Vespa; Emanuel Ignacio,9999,0,9999,0
1713490097253,ANAR 135S,A00,494369,Braswell; Geoffrey E.,0,0,0,0
1713490098281,CAT 124RS,A01,519847,Geibel; William,6,0,20,14
1713490099305,CAT 125RS,A01,515971,Geibel; William,6,0,20,14
1713490100333,CLRE 250,A00,511389,Morris; Sheldon,9996,0,9999,3
1713490101363,CLRE 251,A00,507176,Mehta; Ravindra L.,9996,0,9999,3
1713490101363,CLRE 251,B00,511410,Mehta; Ravindra L.,9998,0,9999,1
1713490102388,CLRE 252,A00,507189,Cuomo; Raphael Eduardo,9998,0,9999,1
1713490103414,CLRE 253,A00,507199,Vaida; Florin,9997,0,9999,2
1713490103414,CLRE 253,B00,507202,Vaida; Florin,9999,0,9999,0
1713490104443,CLRE 259,A00,507211,Patel; Hemal,9996,0,9999,3
1713490105468,CLRE 260,A00,507221,Cuomo; Raphael Eduardo,9999,0,9999,0
1713490106493,CLRE 297,001,507242,Cuomo; Raphael Eduardo,9999,0,9999,0
1713490107517,CSE 191,A00,516875,Minnes Kemp; Mor Mia,9999,0,9999,0
1713490108542,CSS 201S,A01,494383,Staff,35,0,35,0
1713490109571,CSS 202S,A01,494387,Staff,35,0,35,0
1713490110599,EAP 100,A00,516065,Staff,9792,0,9999,207
1713490111624,ECE 45,A01,507414,Staff,38,0,60,22
1713490112650,ECE 100,A01,507416,Baghdadchi; Saharnaz,0,0,20,20
1713490112650,ECE 100,A02,507418,Baghdadchi; Saharnaz,19,0,20,1
1713490113675,ECE 111,A01,507420,Staff,27,0,50,23
1713490114704,ECE 197,001,548057,Sievenpiper; Daniel F.,9998,0,9999,1
1713490115732,EDS 115,A00,507243,Choi; Bailey Miyeon,27,0,28,1
1713490116760,EDS 117,A01,494379,Staff,16,0,25,9
1713490117790,EDS 125,A00,507246,Hopkins; Megan Beth,27,0,30,3
1713490118820,EDS 128A,A01,507264,Fargason; Sharon Gayle,26,0,26,0
1713490119845,EDS 128B,A01,507293,Pappas; Elizabeth,30,0,30,0
1713490120870,EDS 139,A00,507294,Fargason; Sharon Gayle,30,0,30,0
1713490120870,EDS 139,B00,507313,Pappas; Elizabeth,30,0,30,0
1713490121896,EDS 201,A00,507315,Staff,18,0,30,12
1713490122921,EDS 203,A01,507317,Halter; Christopher P.,17,0,30,13
1713490123946,EDS 204R,A01,507319,Halter; Christopher P.,0,1,30,30
1713490123946,EDS 204R,B01,507331,Heinzman; Erica M.,22,0,30,8
1713490124971,EDS 206R,A00,507332,Staff,0,2,30,30
1713490124971,EDS 206R,B00,507343,Staff,23,0,30,7
1713490125997,EDS 250,A00,507344,Hemans; Patricia Ann Benitez,27,0,40,13
1713490127022,EDS 281,A00,507345,Daly; Alan J.,18,0,18,0
1713490128049,EDS 284,A00,507350,Daly; Alan J.,16,0,16,0
1713490129077,EDS 286,A00,507359,Fine; Sarah,18,0,18,0
1713490130104,EDS 289C,A01,507361,Daly; Alan J.,18,0,18,0
1713490131129,EDS 290,A00,507366,Hofstetter; Carolyn,15,0,15,0
1713490132153,LIGM 5A,A00,507421,Fischer-Grunski; Eva K,20,0,20,0
1713490133178,LIGM 5B,A00,507423,Fischer-Grunski; Eva K,20,0,20,0
1713490134207,LIGM 5C,A00,507425,Fischer-Grunski; Eva K,20,0,20,0
1713490135236,LIIT 5AS,A00,507427,Carnelos; Chiara,20,0,20,0
1713490136261,LIIT 5BS,A00,507430,Carnelos; Chiara,20,0,20,0
1713490137290,LIIT 5CS,A00,507432,Carnelos; Chiara,20,0,20,0
1713490138316,LISP 5A,A00,507541,Munoz Sanchez; Alicia,14,0,20,6
1713490139346,LISP 5B,A00,507671,Munoz Sanchez; Alicia,12,0,20,8
1713490140378,LISP 5C,A00,507696,Munoz Sanchez; Alicia,11,0,20,9
1713490141405,MAE 197,001,528363,Boechler; Nicholas Sebastia,9998,0,9999,1
1713490142434,MATH 197,001,523477,Kedlaya; Kiran S.,9999,0,9999,0
1713490142434,MATH 197,002,563811,Zhang; Danna,9998,0,9999,1
1713490143463,MCWP 40R,A00,518780,Staff,15,0,20,5
1713490143463,MCWP 40R,B00,518781,Staff,14,0,20,6
1713490143463,MCWP 40R,C00,518783,Staff,10,0,20,10
1713490144492,MCWP 50R,A00,518791,Staff,8,0,20,12
1713490144492,MCWP 50R,B00,518792,Staff,4,0,20,16
1713490144492,MCWP 50R,C00,518793,Staff,7,0,20,13
1713490144492,MCWP 50R,D00,518794,Staff,0,0,20,20
1713490144492,MCWP 50R,E00,518795,Staff,1,0,20,19
1713490144492,MCWP 50R,F00,518796,Staff,13,0,20,7
1713490144492,MCWP 50R,G00,518797,Staff,11,0,20,9
1713490145519,MMW 12R,A01,514034,Herbst; Matthew,5,0,16,11
1713490145519,MMW 12R,A02,514035,Herbst; Matthew,13,0,16,3
1713490146546,MMW 13R,A01,514037,Staff,0,5,16,16
1713490146546,MMW 13R,A02,514039,Staff,0,4,16,16
1713490148593,SIO 295LS,A00,523233,Staff,15,0,30,15
1713490149618,SIO 295S,A00,523232,Staff,15,0,30,15
1713490150643,SOCI 117,A01,494376,Staff,0,2,5,5
1713490151668,WES 237B,A00,494380,Staff,19,0,20,1
1713490153735,AESE 279B,A00,494370,Wade; Jon P,33,0,33,0
1713490154763,AIP 197,001,627712,Vespa; Emanuel Ignacio,9999,0,9999,0
1713490155789,ANAR 135S,A00,494369,Braswell; Geoffrey E.,0,0,0,0
1713490156814,CAT 124RS,A01,519847,Geibel; William,6,0,20,14
1713490157840,CAT 125RS,A01,515971,Geibel; William,6,0,20,14
1713490158868,CLRE 250,A00,511389,Morris; Sheldon,9996,0,9999,3
1713490159894,CLRE 251,A00,507176,Mehta; Ravindra L.,9996,0,9999,3
1713490159894,CLRE 251,B00,511410,Mehta; Ravindra L.,9998,0,9999,1
1713490160925,CLRE 252,A00,507189,Cuomo; Raphael Eduardo,9998,0,9999,1
1713490161950,CLRE 253,A00,507199,Vaida; Florin,9997,0,9999,2
1713490161950,CLRE 253,B00,507202,Vaida; Florin,9999,0,9999,0
1713490162975,CLRE 259,A00,507211,Patel; Hemal,9996,0,9999,3
1713490164003,CLRE 260,A00,507221,Cuomo; Raphael Eduardo,9999,0,9999,0
1713490165029,CLRE 297,001,507242,Cuomo; Raphael Eduardo,9999,0,9999,0
1713490166058,CSE 191,A00,516875,Minnes Kemp; Mor Mia,9999,0,9999,0
1713490167084,CSS 201S,A01,494383,Staff,35,0,35,0
1713490168113,CSS 202S,A01,494387,Staff,35,0,35,0
1713490169140,EAP 100,A00,516065,Staff,9792,0,9999,207
1713490170166,ECE 45,A01,507414,Staff,38,0,60,22
1713490171192,ECE 100,A01,507416,Baghdadchi; Saharnaz,0,0,20,20
1713490171192,ECE 100,A02,507418,Baghdadchi; Saharnaz,19,0,20,1
1713490172217,ECE 111,A01,507420,Staff,27,0,50,23
1713490173242,ECE 197,001,548057,Sievenpiper; Daniel F.,9998,0,9999,1
1713490174267,EDS 115,A00,507243,Choi; Bailey Miyeon,27,0,28,1
1713490175295,EDS 117,A01,494379,Staff,16,0,25,9
1713490176323,EDS 125,A00,507246,Hopkins; Megan Beth,27,0,30,3
1713490177406,EDS 128A,A01,507264,Fargason; Sharon Gayle,26,0,26,0
1713490178433,EDS 128B,A01,507293,Pappas; Elizabeth,30,0,30,0
1713490179458,EDS 139,A00,507294,Fargason; Sharon Gayle,30,0,30,0
1713490179458,EDS 139,B00,507313,Pappas; Elizabeth,30,0,30,0
1713490180482,EDS 201,A00,507315,Staff,18,0,30,12
1713490181507,EDS 203,A01,507317,Halter; Christopher P.,17,0,30,13
1713490182536,EDS 204R,A01,507319,Halter; Christopher P.,0,1,30,30
1713490182536,EDS 204R,B01,507331,Heinzman; Erica M.,22,0,30,8
1713490183565,EDS 206R,A00,507332,Staff,0,2,30,30
1713490183565,EDS 206R,B00,507343,Staff,23,0,30,7
1713490184589,EDS 250,A00,507344,Hemans; Patricia Ann Benitez,27,0,40,13
1713490185615,EDS 281,A00,507345,Daly; Alan J.,18,0,18,0
1713490186638,EDS 284,A00,507350,Daly; Alan J.,16,0,16,0
1713490187662,EDS 286,A00,507359,Fine; Sarah,18,0,18,0
1713490188688,EDS 289C,A01,507361,Daly; Alan J.,18,0,18,0
1713490189713,EDS 290,A00,507366,Hofstetter; Carolyn,15,0,15,0
1713490190740,LIGM 5A,A00,507421,Fischer-Grunski; Eva K,20,0,20,0
1713490191769,LIGM 5B,A00,507423,Fischer-Grunski; Eva K,20,0,20,0
1713490192797,LIGM 5C,A00,507425,Fischer-Grunski; Eva K,20,0,20,0
1713490193822,LIIT 5AS,A00,507427,Carnelos; Chiara,20,0,20,0
1713490194848,LIIT 5BS,A00,507430,Carnelos; Chiara,20,0,20,0
1713490195884,LIIT 5CS,A00,507432,Carnelos; Chiara,20,0,20,0
1713490196910,LISP 5A,A00,507541,Munoz Sanchez; Alicia,14,0,20,6
1713490197934,LISP 5B,A00,507671,Munoz Sanchez; Alicia,12,0,20,8
1713490198964,LISP 5C,A00,507696,Munoz Sanchez; Alicia,11,0,20,9
1713490199988,MAE 197,001,528363,Boechler; Nicholas Sebastia,9998,0,9999,1
1713490201013,MATH 197,001,523477,Kedlaya; Kiran S.,9999,0,9999,0
1713490201013,MATH 197,002,563811,Zhang; Danna,9998,0,9999,1
1713490202037,MCWP 40R,A00,518780,Staff,15,0,20,5
1713490202037,MCWP 40R,B00,518781,Staff,14,0,20,6
1713490202037,MCWP 40R,C00,518783,Staff,10,0,20,10
1713490203065,MCWP 50R,A00,518791,Staff,8,0,20,12
1713490203065,MCWP 50R,B00,518792,Staff,4,0,20,16
1713490203065,MCWP 50R,C00,518793,Staff,7,0,20,13
1713490203065,MCWP 50R,D00,518794,Staff,0,0,20,20
1713490203065,MCWP 50R,E00,518795,Staff,1,0,20,19
1713490203065,MCWP 50R,F00,518796,Staff,13,0,20,7
1713490203065,MCWP 50R,G00,518797,Staff,11,0,20,9
1713490204089,MMW 12R,A01,514034,Herbst; Matthew,5,0,16,11
1713490204089,MMW 12R,A02,514035,Herbst; Matthew,13,0,16,3
1713490205112,MMW 13R,A01,514037,Staff,0,5,16,16
1713490205112,MMW 13R,A02,514039,Staff,0,4,16,16
1713490207168,SIO 295LS,A00,523233,Staff,15,0,30,15
1713490208197,SIO 295S,A00,523232,Staff,15,0,30,15
1713490209225,SOCI 117,A01,494376,Staff,0,2,5,5
1713490210253,WES 237B,A00,494380,Staff,19,0,20,1
1713490212314,AESE 279B,A00,494370,Wade; Jon P,33,0,33,0
1713490213339,AIP 197,001,627712,Vespa; Emanuel Ignacio,9999,0,9999,0
1713490214366,ANAR 135S,A00,494369,Braswell; Geoffrey E.,0,0,0,0
1713490215393,CAT 124RS,A01,519847,Geibel; William,6,0,20,14
1713490216421,CAT 125RS,A01,515971,Geibel; William,6,0,20,14
1713490217445,CLRE 250,A00,511389,Morris; Sheldon,9996,0,9999,3
1713490218470,CLRE 251,A00,507176,Mehta; Ravindra L.,9996,0,9999,3
1713490218470,CLRE 251,B00,511410,Mehta; Ravindra L.,9998,0,9999,1
1713490219498,CLRE 252,A00,507189,Cuomo; Raphael Eduardo,9998,0,9999,1
1713490220523,CLRE 253,A00,507199,Vaida; Florin,9997,0,9999,2
1713490220523,CLRE 253,B00,507202,Vaida; Florin,9999,0,9999,0
1713490221548,CLRE 259,A00,507211,Patel; Hemal,9996,0,9999,3
1713490222572,CLRE 260,A00,507221,Cuomo; Raphael Eduardo,9999,0,9999,0
1713490223596,CLRE 297,001,507242,Cuomo; Raphael Eduardo,9999,0,9999,0
1713490224624,CSE 191,A00,516875,Minnes Kemp; Mor Mia,9999,0,9999,0
1713490225651,CSS 201S,A01,494383,Staff,35,0,35,0
1713490226680,CSS 202S,A01,494387,Staff,35,0,35,0
1713490227708,EAP 100,A00,516065,Staff,9792,0,9999,207
1713490228737,ECE 45,A01,507414,Staff,38,0,60,22
1713490229762,ECE 100,A01,507416,Baghdadchi; Saharnaz,0,0,20,20
1713490229762,ECE 100,A02,507418,Baghdadchi; Saharnaz,19,0,20,1
1713490230789,ECE 111,A01,507420,Staff,27,0,50,23
1713490231813,ECE 197,001,548057,Sievenpiper; Daniel F.,9998,0,9999,1
1713490232837,EDS 115,A00,507243,Choi; Bailey Miyeon,27,0,28,1
1713490233868,EDS 117,A01,494379,Staff,16,0,25,9
1713490234893,EDS 125,A00,507246,Hopkins; Megan Beth,27,0,30,3
1713490235923,EDS 128A,A01,507264,Fargason; Sharon Gayle,26,0,26,0
1713490236948,EDS 128B,A01,507293,Pappas; Elizabeth,30,0,30,0
1713490237975,EDS 139,A00,507294,Fargason; Sharon Gayle,30,0,30,0
1713490237975,EDS 139,B00,507313,Pappas; Elizabeth,30,0,30,0
1713490239005,EDS 201,A00,507315,Staff,18,0,30,12
1713490240089,EDS 203,A01,507317,Halter; Christopher P.,17,0,30,13
1713490241117,EDS 204R,A01,507319,Halter; Christopher P.,0,1,30,30
1713490241117,EDS 204R,B01,507331,Heinzman; Erica M.,22,0,30,8
1713490242142,EDS 206R,A00,507332,Staff,0,2,30,30
1713490242142,EDS 206R,B00,507343,Staff,23,0,30,7
1713490243167,EDS 250,A00,507344,Hemans; Patricia Ann Benitez,27,0,40,13
1713490244194,EDS 281,A00,507345,Daly; Alan J.,18,0,18,0
1713490245220,EDS 284,A00,507350,Daly; Alan J.,16,0,16,0
1713490246244,EDS 286,A00,507359,Fine; Sarah,18,0,18,0
1713490247272,EDS 289C,A01,507361,Daly; Alan J.,18,0,18,0
1713490248298,EDS 290,A00,507366,Hofstetter; Carolyn,15,0,15,0
1713490249322,LIGM 5A,A00,507421,Fischer-Grunski; Eva K,20,0,20,0
1713490250348,LIGM 5B,A00,507423,Fischer-Grunski; Eva K,20,0,20,0
1713490251376,LIGM 5C,A00,507425,Fischer-Grunski; Eva K,20,0,20,0
1713490252403,LIIT 5AS,A00,507427,Carnelos; Chiara,20,0,20,0
1713490253432,LIIT 5BS,A00,507430,Carnelos; Chiara,20,0,20,0
1713490254462,LIIT 5CS,A00,507432,Carnelos; Chiara,20,0,20,0
1713490255491,LISP 5A,A00,507541,Munoz Sanchez; Alicia,14,0,20,6
1713490256515,LISP 5B,A00,507671,Munoz Sanchez; Alicia,12,0,20,8
1713490257541,LISP 5C,A00,507696,Munoz Sanchez; Alicia,11,0,20,9
1713490258571,MAE 197,001,528363,Boechler; Nicholas Sebastia,9998,0,9999,1
1713490259596,MATH 197,001,523477,Kedlaya; Kiran S.,9999,0,9999,0
1713490259596,MATH 197,002,563811,Zhang; Danna,9998,0,9999,1
1713490260627,MCWP 40R,A00,518780,Staff,15,0,20,5
1713490260627,MCWP 40R,B00,518781,Staff,14,0,20,6
1713490260627,MCWP 40R,C00,518783,Staff,10,0,20,10
1713490261651,MCWP 50R,A00,518791,Staff,8,0,20,12
1713490261651,MCWP 50R,B00,518792,Staff,4,0,20,16
1713490261651,MCWP 50R,C00,518793,Staff,7,0,20,13
1713490261651,MCWP 50R,D00,518794,Staff,0,0,20,20
1713490261651,MCWP 50R,E00,518795,Staff,1,0,20,19
1713490261651,MCWP 50R,F00,518796,Staff,13,0,20,7
1713490261651,MCWP 50R,G00,518797,Staff,11,0,20,9
1713490262676,MMW 12R,A01,514034,Herbst; Matthew,5,0,16,11
1713490262676,MMW 12R,A02,514035,Herbst; Matthew,13,0,16,3
1713490263704,MMW 13R,A01,514037,Staff,0,5,16,16
1713490263704,MMW 13R,A02,514039,Staff,0,4,16,16
1713490265754,SIO 295LS,A00,523233,Staff,15,0,30,15
1713490266780,SIO 295S,A00,523232,Staff,15,0,30,15
1713490267808,SOCI 117,A01,494376,Staff,0,2,5,5
1713490268833,WES 237B,A00,494380,Staff,19,0,20,1
1713490270899,AESE 279B,A00,494370,Wade; Jon P,33,0,33,0
1713490271927,AIP 197,001,627712,Vespa; Emanuel Ignacio,9999,0,9999,0
1713490272957,ANAR 135S,A00,494369,Braswell; Geoffrey E.,0,0,0,0
1713490273982,CAT 124RS,A01,519847,Geibel; William,6,0,20,14
1713490275010,CAT 125RS,A01,515971,Geibel; William,6,0,20,14
1713490276036,CLRE 250,A00,511389,Morris; Sheldon,9996,0,9999,3
1713490277061,CLRE 251,A00,507176,Mehta; Ravindra L.,9996,0,9999,3
1713490277061,CLRE 251,B00,511410,Mehta; Ravindra L.,9998,0,9999,1
1713490278085,CLRE 252,A00,507189,Cuomo; Raphael Eduardo,9998,0,9999,1
1713490279109,CLRE 253,A00,507199,Vaida; Florin,9997,0,9999,2
1713490279109,CLRE 253,B00,507202,Vaida; Florin,9999,0,9999,0
1713490280134,CLRE 259,A00,507211,Patel; Hemal,9996,0,9999,3
1713490281234,CLRE 260,A00,507221,Cuomo; Raphael Eduardo,9999,0,9999,0
1713490282263,CLRE 297,001,507242,Cuomo; Raphael Eduardo,9999,0,9999,0
1713490283293,CSE 191,A00,516875,Minnes Kemp; Mor Mia,9999,0,9999,0
1713490284322,CSS 201S,A01,494383,Staff,35,0,35,0
1713490285347,CSS 202S,A01,494387,Staff,35,0,35,0
1713490286374,EAP 100,A00,516065,Staff,9792,0,9999,207
1713490287399,ECE 45,A01,507414,Staff,38,0,60,22
1713490288423,ECE 100,A01,507416,Baghdadchi; Saharnaz,0,0,20,20
1713490288423,ECE 100,A02,507418,Baghdadchi; Saharnaz,19,0,20,1
1713490289448,ECE 111,A01,507420,Staff,27,0,50,23
1713490290473,ECE 197,001,548057,Sievenpiper; Daniel F.,9998,0,9999,1
1713490291499,EDS 115,A00,507243,Choi; Bailey Miyeon,27,0,28,1
1713490292528,EDS 117,A01,494379,Staff,16,0,25,9
1713490293553,EDS 125,A00,507246,Hopkins; Megan Beth,27,0,30,3
1713490294582,EDS 128A,A01,507264,Fargason; Sharon Gayle,26,0,26,0
1713490295607,EDS 128B,A01,507293,Pappas; Elizabeth,30,0,30,0
1713490296631,EDS 139,A00,507294,Fargason; Sharon Gayle,30,0,30,0
1713490296631,EDS 139,B00,507313,Pappas; Elizabeth,30,0,30,0
1713490297657,EDS 201,A00,507315,Staff,18,0,30,12
1713490298682,EDS 203,A01,507317,Halter; Christopher P.,17,0,30,13
1713490299706,EDS 204R,A01,507319,Halter; Christopher P.,0,1,30,30
1713490299706,EDS 204R,B01,507331,Heinzman; Erica M.,22,0,30,8
1713490300734,EDS 206R,A00,507332,Staff,0,2,30,30
1713490300734,EDS 206R,B00,507343,Staff,23,0,30,7
1713490301758,EDS 250,A00,507344,Hemans; Patricia Ann Benitez,27,0,40,13
1713490302787,EDS 281,A00,507345,Daly; Alan J.,18,0,18,0
1713490303810,EDS 284,A00,507350,Daly; Alan J.,16,0,16,0
1713490304836,EDS 286,A00,507359,Fine; Sarah,18,0,18,0
1713490305863,EDS 289C,A01,507361,Daly; Alan J.,18,0,18,0
1713490306887,EDS 290,A00,507366,Hofstetter; Carolyn,15,0,15,0
1713490307916,LIGM 5A,A00,507421,Fischer-Grunski; Eva K,20,0,20,0
1713490308941,LIGM 5B,A00,507423,Fischer-Grunski; Eva K,20,0,20,0
1713490309971,LIGM 5C,A00,507425,Fischer-Grunski; Eva K,20,0,20,0
1713490311002,LIIT 5AS,A00,507427,Carnelos; Chiara,20,0,20,0
1713490312029,LIIT 5BS,A00,507430,Carnelos; Chiara,20,0,20,0
1713490313055,LIIT 5CS,A00,507432,Carnelos; Chiara,20,0,20,0
1713490314083,LISP 5A,A00,507541,Munoz Sanchez; Alicia,14,0,20,6
1713490315109,LISP 5B,A00,507671,Munoz Sanchez; Alicia,12,0,20,8
1713490316138,LISP 5C,A00,507696,Munoz Sanchez; Alicia,11,0,20,9
1713490317165,MAE 197,001,528363,Boechler; Nicholas Sebastia,9998,0,9999,1
1713490318191,MATH 197,001,523477,Kedlaya; Kiran S.,9999,0,9999,0
1713490318191,MATH 197,002,563811,Zhang; Danna,9998,0,9999,1
1713490319218,MCWP 40R,A00,518780,Staff,15,0,20,5
1713490319218,MCWP 40R,B00,518781,Staff,14,0,20,6
1713490319218,MCWP 40R,C00,518783,Staff,10,0,20,10
1713490320244,MCWP 50R,A00,518791,Staff,8,0,20,12
1713490320244,MCWP 50R,B00,518792,Staff,4,0,20,16
1713490320244,MCWP 50R,C00,518793,Staff,7,0,20,13
1713490320244,MCWP 50R,D00,518794,Staff,0,0,20,20
1713490320244,MCWP 50R,E00,518795,Staff,1,0,20,19
1713490320244,MCWP 50R,F00,518796,Staff,13,0,20,7
1713490320244,MCWP 50R,G00,518797,Staff,11,0,20,9
1713490321270,MMW 12R,A01,514034,Herbst; Matthew,5,0,16,11
1713490321270,MMW 12R,A02,514035,Herbst; Matthew,13,0,16,3
1713490322299,MMW 13R,A01,514037,Staff,0,5,16,16
1713490322299,MMW 13R,A02,514039,Staff,0,4,16,16
1713490324354,SIO 295LS,A00,523233,Staff,15,0,30,15
1713490325378,SIO 295S,A00,523232,Staff,15,0,30,15
1713490326407,SOCI 117,A01,494376,Staff,0,2,5,5
1713490327435,WES 237B,A00,494380,Staff,19,0,20,1
1713490329507,AESE 279B,A00,494370,Wade; Jon P,33,0,33,0
1713490330532,AIP 197,001,627712,Vespa; Emanuel Ignacio,9999,0,9999,0
1713490331570,ANAR 135S,A00,494369,Braswell; Geoffrey E.,0,0,0,0
1713490332599,CAT 124RS,A01,519847,Geibel; William,6,0,20,14
1713490333626,CAT 125RS,A01,515971,Geibel; William,6,0,20,14
1713490334654,CLRE 250,A00,511389,Morris; Sheldon,9996,0,9999,3
1713490335678,CLRE 251,A00,507176,Mehta; Ravindra L.,9996,0,9999,3
1713490335678,CLRE 251,B00,511410,Mehta; Ravindra L.,9998,0,9999,1
1713490336701,CLRE 252,A00,507189,Cuomo; Raphael Eduardo,9998,0,9999,1
1713490337726,CLRE 253,A00,507199,Vaida; Florin,9997,0,9999,2
1713490337726,CLRE 253,B00,507202,Vaida; Florin,9999,0,9999,0
1713490338750,CLRE 259,A00,507211,Patel; Hemal,9996,0,9999,3
1713490339828,CLRE 260,A00,507221,Cuomo; Raphael Eduardo,9999,0,9999,0
1713490340854,CLRE 297,001,507242,Cuomo; Raphael Eduardo,9999,0,9999,0
1713490341879,CSE 191,A00,516875,Minnes Kemp; Mor Mia,9999,0,9999,0
1713490342908,CSS 201S,A01,494383,Staff,35,0,35,0
1713490343935,CSS 202S,A01,494387,Staff,35,0,35,0
1713490344960,EAP 100,A00,516065,Staff,9792,0,9999,207
1713490345989,ECE 45,A01,507414,Staff,38,0,60,22
1713490347013,ECE 100,A01,507416,Baghdadchi; Saharnaz,0,0,20,20
1713490347013,ECE 100,A02,507418,Baghdadchi; Saharnaz,19,0,20,1
1713490348040,ECE 111,A01,507420,Staff,27,0,50,23
1713490349069,ECE 197,001,548057,Sievenpiper; Daniel F.,9998,0,9999,1
1713490350095,EDS 115,A00,507243,Choi; Bailey Miyeon,27,0,28,1
1713490351120,EDS 117,A01,494379,Staff,15,0,25,10
1713490352149,EDS 125,A00,507246,Hopkins; Megan Beth,27,0,30,3
1713490353174,EDS 128A,A01,507264,Fargason; Sharon Gayle,26,0,26,0
1713490354200,EDS 128B,A01,507293,Pappas; Elizabeth,30,0,30,0
1713490355225,EDS 139,A00,507294,Fargason; Sharon Gayle,30,0,30,0
1713490355225,EDS 139,B00,507313,Pappas; Elizabeth,30,0,30,0
1713490356250,EDS 201,A00,507315,Staff,18,0,30,12
1713490357276,EDS 203,A01,507317,Halter; Christopher P.,17,0,30,13
1713490358302,EDS 204R,A01,507319,Halter; Christopher P.,0,1,30,30
1713490358302,EDS 204R,B01,507331,Heinzman; Erica M.,22,0,30,8
1713490359330,EDS 206R,A00,507332,Staff,0,2,30,30
1713490359330,EDS 206R,B00,507343,Staff,23,0,30,7
1713490360354,EDS 250,A00,507344,Hemans; Patricia Ann Benitez,27,0,40,13
1713490361383,EDS 281,A00,507345,Daly; Alan J.,18,0,18,0
1713490362408,EDS 284,A00,507350,Daly; Alan J.,16,0,16,0
1713490363435,EDS 286,A00,507359,Fine; Sarah,18,0,18,0
1713490364460,EDS 289C,A01,507361,Daly; Alan J.,18,0,18,0
1713490365488,EDS 290,A00,507366,Hofstetter; Carolyn,15,0,15,0
1713490366517,LIGM 5A,A00,507421,Fischer-Grunski; Eva K,20,0,20,0
1713490367545,LIGM 5B,A00,507423,Fischer-Grunski; Eva K,20,0,20,0
1713490368574,LIGM 5C,A00,507425,Fischer-Grunski; Eva K,20,0,20,0
1713490369602,LIIT 5AS,A00,507427,Carnelos; Chiara,20,0,20,0
1713490370627,LIIT 5BS,A00,507430,Carnelos; Chiara,20,0,20,0
1713490371651,LIIT 5CS,A00,507432,Carnelos; Chiara,20,0,20,0
1713490372677,LISP 5A,A00,507541,Munoz Sanchez; Alicia,14,0,20,6
1713490373705,LISP 5B,A00,507671,Munoz Sanchez; Alicia,12,0,20,8
1713490374730,LISP 5C,A00,507696,Munoz Sanchez; Alicia,11,0,20,9
1713490375755,MAE 197,001,528363,Boechler; Nicholas Sebastia,9998,0,9999,1
1713490376779,MATH 197,001,523477,Kedlaya; Kiran S.,9999,0,9999,0
1713490376779,MATH 197,002,563811,Zhang; Danna,9998,0,9999,1
1713490377806,MCWP 40R,A00,518780,Staff,15,0,20,5
1713490377806,MCWP 40R,B00,518781,Staff,14,0,20,6
1713490377806,MCWP 40R,C00,518783,Staff,10,0,20,10
1713490378834,MCWP 50R,A00,518791,Staff,8,0,20,12
1713490378834,MCWP 50R,B00,518792,Staff,4,0,20,16
1713490378834,MCWP 50R,C00,518793,Staff,7,0,20,13
1713490378834,MCWP 50R,D00,518794,Staff,0,0,20,20
1713490378834,MCWP 50R,E00,518795,Staff,1,0,20,19
1713490378834,MCWP 50R,F00,518796,Staff,13,0,20,7
1713490378834,MCWP 50R,G00,518797,Staff,11,0,20,9
1713490379858,MMW 12R,A01,514034,Herbst; Matthew,5,0,16,11
1713490379858,MMW 12R,A02,514035,Herbst; Matthew,13,0,16,3
1713490380887,MMW 13R,A01,514037,Staff,0,5,16,16
1713490380887,MMW 13R,A02,514039,Staff,0,4,16,16
1713490382939,SIO 295LS,A00,523233,Staff,15,0,30,15
1713490383965,SIO 295S,A00,523232,Staff,15,0,30,15
1713490385044,SOCI 117,A01,494376,Staff,0,2,5,5
1713490386071,WES 237B,A00,494380,Staff,19,0,20,1
1713490388128,AESE 279B,A00,494370,Wade; Jon P,33,0,33,0
1713490389151,AIP 197,001,627712,Vespa; Emanuel Ignacio,9999,0,9999,0
1713490390175,ANAR 135S,A00,494369,Braswell; Geoffrey E.,0,0,0,0
1713490391200,CAT 124RS,A01,519847,Geibel; William,6,0,20,14
1713490392226,CAT 125RS,A01,515971,Geibel; William,6,0,20,14
1713490393252,CLRE 250,A00,511389,Morris; Sheldon,9996,0,9999,3
1713490394281,CLRE 251,A00,507176,Mehta; Ravindra L.,9996,0,9999,3
1713490394281,CLRE 251,B00,511410,Mehta; Ravindra L.,9998,0,9999,1
1713490395306,CLRE 252,A00,507189,Cuomo; Raphael Eduardo,9998,0,9999,1
1713490396335,CLRE 253,A00,507199,Vaida; Florin,9997,0,9999,2
1713490396335,CLRE 253,B00,507202,Vaida; Florin,9999,0,9999,0
1713490397361,CLRE 259,A00,507211,Patel; Hemal,9996,0,9999,3
1713490398386,CLRE 260,A00,507221,Cuomo; Raphael Eduardo,9999,0,9999,0
1713490399414,CLRE 297,001,507242,Cuomo; Raphael Eduardo,9999,0,9999,0
1713490400441,CSE 191,A00,516875,Minnes Kemp; Mor Mia,9999,0,9999,0
1713490401471,CSS 201S,A01,494383,Staff,35,0,35,0
1713490402497,CSS 202S,A01,494387,Staff,35,0,35,0
1713490403522,EAP 100,A00,516065,Staff,9792,0,9999,207
1713490404548,ECE 45,A01,507414,Staff,38,0,60,22
1713490405578,ECE 100,A01,507416,Baghdadchi; Saharnaz,0,0,20,20
1713490405578,ECE 100,A02,507418,Baghdadchi; Saharnaz,19,0,20,1
1713490406603,ECE 111,A01,507420,Staff,27,0,50,23
1713490407629,ECE 197,001,548057,Sievenpiper; Daniel F.,9998,0,9999,1
1713490408654,EDS 115,A00,507243,Choi; Bailey Miyeon,27,0,28,1
1713490409680,EDS 117,A01,494379,Staff,15,0,25,10
1713490410709,EDS 125,A00,507246,Hopkins; Megan Beth,27,0,30,3
1713490411735,EDS 128A,A01,507264,Fargason; Sharon Gayle,26,0,26,0
1713490412761,EDS 128B,A01,507293,Pappas; Elizabeth,30,0,30,0
1713490413791,EDS 139,A00,507294,Fargason; Sharon Gayle,30,0,30,0
1713490413791,EDS 139,B00,507313,Pappas; Elizabeth,30,0,30,0
1713490414818,EDS 201,A00,507315,Staff,18,0,30,12
1713490415848,EDS 203,A01,507317,Halter; Christopher P.,17,0,30,13
1713490416874,EDS 204R,A01,507319,Halter; Christopher P.,0,1,30,30
1713490416874,EDS 204R,B01,507331,Heinzman; Erica M.,22,0,30,8
1713490417902,EDS 206R,A00,507332,Staff,0,2,30,30
1713490417902,EDS 206R,B00,507343,Staff,23,0,30,7
1713490418933,EDS 250,A00,507344,Hemans; Patricia Ann Benitez,27,0,40,13
1713490419962,EDS 281,A00,507345,Daly; Alan J.,18,0,18,0
1713490420988,EDS 284,A00,507350,Daly; Alan J.,16,0,16,0
1713490422014,EDS 286,A00,507359,Fine; Sarah,18,0,18,0
1713490423043,EDS 289C,A01,507361,Daly; Alan J.,18,0,18,0
1713490424072,EDS 290,A00,507366,Hofstetter; Carolyn,15,0,15,0
1713490425102,LIGM 5A,A00,507421,Fischer-Grunski; Eva K,20,0,20,0
1713490426128,LIGM 5B,A00,507423,Fischer-Grunski; Eva K,20,0,20,0
1713490427157,LIGM 5C,A00,507425,Fischer-Grunski; Eva K,20,0,20,0
1713490428183,LIIT 5AS,A00,507427,Carnelos; Chiara,20,0,20,0
1713490429208,LIIT 5BS,A00,507430,Carnelos; Chiara,20,0,20,0
1713490430238,LIIT 5CS,A00,507432,Carnelos; Chiara,20,0,20,0
1713490431266,LISP 5A,A00,507541,Munoz Sanchez; Alicia,14,0,20,6
1713490432292,LISP 5B,A00,507671,Munoz Sanchez; Alicia,12,0,20,8
1713490433323,LISP 5C,A00,507696,Munoz Sanchez; Alicia,11,0,20,9
1713490434352,MAE 197,001,528363,Boechler; Nicholas Sebastia,9998,0,9999,1
1713490435375,MATH 197,001,523477,Kedlaya; Kiran S.,9999,0,9999,0
1713490435375,MATH 197,002,563811,Zhang; Danna,9998,0,9999,1
1713490436402,MCWP 40R,A00,518780,Staff,15,0,20,5
1713490436402,MCWP 40R,B00,518781,Staff,14,0,20,6
1713490436402,MCWP 40R,C00,518783,Staff,10,0,20,10
1713490437432,MCWP 50R,A00,518791,Staff,8,0,20,12
1713490437432,MCWP 50R,B00,518792,Staff,4,0,20,16
1713490437432,MCWP 50R,C00,518793,Staff,7,0,20,13
1713490437432,MCWP 50R,D00,518794,Staff,0,0,20,20
1713490437432,MCWP 50R,E00,518795,Staff,1,0,20,19
1713490437432,MCWP 50R,F00,518796,Staff,13,0,20,7
1713490437432,MCWP 50R,G00,518797,Staff,11,0,20,9
1713490438461,MMW 12R,A01,514034,Herbst; Matthew,5,0,16,11
1713490438461,MMW 12R,A02,514035,Herbst; Matthew,13,0,16,3
1713490439487,MMW 13R,A01,514037,Staff,0,5,16,16
1713490439487,MMW 13R,A02,514039,Staff,0,4,16,16
1713490441541,SIO 295LS,A00,523233,Staff,15,0,30,15
1713490442567,SIO 295S,A00,523232,Staff,15,0,30,15
1713490443599,SOCI 117,A01,494376,Staff,0,2,5,5
1713490444626,WES 237B,A00,494380,Staff,19,0,20,1
1713490446685,AESE 279B,A00,494370,Wade; Jon P,33,0,33,0
1713490447709,AIP 197,001,627712,Vespa; Emanuel Ignacio,9999,0,9999,0
1713490448735,ANAR 135S,A00,494369,Braswell; Geoffrey E.,0,0,0,0
1713490449765,CAT 124RS,A01,519847,Geibel; William,6,0,20,14
1713490450792,CAT 125RS,A01,515971,Geibel; William,6,0,20,14
1713490451821,CLRE 250,A00,511389,Morris; Sheldon,9996,0,9999,3
1713490452847,CLRE 251,A00,507176,Mehta; Ravindra L.,9996,0,9999,3
1713490452847,CLRE 251,B00,511410,Mehta; Ravindra L.,9998,0,9999,1
1713490453874,CLRE 252,A00,507189,Cuomo; Raphael Eduardo,9998,0,9999,1
1713490454905,CLRE 253,A00,507199,Vaida; Florin,9997,0,9999,2
1713490454905,CLRE 253,B00,507202,Vaida; Florin,9999,0,9999,0
1713490455932,CLRE 259,A00,507211,Patel; Hemal,9996,0,9999,3
1713490456958,CLRE 260,A00,507221,Cuomo; Raphael Eduardo,9999,0,9999,0
1713490457986,CLRE 297,001,507242,Cuomo; Raphael Eduardo,9999,0,9999,0
1713490459011,CSE 191,A00,516875,Minnes Kemp; Mor Mia,9999,0,9999,0
1713490460040,CSS 201S,A01,494383,Staff,35,0,35,0
1713490461070,CSS 202S,A01,494387,Staff,35,0,35,0
1713490462095,EAP 100,A00,516065,Staff,9792,0,9999,207
1713490463121,ECE 45,A01,507414,Staff,38,0,60,22
1713490464147,ECE 100,A01,507416,Baghdadchi; Saharnaz,0,0,20,20
1713490464147,ECE 100,A02,507418,Baghdadchi; Saharnaz,19,0,20,1
1713490465173,ECE 111,A01,507420,Staff,27,0,50,23
1713490466201,ECE 197,001,548057,Sievenpiper; Daniel F.,9998,0,9999,1
1713490467226,EDS 115,A00,507243,Choi; Bailey Miyeon,27,0,28,1
1713490468252,EDS 117,A01,494379,Staff,15,0,25,10
1713490469282,EDS 125,A00,507246,Hopkins; Megan Beth,27,0,30,3
1713490470308,EDS 128A,A01,507264,Fargason; Sharon Gayle,26,0,26,0
1713490471336,EDS 128B,A01,507293,Pappas; Elizabeth,30,0,30,0
1713490472361,EDS 139,A00,507294,Fargason; Sharon Gayle,30,0,30,0
1713490472361,EDS 139,B00,507313,Pappas; Elizabeth,30,0,30,0
1713490473391,EDS 201,A00,507315,Staff,18,0,30,12
1713490474416,EDS 203,A01,507317,Halter; Christopher P.,17,0,30,13
1713490475442,EDS 204R,A01,507319,Halter; Christopher P.,0,1,30,30
1713490475442,EDS 204R,B01,507331,Heinzman; Erica M.,22,0,30,8
1713490476469,EDS 206R,A00,507332,Staff,0,2,30,30
1713490476469,EDS 206R,B00,507343,Staff,23,0,30,7
1713490477529,EDS 250,A00,507344,Hemans; Patricia Ann Benitez,27,0,40,13
1713490478554,EDS 281,A00,507345,Daly; Alan J.,18,0,18,0
1713490479578,EDS 284,A00,507350,Daly; Alan J.,16,0,16,0
1713490480604,EDS 286,A00,507359,Fine; Sarah,18,0,18,0
1713490481630,EDS 289C,A01,507361,Daly; Alan J.,18,0,18,0
1713490482659,EDS 290,A00,507366,Hofstetter; Carolyn,15,0,15,0
1713490483684,LIGM 5A,A00,507421,Fischer-Grunski; Eva K,20,0,20,0
1713490484710,LIGM 5B,A00,507423,Fischer-Grunski; Eva K,20,0,20,0
1713490485738,LIGM 5C,A00,507425,Fischer-Grunski; Eva K,20,0,20,0
1713490486764,LIIT 5AS,A00,507427,Carnelos; Chiara,20,0,20,0
1713490487794,LIIT 5BS,A00,507430,Carnelos; Chiara,20,0,20,0
1713490488875,LIIT 5CS,A00,507432,Carnelos; Chiara,20,0,20,0
1713490489902,LISP 5A,A00,507541,Munoz Sanchez; Alicia,14,0,20,6
1713490490927,LISP 5B,A00,507671,Munoz Sanchez; Alicia,12,0,20,8
1713490491957,LISP 5C,A00,507696,Munoz Sanchez; Alicia,11,0,20,9
1713490492981,MAE 197,001,528363,Boechler; Nicholas Sebastia,9998,0,9999,1
1713490494007,MATH 197,001,523477,Kedlaya; Kiran S.,9999,0,9999,0
1713490494007,MATH 197,002,563811,Zhang; Danna,9998,0,9999,1
1713490495035,MCWP 40R,A00,518780,Staff,15,0,20,5
1713490495035,MCWP 40R,B00,518781,Staff,14,0,20,6
1713490495035,MCWP 40R,C00,518783,Staff,10,0,20,10
1713490496060,MCWP 50R,A00,518791,Staff,8,0,20,12
1713490496060,MCWP 50R,B00,518792,Staff,4,0,20,16
1713490496060,MCWP 50R,C00,518793,Staff,7,0,20,13
1713490496060,MCWP 50R,D00,518794,Staff,0,0,20,20
1713490496060,MCWP 50R,E00,518795,Staff,0,0,20,20
1713490496060,MCWP 50R,F00,518796,Staff,13,0,20,7
1713490496060,MCWP 50R,G00,518797,Staff,11,0,20,9
1713490497089,MMW 12R,A01,514034,Herbst; Matthew,5,0,16,11
1713490497089,MMW 12R,A02,514035,Herbst; Matthew,13,0,16,3
1713490498118,MMW 13R,A01,514037,Staff,0,5,16,16
1713490498118,MMW 13R,A02,514039,Staff,0,4,16,16
1713490500186,SIO 295LS,A00,523233,Staff,15,0,30,15
1713490501213,SIO 295S,A00,523232,Staff,15,0,30,15
1713490502239,SOCI 117,A01,494376,Staff,0,2,5,5
1713490503264,WES 237B,A00,494380,Staff,19,0,20,1
1713490505333,AESE 279B,A00,494370,Wade; Jon P,33,0,33,0
1713490506361,AIP 197,001,627712,Vespa; Emanuel Ignacio,9999,0,9999,0
1713490507386,ANAR 135S,A00,494369,Braswell; Geoffrey E.,0,0,0,0
1713490508411,CAT 124RS,A01,519847,Geibel; William,6,0,20,14
1713490509436,CAT 125RS,A01,515971,Geibel; William,6,0,20,14
1713490510465,CLRE 250,A00,511389,Morris; Sheldon,9996,0,9999,3
1713490511496,CLRE 251,A00,507176,Mehta; Ravindra L.,9996,0,9999,3
1713490511496,CLRE 251,B00,511410,Mehta; Ravindra L.,9998,0,9999,1
1713490512524,CLRE 252,A00,507189,Cuomo; Raphael Eduardo,9998,0,9999,1
1713490513550,CLRE 253,A00,507199,Vaida; Florin,9997,0,9999,2
1713490513550,CLRE 253,B00,507202,Vaida; Florin,9999,0,9999,0
1713490514579,CLRE 259,A00,507211,Patel; Hemal,9996,0,9999,3
1713490515604,CLRE 260,A00,507221,Cuomo; Raphael Eduardo,9999,0,9999,0
1713490516631,CLRE 297,001,507242,Cuomo; Raphael Eduardo,9999,0,9999,0
1713490517656,CSE 191,A00,516875,Minnes Kemp; Mor Mia,9999,0,9999,0
1713490518682,CSS 201S,A01,494383,Staff,35,0,35,0
1713490519716,CSS 202S,A01,494387,Staff,35,0,35,0
1713490520740,EAP 100,A00,516065,Staff,9792,0,9999,207
1713490521767,ECE 45,A01,507414,Staff,38,0,60,22
1713490522795,ECE 100,A01,507416,Baghdadchi; Saharnaz,0,0,20,20
1713490522795,ECE 100,A02,507418,Baghdadchi; Saharnaz,19,0,20,1
1713490523846,ECE 111,A01,507420,Staff,27,0,50,23
1713490524878,ECE 197,001,548057,Sievenpiper; Daniel F.,9998,0,9999,1
1713490525903,EDS 115,A00,507243,Choi; Bailey Miyeon,27,0,28,1
1713490526928,EDS 117,A01,494379,Staff,15,0,25,10
1713490527956,EDS 125,A00,507246,Hopkins; Megan Beth,27,0,30,3
1713490528986,EDS 128A,A01,507264,Fargason; Sharon Gayle,26,0,26,0
1713490530010,EDS 128B,A01,507293,Pappas; Elizabeth,30,0,30,0
1713490531039,EDS 139,A00,507294,Fargason; Sharon Gayle,30,0,30,0
1713490531039,EDS 139,B00,507313,Pappas; Elizabeth,30,0,30,0
1713490532066,EDS 201,A00,507315,Staff,18,0,30,12
1713490533094,EDS 203,A01,507317,Halter; Christopher P.,17,0,30,13
1713490534120,EDS 204R,A01,507319,Halter; Christopher P.,0,1,30,30
1713490534120,EDS 204R,B01,507331,Heinzman; Erica M.,22,0,30,8
1713490535146,EDS 206R,A00,507332,Staff,0,2,30,30
1713490535146,EDS 206R,B00,507343,Staff,23,0,30,7
1713490536168,EDS 250,A00,507344,Hemans; Patricia Ann Benitez,27,0,40,13
1713490537192,EDS 281,A00,507345,Daly; Alan J.,18,0,18,0
1713490538216,EDS 284,A00,507350,Daly; Alan J.,16,0,16,0
1713490539243,EDS 286,A00,507359,Fine; Sarah,18,0,18,0
1713490540268,EDS 289C,A01,507361,Daly; Alan J.,18,0,18,0
1713490541298,EDS 290,A00,507366,Hofstetter; Carolyn,15,0,15,0
1713490542329,LIGM 5A,A00,507421,Fischer-Grunski; Eva K,20,0,20,0
1713490543357,LIGM 5B,A00,507423,Fischer-Grunski; Eva K,20,0,20,0
1713490544383,LIGM 5C,A00,507425,Fischer-Grunski; Eva K,20,0,20,0
1713490545408,LIIT 5AS,A00,507427,Carnelos; Chiara,20,0,20,0
1713490546437,LIIT 5BS,A00,507430,Carnelos; Chiara,20,0,20,0
1713490547464,LIIT 5CS,A00,507432,Carnelos; Chiara,20,0,20,0
1713490548489,LISP 5A,A00,507541,Munoz Sanchez; Alicia,14,0,20,6
1713490549518,LISP 5B,A00,507671,Munoz Sanchez; Alicia,12,0,20,8
1713490550547,LISP 5C,A00,507696,Munoz Sanchez; Alicia,11,0,20,9
1713490551586,MAE 197,001,528363,Boechler; Nicholas Sebastia,9998,0,9999,1
1713490552610,MATH 197,001,523477,Kedlaya; Kiran S.,9999,0,9999,0
1713490552610,MATH 197,002,563811,Zhang; Danna,9998,0,9999,1
1713490553635,MCWP 40R,A00,518780,Staff,15,0,20,5
1713490553635,MCWP 40R,B00,518781,Staff,14,0,20,6
1713490553635,MCWP 40R,C00,518783,Staff,10,0,20,10
1713490554661,MCWP 50R,A00,518791,Staff,8,0,20,12
1713490554661,MCWP 50R,B00,518792,Staff,4,0,20,16
1713490554661,MCWP 50R,C00,518793,Staff,7,0,20,13
1713490554661,MCWP 50R,D00,518794,Staff,0,0,20,20
1713490554661,MCWP 50R,E00,518795,Staff,0,0,20,20
1713490554661,MCWP 50R,F00,518796,Staff,13,0,20,7
1713490554661,MCWP 50R,G00,518797,Staff,11,0,20,9
1713490555685,MMW 12R,A01,514034,Herbst; Matthew,5,0,16,11
1713490555685,MMW 12R,A02,514035,Herbst; Matthew,13,0,16,3
1713490556711,MMW 13R,A01,514037,Staff,0,5,16,16
1713490556711,MMW 13R,A02,514039,Staff,0,4,16,16
1713490558763,SIO 295LS,A00,523233,Staff,15,0,30,15
1713490559791,SIO 295S,A00,523232,Staff,15,0,30,15
1713490560818,SOCI 117,A01,494376,Staff,0,2,5,5
1713490561844,WES 237B,A00,494380,Staff,19,0,20,1
1713490563907,AESE 279B,A00,494370,Wade; Jon P,33,0,33,0
1713490564932,AIP 197,001,627712,Vespa; Emanuel Ignacio,9999,0,9999,0
1713490565961,ANAR 135S,A00,494369,Braswell; Geoffrey E.,0,0,0,0
1713490566987,CAT 124RS,A01,519847,Geibel; William,6,0,20,14
1713490568015,CAT 125RS,A01,515971,Geibel; William,6,0,20,14
1713490569040,CLRE 250,A00,511389,Morris; Sheldon,9996,0,9999,3
1713490570065,CLRE 251,A00,507176,Mehta; Ravindra L.,9996,0,9999,3
1713490570065,CLRE 251,B00,511410,Mehta; Ravindra L.,9998,0,9999,1
1713490571091,CLRE 252,A00,507189,Cuomo; Raphael Eduardo,9998,0,9999,1
1713490572118,CLRE 253,A00,507199,Vaida; Florin,9997,0,9999,2
1713490572118,CLRE 253,B00,507202,Vaida; Florin,9999,0,9999,0
1713490573146,CLRE 259,A00,507211,Patel; Hemal,9996,0,9999,3
1713490574175,CLRE 260,A00,507221,Cuomo; Raphael Eduardo,9999,0,9999,0
1713490575201,CLRE 297,001,507242,Cuomo; Raphael Eduardo,9999,0,9999,0
1713490576227,CSE 191,A00,516875,Minnes Kemp; Mor Mia,9999,0,9999,0
1713490577254,CSS 201S,A01,494383,Staff,35,0,35,0
1713490578283,CSS 202S,A01,494387,Staff,35,0,35,0
1713490579311,EAP 100,A00,516065,Staff,9792,0,9999,207
1713490580340,ECE 45,A01,507414,Staff,38,0,60,22
1713490581366,ECE 100,A01,507416,Baghdadchi; Saharnaz,0,0,20,20
1713490581366,ECE 100,A02,507418,Baghdadchi; Saharnaz,19,0,20,1
1713490582389,ECE 111,A01,507420,Staff,27,0,50,23
1713490583414,ECE 197,001,548057,Sievenpiper; Daniel F.,9998,0,9999,1
1713490584442,EDS 115,A00,507243,Choi; Bailey Miyeon,27,0,28,1
1713490585469,EDS 117,A01,494379,Staff,15,0,25,10
1713490586495,EDS 125,A00,507246,Hopkins; Megan Beth,27,0,30,3
1713490587523,EDS 128A,A01,507264,Fargason; Sharon Gayle,26,0,26,0
1713490588548,EDS 128B,A01,507293,Pappas; Elizabeth,30,0,30,0
1713490589573,EDS 139,A00,507294,Fargason; Sharon Gayle,30,0,30,0
1713490589573,EDS 139,B00,507313,Pappas; Elizabeth,30,0,30,0
1713490590598,EDS 201,A00,507315,Staff,18,0,30,12
1713490591630,EDS 203,A01,507317,Halter; Christopher P.,17,0,30,13
1713490592710,EDS 204R,A01,507319,Halter; Christopher P.,0,1,30,30
1713490592710,EDS 204R,B01,507331,Heinzman; Erica M.,22,0,30,8
1713490593736,EDS 206R,A00,507332,Staff,0,2,30,30
1713490593736,EDS 206R,B00,507343,Staff,23,0,30,7
1713490594762,EDS 250,A00,507344,Hemans; Patricia Ann Benitez,27,0,40,13
1713490595787,EDS 281,A00,507345,Daly; Alan J.,18,0,18,0
1713490596814,EDS 284,A00,507350,Daly; Alan J.,16,0,16,0
1713490597843,EDS 286,A00,507359,Fine; Sarah,18,0,18,0
1713490598867,EDS 289C,A01,507361,Daly; Alan J.,18,0,18,0
1713490599895,EDS 290,A00,507366,Hofstetter; Carolyn,15,0,15,0
1713490600922,LIGM 5A,A00,507421,Fischer-Grunski; Eva K,20,0,20,0
1713490601948,LIGM 5B,A00,507423,Fischer-Grunski; Eva K,20,0,20,0
1713490602977,LIGM 5C,A00,507425,Fischer-Grunski; Eva K,20,0,20,0
1713490604002,LIIT 5AS,A00,507427,Carnelos; Chiara,20,0,20,0
1713490605029,LIIT 5BS,A00,507430,Carnelos; Chiara,20,0,20,0
1713490606055,LIIT 5CS,A00,507432,Carnelos; Chiara,20,0,20,0
1713490607080,LISP 5A,A00,507541,Munoz Sanchez; Alicia,14,0,20,6
1713490608110,LISP 5B,A00,507671,Munoz Sanchez; Alicia,12,0,20,8
1713490609134,LISP 5C,A00,507696,Munoz Sanchez; Alicia,11,0,20,9
1713490610159,MAE 197,001,528363,Boechler; Nicholas Sebastia,9998,0,9999,1
1713490611187,MATH 197,001,523477,Kedlaya; Kiran S.,9999,0,9999,0
1713490611187,MATH 197,002,563811,Zhang; Danna,9998,0,9999,1
1713490612217,MCWP 40R,A00,518780,Staff,15,0,20,5
1713490612217,MCWP 40R,B00,518781,Staff,14,0,20,6
1713490612217,MCWP 40R,C00,518783,Staff,10,0,20,10
1713490613246,MCWP 50R,A00,518791,Staff,8,0,20,12
1713490613246,MCWP 50R,B00,518792,Staff,4,0,20,16
1713490613246,MCWP 50R,C00,518793,Staff,7,0,20,13
1713490613246,MCWP 50R,D00,518794,Staff,0,0,20,20
1713490613246,MCWP 50R,E00,518795,Staff,0,0,20,20
1713490613246,MCWP 50R,F00,518796,Staff,13,0,20,7
1713490613246,MCWP 50R,G00,518797,Staff,11,0,20,9
1713490614273,MMW 12R,A01,514034,Herbst; Matthew,5,0,16,11
1713490614273,MMW 12R,A02,514035,Herbst; Matthew,13,0,16,3
1713490615298,MMW 13R,A01,514037,Staff,0,5,16,16
1713490615298,MMW 13R,A02,514039,Staff,0,4,16,16
1713490617353,SIO 295LS,A00,523233,Staff,15,0,30,15
1713490618379,SIO 295S,A00,523232,Staff,15,0,30,15
1713490619407,SOCI 117,A01,494376,Staff,0,2,5,5
1713490620431,WES 237B,A00,494380,Staff,19,0,20,1
1713490622492,AESE 279B,A00,494370,Wade; Jon P,33,0,33,0
1713490623517,AIP 197,001,627712,Vespa; Emanuel Ignacio,9999,0,9999,0
1713490624546,ANAR 135S,A00,494369,Braswell; Geoffrey E.,0,0,0,0
1713490625570,CAT 124RS,A01,519847,Geibel; William,6,0,20,14
1713490626604,CAT 125RS,A01,515971,Geibel; William,6,0,20,14
1713490627628,CLRE 250,A00,511389,Morris; Sheldon,9996,0,9999,3
1713490628654,CLRE 251,A00,507176,Mehta; Ravindra L.,9996,0,9999,3
1713490628654,CLRE 251,B00,511410,Mehta; Ravindra L.,9998,0,9999,1
1713490629681,CLRE 252,A00,507189,Cuomo; Raphael Eduardo,9998,0,9999,1
1713490630710,CLRE 253,A00,507199,Vaida; Florin,9997,0,9999,2
1713490630710,CLRE 253,B00,507202,Vaida; Florin,9999,0,9999,0
1713490631734,CLRE 259,A00,507211,Patel; Hemal,9996,0,9999,3
1713490632760,CLRE 260,A00,507221,Cuomo; Raphael Eduardo,9999,0,9999,0
1713490633785,CLRE 297,001,507242,Cuomo; Raphael Eduardo,9999,0,9999,0
1713490634810,CSE 191,A00,516875,Minnes Kemp; Mor Mia,9999,0,9999,0
1713490635838,CSS 201S,A01,494383,Staff,35,0,35,0
1713490636867,CSS 202S,A01,494387,Staff,35,0,35,0
1713490637895,EAP 100,A00,516065,Staff,9792,0,9999,207
1713490638924,ECE 45,A01,507414,Staff,38,0,60,22
1713490639950,ECE 100,A01,507416,Baghdadchi; Saharnaz,0,0,20,20
1713490639950,ECE 100,A02,507418,Baghdadchi; Saharnaz,19,0,20,1
1713490640975,ECE 111,A01,507420,Staff,27,0,50,23
1713490642001,ECE 197,001,548057,Sievenpiper; Daniel F.,9998,0,9999,1
1713490643031,EDS 115,A00,507243,Choi; Bailey Miyeon,27,0,28,1
1713490644056,EDS 117,A01,494379,Staff,15,0,25,10
1713490645082,EDS 125,A00,507246,Hopkins; Megan Beth,27,0,30,3
1713490646111,EDS 128A,A01,507264,Fargason; Sharon Gayle,26,0,26,0
1713490647136,EDS 128B,A01,507293,Pappas; Elizabeth,30,0,30,0
1713490648163,EDS 139,A00,507294,Fargason; Sharon Gayle,30,0,30,0
1713490648163,EDS 139,B00,507313,Pappas; Elizabeth,30,0,30,0
1713490649191,EDS 201,A00,507315,Staff,18,0,30,12
1713490650217,EDS 203,A01,507317,Halter; Christopher P.,17,0,30,13
1713490651247,EDS 204R,A01,507319,Halter; Christopher P.,0,1,30,30
1713490651247,EDS 204R,B01,507331,Heinzman; Erica M.,22,0,30,8
1713490652274,EDS 206R,A00,507332,Staff,0,2,30,30
1713490652274,EDS 206R,B00,507343,Staff,23,0,30,7
1713490653299,EDS 250,A00,507344,Hemans; Patricia Ann Benitez,27,0,40,13
1713490654329,EDS 281,A00,507345,Daly; Alan J.,18,0,18,0
1713490655356,EDS 284,A00,507350,Daly; Alan J.,16,0,16,0
1713490656380,EDS 286,A00,507359,Fine; Sarah,18,0,18,0
1713490657403,EDS 289C,A01,507361,Daly; Alan J.,18,0,18,0
1713490658428,EDS 290,A00,507366,Hofstetter; Carolyn,15,0,15,0
1713490659456,LIGM 5A,A00,507421,Fischer-Grunski; Eva K,20,0,20,0
1713490660485,LIGM 5B,A00,507423,Fischer-Grunski; Eva K,20,0,20,0
1713490661511,LIGM 5C,A00,507425,Fischer-Grunski; Eva K,20,0,20,0
1713490662540,LIIT 5AS,A00,507427,Carnelos; Chiara,20,0,20,0
1713490663569,LIIT 5BS,A00,507430,Carnelos; Chiara,20,0,20,0
1713490664599,LIIT 5CS,A00,507432,Carnelos; Chiara,20,0,20,0
1713490665623,LISP 5A,A00,507541,Munoz Sanchez; Alicia,14,0,20,6
1713490666647,LISP 5B,A00,507671,Munoz Sanchez; Alicia,12,0,20,8
1713490667672,LISP 5C,A00,507696,Munoz Sanchez; Alicia,11,0,20,9
1713490668697,MAE 197,001,528363,Boechler; Nicholas Sebastia,9998,0,9999,1
1713490669725,MATH 197,001,523477,Kedlaya; Kiran S.,9999,0,9999,0
1713490669725,MATH 197,002,563811,Zhang; Danna,9998,0,9999,1
1713490670751,MCWP 40R,A00,518780,Staff,15,0,20,5
1713490670751,MCWP 40R,B00,518781,Staff,14,0,20,6
1713490670751,MCWP 40R,C00,518783,Staff,10,0,20,10
1713490671777,MCWP 50R,A00,518791,Staff,8,0,20,12
1713490671777,MCWP 50R,B00,518792,Staff,4,0,20,16
1713490671777,MCWP 50R,C00,518793,Staff,7,0,20,13
1713490671777,MCWP 50R,D00,518794,Staff,0,0,20,20
1713490671777,MCWP 50R,E00,518795,Staff,0,0,20,20
1713490671777,MCWP 50R,F00,518796,Staff,13,0,20,7
1713490671777,MCWP 50R,G00,518797,Staff,11,0,20,9
1713490672802,MMW 12R,A01,514034,Herbst; Matthew,5,0,16,11
1713490672802,MMW 12R,A02,514035,Herbst; Matthew,13,0,16,3
1713490673827,MMW 13R,A01,514037,Staff,0,5,16,16
1713490673827,MMW 13R,A02,514039,Staff,0,4,16,16
1713490675879,SIO 295LS,A00,523233,Staff,15,0,30,15
1713490676902,SIO 295S,A00,523232,Staff,15,0,30,15
1713490677927,SOCI 117,A01,494376,Staff,0,2,5,5
1713490678952,WES 237B,A00,494380,Staff,19,0,20,1
1713490681022,AESE 279B,A00,494370,Wade; Jon P,33,0,33,0
1713490682048,AIP 197,001,627712,Vespa; Emanuel Ignacio,9999,0,9999,0
1713490683073,ANAR 135S,A00,494369,Braswell; Geoffrey E.,0,0,0,0
1713490684114,CAT 124RS,A01,519847,Geibel; William,6,0,20,14
1713490685139,CAT 125RS,A01,515971,Geibel; William,6,0,20,14
1713490686165,CLRE 250,A00,511389,Morris; Sheldon,9996,0,9999,3
1713490687194,CLRE 251,A00,507176,Mehta; Ravindra L.,9996,0,9999,3
1713490687194,CLRE 251,B00,511410,Mehta; Ravindra L.,9998,0,9999,1
1713490688218,CLRE 252,A00,507189,Cuomo; Raphael Eduardo,9998,0,9999,1
1713490689243,CLRE 253,A00,507199,Vaida; Florin,9997,0,9999,2
1713490689243,CLRE 253,B00,507202,Vaida; Florin,9999,0,9999,0
1713490690270,CLRE 259,A00,507211,Patel; Hemal,9996,0,9999,3
1713490691298,CLRE 260,A00,507221,Cuomo; Raphael Eduardo,9999,0,9999,0
1713490692324,CLRE 297,001,507242,Cuomo; Raphael Eduardo,9999,0,9999,0
1713490693350,CSE 191,A00,516875,Minnes Kemp; Mor Mia,9999,0,9999,0
1713490694374,CSS 201S,A01,494383,Staff,35,0,35,0
1713490695403,CSS 202S,A01,494387,Staff,35,0,35,0
1713490696486,EAP 100,A00,516065,Staff,9792,0,9999,207
1713490697511,ECE 45,A01,507414,Staff,38,0,60,22
1713490698537,ECE 100,A01,507416,Baghdadchi; Saharnaz,0,0,20,20
1713490698537,ECE 100,A02,507418,Baghdadchi; Saharnaz,19,0,20,1
1713490699561,ECE 111,A01,507420,Staff,27,0,50,23
1713490700587,ECE 197,001,548057,Sievenpiper; Daniel F.,9998,0,9999,1
1713490701613,EDS 115,A00,507243,Choi; Bailey Miyeon,27,0,28,1
1713490702637,EDS 117,A01,494379,Staff,15,0,25,10
1713490703662,EDS 125,A00,507246,Hopkins; Megan Beth,27,0,30,3
1713490704686,EDS 128A,A01,507264,Fargason; Sharon Gayle,26,0,26,0
1713490705714,EDS 128B,A01,507293,Pappas; Elizabeth,30,0,30,0
1713490706739,EDS 139,A00,507294,Fargason; Sharon Gayle,30,0,30,0
1713490706739,EDS 139,B00,507313,Pappas; Elizabeth,30,0,30,0
1713490707767,EDS 201,A00,507315,Staff,18,0,30,12
1713490708791,EDS 203,A01,507317,Halter; Christopher P.,17,0,30,13
1713490709820,EDS 204R,A01,507319,Halter; Christopher P.,0,1,30,30
1713490709820,EDS 204R,B01,507331,Heinzman; Erica M.,22,0,30,8
1713490710845,EDS 206R,A00,507332,Staff,0,2,30,30
1713490710845,EDS 206R,B00,507343,Staff,23,0,30,7
1713490711872,EDS 250,A00,507344,Hemans; Patricia Ann Benitez,27,0,40,13
1713490712900,EDS 281,A00,507345,Daly; Alan J.,18,0,18,0
1713490713928,EDS 284,A00,507350,Daly; Alan J.,16,0,16,0
1713490714953,EDS 286,A00,507359,Fine; Sarah,18,0,18,0
1713490715985,EDS 289C,A01,507361,Daly; Alan J.,18,0,18,0
1713490717009,EDS 290,A00,507366,Hofstetter; Carolyn,15,0,15,0
1713490718035,LIGM 5A,A00,507421,Fischer-Grunski; Eva K,20,0,20,0
1713490719063,LIGM 5B,A00,507423,Fischer-Grunski; Eva K,20,0,20,0
1713490720092,LIGM 5C,A00,507425,Fischer-Grunski; Eva K,20,0,20,0
1713490721121,LIIT 5AS,A00,507427,Carnelos; Chiara,20,0,20,0
1713490722146,LIIT 5BS,A00,507430,Carnelos; Chiara,20,0,20,0
1713490723171,LIIT 5CS,A00,507432,Carnelos; Chiara,20,0,20,0
1713490724199,LISP 5A,A00,507541,Munoz Sanchez; Alicia,14,0,20,6
1713490725224,LISP 5B,A00,507671,Munoz Sanchez; Alicia,12,0,20,8
1713490726250,LISP 5C,A00,507696,Munoz Sanchez; Alicia,11,0,20,9
1713490727279,MAE 197,001,528363,Boechler; Nicholas Sebastia,9998,0,9999,1
1713490728309,MATH 197,001,523477,Kedlaya; Kiran S.,9999,0,9999,0
1713490728309,MATH 197,002,563811,Zhang; Danna,9998,0,9999,1
1713490729336,MCWP 40R,A00,518780,Staff,15,0,20,5
1713490729336,MCWP 40R,B00,518781,Staff,14,0,20,6
1713490729336,MCWP 40R,C00,518783,Staff,10,0,20,10
1713490730364,MCWP 50R,A00,518791,Staff,8,0,20,12
1713490730364,MCWP 50R,B00,518792,Staff,4,0,20,16
1713490730364,MCWP 50R,C00,518793,Staff,7,0,20,13
1713490730364,MCWP 50R,D00,518794,Staff,0,0,20,20
1713490730364,MCWP 50R,E00,518795,Staff,0,0,20,20
1713490730364,MCWP 50R,F00,518796,Staff,13,0,20,7
1713490730364,MCWP 50R,G00,518797,Staff,11,0,20,9
1713490731390,MMW 12R,A01,514034,Herbst; Matthew,5,0,16,11
1713490731390,MMW 12R,A02,514035,Herbst; Matthew,13,0,16,3
1713490732413,MMW 13R,A01,514037,Staff,0,5,16,16
1713490732413,MMW 13R,A02,514039,Staff,0,4,16,16
1713490734471,SIO 295LS,A00,523233,Staff,15,0,30,15
1713490735497,SIO 295S,A00,523232,Staff,15,0,30,15
1713490736521,SOCI 117,A01,494376,Staff,0,2,5,5
1713490737548,WES 237B,A00,494380,Staff,19,0,20,1
1713490739608,AESE 279B,A00,494370,Wade; Jon P,33,0,33,0
1713490740636,AIP 197,001,627712,Vespa; Emanuel Ignacio,9999,0,9999,0
1713490741660,ANAR 135S,A00,494369,Braswell; Geoffrey E.,0,0,0,0
1713490742689,CAT 124RS,A01,519847,Geibel; William,6,0,20,14
1713490743718,CAT 125RS,A01,515971,Geibel; William,6,0,20,14
1713490744746,CLRE 250,A00,511389,Morris; Sheldon,9996,0,9999,3
1713490745774,CLRE 251,A00,507176,Mehta; Ravindra L.,9996,0,9999,3
1713490745774,CLRE 251,B00,511410,Mehta; Ravindra L.,9998,0,9999,1
1713490746799,CLRE 252,A00,507189,Cuomo; Raphael Eduardo,9998,0,9999,1
1713490747826,CLRE 253,A00,507199,Vaida; Florin,9997,0,9999,2
1713490747826,CLRE 253,B00,507202,Vaida; Florin,9999,0,9999,0
1713490748852,CLRE 259,A00,507211,Patel; Hemal,9996,0,9999,3
1713490749880,CLRE 260,A00,507221,Cuomo; Raphael Eduardo,9999,0,9999,0
1713490750902,CLRE 297,001,507242,Cuomo; Raphael Eduardo,9999,0,9999,0
1713490751926,CSE 191,A00,516875,Minnes Kemp; Mor Mia,9999,0,9999,0
1713490752956,CSS 201S,A01,494383,Staff,35,0,35,0
1713490753983,CSS 202S,A01,494387,Staff,35,0,35,0
1713490755010,EAP 100,A00,516065,Staff,9792,0,9999,207
1713490756036,ECE 45,A01,507414,Staff,38,0,60,22
1713490757065,ECE 100,A01,507416,Baghdadchi; Saharnaz,0,0,20,20
1713490757065,ECE 100,A02,507418,Baghdadchi; Saharnaz,19,0,20,1
1713490758093,ECE 111,A01,507420,Staff,27,0,50,23
1713490759122,ECE 197,001,548057,Sievenpiper; Daniel F.,9998,0,9999,1
1713490760147,EDS 115,A00,507243,Choi; Bailey Miyeon,27,0,28,1
1713490761175,EDS 117,A01,494379,Staff,15,0,25,10
1713490762202,EDS 125,A00,507246,Hopkins; Megan Beth,27,0,30,3
1713490763227,EDS 128A,A01,507264,Fargason; Sharon Gayle,26,0,26,0
1713490764252,EDS 128B,A01,507293,Pappas; Elizabeth,30,0,30,0
1713490765278,EDS 139,A00,507294,Fargason; Sharon Gayle,30,0,30,0
1713490765278,EDS 139,B00,507313,Pappas; Elizabeth,30,0,30,0
1713490766306,EDS 201,A00,507315,Staff,18,0,30,12
1713490767335,EDS 203,A01,507317,Halter; Christopher P.,17,0,30,13
1713490768365,EDS 204R,A01,507319,Halter; Christopher P.,0,1,30,30
1713490768365,EDS 204R,B01,507331,Heinzman; Erica M.,22,0,30,8
1713490769392,EDS 206R,A00,507332,Staff,0,2,30,30
1713490769392,EDS 206R,B00,507343,Staff,23,0,30,7
1713490770419,EDS 250,A00,507344,Hemans; Patricia Ann Benitez,27,0,40,13
1713490771446,EDS 281,A00,507345,Daly; Alan J.,18,0,18,0
1713490772471,EDS 284,A00,507350,Daly; Alan J.,16,0,16,0
1713490773496,EDS 286,A00,507359,Fine; Sarah,18,0,18,0
1713490774521,EDS 289C,A01,507361,Daly; Alan J.,18,0,18,0
1713490775545,EDS 290,A00,507366,Hofstetter; Carolyn,15,0,15,0
1713490776574,LIGM 5A,A00,507421,Fischer-Grunski; Eva K,20,0,20,0
1713490777601,LIGM 5B,A00,507423,Fischer-Grunski; Eva K,20,0,20,0
1713490778631,LIGM 5C,A00,507425,Fischer-Grunski; Eva K,20,0,20,0
1713490779655,LIIT 5AS,A00,507427,Carnelos; Chiara,20,0,20,0
1713490780680,LIIT 5BS,A00,507430,Carnelos; Chiara,20,0,20,0
1713490781708,LIIT 5CS,A00,507432,Carnelos; Chiara,20,0,20,0
1713490782734,LISP 5A,A00,507541,Munoz Sanchez; Alicia,14,0,20,6
1713490783761,LISP 5B,A00,507671,Munoz Sanchez; Alicia,12,0,20,8
1713490784791,LISP 5C,A00,507696,Munoz Sanchez; Alicia,11,0,20,9
1713490785817,MAE 197,001,528363,Boechler; Nicholas Sebastia,9998,0,9999,1
1713490786845,MATH 197,001,523477,Kedlaya; Kiran S.,9999,0,9999,0
1713490786845,MATH 197,002,563811,Zhang; Danna,9998,0,9999,1
1713490787868,MCWP 40R,A00,518780,Staff,15,0,20,5
1713490787868,MCWP 40R,B00,518781,Staff,14,0,20,6
1713490787868,MCWP 40R,C00,518783,Staff,10,0,20,10
1713490788898,MCWP 50R,A00,518791,Staff,8,0,20,12
1713490788898,MCWP 50R,B00,518792,Staff,4,0,20,16
1713490788898,MCWP 50R,C00,518793,Staff,7,0,20,13
1713490788898,MCWP 50R,D00,518794,Staff,0,0,20,20
1713490788898,MCWP 50R,E00,518795,Staff,0,0,20,20
1713490788898,MCWP 50R,F00,518796,Staff,13,0,20,7
1713490788898,MCWP 50R,G00,518797,Staff,11,0,20,9
1713490789926,MMW 12R,A01,514034,Herbst; Matthew,5,0,16,11
1713490789926,MMW 12R,A02,514035,Herbst; Matthew,13,0,16,3
1713490790954,MMW 13R,A01,514037,Staff,0,5,16,16
1713490790954,MMW 13R,A02,514039,Staff,0,4,16,16
1713490793004,SIO 295LS,A00,523233,Staff,15,0,30,15
1713490794034,SIO 295S,A00,523232,Staff,15,0,30,15
1713490795061,SOCI 117,A01,494376,Staff,0,2,5,5
1713490796089,WES 237B,A00,494380,Staff,19,0,20,1
1713490798158,AESE 279B,A00,494370,Wade; Jon P,33,0,33,0
1713490799185,AIP 197,001,627712,Vespa; Emanuel Ignacio,9999,0,9999,0
1713490800266,ANAR 135S,A00,494369,Braswell; Geoffrey E.,0,0,0,0
1713490801294,CAT 124RS,A01,519847,Geibel; William,6,0,20,14
1713490802319,CAT 125RS,A01,515971,Geibel; William,6,0,20,14
1713490803343,CLRE 250,A00,511389,Morris; Sheldon,9996,0,9999,3
1713490804369,CLRE 251,A00,507176,Mehta; Ravindra L.,9996,0,9999,3
1713490804369,CLRE 251,B00,511410,Mehta; Ravindra L.,9998,0,9999,1
1713490805396,CLRE 252,A00,507189,Cuomo; Raphael Eduardo,9998,0,9999,1
1713490806422,CLRE 253,A00,507199,Vaida; Florin,9997,0,9999,2
1713490806422,CLRE 253,B00,507202,Vaida; Florin,9999,0,9999,0
1713490807449,CLRE 259,A00,507211,Patel; Hemal,9996,0,9999,3
1713490808476,CLRE 260,A00,507221,Cuomo; Raphael Eduardo,9999,0,9999,0
1713490809502,CLRE 297,001,507242,Cuomo; Raphael Eduardo,9999,0,9999,0
1713490810530,CSE 191,A00,516875,Minnes Kemp; Mor Mia,9999,0,9999,0
1713490811560,CSS 201S,A01,494383,Staff,35,0,35,0
1713490812583,CSS 202S,A01,494387,Staff,35,0,35,0
1713490813605,EAP 100,A00,516065,Staff,9792,0,9999,207
1713490814634,ECE 45,A01,507414,Staff,38,0,60,22
1713490815660,ECE 100,A01,507416,Baghdadchi; Saharnaz,0,0,20,20
1713490815660,ECE 100,A02,507418,Baghdadchi; Saharnaz,19,0,20,1
1713490816684,ECE 111,A01,507420,Staff,27,0,50,23
1713490817708,ECE 197,001,548057,Sievenpiper; Daniel F.,9998,0,9999,1
1713490818733,EDS 115,A00,507243,Choi; Bailey Miyeon,27,0,28,1
1713490819762,EDS 117,A01,494379,Staff,15,0,25,10
1713490820786,EDS 125,A00,507246,Hopkins; Megan Beth,27,0,30,3
1713490821812,EDS 128A,A01,507264,Fargason; Sharon Gayle,26,0,26,0
1713490822839,EDS 128B,A01,507293,Pappas; Elizabeth,30,0,30,0
1713490823865,EDS 139,A00,507294,Fargason; Sharon Gayle,30,0,30,0
1713490823865,EDS 139,B00,507313,Pappas; Elizabeth,30,0,30,0
1713490824891,EDS 201,A00,507315,Staff,18,0,30,12
1713490825918,EDS 203,A01,507317,Halter; Christopher P.,17,0,30,13
1713490826942,EDS 204R,A01,507319,Halter; Christopher P.,0,1,30,30
1713490826942,EDS 204R,B01,507331,Heinzman; Erica M.,22,0,30,8
1713490827966,EDS 206R,A00,507332,Staff,0,2,30,30
1713490827966,EDS 206R,B00,507343,Staff,23,0,30,7
1713490828994,EDS 250,A00,507344,Hemans; Patricia Ann Benitez,27,0,40,13
1713490830022,EDS 281,A00,507345,Daly; Alan J.,18,0,18,0
1713490831051,EDS 284,A00,507350,Daly; Alan J.,16,0,16,0
1713490832076,EDS 286,A00,507359,Fine; Sarah,18,0,18,0
1713490833107,EDS 289C,A01,507361,Daly; Alan J.,18,0,18,0
1713490834135,EDS 290,A00,507366,Hofstetter; Carolyn,15,0,15,0
1713490835159,LIGM 5A,A00,507421,Fischer-Grunski; Eva K,20,0,20,0
1713490836187,LIGM 5B,A00,507423,Fischer-Grunski; Eva K,20,0,20,0
1713490837214,LIGM 5C,A00,507425,Fischer-Grunski; Eva K,20,0,20,0
1713490838239,LIIT 5AS,A00,507427,Carnelos; Chiara,20,0,20,0
1713490839264,LIIT 5BS,A00,507430,Carnelos; Chiara,20,0,20,0
1713490840290,LIIT 5CS,A00,507432,Carnelos; Chiara,20,0,20,0
1713490841315,LISP 5A,A00,507541,Munoz Sanchez; Alicia,14,0,20,6
1713490842340,LISP 5B,A00,507671,Munoz Sanchez; Alicia,12,0,20,8
1713490843365,LISP 5C,A00,507696,Munoz Sanchez; Alicia,11,0,20,9
1713490844389,MAE 197,001,528363,Boechler; Nicholas Sebastia,9998,0,9999,1
1713490845414,MATH 197,001,523477,Kedlaya; Kiran S.,9999,0,9999,0
1713490845414,MATH 197,002,563811,Zhang; Danna,9998,0,9999,1
1713490846441,MCWP 40R,A00,518780,Staff,15,0,20,5
1713490846441,MCWP 40R,B00,518781,Staff,14,0,20,6
1713490846441,MCWP 40R,C00,518783,Staff,10,0,20,10
1713490847468,MCWP 50R,A00,518791,Staff,8,0,20,12
1713490847468,MCWP 50R,B00,518792,Staff,4,0,20,16
1713490847468,MCWP 50R,C00,518793,Staff,7,0,20,13
1713490847468,MCWP 50R,D00,518794,Staff,0,0,20,20
1713490847468,MCWP 50R,E00,518795,Staff,0,0,20,20
1713490847468,MCWP 50R,F00,518796,Staff,13,0,20,7
1713490847468,MCWP 50R,G00,518797,Staff,11,0,20,9
1713490848495,MMW 12R,A01,514034,Herbst; Matthew,5,0,16,11
1713490848495,MMW 12R,A02,514035,Herbst; Matthew,13,0,16,3
1713490849519,MMW 13R,A01,514037,Staff,0,5,16,16
1713490849519,MMW 13R,A02,514039,Staff,0,4,16,16
1713490851574,SIO 295LS,A00,523233,Staff,15,0,30,15
1713490852597,SIO 295S,A00,523232,Staff,15,0,30,15
1713490853624,SOCI 117,A01,494376,Staff,0,2,5,5
1713490854650,WES 237B,A00,494380,Staff,19,0,20,1
1713490856724,AESE 279B,A00,494370,Wade; Jon P,33,0,33,0
1713490857749,AIP 197,001,627712,Vespa; Emanuel Ignacio,9999,0,9999,0
1713490858777,ANAR 135S,A00,494369,Braswell; Geoffrey E.,0,0,0,0
1713490859805,CAT 124RS,A01,519847,Geibel; William,6,0,20,14
1713490860830,CAT 125RS,A01,515971,Geibel; William,6,0,20,14
1713490861855,CLRE 250,A00,511389,Morris; Sheldon,9996,0,9999,3
1713490862894,CLRE 251,A00,507176,Mehta; Ravindra L.,9996,0,9999,3
1713490862894,CLRE 251,B00,511410,Mehta; Ravindra L.,9998,0,9999,1
1713490863924,CLRE 252,A00,507189,Cuomo; Raphael Eduardo,9998,0,9999,1
1713490864952,CLRE 253,A00,507199,Vaida; Florin,9997,0,9999,2
1713490864952,CLRE 253,B00,507202,Vaida; Florin,9999,0,9999,0
1713490865980,CLRE 259,A00,507211,Patel; Hemal,9996,0,9999,3
1713490867007,CLRE 260,A00,507221,Cuomo; Raphael Eduardo,9999,0,9999,0
1713490868035,CLRE 297,001,507242,Cuomo; Raphael Eduardo,9999,0,9999,0
1713490869063,CSE 191,A00,516875,Minnes Kemp; Mor Mia,9999,0,9999,0
1713490870093,CSS 201S,A01,494383,Staff,35,0,35,0
1713490871118,CSS 202S,A01,494387,Staff,35,0,35,0
1713490872146,EAP 100,A00,516065,Staff,9792,0,9999,207
1713490873172,ECE 45,A01,507414,Staff,38,0,60,22
1713490874202,ECE 100,A01,507416,Baghdadchi; Saharnaz,0,0,20,20
1713490874202,ECE 100,A02,507418,Baghdadchi; Saharnaz,19,0,20,1
1713490875227,ECE 111,A01,507420,Staff,27,0,50,23
1713490876253,ECE 197,001,548057,Sievenpiper; Daniel F.,9998,0,9999,1
1713490877279,EDS 115,A00,507243,Choi; Bailey Miyeon,27,0,28,1
1713490878307,EDS 117,A01,494379,Staff,15,0,25,10
1713490879331,EDS 125,A00,507246,Hopkins; Megan Beth,27,0,30,3
1713490880360,EDS 128A,A01,507264,Fargason; Sharon Gayle,26,0,26,0
1713490881386,EDS 128B,A01,507293,Pappas; Elizabeth,30,0,30,0
1713490882415,EDS 139,A00,507294,Fargason; Sharon Gayle,30,0,30,0
1713490882415,EDS 139,B00,507313,Pappas; Elizabeth,30,0,30,0
1713490883440,EDS 201,A00,507315,Staff,18,0,30,12
1713490884469,EDS 203,A01,507317,Halter; Christopher P.,17,0,30,13
1713490885494,EDS 204R,A01,507319,Halter; Christopher P.,0,1,30,30
1713490885494,EDS 204R,B01,507331,Heinzman; Erica M.,22,0,30,8
1713490886530,EDS 206R,A00,507332,Staff,0,2,30,30
1713490886530,EDS 206R,B00,507343,Staff,23,0,30,7
1713490887554,EDS 250,A00,507344,Hemans; Patricia Ann Benitez,27,0,40,13
1713490888582,EDS 281,A00,507345,Daly; Alan J.,18,0,18,0
1713490889607,EDS 284,A00,507350,Daly; Alan J.,16,0,16,0
1713490890636,EDS 286,A00,507359,Fine; Sarah,18,0,18,0
1713490891658,EDS 289C,A01,507361,Daly; Alan J.,18,0,18,0
1713490892683,EDS 290,A00,507366,Hofstetter; Carolyn,15,0,15,0
1713490893709,LIGM 5A,A00,507421,Fischer-Grunski; Eva K,20,0,20,0
1713490894734,LIGM 5B,A00,507423,Fischer-Grunski; Eva K,20,0,20,0
1713490895763,LIGM 5C,A00,507425,Fischer-Grunski; Eva K,20,0,20,0
1713490896792,LIIT 5AS,A00,507427,Carnelos; Chiara,20,0,20,0
1713490897815,LIIT 5BS,A00,507430,Carnelos; Chiara,20,0,20,0
1713490898840,LIIT 5CS,A00,507432,Carnelos; Chiara,20,0,20,0
1713490899870,LISP 5A,A00,507541,Munoz Sanchez; Alicia,14,0,20,6
1713490900895,LISP 5B,A00,507671,Munoz Sanchez; Alicia,12,0,20,8
1713490901933,LISP 5C,A00,507696,Munoz Sanchez; Alicia,11,0,20,9
1713490902958,MAE 197,001,528363,Boechler; Nicholas Sebastia,9998,0,9999,1
1713490904041,MATH 197,001,523477,Kedlaya; Kiran S.,9999,0,9999,0
1713490904041,MATH 197,002,563811,Zhang; Danna,9998,0,9999,1
1713490905067,MCWP 40R,A00,518780,Staff,15,0,20,5
1713490905067,MCWP 40R,B00,518781,Staff,14,0,20,6
1713490905067,MCWP 40R,C00,518783,Staff,10,0,20,10
1713490906096,MCWP 50R,A00,518791,Staff,8,0,20,12
1713490906096,MCWP 50R,B00,518792,Staff,4,0,20,16
1713490906096,MCWP 50R,C00,518793,Staff,7,0,20,13
1713490906096,MCWP 50R,D00,518794,Staff,0,0,20,20
1713490906096,MCWP 50R,E00,518795,Staff,0,0,20,20
1713490906096,MCWP 50R,F00,518796,Staff,13,0,20,7
1713490906096,MCWP 50R,G00,518797,Staff,11,0,20,9
1713490907122,MMW 12R,A01,514034,Herbst; Matthew,5,0,16,11
1713490907122,MMW 12R,A02,514035,Herbst; Matthew,13,0,16,3
1713490908149,MMW 13R,A01,514037,Staff,0,5,16,16
1713490908149,MMW 13R,A02,514039,Staff,0,4,16,16
1713490910202,SIO 295LS,A00,523233,Staff,15,0,30,15
1713490911231,SIO 295S,A00,523232,Staff,15,0,30,15
1713490912256,SOCI 117,A01,494376,Staff,0,2,5,5
1713490913284,WES 237B,A00,494380,Staff,19,0,20,1
1713490915342,AESE 279B,A00,494370,Wade; Jon P,33,0,33,0
1713490916367,AIP 197,001,627712,Vespa; Emanuel Ignacio,9999,0,9999,0
1713490917394,ANAR 135S,A00,494369,Braswell; Geoffrey E.,0,0,0,0
1713490918423,CAT 124RS,A01,519847,Geibel; William,6,0,20,14
1713490919448,CAT 125RS,A01,515971,Geibel; William,6,0,20,14
1713490920476,CLRE 250,A00,511389,Morris; Sheldon,9996,0,9999,3
1713490921503,CLRE 251,A00,507176,Mehta; Ravindra L.,9996,0,9999,3
1713490921503,CLRE 251,B00,511410,Mehta; Ravindra L.,9998,0,9999,1
1713490922528,CLRE 252,A00,507189,Cuomo; Raphael Eduardo,9998,0,9999,1
1713490923554,CLRE 253,A00,507199,Vaida; Florin,9997,0,9999,2
1713490923554,CLRE 253,B00,507202,Vaida; Florin,9999,0,9999,0
1713490924579,CLRE 259,A00,507211,Patel; Hemal,9996,0,9999,3
1713490925601,CLRE 260,A00,507221,Cuomo; Raphael Eduardo,9999,0,9999,0
1713490926626,CLRE 297,001,507242,Cuomo; Raphael Eduardo,9999,0,9999,0
1713490927654,CSE 191,A00,516875,Minnes Kemp; Mor Mia,9999,0,9999,0
1713490928679,CSS 201S,A01,494383,Staff,35,0,35,0
1713490929705,CSS 202S,A01,494387,Staff,35,0,35,0
1713490930731,EAP 100,A00,516065,Staff,9792,0,9999,207
1713490931757,ECE 45,A01,507414,Staff,38,0,60,22
1713490932782,ECE 100,A01,507416,Baghdadchi; Saharnaz,0,0,20,20
1713490932782,ECE 100,A02,507418,Baghdadchi; Saharnaz,19,0,20,1
1713490933808,ECE 111,A01,507420,Staff,27,0,50,23
1713490934831,ECE 197,001,548057,Sievenpiper; Daniel F.,9998,0,9999,1
1713490935857,EDS 115,A00,507243,Choi; Bailey Miyeon,27,0,28,1
1713490936881,EDS 117,A01,494379,Staff,15,0,25,10
1713490937907,EDS 125,A00,507246,Hopkins; Megan Beth,27,0,30,3
1713490938937,EDS 128A,A01,507264,Fargason; Sharon Gayle,26,0,26,0
1713490939961,EDS 128B,A01,507293,Pappas; Elizabeth,30,0,30,0
1713490940985,EDS 139,A00,507294,Fargason; Sharon Gayle,30,0,30,0
1713490940985,EDS 139,B00,507313,Pappas; Elizabeth,30,0,30,0
1713490942009,EDS 201,A00,507315,Staff,18,0,30,12
1713490943034,EDS 203,A01,507317,Halter; Christopher P.,17,0,30,13
1713490944060,EDS 204R,A01,507319,Halter; Christopher P.,0,1,30,30
1713490944060,EDS 204R,B01,507331,Heinzman; Erica M.,22,0,30,8
1713490945089,EDS 206R,A00,507332,Staff,0,2,30,30
1713490945089,EDS 206R,B00,507343,Staff,23,0,30,7
1713490946114,EDS 250,A00,507344,Hemans; Patricia Ann Benitez,27,0,40,13
1713490947141,EDS 281,A00,507345,Daly; Alan J.,18,0,18,0
1713490948169,EDS 284,A00,507350,Daly; Alan J.,16,0,16,0
1713490949194,EDS 286,A00,507359,Fine; Sarah,18,0,18,0
1713490950224,EDS 289C,A01,507361,Daly; Alan J.,18,0,18,0
1713490951254,EDS 290,A00,507366,Hofstetter; Carolyn,15,0,15,0
1713490952280,LIGM 5A,A00,507421,Fischer-Grunski; Eva K,20,0,20,0
1713490953306,LIGM 5B,A00,507423,Fischer-Grunski; Eva K,20,0,20,0
1713490954333,LIGM 5C,A00,507425,Fischer-Grunski; Eva K,20,0,20,0
1713490955358,LIIT 5AS,A00,507427,Carnelos; Chiara,20,0,20,0
1713490956386,LIIT 5BS,A00,507430,Carnelos; Chiara,20,0,20,0
1713490957416,LIIT 5CS,A00,507432,Carnelos; Chiara,20,0,20,0
1713490958440,LISP 5A,A00,507541,Munoz Sanchez; Alicia,14,0,20,6
1713490959468,LISP 5B,A00,507671,Munoz Sanchez; Alicia,12,0,20,8
1713490960498,LISP 5C,A00,507696,Munoz Sanchez; Alicia,11,0,20,9
1713490961523,MAE 197,001,528363,Boechler; Nicholas Sebastia,9998,0,9999,1
1713490962551,MATH 197,001,523477,Kedlaya; Kiran S.,9999,0,9999,0
1713490962551,MATH 197,002,563811,Zhang; Danna,9998,0,9999,1
1713490963574,MCWP 40R,A00,518780,Staff,15,0,20,5
1713490963574,MCWP 40R,B00,518781,Staff,14,0,20,6
1713490963574,MCWP 40R,C00,518783,Staff,10,0,20,10
1713490964597,MCWP 50R,A00,518791,Staff,8,0,20,12
1713490964597,MCWP 50R,B00,518792,Staff,4,0,20,16
1713490964597,MCWP 50R,C00,518793,Staff,7,0,20,13
1713490964597,MCWP 50R,D00,518794,Staff,0,0,20,20
1713490964597,MCWP 50R,E00,518795,Staff,0,0,20,20
1713490964597,MCWP 50R,F00,518796,Staff,13,0,20,7
1713490964597,MCWP 50R,G00,518797,Staff,11,0,20,9
1713490965623,MMW 12R,A01,514034,Herbst; Matthew,5,0,16,11
1713490965623,MMW 12R,A02,514035,Herbst; Matthew,13,0,16,3
1713490966647,MMW 13R,A01,514037,Staff,0,5,16,16
1713490966647,MMW 13R,A02,514039,Staff,0,4,16,16
1713490968697,SIO 295LS,A00,523233,Staff,15,0,30,15
1713490969721,SIO 295S,A00,523232,Staff,15,0,30,15
1713490970748,SOCI 117,A01,494376,Staff,0,2,5,5
1713490971776,WES 237B,A00,494380,Staff,19,0,20,1
1713490973836,AESE 279B,A00,494370,Wade; Jon P,33,0,33,0
1713490974860,AIP 197,001,627712,Vespa; Emanuel Ignacio,9999,0,9999,0
1713490975890,ANAR 135S,A00,494369,Braswell; Geoffrey E.,0,0,0,0
1713490976919,CAT 124RS,A01,519847,Geibel; William,6,0,20,14
1713490977943,CAT 125RS,A01,515971,Geibel; William,6,0,20,14
1713490978968,CLRE 250,A00,511389,Morris; Sheldon,9996,0,9999,3
1713490979996,CLRE 251,A00,507176,Mehta; Ravindra L.,9996,0,9999,3
1713490979996,CLRE 251,B00,511410,Mehta; Ravindra L.,9998,0,9999,1
1713490981026,CLRE 252,A00,507189,Cuomo; Raphael Eduardo,9998,0,9999,1
1713490982054,CLRE 253,A00,507199,Vaida; Florin,9997,0,9999,2
1713490982054,CLRE 253,B00,507202,Vaida; Florin,9999,0,9999,0
1713490983080,CLRE 259,A00,507211,Patel; Hemal,9996,0,9999,3
1713490984106,CLRE 260,A00,507221,Cuomo; Raphael Eduardo,9999,0,9999,0
1713490985134,CLRE 297,001,507242,Cuomo; Raphael Eduardo,9999,0,9999,0
1713490986162,CSE 191,A00,516875,Minnes Kemp; Mor Mia,9999,0,9999,0
1713490987188,CSS 201S,A01,494383,Staff,35,0,35,0
1713490988212,CSS 202S,A01,494387,Staff,35,0,35,0
1713490989237,EAP 100,A00,516065,Staff,9792,0,9999,207
1713490990263,ECE 45,A01,507414,Staff,38,0,60,22
1713490991287,ECE 100,A01,507416,Baghdadchi; Saharnaz,0,0,20,20
1713490991287,ECE 100,A02,507418,Baghdadchi; Saharnaz,19,0,20,1
1713490992318,ECE 111,A01,507420,Staff,27,0,50,23
1713490993342,ECE 197,001,548057,Sievenpiper; Daniel F.,9998,0,9999,1
1713490994367,EDS 115,A00,507243,Choi; Bailey Miyeon,27,0,28,1
1713490995393,EDS 117,A01,494379,Staff,15,0,25,10
1713490996422,EDS 125,A00,507246,Hopkins; Megan Beth,27,0,30,3
1713490997449,EDS 128A,A01,507264,Fargason; Sharon Gayle,26,0,26,0
1713490998475,EDS 128B,A01,507293,Pappas; Elizabeth,30,0,30,0
1713490999500,EDS 139,A00,507294,Fargason; Sharon Gayle,30,0,30,0
1713490999500,EDS 139,B00,507313,Pappas; Elizabeth,30,0,30,0
1713491000526,EDS 201,A00,507315,Staff,18,0,30,12
1713491001551,EDS 203,A01,507317,Halter; Christopher P.,17,0,30,13
1713491002580,EDS 204R,A01,507319,Halter; Christopher P.,0,1,30,30
1713491002580,EDS 204R,B01,507331,Heinzman; Erica M.,22,0,30,8
1713491003607,EDS 206R,A00,507332,Staff,0,2,30,30
1713491003607,EDS 206R,B00,507343,Staff,23,0,30,7
1713491004631,EDS 250,A00,507344,Hemans; Patricia Ann Benitez,27,0,40,13
1713491005657,EDS 281,A00,507345,Daly; Alan J.,18,0,18,0
1713491006684,EDS 284,A00,507350,Daly; Alan J.,16,0,16,0
1713491007768,EDS 286,A00,507359,Fine; Sarah,18,0,18,0
1713491008796,EDS 289C,A01,507361,Daly; Alan J.,18,0,18,0
1713491009821,EDS 290,A00,507366,Hofstetter; Carolyn,15,0,15,0
1713491010849,LIGM 5A,A00,507421,Fischer-Grunski; Eva K,20,0,20,0
1713491012018,LIGM 5B,A00,507423,Fischer-Grunski; Eva K,20,0,20,0
1713491013044,LIGM 5C,A00,507425,Fischer-Grunski; Eva K,20,0,20,0
1713491014069,LIIT 5AS,A00,507427,Carnelos; Chiara,20,0,20,0
1713491015095,LIIT 5BS,A00,507430,Carnelos; Chiara,20,0,20,0
1713491016120,LIIT 5CS,A00,507432,Carnelos; Chiara,20,0,20,0
1713491017145,LISP 5A,A00,507541,Munoz Sanchez; Alicia,14,0,20,6
1713491018171,LISP 5B,A00,507671,Munoz Sanchez; Alicia,12,0,20,8
1713491019201,LISP 5C,A00,507696,Munoz Sanchez; Alicia,11,0,20,9
1713491020229,MAE 197,001,528363,Boechler; Nicholas Sebastia,9998,0,9999,1
1713491021254,MATH 197,001,523477,Kedlaya; Kiran S.,9999,0,9999,0
1713491021254,MATH 197,002,563811,Zhang; Danna,9998,0,9999,1
1713491022279,MCWP 40R,A00,518780,Staff,15,0,20,5
1713491022279,MCWP 40R,B00,518781,Staff,14,0,20,6
1713491022279,MCWP 40R,C00,518783,Staff,10,0,20,10
1713491023304,MCWP 50R,A00,518791,Staff,8,0,20,12
1713491023304,MCWP 50R,B00,518792,Staff,4,0,20,16
1713491023304,MCWP 50R,C00,518793,Staff,7,0,20,13
1713491023304,MCWP 50R,D00,518794,Staff,0,0,20,20
1713491023304,MCWP 50R,E00,518795,Staff,0,0,20,20
1713491023304,MCWP 50R,F00,518796,Staff,13,0,20,7
1713491023304,MCWP 50R,G00,518797,Staff,11,0,20,9
1713491024331,MMW 12R,A01,514034,Herbst; Matthew,5,0,16,11
1713491024331,MMW 12R,A02,514035,Herbst; Matthew,13,0,16,3
1713491025358,MMW 13R,A01,514037,Staff,0,5,16,16
1713491025358,MMW 13R,A02,514039,Staff,0,4,16,16
1713491027413,SIO 295LS,A00,523233,Staff,15,0,30,15
1713491028441,SIO 295S,A00,523232,Staff,15,0,30,15
1713491029466,SOCI 117,A01,494376,Staff,0,2,5,5
1713491030494,WES 237B,A00,494380,Staff,19,0,20,1
1713491032551,AESE 279B,A00,494370,Wade; Jon P,33,0,33,0
1713491033575,AIP 197,001,627712,Vespa; Emanuel Ignacio,9999,0,9999,0
1713491034600,ANAR 135S,A00,494369,Braswell; Geoffrey E.,0,0,0,0
1713491035627,CAT 124RS,A01,519847,Geibel; William,6,0,20,14
1713491036653,CAT 125RS,A01,515971,Geibel; William,6,0,20,14
1713491037678,CLRE 250,A00,511389,Morris; Sheldon,9996,0,9999,3
1713491038702,CLRE 251,A00,507176,Mehta; Ravindra L.,9996,0,9999,3
1713491038702,CLRE 251,B00,511410,Mehta; Ravindra L.,9998,0,9999,1
1713491039730,CLRE 252,A00,507189,Cuomo; Raphael Eduardo,9998,0,9999,1
1713491040754,CLRE 253,A00,507199,Vaida; Florin,9997,0,9999,2
1713491040754,CLRE 253,B00,507202,Vaida; Florin,9999,0,9999,0
1713491041780,CLRE 259,A00,507211,Patel; Hemal,9996,0,9999,3
1713491042808,CLRE 260,A00,507221,Cuomo; Raphael Eduardo,9999,0,9999,0
1713491043833,CLRE 297,001,507242,Cuomo; Raphael Eduardo,9999,0,9999,0
1713491044857,CSE 191,A00,516875,Minnes Kemp; Mor Mia,9999,0,9999,0
1713491045887,CSS 201S,A01,494383,Staff,35,0,35,0
1713491046915,CSS 202S,A01,494387,Staff,35,0,35,0
1713491047944,EAP 100,A00,516065,Staff,9792,0,9999,207
1713491048973,ECE 45,A01,507414,Staff,38,0,60,22
1713491050002,ECE 100,A01,507416,Baghdadchi; Saharnaz,0,0,20,20
1713491050002,ECE 100,A02,507418,Baghdadchi; Saharnaz,19,0,20,1
1713491051031,ECE 111,A01,507420,Staff,27,0,50,23
1713491052055,ECE 197,001,548057,Sievenpiper; Daniel F.,9998,0,9999,1
1713491053078,EDS 115,A00,507243,Choi; Bailey Miyeon,27,0,28,1
1713491054104,EDS 117,A01,494379,Staff,15,0,25,10
1713491055132,EDS 125,A00,507246,Hopkins; Megan Beth,27,0,30,3
1713491056160,EDS 128A,A01,507264,Fargason; Sharon Gayle,26,0,26,0
1713491057185,EDS 128B,A01,507293,Pappas; Elizabeth,30,0,30,0
1713491058209,EDS 139,A00,507294,Fargason; Sharon Gayle,30,0,30,0
1713491058209,EDS 139,B00,507313,Pappas; Elizabeth,30,0,30,0
1713491059237,EDS 201,A00,507315,Staff,18,0,30,12
1713491060261,EDS 203,A01,507317,Halter; Christopher P.,17,0,30,13
1713491061287,EDS 204R,A01,507319,Halter; Christopher P.,0,1,30,30
1713491061287,EDS 204R,B01,507331,Heinzman; Erica M.,22,0,30,8
1713491062316,EDS 206R,A00,507332,Staff,0,2,30,30
1713491062316,EDS 206R,B00,507343,Staff,23,0,30,7
1713491063341,EDS 250,A00,507344,Hemans; Patricia Ann Benitez,27,0,40,13
1713491064367,EDS 281,A00,507345,Daly; Alan J.,18,0,18,0
1713491065391,EDS 284,A00,507350,Daly; Alan J.,16,0,16,0
1713491066418,EDS 286,A00,507359,Fine; Sarah,18,0,18,0
1713491067444,EDS 289C,A01,507361,Daly; Alan J.,18,0,18,0
1713491068468,EDS 290,A00,507366,Hofstetter; Carolyn,15,0,15,0
1713491069497,LIGM 5A,A00,507421,Fischer-Grunski; Eva K,20,0,20,0
1713491070523,LIGM 5B,A00,507423,Fischer-Grunski; Eva K,20,0,20,0
1713491071548,LIGM 5C,A00,507425,Fischer-Grunski; Eva K,20,0,20,0
1713491072574,LIIT 5AS,A00,507427,Carnelos; Chiara,20,0,20,0
1713491073603,LIIT 5BS,A00,507430,Carnelos; Chiara,20,0,20,0
1713491074627,LIIT 5CS,A00,507432,Carnelos; Chiara,20,0,20,0
1713491075656,LISP 5A,A00,507541,Munoz Sanchez; Alicia,14,0,20,6
1713491076683,LISP 5B,A00,507671,Munoz Sanchez; Alicia,12,0,20,8
1713491077707,LISP 5C,A00,507696,Munoz Sanchez; Alicia,11,0,20,9
1713491078732,MAE 197,001,528363,Boechler; Nicholas Sebastia,9998,0,9999,1
1713491079762,MATH 197,001,523477,Kedlaya; Kiran S.,9999,0,9999,0
1713491079762,MATH 197,002,563811,Zhang; Danna,9998,0,9999,1
1713491080791,MCWP 40R,A00,518780,Staff,15,0,20,5
1713491080791,MCWP 40R,B00,518781,Staff,14,0,20,6
1713491080791,MCWP 40R,C00,518783,Staff,10,0,20,10
1713491081817,MCWP 50R,A00,518791,Staff,8,0,20,12
1713491081817,MCWP 50R,B00,518792,Staff,4,0,20,16
1713491081817,MCWP 50R,C00,518793,Staff,7,0,20,13
1713491081817,MCWP 50R,D00,518794,Staff,0,0,20,20
1713491081817,MCWP 50R,E00,518795,Staff,0,0,20,20
1713491081817,MCWP 50R,F00,518796,Staff,13,0,20,7
1713491081817,MCWP 50R,G00,518797,Staff,11,0,20,9
1713491082847,MMW 12R,A01,514034,Herbst; Matthew,5,0,16,11
1713491082847,MMW 12R,A02,514035,Herbst; Matthew,13,0,16,3
1713491083871,MMW 13R,A01,514037,Staff,0,5,16,16
1713491083871,MMW 13R,A02,514039,Staff,0,4,16,16
1713491085923,SIO 295LS,A00,523233,Staff,15,0,30,15
1713491086952,SIO 295S,A00,523232,Staff,15,0,30,15
1713491087979,SOCI 117,A01,494376,Staff,0,2,5,5
1713491089004,WES 237B,A00,494380,Staff,19,0,20,1
1713491091058,AESE 279B,A00,494370,Wade; Jon P,33,0,33,0
1713491092085,AIP 197,001,627712,Vespa; Emanuel Ignacio,9999,0,9999,0
1713491093112,ANAR 135S,A00,494369,Braswell; Geoffrey E.,0,0,0,0
1713491094137,CAT 124RS,A01,519847,Geibel; William,6,0,20,14
1713491095167,CAT 125RS,A01,515971,Geibel; William,6,0,20,14
1713491096195,CLRE 250,A00,511389,Morris; Sheldon,9996,0,9999,3
1713491097227,CLRE 251,A00,507176,Mehta; Ravindra L.,9996,0,9999,3
1713491097227,CLRE 251,B00,511410,Mehta; Ravindra L.,9998,0,9999,1
1713491098256,CLRE 252,A00,507189,Cuomo; Raphael Eduardo,9998,0,9999,1
1713491099280,CLRE 253,A00,507199,Vaida; Florin,9997,0,9999,2
1713491099280,CLRE 253,B00,507202,Vaida; Florin,9999,0,9999,0
1713491100310,CLRE 259,A00,507211,Patel; Hemal,9996,0,9999,3
1713491101334,CLRE 260,A00,507221,Cuomo; Raphael Eduardo,9999,0,9999,0
1713491102361,CLRE 297,001,507242,Cuomo; Raphael Eduardo,9999,0,9999,0
1713491103386,CSE 191,A00,516875,Minnes Kemp; Mor Mia,9999,0,9999,0
1713491104410,CSS 201S,A01,494383,Staff,35,0,35,0
1713491105439,CSS 202S,A01,494387,Staff,35,0,35,0
1713491106463,EAP 100,A00,516065,Staff,9792,0,9999,207
1713491107487,ECE 45,A01,507414,Staff,38,0,60,22
1713491108517,ECE 100,A01,507416,Baghdadchi; Saharnaz,0,0,20,20
1713491108517,ECE 100,A02,507418,Baghdadchi; Saharnaz,19,0,20,1
1713491109542,ECE 111,A01,507420,Staff,27,0,50,23
1713491110569,ECE 197,001,548057,Sievenpiper; Daniel F.,9998,0,9999,1
1713491111661,EDS 115,A00,507243,Choi; Bailey Miyeon,27,0,28,1
1713491112686,EDS 117,A01,494379,Staff,15,0,25,10
1713491113715,EDS 125,A00,507246,Hopkins; Megan Beth,27,0,30,3
1713491114739,EDS 128A,A01,507264,Fargason; Sharon Gayle,26,0,26,0
1713491115764,EDS 128B,A01,507293,Pappas; Elizabeth,30,0,30,0
1713491116789,EDS 139,A00,507294,Fargason; Sharon Gayle,30,0,30,0
1713491116789,EDS 139,B00,507313,Pappas; Elizabeth,30,0,30,0
1713491117874,EDS 201,A00,507315,Staff,18,0,30,12
1713491118904,EDS 203,A01,507317,Halter; Christopher P.,17,0,30,13
1713491119933,EDS 204R,A01,507319,Halter; Christopher P.,0,1,30,30
1713491119933,EDS 204R,B01,507331,Heinzman; Erica M.,22,0,30,8
1713491120957,EDS 206R,A00,507332,Staff,0,2,30,30
1713491120957,EDS 206R,B00,507343,Staff,23,0,30,7
1713491121984,EDS 250,A00,507344,Hemans; Patricia Ann Benitez,27,0,40,13
1713491123010,EDS 281,A00,507345,Daly; Alan J.,18,0,18,0
1713491124037,EDS 284,A00,507350,Daly; Alan J.,16,0,16,0
1713491125065,EDS 286,A00,507359,Fine; Sarah,18,0,18,0
1713491126094,EDS 289C,A01,507361,Daly; Alan J.,18,0,18,0
1713491127122,EDS 290,A00,507366,Hofstetter; Carolyn,15,0,15,0
1713491128148,LIGM 5A,A00,507421,Fischer-Grunski; Eva K,20,0,20,0
1713491129173,LIGM 5B,A00,507423,Fischer-Grunski; Eva K,20,0,20,0
1713491130199,LIGM 5C,A00,507425,Fischer-Grunski; Eva K,20,0,20,0
1713491131228,LIIT 5AS,A00,507427,Carnelos; Chiara,20,0,20,0
1713491132254,LIIT 5BS,A00,507430,Carnelos; Chiara,20,0,20,0
1713491133279,LIIT 5CS,A00,507432,Carnelos; Chiara,20,0,20,0
1713491134308,LISP 5A,A00,507541,Munoz Sanchez; Alicia,14,0,20,6
1713491135337,LISP 5B,A00,507671,Munoz Sanchez; Alicia,12,0,20,8
1713491136362,LISP 5C,A00,507696,Munoz Sanchez; Alicia,11,0,20,9
1713491137388,MAE 197,001,528363,Boechler; Nicholas Sebastia,9998,0,9999,1
1713491138415,MATH 197,001,523477,Kedlaya; Kiran S.,9999,0,9999,0
1713491138415,MATH 197,002,563811,Zhang; Danna,9998,0,9999,1
1713491139441,MCWP 40R,A00,518780,Staff,15,0,20,5
1713491139441,MCWP 40R,B00,518781,Staff,14,0,20,6
1713491139441,MCWP 40R,C00,518783,Staff,10,0,20,10
1713491140472,MCWP 50R,A00,518791,Staff,8,0,20,12
1713491140472,MCWP 50R,B00,518792,Staff,4,0,20,16
1713491140472,MCWP 50R,C00,518793,Staff,7,0,20,13
1713491140472,MCWP 50R,D00,518794,Staff,0,0,20,20
1713491140472,MCWP 50R,E00,518795,Staff,0,0,20,20
1713491140472,MCWP 50R,F00,518796,Staff,13,0,20,7
1713491140472,MCWP 50R,G00,518797,Staff,11,0,20,9
1713491141497,MMW 12R,A01,514034,Herbst; Matthew,5,0,16,11
1713491141497,MMW 12R,A02,514035,Herbst; Matthew,13,0,16,3
1713491142526,MMW 13R,A01,514037,Staff,0,5,16,16
1713491142526,MMW 13R,A02,514039,Staff,0,4,16,16
1713491144577,SIO 295LS,A00,523233,Staff,15,0,30,15
1713491145603,SIO 295S,A00,523232,Staff,15,0,30,15
1713491146626,SOCI 117,A01,494376,Staff,0,2,5,5
1713491147655,WES 237B,A00,494380,Staff,19,0,20,1
1713491149720,AESE 279B,A00,494370,Wade; Jon P,33,0,33,0
1713491150745,AIP 197,001,627712,Vespa; Emanuel Ignacio,9999,0,9999,0
1713491151770,ANAR 135S,A00,494369,Braswell; Geoffrey E.,0,0,0,0
1713491152795,CAT 124RS,A01,519847,Geibel; William,6,0,20,14
1713491153819,CAT 125RS,A01,515971,Geibel; William,6,0,20,14
1713491154844,CLRE 250,A00,511389,Morris; Sheldon,9996,0,9999,3
1713491155874,CLRE 251,A00,507176,Mehta; Ravindra L.,9996,0,9999,3
1713491155874,CLRE 251,B00,511410,Mehta; Ravindra L.,9998,0,9999,1
1713491156900,CLRE 252,A00,507189,Cuomo; Raphael Eduardo,9998,0,9999,1
1713491157927,CLRE 253,A00,507199,Vaida; Florin,9997,0,9999,2
1713491157927,CLRE 253,B00,507202,Vaida; Florin,9999,0,9999,0
1713491158953,CLRE 259,A00,507211,Patel; Hemal,9996,0,9999,3
1713491159980,CLRE 260,A00,507221,Cuomo; Raphael Eduardo,9999,0,9999,0
1713491161010,CLRE 297,001,507242,Cuomo; Raphael Eduardo,9999,0,9999,0
1713491162035,CSE 191,A00,516875,Minnes Kemp; Mor Mia,9999,0,9999,0
1713491163065,CSS 201S,A01,494383,Staff,35,0,35,0
1713491164095,CSS 202S,A01,494387,Staff,35,0,35,0
1713491165124,EAP 100,A00,516065,Staff,9792,0,9999,207
1713491166150,ECE 45,A01,507414,Staff,38,0,60,22
1713491167178,ECE 100,A01,507416,Baghdadchi; Saharnaz,0,0,20,20
1713491167178,ECE 100,A02,507418,Baghdadchi; Saharnaz,19,0,20,1
1713491168204,ECE 111,A01,507420,Staff,27,0,50,23
1713491169231,ECE 197,001,548057,Sievenpiper; Daniel F.,9998,0,9999,1
1713491170256,EDS 115,A00,507243,Choi; Bailey Miyeon,27,0,28,1
1713491171282,EDS 117,A01,494379,Staff,15,0,25,10
1713491172307,EDS 125,A00,507246,Hopkins; Megan Beth,27,0,30,3
1713491173332,EDS 128A,A01,507264,Fargason; Sharon Gayle,26,0,26,0
1713491174361,EDS 128B,A01,507293,Pappas; Elizabeth,30,0,30,0
1713491175387,EDS 139,A00,507294,Fargason; Sharon Gayle,30,0,30,0
1713491175387,EDS 139,B00,507313,Pappas; Elizabeth,30,0,30,0
1713491176415,EDS 201,A00,507315,Staff,18,0,30,12
1713491177440,EDS 203,A01,507317,Halter; Christopher P.,17,0,30,13
1713491178465,EDS 204R,A01,507319,Halter; Christopher P.,0,1,30,30
1713491178465,EDS 204R,B01,507331,Heinzman; Erica M.,22,0,30,8
1713491179490,EDS 206R,A00,507332,Staff,0,2,30,30
1713491179490,EDS 206R,B00,507343,Staff,23,0,30,7
1713491180519,EDS 250,A00,507344,Hemans; Patricia Ann Benitez,27,0,40,13
1713491181544,EDS 281,A00,507345,Daly; Alan J.,18,0,18,0
1713491182568,EDS 284,A00,507350,Daly; Alan J.,16,0,16,0
1713491183596,EDS 286,A00,507359,Fine; Sarah,18,0,18,0
1713491184621,EDS 289C,A01,507361,Daly; Alan J.,18,0,18,0
1713491185646,EDS 290,A00,507366,Hofstetter; Carolyn,15,0,15,0
1713491186719,LIGM 5A,A00,507421,Fischer-Grunski; Eva K,20,0,20,0
1713491187748,LIGM 5B,A00,507423,Fischer-Grunski; Eva K,20,0,20,0
1713491188777,LIGM 5C,A00,507425,Fischer-Grunski; Eva K,20,0,20,0
1713491189806,LIIT 5AS,A00,507427,Carnelos; Chiara,20,0,20,0
1713491190836,LIIT 5BS,A00,507430,Carnelos; Chiara,20,0,20,0
1713491191864,LIIT 5CS,A00,507432,Carnelos; Chiara,20,0,20,0
1713491192891,LISP 5A,A00,507541,Munoz Sanchez; Alicia,14,0,20,6
1713491193916,LISP 5B,A00,507671,Munoz Sanchez; Alicia,12,0,20,8
1713491194941,LISP 5C,A00,507696,Munoz Sanchez; Alicia,11,0,20,9
1713491195969,MAE 197,001,528363,Boechler; Nicholas Sebastia,9998,0,9999,1
1713491196994,MATH 197,001,523477,Kedlaya; Kiran S.,9999,0,9999,0
1713491196994,MATH 197,002,563811,Zhang; Danna,9998,0,9999,1
1713491198019,MCWP 40R,A00,518780,Staff,15,0,20,5
1713491198019,MCWP 40R,B00,518781,Staff,14,0,20,6
1713491198019,MCWP 40R,C00,518783,Staff,10,0,20,10
1713491199045,MCWP 50R,A00,518791,Staff,8,0,20,12
1713491199045,MCWP 50R,B00,518792,Staff,4,0,20,16
1713491199045,MCWP 50R,C00,518793,Staff,7,0,20,13
1713491199045,MCWP 50R,D00,518794,Staff,0,0,20,20
1713491199045,MCWP 50R,E00,518795,Staff,0,0,20,20
1713491199045,MCWP 50R,F00,518796,Staff,13,0,20,7
1713491199045,MCWP 50R,G00,518797,Staff,11,0,20,9
1713491200069,MMW 12R,A01,514034,Herbst; Matthew,5,0,16,11
1713491200069,MMW 12R,A02,514035,Herbst; Matthew,13,0,16,3
1713491201099,MMW 13R,A01,514037,Staff,0,5,16,16
1713491201099,MMW 13R,A02,514039,Staff,0,4,16,16
1713491203150,SIO 295LS,A00,523233,Staff,15,0,30,15
1713491204176,SIO 295S,A00,523232,Staff,15,0,30,15
1713491205205,SOCI 117,A01,494376,Staff,0,2,5,5
1713491206234,WES 237B,A00,494380,Staff,19,0,20,1
1713491208296,AESE 279B,A00,494370,Wade; Jon P,33,0,33,0
1713491209320,AIP 197,001,627712,Vespa; Emanuel Ignacio,9999,0,9999,0
1713491210345,ANAR 135S,A00,494369,Braswell; Geoffrey E.,0,0,0,0
1713491211372,CAT 124RS,A01,519847,Geibel; William,6,0,20,14
1713491212401,CAT 125RS,A01,515971,Geibel; William,6,0,20,14
1713491213426,CLRE 250,A00,511389,Morris; Sheldon,9996,0,9999,3
1713491214459,CLRE 251,A00,507176,Mehta; Ravindra L.,9996,0,9999,3
1713491214459,CLRE 251,B00,511410,Mehta; Ravindra L.,9998,0,9999,1
1713491215543,CLRE 252,A00,507189,Cuomo; Raphael Eduardo,9998,0,9999,1
1713491216570,CLRE 253,A00,507199,Vaida; Florin,9997,0,9999,2
1713491216570,CLRE 253,B00,507202,Vaida; Florin,9999,0,9999,0
1713491217595,CLRE 259,A00,507211,Patel; Hemal,9996,0,9999,3
1713491218623,CLRE 260,A00,507221,Cuomo; Raphael Eduardo,9999,0,9999,0
1713491219649,CLRE 297,001,507242,Cuomo; Raphael Eduardo,9999,0,9999,0
1713491220677,CSE 191,A00,516875,Minnes Kemp; Mor Mia,9999,0,9999,0
1713491221703,CSS 201S,A01,494383,Staff,35,0,35,0
1713491222732,CSS 202S,A01,494387,Staff,35,0,35,0
1713491223757,EAP 100,A00,516065,Staff,9792,0,9999,207
1713491224783,ECE 45,A01,507414,Staff,38,0,60,22
1713491225811,ECE 100,A01,507416,Baghdadchi; Saharnaz,0,0,20,20
1713491225811,ECE 100,A02,507418,Baghdadchi; Saharnaz,19,0,20,1
1713491226836,ECE 111,A01,507420,Staff,27,0,50,23
1713491227861,ECE 197,001,548057,Sievenpiper; Daniel F.,9998,0,9999,1
1713491228886,EDS 115,A00,507243,Choi; Bailey Miyeon,27,0,28,1
1713491229911,EDS 117,A01,494379,Staff,15,0,25,10
1713491230940,EDS 125,A00,507246,Hopkins; Megan Beth,27,0,30,3
1713491231965,EDS 128A,A01,507264,Fargason; Sharon Gayle,26,0,26,0
1713491232991,EDS 128B,A01,507293,Pappas; Elizabeth,30,0,30,0
1713491234019,EDS 139,A00,507294,Fargason; Sharon Gayle,30,0,30,0
1713491234019,EDS 139,B00,507313,Pappas; Elizabeth,30,0,30,0
1713491235046,EDS 201,A00,507315,Staff,18,0,30,12
1713491236075,EDS 203,A01,507317,Halter; Christopher P.,17,0,30,13
1713491237099,EDS 204R,A01,507319,Halter; Christopher P.,0,1,30,30
1713491237099,EDS 204R,B01,507331,Heinzman; Erica M.,22,0,30,8
1713491238126,EDS 206R,A00,507332,Staff,0,2,30,30
1713491238126,EDS 206R,B00,507343,Staff,23,0,30,7
1713491239151,EDS 250,A00,507344,Hemans; Patricia Ann Benitez,27,0,40,13
1713491240182,EDS 281,A00,507345,Daly; Alan J.,18,0,18,0
1713491241210,EDS 284,A00,507350,Daly; Alan J.,16,0,16,0
1713491242238,EDS 286,A00,507359,Fine; Sarah,18,0,18,0
1713491243265,EDS 289C,A01,507361,Daly; Alan J.,18,0,18,0
1713491244293,EDS 290,A00,507366,Hofstetter; Carolyn,15,0,15,0
1713491245318,LIGM 5A,A00,507421,Fischer-Grunski; Eva K,20,0,20,0
1713491246344,LIGM 5B,A00,507423,Fischer-Grunski; Eva K,20,0,20,0
1713491247369,LIGM 5C,A00,507425,Fischer-Grunski; Eva K,20,0,20,0
1713491248395,LIIT 5AS,A00,507427,Carnelos; Chiara,20,0,20,0
1713491249427,LIIT 5BS,A00,507430,Carnelos; Chiara,20,0,20,0
1713491250456,LIIT 5CS,A00,507432,Carnelos; Chiara,20,0,20,0
1713491251484,LISP 5A,A00,507541,Munoz Sanchez; Alicia,14,0,20,6
1713491252509,LISP 5B,A00,507671,Munoz Sanchez; Alicia,12,0,20,8
1713491253538,LISP 5C,A00,507696,Munoz Sanchez; Alicia,11,0,20,9
1713491254566,MAE 197,001,528363,Boechler; Nicholas Sebastia,9998,0,9999,1
1713491255591,MATH 197,001,523477,Kedlaya; Kiran S.,9999,0,9999,0
1713491255591,MATH 197,002,563811,Zhang; Danna,9998,0,9999,1
1713491256617,MCWP 40R,A00,518780,Staff,15,0,20,5
1713491256617,MCWP 40R,B00,518781,Staff,14,0,20,6
1713491256617,MCWP 40R,C00,518783,Staff,10,0,20,10
1713491257645,MCWP 50R,A00,518791,Staff,8,0,20,12
1713491257645,MCWP 50R,B00,518792,Staff,4,0,20,16
1713491257645,MCWP 50R,C00,518793,Staff,7,0,20,13
1713491257645,MCWP 50R,D00,518794,Staff,0,0,20,20
1713491257645,MCWP 50R,E00,518795,Staff,0,0,20,20
1713491257645,MCWP 50R,F00,518796,Staff,13,0,20,7
1713491257645,MCWP 50R,G00,518797,Staff,11,0,20,9
1713491258669,MMW 12R,A01,514034,Herbst; Matthew,5,0,16,11
1713491258669,MMW 12R,A02,514035,Herbst; Matthew,13,0,16,3
1713491259696,MMW 13R,A01,514037,Staff,0,5,16,16
1713491259696,MMW 13R,A02,514039,Staff,0,4,16,16
1713491261745,SIO 295LS,A00,523233,Staff,15,0,30,15
1713491262769,SIO 295S,A00,523232,Staff,15,0,30,15
1713491263798,SOCI 117,A01,494376,Staff,0,2,5,5
1713491264831,WES 237B,A00,494380,Staff,19,0,20,1
1713491266888,AESE 279B,A00,494370,Wade; Jon P,33,0,33,0
1713491267914,AIP 197,001,627712,Vespa; Emanuel Ignacio,9999,0,9999,0
1713491268939,ANAR 135S,A00,494369,Braswell; Geoffrey E.,0,0,0,0
1713491269967,CAT 124RS,A01,519847,Geibel; William,6,0,20,14
1713491270992,CAT 125RS,A01,515971,Geibel; William,6,0,20,14
1713491272017,CLRE 250,A00,511389,Morris; Sheldon,9996,0,9999,3
1713491273047,CLRE 251,A00,507176,Mehta; Ravindra L.,9996,0,9999,3
1713491273047,CLRE 251,B00,511410,Mehta; Ravindra L.,9998,0,9999,1
1713491274073,CLRE 252,A00,507189,Cuomo; Raphael Eduardo,9998,0,9999,1
1713491275097,CLRE 253,A00,507199,Vaida; Florin,9997,0,9999,2
1713491275097,CLRE 253,B00,507202,Vaida; Florin,9999,0,9999,0
1713491276123,CLRE 259,A00,507211,Patel; Hemal,9996,0,9999,3
1713491277149,CLRE 260,A00,507221,Cuomo; Raphael Eduardo,9999,0,9999,0
1713491278174,CLRE 297,001,507242,Cuomo; Raphael Eduardo,9999,0,9999,0
1713491279200,CSE 191,A00,516875,Minnes Kemp; Mor Mia,9999,0,9999,0
1713491280225,CSS 201S,A01,494383,Staff,35,0,35,0
1713491281254,CSS 202S,A01,494387,Staff,35,0,35,0
1713491282282,EAP 100,A00,516065,Staff,9792,0,9999,207
1713491283311,ECE 45,A01,507414,Staff,38,0,60,22
1713491284341,ECE 100,A01,507416,Baghdadchi; Saharnaz,0,0,20,20
1713491284341,ECE 100,A02,507418,Baghdadchi; Saharnaz,19,0,20,1
1713491285365,ECE 111,A01,507420,Staff,27,0,50,23
1713491286393,ECE 197,001,548057,Sievenpiper; Daniel F.,9998,0,9999,1
1713491287417,EDS 115,A00,507243,Choi; Bailey Miyeon,27,0,28,1
1713491288446,EDS 117,A01,494379,Staff,15,0,25,10
1713491289476,EDS 125,A00,507246,Hopkins; Megan Beth,27,0,30,3
1713491290505,EDS 128A,A01,507264,Fargason; Sharon Gayle,26,0,26,0
1713491291531,EDS 128B,A01,507293,Pappas; Elizabeth,30,0,30,0
1713491292560,EDS 139,A00,507294,Fargason; Sharon Gayle,30,0,30,0
1713491292560,EDS 139,B00,507313,Pappas; Elizabeth,30,0,30,0
1713491293584,EDS 201,A00,507315,Staff,18,0,30,12
1713491294609,EDS 203,A01,507317,Halter; Christopher P.,17,0,30,13
1713491295634,EDS 204R,A01,507319,Halter; Christopher P.,0,1,30,30
1713491295634,EDS 204R,B01,507331,Heinzman; Erica M.,22,0,30,8
1713491296661,EDS 206R,A00,507332,Staff,0,2,30,30
1713491296661,EDS 206R,B00,507343,Staff,23,0,30,7
1713491297686,EDS 250,A00,507344,Hemans; Patricia Ann Benitez,27,0,40,13
1713491298711,EDS 281,A00,507345,Daly; Alan J.,18,0,18,0
1713491299737,EDS 284,A00,507350,Daly; Alan J.,16,0,16,0
1713491300763,EDS 286,A00,507359,Fine; Sarah,18,0,18,0
1713491301789,EDS 289C,A01,507361,Daly; Alan J.,18,0,18,0
1713491302815,EDS 290,A00,507366,Hofstetter; Carolyn,15,0,15,0
1713491303845,LIGM 5A,A00,507421,Fischer-Grunski; Eva K,20,0,20,0
1713491304871,LIGM 5B,A00,507423,Fischer-Grunski; Eva K,20,0,20,0
1713491305901,LIGM 5C,A00,507425,Fischer-Grunski; Eva K,20,0,20,0
1713491306927,LIIT 5AS,A00,507427,Carnelos; Chiara,20,0,20,0
1713491307953,LIIT 5BS,A00,507430,Carnelos; Chiara,20,0,20,0
1713491308978,LIIT 5CS,A00,507432,Carnelos; Chiara,20,0,20,0
1713491310007,LISP 5A,A00,507541,Munoz Sanchez; Alicia,14,0,20,6
1713491311034,LISP 5B,A00,507671,Munoz Sanchez; Alicia,12,0,20,8
1713491312061,LISP 5C,A00,507696,Munoz Sanchez; Alicia,11,0,20,9
1713491313087,MAE 197,001,528363,Boechler; Nicholas Sebastia,9998,0,9999,1
1713491314116,MATH 197,001,523477,Kedlaya; Kiran S.,9999,0,9999,0
1713491314116,MATH 197,002,563811,Zhang; Danna,9998,0,9999,1
1713491315141,MCWP 40R,A00,518780,Staff,15,0,20,5
1713491315141,MCWP 40R,B00,518781,Staff,14,0,20,6
1713491315141,MCWP 40R,C00,518783,Staff,10,0,20,10
1713491316168,MCWP 50R,A00,518791,Staff,8,0,20,12
1713491316168,MCWP 50R,B00,518792,Staff,4,0,20,16
1713491316168,MCWP 50R,C00,518793,Staff,7,0,20,13
1713491316168,MCWP 50R,D00,518794,Staff,0,0,20,20
1713491316168,MCWP 50R,E00,518795,Staff,0,0,20,20
1713491316168,MCWP 50R,F00,518796,Staff,13,0,20,7
1713491316168,MCWP 50R,G00,518797,Staff,11,0,20,9
1713491317194,MMW 12R,A01,514034,Herbst; Matthew,5,0,16,11
1713491317194,MMW 12R,A02,514035,Herbst; Matthew,13,0,16,3
1713491318217,MMW 13R,A01,514037,Staff,0,5,16,16
1713491318217,MMW 13R,A02,514039,Staff,0,4,16,16
1713491320324,SIO 295LS,A00,523233,Staff,15,0,30,15
1713491321350,SIO 295S,A00,523232,Staff,15,0,30,15
1713491322373,SOCI 117,A01,494376,Staff,0,2,5,5
1713491323398,WES 237B,A00,494380,Staff,19,0,20,1
1713491325474,AESE 279B,A00,494370,Wade; Jon P,33,0,33,0
1713491326498,AIP 197,001,627712,Vespa; Emanuel Ignacio,9999,0,9999,0
1713491327523,ANAR 135S,A00,494369,Braswell; Geoffrey E.,0,0,0,0
1713491328547,CAT 124RS,A01,519847,Geibel; William,6,0,20,14
1713491329574,CAT 125RS,A01,515971,Geibel; William,6,0,20,14
1713491330601,CLRE 250,A00,511389,Morris; Sheldon,9996,0,9999,3
1713491331627,CLRE 251,A00,507176,Mehta; Ravindra L.,9996,0,9999,3
1713491331627,CLRE 251,B00,511410,Mehta; Ravindra L.,9998,0,9999,1
1713491332655,CLRE 252,A00,507189,Cuomo; Raphael Eduardo,9998,0,9999,1
1713491333680,CLRE 253,A00,507199,Vaida; Florin,9997,0,9999,2
1713491333680,CLRE 253,B00,507202,Vaida; Florin,9999,0,9999,0
1713491334711,CLRE 259,A00,507211,Patel; Hemal,9996,0,9999,3
1713491335735,CLRE 260,A00,507221,Cuomo; Raphael Eduardo,9999,0,9999,0
1713491336760,CLRE 297,001,507242,Cuomo; Raphael Eduardo,9999,0,9999,0
1713491337786,CSE 191,A00,516875,Minnes Kemp; Mor Mia,9999,0,9999,0
1713491338814,CSS 201S,A01,494383,Staff,35,0,35,0
1713491339839,CSS 202S,A01,494387,Staff,35,0,35,0
1713491340865,EAP 100,A00,516065,Staff,9792,0,9999,207
1713491341895,ECE 45,A01,507414,Staff,38,0,60,22
1713491342920,ECE 100,A01,507416,Baghdadchi; Saharnaz,0,0,20,20
1713491342920,ECE 100,A02,507418,Baghdadchi; Saharnaz,19,0,20,1
1713491343946,ECE 111,A01,507420,Staff,27,0,50,23
1713491344973,ECE 197,001,548057,Sievenpiper; Daniel F.,9998,0,9999,1
1713491346002,EDS 115,A00,507243,Choi; Bailey Miyeon,27,0,28,1
1713491347027,EDS 117,A01,494379,Staff,15,0,25,10
1713491348052,EDS 125,A00,507246,Hopkins; Megan Beth,27,0,30,3
1713491349080,EDS 128A,A01,507264,Fargason; Sharon Gayle,26,0,26,0
1713491350109,EDS 128B,A01,507293,Pappas; Elizabeth,30,0,30,0
1713491351132,EDS 139,A00,507294,Fargason; Sharon Gayle,30,0,30,0
1713491351132,EDS 139,B00,507313,Pappas; Elizabeth,30,0,30,0
1713491352161,EDS 201,A00,507315,Staff,18,0,30,12
1713491353187,EDS 203,A01,507317,Halter; Christopher P.,17,0,30,13
1713491354214,EDS 204R,A01,507319,Halter; Christopher P.,0,1,30,30
1713491354214,EDS 204R,B01,507331,Heinzman; Erica M.,22,0,30,8
1713491355241,EDS 206R,A00,507332,Staff,0,2,30,30
1713491355241,EDS 206R,B00,507343,Staff,23,0,30,7
1713491356267,EDS 250,A00,507344,Hemans; Patricia Ann Benitez,27,0,40,13
1713491357292,EDS 281,A00,507345,Daly; Alan J.,18,0,18,0
1713491358317,EDS 284,A00,507350,Daly; Alan J.,16,0,16,0
1713491359343,EDS 286,A00,507359,Fine; Sarah,18,0,18,0
1713491360373,EDS 289C,A01,507361,Daly; Alan J.,18,0,18,0
1713491361401,EDS 290,A00,507366,Hofstetter; Carolyn,15,0,15,0
1713491362425,LIGM 5A,A00,507421,Fischer-Grunski; Eva K,20,0,20,0
1713491363450,LIGM 5B,A00,507423,Fischer-Grunski; Eva K,20,0,20,0
1713491364480,LIGM 5C,A00,507425,Fischer-Grunski; Eva K,20,0,20,0
1713491365507,LIIT 5AS,A00,507427,Carnelos; Chiara,20,0,20,0
1713491366533,LIIT 5BS,A00,507430,Carnelos; Chiara,20,0,20,0
1713491367563,LIIT 5CS,A00,507432,Carnelos; Chiara,20,0,20,0
1713491368589,LISP 5A,A00,507541,Munoz Sanchez; Alicia,14,0,20,6
1713491369614,LISP 5B,A00,507671,Munoz Sanchez; Alicia,12,0,20,8
1713491370638,LISP 5C,A00,507696,Munoz Sanchez; Alicia,11,0,20,9
1713491371667,MAE 197,001,528363,Boechler; Nicholas Sebastia,9998,0,9999,1
1713491372692,MATH 197,001,523477,Kedlaya; Kiran S.,9999,0,9999,0
1713491372692,MATH 197,002,563811,Zhang; Danna,9998,0,9999,1
1713491373717,MCWP 40R,A00,518780,Staff,15,0,20,5
1713491373717,MCWP 40R,B00,518781,Staff,14,0,20,6
1713491373717,MCWP 40R,C00,518783,Staff,10,0,20,10
1713491374746,MCWP 50R,A00,518791,Staff,8,0,20,12
1713491374746,MCWP 50R,B00,518792,Staff,4,0,20,16
1713491374746,MCWP 50R,C00,518793,Staff,7,0,20,13
1713491374746,MCWP 50R,D00,518794,Staff,0,0,20,20
1713491374746,MCWP 50R,E00,518795,Staff,0,0,20,20
1713491374746,MCWP 50R,F00,518796,Staff,13,0,20,7
1713491374746,MCWP 50R,G00,518797,Staff,11,0,20,9
1713491375773,MMW 12R,A01,514034,Herbst; Matthew,5,0,16,11
1713491375773,MMW 12R,A02,514035,Herbst; Matthew,13,0,16,3
1713491376801,MMW 13R,A01,514037,Staff,0,5,16,16
1713491376801,MMW 13R,A02,514039,Staff,0,4,16,16
1713491378854,SIO 295LS,A00,523233,Staff,15,0,30,15
1713491379879,SIO 295S,A00,523232,Staff,15,0,30,15
1713491380905,SOCI 117,A01,494376,Staff,0,2,5,5
1713491381935,WES 237B,A00,494380,Staff,19,0,20,1
1713491384000,AESE 279B,A00,494370,Wade; Jon P,33,0,33,0
1713491385024,AIP 197,001,627712,Vespa; Emanuel Ignacio,9999,0,9999,0
1713491386048,ANAR 135S,A00,494369,Braswell; Geoffrey E.,0,0,0,0
1713491387074,CAT 124RS,A01,519847,Geibel; William,6,0,20,14
1713491388099,CAT 125RS,A01,515971,Geibel; William,6,0,20,14
1713491389125,CLRE 250,A00,511389,Morris; Sheldon,9996,0,9999,3
1713491390154,CLRE 251,A00,507176,Mehta; Ravindra L.,9996,0,9999,3
1713491390154,CLRE 251,B00,511410,Mehta; Ravindra L.,9998,0,9999,1
1713491391179,CLRE 252,A00,507189,Cuomo; Raphael Eduardo,9998,0,9999,1
1713491392204,CLRE 253,A00,507199,Vaida; Florin,9997,0,9999,2
1713491392204,CLRE 253,B00,507202,Vaida; Florin,9999,0,9999,0
1713491393232,CLRE 259,A00,507211,Patel; Hemal,9996,0,9999,3
1713491394260,CLRE 260,A00,507221,Cuomo; Raphael Eduardo,9999,0,9999,0
1713491395285,CLRE 297,001,507242,Cuomo; Raphael Eduardo,9999,0,9999,0
1713491396312,CSE 191,A00,516875,Minnes Kemp; Mor Mia,9999,0,9999,0
1713491397341,CSS 201S,A01,494383,Staff,35,0,35,0
1713491398365,CSS 202S,A01,494387,Staff,35,0,35,0
1713491399388,EAP 100,A00,516065,Staff,9792,0,9999,207
1713491400418,ECE 45,A01,507414,Staff,38,0,60,22
1713491401442,ECE 100,A01,507416,Baghdadchi; Saharnaz,0,0,20,20
1713491401442,ECE 100,A02,507418,Baghdadchi; Saharnaz,19,0,20,1
1713491402467,ECE 111,A01,507420,Staff,27,0,50,23
1713491403496,ECE 197,001,548057,Sievenpiper; Daniel F.,9998,0,9999,1
1713491404523,EDS 115,A00,507243,Choi; Bailey Miyeon,27,0,28,1
1713491405548,EDS 117,A01,494379,Staff,15,0,25,10
1713491406573,EDS 125,A00,507246,Hopkins; Megan Beth,27,0,30,3
1713491407601,EDS 128A,A01,507264,Fargason; Sharon Gayle,26,0,26,0
1713491408627,EDS 128B,A01,507293,Pappas; Elizabeth,30,0,30,0
1713491409655,EDS 139,A00,507294,Fargason; Sharon Gayle,30,0,30,0
1713491409655,EDS 139,B00,507313,Pappas; Elizabeth,30,0,30,0
1713491410683,EDS 201,A00,507315,Staff,18,0,30,12
1713491411708,EDS 203,A01,507317,Halter; Christopher P.,17,0,30,13
1713491412736,EDS 204R,A01,507319,Halter; Christopher P.,0,1,30,30
1713491412736,EDS 204R,B01,507331,Heinzman; Erica M.,22,0,30,8
1713491413764,EDS 206R,A00,507332,Staff,0,2,30,30
1713491413764,EDS 206R,B00,507343,Staff,23,0,30,7
1713491414793,EDS 250,A00,507344,Hemans; Patricia Ann Benitez,27,0,40,13
1713491415818,EDS 281,A00,507345,Daly; Alan J.,18,0,18,0
1713491416843,EDS 284,A00,507350,Daly; Alan J.,16,0,16,0
1713491417868,EDS 286,A00,507359,Fine; Sarah,18,0,18,0
1713491418892,EDS 289C,A01,507361,Daly; Alan J.,18,0,18,0
1713491419920,EDS 290,A00,507366,Hofstetter; Carolyn,15,0,15,0
1713491420951,LIGM 5A,A00,507421,Fischer-Grunski; Eva K,20,0,20,0
1713491421981,LIGM 5B,A00,507423,Fischer-Grunski; Eva K,20,0,20,0
1713491423060,LIGM 5C,A00,507425,Fischer-Grunski; Eva K,20,0,20,0
1713491424087,LIIT 5AS,A00,507427,Carnelos; Chiara,20,0,20,0
1713491425112,LIIT 5BS,A00,507430,Carnelos; Chiara,20,0,20,0
1713491426136,LIIT 5CS,A00,507432,Carnelos; Chiara,20,0,20,0
1713491427162,LISP 5A,A00,507541,Munoz Sanchez; Alicia,14,0,20,6
1713491428192,LISP 5B,A00,507671,Munoz Sanchez; Alicia,12,0,20,8
1713491429219,LISP 5C,A00,507696,Munoz Sanchez; Alicia,11,0,20,9
1713491430246,MAE 197,001,528363,Boechler; Nicholas Sebastia,9998,0,9999,1
1713491431270,MATH 197,001,523477,Kedlaya; Kiran S.,9999,0,9999,0
1713491431270,MATH 197,002,563811,Zhang; Danna,9998,0,9999,1
1713491432295,MCWP 40R,A00,518780,Staff,15,0,20,5
1713491432295,MCWP 40R,B00,518781,Staff,14,0,20,6
1713491432295,MCWP 40R,C00,518783,Staff,10,0,20,10
1713491433323,MCWP 50R,A00,518791,Staff,8,0,20,12
1713491433323,MCWP 50R,B00,518792,Staff,4,0,20,16
1713491433323,MCWP 50R,C00,518793,Staff,7,0,20,13
1713491433323,MCWP 50R,D00,518794,Staff,0,0,20,20
1713491433323,MCWP 50R,E00,518795,Staff,0,0,20,20
1713491433323,MCWP 50R,F00,518796,Staff,13,0,20,7
1713491433323,MCWP 50R,G00,518797,Staff,11,0,20,9
1713491434347,MMW 12R,A01,514034,Herbst; Matthew,5,0,16,11
1713491434347,MMW 12R,A02,514035,Herbst; Matthew,13,0,16,3
1713491435374,MMW 13R,A01,514037,Staff,0,5,16,16
1713491435374,MMW 13R,A02,514039,Staff,0,4,16,16
1713491437427,SIO 295LS,A00,523233,Staff,15,0,30,15
1713491438455,SIO 295S,A00,523232,Staff,15,0,30,15
1713491439480,SOCI 117,A01,494376,Staff,0,2,5,5
1713491440508,WES 237B,A00,494380,Staff,19,0,20,1
1713491442585,AESE 279B,A00,494370,Wade; Jon P,33,0,33,0
1713491443610,AIP 197,001,627712,Vespa; Emanuel Ignacio,9999,0,9999,0
1713491444635,ANAR 135S,A00,494369,Braswell; Geoffrey E.,0,0,0,0
1713491445660,CAT 124RS,A01,519847,Geibel; William,6,0,20,14
1713491446726,CAT 125RS,A01,515971,Geibel; William,6,0,20,14
1713491447753,CLRE 250,A00,511389,Morris; Sheldon,9996,0,9999,3
1713491448783,CLRE 251,A00,507176,Mehta; Ravindra L.,9996,0,9999,3
1713491448783,CLRE 251,B00,511410,Mehta; Ravindra L.,9998,0,9999,1
1713491449808,CLRE 252,A00,507189,Cuomo; Raphael Eduardo,9998,0,9999,1
1713491450838,CLRE 253,A00,507199,Vaida; Florin,9997,0,9999,2
1713491450838,CLRE 253,B00,507202,Vaida; Florin,9999,0,9999,0
1713491451865,CLRE 259,A00,507211,Patel; Hemal,9996,0,9999,3
1713491452892,CLRE 260,A00,507221,Cuomo; Raphael Eduardo,9999,0,9999,0
1713491453920,CLRE 297,001,507242,Cuomo; Raphael Eduardo,9999,0,9999,0
1713491454943,CSE 191,A00,516875,Minnes Kemp; Mor Mia,9999,0,9999,0
1713491455968,CSS 201S,A01,494383,Staff,35,0,35,0
1713491456993,CSS 202S,A01,494387,Staff,35,0,35,0
1713491458017,EAP 100,A00,516065,Staff,9792,0,9999,207
1713491459043,ECE 45,A01,507414,Staff,38,0,60,22
1713491460067,ECE 100,A01,507416,Baghdadchi; Saharnaz,0,0,20,20
1713491460067,ECE 100,A02,507418,Baghdadchi; Saharnaz,19,0,20,1
1713491461096,ECE 111,A01,507420,Staff,27,0,50,23
1713491462120,ECE 197,001,548057,Sievenpiper; Daniel F.,9998,0,9999,1
1713491463151,EDS 115,A00,507243,Choi; Bailey Miyeon,27,0,28,1
1713491464178,EDS 117,A01,494379,Staff,15,0,25,10
1713491465209,EDS 125,A00,507246,Hopkins; Megan Beth,27,0,30,3
1713491466234,EDS 128A,A01,507264,Fargason; Sharon Gayle,26,0,26,0
1713491467260,EDS 128B,A01,507293,Pappas; Elizabeth,30,0,30,0
1713491468285,EDS 139,A00,507294,Fargason; Sharon Gayle,30,0,30,0
1713491468285,EDS 139,B00,507313,Pappas; Elizabeth,30,0,30,0
1713491469309,EDS 201,A00,507315,Staff,18,0,30,12
1713491470337,EDS 203,A01,507317,Halter; Christopher P.,17,0,30,13
1713491471366,EDS 204R,A01,507319,Halter; Christopher P.,0,1,30,30
1713491471366,EDS 204R,B01,507331,Heinzman; Erica M.,22,0,30,8
1713491472394,EDS 206R,A00,507332,Staff,0,2,30,30
1713491472394,EDS 206R,B00,507343,Staff,23,0,30,7
1713491473422,EDS 250,A00,507344,Hemans; Patricia Ann Benitez,27,0,40,13
1713491474447,EDS 281,A00,507345,Daly; Alan J.,18,0,18,0
1713491475473,EDS 284,A00,507350,Daly; Alan J.,16,0,16,0
1713491476499,EDS 286,A00,507359,Fine; Sarah,18,0,18,0
1713491477527,EDS 289C,A01,507361,Daly; Alan J.,18,0,18,0
1713491478553,EDS 290,A00,507366,Hofstetter; Carolyn,15,0,15,0
1713491479581,LIGM 5A,A00,507421,Fischer-Grunski; Eva K,20,0,20,0
1713491480607,LIGM 5B,A00,507423,Fischer-Grunski; Eva K,20,0,20,0
1713491481633,LIGM 5C,A00,507425,Fischer-Grunski; Eva K,20,0,20,0
1713491482658,LIIT 5AS,A00,507427,Carnelos; Chiara,20,0,20,0
1713491483687,LIIT 5BS,A00,507430,Carnelos; Chiara,20,0,20,0
1713491484711,LIIT 5CS,A00,507432,Carnelos; Chiara,20,0,20,0
1713491485735,LISP 5A,A00,507541,Munoz Sanchez; Alicia,14,0,20,6
1713491486764,LISP 5B,A00,507671,Munoz Sanchez; Alicia,12,0,20,8
1713491487790,LISP 5C,A00,507696,Munoz Sanchez; Alicia,11,0,20,9
1713491488815,MAE 197,001,528363,Boechler; Nicholas Sebastia,9998,0,9999,1
1713491489840,MATH 197,001,523477,Kedlaya; Kiran S.,9999,0,9999,0
1713491489840,MATH 197,002,563811,Zhang; Danna,9998,0,9999,1
1713491490865,MCWP 40R,A00,518780,Staff,15,0,20,5
1713491490865,MCWP 40R,B00,518781,Staff,14,0,20,6
1713491490865,MCWP 40R,C00,518783,Staff,10,0,20,10
1713491491891,MCWP 50R,A00,518791,Staff,8,0,20,12
1713491491891,MCWP 50R,B00,518792,Staff,4,0,20,16
1713491491891,MCWP 50R,C00,518793,Staff,7,0,20,13
1713491491891,MCWP 50R,D00,518794,Staff,0,0,20,20
1713491491891,MCWP 50R,E00,518795,Staff,0,0,20,20
1713491491891,MCWP 50R,F00,518796,Staff,13,0,20,7
1713491491891,MCWP 50R,G00,518797,Staff,11,0,20,9
1713491492917,MMW 12R,A01,514034,Herbst; Matthew,5,0,16,11
1713491492917,MMW 12R,A02,514035,Herbst; Matthew,13,0,16,3
1713491493945,MMW 13R,A01,514037,Staff,0,5,16,16
1713491493945,MMW 13R,A02,514039,Staff,0,4,16,16
1713491495996,SIO 295LS,A00,523233,Staff,15,0,30,15
1713491497022,SIO 295S,A00,523232,Staff,15,0,30,15
1713491498046,SOCI 117,A01,494376,Staff,0,2,5,5
1713491499073,WES 237B,A00,494380,Staff,19,0,20,1
1713491501140,AESE 279B,A00,494370,Wade; Jon P,33,0,33,0
1713491502168,AIP 197,001,627712,Vespa; Emanuel Ignacio,9999,0,9999,0
1713491503194,ANAR 135S,A00,494369,Braswell; Geoffrey E.,0,0,0,0
1713491504218,CAT 124RS,A01,519847,Geibel; William,6,0,20,14
1713491505243,CAT 125RS,A01,515971,Geibel; William,6,0,20,14
1713491506274,CLRE 250,A00,511389,Morris; Sheldon,9996,0,9999,3
1713491507303,CLRE 251,A00,507176,Mehta; Ravindra L.,9996,0,9999,3
1713491507303,CLRE 251,B00,511410,Mehta; Ravindra L.,9998,0,9999,1
1713491508329,CLRE 252,A00,507189,Cuomo; Raphael Eduardo,9998,0,9999,1
1713491509359,CLRE 253,A00,507199,Vaida; Florin,9997,0,9999,2
1713491509359,CLRE 253,B00,507202,Vaida; Florin,9999,0,9999,0
1713491510386,CLRE 259,A00,507211,Patel; Hemal,9996,0,9999,3
1713491511411,CLRE 260,A00,507221,Cuomo; Raphael Eduardo,9999,0,9999,0
1713491512437,CLRE 297,001,507242,Cuomo; Raphael Eduardo,9999,0,9999,0
1713491513463,CSE 191,A00,516875,Minnes Kemp; Mor Mia,9999,0,9999,0
1713491514492,CSS 201S,A01,494383,Staff,35,0,35,0
1713491515521,CSS 202S,A01,494387,Staff,35,0,35,0
1713491516548,EAP 100,A00,516065,Staff,9792,0,9999,207
1713491517577,ECE 45,A01,507414,Staff,38,0,60,22
1713491518603,ECE 100,A01,507416,Baghdadchi; Saharnaz,0,0,20,20
1713491518603,ECE 100,A02,507418,Baghdadchi; Saharnaz,19,0,20,1
1713491519631,ECE 111,A01,507420,Staff,27,0,50,23
1713491520656,ECE 197,001,548057,Sievenpiper; Daniel F.,9998,0,9999,1
1713491521683,EDS 115,A00,507243,Choi; Bailey Miyeon,27,0,28,1
1713491522707,EDS 117,A01,494379,Staff,15,0,25,10
1713491523733,EDS 125,A00,507246,Hopkins; Megan Beth,27,0,30,3
1713491524758,EDS 128A,A01,507264,Fargason; Sharon Gayle,26,0,26,0
1713491525783,EDS 128B,A01,507293,Pappas; Elizabeth,30,0,30,0
1713491526862,EDS 139,A00,507294,Fargason; Sharon Gayle,30,0,30,0
1713491526862,EDS 139,B00,507313,Pappas; Elizabeth,30,0,30,0
1713491527887,EDS 201,A00,507315,Staff,18,0,30,12
1713491528915,EDS 203,A01,507317,Halter; Christopher P.,17,0,30,13
1713491529944,EDS 204R,A01,507319,Halter; Christopher P.,0,1,30,30
1713491529944,EDS 204R,B01,507331,Heinzman; Erica M.,22,0,30,8
1713491530969,EDS 206R,A00,507332,Staff,0,2,30,30
1713491530969,EDS 206R,B00,507343,Staff,23,0,30,7
1713491531997,EDS 250,A00,507344,Hemans; Patricia Ann Benitez,27,0,40,13
1713491533022,EDS 281,A00,507345,Daly; Alan J.,18,0,18,0
1713491534047,EDS 284,A00,507350,Daly; Alan J.,16,0,16,0
1713491535074,EDS 286,A00,507359,Fine; Sarah,18,0,18,0
1713491536099,EDS 289C,A01,507361,Daly; Alan J.,18,0,18,0
1713491537128,EDS 290,A00,507366,Hofstetter; Carolyn,15,0,15,0
1713491538153,LIGM 5A,A00,507421,Fischer-Grunski; Eva K,20,0,20,0
1713491539181,LIGM 5B,A00,507423,Fischer-Grunski; Eva K,20,0,20,0
1713491540209,LIGM 5C,A00,507425,Fischer-Grunski; Eva K,20,0,20,0
1713491541234,LIIT 5AS,A00,507427,Carnelos; Chiara,20,0,20,0
1713491542259,LIIT 5BS,A00,507430,Carnelos; Chiara,20,0,20,0
1713491543286,LIIT 5CS,A00,507432,Carnelos; Chiara,20,0,20,0
1713491544315,LISP 5A,A00,507541,Munoz Sanchez; Alicia,14,0,20,6
1713491545341,LISP 5B,A00,507671,Munoz Sanchez; Alicia,12,0,20,8
1713491546366,LISP 5C,A00,507696,Munoz Sanchez; Alicia,11,0,20,9
1713491547391,MAE 197,001,528363,Boechler; Nicholas Sebastia,9998,0,9999,1
1713491548416,MATH 197,001,523477,Kedlaya; Kiran S.,9999,0,9999,0
1713491548416,MATH 197,002,563811,Zhang; Danna,9998,0,9999,1
1713491549445,MCWP 40R,A00,518780,Staff,15,0,20,5
1713491549445,MCWP 40R,B00,518781,Staff,14,0,20,6
1713491549445,MCWP 40R,C00,518783,Staff,10,0,20,10
1713491550475,MCWP 50R,A00,518791,Staff,8,0,20,12
1713491550475,MCWP 50R,B00,518792,Staff,4,0,20,16
1713491550475,MCWP 50R,C00,518793,Staff,7,0,20,13
1713491550475,MCWP 50R,D00,518794,Staff,0,0,20,20
1713491550475,MCWP 50R,E00,518795,Staff,0,0,20,20
1713491550475,MCWP 50R,F00,518796,Staff,13,0,20,7
1713491550475,MCWP 50R,G00,518797,Staff,11,0,20,9
1713491551500,MMW 12R,A01,514034,Herbst; Matthew,5,0,16,11
1713491551500,MMW 12R,A02,514035,Herbst; Matthew,13,0,16,3
1713491552527,MMW 13R,A01,514037,Staff,0,5,16,16
1713491552527,MMW 13R,A02,514039,Staff,0,4,16,16
1713491554578,SIO 295LS,A00,523233,Staff,15,0,30,15
1713491555607,SIO 295S,A00,523232,Staff,15,0,30,15
1713491556635,SOCI 117,A01,494376,Staff,0,2,5,5
1713491557659,WES 237B,A00,494380,Staff,19,0,20,1
1713491559724,AESE 279B,A00,494370,Wade; Jon P,33,0,33,0
1713491560751,AIP 197,001,627712,Vespa; Emanuel Ignacio,9999,0,9999,0
1713491561780,ANAR 135S,A00,494369,Braswell; Geoffrey E.,0,0,0,0
1713491562804,CAT 124RS,A01,519847,Geibel; William,6,0,20,14
1713491563828,CAT 125RS,A01,515971,Geibel; William,6,0,20,14
1713491564862,CLRE 250,A00,511389,Morris; Sheldon,9996,0,9999,3
1713491565895,CLRE 251,A00,507176,Mehta; Ravindra L.,9996,0,9999,3
1713491565895,CLRE 251,B00,511410,Mehta; Ravindra L.,9998,0,9999,1
1713491566921,CLRE 252,A00,507189,Cuomo; Raphael Eduardo,9998,0,9999,1
1713491567945,CLRE 253,A00,507199,Vaida; Florin,9997,0,9999,2
1713491567945,CLRE 253,B00,507202,Vaida; Florin,9999,0,9999,0
1713491568971,CLRE 259,A00,507211,Patel; Hemal,9996,0,9999,3
1713491569998,CLRE 260,A00,507221,Cuomo; Raphael Eduardo,9999,0,9999,0
1713491571023,CLRE 297,001,507242,Cuomo; Raphael Eduardo,9999,0,9999,0
1713491572047,CSE 191,A00,516875,Minnes Kemp; Mor Mia,9999,0,9999,0
1713491573076,CSS 201S,A01,494383,Staff,35,0,35,0
1713491574100,CSS 202S,A01,494387,Staff,35,0,35,0
1713491575126,EAP 100,A00,516065,Staff,9792,0,9999,207
1713491576154,ECE 45,A01,507414,Staff,38,0,60,22
1713491577182,ECE 100,A01,507416,Baghdadchi; Saharnaz,0,0,20,20
1713491577182,ECE 100,A02,507418,Baghdadchi; Saharnaz,19,0,20,1
1713491578206,ECE 111,A01,507420,Staff,27,0,50,23
1713491579231,ECE 197,001,548057,Sievenpiper; Daniel F.,9998,0,9999,1
1713491580257,EDS 115,A00,507243,Choi; Bailey Miyeon,27,0,28,1
1713491581281,EDS 117,A01,494379,Staff,15,0,25,10
1713491582310,EDS 125,A00,507246,Hopkins; Megan Beth,27,0,30,3
1713491583339,EDS 128A,A01,507264,Fargason; Sharon Gayle,26,0,26,0
1713491584363,EDS 128B,A01,507293,Pappas; Elizabeth,30,0,30,0
1713491585389,EDS 139,A00,507294,Fargason; Sharon Gayle,30,0,30,0
1713491585389,EDS 139,B00,507313,Pappas; Elizabeth,30,0,30,0
1713491586416,EDS 201,A00,507315,Staff,18,0,30,12
1713491587444,EDS 203,A01,507317,Halter; Christopher P.,17,0,30,13
1713491588473,EDS 204R,A01,507319,Halter; Christopher P.,0,1,30,30
1713491588473,EDS 204R,B01,507331,Heinzman; Erica M.,22,0,30,8
1713491589499,EDS 206R,A00,507332,Staff,0,2,30,30
1713491589499,EDS 206R,B00,507343,Staff,23,0,30,7
1713491590523,EDS 250,A00,507344,Hemans; Patricia Ann Benitez,27,0,40,13
1713491591551,EDS 281,A00,507345,Daly; Alan J.,18,0,18,0
1713491592575,EDS 284,A00,507350,Daly; Alan J.,16,0,16,0
1713491593602,EDS 286,A00,507359,Fine; Sarah,18,0,18,0
1713491594627,EDS 289C,A01,507361,Daly; Alan J.,18,0,18,0
1713491595654,EDS 290,A00,507366,Hofstetter; Carolyn,15,0,15,0
1713491596682,LIGM 5A,A00,507421,Fischer-Grunski; Eva K,20,0,20,0
1713491597706,LIGM 5B,A00,507423,Fischer-Grunski; Eva K,20,0,20,0
1713491598730,LIGM 5C,A00,507425,Fischer-Grunski; Eva K,20,0,20,0
1713491599755,LIIT 5AS,A00,507427,Carnelos; Chiara,20,0,20,0
1713491600781,LIIT 5BS,A00,507430,Carnelos; Chiara,20,0,20,0
1713491601807,LIIT 5CS,A00,507432,Carnelos; Chiara,20,0,20,0
1713491602836,LISP 5A,A00,507541,Munoz Sanchez; Alicia,14,0,20,6
1713491603861,LISP 5B,A00,507671,Munoz Sanchez; Alicia,12,0,20,8
1713491604890,LISP 5C,A00,507696,Munoz Sanchez; Alicia,11,0,20,9
1713491605918,MAE 197,001,528363,Boechler; Nicholas Sebastia,9998,0,9999,1
1713491606943,MATH 197,001,523477,Kedlaya; Kiran S.,9999,0,9999,0
1713491606943,MATH 197,002,563811,Zhang; Danna,9998,0,9999,1
1713491607971,MCWP 40R,A00,518780,Staff,15,0,20,5
1713491607971,MCWP 40R,B00,518781,Staff,14,0,20,6
1713491607971,MCWP 40R,C00,518783,Staff,10,0,20,10
1713491608997,MCWP 50R,A00,518791,Staff,8,0,20,12
1713491608997,MCWP 50R,B00,518792,Staff,4,0,20,16
1713491608997,MCWP 50R,C00,518793,Staff,7,0,20,13
1713491608997,MCWP 50R,D00,518794,Staff,0,0,20,20
1713491608997,MCWP 50R,E00,518795,Staff,0,0,20,20
1713491608997,MCWP 50R,F00,518796,Staff,13,0,20,7
1713491608997,MCWP 50R,G00,518797,Staff,11,0,20,9
1713491610023,MMW 12R,A01,514034,Herbst; Matthew,5,0,16,11
1713491610023,MMW 12R,A02,514035,Herbst; Matthew,13,0,16,3
1713491611051,MMW 13R,A01,514037,Staff,0,5,16,16
1713491611051,MMW 13R,A02,514039,Staff,0,4,16,16
1713491613107,SIO 295LS,A00,523233,Staff,15,0,30,15
1713491614134,SIO 295S,A00,523232,Staff,15,0,30,15
1713491615164,SOCI 117,A01,494376,Staff,0,2,5,5
1713491616188,WES 237B,A00,494380,Staff,19,0,20,1
1713491618253,AESE 279B,A00,494370,Wade; Jon P,33,0,33,0
1713491619281,AIP 197,001,627712,Vespa; Emanuel Ignacio,9999,0,9999,0
1713491620306,ANAR 135S,A00,494369,Braswell; Geoffrey E.,0,0,0,0
1713491621333,CAT 124RS,A01,519847,Geibel; William,6,0,20,14
1713491622360,CAT 125RS,A01,515971,Geibel; William,6,0,20,14
1713491623388,CLRE 250,A00,511389,Morris; Sheldon,9996,0,9999,3
1713491624419,CLRE 251,A00,507176,Mehta; Ravindra L.,9996,0,9999,3
1713491624419,CLRE 251,B00,511410,Mehta; Ravindra L.,9998,0,9999,1
1713491625444,CLRE 252,A00,507189,Cuomo; Raphael Eduardo,9998,0,9999,1
1713491626470,CLRE 253,A00,507199,Vaida; Florin,9997,0,9999,2
1713491626470,CLRE 253,B00,507202,Vaida; Florin,9999,0,9999,0
1713491627495,CLRE 259,A00,507211,Patel; Hemal,9996,0,9999,3
1713491628520,CLRE 260,A00,507221,Cuomo; Raphael Eduardo,9999,0,9999,0
1713491629549,CLRE 297,001,507242,Cuomo; Raphael Eduardo,9999,0,9999,0
1713491630627,CSE 191,A00,516875,Minnes Kemp; Mor Mia,9999,0,9999,0
1713491631653,CSS 201S,A01,494383,Staff,35,0,35,0
1713491632682,CSS 202S,A01,494387,Staff,35,0,35,0
1713491633707,EAP 100,A00,516065,Staff,9792,0,9999,207
1713491634735,ECE 45,A01,507414,Staff,38,0,60,22
1713491635762,ECE 100,A01,507416,Baghdadchi; Saharnaz,0,0,20,20
1713491635762,ECE 100,A02,507418,Baghdadchi; Saharnaz,19,0,20,1
1713491636791,ECE 111,A01,507420,Staff,27,0,50,23
1713491637820,ECE 197,001,548057,Sievenpiper; Daniel F.,9998,0,9999,1
1713491638845,EDS 115,A00,507243,Choi; Bailey Miyeon,27,0,28,1
1713491639871,EDS 117,A01,494379,Staff,15,0,25,10
1713491640897,EDS 125,A00,507246,Hopkins; Megan Beth,27,0,30,3
1713491641921,EDS 128A,A01,507264,Fargason; Sharon Gayle,26,0,26,0
1713491642946,EDS 128B,A01,507293,Pappas; Elizabeth,30,0,30,0
1713491643973,EDS 139,A00,507294,Fargason; Sharon Gayle,30,0,30,0
1713491643973,EDS 139,B00,507313,Pappas; Elizabeth,30,0,30,0
1713491644998,EDS 201,A00,507315,Staff,18,0,30,12
1713491646022,EDS 203,A01,507317,Halter; Christopher P.,17,0,30,13
1713491647063,EDS 204R,A01,507319,Halter; Christopher P.,0,1,30,30
1713491647063,EDS 204R,B01,507331,Heinzman; Erica M.,22,0,30,8
1713491648090,EDS 206R,A00,507332,Staff,0,2,30,30
1713491648090,EDS 206R,B00,507343,Staff,23,0,30,7
1713491649115,EDS 250,A00,507344,Hemans; Patricia Ann Benitez,27,0,40,13
1713491650142,EDS 281,A00,507345,Daly; Alan J.,18,0,18,0
1713491651166,EDS 284,A00,507350,Daly; Alan J.,16,0,16,0
1713491652194,EDS 286,A00,507359,Fine; Sarah,18,0,18,0
1713491653219,EDS 289C,A01,507361,Daly; Alan J.,18,0,18,0
1713491654243,EDS 290,A00,507366,Hofstetter; Carolyn,15,0,15,0
1713491655269,LIGM 5A,A00,507421,Fischer-Grunski; Eva K,20,0,20,0
1713491656292,LIGM 5B,A00,507423,Fischer-Grunski; Eva K,20,0,20,0
1713491657317,LIGM 5C,A00,507425,Fischer-Grunski; Eva K,20,0,20,0
1713491658343,LIIT 5AS,A00,507427,Carnelos; Chiara,20,0,20,0
1713491659372,LIIT 5BS,A00,507430,Carnelos; Chiara,20,0,20,0
1713491660401,LIIT 5CS,A00,507432,Carnelos; Chiara,20,0,20,0
1713491661427,LISP 5A,A00,507541,Munoz Sanchez; Alicia,14,0,20,6
1713491662451,LISP 5B,A00,507671,Munoz Sanchez; Alicia,12,0,20,8
1713491663480,LISP 5C,A00,507696,Munoz Sanchez; Alicia,11,0,20,9
1713491664506,MAE 197,001,528363,Boechler; Nicholas Sebastia,9998,0,9999,1
1713491665530,MATH 197,001,523477,Kedlaya; Kiran S.,9999,0,9999,0
1713491665530,MATH 197,002,563811,Zhang; Danna,9998,0,9999,1
1713491666559,MCWP 40R,A00,518780,Staff,15,0,20,5
1713491666559,MCWP 40R,B00,518781,Staff,14,0,20,6
1713491666559,MCWP 40R,C00,518783,Staff,10,0,20,10
1713491667587,MCWP 50R,A00,518791,Staff,8,0,20,12
1713491667587,MCWP 50R,B00,518792,Staff,4,0,20,16
1713491667587,MCWP 50R,C00,518793,Staff,7,0,20,13
1713491667587,MCWP 50R,D00,518794,Staff,0,0,20,20
1713491667587,MCWP 50R,E00,518795,Staff,0,0,20,20
1713491667587,MCWP 50R,F00,518796,Staff,13,0,20,7
1713491667587,MCWP 50R,G00,518797,Staff,11,0,20,9
1713491668611,MMW 12R,A01,514034,Herbst; Matthew,5,0,16,11
1713491668611,MMW 12R,A02,514035,Herbst; Matthew,13,0,16,3
1713491669635,MMW 13R,A01,514037,Staff,0,5,16,16
1713491669635,MMW 13R,A02,514039,Staff,0,4,16,16
1713491671685,SIO 295LS,A00,523233,Staff,15,0,30,15
1713491672710,SIO 295S,A00,523232,Staff,15,0,30,15
1713491673736,SOCI 117,A01,494376,Staff,0,2,5,5
1713491674763,WES 237B,A00,494380,Staff,19,0,20,1
1713491676831,AESE 279B,A00,494370,Wade; Jon P,33,0,33,0
1713491677857,AIP 197,001,627712,Vespa; Emanuel Ignacio,9999,0,9999,0
1713491678888,ANAR 135S,A00,494369,Braswell; Geoffrey E.,0,0,0,0
1713491679914,CAT 124RS,A01,519847,Geibel; William,6,0,20,14
1713491680941,CAT 125RS,A01,515971,Geibel; William,6,0,20,14
1713491681970,CLRE 250,A00,511389,Morris; Sheldon,9996,0,9999,3
1713491682997,CLRE 251,A00,507176,Mehta; Ravindra L.,9996,0,9999,3
1713491682997,CLRE 251,B00,511410,Mehta; Ravindra L.,9998,0,9999,1
1713491684025,CLRE 252,A00,507189,Cuomo; Raphael Eduardo,9998,0,9999,1
1713491685051,CLRE 253,A00,507199,Vaida; Florin,9997,0,9999,2
1713491685051,CLRE 253,B00,507202,Vaida; Florin,9999,0,9999,0
1713491686076,CLRE 259,A00,507211,Patel; Hemal,9996,0,9999,3
1713491687102,CLRE 260,A00,507221,Cuomo; Raphael Eduardo,9999,0,9999,0
1713491688130,CLRE 297,001,507242,Cuomo; Raphael Eduardo,9999,0,9999,0
1713491689158,CSE 191,A00,516875,Minnes Kemp; Mor Mia,9999,0,9999,0
1713491690187,CSS 201S,A01,494383,Staff,35,0,35,0
1713491691217,CSS 202S,A01,494387,Staff,35,0,35,0
1713491692243,EAP 100,A00,516065,Staff,9792,0,9999,207
1713491693269,ECE 45,A01,507414,Staff,38,0,60,22
1713491694295,ECE 100,A01,507416,Baghdadchi; Saharnaz,0,0,20,20
1713491694295,ECE 100,A02,507418,Baghdadchi; Saharnaz,19,0,20,1
1713491695323,ECE 111,A01,507420,Staff,27,0,50,23
1713491696352,ECE 197,001,548057,Sievenpiper; Daniel F.,9998,0,9999,1
1713491697377,EDS 115,A00,507243,Choi; Bailey Miyeon,27,0,28,1
1713491698404,EDS 117,A01,494379,Staff,15,0,25,10
1713491699432,EDS 125,A00,507246,Hopkins; Megan Beth,27,0,30,3
1713491700458,EDS 128A,A01,507264,Fargason; Sharon Gayle,26,0,26,0
1713491701492,EDS 128B,A01,507293,Pappas; Elizabeth,30,0,30,0
1713491702521,EDS 139,A00,507294,Fargason; Sharon Gayle,30,0,30,0
1713491702521,EDS 139,B00,507313,Pappas; Elizabeth,30,0,30,0
1713491703550,EDS 201,A00,507315,Staff,18,0,30,12
1713491704580,EDS 203,A01,507317,Halter; Christopher P.,17,0,30,13
1713491705607,EDS 204R,A01,507319,Halter; Christopher P.,0,1,30,30
1713491705607,EDS 204R,B01,507331,Heinzman; Erica M.,22,0,30,8
1713491706633,EDS 206R,A00,507332,Staff,0,2,30,30
1713491706633,EDS 206R,B00,507343,Staff,23,0,30,7
1713491707659,EDS 250,A00,507344,Hemans; Patricia Ann Benitez,27,0,40,13
1713491708689,EDS 281,A00,507345,Daly; Alan J.,18,0,18,0
1713491709717,EDS 284,A00,507350,Daly; Alan J.,16,0,16,0
1713491710742,EDS 286,A00,507359,Fine; Sarah,18,0,18,0
1713491711771,EDS 289C,A01,507361,Daly; Alan J.,18,0,18,0
1713491712797,EDS 290,A00,507366,Hofstetter; Carolyn,15,0,15,0
1713491713823,LIGM 5A,A00,507421,Fischer-Grunski; Eva K,20,0,20,0
1713491714851,LIGM 5B,A00,507423,Fischer-Grunski; Eva K,20,0,20,0
1713491715875,LIGM 5C,A00,507425,Fischer-Grunski; Eva K,20,0,20,0
1713491716902,LIIT 5AS,A00,507427,Carnelos; Chiara,20,0,20,0
1713491717929,LIIT 5BS,A00,507430,Carnelos; Chiara,20,0,20,0
1713491718954,LIIT 5CS,A00,507432,Carnelos; Chiara,20,0,20,0
1713491719979,LISP 5A,A00,507541,Munoz Sanchez; Alicia,14,0,20,6
1713491721011,LISP 5B,A00,507671,Munoz Sanchez; Alicia,12,0,20,8
1713491722040,LISP 5C,A00,507696,Munoz Sanchez; Alicia,11,0,20,9
1713491723068,MAE 197,001,528363,Boechler; Nicholas Sebastia,9998,0,9999,1
1713491724095,MATH 197,001,523477,Kedlaya; Kiran S.,9999,0,9999,0
1713491724095,MATH 197,002,563811,Zhang; Danna,9998,0,9999,1
1713491725121,MCWP 40R,A00,518780,Staff,15,0,20,5
1713491725121,MCWP 40R,B00,518781,Staff,14,0,20,6
1713491725121,MCWP 40R,C00,518783,Staff,10,0,20,10
1713491726146,MCWP 50R,A00,518791,Staff,8,0,20,12
1713491726146,MCWP 50R,B00,518792,Staff,4,0,20,16
1713491726146,MCWP 50R,C00,518793,Staff,7,0,20,13
1713491726146,MCWP 50R,D00,518794,Staff,0,0,20,20
1713491726146,MCWP 50R,E00,518795,Staff,0,0,20,20
1713491726146,MCWP 50R,F00,518796,Staff,13,0,20,7
1713491726146,MCWP 50R,G00,518797,Staff,11,0,20,9
1713491727177,MMW 12R,A01,514034,Herbst; Matthew,5,0,16,11
1713491727177,MMW 12R,A02,514035,Herbst; Matthew,13,0,16,3
1713491728207,MMW 13R,A01,514037,Staff,0,5,16,16
1713491728207,MMW 13R,A02,514039,Staff,0,4,16,16
1713491730262,SIO 295LS,A00,523233,Staff,15,0,30,15
1713491731286,SIO 295S,A00,523232,Staff,15,0,30,15
1713491732311,SOCI 117,A01,494376,Staff,0,2,5,5
1713491733339,WES 237B,A00,494380,Staff,19,0,20,1
1713491735459,AESE 279B,A00,494370,Wade; Jon P,33,0,33,0
1713491736488,AIP 197,001,627712,Vespa; Emanuel Ignacio,9999,0,9999,0
1713491737516,ANAR 135S,A00,494369,Braswell; Geoffrey E.,0,0,0,0
1713491738542,CAT 124RS,A01,519847,Geibel; William,6,0,20,14
1713491739566,CAT 125RS,A01,515971,Geibel; William,6,0,20,14
1713491740592,CLRE 250,A00,511389,Morris; Sheldon,9996,0,9999,3
1713491741619,CLRE 251,A00,507176,Mehta; Ravindra L.,9996,0,9999,3
1713491741619,CLRE 251,B00,511410,Mehta; Ravindra L.,9998,0,9999,1
1713491742650,CLRE 252,A00,507189,Cuomo; Raphael Eduardo,9998,0,9999,1
1713491743675,CLRE 253,A00,507199,Vaida; Florin,9997,0,9999,2
1713491743675,CLRE 253,B00,507202,Vaida; Florin,9999,0,9999,0
1713491744700,CLRE 259,A00,507211,Patel; Hemal,9996,0,9999,3
1713491745725,CLRE 260,A00,507221,Cuomo; Raphael Eduardo,9999,0,9999,0
1713491746753,CLRE 297,001,507242,Cuomo; Raphael Eduardo,9999,0,9999,0
1713491747779,CSE 191,A00,516875,Minnes Kemp; Mor Mia,9999,0,9999,0
1713491748805,CSS 201S,A01,494383,Staff,35,0,35,0
1713491749835,CSS 202S,A01,494387,Staff,35,0,35,0
1713491750860,EAP 100,A00,516065,Staff,9792,0,9999,207
1713491751889,ECE 45,A01,507414,Staff,38,0,60,22
1713491752915,ECE 100,A01,507416,Baghdadchi; Saharnaz,0,0,20,20
1713491752915,ECE 100,A02,507418,Baghdadchi; Saharnaz,19,0,20,1
1713491753944,ECE 111,A01,507420,Staff,27,0,50,23
1713491754971,ECE 197,001,548057,Sievenpiper; Daniel F.,9998,0,9999,1
1713491756001,EDS 115,A00,507243,Choi; Bailey Miyeon,27,0,28,1
1713491757027,EDS 117,A01,494379,Staff,15,0,25,10
1713491758055,EDS 125,A00,507246,Hopkins; Megan Beth,27,0,30,3
1713491759082,EDS 128A,A01,507264,Fargason; Sharon Gayle,26,0,26,0
1713491760113,EDS 128B,A01,507293,Pappas; Elizabeth,30,0,30,0
1713491761141,EDS 139,A00,507294,Fargason; Sharon Gayle,30,0,30,0
1713491761141,EDS 139,B00,507313,Pappas; Elizabeth,30,0,30,0
1713491762170,EDS 201,A00,507315,Staff,18,0,30,12
1713491763201,EDS 203,A01,507317,Halter; Christopher P.,17,0,30,13
1713491764227,EDS 204R,A01,507319,Halter; Christopher P.,0,1,30,30
1713491764227,EDS 204R,B01,507331,Heinzman; Erica M.,22,0,30,8
1713491765253,EDS 206R,A00,507332,Staff,0,2,30,30
1713491765253,EDS 206R,B00,507343,Staff,23,0,30,7
1713491766279,EDS 250,A00,507344,Hemans; Patricia Ann Benitez,27,0,40,13
1713491767306,EDS 281,A00,507345,Daly; Alan J.,18,0,18,0
1713491768332,EDS 284,A00,507350,Daly; Alan J.,16,0,16,0
1713491769358,EDS 286,A00,507359,Fine; Sarah,18,0,18,0
1713491770387,EDS 289C,A01,507361,Daly; Alan J.,18,0,18,0
1713491771413,EDS 290,A00,507366,Hofstetter; Carolyn,15,0,15,0
1713491772442,LIGM 5A,A00,507421,Fischer-Grunski; Eva K,20,0,20,0
1713491773472,LIGM 5B,A00,507423,Fischer-Grunski; Eva K,20,0,20,0
1713491774497,LIGM 5C,A00,507425,Fischer-Grunski; Eva K,20,0,20,0
1713491775528,LIIT 5AS,A00,507427,Carnelos; Chiara,20,0,20,0
1713491776559,LIIT 5BS,A00,507430,Carnelos; Chiara,20,0,20,0
1713491777585,LIIT 5CS,A00,507432,Carnelos; Chiara,20,0,20,0
1713491778612,LISP 5A,A00,507541,Munoz Sanchez; Alicia,14,0,20,6
1713491779636,LISP 5B,A00,507671,Munoz Sanchez; Alicia,12,0,20,8
1713491780666,LISP 5C,A00,507696,Munoz Sanchez; Alicia,11,0,20,9
1713491781693,MAE 197,001,528363,Boechler; Nicholas Sebastia,9998,0,9999,1
1713491782722,MATH 197,001,523477,Kedlaya; Kiran S.,9999,0,9999,0
1713491782722,MATH 197,002,563811,Zhang; Danna,9998,0,9999,1
1713491783747,MCWP 40R,A00,518780,Staff,15,0,20,5
1713491783747,MCWP 40R,B00,518781,Staff,14,0,20,6
1713491783747,MCWP 40R,C00,518783,Staff,10,0,20,10
1713491784777,MCWP 50R,A00,518791,Staff,8,0,20,12
1713491784777,MCWP 50R,B00,518792,Staff,4,0,20,16
1713491784777,MCWP 50R,C00,518793,Staff,7,0,20,13
1713491784777,MCWP 50R,D00,518794,Staff,0,0,20,20
1713491784777,MCWP 50R,E00,518795,Staff,0,0,20,20
1713491784777,MCWP 50R,F00,518796,Staff,12,0,20,8
1713491784777,MCWP 50R,G00,518797,Staff,11,0,20,9
1713491785805,MMW 12R,A01,514034,Herbst; Matthew,5,0,16,11
1713491785805,MMW 12R,A02,514035,Herbst; Matthew,13,0,16,3
1713491786829,MMW 13R,A01,514037,Staff,0,5,16,16
1713491786829,MMW 13R,A02,514039,Staff,0,4,16,16
1713491788883,SIO 295LS,A00,523233,Staff,15,0,30,15
1713491789913,SIO 295S,A00,523232,Staff,15,0,30,15
1713491790941,SOCI 117,A01,494376,Staff,0,2,5,5
1713491791966,WES 237B,A00,494380,Staff,19,0,20,1
1713491794057,AESE 279B,A00,494370,Wade; Jon P,33,0,33,0
1713491795081,AIP 197,001,627712,Vespa; Emanuel Ignacio,9999,0,9999,0
1713491796111,ANAR 135S,A00,494369,Braswell; Geoffrey E.,0,0,0,0
1713491797137,CAT 124RS,A01,519847,Geibel; William,6,0,20,14
1713491798163,CAT 125RS,A01,515971,Geibel; William,6,0,20,14
1713491799188,CLRE 250,A00,511389,Morris; Sheldon,9996,0,9999,3
1713491800219,CLRE 251,A00,507176,Mehta; Ravindra L.,9996,0,9999,3
1713491800219,CLRE 251,B00,511410,Mehta; Ravindra L.,9998,0,9999,1
1713491801251,CLRE 252,A00,507189,Cuomo; Raphael Eduardo,9998,0,9999,1
1713491802279,CLRE 253,A00,507199,Vaida; Florin,9997,0,9999,2
1713491802279,CLRE 253,B00,507202,Vaida; Florin,9999,0,9999,0
1713491803306,CLRE 259,A00,507211,Patel; Hemal,9996,0,9999,3
1713491804334,CLRE 260,A00,507221,Cuomo; Raphael Eduardo,9999,0,9999,0
1713491805359,CLRE 297,001,507242,Cuomo; Raphael Eduardo,9999,0,9999,0
1713491806390,CSE 191,A00,516875,Minnes Kemp; Mor Mia,9999,0,9999,0
1713491807421,CSS 201S,A01,494383,Staff,35,0,35,0
1713491808445,CSS 202S,A01,494387,Staff,35,0,35,0
1713491809469,EAP 100,A00,516065,Staff,9792,0,9999,207
1713491810495,ECE 45,A01,507414,Staff,38,0,60,22
1713491811521,ECE 100,A01,507416,Baghdadchi; Saharnaz,0,0,20,20
1713491811521,ECE 100,A02,507418,Baghdadchi; Saharnaz,19,0,20,1
1713491812546,ECE 111,A01,507420,Staff,27,0,50,23
1713491813575,ECE 197,001,548057,Sievenpiper; Daniel F.,9998,0,9999,1
1713491814604,EDS 115,A00,507243,Choi; Bailey Miyeon,27,0,28,1
1713491815632,EDS 117,A01,494379,Staff,15,0,25,10
1713491816657,EDS 125,A00,507246,Hopkins; Megan Beth,27,0,30,3
1713491817683,EDS 128A,A01,507264,Fargason; Sharon Gayle,26,0,26,0
1713491818708,EDS 128B,A01,507293,Pappas; Elizabeth,30,0,30,0
1713491819737,EDS 139,A00,507294,Fargason; Sharon Gayle,30,0,30,0
1713491819737,EDS 139,B00,507313,Pappas; Elizabeth,30,0,30,0
1713491820763,EDS 201,A00,507315,Staff,18,0,30,12
1713491821791,EDS 203,A01,507317,Halter; Christopher P.,17,0,30,13
1713491822818,EDS 204R,A01,507319,Halter; Christopher P.,0,1,30,30
1713491822818,EDS 204R,B01,507331,Heinzman; Erica M.,22,0,30,8
1713491823843,EDS 206R,A00,507332,Staff,0,2,30,30
1713491823843,EDS 206R,B00,507343,Staff,23,0,30,7
1713491824869,EDS 250,A00,507344,Hemans; Patricia Ann Benitez,27,0,40,13
1713491825894,EDS 281,A00,507345,Daly; Alan J.,18,0,18,0
1713491826920,EDS 284,A00,507350,Daly; Alan J.,16,0,16,0
1713491827946,EDS 286,A00,507359,Fine; Sarah,18,0,18,0
1713491828973,EDS 289C,A01,507361,Daly; Alan J.,18,0,18,0
1713491830002,EDS 290,A00,507366,Hofstetter; Carolyn,15,0,15,0
1713491831031,LIGM 5A,A00,507421,Fischer-Grunski; Eva K,20,0,20,0
1713491832056,LIGM 5B,A00,507423,Fischer-Grunski; Eva K,20,0,20,0
1713491833085,LIGM 5C,A00,507425,Fischer-Grunski; Eva K,20,0,20,0
1713491834117,LIIT 5AS,A00,507427,Carnelos; Chiara,20,0,20,0
1713491835143,LIIT 5BS,A00,507430,Carnelos; Chiara,20,0,20,0
1713491836169,LIIT 5CS,A00,507432,Carnelos; Chiara,20,0,20,0
1713491837196,LISP 5A,A00,507541,Munoz Sanchez; Alicia,14,0,20,6
1713491838275,LISP 5B,A00,507671,Munoz Sanchez; Alicia,12,0,20,8
1713491839302,LISP 5C,A00,507696,Munoz Sanchez; Alicia,11,0,20,9
1713491840331,MAE 197,001,528363,Boechler; Nicholas Sebastia,9998,0,9999,1
1713491841356,MATH 197,001,523477,Kedlaya; Kiran S.,9999,0,9999,0
1713491841356,MATH 197,002,563811,Zhang; Danna,9998,0,9999,1
1713491842384,MCWP 40R,A00,518780,Staff,15,0,20,5
1713491842384,MCWP 40R,B00,518781,Staff,14,0,20,6
1713491842384,MCWP 40R,C00,518783,Staff,10,0,20,10
1713491843409,MCWP 50R,A00,518791,Staff,8,0,20,12
1713491843409,MCWP 50R,B00,518792,Staff,4,0,20,16
1713491843409,MCWP 50R,C00,518793,Staff,7,0,20,13
1713491843409,MCWP 50R,D00,518794,Staff,0,0,20,20
1713491843409,MCWP 50R,E00,518795,Staff,0,0,20,20
1713491843409,MCWP 50R,F00,518796,Staff,12,0,20,8
1713491843409,MCWP 50R,G00,518797,Staff,11,0,20,9
1713491844435,MMW 12R,A01,514034,Herbst; Matthew,5,0,16,11
1713491844435,MMW 12R,A02,514035,Herbst; Matthew,13,0,16,3
1713491845460,MMW 13R,A01,514037,Staff,0,5,16,16
1713491845460,MMW 13R,A02,514039,Staff,0,4,16,16
1713491847512,SIO 295LS,A00,523233,Staff,15,0,30,15
1713491848541,SIO 295S,A00,523232,Staff,15,0,30,15
1713491849566,SOCI 117,A01,494376,Staff,0,2,5,5
1713491850591,WES 237B,A00,494380,Staff,19,0,20,1
1713491852674,AESE 279B,A00,494370,Wade; Jon P,33,0,33,0
1713491853702,AIP 197,001,627712,Vespa; Emanuel Ignacio,9999,0,9999,0
1713491854728,ANAR 135S,A00,494369,Braswell; Geoffrey E.,0,0,0,0
1713491855753,CAT 124RS,A01,519847,Geibel; William,6,0,20,14
1713491856781,CAT 125RS,A01,515971,Geibel; William,6,0,20,14
1713491857809,CLRE 250,A00,511389,Morris; Sheldon,9996,0,9999,3
1713491858842,CLRE 251,A00,507176,Mehta; Ravindra L.,9996,0,9999,3
1713491858842,CLRE 251,B00,511410,Mehta; Ravindra L.,9998,0,9999,1
1713491859871,CLRE 252,A00,507189,Cuomo; Raphael Eduardo,9998,0,9999,1
1713491860898,CLRE 253,A00,507199,Vaida; Florin,9997,0,9999,2
1713491860898,CLRE 253,B00,507202,Vaida; Florin,9999,0,9999,0
1713491861923,CLRE 259,A00,507211,Patel; Hemal,9996,0,9999,3
1713491862951,CLRE 260,A00,507221,Cuomo; Raphael Eduardo,9999,0,9999,0
1713491863979,CLRE 297,001,507242,Cuomo; Raphael Eduardo,9999,0,9999,0
1713491865007,CSE 191,A00,516875,Minnes Kemp; Mor Mia,9999,0,9999,0
1713491866036,CSS 201S,A01,494383,Staff,35,0,35,0
1713491867061,CSS 202S,A01,494387,Staff,35,0,35,0
1713491868085,EAP 100,A00,516065,Staff,9792,0,9999,207
1713491869111,ECE 45,A01,507414,Staff,38,0,60,22
1713491870141,ECE 100,A01,507416,Baghdadchi; Saharnaz,0,0,20,20
1713491870141,ECE 100,A02,507418,Baghdadchi; Saharnaz,19,0,20,1
1713491871170,ECE 111,A01,507420,Staff,27,0,50,23
1713491872199,ECE 197,001,548057,Sievenpiper; Daniel F.,9998,0,9999,1
1713491873227,EDS 115,A00,507243,Choi; Bailey Miyeon,27,0,28,1
1713491874256,EDS 117,A01,494379,Staff,15,0,25,10
1713491875282,EDS 125,A00,507246,Hopkins; Megan Beth,27,0,30,3
1713491876308,EDS 128A,A01,507264,Fargason; Sharon Gayle,26,0,26,0
1713491877334,EDS 128B,A01,507293,Pappas; Elizabeth,30,0,30,0
1713491878359,EDS 139,A00,507294,Fargason; Sharon Gayle,30,0,30,0
1713491878359,EDS 139,B00,507313,Pappas; Elizabeth,30,0,30,0
1713491879384,EDS 201,A00,507315,Staff,18,0,30,12
1713491880410,EDS 203,A01,507317,Halter; Christopher P.,17,0,30,13
1713491881440,EDS 204R,A01,507319,Halter; Christopher P.,0,1,30,30
1713491881440,EDS 204R,B01,507331,Heinzman; Erica M.,22,0,30,8
1713491882466,EDS 206R,A00,507332,Staff,0,2,30,30
1713491882466,EDS 206R,B00,507343,Staff,23,0,30,7
1713491883495,EDS 250,A00,507344,Hemans; Patricia Ann Benitez,27,0,40,13
1713491884521,EDS 281,A00,507345,Daly; Alan J.,18,0,18,0
1713491885547,EDS 284,A00,507350,Daly; Alan J.,16,0,16,0
1713491886574,EDS 286,A00,507359,Fine; Sarah,18,0,18,0
1713491887597,EDS 289C,A01,507361,Daly; Alan J.,18,0,18,0
1713491888625,EDS 290,A00,507366,Hofstetter; Carolyn,15,0,15,0
1713491889651,LIGM 5A,A00,507421,Fischer-Grunski; Eva K,20,0,20,0
1713491890679,LIGM 5B,A00,507423,Fischer-Grunski; Eva K,20,0,20,0
1713491891708,LIGM 5C,A00,507425,Fischer-Grunski; Eva K,20,0,20,0
1713491892737,LIIT 5AS,A00,507427,Carnelos; Chiara,20,0,20,0
1713491893762,LIIT 5BS,A00,507430,Carnelos; Chiara,20,0,20,0
1713491894786,LIIT 5CS,A00,507432,Carnelos; Chiara,20,0,20,0
1713491895812,LISP 5A,A00,507541,Munoz Sanchez; Alicia,14,0,20,6
1713491896837,LISP 5B,A00,507671,Munoz Sanchez; Alicia,12,0,20,8
1713491897862,LISP 5C,A00,507696,Munoz Sanchez; Alicia,11,0,20,9
1713491898888,MAE 197,001,528363,Boechler; Nicholas Sebastia,9998,0,9999,1
1713491899914,MATH 197,001,523477,Kedlaya; Kiran S.,9999,0,9999,0
1713491899914,MATH 197,002,563811,Zhang; Danna,9998,0,9999,1
1713491900940,MCWP 40R,A00,518780,Staff,15,0,20,5
1713491900940,MCWP 40R,B00,518781,Staff,14,0,20,6
1713491900940,MCWP 40R,C00,518783,Staff,10,0,20,10
1713491901968,MCWP 50R,A00,518791,Staff,8,0,20,12
1713491901968,MCWP 50R,B00,518792,Staff,4,0,20,16
1713491901968,MCWP 50R,C00,518793,Staff,7,0,20,13
1713491901968,MCWP 50R,D00,518794,Staff,0,0,20,20
1713491901968,MCWP 50R,E00,518795,Staff,0,0,20,20
1713491901968,MCWP 50R,F00,518796,Staff,12,0,20,8
1713491901968,MCWP 50R,G00,518797,Staff,11,0,20,9
1713491902993,MMW 12R,A01,514034,Herbst; Matthew,5,0,16,11
1713491902993,MMW 12R,A02,514035,Herbst; Matthew,13,0,16,3
1713491904018,MMW 13R,A01,514037,Staff,0,5,16,16
1713491904018,MMW 13R,A02,514039,Staff,0,4,16,16
1713491906074,SIO 295LS,A00,523233,Staff,15,0,30,15
1713491907100,SIO 295S,A00,523232,Staff,15,0,30,15
1713491908125,SOCI 117,A01,494376,Staff,0,2,5,5
1713491909150,WES 237B,A00,494380,Staff,19,0,20,1
1713491911222,AESE 279B,A00,494370,Wade; Jon P,33,0,33,0
1713491912248,AIP 197,001,627712,Vespa; Emanuel Ignacio,9999,0,9999,0
1713491913273,ANAR 135S,A00,494369,Braswell; Geoffrey E.,0,0,0,0
1713491914298,CAT 124RS,A01,519847,Geibel; William,6,0,20,14
1713491915326,CAT 125RS,A01,515971,Geibel; William,6,0,20,14
1713491916354,CLRE 250,A00,511389,Morris; Sheldon,9996,0,9999,3
1713491917384,CLRE 251,A00,507176,Mehta; Ravindra L.,9996,0,9999,3
1713491917384,CLRE 251,B00,511410,Mehta; Ravindra L.,9998,0,9999,1
1713491918412,CLRE 252,A00,507189,Cuomo; Raphael Eduardo,9998,0,9999,1
1713491919442,CLRE 253,A00,507199,Vaida; Florin,9997,0,9999,2
1713491919442,CLRE 253,B00,507202,Vaida; Florin,9999,0,9999,0
1713491920467,CLRE 259,A00,507211,Patel; Hemal,9996,0,9999,3
1713491921498,CLRE 260,A00,507221,Cuomo; Raphael Eduardo,9999,0,9999,0
1713491922523,CLRE 297,001,507242,Cuomo; Raphael Eduardo,9999,0,9999,0
1713491923554,CSE 191,A00,516875,Minnes Kemp; Mor Mia,9999,0,9999,0
1713491924583,CSS 201S,A01,494383,Staff,35,0,35,0
1713491925611,CSS 202S,A01,494387,Staff,35,0,35,0
1713491926637,EAP 100,A00,516065,Staff,9792,0,9999,207
1713491927718,ECE 45,A01,507414,Staff,38,0,60,22
1713491928748,ECE 100,A01,507416,Baghdadchi; Saharnaz,0,0,20,20
1713491928748,ECE 100,A02,507418,Baghdadchi; Saharnaz,19,0,20,1
1713491929778,ECE 111,A01,507420,Staff,27,0,50,23
1713491930804,ECE 197,001,548057,Sievenpiper; Daniel F.,9998,0,9999,1
1713491931831,EDS 115,A00,507243,Choi; Bailey Miyeon,27,0,28,1
1713491932857,EDS 117,A01,494379,Staff,15,0,25,10
1713491933893,EDS 125,A00,507246,Hopkins; Megan Beth,27,0,30,3
1713491934922,EDS 128A,A01,507264,Fargason; Sharon Gayle,26,0,26,0
1713491935947,EDS 128B,A01,507293,Pappas; Elizabeth,30,0,30,0
1713491936973,EDS 139,A00,507294,Fargason; Sharon Gayle,30,0,30,0
1713491936973,EDS 139,B00,507313,Pappas; Elizabeth,30,0,30,0
1713491938000,EDS 201,A00,507315,Staff,18,0,30,12
1713491939027,EDS 203,A01,507317,Halter; Christopher P.,17,0,30,13
1713491940051,EDS 204R,A01,507319,Halter; Christopher P.,0,1,30,30
1713491940051,EDS 204R,B01,507331,Heinzman; Erica M.,22,0,30,8
1713491941076,EDS 206R,A00,507332,Staff,0,2,30,30
1713491941076,EDS 206R,B00,507343,Staff,23,0,30,7
1713491942160,EDS 250,A00,507344,Hemans; Patricia Ann Benitez,27,0,40,13
1713491943190,EDS 281,A00,507345,Daly; Alan J.,18,0,18,0
1713491944215,EDS 284,A00,507350,Daly; Alan J.,16,0,16,0
1713491945242,EDS 286,A00,507359,Fine; Sarah,18,0,18,0
1713491946269,EDS 289C,A01,507361,Daly; Alan J.,18,0,18,0
1713491947298,EDS 290,A00,507366,Hofstetter; Carolyn,15,0,15,0
1713491948324,LIGM 5A,A00,507421,Fischer-Grunski; Eva K,20,0,20,0
1713491949350,LIGM 5B,A00,507423,Fischer-Grunski; Eva K,20,0,20,0
1713491950377,LIGM 5C,A00,507425,Fischer-Grunski; Eva K,20,0,20,0
1713491951404,LIIT 5AS,A00,507427,Carnelos; Chiara,20,0,20,0
1713491952430,LIIT 5BS,A00,507430,Carnelos; Chiara,20,0,20,0
1713491953456,LIIT 5CS,A00,507432,Carnelos; Chiara,20,0,20,0
1713491954481,LISP 5A,A00,507541,Munoz Sanchez; Alicia,14,0,20,6
1713491955506,LISP 5B,A00,507671,Munoz Sanchez; Alicia,12,0,20,8
1713491956535,LISP 5C,A00,507696,Munoz Sanchez; Alicia,11,0,20,9
1713491957561,MAE 197,001,528363,Boechler; Nicholas Sebastia,9998,0,9999,1
1713491958591,MATH 197,001,523477,Kedlaya; Kiran S.,9999,0,9999,0
1713491958591,MATH 197,002,563811,Zhang; Danna,9998,0,9999,1
1713491959619,MCWP 40R,A00,518780,Staff,15,0,20,5
1713491959619,MCWP 40R,B00,518781,Staff,14,0,20,6
1713491959619,MCWP 40R,C00,518783,Staff,10,0,20,10
1713491960645,MCWP 50R,A00,518791,Staff,8,0,20,12
1713491960645,MCWP 50R,B00,518792,Staff,4,0,20,16
1713491960645,MCWP 50R,C00,518793,Staff,7,0,20,13
1713491960645,MCWP 50R,D00,518794,Staff,0,0,20,20
1713491960645,MCWP 50R,E00,518795,Staff,0,0,20,20
1713491960645,MCWP 50R,F00,518796,Staff,12,0,20,8
1713491960645,MCWP 50R,G00,518797,Staff,11,0,20,9
1713491961671,MMW 12R,A01,514034,Herbst; Matthew,5,0,16,11
1713491961671,MMW 12R,A02,514035,Herbst; Matthew,13,0,16,3
1713491962697,MMW 13R,A01,514037,Staff,0,5,16,16
1713491962697,MMW 13R,A02,514039,Staff,0,4,16,16
1713491964751,SIO 295LS,A00,523233,Staff,15,0,30,15
1713491965779,SIO 295S,A00,523232,Staff,15,0,30,15
1713491966815,SOCI 117,A01,494376,Staff,0,2,5,5
1713491967847,WES 237B,A00,494380,Staff,19,0,20,1
1713491969917,AESE 279B,A00,494370,Wade; Jon P,33,0,33,0
1713491970941,AIP 197,001,627712,Vespa; Emanuel Ignacio,9999,0,9999,0
1713491971970,ANAR 135S,A00,494369,Braswell; Geoffrey E.,0,0,0,0
1713491972999,CAT 124RS,A01,519847,Geibel; William,6,0,20,14
1713491974029,CAT 125RS,A01,515971,Geibel; William,6,0,20,14
1713491975055,CLRE 250,A00,511389,Morris; Sheldon,9996,0,9999,3
1713491976082,CLRE 251,A00,507176,Mehta; Ravindra L.,9996,0,9999,3
1713491976082,CLRE 251,B00,511410,Mehta; Ravindra L.,9998,0,9999,1
1713491977111,CLRE 252,A00,507189,Cuomo; Raphael Eduardo,9998,0,9999,1
1713491978136,CLRE 253,A00,507199,Vaida; Florin,9997,0,9999,2
1713491978136,CLRE 253,B00,507202,Vaida; Florin,9999,0,9999,0
1713491979165,CLRE 259,A00,507211,Patel; Hemal,9996,0,9999,3
1713491980191,CLRE 260,A00,507221,Cuomo; Raphael Eduardo,9999,0,9999,0
1713491981216,CLRE 297,001,507242,Cuomo; Raphael Eduardo,9999,0,9999,0
1713491982241,CSE 191,A00,516875,Minnes Kemp; Mor Mia,9999,0,9999,0
1713491983267,CSS 201S,A01,494383,Staff,35,0,35,0
1713491984294,CSS 202S,A01,494387,Staff,35,0,35,0
1713491985325,EAP 100,A00,516065,Staff,9792,0,9999,207
1713491986351,ECE 45,A01,507414,Staff,38,0,60,22
1713491987383,ECE 100,A01,507416,Baghdadchi; Saharnaz,0,0,20,20
1713491987383,ECE 100,A02,507418,Baghdadchi; Saharnaz,19,0,20,1
1713491988409,ECE 111,A01,507420,Staff,27,0,50,23
1713491989435,ECE 197,001,548057,Sievenpiper; Daniel F.,9998,0,9999,1
1713491990461,EDS 115,A00,507243,Choi; Bailey Miyeon,27,0,28,1
1713491991489,EDS 117,A01,494379,Staff,15,0,25,10
1713491992516,EDS 125,A00,507246,Hopkins; Megan Beth,27,0,30,3
1713491993543,EDS 128A,A01,507264,Fargason; Sharon Gayle,26,0,26,0
1713491994570,EDS 128B,A01,507293,Pappas; Elizabeth,30,0,30,0
1713491995599,EDS 139,A00,507294,Fargason; Sharon Gayle,30,0,30,0
1713491995599,EDS 139,B00,507313,Pappas; Elizabeth,30,0,30,0
1713491996626,EDS 201,A00,507315,Staff,18,0,30,12
1713491997652,EDS 203,A01,507317,Halter; Christopher P.,17,0,30,13
1713491998677,EDS 204R,A01,507319,Halter; Christopher P.,0,1,30,30
1713491998677,EDS 204R,B01,507331,Heinzman; Erica M.,22,0,30,8
1713491999702,EDS 206R,A00,507332,Staff,0,2,30,30
1713491999702,EDS 206R,B00,507343,Staff,23,0,30,7
1713492000732,EDS 250,A00,507344,Hemans; Patricia Ann Benitez,27,0,40,13
1713492001760,EDS 281,A00,507345,Daly; Alan J.,18,0,18,0
1713492002784,EDS 284,A00,507350,Daly; Alan J.,16,0,16,0
1713492003809,EDS 286,A00,507359,Fine; Sarah,18,0,18,0
1713492004837,EDS 289C,A01,507361,Daly; Alan J.,18,0,18,0
1713492005866,EDS 290,A00,507366,Hofstetter; Carolyn,15,0,15,0
1713492006909,LIGM 5A,A00,507421,Fischer-Grunski; Eva K,20,0,20,0
1713492007937,LIGM 5B,A00,507423,Fischer-Grunski; Eva K,20,0,20,0
1713492008964,LIGM 5C,A00,507425,Fischer-Grunski; Eva K,20,0,20,0
1713492009989,LIIT 5AS,A00,507427,Carnelos; Chiara,20,0,20,0
1713492011017,LIIT 5BS,A00,507430,Carnelos; Chiara,20,0,20,0
1713492012044,LIIT 5CS,A00,507432,Carnelos; Chiara,20,0,20,0
1713492013071,LISP 5A,A00,507541,Munoz Sanchez; Alicia,14,0,20,6
1713492014096,LISP 5B,A00,507671,Munoz Sanchez; Alicia,12,0,20,8
1713492015121,LISP 5C,A00,507696,Munoz Sanchez; Alicia,11,0,20,9
1713492016150,MAE 197,001,528363,Boechler; Nicholas Sebastia,9998,0,9999,1
1713492017178,MATH 197,001,523477,Kedlaya; Kiran S.,9999,0,9999,0
1713492017178,MATH 197,002,563811,Zhang; Danna,9998,0,9999,1
1713492018208,MCWP 40R,A00,518780,Staff,15,0,20,5
1713492018208,MCWP 40R,B00,518781,Staff,14,0,20,6
1713492018208,MCWP 40R,C00,518783,Staff,10,0,20,10
1713492019237,MCWP 50R,A00,518791,Staff,8,0,20,12
1713492019237,MCWP 50R,B00,518792,Staff,4,0,20,16
1713492019237,MCWP 50R,C00,518793,Staff,7,0,20,13
1713492019237,MCWP 50R,D00,518794,Staff,0,0,20,20
1713492019237,MCWP 50R,E00,518795,Staff,0,0,20,20
1713492019237,MCWP 50R,F00,518796,Staff,12,0,20,8
1713492019237,MCWP 50R,G00,518797,Staff,11,0,20,9
1713492020267,MMW 12R,A01,514034,Herbst; Matthew,5,0,16,11
1713492020267,MMW 12R,A02,514035,Herbst; Matthew,13,0,16,3
1713492021292,MMW 13R,A01,514037,Staff,0,5,16,16
1713492021292,MMW 13R,A02,514039,Staff,0,4,16,16
1713492023346,SIO 295LS,A00,523233,Staff,15,0,30,15
1713492024372,SIO 295S,A00,523232,Staff,15,0,30,15
1713492025398,SOCI 117,A01,494376,Staff,0,2,5,5
1713492026424,WES 237B,A00,494380,Staff,19,0,20,1
1713492028489,AESE 279B,A00,494370,Wade; Jon P,33,0,33,0
1713492029517,AIP 197,001,627712,Vespa; Emanuel Ignacio,9999,0,9999,0
1713492030542,ANAR 135S,A00,494369,Braswell; Geoffrey E.,0,0,0,0
1713492031574,CAT 124RS,A01,519847,Geibel; William,6,0,20,14
1713492032600,CAT 125RS,A01,515971,Geibel; William,6,0,20,14
1713492033627,CLRE 250,A00,511389,Morris; Sheldon,9996,0,9999,3
1713492034653,CLRE 251,A00,507176,Mehta; Ravindra L.,9996,0,9999,3
1713492034653,CLRE 251,B00,511410,Mehta; Ravindra L.,9998,0,9999,1
1713492035684,CLRE 252,A00,507189,Cuomo; Raphael Eduardo,9998,0,9999,1
1713492036710,CLRE 253,A00,507199,Vaida; Florin,9997,0,9999,2
1713492036710,CLRE 253,B00,507202,Vaida; Florin,9999,0,9999,0
1713492037740,CLRE 259,A00,507211,Patel; Hemal,9996,0,9999,3
1713492038765,CLRE 260,A00,507221,Cuomo; Raphael Eduardo,9999,0,9999,0
1713492039791,CLRE 297,001,507242,Cuomo; Raphael Eduardo,9999,0,9999,0
1713492040818,CSE 191,A00,516875,Minnes Kemp; Mor Mia,9999,0,9999,0
1713492041844,CSS 201S,A01,494383,Staff,35,0,35,0
1713492042873,CSS 202S,A01,494387,Staff,35,0,35,0
1713492043898,EAP 100,A00,516065,Staff,9792,0,9999,207
1713492044925,ECE 45,A01,507414,Staff,38,0,60,22
1713492046009,ECE 100,A01,507416,Baghdadchi; Saharnaz,0,0,20,20
1713492046009,ECE 100,A02,507418,Baghdadchi; Saharnaz,19,0,20,1
1713492047037,ECE 111,A01,507420,Staff,27,0,50,23
1713492048067,ECE 197,001,548057,Sievenpiper; Daniel F.,9998,0,9999,1
1713492049094,EDS 115,A00,507243,Choi; Bailey Miyeon,27,0,28,1
1713492050126,EDS 117,A01,494379,Staff,15,0,25,10
1713492051153,EDS 125,A00,507246,Hopkins; Megan Beth,27,0,30,3
1713492052181,EDS 128A,A01,507264,Fargason; Sharon Gayle,26,0,26,0
1713492053209,EDS 128B,A01,507293,Pappas; Elizabeth,30,0,30,0
1713492054238,EDS 139,A00,507294,Fargason; Sharon Gayle,30,0,30,0
1713492054238,EDS 139,B00,507313,Pappas; Elizabeth,30,0,30,0
1713492055263,EDS 201,A00,507315,Staff,18,0,30,12
1713492056295,EDS 203,A01,507317,Halter; Christopher P.,17,0,30,13
1713492057323,EDS 204R,A01,507319,Halter; Christopher P.,0,1,30,30
1713492057323,EDS 204R,B01,507331,Heinzman; Erica M.,22,0,30,8
1713492058347,EDS 206R,A00,507332,Staff,0,2,30,30
1713492058347,EDS 206R,B00,507343,Staff,23,0,30,7
1713492059376,EDS 250,A00,507344,Hemans; Patricia Ann Benitez,27,0,40,13
1713492060405,EDS 281,A00,507345,Daly; Alan J.,18,0,18,0
1713492061429,EDS 284,A00,507350,Daly; Alan J.,16,0,16,0
1713492062455,EDS 286,A00,507359,Fine; Sarah,18,0,18,0
1713492063482,EDS 289C,A01,507361,Daly; Alan J.,18,0,18,0
1713492064512,EDS 290,A00,507366,Hofstetter; Carolyn,15,0,15,0
1713492065545,LIGM 5A,A00,507421,Fischer-Grunski; Eva K,20,0,20,0
1713492066571,LIGM 5B,A00,507423,Fischer-Grunski; Eva K,20,0,20,0
1713492067596,LIGM 5C,A00,507425,Fischer-Grunski; Eva K,20,0,20,0
1713492068622,LIIT 5AS,A00,507427,Carnelos; Chiara,20,0,20,0
1713492069652,LIIT 5BS,A00,507430,Carnelos; Chiara,20,0,20,0
1713492070677,LIIT 5CS,A00,507432,Carnelos; Chiara,20,0,20,0
1713492071702,LISP 5A,A00,507541,Munoz Sanchez; Alicia,14,0,20,6
1713492072730,LISP 5B,A00,507671,Munoz Sanchez; Alicia,12,0,20,8
1713492073759,LISP 5C,A00,507696,Munoz Sanchez; Alicia,11,0,20,9
1713492074784,MAE 197,001,528363,Boechler; Nicholas Sebastia,9998,0,9999,1
1713492075817,MATH 197,001,523477,Kedlaya; Kiran S.,9999,0,9999,0
1713492075817,MATH 197,002,563811,Zhang; Danna,9998,0,9999,1
1713492076842,MCWP 40R,A00,518780,Staff,15,0,20,5
1713492076842,MCWP 40R,B00,518781,Staff,14,0,20,6
1713492076842,MCWP 40R,C00,518783,Staff,10,0,20,10
1713492077873,MCWP 50R,A00,518791,Staff,8,0,20,12
1713492077873,MCWP 50R,B00,518792,Staff,4,0,20,16
1713492077873,MCWP 50R,C00,518793,Staff,7,0,20,13
1713492077873,MCWP 50R,D00,518794,Staff,0,0,20,20
1713492077873,MCWP 50R,E00,518795,Staff,0,0,20,20
1713492077873,MCWP 50R,F00,518796,Staff,12,0,20,8
1713492077873,MCWP 50R,G00,518797,Staff,11,0,20,9
1713492078899,MMW 12R,A01,514034,Herbst; Matthew,5,0,16,11
1713492078899,MMW 12R,A02,514035,Herbst; Matthew,13,0,16,3
1713492079926,MMW 13R,A01,514037,Staff,0,5,16,16
1713492079926,MMW 13R,A02,514039,Staff,0,4,16,16
1713492081980,SIO 295LS,A00,523233,Staff,15,0,30,15
1713492083005,SIO 295S,A00,523232,Staff,15,0,30,15
1713492084033,SOCI 117,A01,494376,Staff,0,2,5,5
1713492085060,WES 237B,A00,494380,Staff,19,0,20,1
1713492087136,AESE 279B,A00,494370,Wade; Jon P,33,0,33,0
1713492088166,AIP 197,001,627712,Vespa; Emanuel Ignacio,9999,0,9999,0
1713492089192,ANAR 135S,A00,494369,Braswell; Geoffrey E.,0,0,0,0
1713492090224,CAT 124RS,A01,519847,Geibel; William,6,0,20,14
1713492091250,CAT 125RS,A01,515971,Geibel; William,6,0,20,14
1713492092274,CLRE 250,A00,511389,Morris; Sheldon,9996,0,9999,3
1713492093302,CLRE 251,A00,507176,Mehta; Ravindra L.,9996,0,9999,3
1713492093302,CLRE 251,B00,511410,Mehta; Ravindra L.,9998,0,9999,1
1713492094328,CLRE 252,A00,507189,Cuomo; Raphael Eduardo,9998,0,9999,1
1713492095354,CLRE 253,A00,507199,Vaida; Florin,9997,0,9999,2
1713492095354,CLRE 253,B00,507202,Vaida; Florin,9999,0,9999,0
1713492096379,CLRE 259,A00,507211,Patel; Hemal,9996,0,9999,3
1713492097407,CLRE 260,A00,507221,Cuomo; Raphael Eduardo,9999,0,9999,0
1713492098432,CLRE 297,001,507242,Cuomo; Raphael Eduardo,9999,0,9999,0
1713492099457,CSE 191,A00,516875,Minnes Kemp; Mor Mia,9999,0,9999,0
1713492100481,CSS 201S,A01,494383,Staff,35,0,35,0
1713492101507,CSS 202S,A01,494387,Staff,35,0,35,0
1713492102533,EAP 100,A00,516065,Staff,9792,0,9999,207
1713492103559,ECE 45,A01,507414,Staff,38,0,60,22
1713492104589,ECE 100,A01,507416,Baghdadchi; Saharnaz,0,0,20,20
1713492104589,ECE 100,A02,507418,Baghdadchi; Saharnaz,19,0,20,1
1713492105614,ECE 111,A01,507420,Staff,27,0,50,23
1713492106638,ECE 197,001,548057,Sievenpiper; Daniel F.,9998,0,9999,1
1713492107664,EDS 115,A00,507243,Choi; Bailey Miyeon,27,0,28,1
1713492108689,EDS 117,A01,494379,Staff,15,0,25,10
1713492109718,EDS 125,A00,507246,Hopkins; Megan Beth,27,0,30,3
1713492110745,EDS 128A,A01,507264,Fargason; Sharon Gayle,26,0,26,0
1713492111777,EDS 128B,A01,507293,Pappas; Elizabeth,30,0,30,0
1713492112801,EDS 139,A00,507294,Fargason; Sharon Gayle,30,0,30,0
1713492112801,EDS 139,B00,507313,Pappas; Elizabeth,30,0,30,0
1713492113829,EDS 201,A00,507315,Staff,18,0,30,12
1713492114854,EDS 203,A01,507317,Halter; Christopher P.,17,0,30,13
1713492115884,EDS 204R,A01,507319,Halter; Christopher P.,0,1,30,30
1713492115884,EDS 204R,B01,507331,Heinzman; Erica M.,22,0,30,8
1713492116910,EDS 206R,A00,507332,Staff,0,2,30,30
1713492116910,EDS 206R,B00,507343,Staff,23,0,30,7
1713492117940,EDS 250,A00,507344,Hemans; Patricia Ann Benitez,27,0,40,13
1713492118969,EDS 281,A00,507345,Daly; Alan J.,18,0,18,0
1713492119993,EDS 284,A00,507350,Daly; Alan J.,16,0,16,0
1713492121026,EDS 286,A00,507359,Fine; Sarah,18,0,18,0
1713492122052,EDS 289C,A01,507361,Daly; Alan J.,18,0,18,0
1713492123078,EDS 290,A00,507366,Hofstetter; Carolyn,15,0,15,0
1713492124102,LIGM 5A,A00,507421,Fischer-Grunski; Eva K,20,0,20,0
1713492125128,LIGM 5B,A00,507423,Fischer-Grunski; Eva K,20,0,20,0
1713492126158,LIGM 5C,A00,507425,Fischer-Grunski; Eva K,20,0,20,0
1713492127188,LIIT 5AS,A00,507427,Carnelos; Chiara,20,0,20,0
1713492128213,LIIT 5BS,A00,507430,Carnelos; Chiara,20,0,20,0
1713492129244,LIIT 5CS,A00,507432,Carnelos; Chiara,20,0,20,0
1713492130271,LISP 5A,A00,507541,Munoz Sanchez; Alicia,14,0,20,6
1713492131297,LISP 5B,A00,507671,Munoz Sanchez; Alicia,12,0,20,8
1713492132325,LISP 5C,A00,507696,Munoz Sanchez; Alicia,11,0,20,9
1713492133354,MAE 197,001,528363,Boechler; Nicholas Sebastia,9998,0,9999,1
1713492134385,MATH 197,001,523477,Kedlaya; Kiran S.,9999,0,9999,0
1713492134385,MATH 197,002,563811,Zhang; Danna,9998,0,9999,1
1713492135410,MCWP 40R,A00,518780,Staff,15,0,20,5
1713492135410,MCWP 40R,B00,518781,Staff,14,0,20,6
1713492135410,MCWP 40R,C00,518783,Staff,10,0,20,10
1713492136437,MCWP 50R,A00,518791,Staff,8,0,20,12
1713492136437,MCWP 50R,B00,518792,Staff,4,0,20,16
1713492136437,MCWP 50R,C00,518793,Staff,7,0,20,13
1713492136437,MCWP 50R,D00,518794,Staff,0,0,20,20
1713492136437,MCWP 50R,E00,518795,Staff,0,0,20,20
1713492136437,MCWP 50R,F00,518796,Staff,12,0,20,8
1713492136437,MCWP 50R,G00,518797,Staff,11,0,20,9
1713492137464,MMW 12R,A01,514034,Herbst; Matthew,5,0,16,11
1713492137464,MMW 12R,A02,514035,Herbst; Matthew,13,0,16,3
1713492138489,MMW 13R,A01,514037,Staff,0,5,16,16
1713492138489,MMW 13R,A02,514039,Staff,0,4,16,16
1713492140543,SIO 295LS,A00,523233,Staff,15,0,30,15
1713492141568,SIO 295S,A00,523232,Staff,15,0,30,15
1713492142596,SOCI 117,A01,494376,Staff,0,2,5,5
1713492143622,WES 237B,A00,494380,Staff,19,0,20,1
1713492145690,AESE 279B,A00,494370,Wade; Jon P,33,0,33,0
1713492146719,AIP 197,001,627712,Vespa; Emanuel Ignacio,9999,0,9999,0
1713492147744,ANAR 135S,A00,494369,Braswell; Geoffrey E.,0,0,0,0
1713492148772,CAT 124RS,A01,519847,Geibel; William,6,0,20,14
1713492149851,CAT 125RS,A01,515971,Geibel; William,6,0,20,14
1713492150878,CLRE 250,A00,511389,Morris; Sheldon,9996,0,9999,3
1713492151909,CLRE 251,A00,507176,Mehta; Ravindra L.,9996,0,9999,3
1713492151909,CLRE 251,B00,511410,Mehta; Ravindra L.,9998,0,9999,1
1713492152938,CLRE 252,A00,507189,Cuomo; Raphael Eduardo,9998,0,9999,1
1713492153968,CLRE 253,A00,507199,Vaida; Florin,9997,0,9999,2
1713492153968,CLRE 253,B00,507202,Vaida; Florin,9999,0,9999,0
1713492154993,CLRE 259,A00,507211,Patel; Hemal,9996,0,9999,3
1713492156024,CLRE 260,A00,507221,Cuomo; Raphael Eduardo,9999,0,9999,0
1713492157050,CLRE 297,001,507242,Cuomo; Raphael Eduardo,9999,0,9999,0
1713492158077,CSE 191,A00,516875,Minnes Kemp; Mor Mia,9999,0,9999,0
1713492159104,CSS 201S,A01,494383,Staff,35,0,35,0
1713492160129,CSS 202S,A01,494387,Staff,35,0,35,0
1713492161154,EAP 100,A00,516065,Staff,9792,0,9999,207
1713492162180,ECE 45,A01,507414,Staff,38,0,60,22
1713492163206,ECE 100,A01,507416,Baghdadchi; Saharnaz,0,0,20,20
1713492163206,ECE 100,A02,507418,Baghdadchi; Saharnaz,19,0,20,1
1713492164230,ECE 111,A01,507420,Staff,27,0,50,23
1713492165261,ECE 197,001,548057,Sievenpiper; Daniel F.,9998,0,9999,1
1713492166286,EDS 115,A00,507243,Choi; Bailey Miyeon,27,0,28,1
1713492167312,EDS 117,A01,494379,Staff,15,0,25,10
1713492168342,EDS 125,A00,507246,Hopkins; Megan Beth,27,0,30,3
1713492169372,EDS 128A,A01,507264,Fargason; Sharon Gayle,26,0,26,0
1713492170398,EDS 128B,A01,507293,Pappas; Elizabeth,30,0,30,0
1713492171424,EDS 139,A00,507294,Fargason; Sharon Gayle,30,0,30,0
1713492171424,EDS 139,B00,507313,Pappas; Elizabeth,30,0,30,0
1713492172453,EDS 201,A00,507315,Staff,18,0,30,12
1713492173481,EDS 203,A01,507317,Halter; Christopher P.,17,0,30,13
1713492174510,EDS 204R,A01,507319,Halter; Christopher P.,0,1,30,30
1713492174510,EDS 204R,B01,507331,Heinzman; Erica M.,22,0,30,8
1713492175535,EDS 206R,A00,507332,Staff,0,2,30,30
1713492175535,EDS 206R,B00,507343,Staff,23,0,30,7
1713492176561,EDS 250,A00,507344,Hemans; Patricia Ann Benitez,27,0,40,13
1713492177589,EDS 281,A00,507345,Daly; Alan J.,18,0,18,0
1713492178619,EDS 284,A00,507350,Daly; Alan J.,16,0,16,0
1713492179645,EDS 286,A00,507359,Fine; Sarah,18,0,18,0
1713492180671,EDS 289C,A01,507361,Daly; Alan J.,18,0,18,0
1713492181696,EDS 290,A00,507366,Hofstetter; Carolyn,15,0,15,0
1713492182723,LIGM 5A,A00,507421,Fischer-Grunski; Eva K,20,0,20,0
1713492183752,LIGM 5B,A00,507423,Fischer-Grunski; Eva K,20,0,20,0
1713492184781,LIGM 5C,A00,507425,Fischer-Grunski; Eva K,20,0,20,0
1713492185807,LIIT 5AS,A00,507427,Carnelos; Chiara,20,0,20,0
1713492186833,LIIT 5BS,A00,507430,Carnelos; Chiara,20,0,20,0
1713492187858,LIIT 5CS,A00,507432,Carnelos; Chiara,20,0,20,0
1713492189024,LISP 5A,A00,507541,Munoz Sanchez; Alicia,14,0,20,6
1713492190050,LISP 5B,A00,507671,Munoz Sanchez; Alicia,12,0,20,8
1713492191075,LISP 5C,A00,507696,Munoz Sanchez; Alicia,11,0,20,9
1713492192100,MAE 197,001,528363,Boechler; Nicholas Sebastia,9998,0,9999,1
1713492193131,MATH 197,001,523477,Kedlaya; Kiran S.,9999,0,9999,0
1713492193131,MATH 197,002,563811,Zhang; Danna,9998,0,9999,1
1713492194161,MCWP 40R,A00,518780,Staff,15,0,20,5
1713492194161,MCWP 40R,B00,518781,Staff,14,0,20,6
1713492194161,MCWP 40R,C00,518783,Staff,10,0,20,10
1713492195186,MCWP 50R,A00,518791,Staff,8,0,20,12
1713492195186,MCWP 50R,B00,518792,Staff,4,0,20,16
1713492195186,MCWP 50R,C00,518793,Staff,7,0,20,13
1713492195186,MCWP 50R,D00,518794,Staff,0,0,20,20
1713492195186,MCWP 50R,E00,518795,Staff,0,0,20,20
1713492195186,MCWP 50R,F00,518796,Staff,11,0,20,9
1713492195186,MCWP 50R,G00,518797,Staff,11,0,20,9
1713492196212,MMW 12R,A01,514034,Herbst; Matthew,5,0,16,11
1713492196212,MMW 12R,A02,514035,Herbst; Matthew,13,0,16,3
1713492197240,MMW 13R,A01,514037,Staff,0,5,16,16
1713492197240,MMW 13R,A02,514039,Staff,0,4,16,16
1713492199298,SIO 295LS,A00,523233,Staff,15,0,30,15
1713492200323,SIO 295S,A00,523232,Staff,15,0,30,15
1713492201350,SOCI 117,A01,494376,Staff,0,2,5,5
1713492202376,WES 237B,A00,494380,Staff,19,0,20,1
1713492204449,AESE 279B,A00,494370,Wade; Jon P,33,0,33,0
1713492205477,AIP 197,001,627712,Vespa; Emanuel Ignacio,9999,0,9999,0
1713492206505,ANAR 135S,A00,494369,Braswell; Geoffrey E.,0,0,0,0
1713492207532,CAT 124RS,A01,519847,Geibel; William,6,0,20,14
1713492208558,CAT 125RS,A01,515971,Geibel; William,6,0,20,14
1713492209584,CLRE 250,A00,511389,Morris; Sheldon,9996,0,9999,3
1713492210612,CLRE 251,A00,507176,Mehta; Ravindra L.,9996,0,9999,3
1713492210612,CLRE 251,B00,511410,Mehta; Ravindra L.,9998,0,9999,1
1713492211637,CLRE 252,A00,507189,Cuomo; Raphael Eduardo,9998,0,9999,1
1713492212666,CLRE 253,A00,507199,Vaida; Florin,9997,0,9999,2
1713492212666,CLRE 253,B00,507202,Vaida; Florin,9999,0,9999,0
1713492213693,CLRE 259,A00,507211,Patel; Hemal,9996,0,9999,3
1713492214717,CLRE 260,A00,507221,Cuomo; Raphael Eduardo,9999,0,9999,0
1713492215744,CLRE 297,001,507242,Cuomo; Raphael Eduardo,9999,0,9999,0
1713492216770,CSE 191,A00,516875,Minnes Kemp; Mor Mia,9999,0,9999,0
1713492217801,CSS 201S,A01,494383,Staff,35,0,35,0
1713492218832,CSS 202S,A01,494387,Staff,35,0,35,0
1713492219857,EAP 100,A00,516065,Staff,9792,0,9999,207
1713492220888,ECE 45,A01,507414,Staff,38,0,60,22
1713492221918,ECE 100,A01,507416,Baghdadchi; Saharnaz,0,0,20,20
1713492221918,ECE 100,A02,507418,Baghdadchi; Saharnaz,19,0,20,1
1713492222944,ECE 111,A01,507420,Staff,27,0,50,23
1713492223970,ECE 197,001,548057,Sievenpiper; Daniel F.,9998,0,9999,1
1713492224996,EDS 115,A00,507243,Choi; Bailey Miyeon,27,0,28,1
1713492226022,EDS 117,A01,494379,Staff,15,0,25,10
1713492227049,EDS 125,A00,507246,Hopkins; Megan Beth,27,0,30,3
1713492228081,EDS 128A,A01,507264,Fargason; Sharon Gayle,26,0,26,0
1713492229110,EDS 128B,A01,507293,Pappas; Elizabeth,30,0,30,0
1713492230137,EDS 139,A00,507294,Fargason; Sharon Gayle,30,0,30,0
1713492230137,EDS 139,B00,507313,Pappas; Elizabeth,30,0,30,0
1713492231163,EDS 201,A00,507315,Staff,18,0,30,12
1713492232193,EDS 203,A01,507317,Halter; Christopher P.,17,0,30,13
1713492233223,EDS 204R,A01,507319,Halter; Christopher P.,0,1,30,30
1713492233223,EDS 204R,B01,507331,Heinzman; Erica M.,22,0,30,8
1713492234250,EDS 206R,A00,507332,Staff,0,2,30,30
1713492234250,EDS 206R,B00,507343,Staff,23,0,30,7
1713492235277,EDS 250,A00,507344,Hemans; Patricia Ann Benitez,27,0,40,13
1713492236304,EDS 281,A00,507345,Daly; Alan J.,18,0,18,0
1713492237327,EDS 284,A00,507350,Daly; Alan J.,16,0,16,0
1713492238352,EDS 286,A00,507359,Fine; Sarah,18,0,18,0
1713492239378,EDS 289C,A01,507361,Daly; Alan J.,18,0,18,0
1713492240614,EDS 290,A00,507366,Hofstetter; Carolyn,15,0,15,0
1713492241641,LIGM 5A,A00,507421,Fischer-Grunski; Eva K,20,0,20,0
1713492242670,LIGM 5B,A00,507423,Fischer-Grunski; Eva K,20,0,20,0
1713492243696,LIGM 5C,A00,507425,Fischer-Grunski; Eva K,20,0,20,0
1713492244721,LIIT 5AS,A00,507427,Carnelos; Chiara,20,0,20,0
1713492245750,LIIT 5BS,A00,507430,Carnelos; Chiara,20,0,20,0
1713492246778,LIIT 5CS,A00,507432,Carnelos; Chiara,20,0,20,0
1713492247803,LISP 5A,A00,507541,Munoz Sanchez; Alicia,14,0,20,6
1713492248833,LISP 5B,A00,507671,Munoz Sanchez; Alicia,12,0,20,8
1713492249859,LISP 5C,A00,507696,Munoz Sanchez; Alicia,11,0,20,9
1713492250883,MAE 197,001,528363,Boechler; Nicholas Sebastia,9998,0,9999,1
1713492251914,MATH 197,001,523477,Kedlaya; Kiran S.,9999,0,9999,0
1713492251914,MATH 197,002,563811,Zhang; Danna,9998,0,9999,1
1713492252938,MCWP 40R,A00,518780,Staff,15,0,20,5
1713492252938,MCWP 40R,B00,518781,Staff,14,0,20,6
1713492252938,MCWP 40R,C00,518783,Staff,10,0,20,10
1713492254020,MCWP 50R,A00,518791,Staff,8,0,20,12
1713492254020,MCWP 50R,B00,518792,Staff,4,0,20,16
1713492254020,MCWP 50R,C00,518793,Staff,7,0,20,13
1713492254020,MCWP 50R,D00,518794,Staff,0,0,20,20
1713492254020,MCWP 50R,E00,518795,Staff,0,0,20,20
1713492254020,MCWP 50R,F00,518796,Staff,11,0,20,9
1713492254020,MCWP 50R,G00,518797,Staff,11,0,20,9
1713492255051,MMW 12R,A01,514034,Herbst; Matthew,5,0,16,11
1713492255051,MMW 12R,A02,514035,Herbst; Matthew,13,0,16,3
1713492256077,MMW 13R,A01,514037,Staff,0,5,16,16
1713492256077,MMW 13R,A02,514039,Staff,0,4,16,16
1713492258131,SIO 295LS,A00,523233,Staff,15,0,30,15
1713492259156,SIO 295S,A00,523232,Staff,15,0,30,15
1713492260185,SOCI 117,A01,494376,Staff,0,2,5,5
1713492261209,WES 237B,A00,494380,Staff,19,0,20,1
1713492263282,AESE 279B,A00,494370,Wade; Jon P,33,0,33,0
1713492264308,AIP 197,001,627712,Vespa; Emanuel Ignacio,9999,0,9999,0
1713492265336,ANAR 135S,A00,494369,Braswell; Geoffrey E.,0,0,0,0
1713492266365,CAT 124RS,A01,519847,Geibel; William,6,0,20,14
1713492267390,CAT 125RS,A01,515971,Geibel; William,6,0,20,14
1713492268414,CLRE 250,A00,511389,Morris; Sheldon,9996,0,9999,3
1713492269446,CLRE 251,A00,507176,Mehta; Ravindra L.,9996,0,9999,3
1713492269446,CLRE 251,B00,511410,Mehta; Ravindra L.,9998,0,9999,1
1713492270472,CLRE 252,A00,507189,Cuomo; Raphael Eduardo,9998,0,9999,1
1713492271498,CLRE 253,A00,507199,Vaida; Florin,9997,0,9999,2
1713492271498,CLRE 253,B00,507202,Vaida; Florin,9999,0,9999,0
1713492272523,CLRE 259,A00,507211,Patel; Hemal,9996,0,9999,3
1713492273549,CLRE 260,A00,507221,Cuomo; Raphael Eduardo,9999,0,9999,0
1713492274576,CLRE 297,001,507242,Cuomo; Raphael Eduardo,9999,0,9999,0
1713492275602,CSE 191,A00,516875,Minnes Kemp; Mor Mia,9999,0,9999,0
1713492276634,CSS 201S,A01,494383,Staff,35,0,35,0
1713492277664,CSS 202S,A01,494387,Staff,35,0,35,0
1713492278689,EAP 100,A00,516065,Staff,9792,0,9999,207
1713492279716,ECE 45,A01,507414,Staff,38,0,60,22
1713492280742,ECE 100,A01,507416,Baghdadchi; Saharnaz,0,0,20,20
1713492280742,ECE 100,A02,507418,Baghdadchi; Saharnaz,19,0,20,1
1713492281772,ECE 111,A01,507420,Staff,27,0,50,23
1713492282801,ECE 197,001,548057,Sievenpiper; Daniel F.,9998,0,9999,1
1713492283827,EDS 115,A00,507243,Choi; Bailey Miyeon,27,0,28,1
1713492284855,EDS 117,A01,494379,Staff,15,0,25,10
1713492285888,EDS 125,A00,507246,Hopkins; Megan Beth,27,0,30,3
1713492286915,EDS 128A,A01,507264,Fargason; Sharon Gayle,26,0,26,0
1713492287941,EDS 128B,A01,507293,Pappas; Elizabeth,30,0,30,0
1713492288967,EDS 139,A00,507294,Fargason; Sharon Gayle,30,0,30,0
1713492288967,EDS 139,B00,507313,Pappas; Elizabeth,30,0,30,0
1713492289992,EDS 201,A00,507315,Staff,18,0,30,12
1713492291021,EDS 203,A01,507317,Halter; Christopher P.,17,0,30,13
1713492292047,EDS 204R,A01,507319,Halter; Christopher P.,0,1,30,30
1713492292047,EDS 204R,B01,507331,Heinzman; Erica M.,22,0,30,8
1713492293076,EDS 206R,A00,507332,Staff,0,2,30,30
1713492293076,EDS 206R,B00,507343,Staff,23,0,30,7
1713492294104,EDS 250,A00,507344,Hemans; Patricia Ann Benitez,27,0,40,13
1713492295132,EDS 281,A00,507345,Daly; Alan J.,18,0,18,0
1713492296160,EDS 284,A00,507350,Daly; Alan J.,16,0,16,0
1713492297186,EDS 286,A00,507359,Fine; Sarah,18,0,18,0
1713492298216,EDS 289C,A01,507361,Daly; Alan J.,18,0,18,0
1713492299241,EDS 290,A00,507366,Hofstetter; Carolyn,15,0,15,0
1713492300267,LIGM 5A,A00,507421,Fischer-Grunski; Eva K,20,0,20,0
1713492301294,LIGM 5B,A00,507423,Fischer-Grunski; Eva K,20,0,20,0
1713492302320,LIGM 5C,A00,507425,Fischer-Grunski; Eva K,20,0,20,0
1713492303346,LIIT 5AS,A00,507427,Carnelos; Chiara,20,0,20,0
1713492304376,LIIT 5BS,A00,507430,Carnelos; Chiara,20,0,20,0
1713492305400,LIIT 5CS,A00,507432,Carnelos; Chiara,20,0,20,0
1713492306432,LISP 5A,A00,507541,Munoz Sanchez; Alicia,14,0,20,6
1713492307493,LISP 5B,A00,507671,Munoz Sanchez; Alicia,12,0,20,8
1713492308523,LISP 5C,A00,507696,Munoz Sanchez; Alicia,11,0,20,9
1713492309548,MAE 197,001,528363,Boechler; Nicholas Sebastia,9998,0,9999,1
1713492310579,MATH 197,001,523477,Kedlaya; Kiran S.,9999,0,9999,0
1713492310579,MATH 197,002,563811,Zhang; Danna,9998,0,9999,1
1713492311605,MCWP 40R,A00,518780,Staff,15,0,20,5
1713492311605,MCWP 40R,B00,518781,Staff,14,0,20,6
1713492311605,MCWP 40R,C00,518783,Staff,10,0,20,10
1713492312631,MCWP 50R,A00,518791,Staff,8,0,20,12
1713492312631,MCWP 50R,B00,518792,Staff,4,0,20,16
1713492312631,MCWP 50R,C00,518793,Staff,7,0,20,13
1713492312631,MCWP 50R,D00,518794,Staff,0,0,20,20
1713492312631,MCWP 50R,E00,518795,Staff,0,0,20,20
1713492312631,MCWP 50R,F00,518796,Staff,11,0,20,9
1713492312631,MCWP 50R,G00,518797,Staff,11,0,20,9
1713492313656,MMW 12R,A01,514034,Herbst; Matthew,5,0,16,11
1713492313656,MMW 12R,A02,514035,Herbst; Matthew,13,0,16,3
1713492314682,MMW 13R,A01,514037,Staff,0,5,16,16
1713492314682,MMW 13R,A02,514039,Staff,0,4,16,16
1713492316740,SIO 295LS,A00,523233,Staff,15,0,30,15
1713492317769,SIO 295S,A00,523232,Staff,15,0,30,15
1713492318795,SOCI 117,A01,494376,Staff,0,2,5,5
1713492319823,WES 237B,A00,494380,Staff,19,0,20,1
1713492321898,AESE 279B,A00,494370,Wade; Jon P,33,0,33,0
1713492322923,AIP 197,001,627712,Vespa; Emanuel Ignacio,9999,0,9999,0
1713492323950,ANAR 135S,A00,494369,Braswell; Geoffrey E.,0,0,0,0
1713492324976,CAT 124RS,A01,519847,Geibel; William,6,0,20,14
1713492326002,CAT 125RS,A01,515971,Geibel; William,6,0,20,14
1713492327028,CLRE 250,A00,511389,Morris; Sheldon,9996,0,9999,3
1713492328055,CLRE 251,A00,507176,Mehta; Ravindra L.,9996,0,9999,3
1713492328055,CLRE 251,B00,511410,Mehta; Ravindra L.,9998,0,9999,1
1713492329083,CLRE 252,A00,507189,Cuomo; Raphael Eduardo,9998,0,9999,1
1713492330110,CLRE 253,A00,507199,Vaida; Florin,9997,0,9999,2
1713492330110,CLRE 253,B00,507202,Vaida; Florin,9999,0,9999,0
1713492331136,CLRE 259,A00,507211,Patel; Hemal,9996,0,9999,3
1713492332165,CLRE 260,A00,507221,Cuomo; Raphael Eduardo,9999,0,9999,0
1713492333192,CLRE 297,001,507242,Cuomo; Raphael Eduardo,9999,0,9999,0
1713492334219,CSE 191,A00,516875,Minnes Kemp; Mor Mia,9999,0,9999,0
1713492335247,CSS 201S,A01,494383,Staff,35,0,35,0
1713492336271,CSS 202S,A01,494387,Staff,35,0,35,0
1713492337297,EAP 100,A00,516065,Staff,9792,0,9999,207
1713492338325,ECE 45,A01,507414,Staff,38,0,60,22
1713492339356,ECE 100,A01,507416,Baghdadchi; Saharnaz,0,0,20,20
1713492339356,ECE 100,A02,507418,Baghdadchi; Saharnaz,19,0,20,1
1713492340380,ECE 111,A01,507420,Staff,27,0,50,23
1713492341408,ECE 197,001,548057,Sievenpiper; Daniel F.,9998,0,9999,1
1713492342434,EDS 115,A00,507243,Choi; Bailey Miyeon,27,0,28,1
1713492343460,EDS 117,A01,494379,Staff,15,0,25,10
1713492344489,EDS 125,A00,507246,Hopkins; Megan Beth,27,0,30,3
1713492345516,EDS 128A,A01,507264,Fargason; Sharon Gayle,26,0,26,0
1713492346548,EDS 128B,A01,507293,Pappas; Elizabeth,30,0,30,0
1713492347572,EDS 139,A00,507294,Fargason; Sharon Gayle,30,0,30,0
1713492347572,EDS 139,B00,507313,Pappas; Elizabeth,30,0,30,0
1713492348597,EDS 201,A00,507315,Staff,18,0,30,12
1713492349626,EDS 203,A01,507317,Halter; Christopher P.,17,0,30,13
1713492350655,EDS 204R,A01,507319,Halter; Christopher P.,0,1,30,30
1713492350655,EDS 204R,B01,507331,Heinzman; Erica M.,22,0,30,8
1713492351681,EDS 206R,A00,507332,Staff,0,2,30,30
1713492351681,EDS 206R,B00,507343,Staff,23,0,30,7
1713492352706,EDS 250,A00,507344,Hemans; Patricia Ann Benitez,27,0,40,13
1713492353734,EDS 281,A00,507345,Daly; Alan J.,18,0,18,0
1713492354760,EDS 284,A00,507350,Daly; Alan J.,16,0,16,0
1713492355790,EDS 286,A00,507359,Fine; Sarah,18,0,18,0
1713492356818,EDS 289C,A01,507361,Daly; Alan J.,18,0,18,0
1713492357898,EDS 290,A00,507366,Hofstetter; Carolyn,15,0,15,0
1713492358925,LIGM 5A,A00,507421,Fischer-Grunski; Eva K,20,0,20,0
1713492359952,LIGM 5B,A00,507423,Fischer-Grunski; Eva K,20,0,20,0
1713492360978,LIGM 5C,A00,507425,Fischer-Grunski; Eva K,20,0,20,0
1713492362011,LIIT 5AS,A00,507427,Carnelos; Chiara,20,0,20,0
1713492363042,LIIT 5BS,A00,507430,Carnelos; Chiara,20,0,20,0
1713492364071,LIIT 5CS,A00,507432,Carnelos; Chiara,20,0,20,0
1713492365097,LISP 5A,A00,507541,Munoz Sanchez; Alicia,14,0,20,6
1713492366123,LISP 5B,A00,507671,Munoz Sanchez; Alicia,12,0,20,8
1713492367148,LISP 5C,A00,507696,Munoz Sanchez; Alicia,11,0,20,9
1713492368174,MAE 197,001,528363,Boechler; Nicholas Sebastia,9998,0,9999,1
1713492369199,MATH 197,001,523477,Kedlaya; Kiran S.,9999,0,9999,0
1713492369199,MATH 197,002,563811,Zhang; Danna,9998,0,9999,1
1713492370225,MCWP 40R,A00,518780,Staff,15,0,20,5
1713492370225,MCWP 40R,B00,518781,Staff,14,0,20,6
1713492370225,MCWP 40R,C00,518783,Staff,10,0,20,10
1713492371255,MCWP 50R,A00,518791,Staff,8,0,20,12
1713492371255,MCWP 50R,B00,518792,Staff,4,0,20,16
1713492371255,MCWP 50R,C00,518793,Staff,7,0,20,13
1713492371255,MCWP 50R,D00,518794,Staff,0,0,20,20
1713492371255,MCWP 50R,E00,518795,Staff,0,0,20,20
1713492371255,MCWP 50R,F00,518796,Staff,11,0,20,9
1713492371255,MCWP 50R,G00,518797,Staff,11,0,20,9
1713492372280,MMW 12R,A01,514034,Herbst; Matthew,5,0,16,11
1713492372280,MMW 12R,A02,514035,Herbst; Matthew,13,0,16,3
1713492373308,MMW 13R,A01,514037,Staff,0,5,16,16
1713492373308,MMW 13R,A02,514039,Staff,0,4,16,16
1713492375360,SIO 295LS,A00,523233,Staff,15,0,30,15
1713492376384,SIO 295S,A00,523232,Staff,15,0,30,15
1713492377410,SOCI 117,A01,494376,Staff,0,2,5,5
1713492378434,WES 237B,A00,494380,Staff,19,0,20,1
1713492380507,AESE 279B,A00,494370,Wade; Jon P,33,0,33,0
1713492381535,AIP 197,001,627712,Vespa; Emanuel Ignacio,9999,0,9999,0
1713492382560,ANAR 135S,A00,494369,Braswell; Geoffrey E.,0,0,0,0
1713492383585,CAT 124RS,A01,519847,Geibel; William,6,0,20,14
1713492384613,CAT 125RS,A01,515971,Geibel; William,6,0,20,14
1713492385641,CLRE 250,A00,511389,Morris; Sheldon,9996,0,9999,3
1713492386671,CLRE 251,A00,507176,Mehta; Ravindra L.,9996,0,9999,3
1713492386671,CLRE 251,B00,511410,Mehta; Ravindra L.,9998,0,9999,1
1713492387698,CLRE 252,A00,507189,Cuomo; Raphael Eduardo,9998,0,9999,1
1713492388724,CLRE 253,A00,507199,Vaida; Florin,9997,0,9999,2
1713492388724,CLRE 253,B00,507202,Vaida; Florin,9999,0,9999,0
1713492389750,CLRE 259,A00,507211,Patel; Hemal,9996,0,9999,3
1713492390776,CLRE 260,A00,507221,Cuomo; Raphael Eduardo,9999,0,9999,0
1713492391800,CLRE 297,001,507242,Cuomo; Raphael Eduardo,9999,0,9999,0
1713492392826,CSE 191,A00,516875,Minnes Kemp; Mor Mia,9999,0,9999,0
1713492393862,CSS 201S,A01,494383,Staff,35,0,35,0
1713492394891,CSS 202S,A01,494387,Staff,35,0,35,0
1713492395918,EAP 100,A00,516065,Staff,9792,0,9999,207
1713492396945,ECE 45,A01,507414,Staff,38,0,60,22
1713492397971,ECE 100,A01,507416,Baghdadchi; Saharnaz,0,0,20,20
1713492397971,ECE 100,A02,507418,Baghdadchi; Saharnaz,19,0,20,1
1713492398996,ECE 111,A01,507420,Staff,27,0,50,23
1713492400024,ECE 197,001,548057,Sievenpiper; Daniel F.,9998,0,9999,1
1713492401060,EDS 115,A00,507243,Choi; Bailey Miyeon,27,0,28,1
1713492402085,EDS 117,A01,494379,Staff,15,0,25,10
1713492403110,EDS 125,A00,507246,Hopkins; Megan Beth,27,0,30,3
1713492404135,EDS 128A,A01,507264,Fargason; Sharon Gayle,26,0,26,0
1713492405160,EDS 128B,A01,507293,Pappas; Elizabeth,30,0,30,0
1713492406189,EDS 139,A00,507294,Fargason; Sharon Gayle,30,0,30,0
1713492406189,EDS 139,B00,507313,Pappas; Elizabeth,30,0,30,0
1713492407214,EDS 201,A00,507315,Staff,18,0,30,12
1713492408243,EDS 203,A01,507317,Halter; Christopher P.,17,0,30,13
1713492409272,EDS 204R,A01,507319,Halter; Christopher P.,0,1,30,30
1713492409272,EDS 204R,B01,507331,Heinzman; Erica M.,22,0,30,8
1713492410300,EDS 206R,A00,507332,Staff,0,2,30,30
1713492410300,EDS 206R,B00,507343,Staff,23,0,30,7
1713492411325,EDS 250,A00,507344,Hemans; Patricia Ann Benitez,27,0,40,13
1713492412350,EDS 281,A00,507345,Daly; Alan J.,18,0,18,0
1713492413376,EDS 284,A00,507350,Daly; Alan J.,16,0,16,0
1713492414405,EDS 286,A00,507359,Fine; Sarah,18,0,18,0
1713492415430,EDS 289C,A01,507361,Daly; Alan J.,18,0,18,0
1713492416456,EDS 290,A00,507366,Hofstetter; Carolyn,15,0,15,0
1713492417483,LIGM 5A,A00,507421,Fischer-Grunski; Eva K,20,0,20,0
1713492418512,LIGM 5B,A00,507423,Fischer-Grunski; Eva K,20,0,20,0
1713492419542,LIGM 5C,A00,507425,Fischer-Grunski; Eva K,20,0,20,0
1713492420568,LIIT 5AS,A00,507427,Carnelos; Chiara,20,0,20,0
1713492421599,LIIT 5BS,A00,507430,Carnelos; Chiara,20,0,20,0
1713492422629,LIIT 5CS,A00,507432,Carnelos; Chiara,20,0,20,0
1713492423659,LISP 5A,A00,507541,Munoz Sanchez; Alicia,14,0,20,6
1713492424688,LISP 5B,A00,507671,Munoz Sanchez; Alicia,12,0,20,8
1713492425715,LISP 5C,A00,507696,Munoz Sanchez; Alicia,11,0,20,9
1713492426741,MAE 197,001,528363,Boechler; Nicholas Sebastia,9998,0,9999,1
1713492427767,MATH 197,001,523477,Kedlaya; Kiran S.,9999,0,9999,0
1713492427767,MATH 197,002,563811,Zhang; Danna,9998,0,9999,1
1713492428797,MCWP 40R,A00,518780,Staff,15,0,20,5
1713492428797,MCWP 40R,B00,518781,Staff,14,0,20,6
1713492428797,MCWP 40R,C00,518783,Staff,10,0,20,10
1713492429823,MCWP 50R,A00,518791,Staff,8,0,20,12
1713492429823,MCWP 50R,B00,518792,Staff,4,0,20,16
1713492429823,MCWP 50R,C00,518793,Staff,7,0,20,13
1713492429823,MCWP 50R,D00,518794,Staff,0,0,20,20
1713492429823,MCWP 50R,E00,518795,Staff,0,0,20,20
1713492429823,MCWP 50R,F00,518796,Staff,11,0,20,9
1713492429823,MCWP 50R,G00,518797,Staff,11,0,20,9
1713492430851,MMW 12R,A01,514034,Herbst; Matthew,5,0,16,11
1713492430851,MMW 12R,A02,514035,Herbst; Matthew,13,0,16,3
1713492431878,MMW 13R,A01,514037,Staff,0,5,16,16
1713492431878,MMW 13R,A02,514039,Staff,0,4,16,16
1713492433930,SIO 295LS,A00,523233,Staff,15,0,30,15
1713492434955,SIO 295S,A00,523232,Staff,15,0,30,15
1713492435980,SOCI 117,A01,494376,Staff,0,2,5,5
1713492437007,WES 237B,A00,494380,Staff,19,0,20,1
1713492439072,AESE 279B,A00,494370,Wade; Jon P,33,0,33,0
1713492440101,AIP 197,001,627712,Vespa; Emanuel Ignacio,9999,0,9999,0
1713492441126,ANAR 135S,A00,494369,Braswell; Geoffrey E.,0,0,0,0
1713492442151,CAT 124RS,A01,519847,Geibel; William,6,0,20,14
1713492443176,CAT 125RS,A01,515971,Geibel; William,6,0,20,14
1713492444203,CLRE 250,A00,511389,Morris; Sheldon,9996,0,9999,3
1713492445234,CLRE 251,A00,507176,Mehta; Ravindra L.,9996,0,9999,3
1713492445234,CLRE 251,B00,511410,Mehta; Ravindra L.,9998,0,9999,1
1713492446261,CLRE 252,A00,507189,Cuomo; Raphael Eduardo,9998,0,9999,1
1713492447287,CLRE 253,A00,507199,Vaida; Florin,9997,0,9999,2
1713492447287,CLRE 253,B00,507202,Vaida; Florin,9999,0,9999,0
1713492448313,CLRE 259,A00,507211,Patel; Hemal,9996,0,9999,3
1713492449337,CLRE 260,A00,507221,Cuomo; Raphael Eduardo,9999,0,9999,0
1713492450364,CLRE 297,001,507242,Cuomo; Raphael Eduardo,9999,0,9999,0
1713492451388,CSE 191,A00,516875,Minnes Kemp; Mor Mia,9999,0,9999,0
1713492452414,CSS 201S,A01,494383,Staff,35,0,35,0
1713492453439,CSS 202S,A01,494387,Staff,35,0,35,0
1713492454466,EAP 100,A00,516065,Staff,9792,0,9999,207
1713492455495,ECE 45,A01,507414,Staff,38,0,60,22
1713492456524,ECE 100,A01,507416,Baghdadchi; Saharnaz,0,0,20,20
1713492456524,ECE 100,A02,507418,Baghdadchi; Saharnaz,19,0,20,1
1713492457552,ECE 111,A01,507420,Staff,27,0,50,23
1713492458577,ECE 197,001,548057,Sievenpiper; Daniel F.,9998,0,9999,1
1713492459607,EDS 115,A00,507243,Choi; Bailey Miyeon,27,0,28,1
1713492460633,EDS 117,A01,494379,Staff,15,0,25,10
1713492461714,EDS 125,A00,507246,Hopkins; Megan Beth,27,0,30,3
1713492462742,EDS 128A,A01,507264,Fargason; Sharon Gayle,26,0,26,0
1713492463768,EDS 128B,A01,507293,Pappas; Elizabeth,30,0,30,0
1713492464797,EDS 139,A00,507294,Fargason; Sharon Gayle,30,0,30,0
1713492464797,EDS 139,B00,507313,Pappas; Elizabeth,30,0,30,0
1713492465821,EDS 201,A00,507315,Staff,18,0,30,12
1713492466847,EDS 203,A01,507317,Halter; Christopher P.,17,0,30,13
1713492467873,EDS 204R,A01,507319,Halter; Christopher P.,0,1,30,30
1713492467873,EDS 204R,B01,507331,Heinzman; Erica M.,22,0,30,8
1713492468903,EDS 206R,A00,507332,Staff,0,2,30,30
1713492468903,EDS 206R,B00,507343,Staff,23,0,30,7
1713492469928,EDS 250,A00,507344,Hemans; Patricia Ann Benitez,27,0,40,13
1713492470957,EDS 281,A00,507345,Daly; Alan J.,18,0,18,0
1713492471985,EDS 284,A00,507350,Daly; Alan J.,16,0,16,0
1713492473009,EDS 286,A00,507359,Fine; Sarah,18,0,18,0
1713492474037,EDS 289C,A01,507361,Daly; Alan J.,18,0,18,0
1713492475062,EDS 290,A00,507366,Hofstetter; Carolyn,15,0,15,0
1713492476089,LIGM 5A,A00,507421,Fischer-Grunski; Eva K,20,0,20,0
1713492477115,LIGM 5B,A00,507423,Fischer-Grunski; Eva K,20,0,20,0
1713492478144,LIGM 5C,A00,507425,Fischer-Grunski; Eva K,20,0,20,0
1713492479172,LIIT 5AS,A00,507427,Carnelos; Chiara,20,0,20,0
1713492480198,LIIT 5BS,A00,507430,Carnelos; Chiara,20,0,20,0
1713492481228,LIIT 5CS,A00,507432,Carnelos; Chiara,20,0,20,0
1713492482253,LISP 5A,A00,507541,Munoz Sanchez; Alicia,14,0,20,6
1713492483283,LISP 5B,A00,507671,Munoz Sanchez; Alicia,12,0,20,8
1713492484313,LISP 5C,A00,507696,Munoz Sanchez; Alicia,11,0,20,9
1713492485336,MAE 197,001,528363,Boechler; Nicholas Sebastia,9998,0,9999,1
1713492486363,MATH 197,001,523477,Kedlaya; Kiran S.,9999,0,9999,0
1713492486363,MATH 197,002,563811,Zhang; Danna,9998,0,9999,1
1713492487389,MCWP 40R,A00,518780,Staff,15,0,20,5
1713492487389,MCWP 40R,B00,518781,Staff,14,0,20,6
1713492487389,MCWP 40R,C00,518783,Staff,10,0,20,10
1713492488419,MCWP 50R,A00,518791,Staff,8,0,20,12
1713492488419,MCWP 50R,B00,518792,Staff,4,0,20,16
1713492488419,MCWP 50R,C00,518793,Staff,7,0,20,13
1713492488419,MCWP 50R,D00,518794,Staff,0,0,20,20
1713492488419,MCWP 50R,E00,518795,Staff,0,0,20,20
1713492488419,MCWP 50R,F00,518796,Staff,11,0,20,9
1713492488419,MCWP 50R,G00,518797,Staff,11,0,20,9
1713492489444,MMW 12R,A01,514034,Herbst; Matthew,5,0,16,11
1713492489444,MMW 12R,A02,514035,Herbst; Matthew,13,0,16,3
1713492490473,MMW 13R,A01,514037,Staff,0,5,16,16
1713492490473,MMW 13R,A02,514039,Staff,0,4,16,16
1713492492525,SIO 295LS,A00,523233,Staff,15,0,30,15
1713492493554,SIO 295S,A00,523232,Staff,15,0,30,15
1713492494585,SOCI 117,A01,494376,Staff,0,2,5,5
1713492495610,WES 237B,A00,494380,Staff,19,0,20,1
1713492497680,AESE 279B,A00,494370,Wade; Jon P,33,0,33,0
1713492498708,AIP 197,001,627712,Vespa; Emanuel Ignacio,9999,0,9999,0
1713492499731,ANAR 135S,A00,494369,Braswell; Geoffrey E.,0,0,0,0
1713492500761,CAT 124RS,A01,519847,Geibel; William,6,0,20,14
1713492501789,CAT 125RS,A01,515971,Geibel; William,6,0,20,14
1713492502817,CLRE 250,A00,511389,Morris; Sheldon,9996,0,9999,3
1713492503849,CLRE 251,A00,507176,Mehta; Ravindra L.,9996,0,9999,3
1713492503849,CLRE 251,B00,511410,Mehta; Ravindra L.,9998,0,9999,1
1713492504879,CLRE 252,A00,507189,Cuomo; Raphael Eduardo,9998,0,9999,1
1713492505904,CLRE 253,A00,507199,Vaida; Florin,9997,0,9999,2
1713492505904,CLRE 253,B00,507202,Vaida; Florin,9999,0,9999,0
1713492506932,CLRE 259,A00,507211,Patel; Hemal,9996,0,9999,3
1713492507957,CLRE 260,A00,507221,Cuomo; Raphael Eduardo,9999,0,9999,0
1713492508982,CLRE 297,001,507242,Cuomo; Raphael Eduardo,9999,0,9999,0
1713492510009,CSE 191,A00,516875,Minnes Kemp; Mor Mia,9999,0,9999,0
1713492511037,CSS 201S,A01,494383,Staff,35,0,35,0
1713492512064,CSS 202S,A01,494387,Staff,35,0,35,0
1713492513089,EAP 100,A00,516065,Staff,9792,0,9999,207
1713492514118,ECE 45,A01,507414,Staff,38,0,60,22
1713492515151,ECE 100,A01,507416,Baghdadchi; Saharnaz,0,0,20,20
1713492515151,ECE 100,A02,507418,Baghdadchi; Saharnaz,19,0,20,1
1713492516177,ECE 111,A01,507420,Staff,27,0,50,23
1713492517206,ECE 197,001,548057,Sievenpiper; Daniel F.,9998,0,9999,1
1713492518237,EDS 115,A00,507243,Choi; Bailey Miyeon,27,0,28,1
1713492519263,EDS 117,A01,494379,Staff,15,0,25,10
1713492520292,EDS 125,A00,507246,Hopkins; Megan Beth,27,0,30,3
1713492521322,EDS 128A,A01,507264,Fargason; Sharon Gayle,26,0,26,0
1713492522349,EDS 128B,A01,507293,Pappas; Elizabeth,30,0,30,0
1713492523373,EDS 139,A00,507294,Fargason; Sharon Gayle,30,0,30,0
1713492523373,EDS 139,B00,507313,Pappas; Elizabeth,30,0,30,0
1713492524399,EDS 201,A00,507315,Staff,18,0,30,12
1713492525427,EDS 203,A01,507317,Halter; Christopher P.,17,0,30,13
1713492526452,EDS 204R,A01,507319,Halter; Christopher P.,0,1,30,30
1713492526452,EDS 204R,B01,507331,Heinzman; Erica M.,22,0,30,8
1713492527481,EDS 206R,A00,507332,Staff,0,2,30,30
1713492527481,EDS 206R,B00,507343,Staff,23,0,30,7
1713492528505,EDS 250,A00,507344,Hemans; Patricia Ann Benitez,27,0,40,13
1713492529529,EDS 281,A00,507345,Daly; Alan J.,18,0,18,0
1713492530555,EDS 284,A00,507350,Daly; Alan J.,16,0,16,0
1713492531580,EDS 286,A00,507359,Fine; Sarah,18,0,18,0
1713492532605,EDS 289C,A01,507361,Daly; Alan J.,18,0,18,0
1713492533634,EDS 290,A00,507366,Hofstetter; Carolyn,15,0,15,0
1713492534661,LIGM 5A,A00,507421,Fischer-Grunski; Eva K,20,0,20,0
1713492535686,LIGM 5B,A00,507423,Fischer-Grunski; Eva K,20,0,20,0
1713492536714,LIGM 5C,A00,507425,Fischer-Grunski; Eva K,20,0,20,0
1713492537740,LIIT 5AS,A00,507427,Carnelos; Chiara,20,0,20,0
1713492538765,LIIT 5BS,A00,507430,Carnelos; Chiara,20,0,20,0
1713492539790,LIIT 5CS,A00,507432,Carnelos; Chiara,20,0,20,0
1713492540817,LISP 5A,A00,507541,Munoz Sanchez; Alicia,14,0,20,6
1713492541849,LISP 5B,A00,507671,Munoz Sanchez; Alicia,12,0,20,8
1713492542875,LISP 5C,A00,507696,Munoz Sanchez; Alicia,11,0,20,9
1713492543902,MAE 197,001,528363,Boechler; Nicholas Sebastia,9998,0,9999,1
1713492544928,MATH 197,001,523477,Kedlaya; Kiran S.,9999,0,9999,0
1713492544928,MATH 197,002,563811,Zhang; Danna,9998,0,9999,1
1713492545955,MCWP 40R,A00,518780,Staff,15,0,20,5
1713492545955,MCWP 40R,B00,518781,Staff,14,0,20,6
1713492545955,MCWP 40R,C00,518783,Staff,10,0,20,10
1713492546980,MCWP 50R,A00,518791,Staff,8,0,20,12
1713492546980,MCWP 50R,B00,518792,Staff,4,0,20,16
1713492546980,MCWP 50R,C00,518793,Staff,7,0,20,13
1713492546980,MCWP 50R,D00,518794,Staff,0,0,20,20
1713492546980,MCWP 50R,E00,518795,Staff,0,0,20,20
1713492546980,MCWP 50R,F00,518796,Staff,11,0,20,9
1713492546980,MCWP 50R,G00,518797,Staff,11,0,20,9
1713492548005,MMW 12R,A01,514034,Herbst; Matthew,5,0,16,11
1713492548005,MMW 12R,A02,514035,Herbst; Matthew,13,0,16,3
1713492549031,MMW 13R,A01,514037,Staff,0,5,16,16
1713492549031,MMW 13R,A02,514039,Staff,0,4,16,16
1713492551081,SIO 295LS,A00,523233,Staff,15,0,30,15
1713492552106,SIO 295S,A00,523232,Staff,15,0,30,15
1713492553137,SOCI 117,A01,494376,Staff,0,2,5,5
1713492554161,WES 237B,A00,494380,Staff,19,0,20,1
1713492556241,AESE 279B,A00,494370,Wade; Jon P,33,0,33,0
1713492557267,AIP 197,001,627712,Vespa; Emanuel Ignacio,9999,0,9999,0
1713492558292,ANAR 135S,A00,494369,Braswell; Geoffrey E.,0,0,0,0
1713492559321,CAT 124RS,A01,519847,Geibel; William,6,0,20,14
1713492560346,CAT 125RS,A01,515971,Geibel; William,6,0,20,14
1713492561373,CLRE 250,A00,511389,Morris; Sheldon,9996,0,9999,3
1713492562401,CLRE 251,A00,507176,Mehta; Ravindra L.,9996,0,9999,3
1713492562401,CLRE 251,B00,511410,Mehta; Ravindra L.,9998,0,9999,1
1713492563433,CLRE 252,A00,507189,Cuomo; Raphael Eduardo,9998,0,9999,1
1713492564462,CLRE 253,A00,507199,Vaida; Florin,9997,0,9999,2
1713492564462,CLRE 253,B00,507202,Vaida; Florin,9999,0,9999,0
1713492565543,CLRE 259,A00,507211,Patel; Hemal,9996,0,9999,3
1713492566570,CLRE 260,A00,507221,Cuomo; Raphael Eduardo,9999,0,9999,0
1713492567594,CLRE 297,001,507242,Cuomo; Raphael Eduardo,9999,0,9999,0
1713492568621,CSE 191,A00,516875,Minnes Kemp; Mor Mia,9999,0,9999,0
1713492569651,CSS 201S,A01,494383,Staff,35,0,35,0
1713492570677,CSS 202S,A01,494387,Staff,35,0,35,0
1713492571700,EAP 100,A00,516065,Staff,9792,0,9999,207
1713492572727,ECE 45,A01,507414,Staff,38,0,60,22
1713492573753,ECE 100,A01,507416,Baghdadchi; Saharnaz,0,0,20,20
1713492573753,ECE 100,A02,507418,Baghdadchi; Saharnaz,19,0,20,1
1713492574782,ECE 111,A01,507420,Staff,27,0,50,23
1713492575807,ECE 197,001,548057,Sievenpiper; Daniel F.,9998,0,9999,1
1713492576832,EDS 115,A00,507243,Choi; Bailey Miyeon,27,0,28,1
1713492577861,EDS 117,A01,494379,Staff,15,0,25,10
1713492578887,EDS 125,A00,507246,Hopkins; Megan Beth,27,0,30,3
1713492579915,EDS 128A,A01,507264,Fargason; Sharon Gayle,26,0,26,0
1713492580940,EDS 128B,A01,507293,Pappas; Elizabeth,30,0,30,0
1713492581966,EDS 139,A00,507294,Fargason; Sharon Gayle,30,0,30,0
1713492581966,EDS 139,B00,507313,Pappas; Elizabeth,30,0,30,0
1713492582990,EDS 201,A00,507315,Staff,18,0,30,12
1713492584016,EDS 203,A01,507317,Halter; Christopher P.,17,0,30,13
1713492585041,EDS 204R,A01,507319,Halter; Christopher P.,0,1,30,30
1713492585041,EDS 204R,B01,507331,Heinzman; Erica M.,22,0,30,8
1713492586069,EDS 206R,A00,507332,Staff,0,2,30,30
1713492586069,EDS 206R,B00,507343,Staff,23,0,30,7
1713492587094,EDS 250,A00,507344,Hemans; Patricia Ann Benitez,27,0,40,13
1713492588122,EDS 281,A00,507345,Daly; Alan J.,18,0,18,0
1713492589146,EDS 284,A00,507350,Daly; Alan J.,16,0,16,0
1713492590176,EDS 286,A00,507359,Fine; Sarah,18,0,18,0
1713492591201,EDS 289C,A01,507361,Daly; Alan J.,18,0,18,0
1713492592225,EDS 290,A00,507366,Hofstetter; Carolyn,15,0,15,0
1713492593251,LIGM 5A,A00,507421,Fischer-Grunski; Eva K,20,0,20,0
1713492594281,LIGM 5B,A00,507423,Fischer-Grunski; Eva K,20,0,20,0
1713492595306,LIGM 5C,A00,507425,Fischer-Grunski; Eva K,20,0,20,0
1713492596331,LIIT 5AS,A00,507427,Carnelos; Chiara,20,0,20,0
1713492597356,LIIT 5BS,A00,507430,Carnelos; Chiara,20,0,20,0
1713492598380,LIIT 5CS,A00,507432,Carnelos; Chiara,20,0,20,0
1713492599409,LISP 5A,A00,507541,Munoz Sanchez; Alicia,14,0,20,6
1713492600439,LISP 5B,A00,507671,Munoz Sanchez; Alicia,12,0,20,8
1713492601463,LISP 5C,A00,507696,Munoz Sanchez; Alicia,11,0,20,9
1713492602489,MAE 197,001,528363,Boechler; Nicholas Sebastia,9998,0,9999,1
1713492603520,MATH 197,001,523477,Kedlaya; Kiran S.,9999,0,9999,0
1713492603520,MATH 197,002,563811,Zhang; Danna,9998,0,9999,1
1713492604546,MCWP 40R,A00,518780,Staff,15,0,20,5
1713492604546,MCWP 40R,B00,518781,Staff,14,0,20,6
1713492604546,MCWP 40R,C00,518783,Staff,10,0,20,10
1713492605570,MCWP 50R,A00,518791,Staff,8,0,20,12
1713492605570,MCWP 50R,B00,518792,Staff,4,0,20,16
1713492605570,MCWP 50R,C00,518793,Staff,7,0,20,13
1713492605570,MCWP 50R,D00,518794,Staff,0,0,20,20
1713492605570,MCWP 50R,E00,518795,Staff,0,0,20,20
1713492605570,MCWP 50R,F00,518796,Staff,11,0,20,9
1713492605570,MCWP 50R,G00,518797,Staff,11,0,20,9
1713492606601,MMW 12R,A01,514034,Herbst; Matthew,5,0,16,11
1713492606601,MMW 12R,A02,514035,Herbst; Matthew,13,0,16,3
1713492607626,MMW 13R,A01,514037,Staff,0,5,16,16
1713492607626,MMW 13R,A02,514039,Staff,0,4,16,16
1713492609675,SIO 295LS,A00,523233,Staff,15,0,30,15
1713492610700,SIO 295S,A00,523232,Staff,15,0,30,15
1713492611725,SOCI 117,A01,494376,Staff,0,2,5,5
1713492612752,WES 237B,A00,494380,Staff,19,0,20,1
1713492614817,AESE 279B,A00,494370,Wade; Jon P,33,0,33,0
1713492615845,AIP 197,001,627712,Vespa; Emanuel Ignacio,9999,0,9999,0
1713492616873,ANAR 135S,A00,494369,Braswell; Geoffrey E.,0,0,0,0
1713492617899,CAT 124RS,A01,519847,Geibel; William,6,0,20,14
1713492618928,CAT 125RS,A01,515971,Geibel; William,6,0,20,14
1713492619964,CLRE 250,A00,511389,Morris; Sheldon,9996,0,9999,3
1713492620995,CLRE 251,A00,507176,Mehta; Ravindra L.,9996,0,9999,3
1713492620995,CLRE 251,B00,511410,Mehta; Ravindra L.,9998,0,9999,1
1713492622021,CLRE 252,A00,507189,Cuomo; Raphael Eduardo,9998,0,9999,1
1713492623053,CLRE 253,A00,507199,Vaida; Florin,9997,0,9999,2
1713492623053,CLRE 253,B00,507202,Vaida; Florin,9999,0,9999,0
1713492624078,CLRE 259,A00,507211,Patel; Hemal,9996,0,9999,3
1713492625110,CLRE 260,A00,507221,Cuomo; Raphael Eduardo,9999,0,9999,0
1713492626133,CLRE 297,001,507242,Cuomo; Raphael Eduardo,9999,0,9999,0
1713492627163,CSE 191,A00,516875,Minnes Kemp; Mor Mia,9999,0,9999,0
1713492628195,CSS 201S,A01,494383,Staff,35,0,35,0
1713492629223,CSS 202S,A01,494387,Staff,35,0,35,0
1713492630247,EAP 100,A00,516065,Staff,9792,0,9999,207
1713492631276,ECE 45,A01,507414,Staff,38,0,60,22
1713492632304,ECE 100,A01,507416,Baghdadchi; Saharnaz,0,0,20,20
1713492632304,ECE 100,A02,507418,Baghdadchi; Saharnaz,19,0,20,1
1713492633330,ECE 111,A01,507420,Staff,27,0,50,23
1713492634354,ECE 197,001,548057,Sievenpiper; Daniel F.,9998,0,9999,1
1713492635379,EDS 115,A00,507243,Choi; Bailey Miyeon,27,0,28,1
1713492636404,EDS 117,A01,494379,Staff,15,0,25,10
1713492637428,EDS 125,A00,507246,Hopkins; Megan Beth,27,0,30,3
1713492638454,EDS 128A,A01,507264,Fargason; Sharon Gayle,26,0,26,0
1713492639480,EDS 128B,A01,507293,Pappas; Elizabeth,30,0,30,0
1713492640505,EDS 139,A00,507294,Fargason; Sharon Gayle,30,0,30,0
1713492640505,EDS 139,B00,507313,Pappas; Elizabeth,30,0,30,0
1713492641530,EDS 201,A00,507315,Staff,18,0,30,12
1713492642556,EDS 203,A01,507317,Halter; Christopher P.,17,0,30,13
1713492643583,EDS 204R,A01,507319,Halter; Christopher P.,0,1,30,30
1713492643583,EDS 204R,B01,507331,Heinzman; Erica M.,22,0,30,8
1713492644608,EDS 206R,A00,507332,Staff,0,2,30,30
1713492644608,EDS 206R,B00,507343,Staff,23,0,30,7
1713492645636,EDS 250,A00,507344,Hemans; Patricia Ann Benitez,27,0,40,13
1713492646660,EDS 281,A00,507345,Daly; Alan J.,18,0,18,0
1713492647691,EDS 284,A00,507350,Daly; Alan J.,16,0,16,0
1713492648717,EDS 286,A00,507359,Fine; Sarah,18,0,18,0
1713492649742,EDS 289C,A01,507361,Daly; Alan J.,18,0,18,0
1713492650768,EDS 290,A00,507366,Hofstetter; Carolyn,15,0,15,0
1713492651801,LIGM 5A,A00,507421,Fischer-Grunski; Eva K,20,0,20,0
1713492652826,LIGM 5B,A00,507423,Fischer-Grunski; Eva K,20,0,20,0
1713492653862,LIGM 5C,A00,507425,Fischer-Grunski; Eva K,20,0,20,0
1713492654889,LIIT 5AS,A00,507427,Carnelos; Chiara,20,0,20,0
1713492655917,LIIT 5BS,A00,507430,Carnelos; Chiara,20,0,20,0
1713492656946,LIIT 5CS,A00,507432,Carnelos; Chiara,20,0,20,0
1713492657976,LISP 5A,A00,507541,Munoz Sanchez; Alicia,14,0,20,6
1713492659006,LISP 5B,A00,507671,Munoz Sanchez; Alicia,12,0,20,8
1713492660047,LISP 5C,A00,507696,Munoz Sanchez; Alicia,11,0,20,9
1713492661072,MAE 197,001,528363,Boechler; Nicholas Sebastia,9998,0,9999,1
1713492662099,MATH 197,001,523477,Kedlaya; Kiran S.,9999,0,9999,0
1713492662099,MATH 197,002,563811,Zhang; Danna,9998,0,9999,1
1713492663128,MCWP 40R,A00,518780,Staff,15,0,20,5
1713492663128,MCWP 40R,B00,518781,Staff,14,0,20,6
1713492663128,MCWP 40R,C00,518783,Staff,10,0,20,10
1713492664159,MCWP 50R,A00,518791,Staff,8,0,20,12
1713492664159,MCWP 50R,B00,518792,Staff,4,0,20,16
1713492664159,MCWP 50R,C00,518793,Staff,7,0,20,13
1713492664159,MCWP 50R,D00,518794,Staff,0,0,20,20
1713492664159,MCWP 50R,E00,518795,Staff,0,0,20,20
1713492664159,MCWP 50R,F00,518796,Staff,11,0,20,9
1713492664159,MCWP 50R,G00,518797,Staff,11,0,20,9
1713492665188,MMW 12R,A01,514034,Herbst; Matthew,5,0,16,11
1713492665188,MMW 12R,A02,514035,Herbst; Matthew,13,0,16,3
1713492666213,MMW 13R,A01,514037,Staff,0,5,16,16
1713492666213,MMW 13R,A02,514039,Staff,0,4,16,16
1713492668266,SIO 295LS,A00,523233,Staff,15,0,30,15
1713492669349,SIO 295S,A00,523232,Staff,15,0,30,15
1713492670375,SOCI 117,A01,494376,Staff,0,2,5,5
1713492671399,WES 237B,A00,494380,Staff,19,0,20,1
1713492673469,AESE 279B,A00,494370,Wade; Jon P,33,0,33,0
1713492674495,AIP 197,001,627712,Vespa; Emanuel Ignacio,9999,0,9999,0
1713492675523,ANAR 135S,A00,494369,Braswell; Geoffrey E.,0,0,0,0
1713492676551,CAT 124RS,A01,519847,Geibel; William,6,0,20,14
1713492677578,CAT 125RS,A01,515971,Geibel; William,6,0,20,14
1713492678609,CLRE 250,A00,511389,Morris; Sheldon,9996,0,9999,3
1713492679636,CLRE 251,A00,507176,Mehta; Ravindra L.,9996,0,9999,3
1713492679636,CLRE 251,B00,511410,Mehta; Ravindra L.,9998,0,9999,1
1713492680662,CLRE 252,A00,507189,Cuomo; Raphael Eduardo,9998,0,9999,1
1713492681686,CLRE 253,A00,507199,Vaida; Florin,9997,0,9999,2
1713492681686,CLRE 253,B00,507202,Vaida; Florin,9999,0,9999,0
1713492682711,CLRE 259,A00,507211,Patel; Hemal,9996,0,9999,3
1713492683735,CLRE 260,A00,507221,Cuomo; Raphael Eduardo,9999,0,9999,0
1713492684763,CLRE 297,001,507242,Cuomo; Raphael Eduardo,9999,0,9999,0
1713492685787,CSE 191,A00,516875,Minnes Kemp; Mor Mia,9999,0,9999,0
1713492686819,CSS 201S,A01,494383,Staff,35,0,35,0
1713492687845,CSS 202S,A01,494387,Staff,35,0,35,0
1713492688869,EAP 100,A00,516065,Staff,9792,0,9999,207
1713492689895,ECE 45,A01,507414,Staff,38,0,60,22
1713492690920,ECE 100,A01,507416,Baghdadchi; Saharnaz,0,0,20,20
1713492690920,ECE 100,A02,507418,Baghdadchi; Saharnaz,19,0,20,1
1713492691950,ECE 111,A01,507420,Staff,27,0,50,23
1713492692975,ECE 197,001,548057,Sievenpiper; Daniel F.,9998,0,9999,1
1713492694007,EDS 115,A00,507243,Choi; Bailey Miyeon,27,0,28,1
1713492695033,EDS 117,A01,494379,Staff,15,0,25,10
1713492696058,EDS 125,A00,507246,Hopkins; Megan Beth,27,0,30,3
1713492697082,EDS 128A,A01,507264,Fargason; Sharon Gayle,26,0,26,0
1713492698111,EDS 128B,A01,507293,Pappas; Elizabeth,30,0,30,0
1713492699136,EDS 139,A00,507294,Fargason; Sharon Gayle,30,0,30,0
1713492699136,EDS 139,B00,507313,Pappas; Elizabeth,30,0,30,0
1713492700164,EDS 201,A00,507315,Staff,18,0,30,12
1713492701193,EDS 203,A01,507317,Halter; Christopher P.,17,0,30,13
1713492702219,EDS 204R,A01,507319,Halter; Christopher P.,0,1,30,30
1713492702219,EDS 204R,B01,507331,Heinzman; Erica M.,22,0,30,8
1713492703247,EDS 206R,A00,507332,Staff,0,2,30,30
1713492703247,EDS 206R,B00,507343,Staff,23,0,30,7
1713492704276,EDS 250,A00,507344,Hemans; Patricia Ann Benitez,27,0,40,13
1713492705305,EDS 281,A00,507345,Daly; Alan J.,18,0,18,0
1713492706331,EDS 284,A00,507350,Daly; Alan J.,16,0,16,0
1713492707357,EDS 286,A00,507359,Fine; Sarah,18,0,18,0
1713492708385,EDS 289C,A01,507361,Daly; Alan J.,18,0,18,0
1713492709410,EDS 290,A00,507366,Hofstetter; Carolyn,15,0,15,0
1713492710437,LIGM 5A,A00,507421,Fischer-Grunski; Eva K,20,0,20,0
1713492711463,LIGM 5B,A00,507423,Fischer-Grunski; Eva K,20,0,20,0
1713492712487,LIGM 5C,A00,507425,Fischer-Grunski; Eva K,20,0,20,0
1713492713510,LIIT 5AS,A00,507427,Carnelos; Chiara,20,0,20,0
1713492714540,LIIT 5BS,A00,507430,Carnelos; Chiara,20,0,20,0
1713492715565,LIIT 5CS,A00,507432,Carnelos; Chiara,20,0,20,0
1713492716591,LISP 5A,A00,507541,Munoz Sanchez; Alicia,14,0,20,6
1713492717620,LISP 5B,A00,507671,Munoz Sanchez; Alicia,12,0,20,8
1713492718645,LISP 5C,A00,507696,Munoz Sanchez; Alicia,11,0,20,9
1713492719674,MAE 197,001,528363,Boechler; Nicholas Sebastia,9998,0,9999,1
1713492720700,MATH 197,001,523477,Kedlaya; Kiran S.,9999,0,9999,0
1713492720700,MATH 197,002,563811,Zhang; Danna,9998,0,9999,1
1713492721729,MCWP 40R,A00,518780,Staff,15,0,20,5
1713492721729,MCWP 40R,B00,518781,Staff,14,0,20,6
1713492721729,MCWP 40R,C00,518783,Staff,9,0,20,11
1713492722758,MCWP 50R,A00,518791,Staff,8,0,20,12
1713492722758,MCWP 50R,B00,518792,Staff,4,0,20,16
1713492722758,MCWP 50R,C00,518793,Staff,7,0,20,13
1713492722758,MCWP 50R,D00,518794,Staff,0,0,20,20
1713492722758,MCWP 50R,E00,518795,Staff,0,0,20,20
1713492722758,MCWP 50R,F00,518796,Staff,11,0,20,9
1713492722758,MCWP 50R,G00,518797,Staff,11,0,20,9
1713492723785,MMW 12R,A01,514034,Herbst; Matthew,5,0,16,11
1713492723785,MMW 12R,A02,514035,Herbst; Matthew,13,0,16,3
1713492724812,MMW 13R,A01,514037,Staff,0,5,16,16
1713492724812,MMW 13R,A02,514039,Staff,0,4,16,16
1713492726868,SIO 295LS,A00,523233,Staff,15,0,30,15
1713492727893,SIO 295S,A00,523232,Staff,15,0,30,15
1713492728918,SOCI 117,A01,494376,Staff,0,2,5,5
1713492729945,WES 237B,A00,494380,Staff,19,0,20,1
1713492732011,AESE 279B,A00,494370,Wade; Jon P,33,0,33,0
1713492733038,AIP 197,001,627712,Vespa; Emanuel Ignacio,9999,0,9999,0
1713492734065,ANAR 135S,A00,494369,Braswell; Geoffrey E.,0,0,0,0
1713492735092,CAT 124RS,A01,519847,Geibel; William,6,0,20,14
1713492736117,CAT 125RS,A01,515971,Geibel; William,6,0,20,14
1713492737143,CLRE 250,A00,511389,Morris; Sheldon,9996,0,9999,3
1713492738171,CLRE 251,A00,507176,Mehta; Ravindra L.,9996,0,9999,3
1713492738171,CLRE 251,B00,511410,Mehta; Ravindra L.,9998,0,9999,1
1713492739197,CLRE 252,A00,507189,Cuomo; Raphael Eduardo,9998,0,9999,1
1713492740222,CLRE 253,A00,507199,Vaida; Florin,9997,0,9999,2
1713492740222,CLRE 253,B00,507202,Vaida; Florin,9999,0,9999,0
1713492741252,CLRE 259,A00,507211,Patel; Hemal,9996,0,9999,3
1713492742278,CLRE 260,A00,507221,Cuomo; Raphael Eduardo,9999,0,9999,0
1713492743307,CLRE 297,001,507242,Cuomo; Raphael Eduardo,9999,0,9999,0
1713492744331,CSE 191,A00,516875,Minnes Kemp; Mor Mia,9999,0,9999,0
1713492745373,CSS 201S,A01,494383,Staff,35,0,35,0
1713492746403,CSS 202S,A01,494387,Staff,35,0,35,0
1713492747428,EAP 100,A00,516065,Staff,9792,0,9999,207
1713492748458,ECE 45,A01,507414,Staff,38,0,60,22
1713492749483,ECE 100,A01,507416,Baghdadchi; Saharnaz,0,0,20,20
1713492749483,ECE 100,A02,507418,Baghdadchi; Saharnaz,19,0,20,1
1713492750508,ECE 111,A01,507420,Staff,27,0,50,23
1713492751533,ECE 197,001,548057,Sievenpiper; Daniel F.,9998,0,9999,1
1713492752563,EDS 115,A00,507243,Choi; Bailey Miyeon,27,0,28,1
1713492753592,EDS 117,A01,494379,Staff,15,0,25,10
1713492754621,EDS 125,A00,507246,Hopkins; Megan Beth,27,0,30,3
1713492755652,EDS 128A,A01,507264,Fargason; Sharon Gayle,26,0,26,0
1713492756677,EDS 128B,A01,507293,Pappas; Elizabeth,30,0,30,0
1713492757705,EDS 139,A00,507294,Fargason; Sharon Gayle,30,0,30,0
1713492757705,EDS 139,B00,507313,Pappas; Elizabeth,30,0,30,0
1713492758732,EDS 201,A00,507315,Staff,18,0,30,12
1713492759758,EDS 203,A01,507317,Halter; Christopher P.,17,0,30,13
1713492760784,EDS 204R,A01,507319,Halter; Christopher P.,0,1,30,30
1713492760784,EDS 204R,B01,507331,Heinzman; Erica M.,22,0,30,8
1713492761809,EDS 206R,A00,507332,Staff,0,2,30,30
1713492761809,EDS 206R,B00,507343,Staff,23,0,30,7
1713492762835,EDS 250,A00,507344,Hemans; Patricia Ann Benitez,27,0,40,13
1713492763868,EDS 281,A00,507345,Daly; Alan J.,18,0,18,0
1713492764895,EDS 284,A00,507350,Daly; Alan J.,16,0,16,0
1713492765923,EDS 286,A00,507359,Fine; Sarah,18,0,18,0
1713492766948,EDS 289C,A01,507361,Daly; Alan J.,18,0,18,0
1713492767974,EDS 290,A00,507366,Hofstetter; Carolyn,15,0,15,0
1713492769004,LIGM 5A,A00,507421,Fischer-Grunski; Eva K,20,0,20,0
1713492770030,LIGM 5B,A00,507423,Fischer-Grunski; Eva K,20,0,20,0
1713492771056,LIGM 5C,A00,507425,Fischer-Grunski; Eva K,20,0,20,0
1713492772086,LIIT 5AS,A00,507427,Carnelos; Chiara,20,0,20,0
1713492773169,LIIT 5BS,A00,507430,Carnelos; Chiara,20,0,20,0
1713492774198,LIIT 5CS,A00,507432,Carnelos; Chiara,20,0,20,0
1713492775228,LISP 5A,A00,507541,Munoz Sanchez; Alicia,14,0,20,6
1713492776254,LISP 5B,A00,507671,Munoz Sanchez; Alicia,12,0,20,8
1713492777279,LISP 5C,A00,507696,Munoz Sanchez; Alicia,11,0,20,9
1713492778306,MAE 197,001,528363,Boechler; Nicholas Sebastia,9998,0,9999,1
1713492779335,MATH 197,001,523477,Kedlaya; Kiran S.,9999,0,9999,0
1713492779335,MATH 197,002,563811,Zhang; Danna,9998,0,9999,1
1713492780361,MCWP 40R,A00,518780,Staff,15,0,20,5
1713492780361,MCWP 40R,B00,518781,Staff,14,0,20,6
1713492780361,MCWP 40R,C00,518783,Staff,9,0,20,11
1713492781390,MCWP 50R,A00,518791,Staff,8,0,20,12
1713492781390,MCWP 50R,B00,518792,Staff,4,0,20,16
1713492781390,MCWP 50R,C00,518793,Staff,7,0,20,13
1713492781390,MCWP 50R,D00,518794,Staff,0,0,20,20
1713492781390,MCWP 50R,E00,518795,Staff,0,0,20,20
1713492781390,MCWP 50R,F00,518796,Staff,11,0,20,9
1713492781390,MCWP 50R,G00,518797,Staff,11,0,20,9
1713492782415,MMW 12R,A01,514034,Herbst; Matthew,5,0,16,11
1713492782415,MMW 12R,A02,514035,Herbst; Matthew,13,0,16,3
1713492783443,MMW 13R,A01,514037,Staff,0,5,16,16
1713492783443,MMW 13R,A02,514039,Staff,0,4,16,16
1713492785496,SIO 295LS,A00,523233,Staff,15,0,30,15
1713492786523,SIO 295S,A00,523232,Staff,15,0,30,15
1713492787547,SOCI 117,A01,494376,Staff,0,2,5,5
1713492788575,WES 237B,A00,494380,Staff,19,0,20,1
1713492790640,AESE 279B,A00,494370,Wade; Jon P,33,0,33,0
1713492791665,AIP 197,001,627712,Vespa; Emanuel Ignacio,9999,0,9999,0
1713492792694,ANAR 135S,A00,494369,Braswell; Geoffrey E.,0,0,0,0
1713492793720,CAT 124RS,A01,519847,Geibel; William,6,0,20,14
1713492794748,CAT 125RS,A01,515971,Geibel; William,6,0,20,14
1713492795773,CLRE 250,A00,511389,Morris; Sheldon,9996,0,9999,3
1713492796812,CLRE 251,A00,507176,Mehta; Ravindra L.,9996,0,9999,3
1713492796812,CLRE 251,B00,511410,Mehta; Ravindra L.,9998,0,9999,1
1713492797837,CLRE 252,A00,507189,Cuomo; Raphael Eduardo,9998,0,9999,1
1713492798862,CLRE 253,A00,507199,Vaida; Florin,9997,0,9999,2
1713492798862,CLRE 253,B00,507202,Vaida; Florin,9999,0,9999,0
1713492799889,CLRE 259,A00,507211,Patel; Hemal,9996,0,9999,3
1713492800916,CLRE 260,A00,507221,Cuomo; Raphael Eduardo,9999,0,9999,0
1713492801945,CLRE 297,001,507242,Cuomo; Raphael Eduardo,9999,0,9999,0
1713492802970,CSE 191,A00,516875,Minnes Kemp; Mor Mia,9999,0,9999,0
1713492803996,CSS 201S,A01,494383,Staff,35,0,35,0
1713492805020,CSS 202S,A01,494387,Staff,35,0,35,0
1713492806047,EAP 100,A00,516065,Staff,9792,0,9999,207
1713492807076,ECE 45,A01,507414,Staff,38,0,60,22
1713492808104,ECE 100,A01,507416,Baghdadchi; Saharnaz,0,0,20,20
1713492808104,ECE 100,A02,507418,Baghdadchi; Saharnaz,19,0,20,1
1713492809133,ECE 111,A01,507420,Staff,27,0,50,23
1713492810163,ECE 197,001,548057,Sievenpiper; Daniel F.,9998,0,9999,1
1713492811190,EDS 115,A00,507243,Choi; Bailey Miyeon,27,0,28,1
1713492812219,EDS 117,A01,494379,Staff,15,0,25,10
1713492813248,EDS 125,A00,507246,Hopkins; Megan Beth,27,0,30,3
1713492814278,EDS 128A,A01,507264,Fargason; Sharon Gayle,26,0,26,0
1713492815304,EDS 128B,A01,507293,Pappas; Elizabeth,30,0,30,0
1713492816330,EDS 139,A00,507294,Fargason; Sharon Gayle,30,0,30,0
1713492816330,EDS 139,B00,507313,Pappas; Elizabeth,30,0,30,0
1713492817355,EDS 201,A00,507315,Staff,18,0,30,12
1713492818385,EDS 203,A01,507317,Halter; Christopher P.,17,0,30,13
1713492819416,EDS 204R,A01,507319,Halter; Christopher P.,0,1,30,30
1713492819416,EDS 204R,B01,507331,Heinzman; Erica M.,22,0,30,8
1713492820444,EDS 206R,A00,507332,Staff,0,2,30,30
1713492820444,EDS 206R,B00,507343,Staff,23,0,30,7
1713492821474,EDS 250,A00,507344,Hemans; Patricia Ann Benitez,27,0,40,13
1713492822501,EDS 281,A00,507345,Daly; Alan J.,18,0,18,0
1713492823527,EDS 284,A00,507350,Daly; Alan J.,16,0,16,0
1713492824557,EDS 286,A00,507359,Fine; Sarah,18,0,18,0
1713492825582,EDS 289C,A01,507361,Daly; Alan J.,18,0,18,0
1713492826609,EDS 290,A00,507366,Hofstetter; Carolyn,15,0,15,0
1713492827641,LIGM 5A,A00,507421,Fischer-Grunski; Eva K,20,0,20,0
1713492828670,LIGM 5B,A00,507423,Fischer-Grunski; Eva K,20,0,20,0
1713492829695,LIGM 5C,A00,507425,Fischer-Grunski; Eva K,20,0,20,0
1713492830725,LIIT 5AS,A00,507427,Carnelos; Chiara,20,0,20,0
1713492831755,LIIT 5BS,A00,507430,Carnelos; Chiara,20,0,20,0
1713492832780,LIIT 5CS,A00,507432,Carnelos; Chiara,20,0,20,0
1713492833806,LISP 5A,A00,507541,Munoz Sanchez; Alicia,14,0,20,6
1713492834832,LISP 5B,A00,507671,Munoz Sanchez; Alicia,12,0,20,8
1713492835862,LISP 5C,A00,507696,Munoz Sanchez; Alicia,11,0,20,9
1713492836888,MAE 197,001,528363,Boechler; Nicholas Sebastia,9998,0,9999,1
1713492837913,MATH 197,001,523477,Kedlaya; Kiran S.,9999,0,9999,0
1713492837913,MATH 197,002,563811,Zhang; Danna,9998,0,9999,1
1713492838943,MCWP 40R,A00,518780,Staff,15,0,20,5
1713492838943,MCWP 40R,B00,518781,Staff,14,0,20,6
1713492838943,MCWP 40R,C00,518783,Staff,9,0,20,11
1713492839970,MCWP 50R,A00,518791,Staff,8,0,20,12
1713492839970,MCWP 50R,B00,518792,Staff,3,0,20,17
1713492839970,MCWP 50R,C00,518793,Staff,7,0,20,13
1713492839970,MCWP 50R,D00,518794,Staff,0,0,20,20
1713492839970,MCWP 50R,E00,518795,Staff,0,0,20,20
1713492839970,MCWP 50R,F00,518796,Staff,11,0,20,9
1713492839970,MCWP 50R,G00,518797,Staff,11,0,20,9
1713492841000,MMW 12R,A01,514034,Herbst; Matthew,5,0,16,11
1713492841000,MMW 12R,A02,514035,Herbst; Matthew,13,0,16,3
1713492842028,MMW 13R,A01,514037,Staff,0,5,16,16
1713492842028,MMW 13R,A02,514039,Staff,0,4,16,16
1713492844084,SIO 295LS,A00,523233,Staff,15,0,30,15
1713492845111,SIO 295S,A00,523232,Staff,15,0,30,15
1713492846138,SOCI 117,A01,494376,Staff,0,2,5,5
1713492847164,WES 237B,A00,494380,Staff,19,0,20,1
1713492849248,AESE 279B,A00,494370,Wade; Jon P,33,0,33,0
1713492850275,AIP 197,001,627712,Vespa; Emanuel Ignacio,9999,0,9999,0
1713492851299,ANAR 135S,A00,494369,Braswell; Geoffrey E.,0,0,0,0
1713492852325,CAT 124RS,A01,519847,Geibel; William,6,0,20,14
1713492853354,CAT 125RS,A01,515971,Geibel; William,6,0,20,14
1713492854383,CLRE 250,A00,511389,Morris; Sheldon,9996,0,9999,3
1713492855412,CLRE 251,A00,507176,Mehta; Ravindra L.,9996,0,9999,3
1713492855412,CLRE 251,B00,511410,Mehta; Ravindra L.,9998,0,9999,1
1713492856442,CLRE 252,A00,507189,Cuomo; Raphael Eduardo,9998,0,9999,1
1713492857472,CLRE 253,A00,507199,Vaida; Florin,9997,0,9999,2
1713492857472,CLRE 253,B00,507202,Vaida; Florin,9999,0,9999,0
1713492858497,CLRE 259,A00,507211,Patel; Hemal,9996,0,9999,3
1713492859523,CLRE 260,A00,507221,Cuomo; Raphael Eduardo,9999,0,9999,0
1713492860549,CLRE 297,001,507242,Cuomo; Raphael Eduardo,9999,0,9999,0
1713492861577,CSE 191,A00,516875,Minnes Kemp; Mor Mia,9999,0,9999,0
1713492862604,CSS 201S,A01,494383,Staff,35,0,35,0
1713492863633,CSS 202S,A01,494387,Staff,35,0,35,0
1713492864660,EAP 100,A00,516065,Staff,9792,0,9999,207
1713492865690,ECE 45,A01,507414,Staff,38,0,60,22
1713492866720,ECE 100,A01,507416,Baghdadchi; Saharnaz,0,0,20,20
1713492866720,ECE 100,A02,507418,Baghdadchi; Saharnaz,19,0,20,1
1713492867748,ECE 111,A01,507420,Staff,27,0,50,23
1713492868776,ECE 197,001,548057,Sievenpiper; Daniel F.,9998,0,9999,1
1713492869803,EDS 115,A00,507243,Choi; Bailey Miyeon,27,0,28,1
1713492870830,EDS 117,A01,494379,Staff,15,0,25,10
1713492871856,EDS 125,A00,507246,Hopkins; Megan Beth,27,0,30,3
1713492872881,EDS 128A,A01,507264,Fargason; Sharon Gayle,26,0,26,0
1713492873908,EDS 128B,A01,507293,Pappas; Elizabeth,30,0,30,0
1713492874935,EDS 139,A00,507294,Fargason; Sharon Gayle,30,0,30,0
1713492874935,EDS 139,B00,507313,Pappas; Elizabeth,30,0,30,0
1713492875959,EDS 201,A00,507315,Staff,18,0,30,12
1713492877043,EDS 203,A01,507317,Halter; Christopher P.,17,0,30,13
1713492878068,EDS 204R,A01,507319,Halter; Christopher P.,0,1,30,30
1713492878068,EDS 204R,B01,507331,Heinzman; Erica M.,22,0,30,8
1713492879097,EDS 206R,A00,507332,Staff,0,2,30,30
1713492879097,EDS 206R,B00,507343,Staff,23,0,30,7
1713492880128,EDS 250,A00,507344,Hemans; Patricia Ann Benitez,27,0,40,13
1713492881155,EDS 281,A00,507345,Daly; Alan J.,18,0,18,0
1713492882180,EDS 284,A00,507350,Daly; Alan J.,16,0,16,0
1713492883208,EDS 286,A00,507359,Fine; Sarah,18,0,18,0
1713492884237,EDS 289C,A01,507361,Daly; Alan J.,18,0,18,0
1713492885266,EDS 290,A00,507366,Hofstetter; Carolyn,15,0,15,0
1713492886297,LIGM 5A,A00,507421,Fischer-Grunski; Eva K,20,0,20,0
1713492887322,LIGM 5B,A00,507423,Fischer-Grunski; Eva K,20,0,20,0
1713492888351,LIGM 5C,A00,507425,Fischer-Grunski; Eva K,20,0,20,0
1713492889379,LIIT 5AS,A00,507427,Carnelos; Chiara,20,0,20,0
1713492890405,LIIT 5BS,A00,507430,Carnelos; Chiara,20,0,20,0
1713492891430,LIIT 5CS,A00,507432,Carnelos; Chiara,20,0,20,0
1713492892462,LISP 5A,A00,507541,Munoz Sanchez; Alicia,14,0,20,6
1713492893488,LISP 5B,A00,507671,Munoz Sanchez; Alicia,12,0,20,8
1713492894514,LISP 5C,A00,507696,Munoz Sanchez; Alicia,11,0,20,9
1713492895544,MAE 197,001,528363,Boechler; Nicholas Sebastia,9998,0,9999,1
1713492896574,MATH 197,001,523477,Kedlaya; Kiran S.,9999,0,9999,0
1713492896574,MATH 197,002,563811,Zhang; Danna,9998,0,9999,1
1713492897601,MCWP 40R,A00,518780,Staff,15,0,20,5
1713492897601,MCWP 40R,B00,518781,Staff,14,0,20,6
1713492897601,MCWP 40R,C00,518783,Staff,9,0,20,11
1713492898627,MCWP 50R,A00,518791,Staff,8,0,20,12
1713492898627,MCWP 50R,B00,518792,Staff,3,0,20,17
1713492898627,MCWP 50R,C00,518793,Staff,7,0,20,13
1713492898627,MCWP 50R,D00,518794,Staff,0,0,20,20
1713492898627,MCWP 50R,E00,518795,Staff,0,0,20,20
1713492898627,MCWP 50R,F00,518796,Staff,11,0,20,9
1713492898627,MCWP 50R,G00,518797,Staff,11,0,20,9
1713492899652,MMW 12R,A01,514034,Herbst; Matthew,5,0,16,11
1713492899652,MMW 12R,A02,514035,Herbst; Matthew,13,0,16,3
1713492900679,MMW 13R,A01,514037,Staff,0,5,16,16
1713492900679,MMW 13R,A02,514039,Staff,0,4,16,16
1713492902736,SIO 295LS,A00,523233,Staff,15,0,30,15
1713492903762,SIO 295S,A00,523232,Staff,15,0,30,15
1713492904788,SOCI 117,A01,494376,Staff,0,2,5,5
1713492905812,WES 237B,A00,494380,Staff,19,0,20,1
1713492907898,AESE 279B,A00,494370,Wade; Jon P,33,0,33,0
1713492908925,AIP 197,001,627712,Vespa; Emanuel Ignacio,9999,0,9999,0
1713492909954,ANAR 135S,A00,494369,Braswell; Geoffrey E.,0,0,0,0
1713492910984,CAT 124RS,A01,519847,Geibel; William,6,0,20,14
1713492912008,CAT 125RS,A01,515971,Geibel; William,6,0,20,14
1713492913033,CLRE 250,A00,511389,Morris; Sheldon,9996,0,9999,3
1713492914060,CLRE 251,A00,507176,Mehta; Ravindra L.,9996,0,9999,3
1713492914060,CLRE 251,B00,511410,Mehta; Ravindra L.,9998,0,9999,1
1713492915091,CLRE 252,A00,507189,Cuomo; Raphael Eduardo,9998,0,9999,1
1713492916121,CLRE 253,A00,507199,Vaida; Florin,9997,0,9999,2
1713492916121,CLRE 253,B00,507202,Vaida; Florin,9999,0,9999,0
1713492917147,CLRE 259,A00,507211,Patel; Hemal,9996,0,9999,3
1713492918175,CLRE 260,A00,507221,Cuomo; Raphael Eduardo,9999,0,9999,0
1713492919201,CLRE 297,001,507242,Cuomo; Raphael Eduardo,9999,0,9999,0
1713492920225,CSE 191,A00,516875,Minnes Kemp; Mor Mia,9999,0,9999,0
1713492921252,CSS 201S,A01,494383,Staff,35,0,35,0
1713492922279,CSS 202S,A01,494387,Staff,35,0,35,0
1713492923306,EAP 100,A00,516065,Staff,9792,0,9999,207
1713492924334,ECE 45,A01,507414,Staff,38,0,60,22
1713492925363,ECE 100,A01,507416,Baghdadchi; Saharnaz,0,0,20,20
1713492925363,ECE 100,A02,507418,Baghdadchi; Saharnaz,19,0,20,1
1713492926389,ECE 111,A01,507420,Staff,27,0,50,23
1713492927414,ECE 197,001,548057,Sievenpiper; Daniel F.,9998,0,9999,1
1713492928443,EDS 115,A00,507243,Choi; Bailey Miyeon,27,0,28,1
1713492929473,EDS 117,A01,494379,Staff,15,0,25,10
1713492930500,EDS 125,A00,507246,Hopkins; Megan Beth,27,0,30,3
1713492931526,EDS 128A,A01,507264,Fargason; Sharon Gayle,26,0,26,0
1713492932555,EDS 128B,A01,507293,Pappas; Elizabeth,30,0,30,0
1713492933580,EDS 139,A00,507294,Fargason; Sharon Gayle,30,0,30,0
1713492933580,EDS 139,B00,507313,Pappas; Elizabeth,30,0,30,0
1713492934604,EDS 201,A00,507315,Staff,18,0,30,12
1713492935633,EDS 203,A01,507317,Halter; Christopher P.,17,0,30,13
1713492936662,EDS 204R,A01,507319,Halter; Christopher P.,0,1,30,30
1713492936662,EDS 204R,B01,507331,Heinzman; Erica M.,22,0,30,8
1713492937686,EDS 206R,A00,507332,Staff,0,2,30,30
1713492937686,EDS 206R,B00,507343,Staff,23,0,30,7
1713492938712,EDS 250,A00,507344,Hemans; Patricia Ann Benitez,27,0,40,13
1713492939737,EDS 281,A00,507345,Daly; Alan J.,18,0,18,0
1713492940765,EDS 284,A00,507350,Daly; Alan J.,16,0,16,0
1713492941794,EDS 286,A00,507359,Fine; Sarah,18,0,18,0
1713492942819,EDS 289C,A01,507361,Daly; Alan J.,18,0,18,0
1713492943844,EDS 290,A00,507366,Hofstetter; Carolyn,15,0,15,0
1713492944874,LIGM 5A,A00,507421,Fischer-Grunski; Eva K,20,0,20,0
1713492945902,LIGM 5B,A00,507423,Fischer-Grunski; Eva K,20,0,20,0
1713492946928,LIGM 5C,A00,507425,Fischer-Grunski; Eva K,20,0,20,0
1713492947956,LIIT 5AS,A00,507427,Carnelos; Chiara,20,0,20,0
1713492948985,LIIT 5BS,A00,507430,Carnelos; Chiara,20,0,20,0
1713492950015,LIIT 5CS,A00,507432,Carnelos; Chiara,20,0,20,0
1713492951042,LISP 5A,A00,507541,Munoz Sanchez; Alicia,14,0,20,6
1713492952072,LISP 5B,A00,507671,Munoz Sanchez; Alicia,12,0,20,8
1713492953101,LISP 5C,A00,507696,Munoz Sanchez; Alicia,11,0,20,9
1713492954131,MAE 197,001,528363,Boechler; Nicholas Sebastia,9998,0,9999,1
1713492955163,MATH 197,001,523477,Kedlaya; Kiran S.,9999,0,9999,0
1713492955163,MATH 197,002,563811,Zhang; Danna,9998,0,9999,1
1713492956190,MCWP 40R,A00,518780,Staff,15,0,20,5
1713492956190,MCWP 40R,B00,518781,Staff,14,0,20,6
1713492956190,MCWP 40R,C00,518783,Staff,9,0,20,11
1713492957221,MCWP 50R,A00,518791,Staff,8,0,20,12
1713492957221,MCWP 50R,B00,518792,Staff,3,0,20,17
1713492957221,MCWP 50R,C00,518793,Staff,7,0,20,13
1713492957221,MCWP 50R,D00,518794,Staff,0,0,20,20
1713492957221,MCWP 50R,E00,518795,Staff,0,0,20,20
1713492957221,MCWP 50R,F00,518796,Staff,11,0,20,9
1713492957221,MCWP 50R,G00,518797,Staff,11,0,20,9
1713492958245,MMW 12R,A01,514034,Herbst; Matthew,5,0,16,11
1713492958245,MMW 12R,A02,514035,Herbst; Matthew,13,0,16,3
1713492959270,MMW 13R,A01,514037,Staff,0,5,16,16
1713492959270,MMW 13R,A02,514039,Staff,0,4,16,16
1713492961325,SIO 295LS,A00,523233,Staff,15,0,30,15
1713492962350,SIO 295S,A00,523232,Staff,15,0,30,15
1713492963377,SOCI 117,A01,494376,Staff,0,2,5,5
1713492964405,WES 237B,A00,494380,Staff,19,0,20,1
1713492966489,AESE 279B,A00,494370,Wade; Jon P,33,0,33,0
1713492967517,AIP 197,001,627712,Vespa; Emanuel Ignacio,9999,0,9999,0
1713492968546,ANAR 135S,A00,494369,Braswell; Geoffrey E.,0,0,0,0
1713492969572,CAT 124RS,A01,519847,Geibel; William,6,0,20,14
1713492970596,CAT 125RS,A01,515971,Geibel; William,6,0,20,14
1713492971621,CLRE 250,A00,511389,Morris; Sheldon,9996,0,9999,3
1713492972651,CLRE 251,A00,507176,Mehta; Ravindra L.,9996,0,9999,3
1713492972651,CLRE 251,B00,511410,Mehta; Ravindra L.,9998,0,9999,1
1713492973679,CLRE 252,A00,507189,Cuomo; Raphael Eduardo,9998,0,9999,1
1713492974707,CLRE 253,A00,507199,Vaida; Florin,9997,0,9999,2
1713492974707,CLRE 253,B00,507202,Vaida; Florin,9999,0,9999,0
1713492975734,CLRE 259,A00,507211,Patel; Hemal,9996,0,9999,3
1713492976758,CLRE 260,A00,507221,Cuomo; Raphael Eduardo,9999,0,9999,0
1713492977782,CLRE 297,001,507242,Cuomo; Raphael Eduardo,9999,0,9999,0
1713492978811,CSE 191,A00,516875,Minnes Kemp; Mor Mia,9999,0,9999,0
1713492979837,CSS 201S,A01,494383,Staff,35,0,35,0
1713492980921,CSS 202S,A01,494387,Staff,35,0,35,0
1713492981948,EAP 100,A00,516065,Staff,9792,0,9999,207
1713492982972,ECE 45,A01,507414,Staff,38,0,60,22
1713492983997,ECE 100,A01,507416,Baghdadchi; Saharnaz,0,0,20,20
1713492983997,ECE 100,A02,507418,Baghdadchi; Saharnaz,19,0,20,1
1713492985022,ECE 111,A01,507420,Staff,27,0,50,23
1713492986044,ECE 197,001,548057,Sievenpiper; Daniel F.,9998,0,9999,1
1713492987069,EDS 115,A00,507243,Choi; Bailey Miyeon,27,0,28,1
1713492988094,EDS 117,A01,494379,Staff,15,0,25,10
1713492989119,EDS 125,A00,507246,Hopkins; Megan Beth,27,0,30,3
1713492990148,EDS 128A,A01,507264,Fargason; Sharon Gayle,26,0,26,0
1713492991173,EDS 128B,A01,507293,Pappas; Elizabeth,30,0,30,0
1713492992200,EDS 139,A00,507294,Fargason; Sharon Gayle,30,0,30,0
1713492992200,EDS 139,B00,507313,Pappas; Elizabeth,30,0,30,0
1713492993223,EDS 201,A00,507315,Staff,18,0,30,12
1713492994250,EDS 203,A01,507317,Halter; Christopher P.,17,0,30,13
1713492995275,EDS 204R,A01,507319,Halter; Christopher P.,0,1,30,30
1713492995275,EDS 204R,B01,507331,Heinzman; Erica M.,22,0,30,8
1713492996300,EDS 206R,A00,507332,Staff,0,2,30,30
1713492996300,EDS 206R,B00,507343,Staff,23,0,30,7
1713492997326,EDS 250,A00,507344,Hemans; Patricia Ann Benitez,27,0,40,13
1713492998353,EDS 281,A00,507345,Daly; Alan J.,18,0,18,0
1713492999381,EDS 284,A00,507350,Daly; Alan J.,16,0,16,0
1713493000405,EDS 286,A00,507359,Fine; Sarah,18,0,18,0
1713493001429,EDS 289C,A01,507361,Daly; Alan J.,18,0,18,0
1713493002458,EDS 290,A00,507366,Hofstetter; Carolyn,15,0,15,0
1713493003485,LIGM 5A,A00,507421,Fischer-Grunski; Eva K,20,0,20,0
1713493004511,LIGM 5B,A00,507423,Fischer-Grunski; Eva K,20,0,20,0
1713493005537,LIGM 5C,A00,507425,Fischer-Grunski; Eva K,20,0,20,0
1713493006563,LIIT 5AS,A00,507427,Carnelos; Chiara,20,0,20,0
1713493007590,LIIT 5BS,A00,507430,Carnelos; Chiara,20,0,20,0
1713493008615,LIIT 5CS,A00,507432,Carnelos; Chiara,20,0,20,0
1713493009641,LISP 5A,A00,507541,Munoz Sanchez; Alicia,14,0,20,6
1713493010670,LISP 5B,A00,507671,Munoz Sanchez; Alicia,12,0,20,8
1713493011699,LISP 5C,A00,507696,Munoz Sanchez; Alicia,11,0,20,9
1713493012724,MAE 197,001,528363,Boechler; Nicholas Sebastia,9998,0,9999,1
1713493013753,MATH 197,001,523477,Kedlaya; Kiran S.,9999,0,9999,0
1713493013753,MATH 197,002,563811,Zhang; Danna,9998,0,9999,1
1713493014778,MCWP 40R,A00,518780,Staff,15,0,20,5
1713493014778,MCWP 40R,B00,518781,Staff,14,0,20,6
1713493014778,MCWP 40R,C00,518783,Staff,9,0,20,11
1713493015808,MCWP 50R,A00,518791,Staff,8,0,20,12
1713493015808,MCWP 50R,B00,518792,Staff,3,0,20,17
1713493015808,MCWP 50R,C00,518793,Staff,7,0,20,13
1713493015808,MCWP 50R,D00,518794,Staff,0,0,20,20
1713493015808,MCWP 50R,E00,518795,Staff,0,0,20,20
1713493015808,MCWP 50R,F00,518796,Staff,11,0,20,9
1713493015808,MCWP 50R,G00,518797,Staff,11,0,20,9
1713493016837,MMW 12R,A01,514034,Herbst; Matthew,5,0,16,11
1713493016837,MMW 12R,A02,514035,Herbst; Matthew,13,0,16,3
1713493017865,MMW 13R,A01,514037,Staff,0,5,16,16
1713493017865,MMW 13R,A02,514039,Staff,0,4,16,16
1713493019919,SIO 295LS,A00,523233,Staff,15,0,30,15
1713493020951,SIO 295S,A00,523232,Staff,15,0,30,15
1713493021981,SOCI 117,A01,494376,Staff,0,2,5,5
1713493023006,WES 237B,A00,494380,Staff,19,0,20,1
1713493025072,AESE 279B,A00,494370,Wade; Jon P,33,0,33,0
1713493026098,AIP 197,001,627712,Vespa; Emanuel Ignacio,9999,0,9999,0
1713493027129,ANAR 135S,A00,494369,Braswell; Geoffrey E.,0,0,0,0
1713493028155,CAT 124RS,A01,519847,Geibel; William,6,0,20,14
1713493029183,CAT 125RS,A01,515971,Geibel; William,6,0,20,14
1713493030212,CLRE 250,A00,511389,Morris; Sheldon,9996,0,9999,3
1713493031239,CLRE 251,A00,507176,Mehta; Ravindra L.,9996,0,9999,3
1713493031239,CLRE 251,B00,511410,Mehta; Ravindra L.,9998,0,9999,1
1713493032265,CLRE 252,A00,507189,Cuomo; Raphael Eduardo,9998,0,9999,1
1713493033296,CLRE 253,A00,507199,Vaida; Florin,9997,0,9999,2
1713493033296,CLRE 253,B00,507202,Vaida; Florin,9999,0,9999,0
1713493034325,CLRE 259,A00,507211,Patel; Hemal,9996,0,9999,3
1713493035351,CLRE 260,A00,507221,Cuomo; Raphael Eduardo,9999,0,9999,0
1713493036375,CLRE 297,001,507242,Cuomo; Raphael Eduardo,9999,0,9999,0
1713493037406,CSE 191,A00,516875,Minnes Kemp; Mor Mia,9999,0,9999,0
1713493038433,CSS 201S,A01,494383,Staff,35,0,35,0
1713493039457,CSS 202S,A01,494387,Staff,35,0,35,0
1713493040483,EAP 100,A00,516065,Staff,9792,0,9999,207
1713493041511,ECE 45,A01,507414,Staff,38,0,60,22
1713493042537,ECE 100,A01,507416,Baghdadchi; Saharnaz,0,0,20,20
1713493042537,ECE 100,A02,507418,Baghdadchi; Saharnaz,19,0,20,1
1713493043562,ECE 111,A01,507420,Staff,27,0,50,23
1713493044586,ECE 197,001,548057,Sievenpiper; Daniel F.,9998,0,9999,1
1713493045612,EDS 115,A00,507243,Choi; Bailey Miyeon,27,0,28,1
1713493046637,EDS 117,A01,494379,Staff,15,0,25,10
1713493047668,EDS 125,A00,507246,Hopkins; Megan Beth,27,0,30,3
1713493048697,EDS 128A,A01,507264,Fargason; Sharon Gayle,26,0,26,0
1713493049723,EDS 128B,A01,507293,Pappas; Elizabeth,30,0,30,0
1713493050748,EDS 139,A00,507294,Fargason; Sharon Gayle,30,0,30,0
1713493050748,EDS 139,B00,507313,Pappas; Elizabeth,30,0,30,0
1713493051774,EDS 201,A00,507315,Staff,18,0,30,12
1713493052800,EDS 203,A01,507317,Halter; Christopher P.,17,0,30,13
1713493053829,EDS 204R,A01,507319,Halter; Christopher P.,0,1,30,30
1713493053829,EDS 204R,B01,507331,Heinzman; Erica M.,22,0,30,8
1713493054858,EDS 206R,A00,507332,Staff,0,2,30,30
1713493054858,EDS 206R,B00,507343,Staff,23,0,30,7
1713493055887,EDS 250,A00,507344,Hemans; Patricia Ann Benitez,27,0,40,13
1713493056915,EDS 281,A00,507345,Daly; Alan J.,18,0,18,0
1713493057942,EDS 284,A00,507350,Daly; Alan J.,16,0,16,0
1713493058971,EDS 286,A00,507359,Fine; Sarah,18,0,18,0
1713493059997,EDS 289C,A01,507361,Daly; Alan J.,18,0,18,0
1713493061022,EDS 290,A00,507366,Hofstetter; Carolyn,15,0,15,0
1713493062084,LIGM 5A,A00,507421,Fischer-Grunski; Eva K,20,0,20,0
1713493063110,LIGM 5B,A00,507423,Fischer-Grunski; Eva K,20,0,20,0
1713493064138,LIGM 5C,A00,507425,Fischer-Grunski; Eva K,20,0,20,0
1713493065164,LIIT 5AS,A00,507427,Carnelos; Chiara,20,0,20,0
1713493066189,LIIT 5BS,A00,507430,Carnelos; Chiara,20,0,20,0
1713493067215,LIIT 5CS,A00,507432,Carnelos; Chiara,20,0,20,0
1713493068244,LISP 5A,A00,507541,Munoz Sanchez; Alicia,14,0,20,6
1713493069270,LISP 5B,A00,507671,Munoz Sanchez; Alicia,12,0,20,8
1713493070298,LISP 5C,A00,507696,Munoz Sanchez; Alicia,11,0,20,9
1713493071328,MAE 197,001,528363,Boechler; Nicholas Sebastia,9998,0,9999,1
1713493072355,MATH 197,001,523477,Kedlaya; Kiran S.,9999,0,9999,0
1713493072355,MATH 197,002,563811,Zhang; Danna,9998,0,9999,1
1713493073381,MCWP 40R,A00,518780,Staff,15,0,20,5
1713493073381,MCWP 40R,B00,518781,Staff,14,0,20,6
1713493073381,MCWP 40R,C00,518783,Staff,9,0,20,11
1713493074407,MCWP 50R,A00,518791,Staff,8,0,20,12
1713493074407,MCWP 50R,B00,518792,Staff,3,0,20,17
1713493074407,MCWP 50R,C00,518793,Staff,7,0,20,13
1713493074407,MCWP 50R,D00,518794,Staff,0,0,20,20
1713493074407,MCWP 50R,E00,518795,Staff,0,0,20,20
1713493074407,MCWP 50R,F00,518796,Staff,11,0,20,9
1713493074407,MCWP 50R,G00,518797,Staff,11,0,20,9
1713493075433,MMW 12R,A01,514034,Herbst; Matthew,5,0,16,11
1713493075433,MMW 12R,A02,514035,Herbst; Matthew,13,0,16,3
1713493076461,MMW 13R,A01,514037,Staff,0,6,16,16
1713493076461,MMW 13R,A02,514039,Staff,0,4,16,16
1713493078513,SIO 295LS,A00,523233,Staff,15,0,30,15
1713493079539,SIO 295S,A00,523232,Staff,15,0,30,15
1713493080565,SOCI 117,A01,494376,Staff,0,2,5,5
1713493081592,WES 237B,A00,494380,Staff,19,0,20,1
1713493083661,AESE 279B,A00,494370,Wade; Jon P,33,0,33,0
1713493084742,AIP 197,001,627712,Vespa; Emanuel Ignacio,9999,0,9999,0
1713493085767,ANAR 135S,A00,494369,Braswell; Geoffrey E.,0,0,0,0
1713493086799,CAT 124RS,A01,519847,Geibel; William,6,0,20,14
1713493087824,CAT 125RS,A01,515971,Geibel; William,6,0,20,14
1713493088850,CLRE 250,A00,511389,Morris; Sheldon,9996,0,9999,3
1713493089880,CLRE 251,A00,507176,Mehta; Ravindra L.,9996,0,9999,3
1713493089880,CLRE 251,B00,511410,Mehta; Ravindra L.,9998,0,9999,1
1713493090908,CLRE 252,A00,507189,Cuomo; Raphael Eduardo,9998,0,9999,1
1713493091939,CLRE 253,A00,507199,Vaida; Florin,9997,0,9999,2
1713493091939,CLRE 253,B00,507202,Vaida; Florin,9999,0,9999,0
1713493092966,CLRE 259,A00,507211,Patel; Hemal,9996,0,9999,3
1713493093992,CLRE 260,A00,507221,Cuomo; Raphael Eduardo,9999,0,9999,0
1713493095018,CLRE 297,001,507242,Cuomo; Raphael Eduardo,9999,0,9999,0
1713493096045,CSE 191,A00,516875,Minnes Kemp; Mor Mia,9999,0,9999,0
1713493097074,CSS 201S,A01,494383,Staff,35,0,35,0
1713493098100,CSS 202S,A01,494387,Staff,35,0,35,0
1713493099129,EAP 100,A00,516065,Staff,9792,0,9999,207
1713493100159,ECE 45,A01,507414,Staff,38,0,60,22
1713493101188,ECE 100,A01,507416,Baghdadchi; Saharnaz,0,0,20,20
1713493101188,ECE 100,A02,507418,Baghdadchi; Saharnaz,19,0,20,1
1713493102214,ECE 111,A01,507420,Staff,27,0,50,23
1713493103244,ECE 197,001,548057,Sievenpiper; Daniel F.,9998,0,9999,1
1713493104274,EDS 115,A00,507243,Choi; Bailey Miyeon,27,0,28,1
1713493105297,EDS 117,A01,494379,Staff,15,0,25,10
1713493106323,EDS 125,A00,507246,Hopkins; Megan Beth,27,0,30,3
1713493107349,EDS 128A,A01,507264,Fargason; Sharon Gayle,26,0,26,0
1713493108375,EDS 128B,A01,507293,Pappas; Elizabeth,30,0,30,0
1713493109400,EDS 139,A00,507294,Fargason; Sharon Gayle,30,0,30,0
1713493109400,EDS 139,B00,507313,Pappas; Elizabeth,30,0,30,0
1713493110428,EDS 201,A00,507315,Staff,18,0,30,12
1713493111454,EDS 203,A01,507317,Halter; Christopher P.,17,0,30,13
1713493112485,EDS 204R,A01,507319,Halter; Christopher P.,0,1,30,30
1713493112485,EDS 204R,B01,507331,Heinzman; Erica M.,22,0,30,8
1713493113512,EDS 206R,A00,507332,Staff,0,2,30,30
1713493113512,EDS 206R,B00,507343,Staff,23,0,30,7
1713493114536,EDS 250,A00,507344,Hemans; Patricia Ann Benitez,27,0,40,13
1713493115563,EDS 281,A00,507345,Daly; Alan J.,18,0,18,0
1713493116590,EDS 284,A00,507350,Daly; Alan J.,16,0,16,0
1713493117617,EDS 286,A00,507359,Fine; Sarah,18,0,18,0
1713493118643,EDS 289C,A01,507361,Daly; Alan J.,18,0,18,0
1713493119674,EDS 290,A00,507366,Hofstetter; Carolyn,15,0,15,0
1713493120699,LIGM 5A,A00,507421,Fischer-Grunski; Eva K,20,0,20,0
1713493121734,LIGM 5B,A00,507423,Fischer-Grunski; Eva K,20,0,20,0
1713493122760,LIGM 5C,A00,507425,Fischer-Grunski; Eva K,20,0,20,0
1713493123790,LIIT 5AS,A00,507427,Carnelos; Chiara,20,0,20,0
1713493124817,LIIT 5BS,A00,507430,Carnelos; Chiara,20,0,20,0
1713493125841,LIIT 5CS,A00,507432,Carnelos; Chiara,20,0,20,0
1713493126873,LISP 5A,A00,507541,Munoz Sanchez; Alicia,14,0,20,6
1713493127899,LISP 5B,A00,507671,Munoz Sanchez; Alicia,12,0,20,8
1713493128926,LISP 5C,A00,507696,Munoz Sanchez; Alicia,11,0,20,9
1713493129953,MAE 197,001,528363,Boechler; Nicholas Sebastia,9998,0,9999,1
1713493130985,MATH 197,001,523477,Kedlaya; Kiran S.,9999,0,9999,0
1713493130985,MATH 197,002,563811,Zhang; Danna,9998,0,9999,1
1713493132015,MCWP 40R,A00,518780,Staff,15,0,20,5
1713493132015,MCWP 40R,B00,518781,Staff,14,0,20,6
1713493132015,MCWP 40R,C00,518783,Staff,9,0,20,11
1713493133050,MCWP 50R,A00,518791,Staff,8,0,20,12
1713493133050,MCWP 50R,B00,518792,Staff,3,0,20,17
1713493133050,MCWP 50R,C00,518793,Staff,7,0,20,13
1713493133050,MCWP 50R,D00,518794,Staff,0,0,20,20
1713493133050,MCWP 50R,E00,518795,Staff,0,0,20,20
1713493133050,MCWP 50R,F00,518796,Staff,11,0,20,9
1713493133050,MCWP 50R,G00,518797,Staff,11,0,20,9
1713493134079,MMW 12R,A01,514034,Herbst; Matthew,5,0,16,11
1713493134079,MMW 12R,A02,514035,Herbst; Matthew,13,0,16,3
1713493135105,MMW 13R,A01,514037,Staff,0,6,16,16
1713493135105,MMW 13R,A02,514039,Staff,0,4,16,16
1713493137160,SIO 295LS,A00,523233,Staff,15,0,30,15
1713493138186,SIO 295S,A00,523232,Staff,15,0,30,15
1713493139212,SOCI 117,A01,494376,Staff,0,2,5,5
1713493140238,WES 237B,A00,494380,Staff,19,0,20,1
1713493142302,AESE 279B,A00,494370,Wade; Jon P,33,0,33,0
1713493143332,AIP 197,001,627712,Vespa; Emanuel Ignacio,9999,0,9999,0
1713493144356,ANAR 135S,A00,494369,Braswell; Geoffrey E.,0,0,0,0
1713493145386,CAT 124RS,A01,519847,Geibel; William,6,0,20,14
1713493146416,CAT 125RS,A01,515971,Geibel; William,6,0,20,14
1713493147446,CLRE 250,A00,511389,Morris; Sheldon,9996,0,9999,3
1713493148476,CLRE 251,A00,507176,Mehta; Ravindra L.,9996,0,9999,3
1713493148476,CLRE 251,B00,511410,Mehta; Ravindra L.,9998,0,9999,1
1713493149506,CLRE 252,A00,507189,Cuomo; Raphael Eduardo,9998,0,9999,1
1713493150528,CLRE 253,A00,507199,Vaida; Florin,9997,0,9999,2
1713493150528,CLRE 253,B00,507202,Vaida; Florin,9999,0,9999,0
1713493151553,CLRE 259,A00,507211,Patel; Hemal,9996,0,9999,3
1713493152579,CLRE 260,A00,507221,Cuomo; Raphael Eduardo,9999,0,9999,0
1713493153605,CLRE 297,001,507242,Cuomo; Raphael Eduardo,9999,0,9999,0
1713493154631,CSE 191,A00,516875,Minnes Kemp; Mor Mia,9999,0,9999,0
1713493155660,CSS 201S,A01,494383,Staff,35,0,35,0
1713493156683,CSS 202S,A01,494387,Staff,35,0,35,0
1713493157710,EAP 100,A00,516065,Staff,9792,0,9999,207
1713493158740,ECE 45,A01,507414,Staff,38,0,60,22
1713493159766,ECE 100,A01,507416,Baghdadchi; Saharnaz,0,0,20,20
1713493159766,ECE 100,A02,507418,Baghdadchi; Saharnaz,19,0,20,1
1713493160795,ECE 111,A01,507420,Staff,27,0,50,23
1713493161821,ECE 197,001,548057,Sievenpiper; Daniel F.,9998,0,9999,1
1713493162847,EDS 115,A00,507243,Choi; Bailey Miyeon,27,0,28,1
1713493163873,EDS 117,A01,494379,Staff,15,0,25,10
1713493164902,EDS 125,A00,507246,Hopkins; Megan Beth,27,0,30,3
1713493165927,EDS 128A,A01,507264,Fargason; Sharon Gayle,26,0,26,0
1713493166958,EDS 128B,A01,507293,Pappas; Elizabeth,30,0,30,0
1713493167991,EDS 139,A00,507294,Fargason; Sharon Gayle,30,0,30,0
1713493167991,EDS 139,B00,507313,Pappas; Elizabeth,30,0,30,0
1713493169016,EDS 201,A00,507315,Staff,18,0,30,12
1713493170045,EDS 203,A01,507317,Halter; Christopher P.,17,0,30,13
1713493171070,EDS 204R,A01,507319,Halter; Christopher P.,0,1,30,30
1713493171070,EDS 204R,B01,507331,Heinzman; Erica M.,22,0,30,8
1713493172094,EDS 206R,A00,507332,Staff,0,2,30,30
1713493172094,EDS 206R,B00,507343,Staff,23,0,30,7
1713493173122,EDS 250,A00,507344,Hemans; Patricia Ann Benitez,27,0,40,13
1713493174147,EDS 281,A00,507345,Daly; Alan J.,18,0,18,0
1713493175175,EDS 284,A00,507350,Daly; Alan J.,16,0,16,0
1713493176201,EDS 286,A00,507359,Fine; Sarah,18,0,18,0
1713493177227,EDS 289C,A01,507361,Daly; Alan J.,18,0,18,0
1713493178253,EDS 290,A00,507366,Hofstetter; Carolyn,15,0,15,0
1713493179285,LIGM 5A,A00,507421,Fischer-Grunski; Eva K,20,0,20,0
1713493180310,LIGM 5B,A00,507423,Fischer-Grunski; Eva K,20,0,20,0
1713493181337,LIGM 5C,A00,507425,Fischer-Grunski; Eva K,20,0,20,0
1713493182369,LIIT 5AS,A00,507427,Carnelos; Chiara,20,0,20,0
1713493183394,LIIT 5BS,A00,507430,Carnelos; Chiara,20,0,20,0
1713493184419,LIIT 5CS,A00,507432,Carnelos; Chiara,20,0,20,0
1713493185447,LISP 5A,A00,507541,Munoz Sanchez; Alicia,14,0,20,6
1713493186477,LISP 5B,A00,507671,Munoz Sanchez; Alicia,12,0,20,8
1713493187501,LISP 5C,A00,507696,Munoz Sanchez; Alicia,11,0,20,9
1713493188581,MAE 197,001,528363,Boechler; Nicholas Sebastia,9998,0,9999,1
1713493189607,MATH 197,001,523477,Kedlaya; Kiran S.,9999,0,9999,0
1713493189607,MATH 197,002,563811,Zhang; Danna,9998,0,9999,1
1713493190634,MCWP 40R,A00,518780,Staff,15,0,20,5
1713493190634,MCWP 40R,B00,518781,Staff,14,0,20,6
1713493190634,MCWP 40R,C00,518783,Staff,9,0,20,11
1713493191661,MCWP 50R,A00,518791,Staff,8,0,20,12
1713493191661,MCWP 50R,B00,518792,Staff,3,0,20,17
1713493191661,MCWP 50R,C00,518793,Staff,7,0,20,13
1713493191661,MCWP 50R,D00,518794,Staff,0,0,20,20
1713493191661,MCWP 50R,E00,518795,Staff,0,0,20,20
1713493191661,MCWP 50R,F00,518796,Staff,11,0,20,9
1713493191661,MCWP 50R,G00,518797,Staff,11,0,20,9
1713493192686,MMW 12R,A01,514034,Herbst; Matthew,5,0,16,11
1713493192686,MMW 12R,A02,514035,Herbst; Matthew,13,0,16,3
1713493193714,MMW 13R,A01,514037,Staff,0,6,16,16
1713493193714,MMW 13R,A02,514039,Staff,0,4,16,16
1713493195770,SIO 295LS,A00,523233,Staff,15,0,30,15
1713493196800,SIO 295S,A00,523232,Staff,15,0,30,15
1713493197826,SOCI 117,A01,494376,Staff,0,2,5,5
1713493198854,WES 237B,A00,494380,Staff,19,0,20,1
1713493200920,AESE 279B,A00,494370,Wade; Jon P,33,0,33,0
1713493201947,AIP 197,001,627712,Vespa; Emanuel Ignacio,9999,0,9999,0
1713493202973,ANAR 135S,A00,494369,Braswell; Geoffrey E.,0,0,0,0
1713493203999,CAT 124RS,A01,519847,Geibel; William,6,0,20,14
1713493205028,CAT 125RS,A01,515971,Geibel; William,6,0,20,14
1713493206055,CLRE 250,A00,511389,Morris; Sheldon,9996,0,9999,3
1713493207086,CLRE 251,A00,507176,Mehta; Ravindra L.,9996,0,9999,3
1713493207086,CLRE 251,B00,511410,Mehta; Ravindra L.,9998,0,9999,1
1713493208113,CLRE 252,A00,507189,Cuomo; Raphael Eduardo,9998,0,9999,1
1713493209140,CLRE 253,A00,507199,Vaida; Florin,9997,0,9999,2
1713493209140,CLRE 253,B00,507202,Vaida; Florin,9999,0,9999,0
1713493210167,CLRE 259,A00,507211,Patel; Hemal,9996,0,9999,3
1713493211194,CLRE 260,A00,507221,Cuomo; Raphael Eduardo,9999,0,9999,0
1713493212221,CLRE 297,001,507242,Cuomo; Raphael Eduardo,9999,0,9999,0
1713493213248,CSE 191,A00,516875,Minnes Kemp; Mor Mia,9999,0,9999,0
1713493214274,CSS 201S,A01,494383,Staff,35,0,35,0
1713493215301,CSS 202S,A01,494387,Staff,35,0,35,0
1713493216326,EAP 100,A00,516065,Staff,9792,0,9999,207
1713493217354,ECE 45,A01,507414,Staff,38,0,60,22
1713493218386,ECE 100,A01,507416,Baghdadchi; Saharnaz,0,0,20,20
1713493218386,ECE 100,A02,507418,Baghdadchi; Saharnaz,19,0,20,1
1713493219413,ECE 111,A01,507420,Staff,27,0,50,23
1713493220439,ECE 197,001,548057,Sievenpiper; Daniel F.,9998,0,9999,1
1713493221465,EDS 115,A00,507243,Choi; Bailey Miyeon,27,0,28,1
1713493222493,EDS 117,A01,494379,Staff,15,0,25,10
1713493223518,EDS 125,A00,507246,Hopkins; Megan Beth,27,0,30,3
1713493224548,EDS 128A,A01,507264,Fargason; Sharon Gayle,26,0,26,0
1713493225576,EDS 128B,A01,507293,Pappas; Elizabeth,30,0,30,0
1713493226605,EDS 139,A00,507294,Fargason; Sharon Gayle,30,0,30,0
1713493226605,EDS 139,B00,507313,Pappas; Elizabeth,30,0,30,0
1713493227631,EDS 201,A00,507315,Staff,18,0,30,12
1713493228658,EDS 203,A01,507317,Halter; Christopher P.,17,0,30,13
1713493229684,EDS 204R,A01,507319,Halter; Christopher P.,0,1,30,30
1713493229684,EDS 204R,B01,507331,Heinzman; Erica M.,22,0,30,8
1713493230709,EDS 206R,A00,507332,Staff,0,2,30,30
1713493230709,EDS 206R,B00,507343,Staff,23,0,30,7
1713493231739,EDS 250,A00,507344,Hemans; Patricia Ann Benitez,27,0,40,13
1713493232766,EDS 281,A00,507345,Daly; Alan J.,18,0,18,0
1713493233792,EDS 284,A00,507350,Daly; Alan J.,16,0,16,0
1713493234818,EDS 286,A00,507359,Fine; Sarah,18,0,18,0
1713493235847,EDS 289C,A01,507361,Daly; Alan J.,18,0,18,0
1713493236874,EDS 290,A00,507366,Hofstetter; Carolyn,15,0,15,0
1713493237903,LIGM 5A,A00,507421,Fischer-Grunski; Eva K,20,0,20,0
1713493238929,LIGM 5B,A00,507423,Fischer-Grunski; Eva K,20,0,20,0
1713493239955,LIGM 5C,A00,507425,Fischer-Grunski; Eva K,20,0,20,0
1713493240985,LIIT 5AS,A00,507427,Carnelos; Chiara,20,0,20,0
1713493242011,LIIT 5BS,A00,507430,Carnelos; Chiara,20,0,20,0
1713493243036,LIIT 5CS,A00,507432,Carnelos; Chiara,20,0,20,0
1713493244062,LISP 5A,A00,507541,Munoz Sanchez; Alicia,14,0,20,6
1713493245087,LISP 5B,A00,507671,Munoz Sanchez; Alicia,12,0,20,8
1713493246113,LISP 5C,A00,507696,Munoz Sanchez; Alicia,11,0,20,9
1713493247141,MAE 197,001,528363,Boechler; Nicholas Sebastia,9998,0,9999,1
1713493248168,MATH 197,001,523477,Kedlaya; Kiran S.,9999,0,9999,0
1713493248168,MATH 197,002,563811,Zhang; Danna,9998,0,9999,1
1713493249193,MCWP 40R,A00,518780,Staff,15,0,20,5
1713493249193,MCWP 40R,B00,518781,Staff,14,0,20,6
1713493249193,MCWP 40R,C00,518783,Staff,9,0,20,11
1713493250220,MCWP 50R,A00,518791,Staff,8,0,20,12
1713493250220,MCWP 50R,B00,518792,Staff,3,0,20,17
1713493250220,MCWP 50R,C00,518793,Staff,7,0,20,13
1713493250220,MCWP 50R,D00,518794,Staff,0,0,20,20
1713493250220,MCWP 50R,E00,518795,Staff,0,0,20,20
1713493250220,MCWP 50R,F00,518796,Staff,11,0,20,9
1713493250220,MCWP 50R,G00,518797,Staff,11,0,20,9
1713493251249,MMW 12R,A01,514034,Herbst; Matthew,5,0,16,11
1713493251249,MMW 12R,A02,514035,Herbst; Matthew,13,0,16,3
1713493252274,MMW 13R,A01,514037,Staff,0,6,16,16
1713493252274,MMW 13R,A02,514039,Staff,0,4,16,16
1713493254329,SIO 295LS,A00,523233,Staff,15,0,30,15
1713493255354,SIO 295S,A00,523232,Staff,15,0,30,15
1713493256380,SOCI 117,A01,494376,Staff,0,2,5,5
1713493257408,WES 237B,A00,494380,Staff,19,0,20,1
1713493259480,AESE 279B,A00,494370,Wade; Jon P,33,0,33,0
1713493260507,AIP 197,001,627712,Vespa; Emanuel Ignacio,9999,0,9999,0
1713493261536,ANAR 135S,A00,494369,Braswell; Geoffrey E.,0,0,0,0
1713493262566,CAT 124RS,A01,519847,Geibel; William,6,0,20,14
1713493263595,CAT 125RS,A01,515971,Geibel; William,6,0,20,14
1713493264620,CLRE 250,A00,511389,Morris; Sheldon,9996,0,9999,3
1713493265649,CLRE 251,A00,507176,Mehta; Ravindra L.,9996,0,9999,3
1713493265649,CLRE 251,B00,511410,Mehta; Ravindra L.,9998,0,9999,1
1713493266680,CLRE 252,A00,507189,Cuomo; Raphael Eduardo,9998,0,9999,1
1713493267708,CLRE 253,A00,507199,Vaida; Florin,9997,0,9999,2
1713493267708,CLRE 253,B00,507202,Vaida; Florin,9999,0,9999,0
1713493268734,CLRE 259,A00,507211,Patel; Hemal,9996,0,9999,3
1713493269763,CLRE 260,A00,507221,Cuomo; Raphael Eduardo,9999,0,9999,0
1713493270789,CLRE 297,001,507242,Cuomo; Raphael Eduardo,9999,0,9999,0
1713493271814,CSE 191,A00,516875,Minnes Kemp; Mor Mia,9999,0,9999,0
1713493272843,CSS 201S,A01,494383,Staff,35,0,35,0
1713493273869,CSS 202S,A01,494387,Staff,35,0,35,0
1713493274895,EAP 100,A00,516065,Staff,9792,0,9999,207
1713493275919,ECE 45,A01,507414,Staff,38,0,60,22
1713493276945,ECE 100,A01,507416,Baghdadchi; Saharnaz,0,0,20,20
1713493276945,ECE 100,A02,507418,Baghdadchi; Saharnaz,19,0,20,1
1713493277971,ECE 111,A01,507420,Staff,27,0,50,23
1713493278996,ECE 197,001,548057,Sievenpiper; Daniel F.,9998,0,9999,1
1713493280022,EDS 115,A00,507243,Choi; Bailey Miyeon,27,0,28,1
1713493281049,EDS 117,A01,494379,Staff,15,0,25,10
1713493282075,EDS 125,A00,507246,Hopkins; Megan Beth,27,0,30,3
1713493283101,EDS 128A,A01,507264,Fargason; Sharon Gayle,26,0,26,0
1713493284125,EDS 128B,A01,507293,Pappas; Elizabeth,30,0,30,0
1713493285148,EDS 139,A00,507294,Fargason; Sharon Gayle,30,0,30,0
1713493285148,EDS 139,B00,507313,Pappas; Elizabeth,30,0,30,0
1713493286176,EDS 201,A00,507315,Staff,18,0,30,12
1713493287203,EDS 203,A01,507317,Halter; Christopher P.,17,0,30,13
1713493288229,EDS 204R,A01,507319,Halter; Christopher P.,0,1,30,30
1713493288229,EDS 204R,B01,507331,Heinzman; Erica M.,22,0,30,8
1713493289258,EDS 206R,A00,507332,Staff,0,2,30,30
1713493289258,EDS 206R,B00,507343,Staff,23,0,30,7
1713493290288,EDS 250,A00,507344,Hemans; Patricia Ann Benitez,27,0,40,13
1713493291318,EDS 281,A00,507345,Daly; Alan J.,18,0,18,0
1713493292397,EDS 284,A00,507350,Daly; Alan J.,16,0,16,0
1713493293422,EDS 286,A00,507359,Fine; Sarah,18,0,18,0
1713493294447,EDS 289C,A01,507361,Daly; Alan J.,18,0,18,0
1713493295474,EDS 290,A00,507366,Hofstetter; Carolyn,15,0,15,0
1713493296502,LIGM 5A,A00,507421,Fischer-Grunski; Eva K,20,0,20,0
1713493297531,LIGM 5B,A00,507423,Fischer-Grunski; Eva K,20,0,20,0
1713493298559,LIGM 5C,A00,507425,Fischer-Grunski; Eva K,20,0,20,0
1713493299591,LIIT 5AS,A00,507427,Carnelos; Chiara,20,0,20,0
1713493300614,LIIT 5BS,A00,507430,Carnelos; Chiara,20,0,20,0
1713493301639,LIIT 5CS,A00,507432,Carnelos; Chiara,20,0,20,0
1713493302671,LISP 5A,A00,507541,Munoz Sanchez; Alicia,14,0,20,6
1713493303697,LISP 5B,A00,507671,Munoz Sanchez; Alicia,12,0,20,8
1713493304722,LISP 5C,A00,507696,Munoz Sanchez; Alicia,11,0,20,9
1713493305748,MAE 197,001,528363,Boechler; Nicholas Sebastia,9998,0,9999,1
1713493306773,MATH 197,001,523477,Kedlaya; Kiran S.,9999,0,9999,0
1713493306773,MATH 197,002,563811,Zhang; Danna,9998,0,9999,1
1713493307798,MCWP 40R,A00,518780,Staff,15,0,20,5
1713493307798,MCWP 40R,B00,518781,Staff,14,0,20,6
1713493307798,MCWP 40R,C00,518783,Staff,9,0,20,11
1713493308825,MCWP 50R,A00,518791,Staff,8,0,20,12
1713493308825,MCWP 50R,B00,518792,Staff,3,0,20,17
1713493308825,MCWP 50R,C00,518793,Staff,7,0,20,13
1713493308825,MCWP 50R,D00,518794,Staff,0,0,20,20
1713493308825,MCWP 50R,E00,518795,Staff,0,0,20,20
1713493308825,MCWP 50R,F00,518796,Staff,11,0,20,9
1713493308825,MCWP 50R,G00,518797,Staff,11,0,20,9
1713493309853,MMW 12R,A01,514034,Herbst; Matthew,5,0,16,11
1713493309853,MMW 12R,A02,514035,Herbst; Matthew,13,0,16,3
1713493310879,MMW 13R,A01,514037,Staff,0,6,16,16
1713493310879,MMW 13R,A02,514039,Staff,0,4,16,16
1713493312932,SIO 295LS,A00,523233,Staff,15,0,30,15
1713493313956,SIO 295S,A00,523232,Staff,15,0,30,15
1713493314986,SOCI 117,A01,494376,Staff,0,2,5,5
1713493316012,WES 237B,A00,494380,Staff,19,0,20,1
1713493318079,AESE 279B,A00,494370,Wade; Jon P,33,0,33,0
1713493319106,AIP 197,001,627712,Vespa; Emanuel Ignacio,9999,0,9999,0
1713493320133,ANAR 135S,A00,494369,Braswell; Geoffrey E.,0,0,0,0
1713493321163,CAT 124RS,A01,519847,Geibel; William,6,0,20,14
1713493322192,CAT 125RS,A01,515971,Geibel; William,6,0,20,14
1713493323222,CLRE 250,A00,511389,Morris; Sheldon,9996,0,9999,3
1713493324249,CLRE 251,A00,507176,Mehta; Ravindra L.,9996,0,9999,3
1713493324249,CLRE 251,B00,511410,Mehta; Ravindra L.,9998,0,9999,1
1713493325276,CLRE 252,A00,507189,Cuomo; Raphael Eduardo,9998,0,9999,1
1713493326304,CLRE 253,A00,507199,Vaida; Florin,9997,0,9999,2
1713493326304,CLRE 253,B00,507202,Vaida; Florin,9999,0,9999,0
1713493327330,CLRE 259,A00,507211,Patel; Hemal,9996,0,9999,3
1713493328355,CLRE 260,A00,507221,Cuomo; Raphael Eduardo,9999,0,9999,0
1713493329380,CLRE 297,001,507242,Cuomo; Raphael Eduardo,9999,0,9999,0
1713493330406,CSE 191,A00,516875,Minnes Kemp; Mor Mia,9999,0,9999,0
1713493331433,CSS 201S,A01,494383,Staff,35,0,35,0
1713493332459,CSS 202S,A01,494387,Staff,35,0,35,0
1713493333487,EAP 100,A00,516065,Staff,9792,0,9999,207
1713493334513,ECE 45,A01,507414,Staff,38,0,60,22
1713493335540,ECE 100,A01,507416,Baghdadchi; Saharnaz,0,0,20,20
1713493335540,ECE 100,A02,507418,Baghdadchi; Saharnaz,19,0,20,1
1713493336563,ECE 111,A01,507420,Staff,27,0,50,23
1713493337590,ECE 197,001,548057,Sievenpiper; Daniel F.,9998,0,9999,1
1713493338616,EDS 115,A00,507243,Choi; Bailey Miyeon,27,0,28,1
1713493339646,EDS 117,A01,494379,Staff,15,0,25,10
1713493340672,EDS 125,A00,507246,Hopkins; Megan Beth,27,0,30,3
1713493341701,EDS 128A,A01,507264,Fargason; Sharon Gayle,26,0,26,0
1713493342725,EDS 128B,A01,507293,Pappas; Elizabeth,30,0,30,0
1713493343749,EDS 139,A00,507294,Fargason; Sharon Gayle,30,0,30,0
1713493343749,EDS 139,B00,507313,Pappas; Elizabeth,30,0,30,0
1713493344774,EDS 201,A00,507315,Staff,18,0,30,12
1713493345800,EDS 203,A01,507317,Halter; Christopher P.,17,0,30,13
1713493346827,EDS 204R,A01,507319,Halter; Christopher P.,0,1,30,30
1713493346827,EDS 204R,B01,507331,Heinzman; Erica M.,22,0,30,8
1713493347853,EDS 206R,A00,507332,Staff,0,2,30,30
1713493347853,EDS 206R,B00,507343,Staff,23,0,30,7
1713493348880,EDS 250,A00,507344,Hemans; Patricia Ann Benitez,27,0,40,13
1713493349905,EDS 281,A00,507345,Daly; Alan J.,18,0,18,0
1713493350929,EDS 284,A00,507350,Daly; Alan J.,16,0,16,0
1713493351957,EDS 286,A00,507359,Fine; Sarah,18,0,18,0
1713493352986,EDS 289C,A01,507361,Daly; Alan J.,18,0,18,0
1713493354013,EDS 290,A00,507366,Hofstetter; Carolyn,15,0,15,0
1713493355040,LIGM 5A,A00,507421,Fischer-Grunski; Eva K,20,0,20,0
1713493356069,LIGM 5B,A00,507423,Fischer-Grunski; Eva K,20,0,20,0
1713493357094,LIGM 5C,A00,507425,Fischer-Grunski; Eva K,20,0,20,0
1713493358139,LIIT 5AS,A00,507427,Carnelos; Chiara,20,0,20,0
1713493359165,LIIT 5BS,A00,507430,Carnelos; Chiara,20,0,20,0
1713493360190,LIIT 5CS,A00,507432,Carnelos; Chiara,20,0,20,0
1713493361219,LISP 5A,A00,507541,Munoz Sanchez; Alicia,14,0,20,6
1713493362248,LISP 5B,A00,507671,Munoz Sanchez; Alicia,12,0,20,8
1713493363277,LISP 5C,A00,507696,Munoz Sanchez; Alicia,11,0,20,9
1713493364304,MAE 197,001,528363,Boechler; Nicholas Sebastia,9998,0,9999,1
1713493365334,MATH 197,001,523477,Kedlaya; Kiran S.,9999,0,9999,0
1713493365334,MATH 197,002,563811,Zhang; Danna,9998,0,9999,1
1713493366360,MCWP 40R,A00,518780,Staff,15,0,20,5
1713493366360,MCWP 40R,B00,518781,Staff,13,0,20,7
1713493366360,MCWP 40R,C00,518783,Staff,9,0,20,11
1713493367386,MCWP 50R,A00,518791,Staff,8,0,20,12
1713493367386,MCWP 50R,B00,518792,Staff,3,0,20,17
1713493367386,MCWP 50R,C00,518793,Staff,7,0,20,13
1713493367386,MCWP 50R,D00,518794,Staff,0,0,20,20
1713493367386,MCWP 50R,E00,518795,Staff,0,0,20,20
1713493367386,MCWP 50R,F00,518796,Staff,11,0,20,9
1713493367386,MCWP 50R,G00,518797,Staff,11,0,20,9
1713493368417,MMW 12R,A01,514034,Herbst; Matthew,5,0,16,11
1713493368417,MMW 12R,A02,514035,Herbst; Matthew,13,0,16,3
1713493369442,MMW 13R,A01,514037,Staff,0,6,16,16
1713493369442,MMW 13R,A02,514039,Staff,0,4,16,16
1713493371498,SIO 295LS,A00,523233,Staff,15,0,30,15
1713493372526,SIO 295S,A00,523232,Staff,15,0,30,15
1713493373552,SOCI 117,A01,494376,Staff,0,2,5,5
1713493374580,WES 237B,A00,494380,Staff,19,0,20,1
1713493376653,AESE 279B,A00,494370,Wade; Jon P,33,0,33,0
1713493377685,AIP 197,001,627712,Vespa; Emanuel Ignacio,9999,0,9999,0
1713493378709,ANAR 135S,A00,494369,Braswell; Geoffrey E.,0,0,0,0
1713493379739,CAT 124RS,A01,519847,Geibel; William,6,0,20,14
1713493380765,CAT 125RS,A01,515971,Geibel; William,6,0,20,14
1713493381792,CLRE 250,A00,511389,Morris; Sheldon,9996,0,9999,3
1713493382821,CLRE 251,A00,507176,Mehta; Ravindra L.,9996,0,9999,3
1713493382821,CLRE 251,B00,511410,Mehta; Ravindra L.,9998,0,9999,1
1713493383847,CLRE 252,A00,507189,Cuomo; Raphael Eduardo,9998,0,9999,1
1713493384873,CLRE 253,A00,507199,Vaida; Florin,9997,0,9999,2
1713493384873,CLRE 253,B00,507202,Vaida; Florin,9999,0,9999,0
1713493385900,CLRE 259,A00,507211,Patel; Hemal,9996,0,9999,3
1713493386926,CLRE 260,A00,507221,Cuomo; Raphael Eduardo,9999,0,9999,0
1713493387952,CLRE 297,001,507242,Cuomo; Raphael Eduardo,9999,0,9999,0
1713493388981,CSE 191,A00,516875,Minnes Kemp; Mor Mia,9999,0,9999,0
1713493390010,CSS 201S,A01,494383,Staff,35,0,35,0
1713493391040,CSS 202S,A01,494387,Staff,35,0,35,0
1713493392068,EAP 100,A00,516065,Staff,9792,0,9999,207
1713493393097,ECE 45,A01,507414,Staff,38,0,60,22
1713493394126,ECE 100,A01,507416,Baghdadchi; Saharnaz,0,0,20,20
1713493394126,ECE 100,A02,507418,Baghdadchi; Saharnaz,19,0,20,1
1713493395155,ECE 111,A01,507420,Staff,27,0,50,23
1713493396233,ECE 197,001,548057,Sievenpiper; Daniel F.,9998,0,9999,1
1713493397259,EDS 115,A00,507243,Choi; Bailey Miyeon,27,0,28,1
1713493398290,EDS 117,A01,494379,Staff,15,0,25,10
1713493399325,EDS 125,A00,507246,Hopkins; Megan Beth,27,0,30,3
1713493400353,EDS 128A,A01,507264,Fargason; Sharon Gayle,26,0,26,0
1713493401379,EDS 128B,A01,507293,Pappas; Elizabeth,30,0,30,0
1713493402407,EDS 139,A00,507294,Fargason; Sharon Gayle,30,0,30,0
1713493402407,EDS 139,B00,507313,Pappas; Elizabeth,30,0,30,0
1713493403433,EDS 201,A00,507315,Staff,18,0,30,12
1713493404460,EDS 203,A01,507317,Halter; Christopher P.,17,0,30,13
1713493405488,EDS 204R,A01,507319,Halter; Christopher P.,0,1,30,30
1713493405488,EDS 204R,B01,507331,Heinzman; Erica M.,22,0,30,8
1713493406514,EDS 206R,A00,507332,Staff,0,2,30,30
1713493406514,EDS 206R,B00,507343,Staff,23,0,30,7
1713493407545,EDS 250,A00,507344,Hemans; Patricia Ann Benitez,27,0,40,13
1713493408571,EDS 281,A00,507345,Daly; Alan J.,18,0,18,0
1713493409596,EDS 284,A00,507350,Daly; Alan J.,16,0,16,0
1713493410621,EDS 286,A00,507359,Fine; Sarah,18,0,18,0
1713493411649,EDS 289C,A01,507361,Daly; Alan J.,18,0,18,0
1713493412675,EDS 290,A00,507366,Hofstetter; Carolyn,15,0,15,0
1713493413706,LIGM 5A,A00,507421,Fischer-Grunski; Eva K,20,0,20,0
1713493414731,LIGM 5B,A00,507423,Fischer-Grunski; Eva K,20,0,20,0
1713493415757,LIGM 5C,A00,507425,Fischer-Grunski; Eva K,20,0,20,0
1713493416788,LIIT 5AS,A00,507427,Carnelos; Chiara,20,0,20,0
1713493417813,LIIT 5BS,A00,507430,Carnelos; Chiara,20,0,20,0
1713493418839,LIIT 5CS,A00,507432,Carnelos; Chiara,20,0,20,0
1713493419869,LISP 5A,A00,507541,Munoz Sanchez; Alicia,14,0,20,6
1713493420895,LISP 5B,A00,507671,Munoz Sanchez; Alicia,12,0,20,8
1713493421925,LISP 5C,A00,507696,Munoz Sanchez; Alicia,11,0,20,9
1713493422952,MAE 197,001,528363,Boechler; Nicholas Sebastia,9998,0,9999,1
1713493423979,MATH 197,001,523477,Kedlaya; Kiran S.,9999,0,9999,0
1713493423979,MATH 197,002,563811,Zhang; Danna,9998,0,9999,1
1713493425004,MCWP 40R,A00,518780,Staff,15,0,20,5
1713493425004,MCWP 40R,B00,518781,Staff,13,0,20,7
1713493425004,MCWP 40R,C00,518783,Staff,9,0,20,11
1713493426035,MCWP 50R,A00,518791,Staff,7,0,20,13
1713493426035,MCWP 50R,B00,518792,Staff,3,0,20,17
1713493426035,MCWP 50R,C00,518793,Staff,7,0,20,13
1713493426035,MCWP 50R,D00,518794,Staff,0,0,20,20
1713493426035,MCWP 50R,E00,518795,Staff,0,0,20,20
1713493426035,MCWP 50R,F00,518796,Staff,11,0,20,9
1713493426035,MCWP 50R,G00,518797,Staff,11,0,20,9
1713493427060,MMW 12R,A01,514034,Herbst; Matthew,5,0,16,11
1713493427060,MMW 12R,A02,514035,Herbst; Matthew,13,0,16,3
1713493428092,MMW 13R,A01,514037,Staff,0,6,16,16
1713493428092,MMW 13R,A02,514039,Staff,0,4,16,16
1713493430145,SIO 295LS,A00,523233,Staff,15,0,30,15
1713493431175,SIO 295S,A00,523232,Staff,15,0,30,15
1713493432205,SOCI 117,A01,494376,Staff,0,2,5,5
1713493433231,WES 237B,A00,494380,Staff,19,0,20,1
1713493435300,AESE 279B,A00,494370,Wade; Jon P,33,0,33,0
1713493436329,AIP 197,001,627712,Vespa; Emanuel Ignacio,9999,0,9999,0
1713493437355,ANAR 135S,A00,494369,Braswell; Geoffrey E.,0,0,0,0
1713493438382,CAT 124RS,A01,519847,Geibel; William,6,0,20,14
1713493439408,CAT 125RS,A01,515971,Geibel; William,6,0,20,14
1713493440437,CLRE 250,A00,511389,Morris; Sheldon,9996,0,9999,3
1713493441467,CLRE 251,A00,507176,Mehta; Ravindra L.,9996,0,9999,3
1713493441467,CLRE 251,B00,511410,Mehta; Ravindra L.,9998,0,9999,1
1713493442496,CLRE 252,A00,507189,Cuomo; Raphael Eduardo,9998,0,9999,1
1713493443526,CLRE 253,A00,507199,Vaida; Florin,9997,0,9999,2
1713493443526,CLRE 253,B00,507202,Vaida; Florin,9999,0,9999,0
1713493444552,CLRE 259,A00,507211,Patel; Hemal,9996,0,9999,3
1713493445580,CLRE 260,A00,507221,Cuomo; Raphael Eduardo,9999,0,9999,0
1713493446606,CLRE 297,001,507242,Cuomo; Raphael Eduardo,9999,0,9999,0
1713493447630,CSE 191,A00,516875,Minnes Kemp; Mor Mia,9999,0,9999,0
1713493448658,CSS 201S,A01,494383,Staff,35,0,35,0
1713493449684,CSS 202S,A01,494387,Staff,35,0,35,0
1713493450708,EAP 100,A00,516065,Staff,9792,0,9999,207
1713493451735,ECE 45,A01,507414,Staff,38,0,60,22
1713493452765,ECE 100,A01,507416,Baghdadchi; Saharnaz,0,0,20,20
1713493452765,ECE 100,A02,507418,Baghdadchi; Saharnaz,19,0,20,1
1713493453791,ECE 111,A01,507420,Staff,27,0,50,23
1713493454816,ECE 197,001,548057,Sievenpiper; Daniel F.,9998,0,9999,1
1713493455841,EDS 115,A00,507243,Choi; Bailey Miyeon,27,0,28,1
1713493456868,EDS 117,A01,494379,Staff,15,0,25,10
1713493457897,EDS 125,A00,507246,Hopkins; Megan Beth,27,0,30,3
1713493458924,EDS 128A,A01,507264,Fargason; Sharon Gayle,26,0,26,0
1713493459950,EDS 128B,A01,507293,Pappas; Elizabeth,30,0,30,0
1713493460979,EDS 139,A00,507294,Fargason; Sharon Gayle,30,0,30,0
1713493460979,EDS 139,B00,507313,Pappas; Elizabeth,30,0,30,0
1713493462005,EDS 201,A00,507315,Staff,18,0,30,12
1713493463035,EDS 203,A01,507317,Halter; Christopher P.,17,0,30,13
1713493464062,EDS 204R,A01,507319,Halter; Christopher P.,0,1,30,30
1713493464062,EDS 204R,B01,507331,Heinzman; Erica M.,22,0,30,8
1713493465088,EDS 206R,A00,507332,Staff,0,2,30,30
1713493465088,EDS 206R,B00,507343,Staff,23,0,30,7
1713493466115,EDS 250,A00,507344,Hemans; Patricia Ann Benitez,27,0,40,13
1713493467140,EDS 281,A00,507345,Daly; Alan J.,18,0,18,0
1713493468166,EDS 284,A00,507350,Daly; Alan J.,16,0,16,0
1713493469193,EDS 286,A00,507359,Fine; Sarah,18,0,18,0
1713493470217,EDS 289C,A01,507361,Daly; Alan J.,18,0,18,0
1713493471244,EDS 290,A00,507366,Hofstetter; Carolyn,15,0,15,0
1713493472273,LIGM 5A,A00,507421,Fischer-Grunski; Eva K,20,0,20,0
1713493473302,LIGM 5B,A00,507423,Fischer-Grunski; Eva K,20,0,20,0
1713493474326,LIGM 5C,A00,507425,Fischer-Grunski; Eva K,20,0,20,0
1713493475352,LIIT 5AS,A00,507427,Carnelos; Chiara,20,0,20,0
1713493476381,LIIT 5BS,A00,507430,Carnelos; Chiara,20,0,20,0
1713493477407,LIIT 5CS,A00,507432,Carnelos; Chiara,20,0,20,0
1713493478436,LISP 5A,A00,507541,Munoz Sanchez; Alicia,14,0,20,6
1713493479464,LISP 5B,A00,507671,Munoz Sanchez; Alicia,12,0,20,8
1713493480490,LISP 5C,A00,507696,Munoz Sanchez; Alicia,11,0,20,9
1713493481517,MAE 197,001,528363,Boechler; Nicholas Sebastia,9998,0,9999,1
1713493482548,MATH 197,001,523477,Kedlaya; Kiran S.,9999,0,9999,0
1713493482548,MATH 197,002,563811,Zhang; Danna,9998,0,9999,1
1713493483573,MCWP 40R,A00,518780,Staff,15,0,20,5
1713493483573,MCWP 40R,B00,518781,Staff,13,0,20,7
1713493483573,MCWP 40R,C00,518783,Staff,9,0,20,11
1713493484599,MCWP 50R,A00,518791,Staff,7,0,20,13
1713493484599,MCWP 50R,B00,518792,Staff,3,0,20,17
1713493484599,MCWP 50R,C00,518793,Staff,7,0,20,13
1713493484599,MCWP 50R,D00,518794,Staff,0,0,20,20
1713493484599,MCWP 50R,E00,518795,Staff,0,0,20,20
1713493484599,MCWP 50R,F00,518796,Staff,11,0,20,9
1713493484599,MCWP 50R,G00,518797,Staff,11,0,20,9
1713493485628,MMW 12R,A01,514034,Herbst; Matthew,5,0,16,11
1713493485628,MMW 12R,A02,514035,Herbst; Matthew,13,0,16,3
1713493486654,MMW 13R,A01,514037,Staff,0,6,16,16
1713493486654,MMW 13R,A02,514039,Staff,0,4,16,16
1713493488705,SIO 295LS,A00,523233,Staff,15,0,30,15
1713493489730,SIO 295S,A00,523232,Staff,15,0,30,15
1713493490758,SOCI 117,A01,494376,Staff,0,2,5,5
1713493491784,WES 237B,A00,494380,Staff,19,0,20,1
1713493493847,AESE 279B,A00,494370,Wade; Jon P,33,0,33,0
1713493494874,AIP 197,001,627712,Vespa; Emanuel Ignacio,9999,0,9999,0
1713493495900,ANAR 135S,A00,494369,Braswell; Geoffrey E.,0,0,0,0
1713493496928,CAT 124RS,A01,519847,Geibel; William,6,0,20,14
1713493497953,CAT 125RS,A01,515971,Geibel; William,6,0,20,14
1713493498984,CLRE 250,A00,511389,Morris; Sheldon,9996,0,9999,3
1713493500065,CLRE 251,A00,507176,Mehta; Ravindra L.,9996,0,9999,3
1713493500065,CLRE 251,B00,511410,Mehta; Ravindra L.,9998,0,9999,1
1713493501096,CLRE 252,A00,507189,Cuomo; Raphael Eduardo,9998,0,9999,1
1713493502120,CLRE 253,A00,507199,Vaida; Florin,9997,0,9999,2
1713493502120,CLRE 253,B00,507202,Vaida; Florin,9999,0,9999,0
1713493503147,CLRE 259,A00,507211,Patel; Hemal,9996,0,9999,3
1713493504172,CLRE 260,A00,507221,Cuomo; Raphael Eduardo,9999,0,9999,0
1713493505198,CLRE 297,001,507242,Cuomo; Raphael Eduardo,9999,0,9999,0
1713493506228,CSE 191,A00,516875,Minnes Kemp; Mor Mia,9999,0,9999,0
1713493507258,CSS 201S,A01,494383,Staff,35,0,35,0
1713493508290,CSS 202S,A01,494387,Staff,35,0,35,0
1713493509316,EAP 100,A00,516065,Staff,9792,0,9999,207
1713493510341,ECE 45,A01,507414,Staff,38,0,60,22
1713493511370,ECE 100,A01,507416,Baghdadchi; Saharnaz,0,0,20,20
1713493511370,ECE 100,A02,507418,Baghdadchi; Saharnaz,19,0,20,1
1713493512395,ECE 111,A01,507420,Staff,27,0,50,23
1713493513419,ECE 197,001,548057,Sievenpiper; Daniel F.,9998,0,9999,1
1713493514451,EDS 115,A00,507243,Choi; Bailey Miyeon,27,0,28,1
1713493515481,EDS 117,A01,494379,Staff,15,0,25,10
1713493516506,EDS 125,A00,507246,Hopkins; Megan Beth,27,0,30,3
1713493517532,EDS 128A,A01,507264,Fargason; Sharon Gayle,26,0,26,0
1713493518558,EDS 128B,A01,507293,Pappas; Elizabeth,30,0,30,0
1713493519582,EDS 139,A00,507294,Fargason; Sharon Gayle,30,0,30,0
1713493519582,EDS 139,B00,507313,Pappas; Elizabeth,30,0,30,0
1713493520608,EDS 201,A00,507315,Staff,18,0,30,12
1713493521634,EDS 203,A01,507317,Halter; Christopher P.,17,0,30,13
1713493522659,EDS 204R,A01,507319,Halter; Christopher P.,0,1,30,30
1713493522659,EDS 204R,B01,507331,Heinzman; Erica M.,22,0,30,8
1713493523684,EDS 206R,A00,507332,Staff,0,2,30,30
1713493523684,EDS 206R,B00,507343,Staff,23,0,30,7
1713493524711,EDS 250,A00,507344,Hemans; Patricia Ann Benitez,27,0,40,13
1713493525736,EDS 281,A00,507345,Daly; Alan J.,18,0,18,0
1713493526761,EDS 284,A00,507350,Daly; Alan J.,16,0,16,0
1713493527787,EDS 286,A00,507359,Fine; Sarah,18,0,18,0
1713493528812,EDS 289C,A01,507361,Daly; Alan J.,18,0,18,0
1713493529839,EDS 290,A00,507366,Hofstetter; Carolyn,15,0,15,0
1713493530867,LIGM 5A,A00,507421,Fischer-Grunski; Eva K,20,0,20,0
1713493531892,LIGM 5B,A00,507423,Fischer-Grunski; Eva K,20,0,20,0
1713493532917,LIGM 5C,A00,507425,Fischer-Grunski; Eva K,20,0,20,0
1713493533944,LIIT 5AS,A00,507427,Carnelos; Chiara,20,0,20,0
1713493534969,LIIT 5BS,A00,507430,Carnelos; Chiara,20,0,20,0
1713493535995,LIIT 5CS,A00,507432,Carnelos; Chiara,20,0,20,0
1713493537021,LISP 5A,A00,507541,Munoz Sanchez; Alicia,14,0,20,6
1713493538046,LISP 5B,A00,507671,Munoz Sanchez; Alicia,12,0,20,8
1713493539075,LISP 5C,A00,507696,Munoz Sanchez; Alicia,11,0,20,9
1713493540105,MAE 197,001,528363,Boechler; Nicholas Sebastia,9998,0,9999,1
1713493541131,MATH 197,001,523477,Kedlaya; Kiran S.,9999,0,9999,0
1713493541131,MATH 197,002,563811,Zhang; Danna,9998,0,9999,1
1713493542159,MCWP 40R,A00,518780,Staff,15,0,20,5
1713493542159,MCWP 40R,B00,518781,Staff,13,0,20,7
1713493542159,MCWP 40R,C00,518783,Staff,9,0,20,11
1713493543186,MCWP 50R,A00,518791,Staff,7,0,20,13
1713493543186,MCWP 50R,B00,518792,Staff,3,0,20,17
1713493543186,MCWP 50R,C00,518793,Staff,7,0,20,13
1713493543186,MCWP 50R,D00,518794,Staff,0,0,20,20
1713493543186,MCWP 50R,E00,518795,Staff,0,0,20,20
1713493543186,MCWP 50R,F00,518796,Staff,11,0,20,9
1713493543186,MCWP 50R,G00,518797,Staff,11,0,20,9
1713493544212,MMW 12R,A01,514034,Herbst; Matthew,5,0,16,11
1713493544212,MMW 12R,A02,514035,Herbst; Matthew,13,0,16,3
1713493545237,MMW 13R,A01,514037,Staff,0,6,16,16
1713493545237,MMW 13R,A02,514039,Staff,0,4,16,16
1713493547290,SIO 295LS,A00,523233,Staff,15,0,30,15
1713493548315,SIO 295S,A00,523232,Staff,15,0,30,15
1713493549344,SOCI 117,A01,494376,Staff,0,2,5,5
1713493550369,WES 237B,A00,494380,Staff,19,0,20,1
1713493552435,AESE 279B,A00,494370,Wade; Jon P,33,0,33,0
1713493553460,AIP 197,001,627712,Vespa; Emanuel Ignacio,9999,0,9999,0
1713493554486,ANAR 135S,A00,494369,Braswell; Geoffrey E.,0,0,0,0
1713493555512,CAT 124RS,A01,519847,Geibel; William,6,0,20,14
1713493556540,CAT 125RS,A01,515971,Geibel; William,6,0,20,14
1713493557569,CLRE 250,A00,511389,Morris; Sheldon,9996,0,9999,3
1713493558595,CLRE 251,A00,507176,Mehta; Ravindra L.,9996,0,9999,3
1713493558595,CLRE 251,B00,511410,Mehta; Ravindra L.,9998,0,9999,1
1713493559621,CLRE 252,A00,507189,Cuomo; Raphael Eduardo,9998,0,9999,1
1713493560647,CLRE 253,A00,507199,Vaida; Florin,9997,0,9999,2
1713493560647,CLRE 253,B00,507202,Vaida; Florin,9999,0,9999,0
1713493561675,CLRE 259,A00,507211,Patel; Hemal,9996,0,9999,3
1713493562700,CLRE 260,A00,507221,Cuomo; Raphael Eduardo,9999,0,9999,0
1713493563725,CLRE 297,001,507242,Cuomo; Raphael Eduardo,9999,0,9999,0
1713493564750,CSE 191,A00,516875,Minnes Kemp; Mor Mia,9999,0,9999,0
1713493565776,CSS 201S,A01,494383,Staff,35,0,35,0
1713493566806,CSS 202S,A01,494387,Staff,35,0,35,0
1713493567832,EAP 100,A00,516065,Staff,9792,0,9999,207
1713493568863,ECE 45,A01,507414,Staff,38,0,60,22
1713493569891,ECE 100,A01,507416,Baghdadchi; Saharnaz,0,0,20,20
1713493569891,ECE 100,A02,507418,Baghdadchi; Saharnaz,19,0,20,1
1713493570920,ECE 111,A01,507420,Staff,27,0,50,23
1713493571945,ECE 197,001,548057,Sievenpiper; Daniel F.,9998,0,9999,1
1713493572974,EDS 115,A00,507243,Choi; Bailey Miyeon,27,0,28,1
1713493573999,EDS 117,A01,494379,Staff,15,0,25,10
1713493575026,EDS 125,A00,507246,Hopkins; Megan Beth,27,0,30,3
1713493576051,EDS 128A,A01,507264,Fargason; Sharon Gayle,26,0,26,0
1713493577080,EDS 128B,A01,507293,Pappas; Elizabeth,30,0,30,0
1713493578108,EDS 139,A00,507294,Fargason; Sharon Gayle,30,0,30,0
1713493578108,EDS 139,B00,507313,Pappas; Elizabeth,30,0,30,0
1713493579133,EDS 201,A00,507315,Staff,18,0,30,12
1713493580163,EDS 203,A01,507317,Halter; Christopher P.,17,0,30,13
1713493581189,EDS 204R,A01,507319,Halter; Christopher P.,0,1,30,30
1713493581189,EDS 204R,B01,507331,Heinzman; Erica M.,22,0,30,8
1713493582213,EDS 206R,A00,507332,Staff,0,2,30,30
1713493582213,EDS 206R,B00,507343,Staff,23,0,30,7
1713493583239,EDS 250,A00,507344,Hemans; Patricia Ann Benitez,27,0,40,13
1713493584266,EDS 281,A00,507345,Daly; Alan J.,18,0,18,0
1713493585290,EDS 284,A00,507350,Daly; Alan J.,16,0,16,0
1713493586319,EDS 286,A00,507359,Fine; Sarah,18,0,18,0
1713493587343,EDS 289C,A01,507361,Daly; Alan J.,18,0,18,0
1713493588370,EDS 290,A00,507366,Hofstetter; Carolyn,15,0,15,0
1713493589404,LIGM 5A,A00,507421,Fischer-Grunski; Eva K,20,0,20,0
1713493590429,LIGM 5B,A00,507423,Fischer-Grunski; Eva K,20,0,20,0
1713493591463,LIGM 5C,A00,507425,Fischer-Grunski; Eva K,20,0,20,0
1713493592494,LIIT 5AS,A00,507427,Carnelos; Chiara,20,0,20,0
1713493593518,LIIT 5BS,A00,507430,Carnelos; Chiara,20,0,20,0
1713493594545,LIIT 5CS,A00,507432,Carnelos; Chiara,20,0,20,0
1713493595573,LISP 5A,A00,507541,Munoz Sanchez; Alicia,14,0,20,6
1713493596597,LISP 5B,A00,507671,Munoz Sanchez; Alicia,12,0,20,8
1713493597621,LISP 5C,A00,507696,Munoz Sanchez; Alicia,11,0,20,9
1713493598648,MAE 197,001,528363,Boechler; Nicholas Sebastia,9998,0,9999,1
1713493599677,MATH 197,001,523477,Kedlaya; Kiran S.,9999,0,9999,0
1713493599677,MATH 197,002,563811,Zhang; Danna,9998,0,9999,1
1713493600701,MCWP 40R,A00,518780,Staff,15,0,20,5
1713493600701,MCWP 40R,B00,518781,Staff,13,0,20,7
1713493600701,MCWP 40R,C00,518783,Staff,9,0,20,11
1713493601732,MCWP 50R,A00,518791,Staff,7,0,20,13
1713493601732,MCWP 50R,B00,518792,Staff,3,0,20,17
1713493601732,MCWP 50R,C00,518793,Staff,7,0,20,13
1713493601732,MCWP 50R,D00,518794,Staff,0,0,20,20
1713493601732,MCWP 50R,E00,518795,Staff,0,0,20,20
1713493601732,MCWP 50R,F00,518796,Staff,11,0,20,9
1713493601732,MCWP 50R,G00,518797,Staff,11,0,20,9
1713493602761,MMW 12R,A01,514034,Herbst; Matthew,5,0,16,11
1713493602761,MMW 12R,A02,514035,Herbst; Matthew,13,0,16,3
1713493603843,MMW 13R,A01,514037,Staff,0,6,16,16
1713493603843,MMW 13R,A02,514039,Staff,0,4,16,16
1713493605893,SIO 295LS,A00,523233,Staff,15,0,30,15
1713493606918,SIO 295S,A00,523232,Staff,15,0,30,15
1713493607942,SOCI 117,A01,494376,Staff,0,2,5,5
1713493608967,WES 237B,A00,494380,Staff,19,0,20,1
1713493611026,AESE 279B,A00,494370,Wade; Jon P,33,0,33,0
1713493612051,AIP 197,001,627712,Vespa; Emanuel Ignacio,9999,0,9999,0
1713493613077,ANAR 135S,A00,494369,Braswell; Geoffrey E.,0,0,0,0
1713493614103,CAT 124RS,A01,519847,Geibel; William,6,0,20,14
1713493615127,CAT 125RS,A01,515971,Geibel; William,6,0,20,14
1713493616156,CLRE 250,A00,511389,Morris; Sheldon,9996,0,9999,3
1713493617184,CLRE 251,A00,507176,Mehta; Ravindra L.,9996,0,9999,3
1713493617184,CLRE 251,B00,511410,Mehta; Ravindra L.,9998,0,9999,1
1713493618210,CLRE 252,A00,507189,Cuomo; Raphael Eduardo,9998,0,9999,1
1713493619236,CLRE 253,A00,507199,Vaida; Florin,9997,0,9999,2
1713493619236,CLRE 253,B00,507202,Vaida; Florin,9999,0,9999,0
1713493620262,CLRE 259,A00,507211,Patel; Hemal,9996,0,9999,3
1713493621289,CLRE 260,A00,507221,Cuomo; Raphael Eduardo,9999,0,9999,0
1713493622314,CLRE 297,001,507242,Cuomo; Raphael Eduardo,9999,0,9999,0
1713493623341,CSE 191,A00,516875,Minnes Kemp; Mor Mia,9999,0,9999,0
1713493624367,CSS 201S,A01,494383,Staff,35,0,35,0
1713493625398,CSS 202S,A01,494387,Staff,35,0,35,0
1713493626444,EAP 100,A00,516065,Staff,9792,0,9999,207
1713493627469,ECE 45,A01,507414,Staff,38,0,60,22
1713493628495,ECE 100,A01,507416,Baghdadchi; Saharnaz,0,0,20,20
1713493628495,ECE 100,A02,507418,Baghdadchi; Saharnaz,19,0,20,1
1713493629521,ECE 111,A01,507420,Staff,27,0,50,23
1713493630546,ECE 197,001,548057,Sievenpiper; Daniel F.,9998,0,9999,1
1713493631573,EDS 115,A00,507243,Choi; Bailey Miyeon,27,0,28,1
1713493632598,EDS 117,A01,494379,Staff,15,0,25,10
1713493633628,EDS 125,A00,507246,Hopkins; Megan Beth,27,0,30,3
1713493634654,EDS 128A,A01,507264,Fargason; Sharon Gayle,26,0,26,0
1713493635678,EDS 128B,A01,507293,Pappas; Elizabeth,30,0,30,0
1713493636702,EDS 139,A00,507294,Fargason; Sharon Gayle,30,0,30,0
1713493636702,EDS 139,B00,507313,Pappas; Elizabeth,30,0,30,0
1713493637730,EDS 201,A00,507315,Staff,18,0,30,12
1713493638759,EDS 203,A01,507317,Halter; Christopher P.,17,0,30,13
1713493639784,EDS 204R,A01,507319,Halter; Christopher P.,0,1,30,30
1713493639784,EDS 204R,B01,507331,Heinzman; Erica M.,22,0,30,8
1713493640808,EDS 206R,A00,507332,Staff,0,2,30,30
1713493640808,EDS 206R,B00,507343,Staff,23,0,30,7
1713493641833,EDS 250,A00,507344,Hemans; Patricia Ann Benitez,27,0,40,13
1713493642860,EDS 281,A00,507345,Daly; Alan J.,18,0,18,0
1713493643884,EDS 284,A00,507350,Daly; Alan J.,16,0,16,0
1713493644913,EDS 286,A00,507359,Fine; Sarah,18,0,18,0
1713493645939,EDS 289C,A01,507361,Daly; Alan J.,18,0,18,0
1713493646968,EDS 290,A00,507366,Hofstetter; Carolyn,15,0,15,0
1713493647994,LIGM 5A,A00,507421,Fischer-Grunski; Eva K,20,0,20,0
1713493649019,LIGM 5B,A00,507423,Fischer-Grunski; Eva K,20,0,20,0
1713493650049,LIGM 5C,A00,507425,Fischer-Grunski; Eva K,20,0,20,0
1713493651078,LIIT 5AS,A00,507427,Carnelos; Chiara,20,0,20,0
1713493652126,LIIT 5BS,A00,507430,Carnelos; Chiara,20,0,20,0
1713493653155,LIIT 5CS,A00,507432,Carnelos; Chiara,20,0,20,0
1713493654182,LISP 5A,A00,507541,Munoz Sanchez; Alicia,14,0,20,6
1713493655207,LISP 5B,A00,507671,Munoz Sanchez; Alicia,12,0,20,8
1713493656234,LISP 5C,A00,507696,Munoz Sanchez; Alicia,11,0,20,9
1713493657264,MAE 197,001,528363,Boechler; Nicholas Sebastia,9998,0,9999,1
1713493658312,MATH 197,001,523477,Kedlaya; Kiran S.,9999,0,9999,0
1713493658312,MATH 197,002,563811,Zhang; Danna,9998,0,9999,1
1713493659340,MCWP 40R,A00,518780,Staff,15,0,20,5
1713493659340,MCWP 40R,B00,518781,Staff,13,0,20,7
1713493659340,MCWP 40R,C00,518783,Staff,9,0,20,11
1713493660370,MCWP 50R,A00,518791,Staff,7,0,20,13
1713493660370,MCWP 50R,B00,518792,Staff,3,0,20,17
1713493660370,MCWP 50R,C00,518793,Staff,7,0,20,13
1713493660370,MCWP 50R,D00,518794,Staff,0,0,20,20
1713493660370,MCWP 50R,E00,518795,Staff,0,0,20,20
1713493660370,MCWP 50R,F00,518796,Staff,11,0,20,9
1713493660370,MCWP 50R,G00,518797,Staff,10,0,20,10
1713493661397,MMW 12R,A01,514034,Herbst; Matthew,5,0,16,11
1713493661397,MMW 12R,A02,514035,Herbst; Matthew,13,0,16,3
1713493662425,MMW 13R,A01,514037,Staff,0,6,16,16
1713493662425,MMW 13R,A02,514039,Staff,0,4,16,16
1713493664478,SIO 295LS,A00,523233,Staff,15,0,30,15
1713493665503,SIO 295S,A00,523232,Staff,15,0,30,15
1713493666529,SOCI 117,A01,494376,Staff,0,2,5,5
1713493667555,WES 237B,A00,494380,Staff,19,0,20,1
1713493669630,AESE 279B,A00,494370,Wade; Jon P,33,0,33,0
1713493670655,AIP 197,001,627712,Vespa; Emanuel Ignacio,9999,0,9999,0
1713493671681,ANAR 135S,A00,494369,Braswell; Geoffrey E.,0,0,0,0
1713493672709,CAT 124RS,A01,519847,Geibel; William,6,0,20,14
1713493673735,CAT 125RS,A01,515971,Geibel; William,6,0,20,14
1713493674761,CLRE 250,A00,511389,Morris; Sheldon,9996,0,9999,3
1713493675788,CLRE 251,A00,507176,Mehta; Ravindra L.,9996,0,9999,3
1713493675788,CLRE 251,B00,511410,Mehta; Ravindra L.,9998,0,9999,1
1713493676814,CLRE 252,A00,507189,Cuomo; Raphael Eduardo,9998,0,9999,1
1713493677840,CLRE 253,A00,507199,Vaida; Florin,9997,0,9999,2
1713493677840,CLRE 253,B00,507202,Vaida; Florin,9999,0,9999,0
1713493678866,CLRE 259,A00,507211,Patel; Hemal,9996,0,9999,3
1713493679890,CLRE 260,A00,507221,Cuomo; Raphael Eduardo,9999,0,9999,0
1713493680919,CLRE 297,001,507242,Cuomo; Raphael Eduardo,9999,0,9999,0
1713493681949,CSE 191,A00,516875,Minnes Kemp; Mor Mia,9999,0,9999,0
1713493682980,CSS 201S,A01,494383,Staff,35,0,35,0
1713493684003,CSS 202S,A01,494387,Staff,35,0,35,0
1713493685028,EAP 100,A00,516065,Staff,9792,0,9999,207
1713493686053,ECE 45,A01,507414,Staff,38,0,60,22
1713493687080,ECE 100,A01,507416,Baghdadchi; Saharnaz,0,0,20,20
1713493687080,ECE 100,A02,507418,Baghdadchi; Saharnaz,19,0,20,1
1713493688106,ECE 111,A01,507420,Staff,27,0,50,23
1713493689136,ECE 197,001,548057,Sievenpiper; Daniel F.,9998,0,9999,1
1713493690165,EDS 115,A00,507243,Choi; Bailey Miyeon,27,0,28,1
1713493691191,EDS 117,A01,494379,Staff,15,0,25,10
1713493692222,EDS 125,A00,507246,Hopkins; Megan Beth,27,0,30,3
1713493693248,EDS 128A,A01,507264,Fargason; Sharon Gayle,26,0,26,0
1713493694279,EDS 128B,A01,507293,Pappas; Elizabeth,30,0,30,0
1713493695305,EDS 139,A00,507294,Fargason; Sharon Gayle,30,0,30,0
1713493695305,EDS 139,B00,507313,Pappas; Elizabeth,30,0,30,0
1713493696331,EDS 201,A00,507315,Staff,18,0,30,12
1713493697357,EDS 203,A01,507317,Halter; Christopher P.,17,0,30,13
1713493698383,EDS 204R,A01,507319,Halter; Christopher P.,0,1,30,30
1713493698383,EDS 204R,B01,507331,Heinzman; Erica M.,22,0,30,8
1713493699409,EDS 206R,A00,507332,Staff,0,2,30,30
1713493699409,EDS 206R,B00,507343,Staff,23,0,30,7
1713493700434,EDS 250,A00,507344,Hemans; Patricia Ann Benitez,27,0,40,13
1713493701462,EDS 281,A00,507345,Daly; Alan J.,18,0,18,0
1713493702487,EDS 284,A00,507350,Daly; Alan J.,16,0,16,0
1713493703512,EDS 286,A00,507359,Fine; Sarah,18,0,18,0
1713493704537,EDS 289C,A01,507361,Daly; Alan J.,18,0,18,0
1713493705566,EDS 290,A00,507366,Hofstetter; Carolyn,15,0,15,0
1713493706592,LIGM 5A,A00,507421,Fischer-Grunski; Eva K,20,0,20,0
1713493707672,LIGM 5B,A00,507423,Fischer-Grunski; Eva K,20,0,20,0
1713493708698,LIGM 5C,A00,507425,Fischer-Grunski; Eva K,20,0,20,0
1713493709728,LIIT 5AS,A00,507427,Carnelos; Chiara,20,0,20,0
1713493710757,LIIT 5BS,A00,507430,Carnelos; Chiara,20,0,20,0
1713493711781,LIIT 5CS,A00,507432,Carnelos; Chiara,20,0,20,0
1713493712808,LISP 5A,A00,507541,Munoz Sanchez; Alicia,14,0,20,6
1713493713834,LISP 5B,A00,507671,Munoz Sanchez; Alicia,12,0,20,8
1713493714861,LISP 5C,A00,507696,Munoz Sanchez; Alicia,11,0,20,9
1713493715886,MAE 197,001,528363,Boechler; Nicholas Sebastia,9998,0,9999,1
1713493716914,MATH 197,001,523477,Kedlaya; Kiran S.,9999,0,9999,0
1713493716914,MATH 197,002,563811,Zhang; Danna,9998,0,9999,1
1713493717941,MCWP 40R,A00,518780,Staff,15,0,20,5
1713493717941,MCWP 40R,B00,518781,Staff,13,0,20,7
1713493717941,MCWP 40R,C00,518783,Staff,9,0,20,11
1713493718970,MCWP 50R,A00,518791,Staff,7,0,20,13
1713493718970,MCWP 50R,B00,518792,Staff,3,0,20,17
1713493718970,MCWP 50R,C00,518793,Staff,7,0,20,13
1713493718970,MCWP 50R,D00,518794,Staff,0,0,20,20
1713493718970,MCWP 50R,E00,518795,Staff,0,0,20,20
1713493718970,MCWP 50R,F00,518796,Staff,11,0,20,9
1713493718970,MCWP 50R,G00,518797,Staff,10,0,20,10
1713493719997,MMW 12R,A01,514034,Herbst; Matthew,5,0,16,11
1713493719997,MMW 12R,A02,514035,Herbst; Matthew,13,0,16,3
1713493721025,MMW 13R,A01,514037,Staff,0,6,16,16
1713493721025,MMW 13R,A02,514039,Staff,0,4,16,16
1713493723079,SIO 295LS,A00,523233,Staff,15,0,30,15
1713493724104,SIO 295S,A00,523232,Staff,15,0,30,15
1713493725128,SOCI 117,A01,494376,Staff,0,2,5,5
1713493726157,WES 237B,A00,494380,Staff,19,0,20,1
1713493728226,AESE 279B,A00,494370,Wade; Jon P,33,0,33,0
1713493729252,AIP 197,001,627712,Vespa; Emanuel Ignacio,9999,0,9999,0
1713493730276,ANAR 135S,A00,494369,Braswell; Geoffrey E.,0,0,0,0
1713493731301,CAT 124RS,A01,519847,Geibel; William,6,0,20,14
1713493732326,CAT 125RS,A01,515971,Geibel; William,6,0,20,14
1713493733353,CLRE 250,A00,511389,Morris; Sheldon,9996,0,9999,3
1713493734379,CLRE 251,A00,507176,Mehta; Ravindra L.,9996,0,9999,3
1713493734379,CLRE 251,B00,511410,Mehta; Ravindra L.,9998,0,9999,1
1713493735405,CLRE 252,A00,507189,Cuomo; Raphael Eduardo,9998,0,9999,1
1713493736437,CLRE 253,A00,507199,Vaida; Florin,9997,0,9999,2
1713493736437,CLRE 253,B00,507202,Vaida; Florin,9999,0,9999,0
1713493737462,CLRE 259,A00,507211,Patel; Hemal,9996,0,9999,3
1713493738488,CLRE 260,A00,507221,Cuomo; Raphael Eduardo,9999,0,9999,0
1713493739516,CLRE 297,001,507242,Cuomo; Raphael Eduardo,9999,0,9999,0
1713493740542,CSE 191,A00,516875,Minnes Kemp; Mor Mia,9999,0,9999,0
1713493741569,CSS 201S,A01,494383,Staff,35,0,35,0
1713493742595,CSS 202S,A01,494387,Staff,35,0,35,0
1713493743623,EAP 100,A00,516065,Staff,9792,0,9999,207
1713493744647,ECE 45,A01,507414,Staff,38,0,60,22
1713493745679,ECE 100,A01,507416,Baghdadchi; Saharnaz,0,0,20,20
1713493745679,ECE 100,A02,507418,Baghdadchi; Saharnaz,19,0,20,1
1713493746705,ECE 111,A01,507420,Staff,27,0,50,23
1713493747735,ECE 197,001,548057,Sievenpiper; Daniel F.,9998,0,9999,1
1713493748760,EDS 115,A00,507243,Choi; Bailey Miyeon,27,0,28,1
1713493749788,EDS 117,A01,494379,Staff,15,0,25,10
1713493750813,EDS 125,A00,507246,Hopkins; Megan Beth,27,0,30,3
1713493751838,EDS 128A,A01,507264,Fargason; Sharon Gayle,26,0,26,0
1713493752864,EDS 128B,A01,507293,Pappas; Elizabeth,30,0,30,0
1713493753893,EDS 139,A00,507294,Fargason; Sharon Gayle,30,0,30,0
1713493753893,EDS 139,B00,507313,Pappas; Elizabeth,30,0,30,0
1713493754920,EDS 201,A00,507315,Staff,18,0,30,12
1713493755948,EDS 203,A01,507317,Halter; Christopher P.,17,0,30,13
1713493756974,EDS 204R,A01,507319,Halter; Christopher P.,0,1,30,30
1713493756974,EDS 204R,B01,507331,Heinzman; Erica M.,22,0,30,8
1713493758004,EDS 206R,A00,507332,Staff,0,2,30,30
1713493758004,EDS 206R,B00,507343,Staff,23,0,30,7
1713493759032,EDS 250,A00,507344,Hemans; Patricia Ann Benitez,27,0,40,13
1713493760059,EDS 281,A00,507345,Daly; Alan J.,18,0,18,0
1713493761086,EDS 284,A00,507350,Daly; Alan J.,16,0,16,0
1713493762113,EDS 286,A00,507359,Fine; Sarah,18,0,18,0
1713493763138,EDS 289C,A01,507361,Daly; Alan J.,18,0,18,0
1713493764168,EDS 290,A00,507366,Hofstetter; Carolyn,15,0,15,0
1713493765196,LIGM 5A,A00,507421,Fischer-Grunski; Eva K,20,0,20,0
1713493766221,LIGM 5B,A00,507423,Fischer-Grunski; Eva K,20,0,20,0
1713493767250,LIGM 5C,A00,507425,Fischer-Grunski; Eva K,20,0,20,0
1713493768276,LIIT 5AS,A00,507427,Carnelos; Chiara,20,0,20,0
1713493769304,LIIT 5BS,A00,507430,Carnelos; Chiara,20,0,20,0
1713493770330,LIIT 5CS,A00,507432,Carnelos; Chiara,20,0,20,0
1713493771355,LISP 5A,A00,507541,Munoz Sanchez; Alicia,14,0,20,6
1713493772383,LISP 5B,A00,507671,Munoz Sanchez; Alicia,12,0,20,8
1713493773407,LISP 5C,A00,507696,Munoz Sanchez; Alicia,11,0,20,9
1713493774434,MAE 197,001,528363,Boechler; Nicholas Sebastia,9998,0,9999,1
1713493775459,MATH 197,001,523477,Kedlaya; Kiran S.,9999,0,9999,0
1713493775459,MATH 197,002,563811,Zhang; Danna,9998,0,9999,1
1713493776486,MCWP 40R,A00,518780,Staff,15,0,20,5
1713493776486,MCWP 40R,B00,518781,Staff,13,0,20,7
1713493776486,MCWP 40R,C00,518783,Staff,9,0,20,11
1713493777514,MCWP 50R,A00,518791,Staff,7,0,20,13
1713493777514,MCWP 50R,B00,518792,Staff,3,0,20,17
1713493777514,MCWP 50R,C00,518793,Staff,7,0,20,13
1713493777514,MCWP 50R,D00,518794,Staff,0,0,20,20
1713493777514,MCWP 50R,E00,518795,Staff,0,0,20,20
1713493777514,MCWP 50R,F00,518796,Staff,11,0,20,9
1713493777514,MCWP 50R,G00,518797,Staff,10,0,20,10
1713493778541,MMW 12R,A01,514034,Herbst; Matthew,5,0,16,11
1713493778541,MMW 12R,A02,514035,Herbst; Matthew,13,0,16,3
1713493779567,MMW 13R,A01,514037,Staff,0,6,16,16
1713493779567,MMW 13R,A02,514039,Staff,0,4,16,16
1713493781620,SIO 295LS,A00,523233,Staff,15,0,30,15
1713493782645,SIO 295S,A00,523232,Staff,15,0,30,15
1713493783672,SOCI 117,A01,494376,Staff,0,2,5,5
1713493784697,WES 237B,A00,494380,Staff,19,0,20,1
1713493786770,AESE 279B,A00,494370,Wade; Jon P,33,0,33,0
1713493787795,AIP 197,001,627712,Vespa; Emanuel Ignacio,9999,0,9999,0
1713493788821,ANAR 135S,A00,494369,Braswell; Geoffrey E.,0,0,0,0
1713493789847,CAT 124RS,A01,519847,Geibel; William,6,0,20,14
1713493790873,CAT 125RS,A01,515971,Geibel; William,6,0,20,14
1713493791899,CLRE 250,A00,511389,Morris; Sheldon,9996,0,9999,3
1713493792927,CLRE 251,A00,507176,Mehta; Ravindra L.,9996,0,9999,3
1713493792927,CLRE 251,B00,511410,Mehta; Ravindra L.,9998,0,9999,1
1713493793957,CLRE 252,A00,507189,Cuomo; Raphael Eduardo,9998,0,9999,1
1713493794983,CLRE 253,A00,507199,Vaida; Florin,9997,0,9999,2
1713493794983,CLRE 253,B00,507202,Vaida; Florin,9999,0,9999,0
1713493796011,CLRE 259,A00,507211,Patel; Hemal,9996,0,9999,3
1713493797036,CLRE 260,A00,507221,Cuomo; Raphael Eduardo,9999,0,9999,0
1713493798065,CLRE 297,001,507242,Cuomo; Raphael Eduardo,9999,0,9999,0
1713493799091,CSE 191,A00,516875,Minnes Kemp; Mor Mia,9999,0,9999,0
1713493800117,CSS 201S,A01,494383,Staff,35,0,35,0
1713493801142,CSS 202S,A01,494387,Staff,35,0,35,0
1713493802168,EAP 100,A00,516065,Staff,9792,0,9999,207
1713493803199,ECE 45,A01,507414,Staff,38,0,60,22
1713493804228,ECE 100,A01,507416,Baghdadchi; Saharnaz,0,0,20,20
1713493804228,ECE 100,A02,507418,Baghdadchi; Saharnaz,19,0,20,1
1713493805255,ECE 111,A01,507420,Staff,27,0,50,23
1713493806285,ECE 197,001,548057,Sievenpiper; Daniel F.,9998,0,9999,1
1713493807310,EDS 115,A00,507243,Choi; Bailey Miyeon,27,0,28,1
1713493808339,EDS 117,A01,494379,Staff,15,0,25,10
1713493809366,EDS 125,A00,507246,Hopkins; Megan Beth,27,0,30,3
1713493810392,EDS 128A,A01,507264,Fargason; Sharon Gayle,26,0,26,0
1713493811472,EDS 128B,A01,507293,Pappas; Elizabeth,30,0,30,0
1713493812497,EDS 139,A00,507294,Fargason; Sharon Gayle,30,0,30,0
1713493812497,EDS 139,B00,507313,Pappas; Elizabeth,30,0,30,0
1713493813521,EDS 201,A00,507315,Staff,18,0,30,12
1713493814547,EDS 203,A01,507317,Halter; Christopher P.,17,0,30,13
1713493815573,EDS 204R,A01,507319,Halter; Christopher P.,0,1,30,30
1713493815573,EDS 204R,B01,507331,Heinzman; Erica M.,22,0,30,8
1713493816597,EDS 206R,A00,507332,Staff,0,2,30,30
1713493816597,EDS 206R,B00,507343,Staff,23,0,30,7
1713493817622,EDS 250,A00,507344,Hemans; Patricia Ann Benitez,27,0,40,13
1713493818650,EDS 281,A00,507345,Daly; Alan J.,18,0,18,0
1713493819673,EDS 284,A00,507350,Daly; Alan J.,16,0,16,0
1713493820704,EDS 286,A00,507359,Fine; Sarah,18,0,18,0
1713493821728,EDS 289C,A01,507361,Daly; Alan J.,18,0,18,0
1713493822757,EDS 290,A00,507366,Hofstetter; Carolyn,15,0,15,0
1713493823782,LIGM 5A,A00,507421,Fischer-Grunski; Eva K,20,0,20,0
1713493824807,LIGM 5B,A00,507423,Fischer-Grunski; Eva K,20,0,20,0
1713493825837,LIGM 5C,A00,507425,Fischer-Grunski; Eva K,20,0,20,0
1713493826861,LIIT 5AS,A00,507427,Carnelos; Chiara,20,0,20,0
1713493827889,LIIT 5BS,A00,507430,Carnelos; Chiara,20,0,20,0
1713493828913,LIIT 5CS,A00,507432,Carnelos; Chiara,20,0,20,0
1713493829939,LISP 5A,A00,507541,Munoz Sanchez; Alicia,14,0,20,6
1713493830968,LISP 5B,A00,507671,Munoz Sanchez; Alicia,12,0,20,8
1713493831997,LISP 5C,A00,507696,Munoz Sanchez; Alicia,11,0,20,9
1713493833025,MAE 197,001,528363,Boechler; Nicholas Sebastia,9998,0,9999,1
1713493834085,MATH 197,001,523477,Kedlaya; Kiran S.,9999,0,9999,0
1713493834085,MATH 197,002,563811,Zhang; Danna,9998,0,9999,1
1713493835111,MCWP 40R,A00,518780,Staff,15,0,20,5
1713493835111,MCWP 40R,B00,518781,Staff,13,0,20,7
1713493835111,MCWP 40R,C00,518783,Staff,9,0,20,11
1713493836137,MCWP 50R,A00,518791,Staff,7,0,20,13
1713493836137,MCWP 50R,B00,518792,Staff,3,0,20,17
1713493836137,MCWP 50R,C00,518793,Staff,7,0,20,13
1713493836137,MCWP 50R,D00,518794,Staff,0,0,20,20
1713493836137,MCWP 50R,E00,518795,Staff,0,0,20,20
1713493836137,MCWP 50R,F00,518796,Staff,11,0,20,9
1713493836137,MCWP 50R,G00,518797,Staff,10,0,20,10
1713493837162,MMW 12R,A01,514034,Herbst; Matthew,5,0,16,11
1713493837162,MMW 12R,A02,514035,Herbst; Matthew,13,0,16,3
1713493838190,MMW 13R,A01,514037,Staff,0,6,16,16
1713493838190,MMW 13R,A02,514039,Staff,0,4,16,16
1713493840241,SIO 295LS,A00,523233,Staff,15,0,30,15
1713493841266,SIO 295S,A00,523232,Staff,15,0,30,15
1713493842293,SOCI 117,A01,494376,Staff,0,2,5,5
1713493843322,WES 237B,A00,494380,Staff,19,0,20,1
1713493845397,AESE 279B,A00,494370,Wade; Jon P,33,0,33,0
1713493846426,AIP 197,001,627712,Vespa; Emanuel Ignacio,9999,0,9999,0
1713493847451,ANAR 135S,A00,494369,Braswell; Geoffrey E.,0,0,0,0
1713493848480,CAT 124RS,A01,519847,Geibel; William,6,0,20,14
1713493849506,CAT 125RS,A01,515971,Geibel; William,6,0,20,14
1713493850532,CLRE 250,A00,511389,Morris; Sheldon,9996,0,9999,3
1713493851564,CLRE 251,A00,507176,Mehta; Ravindra L.,9996,0,9999,3
1713493851564,CLRE 251,B00,511410,Mehta; Ravindra L.,9998,0,9999,1
1713493852590,CLRE 252,A00,507189,Cuomo; Raphael Eduardo,9998,0,9999,1
1713493853623,CLRE 253,A00,507199,Vaida; Florin,9997,0,9999,2
1713493853623,CLRE 253,B00,507202,Vaida; Florin,9999,0,9999,0
1713493854652,CLRE 259,A00,507211,Patel; Hemal,9996,0,9999,3
1713493855679,CLRE 260,A00,507221,Cuomo; Raphael Eduardo,9999,0,9999,0
1713493856706,CLRE 297,001,507242,Cuomo; Raphael Eduardo,9999,0,9999,0
1713493857734,CSE 191,A00,516875,Minnes Kemp; Mor Mia,9999,0,9999,0
1713493858759,CSS 201S,A01,494383,Staff,35,0,35,0
1713493859787,CSS 202S,A01,494387,Staff,35,0,35,0
1713493860814,EAP 100,A00,516065,Staff,9792,0,9999,207
1713493861839,ECE 45,A01,507414,Staff,38,0,60,22
1713493862865,ECE 100,A01,507416,Baghdadchi; Saharnaz,0,0,20,20
1713493862865,ECE 100,A02,507418,Baghdadchi; Saharnaz,19,0,20,1
1713493863894,ECE 111,A01,507420,Staff,27,0,50,23
1713493864919,ECE 197,001,548057,Sievenpiper; Daniel F.,9998,0,9999,1
1713493865949,EDS 115,A00,507243,Choi; Bailey Miyeon,27,0,28,1
1713493866977,EDS 117,A01,494379,Staff,15,0,25,10
1713493868007,EDS 125,A00,507246,Hopkins; Megan Beth,27,0,30,3
1713493869034,EDS 128A,A01,507264,Fargason; Sharon Gayle,26,0,26,0
1713493870065,EDS 128B,A01,507293,Pappas; Elizabeth,30,0,30,0
1713493871091,EDS 139,A00,507294,Fargason; Sharon Gayle,30,0,30,0
1713493871091,EDS 139,B00,507313,Pappas; Elizabeth,30,0,30,0
1713493872117,EDS 201,A00,507315,Staff,18,0,30,12
1713493873146,EDS 203,A01,507317,Halter; Christopher P.,17,0,30,13
1713493874177,EDS 204R,A01,507319,Halter; Christopher P.,0,1,30,30
1713493874177,EDS 204R,B01,507331,Heinzman; Erica M.,22,0,30,8
1713493875206,EDS 206R,A00,507332,Staff,0,2,30,30
1713493875206,EDS 206R,B00,507343,Staff,23,0,30,7
1713493876231,EDS 250,A00,507344,Hemans; Patricia Ann Benitez,27,0,40,13
1713493877256,EDS 281,A00,507345,Daly; Alan J.,18,0,18,0
1713493878284,EDS 284,A00,507350,Daly; Alan J.,16,0,16,0
1713493879313,EDS 286,A00,507359,Fine; Sarah,18,0,18,0
1713493880337,EDS 289C,A01,507361,Daly; Alan J.,18,0,18,0
1713493881363,EDS 290,A00,507366,Hofstetter; Carolyn,15,0,15,0
1713493882392,LIGM 5A,A00,507421,Fischer-Grunski; Eva K,20,0,20,0
1713493883416,LIGM 5B,A00,507423,Fischer-Grunski; Eva K,20,0,20,0
1713493884441,LIGM 5C,A00,507425,Fischer-Grunski; Eva K,20,0,20,0
1713493885468,LIIT 5AS,A00,507427,Carnelos; Chiara,20,0,20,0
1713493886493,LIIT 5BS,A00,507430,Carnelos; Chiara,20,0,20,0
1713493887532,LIIT 5CS,A00,507432,Carnelos; Chiara,20,0,20,0
1713493888562,LISP 5A,A00,507541,Munoz Sanchez; Alicia,14,0,20,6
1713493889591,LISP 5B,A00,507671,Munoz Sanchez; Alicia,12,0,20,8
1713493890620,LISP 5C,A00,507696,Munoz Sanchez; Alicia,11,0,20,9
1713493891644,MAE 197,001,528363,Boechler; Nicholas Sebastia,9998,0,9999,1
1713493892670,MATH 197,001,523477,Kedlaya; Kiran S.,9999,0,9999,0
1713493892670,MATH 197,002,563811,Zhang; Danna,9998,0,9999,1
1713493893696,MCWP 40R,A00,518780,Staff,15,0,20,5
1713493893696,MCWP 40R,B00,518781,Staff,13,0,20,7
1713493893696,MCWP 40R,C00,518783,Staff,9,0,20,11
1713493894720,MCWP 50R,A00,518791,Staff,7,0,20,13
1713493894720,MCWP 50R,B00,518792,Staff,3,0,20,17
1713493894720,MCWP 50R,C00,518793,Staff,7,0,20,13
1713493894720,MCWP 50R,D00,518794,Staff,0,0,20,20
1713493894720,MCWP 50R,E00,518795,Staff,0,0,20,20
1713493894720,MCWP 50R,F00,518796,Staff,11,0,20,9
1713493894720,MCWP 50R,G00,518797,Staff,10,0,20,10
1713493895749,MMW 12R,A01,514034,Herbst; Matthew,5,0,16,11
1713493895749,MMW 12R,A02,514035,Herbst; Matthew,13,0,16,3
1713493896775,MMW 13R,A01,514037,Staff,0,6,16,16
1713493896775,MMW 13R,A02,514039,Staff,0,4,16,16
1713493898828,SIO 295LS,A00,523233,Staff,15,0,30,15
1713493899854,SIO 295S,A00,523232,Staff,15,0,30,15
1713493900885,SOCI 117,A01,494376,Staff,0,2,5,5
1713493901912,WES 237B,A00,494380,Staff,19,0,20,1
1713493904053,AESE 279B,A00,494370,Wade; Jon P,33,0,33,0
1713493905082,AIP 197,001,627712,Vespa; Emanuel Ignacio,9999,0,9999,0
1713493906111,ANAR 135S,A00,494369,Braswell; Geoffrey E.,0,0,0,0
1713493907139,CAT 124RS,A01,519847,Geibel; William,6,0,20,14
1713493908165,CAT 125RS,A01,515971,Geibel; William,6,0,20,14
1713493909191,CLRE 250,A00,511389,Morris; Sheldon,9996,0,9999,3
1713493910217,CLRE 251,A00,507176,Mehta; Ravindra L.,9996,0,9999,3
1713493910217,CLRE 251,B00,511410,Mehta; Ravindra L.,9998,0,9999,1
1713493911247,CLRE 252,A00,507189,Cuomo; Raphael Eduardo,9998,0,9999,1
1713493912273,CLRE 253,A00,507199,Vaida; Florin,9997,0,9999,2
1713493912273,CLRE 253,B00,507202,Vaida; Florin,9999,0,9999,0
1713493913298,CLRE 259,A00,507211,Patel; Hemal,9996,0,9999,3
1713493914329,CLRE 260,A00,507221,Cuomo; Raphael Eduardo,9999,0,9999,0
1713493915406,CLRE 297,001,507242,Cuomo; Raphael Eduardo,9999,0,9999,0
1713493916432,CSE 191,A00,516875,Minnes Kemp; Mor Mia,9999,0,9999,0
1713493917457,CSS 201S,A01,494383,Staff,35,0,35,0
1713493918484,CSS 202S,A01,494387,Staff,35,0,35,0
1713493919510,EAP 100,A00,516065,Staff,9792,0,9999,207
1713493920541,ECE 45,A01,507414,Staff,38,0,60,22
1713493921567,ECE 100,A01,507416,Baghdadchi; Saharnaz,0,0,20,20
1713493921567,ECE 100,A02,507418,Baghdadchi; Saharnaz,19,0,20,1
1713493922592,ECE 111,A01,507420,Staff,27,0,50,23
1713493923620,ECE 197,001,548057,Sievenpiper; Daniel F.,9998,0,9999,1
1713493924650,EDS 115,A00,507243,Choi; Bailey Miyeon,27,0,28,1
1713493925675,EDS 117,A01,494379,Staff,15,0,25,10
1713493926702,EDS 125,A00,507246,Hopkins; Megan Beth,27,0,30,3
1713493927729,EDS 128A,A01,507264,Fargason; Sharon Gayle,26,0,26,0
1713493928754,EDS 128B,A01,507293,Pappas; Elizabeth,30,0,30,0
1713493929781,EDS 139,A00,507294,Fargason; Sharon Gayle,30,0,30,0
1713493929781,EDS 139,B00,507313,Pappas; Elizabeth,30,0,30,0
1713493930806,EDS 201,A00,507315,Staff,18,0,30,12
1713493931831,EDS 203,A01,507317,Halter; Christopher P.,17,0,30,13
1713493932858,EDS 204R,A01,507319,Halter; Christopher P.,0,1,30,30
1713493932858,EDS 204R,B01,507331,Heinzman; Erica M.,22,0,30,8
1713493933884,EDS 206R,A00,507332,Staff,0,2,30,30
1713493933884,EDS 206R,B00,507343,Staff,23,0,30,7
1713493934914,EDS 250,A00,507344,Hemans; Patricia Ann Benitez,27,0,40,13
1713493935940,EDS 281,A00,507345,Daly; Alan J.,18,0,18,0
1713493936969,EDS 284,A00,507350,Daly; Alan J.,16,0,16,0
1713493937998,EDS 286,A00,507359,Fine; Sarah,18,0,18,0
1713493939026,EDS 289C,A01,507361,Daly; Alan J.,18,0,18,0
1713493940054,EDS 290,A00,507366,Hofstetter; Carolyn,15,0,15,0
1713493941080,LIGM 5A,A00,507421,Fischer-Grunski; Eva K,20,0,20,0
1713493942110,LIGM 5B,A00,507423,Fischer-Grunski; Eva K,20,0,20,0
1713493943136,LIGM 5C,A00,507425,Fischer-Grunski; Eva K,20,0,20,0
1713493944166,LIIT 5AS,A00,507427,Carnelos; Chiara,20,0,20,0
1713493945190,LIIT 5BS,A00,507430,Carnelos; Chiara,20,0,20,0
1713493946217,LIIT 5CS,A00,507432,Carnelos; Chiara,20,0,20,0
1713493947244,LISP 5A,A00,507541,Munoz Sanchez; Alicia,14,0,20,6
1713493948268,LISP 5B,A00,507671,Munoz Sanchez; Alicia,12,0,20,8
1713493949294,LISP 5C,A00,507696,Munoz Sanchez; Alicia,11,0,20,9
1713493950318,MAE 197,001,528363,Boechler; Nicholas Sebastia,9998,0,9999,1
1713493951348,MATH 197,001,523477,Kedlaya; Kiran S.,9999,0,9999,0
1713493951348,MATH 197,002,563811,Zhang; Danna,9998,0,9999,1
1713493952374,MCWP 40R,A00,518780,Staff,15,0,20,5
1713493952374,MCWP 40R,B00,518781,Staff,13,0,20,7
1713493952374,MCWP 40R,C00,518783,Staff,9,0,20,11
1713493953400,MCWP 50R,A00,518791,Staff,7,0,20,13
1713493953400,MCWP 50R,B00,518792,Staff,3,0,20,17
1713493953400,MCWP 50R,C00,518793,Staff,7,0,20,13
1713493953400,MCWP 50R,D00,518794,Staff,0,0,20,20
1713493953400,MCWP 50R,E00,518795,Staff,0,0,20,20
1713493953400,MCWP 50R,F00,518796,Staff,11,0,20,9
1713493953400,MCWP 50R,G00,518797,Staff,10,0,20,10
1713493954424,MMW 12R,A01,514034,Herbst; Matthew,5,0,16,11
1713493954424,MMW 12R,A02,514035,Herbst; Matthew,13,0,16,3
1713493955449,MMW 13R,A01,514037,Staff,0,6,16,16
1713493955449,MMW 13R,A02,514039,Staff,0,4,16,16
1713493957505,SIO 295LS,A00,523233,Staff,15,0,30,15
1713493958533,SIO 295S,A00,523232,Staff,15,0,30,15
1713493959558,SOCI 117,A01,494376,Staff,0,2,5,5
1713493960583,WES 237B,A00,494380,Staff,19,0,20,1
1713493962656,AESE 279B,A00,494370,Wade; Jon P,33,0,33,0
1713493963682,AIP 197,001,627712,Vespa; Emanuel Ignacio,9999,0,9999,0
1713493964708,ANAR 135S,A00,494369,Braswell; Geoffrey E.,0,0,0,0
1713493965738,CAT 124RS,A01,519847,Geibel; William,6,0,20,14
1713493966767,CAT 125RS,A01,515971,Geibel; William,6,0,20,14
1713493967798,CLRE 250,A00,511389,Morris; Sheldon,9996,0,9999,3
1713493968828,CLRE 251,A00,507176,Mehta; Ravindra L.,9996,0,9999,3
1713493968828,CLRE 251,B00,511410,Mehta; Ravindra L.,9998,0,9999,1
1713493969857,CLRE 252,A00,507189,Cuomo; Raphael Eduardo,9998,0,9999,1
1713493970883,CLRE 253,A00,507199,Vaida; Florin,9997,0,9999,2
1713493970883,CLRE 253,B00,507202,Vaida; Florin,9999,0,9999,0
1713493971910,CLRE 259,A00,507211,Patel; Hemal,9996,0,9999,3
1713493972934,CLRE 260,A00,507221,Cuomo; Raphael Eduardo,9999,0,9999,0
1713493973959,CLRE 297,001,507242,Cuomo; Raphael Eduardo,9999,0,9999,0
1713493974985,CSE 191,A00,516875,Minnes Kemp; Mor Mia,9999,0,9999,0
1713493976015,CSS 201S,A01,494383,Staff,35,0,35,0
1713493977042,CSS 202S,A01,494387,Staff,35,0,35,0
1713493978069,EAP 100,A00,516065,Staff,9792,0,9999,207
1713493979096,ECE 45,A01,507414,Staff,38,0,60,22
1713493980123,ECE 100,A01,507416,Baghdadchi; Saharnaz,0,0,20,20
1713493980123,ECE 100,A02,507418,Baghdadchi; Saharnaz,19,0,20,1
1713493981148,ECE 111,A01,507420,Staff,27,0,50,23
1713493982174,ECE 197,001,548057,Sievenpiper; Daniel F.,9998,0,9999,1
1713493983201,EDS 115,A00,507243,Choi; Bailey Miyeon,27,0,28,1
1713493984226,EDS 117,A01,494379,Staff,15,0,25,10
1713493985255,EDS 125,A00,507246,Hopkins; Megan Beth,27,0,30,3
1713493986280,EDS 128A,A01,507264,Fargason; Sharon Gayle,26,0,26,0
1713493987305,EDS 128B,A01,507293,Pappas; Elizabeth,30,0,30,0
1713493988329,EDS 139,A00,507294,Fargason; Sharon Gayle,30,0,30,0
1713493988329,EDS 139,B00,507313,Pappas; Elizabeth,30,0,30,0
1713493989353,EDS 201,A00,507315,Staff,18,0,30,12
1713493990379,EDS 203,A01,507317,Halter; Christopher P.,17,0,30,13
1713493991405,EDS 204R,A01,507319,Halter; Christopher P.,0,1,30,30
1713493991405,EDS 204R,B01,507331,Heinzman; Erica M.,22,0,30,8
1713493992430,EDS 206R,A00,507332,Staff,0,2,30,30
1713493992430,EDS 206R,B00,507343,Staff,23,0,30,7
1713493993455,EDS 250,A00,507344,Hemans; Patricia Ann Benitez,27,0,40,13
1713493994481,EDS 281,A00,507345,Daly; Alan J.,18,0,18,0
1713493995509,EDS 284,A00,507350,Daly; Alan J.,16,0,16,0
1713493996532,EDS 286,A00,507359,Fine; Sarah,18,0,18,0
1713493997557,EDS 289C,A01,507361,Daly; Alan J.,18,0,18,0
1713493998584,EDS 290,A00,507366,Hofstetter; Carolyn,15,0,15,0
1713493999615,LIGM 5A,A00,507421,Fischer-Grunski; Eva K,20,0,20,0
1713494000643,LIGM 5B,A00,507423,Fischer-Grunski; Eva K,20,0,20,0
1713494001669,LIGM 5C,A00,507425,Fischer-Grunski; Eva K,20,0,20,0
1713494002694,LIIT 5AS,A00,507427,Carnelos; Chiara,20,0,20,0
1713494003719,LIIT 5BS,A00,507430,Carnelos; Chiara,20,0,20,0
1713494004750,LIIT 5CS,A00,507432,Carnelos; Chiara,20,0,20,0
1713494005777,LISP 5A,A00,507541,Munoz Sanchez; Alicia,14,0,20,6
1713494006807,LISP 5B,A00,507671,Munoz Sanchez; Alicia,12,0,20,8
1713494007835,LISP 5C,A00,507696,Munoz Sanchez; Alicia,11,0,20,9
1713494008861,MAE 197,001,528363,Boechler; Nicholas Sebastia,9998,0,9999,1
1713494009887,MATH 197,001,523477,Kedlaya; Kiran S.,9999,0,9999,0
1713494009887,MATH 197,002,563811,Zhang; Danna,9998,0,9999,1
1713494010913,MCWP 40R,A00,518780,Staff,15,0,20,5
1713494010913,MCWP 40R,B00,518781,Staff,13,0,20,7
1713494010913,MCWP 40R,C00,518783,Staff,9,0,20,11
1713494011941,MCWP 50R,A00,518791,Staff,7,0,20,13
1713494011941,MCWP 50R,B00,518792,Staff,3,0,20,17
1713494011941,MCWP 50R,C00,518793,Staff,7,0,20,13
1713494011941,MCWP 50R,D00,518794,Staff,0,0,20,20
1713494011941,MCWP 50R,E00,518795,Staff,0,0,20,20
1713494011941,MCWP 50R,F00,518796,Staff,11,0,20,9
1713494011941,MCWP 50R,G00,518797,Staff,10,0,20,10
1713494012967,MMW 12R,A01,514034,Herbst; Matthew,5,0,16,11
1713494012967,MMW 12R,A02,514035,Herbst; Matthew,13,0,16,3
1713494013993,MMW 13R,A01,514037,Staff,0,6,16,16
1713494013993,MMW 13R,A02,514039,Staff,0,4,16,16
1713494016046,SIO 295LS,A00,523233,Staff,15,0,30,15
1713494017071,SIO 295S,A00,523232,Staff,15,0,30,15
1713494018098,SOCI 117,A01,494376,Staff,0,2,5,5
1713494019179,WES 237B,A00,494380,Staff,19,0,20,1
1713494021260,AESE 279B,A00,494370,Wade; Jon P,33,0,33,0
1713494022290,AIP 197,001,627712,Vespa; Emanuel Ignacio,9999,0,9999,0
1713494023319,ANAR 135S,A00,494369,Braswell; Geoffrey E.,0,0,0,0
1713494024345,CAT 124RS,A01,519847,Geibel; William,6,0,20,14
1713494025373,CAT 125RS,A01,515971,Geibel; William,6,0,20,14
1713494026403,CLRE 250,A00,511389,Morris; Sheldon,9996,0,9999,3
1713494027430,CLRE 251,A00,507176,Mehta; Ravindra L.,9996,0,9999,3
1713494027430,CLRE 251,B00,511410,Mehta; Ravindra L.,9998,0,9999,1
1713494028459,CLRE 252,A00,507189,Cuomo; Raphael Eduardo,9998,0,9999,1
1713494029484,CLRE 253,A00,507199,Vaida; Florin,9997,0,9999,2
1713494029484,CLRE 253,B00,507202,Vaida; Florin,9999,0,9999,0
1713494030510,CLRE 259,A00,507211,Patel; Hemal,9996,0,9999,3
1713494031536,CLRE 260,A00,507221,Cuomo; Raphael Eduardo,9999,0,9999,0
1713494032562,CLRE 297,001,507242,Cuomo; Raphael Eduardo,9999,0,9999,0
1713494033586,CSE 191,A00,516875,Minnes Kemp; Mor Mia,9999,0,9999,0
1713494034613,CSS 201S,A01,494383,Staff,35,0,35,0
1713494035636,CSS 202S,A01,494387,Staff,35,0,35,0
1713494036661,EAP 100,A00,516065,Staff,9792,0,9999,207
1713494037691,ECE 45,A01,507414,Staff,38,0,60,22
1713494038717,ECE 100,A01,507416,Baghdadchi; Saharnaz,0,0,20,20
1713494038717,ECE 100,A02,507418,Baghdadchi; Saharnaz,19,0,20,1
1713494039743,ECE 111,A01,507420,Staff,27,0,50,23
1713494040772,ECE 197,001,548057,Sievenpiper; Daniel F.,9998,0,9999,1
1713494041799,EDS 115,A00,507243,Choi; Bailey Miyeon,27,0,28,1
1713494042825,EDS 117,A01,494379,Staff,15,0,25,10
1713494043862,EDS 125,A00,507246,Hopkins; Megan Beth,27,0,30,3
1713494044888,EDS 128A,A01,507264,Fargason; Sharon Gayle,26,0,26,0
1713494045914,EDS 128B,A01,507293,Pappas; Elizabeth,30,0,30,0
1713494046939,EDS 139,A00,507294,Fargason; Sharon Gayle,30,0,30,0
1713494046939,EDS 139,B00,507313,Pappas; Elizabeth,30,0,30,0
1713494047967,EDS 201,A00,507315,Staff,18,0,30,12
1713494048992,EDS 203,A01,507317,Halter; Christopher P.,17,0,30,13
1713494050019,EDS 204R,A01,507319,Halter; Christopher P.,0,1,30,30
1713494050019,EDS 204R,B01,507331,Heinzman; Erica M.,22,0,30,8
1713494051044,EDS 206R,A00,507332,Staff,0,2,30,30
1713494051044,EDS 206R,B00,507343,Staff,23,0,30,7
1713494052074,EDS 250,A00,507344,Hemans; Patricia Ann Benitez,27,0,40,13
1713494053098,EDS 281,A00,507345,Daly; Alan J.,18,0,18,0
1713494054126,EDS 284,A00,507350,Daly; Alan J.,16,0,16,0
1713494055153,EDS 286,A00,507359,Fine; Sarah,18,0,18,0
1713494056182,EDS 289C,A01,507361,Daly; Alan J.,18,0,18,0
1713494057211,EDS 290,A00,507366,Hofstetter; Carolyn,15,0,15,0
1713494058238,LIGM 5A,A00,507421,Fischer-Grunski; Eva K,20,0,20,0
1713494059267,LIGM 5B,A00,507423,Fischer-Grunski; Eva K,20,0,20,0
1713494060293,LIGM 5C,A00,507425,Fischer-Grunski; Eva K,20,0,20,0
1713494061328,LIIT 5AS,A00,507427,Carnelos; Chiara,20,0,20,0
1713494062355,LIIT 5BS,A00,507430,Carnelos; Chiara,20,0,20,0
1713494063380,LIIT 5CS,A00,507432,Carnelos; Chiara,20,0,20,0
1713494064405,LISP 5A,A00,507541,Munoz Sanchez; Alicia,14,0,20,6
1713494065431,LISP 5B,A00,507671,Munoz Sanchez; Alicia,12,0,20,8
1713494066457,LISP 5C,A00,507696,Munoz Sanchez; Alicia,11,0,20,9
1713494067485,MAE 197,001,528363,Boechler; Nicholas Sebastia,9998,0,9999,1
1713494068512,MATH 197,001,523477,Kedlaya; Kiran S.,9999,0,9999,0
1713494068512,MATH 197,002,563811,Zhang; Danna,9998,0,9999,1
1713494069538,MCWP 40R,A00,518780,Staff,15,0,20,5
1713494069538,MCWP 40R,B00,518781,Staff,13,0,20,7
1713494069538,MCWP 40R,C00,518783,Staff,9,0,20,11
1713494070565,MCWP 50R,A00,518791,Staff,7,0,20,13
1713494070565,MCWP 50R,B00,518792,Staff,3,0,20,17
1713494070565,MCWP 50R,C00,518793,Staff,7,0,20,13
1713494070565,MCWP 50R,D00,518794,Staff,0,0,20,20
1713494070565,MCWP 50R,E00,518795,Staff,0,0,20,20
1713494070565,MCWP 50R,F00,518796,Staff,11,0,20,9
1713494070565,MCWP 50R,G00,518797,Staff,10,0,20,10
1713494071590,MMW 12R,A01,514034,Herbst; Matthew,5,0,16,11
1713494071590,MMW 12R,A02,514035,Herbst; Matthew,13,0,16,3
1713494072617,MMW 13R,A01,514037,Staff,0,6,16,16
1713494072617,MMW 13R,A02,514039,Staff,0,4,16,16
1713494074670,SIO 295LS,A00,523233,Staff,15,0,30,15
1713494075694,SIO 295S,A00,523232,Staff,15,0,30,15
1713494076720,SOCI 117,A01,494376,Staff,0,2,5,5
1713494077748,WES 237B,A00,494380,Staff,19,0,20,1
1713494079827,AESE 279B,A00,494370,Wade; Jon P,33,0,33,0
1713494080853,AIP 197,001,627712,Vespa; Emanuel Ignacio,9999,0,9999,0
1713494081878,ANAR 135S,A00,494369,Braswell; Geoffrey E.,0,0,0,0
1713494082903,CAT 124RS,A01,519847,Geibel; William,6,0,20,14
1713494083929,CAT 125RS,A01,515971,Geibel; William,6,0,20,14
1713494084955,CLRE 250,A00,511389,Morris; Sheldon,9996,0,9999,3
1713494085981,CLRE 251,A00,507176,Mehta; Ravindra L.,9996,0,9999,3
1713494085981,CLRE 251,B00,511410,Mehta; Ravindra L.,9998,0,9999,1
1713494087010,CLRE 252,A00,507189,Cuomo; Raphael Eduardo,9998,0,9999,1
1713494088039,CLRE 253,A00,507199,Vaida; Florin,9997,0,9999,2
1713494088039,CLRE 253,B00,507202,Vaida; Florin,9999,0,9999,0
1713494089064,CLRE 259,A00,507211,Patel; Hemal,9996,0,9999,3
1713494090089,CLRE 260,A00,507221,Cuomo; Raphael Eduardo,9999,0,9999,0
1713494091114,CLRE 297,001,507242,Cuomo; Raphael Eduardo,9999,0,9999,0
1713494092139,CSE 191,A00,516875,Minnes Kemp; Mor Mia,9999,0,9999,0
1713494093164,CSS 201S,A01,494383,Staff,35,0,35,0
1713494094189,CSS 202S,A01,494387,Staff,35,0,35,0
1713494095215,EAP 100,A00,516065,Staff,9792,0,9999,207
1713494096241,ECE 45,A01,507414,Staff,38,0,60,22
1713494097266,ECE 100,A01,507416,Baghdadchi; Saharnaz,0,0,20,20
1713494097266,ECE 100,A02,507418,Baghdadchi; Saharnaz,19,0,20,1
1713494098292,ECE 111,A01,507420,Staff,27,0,50,23
1713494099320,ECE 197,001,548057,Sievenpiper; Daniel F.,9998,0,9999,1
1713494100344,EDS 115,A00,507243,Choi; Bailey Miyeon,27,0,28,1
1713494101370,EDS 117,A01,494379,Staff,15,0,25,10
1713494102396,EDS 125,A00,507246,Hopkins; Megan Beth,27,0,30,3
1713494103420,EDS 128A,A01,507264,Fargason; Sharon Gayle,26,0,26,0
1713494104447,EDS 128B,A01,507293,Pappas; Elizabeth,30,0,30,0
1713494105473,EDS 139,A00,507294,Fargason; Sharon Gayle,30,0,30,0
1713494105473,EDS 139,B00,507313,Pappas; Elizabeth,30,0,30,0
1713494106498,EDS 201,A00,507315,Staff,18,0,30,12
1713494107522,EDS 203,A01,507317,Halter; Christopher P.,17,0,30,13
1713494108547,EDS 204R,A01,507319,Halter; Christopher P.,0,1,30,30
1713494108547,EDS 204R,B01,507331,Heinzman; Erica M.,22,0,30,8
1713494109574,EDS 206R,A00,507332,Staff,0,2,30,30
1713494109574,EDS 206R,B00,507343,Staff,23,0,30,7
1713494110603,EDS 250,A00,507344,Hemans; Patricia Ann Benitez,27,0,40,13
1713494111627,EDS 281,A00,507345,Daly; Alan J.,18,0,18,0
1713494112652,EDS 284,A00,507350,Daly; Alan J.,16,0,16,0
1713494113677,EDS 286,A00,507359,Fine; Sarah,18,0,18,0
1713494114705,EDS 289C,A01,507361,Daly; Alan J.,18,0,18,0
1713494115733,EDS 290,A00,507366,Hofstetter; Carolyn,15,0,15,0
1713494116762,LIGM 5A,A00,507421,Fischer-Grunski; Eva K,20,0,20,0
1713494117786,LIGM 5B,A00,507423,Fischer-Grunski; Eva K,20,0,20,0
1713494118816,LIGM 5C,A00,507425,Fischer-Grunski; Eva K,20,0,20,0
1713494119845,LIIT 5AS,A00,507427,Carnelos; Chiara,20,0,20,0
1713494121022,LIIT 5BS,A00,507430,Carnelos; Chiara,20,0,20,0
1713494122051,LIIT 5CS,A00,507432,Carnelos; Chiara,20,0,20,0
1713494123135,LISP 5A,A00,507541,Munoz Sanchez; Alicia,14,0,20,6
1713494124165,LISP 5B,A00,507671,Munoz Sanchez; Alicia,12,0,20,8
1713494125194,LISP 5C,A00,507696,Munoz Sanchez; Alicia,11,0,20,9
1713494126224,MAE 197,001,528363,Boechler; Nicholas Sebastia,9998,0,9999,1
1713494127254,MATH 197,001,523477,Kedlaya; Kiran S.,9999,0,9999,0
1713494127254,MATH 197,002,563811,Zhang; Danna,9998,0,9999,1
1713494128282,MCWP 40R,A00,518780,Staff,15,0,20,5
1713494128282,MCWP 40R,B00,518781,Staff,13,0,20,7
1713494128282,MCWP 40R,C00,518783,Staff,9,0,20,11
1713494129309,MCWP 50R,A00,518791,Staff,7,0,20,13
1713494129309,MCWP 50R,B00,518792,Staff,3,0,20,17
1713494129309,MCWP 50R,C00,518793,Staff,7,0,20,13
1713494129309,MCWP 50R,D00,518794,Staff,0,0,20,20
1713494129309,MCWP 50R,E00,518795,Staff,0,0,20,20
1713494129309,MCWP 50R,F00,518796,Staff,11,0,20,9
1713494129309,MCWP 50R,G00,518797,Staff,10,0,20,10
1713494130336,MMW 12R,A01,514034,Herbst; Matthew,5,0,16,11
1713494130336,MMW 12R,A02,514035,Herbst; Matthew,13,0,16,3
1713494131359,MMW 13R,A01,514037,Staff,0,6,16,16
1713494131359,MMW 13R,A02,514039,Staff,0,4,16,16
1713494133418,SIO 295LS,A00,523233,Staff,15,0,30,15
1713494134448,SIO 295S,A00,523232,Staff,15,0,30,15
1713494135473,SOCI 117,A01,494376,Staff,0,2,5,5
1713494136499,WES 237B,A00,494380,Staff,19,0,20,1
1713494138565,AESE 279B,A00,494370,Wade; Jon P,33,0,33,0
1713494139594,AIP 197,001,627712,Vespa; Emanuel Ignacio,9999,0,9999,0
1713494140622,ANAR 135S,A00,494369,Braswell; Geoffrey E.,0,0,0,0
1713494141649,CAT 124RS,A01,519847,Geibel; William,6,0,20,14
1713494142678,CAT 125RS,A01,515971,Geibel; William,6,0,20,14
1713494143708,CLRE 250,A00,511389,Morris; Sheldon,9996,0,9999,3
1713494144736,CLRE 251,A00,507176,Mehta; Ravindra L.,9996,0,9999,3
1713494144736,CLRE 251,B00,511410,Mehta; Ravindra L.,9998,0,9999,1
1713494145767,CLRE 252,A00,507189,Cuomo; Raphael Eduardo,9998,0,9999,1
1713494146793,CLRE 253,A00,507199,Vaida; Florin,9997,0,9999,2
1713494146793,CLRE 253,B00,507202,Vaida; Florin,9999,0,9999,0
1713494147819,CLRE 259,A00,507211,Patel; Hemal,9996,0,9999,3
1713494148845,CLRE 260,A00,507221,Cuomo; Raphael Eduardo,9999,0,9999,0
1713494149873,CLRE 297,001,507242,Cuomo; Raphael Eduardo,9999,0,9999,0
1713494150899,CSE 191,A00,516875,Minnes Kemp; Mor Mia,9999,0,9999,0
1713494151929,CSS 201S,A01,494383,Staff,35,0,35,0
1713494152956,CSS 202S,A01,494387,Staff,35,0,35,0
1713494153981,EAP 100,A00,516065,Staff,9792,0,9999,207
1713494155007,ECE 45,A01,507414,Staff,38,0,60,22
1713494156033,ECE 100,A01,507416,Baghdadchi; Saharnaz,0,0,20,20
1713494156033,ECE 100,A02,507418,Baghdadchi; Saharnaz,19,0,20,1
1713494157059,ECE 111,A01,507420,Staff,27,0,50,23
1713494158087,ECE 197,001,548057,Sievenpiper; Daniel F.,9998,0,9999,1
1713494159114,EDS 115,A00,507243,Choi; Bailey Miyeon,27,0,28,1
1713494160140,EDS 117,A01,494379,Staff,15,0,25,10
1713494161169,EDS 125,A00,507246,Hopkins; Megan Beth,27,0,30,3
1713494162194,EDS 128A,A01,507264,Fargason; Sharon Gayle,26,0,26,0
1713494163220,EDS 128B,A01,507293,Pappas; Elizabeth,30,0,30,0
1713494164249,EDS 139,A00,507294,Fargason; Sharon Gayle,30,0,30,0
1713494164249,EDS 139,B00,507313,Pappas; Elizabeth,30,0,30,0
1713494165274,EDS 201,A00,507315,Staff,18,0,30,12
1713494166302,EDS 203,A01,507317,Halter; Christopher P.,17,0,30,13
1713494167328,EDS 204R,A01,507319,Halter; Christopher P.,0,1,30,30
1713494167328,EDS 204R,B01,507331,Heinzman; Erica M.,22,0,30,8
1713494168353,EDS 206R,A00,507332,Staff,0,2,30,30
1713494168353,EDS 206R,B00,507343,Staff,23,0,30,7
1713494169382,EDS 250,A00,507344,Hemans; Patricia Ann Benitez,27,0,40,13
1713494170407,EDS 281,A00,507345,Daly; Alan J.,18,0,18,0
1713494171434,EDS 284,A00,507350,Daly; Alan J.,16,0,16,0
1713494172462,EDS 286,A00,507359,Fine; Sarah,18,0,18,0
1713494173485,EDS 289C,A01,507361,Daly; Alan J.,18,0,18,0
1713494174514,EDS 290,A00,507366,Hofstetter; Carolyn,15,0,15,0
1713494175545,LIGM 5A,A00,507421,Fischer-Grunski; Eva K,20,0,20,0
1713494176572,LIGM 5B,A00,507423,Fischer-Grunski; Eva K,20,0,20,0
1713494177597,LIGM 5C,A00,507425,Fischer-Grunski; Eva K,20,0,20,0
1713494178632,LIIT 5AS,A00,507427,Carnelos; Chiara,20,0,20,0
1713494179657,LIIT 5BS,A00,507430,Carnelos; Chiara,20,0,20,0
1713494180681,LIIT 5CS,A00,507432,Carnelos; Chiara,20,0,20,0
1713494181705,LISP 5A,A00,507541,Munoz Sanchez; Alicia,14,0,20,6
1713494182730,LISP 5B,A00,507671,Munoz Sanchez; Alicia,12,0,20,8
1713494183755,LISP 5C,A00,507696,Munoz Sanchez; Alicia,11,0,20,9
1713494184782,MAE 197,001,528363,Boechler; Nicholas Sebastia,9998,0,9999,1
1713494185807,MATH 197,001,523477,Kedlaya; Kiran S.,9999,0,9999,0
1713494185807,MATH 197,002,563811,Zhang; Danna,9998,0,9999,1
1713494186839,MCWP 40R,A00,518780,Staff,15,0,20,5
1713494186839,MCWP 40R,B00,518781,Staff,13,0,20,7
1713494186839,MCWP 40R,C00,518783,Staff,9,0,20,11
1713494187865,MCWP 50R,A00,518791,Staff,7,0,20,13
1713494187865,MCWP 50R,B00,518792,Staff,3,0,20,17
1713494187865,MCWP 50R,C00,518793,Staff,7,0,20,13
1713494187865,MCWP 50R,D00,518794,Staff,0,0,20,20
1713494187865,MCWP 50R,E00,518795,Staff,0,0,20,20
1713494187865,MCWP 50R,F00,518796,Staff,11,0,20,9
1713494187865,MCWP 50R,G00,518797,Staff,10,0,20,10
1713494188894,MMW 12R,A01,514034,Herbst; Matthew,5,0,16,11
1713494188894,MMW 12R,A02,514035,Herbst; Matthew,13,0,16,3
1713494189921,MMW 13R,A01,514037,Staff,0,6,16,16
1713494189921,MMW 13R,A02,514039,Staff,0,4,16,16
1713494191973,SIO 295LS,A00,523233,Staff,15,0,30,15
1713494193003,SIO 295S,A00,523232,Staff,15,0,30,15
1713494194032,SOCI 117,A01,494376,Staff,0,2,5,5
1713494195058,WES 237B,A00,494380,Staff,19,0,20,1
1713494197127,AESE 279B,A00,494370,Wade; Jon P,33,0,33,0
1713494198156,AIP 197,001,627712,Vespa; Emanuel Ignacio,9999,0,9999,0
1713494199181,ANAR 135S,A00,494369,Braswell; Geoffrey E.,0,0,0,0
1713494200209,CAT 124RS,A01,519847,Geibel; William,6,0,20,14
1713494201235,CAT 125RS,A01,515971,Geibel; William,6,0,20,14
1713494202263,CLRE 250,A00,511389,Morris; Sheldon,9996,0,9999,3
1713494203293,CLRE 251,A00,507176,Mehta; Ravindra L.,9996,0,9999,3
1713494203293,CLRE 251,B00,511410,Mehta; Ravindra L.,9998,0,9999,1
1713494204321,CLRE 252,A00,507189,Cuomo; Raphael Eduardo,9998,0,9999,1
1713494205346,CLRE 253,A00,507199,Vaida; Florin,9997,0,9999,2
1713494205346,CLRE 253,B00,507202,Vaida; Florin,9999,0,9999,0
1713494206374,CLRE 259,A00,507211,Patel; Hemal,9996,0,9999,3
1713494207399,CLRE 260,A00,507221,Cuomo; Raphael Eduardo,9999,0,9999,0
1713494208425,CLRE 297,001,507242,Cuomo; Raphael Eduardo,9999,0,9999,0
1713494209450,CSE 191,A00,516875,Minnes Kemp; Mor Mia,9999,0,9999,0
1713494210474,CSS 201S,A01,494383,Staff,35,0,35,0
1713494211503,CSS 202S,A01,494387,Staff,35,0,35,0
1713494212527,EAP 100,A00,516065,Staff,9792,0,9999,207
1713494213557,ECE 45,A01,507414,Staff,38,0,60,22
1713494214581,ECE 100,A01,507416,Baghdadchi; Saharnaz,0,0,20,20
1713494214581,ECE 100,A02,507418,Baghdadchi; Saharnaz,19,0,20,1
1713494215605,ECE 111,A01,507420,Staff,27,0,50,23
1713494216628,ECE 197,001,548057,Sievenpiper; Daniel F.,9998,0,9999,1
1713494217652,EDS 115,A00,507243,Choi; Bailey Miyeon,27,0,28,1
1713494218681,EDS 117,A01,494379,Staff,15,0,25,10
1713494219705,EDS 125,A00,507246,Hopkins; Megan Beth,27,0,30,3
1713494220730,EDS 128A,A01,507264,Fargason; Sharon Gayle,26,0,26,0
1713494221755,EDS 128B,A01,507293,Pappas; Elizabeth,30,0,30,0
1713494222779,EDS 139,A00,507294,Fargason; Sharon Gayle,30,0,30,0
1713494222779,EDS 139,B00,507313,Pappas; Elizabeth,30,0,30,0
1713494223806,EDS 201,A00,507315,Staff,18,0,30,12
1713494224835,EDS 203,A01,507317,Halter; Christopher P.,17,0,30,13
1713494225863,EDS 204R,A01,507319,Halter; Christopher P.,0,1,30,30
1713494225863,EDS 204R,B01,507331,Heinzman; Erica M.,22,0,30,8
1713494226945,EDS 206R,A00,507332,Staff,0,2,30,30
1713494226945,EDS 206R,B00,507343,Staff,23,0,30,7
1713494227969,EDS 250,A00,507344,Hemans; Patricia Ann Benitez,27,0,40,13
1713494228995,EDS 281,A00,507345,Daly; Alan J.,18,0,18,0
1713494230021,EDS 284,A00,507350,Daly; Alan J.,16,0,16,0
1713494231049,EDS 286,A00,507359,Fine; Sarah,18,0,18,0
1713494232074,EDS 289C,A01,507361,Daly; Alan J.,18,0,18,0
1713494233100,EDS 290,A00,507366,Hofstetter; Carolyn,15,0,15,0
1713494234126,LIGM 5A,A00,507421,Fischer-Grunski; Eva K,20,0,20,0
1713494235151,LIGM 5B,A00,507423,Fischer-Grunski; Eva K,20,0,20,0
1713494236180,LIGM 5C,A00,507425,Fischer-Grunski; Eva K,20,0,20,0
1713494237206,LIIT 5AS,A00,507427,Carnelos; Chiara,20,0,20,0
1713494238235,LIIT 5BS,A00,507430,Carnelos; Chiara,20,0,20,0
1713494239258,LIIT 5CS,A00,507432,Carnelos; Chiara,20,0,20,0
1713494240283,LISP 5A,A00,507541,Munoz Sanchez; Alicia,14,0,20,6
1713494241310,LISP 5B,A00,507671,Munoz Sanchez; Alicia,12,0,20,8
1713494242338,LISP 5C,A00,507696,Munoz Sanchez; Alicia,11,0,20,9
1713494243366,MAE 197,001,528363,Boechler; Nicholas Sebastia,9998,0,9999,1
1713494244391,MATH 197,001,523477,Kedlaya; Kiran S.,9999,0,9999,0
1713494244391,MATH 197,002,563811,Zhang; Danna,9998,0,9999,1
1713494245416,MCWP 40R,A00,518780,Staff,14,0,20,6
1713494245416,MCWP 40R,B00,518781,Staff,13,0,20,7
1713494245416,MCWP 40R,C00,518783,Staff,9,0,20,11
1713494246441,MCWP 50R,A00,518791,Staff,7,0,20,13
1713494246441,MCWP 50R,B00,518792,Staff,3,0,20,17
1713494246441,MCWP 50R,C00,518793,Staff,7,0,20,13
1713494246441,MCWP 50R,D00,518794,Staff,0,0,20,20
1713494246441,MCWP 50R,E00,518795,Staff,0,0,20,20
1713494246441,MCWP 50R,F00,518796,Staff,11,0,20,9
1713494246441,MCWP 50R,G00,518797,Staff,10,0,20,10
1713494247471,MMW 12R,A01,514034,Herbst; Matthew,5,0,16,11
1713494247471,MMW 12R,A02,514035,Herbst; Matthew,13,0,16,3
1713494248498,MMW 13R,A01,514037,Staff,0,6,16,16
1713494248498,MMW 13R,A02,514039,Staff,0,4,16,16
1713494250548,SIO 295LS,A00,523233,Staff,15,0,30,15
1713494251573,SIO 295S,A00,523232,Staff,15,0,30,15
1713494252602,SOCI 117,A01,494376,Staff,0,2,5,5
1713494253626,WES 237B,A00,494380,Staff,19,0,20,1
1713494255697,AESE 279B,A00,494370,Wade; Jon P,33,0,33,0
1713494256722,AIP 197,001,627712,Vespa; Emanuel Ignacio,9999,0,9999,0
1713494257752,ANAR 135S,A00,494369,Braswell; Geoffrey E.,0,0,0,0
1713494258778,CAT 124RS,A01,519847,Geibel; William,6,0,20,14
1713494259805,CAT 125RS,A01,515971,Geibel; William,6,0,20,14
1713494260831,CLRE 250,A00,511389,Morris; Sheldon,9996,0,9999,3
1713494261863,CLRE 251,A00,507176,Mehta; Ravindra L.,9996,0,9999,3
1713494261863,CLRE 251,B00,511410,Mehta; Ravindra L.,9998,0,9999,1
1713494262888,CLRE 252,A00,507189,Cuomo; Raphael Eduardo,9998,0,9999,1
1713494263916,CLRE 253,A00,507199,Vaida; Florin,9997,0,9999,2
1713494263916,CLRE 253,B00,507202,Vaida; Florin,9999,0,9999,0
1713494264942,CLRE 259,A00,507211,Patel; Hemal,9996,0,9999,3
1713494265971,CLRE 260,A00,507221,Cuomo; Raphael Eduardo,9999,0,9999,0
1713494266996,CLRE 297,001,507242,Cuomo; Raphael Eduardo,9999,0,9999,0
1713494268021,CSE 191,A00,516875,Minnes Kemp; Mor Mia,9999,0,9999,0
1713494269044,CSS 201S,A01,494383,Staff,35,0,35,0
1713494270070,CSS 202S,A01,494387,Staff,35,0,35,0
1713494271100,EAP 100,A00,516065,Staff,9792,0,9999,207
1713494272128,ECE 45,A01,507414,Staff,38,0,60,22
1713494273153,ECE 100,A01,507416,Baghdadchi; Saharnaz,0,0,20,20
1713494273153,ECE 100,A02,507418,Baghdadchi; Saharnaz,19,0,20,1
1713494274177,ECE 111,A01,507420,Staff,27,0,50,23
1713494275204,ECE 197,001,548057,Sievenpiper; Daniel F.,9998,0,9999,1
1713494276229,EDS 115,A00,507243,Choi; Bailey Miyeon,27,0,28,1
1713494277258,EDS 117,A01,494379,Staff,15,0,25,10
1713494278286,EDS 125,A00,507246,Hopkins; Megan Beth,27,0,30,3
1713494279314,EDS 128A,A01,507264,Fargason; Sharon Gayle,26,0,26,0
1713494280340,EDS 128B,A01,507293,Pappas; Elizabeth,30,0,30,0
1713494281365,EDS 139,A00,507294,Fargason; Sharon Gayle,30,0,30,0
1713494281365,EDS 139,B00,507313,Pappas; Elizabeth,30,0,30,0
1713494282391,EDS 201,A00,507315,Staff,18,0,30,12
1713494283418,EDS 203,A01,507317,Halter; Christopher P.,17,0,30,13
1713494284452,EDS 204R,A01,507319,Halter; Christopher P.,0,1,30,30
1713494284452,EDS 204R,B01,507331,Heinzman; Erica M.,22,0,30,8
1713494285476,EDS 206R,A00,507332,Staff,0,2,30,30
1713494285476,EDS 206R,B00,507343,Staff,23,0,30,7
1713494286504,EDS 250,A00,507344,Hemans; Patricia Ann Benitez,27,0,40,13
1713494287529,EDS 281,A00,507345,Daly; Alan J.,18,0,18,0
1713494288554,EDS 284,A00,507350,Daly; Alan J.,16,0,16,0
1713494289579,EDS 286,A00,507359,Fine; Sarah,18,0,18,0
1713494290604,EDS 289C,A01,507361,Daly; Alan J.,18,0,18,0
1713494291629,EDS 290,A00,507366,Hofstetter; Carolyn,15,0,15,0
1713494292656,LIGM 5A,A00,507421,Fischer-Grunski; Eva K,20,0,20,0
1713494293680,LIGM 5B,A00,507423,Fischer-Grunski; Eva K,20,0,20,0
1713494294709,LIGM 5C,A00,507425,Fischer-Grunski; Eva K,20,0,20,0
1713494295735,LIIT 5AS,A00,507427,Carnelos; Chiara,20,0,20,0
1713494296764,LIIT 5BS,A00,507430,Carnelos; Chiara,20,0,20,0
1713494297788,LIIT 5CS,A00,507432,Carnelos; Chiara,20,0,20,0
1713494298813,LISP 5A,A00,507541,Munoz Sanchez; Alicia,14,0,20,6
1713494299837,LISP 5B,A00,507671,Munoz Sanchez; Alicia,12,0,20,8
1713494300865,LISP 5C,A00,507696,Munoz Sanchez; Alicia,11,0,20,9
1713494301894,MAE 197,001,528363,Boechler; Nicholas Sebastia,9998,0,9999,1
1713494302919,MATH 197,001,523477,Kedlaya; Kiran S.,9999,0,9999,0
1713494302919,MATH 197,002,563811,Zhang; Danna,9998,0,9999,1
1713494303944,MCWP 40R,A00,518780,Staff,14,0,20,6
1713494303944,MCWP 40R,B00,518781,Staff,13,0,20,7
1713494303944,MCWP 40R,C00,518783,Staff,9,0,20,11
1713494304970,MCWP 50R,A00,518791,Staff,7,0,20,13
1713494304970,MCWP 50R,B00,518792,Staff,3,0,20,17
1713494304970,MCWP 50R,C00,518793,Staff,7,0,20,13
1713494304970,MCWP 50R,D00,518794,Staff,0,0,20,20
1713494304970,MCWP 50R,E00,518795,Staff,0,0,20,20
1713494304970,MCWP 50R,F00,518796,Staff,11,0,20,9
1713494304970,MCWP 50R,G00,518797,Staff,10,0,20,10
1713494305996,MMW 12R,A01,514034,Herbst; Matthew,5,0,16,11
1713494305996,MMW 12R,A02,514035,Herbst; Matthew,13,0,16,3
1713494307020,MMW 13R,A01,514037,Staff,0,6,16,16
1713494307020,MMW 13R,A02,514039,Staff,0,4,16,16
1713494309073,SIO 295LS,A00,523233,Staff,15,0,30,15
1713494310099,SIO 295S,A00,523232,Staff,15,0,30,15
1713494311127,SOCI 117,A01,494376,Staff,0,2,5,5
1713494312155,WES 237B,A00,494380,Staff,19,0,20,1
1713494314222,AESE 279B,A00,494370,Wade; Jon P,33,0,33,0
1713494315247,AIP 197,001,627712,Vespa; Emanuel Ignacio,9999,0,9999,0
1713494316274,ANAR 135S,A00,494369,Braswell; Geoffrey E.,0,0,0,0
1713494317302,CAT 124RS,A01,519847,Geibel; William,6,0,20,14
1713494318328,CAT 125RS,A01,515971,Geibel; William,6,0,20,14
1713494319355,CLRE 250,A00,511389,Morris; Sheldon,9996,0,9999,3
1713494320386,CLRE 251,A00,507176,Mehta; Ravindra L.,9996,0,9999,3
1713494320386,CLRE 251,B00,511410,Mehta; Ravindra L.,9998,0,9999,1
1713494321412,CLRE 252,A00,507189,Cuomo; Raphael Eduardo,9998,0,9999,1
1713494322439,CLRE 253,A00,507199,Vaida; Florin,9997,0,9999,2
1713494322439,CLRE 253,B00,507202,Vaida; Florin,9999,0,9999,0
1713494323467,CLRE 259,A00,507211,Patel; Hemal,9996,0,9999,3
1713494324492,CLRE 260,A00,507221,Cuomo; Raphael Eduardo,9999,0,9999,0
1713494325518,CLRE 297,001,507242,Cuomo; Raphael Eduardo,9999,0,9999,0
1713494326543,CSE 191,A00,516875,Minnes Kemp; Mor Mia,9999,0,9999,0
1713494327574,CSS 201S,A01,494383,Staff,35,0,35,0
1713494328604,CSS 202S,A01,494387,Staff,35,0,35,0
1713494329632,EAP 100,A00,516065,Staff,9792,0,9999,207
1713494330736,ECE 45,A01,507414,Staff,38,0,60,22
1713494331766,ECE 100,A01,507416,Baghdadchi; Saharnaz,0,0,20,20
1713494331766,ECE 100,A02,507418,Baghdadchi; Saharnaz,19,0,20,1
1713494332798,ECE 111,A01,507420,Staff,27,0,50,23
1713494333822,ECE 197,001,548057,Sievenpiper; Daniel F.,9998,0,9999,1
1713494334850,EDS 115,A00,507243,Choi; Bailey Miyeon,27,0,28,1
1713494335880,EDS 117,A01,494379,Staff,15,0,25,10
1713494336908,EDS 125,A00,507246,Hopkins; Megan Beth,27,0,30,3
1713494337939,EDS 128A,A01,507264,Fargason; Sharon Gayle,26,0,26,0
1713494338967,EDS 128B,A01,507293,Pappas; Elizabeth,30,0,30,0
1713494339994,EDS 139,A00,507294,Fargason; Sharon Gayle,30,0,30,0
1713494339994,EDS 139,B00,507313,Pappas; Elizabeth,30,0,30,0
1713494341020,EDS 201,A00,507315,Staff,18,0,30,12
1713494342050,EDS 203,A01,507317,Halter; Christopher P.,17,0,30,13
1713494343074,EDS 204R,A01,507319,Halter; Christopher P.,0,1,30,30
1713494343074,EDS 204R,B01,507331,Heinzman; Erica M.,22,0,30,8
1713494344099,EDS 206R,A00,507332,Staff,0,2,30,30
1713494344099,EDS 206R,B00,507343,Staff,23,0,30,7
1713494345123,EDS 250,A00,507344,Hemans; Patricia Ann Benitez,27,0,40,13
1713494346149,EDS 281,A00,507345,Daly; Alan J.,18,0,18,0
1713494347175,EDS 284,A00,507350,Daly; Alan J.,16,0,16,0
1713494348204,EDS 286,A00,507359,Fine; Sarah,18,0,18,0
1713494349232,EDS 289C,A01,507361,Daly; Alan J.,18,0,18,0
1713494350259,EDS 290,A00,507366,Hofstetter; Carolyn,15,0,15,0
1713494351289,LIGM 5A,A00,507421,Fischer-Grunski; Eva K,20,0,20,0
1713494352315,LIGM 5B,A00,507423,Fischer-Grunski; Eva K,20,0,20,0
1713494353339,LIGM 5C,A00,507425,Fischer-Grunski; Eva K,20,0,20,0
1713494354366,LIIT 5AS,A00,507427,Carnelos; Chiara,20,0,20,0
1713494355391,LIIT 5BS,A00,507430,Carnelos; Chiara,20,0,20,0
1713494356420,LIIT 5CS,A00,507432,Carnelos; Chiara,20,0,20,0
1713494357450,LISP 5A,A00,507541,Munoz Sanchez; Alicia,14,0,20,6
1713494358479,LISP 5B,A00,507671,Munoz Sanchez; Alicia,12,0,20,8
1713494359508,LISP 5C,A00,507696,Munoz Sanchez; Alicia,11,0,20,9
1713494360534,MAE 197,001,528363,Boechler; Nicholas Sebastia,9998,0,9999,1
1713494361563,MATH 197,001,523477,Kedlaya; Kiran S.,9999,0,9999,0
1713494361563,MATH 197,002,563811,Zhang; Danna,9998,0,9999,1
1713494362589,MCWP 40R,A00,518780,Staff,14,0,20,6
1713494362589,MCWP 40R,B00,518781,Staff,13,0,20,7
1713494362589,MCWP 40R,C00,518783,Staff,9,0,20,11
1713494363618,MCWP 50R,A00,518791,Staff,7,0,20,13
1713494363618,MCWP 50R,B00,518792,Staff,3,0,20,17
1713494363618,MCWP 50R,C00,518793,Staff,7,0,20,13
1713494363618,MCWP 50R,D00,518794,Staff,0,0,20,20
1713494363618,MCWP 50R,E00,518795,Staff,0,0,20,20
1713494363618,MCWP 50R,F00,518796,Staff,11,0,20,9
1713494363618,MCWP 50R,G00,518797,Staff,10,0,20,10
1713494364644,MMW 12R,A01,514034,Herbst; Matthew,5,0,16,11
1713494364644,MMW 12R,A02,514035,Herbst; Matthew,13,0,16,3
1713494365668,MMW 13R,A01,514037,Staff,0,6,16,16
1713494365668,MMW 13R,A02,514039,Staff,0,4,16,16
1713494367720,SIO 295LS,A00,523233,Staff,15,0,30,15
1713494368746,SIO 295S,A00,523232,Staff,15,0,30,15
1713494369772,SOCI 117,A01,494376,Staff,0,2,5,5
1713494370798,WES 237B,A00,494380,Staff,19,0,20,1
1713494372867,AESE 279B,A00,494370,Wade; Jon P,33,0,33,0
1713494373897,AIP 197,001,627712,Vespa; Emanuel Ignacio,9999,0,9999,0
1713494374923,ANAR 135S,A00,494369,Braswell; Geoffrey E.,0,0,0,0
1713494375949,CAT 124RS,A01,519847,Geibel; William,6,0,20,14
1713494376973,CAT 125RS,A01,515971,Geibel; William,6,0,20,14
1713494377999,CLRE 250,A00,511389,Morris; Sheldon,9996,0,9999,3
1713494379026,CLRE 251,A00,507176,Mehta; Ravindra L.,9996,0,9999,3
1713494379026,CLRE 251,B00,511410,Mehta; Ravindra L.,9998,0,9999,1
1713494380050,CLRE 252,A00,507189,Cuomo; Raphael Eduardo,9998,0,9999,1
1713494381076,CLRE 253,A00,507199,Vaida; Florin,9997,0,9999,2
1713494381076,CLRE 253,B00,507202,Vaida; Florin,9999,0,9999,0
1713494382102,CLRE 259,A00,507211,Patel; Hemal,9996,0,9999,3
1713494383130,CLRE 260,A00,507221,Cuomo; Raphael Eduardo,9999,0,9999,0
1713494384155,CLRE 297,001,507242,Cuomo; Raphael Eduardo,9999,0,9999,0
1713494385182,CSE 191,A00,516875,Minnes Kemp; Mor Mia,9999,0,9999,0
1713494386209,CSS 201S,A01,494383,Staff,35,0,35,0
1713494387238,CSS 202S,A01,494387,Staff,35,0,35,0
1713494388262,EAP 100,A00,516065,Staff,9792,0,9999,207
1713494389292,ECE 45,A01,507414,Staff,38,0,60,22
1713494390319,ECE 100,A01,507416,Baghdadchi; Saharnaz,0,0,20,20
1713494390319,ECE 100,A02,507418,Baghdadchi; Saharnaz,19,0,20,1
1713494391344,ECE 111,A01,507420,Staff,27,0,50,23
1713494392370,ECE 197,001,548057,Sievenpiper; Daniel F.,9998,0,9999,1
1713494393401,EDS 115,A00,507243,Choi; Bailey Miyeon,27,0,28,1
1713494394431,EDS 117,A01,494379,Staff,15,0,25,10
1713494395459,EDS 125,A00,507246,Hopkins; Megan Beth,27,0,30,3
1713494396484,EDS 128A,A01,507264,Fargason; Sharon Gayle,26,0,26,0
1713494397509,EDS 128B,A01,507293,Pappas; Elizabeth,30,0,30,0
1713494398535,EDS 139,A00,507294,Fargason; Sharon Gayle,30,0,30,0
1713494398535,EDS 139,B00,507313,Pappas; Elizabeth,30,0,30,0
1713494399559,EDS 201,A00,507315,Staff,18,0,30,12
1713494400585,EDS 203,A01,507317,Halter; Christopher P.,17,0,30,13
1713494401609,EDS 204R,A01,507319,Halter; Christopher P.,0,1,30,30
1713494401609,EDS 204R,B01,507331,Heinzman; Erica M.,22,0,30,8
1713494402633,EDS 206R,A00,507332,Staff,0,2,30,30
1713494402633,EDS 206R,B00,507343,Staff,23,0,30,7
1713494403658,EDS 250,A00,507344,Hemans; Patricia Ann Benitez,27,0,40,13
1713494404683,EDS 281,A00,507345,Daly; Alan J.,18,0,18,0
1713494405711,EDS 284,A00,507350,Daly; Alan J.,16,0,16,0
1713494406736,EDS 286,A00,507359,Fine; Sarah,18,0,18,0
1713494407761,EDS 289C,A01,507361,Daly; Alan J.,18,0,18,0
1713494408789,EDS 290,A00,507366,Hofstetter; Carolyn,15,0,15,0
1713494409815,LIGM 5A,A00,507421,Fischer-Grunski; Eva K,20,0,20,0
1713494410839,LIGM 5B,A00,507423,Fischer-Grunski; Eva K,20,0,20,0
1713494411863,LIGM 5C,A00,507425,Fischer-Grunski; Eva K,20,0,20,0
1713494412891,LIIT 5AS,A00,507427,Carnelos; Chiara,20,0,20,0
1713494413919,LIIT 5BS,A00,507430,Carnelos; Chiara,20,0,20,0
1713494414947,LIIT 5CS,A00,507432,Carnelos; Chiara,20,0,20,0
1713494415977,LISP 5A,A00,507541,Munoz Sanchez; Alicia,14,0,20,6
1713494417002,LISP 5B,A00,507671,Munoz Sanchez; Alicia,12,0,20,8
1713494418031,LISP 5C,A00,507696,Munoz Sanchez; Alicia,11,0,20,9
1713494419056,MAE 197,001,528363,Boechler; Nicholas Sebastia,9998,0,9999,1
1713494420085,MATH 197,001,523477,Kedlaya; Kiran S.,9999,0,9999,0
1713494420085,MATH 197,002,563811,Zhang; Danna,9998,0,9999,1
1713494421113,MCWP 40R,A00,518780,Staff,14,0,20,6
1713494421113,MCWP 40R,B00,518781,Staff,13,0,20,7
1713494421113,MCWP 40R,C00,518783,Staff,9,0,20,11
1713494422137,MCWP 50R,A00,518791,Staff,7,0,20,13
1713494422137,MCWP 50R,B00,518792,Staff,3,0,20,17
1713494422137,MCWP 50R,C00,518793,Staff,7,0,20,13
1713494422137,MCWP 50R,D00,518794,Staff,0,0,20,20
1713494422137,MCWP 50R,E00,518795,Staff,0,0,20,20
1713494422137,MCWP 50R,F00,518796,Staff,11,0,20,9
1713494422137,MCWP 50R,G00,518797,Staff,10,0,20,10
1713494423163,MMW 12R,A01,514034,Herbst; Matthew,5,0,16,11
1713494423163,MMW 12R,A02,514035,Herbst; Matthew,13,0,16,3
1713494424191,MMW 13R,A01,514037,Staff,0,6,16,16
1713494424191,MMW 13R,A02,514039,Staff,0,4,16,16
1713494426244,SIO 295LS,A00,523233,Staff,15,0,30,15
1713494427272,SIO 295S,A00,523232,Staff,15,0,30,15
1713494428303,SOCI 117,A01,494376,Staff,0,2,5,5
1713494429328,WES 237B,A00,494380,Staff,19,0,20,1
1713494431390,AESE 279B,A00,494370,Wade; Jon P,33,0,33,0
1713494432415,AIP 197,001,627712,Vespa; Emanuel Ignacio,9999,0,9999,0
1713494433439,ANAR 135S,A00,494369,Braswell; Geoffrey E.,0,0,0,0
1713494434522,CAT 124RS,A01,519847,Geibel; William,6,0,20,14
1713494435548,CAT 125RS,A01,515971,Geibel; William,6,0,20,14
1713494436572,CLRE 250,A00,511389,Morris; Sheldon,9996,0,9999,3
1713494437596,CLRE 251,A00,507176,Mehta; Ravindra L.,9996,0,9999,3
1713494437596,CLRE 251,B00,511410,Mehta; Ravindra L.,9998,0,9999,1
1713494438622,CLRE 252,A00,507189,Cuomo; Raphael Eduardo,9998,0,9999,1
1713494439652,CLRE 253,A00,507199,Vaida; Florin,9997,0,9999,2
1713494439652,CLRE 253,B00,507202,Vaida; Florin,9999,0,9999,0
1713494440678,CLRE 259,A00,507211,Patel; Hemal,9996,0,9999,3
1713494441708,CLRE 260,A00,507221,Cuomo; Raphael Eduardo,9999,0,9999,0
1713494442733,CLRE 297,001,507242,Cuomo; Raphael Eduardo,9999,0,9999,0
1713494462220,CSE 191,A00,516875,Minnes Kemp; Mor Mia,9999,0,9999,0
1713494463246,CSS 201S,A01,494383,Staff,35,0,35,0
1713494464272,CSS 202S,A01,494387,Staff,35,0,35,0
1713494465297,EAP 100,A00,516065,Staff,9792,0,9999,207
1713494466324,ECE 45,A01,507414,Staff,38,0,60,22
1713494467351,ECE 100,A01,507416,Baghdadchi; Saharnaz,0,0,20,20
1713494467351,ECE 100,A02,507418,Baghdadchi; Saharnaz,19,0,20,1
1713494468378,ECE 111,A01,507420,Staff,27,0,50,23
1713494469403,ECE 197,001,548057,Sievenpiper; Daniel F.,9998,0,9999,1
1713494470430,EDS 115,A00,507243,Choi; Bailey Miyeon,27,0,28,1
1713494471458,EDS 117,A01,494379,Staff,15,0,25,10
1713494472488,EDS 125,A00,507246,Hopkins; Megan Beth,27,0,30,3
1713494473514,EDS 128A,A01,507264,Fargason; Sharon Gayle,26,0,26,0
1713494474540,EDS 128B,A01,507293,Pappas; Elizabeth,30,0,30,0
1713494475566,EDS 139,A00,507294,Fargason; Sharon Gayle,30,0,30,0
1713494475566,EDS 139,B00,507313,Pappas; Elizabeth,30,0,30,0
1713494476593,EDS 201,A00,507315,Staff,18,0,30,12
1713494477618,EDS 203,A01,507317,Halter; Christopher P.,17,0,30,13
1713494478643,EDS 204R,A01,507319,Halter; Christopher P.,0,1,30,30
1713494478643,EDS 204R,B01,507331,Heinzman; Erica M.,22,0,30,8
1713494479668,EDS 206R,A00,507332,Staff,0,2,30,30
1713494479668,EDS 206R,B00,507343,Staff,23,0,30,7
1713494480699,EDS 250,A00,507344,Hemans; Patricia Ann Benitez,27,0,40,13
1713494481723,EDS 281,A00,507345,Daly; Alan J.,18,0,18,0
1713494482750,EDS 284,A00,507350,Daly; Alan J.,16,0,16,0
1713494483779,EDS 286,A00,507359,Fine; Sarah,18,0,18,0
1713494484808,EDS 289C,A01,507361,Daly; Alan J.,18,0,18,0
1713494485837,EDS 290,A00,507366,Hofstetter; Carolyn,15,0,15,0
1713494486863,LIGM 5A,A00,507421,Fischer-Grunski; Eva K,20,0,20,0
1713494487892,LIGM 5B,A00,507423,Fischer-Grunski; Eva K,20,0,20,0
1713494488922,LIGM 5C,A00,507425,Fischer-Grunski; Eva K,20,0,20,0
1713494489948,LIIT 5AS,A00,507427,Carnelos; Chiara,20,0,20,0
1713494490973,LIIT 5BS,A00,507430,Carnelos; Chiara,20,0,20,0
1713494492002,LIIT 5CS,A00,507432,Carnelos; Chiara,20,0,20,0
1713494493033,LISP 5A,A00,507541,Munoz Sanchez; Alicia,14,0,20,6
1713494494062,LISP 5B,A00,507671,Munoz Sanchez; Alicia,12,0,20,8
1713494495091,LISP 5C,A00,507696,Munoz Sanchez; Alicia,11,0,20,9
1713494496119,MAE 197,001,528363,Boechler; Nicholas Sebastia,9998,0,9999,1
1713494497145,MATH 197,001,523477,Kedlaya; Kiran S.,9999,0,9999,0
1713494497145,MATH 197,002,563811,Zhang; Danna,9998,0,9999,1
1713494498172,MCWP 40R,A00,518780,Staff,14,0,20,6
1713494498172,MCWP 40R,B00,518781,Staff,13,0,20,7
1713494498172,MCWP 40R,C00,518783,Staff,9,0,20,11
1713494499203,MCWP 50R,A00,518791,Staff,7,0,20,13
1713494499203,MCWP 50R,B00,518792,Staff,3,0,20,17
1713494499203,MCWP 50R,C00,518793,Staff,7,0,20,13
1713494499203,MCWP 50R,D00,518794,Staff,0,0,20,20
1713494499203,MCWP 50R,E00,518795,Staff,0,0,20,20
1713494499203,MCWP 50R,F00,518796,Staff,11,0,20,9
1713494499203,MCWP 50R,G00,518797,Staff,10,0,20,10
1713494500228,MMW 12R,A01,514034,Herbst; Matthew,4,0,16,12
1713494500228,MMW 12R,A02,514035,Herbst; Matthew,13,0,16,3
1713494501256,MMW 13R,A01,514037,Staff,0,6,16,16
1713494501256,MMW 13R,A02,514039,Staff,0,5,16,16
1713494503307,SIO 295LS,A00,523233,Staff,15,0,30,15
1713494504333,SIO 295S,A00,523232,Staff,15,0,30,15
1713494505359,SOCI 117,A01,494376,Staff,0,2,5,5
1713494506383,WES 237B,A00,494380,Staff,19,0,20,1
1713494508444,AESE 279B,A00,494370,Wade; Jon P,33,0,33,0
1713494509471,AIP 197,001,627712,Vespa; Emanuel Ignacio,9999,0,9999,0
1713494510500,ANAR 135S,A00,494369,Braswell; Geoffrey E.,0,0,0,0
1713494511526,CAT 124RS,A01,519847,Geibel; William,6,0,20,14
1713494512553,CAT 125RS,A01,515971,Geibel; William,6,0,20,14
1713494513579,CLRE 250,A00,511389,Morris; Sheldon,9996,0,9999,3
1713494514605,CLRE 251,A00,507176,Mehta; Ravindra L.,9996,0,9999,3
1713494514605,CLRE 251,B00,511410,Mehta; Ravindra L.,9998,0,9999,1
1713494515634,CLRE 252,A00,507189,Cuomo; Raphael Eduardo,9998,0,9999,1
1713494516660,CLRE 253,A00,507199,Vaida; Florin,9997,0,9999,2
1713494516660,CLRE 253,B00,507202,Vaida; Florin,9999,0,9999,0
1713494517685,CLRE 259,A00,507211,Patel; Hemal,9996,0,9999,3
1713494518709,CLRE 260,A00,507221,Cuomo; Raphael Eduardo,9999,0,9999,0
1713494519737,CLRE 297,001,507242,Cuomo; Raphael Eduardo,9999,0,9999,0
1713494520762,CSE 191,A00,516875,Minnes Kemp; Mor Mia,9999,0,9999,0
1713494521793,CSS 201S,A01,494383,Staff,35,0,35,0
1713494522823,CSS 202S,A01,494387,Staff,35,0,35,0
1713494523848,EAP 100,A00,516065,Staff,9792,0,9999,207
1713494524873,ECE 45,A01,507414,Staff,38,0,60,22
1713494525897,ECE 100,A01,507416,Baghdadchi; Saharnaz,0,0,20,20
1713494525897,ECE 100,A02,507418,Baghdadchi; Saharnaz,19,0,20,1
1713494526923,ECE 111,A01,507420,Staff,27,0,50,23
1713494527950,ECE 197,001,548057,Sievenpiper; Daniel F.,9998,0,9999,1
1713494528976,EDS 115,A00,507243,Choi; Bailey Miyeon,27,0,28,1
1713494530004,EDS 117,A01,494379,Staff,15,0,25,10
1713494531030,EDS 125,A00,507246,Hopkins; Megan Beth,27,0,30,3
1713494532056,EDS 128A,A01,507264,Fargason; Sharon Gayle,26,0,26,0
1713494533088,EDS 128B,A01,507293,Pappas; Elizabeth,30,0,30,0
1713494534116,EDS 139,A00,507294,Fargason; Sharon Gayle,30,0,30,0
1713494534116,EDS 139,B00,507313,Pappas; Elizabeth,30,0,30,0
1713494535142,EDS 201,A00,507315,Staff,18,0,30,12
1713494536170,EDS 203,A01,507317,Halter; Christopher P.,17,0,30,13
1713494537195,EDS 204R,A01,507319,Halter; Christopher P.,0,1,30,30
1713494537195,EDS 204R,B01,507331,Heinzman; Erica M.,22,0,30,8
1713494538220,EDS 206R,A00,507332,Staff,0,2,30,30
1713494538220,EDS 206R,B00,507343,Staff,23,0,30,7
1713494539249,EDS 250,A00,507344,Hemans; Patricia Ann Benitez,27,0,40,13
1713494540278,EDS 281,A00,507345,Daly; Alan J.,18,0,18,0
1713494541306,EDS 284,A00,507350,Daly; Alan J.,16,0,16,0
1713494542330,EDS 286,A00,507359,Fine; Sarah,18,0,18,0
1713494543356,EDS 289C,A01,507361,Daly; Alan J.,18,0,18,0
1713494544381,EDS 290,A00,507366,Hofstetter; Carolyn,15,0,15,0
1713494545408,LIGM 5A,A00,507421,Fischer-Grunski; Eva K,20,0,20,0
1713494546432,LIGM 5B,A00,507423,Fischer-Grunski; Eva K,20,0,20,0
1713494547463,LIGM 5C,A00,507425,Fischer-Grunski; Eva K,20,0,20,0
1713494548493,LIIT 5AS,A00,507427,Carnelos; Chiara,20,0,20,0
1713494549519,LIIT 5BS,A00,507430,Carnelos; Chiara,20,0,20,0
1713494550547,LIIT 5CS,A00,507432,Carnelos; Chiara,20,0,20,0
1713494551573,LISP 5A,A00,507541,Munoz Sanchez; Alicia,14,0,20,6
1713494552598,LISP 5B,A00,507671,Munoz Sanchez; Alicia,12,0,20,8
1713494553628,LISP 5C,A00,507696,Munoz Sanchez; Alicia,11,0,20,9
1713494554651,MAE 197,001,528363,Boechler; Nicholas Sebastia,9998,0,9999,1
1713494555677,MATH 197,001,523477,Kedlaya; Kiran S.,9999,0,9999,0
1713494555677,MATH 197,002,563811,Zhang; Danna,9998,0,9999,1
1713494556780,MCWP 40R,A00,518780,Staff,14,0,20,6
1713494556780,MCWP 40R,B00,518781,Staff,13,0,20,7
1713494556780,MCWP 40R,C00,518783,Staff,9,0,20,11
1713494557811,MCWP 50R,A00,518791,Staff,7,0,20,13
1713494557811,MCWP 50R,B00,518792,Staff,3,0,20,17
1713494557811,MCWP 50R,C00,518793,Staff,7,0,20,13
1713494557811,MCWP 50R,D00,518794,Staff,0,0,20,20
1713494557811,MCWP 50R,E00,518795,Staff,0,0,20,20
1713494557811,MCWP 50R,F00,518796,Staff,11,0,20,9
1713494557811,MCWP 50R,G00,518797,Staff,10,0,20,10
1713494558838,MMW 12R,A01,514034,Herbst; Matthew,4,0,16,12
1713494558838,MMW 12R,A02,514035,Herbst; Matthew,13,0,16,3
1713494559867,MMW 13R,A01,514037,Staff,0,6,16,16
1713494559867,MMW 13R,A02,514039,Staff,0,5,16,16
1713494561922,SIO 295LS,A00,523233,Staff,15,0,30,15
1713494562948,SIO 295S,A00,523232,Staff,15,0,30,15
1713494563973,SOCI 117,A01,494376,Staff,0,2,5,5
1713494564998,WES 237B,A00,494380,Staff,19,0,20,1
1713494567062,AESE 279B,A00,494370,Wade; Jon P,33,0,33,0
1713494568091,AIP 197,001,627712,Vespa; Emanuel Ignacio,9999,0,9999,0
1713494569116,ANAR 135S,A00,494369,Braswell; Geoffrey E.,0,0,0,0
1713494570147,CAT 124RS,A01,519847,Geibel; William,6,0,20,14
1713494571172,CAT 125RS,A01,515971,Geibel; William,6,0,20,14
1713494572199,CLRE 250,A00,511389,Morris; Sheldon,9996,0,9999,3
1713494573226,CLRE 251,A00,507176,Mehta; Ravindra L.,9996,0,9999,3
1713494573226,CLRE 251,B00,511410,Mehta; Ravindra L.,9998,0,9999,1
1713494574254,CLRE 252,A00,507189,Cuomo; Raphael Eduardo,9998,0,9999,1
1713494575280,CLRE 253,A00,507199,Vaida; Florin,9997,0,9999,2
1713494575280,CLRE 253,B00,507202,Vaida; Florin,9999,0,9999,0
1713494576308,CLRE 259,A00,507211,Patel; Hemal,9996,0,9999,3
1713494577335,CLRE 260,A00,507221,Cuomo; Raphael Eduardo,9999,0,9999,0
1713494578364,CLRE 297,001,507242,Cuomo; Raphael Eduardo,9999,0,9999,0
1713494579392,CSE 191,A00,516875,Minnes Kemp; Mor Mia,9999,0,9999,0
1713494580417,CSS 201S,A01,494383,Staff,35,0,35,0
1713494581444,CSS 202S,A01,494387,Staff,35,0,35,0
1713494582469,EAP 100,A00,516065,Staff,9792,0,9999,207
1713494583494,ECE 45,A01,507414,Staff,38,0,60,22
1713494584523,ECE 100,A01,507416,Baghdadchi; Saharnaz,0,0,20,20
1713494584523,ECE 100,A02,507418,Baghdadchi; Saharnaz,19,0,20,1
1713494585547,ECE 111,A01,507420,Staff,27,0,50,23
1713494586577,ECE 197,001,548057,Sievenpiper; Daniel F.,9998,0,9999,1
1713494587600,EDS 115,A00,507243,Choi; Bailey Miyeon,27,0,28,1
1713494588625,EDS 117,A01,494379,Staff,15,0,25,10
1713494589650,EDS 125,A00,507246,Hopkins; Megan Beth,27,0,30,3
1713494590675,EDS 128A,A01,507264,Fargason; Sharon Gayle,26,0,26,0
1713494591700,EDS 128B,A01,507293,Pappas; Elizabeth,30,0,30,0
1713494592728,EDS 139,A00,507294,Fargason; Sharon Gayle,30,0,30,0
1713494592728,EDS 139,B00,507313,Pappas; Elizabeth,30,0,30,0
1713494593756,EDS 201,A00,507315,Staff,18,0,30,12
1713494594781,EDS 203,A01,507317,Halter; Christopher P.,17,0,30,13
1713494595806,EDS 204R,A01,507319,Halter; Christopher P.,0,1,30,30
1713494595806,EDS 204R,B01,507331,Heinzman; Erica M.,22,0,30,8
1713494596831,EDS 206R,A00,507332,Staff,0,2,30,30
1713494596831,EDS 206R,B00,507343,Staff,23,0,30,7
1713494597855,EDS 250,A00,507344,Hemans; Patricia Ann Benitez,27,0,40,13
1713494598878,EDS 281,A00,507345,Daly; Alan J.,18,0,18,0
1713494599906,EDS 284,A00,507350,Daly; Alan J.,16,0,16,0
1713494600932,EDS 286,A00,507359,Fine; Sarah,18,0,18,0
1713494601958,EDS 289C,A01,507361,Daly; Alan J.,18,0,18,0
1713494602983,EDS 290,A00,507366,Hofstetter; Carolyn,15,0,15,0
1713494604008,LIGM 5A,A00,507421,Fischer-Grunski; Eva K,20,0,20,0
1713494605034,LIGM 5B,A00,507423,Fischer-Grunski; Eva K,20,0,20,0
1713494606063,LIGM 5C,A00,507425,Fischer-Grunski; Eva K,20,0,20,0
1713494607090,LIIT 5AS,A00,507427,Carnelos; Chiara,20,0,20,0
1713494608115,LIIT 5BS,A00,507430,Carnelos; Chiara,20,0,20,0
1713494609144,LIIT 5CS,A00,507432,Carnelos; Chiara,20,0,20,0
1713494610170,LISP 5A,A00,507541,Munoz Sanchez; Alicia,14,0,20,6
1713494611199,LISP 5B,A00,507671,Munoz Sanchez; Alicia,12,0,20,8
1713494612225,LISP 5C,A00,507696,Munoz Sanchez; Alicia,11,0,20,9
1713494613251,MAE 197,001,528363,Boechler; Nicholas Sebastia,9998,0,9999,1
1713494614277,MATH 197,001,523477,Kedlaya; Kiran S.,9999,0,9999,0
1713494614277,MATH 197,002,563811,Zhang; Danna,9998,0,9999,1
1713494615303,MCWP 40R,A00,518780,Staff,14,0,20,6
1713494615303,MCWP 40R,B00,518781,Staff,13,0,20,7
1713494615303,MCWP 40R,C00,518783,Staff,9,0,20,11
1713494616333,MCWP 50R,A00,518791,Staff,7,0,20,13
1713494616333,MCWP 50R,B00,518792,Staff,3,0,20,17
1713494616333,MCWP 50R,C00,518793,Staff,7,0,20,13
1713494616333,MCWP 50R,D00,518794,Staff,0,0,20,20
1713494616333,MCWP 50R,E00,518795,Staff,0,0,20,20
1713494616333,MCWP 50R,F00,518796,Staff,11,0,20,9
1713494616333,MCWP 50R,G00,518797,Staff,10,0,20,10
1713494617360,MMW 12R,A01,514034,Herbst; Matthew,4,0,16,12
1713494617360,MMW 12R,A02,514035,Herbst; Matthew,13,0,16,3
1713494618388,MMW 13R,A01,514037,Staff,0,6,16,16
1713494618388,MMW 13R,A02,514039,Staff,0,5,16,16
1713494620445,SIO 295LS,A00,523233,Staff,15,0,30,15
1713494621473,SIO 295S,A00,523232,Staff,15,0,30,15
1713494622499,SOCI 117,A01,494376,Staff,0,2,5,5
1713494623524,WES 237B,A00,494380,Staff,19,0,20,1
1713494625599,AESE 279B,A00,494370,Wade; Jon P,33,0,33,0
1713494626627,AIP 197,001,627712,Vespa; Emanuel Ignacio,9999,0,9999,0
1713494627652,ANAR 135S,A00,494369,Braswell; Geoffrey E.,0,0,0,0
1713494628678,CAT 124RS,A01,519847,Geibel; William,6,0,20,14
1713494629701,CAT 125RS,A01,515971,Geibel; William,6,0,20,14
1713494630729,CLRE 250,A00,511389,Morris; Sheldon,9996,0,9999,3
1713494631753,CLRE 251,A00,507176,Mehta; Ravindra L.,9996,0,9999,3
1713494631753,CLRE 251,B00,511410,Mehta; Ravindra L.,9998,0,9999,1
1713494632777,CLRE 252,A00,507189,Cuomo; Raphael Eduardo,9998,0,9999,1
1713494633803,CLRE 253,A00,507199,Vaida; Florin,9997,0,9999,2
1713494633803,CLRE 253,B00,507202,Vaida; Florin,9999,0,9999,0
1713494634827,CLRE 259,A00,507211,Patel; Hemal,9996,0,9999,3
1713494635851,CLRE 260,A00,507221,Cuomo; Raphael Eduardo,9999,0,9999,0
1713494636877,CLRE 297,001,507242,Cuomo; Raphael Eduardo,9999,0,9999,0
1713494637902,CSE 191,A00,516875,Minnes Kemp; Mor Mia,9999,0,9999,0
1713494638927,CSS 201S,A01,494383,Staff,35,0,35,0
1713494639957,CSS 202S,A01,494387,Staff,35,0,35,0
1713494640983,EAP 100,A00,516065,Staff,9792,0,9999,207
1713494642008,ECE 45,A01,507414,Staff,38,0,60,22
1713494643036,ECE 100,A01,507416,Baghdadchi; Saharnaz,0,0,20,20
1713494643036,ECE 100,A02,507418,Baghdadchi; Saharnaz,19,0,20,1
1713494644062,ECE 111,A01,507420,Staff,27,0,50,23
1713494645668,ECE 197,001,548057,Sievenpiper; Daniel F.,9998,0,9999,1
1713494646696,EDS 115,A00,507243,Choi; Bailey Miyeon,27,0,28,1
1713494647720,EDS 117,A01,494379,Staff,15,0,25,10
1713494648746,EDS 125,A00,507246,Hopkins; Megan Beth,27,0,30,3
1713494649772,EDS 128A,A01,507264,Fargason; Sharon Gayle,26,0,26,0
1713494650798,EDS 128B,A01,507293,Pappas; Elizabeth,30,0,30,0
1713494651823,EDS 139,A00,507294,Fargason; Sharon Gayle,30,0,30,0
1713494651823,EDS 139,B00,507313,Pappas; Elizabeth,30,0,30,0
1713494652852,EDS 201,A00,507315,Staff,18,0,30,12
1713494653882,EDS 203,A01,507317,Halter; Christopher P.,17,0,30,13
1713494654908,EDS 204R,A01,507319,Halter; Christopher P.,0,1,30,30
1713494654908,EDS 204R,B01,507331,Heinzman; Erica M.,22,0,30,8
1713494655934,EDS 206R,A00,507332,Staff,0,2,30,30
1713494655934,EDS 206R,B00,507343,Staff,23,0,30,7
1713494656960,EDS 250,A00,507344,Hemans; Patricia Ann Benitez,27,0,40,13
1713494657988,EDS 281,A00,507345,Daly; Alan J.,18,0,18,0
1713494659013,EDS 284,A00,507350,Daly; Alan J.,16,0,16,0
1713494660042,EDS 286,A00,507359,Fine; Sarah,18,0,18,0
1713494661122,EDS 289C,A01,507361,Daly; Alan J.,18,0,18,0
1713494662151,EDS 290,A00,507366,Hofstetter; Carolyn,15,0,15,0
1713494663177,LIGM 5A,A00,507421,Fischer-Grunski; Eva K,20,0,20,0
1713494664206,LIGM 5B,A00,507423,Fischer-Grunski; Eva K,20,0,20,0
1713494665235,LIGM 5C,A00,507425,Fischer-Grunski; Eva K,20,0,20,0
1713494666261,LIIT 5AS,A00,507427,Carnelos; Chiara,20,0,20,0
1713494667286,LIIT 5BS,A00,507430,Carnelos; Chiara,20,0,20,0
1713494668312,LIIT 5CS,A00,507432,Carnelos; Chiara,20,0,20,0
1713494669338,LISP 5A,A00,507541,Munoz Sanchez; Alicia,14,0,20,6
1713494670365,LISP 5B,A00,507671,Munoz Sanchez; Alicia,12,0,20,8
1713494671389,LISP 5C,A00,507696,Munoz Sanchez; Alicia,11,0,20,9
1713494672414,MAE 197,001,528363,Boechler; Nicholas Sebastia,9998,0,9999,1
1713494673445,MATH 197,001,523477,Kedlaya; Kiran S.,9999,0,9999,0
1713494673445,MATH 197,002,563811,Zhang; Danna,9998,0,9999,1
1713494674469,MCWP 40R,A00,518780,Staff,14,0,20,6
1713494674469,MCWP 40R,B00,518781,Staff,13,0,20,7
1713494674469,MCWP 40R,C00,518783,Staff,9,0,20,11
1713494675499,MCWP 50R,A00,518791,Staff,7,0,20,13
1713494675499,MCWP 50R,B00,518792,Staff,3,0,20,17
1713494675499,MCWP 50R,C00,518793,Staff,7,0,20,13
1713494675499,MCWP 50R,D00,518794,Staff,0,0,20,20
1713494675499,MCWP 50R,E00,518795,Staff,0,0,20,20
1713494675499,MCWP 50R,F00,518796,Staff,11,0,20,9
1713494675499,MCWP 50R,G00,518797,Staff,10,0,20,10
1713494676525,MMW 12R,A01,514034,Herbst; Matthew,4,0,16,12
1713494676525,MMW 12R,A02,514035,Herbst; Matthew,13,0,16,3
1713494677548,MMW 13R,A01,514037,Staff,0,6,16,16
1713494677548,MMW 13R,A02,514039,Staff,0,5,16,16
1713494679603,SIO 295LS,A00,523233,Staff,15,0,30,15
1713494680629,SIO 295S,A00,523232,Staff,15,0,30,15
1713494681657,SOCI 117,A01,494376,Staff,0,2,5,5
1713494682683,WES 237B,A00,494380,Staff,19,0,20,1
1713494684750,AESE 279B,A00,494370,Wade; Jon P,33,0,33,0
1713494685776,AIP 197,001,627712,Vespa; Emanuel Ignacio,9999,0,9999,0
1713494686802,ANAR 135S,A00,494369,Braswell; Geoffrey E.,0,0,0,0
1713494687827,CAT 124RS,A01,519847,Geibel; William,6,0,20,14
1713494688852,CAT 125RS,A01,515971,Geibel; William,6,0,20,14
1713494689883,CLRE 250,A00,511389,Morris; Sheldon,9996,0,9999,3
1713494690910,CLRE 251,A00,507176,Mehta; Ravindra L.,9996,0,9999,3
1713494690910,CLRE 251,B00,511410,Mehta; Ravindra L.,9998,0,9999,1
1713494691936,CLRE 252,A00,507189,Cuomo; Raphael Eduardo,9998,0,9999,1
1713494692961,CLRE 253,A00,507199,Vaida; Florin,9997,0,9999,2
1713494692961,CLRE 253,B00,507202,Vaida; Florin,9999,0,9999,0
1713494693986,CLRE 259,A00,507211,Patel; Hemal,9996,0,9999,3
1713494695011,CLRE 260,A00,507221,Cuomo; Raphael Eduardo,9999,0,9999,0
1713494696039,CLRE 297,001,507242,Cuomo; Raphael Eduardo,9999,0,9999,0
1713494697064,CSE 191,A00,516875,Minnes Kemp; Mor Mia,9999,0,9999,0
1713494698092,CSS 201S,A01,494383,Staff,35,0,35,0
1713494699121,CSS 202S,A01,494387,Staff,35,0,35,0
1713494700145,EAP 100,A00,516065,Staff,9792,0,9999,207
1713494701170,ECE 45,A01,507414,Staff,38,0,60,22
1713494702196,ECE 100,A01,507416,Baghdadchi; Saharnaz,0,0,20,20
1713494702196,ECE 100,A02,507418,Baghdadchi; Saharnaz,19,0,20,1
1713494703224,ECE 111,A01,507420,Staff,27,0,50,23
1713494704250,ECE 197,001,548057,Sievenpiper; Daniel F.,9998,0,9999,1
1713494705278,EDS 115,A00,507243,Choi; Bailey Miyeon,27,0,28,1
1713494706303,EDS 117,A01,494379,Staff,15,0,25,10
1713494707331,EDS 125,A00,507246,Hopkins; Megan Beth,27,0,30,3
1713494708357,EDS 128A,A01,507264,Fargason; Sharon Gayle,26,0,26,0
1713494709387,EDS 128B,A01,507293,Pappas; Elizabeth,30,0,30,0
1713494710410,EDS 139,A00,507294,Fargason; Sharon Gayle,30,0,30,0
1713494710410,EDS 139,B00,507313,Pappas; Elizabeth,30,0,30,0
1713494711435,EDS 201,A00,507315,Staff,18,0,30,12
1713494712461,EDS 203,A01,507317,Halter; Christopher P.,17,0,30,13
1713494713486,EDS 204R,A01,507319,Halter; Christopher P.,0,1,30,30
1713494713486,EDS 204R,B01,507331,Heinzman; Erica M.,22,0,30,8
1713494714513,EDS 206R,A00,507332,Staff,0,2,30,30
1713494714513,EDS 206R,B00,507343,Staff,23,0,30,7
1713494715539,EDS 250,A00,507344,Hemans; Patricia Ann Benitez,27,0,40,13
1713494716562,EDS 281,A00,507345,Daly; Alan J.,18,0,18,0
1713494717588,EDS 284,A00,507350,Daly; Alan J.,16,0,16,0
1713494718616,EDS 286,A00,507359,Fine; Sarah,18,0,18,0
1713494719641,EDS 289C,A01,507361,Daly; Alan J.,18,0,18,0
1713494720670,EDS 290,A00,507366,Hofstetter; Carolyn,15,0,15,0
1713494721696,LIGM 5A,A00,507421,Fischer-Grunski; Eva K,20,0,20,0
1713494722719,LIGM 5B,A00,507423,Fischer-Grunski; Eva K,20,0,20,0
1713494723745,LIGM 5C,A00,507425,Fischer-Grunski; Eva K,20,0,20,0
1713494724770,LIIT 5AS,A00,507427,Carnelos; Chiara,20,0,20,0
1713494725799,LIIT 5BS,A00,507430,Carnelos; Chiara,20,0,20,0
1713494726825,LIIT 5CS,A00,507432,Carnelos; Chiara,20,0,20,0
1713494727851,LISP 5A,A00,507541,Munoz Sanchez; Alicia,14,0,20,6
1713494728877,LISP 5B,A00,507671,Munoz Sanchez; Alicia,12,0,20,8
1713494729907,LISP 5C,A00,507696,Munoz Sanchez; Alicia,11,0,20,9
1713494730935,MAE 197,001,528363,Boechler; Nicholas Sebastia,9998,0,9999,1
1713494731960,MATH 197,001,523477,Kedlaya; Kiran S.,9999,0,9999,0
1713494731960,MATH 197,002,563811,Zhang; Danna,9998,0,9999,1
1713494732987,MCWP 40R,A00,518780,Staff,14,0,20,6
1713494732987,MCWP 40R,B00,518781,Staff,13,0,20,7
1713494732987,MCWP 40R,C00,518783,Staff,9,0,20,11
1713494734012,MCWP 50R,A00,518791,Staff,7,0,20,13
1713494734012,MCWP 50R,B00,518792,Staff,3,0,20,17
1713494734012,MCWP 50R,C00,518793,Staff,7,0,20,13
1713494734012,MCWP 50R,D00,518794,Staff,0,0,20,20
1713494734012,MCWP 50R,E00,518795,Staff,0,0,20,20
1713494734012,MCWP 50R,F00,518796,Staff,11,0,20,9
1713494734012,MCWP 50R,G00,518797,Staff,10,0,20,10
1713494735037,MMW 12R,A01,514034,Herbst; Matthew,4,0,16,12
1713494735037,MMW 12R,A02,514035,Herbst; Matthew,13,0,16,3
1713494736061,MMW 13R,A01,514037,Staff,0,6,16,16
1713494736061,MMW 13R,A02,514039,Staff,0,5,16,16
1713494738114,SIO 295LS,A00,523233,Staff,15,0,30,15
1713494739139,SIO 295S,A00,523232,Staff,15,0,30,15
1713494740168,SOCI 117,A01,494376,Staff,0,2,5,5
1713494741196,WES 237B,A00,494380,Staff,19,0,20,1
1713494743277,AESE 279B,A00,494370,Wade; Jon P,33,0,33,0
1713494744304,AIP 197,001,627712,Vespa; Emanuel Ignacio,9999,0,9999,0
1713494745330,ANAR 135S,A00,494369,Braswell; Geoffrey E.,0,0,0,0
1713494746358,CAT 124RS,A01,519847,Geibel; William,6,0,20,14
1713494747384,CAT 125RS,A01,515971,Geibel; William,6,0,20,14
1713494748412,CLRE 250,A00,511389,Morris; Sheldon,9996,0,9999,3
1713494749443,CLRE 251,A00,507176,Mehta; Ravindra L.,9996,0,9999,3
1713494749443,CLRE 251,B00,511410,Mehta; Ravindra L.,9998,0,9999,1
1713494750471,CLRE 252,A00,507189,Cuomo; Raphael Eduardo,9998,0,9999,1
1713494751502,CLRE 253,A00,507199,Vaida; Florin,9997,0,9999,2
1713494751502,CLRE 253,B00,507202,Vaida; Florin,9999,0,9999,0
1713494752527,CLRE 259,A00,507211,Patel; Hemal,9996,0,9999,3
1713494753555,CLRE 260,A00,507221,Cuomo; Raphael Eduardo,9999,0,9999,0
1713494754580,CLRE 297,001,507242,Cuomo; Raphael Eduardo,9999,0,9999,0
1713494755604,CSE 191,A00,516875,Minnes Kemp; Mor Mia,9999,0,9999,0
1713494756630,CSS 201S,A01,494383,Staff,35,0,35,0
1713494757659,CSS 202S,A01,494387,Staff,35,0,35,0
1713494758688,EAP 100,A00,516065,Staff,9792,0,9999,207
1713494759714,ECE 45,A01,507414,Staff,38,0,60,22
1713494760743,ECE 100,A01,507416,Baghdadchi; Saharnaz,0,0,20,20
1713494760743,ECE 100,A02,507418,Baghdadchi; Saharnaz,19,0,20,1
1713494761768,ECE 111,A01,507420,Staff,27,0,50,23
1713494762795,ECE 197,001,548057,Sievenpiper; Daniel F.,9998,0,9999,1
1713494763825,EDS 115,A00,507243,Choi; Bailey Miyeon,27,0,28,1
1713494764907,EDS 117,A01,494379,Staff,15,0,25,10
1713494765933,EDS 125,A00,507246,Hopkins; Megan Beth,27,0,30,3
1713494766958,EDS 128A,A01,507264,Fargason; Sharon Gayle,26,0,26,0
1713494767987,EDS 128B,A01,507293,Pappas; Elizabeth,30,0,30,0
1713494769012,EDS 139,A00,507294,Fargason; Sharon Gayle,30,0,30,0
1713494769012,EDS 139,B00,507313,Pappas; Elizabeth,30,0,30,0
1713494770038,EDS 201,A00,507315,Staff,18,0,30,12
1713494771064,EDS 203,A01,507317,Halter; Christopher P.,17,0,30,13
1713494772093,EDS 204R,A01,507319,Halter; Christopher P.,0,1,30,30
1713494772093,EDS 204R,B01,507331,Heinzman; Erica M.,22,0,30,8
1713494773117,EDS 206R,A00,507332,Staff,0,2,30,30
1713494773117,EDS 206R,B00,507343,Staff,23,0,30,7
1713494774146,EDS 250,A00,507344,Hemans; Patricia Ann Benitez,27,0,40,13
1713494775172,EDS 281,A00,507345,Daly; Alan J.,18,0,18,0
1713494776198,EDS 284,A00,507350,Daly; Alan J.,16,0,16,0
1713494777224,EDS 286,A00,507359,Fine; Sarah,18,0,18,0
1713494778251,EDS 289C,A01,507361,Daly; Alan J.,18,0,18,0
1713494779277,EDS 290,A00,507366,Hofstetter; Carolyn,15,0,15,0
1713494780303,LIGM 5A,A00,507421,Fischer-Grunski; Eva K,20,0,20,0
1713494781331,LIGM 5B,A00,507423,Fischer-Grunski; Eva K,20,0,20,0
1713494782355,LIGM 5C,A00,507425,Fischer-Grunski; Eva K,20,0,20,0
1713494783437,LIIT 5AS,A00,507427,Carnelos; Chiara,20,0,20,0
1713494784463,LIIT 5BS,A00,507430,Carnelos; Chiara,20,0,20,0
1713494785491,LIIT 5CS,A00,507432,Carnelos; Chiara,20,0,20,0
1713494786518,LISP 5A,A00,507541,Munoz Sanchez; Alicia,14,0,20,6
1713494787543,LISP 5B,A00,507671,Munoz Sanchez; Alicia,12,0,20,8
1713494788568,LISP 5C,A00,507696,Munoz Sanchez; Alicia,11,0,20,9
1713494789595,MAE 197,001,528363,Boechler; Nicholas Sebastia,9998,0,9999,1
1713494790621,MATH 197,001,523477,Kedlaya; Kiran S.,9999,0,9999,0
1713494790621,MATH 197,002,563811,Zhang; Danna,9998,0,9999,1
1713494791647,MCWP 40R,A00,518780,Staff,14,0,20,6
1713494791647,MCWP 40R,B00,518781,Staff,13,0,20,7
1713494791647,MCWP 40R,C00,518783,Staff,9,0,20,11
1713494792673,MCWP 50R,A00,518791,Staff,7,0,20,13
1713494792673,MCWP 50R,B00,518792,Staff,3,0,20,17
1713494792673,MCWP 50R,C00,518793,Staff,7,0,20,13
1713494792673,MCWP 50R,D00,518794,Staff,0,0,20,20
1713494792673,MCWP 50R,E00,518795,Staff,0,0,20,20
1713494792673,MCWP 50R,F00,518796,Staff,11,0,20,9
1713494792673,MCWP 50R,G00,518797,Staff,10,0,20,10
1713494793698,MMW 12R,A01,514034,Herbst; Matthew,4,0,16,12
1713494793698,MMW 12R,A02,514035,Herbst; Matthew,13,0,16,3
1713494794727,MMW 13R,A01,514037,Staff,0,6,16,16
1713494794727,MMW 13R,A02,514039,Staff,0,5,16,16
1713494796784,SIO 295LS,A00,523233,Staff,15,0,30,15
1713494797809,SIO 295S,A00,523232,Staff,15,0,30,15
1713494798838,SOCI 117,A01,494376,Staff,0,2,5,5
1713494799865,WES 237B,A00,494380,Staff,19,0,20,1
1713494801923,AESE 279B,A00,494370,Wade; Jon P,33,0,33,0
1713494802948,AIP 197,001,627712,Vespa; Emanuel Ignacio,9999,0,9999,0
1713494803976,ANAR 135S,A00,494369,Braswell; Geoffrey E.,0,0,0,0
1713494805001,CAT 124RS,A01,519847,Geibel; William,6,0,20,14
1713494806027,CAT 125RS,A01,515971,Geibel; William,6,0,20,14
1713494807057,CLRE 250,A00,511389,Morris; Sheldon,9996,0,9999,3
1713494808083,CLRE 251,A00,507176,Mehta; Ravindra L.,9996,0,9999,3
1713494808083,CLRE 251,B00,511410,Mehta; Ravindra L.,9998,0,9999,1
1713494809113,CLRE 252,A00,507189,Cuomo; Raphael Eduardo,9998,0,9999,1
1713494810139,CLRE 253,A00,507199,Vaida; Florin,9997,0,9999,2
1713494810139,CLRE 253,B00,507202,Vaida; Florin,9999,0,9999,0
1713494811167,CLRE 259,A00,507211,Patel; Hemal,9996,0,9999,3
1713494812195,CLRE 260,A00,507221,Cuomo; Raphael Eduardo,9999,0,9999,0
1713494813224,CLRE 297,001,507242,Cuomo; Raphael Eduardo,9999,0,9999,0
1713494814253,CSE 191,A00,516875,Minnes Kemp; Mor Mia,9999,0,9999,0
1713494815284,CSS 201S,A01,494383,Staff,35,0,35,0
1713494816310,CSS 202S,A01,494387,Staff,35,0,35,0
1713494817335,EAP 100,A00,516065,Staff,9792,0,9999,207
1713494818360,ECE 45,A01,507414,Staff,38,0,60,22
1713494819390,ECE 100,A01,507416,Baghdadchi; Saharnaz,0,0,20,20
1713494819390,ECE 100,A02,507418,Baghdadchi; Saharnaz,19,0,20,1
1713494820423,ECE 111,A01,507420,Staff,27,0,50,23
1713494821446,ECE 197,001,548057,Sievenpiper; Daniel F.,9998,0,9999,1
1713494822474,EDS 115,A00,507243,Choi; Bailey Miyeon,27,0,28,1
1713494823503,EDS 117,A01,494379,Staff,15,0,25,10
1713494824534,EDS 125,A00,507246,Hopkins; Megan Beth,27,0,30,3
1713494825559,EDS 128A,A01,507264,Fargason; Sharon Gayle,26,0,26,0
1713494826587,EDS 128B,A01,507293,Pappas; Elizabeth,30,0,30,0
1713494827614,EDS 139,A00,507294,Fargason; Sharon Gayle,30,0,30,0
1713494827614,EDS 139,B00,507313,Pappas; Elizabeth,30,0,30,0
1713494828644,EDS 201,A00,507315,Staff,18,0,30,12
1713494829673,EDS 203,A01,507317,Halter; Christopher P.,17,0,30,13
1713494830702,EDS 204R,A01,507319,Halter; Christopher P.,0,1,30,30
1713494830702,EDS 204R,B01,507331,Heinzman; Erica M.,22,0,30,8
1713494831727,EDS 206R,A00,507332,Staff,0,2,30,30
1713494831727,EDS 206R,B00,507343,Staff,23,0,30,7
1713494832757,EDS 250,A00,507344,Hemans; Patricia Ann Benitez,27,0,40,13
1713494833782,EDS 281,A00,507345,Daly; Alan J.,18,0,18,0
1713494834810,EDS 284,A00,507350,Daly; Alan J.,16,0,16,0
1713494835839,EDS 286,A00,507359,Fine; Sarah,18,0,18,0
1713494836867,EDS 289C,A01,507361,Daly; Alan J.,18,0,18,0
1713494837892,EDS 290,A00,507366,Hofstetter; Carolyn,15,0,15,0
1713494838923,LIGM 5A,A00,507421,Fischer-Grunski; Eva K,20,0,20,0
1713494839949,LIGM 5B,A00,507423,Fischer-Grunski; Eva K,20,0,20,0
1713494840979,LIGM 5C,A00,507425,Fischer-Grunski; Eva K,20,0,20,0
1713494842005,LIIT 5AS,A00,507427,Carnelos; Chiara,20,0,20,0
1713494843031,LIIT 5BS,A00,507430,Carnelos; Chiara,20,0,20,0
1713494844057,LIIT 5CS,A00,507432,Carnelos; Chiara,20,0,20,0
1713494845083,LISP 5A,A00,507541,Munoz Sanchez; Alicia,14,0,20,6
1713494846111,LISP 5B,A00,507671,Munoz Sanchez; Alicia,12,0,20,8
1713494847136,LISP 5C,A00,507696,Munoz Sanchez; Alicia,11,0,20,9
1713494848161,MAE 197,001,528363,Boechler; Nicholas Sebastia,9998,0,9999,1
1713494849190,MATH 197,001,523477,Kedlaya; Kiran S.,9999,0,9999,0
1713494849190,MATH 197,002,563811,Zhang; Danna,9998,0,9999,1
1713494850215,MCWP 40R,A00,518780,Staff,14,0,20,6
1713494850215,MCWP 40R,B00,518781,Staff,13,0,20,7
1713494850215,MCWP 40R,C00,518783,Staff,9,0,20,11
1713494851243,MCWP 50R,A00,518791,Staff,7,0,20,13
1713494851243,MCWP 50R,B00,518792,Staff,3,0,20,17
1713494851243,MCWP 50R,C00,518793,Staff,7,0,20,13
1713494851243,MCWP 50R,D00,518794,Staff,0,0,20,20
1713494851243,MCWP 50R,E00,518795,Staff,0,0,20,20
1713494851243,MCWP 50R,F00,518796,Staff,11,0,20,9
1713494851243,MCWP 50R,G00,518797,Staff,10,0,20,10
1713494852268,MMW 12R,A01,514034,Herbst; Matthew,4,0,16,12
1713494852268,MMW 12R,A02,514035,Herbst; Matthew,13,0,16,3
1713494853296,MMW 13R,A01,514037,Staff,0,6,16,16
1713494853296,MMW 13R,A02,514039,Staff,0,5,16,16
1713494855350,SIO 295LS,A00,523233,Staff,15,0,30,15
1713494856377,SIO 295S,A00,523232,Staff,15,0,30,15
1713494857402,SOCI 117,A01,494376,Staff,0,2,5,5
1713494858427,WES 237B,A00,494380,Staff,19,0,20,1
1713494860495,AESE 279B,A00,494370,Wade; Jon P,33,0,33,0
1713494861520,AIP 197,001,627712,Vespa; Emanuel Ignacio,9999,0,9999,0
1713494862546,ANAR 135S,A00,494369,Braswell; Geoffrey E.,0,0,0,0
1713494863572,CAT 124RS,A01,519847,Geibel; William,6,0,20,14
1713494864597,CAT 125RS,A01,515971,Geibel; William,6,0,20,14
1713494865623,CLRE 250,A00,511389,Morris; Sheldon,9996,0,9999,3
1713494866651,CLRE 251,A00,507176,Mehta; Ravindra L.,9996,0,9999,3
1713494866651,CLRE 251,B00,511410,Mehta; Ravindra L.,9998,0,9999,1
1713494867679,CLRE 252,A00,507189,Cuomo; Raphael Eduardo,9998,0,9999,1
1713494868758,CLRE 253,A00,507199,Vaida; Florin,9997,0,9999,2
1713494868758,CLRE 253,B00,507202,Vaida; Florin,9999,0,9999,0
1713494869786,CLRE 259,A00,507211,Patel; Hemal,9996,0,9999,3
1713494870812,CLRE 260,A00,507221,Cuomo; Raphael Eduardo,9999,0,9999,0
1713494871840,CLRE 297,001,507242,Cuomo; Raphael Eduardo,9999,0,9999,0
1713494872865,CSE 191,A00,516875,Minnes Kemp; Mor Mia,9999,0,9999,0
1713494873890,CSS 201S,A01,494383,Staff,35,0,35,0
1713494874912,CSS 202S,A01,494387,Staff,35,0,35,0
1713494875935,EAP 100,A00,516065,Staff,9792,0,9999,207
1713494876964,ECE 45,A01,507414,Staff,38,0,60,22
1713494877990,ECE 100,A01,507416,Baghdadchi; Saharnaz,0,0,20,20
1713494877990,ECE 100,A02,507418,Baghdadchi; Saharnaz,19,0,20,1
1713494879026,ECE 111,A01,507420,Staff,27,0,50,23
1713494880054,ECE 197,001,548057,Sievenpiper; Daniel F.,9998,0,9999,1
1713494881080,EDS 115,A00,507243,Choi; Bailey Miyeon,27,0,28,1
1713494882109,EDS 117,A01,494379,Staff,15,0,25,10
1713494883140,EDS 125,A00,507246,Hopkins; Megan Beth,27,0,30,3
1713494884166,EDS 128A,A01,507264,Fargason; Sharon Gayle,26,0,26,0
1713494885194,EDS 128B,A01,507293,Pappas; Elizabeth,30,0,30,0
1713494886224,EDS 139,A00,507294,Fargason; Sharon Gayle,30,0,30,0
1713494886224,EDS 139,B00,507313,Pappas; Elizabeth,30,0,30,0
1713494887250,EDS 201,A00,507315,Staff,18,0,30,12
1713494888290,EDS 203,A01,507317,Halter; Christopher P.,17,0,30,13
1713494889318,EDS 204R,A01,507319,Halter; Christopher P.,0,1,30,30
1713494889318,EDS 204R,B01,507331,Heinzman; Erica M.,22,0,30,8
1713494890345,EDS 206R,A00,507332,Staff,0,2,30,30
1713494890345,EDS 206R,B00,507343,Staff,23,0,30,7
1713494891373,EDS 250,A00,507344,Hemans; Patricia Ann Benitez,27,0,40,13
1713494892401,EDS 281,A00,507345,Daly; Alan J.,18,0,18,0
1713494893428,EDS 284,A00,507350,Daly; Alan J.,16,0,16,0
1713494894456,EDS 286,A00,507359,Fine; Sarah,18,0,18,0
1713494895481,EDS 289C,A01,507361,Daly; Alan J.,18,0,18,0
1713494896511,EDS 290,A00,507366,Hofstetter; Carolyn,15,0,15,0
1713494897538,LIGM 5A,A00,507421,Fischer-Grunski; Eva K,20,0,20,0
1713494898567,LIGM 5B,A00,507423,Fischer-Grunski; Eva K,20,0,20,0
1713494899592,LIGM 5C,A00,507425,Fischer-Grunski; Eva K,20,0,20,0
1713494900624,LIIT 5AS,A00,507427,Carnelos; Chiara,20,0,20,0
1713494901649,LIIT 5BS,A00,507430,Carnelos; Chiara,20,0,20,0
1713494902677,LIIT 5CS,A00,507432,Carnelos; Chiara,20,0,20,0
1713494903706,LISP 5A,A00,507541,Munoz Sanchez; Alicia,14,0,20,6
1713494904735,LISP 5B,A00,507671,Munoz Sanchez; Alicia,12,0,20,8
1713494905764,LISP 5C,A00,507696,Munoz Sanchez; Alicia,11,0,20,9
1713494906792,MAE 197,001,528363,Boechler; Nicholas Sebastia,9998,0,9999,1
1713494907824,MATH 197,001,523477,Kedlaya; Kiran S.,9999,0,9999,0
1713494907824,MATH 197,002,563811,Zhang; Danna,9998,0,9999,1
1713494908849,MCWP 40R,A00,518780,Staff,14,0,20,6
1713494908849,MCWP 40R,B00,518781,Staff,13,0,20,7
1713494908849,MCWP 40R,C00,518783,Staff,9,0,20,11
1713494909875,MCWP 50R,A00,518791,Staff,7,0,20,13
1713494909875,MCWP 50R,B00,518792,Staff,3,0,20,17
1713494909875,MCWP 50R,C00,518793,Staff,7,0,20,13
1713494909875,MCWP 50R,D00,518794,Staff,0,0,20,20
1713494909875,MCWP 50R,E00,518795,Staff,0,0,20,20
1713494909875,MCWP 50R,F00,518796,Staff,11,0,20,9
1713494909875,MCWP 50R,G00,518797,Staff,10,0,20,10
1713494910901,MMW 12R,A01,514034,Herbst; Matthew,4,0,16,12
1713494910901,MMW 12R,A02,514035,Herbst; Matthew,13,0,16,3
1713494911926,MMW 13R,A01,514037,Staff,0,6,16,16
1713494911926,MMW 13R,A02,514039,Staff,0,5,16,16
1713494913979,SIO 295LS,A00,523233,Staff,15,0,30,15
1713494915006,SIO 295S,A00,523232,Staff,15,0,30,15
1713494916032,SOCI 117,A01,494376,Staff,0,2,5,5
1713494917057,WES 237B,A00,494380,Staff,19,0,20,1
1713494919122,AESE 279B,A00,494370,Wade; Jon P,33,0,33,0
1713494920147,AIP 197,001,627712,Vespa; Emanuel Ignacio,9999,0,9999,0
1713494921174,ANAR 135S,A00,494369,Braswell; Geoffrey E.,0,0,0,0
1713494922200,CAT 124RS,A01,519847,Geibel; William,6,0,20,14
1713494923229,CAT 125RS,A01,515971,Geibel; William,6,0,20,14
1713494924254,CLRE 250,A00,511389,Morris; Sheldon,9996,0,9999,3
1713494925280,CLRE 251,A00,507176,Mehta; Ravindra L.,9996,0,9999,3
1713494925280,CLRE 251,B00,511410,Mehta; Ravindra L.,9998,0,9999,1
1713494926308,CLRE 252,A00,507189,Cuomo; Raphael Eduardo,9998,0,9999,1
1713494927333,CLRE 253,A00,507199,Vaida; Florin,9997,0,9999,2
1713494927333,CLRE 253,B00,507202,Vaida; Florin,9999,0,9999,0
1713494928362,CLRE 259,A00,507211,Patel; Hemal,9996,0,9999,3
1713494929389,CLRE 260,A00,507221,Cuomo; Raphael Eduardo,9999,0,9999,0
1713494930416,CLRE 297,001,507242,Cuomo; Raphael Eduardo,9999,0,9999,0
1713494931445,CSE 191,A00,516875,Minnes Kemp; Mor Mia,9999,0,9999,0
1713494932469,CSS 201S,A01,494383,Staff,35,0,35,0
1713494933498,CSS 202S,A01,494387,Staff,35,0,35,0
1713494934524,EAP 100,A00,516065,Staff,9792,0,9999,207
1713494935550,ECE 45,A01,507414,Staff,38,0,60,22
1713494936575,ECE 100,A01,507416,Baghdadchi; Saharnaz,0,0,20,20
1713494936575,ECE 100,A02,507418,Baghdadchi; Saharnaz,19,0,20,1
1713494937602,ECE 111,A01,507420,Staff,27,0,50,23
1713494938629,ECE 197,001,548057,Sievenpiper; Daniel F.,9998,0,9999,1
1713494939655,EDS 115,A00,507243,Choi; Bailey Miyeon,27,0,28,1
1713494940683,EDS 117,A01,494379,Staff,15,0,25,10
1713494941707,EDS 125,A00,507246,Hopkins; Megan Beth,27,0,30,3
1713494942733,EDS 128A,A01,507264,Fargason; Sharon Gayle,26,0,26,0
1713494943760,EDS 128B,A01,507293,Pappas; Elizabeth,30,0,30,0
1713494944789,EDS 139,A00,507294,Fargason; Sharon Gayle,30,0,30,0
1713494944789,EDS 139,B00,507313,Pappas; Elizabeth,30,0,30,0
1713494945816,EDS 201,A00,507315,Staff,18,0,30,12
1713494946847,EDS 203,A01,507317,Halter; Christopher P.,17,0,30,13
1713494947873,EDS 204R,A01,507319,Halter; Christopher P.,0,1,30,30
1713494947873,EDS 204R,B01,507331,Heinzman; Erica M.,22,0,30,8
1713494948899,EDS 206R,A00,507332,Staff,0,2,30,30
1713494948899,EDS 206R,B00,507343,Staff,23,0,30,7
1713494949927,EDS 250,A00,507344,Hemans; Patricia Ann Benitez,27,0,40,13
1713494950955,EDS 281,A00,507345,Daly; Alan J.,18,0,18,0
1713494951983,EDS 284,A00,507350,Daly; Alan J.,16,0,16,0
1713494953013,EDS 286,A00,507359,Fine; Sarah,18,0,18,0
1713494954038,EDS 289C,A01,507361,Daly; Alan J.,18,0,18,0
1713494955064,EDS 290,A00,507366,Hofstetter; Carolyn,15,0,15,0
1713494956090,LIGM 5A,A00,507421,Fischer-Grunski; Eva K,20,0,20,0
1713494957116,LIGM 5B,A00,507423,Fischer-Grunski; Eva K,20,0,20,0
1713494958142,LIGM 5C,A00,507425,Fischer-Grunski; Eva K,20,0,20,0
1713494959168,LIIT 5AS,A00,507427,Carnelos; Chiara,20,0,20,0
1713494960197,LIIT 5BS,A00,507430,Carnelos; Chiara,20,0,20,0
1713494961227,LIIT 5CS,A00,507432,Carnelos; Chiara,20,0,20,0
1713494962259,LISP 5A,A00,507541,Munoz Sanchez; Alicia,14,0,20,6
1713494963285,LISP 5B,A00,507671,Munoz Sanchez; Alicia,12,0,20,8
1713494964310,LISP 5C,A00,507696,Munoz Sanchez; Alicia,11,0,20,9
1713494965340,MAE 197,001,528363,Boechler; Nicholas Sebastia,9998,0,9999,1
1713494966372,MATH 197,001,523477,Kedlaya; Kiran S.,9999,0,9999,0
1713494966372,MATH 197,002,563811,Zhang; Danna,9998,0,9999,1
1713494967403,MCWP 40R,A00,518780,Staff,14,0,20,6
1713494967403,MCWP 40R,B00,518781,Staff,13,0,20,7
1713494967403,MCWP 40R,C00,518783,Staff,9,0,20,11
1713494968433,MCWP 50R,A00,518791,Staff,7,0,20,13
1713494968433,MCWP 50R,B00,518792,Staff,3,0,20,17
1713494968433,MCWP 50R,C00,518793,Staff,7,0,20,13
1713494968433,MCWP 50R,D00,518794,Staff,0,0,20,20
1713494968433,MCWP 50R,E00,518795,Staff,0,0,20,20
1713494968433,MCWP 50R,F00,518796,Staff,11,0,20,9
1713494968433,MCWP 50R,G00,518797,Staff,10,0,20,10
1713494969459,MMW 12R,A01,514034,Herbst; Matthew,4,0,16,12
1713494969459,MMW 12R,A02,514035,Herbst; Matthew,13,0,16,3
1713494970486,MMW 13R,A01,514037,Staff,0,6,16,16
1713494970486,MMW 13R,A02,514039,Staff,0,5,16,16
1713494972591,SIO 295LS,A00,523233,Staff,15,0,30,15
1713494973618,SIO 295S,A00,523232,Staff,15,0,30,15
1713494974645,SOCI 117,A01,494376,Staff,0,2,5,5
1713494975671,WES 237B,A00,494380,Staff,19,0,20,1
1713494977740,AESE 279B,A00,494370,Wade; Jon P,33,0,33,0
1713494978768,AIP 197,001,627712,Vespa; Emanuel Ignacio,9999,0,9999,0
1713494979796,ANAR 135S,A00,494369,Braswell; Geoffrey E.,0,0,0,0
1713494980822,CAT 124RS,A01,519847,Geibel; William,6,0,20,14
1713494981859,CAT 125RS,A01,515971,Geibel; William,6,0,20,14
1713494982887,CLRE 250,A00,511389,Morris; Sheldon,9996,0,9999,3
1713494983913,CLRE 251,A00,507176,Mehta; Ravindra L.,9996,0,9999,3
1713494983913,CLRE 251,B00,511410,Mehta; Ravindra L.,9998,0,9999,1
1713494984939,CLRE 252,A00,507189,Cuomo; Raphael Eduardo,9998,0,9999,1
1713494985965,CLRE 253,A00,507199,Vaida; Florin,9997,0,9999,2
1713494985965,CLRE 253,B00,507202,Vaida; Florin,9999,0,9999,0
1713494986995,CLRE 259,A00,507211,Patel; Hemal,9996,0,9999,3
1713494988023,CLRE 260,A00,507221,Cuomo; Raphael Eduardo,9999,0,9999,0
1713494989051,CLRE 297,001,507242,Cuomo; Raphael Eduardo,9999,0,9999,0
1713494990080,CSE 191,A00,516875,Minnes Kemp; Mor Mia,9999,0,9999,0
1713494991106,CSS 201S,A01,494383,Staff,35,0,35,0
1713494992132,CSS 202S,A01,494387,Staff,35,0,35,0
1713494993157,EAP 100,A00,516065,Staff,9792,0,9999,207
1713494994186,ECE 45,A01,507414,Staff,38,0,60,22
1713494995211,ECE 100,A01,507416,Baghdadchi; Saharnaz,0,0,20,20
1713494995211,ECE 100,A02,507418,Baghdadchi; Saharnaz,19,0,20,1
1713494996237,ECE 111,A01,507420,Staff,27,0,50,23
1713494997262,ECE 197,001,548057,Sievenpiper; Daniel F.,9998,0,9999,1
1713494998288,EDS 115,A00,507243,Choi; Bailey Miyeon,27,0,28,1
1713494999317,EDS 117,A01,494379,Staff,15,0,25,10
1713495000348,EDS 125,A00,507246,Hopkins; Megan Beth,27,0,30,3
1713495001375,EDS 128A,A01,507264,Fargason; Sharon Gayle,26,0,26,0
1713495002400,EDS 128B,A01,507293,Pappas; Elizabeth,30,0,30,0
1713495003426,EDS 139,A00,507294,Fargason; Sharon Gayle,30,0,30,0
1713495003426,EDS 139,B00,507313,Pappas; Elizabeth,30,0,30,0
1713495004454,EDS 201,A00,507315,Staff,18,0,30,12
1713495005481,EDS 203,A01,507317,Halter; Christopher P.,17,0,30,13
1713495006509,EDS 204R,A01,507319,Halter; Christopher P.,0,1,30,30
1713495006509,EDS 204R,B01,507331,Heinzman; Erica M.,22,0,30,8
1713495007534,EDS 206R,A00,507332,Staff,0,2,30,30
1713495007534,EDS 206R,B00,507343,Staff,23,0,30,7
1713495008564,EDS 250,A00,507344,Hemans; Patricia Ann Benitez,27,0,40,13
1713495009589,EDS 281,A00,507345,Daly; Alan J.,18,0,18,0
1713495010614,EDS 284,A00,507350,Daly; Alan J.,16,0,16,0
1713495011642,EDS 286,A00,507359,Fine; Sarah,18,0,18,0
1713495012669,EDS 289C,A01,507361,Daly; Alan J.,18,0,18,0
1713495013694,EDS 290,A00,507366,Hofstetter; Carolyn,15,0,15,0
1713495014723,LIGM 5A,A00,507421,Fischer-Grunski; Eva K,20,0,20,0
1713495015748,LIGM 5B,A00,507423,Fischer-Grunski; Eva K,20,0,20,0
1713495016774,LIGM 5C,A00,507425,Fischer-Grunski; Eva K,20,0,20,0
1713495017800,LIIT 5AS,A00,507427,Carnelos; Chiara,20,0,20,0
1713495018826,LIIT 5BS,A00,507430,Carnelos; Chiara,20,0,20,0
1713495019851,LIIT 5CS,A00,507432,Carnelos; Chiara,20,0,20,0
1713495020882,LISP 5A,A00,507541,Munoz Sanchez; Alicia,14,0,20,6
1713495021907,LISP 5B,A00,507671,Munoz Sanchez; Alicia,12,0,20,8
1713495022936,LISP 5C,A00,507696,Munoz Sanchez; Alicia,11,0,20,9
1713495023965,MAE 197,001,528363,Boechler; Nicholas Sebastia,9998,0,9999,1
1713495024990,MATH 197,001,523477,Kedlaya; Kiran S.,9999,0,9999,0
1713495024990,MATH 197,002,563811,Zhang; Danna,9998,0,9999,1
1713495026018,MCWP 40R,A00,518780,Staff,14,0,20,6
1713495026018,MCWP 40R,B00,518781,Staff,13,0,20,7
1713495026018,MCWP 40R,C00,518783,Staff,9,0,20,11
1713495027048,MCWP 50R,A00,518791,Staff,7,0,20,13
1713495027048,MCWP 50R,B00,518792,Staff,3,0,20,17
1713495027048,MCWP 50R,C00,518793,Staff,7,0,20,13
1713495027048,MCWP 50R,D00,518794,Staff,0,0,20,20
1713495027048,MCWP 50R,E00,518795,Staff,0,0,20,20
1713495027048,MCWP 50R,F00,518796,Staff,11,0,20,9
1713495027048,MCWP 50R,G00,518797,Staff,10,0,20,10
1713495028073,MMW 12R,A01,514034,Herbst; Matthew,4,0,16,12
1713495028073,MMW 12R,A02,514035,Herbst; Matthew,13,0,16,3
1713495029106,MMW 13R,A01,514037,Staff,0,6,16,16
1713495029106,MMW 13R,A02,514039,Staff,0,5,16,16
1713495031160,SIO 295LS,A00,523233,Staff,15,0,30,15
1713495032187,SIO 295S,A00,523232,Staff,15,0,30,15
1713495033213,SOCI 117,A01,494376,Staff,0,2,5,5
1713495034238,WES 237B,A00,494380,Staff,19,0,20,1
1713495036301,AESE 279B,A00,494370,Wade; Jon P,33,0,33,0
1713495037328,AIP 197,001,627712,Vespa; Emanuel Ignacio,9999,0,9999,0
1713495038354,ANAR 135S,A00,494369,Braswell; Geoffrey E.,0,0,0,0
1713495039379,CAT 124RS,A01,519847,Geibel; William,6,0,20,14
1713495040406,CAT 125RS,A01,515971,Geibel; William,6,0,20,14
1713495041432,CLRE 250,A00,511389,Morris; Sheldon,9996,0,9999,3
1713495042459,CLRE 251,A00,507176,Mehta; Ravindra L.,9996,0,9999,3
1713495042459,CLRE 251,B00,511410,Mehta; Ravindra L.,9998,0,9999,1
1713495043485,CLRE 252,A00,507189,Cuomo; Raphael Eduardo,9998,0,9999,1
1713495044512,CLRE 253,A00,507199,Vaida; Florin,9997,0,9999,2
1713495044512,CLRE 253,B00,507202,Vaida; Florin,9999,0,9999,0
1713495045542,CLRE 259,A00,507211,Patel; Hemal,9996,0,9999,3
1713495046567,CLRE 260,A00,507221,Cuomo; Raphael Eduardo,9999,0,9999,0
1713495047592,CLRE 297,001,507242,Cuomo; Raphael Eduardo,9999,0,9999,0
1713495048618,CSE 191,A00,516875,Minnes Kemp; Mor Mia,9999,0,9999,0
1713495049647,CSS 201S,A01,494383,Staff,35,0,35,0
1713495050674,CSS 202S,A01,494387,Staff,35,0,35,0
1713495051701,EAP 100,A00,516065,Staff,9792,0,9999,207
1713495052727,ECE 45,A01,507414,Staff,38,0,60,22
1713495053753,ECE 100,A01,507416,Baghdadchi; Saharnaz,0,0,20,20
1713495053753,ECE 100,A02,507418,Baghdadchi; Saharnaz,19,0,20,1
1713495054778,ECE 111,A01,507420,Staff,27,0,50,23
1713495055804,ECE 197,001,548057,Sievenpiper; Daniel F.,9998,0,9999,1
1713495056830,EDS 115,A00,507243,Choi; Bailey Miyeon,27,0,28,1
1713495057860,EDS 117,A01,494379,Staff,15,0,25,10
1713495058890,EDS 125,A00,507246,Hopkins; Megan Beth,27,0,30,3
1713495059919,EDS 128A,A01,507264,Fargason; Sharon Gayle,26,0,26,0
1713495060945,EDS 128B,A01,507293,Pappas; Elizabeth,30,0,30,0
1713495061971,EDS 139,A00,507294,Fargason; Sharon Gayle,30,0,30,0
1713495061971,EDS 139,B00,507313,Pappas; Elizabeth,30,0,30,0
1713495062996,EDS 201,A00,507315,Staff,18,0,30,12
1713495064021,EDS 203,A01,507317,Halter; Christopher P.,17,0,30,13
1713495065047,EDS 204R,A01,507319,Halter; Christopher P.,0,1,30,30
1713495065047,EDS 204R,B01,507331,Heinzman; Erica M.,22,0,30,8
1713495066072,EDS 206R,A00,507332,Staff,0,2,30,30
1713495066072,EDS 206R,B00,507343,Staff,23,0,30,7
1713495067100,EDS 250,A00,507344,Hemans; Patricia Ann Benitez,27,0,40,13
1713495068124,EDS 281,A00,507345,Daly; Alan J.,18,0,18,0
1713495069152,EDS 284,A00,507350,Daly; Alan J.,16,0,16,0
1713495070181,EDS 286,A00,507359,Fine; Sarah,18,0,18,0
1713495071209,EDS 289C,A01,507361,Daly; Alan J.,18,0,18,0
1713495072234,EDS 290,A00,507366,Hofstetter; Carolyn,15,0,15,0
1713495073259,LIGM 5A,A00,507421,Fischer-Grunski; Eva K,20,0,20,0
1713495074289,LIGM 5B,A00,507423,Fischer-Grunski; Eva K,20,0,20,0
1713495075318,LIGM 5C,A00,507425,Fischer-Grunski; Eva K,20,0,20,0
1713495076400,LIIT 5AS,A00,507427,Carnelos; Chiara,20,0,20,0
1713495077425,LIIT 5BS,A00,507430,Carnelos; Chiara,20,0,20,0
1713495078451,LIIT 5CS,A00,507432,Carnelos; Chiara,20,0,20,0
1713495079475,LISP 5A,A00,507541,Munoz Sanchez; Alicia,14,0,20,6
1713495080501,LISP 5B,A00,507671,Munoz Sanchez; Alicia,12,0,20,8
1713495081530,LISP 5C,A00,507696,Munoz Sanchez; Alicia,11,0,20,9
1713495082559,MAE 197,001,528363,Boechler; Nicholas Sebastia,9998,0,9999,1
1713495083589,MATH 197,001,523477,Kedlaya; Kiran S.,9999,0,9999,0
1713495083589,MATH 197,002,563811,Zhang; Danna,9998,0,9999,1
1713495084614,MCWP 40R,A00,518780,Staff,14,0,20,6
1713495084614,MCWP 40R,B00,518781,Staff,13,0,20,7
1713495084614,MCWP 40R,C00,518783,Staff,9,0,20,11
1713495085643,MCWP 50R,A00,518791,Staff,7,0,20,13
1713495085643,MCWP 50R,B00,518792,Staff,3,0,20,17
1713495085643,MCWP 50R,C00,518793,Staff,7,0,20,13
1713495085643,MCWP 50R,D00,518794,Staff,0,0,20,20
1713495085643,MCWP 50R,E00,518795,Staff,0,0,20,20
1713495085643,MCWP 50R,F00,518796,Staff,11,0,20,9
1713495085643,MCWP 50R,G00,518797,Staff,10,0,20,10
1713495086669,MMW 12R,A01,514034,Herbst; Matthew,4,0,16,12
1713495086669,MMW 12R,A02,514035,Herbst; Matthew,13,0,16,3
1713495087698,MMW 13R,A01,514037,Staff,0,6,16,16
1713495087698,MMW 13R,A02,514039,Staff,0,5,16,16
1713495089749,SIO 295LS,A00,523233,Staff,15,0,30,15
1713495090775,SIO 295S,A00,523232,Staff,15,0,30,15
1713495091800,SOCI 117,A01,494376,Staff,0,2,5,5
1713495092827,WES 237B,A00,494380,Staff,19,0,20,1
1713495094890,AESE 279B,A00,494370,Wade; Jon P,33,0,33,0
1713495095916,AIP 197,001,627712,Vespa; Emanuel Ignacio,9999,0,9999,0
1713495096941,ANAR 135S,A00,494369,Braswell; Geoffrey E.,0,0,0,0
1713495097968,CAT 124RS,A01,519847,Geibel; William,6,0,20,14
1713495098993,CAT 125RS,A01,515971,Geibel; William,6,0,20,14
1713495100019,CLRE 250,A00,511389,Morris; Sheldon,9996,0,9999,3
1713495101051,CLRE 251,A00,507176,Mehta; Ravindra L.,9996,0,9999,3
1713495101051,CLRE 251,B00,511410,Mehta; Ravindra L.,9998,0,9999,1
1713495102081,CLRE 252,A00,507189,Cuomo; Raphael Eduardo,9998,0,9999,1
1713495103108,CLRE 253,A00,507199,Vaida; Florin,9997,0,9999,2
1713495103108,CLRE 253,B00,507202,Vaida; Florin,9999,0,9999,0
1713495104137,CLRE 259,A00,507211,Patel; Hemal,9996,0,9999,3
1713495105164,CLRE 260,A00,507221,Cuomo; Raphael Eduardo,9999,0,9999,0
1713495106189,CLRE 297,001,507242,Cuomo; Raphael Eduardo,9999,0,9999,0
1713495107213,CSE 191,A00,516875,Minnes Kemp; Mor Mia,9999,0,9999,0
1713495108240,CSS 201S,A01,494383,Staff,35,0,35,0
1713495109269,CSS 202S,A01,494387,Staff,35,0,35,0
1713495110298,EAP 100,A00,516065,Staff,9792,0,9999,207
1713495111324,ECE 45,A01,507414,Staff,38,0,60,22
1713495112354,ECE 100,A01,507416,Baghdadchi; Saharnaz,0,0,20,20
1713495112354,ECE 100,A02,507418,Baghdadchi; Saharnaz,19,0,20,1
1713495113378,ECE 111,A01,507420,Staff,27,0,50,23
1713495114405,ECE 197,001,548057,Sievenpiper; Daniel F.,9998,0,9999,1
1713495115430,EDS 115,A00,507243,Choi; Bailey Miyeon,27,0,28,1
1713495116456,EDS 117,A01,494379,Staff,15,0,25,10
1713495117485,EDS 125,A00,507246,Hopkins; Megan Beth,27,0,30,3
1713495118515,EDS 128A,A01,507264,Fargason; Sharon Gayle,26,0,26,0
1713495119544,EDS 128B,A01,507293,Pappas; Elizabeth,30,0,30,0
1713495120570,EDS 139,A00,507294,Fargason; Sharon Gayle,30,0,30,0
1713495120570,EDS 139,B00,507313,Pappas; Elizabeth,30,0,30,0
1713495121598,EDS 201,A00,507315,Staff,18,0,30,12
1713495122625,EDS 203,A01,507317,Halter; Christopher P.,17,0,30,13
1713495123651,EDS 204R,A01,507319,Halter; Christopher P.,0,1,30,30
1713495123651,EDS 204R,B01,507331,Heinzman; Erica M.,22,0,30,8
1713495124676,EDS 206R,A00,507332,Staff,0,2,30,30
1713495124676,EDS 206R,B00,507343,Staff,23,0,30,7
1713495125701,EDS 250,A00,507344,Hemans; Patricia Ann Benitez,27,0,40,13
1713495126725,EDS 281,A00,507345,Daly; Alan J.,18,0,18,0
1713495127751,EDS 284,A00,507350,Daly; Alan J.,16,0,16,0
1713495128780,EDS 286,A00,507359,Fine; Sarah,18,0,18,0
1713495129809,EDS 289C,A01,507361,Daly; Alan J.,18,0,18,0
1713495130836,EDS 290,A00,507366,Hofstetter; Carolyn,15,0,15,0
1713495131864,LIGM 5A,A00,507421,Fischer-Grunski; Eva K,20,0,20,0
1713495132894,LIGM 5B,A00,507423,Fischer-Grunski; Eva K,20,0,20,0
1713495133919,LIGM 5C,A00,507425,Fischer-Grunski; Eva K,20,0,20,0
1713495134945,LIIT 5AS,A00,507427,Carnelos; Chiara,20,0,20,0
1713495135975,LIIT 5BS,A00,507430,Carnelos; Chiara,20,0,20,0
1713495137001,LIIT 5CS,A00,507432,Carnelos; Chiara,20,0,20,0
1713495138026,LISP 5A,A00,507541,Munoz Sanchez; Alicia,14,0,20,6
1713495139052,LISP 5B,A00,507671,Munoz Sanchez; Alicia,12,0,20,8
1713495140077,LISP 5C,A00,507696,Munoz Sanchez; Alicia,11,0,20,9
1713495141106,MAE 197,001,528363,Boechler; Nicholas Sebastia,9998,0,9999,1
1713495142133,MATH 197,001,523477,Kedlaya; Kiran S.,9999,0,9999,0
1713495142133,MATH 197,002,563811,Zhang; Danna,9998,0,9999,1
1713495143158,MCWP 40R,A00,518780,Staff,14,0,20,6
1713495143158,MCWP 40R,B00,518781,Staff,13,0,20,7
1713495143158,MCWP 40R,C00,518783,Staff,9,0,20,11
1713495144189,MCWP 50R,A00,518791,Staff,7,0,20,13
1713495144189,MCWP 50R,B00,518792,Staff,3,0,20,17
1713495144189,MCWP 50R,C00,518793,Staff,7,0,20,13
1713495144189,MCWP 50R,D00,518794,Staff,0,0,20,20
1713495144189,MCWP 50R,E00,518795,Staff,0,0,20,20
1713495144189,MCWP 50R,F00,518796,Staff,11,0,20,9
1713495144189,MCWP 50R,G00,518797,Staff,10,0,20,10
1713495145215,MMW 12R,A01,514034,Herbst; Matthew,4,0,16,12
1713495145215,MMW 12R,A02,514035,Herbst; Matthew,13,0,16,3
1713495146240,MMW 13R,A01,514037,Staff,0,6,16,16
1713495146240,MMW 13R,A02,514039,Staff,0,5,16,16
1713495148290,SIO 295LS,A00,523233,Staff,15,0,30,15
1713495149316,SIO 295S,A00,523232,Staff,15,0,30,15
1713495150342,SOCI 117,A01,494376,Staff,0,2,5,5
1713495151367,WES 237B,A00,494380,Staff,19,0,20,1
1713495153427,AESE 279B,A00,494370,Wade; Jon P,33,0,33,0
1713495154452,AIP 197,001,627712,Vespa; Emanuel Ignacio,9999,0,9999,0
1713495155477,ANAR 135S,A00,494369,Braswell; Geoffrey E.,0,0,0,0
1713495156502,CAT 124RS,A01,519847,Geibel; William,6,0,20,14
1713495157525,CAT 125RS,A01,515971,Geibel; William,6,0,20,14
1713495158551,CLRE 250,A00,511389,Morris; Sheldon,9996,0,9999,3
1713495159577,CLRE 251,A00,507176,Mehta; Ravindra L.,9996,0,9999,3
1713495159577,CLRE 251,B00,511410,Mehta; Ravindra L.,9998,0,9999,1
1713495160605,CLRE 252,A00,507189,Cuomo; Raphael Eduardo,9998,0,9999,1
1713495161633,CLRE 253,A00,507199,Vaida; Florin,9997,0,9999,2
1713495161633,CLRE 253,B00,507202,Vaida; Florin,9999,0,9999,0
1713495162659,CLRE 259,A00,507211,Patel; Hemal,9996,0,9999,3
1713495163685,CLRE 260,A00,507221,Cuomo; Raphael Eduardo,9999,0,9999,0
1713495164710,CLRE 297,001,507242,Cuomo; Raphael Eduardo,9999,0,9999,0
1713495165738,CSE 191,A00,516875,Minnes Kemp; Mor Mia,9999,0,9999,0
1713495166768,CSS 201S,A01,494383,Staff,35,0,35,0
1713495167794,CSS 202S,A01,494387,Staff,35,0,35,0
1713495168822,EAP 100,A00,516065,Staff,9792,0,9999,207
1713495169852,ECE 45,A01,507414,Staff,38,0,60,22
1713495170876,ECE 100,A01,507416,Baghdadchi; Saharnaz,0,0,20,20
1713495170876,ECE 100,A02,507418,Baghdadchi; Saharnaz,19,0,20,1
1713495171905,ECE 111,A01,507420,Staff,27,0,50,23
1713495172931,ECE 197,001,548057,Sievenpiper; Daniel F.,9998,0,9999,1
1713495173961,EDS 115,A00,507243,Choi; Bailey Miyeon,27,0,28,1
1713495174990,EDS 117,A01,494379,Staff,15,0,25,10
1713495176016,EDS 125,A00,507246,Hopkins; Megan Beth,27,0,30,3
1713495177041,EDS 128A,A01,507264,Fargason; Sharon Gayle,26,0,26,0
1713495178071,EDS 128B,A01,507293,Pappas; Elizabeth,30,0,30,0
1713495179098,EDS 139,A00,507294,Fargason; Sharon Gayle,30,0,30,0
1713495179098,EDS 139,B00,507313,Pappas; Elizabeth,30,0,30,0
1713495180193,EDS 201,A00,507315,Staff,18,0,30,12
1713495181222,EDS 203,A01,507317,Halter; Christopher P.,17,0,30,13
1713495182253,EDS 204R,A01,507319,Halter; Christopher P.,0,1,30,30
1713495182253,EDS 204R,B01,507331,Heinzman; Erica M.,22,0,30,8
1713495183278,EDS 206R,A00,507332,Staff,0,2,30,30
1713495183278,EDS 206R,B00,507343,Staff,23,0,30,7
1713495184307,EDS 250,A00,507344,Hemans; Patricia Ann Benitez,27,0,40,13
1713495185332,EDS 281,A00,507345,Daly; Alan J.,18,0,18,0
1713495186357,EDS 284,A00,507350,Daly; Alan J.,16,0,16,0
1713495187385,EDS 286,A00,507359,Fine; Sarah,18,0,18,0
1713495188414,EDS 289C,A01,507361,Daly; Alan J.,18,0,18,0
1713495189438,EDS 290,A00,507366,Hofstetter; Carolyn,15,0,15,0
1713495190468,LIGM 5A,A00,507421,Fischer-Grunski; Eva K,20,0,20,0
1713495191498,LIGM 5B,A00,507423,Fischer-Grunski; Eva K,20,0,20,0
1713495192523,LIGM 5C,A00,507425,Fischer-Grunski; Eva K,20,0,20,0
1713495193548,LIIT 5AS,A00,507427,Carnelos; Chiara,20,0,20,0
1713495194578,LIIT 5BS,A00,507430,Carnelos; Chiara,20,0,20,0
1713495195604,LIIT 5CS,A00,507432,Carnelos; Chiara,20,0,20,0
1713495196628,LISP 5A,A00,507541,Munoz Sanchez; Alicia,14,0,20,6
1713495197654,LISP 5B,A00,507671,Munoz Sanchez; Alicia,12,0,20,8
1713495198679,LISP 5C,A00,507696,Munoz Sanchez; Alicia,11,0,20,9
1713495199704,MAE 197,001,528363,Boechler; Nicholas Sebastia,9998,0,9999,1
1713495200731,MATH 197,001,523477,Kedlaya; Kiran S.,9999,0,9999,0
1713495200731,MATH 197,002,563811,Zhang; Danna,9998,0,9999,1
1713495201756,MCWP 40R,A00,518780,Staff,14,0,20,6
1713495201756,MCWP 40R,B00,518781,Staff,13,0,20,7
1713495201756,MCWP 40R,C00,518783,Staff,9,0,20,11
1713495202787,MCWP 50R,A00,518791,Staff,7,0,20,13
1713495202787,MCWP 50R,B00,518792,Staff,3,0,20,17
1713495202787,MCWP 50R,C00,518793,Staff,7,0,20,13
1713495202787,MCWP 50R,D00,518794,Staff,0,0,20,20
1713495202787,MCWP 50R,E00,518795,Staff,0,0,20,20
1713495202787,MCWP 50R,F00,518796,Staff,11,0,20,9
1713495202787,MCWP 50R,G00,518797,Staff,10,0,20,10
1713495203816,MMW 12R,A01,514034,Herbst; Matthew,4,0,16,12
1713495203816,MMW 12R,A02,514035,Herbst; Matthew,13,0,16,3
1713495204840,MMW 13R,A01,514037,Staff,0,6,16,16
1713495204840,MMW 13R,A02,514039,Staff,0,5,16,16
1713495206893,SIO 295LS,A00,523233,Staff,15,0,30,15
1713495207922,SIO 295S,A00,523232,Staff,15,0,30,15
1713495208949,SOCI 117,A01,494376,Staff,0,2,5,5
1713495209976,WES 237B,A00,494380,Staff,19,0,20,1
1713495212044,AESE 279B,A00,494370,Wade; Jon P,33,0,33,0
1713495213070,AIP 197,001,627712,Vespa; Emanuel Ignacio,9999,0,9999,0
1713495214099,ANAR 135S,A00,494369,Braswell; Geoffrey E.,0,0,0,0
1713495215124,CAT 124RS,A01,519847,Geibel; William,6,0,20,14
1713495216152,CAT 125RS,A01,515971,Geibel; William,6,0,20,14
1713495217178,CLRE 250,A00,511389,Morris; Sheldon,9996,0,9999,3
1713495218208,CLRE 251,A00,507176,Mehta; Ravindra L.,9996,0,9999,3
1713495218208,CLRE 251,B00,511410,Mehta; Ravindra L.,9998,0,9999,1
1713495219237,CLRE 252,A00,507189,Cuomo; Raphael Eduardo,9998,0,9999,1
1713495220265,CLRE 253,A00,507199,Vaida; Florin,9997,0,9999,2
1713495220265,CLRE 253,B00,507202,Vaida; Florin,9999,0,9999,0
1713495221291,CLRE 259,A00,507211,Patel; Hemal,9996,0,9999,3
1713495222317,CLRE 260,A00,507221,Cuomo; Raphael Eduardo,9999,0,9999,0
1713495223343,CLRE 297,001,507242,Cuomo; Raphael Eduardo,9999,0,9999,0
1713495224368,CSE 191,A00,516875,Minnes Kemp; Mor Mia,9999,0,9999,0
1713495225394,CSS 201S,A01,494383,Staff,35,0,35,0
1713495226423,CSS 202S,A01,494387,Staff,35,0,35,0
1713495227450,EAP 100,A00,516065,Staff,9792,0,9999,207
1713495228475,ECE 45,A01,507414,Staff,38,0,60,22
1713495229501,ECE 100,A01,507416,Baghdadchi; Saharnaz,0,0,20,20
1713495229501,ECE 100,A02,507418,Baghdadchi; Saharnaz,19,0,20,1
1713495230527,ECE 111,A01,507420,Staff,27,0,50,23
1713495231558,ECE 197,001,548057,Sievenpiper; Daniel F.,9998,0,9999,1
1713495232583,EDS 115,A00,507243,Choi; Bailey Miyeon,27,0,28,1
1713495233609,EDS 117,A01,494379,Staff,15,0,25,10
1713495234638,EDS 125,A00,507246,Hopkins; Megan Beth,27,0,30,3
1713495235663,EDS 128A,A01,507264,Fargason; Sharon Gayle,26,0,26,0
1713495236695,EDS 128B,A01,507293,Pappas; Elizabeth,30,0,30,0
1713495237725,EDS 139,A00,507294,Fargason; Sharon Gayle,30,0,30,0
1713495237725,EDS 139,B00,507313,Pappas; Elizabeth,30,0,30,0
1713495238751,EDS 201,A00,507315,Staff,18,0,30,12
1713495239780,EDS 203,A01,507317,Halter; Christopher P.,17,0,30,13
1713495240811,EDS 204R,A01,507319,Halter; Christopher P.,0,1,30,30
1713495240811,EDS 204R,B01,507331,Heinzman; Erica M.,22,0,30,8
1713495241838,EDS 206R,A00,507332,Staff,0,2,30,30
1713495241838,EDS 206R,B00,507343,Staff,23,0,30,7
1713495242865,EDS 250,A00,507344,Hemans; Patricia Ann Benitez,27,0,40,13
1713495243905,EDS 281,A00,507345,Daly; Alan J.,18,0,18,0
1713495244930,EDS 284,A00,507350,Daly; Alan J.,16,0,16,0
1713495245956,EDS 286,A00,507359,Fine; Sarah,18,0,18,0
1713495246985,EDS 289C,A01,507361,Daly; Alan J.,18,0,18,0
1713495248011,EDS 290,A00,507366,Hofstetter; Carolyn,15,0,15,0
1713495249036,LIGM 5A,A00,507421,Fischer-Grunski; Eva K,20,0,20,0
1713495250064,LIGM 5B,A00,507423,Fischer-Grunski; Eva K,20,0,20,0
1713495251093,LIGM 5C,A00,507425,Fischer-Grunski; Eva K,20,0,20,0
1713495252119,LIIT 5AS,A00,507427,Carnelos; Chiara,20,0,20,0
1713495253145,LIIT 5BS,A00,507430,Carnelos; Chiara,20,0,20,0
1713495254174,LIIT 5CS,A00,507432,Carnelos; Chiara,20,0,20,0
1713495255200,LISP 5A,A00,507541,Munoz Sanchez; Alicia,14,0,20,6
1713495256230,LISP 5B,A00,507671,Munoz Sanchez; Alicia,12,0,20,8
1713495257260,LISP 5C,A00,507696,Munoz Sanchez; Alicia,11,0,20,9
1713495258287,MAE 197,001,528363,Boechler; Nicholas Sebastia,9998,0,9999,1
1713495259316,MATH 197,001,523477,Kedlaya; Kiran S.,9999,0,9999,0
1713495259316,MATH 197,002,563811,Zhang; Danna,9998,0,9999,1
1713495260341,MCWP 40R,A00,518780,Staff,14,0,20,6
1713495260341,MCWP 40R,B00,518781,Staff,13,0,20,7
1713495260341,MCWP 40R,C00,518783,Staff,9,0,20,11
1713495261368,MCWP 50R,A00,518791,Staff,7,0,20,13
1713495261368,MCWP 50R,B00,518792,Staff,3,0,20,17
1713495261368,MCWP 50R,C00,518793,Staff,7,0,20,13
1713495261368,MCWP 50R,D00,518794,Staff,0,0,20,20
1713495261368,MCWP 50R,E00,518795,Staff,0,0,20,20
1713495261368,MCWP 50R,F00,518796,Staff,11,0,20,9
1713495261368,MCWP 50R,G00,518797,Staff,10,0,20,10
1713495262393,MMW 12R,A01,514034,Herbst; Matthew,4,0,16,12
1713495262393,MMW 12R,A02,514035,Herbst; Matthew,13,0,16,3
1713495263418,MMW 13R,A01,514037,Staff,0,6,16,16
1713495263418,MMW 13R,A02,514039,Staff,0,5,16,16
1713495265472,SIO 295LS,A00,523233,Staff,15,0,30,15
1713495266502,SIO 295S,A00,523232,Staff,15,0,30,15
1713495267532,SOCI 117,A01,494376,Staff,0,2,5,5
1713495268558,WES 237B,A00,494380,Staff,19,0,20,1
1713495270616,AESE 279B,A00,494370,Wade; Jon P,33,0,33,0
1713495271640,AIP 197,001,627712,Vespa; Emanuel Ignacio,9999,0,9999,0
1713495272670,ANAR 135S,A00,494369,Braswell; Geoffrey E.,0,0,0,0
1713495273695,CAT 124RS,A01,519847,Geibel; William,6,0,20,14
1713495274723,CAT 125RS,A01,515971,Geibel; William,6,0,20,14
1713495275749,CLRE 250,A00,511389,Morris; Sheldon,9996,0,9999,3
1713495276778,CLRE 251,A00,507176,Mehta; Ravindra L.,9996,0,9999,3
1713495276778,CLRE 251,B00,511410,Mehta; Ravindra L.,9998,0,9999,1
1713495277804,CLRE 252,A00,507189,Cuomo; Raphael Eduardo,9998,0,9999,1
1713495278830,CLRE 253,A00,507199,Vaida; Florin,9997,0,9999,2
1713495278830,CLRE 253,B00,507202,Vaida; Florin,9999,0,9999,0
1713495279855,CLRE 259,A00,507211,Patel; Hemal,9996,0,9999,3
1713495280884,CLRE 260,A00,507221,Cuomo; Raphael Eduardo,9999,0,9999,0
1713495281914,CLRE 297,001,507242,Cuomo; Raphael Eduardo,9999,0,9999,0
1713495282940,CSE 191,A00,516875,Minnes Kemp; Mor Mia,9999,0,9999,0
1713495284021,CSS 201S,A01,494383,Staff,35,0,35,0
1713495285048,CSS 202S,A01,494387,Staff,35,0,35,0
1713495286079,EAP 100,A00,516065,Staff,9792,0,9999,207
1713495287105,ECE 45,A01,507414,Staff,38,0,60,22
1713495288131,ECE 100,A01,507416,Baghdadchi; Saharnaz,0,0,20,20
1713495288131,ECE 100,A02,507418,Baghdadchi; Saharnaz,19,0,20,1
1713495289156,ECE 111,A01,507420,Staff,27,0,50,23
1713495290181,ECE 197,001,548057,Sievenpiper; Daniel F.,9998,0,9999,1
1713495291206,EDS 115,A00,507243,Choi; Bailey Miyeon,27,0,28,1
1713495292234,EDS 117,A01,494379,Staff,15,0,25,10
1713495293263,EDS 125,A00,507246,Hopkins; Megan Beth,27,0,30,3
1713495294289,EDS 128A,A01,507264,Fargason; Sharon Gayle,26,0,26,0
1713495295319,EDS 128B,A01,507293,Pappas; Elizabeth,30,0,30,0
1713495296346,EDS 139,A00,507294,Fargason; Sharon Gayle,30,0,30,0
1713495296346,EDS 139,B00,507313,Pappas; Elizabeth,30,0,30,0
1713495297375,EDS 201,A00,507315,Staff,18,0,30,12
1713495298399,EDS 203,A01,507317,Halter; Christopher P.,17,0,30,13
1713495299425,EDS 204R,A01,507319,Halter; Christopher P.,0,1,30,30
1713495299425,EDS 204R,B01,507331,Heinzman; Erica M.,22,0,30,8
1713495300450,EDS 206R,A00,507332,Staff,0,2,30,30
1713495300450,EDS 206R,B00,507343,Staff,23,0,30,7
1713495301474,EDS 250,A00,507344,Hemans; Patricia Ann Benitez,27,0,40,13
1713495302499,EDS 281,A00,507345,Daly; Alan J.,18,0,18,0
1713495303528,EDS 284,A00,507350,Daly; Alan J.,16,0,16,0
1713495304558,EDS 286,A00,507359,Fine; Sarah,18,0,18,0
1713495305583,EDS 289C,A01,507361,Daly; Alan J.,18,0,18,0
1713495306612,EDS 290,A00,507366,Hofstetter; Carolyn,15,0,15,0
1713495307642,LIGM 5A,A00,507421,Fischer-Grunski; Eva K,20,0,20,0
1713495308670,LIGM 5B,A00,507423,Fischer-Grunski; Eva K,20,0,20,0
1713495309699,LIGM 5C,A00,507425,Fischer-Grunski; Eva K,20,0,20,0
1713495310724,LIIT 5AS,A00,507427,Carnelos; Chiara,20,0,20,0
1713495311750,LIIT 5BS,A00,507430,Carnelos; Chiara,20,0,20,0
1713495312777,LIIT 5CS,A00,507432,Carnelos; Chiara,20,0,20,0
1713495313804,LISP 5A,A00,507541,Munoz Sanchez; Alicia,14,0,20,6
1713495314832,LISP 5B,A00,507671,Munoz Sanchez; Alicia,12,0,20,8
1713495315861,LISP 5C,A00,507696,Munoz Sanchez; Alicia,11,0,20,9
1713495316886,MAE 197,001,528363,Boechler; Nicholas Sebastia,9998,0,9999,1
1713495317920,MATH 197,001,523477,Kedlaya; Kiran S.,9999,0,9999,0
1713495317920,MATH 197,002,563811,Zhang; Danna,9998,0,9999,1
1713495318948,MCWP 40R,A00,518780,Staff,14,0,20,6
1713495318948,MCWP 40R,B00,518781,Staff,13,0,20,7
1713495318948,MCWP 40R,C00,518783,Staff,9,0,20,11
1713495319977,MCWP 50R,A00,518791,Staff,7,0,20,13
1713495319977,MCWP 50R,B00,518792,Staff,3,0,20,17
1713495319977,MCWP 50R,C00,518793,Staff,7,0,20,13
1713495319977,MCWP 50R,D00,518794,Staff,0,0,20,20
1713495319977,MCWP 50R,E00,518795,Staff,0,0,20,20
1713495319977,MCWP 50R,F00,518796,Staff,11,0,20,9
1713495319977,MCWP 50R,G00,518797,Staff,10,0,20,10
1713495321006,MMW 12R,A01,514034,Herbst; Matthew,4,0,16,12
1713495321006,MMW 12R,A02,514035,Herbst; Matthew,13,0,16,3
1713495322032,MMW 13R,A01,514037,Staff,0,6,16,16
1713495322032,MMW 13R,A02,514039,Staff,0,5,16,16
1713495324082,SIO 295LS,A00,523233,Staff,15,0,30,15
1713495325107,SIO 295S,A00,523232,Staff,15,0,30,15
1713495326131,SOCI 117,A01,494376,Staff,0,2,5,5
1713495327160,WES 237B,A00,494380,Staff,19,0,20,1
1713495329232,AESE 279B,A00,494370,Wade; Jon P,33,0,33,0
1713495330257,AIP 197,001,627712,Vespa; Emanuel Ignacio,9999,0,9999,0
1713495331286,ANAR 135S,A00,494369,Braswell; Geoffrey E.,0,0,0,0
1713495332312,CAT 124RS,A01,519847,Geibel; William,6,0,20,14
1713495333335,CAT 125RS,A01,515971,Geibel; William,6,0,20,14
1713495334364,CLRE 250,A00,511389,Morris; Sheldon,9996,0,9999,3
1713495335393,CLRE 251,A00,507176,Mehta; Ravindra L.,9996,0,9999,3
1713495335393,CLRE 251,B00,511410,Mehta; Ravindra L.,9998,0,9999,1
1713495336417,CLRE 252,A00,507189,Cuomo; Raphael Eduardo,9998,0,9999,1
1713495337446,CLRE 253,A00,507199,Vaida; Florin,9997,0,9999,2
1713495337446,CLRE 253,B00,507202,Vaida; Florin,9999,0,9999,0
1713495338471,CLRE 259,A00,507211,Patel; Hemal,9996,0,9999,3
1713495339497,CLRE 260,A00,507221,Cuomo; Raphael Eduardo,9999,0,9999,0
1713495340523,CLRE 297,001,507242,Cuomo; Raphael Eduardo,9999,0,9999,0
1713495341547,CSE 191,A00,516875,Minnes Kemp; Mor Mia,9999,0,9999,0
1713495342578,CSS 201S,A01,494383,Staff,35,0,35,0
1713495343606,CSS 202S,A01,494387,Staff,35,0,35,0
1713495344635,EAP 100,A00,516065,Staff,9792,0,9999,207
1713495345662,ECE 45,A01,507414,Staff,38,0,60,22
1713495346686,ECE 100,A01,507416,Baghdadchi; Saharnaz,0,0,20,20
1713495346686,ECE 100,A02,507418,Baghdadchi; Saharnaz,19,0,20,1
1713495347712,ECE 111,A01,507420,Staff,27,0,50,23
1713495348745,ECE 197,001,548057,Sievenpiper; Daniel F.,9998,0,9999,1
1713495349771,EDS 115,A00,507243,Choi; Bailey Miyeon,27,0,28,1
1713495350798,EDS 117,A01,494379,Staff,15,0,25,10
1713495351827,EDS 125,A00,507246,Hopkins; Megan Beth,27,0,30,3
1713495352851,EDS 128A,A01,507264,Fargason; Sharon Gayle,26,0,26,0
1713495353876,EDS 128B,A01,507293,Pappas; Elizabeth,30,0,30,0
1713495354902,EDS 139,A00,507294,Fargason; Sharon Gayle,30,0,30,0
1713495354902,EDS 139,B00,507313,Pappas; Elizabeth,30,0,30,0
1713495355928,EDS 201,A00,507315,Staff,18,0,30,12
1713495356956,EDS 203,A01,507317,Halter; Christopher P.,17,0,30,13
1713495357981,EDS 204R,A01,507319,Halter; Christopher P.,0,1,30,30
1713495357981,EDS 204R,B01,507331,Heinzman; Erica M.,22,0,30,8
1713495359013,EDS 206R,A00,507332,Staff,0,2,30,30
1713495359013,EDS 206R,B00,507343,Staff,23,0,30,7
1713495360044,EDS 250,A00,507344,Hemans; Patricia Ann Benitez,27,0,40,13
1713495361072,EDS 281,A00,507345,Daly; Alan J.,18,0,18,0
1713495362097,EDS 284,A00,507350,Daly; Alan J.,16,0,16,0
1713495363123,EDS 286,A00,507359,Fine; Sarah,18,0,18,0
1713495364152,EDS 289C,A01,507361,Daly; Alan J.,18,0,18,0
1713495365182,EDS 290,A00,507366,Hofstetter; Carolyn,15,0,15,0
1713495366208,LIGM 5A,A00,507421,Fischer-Grunski; Eva K,20,0,20,0
1713495367238,LIGM 5B,A00,507423,Fischer-Grunski; Eva K,20,0,20,0
1713495368266,LIGM 5C,A00,507425,Fischer-Grunski; Eva K,20,0,20,0
1713495369296,LIIT 5AS,A00,507427,Carnelos; Chiara,20,0,20,0
1713495370325,LIIT 5BS,A00,507430,Carnelos; Chiara,20,0,20,0
1713495371351,LIIT 5CS,A00,507432,Carnelos; Chiara,20,0,20,0
1713495372381,LISP 5A,A00,507541,Munoz Sanchez; Alicia,14,0,20,6
1713495373408,LISP 5B,A00,507671,Munoz Sanchez; Alicia,12,0,20,8
1713495374437,LISP 5C,A00,507696,Munoz Sanchez; Alicia,11,0,20,9
1713495375461,MAE 197,001,528363,Boechler; Nicholas Sebastia,9998,0,9999,1
1713495376486,MATH 197,001,523477,Kedlaya; Kiran S.,9999,0,9999,0
1713495376486,MATH 197,002,563811,Zhang; Danna,9998,0,9999,1
1713495377513,MCWP 40R,A00,518780,Staff,14,0,20,6
1713495377513,MCWP 40R,B00,518781,Staff,13,0,20,7
1713495377513,MCWP 40R,C00,518783,Staff,9,0,20,11
1713495378538,MCWP 50R,A00,518791,Staff,7,0,20,13
1713495378538,MCWP 50R,B00,518792,Staff,3,0,20,17
1713495378538,MCWP 50R,C00,518793,Staff,7,0,20,13
1713495378538,MCWP 50R,D00,518794,Staff,0,0,20,20
1713495378538,MCWP 50R,E00,518795,Staff,0,0,20,20
1713495378538,MCWP 50R,F00,518796,Staff,11,0,20,9
1713495378538,MCWP 50R,G00,518797,Staff,10,0,20,10
1713495379564,MMW 12R,A01,514034,Herbst; Matthew,4,0,16,12
1713495379564,MMW 12R,A02,514035,Herbst; Matthew,13,0,16,3
1713495380588,MMW 13R,A01,514037,Staff,0,6,16,16
1713495380588,MMW 13R,A02,514039,Staff,0,5,16,16
1713495382641,SIO 295LS,A00,523233,Staff,15,0,30,15
1713495383666,SIO 295S,A00,523232,Staff,15,0,30,15
1713495384692,SOCI 117,A01,494376,Staff,0,2,5,5
1713495385718,WES 237B,A00,494380,Staff,19,0,20,1
1713495387840,AESE 279B,A00,494370,Wade; Jon P,33,0,33,0
1713495388869,AIP 197,001,627712,Vespa; Emanuel Ignacio,9999,0,9999,0
1713495389895,ANAR 135S,A00,494369,Braswell; Geoffrey E.,0,0,0,0
1713495390924,CAT 124RS,A01,519847,Geibel; William,6,0,20,14
1713495391952,CAT 125RS,A01,515971,Geibel; William,6,0,20,14
1713495392979,CLRE 250,A00,511389,Morris; Sheldon,9996,0,9999,3
1713495394012,CLRE 251,A00,507176,Mehta; Ravindra L.,9996,0,9999,3
1713495394012,CLRE 251,B00,511410,Mehta; Ravindra L.,9998,0,9999,1
1713495395040,CLRE 252,A00,507189,Cuomo; Raphael Eduardo,9998,0,9999,1
1713495396068,CLRE 253,A00,507199,Vaida; Florin,9997,0,9999,2
1713495396068,CLRE 253,B00,507202,Vaida; Florin,9999,0,9999,0
1713495397093,CLRE 259,A00,507211,Patel; Hemal,9996,0,9999,3
1713495398122,CLRE 260,A00,507221,Cuomo; Raphael Eduardo,9999,0,9999,0
1713495399150,CLRE 297,001,507242,Cuomo; Raphael Eduardo,9999,0,9999,0
1713495400175,CSE 191,A00,516875,Minnes Kemp; Mor Mia,9999,0,9999,0
1713495401205,CSS 201S,A01,494383,Staff,35,0,35,0
1713495402293,CSS 202S,A01,494387,Staff,35,0,35,0
1713495403320,EAP 100,A00,516065,Staff,9792,0,9999,207
1713495404345,ECE 45,A01,507414,Staff,38,0,60,22
1713495405372,ECE 100,A01,507416,Baghdadchi; Saharnaz,0,0,20,20
1713495405372,ECE 100,A02,507418,Baghdadchi; Saharnaz,19,0,20,1
1713495406397,ECE 111,A01,507420,Staff,27,0,50,23
1713495407421,ECE 197,001,548057,Sievenpiper; Daniel F.,9998,0,9999,1
1713495408446,EDS 115,A00,507243,Choi; Bailey Miyeon,27,0,28,1
1713495409471,EDS 117,A01,494379,Staff,15,0,25,10
1713495410498,EDS 125,A00,507246,Hopkins; Megan Beth,27,0,30,3
1713495411528,EDS 128A,A01,507264,Fargason; Sharon Gayle,26,0,26,0
1713495412555,EDS 128B,A01,507293,Pappas; Elizabeth,30,0,30,0
1713495413580,EDS 139,A00,507294,Fargason; Sharon Gayle,30,0,30,0
1713495413580,EDS 139,B00,507313,Pappas; Elizabeth,30,0,30,0
1713495414605,EDS 201,A00,507315,Staff,18,0,30,12
1713495415629,EDS 203,A01,507317,Halter; Christopher P.,17,0,30,13
1713495416654,EDS 204R,A01,507319,Halter; Christopher P.,0,1,30,30
1713495416654,EDS 204R,B01,507331,Heinzman; Erica M.,22,0,30,8
1713495417683,EDS 206R,A00,507332,Staff,0,2,30,30
1713495417683,EDS 206R,B00,507343,Staff,23,0,30,7
1713495418715,EDS 250,A00,507344,Hemans; Patricia Ann Benitez,27,0,40,13
1713495419740,EDS 281,A00,507345,Daly; Alan J.,18,0,18,0
1713495420763,EDS 284,A00,507350,Daly; Alan J.,16,0,16,0
1713495421793,EDS 286,A00,507359,Fine; Sarah,18,0,18,0
1713495422821,EDS 289C,A01,507361,Daly; Alan J.,18,0,18,0
1713495423863,EDS 290,A00,507366,Hofstetter; Carolyn,15,0,15,0
1713495424892,LIGM 5A,A00,507421,Fischer-Grunski; Eva K,20,0,20,0
1713495425920,LIGM 5B,A00,507423,Fischer-Grunski; Eva K,20,0,20,0
1713495426947,LIGM 5C,A00,507425,Fischer-Grunski; Eva K,20,0,20,0
1713495427973,LIIT 5AS,A00,507427,Carnelos; Chiara,20,0,20,0
1713495429002,LIIT 5BS,A00,507430,Carnelos; Chiara,20,0,20,0
1713495430035,LIIT 5CS,A00,507432,Carnelos; Chiara,20,0,20,0
1713495431064,LISP 5A,A00,507541,Munoz Sanchez; Alicia,14,0,20,6
1713495432090,LISP 5B,A00,507671,Munoz Sanchez; Alicia,12,0,20,8
1713495433119,LISP 5C,A00,507696,Munoz Sanchez; Alicia,11,0,20,9
1713495434145,MAE 197,001,528363,Boechler; Nicholas Sebastia,9998,0,9999,1
1713495435172,MATH 197,001,523477,Kedlaya; Kiran S.,9999,0,9999,0
1713495435172,MATH 197,002,563811,Zhang; Danna,9998,0,9999,1
1713495436200,MCWP 40R,A00,518780,Staff,14,0,20,6
1713495436200,MCWP 40R,B00,518781,Staff,13,0,20,7
1713495436200,MCWP 40R,C00,518783,Staff,9,0,20,11
1713495437230,MCWP 50R,A00,518791,Staff,7,0,20,13
1713495437230,MCWP 50R,B00,518792,Staff,3,0,20,17
1713495437230,MCWP 50R,C00,518793,Staff,7,0,20,13
1713495437230,MCWP 50R,D00,518794,Staff,0,0,20,20
1713495437230,MCWP 50R,E00,518795,Staff,0,0,20,20
1713495437230,MCWP 50R,F00,518796,Staff,11,0,20,9
1713495437230,MCWP 50R,G00,518797,Staff,10,0,20,10
1713495438258,MMW 12R,A01,514034,Herbst; Matthew,4,0,16,12
1713495438258,MMW 12R,A02,514035,Herbst; Matthew,13,0,16,3
1713495439288,MMW 13R,A01,514037,Staff,0,6,16,16
1713495439288,MMW 13R,A02,514039,Staff,0,5,16,16
1713495441340,SIO 295LS,A00,523233,Staff,15,0,30,15
1713495442366,SIO 295S,A00,523232,Staff,15,0,30,15
1713495443392,SOCI 117,A01,494376,Staff,0,2,5,5
1713495444417,WES 237B,A00,494380,Staff,19,0,20,1
1713495446484,AESE 279B,A00,494370,Wade; Jon P,33,0,33,0
1713495447510,AIP 197,001,627712,Vespa; Emanuel Ignacio,9999,0,9999,0
1713495448536,ANAR 135S,A00,494369,Braswell; Geoffrey E.,0,0,0,0
1713495449562,CAT 124RS,A01,519847,Geibel; William,6,0,20,14
1713495450586,CAT 125RS,A01,515971,Geibel; William,6,0,20,14
1713495451614,CLRE 250,A00,511389,Morris; Sheldon,9996,0,9999,3
1713495452641,CLRE 251,A00,507176,Mehta; Ravindra L.,9996,0,9999,3
1713495452641,CLRE 251,B00,511410,Mehta; Ravindra L.,9998,0,9999,1
1713495453665,CLRE 252,A00,507189,Cuomo; Raphael Eduardo,9998,0,9999,1
1713495454690,CLRE 253,A00,507199,Vaida; Florin,9997,0,9999,2
1713495454690,CLRE 253,B00,507202,Vaida; Florin,9999,0,9999,0
1713495455718,CLRE 259,A00,507211,Patel; Hemal,9996,0,9999,3
1713495456743,CLRE 260,A00,507221,Cuomo; Raphael Eduardo,9999,0,9999,0
1713495457767,CLRE 297,001,507242,Cuomo; Raphael Eduardo,9999,0,9999,0
1713495458795,CSE 191,A00,516875,Minnes Kemp; Mor Mia,9999,0,9999,0
1713495459821,CSS 201S,A01,494383,Staff,35,0,35,0
1713495460850,CSS 202S,A01,494387,Staff,35,0,35,0
1713495461875,EAP 100,A00,516065,Staff,9792,0,9999,207
1713495462903,ECE 45,A01,507414,Staff,38,0,60,22
1713495463931,ECE 100,A01,507416,Baghdadchi; Saharnaz,0,0,20,20
1713495463931,ECE 100,A02,507418,Baghdadchi; Saharnaz,19,0,20,1
1713495464959,ECE 111,A01,507420,Staff,27,0,50,23
1713495465987,ECE 197,001,548057,Sievenpiper; Daniel F.,9998,0,9999,1
1713495467012,EDS 115,A00,507243,Choi; Bailey Miyeon,27,0,28,1
1713495468042,EDS 117,A01,494379,Staff,15,0,25,10
1713495469066,EDS 125,A00,507246,Hopkins; Megan Beth,27,0,30,3
1713495470092,EDS 128A,A01,507264,Fargason; Sharon Gayle,26,0,26,0
1713495471117,EDS 128B,A01,507293,Pappas; Elizabeth,30,0,30,0
1713495472142,EDS 139,A00,507294,Fargason; Sharon Gayle,30,0,30,0
1713495472142,EDS 139,B00,507313,Pappas; Elizabeth,30,0,30,0
1713495473171,EDS 201,A00,507315,Staff,18,0,30,12
1713495474197,EDS 203,A01,507317,Halter; Christopher P.,17,0,30,13
1713495475223,EDS 204R,A01,507319,Halter; Christopher P.,0,1,30,30
1713495475223,EDS 204R,B01,507331,Heinzman; Erica M.,22,0,30,8
1713495476251,EDS 206R,A00,507332,Staff,0,2,30,30
1713495476251,EDS 206R,B00,507343,Staff,23,0,30,7
1713495477277,EDS 250,A00,507344,Hemans; Patricia Ann Benitez,27,0,40,13
1713495478306,EDS 281,A00,507345,Daly; Alan J.,18,0,18,0
1713495479335,EDS 284,A00,507350,Daly; Alan J.,16,0,16,0
1713495480361,EDS 286,A00,507359,Fine; Sarah,18,0,18,0
1713495481389,EDS 289C,A01,507361,Daly; Alan J.,18,0,18,0
1713495482414,EDS 290,A00,507366,Hofstetter; Carolyn,15,0,15,0
1713495483443,LIGM 5A,A00,507421,Fischer-Grunski; Eva K,20,0,20,0
1713495484469,LIGM 5B,A00,507423,Fischer-Grunski; Eva K,20,0,20,0
1713495485495,LIGM 5C,A00,507425,Fischer-Grunski; Eva K,20,0,20,0
1713495486522,LIIT 5AS,A00,507427,Carnelos; Chiara,20,0,20,0
1713495487549,LIIT 5BS,A00,507430,Carnelos; Chiara,20,0,20,0
1713495488577,LIIT 5CS,A00,507432,Carnelos; Chiara,20,0,20,0
1713495489601,LISP 5A,A00,507541,Munoz Sanchez; Alicia,14,0,20,6
1713495490626,LISP 5B,A00,507671,Munoz Sanchez; Alicia,12,0,20,8
1713495491710,LISP 5C,A00,507696,Munoz Sanchez; Alicia,11,0,20,9
1713495492737,MAE 197,001,528363,Boechler; Nicholas Sebastia,9998,0,9999,1
1713495493762,MATH 197,001,523477,Kedlaya; Kiran S.,9999,0,9999,0
1713495493762,MATH 197,002,563811,Zhang; Danna,9998,0,9999,1
1713495494787,MCWP 40R,A00,518780,Staff,14,0,20,6
1713495494787,MCWP 40R,B00,518781,Staff,13,0,20,7
1713495494787,MCWP 40R,C00,518783,Staff,9,0,20,11
1713495495819,MCWP 50R,A00,518791,Staff,7,0,20,13
1713495495819,MCWP 50R,B00,518792,Staff,3,0,20,17
1713495495819,MCWP 50R,C00,518793,Staff,7,0,20,13
1713495495819,MCWP 50R,D00,518794,Staff,0,0,20,20
1713495495819,MCWP 50R,E00,518795,Staff,0,0,20,20
1713495495819,MCWP 50R,F00,518796,Staff,11,0,20,9
1713495495819,MCWP 50R,G00,518797,Staff,10,0,20,10
1713495496844,MMW 12R,A01,514034,Herbst; Matthew,4,0,16,12
1713495496844,MMW 12R,A02,514035,Herbst; Matthew,13,0,16,3
1713495497870,MMW 13R,A01,514037,Staff,0,6,16,16
1713495497870,MMW 13R,A02,514039,Staff,0,5,16,16
1713495499925,SIO 295LS,A00,523233,Staff,15,0,30,15
1713495500951,SIO 295S,A00,523232,Staff,15,0,30,15
1713495501975,SOCI 117,A01,494376,Staff,0,2,5,5
1713495503001,WES 237B,A00,494380,Staff,19,0,20,1
1713495505069,AESE 279B,A00,494370,Wade; Jon P,33,0,33,0
1713495506095,AIP 197,001,627712,Vespa; Emanuel Ignacio,9999,0,9999,0
1713495507121,ANAR 135S,A00,494369,Braswell; Geoffrey E.,0,0,0,0
1713495508149,CAT 124RS,A01,519847,Geibel; William,6,0,20,14
1713495509179,CAT 125RS,A01,515971,Geibel; William,6,0,20,14
1713495510208,CLRE 250,A00,511389,Morris; Sheldon,9996,0,9999,3
1713495511239,CLRE 251,A00,507176,Mehta; Ravindra L.,9996,0,9999,3
1713495511239,CLRE 251,B00,511410,Mehta; Ravindra L.,9998,0,9999,1
1713495512264,CLRE 252,A00,507189,Cuomo; Raphael Eduardo,9998,0,9999,1
1713495513295,CLRE 253,A00,507199,Vaida; Florin,9997,0,9999,2
1713495513295,CLRE 253,B00,507202,Vaida; Florin,9999,0,9999,0
1713495514324,CLRE 259,A00,507211,Patel; Hemal,9996,0,9999,3
1713495515349,CLRE 260,A00,507221,Cuomo; Raphael Eduardo,9999,0,9999,0
1713495516377,CLRE 297,001,507242,Cuomo; Raphael Eduardo,9999,0,9999,0
1713495517402,CSE 191,A00,516875,Minnes Kemp; Mor Mia,9999,0,9999,0
1713495518429,CSS 201S,A01,494383,Staff,35,0,35,0
1713495519456,CSS 202S,A01,494387,Staff,35,0,35,0
1713495520481,EAP 100,A00,516065,Staff,9792,0,9999,207
1713495521508,ECE 45,A01,507414,Staff,38,0,60,22
1713495522534,ECE 100,A01,507416,Baghdadchi; Saharnaz,0,0,20,20
1713495522534,ECE 100,A02,507418,Baghdadchi; Saharnaz,19,0,20,1
1713495523564,ECE 111,A01,507420,Staff,27,0,50,23
1713495524591,ECE 197,001,548057,Sievenpiper; Daniel F.,9998,0,9999,1
1713495525619,EDS 115,A00,507243,Choi; Bailey Miyeon,27,0,28,1
1713495526643,EDS 117,A01,494379,Staff,15,0,25,10
1713495527674,EDS 125,A00,507246,Hopkins; Megan Beth,27,0,30,3
1713495528700,EDS 128A,A01,507264,Fargason; Sharon Gayle,26,0,26,0
1713495529729,EDS 128B,A01,507293,Pappas; Elizabeth,30,0,30,0
1713495530753,EDS 139,A00,507294,Fargason; Sharon Gayle,30,0,30,0
1713495530753,EDS 139,B00,507313,Pappas; Elizabeth,30,0,30,0
1713495531779,EDS 201,A00,507315,Staff,18,0,30,12
1713495532804,EDS 203,A01,507317,Halter; Christopher P.,17,0,30,13
1713495533834,EDS 204R,A01,507319,Halter; Christopher P.,0,1,30,30
1713495533834,EDS 204R,B01,507331,Heinzman; Erica M.,22,0,30,8
1713495534863,EDS 206R,A00,507332,Staff,0,2,30,30
1713495534863,EDS 206R,B00,507343,Staff,23,0,30,7
1713495535888,EDS 250,A00,507344,Hemans; Patricia Ann Benitez,27,0,40,13
1713495536913,EDS 281,A00,507345,Daly; Alan J.,18,0,18,0
1713495537938,EDS 284,A00,507350,Daly; Alan J.,16,0,16,0
1713495538963,EDS 286,A00,507359,Fine; Sarah,18,0,18,0
1713495539993,EDS 289C,A01,507361,Daly; Alan J.,18,0,18,0
1713495541022,EDS 290,A00,507366,Hofstetter; Carolyn,15,0,15,0
1713495542047,LIGM 5A,A00,507421,Fischer-Grunski; Eva K,20,0,20,0
1713495543073,LIGM 5B,A00,507423,Fischer-Grunski; Eva K,20,0,20,0
1713495544099,LIGM 5C,A00,507425,Fischer-Grunski; Eva K,20,0,20,0
1713495545123,LIIT 5AS,A00,507427,Carnelos; Chiara,20,0,20,0
1713495546150,LIIT 5BS,A00,507430,Carnelos; Chiara,20,0,20,0
1713495547175,LIIT 5CS,A00,507432,Carnelos; Chiara,20,0,20,0
1713495548205,LISP 5A,A00,507541,Munoz Sanchez; Alicia,14,0,20,6
1713495549231,LISP 5B,A00,507671,Munoz Sanchez; Alicia,12,0,20,8
1713495550265,LISP 5C,A00,507696,Munoz Sanchez; Alicia,11,0,20,9
1713495551288,MAE 197,001,528363,Boechler; Nicholas Sebastia,9998,0,9999,1
1713495552313,MATH 197,001,523477,Kedlaya; Kiran S.,9999,0,9999,0
1713495552313,MATH 197,002,563811,Zhang; Danna,9998,0,9999,1
1713495553340,MCWP 40R,A00,518780,Staff,14,0,20,6
1713495553340,MCWP 40R,B00,518781,Staff,13,0,20,7
1713495553340,MCWP 40R,C00,518783,Staff,9,0,20,11
1713495554364,MCWP 50R,A00,518791,Staff,7,0,20,13
1713495554364,MCWP 50R,B00,518792,Staff,3,0,20,17
1713495554364,MCWP 50R,C00,518793,Staff,7,0,20,13
1713495554364,MCWP 50R,D00,518794,Staff,0,0,20,20
1713495554364,MCWP 50R,E00,518795,Staff,0,0,20,20
1713495554364,MCWP 50R,F00,518796,Staff,11,0,20,9
1713495554364,MCWP 50R,G00,518797,Staff,10,0,20,10
1713495555390,MMW 12R,A01,514034,Herbst; Matthew,4,0,16,12
1713495555390,MMW 12R,A02,514035,Herbst; Matthew,13,0,16,3
1713495556415,MMW 13R,A01,514037,Staff,0,6,16,16
1713495556415,MMW 13R,A02,514039,Staff,0,5,16,16
1713495558467,SIO 295LS,A00,523233,Staff,15,0,30,15
1713495559493,SIO 295S,A00,523232,Staff,15,0,30,15
1713495560521,SOCI 117,A01,494376,Staff,0,2,5,5
1713495561551,WES 237B,A00,494380,Staff,19,0,20,1
1713495563613,AESE 279B,A00,494370,Wade; Jon P,33,0,33,0
1713495564643,AIP 197,001,627712,Vespa; Emanuel Ignacio,9999,0,9999,0
1713495565669,ANAR 135S,A00,494369,Braswell; Geoffrey E.,0,0,0,0
1713495566699,CAT 124RS,A01,519847,Geibel; William,6,0,20,14
1713495567724,CAT 125RS,A01,515971,Geibel; William,6,0,20,14
1713495568749,CLRE 250,A00,511389,Morris; Sheldon,9996,0,9999,3
1713495569774,CLRE 251,A00,507176,Mehta; Ravindra L.,9996,0,9999,3
1713495569774,CLRE 251,B00,511410,Mehta; Ravindra L.,9998,0,9999,1
1713495570799,CLRE 252,A00,507189,Cuomo; Raphael Eduardo,9998,0,9999,1
1713495571827,CLRE 253,A00,507199,Vaida; Florin,9997,0,9999,2
1713495571827,CLRE 253,B00,507202,Vaida; Florin,9999,0,9999,0
1713495572853,CLRE 259,A00,507211,Patel; Hemal,9996,0,9999,3
1713495573882,CLRE 260,A00,507221,Cuomo; Raphael Eduardo,9999,0,9999,0
1713495574906,CLRE 297,001,507242,Cuomo; Raphael Eduardo,9999,0,9999,0
1713495575932,CSE 191,A00,516875,Minnes Kemp; Mor Mia,9999,0,9999,0
1713495576961,CSS 201S,A01,494383,Staff,35,0,35,0
1713495577990,CSS 202S,A01,494387,Staff,35,0,35,0
1713495579015,EAP 100,A00,516065,Staff,9792,0,9999,207
1713495580044,ECE 45,A01,507414,Staff,38,0,60,22
1713495581071,ECE 100,A01,507416,Baghdadchi; Saharnaz,0,0,20,20
1713495581071,ECE 100,A02,507418,Baghdadchi; Saharnaz,19,0,20,1
1713495582100,ECE 111,A01,507420,Staff,27,0,50,23
1713495583126,ECE 197,001,548057,Sievenpiper; Daniel F.,9998,0,9999,1
1713495584153,EDS 115,A00,507243,Choi; Bailey Miyeon,27,0,28,1
1713495585182,EDS 117,A01,494379,Staff,15,0,25,10
1713495586208,EDS 125,A00,507246,Hopkins; Megan Beth,27,0,30,3
1713495587233,EDS 128A,A01,507264,Fargason; Sharon Gayle,26,0,26,0
1713495588259,EDS 128B,A01,507293,Pappas; Elizabeth,30,0,30,0
1713495589285,EDS 139,A00,507294,Fargason; Sharon Gayle,30,0,30,0
1713495589285,EDS 139,B00,507313,Pappas; Elizabeth,30,0,30,0
1713495590311,EDS 201,A00,507315,Staff,18,0,30,12
1713495591339,EDS 203,A01,507317,Halter; Christopher P.,17,0,30,13
1713495592364,EDS 204R,A01,507319,Halter; Christopher P.,0,1,30,30
1713495592364,EDS 204R,B01,507331,Heinzman; Erica M.,22,0,30,8
1713495593389,EDS 206R,A00,507332,Staff,0,2,30,30
1713495593389,EDS 206R,B00,507343,Staff,23,0,30,7
1713495594416,EDS 250,A00,507344,Hemans; Patricia Ann Benitez,27,0,40,13
1713495595500,EDS 281,A00,507345,Daly; Alan J.,18,0,18,0
1713495596525,EDS 284,A00,507350,Daly; Alan J.,16,0,16,0
1713495597551,EDS 286,A00,507359,Fine; Sarah,18,0,18,0
1713495598577,EDS 289C,A01,507361,Daly; Alan J.,18,0,18,0
1713495599603,EDS 290,A00,507366,Hofstetter; Carolyn,15,0,15,0
1713495600628,LIGM 5A,A00,507421,Fischer-Grunski; Eva K,20,0,20,0
1713495601654,LIGM 5B,A00,507423,Fischer-Grunski; Eva K,20,0,20,0
1713495602680,LIGM 5C,A00,507425,Fischer-Grunski; Eva K,20,0,20,0
1713495603705,LIIT 5AS,A00,507427,Carnelos; Chiara,20,0,20,0
1713495604730,LIIT 5BS,A00,507430,Carnelos; Chiara,20,0,20,0
1713495605757,LIIT 5CS,A00,507432,Carnelos; Chiara,20,0,20,0
1713495606786,LISP 5A,A00,507541,Munoz Sanchez; Alicia,14,0,20,6
1713495607815,LISP 5B,A00,507671,Munoz Sanchez; Alicia,12,0,20,8
1713495608840,LISP 5C,A00,507696,Munoz Sanchez; Alicia,11,0,20,9
1713495609865,MAE 197,001,528363,Boechler; Nicholas Sebastia,9998,0,9999,1
1713495610895,MATH 197,001,523477,Kedlaya; Kiran S.,9999,0,9999,0
1713495610895,MATH 197,002,563811,Zhang; Danna,9998,0,9999,1
1713495611921,MCWP 40R,A00,518780,Staff,14,0,20,6
1713495611921,MCWP 40R,B00,518781,Staff,13,0,20,7
1713495611921,MCWP 40R,C00,518783,Staff,9,0,20,11
1713495612946,MCWP 50R,A00,518791,Staff,7,0,20,13
1713495612946,MCWP 50R,B00,518792,Staff,3,0,20,17
1713495612946,MCWP 50R,C00,518793,Staff,7,0,20,13
1713495612946,MCWP 50R,D00,518794,Staff,0,0,20,20
1713495612946,MCWP 50R,E00,518795,Staff,0,0,20,20
1713495612946,MCWP 50R,F00,518796,Staff,11,0,20,9
1713495612946,MCWP 50R,G00,518797,Staff,10,0,20,10
1713495613970,MMW 12R,A01,514034,Herbst; Matthew,4,0,16,12
1713495613970,MMW 12R,A02,514035,Herbst; Matthew,13,0,16,3
1713495614999,MMW 13R,A01,514037,Staff,0,6,16,16
1713495614999,MMW 13R,A02,514039,Staff,0,6,16,16
1713495617052,SIO 295LS,A00,523233,Staff,15,0,30,15
1713495618076,SIO 295S,A00,523232,Staff,15,0,30,15
1713495619099,SOCI 117,A01,494376,Staff,0,2,5,5
1713495620126,WES 237B,A00,494380,Staff,19,0,20,1
1713495622192,AESE 279B,A00,494370,Wade; Jon P,33,0,33,0
1713495623217,AIP 197,001,627712,Vespa; Emanuel Ignacio,9999,0,9999,0
1713495624242,ANAR 135S,A00,494369,Braswell; Geoffrey E.,0,0,0,0
1713495625267,CAT 124RS,A01,519847,Geibel; William,6,0,20,14
1713495626291,CAT 125RS,A01,515971,Geibel; William,6,0,20,14
1713495627320,CLRE 250,A00,511389,Morris; Sheldon,9996,0,9999,3
1713495628348,CLRE 251,A00,507176,Mehta; Ravindra L.,9996,0,9999,3
1713495628348,CLRE 251,B00,511410,Mehta; Ravindra L.,9998,0,9999,1
1713495629373,CLRE 252,A00,507189,Cuomo; Raphael Eduardo,9998,0,9999,1
1713495630399,CLRE 253,A00,507199,Vaida; Florin,9997,0,9999,2
1713495630399,CLRE 253,B00,507202,Vaida; Florin,9999,0,9999,0
1713495631425,CLRE 259,A00,507211,Patel; Hemal,9996,0,9999,3
1713495632450,CLRE 260,A00,507221,Cuomo; Raphael Eduardo,9999,0,9999,0
1713495633478,CLRE 297,001,507242,Cuomo; Raphael Eduardo,9999,0,9999,0
1713495634508,CSE 191,A00,516875,Minnes Kemp; Mor Mia,9999,0,9999,0
1713495635538,CSS 201S,A01,494383,Staff,35,0,35,0
1713495636564,CSS 202S,A01,494387,Staff,35,0,35,0
1713495637587,EAP 100,A00,516065,Staff,9792,0,9999,207
1713495638613,ECE 45,A01,507414,Staff,38,0,60,22
1713495639640,ECE 100,A01,507416,Baghdadchi; Saharnaz,0,0,20,20
1713495639640,ECE 100,A02,507418,Baghdadchi; Saharnaz,19,0,20,1
1713495640665,ECE 111,A01,507420,Staff,27,0,50,23
1713495641691,ECE 197,001,548057,Sievenpiper; Daniel F.,9998,0,9999,1
1713495642721,EDS 115,A00,507243,Choi; Bailey Miyeon,27,0,28,1
1713495643745,EDS 117,A01,494379,Staff,15,0,25,10
1713495644771,EDS 125,A00,507246,Hopkins; Megan Beth,27,0,30,3
1713495645796,EDS 128A,A01,507264,Fargason; Sharon Gayle,26,0,26,0
1713495646825,EDS 128B,A01,507293,Pappas; Elizabeth,30,0,30,0
1713495647850,EDS 139,A00,507294,Fargason; Sharon Gayle,30,0,30,0
1713495647850,EDS 139,B00,507313,Pappas; Elizabeth,30,0,30,0
1713495648875,EDS 201,A00,507315,Staff,18,0,30,12
1713495649901,EDS 203,A01,507317,Halter; Christopher P.,17,0,30,13
1713495650931,EDS 204R,A01,507319,Halter; Christopher P.,0,1,30,30
1713495650931,EDS 204R,B01,507331,Heinzman; Erica M.,22,0,30,8
1713495651957,EDS 206R,A00,507332,Staff,0,2,30,30
1713495651957,EDS 206R,B00,507343,Staff,23,0,30,7
1713495652983,EDS 250,A00,507344,Hemans; Patricia Ann Benitez,27,0,40,13
1713495654009,EDS 281,A00,507345,Daly; Alan J.,18,0,18,0
1713495655034,EDS 284,A00,507350,Daly; Alan J.,16,0,16,0
1713495656058,EDS 286,A00,507359,Fine; Sarah,18,0,18,0
1713495657084,EDS 289C,A01,507361,Daly; Alan J.,18,0,18,0
1713495658109,EDS 290,A00,507366,Hofstetter; Carolyn,15,0,15,0
1713495659133,LIGM 5A,A00,507421,Fischer-Grunski; Eva K,20,0,20,0
1713495660165,LIGM 5B,A00,507423,Fischer-Grunski; Eva K,20,0,20,0
1713495661190,LIGM 5C,A00,507425,Fischer-Grunski; Eva K,20,0,20,0
1713495662215,LIIT 5AS,A00,507427,Carnelos; Chiara,20,0,20,0
1713495663243,LIIT 5BS,A00,507430,Carnelos; Chiara,20,0,20,0
1713495664268,LIIT 5CS,A00,507432,Carnelos; Chiara,20,0,20,0
1713495665294,LISP 5A,A00,507541,Munoz Sanchez; Alicia,14,0,20,6
1713495666320,LISP 5B,A00,507671,Munoz Sanchez; Alicia,12,0,20,8
1713495667344,LISP 5C,A00,507696,Munoz Sanchez; Alicia,11,0,20,9
1713495668374,MAE 197,001,528363,Boechler; Nicholas Sebastia,9998,0,9999,1
1713495669405,MATH 197,001,523477,Kedlaya; Kiran S.,9999,0,9999,0
1713495669405,MATH 197,002,563811,Zhang; Danna,9998,0,9999,1
1713495670429,MCWP 40R,A00,518780,Staff,14,0,20,6
1713495670429,MCWP 40R,B00,518781,Staff,13,0,20,7
1713495670429,MCWP 40R,C00,518783,Staff,9,0,20,11
1713495671458,MCWP 50R,A00,518791,Staff,7,0,20,13
1713495671458,MCWP 50R,B00,518792,Staff,3,0,20,17
1713495671458,MCWP 50R,C00,518793,Staff,7,0,20,13
1713495671458,MCWP 50R,D00,518794,Staff,0,0,20,20
1713495671458,MCWP 50R,E00,518795,Staff,0,0,20,20
1713495671458,MCWP 50R,F00,518796,Staff,11,0,20,9
1713495671458,MCWP 50R,G00,518797,Staff,10,0,20,10
1713495672484,MMW 12R,A01,514034,Herbst; Matthew,4,0,16,12
1713495672484,MMW 12R,A02,514035,Herbst; Matthew,13,0,16,3
1713495673509,MMW 13R,A01,514037,Staff,0,6,16,16
1713495673509,MMW 13R,A02,514039,Staff,0,6,16,16
1713495675562,SIO 295LS,A00,523233,Staff,15,0,30,15
1713495676586,SIO 295S,A00,523232,Staff,15,0,30,15
1713495677611,SOCI 117,A01,494376,Staff,0,2,5,5
1713495678638,WES 237B,A00,494380,Staff,19,0,20,1
1713495680714,AESE 279B,A00,494370,Wade; Jon P,33,0,33,0
1713495681738,AIP 197,001,627712,Vespa; Emanuel Ignacio,9999,0,9999,0
1713495682764,ANAR 135S,A00,494369,Braswell; Geoffrey E.,0,0,0,0
1713495683792,CAT 124RS,A01,519847,Geibel; William,6,0,20,14
1713495684821,CAT 125RS,A01,515971,Geibel; William,6,0,20,14
1713495685850,CLRE 250,A00,511389,Morris; Sheldon,9996,0,9999,3
1713495686877,CLRE 251,A00,507176,Mehta; Ravindra L.,9996,0,9999,3
1713495686877,CLRE 251,B00,511410,Mehta; Ravindra L.,9998,0,9999,1
1713495687906,CLRE 252,A00,507189,Cuomo; Raphael Eduardo,9998,0,9999,1
1713495688933,CLRE 253,A00,507199,Vaida; Florin,9997,0,9999,2
1713495688933,CLRE 253,B00,507202,Vaida; Florin,9999,0,9999,0
1713495689962,CLRE 259,A00,507211,Patel; Hemal,9996,0,9999,3
1713495690987,CLRE 260,A00,507221,Cuomo; Raphael Eduardo,9999,0,9999,0
1713495692013,CLRE 297,001,507242,Cuomo; Raphael Eduardo,9999,0,9999,0
1713495693038,CSE 191,A00,516875,Minnes Kemp; Mor Mia,9999,0,9999,0
1713495694064,CSS 201S,A01,494383,Staff,35,0,35,0
1713495695089,CSS 202S,A01,494387,Staff,35,0,35,0
1713495696113,EAP 100,A00,516065,Staff,9792,0,9999,207
1713495697140,ECE 45,A01,507414,Staff,38,0,60,22
1713495698165,ECE 100,A01,507416,Baghdadchi; Saharnaz,0,0,20,20
1713495698165,ECE 100,A02,507418,Baghdadchi; Saharnaz,19,0,20,1
1713495699245,ECE 111,A01,507420,Staff,27,0,50,23
1713495700271,ECE 197,001,548057,Sievenpiper; Daniel F.,9998,0,9999,1
1713495701298,EDS 115,A00,507243,Choi; Bailey Miyeon,27,0,28,1
1713495702324,EDS 117,A01,494379,Staff,15,0,25,10
1713495703348,EDS 125,A00,507246,Hopkins; Megan Beth,27,0,30,3
1713495704373,EDS 128A,A01,507264,Fargason; Sharon Gayle,26,0,26,0
1713495705402,EDS 128B,A01,507293,Pappas; Elizabeth,30,0,30,0
1713495706429,EDS 139,A00,507294,Fargason; Sharon Gayle,30,0,30,0
1713495706429,EDS 139,B00,507313,Pappas; Elizabeth,30,0,30,0
1713495707457,EDS 201,A00,507315,Staff,18,0,30,12
1713495708485,EDS 203,A01,507317,Halter; Christopher P.,17,0,30,13
1713495709511,EDS 204R,A01,507319,Halter; Christopher P.,0,1,30,30
1713495709511,EDS 204R,B01,507331,Heinzman; Erica M.,22,0,30,8
1713495710540,EDS 206R,A00,507332,Staff,0,2,30,30
1713495710540,EDS 206R,B00,507343,Staff,23,0,30,7
1713495711565,EDS 250,A00,507344,Hemans; Patricia Ann Benitez,27,0,40,13
1713495712590,EDS 281,A00,507345,Daly; Alan J.,18,0,18,0
1713495713615,EDS 284,A00,507350,Daly; Alan J.,16,0,16,0
1713495714643,EDS 286,A00,507359,Fine; Sarah,18,0,18,0
1713495715669,EDS 289C,A01,507361,Daly; Alan J.,18,0,18,0
1713495716693,EDS 290,A00,507366,Hofstetter; Carolyn,15,0,15,0
1713495717721,LIGM 5A,A00,507421,Fischer-Grunski; Eva K,20,0,20,0
1713495718745,LIGM 5B,A00,507423,Fischer-Grunski; Eva K,20,0,20,0
1713495719770,LIGM 5C,A00,507425,Fischer-Grunski; Eva K,20,0,20,0
1713495720800,LIIT 5AS,A00,507427,Carnelos; Chiara,20,0,20,0
1713495721829,LIIT 5BS,A00,507430,Carnelos; Chiara,20,0,20,0
1713495722855,LIIT 5CS,A00,507432,Carnelos; Chiara,20,0,20,0
1713495723881,LISP 5A,A00,507541,Munoz Sanchez; Alicia,14,0,20,6
1713495724906,LISP 5B,A00,507671,Munoz Sanchez; Alicia,12,0,20,8
1713495725936,LISP 5C,A00,507696,Munoz Sanchez; Alicia,11,0,20,9
1713495726961,MAE 197,001,528363,Boechler; Nicholas Sebastia,9998,0,9999,1
1713495727988,MATH 197,001,523477,Kedlaya; Kiran S.,9999,0,9999,0
1713495727988,MATH 197,002,563811,Zhang; Danna,9998,0,9999,1
1713495729014,MCWP 40R,A00,518780,Staff,14,0,20,6
1713495729014,MCWP 40R,B00,518781,Staff,13,0,20,7
1713495729014,MCWP 40R,C00,518783,Staff,9,0,20,11
1713495730041,MCWP 50R,A00,518791,Staff,7,0,20,13
1713495730041,MCWP 50R,B00,518792,Staff,3,0,20,17
1713495730041,MCWP 50R,C00,518793,Staff,7,0,20,13
1713495730041,MCWP 50R,D00,518794,Staff,0,0,20,20
1713495730041,MCWP 50R,E00,518795,Staff,0,0,20,20
1713495730041,MCWP 50R,F00,518796,Staff,11,0,20,9
1713495730041,MCWP 50R,G00,518797,Staff,10,0,20,10
1713495731069,MMW 12R,A01,514034,Herbst; Matthew,4,0,16,12
1713495731069,MMW 12R,A02,514035,Herbst; Matthew,13,0,16,3
1713495732098,MMW 13R,A01,514037,Staff,0,6,16,16
1713495732098,MMW 13R,A02,514039,Staff,0,6,16,16
1713495734204,SIO 295LS,A00,523233,Staff,15,0,30,15
1713495735230,SIO 295S,A00,523232,Staff,15,0,30,15
1713495736259,SOCI 117,A01,494376,Staff,0,2,5,5
1713495737289,WES 237B,A00,494380,Staff,19,0,20,1
1713495739360,AESE 279B,A00,494370,Wade; Jon P,33,0,33,0
1713495740388,AIP 197,001,627712,Vespa; Emanuel Ignacio,9999,0,9999,0
1713495741414,ANAR 135S,A00,494369,Braswell; Geoffrey E.,0,0,0,0
1713495742439,CAT 124RS,A01,519847,Geibel; William,6,0,20,14
1713495743463,CAT 125RS,A01,515971,Geibel; William,6,0,20,14
1713495744488,CLRE 250,A00,511389,Morris; Sheldon,9996,0,9999,3
1713495745513,CLRE 251,A00,507176,Mehta; Ravindra L.,9996,0,9999,3
1713495745513,CLRE 251,B00,511410,Mehta; Ravindra L.,9998,0,9999,1
1713495746537,CLRE 252,A00,507189,Cuomo; Raphael Eduardo,9998,0,9999,1
1713495747563,CLRE 253,A00,507199,Vaida; Florin,9997,0,9999,2
1713495747563,CLRE 253,B00,507202,Vaida; Florin,9999,0,9999,0
1713495748588,CLRE 259,A00,507211,Patel; Hemal,9996,0,9999,3
1713495749613,CLRE 260,A00,507221,Cuomo; Raphael Eduardo,9999,0,9999,0
1713495750641,CLRE 297,001,507242,Cuomo; Raphael Eduardo,9999,0,9999,0
1713495751668,CSE 191,A00,516875,Minnes Kemp; Mor Mia,9999,0,9999,0
1713495752695,CSS 201S,A01,494383,Staff,35,0,35,0
1713495753724,CSS 202S,A01,494387,Staff,35,0,35,0
1713495754749,EAP 100,A00,516065,Staff,9792,0,9999,207
1713495755778,ECE 45,A01,507414,Staff,38,0,60,22
1713495756804,ECE 100,A01,507416,Baghdadchi; Saharnaz,0,0,20,20
1713495756804,ECE 100,A02,507418,Baghdadchi; Saharnaz,19,0,20,1
1713495757830,ECE 111,A01,507420,Staff,27,0,50,23
1713495758858,ECE 197,001,548057,Sievenpiper; Daniel F.,9998,0,9999,1
1713495759884,EDS 115,A00,507243,Choi; Bailey Miyeon,27,0,28,1
1713495760913,EDS 117,A01,494379,Staff,15,0,25,10
1713495761938,EDS 125,A00,507246,Hopkins; Megan Beth,27,0,30,3
1713495762966,EDS 128A,A01,507264,Fargason; Sharon Gayle,26,0,26,0
1713495763991,EDS 128B,A01,507293,Pappas; Elizabeth,30,0,30,0
1713495765018,EDS 139,A00,507294,Fargason; Sharon Gayle,30,0,30,0
1713495765018,EDS 139,B00,507313,Pappas; Elizabeth,30,0,30,0
1713495766046,EDS 201,A00,507315,Staff,18,0,30,12
1713495767073,EDS 203,A01,507317,Halter; Christopher P.,17,0,30,13
1713495768102,EDS 204R,A01,507319,Halter; Christopher P.,0,1,30,30
1713495768102,EDS 204R,B01,507331,Heinzman; Erica M.,22,0,30,8
1713495769129,EDS 206R,A00,507332,Staff,0,2,30,30
1713495769129,EDS 206R,B00,507343,Staff,23,0,30,7
1713495770154,EDS 250,A00,507344,Hemans; Patricia Ann Benitez,27,0,40,13
1713495771182,EDS 281,A00,507345,Daly; Alan J.,18,0,18,0
1713495772211,EDS 284,A00,507350,Daly; Alan J.,16,0,16,0
1713495773239,EDS 286,A00,507359,Fine; Sarah,18,0,18,0
1713495774267,EDS 289C,A01,507361,Daly; Alan J.,18,0,18,0
1713495775292,EDS 290,A00,507366,Hofstetter; Carolyn,15,0,15,0
1713495776322,LIGM 5A,A00,507421,Fischer-Grunski; Eva K,20,0,20,0
1713495777347,LIGM 5B,A00,507423,Fischer-Grunski; Eva K,20,0,20,0
1713495778372,LIGM 5C,A00,507425,Fischer-Grunski; Eva K,20,0,20,0
1713495779400,LIIT 5AS,A00,507427,Carnelos; Chiara,20,0,20,0
1713495780429,LIIT 5BS,A00,507430,Carnelos; Chiara,20,0,20,0
1713495781455,LIIT 5CS,A00,507432,Carnelos; Chiara,20,0,20,0
1713495782481,LISP 5A,A00,507541,Munoz Sanchez; Alicia,14,0,20,6
1713495783508,LISP 5B,A00,507671,Munoz Sanchez; Alicia,12,0,20,8
1713495784533,LISP 5C,A00,507696,Munoz Sanchez; Alicia,11,0,20,9
1713495785557,MAE 197,001,528363,Boechler; Nicholas Sebastia,9998,0,9999,1
1713495786582,MATH 197,001,523477,Kedlaya; Kiran S.,9999,0,9999,0
1713495786582,MATH 197,002,563811,Zhang; Danna,9998,0,9999,1
1713495787606,MCWP 40R,A00,518780,Staff,14,0,20,6
1713495787606,MCWP 40R,B00,518781,Staff,13,0,20,7
1713495787606,MCWP 40R,C00,518783,Staff,9,0,20,11
1713495788632,MCWP 50R,A00,518791,Staff,7,0,20,13
1713495788632,MCWP 50R,B00,518792,Staff,3,0,20,17
1713495788632,MCWP 50R,C00,518793,Staff,7,0,20,13
1713495788632,MCWP 50R,D00,518794,Staff,0,0,20,20
1713495788632,MCWP 50R,E00,518795,Staff,0,0,20,20
1713495788632,MCWP 50R,F00,518796,Staff,11,0,20,9
1713495788632,MCWP 50R,G00,518797,Staff,10,0,20,10
1713495789657,MMW 12R,A01,514034,Herbst; Matthew,4,0,16,12
1713495789657,MMW 12R,A02,514035,Herbst; Matthew,13,0,16,3
1713495790684,MMW 13R,A01,514037,Staff,0,6,16,16
1713495790684,MMW 13R,A02,514039,Staff,0,6,16,16
1713495792736,SIO 295LS,A00,523233,Staff,15,0,30,15
1713495793760,SIO 295S,A00,523232,Staff,15,0,30,15
1713495794789,SOCI 117,A01,494376,Staff,0,2,5,5
1713495795815,WES 237B,A00,494380,Staff,19,0,20,1
1713495797881,AESE 279B,A00,494370,Wade; Jon P,33,0,33,0
1713495798906,AIP 197,001,627712,Vespa; Emanuel Ignacio,9999,0,9999,0
1713495799934,ANAR 135S,A00,494369,Braswell; Geoffrey E.,0,0,0,0
1713495800960,CAT 124RS,A01,519847,Geibel; William,6,0,20,14
1713495801991,CAT 125RS,A01,515971,Geibel; William,6,0,20,14
1713495803073,CLRE 250,A00,511389,Morris; Sheldon,9996,0,9999,3
1713495804099,CLRE 251,A00,507176,Mehta; Ravindra L.,9996,0,9999,3
1713495804099,CLRE 251,B00,511410,Mehta; Ravindra L.,9998,0,9999,1
1713495805129,CLRE 252,A00,507189,Cuomo; Raphael Eduardo,9998,0,9999,1
1713495806155,CLRE 253,A00,507199,Vaida; Florin,9997,0,9999,2
1713495806155,CLRE 253,B00,507202,Vaida; Florin,9999,0,9999,0
1713495807180,CLRE 259,A00,507211,Patel; Hemal,9996,0,9999,3
1713495808208,CLRE 260,A00,507221,Cuomo; Raphael Eduardo,9999,0,9999,0
1713495809235,CLRE 297,001,507242,Cuomo; Raphael Eduardo,9999,0,9999,0
1713495810260,CSE 191,A00,516875,Minnes Kemp; Mor Mia,9999,0,9999,0
1713495811286,CSS 201S,A01,494383,Staff,35,0,35,0
1713495812315,CSS 202S,A01,494387,Staff,35,0,35,0
1713495813340,EAP 100,A00,516065,Staff,9792,0,9999,207
1713495814367,ECE 45,A01,507414,Staff,38,0,60,22
1713495815394,ECE 100,A01,507416,Baghdadchi; Saharnaz,0,0,20,20
1713495815394,ECE 100,A02,507418,Baghdadchi; Saharnaz,19,0,20,1
1713495816420,ECE 111,A01,507420,Staff,27,0,50,23
1713495817448,ECE 197,001,548057,Sievenpiper; Daniel F.,9998,0,9999,1
1713495818474,EDS 115,A00,507243,Choi; Bailey Miyeon,27,0,28,1
1713495819502,EDS 117,A01,494379,Staff,15,0,25,10
1713495820527,EDS 125,A00,507246,Hopkins; Megan Beth,27,0,30,3
1713495821552,EDS 128A,A01,507264,Fargason; Sharon Gayle,26,0,26,0
1713495822577,EDS 128B,A01,507293,Pappas; Elizabeth,30,0,30,0
1713495823602,EDS 139,A00,507294,Fargason; Sharon Gayle,30,0,30,0
1713495823602,EDS 139,B00,507313,Pappas; Elizabeth,30,0,30,0
1713495824628,EDS 201,A00,507315,Staff,18,0,30,12
1713495825658,EDS 203,A01,507317,Halter; Christopher P.,17,0,30,13
1713495826687,EDS 204R,A01,507319,Halter; Christopher P.,0,1,30,30
1713495826687,EDS 204R,B01,507331,Heinzman; Erica M.,22,0,30,8
1713495827713,EDS 206R,A00,507332,Staff,0,2,30,30
1713495827713,EDS 206R,B00,507343,Staff,23,0,30,7
1713495828739,EDS 250,A00,507344,Hemans; Patricia Ann Benitez,27,0,40,13
1713495829767,EDS 281,A00,507345,Daly; Alan J.,18,0,18,0
1713495830793,EDS 284,A00,507350,Daly; Alan J.,16,0,16,0
1713495831817,EDS 286,A00,507359,Fine; Sarah,18,0,18,0
1713495832841,EDS 289C,A01,507361,Daly; Alan J.,18,0,18,0
1713495833866,EDS 290,A00,507366,Hofstetter; Carolyn,15,0,15,0
1713495834892,LIGM 5A,A00,507421,Fischer-Grunski; Eva K,20,0,20,0
1713495835917,LIGM 5B,A00,507423,Fischer-Grunski; Eva K,20,0,20,0
1713495836946,LIGM 5C,A00,507425,Fischer-Grunski; Eva K,20,0,20,0
1713495837972,LIIT 5AS,A00,507427,Carnelos; Chiara,20,0,20,0
1713495838997,LIIT 5BS,A00,507430,Carnelos; Chiara,20,0,20,0
1713495840028,LIIT 5CS,A00,507432,Carnelos; Chiara,20,0,20,0
1713495841058,LISP 5A,A00,507541,Munoz Sanchez; Alicia,14,0,20,6
1713495842084,LISP 5B,A00,507671,Munoz Sanchez; Alicia,12,0,20,8
1713495843109,LISP 5C,A00,507696,Munoz Sanchez; Alicia,11,0,20,9
1713495844134,MAE 197,001,528363,Boechler; Nicholas Sebastia,9998,0,9999,1
1713495845161,MATH 197,001,523477,Kedlaya; Kiran S.,9999,0,9999,0
1713495845161,MATH 197,002,563811,Zhang; Danna,9998,0,9999,1
1713495846190,MCWP 40R,A00,518780,Staff,14,0,20,6
1713495846190,MCWP 40R,B00,518781,Staff,13,0,20,7
1713495846190,MCWP 40R,C00,518783,Staff,9,0,20,11
1713495847214,MCWP 50R,A00,518791,Staff,7,0,20,13
1713495847214,MCWP 50R,B00,518792,Staff,3,0,20,17
1713495847214,MCWP 50R,C00,518793,Staff,7,0,20,13
1713495847214,MCWP 50R,D00,518794,Staff,0,0,20,20
1713495847214,MCWP 50R,E00,518795,Staff,0,0,20,20
1713495847214,MCWP 50R,F00,518796,Staff,11,0,20,9
1713495847214,MCWP 50R,G00,518797,Staff,10,0,20,10
1713495848243,MMW 12R,A01,514034,Herbst; Matthew,4,0,16,12
1713495848243,MMW 12R,A02,514035,Herbst; Matthew,13,0,16,3
1713495849268,MMW 13R,A01,514037,Staff,0,7,16,16
1713495849268,MMW 13R,A02,514039,Staff,0,6,16,16
1713495851320,SIO 295LS,A00,523233,Staff,15,0,30,15
1713495852345,SIO 295S,A00,523232,Staff,15,0,30,15
1713495853375,SOCI 117,A01,494376,Staff,0,2,5,5
1713495854400,WES 237B,A00,494380,Staff,19,0,20,1
1713495856463,AESE 279B,A00,494370,Wade; Jon P,33,0,33,0
1713495857488,AIP 197,001,627712,Vespa; Emanuel Ignacio,9999,0,9999,0
1713495858513,ANAR 135S,A00,494369,Braswell; Geoffrey E.,0,0,0,0
1713495859539,CAT 124RS,A01,519847,Geibel; William,6,0,20,14
1713495860565,CAT 125RS,A01,515971,Geibel; William,6,0,20,14
1713495861593,CLRE 250,A00,511389,Morris; Sheldon,9996,0,9999,3
1713495862618,CLRE 251,A00,507176,Mehta; Ravindra L.,9996,0,9999,3
1713495862618,CLRE 251,B00,511410,Mehta; Ravindra L.,9998,0,9999,1
1713495863644,CLRE 252,A00,507189,Cuomo; Raphael Eduardo,9998,0,9999,1
1713495864673,CLRE 253,A00,507199,Vaida; Florin,9997,0,9999,2
1713495864673,CLRE 253,B00,507202,Vaida; Florin,9999,0,9999,0
1713495865701,CLRE 259,A00,507211,Patel; Hemal,9996,0,9999,3
1713495866725,CLRE 260,A00,507221,Cuomo; Raphael Eduardo,9999,0,9999,0
1713495867754,CLRE 297,001,507242,Cuomo; Raphael Eduardo,9999,0,9999,0
1713495868779,CSE 191,A00,516875,Minnes Kemp; Mor Mia,9999,0,9999,0
1713495869806,CSS 201S,A01,494383,Staff,35,0,35,0
1713495870831,CSS 202S,A01,494387,Staff,35,0,35,0
1713495871856,EAP 100,A00,516065,Staff,9792,0,9999,207
1713495872884,ECE 45,A01,507414,Staff,37,0,60,23
1713495873909,ECE 100,A01,507416,Baghdadchi; Saharnaz,0,0,20,20
1713495873909,ECE 100,A02,507418,Baghdadchi; Saharnaz,19,0,20,1
1713495874937,ECE 111,A01,507420,Staff,27,0,50,23
1713495875962,ECE 197,001,548057,Sievenpiper; Daniel F.,9998,0,9999,1
1713495876986,EDS 115,A00,507243,Choi; Bailey Miyeon,27,0,28,1
1713495878013,EDS 117,A01,494379,Staff,15,0,25,10
1713495879039,EDS 125,A00,507246,Hopkins; Megan Beth,27,0,30,3
1713495880067,EDS 128A,A01,507264,Fargason; Sharon Gayle,26,0,26,0
1713495881093,EDS 128B,A01,507293,Pappas; Elizabeth,30,0,30,0
1713495882118,EDS 139,A00,507294,Fargason; Sharon Gayle,30,0,30,0
1713495882118,EDS 139,B00,507313,Pappas; Elizabeth,30,0,30,0
1713495883143,EDS 201,A00,507315,Staff,18,0,30,12
1713495884171,EDS 203,A01,507317,Halter; Christopher P.,17,0,30,13
1713495885200,EDS 204R,A01,507319,Halter; Christopher P.,0,1,30,30
1713495885200,EDS 204R,B01,507331,Heinzman; Erica M.,22,0,30,8
1713495886229,EDS 206R,A00,507332,Staff,0,2,30,30
1713495886229,EDS 206R,B00,507343,Staff,23,0,30,7
1713495887254,EDS 250,A00,507344,Hemans; Patricia Ann Benitez,27,0,40,13
1713495888280,EDS 281,A00,507345,Daly; Alan J.,18,0,18,0
1713495889304,EDS 284,A00,507350,Daly; Alan J.,16,0,16,0
1713495890329,EDS 286,A00,507359,Fine; Sarah,18,0,18,0
1713495891356,EDS 289C,A01,507361,Daly; Alan J.,18,0,18,0
1713495892380,EDS 290,A00,507366,Hofstetter; Carolyn,15,0,15,0
1713495893411,LIGM 5A,A00,507421,Fischer-Grunski; Eva K,20,0,20,0
1713495894441,LIGM 5B,A00,507423,Fischer-Grunski; Eva K,20,0,20,0
1713495895466,LIGM 5C,A00,507425,Fischer-Grunski; Eva K,20,0,20,0
1713495896496,LIIT 5AS,A00,507427,Carnelos; Chiara,20,0,20,0
1713495897522,LIIT 5BS,A00,507430,Carnelos; Chiara,20,0,20,0
1713495898547,LIIT 5CS,A00,507432,Carnelos; Chiara,20,0,20,0
1713495899577,LISP 5A,A00,507541,Munoz Sanchez; Alicia,14,0,20,6
1713495900606,LISP 5B,A00,507671,Munoz Sanchez; Alicia,12,0,20,8
1713495901635,LISP 5C,A00,507696,Munoz Sanchez; Alicia,11,0,20,9
1713495902665,MAE 197,001,528363,Boechler; Nicholas Sebastia,9998,0,9999,1
1713495903692,MATH 197,001,523477,Kedlaya; Kiran S.,9999,0,9999,0
1713495903692,MATH 197,002,563811,Zhang; Danna,9998,0,9999,1
1713495904716,MCWP 40R,A00,518780,Staff,14,0,20,6
1713495904716,MCWP 40R,B00,518781,Staff,13,0,20,7
1713495904716,MCWP 40R,C00,518783,Staff,9,0,20,11
1713495905742,MCWP 50R,A00,518791,Staff,7,0,20,13
1713495905742,MCWP 50R,B00,518792,Staff,3,0,20,17
1713495905742,MCWP 50R,C00,518793,Staff,7,0,20,13
1713495905742,MCWP 50R,D00,518794,Staff,0,0,20,20
1713495905742,MCWP 50R,E00,518795,Staff,0,0,20,20
1713495905742,MCWP 50R,F00,518796,Staff,11,0,20,9
1713495905742,MCWP 50R,G00,518797,Staff,10,0,20,10
1713495906821,MMW 12R,A01,514034,Herbst; Matthew,4,0,16,12
1713495906821,MMW 12R,A02,514035,Herbst; Matthew,13,0,16,3
1713495907847,MMW 13R,A01,514037,Staff,0,7,16,16
1713495907847,MMW 13R,A02,514039,Staff,0,6,16,16
1713495909900,SIO 295LS,A00,523233,Staff,15,0,30,15
1713495910926,SIO 295S,A00,523232,Staff,15,0,30,15
1713495911955,SOCI 117,A01,494376,Staff,0,2,5,5
1713495912980,WES 237B,A00,494380,Staff,19,0,20,1
1713495915050,AESE 279B,A00,494370,Wade; Jon P,33,0,33,0
1713495916078,AIP 197,001,627712,Vespa; Emanuel Ignacio,9999,0,9999,0
1713495917103,ANAR 135S,A00,494369,Braswell; Geoffrey E.,0,0,0,0
1713495918130,CAT 124RS,A01,519847,Geibel; William,6,0,20,14
1713495919155,CAT 125RS,A01,515971,Geibel; William,6,0,20,14
1713495920184,CLRE 250,A00,511389,Morris; Sheldon,9996,0,9999,3
1713495921210,CLRE 251,A00,507176,Mehta; Ravindra L.,9996,0,9999,3
1713495921210,CLRE 251,B00,511410,Mehta; Ravindra L.,9998,0,9999,1
1713495922237,CLRE 252,A00,507189,Cuomo; Raphael Eduardo,9998,0,9999,1
1713495923262,CLRE 253,A00,507199,Vaida; Florin,9997,0,9999,2
1713495923262,CLRE 253,B00,507202,Vaida; Florin,9999,0,9999,0
1713495924295,CLRE 259,A00,507211,Patel; Hemal,9996,0,9999,3
1713495925320,CLRE 260,A00,507221,Cuomo; Raphael Eduardo,9999,0,9999,0
1713495926348,CLRE 297,001,507242,Cuomo; Raphael Eduardo,9999,0,9999,0
1713495927374,CSE 191,A00,516875,Minnes Kemp; Mor Mia,9999,0,9999,0
1713495928399,CSS 201S,A01,494383,Staff,35,0,35,0
1713495929425,CSS 202S,A01,494387,Staff,35,0,35,0
1713495930450,EAP 100,A00,516065,Staff,9792,0,9999,207
1713495931474,ECE 45,A01,507414,Staff,37,0,60,23
1713495932501,ECE 100,A01,507416,Baghdadchi; Saharnaz,0,0,20,20
1713495932501,ECE 100,A02,507418,Baghdadchi; Saharnaz,19,0,20,1
1713495933527,ECE 111,A01,507420,Staff,27,0,50,23
1713495934553,ECE 197,001,548057,Sievenpiper; Daniel F.,9998,0,9999,1
1713495935581,EDS 115,A00,507243,Choi; Bailey Miyeon,27,0,28,1
1713495936606,EDS 117,A01,494379,Staff,15,0,25,10
1713495937630,EDS 125,A00,507246,Hopkins; Megan Beth,27,0,30,3
1713495938656,EDS 128A,A01,507264,Fargason; Sharon Gayle,26,0,26,0
1713495939684,EDS 128B,A01,507293,Pappas; Elizabeth,30,0,30,0
1713495940708,EDS 139,A00,507294,Fargason; Sharon Gayle,30,0,30,0
1713495940708,EDS 139,B00,507313,Pappas; Elizabeth,30,0,30,0
1713495941736,EDS 201,A00,507315,Staff,18,0,30,12
1713495942762,EDS 203,A01,507317,Halter; Christopher P.,17,0,30,13
1713495943794,EDS 204R,A01,507319,Halter; Christopher P.,0,1,30,30
1713495943794,EDS 204R,B01,507331,Heinzman; Erica M.,22,0,30,8
1713495944820,EDS 206R,A00,507332,Staff,0,2,30,30
1713495944820,EDS 206R,B00,507343,Staff,23,0,30,7
1713495945846,EDS 250,A00,507344,Hemans; Patricia Ann Benitez,27,0,40,13
1713495946870,EDS 281,A00,507345,Daly; Alan J.,18,0,18,0
1713495947898,EDS 284,A00,507350,Daly; Alan J.,16,0,16,0
1713495948923,EDS 286,A00,507359,Fine; Sarah,18,0,18,0
1713495949951,EDS 289C,A01,507361,Daly; Alan J.,18,0,18,0
1713495950977,EDS 290,A00,507366,Hofstetter; Carolyn,15,0,15,0
1713495952007,LIGM 5A,A00,507421,Fischer-Grunski; Eva K,20,0,20,0
1713495953032,LIGM 5B,A00,507423,Fischer-Grunski; Eva K,20,0,20,0
1713495954057,LIGM 5C,A00,507425,Fischer-Grunski; Eva K,20,0,20,0
1713495955082,LIIT 5AS,A00,507427,Carnelos; Chiara,20,0,20,0
1713495956107,LIIT 5BS,A00,507430,Carnelos; Chiara,20,0,20,0
1713495957132,LIIT 5CS,A00,507432,Carnelos; Chiara,20,0,20,0
1713495958158,LISP 5A,A00,507541,Munoz Sanchez; Alicia,14,0,20,6
1713495959185,LISP 5B,A00,507671,Munoz Sanchez; Alicia,12,0,20,8
1713495960211,LISP 5C,A00,507696,Munoz Sanchez; Alicia,11,0,20,9
1713495961238,MAE 197,001,528363,Boechler; Nicholas Sebastia,9998,0,9999,1
1713495962264,MATH 197,001,523477,Kedlaya; Kiran S.,9999,0,9999,0
1713495962264,MATH 197,002,563811,Zhang; Danna,9998,0,9999,1
1713495963288,MCWP 40R,A00,518780,Staff,14,0,20,6
1713495963288,MCWP 40R,B00,518781,Staff,12,0,20,8
1713495963288,MCWP 40R,C00,518783,Staff,9,0,20,11
1713495964313,MCWP 50R,A00,518791,Staff,7,0,20,13
1713495964313,MCWP 50R,B00,518792,Staff,3,0,20,17
1713495964313,MCWP 50R,C00,518793,Staff,7,0,20,13
1713495964313,MCWP 50R,D00,518794,Staff,0,0,20,20
1713495964313,MCWP 50R,E00,518795,Staff,0,0,20,20
1713495964313,MCWP 50R,F00,518796,Staff,11,0,20,9
1713495964313,MCWP 50R,G00,518797,Staff,10,0,20,10
1713495965341,MMW 12R,A01,514034,Herbst; Matthew,4,0,16,12
1713495965341,MMW 12R,A02,514035,Herbst; Matthew,13,0,16,3
1713495966369,MMW 13R,A01,514037,Staff,0,7,16,16
1713495966369,MMW 13R,A02,514039,Staff,0,6,16,16
1713495968424,SIO 295LS,A00,523233,Staff,15,0,30,15
1713495969453,SIO 295S,A00,523232,Staff,15,0,30,15
1713495970481,SOCI 117,A01,494376,Staff,0,2,5,5
1713495971510,WES 237B,A00,494380,Staff,19,0,20,1
1713495973584,AESE 279B,A00,494370,Wade; Jon P,33,0,33,0
1713495974609,AIP 197,001,627712,Vespa; Emanuel Ignacio,9999,0,9999,0
1713495975635,ANAR 135S,A00,494369,Braswell; Geoffrey E.,0,0,0,0
1713495976664,CAT 124RS,A01,519847,Geibel; William,6,0,20,14
1713495977690,CAT 125RS,A01,515971,Geibel; William,6,0,20,14
1713495978715,CLRE 250,A00,511389,Morris; Sheldon,9996,0,9999,3
1713495979740,CLRE 251,A00,507176,Mehta; Ravindra L.,9996,0,9999,3
1713495979740,CLRE 251,B00,511410,Mehta; Ravindra L.,9998,0,9999,1
1713495980766,CLRE 252,A00,507189,Cuomo; Raphael Eduardo,9998,0,9999,1
1713495981795,CLRE 253,A00,507199,Vaida; Florin,9997,0,9999,2
1713495981795,CLRE 253,B00,507202,Vaida; Florin,9999,0,9999,0
1713495982820,CLRE 259,A00,507211,Patel; Hemal,9996,0,9999,3
1713495983846,CLRE 260,A00,507221,Cuomo; Raphael Eduardo,9999,0,9999,0
1713495984871,CLRE 297,001,507242,Cuomo; Raphael Eduardo,9999,0,9999,0
1713495985896,CSE 191,A00,516875,Minnes Kemp; Mor Mia,9999,0,9999,0
1713495986922,CSS 201S,A01,494383,Staff,35,0,35,0
1713495987949,CSS 202S,A01,494387,Staff,35,0,35,0
1713495988974,EAP 100,A00,516065,Staff,9792,0,9999,207
1713495990000,ECE 45,A01,507414,Staff,37,0,60,23
1713495991025,ECE 100,A01,507416,Baghdadchi; Saharnaz,0,0,20,20
1713495991025,ECE 100,A02,507418,Baghdadchi; Saharnaz,19,0,20,1
1713495992049,ECE 111,A01,507420,Staff,27,0,50,23
1713495993073,ECE 197,001,548057,Sievenpiper; Daniel F.,9998,0,9999,1
1713495994102,EDS 115,A00,507243,Choi; Bailey Miyeon,27,0,28,1
1713495995128,EDS 117,A01,494379,Staff,15,0,25,10
1713495996156,EDS 125,A00,507246,Hopkins; Megan Beth,27,0,30,3
1713495997186,EDS 128A,A01,507264,Fargason; Sharon Gayle,26,0,26,0
1713495998212,EDS 128B,A01,507293,Pappas; Elizabeth,30,0,30,0
1713495999239,EDS 139,A00,507294,Fargason; Sharon Gayle,30,0,30,0
1713495999239,EDS 139,B00,507313,Pappas; Elizabeth,30,0,30,0
1713496000263,EDS 201,A00,507315,Staff,18,0,30,12
1713496001290,EDS 203,A01,507317,Halter; Christopher P.,17,0,30,13
1713496002320,EDS 204R,A01,507319,Halter; Christopher P.,0,1,30,30
1713496002320,EDS 204R,B01,507331,Heinzman; Erica M.,22,0,30,8
1713496003347,EDS 206R,A00,507332,Staff,0,2,30,30
1713496003347,EDS 206R,B00,507343,Staff,23,0,30,7
1713496004373,EDS 250,A00,507344,Hemans; Patricia Ann Benitez,27,0,40,13
1713496005400,EDS 281,A00,507345,Daly; Alan J.,18,0,18,0
1713496006426,EDS 284,A00,507350,Daly; Alan J.,16,0,16,0
1713496007455,EDS 286,A00,507359,Fine; Sarah,18,0,18,0
1713496008482,EDS 289C,A01,507361,Daly; Alan J.,18,0,18,0
1713496009509,EDS 290,A00,507366,Hofstetter; Carolyn,15,0,15,0
1713496010590,LIGM 5A,A00,507421,Fischer-Grunski; Eva K,20,0,20,0
1713496011619,LIGM 5B,A00,507423,Fischer-Grunski; Eva K,20,0,20,0
1713496012648,LIGM 5C,A00,507425,Fischer-Grunski; Eva K,20,0,20,0
1713496013677,LIIT 5AS,A00,507427,Carnelos; Chiara,20,0,20,0
1713496014702,LIIT 5BS,A00,507430,Carnelos; Chiara,20,0,20,0
1713496015726,LIIT 5CS,A00,507432,Carnelos; Chiara,20,0,20,0
1713496016756,LISP 5A,A00,507541,Munoz Sanchez; Alicia,14,0,20,6
1713496017782,LISP 5B,A00,507671,Munoz Sanchez; Alicia,12,0,20,8
1713496018807,LISP 5C,A00,507696,Munoz Sanchez; Alicia,11,0,20,9
1713496019836,MAE 197,001,528363,Boechler; Nicholas Sebastia,9998,0,9999,1
1713496020864,MATH 197,001,523477,Kedlaya; Kiran S.,9999,0,9999,0
1713496020864,MATH 197,002,563811,Zhang; Danna,9998,0,9999,1
1713496021892,MCWP 40R,A00,518780,Staff,14,0,20,6
1713496021892,MCWP 40R,B00,518781,Staff,12,0,20,8
1713496021892,MCWP 40R,C00,518783,Staff,9,0,20,11
1713496022921,MCWP 50R,A00,518791,Staff,7,0,20,13
1713496022921,MCWP 50R,B00,518792,Staff,3,0,20,17
1713496022921,MCWP 50R,C00,518793,Staff,7,0,20,13
1713496022921,MCWP 50R,D00,518794,Staff,0,0,20,20
1713496022921,MCWP 50R,E00,518795,Staff,0,0,20,20
1713496022921,MCWP 50R,F00,518796,Staff,11,0,20,9
1713496022921,MCWP 50R,G00,518797,Staff,10,0,20,10
1713496023946,MMW 12R,A01,514034,Herbst; Matthew,4,0,16,12
1713496023946,MMW 12R,A02,514035,Herbst; Matthew,13,0,16,3
1713496024970,MMW 13R,A01,514037,Staff,0,7,16,16
1713496024970,MMW 13R,A02,514039,Staff,0,6,16,16
1713496027027,SIO 295LS,A00,523233,Staff,15,0,30,15
1713496028052,SIO 295S,A00,523232,Staff,15,0,30,15
1713496029077,SOCI 117,A01,494376,Staff,0,2,5,5
1713496030102,WES 237B,A00,494380,Staff,19,0,20,1
1713496032161,AESE 279B,A00,494370,Wade; Jon P,33,0,33,0
1713496033189,AIP 197,001,627712,Vespa; Emanuel Ignacio,9999,0,9999,0
1713496034213,ANAR 135S,A00,494369,Braswell; Geoffrey E.,0,0,0,0
1713496035239,CAT 124RS,A01,519847,Geibel; William,6,0,20,14
1713496036265,CAT 125RS,A01,515971,Geibel; William,6,0,20,14
1713496037293,CLRE 250,A00,511389,Morris; Sheldon,9996,0,9999,3
1713496038320,CLRE 251,A00,507176,Mehta; Ravindra L.,9996,0,9999,3
1713496038320,CLRE 251,B00,511410,Mehta; Ravindra L.,9998,0,9999,1
1713496039346,CLRE 252,A00,507189,Cuomo; Raphael Eduardo,9998,0,9999,1
1713496040371,CLRE 253,A00,507199,Vaida; Florin,9997,0,9999,2
1713496040371,CLRE 253,B00,507202,Vaida; Florin,9999,0,9999,0
1713496041395,CLRE 259,A00,507211,Patel; Hemal,9996,0,9999,3
1713496042420,CLRE 260,A00,507221,Cuomo; Raphael Eduardo,9999,0,9999,0
1713496043444,CLRE 297,001,507242,Cuomo; Raphael Eduardo,9999,0,9999,0
1713496044472,CSE 191,A00,516875,Minnes Kemp; Mor Mia,9999,0,9999,0
1713496045502,CSS 201S,A01,494383,Staff,35,0,35,0
1713496046527,CSS 202S,A01,494387,Staff,35,0,35,0
1713496047551,EAP 100,A00,516065,Staff,9792,0,9999,207
1713496048575,ECE 45,A01,507414,Staff,37,0,60,23
1713496049603,ECE 100,A01,507416,Baghdadchi; Saharnaz,0,0,20,20
1713496049603,ECE 100,A02,507418,Baghdadchi; Saharnaz,19,0,20,1
1713496050627,ECE 111,A01,507420,Staff,27,0,50,23
1713496051652,ECE 197,001,548057,Sievenpiper; Daniel F.,9998,0,9999,1
1713496052681,EDS 115,A00,507243,Choi; Bailey Miyeon,27,0,28,1
1713496053709,EDS 117,A01,494379,Staff,15,0,25,10
1713496054738,EDS 125,A00,507246,Hopkins; Megan Beth,27,0,30,3
1713496055764,EDS 128A,A01,507264,Fargason; Sharon Gayle,26,0,26,0
1713496056795,EDS 128B,A01,507293,Pappas; Elizabeth,30,0,30,0
1713496057820,EDS 139,A00,507294,Fargason; Sharon Gayle,30,0,30,0
1713496057820,EDS 139,B00,507313,Pappas; Elizabeth,30,0,30,0
1713496058850,EDS 201,A00,507315,Staff,18,0,30,12
1713496059880,EDS 203,A01,507317,Halter; Christopher P.,17,0,30,13
1713496060910,EDS 204R,A01,507319,Halter; Christopher P.,0,1,30,30
1713496060910,EDS 204R,B01,507331,Heinzman; Erica M.,22,0,30,8
1713496061939,EDS 206R,A00,507332,Staff,0,2,30,30
1713496061939,EDS 206R,B00,507343,Staff,23,0,30,7
1713496062963,EDS 250,A00,507344,Hemans; Patricia Ann Benitez,27,0,40,13
1713496063988,EDS 281,A00,507345,Daly; Alan J.,18,0,18,0
1713496065013,EDS 284,A00,507350,Daly; Alan J.,16,0,16,0
1713496066041,EDS 286,A00,507359,Fine; Sarah,18,0,18,0
1713496067068,EDS 289C,A01,507361,Daly; Alan J.,18,0,18,0
1713496068093,EDS 290,A00,507366,Hofstetter; Carolyn,15,0,15,0
1713496069118,LIGM 5A,A00,507421,Fischer-Grunski; Eva K,20,0,20,0
1713496070144,LIGM 5B,A00,507423,Fischer-Grunski; Eva K,20,0,20,0
1713496071169,LIGM 5C,A00,507425,Fischer-Grunski; Eva K,20,0,20,0
1713496072198,LIIT 5AS,A00,507427,Carnelos; Chiara,20,0,20,0
1713496073227,LIIT 5BS,A00,507430,Carnelos; Chiara,20,0,20,0
1713496074252,LIIT 5CS,A00,507432,Carnelos; Chiara,20,0,20,0
1713496075278,LISP 5A,A00,507541,Munoz Sanchez; Alicia,14,0,20,6
1713496076306,LISP 5B,A00,507671,Munoz Sanchez; Alicia,12,0,20,8
1713496077334,LISP 5C,A00,507696,Munoz Sanchez; Alicia,11,0,20,9
1713496078358,MAE 197,001,528363,Boechler; Nicholas Sebastia,9998,0,9999,1
1713496079383,MATH 197,001,523477,Kedlaya; Kiran S.,9999,0,9999,0
1713496079383,MATH 197,002,563811,Zhang; Danna,9998,0,9999,1
1713496080408,MCWP 40R,A00,518780,Staff,14,0,20,6
1713496080408,MCWP 40R,B00,518781,Staff,12,0,20,8
1713496080408,MCWP 40R,C00,518783,Staff,9,0,20,11
1713496081432,MCWP 50R,A00,518791,Staff,7,0,20,13
1713496081432,MCWP 50R,B00,518792,Staff,3,0,20,17
1713496081432,MCWP 50R,C00,518793,Staff,7,0,20,13
1713496081432,MCWP 50R,D00,518794,Staff,0,0,20,20
1713496081432,MCWP 50R,E00,518795,Staff,0,0,20,20
1713496081432,MCWP 50R,F00,518796,Staff,11,0,20,9
1713496081432,MCWP 50R,G00,518797,Staff,10,0,20,10
1713496082458,MMW 12R,A01,514034,Herbst; Matthew,4,0,16,12
1713496082458,MMW 12R,A02,514035,Herbst; Matthew,13,0,16,3
1713496083483,MMW 13R,A01,514037,Staff,0,7,16,16
1713496083483,MMW 13R,A02,514039,Staff,0,6,16,16
1713496085535,SIO 295LS,A00,523233,Staff,15,0,30,15
1713496086560,SIO 295S,A00,523232,Staff,15,0,30,15
1713496087585,SOCI 117,A01,494376,Staff,0,2,5,5
1713496088613,WES 237B,A00,494380,Staff,19,0,20,1
1713496090677,AESE 279B,A00,494370,Wade; Jon P,33,0,33,0
1713496091702,AIP 197,001,627712,Vespa; Emanuel Ignacio,9999,0,9999,0
1713496092728,ANAR 135S,A00,494369,Braswell; Geoffrey E.,0,0,0,0
1713496093757,CAT 124RS,A01,519847,Geibel; William,6,0,20,14
1713496094783,CAT 125RS,A01,515971,Geibel; William,6,0,20,14
1713496095809,CLRE 250,A00,511389,Morris; Sheldon,9996,0,9999,3
1713496096840,CLRE 251,A00,507176,Mehta; Ravindra L.,9996,0,9999,3
1713496096840,CLRE 251,B00,511410,Mehta; Ravindra L.,9998,0,9999,1
1713496097866,CLRE 252,A00,507189,Cuomo; Raphael Eduardo,9998,0,9999,1
1713496098896,CLRE 253,A00,507199,Vaida; Florin,9997,0,9999,2
1713496098896,CLRE 253,B00,507202,Vaida; Florin,9999,0,9999,0
1713496099921,CLRE 259,A00,507211,Patel; Hemal,9996,0,9999,3
1713496100946,CLRE 260,A00,507221,Cuomo; Raphael Eduardo,9999,0,9999,0
1713496101970,CLRE 297,001,507242,Cuomo; Raphael Eduardo,9999,0,9999,0
1713496102996,CSE 191,A00,516875,Minnes Kemp; Mor Mia,9999,0,9999,0
1713496104022,CSS 201S,A01,494383,Staff,35,0,35,0
1713496105048,CSS 202S,A01,494387,Staff,35,0,35,0
1713496106072,EAP 100,A00,516065,Staff,9792,0,9999,207
1713496107097,ECE 45,A01,507414,Staff,37,0,60,23
1713496108123,ECE 100,A01,507416,Baghdadchi; Saharnaz,0,0,20,20
1713496108123,ECE 100,A02,507418,Baghdadchi; Saharnaz,19,0,20,1
1713496109148,ECE 111,A01,507420,Staff,27,0,50,23
1713496110173,ECE 197,001,548057,Sievenpiper; Daniel F.,9998,0,9999,1
1713496111201,EDS 115,A00,507243,Choi; Bailey Miyeon,27,0,28,1
1713496112228,EDS 117,A01,494379,Staff,15,0,25,10
1713496113254,EDS 125,A00,507246,Hopkins; Megan Beth,27,0,30,3
1713496114335,EDS 128A,A01,507264,Fargason; Sharon Gayle,26,0,26,0
1713496115360,EDS 128B,A01,507293,Pappas; Elizabeth,30,0,30,0
1713496116385,EDS 139,A00,507294,Fargason; Sharon Gayle,30,0,30,0
1713496116385,EDS 139,B00,507313,Pappas; Elizabeth,30,0,30,0
1713496117410,EDS 201,A00,507315,Staff,18,0,30,12
1713496118435,EDS 203,A01,507317,Halter; Christopher P.,17,0,30,13
1713496119463,EDS 204R,A01,507319,Halter; Christopher P.,0,1,30,30
1713496119463,EDS 204R,B01,507331,Heinzman; Erica M.,22,0,30,8
1713496120488,EDS 206R,A00,507332,Staff,0,2,30,30
1713496120488,EDS 206R,B00,507343,Staff,23,0,30,7
1713496121514,EDS 250,A00,507344,Hemans; Patricia Ann Benitez,27,0,40,13
1713496122539,EDS 281,A00,507345,Daly; Alan J.,18,0,18,0
1713496123563,EDS 284,A00,507350,Daly; Alan J.,16,0,16,0
1713496124591,EDS 286,A00,507359,Fine; Sarah,18,0,18,0
1713496125620,EDS 289C,A01,507361,Daly; Alan J.,18,0,18,0
1713496126644,EDS 290,A00,507366,Hofstetter; Carolyn,15,0,15,0
1713496127670,LIGM 5A,A00,507421,Fischer-Grunski; Eva K,20,0,20,0
1713496128696,LIGM 5B,A00,507423,Fischer-Grunski; Eva K,20,0,20,0
1713496129721,LIGM 5C,A00,507425,Fischer-Grunski; Eva K,20,0,20,0
1713496130748,LIIT 5AS,A00,507427,Carnelos; Chiara,20,0,20,0
1713496131777,LIIT 5BS,A00,507430,Carnelos; Chiara,20,0,20,0
1713496132805,LIIT 5CS,A00,507432,Carnelos; Chiara,20,0,20,0
1713496133834,LISP 5A,A00,507541,Munoz Sanchez; Alicia,14,0,20,6
1713496134860,LISP 5B,A00,507671,Munoz Sanchez; Alicia,12,0,20,8
1713496135885,LISP 5C,A00,507696,Munoz Sanchez; Alicia,11,0,20,9
1713496136911,MAE 197,001,528363,Boechler; Nicholas Sebastia,9998,0,9999,1
1713496137936,MATH 197,001,523477,Kedlaya; Kiran S.,9999,0,9999,0
1713496137936,MATH 197,002,563811,Zhang; Danna,9998,0,9999,1
1713496138965,MCWP 40R,A00,518780,Staff,14,0,20,6
1713496138965,MCWP 40R,B00,518781,Staff,12,0,20,8
1713496138965,MCWP 40R,C00,518783,Staff,9,0,20,11
1713496139996,MCWP 50R,A00,518791,Staff,7,0,20,13
1713496139996,MCWP 50R,B00,518792,Staff,3,0,20,17
1713496139996,MCWP 50R,C00,518793,Staff,7,0,20,13
1713496139996,MCWP 50R,D00,518794,Staff,0,0,20,20
1713496139996,MCWP 50R,E00,518795,Staff,0,0,20,20
1713496139996,MCWP 50R,F00,518796,Staff,11,0,20,9
1713496139996,MCWP 50R,G00,518797,Staff,10,0,20,10
1713496141020,MMW 12R,A01,514034,Herbst; Matthew,4,0,16,12
1713496141020,MMW 12R,A02,514035,Herbst; Matthew,13,0,16,3
1713496142054,MMW 13R,A01,514037,Staff,0,7,16,16
1713496142054,MMW 13R,A02,514039,Staff,0,6,16,16
1713496144105,SIO 295LS,A00,523233,Staff,15,0,30,15
1713496145133,SIO 295S,A00,523232,Staff,15,0,30,15
1713496146162,SOCI 117,A01,494376,Staff,0,2,5,5
1713496147186,WES 237B,A00,494380,Staff,19,0,20,1
1713496149245,AESE 279B,A00,494370,Wade; Jon P,33,0,33,0
1713496150270,AIP 197,001,627712,Vespa; Emanuel Ignacio,9999,0,9999,0
1713496151294,ANAR 135S,A00,494369,Braswell; Geoffrey E.,0,0,0,0
1713496152320,CAT 124RS,A01,519847,Geibel; William,6,0,20,14
1713496153347,CAT 125RS,A01,515971,Geibel; William,6,0,20,14
1713496154376,CLRE 250,A00,511389,Morris; Sheldon,9996,0,9999,3
1713496155403,CLRE 251,A00,507176,Mehta; Ravindra L.,9996,0,9999,3
1713496155403,CLRE 251,B00,511410,Mehta; Ravindra L.,9998,0,9999,1
1713496156427,CLRE 252,A00,507189,Cuomo; Raphael Eduardo,9998,0,9999,1
1713496157452,CLRE 253,A00,507199,Vaida; Florin,9997,0,9999,2
1713496157452,CLRE 253,B00,507202,Vaida; Florin,9999,0,9999,0
1713496158481,CLRE 259,A00,507211,Patel; Hemal,9996,0,9999,3
1713496159506,CLRE 260,A00,507221,Cuomo; Raphael Eduardo,9999,0,9999,0
1713496160530,CLRE 297,001,507242,Cuomo; Raphael Eduardo,9999,0,9999,0
1713496161557,CSE 191,A00,516875,Minnes Kemp; Mor Mia,9999,0,9999,0
1713496162583,CSS 201S,A01,494383,Staff,35,0,35,0
1713496163611,CSS 202S,A01,494387,Staff,35,0,35,0
1713496164636,EAP 100,A00,516065,Staff,9792,0,9999,207
1713496165660,ECE 45,A01,507414,Staff,37,0,60,23
1713496166688,ECE 100,A01,507416,Baghdadchi; Saharnaz,0,0,20,20
1713496166688,ECE 100,A02,507418,Baghdadchi; Saharnaz,19,0,20,1
1713496167712,ECE 111,A01,507420,Staff,27,0,50,23
1713496168740,ECE 197,001,548057,Sievenpiper; Daniel F.,9998,0,9999,1
1713496169765,EDS 115,A00,507243,Choi; Bailey Miyeon,27,0,28,1
1713496170792,EDS 117,A01,494379,Staff,15,0,25,10
1713496171820,EDS 125,A00,507246,Hopkins; Megan Beth,27,0,30,3
1713496172846,EDS 128A,A01,507264,Fargason; Sharon Gayle,26,0,26,0
1713496173875,EDS 128B,A01,507293,Pappas; Elizabeth,30,0,30,0
1713496174899,EDS 139,A00,507294,Fargason; Sharon Gayle,30,0,30,0
1713496174899,EDS 139,B00,507313,Pappas; Elizabeth,30,0,30,0
1713496175926,EDS 201,A00,507315,Staff,18,0,30,12
1713496176949,EDS 203,A01,507317,Halter; Christopher P.,17,0,30,13
1713496177976,EDS 204R,A01,507319,Halter; Christopher P.,0,1,30,30
1713496177976,EDS 204R,B01,507331,Heinzman; Erica M.,22,0,30,8
1713496179002,EDS 206R,A00,507332,Staff,0,2,30,30
1713496179002,EDS 206R,B00,507343,Staff,23,0,30,7
1713496180026,EDS 250,A00,507344,Hemans; Patricia Ann Benitez,27,0,40,13
1713496181052,EDS 281,A00,507345,Daly; Alan J.,18,0,18,0
1713496182082,EDS 284,A00,507350,Daly; Alan J.,16,0,16,0
1713496183111,EDS 286,A00,507359,Fine; Sarah,18,0,18,0
1713496184139,EDS 289C,A01,507361,Daly; Alan J.,18,0,18,0
1713496185169,EDS 290,A00,507366,Hofstetter; Carolyn,15,0,15,0
1713496186197,LIGM 5A,A00,507421,Fischer-Grunski; Eva K,20,0,20,0
1713496187226,LIGM 5B,A00,507423,Fischer-Grunski; Eva K,20,0,20,0
1713496188256,LIGM 5C,A00,507425,Fischer-Grunski; Eva K,20,0,20,0
1713496189284,LIIT 5AS,A00,507427,Carnelos; Chiara,20,0,20,0
1713496190309,LIIT 5BS,A00,507430,Carnelos; Chiara,20,0,20,0
1713496191339,LIIT 5CS,A00,507432,Carnelos; Chiara,20,0,20,0
1713496192364,LISP 5A,A00,507541,Munoz Sanchez; Alicia,14,0,20,6
1713496193389,LISP 5B,A00,507671,Munoz Sanchez; Alicia,12,0,20,8
1713496194418,LISP 5C,A00,507696,Munoz Sanchez; Alicia,11,0,20,9
1713496195444,MAE 197,001,528363,Boechler; Nicholas Sebastia,9998,0,9999,1
1713496196469,MATH 197,001,523477,Kedlaya; Kiran S.,9999,0,9999,0
1713496196469,MATH 197,002,563811,Zhang; Danna,9998,0,9999,1
1713496197494,MCWP 40R,A00,518780,Staff,14,0,20,6
1713496197494,MCWP 40R,B00,518781,Staff,12,0,20,8
1713496197494,MCWP 40R,C00,518783,Staff,9,0,20,11
1713496198522,MCWP 50R,A00,518791,Staff,7,0,20,13
1713496198522,MCWP 50R,B00,518792,Staff,3,0,20,17
1713496198522,MCWP 50R,C00,518793,Staff,7,0,20,13
1713496198522,MCWP 50R,D00,518794,Staff,0,0,20,20
1713496198522,MCWP 50R,E00,518795,Staff,0,0,20,20
1713496198522,MCWP 50R,F00,518796,Staff,11,0,20,9
1713496198522,MCWP 50R,G00,518797,Staff,10,0,20,10
1713496199550,MMW 12R,A01,514034,Herbst; Matthew,4,0,16,12
1713496199550,MMW 12R,A02,514035,Herbst; Matthew,13,0,16,3
1713496200579,MMW 13R,A01,514037,Staff,0,7,16,16
1713496200579,MMW 13R,A02,514039,Staff,0,6,16,16
1713496202633,SIO 295LS,A00,523233,Staff,15,0,30,15
1713496203659,SIO 295S,A00,523232,Staff,15,0,30,15
1713496204689,SOCI 117,A01,494376,Staff,0,2,5,5
1713496205719,WES 237B,A00,494380,Staff,19,0,20,1
1713496207780,AESE 279B,A00,494370,Wade; Jon P,33,0,33,0
1713496208808,AIP 197,001,627712,Vespa; Emanuel Ignacio,9999,0,9999,0
1713496209833,ANAR 135S,A00,494369,Braswell; Geoffrey E.,0,0,0,0
1713496210860,CAT 124RS,A01,519847,Geibel; William,6,0,20,14
1713496211888,CAT 125RS,A01,515971,Geibel; William,6,0,20,14
1713496212911,CLRE 250,A00,511389,Morris; Sheldon,9996,0,9999,3
1713496213943,CLRE 251,A00,507176,Mehta; Ravindra L.,9996,0,9999,3
1713496213943,CLRE 251,B00,511410,Mehta; Ravindra L.,9998,0,9999,1
1713496214971,CLRE 252,A00,507189,Cuomo; Raphael Eduardo,9998,0,9999,1
1713496215996,CLRE 253,A00,507199,Vaida; Florin,9997,0,9999,2
1713496215996,CLRE 253,B00,507202,Vaida; Florin,9999,0,9999,0
1713496217023,CLRE 259,A00,507211,Patel; Hemal,9996,0,9999,3
1713496218120,CLRE 260,A00,507221,Cuomo; Raphael Eduardo,9999,0,9999,0
1713496219149,CLRE 297,001,507242,Cuomo; Raphael Eduardo,9999,0,9999,0
1713496220176,CSE 191,A00,516875,Minnes Kemp; Mor Mia,9999,0,9999,0
1713496221204,CSS 201S,A01,494383,Staff,35,0,35,0
1713496222233,CSS 202S,A01,494387,Staff,35,0,35,0
1713496223257,EAP 100,A00,516065,Staff,9792,0,9999,207
1713496224282,ECE 45,A01,507414,Staff,37,0,60,23
1713496225308,ECE 100,A01,507416,Baghdadchi; Saharnaz,0,0,20,20
1713496225308,ECE 100,A02,507418,Baghdadchi; Saharnaz,19,0,20,1
1713496226339,ECE 111,A01,507420,Staff,27,0,50,23
1713496227364,ECE 197,001,548057,Sievenpiper; Daniel F.,9998,0,9999,1
1713496228388,EDS 115,A00,507243,Choi; Bailey Miyeon,27,0,28,1
1713496229417,EDS 117,A01,494379,Staff,15,0,25,10
1713496230444,EDS 125,A00,507246,Hopkins; Megan Beth,27,0,30,3
1713496231474,EDS 128A,A01,507264,Fargason; Sharon Gayle,26,0,26,0
1713496232500,EDS 128B,A01,507293,Pappas; Elizabeth,30,0,30,0
1713496233528,EDS 139,A00,507294,Fargason; Sharon Gayle,30,0,30,0
1713496233528,EDS 139,B00,507313,Pappas; Elizabeth,30,0,30,0
1713496234555,EDS 201,A00,507315,Staff,18,0,30,12
1713496235578,EDS 203,A01,507317,Halter; Christopher P.,17,0,30,13
1713496236603,EDS 204R,A01,507319,Halter; Christopher P.,0,1,30,30
1713496236603,EDS 204R,B01,507331,Heinzman; Erica M.,22,0,30,8
1713496237630,EDS 206R,A00,507332,Staff,0,2,30,30
1713496237630,EDS 206R,B00,507343,Staff,23,0,30,7
1713496238656,EDS 250,A00,507344,Hemans; Patricia Ann Benitez,27,0,40,13
1713496239682,EDS 281,A00,507345,Daly; Alan J.,18,0,18,0
1713496240707,EDS 284,A00,507350,Daly; Alan J.,16,0,16,0
1713496241734,EDS 286,A00,507359,Fine; Sarah,18,0,18,0
1713496242762,EDS 289C,A01,507361,Daly; Alan J.,18,0,18,0
1713496243790,EDS 290,A00,507366,Hofstetter; Carolyn,15,0,15,0
1713496244815,LIGM 5A,A00,507421,Fischer-Grunski; Eva K,20,0,20,0
1713496245842,LIGM 5B,A00,507423,Fischer-Grunski; Eva K,20,0,20,0
1713496246866,LIGM 5C,A00,507425,Fischer-Grunski; Eva K,20,0,20,0
1713496247895,LIIT 5AS,A00,507427,Carnelos; Chiara,20,0,20,0
1713496248924,LIIT 5BS,A00,507430,Carnelos; Chiara,20,0,20,0
1713496249982,LIIT 5CS,A00,507432,Carnelos; Chiara,20,0,20,0
1713496251012,LISP 5A,A00,507541,Munoz Sanchez; Alicia,14,0,20,6
1713496252038,LISP 5B,A00,507671,Munoz Sanchez; Alicia,12,0,20,8
1713496253062,LISP 5C,A00,507696,Munoz Sanchez; Alicia,11,0,20,9
1713496254091,MAE 197,001,528363,Boechler; Nicholas Sebastia,9998,0,9999,1
1713496255116,MATH 197,001,523477,Kedlaya; Kiran S.,9999,0,9999,0
1713496255116,MATH 197,002,563811,Zhang; Danna,9998,0,9999,1
1713496256144,MCWP 40R,A00,518780,Staff,14,0,20,6
1713496256144,MCWP 40R,B00,518781,Staff,12,0,20,8
1713496256144,MCWP 40R,C00,518783,Staff,9,0,20,11
1713496257169,MCWP 50R,A00,518791,Staff,7,0,20,13
1713496257169,MCWP 50R,B00,518792,Staff,3,0,20,17
1713496257169,MCWP 50R,C00,518793,Staff,7,0,20,13
1713496257169,MCWP 50R,D00,518794,Staff,0,0,20,20
1713496257169,MCWP 50R,E00,518795,Staff,0,0,20,20
1713496257169,MCWP 50R,F00,518796,Staff,11,0,20,9
1713496257169,MCWP 50R,G00,518797,Staff,10,0,20,10
1713496258194,MMW 12R,A01,514034,Herbst; Matthew,4,0,16,12
1713496258194,MMW 12R,A02,514035,Herbst; Matthew,13,0,16,3
1713496259220,MMW 13R,A01,514037,Staff,0,7,16,16
1713496259220,MMW 13R,A02,514039,Staff,0,6,16,16
1713496261275,SIO 295LS,A00,523233,Staff,15,0,30,15
1713496262302,SIO 295S,A00,523232,Staff,15,0,30,15
1713496263331,SOCI 117,A01,494376,Staff,0,2,5,5
1713496264356,WES 237B,A00,494380,Staff,19,0,20,1
1713496266418,AESE 279B,A00,494370,Wade; Jon P,33,0,33,0
1713496267452,AIP 197,001,627712,Vespa; Emanuel Ignacio,9999,0,9999,0
1713496268478,ANAR 135S,A00,494369,Braswell; Geoffrey E.,0,0,0,0
1713496269507,CAT 124RS,A01,519847,Geibel; William,6,0,20,14
1713496270532,CAT 125RS,A01,515971,Geibel; William,6,0,20,14
1713496271557,CLRE 250,A00,511389,Morris; Sheldon,9996,0,9999,3
1713496272583,CLRE 251,A00,507176,Mehta; Ravindra L.,9996,0,9999,3
1713496272583,CLRE 251,B00,511410,Mehta; Ravindra L.,9998,0,9999,1
1713496273609,CLRE 252,A00,507189,Cuomo; Raphael Eduardo,9998,0,9999,1
1713496274634,CLRE 253,A00,507199,Vaida; Florin,9997,0,9999,2
1713496274634,CLRE 253,B00,507202,Vaida; Florin,9999,0,9999,0
1713496275660,CLRE 259,A00,507211,Patel; Hemal,9996,0,9999,3
1713496276687,CLRE 260,A00,507221,Cuomo; Raphael Eduardo,9999,0,9999,0
1713496277712,CLRE 297,001,507242,Cuomo; Raphael Eduardo,9999,0,9999,0
1713496278738,CSE 191,A00,516875,Minnes Kemp; Mor Mia,9999,0,9999,0
1713496279764,CSS 201S,A01,494383,Staff,35,0,35,0
1713496280793,CSS 202S,A01,494387,Staff,35,0,35,0
1713496281817,EAP 100,A00,516065,Staff,9792,0,9999,207
1713496282845,ECE 45,A01,507414,Staff,37,0,60,23
1713496283871,ECE 100,A01,507416,Baghdadchi; Saharnaz,0,0,20,20
1713496283871,ECE 100,A02,507418,Baghdadchi; Saharnaz,19,0,20,1
1713496284896,ECE 111,A01,507420,Staff,27,0,50,23
1713496285921,ECE 197,001,548057,Sievenpiper; Daniel F.,9998,0,9999,1
1713496286950,EDS 115,A00,507243,Choi; Bailey Miyeon,27,0,28,1
1713496287977,EDS 117,A01,494379,Staff,15,0,25,10
1713496289002,EDS 125,A00,507246,Hopkins; Megan Beth,27,0,30,3
1713496290027,EDS 128A,A01,507264,Fargason; Sharon Gayle,26,0,26,0
1713496291055,EDS 128B,A01,507293,Pappas; Elizabeth,30,0,30,0
1713496292082,EDS 139,A00,507294,Fargason; Sharon Gayle,30,0,30,0
1713496292082,EDS 139,B00,507313,Pappas; Elizabeth,30,0,30,0
1713496293107,EDS 201,A00,507315,Staff,18,0,30,12
1713496294133,EDS 203,A01,507317,Halter; Christopher P.,17,0,30,13
1713496295162,EDS 204R,A01,507319,Halter; Christopher P.,0,1,30,30
1713496295162,EDS 204R,B01,507331,Heinzman; Erica M.,22,0,30,8
1713496296190,EDS 206R,A00,507332,Staff,0,2,30,30
1713496296190,EDS 206R,B00,507343,Staff,23,0,30,7
1713496297215,EDS 250,A00,507344,Hemans; Patricia Ann Benitez,27,0,40,13
1713496298239,EDS 281,A00,507345,Daly; Alan J.,18,0,18,0
1713496299263,EDS 284,A00,507350,Daly; Alan J.,16,0,16,0
1713496300288,EDS 286,A00,507359,Fine; Sarah,18,0,18,0
1713496301310,EDS 289C,A01,507361,Daly; Alan J.,18,0,18,0
1713496302334,EDS 290,A00,507366,Hofstetter; Carolyn,15,0,15,0
1713496303363,LIGM 5A,A00,507421,Fischer-Grunski; Eva K,20,0,20,0
1713496304388,LIGM 5B,A00,507423,Fischer-Grunski; Eva K,20,0,20,0
1713496305413,LIGM 5C,A00,507425,Fischer-Grunski; Eva K,20,0,20,0
1713496306439,LIIT 5AS,A00,507427,Carnelos; Chiara,20,0,20,0
1713496307464,LIIT 5BS,A00,507430,Carnelos; Chiara,20,0,20,0
1713496308493,LIIT 5CS,A00,507432,Carnelos; Chiara,20,0,20,0
1713496309517,LISP 5A,A00,507541,Munoz Sanchez; Alicia,14,0,20,6
1713496310547,LISP 5B,A00,507671,Munoz Sanchez; Alicia,12,0,20,8
1713496311576,LISP 5C,A00,507696,Munoz Sanchez; Alicia,11,0,20,9
1713496312601,MAE 197,001,528363,Boechler; Nicholas Sebastia,9998,0,9999,1
1713496313626,MATH 197,001,523477,Kedlaya; Kiran S.,9999,0,9999,0
1713496313626,MATH 197,002,563811,Zhang; Danna,9998,0,9999,1
1713496314651,MCWP 40R,A00,518780,Staff,14,0,20,6
1713496314651,MCWP 40R,B00,518781,Staff,12,0,20,8
1713496314651,MCWP 40R,C00,518783,Staff,9,0,20,11
1713496315677,MCWP 50R,A00,518791,Staff,7,0,20,13
1713496315677,MCWP 50R,B00,518792,Staff,3,0,20,17
1713496315677,MCWP 50R,C00,518793,Staff,7,0,20,13
1713496315677,MCWP 50R,D00,518794,Staff,0,0,20,20
1713496315677,MCWP 50R,E00,518795,Staff,0,0,20,20
1713496315677,MCWP 50R,F00,518796,Staff,11,0,20,9
1713496315677,MCWP 50R,G00,518797,Staff,10,0,20,10
1713496316702,MMW 12R,A01,514034,Herbst; Matthew,4,0,16,12
1713496316702,MMW 12R,A02,514035,Herbst; Matthew,13,0,16,3
1713496317727,MMW 13R,A01,514037,Staff,0,7,16,16
1713496317727,MMW 13R,A02,514039,Staff,0,6,16,16
1713496319777,SIO 295LS,A00,523233,Staff,15,0,30,15
1713496320802,SIO 295S,A00,523232,Staff,15,0,30,15
1713496321884,SOCI 117,A01,494376,Staff,0,2,5,5
1713496322909,WES 237B,A00,494380,Staff,19,0,20,1
1713496324966,AESE 279B,A00,494370,Wade; Jon P,33,0,33,0
1713496325991,AIP 197,001,627712,Vespa; Emanuel Ignacio,9999,0,9999,0
1713496327018,ANAR 135S,A00,494369,Braswell; Geoffrey E.,0,0,0,0
1713496328047,CAT 124RS,A01,519847,Geibel; William,6,0,20,14
1713496329073,CAT 125RS,A01,515971,Geibel; William,6,0,20,14
1713496330099,CLRE 250,A00,511389,Morris; Sheldon,9996,0,9999,3
1713496331125,CLRE 251,A00,507176,Mehta; Ravindra L.,9996,0,9999,3
1713496331125,CLRE 251,B00,511410,Mehta; Ravindra L.,9998,0,9999,1
1713496332150,CLRE 252,A00,507189,Cuomo; Raphael Eduardo,9998,0,9999,1
1713496333179,CLRE 253,A00,507199,Vaida; Florin,9997,0,9999,2
1713496333179,CLRE 253,B00,507202,Vaida; Florin,9999,0,9999,0
1713496334205,CLRE 259,A00,507211,Patel; Hemal,9996,0,9999,3
1713496335232,CLRE 260,A00,507221,Cuomo; Raphael Eduardo,9999,0,9999,0
1713496336257,CLRE 297,001,507242,Cuomo; Raphael Eduardo,9999,0,9999,0
1713496337284,CSE 191,A00,516875,Minnes Kemp; Mor Mia,9999,0,9999,0
1713496338313,CSS 201S,A01,494383,Staff,35,0,35,0
1713496339342,CSS 202S,A01,494387,Staff,35,0,35,0
1713496340369,EAP 100,A00,516065,Staff,9792,0,9999,207
1713496341399,ECE 45,A01,507414,Staff,37,0,60,23
1713496342432,ECE 100,A01,507416,Baghdadchi; Saharnaz,0,0,20,20
1713496342432,ECE 100,A02,507418,Baghdadchi; Saharnaz,19,0,20,1
1713496343456,ECE 111,A01,507420,Staff,27,0,50,23
1713496344484,ECE 197,001,548057,Sievenpiper; Daniel F.,9998,0,9999,1
1713496345509,EDS 115,A00,507243,Choi; Bailey Miyeon,27,0,28,1
1713496346534,EDS 117,A01,494379,Staff,15,0,25,10
1713496347559,EDS 125,A00,507246,Hopkins; Megan Beth,27,0,30,3
1713496348584,EDS 128A,A01,507264,Fargason; Sharon Gayle,26,0,26,0
1713496349609,EDS 128B,A01,507293,Pappas; Elizabeth,30,0,30,0
1713496350634,EDS 139,A00,507294,Fargason; Sharon Gayle,30,0,30,0
1713496350634,EDS 139,B00,507313,Pappas; Elizabeth,30,0,30,0
1713496351659,EDS 201,A00,507315,Staff,18,0,30,12
1713496352687,EDS 203,A01,507317,Halter; Christopher P.,17,0,30,13
1713496353717,EDS 204R,A01,507319,Halter; Christopher P.,0,1,30,30
1713496353717,EDS 204R,B01,507331,Heinzman; Erica M.,22,0,30,8
1713496354745,EDS 206R,A00,507332,Staff,0,2,30,30
1713496354745,EDS 206R,B00,507343,Staff,23,0,30,7
1713496355774,EDS 250,A00,507344,Hemans; Patricia Ann Benitez,27,0,40,13
1713496356799,EDS 281,A00,507345,Daly; Alan J.,18,0,18,0
1713496357827,EDS 284,A00,507350,Daly; Alan J.,16,0,16,0
1713496358856,EDS 286,A00,507359,Fine; Sarah,18,0,18,0
1713496359883,EDS 289C,A01,507361,Daly; Alan J.,18,0,18,0
1713496360911,EDS 290,A00,507366,Hofstetter; Carolyn,15,0,15,0
1713496361942,LIGM 5A,A00,507421,Fischer-Grunski; Eva K,20,0,20,0
1713496362968,LIGM 5B,A00,507423,Fischer-Grunski; Eva K,20,0,20,0
1713496363994,LIGM 5C,A00,507425,Fischer-Grunski; Eva K,20,0,20,0
1713496365020,LIIT 5AS,A00,507427,Carnelos; Chiara,20,0,20,0
1713496366049,LIIT 5BS,A00,507430,Carnelos; Chiara,20,0,20,0
1713496367077,LIIT 5CS,A00,507432,Carnelos; Chiara,20,0,20,0
1713496368102,LISP 5A,A00,507541,Munoz Sanchez; Alicia,14,0,20,6
1713496369130,LISP 5B,A00,507671,Munoz Sanchez; Alicia,12,0,20,8
1713496370154,LISP 5C,A00,507696,Munoz Sanchez; Alicia,11,0,20,9
1713496371179,MAE 197,001,528363,Boechler; Nicholas Sebastia,9998,0,9999,1
1713496372203,MATH 197,001,523477,Kedlaya; Kiran S.,9999,0,9999,0
1713496372203,MATH 197,002,563811,Zhang; Danna,9998,0,9999,1
1713496373227,MCWP 40R,A00,518780,Staff,14,0,20,6
1713496373227,MCWP 40R,B00,518781,Staff,12,0,20,8
1713496373227,MCWP 40R,C00,518783,Staff,9,0,20,11
1713496374252,MCWP 50R,A00,518791,Staff,7,0,20,13
1713496374252,MCWP 50R,B00,518792,Staff,3,0,20,17
1713496374252,MCWP 50R,C00,518793,Staff,7,0,20,13
1713496374252,MCWP 50R,D00,518794,Staff,0,0,20,20
1713496374252,MCWP 50R,E00,518795,Staff,0,0,20,20
1713496374252,MCWP 50R,F00,518796,Staff,11,0,20,9
1713496374252,MCWP 50R,G00,518797,Staff,10,0,20,10
1713496375281,MMW 12R,A01,514034,Herbst; Matthew,4,0,16,12
1713496375281,MMW 12R,A02,514035,Herbst; Matthew,13,0,16,3
1713496376305,MMW 13R,A01,514037,Staff,0,7,16,16
1713496376305,MMW 13R,A02,514039,Staff,0,6,16,16
1713496378358,SIO 295LS,A00,523233,Staff,15,0,30,15
1713496379384,SIO 295S,A00,523232,Staff,15,0,30,15
1713496380410,SOCI 117,A01,494376,Staff,0,2,5,5
1713496381436,WES 237B,A00,494380,Staff,19,0,20,1
1713496383500,AESE 279B,A00,494370,Wade; Jon P,33,0,33,0
1713496384528,AIP 197,001,627712,Vespa; Emanuel Ignacio,9999,0,9999,0
1713496385554,ANAR 135S,A00,494369,Braswell; Geoffrey E.,0,0,0,0
1713496386585,CAT 124RS,A01,519847,Geibel; William,6,0,20,14
1713496387612,CAT 125RS,A01,515971,Geibel; William,6,0,20,14
1713496388637,CLRE 250,A00,511389,Morris; Sheldon,9996,0,9999,3
1713496389663,CLRE 251,A00,507176,Mehta; Ravindra L.,9996,0,9999,3
1713496389663,CLRE 251,B00,511410,Mehta; Ravindra L.,9998,0,9999,1
1713496390692,CLRE 252,A00,507189,Cuomo; Raphael Eduardo,9998,0,9999,1
1713496391718,CLRE 253,A00,507199,Vaida; Florin,9997,0,9999,2
1713496391718,CLRE 253,B00,507202,Vaida; Florin,9999,0,9999,0
1713496392746,CLRE 259,A00,507211,Patel; Hemal,9996,0,9999,3
1713496393773,CLRE 260,A00,507221,Cuomo; Raphael Eduardo,9999,0,9999,0
1713496394801,CLRE 297,001,507242,Cuomo; Raphael Eduardo,9999,0,9999,0
1713496395825,CSE 191,A00,516875,Minnes Kemp; Mor Mia,9999,0,9999,0
1713496396854,CSS 201S,A01,494383,Staff,35,0,35,0
1713496397879,CSS 202S,A01,494387,Staff,35,0,35,0
1713496398905,EAP 100,A00,516065,Staff,9792,0,9999,207
1713496399930,ECE 45,A01,507414,Staff,37,0,60,23
1713496400954,ECE 100,A01,507416,Baghdadchi; Saharnaz,0,0,20,20
1713496400954,ECE 100,A02,507418,Baghdadchi; Saharnaz,19,0,20,1
1713496401980,ECE 111,A01,507420,Staff,27,0,50,23
1713496403008,ECE 197,001,548057,Sievenpiper; Daniel F.,9998,0,9999,1
1713496404038,EDS 115,A00,507243,Choi; Bailey Miyeon,27,0,28,1
1713496405066,EDS 117,A01,494379,Staff,15,0,25,10
1713496406095,EDS 125,A00,507246,Hopkins; Megan Beth,27,0,30,3
1713496407126,EDS 128A,A01,507264,Fargason; Sharon Gayle,26,0,26,0
1713496408155,EDS 128B,A01,507293,Pappas; Elizabeth,30,0,30,0
1713496409183,EDS 139,A00,507294,Fargason; Sharon Gayle,30,0,30,0
1713496409183,EDS 139,B00,507313,Pappas; Elizabeth,30,0,30,0
1713496410213,EDS 201,A00,507315,Staff,18,0,30,12
1713496411268,EDS 203,A01,507317,Halter; Christopher P.,17,0,30,13
1713496412298,EDS 204R,A01,507319,Halter; Christopher P.,0,1,30,30
1713496412298,EDS 204R,B01,507331,Heinzman; Erica M.,22,0,30,8
1713496413325,EDS 206R,A00,507332,Staff,0,2,30,30
1713496413325,EDS 206R,B00,507343,Staff,23,0,30,7
1713496414353,EDS 250,A00,507344,Hemans; Patricia Ann Benitez,27,0,40,13
1713496415381,EDS 281,A00,507345,Daly; Alan J.,18,0,18,0
1713496416406,EDS 284,A00,507350,Daly; Alan J.,16,0,16,0
1713496417430,EDS 286,A00,507359,Fine; Sarah,18,0,18,0
1713496418458,EDS 289C,A01,507361,Daly; Alan J.,18,0,18,0
1713496419487,EDS 290,A00,507366,Hofstetter; Carolyn,15,0,15,0
1713496420512,LIGM 5A,A00,507421,Fischer-Grunski; Eva K,20,0,20,0
1713496421537,LIGM 5B,A00,507423,Fischer-Grunski; Eva K,20,0,20,0
1713496422565,LIGM 5C,A00,507425,Fischer-Grunski; Eva K,20,0,20,0
1713496423589,LIIT 5AS,A00,507427,Carnelos; Chiara,20,0,20,0
1713496424619,LIIT 5BS,A00,507430,Carnelos; Chiara,20,0,20,0
1713496425716,LIIT 5CS,A00,507432,Carnelos; Chiara,20,0,20,0
1713496426742,LISP 5A,A00,507541,Munoz Sanchez; Alicia,14,0,20,6
1713496427767,LISP 5B,A00,507671,Munoz Sanchez; Alicia,12,0,20,8
1713496428792,LISP 5C,A00,507696,Munoz Sanchez; Alicia,11,0,20,9
1713496429818,MAE 197,001,528363,Boechler; Nicholas Sebastia,9998,0,9999,1
1713496430845,MATH 197,001,523477,Kedlaya; Kiran S.,9999,0,9999,0
1713496430845,MATH 197,002,563811,Zhang; Danna,9998,0,9999,1
1713496431868,MCWP 40R,A00,518780,Staff,14,0,20,6
1713496431868,MCWP 40R,B00,518781,Staff,12,0,20,8
1713496431868,MCWP 40R,C00,518783,Staff,9,0,20,11
1713496432930,MCWP 50R,A00,518791,Staff,7,0,20,13
1713496432930,MCWP 50R,B00,518792,Staff,3,0,20,17
1713496432930,MCWP 50R,C00,518793,Staff,7,0,20,13
1713496432930,MCWP 50R,D00,518794,Staff,0,0,20,20
1713496432930,MCWP 50R,E00,518795,Staff,0,0,20,20
1713496432930,MCWP 50R,F00,518796,Staff,11,0,20,9
1713496432930,MCWP 50R,G00,518797,Staff,10,0,20,10
1713496433957,MMW 12R,A01,514034,Herbst; Matthew,4,0,16,12
1713496433957,MMW 12R,A02,514035,Herbst; Matthew,13,0,16,3
1713496434982,MMW 13R,A01,514037,Staff,0,7,16,16
1713496434982,MMW 13R,A02,514039,Staff,0,6,16,16
1713496437039,SIO 295LS,A00,523233,Staff,15,0,30,15
1713496438072,SIO 295S,A00,523232,Staff,15,0,30,15
1713496439100,SOCI 117,A01,494376,Staff,0,2,5,5
1713496440126,WES 237B,A00,494380,Staff,19,0,20,1
1713496442198,AESE 279B,A00,494370,Wade; Jon P,33,0,33,0
1713496443226,AIP 197,001,627712,Vespa; Emanuel Ignacio,9999,0,9999,0
1713496444254,ANAR 135S,A00,494369,Braswell; Geoffrey E.,0,0,0,0
1713496445279,CAT 124RS,A01,519847,Geibel; William,6,0,20,14
1713496446308,CAT 125RS,A01,515971,Geibel; William,6,0,20,14
1713496447340,CLRE 250,A00,511389,Morris; Sheldon,9996,0,9999,3
1713496448366,CLRE 251,A00,507176,Mehta; Ravindra L.,9996,0,9999,3
1713496448366,CLRE 251,B00,511410,Mehta; Ravindra L.,9998,0,9999,1
1713496449396,CLRE 252,A00,507189,Cuomo; Raphael Eduardo,9998,0,9999,1
1713496450420,CLRE 253,A00,507199,Vaida; Florin,9997,0,9999,2
1713496450420,CLRE 253,B00,507202,Vaida; Florin,9999,0,9999,0
1713496451449,CLRE 259,A00,507211,Patel; Hemal,9996,0,9999,3
1713496452473,CLRE 260,A00,507221,Cuomo; Raphael Eduardo,9999,0,9999,0
1713496453497,CLRE 297,001,507242,Cuomo; Raphael Eduardo,9999,0,9999,0
1713496454525,CSE 191,A00,516875,Minnes Kemp; Mor Mia,9999,0,9999,0
1713496455550,CSS 201S,A01,494383,Staff,35,0,35,0
1713496456577,CSS 202S,A01,494387,Staff,35,0,35,0
1713496457603,EAP 100,A00,516065,Staff,9792,0,9999,207
1713496458628,ECE 45,A01,507414,Staff,37,0,60,23
1713496459652,ECE 100,A01,507416,Baghdadchi; Saharnaz,0,0,20,20
1713496459652,ECE 100,A02,507418,Baghdadchi; Saharnaz,19,0,20,1
1713496460681,ECE 111,A01,507420,Staff,27,0,50,23
1713496461709,ECE 197,001,548057,Sievenpiper; Daniel F.,9998,0,9999,1
1713496462736,EDS 115,A00,507243,Choi; Bailey Miyeon,27,0,28,1
1713496463764,EDS 117,A01,494379,Staff,15,0,25,10
1713496464790,EDS 125,A00,507246,Hopkins; Megan Beth,27,0,30,3
1713496465816,EDS 128A,A01,507264,Fargason; Sharon Gayle,26,0,26,0
1713496466844,EDS 128B,A01,507293,Pappas; Elizabeth,30,0,30,0
1713496467873,EDS 139,A00,507294,Fargason; Sharon Gayle,30,0,30,0
1713496467873,EDS 139,B00,507313,Pappas; Elizabeth,30,0,30,0
1713496468900,EDS 201,A00,507315,Staff,18,0,30,12
1713496469925,EDS 203,A01,507317,Halter; Christopher P.,17,0,30,13
1713496470951,EDS 204R,A01,507319,Halter; Christopher P.,0,1,30,30
1713496470951,EDS 204R,B01,507331,Heinzman; Erica M.,22,0,30,8
1713496471976,EDS 206R,A00,507332,Staff,0,2,30,30
1713496471976,EDS 206R,B00,507343,Staff,23,0,30,7
1713496473007,EDS 250,A00,507344,Hemans; Patricia Ann Benitez,27,0,40,13
1713496474036,EDS 281,A00,507345,Daly; Alan J.,18,0,18,0
1713496475064,EDS 284,A00,507350,Daly; Alan J.,16,0,16,0
1713496476090,EDS 286,A00,507359,Fine; Sarah,18,0,18,0
1713496477116,EDS 289C,A01,507361,Daly; Alan J.,18,0,18,0
1713496478142,EDS 290,A00,507366,Hofstetter; Carolyn,15,0,15,0
1713496479173,LIGM 5A,A00,507421,Fischer-Grunski; Eva K,20,0,20,0
1713496480197,LIGM 5B,A00,507423,Fischer-Grunski; Eva K,20,0,20,0
1713496481226,LIGM 5C,A00,507425,Fischer-Grunski; Eva K,20,0,20,0
1713496482252,LIIT 5AS,A00,507427,Carnelos; Chiara,20,0,20,0
1713496483282,LIIT 5BS,A00,507430,Carnelos; Chiara,20,0,20,0
1713496484312,LIIT 5CS,A00,507432,Carnelos; Chiara,20,0,20,0
1713496485340,LISP 5A,A00,507541,Munoz Sanchez; Alicia,14,0,20,6
1713496486368,LISP 5B,A00,507671,Munoz Sanchez; Alicia,12,0,20,8
1713496487396,LISP 5C,A00,507696,Munoz Sanchez; Alicia,11,0,20,9
1713496488421,MAE 197,001,528363,Boechler; Nicholas Sebastia,9998,0,9999,1
1713496489446,MATH 197,001,523477,Kedlaya; Kiran S.,9999,0,9999,0
1713496489446,MATH 197,002,563811,Zhang; Danna,9998,0,9999,1
1713496490469,MCWP 40R,A00,518780,Staff,14,0,20,6
1713496490469,MCWP 40R,B00,518781,Staff,12,0,20,8
1713496490469,MCWP 40R,C00,518783,Staff,9,0,20,11
1713496491494,MCWP 50R,A00,518791,Staff,7,0,20,13
1713496491494,MCWP 50R,B00,518792,Staff,3,0,20,17
1713496491494,MCWP 50R,C00,518793,Staff,7,0,20,13
1713496491494,MCWP 50R,D00,518794,Staff,0,0,20,20
1713496491494,MCWP 50R,E00,518795,Staff,0,0,20,20
1713496491494,MCWP 50R,F00,518796,Staff,11,0,20,9
1713496491494,MCWP 50R,G00,518797,Staff,10,0,20,10
1713496492522,MMW 12R,A01,514034,Herbst; Matthew,4,0,16,12
1713496492522,MMW 12R,A02,514035,Herbst; Matthew,13,0,16,3
1713496493548,MMW 13R,A01,514037,Staff,0,7,16,16
1713496493548,MMW 13R,A02,514039,Staff,0,6,16,16
1713496495603,SIO 295LS,A00,523233,Staff,15,0,30,15
1713496496632,SIO 295S,A00,523232,Staff,15,0,30,15
1713496497661,SOCI 117,A01,494376,Staff,0,2,5,5
1713496498686,WES 237B,A00,494380,Staff,19,0,20,1
1713496500759,AESE 279B,A00,494370,Wade; Jon P,33,0,33,0
1713496501784,AIP 197,001,627712,Vespa; Emanuel Ignacio,9999,0,9999,0
1713496502814,ANAR 135S,A00,494369,Braswell; Geoffrey E.,0,0,0,0
1713496503839,CAT 124RS,A01,519847,Geibel; William,6,0,20,14
1713496504864,CAT 125RS,A01,515971,Geibel; William,6,0,20,14
1713496505892,CLRE 250,A00,511389,Morris; Sheldon,9996,0,9999,3
1713496506923,CLRE 251,A00,507176,Mehta; Ravindra L.,9996,0,9999,3
1713496506923,CLRE 251,B00,511410,Mehta; Ravindra L.,9998,0,9999,1
1713496507948,CLRE 252,A00,507189,Cuomo; Raphael Eduardo,9998,0,9999,1
1713496508977,CLRE 253,A00,507199,Vaida; Florin,9997,0,9999,2
1713496508977,CLRE 253,B00,507202,Vaida; Florin,9999,0,9999,0
1713496510003,CLRE 259,A00,507211,Patel; Hemal,9996,0,9999,3
1713496511028,CLRE 260,A00,507221,Cuomo; Raphael Eduardo,9999,0,9999,0
1713496512053,CLRE 297,001,507242,Cuomo; Raphael Eduardo,9999,0,9999,0
1713496513078,CSE 191,A00,516875,Minnes Kemp; Mor Mia,9999,0,9999,0
1713496514103,CSS 201S,A01,494383,Staff,35,0,35,0
1713496515130,CSS 202S,A01,494387,Staff,35,0,35,0
1713496516155,EAP 100,A00,516065,Staff,9792,0,9999,207
1713496517183,ECE 45,A01,507414,Staff,37,0,60,23
1713496518212,ECE 100,A01,507416,Baghdadchi; Saharnaz,0,0,20,20
1713496518212,ECE 100,A02,507418,Baghdadchi; Saharnaz,19,0,20,1
1713496519241,ECE 111,A01,507420,Staff,27,0,50,23
1713496520265,ECE 197,001,548057,Sievenpiper; Daniel F.,9998,0,9999,1
1713496521290,EDS 115,A00,507243,Choi; Bailey Miyeon,27,0,28,1
1713496522320,EDS 117,A01,494379,Staff,15,0,25,10
1713496523348,EDS 125,A00,507246,Hopkins; Megan Beth,27,0,30,3
1713496524372,EDS 128A,A01,507264,Fargason; Sharon Gayle,26,0,26,0
1713496525401,EDS 128B,A01,507293,Pappas; Elizabeth,30,0,30,0
1713496526428,EDS 139,A00,507294,Fargason; Sharon Gayle,30,0,30,0
1713496526428,EDS 139,B00,507313,Pappas; Elizabeth,30,0,30,0
1713496527452,EDS 201,A00,507315,Staff,18,0,30,12
1713496528477,EDS 203,A01,507317,Halter; Christopher P.,17,0,30,13
1713496529562,EDS 204R,A01,507319,Halter; Christopher P.,0,1,30,30
1713496529562,EDS 204R,B01,507331,Heinzman; Erica M.,22,0,30,8
1713496530588,EDS 206R,A00,507332,Staff,0,2,30,30
1713496530588,EDS 206R,B00,507343,Staff,23,0,30,7
1713496531612,EDS 250,A00,507344,Hemans; Patricia Ann Benitez,27,0,40,13
1713496532636,EDS 281,A00,507345,Daly; Alan J.,18,0,18,0
1713496533663,EDS 284,A00,507350,Daly; Alan J.,16,0,16,0
1713496534693,EDS 286,A00,507359,Fine; Sarah,18,0,18,0
1713496535720,EDS 289C,A01,507361,Daly; Alan J.,18,0,18,0
1713496536748,EDS 290,A00,507366,Hofstetter; Carolyn,15,0,15,0
1713496537778,LIGM 5A,A00,507421,Fischer-Grunski; Eva K,20,0,20,0
1713496538804,LIGM 5B,A00,507423,Fischer-Grunski; Eva K,20,0,20,0
1713496539831,LIGM 5C,A00,507425,Fischer-Grunski; Eva K,20,0,20,0
1713496540862,LIIT 5AS,A00,507427,Carnelos; Chiara,20,0,20,0
1713496541888,LIIT 5BS,A00,507430,Carnelos; Chiara,20,0,20,0
1713496542913,LIIT 5CS,A00,507432,Carnelos; Chiara,20,0,20,0
1713496543940,LISP 5A,A00,507541,Munoz Sanchez; Alicia,14,0,20,6
1713496544968,LISP 5B,A00,507671,Munoz Sanchez; Alicia,12,0,20,8
1713496545997,LISP 5C,A00,507696,Munoz Sanchez; Alicia,11,0,20,9
1713496547023,MAE 197,001,528363,Boechler; Nicholas Sebastia,9998,0,9999,1
1713496548052,MATH 197,001,523477,Kedlaya; Kiran S.,9999,0,9999,0
1713496548052,MATH 197,002,563811,Zhang; Danna,9998,0,9999,1
1713496549078,MCWP 40R,A00,518780,Staff,14,0,20,6
1713496549078,MCWP 40R,B00,518781,Staff,12,0,20,8
1713496549078,MCWP 40R,C00,518783,Staff,9,0,20,11
1713496550107,MCWP 50R,A00,518791,Staff,7,0,20,13
1713496550107,MCWP 50R,B00,518792,Staff,3,0,20,17
1713496550107,MCWP 50R,C00,518793,Staff,7,0,20,13
1713496550107,MCWP 50R,D00,518794,Staff,0,0,20,20
1713496550107,MCWP 50R,E00,518795,Staff,0,0,20,20
1713496550107,MCWP 50R,F00,518796,Staff,11,0,20,9
1713496550107,MCWP 50R,G00,518797,Staff,10,0,20,10
1713496551132,MMW 12R,A01,514034,Herbst; Matthew,4,0,16,12
1713496551132,MMW 12R,A02,514035,Herbst; Matthew,13,0,16,3
1713496552156,MMW 13R,A01,514037,Staff,0,7,16,16
1713496552156,MMW 13R,A02,514039,Staff,0,6,16,16
1713496554210,SIO 295LS,A00,523233,Staff,15,0,30,15
1713496555240,SIO 295S,A00,523232,Staff,15,0,30,15
1713496556266,SOCI 117,A01,494376,Staff,0,2,5,5
1713496557292,WES 237B,A00,494380,Staff,19,0,20,1
1713496559357,AESE 279B,A00,494370,Wade; Jon P,33,0,33,0
1713496560386,AIP 197,001,627712,Vespa; Emanuel Ignacio,9999,0,9999,0
1713496561414,ANAR 135S,A00,494369,Braswell; Geoffrey E.,0,0,0,0
1713496562440,CAT 124RS,A01,519847,Geibel; William,6,0,20,14
1713496563466,CAT 125RS,A01,515971,Geibel; William,6,0,20,14
1713496564493,CLRE 250,A00,511389,Morris; Sheldon,9996,0,9999,3
1713496565517,CLRE 251,A00,507176,Mehta; Ravindra L.,9996,0,9999,3
1713496565517,CLRE 251,B00,511410,Mehta; Ravindra L.,9998,0,9999,1
1713496566552,CLRE 252,A00,507189,Cuomo; Raphael Eduardo,9998,0,9999,1
1713496567576,CLRE 253,A00,507199,Vaida; Florin,9997,0,9999,2
1713496567576,CLRE 253,B00,507202,Vaida; Florin,9999,0,9999,0
1713496568604,CLRE 259,A00,507211,Patel; Hemal,9996,0,9999,3
1713496569630,CLRE 260,A00,507221,Cuomo; Raphael Eduardo,9999,0,9999,0
1713496570658,CLRE 297,001,507242,Cuomo; Raphael Eduardo,9999,0,9999,0
1713496571685,CSE 191,A00,516875,Minnes Kemp; Mor Mia,9999,0,9999,0
1713496572711,CSS 201S,A01,494383,Staff,35,0,35,0
1713496573739,CSS 202S,A01,494387,Staff,35,0,35,0
1713496574766,EAP 100,A00,516065,Staff,9792,0,9999,207
1713496575791,ECE 45,A01,507414,Staff,37,0,60,23
1713496576817,ECE 100,A01,507416,Baghdadchi; Saharnaz,0,0,20,20
1713496576817,ECE 100,A02,507418,Baghdadchi; Saharnaz,19,0,20,1
1713496577845,ECE 111,A01,507420,Staff,27,0,50,23
1713496578874,ECE 197,001,548057,Sievenpiper; Daniel F.,9998,0,9999,1
1713496579903,EDS 115,A00,507243,Choi; Bailey Miyeon,27,0,28,1
1713496580931,EDS 117,A01,494379,Staff,15,0,25,10
1713496581955,EDS 125,A00,507246,Hopkins; Megan Beth,27,0,30,3
1713496582985,EDS 128A,A01,507264,Fargason; Sharon Gayle,26,0,26,0
1713496584010,EDS 128B,A01,507293,Pappas; Elizabeth,30,0,30,0
1713496585038,EDS 139,A00,507294,Fargason; Sharon Gayle,30,0,30,0
1713496585038,EDS 139,B00,507313,Pappas; Elizabeth,30,0,30,0
1713496586066,EDS 201,A00,507315,Staff,18,0,30,12
1713496587091,EDS 203,A01,507317,Halter; Christopher P.,17,0,30,13
1713496588120,EDS 204R,A01,507319,Halter; Christopher P.,0,1,30,30
1713496588120,EDS 204R,B01,507331,Heinzman; Erica M.,22,0,30,8
1713496589149,EDS 206R,A00,507332,Staff,0,2,30,30
1713496589149,EDS 206R,B00,507343,Staff,23,0,30,7
1713496590177,EDS 250,A00,507344,Hemans; Patricia Ann Benitez,27,0,40,13
1713496591202,EDS 281,A00,507345,Daly; Alan J.,18,0,18,0
1713496592230,EDS 284,A00,507350,Daly; Alan J.,16,0,16,0
1713496593258,EDS 286,A00,507359,Fine; Sarah,18,0,18,0
1713496594283,EDS 289C,A01,507361,Daly; Alan J.,18,0,18,0
1713496595308,EDS 290,A00,507366,Hofstetter; Carolyn,15,0,15,0
1713496596333,LIGM 5A,A00,507421,Fischer-Grunski; Eva K,20,0,20,0
1713496597357,LIGM 5B,A00,507423,Fischer-Grunski; Eva K,20,0,20,0
1713496598386,LIGM 5C,A00,507425,Fischer-Grunski; Eva K,20,0,20,0
1713496599410,LIIT 5AS,A00,507427,Carnelos; Chiara,20,0,20,0
1713496600435,LIIT 5BS,A00,507430,Carnelos; Chiara,20,0,20,0
1713496601461,LIIT 5CS,A00,507432,Carnelos; Chiara,20,0,20,0
1713496602486,LISP 5A,A00,507541,Munoz Sanchez; Alicia,14,0,20,6
1713496603516,LISP 5B,A00,507671,Munoz Sanchez; Alicia,12,0,20,8
1713496604541,LISP 5C,A00,507696,Munoz Sanchez; Alicia,11,0,20,9
1713496605570,MAE 197,001,528363,Boechler; Nicholas Sebastia,9998,0,9999,1
1713496606595,MATH 197,001,523477,Kedlaya; Kiran S.,9999,0,9999,0
1713496606595,MATH 197,002,563811,Zhang; Danna,9998,0,9999,1
1713496607620,MCWP 40R,A00,518780,Staff,14,0,20,6
1713496607620,MCWP 40R,B00,518781,Staff,12,0,20,8
1713496607620,MCWP 40R,C00,518783,Staff,9,0,20,11
1713496608653,MCWP 50R,A00,518791,Staff,7,0,20,13
1713496608653,MCWP 50R,B00,518792,Staff,3,0,20,17
1713496608653,MCWP 50R,C00,518793,Staff,7,0,20,13
1713496608653,MCWP 50R,D00,518794,Staff,0,0,20,20
1713496608653,MCWP 50R,E00,518795,Staff,0,0,20,20
1713496608653,MCWP 50R,F00,518796,Staff,11,0,20,9
1713496608653,MCWP 50R,G00,518797,Staff,10,0,20,10
1713496609681,MMW 12R,A01,514034,Herbst; Matthew,4,0,16,12
1713496609681,MMW 12R,A02,514035,Herbst; Matthew,13,0,16,3
1713496610707,MMW 13R,A01,514037,Staff,0,7,16,16
1713496610707,MMW 13R,A02,514039,Staff,0,6,16,16
1713496612758,SIO 295LS,A00,523233,Staff,15,0,30,15
1713496613783,SIO 295S,A00,523232,Staff,15,0,30,15
1713496614809,SOCI 117,A01,494376,Staff,0,2,5,5
1713496615835,WES 237B,A00,494380,Staff,19,0,20,1
1713496617911,AESE 279B,A00,494370,Wade; Jon P,33,0,33,0
1713496618940,AIP 197,001,627712,Vespa; Emanuel Ignacio,9999,0,9999,0
1713496619963,ANAR 135S,A00,494369,Braswell; Geoffrey E.,0,0,0,0
1713496620992,CAT 124RS,A01,519847,Geibel; William,6,0,20,14
1713496622020,CAT 125RS,A01,515971,Geibel; William,6,0,20,14
1713496623048,CLRE 250,A00,511389,Morris; Sheldon,9996,0,9999,3
1713496624074,CLRE 251,A00,507176,Mehta; Ravindra L.,9996,0,9999,3
1713496624074,CLRE 251,B00,511410,Mehta; Ravindra L.,9998,0,9999,1
1713496625099,CLRE 252,A00,507189,Cuomo; Raphael Eduardo,9998,0,9999,1
1713496626127,CLRE 253,A00,507199,Vaida; Florin,9997,0,9999,2
1713496626127,CLRE 253,B00,507202,Vaida; Florin,9999,0,9999,0
1713496627154,CLRE 259,A00,507211,Patel; Hemal,9996,0,9999,3
1713496628182,CLRE 260,A00,507221,Cuomo; Raphael Eduardo,9999,0,9999,0
1713496629212,CLRE 297,001,507242,Cuomo; Raphael Eduardo,9999,0,9999,0
1713496630238,CSE 191,A00,516875,Minnes Kemp; Mor Mia,9999,0,9999,0
1713496631267,CSS 201S,A01,494383,Staff,35,0,35,0
1713496632452,CSS 202S,A01,494387,Staff,35,0,35,0
1713496633531,EAP 100,A00,516065,Staff,9792,0,9999,207
1713496634562,ECE 45,A01,507414,Staff,37,0,60,23
1713496635591,ECE 100,A01,507416,Baghdadchi; Saharnaz,0,0,20,20
1713496635591,ECE 100,A02,507418,Baghdadchi; Saharnaz,19,0,20,1
1713496636616,ECE 111,A01,507420,Staff,27,0,50,23
1713496637640,ECE 197,001,548057,Sievenpiper; Daniel F.,9998,0,9999,1
1713496638669,EDS 115,A00,507243,Choi; Bailey Miyeon,27,0,28,1
1713496639700,EDS 117,A01,494379,Staff,15,0,25,10
1713496640727,EDS 125,A00,507246,Hopkins; Megan Beth,27,0,30,3
1713496641753,EDS 128A,A01,507264,Fargason; Sharon Gayle,26,0,26,0
1713496642779,EDS 128B,A01,507293,Pappas; Elizabeth,30,0,30,0
1713496643805,EDS 139,A00,507294,Fargason; Sharon Gayle,30,0,30,0
1713496643805,EDS 139,B00,507313,Pappas; Elizabeth,30,0,30,0
1713496644833,EDS 201,A00,507315,Staff,18,0,30,12
1713496645859,EDS 203,A01,507317,Halter; Christopher P.,17,0,30,13
1713496646885,EDS 204R,A01,507319,Halter; Christopher P.,0,1,30,30
1713496646885,EDS 204R,B01,507331,Heinzman; Erica M.,22,0,30,8
1713496647914,EDS 206R,A00,507332,Staff,0,2,30,30
1713496647914,EDS 206R,B00,507343,Staff,23,0,30,7
1713496648939,EDS 250,A00,507344,Hemans; Patricia Ann Benitez,27,0,40,13
1713496649964,EDS 281,A00,507345,Daly; Alan J.,18,0,18,0
1713496650989,EDS 284,A00,507350,Daly; Alan J.,16,0,16,0
1713496652018,EDS 286,A00,507359,Fine; Sarah,18,0,18,0
1713496653047,EDS 289C,A01,507361,Daly; Alan J.,18,0,18,0
1713496654073,EDS 290,A00,507366,Hofstetter; Carolyn,15,0,15,0
1713496655100,LIGM 5A,A00,507421,Fischer-Grunski; Eva K,20,0,20,0
1713496656126,LIGM 5B,A00,507423,Fischer-Grunski; Eva K,20,0,20,0
1713496657153,LIGM 5C,A00,507425,Fischer-Grunski; Eva K,20,0,20,0
1713496658180,LIIT 5AS,A00,507427,Carnelos; Chiara,20,0,20,0
1713496659207,LIIT 5BS,A00,507430,Carnelos; Chiara,20,0,20,0
1713496660236,LIIT 5CS,A00,507432,Carnelos; Chiara,20,0,20,0
1713496661263,LISP 5A,A00,507541,Munoz Sanchez; Alicia,14,0,20,6
1713496662292,LISP 5B,A00,507671,Munoz Sanchez; Alicia,12,0,20,8
1713496663318,LISP 5C,A00,507696,Munoz Sanchez; Alicia,11,0,20,9
1713496664343,MAE 197,001,528363,Boechler; Nicholas Sebastia,9998,0,9999,1
1713496665372,MATH 197,001,523477,Kedlaya; Kiran S.,9999,0,9999,0
1713496665372,MATH 197,002,563811,Zhang; Danna,9998,0,9999,1
1713496666398,MCWP 40R,A00,518780,Staff,14,0,20,6
1713496666398,MCWP 40R,B00,518781,Staff,12,0,20,8
1713496666398,MCWP 40R,C00,518783,Staff,9,0,20,11
1713496667424,MCWP 50R,A00,518791,Staff,7,0,20,13
1713496667424,MCWP 50R,B00,518792,Staff,3,0,20,17
1713496667424,MCWP 50R,C00,518793,Staff,7,0,20,13
1713496667424,MCWP 50R,D00,518794,Staff,0,0,20,20
1713496667424,MCWP 50R,E00,518795,Staff,0,0,20,20
1713496667424,MCWP 50R,F00,518796,Staff,11,0,20,9
1713496667424,MCWP 50R,G00,518797,Staff,10,0,20,10
1713496668452,MMW 12R,A01,514034,Herbst; Matthew,4,0,16,12
1713496668452,MMW 12R,A02,514035,Herbst; Matthew,13,0,16,3
1713496669478,MMW 13R,A01,514037,Staff,0,7,16,16
1713496669478,MMW 13R,A02,514039,Staff,0,6,16,16
1713496671534,SIO 295LS,A00,523233,Staff,15,0,30,15
1713496672558,SIO 295S,A00,523232,Staff,15,0,30,15
1713496673583,SOCI 117,A01,494376,Staff,0,2,5,5
1713496674608,WES 237B,A00,494380,Staff,19,0,20,1
1713496676668,AESE 279B,A00,494370,Wade; Jon P,33,0,33,0
1713496677693,AIP 197,001,627712,Vespa; Emanuel Ignacio,9999,0,9999,0
1713496678723,ANAR 135S,A00,494369,Braswell; Geoffrey E.,0,0,0,0
1713496679748,CAT 124RS,A01,519847,Geibel; William,6,0,20,14
1713496680773,CAT 125RS,A01,515971,Geibel; William,6,0,20,14
1713496681804,CLRE 250,A00,511389,Morris; Sheldon,9996,0,9999,3
1713496682835,CLRE 251,A00,507176,Mehta; Ravindra L.,9996,0,9999,3
1713496682835,CLRE 251,B00,511410,Mehta; Ravindra L.,9998,0,9999,1
1713496683874,CLRE 252,A00,507189,Cuomo; Raphael Eduardo,9998,0,9999,1
1713496684902,CLRE 253,A00,507199,Vaida; Florin,9997,0,9999,2
1713496684902,CLRE 253,B00,507202,Vaida; Florin,9999,0,9999,0
1713496685931,CLRE 259,A00,507211,Patel; Hemal,9996,0,9999,3
1713496686955,CLRE 260,A00,507221,Cuomo; Raphael Eduardo,9999,0,9999,0
1713496687980,CLRE 297,001,507242,Cuomo; Raphael Eduardo,9999,0,9999,0
1713496689005,CSE 191,A00,516875,Minnes Kemp; Mor Mia,9999,0,9999,0
1713496690030,CSS 201S,A01,494383,Staff,35,0,35,0
1713496691056,CSS 202S,A01,494387,Staff,35,0,35,0
1713496692084,EAP 100,A00,516065,Staff,9792,0,9999,207
1713496693112,ECE 45,A01,507414,Staff,37,0,60,23
1713496694137,ECE 100,A01,507416,Baghdadchi; Saharnaz,0,0,20,20
1713496694137,ECE 100,A02,507418,Baghdadchi; Saharnaz,19,0,20,1
1713496695165,ECE 111,A01,507420,Staff,27,0,50,23
1713496696192,ECE 197,001,548057,Sievenpiper; Daniel F.,9998,0,9999,1
1713496697221,EDS 115,A00,507243,Choi; Bailey Miyeon,27,0,28,1
1713496698249,EDS 117,A01,494379,Staff,15,0,25,10
1713496699275,EDS 125,A00,507246,Hopkins; Megan Beth,27,0,30,3
1713496700300,EDS 128A,A01,507264,Fargason; Sharon Gayle,26,0,26,0
1713496701328,EDS 128B,A01,507293,Pappas; Elizabeth,30,0,30,0
1713496702355,EDS 139,A00,507294,Fargason; Sharon Gayle,30,0,30,0
1713496702355,EDS 139,B00,507313,Pappas; Elizabeth,30,0,30,0
1713496703378,EDS 201,A00,507315,Staff,18,0,30,12
1713496704404,EDS 203,A01,507317,Halter; Christopher P.,17,0,30,13
1713496705427,EDS 204R,A01,507319,Halter; Christopher P.,0,1,30,30
1713496705427,EDS 204R,B01,507331,Heinzman; Erica M.,22,0,30,8
1713496706455,EDS 206R,A00,507332,Staff,0,2,30,30
1713496706455,EDS 206R,B00,507343,Staff,23,0,30,7
1713496707481,EDS 250,A00,507344,Hemans; Patricia Ann Benitez,27,0,40,13
1713496708509,EDS 281,A00,507345,Daly; Alan J.,18,0,18,0
1713496709539,EDS 284,A00,507350,Daly; Alan J.,16,0,16,0
1713496710566,EDS 286,A00,507359,Fine; Sarah,18,0,18,0
1713496711591,EDS 289C,A01,507361,Daly; Alan J.,18,0,18,0
1713496712616,EDS 290,A00,507366,Hofstetter; Carolyn,15,0,15,0
1713496713646,LIGM 5A,A00,507421,Fischer-Grunski; Eva K,20,0,20,0
1713496714670,LIGM 5B,A00,507423,Fischer-Grunski; Eva K,20,0,20,0
1713496715697,LIGM 5C,A00,507425,Fischer-Grunski; Eva K,20,0,20,0
1713496716723,LIIT 5AS,A00,507427,Carnelos; Chiara,20,0,20,0
1713496717752,LIIT 5BS,A00,507430,Carnelos; Chiara,20,0,20,0
1713496718777,LIIT 5CS,A00,507432,Carnelos; Chiara,20,0,20,0
1713496719806,LISP 5A,A00,507541,Munoz Sanchez; Alicia,14,0,20,6
1713496720830,LISP 5B,A00,507671,Munoz Sanchez; Alicia,12,0,20,8
1713496721855,LISP 5C,A00,507696,Munoz Sanchez; Alicia,11,0,20,9
1713496722881,MAE 197,001,528363,Boechler; Nicholas Sebastia,9998,0,9999,1
1713496723908,MATH 197,001,523477,Kedlaya; Kiran S.,9999,0,9999,0
1713496723908,MATH 197,002,563811,Zhang; Danna,9998,0,9999,1
1713496724938,MCWP 40R,A00,518780,Staff,14,0,20,6
1713496724938,MCWP 40R,B00,518781,Staff,12,0,20,8
1713496724938,MCWP 40R,C00,518783,Staff,9,0,20,11
1713496725964,MCWP 50R,A00,518791,Staff,7,0,20,13
1713496725964,MCWP 50R,B00,518792,Staff,3,0,20,17
1713496725964,MCWP 50R,C00,518793,Staff,7,0,20,13
1713496725964,MCWP 50R,D00,518794,Staff,0,0,20,20
1713496725964,MCWP 50R,E00,518795,Staff,0,0,20,20
1713496725964,MCWP 50R,F00,518796,Staff,11,0,20,9
1713496725964,MCWP 50R,G00,518797,Staff,10,0,20,10
1713496726990,MMW 12R,A01,514034,Herbst; Matthew,4,0,16,12
1713496726990,MMW 12R,A02,514035,Herbst; Matthew,13,0,16,3
1713496728017,MMW 13R,A01,514037,Staff,0,7,16,16
1713496728017,MMW 13R,A02,514039,Staff,0,6,16,16
1713496730067,SIO 295LS,A00,523233,Staff,15,0,30,15
1713496731092,SIO 295S,A00,523232,Staff,15,0,30,15
1713496732117,SOCI 117,A01,494376,Staff,0,2,5,5
1713496733145,WES 237B,A00,494380,Staff,19,0,20,1
1713496735214,AESE 279B,A00,494370,Wade; Jon P,33,0,33,0
1713496736244,AIP 197,001,627712,Vespa; Emanuel Ignacio,9999,0,9999,0
1713496737325,ANAR 135S,A00,494369,Braswell; Geoffrey E.,0,0,0,0
1713496738351,CAT 124RS,A01,519847,Geibel; William,6,0,20,14
1713496739377,CAT 125RS,A01,515971,Geibel; William,6,0,20,14
1713496740402,CLRE 250,A00,511389,Morris; Sheldon,9996,0,9999,3
1713496741430,CLRE 251,A00,507176,Mehta; Ravindra L.,9996,0,9999,3
1713496741430,CLRE 251,B00,511410,Mehta; Ravindra L.,9998,0,9999,1
1713496742459,CLRE 252,A00,507189,Cuomo; Raphael Eduardo,9998,0,9999,1
1713496743487,CLRE 253,A00,507199,Vaida; Florin,9997,0,9999,2
1713496743487,CLRE 253,B00,507202,Vaida; Florin,9999,0,9999,0
1713496744512,CLRE 259,A00,507211,Patel; Hemal,9996,0,9999,3
1713496745540,CLRE 260,A00,507221,Cuomo; Raphael Eduardo,9999,0,9999,0
1713496746569,CLRE 297,001,507242,Cuomo; Raphael Eduardo,9999,0,9999,0
1713496747592,CSE 191,A00,516875,Minnes Kemp; Mor Mia,9999,0,9999,0
1713496748621,CSS 201S,A01,494383,Staff,35,0,35,0
1713496749647,CSS 202S,A01,494387,Staff,35,0,35,0
1713496750675,EAP 100,A00,516065,Staff,9792,0,9999,207
1713496751705,ECE 45,A01,507414,Staff,37,0,60,23
1713496752735,ECE 100,A01,507416,Baghdadchi; Saharnaz,0,0,20,20
1713496752735,ECE 100,A02,507418,Baghdadchi; Saharnaz,19,0,20,1
1713496753760,ECE 111,A01,507420,Staff,27,0,50,23
1713496754784,ECE 197,001,548057,Sievenpiper; Daniel F.,9998,0,9999,1
1713496755811,EDS 115,A00,507243,Choi; Bailey Miyeon,27,0,28,1
1713496756840,EDS 117,A01,494379,Staff,15,0,25,10
1713496757871,EDS 125,A00,507246,Hopkins; Megan Beth,27,0,30,3
1713496758897,EDS 128A,A01,507264,Fargason; Sharon Gayle,26,0,26,0
1713496759921,EDS 128B,A01,507293,Pappas; Elizabeth,30,0,30,0
1713496760946,EDS 139,A00,507294,Fargason; Sharon Gayle,30,0,30,0
1713496760946,EDS 139,B00,507313,Pappas; Elizabeth,30,0,30,0
1713496761971,EDS 201,A00,507315,Staff,18,0,30,12
1713496763002,EDS 203,A01,507317,Halter; Christopher P.,17,0,30,13
1713496764028,EDS 204R,A01,507319,Halter; Christopher P.,0,1,30,30
1713496764028,EDS 204R,B01,507331,Heinzman; Erica M.,22,0,30,8
1713496765053,EDS 206R,A00,507332,Staff,0,2,30,30
1713496765053,EDS 206R,B00,507343,Staff,23,0,30,7
1713496766078,EDS 250,A00,507344,Hemans; Patricia Ann Benitez,27,0,40,13
1713496767107,EDS 281,A00,507345,Daly; Alan J.,18,0,18,0
1713496768133,EDS 284,A00,507350,Daly; Alan J.,16,0,16,0
1713496769158,EDS 286,A00,507359,Fine; Sarah,18,0,18,0
1713496770182,EDS 289C,A01,507361,Daly; Alan J.,18,0,18,0
1713496771209,EDS 290,A00,507366,Hofstetter; Carolyn,15,0,15,0
1713496772238,LIGM 5A,A00,507421,Fischer-Grunski; Eva K,20,0,20,0
1713496773264,LIGM 5B,A00,507423,Fischer-Grunski; Eva K,20,0,20,0
1713496774289,LIGM 5C,A00,507425,Fischer-Grunski; Eva K,20,0,20,0
1713496775314,LIIT 5AS,A00,507427,Carnelos; Chiara,20,0,20,0
1713496776343,LIIT 5BS,A00,507430,Carnelos; Chiara,20,0,20,0
1713496777367,LIIT 5CS,A00,507432,Carnelos; Chiara,20,0,20,0
1713496778397,LISP 5A,A00,507541,Munoz Sanchez; Alicia,14,0,20,6
1713496779421,LISP 5B,A00,507671,Munoz Sanchez; Alicia,12,0,20,8
1713496780454,LISP 5C,A00,507696,Munoz Sanchez; Alicia,11,0,20,9
1713496781481,MAE 197,001,528363,Boechler; Nicholas Sebastia,9998,0,9999,1
1713496782510,MATH 197,001,523477,Kedlaya; Kiran S.,9999,0,9999,0
1713496782510,MATH 197,002,563811,Zhang; Danna,9998,0,9999,1
1713496783538,MCWP 40R,A00,518780,Staff,14,0,20,6
1713496783538,MCWP 40R,B00,518781,Staff,12,0,20,8
1713496783538,MCWP 40R,C00,518783,Staff,9,0,20,11
1713496784573,MCWP 50R,A00,518791,Staff,7,0,20,13
1713496784573,MCWP 50R,B00,518792,Staff,3,0,20,17
1713496784573,MCWP 50R,C00,518793,Staff,7,0,20,13
1713496784573,MCWP 50R,D00,518794,Staff,0,0,20,20
1713496784573,MCWP 50R,E00,518795,Staff,0,0,20,20
1713496784573,MCWP 50R,F00,518796,Staff,11,0,20,9
1713496784573,MCWP 50R,G00,518797,Staff,10,0,20,10
1713496785601,MMW 12R,A01,514034,Herbst; Matthew,4,0,16,12
1713496785601,MMW 12R,A02,514035,Herbst; Matthew,13,0,16,3
1713496786628,MMW 13R,A01,514037,Staff,0,7,16,16
1713496786628,MMW 13R,A02,514039,Staff,0,6,16,16
1713496788679,SIO 295LS,A00,523233,Staff,15,0,30,15
1713496789702,SIO 295S,A00,523232,Staff,15,0,30,15
1713496790728,SOCI 117,A01,494376,Staff,0,2,5,5
1713496791753,WES 237B,A00,494380,Staff,19,0,20,1
1713496793811,AESE 279B,A00,494370,Wade; Jon P,33,0,33,0
1713496794840,AIP 197,001,627712,Vespa; Emanuel Ignacio,9999,0,9999,0
1713496795865,ANAR 135S,A00,494369,Braswell; Geoffrey E.,0,0,0,0
1713496796889,CAT 124RS,A01,519847,Geibel; William,6,0,20,14
1713496797915,CAT 125RS,A01,515971,Geibel; William,6,0,20,14
1713496798944,CLRE 250,A00,511389,Morris; Sheldon,9996,0,9999,3
1713496799970,CLRE 251,A00,507176,Mehta; Ravindra L.,9996,0,9999,3
1713496799970,CLRE 251,B00,511410,Mehta; Ravindra L.,9998,0,9999,1
1713496800999,CLRE 252,A00,507189,Cuomo; Raphael Eduardo,9998,0,9999,1
1713496802028,CLRE 253,A00,507199,Vaida; Florin,9997,0,9999,2
1713496802028,CLRE 253,B00,507202,Vaida; Florin,9999,0,9999,0
1713496803053,CLRE 259,A00,507211,Patel; Hemal,9996,0,9999,3
1713496804081,CLRE 260,A00,507221,Cuomo; Raphael Eduardo,9999,0,9999,0
1713496805108,CLRE 297,001,507242,Cuomo; Raphael Eduardo,9999,0,9999,0
1713496806136,CSE 191,A00,516875,Minnes Kemp; Mor Mia,9999,0,9999,0
1713496807164,CSS 201S,A01,494383,Staff,35,0,35,0
1713496808193,CSS 202S,A01,494387,Staff,35,0,35,0
1713496809217,EAP 100,A00,516065,Staff,9792,0,9999,207
1713496810248,ECE 45,A01,507414,Staff,37,0,60,23
1713496811278,ECE 100,A01,507416,Baghdadchi; Saharnaz,0,0,20,20
1713496811278,ECE 100,A02,507418,Baghdadchi; Saharnaz,19,0,20,1
1713496812304,ECE 111,A01,507420,Staff,27,0,50,23
1713496813333,ECE 197,001,548057,Sievenpiper; Daniel F.,9998,0,9999,1
1713496814359,EDS 115,A00,507243,Choi; Bailey Miyeon,27,0,28,1
1713496815383,EDS 117,A01,494379,Staff,15,0,25,10
1713496816408,EDS 125,A00,507246,Hopkins; Megan Beth,27,0,30,3
1713496817434,EDS 128A,A01,507264,Fargason; Sharon Gayle,26,0,26,0
1713496818458,EDS 128B,A01,507293,Pappas; Elizabeth,30,0,30,0
1713496819483,EDS 139,A00,507294,Fargason; Sharon Gayle,30,0,30,0
1713496819483,EDS 139,B00,507313,Pappas; Elizabeth,30,0,30,0
1713496820509,EDS 201,A00,507315,Staff,18,0,30,12
1713496821536,EDS 203,A01,507317,Halter; Christopher P.,17,0,30,13
1713496822566,EDS 204R,A01,507319,Halter; Christopher P.,0,1,30,30
1713496822566,EDS 204R,B01,507331,Heinzman; Erica M.,22,0,30,8
1713496823597,EDS 206R,A00,507332,Staff,0,2,30,30
1713496823597,EDS 206R,B00,507343,Staff,23,0,30,7
1713496824625,EDS 250,A00,507344,Hemans; Patricia Ann Benitez,27,0,40,13
1713496825652,EDS 281,A00,507345,Daly; Alan J.,18,0,18,0
1713496826679,EDS 284,A00,507350,Daly; Alan J.,16,0,16,0
1713496827707,EDS 286,A00,507359,Fine; Sarah,18,0,18,0
1713496828731,EDS 289C,A01,507361,Daly; Alan J.,18,0,18,0
1713496829757,EDS 290,A00,507366,Hofstetter; Carolyn,15,0,15,0
1713496830783,LIGM 5A,A00,507421,Fischer-Grunski; Eva K,20,0,20,0
1713496831808,LIGM 5B,A00,507423,Fischer-Grunski; Eva K,20,0,20,0
1713496832838,LIGM 5C,A00,507425,Fischer-Grunski; Eva K,20,0,20,0
1713496833870,LIIT 5AS,A00,507427,Carnelos; Chiara,20,0,20,0
1713496834895,LIIT 5BS,A00,507430,Carnelos; Chiara,20,0,20,0
1713496835921,LIIT 5CS,A00,507432,Carnelos; Chiara,20,0,20,0
1713496836954,LISP 5A,A00,507541,Munoz Sanchez; Alicia,14,0,20,6
1713496837983,LISP 5B,A00,507671,Munoz Sanchez; Alicia,12,0,20,8
1713496839009,LISP 5C,A00,507696,Munoz Sanchez; Alicia,11,0,20,9
1713496840037,MAE 197,001,528363,Boechler; Nicholas Sebastia,9998,0,9999,1
1713496841115,MATH 197,001,523477,Kedlaya; Kiran S.,9999,0,9999,0
1713496841115,MATH 197,002,563811,Zhang; Danna,9998,0,9999,1
1713496842141,MCWP 40R,A00,518780,Staff,14,0,20,6
1713496842141,MCWP 40R,B00,518781,Staff,12,0,20,8
1713496842141,MCWP 40R,C00,518783,Staff,9,0,20,11
1713496843171,MCWP 50R,A00,518791,Staff,7,0,20,13
1713496843171,MCWP 50R,B00,518792,Staff,3,0,20,17
1713496843171,MCWP 50R,C00,518793,Staff,7,0,20,13
1713496843171,MCWP 50R,D00,518794,Staff,0,0,20,20
1713496843171,MCWP 50R,E00,518795,Staff,0,0,20,20
1713496843171,MCWP 50R,F00,518796,Staff,11,0,20,9
1713496843171,MCWP 50R,G00,518797,Staff,10,0,20,10
1713496844196,MMW 12R,A01,514034,Herbst; Matthew,4,0,16,12
1713496844196,MMW 12R,A02,514035,Herbst; Matthew,13,0,16,3
1713496845220,MMW 13R,A01,514037,Staff,0,7,16,16
1713496845220,MMW 13R,A02,514039,Staff,0,6,16,16
1713496847273,SIO 295LS,A00,523233,Staff,15,0,30,15
1713496848298,SIO 295S,A00,523232,Staff,15,0,30,15
1713496849324,SOCI 117,A01,494376,Staff,0,2,5,5
1713496850353,WES 237B,A00,494380,Staff,19,0,20,1
1713496852416,AESE 279B,A00,494370,Wade; Jon P,33,0,33,0
1713496853441,AIP 197,001,627712,Vespa; Emanuel Ignacio,9999,0,9999,0
1713496854469,ANAR 135S,A00,494369,Braswell; Geoffrey E.,0,0,0,0
1713496855495,CAT 124RS,A01,519847,Geibel; William,6,0,20,14
1713496856524,CAT 125RS,A01,515971,Geibel; William,6,0,20,14
1713496857554,CLRE 250,A00,511389,Morris; Sheldon,9996,0,9999,3
1713496858582,CLRE 251,A00,507176,Mehta; Ravindra L.,9996,0,9999,3
1713496858582,CLRE 251,B00,511410,Mehta; Ravindra L.,9998,0,9999,1
1713496859607,CLRE 252,A00,507189,Cuomo; Raphael Eduardo,9998,0,9999,1
1713496860638,CLRE 253,A00,507199,Vaida; Florin,9997,0,9999,2
1713496860638,CLRE 253,B00,507202,Vaida; Florin,9999,0,9999,0
1713496861667,CLRE 259,A00,507211,Patel; Hemal,9996,0,9999,3
1713496862691,CLRE 260,A00,507221,Cuomo; Raphael Eduardo,9999,0,9999,0
1713496863716,CLRE 297,001,507242,Cuomo; Raphael Eduardo,9999,0,9999,0
1713496864743,CSE 191,A00,516875,Minnes Kemp; Mor Mia,9999,0,9999,0
1713496865769,CSS 201S,A01,494383,Staff,35,0,35,0
1713496866797,CSS 202S,A01,494387,Staff,35,0,35,0
1713496867825,EAP 100,A00,516065,Staff,9792,0,9999,207
1713496868854,ECE 45,A01,507414,Staff,37,0,60,23
1713496869880,ECE 100,A01,507416,Baghdadchi; Saharnaz,0,0,20,20
1713496869880,ECE 100,A02,507418,Baghdadchi; Saharnaz,19,0,20,1
1713496870909,ECE 111,A01,507420,Staff,27,0,50,23
1713496871940,ECE 197,001,548057,Sievenpiper; Daniel F.,9998,0,9999,1
1713496872968,EDS 115,A00,507243,Choi; Bailey Miyeon,27,0,28,1
1713496873994,EDS 117,A01,494379,Staff,15,0,25,10
1713496875020,EDS 125,A00,507246,Hopkins; Megan Beth,27,0,30,3
1713496876049,EDS 128A,A01,507264,Fargason; Sharon Gayle,26,0,26,0
1713496877076,EDS 128B,A01,507293,Pappas; Elizabeth,30,0,30,0
1713496878101,EDS 139,A00,507294,Fargason; Sharon Gayle,30,0,30,0
1713496878101,EDS 139,B00,507313,Pappas; Elizabeth,30,0,30,0
1713496879128,EDS 201,A00,507315,Staff,18,0,30,12
1713496880154,EDS 203,A01,507317,Halter; Christopher P.,17,0,30,13
1713496881179,EDS 204R,A01,507319,Halter; Christopher P.,0,1,30,30
1713496881179,EDS 204R,B01,507331,Heinzman; Erica M.,22,0,30,8
1713496882205,EDS 206R,A00,507332,Staff,0,2,30,30
1713496882205,EDS 206R,B00,507343,Staff,23,0,30,7
1713496883234,EDS 250,A00,507344,Hemans; Patricia Ann Benitez,27,0,40,13
1713496884264,EDS 281,A00,507345,Daly; Alan J.,18,0,18,0
1713496885294,EDS 284,A00,507350,Daly; Alan J.,16,0,16,0
1713496886319,EDS 286,A00,507359,Fine; Sarah,18,0,18,0
1713496887344,EDS 289C,A01,507361,Daly; Alan J.,18,0,18,0
1713496888373,EDS 290,A00,507366,Hofstetter; Carolyn,15,0,15,0
1713496889400,LIGM 5A,A00,507421,Fischer-Grunski; Eva K,20,0,20,0
1713496890426,LIGM 5B,A00,507423,Fischer-Grunski; Eva K,20,0,20,0
1713496891451,LIGM 5C,A00,507425,Fischer-Grunski; Eva K,20,0,20,0
1713496892480,LIIT 5AS,A00,507427,Carnelos; Chiara,20,0,20,0
1713496893505,LIIT 5BS,A00,507430,Carnelos; Chiara,20,0,20,0
1713496894531,LIIT 5CS,A00,507432,Carnelos; Chiara,20,0,20,0
1713496895561,LISP 5A,A00,507541,Munoz Sanchez; Alicia,14,0,20,6
1713496896586,LISP 5B,A00,507671,Munoz Sanchez; Alicia,12,0,20,8
1713496897609,LISP 5C,A00,507696,Munoz Sanchez; Alicia,11,0,20,9
1713496898637,MAE 197,001,528363,Boechler; Nicholas Sebastia,9998,0,9999,1
1713496899662,MATH 197,001,523477,Kedlaya; Kiran S.,9999,0,9999,0
1713496899662,MATH 197,002,563811,Zhang; Danna,9998,0,9999,1
1713496900688,MCWP 40R,A00,518780,Staff,14,0,20,6
1713496900688,MCWP 40R,B00,518781,Staff,12,0,20,8
1713496900688,MCWP 40R,C00,518783,Staff,9,0,20,11
1713496901718,MCWP 50R,A00,518791,Staff,7,0,20,13
1713496901718,MCWP 50R,B00,518792,Staff,3,0,20,17
1713496901718,MCWP 50R,C00,518793,Staff,7,0,20,13
1713496901718,MCWP 50R,D00,518794,Staff,0,0,20,20
1713496901718,MCWP 50R,E00,518795,Staff,0,0,20,20
1713496901718,MCWP 50R,F00,518796,Staff,11,0,20,9
1713496901718,MCWP 50R,G00,518797,Staff,10,0,20,10
1713496902744,MMW 12R,A01,514034,Herbst; Matthew,4,0,16,12
1713496902744,MMW 12R,A02,514035,Herbst; Matthew,13,0,16,3
1713496903768,MMW 13R,A01,514037,Staff,0,7,16,16
1713496903768,MMW 13R,A02,514039,Staff,0,6,16,16
1713496905821,SIO 295LS,A00,523233,Staff,15,0,30,15
1713496906846,SIO 295S,A00,523232,Staff,15,0,30,15
1713496907875,SOCI 117,A01,494376,Staff,0,2,5,5
1713496908902,WES 237B,A00,494380,Staff,19,0,20,1
1713496910969,AESE 279B,A00,494370,Wade; Jon P,33,0,33,0
1713496911994,AIP 197,001,627712,Vespa; Emanuel Ignacio,9999,0,9999,0
1713496913020,ANAR 135S,A00,494369,Braswell; Geoffrey E.,0,0,0,0
1713496914047,CAT 124RS,A01,519847,Geibel; William,6,0,20,14
1713496915075,CAT 125RS,A01,515971,Geibel; William,6,0,20,14
1713496916100,CLRE 250,A00,511389,Morris; Sheldon,9996,0,9999,3
1713496917129,CLRE 251,A00,507176,Mehta; Ravindra L.,9996,0,9999,3
1713496917129,CLRE 251,B00,511410,Mehta; Ravindra L.,9998,0,9999,1
1713496918154,CLRE 252,A00,507189,Cuomo; Raphael Eduardo,9998,0,9999,1
1713496919180,CLRE 253,A00,507199,Vaida; Florin,9997,0,9999,2
1713496919180,CLRE 253,B00,507202,Vaida; Florin,9999,0,9999,0
1713496920205,CLRE 259,A00,507211,Patel; Hemal,9996,0,9999,3
1713496921230,CLRE 260,A00,507221,Cuomo; Raphael Eduardo,9999,0,9999,0
1713496922259,CLRE 297,001,507242,Cuomo; Raphael Eduardo,9999,0,9999,0
1713496923289,CSE 191,A00,516875,Minnes Kemp; Mor Mia,9999,0,9999,0
1713496924315,CSS 201S,A01,494383,Staff,35,0,35,0
1713496925345,CSS 202S,A01,494387,Staff,35,0,35,0
1713496926371,EAP 100,A00,516065,Staff,9792,0,9999,207
1713496927396,ECE 45,A01,507414,Staff,37,0,60,23
1713496928421,ECE 100,A01,507416,Baghdadchi; Saharnaz,0,0,20,20
1713496928421,ECE 100,A02,507418,Baghdadchi; Saharnaz,19,0,20,1
1713496929450,ECE 111,A01,507420,Staff,27,0,50,23
1713496930475,ECE 197,001,548057,Sievenpiper; Daniel F.,9998,0,9999,1
1713496931504,EDS 115,A00,507243,Choi; Bailey Miyeon,27,0,28,1
1713496932529,EDS 117,A01,494379,Staff,15,0,25,10
1713496933558,EDS 125,A00,507246,Hopkins; Megan Beth,27,0,30,3
1713496934583,EDS 128A,A01,507264,Fargason; Sharon Gayle,26,0,26,0
1713496935612,EDS 128B,A01,507293,Pappas; Elizabeth,30,0,30,0
1713496936638,EDS 139,A00,507294,Fargason; Sharon Gayle,30,0,30,0
1713496936638,EDS 139,B00,507313,Pappas; Elizabeth,30,0,30,0
1713496937667,EDS 201,A00,507315,Staff,18,0,30,12
1713496938693,EDS 203,A01,507317,Halter; Christopher P.,17,0,30,13
1713496939723,EDS 204R,A01,507319,Halter; Christopher P.,0,1,30,30
1713496939723,EDS 204R,B01,507331,Heinzman; Erica M.,22,0,30,8
1713496940749,EDS 206R,A00,507332,Staff,0,2,30,30
1713496940749,EDS 206R,B00,507343,Staff,23,0,30,7
1713496941779,EDS 250,A00,507344,Hemans; Patricia Ann Benitez,27,0,40,13
1713496942803,EDS 281,A00,507345,Daly; Alan J.,18,0,18,0
1713496943830,EDS 284,A00,507350,Daly; Alan J.,16,0,16,0
1713496944913,EDS 286,A00,507359,Fine; Sarah,18,0,18,0
1713496945940,EDS 289C,A01,507361,Daly; Alan J.,18,0,18,0
1713496946971,EDS 290,A00,507366,Hofstetter; Carolyn,15,0,15,0
1713496948000,LIGM 5A,A00,507421,Fischer-Grunski; Eva K,20,0,20,0
1713496949029,LIGM 5B,A00,507423,Fischer-Grunski; Eva K,20,0,20,0
1713496950053,LIGM 5C,A00,507425,Fischer-Grunski; Eva K,20,0,20,0
1713496951078,LIIT 5AS,A00,507427,Carnelos; Chiara,20,0,20,0
1713496952102,LIIT 5BS,A00,507430,Carnelos; Chiara,20,0,20,0
1713496953128,LIIT 5CS,A00,507432,Carnelos; Chiara,20,0,20,0
1713496954156,LISP 5A,A00,507541,Munoz Sanchez; Alicia,14,0,20,6
1713496955181,LISP 5B,A00,507671,Munoz Sanchez; Alicia,12,0,20,8
1713496956206,LISP 5C,A00,507696,Munoz Sanchez; Alicia,11,0,20,9
1713496957235,MAE 197,001,528363,Boechler; Nicholas Sebastia,9998,0,9999,1
1713496958263,MATH 197,001,523477,Kedlaya; Kiran S.,9999,0,9999,0
1713496958263,MATH 197,002,563811,Zhang; Danna,9998,0,9999,1
1713496959292,MCWP 40R,A00,518780,Staff,14,0,20,6
1713496959292,MCWP 40R,B00,518781,Staff,12,0,20,8
1713496959292,MCWP 40R,C00,518783,Staff,9,0,20,11
1713496960322,MCWP 50R,A00,518791,Staff,7,0,20,13
1713496960322,MCWP 50R,B00,518792,Staff,3,0,20,17
1713496960322,MCWP 50R,C00,518793,Staff,7,0,20,13
1713496960322,MCWP 50R,D00,518794,Staff,0,0,20,20
1713496960322,MCWP 50R,E00,518795,Staff,0,0,20,20
1713496960322,MCWP 50R,F00,518796,Staff,11,0,20,9
1713496960322,MCWP 50R,G00,518797,Staff,10,0,20,10
1713496961350,MMW 12R,A01,514034,Herbst; Matthew,4,0,16,12
1713496961350,MMW 12R,A02,514035,Herbst; Matthew,13,0,16,3
1713496962377,MMW 13R,A01,514037,Staff,0,7,16,16
1713496962377,MMW 13R,A02,514039,Staff,0,6,16,16
1713496964431,SIO 295LS,A00,523233,Staff,15,0,30,15
1713496965459,SIO 295S,A00,523232,Staff,15,0,30,15
1713496966484,SOCI 117,A01,494376,Staff,0,2,5,5
1713496967513,WES 237B,A00,494380,Staff,19,0,20,1
1713496969593,AESE 279B,A00,494370,Wade; Jon P,33,0,33,0
1713496970618,AIP 197,001,627712,Vespa; Emanuel Ignacio,9999,0,9999,0
1713496971644,ANAR 135S,A00,494369,Braswell; Geoffrey E.,0,0,0,0
1713496972673,CAT 124RS,A01,519847,Geibel; William,6,0,20,14
1713496973698,CAT 125RS,A01,515971,Geibel; William,6,0,20,14
1713496974725,CLRE 250,A00,511389,Morris; Sheldon,9996,0,9999,3
1713496975756,CLRE 251,A00,507176,Mehta; Ravindra L.,9996,0,9999,3
1713496975756,CLRE 251,B00,511410,Mehta; Ravindra L.,9998,0,9999,1
1713496976782,CLRE 252,A00,507189,Cuomo; Raphael Eduardo,9998,0,9999,1
1713496977812,CLRE 253,A00,507199,Vaida; Florin,9997,0,9999,2
1713496977812,CLRE 253,B00,507202,Vaida; Florin,9999,0,9999,0
1713496978839,CLRE 259,A00,507211,Patel; Hemal,9996,0,9999,3
1713496979866,CLRE 260,A00,507221,Cuomo; Raphael Eduardo,9999,0,9999,0
1713496980890,CLRE 297,001,507242,Cuomo; Raphael Eduardo,9999,0,9999,0
1713496981918,CSE 191,A00,516875,Minnes Kemp; Mor Mia,9999,0,9999,0
1713496982949,CSS 201S,A01,494383,Staff,35,0,35,0
1713496983975,CSS 202S,A01,494387,Staff,35,0,35,0
1713496985000,EAP 100,A00,516065,Staff,9792,0,9999,207
1713496986027,ECE 45,A01,507414,Staff,37,0,60,23
1713496987052,ECE 100,A01,507416,Baghdadchi; Saharnaz,0,0,20,20
1713496987052,ECE 100,A02,507418,Baghdadchi; Saharnaz,19,0,20,1
1713496988078,ECE 111,A01,507420,Staff,27,0,50,23
1713496989104,ECE 197,001,548057,Sievenpiper; Daniel F.,9998,0,9999,1
1713496990136,EDS 115,A00,507243,Choi; Bailey Miyeon,27,0,28,1
1713496991166,EDS 117,A01,494379,Staff,15,0,25,10
1713496992197,EDS 125,A00,507246,Hopkins; Megan Beth,27,0,30,3
1713496993226,EDS 128A,A01,507264,Fargason; Sharon Gayle,26,0,26,0
1713496994253,EDS 128B,A01,507293,Pappas; Elizabeth,30,0,30,0
1713496995281,EDS 139,A00,507294,Fargason; Sharon Gayle,30,0,30,0
1713496995281,EDS 139,B00,507313,Pappas; Elizabeth,30,0,30,0
1713496996306,EDS 201,A00,507315,Staff,18,0,30,12
1713496997334,EDS 203,A01,507317,Halter; Christopher P.,17,0,30,13
1713496998360,EDS 204R,A01,507319,Halter; Christopher P.,0,1,30,30
1713496998360,EDS 204R,B01,507331,Heinzman; Erica M.,22,0,30,8
1713496999389,EDS 206R,A00,507332,Staff,0,2,30,30
1713496999389,EDS 206R,B00,507343,Staff,23,0,30,7
1713497000413,EDS 250,A00,507344,Hemans; Patricia Ann Benitez,27,0,40,13
1713497001438,EDS 281,A00,507345,Daly; Alan J.,18,0,18,0
1713497002466,EDS 284,A00,507350,Daly; Alan J.,16,0,16,0
1713497003493,EDS 286,A00,507359,Fine; Sarah,18,0,18,0
1713497004518,EDS 289C,A01,507361,Daly; Alan J.,18,0,18,0
1713497005544,EDS 290,A00,507366,Hofstetter; Carolyn,15,0,15,0
1713497006574,LIGM 5A,A00,507421,Fischer-Grunski; Eva K,20,0,20,0
1713497007603,LIGM 5B,A00,507423,Fischer-Grunski; Eva K,20,0,20,0
1713497008629,LIGM 5C,A00,507425,Fischer-Grunski; Eva K,20,0,20,0
1713497009654,LIIT 5AS,A00,507427,Carnelos; Chiara,20,0,20,0
1713497010683,LIIT 5BS,A00,507430,Carnelos; Chiara,20,0,20,0
1713497011711,LIIT 5CS,A00,507432,Carnelos; Chiara,20,0,20,0
1713497012737,LISP 5A,A00,507541,Munoz Sanchez; Alicia,14,0,20,6
1713497013763,LISP 5B,A00,507671,Munoz Sanchez; Alicia,12,0,20,8
1713497014793,LISP 5C,A00,507696,Munoz Sanchez; Alicia,11,0,20,9
1713497015821,MAE 197,001,528363,Boechler; Nicholas Sebastia,9998,0,9999,1
1713497016851,MATH 197,001,523477,Kedlaya; Kiran S.,9999,0,9999,0
1713497016851,MATH 197,002,563811,Zhang; Danna,9998,0,9999,1
1713497017877,MCWP 40R,A00,518780,Staff,14,0,20,6
1713497017877,MCWP 40R,B00,518781,Staff,12,0,20,8
1713497017877,MCWP 40R,C00,518783,Staff,9,0,20,11
1713497018904,MCWP 50R,A00,518791,Staff,7,0,20,13
1713497018904,MCWP 50R,B00,518792,Staff,3,0,20,17
1713497018904,MCWP 50R,C00,518793,Staff,7,0,20,13
1713497018904,MCWP 50R,D00,518794,Staff,0,0,20,20
1713497018904,MCWP 50R,E00,518795,Staff,0,0,20,20
1713497018904,MCWP 50R,F00,518796,Staff,11,0,20,9
1713497018904,MCWP 50R,G00,518797,Staff,10,0,20,10
1713497019930,MMW 12R,A01,514034,Herbst; Matthew,4,0,16,12
1713497019930,MMW 12R,A02,514035,Herbst; Matthew,13,0,16,3
1713497020958,MMW 13R,A01,514037,Staff,0,7,16,16
1713497020958,MMW 13R,A02,514039,Staff,0,6,16,16
1713497023010,SIO 295LS,A00,523233,Staff,15,0,30,15
1713497024037,SIO 295S,A00,523232,Staff,15,0,30,15
1713497025066,SOCI 117,A01,494376,Staff,0,2,5,5
1713497026092,WES 237B,A00,494380,Staff,19,0,20,1
1713497028165,AESE 279B,A00,494370,Wade; Jon P,33,0,33,0
1713497029194,AIP 197,001,627712,Vespa; Emanuel Ignacio,9999,0,9999,0
1713497030220,ANAR 135S,A00,494369,Braswell; Geoffrey E.,0,0,0,0
1713497031246,CAT 124RS,A01,519847,Geibel; William,6,0,20,14
1713497032272,CAT 125RS,A01,515971,Geibel; William,6,0,20,14
1713497033298,CLRE 250,A00,511389,Morris; Sheldon,9996,0,9999,3
1713497034329,CLRE 251,A00,507176,Mehta; Ravindra L.,9996,0,9999,3
1713497034329,CLRE 251,B00,511410,Mehta; Ravindra L.,9998,0,9999,1
1713497035353,CLRE 252,A00,507189,Cuomo; Raphael Eduardo,9998,0,9999,1
1713497036380,CLRE 253,A00,507199,Vaida; Florin,9997,0,9999,2
1713497036380,CLRE 253,B00,507202,Vaida; Florin,9999,0,9999,0
1713497037406,CLRE 259,A00,507211,Patel; Hemal,9996,0,9999,3
1713497038429,CLRE 260,A00,507221,Cuomo; Raphael Eduardo,9999,0,9999,0
1713497039457,CLRE 297,001,507242,Cuomo; Raphael Eduardo,9999,0,9999,0
1713497040485,CSE 191,A00,516875,Minnes Kemp; Mor Mia,9999,0,9999,0
1713497041513,CSS 201S,A01,494383,Staff,35,0,35,0
1713497042542,CSS 202S,A01,494387,Staff,35,0,35,0
1713497043570,EAP 100,A00,516065,Staff,9792,0,9999,207
1713497044596,ECE 45,A01,507414,Staff,37,0,60,23
1713497045623,ECE 100,A01,507416,Baghdadchi; Saharnaz,0,0,20,20
1713497045623,ECE 100,A02,507418,Baghdadchi; Saharnaz,19,0,20,1
1713497046651,ECE 111,A01,507420,Staff,27,0,50,23
1713497047676,ECE 197,001,548057,Sievenpiper; Daniel F.,9998,0,9999,1
1713497048760,EDS 115,A00,507243,Choi; Bailey Miyeon,27,0,28,1
1713497049785,EDS 117,A01,494379,Staff,15,0,25,10
1713497050811,EDS 125,A00,507246,Hopkins; Megan Beth,27,0,30,3
1713497051841,EDS 128A,A01,507264,Fargason; Sharon Gayle,26,0,26,0
1713497052871,EDS 128B,A01,507293,Pappas; Elizabeth,30,0,30,0
1713497053903,EDS 139,A00,507294,Fargason; Sharon Gayle,30,0,30,0
1713497053903,EDS 139,B00,507313,Pappas; Elizabeth,30,0,30,0
1713497054931,EDS 201,A00,507315,Staff,18,0,30,12
1713497055956,EDS 203,A01,507317,Halter; Christopher P.,17,0,30,13
1713497056983,EDS 204R,A01,507319,Halter; Christopher P.,0,1,30,30
1713497056983,EDS 204R,B01,507331,Heinzman; Erica M.,22,0,30,8
1713497058010,EDS 206R,A00,507332,Staff,0,2,30,30
1713497058010,EDS 206R,B00,507343,Staff,23,0,30,7
1713497059034,EDS 250,A00,507344,Hemans; Patricia Ann Benitez,27,0,40,13
1713497060062,EDS 281,A00,507345,Daly; Alan J.,18,0,18,0
1713497061086,EDS 284,A00,507350,Daly; Alan J.,16,0,16,0
1713497062112,EDS 286,A00,507359,Fine; Sarah,18,0,18,0
1713497063141,EDS 289C,A01,507361,Daly; Alan J.,18,0,18,0
1713497064167,EDS 290,A00,507366,Hofstetter; Carolyn,15,0,15,0
1713497065192,LIGM 5A,A00,507421,Fischer-Grunski; Eva K,20,0,20,0
1713497066218,LIGM 5B,A00,507423,Fischer-Grunski; Eva K,20,0,20,0
1713497067245,LIGM 5C,A00,507425,Fischer-Grunski; Eva K,20,0,20,0
1713497068270,LIIT 5AS,A00,507427,Carnelos; Chiara,20,0,20,0
1713497069302,LIIT 5BS,A00,507430,Carnelos; Chiara,20,0,20,0
1713497070328,LIIT 5CS,A00,507432,Carnelos; Chiara,20,0,20,0
1713497071354,LISP 5A,A00,507541,Munoz Sanchez; Alicia,14,0,20,6
1713497072380,LISP 5B,A00,507671,Munoz Sanchez; Alicia,12,0,20,8
1713497073409,LISP 5C,A00,507696,Munoz Sanchez; Alicia,11,0,20,9
1713497074437,MAE 197,001,528363,Boechler; Nicholas Sebastia,9998,0,9999,1
1713497075464,MATH 197,001,523477,Kedlaya; Kiran S.,9999,0,9999,0
1713497075464,MATH 197,002,563811,Zhang; Danna,9998,0,9999,1
1713497076492,MCWP 40R,A00,518780,Staff,14,0,20,6
1713497076492,MCWP 40R,B00,518781,Staff,12,0,20,8
1713497076492,MCWP 40R,C00,518783,Staff,9,0,20,11
1713497077516,MCWP 50R,A00,518791,Staff,7,0,20,13
1713497077516,MCWP 50R,B00,518792,Staff,3,0,20,17
1713497077516,MCWP 50R,C00,518793,Staff,7,0,20,13
1713497077516,MCWP 50R,D00,518794,Staff,0,0,20,20
1713497077516,MCWP 50R,E00,518795,Staff,0,0,20,20
1713497077516,MCWP 50R,F00,518796,Staff,11,0,20,9
1713497077516,MCWP 50R,G00,518797,Staff,10,0,20,10
1713497078542,MMW 12R,A01,514034,Herbst; Matthew,4,0,16,12
1713497078542,MMW 12R,A02,514035,Herbst; Matthew,13,0,16,3
1713497079567,MMW 13R,A01,514037,Staff,0,7,16,16
1713497079567,MMW 13R,A02,514039,Staff,0,6,16,16
1713497081618,SIO 295LS,A00,523233,Staff,15,0,30,15
1713497082642,SIO 295S,A00,523232,Staff,15,0,30,15
1713497083667,SOCI 117,A01,494376,Staff,0,2,5,5
1713497084694,WES 237B,A00,494380,Staff,19,0,20,1
1713497086759,AESE 279B,A00,494370,Wade; Jon P,33,0,33,0
1713497087783,AIP 197,001,627712,Vespa; Emanuel Ignacio,9999,0,9999,0
1713497088808,ANAR 135S,A00,494369,Braswell; Geoffrey E.,0,0,0,0
1713497089836,CAT 124RS,A01,519847,Geibel; William,6,0,20,14
1713497090862,CAT 125RS,A01,515971,Geibel; William,6,0,20,14
1713497091891,CLRE 250,A00,511389,Morris; Sheldon,9996,0,9999,3
1713497092918,CLRE 251,A00,507176,Mehta; Ravindra L.,9996,0,9999,3
1713497092918,CLRE 251,B00,511410,Mehta; Ravindra L.,9998,0,9999,1
1713497093946,CLRE 252,A00,507189,Cuomo; Raphael Eduardo,9998,0,9999,1
1713497094975,CLRE 253,A00,507199,Vaida; Florin,9997,0,9999,2
1713497094975,CLRE 253,B00,507202,Vaida; Florin,9999,0,9999,0
1713497096003,CLRE 259,A00,507211,Patel; Hemal,9996,0,9999,3
1713497097031,CLRE 260,A00,507221,Cuomo; Raphael Eduardo,9999,0,9999,0
1713497098060,CLRE 297,001,507242,Cuomo; Raphael Eduardo,9999,0,9999,0
1713497099086,CSE 191,A00,516875,Minnes Kemp; Mor Mia,9999,0,9999,0
1713497100115,CSS 201S,A01,494383,Staff,35,0,35,0
1713497101142,CSS 202S,A01,494387,Staff,35,0,35,0
1713497102167,EAP 100,A00,516065,Staff,9792,0,9999,207
1713497103193,ECE 45,A01,507414,Staff,37,0,60,23
1713497104219,ECE 100,A01,507416,Baghdadchi; Saharnaz,0,0,20,20
1713497104219,ECE 100,A02,507418,Baghdadchi; Saharnaz,19,0,20,1
1713497105248,ECE 111,A01,507420,Staff,27,0,50,23
1713497106273,ECE 197,001,548057,Sievenpiper; Daniel F.,9998,0,9999,1
1713497107302,EDS 115,A00,507243,Choi; Bailey Miyeon,27,0,28,1
1713497108328,EDS 117,A01,494379,Staff,15,0,25,10
1713497109352,EDS 125,A00,507246,Hopkins; Megan Beth,27,0,30,3
1713497110375,EDS 128A,A01,507264,Fargason; Sharon Gayle,26,0,26,0
1713497111401,EDS 128B,A01,507293,Pappas; Elizabeth,30,0,30,0
1713497112429,EDS 139,A00,507294,Fargason; Sharon Gayle,30,0,30,0
1713497112429,EDS 139,B00,507313,Pappas; Elizabeth,30,0,30,0
1713497113455,EDS 201,A00,507315,Staff,18,0,30,12
1713497114485,EDS 203,A01,507317,Halter; Christopher P.,17,0,30,13
1713497115511,EDS 204R,A01,507319,Halter; Christopher P.,0,1,30,30
1713497115511,EDS 204R,B01,507331,Heinzman; Erica M.,22,0,30,8
1713497116535,EDS 206R,A00,507332,Staff,0,2,30,30
1713497116535,EDS 206R,B00,507343,Staff,23,0,30,7
1713497117559,EDS 250,A00,507344,Hemans; Patricia Ann Benitez,27,0,40,13
1713497118585,EDS 281,A00,507345,Daly; Alan J.,18,0,18,0
1713497119609,EDS 284,A00,507350,Daly; Alan J.,16,0,16,0
1713497120634,EDS 286,A00,507359,Fine; Sarah,18,0,18,0
1713497121658,EDS 289C,A01,507361,Daly; Alan J.,18,0,18,0
1713497122683,EDS 290,A00,507366,Hofstetter; Carolyn,15,0,15,0
1713497123713,LIGM 5A,A00,507421,Fischer-Grunski; Eva K,20,0,20,0
1713497124741,LIGM 5B,A00,507423,Fischer-Grunski; Eva K,20,0,20,0
1713497125770,LIGM 5C,A00,507425,Fischer-Grunski; Eva K,20,0,20,0
1713497126796,LIIT 5AS,A00,507427,Carnelos; Chiara,20,0,20,0
1713497127822,LIIT 5BS,A00,507430,Carnelos; Chiara,20,0,20,0
1713497128851,LIIT 5CS,A00,507432,Carnelos; Chiara,20,0,20,0
1713497129877,LISP 5A,A00,507541,Munoz Sanchez; Alicia,14,0,20,6
1713497130902,LISP 5B,A00,507671,Munoz Sanchez; Alicia,12,0,20,8
1713497131932,LISP 5C,A00,507696,Munoz Sanchez; Alicia,11,0,20,9
1713497132961,MAE 197,001,528363,Boechler; Nicholas Sebastia,9998,0,9999,1
1713497133989,MATH 197,001,523477,Kedlaya; Kiran S.,9999,0,9999,0
1713497133989,MATH 197,002,563811,Zhang; Danna,9998,0,9999,1
1713497135018,MCWP 40R,A00,518780,Staff,14,0,20,6
1713497135018,MCWP 40R,B00,518781,Staff,12,0,20,8
1713497135018,MCWP 40R,C00,518783,Staff,9,0,20,11
1713497136045,MCWP 50R,A00,518791,Staff,7,0,20,13
1713497136045,MCWP 50R,B00,518792,Staff,3,0,20,17
1713497136045,MCWP 50R,C00,518793,Staff,7,0,20,13
1713497136045,MCWP 50R,D00,518794,Staff,0,0,20,20
1713497136045,MCWP 50R,E00,518795,Staff,0,0,20,20
1713497136045,MCWP 50R,F00,518796,Staff,11,0,20,9
1713497136045,MCWP 50R,G00,518797,Staff,10,0,20,10
1713497137074,MMW 12R,A01,514034,Herbst; Matthew,4,0,16,12
1713497137074,MMW 12R,A02,514035,Herbst; Matthew,13,0,16,3
1713497138098,MMW 13R,A01,514037,Staff,0,7,16,16
1713497138098,MMW 13R,A02,514039,Staff,0,6,16,16
1713497140154,SIO 295LS,A00,523233,Staff,15,0,30,15
1713497141183,SIO 295S,A00,523232,Staff,15,0,30,15
1713497142212,SOCI 117,A01,494376,Staff,0,2,5,5
1713497143240,WES 237B,A00,494380,Staff,19,0,20,1
1713497145305,AESE 279B,A00,494370,Wade; Jon P,33,0,33,0
1713497146333,AIP 197,001,627712,Vespa; Emanuel Ignacio,9999,0,9999,0
1713497147358,ANAR 135S,A00,494369,Braswell; Geoffrey E.,0,0,0,0
1713497148384,CAT 124RS,A01,519847,Geibel; William,6,0,20,14
1713497149413,CAT 125RS,A01,515971,Geibel; William,6,0,20,14
1713497150442,CLRE 250,A00,511389,Morris; Sheldon,9996,0,9999,3
1713497151470,CLRE 251,A00,507176,Mehta; Ravindra L.,9996,0,9999,3
1713497151470,CLRE 251,B00,511410,Mehta; Ravindra L.,9998,0,9999,1
1713497152552,CLRE 252,A00,507189,Cuomo; Raphael Eduardo,9998,0,9999,1
1713497153577,CLRE 253,A00,507199,Vaida; Florin,9997,0,9999,2
1713497153577,CLRE 253,B00,507202,Vaida; Florin,9999,0,9999,0
1713497154602,CLRE 259,A00,507211,Patel; Hemal,9996,0,9999,3
1713497155627,CLRE 260,A00,507221,Cuomo; Raphael Eduardo,9999,0,9999,0
1713497156656,CLRE 297,001,507242,Cuomo; Raphael Eduardo,9999,0,9999,0
1713497157681,CSE 191,A00,516875,Minnes Kemp; Mor Mia,9999,0,9999,0
1713497158706,CSS 201S,A01,494383,Staff,35,0,35,0
1713497159731,CSS 202S,A01,494387,Staff,35,0,35,0
1713497160756,EAP 100,A00,516065,Staff,9792,0,9999,207
1713497161779,ECE 45,A01,507414,Staff,37,0,60,23
1713497162804,ECE 100,A01,507416,Baghdadchi; Saharnaz,0,0,20,20
1713497162804,ECE 100,A02,507418,Baghdadchi; Saharnaz,19,0,20,1
1713497163832,ECE 111,A01,507420,Staff,27,0,50,23
1713497164860,ECE 197,001,548057,Sievenpiper; Daniel F.,9998,0,9999,1
1713497165885,EDS 115,A00,507243,Choi; Bailey Miyeon,27,0,28,1
1713497166909,EDS 117,A01,494379,Staff,15,0,25,10
1713497167939,EDS 125,A00,507246,Hopkins; Megan Beth,27,0,30,3
1713497168964,EDS 128A,A01,507264,Fargason; Sharon Gayle,26,0,26,0
1713497169991,EDS 128B,A01,507293,Pappas; Elizabeth,30,0,30,0
1713497171016,EDS 139,A00,507294,Fargason; Sharon Gayle,30,0,30,0
1713497171016,EDS 139,B00,507313,Pappas; Elizabeth,30,0,30,0
1713497172041,EDS 201,A00,507315,Staff,18,0,30,12
1713497173069,EDS 203,A01,507317,Halter; Christopher P.,17,0,30,13
1713497174097,EDS 204R,A01,507319,Halter; Christopher P.,0,1,30,30
1713497174097,EDS 204R,B01,507331,Heinzman; Erica M.,22,0,30,8
1713497175125,EDS 206R,A00,507332,Staff,0,2,30,30
1713497175125,EDS 206R,B00,507343,Staff,23,0,30,7
1713497176154,EDS 250,A00,507344,Hemans; Patricia Ann Benitez,27,0,40,13
1713497177181,EDS 281,A00,507345,Daly; Alan J.,18,0,18,0
1713497178206,EDS 284,A00,507350,Daly; Alan J.,16,0,16,0
1713497179235,EDS 286,A00,507359,Fine; Sarah,18,0,18,0
1713497180263,EDS 289C,A01,507361,Daly; Alan J.,18,0,18,0
1713497181292,EDS 290,A00,507366,Hofstetter; Carolyn,15,0,15,0
1713497182317,LIGM 5A,A00,507421,Fischer-Grunski; Eva K,20,0,20,0
1713497183347,LIGM 5B,A00,507423,Fischer-Grunski; Eva K,20,0,20,0
1713497184377,LIGM 5C,A00,507425,Fischer-Grunski; Eva K,20,0,20,0
1713497185406,LIIT 5AS,A00,507427,Carnelos; Chiara,20,0,20,0
1713497186435,LIIT 5BS,A00,507430,Carnelos; Chiara,20,0,20,0
1713497187461,LIIT 5CS,A00,507432,Carnelos; Chiara,20,0,20,0
1713497188486,LISP 5A,A00,507541,Munoz Sanchez; Alicia,14,0,20,6
1713497189516,LISP 5B,A00,507671,Munoz Sanchez; Alicia,12,0,20,8
1713497190546,LISP 5C,A00,507696,Munoz Sanchez; Alicia,11,0,20,9
1713497191574,MAE 197,001,528363,Boechler; Nicholas Sebastia,9998,0,9999,1
1713497192601,MATH 197,001,523477,Kedlaya; Kiran S.,9999,0,9999,0
1713497192601,MATH 197,002,563811,Zhang; Danna,9998,0,9999,1
1713497193627,MCWP 40R,A00,518780,Staff,14,0,20,6
1713497193627,MCWP 40R,B00,518781,Staff,12,0,20,8
1713497193627,MCWP 40R,C00,518783,Staff,9,0,20,11
1713497194651,MCWP 50R,A00,518791,Staff,7,0,20,13
1713497194651,MCWP 50R,B00,518792,Staff,3,0,20,17
1713497194651,MCWP 50R,C00,518793,Staff,7,0,20,13
1713497194651,MCWP 50R,D00,518794,Staff,0,0,20,20
1713497194651,MCWP 50R,E00,518795,Staff,0,0,20,20
1713497194651,MCWP 50R,F00,518796,Staff,11,0,20,9
1713497194651,MCWP 50R,G00,518797,Staff,10,0,20,10
1713497195680,MMW 12R,A01,514034,Herbst; Matthew,4,0,16,12
1713497195680,MMW 12R,A02,514035,Herbst; Matthew,13,0,16,3
1713497196706,MMW 13R,A01,514037,Staff,0,7,16,16
1713497196706,MMW 13R,A02,514039,Staff,0,6,16,16
1713497198757,SIO 295LS,A00,523233,Staff,15,0,30,15
1713497199785,SIO 295S,A00,523232,Staff,15,0,30,15
1713497200811,SOCI 117,A01,494376,Staff,0,2,5,5
1713497201839,WES 237B,A00,494380,Staff,19,0,20,1
1713497203903,AESE 279B,A00,494370,Wade; Jon P,33,0,33,0
1713497204932,AIP 197,001,627712,Vespa; Emanuel Ignacio,9999,0,9999,0
1713497205957,ANAR 135S,A00,494369,Braswell; Geoffrey E.,0,0,0,0
1713497206982,CAT 124RS,A01,519847,Geibel; William,6,0,20,14
1713497208007,CAT 125RS,A01,515971,Geibel; William,6,0,20,14
1713497209032,CLRE 250,A00,511389,Morris; Sheldon,9996,0,9999,3
1713497210058,CLRE 251,A00,507176,Mehta; Ravindra L.,9996,0,9999,3
1713497210058,CLRE 251,B00,511410,Mehta; Ravindra L.,9998,0,9999,1
1713497211087,CLRE 252,A00,507189,Cuomo; Raphael Eduardo,9998,0,9999,1
1713497212116,CLRE 253,A00,507199,Vaida; Florin,9997,0,9999,2
1713497212116,CLRE 253,B00,507202,Vaida; Florin,9999,0,9999,0
1713497213144,CLRE 259,A00,507211,Patel; Hemal,9996,0,9999,3
1713497214169,CLRE 260,A00,507221,Cuomo; Raphael Eduardo,9999,0,9999,0
1713497215194,CLRE 297,001,507242,Cuomo; Raphael Eduardo,9999,0,9999,0
1713497216223,CSE 191,A00,516875,Minnes Kemp; Mor Mia,9999,0,9999,0
1713497217253,CSS 201S,A01,494383,Staff,35,0,35,0
1713497218281,CSS 202S,A01,494387,Staff,35,0,35,0
1713497219309,EAP 100,A00,516065,Staff,9792,0,9999,207
1713497220338,ECE 45,A01,507414,Staff,37,0,60,23
1713497221367,ECE 100,A01,507416,Baghdadchi; Saharnaz,0,0,20,20
1713497221367,ECE 100,A02,507418,Baghdadchi; Saharnaz,19,0,20,1
1713497222391,ECE 111,A01,507420,Staff,27,0,50,23
1713497223419,ECE 197,001,548057,Sievenpiper; Daniel F.,9998,0,9999,1
1713497224442,EDS 115,A00,507243,Choi; Bailey Miyeon,27,0,28,1
1713497225467,EDS 117,A01,494379,Staff,15,0,25,10
1713497226493,EDS 125,A00,507246,Hopkins; Megan Beth,27,0,30,3
1713497227519,EDS 128A,A01,507264,Fargason; Sharon Gayle,26,0,26,0
1713497228545,EDS 128B,A01,507293,Pappas; Elizabeth,30,0,30,0
1713497229571,EDS 139,A00,507294,Fargason; Sharon Gayle,30,0,30,0
1713497229571,EDS 139,B00,507313,Pappas; Elizabeth,30,0,30,0
1713497230596,EDS 201,A00,507315,Staff,18,0,30,12
1713497231622,EDS 203,A01,507317,Halter; Christopher P.,17,0,30,13
1713497232651,EDS 204R,A01,507319,Halter; Christopher P.,0,1,30,30
1713497232651,EDS 204R,B01,507331,Heinzman; Erica M.,22,0,30,8
1713497233676,EDS 206R,A00,507332,Staff,0,2,30,30
1713497233676,EDS 206R,B00,507343,Staff,23,0,30,7
1713497234701,EDS 250,A00,507344,Hemans; Patricia Ann Benitez,27,0,40,13
1713497235726,EDS 281,A00,507345,Daly; Alan J.,18,0,18,0
1713497236752,EDS 284,A00,507350,Daly; Alan J.,16,0,16,0
1713497237782,EDS 286,A00,507359,Fine; Sarah,18,0,18,0
1713497238808,EDS 289C,A01,507361,Daly; Alan J.,18,0,18,0
1713497239837,EDS 290,A00,507366,Hofstetter; Carolyn,15,0,15,0
1713497240867,LIGM 5A,A00,507421,Fischer-Grunski; Eva K,20,0,20,0
1713497241896,LIGM 5B,A00,507423,Fischer-Grunski; Eva K,20,0,20,0
1713497242921,LIGM 5C,A00,507425,Fischer-Grunski; Eva K,20,0,20,0
1713497243951,LIIT 5AS,A00,507427,Carnelos; Chiara,20,0,20,0
1713497244976,LIIT 5BS,A00,507430,Carnelos; Chiara,20,0,20,0
1713497246006,LIIT 5CS,A00,507432,Carnelos; Chiara,20,0,20,0
1713497247038,LISP 5A,A00,507541,Munoz Sanchez; Alicia,14,0,20,6
1713497248062,LISP 5B,A00,507671,Munoz Sanchez; Alicia,12,0,20,8
1713497249087,LISP 5C,A00,507696,Munoz Sanchez; Alicia,11,0,20,9
1713497250114,MAE 197,001,528363,Boechler; Nicholas Sebastia,9998,0,9999,1
1713497251145,MATH 197,001,523477,Kedlaya; Kiran S.,9999,0,9999,0
1713497251145,MATH 197,002,563811,Zhang; Danna,9998,0,9999,1
1713497252171,MCWP 40R,A00,518780,Staff,14,0,20,6
1713497252171,MCWP 40R,B00,518781,Staff,12,0,20,8
1713497252171,MCWP 40R,C00,518783,Staff,9,0,20,11
1713497253201,MCWP 50R,A00,518791,Staff,7,0,20,13
1713497253201,MCWP 50R,B00,518792,Staff,3,0,20,17
1713497253201,MCWP 50R,C00,518793,Staff,7,0,20,13
1713497253201,MCWP 50R,D00,518794,Staff,0,0,20,20
1713497253201,MCWP 50R,E00,518795,Staff,0,0,20,20
1713497253201,MCWP 50R,F00,518796,Staff,11,0,20,9
1713497253201,MCWP 50R,G00,518797,Staff,10,0,20,10
1713497254231,MMW 12R,A01,514034,Herbst; Matthew,4,0,16,12
1713497254231,MMW 12R,A02,514035,Herbst; Matthew,13,0,16,3
1713497255256,MMW 13R,A01,514037,Staff,0,7,16,16
1713497255256,MMW 13R,A02,514039,Staff,0,6,16,16
1713497257368,SIO 295LS,A00,523233,Staff,15,0,30,15
1713497258394,SIO 295S,A00,523232,Staff,15,0,30,15
1713497259422,SOCI 117,A01,494376,Staff,0,2,5,5
1713497260449,WES 237B,A00,494380,Staff,19,0,20,1
1713497262516,AESE 279B,A00,494370,Wade; Jon P,33,0,33,0
1713497263540,AIP 197,001,627712,Vespa; Emanuel Ignacio,9999,0,9999,0
1713497264566,ANAR 135S,A00,494369,Braswell; Geoffrey E.,0,0,0,0
1713497265592,CAT 124RS,A01,519847,Geibel; William,6,0,20,14
1713497266619,CAT 125RS,A01,515971,Geibel; William,6,0,20,14
1713497267646,CLRE 250,A00,511389,Morris; Sheldon,9996,0,9999,3
1713497268673,CLRE 251,A00,507176,Mehta; Ravindra L.,9996,0,9999,3
1713497268673,CLRE 251,B00,511410,Mehta; Ravindra L.,9998,0,9999,1
1713497269701,CLRE 252,A00,507189,Cuomo; Raphael Eduardo,9998,0,9999,1
1713497270727,CLRE 253,A00,507199,Vaida; Florin,9997,0,9999,2
1713497270727,CLRE 253,B00,507202,Vaida; Florin,9999,0,9999,0
1713497271753,CLRE 259,A00,507211,Patel; Hemal,9996,0,9999,3
1713497272781,CLRE 260,A00,507221,Cuomo; Raphael Eduardo,9999,0,9999,0
1713497273805,CLRE 297,001,507242,Cuomo; Raphael Eduardo,9999,0,9999,0
1713497274829,CSE 191,A00,516875,Minnes Kemp; Mor Mia,9999,0,9999,0
1713497275854,CSS 201S,A01,494383,Staff,35,0,35,0
1713497276879,CSS 202S,A01,494387,Staff,35,0,35,0
1713497277907,EAP 100,A00,516065,Staff,9792,0,9999,207
1713497278933,ECE 45,A01,507414,Staff,37,0,60,23
1713497279959,ECE 100,A01,507416,Baghdadchi; Saharnaz,0,0,20,20
1713497279959,ECE 100,A02,507418,Baghdadchi; Saharnaz,19,0,20,1
1713497280982,ECE 111,A01,507420,Staff,27,0,50,23
1713497282008,ECE 197,001,548057,Sievenpiper; Daniel F.,9998,0,9999,1
1713497283033,EDS 115,A00,507243,Choi; Bailey Miyeon,27,0,28,1
1713497284059,EDS 117,A01,494379,Staff,15,0,25,10
1713497285084,EDS 125,A00,507246,Hopkins; Megan Beth,27,0,30,3
1713497286110,EDS 128A,A01,507264,Fargason; Sharon Gayle,26,0,26,0
1713497287136,EDS 128B,A01,507293,Pappas; Elizabeth,30,0,30,0
1713497288164,EDS 139,A00,507294,Fargason; Sharon Gayle,30,0,30,0
1713497288164,EDS 139,B00,507313,Pappas; Elizabeth,30,0,30,0
1713497289190,EDS 201,A00,507315,Staff,18,0,30,12
1713497290218,EDS 203,A01,507317,Halter; Christopher P.,17,0,30,13
1713497291246,EDS 204R,A01,507319,Halter; Christopher P.,0,1,30,30
1713497291246,EDS 204R,B01,507331,Heinzman; Erica M.,22,0,30,8
1713497292274,EDS 206R,A00,507332,Staff,0,2,30,30
1713497292274,EDS 206R,B00,507343,Staff,23,0,30,7
1713497293302,EDS 250,A00,507344,Hemans; Patricia Ann Benitez,27,0,40,13
1713497294330,EDS 281,A00,507345,Daly; Alan J.,18,0,18,0
1713497295354,EDS 284,A00,507350,Daly; Alan J.,16,0,16,0
1713497296380,EDS 286,A00,507359,Fine; Sarah,18,0,18,0
1713497297405,EDS 289C,A01,507361,Daly; Alan J.,18,0,18,0
1713497298433,EDS 290,A00,507366,Hofstetter; Carolyn,15,0,15,0
1713497299460,LIGM 5A,A00,507421,Fischer-Grunski; Eva K,20,0,20,0
1713497300485,LIGM 5B,A00,507423,Fischer-Grunski; Eva K,20,0,20,0
1713497301512,LIGM 5C,A00,507425,Fischer-Grunski; Eva K,20,0,20,0
1713497302538,LIIT 5AS,A00,507427,Carnelos; Chiara,20,0,20,0
1713497303564,LIIT 5BS,A00,507430,Carnelos; Chiara,20,0,20,0
1713497304588,LIIT 5CS,A00,507432,Carnelos; Chiara,20,0,20,0
1713497305613,LISP 5A,A00,507541,Munoz Sanchez; Alicia,14,0,20,6
1713497306641,LISP 5B,A00,507671,Munoz Sanchez; Alicia,12,0,20,8
1713497307667,LISP 5C,A00,507696,Munoz Sanchez; Alicia,11,0,20,9
1713497308692,MAE 197,001,528363,Boechler; Nicholas Sebastia,9998,0,9999,1
1713497309716,MATH 197,001,523477,Kedlaya; Kiran S.,9999,0,9999,0
1713497309716,MATH 197,002,563811,Zhang; Danna,9998,0,9999,1
1713497310742,MCWP 40R,A00,518780,Staff,14,0,20,6
1713497310742,MCWP 40R,B00,518781,Staff,12,0,20,8
1713497310742,MCWP 40R,C00,518783,Staff,9,0,20,11
1713497311772,MCWP 50R,A00,518791,Staff,7,0,20,13
1713497311772,MCWP 50R,B00,518792,Staff,3,0,20,17
1713497311772,MCWP 50R,C00,518793,Staff,7,0,20,13
1713497311772,MCWP 50R,D00,518794,Staff,0,0,20,20
1713497311772,MCWP 50R,E00,518795,Staff,0,0,20,20
1713497311772,MCWP 50R,F00,518796,Staff,11,0,20,9
1713497311772,MCWP 50R,G00,518797,Staff,10,0,20,10
1713497312802,MMW 12R,A01,514034,Herbst; Matthew,4,0,16,12
1713497312802,MMW 12R,A02,514035,Herbst; Matthew,13,0,16,3
1713497313828,MMW 13R,A01,514037,Staff,0,7,16,16
1713497313828,MMW 13R,A02,514039,Staff,0,6,16,16
1713497315881,SIO 295LS,A00,523233,Staff,15,0,30,15
1713497316911,SIO 295S,A00,523232,Staff,15,0,30,15
1713497317938,SOCI 117,A01,494376,Staff,0,2,5,5
1713497318966,WES 237B,A00,494380,Staff,19,0,20,1
1713497321024,AESE 279B,A00,494370,Wade; Jon P,33,0,33,0
1713497322054,AIP 197,001,627712,Vespa; Emanuel Ignacio,9999,0,9999,0
1713497323080,ANAR 135S,A00,494369,Braswell; Geoffrey E.,0,0,0,0
1713497324104,CAT 124RS,A01,519847,Geibel; William,6,0,20,14
1713497325133,CAT 125RS,A01,515971,Geibel; William,6,0,20,14
1713497326158,CLRE 250,A00,511389,Morris; Sheldon,9996,0,9999,3
1713497327184,CLRE 251,A00,507176,Mehta; Ravindra L.,9996,0,9999,3
1713497327184,CLRE 251,B00,511410,Mehta; Ravindra L.,9998,0,9999,1
1713497328210,CLRE 252,A00,507189,Cuomo; Raphael Eduardo,9998,0,9999,1
1713497329239,CLRE 253,A00,507199,Vaida; Florin,9997,0,9999,2
1713497329239,CLRE 253,B00,507202,Vaida; Florin,9999,0,9999,0
1713497330266,CLRE 259,A00,507211,Patel; Hemal,9996,0,9999,3
1713497331295,CLRE 260,A00,507221,Cuomo; Raphael Eduardo,9999,0,9999,0
1713497332322,CLRE 297,001,507242,Cuomo; Raphael Eduardo,9999,0,9999,0
1713497333348,CSE 191,A00,516875,Minnes Kemp; Mor Mia,9999,0,9999,0
1713497334379,CSS 201S,A01,494383,Staff,35,0,35,0
1713497335406,CSS 202S,A01,494387,Staff,35,0,35,0
1713497336431,EAP 100,A00,516065,Staff,9792,0,9999,207
1713497337457,ECE 45,A01,507414,Staff,37,0,60,23
1713497338483,ECE 100,A01,507416,Baghdadchi; Saharnaz,0,0,20,20
1713497338483,ECE 100,A02,507418,Baghdadchi; Saharnaz,19,0,20,1
1713497339510,ECE 111,A01,507420,Staff,27,0,50,23
1713497340541,ECE 197,001,548057,Sievenpiper; Daniel F.,9998,0,9999,1
1713497341568,EDS 115,A00,507243,Choi; Bailey Miyeon,27,0,28,1
1713497342594,EDS 117,A01,494379,Staff,15,0,25,10
1713497343620,EDS 125,A00,507246,Hopkins; Megan Beth,27,0,30,3
1713497344649,EDS 128A,A01,507264,Fargason; Sharon Gayle,26,0,26,0
1713497345673,EDS 128B,A01,507293,Pappas; Elizabeth,30,0,30,0
1713497346700,EDS 139,A00,507294,Fargason; Sharon Gayle,30,0,30,0
1713497346700,EDS 139,B00,507313,Pappas; Elizabeth,30,0,30,0
1713497347725,EDS 201,A00,507315,Staff,18,0,30,12
1713497348752,EDS 203,A01,507317,Halter; Christopher P.,17,0,30,13
1713497349779,EDS 204R,A01,507319,Halter; Christopher P.,0,1,30,30
1713497349779,EDS 204R,B01,507331,Heinzman; Erica M.,22,0,30,8
1713497350805,EDS 206R,A00,507332,Staff,0,2,30,30
1713497350805,EDS 206R,B00,507343,Staff,23,0,30,7
1713497351833,EDS 250,A00,507344,Hemans; Patricia Ann Benitez,27,0,40,13
1713497352861,EDS 281,A00,507345,Daly; Alan J.,18,0,18,0
1713497353895,EDS 284,A00,507350,Daly; Alan J.,16,0,16,0
1713497354926,EDS 286,A00,507359,Fine; Sarah,18,0,18,0
1713497355952,EDS 289C,A01,507361,Daly; Alan J.,18,0,18,0
1713497356983,EDS 290,A00,507366,Hofstetter; Carolyn,15,0,15,0
1713497358009,LIGM 5A,A00,507421,Fischer-Grunski; Eva K,20,0,20,0
1713497359037,LIGM 5B,A00,507423,Fischer-Grunski; Eva K,20,0,20,0
1713497360117,LIGM 5C,A00,507425,Fischer-Grunski; Eva K,20,0,20,0
1713497361143,LIIT 5AS,A00,507427,Carnelos; Chiara,20,0,20,0
1713497362168,LIIT 5BS,A00,507430,Carnelos; Chiara,20,0,20,0
1713497363194,LIIT 5CS,A00,507432,Carnelos; Chiara,20,0,20,0
1713497364223,LISP 5A,A00,507541,Munoz Sanchez; Alicia,14,0,20,6
1713497365252,LISP 5B,A00,507671,Munoz Sanchez; Alicia,12,0,20,8
1713497366279,LISP 5C,A00,507696,Munoz Sanchez; Alicia,11,0,20,9
1713497367305,MAE 197,001,528363,Boechler; Nicholas Sebastia,9998,0,9999,1
1713497368330,MATH 197,001,523477,Kedlaya; Kiran S.,9999,0,9999,0
1713497368330,MATH 197,002,563811,Zhang; Danna,9998,0,9999,1
1713497369356,MCWP 40R,A00,518780,Staff,14,0,20,6
1713497369356,MCWP 40R,B00,518781,Staff,12,0,20,8
1713497369356,MCWP 40R,C00,518783,Staff,9,0,20,11
1713497370382,MCWP 50R,A00,518791,Staff,7,0,20,13
1713497370382,MCWP 50R,B00,518792,Staff,3,0,20,17
1713497370382,MCWP 50R,C00,518793,Staff,7,0,20,13
1713497370382,MCWP 50R,D00,518794,Staff,0,0,20,20
1713497370382,MCWP 50R,E00,518795,Staff,0,0,20,20
1713497370382,MCWP 50R,F00,518796,Staff,11,0,20,9
1713497370382,MCWP 50R,G00,518797,Staff,10,0,20,10
1713497371406,MMW 12R,A01,514034,Herbst; Matthew,4,0,16,12
1713497371406,MMW 12R,A02,514035,Herbst; Matthew,13,0,16,3
1713497372432,MMW 13R,A01,514037,Staff,0,7,16,16
1713497372432,MMW 13R,A02,514039,Staff,0,6,16,16
1713497374479,SIO 295LS,A00,523233,Staff,15,0,30,15
1713497375503,SIO 295S,A00,523232,Staff,15,0,30,15
1713497376528,SOCI 117,A01,494376,Staff,0,2,5,5
1713497377552,WES 237B,A00,494380,Staff,19,0,20,1
1713497379624,AESE 279B,A00,494370,Wade; Jon P,33,0,33,0
1713497380649,AIP 197,001,627712,Vespa; Emanuel Ignacio,9999,0,9999,0
1713497381674,ANAR 135S,A00,494369,Braswell; Geoffrey E.,0,0,0,0
1713497382699,CAT 124RS,A01,519847,Geibel; William,6,0,20,14
1713497383723,CAT 125RS,A01,515971,Geibel; William,6,0,20,14
1713497384748,CLRE 250,A00,511389,Morris; Sheldon,9996,0,9999,3
1713497385777,CLRE 251,A00,507176,Mehta; Ravindra L.,9996,0,9999,3
1713497385777,CLRE 251,B00,511410,Mehta; Ravindra L.,9998,0,9999,1
1713497386802,CLRE 252,A00,507189,Cuomo; Raphael Eduardo,9998,0,9999,1
1713497387829,CLRE 253,A00,507199,Vaida; Florin,9997,0,9999,2
1713497387829,CLRE 253,B00,507202,Vaida; Florin,9999,0,9999,0
1713497388857,CLRE 259,A00,507211,Patel; Hemal,9996,0,9999,3
1713497389881,CLRE 260,A00,507221,Cuomo; Raphael Eduardo,9999,0,9999,0
1713497390906,CLRE 297,001,507242,Cuomo; Raphael Eduardo,9999,0,9999,0
1713497391932,CSE 191,A00,516875,Minnes Kemp; Mor Mia,9999,0,9999,0
1713497392960,CSS 201S,A01,494383,Staff,35,0,35,0
1713497393991,CSS 202S,A01,494387,Staff,35,0,35,0
1713497395018,EAP 100,A00,516065,Staff,9792,0,9999,207
1713497396046,ECE 45,A01,507414,Staff,37,0,60,23
1713497397072,ECE 100,A01,507416,Baghdadchi; Saharnaz,0,0,20,20
1713497397072,ECE 100,A02,507418,Baghdadchi; Saharnaz,19,0,20,1
1713497398101,ECE 111,A01,507420,Staff,27,0,50,23
1713497399130,ECE 197,001,548057,Sievenpiper; Daniel F.,9998,0,9999,1
1713497400162,EDS 115,A00,507243,Choi; Bailey Miyeon,27,0,28,1
1713497401188,EDS 117,A01,494379,Staff,15,0,25,10
1713497402214,EDS 125,A00,507246,Hopkins; Megan Beth,27,0,30,3
1713497403240,EDS 128A,A01,507264,Fargason; Sharon Gayle,26,0,26,0
1713497404269,EDS 128B,A01,507293,Pappas; Elizabeth,30,0,30,0
1713497405292,EDS 139,A00,507294,Fargason; Sharon Gayle,30,0,30,0
1713497405292,EDS 139,B00,507313,Pappas; Elizabeth,30,0,30,0
1713497406317,EDS 201,A00,507315,Staff,18,0,30,12
1713497407341,EDS 203,A01,507317,Halter; Christopher P.,17,0,30,13
1713497408367,EDS 204R,A01,507319,Halter; Christopher P.,0,1,30,30
1713497408367,EDS 204R,B01,507331,Heinzman; Erica M.,22,0,30,8
1713497409396,EDS 206R,A00,507332,Staff,0,2,30,30
1713497409396,EDS 206R,B00,507343,Staff,23,0,30,7
1713497410420,EDS 250,A00,507344,Hemans; Patricia Ann Benitez,27,0,40,13
1713497411447,EDS 281,A00,507345,Daly; Alan J.,18,0,18,0
1713497412476,EDS 284,A00,507350,Daly; Alan J.,16,0,16,0
1713497413504,EDS 286,A00,507359,Fine; Sarah,18,0,18,0
1713497414528,EDS 289C,A01,507361,Daly; Alan J.,18,0,18,0
1713497415552,EDS 290,A00,507366,Hofstetter; Carolyn,15,0,15,0
1713497416581,LIGM 5A,A00,507421,Fischer-Grunski; Eva K,20,0,20,0
1713497417606,LIGM 5B,A00,507423,Fischer-Grunski; Eva K,20,0,20,0
1713497418634,LIGM 5C,A00,507425,Fischer-Grunski; Eva K,20,0,20,0
1713497419662,LIIT 5AS,A00,507427,Carnelos; Chiara,20,0,20,0
1713497420688,LIIT 5BS,A00,507430,Carnelos; Chiara,20,0,20,0
1713497421717,LIIT 5CS,A00,507432,Carnelos; Chiara,20,0,20,0
1713497422749,LISP 5A,A00,507541,Munoz Sanchez; Alicia,14,0,20,6
1713497423777,LISP 5B,A00,507671,Munoz Sanchez; Alicia,12,0,20,8
1713497424803,LISP 5C,A00,507696,Munoz Sanchez; Alicia,11,0,20,9
1713497425832,MAE 197,001,528363,Boechler; Nicholas Sebastia,9998,0,9999,1
1713497426860,MATH 197,001,523477,Kedlaya; Kiran S.,9999,0,9999,0
1713497426860,MATH 197,002,563811,Zhang; Danna,9998,0,9999,1
1713497427885,MCWP 40R,A00,518780,Staff,14,0,20,6
1713497427885,MCWP 40R,B00,518781,Staff,12,0,20,8
1713497427885,MCWP 40R,C00,518783,Staff,9,0,20,11
1713497428913,MCWP 50R,A00,518791,Staff,7,0,20,13
1713497428913,MCWP 50R,B00,518792,Staff,3,0,20,17
1713497428913,MCWP 50R,C00,518793,Staff,7,0,20,13
1713497428913,MCWP 50R,D00,518794,Staff,0,0,20,20
1713497428913,MCWP 50R,E00,518795,Staff,0,0,20,20
1713497428913,MCWP 50R,F00,518796,Staff,11,0,20,9
1713497428913,MCWP 50R,G00,518797,Staff,10,0,20,10
1713497429940,MMW 12R,A01,514034,Herbst; Matthew,4,0,16,12
1713497429940,MMW 12R,A02,514035,Herbst; Matthew,13,0,16,3
1713497430968,MMW 13R,A01,514037,Staff,0,7,16,16
1713497430968,MMW 13R,A02,514039,Staff,0,6,16,16
1713497433023,SIO 295LS,A00,523233,Staff,15,0,30,15
1713497434049,SIO 295S,A00,523232,Staff,15,0,30,15
1713497435074,SOCI 117,A01,494376,Staff,0,2,5,5
1713497436098,WES 237B,A00,494380,Staff,19,0,20,1
1713497438161,AESE 279B,A00,494370,Wade; Jon P,33,0,33,0
1713497439186,AIP 197,001,627712,Vespa; Emanuel Ignacio,9999,0,9999,0
1713497440211,ANAR 135S,A00,494369,Braswell; Geoffrey E.,0,0,0,0
1713497441240,CAT 124RS,A01,519847,Geibel; William,6,0,20,14
1713497442269,CAT 125RS,A01,515971,Geibel; William,6,0,20,14
1713497443295,CLRE 250,A00,511389,Morris; Sheldon,9996,0,9999,3
1713497444321,CLRE 251,A00,507176,Mehta; Ravindra L.,9996,0,9999,3
1713497444321,CLRE 251,B00,511410,Mehta; Ravindra L.,9998,0,9999,1
1713497445350,CLRE 252,A00,507189,Cuomo; Raphael Eduardo,9998,0,9999,1
1713497446376,CLRE 253,A00,507199,Vaida; Florin,9997,0,9999,2
1713497446376,CLRE 253,B00,507202,Vaida; Florin,9999,0,9999,0
1713497447402,CLRE 259,A00,507211,Patel; Hemal,9996,0,9999,3
1713497448428,CLRE 260,A00,507221,Cuomo; Raphael Eduardo,9999,0,9999,0
1713497449454,CLRE 297,001,507242,Cuomo; Raphael Eduardo,9999,0,9999,0
1713497450485,CSE 191,A00,516875,Minnes Kemp; Mor Mia,9999,0,9999,0
1713497451512,CSS 201S,A01,494383,Staff,35,0,35,0
1713497452539,CSS 202S,A01,494387,Staff,35,0,35,0
1713497453564,EAP 100,A00,516065,Staff,9792,0,9999,207
1713497454590,ECE 45,A01,507414,Staff,37,0,60,23
1713497455619,ECE 100,A01,507416,Baghdadchi; Saharnaz,0,0,20,20
1713497455619,ECE 100,A02,507418,Baghdadchi; Saharnaz,19,0,20,1
1713497456645,ECE 111,A01,507420,Staff,27,0,50,23
1713497457676,ECE 197,001,548057,Sievenpiper; Daniel F.,9998,0,9999,1
1713497458702,EDS 115,A00,507243,Choi; Bailey Miyeon,27,0,28,1
1713497459728,EDS 117,A01,494379,Staff,15,0,25,10
1713497460758,EDS 125,A00,507246,Hopkins; Megan Beth,27,0,30,3
1713497461784,EDS 128A,A01,507264,Fargason; Sharon Gayle,26,0,26,0
1713497462813,EDS 128B,A01,507293,Pappas; Elizabeth,30,0,30,0
1713497463896,EDS 139,A00,507294,Fargason; Sharon Gayle,30,0,30,0
1713497463896,EDS 139,B00,507313,Pappas; Elizabeth,30,0,30,0
1713497464923,EDS 201,A00,507315,Staff,18,0,30,12
1713497465950,EDS 203,A01,507317,Halter; Christopher P.,17,0,30,13
1713497466989,EDS 204R,A01,507319,Halter; Christopher P.,0,1,30,30
1713497466989,EDS 204R,B01,507331,Heinzman; Erica M.,22,0,30,8
1713497468021,EDS 206R,A00,507332,Staff,0,2,30,30
1713497468021,EDS 206R,B00,507343,Staff,23,0,30,7
1713497469046,EDS 250,A00,507344,Hemans; Patricia Ann Benitez,27,0,40,13
1713497470073,EDS 281,A00,507345,Daly; Alan J.,18,0,18,0
1713497471099,EDS 284,A00,507350,Daly; Alan J.,16,0,16,0
1713497472124,EDS 286,A00,507359,Fine; Sarah,18,0,18,0
1713497473152,EDS 289C,A01,507361,Daly; Alan J.,18,0,18,0
1713497474177,EDS 290,A00,507366,Hofstetter; Carolyn,15,0,15,0
1713497475202,LIGM 5A,A00,507421,Fischer-Grunski; Eva K,20,0,20,0
1713497476231,LIGM 5B,A00,507423,Fischer-Grunski; Eva K,20,0,20,0
1713497477257,LIGM 5C,A00,507425,Fischer-Grunski; Eva K,20,0,20,0
1713497478286,LIIT 5AS,A00,507427,Carnelos; Chiara,20,0,20,0
1713497479312,LIIT 5BS,A00,507430,Carnelos; Chiara,20,0,20,0
1713497480341,LIIT 5CS,A00,507432,Carnelos; Chiara,20,0,20,0
1713497481366,LISP 5A,A00,507541,Munoz Sanchez; Alicia,14,0,20,6
1713497482396,LISP 5B,A00,507671,Munoz Sanchez; Alicia,12,0,20,8
1713497483422,LISP 5C,A00,507696,Munoz Sanchez; Alicia,11,0,20,9
1713497484450,MAE 197,001,528363,Boechler; Nicholas Sebastia,9998,0,9999,1
1713497485476,MATH 197,001,523477,Kedlaya; Kiran S.,9999,0,9999,0
1713497485476,MATH 197,002,563811,Zhang; Danna,9998,0,9999,1
1713497486504,MCWP 40R,A00,518780,Staff,14,0,20,6
1713497486504,MCWP 40R,B00,518781,Staff,12,0,20,8
1713497486504,MCWP 40R,C00,518783,Staff,9,0,20,11
1713497487530,MCWP 50R,A00,518791,Staff,7,0,20,13
1713497487530,MCWP 50R,B00,518792,Staff,3,0,20,17
1713497487530,MCWP 50R,C00,518793,Staff,7,0,20,13
1713497487530,MCWP 50R,D00,518794,Staff,0,0,20,20
1713497487530,MCWP 50R,E00,518795,Staff,0,0,20,20
1713497487530,MCWP 50R,F00,518796,Staff,11,0,20,9
1713497487530,MCWP 50R,G00,518797,Staff,10,0,20,10
1713497488555,MMW 12R,A01,514034,Herbst; Matthew,4,0,16,12
1713497488555,MMW 12R,A02,514035,Herbst; Matthew,13,0,16,3
1713497489580,MMW 13R,A01,514037,Staff,0,7,16,16
1713497489580,MMW 13R,A02,514039,Staff,0,6,16,16
1713497491632,SIO 295LS,A00,523233,Staff,15,0,30,15
1713497492658,SIO 295S,A00,523232,Staff,15,0,30,15
1713497493684,SOCI 117,A01,494376,Staff,0,2,5,5
1713497494708,WES 237B,A00,494380,Staff,19,0,20,1
1713497496780,AESE 279B,A00,494370,Wade; Jon P,33,0,33,0
1713497497808,AIP 197,001,627712,Vespa; Emanuel Ignacio,9999,0,9999,0
1713497498836,ANAR 135S,A00,494369,Braswell; Geoffrey E.,0,0,0,0
1713497499866,CAT 124RS,A01,519847,Geibel; William,6,0,20,14
1713497500892,CAT 125RS,A01,515971,Geibel; William,6,0,20,14
1713497501916,CLRE 250,A00,511389,Morris; Sheldon,9996,0,9999,3
1713497502946,CLRE 251,A00,507176,Mehta; Ravindra L.,9996,0,9999,3
1713497502946,CLRE 251,B00,511410,Mehta; Ravindra L.,9998,0,9999,1
1713497503972,CLRE 252,A00,507189,Cuomo; Raphael Eduardo,9998,0,9999,1
1713497504997,CLRE 253,A00,507199,Vaida; Florin,9997,0,9999,2
1713497504997,CLRE 253,B00,507202,Vaida; Florin,9999,0,9999,0
1713497506024,CLRE 259,A00,507211,Patel; Hemal,9996,0,9999,3
1713497507051,CLRE 260,A00,507221,Cuomo; Raphael Eduardo,9999,0,9999,0
1713497508076,CLRE 297,001,507242,Cuomo; Raphael Eduardo,9999,0,9999,0
1713497509103,CSE 191,A00,516875,Minnes Kemp; Mor Mia,9999,0,9999,0
1713497510134,CSS 201S,A01,494383,Staff,35,0,35,0
1713497511164,CSS 202S,A01,494387,Staff,35,0,35,0
1713497512191,EAP 100,A00,516065,Staff,9792,0,9999,207
1713497513217,ECE 45,A01,507414,Staff,37,0,60,23
1713497514246,ECE 100,A01,507416,Baghdadchi; Saharnaz,0,0,20,20
1713497514246,ECE 100,A02,507418,Baghdadchi; Saharnaz,19,0,20,1
1713497515272,ECE 111,A01,507420,Staff,27,0,50,23
1713497516298,ECE 197,001,548057,Sievenpiper; Daniel F.,9998,0,9999,1
1713497517326,EDS 115,A00,507243,Choi; Bailey Miyeon,27,0,28,1
1713497518352,EDS 117,A01,494379,Staff,15,0,25,10
1713497519377,EDS 125,A00,507246,Hopkins; Megan Beth,27,0,30,3
1713497520407,EDS 128A,A01,507264,Fargason; Sharon Gayle,26,0,26,0
1713497521437,EDS 128B,A01,507293,Pappas; Elizabeth,30,0,30,0
1713497522463,EDS 139,A00,507294,Fargason; Sharon Gayle,30,0,30,0
1713497522463,EDS 139,B00,507313,Pappas; Elizabeth,30,0,30,0
1713497523490,EDS 201,A00,507315,Staff,18,0,30,12
1713497524518,EDS 203,A01,507317,Halter; Christopher P.,17,0,30,13
1713497525548,EDS 204R,A01,507319,Halter; Christopher P.,0,1,30,30
1713497525548,EDS 204R,B01,507331,Heinzman; Erica M.,22,0,30,8
1713497526588,EDS 206R,A00,507332,Staff,0,2,30,30
1713497526588,EDS 206R,B00,507343,Staff,23,0,30,7
1713497527615,EDS 250,A00,507344,Hemans; Patricia Ann Benitez,27,0,40,13
1713497528640,EDS 281,A00,507345,Daly; Alan J.,18,0,18,0
1713497529668,EDS 284,A00,507350,Daly; Alan J.,16,0,16,0
1713497530696,EDS 286,A00,507359,Fine; Sarah,18,0,18,0
1713497531722,EDS 289C,A01,507361,Daly; Alan J.,18,0,18,0
1713497532750,EDS 290,A00,507366,Hofstetter; Carolyn,15,0,15,0
1713497533776,LIGM 5A,A00,507421,Fischer-Grunski; Eva K,20,0,20,0
1713497534801,LIGM 5B,A00,507423,Fischer-Grunski; Eva K,20,0,20,0
1713497535827,LIGM 5C,A00,507425,Fischer-Grunski; Eva K,20,0,20,0
1713497536853,LIIT 5AS,A00,507427,Carnelos; Chiara,20,0,20,0
1713497537882,LIIT 5BS,A00,507430,Carnelos; Chiara,20,0,20,0
1713497538911,LIIT 5CS,A00,507432,Carnelos; Chiara,20,0,20,0
1713497539942,LISP 5A,A00,507541,Munoz Sanchez; Alicia,14,0,20,6
1713497540971,LISP 5B,A00,507671,Munoz Sanchez; Alicia,12,0,20,8
1713497541996,LISP 5C,A00,507696,Munoz Sanchez; Alicia,11,0,20,9
1713497543024,MAE 197,001,528363,Boechler; Nicholas Sebastia,9998,0,9999,1
1713497544049,MATH 197,001,523477,Kedlaya; Kiran S.,9999,0,9999,0
1713497544049,MATH 197,002,563811,Zhang; Danna,9998,0,9999,1
1713497545075,MCWP 40R,A00,518780,Staff,14,0,20,6
1713497545075,MCWP 40R,B00,518781,Staff,12,0,20,8
1713497545075,MCWP 40R,C00,518783,Staff,9,0,20,11
1713497546100,MCWP 50R,A00,518791,Staff,7,0,20,13
1713497546100,MCWP 50R,B00,518792,Staff,3,0,20,17
1713497546100,MCWP 50R,C00,518793,Staff,7,0,20,13
1713497546100,MCWP 50R,D00,518794,Staff,0,0,20,20
1713497546100,MCWP 50R,E00,518795,Staff,0,0,20,20
1713497546100,MCWP 50R,F00,518796,Staff,11,0,20,9
1713497546100,MCWP 50R,G00,518797,Staff,10,0,20,10
1713497547126,MMW 12R,A01,514034,Herbst; Matthew,4,0,16,12
1713497547126,MMW 12R,A02,514035,Herbst; Matthew,13,0,16,3
1713497548156,MMW 13R,A01,514037,Staff,0,7,16,16
1713497548156,MMW 13R,A02,514039,Staff,0,6,16,16
1713497550207,SIO 295LS,A00,523233,Staff,15,0,30,15
1713497551233,SIO 295S,A00,523232,Staff,15,0,30,15
1713497552260,SOCI 117,A01,494376,Staff,0,2,5,5
1713497553288,WES 237B,A00,494380,Staff,19,0,20,1
1713497555353,AESE 279B,A00,494370,Wade; Jon P,33,0,33,0
1713497556383,AIP 197,001,627712,Vespa; Emanuel Ignacio,9999,0,9999,0
1713497557408,ANAR 135S,A00,494369,Braswell; Geoffrey E.,0,0,0,0
1713497558435,CAT 124RS,A01,519847,Geibel; William,6,0,20,14
1713497559460,CAT 125RS,A01,515971,Geibel; William,6,0,20,14
1713497560484,CLRE 250,A00,511389,Morris; Sheldon,9996,0,9999,3
1713497561514,CLRE 251,A00,507176,Mehta; Ravindra L.,9996,0,9999,3
1713497561514,CLRE 251,B00,511410,Mehta; Ravindra L.,9998,0,9999,1
1713497562538,CLRE 252,A00,507189,Cuomo; Raphael Eduardo,9998,0,9999,1
1713497563565,CLRE 253,A00,507199,Vaida; Florin,9997,0,9999,2
1713497563565,CLRE 253,B00,507202,Vaida; Florin,9999,0,9999,0
1713497564589,CLRE 259,A00,507211,Patel; Hemal,9996,0,9999,3
1713497565617,CLRE 260,A00,507221,Cuomo; Raphael Eduardo,9999,0,9999,0
1713497566642,CLRE 297,001,507242,Cuomo; Raphael Eduardo,9999,0,9999,0
1713497567722,CSE 191,A00,516875,Minnes Kemp; Mor Mia,9999,0,9999,0
1713497568748,CSS 201S,A01,494383,Staff,35,0,35,0
1713497569775,CSS 202S,A01,494387,Staff,35,0,35,0
1713497570805,EAP 100,A00,516065,Staff,9792,0,9999,207
1713497571831,ECE 45,A01,507414,Staff,37,0,60,23
1713497572857,ECE 100,A01,507416,Baghdadchi; Saharnaz,0,0,20,20
1713497572857,ECE 100,A02,507418,Baghdadchi; Saharnaz,19,0,20,1
1713497573882,ECE 111,A01,507420,Staff,27,0,50,23
1713497574909,ECE 197,001,548057,Sievenpiper; Daniel F.,9998,0,9999,1
1713497575935,EDS 115,A00,507243,Choi; Bailey Miyeon,27,0,28,1
1713497576962,EDS 117,A01,494379,Staff,15,0,25,10
1713497577986,EDS 125,A00,507246,Hopkins; Megan Beth,27,0,30,3
1713497579016,EDS 128A,A01,507264,Fargason; Sharon Gayle,26,0,26,0
1713497580040,EDS 128B,A01,507293,Pappas; Elizabeth,30,0,30,0
1713497581067,EDS 139,A00,507294,Fargason; Sharon Gayle,30,0,30,0
1713497581067,EDS 139,B00,507313,Pappas; Elizabeth,30,0,30,0
1713497582095,EDS 201,A00,507315,Staff,18,0,30,12
1713497583125,EDS 203,A01,507317,Halter; Christopher P.,17,0,30,13
1713497584155,EDS 204R,A01,507319,Halter; Christopher P.,0,1,30,30
1713497584155,EDS 204R,B01,507331,Heinzman; Erica M.,22,0,30,8
1713497585183,EDS 206R,A00,507332,Staff,0,2,30,30
1713497585183,EDS 206R,B00,507343,Staff,23,0,30,7
1713497586212,EDS 250,A00,507344,Hemans; Patricia Ann Benitez,27,0,40,13
1713497587237,EDS 281,A00,507345,Daly; Alan J.,18,0,18,0
1713497588266,EDS 284,A00,507350,Daly; Alan J.,16,0,16,0
1713497589293,EDS 286,A00,507359,Fine; Sarah,18,0,18,0
1713497590319,EDS 289C,A01,507361,Daly; Alan J.,18,0,18,0
1713497591349,EDS 290,A00,507366,Hofstetter; Carolyn,15,0,15,0
1713497592374,LIGM 5A,A00,507421,Fischer-Grunski; Eva K,20,0,20,0
1713497593400,LIGM 5B,A00,507423,Fischer-Grunski; Eva K,20,0,20,0
1713497594429,LIGM 5C,A00,507425,Fischer-Grunski; Eva K,20,0,20,0
1713497595455,LIIT 5AS,A00,507427,Carnelos; Chiara,20,0,20,0
1713497596479,LIIT 5BS,A00,507430,Carnelos; Chiara,20,0,20,0
1713497597507,LIIT 5CS,A00,507432,Carnelos; Chiara,20,0,20,0
1713497598537,LISP 5A,A00,507541,Munoz Sanchez; Alicia,14,0,20,6
1713497599562,LISP 5B,A00,507671,Munoz Sanchez; Alicia,12,0,20,8
1713497600587,LISP 5C,A00,507696,Munoz Sanchez; Alicia,11,0,20,9
1713497601613,MAE 197,001,528363,Boechler; Nicholas Sebastia,9998,0,9999,1
1713497602636,MATH 197,001,523477,Kedlaya; Kiran S.,9999,0,9999,0
1713497602636,MATH 197,002,563811,Zhang; Danna,9998,0,9999,1
1713497603661,MCWP 40R,A00,518780,Staff,14,0,20,6
1713497603661,MCWP 40R,B00,518781,Staff,12,0,20,8
1713497603661,MCWP 40R,C00,518783,Staff,9,0,20,11
1713497604688,MCWP 50R,A00,518791,Staff,7,0,20,13
1713497604688,MCWP 50R,B00,518792,Staff,3,0,20,17
1713497604688,MCWP 50R,C00,518793,Staff,7,0,20,13
1713497604688,MCWP 50R,D00,518794,Staff,0,0,20,20
1713497604688,MCWP 50R,E00,518795,Staff,0,0,20,20
1713497604688,MCWP 50R,F00,518796,Staff,11,0,20,9
1713497604688,MCWP 50R,G00,518797,Staff,10,0,20,10
1713497605712,MMW 12R,A01,514034,Herbst; Matthew,4,0,16,12
1713497605712,MMW 12R,A02,514035,Herbst; Matthew,13,0,16,3
1713497606741,MMW 13R,A01,514037,Staff,0,8,16,16
1713497606741,MMW 13R,A02,514039,Staff,0,6,16,16
1713497608793,SIO 295LS,A00,523233,Staff,15,0,30,15
1713497609822,SIO 295S,A00,523232,Staff,15,0,30,15
1713497610849,SOCI 117,A01,494376,Staff,0,2,5,5
1713497611877,WES 237B,A00,494380,Staff,19,0,20,1
1713497613956,AESE 279B,A00,494370,Wade; Jon P,33,0,33,0
1713497614984,AIP 197,001,627712,Vespa; Emanuel Ignacio,9999,0,9999,0
1713497616012,ANAR 135S,A00,494369,Braswell; Geoffrey E.,0,0,0,0
1713497617040,CAT 124RS,A01,519847,Geibel; William,6,0,20,14
1713497618064,CAT 125RS,A01,515971,Geibel; William,6,0,20,14
1713497619089,CLRE 250,A00,511389,Morris; Sheldon,9996,0,9999,3
1713497620117,CLRE 251,A00,507176,Mehta; Ravindra L.,9996,0,9999,3
1713497620117,CLRE 251,B00,511410,Mehta; Ravindra L.,9998,0,9999,1
1713497621143,CLRE 252,A00,507189,Cuomo; Raphael Eduardo,9998,0,9999,1
1713497622167,CLRE 253,A00,507199,Vaida; Florin,9997,0,9999,2
1713497622167,CLRE 253,B00,507202,Vaida; Florin,9999,0,9999,0
1713497623196,CLRE 259,A00,507211,Patel; Hemal,9996,0,9999,3
1713497624221,CLRE 260,A00,507221,Cuomo; Raphael Eduardo,9999,0,9999,0
1713497625250,CLRE 297,001,507242,Cuomo; Raphael Eduardo,9999,0,9999,0
1713497626279,CSE 191,A00,516875,Minnes Kemp; Mor Mia,9999,0,9999,0
1713497627308,CSS 201S,A01,494383,Staff,35,0,35,0
1713497628334,CSS 202S,A01,494387,Staff,35,0,35,0
1713497629360,EAP 100,A00,516065,Staff,9792,0,9999,207
1713497630387,ECE 45,A01,507414,Staff,37,0,60,23
1713497631411,ECE 100,A01,507416,Baghdadchi; Saharnaz,0,0,20,20
1713497631411,ECE 100,A02,507418,Baghdadchi; Saharnaz,19,0,20,1
1713497632436,ECE 111,A01,507420,Staff,27,0,50,23
1713497633467,ECE 197,001,548057,Sievenpiper; Daniel F.,9998,0,9999,1
1713497634492,EDS 115,A00,507243,Choi; Bailey Miyeon,27,0,28,1
1713497635521,EDS 117,A01,494379,Staff,15,0,25,10
1713497636547,EDS 125,A00,507246,Hopkins; Megan Beth,27,0,30,3
1713497637577,EDS 128A,A01,507264,Fargason; Sharon Gayle,26,0,26,0
1713497638605,EDS 128B,A01,507293,Pappas; Elizabeth,30,0,30,0
1713497639633,EDS 139,A00,507294,Fargason; Sharon Gayle,30,0,30,0
1713497639633,EDS 139,B00,507313,Pappas; Elizabeth,30,0,30,0
1713497640658,EDS 201,A00,507315,Staff,18,0,30,12
1713497641682,EDS 203,A01,507317,Halter; Christopher P.,17,0,30,13
1713497642708,EDS 204R,A01,507319,Halter; Christopher P.,0,1,30,30
1713497642708,EDS 204R,B01,507331,Heinzman; Erica M.,22,0,30,8
1713497643734,EDS 206R,A00,507332,Staff,0,2,30,30
1713497643734,EDS 206R,B00,507343,Staff,23,0,30,7
1713497644760,EDS 250,A00,507344,Hemans; Patricia Ann Benitez,27,0,40,13
1713497645787,EDS 281,A00,507345,Daly; Alan J.,18,0,18,0
1713497646812,EDS 284,A00,507350,Daly; Alan J.,16,0,16,0
1713497647838,EDS 286,A00,507359,Fine; Sarah,18,0,18,0
1713497648866,EDS 289C,A01,507361,Daly; Alan J.,18,0,18,0
1713497649893,EDS 290,A00,507366,Hofstetter; Carolyn,15,0,15,0
1713497650919,LIGM 5A,A00,507421,Fischer-Grunski; Eva K,20,0,20,0
1713497651945,LIGM 5B,A00,507423,Fischer-Grunski; Eva K,20,0,20,0
1713497652971,LIGM 5C,A00,507425,Fischer-Grunski; Eva K,20,0,20,0
1713497654002,LIIT 5AS,A00,507427,Carnelos; Chiara,20,0,20,0
1713497655029,LIIT 5BS,A00,507430,Carnelos; Chiara,20,0,20,0
1713497656055,LIIT 5CS,A00,507432,Carnelos; Chiara,20,0,20,0
1713497657085,LISP 5A,A00,507541,Munoz Sanchez; Alicia,14,0,20,6
1713497658112,LISP 5B,A00,507671,Munoz Sanchez; Alicia,12,0,20,8
1713497659141,LISP 5C,A00,507696,Munoz Sanchez; Alicia,11,0,20,9
1713497660170,MAE 197,001,528363,Boechler; Nicholas Sebastia,9998,0,9999,1
1713497661197,MATH 197,001,523477,Kedlaya; Kiran S.,9999,0,9999,0
1713497661197,MATH 197,002,563811,Zhang; Danna,9998,0,9999,1
1713497662222,MCWP 40R,A00,518780,Staff,14,0,20,6
1713497662222,MCWP 40R,B00,518781,Staff,12,0,20,8
1713497662222,MCWP 40R,C00,518783,Staff,9,0,20,11
1713497663249,MCWP 50R,A00,518791,Staff,7,0,20,13
1713497663249,MCWP 50R,B00,518792,Staff,3,0,20,17
1713497663249,MCWP 50R,C00,518793,Staff,7,0,20,13
1713497663249,MCWP 50R,D00,518794,Staff,0,0,20,20
1713497663249,MCWP 50R,E00,518795,Staff,0,0,20,20
1713497663249,MCWP 50R,F00,518796,Staff,11,0,20,9
1713497663249,MCWP 50R,G00,518797,Staff,10,0,20,10
1713497664279,MMW 12R,A01,514034,Herbst; Matthew,4,0,16,12
1713497664279,MMW 12R,A02,514035,Herbst; Matthew,13,0,16,3
1713497665308,MMW 13R,A01,514037,Staff,0,8,16,16
1713497665308,MMW 13R,A02,514039,Staff,0,6,16,16
1713497667364,SIO 295LS,A00,523233,Staff,15,0,30,15
1713497668390,SIO 295S,A00,523232,Staff,15,0,30,15
1713497669417,SOCI 117,A01,494376,Staff,0,2,5,5
1713497670443,WES 237B,A00,494380,Staff,19,0,20,1
1713497672563,AESE 279B,A00,494370,Wade; Jon P,33,0,33,0
1713497673588,AIP 197,001,627712,Vespa; Emanuel Ignacio,9999,0,9999,0
1713497674618,ANAR 135S,A00,494369,Braswell; Geoffrey E.,0,0,0,0
1713497675644,CAT 124RS,A01,519847,Geibel; William,6,0,20,14
1713497676671,CAT 125RS,A01,515971,Geibel; William,6,0,20,14
1713497677695,CLRE 250,A00,511389,Morris; Sheldon,9996,0,9999,3
1713497678725,CLRE 251,A00,507176,Mehta; Ravindra L.,9996,0,9999,3
1713497678725,CLRE 251,B00,511410,Mehta; Ravindra L.,9998,0,9999,1
1713497679753,CLRE 252,A00,507189,Cuomo; Raphael Eduardo,9998,0,9999,1
1713497680779,CLRE 253,A00,507199,Vaida; Florin,9997,0,9999,2
1713497680779,CLRE 253,B00,507202,Vaida; Florin,9999,0,9999,0
1713497681803,CLRE 259,A00,507211,Patel; Hemal,9996,0,9999,3
1713497682829,CLRE 260,A00,507221,Cuomo; Raphael Eduardo,9999,0,9999,0
1713497683854,CLRE 297,001,507242,Cuomo; Raphael Eduardo,9999,0,9999,0
1713497684883,CSE 191,A00,516875,Minnes Kemp; Mor Mia,9999,0,9999,0
1713497685909,CSS 201S,A01,494383,Staff,35,0,35,0
1713497686939,CSS 202S,A01,494387,Staff,35,0,35,0
1713497687968,EAP 100,A00,516065,Staff,9792,0,9999,207
1713497688997,ECE 45,A01,507414,Staff,37,0,60,23
1713497690023,ECE 100,A01,507416,Baghdadchi; Saharnaz,0,0,20,20
1713497690023,ECE 100,A02,507418,Baghdadchi; Saharnaz,19,0,20,1
1713497691053,ECE 111,A01,507420,Staff,27,0,50,23
1713497692078,ECE 197,001,548057,Sievenpiper; Daniel F.,9998,0,9999,1
1713497693106,EDS 115,A00,507243,Choi; Bailey Miyeon,27,0,28,1
1713497694132,EDS 117,A01,494379,Staff,15,0,25,10
1713497695158,EDS 125,A00,507246,Hopkins; Megan Beth,27,0,30,3
1713497696184,EDS 128A,A01,507264,Fargason; Sharon Gayle,26,0,26,0
1713497697212,EDS 128B,A01,507293,Pappas; Elizabeth,30,0,30,0
1713497698239,EDS 139,A00,507294,Fargason; Sharon Gayle,30,0,30,0
1713497698239,EDS 139,B00,507313,Pappas; Elizabeth,30,0,30,0
1713497699265,EDS 201,A00,507315,Staff,18,0,30,12
1713497700289,EDS 203,A01,507317,Halter; Christopher P.,17,0,30,13
1713497701315,EDS 204R,A01,507319,Halter; Christopher P.,0,1,30,30
1713497701315,EDS 204R,B01,507331,Heinzman; Erica M.,22,0,30,8
1713497702342,EDS 206R,A00,507332,Staff,0,2,30,30
1713497702342,EDS 206R,B00,507343,Staff,23,0,30,7
1713497703369,EDS 250,A00,507344,Hemans; Patricia Ann Benitez,27,0,40,13
1713497704396,EDS 281,A00,507345,Daly; Alan J.,18,0,18,0
1713497705420,EDS 284,A00,507350,Daly; Alan J.,16,0,16,0
1713497706446,EDS 286,A00,507359,Fine; Sarah,18,0,18,0
1713497707473,EDS 289C,A01,507361,Daly; Alan J.,18,0,18,0
1713497708497,EDS 290,A00,507366,Hofstetter; Carolyn,15,0,15,0
1713497709525,LIGM 5A,A00,507421,Fischer-Grunski; Eva K,20,0,20,0
1713497710549,LIGM 5B,A00,507423,Fischer-Grunski; Eva K,20,0,20,0
1713497711574,LIGM 5C,A00,507425,Fischer-Grunski; Eva K,20,0,20,0
1713497712600,LIIT 5AS,A00,507427,Carnelos; Chiara,20,0,20,0
1713497713625,LIIT 5BS,A00,507430,Carnelos; Chiara,20,0,20,0
1713497714650,LIIT 5CS,A00,507432,Carnelos; Chiara,20,0,20,0
1713497715676,LISP 5A,A00,507541,Munoz Sanchez; Alicia,14,0,20,6
1713497716701,LISP 5B,A00,507671,Munoz Sanchez; Alicia,12,0,20,8
1713497717727,LISP 5C,A00,507696,Munoz Sanchez; Alicia,11,0,20,9
1713497718752,MAE 197,001,528363,Boechler; Nicholas Sebastia,9998,0,9999,1
1713497719777,MATH 197,001,523477,Kedlaya; Kiran S.,9999,0,9999,0
1713497719777,MATH 197,002,563811,Zhang; Danna,9998,0,9999,1
1713497720805,MCWP 40R,A00,518780,Staff,14,0,20,6
1713497720805,MCWP 40R,B00,518781,Staff,12,0,20,8
1713497720805,MCWP 40R,C00,518783,Staff,9,0,20,11
1713497721832,MCWP 50R,A00,518791,Staff,7,0,20,13
1713497721832,MCWP 50R,B00,518792,Staff,3,0,20,17
1713497721832,MCWP 50R,C00,518793,Staff,7,0,20,13
1713497721832,MCWP 50R,D00,518794,Staff,0,0,20,20
1713497721832,MCWP 50R,E00,518795,Staff,0,0,20,20
1713497721832,MCWP 50R,F00,518796,Staff,11,0,20,9
1713497721832,MCWP 50R,G00,518797,Staff,10,0,20,10
1713497722857,MMW 12R,A01,514034,Herbst; Matthew,4,0,16,12
1713497722857,MMW 12R,A02,514035,Herbst; Matthew,13,0,16,3
1713497723882,MMW 13R,A01,514037,Staff,0,8,16,16
1713497723882,MMW 13R,A02,514039,Staff,0,6,16,16
1713497725932,SIO 295LS,A00,523233,Staff,15,0,30,15
1713497726961,SIO 295S,A00,523232,Staff,15,0,30,15
1713497727986,SOCI 117,A01,494376,Staff,0,2,5,5
1713497729010,WES 237B,A00,494380,Staff,19,0,20,1
1713497731086,AESE 279B,A00,494370,Wade; Jon P,33,0,33,0
1713497732115,AIP 197,001,627712,Vespa; Emanuel Ignacio,9999,0,9999,0
1713497733139,ANAR 135S,A00,494369,Braswell; Geoffrey E.,0,0,0,0
1713497734163,CAT 124RS,A01,519847,Geibel; William,6,0,20,14
1713497735189,CAT 125RS,A01,515971,Geibel; William,6,0,20,14
1713497736218,CLRE 250,A00,511389,Morris; Sheldon,9996,0,9999,3
1713497737248,CLRE 251,A00,507176,Mehta; Ravindra L.,9996,0,9999,3
1713497737248,CLRE 251,B00,511410,Mehta; Ravindra L.,9998,0,9999,1
1713497738273,CLRE 252,A00,507189,Cuomo; Raphael Eduardo,9998,0,9999,1
1713497739299,CLRE 253,A00,507199,Vaida; Florin,9997,0,9999,2
1713497739299,CLRE 253,B00,507202,Vaida; Florin,9999,0,9999,0
1713497740327,CLRE 259,A00,507211,Patel; Hemal,9996,0,9999,3
1713497741352,CLRE 260,A00,507221,Cuomo; Raphael Eduardo,9999,0,9999,0
1713497742377,CLRE 297,001,507242,Cuomo; Raphael Eduardo,9999,0,9999,0
1713497743405,CSE 191,A00,516875,Minnes Kemp; Mor Mia,9999,0,9999,0
1713497744435,CSS 201S,A01,494383,Staff,35,0,35,0
1713497745459,CSS 202S,A01,494387,Staff,35,0,35,0
1713497746483,EAP 100,A00,516065,Staff,9792,0,9999,207
1713497747512,ECE 45,A01,507414,Staff,37,0,60,23
1713497748539,ECE 100,A01,507416,Baghdadchi; Saharnaz,0,0,20,20
1713497748539,ECE 100,A02,507418,Baghdadchi; Saharnaz,19,0,20,1
1713497749564,ECE 111,A01,507420,Staff,27,0,50,23
1713497750594,ECE 197,001,548057,Sievenpiper; Daniel F.,9998,0,9999,1
1713497751620,EDS 115,A00,507243,Choi; Bailey Miyeon,27,0,28,1
1713497752645,EDS 117,A01,494379,Staff,15,0,25,10
1713497753673,EDS 125,A00,507246,Hopkins; Megan Beth,27,0,30,3
1713497754699,EDS 128A,A01,507264,Fargason; Sharon Gayle,26,0,26,0
1713497755725,EDS 128B,A01,507293,Pappas; Elizabeth,30,0,30,0
1713497756751,EDS 139,A00,507294,Fargason; Sharon Gayle,30,0,30,0
1713497756751,EDS 139,B00,507313,Pappas; Elizabeth,30,0,30,0
1713497757775,EDS 201,A00,507315,Staff,18,0,30,12
1713497758805,EDS 203,A01,507317,Halter; Christopher P.,17,0,30,13
1713497759832,EDS 204R,A01,507319,Halter; Christopher P.,0,1,30,30
1713497759832,EDS 204R,B01,507331,Heinzman; Erica M.,22,0,30,8
1713497760856,EDS 206R,A00,507332,Staff,0,2,30,30
1713497760856,EDS 206R,B00,507343,Staff,23,0,30,7
1713497761884,EDS 250,A00,507344,Hemans; Patricia Ann Benitez,27,0,40,13
1713497762911,EDS 281,A00,507345,Daly; Alan J.,18,0,18,0
1713497763939,EDS 284,A00,507350,Daly; Alan J.,16,0,16,0
1713497764963,EDS 286,A00,507359,Fine; Sarah,18,0,18,0
1713497765991,EDS 289C,A01,507361,Daly; Alan J.,18,0,18,0
1713497767020,EDS 290,A00,507366,Hofstetter; Carolyn,15,0,15,0
1713497768048,LIGM 5A,A00,507421,Fischer-Grunski; Eva K,20,0,20,0
1713497769074,LIGM 5B,A00,507423,Fischer-Grunski; Eva K,20,0,20,0
1713497770099,LIGM 5C,A00,507425,Fischer-Grunski; Eva K,20,0,20,0
1713497771129,LIIT 5AS,A00,507427,Carnelos; Chiara,20,0,20,0
1713497772159,LIIT 5BS,A00,507430,Carnelos; Chiara,20,0,20,0
1713497773186,LIIT 5CS,A00,507432,Carnelos; Chiara,20,0,20,0
1713497774213,LISP 5A,A00,507541,Munoz Sanchez; Alicia,14,0,20,6
1713497775297,LISP 5B,A00,507671,Munoz Sanchez; Alicia,12,0,20,8
1713497776324,LISP 5C,A00,507696,Munoz Sanchez; Alicia,11,0,20,9
1713497777352,MAE 197,001,528363,Boechler; Nicholas Sebastia,9998,0,9999,1
1713497778376,MATH 197,001,523477,Kedlaya; Kiran S.,9999,0,9999,0
1713497778376,MATH 197,002,563811,Zhang; Danna,9998,0,9999,1
1713497779404,MCWP 40R,A00,518780,Staff,14,0,20,6
1713497779404,MCWP 40R,B00,518781,Staff,12,0,20,8
1713497779404,MCWP 40R,C00,518783,Staff,9,0,20,11
1713497780433,MCWP 50R,A00,518791,Staff,7,0,20,13
1713497780433,MCWP 50R,B00,518792,Staff,3,0,20,17
1713497780433,MCWP 50R,C00,518793,Staff,7,0,20,13
1713497780433,MCWP 50R,D00,518794,Staff,0,0,20,20
1713497780433,MCWP 50R,E00,518795,Staff,0,0,20,20
1713497780433,MCWP 50R,F00,518796,Staff,11,0,20,9
1713497780433,MCWP 50R,G00,518797,Staff,10,0,20,10
1713497781457,MMW 12R,A01,514034,Herbst; Matthew,4,0,16,12
1713497781457,MMW 12R,A02,514035,Herbst; Matthew,13,0,16,3
1713497782486,MMW 13R,A01,514037,Staff,0,8,16,16
1713497782486,MMW 13R,A02,514039,Staff,0,6,16,16
1713497784537,SIO 295LS,A00,523233,Staff,15,0,30,15
1713497785565,SIO 295S,A00,523232,Staff,15,0,30,15
1713497786590,SOCI 117,A01,494376,Staff,0,2,5,5
1713497787618,WES 237B,A00,494380,Staff,19,0,20,1
1713497789680,AESE 279B,A00,494370,Wade; Jon P,33,0,33,0
1713497790708,AIP 197,001,627712,Vespa; Emanuel Ignacio,9999,0,9999,0
1713497791737,ANAR 135S,A00,494369,Braswell; Geoffrey E.,0,0,0,0
1713497792764,CAT 124RS,A01,519847,Geibel; William,6,0,20,14
1713497793791,CAT 125RS,A01,515971,Geibel; William,6,0,20,14
1713497794817,CLRE 250,A00,511389,Morris; Sheldon,9996,0,9999,3
1713497795843,CLRE 251,A00,507176,Mehta; Ravindra L.,9996,0,9999,3
1713497795843,CLRE 251,B00,511410,Mehta; Ravindra L.,9998,0,9999,1
1713497796873,CLRE 252,A00,507189,Cuomo; Raphael Eduardo,9998,0,9999,1
1713497797898,CLRE 253,A00,507199,Vaida; Florin,9997,0,9999,2
1713497797898,CLRE 253,B00,507202,Vaida; Florin,9999,0,9999,0
1713497798926,CLRE 259,A00,507211,Patel; Hemal,9996,0,9999,3
1713497799954,CLRE 260,A00,507221,Cuomo; Raphael Eduardo,9999,0,9999,0
1713497800980,CLRE 297,001,507242,Cuomo; Raphael Eduardo,9999,0,9999,0
1713497802005,CSE 191,A00,516875,Minnes Kemp; Mor Mia,9999,0,9999,0
1713497803030,CSS 201S,A01,494383,Staff,35,0,35,0
1713497804056,CSS 202S,A01,494387,Staff,35,0,35,0
1713497805083,EAP 100,A00,516065,Staff,9792,0,9999,207
1713497806114,ECE 45,A01,507414,Staff,37,0,60,23
1713497807143,ECE 100,A01,507416,Baghdadchi; Saharnaz,0,0,20,20
1713497807143,ECE 100,A02,507418,Baghdadchi; Saharnaz,19,0,20,1
1713497808170,ECE 111,A01,507420,Staff,27,0,50,23
1713497809196,ECE 197,001,548057,Sievenpiper; Daniel F.,9998,0,9999,1
1713497810222,EDS 115,A00,507243,Choi; Bailey Miyeon,27,0,28,1
1713497811248,EDS 117,A01,494379,Staff,15,0,25,10
1713497812273,EDS 125,A00,507246,Hopkins; Megan Beth,27,0,30,3
1713497813302,EDS 128A,A01,507264,Fargason; Sharon Gayle,26,0,26,0
1713497814327,EDS 128B,A01,507293,Pappas; Elizabeth,30,0,30,0
1713497815356,EDS 139,A00,507294,Fargason; Sharon Gayle,30,0,30,0
1713497815356,EDS 139,B00,507313,Pappas; Elizabeth,30,0,30,0
1713497816384,EDS 201,A00,507315,Staff,18,0,30,12
1713497817409,EDS 203,A01,507317,Halter; Christopher P.,17,0,30,13
1713497818434,EDS 204R,A01,507319,Halter; Christopher P.,0,1,30,30
1713497818434,EDS 204R,B01,507331,Heinzman; Erica M.,22,0,30,8
1713497819461,EDS 206R,A00,507332,Staff,0,2,30,30
1713497819461,EDS 206R,B00,507343,Staff,23,0,30,7
1713497820486,EDS 250,A00,507344,Hemans; Patricia Ann Benitez,27,0,40,13
1713497821510,EDS 281,A00,507345,Daly; Alan J.,18,0,18,0
1713497822536,EDS 284,A00,507350,Daly; Alan J.,16,0,16,0
1713497823565,EDS 286,A00,507359,Fine; Sarah,18,0,18,0
1713497824591,EDS 289C,A01,507361,Daly; Alan J.,18,0,18,0
1713497825619,EDS 290,A00,507366,Hofstetter; Carolyn,15,0,15,0
1713497826649,LIGM 5A,A00,507421,Fischer-Grunski; Eva K,20,0,20,0
1713497827673,LIGM 5B,A00,507423,Fischer-Grunski; Eva K,20,0,20,0
1713497828702,LIGM 5C,A00,507425,Fischer-Grunski; Eva K,20,0,20,0
1713497829731,LIIT 5AS,A00,507427,Carnelos; Chiara,20,0,20,0
1713497830756,LIIT 5BS,A00,507430,Carnelos; Chiara,20,0,20,0
1713497831784,LIIT 5CS,A00,507432,Carnelos; Chiara,20,0,20,0
1713497832810,LISP 5A,A00,507541,Munoz Sanchez; Alicia,14,0,20,6
1713497833839,LISP 5B,A00,507671,Munoz Sanchez; Alicia,12,0,20,8
1713497834865,LISP 5C,A00,507696,Munoz Sanchez; Alicia,11,0,20,9
1713497835893,MAE 197,001,528363,Boechler; Nicholas Sebastia,9998,0,9999,1
1713497836919,MATH 197,001,523477,Kedlaya; Kiran S.,9999,0,9999,0
1713497836919,MATH 197,002,563811,Zhang; Danna,9998,0,9999,1
1713497837946,MCWP 40R,A00,518780,Staff,14,0,20,6
1713497837946,MCWP 40R,B00,518781,Staff,12,0,20,8
1713497837946,MCWP 40R,C00,518783,Staff,9,0,20,11
1713497838975,MCWP 50R,A00,518791,Staff,7,0,20,13
1713497838975,MCWP 50R,B00,518792,Staff,3,0,20,17
1713497838975,MCWP 50R,C00,518793,Staff,7,0,20,13
1713497838975,MCWP 50R,D00,518794,Staff,0,0,20,20
1713497838975,MCWP 50R,E00,518795,Staff,0,0,20,20
1713497838975,MCWP 50R,F00,518796,Staff,11,0,20,9
1713497838975,MCWP 50R,G00,518797,Staff,10,0,20,10
1713497840003,MMW 12R,A01,514034,Herbst; Matthew,4,0,16,12
1713497840003,MMW 12R,A02,514035,Herbst; Matthew,13,0,16,3
1713497841027,MMW 13R,A01,514037,Staff,0,8,16,16
1713497841027,MMW 13R,A02,514039,Staff,0,6,16,16
1713497843079,SIO 295LS,A00,523233,Staff,15,0,30,15
1713497844103,SIO 295S,A00,523232,Staff,15,0,30,15
1713497845129,SOCI 117,A01,494376,Staff,0,2,5,5
1713497846156,WES 237B,A00,494380,Staff,19,0,20,1
1713497848218,AESE 279B,A00,494370,Wade; Jon P,33,0,33,0
1713497849243,AIP 197,001,627712,Vespa; Emanuel Ignacio,9999,0,9999,0
1713497850267,ANAR 135S,A00,494369,Braswell; Geoffrey E.,0,0,0,0
1713497851296,CAT 124RS,A01,519847,Geibel; William,6,0,20,14
1713497852324,CAT 125RS,A01,515971,Geibel; William,6,0,20,14
1713497853352,CLRE 250,A00,511389,Morris; Sheldon,9996,0,9999,3
1713497854381,CLRE 251,A00,507176,Mehta; Ravindra L.,9996,0,9999,3
1713497854381,CLRE 251,B00,511410,Mehta; Ravindra L.,9998,0,9999,1
1713497855406,CLRE 252,A00,507189,Cuomo; Raphael Eduardo,9998,0,9999,1
1713497856431,CLRE 253,A00,507199,Vaida; Florin,9997,0,9999,2
1713497856431,CLRE 253,B00,507202,Vaida; Florin,9999,0,9999,0
1713497857456,CLRE 259,A00,507211,Patel; Hemal,9996,0,9999,3
1713497858480,CLRE 260,A00,507221,Cuomo; Raphael Eduardo,9999,0,9999,0
1713497859506,CLRE 297,001,507242,Cuomo; Raphael Eduardo,9999,0,9999,0
1713497860534,CSE 191,A00,516875,Minnes Kemp; Mor Mia,9999,0,9999,0
1713497861558,CSS 201S,A01,494383,Staff,35,0,35,0
1713497862582,CSS 202S,A01,494387,Staff,35,0,35,0
1713497863609,EAP 100,A00,516065,Staff,9792,0,9999,207
1713497864635,ECE 45,A01,507414,Staff,37,0,60,23
1713497865661,ECE 100,A01,507416,Baghdadchi; Saharnaz,0,0,20,20
1713497865661,ECE 100,A02,507418,Baghdadchi; Saharnaz,19,0,20,1
1713497866685,ECE 111,A01,507420,Staff,27,0,50,23
1713497867713,ECE 197,001,548057,Sievenpiper; Daniel F.,9998,0,9999,1
1713497868738,EDS 115,A00,507243,Choi; Bailey Miyeon,27,0,28,1
1713497869767,EDS 117,A01,494379,Staff,15,0,25,10
1713497870793,EDS 125,A00,507246,Hopkins; Megan Beth,27,0,30,3
1713497871818,EDS 128A,A01,507264,Fargason; Sharon Gayle,26,0,26,0
1713497872844,EDS 128B,A01,507293,Pappas; Elizabeth,30,0,30,0
1713497873870,EDS 139,A00,507294,Fargason; Sharon Gayle,30,0,30,0
1713497873870,EDS 139,B00,507313,Pappas; Elizabeth,30,0,30,0
1713497874895,EDS 201,A00,507315,Staff,18,0,30,12
1713497875922,EDS 203,A01,507317,Halter; Christopher P.,17,0,30,13
1713497876946,EDS 204R,A01,507319,Halter; Christopher P.,0,1,30,30
1713497876946,EDS 204R,B01,507331,Heinzman; Erica M.,22,0,30,8
1713497877976,EDS 206R,A00,507332,Staff,0,2,30,30
1713497877976,EDS 206R,B00,507343,Staff,23,0,30,7
1713497879061,EDS 250,A00,507344,Hemans; Patricia Ann Benitez,27,0,40,13
1713497880085,EDS 281,A00,507345,Daly; Alan J.,18,0,18,0
1713497881111,EDS 284,A00,507350,Daly; Alan J.,16,0,16,0
1713497882136,EDS 286,A00,507359,Fine; Sarah,18,0,18,0
1713497883161,EDS 289C,A01,507361,Daly; Alan J.,18,0,18,0
1713497884351,EDS 290,A00,507366,Hofstetter; Carolyn,15,0,15,0
1713497885380,LIGM 5A,A00,507421,Fischer-Grunski; Eva K,20,0,20,0
1713497886407,LIGM 5B,A00,507423,Fischer-Grunski; Eva K,20,0,20,0
1713497887433,LIGM 5C,A00,507425,Fischer-Grunski; Eva K,20,0,20,0
1713497888463,LIIT 5AS,A00,507427,Carnelos; Chiara,20,0,20,0
1713497889491,LIIT 5BS,A00,507430,Carnelos; Chiara,20,0,20,0
1713497890521,LIIT 5CS,A00,507432,Carnelos; Chiara,20,0,20,0
1713497891547,LISP 5A,A00,507541,Munoz Sanchez; Alicia,14,0,20,6
1713497892574,LISP 5B,A00,507671,Munoz Sanchez; Alicia,12,0,20,8
1713497893604,LISP 5C,A00,507696,Munoz Sanchez; Alicia,11,0,20,9
1713497894630,MAE 197,001,528363,Boechler; Nicholas Sebastia,9998,0,9999,1
1713497895656,MATH 197,001,523477,Kedlaya; Kiran S.,9999,0,9999,0
1713497895656,MATH 197,002,563811,Zhang; Danna,9998,0,9999,1
1713497896679,MCWP 40R,A00,518780,Staff,14,0,20,6
1713497896679,MCWP 40R,B00,518781,Staff,12,0,20,8
1713497896679,MCWP 40R,C00,518783,Staff,9,0,20,11
1713497897710,MCWP 50R,A00,518791,Staff,7,0,20,13
1713497897710,MCWP 50R,B00,518792,Staff,3,0,20,17
1713497897710,MCWP 50R,C00,518793,Staff,7,0,20,13
1713497897710,MCWP 50R,D00,518794,Staff,0,0,20,20
1713497897710,MCWP 50R,E00,518795,Staff,0,0,20,20
1713497897710,MCWP 50R,F00,518796,Staff,11,0,20,9
1713497897710,MCWP 50R,G00,518797,Staff,10,0,20,10
1713497898739,MMW 12R,A01,514034,Herbst; Matthew,4,0,16,12
1713497898739,MMW 12R,A02,514035,Herbst; Matthew,13,0,16,3
1713497899767,MMW 13R,A01,514037,Staff,0,8,16,16
1713497899767,MMW 13R,A02,514039,Staff,0,6,16,16
1713497901821,SIO 295LS,A00,523233,Staff,15,0,30,15
1713497902846,SIO 295S,A00,523232,Staff,15,0,30,15
1713497903872,SOCI 117,A01,494376,Staff,0,2,5,5
1713497904901,WES 237B,A00,494380,Staff,19,0,20,1
1713497906961,AESE 279B,A00,494370,Wade; Jon P,33,0,33,0
1713497907987,AIP 197,001,627712,Vespa; Emanuel Ignacio,9999,0,9999,0
1713497909013,ANAR 135S,A00,494369,Braswell; Geoffrey E.,0,0,0,0
1713497910039,CAT 124RS,A01,519847,Geibel; William,6,0,20,14
1713497911064,CAT 125RS,A01,515971,Geibel; William,6,0,20,14
1713497912092,CLRE 250,A00,511389,Morris; Sheldon,9996,0,9999,3
1713497913123,CLRE 251,A00,507176,Mehta; Ravindra L.,9996,0,9999,3
1713497913123,CLRE 251,B00,511410,Mehta; Ravindra L.,9998,0,9999,1
1713497914152,CLRE 252,A00,507189,Cuomo; Raphael Eduardo,9998,0,9999,1
1713497915179,CLRE 253,A00,507199,Vaida; Florin,9997,0,9999,2
1713497915179,CLRE 253,B00,507202,Vaida; Florin,9999,0,9999,0
1713497916205,CLRE 259,A00,507211,Patel; Hemal,9996,0,9999,3
1713497917230,CLRE 260,A00,507221,Cuomo; Raphael Eduardo,9999,0,9999,0
1713497918258,CLRE 297,001,507242,Cuomo; Raphael Eduardo,9999,0,9999,0
1713497919287,CSE 191,A00,516875,Minnes Kemp; Mor Mia,9999,0,9999,0
1713497920314,CSS 201S,A01,494383,Staff,35,0,35,0
1713497921342,CSS 202S,A01,494387,Staff,35,0,35,0
1713497922372,EAP 100,A00,516065,Staff,9792,0,9999,207
1713497923401,ECE 45,A01,507414,Staff,37,0,60,23
1713497924428,ECE 100,A01,507416,Baghdadchi; Saharnaz,0,0,20,20
1713497924428,ECE 100,A02,507418,Baghdadchi; Saharnaz,19,0,20,1
1713497925456,ECE 111,A01,507420,Staff,27,0,50,23
1713497926481,ECE 197,001,548057,Sievenpiper; Daniel F.,9998,0,9999,1
1713497927508,EDS 115,A00,507243,Choi; Bailey Miyeon,27,0,28,1
1713497928537,EDS 117,A01,494379,Staff,15,0,25,10
1713497929564,EDS 125,A00,507246,Hopkins; Megan Beth,27,0,30,3
1713497930590,EDS 128A,A01,507264,Fargason; Sharon Gayle,26,0,26,0
1713497931616,EDS 128B,A01,507293,Pappas; Elizabeth,30,0,30,0
1713497932643,EDS 139,A00,507294,Fargason; Sharon Gayle,30,0,30,0
1713497932643,EDS 139,B00,507313,Pappas; Elizabeth,30,0,30,0
1713497933671,EDS 201,A00,507315,Staff,18,0,30,12
1713497934700,EDS 203,A01,507317,Halter; Christopher P.,17,0,30,13
1713497935730,EDS 204R,A01,507319,Halter; Christopher P.,0,1,30,30
1713497935730,EDS 204R,B01,507331,Heinzman; Erica M.,22,0,30,8
1713497936755,EDS 206R,A00,507332,Staff,0,2,30,30
1713497936755,EDS 206R,B00,507343,Staff,23,0,30,7
1713497937781,EDS 250,A00,507344,Hemans; Patricia Ann Benitez,27,0,40,13
1713497938807,EDS 281,A00,507345,Daly; Alan J.,18,0,18,0
1713497939839,EDS 284,A00,507350,Daly; Alan J.,16,0,16,0
1713497940888,EDS 286,A00,507359,Fine; Sarah,18,0,18,0
1713497941915,EDS 289C,A01,507361,Daly; Alan J.,18,0,18,0
1713497942939,EDS 290,A00,507366,Hofstetter; Carolyn,15,0,15,0
1713497943967,LIGM 5A,A00,507421,Fischer-Grunski; Eva K,20,0,20,0
1713497944992,LIGM 5B,A00,507423,Fischer-Grunski; Eva K,20,0,20,0
1713497946019,LIGM 5C,A00,507425,Fischer-Grunski; Eva K,20,0,20,0
1713497947044,LIIT 5AS,A00,507427,Carnelos; Chiara,20,0,20,0
1713497948070,LIIT 5BS,A00,507430,Carnelos; Chiara,20,0,20,0
1713497949095,LIIT 5CS,A00,507432,Carnelos; Chiara,20,0,20,0
1713497950122,LISP 5A,A00,507541,Munoz Sanchez; Alicia,14,0,20,6
1713497951148,LISP 5B,A00,507671,Munoz Sanchez; Alicia,12,0,20,8
1713497952173,LISP 5C,A00,507696,Munoz Sanchez; Alicia,11,0,20,9
1713497953202,MAE 197,001,528363,Boechler; Nicholas Sebastia,9998,0,9999,1
1713497954229,MATH 197,001,523477,Kedlaya; Kiran S.,9999,0,9999,0
1713497954229,MATH 197,002,563811,Zhang; Danna,9998,0,9999,1
1713497955255,MCWP 40R,A00,518780,Staff,14,0,20,6
1713497955255,MCWP 40R,B00,518781,Staff,12,0,20,8
1713497955255,MCWP 40R,C00,518783,Staff,9,0,20,11
1713497956282,MCWP 50R,A00,518791,Staff,7,0,20,13
1713497956282,MCWP 50R,B00,518792,Staff,3,0,20,17
1713497956282,MCWP 50R,C00,518793,Staff,7,0,20,13
1713497956282,MCWP 50R,D00,518794,Staff,0,0,20,20
1713497956282,MCWP 50R,E00,518795,Staff,0,0,20,20
1713497956282,MCWP 50R,F00,518796,Staff,11,0,20,9
1713497956282,MCWP 50R,G00,518797,Staff,10,0,20,10
1713497957309,MMW 12R,A01,514034,Herbst; Matthew,4,0,16,12
1713497957309,MMW 12R,A02,514035,Herbst; Matthew,13,0,16,3
1713497958334,MMW 13R,A01,514037,Staff,0,8,16,16
1713497958334,MMW 13R,A02,514039,Staff,0,6,16,16
1713497960388,SIO 295LS,A00,523233,Staff,15,0,30,15
1713497961415,SIO 295S,A00,523232,Staff,15,0,30,15
1713497962440,SOCI 117,A01,494376,Staff,0,2,5,5
1713497963465,WES 237B,A00,494380,Staff,19,0,20,1
1713497965531,AESE 279B,A00,494370,Wade; Jon P,33,0,33,0
1713497966557,AIP 197,001,627712,Vespa; Emanuel Ignacio,9999,0,9999,0
1713497967583,ANAR 135S,A00,494369,Braswell; Geoffrey E.,0,0,0,0
1713497968610,CAT 124RS,A01,519847,Geibel; William,6,0,20,14
1713497969637,CAT 125RS,A01,515971,Geibel; William,6,0,20,14
1713497970662,CLRE 250,A00,511389,Morris; Sheldon,9996,0,9999,3
1713497971690,CLRE 251,A00,507176,Mehta; Ravindra L.,9996,0,9999,3
1713497971690,CLRE 251,B00,511410,Mehta; Ravindra L.,9998,0,9999,1
1713497972715,CLRE 252,A00,507189,Cuomo; Raphael Eduardo,9998,0,9999,1
1713497973742,CLRE 253,A00,507199,Vaida; Florin,9997,0,9999,2
1713497973742,CLRE 253,B00,507202,Vaida; Florin,9999,0,9999,0
1713497974766,CLRE 259,A00,507211,Patel; Hemal,9996,0,9999,3
1713497975792,CLRE 260,A00,507221,Cuomo; Raphael Eduardo,9999,0,9999,0
1713497976817,CLRE 297,001,507242,Cuomo; Raphael Eduardo,9999,0,9999,0
1713497977845,CSE 191,A00,516875,Minnes Kemp; Mor Mia,9999,0,9999,0
1713497978871,CSS 201S,A01,494383,Staff,35,0,35,0
1713497979897,CSS 202S,A01,494387,Staff,35,0,35,0
1713497980924,EAP 100,A00,516065,Staff,9792,0,9999,207
1713497981951,ECE 45,A01,507414,Staff,37,0,60,23
1713497983036,ECE 100,A01,507416,Baghdadchi; Saharnaz,0,0,20,20
1713497983036,ECE 100,A02,507418,Baghdadchi; Saharnaz,19,0,20,1
1713497984063,ECE 111,A01,507420,Staff,27,0,50,23
1713497985088,ECE 197,001,548057,Sievenpiper; Daniel F.,9998,0,9999,1
1713497986115,EDS 115,A00,507243,Choi; Bailey Miyeon,27,0,28,1
1713497987140,EDS 117,A01,494379,Staff,15,0,25,10
1713497988166,EDS 125,A00,507246,Hopkins; Megan Beth,27,0,30,3
1713497989191,EDS 128A,A01,507264,Fargason; Sharon Gayle,26,0,26,0
1713497990217,EDS 128B,A01,507293,Pappas; Elizabeth,30,0,30,0
1713497991242,EDS 139,A00,507294,Fargason; Sharon Gayle,30,0,30,0
1713497991242,EDS 139,B00,507313,Pappas; Elizabeth,30,0,30,0
1713497992269,EDS 201,A00,507315,Staff,18,0,30,12
1713497993295,EDS 203,A01,507317,Halter; Christopher P.,17,0,30,13
1713497994321,EDS 204R,A01,507319,Halter; Christopher P.,0,1,30,30
1713497994321,EDS 204R,B01,507331,Heinzman; Erica M.,22,0,30,8
1713497995347,EDS 206R,A00,507332,Staff,0,2,30,30
1713497995347,EDS 206R,B00,507343,Staff,23,0,30,7
1713497996372,EDS 250,A00,507344,Hemans; Patricia Ann Benitez,27,0,40,13
1713497997402,EDS 281,A00,507345,Daly; Alan J.,18,0,18,0
1713497998429,EDS 284,A00,507350,Daly; Alan J.,16,0,16,0
1713497999456,EDS 286,A00,507359,Fine; Sarah,18,0,18,0
1713498000479,EDS 289C,A01,507361,Daly; Alan J.,18,0,18,0
1713498001509,EDS 290,A00,507366,Hofstetter; Carolyn,15,0,15,0
1713498002541,LIGM 5A,A00,507421,Fischer-Grunski; Eva K,20,0,20,0
1713498003567,LIGM 5B,A00,507423,Fischer-Grunski; Eva K,20,0,20,0
1713498004594,LIGM 5C,A00,507425,Fischer-Grunski; Eva K,20,0,20,0
1713498005621,LIIT 5AS,A00,507427,Carnelos; Chiara,20,0,20,0
1713498006647,LIIT 5BS,A00,507430,Carnelos; Chiara,20,0,20,0
1713498007676,LIIT 5CS,A00,507432,Carnelos; Chiara,20,0,20,0
1713498008706,LISP 5A,A00,507541,Munoz Sanchez; Alicia,14,0,20,6
1713498009731,LISP 5B,A00,507671,Munoz Sanchez; Alicia,12,0,20,8
1713498010757,LISP 5C,A00,507696,Munoz Sanchez; Alicia,11,0,20,9
1713498011785,MAE 197,001,528363,Boechler; Nicholas Sebastia,9998,0,9999,1
1713498012809,MATH 197,001,523477,Kedlaya; Kiran S.,9999,0,9999,0
1713498012809,MATH 197,002,563811,Zhang; Danna,9998,0,9999,1
1713498013837,MCWP 40R,A00,518780,Staff,14,0,20,6
1713498013837,MCWP 40R,B00,518781,Staff,12,0,20,8
1713498013837,MCWP 40R,C00,518783,Staff,9,0,20,11
1713498014863,MCWP 50R,A00,518791,Staff,7,0,20,13
1713498014863,MCWP 50R,B00,518792,Staff,3,0,20,17
1713498014863,MCWP 50R,C00,518793,Staff,7,0,20,13
1713498014863,MCWP 50R,D00,518794,Staff,0,0,20,20
1713498014863,MCWP 50R,E00,518795,Staff,0,0,20,20
1713498014863,MCWP 50R,F00,518796,Staff,11,0,20,9
1713498014863,MCWP 50R,G00,518797,Staff,10,0,20,10
1713498015888,MMW 12R,A01,514034,Herbst; Matthew,4,0,16,12
1713498015888,MMW 12R,A02,514035,Herbst; Matthew,13,0,16,3
1713498016912,MMW 13R,A01,514037,Staff,0,8,16,16
1713498016912,MMW 13R,A02,514039,Staff,0,6,16,16
1713498018970,SIO 295LS,A00,523233,Staff,15,0,30,15
1713498019995,SIO 295S,A00,523232,Staff,15,0,30,15
1713498021020,SOCI 117,A01,494376,Staff,0,2,5,5
1713498022047,WES 237B,A00,494380,Staff,19,0,20,1
1713498024111,AESE 279B,A00,494370,Wade; Jon P,33,0,33,0
1713498025141,AIP 197,001,627712,Vespa; Emanuel Ignacio,9999,0,9999,0
1713498026166,ANAR 135S,A00,494369,Braswell; Geoffrey E.,0,0,0,0
1713498027192,CAT 124RS,A01,519847,Geibel; William,6,0,20,14
1713498028216,CAT 125RS,A01,515971,Geibel; William,6,0,20,14
1713498029242,CLRE 250,A00,511389,Morris; Sheldon,9996,0,9999,3
1713498030272,CLRE 251,A00,507176,Mehta; Ravindra L.,9996,0,9999,3
1713498030272,CLRE 251,B00,511410,Mehta; Ravindra L.,9998,0,9999,1
1713498031297,CLRE 252,A00,507189,Cuomo; Raphael Eduardo,9998,0,9999,1
1713498032322,CLRE 253,A00,507199,Vaida; Florin,9997,0,9999,2
1713498032322,CLRE 253,B00,507202,Vaida; Florin,9999,0,9999,0
1713498033346,CLRE 259,A00,507211,Patel; Hemal,9996,0,9999,3
1713498034374,CLRE 260,A00,507221,Cuomo; Raphael Eduardo,9999,0,9999,0
1713498035400,CLRE 297,001,507242,Cuomo; Raphael Eduardo,9999,0,9999,0
1713498036428,CSE 191,A00,516875,Minnes Kemp; Mor Mia,9999,0,9999,0
1713498037455,CSS 201S,A01,494383,Staff,35,0,35,0
1713498038484,CSS 202S,A01,494387,Staff,35,0,35,0
1713498039511,EAP 100,A00,516065,Staff,9792,0,9999,207
1713498040536,ECE 45,A01,507414,Staff,37,0,60,23
1713498041564,ECE 100,A01,507416,Baghdadchi; Saharnaz,0,0,20,20
1713498041564,ECE 100,A02,507418,Baghdadchi; Saharnaz,19,0,20,1
1713498042591,ECE 111,A01,507420,Staff,27,0,50,23
1713498043621,ECE 197,001,548057,Sievenpiper; Daniel F.,9998,0,9999,1
1713498044650,EDS 115,A00,507243,Choi; Bailey Miyeon,27,0,28,1
1713498045678,EDS 117,A01,494379,Staff,15,0,25,10
1713498046703,EDS 125,A00,507246,Hopkins; Megan Beth,27,0,30,3
1713498047730,EDS 128A,A01,507264,Fargason; Sharon Gayle,26,0,26,0
1713498048755,EDS 128B,A01,507293,Pappas; Elizabeth,30,0,30,0
1713498049783,EDS 139,A00,507294,Fargason; Sharon Gayle,30,0,30,0
1713498049783,EDS 139,B00,507313,Pappas; Elizabeth,30,0,30,0
1713498050811,EDS 201,A00,507315,Staff,18,0,30,12
1713498051836,EDS 203,A01,507317,Halter; Christopher P.,17,0,30,13
1713498052864,EDS 204R,A01,507319,Halter; Christopher P.,0,1,30,30
1713498052864,EDS 204R,B01,507331,Heinzman; Erica M.,22,0,30,8
1713498053901,EDS 206R,A00,507332,Staff,0,2,30,30
1713498053901,EDS 206R,B00,507343,Staff,23,0,30,7
1713498054926,EDS 250,A00,507344,Hemans; Patricia Ann Benitez,27,0,40,13
1713498055953,EDS 281,A00,507345,Daly; Alan J.,18,0,18,0
1713498056982,EDS 284,A00,507350,Daly; Alan J.,16,0,16,0
1713498058010,EDS 286,A00,507359,Fine; Sarah,18,0,18,0
1713498059038,EDS 289C,A01,507361,Daly; Alan J.,18,0,18,0
1713498060063,EDS 290,A00,507366,Hofstetter; Carolyn,15,0,15,0
1713498061088,LIGM 5A,A00,507421,Fischer-Grunski; Eva K,20,0,20,0
1713498062114,LIGM 5B,A00,507423,Fischer-Grunski; Eva K,20,0,20,0
1713498063138,LIGM 5C,A00,507425,Fischer-Grunski; Eva K,20,0,20,0
1713498064167,LIIT 5AS,A00,507427,Carnelos; Chiara,20,0,20,0
1713498065192,LIIT 5BS,A00,507430,Carnelos; Chiara,20,0,20,0
1713498066220,LIIT 5CS,A00,507432,Carnelos; Chiara,20,0,20,0
1713498067249,LISP 5A,A00,507541,Munoz Sanchez; Alicia,14,0,20,6
1713498068274,LISP 5B,A00,507671,Munoz Sanchez; Alicia,12,0,20,8
1713498069296,LISP 5C,A00,507696,Munoz Sanchez; Alicia,11,0,20,9
1713498070324,MAE 197,001,528363,Boechler; Nicholas Sebastia,9998,0,9999,1
1713498071354,MATH 197,001,523477,Kedlaya; Kiran S.,9999,0,9999,0
1713498071354,MATH 197,002,563811,Zhang; Danna,9998,0,9999,1
1713498072378,MCWP 40R,A00,518780,Staff,14,0,20,6
1713498072378,MCWP 40R,B00,518781,Staff,12,0,20,8
1713498072378,MCWP 40R,C00,518783,Staff,9,0,20,11
1713498073407,MCWP 50R,A00,518791,Staff,7,0,20,13
1713498073407,MCWP 50R,B00,518792,Staff,3,0,20,17
1713498073407,MCWP 50R,C00,518793,Staff,7,0,20,13
1713498073407,MCWP 50R,D00,518794,Staff,0,0,20,20
1713498073407,MCWP 50R,E00,518795,Staff,0,0,20,20
1713498073407,MCWP 50R,F00,518796,Staff,11,0,20,9
1713498073407,MCWP 50R,G00,518797,Staff,10,0,20,10
1713498074437,MMW 12R,A01,514034,Herbst; Matthew,4,0,16,12
1713498074437,MMW 12R,A02,514035,Herbst; Matthew,13,0,16,3
1713498075467,MMW 13R,A01,514037,Staff,0,8,16,16
1713498075467,MMW 13R,A02,514039,Staff,0,6,16,16
1713498077518,SIO 295LS,A00,523233,Staff,15,0,30,15
1713498078543,SIO 295S,A00,523232,Staff,15,0,30,15
1713498079568,SOCI 117,A01,494376,Staff,0,2,5,5
1713498080592,WES 237B,A00,494380,Staff,19,0,20,1
1713498082663,AESE 279B,A00,494370,Wade; Jon P,33,0,33,0
1713498083689,AIP 197,001,627712,Vespa; Emanuel Ignacio,9999,0,9999,0
1713498084714,ANAR 135S,A00,494369,Braswell; Geoffrey E.,0,0,0,0
1713498085741,CAT 124RS,A01,519847,Geibel; William,6,0,20,14
1713498086820,CAT 125RS,A01,515971,Geibel; William,6,0,20,14
1713498087846,CLRE 250,A00,511389,Morris; Sheldon,9996,0,9999,3
1713498088873,CLRE 251,A00,507176,Mehta; Ravindra L.,9996,0,9999,3
1713498088873,CLRE 251,B00,511410,Mehta; Ravindra L.,9998,0,9999,1
1713498089898,CLRE 252,A00,507189,Cuomo; Raphael Eduardo,9998,0,9999,1
1713498090923,CLRE 253,A00,507199,Vaida; Florin,9997,0,9999,2
1713498090923,CLRE 253,B00,507202,Vaida; Florin,9999,0,9999,0
1713498091950,CLRE 259,A00,507211,Patel; Hemal,9996,0,9999,3
1713498092978,CLRE 260,A00,507221,Cuomo; Raphael Eduardo,9999,0,9999,0
1713498094006,CLRE 297,001,507242,Cuomo; Raphael Eduardo,9999,0,9999,0
1713498095031,CSE 191,A00,516875,Minnes Kemp; Mor Mia,9999,0,9999,0
1713498096057,CSS 201S,A01,494383,Staff,35,0,35,0
1713498097087,CSS 202S,A01,494387,Staff,35,0,35,0
1713498098112,EAP 100,A00,516065,Staff,9792,0,9999,207
1713498099140,ECE 45,A01,507414,Staff,37,0,60,23
1713498100165,ECE 100,A01,507416,Baghdadchi; Saharnaz,0,0,20,20
1713498100165,ECE 100,A02,507418,Baghdadchi; Saharnaz,19,0,20,1
1713498101191,ECE 111,A01,507420,Staff,27,0,50,23
1713498102216,ECE 197,001,548057,Sievenpiper; Daniel F.,9998,0,9999,1
1713498103245,EDS 115,A00,507243,Choi; Bailey Miyeon,27,0,28,1
1713498104275,EDS 117,A01,494379,Staff,15,0,25,10
1713498105300,EDS 125,A00,507246,Hopkins; Megan Beth,27,0,30,3
1713498106329,EDS 128A,A01,507264,Fargason; Sharon Gayle,26,0,26,0
1713498107354,EDS 128B,A01,507293,Pappas; Elizabeth,30,0,30,0
1713498108379,EDS 139,A00,507294,Fargason; Sharon Gayle,30,0,30,0
1713498108379,EDS 139,B00,507313,Pappas; Elizabeth,30,0,30,0
1713498109405,EDS 201,A00,507315,Staff,18,0,30,12
1713498110430,EDS 203,A01,507317,Halter; Christopher P.,17,0,30,13
1713498111461,EDS 204R,A01,507319,Halter; Christopher P.,0,1,30,30
1713498111461,EDS 204R,B01,507331,Heinzman; Erica M.,22,0,30,8
1713498112485,EDS 206R,A00,507332,Staff,0,2,30,30
1713498112485,EDS 206R,B00,507343,Staff,23,0,30,7
1713498113517,EDS 250,A00,507344,Hemans; Patricia Ann Benitez,27,0,40,13
1713498114542,EDS 281,A00,507345,Daly; Alan J.,18,0,18,0
1713498115567,EDS 284,A00,507350,Daly; Alan J.,16,0,16,0
1713498116594,EDS 286,A00,507359,Fine; Sarah,18,0,18,0
1713498117622,EDS 289C,A01,507361,Daly; Alan J.,18,0,18,0
1713498118648,EDS 290,A00,507366,Hofstetter; Carolyn,15,0,15,0
1713498119675,LIGM 5A,A00,507421,Fischer-Grunski; Eva K,20,0,20,0
1713498120705,LIGM 5B,A00,507423,Fischer-Grunski; Eva K,20,0,20,0
1713498121734,LIGM 5C,A00,507425,Fischer-Grunski; Eva K,20,0,20,0
1713498122760,LIIT 5AS,A00,507427,Carnelos; Chiara,20,0,20,0
1713498123789,LIIT 5BS,A00,507430,Carnelos; Chiara,20,0,20,0
1713498124815,LIIT 5CS,A00,507432,Carnelos; Chiara,20,0,20,0
1713498125854,LISP 5A,A00,507541,Munoz Sanchez; Alicia,14,0,20,6
1713498126885,LISP 5B,A00,507671,Munoz Sanchez; Alicia,12,0,20,8
1713498127915,LISP 5C,A00,507696,Munoz Sanchez; Alicia,11,0,20,9
1713498128943,MAE 197,001,528363,Boechler; Nicholas Sebastia,9998,0,9999,1
1713498129972,MATH 197,001,523477,Kedlaya; Kiran S.,9999,0,9999,0
1713498129972,MATH 197,002,563811,Zhang; Danna,9998,0,9999,1
1713498131010,MCWP 40R,A00,518780,Staff,14,0,20,6
1713498131010,MCWP 40R,B00,518781,Staff,12,0,20,8
1713498131010,MCWP 40R,C00,518783,Staff,9,0,20,11
1713498132037,MCWP 50R,A00,518791,Staff,7,0,20,13
1713498132037,MCWP 50R,B00,518792,Staff,3,0,20,17
1713498132037,MCWP 50R,C00,518793,Staff,7,0,20,13
1713498132037,MCWP 50R,D00,518794,Staff,0,0,20,20
1713498132037,MCWP 50R,E00,518795,Staff,0,0,20,20
1713498132037,MCWP 50R,F00,518796,Staff,11,0,20,9
1713498132037,MCWP 50R,G00,518797,Staff,10,0,20,10
1713498133067,MMW 12R,A01,514034,Herbst; Matthew,4,0,16,12
1713498133067,MMW 12R,A02,514035,Herbst; Matthew,13,0,16,3
1713498134091,MMW 13R,A01,514037,Staff,0,8,16,16
1713498134091,MMW 13R,A02,514039,Staff,0,6,16,16
1713498136144,SIO 295LS,A00,523233,Staff,15,0,30,15
1713498137170,SIO 295S,A00,523232,Staff,15,0,30,15
1713498138199,SOCI 117,A01,494376,Staff,0,2,5,5
1713498139224,WES 237B,A00,494380,Staff,19,0,20,1
1713498141294,AESE 279B,A00,494370,Wade; Jon P,33,0,33,0
1713498142319,AIP 197,001,627712,Vespa; Emanuel Ignacio,9999,0,9999,0
1713498143346,ANAR 135S,A00,494369,Braswell; Geoffrey E.,0,0,0,0
1713498144370,CAT 124RS,A01,519847,Geibel; William,6,0,20,14
1713498145399,CAT 125RS,A01,515971,Geibel; William,6,0,20,14
1713498146428,CLRE 250,A00,511389,Morris; Sheldon,9996,0,9999,3
1713498147458,CLRE 251,A00,507176,Mehta; Ravindra L.,9996,0,9999,3
1713498147458,CLRE 251,B00,511410,Mehta; Ravindra L.,9998,0,9999,1
1713498148486,CLRE 252,A00,507189,Cuomo; Raphael Eduardo,9998,0,9999,1
1713498149511,CLRE 253,A00,507199,Vaida; Florin,9997,0,9999,2
1713498149511,CLRE 253,B00,507202,Vaida; Florin,9999,0,9999,0
1713498150538,CLRE 259,A00,507211,Patel; Hemal,9996,0,9999,3
1713498151566,CLRE 260,A00,507221,Cuomo; Raphael Eduardo,9999,0,9999,0
1713498152591,CLRE 297,001,507242,Cuomo; Raphael Eduardo,9999,0,9999,0
1713498153620,CSE 191,A00,516875,Minnes Kemp; Mor Mia,9999,0,9999,0
1713498154643,CSS 201S,A01,494383,Staff,35,0,35,0
1713498155672,CSS 202S,A01,494387,Staff,35,0,35,0
1713498156696,EAP 100,A00,516065,Staff,9792,0,9999,207
1713498157723,ECE 45,A01,507414,Staff,37,0,60,23
1713498158749,ECE 100,A01,507416,Baghdadchi; Saharnaz,0,0,20,20
1713498158749,ECE 100,A02,507418,Baghdadchi; Saharnaz,19,0,20,1
1713498159774,ECE 111,A01,507420,Staff,27,0,50,23
1713498160799,ECE 197,001,548057,Sievenpiper; Daniel F.,9998,0,9999,1
1713498161828,EDS 115,A00,507243,Choi; Bailey Miyeon,27,0,28,1
1713498162854,EDS 117,A01,494379,Staff,15,0,25,10
1713498163883,EDS 125,A00,507246,Hopkins; Megan Beth,27,0,30,3
1713498164912,EDS 128A,A01,507264,Fargason; Sharon Gayle,26,0,26,0
1713498165937,EDS 128B,A01,507293,Pappas; Elizabeth,30,0,30,0
1713498166962,EDS 139,A00,507294,Fargason; Sharon Gayle,30,0,30,0
1713498166962,EDS 139,B00,507313,Pappas; Elizabeth,30,0,30,0
1713498167987,EDS 201,A00,507315,Staff,18,0,30,12
1713498169016,EDS 203,A01,507317,Halter; Christopher P.,17,0,30,13
1713498170043,EDS 204R,A01,507319,Halter; Christopher P.,0,1,30,30
1713498170043,EDS 204R,B01,507331,Heinzman; Erica M.,22,0,30,8
1713498171071,EDS 206R,A00,507332,Staff,0,2,30,30
1713498171071,EDS 206R,B00,507343,Staff,23,0,30,7
1713498172096,EDS 250,A00,507344,Hemans; Patricia Ann Benitez,27,0,40,13
1713498173125,EDS 281,A00,507345,Daly; Alan J.,18,0,18,0
1713498174149,EDS 284,A00,507350,Daly; Alan J.,16,0,16,0
1713498175176,EDS 286,A00,507359,Fine; Sarah,18,0,18,0
1713498176201,EDS 289C,A01,507361,Daly; Alan J.,18,0,18,0
1713498177226,EDS 290,A00,507366,Hofstetter; Carolyn,15,0,15,0
1713498178251,LIGM 5A,A00,507421,Fischer-Grunski; Eva K,20,0,20,0
1713498179282,LIGM 5B,A00,507423,Fischer-Grunski; Eva K,20,0,20,0
1713498180314,LIGM 5C,A00,507425,Fischer-Grunski; Eva K,20,0,20,0
1713498181344,LIIT 5AS,A00,507427,Carnelos; Chiara,20,0,20,0
1713498182375,LIIT 5BS,A00,507430,Carnelos; Chiara,20,0,20,0
1713498183401,LIIT 5CS,A00,507432,Carnelos; Chiara,20,0,20,0
1713498184427,LISP 5A,A00,507541,Munoz Sanchez; Alicia,14,0,20,6
1713498185453,LISP 5B,A00,507671,Munoz Sanchez; Alicia,12,0,20,8
1713498186482,LISP 5C,A00,507696,Munoz Sanchez; Alicia,11,0,20,9
1713498187508,MAE 197,001,528363,Boechler; Nicholas Sebastia,9998,0,9999,1
1713498188534,MATH 197,001,523477,Kedlaya; Kiran S.,9999,0,9999,0
1713498188534,MATH 197,002,563811,Zhang; Danna,9998,0,9999,1
1713498189563,MCWP 40R,A00,518780,Staff,14,0,20,6
1713498189563,MCWP 40R,B00,518781,Staff,12,0,20,8
1713498189563,MCWP 40R,C00,518783,Staff,9,0,20,11
1713498190663,MCWP 50R,A00,518791,Staff,7,0,20,13
1713498190663,MCWP 50R,B00,518792,Staff,3,0,20,17
1713498190663,MCWP 50R,C00,518793,Staff,7,0,20,13
1713498190663,MCWP 50R,D00,518794,Staff,0,0,20,20
1713498190663,MCWP 50R,E00,518795,Staff,0,0,20,20
1713498190663,MCWP 50R,F00,518796,Staff,11,0,20,9
1713498190663,MCWP 50R,G00,518797,Staff,10,0,20,10
1713498191689,MMW 12R,A01,514034,Herbst; Matthew,4,0,16,12
1713498191689,MMW 12R,A02,514035,Herbst; Matthew,13,0,16,3
1713498192713,MMW 13R,A01,514037,Staff,0,8,16,16
1713498192713,MMW 13R,A02,514039,Staff,0,6,16,16
1713498194767,SIO 295LS,A00,523233,Staff,15,0,30,15
1713498195796,SIO 295S,A00,523232,Staff,15,0,30,15
1713498196824,SOCI 117,A01,494376,Staff,0,2,5,5
1713498197852,WES 237B,A00,494380,Staff,19,0,20,1
1713498199913,AESE 279B,A00,494370,Wade; Jon P,33,0,33,0
1713498200942,AIP 197,001,627712,Vespa; Emanuel Ignacio,9999,0,9999,0
1713498201971,ANAR 135S,A00,494369,Braswell; Geoffrey E.,0,0,0,0
1713498202999,CAT 124RS,A01,519847,Geibel; William,6,0,20,14
1713498204028,CAT 125RS,A01,515971,Geibel; William,6,0,20,14
1713498205054,CLRE 250,A00,511389,Morris; Sheldon,9996,0,9999,3
1713498206085,CLRE 251,A00,507176,Mehta; Ravindra L.,9996,0,9999,3
1713498206085,CLRE 251,B00,511410,Mehta; Ravindra L.,9998,0,9999,1
1713498207109,CLRE 252,A00,507189,Cuomo; Raphael Eduardo,9998,0,9999,1
1713498208139,CLRE 253,A00,507199,Vaida; Florin,9997,0,9999,2
1713498208139,CLRE 253,B00,507202,Vaida; Florin,9999,0,9999,0
1713498209167,CLRE 259,A00,507211,Patel; Hemal,9996,0,9999,3
1713498210192,CLRE 260,A00,507221,Cuomo; Raphael Eduardo,9999,0,9999,0
1713498211219,CLRE 297,001,507242,Cuomo; Raphael Eduardo,9999,0,9999,0
1713498212249,CSE 191,A00,516875,Minnes Kemp; Mor Mia,9999,0,9999,0
1713498213277,CSS 201S,A01,494383,Staff,35,0,35,0
1713498214303,CSS 202S,A01,494387,Staff,35,0,35,0
1713498215328,EAP 100,A00,516065,Staff,9792,0,9999,207
1713498216357,ECE 45,A01,507414,Staff,37,0,60,23
1713498217388,ECE 100,A01,507416,Baghdadchi; Saharnaz,0,0,20,20
1713498217388,ECE 100,A02,507418,Baghdadchi; Saharnaz,19,0,20,1
1713498218414,ECE 111,A01,507420,Staff,27,0,50,23
1713498219439,ECE 197,001,548057,Sievenpiper; Daniel F.,9998,0,9999,1
1713498220463,EDS 115,A00,507243,Choi; Bailey Miyeon,27,0,28,1
1713498221494,EDS 117,A01,494379,Staff,15,0,25,10
1713498222524,EDS 125,A00,507246,Hopkins; Megan Beth,27,0,30,3
1713498223553,EDS 128A,A01,507264,Fargason; Sharon Gayle,26,0,26,0
1713498224579,EDS 128B,A01,507293,Pappas; Elizabeth,30,0,30,0
1713498225603,EDS 139,A00,507294,Fargason; Sharon Gayle,30,0,30,0
1713498225603,EDS 139,B00,507313,Pappas; Elizabeth,30,0,30,0
1713498226634,EDS 201,A00,507315,Staff,18,0,30,12
1713498227657,EDS 203,A01,507317,Halter; Christopher P.,17,0,30,13
1713498228682,EDS 204R,A01,507319,Halter; Christopher P.,0,1,30,30
1713498228682,EDS 204R,B01,507331,Heinzman; Erica M.,22,0,30,8
1713498229709,EDS 206R,A00,507332,Staff,0,2,30,30
1713498229709,EDS 206R,B00,507343,Staff,23,0,30,7
1713498230739,EDS 250,A00,507344,Hemans; Patricia Ann Benitez,27,0,40,13
1713498231768,EDS 281,A00,507345,Daly; Alan J.,18,0,18,0
1713498232794,EDS 284,A00,507350,Daly; Alan J.,16,0,16,0
1713498233822,EDS 286,A00,507359,Fine; Sarah,18,0,18,0
1713498234848,EDS 289C,A01,507361,Daly; Alan J.,18,0,18,0
1713498235874,EDS 290,A00,507366,Hofstetter; Carolyn,15,0,15,0
1713498236904,LIGM 5A,A00,507421,Fischer-Grunski; Eva K,20,0,20,0
1713498237933,LIGM 5B,A00,507423,Fischer-Grunski; Eva K,20,0,20,0
1713498238958,LIGM 5C,A00,507425,Fischer-Grunski; Eva K,20,0,20,0
1713498239984,LIIT 5AS,A00,507427,Carnelos; Chiara,20,0,20,0
1713498241011,LIIT 5BS,A00,507430,Carnelos; Chiara,20,0,20,0
1713498242041,LIIT 5CS,A00,507432,Carnelos; Chiara,20,0,20,0
1713498243068,LISP 5A,A00,507541,Munoz Sanchez; Alicia,14,0,20,6
1713498244098,LISP 5B,A00,507671,Munoz Sanchez; Alicia,12,0,20,8
1713498245123,LISP 5C,A00,507696,Munoz Sanchez; Alicia,11,0,20,9
1713498246151,MAE 197,001,528363,Boechler; Nicholas Sebastia,9998,0,9999,1
1713498247181,MATH 197,001,523477,Kedlaya; Kiran S.,9999,0,9999,0
1713498247181,MATH 197,002,563811,Zhang; Danna,9998,0,9999,1
1713498248204,MCWP 40R,A00,518780,Staff,14,0,20,6
1713498248204,MCWP 40R,B00,518781,Staff,12,0,20,8
1713498248204,MCWP 40R,C00,518783,Staff,9,0,20,11
1713498249235,MCWP 50R,A00,518791,Staff,7,0,20,13
1713498249235,MCWP 50R,B00,518792,Staff,3,0,20,17
1713498249235,MCWP 50R,C00,518793,Staff,7,0,20,13
1713498249235,MCWP 50R,D00,518794,Staff,0,0,20,20
1713498249235,MCWP 50R,E00,518795,Staff,0,0,20,20
1713498249235,MCWP 50R,F00,518796,Staff,11,0,20,9
1713498249235,MCWP 50R,G00,518797,Staff,10,0,20,10
1713498250261,MMW 12R,A01,514034,Herbst; Matthew,4,0,16,12
1713498250261,MMW 12R,A02,514035,Herbst; Matthew,13,0,16,3
1713498251290,MMW 13R,A01,514037,Staff,0,8,16,16
1713498251290,MMW 13R,A02,514039,Staff,0,6,16,16
1713498253344,SIO 295LS,A00,523233,Staff,15,0,30,15
1713498254373,SIO 295S,A00,523232,Staff,15,0,30,15
1713498255399,SOCI 117,A01,494376,Staff,0,2,5,5
1713498256424,WES 237B,A00,494380,Staff,19,0,20,1
1713498258482,AESE 279B,A00,494370,Wade; Jon P,33,0,33,0
1713498259510,AIP 197,001,627712,Vespa; Emanuel Ignacio,9999,0,9999,0
1713498260538,ANAR 135S,A00,494369,Braswell; Geoffrey E.,0,0,0,0
1713498261563,CAT 124RS,A01,519847,Geibel; William,6,0,20,14
1713498262588,CAT 125RS,A01,515971,Geibel; William,6,0,20,14
1713498263612,CLRE 250,A00,511389,Morris; Sheldon,9996,0,9999,3
1713498264641,CLRE 251,A00,507176,Mehta; Ravindra L.,9996,0,9999,3
1713498264641,CLRE 251,B00,511410,Mehta; Ravindra L.,9998,0,9999,1
1713498265671,CLRE 252,A00,507189,Cuomo; Raphael Eduardo,9998,0,9999,1
1713498266701,CLRE 253,A00,507199,Vaida; Florin,9997,0,9999,2
1713498266701,CLRE 253,B00,507202,Vaida; Florin,9999,0,9999,0
1713498267726,CLRE 259,A00,507211,Patel; Hemal,9996,0,9999,3
1713498268753,CLRE 260,A00,507221,Cuomo; Raphael Eduardo,9999,0,9999,0
1713498269781,CLRE 297,001,507242,Cuomo; Raphael Eduardo,9999,0,9999,0
1713498270810,CSE 191,A00,516875,Minnes Kemp; Mor Mia,9999,0,9999,0
1713498271841,CSS 201S,A01,494383,Staff,35,0,35,0
1713498272866,CSS 202S,A01,494387,Staff,35,0,35,0
1713498273890,EAP 100,A00,516065,Staff,9792,0,9999,207
1713498274920,ECE 45,A01,507414,Staff,37,0,60,23
1713498275946,ECE 100,A01,507416,Baghdadchi; Saharnaz,0,0,20,20
1713498275946,ECE 100,A02,507418,Baghdadchi; Saharnaz,19,0,20,1
1713498276975,ECE 111,A01,507420,Staff,27,0,50,23
1713498278006,ECE 197,001,548057,Sievenpiper; Daniel F.,9998,0,9999,1
1713498279030,EDS 115,A00,507243,Choi; Bailey Miyeon,27,0,28,1
1713498280056,EDS 117,A01,494379,Staff,15,0,25,10
1713498281082,EDS 125,A00,507246,Hopkins; Megan Beth,27,0,30,3
1713498282106,EDS 128A,A01,507264,Fargason; Sharon Gayle,26,0,26,0
1713498283136,EDS 128B,A01,507293,Pappas; Elizabeth,30,0,30,0
1713498284164,EDS 139,A00,507294,Fargason; Sharon Gayle,30,0,30,0
1713498284164,EDS 139,B00,507313,Pappas; Elizabeth,30,0,30,0
1713498285190,EDS 201,A00,507315,Staff,18,0,30,12
1713498286216,EDS 203,A01,507317,Halter; Christopher P.,17,0,30,13
1713498287246,EDS 204R,A01,507319,Halter; Christopher P.,0,1,30,30
1713498287246,EDS 204R,B01,507331,Heinzman; Erica M.,22,0,30,8
1713498288271,EDS 206R,A00,507332,Staff,0,2,30,30
1713498288271,EDS 206R,B00,507343,Staff,23,0,30,7
1713498289302,EDS 250,A00,507344,Hemans; Patricia Ann Benitez,27,0,40,13
1713498290328,EDS 281,A00,507345,Daly; Alan J.,18,0,18,0
1713498291353,EDS 284,A00,507350,Daly; Alan J.,16,0,16,0
1713498292378,EDS 286,A00,507359,Fine; Sarah,18,0,18,0
1713498293402,EDS 289C,A01,507361,Daly; Alan J.,18,0,18,0
1713498294483,EDS 290,A00,507366,Hofstetter; Carolyn,15,0,15,0
1713498295507,LIGM 5A,A00,507421,Fischer-Grunski; Eva K,20,0,20,0
1713498296537,LIGM 5B,A00,507423,Fischer-Grunski; Eva K,20,0,20,0
1713498297566,LIGM 5C,A00,507425,Fischer-Grunski; Eva K,20,0,20,0
1713498298591,LIIT 5AS,A00,507427,Carnelos; Chiara,20,0,20,0
1713498299618,LIIT 5BS,A00,507430,Carnelos; Chiara,20,0,20,0
1713498300642,LIIT 5CS,A00,507432,Carnelos; Chiara,20,0,20,0
1713498301668,LISP 5A,A00,507541,Munoz Sanchez; Alicia,14,0,20,6
1713498302698,LISP 5B,A00,507671,Munoz Sanchez; Alicia,12,0,20,8
1713498303723,LISP 5C,A00,507696,Munoz Sanchez; Alicia,11,0,20,9
1713498304752,MAE 197,001,528363,Boechler; Nicholas Sebastia,9998,0,9999,1
1713498305780,MATH 197,001,523477,Kedlaya; Kiran S.,9999,0,9999,0
1713498305780,MATH 197,002,563811,Zhang; Danna,9998,0,9999,1
1713498306809,MCWP 40R,A00,518780,Staff,14,0,20,6
1713498306809,MCWP 40R,B00,518781,Staff,12,0,20,8
1713498306809,MCWP 40R,C00,518783,Staff,9,0,20,11
1713498307840,MCWP 50R,A00,518791,Staff,7,0,20,13
1713498307840,MCWP 50R,B00,518792,Staff,3,0,20,17
1713498307840,MCWP 50R,C00,518793,Staff,7,0,20,13
1713498307840,MCWP 50R,D00,518794,Staff,0,0,20,20
1713498307840,MCWP 50R,E00,518795,Staff,0,0,20,20
1713498307840,MCWP 50R,F00,518796,Staff,11,0,20,9
1713498307840,MCWP 50R,G00,518797,Staff,10,0,20,10
1713498308869,MMW 12R,A01,514034,Herbst; Matthew,4,0,16,12
1713498308869,MMW 12R,A02,514035,Herbst; Matthew,13,0,16,3
1713498309895,MMW 13R,A01,514037,Staff,0,8,16,16
1713498309895,MMW 13R,A02,514039,Staff,0,6,16,16
1713498311950,SIO 295LS,A00,523233,Staff,15,0,30,15
1713498312976,SIO 295S,A00,523232,Staff,15,0,30,15
1713498314000,SOCI 117,A01,494376,Staff,0,2,5,5
1713498315024,WES 237B,A00,494380,Staff,19,0,20,1
1713498317091,AESE 279B,A00,494370,Wade; Jon P,33,0,33,0
1713498318118,AIP 197,001,627712,Vespa; Emanuel Ignacio,9999,0,9999,0
1713498319146,ANAR 135S,A00,494369,Braswell; Geoffrey E.,0,0,0,0
1713498320172,CAT 124RS,A01,519847,Geibel; William,6,0,20,14
1713498321197,CAT 125RS,A01,515971,Geibel; William,6,0,20,14
1713498322222,CLRE 250,A00,511389,Morris; Sheldon,9996,0,9999,3
1713498323253,CLRE 251,A00,507176,Mehta; Ravindra L.,9996,0,9999,3
1713498323253,CLRE 251,B00,511410,Mehta; Ravindra L.,9998,0,9999,1
1713498324282,CLRE 252,A00,507189,Cuomo; Raphael Eduardo,9998,0,9999,1
1713498325312,CLRE 253,A00,507199,Vaida; Florin,9997,0,9999,2
1713498325312,CLRE 253,B00,507202,Vaida; Florin,9999,0,9999,0
1713498326337,CLRE 259,A00,507211,Patel; Hemal,9996,0,9999,3
1713498327363,CLRE 260,A00,507221,Cuomo; Raphael Eduardo,9999,0,9999,0
1713498328389,CLRE 297,001,507242,Cuomo; Raphael Eduardo,9999,0,9999,0
1713498329418,CSE 191,A00,516875,Minnes Kemp; Mor Mia,9999,0,9999,0
1713498330448,CSS 201S,A01,494383,Staff,35,0,35,0
1713498331474,CSS 202S,A01,494387,Staff,35,0,35,0
1713498332503,EAP 100,A00,516065,Staff,9792,0,9999,207
1713498333531,ECE 45,A01,507414,Staff,37,0,60,23
1713498334558,ECE 100,A01,507416,Baghdadchi; Saharnaz,0,0,20,20
1713498334558,ECE 100,A02,507418,Baghdadchi; Saharnaz,19,0,20,1
1713498335582,ECE 111,A01,507420,Staff,27,0,50,23
1713498336617,ECE 197,001,548057,Sievenpiper; Daniel F.,9998,0,9999,1
1713498337641,EDS 115,A00,507243,Choi; Bailey Miyeon,27,0,28,1
1713498338671,EDS 117,A01,494379,Staff,15,0,25,10
1713498339697,EDS 125,A00,507246,Hopkins; Megan Beth,27,0,30,3
1713498340725,EDS 128A,A01,507264,Fargason; Sharon Gayle,26,0,26,0
1713498341753,EDS 128B,A01,507293,Pappas; Elizabeth,30,0,30,0
1713498342780,EDS 139,A00,507294,Fargason; Sharon Gayle,30,0,30,0
1713498342780,EDS 139,B00,507313,Pappas; Elizabeth,30,0,30,0
1713498343805,EDS 201,A00,507315,Staff,18,0,30,12
1713498344834,EDS 203,A01,507317,Halter; Christopher P.,17,0,30,13
1713498345860,EDS 204R,A01,507319,Halter; Christopher P.,0,1,30,30
1713498345860,EDS 204R,B01,507331,Heinzman; Erica M.,22,0,30,8
1713498346888,EDS 206R,A00,507332,Staff,0,2,30,30
1713498346888,EDS 206R,B00,507343,Staff,23,0,30,7
1713498347914,EDS 250,A00,507344,Hemans; Patricia Ann Benitez,27,0,40,13
1713498348944,EDS 281,A00,507345,Daly; Alan J.,18,0,18,0
1713498349970,EDS 284,A00,507350,Daly; Alan J.,16,0,16,0
1713498350999,EDS 286,A00,507359,Fine; Sarah,18,0,18,0
1713498352024,EDS 289C,A01,507361,Daly; Alan J.,18,0,18,0
1713498353053,EDS 290,A00,507366,Hofstetter; Carolyn,15,0,15,0
1713498354078,LIGM 5A,A00,507421,Fischer-Grunski; Eva K,20,0,20,0
1713498355151,LIGM 5B,A00,507423,Fischer-Grunski; Eva K,20,0,20,0
1713498356177,LIGM 5C,A00,507425,Fischer-Grunski; Eva K,20,0,20,0
1713498357207,LIIT 5AS,A00,507427,Carnelos; Chiara,20,0,20,0
1713498358232,LIIT 5BS,A00,507430,Carnelos; Chiara,20,0,20,0
1713498359261,LIIT 5CS,A00,507432,Carnelos; Chiara,20,0,20,0
1713498360292,LISP 5A,A00,507541,Munoz Sanchez; Alicia,14,0,20,6
1713498361318,LISP 5B,A00,507671,Munoz Sanchez; Alicia,12,0,20,8
1713498362343,LISP 5C,A00,507696,Munoz Sanchez; Alicia,11,0,20,9
1713498363368,MAE 197,001,528363,Boechler; Nicholas Sebastia,9998,0,9999,1
1713498364394,MATH 197,001,523477,Kedlaya; Kiran S.,9999,0,9999,0
1713498364394,MATH 197,002,563811,Zhang; Danna,9998,0,9999,1
1713498365420,MCWP 40R,A00,518780,Staff,14,0,20,6
1713498365420,MCWP 40R,B00,518781,Staff,12,0,20,8
1713498365420,MCWP 40R,C00,518783,Staff,9,0,20,11
1713498366445,MCWP 50R,A00,518791,Staff,7,0,20,13
1713498366445,MCWP 50R,B00,518792,Staff,3,0,20,17
1713498366445,MCWP 50R,C00,518793,Staff,7,0,20,13
1713498366445,MCWP 50R,D00,518794,Staff,0,0,20,20
1713498366445,MCWP 50R,E00,518795,Staff,0,0,20,20
1713498366445,MCWP 50R,F00,518796,Staff,11,0,20,9
1713498366445,MCWP 50R,G00,518797,Staff,10,0,20,10
1713498367470,MMW 12R,A01,514034,Herbst; Matthew,4,0,16,12
1713498367470,MMW 12R,A02,514035,Herbst; Matthew,13,0,16,3
1713498368494,MMW 13R,A01,514037,Staff,0,8,16,16
1713498368494,MMW 13R,A02,514039,Staff,0,6,16,16
1713498370549,SIO 295LS,A00,523233,Staff,15,0,30,15
1713498371577,SIO 295S,A00,523232,Staff,15,0,30,15
1713498372602,SOCI 117,A01,494376,Staff,0,2,5,5
1713498373626,WES 237B,A00,494380,Staff,19,0,20,1
1713498375699,AESE 279B,A00,494370,Wade; Jon P,33,0,33,0
1713498376725,AIP 197,001,627712,Vespa; Emanuel Ignacio,9999,0,9999,0
1713498377750,ANAR 135S,A00,494369,Braswell; Geoffrey E.,0,0,0,0
1713498378775,CAT 124RS,A01,519847,Geibel; William,6,0,20,14
1713498379803,CAT 125RS,A01,515971,Geibel; William,6,0,20,14
1713498380835,CLRE 250,A00,511389,Morris; Sheldon,9996,0,9999,3
1713498381860,CLRE 251,A00,507176,Mehta; Ravindra L.,9996,0,9999,3
1713498381860,CLRE 251,B00,511410,Mehta; Ravindra L.,9998,0,9999,1
1713498382886,CLRE 252,A00,507189,Cuomo; Raphael Eduardo,9998,0,9999,1
1713498383911,CLRE 253,A00,507199,Vaida; Florin,9997,0,9999,2
1713498383911,CLRE 253,B00,507202,Vaida; Florin,9999,0,9999,0
1713498384940,CLRE 259,A00,507211,Patel; Hemal,9996,0,9999,3
1713498385968,CLRE 260,A00,507221,Cuomo; Raphael Eduardo,9999,0,9999,0
1713498386992,CLRE 297,001,507242,Cuomo; Raphael Eduardo,9999,0,9999,0
1713498388023,CSE 191,A00,516875,Minnes Kemp; Mor Mia,9999,0,9999,0
1713498389052,CSS 201S,A01,494383,Staff,35,0,35,0
1713498390082,CSS 202S,A01,494387,Staff,35,0,35,0
1713498391109,EAP 100,A00,516065,Staff,9792,0,9999,207
1713498392133,ECE 45,A01,507414,Staff,37,0,60,23
1713498393159,ECE 100,A01,507416,Baghdadchi; Saharnaz,0,0,20,20
1713498393159,ECE 100,A02,507418,Baghdadchi; Saharnaz,19,0,20,1
1713498394183,ECE 111,A01,507420,Staff,27,0,50,23
1713498395211,ECE 197,001,548057,Sievenpiper; Daniel F.,9998,0,9999,1
1713498396240,EDS 115,A00,507243,Choi; Bailey Miyeon,27,0,28,1
1713498397267,EDS 117,A01,494379,Staff,15,0,25,10
1713498398349,EDS 125,A00,507246,Hopkins; Megan Beth,27,0,30,3
1713498399374,EDS 128A,A01,507264,Fargason; Sharon Gayle,26,0,26,0
1713498400400,EDS 128B,A01,507293,Pappas; Elizabeth,30,0,30,0
1713498401426,EDS 139,A00,507294,Fargason; Sharon Gayle,30,0,30,0
1713498401426,EDS 139,B00,507313,Pappas; Elizabeth,30,0,30,0
1713498402451,EDS 201,A00,507315,Staff,18,0,30,12
1713498403476,EDS 203,A01,507317,Halter; Christopher P.,17,0,30,13
1713498404507,EDS 204R,A01,507319,Halter; Christopher P.,0,1,30,30
1713498404507,EDS 204R,B01,507331,Heinzman; Erica M.,22,0,30,8
1713498405535,EDS 206R,A00,507332,Staff,0,2,30,30
1713498405535,EDS 206R,B00,507343,Staff,23,0,30,7
1713498406561,EDS 250,A00,507344,Hemans; Patricia Ann Benitez,27,0,40,13
1713498407585,EDS 281,A00,507345,Daly; Alan J.,18,0,18,0
1713498408613,EDS 284,A00,507350,Daly; Alan J.,16,0,16,0
1713498409646,EDS 286,A00,507359,Fine; Sarah,18,0,18,0
1713498410671,EDS 289C,A01,507361,Daly; Alan J.,18,0,18,0
1713498411696,EDS 290,A00,507366,Hofstetter; Carolyn,15,0,15,0
1713498412725,LIGM 5A,A00,507421,Fischer-Grunski; Eva K,20,0,20,0
1713498413754,LIGM 5B,A00,507423,Fischer-Grunski; Eva K,20,0,20,0
1713498414779,LIGM 5C,A00,507425,Fischer-Grunski; Eva K,20,0,20,0
1713498415810,LIIT 5AS,A00,507427,Carnelos; Chiara,20,0,20,0
1713498416835,LIIT 5BS,A00,507430,Carnelos; Chiara,20,0,20,0
1713498417861,LIIT 5CS,A00,507432,Carnelos; Chiara,20,0,20,0
1713498418890,LISP 5A,A00,507541,Munoz Sanchez; Alicia,14,0,20,6
1713498419920,LISP 5B,A00,507671,Munoz Sanchez; Alicia,12,0,20,8
1713498420945,LISP 5C,A00,507696,Munoz Sanchez; Alicia,11,0,20,9
1713498421971,MAE 197,001,528363,Boechler; Nicholas Sebastia,9998,0,9999,1
1713498422999,MATH 197,001,523477,Kedlaya; Kiran S.,9999,0,9999,0
1713498422999,MATH 197,002,563811,Zhang; Danna,9998,0,9999,1
1713498424025,MCWP 40R,A00,518780,Staff,14,0,20,6
1713498424025,MCWP 40R,B00,518781,Staff,12,0,20,8
1713498424025,MCWP 40R,C00,518783,Staff,9,0,20,11
1713498425051,MCWP 50R,A00,518791,Staff,7,0,20,13
1713498425051,MCWP 50R,B00,518792,Staff,3,0,20,17
1713498425051,MCWP 50R,C00,518793,Staff,7,0,20,13
1713498425051,MCWP 50R,D00,518794,Staff,0,0,20,20
1713498425051,MCWP 50R,E00,518795,Staff,0,0,20,20
1713498425051,MCWP 50R,F00,518796,Staff,11,0,20,9
1713498425051,MCWP 50R,G00,518797,Staff,10,0,20,10
1713498426076,MMW 12R,A01,514034,Herbst; Matthew,4,0,16,12
1713498426076,MMW 12R,A02,514035,Herbst; Matthew,13,0,16,3
1713498427102,MMW 13R,A01,514037,Staff,0,8,16,16
1713498427102,MMW 13R,A02,514039,Staff,0,6,16,16
1713498429152,SIO 295LS,A00,523233,Staff,15,0,30,15
1713498430177,SIO 295S,A00,523232,Staff,15,0,30,15
1713498431206,SOCI 117,A01,494376,Staff,0,2,5,5
1713498432231,WES 237B,A00,494380,Staff,19,0,20,1
1713498434293,AESE 279B,A00,494370,Wade; Jon P,33,0,33,0
1713498435321,AIP 197,001,627712,Vespa; Emanuel Ignacio,9999,0,9999,0
1713498436350,ANAR 135S,A00,494369,Braswell; Geoffrey E.,0,0,0,0
1713498437380,CAT 124RS,A01,519847,Geibel; William,6,0,20,14
1713498438406,CAT 125RS,A01,515971,Geibel; William,6,0,20,14
1713498439434,CLRE 250,A00,511389,Morris; Sheldon,9996,0,9999,3
1713498440461,CLRE 251,A00,507176,Mehta; Ravindra L.,9996,0,9999,3
1713498440461,CLRE 251,B00,511410,Mehta; Ravindra L.,9998,0,9999,1
1713498441486,CLRE 252,A00,507189,Cuomo; Raphael Eduardo,9998,0,9999,1
1713498442516,CLRE 253,A00,507199,Vaida; Florin,9997,0,9999,2
1713498442516,CLRE 253,B00,507202,Vaida; Florin,9999,0,9999,0
1713498443540,CLRE 259,A00,507211,Patel; Hemal,9996,0,9999,3
1713498444565,CLRE 260,A00,507221,Cuomo; Raphael Eduardo,9999,0,9999,0
1713498445592,CLRE 297,001,507242,Cuomo; Raphael Eduardo,9999,0,9999,0
1713498446618,CSE 191,A00,516875,Minnes Kemp; Mor Mia,9999,0,9999,0
1713498447642,CSS 201S,A01,494383,Staff,35,0,35,0
1713498448671,CSS 202S,A01,494387,Staff,35,0,35,0
1713498449697,EAP 100,A00,516065,Staff,9792,0,9999,207
1713498450727,ECE 45,A01,507414,Staff,37,0,60,23
1713498451751,ECE 100,A01,507416,Baghdadchi; Saharnaz,0,0,20,20
1713498451751,ECE 100,A02,507418,Baghdadchi; Saharnaz,19,0,20,1
1713498452775,ECE 111,A01,507420,Staff,27,0,50,23
1713498453801,ECE 197,001,548057,Sievenpiper; Daniel F.,9998,0,9999,1
1713498454826,EDS 115,A00,507243,Choi; Bailey Miyeon,27,0,28,1
1713498455852,EDS 117,A01,494379,Staff,15,0,25,10
1713498456878,EDS 125,A00,507246,Hopkins; Megan Beth,27,0,30,3
1713498457904,EDS 128A,A01,507264,Fargason; Sharon Gayle,26,0,26,0
1713498458930,EDS 128B,A01,507293,Pappas; Elizabeth,30,0,30,0
1713498459961,EDS 139,A00,507294,Fargason; Sharon Gayle,30,0,30,0
1713498459961,EDS 139,B00,507313,Pappas; Elizabeth,30,0,30,0
1713498460989,EDS 201,A00,507315,Staff,18,0,30,12
1713498462014,EDS 203,A01,507317,Halter; Christopher P.,17,0,30,13
1713498463043,EDS 204R,A01,507319,Halter; Christopher P.,0,1,30,30
1713498463043,EDS 204R,B01,507331,Heinzman; Erica M.,22,0,30,8
1713498464068,EDS 206R,A00,507332,Staff,0,2,30,30
1713498464068,EDS 206R,B00,507343,Staff,23,0,30,7
1713498465096,EDS 250,A00,507344,Hemans; Patricia Ann Benitez,27,0,40,13
1713498466121,EDS 281,A00,507345,Daly; Alan J.,18,0,18,0
1713498467149,EDS 284,A00,507350,Daly; Alan J.,16,0,16,0
1713498468174,EDS 286,A00,507359,Fine; Sarah,18,0,18,0
1713498469198,EDS 289C,A01,507361,Daly; Alan J.,18,0,18,0
1713498470227,EDS 290,A00,507366,Hofstetter; Carolyn,15,0,15,0
1713498471254,LIGM 5A,A00,507421,Fischer-Grunski; Eva K,20,0,20,0
1713498472280,LIGM 5B,A00,507423,Fischer-Grunski; Eva K,20,0,20,0
1713498473306,LIGM 5C,A00,507425,Fischer-Grunski; Eva K,20,0,20,0
1713498474336,LIIT 5AS,A00,507427,Carnelos; Chiara,20,0,20,0
1713498475363,LIIT 5BS,A00,507430,Carnelos; Chiara,20,0,20,0
1713498476391,LIIT 5CS,A00,507432,Carnelos; Chiara,20,0,20,0
1713498477421,LISP 5A,A00,507541,Munoz Sanchez; Alicia,14,0,20,6
1713498478445,LISP 5B,A00,507671,Munoz Sanchez; Alicia,12,0,20,8
1713498479474,LISP 5C,A00,507696,Munoz Sanchez; Alicia,11,0,20,9
1713498480499,MAE 197,001,528363,Boechler; Nicholas Sebastia,9998,0,9999,1
1713498481578,MATH 197,001,523477,Kedlaya; Kiran S.,9999,0,9999,0
1713498481578,MATH 197,002,563811,Zhang; Danna,9998,0,9999,1
1713498482606,MCWP 40R,A00,518780,Staff,14,0,20,6
1713498482606,MCWP 40R,B00,518781,Staff,12,0,20,8
1713498482606,MCWP 40R,C00,518783,Staff,9,0,20,11
1713498483633,MCWP 50R,A00,518791,Staff,7,0,20,13
1713498483633,MCWP 50R,B00,518792,Staff,3,0,20,17
1713498483633,MCWP 50R,C00,518793,Staff,7,0,20,13
1713498483633,MCWP 50R,D00,518794,Staff,0,0,20,20
1713498483633,MCWP 50R,E00,518795,Staff,0,0,20,20
1713498483633,MCWP 50R,F00,518796,Staff,11,0,20,9
1713498483633,MCWP 50R,G00,518797,Staff,10,0,20,10
1713498484657,MMW 12R,A01,514034,Herbst; Matthew,4,0,16,12
1713498484657,MMW 12R,A02,514035,Herbst; Matthew,13,0,16,3
1713498485682,MMW 13R,A01,514037,Staff,0,8,16,16
1713498485682,MMW 13R,A02,514039,Staff,0,6,16,16
1713498487738,SIO 295LS,A00,523233,Staff,15,0,30,15
1713498488763,SIO 295S,A00,523232,Staff,15,0,30,15
1713498489790,SOCI 117,A01,494376,Staff,0,2,5,5
1713498490819,WES 237B,A00,494380,Staff,19,0,20,1
1713498492886,AESE 279B,A00,494370,Wade; Jon P,33,0,33,0
1713498493914,AIP 197,001,627712,Vespa; Emanuel Ignacio,9999,0,9999,0
1713498494940,ANAR 135S,A00,494369,Braswell; Geoffrey E.,0,0,0,0
1713498495969,CAT 124RS,A01,519847,Geibel; William,6,0,20,14
1713498496995,CAT 125RS,A01,515971,Geibel; William,6,0,20,14
1713498498038,CLRE 250,A00,511389,Morris; Sheldon,9996,0,9999,3
1713498499069,CLRE 251,A00,507176,Mehta; Ravindra L.,9996,0,9999,3
1713498499069,CLRE 251,B00,511410,Mehta; Ravindra L.,9998,0,9999,1
1713498500095,CLRE 252,A00,507189,Cuomo; Raphael Eduardo,9998,0,9999,1
1713498501121,CLRE 253,A00,507199,Vaida; Florin,9997,0,9999,2
1713498501121,CLRE 253,B00,507202,Vaida; Florin,9999,0,9999,0
1713498502206,CLRE 259,A00,507211,Patel; Hemal,9996,0,9999,3
1713498503231,CLRE 260,A00,507221,Cuomo; Raphael Eduardo,9999,0,9999,0
1713498504259,CLRE 297,001,507242,Cuomo; Raphael Eduardo,9999,0,9999,0
1713498505287,CSE 191,A00,516875,Minnes Kemp; Mor Mia,9999,0,9999,0
1713498506311,CSS 201S,A01,494383,Staff,35,0,35,0
1713498507339,CSS 202S,A01,494387,Staff,35,0,35,0
1713498508364,EAP 100,A00,516065,Staff,9792,0,9999,207
1713498509392,ECE 45,A01,507414,Staff,37,0,60,23
1713498510422,ECE 100,A01,507416,Baghdadchi; Saharnaz,0,0,20,20
1713498510422,ECE 100,A02,507418,Baghdadchi; Saharnaz,19,0,20,1
1713498511447,ECE 111,A01,507420,Staff,27,0,50,23
1713498512473,ECE 197,001,548057,Sievenpiper; Daniel F.,9998,0,9999,1
1713498513501,EDS 115,A00,507243,Choi; Bailey Miyeon,27,0,28,1
1713498514528,EDS 117,A01,494379,Staff,15,0,25,10
1713498515556,EDS 125,A00,507246,Hopkins; Megan Beth,27,0,30,3
1713498516583,EDS 128A,A01,507264,Fargason; Sharon Gayle,26,0,26,0
1713498517610,EDS 128B,A01,507293,Pappas; Elizabeth,30,0,30,0
1713498518633,EDS 139,A00,507294,Fargason; Sharon Gayle,30,0,30,0
1713498518633,EDS 139,B00,507313,Pappas; Elizabeth,30,0,30,0
1713498519661,EDS 201,A00,507315,Staff,18,0,30,12
1713498520685,EDS 203,A01,507317,Halter; Christopher P.,17,0,30,13
1713498521710,EDS 204R,A01,507319,Halter; Christopher P.,0,1,30,30
1713498521710,EDS 204R,B01,507331,Heinzman; Erica M.,22,0,30,8
1713498522736,EDS 206R,A00,507332,Staff,0,2,30,30
1713498522736,EDS 206R,B00,507343,Staff,23,0,30,7
1713498523762,EDS 250,A00,507344,Hemans; Patricia Ann Benitez,27,0,40,13
1713498524788,EDS 281,A00,507345,Daly; Alan J.,18,0,18,0
1713498525817,EDS 284,A00,507350,Daly; Alan J.,16,0,16,0
1713498526842,EDS 286,A00,507359,Fine; Sarah,18,0,18,0
1713498527871,EDS 289C,A01,507361,Daly; Alan J.,18,0,18,0
1713498528896,EDS 290,A00,507366,Hofstetter; Carolyn,15,0,15,0
1713498529926,LIGM 5A,A00,507421,Fischer-Grunski; Eva K,20,0,20,0
1713498530956,LIGM 5B,A00,507423,Fischer-Grunski; Eva K,20,0,20,0
1713498531981,LIGM 5C,A00,507425,Fischer-Grunski; Eva K,20,0,20,0
1713498533007,LIIT 5AS,A00,507427,Carnelos; Chiara,20,0,20,0
1713498534032,LIIT 5BS,A00,507430,Carnelos; Chiara,20,0,20,0
1713498535063,LIIT 5CS,A00,507432,Carnelos; Chiara,20,0,20,0
1713498536088,LISP 5A,A00,507541,Munoz Sanchez; Alicia,14,0,20,6
1713498537114,LISP 5B,A00,507671,Munoz Sanchez; Alicia,12,0,20,8
1713498538140,LISP 5C,A00,507696,Munoz Sanchez; Alicia,11,0,20,9
1713498539166,MAE 197,001,528363,Boechler; Nicholas Sebastia,9998,0,9999,1
1713498540198,MATH 197,001,523477,Kedlaya; Kiran S.,9999,0,9999,0
1713498540198,MATH 197,002,563811,Zhang; Danna,9998,0,9999,1
1713498541225,MCWP 40R,A00,518780,Staff,14,0,20,6
1713498541225,MCWP 40R,B00,518781,Staff,12,0,20,8
1713498541225,MCWP 40R,C00,518783,Staff,9,0,20,11
1713498542255,MCWP 50R,A00,518791,Staff,7,0,20,13
1713498542255,MCWP 50R,B00,518792,Staff,3,0,20,17
1713498542255,MCWP 50R,C00,518793,Staff,7,0,20,13
1713498542255,MCWP 50R,D00,518794,Staff,0,0,20,20
1713498542255,MCWP 50R,E00,518795,Staff,0,0,20,20
1713498542255,MCWP 50R,F00,518796,Staff,11,0,20,9
1713498542255,MCWP 50R,G00,518797,Staff,10,0,20,10
1713498543282,MMW 12R,A01,514034,Herbst; Matthew,4,0,16,12
1713498543282,MMW 12R,A02,514035,Herbst; Matthew,13,0,16,3
1713498544307,MMW 13R,A01,514037,Staff,0,8,16,16
1713498544307,MMW 13R,A02,514039,Staff,0,6,16,16
1713498546362,SIO 295LS,A00,523233,Staff,15,0,30,15
1713498547392,SIO 295S,A00,523232,Staff,15,0,30,15
1713498548418,SOCI 117,A01,494376,Staff,0,2,5,5
1713498549445,WES 237B,A00,494380,Staff,19,0,20,1
1713498551514,AESE 279B,A00,494370,Wade; Jon P,33,0,33,0
1713498552542,AIP 197,001,627712,Vespa; Emanuel Ignacio,9999,0,9999,0
1713498553567,ANAR 135S,A00,494369,Braswell; Geoffrey E.,0,0,0,0
1713498554590,CAT 124RS,A01,519847,Geibel; William,6,0,20,14
1713498555618,CAT 125RS,A01,515971,Geibel; William,6,0,20,14
1713498556647,CLRE 250,A00,511389,Morris; Sheldon,9996,0,9999,3
1713498557675,CLRE 251,A00,507176,Mehta; Ravindra L.,9996,0,9999,3
1713498557675,CLRE 251,B00,511410,Mehta; Ravindra L.,9998,0,9999,1
1713498558703,CLRE 252,A00,507189,Cuomo; Raphael Eduardo,9998,0,9999,1
1713498559730,CLRE 253,A00,507199,Vaida; Florin,9997,0,9999,2
1713498559730,CLRE 253,B00,507202,Vaida; Florin,9999,0,9999,0
1713498560759,CLRE 259,A00,507211,Patel; Hemal,9996,0,9999,3
1713498561784,CLRE 260,A00,507221,Cuomo; Raphael Eduardo,9999,0,9999,0
1713498562813,CLRE 297,001,507242,Cuomo; Raphael Eduardo,9999,0,9999,0
1713498563839,CSE 191,A00,516875,Minnes Kemp; Mor Mia,9999,0,9999,0
1713498564865,CSS 201S,A01,494383,Staff,35,0,35,0
1713498565896,CSS 202S,A01,494387,Staff,35,0,35,0
1713498566925,EAP 100,A00,516065,Staff,9792,0,9999,207
1713498567952,ECE 45,A01,507414,Staff,37,0,60,23
1713498568982,ECE 100,A01,507416,Baghdadchi; Saharnaz,0,0,20,20
1713498568982,ECE 100,A02,507418,Baghdadchi; Saharnaz,19,0,20,1
1713498570009,ECE 111,A01,507420,Staff,27,0,50,23
1713498571037,ECE 197,001,548057,Sievenpiper; Daniel F.,9998,0,9999,1
1713498572063,EDS 115,A00,507243,Choi; Bailey Miyeon,27,0,28,1
1713498573088,EDS 117,A01,494379,Staff,15,0,25,10
1713498574114,EDS 125,A00,507246,Hopkins; Megan Beth,27,0,30,3
1713498575143,EDS 128A,A01,507264,Fargason; Sharon Gayle,26,0,26,0
1713498576169,EDS 128B,A01,507293,Pappas; Elizabeth,30,0,30,0
1713498577199,EDS 139,A00,507294,Fargason; Sharon Gayle,30,0,30,0
1713498577199,EDS 139,B00,507313,Pappas; Elizabeth,30,0,30,0
1713498578226,EDS 201,A00,507315,Staff,18,0,30,12
1713498579253,EDS 203,A01,507317,Halter; Christopher P.,17,0,30,13
1713498580279,EDS 204R,A01,507319,Halter; Christopher P.,0,1,30,30
1713498580279,EDS 204R,B01,507331,Heinzman; Erica M.,22,0,30,8
1713498581307,EDS 206R,A00,507332,Staff,0,2,30,30
1713498581307,EDS 206R,B00,507343,Staff,23,0,30,7
1713498582332,EDS 250,A00,507344,Hemans; Patricia Ann Benitez,27,0,40,13
1713498583357,EDS 281,A00,507345,Daly; Alan J.,18,0,18,0
1713498584385,EDS 284,A00,507350,Daly; Alan J.,16,0,16,0
1713498585411,EDS 286,A00,507359,Fine; Sarah,18,0,18,0
1713498586436,EDS 289C,A01,507361,Daly; Alan J.,18,0,18,0
1713498587463,EDS 290,A00,507366,Hofstetter; Carolyn,15,0,15,0
1713498588492,LIGM 5A,A00,507421,Fischer-Grunski; Eva K,20,0,20,0
1713498589519,LIGM 5B,A00,507423,Fischer-Grunski; Eva K,20,0,20,0
1713498590545,LIGM 5C,A00,507425,Fischer-Grunski; Eva K,20,0,20,0
1713498591572,LIIT 5AS,A00,507427,Carnelos; Chiara,20,0,20,0
1713498592600,LIIT 5BS,A00,507430,Carnelos; Chiara,20,0,20,0
1713498593626,LIIT 5CS,A00,507432,Carnelos; Chiara,20,0,20,0
1713498594658,LISP 5A,A00,507541,Munoz Sanchez; Alicia,14,0,20,6
1713498595681,LISP 5B,A00,507671,Munoz Sanchez; Alicia,12,0,20,8
1713498596707,LISP 5C,A00,507696,Munoz Sanchez; Alicia,11,0,20,9
1713498597735,MAE 197,001,528363,Boechler; Nicholas Sebastia,9998,0,9999,1
1713498598761,MATH 197,001,523477,Kedlaya; Kiran S.,9999,0,9999,0
1713498598761,MATH 197,002,563811,Zhang; Danna,9998,0,9999,1
1713498599787,MCWP 40R,A00,518780,Staff,14,0,20,6
1713498599787,MCWP 40R,B00,518781,Staff,12,0,20,8
1713498599787,MCWP 40R,C00,518783,Staff,9,0,20,11
1713498600813,MCWP 50R,A00,518791,Staff,7,0,20,13
1713498600813,MCWP 50R,B00,518792,Staff,3,0,20,17
1713498600813,MCWP 50R,C00,518793,Staff,7,0,20,13
1713498600813,MCWP 50R,D00,518794,Staff,0,0,20,20
1713498600813,MCWP 50R,E00,518795,Staff,0,0,20,20
1713498600813,MCWP 50R,F00,518796,Staff,11,0,20,9
1713498600813,MCWP 50R,G00,518797,Staff,10,0,20,10
1713498601844,MMW 12R,A01,514034,Herbst; Matthew,4,0,16,12
1713498601844,MMW 12R,A02,514035,Herbst; Matthew,13,0,16,3
1713498602869,MMW 13R,A01,514037,Staff,0,8,16,16
1713498602869,MMW 13R,A02,514039,Staff,0,6,16,16
1713498604930,SIO 295LS,A00,523233,Staff,15,0,30,15
1713498606007,SIO 295S,A00,523232,Staff,15,0,30,15
1713498607044,SOCI 117,A01,494376,Staff,0,2,5,5
1713498608072,WES 237B,A00,494380,Staff,19,0,20,1
1713498610153,AESE 279B,A00,494370,Wade; Jon P,33,0,33,0
1713498611179,AIP 197,001,627712,Vespa; Emanuel Ignacio,9999,0,9999,0
1713498612205,ANAR 135S,A00,494369,Braswell; Geoffrey E.,0,0,0,0
1713498613236,CAT 124RS,A01,519847,Geibel; William,6,0,20,14
1713498614264,CAT 125RS,A01,515971,Geibel; William,6,0,20,14
1713498615289,CLRE 250,A00,511389,Morris; Sheldon,9996,0,9999,3
1713498616315,CLRE 251,A00,507176,Mehta; Ravindra L.,9996,0,9999,3
1713498616315,CLRE 251,B00,511410,Mehta; Ravindra L.,9998,0,9999,1
1713498617339,CLRE 252,A00,507189,Cuomo; Raphael Eduardo,9998,0,9999,1
1713498618366,CLRE 253,A00,507199,Vaida; Florin,9997,0,9999,2
1713498618366,CLRE 253,B00,507202,Vaida; Florin,9999,0,9999,0
1713498619394,CLRE 259,A00,507211,Patel; Hemal,9996,0,9999,3
1713498620419,CLRE 260,A00,507221,Cuomo; Raphael Eduardo,9999,0,9999,0
1713498621448,CLRE 297,001,507242,Cuomo; Raphael Eduardo,9999,0,9999,0
1713498622473,CSE 191,A00,516875,Minnes Kemp; Mor Mia,9999,0,9999,0
1713498623504,CSS 201S,A01,494383,Staff,35,0,35,0
1713498624534,CSS 202S,A01,494387,Staff,35,0,35,0
1713498625564,EAP 100,A00,516065,Staff,9792,0,9999,207
1713498626594,ECE 45,A01,507414,Staff,37,0,60,23
1713498627623,ECE 100,A01,507416,Baghdadchi; Saharnaz,0,0,20,20
1713498627623,ECE 100,A02,507418,Baghdadchi; Saharnaz,19,0,20,1
1713498628653,ECE 111,A01,507420,Staff,27,0,50,23
1713498629680,ECE 197,001,548057,Sievenpiper; Daniel F.,9998,0,9999,1
1713498630708,EDS 115,A00,507243,Choi; Bailey Miyeon,27,0,28,1
1713498631733,EDS 117,A01,494379,Staff,15,0,25,10
1713498632758,EDS 125,A00,507246,Hopkins; Megan Beth,27,0,30,3
1713498633783,EDS 128A,A01,507264,Fargason; Sharon Gayle,26,0,26,0
1713498634812,EDS 128B,A01,507293,Pappas; Elizabeth,30,0,30,0
1713498635839,EDS 139,A00,507294,Fargason; Sharon Gayle,30,0,30,0
1713498635839,EDS 139,B00,507313,Pappas; Elizabeth,30,0,30,0
1713498636867,EDS 201,A00,507315,Staff,18,0,30,12
1713498637895,EDS 203,A01,507317,Halter; Christopher P.,17,0,30,13
1713498638920,EDS 204R,A01,507319,Halter; Christopher P.,0,1,30,30
1713498638920,EDS 204R,B01,507331,Heinzman; Erica M.,22,0,30,8
1713498639949,EDS 206R,A00,507332,Staff,0,2,30,30
1713498639949,EDS 206R,B00,507343,Staff,23,0,30,7
1713498640979,EDS 250,A00,507344,Hemans; Patricia Ann Benitez,27,0,40,13
1713498642008,EDS 281,A00,507345,Daly; Alan J.,18,0,18,0
1713498643034,EDS 284,A00,507350,Daly; Alan J.,16,0,16,0
1713498644058,EDS 286,A00,507359,Fine; Sarah,18,0,18,0
1713498645082,EDS 289C,A01,507361,Daly; Alan J.,18,0,18,0
1713498646108,EDS 290,A00,507366,Hofstetter; Carolyn,15,0,15,0
1713498647135,LIGM 5A,A00,507421,Fischer-Grunski; Eva K,20,0,20,0
1713498648162,LIGM 5B,A00,507423,Fischer-Grunski; Eva K,20,0,20,0
1713498649191,LIGM 5C,A00,507425,Fischer-Grunski; Eva K,20,0,20,0
1713498650216,LIIT 5AS,A00,507427,Carnelos; Chiara,20,0,20,0
1713498651242,LIIT 5BS,A00,507430,Carnelos; Chiara,20,0,20,0
1713498652268,LIIT 5CS,A00,507432,Carnelos; Chiara,20,0,20,0
1713498653298,LISP 5A,A00,507541,Munoz Sanchez; Alicia,14,0,20,6
1713498654326,LISP 5B,A00,507671,Munoz Sanchez; Alicia,12,0,20,8
1713498655354,LISP 5C,A00,507696,Munoz Sanchez; Alicia,11,0,20,9
1713498656380,MAE 197,001,528363,Boechler; Nicholas Sebastia,9998,0,9999,1
1713498657406,MATH 197,001,523477,Kedlaya; Kiran S.,9999,0,9999,0
1713498657406,MATH 197,002,563811,Zhang; Danna,9998,0,9999,1
1713498658431,MCWP 40R,A00,518780,Staff,14,0,20,6
1713498658431,MCWP 40R,B00,518781,Staff,12,0,20,8
1713498658431,MCWP 40R,C00,518783,Staff,9,0,20,11
1713498659461,MCWP 50R,A00,518791,Staff,7,0,20,13
1713498659461,MCWP 50R,B00,518792,Staff,3,0,20,17
1713498659461,MCWP 50R,C00,518793,Staff,7,0,20,13
1713498659461,MCWP 50R,D00,518794,Staff,0,0,20,20
1713498659461,MCWP 50R,E00,518795,Staff,0,0,20,20
1713498659461,MCWP 50R,F00,518796,Staff,11,0,20,9
1713498659461,MCWP 50R,G00,518797,Staff,10,0,20,10
1713498660487,MMW 12R,A01,514034,Herbst; Matthew,4,0,16,12
1713498660487,MMW 12R,A02,514035,Herbst; Matthew,13,0,16,3
1713498661513,MMW 13R,A01,514037,Staff,0,8,16,16
1713498661513,MMW 13R,A02,514039,Staff,0,6,16,16
1713498663568,SIO 295LS,A00,523233,Staff,15,0,30,15
1713498664594,SIO 295S,A00,523232,Staff,15,0,30,15
1713498665623,SOCI 117,A01,494376,Staff,0,2,5,5
1713498666647,WES 237B,A00,494380,Staff,19,0,20,1
1713498668714,AESE 279B,A00,494370,Wade; Jon P,33,0,33,0
1713498669740,AIP 197,001,627712,Vespa; Emanuel Ignacio,9999,0,9999,0
1713498670766,ANAR 135S,A00,494369,Braswell; Geoffrey E.,0,0,0,0
1713498671793,CAT 124RS,A01,519847,Geibel; William,6,0,20,14
1713498672820,CAT 125RS,A01,515971,Geibel; William,6,0,20,14
1713498673846,CLRE 250,A00,511389,Morris; Sheldon,9996,0,9999,3
1713498674877,CLRE 251,A00,507176,Mehta; Ravindra L.,9996,0,9999,3
1713498674877,CLRE 251,B00,511410,Mehta; Ravindra L.,9998,0,9999,1
1713498675903,CLRE 252,A00,507189,Cuomo; Raphael Eduardo,9998,0,9999,1
1713498676931,CLRE 253,A00,507199,Vaida; Florin,9997,0,9999,2
1713498676931,CLRE 253,B00,507202,Vaida; Florin,9999,0,9999,0
1713498677956,CLRE 259,A00,507211,Patel; Hemal,9996,0,9999,3
1713498678985,CLRE 260,A00,507221,Cuomo; Raphael Eduardo,9999,0,9999,0
1713498680013,CLRE 297,001,507242,Cuomo; Raphael Eduardo,9999,0,9999,0
1713498681041,CSE 191,A00,516875,Minnes Kemp; Mor Mia,9999,0,9999,0
1713498682072,CSS 201S,A01,494383,Staff,35,0,35,0
1713498683098,CSS 202S,A01,494387,Staff,35,0,35,0
1713498684124,EAP 100,A00,516065,Staff,9792,0,9999,207
1713498685151,ECE 45,A01,507414,Staff,37,0,60,23
1713498686180,ECE 100,A01,507416,Baghdadchi; Saharnaz,0,0,20,20
1713498686180,ECE 100,A02,507418,Baghdadchi; Saharnaz,19,0,20,1
1713498687206,ECE 111,A01,507420,Staff,27,0,50,23
1713498688229,ECE 197,001,548057,Sievenpiper; Daniel F.,9998,0,9999,1
1713498689253,EDS 115,A00,507243,Choi; Bailey Miyeon,27,0,28,1
1713498690283,EDS 117,A01,494379,Staff,15,0,25,10
1713498691361,EDS 125,A00,507246,Hopkins; Megan Beth,27,0,30,3
1713498692389,EDS 128A,A01,507264,Fargason; Sharon Gayle,26,0,26,0
1713498693414,EDS 128B,A01,507293,Pappas; Elizabeth,30,0,30,0
1713498694438,EDS 139,A00,507294,Fargason; Sharon Gayle,30,0,30,0
1713498694438,EDS 139,B00,507313,Pappas; Elizabeth,30,0,30,0
1713498695463,EDS 201,A00,507315,Staff,18,0,30,12
1713498696489,EDS 203,A01,507317,Halter; Christopher P.,17,0,30,13
1713498697513,EDS 204R,A01,507319,Halter; Christopher P.,0,1,30,30
1713498697513,EDS 204R,B01,507331,Heinzman; Erica M.,22,0,30,8
1713498698537,EDS 206R,A00,507332,Staff,0,2,30,30
1713498698537,EDS 206R,B00,507343,Staff,23,0,30,7
1713498699563,EDS 250,A00,507344,Hemans; Patricia Ann Benitez,27,0,40,13
1713498700588,EDS 281,A00,507345,Daly; Alan J.,18,0,18,0
1713498701616,EDS 284,A00,507350,Daly; Alan J.,16,0,16,0
1713498702643,EDS 286,A00,507359,Fine; Sarah,18,0,18,0
1713498703667,EDS 289C,A01,507361,Daly; Alan J.,18,0,18,0
1713498704691,EDS 290,A00,507366,Hofstetter; Carolyn,15,0,15,0
1713498705717,LIGM 5A,A00,507421,Fischer-Grunski; Eva K,20,0,20,0
1713498706746,LIGM 5B,A00,507423,Fischer-Grunski; Eva K,20,0,20,0
1713498707774,LIGM 5C,A00,507425,Fischer-Grunski; Eva K,20,0,20,0
1713498708800,LIIT 5AS,A00,507427,Carnelos; Chiara,20,0,20,0
1713498709880,LIIT 5BS,A00,507430,Carnelos; Chiara,20,0,20,0
1713498710906,LIIT 5CS,A00,507432,Carnelos; Chiara,20,0,20,0
1713498711932,LISP 5A,A00,507541,Munoz Sanchez; Alicia,14,0,20,6
1713498712957,LISP 5B,A00,507671,Munoz Sanchez; Alicia,12,0,20,8
1713498713983,LISP 5C,A00,507696,Munoz Sanchez; Alicia,11,0,20,9
1713498715011,MAE 197,001,528363,Boechler; Nicholas Sebastia,9998,0,9999,1
1713498716036,MATH 197,001,523477,Kedlaya; Kiran S.,9999,0,9999,0
1713498716036,MATH 197,002,563811,Zhang; Danna,9998,0,9999,1
1713498717064,MCWP 40R,A00,518780,Staff,14,0,20,6
1713498717064,MCWP 40R,B00,518781,Staff,12,0,20,8
1713498717064,MCWP 40R,C00,518783,Staff,9,0,20,11
1713498718090,MCWP 50R,A00,518791,Staff,7,0,20,13
1713498718090,MCWP 50R,B00,518792,Staff,3,0,20,17
1713498718090,MCWP 50R,C00,518793,Staff,7,0,20,13
1713498718090,MCWP 50R,D00,518794,Staff,0,0,20,20
1713498718090,MCWP 50R,E00,518795,Staff,0,0,20,20
1713498718090,MCWP 50R,F00,518796,Staff,11,0,20,9
1713498718090,MCWP 50R,G00,518797,Staff,10,0,20,10
1713498719116,MMW 12R,A01,514034,Herbst; Matthew,4,0,16,12
1713498719116,MMW 12R,A02,514035,Herbst; Matthew,13,0,16,3
1713498720145,MMW 13R,A01,514037,Staff,0,8,16,16
1713498720145,MMW 13R,A02,514039,Staff,0,6,16,16
1713498722198,SIO 295LS,A00,523233,Staff,15,0,30,15
1713498723223,SIO 295S,A00,523232,Staff,15,0,30,15
1713498724247,SOCI 117,A01,494376,Staff,0,2,5,5
1713498725275,WES 237B,A00,494380,Staff,19,0,20,1
1713498727333,AESE 279B,A00,494370,Wade; Jon P,33,0,33,0
1713498728361,AIP 197,001,627712,Vespa; Emanuel Ignacio,9999,0,9999,0
1713498729386,ANAR 135S,A00,494369,Braswell; Geoffrey E.,0,0,0,0
1713498730411,CAT 124RS,A01,519847,Geibel; William,6,0,20,14
1713498731436,CAT 125RS,A01,515971,Geibel; William,6,0,20,14
1713498732461,CLRE 250,A00,511389,Morris; Sheldon,9996,0,9999,3
1713498733486,CLRE 251,A00,507176,Mehta; Ravindra L.,9996,0,9999,3
1713498733486,CLRE 251,B00,511410,Mehta; Ravindra L.,9998,0,9999,1
1713498734511,CLRE 252,A00,507189,Cuomo; Raphael Eduardo,9998,0,9999,1
1713498735537,CLRE 253,A00,507199,Vaida; Florin,9997,0,9999,2
1713498735537,CLRE 253,B00,507202,Vaida; Florin,9999,0,9999,0
1713498736565,CLRE 259,A00,507211,Patel; Hemal,9996,0,9999,3
1713498737589,CLRE 260,A00,507221,Cuomo; Raphael Eduardo,9999,0,9999,0
1713498738614,CLRE 297,001,507242,Cuomo; Raphael Eduardo,9999,0,9999,0
1713498739638,CSE 191,A00,516875,Minnes Kemp; Mor Mia,9999,0,9999,0
1713498740664,CSS 201S,A01,494383,Staff,35,0,35,0
1713498741688,CSS 202S,A01,494387,Staff,35,0,35,0
1713498742714,EAP 100,A00,516065,Staff,9792,0,9999,207
1713498743740,ECE 45,A01,507414,Staff,37,0,60,23
1713498744769,ECE 100,A01,507416,Baghdadchi; Saharnaz,0,0,20,20
1713498744769,ECE 100,A02,507418,Baghdadchi; Saharnaz,19,0,20,1
1713498745794,ECE 111,A01,507420,Staff,27,0,50,23
1713498746819,ECE 197,001,548057,Sievenpiper; Daniel F.,9998,0,9999,1
1713498747845,EDS 115,A00,507243,Choi; Bailey Miyeon,27,0,28,1
1713498748870,EDS 117,A01,494379,Staff,15,0,25,10
1713498749899,EDS 125,A00,507246,Hopkins; Megan Beth,27,0,30,3
1713498750925,EDS 128A,A01,507264,Fargason; Sharon Gayle,26,0,26,0
1713498751950,EDS 128B,A01,507293,Pappas; Elizabeth,30,0,30,0
1713498752975,EDS 139,A00,507294,Fargason; Sharon Gayle,30,0,30,0
1713498752975,EDS 139,B00,507313,Pappas; Elizabeth,30,0,30,0
1713498754001,EDS 201,A00,507315,Staff,18,0,30,12
1713498755026,EDS 203,A01,507317,Halter; Christopher P.,17,0,30,13
1713498756056,EDS 204R,A01,507319,Halter; Christopher P.,0,1,30,30
1713498756056,EDS 204R,B01,507331,Heinzman; Erica M.,22,0,30,8
1713498757086,EDS 206R,A00,507332,Staff,0,2,30,30
1713498757086,EDS 206R,B00,507343,Staff,23,0,30,7
1713498758112,EDS 250,A00,507344,Hemans; Patricia Ann Benitez,27,0,40,13
1713498759138,EDS 281,A00,507345,Daly; Alan J.,18,0,18,0
1713498760166,EDS 284,A00,507350,Daly; Alan J.,16,0,16,0
1713498761191,EDS 286,A00,507359,Fine; Sarah,18,0,18,0
1713498762216,EDS 289C,A01,507361,Daly; Alan J.,18,0,18,0
1713498763242,EDS 290,A00,507366,Hofstetter; Carolyn,15,0,15,0
1713498764267,LIGM 5A,A00,507421,Fischer-Grunski; Eva K,20,0,20,0
1713498765296,LIGM 5B,A00,507423,Fischer-Grunski; Eva K,20,0,20,0
1713498766324,LIGM 5C,A00,507425,Fischer-Grunski; Eva K,20,0,20,0
1713498767349,LIIT 5AS,A00,507427,Carnelos; Chiara,20,0,20,0
1713498768377,LIIT 5BS,A00,507430,Carnelos; Chiara,20,0,20,0
1713498769406,LIIT 5CS,A00,507432,Carnelos; Chiara,20,0,20,0
1713498770433,LISP 5A,A00,507541,Munoz Sanchez; Alicia,14,0,20,6
1713498771459,LISP 5B,A00,507671,Munoz Sanchez; Alicia,12,0,20,8
1713498772484,LISP 5C,A00,507696,Munoz Sanchez; Alicia,11,0,20,9
1713498773510,MAE 197,001,528363,Boechler; Nicholas Sebastia,9998,0,9999,1
1713498774536,MATH 197,001,523477,Kedlaya; Kiran S.,9999,0,9999,0
1713498774536,MATH 197,002,563811,Zhang; Danna,9998,0,9999,1
1713498775566,MCWP 40R,A00,518780,Staff,14,0,20,6
1713498775566,MCWP 40R,B00,518781,Staff,12,0,20,8
1713498775566,MCWP 40R,C00,518783,Staff,9,0,20,11
1713498776597,MCWP 50R,A00,518791,Staff,7,0,20,13
1713498776597,MCWP 50R,B00,518792,Staff,3,0,20,17
1713498776597,MCWP 50R,C00,518793,Staff,7,0,20,13
1713498776597,MCWP 50R,D00,518794,Staff,0,0,20,20
1713498776597,MCWP 50R,E00,518795,Staff,0,0,20,20
1713498776597,MCWP 50R,F00,518796,Staff,11,0,20,9
1713498776597,MCWP 50R,G00,518797,Staff,10,0,20,10
1713498777624,MMW 12R,A01,514034,Herbst; Matthew,4,0,16,12
1713498777624,MMW 12R,A02,514035,Herbst; Matthew,13,0,16,3
1713498778648,MMW 13R,A01,514037,Staff,0,8,16,16
1713498778648,MMW 13R,A02,514039,Staff,0,6,16,16
1713498780701,SIO 295LS,A00,523233,Staff,15,0,30,15
1713498781727,SIO 295S,A00,523232,Staff,15,0,30,15
1713498782753,SOCI 117,A01,494376,Staff,0,2,5,5
1713498783779,WES 237B,A00,494380,Staff,19,0,20,1
1713498785845,AESE 279B,A00,494370,Wade; Jon P,33,0,33,0
1713498786872,AIP 197,001,627712,Vespa; Emanuel Ignacio,9999,0,9999,0
1713498787901,ANAR 135S,A00,494369,Braswell; Geoffrey E.,0,0,0,0
1713498788927,CAT 124RS,A01,519847,Geibel; William,6,0,20,14
1713498789956,CAT 125RS,A01,515971,Geibel; William,6,0,20,14
1713498790980,CLRE 250,A00,511389,Morris; Sheldon,9996,0,9999,3
1713498792013,CLRE 251,A00,507176,Mehta; Ravindra L.,9996,0,9999,3
1713498792013,CLRE 251,B00,511410,Mehta; Ravindra L.,9998,0,9999,1
1713498793038,CLRE 252,A00,507189,Cuomo; Raphael Eduardo,9998,0,9999,1
1713498794063,CLRE 253,A00,507199,Vaida; Florin,9997,0,9999,2
1713498794063,CLRE 253,B00,507202,Vaida; Florin,9999,0,9999,0
1713498795089,CLRE 259,A00,507211,Patel; Hemal,9996,0,9999,3
1713498796115,CLRE 260,A00,507221,Cuomo; Raphael Eduardo,9999,0,9999,0
1713498797139,CLRE 297,001,507242,Cuomo; Raphael Eduardo,9999,0,9999,0
1713498798164,CSE 191,A00,516875,Minnes Kemp; Mor Mia,9999,0,9999,0
1713498799189,CSS 201S,A01,494383,Staff,35,0,35,0
1713498800219,CSS 202S,A01,494387,Staff,35,0,35,0
1713498801244,EAP 100,A00,516065,Staff,9792,0,9999,207
1713498802272,ECE 45,A01,507414,Staff,37,0,60,23
1713498803301,ECE 100,A01,507416,Baghdadchi; Saharnaz,0,0,20,20
1713498803301,ECE 100,A02,507418,Baghdadchi; Saharnaz,19,0,20,1
1713498804328,ECE 111,A01,507420,Staff,27,0,50,23
1713498805352,ECE 197,001,548057,Sievenpiper; Daniel F.,9998,0,9999,1
1713498806377,EDS 115,A00,507243,Choi; Bailey Miyeon,27,0,28,1
1713498807402,EDS 117,A01,494379,Staff,15,0,25,10
1713498808431,EDS 125,A00,507246,Hopkins; Megan Beth,27,0,30,3
1713498809462,EDS 128A,A01,507264,Fargason; Sharon Gayle,26,0,26,0
1713498810492,EDS 128B,A01,507293,Pappas; Elizabeth,30,0,30,0
1713498811519,EDS 139,A00,507294,Fargason; Sharon Gayle,30,0,30,0
1713498811519,EDS 139,B00,507313,Pappas; Elizabeth,30,0,30,0
1713498812544,EDS 201,A00,507315,Staff,18,0,30,12
1713498813629,EDS 203,A01,507317,Halter; Christopher P.,17,0,30,13
1713498814653,EDS 204R,A01,507319,Halter; Christopher P.,0,1,30,30
1713498814653,EDS 204R,B01,507331,Heinzman; Erica M.,22,0,30,8
1713498815681,EDS 206R,A00,507332,Staff,0,2,30,30
1713498815681,EDS 206R,B00,507343,Staff,23,0,30,7
1713498816706,EDS 250,A00,507344,Hemans; Patricia Ann Benitez,27,0,40,13
1713498817734,EDS 281,A00,507345,Daly; Alan J.,18,0,18,0
1713498818760,EDS 284,A00,507350,Daly; Alan J.,16,0,16,0
1713498819788,EDS 286,A00,507359,Fine; Sarah,18,0,18,0
1713498820815,EDS 289C,A01,507361,Daly; Alan J.,18,0,18,0
1713498821840,EDS 290,A00,507366,Hofstetter; Carolyn,15,0,15,0
1713498822864,LIGM 5A,A00,507421,Fischer-Grunski; Eva K,20,0,20,0
1713498823904,LIGM 5B,A00,507423,Fischer-Grunski; Eva K,20,0,20,0
1713498824935,LIGM 5C,A00,507425,Fischer-Grunski; Eva K,20,0,20,0
1713498825965,LIIT 5AS,A00,507427,Carnelos; Chiara,20,0,20,0
1713498826994,LIIT 5BS,A00,507430,Carnelos; Chiara,20,0,20,0
1713498828020,LIIT 5CS,A00,507432,Carnelos; Chiara,20,0,20,0
1713498829046,LISP 5A,A00,507541,Munoz Sanchez; Alicia,14,0,20,6
1713498830072,LISP 5B,A00,507671,Munoz Sanchez; Alicia,12,0,20,8
1713498831098,LISP 5C,A00,507696,Munoz Sanchez; Alicia,11,0,20,9
1713498832127,MAE 197,001,528363,Boechler; Nicholas Sebastia,9998,0,9999,1
1713498833154,MATH 197,001,523477,Kedlaya; Kiran S.,9999,0,9999,0
1713498833154,MATH 197,002,563811,Zhang; Danna,9998,0,9999,1
1713498834178,MCWP 40R,A00,518780,Staff,14,0,20,6
1713498834178,MCWP 40R,B00,518781,Staff,12,0,20,8
1713498834178,MCWP 40R,C00,518783,Staff,9,0,20,11
1713498835208,MCWP 50R,A00,518791,Staff,7,0,20,13
1713498835208,MCWP 50R,B00,518792,Staff,3,0,20,17
1713498835208,MCWP 50R,C00,518793,Staff,7,0,20,13
1713498835208,MCWP 50R,D00,518794,Staff,0,0,20,20
1713498835208,MCWP 50R,E00,518795,Staff,0,0,20,20
1713498835208,MCWP 50R,F00,518796,Staff,11,0,20,9
1713498835208,MCWP 50R,G00,518797,Staff,10,0,20,10
1713498836234,MMW 12R,A01,514034,Herbst; Matthew,4,0,16,12
1713498836234,MMW 12R,A02,514035,Herbst; Matthew,13,0,16,3
1713498837265,MMW 13R,A01,514037,Staff,0,8,16,16
1713498837265,MMW 13R,A02,514039,Staff,0,6,16,16
1713498839319,SIO 295LS,A00,523233,Staff,15,0,30,15
1713498840344,SIO 295S,A00,523232,Staff,15,0,30,15
1713498841367,SOCI 117,A01,494376,Staff,0,2,5,5
1713498842392,WES 237B,A00,494380,Staff,19,0,20,1
1713498844458,AESE 279B,A00,494370,Wade; Jon P,33,0,33,0
1713498845484,AIP 197,001,627712,Vespa; Emanuel Ignacio,9999,0,9999,0
1713498846512,ANAR 135S,A00,494369,Braswell; Geoffrey E.,0,0,0,0
1713498847537,CAT 124RS,A01,519847,Geibel; William,6,0,20,14
1713498848560,CAT 125RS,A01,515971,Geibel; William,6,0,20,14
1713498849588,CLRE 250,A00,511389,Morris; Sheldon,9996,0,9999,3
1713498850614,CLRE 251,A00,507176,Mehta; Ravindra L.,9996,0,9999,3
1713498850614,CLRE 251,B00,511410,Mehta; Ravindra L.,9998,0,9999,1
1713498851645,CLRE 252,A00,507189,Cuomo; Raphael Eduardo,9998,0,9999,1
1713498852669,CLRE 253,A00,507199,Vaida; Florin,9997,0,9999,2
1713498852669,CLRE 253,B00,507202,Vaida; Florin,9999,0,9999,0
1713498853692,CLRE 259,A00,507211,Patel; Hemal,9996,0,9999,3
1713498854719,CLRE 260,A00,507221,Cuomo; Raphael Eduardo,9999,0,9999,0
1713498855750,CLRE 297,001,507242,Cuomo; Raphael Eduardo,9999,0,9999,0
1713498856774,CSE 191,A00,516875,Minnes Kemp; Mor Mia,9999,0,9999,0
1713498857804,CSS 201S,A01,494383,Staff,35,0,35,0
1713498858832,CSS 202S,A01,494387,Staff,35,0,35,0
1713498859858,EAP 100,A00,516065,Staff,9792,0,9999,207
1713498860884,ECE 45,A01,507414,Staff,37,0,60,23
1713498861912,ECE 100,A01,507416,Baghdadchi; Saharnaz,0,0,20,20
1713498861912,ECE 100,A02,507418,Baghdadchi; Saharnaz,19,0,20,1
1713498862936,ECE 111,A01,507420,Staff,27,0,50,23
1713498863961,ECE 197,001,548057,Sievenpiper; Daniel F.,9998,0,9999,1
1713498864989,EDS 115,A00,507243,Choi; Bailey Miyeon,27,0,28,1
1713498866015,EDS 117,A01,494379,Staff,15,0,25,10
1713498867042,EDS 125,A00,507246,Hopkins; Megan Beth,27,0,30,3
1713498868067,EDS 128A,A01,507264,Fargason; Sharon Gayle,26,0,26,0
1713498869093,EDS 128B,A01,507293,Pappas; Elizabeth,30,0,30,0
1713498870121,EDS 139,A00,507294,Fargason; Sharon Gayle,30,0,30,0
1713498870121,EDS 139,B00,507313,Pappas; Elizabeth,30,0,30,0
1713498871147,EDS 201,A00,507315,Staff,18,0,30,12
1713498872176,EDS 203,A01,507317,Halter; Christopher P.,17,0,30,13
1713498873204,EDS 204R,A01,507319,Halter; Christopher P.,0,1,30,30
1713498873204,EDS 204R,B01,507331,Heinzman; Erica M.,22,0,30,8
1713498874231,EDS 206R,A00,507332,Staff,0,2,30,30
1713498874231,EDS 206R,B00,507343,Staff,23,0,30,7
1713498875257,EDS 250,A00,507344,Hemans; Patricia Ann Benitez,27,0,40,13
1713498876286,EDS 281,A00,507345,Daly; Alan J.,18,0,18,0
1713498877317,EDS 284,A00,507350,Daly; Alan J.,16,0,16,0
1713498878342,EDS 286,A00,507359,Fine; Sarah,18,0,18,0
1713498879368,EDS 289C,A01,507361,Daly; Alan J.,18,0,18,0
1713498880394,EDS 290,A00,507366,Hofstetter; Carolyn,15,0,15,0
1713498881423,LIGM 5A,A00,507421,Fischer-Grunski; Eva K,20,0,20,0
1713498882448,LIGM 5B,A00,507423,Fischer-Grunski; Eva K,20,0,20,0
1713498883473,LIGM 5C,A00,507425,Fischer-Grunski; Eva K,20,0,20,0
1713498884499,LIIT 5AS,A00,507427,Carnelos; Chiara,20,0,20,0
1713498885528,LIIT 5BS,A00,507430,Carnelos; Chiara,20,0,20,0
1713498886554,LIIT 5CS,A00,507432,Carnelos; Chiara,20,0,20,0
1713498887580,LISP 5A,A00,507541,Munoz Sanchez; Alicia,14,0,20,6
1713498888609,LISP 5B,A00,507671,Munoz Sanchez; Alicia,12,0,20,8
1713498889634,LISP 5C,A00,507696,Munoz Sanchez; Alicia,11,0,20,9
1713498890660,MAE 197,001,528363,Boechler; Nicholas Sebastia,9998,0,9999,1
1713498891689,MATH 197,001,523477,Kedlaya; Kiran S.,9999,0,9999,0
1713498891689,MATH 197,002,563811,Zhang; Danna,9998,0,9999,1
1713498892716,MCWP 40R,A00,518780,Staff,14,0,20,6
1713498892716,MCWP 40R,B00,518781,Staff,12,0,20,8
1713498892716,MCWP 40R,C00,518783,Staff,9,0,20,11
1713498893742,MCWP 50R,A00,518791,Staff,7,0,20,13
1713498893742,MCWP 50R,B00,518792,Staff,3,0,20,17
1713498893742,MCWP 50R,C00,518793,Staff,7,0,20,13
1713498893742,MCWP 50R,D00,518794,Staff,0,0,20,20
1713498893742,MCWP 50R,E00,518795,Staff,0,0,20,20
1713498893742,MCWP 50R,F00,518796,Staff,11,0,20,9
1713498893742,MCWP 50R,G00,518797,Staff,10,0,20,10
1713498894767,MMW 12R,A01,514034,Herbst; Matthew,4,0,16,12
1713498894767,MMW 12R,A02,514035,Herbst; Matthew,13,0,16,3
1713498895793,MMW 13R,A01,514037,Staff,0,8,16,16
1713498895793,MMW 13R,A02,514039,Staff,0,6,16,16
1713498897843,SIO 295LS,A00,523233,Staff,15,0,30,15
1713498898867,SIO 295S,A00,523232,Staff,15,0,30,15
1713498899892,SOCI 117,A01,494376,Staff,0,2,5,5
1713498900918,WES 237B,A00,494380,Staff,19,0,20,1
1713498902985,AESE 279B,A00,494370,Wade; Jon P,33,0,33,0
1713498904012,AIP 197,001,627712,Vespa; Emanuel Ignacio,9999,0,9999,0
1713498905038,ANAR 135S,A00,494369,Braswell; Geoffrey E.,0,0,0,0
1713498906069,CAT 124RS,A01,519847,Geibel; William,6,0,20,14
1713498907093,CAT 125RS,A01,515971,Geibel; William,6,0,20,14
1713498908120,CLRE 250,A00,511389,Morris; Sheldon,9996,0,9999,3
1713498909147,CLRE 251,A00,507176,Mehta; Ravindra L.,9996,0,9999,3
1713498909147,CLRE 251,B00,511410,Mehta; Ravindra L.,9998,0,9999,1
1713498910173,CLRE 252,A00,507189,Cuomo; Raphael Eduardo,9998,0,9999,1
1713498911199,CLRE 253,A00,507199,Vaida; Florin,9997,0,9999,2
1713498911199,CLRE 253,B00,507202,Vaida; Florin,9999,0,9999,0
1713498912223,CLRE 259,A00,507211,Patel; Hemal,9996,0,9999,3
1713498913251,CLRE 260,A00,507221,Cuomo; Raphael Eduardo,9999,0,9999,0
1713498914275,CLRE 297,001,507242,Cuomo; Raphael Eduardo,9999,0,9999,0
1713498915302,CSE 191,A00,516875,Minnes Kemp; Mor Mia,9999,0,9999,0
1713498916327,CSS 201S,A01,494383,Staff,35,0,35,0
1713498917408,CSS 202S,A01,494387,Staff,35,0,35,0
1713498918436,EAP 100,A00,516065,Staff,9792,0,9999,207
1713498919462,ECE 45,A01,507414,Staff,37,0,60,23
1713498920488,ECE 100,A01,507416,Baghdadchi; Saharnaz,0,0,20,20
1713498920488,ECE 100,A02,507418,Baghdadchi; Saharnaz,19,0,20,1
1713498921514,ECE 111,A01,507420,Staff,27,0,50,23
1713498922543,ECE 197,001,548057,Sievenpiper; Daniel F.,9998,0,9999,1
1713498923568,EDS 115,A00,507243,Choi; Bailey Miyeon,27,0,28,1
1713498924597,EDS 117,A01,494379,Staff,15,0,25,10
1713498925622,EDS 125,A00,507246,Hopkins; Megan Beth,27,0,30,3
1713498926647,EDS 128A,A01,507264,Fargason; Sharon Gayle,26,0,26,0
1713498927686,EDS 128B,A01,507293,Pappas; Elizabeth,30,0,30,0
1713498928710,EDS 139,A00,507294,Fargason; Sharon Gayle,30,0,30,0
1713498928710,EDS 139,B00,507313,Pappas; Elizabeth,30,0,30,0
1713498929737,EDS 201,A00,507315,Staff,18,0,30,12
1713498930765,EDS 203,A01,507317,Halter; Christopher P.,17,0,30,13
1713498931791,EDS 204R,A01,507319,Halter; Christopher P.,0,1,30,30
1713498931791,EDS 204R,B01,507331,Heinzman; Erica M.,22,0,30,8
1713498932825,EDS 206R,A00,507332,Staff,0,2,30,30
1713498932825,EDS 206R,B00,507343,Staff,23,0,30,7
1713498933861,EDS 250,A00,507344,Hemans; Patricia Ann Benitez,27,0,40,13
1713498934888,EDS 281,A00,507345,Daly; Alan J.,18,0,18,0
1713498935916,EDS 284,A00,507350,Daly; Alan J.,16,0,16,0
1713498936943,EDS 286,A00,507359,Fine; Sarah,18,0,18,0
1713498937969,EDS 289C,A01,507361,Daly; Alan J.,18,0,18,0
1713498938994,EDS 290,A00,507366,Hofstetter; Carolyn,15,0,15,0
1713498940022,LIGM 5A,A00,507421,Fischer-Grunski; Eva K,20,0,20,0
1713498941048,LIGM 5B,A00,507423,Fischer-Grunski; Eva K,20,0,20,0
1713498942083,LIGM 5C,A00,507425,Fischer-Grunski; Eva K,20,0,20,0
1713498943113,LIIT 5AS,A00,507427,Carnelos; Chiara,20,0,20,0
1713498944137,LIIT 5BS,A00,507430,Carnelos; Chiara,20,0,20,0
1713498945162,LIIT 5CS,A00,507432,Carnelos; Chiara,20,0,20,0
1713498946192,LISP 5A,A00,507541,Munoz Sanchez; Alicia,14,0,20,6
1713498947218,LISP 5B,A00,507671,Munoz Sanchez; Alicia,12,0,20,8
1713498948244,LISP 5C,A00,507696,Munoz Sanchez; Alicia,11,0,20,9
1713498949269,MAE 197,001,528363,Boechler; Nicholas Sebastia,9998,0,9999,1
1713498950294,MATH 197,001,523477,Kedlaya; Kiran S.,9999,0,9999,0
1713498950294,MATH 197,002,563811,Zhang; Danna,9998,0,9999,1
1713498951319,MCWP 40R,A00,518780,Staff,14,0,20,6
1713498951319,MCWP 40R,B00,518781,Staff,12,0,20,8
1713498951319,MCWP 40R,C00,518783,Staff,9,0,20,11
1713498952345,MCWP 50R,A00,518791,Staff,7,0,20,13
1713498952345,MCWP 50R,B00,518792,Staff,3,0,20,17
1713498952345,MCWP 50R,C00,518793,Staff,7,0,20,13
1713498952345,MCWP 50R,D00,518794,Staff,0,0,20,20
1713498952345,MCWP 50R,E00,518795,Staff,0,0,20,20
1713498952345,MCWP 50R,F00,518796,Staff,11,0,20,9
1713498952345,MCWP 50R,G00,518797,Staff,10,0,20,10
1713498953374,MMW 12R,A01,514034,Herbst; Matthew,4,0,16,12
1713498953374,MMW 12R,A02,514035,Herbst; Matthew,13,0,16,3
1713498954402,MMW 13R,A01,514037,Staff,0,8,16,16
1713498954402,MMW 13R,A02,514039,Staff,0,6,16,16
1713498956452,SIO 295LS,A00,523233,Staff,15,0,30,15
1713498957478,SIO 295S,A00,523232,Staff,15,0,30,15
1713498958507,SOCI 117,A01,494376,Staff,0,2,5,5
1713498959530,WES 237B,A00,494380,Staff,19,0,20,1
1713498961591,AESE 279B,A00,494370,Wade; Jon P,33,0,33,0
1713498962616,AIP 197,001,627712,Vespa; Emanuel Ignacio,9999,0,9999,0
1713498963644,ANAR 135S,A00,494369,Braswell; Geoffrey E.,0,0,0,0
1713498964674,CAT 124RS,A01,519847,Geibel; William,6,0,20,14
1713498965699,CAT 125RS,A01,515971,Geibel; William,6,0,20,14
1713498966725,CLRE 250,A00,511389,Morris; Sheldon,9996,0,9999,3
1713498967751,CLRE 251,A00,507176,Mehta; Ravindra L.,9996,0,9999,3
1713498967751,CLRE 251,B00,511410,Mehta; Ravindra L.,9998,0,9999,1
1713498968776,CLRE 252,A00,507189,Cuomo; Raphael Eduardo,9998,0,9999,1
1713498969800,CLRE 253,A00,507199,Vaida; Florin,9997,0,9999,2
1713498969800,CLRE 253,B00,507202,Vaida; Florin,9999,0,9999,0
1713498970825,CLRE 259,A00,507211,Patel; Hemal,9996,0,9999,3
1713498971850,CLRE 260,A00,507221,Cuomo; Raphael Eduardo,9999,0,9999,0
1713498972876,CLRE 297,001,507242,Cuomo; Raphael Eduardo,9999,0,9999,0
1713498973905,CSE 191,A00,516875,Minnes Kemp; Mor Mia,9999,0,9999,0
1713498974931,CSS 201S,A01,494383,Staff,35,0,35,0
1713498975960,CSS 202S,A01,494387,Staff,35,0,35,0
1713498976986,EAP 100,A00,516065,Staff,9792,0,9999,207
1713498978011,ECE 45,A01,507414,Staff,37,0,60,23
1713498979040,ECE 100,A01,507416,Baghdadchi; Saharnaz,0,0,20,20
1713498979040,ECE 100,A02,507418,Baghdadchi; Saharnaz,19,0,20,1
1713498980065,ECE 111,A01,507420,Staff,27,0,50,23
1713498981094,ECE 197,001,548057,Sievenpiper; Daniel F.,9998,0,9999,1
1713498982119,EDS 115,A00,507243,Choi; Bailey Miyeon,27,0,28,1
1713498983146,EDS 117,A01,494379,Staff,15,0,25,10
1713498984171,EDS 125,A00,507246,Hopkins; Megan Beth,27,0,30,3
1713498985201,EDS 128A,A01,507264,Fargason; Sharon Gayle,26,0,26,0
1713498986226,EDS 128B,A01,507293,Pappas; Elizabeth,30,0,30,0
1713498987253,EDS 139,A00,507294,Fargason; Sharon Gayle,30,0,30,0
1713498987253,EDS 139,B00,507313,Pappas; Elizabeth,30,0,30,0
1713498988279,EDS 201,A00,507315,Staff,18,0,30,12
1713498989309,EDS 203,A01,507317,Halter; Christopher P.,17,0,30,13
1713498990335,EDS 204R,A01,507319,Halter; Christopher P.,0,1,30,30
1713498990335,EDS 204R,B01,507331,Heinzman; Erica M.,22,0,30,8
1713498991359,EDS 206R,A00,507332,Staff,0,2,30,30
1713498991359,EDS 206R,B00,507343,Staff,23,0,30,7
1713498992386,EDS 250,A00,507344,Hemans; Patricia Ann Benitez,27,0,40,13
1713498993412,EDS 281,A00,507345,Daly; Alan J.,18,0,18,0
1713498994437,EDS 284,A00,507350,Daly; Alan J.,16,0,16,0
1713498995463,EDS 286,A00,507359,Fine; Sarah,18,0,18,0
1713498996492,EDS 289C,A01,507361,Daly; Alan J.,18,0,18,0
1713498997519,EDS 290,A00,507366,Hofstetter; Carolyn,15,0,15,0
1713498998550,LIGM 5A,A00,507421,Fischer-Grunski; Eva K,20,0,20,0
1713498999574,LIGM 5B,A00,507423,Fischer-Grunski; Eva K,20,0,20,0
1713499000598,LIGM 5C,A00,507425,Fischer-Grunski; Eva K,20,0,20,0
1713499001624,LIIT 5AS,A00,507427,Carnelos; Chiara,20,0,20,0
1713499002650,LIIT 5BS,A00,507430,Carnelos; Chiara,20,0,20,0
1713499003677,LIIT 5CS,A00,507432,Carnelos; Chiara,20,0,20,0
1713499004707,LISP 5A,A00,507541,Munoz Sanchez; Alicia,14,0,20,6
1713499005732,LISP 5B,A00,507671,Munoz Sanchez; Alicia,12,0,20,8
1713499006760,LISP 5C,A00,507696,Munoz Sanchez; Alicia,11,0,20,9
1713499007785,MAE 197,001,528363,Boechler; Nicholas Sebastia,9998,0,9999,1
1713499008809,MATH 197,001,523477,Kedlaya; Kiran S.,9999,0,9999,0
1713499008809,MATH 197,002,563811,Zhang; Danna,9998,0,9999,1
1713499009838,MCWP 40R,A00,518780,Staff,14,0,20,6
1713499009838,MCWP 40R,B00,518781,Staff,12,0,20,8
1713499009838,MCWP 40R,C00,518783,Staff,9,0,20,11
1713499010871,MCWP 50R,A00,518791,Staff,7,0,20,13
1713499010871,MCWP 50R,B00,518792,Staff,3,0,20,17
1713499010871,MCWP 50R,C00,518793,Staff,7,0,20,13
1713499010871,MCWP 50R,D00,518794,Staff,0,0,20,20
1713499010871,MCWP 50R,E00,518795,Staff,0,0,20,20
1713499010871,MCWP 50R,F00,518796,Staff,11,0,20,9
1713499010871,MCWP 50R,G00,518797,Staff,10,0,20,10
1713499011897,MMW 12R,A01,514034,Herbst; Matthew,4,0,16,12
1713499011897,MMW 12R,A02,514035,Herbst; Matthew,13,0,16,3
1713499012922,MMW 13R,A01,514037,Staff,0,8,16,16
1713499012922,MMW 13R,A02,514039,Staff,0,6,16,16
1713499014975,SIO 295LS,A00,523233,Staff,15,0,30,15
1713499016003,SIO 295S,A00,523232,Staff,15,0,30,15
1713499017032,SOCI 117,A01,494376,Staff,0,2,5,5
1713499018058,WES 237B,A00,494380,Staff,19,0,20,1
1713499020123,AESE 279B,A00,494370,Wade; Jon P,33,0,33,0
1713499021204,AIP 197,001,627712,Vespa; Emanuel Ignacio,9999,0,9999,0
1713499022230,ANAR 135S,A00,494369,Braswell; Geoffrey E.,0,0,0,0
1713499023255,CAT 124RS,A01,519847,Geibel; William,6,0,20,14
1713499024283,CAT 125RS,A01,515971,Geibel; William,6,0,20,14
1713499025309,CLRE 250,A00,511389,Morris; Sheldon,9996,0,9999,3
1713499026339,CLRE 251,A00,507176,Mehta; Ravindra L.,9996,0,9999,3
1713499026339,CLRE 251,B00,511410,Mehta; Ravindra L.,9998,0,9999,1
1713499027363,CLRE 252,A00,507189,Cuomo; Raphael Eduardo,9998,0,9999,1
1713499028387,CLRE 253,A00,507199,Vaida; Florin,9997,0,9999,2
1713499028387,CLRE 253,B00,507202,Vaida; Florin,9999,0,9999,0
1713499029412,CLRE 259,A00,507211,Patel; Hemal,9996,0,9999,3
1713499030436,CLRE 260,A00,507221,Cuomo; Raphael Eduardo,9999,0,9999,0
1713499031463,CLRE 297,001,507242,Cuomo; Raphael Eduardo,9999,0,9999,0
1713499032492,CSE 191,A00,516875,Minnes Kemp; Mor Mia,9999,0,9999,0
1713499033521,CSS 201S,A01,494383,Staff,35,0,35,0
1713499034546,CSS 202S,A01,494387,Staff,35,0,35,0
1713499035571,EAP 100,A00,516065,Staff,9792,0,9999,207
1713499036596,ECE 45,A01,507414,Staff,37,0,60,23
1713499037623,ECE 100,A01,507416,Baghdadchi; Saharnaz,0,0,20,20
1713499037623,ECE 100,A02,507418,Baghdadchi; Saharnaz,19,0,20,1
1713499038649,ECE 111,A01,507420,Staff,27,0,50,23
1713499039674,ECE 197,001,548057,Sievenpiper; Daniel F.,9998,0,9999,1
1713499040701,EDS 115,A00,507243,Choi; Bailey Miyeon,27,0,28,1
1713499041727,EDS 117,A01,494379,Staff,15,0,25,10
1713499042754,EDS 125,A00,507246,Hopkins; Megan Beth,27,0,30,3
1713499043784,EDS 128A,A01,507264,Fargason; Sharon Gayle,26,0,26,0
1713499044809,EDS 128B,A01,507293,Pappas; Elizabeth,30,0,30,0
1713499045836,EDS 139,A00,507294,Fargason; Sharon Gayle,30,0,30,0
1713499045836,EDS 139,B00,507313,Pappas; Elizabeth,30,0,30,0
1713499046861,EDS 201,A00,507315,Staff,18,0,30,12
1713499047886,EDS 203,A01,507317,Halter; Christopher P.,17,0,30,13
1713499048915,EDS 204R,A01,507319,Halter; Christopher P.,0,1,30,30
1713499048915,EDS 204R,B01,507331,Heinzman; Erica M.,22,0,30,8
1713499049939,EDS 206R,A00,507332,Staff,0,2,30,30
1713499049939,EDS 206R,B00,507343,Staff,23,0,30,7
1713499050968,EDS 250,A00,507344,Hemans; Patricia Ann Benitez,27,0,40,13
1713499051993,EDS 281,A00,507345,Daly; Alan J.,18,0,18,0
1713499053021,EDS 284,A00,507350,Daly; Alan J.,16,0,16,0
1713499054049,EDS 286,A00,507359,Fine; Sarah,18,0,18,0
1713499055077,EDS 289C,A01,507361,Daly; Alan J.,18,0,18,0
1713499056106,EDS 290,A00,507366,Hofstetter; Carolyn,15,0,15,0
1713499057136,LIGM 5A,A00,507421,Fischer-Grunski; Eva K,20,0,20,0
1713499058165,LIGM 5B,A00,507423,Fischer-Grunski; Eva K,20,0,20,0
1713499059190,LIGM 5C,A00,507425,Fischer-Grunski; Eva K,20,0,20,0
1713499060216,LIIT 5AS,A00,507427,Carnelos; Chiara,20,0,20,0
1713499061244,LIIT 5BS,A00,507430,Carnelos; Chiara,20,0,20,0
1713499062269,LIIT 5CS,A00,507432,Carnelos; Chiara,20,0,20,0
1713499063295,LISP 5A,A00,507541,Munoz Sanchez; Alicia,14,0,20,6
1713499064321,LISP 5B,A00,507671,Munoz Sanchez; Alicia,12,0,20,8
1713499065346,LISP 5C,A00,507696,Munoz Sanchez; Alicia,11,0,20,9
1713499066373,MAE 197,001,528363,Boechler; Nicholas Sebastia,9998,0,9999,1
1713499067400,MATH 197,001,523477,Kedlaya; Kiran S.,9999,0,9999,0
1713499067400,MATH 197,002,563811,Zhang; Danna,9998,0,9999,1
1713499068429,MCWP 40R,A00,518780,Staff,14,0,20,6
1713499068429,MCWP 40R,B00,518781,Staff,11,0,20,9
1713499068429,MCWP 40R,C00,518783,Staff,9,0,20,11
1713499069458,MCWP 50R,A00,518791,Staff,7,0,20,13
1713499069458,MCWP 50R,B00,518792,Staff,3,0,20,17
1713499069458,MCWP 50R,C00,518793,Staff,7,0,20,13
1713499069458,MCWP 50R,D00,518794,Staff,0,0,20,20
1713499069458,MCWP 50R,E00,518795,Staff,0,0,20,20
1713499069458,MCWP 50R,F00,518796,Staff,11,0,20,9
1713499069458,MCWP 50R,G00,518797,Staff,10,0,20,10
1713499070485,MMW 12R,A01,514034,Herbst; Matthew,4,0,16,12
1713499070485,MMW 12R,A02,514035,Herbst; Matthew,13,0,16,3
1713499071508,MMW 13R,A01,514037,Staff,0,8,16,16
1713499071508,MMW 13R,A02,514039,Staff,0,6,16,16
1713499073561,SIO 295LS,A00,523233,Staff,15,0,30,15
1713499074587,SIO 295S,A00,523232,Staff,15,0,30,15
1713499075615,SOCI 117,A01,494376,Staff,0,2,5,5
1713499076641,WES 237B,A00,494380,Staff,19,0,20,1
1713499078709,AESE 279B,A00,494370,Wade; Jon P,33,0,33,0
1713499079741,AIP 197,001,627712,Vespa; Emanuel Ignacio,9999,0,9999,0
1713499080767,ANAR 135S,A00,494369,Braswell; Geoffrey E.,0,0,0,0
1713499081793,CAT 124RS,A01,519847,Geibel; William,6,0,20,14
1713499082817,CAT 125RS,A01,515971,Geibel; William,6,0,20,14
1713499083842,CLRE 250,A00,511389,Morris; Sheldon,9996,0,9999,3
1713499084869,CLRE 251,A00,507176,Mehta; Ravindra L.,9996,0,9999,3
1713499084869,CLRE 251,B00,511410,Mehta; Ravindra L.,9998,0,9999,1
1713499085895,CLRE 252,A00,507189,Cuomo; Raphael Eduardo,9998,0,9999,1
1713499086920,CLRE 253,A00,507199,Vaida; Florin,9997,0,9999,2
1713499086920,CLRE 253,B00,507202,Vaida; Florin,9999,0,9999,0
1713499087945,CLRE 259,A00,507211,Patel; Hemal,9996,0,9999,3
1713499088977,CLRE 260,A00,507221,Cuomo; Raphael Eduardo,9999,0,9999,0
1713499090002,CLRE 297,001,507242,Cuomo; Raphael Eduardo,9999,0,9999,0
1713499091028,CSE 191,A00,516875,Minnes Kemp; Mor Mia,9999,0,9999,0
1713499092055,CSS 201S,A01,494383,Staff,35,0,35,0
1713499093081,CSS 202S,A01,494387,Staff,35,0,35,0
1713499094107,EAP 100,A00,516065,Staff,9792,0,9999,207
1713499095132,ECE 45,A01,507414,Staff,37,0,60,23
1713499096157,ECE 100,A01,507416,Baghdadchi; Saharnaz,0,0,20,20
1713499096157,ECE 100,A02,507418,Baghdadchi; Saharnaz,19,0,20,1
1713499097182,ECE 111,A01,507420,Staff,27,0,50,23
1713499098210,ECE 197,001,548057,Sievenpiper; Daniel F.,9998,0,9999,1
1713499099237,EDS 115,A00,507243,Choi; Bailey Miyeon,27,0,28,1
1713499100268,EDS 117,A01,494379,Staff,15,0,25,10
1713499101293,EDS 125,A00,507246,Hopkins; Megan Beth,27,0,30,3
1713499102319,EDS 128A,A01,507264,Fargason; Sharon Gayle,26,0,26,0
1713499103349,EDS 128B,A01,507293,Pappas; Elizabeth,30,0,30,0
1713499104374,EDS 139,A00,507294,Fargason; Sharon Gayle,30,0,30,0
1713499104374,EDS 139,B00,507313,Pappas; Elizabeth,30,0,30,0
1713499105401,EDS 201,A00,507315,Staff,18,0,30,12
1713499106430,EDS 203,A01,507317,Halter; Christopher P.,17,0,30,13
1713499107458,EDS 204R,A01,507319,Halter; Christopher P.,0,1,30,30
1713499107458,EDS 204R,B01,507331,Heinzman; Erica M.,22,0,30,8
1713499108481,EDS 206R,A00,507332,Staff,0,2,30,30
1713499108481,EDS 206R,B00,507343,Staff,23,0,30,7
1713499109511,EDS 250,A00,507344,Hemans; Patricia Ann Benitez,27,0,40,13
1713499110539,EDS 281,A00,507345,Daly; Alan J.,18,0,18,0
1713499111566,EDS 284,A00,507350,Daly; Alan J.,16,0,16,0
1713499112591,EDS 286,A00,507359,Fine; Sarah,18,0,18,0
1713499113617,EDS 289C,A01,507361,Daly; Alan J.,18,0,18,0
1713499114644,EDS 290,A00,507366,Hofstetter; Carolyn,15,0,15,0
1713499115670,LIGM 5A,A00,507421,Fischer-Grunski; Eva K,20,0,20,0
1713499116695,LIGM 5B,A00,507423,Fischer-Grunski; Eva K,20,0,20,0
1713499117722,LIGM 5C,A00,507425,Fischer-Grunski; Eva K,20,0,20,0
1713499118751,LIIT 5AS,A00,507427,Carnelos; Chiara,20,0,20,0
1713499119781,LIIT 5BS,A00,507430,Carnelos; Chiara,20,0,20,0
1713499120807,LIIT 5CS,A00,507432,Carnelos; Chiara,20,0,20,0
1713499121833,LISP 5A,A00,507541,Munoz Sanchez; Alicia,14,0,20,6
1713499122864,LISP 5B,A00,507671,Munoz Sanchez; Alicia,12,0,20,8
1713499123900,LISP 5C,A00,507696,Munoz Sanchez; Alicia,11,0,20,9
1713499124982,MAE 197,001,528363,Boechler; Nicholas Sebastia,9998,0,9999,1
1713499126008,MATH 197,001,523477,Kedlaya; Kiran S.,9999,0,9999,0
1713499126008,MATH 197,002,563811,Zhang; Danna,9998,0,9999,1
1713499127038,MCWP 40R,A00,518780,Staff,14,0,20,6
1713499127038,MCWP 40R,B00,518781,Staff,11,0,20,9
1713499127038,MCWP 40R,C00,518783,Staff,9,0,20,11
1713499128068,MCWP 50R,A00,518791,Staff,7,0,20,13
1713499128068,MCWP 50R,B00,518792,Staff,3,0,20,17
1713499128068,MCWP 50R,C00,518793,Staff,7,0,20,13
1713499128068,MCWP 50R,D00,518794,Staff,0,0,20,20
1713499128068,MCWP 50R,E00,518795,Staff,0,0,20,20
1713499128068,MCWP 50R,F00,518796,Staff,11,0,20,9
1713499128068,MCWP 50R,G00,518797,Staff,10,0,20,10
1713499129097,MMW 12R,A01,514034,Herbst; Matthew,4,0,16,12
1713499129097,MMW 12R,A02,514035,Herbst; Matthew,13,0,16,3
1713499130126,MMW 13R,A01,514037,Staff,0,8,16,16
1713499130126,MMW 13R,A02,514039,Staff,0,6,16,16
1713499132178,SIO 295LS,A00,523233,Staff,15,0,30,15
1713499133204,SIO 295S,A00,523232,Staff,15,0,30,15
1713499134231,SOCI 117,A01,494376,Staff,0,2,5,5
1713499135259,WES 237B,A00,494380,Staff,19,0,20,1
1713499137329,AESE 279B,A00,494370,Wade; Jon P,33,0,33,0
1713499138354,AIP 197,001,627712,Vespa; Emanuel Ignacio,9999,0,9999,0
1713499139379,ANAR 135S,A00,494369,Braswell; Geoffrey E.,0,0,0,0
1713499140405,CAT 124RS,A01,519847,Geibel; William,6,0,20,14
1713499141433,CAT 125RS,A01,515971,Geibel; William,6,0,20,14
1713499142458,CLRE 250,A00,511389,Morris; Sheldon,9996,0,9999,3
1713499143485,CLRE 251,A00,507176,Mehta; Ravindra L.,9996,0,9999,3
1713499143485,CLRE 251,B00,511410,Mehta; Ravindra L.,9998,0,9999,1
1713499144511,CLRE 252,A00,507189,Cuomo; Raphael Eduardo,9998,0,9999,1
1713499145540,CLRE 253,A00,507199,Vaida; Florin,9997,0,9999,2
1713499145540,CLRE 253,B00,507202,Vaida; Florin,9999,0,9999,0
1713499146566,CLRE 259,A00,507211,Patel; Hemal,9996,0,9999,3
1713499147592,CLRE 260,A00,507221,Cuomo; Raphael Eduardo,9999,0,9999,0
1713499148619,CLRE 297,001,507242,Cuomo; Raphael Eduardo,9999,0,9999,0
1713499149645,CSE 191,A00,516875,Minnes Kemp; Mor Mia,9999,0,9999,0
1713499150673,CSS 201S,A01,494383,Staff,35,0,35,0
1713499151745,CSS 202S,A01,494387,Staff,35,0,35,0
1713499152769,EAP 100,A00,516065,Staff,9792,0,9999,207
1713499153806,ECE 45,A01,507414,Staff,37,0,60,23
1713499154837,ECE 100,A01,507416,Baghdadchi; Saharnaz,0,0,20,20
1713499154837,ECE 100,A02,507418,Baghdadchi; Saharnaz,19,0,20,1
1713499155866,ECE 111,A01,507420,Staff,27,0,50,23
1713499156893,ECE 197,001,548057,Sievenpiper; Daniel F.,9998,0,9999,1
1713499157923,EDS 115,A00,507243,Choi; Bailey Miyeon,27,0,28,1
1713499158950,EDS 117,A01,494379,Staff,15,0,25,10
1713499159980,EDS 125,A00,507246,Hopkins; Megan Beth,27,0,30,3
1713499161008,EDS 128A,A01,507264,Fargason; Sharon Gayle,26,0,26,0
1713499162035,EDS 128B,A01,507293,Pappas; Elizabeth,30,0,30,0
1713499163063,EDS 139,A00,507294,Fargason; Sharon Gayle,30,0,30,0
1713499163063,EDS 139,B00,507313,Pappas; Elizabeth,30,0,30,0
1713499164087,EDS 201,A00,507315,Staff,18,0,30,12
1713499165114,EDS 203,A01,507317,Halter; Christopher P.,17,0,30,13
1713499166143,EDS 204R,A01,507319,Halter; Christopher P.,0,1,30,30
1713499166143,EDS 204R,B01,507331,Heinzman; Erica M.,22,0,30,8
1713499167166,EDS 206R,A00,507332,Staff,0,2,30,30
1713499167166,EDS 206R,B00,507343,Staff,23,0,30,7
1713499168192,EDS 250,A00,507344,Hemans; Patricia Ann Benitez,27,0,40,13
1713499169221,EDS 281,A00,507345,Daly; Alan J.,18,0,18,0
1713499170246,EDS 284,A00,507350,Daly; Alan J.,16,0,16,0
1713499171272,EDS 286,A00,507359,Fine; Sarah,18,0,18,0
1713499172296,EDS 289C,A01,507361,Daly; Alan J.,18,0,18,0
1713499173322,EDS 290,A00,507366,Hofstetter; Carolyn,15,0,15,0
1713499174349,LIGM 5A,A00,507421,Fischer-Grunski; Eva K,20,0,20,0
1713499175373,LIGM 5B,A00,507423,Fischer-Grunski; Eva K,20,0,20,0
1713499176398,LIGM 5C,A00,507425,Fischer-Grunski; Eva K,20,0,20,0
1713499177426,LIIT 5AS,A00,507427,Carnelos; Chiara,20,0,20,0
1713499178451,LIIT 5BS,A00,507430,Carnelos; Chiara,20,0,20,0
1713499179480,LIIT 5CS,A00,507432,Carnelos; Chiara,20,0,20,0
1713499180505,LISP 5A,A00,507541,Munoz Sanchez; Alicia,14,0,20,6
1713499181529,LISP 5B,A00,507671,Munoz Sanchez; Alicia,12,0,20,8
1713499182554,LISP 5C,A00,507696,Munoz Sanchez; Alicia,11,0,20,9
1713499183582,MAE 197,001,528363,Boechler; Nicholas Sebastia,9998,0,9999,1
1713499184611,MATH 197,001,523477,Kedlaya; Kiran S.,9999,0,9999,0
1713499184611,MATH 197,002,563811,Zhang; Danna,9998,0,9999,1
1713499185637,MCWP 40R,A00,518780,Staff,14,0,20,6
1713499185637,MCWP 40R,B00,518781,Staff,11,0,20,9
1713499185637,MCWP 40R,C00,518783,Staff,9,0,20,11
1713499186662,MCWP 50R,A00,518791,Staff,7,0,20,13
1713499186662,MCWP 50R,B00,518792,Staff,3,0,20,17
1713499186662,MCWP 50R,C00,518793,Staff,7,0,20,13
1713499186662,MCWP 50R,D00,518794,Staff,0,0,20,20
1713499186662,MCWP 50R,E00,518795,Staff,0,0,20,20
1713499186662,MCWP 50R,F00,518796,Staff,11,0,20,9
1713499186662,MCWP 50R,G00,518797,Staff,10,0,20,10
1713499187691,MMW 12R,A01,514034,Herbst; Matthew,4,0,16,12
1713499187691,MMW 12R,A02,514035,Herbst; Matthew,13,0,16,3
1713499188719,MMW 13R,A01,514037,Staff,0,8,16,16
1713499188719,MMW 13R,A02,514039,Staff,0,6,16,16
1713499190771,SIO 295LS,A00,523233,Staff,15,0,30,15
1713499191800,SIO 295S,A00,523232,Staff,15,0,30,15
1713499192826,SOCI 117,A01,494376,Staff,0,2,5,5
1713499193853,WES 237B,A00,494380,Staff,19,0,20,1
1713499195921,AESE 279B,A00,494370,Wade; Jon P,33,0,33,0
1713499196946,AIP 197,001,627712,Vespa; Emanuel Ignacio,9999,0,9999,0
1713499197972,ANAR 135S,A00,494369,Braswell; Geoffrey E.,0,0,0,0
1713499198997,CAT 124RS,A01,519847,Geibel; William,6,0,20,14
1713499200027,CAT 125RS,A01,515971,Geibel; William,6,0,20,14
1713499201052,CLRE 250,A00,511389,Morris; Sheldon,9996,0,9999,3
1713499202077,CLRE 251,A00,507176,Mehta; Ravindra L.,9996,0,9999,3
1713499202077,CLRE 251,B00,511410,Mehta; Ravindra L.,9998,0,9999,1
1713499203104,CLRE 252,A00,507189,Cuomo; Raphael Eduardo,9998,0,9999,1
1713499204128,CLRE 253,A00,507199,Vaida; Florin,9997,0,9999,2
1713499204128,CLRE 253,B00,507202,Vaida; Florin,9999,0,9999,0
1713499205156,CLRE 259,A00,507211,Patel; Hemal,9996,0,9999,3
1713499206187,CLRE 260,A00,507221,Cuomo; Raphael Eduardo,9999,0,9999,0
1713499207212,CLRE 297,001,507242,Cuomo; Raphael Eduardo,9999,0,9999,0
1713499208242,CSE 191,A00,516875,Minnes Kemp; Mor Mia,9999,0,9999,0
1713499209271,CSS 201S,A01,494383,Staff,35,0,35,0
1713499210300,CSS 202S,A01,494387,Staff,35,0,35,0
1713499211328,EAP 100,A00,516065,Staff,9792,0,9999,207
1713499212357,ECE 45,A01,507414,Staff,37,0,60,23
1713499213386,ECE 100,A01,507416,Baghdadchi; Saharnaz,0,0,20,20
1713499213386,ECE 100,A02,507418,Baghdadchi; Saharnaz,19,0,20,1
1713499214411,ECE 111,A01,507420,Staff,27,0,50,23
1713499215437,ECE 197,001,548057,Sievenpiper; Daniel F.,9998,0,9999,1
1713499216465,EDS 115,A00,507243,Choi; Bailey Miyeon,27,0,28,1
1713499217493,EDS 117,A01,494379,Staff,15,0,25,10
1713499218521,EDS 125,A00,507246,Hopkins; Megan Beth,27,0,30,3
1713499219547,EDS 128A,A01,507264,Fargason; Sharon Gayle,26,0,26,0
1713499220572,EDS 128B,A01,507293,Pappas; Elizabeth,30,0,30,0
1713499221600,EDS 139,A00,507294,Fargason; Sharon Gayle,30,0,30,0
1713499221600,EDS 139,B00,507313,Pappas; Elizabeth,30,0,30,0
1713499222623,EDS 201,A00,507315,Staff,18,0,30,12
1713499223649,EDS 203,A01,507317,Halter; Christopher P.,17,0,30,13
1713499224678,EDS 204R,A01,507319,Halter; Christopher P.,0,1,30,30
1713499224678,EDS 204R,B01,507331,Heinzman; Erica M.,22,0,30,8
1713499225702,EDS 206R,A00,507332,Staff,0,2,30,30
1713499225702,EDS 206R,B00,507343,Staff,23,0,30,7
1713499226728,EDS 250,A00,507344,Hemans; Patricia Ann Benitez,27,0,40,13
1713499227753,EDS 281,A00,507345,Daly; Alan J.,18,0,18,0
1713499228833,EDS 284,A00,507350,Daly; Alan J.,16,0,16,0
1713499229861,EDS 286,A00,507359,Fine; Sarah,18,0,18,0
1713499230889,EDS 289C,A01,507361,Daly; Alan J.,18,0,18,0
1713499231914,EDS 290,A00,507366,Hofstetter; Carolyn,15,0,15,0
1713499232941,LIGM 5A,A00,507421,Fischer-Grunski; Eva K,20,0,20,0
1713499233966,LIGM 5B,A00,507423,Fischer-Grunski; Eva K,20,0,20,0
1713499234991,LIGM 5C,A00,507425,Fischer-Grunski; Eva K,20,0,20,0
1713499236020,LIIT 5AS,A00,507427,Carnelos; Chiara,20,0,20,0
1713499237049,LIIT 5BS,A00,507430,Carnelos; Chiara,20,0,20,0
1713499238073,LIIT 5CS,A00,507432,Carnelos; Chiara,20,0,20,0
1713499239099,LISP 5A,A00,507541,Munoz Sanchez; Alicia,14,0,20,6
1713499240125,LISP 5B,A00,507671,Munoz Sanchez; Alicia,12,0,20,8
1713499241154,LISP 5C,A00,507696,Munoz Sanchez; Alicia,11,0,20,9
1713499242182,MAE 197,001,528363,Boechler; Nicholas Sebastia,9998,0,9999,1
1713499243212,MATH 197,001,523477,Kedlaya; Kiran S.,9999,0,9999,0
1713499243212,MATH 197,002,563811,Zhang; Danna,9998,0,9999,1
1713499244243,MCWP 40R,A00,518780,Staff,14,0,20,6
1713499244243,MCWP 40R,B00,518781,Staff,11,0,20,9
1713499244243,MCWP 40R,C00,518783,Staff,9,0,20,11
1713499245269,MCWP 50R,A00,518791,Staff,7,0,20,13
1713499245269,MCWP 50R,B00,518792,Staff,3,0,20,17
1713499245269,MCWP 50R,C00,518793,Staff,7,0,20,13
1713499245269,MCWP 50R,D00,518794,Staff,0,0,20,20
1713499245269,MCWP 50R,E00,518795,Staff,0,0,20,20
1713499245269,MCWP 50R,F00,518796,Staff,11,0,20,9
1713499245269,MCWP 50R,G00,518797,Staff,10,0,20,10
1713499246295,MMW 12R,A01,514034,Herbst; Matthew,4,0,16,12
1713499246295,MMW 12R,A02,514035,Herbst; Matthew,13,0,16,3
1713499247319,MMW 13R,A01,514037,Staff,0,8,16,16
1713499247319,MMW 13R,A02,514039,Staff,0,6,16,16
1713499249371,SIO 295LS,A00,523233,Staff,15,0,30,15
1713499250396,SIO 295S,A00,523232,Staff,15,0,30,15
1713499251423,SOCI 117,A01,494376,Staff,0,2,5,5
1713499252449,WES 237B,A00,494380,Staff,19,0,20,1
1713499254515,AESE 279B,A00,494370,Wade; Jon P,33,0,33,0
1713499255539,AIP 197,001,627712,Vespa; Emanuel Ignacio,9999,0,9999,0
1713499256565,ANAR 135S,A00,494369,Braswell; Geoffrey E.,0,0,0,0
1713499257592,CAT 124RS,A01,519847,Geibel; William,6,0,20,14
1713499258623,CAT 125RS,A01,515971,Geibel; William,6,0,20,14
1713499259649,CLRE 250,A00,511389,Morris; Sheldon,9996,0,9999,3
1713499260682,CLRE 251,A00,507176,Mehta; Ravindra L.,9996,0,9999,3
1713499260682,CLRE 251,B00,511410,Mehta; Ravindra L.,9998,0,9999,1
1713499261712,CLRE 252,A00,507189,Cuomo; Raphael Eduardo,9998,0,9999,1
1713499262739,CLRE 253,A00,507199,Vaida; Florin,9997,0,9999,2
1713499262739,CLRE 253,B00,507202,Vaida; Florin,9999,0,9999,0
1713499263765,CLRE 259,A00,507211,Patel; Hemal,9996,0,9999,3
1713499264791,CLRE 260,A00,507221,Cuomo; Raphael Eduardo,9999,0,9999,0
1713499265817,CLRE 297,001,507242,Cuomo; Raphael Eduardo,9999,0,9999,0
1713499266845,CSE 191,A00,516875,Minnes Kemp; Mor Mia,9999,0,9999,0
1713499267871,CSS 201S,A01,494383,Staff,35,0,35,0
1713499268899,CSS 202S,A01,494387,Staff,35,0,35,0
1713499269926,EAP 100,A00,516065,Staff,9792,0,9999,207
1713499270952,ECE 45,A01,507414,Staff,37,0,60,23
1713499271980,ECE 100,A01,507416,Baghdadchi; Saharnaz,0,0,20,20
1713499271980,ECE 100,A02,507418,Baghdadchi; Saharnaz,19,0,20,1
1713499273006,ECE 111,A01,507420,Staff,27,0,50,23
1713499274031,ECE 197,001,548057,Sievenpiper; Daniel F.,9998,0,9999,1
1713499275056,EDS 115,A00,507243,Choi; Bailey Miyeon,27,0,28,1
1713499276081,EDS 117,A01,494379,Staff,15,0,25,10
1713499277110,EDS 125,A00,507246,Hopkins; Megan Beth,27,0,30,3
1713499278139,EDS 128A,A01,507264,Fargason; Sharon Gayle,26,0,26,0
1713499279167,EDS 128B,A01,507293,Pappas; Elizabeth,30,0,30,0
1713499280190,EDS 139,A00,507294,Fargason; Sharon Gayle,30,0,30,0
1713499280190,EDS 139,B00,507313,Pappas; Elizabeth,30,0,30,0
1713499281214,EDS 201,A00,507315,Staff,18,0,30,12
1713499282239,EDS 203,A01,507317,Halter; Christopher P.,17,0,30,13
1713499283265,EDS 204R,A01,507319,Halter; Christopher P.,0,1,30,30
1713499283265,EDS 204R,B01,507331,Heinzman; Erica M.,22,0,30,8
1713499284290,EDS 206R,A00,507332,Staff,0,2,30,30
1713499284290,EDS 206R,B00,507343,Staff,23,0,30,7
1713499285316,EDS 250,A00,507344,Hemans; Patricia Ann Benitez,27,0,40,13
1713499286341,EDS 281,A00,507345,Daly; Alan J.,18,0,18,0
1713499287369,EDS 284,A00,507350,Daly; Alan J.,16,0,16,0
1713499288395,EDS 286,A00,507359,Fine; Sarah,18,0,18,0
1713499289420,EDS 289C,A01,507361,Daly; Alan J.,18,0,18,0
1713499290445,EDS 290,A00,507366,Hofstetter; Carolyn,15,0,15,0
1713499291473,LIGM 5A,A00,507421,Fischer-Grunski; Eva K,20,0,20,0
1713499292498,LIGM 5B,A00,507423,Fischer-Grunski; Eva K,20,0,20,0
1713499293523,LIGM 5C,A00,507425,Fischer-Grunski; Eva K,20,0,20,0
1713499294548,LIIT 5AS,A00,507427,Carnelos; Chiara,20,0,20,0
1713499295574,LIIT 5BS,A00,507430,Carnelos; Chiara,20,0,20,0
1713499296603,LIIT 5CS,A00,507432,Carnelos; Chiara,20,0,20,0
1713499297631,LISP 5A,A00,507541,Munoz Sanchez; Alicia,14,0,20,6
1713499298657,LISP 5B,A00,507671,Munoz Sanchez; Alicia,12,0,20,8
1713499299682,LISP 5C,A00,507696,Munoz Sanchez; Alicia,11,0,20,9
1713499300709,MAE 197,001,528363,Boechler; Nicholas Sebastia,9998,0,9999,1
1713499301735,MATH 197,001,523477,Kedlaya; Kiran S.,9999,0,9999,0
1713499301735,MATH 197,002,563811,Zhang; Danna,9998,0,9999,1
1713499302760,MCWP 40R,A00,518780,Staff,14,0,20,6
1713499302760,MCWP 40R,B00,518781,Staff,11,0,20,9
1713499302760,MCWP 40R,C00,518783,Staff,9,0,20,11
1713499303786,MCWP 50R,A00,518791,Staff,7,0,20,13
1713499303786,MCWP 50R,B00,518792,Staff,3,0,20,17
1713499303786,MCWP 50R,C00,518793,Staff,7,0,20,13
1713499303786,MCWP 50R,D00,518794,Staff,0,0,20,20
1713499303786,MCWP 50R,E00,518795,Staff,0,0,20,20
1713499303786,MCWP 50R,F00,518796,Staff,11,0,20,9
1713499303786,MCWP 50R,G00,518797,Staff,10,0,20,10
1713499304811,MMW 12R,A01,514034,Herbst; Matthew,4,0,16,12
1713499304811,MMW 12R,A02,514035,Herbst; Matthew,13,0,16,3
1713499305839,MMW 13R,A01,514037,Staff,0,8,16,16
1713499305839,MMW 13R,A02,514039,Staff,0,6,16,16
1713499307894,SIO 295LS,A00,523233,Staff,15,0,30,15
1713499308923,SIO 295S,A00,523232,Staff,15,0,30,15
1713499309951,SOCI 117,A01,494376,Staff,0,2,5,5
1713499310979,WES 237B,A00,494380,Staff,19,0,20,1
1713499313038,AESE 279B,A00,494370,Wade; Jon P,33,0,33,0
1713499314067,AIP 197,001,627712,Vespa; Emanuel Ignacio,9999,0,9999,0
1713499315095,ANAR 135S,A00,494369,Braswell; Geoffrey E.,0,0,0,0
1713499316121,CAT 124RS,A01,519847,Geibel; William,6,0,20,14
1713499317146,CAT 125RS,A01,515971,Geibel; William,6,0,20,14
1713499318175,CLRE 250,A00,511389,Morris; Sheldon,9996,0,9999,3
1713499319202,CLRE 251,A00,507176,Mehta; Ravindra L.,9996,0,9999,3
1713499319202,CLRE 251,B00,511410,Mehta; Ravindra L.,9998,0,9999,1
1713499320231,CLRE 252,A00,507189,Cuomo; Raphael Eduardo,9998,0,9999,1
1713499321257,CLRE 253,A00,507199,Vaida; Florin,9997,0,9999,2
1713499321257,CLRE 253,B00,507202,Vaida; Florin,9999,0,9999,0
1713499322286,CLRE 259,A00,507211,Patel; Hemal,9996,0,9999,3
1713499323311,CLRE 260,A00,507221,Cuomo; Raphael Eduardo,9999,0,9999,0
1713499324339,CLRE 297,001,507242,Cuomo; Raphael Eduardo,9999,0,9999,0
1713499325364,CSE 191,A00,516875,Minnes Kemp; Mor Mia,9999,0,9999,0
1713499326391,CSS 201S,A01,494383,Staff,35,0,35,0
1713499327419,CSS 202S,A01,494387,Staff,35,0,35,0
1713499328447,EAP 100,A00,516065,Staff,9792,0,9999,207
1713499329475,ECE 45,A01,507414,Staff,37,0,60,23
1713499330501,ECE 100,A01,507416,Baghdadchi; Saharnaz,0,0,20,20
1713499330501,ECE 100,A02,507418,Baghdadchi; Saharnaz,19,0,20,1
1713499331525,ECE 111,A01,507420,Staff,27,0,50,23
1713499332605,ECE 197,001,548057,Sievenpiper; Daniel F.,9998,0,9999,1
1713499333634,EDS 115,A00,507243,Choi; Bailey Miyeon,27,0,28,1
1713499334664,EDS 117,A01,494379,Staff,15,0,25,10
1713499335694,EDS 125,A00,507246,Hopkins; Megan Beth,27,0,30,3
1713499336719,EDS 128A,A01,507264,Fargason; Sharon Gayle,26,0,26,0
1713499337743,EDS 128B,A01,507293,Pappas; Elizabeth,30,0,30,0
1713499338771,EDS 139,A00,507294,Fargason; Sharon Gayle,30,0,30,0
1713499338771,EDS 139,B00,507313,Pappas; Elizabeth,30,0,30,0
1713499339797,EDS 201,A00,507315,Staff,18,0,30,12
1713499340824,EDS 203,A01,507317,Halter; Christopher P.,17,0,30,13
1713499341850,EDS 204R,A01,507319,Halter; Christopher P.,0,1,30,30
1713499341850,EDS 204R,B01,507331,Heinzman; Erica M.,22,0,30,8
1713499342876,EDS 206R,A00,507332,Staff,0,2,30,30
1713499342876,EDS 206R,B00,507343,Staff,23,0,30,7
1713499343902,EDS 250,A00,507344,Hemans; Patricia Ann Benitez,27,0,40,13
1713499344928,EDS 281,A00,507345,Daly; Alan J.,18,0,18,0
1713499345956,EDS 284,A00,507350,Daly; Alan J.,16,0,16,0
1713499346982,EDS 286,A00,507359,Fine; Sarah,18,0,18,0
1713499348005,EDS 289C,A01,507361,Daly; Alan J.,18,0,18,0
1713499349034,EDS 290,A00,507366,Hofstetter; Carolyn,15,0,15,0
1713499350063,LIGM 5A,A00,507421,Fischer-Grunski; Eva K,20,0,20,0
1713499351093,LIGM 5B,A00,507423,Fischer-Grunski; Eva K,20,0,20,0
1713499352118,LIGM 5C,A00,507425,Fischer-Grunski; Eva K,20,0,20,0
1713499353147,LIIT 5AS,A00,507427,Carnelos; Chiara,20,0,20,0
1713499354174,LIIT 5BS,A00,507430,Carnelos; Chiara,20,0,20,0
1713499355203,LIIT 5CS,A00,507432,Carnelos; Chiara,20,0,20,0
1713499356233,LISP 5A,A00,507541,Munoz Sanchez; Alicia,14,0,20,6
1713499357264,LISP 5B,A00,507671,Munoz Sanchez; Alicia,12,0,20,8
1713499358291,LISP 5C,A00,507696,Munoz Sanchez; Alicia,11,0,20,9
1713499359316,MAE 197,001,528363,Boechler; Nicholas Sebastia,9998,0,9999,1
1713499360341,MATH 197,001,523477,Kedlaya; Kiran S.,9999,0,9999,0
1713499360341,MATH 197,002,563811,Zhang; Danna,9998,0,9999,1
1713499361371,MCWP 40R,A00,518780,Staff,14,0,20,6
1713499361371,MCWP 40R,B00,518781,Staff,11,0,20,9
1713499361371,MCWP 40R,C00,518783,Staff,9,0,20,11
1713499362396,MCWP 50R,A00,518791,Staff,7,0,20,13
1713499362396,MCWP 50R,B00,518792,Staff,3,0,20,17
1713499362396,MCWP 50R,C00,518793,Staff,7,0,20,13
1713499362396,MCWP 50R,D00,518794,Staff,0,0,20,20
1713499362396,MCWP 50R,E00,518795,Staff,0,0,20,20
1713499362396,MCWP 50R,F00,518796,Staff,11,0,20,9
1713499362396,MCWP 50R,G00,518797,Staff,10,0,20,10
1713499363421,MMW 12R,A01,514034,Herbst; Matthew,4,0,16,12
1713499363421,MMW 12R,A02,514035,Herbst; Matthew,13,0,16,3
1713499364446,MMW 13R,A01,514037,Staff,0,8,16,16
1713499364446,MMW 13R,A02,514039,Staff,0,6,16,16
1713499366502,SIO 295LS,A00,523233,Staff,15,0,30,15
1713499367528,SIO 295S,A00,523232,Staff,15,0,30,15
1713499368556,SOCI 117,A01,494376,Staff,0,2,5,5
1713499369583,WES 237B,A00,494380,Staff,19,0,20,1
1713499371648,AESE 279B,A00,494370,Wade; Jon P,33,0,33,0
1713499372676,AIP 197,001,627712,Vespa; Emanuel Ignacio,9999,0,9999,0
1713499373700,ANAR 135S,A00,494369,Braswell; Geoffrey E.,0,0,0,0
1713499374730,CAT 124RS,A01,519847,Geibel; William,6,0,20,14
1713499375755,CAT 125RS,A01,515971,Geibel; William,6,0,20,14
1713499376781,CLRE 250,A00,511389,Morris; Sheldon,9996,0,9999,3
1713499377805,CLRE 251,A00,507176,Mehta; Ravindra L.,9996,0,9999,3
1713499377805,CLRE 251,B00,511410,Mehta; Ravindra L.,9998,0,9999,1
1713499378833,CLRE 252,A00,507189,Cuomo; Raphael Eduardo,9998,0,9999,1
1713499379862,CLRE 253,A00,507199,Vaida; Florin,9997,0,9999,2
1713499379862,CLRE 253,B00,507202,Vaida; Florin,9999,0,9999,0
1713499380891,CLRE 259,A00,507211,Patel; Hemal,9996,0,9999,3
1713499381917,CLRE 260,A00,507221,Cuomo; Raphael Eduardo,9999,0,9999,0
1713499382941,CLRE 297,001,507242,Cuomo; Raphael Eduardo,9999,0,9999,0
1713499383971,CSE 191,A00,516875,Minnes Kemp; Mor Mia,9999,0,9999,0
1713499385000,CSS 201S,A01,494383,Staff,35,0,35,0
1713499386026,CSS 202S,A01,494387,Staff,35,0,35,0
1713499387054,EAP 100,A00,516065,Staff,9792,0,9999,207
1713499388081,ECE 45,A01,507414,Staff,37,0,60,23
1713499389106,ECE 100,A01,507416,Baghdadchi; Saharnaz,0,0,20,20
1713499389106,ECE 100,A02,507418,Baghdadchi; Saharnaz,19,0,20,1
1713499390137,ECE 111,A01,507420,Staff,27,0,50,23
1713499391163,ECE 197,001,548057,Sievenpiper; Daniel F.,9998,0,9999,1
1713499392191,EDS 115,A00,507243,Choi; Bailey Miyeon,27,0,28,1
1713499393219,EDS 117,A01,494379,Staff,15,0,25,10
1713499394245,EDS 125,A00,507246,Hopkins; Megan Beth,27,0,30,3
1713499395273,EDS 128A,A01,507264,Fargason; Sharon Gayle,26,0,26,0
1713499396299,EDS 128B,A01,507293,Pappas; Elizabeth,30,0,30,0
1713499397328,EDS 139,A00,507294,Fargason; Sharon Gayle,30,0,30,0
1713499397328,EDS 139,B00,507313,Pappas; Elizabeth,30,0,30,0
1713499398354,EDS 201,A00,507315,Staff,18,0,30,12
1713499399380,EDS 203,A01,507317,Halter; Christopher P.,17,0,30,13
1713499400406,EDS 204R,A01,507319,Halter; Christopher P.,0,1,30,30
1713499400406,EDS 204R,B01,507331,Heinzman; Erica M.,22,0,30,8
1713499401431,EDS 206R,A00,507332,Staff,0,2,30,30
1713499401431,EDS 206R,B00,507343,Staff,23,0,30,7
1713499402459,EDS 250,A00,507344,Hemans; Patricia Ann Benitez,27,0,40,13
1713499403487,EDS 281,A00,507345,Daly; Alan J.,18,0,18,0
1713499404512,EDS 284,A00,507350,Daly; Alan J.,16,0,16,0
1713499405538,EDS 286,A00,507359,Fine; Sarah,18,0,18,0
1713499406565,EDS 289C,A01,507361,Daly; Alan J.,18,0,18,0
1713499407591,EDS 290,A00,507366,Hofstetter; Carolyn,15,0,15,0
1713499408617,LIGM 5A,A00,507421,Fischer-Grunski; Eva K,20,0,20,0
1713499409643,LIGM 5B,A00,507423,Fischer-Grunski; Eva K,20,0,20,0
1713499410668,LIGM 5C,A00,507425,Fischer-Grunski; Eva K,20,0,20,0
1713499411693,LIIT 5AS,A00,507427,Carnelos; Chiara,20,0,20,0
1713499412719,LIIT 5BS,A00,507430,Carnelos; Chiara,20,0,20,0
1713499413747,LIIT 5CS,A00,507432,Carnelos; Chiara,20,0,20,0
1713499414774,LISP 5A,A00,507541,Munoz Sanchez; Alicia,14,0,20,6
1713499415800,LISP 5B,A00,507671,Munoz Sanchez; Alicia,12,0,20,8
1713499416826,LISP 5C,A00,507696,Munoz Sanchez; Alicia,11,0,20,9
1713499417855,MAE 197,001,528363,Boechler; Nicholas Sebastia,9998,0,9999,1
1713499418881,MATH 197,001,523477,Kedlaya; Kiran S.,9999,0,9999,0
1713499418881,MATH 197,002,563811,Zhang; Danna,9998,0,9999,1
1713499419909,MCWP 40R,A00,518780,Staff,14,0,20,6
1713499419909,MCWP 40R,B00,518781,Staff,11,0,20,9
1713499419909,MCWP 40R,C00,518783,Staff,9,0,20,11
1713499420936,MCWP 50R,A00,518791,Staff,7,0,20,13
1713499420936,MCWP 50R,B00,518792,Staff,3,0,20,17
1713499420936,MCWP 50R,C00,518793,Staff,7,0,20,13
1713499420936,MCWP 50R,D00,518794,Staff,0,0,20,20
1713499420936,MCWP 50R,E00,518795,Staff,0,0,20,20
1713499420936,MCWP 50R,F00,518796,Staff,11,0,20,9
1713499420936,MCWP 50R,G00,518797,Staff,10,0,20,10
1713499421961,MMW 12R,A01,514034,Herbst; Matthew,4,0,16,12
1713499421961,MMW 12R,A02,514035,Herbst; Matthew,13,0,16,3
1713499422986,MMW 13R,A01,514037,Staff,0,8,16,16
1713499422986,MMW 13R,A02,514039,Staff,0,6,16,16
1713499425036,SIO 295LS,A00,523233,Staff,15,0,30,15
1713499426061,SIO 295S,A00,523232,Staff,15,0,30,15
1713499427088,SOCI 117,A01,494376,Staff,0,2,5,5
1713499428112,WES 237B,A00,494380,Staff,19,0,20,1
1713499430179,AESE 279B,A00,494370,Wade; Jon P,33,0,33,0
1713499431208,AIP 197,001,627712,Vespa; Emanuel Ignacio,9999,0,9999,0
1713499432237,ANAR 135S,A00,494369,Braswell; Geoffrey E.,0,0,0,0
1713499433265,CAT 124RS,A01,519847,Geibel; William,6,0,20,14
1713499434293,CAT 125RS,A01,515971,Geibel; William,6,0,20,14
1713499435318,CLRE 250,A00,511389,Morris; Sheldon,9996,0,9999,3
1713499436406,CLRE 251,A00,507176,Mehta; Ravindra L.,9996,0,9999,3
1713499436406,CLRE 251,B00,511410,Mehta; Ravindra L.,9998,0,9999,1
1713499437432,CLRE 252,A00,507189,Cuomo; Raphael Eduardo,9998,0,9999,1
1713499438457,CLRE 253,A00,507199,Vaida; Florin,9997,0,9999,2
1713499438457,CLRE 253,B00,507202,Vaida; Florin,9999,0,9999,0
1713499439483,CLRE 259,A00,507211,Patel; Hemal,9996,0,9999,3
1713499440508,CLRE 260,A00,507221,Cuomo; Raphael Eduardo,9999,0,9999,0
1713499441537,CLRE 297,001,507242,Cuomo; Raphael Eduardo,9999,0,9999,0
1713499442565,CSE 191,A00,516875,Minnes Kemp; Mor Mia,9999,0,9999,0
1713499443594,CSS 201S,A01,494383,Staff,35,0,35,0
1713499444621,CSS 202S,A01,494387,Staff,35,0,35,0
1713499445653,EAP 100,A00,516065,Staff,9792,0,9999,207
1713499446681,ECE 45,A01,507414,Staff,37,0,60,23
1713499447709,ECE 100,A01,507416,Baghdadchi; Saharnaz,0,0,20,20
1713499447709,ECE 100,A02,507418,Baghdadchi; Saharnaz,19,0,20,1
1713499448739,ECE 111,A01,507420,Staff,27,0,50,23
1713499449768,ECE 197,001,548057,Sievenpiper; Daniel F.,9998,0,9999,1
1713499450797,EDS 115,A00,507243,Choi; Bailey Miyeon,27,0,28,1
1713499451823,EDS 117,A01,494379,Staff,15,0,25,10
1713499452849,EDS 125,A00,507246,Hopkins; Megan Beth,27,0,30,3
1713499453874,EDS 128A,A01,507264,Fargason; Sharon Gayle,26,0,26,0
1713499454901,EDS 128B,A01,507293,Pappas; Elizabeth,30,0,30,0
1713499455929,EDS 139,A00,507294,Fargason; Sharon Gayle,30,0,30,0
1713499455929,EDS 139,B00,507313,Pappas; Elizabeth,30,0,30,0
1713499456954,EDS 201,A00,507315,Staff,18,0,30,12
1713499457982,EDS 203,A01,507317,Halter; Christopher P.,17,0,30,13
1713499459011,EDS 204R,A01,507319,Halter; Christopher P.,0,1,30,30
1713499459011,EDS 204R,B01,507331,Heinzman; Erica M.,22,0,30,8
1713499460035,EDS 206R,A00,507332,Staff,0,2,30,30
1713499460035,EDS 206R,B00,507343,Staff,23,0,30,7
1713499461059,EDS 250,A00,507344,Hemans; Patricia Ann Benitez,27,0,40,13
1713499462083,EDS 281,A00,507345,Daly; Alan J.,18,0,18,0
1713499463107,EDS 284,A00,507350,Daly; Alan J.,16,0,16,0
1713499464131,EDS 286,A00,507359,Fine; Sarah,18,0,18,0
1713499465160,EDS 289C,A01,507361,Daly; Alan J.,18,0,18,0
1713499466192,EDS 290,A00,507366,Hofstetter; Carolyn,15,0,15,0
1713499467519,LIGM 5A,A00,507421,Fischer-Grunski; Eva K,20,0,20,0
1713499468545,LIGM 5B,A00,507423,Fischer-Grunski; Eva K,20,0,20,0
1713499469574,LIGM 5C,A00,507425,Fischer-Grunski; Eva K,20,0,20,0
1713499470603,LIIT 5AS,A00,507427,Carnelos; Chiara,20,0,20,0
1713499471632,LIIT 5BS,A00,507430,Carnelos; Chiara,20,0,20,0
1713499472660,LIIT 5CS,A00,507432,Carnelos; Chiara,20,0,20,0
1713499473686,LISP 5A,A00,507541,Munoz Sanchez; Alicia,14,0,20,6
1713499474714,LISP 5B,A00,507671,Munoz Sanchez; Alicia,12,0,20,8
1713499475744,LISP 5C,A00,507696,Munoz Sanchez; Alicia,11,0,20,9
1713499476768,MAE 197,001,528363,Boechler; Nicholas Sebastia,9998,0,9999,1
1713499477798,MATH 197,001,523477,Kedlaya; Kiran S.,9999,0,9999,0
1713499477798,MATH 197,002,563811,Zhang; Danna,9998,0,9999,1
1713499478822,MCWP 40R,A00,518780,Staff,14,0,20,6
1713499478822,MCWP 40R,B00,518781,Staff,11,0,20,9
1713499478822,MCWP 40R,C00,518783,Staff,9,0,20,11
1713499479853,MCWP 50R,A00,518791,Staff,7,0,20,13
1713499479853,MCWP 50R,B00,518792,Staff,3,0,20,17
1713499479853,MCWP 50R,C00,518793,Staff,7,0,20,13
1713499479853,MCWP 50R,D00,518794,Staff,0,0,20,20
1713499479853,MCWP 50R,E00,518795,Staff,0,0,20,20
1713499479853,MCWP 50R,F00,518796,Staff,11,0,20,9
1713499479853,MCWP 50R,G00,518797,Staff,10,0,20,10
1713499480880,MMW 12R,A01,514034,Herbst; Matthew,4,0,16,12
1713499480880,MMW 12R,A02,514035,Herbst; Matthew,13,0,16,3
1713499481925,MMW 13R,A01,514037,Staff,0,8,16,16
1713499481925,MMW 13R,A02,514039,Staff,0,6,16,16
1713499483974,SIO 295LS,A00,523233,Staff,15,0,30,15
1713499485000,SIO 295S,A00,523232,Staff,15,0,30,15
1713499486028,SOCI 117,A01,494376,Staff,0,2,5,5
1713499487054,WES 237B,A00,494380,Staff,19,0,20,1
1713499489132,AESE 279B,A00,494370,Wade; Jon P,33,0,33,0
1713499490158,AIP 197,001,627712,Vespa; Emanuel Ignacio,9999,0,9999,0
1713499491187,ANAR 135S,A00,494369,Braswell; Geoffrey E.,0,0,0,0
1713499492217,CAT 124RS,A01,519847,Geibel; William,6,0,20,14
1713499493245,CAT 125RS,A01,515971,Geibel; William,6,0,20,14
1713499494270,CLRE 250,A00,511389,Morris; Sheldon,9996,0,9999,3
1713499495296,CLRE 251,A00,507176,Mehta; Ravindra L.,9996,0,9999,3
1713499495296,CLRE 251,B00,511410,Mehta; Ravindra L.,9998,0,9999,1
1713499496325,CLRE 252,A00,507189,Cuomo; Raphael Eduardo,9998,0,9999,1
1713499497354,CLRE 253,A00,507199,Vaida; Florin,9997,0,9999,2
1713499497354,CLRE 253,B00,507202,Vaida; Florin,9999,0,9999,0
1713499498378,CLRE 259,A00,507211,Patel; Hemal,9996,0,9999,3
1713499499403,CLRE 260,A00,507221,Cuomo; Raphael Eduardo,9999,0,9999,0
1713499500429,CLRE 297,001,507242,Cuomo; Raphael Eduardo,9999,0,9999,0
1713499501455,CSE 191,A00,516875,Minnes Kemp; Mor Mia,9999,0,9999,0
1713499502479,CSS 201S,A01,494383,Staff,35,0,35,0
1713499503505,CSS 202S,A01,494387,Staff,35,0,35,0
1713499504534,EAP 100,A00,516065,Staff,9792,0,9999,207
1713499505562,ECE 45,A01,507414,Staff,37,0,60,23
1713499506593,ECE 100,A01,507416,Baghdadchi; Saharnaz,0,0,20,20
1713499506593,ECE 100,A02,507418,Baghdadchi; Saharnaz,19,0,20,1
1713499507616,ECE 111,A01,507420,Staff,27,0,50,23
1713499508645,ECE 197,001,548057,Sievenpiper; Daniel F.,9998,0,9999,1
1713499509670,EDS 115,A00,507243,Choi; Bailey Miyeon,27,0,28,1
1713499510700,EDS 117,A01,494379,Staff,15,0,25,10
1713499511723,EDS 125,A00,507246,Hopkins; Megan Beth,27,0,30,3
1713499512752,EDS 128A,A01,507264,Fargason; Sharon Gayle,26,0,26,0
1713499513776,EDS 128B,A01,507293,Pappas; Elizabeth,30,0,30,0
1713499514801,EDS 139,A00,507294,Fargason; Sharon Gayle,30,0,30,0
1713499514801,EDS 139,B00,507313,Pappas; Elizabeth,30,0,30,0
1713499515827,EDS 201,A00,507315,Staff,18,0,30,12
1713499516851,EDS 203,A01,507317,Halter; Christopher P.,17,0,30,13
1713499517877,EDS 204R,A01,507319,Halter; Christopher P.,0,1,30,30
1713499517877,EDS 204R,B01,507331,Heinzman; Erica M.,22,0,30,8
1713499518906,EDS 206R,A00,507332,Staff,0,2,30,30
1713499518906,EDS 206R,B00,507343,Staff,23,0,30,7
1713499519931,EDS 250,A00,507344,Hemans; Patricia Ann Benitez,27,0,40,13
1713499520961,EDS 281,A00,507345,Daly; Alan J.,18,0,18,0
1713499521990,EDS 284,A00,507350,Daly; Alan J.,16,0,16,0
1713499523017,EDS 286,A00,507359,Fine; Sarah,18,0,18,0
1713499524043,EDS 289C,A01,507361,Daly; Alan J.,18,0,18,0
1713499525069,EDS 290,A00,507366,Hofstetter; Carolyn,15,0,15,0
1713499526100,LIGM 5A,A00,507421,Fischer-Grunski; Eva K,20,0,20,0
1713499527128,LIGM 5B,A00,507423,Fischer-Grunski; Eva K,20,0,20,0
1713499528156,LIGM 5C,A00,507425,Fischer-Grunski; Eva K,20,0,20,0
1713499529183,LIIT 5AS,A00,507427,Carnelos; Chiara,20,0,20,0
1713499530208,LIIT 5BS,A00,507430,Carnelos; Chiara,20,0,20,0
1713499531238,LIIT 5CS,A00,507432,Carnelos; Chiara,20,0,20,0
1713499532267,LISP 5A,A00,507541,Munoz Sanchez; Alicia,14,0,20,6
1713499533296,LISP 5B,A00,507671,Munoz Sanchez; Alicia,12,0,20,8
1713499534324,LISP 5C,A00,507696,Munoz Sanchez; Alicia,11,0,20,9
1713499535349,MAE 197,001,528363,Boechler; Nicholas Sebastia,9998,0,9999,1
1713499536380,MATH 197,001,523477,Kedlaya; Kiran S.,9999,0,9999,0
1713499536380,MATH 197,002,563811,Zhang; Danna,9998,0,9999,1
1713499537405,MCWP 40R,A00,518780,Staff,14,0,20,6
1713499537405,MCWP 40R,B00,518781,Staff,11,0,20,9
1713499537405,MCWP 40R,C00,518783,Staff,9,0,20,11
1713499538432,MCWP 50R,A00,518791,Staff,7,0,20,13
1713499538432,MCWP 50R,B00,518792,Staff,3,0,20,17
1713499538432,MCWP 50R,C00,518793,Staff,7,0,20,13
1713499538432,MCWP 50R,D00,518794,Staff,0,0,20,20
1713499538432,MCWP 50R,E00,518795,Staff,0,0,20,20
1713499538432,MCWP 50R,F00,518796,Staff,11,0,20,9
1713499538432,MCWP 50R,G00,518797,Staff,10,0,20,10
1713499539458,MMW 12R,A01,514034,Herbst; Matthew,4,0,16,12
1713499539458,MMW 12R,A02,514035,Herbst; Matthew,13,0,16,3
1713499540542,MMW 13R,A01,514037,Staff,0,8,16,16
1713499540542,MMW 13R,A02,514039,Staff,0,6,16,16
1713499542593,SIO 295LS,A00,523233,Staff,15,0,30,15
1713499543619,SIO 295S,A00,523232,Staff,15,0,30,15
1713499544650,SOCI 117,A01,494376,Staff,0,2,5,5
1713499545676,WES 237B,A00,494380,Staff,19,0,20,1
1713499547746,AESE 279B,A00,494370,Wade; Jon P,33,0,33,0
1713499548772,AIP 197,001,627712,Vespa; Emanuel Ignacio,9999,0,9999,0
1713499549798,ANAR 135S,A00,494369,Braswell; Geoffrey E.,0,0,0,0
1713499550827,CAT 124RS,A01,519847,Geibel; William,6,0,20,14
1713499551853,CAT 125RS,A01,515971,Geibel; William,6,0,20,14
1713499552879,CLRE 250,A00,511389,Morris; Sheldon,9996,0,9999,3
1713499553911,CLRE 251,A00,507176,Mehta; Ravindra L.,9996,0,9999,3
1713499553911,CLRE 251,B00,511410,Mehta; Ravindra L.,9998,0,9999,1
1713499554937,CLRE 252,A00,507189,Cuomo; Raphael Eduardo,9998,0,9999,1
1713499555963,CLRE 253,A00,507199,Vaida; Florin,9997,0,9999,2
1713499555963,CLRE 253,B00,507202,Vaida; Florin,9999,0,9999,0
1713499556988,CLRE 259,A00,507211,Patel; Hemal,9996,0,9999,3
1713499558018,CLRE 260,A00,507221,Cuomo; Raphael Eduardo,9999,0,9999,0
1713499559043,CLRE 297,001,507242,Cuomo; Raphael Eduardo,9999,0,9999,0
1713499560074,CSE 191,A00,516875,Minnes Kemp; Mor Mia,9999,0,9999,0
1713499561100,CSS 201S,A01,494383,Staff,35,0,35,0
1713499562129,CSS 202S,A01,494387,Staff,35,0,35,0
1713499563154,EAP 100,A00,516065,Staff,9792,0,9999,207
1713499564180,ECE 45,A01,507414,Staff,37,0,60,23
1713499565206,ECE 100,A01,507416,Baghdadchi; Saharnaz,0,0,20,20
1713499565206,ECE 100,A02,507418,Baghdadchi; Saharnaz,19,0,20,1
1713499566234,ECE 111,A01,507420,Staff,27,0,50,23
1713499567260,ECE 197,001,548057,Sievenpiper; Daniel F.,9998,0,9999,1
1713499568287,EDS 115,A00,507243,Choi; Bailey Miyeon,27,0,28,1
1713499569312,EDS 117,A01,494379,Staff,15,0,25,10
1713499570337,EDS 125,A00,507246,Hopkins; Megan Beth,27,0,30,3
1713499571366,EDS 128A,A01,507264,Fargason; Sharon Gayle,26,0,26,0
1713499572395,EDS 128B,A01,507293,Pappas; Elizabeth,30,0,30,0
1713499573421,EDS 139,A00,507294,Fargason; Sharon Gayle,30,0,30,0
1713499573421,EDS 139,B00,507313,Pappas; Elizabeth,30,0,30,0
1713499574448,EDS 201,A00,507315,Staff,18,0,30,12
1713499575478,EDS 203,A01,507317,Halter; Christopher P.,17,0,30,13
1713499576502,EDS 204R,A01,507319,Halter; Christopher P.,0,1,30,30
1713499576502,EDS 204R,B01,507331,Heinzman; Erica M.,22,0,30,8
1713499577526,EDS 206R,A00,507332,Staff,0,2,30,30
1713499577526,EDS 206R,B00,507343,Staff,23,0,30,7
1713499578552,EDS 250,A00,507344,Hemans; Patricia Ann Benitez,27,0,40,13
1713499579581,EDS 281,A00,507345,Daly; Alan J.,18,0,18,0
1713499580607,EDS 284,A00,507350,Daly; Alan J.,16,0,16,0
1713499581636,EDS 286,A00,507359,Fine; Sarah,18,0,18,0
1713499582668,EDS 289C,A01,507361,Daly; Alan J.,18,0,18,0
1713499583697,EDS 290,A00,507366,Hofstetter; Carolyn,15,0,15,0
1713499584724,LIGM 5A,A00,507421,Fischer-Grunski; Eva K,20,0,20,0
1713499585754,LIGM 5B,A00,507423,Fischer-Grunski; Eva K,20,0,20,0
1713499586782,LIGM 5C,A00,507425,Fischer-Grunski; Eva K,20,0,20,0
1713499587808,LIIT 5AS,A00,507427,Carnelos; Chiara,20,0,20,0
1713499588837,LIIT 5BS,A00,507430,Carnelos; Chiara,20,0,20,0
1713499589863,LIIT 5CS,A00,507432,Carnelos; Chiara,20,0,20,0
1713499590889,LISP 5A,A00,507541,Munoz Sanchez; Alicia,14,0,20,6
1713499591914,LISP 5B,A00,507671,Munoz Sanchez; Alicia,12,0,20,8
1713499592940,LISP 5C,A00,507696,Munoz Sanchez; Alicia,11,0,20,9
1713499593966,MAE 197,001,528363,Boechler; Nicholas Sebastia,9998,0,9999,1
1713499594995,MATH 197,001,523477,Kedlaya; Kiran S.,9999,0,9999,0
1713499594995,MATH 197,002,563811,Zhang; Danna,9998,0,9999,1
1713499596021,MCWP 40R,A00,518780,Staff,14,0,20,6
1713499596021,MCWP 40R,B00,518781,Staff,11,0,20,9
1713499596021,MCWP 40R,C00,518783,Staff,9,0,20,11
1713499597048,MCWP 50R,A00,518791,Staff,7,0,20,13
1713499597048,MCWP 50R,B00,518792,Staff,3,0,20,17
1713499597048,MCWP 50R,C00,518793,Staff,7,0,20,13
1713499597048,MCWP 50R,D00,518794,Staff,0,0,20,20
1713499597048,MCWP 50R,E00,518795,Staff,0,0,20,20
1713499597048,MCWP 50R,F00,518796,Staff,11,0,20,9
1713499597048,MCWP 50R,G00,518797,Staff,10,0,20,10
1713499598073,MMW 12R,A01,514034,Herbst; Matthew,4,0,16,12
1713499598073,MMW 12R,A02,514035,Herbst; Matthew,13,0,16,3
1713499599102,MMW 13R,A01,514037,Staff,0,8,16,16
1713499599102,MMW 13R,A02,514039,Staff,0,6,16,16
1713499601154,SIO 295LS,A00,523233,Staff,15,0,30,15
1713499602183,SIO 295S,A00,523232,Staff,15,0,30,15
1713499603208,SOCI 117,A01,494376,Staff,0,2,5,5
1713499604231,WES 237B,A00,494380,Staff,19,0,20,1
1713499606310,AESE 279B,A00,494370,Wade; Jon P,33,0,33,0
1713499607336,AIP 197,001,627712,Vespa; Emanuel Ignacio,9999,0,9999,0
1713499608364,ANAR 135S,A00,494369,Braswell; Geoffrey E.,0,0,0,0
1713499609392,CAT 124RS,A01,519847,Geibel; William,6,0,20,14
1713499610421,CAT 125RS,A01,515971,Geibel; William,6,0,20,14
1713499611446,CLRE 250,A00,511389,Morris; Sheldon,9996,0,9999,3
1713499612476,CLRE 251,A00,507176,Mehta; Ravindra L.,9996,0,9999,3
1713499612476,CLRE 251,B00,511410,Mehta; Ravindra L.,9998,0,9999,1
1713499613502,CLRE 252,A00,507189,Cuomo; Raphael Eduardo,9998,0,9999,1
1713499614532,CLRE 253,A00,507199,Vaida; Florin,9997,0,9999,2
1713499614532,CLRE 253,B00,507202,Vaida; Florin,9999,0,9999,0
1713499615556,CLRE 259,A00,507211,Patel; Hemal,9996,0,9999,3
1713499616586,CLRE 260,A00,507221,Cuomo; Raphael Eduardo,9999,0,9999,0
1713499617611,CLRE 297,001,507242,Cuomo; Raphael Eduardo,9999,0,9999,0
1713499618638,CSE 191,A00,516875,Minnes Kemp; Mor Mia,9999,0,9999,0
1713499619664,CSS 201S,A01,494383,Staff,35,0,35,0
1713499620693,CSS 202S,A01,494387,Staff,35,0,35,0
1713499621717,EAP 100,A00,516065,Staff,9792,0,9999,207
1713499622748,ECE 45,A01,507414,Staff,37,0,60,23
1713499623774,ECE 100,A01,507416,Baghdadchi; Saharnaz,0,0,20,20
1713499623774,ECE 100,A02,507418,Baghdadchi; Saharnaz,19,0,20,1
1713499624799,ECE 111,A01,507420,Staff,27,0,50,23
1713499625824,ECE 197,001,548057,Sievenpiper; Daniel F.,9998,0,9999,1
1713499626853,EDS 115,A00,507243,Choi; Bailey Miyeon,27,0,28,1
1713499627882,EDS 117,A01,494379,Staff,15,0,25,10
1713499628910,EDS 125,A00,507246,Hopkins; Megan Beth,27,0,30,3
1713499629949,EDS 128A,A01,507264,Fargason; Sharon Gayle,26,0,26,0
1713499630978,EDS 128B,A01,507293,Pappas; Elizabeth,30,0,30,0
1713499632043,EDS 139,A00,507294,Fargason; Sharon Gayle,30,0,30,0
1713499632043,EDS 139,B00,507313,Pappas; Elizabeth,30,0,30,0
1713499633069,EDS 201,A00,507315,Staff,18,0,30,12
1713499634095,EDS 203,A01,507317,Halter; Christopher P.,17,0,30,13
1713499635121,EDS 204R,A01,507319,Halter; Christopher P.,0,1,30,30
1713499635121,EDS 204R,B01,507331,Heinzman; Erica M.,22,0,30,8
1713499636145,EDS 206R,A00,507332,Staff,0,2,30,30
1713499636145,EDS 206R,B00,507343,Staff,23,0,30,7
1713499637170,EDS 250,A00,507344,Hemans; Patricia Ann Benitez,27,0,40,13
1713499638194,EDS 281,A00,507345,Daly; Alan J.,18,0,18,0
1713499639219,EDS 284,A00,507350,Daly; Alan J.,16,0,16,0
1713499640244,EDS 286,A00,507359,Fine; Sarah,18,0,18,0
1713499641273,EDS 289C,A01,507361,Daly; Alan J.,18,0,18,0
1713499642299,EDS 290,A00,507366,Hofstetter; Carolyn,15,0,15,0
1713499643329,LIGM 5A,A00,507421,Fischer-Grunski; Eva K,20,0,20,0
1713499644408,LIGM 5B,A00,507423,Fischer-Grunski; Eva K,20,0,20,0
1713499645433,LIGM 5C,A00,507425,Fischer-Grunski; Eva K,20,0,20,0
1713499646459,LIIT 5AS,A00,507427,Carnelos; Chiara,20,0,20,0
1713499647484,LIIT 5BS,A00,507430,Carnelos; Chiara,20,0,20,0
1713499648510,LIIT 5CS,A00,507432,Carnelos; Chiara,20,0,20,0
1713499649535,LISP 5A,A00,507541,Munoz Sanchez; Alicia,14,0,20,6
1713499650563,LISP 5B,A00,507671,Munoz Sanchez; Alicia,12,0,20,8
1713499651588,LISP 5C,A00,507696,Munoz Sanchez; Alicia,11,0,20,9
1713499652615,MAE 197,001,528363,Boechler; Nicholas Sebastia,9998,0,9999,1
1713499653642,MATH 197,001,523477,Kedlaya; Kiran S.,9999,0,9999,0
1713499653642,MATH 197,002,563811,Zhang; Danna,9998,0,9999,1
1713499654670,MCWP 40R,A00,518780,Staff,14,0,20,6
1713499654670,MCWP 40R,B00,518781,Staff,11,0,20,9
1713499654670,MCWP 40R,C00,518783,Staff,9,0,20,11
1713499655699,MCWP 50R,A00,518791,Staff,7,0,20,13
1713499655699,MCWP 50R,B00,518792,Staff,3,0,20,17
1713499655699,MCWP 50R,C00,518793,Staff,7,0,20,13
1713499655699,MCWP 50R,D00,518794,Staff,0,0,20,20
1713499655699,MCWP 50R,E00,518795,Staff,0,0,20,20
1713499655699,MCWP 50R,F00,518796,Staff,11,0,20,9
1713499655699,MCWP 50R,G00,518797,Staff,10,0,20,10
1713499656723,MMW 12R,A01,514034,Herbst; Matthew,4,0,16,12
1713499656723,MMW 12R,A02,514035,Herbst; Matthew,13,0,16,3
1713499657748,MMW 13R,A01,514037,Staff,0,8,16,16
1713499657748,MMW 13R,A02,514039,Staff,0,6,16,16
1713499659797,SIO 295LS,A00,523233,Staff,15,0,30,15
1713499660821,SIO 295S,A00,523232,Staff,15,0,30,15
1713499661851,SOCI 117,A01,494376,Staff,0,2,5,5
1713499662877,WES 237B,A00,494380,Staff,19,0,20,1
1713499664939,AESE 279B,A00,494370,Wade; Jon P,33,0,33,0
1713499666489,AIP 197,001,627712,Vespa; Emanuel Ignacio,9999,0,9999,0
1713499667517,ANAR 135S,A00,494369,Braswell; Geoffrey E.,0,0,0,0
1713499668542,CAT 124RS,A01,519847,Geibel; William,6,0,20,14
1713499669569,CAT 125RS,A01,515971,Geibel; William,6,0,20,14
1713499670595,CLRE 250,A00,511389,Morris; Sheldon,9996,0,9999,3
1713499671626,CLRE 251,A00,507176,Mehta; Ravindra L.,9996,0,9999,3
1713499671626,CLRE 251,B00,511410,Mehta; Ravindra L.,9998,0,9999,1
1713499672654,CLRE 252,A00,507189,Cuomo; Raphael Eduardo,9998,0,9999,1
1713499673679,CLRE 253,A00,507199,Vaida; Florin,9997,0,9999,2
1713499673679,CLRE 253,B00,507202,Vaida; Florin,9999,0,9999,0
1713499674708,CLRE 259,A00,507211,Patel; Hemal,9996,0,9999,3
1713499675741,CLRE 260,A00,507221,Cuomo; Raphael Eduardo,9999,0,9999,0
1713499676768,CLRE 297,001,507242,Cuomo; Raphael Eduardo,9999,0,9999,0
1713499677795,CSE 191,A00,516875,Minnes Kemp; Mor Mia,9999,0,9999,0
1713499678826,CSS 201S,A01,494383,Staff,35,0,35,0
1713499679850,CSS 202S,A01,494387,Staff,35,0,35,0
1713499680875,EAP 100,A00,516065,Staff,9792,0,9999,207
1713499681905,ECE 45,A01,507414,Staff,37,0,60,23
1713499682931,ECE 100,A01,507416,Baghdadchi; Saharnaz,0,0,20,20
1713499682931,ECE 100,A02,507418,Baghdadchi; Saharnaz,19,0,20,1
1713499683956,ECE 111,A01,507420,Staff,27,0,50,23
1713499684980,ECE 197,001,548057,Sievenpiper; Daniel F.,9998,0,9999,1
1713499686006,EDS 115,A00,507243,Choi; Bailey Miyeon,27,0,28,1
1713499687033,EDS 117,A01,494379,Staff,15,0,25,10
1713499688063,EDS 125,A00,507246,Hopkins; Megan Beth,27,0,30,3
1713499689092,EDS 128A,A01,507264,Fargason; Sharon Gayle,26,0,26,0
1713499690116,EDS 128B,A01,507293,Pappas; Elizabeth,30,0,30,0
1713499691144,EDS 139,A00,507294,Fargason; Sharon Gayle,30,0,30,0
1713499691144,EDS 139,B00,507313,Pappas; Elizabeth,30,0,30,0
1713499692168,EDS 201,A00,507315,Staff,18,0,30,12
1713499693193,EDS 203,A01,507317,Halter; Christopher P.,17,0,30,13
1713499694219,EDS 204R,A01,507319,Halter; Christopher P.,0,1,30,30
1713499694219,EDS 204R,B01,507331,Heinzman; Erica M.,22,0,30,8
1713499695244,EDS 206R,A00,507332,Staff,0,2,30,30
1713499695244,EDS 206R,B00,507343,Staff,23,0,30,7
1713499696271,EDS 250,A00,507344,Hemans; Patricia Ann Benitez,27,0,40,13
1713499697297,EDS 281,A00,507345,Daly; Alan J.,18,0,18,0
1713499698323,EDS 284,A00,507350,Daly; Alan J.,16,0,16,0
1713499699346,EDS 286,A00,507359,Fine; Sarah,18,0,18,0
1713499700375,EDS 289C,A01,507361,Daly; Alan J.,18,0,18,0
1713499701405,EDS 290,A00,507366,Hofstetter; Carolyn,15,0,15,0
1713499702434,LIGM 5A,A00,507421,Fischer-Grunski; Eva K,20,0,20,0
1713499703459,LIGM 5B,A00,507423,Fischer-Grunski; Eva K,20,0,20,0
1713499704485,LIGM 5C,A00,507425,Fischer-Grunski; Eva K,20,0,20,0
1713499705511,LIIT 5AS,A00,507427,Carnelos; Chiara,20,0,20,0
1713499706537,LIIT 5BS,A00,507430,Carnelos; Chiara,20,0,20,0
1713499707566,LIIT 5CS,A00,507432,Carnelos; Chiara,20,0,20,0
1713499708597,LISP 5A,A00,507541,Munoz Sanchez; Alicia,14,0,20,6
1713499709627,LISP 5B,A00,507671,Munoz Sanchez; Alicia,12,0,20,8
1713499710652,LISP 5C,A00,507696,Munoz Sanchez; Alicia,11,0,20,9
1713499711676,MAE 197,001,528363,Boechler; Nicholas Sebastia,9998,0,9999,1
1713499712700,MATH 197,001,523477,Kedlaya; Kiran S.,9999,0,9999,0
1713499712700,MATH 197,002,563811,Zhang; Danna,9998,0,9999,1
1713499713726,MCWP 40R,A00,518780,Staff,14,0,20,6
1713499713726,MCWP 40R,B00,518781,Staff,11,0,20,9
1713499713726,MCWP 40R,C00,518783,Staff,9,0,20,11
1713499714753,MCWP 50R,A00,518791,Staff,7,0,20,13
1713499714753,MCWP 50R,B00,518792,Staff,3,0,20,17
1713499714753,MCWP 50R,C00,518793,Staff,7,0,20,13
1713499714753,MCWP 50R,D00,518794,Staff,0,0,20,20
1713499714753,MCWP 50R,E00,518795,Staff,0,0,20,20
1713499714753,MCWP 50R,F00,518796,Staff,11,0,20,9
1713499714753,MCWP 50R,G00,518797,Staff,10,0,20,10
1713499715780,MMW 12R,A01,514034,Herbst; Matthew,4,0,16,12
1713499715780,MMW 12R,A02,514035,Herbst; Matthew,13,0,16,3
1713499716807,MMW 13R,A01,514037,Staff,0,8,16,16
1713499716807,MMW 13R,A02,514039,Staff,0,6,16,16
1713499718861,SIO 295LS,A00,523233,Staff,15,0,30,15
1713499719888,SIO 295S,A00,523232,Staff,15,0,30,15
1713499720916,SOCI 117,A01,494376,Staff,0,2,5,5
1713499721941,WES 237B,A00,494380,Staff,19,0,20,1
1713499724016,AESE 279B,A00,494370,Wade; Jon P,33,0,33,0
1713499725042,AIP 197,001,627712,Vespa; Emanuel Ignacio,9999,0,9999,0
1713499726067,ANAR 135S,A00,494369,Braswell; Geoffrey E.,0,0,0,0
1713499727091,CAT 124RS,A01,519847,Geibel; William,6,0,20,14
1713499728121,CAT 125RS,A01,515971,Geibel; William,6,0,20,14
1713499729147,CLRE 250,A00,511389,Morris; Sheldon,9996,0,9999,3
1713499730174,CLRE 251,A00,507176,Mehta; Ravindra L.,9996,0,9999,3
1713499730174,CLRE 251,B00,511410,Mehta; Ravindra L.,9998,0,9999,1
1713499731201,CLRE 252,A00,507189,Cuomo; Raphael Eduardo,9998,0,9999,1
1713499732229,CLRE 253,A00,507199,Vaida; Florin,9997,0,9999,2
1713499732229,CLRE 253,B00,507202,Vaida; Florin,9999,0,9999,0
1713499733258,CLRE 259,A00,507211,Patel; Hemal,9996,0,9999,3
1713499734286,CLRE 260,A00,507221,Cuomo; Raphael Eduardo,9999,0,9999,0
1713499735311,CLRE 297,001,507242,Cuomo; Raphael Eduardo,9999,0,9999,0
1713499736337,CSE 191,A00,516875,Minnes Kemp; Mor Mia,9999,0,9999,0
1713499737362,CSS 201S,A01,494383,Staff,35,0,35,0
1713499738391,CSS 202S,A01,494387,Staff,35,0,35,0
1713499739418,EAP 100,A00,516065,Staff,9792,0,9999,207
1713499740447,ECE 45,A01,507414,Staff,37,0,60,23
1713499741473,ECE 100,A01,507416,Baghdadchi; Saharnaz,0,0,20,20
1713499741473,ECE 100,A02,507418,Baghdadchi; Saharnaz,19,0,20,1
1713499742502,ECE 111,A01,507420,Staff,27,0,50,23
1713499743535,ECE 197,001,548057,Sievenpiper; Daniel F.,9998,0,9999,1
1713499744561,EDS 115,A00,507243,Choi; Bailey Miyeon,27,0,28,1
1713499745591,EDS 117,A01,494379,Staff,15,0,25,10
1713499746619,EDS 125,A00,507246,Hopkins; Megan Beth,27,0,30,3
1713499747645,EDS 128A,A01,507264,Fargason; Sharon Gayle,26,0,26,0
1713499748726,EDS 128B,A01,507293,Pappas; Elizabeth,30,0,30,0
1713499749751,EDS 139,A00,507294,Fargason; Sharon Gayle,30,0,30,0
1713499749751,EDS 139,B00,507313,Pappas; Elizabeth,30,0,30,0
1713499750778,EDS 201,A00,507315,Staff,18,0,30,12
1713499751804,EDS 203,A01,507317,Halter; Christopher P.,17,0,30,13
1713499752830,EDS 204R,A01,507319,Halter; Christopher P.,0,1,30,30
1713499752830,EDS 204R,B01,507331,Heinzman; Erica M.,22,0,30,8
1713499753872,EDS 206R,A00,507332,Staff,0,2,30,30
1713499753872,EDS 206R,B00,507343,Staff,23,0,30,7
1713499754897,EDS 250,A00,507344,Hemans; Patricia Ann Benitez,27,0,40,13
1713499755926,EDS 281,A00,507345,Daly; Alan J.,18,0,18,0
1713499756952,EDS 284,A00,507350,Daly; Alan J.,16,0,16,0
1713499757980,EDS 286,A00,507359,Fine; Sarah,18,0,18,0
1713499759008,EDS 289C,A01,507361,Daly; Alan J.,18,0,18,0
1713499760036,EDS 290,A00,507366,Hofstetter; Carolyn,15,0,15,0
1713499761069,LIGM 5A,A00,507421,Fischer-Grunski; Eva K,20,0,20,0
1713499762100,LIGM 5B,A00,507423,Fischer-Grunski; Eva K,20,0,20,0
1713499763129,LIGM 5C,A00,507425,Fischer-Grunski; Eva K,20,0,20,0
1713499764155,LIIT 5AS,A00,507427,Carnelos; Chiara,20,0,20,0
1713499765181,LIIT 5BS,A00,507430,Carnelos; Chiara,20,0,20,0
1713499766207,LIIT 5CS,A00,507432,Carnelos; Chiara,20,0,20,0
1713499767236,LISP 5A,A00,507541,Munoz Sanchez; Alicia,14,0,20,6
1713499768262,LISP 5B,A00,507671,Munoz Sanchez; Alicia,12,0,20,8
1713499769288,LISP 5C,A00,507696,Munoz Sanchez; Alicia,11,0,20,9
1713499770317,MAE 197,001,528363,Boechler; Nicholas Sebastia,9998,0,9999,1
1713499771342,MATH 197,001,523477,Kedlaya; Kiran S.,9999,0,9999,0
1713499771342,MATH 197,002,563811,Zhang; Danna,9998,0,9999,1
1713499772368,MCWP 40R,A00,518780,Staff,14,0,20,6
1713499772368,MCWP 40R,B00,518781,Staff,11,0,20,9
1713499772368,MCWP 40R,C00,518783,Staff,9,0,20,11
1713499773394,MCWP 50R,A00,518791,Staff,7,0,20,13
1713499773394,MCWP 50R,B00,518792,Staff,3,0,20,17
1713499773394,MCWP 50R,C00,518793,Staff,7,0,20,13
1713499773394,MCWP 50R,D00,518794,Staff,0,0,20,20
1713499773394,MCWP 50R,E00,518795,Staff,0,0,20,20
1713499773394,MCWP 50R,F00,518796,Staff,11,0,20,9
1713499773394,MCWP 50R,G00,518797,Staff,10,0,20,10
1713499774422,MMW 12R,A01,514034,Herbst; Matthew,4,0,16,12
1713499774422,MMW 12R,A02,514035,Herbst; Matthew,13,0,16,3
1713499775450,MMW 13R,A01,514037,Staff,0,8,16,16
1713499775450,MMW 13R,A02,514039,Staff,0,6,16,16
1713499777502,SIO 295LS,A00,523233,Staff,15,0,30,15
1713499778530,SIO 295S,A00,523232,Staff,15,0,30,15
1713499779556,SOCI 117,A01,494376,Staff,0,2,5,5
1713499780582,WES 237B,A00,494380,Staff,19,0,20,1
1713499782654,AESE 279B,A00,494370,Wade; Jon P,33,0,33,0
1713499783678,AIP 197,001,627712,Vespa; Emanuel Ignacio,9999,0,9999,0
1713499784708,ANAR 135S,A00,494369,Braswell; Geoffrey E.,0,0,0,0
1713499785737,CAT 124RS,A01,519847,Geibel; William,6,0,20,14
1713499786762,CAT 125RS,A01,515971,Geibel; William,6,0,20,14
1713499787789,CLRE 250,A00,511389,Morris; Sheldon,9996,0,9999,3
1713499788819,CLRE 251,A00,507176,Mehta; Ravindra L.,9996,0,9999,3
1713499788819,CLRE 251,B00,511410,Mehta; Ravindra L.,9998,0,9999,1
1713499789845,CLRE 252,A00,507189,Cuomo; Raphael Eduardo,9998,0,9999,1
1713499790876,CLRE 253,A00,507199,Vaida; Florin,9997,0,9999,2
1713499790876,CLRE 253,B00,507202,Vaida; Florin,9999,0,9999,0
1713499791901,CLRE 259,A00,507211,Patel; Hemal,9996,0,9999,3
1713499792928,CLRE 260,A00,507221,Cuomo; Raphael Eduardo,9999,0,9999,0
1713499793957,CLRE 297,001,507242,Cuomo; Raphael Eduardo,9999,0,9999,0
1713499794981,CSE 191,A00,516875,Minnes Kemp; Mor Mia,9999,0,9999,0
1713499796009,CSS 201S,A01,494383,Staff,35,0,35,0
1713499797039,CSS 202S,A01,494387,Staff,35,0,35,0
1713499798065,EAP 100,A00,516065,Staff,9792,0,9999,207
1713499799091,ECE 45,A01,507414,Staff,37,0,60,23
1713499800116,ECE 100,A01,507416,Baghdadchi; Saharnaz,0,0,20,20
1713499800116,ECE 100,A02,507418,Baghdadchi; Saharnaz,19,0,20,1
1713499801141,ECE 111,A01,507420,Staff,27,0,50,23
1713499802166,ECE 197,001,548057,Sievenpiper; Daniel F.,9998,0,9999,1
1713499803191,EDS 115,A00,507243,Choi; Bailey Miyeon,27,0,28,1
1713499804216,EDS 117,A01,494379,Staff,15,0,25,10
1713499805241,EDS 125,A00,507246,Hopkins; Megan Beth,27,0,30,3
1713499806267,EDS 128A,A01,507264,Fargason; Sharon Gayle,26,0,26,0
1713499807297,EDS 128B,A01,507293,Pappas; Elizabeth,30,0,30,0
1713499808322,EDS 139,A00,507294,Fargason; Sharon Gayle,30,0,30,0
1713499808322,EDS 139,B00,507313,Pappas; Elizabeth,30,0,30,0
1713499809347,EDS 201,A00,507315,Staff,18,0,30,12
1713499810372,EDS 203,A01,507317,Halter; Christopher P.,17,0,30,13
1713499811399,EDS 204R,A01,507319,Halter; Christopher P.,0,1,30,30
1713499811399,EDS 204R,B01,507331,Heinzman; Erica M.,22,0,30,8
1713499812433,EDS 206R,A00,507332,Staff,0,2,30,30
1713499812433,EDS 206R,B00,507343,Staff,23,0,30,7
1713499813462,EDS 250,A00,507344,Hemans; Patricia Ann Benitez,27,0,40,13
1713499814488,EDS 281,A00,507345,Daly; Alan J.,18,0,18,0
1713499815513,EDS 284,A00,507350,Daly; Alan J.,16,0,16,0
1713499816538,EDS 286,A00,507359,Fine; Sarah,18,0,18,0
1713499817562,EDS 289C,A01,507361,Daly; Alan J.,18,0,18,0
1713499818588,EDS 290,A00,507366,Hofstetter; Carolyn,15,0,15,0
1713499819618,LIGM 5A,A00,507421,Fischer-Grunski; Eva K,20,0,20,0
1713499820650,LIGM 5B,A00,507423,Fischer-Grunski; Eva K,20,0,20,0
1713499821679,LIGM 5C,A00,507425,Fischer-Grunski; Eva K,20,0,20,0
1713499822704,LIIT 5AS,A00,507427,Carnelos; Chiara,20,0,20,0
1713499823729,LIIT 5BS,A00,507430,Carnelos; Chiara,20,0,20,0
1713499824755,LIIT 5CS,A00,507432,Carnelos; Chiara,20,0,20,0
1713499825781,LISP 5A,A00,507541,Munoz Sanchez; Alicia,14,0,20,6
1713499826806,LISP 5B,A00,507671,Munoz Sanchez; Alicia,12,0,20,8
1713499827832,LISP 5C,A00,507696,Munoz Sanchez; Alicia,11,0,20,9
1713499828857,MAE 197,001,528363,Boechler; Nicholas Sebastia,9998,0,9999,1
1713499829883,MATH 197,001,523477,Kedlaya; Kiran S.,9999,0,9999,0
1713499829883,MATH 197,002,563811,Zhang; Danna,9998,0,9999,1
1713499830912,MCWP 40R,A00,518780,Staff,14,0,20,6
1713499830912,MCWP 40R,B00,518781,Staff,11,0,20,9
1713499830912,MCWP 40R,C00,518783,Staff,9,0,20,11
1713499831942,MCWP 50R,A00,518791,Staff,7,0,20,13
1713499831942,MCWP 50R,B00,518792,Staff,3,0,20,17
1713499831942,MCWP 50R,C00,518793,Staff,7,0,20,13
1713499831942,MCWP 50R,D00,518794,Staff,0,0,20,20
1713499831942,MCWP 50R,E00,518795,Staff,0,0,20,20
1713499831942,MCWP 50R,F00,518796,Staff,11,0,20,9
1713499831942,MCWP 50R,G00,518797,Staff,10,0,20,10
1713499832968,MMW 12R,A01,514034,Herbst; Matthew,4,0,16,12
1713499832968,MMW 12R,A02,514035,Herbst; Matthew,13,0,16,3
1713499833993,MMW 13R,A01,514037,Staff,0,8,16,16
1713499833993,MMW 13R,A02,514039,Staff,0,6,16,16
1713499836047,SIO 295LS,A00,523233,Staff,15,0,30,15
1713499837074,SIO 295S,A00,523232,Staff,15,0,30,15
1713499838104,SOCI 117,A01,494376,Staff,0,2,5,5
1713499839129,WES 237B,A00,494380,Staff,19,0,20,1
1713499841207,AESE 279B,A00,494370,Wade; Jon P,33,0,33,0
1713499842237,AIP 197,001,627712,Vespa; Emanuel Ignacio,9999,0,9999,0
1713499843264,ANAR 135S,A00,494369,Braswell; Geoffrey E.,0,0,0,0
1713499844295,CAT 124RS,A01,519847,Geibel; William,6,0,20,14
1713499845321,CAT 125RS,A01,515971,Geibel; William,6,0,20,14
1713499846350,CLRE 250,A00,511389,Morris; Sheldon,9996,0,9999,3
1713499847377,CLRE 251,A00,507176,Mehta; Ravindra L.,9996,0,9999,3
1713499847377,CLRE 251,B00,511410,Mehta; Ravindra L.,9998,0,9999,1
1713499848402,CLRE 252,A00,507189,Cuomo; Raphael Eduardo,9998,0,9999,1
1713499849430,CLRE 253,A00,507199,Vaida; Florin,9997,0,9999,2
1713499849430,CLRE 253,B00,507202,Vaida; Florin,9999,0,9999,0
1713499850460,CLRE 259,A00,507211,Patel; Hemal,9996,0,9999,3
1713499851486,CLRE 260,A00,507221,Cuomo; Raphael Eduardo,9999,0,9999,0
1713499852569,CLRE 297,001,507242,Cuomo; Raphael Eduardo,9999,0,9999,0
1713499853595,CSE 191,A00,516875,Minnes Kemp; Mor Mia,9999,0,9999,0
1713499854620,CSS 201S,A01,494383,Staff,35,0,35,0
1713499855648,CSS 202S,A01,494387,Staff,35,0,35,0
1713499856674,EAP 100,A00,516065,Staff,9792,0,9999,207
1713499857697,ECE 45,A01,507414,Staff,37,0,60,23
1713499858723,ECE 100,A01,507416,Baghdadchi; Saharnaz,0,0,20,20
1713499858723,ECE 100,A02,507418,Baghdadchi; Saharnaz,19,0,20,1
1713499859753,ECE 111,A01,507420,Staff,27,0,50,23
1713499860784,ECE 197,001,548057,Sievenpiper; Daniel F.,9998,0,9999,1
1713499861814,EDS 115,A00,507243,Choi; Bailey Miyeon,27,0,28,1
1713499862839,EDS 117,A01,494379,Staff,15,0,25,10
1713499863865,EDS 125,A00,507246,Hopkins; Megan Beth,27,0,30,3
1713499864891,EDS 128A,A01,507264,Fargason; Sharon Gayle,26,0,26,0
1713499865920,EDS 128B,A01,507293,Pappas; Elizabeth,30,0,30,0
1713499866948,EDS 139,A00,507294,Fargason; Sharon Gayle,30,0,30,0
1713499866948,EDS 139,B00,507313,Pappas; Elizabeth,30,0,30,0
1713499867976,EDS 201,A00,507315,Staff,18,0,30,12
1713499869005,EDS 203,A01,507317,Halter; Christopher P.,17,0,30,13
1713499870032,EDS 204R,A01,507319,Halter; Christopher P.,0,1,30,30
1713499870032,EDS 204R,B01,507331,Heinzman; Erica M.,22,0,30,8
1713499871060,EDS 206R,A00,507332,Staff,0,2,30,30
1713499871060,EDS 206R,B00,507343,Staff,23,0,30,7
1713499872090,EDS 250,A00,507344,Hemans; Patricia Ann Benitez,27,0,40,13
1713499873115,EDS 281,A00,507345,Daly; Alan J.,18,0,18,0
1713499874144,EDS 284,A00,507350,Daly; Alan J.,16,0,16,0
1713499875169,EDS 286,A00,507359,Fine; Sarah,18,0,18,0
1713499876197,EDS 289C,A01,507361,Daly; Alan J.,18,0,18,0
1713499877223,EDS 290,A00,507366,Hofstetter; Carolyn,15,0,15,0
1713499878251,LIGM 5A,A00,507421,Fischer-Grunski; Eva K,20,0,20,0
1713499879276,LIGM 5B,A00,507423,Fischer-Grunski; Eva K,20,0,20,0
1713499880306,LIGM 5C,A00,507425,Fischer-Grunski; Eva K,20,0,20,0
1713499881331,LIIT 5AS,A00,507427,Carnelos; Chiara,20,0,20,0
1713499882356,LIIT 5BS,A00,507430,Carnelos; Chiara,20,0,20,0
1713499883382,LIIT 5CS,A00,507432,Carnelos; Chiara,20,0,20,0
1713499884413,LISP 5A,A00,507541,Munoz Sanchez; Alicia,14,0,20,6
1713499885441,LISP 5B,A00,507671,Munoz Sanchez; Alicia,12,0,20,8
1713499886466,LISP 5C,A00,507696,Munoz Sanchez; Alicia,11,0,20,9
1713499887493,MAE 197,001,528363,Boechler; Nicholas Sebastia,9998,0,9999,1
1713499888518,MATH 197,001,523477,Kedlaya; Kiran S.,9999,0,9999,0
1713499888518,MATH 197,002,563811,Zhang; Danna,9998,0,9999,1
1713499889543,MCWP 40R,A00,518780,Staff,14,0,20,6
1713499889543,MCWP 40R,B00,518781,Staff,11,0,20,9
1713499889543,MCWP 40R,C00,518783,Staff,9,0,20,11
1713499890570,MCWP 50R,A00,518791,Staff,7,0,20,13
1713499890570,MCWP 50R,B00,518792,Staff,3,0,20,17
1713499890570,MCWP 50R,C00,518793,Staff,7,0,20,13
1713499890570,MCWP 50R,D00,518794,Staff,0,0,20,20
1713499890570,MCWP 50R,E00,518795,Staff,0,0,20,20
1713499890570,MCWP 50R,F00,518796,Staff,11,0,20,9
1713499890570,MCWP 50R,G00,518797,Staff,10,0,20,10
1713499891595,MMW 12R,A01,514034,Herbst; Matthew,4,0,16,12
1713499891595,MMW 12R,A02,514035,Herbst; Matthew,13,0,16,3
1713499892619,MMW 13R,A01,514037,Staff,0,8,16,16
1713499892619,MMW 13R,A02,514039,Staff,0,6,16,16
1713499894669,SIO 295LS,A00,523233,Staff,15,0,30,15
1713499895697,SIO 295S,A00,523232,Staff,15,0,30,15
1713499896726,SOCI 117,A01,494376,Staff,0,2,5,5
1713499897750,WES 237B,A00,494380,Staff,19,0,20,1
1713499899818,AESE 279B,A00,494370,Wade; Jon P,33,0,33,0
1713499900845,AIP 197,001,627712,Vespa; Emanuel Ignacio,9999,0,9999,0
1713499901870,ANAR 135S,A00,494369,Braswell; Geoffrey E.,0,0,0,0
1713499902893,CAT 124RS,A01,519847,Geibel; William,6,0,20,14
1713499903922,CAT 125RS,A01,515971,Geibel; William,6,0,20,14
1713499904952,CLRE 250,A00,511389,Morris; Sheldon,9996,0,9999,3
1713499905982,CLRE 251,A00,507176,Mehta; Ravindra L.,9996,0,9999,3
1713499905982,CLRE 251,B00,511410,Mehta; Ravindra L.,9998,0,9999,1
1713499907007,CLRE 252,A00,507189,Cuomo; Raphael Eduardo,9998,0,9999,1
1713499908033,CLRE 253,A00,507199,Vaida; Florin,9997,0,9999,2
1713499908033,CLRE 253,B00,507202,Vaida; Florin,9999,0,9999,0
1713499909060,CLRE 259,A00,507211,Patel; Hemal,9996,0,9999,3
1713499910084,CLRE 260,A00,507221,Cuomo; Raphael Eduardo,9999,0,9999,0
1713499911109,CLRE 297,001,507242,Cuomo; Raphael Eduardo,9999,0,9999,0
1713499912135,CSE 191,A00,516875,Minnes Kemp; Mor Mia,9999,0,9999,0
1713499913165,CSS 201S,A01,494383,Staff,35,0,35,0
1713499914194,CSS 202S,A01,494387,Staff,35,0,35,0
1713499915222,EAP 100,A00,516065,Staff,9792,0,9999,207
1713499916248,ECE 45,A01,507414,Staff,37,0,60,23
1713499917274,ECE 100,A01,507416,Baghdadchi; Saharnaz,0,0,20,20
1713499917274,ECE 100,A02,507418,Baghdadchi; Saharnaz,19,0,20,1
1713499918303,ECE 111,A01,507420,Staff,27,0,50,23
1713499919330,ECE 197,001,548057,Sievenpiper; Daniel F.,9998,0,9999,1
1713499920360,EDS 115,A00,507243,Choi; Bailey Miyeon,27,0,28,1
1713499921390,EDS 117,A01,494379,Staff,15,0,25,10
1713499922419,EDS 125,A00,507246,Hopkins; Megan Beth,27,0,30,3
1713499923445,EDS 128A,A01,507264,Fargason; Sharon Gayle,26,0,26,0
1713499924472,EDS 128B,A01,507293,Pappas; Elizabeth,30,0,30,0
1713499925499,EDS 139,A00,507294,Fargason; Sharon Gayle,30,0,30,0
1713499925499,EDS 139,B00,507313,Pappas; Elizabeth,30,0,30,0
1713499926527,EDS 201,A00,507315,Staff,18,0,30,12
1713499927552,EDS 203,A01,507317,Halter; Christopher P.,17,0,30,13
1713499928576,EDS 204R,A01,507319,Halter; Christopher P.,0,1,30,30
1713499928576,EDS 204R,B01,507331,Heinzman; Erica M.,22,0,30,8
1713499929600,EDS 206R,A00,507332,Staff,0,2,30,30
1713499929600,EDS 206R,B00,507343,Staff,23,0,30,7
1713499930625,EDS 250,A00,507344,Hemans; Patricia Ann Benitez,27,0,40,13
1713499931654,EDS 281,A00,507345,Daly; Alan J.,18,0,18,0
1713499932678,EDS 284,A00,507350,Daly; Alan J.,16,0,16,0
1713499933703,EDS 286,A00,507359,Fine; Sarah,18,0,18,0
1713499934727,EDS 289C,A01,507361,Daly; Alan J.,18,0,18,0
1713499935755,EDS 290,A00,507366,Hofstetter; Carolyn,15,0,15,0
1713499936784,LIGM 5A,A00,507421,Fischer-Grunski; Eva K,20,0,20,0
1713499937809,LIGM 5B,A00,507423,Fischer-Grunski; Eva K,20,0,20,0
1713499938835,LIGM 5C,A00,507425,Fischer-Grunski; Eva K,20,0,20,0
1713499939865,LIIT 5AS,A00,507427,Carnelos; Chiara,20,0,20,0
1713499940895,LIIT 5BS,A00,507430,Carnelos; Chiara,20,0,20,0
1713499941925,LIIT 5CS,A00,507432,Carnelos; Chiara,20,0,20,0
1713499942951,LISP 5A,A00,507541,Munoz Sanchez; Alicia,14,0,20,6
1713499943979,LISP 5B,A00,507671,Munoz Sanchez; Alicia,12,0,20,8
1713499945007,LISP 5C,A00,507696,Munoz Sanchez; Alicia,11,0,20,9
1713499946037,MAE 197,001,528363,Boechler; Nicholas Sebastia,9998,0,9999,1
1713499947066,MATH 197,001,523477,Kedlaya; Kiran S.,9999,0,9999,0
1713499947066,MATH 197,002,563811,Zhang; Danna,9998,0,9999,1
1713499948092,MCWP 40R,A00,518780,Staff,14,0,20,6
1713499948092,MCWP 40R,B00,518781,Staff,11,0,20,9
1713499948092,MCWP 40R,C00,518783,Staff,9,0,20,11
1713499949122,MCWP 50R,A00,518791,Staff,7,0,20,13
1713499949122,MCWP 50R,B00,518792,Staff,3,0,20,17
1713499949122,MCWP 50R,C00,518793,Staff,7,0,20,13
1713499949122,MCWP 50R,D00,518794,Staff,0,0,20,20
1713499949122,MCWP 50R,E00,518795,Staff,0,0,20,20
1713499949122,MCWP 50R,F00,518796,Staff,11,0,20,9
1713499949122,MCWP 50R,G00,518797,Staff,10,0,20,10
1713499950151,MMW 12R,A01,514034,Herbst; Matthew,4,0,16,12
1713499950151,MMW 12R,A02,514035,Herbst; Matthew,13,0,16,3
1713499951176,MMW 13R,A01,514037,Staff,0,8,16,16
1713499951176,MMW 13R,A02,514039,Staff,0,6,16,16
1713499953231,SIO 295LS,A00,523233,Staff,15,0,30,15
1713499954260,SIO 295S,A00,523232,Staff,15,0,30,15
1713499955285,SOCI 117,A01,494376,Staff,0,2,5,5
1713499956365,WES 237B,A00,494380,Staff,19,0,20,1
1713499958440,AESE 279B,A00,494370,Wade; Jon P,33,0,33,0
1713499959466,AIP 197,001,627712,Vespa; Emanuel Ignacio,9999,0,9999,0
1713499960490,ANAR 135S,A00,494369,Braswell; Geoffrey E.,0,0,0,0
1713499961519,CAT 124RS,A01,519847,Geibel; William,6,0,20,14
1713499962547,CAT 125RS,A01,515971,Geibel; William,6,0,20,14
1713499963572,CLRE 250,A00,511389,Morris; Sheldon,9996,0,9999,3
1713499964598,CLRE 251,A00,507176,Mehta; Ravindra L.,9996,0,9999,3
1713499964598,CLRE 251,B00,511410,Mehta; Ravindra L.,9998,0,9999,1
1713499965623,CLRE 252,A00,507189,Cuomo; Raphael Eduardo,9998,0,9999,1
1713499966647,CLRE 253,A00,507199,Vaida; Florin,9997,0,9999,2
1713499966647,CLRE 253,B00,507202,Vaida; Florin,9999,0,9999,0
1713499967672,CLRE 259,A00,507211,Patel; Hemal,9996,0,9999,3
1713499968697,CLRE 260,A00,507221,Cuomo; Raphael Eduardo,9999,0,9999,0
1713499969722,CLRE 297,001,507242,Cuomo; Raphael Eduardo,9999,0,9999,0
1713499970749,CSE 191,A00,516875,Minnes Kemp; Mor Mia,9999,0,9999,0
1713499971773,CSS 201S,A01,494383,Staff,35,0,35,0
1713499972798,CSS 202S,A01,494387,Staff,35,0,35,0
1713499973825,EAP 100,A00,516065,Staff,9792,0,9999,207
1713499974856,ECE 45,A01,507414,Staff,37,0,60,23
1713499975884,ECE 100,A01,507416,Baghdadchi; Saharnaz,0,0,20,20
1713499975884,ECE 100,A02,507418,Baghdadchi; Saharnaz,19,0,20,1
1713499976910,ECE 111,A01,507420,Staff,27,0,50,23
1713499977939,ECE 197,001,548057,Sievenpiper; Daniel F.,9998,0,9999,1
1713499978968,EDS 115,A00,507243,Choi; Bailey Miyeon,27,0,28,1
1713499979994,EDS 117,A01,494379,Staff,15,0,25,10
1713499981018,EDS 125,A00,507246,Hopkins; Megan Beth,27,0,30,3
1713499982046,EDS 128A,A01,507264,Fargason; Sharon Gayle,26,0,26,0
1713499983072,EDS 128B,A01,507293,Pappas; Elizabeth,30,0,30,0
1713499984097,EDS 139,A00,507294,Fargason; Sharon Gayle,30,0,30,0
1713499984097,EDS 139,B00,507313,Pappas; Elizabeth,30,0,30,0
1713499985124,EDS 201,A00,507315,Staff,18,0,30,12
1713499986150,EDS 203,A01,507317,Halter; Christopher P.,17,0,30,13
1713499987175,EDS 204R,A01,507319,Halter; Christopher P.,0,1,30,30
1713499987175,EDS 204R,B01,507331,Heinzman; Erica M.,22,0,30,8
1713499988202,EDS 206R,A00,507332,Staff,0,2,30,30
1713499988202,EDS 206R,B00,507343,Staff,23,0,30,7
1713499989231,EDS 250,A00,507344,Hemans; Patricia Ann Benitez,27,0,40,13
1713499990257,EDS 281,A00,507345,Daly; Alan J.,18,0,18,0
1713499991283,EDS 284,A00,507350,Daly; Alan J.,16,0,16,0
1713499992312,EDS 286,A00,507359,Fine; Sarah,18,0,18,0
1713499993341,EDS 289C,A01,507361,Daly; Alan J.,18,0,18,0
1713499994369,EDS 290,A00,507366,Hofstetter; Carolyn,15,0,15,0
1713499995398,LIGM 5A,A00,507421,Fischer-Grunski; Eva K,20,0,20,0
1713499996424,LIGM 5B,A00,507423,Fischer-Grunski; Eva K,20,0,20,0
1713499997450,LIGM 5C,A00,507425,Fischer-Grunski; Eva K,20,0,20,0
1713499998476,LIIT 5AS,A00,507427,Carnelos; Chiara,20,0,20,0
1713499999504,LIIT 5BS,A00,507430,Carnelos; Chiara,20,0,20,0
1713500000530,LIIT 5CS,A00,507432,Carnelos; Chiara,20,0,20,0
1713500001556,LISP 5A,A00,507541,Munoz Sanchez; Alicia,14,0,20,6
1713500002582,LISP 5B,A00,507671,Munoz Sanchez; Alicia,12,0,20,8
1713500003611,LISP 5C,A00,507696,Munoz Sanchez; Alicia,11,0,20,9
1713500004640,MAE 197,001,528363,Boechler; Nicholas Sebastia,9998,0,9999,1
1713500005667,MATH 197,001,523477,Kedlaya; Kiran S.,9999,0,9999,0
1713500005667,MATH 197,002,563811,Zhang; Danna,9998,0,9999,1
1713500006696,MCWP 40R,A00,518780,Staff,14,0,20,6
1713500006696,MCWP 40R,B00,518781,Staff,11,0,20,9
1713500006696,MCWP 40R,C00,518783,Staff,9,0,20,11
1713500007722,MCWP 50R,A00,518791,Staff,7,0,20,13
1713500007722,MCWP 50R,B00,518792,Staff,3,0,20,17
1713500007722,MCWP 50R,C00,518793,Staff,7,0,20,13
1713500007722,MCWP 50R,D00,518794,Staff,0,0,20,20
1713500007722,MCWP 50R,E00,518795,Staff,0,0,20,20
1713500007722,MCWP 50R,F00,518796,Staff,11,0,20,9
1713500007722,MCWP 50R,G00,518797,Staff,10,0,20,10
1713500008747,MMW 12R,A01,514034,Herbst; Matthew,4,0,16,12
1713500008747,MMW 12R,A02,514035,Herbst; Matthew,13,0,16,3
1713500009773,MMW 13R,A01,514037,Staff,0,8,16,16
1713500009773,MMW 13R,A02,514039,Staff,0,6,16,16
1713500011827,SIO 295LS,A00,523233,Staff,15,0,30,15
1713500012856,SIO 295S,A00,523232,Staff,15,0,30,15
1713500013887,SOCI 117,A01,494376,Staff,0,2,5,5
1713500014912,WES 237B,A00,494380,Staff,19,0,20,1
1713500016986,AESE 279B,A00,494370,Wade; Jon P,33,0,33,0
1713500018012,AIP 197,001,627712,Vespa; Emanuel Ignacio,9999,0,9999,0
1713500019040,ANAR 135S,A00,494369,Braswell; Geoffrey E.,0,0,0,0
1713500020067,CAT 124RS,A01,519847,Geibel; William,6,0,20,14
1713500021095,CAT 125RS,A01,515971,Geibel; William,6,0,20,14
1713500022120,CLRE 250,A00,511389,Morris; Sheldon,9996,0,9999,3
1713500023151,CLRE 251,A00,507176,Mehta; Ravindra L.,9996,0,9999,3
1713500023151,CLRE 251,B00,511410,Mehta; Ravindra L.,9998,0,9999,1
1713500024177,CLRE 252,A00,507189,Cuomo; Raphael Eduardo,9998,0,9999,1
1713500025205,CLRE 253,A00,507199,Vaida; Florin,9997,0,9999,2
1713500025205,CLRE 253,B00,507202,Vaida; Florin,9999,0,9999,0
1713500026232,CLRE 259,A00,507211,Patel; Hemal,9996,0,9999,3
1713500027260,CLRE 260,A00,507221,Cuomo; Raphael Eduardo,9999,0,9999,0
1713500028290,CLRE 297,001,507242,Cuomo; Raphael Eduardo,9999,0,9999,0
1713500029319,CSE 191,A00,516875,Minnes Kemp; Mor Mia,9999,0,9999,0
1713500030344,CSS 201S,A01,494383,Staff,35,0,35,0
1713500031373,CSS 202S,A01,494387,Staff,35,0,35,0
1713500032398,EAP 100,A00,516065,Staff,9792,0,9999,207
1713500033429,ECE 45,A01,507414,Staff,37,0,60,23
1713500034458,ECE 100,A01,507416,Baghdadchi; Saharnaz,0,0,20,20
1713500034458,ECE 100,A02,507418,Baghdadchi; Saharnaz,19,0,20,1
1713500035483,ECE 111,A01,507420,Staff,27,0,50,23
1713500036510,ECE 197,001,548057,Sievenpiper; Daniel F.,9998,0,9999,1
1713500037533,EDS 115,A00,507243,Choi; Bailey Miyeon,27,0,28,1
1713500038558,EDS 117,A01,494379,Staff,15,0,25,10
1713500039583,EDS 125,A00,507246,Hopkins; Megan Beth,27,0,30,3
1713500040609,EDS 128A,A01,507264,Fargason; Sharon Gayle,26,0,26,0
1713500041637,EDS 128B,A01,507293,Pappas; Elizabeth,30,0,30,0
1713500042661,EDS 139,A00,507294,Fargason; Sharon Gayle,30,0,30,0
1713500042661,EDS 139,B00,507313,Pappas; Elizabeth,30,0,30,0
1713500043687,EDS 201,A00,507315,Staff,18,0,30,12
1713500044714,EDS 203,A01,507317,Halter; Christopher P.,17,0,30,13
1713500045741,EDS 204R,A01,507319,Halter; Christopher P.,0,1,30,30
1713500045741,EDS 204R,B01,507331,Heinzman; Erica M.,22,0,30,8
1713500046767,EDS 206R,A00,507332,Staff,0,2,30,30
1713500046767,EDS 206R,B00,507343,Staff,23,0,30,7
1713500047796,EDS 250,A00,507344,Hemans; Patricia Ann Benitez,27,0,40,13
1713500048821,EDS 281,A00,507345,Daly; Alan J.,18,0,18,0
1713500049846,EDS 284,A00,507350,Daly; Alan J.,16,0,16,0
1713500050872,EDS 286,A00,507359,Fine; Sarah,18,0,18,0
1713500051900,EDS 289C,A01,507361,Daly; Alan J.,18,0,18,0
1713500052925,EDS 290,A00,507366,Hofstetter; Carolyn,15,0,15,0
1713500053951,LIGM 5A,A00,507421,Fischer-Grunski; Eva K,20,0,20,0
1713500054981,LIGM 5B,A00,507423,Fischer-Grunski; Eva K,20,0,20,0
1713500056006,LIGM 5C,A00,507425,Fischer-Grunski; Eva K,20,0,20,0
1713500057032,LIIT 5AS,A00,507427,Carnelos; Chiara,20,0,20,0
1713500058060,LIIT 5BS,A00,507430,Carnelos; Chiara,20,0,20,0
1713500059090,LIIT 5CS,A00,507432,Carnelos; Chiara,20,0,20,0
1713500060173,LISP 5A,A00,507541,Munoz Sanchez; Alicia,14,0,20,6
1713500061203,LISP 5B,A00,507671,Munoz Sanchez; Alicia,12,0,20,8
1713500062225,LISP 5C,A00,507696,Munoz Sanchez; Alicia,11,0,20,9
1713500063250,MAE 197,001,528363,Boechler; Nicholas Sebastia,9998,0,9999,1
1713500064276,MATH 197,001,523477,Kedlaya; Kiran S.,9999,0,9999,0
1713500064276,MATH 197,002,563811,Zhang; Danna,9998,0,9999,1
1713500065306,MCWP 40R,A00,518780,Staff,14,0,20,6
1713500065306,MCWP 40R,B00,518781,Staff,11,0,20,9
1713500065306,MCWP 40R,C00,518783,Staff,9,0,20,11
1713500066332,MCWP 50R,A00,518791,Staff,7,0,20,13
1713500066332,MCWP 50R,B00,518792,Staff,3,0,20,17
1713500066332,MCWP 50R,C00,518793,Staff,7,0,20,13
1713500066332,MCWP 50R,D00,518794,Staff,0,0,20,20
1713500066332,MCWP 50R,E00,518795,Staff,0,0,20,20
1713500066332,MCWP 50R,F00,518796,Staff,11,0,20,9
1713500066332,MCWP 50R,G00,518797,Staff,10,0,20,10
1713500067361,MMW 12R,A01,514034,Herbst; Matthew,4,0,16,12
1713500067361,MMW 12R,A02,514035,Herbst; Matthew,13,0,16,3
1713500068387,MMW 13R,A01,514037,Staff,0,8,16,16
1713500068387,MMW 13R,A02,514039,Staff,0,6,16,16
1713500070438,SIO 295LS,A00,523233,Staff,15,0,30,15
1713500071521,SIO 295S,A00,523232,Staff,15,0,30,15
1713500072545,SOCI 117,A01,494376,Staff,0,2,5,5
1713500073572,WES 237B,A00,494380,Staff,19,0,20,1
1713500075638,AESE 279B,A00,494370,Wade; Jon P,33,0,33,0
1713500076663,AIP 197,001,627712,Vespa; Emanuel Ignacio,9999,0,9999,0
1713500077687,ANAR 135S,A00,494369,Braswell; Geoffrey E.,0,0,0,0
1713500078712,CAT 124RS,A01,519847,Geibel; William,6,0,20,14
1713500079741,CAT 125RS,A01,515971,Geibel; William,6,0,20,14
1713500080770,CLRE 250,A00,511389,Morris; Sheldon,9996,0,9999,3
1713500081801,CLRE 251,A00,507176,Mehta; Ravindra L.,9996,0,9999,3
1713500081801,CLRE 251,B00,511410,Mehta; Ravindra L.,9998,0,9999,1
1713500082826,CLRE 252,A00,507189,Cuomo; Raphael Eduardo,9998,0,9999,1
1713500083857,CLRE 253,A00,507199,Vaida; Florin,9997,0,9999,2
1713500083857,CLRE 253,B00,507202,Vaida; Florin,9999,0,9999,0
1713500084886,CLRE 259,A00,507211,Patel; Hemal,9996,0,9999,3
1713500085912,CLRE 260,A00,507221,Cuomo; Raphael Eduardo,9999,0,9999,0
1713500086937,CLRE 297,001,507242,Cuomo; Raphael Eduardo,9999,0,9999,0
1713500087966,CSE 191,A00,516875,Minnes Kemp; Mor Mia,9999,0,9999,0
1713500088992,CSS 201S,A01,494383,Staff,35,0,35,0
1713500090017,CSS 202S,A01,494387,Staff,35,0,35,0
1713500091045,EAP 100,A00,516065,Staff,9792,0,9999,207
1713500092076,ECE 45,A01,507414,Staff,37,0,60,23
1713500093100,ECE 100,A01,507416,Baghdadchi; Saharnaz,0,0,20,20
1713500093100,ECE 100,A02,507418,Baghdadchi; Saharnaz,19,0,20,1
1713500094127,ECE 111,A01,507420,Staff,27,0,50,23
1713500095159,ECE 197,001,548057,Sievenpiper; Daniel F.,9998,0,9999,1
1713500096184,EDS 115,A00,507243,Choi; Bailey Miyeon,27,0,28,1
1713500097212,EDS 117,A01,494379,Staff,15,0,25,10
1713500098238,EDS 125,A00,507246,Hopkins; Megan Beth,27,0,30,3
1713500099271,EDS 128A,A01,507264,Fargason; Sharon Gayle,26,0,26,0
1713500100302,EDS 128B,A01,507293,Pappas; Elizabeth,30,0,30,0
1713500101330,EDS 139,A00,507294,Fargason; Sharon Gayle,30,0,30,0
1713500101330,EDS 139,B00,507313,Pappas; Elizabeth,30,0,30,0
1713500102359,EDS 201,A00,507315,Staff,18,0,30,12
1713500103388,EDS 203,A01,507317,Halter; Christopher P.,17,0,30,13
1713500104419,EDS 204R,A01,507319,Halter; Christopher P.,0,1,30,30
1713500104419,EDS 204R,B01,507331,Heinzman; Erica M.,22,0,30,8
1713500105445,EDS 206R,A00,507332,Staff,0,2,30,30
1713500105445,EDS 206R,B00,507343,Staff,23,0,30,7
1713500106470,EDS 250,A00,507344,Hemans; Patricia Ann Benitez,27,0,40,13
1713500107494,EDS 281,A00,507345,Daly; Alan J.,18,0,18,0
1713500108519,EDS 284,A00,507350,Daly; Alan J.,16,0,16,0
1713500109545,EDS 286,A00,507359,Fine; Sarah,18,0,18,0
1713500110571,EDS 289C,A01,507361,Daly; Alan J.,18,0,18,0
1713500111600,EDS 290,A00,507366,Hofstetter; Carolyn,15,0,15,0
1713500112628,LIGM 5A,A00,507421,Fischer-Grunski; Eva K,20,0,20,0
1713500113657,LIGM 5B,A00,507423,Fischer-Grunski; Eva K,20,0,20,0
1713500114684,LIGM 5C,A00,507425,Fischer-Grunski; Eva K,20,0,20,0
1713500115713,LIIT 5AS,A00,507427,Carnelos; Chiara,20,0,20,0
1713500116739,LIIT 5BS,A00,507430,Carnelos; Chiara,20,0,20,0
1713500117765,LIIT 5CS,A00,507432,Carnelos; Chiara,20,0,20,0
1713500118791,LISP 5A,A00,507541,Munoz Sanchez; Alicia,14,0,20,6
1713500119816,LISP 5B,A00,507671,Munoz Sanchez; Alicia,12,0,20,8
1713500120842,LISP 5C,A00,507696,Munoz Sanchez; Alicia,11,0,20,9
1713500121870,MAE 197,001,528363,Boechler; Nicholas Sebastia,9998,0,9999,1
1713500122895,MATH 197,001,523477,Kedlaya; Kiran S.,9999,0,9999,0
1713500122895,MATH 197,002,563811,Zhang; Danna,9998,0,9999,1
1713500123920,MCWP 40R,A00,518780,Staff,14,0,20,6
1713500123920,MCWP 40R,B00,518781,Staff,11,0,20,9
1713500123920,MCWP 40R,C00,518783,Staff,9,0,20,11
1713500124950,MCWP 50R,A00,518791,Staff,7,0,20,13
1713500124950,MCWP 50R,B00,518792,Staff,3,0,20,17
1713500124950,MCWP 50R,C00,518793,Staff,7,0,20,13
1713500124950,MCWP 50R,D00,518794,Staff,0,0,20,20
1713500124950,MCWP 50R,E00,518795,Staff,0,0,20,20
1713500124950,MCWP 50R,F00,518796,Staff,11,0,20,9
1713500124950,MCWP 50R,G00,518797,Staff,10,0,20,10
1713500125975,MMW 12R,A01,514034,Herbst; Matthew,4,0,16,12
1713500125975,MMW 12R,A02,514035,Herbst; Matthew,13,0,16,3
1713500127000,MMW 13R,A01,514037,Staff,0,8,16,16
1713500127000,MMW 13R,A02,514039,Staff,0,6,16,16
1713500129050,SIO 295LS,A00,523233,Staff,15,0,30,15
1713500130076,SIO 295S,A00,523232,Staff,15,0,30,15
1713500131100,SOCI 117,A01,494376,Staff,0,2,5,5
1713500132124,WES 237B,A00,494380,Staff,19,0,20,1
1713500134192,AESE 279B,A00,494370,Wade; Jon P,33,0,33,0
1713500135218,AIP 197,001,627712,Vespa; Emanuel Ignacio,9999,0,9999,0
1713500136244,ANAR 135S,A00,494369,Braswell; Geoffrey E.,0,0,0,0
1713500137274,CAT 124RS,A01,519847,Geibel; William,6,0,20,14
1713500138303,CAT 125RS,A01,515971,Geibel; William,6,0,20,14
1713500139329,CLRE 250,A00,511389,Morris; Sheldon,9996,0,9999,3
1713500140354,CLRE 251,A00,507176,Mehta; Ravindra L.,9996,0,9999,3
1713500140354,CLRE 251,B00,511410,Mehta; Ravindra L.,9998,0,9999,1
1713500141379,CLRE 252,A00,507189,Cuomo; Raphael Eduardo,9998,0,9999,1
1713500142405,CLRE 253,A00,507199,Vaida; Florin,9997,0,9999,2
1713500142405,CLRE 253,B00,507202,Vaida; Florin,9999,0,9999,0
1713500143433,CLRE 259,A00,507211,Patel; Hemal,9996,0,9999,3
1713500144462,CLRE 260,A00,507221,Cuomo; Raphael Eduardo,9999,0,9999,0
1713500145491,CLRE 297,001,507242,Cuomo; Raphael Eduardo,9999,0,9999,0
1713500146518,CSE 191,A00,516875,Minnes Kemp; Mor Mia,9999,0,9999,0
1713500147544,CSS 201S,A01,494383,Staff,35,0,35,0
1713500148569,CSS 202S,A01,494387,Staff,35,0,35,0
1713500149597,EAP 100,A00,516065,Staff,9792,0,9999,207
1713500150625,ECE 45,A01,507414,Staff,37,0,60,23
1713500151656,ECE 100,A01,507416,Baghdadchi; Saharnaz,0,0,20,20
1713500151656,ECE 100,A02,507418,Baghdadchi; Saharnaz,19,0,20,1
1713500152684,ECE 111,A01,507420,Staff,27,0,50,23
1713500153709,ECE 197,001,548057,Sievenpiper; Daniel F.,9998,0,9999,1
1713500154734,EDS 115,A00,507243,Choi; Bailey Miyeon,27,0,28,1
1713500155765,EDS 117,A01,494379,Staff,15,0,25,10
1713500156793,EDS 125,A00,507246,Hopkins; Megan Beth,27,0,30,3
1713500157818,EDS 128A,A01,507264,Fargason; Sharon Gayle,26,0,26,0
1713500158844,EDS 128B,A01,507293,Pappas; Elizabeth,30,0,30,0
1713500159869,EDS 139,A00,507294,Fargason; Sharon Gayle,30,0,30,0
1713500159869,EDS 139,B00,507313,Pappas; Elizabeth,30,0,30,0
1713500160895,EDS 201,A00,507315,Staff,18,0,30,12
1713500161921,EDS 203,A01,507317,Halter; Christopher P.,17,0,30,13
1713500162950,EDS 204R,A01,507319,Halter; Christopher P.,0,1,30,30
1713500162950,EDS 204R,B01,507331,Heinzman; Erica M.,22,0,30,8
1713500164035,EDS 206R,A00,507332,Staff,0,2,30,30
1713500164035,EDS 206R,B00,507343,Staff,23,0,30,7
1713500165066,EDS 250,A00,507344,Hemans; Patricia Ann Benitez,27,0,40,13
1713500166094,EDS 281,A00,507345,Daly; Alan J.,18,0,18,0
1713500167120,EDS 284,A00,507350,Daly; Alan J.,16,0,16,0
1713500168146,EDS 286,A00,507359,Fine; Sarah,18,0,18,0
1713500169170,EDS 289C,A01,507361,Daly; Alan J.,18,0,18,0
1713500170198,EDS 290,A00,507366,Hofstetter; Carolyn,15,0,15,0
1713500171228,LIGM 5A,A00,507421,Fischer-Grunski; Eva K,20,0,20,0
1713500172253,LIGM 5B,A00,507423,Fischer-Grunski; Eva K,20,0,20,0
1713500173278,LIGM 5C,A00,507425,Fischer-Grunski; Eva K,20,0,20,0
1713500174305,LIIT 5AS,A00,507427,Carnelos; Chiara,20,0,20,0
1713500175335,LIIT 5BS,A00,507430,Carnelos; Chiara,20,0,20,0
1713500176360,LIIT 5CS,A00,507432,Carnelos; Chiara,20,0,20,0
1713500177390,LISP 5A,A00,507541,Munoz Sanchez; Alicia,14,0,20,6
1713500178416,LISP 5B,A00,507671,Munoz Sanchez; Alicia,12,0,20,8
1713500179441,LISP 5C,A00,507696,Munoz Sanchez; Alicia,11,0,20,9
1713500180468,MAE 197,001,528363,Boechler; Nicholas Sebastia,9998,0,9999,1
1713500181493,MATH 197,001,523477,Kedlaya; Kiran S.,9999,0,9999,0
1713500181493,MATH 197,002,563811,Zhang; Danna,9998,0,9999,1
1713500182518,MCWP 40R,A00,518780,Staff,14,0,20,6
1713500182518,MCWP 40R,B00,518781,Staff,11,0,20,9
1713500182518,MCWP 40R,C00,518783,Staff,9,0,20,11
1713500183549,MCWP 50R,A00,518791,Staff,7,0,20,13
1713500183549,MCWP 50R,B00,518792,Staff,3,0,20,17
1713500183549,MCWP 50R,C00,518793,Staff,7,0,20,13
1713500183549,MCWP 50R,D00,518794,Staff,0,0,20,20
1713500183549,MCWP 50R,E00,518795,Staff,0,0,20,20
1713500183549,MCWP 50R,F00,518796,Staff,11,0,20,9
1713500183549,MCWP 50R,G00,518797,Staff,10,0,20,10
1713500184574,MMW 12R,A01,514034,Herbst; Matthew,4,0,16,12
1713500184574,MMW 12R,A02,514035,Herbst; Matthew,13,0,16,3
1713500185598,MMW 13R,A01,514037,Staff,0,8,16,16
1713500185598,MMW 13R,A02,514039,Staff,0,6,16,16
1713500187654,SIO 295LS,A00,523233,Staff,15,0,30,15
1713500188678,SIO 295S,A00,523232,Staff,15,0,30,15
1713500189704,SOCI 117,A01,494376,Staff,0,2,5,5
1713500190729,WES 237B,A00,494380,Staff,19,0,20,1
1713500192801,AESE 279B,A00,494370,Wade; Jon P,33,0,33,0
1713500193829,AIP 197,001,627712,Vespa; Emanuel Ignacio,9999,0,9999,0
1713500194855,ANAR 135S,A00,494369,Braswell; Geoffrey E.,0,0,0,0
1713500195880,CAT 124RS,A01,519847,Geibel; William,6,0,20,14
1713500196909,CAT 125RS,A01,515971,Geibel; William,6,0,20,14
1713500197934,CLRE 250,A00,511389,Morris; Sheldon,9996,0,9999,3
1713500198969,CLRE 251,A00,507176,Mehta; Ravindra L.,9996,0,9999,3
1713500198969,CLRE 251,B00,511410,Mehta; Ravindra L.,9998,0,9999,1
1713500199999,CLRE 252,A00,507189,Cuomo; Raphael Eduardo,9998,0,9999,1
1713500201025,CLRE 253,A00,507199,Vaida; Florin,9997,0,9999,2
1713500201025,CLRE 253,B00,507202,Vaida; Florin,9999,0,9999,0
1713500202051,CLRE 259,A00,507211,Patel; Hemal,9996,0,9999,3
1713500203076,CLRE 260,A00,507221,Cuomo; Raphael Eduardo,9999,0,9999,0
1713500204103,CLRE 297,001,507242,Cuomo; Raphael Eduardo,9999,0,9999,0
1713500205132,CSE 191,A00,516875,Minnes Kemp; Mor Mia,9999,0,9999,0
1713500206157,CSS 201S,A01,494383,Staff,35,0,35,0
1713500207182,CSS 202S,A01,494387,Staff,35,0,35,0
1713500208206,EAP 100,A00,516065,Staff,9792,0,9999,207
1713500209235,ECE 45,A01,507414,Staff,37,0,60,23
1713500210260,ECE 100,A01,507416,Baghdadchi; Saharnaz,0,0,20,20
1713500210260,ECE 100,A02,507418,Baghdadchi; Saharnaz,19,0,20,1
1713500211290,ECE 111,A01,507420,Staff,27,0,50,23
1713500212320,ECE 197,001,548057,Sievenpiper; Daniel F.,9998,0,9999,1
1713500213346,EDS 115,A00,507243,Choi; Bailey Miyeon,27,0,28,1
1713500214371,EDS 117,A01,494379,Staff,15,0,25,10
1713500215396,EDS 125,A00,507246,Hopkins; Megan Beth,27,0,30,3
1713500216422,EDS 128A,A01,507264,Fargason; Sharon Gayle,26,0,26,0
1713500217450,EDS 128B,A01,507293,Pappas; Elizabeth,30,0,30,0
1713500218475,EDS 139,A00,507294,Fargason; Sharon Gayle,30,0,30,0
1713500218475,EDS 139,B00,507313,Pappas; Elizabeth,30,0,30,0
1713500219503,EDS 201,A00,507315,Staff,18,0,30,12
1713500220530,EDS 203,A01,507317,Halter; Christopher P.,17,0,30,13
1713500221554,EDS 204R,A01,507319,Halter; Christopher P.,0,1,30,30
1713500221554,EDS 204R,B01,507331,Heinzman; Erica M.,22,0,30,8
1713500222583,EDS 206R,A00,507332,Staff,0,2,30,30
1713500222583,EDS 206R,B00,507343,Staff,23,0,30,7
1713500223610,EDS 250,A00,507344,Hemans; Patricia Ann Benitez,27,0,40,13
1713500224634,EDS 281,A00,507345,Daly; Alan J.,18,0,18,0
1713500225660,EDS 284,A00,507350,Daly; Alan J.,16,0,16,0
1713500226686,EDS 286,A00,507359,Fine; Sarah,18,0,18,0
1713500227711,EDS 289C,A01,507361,Daly; Alan J.,18,0,18,0
1713500228737,EDS 290,A00,507366,Hofstetter; Carolyn,15,0,15,0
1713500229764,LIGM 5A,A00,507421,Fischer-Grunski; Eva K,20,0,20,0
1713500230792,LIGM 5B,A00,507423,Fischer-Grunski; Eva K,20,0,20,0
1713500231823,LIGM 5C,A00,507425,Fischer-Grunski; Eva K,20,0,20,0
1713500232852,LIIT 5AS,A00,507427,Carnelos; Chiara,20,0,20,0
1713500233894,LIIT 5BS,A00,507430,Carnelos; Chiara,20,0,20,0
1713500234924,LIIT 5CS,A00,507432,Carnelos; Chiara,20,0,20,0
1713500235950,LISP 5A,A00,507541,Munoz Sanchez; Alicia,14,0,20,6
1713500236980,LISP 5B,A00,507671,Munoz Sanchez; Alicia,12,0,20,8
1713500238006,LISP 5C,A00,507696,Munoz Sanchez; Alicia,11,0,20,9
1713500239032,MAE 197,001,528363,Boechler; Nicholas Sebastia,9998,0,9999,1
1713500240059,MATH 197,001,523477,Kedlaya; Kiran S.,9999,0,9999,0
1713500240059,MATH 197,002,563811,Zhang; Danna,9998,0,9999,1
1713500241086,MCWP 40R,A00,518780,Staff,14,0,20,6
1713500241086,MCWP 40R,B00,518781,Staff,11,0,20,9
1713500241086,MCWP 40R,C00,518783,Staff,9,0,20,11
1713500242114,MCWP 50R,A00,518791,Staff,7,0,20,13
1713500242114,MCWP 50R,B00,518792,Staff,3,0,20,17
1713500242114,MCWP 50R,C00,518793,Staff,7,0,20,13
1713500242114,MCWP 50R,D00,518794,Staff,0,0,20,20
1713500242114,MCWP 50R,E00,518795,Staff,0,0,20,20
1713500242114,MCWP 50R,F00,518796,Staff,11,0,20,9
1713500242114,MCWP 50R,G00,518797,Staff,10,0,20,10
1713500243139,MMW 12R,A01,514034,Herbst; Matthew,4,0,16,12
1713500243139,MMW 12R,A02,514035,Herbst; Matthew,13,0,16,3
1713500244164,MMW 13R,A01,514037,Staff,0,8,16,16
1713500244164,MMW 13R,A02,514039,Staff,0,6,16,16
1713500246218,SIO 295LS,A00,523233,Staff,15,0,30,15
1713500247243,SIO 295S,A00,523232,Staff,15,0,30,15
1713500248271,SOCI 117,A01,494376,Staff,0,2,5,5
1713500249297,WES 237B,A00,494380,Staff,19,0,20,1
1713500251355,AESE 279B,A00,494370,Wade; Jon P,33,0,33,0
1713500252380,AIP 197,001,627712,Vespa; Emanuel Ignacio,9999,0,9999,0
1713500253407,ANAR 135S,A00,494369,Braswell; Geoffrey E.,0,0,0,0
1713500254435,CAT 124RS,A01,519847,Geibel; William,6,0,20,14
1713500255463,CAT 125RS,A01,515971,Geibel; William,6,0,20,14
1713500256487,CLRE 250,A00,511389,Morris; Sheldon,9996,0,9999,3
1713500257511,CLRE 251,A00,507176,Mehta; Ravindra L.,9996,0,9999,3
1713500257511,CLRE 251,B00,511410,Mehta; Ravindra L.,9998,0,9999,1
1713500258539,CLRE 252,A00,507189,Cuomo; Raphael Eduardo,9998,0,9999,1
1713500259564,CLRE 253,A00,507199,Vaida; Florin,9997,0,9999,2
1713500259564,CLRE 253,B00,507202,Vaida; Florin,9999,0,9999,0
1713500260590,CLRE 259,A00,507211,Patel; Hemal,9996,0,9999,3
1713500261615,CLRE 260,A00,507221,Cuomo; Raphael Eduardo,9999,0,9999,0
1713500262641,CLRE 297,001,507242,Cuomo; Raphael Eduardo,9999,0,9999,0
1713500263669,CSE 191,A00,516875,Minnes Kemp; Mor Mia,9999,0,9999,0
1713500264699,CSS 201S,A01,494383,Staff,35,0,35,0
1713500265729,CSS 202S,A01,494387,Staff,35,0,35,0
1713500266757,EAP 100,A00,516065,Staff,9792,0,9999,207
1713500267856,ECE 45,A01,507414,Staff,37,0,60,23
1713500268882,ECE 100,A01,507416,Baghdadchi; Saharnaz,0,0,20,20
1713500268882,ECE 100,A02,507418,Baghdadchi; Saharnaz,19,0,20,1
1713500269907,ECE 111,A01,507420,Staff,27,0,50,23
1713500270931,ECE 197,001,548057,Sievenpiper; Daniel F.,9998,0,9999,1
1713500271956,EDS 115,A00,507243,Choi; Bailey Miyeon,27,0,28,1
1713500272980,EDS 117,A01,494379,Staff,15,0,25,10
1713500274006,EDS 125,A00,507246,Hopkins; Megan Beth,27,0,30,3
1713500275035,EDS 128A,A01,507264,Fargason; Sharon Gayle,26,0,26,0
1713500276063,EDS 128B,A01,507293,Pappas; Elizabeth,30,0,30,0
1713500277092,EDS 139,A00,507294,Fargason; Sharon Gayle,30,0,30,0
1713500277092,EDS 139,B00,507313,Pappas; Elizabeth,30,0,30,0
1713500278116,EDS 201,A00,507315,Staff,18,0,30,12
1713500279142,EDS 203,A01,507317,Halter; Christopher P.,17,0,30,13
1713500280168,EDS 204R,A01,507319,Halter; Christopher P.,0,1,30,30
1713500280168,EDS 204R,B01,507331,Heinzman; Erica M.,22,0,30,8
1713500281196,EDS 206R,A00,507332,Staff,0,2,30,30
1713500281196,EDS 206R,B00,507343,Staff,23,0,30,7
1713500282220,EDS 250,A00,507344,Hemans; Patricia Ann Benitez,27,0,40,13
1713500283246,EDS 281,A00,507345,Daly; Alan J.,18,0,18,0
1713500284275,EDS 284,A00,507350,Daly; Alan J.,16,0,16,0
1713500285304,EDS 286,A00,507359,Fine; Sarah,18,0,18,0
1713500286331,EDS 289C,A01,507361,Daly; Alan J.,18,0,18,0
1713500287357,EDS 290,A00,507366,Hofstetter; Carolyn,15,0,15,0
1713500288387,LIGM 5A,A00,507421,Fischer-Grunski; Eva K,20,0,20,0
1713500289411,LIGM 5B,A00,507423,Fischer-Grunski; Eva K,20,0,20,0
1713500290437,LIGM 5C,A00,507425,Fischer-Grunski; Eva K,20,0,20,0
1713500291464,LIIT 5AS,A00,507427,Carnelos; Chiara,20,0,20,0
1713500292490,LIIT 5BS,A00,507430,Carnelos; Chiara,20,0,20,0
1713500293520,LIIT 5CS,A00,507432,Carnelos; Chiara,20,0,20,0
1713500294548,LISP 5A,A00,507541,Munoz Sanchez; Alicia,14,0,20,6
1713500295578,LISP 5B,A00,507671,Munoz Sanchez; Alicia,12,0,20,8
1713500296606,LISP 5C,A00,507696,Munoz Sanchez; Alicia,11,0,20,9
1713500297631,MAE 197,001,528363,Boechler; Nicholas Sebastia,9998,0,9999,1
1713500298655,MATH 197,001,523477,Kedlaya; Kiran S.,9999,0,9999,0
1713500298655,MATH 197,002,563811,Zhang; Danna,9998,0,9999,1
1713500299679,MCWP 40R,A00,518780,Staff,14,0,20,6
1713500299679,MCWP 40R,B00,518781,Staff,11,0,20,9
1713500299679,MCWP 40R,C00,518783,Staff,9,0,20,11
1713500300709,MCWP 50R,A00,518791,Staff,7,0,20,13
1713500300709,MCWP 50R,B00,518792,Staff,3,0,20,17
1713500300709,MCWP 50R,C00,518793,Staff,7,0,20,13
1713500300709,MCWP 50R,D00,518794,Staff,0,0,20,20
1713500300709,MCWP 50R,E00,518795,Staff,0,0,20,20
1713500300709,MCWP 50R,F00,518796,Staff,11,0,20,9
1713500300709,MCWP 50R,G00,518797,Staff,10,0,20,10
1713500301737,MMW 12R,A01,514034,Herbst; Matthew,4,0,16,12
1713500301737,MMW 12R,A02,514035,Herbst; Matthew,13,0,16,3
1713500302767,MMW 13R,A01,514037,Staff,0,8,16,16
1713500302767,MMW 13R,A02,514039,Staff,0,6,16,16
1713500304824,SIO 295LS,A00,523233,Staff,15,0,30,15
1713500305850,SIO 295S,A00,523232,Staff,15,0,30,15
1713500306876,SOCI 117,A01,494376,Staff,0,2,5,5
1713500307906,WES 237B,A00,494380,Staff,19,0,20,1
1713500309975,AESE 279B,A00,494370,Wade; Jon P,33,0,33,0
1713500310999,AIP 197,001,627712,Vespa; Emanuel Ignacio,9999,0,9999,0
1713500312024,ANAR 135S,A00,494369,Braswell; Geoffrey E.,0,0,0,0
1713500313050,CAT 124RS,A01,519847,Geibel; William,6,0,20,14
1713500314074,CAT 125RS,A01,515971,Geibel; William,6,0,20,14
1713500315102,CLRE 250,A00,511389,Morris; Sheldon,9996,0,9999,3
1713500316127,CLRE 251,A00,507176,Mehta; Ravindra L.,9996,0,9999,3
1713500316127,CLRE 251,B00,511410,Mehta; Ravindra L.,9998,0,9999,1
1713500317155,CLRE 252,A00,507189,Cuomo; Raphael Eduardo,9998,0,9999,1
1713500318184,CLRE 253,A00,507199,Vaida; Florin,9997,0,9999,2
1713500318184,CLRE 253,B00,507202,Vaida; Florin,9999,0,9999,0
1713500319213,CLRE 259,A00,507211,Patel; Hemal,9996,0,9999,3
1713500320238,CLRE 260,A00,507221,Cuomo; Raphael Eduardo,9999,0,9999,0
1713500321265,CLRE 297,001,507242,Cuomo; Raphael Eduardo,9999,0,9999,0
1713500322289,CSE 191,A00,516875,Minnes Kemp; Mor Mia,9999,0,9999,0
1713500323315,CSS 201S,A01,494383,Staff,35,0,35,0
1713500324345,CSS 202S,A01,494387,Staff,35,0,35,0
1713500325370,EAP 100,A00,516065,Staff,9792,0,9999,207
1713500326401,ECE 45,A01,507414,Staff,37,0,60,23
1713500327429,ECE 100,A01,507416,Baghdadchi; Saharnaz,0,0,20,20
1713500327429,ECE 100,A02,507418,Baghdadchi; Saharnaz,19,0,20,1
1713500328455,ECE 111,A01,507420,Staff,27,0,50,23
1713500329483,ECE 197,001,548057,Sievenpiper; Daniel F.,9998,0,9999,1
1713500330508,EDS 115,A00,507243,Choi; Bailey Miyeon,27,0,28,1
1713500331540,EDS 117,A01,494379,Staff,15,0,25,10
1713500332565,EDS 125,A00,507246,Hopkins; Megan Beth,27,0,30,3
1713500333591,EDS 128A,A01,507264,Fargason; Sharon Gayle,26,0,26,0
1713500334617,EDS 128B,A01,507293,Pappas; Elizabeth,30,0,30,0
1713500335643,EDS 139,A00,507294,Fargason; Sharon Gayle,30,0,30,0
1713500335643,EDS 139,B00,507313,Pappas; Elizabeth,30,0,30,0
1713500336667,EDS 201,A00,507315,Staff,18,0,30,12
1713500337690,EDS 203,A01,507317,Halter; Christopher P.,17,0,30,13
1713500338720,EDS 204R,A01,507319,Halter; Christopher P.,0,1,30,30
1713500338720,EDS 204R,B01,507331,Heinzman; Erica M.,22,0,30,8
1713500339750,EDS 206R,A00,507332,Staff,0,2,30,30
1713500339750,EDS 206R,B00,507343,Staff,23,0,30,7
1713500340780,EDS 250,A00,507344,Hemans; Patricia Ann Benitez,27,0,40,13
1713500341806,EDS 281,A00,507345,Daly; Alan J.,18,0,18,0
1713500342833,EDS 284,A00,507350,Daly; Alan J.,16,0,16,0
1713500343872,EDS 286,A00,507359,Fine; Sarah,18,0,18,0
1713500344900,EDS 289C,A01,507361,Daly; Alan J.,18,0,18,0
1713500345924,EDS 290,A00,507366,Hofstetter; Carolyn,15,0,15,0
1713500346952,LIGM 5A,A00,507421,Fischer-Grunski; Eva K,20,0,20,0
1713500347983,LIGM 5B,A00,507423,Fischer-Grunski; Eva K,20,0,20,0
1713500349009,LIGM 5C,A00,507425,Fischer-Grunski; Eva K,20,0,20,0
1713500350038,LIIT 5AS,A00,507427,Carnelos; Chiara,20,0,20,0
1713500351063,LIIT 5BS,A00,507430,Carnelos; Chiara,20,0,20,0
1713500352088,LIIT 5CS,A00,507432,Carnelos; Chiara,20,0,20,0
1713500353116,LISP 5A,A00,507541,Munoz Sanchez; Alicia,14,0,20,6
1713500354142,LISP 5B,A00,507671,Munoz Sanchez; Alicia,12,0,20,8
1713500355169,LISP 5C,A00,507696,Munoz Sanchez; Alicia,11,0,20,9
1713500356198,MAE 197,001,528363,Boechler; Nicholas Sebastia,9998,0,9999,1
1713500357224,MATH 197,001,523477,Kedlaya; Kiran S.,9999,0,9999,0
1713500357224,MATH 197,002,563811,Zhang; Danna,9998,0,9999,1
1713500358247,MCWP 40R,A00,518780,Staff,14,0,20,6
1713500358247,MCWP 40R,B00,518781,Staff,11,0,20,9
1713500358247,MCWP 40R,C00,518783,Staff,9,0,20,11
1713500359275,MCWP 50R,A00,518791,Staff,7,0,20,13
1713500359275,MCWP 50R,B00,518792,Staff,3,0,20,17
1713500359275,MCWP 50R,C00,518793,Staff,7,0,20,13
1713500359275,MCWP 50R,D00,518794,Staff,0,0,20,20
1713500359275,MCWP 50R,E00,518795,Staff,0,0,20,20
1713500359275,MCWP 50R,F00,518796,Staff,11,0,20,9
1713500359275,MCWP 50R,G00,518797,Staff,10,0,20,10
1713500360300,MMW 12R,A01,514034,Herbst; Matthew,4,0,16,12
1713500360300,MMW 12R,A02,514035,Herbst; Matthew,13,0,16,3
1713500361328,MMW 13R,A01,514037,Staff,0,8,16,16
1713500361328,MMW 13R,A02,514039,Staff,0,6,16,16
1713500363382,SIO 295LS,A00,523233,Staff,15,0,30,15
1713500364406,SIO 295S,A00,523232,Staff,15,0,30,15
1713500365433,SOCI 117,A01,494376,Staff,0,2,5,5
1713500366462,WES 237B,A00,494380,Staff,19,0,20,1
1713500368521,AESE 279B,A00,494370,Wade; Jon P,33,0,33,0
1713500369546,AIP 197,001,627712,Vespa; Emanuel Ignacio,9999,0,9999,0
1713500370573,ANAR 135S,A00,494369,Braswell; Geoffrey E.,0,0,0,0
1713500371655,CAT 124RS,A01,519847,Geibel; William,6,0,20,14
1713500372681,CAT 125RS,A01,515971,Geibel; William,6,0,20,14
1713500373710,CLRE 250,A00,511389,Morris; Sheldon,9996,0,9999,3
1713500374734,CLRE 251,A00,507176,Mehta; Ravindra L.,9996,0,9999,3
1713500374734,CLRE 251,B00,511410,Mehta; Ravindra L.,9998,0,9999,1
1713500375759,CLRE 252,A00,507189,Cuomo; Raphael Eduardo,9998,0,9999,1
1713500376782,CLRE 253,A00,507199,Vaida; Florin,9997,0,9999,2
1713500376782,CLRE 253,B00,507202,Vaida; Florin,9999,0,9999,0
1713500377806,CLRE 259,A00,507211,Patel; Hemal,9996,0,9999,3
1713500378832,CLRE 260,A00,507221,Cuomo; Raphael Eduardo,9999,0,9999,0
1713500379860,CLRE 297,001,507242,Cuomo; Raphael Eduardo,9999,0,9999,0
1713500380887,CSE 191,A00,516875,Minnes Kemp; Mor Mia,9999,0,9999,0
1713500381916,CSS 201S,A01,494383,Staff,35,0,35,0
1713500382940,CSS 202S,A01,494387,Staff,35,0,35,0
1713500383965,EAP 100,A00,516065,Staff,9792,0,9999,207
1713500384994,ECE 45,A01,507414,Staff,37,0,60,23
1713500386024,ECE 100,A01,507416,Baghdadchi; Saharnaz,0,0,20,20
1713500386024,ECE 100,A02,507418,Baghdadchi; Saharnaz,19,0,20,1
1713500387049,ECE 111,A01,507420,Staff,27,0,50,23
1713500388073,ECE 197,001,548057,Sievenpiper; Daniel F.,9998,0,9999,1
1713500389098,EDS 115,A00,507243,Choi; Bailey Miyeon,27,0,28,1
1713500390138,EDS 117,A01,494379,Staff,15,0,25,10
1713500391164,EDS 125,A00,507246,Hopkins; Megan Beth,27,0,30,3
1713500392193,EDS 128A,A01,507264,Fargason; Sharon Gayle,26,0,26,0
1713500393221,EDS 128B,A01,507293,Pappas; Elizabeth,30,0,30,0
1713500394247,EDS 139,A00,507294,Fargason; Sharon Gayle,30,0,30,0
1713500394247,EDS 139,B00,507313,Pappas; Elizabeth,30,0,30,0
1713500395272,EDS 201,A00,507315,Staff,18,0,30,12
1713500396298,EDS 203,A01,507317,Halter; Christopher P.,17,0,30,13
1713500397326,EDS 204R,A01,507319,Halter; Christopher P.,0,1,30,30
1713500397326,EDS 204R,B01,507331,Heinzman; Erica M.,22,0,30,8
1713500398352,EDS 206R,A00,507332,Staff,0,2,30,30
1713500398352,EDS 206R,B00,507343,Staff,23,0,30,7
1713500399381,EDS 250,A00,507344,Hemans; Patricia Ann Benitez,27,0,40,13
1713500400404,EDS 281,A00,507345,Daly; Alan J.,18,0,18,0
1713500401429,EDS 284,A00,507350,Daly; Alan J.,16,0,16,0
1713500402455,EDS 286,A00,507359,Fine; Sarah,18,0,18,0
1713500403485,EDS 289C,A01,507361,Daly; Alan J.,18,0,18,0
1713500404511,EDS 290,A00,507366,Hofstetter; Carolyn,15,0,15,0
1713500405539,LIGM 5A,A00,507421,Fischer-Grunski; Eva K,20,0,20,0
1713500406566,LIGM 5B,A00,507423,Fischer-Grunski; Eva K,20,0,20,0
1713500407591,LIGM 5C,A00,507425,Fischer-Grunski; Eva K,20,0,20,0
1713500408616,LIIT 5AS,A00,507427,Carnelos; Chiara,20,0,20,0
1713500409642,LIIT 5BS,A00,507430,Carnelos; Chiara,20,0,20,0
1713500410668,LIIT 5CS,A00,507432,Carnelos; Chiara,20,0,20,0
1713500411694,LISP 5A,A00,507541,Munoz Sanchez; Alicia,14,0,20,6
1713500412724,LISP 5B,A00,507671,Munoz Sanchez; Alicia,12,0,20,8
1713500413749,LISP 5C,A00,507696,Munoz Sanchez; Alicia,11,0,20,9
1713500414774,MAE 197,001,528363,Boechler; Nicholas Sebastia,9998,0,9999,1
1713500415799,MATH 197,001,523477,Kedlaya; Kiran S.,9999,0,9999,0
1713500415799,MATH 197,002,563811,Zhang; Danna,9998,0,9999,1
1713500416828,MCWP 40R,A00,518780,Staff,14,0,20,6
1713500416828,MCWP 40R,B00,518781,Staff,11,0,20,9
1713500416828,MCWP 40R,C00,518783,Staff,9,0,20,11
1713500417852,MCWP 50R,A00,518791,Staff,7,0,20,13
1713500417852,MCWP 50R,B00,518792,Staff,3,0,20,17
1713500417852,MCWP 50R,C00,518793,Staff,7,0,20,13
1713500417852,MCWP 50R,D00,518794,Staff,0,0,20,20
1713500417852,MCWP 50R,E00,518795,Staff,0,0,20,20
1713500417852,MCWP 50R,F00,518796,Staff,11,0,20,9
1713500417852,MCWP 50R,G00,518797,Staff,10,0,20,10
1713500418879,MMW 12R,A01,514034,Herbst; Matthew,4,0,16,12
1713500418879,MMW 12R,A02,514035,Herbst; Matthew,13,0,16,3
1713500419908,MMW 13R,A01,514037,Staff,0,8,16,16
1713500419908,MMW 13R,A02,514039,Staff,0,6,16,16
1713500421957,SIO 295LS,A00,523233,Staff,15,0,30,15
1713500422986,SIO 295S,A00,523232,Staff,15,0,30,15
1713500424010,SOCI 117,A01,494376,Staff,0,2,5,5
1713500425036,WES 237B,A00,494380,Staff,19,0,20,1
1713500427098,AESE 279B,A00,494370,Wade; Jon P,33,0,33,0
1713500428132,AIP 197,001,627712,Vespa; Emanuel Ignacio,9999,0,9999,0
1713500429160,ANAR 135S,A00,494369,Braswell; Geoffrey E.,0,0,0,0
1713500430186,CAT 124RS,A01,519847,Geibel; William,6,0,20,14
1713500431214,CAT 125RS,A01,515971,Geibel; William,6,0,20,14
1713500432239,CLRE 250,A00,511389,Morris; Sheldon,9996,0,9999,3
1713500433267,CLRE 251,A00,507176,Mehta; Ravindra L.,9996,0,9999,3
1713500433267,CLRE 251,B00,511410,Mehta; Ravindra L.,9998,0,9999,1
1713500434298,CLRE 252,A00,507189,Cuomo; Raphael Eduardo,9998,0,9999,1
1713500435328,CLRE 253,A00,507199,Vaida; Florin,9997,0,9999,2
1713500435328,CLRE 253,B00,507202,Vaida; Florin,9999,0,9999,0
1713500436356,CLRE 259,A00,507211,Patel; Hemal,9996,0,9999,3
1713500437379,CLRE 260,A00,507221,Cuomo; Raphael Eduardo,9999,0,9999,0
1713500438408,CLRE 297,001,507242,Cuomo; Raphael Eduardo,9999,0,9999,0
1713500439432,CSE 191,A00,516875,Minnes Kemp; Mor Mia,9999,0,9999,0
1713500440457,CSS 201S,A01,494383,Staff,35,0,35,0
1713500441672,CSS 202S,A01,494387,Staff,35,0,35,0
1713500442695,EAP 100,A00,516065,Staff,9792,0,9999,207
1713500443719,ECE 45,A01,507414,Staff,37,0,60,23
1713500444747,ECE 100,A01,507416,Baghdadchi; Saharnaz,0,0,20,20
1713500444747,ECE 100,A02,507418,Baghdadchi; Saharnaz,19,0,20,1
1713500445772,ECE 111,A01,507420,Staff,27,0,50,23
1713500446798,ECE 197,001,548057,Sievenpiper; Daniel F.,9998,0,9999,1
1713500447824,EDS 115,A00,507243,Choi; Bailey Miyeon,27,0,28,1
1713500448852,EDS 117,A01,494379,Staff,15,0,25,10
1713500449880,EDS 125,A00,507246,Hopkins; Megan Beth,27,0,30,3
1713500450905,EDS 128A,A01,507264,Fargason; Sharon Gayle,26,0,26,0
1713500451930,EDS 128B,A01,507293,Pappas; Elizabeth,30,0,30,0
1713500452956,EDS 139,A00,507294,Fargason; Sharon Gayle,30,0,30,0
1713500452956,EDS 139,B00,507313,Pappas; Elizabeth,30,0,30,0
1713500453982,EDS 201,A00,507315,Staff,18,0,30,12
1713500455008,EDS 203,A01,507317,Halter; Christopher P.,17,0,30,13
1713500456035,EDS 204R,A01,507319,Halter; Christopher P.,0,1,30,30
1713500456035,EDS 204R,B01,507331,Heinzman; Erica M.,22,0,30,8
1713500457064,EDS 206R,A00,507332,Staff,0,2,30,30
1713500457064,EDS 206R,B00,507343,Staff,23,0,30,7
1713500458092,EDS 250,A00,507344,Hemans; Patricia Ann Benitez,27,0,40,13
1713500459120,EDS 281,A00,507345,Daly; Alan J.,18,0,18,0
1713500460146,EDS 284,A00,507350,Daly; Alan J.,16,0,16,0
1713500461172,EDS 286,A00,507359,Fine; Sarah,18,0,18,0
1713500462200,EDS 289C,A01,507361,Daly; Alan J.,18,0,18,0
1713500463226,EDS 290,A00,507366,Hofstetter; Carolyn,15,0,15,0
1713500464254,LIGM 5A,A00,507421,Fischer-Grunski; Eva K,20,0,20,0
1713500465283,LIGM 5B,A00,507423,Fischer-Grunski; Eva K,20,0,20,0
1713500466313,LIGM 5C,A00,507425,Fischer-Grunski; Eva K,20,0,20,0
1713500467342,LIIT 5AS,A00,507427,Carnelos; Chiara,20,0,20,0
1713500468368,LIIT 5BS,A00,507430,Carnelos; Chiara,20,0,20,0
1713500469397,LIIT 5CS,A00,507432,Carnelos; Chiara,20,0,20,0
1713500470426,LISP 5A,A00,507541,Munoz Sanchez; Alicia,14,0,20,6
1713500471454,LISP 5B,A00,507671,Munoz Sanchez; Alicia,12,0,20,8
1713500472480,LISP 5C,A00,507696,Munoz Sanchez; Alicia,11,0,20,9
1713500473503,MAE 197,001,528363,Boechler; Nicholas Sebastia,9998,0,9999,1
1713500474530,MATH 197,001,523477,Kedlaya; Kiran S.,9999,0,9999,0
1713500474530,MATH 197,002,563811,Zhang; Danna,9998,0,9999,1
1713500475614,MCWP 40R,A00,518780,Staff,14,0,20,6
1713500475614,MCWP 40R,B00,518781,Staff,11,0,20,9
1713500475614,MCWP 40R,C00,518783,Staff,9,0,20,11
1713500476644,MCWP 50R,A00,518791,Staff,7,0,20,13
1713500476644,MCWP 50R,B00,518792,Staff,3,0,20,17
1713500476644,MCWP 50R,C00,518793,Staff,7,0,20,13
1713500476644,MCWP 50R,D00,518794,Staff,0,0,20,20
1713500476644,MCWP 50R,E00,518795,Staff,0,0,20,20
1713500476644,MCWP 50R,F00,518796,Staff,11,0,20,9
1713500476644,MCWP 50R,G00,518797,Staff,10,0,20,10
1713500477670,MMW 12R,A01,514034,Herbst; Matthew,4,0,16,12
1713500477670,MMW 12R,A02,514035,Herbst; Matthew,13,0,16,3
1713500478699,MMW 13R,A01,514037,Staff,0,8,16,16
1713500478699,MMW 13R,A02,514039,Staff,0,6,16,16
1713500480749,SIO 295LS,A00,523233,Staff,15,0,30,15
1713500481775,SIO 295S,A00,523232,Staff,15,0,30,15
1713500482801,SOCI 117,A01,494376,Staff,0,2,5,5
1713500483827,WES 237B,A00,494380,Staff,19,0,20,1
1713500485885,AESE 279B,A00,494370,Wade; Jon P,33,0,33,0
1713500486909,AIP 197,001,627712,Vespa; Emanuel Ignacio,9999,0,9999,0
1713500487935,ANAR 135S,A00,494369,Braswell; Geoffrey E.,0,0,0,0
1713500488963,CAT 124RS,A01,519847,Geibel; William,6,0,20,14
1713500489988,CAT 125RS,A01,515971,Geibel; William,6,0,20,14
1713500491016,CLRE 250,A00,511389,Morris; Sheldon,9996,0,9999,3
1713500492043,CLRE 251,A00,507176,Mehta; Ravindra L.,9996,0,9999,3
1713500492043,CLRE 251,B00,511410,Mehta; Ravindra L.,9998,0,9999,1
1713500493074,CLRE 252,A00,507189,Cuomo; Raphael Eduardo,9998,0,9999,1
1713500494101,CLRE 253,A00,507199,Vaida; Florin,9997,0,9999,2
1713500494101,CLRE 253,B00,507202,Vaida; Florin,9999,0,9999,0
1713500495129,CLRE 259,A00,507211,Patel; Hemal,9996,0,9999,3
1713500496153,CLRE 260,A00,507221,Cuomo; Raphael Eduardo,9999,0,9999,0
1713500497179,CLRE 297,001,507242,Cuomo; Raphael Eduardo,9999,0,9999,0
1713500498204,CSE 191,A00,516875,Minnes Kemp; Mor Mia,9999,0,9999,0
1713500499228,CSS 201S,A01,494383,Staff,35,0,35,0
1713500500256,CSS 202S,A01,494387,Staff,35,0,35,0
1713500501283,EAP 100,A00,516065,Staff,9792,0,9999,207
1713500502309,ECE 45,A01,507414,Staff,37,0,60,23
1713500503336,ECE 100,A01,507416,Baghdadchi; Saharnaz,0,0,20,20
1713500503336,ECE 100,A02,507418,Baghdadchi; Saharnaz,19,0,20,1
1713500504363,ECE 111,A01,507420,Staff,27,0,50,23
1713500505387,ECE 197,001,548057,Sievenpiper; Daniel F.,9998,0,9999,1
1713500506414,EDS 115,A00,507243,Choi; Bailey Miyeon,27,0,28,1
1713500507440,EDS 117,A01,494379,Staff,15,0,25,10
1713500508465,EDS 125,A00,507246,Hopkins; Megan Beth,27,0,30,3
1713500509494,EDS 128A,A01,507264,Fargason; Sharon Gayle,26,0,26,0
1713500510519,EDS 128B,A01,507293,Pappas; Elizabeth,30,0,30,0
1713500511546,EDS 139,A00,507294,Fargason; Sharon Gayle,30,0,30,0
1713500511546,EDS 139,B00,507313,Pappas; Elizabeth,30,0,30,0
1713500512571,EDS 201,A00,507315,Staff,18,0,30,12
1713500513598,EDS 203,A01,507317,Halter; Christopher P.,17,0,30,13
1713500514627,EDS 204R,A01,507319,Halter; Christopher P.,0,1,30,30
1713500514627,EDS 204R,B01,507331,Heinzman; Erica M.,22,0,30,8
1713500515653,EDS 206R,A00,507332,Staff,0,2,30,30
1713500515653,EDS 206R,B00,507343,Staff,23,0,30,7
1713500516677,EDS 250,A00,507344,Hemans; Patricia Ann Benitez,27,0,40,13
1713500517700,EDS 281,A00,507345,Daly; Alan J.,18,0,18,0
1713500518726,EDS 284,A00,507350,Daly; Alan J.,16,0,16,0
1713500519752,EDS 286,A00,507359,Fine; Sarah,18,0,18,0
1713500520782,EDS 289C,A01,507361,Daly; Alan J.,18,0,18,0
1713500521810,EDS 290,A00,507366,Hofstetter; Carolyn,15,0,15,0
1713500522838,LIGM 5A,A00,507421,Fischer-Grunski; Eva K,20,0,20,0
1713500523863,LIGM 5B,A00,507423,Fischer-Grunski; Eva K,20,0,20,0
1713500524891,LIGM 5C,A00,507425,Fischer-Grunski; Eva K,20,0,20,0
1713500525916,LIIT 5AS,A00,507427,Carnelos; Chiara,20,0,20,0
1713500526941,LIIT 5BS,A00,507430,Carnelos; Chiara,20,0,20,0
1713500527966,LIIT 5CS,A00,507432,Carnelos; Chiara,20,0,20,0
1713500528995,LISP 5A,A00,507541,Munoz Sanchez; Alicia,14,0,20,6
1713500530020,LISP 5B,A00,507671,Munoz Sanchez; Alicia,12,0,20,8
1713500531049,LISP 5C,A00,507696,Munoz Sanchez; Alicia,11,0,20,9
1713500532075,MAE 197,001,528363,Boechler; Nicholas Sebastia,9998,0,9999,1
1713500533101,MATH 197,001,523477,Kedlaya; Kiran S.,9999,0,9999,0
1713500533101,MATH 197,002,563811,Zhang; Danna,9998,0,9999,1
1713500534126,MCWP 40R,A00,518780,Staff,14,0,20,6
1713500534126,MCWP 40R,B00,518781,Staff,11,0,20,9
1713500534126,MCWP 40R,C00,518783,Staff,9,0,20,11
1713500535155,MCWP 50R,A00,518791,Staff,7,0,20,13
1713500535155,MCWP 50R,B00,518792,Staff,3,0,20,17
1713500535155,MCWP 50R,C00,518793,Staff,7,0,20,13
1713500535155,MCWP 50R,D00,518794,Staff,0,0,20,20
1713500535155,MCWP 50R,E00,518795,Staff,0,0,20,20
1713500535155,MCWP 50R,F00,518796,Staff,11,0,20,9
1713500535155,MCWP 50R,G00,518797,Staff,10,0,20,10
1713500536183,MMW 12R,A01,514034,Herbst; Matthew,4,0,16,12
1713500536183,MMW 12R,A02,514035,Herbst; Matthew,13,0,16,3
1713500537211,MMW 13R,A01,514037,Staff,0,8,16,16
1713500537211,MMW 13R,A02,514039,Staff,0,6,16,16
1713500539265,SIO 295LS,A00,523233,Staff,15,0,30,15
1713500540292,SIO 295S,A00,523232,Staff,15,0,30,15
1713500541317,SOCI 117,A01,494376,Staff,0,2,5,5
1713500542345,WES 237B,A00,494380,Staff,19,0,20,1
1713500544417,AESE 279B,A00,494370,Wade; Jon P,33,0,33,0
1713500545446,AIP 197,001,627712,Vespa; Emanuel Ignacio,9999,0,9999,0
1713500546473,ANAR 135S,A00,494369,Braswell; Geoffrey E.,0,0,0,0
1713500547500,CAT 124RS,A01,519847,Geibel; William,6,0,20,14
1713500548523,CAT 125RS,A01,515971,Geibel; William,6,0,20,14
1713500549549,CLRE 250,A00,511389,Morris; Sheldon,9996,0,9999,3
1713500550575,CLRE 251,A00,507176,Mehta; Ravindra L.,9996,0,9999,3
1713500550575,CLRE 251,B00,511410,Mehta; Ravindra L.,9998,0,9999,1
1713500551605,CLRE 252,A00,507189,Cuomo; Raphael Eduardo,9998,0,9999,1
1713500552634,CLRE 253,A00,507199,Vaida; Florin,9997,0,9999,2
1713500552634,CLRE 253,B00,507202,Vaida; Florin,9999,0,9999,0
1713500553659,CLRE 259,A00,507211,Patel; Hemal,9996,0,9999,3
1713500554683,CLRE 260,A00,507221,Cuomo; Raphael Eduardo,9999,0,9999,0
1713500555710,CLRE 297,001,507242,Cuomo; Raphael Eduardo,9999,0,9999,0
1713500556737,CSE 191,A00,516875,Minnes Kemp; Mor Mia,9999,0,9999,0
1713500557761,CSS 201S,A01,494383,Staff,35,0,35,0
1713500558786,CSS 202S,A01,494387,Staff,35,0,35,0
1713500559813,EAP 100,A00,516065,Staff,9792,0,9999,207
1713500560841,ECE 45,A01,507414,Staff,37,0,60,23
1713500561869,ECE 100,A01,507416,Baghdadchi; Saharnaz,0,0,20,20
1713500561869,ECE 100,A02,507418,Baghdadchi; Saharnaz,19,0,20,1
1713500562898,ECE 111,A01,507420,Staff,27,0,50,23
1713500563923,ECE 197,001,548057,Sievenpiper; Daniel F.,9998,0,9999,1
1713500564946,EDS 115,A00,507243,Choi; Bailey Miyeon,27,0,28,1
1713500565972,EDS 117,A01,494379,Staff,15,0,25,10
1713500566998,EDS 125,A00,507246,Hopkins; Megan Beth,27,0,30,3
1713500568023,EDS 128A,A01,507264,Fargason; Sharon Gayle,26,0,26,0
1713500569049,EDS 128B,A01,507293,Pappas; Elizabeth,30,0,30,0
1713500570077,EDS 139,A00,507294,Fargason; Sharon Gayle,30,0,30,0
1713500570077,EDS 139,B00,507313,Pappas; Elizabeth,30,0,30,0
1713500571106,EDS 201,A00,507315,Staff,18,0,30,12
1713500572136,EDS 203,A01,507317,Halter; Christopher P.,17,0,30,13
1713500573162,EDS 204R,A01,507319,Halter; Christopher P.,0,1,30,30
1713500573162,EDS 204R,B01,507331,Heinzman; Erica M.,22,0,30,8
1713500574192,EDS 206R,A00,507332,Staff,0,2,30,30
1713500574192,EDS 206R,B00,507343,Staff,23,0,30,7
1713500575217,EDS 250,A00,507344,Hemans; Patricia Ann Benitez,27,0,40,13
1713500576244,EDS 281,A00,507345,Daly; Alan J.,18,0,18,0
1713500577271,EDS 284,A00,507350,Daly; Alan J.,16,0,16,0
1713500578299,EDS 286,A00,507359,Fine; Sarah,18,0,18,0
1713500579380,EDS 289C,A01,507361,Daly; Alan J.,18,0,18,0
1713500580411,EDS 290,A00,507366,Hofstetter; Carolyn,15,0,15,0
1713500581436,LIGM 5A,A00,507421,Fischer-Grunski; Eva K,20,0,20,0
1713500582462,LIGM 5B,A00,507423,Fischer-Grunski; Eva K,20,0,20,0
1713500583493,LIGM 5C,A00,507425,Fischer-Grunski; Eva K,20,0,20,0
1713500584518,LIIT 5AS,A00,507427,Carnelos; Chiara,20,0,20,0
1713500585547,LIIT 5BS,A00,507430,Carnelos; Chiara,20,0,20,0
1713500586579,LIIT 5CS,A00,507432,Carnelos; Chiara,20,0,20,0
1713500587604,LISP 5A,A00,507541,Munoz Sanchez; Alicia,14,0,20,6
1713500588634,LISP 5B,A00,507671,Munoz Sanchez; Alicia,12,0,20,8
1713500589661,LISP 5C,A00,507696,Munoz Sanchez; Alicia,11,0,20,9
1713500590688,MAE 197,001,528363,Boechler; Nicholas Sebastia,9998,0,9999,1
1713500591715,MATH 197,001,523477,Kedlaya; Kiran S.,9999,0,9999,0
1713500591715,MATH 197,002,563811,Zhang; Danna,9998,0,9999,1
1713500592741,MCWP 40R,A00,518780,Staff,14,0,20,6
1713500592741,MCWP 40R,B00,518781,Staff,11,0,20,9
1713500592741,MCWP 40R,C00,518783,Staff,9,0,20,11
1713500593767,MCWP 50R,A00,518791,Staff,7,0,20,13
1713500593767,MCWP 50R,B00,518792,Staff,3,0,20,17
1713500593767,MCWP 50R,C00,518793,Staff,7,0,20,13
1713500593767,MCWP 50R,D00,518794,Staff,0,0,20,20
1713500593767,MCWP 50R,E00,518795,Staff,0,0,20,20
1713500593767,MCWP 50R,F00,518796,Staff,11,0,20,9
1713500593767,MCWP 50R,G00,518797,Staff,10,0,20,10
1713500594793,MMW 12R,A01,514034,Herbst; Matthew,4,0,16,12
1713500594793,MMW 12R,A02,514035,Herbst; Matthew,13,0,16,3
1713500595819,MMW 13R,A01,514037,Staff,0,8,16,16
1713500595819,MMW 13R,A02,514039,Staff,0,6,16,16
1713500597872,SIO 295LS,A00,523233,Staff,15,0,30,15
1713500598901,SIO 295S,A00,523232,Staff,15,0,30,15
1713500599928,SOCI 117,A01,494376,Staff,0,2,5,5
1713500600957,WES 237B,A00,494380,Staff,19,0,20,1
1713500603023,AESE 279B,A00,494370,Wade; Jon P,33,0,33,0
1713500604052,AIP 197,001,627712,Vespa; Emanuel Ignacio,9999,0,9999,0
1713500605080,ANAR 135S,A00,494369,Braswell; Geoffrey E.,0,0,0,0
1713500606107,CAT 124RS,A01,519847,Geibel; William,6,0,20,14
1713500607136,CAT 125RS,A01,515971,Geibel; William,6,0,20,14
1713500608164,CLRE 250,A00,511389,Morris; Sheldon,9996,0,9999,3
1713500609192,CLRE 251,A00,507176,Mehta; Ravindra L.,9996,0,9999,3
1713500609192,CLRE 251,B00,511410,Mehta; Ravindra L.,9998,0,9999,1
1713500610218,CLRE 252,A00,507189,Cuomo; Raphael Eduardo,9998,0,9999,1
1713500611245,CLRE 253,A00,507199,Vaida; Florin,9997,0,9999,2
1713500611245,CLRE 253,B00,507202,Vaida; Florin,9999,0,9999,0
1713500612271,CLRE 259,A00,507211,Patel; Hemal,9996,0,9999,3
1713500613298,CLRE 260,A00,507221,Cuomo; Raphael Eduardo,9999,0,9999,0
1713500614325,CLRE 297,001,507242,Cuomo; Raphael Eduardo,9999,0,9999,0
1713500615354,CSE 191,A00,516875,Minnes Kemp; Mor Mia,9999,0,9999,0
1713500616384,CSS 201S,A01,494383,Staff,35,0,35,0
1713500617410,CSS 202S,A01,494387,Staff,35,0,35,0
1713500618436,EAP 100,A00,516065,Staff,9792,0,9999,207
1713500619462,ECE 45,A01,507414,Staff,37,0,60,23
1713500620487,ECE 100,A01,507416,Baghdadchi; Saharnaz,0,0,20,20
1713500620487,ECE 100,A02,507418,Baghdadchi; Saharnaz,19,0,20,1
1713500621512,ECE 111,A01,507420,Staff,27,0,50,23
1713500622537,ECE 197,001,548057,Sievenpiper; Daniel F.,9998,0,9999,1
1713500623561,EDS 115,A00,507243,Choi; Bailey Miyeon,27,0,28,1
1713500624588,EDS 117,A01,494379,Staff,15,0,25,10
1713500625614,EDS 125,A00,507246,Hopkins; Megan Beth,27,0,30,3
1713500626641,EDS 128A,A01,507264,Fargason; Sharon Gayle,26,0,26,0
1713500627672,EDS 128B,A01,507293,Pappas; Elizabeth,30,0,30,0
1713500628700,EDS 139,A00,507294,Fargason; Sharon Gayle,30,0,30,0
1713500628700,EDS 139,B00,507313,Pappas; Elizabeth,30,0,30,0
1713500629724,EDS 201,A00,507315,Staff,18,0,30,12
1713500630750,EDS 203,A01,507317,Halter; Christopher P.,17,0,30,13
1713500631776,EDS 204R,A01,507319,Halter; Christopher P.,0,1,30,30
1713500631776,EDS 204R,B01,507331,Heinzman; Erica M.,22,0,30,8
1713500632801,EDS 206R,A00,507332,Staff,0,2,30,30
1713500632801,EDS 206R,B00,507343,Staff,23,0,30,7
1713500633825,EDS 250,A00,507344,Hemans; Patricia Ann Benitez,27,0,40,13
1713500634853,EDS 281,A00,507345,Daly; Alan J.,18,0,18,0
1713500635878,EDS 284,A00,507350,Daly; Alan J.,16,0,16,0
1713500636903,EDS 286,A00,507359,Fine; Sarah,18,0,18,0
1713500637931,EDS 289C,A01,507361,Daly; Alan J.,18,0,18,0
1713500638958,EDS 290,A00,507366,Hofstetter; Carolyn,15,0,15,0
1713500639983,LIGM 5A,A00,507421,Fischer-Grunski; Eva K,20,0,20,0
1713500641011,LIGM 5B,A00,507423,Fischer-Grunski; Eva K,20,0,20,0
1713500642039,LIGM 5C,A00,507425,Fischer-Grunski; Eva K,20,0,20,0
1713500643066,LIIT 5AS,A00,507427,Carnelos; Chiara,20,0,20,0
1713500644095,LIIT 5BS,A00,507430,Carnelos; Chiara,20,0,20,0
1713500645124,LIIT 5CS,A00,507432,Carnelos; Chiara,20,0,20,0
1713500646151,LISP 5A,A00,507541,Munoz Sanchez; Alicia,14,0,20,6
1713500647181,LISP 5B,A00,507671,Munoz Sanchez; Alicia,12,0,20,8
1713500648208,LISP 5C,A00,507696,Munoz Sanchez; Alicia,11,0,20,9
1713500649237,MAE 197,001,528363,Boechler; Nicholas Sebastia,9998,0,9999,1
1713500650263,MATH 197,001,523477,Kedlaya; Kiran S.,9999,0,9999,0
1713500650263,MATH 197,002,563811,Zhang; Danna,9998,0,9999,1
1713500651291,MCWP 40R,A00,518780,Staff,14,0,20,6
1713500651291,MCWP 40R,B00,518781,Staff,11,0,20,9
1713500651291,MCWP 40R,C00,518783,Staff,9,0,20,11
1713500652317,MCWP 50R,A00,518791,Staff,7,0,20,13
1713500652317,MCWP 50R,B00,518792,Staff,3,0,20,17
1713500652317,MCWP 50R,C00,518793,Staff,7,0,20,13
1713500652317,MCWP 50R,D00,518794,Staff,0,0,20,20
1713500652317,MCWP 50R,E00,518795,Staff,0,0,20,20
1713500652317,MCWP 50R,F00,518796,Staff,11,0,20,9
1713500652317,MCWP 50R,G00,518797,Staff,10,0,20,10
1713500653341,MMW 12R,A01,514034,Herbst; Matthew,4,0,16,12
1713500653341,MMW 12R,A02,514035,Herbst; Matthew,13,0,16,3
1713500654366,MMW 13R,A01,514037,Staff,0,8,16,16
1713500654366,MMW 13R,A02,514039,Staff,0,6,16,16
1713500656415,SIO 295LS,A00,523233,Staff,15,0,30,15
1713500657443,SIO 295S,A00,523232,Staff,15,0,30,15
1713500658468,SOCI 117,A01,494376,Staff,0,2,5,5
1713500659493,WES 237B,A00,494380,Staff,19,0,20,1
1713500661554,AESE 279B,A00,494370,Wade; Jon P,33,0,33,0
1713500662579,AIP 197,001,627712,Vespa; Emanuel Ignacio,9999,0,9999,0
1713500663607,ANAR 135S,A00,494369,Braswell; Geoffrey E.,0,0,0,0
1713500664636,CAT 124RS,A01,519847,Geibel; William,6,0,20,14
1713500665661,CAT 125RS,A01,515971,Geibel; William,6,0,20,14
1713500666687,CLRE 250,A00,511389,Morris; Sheldon,9996,0,9999,3
1713500667717,CLRE 251,A00,507176,Mehta; Ravindra L.,9996,0,9999,3
1713500667717,CLRE 251,B00,511410,Mehta; Ravindra L.,9998,0,9999,1
1713500668742,CLRE 252,A00,507189,Cuomo; Raphael Eduardo,9998,0,9999,1
1713500669769,CLRE 253,A00,507199,Vaida; Florin,9997,0,9999,2
1713500669769,CLRE 253,B00,507202,Vaida; Florin,9999,0,9999,0
1713500670796,CLRE 259,A00,507211,Patel; Hemal,9996,0,9999,3
1713500671820,CLRE 260,A00,507221,Cuomo; Raphael Eduardo,9999,0,9999,0
1713500672848,CLRE 297,001,507242,Cuomo; Raphael Eduardo,9999,0,9999,0
1713500673878,CSE 191,A00,516875,Minnes Kemp; Mor Mia,9999,0,9999,0
1713500674904,CSS 201S,A01,494383,Staff,35,0,35,0
1713500675929,CSS 202S,A01,494387,Staff,35,0,35,0
1713500676956,EAP 100,A00,516065,Staff,9792,0,9999,207
1713500677984,ECE 45,A01,507414,Staff,37,0,60,23
1713500679010,ECE 100,A01,507416,Baghdadchi; Saharnaz,0,0,20,20
1713500679010,ECE 100,A02,507418,Baghdadchi; Saharnaz,19,0,20,1
1713500680036,ECE 111,A01,507420,Staff,27,0,50,23
1713500681068,ECE 197,001,548057,Sievenpiper; Daniel F.,9998,0,9999,1
1713500682093,EDS 115,A00,507243,Choi; Bailey Miyeon,27,0,28,1
1713500683172,EDS 117,A01,494379,Staff,15,0,25,10
1713500684199,EDS 125,A00,507246,Hopkins; Megan Beth,27,0,30,3
1713500685229,EDS 128A,A01,507264,Fargason; Sharon Gayle,26,0,26,0
1713500686255,EDS 128B,A01,507293,Pappas; Elizabeth,30,0,30,0
1713500687282,EDS 139,A00,507294,Fargason; Sharon Gayle,30,0,30,0
1713500687282,EDS 139,B00,507313,Pappas; Elizabeth,30,0,30,0
1713500688309,EDS 201,A00,507315,Staff,18,0,30,12
1713500689335,EDS 203,A01,507317,Halter; Christopher P.,17,0,30,13
1713500690362,EDS 204R,A01,507319,Halter; Christopher P.,0,1,30,30
1713500690362,EDS 204R,B01,507331,Heinzman; Erica M.,22,0,30,8
1713500691389,EDS 206R,A00,507332,Staff,0,2,30,30
1713500691389,EDS 206R,B00,507343,Staff,23,0,30,7
1713500692414,EDS 250,A00,507344,Hemans; Patricia Ann Benitez,27,0,40,13
1713500693441,EDS 281,A00,507345,Daly; Alan J.,18,0,18,0
1713500694469,EDS 284,A00,507350,Daly; Alan J.,16,0,16,0
1713500695496,EDS 286,A00,507359,Fine; Sarah,18,0,18,0
1713500696521,EDS 289C,A01,507361,Daly; Alan J.,18,0,18,0
1713500697546,EDS 290,A00,507366,Hofstetter; Carolyn,15,0,15,0
1713500698571,LIGM 5A,A00,507421,Fischer-Grunski; Eva K,20,0,20,0
1713500699599,LIGM 5B,A00,507423,Fischer-Grunski; Eva K,20,0,20,0
1713500700623,LIGM 5C,A00,507425,Fischer-Grunski; Eva K,20,0,20,0
1713500701649,LIIT 5AS,A00,507427,Carnelos; Chiara,20,0,20,0
1713500702701,LIIT 5BS,A00,507430,Carnelos; Chiara,20,0,20,0
1713500703727,LIIT 5CS,A00,507432,Carnelos; Chiara,20,0,20,0
1713500704753,LISP 5A,A00,507541,Munoz Sanchez; Alicia,14,0,20,6
1713500705779,LISP 5B,A00,507671,Munoz Sanchez; Alicia,12,0,20,8
1713500706808,LISP 5C,A00,507696,Munoz Sanchez; Alicia,11,0,20,9
1713500707836,MAE 197,001,528363,Boechler; Nicholas Sebastia,9998,0,9999,1
1713500708862,MATH 197,001,523477,Kedlaya; Kiran S.,9999,0,9999,0
1713500708862,MATH 197,002,563811,Zhang; Danna,9998,0,9999,1
1713500709887,MCWP 40R,A00,518780,Staff,14,0,20,6
1713500709887,MCWP 40R,B00,518781,Staff,11,0,20,9
1713500709887,MCWP 40R,C00,518783,Staff,9,0,20,11
1713500710914,MCWP 50R,A00,518791,Staff,7,0,20,13
1713500710914,MCWP 50R,B00,518792,Staff,3,0,20,17
1713500710914,MCWP 50R,C00,518793,Staff,6,0,20,14
1713500710914,MCWP 50R,D00,518794,Staff,0,0,20,20
1713500710914,MCWP 50R,E00,518795,Staff,0,0,20,20
1713500710914,MCWP 50R,F00,518796,Staff,11,0,20,9
1713500710914,MCWP 50R,G00,518797,Staff,10,0,20,10
1713500711940,MMW 12R,A01,514034,Herbst; Matthew,4,0,16,12
1713500711940,MMW 12R,A02,514035,Herbst; Matthew,13,0,16,3
1713500712965,MMW 13R,A01,514037,Staff,0,8,16,16
1713500712965,MMW 13R,A02,514039,Staff,0,6,16,16
1713500715017,SIO 295LS,A00,523233,Staff,15,0,30,15
1713500716042,SIO 295S,A00,523232,Staff,15,0,30,15
1713500717070,SOCI 117,A01,494376,Staff,0,2,5,5
1713500718097,WES 237B,A00,494380,Staff,19,0,20,1
1713500720152,AESE 279B,A00,494370,Wade; Jon P,33,0,33,0
1713500721178,AIP 197,001,627712,Vespa; Emanuel Ignacio,9999,0,9999,0
1713500722206,ANAR 135S,A00,494369,Braswell; Geoffrey E.,0,0,0,0
1713500723235,CAT 124RS,A01,519847,Geibel; William,6,0,20,14
1713500724260,CAT 125RS,A01,515971,Geibel; William,6,0,20,14
1713500725285,CLRE 250,A00,511389,Morris; Sheldon,9996,0,9999,3
1713500726314,CLRE 251,A00,507176,Mehta; Ravindra L.,9996,0,9999,3
1713500726314,CLRE 251,B00,511410,Mehta; Ravindra L.,9998,0,9999,1
1713500727343,CLRE 252,A00,507189,Cuomo; Raphael Eduardo,9998,0,9999,1
1713500728370,CLRE 253,A00,507199,Vaida; Florin,9997,0,9999,2
1713500728370,CLRE 253,B00,507202,Vaida; Florin,9999,0,9999,0
1713500729398,CLRE 259,A00,507211,Patel; Hemal,9996,0,9999,3
1713500730422,CLRE 260,A00,507221,Cuomo; Raphael Eduardo,9999,0,9999,0
1713500731450,CLRE 297,001,507242,Cuomo; Raphael Eduardo,9999,0,9999,0
1713500732474,CSE 191,A00,516875,Minnes Kemp; Mor Mia,9999,0,9999,0
1713500733500,CSS 201S,A01,494383,Staff,35,0,35,0
1713500734524,CSS 202S,A01,494387,Staff,35,0,35,0
1713500735552,EAP 100,A00,516065,Staff,9792,0,9999,207
1713500736576,ECE 45,A01,507414,Staff,37,0,60,23
1713500737599,ECE 100,A01,507416,Baghdadchi; Saharnaz,0,0,20,20
1713500737599,ECE 100,A02,507418,Baghdadchi; Saharnaz,19,0,20,1
1713500738628,ECE 111,A01,507420,Staff,27,0,50,23
1713500739656,ECE 197,001,548057,Sievenpiper; Daniel F.,9998,0,9999,1
1713500740684,EDS 115,A00,507243,Choi; Bailey Miyeon,27,0,28,1
1713500741713,EDS 117,A01,494379,Staff,15,0,25,10
1713500742738,EDS 125,A00,507246,Hopkins; Megan Beth,27,0,30,3
1713500743767,EDS 128A,A01,507264,Fargason; Sharon Gayle,26,0,26,0
1713500744797,EDS 128B,A01,507293,Pappas; Elizabeth,30,0,30,0
1713500745828,EDS 139,A00,507294,Fargason; Sharon Gayle,30,0,30,0
1713500745828,EDS 139,B00,507313,Pappas; Elizabeth,30,0,30,0
1713500746854,EDS 201,A00,507315,Staff,18,0,30,12
1713500747880,EDS 203,A01,507317,Halter; Christopher P.,17,0,30,13
1713500748904,EDS 204R,A01,507319,Halter; Christopher P.,0,1,30,30
1713500748904,EDS 204R,B01,507331,Heinzman; Erica M.,22,0,30,8
1713500749930,EDS 206R,A00,507332,Staff,0,2,30,30
1713500749930,EDS 206R,B00,507343,Staff,23,0,30,7
1713500750958,EDS 250,A00,507344,Hemans; Patricia Ann Benitez,27,0,40,13
1713500751986,EDS 281,A00,507345,Daly; Alan J.,18,0,18,0
1713500753012,EDS 284,A00,507350,Daly; Alan J.,16,0,16,0
1713500754039,EDS 286,A00,507359,Fine; Sarah,18,0,18,0
1713500755066,EDS 289C,A01,507361,Daly; Alan J.,18,0,18,0
1713500756091,EDS 290,A00,507366,Hofstetter; Carolyn,15,0,15,0
1713500757116,LIGM 5A,A00,507421,Fischer-Grunski; Eva K,20,0,20,0
1713500758141,LIGM 5B,A00,507423,Fischer-Grunski; Eva K,20,0,20,0
1713500759167,LIGM 5C,A00,507425,Fischer-Grunski; Eva K,20,0,20,0
1713500760192,LIIT 5AS,A00,507427,Carnelos; Chiara,20,0,20,0
1713500761217,LIIT 5BS,A00,507430,Carnelos; Chiara,20,0,20,0
1713500762242,LIIT 5CS,A00,507432,Carnelos; Chiara,20,0,20,0
1713500763266,LISP 5A,A00,507541,Munoz Sanchez; Alicia,14,0,20,6
1713500764295,LISP 5B,A00,507671,Munoz Sanchez; Alicia,12,0,20,8
1713500765321,LISP 5C,A00,507696,Munoz Sanchez; Alicia,11,0,20,9
1713500766349,MAE 197,001,528363,Boechler; Nicholas Sebastia,9998,0,9999,1
1713500767373,MATH 197,001,523477,Kedlaya; Kiran S.,9999,0,9999,0
1713500767373,MATH 197,002,563811,Zhang; Danna,9998,0,9999,1
1713500768398,MCWP 40R,A00,518780,Staff,14,0,20,6
1713500768398,MCWP 40R,B00,518781,Staff,11,0,20,9
1713500768398,MCWP 40R,C00,518783,Staff,9,0,20,11
1713500769426,MCWP 50R,A00,518791,Staff,7,0,20,13
1713500769426,MCWP 50R,B00,518792,Staff,3,0,20,17
1713500769426,MCWP 50R,C00,518793,Staff,6,0,20,14
1713500769426,MCWP 50R,D00,518794,Staff,0,0,20,20
1713500769426,MCWP 50R,E00,518795,Staff,0,0,20,20
1713500769426,MCWP 50R,F00,518796,Staff,11,0,20,9
1713500769426,MCWP 50R,G00,518797,Staff,10,0,20,10
1713500770452,MMW 12R,A01,514034,Herbst; Matthew,4,0,16,12
1713500770452,MMW 12R,A02,514035,Herbst; Matthew,13,0,16,3
1713500771476,MMW 13R,A01,514037,Staff,0,8,16,16
1713500771476,MMW 13R,A02,514039,Staff,0,7,16,16
1713500773526,SIO 295LS,A00,523233,Staff,15,0,30,15
1713500774551,SIO 295S,A00,523232,Staff,15,0,30,15
1713500775578,SOCI 117,A01,494376,Staff,0,2,5,5
1713500776606,WES 237B,A00,494380,Staff,19,0,20,1
1713500778669,AESE 279B,A00,494370,Wade; Jon P,33,0,33,0
1713500779693,AIP 197,001,627712,Vespa; Emanuel Ignacio,9999,0,9999,0
1713500780721,ANAR 135S,A00,494369,Braswell; Geoffrey E.,0,0,0,0
1713500781747,CAT 124RS,A01,519847,Geibel; William,6,0,20,14
1713500782772,CAT 125RS,A01,515971,Geibel; William,6,0,20,14
1713500783795,CLRE 250,A00,511389,Morris; Sheldon,9996,0,9999,3
1713500784826,CLRE 251,A00,507176,Mehta; Ravindra L.,9996,0,9999,3
1713500784826,CLRE 251,B00,511410,Mehta; Ravindra L.,9998,0,9999,1
1713500785851,CLRE 252,A00,507189,Cuomo; Raphael Eduardo,9998,0,9999,1
1713500786931,CLRE 253,A00,507199,Vaida; Florin,9997,0,9999,2
1713500786931,CLRE 253,B00,507202,Vaida; Florin,9999,0,9999,0
1713500787957,CLRE 259,A00,507211,Patel; Hemal,9996,0,9999,3
1713500788982,CLRE 260,A00,507221,Cuomo; Raphael Eduardo,9999,0,9999,0
1713500790007,CLRE 297,001,507242,Cuomo; Raphael Eduardo,9999,0,9999,0
1713500791034,CSE 191,A00,516875,Minnes Kemp; Mor Mia,9999,0,9999,0
1713500792064,CSS 201S,A01,494383,Staff,35,0,35,0
1713500793088,CSS 202S,A01,494387,Staff,35,0,35,0
1713500794111,EAP 100,A00,516065,Staff,9792,0,9999,207
1713500795135,ECE 45,A01,507414,Staff,37,0,60,23
1713500796160,ECE 100,A01,507416,Baghdadchi; Saharnaz,0,0,20,20
1713500796160,ECE 100,A02,507418,Baghdadchi; Saharnaz,19,0,20,1
1713500797192,ECE 111,A01,507420,Staff,27,0,50,23
1713500798217,ECE 197,001,548057,Sievenpiper; Daniel F.,9998,0,9999,1
1713500799245,EDS 115,A00,507243,Choi; Bailey Miyeon,27,0,28,1
1713500800270,EDS 117,A01,494379,Staff,15,0,25,10
1713500801299,EDS 125,A00,507246,Hopkins; Megan Beth,27,0,30,3
1713500802327,EDS 128A,A01,507264,Fargason; Sharon Gayle,26,0,26,0
1713500803351,EDS 128B,A01,507293,Pappas; Elizabeth,30,0,30,0
1713500804379,EDS 139,A00,507294,Fargason; Sharon Gayle,30,0,30,0
1713500804379,EDS 139,B00,507313,Pappas; Elizabeth,30,0,30,0
1713500805404,EDS 201,A00,507315,Staff,18,0,30,12
1713500806428,EDS 203,A01,507317,Halter; Christopher P.,17,0,30,13
1713500807456,EDS 204R,A01,507319,Halter; Christopher P.,0,1,30,30
1713500807456,EDS 204R,B01,507331,Heinzman; Erica M.,22,0,30,8
1713500808484,EDS 206R,A00,507332,Staff,0,2,30,30
1713500808484,EDS 206R,B00,507343,Staff,23,0,30,7
1713500809509,EDS 250,A00,507344,Hemans; Patricia Ann Benitez,27,0,40,13
1713500810537,EDS 281,A00,507345,Daly; Alan J.,18,0,18,0
1713500811565,EDS 284,A00,507350,Daly; Alan J.,16,0,16,0
1713500812589,EDS 286,A00,507359,Fine; Sarah,18,0,18,0
1713500813615,EDS 289C,A01,507361,Daly; Alan J.,18,0,18,0
1713500814641,EDS 290,A00,507366,Hofstetter; Carolyn,15,0,15,0
1713500815665,LIGM 5A,A00,507421,Fischer-Grunski; Eva K,20,0,20,0
1713500816691,LIGM 5B,A00,507423,Fischer-Grunski; Eva K,20,0,20,0
1713500817715,LIGM 5C,A00,507425,Fischer-Grunski; Eva K,20,0,20,0
1713500818745,LIIT 5AS,A00,507427,Carnelos; Chiara,20,0,20,0
1713500819771,LIIT 5BS,A00,507430,Carnelos; Chiara,20,0,20,0
1713500820797,LIIT 5CS,A00,507432,Carnelos; Chiara,20,0,20,0
1713500821822,LISP 5A,A00,507541,Munoz Sanchez; Alicia,14,0,20,6
1713500822851,LISP 5B,A00,507671,Munoz Sanchez; Alicia,12,0,20,8
1713500823881,LISP 5C,A00,507696,Munoz Sanchez; Alicia,11,0,20,9
1713500824911,MAE 197,001,528363,Boechler; Nicholas Sebastia,9998,0,9999,1
1713500825934,MATH 197,001,523477,Kedlaya; Kiran S.,9999,0,9999,0
1713500825934,MATH 197,002,563811,Zhang; Danna,9998,0,9999,1
1713500826958,MCWP 40R,A00,518780,Staff,14,0,20,6
1713500826958,MCWP 40R,B00,518781,Staff,11,0,20,9
1713500826958,MCWP 40R,C00,518783,Staff,9,0,20,11
1713500827988,MCWP 50R,A00,518791,Staff,7,0,20,13
1713500827988,MCWP 50R,B00,518792,Staff,3,0,20,17
1713500827988,MCWP 50R,C00,518793,Staff,6,0,20,14
1713500827988,MCWP 50R,D00,518794,Staff,0,0,20,20
1713500827988,MCWP 50R,E00,518795,Staff,0,0,20,20
1713500827988,MCWP 50R,F00,518796,Staff,11,0,20,9
1713500827988,MCWP 50R,G00,518797,Staff,10,0,20,10
1713500829012,MMW 12R,A01,514034,Herbst; Matthew,4,0,16,12
1713500829012,MMW 12R,A02,514035,Herbst; Matthew,13,0,16,3
1713500830041,MMW 13R,A01,514037,Staff,0,8,16,16
1713500830041,MMW 13R,A02,514039,Staff,0,7,16,16
1713500832093,SIO 295LS,A00,523233,Staff,15,0,30,15
1713500833123,SIO 295S,A00,523232,Staff,15,0,30,15
1713500834147,SOCI 117,A01,494376,Staff,0,2,5,5
1713500835177,WES 237B,A00,494380,Staff,19,0,20,1
1713500837248,AESE 279B,A00,494370,Wade; Jon P,33,0,33,0
1713500838273,AIP 197,001,627712,Vespa; Emanuel Ignacio,9999,0,9999,0
1713500839299,ANAR 135S,A00,494369,Braswell; Geoffrey E.,0,0,0,0
1713500840324,CAT 124RS,A01,519847,Geibel; William,6,0,20,14
1713500841355,CAT 125RS,A01,515971,Geibel; William,6,0,20,14
1713500842379,CLRE 250,A00,511389,Morris; Sheldon,9996,0,9999,3
1713500843404,CLRE 251,A00,507176,Mehta; Ravindra L.,9996,0,9999,3
1713500843404,CLRE 251,B00,511410,Mehta; Ravindra L.,9998,0,9999,1
1713500844433,CLRE 252,A00,507189,Cuomo; Raphael Eduardo,9998,0,9999,1
1713500845461,CLRE 253,A00,507199,Vaida; Florin,9997,0,9999,2
1713500845461,CLRE 253,B00,507202,Vaida; Florin,9999,0,9999,0
1713500846489,CLRE 259,A00,507211,Patel; Hemal,9996,0,9999,3
1713500847515,CLRE 260,A00,507221,Cuomo; Raphael Eduardo,9999,0,9999,0
1713500848539,CLRE 297,001,507242,Cuomo; Raphael Eduardo,9999,0,9999,0
1713500849567,CSE 191,A00,516875,Minnes Kemp; Mor Mia,9999,0,9999,0
1713500850597,CSS 201S,A01,494383,Staff,35,0,35,0
1713500851625,CSS 202S,A01,494387,Staff,35,0,35,0
1713500852649,EAP 100,A00,516065,Staff,9792,0,9999,207
1713500853678,ECE 45,A01,507414,Staff,37,0,60,23
1713500854705,ECE 100,A01,507416,Baghdadchi; Saharnaz,0,0,20,20
1713500854705,ECE 100,A02,507418,Baghdadchi; Saharnaz,19,0,20,1
1713500855730,ECE 111,A01,507420,Staff,27,0,50,23
1713500856759,ECE 197,001,548057,Sievenpiper; Daniel F.,9998,0,9999,1
1713500857829,EDS 115,A00,507243,Choi; Bailey Miyeon,27,0,28,1
1713500858854,EDS 117,A01,494379,Staff,15,0,25,10
1713500859880,EDS 125,A00,507246,Hopkins; Megan Beth,27,0,30,3
1713500860908,EDS 128A,A01,507264,Fargason; Sharon Gayle,26,0,26,0
1713500861933,EDS 128B,A01,507293,Pappas; Elizabeth,30,0,30,0
1713500862958,EDS 139,A00,507294,Fargason; Sharon Gayle,30,0,30,0
1713500862958,EDS 139,B00,507313,Pappas; Elizabeth,30,0,30,0
1713500863983,EDS 201,A00,507315,Staff,18,0,30,12
1713500865008,EDS 203,A01,507317,Halter; Christopher P.,17,0,30,13
1713500866033,EDS 204R,A01,507319,Halter; Christopher P.,0,1,30,30
1713500866033,EDS 204R,B01,507331,Heinzman; Erica M.,22,0,30,8
1713500867057,EDS 206R,A00,507332,Staff,0,2,30,30
1713500867057,EDS 206R,B00,507343,Staff,23,0,30,7
1713500868085,EDS 250,A00,507344,Hemans; Patricia Ann Benitez,27,0,40,13
1713500869112,EDS 281,A00,507345,Daly; Alan J.,18,0,18,0
1713500870140,EDS 284,A00,507350,Daly; Alan J.,16,0,16,0
1713500871165,EDS 286,A00,507359,Fine; Sarah,18,0,18,0
1713500872193,EDS 289C,A01,507361,Daly; Alan J.,18,0,18,0
1713500873217,EDS 290,A00,507366,Hofstetter; Carolyn,15,0,15,0
1713500874246,LIGM 5A,A00,507421,Fischer-Grunski; Eva K,20,0,20,0
1713500875326,LIGM 5B,A00,507423,Fischer-Grunski; Eva K,20,0,20,0
1713500876355,LIGM 5C,A00,507425,Fischer-Grunski; Eva K,20,0,20,0
1713500877380,LIIT 5AS,A00,507427,Carnelos; Chiara,20,0,20,0
1713500878403,LIIT 5BS,A00,507430,Carnelos; Chiara,20,0,20,0
1713500879433,LIIT 5CS,A00,507432,Carnelos; Chiara,20,0,20,0
1713500880462,LISP 5A,A00,507541,Munoz Sanchez; Alicia,14,0,20,6
1713500881487,LISP 5B,A00,507671,Munoz Sanchez; Alicia,12,0,20,8
1713500882516,LISP 5C,A00,507696,Munoz Sanchez; Alicia,11,0,20,9
1713500883547,MAE 197,001,528363,Boechler; Nicholas Sebastia,9998,0,9999,1
1713500884570,MATH 197,001,523477,Kedlaya; Kiran S.,9999,0,9999,0
1713500884570,MATH 197,002,563811,Zhang; Danna,9998,0,9999,1
1713500885600,MCWP 40R,A00,518780,Staff,14,0,20,6
1713500885600,MCWP 40R,B00,518781,Staff,11,0,20,9
1713500885600,MCWP 40R,C00,518783,Staff,9,0,20,11
1713500886630,MCWP 50R,A00,518791,Staff,7,0,20,13
1713500886630,MCWP 50R,B00,518792,Staff,3,0,20,17
1713500886630,MCWP 50R,C00,518793,Staff,6,0,20,14
1713500886630,MCWP 50R,D00,518794,Staff,0,0,20,20
1713500886630,MCWP 50R,E00,518795,Staff,0,0,20,20
1713500886630,MCWP 50R,F00,518796,Staff,11,0,20,9
1713500886630,MCWP 50R,G00,518797,Staff,10,0,20,10
1713500887654,MMW 12R,A01,514034,Herbst; Matthew,4,0,16,12
1713500887654,MMW 12R,A02,514035,Herbst; Matthew,13,0,16,3
1713500888681,MMW 13R,A01,514037,Staff,0,8,16,16
1713500888681,MMW 13R,A02,514039,Staff,0,7,16,16
1713500890786,SIO 295LS,A00,523233,Staff,15,0,30,15
1713500891814,SIO 295S,A00,523232,Staff,15,0,30,15
1713500892840,SOCI 117,A01,494376,Staff,0,2,5,5
1713500893872,WES 237B,A00,494380,Staff,19,0,20,1
1713500895940,AESE 279B,A00,494370,Wade; Jon P,33,0,33,0
1713500896965,AIP 197,001,627712,Vespa; Emanuel Ignacio,9999,0,9999,0
1713500897993,ANAR 135S,A00,494369,Braswell; Geoffrey E.,0,0,0,0
1713500899018,CAT 124RS,A01,519847,Geibel; William,6,0,20,14
1713500900047,CAT 125RS,A01,515971,Geibel; William,6,0,20,14
1713500901072,CLRE 250,A00,511389,Morris; Sheldon,9996,0,9999,3
1713500902098,CLRE 251,A00,507176,Mehta; Ravindra L.,9996,0,9999,3
1713500902098,CLRE 251,B00,511410,Mehta; Ravindra L.,9998,0,9999,1
1713500903124,CLRE 252,A00,507189,Cuomo; Raphael Eduardo,9998,0,9999,1
1713500904148,CLRE 253,A00,507199,Vaida; Florin,9997,0,9999,2
1713500904148,CLRE 253,B00,507202,Vaida; Florin,9999,0,9999,0
1713500905176,CLRE 259,A00,507211,Patel; Hemal,9996,0,9999,3
1713500906204,CLRE 260,A00,507221,Cuomo; Raphael Eduardo,9999,0,9999,0
1713500907229,CLRE 297,001,507242,Cuomo; Raphael Eduardo,9999,0,9999,0
1713500908253,CSE 191,A00,516875,Minnes Kemp; Mor Mia,9999,0,9999,0
1713500909282,CSS 201S,A01,494383,Staff,35,0,35,0
1713500910305,CSS 202S,A01,494387,Staff,35,0,35,0
1713500911329,EAP 100,A00,516065,Staff,9792,0,9999,207
1713500912355,ECE 45,A01,507414,Staff,37,0,60,23
1713500913380,ECE 100,A01,507416,Baghdadchi; Saharnaz,0,0,20,20
1713500913380,ECE 100,A02,507418,Baghdadchi; Saharnaz,19,0,20,1
1713500914405,ECE 111,A01,507420,Staff,27,0,50,23
1713500915432,ECE 197,001,548057,Sievenpiper; Daniel F.,9998,0,9999,1
1713500916457,EDS 115,A00,507243,Choi; Bailey Miyeon,27,0,28,1
1713500917482,EDS 117,A01,494379,Staff,15,0,25,10
1713500918511,EDS 125,A00,507246,Hopkins; Megan Beth,27,0,30,3
1713500919541,EDS 128A,A01,507264,Fargason; Sharon Gayle,26,0,26,0
1713500920566,EDS 128B,A01,507293,Pappas; Elizabeth,30,0,30,0
1713500921593,EDS 139,A00,507294,Fargason; Sharon Gayle,30,0,30,0
1713500921593,EDS 139,B00,507313,Pappas; Elizabeth,30,0,30,0
1713500922618,EDS 201,A00,507315,Staff,18,0,30,12
1713500923644,EDS 203,A01,507317,Halter; Christopher P.,17,0,30,13
1713500924671,EDS 204R,A01,507319,Halter; Christopher P.,0,1,30,30
1713500924671,EDS 204R,B01,507331,Heinzman; Erica M.,22,0,30,8
1713500925698,EDS 206R,A00,507332,Staff,0,2,30,30
1713500925698,EDS 206R,B00,507343,Staff,23,0,30,7
1713500926724,EDS 250,A00,507344,Hemans; Patricia Ann Benitez,27,0,40,13
1713500927749,EDS 281,A00,507345,Daly; Alan J.,18,0,18,0
1713500928774,EDS 284,A00,507350,Daly; Alan J.,16,0,16,0
1713500929799,EDS 286,A00,507359,Fine; Sarah,18,0,18,0
1713500930824,EDS 289C,A01,507361,Daly; Alan J.,18,0,18,0
1713500931848,EDS 290,A00,507366,Hofstetter; Carolyn,15,0,15,0
1713500932873,LIGM 5A,A00,507421,Fischer-Grunski; Eva K,20,0,20,0
1713500933898,LIGM 5B,A00,507423,Fischer-Grunski; Eva K,20,0,20,0
1713500934925,LIGM 5C,A00,507425,Fischer-Grunski; Eva K,20,0,20,0
1713500935949,LIIT 5AS,A00,507427,Carnelos; Chiara,20,0,20,0
1713500936975,LIIT 5BS,A00,507430,Carnelos; Chiara,20,0,20,0
1713500938003,LIIT 5CS,A00,507432,Carnelos; Chiara,20,0,20,0
1713500939032,LISP 5A,A00,507541,Munoz Sanchez; Alicia,14,0,20,6
1713500940057,LISP 5B,A00,507671,Munoz Sanchez; Alicia,12,0,20,8
1713500941086,LISP 5C,A00,507696,Munoz Sanchez; Alicia,11,0,20,9
1713500942111,MAE 197,001,528363,Boechler; Nicholas Sebastia,9998,0,9999,1
1713500943136,MATH 197,001,523477,Kedlaya; Kiran S.,9999,0,9999,0
1713500943136,MATH 197,002,563811,Zhang; Danna,9998,0,9999,1
1713500944162,MCWP 40R,A00,518780,Staff,14,0,20,6
1713500944162,MCWP 40R,B00,518781,Staff,11,0,20,9
1713500944162,MCWP 40R,C00,518783,Staff,9,0,20,11
1713500945188,MCWP 50R,A00,518791,Staff,7,0,20,13
1713500945188,MCWP 50R,B00,518792,Staff,3,0,20,17
1713500945188,MCWP 50R,C00,518793,Staff,6,0,20,14
1713500945188,MCWP 50R,D00,518794,Staff,0,0,20,20
1713500945188,MCWP 50R,E00,518795,Staff,0,0,20,20
1713500945188,MCWP 50R,F00,518796,Staff,11,0,20,9
1713500945188,MCWP 50R,G00,518797,Staff,10,0,20,10
1713500946216,MMW 12R,A01,514034,Herbst; Matthew,4,0,16,12
1713500946216,MMW 12R,A02,514035,Herbst; Matthew,13,0,16,3
1713500947240,MMW 13R,A01,514037,Staff,0,8,16,16
1713500947240,MMW 13R,A02,514039,Staff,0,7,16,16
1713500949293,SIO 295LS,A00,523233,Staff,15,0,30,15
1713500950319,SIO 295S,A00,523232,Staff,15,0,30,15
1713500951346,SOCI 117,A01,494376,Staff,0,2,5,5
1713500952371,WES 237B,A00,494380,Staff,19,0,20,1
1713500954446,AESE 279B,A00,494370,Wade; Jon P,33,0,33,0
1713500955475,AIP 197,001,627712,Vespa; Emanuel Ignacio,9999,0,9999,0
1713500956498,ANAR 135S,A00,494369,Braswell; Geoffrey E.,0,0,0,0
1713500957526,CAT 124RS,A01,519847,Geibel; William,6,0,20,14
1713500958551,CAT 125RS,A01,515971,Geibel; William,6,0,20,14
1713500959575,CLRE 250,A00,511389,Morris; Sheldon,9996,0,9999,3
1713500960600,CLRE 251,A00,507176,Mehta; Ravindra L.,9996,0,9999,3
1713500960600,CLRE 251,B00,511410,Mehta; Ravindra L.,9998,0,9999,1
1713500961626,CLRE 252,A00,507189,Cuomo; Raphael Eduardo,9998,0,9999,1
1713500962650,CLRE 253,A00,507199,Vaida; Florin,9997,0,9999,2
1713500962650,CLRE 253,B00,507202,Vaida; Florin,9999,0,9999,0
1713500963676,CLRE 259,A00,507211,Patel; Hemal,9996,0,9999,3
1713500964702,CLRE 260,A00,507221,Cuomo; Raphael Eduardo,9999,0,9999,0
1713500965730,CLRE 297,001,507242,Cuomo; Raphael Eduardo,9999,0,9999,0
1713500966754,CSE 191,A00,516875,Minnes Kemp; Mor Mia,9999,0,9999,0
1713500967779,CSS 201S,A01,494383,Staff,35,0,35,0
1713500968804,CSS 202S,A01,494387,Staff,35,0,35,0
1713500969828,EAP 100,A00,516065,Staff,9792,0,9999,207
1713500970856,ECE 45,A01,507414,Staff,37,0,60,23
1713500971882,ECE 100,A01,507416,Baghdadchi; Saharnaz,0,0,20,20
1713500971882,ECE 100,A02,507418,Baghdadchi; Saharnaz,19,0,20,1
1713500972909,ECE 111,A01,507420,Staff,27,0,50,23
1713500973933,ECE 197,001,548057,Sievenpiper; Daniel F.,9998,0,9999,1
1713500974959,EDS 115,A00,507243,Choi; Bailey Miyeon,27,0,28,1
1713500975985,EDS 117,A01,494379,Staff,15,0,25,10
1713500977013,EDS 125,A00,507246,Hopkins; Megan Beth,27,0,30,3
1713500978041,EDS 128A,A01,507264,Fargason; Sharon Gayle,26,0,26,0
1713500979067,EDS 128B,A01,507293,Pappas; Elizabeth,30,0,30,0
1713500980093,EDS 139,A00,507294,Fargason; Sharon Gayle,30,0,30,0
1713500980093,EDS 139,B00,507313,Pappas; Elizabeth,30,0,30,0
1713500981121,EDS 201,A00,507315,Staff,18,0,30,12
1713500982146,EDS 203,A01,507317,Halter; Christopher P.,17,0,30,13
1713500983173,EDS 204R,A01,507319,Halter; Christopher P.,0,1,30,30
1713500983173,EDS 204R,B01,507331,Heinzman; Erica M.,22,0,30,8
1713500984197,EDS 206R,A00,507332,Staff,0,2,30,30
1713500984197,EDS 206R,B00,507343,Staff,23,0,30,7
1713500985222,EDS 250,A00,507344,Hemans; Patricia Ann Benitez,27,0,40,13
1713500986249,EDS 281,A00,507345,Daly; Alan J.,18,0,18,0
1713500987275,EDS 284,A00,507350,Daly; Alan J.,16,0,16,0
1713500988301,EDS 286,A00,507359,Fine; Sarah,18,0,18,0
1713500989326,EDS 289C,A01,507361,Daly; Alan J.,18,0,18,0
1713500990352,EDS 290,A00,507366,Hofstetter; Carolyn,15,0,15,0
1713500991377,LIGM 5A,A00,507421,Fischer-Grunski; Eva K,20,0,20,0
1713500992401,LIGM 5B,A00,507423,Fischer-Grunski; Eva K,20,0,20,0
1713500993428,LIGM 5C,A00,507425,Fischer-Grunski; Eva K,20,0,20,0
1713500994510,LIIT 5AS,A00,507427,Carnelos; Chiara,20,0,20,0
1713500995536,LIIT 5BS,A00,507430,Carnelos; Chiara,20,0,20,0
1713500996562,LIIT 5CS,A00,507432,Carnelos; Chiara,20,0,20,0
1713500997590,LISP 5A,A00,507541,Munoz Sanchez; Alicia,14,0,20,6
1713500998618,LISP 5B,A00,507671,Munoz Sanchez; Alicia,12,0,20,8
1713500999648,LISP 5C,A00,507696,Munoz Sanchez; Alicia,11,0,20,9
1713501000672,MAE 197,001,528363,Boechler; Nicholas Sebastia,9998,0,9999,1
1713501001697,MATH 197,001,523477,Kedlaya; Kiran S.,9999,0,9999,0
1713501001697,MATH 197,002,563811,Zhang; Danna,9998,0,9999,1
1713501002724,MCWP 40R,A00,518780,Staff,14,0,20,6
1713501002724,MCWP 40R,B00,518781,Staff,11,0,20,9
1713501002724,MCWP 40R,C00,518783,Staff,8,0,20,12
1713501003751,MCWP 50R,A00,518791,Staff,7,0,20,13
1713501003751,MCWP 50R,B00,518792,Staff,3,0,20,17
1713501003751,MCWP 50R,C00,518793,Staff,5,0,20,15
1713501003751,MCWP 50R,D00,518794,Staff,0,0,20,20
1713501003751,MCWP 50R,E00,518795,Staff,0,0,20,20
1713501003751,MCWP 50R,F00,518796,Staff,11,0,20,9
1713501003751,MCWP 50R,G00,518797,Staff,10,0,20,10
1713501004775,MMW 12R,A01,514034,Herbst; Matthew,4,0,16,12
1713501004775,MMW 12R,A02,514035,Herbst; Matthew,13,0,16,3
1713501005799,MMW 13R,A01,514037,Staff,0,8,16,16
1713501005799,MMW 13R,A02,514039,Staff,0,7,16,16
1713501007851,SIO 295LS,A00,523233,Staff,15,0,30,15
1713501008876,SIO 295S,A00,523232,Staff,15,0,30,15
1713501009904,SOCI 117,A01,494376,Staff,0,2,5,5
1713501010934,WES 237B,A00,494380,Staff,19,0,20,1
1713501013004,AESE 279B,A00,494370,Wade; Jon P,33,0,33,0
1713501014030,AIP 197,001,627712,Vespa; Emanuel Ignacio,9999,0,9999,0
1713501015056,ANAR 135S,A00,494369,Braswell; Geoffrey E.,0,0,0,0
1713501016084,CAT 124RS,A01,519847,Geibel; William,6,0,20,14
1713501017108,CAT 125RS,A01,515971,Geibel; William,6,0,20,14
1713501018134,CLRE 250,A00,511389,Morris; Sheldon,9996,0,9999,3
1713501019160,CLRE 251,A00,507176,Mehta; Ravindra L.,9996,0,9999,3
1713501019160,CLRE 251,B00,511410,Mehta; Ravindra L.,9998,0,9999,1
1713501020189,CLRE 252,A00,507189,Cuomo; Raphael Eduardo,9998,0,9999,1
1713501021215,CLRE 253,A00,507199,Vaida; Florin,9997,0,9999,2
1713501021215,CLRE 253,B00,507202,Vaida; Florin,9999,0,9999,0
1713501022240,CLRE 259,A00,507211,Patel; Hemal,9996,0,9999,3
1713501023267,CLRE 260,A00,507221,Cuomo; Raphael Eduardo,9999,0,9999,0
1713501024295,CLRE 297,001,507242,Cuomo; Raphael Eduardo,9999,0,9999,0
1713501025317,CSE 191,A00,516875,Minnes Kemp; Mor Mia,9999,0,9999,0
1713501026347,CSS 201S,A01,494383,Staff,35,0,35,0
1713501027373,CSS 202S,A01,494387,Staff,35,0,35,0
1713501028398,EAP 100,A00,516065,Staff,9792,0,9999,207
1713501029427,ECE 45,A01,507414,Staff,37,0,60,23
1713501030453,ECE 100,A01,507416,Baghdadchi; Saharnaz,0,0,20,20
1713501030453,ECE 100,A02,507418,Baghdadchi; Saharnaz,19,0,20,1
1713501031484,ECE 111,A01,507420,Staff,27,0,50,23
1713501032509,ECE 197,001,548057,Sievenpiper; Daniel F.,9998,0,9999,1
1713501033536,EDS 115,A00,507243,Choi; Bailey Miyeon,27,0,28,1
1713501034561,EDS 117,A01,494379,Staff,15,0,25,10
1713501035586,EDS 125,A00,507246,Hopkins; Megan Beth,27,0,30,3
1713501036612,EDS 128A,A01,507264,Fargason; Sharon Gayle,26,0,26,0
1713501037636,EDS 128B,A01,507293,Pappas; Elizabeth,30,0,30,0
1713501038661,EDS 139,A00,507294,Fargason; Sharon Gayle,30,0,30,0
1713501038661,EDS 139,B00,507313,Pappas; Elizabeth,30,0,30,0
1713501039694,EDS 201,A00,507315,Staff,18,0,30,12
1713501040723,EDS 203,A01,507317,Halter; Christopher P.,17,0,30,13
1713501041753,EDS 204R,A01,507319,Halter; Christopher P.,0,1,30,30
1713501041753,EDS 204R,B01,507331,Heinzman; Erica M.,22,0,30,8
1713501042778,EDS 206R,A00,507332,Staff,0,2,30,30
1713501042778,EDS 206R,B00,507343,Staff,23,0,30,7
1713501043808,EDS 250,A00,507344,Hemans; Patricia Ann Benitez,27,0,40,13
1713501044834,EDS 281,A00,507345,Daly; Alan J.,18,0,18,0
1713501045859,EDS 284,A00,507350,Daly; Alan J.,16,0,16,0
1713501046884,EDS 286,A00,507359,Fine; Sarah,18,0,18,0
1713501047915,EDS 289C,A01,507361,Daly; Alan J.,18,0,18,0
1713501048944,EDS 290,A00,507366,Hofstetter; Carolyn,15,0,15,0
1713501049970,LIGM 5A,A00,507421,Fischer-Grunski; Eva K,20,0,20,0
1713501050996,LIGM 5B,A00,507423,Fischer-Grunski; Eva K,20,0,20,0
1713501052023,LIGM 5C,A00,507425,Fischer-Grunski; Eva K,20,0,20,0
1713501053054,LIIT 5AS,A00,507427,Carnelos; Chiara,20,0,20,0
1713501054083,LIIT 5BS,A00,507430,Carnelos; Chiara,20,0,20,0
1713501055110,LIIT 5CS,A00,507432,Carnelos; Chiara,20,0,20,0
1713501056140,LISP 5A,A00,507541,Munoz Sanchez; Alicia,14,0,20,6
1713501057167,LISP 5B,A00,507671,Munoz Sanchez; Alicia,12,0,20,8
1713501058195,LISP 5C,A00,507696,Munoz Sanchez; Alicia,11,0,20,9
1713501059220,MAE 197,001,528363,Boechler; Nicholas Sebastia,9998,0,9999,1
1713501060247,MATH 197,001,523477,Kedlaya; Kiran S.,9999,0,9999,0
1713501060247,MATH 197,002,563811,Zhang; Danna,9998,0,9999,1
1713501061273,MCWP 40R,A00,518780,Staff,14,0,20,6
1713501061273,MCWP 40R,B00,518781,Staff,11,0,20,9
1713501061273,MCWP 40R,C00,518783,Staff,8,0,20,12
1713501062300,MCWP 50R,A00,518791,Staff,7,0,20,13
1713501062300,MCWP 50R,B00,518792,Staff,3,0,20,17
1713501062300,MCWP 50R,C00,518793,Staff,5,0,20,15
1713501062300,MCWP 50R,D00,518794,Staff,0,0,20,20
1713501062300,MCWP 50R,E00,518795,Staff,0,0,20,20
1713501062300,MCWP 50R,F00,518796,Staff,11,0,20,9
1713501062300,MCWP 50R,G00,518797,Staff,10,0,20,10
1713501063326,MMW 12R,A01,514034,Herbst; Matthew,4,0,16,12
1713501063326,MMW 12R,A02,514035,Herbst; Matthew,13,0,16,3
1713501064356,MMW 13R,A01,514037,Staff,0,8,16,16
1713501064356,MMW 13R,A02,514039,Staff,0,7,16,16
1713501066412,SIO 295LS,A00,523233,Staff,15,0,30,15
1713501067439,SIO 295S,A00,523232,Staff,15,0,30,15
1713501068469,SOCI 117,A01,494376,Staff,0,2,5,5
1713501069495,WES 237B,A00,494380,Staff,19,0,20,1
1713501071557,AESE 279B,A00,494370,Wade; Jon P,33,0,33,0
1713501072581,AIP 197,001,627712,Vespa; Emanuel Ignacio,9999,0,9999,0
1713501073607,ANAR 135S,A00,494369,Braswell; Geoffrey E.,0,0,0,0
1713501074632,CAT 124RS,A01,519847,Geibel; William,6,0,20,14
1713501075658,CAT 125RS,A01,515971,Geibel; William,6,0,20,14
1713501076682,CLRE 250,A00,511389,Morris; Sheldon,9996,0,9999,3
1713501077708,CLRE 251,A00,507176,Mehta; Ravindra L.,9996,0,9999,3
1713501077708,CLRE 251,B00,511410,Mehta; Ravindra L.,9998,0,9999,1
1713501078738,CLRE 252,A00,507189,Cuomo; Raphael Eduardo,9998,0,9999,1
1713501079764,CLRE 253,A00,507199,Vaida; Florin,9997,0,9999,2
1713501079764,CLRE 253,B00,507202,Vaida; Florin,9999,0,9999,0
1713501080792,CLRE 259,A00,507211,Patel; Hemal,9996,0,9999,3
1713501081818,CLRE 260,A00,507221,Cuomo; Raphael Eduardo,9999,0,9999,0
1713501082847,CLRE 297,001,507242,Cuomo; Raphael Eduardo,9999,0,9999,0
1713501083876,CSE 191,A00,516875,Minnes Kemp; Mor Mia,9999,0,9999,0
1713501084906,CSS 201S,A01,494383,Staff,35,0,35,0
1713501085932,CSS 202S,A01,494387,Staff,35,0,35,0
1713501086957,EAP 100,A00,516065,Staff,9792,0,9999,207
1713501087983,ECE 45,A01,507414,Staff,37,0,60,23
1713501089012,ECE 100,A01,507416,Baghdadchi; Saharnaz,0,0,20,20
1713501089012,ECE 100,A02,507418,Baghdadchi; Saharnaz,19,0,20,1
1713501090038,ECE 111,A01,507420,Staff,27,0,50,23
1713501091063,ECE 197,001,548057,Sievenpiper; Daniel F.,9998,0,9999,1
1713501092092,EDS 115,A00,507243,Choi; Bailey Miyeon,27,0,28,1
1713501093118,EDS 117,A01,494379,Staff,15,0,25,10
1713501094144,EDS 125,A00,507246,Hopkins; Megan Beth,27,0,30,3
1713501095169,EDS 128A,A01,507264,Fargason; Sharon Gayle,26,0,26,0
1713501096194,EDS 128B,A01,507293,Pappas; Elizabeth,30,0,30,0
1713501097223,EDS 139,A00,507294,Fargason; Sharon Gayle,30,0,30,0
1713501097223,EDS 139,B00,507313,Pappas; Elizabeth,30,0,30,0
1713501098591,EDS 201,A00,507315,Staff,18,0,30,12
1713501099621,EDS 203,A01,507317,Halter; Christopher P.,17,0,30,13
1713501100649,EDS 204R,A01,507319,Halter; Christopher P.,0,1,30,30
1713501100649,EDS 204R,B01,507331,Heinzman; Erica M.,22,0,30,8
1713501101679,EDS 206R,A00,507332,Staff,0,2,30,30
1713501101679,EDS 206R,B00,507343,Staff,23,0,30,7
1713501102705,EDS 250,A00,507344,Hemans; Patricia Ann Benitez,27,0,40,13
1713501103730,EDS 281,A00,507345,Daly; Alan J.,18,0,18,0
1713501104755,EDS 284,A00,507350,Daly; Alan J.,16,0,16,0
1713501105783,EDS 286,A00,507359,Fine; Sarah,18,0,18,0
1713501106809,EDS 289C,A01,507361,Daly; Alan J.,18,0,18,0
1713501107838,EDS 290,A00,507366,Hofstetter; Carolyn,15,0,15,0
1713501108867,LIGM 5A,A00,507421,Fischer-Grunski; Eva K,20,0,20,0
1713501109892,LIGM 5B,A00,507423,Fischer-Grunski; Eva K,20,0,20,0
1713501110922,LIGM 5C,A00,507425,Fischer-Grunski; Eva K,20,0,20,0
1713501111950,LIIT 5AS,A00,507427,Carnelos; Chiara,20,0,20,0
1713501112978,LIIT 5BS,A00,507430,Carnelos; Chiara,20,0,20,0
1713501114008,LIIT 5CS,A00,507432,Carnelos; Chiara,20,0,20,0
1713501115034,LISP 5A,A00,507541,Munoz Sanchez; Alicia,14,0,20,6
1713501116061,LISP 5B,A00,507671,Munoz Sanchez; Alicia,12,0,20,8
1713501117090,LISP 5C,A00,507696,Munoz Sanchez; Alicia,11,0,20,9
1713501118116,MAE 197,001,528363,Boechler; Nicholas Sebastia,9998,0,9999,1
1713501119142,MATH 197,001,523477,Kedlaya; Kiran S.,9999,0,9999,0
1713501119142,MATH 197,002,563811,Zhang; Danna,9998,0,9999,1
1713501120168,MCWP 40R,A00,518780,Staff,14,0,20,6
1713501120168,MCWP 40R,B00,518781,Staff,11,0,20,9
1713501120168,MCWP 40R,C00,518783,Staff,8,0,20,12
1713501121194,MCWP 50R,A00,518791,Staff,7,0,20,13
1713501121194,MCWP 50R,B00,518792,Staff,3,0,20,17
1713501121194,MCWP 50R,C00,518793,Staff,5,0,20,15
1713501121194,MCWP 50R,D00,518794,Staff,0,0,20,20
1713501121194,MCWP 50R,E00,518795,Staff,0,0,20,20
1713501121194,MCWP 50R,F00,518796,Staff,11,0,20,9
1713501121194,MCWP 50R,G00,518797,Staff,10,0,20,10
1713501122220,MMW 12R,A01,514034,Herbst; Matthew,4,0,16,12
1713501122220,MMW 12R,A02,514035,Herbst; Matthew,13,0,16,3
1713501123250,MMW 13R,A01,514037,Staff,0,8,16,16
1713501123250,MMW 13R,A02,514039,Staff,0,7,16,16
1713501125309,SIO 295LS,A00,523233,Staff,15,0,30,15
1713501126338,SIO 295S,A00,523232,Staff,15,0,30,15
1713501127362,SOCI 117,A01,494376,Staff,0,2,5,5
1713501128388,WES 237B,A00,494380,Staff,19,0,20,1
1713501130463,AESE 279B,A00,494370,Wade; Jon P,33,0,33,0
1713501131490,AIP 197,001,627712,Vespa; Emanuel Ignacio,9999,0,9999,0
1713501132518,ANAR 135S,A00,494369,Braswell; Geoffrey E.,0,0,0,0
1713501133544,CAT 124RS,A01,519847,Geibel; William,6,0,20,14
1713501134573,CAT 125RS,A01,515971,Geibel; William,6,0,20,14
1713501135602,CLRE 250,A00,511389,Morris; Sheldon,9996,0,9999,3
1713501136632,CLRE 251,A00,507176,Mehta; Ravindra L.,9996,0,9999,3
1713501136632,CLRE 251,B00,511410,Mehta; Ravindra L.,9998,0,9999,1
1713501137659,CLRE 252,A00,507189,Cuomo; Raphael Eduardo,9998,0,9999,1
1713501138688,CLRE 253,A00,507199,Vaida; Florin,9997,0,9999,2
1713501138688,CLRE 253,B00,507202,Vaida; Florin,9999,0,9999,0
1713501139716,CLRE 259,A00,507211,Patel; Hemal,9996,0,9999,3
1713501140742,CLRE 260,A00,507221,Cuomo; Raphael Eduardo,9999,0,9999,0
1713501141771,CLRE 297,001,507242,Cuomo; Raphael Eduardo,9999,0,9999,0
1713501142796,CSE 191,A00,516875,Minnes Kemp; Mor Mia,9999,0,9999,0
1713501143824,CSS 201S,A01,494383,Staff,35,0,35,0
1713501144850,CSS 202S,A01,494387,Staff,35,0,35,0
1713501145875,EAP 100,A00,516065,Staff,9792,0,9999,207
1713501146904,ECE 45,A01,507414,Staff,37,0,60,23
1713501147934,ECE 100,A01,507416,Baghdadchi; Saharnaz,0,0,20,20
1713501147934,ECE 100,A02,507418,Baghdadchi; Saharnaz,19,0,20,1
1713501148963,ECE 111,A01,507420,Staff,27,0,50,23
1713501149988,ECE 197,001,548057,Sievenpiper; Daniel F.,9998,0,9999,1
1713501151013,EDS 115,A00,507243,Choi; Bailey Miyeon,27,0,28,1
1713501152037,EDS 117,A01,494379,Staff,15,0,25,10
1713501153062,EDS 125,A00,507246,Hopkins; Megan Beth,27,0,30,3
1713501154086,EDS 128A,A01,507264,Fargason; Sharon Gayle,26,0,26,0
1713501155111,EDS 128B,A01,507293,Pappas; Elizabeth,30,0,30,0
1713501156137,EDS 139,A00,507294,Fargason; Sharon Gayle,30,0,30,0
1713501156137,EDS 139,B00,507313,Pappas; Elizabeth,30,0,30,0
1713501157162,EDS 201,A00,507315,Staff,18,0,30,12
1713501158191,EDS 203,A01,507317,Halter; Christopher P.,17,0,30,13
1713501159219,EDS 204R,A01,507319,Halter; Christopher P.,0,1,30,30
1713501159219,EDS 204R,B01,507331,Heinzman; Erica M.,22,0,30,8
1713501160243,EDS 206R,A00,507332,Staff,0,2,30,30
1713501160243,EDS 206R,B00,507343,Staff,23,0,30,7
1713501161267,EDS 250,A00,507344,Hemans; Patricia Ann Benitez,27,0,40,13
1713501162292,EDS 281,A00,507345,Daly; Alan J.,18,0,18,0
1713501163320,EDS 284,A00,507350,Daly; Alan J.,16,0,16,0
1713501164349,EDS 286,A00,507359,Fine; Sarah,18,0,18,0
1713501165375,EDS 289C,A01,507361,Daly; Alan J.,18,0,18,0
1713501166400,EDS 290,A00,507366,Hofstetter; Carolyn,15,0,15,0
1713501167426,LIGM 5A,A00,507421,Fischer-Grunski; Eva K,20,0,20,0
1713501168450,LIGM 5B,A00,507423,Fischer-Grunski; Eva K,20,0,20,0
1713501169474,LIGM 5C,A00,507425,Fischer-Grunski; Eva K,20,0,20,0
1713501170505,LIIT 5AS,A00,507427,Carnelos; Chiara,20,0,20,0
1713501171532,LIIT 5BS,A00,507430,Carnelos; Chiara,20,0,20,0
1713501172560,LIIT 5CS,A00,507432,Carnelos; Chiara,20,0,20,0
1713501173586,LISP 5A,A00,507541,Munoz Sanchez; Alicia,14,0,20,6
1713501174616,LISP 5B,A00,507671,Munoz Sanchez; Alicia,12,0,20,8
1713501175642,LISP 5C,A00,507696,Munoz Sanchez; Alicia,11,0,20,9
1713501176666,MAE 197,001,528363,Boechler; Nicholas Sebastia,9998,0,9999,1
1713501177691,MATH 197,001,523477,Kedlaya; Kiran S.,9999,0,9999,0
1713501177691,MATH 197,002,563811,Zhang; Danna,9998,0,9999,1
1713501178717,MCWP 40R,A00,518780,Staff,14,0,20,6
1713501178717,MCWP 40R,B00,518781,Staff,11,0,20,9
1713501178717,MCWP 40R,C00,518783,Staff,8,0,20,12
1713501179743,MCWP 50R,A00,518791,Staff,7,0,20,13
1713501179743,MCWP 50R,B00,518792,Staff,3,0,20,17
1713501179743,MCWP 50R,C00,518793,Staff,5,0,20,15
1713501179743,MCWP 50R,D00,518794,Staff,0,0,20,20
1713501179743,MCWP 50R,E00,518795,Staff,0,0,20,20
1713501179743,MCWP 50R,F00,518796,Staff,11,0,20,9
1713501179743,MCWP 50R,G00,518797,Staff,10,0,20,10
1713501180771,MMW 12R,A01,514034,Herbst; Matthew,4,0,16,12
1713501180771,MMW 12R,A02,514035,Herbst; Matthew,13,0,16,3
1713501181799,MMW 13R,A01,514037,Staff,0,8,16,16
1713501181799,MMW 13R,A02,514039,Staff,0,7,16,16
1713501183864,SIO 295LS,A00,523233,Staff,15,0,30,15
1713501184891,SIO 295S,A00,523232,Staff,15,0,30,15
1713501185921,SOCI 117,A01,494376,Staff,0,2,5,5
1713501186946,WES 237B,A00,494380,Staff,19,0,20,1
1713501189007,AESE 279B,A00,494370,Wade; Jon P,33,0,33,0
1713501190032,AIP 197,001,627712,Vespa; Emanuel Ignacio,9999,0,9999,0
1713501191057,ANAR 135S,A00,494369,Braswell; Geoffrey E.,0,0,0,0
1713501192082,CAT 124RS,A01,519847,Geibel; William,6,0,20,14
1713501193108,CAT 125RS,A01,515971,Geibel; William,6,0,20,14
1713501194137,CLRE 250,A00,511389,Morris; Sheldon,9996,0,9999,3
1713501195163,CLRE 251,A00,507176,Mehta; Ravindra L.,9996,0,9999,3
1713501195163,CLRE 251,B00,511410,Mehta; Ravindra L.,9998,0,9999,1
1713501196189,CLRE 252,A00,507189,Cuomo; Raphael Eduardo,9998,0,9999,1
1713501197215,CLRE 253,A00,507199,Vaida; Florin,9997,0,9999,2
1713501197215,CLRE 253,B00,507202,Vaida; Florin,9999,0,9999,0
1713501198244,CLRE 259,A00,507211,Patel; Hemal,9996,0,9999,3
1713501199272,CLRE 260,A00,507221,Cuomo; Raphael Eduardo,9999,0,9999,0
1713501200298,CLRE 297,001,507242,Cuomo; Raphael Eduardo,9999,0,9999,0
1713501201327,CSE 191,A00,516875,Minnes Kemp; Mor Mia,9999,0,9999,0
1713501202410,CSS 201S,A01,494383,Staff,35,0,35,0
1713501203436,CSS 202S,A01,494387,Staff,35,0,35,0
1713501204466,EAP 100,A00,516065,Staff,9792,0,9999,207
1713501205491,ECE 45,A01,507414,Staff,37,0,60,23
1713501206521,ECE 100,A01,507416,Baghdadchi; Saharnaz,0,0,20,20
1713501206521,ECE 100,A02,507418,Baghdadchi; Saharnaz,19,0,20,1
1713501207545,ECE 111,A01,507420,Staff,27,0,50,23
1713501208570,ECE 197,001,548057,Sievenpiper; Daniel F.,9998,0,9999,1
1713501209595,EDS 115,A00,507243,Choi; Bailey Miyeon,27,0,28,1
1713501210622,EDS 117,A01,494379,Staff,15,0,25,10
1713501211651,EDS 125,A00,507246,Hopkins; Megan Beth,27,0,30,3
1713501212680,EDS 128A,A01,507264,Fargason; Sharon Gayle,26,0,26,0
1713501213707,EDS 128B,A01,507293,Pappas; Elizabeth,30,0,30,0
1713501214731,EDS 139,A00,507294,Fargason; Sharon Gayle,30,0,30,0
1713501214731,EDS 139,B00,507313,Pappas; Elizabeth,30,0,30,0
1713501215757,EDS 201,A00,507315,Staff,18,0,30,12
1713501216786,EDS 203,A01,507317,Halter; Christopher P.,17,0,30,13
1713501217811,EDS 204R,A01,507319,Halter; Christopher P.,0,1,30,30
1713501217811,EDS 204R,B01,507331,Heinzman; Erica M.,22,0,30,8
1713501218840,EDS 206R,A00,507332,Staff,0,2,30,30
1713501218840,EDS 206R,B00,507343,Staff,23,0,30,7
1713501219866,EDS 250,A00,507344,Hemans; Patricia Ann Benitez,27,0,40,13
1713501220894,EDS 281,A00,507345,Daly; Alan J.,18,0,18,0
1713501221919,EDS 284,A00,507350,Daly; Alan J.,16,0,16,0
1713501222945,EDS 286,A00,507359,Fine; Sarah,18,0,18,0
1713501223970,EDS 289C,A01,507361,Daly; Alan J.,18,0,18,0
1713501224996,EDS 290,A00,507366,Hofstetter; Carolyn,15,0,15,0
1713501226022,LIGM 5A,A00,507421,Fischer-Grunski; Eva K,20,0,20,0
1713501227050,LIGM 5B,A00,507423,Fischer-Grunski; Eva K,20,0,20,0
1713501228080,LIGM 5C,A00,507425,Fischer-Grunski; Eva K,20,0,20,0
1713501229107,LIIT 5AS,A00,507427,Carnelos; Chiara,20,0,20,0
1713501230137,LIIT 5BS,A00,507430,Carnelos; Chiara,20,0,20,0
1713501231167,LIIT 5CS,A00,507432,Carnelos; Chiara,20,0,20,0
1713501232193,LISP 5A,A00,507541,Munoz Sanchez; Alicia,14,0,20,6
1713501233223,LISP 5B,A00,507671,Munoz Sanchez; Alicia,12,0,20,8
1713501234251,LISP 5C,A00,507696,Munoz Sanchez; Alicia,11,0,20,9
1713501235275,MAE 197,001,528363,Boechler; Nicholas Sebastia,9998,0,9999,1
1713501236306,MATH 197,001,523477,Kedlaya; Kiran S.,9999,0,9999,0
1713501236306,MATH 197,002,563811,Zhang; Danna,9998,0,9999,1
1713501237331,MCWP 40R,A00,518780,Staff,14,0,20,6
1713501237331,MCWP 40R,B00,518781,Staff,11,0,20,9
1713501237331,MCWP 40R,C00,518783,Staff,8,0,20,12
1713501238357,MCWP 50R,A00,518791,Staff,7,0,20,13
1713501238357,MCWP 50R,B00,518792,Staff,3,0,20,17
1713501238357,MCWP 50R,C00,518793,Staff,5,0,20,15
1713501238357,MCWP 50R,D00,518794,Staff,0,0,20,20
1713501238357,MCWP 50R,E00,518795,Staff,0,0,20,20
1713501238357,MCWP 50R,F00,518796,Staff,11,0,20,9
1713501238357,MCWP 50R,G00,518797,Staff,10,0,20,10
1713501239386,MMW 12R,A01,514034,Herbst; Matthew,4,0,16,12
1713501239386,MMW 12R,A02,514035,Herbst; Matthew,13,0,16,3
1713501240413,MMW 13R,A01,514037,Staff,0,8,16,16
1713501240413,MMW 13R,A02,514039,Staff,0,7,16,16
1713501242469,SIO 295LS,A00,523233,Staff,15,0,30,15
1713501243499,SIO 295S,A00,523232,Staff,15,0,30,15
1713501244523,SOCI 117,A01,494376,Staff,0,2,5,5
1713501245548,WES 237B,A00,494380,Staff,19,0,20,1
1713501247615,AESE 279B,A00,494370,Wade; Jon P,33,0,33,0
1713501248641,AIP 197,001,627712,Vespa; Emanuel Ignacio,9999,0,9999,0
1713501249669,ANAR 135S,A00,494369,Braswell; Geoffrey E.,0,0,0,0
1713501250693,CAT 124RS,A01,519847,Geibel; William,6,0,20,14
1713501251717,CAT 125RS,A01,515971,Geibel; William,6,0,20,14
1713501252746,CLRE 250,A00,511389,Morris; Sheldon,9996,0,9999,3
1713501253773,CLRE 251,A00,507176,Mehta; Ravindra L.,9996,0,9999,3
1713501253773,CLRE 251,B00,511410,Mehta; Ravindra L.,9998,0,9999,1
1713501254796,CLRE 252,A00,507189,Cuomo; Raphael Eduardo,9998,0,9999,1
1713501255826,CLRE 253,A00,507199,Vaida; Florin,9997,0,9999,2
1713501255826,CLRE 253,B00,507202,Vaida; Florin,9999,0,9999,0
1713501256855,CLRE 259,A00,507211,Patel; Hemal,9996,0,9999,3
1713501257884,CLRE 260,A00,507221,Cuomo; Raphael Eduardo,9999,0,9999,0
1713501258910,CLRE 297,001,507242,Cuomo; Raphael Eduardo,9999,0,9999,0
1713501259936,CSE 191,A00,516875,Minnes Kemp; Mor Mia,9999,0,9999,0
1713501260965,CSS 201S,A01,494383,Staff,35,0,35,0
1713501261990,CSS 202S,A01,494387,Staff,35,0,35,0
1713501263016,EAP 100,A00,516065,Staff,9792,0,9999,207
1713501264045,ECE 45,A01,507414,Staff,37,0,60,23
1713501265075,ECE 100,A01,507416,Baghdadchi; Saharnaz,0,0,20,20
1713501265075,ECE 100,A02,507418,Baghdadchi; Saharnaz,19,0,20,1
1713501266100,ECE 111,A01,507420,Staff,27,0,50,23
1713501267125,ECE 197,001,548057,Sievenpiper; Daniel F.,9998,0,9999,1
1713501268151,EDS 115,A00,507243,Choi; Bailey Miyeon,27,0,28,1
1713501269177,EDS 117,A01,494379,Staff,15,0,25,10
1713501270203,EDS 125,A00,507246,Hopkins; Megan Beth,27,0,30,3
1713501271228,EDS 128A,A01,507264,Fargason; Sharon Gayle,26,0,26,0
1713501272254,EDS 128B,A01,507293,Pappas; Elizabeth,30,0,30,0
1713501273281,EDS 139,A00,507294,Fargason; Sharon Gayle,30,0,30,0
1713501273281,EDS 139,B00,507313,Pappas; Elizabeth,30,0,30,0
1713501274310,EDS 201,A00,507315,Staff,18,0,30,12
1713501275336,EDS 203,A01,507317,Halter; Christopher P.,17,0,30,13
1713501276362,EDS 204R,A01,507319,Halter; Christopher P.,0,1,30,30
1713501276362,EDS 204R,B01,507331,Heinzman; Erica M.,22,0,30,8
1713501277390,EDS 206R,A00,507332,Staff,0,2,30,30
1713501277390,EDS 206R,B00,507343,Staff,23,0,30,7
1713501278414,EDS 250,A00,507344,Hemans; Patricia Ann Benitez,27,0,40,13
1713501279439,EDS 281,A00,507345,Daly; Alan J.,18,0,18,0
1713501280464,EDS 284,A00,507350,Daly; Alan J.,16,0,16,0
1713501281490,EDS 286,A00,507359,Fine; Sarah,18,0,18,0
1713501282515,EDS 289C,A01,507361,Daly; Alan J.,18,0,18,0
1713501283541,EDS 290,A00,507366,Hofstetter; Carolyn,15,0,15,0
1713501284566,LIGM 5A,A00,507421,Fischer-Grunski; Eva K,20,0,20,0
1713501285597,LIGM 5B,A00,507423,Fischer-Grunski; Eva K,20,0,20,0
1713501286623,LIGM 5C,A00,507425,Fischer-Grunski; Eva K,20,0,20,0
1713501287650,LIIT 5AS,A00,507427,Carnelos; Chiara,20,0,20,0
1713501288676,LIIT 5BS,A00,507430,Carnelos; Chiara,20,0,20,0
1713501289700,LIIT 5CS,A00,507432,Carnelos; Chiara,20,0,20,0
1713501290726,LISP 5A,A00,507541,Munoz Sanchez; Alicia,14,0,20,6
1713501291752,LISP 5B,A00,507671,Munoz Sanchez; Alicia,12,0,20,8
1713501292782,LISP 5C,A00,507696,Munoz Sanchez; Alicia,11,0,20,9
1713501293808,MAE 197,001,528363,Boechler; Nicholas Sebastia,9998,0,9999,1
1713501294837,MATH 197,001,523477,Kedlaya; Kiran S.,9999,0,9999,0
1713501294837,MATH 197,002,563811,Zhang; Danna,9998,0,9999,1
1713501295866,MCWP 40R,A00,518780,Staff,14,0,20,6
1713501295866,MCWP 40R,B00,518781,Staff,11,0,20,9
1713501295866,MCWP 40R,C00,518783,Staff,8,0,20,12
1713501296893,MCWP 50R,A00,518791,Staff,7,0,20,13
1713501296893,MCWP 50R,B00,518792,Staff,3,0,20,17
1713501296893,MCWP 50R,C00,518793,Staff,5,0,20,15
1713501296893,MCWP 50R,D00,518794,Staff,0,0,20,20
1713501296893,MCWP 50R,E00,518795,Staff,0,0,20,20
1713501296893,MCWP 50R,F00,518796,Staff,11,0,20,9
1713501296893,MCWP 50R,G00,518797,Staff,10,0,20,10
1713501297919,MMW 12R,A01,514034,Herbst; Matthew,4,0,16,12
1713501297919,MMW 12R,A02,514035,Herbst; Matthew,13,0,16,3
1713501298944,MMW 13R,A01,514037,Staff,0,8,16,16
1713501298944,MMW 13R,A02,514039,Staff,0,7,16,16
1713501300994,SIO 295LS,A00,523233,Staff,15,0,30,15
1713501302024,SIO 295S,A00,523232,Staff,15,0,30,15
1713501303049,SOCI 117,A01,494376,Staff,0,2,5,5
1713501304075,WES 237B,A00,494380,Staff,19,0,20,1
1713501306196,AESE 279B,A00,494370,Wade; Jon P,33,0,33,0
1713501307225,AIP 197,001,627712,Vespa; Emanuel Ignacio,9999,0,9999,0
1713501308250,ANAR 135S,A00,494369,Braswell; Geoffrey E.,0,0,0,0
1713501309279,CAT 124RS,A01,519847,Geibel; William,6,0,20,14
1713501310307,CAT 125RS,A01,515971,Geibel; William,6,0,20,14
1713501311336,CLRE 250,A00,511389,Morris; Sheldon,9996,0,9999,3
1713501312361,CLRE 251,A00,507176,Mehta; Ravindra L.,9996,0,9999,3
1713501312361,CLRE 251,B00,511410,Mehta; Ravindra L.,9998,0,9999,1
1713501313384,CLRE 252,A00,507189,Cuomo; Raphael Eduardo,9998,0,9999,1
1713501314410,CLRE 253,A00,507199,Vaida; Florin,9997,0,9999,2
1713501314410,CLRE 253,B00,507202,Vaida; Florin,9999,0,9999,0
1713501315441,CLRE 259,A00,507211,Patel; Hemal,9996,0,9999,3
1713501316466,CLRE 260,A00,507221,Cuomo; Raphael Eduardo,9999,0,9999,0
1713501317494,CLRE 297,001,507242,Cuomo; Raphael Eduardo,9999,0,9999,0
1713501318520,CSE 191,A00,516875,Minnes Kemp; Mor Mia,9999,0,9999,0
1713501319549,CSS 201S,A01,494383,Staff,35,0,35,0
1713501320574,CSS 202S,A01,494387,Staff,35,0,35,0
1713501321600,EAP 100,A00,516065,Staff,9792,0,9999,207
1713501322625,ECE 45,A01,507414,Staff,37,0,60,23
1713501323651,ECE 100,A01,507416,Baghdadchi; Saharnaz,0,0,20,20
1713501323651,ECE 100,A02,507418,Baghdadchi; Saharnaz,19,0,20,1
1713501324676,ECE 111,A01,507420,Staff,27,0,50,23
1713501325700,ECE 197,001,548057,Sievenpiper; Daniel F.,9998,0,9999,1
1713501326728,EDS 115,A00,507243,Choi; Bailey Miyeon,27,0,28,1
1713501327756,EDS 117,A01,494379,Staff,15,0,25,10
1713501328783,EDS 125,A00,507246,Hopkins; Megan Beth,27,0,30,3
1713501329812,EDS 128A,A01,507264,Fargason; Sharon Gayle,26,0,26,0
1713501330842,EDS 128B,A01,507293,Pappas; Elizabeth,30,0,30,0
1713501331867,EDS 139,A00,507294,Fargason; Sharon Gayle,30,0,30,0
1713501331867,EDS 139,B00,507313,Pappas; Elizabeth,30,0,30,0
1713501332893,EDS 201,A00,507315,Staff,18,0,30,12
1713501333919,EDS 203,A01,507317,Halter; Christopher P.,17,0,30,13
1713501334949,EDS 204R,A01,507319,Halter; Christopher P.,0,1,30,30
1713501334949,EDS 204R,B01,507331,Heinzman; Erica M.,22,0,30,8
1713501335978,EDS 206R,A00,507332,Staff,0,2,30,30
1713501335978,EDS 206R,B00,507343,Staff,23,0,30,7
1713501337005,EDS 250,A00,507344,Hemans; Patricia Ann Benitez,27,0,40,13
1713501338030,EDS 281,A00,507345,Daly; Alan J.,18,0,18,0
1713501339055,EDS 284,A00,507350,Daly; Alan J.,16,0,16,0
1713501340084,EDS 286,A00,507359,Fine; Sarah,18,0,18,0
1713501341110,EDS 289C,A01,507361,Daly; Alan J.,18,0,18,0
1713501342136,EDS 290,A00,507366,Hofstetter; Carolyn,15,0,15,0
1713501343162,LIGM 5A,A00,507421,Fischer-Grunski; Eva K,20,0,20,0
1713501344192,LIGM 5B,A00,507423,Fischer-Grunski; Eva K,20,0,20,0
1713501345273,LIGM 5C,A00,507425,Fischer-Grunski; Eva K,20,0,20,0
1713501346300,LIIT 5AS,A00,507427,Carnelos; Chiara,20,0,20,0
1713501347328,LIIT 5BS,A00,507430,Carnelos; Chiara,20,0,20,0
1713501348354,LIIT 5CS,A00,507432,Carnelos; Chiara,20,0,20,0
1713501349379,LISP 5A,A00,507541,Munoz Sanchez; Alicia,14,0,20,6
1713501350406,LISP 5B,A00,507671,Munoz Sanchez; Alicia,12,0,20,8
1713501351432,LISP 5C,A00,507696,Munoz Sanchez; Alicia,11,0,20,9
1713501352457,MAE 197,001,528363,Boechler; Nicholas Sebastia,9998,0,9999,1
1713501353486,MATH 197,001,523477,Kedlaya; Kiran S.,9999,0,9999,0
1713501353486,MATH 197,002,563811,Zhang; Danna,9998,0,9999,1
1713501354515,MCWP 40R,A00,518780,Staff,14,0,20,6
1713501354515,MCWP 40R,B00,518781,Staff,11,0,20,9
1713501354515,MCWP 40R,C00,518783,Staff,8,0,20,12
1713501355545,MCWP 50R,A00,518791,Staff,7,0,20,13
1713501355545,MCWP 50R,B00,518792,Staff,3,0,20,17
1713501355545,MCWP 50R,C00,518793,Staff,5,0,20,15
1713501355545,MCWP 50R,D00,518794,Staff,0,0,20,20
1713501355545,MCWP 50R,E00,518795,Staff,0,0,20,20
1713501355545,MCWP 50R,F00,518796,Staff,11,0,20,9
1713501355545,MCWP 50R,G00,518797,Staff,10,0,20,10
1713501356571,MMW 12R,A01,514034,Herbst; Matthew,4,0,16,12
1713501356571,MMW 12R,A02,514035,Herbst; Matthew,13,0,16,3
1713501357600,MMW 13R,A01,514037,Staff,0,8,16,16
1713501357600,MMW 13R,A02,514039,Staff,0,7,16,16
1713501359656,SIO 295LS,A00,523233,Staff,15,0,30,15
1713501360684,SIO 295S,A00,523232,Staff,15,0,30,15
1713501361714,SOCI 117,A01,494376,Staff,0,2,5,5
1713501362740,WES 237B,A00,494380,Staff,19,0,20,1
1713501364810,AESE 279B,A00,494370,Wade; Jon P,33,0,33,0
1713501365836,AIP 197,001,627712,Vespa; Emanuel Ignacio,9999,0,9999,0
1713501366866,ANAR 135S,A00,494369,Braswell; Geoffrey E.,0,0,0,0
1713501367891,CAT 124RS,A01,519847,Geibel; William,6,0,20,14
1713501368915,CAT 125RS,A01,515971,Geibel; William,6,0,20,14
1713501369940,CLRE 250,A00,511389,Morris; Sheldon,9996,0,9999,3
1713501370970,CLRE 251,A00,507176,Mehta; Ravindra L.,9996,0,9999,3
1713501370970,CLRE 251,B00,511410,Mehta; Ravindra L.,9998,0,9999,1
1713501372000,CLRE 252,A00,507189,Cuomo; Raphael Eduardo,9998,0,9999,1
1713501373025,CLRE 253,A00,507199,Vaida; Florin,9997,0,9999,2
1713501373025,CLRE 253,B00,507202,Vaida; Florin,9999,0,9999,0
1713501374055,CLRE 259,A00,507211,Patel; Hemal,9996,0,9999,3
1713501375081,CLRE 260,A00,507221,Cuomo; Raphael Eduardo,9999,0,9999,0
1713501376106,CLRE 297,001,507242,Cuomo; Raphael Eduardo,9999,0,9999,0
1713501377135,CSE 191,A00,516875,Minnes Kemp; Mor Mia,9999,0,9999,0
1713501378161,CSS 201S,A01,494383,Staff,35,0,35,0
1713501379189,CSS 202S,A01,494387,Staff,35,0,35,0
1713501380217,EAP 100,A00,516065,Staff,9792,0,9999,207
1713501381242,ECE 45,A01,507414,Staff,37,0,60,23
1713501382272,ECE 100,A01,507416,Baghdadchi; Saharnaz,0,0,20,20
1713501382272,ECE 100,A02,507418,Baghdadchi; Saharnaz,19,0,20,1
1713501383300,ECE 111,A01,507420,Staff,27,0,50,23
1713501384328,ECE 197,001,548057,Sievenpiper; Daniel F.,9998,0,9999,1
1713501385355,EDS 115,A00,507243,Choi; Bailey Miyeon,27,0,28,1
1713501386384,EDS 117,A01,494379,Staff,15,0,25,10
1713501387408,EDS 125,A00,507246,Hopkins; Megan Beth,27,0,30,3
1713501388432,EDS 128A,A01,507264,Fargason; Sharon Gayle,26,0,26,0
1713501389459,EDS 128B,A01,507293,Pappas; Elizabeth,30,0,30,0
1713501390482,EDS 139,A00,507294,Fargason; Sharon Gayle,30,0,30,0
1713501390482,EDS 139,B00,507313,Pappas; Elizabeth,30,0,30,0
1713501391507,EDS 201,A00,507315,Staff,18,0,30,12
1713501392536,EDS 203,A01,507317,Halter; Christopher P.,17,0,30,13
1713501393563,EDS 204R,A01,507319,Halter; Christopher P.,0,1,30,30
1713501393563,EDS 204R,B01,507331,Heinzman; Erica M.,22,0,30,8
1713501394589,EDS 206R,A00,507332,Staff,0,2,30,30
1713501394589,EDS 206R,B00,507343,Staff,23,0,30,7
1713501395619,EDS 250,A00,507344,Hemans; Patricia Ann Benitez,27,0,40,13
1713501396645,EDS 281,A00,507345,Daly; Alan J.,18,0,18,0
1713501397673,EDS 284,A00,507350,Daly; Alan J.,16,0,16,0
1713501398698,EDS 286,A00,507359,Fine; Sarah,18,0,18,0
1713501399725,EDS 289C,A01,507361,Daly; Alan J.,18,0,18,0
1713501400750,EDS 290,A00,507366,Hofstetter; Carolyn,15,0,15,0
1713501401775,LIGM 5A,A00,507421,Fischer-Grunski; Eva K,20,0,20,0
1713501402801,LIGM 5B,A00,507423,Fischer-Grunski; Eva K,20,0,20,0
1713501403827,LIGM 5C,A00,507425,Fischer-Grunski; Eva K,20,0,20,0
1713501404852,LIIT 5AS,A00,507427,Carnelos; Chiara,20,0,20,0
1713501405877,LIIT 5BS,A00,507430,Carnelos; Chiara,20,0,20,0
1713501406907,LIIT 5CS,A00,507432,Carnelos; Chiara,20,0,20,0
1713501407934,LISP 5A,A00,507541,Munoz Sanchez; Alicia,14,0,20,6
1713501408964,LISP 5B,A00,507671,Munoz Sanchez; Alicia,12,0,20,8
1713501410063,LISP 5C,A00,507696,Munoz Sanchez; Alicia,11,0,20,9
1713501411091,MAE 197,001,528363,Boechler; Nicholas Sebastia,9998,0,9999,1
1713501412118,MATH 197,001,523477,Kedlaya; Kiran S.,9999,0,9999,0
1713501412118,MATH 197,002,563811,Zhang; Danna,9998,0,9999,1
1713501413143,MCWP 40R,A00,518780,Staff,14,0,20,6
1713501413143,MCWP 40R,B00,518781,Staff,11,0,20,9
1713501413143,MCWP 40R,C00,518783,Staff,8,0,20,12
1713501414170,MCWP 50R,A00,518791,Staff,7,0,20,13
1713501414170,MCWP 50R,B00,518792,Staff,3,0,20,17
1713501414170,MCWP 50R,C00,518793,Staff,5,0,20,15
1713501414170,MCWP 50R,D00,518794,Staff,0,0,20,20
1713501414170,MCWP 50R,E00,518795,Staff,0,0,20,20
1713501414170,MCWP 50R,F00,518796,Staff,11,0,20,9
1713501414170,MCWP 50R,G00,518797,Staff,10,0,20,10
1713501415196,MMW 12R,A01,514034,Herbst; Matthew,4,0,16,12
1713501415196,MMW 12R,A02,514035,Herbst; Matthew,13,0,16,3
1713501416221,MMW 13R,A01,514037,Staff,0,8,16,16
1713501416221,MMW 13R,A02,514039,Staff,0,7,16,16
1713501418274,SIO 295LS,A00,523233,Staff,15,0,30,15
1713501419299,SIO 295S,A00,523232,Staff,15,0,30,15
1713501420329,SOCI 117,A01,494376,Staff,0,2,5,5
1713501421357,WES 237B,A00,494380,Staff,19,0,20,1
1713501423418,AESE 279B,A00,494370,Wade; Jon P,33,0,33,0
1713501424442,AIP 197,001,627712,Vespa; Emanuel Ignacio,9999,0,9999,0
1713501425470,ANAR 135S,A00,494369,Braswell; Geoffrey E.,0,0,0,0
1713501426498,CAT 124RS,A01,519847,Geibel; William,6,0,20,14
1713501427526,CAT 125RS,A01,515971,Geibel; William,6,0,20,14
1713501428550,CLRE 250,A00,511389,Morris; Sheldon,9996,0,9999,3
1713501429577,CLRE 251,A00,507176,Mehta; Ravindra L.,9996,0,9999,3
1713501429577,CLRE 251,B00,511410,Mehta; Ravindra L.,9998,0,9999,1
1713501430602,CLRE 252,A00,507189,Cuomo; Raphael Eduardo,9998,0,9999,1
1713501431627,CLRE 253,A00,507199,Vaida; Florin,9997,0,9999,2
1713501431627,CLRE 253,B00,507202,Vaida; Florin,9999,0,9999,0
1713501432652,CLRE 259,A00,507211,Patel; Hemal,9996,0,9999,3
1713501433676,CLRE 260,A00,507221,Cuomo; Raphael Eduardo,9999,0,9999,0
1713501434701,CLRE 297,001,507242,Cuomo; Raphael Eduardo,9999,0,9999,0
1713501435726,CSE 191,A00,516875,Minnes Kemp; Mor Mia,9999,0,9999,0
1713501436755,CSS 201S,A01,494383,Staff,35,0,35,0
1713501437785,CSS 202S,A01,494387,Staff,35,0,35,0
1713501438808,EAP 100,A00,516065,Staff,9792,0,9999,207
1713501439834,ECE 45,A01,507414,Staff,37,0,60,23
1713501440863,ECE 100,A01,507416,Baghdadchi; Saharnaz,0,0,20,20
1713501440863,ECE 100,A02,507418,Baghdadchi; Saharnaz,19,0,20,1
1713501441891,ECE 111,A01,507420,Staff,27,0,50,23
1713501442919,ECE 197,001,548057,Sievenpiper; Daniel F.,9998,0,9999,1
1713501443947,EDS 115,A00,507243,Choi; Bailey Miyeon,27,0,28,1
1713501444972,EDS 117,A01,494379,Staff,15,0,25,10
1713501446000,EDS 125,A00,507246,Hopkins; Megan Beth,27,0,30,3
1713501447028,EDS 128A,A01,507264,Fargason; Sharon Gayle,26,0,26,0
1713501448057,EDS 128B,A01,507293,Pappas; Elizabeth,30,0,30,0
1713501449085,EDS 139,A00,507294,Fargason; Sharon Gayle,30,0,30,0
1713501449085,EDS 139,B00,507313,Pappas; Elizabeth,30,0,30,0
1713501450112,EDS 201,A00,507315,Staff,18,0,30,12
1713501451137,EDS 203,A01,507317,Halter; Christopher P.,17,0,30,13
1713501452166,EDS 204R,A01,507319,Halter; Christopher P.,0,1,30,30
1713501452166,EDS 204R,B01,507331,Heinzman; Erica M.,22,0,30,8
1713501453190,EDS 206R,A00,507332,Staff,0,2,30,30
1713501453190,EDS 206R,B00,507343,Staff,23,0,30,7
1713501454221,EDS 250,A00,507344,Hemans; Patricia Ann Benitez,27,0,40,13
1713501455244,EDS 281,A00,507345,Daly; Alan J.,18,0,18,0
1713501456273,EDS 284,A00,507350,Daly; Alan J.,16,0,16,0
1713501457303,EDS 286,A00,507359,Fine; Sarah,18,0,18,0
1713501458328,EDS 289C,A01,507361,Daly; Alan J.,18,0,18,0
1713501459354,EDS 290,A00,507366,Hofstetter; Carolyn,15,0,15,0
1713501460379,LIGM 5A,A00,507421,Fischer-Grunski; Eva K,20,0,20,0
1713501461409,LIGM 5B,A00,507423,Fischer-Grunski; Eva K,20,0,20,0
1713501462433,LIGM 5C,A00,507425,Fischer-Grunski; Eva K,20,0,20,0
1713501463456,LIIT 5AS,A00,507427,Carnelos; Chiara,20,0,20,0
1713501464485,LIIT 5BS,A00,507430,Carnelos; Chiara,20,0,20,0
1713501465512,LIIT 5CS,A00,507432,Carnelos; Chiara,20,0,20,0
1713501466539,LISP 5A,A00,507541,Munoz Sanchez; Alicia,14,0,20,6
1713501467564,LISP 5B,A00,507671,Munoz Sanchez; Alicia,12,0,20,8
1713501468589,LISP 5C,A00,507696,Munoz Sanchez; Alicia,11,0,20,9
1713501469615,MAE 197,001,528363,Boechler; Nicholas Sebastia,9998,0,9999,1
1713501470644,MATH 197,001,523477,Kedlaya; Kiran S.,9999,0,9999,0
1713501470644,MATH 197,002,563811,Zhang; Danna,9998,0,9999,1
1713501471668,MCWP 40R,A00,518780,Staff,14,0,20,6
1713501471668,MCWP 40R,B00,518781,Staff,11,0,20,9
1713501471668,MCWP 40R,C00,518783,Staff,8,0,20,12
1713501472699,MCWP 50R,A00,518791,Staff,7,0,20,13
1713501472699,MCWP 50R,B00,518792,Staff,3,0,20,17
1713501472699,MCWP 50R,C00,518793,Staff,5,0,20,15
1713501472699,MCWP 50R,D00,518794,Staff,0,0,20,20
1713501472699,MCWP 50R,E00,518795,Staff,0,0,20,20
1713501472699,MCWP 50R,F00,518796,Staff,11,0,20,9
1713501472699,MCWP 50R,G00,518797,Staff,10,0,20,10
1713501473723,MMW 12R,A01,514034,Herbst; Matthew,4,0,16,12
1713501473723,MMW 12R,A02,514035,Herbst; Matthew,13,0,16,3
1713501474752,MMW 13R,A01,514037,Staff,0,8,16,16
1713501474752,MMW 13R,A02,514039,Staff,0,7,16,16
1713501476804,SIO 295LS,A00,523233,Staff,15,0,30,15
1713501477833,SIO 295S,A00,523232,Staff,15,0,30,15
1713501478857,SOCI 117,A01,494376,Staff,0,2,5,5
1713501479885,WES 237B,A00,494380,Staff,19,0,20,1
1713501481941,AESE 279B,A00,494370,Wade; Jon P,33,0,33,0
1713501482967,AIP 197,001,627712,Vespa; Emanuel Ignacio,9999,0,9999,0
1713501483997,ANAR 135S,A00,494369,Braswell; Geoffrey E.,0,0,0,0
1713501485023,CAT 124RS,A01,519847,Geibel; William,6,0,20,14
1713501486056,CAT 125RS,A01,515971,Geibel; William,6,0,20,14
1713501487085,CLRE 250,A00,511389,Morris; Sheldon,9996,0,9999,3
1713501488112,CLRE 251,A00,507176,Mehta; Ravindra L.,9996,0,9999,3
1713501488112,CLRE 251,B00,511410,Mehta; Ravindra L.,9998,0,9999,1
1713501489136,CLRE 252,A00,507189,Cuomo; Raphael Eduardo,9998,0,9999,1
1713501490163,CLRE 253,A00,507199,Vaida; Florin,9997,0,9999,2
1713501490163,CLRE 253,B00,507202,Vaida; Florin,9999,0,9999,0
1713501491189,CLRE 259,A00,507211,Patel; Hemal,9996,0,9999,3
1713501492216,CLRE 260,A00,507221,Cuomo; Raphael Eduardo,9999,0,9999,0
1713501493247,CLRE 297,001,507242,Cuomo; Raphael Eduardo,9999,0,9999,0
1713501494271,CSE 191,A00,516875,Minnes Kemp; Mor Mia,9999,0,9999,0
1713501495298,CSS 201S,A01,494383,Staff,35,0,35,0
1713501496328,CSS 202S,A01,494387,Staff,35,0,35,0
1713501497355,EAP 100,A00,516065,Staff,9792,0,9999,207
1713501498381,ECE 45,A01,507414,Staff,37,0,60,23
1713501499407,ECE 100,A01,507416,Baghdadchi; Saharnaz,0,0,20,20
1713501499407,ECE 100,A02,507418,Baghdadchi; Saharnaz,19,0,20,1
1713501500434,ECE 111,A01,507420,Staff,27,0,50,23
1713501501463,ECE 197,001,548057,Sievenpiper; Daniel F.,9998,0,9999,1
1713501502492,EDS 115,A00,507243,Choi; Bailey Miyeon,27,0,28,1
1713501503518,EDS 117,A01,494379,Staff,15,0,25,10
1713501504544,EDS 125,A00,507246,Hopkins; Megan Beth,27,0,30,3
1713501505573,EDS 128A,A01,507264,Fargason; Sharon Gayle,26,0,26,0
1713501506600,EDS 128B,A01,507293,Pappas; Elizabeth,30,0,30,0
1713501507625,EDS 139,A00,507294,Fargason; Sharon Gayle,30,0,30,0
1713501507625,EDS 139,B00,507313,Pappas; Elizabeth,30,0,30,0
1713501508650,EDS 201,A00,507315,Staff,18,0,30,12
1713501509680,EDS 203,A01,507317,Halter; Christopher P.,17,0,30,13
1713501510706,EDS 204R,A01,507319,Halter; Christopher P.,0,1,30,30
1713501510706,EDS 204R,B01,507331,Heinzman; Erica M.,22,0,30,8
1713501511732,EDS 206R,A00,507332,Staff,0,2,30,30
1713501511732,EDS 206R,B00,507343,Staff,23,0,30,7
1713501512759,EDS 250,A00,507344,Hemans; Patricia Ann Benitez,27,0,40,13
1713501513842,EDS 281,A00,507345,Daly; Alan J.,18,0,18,0
1713501514866,EDS 284,A00,507350,Daly; Alan J.,16,0,16,0
1713501515891,EDS 286,A00,507359,Fine; Sarah,18,0,18,0
1713501516917,EDS 289C,A01,507361,Daly; Alan J.,18,0,18,0
1713501517943,EDS 290,A00,507366,Hofstetter; Carolyn,15,0,15,0
1713501518968,LIGM 5A,A00,507421,Fischer-Grunski; Eva K,20,0,20,0
1713501519994,LIGM 5B,A00,507423,Fischer-Grunski; Eva K,20,0,20,0
1713501521020,LIGM 5C,A00,507425,Fischer-Grunski; Eva K,20,0,20,0
1713501522052,LIIT 5AS,A00,507427,Carnelos; Chiara,20,0,20,0
1713501523076,LIIT 5BS,A00,507430,Carnelos; Chiara,20,0,20,0
1713501524103,LIIT 5CS,A00,507432,Carnelos; Chiara,20,0,20,0
1713501525127,LISP 5A,A00,507541,Munoz Sanchez; Alicia,14,0,20,6
1713501526153,LISP 5B,A00,507671,Munoz Sanchez; Alicia,12,0,20,8
1713501527178,LISP 5C,A00,507696,Munoz Sanchez; Alicia,11,0,20,9
1713501528204,MAE 197,001,528363,Boechler; Nicholas Sebastia,9998,0,9999,1
1713501529231,MATH 197,001,523477,Kedlaya; Kiran S.,9999,0,9999,0
1713501529231,MATH 197,002,563811,Zhang; Danna,9998,0,9999,1
1713501530260,MCWP 40R,A00,518780,Staff,14,0,20,6
1713501530260,MCWP 40R,B00,518781,Staff,11,0,20,9
1713501530260,MCWP 40R,C00,518783,Staff,8,0,20,12
1713501531286,MCWP 50R,A00,518791,Staff,7,0,20,13
1713501531286,MCWP 50R,B00,518792,Staff,3,0,20,17
1713501531286,MCWP 50R,C00,518793,Staff,5,0,20,15
1713501531286,MCWP 50R,D00,518794,Staff,0,0,20,20
1713501531286,MCWP 50R,E00,518795,Staff,0,0,20,20
1713501531286,MCWP 50R,F00,518796,Staff,11,0,20,9
1713501531286,MCWP 50R,G00,518797,Staff,10,0,20,10
1713501532311,MMW 12R,A01,514034,Herbst; Matthew,3,0,16,13
1713501532311,MMW 12R,A02,514035,Herbst; Matthew,13,0,16,3
1713501533341,MMW 13R,A01,514037,Staff,0,8,16,16
1713501533341,MMW 13R,A02,514039,Staff,0,7,16,16
1713501535393,SIO 295LS,A00,523233,Staff,15,0,30,15
1713501536421,SIO 295S,A00,523232,Staff,15,0,30,15
1713501537447,SOCI 117,A01,494376,Staff,0,2,5,5
1713501538472,WES 237B,A00,494380,Staff,19,0,20,1
1713501540527,AESE 279B,A00,494370,Wade; Jon P,33,0,33,0
1713501541559,AIP 197,001,627712,Vespa; Emanuel Ignacio,9999,0,9999,0
1713501542585,ANAR 135S,A00,494369,Braswell; Geoffrey E.,0,0,0,0
1713501543611,CAT 124RS,A01,519847,Geibel; William,6,0,20,14
1713501544635,CAT 125RS,A01,515971,Geibel; William,6,0,20,14
1713501545663,CLRE 250,A00,511389,Morris; Sheldon,9996,0,9999,3
1713501546688,CLRE 251,A00,507176,Mehta; Ravindra L.,9996,0,9999,3
1713501546688,CLRE 251,B00,511410,Mehta; Ravindra L.,9998,0,9999,1
1713501547713,CLRE 252,A00,507189,Cuomo; Raphael Eduardo,9998,0,9999,1
1713501548738,CLRE 253,A00,507199,Vaida; Florin,9997,0,9999,2
1713501548738,CLRE 253,B00,507202,Vaida; Florin,9999,0,9999,0
1713501549766,CLRE 259,A00,507211,Patel; Hemal,9996,0,9999,3
1713501550791,CLRE 260,A00,507221,Cuomo; Raphael Eduardo,9999,0,9999,0
1713501551815,CLRE 297,001,507242,Cuomo; Raphael Eduardo,9999,0,9999,0
1713501552838,CSE 191,A00,516875,Minnes Kemp; Mor Mia,9999,0,9999,0
1713501553871,CSS 201S,A01,494383,Staff,35,0,35,0
1713501554902,CSS 202S,A01,494387,Staff,35,0,35,0
1713501555931,EAP 100,A00,516065,Staff,9792,0,9999,207
1713501556955,ECE 45,A01,507414,Staff,37,0,60,23
1713501557985,ECE 100,A01,507416,Baghdadchi; Saharnaz,0,0,20,20
1713501557985,ECE 100,A02,507418,Baghdadchi; Saharnaz,19,0,20,1
1713501559011,ECE 111,A01,507420,Staff,27,0,50,23
1713501560035,ECE 197,001,548057,Sievenpiper; Daniel F.,9998,0,9999,1
1713501561061,EDS 115,A00,507243,Choi; Bailey Miyeon,27,0,28,1
1713501562085,EDS 117,A01,494379,Staff,15,0,25,10
1713501563112,EDS 125,A00,507246,Hopkins; Megan Beth,27,0,30,3
1713501564142,EDS 128A,A01,507264,Fargason; Sharon Gayle,26,0,26,0
1713501565170,EDS 128B,A01,507293,Pappas; Elizabeth,30,0,30,0
1713501566199,EDS 139,A00,507294,Fargason; Sharon Gayle,30,0,30,0
1713501566199,EDS 139,B00,507313,Pappas; Elizabeth,30,0,30,0
1713501567224,EDS 201,A00,507315,Staff,18,0,30,12
1713501568251,EDS 203,A01,507317,Halter; Christopher P.,17,0,30,13
1713501569276,EDS 204R,A01,507319,Halter; Christopher P.,0,1,30,30
1713501569276,EDS 204R,B01,507331,Heinzman; Erica M.,22,0,30,8
1713501570306,EDS 206R,A00,507332,Staff,0,2,30,30
1713501570306,EDS 206R,B00,507343,Staff,23,0,30,7
1713501571335,EDS 250,A00,507344,Hemans; Patricia Ann Benitez,27,0,40,13
1713501572361,EDS 281,A00,507345,Daly; Alan J.,18,0,18,0
1713501573387,EDS 284,A00,507350,Daly; Alan J.,16,0,16,0
1713501574617,EDS 286,A00,507359,Fine; Sarah,18,0,18,0
1713501575647,EDS 289C,A01,507361,Daly; Alan J.,18,0,18,0
1713501576673,EDS 290,A00,507366,Hofstetter; Carolyn,15,0,15,0
1713501577696,LIGM 5A,A00,507421,Fischer-Grunski; Eva K,20,0,20,0
1713501578726,LIGM 5B,A00,507423,Fischer-Grunski; Eva K,20,0,20,0
1713501579756,LIGM 5C,A00,507425,Fischer-Grunski; Eva K,20,0,20,0
1713501580781,LIIT 5AS,A00,507427,Carnelos; Chiara,20,0,20,0
1713501581811,LIIT 5BS,A00,507430,Carnelos; Chiara,20,0,20,0
1713501582837,LIIT 5CS,A00,507432,Carnelos; Chiara,20,0,20,0
1713501583869,LISP 5A,A00,507541,Munoz Sanchez; Alicia,14,0,20,6
1713501584896,LISP 5B,A00,507671,Munoz Sanchez; Alicia,12,0,20,8
1713501585921,LISP 5C,A00,507696,Munoz Sanchez; Alicia,11,0,20,9
1713501586946,MAE 197,001,528363,Boechler; Nicholas Sebastia,9998,0,9999,1
1713501587976,MATH 197,001,523477,Kedlaya; Kiran S.,9999,0,9999,0
1713501587976,MATH 197,002,563811,Zhang; Danna,9998,0,9999,1
1713501589002,MCWP 40R,A00,518780,Staff,14,0,20,6
1713501589002,MCWP 40R,B00,518781,Staff,11,0,20,9
1713501589002,MCWP 40R,C00,518783,Staff,8,0,20,12
1713501590029,MCWP 50R,A00,518791,Staff,7,0,20,13
1713501590029,MCWP 50R,B00,518792,Staff,3,0,20,17
1713501590029,MCWP 50R,C00,518793,Staff,5,0,20,15
1713501590029,MCWP 50R,D00,518794,Staff,0,0,20,20
1713501590029,MCWP 50R,E00,518795,Staff,0,0,20,20
1713501590029,MCWP 50R,F00,518796,Staff,11,0,20,9
1713501590029,MCWP 50R,G00,518797,Staff,10,0,20,10
1713501591053,MMW 12R,A01,514034,Herbst; Matthew,3,0,16,13
1713501591053,MMW 12R,A02,514035,Herbst; Matthew,13,0,16,3
1713501592079,MMW 13R,A01,514037,Staff,0,8,16,16
1713501592079,MMW 13R,A02,514039,Staff,0,7,16,16
1713501594131,SIO 295LS,A00,523233,Staff,15,0,30,15
1713501595157,SIO 295S,A00,523232,Staff,15,0,30,15
1713501596181,SOCI 117,A01,494376,Staff,0,2,5,5
1713501597206,WES 237B,A00,494380,Staff,19,0,20,1
1713501599274,AESE 279B,A00,494370,Wade; Jon P,33,0,33,0
1713501600302,AIP 197,001,627712,Vespa; Emanuel Ignacio,9999,0,9999,0
1713501601327,ANAR 135S,A00,494369,Braswell; Geoffrey E.,0,0,0,0
1713501602356,CAT 124RS,A01,519847,Geibel; William,6,0,20,14
1713501603380,CAT 125RS,A01,515971,Geibel; William,6,0,20,14
1713501604408,CLRE 250,A00,511389,Morris; Sheldon,9996,0,9999,3
1713501605438,CLRE 251,A00,507176,Mehta; Ravindra L.,9996,0,9999,3
1713501605438,CLRE 251,B00,511410,Mehta; Ravindra L.,9998,0,9999,1
1713501606464,CLRE 252,A00,507189,Cuomo; Raphael Eduardo,9998,0,9999,1
1713501607491,CLRE 253,A00,507199,Vaida; Florin,9997,0,9999,2
1713501607491,CLRE 253,B00,507202,Vaida; Florin,9999,0,9999,0
1713501608517,CLRE 259,A00,507211,Patel; Hemal,9996,0,9999,3
1713501609544,CLRE 260,A00,507221,Cuomo; Raphael Eduardo,9999,0,9999,0
1713501610569,CLRE 297,001,507242,Cuomo; Raphael Eduardo,9999,0,9999,0
1713501611594,CSE 191,A00,516875,Minnes Kemp; Mor Mia,9999,0,9999,0
1713501612619,CSS 201S,A01,494383,Staff,35,0,35,0
1713501613648,CSS 202S,A01,494387,Staff,35,0,35,0
1713501614673,EAP 100,A00,516065,Staff,9792,0,9999,207
1713501615702,ECE 45,A01,507414,Staff,37,0,60,23
1713501616727,ECE 100,A01,507416,Baghdadchi; Saharnaz,0,0,20,20
1713501616727,ECE 100,A02,507418,Baghdadchi; Saharnaz,19,0,20,1
1713501617823,ECE 111,A01,507420,Staff,27,0,50,23
1713501618850,ECE 197,001,548057,Sievenpiper; Daniel F.,9998,0,9999,1
1713501619878,EDS 115,A00,507243,Choi; Bailey Miyeon,27,0,28,1
1713501620906,EDS 117,A01,494379,Staff,15,0,25,10
1713501621935,EDS 125,A00,507246,Hopkins; Megan Beth,27,0,30,3
1713501622961,EDS 128A,A01,507264,Fargason; Sharon Gayle,26,0,26,0
1713501623988,EDS 128B,A01,507293,Pappas; Elizabeth,30,0,30,0
1713501625012,EDS 139,A00,507294,Fargason; Sharon Gayle,30,0,30,0
1713501625012,EDS 139,B00,507313,Pappas; Elizabeth,30,0,30,0
1713501626040,EDS 201,A00,507315,Staff,18,0,30,12
1713501627067,EDS 203,A01,507317,Halter; Christopher P.,17,0,30,13
1713501628091,EDS 204R,A01,507319,Halter; Christopher P.,0,1,30,30
1713501628091,EDS 204R,B01,507331,Heinzman; Erica M.,22,0,30,8
1713501629120,EDS 206R,A00,507332,Staff,0,2,30,30
1713501629120,EDS 206R,B00,507343,Staff,23,0,30,7
1713501630149,EDS 250,A00,507344,Hemans; Patricia Ann Benitez,27,0,40,13
1713501631172,EDS 281,A00,507345,Daly; Alan J.,18,0,18,0
1713501632200,EDS 284,A00,507350,Daly; Alan J.,16,0,16,0
1713501633233,EDS 286,A00,507359,Fine; Sarah,18,0,18,0
1713501634259,EDS 289C,A01,507361,Daly; Alan J.,18,0,18,0
1713501635287,EDS 290,A00,507366,Hofstetter; Carolyn,15,0,15,0
1713501636312,LIGM 5A,A00,507421,Fischer-Grunski; Eva K,20,0,20,0
1713501637337,LIGM 5B,A00,507423,Fischer-Grunski; Eva K,20,0,20,0
1713501638367,LIGM 5C,A00,507425,Fischer-Grunski; Eva K,20,0,20,0
1713501639392,LIIT 5AS,A00,507427,Carnelos; Chiara,20,0,20,0
1713501640422,LIIT 5BS,A00,507430,Carnelos; Chiara,20,0,20,0
1713501641447,LIIT 5CS,A00,507432,Carnelos; Chiara,20,0,20,0
1713501642473,LISP 5A,A00,507541,Munoz Sanchez; Alicia,14,0,20,6
1713501643496,LISP 5B,A00,507671,Munoz Sanchez; Alicia,12,0,20,8
1713501644526,LISP 5C,A00,507696,Munoz Sanchez; Alicia,11,0,20,9
1713501645553,MAE 197,001,528363,Boechler; Nicholas Sebastia,9998,0,9999,1
1713501646582,MATH 197,001,523477,Kedlaya; Kiran S.,9999,0,9999,0
1713501646582,MATH 197,002,563811,Zhang; Danna,9998,0,9999,1
1713501647611,MCWP 40R,A00,518780,Staff,14,0,20,6
1713501647611,MCWP 40R,B00,518781,Staff,11,0,20,9
1713501647611,MCWP 40R,C00,518783,Staff,8,0,20,12
1713501648635,MCWP 50R,A00,518791,Staff,7,0,20,13
1713501648635,MCWP 50R,B00,518792,Staff,3,0,20,17
1713501648635,MCWP 50R,C00,518793,Staff,5,0,20,15
1713501648635,MCWP 50R,D00,518794,Staff,0,0,20,20
1713501648635,MCWP 50R,E00,518795,Staff,0,0,20,20
1713501648635,MCWP 50R,F00,518796,Staff,11,0,20,9
1713501648635,MCWP 50R,G00,518797,Staff,10,0,20,10
1713501649660,MMW 12R,A01,514034,Herbst; Matthew,3,0,16,13
1713501649660,MMW 12R,A02,514035,Herbst; Matthew,13,0,16,3
1713501650689,MMW 13R,A01,514037,Staff,0,8,16,16
1713501650689,MMW 13R,A02,514039,Staff,0,7,16,16
1713501652745,SIO 295LS,A00,523233,Staff,15,0,30,15
1713501653774,SIO 295S,A00,523232,Staff,15,0,30,15
1713501654801,SOCI 117,A01,494376,Staff,0,2,5,5
1713501655827,WES 237B,A00,494380,Staff,19,0,20,1
1713501657883,AESE 279B,A00,494370,Wade; Jon P,33,0,33,0
1713501658909,AIP 197,001,627712,Vespa; Emanuel Ignacio,9999,0,9999,0
1713501659936,ANAR 135S,A00,494369,Braswell; Geoffrey E.,0,0,0,0
1713501660967,CAT 124RS,A01,519847,Geibel; William,6,0,20,14
1713501661994,CAT 125RS,A01,515971,Geibel; William,6,0,20,14
1713501663023,CLRE 250,A00,511389,Morris; Sheldon,9996,0,9999,3
1713501664052,CLRE 251,A00,507176,Mehta; Ravindra L.,9996,0,9999,3
1713501664052,CLRE 251,B00,511410,Mehta; Ravindra L.,9998,0,9999,1
1713501665080,CLRE 252,A00,507189,Cuomo; Raphael Eduardo,9998,0,9999,1
1713501666108,CLRE 253,A00,507199,Vaida; Florin,9997,0,9999,2
1713501666108,CLRE 253,B00,507202,Vaida; Florin,9999,0,9999,0
1713501667133,CLRE 259,A00,507211,Patel; Hemal,9996,0,9999,3
1713501668158,CLRE 260,A00,507221,Cuomo; Raphael Eduardo,9999,0,9999,0
1713501669182,CLRE 297,001,507242,Cuomo; Raphael Eduardo,9999,0,9999,0
1713501670206,CSE 191,A00,516875,Minnes Kemp; Mor Mia,9999,0,9999,0
1713501671235,CSS 201S,A01,494383,Staff,35,0,35,0
1713501672265,CSS 202S,A01,494387,Staff,35,0,35,0
1713501673293,EAP 100,A00,516065,Staff,9792,0,9999,207
1713501674322,ECE 45,A01,507414,Staff,37,0,60,23
1713501675347,ECE 100,A01,507416,Baghdadchi; Saharnaz,0,0,20,20
1713501675347,ECE 100,A02,507418,Baghdadchi; Saharnaz,19,0,20,1
1713501676376,ECE 111,A01,507420,Staff,27,0,50,23
1713501677405,ECE 197,001,548057,Sievenpiper; Daniel F.,9998,0,9999,1
1713501678434,EDS 115,A00,507243,Choi; Bailey Miyeon,27,0,28,1
1713501679462,EDS 117,A01,494379,Staff,15,0,25,10
1713501680486,EDS 125,A00,507246,Hopkins; Megan Beth,27,0,30,3
1713501681515,EDS 128A,A01,507264,Fargason; Sharon Gayle,26,0,26,0
1713501682543,EDS 128B,A01,507293,Pappas; Elizabeth,30,0,30,0
1713501683571,EDS 139,A00,507294,Fargason; Sharon Gayle,30,0,30,0
1713501683571,EDS 139,B00,507313,Pappas; Elizabeth,30,0,30,0
1713501684599,EDS 201,A00,507315,Staff,18,0,30,12
1713501685629,EDS 203,A01,507317,Halter; Christopher P.,17,0,30,13
1713501686655,EDS 204R,A01,507319,Halter; Christopher P.,0,1,30,30
1713501686655,EDS 204R,B01,507331,Heinzman; Erica M.,22,0,30,8
1713501687684,EDS 206R,A00,507332,Staff,0,2,30,30
1713501687684,EDS 206R,B00,507343,Staff,23,0,30,7
1713501688712,EDS 250,A00,507344,Hemans; Patricia Ann Benitez,27,0,40,13
1713501689740,EDS 281,A00,507345,Daly; Alan J.,18,0,18,0
1713501690768,EDS 284,A00,507350,Daly; Alan J.,16,0,16,0
1713501691798,EDS 286,A00,507359,Fine; Sarah,18,0,18,0
1713501692824,EDS 289C,A01,507361,Daly; Alan J.,18,0,18,0
1713501693863,EDS 290,A00,507366,Hofstetter; Carolyn,15,0,15,0
1713501694889,LIGM 5A,A00,507421,Fischer-Grunski; Eva K,20,0,20,0
1713501695914,LIGM 5B,A00,507423,Fischer-Grunski; Eva K,20,0,20,0
1713501696941,LIGM 5C,A00,507425,Fischer-Grunski; Eva K,20,0,20,0
1713501697973,LIIT 5AS,A00,507427,Carnelos; Chiara,20,0,20,0
1713501699003,LIIT 5BS,A00,507430,Carnelos; Chiara,20,0,20,0
1713501700029,LIIT 5CS,A00,507432,Carnelos; Chiara,20,0,20,0
1713501701054,LISP 5A,A00,507541,Munoz Sanchez; Alicia,14,0,20,6
1713501702080,LISP 5B,A00,507671,Munoz Sanchez; Alicia,12,0,20,8
1713501703109,LISP 5C,A00,507696,Munoz Sanchez; Alicia,11,0,20,9
1713501704139,MAE 197,001,528363,Boechler; Nicholas Sebastia,9998,0,9999,1
1713501705165,MATH 197,001,523477,Kedlaya; Kiran S.,9999,0,9999,0
1713501705165,MATH 197,002,563811,Zhang; Danna,9998,0,9999,1
1713501706197,MCWP 40R,A00,518780,Staff,14,0,20,6
1713501706197,MCWP 40R,B00,518781,Staff,11,0,20,9
1713501706197,MCWP 40R,C00,518783,Staff,8,0,20,12
1713501707228,MCWP 50R,A00,518791,Staff,7,0,20,13
1713501707228,MCWP 50R,B00,518792,Staff,3,0,20,17
1713501707228,MCWP 50R,C00,518793,Staff,5,0,20,15
1713501707228,MCWP 50R,D00,518794,Staff,0,0,20,20
1713501707228,MCWP 50R,E00,518795,Staff,0,0,20,20
1713501707228,MCWP 50R,F00,518796,Staff,11,0,20,9
1713501707228,MCWP 50R,G00,518797,Staff,10,0,20,10
1713501708257,MMW 12R,A01,514034,Herbst; Matthew,3,0,16,13
1713501708257,MMW 12R,A02,514035,Herbst; Matthew,13,0,16,3
1713501709286,MMW 13R,A01,514037,Staff,0,8,16,16
1713501709286,MMW 13R,A02,514039,Staff,0,7,16,16
1713501711339,SIO 295LS,A00,523233,Staff,15,0,30,15
1713501712363,SIO 295S,A00,523232,Staff,15,0,30,15
1713501713389,SOCI 117,A01,494376,Staff,0,2,5,5
1713501714414,WES 237B,A00,494380,Staff,19,0,20,1
1713501716471,AESE 279B,A00,494370,Wade; Jon P,33,0,33,0
1713501717500,AIP 197,001,627712,Vespa; Emanuel Ignacio,9999,0,9999,0
1713501718525,ANAR 135S,A00,494369,Braswell; Geoffrey E.,0,0,0,0
1713501719551,CAT 124RS,A01,519847,Geibel; William,6,0,20,14
1713501720578,CAT 125RS,A01,515971,Geibel; William,6,0,20,14
1713501721661,CLRE 250,A00,511389,Morris; Sheldon,9996,0,9999,3
1713501722691,CLRE 251,A00,507176,Mehta; Ravindra L.,9996,0,9999,3
1713501722691,CLRE 251,B00,511410,Mehta; Ravindra L.,9998,0,9999,1
1713501723717,CLRE 252,A00,507189,Cuomo; Raphael Eduardo,9998,0,9999,1
1713501724741,CLRE 253,A00,507199,Vaida; Florin,9997,0,9999,2
1713501724741,CLRE 253,B00,507202,Vaida; Florin,9999,0,9999,0
1713501725769,CLRE 259,A00,507211,Patel; Hemal,9996,0,9999,3
1713501726797,CLRE 260,A00,507221,Cuomo; Raphael Eduardo,9999,0,9999,0
1713501727825,CLRE 297,001,507242,Cuomo; Raphael Eduardo,9999,0,9999,0
1713501728850,CSE 191,A00,516875,Minnes Kemp; Mor Mia,9999,0,9999,0
1713501729876,CSS 201S,A01,494383,Staff,35,0,35,0
1713501730905,CSS 202S,A01,494387,Staff,35,0,35,0
1713501731933,EAP 100,A00,516065,Staff,9792,0,9999,207
1713501732961,ECE 45,A01,507414,Staff,37,0,60,23
1713501733990,ECE 100,A01,507416,Baghdadchi; Saharnaz,0,0,20,20
1713501733990,ECE 100,A02,507418,Baghdadchi; Saharnaz,19,0,20,1
1713501735015,ECE 111,A01,507420,Staff,27,0,50,23
1713501736042,ECE 197,001,548057,Sievenpiper; Daniel F.,9998,0,9999,1
1713501737070,EDS 115,A00,507243,Choi; Bailey Miyeon,27,0,28,1
1713501738096,EDS 117,A01,494379,Staff,15,0,25,10
1713501739121,EDS 125,A00,507246,Hopkins; Megan Beth,27,0,30,3
1713501740151,EDS 128A,A01,507264,Fargason; Sharon Gayle,26,0,26,0
1713501741176,EDS 128B,A01,507293,Pappas; Elizabeth,30,0,30,0
1713501742202,EDS 139,A00,507294,Fargason; Sharon Gayle,30,0,30,0
1713501742202,EDS 139,B00,507313,Pappas; Elizabeth,30,0,30,0
1713501743227,EDS 201,A00,507315,Staff,18,0,30,12
1713501744253,EDS 203,A01,507317,Halter; Christopher P.,17,0,30,13
1713501745279,EDS 204R,A01,507319,Halter; Christopher P.,0,1,30,30
1713501745279,EDS 204R,B01,507331,Heinzman; Erica M.,22,0,30,8
1713501746305,EDS 206R,A00,507332,Staff,0,2,30,30
1713501746305,EDS 206R,B00,507343,Staff,23,0,30,7
1713501747331,EDS 250,A00,507344,Hemans; Patricia Ann Benitez,27,0,40,13
1713501748356,EDS 281,A00,507345,Daly; Alan J.,18,0,18,0
1713501749383,EDS 284,A00,507350,Daly; Alan J.,16,0,16,0
1713501750407,EDS 286,A00,507359,Fine; Sarah,18,0,18,0
1713501751433,EDS 289C,A01,507361,Daly; Alan J.,18,0,18,0
1713501752457,EDS 290,A00,507366,Hofstetter; Carolyn,15,0,15,0
1713501753482,LIGM 5A,A00,507421,Fischer-Grunski; Eva K,20,0,20,0
1713501754507,LIGM 5B,A00,507423,Fischer-Grunski; Eva K,20,0,20,0
1713501755532,LIGM 5C,A00,507425,Fischer-Grunski; Eva K,20,0,20,0
1713501756560,LIIT 5AS,A00,507427,Carnelos; Chiara,20,0,20,0
1713501757589,LIIT 5BS,A00,507430,Carnelos; Chiara,20,0,20,0
1713501758614,LIIT 5CS,A00,507432,Carnelos; Chiara,20,0,20,0
1713501759639,LISP 5A,A00,507541,Munoz Sanchez; Alicia,14,0,20,6
1713501760663,LISP 5B,A00,507671,Munoz Sanchez; Alicia,12,0,20,8
1713501761693,LISP 5C,A00,507696,Munoz Sanchez; Alicia,11,0,20,9
1713501762721,MAE 197,001,528363,Boechler; Nicholas Sebastia,9998,0,9999,1
1713501763745,MATH 197,001,523477,Kedlaya; Kiran S.,9999,0,9999,0
1713501763745,MATH 197,002,563811,Zhang; Danna,9998,0,9999,1
1713501764771,MCWP 40R,A00,518780,Staff,14,0,20,6
1713501764771,MCWP 40R,B00,518781,Staff,11,0,20,9
1713501764771,MCWP 40R,C00,518783,Staff,8,0,20,12
1713501765800,MCWP 50R,A00,518791,Staff,7,0,20,13
1713501765800,MCWP 50R,B00,518792,Staff,3,0,20,17
1713501765800,MCWP 50R,C00,518793,Staff,5,0,20,15
1713501765800,MCWP 50R,D00,518794,Staff,0,0,20,20
1713501765800,MCWP 50R,E00,518795,Staff,0,0,20,20
1713501765800,MCWP 50R,F00,518796,Staff,11,0,20,9
1713501765800,MCWP 50R,G00,518797,Staff,10,0,20,10
1713501766826,MMW 12R,A01,514034,Herbst; Matthew,3,0,16,13
1713501766826,MMW 12R,A02,514035,Herbst; Matthew,13,0,16,3
1713501767852,MMW 13R,A01,514037,Staff,0,8,16,16
1713501767852,MMW 13R,A02,514039,Staff,0,7,16,16
1713501769909,SIO 295LS,A00,523233,Staff,15,0,30,15
1713501770935,SIO 295S,A00,523232,Staff,15,0,30,15
1713501771959,SOCI 117,A01,494376,Staff,0,2,5,5
1713501772984,WES 237B,A00,494380,Staff,19,0,20,1
1713501775041,AESE 279B,A00,494370,Wade; Jon P,33,0,33,0
1713501776066,AIP 197,001,627712,Vespa; Emanuel Ignacio,9999,0,9999,0
1713501777091,ANAR 135S,A00,494369,Braswell; Geoffrey E.,0,0,0,0
1713501778116,CAT 124RS,A01,519847,Geibel; William,6,0,20,14
1713501779139,CAT 125RS,A01,515971,Geibel; William,6,0,20,14
1713501780165,CLRE 250,A00,511389,Morris; Sheldon,9996,0,9999,3
1713501781191,CLRE 251,A00,507176,Mehta; Ravindra L.,9996,0,9999,3
1713501781191,CLRE 251,B00,511410,Mehta; Ravindra L.,9998,0,9999,1
1713501782216,CLRE 252,A00,507189,Cuomo; Raphael Eduardo,9998,0,9999,1
1713501783241,CLRE 253,A00,507199,Vaida; Florin,9997,0,9999,2
1713501783241,CLRE 253,B00,507202,Vaida; Florin,9999,0,9999,0
1713501784266,CLRE 259,A00,507211,Patel; Hemal,9996,0,9999,3
1713501785290,CLRE 260,A00,507221,Cuomo; Raphael Eduardo,9999,0,9999,0
1713501786316,CLRE 297,001,507242,Cuomo; Raphael Eduardo,9999,0,9999,0
1713501787342,CSE 191,A00,516875,Minnes Kemp; Mor Mia,9999,0,9999,0
1713501788368,CSS 201S,A01,494383,Staff,35,0,35,0
1713501789394,CSS 202S,A01,494387,Staff,35,0,35,0
1713501790420,EAP 100,A00,516065,Staff,9792,0,9999,207
1713501791448,ECE 45,A01,507414,Staff,37,0,60,23
1713501792472,ECE 100,A01,507416,Baghdadchi; Saharnaz,0,0,20,20
1713501792472,ECE 100,A02,507418,Baghdadchi; Saharnaz,19,0,20,1
1713501793497,ECE 111,A01,507420,Staff,27,0,50,23
1713501794523,ECE 197,001,548057,Sievenpiper; Daniel F.,9998,0,9999,1
1713501795550,EDS 115,A00,507243,Choi; Bailey Miyeon,27,0,28,1
1713501796576,EDS 117,A01,494379,Staff,15,0,25,10
1713501797604,EDS 125,A00,507246,Hopkins; Megan Beth,27,0,30,3
1713501798629,EDS 128A,A01,507264,Fargason; Sharon Gayle,26,0,26,0
1713501799652,EDS 128B,A01,507293,Pappas; Elizabeth,30,0,30,0
1713501800681,EDS 139,A00,507294,Fargason; Sharon Gayle,30,0,30,0
1713501800681,EDS 139,B00,507313,Pappas; Elizabeth,30,0,30,0
1713501801707,EDS 201,A00,507315,Staff,18,0,30,12
1713501802733,EDS 203,A01,507317,Halter; Christopher P.,17,0,30,13
1713501803760,EDS 204R,A01,507319,Halter; Christopher P.,0,1,30,30
1713501803760,EDS 204R,B01,507331,Heinzman; Erica M.,22,0,30,8
1713501804785,EDS 206R,A00,507332,Staff,0,2,30,30
1713501804785,EDS 206R,B00,507343,Staff,23,0,30,7
1713501805812,EDS 250,A00,507344,Hemans; Patricia Ann Benitez,27,0,40,13
1713501806837,EDS 281,A00,507345,Daly; Alan J.,18,0,18,0
1713501807864,EDS 284,A00,507350,Daly; Alan J.,16,0,16,0
1713501808890,EDS 286,A00,507359,Fine; Sarah,18,0,18,0
1713501809913,EDS 289C,A01,507361,Daly; Alan J.,18,0,18,0
1713501810939,EDS 290,A00,507366,Hofstetter; Carolyn,15,0,15,0
1713501811969,LIGM 5A,A00,507421,Fischer-Grunski; Eva K,20,0,20,0
1713501812996,LIGM 5B,A00,507423,Fischer-Grunski; Eva K,20,0,20,0
1713501814023,LIGM 5C,A00,507425,Fischer-Grunski; Eva K,20,0,20,0
1713501815052,LIIT 5AS,A00,507427,Carnelos; Chiara,20,0,20,0
1713501816079,LIIT 5BS,A00,507430,Carnelos; Chiara,20,0,20,0
1713501817107,LIIT 5CS,A00,507432,Carnelos; Chiara,20,0,20,0
1713501818133,LISP 5A,A00,507541,Munoz Sanchez; Alicia,14,0,20,6
1713501819158,LISP 5B,A00,507671,Munoz Sanchez; Alicia,12,0,20,8
1713501820184,LISP 5C,A00,507696,Munoz Sanchez; Alicia,11,0,20,9
1713501821213,MAE 197,001,528363,Boechler; Nicholas Sebastia,9998,0,9999,1
1713501822239,MATH 197,001,523477,Kedlaya; Kiran S.,9999,0,9999,0
1713501822239,MATH 197,002,563811,Zhang; Danna,9998,0,9999,1
1713501823265,MCWP 40R,A00,518780,Staff,14,0,20,6
1713501823265,MCWP 40R,B00,518781,Staff,11,0,20,9
1713501823265,MCWP 40R,C00,518783,Staff,8,0,20,12
1713501824296,MCWP 50R,A00,518791,Staff,7,0,20,13
1713501824296,MCWP 50R,B00,518792,Staff,3,0,20,17
1713501824296,MCWP 50R,C00,518793,Staff,5,0,20,15
1713501824296,MCWP 50R,D00,518794,Staff,0,0,20,20
1713501824296,MCWP 50R,E00,518795,Staff,0,0,20,20
1713501824296,MCWP 50R,F00,518796,Staff,11,0,20,9
1713501824296,MCWP 50R,G00,518797,Staff,10,0,20,10
1713501825377,MMW 12R,A01,514034,Herbst; Matthew,3,0,16,13
1713501825377,MMW 12R,A02,514035,Herbst; Matthew,13,0,16,3
1713501826405,MMW 13R,A01,514037,Staff,0,8,16,16
1713501826405,MMW 13R,A02,514039,Staff,0,7,16,16
1713501828456,SIO 295LS,A00,523233,Staff,15,0,30,15
1713501829484,SIO 295S,A00,523232,Staff,15,0,30,15
1713501830511,SOCI 117,A01,494376,Staff,0,2,5,5
1713501831541,WES 237B,A00,494380,Staff,19,0,20,1
1713501833597,AESE 279B,A00,494370,Wade; Jon P,33,0,33,0
1713501834621,AIP 197,001,627712,Vespa; Emanuel Ignacio,9999,0,9999,0
1713501835648,ANAR 135S,A00,494369,Braswell; Geoffrey E.,0,0,0,0
1713501836676,CAT 124RS,A01,519847,Geibel; William,6,0,20,14
1713501837704,CAT 125RS,A01,515971,Geibel; William,6,0,20,14
1713501838727,CLRE 250,A00,511389,Morris; Sheldon,9996,0,9999,3
1713501839757,CLRE 251,A00,507176,Mehta; Ravindra L.,9996,0,9999,3
1713501839757,CLRE 251,B00,511410,Mehta; Ravindra L.,9998,0,9999,1
1713501840783,CLRE 252,A00,507189,Cuomo; Raphael Eduardo,9998,0,9999,1
1713501841808,CLRE 253,A00,507199,Vaida; Florin,9997,0,9999,2
1713501841808,CLRE 253,B00,507202,Vaida; Florin,9999,0,9999,0
1713501842837,CLRE 259,A00,507211,Patel; Hemal,9996,0,9999,3
1713501843865,CLRE 260,A00,507221,Cuomo; Raphael Eduardo,9999,0,9999,0
1713501844890,CLRE 297,001,507242,Cuomo; Raphael Eduardo,9999,0,9999,0
1713501845913,CSE 191,A00,516875,Minnes Kemp; Mor Mia,9999,0,9999,0
1713501846939,CSS 201S,A01,494383,Staff,35,0,35,0
1713501847965,CSS 202S,A01,494387,Staff,35,0,35,0
1713501848990,EAP 100,A00,516065,Staff,9792,0,9999,207
1713501850017,ECE 45,A01,507414,Staff,37,0,60,23
1713501851046,ECE 100,A01,507416,Baghdadchi; Saharnaz,0,0,20,20
1713501851046,ECE 100,A02,507418,Baghdadchi; Saharnaz,19,0,20,1
1713501852073,ECE 111,A01,507420,Staff,27,0,50,23
1713501853097,ECE 197,001,548057,Sievenpiper; Daniel F.,9998,0,9999,1
1713501854123,EDS 115,A00,507243,Choi; Bailey Miyeon,27,0,28,1
1713501855148,EDS 117,A01,494379,Staff,15,0,25,10
1713501856174,EDS 125,A00,507246,Hopkins; Megan Beth,27,0,30,3
1713501857200,EDS 128A,A01,507264,Fargason; Sharon Gayle,26,0,26,0
1713501858225,EDS 128B,A01,507293,Pappas; Elizabeth,30,0,30,0
1713501859251,EDS 139,A00,507294,Fargason; Sharon Gayle,30,0,30,0
1713501859251,EDS 139,B00,507313,Pappas; Elizabeth,30,0,30,0
1713501860280,EDS 201,A00,507315,Staff,18,0,30,12
1713501861305,EDS 203,A01,507317,Halter; Christopher P.,17,0,30,13
1713501862335,EDS 204R,A01,507319,Halter; Christopher P.,0,1,30,30
1713501862335,EDS 204R,B01,507331,Heinzman; Erica M.,22,0,30,8
1713501863363,EDS 206R,A00,507332,Staff,0,2,30,30
1713501863363,EDS 206R,B00,507343,Staff,23,0,30,7
1713501864389,EDS 250,A00,507344,Hemans; Patricia Ann Benitez,27,0,40,13
1713501865414,EDS 281,A00,507345,Daly; Alan J.,18,0,18,0
1713501866440,EDS 284,A00,507350,Daly; Alan J.,16,0,16,0
1713501867465,EDS 286,A00,507359,Fine; Sarah,18,0,18,0
1713501868493,EDS 289C,A01,507361,Daly; Alan J.,18,0,18,0
1713501869523,EDS 290,A00,507366,Hofstetter; Carolyn,15,0,15,0
1713501870548,LIGM 5A,A00,507421,Fischer-Grunski; Eva K,20,0,20,0
1713501871577,LIGM 5B,A00,507423,Fischer-Grunski; Eva K,20,0,20,0
1713501872599,LIGM 5C,A00,507425,Fischer-Grunski; Eva K,20,0,20,0
1713501873628,LIIT 5AS,A00,507427,Carnelos; Chiara,20,0,20,0
1713501874655,LIIT 5BS,A00,507430,Carnelos; Chiara,20,0,20,0
1713501875682,LIIT 5CS,A00,507432,Carnelos; Chiara,20,0,20,0
1713501876706,LISP 5A,A00,507541,Munoz Sanchez; Alicia,14,0,20,6
1713501877732,LISP 5B,A00,507671,Munoz Sanchez; Alicia,12,0,20,8
1713501878756,LISP 5C,A00,507696,Munoz Sanchez; Alicia,11,0,20,9
1713501879783,MAE 197,001,528363,Boechler; Nicholas Sebastia,9998,0,9999,1
1713501880814,MATH 197,001,523477,Kedlaya; Kiran S.,9999,0,9999,0
1713501880814,MATH 197,002,563811,Zhang; Danna,9998,0,9999,1
1713501881843,MCWP 40R,A00,518780,Staff,14,0,20,6
1713501881843,MCWP 40R,B00,518781,Staff,11,0,20,9
1713501881843,MCWP 40R,C00,518783,Staff,8,0,20,12
1713501882870,MCWP 50R,A00,518791,Staff,7,0,20,13
1713501882870,MCWP 50R,B00,518792,Staff,3,0,20,17
1713501882870,MCWP 50R,C00,518793,Staff,5,0,20,15
1713501882870,MCWP 50R,D00,518794,Staff,0,0,20,20
1713501882870,MCWP 50R,E00,518795,Staff,0,0,20,20
1713501882870,MCWP 50R,F00,518796,Staff,11,0,20,9
1713501882870,MCWP 50R,G00,518797,Staff,10,0,20,10
1713501883902,MMW 12R,A01,514034,Herbst; Matthew,3,0,16,13
1713501883902,MMW 12R,A02,514035,Herbst; Matthew,13,0,16,3
1713501884926,MMW 13R,A01,514037,Staff,0,8,16,16
1713501884926,MMW 13R,A02,514039,Staff,0,7,16,16
1713501886978,SIO 295LS,A00,523233,Staff,15,0,30,15
1713501888006,SIO 295S,A00,523232,Staff,15,0,30,15
1713501889031,SOCI 117,A01,494376,Staff,0,2,5,5
1713501890056,WES 237B,A00,494380,Staff,19,0,20,1
1713501892120,AESE 279B,A00,494370,Wade; Jon P,33,0,33,0
1713501893149,AIP 197,001,627712,Vespa; Emanuel Ignacio,9999,0,9999,0
1713501894174,ANAR 135S,A00,494369,Braswell; Geoffrey E.,0,0,0,0
1713501895203,CAT 124RS,A01,519847,Geibel; William,6,0,20,14
1713501896229,CAT 125RS,A01,515971,Geibel; William,6,0,20,14
1713501897262,CLRE 250,A00,511389,Morris; Sheldon,9996,0,9999,3
1713501898291,CLRE 251,A00,507176,Mehta; Ravindra L.,9996,0,9999,3
1713501898291,CLRE 251,B00,511410,Mehta; Ravindra L.,9998,0,9999,1
1713501899317,CLRE 252,A00,507189,Cuomo; Raphael Eduardo,9998,0,9999,1
1713501900341,CLRE 253,A00,507199,Vaida; Florin,9997,0,9999,2
1713501900341,CLRE 253,B00,507202,Vaida; Florin,9999,0,9999,0
1713501901368,CLRE 259,A00,507211,Patel; Hemal,9996,0,9999,3
1713501902395,CLRE 260,A00,507221,Cuomo; Raphael Eduardo,9999,0,9999,0
1713501903421,CLRE 297,001,507242,Cuomo; Raphael Eduardo,9999,0,9999,0
1713501904449,CSE 191,A00,516875,Minnes Kemp; Mor Mia,9999,0,9999,0
1713501905475,CSS 201S,A01,494383,Staff,35,0,35,0
1713501906502,CSS 202S,A01,494387,Staff,35,0,35,0
1713501907526,EAP 100,A00,516065,Staff,9792,0,9999,207
1713501908550,ECE 45,A01,507414,Staff,37,0,60,23
1713501909576,ECE 100,A01,507416,Baghdadchi; Saharnaz,0,0,20,20
1713501909576,ECE 100,A02,507418,Baghdadchi; Saharnaz,19,0,20,1
1713501910607,ECE 111,A01,507420,Staff,27,0,50,23
1713501911635,ECE 197,001,548057,Sievenpiper; Daniel F.,9998,0,9999,1
1713501912662,EDS 115,A00,507243,Choi; Bailey Miyeon,27,0,28,1
1713501913687,EDS 117,A01,494379,Staff,15,0,25,10
1713501914714,EDS 125,A00,507246,Hopkins; Megan Beth,27,0,30,3
1713501915739,EDS 128A,A01,507264,Fargason; Sharon Gayle,26,0,26,0
1713501916763,EDS 128B,A01,507293,Pappas; Elizabeth,30,0,30,0
1713501917793,EDS 139,A00,507294,Fargason; Sharon Gayle,30,0,30,0
1713501917793,EDS 139,B00,507313,Pappas; Elizabeth,30,0,30,0
1713501918822,EDS 201,A00,507315,Staff,18,0,30,12
1713501919849,EDS 203,A01,507317,Halter; Christopher P.,17,0,30,13
1713501920875,EDS 204R,A01,507319,Halter; Christopher P.,0,1,30,30
1713501920875,EDS 204R,B01,507331,Heinzman; Erica M.,22,0,30,8
1713501921906,EDS 206R,A00,507332,Staff,0,2,30,30
1713501921906,EDS 206R,B00,507343,Staff,23,0,30,7
1713501922932,EDS 250,A00,507344,Hemans; Patricia Ann Benitez,27,0,40,13
1713501923958,EDS 281,A00,507345,Daly; Alan J.,18,0,18,0
1713501924986,EDS 284,A00,507350,Daly; Alan J.,16,0,16,0
1713501926010,EDS 286,A00,507359,Fine; Sarah,18,0,18,0
1713501927037,EDS 289C,A01,507361,Daly; Alan J.,18,0,18,0
1713501928061,EDS 290,A00,507366,Hofstetter; Carolyn,15,0,15,0
1713501929141,LIGM 5A,A00,507421,Fischer-Grunski; Eva K,20,0,20,0
1713501930173,LIGM 5B,A00,507423,Fischer-Grunski; Eva K,20,0,20,0
1713501931198,LIGM 5C,A00,507425,Fischer-Grunski; Eva K,20,0,20,0
1713501932228,LIIT 5AS,A00,507427,Carnelos; Chiara,20,0,20,0
1713501933257,LIIT 5BS,A00,507430,Carnelos; Chiara,20,0,20,0
1713501934286,LIIT 5CS,A00,507432,Carnelos; Chiara,20,0,20,0
1713501935312,LISP 5A,A00,507541,Munoz Sanchez; Alicia,14,0,20,6
1713501936339,LISP 5B,A00,507671,Munoz Sanchez; Alicia,12,0,20,8
1713501937368,LISP 5C,A00,507696,Munoz Sanchez; Alicia,11,0,20,9
1713501938395,MAE 197,001,528363,Boechler; Nicholas Sebastia,9998,0,9999,1
1713501939425,MATH 197,001,523477,Kedlaya; Kiran S.,9999,0,9999,0
1713501939425,MATH 197,002,563811,Zhang; Danna,9998,0,9999,1
1713501940449,MCWP 40R,A00,518780,Staff,14,0,20,6
1713501940449,MCWP 40R,B00,518781,Staff,11,0,20,9
1713501940449,MCWP 40R,C00,518783,Staff,8,0,20,12
1713501941479,MCWP 50R,A00,518791,Staff,7,0,20,13
1713501941479,MCWP 50R,B00,518792,Staff,3,0,20,17
1713501941479,MCWP 50R,C00,518793,Staff,5,0,20,15
1713501941479,MCWP 50R,D00,518794,Staff,0,0,20,20
1713501941479,MCWP 50R,E00,518795,Staff,0,0,20,20
1713501941479,MCWP 50R,F00,518796,Staff,11,0,20,9
1713501941479,MCWP 50R,G00,518797,Staff,10,0,20,10
1713501942504,MMW 12R,A01,514034,Herbst; Matthew,3,0,16,13
1713501942504,MMW 12R,A02,514035,Herbst; Matthew,13,0,16,3
1713501943529,MMW 13R,A01,514037,Staff,0,8,16,16
1713501943529,MMW 13R,A02,514039,Staff,0,7,16,16
1713501945584,SIO 295LS,A00,523233,Staff,15,0,30,15
1713501946613,SIO 295S,A00,523232,Staff,15,0,30,15
1713501947638,SOCI 117,A01,494376,Staff,0,2,5,5
1713501948662,WES 237B,A00,494380,Staff,19,0,20,1
1713501950724,AESE 279B,A00,494370,Wade; Jon P,33,0,33,0
1713501951750,AIP 197,001,627712,Vespa; Emanuel Ignacio,9999,0,9999,0
1713501952777,ANAR 135S,A00,494369,Braswell; Geoffrey E.,0,0,0,0
1713501953807,CAT 124RS,A01,519847,Geibel; William,6,0,20,14
1713501954833,CAT 125RS,A01,515971,Geibel; William,6,0,20,14
1713501955862,CLRE 250,A00,511389,Morris; Sheldon,9996,0,9999,3
1713501956889,CLRE 251,A00,507176,Mehta; Ravindra L.,9996,0,9999,3
1713501956889,CLRE 251,B00,511410,Mehta; Ravindra L.,9998,0,9999,1
1713501957915,CLRE 252,A00,507189,Cuomo; Raphael Eduardo,9998,0,9999,1
1713501958944,CLRE 253,A00,507199,Vaida; Florin,9997,0,9999,2
1713501958944,CLRE 253,B00,507202,Vaida; Florin,9999,0,9999,0
1713501959970,CLRE 259,A00,507211,Patel; Hemal,9996,0,9999,3
1713501960995,CLRE 260,A00,507221,Cuomo; Raphael Eduardo,9999,0,9999,0
1713501962025,CLRE 297,001,507242,Cuomo; Raphael Eduardo,9999,0,9999,0
1713501963051,CSE 191,A00,516875,Minnes Kemp; Mor Mia,9999,0,9999,0
1713501964081,CSS 201S,A01,494383,Staff,35,0,35,0
1713501965106,CSS 202S,A01,494387,Staff,35,0,35,0
1713501966134,EAP 100,A00,516065,Staff,9792,0,9999,207
1713501967162,ECE 45,A01,507414,Staff,37,0,60,23
1713501968191,ECE 100,A01,507416,Baghdadchi; Saharnaz,0,0,20,20
1713501968191,ECE 100,A02,507418,Baghdadchi; Saharnaz,19,0,20,1
1713501969215,ECE 111,A01,507420,Staff,27,0,50,23
1713501970242,ECE 197,001,548057,Sievenpiper; Daniel F.,9998,0,9999,1
1713501971266,EDS 115,A00,507243,Choi; Bailey Miyeon,27,0,28,1
1713501972295,EDS 117,A01,494379,Staff,15,0,25,10
1713501973320,EDS 125,A00,507246,Hopkins; Megan Beth,27,0,30,3
1713501974347,EDS 128A,A01,507264,Fargason; Sharon Gayle,26,0,26,0
1713501975372,EDS 128B,A01,507293,Pappas; Elizabeth,30,0,30,0
1713501976400,EDS 139,A00,507294,Fargason; Sharon Gayle,30,0,30,0
1713501976400,EDS 139,B00,507313,Pappas; Elizabeth,30,0,30,0
1713501977426,EDS 201,A00,507315,Staff,18,0,30,12
1713501978456,EDS 203,A01,507317,Halter; Christopher P.,17,0,30,13
1713501979483,EDS 204R,A01,507319,Halter; Christopher P.,0,1,30,30
1713501979483,EDS 204R,B01,507331,Heinzman; Erica M.,22,0,30,8
1713501980508,EDS 206R,A00,507332,Staff,0,2,30,30
1713501980508,EDS 206R,B00,507343,Staff,23,0,30,7
1713501981533,EDS 250,A00,507344,Hemans; Patricia Ann Benitez,27,0,40,13
1713501982562,EDS 281,A00,507345,Daly; Alan J.,18,0,18,0
1713501983587,EDS 284,A00,507350,Daly; Alan J.,16,0,16,0
1713501984614,EDS 286,A00,507359,Fine; Sarah,18,0,18,0
1713501985642,EDS 289C,A01,507361,Daly; Alan J.,18,0,18,0
1713501986667,EDS 290,A00,507366,Hofstetter; Carolyn,15,0,15,0
1713501987693,LIGM 5A,A00,507421,Fischer-Grunski; Eva K,20,0,20,0
1713501988720,LIGM 5B,A00,507423,Fischer-Grunski; Eva K,20,0,20,0
1713501989747,LIGM 5C,A00,507425,Fischer-Grunski; Eva K,20,0,20,0
1713501990773,LIIT 5AS,A00,507427,Carnelos; Chiara,20,0,20,0
1713501991798,LIIT 5BS,A00,507430,Carnelos; Chiara,20,0,20,0
1713501992829,LIIT 5CS,A00,507432,Carnelos; Chiara,20,0,20,0
1713501993856,LISP 5A,A00,507541,Munoz Sanchez; Alicia,14,0,20,6
1713501994883,LISP 5B,A00,507671,Munoz Sanchez; Alicia,12,0,20,8
1713501995909,LISP 5C,A00,507696,Munoz Sanchez; Alicia,11,0,20,9
1713501996934,MAE 197,001,528363,Boechler; Nicholas Sebastia,9998,0,9999,1
1713501997965,MATH 197,001,523477,Kedlaya; Kiran S.,9999,0,9999,0
1713501997965,MATH 197,002,563811,Zhang; Danna,9998,0,9999,1
1713501998991,MCWP 40R,A00,518780,Staff,14,0,20,6
1713501998991,MCWP 40R,B00,518781,Staff,11,0,20,9
1713501998991,MCWP 40R,C00,518783,Staff,8,0,20,12
1713502000021,MCWP 50R,A00,518791,Staff,7,0,20,13
1713502000021,MCWP 50R,B00,518792,Staff,3,0,20,17
1713502000021,MCWP 50R,C00,518793,Staff,5,0,20,15
1713502000021,MCWP 50R,D00,518794,Staff,0,0,20,20
1713502000021,MCWP 50R,E00,518795,Staff,0,0,20,20
1713502000021,MCWP 50R,F00,518796,Staff,11,0,20,9
1713502000021,MCWP 50R,G00,518797,Staff,10,0,20,10
1713502001049,MMW 12R,A01,514034,Herbst; Matthew,3,0,16,13
1713502001049,MMW 12R,A02,514035,Herbst; Matthew,13,0,16,3
1713502002075,MMW 13R,A01,514037,Staff,0,8,16,16
1713502002075,MMW 13R,A02,514039,Staff,0,7,16,16
1713502004128,SIO 295LS,A00,523233,Staff,15,0,30,15
1713502005154,SIO 295S,A00,523232,Staff,15,0,30,15
1713502006179,SOCI 117,A01,494376,Staff,0,2,5,5
1713502007208,WES 237B,A00,494380,Staff,19,0,20,1
1713502009275,AESE 279B,A00,494370,Wade; Jon P,33,0,33,0
1713502010300,AIP 197,001,627712,Vespa; Emanuel Ignacio,9999,0,9999,0
1713502011326,ANAR 135S,A00,494369,Braswell; Geoffrey E.,0,0,0,0
1713502012351,CAT 124RS,A01,519847,Geibel; William,6,0,20,14
1713502013379,CAT 125RS,A01,515971,Geibel; William,6,0,20,14
1713502014404,CLRE 250,A00,511389,Morris; Sheldon,9996,0,9999,3
1713502015430,CLRE 251,A00,507176,Mehta; Ravindra L.,9996,0,9999,3
1713502015430,CLRE 251,B00,511410,Mehta; Ravindra L.,9998,0,9999,1
1713502016455,CLRE 252,A00,507189,Cuomo; Raphael Eduardo,9998,0,9999,1
1713502017482,CLRE 253,A00,507199,Vaida; Florin,9997,0,9999,2
1713502017482,CLRE 253,B00,507202,Vaida; Florin,9999,0,9999,0
1713502018507,CLRE 259,A00,507211,Patel; Hemal,9996,0,9999,3
1713502019535,CLRE 260,A00,507221,Cuomo; Raphael Eduardo,9999,0,9999,0
1713502020565,CLRE 297,001,507242,Cuomo; Raphael Eduardo,9999,0,9999,0
1713502021591,CSE 191,A00,516875,Minnes Kemp; Mor Mia,9999,0,9999,0
1713502022616,CSS 201S,A01,494383,Staff,35,0,35,0
1713502023646,CSS 202S,A01,494387,Staff,35,0,35,0
1713502024670,EAP 100,A00,516065,Staff,9792,0,9999,207
1713502025699,ECE 45,A01,507414,Staff,37,0,60,23
1713502026725,ECE 100,A01,507416,Baghdadchi; Saharnaz,0,0,20,20
1713502026725,ECE 100,A02,507418,Baghdadchi; Saharnaz,19,0,20,1
1713502027753,ECE 111,A01,507420,Staff,27,0,50,23
1713502028778,ECE 197,001,548057,Sievenpiper; Daniel F.,9998,0,9999,1
1713502029807,EDS 115,A00,507243,Choi; Bailey Miyeon,27,0,28,1
1713502030833,EDS 117,A01,494379,Staff,15,0,25,10
1713502031863,EDS 125,A00,507246,Hopkins; Megan Beth,27,0,30,3
1713502032943,EDS 128A,A01,507264,Fargason; Sharon Gayle,26,0,26,0
1713502033972,EDS 128B,A01,507293,Pappas; Elizabeth,30,0,30,0
1713502035000,EDS 139,A00,507294,Fargason; Sharon Gayle,30,0,30,0
1713502035000,EDS 139,B00,507313,Pappas; Elizabeth,30,0,30,0
1713502036030,EDS 201,A00,507315,Staff,18,0,30,12
1713502037055,EDS 203,A01,507317,Halter; Christopher P.,17,0,30,13
1713502038080,EDS 204R,A01,507319,Halter; Christopher P.,0,1,30,30
1713502038080,EDS 204R,B01,507331,Heinzman; Erica M.,22,0,30,8
1713502039105,EDS 206R,A00,507332,Staff,0,2,30,30
1713502039105,EDS 206R,B00,507343,Staff,23,0,30,7
1713502040130,EDS 250,A00,507344,Hemans; Patricia Ann Benitez,27,0,40,13
1713502041154,EDS 281,A00,507345,Daly; Alan J.,18,0,18,0
1713502042180,EDS 284,A00,507350,Daly; Alan J.,16,0,16,0
1713502043207,EDS 286,A00,507359,Fine; Sarah,18,0,18,0
1713502044231,EDS 289C,A01,507361,Daly; Alan J.,18,0,18,0
1713502045258,EDS 290,A00,507366,Hofstetter; Carolyn,15,0,15,0
1713502046284,LIGM 5A,A00,507421,Fischer-Grunski; Eva K,20,0,20,0
1713502047309,LIGM 5B,A00,507423,Fischer-Grunski; Eva K,20,0,20,0
1713502048337,LIGM 5C,A00,507425,Fischer-Grunski; Eva K,20,0,20,0
1713502049362,LIIT 5AS,A00,507427,Carnelos; Chiara,20,0,20,0
1713502050387,LIIT 5BS,A00,507430,Carnelos; Chiara,20,0,20,0
1713502051414,LIIT 5CS,A00,507432,Carnelos; Chiara,20,0,20,0
1713502052439,LISP 5A,A00,507541,Munoz Sanchez; Alicia,14,0,20,6
1713502053469,LISP 5B,A00,507671,Munoz Sanchez; Alicia,12,0,20,8
1713502054498,LISP 5C,A00,507696,Munoz Sanchez; Alicia,11,0,20,9
1713502055523,MAE 197,001,528363,Boechler; Nicholas Sebastia,9998,0,9999,1
1713502056549,MATH 197,001,523477,Kedlaya; Kiran S.,9999,0,9999,0
1713502056549,MATH 197,002,563811,Zhang; Danna,9998,0,9999,1
1713502057574,MCWP 40R,A00,518780,Staff,14,0,20,6
1713502057574,MCWP 40R,B00,518781,Staff,11,0,20,9
1713502057574,MCWP 40R,C00,518783,Staff,8,0,20,12
1713502058600,MCWP 50R,A00,518791,Staff,7,0,20,13
1713502058600,MCWP 50R,B00,518792,Staff,3,0,20,17
1713502058600,MCWP 50R,C00,518793,Staff,5,0,20,15
1713502058600,MCWP 50R,D00,518794,Staff,0,0,20,20
1713502058600,MCWP 50R,E00,518795,Staff,0,0,20,20
1713502058600,MCWP 50R,F00,518796,Staff,11,0,20,9
1713502058600,MCWP 50R,G00,518797,Staff,10,0,20,10
1713502059625,MMW 12R,A01,514034,Herbst; Matthew,3,0,16,13
1713502059625,MMW 12R,A02,514035,Herbst; Matthew,13,0,16,3
1713502060653,MMW 13R,A01,514037,Staff,0,8,16,16
1713502060653,MMW 13R,A02,514039,Staff,0,7,16,16
1713502062706,SIO 295LS,A00,523233,Staff,15,0,30,15
1713502063732,SIO 295S,A00,523232,Staff,15,0,30,15
1713502064757,SOCI 117,A01,494376,Staff,0,2,5,5
1713502065782,WES 237B,A00,494380,Staff,19,0,20,1
1713502067857,AESE 279B,A00,494370,Wade; Jon P,33,0,33,0
1713502068885,AIP 197,001,627712,Vespa; Emanuel Ignacio,9999,0,9999,0
1713502069914,ANAR 135S,A00,494369,Braswell; Geoffrey E.,0,0,0,0
1713502070940,CAT 124RS,A01,519847,Geibel; William,6,0,20,14
1713502071965,CAT 125RS,A01,515971,Geibel; William,6,0,20,14
1713502072991,CLRE 250,A00,511389,Morris; Sheldon,9996,0,9999,3
1713502074020,CLRE 251,A00,507176,Mehta; Ravindra L.,9996,0,9999,3
1713502074020,CLRE 251,B00,511410,Mehta; Ravindra L.,9998,0,9999,1
1713502075045,CLRE 252,A00,507189,Cuomo; Raphael Eduardo,9998,0,9999,1
1713502076069,CLRE 253,A00,507199,Vaida; Florin,9997,0,9999,2
1713502076069,CLRE 253,B00,507202,Vaida; Florin,9999,0,9999,0
1713502077099,CLRE 259,A00,507211,Patel; Hemal,9996,0,9999,3
1713502078125,CLRE 260,A00,507221,Cuomo; Raphael Eduardo,9999,0,9999,0
1713502079151,CLRE 297,001,507242,Cuomo; Raphael Eduardo,9999,0,9999,0
1713502080181,CSE 191,A00,516875,Minnes Kemp; Mor Mia,9999,0,9999,0
1713502081211,CSS 201S,A01,494383,Staff,35,0,35,0
1713502082236,CSS 202S,A01,494387,Staff,35,0,35,0
1713502083262,EAP 100,A00,516065,Staff,9792,0,9999,207
1713502084291,ECE 45,A01,507414,Staff,37,0,60,23
1713502085319,ECE 100,A01,507416,Baghdadchi; Saharnaz,0,0,20,20
1713502085319,ECE 100,A02,507418,Baghdadchi; Saharnaz,19,0,20,1
1713502086345,ECE 111,A01,507420,Staff,27,0,50,23
1713502087371,ECE 197,001,548057,Sievenpiper; Daniel F.,9998,0,9999,1
1713502088395,EDS 115,A00,507243,Choi; Bailey Miyeon,27,0,28,1
1713502089422,EDS 117,A01,494379,Staff,15,0,25,10
1713502090448,EDS 125,A00,507246,Hopkins; Megan Beth,27,0,30,3
1713502091478,EDS 128A,A01,507264,Fargason; Sharon Gayle,26,0,26,0
1713502092507,EDS 128B,A01,507293,Pappas; Elizabeth,30,0,30,0
1713502093533,EDS 139,A00,507294,Fargason; Sharon Gayle,30,0,30,0
1713502093533,EDS 139,B00,507313,Pappas; Elizabeth,30,0,30,0
1713502094559,EDS 201,A00,507315,Staff,18,0,30,12
1713502095588,EDS 203,A01,507317,Halter; Christopher P.,17,0,30,13
1713502096614,EDS 204R,A01,507319,Halter; Christopher P.,0,1,30,30
1713502096614,EDS 204R,B01,507331,Heinzman; Erica M.,22,0,30,8
1713502097643,EDS 206R,A00,507332,Staff,0,2,30,30
1713502097643,EDS 206R,B00,507343,Staff,23,0,30,7
1713502098668,EDS 250,A00,507344,Hemans; Patricia Ann Benitez,27,0,40,13
1713502099691,EDS 281,A00,507345,Daly; Alan J.,18,0,18,0
1713502100717,EDS 284,A00,507350,Daly; Alan J.,16,0,16,0
1713502101743,EDS 286,A00,507359,Fine; Sarah,18,0,18,0
1713502102769,EDS 289C,A01,507361,Daly; Alan J.,18,0,18,0
1713502103795,EDS 290,A00,507366,Hofstetter; Carolyn,15,0,15,0
1713502104824,LIGM 5A,A00,507421,Fischer-Grunski; Eva K,20,0,20,0
1713502105853,LIGM 5B,A00,507423,Fischer-Grunski; Eva K,20,0,20,0
1713502106879,LIGM 5C,A00,507425,Fischer-Grunski; Eva K,20,0,20,0
1713502107905,LIIT 5AS,A00,507427,Carnelos; Chiara,20,0,20,0
1713502108935,LIIT 5BS,A00,507430,Carnelos; Chiara,20,0,20,0
1713502109964,LIIT 5CS,A00,507432,Carnelos; Chiara,20,0,20,0
1713502110994,LISP 5A,A00,507541,Munoz Sanchez; Alicia,14,0,20,6
1713502112023,LISP 5B,A00,507671,Munoz Sanchez; Alicia,12,0,20,8
1713502113052,LISP 5C,A00,507696,Munoz Sanchez; Alicia,11,0,20,9
1713502114077,MAE 197,001,528363,Boechler; Nicholas Sebastia,9998,0,9999,1
1713502115103,MATH 197,001,523477,Kedlaya; Kiran S.,9999,0,9999,0
1713502115103,MATH 197,002,563811,Zhang; Danna,9998,0,9999,1
1713502116128,MCWP 40R,A00,518780,Staff,14,0,20,6
1713502116128,MCWP 40R,B00,518781,Staff,11,0,20,9
1713502116128,MCWP 40R,C00,518783,Staff,8,0,20,12
1713502117153,MCWP 50R,A00,518791,Staff,7,0,20,13
1713502117153,MCWP 50R,B00,518792,Staff,3,0,20,17
1713502117153,MCWP 50R,C00,518793,Staff,5,0,20,15
1713502117153,MCWP 50R,D00,518794,Staff,0,0,20,20
1713502117153,MCWP 50R,E00,518795,Staff,0,0,20,20
1713502117153,MCWP 50R,F00,518796,Staff,11,0,20,9
1713502117153,MCWP 50R,G00,518797,Staff,10,0,20,10
1713502118179,MMW 12R,A01,514034,Herbst; Matthew,3,0,16,13
1713502118179,MMW 12R,A02,514035,Herbst; Matthew,13,0,16,3
1713502119203,MMW 13R,A01,514037,Staff,0,8,16,16
1713502119203,MMW 13R,A02,514039,Staff,0,7,16,16
1713502121261,SIO 295LS,A00,523233,Staff,15,0,30,15
1713502122285,SIO 295S,A00,523232,Staff,15,0,30,15
1713502123311,SOCI 117,A01,494376,Staff,0,2,5,5
1713502124337,WES 237B,A00,494380,Staff,19,0,20,1
1713502126399,AESE 279B,A00,494370,Wade; Jon P,33,0,33,0
1713502127425,AIP 197,001,627712,Vespa; Emanuel Ignacio,9999,0,9999,0
1713502128450,ANAR 135S,A00,494369,Braswell; Geoffrey E.,0,0,0,0
1713502129477,CAT 124RS,A01,519847,Geibel; William,6,0,20,14
1713502130503,CAT 125RS,A01,515971,Geibel; William,6,0,20,14
1713502131528,CLRE 250,A00,511389,Morris; Sheldon,9996,0,9999,3
1713502132554,CLRE 251,A00,507176,Mehta; Ravindra L.,9996,0,9999,3
1713502132554,CLRE 251,B00,511410,Mehta; Ravindra L.,9998,0,9999,1
1713502133583,CLRE 252,A00,507189,Cuomo; Raphael Eduardo,9998,0,9999,1
1713502134608,CLRE 253,A00,507199,Vaida; Florin,9997,0,9999,2
1713502134608,CLRE 253,B00,507202,Vaida; Florin,9999,0,9999,0
1713502135632,CLRE 259,A00,507211,Patel; Hemal,9996,0,9999,3
1713502136712,CLRE 260,A00,507221,Cuomo; Raphael Eduardo,9999,0,9999,0
1713502137735,CLRE 297,001,507242,Cuomo; Raphael Eduardo,9999,0,9999,0
1713502138763,CSE 191,A00,516875,Minnes Kemp; Mor Mia,9999,0,9999,0
1713502139789,CSS 201S,A01,494383,Staff,35,0,35,0
1713502140814,CSS 202S,A01,494387,Staff,35,0,35,0
1713502141839,EAP 100,A00,516065,Staff,9792,0,9999,207
1713502142864,ECE 45,A01,507414,Staff,37,0,60,23
1713502143901,ECE 100,A01,507416,Baghdadchi; Saharnaz,0,0,20,20
1713502143901,ECE 100,A02,507418,Baghdadchi; Saharnaz,19,0,20,1
1713502144929,ECE 111,A01,507420,Staff,27,0,50,23
1713502145953,ECE 197,001,548057,Sievenpiper; Daniel F.,9998,0,9999,1
1713502146979,EDS 115,A00,507243,Choi; Bailey Miyeon,27,0,28,1
1713502148007,EDS 117,A01,494379,Staff,15,0,25,10
1713502149031,EDS 125,A00,507246,Hopkins; Megan Beth,27,0,30,3
1713502150061,EDS 128A,A01,507264,Fargason; Sharon Gayle,26,0,26,0
1713502151091,EDS 128B,A01,507293,Pappas; Elizabeth,30,0,30,0
1713502152116,EDS 139,A00,507294,Fargason; Sharon Gayle,30,0,30,0
1713502152116,EDS 139,B00,507313,Pappas; Elizabeth,30,0,30,0
1713502153142,EDS 201,A00,507315,Staff,18,0,30,12
1713502154172,EDS 203,A01,507317,Halter; Christopher P.,17,0,30,13
1713502155198,EDS 204R,A01,507319,Halter; Christopher P.,0,1,30,30
1713502155198,EDS 204R,B01,507331,Heinzman; Erica M.,22,0,30,8
1713502156227,EDS 206R,A00,507332,Staff,0,2,30,30
1713502156227,EDS 206R,B00,507343,Staff,23,0,30,7
1713502157270,EDS 250,A00,507344,Hemans; Patricia Ann Benitez,27,0,40,13
1713502158298,EDS 281,A00,507345,Daly; Alan J.,18,0,18,0
1713502159324,EDS 284,A00,507350,Daly; Alan J.,16,0,16,0
1713502160562,EDS 286,A00,507359,Fine; Sarah,18,0,18,0
1713502161589,EDS 289C,A01,507361,Daly; Alan J.,18,0,18,0
1713502162617,EDS 290,A00,507366,Hofstetter; Carolyn,15,0,15,0
1713502163643,LIGM 5A,A00,507421,Fischer-Grunski; Eva K,20,0,20,0
1713502164669,LIGM 5B,A00,507423,Fischer-Grunski; Eva K,20,0,20,0
1713502165693,LIGM 5C,A00,507425,Fischer-Grunski; Eva K,20,0,20,0
1713502166719,LIIT 5AS,A00,507427,Carnelos; Chiara,20,0,20,0
1713502167743,LIIT 5BS,A00,507430,Carnelos; Chiara,20,0,20,0
1713502168769,LIIT 5CS,A00,507432,Carnelos; Chiara,20,0,20,0
1713502169794,LISP 5A,A00,507541,Munoz Sanchez; Alicia,14,0,20,6
1713502170819,LISP 5B,A00,507671,Munoz Sanchez; Alicia,12,0,20,8
1713502171845,LISP 5C,A00,507696,Munoz Sanchez; Alicia,11,0,20,9
1713502172874,MAE 197,001,528363,Boechler; Nicholas Sebastia,9998,0,9999,1
1713502173904,MATH 197,001,523477,Kedlaya; Kiran S.,9999,0,9999,0
1713502173904,MATH 197,002,563811,Zhang; Danna,9998,0,9999,1
1713502174930,MCWP 40R,A00,518780,Staff,14,0,20,6
1713502174930,MCWP 40R,B00,518781,Staff,11,0,20,9
1713502174930,MCWP 40R,C00,518783,Staff,8,0,20,12
1713502175957,MCWP 50R,A00,518791,Staff,7,0,20,13
1713502175957,MCWP 50R,B00,518792,Staff,3,0,20,17
1713502175957,MCWP 50R,C00,518793,Staff,5,0,20,15
1713502175957,MCWP 50R,D00,518794,Staff,0,0,20,20
1713502175957,MCWP 50R,E00,518795,Staff,0,0,20,20
1713502175957,MCWP 50R,F00,518796,Staff,11,0,20,9
1713502175957,MCWP 50R,G00,518797,Staff,10,0,20,10
1713502176986,MMW 12R,A01,514034,Herbst; Matthew,3,0,16,13
1713502176986,MMW 12R,A02,514035,Herbst; Matthew,13,0,16,3
1713502178012,MMW 13R,A01,514037,Staff,0,8,16,16
1713502178012,MMW 13R,A02,514039,Staff,0,7,16,16
1713502180067,SIO 295LS,A00,523233,Staff,15,0,30,15
1713502181092,SIO 295S,A00,523232,Staff,15,0,30,15
1713502182119,SOCI 117,A01,494376,Staff,0,2,5,5
1713502183146,WES 237B,A00,494380,Staff,19,0,20,1
1713502185214,AESE 279B,A00,494370,Wade; Jon P,33,0,33,0
1713502186240,AIP 197,001,627712,Vespa; Emanuel Ignacio,9999,0,9999,0
1713502187266,ANAR 135S,A00,494369,Braswell; Geoffrey E.,0,0,0,0
1713502188292,CAT 124RS,A01,519847,Geibel; William,6,0,20,14
1713502189317,CAT 125RS,A01,515971,Geibel; William,6,0,20,14
1713502190342,CLRE 250,A00,511389,Morris; Sheldon,9996,0,9999,3
1713502191368,CLRE 251,A00,507176,Mehta; Ravindra L.,9996,0,9999,3
1713502191368,CLRE 251,B00,511410,Mehta; Ravindra L.,9998,0,9999,1
1713502192397,CLRE 252,A00,507189,Cuomo; Raphael Eduardo,9998,0,9999,1
1713502193424,CLRE 253,A00,507199,Vaida; Florin,9997,0,9999,2
1713502193424,CLRE 253,B00,507202,Vaida; Florin,9999,0,9999,0
1713502194449,CLRE 259,A00,507211,Patel; Hemal,9996,0,9999,3
1713502195476,CLRE 260,A00,507221,Cuomo; Raphael Eduardo,9999,0,9999,0
1713502196505,CLRE 297,001,507242,Cuomo; Raphael Eduardo,9999,0,9999,0
1713502197530,CSE 191,A00,516875,Minnes Kemp; Mor Mia,9999,0,9999,0
1713502198556,CSS 201S,A01,494383,Staff,35,0,35,0
1713502199582,CSS 202S,A01,494387,Staff,35,0,35,0
1713502200607,EAP 100,A00,516065,Staff,9792,0,9999,207
1713502201634,ECE 45,A01,507414,Staff,37,0,60,23
1713502202659,ECE 100,A01,507416,Baghdadchi; Saharnaz,0,0,20,20
1713502202659,ECE 100,A02,507418,Baghdadchi; Saharnaz,19,0,20,1
1713502203685,ECE 111,A01,507420,Staff,27,0,50,23
1713502204709,ECE 197,001,548057,Sievenpiper; Daniel F.,9998,0,9999,1
1713502205735,EDS 115,A00,507243,Choi; Bailey Miyeon,27,0,28,1
1713502206761,EDS 117,A01,494379,Staff,15,0,25,10
1713502207789,EDS 125,A00,507246,Hopkins; Megan Beth,27,0,30,3
1713502208814,EDS 128A,A01,507264,Fargason; Sharon Gayle,26,0,26,0
1713502209840,EDS 128B,A01,507293,Pappas; Elizabeth,30,0,30,0
1713502210868,EDS 139,A00,507294,Fargason; Sharon Gayle,30,0,30,0
1713502210868,EDS 139,B00,507313,Pappas; Elizabeth,30,0,30,0
1713502211896,EDS 201,A00,507315,Staff,18,0,30,12
1713502212925,EDS 203,A01,507317,Halter; Christopher P.,17,0,30,13
1713502213953,EDS 204R,A01,507319,Halter; Christopher P.,0,1,30,30
1713502213953,EDS 204R,B01,507331,Heinzman; Erica M.,22,0,30,8
1713502214982,EDS 206R,A00,507332,Staff,0,2,30,30
1713502214982,EDS 206R,B00,507343,Staff,23,0,30,7
1713502216009,EDS 250,A00,507344,Hemans; Patricia Ann Benitez,27,0,40,13
1713502217034,EDS 281,A00,507345,Daly; Alan J.,18,0,18,0
1713502218059,EDS 284,A00,507350,Daly; Alan J.,16,0,16,0
1713502219085,EDS 286,A00,507359,Fine; Sarah,18,0,18,0
1713502220109,EDS 289C,A01,507361,Daly; Alan J.,18,0,18,0
1713502221135,EDS 290,A00,507366,Hofstetter; Carolyn,15,0,15,0
1713502222163,LIGM 5A,A00,507421,Fischer-Grunski; Eva K,20,0,20,0
1713502223188,LIGM 5B,A00,507423,Fischer-Grunski; Eva K,20,0,20,0
1713502224215,LIGM 5C,A00,507425,Fischer-Grunski; Eva K,20,0,20,0
1713502225241,LIIT 5AS,A00,507427,Carnelos; Chiara,20,0,20,0
1713502226271,LIIT 5BS,A00,507430,Carnelos; Chiara,20,0,20,0
1713502227296,LIIT 5CS,A00,507432,Carnelos; Chiara,20,0,20,0
1713502228321,LISP 5A,A00,507541,Munoz Sanchez; Alicia,14,0,20,6
1713502229347,LISP 5B,A00,507671,Munoz Sanchez; Alicia,12,0,20,8
1713502230371,LISP 5C,A00,507696,Munoz Sanchez; Alicia,11,0,20,9
1713502231399,MAE 197,001,528363,Boechler; Nicholas Sebastia,9998,0,9999,1
1713502232426,MATH 197,001,523477,Kedlaya; Kiran S.,9999,0,9999,0
1713502232426,MATH 197,002,563811,Zhang; Danna,9998,0,9999,1
1713502233451,MCWP 40R,A00,518780,Staff,14,0,20,6
1713502233451,MCWP 40R,B00,518781,Staff,11,0,20,9
1713502233451,MCWP 40R,C00,518783,Staff,8,0,20,12
1713502234480,MCWP 50R,A00,518791,Staff,7,0,20,13
1713502234480,MCWP 50R,B00,518792,Staff,3,0,20,17
1713502234480,MCWP 50R,C00,518793,Staff,5,0,20,15
1713502234480,MCWP 50R,D00,518794,Staff,0,0,20,20
1713502234480,MCWP 50R,E00,518795,Staff,0,0,20,20
1713502234480,MCWP 50R,F00,518796,Staff,11,0,20,9
1713502234480,MCWP 50R,G00,518797,Staff,10,0,20,10
1713502235508,MMW 12R,A01,514034,Herbst; Matthew,3,0,16,13
1713502235508,MMW 12R,A02,514035,Herbst; Matthew,13,0,16,3
1713502236532,MMW 13R,A01,514037,Staff,0,8,16,16
1713502236532,MMW 13R,A02,514039,Staff,0,7,16,16
1713502238587,SIO 295LS,A00,523233,Staff,15,0,30,15
1713502239617,SIO 295S,A00,523232,Staff,15,0,30,15
1713502240698,SOCI 117,A01,494376,Staff,0,2,5,5
1713502241726,WES 237B,A00,494380,Staff,19,0,20,1
1713502243795,AESE 279B,A00,494370,Wade; Jon P,33,0,33,0
1713502244820,AIP 197,001,627712,Vespa; Emanuel Ignacio,9999,0,9999,0
1713502245845,ANAR 135S,A00,494369,Braswell; Geoffrey E.,0,0,0,0
1713502246874,CAT 124RS,A01,519847,Geibel; William,6,0,20,14
1713502247902,CAT 125RS,A01,515971,Geibel; William,6,0,20,14
1713502248930,CLRE 250,A00,511389,Morris; Sheldon,9996,0,9999,3
1713502249962,CLRE 251,A00,507176,Mehta; Ravindra L.,9996,0,9999,3
1713502249962,CLRE 251,B00,511410,Mehta; Ravindra L.,9998,0,9999,1
1713502250990,CLRE 252,A00,507189,Cuomo; Raphael Eduardo,9998,0,9999,1
1713502252016,CLRE 253,A00,507199,Vaida; Florin,9997,0,9999,2
1713502252016,CLRE 253,B00,507202,Vaida; Florin,9999,0,9999,0
1713502253046,CLRE 259,A00,507211,Patel; Hemal,9996,0,9999,3
1713502254073,CLRE 260,A00,507221,Cuomo; Raphael Eduardo,9999,0,9999,0
1713502255099,CLRE 297,001,507242,Cuomo; Raphael Eduardo,9999,0,9999,0
1713502256128,CSE 191,A00,516875,Minnes Kemp; Mor Mia,9999,0,9999,0
1713502257153,CSS 201S,A01,494383,Staff,35,0,35,0
1713502258182,CSS 202S,A01,494387,Staff,35,0,35,0
1713502259207,EAP 100,A00,516065,Staff,9792,0,9999,207
1713502260234,ECE 45,A01,507414,Staff,37,0,60,23
1713502261260,ECE 100,A01,507416,Baghdadchi; Saharnaz,0,0,20,20
1713502261260,ECE 100,A02,507418,Baghdadchi; Saharnaz,19,0,20,1
1713502262286,ECE 111,A01,507420,Staff,27,0,50,23
1713502263316,ECE 197,001,548057,Sievenpiper; Daniel F.,9998,0,9999,1
1713502264341,EDS 115,A00,507243,Choi; Bailey Miyeon,27,0,28,1
1713502265369,EDS 117,A01,494379,Staff,15,0,25,10
1713502266399,EDS 125,A00,507246,Hopkins; Megan Beth,27,0,30,3
1713502267424,EDS 128A,A01,507264,Fargason; Sharon Gayle,26,0,26,0
1713502268452,EDS 128B,A01,507293,Pappas; Elizabeth,30,0,30,0
1713502269478,EDS 139,A00,507294,Fargason; Sharon Gayle,30,0,30,0
1713502269478,EDS 139,B00,507313,Pappas; Elizabeth,30,0,30,0
1713502270502,EDS 201,A00,507315,Staff,18,0,30,12
1713502271532,EDS 203,A01,507317,Halter; Christopher P.,17,0,30,13
1713502272558,EDS 204R,A01,507319,Halter; Christopher P.,0,1,30,30
1713502272558,EDS 204R,B01,507331,Heinzman; Erica M.,22,0,30,8
1713502273587,EDS 206R,A00,507332,Staff,0,2,30,30
1713502273587,EDS 206R,B00,507343,Staff,23,0,30,7
1713502274613,EDS 250,A00,507344,Hemans; Patricia Ann Benitez,27,0,40,13
1713502275641,EDS 281,A00,507345,Daly; Alan J.,18,0,18,0
1713502276667,EDS 284,A00,507350,Daly; Alan J.,16,0,16,0
1713502277692,EDS 286,A00,507359,Fine; Sarah,18,0,18,0
1713502278717,EDS 289C,A01,507361,Daly; Alan J.,18,0,18,0
1713502279742,EDS 290,A00,507366,Hofstetter; Carolyn,15,0,15,0
1713502280770,LIGM 5A,A00,507421,Fischer-Grunski; Eva K,20,0,20,0
1713502281796,LIGM 5B,A00,507423,Fischer-Grunski; Eva K,20,0,20,0
1713502282820,LIGM 5C,A00,507425,Fischer-Grunski; Eva K,20,0,20,0
1713502283863,LIIT 5AS,A00,507427,Carnelos; Chiara,20,0,20,0
1713502284893,LIIT 5BS,A00,507430,Carnelos; Chiara,20,0,20,0
1713502285923,LIIT 5CS,A00,507432,Carnelos; Chiara,20,0,20,0
1713502286952,LISP 5A,A00,507541,Munoz Sanchez; Alicia,14,0,20,6
1713502287982,LISP 5B,A00,507671,Munoz Sanchez; Alicia,12,0,20,8
1713502289009,LISP 5C,A00,507696,Munoz Sanchez; Alicia,11,0,20,9
1713502290034,MAE 197,001,528363,Boechler; Nicholas Sebastia,9998,0,9999,1
1713502291059,MATH 197,001,523477,Kedlaya; Kiran S.,9999,0,9999,0
1713502291059,MATH 197,002,563811,Zhang; Danna,9998,0,9999,1
1713502292088,MCWP 40R,A00,518780,Staff,14,0,20,6
1713502292088,MCWP 40R,B00,518781,Staff,11,0,20,9
1713502292088,MCWP 40R,C00,518783,Staff,8,0,20,12
1713502293114,MCWP 50R,A00,518791,Staff,7,0,20,13
1713502293114,MCWP 50R,B00,518792,Staff,3,0,20,17
1713502293114,MCWP 50R,C00,518793,Staff,5,0,20,15
1713502293114,MCWP 50R,D00,518794,Staff,0,0,20,20
1713502293114,MCWP 50R,E00,518795,Staff,0,0,20,20
1713502293114,MCWP 50R,F00,518796,Staff,11,0,20,9
1713502293114,MCWP 50R,G00,518797,Staff,10,0,20,10
1713502294140,MMW 12R,A01,514034,Herbst; Matthew,3,0,16,13
1713502294140,MMW 12R,A02,514035,Herbst; Matthew,13,0,16,3
1713502295168,MMW 13R,A01,514037,Staff,0,8,16,16
1713502295168,MMW 13R,A02,514039,Staff,0,7,16,16
1713502297218,SIO 295LS,A00,523233,Staff,15,0,30,15
1713502298247,SIO 295S,A00,523232,Staff,15,0,30,15
1713502299275,SOCI 117,A01,494376,Staff,0,2,5,5
1713502300300,WES 237B,A00,494380,Staff,19,0,20,1
1713502302372,AESE 279B,A00,494370,Wade; Jon P,33,0,33,0
1713502303399,AIP 197,001,627712,Vespa; Emanuel Ignacio,9999,0,9999,0
1713502304427,ANAR 135S,A00,494369,Braswell; Geoffrey E.,0,0,0,0
1713502305452,CAT 124RS,A01,519847,Geibel; William,6,0,20,14
1713502306477,CAT 125RS,A01,515971,Geibel; William,6,0,20,14
1713502307507,CLRE 250,A00,511389,Morris; Sheldon,9996,0,9999,3
1713502308533,CLRE 251,A00,507176,Mehta; Ravindra L.,9996,0,9999,3
1713502308533,CLRE 251,B00,511410,Mehta; Ravindra L.,9998,0,9999,1
1713502309557,CLRE 252,A00,507189,Cuomo; Raphael Eduardo,9998,0,9999,1
1713502310583,CLRE 253,A00,507199,Vaida; Florin,9997,0,9999,2
1713502310583,CLRE 253,B00,507202,Vaida; Florin,9999,0,9999,0
1713502311611,CLRE 259,A00,507211,Patel; Hemal,9996,0,9999,3
1713502312638,CLRE 260,A00,507221,Cuomo; Raphael Eduardo,9999,0,9999,0
1713502313665,CLRE 297,001,507242,Cuomo; Raphael Eduardo,9999,0,9999,0
1713502314690,CSE 191,A00,516875,Minnes Kemp; Mor Mia,9999,0,9999,0
1713502315719,CSS 201S,A01,494383,Staff,35,0,35,0
1713502316744,CSS 202S,A01,494387,Staff,35,0,35,0
1713502317770,EAP 100,A00,516065,Staff,9792,0,9999,207
1713502318795,ECE 45,A01,507414,Staff,37,0,60,23
1713502319825,ECE 100,A01,507416,Baghdadchi; Saharnaz,0,0,20,20
1713502319825,ECE 100,A02,507418,Baghdadchi; Saharnaz,19,0,20,1
1713502320851,ECE 111,A01,507420,Staff,27,0,50,23
1713502321876,ECE 197,001,548057,Sievenpiper; Daniel F.,9998,0,9999,1
1713502322902,EDS 115,A00,507243,Choi; Bailey Miyeon,27,0,28,1
1713502323928,EDS 117,A01,494379,Staff,15,0,25,10
1713502324954,EDS 125,A00,507246,Hopkins; Megan Beth,27,0,30,3
1713502325979,EDS 128A,A01,507264,Fargason; Sharon Gayle,26,0,26,0
1713502327005,EDS 128B,A01,507293,Pappas; Elizabeth,30,0,30,0
1713502328034,EDS 139,A00,507294,Fargason; Sharon Gayle,30,0,30,0
1713502328034,EDS 139,B00,507313,Pappas; Elizabeth,30,0,30,0
1713502329060,EDS 201,A00,507315,Staff,18,0,30,12
1713502330086,EDS 203,A01,507317,Halter; Christopher P.,17,0,30,13
1713502331111,EDS 204R,A01,507319,Halter; Christopher P.,0,1,30,30
1713502331111,EDS 204R,B01,507331,Heinzman; Erica M.,22,0,30,8
1713502332137,EDS 206R,A00,507332,Staff,0,2,30,30
1713502332137,EDS 206R,B00,507343,Staff,23,0,30,7
1713502333162,EDS 250,A00,507344,Hemans; Patricia Ann Benitez,27,0,40,13
1713502334189,EDS 281,A00,507345,Daly; Alan J.,18,0,18,0
1713502335212,EDS 284,A00,507350,Daly; Alan J.,16,0,16,0
1713502336237,EDS 286,A00,507359,Fine; Sarah,18,0,18,0
1713502337262,EDS 289C,A01,507361,Daly; Alan J.,18,0,18,0
1713502338286,EDS 290,A00,507366,Hofstetter; Carolyn,15,0,15,0
1713502339315,LIGM 5A,A00,507421,Fischer-Grunski; Eva K,20,0,20,0
1713502340343,LIGM 5B,A00,507423,Fischer-Grunski; Eva K,20,0,20,0
1713502341369,LIGM 5C,A00,507425,Fischer-Grunski; Eva K,20,0,20,0
1713502342393,LIIT 5AS,A00,507427,Carnelos; Chiara,20,0,20,0
1713502343419,LIIT 5BS,A00,507430,Carnelos; Chiara,20,0,20,0
1713502344499,LIIT 5CS,A00,507432,Carnelos; Chiara,20,0,20,0
1713502345527,LISP 5A,A00,507541,Munoz Sanchez; Alicia,14,0,20,6
1713502346552,LISP 5B,A00,507671,Munoz Sanchez; Alicia,12,0,20,8
1713502347580,LISP 5C,A00,507696,Munoz Sanchez; Alicia,11,0,20,9
1713502348605,MAE 197,001,528363,Boechler; Nicholas Sebastia,9998,0,9999,1
1713502349630,MATH 197,001,523477,Kedlaya; Kiran S.,9999,0,9999,0
1713502349630,MATH 197,002,563811,Zhang; Danna,9998,0,9999,1
1713502350661,MCWP 40R,A00,518780,Staff,14,0,20,6
1713502350661,MCWP 40R,B00,518781,Staff,11,0,20,9
1713502350661,MCWP 40R,C00,518783,Staff,8,0,20,12
1713502351688,MCWP 50R,A00,518791,Staff,7,0,20,13
1713502351688,MCWP 50R,B00,518792,Staff,3,0,20,17
1713502351688,MCWP 50R,C00,518793,Staff,5,0,20,15
1713502351688,MCWP 50R,D00,518794,Staff,0,0,20,20
1713502351688,MCWP 50R,E00,518795,Staff,0,0,20,20
1713502351688,MCWP 50R,F00,518796,Staff,11,0,20,9
1713502351688,MCWP 50R,G00,518797,Staff,10,0,20,10
1713502352712,MMW 12R,A01,514034,Herbst; Matthew,3,0,16,13
1713502352712,MMW 12R,A02,514035,Herbst; Matthew,13,0,16,3
1713502353741,MMW 13R,A01,514037,Staff,0,8,16,16
1713502353741,MMW 13R,A02,514039,Staff,0,7,16,16
1713502355796,SIO 295LS,A00,523233,Staff,15,0,30,15
1713502356822,SIO 295S,A00,523232,Staff,15,0,30,15
1713502357848,SOCI 117,A01,494376,Staff,0,2,5,5
1713502358875,WES 237B,A00,494380,Staff,19,0,20,1
1713502360935,AESE 279B,A00,494370,Wade; Jon P,33,0,33,0
1713502361960,AIP 197,001,627712,Vespa; Emanuel Ignacio,9999,0,9999,0
1713502362984,ANAR 135S,A00,494369,Braswell; Geoffrey E.,0,0,0,0
1713502364010,CAT 124RS,A01,519847,Geibel; William,6,0,20,14
1713502365036,CAT 125RS,A01,515971,Geibel; William,6,0,20,14
1713502366061,CLRE 250,A00,511389,Morris; Sheldon,9996,0,9999,3
1713502367087,CLRE 251,A00,507176,Mehta; Ravindra L.,9996,0,9999,3
1713502367087,CLRE 251,B00,511410,Mehta; Ravindra L.,9998,0,9999,1
1713502368113,CLRE 252,A00,507189,Cuomo; Raphael Eduardo,9998,0,9999,1
1713502369139,CLRE 253,A00,507199,Vaida; Florin,9997,0,9999,2
1713502369139,CLRE 253,B00,507202,Vaida; Florin,9999,0,9999,0
1713502370164,CLRE 259,A00,507211,Patel; Hemal,9996,0,9999,3
1713502371192,CLRE 260,A00,507221,Cuomo; Raphael Eduardo,9999,0,9999,0
1713502372219,CLRE 297,001,507242,Cuomo; Raphael Eduardo,9999,0,9999,0
1713502373245,CSE 191,A00,516875,Minnes Kemp; Mor Mia,9999,0,9999,0
1713502374272,CSS 201S,A01,494383,Staff,35,0,35,0
1713502375297,CSS 202S,A01,494387,Staff,35,0,35,0
1713502376322,EAP 100,A00,516065,Staff,9792,0,9999,207
1713502377347,ECE 45,A01,507414,Staff,37,0,60,23
1713502378374,ECE 100,A01,507416,Baghdadchi; Saharnaz,0,0,20,20
1713502378374,ECE 100,A02,507418,Baghdadchi; Saharnaz,19,0,20,1
1713502379400,ECE 111,A01,507420,Staff,27,0,50,23
1713502380426,ECE 197,001,548057,Sievenpiper; Daniel F.,9998,0,9999,1
1713502381452,EDS 115,A00,507243,Choi; Bailey Miyeon,27,0,28,1
1713502382477,EDS 117,A01,494379,Staff,15,0,25,10
1713502383505,EDS 125,A00,507246,Hopkins; Megan Beth,27,0,30,3
1713502384534,EDS 128A,A01,507264,Fargason; Sharon Gayle,26,0,26,0
1713502385563,EDS 128B,A01,507293,Pappas; Elizabeth,30,0,30,0
1713502386591,EDS 139,A00,507294,Fargason; Sharon Gayle,30,0,30,0
1713502386591,EDS 139,B00,507313,Pappas; Elizabeth,30,0,30,0
1713502387618,EDS 201,A00,507315,Staff,18,0,30,12
1713502388647,EDS 203,A01,507317,Halter; Christopher P.,17,0,30,13
1713502389673,EDS 204R,A01,507319,Halter; Christopher P.,0,1,30,30
1713502389673,EDS 204R,B01,507331,Heinzman; Erica M.,22,0,30,8
1713502390699,EDS 206R,A00,507332,Staff,0,2,30,30
1713502390699,EDS 206R,B00,507343,Staff,23,0,30,7
1713502391729,EDS 250,A00,507344,Hemans; Patricia Ann Benitez,27,0,40,13
1713502392757,EDS 281,A00,507345,Daly; Alan J.,18,0,18,0
1713502393785,EDS 284,A00,507350,Daly; Alan J.,16,0,16,0
1713502394813,EDS 286,A00,507359,Fine; Sarah,18,0,18,0
1713502395840,EDS 289C,A01,507361,Daly; Alan J.,18,0,18,0
1713502396865,EDS 290,A00,507366,Hofstetter; Carolyn,15,0,15,0
1713502397892,LIGM 5A,A00,507421,Fischer-Grunski; Eva K,20,0,20,0
1713502398917,LIGM 5B,A00,507423,Fischer-Grunski; Eva K,20,0,20,0
1713502399941,LIGM 5C,A00,507425,Fischer-Grunski; Eva K,20,0,20,0
1713502400967,LIIT 5AS,A00,507427,Carnelos; Chiara,20,0,20,0
1713502401992,LIIT 5BS,A00,507430,Carnelos; Chiara,20,0,20,0
1713502403018,LIIT 5CS,A00,507432,Carnelos; Chiara,20,0,20,0
1713502404042,LISP 5A,A00,507541,Munoz Sanchez; Alicia,14,0,20,6
1713502405072,LISP 5B,A00,507671,Munoz Sanchez; Alicia,12,0,20,8
1713502406101,LISP 5C,A00,507696,Munoz Sanchez; Alicia,11,0,20,9
1713502407130,MAE 197,001,528363,Boechler; Nicholas Sebastia,9998,0,9999,1
1713502408159,MATH 197,001,523477,Kedlaya; Kiran S.,9999,0,9999,0
1713502408159,MATH 197,002,563811,Zhang; Danna,9998,0,9999,1
1713502409188,MCWP 40R,A00,518780,Staff,14,0,20,6
1713502409188,MCWP 40R,B00,518781,Staff,11,0,20,9
1713502409188,MCWP 40R,C00,518783,Staff,8,0,20,12
1713502410218,MCWP 50R,A00,518791,Staff,7,0,20,13
1713502410218,MCWP 50R,B00,518792,Staff,3,0,20,17
1713502410218,MCWP 50R,C00,518793,Staff,5,0,20,15
1713502410218,MCWP 50R,D00,518794,Staff,0,0,20,20
1713502410218,MCWP 50R,E00,518795,Staff,0,0,20,20
1713502410218,MCWP 50R,F00,518796,Staff,11,0,20,9
1713502410218,MCWP 50R,G00,518797,Staff,10,0,20,10
1713502411247,MMW 12R,A01,514034,Herbst; Matthew,3,0,16,13
1713502411247,MMW 12R,A02,514035,Herbst; Matthew,13,0,16,3
1713502412278,MMW 13R,A01,514037,Staff,0,8,16,16
1713502412278,MMW 13R,A02,514039,Staff,0,7,16,16
1713502414331,SIO 295LS,A00,523233,Staff,15,0,30,15
1713502415359,SIO 295S,A00,523232,Staff,15,0,30,15
1713502416385,SOCI 117,A01,494376,Staff,0,2,5,5
1713502417413,WES 237B,A00,494380,Staff,19,0,20,1
1713502419481,AESE 279B,A00,494370,Wade; Jon P,33,0,33,0
1713502420506,AIP 197,001,627712,Vespa; Emanuel Ignacio,9999,0,9999,0
1713502421535,ANAR 135S,A00,494369,Braswell; Geoffrey E.,0,0,0,0
1713502422560,CAT 124RS,A01,519847,Geibel; William,6,0,20,14
1713502423587,CAT 125RS,A01,515971,Geibel; William,6,0,20,14
1713502424617,CLRE 250,A00,511389,Morris; Sheldon,9996,0,9999,3
1713502425643,CLRE 251,A00,507176,Mehta; Ravindra L.,9996,0,9999,3
1713502425643,CLRE 251,B00,511410,Mehta; Ravindra L.,9998,0,9999,1
1713502426669,CLRE 252,A00,507189,Cuomo; Raphael Eduardo,9998,0,9999,1
1713502427694,CLRE 253,A00,507199,Vaida; Florin,9997,0,9999,2
1713502427694,CLRE 253,B00,507202,Vaida; Florin,9999,0,9999,0
1713502428718,CLRE 259,A00,507211,Patel; Hemal,9996,0,9999,3
1713502429744,CLRE 260,A00,507221,Cuomo; Raphael Eduardo,9999,0,9999,0
1713502430770,CLRE 297,001,507242,Cuomo; Raphael Eduardo,9999,0,9999,0
1713502431795,CSE 191,A00,516875,Minnes Kemp; Mor Mia,9999,0,9999,0
1713502432821,CSS 201S,A01,494383,Staff,35,0,35,0
1713502433847,CSS 202S,A01,494387,Staff,35,0,35,0
1713502434872,EAP 100,A00,516065,Staff,9792,0,9999,207
1713502435901,ECE 45,A01,507414,Staff,37,0,60,23
1713502436930,ECE 100,A01,507416,Baghdadchi; Saharnaz,0,0,20,20
1713502436930,ECE 100,A02,507418,Baghdadchi; Saharnaz,19,0,20,1
1713502437956,ECE 111,A01,507420,Staff,27,0,50,23
1713502438983,ECE 197,001,548057,Sievenpiper; Daniel F.,9998,0,9999,1
1713502440009,EDS 115,A00,507243,Choi; Bailey Miyeon,27,0,28,1
1713502441037,EDS 117,A01,494379,Staff,15,0,25,10
1713502442067,EDS 125,A00,507246,Hopkins; Megan Beth,27,0,30,3
1713502443097,EDS 128A,A01,507264,Fargason; Sharon Gayle,26,0,26,0
1713502444127,EDS 128B,A01,507293,Pappas; Elizabeth,30,0,30,0
1713502445156,EDS 139,A00,507294,Fargason; Sharon Gayle,30,0,30,0
1713502445156,EDS 139,B00,507313,Pappas; Elizabeth,30,0,30,0
1713502446181,EDS 201,A00,507315,Staff,18,0,30,12
1713502447211,EDS 203,A01,507317,Halter; Christopher P.,17,0,30,13
1713502448293,EDS 204R,A01,507319,Halter; Christopher P.,0,1,30,30
1713502448293,EDS 204R,B01,507331,Heinzman; Erica M.,22,0,30,8
1713502449318,EDS 206R,A00,507332,Staff,0,2,30,30
1713502449318,EDS 206R,B00,507343,Staff,23,0,30,7
1713502450344,EDS 250,A00,507344,Hemans; Patricia Ann Benitez,27,0,40,13
1713502451369,EDS 281,A00,507345,Daly; Alan J.,18,0,18,0
1713502452395,EDS 284,A00,507350,Daly; Alan J.,16,0,16,0
1713502453422,EDS 286,A00,507359,Fine; Sarah,18,0,18,0
1713502454447,EDS 289C,A01,507361,Daly; Alan J.,18,0,18,0
1713502455476,EDS 290,A00,507366,Hofstetter; Carolyn,15,0,15,0
1713502456505,LIGM 5A,A00,507421,Fischer-Grunski; Eva K,20,0,20,0
1713502457529,LIGM 5B,A00,507423,Fischer-Grunski; Eva K,20,0,20,0
1713502458556,LIGM 5C,A00,507425,Fischer-Grunski; Eva K,20,0,20,0
1713502459582,LIIT 5AS,A00,507427,Carnelos; Chiara,20,0,20,0
1713502460611,LIIT 5BS,A00,507430,Carnelos; Chiara,20,0,20,0
1713502461641,LIIT 5CS,A00,507432,Carnelos; Chiara,20,0,20,0
1713502462670,LISP 5A,A00,507541,Munoz Sanchez; Alicia,14,0,20,6
1713502463696,LISP 5B,A00,507671,Munoz Sanchez; Alicia,12,0,20,8
1713502464725,LISP 5C,A00,507696,Munoz Sanchez; Alicia,11,0,20,9
1713502465753,MAE 197,001,528363,Boechler; Nicholas Sebastia,9998,0,9999,1
1713502466779,MATH 197,001,523477,Kedlaya; Kiran S.,9999,0,9999,0
1713502466779,MATH 197,002,563811,Zhang; Danna,9998,0,9999,1
1713502467805,MCWP 40R,A00,518780,Staff,14,0,20,6
1713502467805,MCWP 40R,B00,518781,Staff,11,0,20,9
1713502467805,MCWP 40R,C00,518783,Staff,8,0,20,12
1713502468836,MCWP 50R,A00,518791,Staff,7,0,20,13
1713502468836,MCWP 50R,B00,518792,Staff,3,0,20,17
1713502468836,MCWP 50R,C00,518793,Staff,5,0,20,15
1713502468836,MCWP 50R,D00,518794,Staff,0,0,20,20
1713502468836,MCWP 50R,E00,518795,Staff,0,0,20,20
1713502468836,MCWP 50R,F00,518796,Staff,11,0,20,9
1713502468836,MCWP 50R,G00,518797,Staff,10,0,20,10
1713502469866,MMW 12R,A01,514034,Herbst; Matthew,3,0,16,13
1713502469866,MMW 12R,A02,514035,Herbst; Matthew,13,0,16,3
1713502470890,MMW 13R,A01,514037,Staff,0,8,16,16
1713502470890,MMW 13R,A02,514039,Staff,0,7,16,16
1713502472941,SIO 295LS,A00,523233,Staff,15,0,30,15
1713502473966,SIO 295S,A00,523232,Staff,15,0,30,15
1713502474995,SOCI 117,A01,494376,Staff,0,2,5,5
1713502476020,WES 237B,A00,494380,Staff,19,0,20,1
1713502478081,AESE 279B,A00,494370,Wade; Jon P,33,0,33,0
1713502479107,AIP 197,001,627712,Vespa; Emanuel Ignacio,9999,0,9999,0
1713502480134,ANAR 135S,A00,494369,Braswell; Geoffrey E.,0,0,0,0
1713502481163,CAT 124RS,A01,519847,Geibel; William,6,0,20,14
1713502482189,CAT 125RS,A01,515971,Geibel; William,6,0,20,14
1713502483219,CLRE 250,A00,511389,Morris; Sheldon,9996,0,9999,3
1713502484248,CLRE 251,A00,507176,Mehta; Ravindra L.,9996,0,9999,3
1713502484248,CLRE 251,B00,511410,Mehta; Ravindra L.,9998,0,9999,1
1713502485275,CLRE 252,A00,507189,Cuomo; Raphael Eduardo,9998,0,9999,1
1713502486304,CLRE 253,A00,507199,Vaida; Florin,9997,0,9999,2
1713502486304,CLRE 253,B00,507202,Vaida; Florin,9999,0,9999,0
1713502487329,CLRE 259,A00,507211,Patel; Hemal,9996,0,9999,3
1713502488358,CLRE 260,A00,507221,Cuomo; Raphael Eduardo,9999,0,9999,0
1713502489384,CLRE 297,001,507242,Cuomo; Raphael Eduardo,9999,0,9999,0
1713502490413,CSE 191,A00,516875,Minnes Kemp; Mor Mia,9999,0,9999,0
1713502491439,CSS 201S,A01,494383,Staff,35,0,35,0
1713502492465,CSS 202S,A01,494387,Staff,35,0,35,0
1713502493490,EAP 100,A00,516065,Staff,9792,0,9999,207
1713502494519,ECE 45,A01,507414,Staff,37,0,60,23
1713502495549,ECE 100,A01,507416,Baghdadchi; Saharnaz,0,0,20,20
1713502495549,ECE 100,A02,507418,Baghdadchi; Saharnaz,19,0,20,1
1713502496575,ECE 111,A01,507420,Staff,27,0,50,23
1713502497602,ECE 197,001,548057,Sievenpiper; Daniel F.,9998,0,9999,1
1713502498628,EDS 115,A00,507243,Choi; Bailey Miyeon,27,0,28,1
1713502499653,EDS 117,A01,494379,Staff,15,0,25,10
1713502500677,EDS 125,A00,507246,Hopkins; Megan Beth,27,0,30,3
1713502501701,EDS 128A,A01,507264,Fargason; Sharon Gayle,26,0,26,0
1713502502727,EDS 128B,A01,507293,Pappas; Elizabeth,30,0,30,0
1713502503752,EDS 139,A00,507294,Fargason; Sharon Gayle,30,0,30,0
1713502503752,EDS 139,B00,507313,Pappas; Elizabeth,30,0,30,0
1713502504778,EDS 201,A00,507315,Staff,18,0,30,12
1713502505802,EDS 203,A01,507317,Halter; Christopher P.,17,0,30,13
1713502506830,EDS 204R,A01,507319,Halter; Christopher P.,0,1,30,30
1713502506830,EDS 204R,B01,507331,Heinzman; Erica M.,22,0,30,8
1713502507857,EDS 206R,A00,507332,Staff,0,2,30,30
1713502507857,EDS 206R,B00,507343,Staff,23,0,30,7
1713502508883,EDS 250,A00,507344,Hemans; Patricia Ann Benitez,27,0,40,13
1713502509908,EDS 281,A00,507345,Daly; Alan J.,18,0,18,0
1713502510933,EDS 284,A00,507350,Daly; Alan J.,16,0,16,0
1713502511962,EDS 286,A00,507359,Fine; Sarah,18,0,18,0
1713502512990,EDS 289C,A01,507361,Daly; Alan J.,18,0,18,0
1713502514016,EDS 290,A00,507366,Hofstetter; Carolyn,15,0,15,0
1713502515041,LIGM 5A,A00,507421,Fischer-Grunski; Eva K,20,0,20,0
1713502516066,LIGM 5B,A00,507423,Fischer-Grunski; Eva K,20,0,20,0
1713502517091,LIGM 5C,A00,507425,Fischer-Grunski; Eva K,20,0,20,0
1713502518115,LIIT 5AS,A00,507427,Carnelos; Chiara,20,0,20,0
1713502519141,LIIT 5BS,A00,507430,Carnelos; Chiara,20,0,20,0
1713502520171,LIIT 5CS,A00,507432,Carnelos; Chiara,20,0,20,0
1713502521196,LISP 5A,A00,507541,Munoz Sanchez; Alicia,14,0,20,6
1713502522220,LISP 5B,A00,507671,Munoz Sanchez; Alicia,12,0,20,8
1713502523246,LISP 5C,A00,507696,Munoz Sanchez; Alicia,11,0,20,9
1713502524275,MAE 197,001,528363,Boechler; Nicholas Sebastia,9998,0,9999,1
1713502525303,MATH 197,001,523477,Kedlaya; Kiran S.,9999,0,9999,0
1713502525303,MATH 197,002,563811,Zhang; Danna,9998,0,9999,1
1713502526328,MCWP 40R,A00,518780,Staff,14,0,20,6
1713502526328,MCWP 40R,B00,518781,Staff,11,0,20,9
1713502526328,MCWP 40R,C00,518783,Staff,8,0,20,12
1713502527356,MCWP 50R,A00,518791,Staff,7,0,20,13
1713502527356,MCWP 50R,B00,518792,Staff,3,0,20,17
1713502527356,MCWP 50R,C00,518793,Staff,5,0,20,15
1713502527356,MCWP 50R,D00,518794,Staff,0,0,20,20
1713502527356,MCWP 50R,E00,518795,Staff,0,0,20,20
1713502527356,MCWP 50R,F00,518796,Staff,11,0,20,9
1713502527356,MCWP 50R,G00,518797,Staff,10,0,20,10
1713502528386,MMW 12R,A01,514034,Herbst; Matthew,3,0,16,13
1713502528386,MMW 12R,A02,514035,Herbst; Matthew,13,0,16,3
1713502529411,MMW 13R,A01,514037,Staff,0,8,16,16
1713502529411,MMW 13R,A02,514039,Staff,0,7,16,16
1713502531459,SIO 295LS,A00,523233,Staff,15,0,30,15
1713502532488,SIO 295S,A00,523232,Staff,15,0,30,15
1713502533513,SOCI 117,A01,494376,Staff,0,2,5,5
1713502534541,WES 237B,A00,494380,Staff,19,0,20,1
1713502536615,AESE 279B,A00,494370,Wade; Jon P,33,0,33,0
1713502537640,AIP 197,001,627712,Vespa; Emanuel Ignacio,9999,0,9999,0
1713502538668,ANAR 135S,A00,494369,Braswell; Geoffrey E.,0,0,0,0
1713502539694,CAT 124RS,A01,519847,Geibel; William,6,0,20,14
1713502540722,CAT 125RS,A01,515971,Geibel; William,6,0,20,14
1713502541748,CLRE 250,A00,511389,Morris; Sheldon,9996,0,9999,3
1713502542775,CLRE 251,A00,507176,Mehta; Ravindra L.,9996,0,9999,3
1713502542775,CLRE 251,B00,511410,Mehta; Ravindra L.,9998,0,9999,1
1713502543801,CLRE 252,A00,507189,Cuomo; Raphael Eduardo,9998,0,9999,1
1713502544831,CLRE 253,A00,507199,Vaida; Florin,9997,0,9999,2
1713502544831,CLRE 253,B00,507202,Vaida; Florin,9999,0,9999,0
1713502545856,CLRE 259,A00,507211,Patel; Hemal,9996,0,9999,3
1713502546882,CLRE 260,A00,507221,Cuomo; Raphael Eduardo,9999,0,9999,0
1713502547907,CLRE 297,001,507242,Cuomo; Raphael Eduardo,9999,0,9999,0
1713502548933,CSE 191,A00,516875,Minnes Kemp; Mor Mia,9999,0,9999,0
1713502549959,CSS 201S,A01,494383,Staff,35,0,35,0
1713502550985,CSS 202S,A01,494387,Staff,35,0,35,0
1713502552065,EAP 100,A00,516065,Staff,9792,0,9999,207
1713502553095,ECE 45,A01,507414,Staff,37,0,60,23
1713502554121,ECE 100,A01,507416,Baghdadchi; Saharnaz,0,0,20,20
1713502554121,ECE 100,A02,507418,Baghdadchi; Saharnaz,19,0,20,1
1713502555147,ECE 111,A01,507420,Staff,27,0,50,23
1713502556175,ECE 197,001,548057,Sievenpiper; Daniel F.,9998,0,9999,1
1713502557201,EDS 115,A00,507243,Choi; Bailey Miyeon,27,0,28,1
1713502558225,EDS 117,A01,494379,Staff,15,0,25,10
1713502559250,EDS 125,A00,507246,Hopkins; Megan Beth,27,0,30,3
1713502560275,EDS 128A,A01,507264,Fargason; Sharon Gayle,26,0,26,0
1713502561300,EDS 128B,A01,507293,Pappas; Elizabeth,30,0,30,0
1713502562327,EDS 139,A00,507294,Fargason; Sharon Gayle,30,0,30,0
1713502562327,EDS 139,B00,507313,Pappas; Elizabeth,30,0,30,0
1713502563356,EDS 201,A00,507315,Staff,18,0,30,12
1713502564380,EDS 203,A01,507317,Halter; Christopher P.,17,0,30,13
1713502565408,EDS 204R,A01,507319,Halter; Christopher P.,0,1,30,30
1713502565408,EDS 204R,B01,507331,Heinzman; Erica M.,22,0,30,8
1713502566434,EDS 206R,A00,507332,Staff,0,2,30,30
1713502566434,EDS 206R,B00,507343,Staff,23,0,30,7
1713502567460,EDS 250,A00,507344,Hemans; Patricia Ann Benitez,27,0,40,13
1713502568484,EDS 281,A00,507345,Daly; Alan J.,18,0,18,0
1713502569510,EDS 284,A00,507350,Daly; Alan J.,16,0,16,0
1713502570535,EDS 286,A00,507359,Fine; Sarah,18,0,18,0
1713502571561,EDS 289C,A01,507361,Daly; Alan J.,18,0,18,0
1713502572588,EDS 290,A00,507366,Hofstetter; Carolyn,15,0,15,0
1713502573617,LIGM 5A,A00,507421,Fischer-Grunski; Eva K,20,0,20,0
1713502574643,LIGM 5B,A00,507423,Fischer-Grunski; Eva K,20,0,20,0
1713502575668,LIGM 5C,A00,507425,Fischer-Grunski; Eva K,20,0,20,0
1713502576696,LIIT 5AS,A00,507427,Carnelos; Chiara,20,0,20,0
1713502577726,LIIT 5BS,A00,507430,Carnelos; Chiara,20,0,20,0
1713502578751,LIIT 5CS,A00,507432,Carnelos; Chiara,20,0,20,0
1713502579778,LISP 5A,A00,507541,Munoz Sanchez; Alicia,14,0,20,6
1713502580805,LISP 5B,A00,507671,Munoz Sanchez; Alicia,12,0,20,8
1713502581830,LISP 5C,A00,507696,Munoz Sanchez; Alicia,11,0,20,9
1713502582857,MAE 197,001,528363,Boechler; Nicholas Sebastia,9998,0,9999,1
1713502583883,MATH 197,001,523477,Kedlaya; Kiran S.,9999,0,9999,0
1713502583883,MATH 197,002,563811,Zhang; Danna,9998,0,9999,1
1713502584910,MCWP 40R,A00,518780,Staff,14,0,20,6
1713502584910,MCWP 40R,B00,518781,Staff,11,0,20,9
1713502584910,MCWP 40R,C00,518783,Staff,8,0,20,12
1713502585940,MCWP 50R,A00,518791,Staff,7,0,20,13
1713502585940,MCWP 50R,B00,518792,Staff,3,0,20,17
1713502585940,MCWP 50R,C00,518793,Staff,5,0,20,15
1713502585940,MCWP 50R,D00,518794,Staff,0,0,20,20
1713502585940,MCWP 50R,E00,518795,Staff,0,0,20,20
1713502585940,MCWP 50R,F00,518796,Staff,11,0,20,9
1713502585940,MCWP 50R,G00,518797,Staff,10,0,20,10
1713502586967,MMW 12R,A01,514034,Herbst; Matthew,3,0,16,13
1713502586967,MMW 12R,A02,514035,Herbst; Matthew,13,0,16,3
1713502587992,MMW 13R,A01,514037,Staff,0,8,16,16
1713502587992,MMW 13R,A02,514039,Staff,0,7,16,16
1713502590047,SIO 295LS,A00,523233,Staff,15,0,30,15
1713502591071,SIO 295S,A00,523232,Staff,15,0,30,15
1713502592096,SOCI 117,A01,494376,Staff,0,2,5,5
1713502593124,WES 237B,A00,494380,Staff,19,0,20,1
1713502595194,AESE 279B,A00,494370,Wade; Jon P,33,0,33,0
1713502596220,AIP 197,001,627712,Vespa; Emanuel Ignacio,9999,0,9999,0
1713502597245,ANAR 135S,A00,494369,Braswell; Geoffrey E.,0,0,0,0
1713502598269,CAT 124RS,A01,519847,Geibel; William,6,0,20,14
1713502599294,CAT 125RS,A01,515971,Geibel; William,6,0,20,14
1713502600320,CLRE 250,A00,511389,Morris; Sheldon,9996,0,9999,3
1713502601346,CLRE 251,A00,507176,Mehta; Ravindra L.,9996,0,9999,3
1713502601346,CLRE 251,B00,511410,Mehta; Ravindra L.,9998,0,9999,1
1713502602374,CLRE 252,A00,507189,Cuomo; Raphael Eduardo,9998,0,9999,1
1713502603407,CLRE 253,A00,507199,Vaida; Florin,9997,0,9999,2
1713502603407,CLRE 253,B00,507202,Vaida; Florin,9999,0,9999,0
1713502604430,CLRE 259,A00,507211,Patel; Hemal,9996,0,9999,3
1713502605459,CLRE 260,A00,507221,Cuomo; Raphael Eduardo,9999,0,9999,0
1713502606482,CLRE 297,001,507242,Cuomo; Raphael Eduardo,9999,0,9999,0
1713502607508,CSE 191,A00,516875,Minnes Kemp; Mor Mia,9999,0,9999,0
1713502608532,CSS 201S,A01,494383,Staff,35,0,35,0
1713502609557,CSS 202S,A01,494387,Staff,35,0,35,0
1713502610583,EAP 100,A00,516065,Staff,9792,0,9999,207
1713502611608,ECE 45,A01,507414,Staff,37,0,60,23
1713502612636,ECE 100,A01,507416,Baghdadchi; Saharnaz,0,0,20,20
1713502612636,ECE 100,A02,507418,Baghdadchi; Saharnaz,19,0,20,1
1713502613663,ECE 111,A01,507420,Staff,27,0,50,23
1713502614688,ECE 197,001,548057,Sievenpiper; Daniel F.,9998,0,9999,1
1713502615713,EDS 115,A00,507243,Choi; Bailey Miyeon,27,0,28,1
1713502616738,EDS 117,A01,494379,Staff,15,0,25,10
1713502617763,EDS 125,A00,507246,Hopkins; Megan Beth,27,0,30,3
1713502618789,EDS 128A,A01,507264,Fargason; Sharon Gayle,26,0,26,0
1713502619818,EDS 128B,A01,507293,Pappas; Elizabeth,30,0,30,0
1713502620843,EDS 139,A00,507294,Fargason; Sharon Gayle,30,0,30,0
1713502620843,EDS 139,B00,507313,Pappas; Elizabeth,30,0,30,0
1713502621872,EDS 201,A00,507315,Staff,18,0,30,12
1713502622898,EDS 203,A01,507317,Halter; Christopher P.,17,0,30,13
1713502623922,EDS 204R,A01,507319,Halter; Christopher P.,0,1,30,30
1713502623922,EDS 204R,B01,507331,Heinzman; Erica M.,22,0,30,8
1713502624947,EDS 206R,A00,507332,Staff,0,2,30,30
1713502624947,EDS 206R,B00,507343,Staff,23,0,30,7
1713502625977,EDS 250,A00,507344,Hemans; Patricia Ann Benitez,27,0,40,13
1713502627002,EDS 281,A00,507345,Daly; Alan J.,18,0,18,0
1713502628027,EDS 284,A00,507350,Daly; Alan J.,16,0,16,0
1713502629054,EDS 286,A00,507359,Fine; Sarah,18,0,18,0
1713502630079,EDS 289C,A01,507361,Daly; Alan J.,18,0,18,0
1713502631104,EDS 290,A00,507366,Hofstetter; Carolyn,15,0,15,0
1713502632129,LIGM 5A,A00,507421,Fischer-Grunski; Eva K,20,0,20,0
1713502633158,LIGM 5B,A00,507423,Fischer-Grunski; Eva K,20,0,20,0
1713502634184,LIGM 5C,A00,507425,Fischer-Grunski; Eva K,20,0,20,0
1713502635210,LIIT 5AS,A00,507427,Carnelos; Chiara,20,0,20,0
1713502636236,LIIT 5BS,A00,507430,Carnelos; Chiara,20,0,20,0
1713502637263,LIIT 5CS,A00,507432,Carnelos; Chiara,20,0,20,0
1713502638289,LISP 5A,A00,507541,Munoz Sanchez; Alicia,14,0,20,6
1713502639315,LISP 5B,A00,507671,Munoz Sanchez; Alicia,12,0,20,8
1713502640341,LISP 5C,A00,507696,Munoz Sanchez; Alicia,11,0,20,9
1713502641368,MAE 197,001,528363,Boechler; Nicholas Sebastia,9998,0,9999,1
1713502642397,MATH 197,001,523477,Kedlaya; Kiran S.,9999,0,9999,0
1713502642397,MATH 197,002,563811,Zhang; Danna,9998,0,9999,1
1713502643422,MCWP 40R,A00,518780,Staff,14,0,20,6
1713502643422,MCWP 40R,B00,518781,Staff,11,0,20,9
1713502643422,MCWP 40R,C00,518783,Staff,8,0,20,12
1713502644448,MCWP 50R,A00,518791,Staff,7,0,20,13
1713502644448,MCWP 50R,B00,518792,Staff,3,0,20,17
1713502644448,MCWP 50R,C00,518793,Staff,5,0,20,15
1713502644448,MCWP 50R,D00,518794,Staff,0,0,20,20
1713502644448,MCWP 50R,E00,518795,Staff,0,0,20,20
1713502644448,MCWP 50R,F00,518796,Staff,11,0,20,9
1713502644448,MCWP 50R,G00,518797,Staff,10,0,20,10
1713502645473,MMW 12R,A01,514034,Herbst; Matthew,3,0,16,13
1713502645473,MMW 12R,A02,514035,Herbst; Matthew,13,0,16,3
1713502646498,MMW 13R,A01,514037,Staff,0,8,16,16
1713502646498,MMW 13R,A02,514039,Staff,0,7,16,16
1713502648550,SIO 295LS,A00,523233,Staff,15,0,30,15
1713502649576,SIO 295S,A00,523232,Staff,15,0,30,15
1713502650600,SOCI 117,A01,494376,Staff,0,2,5,5
1713502651626,WES 237B,A00,494380,Staff,19,0,20,1
1713502653683,AESE 279B,A00,494370,Wade; Jon P,33,0,33,0
1713502654707,AIP 197,001,627712,Vespa; Emanuel Ignacio,9999,0,9999,0
1713502655792,ANAR 135S,A00,494369,Braswell; Geoffrey E.,0,0,0,0
1713502656821,CAT 124RS,A01,519847,Geibel; William,6,0,20,14
1713502657848,CAT 125RS,A01,515971,Geibel; William,6,0,20,14
1713502658877,CLRE 250,A00,511389,Morris; Sheldon,9996,0,9999,3
1713502659902,CLRE 251,A00,507176,Mehta; Ravindra L.,9996,0,9999,3
1713502659902,CLRE 251,B00,511410,Mehta; Ravindra L.,9998,0,9999,1
1713502660928,CLRE 252,A00,507189,Cuomo; Raphael Eduardo,9998,0,9999,1
1713502661953,CLRE 253,A00,507199,Vaida; Florin,9997,0,9999,2
1713502661953,CLRE 253,B00,507202,Vaida; Florin,9999,0,9999,0
1713502662981,CLRE 259,A00,507211,Patel; Hemal,9996,0,9999,3
1713502664009,CLRE 260,A00,507221,Cuomo; Raphael Eduardo,9999,0,9999,0
1713502665037,CLRE 297,001,507242,Cuomo; Raphael Eduardo,9999,0,9999,0
1713502666065,CSE 191,A00,516875,Minnes Kemp; Mor Mia,9999,0,9999,0
1713502667093,CSS 201S,A01,494383,Staff,35,0,35,0
1713502668117,CSS 202S,A01,494387,Staff,35,0,35,0
1713502669143,EAP 100,A00,516065,Staff,9792,0,9999,207
1713502670170,ECE 45,A01,507414,Staff,37,0,60,23
1713502671193,ECE 100,A01,507416,Baghdadchi; Saharnaz,0,0,20,20
1713502671193,ECE 100,A02,507418,Baghdadchi; Saharnaz,19,0,20,1
1713502672218,ECE 111,A01,507420,Staff,27,0,50,23
1713502673243,ECE 197,001,548057,Sievenpiper; Daniel F.,9998,0,9999,1
1713502674268,EDS 115,A00,507243,Choi; Bailey Miyeon,27,0,28,1
1713502675296,EDS 117,A01,494379,Staff,15,0,25,10
1713502676325,EDS 125,A00,507246,Hopkins; Megan Beth,27,0,30,3
1713502677352,EDS 128A,A01,507264,Fargason; Sharon Gayle,26,0,26,0
1713502678376,EDS 128B,A01,507293,Pappas; Elizabeth,30,0,30,0
1713502679402,EDS 139,A00,507294,Fargason; Sharon Gayle,30,0,30,0
1713502679402,EDS 139,B00,507313,Pappas; Elizabeth,30,0,30,0
1713502680426,EDS 201,A00,507315,Staff,18,0,30,12
1713502681454,EDS 203,A01,507317,Halter; Christopher P.,17,0,30,13
1713502682483,EDS 204R,A01,507319,Halter; Christopher P.,0,1,30,30
1713502682483,EDS 204R,B01,507331,Heinzman; Erica M.,22,0,30,8
1713502683508,EDS 206R,A00,507332,Staff,0,2,30,30
1713502683508,EDS 206R,B00,507343,Staff,23,0,30,7
1713502684534,EDS 250,A00,507344,Hemans; Patricia Ann Benitez,27,0,40,13
1713502685562,EDS 281,A00,507345,Daly; Alan J.,18,0,18,0
1713502686587,EDS 284,A00,507350,Daly; Alan J.,16,0,16,0
1713502687610,EDS 286,A00,507359,Fine; Sarah,18,0,18,0
1713502688635,EDS 289C,A01,507361,Daly; Alan J.,18,0,18,0
1713502689661,EDS 290,A00,507366,Hofstetter; Carolyn,15,0,15,0
1713502690688,LIGM 5A,A00,507421,Fischer-Grunski; Eva K,20,0,20,0
1713502691717,LIGM 5B,A00,507423,Fischer-Grunski; Eva K,20,0,20,0
1713502692742,LIGM 5C,A00,507425,Fischer-Grunski; Eva K,20,0,20,0
1713502693773,LIIT 5AS,A00,507427,Carnelos; Chiara,20,0,20,0
1713502694799,LIIT 5BS,A00,507430,Carnelos; Chiara,20,0,20,0
1713502695825,LIIT 5CS,A00,507432,Carnelos; Chiara,20,0,20,0
1713502696850,LISP 5A,A00,507541,Munoz Sanchez; Alicia,14,0,20,6
1713502697882,LISP 5B,A00,507671,Munoz Sanchez; Alicia,12,0,20,8
1713502698907,LISP 5C,A00,507696,Munoz Sanchez; Alicia,11,0,20,9
1713502699935,MAE 197,001,528363,Boechler; Nicholas Sebastia,9998,0,9999,1
1713502700960,MATH 197,001,523477,Kedlaya; Kiran S.,9999,0,9999,0
1713502700960,MATH 197,002,563811,Zhang; Danna,9998,0,9999,1
1713502701988,MCWP 40R,A00,518780,Staff,14,0,20,6
1713502701988,MCWP 40R,B00,518781,Staff,11,0,20,9
1713502701988,MCWP 40R,C00,518783,Staff,8,0,20,12
1713502703018,MCWP 50R,A00,518791,Staff,7,0,20,13
1713502703018,MCWP 50R,B00,518792,Staff,3,0,20,17
1713502703018,MCWP 50R,C00,518793,Staff,5,0,20,15
1713502703018,MCWP 50R,D00,518794,Staff,0,0,20,20
1713502703018,MCWP 50R,E00,518795,Staff,0,0,20,20
1713502703018,MCWP 50R,F00,518796,Staff,11,0,20,9
1713502703018,MCWP 50R,G00,518797,Staff,10,0,20,10
1713502704045,MMW 12R,A01,514034,Herbst; Matthew,3,0,16,13
1713502704045,MMW 12R,A02,514035,Herbst; Matthew,13,0,16,3
1713502705074,MMW 13R,A01,514037,Staff,0,8,16,16
1713502705074,MMW 13R,A02,514039,Staff,0,7,16,16
1713502707131,SIO 295LS,A00,523233,Staff,15,0,30,15
1713502708156,SIO 295S,A00,523232,Staff,15,0,30,15
1713502709185,SOCI 117,A01,494376,Staff,0,2,5,5
1713502710209,WES 237B,A00,494380,Staff,19,0,20,1
1713502712269,AESE 279B,A00,494370,Wade; Jon P,33,0,33,0
1713502713295,AIP 197,001,627712,Vespa; Emanuel Ignacio,9999,0,9999,0
1713502714321,ANAR 135S,A00,494369,Braswell; Geoffrey E.,0,0,0,0
1713502715347,CAT 124RS,A01,519847,Geibel; William,6,0,20,14
1713502716373,CAT 125RS,A01,515971,Geibel; William,6,0,20,14
1713502717396,CLRE 250,A00,511389,Morris; Sheldon,9996,0,9999,3
1713502718426,CLRE 251,A00,507176,Mehta; Ravindra L.,9996,0,9999,3
1713502718426,CLRE 251,B00,511410,Mehta; Ravindra L.,9998,0,9999,1
1713502719451,CLRE 252,A00,507189,Cuomo; Raphael Eduardo,9998,0,9999,1
1713502720476,CLRE 253,A00,507199,Vaida; Florin,9997,0,9999,2
1713502720476,CLRE 253,B00,507202,Vaida; Florin,9999,0,9999,0
1713502721502,CLRE 259,A00,507211,Patel; Hemal,9996,0,9999,3
1713502722527,CLRE 260,A00,507221,Cuomo; Raphael Eduardo,9999,0,9999,0
1713502723552,CLRE 297,001,507242,Cuomo; Raphael Eduardo,9999,0,9999,0
1713502724579,CSE 191,A00,516875,Minnes Kemp; Mor Mia,9999,0,9999,0
1713502725609,CSS 201S,A01,494383,Staff,35,0,35,0
1713502726635,CSS 202S,A01,494387,Staff,35,0,35,0
1713502727663,EAP 100,A00,516065,Staff,9792,0,9999,207
1713502728693,ECE 45,A01,507414,Staff,37,0,60,23
1713502729718,ECE 100,A01,507416,Baghdadchi; Saharnaz,0,0,20,20
1713502729718,ECE 100,A02,507418,Baghdadchi; Saharnaz,19,0,20,1
1713502730744,ECE 111,A01,507420,Staff,27,0,50,23
1713502731770,ECE 197,001,548057,Sievenpiper; Daniel F.,9998,0,9999,1
1713502732795,EDS 115,A00,507243,Choi; Bailey Miyeon,27,0,28,1
1713502733819,EDS 117,A01,494379,Staff,15,0,25,10
1713502734848,EDS 125,A00,507246,Hopkins; Megan Beth,27,0,30,3
1713502735874,EDS 128A,A01,507264,Fargason; Sharon Gayle,26,0,26,0
1713502736899,EDS 128B,A01,507293,Pappas; Elizabeth,30,0,30,0
1713502737924,EDS 139,A00,507294,Fargason; Sharon Gayle,30,0,30,0
1713502737924,EDS 139,B00,507313,Pappas; Elizabeth,30,0,30,0
1713502738950,EDS 201,A00,507315,Staff,18,0,30,12
1713502739979,EDS 203,A01,507317,Halter; Christopher P.,17,0,30,13
1713502741004,EDS 204R,A01,507319,Halter; Christopher P.,0,1,30,30
1713502741004,EDS 204R,B01,507331,Heinzman; Erica M.,22,0,30,8
1713502742028,EDS 206R,A00,507332,Staff,0,2,30,30
1713502742028,EDS 206R,B00,507343,Staff,23,0,30,7
1713502743054,EDS 250,A00,507344,Hemans; Patricia Ann Benitez,27,0,40,13
1713502744079,EDS 281,A00,507345,Daly; Alan J.,18,0,18,0
1713502745106,EDS 284,A00,507350,Daly; Alan J.,16,0,16,0
1713502746131,EDS 286,A00,507359,Fine; Sarah,18,0,18,0
1713502747157,EDS 289C,A01,507361,Daly; Alan J.,18,0,18,0
1713502748183,EDS 290,A00,507366,Hofstetter; Carolyn,15,0,15,0
1713502749208,LIGM 5A,A00,507421,Fischer-Grunski; Eva K,20,0,20,0
1713502750238,LIGM 5B,A00,507423,Fischer-Grunski; Eva K,20,0,20,0
1713502751264,LIGM 5C,A00,507425,Fischer-Grunski; Eva K,20,0,20,0
1713502752290,LIIT 5AS,A00,507427,Carnelos; Chiara,20,0,20,0
1713502753317,LIIT 5BS,A00,507430,Carnelos; Chiara,20,0,20,0
1713502754345,LIIT 5CS,A00,507432,Carnelos; Chiara,20,0,20,0
1713502755374,LISP 5A,A00,507541,Munoz Sanchez; Alicia,14,0,20,6
1713502756399,LISP 5B,A00,507671,Munoz Sanchez; Alicia,12,0,20,8
1713502757429,LISP 5C,A00,507696,Munoz Sanchez; Alicia,11,0,20,9
1713502758455,MAE 197,001,528363,Boechler; Nicholas Sebastia,9998,0,9999,1
1713502759537,MATH 197,001,523477,Kedlaya; Kiran S.,9999,0,9999,0
1713502759537,MATH 197,002,563811,Zhang; Danna,9998,0,9999,1
1713502760564,MCWP 40R,A00,518780,Staff,14,0,20,6
1713502760564,MCWP 40R,B00,518781,Staff,11,0,20,9
1713502760564,MCWP 40R,C00,518783,Staff,8,0,20,12
1713502761594,MCWP 50R,A00,518791,Staff,7,0,20,13
1713502761594,MCWP 50R,B00,518792,Staff,3,0,20,17
1713502761594,MCWP 50R,C00,518793,Staff,5,0,20,15
1713502761594,MCWP 50R,D00,518794,Staff,0,0,20,20
1713502761594,MCWP 50R,E00,518795,Staff,0,0,20,20
1713502761594,MCWP 50R,F00,518796,Staff,11,0,20,9
1713502761594,MCWP 50R,G00,518797,Staff,10,0,20,10
1713502762620,MMW 12R,A01,514034,Herbst; Matthew,3,0,16,13
1713502762620,MMW 12R,A02,514035,Herbst; Matthew,13,0,16,3
1713502763649,MMW 13R,A01,514037,Staff,0,8,16,16
1713502763649,MMW 13R,A02,514039,Staff,0,7,16,16
1713502765697,SIO 295LS,A00,523233,Staff,15,0,30,15
1713502766727,SIO 295S,A00,523232,Staff,15,0,30,15
1713502767752,SOCI 117,A01,494376,Staff,0,2,5,5
1713502768780,WES 237B,A00,494380,Staff,19,0,20,1
1713502770845,AESE 279B,A00,494370,Wade; Jon P,33,0,33,0
1713502771870,AIP 197,001,627712,Vespa; Emanuel Ignacio,9999,0,9999,0
1713502772898,ANAR 135S,A00,494369,Braswell; Geoffrey E.,0,0,0,0
1713502773927,CAT 124RS,A01,519847,Geibel; William,6,0,20,14
1713502774956,CAT 125RS,A01,515971,Geibel; William,6,0,20,14
1713502775987,CLRE 250,A00,511389,Morris; Sheldon,9996,0,9999,3
1713502777013,CLRE 251,A00,507176,Mehta; Ravindra L.,9996,0,9999,3
1713502777013,CLRE 251,B00,511410,Mehta; Ravindra L.,9998,0,9999,1
1713502778042,CLRE 252,A00,507189,Cuomo; Raphael Eduardo,9998,0,9999,1
1713502779066,CLRE 253,A00,507199,Vaida; Florin,9997,0,9999,2
1713502779066,CLRE 253,B00,507202,Vaida; Florin,9999,0,9999,0
1713502780093,CLRE 259,A00,507211,Patel; Hemal,9996,0,9999,3
1713502781117,CLRE 260,A00,507221,Cuomo; Raphael Eduardo,9999,0,9999,0
1713502782142,CLRE 297,001,507242,Cuomo; Raphael Eduardo,9999,0,9999,0
1713502783168,CSE 191,A00,516875,Minnes Kemp; Mor Mia,9999,0,9999,0
1713502784197,CSS 201S,A01,494383,Staff,35,0,35,0
1713502785223,CSS 202S,A01,494387,Staff,35,0,35,0
1713502786248,EAP 100,A00,516065,Staff,9792,0,9999,207
1713502787276,ECE 45,A01,507414,Staff,37,0,60,23
1713502788302,ECE 100,A01,507416,Baghdadchi; Saharnaz,0,0,20,20
1713502788302,ECE 100,A02,507418,Baghdadchi; Saharnaz,19,0,20,1
1713502789328,ECE 111,A01,507420,Staff,27,0,50,23
1713502790357,ECE 197,001,548057,Sievenpiper; Daniel F.,9998,0,9999,1
1713502791387,EDS 115,A00,507243,Choi; Bailey Miyeon,27,0,28,1
1713502792417,EDS 117,A01,494379,Staff,15,0,25,10
1713502793441,EDS 125,A00,507246,Hopkins; Megan Beth,27,0,30,3
1713502794469,EDS 128A,A01,507264,Fargason; Sharon Gayle,26,0,26,0
1713502795495,EDS 128B,A01,507293,Pappas; Elizabeth,30,0,30,0
1713502796522,EDS 139,A00,507294,Fargason; Sharon Gayle,30,0,30,0
1713502796522,EDS 139,B00,507313,Pappas; Elizabeth,30,0,30,0
1713502797551,EDS 201,A00,507315,Staff,18,0,30,12
1713502798581,EDS 203,A01,507317,Halter; Christopher P.,17,0,30,13
1713502799617,EDS 204R,A01,507319,Halter; Christopher P.,0,1,30,30
1713502799617,EDS 204R,B01,507331,Heinzman; Erica M.,22,0,30,8
1713502800846,EDS 206R,A00,507332,Staff,0,2,30,30
1713502800846,EDS 206R,B00,507343,Staff,23,0,30,7
1713502801874,EDS 250,A00,507344,Hemans; Patricia Ann Benitez,27,0,40,13
1713502802899,EDS 281,A00,507345,Daly; Alan J.,18,0,18,0
1713502803923,EDS 284,A00,507350,Daly; Alan J.,16,0,16,0
1713502804949,EDS 286,A00,507359,Fine; Sarah,18,0,18,0
1713502805975,EDS 289C,A01,507361,Daly; Alan J.,18,0,18,0
1713502806999,EDS 290,A00,507366,Hofstetter; Carolyn,15,0,15,0
1713502808022,LIGM 5A,A00,507421,Fischer-Grunski; Eva K,20,0,20,0
1713502809047,LIGM 5B,A00,507423,Fischer-Grunski; Eva K,20,0,20,0
1713502810070,LIGM 5C,A00,507425,Fischer-Grunski; Eva K,20,0,20,0
1713502811101,LIIT 5AS,A00,507427,Carnelos; Chiara,20,0,20,0
1713502812127,LIIT 5BS,A00,507430,Carnelos; Chiara,20,0,20,0
1713502813152,LIIT 5CS,A00,507432,Carnelos; Chiara,20,0,20,0
1713502814183,LISP 5A,A00,507541,Munoz Sanchez; Alicia,14,0,20,6
1713502815211,LISP 5B,A00,507671,Munoz Sanchez; Alicia,12,0,20,8
1713502816241,LISP 5C,A00,507696,Munoz Sanchez; Alicia,11,0,20,9
1713502817266,MAE 197,001,528363,Boechler; Nicholas Sebastia,9998,0,9999,1
1713502818290,MATH 197,001,523477,Kedlaya; Kiran S.,9999,0,9999,0
1713502818290,MATH 197,002,563811,Zhang; Danna,9998,0,9999,1
1713502819314,MCWP 40R,A00,518780,Staff,14,0,20,6
1713502819314,MCWP 40R,B00,518781,Staff,11,0,20,9
1713502819314,MCWP 40R,C00,518783,Staff,8,0,20,12
1713502820340,MCWP 50R,A00,518791,Staff,7,0,20,13
1713502820340,MCWP 50R,B00,518792,Staff,3,0,20,17
1713502820340,MCWP 50R,C00,518793,Staff,5,0,20,15
1713502820340,MCWP 50R,D00,518794,Staff,0,0,20,20
1713502820340,MCWP 50R,E00,518795,Staff,0,0,20,20
1713502820340,MCWP 50R,F00,518796,Staff,11,0,20,9
1713502820340,MCWP 50R,G00,518797,Staff,10,0,20,10
1713502821369,MMW 12R,A01,514034,Herbst; Matthew,3,0,16,13
1713502821369,MMW 12R,A02,514035,Herbst; Matthew,13,0,16,3
1713502822392,MMW 13R,A01,514037,Staff,0,8,16,16
1713502822392,MMW 13R,A02,514039,Staff,0,7,16,16
1713502824440,SIO 295LS,A00,523233,Staff,15,0,30,15
1713502825464,SIO 295S,A00,523232,Staff,15,0,30,15
1713502826491,SOCI 117,A01,494376,Staff,0,2,5,5
1713502827520,WES 237B,A00,494380,Staff,19,0,20,1
1713502829580,AESE 279B,A00,494370,Wade; Jon P,33,0,33,0
1713502830607,AIP 197,001,627712,Vespa; Emanuel Ignacio,9999,0,9999,0
1713502831635,ANAR 135S,A00,494369,Braswell; Geoffrey E.,0,0,0,0
1713502832661,CAT 124RS,A01,519847,Geibel; William,6,0,20,14
1713502833689,CAT 125RS,A01,515971,Geibel; William,6,0,20,14
1713502834713,CLRE 250,A00,511389,Morris; Sheldon,9996,0,9999,3
1713502835738,CLRE 251,A00,507176,Mehta; Ravindra L.,9996,0,9999,3
1713502835738,CLRE 251,B00,511410,Mehta; Ravindra L.,9998,0,9999,1
1713502836764,CLRE 252,A00,507189,Cuomo; Raphael Eduardo,9998,0,9999,1
1713502837790,CLRE 253,A00,507199,Vaida; Florin,9997,0,9999,2
1713502837790,CLRE 253,B00,507202,Vaida; Florin,9999,0,9999,0
1713502838814,CLRE 259,A00,507211,Patel; Hemal,9996,0,9999,3
1713502839839,CLRE 260,A00,507221,Cuomo; Raphael Eduardo,9999,0,9999,0
1713502840864,CLRE 297,001,507242,Cuomo; Raphael Eduardo,9999,0,9999,0
1713502841890,CSE 191,A00,516875,Minnes Kemp; Mor Mia,9999,0,9999,0
1713502842916,CSS 201S,A01,494383,Staff,35,0,35,0
1713502843941,CSS 202S,A01,494387,Staff,35,0,35,0
1713502844966,EAP 100,A00,516065,Staff,9792,0,9999,207
1713502845996,ECE 45,A01,507414,Staff,37,0,60,23
1713502847024,ECE 100,A01,507416,Baghdadchi; Saharnaz,0,0,20,20
1713502847024,ECE 100,A02,507418,Baghdadchi; Saharnaz,19,0,20,1
1713502848049,ECE 111,A01,507420,Staff,27,0,50,23
1713502849075,ECE 197,001,548057,Sievenpiper; Daniel F.,9998,0,9999,1
1713502850115,EDS 115,A00,507243,Choi; Bailey Miyeon,27,0,28,1
1713502851144,EDS 117,A01,494379,Staff,15,0,25,10
1713502852170,EDS 125,A00,507246,Hopkins; Megan Beth,27,0,30,3
1713502853198,EDS 128A,A01,507264,Fargason; Sharon Gayle,26,0,26,0
1713502854227,EDS 128B,A01,507293,Pappas; Elizabeth,30,0,30,0
1713502855252,EDS 139,A00,507294,Fargason; Sharon Gayle,30,0,30,0
1713502855252,EDS 139,B00,507313,Pappas; Elizabeth,30,0,30,0
1713502856278,EDS 201,A00,507315,Staff,18,0,30,12
1713502857305,EDS 203,A01,507317,Halter; Christopher P.,17,0,30,13
1713502858330,EDS 204R,A01,507319,Halter; Christopher P.,0,1,30,30
1713502858330,EDS 204R,B01,507331,Heinzman; Erica M.,22,0,30,8
1713502859356,EDS 206R,A00,507332,Staff,0,2,30,30
1713502859356,EDS 206R,B00,507343,Staff,23,0,30,7
1713502860387,EDS 250,A00,507344,Hemans; Patricia Ann Benitez,27,0,40,13
1713502861414,EDS 281,A00,507345,Daly; Alan J.,18,0,18,0
1713502862440,EDS 284,A00,507350,Daly; Alan J.,16,0,16,0
1713502863522,EDS 286,A00,507359,Fine; Sarah,18,0,18,0
1713502864567,EDS 289C,A01,507361,Daly; Alan J.,18,0,18,0
1713502865593,EDS 290,A00,507366,Hofstetter; Carolyn,15,0,15,0
1713502866624,LIGM 5A,A00,507421,Fischer-Grunski; Eva K,20,0,20,0
1713502867649,LIGM 5B,A00,507423,Fischer-Grunski; Eva K,20,0,20,0
1713502868675,LIGM 5C,A00,507425,Fischer-Grunski; Eva K,20,0,20,0
1713502869701,LIIT 5AS,A00,507427,Carnelos; Chiara,20,0,20,0
1713502870730,LIIT 5BS,A00,507430,Carnelos; Chiara,20,0,20,0
1713502871760,LIIT 5CS,A00,507432,Carnelos; Chiara,20,0,20,0
1713502872787,LISP 5A,A00,507541,Munoz Sanchez; Alicia,14,0,20,6
1713502873812,LISP 5B,A00,507671,Munoz Sanchez; Alicia,12,0,20,8
1713502874844,LISP 5C,A00,507696,Munoz Sanchez; Alicia,11,0,20,9
1713502875873,MAE 197,001,528363,Boechler; Nicholas Sebastia,9998,0,9999,1
1713502876898,MATH 197,001,523477,Kedlaya; Kiran S.,9999,0,9999,0
1713502876898,MATH 197,002,563811,Zhang; Danna,9998,0,9999,1
1713502877924,MCWP 40R,A00,518780,Staff,14,0,20,6
1713502877924,MCWP 40R,B00,518781,Staff,11,0,20,9
1713502877924,MCWP 40R,C00,518783,Staff,8,0,20,12
1713502878951,MCWP 50R,A00,518791,Staff,7,0,20,13
1713502878951,MCWP 50R,B00,518792,Staff,3,0,20,17
1713502878951,MCWP 50R,C00,518793,Staff,5,0,20,15
1713502878951,MCWP 50R,D00,518794,Staff,0,0,20,20
1713502878951,MCWP 50R,E00,518795,Staff,0,0,20,20
1713502878951,MCWP 50R,F00,518796,Staff,11,0,20,9
1713502878951,MCWP 50R,G00,518797,Staff,10,0,20,10
1713502879978,MMW 12R,A01,514034,Herbst; Matthew,3,0,16,13
1713502879978,MMW 12R,A02,514035,Herbst; Matthew,13,0,16,3
1713502881007,MMW 13R,A01,514037,Staff,0,8,16,16
1713502881007,MMW 13R,A02,514039,Staff,0,7,16,16
1713502883063,SIO 295LS,A00,523233,Staff,15,0,30,15
1713502884091,SIO 295S,A00,523232,Staff,15,0,30,15
1713502885116,SOCI 117,A01,494376,Staff,0,2,5,5
1713502886142,WES 237B,A00,494380,Staff,19,0,20,1
1713502888207,AESE 279B,A00,494370,Wade; Jon P,33,0,33,0
1713502889234,AIP 197,001,627712,Vespa; Emanuel Ignacio,9999,0,9999,0
1713502890262,ANAR 135S,A00,494369,Braswell; Geoffrey E.,0,0,0,0
1713502891292,CAT 124RS,A01,519847,Geibel; William,6,0,20,14
1713502892319,CAT 125RS,A01,515971,Geibel; William,6,0,20,14
1713502893346,CLRE 250,A00,511389,Morris; Sheldon,9996,0,9999,3
1713502894375,CLRE 251,A00,507176,Mehta; Ravindra L.,9996,0,9999,3
1713502894375,CLRE 251,B00,511410,Mehta; Ravindra L.,9998,0,9999,1
1713502895400,CLRE 252,A00,507189,Cuomo; Raphael Eduardo,9998,0,9999,1
1713502896429,CLRE 253,A00,507199,Vaida; Florin,9997,0,9999,2
1713502896429,CLRE 253,B00,507202,Vaida; Florin,9999,0,9999,0
1713502897455,CLRE 259,A00,507211,Patel; Hemal,9996,0,9999,3
1713502898483,CLRE 260,A00,507221,Cuomo; Raphael Eduardo,9999,0,9999,0
1713502899509,CLRE 297,001,507242,Cuomo; Raphael Eduardo,9999,0,9999,0
1713502900534,CSE 191,A00,516875,Minnes Kemp; Mor Mia,9999,0,9999,0
1713502901560,CSS 201S,A01,494383,Staff,35,0,35,0
1713502902585,CSS 202S,A01,494387,Staff,35,0,35,0
1713502903610,EAP 100,A00,516065,Staff,9792,0,9999,207
1713502904640,ECE 45,A01,507414,Staff,37,0,60,23
1713502905665,ECE 100,A01,507416,Baghdadchi; Saharnaz,0,0,20,20
1713502905665,ECE 100,A02,507418,Baghdadchi; Saharnaz,19,0,20,1
1713502906693,ECE 111,A01,507420,Staff,27,0,50,23
1713502907719,ECE 197,001,548057,Sievenpiper; Daniel F.,9998,0,9999,1
1713502908744,EDS 115,A00,507243,Choi; Bailey Miyeon,27,0,28,1
1713502909769,EDS 117,A01,494379,Staff,15,0,25,10
1713502910799,EDS 125,A00,507246,Hopkins; Megan Beth,27,0,30,3
1713502911824,EDS 128A,A01,507264,Fargason; Sharon Gayle,26,0,26,0
1713502912853,EDS 128B,A01,507293,Pappas; Elizabeth,30,0,30,0
1713502913897,EDS 139,A00,507294,Fargason; Sharon Gayle,30,0,30,0
1713502913897,EDS 139,B00,507313,Pappas; Elizabeth,30,0,30,0
1713502914925,EDS 201,A00,507315,Staff,18,0,30,12
1713502915954,EDS 203,A01,507317,Halter; Christopher P.,17,0,30,13
1713502916983,EDS 204R,A01,507319,Halter; Christopher P.,0,1,30,30
1713502916983,EDS 204R,B01,507331,Heinzman; Erica M.,22,0,30,8
1713502918013,EDS 206R,A00,507332,Staff,0,2,30,30
1713502918013,EDS 206R,B00,507343,Staff,23,0,30,7
1713502919040,EDS 250,A00,507344,Hemans; Patricia Ann Benitez,27,0,40,13
1713502920068,EDS 281,A00,507345,Daly; Alan J.,18,0,18,0
1713502921094,EDS 284,A00,507350,Daly; Alan J.,16,0,16,0
1713502922120,EDS 286,A00,507359,Fine; Sarah,18,0,18,0
1713502923146,EDS 289C,A01,507361,Daly; Alan J.,18,0,18,0
1713502924174,EDS 290,A00,507366,Hofstetter; Carolyn,15,0,15,0
1713502925204,LIGM 5A,A00,507421,Fischer-Grunski; Eva K,20,0,20,0
1713502926233,LIGM 5B,A00,507423,Fischer-Grunski; Eva K,20,0,20,0
1713502927261,LIGM 5C,A00,507425,Fischer-Grunski; Eva K,20,0,20,0
1713502928286,LIIT 5AS,A00,507427,Carnelos; Chiara,20,0,20,0
1713502929315,LIIT 5BS,A00,507430,Carnelos; Chiara,20,0,20,0
1713502930340,LIIT 5CS,A00,507432,Carnelos; Chiara,20,0,20,0
1713502931365,LISP 5A,A00,507541,Munoz Sanchez; Alicia,14,0,20,6
1713502932395,LISP 5B,A00,507671,Munoz Sanchez; Alicia,12,0,20,8
1713502933425,LISP 5C,A00,507696,Munoz Sanchez; Alicia,11,0,20,9
1713502934454,MAE 197,001,528363,Boechler; Nicholas Sebastia,9998,0,9999,1
1713502935479,MATH 197,001,523477,Kedlaya; Kiran S.,9999,0,9999,0
1713502935479,MATH 197,002,563811,Zhang; Danna,9998,0,9999,1
1713502936504,MCWP 40R,A00,518780,Staff,14,0,20,6
1713502936504,MCWP 40R,B00,518781,Staff,11,0,20,9
1713502936504,MCWP 40R,C00,518783,Staff,8,0,20,12
1713502937531,MCWP 50R,A00,518791,Staff,7,0,20,13
1713502937531,MCWP 50R,B00,518792,Staff,3,0,20,17
1713502937531,MCWP 50R,C00,518793,Staff,5,0,20,15
1713502937531,MCWP 50R,D00,518794,Staff,0,0,20,20
1713502937531,MCWP 50R,E00,518795,Staff,0,0,20,20
1713502937531,MCWP 50R,F00,518796,Staff,11,0,20,9
1713502937531,MCWP 50R,G00,518797,Staff,10,0,20,10
1713502938555,MMW 12R,A01,514034,Herbst; Matthew,3,0,16,13
1713502938555,MMW 12R,A02,514035,Herbst; Matthew,13,0,16,3
1713502939583,MMW 13R,A01,514037,Staff,0,8,16,16
1713502939583,MMW 13R,A02,514039,Staff,0,7,16,16
1713502941637,SIO 295LS,A00,523233,Staff,15,0,30,15
1713502942668,SIO 295S,A00,523232,Staff,15,0,30,15
1713502943696,SOCI 117,A01,494376,Staff,0,2,5,5
1713502944720,WES 237B,A00,494380,Staff,19,0,20,1
1713502946781,AESE 279B,A00,494370,Wade; Jon P,33,0,33,0
1713502947806,AIP 197,001,627712,Vespa; Emanuel Ignacio,9999,0,9999,0
1713502948832,ANAR 135S,A00,494369,Braswell; Geoffrey E.,0,0,0,0
1713502949861,CAT 124RS,A01,519847,Geibel; William,6,0,20,14
1713502950886,CAT 125RS,A01,515971,Geibel; William,6,0,20,14
1713502951912,CLRE 250,A00,511389,Morris; Sheldon,9996,0,9999,3
1713502952941,CLRE 251,A00,507176,Mehta; Ravindra L.,9996,0,9999,3
1713502952941,CLRE 251,B00,511410,Mehta; Ravindra L.,9998,0,9999,1
1713502953970,CLRE 252,A00,507189,Cuomo; Raphael Eduardo,9998,0,9999,1
1713502954998,CLRE 253,A00,507199,Vaida; Florin,9997,0,9999,2
1713502954998,CLRE 253,B00,507202,Vaida; Florin,9999,0,9999,0
1713502956023,CLRE 259,A00,507211,Patel; Hemal,9996,0,9999,3
1713502957048,CLRE 260,A00,507221,Cuomo; Raphael Eduardo,9999,0,9999,0
1713502958075,CLRE 297,001,507242,Cuomo; Raphael Eduardo,9999,0,9999,0
1713502959100,CSE 191,A00,516875,Minnes Kemp; Mor Mia,9999,0,9999,0
1713502960124,CSS 201S,A01,494383,Staff,35,0,35,0
1713502961150,CSS 202S,A01,494387,Staff,35,0,35,0
1713502962175,EAP 100,A00,516065,Staff,9792,0,9999,207
1713502963203,ECE 45,A01,507414,Staff,37,0,60,23
1713502964228,ECE 100,A01,507416,Baghdadchi; Saharnaz,0,0,20,20
1713502964228,ECE 100,A02,507418,Baghdadchi; Saharnaz,19,0,20,1
1713502965256,ECE 111,A01,507420,Staff,27,0,50,23
1713502966281,ECE 197,001,548057,Sievenpiper; Daniel F.,9998,0,9999,1
1713502967364,EDS 115,A00,507243,Choi; Bailey Miyeon,27,0,28,1
1713502968392,EDS 117,A01,494379,Staff,15,0,25,10
1713502969417,EDS 125,A00,507246,Hopkins; Megan Beth,27,0,30,3
1713502970443,EDS 128A,A01,507264,Fargason; Sharon Gayle,26,0,26,0
1713502971469,EDS 128B,A01,507293,Pappas; Elizabeth,30,0,30,0
1713502972495,EDS 139,A00,507294,Fargason; Sharon Gayle,30,0,30,0
1713502972495,EDS 139,B00,507313,Pappas; Elizabeth,30,0,30,0
1713502973524,EDS 201,A00,507315,Staff,18,0,30,12
1713502974554,EDS 203,A01,507317,Halter; Christopher P.,17,0,30,13
1713502975578,EDS 204R,A01,507319,Halter; Christopher P.,0,1,30,30
1713502975578,EDS 204R,B01,507331,Heinzman; Erica M.,22,0,30,8
1713502976604,EDS 206R,A00,507332,Staff,0,2,30,30
1713502976604,EDS 206R,B00,507343,Staff,23,0,30,7
1713502977630,EDS 250,A00,507344,Hemans; Patricia Ann Benitez,27,0,40,13
1713502978657,EDS 281,A00,507345,Daly; Alan J.,18,0,18,0
1713502979682,EDS 284,A00,507350,Daly; Alan J.,16,0,16,0
1713502980707,EDS 286,A00,507359,Fine; Sarah,18,0,18,0
1713502981731,EDS 289C,A01,507361,Daly; Alan J.,18,0,18,0
1713502982759,EDS 290,A00,507366,Hofstetter; Carolyn,15,0,15,0
1713502983790,LIGM 5A,A00,507421,Fischer-Grunski; Eva K,20,0,20,0
1713502984820,LIGM 5B,A00,507423,Fischer-Grunski; Eva K,20,0,20,0
1713502985853,LIGM 5C,A00,507425,Fischer-Grunski; Eva K,20,0,20,0
1713502986883,LIIT 5AS,A00,507427,Carnelos; Chiara,20,0,20,0
1713502987909,LIIT 5BS,A00,507430,Carnelos; Chiara,20,0,20,0
1713502988934,LIIT 5CS,A00,507432,Carnelos; Chiara,20,0,20,0
1713502989965,LISP 5A,A00,507541,Munoz Sanchez; Alicia,14,0,20,6
1713502990990,LISP 5B,A00,507671,Munoz Sanchez; Alicia,12,0,20,8
1713502992019,LISP 5C,A00,507696,Munoz Sanchez; Alicia,11,0,20,9
1713502993047,MAE 197,001,528363,Boechler; Nicholas Sebastia,9998,0,9999,1
1713502994073,MATH 197,001,523477,Kedlaya; Kiran S.,9999,0,9999,0
1713502994073,MATH 197,002,563811,Zhang; Danna,9998,0,9999,1
1713502995100,MCWP 40R,A00,518780,Staff,14,0,20,6
1713502995100,MCWP 40R,B00,518781,Staff,11,0,20,9
1713502995100,MCWP 40R,C00,518783,Staff,8,0,20,12
1713502996133,MCWP 50R,A00,518791,Staff,7,0,20,13
1713502996133,MCWP 50R,B00,518792,Staff,3,0,20,17
1713502996133,MCWP 50R,C00,518793,Staff,5,0,20,15
1713502996133,MCWP 50R,D00,518794,Staff,0,0,20,20
1713502996133,MCWP 50R,E00,518795,Staff,0,0,20,20
1713502996133,MCWP 50R,F00,518796,Staff,11,0,20,9
1713502996133,MCWP 50R,G00,518797,Staff,10,0,20,10
1713502997159,MMW 12R,A01,514034,Herbst; Matthew,3,0,16,13
1713502997159,MMW 12R,A02,514035,Herbst; Matthew,13,0,16,3
1713502998188,MMW 13R,A01,514037,Staff,0,8,16,16
1713502998188,MMW 13R,A02,514039,Staff,0,7,16,16
1713503000241,SIO 295LS,A00,523233,Staff,15,0,30,15
1713503001266,SIO 295S,A00,523232,Staff,15,0,30,15
1713503002292,SOCI 117,A01,494376,Staff,0,2,5,5
1713503003320,WES 237B,A00,494380,Staff,19,0,20,1
1713503005391,AESE 279B,A00,494370,Wade; Jon P,33,0,33,0
1713503006417,AIP 197,001,627712,Vespa; Emanuel Ignacio,9999,0,9999,0
1713503007441,ANAR 135S,A00,494369,Braswell; Geoffrey E.,0,0,0,0
1713503008470,CAT 124RS,A01,519847,Geibel; William,6,0,20,14
1713503009495,CAT 125RS,A01,515971,Geibel; William,6,0,20,14
1713503010521,CLRE 250,A00,511389,Morris; Sheldon,9996,0,9999,3
1713503011552,CLRE 251,A00,507176,Mehta; Ravindra L.,9996,0,9999,3
1713503011552,CLRE 251,B00,511410,Mehta; Ravindra L.,9998,0,9999,1
1713503012582,CLRE 252,A00,507189,Cuomo; Raphael Eduardo,9998,0,9999,1
1713503013609,CLRE 253,A00,507199,Vaida; Florin,9997,0,9999,2
1713503013609,CLRE 253,B00,507202,Vaida; Florin,9999,0,9999,0
1713503014638,CLRE 259,A00,507211,Patel; Hemal,9996,0,9999,3
1713503015664,CLRE 260,A00,507221,Cuomo; Raphael Eduardo,9999,0,9999,0
1713503016692,CLRE 297,001,507242,Cuomo; Raphael Eduardo,9999,0,9999,0
1713503017719,CSE 191,A00,516875,Minnes Kemp; Mor Mia,9999,0,9999,0
1713503018744,CSS 201S,A01,494383,Staff,35,0,35,0
1713503019773,CSS 202S,A01,494387,Staff,35,0,35,0
1713503020800,EAP 100,A00,516065,Staff,9792,0,9999,207
1713503021827,ECE 45,A01,507414,Staff,37,0,60,23
1713503022856,ECE 100,A01,507416,Baghdadchi; Saharnaz,0,0,20,20
1713503022856,ECE 100,A02,507418,Baghdadchi; Saharnaz,19,0,20,1
1713503023897,ECE 111,A01,507420,Staff,27,0,50,23
1713503024921,ECE 197,001,548057,Sievenpiper; Daniel F.,9998,0,9999,1
1713503025951,EDS 115,A00,507243,Choi; Bailey Miyeon,27,0,28,1
1713503026980,EDS 117,A01,494379,Staff,15,0,25,10
1713503028009,EDS 125,A00,507246,Hopkins; Megan Beth,27,0,30,3
1713503029035,EDS 128A,A01,507264,Fargason; Sharon Gayle,26,0,26,0
1713503030058,EDS 128B,A01,507293,Pappas; Elizabeth,30,0,30,0
1713503031082,EDS 139,A00,507294,Fargason; Sharon Gayle,30,0,30,0
1713503031082,EDS 139,B00,507313,Pappas; Elizabeth,30,0,30,0
1713503032109,EDS 201,A00,507315,Staff,18,0,30,12
1713503033138,EDS 203,A01,507317,Halter; Christopher P.,17,0,30,13
1713503034168,EDS 204R,A01,507319,Halter; Christopher P.,0,1,30,30
1713503034168,EDS 204R,B01,507331,Heinzman; Erica M.,22,0,30,8
1713503035194,EDS 206R,A00,507332,Staff,0,2,30,30
1713503035194,EDS 206R,B00,507343,Staff,23,0,30,7
1713503036222,EDS 250,A00,507344,Hemans; Patricia Ann Benitez,27,0,40,13
1713503037250,EDS 281,A00,507345,Daly; Alan J.,18,0,18,0
1713503038278,EDS 284,A00,507350,Daly; Alan J.,16,0,16,0
1713503039308,EDS 286,A00,507359,Fine; Sarah,18,0,18,0
1713503040334,EDS 289C,A01,507361,Daly; Alan J.,18,0,18,0
1713503041360,EDS 290,A00,507366,Hofstetter; Carolyn,15,0,15,0
1713503042386,LIGM 5A,A00,507421,Fischer-Grunski; Eva K,20,0,20,0
1713503043415,LIGM 5B,A00,507423,Fischer-Grunski; Eva K,20,0,20,0
1713503044444,LIGM 5C,A00,507425,Fischer-Grunski; Eva K,20,0,20,0
1713503045470,LIIT 5AS,A00,507427,Carnelos; Chiara,20,0,20,0
1713503046497,LIIT 5BS,A00,507430,Carnelos; Chiara,20,0,20,0
1713503047524,LIIT 5CS,A00,507432,Carnelos; Chiara,20,0,20,0
1713503048555,LISP 5A,A00,507541,Munoz Sanchez; Alicia,14,0,20,6
1713503049581,LISP 5B,A00,507671,Munoz Sanchez; Alicia,12,0,20,8
1713503050606,LISP 5C,A00,507696,Munoz Sanchez; Alicia,11,0,20,9
1713503051631,MAE 197,001,528363,Boechler; Nicholas Sebastia,9998,0,9999,1
1713503052656,MATH 197,001,523477,Kedlaya; Kiran S.,9999,0,9999,0
1713503052656,MATH 197,002,563811,Zhang; Danna,9998,0,9999,1
1713503053682,MCWP 40R,A00,518780,Staff,14,0,20,6
1713503053682,MCWP 40R,B00,518781,Staff,11,0,20,9
1713503053682,MCWP 40R,C00,518783,Staff,8,0,20,12
1713503054708,MCWP 50R,A00,518791,Staff,7,0,20,13
1713503054708,MCWP 50R,B00,518792,Staff,3,0,20,17
1713503054708,MCWP 50R,C00,518793,Staff,5,0,20,15
1713503054708,MCWP 50R,D00,518794,Staff,0,0,20,20
1713503054708,MCWP 50R,E00,518795,Staff,0,0,20,20
1713503054708,MCWP 50R,F00,518796,Staff,11,0,20,9
1713503054708,MCWP 50R,G00,518797,Staff,10,0,20,10
1713503055733,MMW 12R,A01,514034,Herbst; Matthew,3,0,16,13
1713503055733,MMW 12R,A02,514035,Herbst; Matthew,13,0,16,3
1713503056762,MMW 13R,A01,514037,Staff,0,8,16,16
1713503056762,MMW 13R,A02,514039,Staff,0,7,16,16
1713503058813,SIO 295LS,A00,523233,Staff,15,0,30,15
1713503059839,SIO 295S,A00,523232,Staff,15,0,30,15
1713503060868,SOCI 117,A01,494376,Staff,0,2,5,5
1713503061897,WES 237B,A00,494380,Staff,19,0,20,1
1713503063968,AESE 279B,A00,494370,Wade; Jon P,33,0,33,0
1713503064993,AIP 197,001,627712,Vespa; Emanuel Ignacio,9999,0,9999,0
1713503066017,ANAR 135S,A00,494369,Braswell; Geoffrey E.,0,0,0,0
1713503067045,CAT 124RS,A01,519847,Geibel; William,6,0,20,14
1713503068074,CAT 125RS,A01,515971,Geibel; William,6,0,20,14
1713503069098,CLRE 250,A00,511389,Morris; Sheldon,9996,0,9999,3
1713503070124,CLRE 251,A00,507176,Mehta; Ravindra L.,9996,0,9999,3
1713503070124,CLRE 251,B00,511410,Mehta; Ravindra L.,9998,0,9999,1
1713503071202,CLRE 252,A00,507189,Cuomo; Raphael Eduardo,9998,0,9999,1
1713503072227,CLRE 253,A00,507199,Vaida; Florin,9997,0,9999,2
1713503072227,CLRE 253,B00,507202,Vaida; Florin,9999,0,9999,0
1713503073255,CLRE 259,A00,507211,Patel; Hemal,9996,0,9999,3
1713503074281,CLRE 260,A00,507221,Cuomo; Raphael Eduardo,9999,0,9999,0
1713503075309,CLRE 297,001,507242,Cuomo; Raphael Eduardo,9999,0,9999,0
1713503076336,CSE 191,A00,516875,Minnes Kemp; Mor Mia,9999,0,9999,0
1713503077361,CSS 201S,A01,494383,Staff,35,0,35,0
1713503078386,CSS 202S,A01,494387,Staff,35,0,35,0
1713503079413,EAP 100,A00,516065,Staff,9792,0,9999,207
1713503080439,ECE 45,A01,507414,Staff,37,0,60,23
1713503081464,ECE 100,A01,507416,Baghdadchi; Saharnaz,0,0,20,20
1713503081464,ECE 100,A02,507418,Baghdadchi; Saharnaz,19,0,20,1
1713503082490,ECE 111,A01,507420,Staff,27,0,50,23
1713503083519,ECE 197,001,548057,Sievenpiper; Daniel F.,9998,0,9999,1
1713503084546,EDS 115,A00,507243,Choi; Bailey Miyeon,27,0,28,1
1713503085576,EDS 117,A01,494379,Staff,15,0,25,10
1713503086603,EDS 125,A00,507246,Hopkins; Megan Beth,27,0,30,3
1713503087629,EDS 128A,A01,507264,Fargason; Sharon Gayle,26,0,26,0
1713503088654,EDS 128B,A01,507293,Pappas; Elizabeth,30,0,30,0
1713503089681,EDS 139,A00,507294,Fargason; Sharon Gayle,30,0,30,0
1713503089681,EDS 139,B00,507313,Pappas; Elizabeth,30,0,30,0
1713503090707,EDS 201,A00,507315,Staff,18,0,30,12
1713503091735,EDS 203,A01,507317,Halter; Christopher P.,17,0,30,13
1713503092762,EDS 204R,A01,507319,Halter; Christopher P.,0,1,30,30
1713503092762,EDS 204R,B01,507331,Heinzman; Erica M.,22,0,30,8
1713503093787,EDS 206R,A00,507332,Staff,0,2,30,30
1713503093787,EDS 206R,B00,507343,Staff,23,0,30,7
1713503094812,EDS 250,A00,507344,Hemans; Patricia Ann Benitez,27,0,40,13
1713503095841,EDS 281,A00,507345,Daly; Alan J.,18,0,18,0
1713503096870,EDS 284,A00,507350,Daly; Alan J.,16,0,16,0
1713503097899,EDS 286,A00,507359,Fine; Sarah,18,0,18,0
1713503098928,EDS 289C,A01,507361,Daly; Alan J.,18,0,18,0
1713503099954,EDS 290,A00,507366,Hofstetter; Carolyn,15,0,15,0
1713503100981,LIGM 5A,A00,507421,Fischer-Grunski; Eva K,20,0,20,0
1713503102009,LIGM 5B,A00,507423,Fischer-Grunski; Eva K,20,0,20,0
1713503103036,LIGM 5C,A00,507425,Fischer-Grunski; Eva K,20,0,20,0
1713503104065,LIIT 5AS,A00,507427,Carnelos; Chiara,20,0,20,0
1713503105091,LIIT 5BS,A00,507430,Carnelos; Chiara,20,0,20,0
1713503106116,LIIT 5CS,A00,507432,Carnelos; Chiara,20,0,20,0
1713503107146,LISP 5A,A00,507541,Munoz Sanchez; Alicia,14,0,20,6
1713503108172,LISP 5B,A00,507671,Munoz Sanchez; Alicia,12,0,20,8
1713503109200,LISP 5C,A00,507696,Munoz Sanchez; Alicia,11,0,20,9
1713503110229,MAE 197,001,528363,Boechler; Nicholas Sebastia,9998,0,9999,1
1713503111253,MATH 197,001,523477,Kedlaya; Kiran S.,9999,0,9999,0
1713503111253,MATH 197,002,563811,Zhang; Danna,9998,0,9999,1
1713503112278,MCWP 40R,A00,518780,Staff,14,0,20,6
1713503112278,MCWP 40R,B00,518781,Staff,11,0,20,9
1713503112278,MCWP 40R,C00,518783,Staff,8,0,20,12
1713503113306,MCWP 50R,A00,518791,Staff,7,0,20,13
1713503113306,MCWP 50R,B00,518792,Staff,3,0,20,17
1713503113306,MCWP 50R,C00,518793,Staff,5,0,20,15
1713503113306,MCWP 50R,D00,518794,Staff,0,0,20,20
1713503113306,MCWP 50R,E00,518795,Staff,0,0,20,20
1713503113306,MCWP 50R,F00,518796,Staff,11,0,20,9
1713503113306,MCWP 50R,G00,518797,Staff,10,0,20,10
1713503114331,MMW 12R,A01,514034,Herbst; Matthew,2,0,16,14
1713503114331,MMW 12R,A02,514035,Herbst; Matthew,13,0,16,3
1713503115354,MMW 13R,A01,514037,Staff,0,8,16,16
1713503115354,MMW 13R,A02,514039,Staff,0,7,16,16
1713503117406,SIO 295LS,A00,523233,Staff,15,0,30,15
1713503118434,SIO 295S,A00,523232,Staff,15,0,30,15
1713503119459,SOCI 117,A01,494376,Staff,0,2,5,5
1713503120484,WES 237B,A00,494380,Staff,19,0,20,1
1713503122541,AESE 279B,A00,494370,Wade; Jon P,33,0,33,0
1713503123569,AIP 197,001,627712,Vespa; Emanuel Ignacio,9999,0,9999,0
1713503124596,ANAR 135S,A00,494369,Braswell; Geoffrey E.,0,0,0,0
1713503125624,CAT 124RS,A01,519847,Geibel; William,6,0,20,14
1713503126714,CAT 125RS,A01,515971,Geibel; William,6,0,20,14
1713503127741,CLRE 250,A00,511389,Morris; Sheldon,9996,0,9999,3
1713503128765,CLRE 251,A00,507176,Mehta; Ravindra L.,9996,0,9999,3
1713503128765,CLRE 251,B00,511410,Mehta; Ravindra L.,9998,0,9999,1
1713503129790,CLRE 252,A00,507189,Cuomo; Raphael Eduardo,9998,0,9999,1
1713503130816,CLRE 253,A00,507199,Vaida; Florin,9997,0,9999,2
1713503130816,CLRE 253,B00,507202,Vaida; Florin,9999,0,9999,0
1713503131842,CLRE 259,A00,507211,Patel; Hemal,9996,0,9999,3
1713503132870,CLRE 260,A00,507221,Cuomo; Raphael Eduardo,9999,0,9999,0
1713503133900,CLRE 297,001,507242,Cuomo; Raphael Eduardo,9999,0,9999,0
1713503134924,CSE 191,A00,516875,Minnes Kemp; Mor Mia,9999,0,9999,0
1713503135952,CSS 201S,A01,494383,Staff,35,0,35,0
1713503136982,CSS 202S,A01,494387,Staff,35,0,35,0
1713503138007,EAP 100,A00,516065,Staff,9792,0,9999,207
1713503139035,ECE 45,A01,507414,Staff,37,0,60,23
1713503140061,ECE 100,A01,507416,Baghdadchi; Saharnaz,0,0,20,20
1713503140061,ECE 100,A02,507418,Baghdadchi; Saharnaz,19,0,20,1
1713503141087,ECE 111,A01,507420,Staff,27,0,50,23
1713503142112,ECE 197,001,548057,Sievenpiper; Daniel F.,9998,0,9999,1
1713503143140,EDS 115,A00,507243,Choi; Bailey Miyeon,27,0,28,1
1713503144167,EDS 117,A01,494379,Staff,15,0,25,10
1713503145196,EDS 125,A00,507246,Hopkins; Megan Beth,27,0,30,3
1713503146224,EDS 128A,A01,507264,Fargason; Sharon Gayle,26,0,26,0
1713503147252,EDS 128B,A01,507293,Pappas; Elizabeth,30,0,30,0
1713503148281,EDS 139,A00,507294,Fargason; Sharon Gayle,30,0,30,0
1713503148281,EDS 139,B00,507313,Pappas; Elizabeth,30,0,30,0
1713503149307,EDS 201,A00,507315,Staff,18,0,30,12
1713503150331,EDS 203,A01,507317,Halter; Christopher P.,17,0,30,13
1713503151360,EDS 204R,A01,507319,Halter; Christopher P.,0,1,30,30
1713503151360,EDS 204R,B01,507331,Heinzman; Erica M.,22,0,30,8
1713503152388,EDS 206R,A00,507332,Staff,0,2,30,30
1713503152388,EDS 206R,B00,507343,Staff,23,0,30,7
1713503153414,EDS 250,A00,507344,Hemans; Patricia Ann Benitez,27,0,40,13
1713503154443,EDS 281,A00,507345,Daly; Alan J.,18,0,18,0
1713503155469,EDS 284,A00,507350,Daly; Alan J.,16,0,16,0
1713503156494,EDS 286,A00,507359,Fine; Sarah,18,0,18,0
1713503157520,EDS 289C,A01,507361,Daly; Alan J.,18,0,18,0
1713503158554,EDS 290,A00,507366,Hofstetter; Carolyn,15,0,15,0
1713503159579,LIGM 5A,A00,507421,Fischer-Grunski; Eva K,20,0,20,0
1713503160608,LIGM 5B,A00,507423,Fischer-Grunski; Eva K,20,0,20,0
1713503161637,LIGM 5C,A00,507425,Fischer-Grunski; Eva K,20,0,20,0
1713503162663,LIIT 5AS,A00,507427,Carnelos; Chiara,20,0,20,0
1713503163692,LIIT 5BS,A00,507430,Carnelos; Chiara,20,0,20,0
1713503164717,LIIT 5CS,A00,507432,Carnelos; Chiara,20,0,20,0
1713503165743,LISP 5A,A00,507541,Munoz Sanchez; Alicia,14,0,20,6
1713503166773,LISP 5B,A00,507671,Munoz Sanchez; Alicia,12,0,20,8
1713503167798,LISP 5C,A00,507696,Munoz Sanchez; Alicia,11,0,20,9
1713503168826,MAE 197,001,528363,Boechler; Nicholas Sebastia,9998,0,9999,1
1713503169853,MATH 197,001,523477,Kedlaya; Kiran S.,9999,0,9999,0
1713503169853,MATH 197,002,563811,Zhang; Danna,9998,0,9999,1
1713503170878,MCWP 40R,A00,518780,Staff,13,0,20,7
1713503170878,MCWP 40R,B00,518781,Staff,11,0,20,9
1713503170878,MCWP 40R,C00,518783,Staff,8,0,20,12
1713503171908,MCWP 50R,A00,518791,Staff,7,0,20,13
1713503171908,MCWP 50R,B00,518792,Staff,3,0,20,17
1713503171908,MCWP 50R,C00,518793,Staff,5,0,20,15
1713503171908,MCWP 50R,D00,518794,Staff,0,0,20,20
1713503171908,MCWP 50R,E00,518795,Staff,0,0,20,20
1713503171908,MCWP 50R,F00,518796,Staff,11,0,20,9
1713503171908,MCWP 50R,G00,518797,Staff,10,0,20,10
1713503172935,MMW 12R,A01,514034,Herbst; Matthew,2,0,16,14
1713503172935,MMW 12R,A02,514035,Herbst; Matthew,13,0,16,3
1713503173960,MMW 13R,A01,514037,Staff,0,8,16,16
1713503173960,MMW 13R,A02,514039,Staff,0,7,16,16
1713503176082,SIO 295LS,A00,523233,Staff,15,0,30,15
1713503177107,SIO 295S,A00,523232,Staff,15,0,30,15
1713503178136,SOCI 117,A01,494376,Staff,0,2,5,5
1713503179161,WES 237B,A00,494380,Staff,19,0,20,1
1713503181221,AESE 279B,A00,494370,Wade; Jon P,33,0,33,0
1713503182244,AIP 197,001,627712,Vespa; Emanuel Ignacio,9999,0,9999,0
1713503183269,ANAR 135S,A00,494369,Braswell; Geoffrey E.,0,0,0,0
1713503184296,CAT 124RS,A01,519847,Geibel; William,6,0,20,14
1713503185323,CAT 125RS,A01,515971,Geibel; William,6,0,20,14
1713503186353,CLRE 250,A00,511389,Morris; Sheldon,9996,0,9999,3
1713503187381,CLRE 251,A00,507176,Mehta; Ravindra L.,9996,0,9999,3
1713503187381,CLRE 251,B00,511410,Mehta; Ravindra L.,9998,0,9999,1
1713503188408,CLRE 252,A00,507189,Cuomo; Raphael Eduardo,9998,0,9999,1
1713503189437,CLRE 253,A00,507199,Vaida; Florin,9997,0,9999,2
1713503189437,CLRE 253,B00,507202,Vaida; Florin,9999,0,9999,0
1713503190461,CLRE 259,A00,507211,Patel; Hemal,9996,0,9999,3
1713503191487,CLRE 260,A00,507221,Cuomo; Raphael Eduardo,9999,0,9999,0
1713503192512,CLRE 297,001,507242,Cuomo; Raphael Eduardo,9999,0,9999,0
1713503193540,CSE 191,A00,516875,Minnes Kemp; Mor Mia,9999,0,9999,0
1713503194569,CSS 201S,A01,494383,Staff,35,0,35,0
1713503195595,CSS 202S,A01,494387,Staff,35,0,35,0
1713503196622,EAP 100,A00,516065,Staff,9792,0,9999,207
1713503197649,ECE 45,A01,507414,Staff,37,0,60,23
1713503198679,ECE 100,A01,507416,Baghdadchi; Saharnaz,0,0,20,20
1713503198679,ECE 100,A02,507418,Baghdadchi; Saharnaz,19,0,20,1
1713503199708,ECE 111,A01,507420,Staff,27,0,50,23
1713503200733,ECE 197,001,548057,Sievenpiper; Daniel F.,9998,0,9999,1
1713503201757,EDS 115,A00,507243,Choi; Bailey Miyeon,27,0,28,1
1713503202784,EDS 117,A01,494379,Staff,15,0,25,10
1713503203810,EDS 125,A00,507246,Hopkins; Megan Beth,27,0,30,3
1713503204838,EDS 128A,A01,507264,Fargason; Sharon Gayle,26,0,26,0
1713503205868,EDS 128B,A01,507293,Pappas; Elizabeth,30,0,30,0
1713503206894,EDS 139,A00,507294,Fargason; Sharon Gayle,30,0,30,0
1713503206894,EDS 139,B00,507313,Pappas; Elizabeth,30,0,30,0
1713503207920,EDS 201,A00,507315,Staff,18,0,30,12
1713503208945,EDS 203,A01,507317,Halter; Christopher P.,17,0,30,13
1713503209969,EDS 204R,A01,507319,Halter; Christopher P.,0,1,30,30
1713503209969,EDS 204R,B01,507331,Heinzman; Erica M.,22,0,30,8
1713503210998,EDS 206R,A00,507332,Staff,0,2,30,30
1713503210998,EDS 206R,B00,507343,Staff,23,0,30,7
1713503212024,EDS 250,A00,507344,Hemans; Patricia Ann Benitez,27,0,40,13
1713503213050,EDS 281,A00,507345,Daly; Alan J.,18,0,18,0
1713503214133,EDS 284,A00,507350,Daly; Alan J.,16,0,16,0
1713503215159,EDS 286,A00,507359,Fine; Sarah,18,0,18,0
1713503225269,EDS 289C,A01,507361,Daly; Alan J.,18,0,18,0
1713503226298,EDS 290,A00,507366,Hofstetter; Carolyn,15,0,15,0
1713503227325,LIGM 5A,A00,507421,Fischer-Grunski; Eva K,20,0,20,0
1713503228350,LIGM 5B,A00,507423,Fischer-Grunski; Eva K,20,0,20,0
1713503229376,LIGM 5C,A00,507425,Fischer-Grunski; Eva K,20,0,20,0
1713503230407,LIIT 5AS,A00,507427,Carnelos; Chiara,20,0,20,0
1713503231433,LIIT 5BS,A00,507430,Carnelos; Chiara,20,0,20,0
1713503232464,LIIT 5CS,A00,507432,Carnelos; Chiara,20,0,20,0
1713503233490,LISP 5A,A00,507541,Munoz Sanchez; Alicia,14,0,20,6
1713503234515,LISP 5B,A00,507671,Munoz Sanchez; Alicia,12,0,20,8
1713503235541,LISP 5C,A00,507696,Munoz Sanchez; Alicia,11,0,20,9
1713503236571,MAE 197,001,528363,Boechler; Nicholas Sebastia,9998,0,9999,1
1713503237597,MATH 197,001,523477,Kedlaya; Kiran S.,9999,0,9999,0
1713503237597,MATH 197,002,563811,Zhang; Danna,9998,0,9999,1
1713503238623,MCWP 40R,A00,518780,Staff,13,0,20,7
1713503238623,MCWP 40R,B00,518781,Staff,11,0,20,9
1713503238623,MCWP 40R,C00,518783,Staff,8,0,20,12
1713503239648,MCWP 50R,A00,518791,Staff,7,0,20,13
1713503239648,MCWP 50R,B00,518792,Staff,3,0,20,17
1713503239648,MCWP 50R,C00,518793,Staff,5,0,20,15
1713503239648,MCWP 50R,D00,518794,Staff,0,0,20,20
1713503239648,MCWP 50R,E00,518795,Staff,0,0,20,20
1713503239648,MCWP 50R,F00,518796,Staff,11,0,20,9
1713503239648,MCWP 50R,G00,518797,Staff,10,0,20,10
1713503240677,MMW 12R,A01,514034,Herbst; Matthew,2,0,16,14
1713503240677,MMW 12R,A02,514035,Herbst; Matthew,13,0,16,3
1713503241704,MMW 13R,A01,514037,Staff,0,8,16,16
1713503241704,MMW 13R,A02,514039,Staff,0,7,16,16
1713503243756,SIO 295LS,A00,523233,Staff,15,0,30,15
1713503244780,SIO 295S,A00,523232,Staff,15,0,30,15
1713503245809,SOCI 117,A01,494376,Staff,0,2,5,5
1713503246832,WES 237B,A00,494380,Staff,19,0,20,1
1713503248895,AESE 279B,A00,494370,Wade; Jon P,33,0,33,0
1713503249921,AIP 197,001,627712,Vespa; Emanuel Ignacio,9999,0,9999,0
1713503250948,ANAR 135S,A00,494369,Braswell; Geoffrey E.,0,0,0,0
1713503251991,CAT 124RS,A01,519847,Geibel; William,6,0,20,14
1713503253019,CAT 125RS,A01,515971,Geibel; William,6,0,20,14
1713503254044,CLRE 250,A00,511389,Morris; Sheldon,9996,0,9999,3
1713503255069,CLRE 251,A00,507176,Mehta; Ravindra L.,9996,0,9999,3
1713503255069,CLRE 251,B00,511410,Mehta; Ravindra L.,9998,0,9999,1
1713503256095,CLRE 252,A00,507189,Cuomo; Raphael Eduardo,9998,0,9999,1
1713503257125,CLRE 253,A00,507199,Vaida; Florin,9997,0,9999,2
1713503257125,CLRE 253,B00,507202,Vaida; Florin,9999,0,9999,0
1713503258149,CLRE 259,A00,507211,Patel; Hemal,9996,0,9999,3
1713503259176,CLRE 260,A00,507221,Cuomo; Raphael Eduardo,9999,0,9999,0
1713503260201,CLRE 297,001,507242,Cuomo; Raphael Eduardo,9999,0,9999,0
1713503261230,CSE 191,A00,516875,Minnes Kemp; Mor Mia,9999,0,9999,0
1713503262261,CSS 201S,A01,494383,Staff,35,0,35,0
1713503263285,CSS 202S,A01,494387,Staff,35,0,35,0
1713503264311,EAP 100,A00,516065,Staff,9792,0,9999,207
1713503265342,ECE 45,A01,507414,Staff,37,0,60,23
1713503266367,ECE 100,A01,507416,Baghdadchi; Saharnaz,0,0,20,20
1713503266367,ECE 100,A02,507418,Baghdadchi; Saharnaz,19,0,20,1
1713503267392,ECE 111,A01,507420,Staff,27,0,50,23
1713503268417,ECE 197,001,548057,Sievenpiper; Daniel F.,9998,0,9999,1
1713503269444,EDS 115,A00,507243,Choi; Bailey Miyeon,27,0,28,1
1713503270470,EDS 117,A01,494379,Staff,15,0,25,10
1713503271495,EDS 125,A00,507246,Hopkins; Megan Beth,27,0,30,3
1713503272521,EDS 128A,A01,507264,Fargason; Sharon Gayle,26,0,26,0
1713503273548,EDS 128B,A01,507293,Pappas; Elizabeth,30,0,30,0
1713503274576,EDS 139,A00,507294,Fargason; Sharon Gayle,30,0,30,0
1713503274576,EDS 139,B00,507313,Pappas; Elizabeth,30,0,30,0
1713503275603,EDS 201,A00,507315,Staff,18,0,30,12
1713503276628,EDS 203,A01,507317,Halter; Christopher P.,17,0,30,13
1713503277652,EDS 204R,A01,507319,Halter; Christopher P.,0,1,30,30
1713503277652,EDS 204R,B01,507331,Heinzman; Erica M.,22,0,30,8
1713503278677,EDS 206R,A00,507332,Staff,0,2,30,30
1713503278677,EDS 206R,B00,507343,Staff,23,0,30,7
1713503279703,EDS 250,A00,507344,Hemans; Patricia Ann Benitez,27,0,40,13
1713503280728,EDS 281,A00,507345,Daly; Alan J.,18,0,18,0
1713503281757,EDS 284,A00,507350,Daly; Alan J.,16,0,16,0
1713503282782,EDS 286,A00,507359,Fine; Sarah,18,0,18,0
1713503283812,EDS 289C,A01,507361,Daly; Alan J.,18,0,18,0
1713503284836,EDS 290,A00,507366,Hofstetter; Carolyn,15,0,15,0
1713503285867,LIGM 5A,A00,507421,Fischer-Grunski; Eva K,20,0,20,0
1713503286897,LIGM 5B,A00,507423,Fischer-Grunski; Eva K,20,0,20,0
1713503287979,LIGM 5C,A00,507425,Fischer-Grunski; Eva K,20,0,20,0
1713503289005,LIIT 5AS,A00,507427,Carnelos; Chiara,20,0,20,0
1713503290034,LIIT 5BS,A00,507430,Carnelos; Chiara,20,0,20,0
1713503291060,LIIT 5CS,A00,507432,Carnelos; Chiara,20,0,20,0
1713503292086,LISP 5A,A00,507541,Munoz Sanchez; Alicia,14,0,20,6
1713503293112,LISP 5B,A00,507671,Munoz Sanchez; Alicia,12,0,20,8
1713503294138,LISP 5C,A00,507696,Munoz Sanchez; Alicia,11,0,20,9
1713503295165,MAE 197,001,528363,Boechler; Nicholas Sebastia,9998,0,9999,1
1713503296189,MATH 197,001,523477,Kedlaya; Kiran S.,9999,0,9999,0
1713503296189,MATH 197,002,563811,Zhang; Danna,9998,0,9999,1
1713503297218,MCWP 40R,A00,518780,Staff,13,0,20,7
1713503297218,MCWP 40R,B00,518781,Staff,11,0,20,9
1713503297218,MCWP 40R,C00,518783,Staff,8,0,20,12
1713503298247,MCWP 50R,A00,518791,Staff,7,0,20,13
1713503298247,MCWP 50R,B00,518792,Staff,3,0,20,17
1713503298247,MCWP 50R,C00,518793,Staff,5,0,20,15
1713503298247,MCWP 50R,D00,518794,Staff,0,0,20,20
1713503298247,MCWP 50R,E00,518795,Staff,0,0,20,20
1713503298247,MCWP 50R,F00,518796,Staff,11,0,20,9
1713503298247,MCWP 50R,G00,518797,Staff,10,0,20,10
1713503299274,MMW 12R,A01,514034,Herbst; Matthew,2,0,16,14
1713503299274,MMW 12R,A02,514035,Herbst; Matthew,13,0,16,3
1713503300303,MMW 13R,A01,514037,Staff,0,8,16,16
1713503300303,MMW 13R,A02,514039,Staff,0,7,16,16
1713503302357,SIO 295LS,A00,523233,Staff,15,0,30,15
1713503303383,SIO 295S,A00,523232,Staff,15,0,30,15
1713503304409,SOCI 117,A01,494376,Staff,0,2,5,5
1713503305436,WES 237B,A00,494380,Staff,19,0,20,1
1713503307501,AESE 279B,A00,494370,Wade; Jon P,33,0,33,0
1713503308530,AIP 197,001,627712,Vespa; Emanuel Ignacio,9999,0,9999,0
1713503309556,ANAR 135S,A00,494369,Braswell; Geoffrey E.,0,0,0,0
1713503310585,CAT 124RS,A01,519847,Geibel; William,6,0,20,14
1713503311611,CAT 125RS,A01,515971,Geibel; William,6,0,20,14
1713503312640,CLRE 250,A00,511389,Morris; Sheldon,9996,0,9999,3
1713503313672,CLRE 251,A00,507176,Mehta; Ravindra L.,9996,0,9999,3
1713503313672,CLRE 251,B00,511410,Mehta; Ravindra L.,9998,0,9999,1
1713503314696,CLRE 252,A00,507189,Cuomo; Raphael Eduardo,9998,0,9999,1
1713503315728,CLRE 253,A00,507199,Vaida; Florin,9997,0,9999,2
1713503315728,CLRE 253,B00,507202,Vaida; Florin,9999,0,9999,0
1713503316753,CLRE 259,A00,507211,Patel; Hemal,9996,0,9999,3
1713503317787,CLRE 260,A00,507221,Cuomo; Raphael Eduardo,9999,0,9999,0
1713503318813,CLRE 297,001,507242,Cuomo; Raphael Eduardo,9999,0,9999,0
1713503319839,CSE 191,A00,516875,Minnes Kemp; Mor Mia,9999,0,9999,0
1713503320869,CSS 201S,A01,494383,Staff,35,0,35,0
1713503321894,CSS 202S,A01,494387,Staff,35,0,35,0
1713503322919,EAP 100,A00,516065,Staff,9792,0,9999,207
1713503323948,ECE 45,A01,507414,Staff,37,0,60,23
1713503324975,ECE 100,A01,507416,Baghdadchi; Saharnaz,0,0,20,20
1713503324975,ECE 100,A02,507418,Baghdadchi; Saharnaz,19,0,20,1
1713503326003,ECE 111,A01,507420,Staff,27,0,50,23
1713503327027,ECE 197,001,548057,Sievenpiper; Daniel F.,9998,0,9999,1
1713503328051,EDS 115,A00,507243,Choi; Bailey Miyeon,27,0,28,1
1713503329076,EDS 117,A01,494379,Staff,15,0,25,10
1713503330102,EDS 125,A00,507246,Hopkins; Megan Beth,27,0,30,3
1713503331131,EDS 128A,A01,507264,Fargason; Sharon Gayle,26,0,26,0
1713503332160,EDS 128B,A01,507293,Pappas; Elizabeth,30,0,30,0
1713503333186,EDS 139,A00,507294,Fargason; Sharon Gayle,30,0,30,0
1713503333186,EDS 139,B00,507313,Pappas; Elizabeth,30,0,30,0
1713503334261,EDS 201,A00,507315,Staff,18,0,30,12
1713503335291,EDS 203,A01,507317,Halter; Christopher P.,17,0,30,13
1713503336318,EDS 204R,A01,507319,Halter; Christopher P.,0,1,30,30
1713503336318,EDS 204R,B01,507331,Heinzman; Erica M.,22,0,30,8
1713503337346,EDS 206R,A00,507332,Staff,0,2,30,30
1713503337346,EDS 206R,B00,507343,Staff,23,0,30,7
1713503338373,EDS 250,A00,507344,Hemans; Patricia Ann Benitez,27,0,40,13
1713503339400,EDS 281,A00,507345,Daly; Alan J.,18,0,18,0
1713503340424,EDS 284,A00,507350,Daly; Alan J.,16,0,16,0
1713503341450,EDS 286,A00,507359,Fine; Sarah,18,0,18,0
1713503342479,EDS 289C,A01,507361,Daly; Alan J.,18,0,18,0
1713503343506,EDS 290,A00,507366,Hofstetter; Carolyn,15,0,15,0
1713503344536,LIGM 5A,A00,507421,Fischer-Grunski; Eva K,20,0,20,0
1713503345565,LIGM 5B,A00,507423,Fischer-Grunski; Eva K,20,0,20,0
1713503346591,LIGM 5C,A00,507425,Fischer-Grunski; Eva K,20,0,20,0
1713503347615,LIIT 5AS,A00,507427,Carnelos; Chiara,20,0,20,0
1713503348639,LIIT 5BS,A00,507430,Carnelos; Chiara,20,0,20,0
1713503349666,LIIT 5CS,A00,507432,Carnelos; Chiara,20,0,20,0
1713503350696,LISP 5A,A00,507541,Munoz Sanchez; Alicia,14,0,20,6
1713503351722,LISP 5B,A00,507671,Munoz Sanchez; Alicia,12,0,20,8
1713503352748,LISP 5C,A00,507696,Munoz Sanchez; Alicia,11,0,20,9
1713503353774,MAE 197,001,528363,Boechler; Nicholas Sebastia,9998,0,9999,1
1713503354798,MATH 197,001,523477,Kedlaya; Kiran S.,9999,0,9999,0
1713503354798,MATH 197,002,563811,Zhang; Danna,9998,0,9999,1
1713503355823,MCWP 40R,A00,518780,Staff,13,0,20,7
1713503355823,MCWP 40R,B00,518781,Staff,11,0,20,9
1713503355823,MCWP 40R,C00,518783,Staff,8,0,20,12
1713503356849,MCWP 50R,A00,518791,Staff,7,0,20,13
1713503356849,MCWP 50R,B00,518792,Staff,3,0,20,17
1713503356849,MCWP 50R,C00,518793,Staff,5,0,20,15
1713503356849,MCWP 50R,D00,518794,Staff,0,0,20,20
1713503356849,MCWP 50R,E00,518795,Staff,0,0,20,20
1713503356849,MCWP 50R,F00,518796,Staff,11,0,20,9
1713503356849,MCWP 50R,G00,518797,Staff,10,0,20,10
1713503357876,MMW 12R,A01,514034,Herbst; Matthew,2,0,16,14
1713503357876,MMW 12R,A02,514035,Herbst; Matthew,13,0,16,3
1713503358901,MMW 13R,A01,514037,Staff,0,8,16,16
1713503358901,MMW 13R,A02,514039,Staff,0,7,16,16
1713503360958,SIO 295LS,A00,523233,Staff,15,0,30,15
1713503361983,SIO 295S,A00,523232,Staff,15,0,30,15
1713503363012,SOCI 117,A01,494376,Staff,0,2,5,5
1713503364038,WES 237B,A00,494380,Staff,19,0,20,1
1713503366116,AESE 279B,A00,494370,Wade; Jon P,33,0,33,0
1713503367145,AIP 197,001,627712,Vespa; Emanuel Ignacio,9999,0,9999,0
1713503368171,ANAR 135S,A00,494369,Braswell; Geoffrey E.,0,0,0,0
1713503369198,CAT 124RS,A01,519847,Geibel; William,6,0,20,14
1713503370226,CAT 125RS,A01,515971,Geibel; William,6,0,20,14
1713503371252,CLRE 250,A00,511389,Morris; Sheldon,9996,0,9999,3
1713503372279,CLRE 251,A00,507176,Mehta; Ravindra L.,9996,0,9999,3
1713503372279,CLRE 251,B00,511410,Mehta; Ravindra L.,9998,0,9999,1
1713503373306,CLRE 252,A00,507189,Cuomo; Raphael Eduardo,9998,0,9999,1
1713503374333,CLRE 253,A00,507199,Vaida; Florin,9997,0,9999,2
1713503374333,CLRE 253,B00,507202,Vaida; Florin,9999,0,9999,0
1713503375360,CLRE 259,A00,507211,Patel; Hemal,9996,0,9999,3
1713503376384,CLRE 260,A00,507221,Cuomo; Raphael Eduardo,9999,0,9999,0
1713503377409,CLRE 297,001,507242,Cuomo; Raphael Eduardo,9999,0,9999,0
1713503378434,CSE 191,A00,516875,Minnes Kemp; Mor Mia,9999,0,9999,0
1713503379465,CSS 201S,A01,494383,Staff,35,0,35,0
1713503380495,CSS 202S,A01,494387,Staff,35,0,35,0
1713503381520,EAP 100,A00,516065,Staff,9792,0,9999,207
1713503382576,ECE 45,A01,507414,Staff,37,0,60,23
1713503383607,ECE 100,A01,507416,Baghdadchi; Saharnaz,0,0,20,20
1713503383607,ECE 100,A02,507418,Baghdadchi; Saharnaz,19,0,20,1
1713503384633,ECE 111,A01,507420,Staff,27,0,50,23
1713503385660,ECE 197,001,548057,Sievenpiper; Daniel F.,9998,0,9999,1
1713503386690,EDS 115,A00,507243,Choi; Bailey Miyeon,27,0,28,1
1713503387715,EDS 117,A01,494379,Staff,15,0,25,10
1713503388740,EDS 125,A00,507246,Hopkins; Megan Beth,27,0,30,3
1713503389766,EDS 128A,A01,507264,Fargason; Sharon Gayle,26,0,26,0
1713503390792,EDS 128B,A01,507293,Pappas; Elizabeth,30,0,30,0
1713503391878,EDS 139,A00,507294,Fargason; Sharon Gayle,30,0,30,0
1713503391878,EDS 139,B00,507313,Pappas; Elizabeth,30,0,30,0
1713503392904,EDS 201,A00,507315,Staff,18,0,30,12
1713503393931,EDS 203,A01,507317,Halter; Christopher P.,17,0,30,13
1713503394960,EDS 204R,A01,507319,Halter; Christopher P.,0,1,30,30
1713503394960,EDS 204R,B01,507331,Heinzman; Erica M.,22,0,30,8
1713503395990,EDS 206R,A00,507332,Staff,0,2,30,30
1713503395990,EDS 206R,B00,507343,Staff,23,0,30,7
1713503397016,EDS 250,A00,507344,Hemans; Patricia Ann Benitez,27,0,40,13
1713503398043,EDS 281,A00,507345,Daly; Alan J.,18,0,18,0
1713503399069,EDS 284,A00,507350,Daly; Alan J.,16,0,16,0
1713503400095,EDS 286,A00,507359,Fine; Sarah,18,0,18,0
1713503401126,EDS 289C,A01,507361,Daly; Alan J.,18,0,18,0
1713503402153,EDS 290,A00,507366,Hofstetter; Carolyn,15,0,15,0
1713503403182,LIGM 5A,A00,507421,Fischer-Grunski; Eva K,20,0,20,0
1713503404208,LIGM 5B,A00,507423,Fischer-Grunski; Eva K,20,0,20,0
1713503405234,LIGM 5C,A00,507425,Fischer-Grunski; Eva K,20,0,20,0
1713503406265,LIIT 5AS,A00,507427,Carnelos; Chiara,20,0,20,0
1713503407292,LIIT 5BS,A00,507430,Carnelos; Chiara,20,0,20,0
1713503408320,LIIT 5CS,A00,507432,Carnelos; Chiara,20,0,20,0
1713503409351,LISP 5A,A00,507541,Munoz Sanchez; Alicia,14,0,20,6
1713503410376,LISP 5B,A00,507671,Munoz Sanchez; Alicia,12,0,20,8
1713503411404,LISP 5C,A00,507696,Munoz Sanchez; Alicia,11,0,20,9
1713503412432,MAE 197,001,528363,Boechler; Nicholas Sebastia,9998,0,9999,1
1713503413460,MATH 197,001,523477,Kedlaya; Kiran S.,9999,0,9999,0
1713503413460,MATH 197,002,563811,Zhang; Danna,9998,0,9999,1
1713503414485,MCWP 40R,A00,518780,Staff,13,0,20,7
1713503414485,MCWP 40R,B00,518781,Staff,11,0,20,9
1713503414485,MCWP 40R,C00,518783,Staff,8,0,20,12
1713503415510,MCWP 50R,A00,518791,Staff,7,0,20,13
1713503415510,MCWP 50R,B00,518792,Staff,3,0,20,17
1713503415510,MCWP 50R,C00,518793,Staff,5,0,20,15
1713503415510,MCWP 50R,D00,518794,Staff,0,0,20,20
1713503415510,MCWP 50R,E00,518795,Staff,0,0,20,20
1713503415510,MCWP 50R,F00,518796,Staff,11,0,20,9
1713503415510,MCWP 50R,G00,518797,Staff,10,0,20,10
1713503416535,MMW 12R,A01,514034,Herbst; Matthew,2,0,16,14
1713503416535,MMW 12R,A02,514035,Herbst; Matthew,13,0,16,3
1713503417560,MMW 13R,A01,514037,Staff,0,8,16,16
1713503417560,MMW 13R,A02,514039,Staff,0,7,16,16
1713503419617,SIO 295LS,A00,523233,Staff,15,0,30,15
1713503420645,SIO 295S,A00,523232,Staff,15,0,30,15
1713503421675,SOCI 117,A01,494376,Staff,0,2,5,5
1713503422702,WES 237B,A00,494380,Staff,19,0,20,1
1713503424773,AESE 279B,A00,494370,Wade; Jon P,33,0,33,0
1713503425799,AIP 197,001,627712,Vespa; Emanuel Ignacio,9999,0,9999,0
1713503426826,ANAR 135S,A00,494369,Braswell; Geoffrey E.,0,0,0,0
1713503427854,CAT 124RS,A01,519847,Geibel; William,6,0,20,14
1713503428880,CAT 125RS,A01,515971,Geibel; William,6,0,20,14
1713503429905,CLRE 250,A00,511389,Morris; Sheldon,9996,0,9999,3
1713503430941,CLRE 251,A00,507176,Mehta; Ravindra L.,9996,0,9999,3
1713503430941,CLRE 251,B00,511410,Mehta; Ravindra L.,9998,0,9999,1
1713503431970,CLRE 252,A00,507189,Cuomo; Raphael Eduardo,9998,0,9999,1
1713503432997,CLRE 253,A00,507199,Vaida; Florin,9997,0,9999,2
1713503432997,CLRE 253,B00,507202,Vaida; Florin,9999,0,9999,0
1713503434022,CLRE 259,A00,507211,Patel; Hemal,9996,0,9999,3
1713503435050,CLRE 260,A00,507221,Cuomo; Raphael Eduardo,9999,0,9999,0
1713503436076,CLRE 297,001,507242,Cuomo; Raphael Eduardo,9999,0,9999,0
1713503437104,CSE 191,A00,516875,Minnes Kemp; Mor Mia,9999,0,9999,0
1713503438130,CSS 201S,A01,494383,Staff,35,0,35,0
1713503439156,CSS 202S,A01,494387,Staff,35,0,35,0
1713503440182,EAP 100,A00,516065,Staff,9792,0,9999,207
1713503441207,ECE 45,A01,507414,Staff,37,0,60,23
1713503442238,ECE 100,A01,507416,Baghdadchi; Saharnaz,0,0,20,20
1713503442238,ECE 100,A02,507418,Baghdadchi; Saharnaz,19,0,20,1
1713503443268,ECE 111,A01,507420,Staff,27,0,50,23
1713503444293,ECE 197,001,548057,Sievenpiper; Daniel F.,9998,0,9999,1
1713503445320,EDS 115,A00,507243,Choi; Bailey Miyeon,27,0,28,1
1713503446346,EDS 117,A01,494379,Staff,15,0,25,10
1713503447371,EDS 125,A00,507246,Hopkins; Megan Beth,27,0,30,3
1713503448402,EDS 128A,A01,507264,Fargason; Sharon Gayle,26,0,26,0
1713503449428,EDS 128B,A01,507293,Pappas; Elizabeth,30,0,30,0
1713503450455,EDS 139,A00,507294,Fargason; Sharon Gayle,30,0,30,0
1713503450455,EDS 139,B00,507313,Pappas; Elizabeth,30,0,30,0
1713503451484,EDS 201,A00,507315,Staff,18,0,30,12
1713503452514,EDS 203,A01,507317,Halter; Christopher P.,17,0,30,13
1713503453543,EDS 204R,A01,507319,Halter; Christopher P.,0,1,30,30
1713503453543,EDS 204R,B01,507331,Heinzman; Erica M.,22,0,30,8
1713503454569,EDS 206R,A00,507332,Staff,0,2,30,30
1713503454569,EDS 206R,B00,507343,Staff,23,0,30,7
1713503455593,EDS 250,A00,507344,Hemans; Patricia Ann Benitez,27,0,40,13
1713503456619,EDS 281,A00,507345,Daly; Alan J.,18,0,18,0
1713503457644,EDS 284,A00,507350,Daly; Alan J.,16,0,16,0
1713503458670,EDS 286,A00,507359,Fine; Sarah,18,0,18,0
1713503459696,EDS 289C,A01,507361,Daly; Alan J.,18,0,18,0
1713503460727,EDS 290,A00,507366,Hofstetter; Carolyn,15,0,15,0
1713503461753,LIGM 5A,A00,507421,Fischer-Grunski; Eva K,20,0,20,0
1713503462786,LIGM 5B,A00,507423,Fischer-Grunski; Eva K,20,0,20,0
1713503463817,LIGM 5C,A00,507425,Fischer-Grunski; Eva K,20,0,20,0
1713503464847,LIIT 5AS,A00,507427,Carnelos; Chiara,20,0,20,0
1713503465877,LIIT 5BS,A00,507430,Carnelos; Chiara,20,0,20,0
1713503466903,LIIT 5CS,A00,507432,Carnelos; Chiara,20,0,20,0
1713503467928,LISP 5A,A00,507541,Munoz Sanchez; Alicia,14,0,20,6
1713503468953,LISP 5B,A00,507671,Munoz Sanchez; Alicia,12,0,20,8
1713503469982,LISP 5C,A00,507696,Munoz Sanchez; Alicia,11,0,20,9
1713503471007,MAE 197,001,528363,Boechler; Nicholas Sebastia,9998,0,9999,1
1713503472033,MATH 197,001,523477,Kedlaya; Kiran S.,9999,0,9999,0
1713503472033,MATH 197,002,563811,Zhang; Danna,9998,0,9999,1
1713503473058,MCWP 40R,A00,518780,Staff,13,0,20,7
1713503473058,MCWP 40R,B00,518781,Staff,11,0,20,9
1713503473058,MCWP 40R,C00,518783,Staff,8,0,20,12
1713503474084,MCWP 50R,A00,518791,Staff,7,0,20,13
1713503474084,MCWP 50R,B00,518792,Staff,3,0,20,17
1713503474084,MCWP 50R,C00,518793,Staff,5,0,20,15
1713503474084,MCWP 50R,D00,518794,Staff,0,0,20,20
1713503474084,MCWP 50R,E00,518795,Staff,0,0,20,20
1713503474084,MCWP 50R,F00,518796,Staff,11,0,20,9
1713503474084,MCWP 50R,G00,518797,Staff,10,0,20,10
1713503475113,MMW 12R,A01,514034,Herbst; Matthew,2,0,16,14
1713503475113,MMW 12R,A02,514035,Herbst; Matthew,13,0,16,3
1713503476138,MMW 13R,A01,514037,Staff,0,8,16,16
1713503476138,MMW 13R,A02,514039,Staff,0,7,16,16
1713503478191,SIO 295LS,A00,523233,Staff,15,0,30,15
1713503479217,SIO 295S,A00,523232,Staff,15,0,30,15
1713503480246,SOCI 117,A01,494376,Staff,0,2,5,5
1713503481274,WES 237B,A00,494380,Staff,19,0,20,1
1713503483339,AESE 279B,A00,494370,Wade; Jon P,33,0,33,0
1713503484363,AIP 197,001,627712,Vespa; Emanuel Ignacio,9999,0,9999,0
1713503485389,ANAR 135S,A00,494369,Braswell; Geoffrey E.,0,0,0,0
1713503486414,CAT 124RS,A01,519847,Geibel; William,6,0,20,14
1713503487439,CAT 125RS,A01,515971,Geibel; William,6,0,20,14
1713503488464,CLRE 250,A00,511389,Morris; Sheldon,9996,0,9999,3
1713503489494,CLRE 251,A00,507176,Mehta; Ravindra L.,9996,0,9999,3
1713503489494,CLRE 251,B00,511410,Mehta; Ravindra L.,9998,0,9999,1
1713503490522,CLRE 252,A00,507189,Cuomo; Raphael Eduardo,9998,0,9999,1
1713503491549,CLRE 253,A00,507199,Vaida; Florin,9997,0,9999,2
1713503491549,CLRE 253,B00,507202,Vaida; Florin,9999,0,9999,0
1713503492576,CLRE 259,A00,507211,Patel; Hemal,9996,0,9999,3
1713503493601,CLRE 260,A00,507221,Cuomo; Raphael Eduardo,9999,0,9999,0
1713503494627,CLRE 297,001,507242,Cuomo; Raphael Eduardo,9999,0,9999,0
1713503495709,CSE 191,A00,516875,Minnes Kemp; Mor Mia,9999,0,9999,0
1713503496738,CSS 201S,A01,494383,Staff,35,0,35,0
1713503497763,CSS 202S,A01,494387,Staff,35,0,35,0
1713503498787,EAP 100,A00,516065,Staff,9792,0,9999,207
1713503499813,ECE 45,A01,507414,Staff,37,0,60,23
1713503500838,ECE 100,A01,507416,Baghdadchi; Saharnaz,0,0,20,20
1713503500838,ECE 100,A02,507418,Baghdadchi; Saharnaz,19,0,20,1
1713503501862,ECE 111,A01,507420,Staff,27,0,50,23
1713503502887,ECE 197,001,548057,Sievenpiper; Daniel F.,9998,0,9999,1
1713503503912,EDS 115,A00,507243,Choi; Bailey Miyeon,27,0,28,1
1713503504941,EDS 117,A01,494379,Staff,15,0,25,10
1713503505970,EDS 125,A00,507246,Hopkins; Megan Beth,27,0,30,3
1713503506999,EDS 128A,A01,507264,Fargason; Sharon Gayle,26,0,26,0
1713503508025,EDS 128B,A01,507293,Pappas; Elizabeth,30,0,30,0
1713503509051,EDS 139,A00,507294,Fargason; Sharon Gayle,30,0,30,0
1713503509051,EDS 139,B00,507313,Pappas; Elizabeth,30,0,30,0
1713503510074,EDS 201,A00,507315,Staff,18,0,30,12
1713503511098,EDS 203,A01,507317,Halter; Christopher P.,17,0,30,13
1713503512127,EDS 204R,A01,507319,Halter; Christopher P.,0,1,30,30
1713503512127,EDS 204R,B01,507331,Heinzman; Erica M.,22,0,30,8
1713503513155,EDS 206R,A00,507332,Staff,0,2,30,30
1713503513155,EDS 206R,B00,507343,Staff,23,0,30,7
1713503514179,EDS 250,A00,507344,Hemans; Patricia Ann Benitez,27,0,40,13
1713503515207,EDS 281,A00,507345,Daly; Alan J.,18,0,18,0
1713503516235,EDS 284,A00,507350,Daly; Alan J.,16,0,16,0
1713503517260,EDS 286,A00,507359,Fine; Sarah,18,0,18,0
1713503518286,EDS 289C,A01,507361,Daly; Alan J.,18,0,18,0
1713503519314,EDS 290,A00,507366,Hofstetter; Carolyn,15,0,15,0
1713503520343,LIGM 5A,A00,507421,Fischer-Grunski; Eva K,20,0,20,0
1713503521369,LIGM 5B,A00,507423,Fischer-Grunski; Eva K,20,0,20,0
1713503522395,LIGM 5C,A00,507425,Fischer-Grunski; Eva K,20,0,20,0
1713503523421,LIIT 5AS,A00,507427,Carnelos; Chiara,20,0,20,0
1713503524446,LIIT 5BS,A00,507430,Carnelos; Chiara,20,0,20,0
1713503525471,LIIT 5CS,A00,507432,Carnelos; Chiara,20,0,20,0
1713503526500,LISP 5A,A00,507541,Munoz Sanchez; Alicia,14,0,20,6
1713503527529,LISP 5B,A00,507671,Munoz Sanchez; Alicia,12,0,20,8
1713503528555,LISP 5C,A00,507696,Munoz Sanchez; Alicia,11,0,20,9
1713503529581,MAE 197,001,528363,Boechler; Nicholas Sebastia,9998,0,9999,1
1713503530610,MATH 197,001,523477,Kedlaya; Kiran S.,9999,0,9999,0
1713503530610,MATH 197,002,563811,Zhang; Danna,9998,0,9999,1
1713503531636,MCWP 40R,A00,518780,Staff,13,0,20,7
1713503531636,MCWP 40R,B00,518781,Staff,11,0,20,9
1713503531636,MCWP 40R,C00,518783,Staff,8,0,20,12
1713503532663,MCWP 50R,A00,518791,Staff,7,0,20,13
1713503532663,MCWP 50R,B00,518792,Staff,3,0,20,17
1713503532663,MCWP 50R,C00,518793,Staff,5,0,20,15
1713503532663,MCWP 50R,D00,518794,Staff,0,0,20,20
1713503532663,MCWP 50R,E00,518795,Staff,0,0,20,20
1713503532663,MCWP 50R,F00,518796,Staff,11,0,20,9
1713503532663,MCWP 50R,G00,518797,Staff,10,0,20,10
1713503533688,MMW 12R,A01,514034,Herbst; Matthew,2,0,16,14
1713503533688,MMW 12R,A02,514035,Herbst; Matthew,13,0,16,3
1713503534713,MMW 13R,A01,514037,Staff,0,8,16,16
1713503534713,MMW 13R,A02,514039,Staff,0,7,16,16
1713503536762,SIO 295LS,A00,523233,Staff,15,0,30,15
1713503537787,SIO 295S,A00,523232,Staff,15,0,30,15
1713503538813,SOCI 117,A01,494376,Staff,0,2,5,5
1713503539838,WES 237B,A00,494380,Staff,19,0,20,1
1713503541900,AESE 279B,A00,494370,Wade; Jon P,33,0,33,0
1713503542925,AIP 197,001,627712,Vespa; Emanuel Ignacio,9999,0,9999,0
1713503543953,ANAR 135S,A00,494369,Braswell; Geoffrey E.,0,0,0,0
1713503544979,CAT 124RS,A01,519847,Geibel; William,6,0,20,14
1713503546006,CAT 125RS,A01,515971,Geibel; William,6,0,20,14
1713503547031,CLRE 250,A00,511389,Morris; Sheldon,9996,0,9999,3
1713503548296,CLRE 251,A00,507176,Mehta; Ravindra L.,9996,0,9999,3
1713503548296,CLRE 251,B00,511410,Mehta; Ravindra L.,9998,0,9999,1
1713503549322,CLRE 252,A00,507189,Cuomo; Raphael Eduardo,9998,0,9999,1
1713503550347,CLRE 253,A00,507199,Vaida; Florin,9997,0,9999,2
1713503550347,CLRE 253,B00,507202,Vaida; Florin,9999,0,9999,0
1713503551376,CLRE 259,A00,507211,Patel; Hemal,9996,0,9999,3
1713503552401,CLRE 260,A00,507221,Cuomo; Raphael Eduardo,9999,0,9999,0
1713503553426,CLRE 297,001,507242,Cuomo; Raphael Eduardo,9999,0,9999,0
1713503554454,CSE 191,A00,516875,Minnes Kemp; Mor Mia,9999,0,9999,0
1713503555484,CSS 201S,A01,494383,Staff,35,0,35,0
1713503556513,CSS 202S,A01,494387,Staff,35,0,35,0
1713503557540,EAP 100,A00,516065,Staff,9792,0,9999,207
1713503558566,ECE 45,A01,507414,Staff,37,0,60,23
1713503559592,ECE 100,A01,507416,Baghdadchi; Saharnaz,0,0,20,20
1713503559592,ECE 100,A02,507418,Baghdadchi; Saharnaz,19,0,20,1
1713503560621,ECE 111,A01,507420,Staff,27,0,50,23
1713503561647,ECE 197,001,548057,Sievenpiper; Daniel F.,9998,0,9999,1
1713503562672,EDS 115,A00,507243,Choi; Bailey Miyeon,27,0,28,1
1713503563698,EDS 117,A01,494379,Staff,15,0,25,10
1713503564723,EDS 125,A00,507246,Hopkins; Megan Beth,27,0,30,3
1713503565753,EDS 128A,A01,507264,Fargason; Sharon Gayle,26,0,26,0
1713503566781,EDS 128B,A01,507293,Pappas; Elizabeth,30,0,30,0
1713503567809,EDS 139,A00,507294,Fargason; Sharon Gayle,30,0,30,0
1713503567809,EDS 139,B00,507313,Pappas; Elizabeth,30,0,30,0
1713503568838,EDS 201,A00,507315,Staff,18,0,30,12
1713503569863,EDS 203,A01,507317,Halter; Christopher P.,17,0,30,13
1713503570893,EDS 204R,A01,507319,Halter; Christopher P.,0,1,30,30
1713503570893,EDS 204R,B01,507331,Heinzman; Erica M.,22,0,30,8
1713503571922,EDS 206R,A00,507332,Staff,0,2,30,30
1713503571922,EDS 206R,B00,507343,Staff,23,0,30,7
1713503572949,EDS 250,A00,507344,Hemans; Patricia Ann Benitez,27,0,40,13
1713503573978,EDS 281,A00,507345,Daly; Alan J.,18,0,18,0
1713503575006,EDS 284,A00,507350,Daly; Alan J.,16,0,16,0
1713503576030,EDS 286,A00,507359,Fine; Sarah,18,0,18,0
1713503577055,EDS 289C,A01,507361,Daly; Alan J.,18,0,18,0
1713503578081,EDS 290,A00,507366,Hofstetter; Carolyn,15,0,15,0
1713503579112,LIGM 5A,A00,507421,Fischer-Grunski; Eva K,20,0,20,0
1713503580138,LIGM 5B,A00,507423,Fischer-Grunski; Eva K,20,0,20,0
1713503581167,LIGM 5C,A00,507425,Fischer-Grunski; Eva K,20,0,20,0
1713503582195,LIIT 5AS,A00,507427,Carnelos; Chiara,20,0,20,0
1713503583226,LIIT 5BS,A00,507430,Carnelos; Chiara,20,0,20,0
1713503584252,LIIT 5CS,A00,507432,Carnelos; Chiara,20,0,20,0
1713503585281,LISP 5A,A00,507541,Munoz Sanchez; Alicia,14,0,20,6
1713503586311,LISP 5B,A00,507671,Munoz Sanchez; Alicia,12,0,20,8
1713503587341,LISP 5C,A00,507696,Munoz Sanchez; Alicia,11,0,20,9
1713503588367,MAE 197,001,528363,Boechler; Nicholas Sebastia,9998,0,9999,1
1713503589393,MATH 197,001,523477,Kedlaya; Kiran S.,9999,0,9999,0
1713503589393,MATH 197,002,563811,Zhang; Danna,9998,0,9999,1
1713503590419,MCWP 40R,A00,518780,Staff,13,0,20,7
1713503590419,MCWP 40R,B00,518781,Staff,11,0,20,9
1713503590419,MCWP 40R,C00,518783,Staff,8,0,20,12
1713503591450,MCWP 50R,A00,518791,Staff,7,0,20,13
1713503591450,MCWP 50R,B00,518792,Staff,3,0,20,17
1713503591450,MCWP 50R,C00,518793,Staff,5,0,20,15
1713503591450,MCWP 50R,D00,518794,Staff,0,0,20,20
1713503591450,MCWP 50R,E00,518795,Staff,0,0,20,20
1713503591450,MCWP 50R,F00,518796,Staff,11,0,20,9
1713503591450,MCWP 50R,G00,518797,Staff,10,0,20,10
1713503592477,MMW 12R,A01,514034,Herbst; Matthew,2,0,16,14
1713503592477,MMW 12R,A02,514035,Herbst; Matthew,13,0,16,3
1713503593502,MMW 13R,A01,514037,Staff,0,8,16,16
1713503593502,MMW 13R,A02,514039,Staff,0,7,16,16
1713503595559,SIO 295LS,A00,523233,Staff,15,0,30,15
1713503596585,SIO 295S,A00,523232,Staff,15,0,30,15
1713503597612,SOCI 117,A01,494376,Staff,0,2,5,5
1713503598641,WES 237B,A00,494380,Staff,19,0,20,1
1713503600768,AESE 279B,A00,494370,Wade; Jon P,33,0,33,0
1713503601793,AIP 197,001,627712,Vespa; Emanuel Ignacio,9999,0,9999,0
1713503602823,ANAR 135S,A00,494369,Braswell; Geoffrey E.,0,0,0,0
1713503603862,CAT 124RS,A01,519847,Geibel; William,6,0,20,14
1713503604890,CAT 125RS,A01,515971,Geibel; William,6,0,20,14
1713503605920,CLRE 250,A00,511389,Morris; Sheldon,9996,0,9999,3
1713503606950,CLRE 251,A00,507176,Mehta; Ravindra L.,9996,0,9999,3
1713503606950,CLRE 251,B00,511410,Mehta; Ravindra L.,9998,0,9999,1
1713503607980,CLRE 252,A00,507189,Cuomo; Raphael Eduardo,9998,0,9999,1
1713503609009,CLRE 253,A00,507199,Vaida; Florin,9997,0,9999,2
1713503609009,CLRE 253,B00,507202,Vaida; Florin,9999,0,9999,0
1713503610039,CLRE 259,A00,507211,Patel; Hemal,9996,0,9999,3
1713503611068,CLRE 260,A00,507221,Cuomo; Raphael Eduardo,9999,0,9999,0
1713503612093,CLRE 297,001,507242,Cuomo; Raphael Eduardo,9999,0,9999,0
1713503613117,CSE 191,A00,516875,Minnes Kemp; Mor Mia,9999,0,9999,0
1713503614147,CSS 201S,A01,494383,Staff,35,0,35,0
1713503615178,CSS 202S,A01,494387,Staff,35,0,35,0
1713503616203,EAP 100,A00,516065,Staff,9792,0,9999,207
1713503617234,ECE 45,A01,507414,Staff,37,0,60,23
1713503618260,ECE 100,A01,507416,Baghdadchi; Saharnaz,0,0,20,20
1713503618260,ECE 100,A02,507418,Baghdadchi; Saharnaz,19,0,20,1
1713503619290,ECE 111,A01,507420,Staff,27,0,50,23
1713503620319,ECE 197,001,548057,Sievenpiper; Daniel F.,9998,0,9999,1
1713503621344,EDS 115,A00,507243,Choi; Bailey Miyeon,27,0,28,1
1713503622369,EDS 117,A01,494379,Staff,15,0,25,10
1713503623398,EDS 125,A00,507246,Hopkins; Megan Beth,27,0,30,3
1713503624423,EDS 128A,A01,507264,Fargason; Sharon Gayle,26,0,26,0
1713503625448,EDS 128B,A01,507293,Pappas; Elizabeth,30,0,30,0
1713503626474,EDS 139,A00,507294,Fargason; Sharon Gayle,30,0,30,0
1713503626474,EDS 139,B00,507313,Pappas; Elizabeth,30,0,30,0
1713503627499,EDS 201,A00,507315,Staff,18,0,30,12
1713503628527,EDS 203,A01,507317,Halter; Christopher P.,17,0,30,13
1713503629557,EDS 204R,A01,507319,Halter; Christopher P.,0,1,30,30
1713503629557,EDS 204R,B01,507331,Heinzman; Erica M.,22,0,30,8
1713503630582,EDS 206R,A00,507332,Staff,0,2,30,30
1713503630582,EDS 206R,B00,507343,Staff,23,0,30,7
1713503631607,EDS 250,A00,507344,Hemans; Patricia Ann Benitez,27,0,40,13
1713503632631,EDS 281,A00,507345,Daly; Alan J.,18,0,18,0
1713503633658,EDS 284,A00,507350,Daly; Alan J.,16,0,16,0
1713503634684,EDS 286,A00,507359,Fine; Sarah,18,0,18,0
1713503635709,EDS 289C,A01,507361,Daly; Alan J.,18,0,18,0
1713503636735,EDS 290,A00,507366,Hofstetter; Carolyn,15,0,15,0
1713503637759,LIGM 5A,A00,507421,Fischer-Grunski; Eva K,20,0,20,0
1713503638785,LIGM 5B,A00,507423,Fischer-Grunski; Eva K,20,0,20,0
1713503639814,LIGM 5C,A00,507425,Fischer-Grunski; Eva K,20,0,20,0
1713503640839,LIIT 5AS,A00,507427,Carnelos; Chiara,20,0,20,0
1713503641867,LIIT 5BS,A00,507430,Carnelos; Chiara,20,0,20,0
1713503642896,LIIT 5CS,A00,507432,Carnelos; Chiara,20,0,20,0
1713503643925,LISP 5A,A00,507541,Munoz Sanchez; Alicia,14,0,20,6
1713503644950,LISP 5B,A00,507671,Munoz Sanchez; Alicia,12,0,20,8
1713503645976,LISP 5C,A00,507696,Munoz Sanchez; Alicia,11,0,20,9
1713503647001,MAE 197,001,528363,Boechler; Nicholas Sebastia,9998,0,9999,1
1713503648030,MATH 197,001,523477,Kedlaya; Kiran S.,9999,0,9999,0
1713503648030,MATH 197,002,563811,Zhang; Danna,9998,0,9999,1
1713503649058,MCWP 40R,A00,518780,Staff,13,0,20,7
1713503649058,MCWP 40R,B00,518781,Staff,11,0,20,9
1713503649058,MCWP 40R,C00,518783,Staff,8,0,20,12
1713503650087,MCWP 50R,A00,518791,Staff,7,0,20,13
1713503650087,MCWP 50R,B00,518792,Staff,3,0,20,17
1713503650087,MCWP 50R,C00,518793,Staff,5,0,20,15
1713503650087,MCWP 50R,D00,518794,Staff,0,0,20,20
1713503650087,MCWP 50R,E00,518795,Staff,0,0,20,20
1713503650087,MCWP 50R,F00,518796,Staff,11,0,20,9
1713503650087,MCWP 50R,G00,518797,Staff,10,0,20,10
1713503651114,MMW 12R,A01,514034,Herbst; Matthew,2,0,16,14
1713503651114,MMW 12R,A02,514035,Herbst; Matthew,13,0,16,3
1713503652144,MMW 13R,A01,514037,Staff,0,8,16,16
1713503652144,MMW 13R,A02,514039,Staff,0,7,16,16
1713503654198,SIO 295LS,A00,523233,Staff,15,0,30,15
1713503655224,SIO 295S,A00,523232,Staff,15,0,30,15
1713503656250,SOCI 117,A01,494376,Staff,0,2,5,5
1713503657276,WES 237B,A00,494380,Staff,19,0,20,1
1713503659345,AESE 279B,A00,494370,Wade; Jon P,33,0,33,0
1713503660370,AIP 197,001,627712,Vespa; Emanuel Ignacio,9999,0,9999,0
1713503661398,ANAR 135S,A00,494369,Braswell; Geoffrey E.,0,0,0,0
1713503662423,CAT 124RS,A01,519847,Geibel; William,6,0,20,14
1713503663446,CAT 125RS,A01,515971,Geibel; William,6,0,20,14
1713503664470,CLRE 250,A00,511389,Morris; Sheldon,9996,0,9999,3
1713503665503,CLRE 251,A00,507176,Mehta; Ravindra L.,9996,0,9999,3
1713503665503,CLRE 251,B00,511410,Mehta; Ravindra L.,9998,0,9999,1
1713503666532,CLRE 252,A00,507189,Cuomo; Raphael Eduardo,9998,0,9999,1
1713503667562,CLRE 253,A00,507199,Vaida; Florin,9997,0,9999,2
1713503667562,CLRE 253,B00,507202,Vaida; Florin,9999,0,9999,0
1713503668587,CLRE 259,A00,507211,Patel; Hemal,9996,0,9999,3
1713503669615,CLRE 260,A00,507221,Cuomo; Raphael Eduardo,9999,0,9999,0
1713503670640,CLRE 297,001,507242,Cuomo; Raphael Eduardo,9999,0,9999,0
1713503671666,CSE 191,A00,516875,Minnes Kemp; Mor Mia,9999,0,9999,0
1713503672692,CSS 201S,A01,494383,Staff,35,0,35,0
1713503673717,CSS 202S,A01,494387,Staff,35,0,35,0
1713503674742,EAP 100,A00,516065,Staff,9792,0,9999,207
1713503675768,ECE 45,A01,507414,Staff,37,0,60,23
1713503676792,ECE 100,A01,507416,Baghdadchi; Saharnaz,0,0,20,20
1713503676792,ECE 100,A02,507418,Baghdadchi; Saharnaz,19,0,20,1
1713503677819,ECE 111,A01,507420,Staff,27,0,50,23
1713503678845,ECE 197,001,548057,Sievenpiper; Daniel F.,9998,0,9999,1
1713503679874,EDS 115,A00,507243,Choi; Bailey Miyeon,27,0,28,1
1713503680903,EDS 117,A01,494379,Staff,15,0,25,10
1713503681932,EDS 125,A00,507246,Hopkins; Megan Beth,27,0,30,3
1713503682958,EDS 128A,A01,507264,Fargason; Sharon Gayle,26,0,26,0
1713503683980,EDS 128B,A01,507293,Pappas; Elizabeth,30,0,30,0
1713503685009,EDS 139,A00,507294,Fargason; Sharon Gayle,30,0,30,0
1713503685009,EDS 139,B00,507313,Pappas; Elizabeth,30,0,30,0
1713503686036,EDS 201,A00,507315,Staff,18,0,30,12
1713503687061,EDS 203,A01,507317,Halter; Christopher P.,17,0,30,13
1713503688090,EDS 204R,A01,507319,Halter; Christopher P.,0,1,30,30
1713503688090,EDS 204R,B01,507331,Heinzman; Erica M.,22,0,30,8
1713503689118,EDS 206R,A00,507332,Staff,0,2,30,30
1713503689118,EDS 206R,B00,507343,Staff,23,0,30,7
1713503690142,EDS 250,A00,507344,Hemans; Patricia Ann Benitez,27,0,40,13
1713503691168,EDS 281,A00,507345,Daly; Alan J.,18,0,18,0
1713503692195,EDS 284,A00,507350,Daly; Alan J.,16,0,16,0
1713503693222,EDS 286,A00,507359,Fine; Sarah,18,0,18,0
1713503694248,EDS 289C,A01,507361,Daly; Alan J.,18,0,18,0
1713503695276,EDS 290,A00,507366,Hofstetter; Carolyn,15,0,15,0
1713503696301,LIGM 5A,A00,507421,Fischer-Grunski; Eva K,20,0,20,0
1713503697333,LIGM 5B,A00,507423,Fischer-Grunski; Eva K,20,0,20,0
1713503698361,LIGM 5C,A00,507425,Fischer-Grunski; Eva K,20,0,20,0
1713503699390,LIIT 5AS,A00,507427,Carnelos; Chiara,20,0,20,0
1713503700419,LIIT 5BS,A00,507430,Carnelos; Chiara,20,0,20,0
1713503701443,LIIT 5CS,A00,507432,Carnelos; Chiara,20,0,20,0
1713503702468,LISP 5A,A00,507541,Munoz Sanchez; Alicia,14,0,20,6
1713503703547,LISP 5B,A00,507671,Munoz Sanchez; Alicia,12,0,20,8
1713503704574,LISP 5C,A00,507696,Munoz Sanchez; Alicia,11,0,20,9
1713503705604,MAE 197,001,528363,Boechler; Nicholas Sebastia,9998,0,9999,1
1713503706631,MATH 197,001,523477,Kedlaya; Kiran S.,9999,0,9999,0
1713503706631,MATH 197,002,563811,Zhang; Danna,9998,0,9999,1
1713503707654,MCWP 40R,A00,518780,Staff,13,0,20,7
1713503707654,MCWP 40R,B00,518781,Staff,11,0,20,9
1713503707654,MCWP 40R,C00,518783,Staff,8,0,20,12
1713503708681,MCWP 50R,A00,518791,Staff,7,0,20,13
1713503708681,MCWP 50R,B00,518792,Staff,3,0,20,17
1713503708681,MCWP 50R,C00,518793,Staff,5,0,20,15
1713503708681,MCWP 50R,D00,518794,Staff,0,0,20,20
1713503708681,MCWP 50R,E00,518795,Staff,0,0,20,20
1713503708681,MCWP 50R,F00,518796,Staff,11,0,20,9
1713503708681,MCWP 50R,G00,518797,Staff,10,0,20,10
1713503709711,MMW 12R,A01,514034,Herbst; Matthew,2,0,16,14
1713503709711,MMW 12R,A02,514035,Herbst; Matthew,13,0,16,3
1713503710740,MMW 13R,A01,514037,Staff,0,8,16,16
1713503710740,MMW 13R,A02,514039,Staff,0,7,16,16
1713503712795,SIO 295LS,A00,523233,Staff,15,0,30,15
1713503713821,SIO 295S,A00,523232,Staff,15,0,30,15
1713503714847,SOCI 117,A01,494376,Staff,0,2,5,5
1713503715871,WES 237B,A00,494380,Staff,19,0,20,1
1713503717949,AESE 279B,A00,494370,Wade; Jon P,33,0,33,0
1713503718977,AIP 197,001,627712,Vespa; Emanuel Ignacio,9999,0,9999,0
1713503720003,ANAR 135S,A00,494369,Braswell; Geoffrey E.,0,0,0,0
1713503721027,CAT 124RS,A01,519847,Geibel; William,6,0,20,14
1713503722054,CAT 125RS,A01,515971,Geibel; William,6,0,20,14
1713503723082,CLRE 250,A00,511389,Morris; Sheldon,9996,0,9999,3
1713503724113,CLRE 251,A00,507176,Mehta; Ravindra L.,9996,0,9999,3
1713503724113,CLRE 251,B00,511410,Mehta; Ravindra L.,9998,0,9999,1
1713503725144,CLRE 252,A00,507189,Cuomo; Raphael Eduardo,9998,0,9999,1
1713503726169,CLRE 253,A00,507199,Vaida; Florin,9997,0,9999,2
1713503726169,CLRE 253,B00,507202,Vaida; Florin,9999,0,9999,0
1713503727194,CLRE 259,A00,507211,Patel; Hemal,9996,0,9999,3
1713503728219,CLRE 260,A00,507221,Cuomo; Raphael Eduardo,9999,0,9999,0
1713503729245,CLRE 297,001,507242,Cuomo; Raphael Eduardo,9999,0,9999,0
1713503730269,CSE 191,A00,516875,Minnes Kemp; Mor Mia,9999,0,9999,0
1713503731295,CSS 201S,A01,494383,Staff,35,0,35,0
1713503732323,CSS 202S,A01,494387,Staff,35,0,35,0
1713503733348,EAP 100,A00,516065,Staff,9792,0,9999,207
1713503734374,ECE 45,A01,507414,Staff,37,0,60,23
1713503735404,ECE 100,A01,507416,Baghdadchi; Saharnaz,0,0,20,20
1713503735404,ECE 100,A02,507418,Baghdadchi; Saharnaz,19,0,20,1
1713503736429,ECE 111,A01,507420,Staff,27,0,50,23
1713503737457,ECE 197,001,548057,Sievenpiper; Daniel F.,9998,0,9999,1
1713503738482,EDS 115,A00,507243,Choi; Bailey Miyeon,27,0,28,1
1713503739511,EDS 117,A01,494379,Staff,15,0,25,10
1713503740539,EDS 125,A00,507246,Hopkins; Megan Beth,27,0,30,3
1713503741565,EDS 128A,A01,507264,Fargason; Sharon Gayle,26,0,26,0
1713503742589,EDS 128B,A01,507293,Pappas; Elizabeth,30,0,30,0
1713503743616,EDS 139,A00,507294,Fargason; Sharon Gayle,30,0,30,0
1713503743616,EDS 139,B00,507313,Pappas; Elizabeth,30,0,30,0
1713503744642,EDS 201,A00,507315,Staff,18,0,30,12
1713503745668,EDS 203,A01,507317,Halter; Christopher P.,17,0,30,13
1713503746698,EDS 204R,A01,507319,Halter; Christopher P.,0,1,30,30
1713503746698,EDS 204R,B01,507331,Heinzman; Erica M.,22,0,30,8
1713503747724,EDS 206R,A00,507332,Staff,0,2,30,30
1713503747724,EDS 206R,B00,507343,Staff,23,0,30,7
1713503748750,EDS 250,A00,507344,Hemans; Patricia Ann Benitez,27,0,40,13
1713503749776,EDS 281,A00,507345,Daly; Alan J.,18,0,18,0
1713503750804,EDS 284,A00,507350,Daly; Alan J.,16,0,16,0
1713503751830,EDS 286,A00,507359,Fine; Sarah,18,0,18,0
1713503752856,EDS 289C,A01,507361,Daly; Alan J.,18,0,18,0
1713503753894,EDS 290,A00,507366,Hofstetter; Carolyn,15,0,15,0
1713503754923,LIGM 5A,A00,507421,Fischer-Grunski; Eva K,20,0,20,0
1713503755951,LIGM 5B,A00,507423,Fischer-Grunski; Eva K,20,0,20,0
1713503756978,LIGM 5C,A00,507425,Fischer-Grunski; Eva K,20,0,20,0
1713503758007,LIIT 5AS,A00,507427,Carnelos; Chiara,20,0,20,0
1713503759033,LIIT 5BS,A00,507430,Carnelos; Chiara,20,0,20,0
1713503760088,LIIT 5CS,A00,507432,Carnelos; Chiara,20,0,20,0
1713503761119,LISP 5A,A00,507541,Munoz Sanchez; Alicia,14,0,20,6
1713503762148,LISP 5B,A00,507671,Munoz Sanchez; Alicia,12,0,20,8
1713503763178,LISP 5C,A00,507696,Munoz Sanchez; Alicia,11,0,20,9
1713503764204,MAE 197,001,528363,Boechler; Nicholas Sebastia,9998,0,9999,1
1713503765229,MATH 197,001,523477,Kedlaya; Kiran S.,9999,0,9999,0
1713503765229,MATH 197,002,563811,Zhang; Danna,9998,0,9999,1
1713503766259,MCWP 40R,A00,518780,Staff,13,0,20,7
1713503766259,MCWP 40R,B00,518781,Staff,11,0,20,9
1713503766259,MCWP 40R,C00,518783,Staff,8,0,20,12
1713503767289,MCWP 50R,A00,518791,Staff,7,0,20,13
1713503767289,MCWP 50R,B00,518792,Staff,3,0,20,17
1713503767289,MCWP 50R,C00,518793,Staff,5,0,20,15
1713503767289,MCWP 50R,D00,518794,Staff,0,0,20,20
1713503767289,MCWP 50R,E00,518795,Staff,0,0,20,20
1713503767289,MCWP 50R,F00,518796,Staff,11,0,20,9
1713503767289,MCWP 50R,G00,518797,Staff,10,0,20,10
1713503768317,MMW 12R,A01,514034,Herbst; Matthew,2,0,16,14
1713503768317,MMW 12R,A02,514035,Herbst; Matthew,13,0,16,3
1713503769343,MMW 13R,A01,514037,Staff,0,8,16,16
1713503769343,MMW 13R,A02,514039,Staff,0,7,16,16
1713503771397,SIO 295LS,A00,523233,Staff,15,0,30,15
1713503772426,SIO 295S,A00,523232,Staff,15,0,30,15
1713503773452,SOCI 117,A01,494376,Staff,0,2,5,5
1713503774477,WES 237B,A00,494380,Staff,19,0,20,1
1713503776547,AESE 279B,A00,494370,Wade; Jon P,33,0,33,0
1713503777572,AIP 197,001,627712,Vespa; Emanuel Ignacio,9999,0,9999,0
1713503778601,ANAR 135S,A00,494369,Braswell; Geoffrey E.,0,0,0,0
1713503779626,CAT 124RS,A01,519847,Geibel; William,6,0,20,14
1713503780651,CAT 125RS,A01,515971,Geibel; William,6,0,20,14
1713503781677,CLRE 250,A00,511389,Morris; Sheldon,9996,0,9999,3
1713503782703,CLRE 251,A00,507176,Mehta; Ravindra L.,9996,0,9999,3
1713503782703,CLRE 251,B00,511410,Mehta; Ravindra L.,9998,0,9999,1
1713503783730,CLRE 252,A00,507189,Cuomo; Raphael Eduardo,9998,0,9999,1
1713503784759,CLRE 253,A00,507199,Vaida; Florin,9997,0,9999,2
1713503784759,CLRE 253,B00,507202,Vaida; Florin,9999,0,9999,0
1713503785786,CLRE 259,A00,507211,Patel; Hemal,9996,0,9999,3
1713503786815,CLRE 260,A00,507221,Cuomo; Raphael Eduardo,9999,0,9999,0
1713503787843,CLRE 297,001,507242,Cuomo; Raphael Eduardo,9999,0,9999,0
1713503788904,CSE 191,A00,516875,Minnes Kemp; Mor Mia,9999,0,9999,0
1713503789930,CSS 201S,A01,494383,Staff,35,0,35,0
1713503790958,CSS 202S,A01,494387,Staff,35,0,35,0
1713503791983,EAP 100,A00,516065,Staff,9792,0,9999,207
1713503793011,ECE 45,A01,507414,Staff,37,0,60,23
1713503794036,ECE 100,A01,507416,Baghdadchi; Saharnaz,0,0,20,20
1713503794036,ECE 100,A02,507418,Baghdadchi; Saharnaz,19,0,20,1
1713503795062,ECE 111,A01,507420,Staff,27,0,50,23
1713503796090,ECE 197,001,548057,Sievenpiper; Daniel F.,9998,0,9999,1
1713503797119,EDS 115,A00,507243,Choi; Bailey Miyeon,27,0,28,1
1713503798146,EDS 117,A01,494379,Staff,15,0,25,10
1713503799172,EDS 125,A00,507246,Hopkins; Megan Beth,27,0,30,3
1713503800197,EDS 128A,A01,507264,Fargason; Sharon Gayle,26,0,26,0
1713503801221,EDS 128B,A01,507293,Pappas; Elizabeth,30,0,30,0
1713503802250,EDS 139,A00,507294,Fargason; Sharon Gayle,30,0,30,0
1713503802250,EDS 139,B00,507313,Pappas; Elizabeth,30,0,30,0
1713503803275,EDS 201,A00,507315,Staff,18,0,30,12
1713503804303,EDS 203,A01,507317,Halter; Christopher P.,17,0,30,13
1713503805385,EDS 204R,A01,507319,Halter; Christopher P.,0,1,30,30
1713503805385,EDS 204R,B01,507331,Heinzman; Erica M.,22,0,30,8
1713503806407,EDS 206R,A00,507332,Staff,0,2,30,30
1713503806407,EDS 206R,B00,507343,Staff,23,0,30,7
1713503807488,EDS 250,A00,507344,Hemans; Patricia Ann Benitez,27,0,40,13
1713503808514,EDS 281,A00,507345,Daly; Alan J.,18,0,18,0
1713503809542,EDS 284,A00,507350,Daly; Alan J.,16,0,16,0
1713503810571,EDS 286,A00,507359,Fine; Sarah,18,0,18,0
1713503811595,EDS 289C,A01,507361,Daly; Alan J.,18,0,18,0
1713503812622,EDS 290,A00,507366,Hofstetter; Carolyn,15,0,15,0
1713503813649,LIGM 5A,A00,507421,Fischer-Grunski; Eva K,20,0,20,0
1713503814677,LIGM 5B,A00,507423,Fischer-Grunski; Eva K,20,0,20,0
1713503815702,LIGM 5C,A00,507425,Fischer-Grunski; Eva K,20,0,20,0
1713503816727,LIIT 5AS,A00,507427,Carnelos; Chiara,20,0,20,0
1713503817756,LIIT 5BS,A00,507430,Carnelos; Chiara,20,0,20,0
1713503818782,LIIT 5CS,A00,507432,Carnelos; Chiara,20,0,20,0
1713503819808,LISP 5A,A00,507541,Munoz Sanchez; Alicia,14,0,20,6
1713503820832,LISP 5B,A00,507671,Munoz Sanchez; Alicia,12,0,20,8
1713503821871,LISP 5C,A00,507696,Munoz Sanchez; Alicia,11,0,20,9
1713503822899,MAE 197,001,528363,Boechler; Nicholas Sebastia,9998,0,9999,1
1713503823926,MATH 197,001,523477,Kedlaya; Kiran S.,9999,0,9999,0
1713503823926,MATH 197,002,563811,Zhang; Danna,9998,0,9999,1
1713503824956,MCWP 40R,A00,518780,Staff,13,0,20,7
1713503824956,MCWP 40R,B00,518781,Staff,11,0,20,9
1713503824956,MCWP 40R,C00,518783,Staff,8,0,20,12
1713503825986,MCWP 50R,A00,518791,Staff,7,0,20,13
1713503825986,MCWP 50R,B00,518792,Staff,3,0,20,17
1713503825986,MCWP 50R,C00,518793,Staff,5,0,20,15
1713503825986,MCWP 50R,D00,518794,Staff,0,0,20,20
1713503825986,MCWP 50R,E00,518795,Staff,0,0,20,20
1713503825986,MCWP 50R,F00,518796,Staff,11,0,20,9
1713503825986,MCWP 50R,G00,518797,Staff,10,0,20,10
1713503827015,MMW 12R,A01,514034,Herbst; Matthew,2,0,16,14
1713503827015,MMW 12R,A02,514035,Herbst; Matthew,13,0,16,3
1713503828041,MMW 13R,A01,514037,Staff,0,8,16,16
1713503828041,MMW 13R,A02,514039,Staff,0,7,16,16
1713503830092,SIO 295LS,A00,523233,Staff,15,0,30,15
1713503831118,SIO 295S,A00,523232,Staff,15,0,30,15
1713503832143,SOCI 117,A01,494376,Staff,0,2,5,5
1713503833167,WES 237B,A00,494380,Staff,19,0,20,1
1713503835246,AESE 279B,A00,494370,Wade; Jon P,33,0,33,0
1713503836271,AIP 197,001,627712,Vespa; Emanuel Ignacio,9999,0,9999,0
1713503837301,ANAR 135S,A00,494369,Braswell; Geoffrey E.,0,0,0,0
1713503838326,CAT 124RS,A01,519847,Geibel; William,6,0,20,14
1713503839351,CAT 125RS,A01,515971,Geibel; William,6,0,20,14
1713503840377,CLRE 250,A00,511389,Morris; Sheldon,9996,0,9999,3
1713503841406,CLRE 251,A00,507176,Mehta; Ravindra L.,9996,0,9999,3
1713503841406,CLRE 251,B00,511410,Mehta; Ravindra L.,9998,0,9999,1
1713503842433,CLRE 252,A00,507189,Cuomo; Raphael Eduardo,9998,0,9999,1
1713503843461,CLRE 253,A00,507199,Vaida; Florin,9997,0,9999,2
1713503843461,CLRE 253,B00,507202,Vaida; Florin,9999,0,9999,0
1713503844486,CLRE 259,A00,507211,Patel; Hemal,9996,0,9999,3
1713503845513,CLRE 260,A00,507221,Cuomo; Raphael Eduardo,9999,0,9999,0
1713503846541,CLRE 297,001,507242,Cuomo; Raphael Eduardo,9999,0,9999,0
1713503847570,CSE 191,A00,516875,Minnes Kemp; Mor Mia,9999,0,9999,0
1713503848594,CSS 201S,A01,494383,Staff,35,0,35,0
1713503849623,CSS 202S,A01,494387,Staff,35,0,35,0
1713503850649,EAP 100,A00,516065,Staff,9792,0,9999,207
1713503851673,ECE 45,A01,507414,Staff,37,0,60,23
1713503852702,ECE 100,A01,507416,Baghdadchi; Saharnaz,0,0,20,20
1713503852702,ECE 100,A02,507418,Baghdadchi; Saharnaz,19,0,20,1
1713503853727,ECE 111,A01,507420,Staff,27,0,50,23
1713503854751,ECE 197,001,548057,Sievenpiper; Daniel F.,9998,0,9999,1
1713503855780,EDS 115,A00,507243,Choi; Bailey Miyeon,27,0,28,1
1713503856804,EDS 117,A01,494379,Staff,15,0,25,10
1713503857832,EDS 125,A00,507246,Hopkins; Megan Beth,27,0,30,3
1713503858860,EDS 128A,A01,507264,Fargason; Sharon Gayle,26,0,26,0
1713503859887,EDS 128B,A01,507293,Pappas; Elizabeth,30,0,30,0
1713503860913,EDS 139,A00,507294,Fargason; Sharon Gayle,30,0,30,0
1713503860913,EDS 139,B00,507313,Pappas; Elizabeth,30,0,30,0
1713503861939,EDS 201,A00,507315,Staff,18,0,30,12
1713503862968,EDS 203,A01,507317,Halter; Christopher P.,17,0,30,13
1713503863998,EDS 204R,A01,507319,Halter; Christopher P.,0,1,30,30
1713503863998,EDS 204R,B01,507331,Heinzman; Erica M.,22,0,30,8
1713503865023,EDS 206R,A00,507332,Staff,0,2,30,30
1713503865023,EDS 206R,B00,507343,Staff,23,0,30,7
1713503866049,EDS 250,A00,507344,Hemans; Patricia Ann Benitez,27,0,40,13
1713503867075,EDS 281,A00,507345,Daly; Alan J.,18,0,18,0
1713503868104,EDS 284,A00,507350,Daly; Alan J.,16,0,16,0
1713503869131,EDS 286,A00,507359,Fine; Sarah,18,0,18,0
1713503870159,EDS 289C,A01,507361,Daly; Alan J.,18,0,18,0
1713503871184,EDS 290,A00,507366,Hofstetter; Carolyn,15,0,15,0
1713503872209,LIGM 5A,A00,507421,Fischer-Grunski; Eva K,20,0,20,0
1713503873237,LIGM 5B,A00,507423,Fischer-Grunski; Eva K,20,0,20,0
1713503874267,LIGM 5C,A00,507425,Fischer-Grunski; Eva K,20,0,20,0
1713503875298,LIIT 5AS,A00,507427,Carnelos; Chiara,20,0,20,0
1713503876325,LIIT 5BS,A00,507430,Carnelos; Chiara,20,0,20,0
1713503877358,LIIT 5CS,A00,507432,Carnelos; Chiara,20,0,20,0
1713503878386,LISP 5A,A00,507541,Munoz Sanchez; Alicia,14,0,20,6
1713503879416,LISP 5B,A00,507671,Munoz Sanchez; Alicia,12,0,20,8
1713503880446,LISP 5C,A00,507696,Munoz Sanchez; Alicia,11,0,20,9
1713503881477,MAE 197,001,528363,Boechler; Nicholas Sebastia,9998,0,9999,1
1713503882506,MATH 197,001,523477,Kedlaya; Kiran S.,9999,0,9999,0
1713503882506,MATH 197,002,563811,Zhang; Danna,9998,0,9999,1
1713503883532,MCWP 40R,A00,518780,Staff,13,0,20,7
1713503883532,MCWP 40R,B00,518781,Staff,11,0,20,9
1713503883532,MCWP 40R,C00,518783,Staff,8,0,20,12
1713503884558,MCWP 50R,A00,518791,Staff,7,0,20,13
1713503884558,MCWP 50R,B00,518792,Staff,3,0,20,17
1713503884558,MCWP 50R,C00,518793,Staff,5,0,20,15
1713503884558,MCWP 50R,D00,518794,Staff,0,0,20,20
1713503884558,MCWP 50R,E00,518795,Staff,0,0,20,20
1713503884558,MCWP 50R,F00,518796,Staff,11,0,20,9
1713503884558,MCWP 50R,G00,518797,Staff,10,0,20,10
1713503885584,MMW 12R,A01,514034,Herbst; Matthew,2,0,16,14
1713503885584,MMW 12R,A02,514035,Herbst; Matthew,13,0,16,3
1713503886610,MMW 13R,A01,514037,Staff,0,8,16,16
1713503886610,MMW 13R,A02,514039,Staff,0,7,16,16
1713503888662,SIO 295LS,A00,523233,Staff,15,0,30,15
1713503889687,SIO 295S,A00,523232,Staff,15,0,30,15
1713503890714,SOCI 117,A01,494376,Staff,0,2,5,5
1713503891739,WES 237B,A00,494380,Staff,19,0,20,1
1713503893818,AESE 279B,A00,494370,Wade; Jon P,33,0,33,0
1713503894847,AIP 197,001,627712,Vespa; Emanuel Ignacio,9999,0,9999,0
1713503895872,ANAR 135S,A00,494369,Braswell; Geoffrey E.,0,0,0,0
1713503896898,CAT 124RS,A01,519847,Geibel; William,6,0,20,14
1713503897927,CAT 125RS,A01,515971,Geibel; William,6,0,20,14
1713503898953,CLRE 250,A00,511389,Morris; Sheldon,9996,0,9999,3
1713503899984,CLRE 251,A00,507176,Mehta; Ravindra L.,9996,0,9999,3
1713503899984,CLRE 251,B00,511410,Mehta; Ravindra L.,9998,0,9999,1
1713503901014,CLRE 252,A00,507189,Cuomo; Raphael Eduardo,9998,0,9999,1
1713503902044,CLRE 253,A00,507199,Vaida; Florin,9997,0,9999,2
1713503902044,CLRE 253,B00,507202,Vaida; Florin,9999,0,9999,0
1713503903070,CLRE 259,A00,507211,Patel; Hemal,9996,0,9999,3
1713503904098,CLRE 260,A00,507221,Cuomo; Raphael Eduardo,9999,0,9999,0
1713503905126,CLRE 297,001,507242,Cuomo; Raphael Eduardo,9999,0,9999,0
1713503906150,CSE 191,A00,516875,Minnes Kemp; Mor Mia,9999,0,9999,0
1713503907175,CSS 201S,A01,494383,Staff,35,0,35,0
1713503908202,CSS 202S,A01,494387,Staff,35,0,35,0
1713503909230,EAP 100,A00,516065,Staff,9792,0,9999,207
1713503910256,ECE 45,A01,507414,Staff,37,0,60,23
1713503911339,ECE 100,A01,507416,Baghdadchi; Saharnaz,0,0,20,20
1713503911339,ECE 100,A02,507418,Baghdadchi; Saharnaz,19,0,20,1
1713503912368,ECE 111,A01,507420,Staff,27,0,50,23
1713503913394,ECE 197,001,548057,Sievenpiper; Daniel F.,9998,0,9999,1
1713503914423,EDS 115,A00,507243,Choi; Bailey Miyeon,27,0,28,1
1713503915452,EDS 117,A01,494379,Staff,15,0,25,10
1713503916478,EDS 125,A00,507246,Hopkins; Megan Beth,27,0,30,3
1713503917503,EDS 128A,A01,507264,Fargason; Sharon Gayle,26,0,26,0
1713503918528,EDS 128B,A01,507293,Pappas; Elizabeth,30,0,30,0
1713503919554,EDS 139,A00,507294,Fargason; Sharon Gayle,30,0,30,0
1713503919554,EDS 139,B00,507313,Pappas; Elizabeth,30,0,30,0
1713503920582,EDS 201,A00,507315,Staff,18,0,30,12
1713503921607,EDS 203,A01,507317,Halter; Christopher P.,17,0,30,13
1713503922634,EDS 204R,A01,507319,Halter; Christopher P.,0,1,30,30
1713503922634,EDS 204R,B01,507331,Heinzman; Erica M.,22,0,30,8
1713503923659,EDS 206R,A00,507332,Staff,0,2,30,30
1713503923659,EDS 206R,B00,507343,Staff,23,0,30,7
1713503924685,EDS 250,A00,507344,Hemans; Patricia Ann Benitez,27,0,40,13
1713503925711,EDS 281,A00,507345,Daly; Alan J.,18,0,18,0
1713503926740,EDS 284,A00,507350,Daly; Alan J.,16,0,16,0
1713503927765,EDS 286,A00,507359,Fine; Sarah,18,0,18,0
1713503928793,EDS 289C,A01,507361,Daly; Alan J.,18,0,18,0
1713503929819,EDS 290,A00,507366,Hofstetter; Carolyn,15,0,15,0
1713503930844,LIGM 5A,A00,507421,Fischer-Grunski; Eva K,20,0,20,0
1713503931868,LIGM 5B,A00,507423,Fischer-Grunski; Eva K,20,0,20,0
1713503932896,LIGM 5C,A00,507425,Fischer-Grunski; Eva K,20,0,20,0
1713503933924,LIIT 5AS,A00,507427,Carnelos; Chiara,20,0,20,0
1713503934949,LIIT 5BS,A00,507430,Carnelos; Chiara,20,0,20,0
1713503935974,LIIT 5CS,A00,507432,Carnelos; Chiara,20,0,20,0
1713503937003,LISP 5A,A00,507541,Munoz Sanchez; Alicia,14,0,20,6
1713503938029,LISP 5B,A00,507671,Munoz Sanchez; Alicia,12,0,20,8
1713503939057,LISP 5C,A00,507696,Munoz Sanchez; Alicia,11,0,20,9
1713503940082,MAE 197,001,528363,Boechler; Nicholas Sebastia,9998,0,9999,1
1713503941108,MATH 197,001,523477,Kedlaya; Kiran S.,9999,0,9999,0
1713503941108,MATH 197,002,563811,Zhang; Danna,9998,0,9999,1
1713503942136,MCWP 40R,A00,518780,Staff,13,0,20,7
1713503942136,MCWP 40R,B00,518781,Staff,11,0,20,9
1713503942136,MCWP 40R,C00,518783,Staff,8,0,20,12
1713503943166,MCWP 50R,A00,518791,Staff,7,0,20,13
1713503943166,MCWP 50R,B00,518792,Staff,3,0,20,17
1713503943166,MCWP 50R,C00,518793,Staff,5,0,20,15
1713503943166,MCWP 50R,D00,518794,Staff,0,0,20,20
1713503943166,MCWP 50R,E00,518795,Staff,0,0,20,20
1713503943166,MCWP 50R,F00,518796,Staff,11,0,20,9
1713503943166,MCWP 50R,G00,518797,Staff,10,0,20,10
1713503944194,MMW 12R,A01,514034,Herbst; Matthew,2,0,16,14
1713503944194,MMW 12R,A02,514035,Herbst; Matthew,13,0,16,3
1713503945220,MMW 13R,A01,514037,Staff,0,8,16,16
1713503945220,MMW 13R,A02,514039,Staff,0,7,16,16
1713503947282,SIO 295LS,A00,523233,Staff,15,0,30,15
1713503948311,SIO 295S,A00,523232,Staff,15,0,30,15
1713503949339,SOCI 117,A01,494376,Staff,0,2,5,5
1713503950368,WES 237B,A00,494380,Staff,19,0,20,1
1713503952438,AESE 279B,A00,494370,Wade; Jon P,33,0,33,0
1713503953464,AIP 197,001,627712,Vespa; Emanuel Ignacio,9999,0,9999,0
1713503954493,ANAR 135S,A00,494369,Braswell; Geoffrey E.,0,0,0,0
1713503955519,CAT 124RS,A01,519847,Geibel; William,6,0,20,14
1713503956545,CAT 125RS,A01,515971,Geibel; William,6,0,20,14
1713503957574,CLRE 250,A00,511389,Morris; Sheldon,9996,0,9999,3
1713503958601,CLRE 251,A00,507176,Mehta; Ravindra L.,9996,0,9999,3
1713503958601,CLRE 251,B00,511410,Mehta; Ravindra L.,9998,0,9999,1
1713503959625,CLRE 252,A00,507189,Cuomo; Raphael Eduardo,9998,0,9999,1
1713503960651,CLRE 253,A00,507199,Vaida; Florin,9997,0,9999,2
1713503960651,CLRE 253,B00,507202,Vaida; Florin,9999,0,9999,0
1713503961680,CLRE 259,A00,507211,Patel; Hemal,9996,0,9999,3
1713503962706,CLRE 260,A00,507221,Cuomo; Raphael Eduardo,9999,0,9999,0
1713503963733,CLRE 297,001,507242,Cuomo; Raphael Eduardo,9999,0,9999,0
1713503964758,CSE 191,A00,516875,Minnes Kemp; Mor Mia,9999,0,9999,0
1713503965785,CSS 201S,A01,494383,Staff,35,0,35,0
1713503966814,CSS 202S,A01,494387,Staff,35,0,35,0
1713503967839,EAP 100,A00,516065,Staff,9792,0,9999,207
1713503968865,ECE 45,A01,507414,Staff,37,0,60,23
1713503969895,ECE 100,A01,507416,Baghdadchi; Saharnaz,0,0,20,20
1713503969895,ECE 100,A02,507418,Baghdadchi; Saharnaz,19,0,20,1
1713503970920,ECE 111,A01,507420,Staff,27,0,50,23
1713503971948,ECE 197,001,548057,Sievenpiper; Daniel F.,9998,0,9999,1
1713503972976,EDS 115,A00,507243,Choi; Bailey Miyeon,27,0,28,1
1713503974007,EDS 117,A01,494379,Staff,15,0,25,10
1713503975036,EDS 125,A00,507246,Hopkins; Megan Beth,27,0,30,3
1713503976066,EDS 128A,A01,507264,Fargason; Sharon Gayle,26,0,26,0
1713503977092,EDS 128B,A01,507293,Pappas; Elizabeth,30,0,30,0
1713503978117,EDS 139,A00,507294,Fargason; Sharon Gayle,30,0,30,0
1713503978117,EDS 139,B00,507313,Pappas; Elizabeth,30,0,30,0
1713503979147,EDS 201,A00,507315,Staff,18,0,30,12
1713503980177,EDS 203,A01,507317,Halter; Christopher P.,17,0,30,13
1713503981206,EDS 204R,A01,507319,Halter; Christopher P.,0,1,30,30
1713503981206,EDS 204R,B01,507331,Heinzman; Erica M.,22,0,30,8
1713503982232,EDS 206R,A00,507332,Staff,0,2,30,30
1713503982232,EDS 206R,B00,507343,Staff,23,0,30,7
1713503983262,EDS 250,A00,507344,Hemans; Patricia Ann Benitez,27,0,40,13
1713503984290,EDS 281,A00,507345,Daly; Alan J.,18,0,18,0
1713503985317,EDS 284,A00,507350,Daly; Alan J.,16,0,16,0
1713503986343,EDS 286,A00,507359,Fine; Sarah,18,0,18,0
1713503987373,EDS 289C,A01,507361,Daly; Alan J.,18,0,18,0
1713503988399,EDS 290,A00,507366,Hofstetter; Carolyn,15,0,15,0
1713503989428,LIGM 5A,A00,507421,Fischer-Grunski; Eva K,20,0,20,0
1713503990454,LIGM 5B,A00,507423,Fischer-Grunski; Eva K,20,0,20,0
1713503991479,LIGM 5C,A00,507425,Fischer-Grunski; Eva K,20,0,20,0
1713503992505,LIIT 5AS,A00,507427,Carnelos; Chiara,20,0,20,0
1713503993531,LIIT 5BS,A00,507430,Carnelos; Chiara,20,0,20,0
1713503994578,LIIT 5CS,A00,507432,Carnelos; Chiara,20,0,20,0
1713503995608,LISP 5A,A00,507541,Munoz Sanchez; Alicia,14,0,20,6
1713503996637,LISP 5B,A00,507671,Munoz Sanchez; Alicia,12,0,20,8
1713503997663,LISP 5C,A00,507696,Munoz Sanchez; Alicia,11,0,20,9
1713503998691,MAE 197,001,528363,Boechler; Nicholas Sebastia,9998,0,9999,1
1713503999717,MATH 197,001,523477,Kedlaya; Kiran S.,9999,0,9999,0
1713503999717,MATH 197,002,563811,Zhang; Danna,9998,0,9999,1
1713504000746,MCWP 40R,A00,518780,Staff,13,0,20,7
1713504000746,MCWP 40R,B00,518781,Staff,11,0,20,9
1713504000746,MCWP 40R,C00,518783,Staff,8,0,20,12
1713504001777,MCWP 50R,A00,518791,Staff,7,0,20,13
1713504001777,MCWP 50R,B00,518792,Staff,3,0,20,17
1713504001777,MCWP 50R,C00,518793,Staff,5,0,20,15
1713504001777,MCWP 50R,D00,518794,Staff,0,0,20,20
1713504001777,MCWP 50R,E00,518795,Staff,0,0,20,20
1713504001777,MCWP 50R,F00,518796,Staff,11,0,20,9
1713504001777,MCWP 50R,G00,518797,Staff,10,0,20,10
1713504002802,MMW 12R,A01,514034,Herbst; Matthew,2,0,16,14
1713504002802,MMW 12R,A02,514035,Herbst; Matthew,13,0,16,3
1713504003828,MMW 13R,A01,514037,Staff,0,8,16,16
1713504003828,MMW 13R,A02,514039,Staff,0,7,16,16
1713504005882,SIO 295LS,A00,523233,Staff,15,0,30,15
1713504006910,SIO 295S,A00,523232,Staff,15,0,30,15
1713504007937,SOCI 117,A01,494376,Staff,0,2,5,5
1713504008961,WES 237B,A00,494380,Staff,19,0,20,1
1713504011021,AESE 279B,A00,494370,Wade; Jon P,33,0,33,0
1713504012048,AIP 197,001,627712,Vespa; Emanuel Ignacio,9999,0,9999,0
1713504013074,ANAR 135S,A00,494369,Braswell; Geoffrey E.,0,0,0,0
1713504014101,CAT 124RS,A01,519847,Geibel; William,6,0,20,14
1713504015181,CAT 125RS,A01,515971,Geibel; William,6,0,20,14
1713504016207,CLRE 250,A00,511389,Morris; Sheldon,9996,0,9999,3
1713504017233,CLRE 251,A00,507176,Mehta; Ravindra L.,9996,0,9999,3
1713504017233,CLRE 251,B00,511410,Mehta; Ravindra L.,9998,0,9999,1
1713504018258,CLRE 252,A00,507189,Cuomo; Raphael Eduardo,9998,0,9999,1
1713504019282,CLRE 253,A00,507199,Vaida; Florin,9997,0,9999,2
1713504019282,CLRE 253,B00,507202,Vaida; Florin,9999,0,9999,0
1713504020311,CLRE 259,A00,507211,Patel; Hemal,9996,0,9999,3
1713504021336,CLRE 260,A00,507221,Cuomo; Raphael Eduardo,9999,0,9999,0
1713504022363,CLRE 297,001,507242,Cuomo; Raphael Eduardo,9999,0,9999,0
1713504023389,CSE 191,A00,516875,Minnes Kemp; Mor Mia,9999,0,9999,0
1713504024423,CSS 201S,A01,494383,Staff,35,0,35,0
1713504025448,CSS 202S,A01,494387,Staff,35,0,35,0
1713504026475,EAP 100,A00,516065,Staff,9792,0,9999,207
1713504027502,ECE 45,A01,507414,Staff,37,0,60,23
1713504028527,ECE 100,A01,507416,Baghdadchi; Saharnaz,0,0,20,20
1713504028527,ECE 100,A02,507418,Baghdadchi; Saharnaz,19,0,20,1
1713504029552,ECE 111,A01,507420,Staff,27,0,50,23
1713504030579,ECE 197,001,548057,Sievenpiper; Daniel F.,9998,0,9999,1
1713504031602,EDS 115,A00,507243,Choi; Bailey Miyeon,27,0,28,1
1713504032629,EDS 117,A01,494379,Staff,15,0,25,10
1713504033655,EDS 125,A00,507246,Hopkins; Megan Beth,27,0,30,3
1713504034681,EDS 128A,A01,507264,Fargason; Sharon Gayle,26,0,26,0
1713504035711,EDS 128B,A01,507293,Pappas; Elizabeth,30,0,30,0
1713504036735,EDS 139,A00,507294,Fargason; Sharon Gayle,30,0,30,0
1713504036735,EDS 139,B00,507313,Pappas; Elizabeth,30,0,30,0
1713504037761,EDS 201,A00,507315,Staff,18,0,30,12
1713504038790,EDS 203,A01,507317,Halter; Christopher P.,17,0,30,13
1713504039816,EDS 204R,A01,507319,Halter; Christopher P.,0,1,30,30
1713504039816,EDS 204R,B01,507331,Heinzman; Erica M.,22,0,30,8
1713504040844,EDS 206R,A00,507332,Staff,0,2,30,30
1713504040844,EDS 206R,B00,507343,Staff,23,0,30,7
1713504041874,EDS 250,A00,507344,Hemans; Patricia Ann Benitez,27,0,40,13
1713504042902,EDS 281,A00,507345,Daly; Alan J.,18,0,18,0
1713504043931,EDS 284,A00,507350,Daly; Alan J.,16,0,16,0
1713504044960,EDS 286,A00,507359,Fine; Sarah,18,0,18,0
1713504045985,EDS 289C,A01,507361,Daly; Alan J.,18,0,18,0
1713504047013,EDS 290,A00,507366,Hofstetter; Carolyn,15,0,15,0
1713504048045,LIGM 5A,A00,507421,Fischer-Grunski; Eva K,20,0,20,0
1713504049074,LIGM 5B,A00,507423,Fischer-Grunski; Eva K,20,0,20,0
1713504050104,LIGM 5C,A00,507425,Fischer-Grunski; Eva K,20,0,20,0
1713504051132,LIIT 5AS,A00,507427,Carnelos; Chiara,20,0,20,0
1713504052158,LIIT 5BS,A00,507430,Carnelos; Chiara,20,0,20,0
1713504053190,LIIT 5CS,A00,507432,Carnelos; Chiara,20,0,20,0
1713504054221,LISP 5A,A00,507541,Munoz Sanchez; Alicia,14,0,20,6
1713504055248,LISP 5B,A00,507671,Munoz Sanchez; Alicia,12,0,20,8
1713504056274,LISP 5C,A00,507696,Munoz Sanchez; Alicia,11,0,20,9
1713504057305,MAE 197,001,528363,Boechler; Nicholas Sebastia,9998,0,9999,1
1713504058335,MATH 197,001,523477,Kedlaya; Kiran S.,9999,0,9999,0
1713504058335,MATH 197,002,563811,Zhang; Danna,9998,0,9999,1
1713504059359,MCWP 40R,A00,518780,Staff,13,0,20,7
1713504059359,MCWP 40R,B00,518781,Staff,11,0,20,9
1713504059359,MCWP 40R,C00,518783,Staff,8,0,20,12
1713504060386,MCWP 50R,A00,518791,Staff,7,0,20,13
1713504060386,MCWP 50R,B00,518792,Staff,3,0,20,17
1713504060386,MCWP 50R,C00,518793,Staff,5,0,20,15
1713504060386,MCWP 50R,D00,518794,Staff,0,0,20,20
1713504060386,MCWP 50R,E00,518795,Staff,0,0,20,20
1713504060386,MCWP 50R,F00,518796,Staff,11,0,20,9
1713504060386,MCWP 50R,G00,518797,Staff,10,0,20,10
1713504061415,MMW 12R,A01,514034,Herbst; Matthew,2,0,16,14
1713504061415,MMW 12R,A02,514035,Herbst; Matthew,13,0,16,3
1713504062439,MMW 13R,A01,514037,Staff,0,8,16,16
1713504062439,MMW 13R,A02,514039,Staff,0,7,16,16
1713504064491,SIO 295LS,A00,523233,Staff,15,0,30,15
1713504065517,SIO 295S,A00,523232,Staff,15,0,30,15
1713504066542,SOCI 117,A01,494376,Staff,0,2,5,5
1713504067576,WES 237B,A00,494380,Staff,19,0,20,1
1713504069638,AESE 279B,A00,494370,Wade; Jon P,33,0,33,0
1713504070665,AIP 197,001,627712,Vespa; Emanuel Ignacio,9999,0,9999,0
1713504071692,ANAR 135S,A00,494369,Braswell; Geoffrey E.,0,0,0,0
1713504072717,CAT 124RS,A01,519847,Geibel; William,6,0,20,14
1713504073746,CAT 125RS,A01,515971,Geibel; William,6,0,20,14
1713504074773,CLRE 250,A00,511389,Morris; Sheldon,9996,0,9999,3
1713504075799,CLRE 251,A00,507176,Mehta; Ravindra L.,9996,0,9999,3
1713504075799,CLRE 251,B00,511410,Mehta; Ravindra L.,9998,0,9999,1
1713504076831,CLRE 252,A00,507189,Cuomo; Raphael Eduardo,9998,0,9999,1
1713504077856,CLRE 253,A00,507199,Vaida; Florin,9997,0,9999,2
1713504077856,CLRE 253,B00,507202,Vaida; Florin,9999,0,9999,0
1713504078884,CLRE 259,A00,507211,Patel; Hemal,9996,0,9999,3
1713504079910,CLRE 260,A00,507221,Cuomo; Raphael Eduardo,9999,0,9999,0
1713504080937,CLRE 297,001,507242,Cuomo; Raphael Eduardo,9999,0,9999,0
1713504081964,CSE 191,A00,516875,Minnes Kemp; Mor Mia,9999,0,9999,0
1713504082991,CSS 201S,A01,494383,Staff,35,0,35,0
1713504084019,CSS 202S,A01,494387,Staff,35,0,35,0
1713504085046,EAP 100,A00,516065,Staff,9792,0,9999,207
1713504086075,ECE 45,A01,507414,Staff,37,0,60,23
1713504087103,ECE 100,A01,507416,Baghdadchi; Saharnaz,0,0,20,20
1713504087103,ECE 100,A02,507418,Baghdadchi; Saharnaz,19,0,20,1
1713504088129,ECE 111,A01,507420,Staff,27,0,50,23
1713504089158,ECE 197,001,548057,Sievenpiper; Daniel F.,9998,0,9999,1
1713504090184,EDS 115,A00,507243,Choi; Bailey Miyeon,27,0,28,1
1713504091212,EDS 117,A01,494379,Staff,15,0,25,10
1713504092239,EDS 125,A00,507246,Hopkins; Megan Beth,27,0,30,3
1713504093267,EDS 128A,A01,507264,Fargason; Sharon Gayle,26,0,26,0
1713504094296,EDS 128B,A01,507293,Pappas; Elizabeth,30,0,30,0
1713504095321,EDS 139,A00,507294,Fargason; Sharon Gayle,30,0,30,0
1713504095321,EDS 139,B00,507313,Pappas; Elizabeth,30,0,30,0
1713504096346,EDS 201,A00,507315,Staff,18,0,30,12
1713504097372,EDS 203,A01,507317,Halter; Christopher P.,17,0,30,13
1713504098397,EDS 204R,A01,507319,Halter; Christopher P.,0,1,30,30
1713504098397,EDS 204R,B01,507331,Heinzman; Erica M.,22,0,30,8
1713504099422,EDS 206R,A00,507332,Staff,0,2,30,30
1713504099422,EDS 206R,B00,507343,Staff,23,0,30,7
1713504100447,EDS 250,A00,507344,Hemans; Patricia Ann Benitez,27,0,40,13
1713504101472,EDS 281,A00,507345,Daly; Alan J.,18,0,18,0
1713504102500,EDS 284,A00,507350,Daly; Alan J.,16,0,16,0
1713504103527,EDS 286,A00,507359,Fine; Sarah,18,0,18,0
1713504104553,EDS 289C,A01,507361,Daly; Alan J.,18,0,18,0
1713504105581,EDS 290,A00,507366,Hofstetter; Carolyn,15,0,15,0
1713504106605,LIGM 5A,A00,507421,Fischer-Grunski; Eva K,20,0,20,0
1713504107631,LIGM 5B,A00,507423,Fischer-Grunski; Eva K,20,0,20,0
1713504108657,LIGM 5C,A00,507425,Fischer-Grunski; Eva K,20,0,20,0
1713504109686,LIIT 5AS,A00,507427,Carnelos; Chiara,20,0,20,0
1713504110711,LIIT 5BS,A00,507430,Carnelos; Chiara,20,0,20,0
1713504111737,LIIT 5CS,A00,507432,Carnelos; Chiara,20,0,20,0
1713504112763,LISP 5A,A00,507541,Munoz Sanchez; Alicia,14,0,20,6
1713504113789,LISP 5B,A00,507671,Munoz Sanchez; Alicia,12,0,20,8
1713504114818,LISP 5C,A00,507696,Munoz Sanchez; Alicia,11,0,20,9
1713504115843,MAE 197,001,528363,Boechler; Nicholas Sebastia,9998,0,9999,1
1713504116872,MATH 197,001,523477,Kedlaya; Kiran S.,9999,0,9999,0
1713504116872,MATH 197,002,563811,Zhang; Danna,9998,0,9999,1
1713504117898,MCWP 40R,A00,518780,Staff,13,0,20,7
1713504117898,MCWP 40R,B00,518781,Staff,11,0,20,9
1713504117898,MCWP 40R,C00,518783,Staff,8,0,20,12
1713504118977,MCWP 50R,A00,518791,Staff,7,0,20,13
1713504118977,MCWP 50R,B00,518792,Staff,3,0,20,17
1713504118977,MCWP 50R,C00,518793,Staff,5,0,20,15
1713504118977,MCWP 50R,D00,518794,Staff,0,0,20,20
1713504118977,MCWP 50R,E00,518795,Staff,0,0,20,20
1713504118977,MCWP 50R,F00,518796,Staff,11,0,20,9
1713504118977,MCWP 50R,G00,518797,Staff,10,0,20,10
1713504120003,MMW 12R,A01,514034,Herbst; Matthew,2,0,16,14
1713504120003,MMW 12R,A02,514035,Herbst; Matthew,13,0,16,3
1713504121028,MMW 13R,A01,514037,Staff,0,8,16,16
1713504121028,MMW 13R,A02,514039,Staff,0,7,16,16
1713504123085,SIO 295LS,A00,523233,Staff,15,0,30,15
1713504124112,SIO 295S,A00,523232,Staff,15,0,30,15
1713504125140,SOCI 117,A01,494376,Staff,0,2,5,5
1713504126166,WES 237B,A00,494380,Staff,19,0,20,1
1713504128224,AESE 279B,A00,494370,Wade; Jon P,33,0,33,0
1713504129252,AIP 197,001,627712,Vespa; Emanuel Ignacio,9999,0,9999,0
1713504130277,ANAR 135S,A00,494369,Braswell; Geoffrey E.,0,0,0,0
1713504131303,CAT 124RS,A01,519847,Geibel; William,6,0,20,14
1713504132326,CAT 125RS,A01,515971,Geibel; William,6,0,20,14
1713504133354,CLRE 250,A00,511389,Morris; Sheldon,9996,0,9999,3
1713504134384,CLRE 251,A00,507176,Mehta; Ravindra L.,9996,0,9999,3
1713504134384,CLRE 251,B00,511410,Mehta; Ravindra L.,9998,0,9999,1
1713504135409,CLRE 252,A00,507189,Cuomo; Raphael Eduardo,9998,0,9999,1
1713504136439,CLRE 253,A00,507199,Vaida; Florin,9997,0,9999,2
1713504136439,CLRE 253,B00,507202,Vaida; Florin,9999,0,9999,0
1713504137466,CLRE 259,A00,507211,Patel; Hemal,9996,0,9999,3
1713504138493,CLRE 260,A00,507221,Cuomo; Raphael Eduardo,9999,0,9999,0
1713504139518,CLRE 297,001,507242,Cuomo; Raphael Eduardo,9999,0,9999,0
1713504140543,CSE 191,A00,516875,Minnes Kemp; Mor Mia,9999,0,9999,0
1713504141571,CSS 201S,A01,494383,Staff,35,0,35,0
1713504142599,CSS 202S,A01,494387,Staff,35,0,35,0
1713504143623,EAP 100,A00,516065,Staff,9792,0,9999,207
1713504144668,ECE 45,A01,507414,Staff,37,0,60,23
1713504145693,ECE 100,A01,507416,Baghdadchi; Saharnaz,0,0,20,20
1713504145693,ECE 100,A02,507418,Baghdadchi; Saharnaz,19,0,20,1
1713504146718,ECE 111,A01,507420,Staff,27,0,50,23
1713504147743,ECE 197,001,548057,Sievenpiper; Daniel F.,9998,0,9999,1
1713504148771,EDS 115,A00,507243,Choi; Bailey Miyeon,27,0,28,1
1713504149801,EDS 117,A01,494379,Staff,15,0,25,10
1713504150827,EDS 125,A00,507246,Hopkins; Megan Beth,27,0,30,3
1713504151853,EDS 128A,A01,507264,Fargason; Sharon Gayle,26,0,26,0
1713504152881,EDS 128B,A01,507293,Pappas; Elizabeth,30,0,30,0
1713504153909,EDS 139,A00,507294,Fargason; Sharon Gayle,30,0,30,0
1713504153909,EDS 139,B00,507313,Pappas; Elizabeth,30,0,30,0
1713504154937,EDS 201,A00,507315,Staff,18,0,30,12
1713504155964,EDS 203,A01,507317,Halter; Christopher P.,17,0,30,13
1713504156990,EDS 204R,A01,507319,Halter; Christopher P.,0,1,30,30
1713504156990,EDS 204R,B01,507331,Heinzman; Erica M.,22,0,30,8
1713504158015,EDS 206R,A00,507332,Staff,0,2,30,30
1713504158015,EDS 206R,B00,507343,Staff,23,0,30,7
1713504159044,EDS 250,A00,507344,Hemans; Patricia Ann Benitez,27,0,40,13
1713504160071,EDS 281,A00,507345,Daly; Alan J.,18,0,18,0
1713504161099,EDS 284,A00,507350,Daly; Alan J.,16,0,16,0
1713504162125,EDS 286,A00,507359,Fine; Sarah,18,0,18,0
1713504163151,EDS 289C,A01,507361,Daly; Alan J.,18,0,18,0
1713504164176,EDS 290,A00,507366,Hofstetter; Carolyn,15,0,15,0
1713504165205,LIGM 5A,A00,507421,Fischer-Grunski; Eva K,20,0,20,0
1713504166234,LIGM 5B,A00,507423,Fischer-Grunski; Eva K,20,0,20,0
1713504167259,LIGM 5C,A00,507425,Fischer-Grunski; Eva K,20,0,20,0
1713504168286,LIIT 5AS,A00,507427,Carnelos; Chiara,20,0,20,0
1713504169315,LIIT 5BS,A00,507430,Carnelos; Chiara,20,0,20,0
1713504170344,LIIT 5CS,A00,507432,Carnelos; Chiara,20,0,20,0
1713504171373,LISP 5A,A00,507541,Munoz Sanchez; Alicia,14,0,20,6
1713504172403,LISP 5B,A00,507671,Munoz Sanchez; Alicia,12,0,20,8
1713504173430,LISP 5C,A00,507696,Munoz Sanchez; Alicia,11,0,20,9
1713504174456,MAE 197,001,528363,Boechler; Nicholas Sebastia,9998,0,9999,1
1713504175482,MATH 197,001,523477,Kedlaya; Kiran S.,9999,0,9999,0
1713504175482,MATH 197,002,563811,Zhang; Danna,9998,0,9999,1
1713504176507,MCWP 40R,A00,518780,Staff,13,0,20,7
1713504176507,MCWP 40R,B00,518781,Staff,11,0,20,9
1713504176507,MCWP 40R,C00,518783,Staff,8,0,20,12
1713504177532,MCWP 50R,A00,518791,Staff,7,0,20,13
1713504177532,MCWP 50R,B00,518792,Staff,3,0,20,17
1713504177532,MCWP 50R,C00,518793,Staff,5,0,20,15
1713504177532,MCWP 50R,D00,518794,Staff,0,0,20,20
1713504177532,MCWP 50R,E00,518795,Staff,0,0,20,20
1713504177532,MCWP 50R,F00,518796,Staff,11,0,20,9
1713504177532,MCWP 50R,G00,518797,Staff,10,0,20,10
1713504178561,MMW 12R,A01,514034,Herbst; Matthew,2,0,16,14
1713504178561,MMW 12R,A02,514035,Herbst; Matthew,13,0,16,3
1713504179585,MMW 13R,A01,514037,Staff,0,8,16,16
1713504179585,MMW 13R,A02,514039,Staff,0,7,16,16
1713504181703,SIO 295LS,A00,523233,Staff,15,0,30,15
1713504182728,SIO 295S,A00,523232,Staff,15,0,30,15
1713504183759,SOCI 117,A01,494376,Staff,0,2,5,5
1713504184788,WES 237B,A00,494380,Staff,19,0,20,1
1713504186847,AESE 279B,A00,494370,Wade; Jon P,33,0,33,0
1713504187873,AIP 197,001,627712,Vespa; Emanuel Ignacio,9999,0,9999,0
1713504188899,ANAR 135S,A00,494369,Braswell; Geoffrey E.,0,0,0,0
1713504189928,CAT 124RS,A01,519847,Geibel; William,6,0,20,14
1713504190956,CAT 125RS,A01,515971,Geibel; William,6,0,20,14
1713504191982,CLRE 250,A00,511389,Morris; Sheldon,9996,0,9999,3
1713504193009,CLRE 251,A00,507176,Mehta; Ravindra L.,9996,0,9999,3
1713504193009,CLRE 251,B00,511410,Mehta; Ravindra L.,9998,0,9999,1
1713504194035,CLRE 252,A00,507189,Cuomo; Raphael Eduardo,9998,0,9999,1
1713504195063,CLRE 253,A00,507199,Vaida; Florin,9997,0,9999,2
1713504195063,CLRE 253,B00,507202,Vaida; Florin,9999,0,9999,0
1713504196088,CLRE 259,A00,507211,Patel; Hemal,9996,0,9999,3
1713504197116,CLRE 260,A00,507221,Cuomo; Raphael Eduardo,9999,0,9999,0
1713504198145,CLRE 297,001,507242,Cuomo; Raphael Eduardo,9999,0,9999,0
1713504199170,CSE 191,A00,516875,Minnes Kemp; Mor Mia,9999,0,9999,0
1713504200201,CSS 201S,A01,494383,Staff,35,0,35,0
1713504201232,CSS 202S,A01,494387,Staff,35,0,35,0
1713504202260,EAP 100,A00,516065,Staff,9792,0,9999,207
1713504203283,ECE 45,A01,507414,Staff,37,0,60,23
1713504204310,ECE 100,A01,507416,Baghdadchi; Saharnaz,0,0,20,20
1713504204310,ECE 100,A02,507418,Baghdadchi; Saharnaz,19,0,20,1
1713504205338,ECE 111,A01,507420,Staff,27,0,50,23
1713504206363,ECE 197,001,548057,Sievenpiper; Daniel F.,9998,0,9999,1
1713504207392,EDS 115,A00,507243,Choi; Bailey Miyeon,27,0,28,1
1713504208418,EDS 117,A01,494379,Staff,15,0,25,10
1713504209447,EDS 125,A00,507246,Hopkins; Megan Beth,27,0,30,3
1713504210473,EDS 128A,A01,507264,Fargason; Sharon Gayle,26,0,26,0
1713504211502,EDS 128B,A01,507293,Pappas; Elizabeth,30,0,30,0
1713504212531,EDS 139,A00,507294,Fargason; Sharon Gayle,30,0,30,0
1713504212531,EDS 139,B00,507313,Pappas; Elizabeth,30,0,30,0
1713504213558,EDS 201,A00,507315,Staff,18,0,30,12
1713504214586,EDS 203,A01,507317,Halter; Christopher P.,17,0,30,13
1713504215612,EDS 204R,A01,507319,Halter; Christopher P.,0,1,30,30
1713504215612,EDS 204R,B01,507331,Heinzman; Erica M.,22,0,30,8
1713504216640,EDS 206R,A00,507332,Staff,0,2,30,30
1713504216640,EDS 206R,B00,507343,Staff,23,0,30,7
1713504217664,EDS 250,A00,507344,Hemans; Patricia Ann Benitez,27,0,40,13
1713504218692,EDS 281,A00,507345,Daly; Alan J.,18,0,18,0
1713504219721,EDS 284,A00,507350,Daly; Alan J.,16,0,16,0
1713504220746,EDS 286,A00,507359,Fine; Sarah,18,0,18,0
1713504221772,EDS 289C,A01,507361,Daly; Alan J.,18,0,18,0
1713504222870,EDS 290,A00,507366,Hofstetter; Carolyn,15,0,15,0
1713504223896,LIGM 5A,A00,507421,Fischer-Grunski; Eva K,20,0,20,0
1713504224922,LIGM 5B,A00,507423,Fischer-Grunski; Eva K,20,0,20,0
1713504225952,LIGM 5C,A00,507425,Fischer-Grunski; Eva K,20,0,20,0
1713504227027,LIIT 5AS,A00,507427,Carnelos; Chiara,20,0,20,0
1713504228056,LIIT 5BS,A00,507430,Carnelos; Chiara,20,0,20,0
1713504229082,LIIT 5CS,A00,507432,Carnelos; Chiara,20,0,20,0
1713504230109,LISP 5A,A00,507541,Munoz Sanchez; Alicia,14,0,20,6
1713504231139,LISP 5B,A00,507671,Munoz Sanchez; Alicia,12,0,20,8
1713504232167,LISP 5C,A00,507696,Munoz Sanchez; Alicia,11,0,20,9
1713504233195,MAE 197,001,528363,Boechler; Nicholas Sebastia,9998,0,9999,1
1713504234221,MATH 197,001,523477,Kedlaya; Kiran S.,9999,0,9999,0
1713504234221,MATH 197,002,563811,Zhang; Danna,9998,0,9999,1
1713504235251,MCWP 40R,A00,518780,Staff,13,0,20,7
1713504235251,MCWP 40R,B00,518781,Staff,11,0,20,9
1713504235251,MCWP 40R,C00,518783,Staff,8,0,20,12
1713504236279,MCWP 50R,A00,518791,Staff,7,0,20,13
1713504236279,MCWP 50R,B00,518792,Staff,3,0,20,17
1713504236279,MCWP 50R,C00,518793,Staff,5,0,20,15
1713504236279,MCWP 50R,D00,518794,Staff,0,0,20,20
1713504236279,MCWP 50R,E00,518795,Staff,0,0,20,20
1713504236279,MCWP 50R,F00,518796,Staff,11,0,20,9
1713504236279,MCWP 50R,G00,518797,Staff,10,0,20,10
1713504237303,MMW 12R,A01,514034,Herbst; Matthew,2,0,16,14
1713504237303,MMW 12R,A02,514035,Herbst; Matthew,13,0,16,3
1713504238329,MMW 13R,A01,514037,Staff,0,8,16,16
1713504238329,MMW 13R,A02,514039,Staff,0,7,16,16
1713504240386,SIO 295LS,A00,523233,Staff,15,0,30,15
1713504241411,SIO 295S,A00,523232,Staff,15,0,30,15
1713504242435,SOCI 117,A01,494376,Staff,0,2,5,5
1713504243494,WES 237B,A00,494380,Staff,19,0,20,1
1713504245563,AESE 279B,A00,494370,Wade; Jon P,33,0,33,0
1713504246587,AIP 197,001,627712,Vespa; Emanuel Ignacio,9999,0,9999,0
1713504247613,ANAR 135S,A00,494369,Braswell; Geoffrey E.,0,0,0,0
1713504248642,CAT 124RS,A01,519847,Geibel; William,6,0,20,14
1713504249667,CAT 125RS,A01,515971,Geibel; William,6,0,20,14
1713504250692,CLRE 250,A00,511389,Morris; Sheldon,9996,0,9999,3
1713504251718,CLRE 251,A00,507176,Mehta; Ravindra L.,9996,0,9999,3
1713504251718,CLRE 251,B00,511410,Mehta; Ravindra L.,9998,0,9999,1
1713504252742,CLRE 252,A00,507189,Cuomo; Raphael Eduardo,9998,0,9999,1
1713504253767,CLRE 253,A00,507199,Vaida; Florin,9997,0,9999,2
1713504253767,CLRE 253,B00,507202,Vaida; Florin,9999,0,9999,0
1713504254794,CLRE 259,A00,507211,Patel; Hemal,9996,0,9999,3
1713504255824,CLRE 260,A00,507221,Cuomo; Raphael Eduardo,9999,0,9999,0
1713504256852,CLRE 297,001,507242,Cuomo; Raphael Eduardo,9999,0,9999,0
1713504257876,CSE 191,A00,516875,Minnes Kemp; Mor Mia,9999,0,9999,0
1713504258903,CSS 201S,A01,494383,Staff,35,0,35,0
1713504259928,CSS 202S,A01,494387,Staff,35,0,35,0
1713504260956,EAP 100,A00,516065,Staff,9792,0,9999,207
1713504261984,ECE 45,A01,507414,Staff,37,0,60,23
1713504263008,ECE 100,A01,507416,Baghdadchi; Saharnaz,0,0,20,20
1713504263008,ECE 100,A02,507418,Baghdadchi; Saharnaz,19,0,20,1
1713504264034,ECE 111,A01,507420,Staff,27,0,50,23
1713504265062,ECE 197,001,548057,Sievenpiper; Daniel F.,9998,0,9999,1
1713504266087,EDS 115,A00,507243,Choi; Bailey Miyeon,27,0,28,1
1713504267112,EDS 117,A01,494379,Staff,15,0,25,10
1713504268137,EDS 125,A00,507246,Hopkins; Megan Beth,27,0,30,3
1713504269164,EDS 128A,A01,507264,Fargason; Sharon Gayle,26,0,26,0
1713504270192,EDS 128B,A01,507293,Pappas; Elizabeth,30,0,30,0
1713504271216,EDS 139,A00,507294,Fargason; Sharon Gayle,30,0,30,0
1713504271216,EDS 139,B00,507313,Pappas; Elizabeth,30,0,30,0
1713504272242,EDS 201,A00,507315,Staff,18,0,30,12
1713504273267,EDS 203,A01,507317,Halter; Christopher P.,17,0,30,13
1713504274292,EDS 204R,A01,507319,Halter; Christopher P.,0,1,30,30
1713504274292,EDS 204R,B01,507331,Heinzman; Erica M.,22,0,30,8
1713504275321,EDS 206R,A00,507332,Staff,0,2,30,30
1713504275321,EDS 206R,B00,507343,Staff,23,0,30,7
1713504276350,EDS 250,A00,507344,Hemans; Patricia Ann Benitez,27,0,40,13
1713504277380,EDS 281,A00,507345,Daly; Alan J.,18,0,18,0
1713504278404,EDS 284,A00,507350,Daly; Alan J.,16,0,16,0
1713504279430,EDS 286,A00,507359,Fine; Sarah,18,0,18,0
1713504280458,EDS 289C,A01,507361,Daly; Alan J.,18,0,18,0
1713504281483,EDS 290,A00,507366,Hofstetter; Carolyn,15,0,15,0
1713504282512,LIGM 5A,A00,507421,Fischer-Grunski; Eva K,20,0,20,0
1713504283537,LIGM 5B,A00,507423,Fischer-Grunski; Eva K,20,0,20,0
1713504284566,LIGM 5C,A00,507425,Fischer-Grunski; Eva K,20,0,20,0
1713504285592,LIIT 5AS,A00,507427,Carnelos; Chiara,20,0,20,0
1713504286621,LIIT 5BS,A00,507430,Carnelos; Chiara,20,0,20,0
1713504287648,LIIT 5CS,A00,507432,Carnelos; Chiara,20,0,20,0
1713504288673,LISP 5A,A00,507541,Munoz Sanchez; Alicia,14,0,20,6
1713504289699,LISP 5B,A00,507671,Munoz Sanchez; Alicia,12,0,20,8
1713504290724,LISP 5C,A00,507696,Munoz Sanchez; Alicia,11,0,20,9
1713504291752,MAE 197,001,528363,Boechler; Nicholas Sebastia,9998,0,9999,1
1713504292780,MATH 197,001,523477,Kedlaya; Kiran S.,9999,0,9999,0
1713504292780,MATH 197,002,563811,Zhang; Danna,9998,0,9999,1
1713504293806,MCWP 40R,A00,518780,Staff,13,0,20,7
1713504293806,MCWP 40R,B00,518781,Staff,11,0,20,9
1713504293806,MCWP 40R,C00,518783,Staff,8,0,20,12
1713504294833,MCWP 50R,A00,518791,Staff,7,0,20,13
1713504294833,MCWP 50R,B00,518792,Staff,3,0,20,17
1713504294833,MCWP 50R,C00,518793,Staff,5,0,20,15
1713504294833,MCWP 50R,D00,518794,Staff,0,0,20,20
1713504294833,MCWP 50R,E00,518795,Staff,0,0,20,20
1713504294833,MCWP 50R,F00,518796,Staff,11,0,20,9
1713504294833,MCWP 50R,G00,518797,Staff,10,0,20,10
1713504295859,MMW 12R,A01,514034,Herbst; Matthew,2,0,16,14
1713504295859,MMW 12R,A02,514035,Herbst; Matthew,13,0,16,3
1713504296884,MMW 13R,A01,514037,Staff,0,8,16,16
1713504296884,MMW 13R,A02,514039,Staff,0,7,16,16
1713504298934,SIO 295LS,A00,523233,Staff,15,0,30,15
1713504299960,SIO 295S,A00,523232,Staff,15,0,30,15
1713504300988,SOCI 117,A01,494376,Staff,0,2,5,5
1713504302020,WES 237B,A00,494380,Staff,19,0,20,1
1713504304095,AESE 279B,A00,494370,Wade; Jon P,33,0,33,0
1713504305124,AIP 197,001,627712,Vespa; Emanuel Ignacio,9999,0,9999,0
1713504306148,ANAR 135S,A00,494369,Braswell; Geoffrey E.,0,0,0,0
1713504307174,CAT 124RS,A01,519847,Geibel; William,6,0,20,14
1713504308203,CAT 125RS,A01,515971,Geibel; William,6,0,20,14
1713504309232,CLRE 250,A00,511389,Morris; Sheldon,9996,0,9999,3
1713504310259,CLRE 251,A00,507176,Mehta; Ravindra L.,9996,0,9999,3
1713504310259,CLRE 251,B00,511410,Mehta; Ravindra L.,9998,0,9999,1
1713504311288,CLRE 252,A00,507189,Cuomo; Raphael Eduardo,9998,0,9999,1
1713504312313,CLRE 253,A00,507199,Vaida; Florin,9997,0,9999,2
1713504312313,CLRE 253,B00,507202,Vaida; Florin,9999,0,9999,0
1713504313337,CLRE 259,A00,507211,Patel; Hemal,9996,0,9999,3
1713504314361,CLRE 260,A00,507221,Cuomo; Raphael Eduardo,9999,0,9999,0
1713504315386,CLRE 297,001,507242,Cuomo; Raphael Eduardo,9999,0,9999,0
1713504316416,CSE 191,A00,516875,Minnes Kemp; Mor Mia,9999,0,9999,0
1713504317447,CSS 201S,A01,494383,Staff,35,0,35,0
1713504318473,CSS 202S,A01,494387,Staff,35,0,35,0
1713504319501,EAP 100,A00,516065,Staff,9792,0,9999,207
1713504320527,ECE 45,A01,507414,Staff,37,0,60,23
1713504321551,ECE 100,A01,507416,Baghdadchi; Saharnaz,0,0,20,20
1713504321551,ECE 100,A02,507418,Baghdadchi; Saharnaz,19,0,20,1
1713504322579,ECE 111,A01,507420,Staff,27,0,50,23
1713504323605,ECE 197,001,548057,Sievenpiper; Daniel F.,9998,0,9999,1
1713504324635,EDS 115,A00,507243,Choi; Bailey Miyeon,27,0,28,1
1713504325664,EDS 117,A01,494379,Staff,15,0,25,10
1713504326746,EDS 125,A00,507246,Hopkins; Megan Beth,27,0,30,3
1713504327775,EDS 128A,A01,507264,Fargason; Sharon Gayle,26,0,26,0
1713504328804,EDS 128B,A01,507293,Pappas; Elizabeth,30,0,30,0
1713504329833,EDS 139,A00,507294,Fargason; Sharon Gayle,30,0,30,0
1713504329833,EDS 139,B00,507313,Pappas; Elizabeth,30,0,30,0
1713504330858,EDS 201,A00,507315,Staff,18,0,30,12
1713504331883,EDS 203,A01,507317,Halter; Christopher P.,17,0,30,13
1713504332909,EDS 204R,A01,507319,Halter; Christopher P.,0,1,30,30
1713504332909,EDS 204R,B01,507331,Heinzman; Erica M.,22,0,30,8
1713504333936,EDS 206R,A00,507332,Staff,0,2,30,30
1713504333936,EDS 206R,B00,507343,Staff,23,0,30,7
1713504334965,EDS 250,A00,507344,Hemans; Patricia Ann Benitez,27,0,40,13
1713504335993,EDS 281,A00,507345,Daly; Alan J.,18,0,18,0
1713504337020,EDS 284,A00,507350,Daly; Alan J.,16,0,16,0
1713504338045,EDS 286,A00,507359,Fine; Sarah,18,0,18,0
1713504339072,EDS 289C,A01,507361,Daly; Alan J.,18,0,18,0
1713504340096,EDS 290,A00,507366,Hofstetter; Carolyn,15,0,15,0
1713504341122,LIGM 5A,A00,507421,Fischer-Grunski; Eva K,20,0,20,0
1713504342147,LIGM 5B,A00,507423,Fischer-Grunski; Eva K,20,0,20,0
1713504343176,LIGM 5C,A00,507425,Fischer-Grunski; Eva K,20,0,20,0
1713504344202,LIIT 5AS,A00,507427,Carnelos; Chiara,20,0,20,0
1713504345228,LIIT 5BS,A00,507430,Carnelos; Chiara,20,0,20,0
1713504346257,LIIT 5CS,A00,507432,Carnelos; Chiara,20,0,20,0
1713504347282,LISP 5A,A00,507541,Munoz Sanchez; Alicia,14,0,20,6
1713504348307,LISP 5B,A00,507671,Munoz Sanchez; Alicia,12,0,20,8
1713504349332,LISP 5C,A00,507696,Munoz Sanchez; Alicia,11,0,20,9
1713504350358,MAE 197,001,528363,Boechler; Nicholas Sebastia,9998,0,9999,1
1713504351390,MATH 197,001,523477,Kedlaya; Kiran S.,9999,0,9999,0
1713504351390,MATH 197,002,563811,Zhang; Danna,9998,0,9999,1
1713504352416,MCWP 40R,A00,518780,Staff,13,0,20,7
1713504352416,MCWP 40R,B00,518781,Staff,11,0,20,9
1713504352416,MCWP 40R,C00,518783,Staff,8,0,20,12
1713504353442,MCWP 50R,A00,518791,Staff,7,0,20,13
1713504353442,MCWP 50R,B00,518792,Staff,3,0,20,17
1713504353442,MCWP 50R,C00,518793,Staff,5,0,20,15
1713504353442,MCWP 50R,D00,518794,Staff,0,0,20,20
1713504353442,MCWP 50R,E00,518795,Staff,0,0,20,20
1713504353442,MCWP 50R,F00,518796,Staff,11,0,20,9
1713504353442,MCWP 50R,G00,518797,Staff,10,0,20,10
1713504354468,MMW 12R,A01,514034,Herbst; Matthew,2,0,16,14
1713504354468,MMW 12R,A02,514035,Herbst; Matthew,13,0,16,3
1713504355492,MMW 13R,A01,514037,Staff,0,8,16,16
1713504355492,MMW 13R,A02,514039,Staff,0,7,16,16
1713504357545,SIO 295LS,A00,523233,Staff,15,0,30,15
1713504358575,SIO 295S,A00,523232,Staff,15,0,30,15
1713504359600,SOCI 117,A01,494376,Staff,0,2,5,5
1713504360624,WES 237B,A00,494380,Staff,19,0,20,1
1713504362679,AESE 279B,A00,494370,Wade; Jon P,33,0,33,0
1713504363703,AIP 197,001,627712,Vespa; Emanuel Ignacio,9999,0,9999,0
1713504364733,ANAR 135S,A00,494369,Braswell; Geoffrey E.,0,0,0,0
1713504365759,CAT 124RS,A01,519847,Geibel; William,6,0,20,14
1713504366788,CAT 125RS,A01,515971,Geibel; William,6,0,20,14
1713504367812,CLRE 250,A00,511389,Morris; Sheldon,9996,0,9999,3
1713504368837,CLRE 251,A00,507176,Mehta; Ravindra L.,9996,0,9999,3
1713504368837,CLRE 251,B00,511410,Mehta; Ravindra L.,9998,0,9999,1
1713504369863,CLRE 252,A00,507189,Cuomo; Raphael Eduardo,9998,0,9999,1
1713504370891,CLRE 253,A00,507199,Vaida; Florin,9997,0,9999,2
1713504370891,CLRE 253,B00,507202,Vaida; Florin,9999,0,9999,0
1713504371918,CLRE 259,A00,507211,Patel; Hemal,9996,0,9999,3
1713504372944,CLRE 260,A00,507221,Cuomo; Raphael Eduardo,9999,0,9999,0
1713504373971,CLRE 297,001,507242,Cuomo; Raphael Eduardo,9999,0,9999,0
1713504374998,CSE 191,A00,516875,Minnes Kemp; Mor Mia,9999,0,9999,0
1713504376022,CSS 201S,A01,494383,Staff,35,0,35,0
1713504377047,CSS 202S,A01,494387,Staff,35,0,35,0
1713504378072,EAP 100,A00,516065,Staff,9792,0,9999,207
1713504379097,ECE 45,A01,507414,Staff,37,0,60,23
1713504380128,ECE 100,A01,507416,Baghdadchi; Saharnaz,0,0,20,20
1713504380128,ECE 100,A02,507418,Baghdadchi; Saharnaz,19,0,20,1
1713504381153,ECE 111,A01,507420,Staff,27,0,50,23
1713504382181,ECE 197,001,548057,Sievenpiper; Daniel F.,9998,0,9999,1
1713504383212,EDS 115,A00,507243,Choi; Bailey Miyeon,27,0,28,1
1713504384238,EDS 117,A01,494379,Staff,15,0,25,10
1713504385265,EDS 125,A00,507246,Hopkins; Megan Beth,27,0,30,3
1713504386292,EDS 128A,A01,507264,Fargason; Sharon Gayle,26,0,26,0
1713504387317,EDS 128B,A01,507293,Pappas; Elizabeth,30,0,30,0
1713504388342,EDS 139,A00,507294,Fargason; Sharon Gayle,30,0,30,0
1713504388342,EDS 139,B00,507313,Pappas; Elizabeth,30,0,30,0
1713504389368,EDS 201,A00,507315,Staff,18,0,30,12
1713504390397,EDS 203,A01,507317,Halter; Christopher P.,17,0,30,13
1713504391426,EDS 204R,A01,507319,Halter; Christopher P.,0,1,30,30
1713504391426,EDS 204R,B01,507331,Heinzman; Erica M.,22,0,30,8
1713504392456,EDS 206R,A00,507332,Staff,0,2,30,30
1713504392456,EDS 206R,B00,507343,Staff,23,0,30,7
1713504393484,EDS 250,A00,507344,Hemans; Patricia Ann Benitez,27,0,40,13
1713504394509,EDS 281,A00,507345,Daly; Alan J.,18,0,18,0
1713504395534,EDS 284,A00,507350,Daly; Alan J.,16,0,16,0
1713504396563,EDS 286,A00,507359,Fine; Sarah,18,0,18,0
1713504397586,EDS 289C,A01,507361,Daly; Alan J.,18,0,18,0
1713504398609,EDS 290,A00,507366,Hofstetter; Carolyn,15,0,15,0
1713504399635,LIGM 5A,A00,507421,Fischer-Grunski; Eva K,20,0,20,0
1713504400659,LIGM 5B,A00,507423,Fischer-Grunski; Eva K,20,0,20,0
1713504401685,LIGM 5C,A00,507425,Fischer-Grunski; Eva K,20,0,20,0
1713504402710,LIIT 5AS,A00,507427,Carnelos; Chiara,20,0,20,0
1713504403736,LIIT 5BS,A00,507430,Carnelos; Chiara,20,0,20,0
1713504404765,LIIT 5CS,A00,507432,Carnelos; Chiara,20,0,20,0
1713504405791,LISP 5A,A00,507541,Munoz Sanchez; Alicia,14,0,20,6
1713504406817,LISP 5B,A00,507671,Munoz Sanchez; Alicia,12,0,20,8
1713504407841,LISP 5C,A00,507696,Munoz Sanchez; Alicia,11,0,20,9
1713504408866,MAE 197,001,528363,Boechler; Nicholas Sebastia,9998,0,9999,1
1713504409894,MATH 197,001,523477,Kedlaya; Kiran S.,9999,0,9999,0
1713504409894,MATH 197,002,563811,Zhang; Danna,9998,0,9999,1
1713504410920,MCWP 40R,A00,518780,Staff,13,0,20,7
1713504410920,MCWP 40R,B00,518781,Staff,11,0,20,9
1713504410920,MCWP 40R,C00,518783,Staff,8,0,20,12
1713504411949,MCWP 50R,A00,518791,Staff,7,0,20,13
1713504411949,MCWP 50R,B00,518792,Staff,3,0,20,17
1713504411949,MCWP 50R,C00,518793,Staff,5,0,20,15
1713504411949,MCWP 50R,D00,518794,Staff,0,0,20,20
1713504411949,MCWP 50R,E00,518795,Staff,0,0,20,20
1713504411949,MCWP 50R,F00,518796,Staff,11,0,20,9
1713504411949,MCWP 50R,G00,518797,Staff,10,0,20,10
1713504412974,MMW 12R,A01,514034,Herbst; Matthew,2,0,16,14
1713504412974,MMW 12R,A02,514035,Herbst; Matthew,13,0,16,3
1713504414001,MMW 13R,A01,514037,Staff,0,8,16,16
1713504414001,MMW 13R,A02,514039,Staff,0,7,16,16
1713504416055,SIO 295LS,A00,523233,Staff,15,0,30,15
1713504417080,SIO 295S,A00,523232,Staff,15,0,30,15
1713504418106,SOCI 117,A01,494376,Staff,0,2,5,5
1713504419133,WES 237B,A00,494380,Staff,19,0,20,1
1713504421199,AESE 279B,A00,494370,Wade; Jon P,33,0,33,0
1713504422227,AIP 197,001,627712,Vespa; Emanuel Ignacio,9999,0,9999,0
1713504423256,ANAR 135S,A00,494369,Braswell; Geoffrey E.,0,0,0,0
1713504424281,CAT 124RS,A01,519847,Geibel; William,6,0,20,14
1713504425307,CAT 125RS,A01,515971,Geibel; William,6,0,20,14
1713504426333,CLRE 250,A00,511389,Morris; Sheldon,9996,0,9999,3
1713504427356,CLRE 251,A00,507176,Mehta; Ravindra L.,9996,0,9999,3
1713504427356,CLRE 251,B00,511410,Mehta; Ravindra L.,9998,0,9999,1
1713504428381,CLRE 252,A00,507189,Cuomo; Raphael Eduardo,9998,0,9999,1
1713504429411,CLRE 253,A00,507199,Vaida; Florin,9997,0,9999,2
1713504429411,CLRE 253,B00,507202,Vaida; Florin,9999,0,9999,0
1713504430492,CLRE 259,A00,507211,Patel; Hemal,9996,0,9999,3
1713504431518,CLRE 260,A00,507221,Cuomo; Raphael Eduardo,9999,0,9999,0
1713504432546,CLRE 297,001,507242,Cuomo; Raphael Eduardo,9999,0,9999,0
1713504433571,CSE 191,A00,516875,Minnes Kemp; Mor Mia,9999,0,9999,0
1713504434597,CSS 201S,A01,494383,Staff,35,0,35,0
1713504435625,CSS 202S,A01,494387,Staff,35,0,35,0
1713504436653,EAP 100,A00,516065,Staff,9792,0,9999,207
1713504437683,ECE 45,A01,507414,Staff,37,0,60,23
1713504438713,ECE 100,A01,507416,Baghdadchi; Saharnaz,0,0,20,20
1713504438713,ECE 100,A02,507418,Baghdadchi; Saharnaz,19,0,20,1
1713504439740,ECE 111,A01,507420,Staff,27,0,50,23
1713504440765,ECE 197,001,548057,Sievenpiper; Daniel F.,9998,0,9999,1
1713504441792,EDS 115,A00,507243,Choi; Bailey Miyeon,27,0,28,1
1713504442819,EDS 117,A01,494379,Staff,15,0,25,10
1713504443848,EDS 125,A00,507246,Hopkins; Megan Beth,27,0,30,3
1713504444874,EDS 128A,A01,507264,Fargason; Sharon Gayle,26,0,26,0
1713504445903,EDS 128B,A01,507293,Pappas; Elizabeth,30,0,30,0
1713504446928,EDS 139,A00,507294,Fargason; Sharon Gayle,30,0,30,0
1713504446928,EDS 139,B00,507313,Pappas; Elizabeth,30,0,30,0
1713504447955,EDS 201,A00,507315,Staff,18,0,30,12
1713504448981,EDS 203,A01,507317,Halter; Christopher P.,17,0,30,13
1713504450010,EDS 204R,A01,507319,Halter; Christopher P.,0,1,30,30
1713504450010,EDS 204R,B01,507331,Heinzman; Erica M.,22,0,30,8
1713504451037,EDS 206R,A00,507332,Staff,0,2,30,30
1713504451037,EDS 206R,B00,507343,Staff,23,0,30,7
1713504452066,EDS 250,A00,507344,Hemans; Patricia Ann Benitez,27,0,40,13
1713504453092,EDS 281,A00,507345,Daly; Alan J.,18,0,18,0
1713504454115,EDS 284,A00,507350,Daly; Alan J.,16,0,16,0
1713504455141,EDS 286,A00,507359,Fine; Sarah,18,0,18,0
1713504456167,EDS 289C,A01,507361,Daly; Alan J.,18,0,18,0
1713504457196,EDS 290,A00,507366,Hofstetter; Carolyn,15,0,15,0
1713504458223,LIGM 5A,A00,507421,Fischer-Grunski; Eva K,20,0,20,0
1713504459248,LIGM 5B,A00,507423,Fischer-Grunski; Eva K,20,0,20,0
1713504460273,LIGM 5C,A00,507425,Fischer-Grunski; Eva K,20,0,20,0
1713504461300,LIIT 5AS,A00,507427,Carnelos; Chiara,20,0,20,0
1713504462324,LIIT 5BS,A00,507430,Carnelos; Chiara,20,0,20,0
1713504463354,LIIT 5CS,A00,507432,Carnelos; Chiara,20,0,20,0
1713504464383,LISP 5A,A00,507541,Munoz Sanchez; Alicia,14,0,20,6
1713504465408,LISP 5B,A00,507671,Munoz Sanchez; Alicia,12,0,20,8
1713504466432,LISP 5C,A00,507696,Munoz Sanchez; Alicia,11,0,20,9
1713504467458,MAE 197,001,528363,Boechler; Nicholas Sebastia,9998,0,9999,1
1713504468485,MATH 197,001,523477,Kedlaya; Kiran S.,9999,0,9999,0
1713504468485,MATH 197,002,563811,Zhang; Danna,9998,0,9999,1
1713504469513,MCWP 40R,A00,518780,Staff,13,0,20,7
1713504469513,MCWP 40R,B00,518781,Staff,11,0,20,9
1713504469513,MCWP 40R,C00,518783,Staff,8,0,20,12
1713504470541,MCWP 50R,A00,518791,Staff,7,0,20,13
1713504470541,MCWP 50R,B00,518792,Staff,3,0,20,17
1713504470541,MCWP 50R,C00,518793,Staff,5,0,20,15
1713504470541,MCWP 50R,D00,518794,Staff,0,0,20,20
1713504470541,MCWP 50R,E00,518795,Staff,0,0,20,20
1713504470541,MCWP 50R,F00,518796,Staff,11,0,20,9
1713504470541,MCWP 50R,G00,518797,Staff,10,0,20,10
1713504471566,MMW 12R,A01,514034,Herbst; Matthew,2,0,16,14
1713504471566,MMW 12R,A02,514035,Herbst; Matthew,13,0,16,3
1713504472590,MMW 13R,A01,514037,Staff,0,8,16,16
1713504472590,MMW 13R,A02,514039,Staff,0,7,16,16
1713504474640,SIO 295LS,A00,523233,Staff,15,0,30,15
1713504475664,SIO 295S,A00,523232,Staff,15,0,30,15
1713504476695,SOCI 117,A01,494376,Staff,0,2,5,5
1713504477723,WES 237B,A00,494380,Staff,19,0,20,1
1713504479795,AESE 279B,A00,494370,Wade; Jon P,33,0,33,0
1713504480825,AIP 197,001,627712,Vespa; Emanuel Ignacio,9999,0,9999,0
1713504481853,ANAR 135S,A00,494369,Braswell; Geoffrey E.,0,0,0,0
1713504482881,CAT 124RS,A01,519847,Geibel; William,6,0,20,14
1713504483911,CAT 125RS,A01,515971,Geibel; William,6,0,20,14
1713504484936,CLRE 250,A00,511389,Morris; Sheldon,9996,0,9999,3
1713504485966,CLRE 251,A00,507176,Mehta; Ravindra L.,9996,0,9999,3
1713504485966,CLRE 251,B00,511410,Mehta; Ravindra L.,9998,0,9999,1
1713504486990,CLRE 252,A00,507189,Cuomo; Raphael Eduardo,9998,0,9999,1
1713504488023,CLRE 253,A00,507199,Vaida; Florin,9997,0,9999,2
1713504488023,CLRE 253,B00,507202,Vaida; Florin,9999,0,9999,0
1713504489051,CLRE 259,A00,507211,Patel; Hemal,9996,0,9999,3
1713504490080,CLRE 260,A00,507221,Cuomo; Raphael Eduardo,9999,0,9999,0
1713504491106,CLRE 297,001,507242,Cuomo; Raphael Eduardo,9999,0,9999,0
1713504492133,CSE 191,A00,516875,Minnes Kemp; Mor Mia,9999,0,9999,0
1713504493166,CSS 201S,A01,494383,Staff,35,0,35,0
1713504494192,CSS 202S,A01,494387,Staff,35,0,35,0
1713504495217,EAP 100,A00,516065,Staff,9792,0,9999,207
1713504496246,ECE 45,A01,507414,Staff,37,0,60,23
1713504497271,ECE 100,A01,507416,Baghdadchi; Saharnaz,0,0,20,20
1713504497271,ECE 100,A02,507418,Baghdadchi; Saharnaz,19,0,20,1
1713504498297,ECE 111,A01,507420,Staff,27,0,50,23
1713504499323,ECE 197,001,548057,Sievenpiper; Daniel F.,9998,0,9999,1
1713504500354,EDS 115,A00,507243,Choi; Bailey Miyeon,27,0,28,1
1713504501380,EDS 117,A01,494379,Staff,15,0,25,10
1713504502407,EDS 125,A00,507246,Hopkins; Megan Beth,27,0,30,3
1713504503437,EDS 128A,A01,507264,Fargason; Sharon Gayle,26,0,26,0
1713504504463,EDS 128B,A01,507293,Pappas; Elizabeth,30,0,30,0
1713504505489,EDS 139,A00,507294,Fargason; Sharon Gayle,30,0,30,0
1713504505489,EDS 139,B00,507313,Pappas; Elizabeth,30,0,30,0
1713504506515,EDS 201,A00,507315,Staff,18,0,30,12
1713504507543,EDS 203,A01,507317,Halter; Christopher P.,17,0,30,13
1713504508570,EDS 204R,A01,507319,Halter; Christopher P.,0,1,30,30
1713504508570,EDS 204R,B01,507331,Heinzman; Erica M.,22,0,30,8
1713504509599,EDS 206R,A00,507332,Staff,0,2,30,30
1713504509599,EDS 206R,B00,507343,Staff,23,0,30,7
1713504510626,EDS 250,A00,507344,Hemans; Patricia Ann Benitez,27,0,40,13
1713504511649,EDS 281,A00,507345,Daly; Alan J.,18,0,18,0
1713504512678,EDS 284,A00,507350,Daly; Alan J.,16,0,16,0
1713504513708,EDS 286,A00,507359,Fine; Sarah,18,0,18,0
1713504514735,EDS 289C,A01,507361,Daly; Alan J.,18,0,18,0
1713504515764,EDS 290,A00,507366,Hofstetter; Carolyn,15,0,15,0
1713504516790,LIGM 5A,A00,507421,Fischer-Grunski; Eva K,20,0,20,0
1713504517820,LIGM 5B,A00,507423,Fischer-Grunski; Eva K,20,0,20,0
1713504518845,LIGM 5C,A00,507425,Fischer-Grunski; Eva K,20,0,20,0
1713504519876,LIIT 5AS,A00,507427,Carnelos; Chiara,20,0,20,0
1713504520906,LIIT 5BS,A00,507430,Carnelos; Chiara,20,0,20,0
1713504521935,LIIT 5CS,A00,507432,Carnelos; Chiara,20,0,20,0
1713504522961,LISP 5A,A00,507541,Munoz Sanchez; Alicia,14,0,20,6
1713504523991,LISP 5B,A00,507671,Munoz Sanchez; Alicia,12,0,20,8
1713504525016,LISP 5C,A00,507696,Munoz Sanchez; Alicia,11,0,20,9
1713504526046,MAE 197,001,528363,Boechler; Nicholas Sebastia,9998,0,9999,1
1713504527071,MATH 197,001,523477,Kedlaya; Kiran S.,9999,0,9999,0
1713504527071,MATH 197,002,563811,Zhang; Danna,9998,0,9999,1
1713504528098,MCWP 40R,A00,518780,Staff,13,0,20,7
1713504528098,MCWP 40R,B00,518781,Staff,11,0,20,9
1713504528098,MCWP 40R,C00,518783,Staff,8,0,20,12
1713504529128,MCWP 50R,A00,518791,Staff,7,0,20,13
1713504529128,MCWP 50R,B00,518792,Staff,3,0,20,17
1713504529128,MCWP 50R,C00,518793,Staff,5,0,20,15
1713504529128,MCWP 50R,D00,518794,Staff,0,0,20,20
1713504529128,MCWP 50R,E00,518795,Staff,0,0,20,20
1713504529128,MCWP 50R,F00,518796,Staff,11,0,20,9
1713504529128,MCWP 50R,G00,518797,Staff,10,0,20,10
1713504530155,MMW 12R,A01,514034,Herbst; Matthew,2,0,16,14
1713504530155,MMW 12R,A02,514035,Herbst; Matthew,13,0,16,3
1713504531180,MMW 13R,A01,514037,Staff,0,8,16,16
1713504531180,MMW 13R,A02,514039,Staff,0,7,16,16
1713504533238,SIO 295LS,A00,523233,Staff,15,0,30,15
1713504534321,SIO 295S,A00,523232,Staff,15,0,30,15
1713504535348,SOCI 117,A01,494376,Staff,0,2,5,5
1713504536373,WES 237B,A00,494380,Staff,19,0,20,1
1713504538456,AESE 279B,A00,494370,Wade; Jon P,33,0,33,0
1713504539484,AIP 197,001,627712,Vespa; Emanuel Ignacio,9999,0,9999,0
1713504540511,ANAR 135S,A00,494369,Braswell; Geoffrey E.,0,0,0,0
1713504541539,CAT 124RS,A01,519847,Geibel; William,6,0,20,14
1713504542566,CAT 125RS,A01,515971,Geibel; William,6,0,20,14
1713504543591,CLRE 250,A00,511389,Morris; Sheldon,9996,0,9999,3
1713504544618,CLRE 251,A00,507176,Mehta; Ravindra L.,9996,0,9999,3
1713504544618,CLRE 251,B00,511410,Mehta; Ravindra L.,9998,0,9999,1
1713504545650,CLRE 252,A00,507189,Cuomo; Raphael Eduardo,9998,0,9999,1
1713504546680,CLRE 253,A00,507199,Vaida; Florin,9997,0,9999,2
1713504546680,CLRE 253,B00,507202,Vaida; Florin,9999,0,9999,0
1713504547708,CLRE 259,A00,507211,Patel; Hemal,9996,0,9999,3
1713504548736,CLRE 260,A00,507221,Cuomo; Raphael Eduardo,9999,0,9999,0
1713504549761,CLRE 297,001,507242,Cuomo; Raphael Eduardo,9999,0,9999,0
1713504550790,CSE 191,A00,516875,Minnes Kemp; Mor Mia,9999,0,9999,0
1713504551817,CSS 201S,A01,494383,Staff,35,0,35,0
1713504552846,CSS 202S,A01,494387,Staff,35,0,35,0
1713504553874,EAP 100,A00,516065,Staff,9792,0,9999,207
1713504554900,ECE 45,A01,507414,Staff,37,0,60,23
1713504555925,ECE 100,A01,507416,Baghdadchi; Saharnaz,0,0,20,20
1713504555925,ECE 100,A02,507418,Baghdadchi; Saharnaz,19,0,20,1
1713504556950,ECE 111,A01,507420,Staff,27,0,50,23
1713504557975,ECE 197,001,548057,Sievenpiper; Daniel F.,9998,0,9999,1
1713504559000,EDS 115,A00,507243,Choi; Bailey Miyeon,27,0,28,1
1713504560026,EDS 117,A01,494379,Staff,15,0,25,10
1713504561055,EDS 125,A00,507246,Hopkins; Megan Beth,27,0,30,3
1713504562080,EDS 128A,A01,507264,Fargason; Sharon Gayle,26,0,26,0
1713504563108,EDS 128B,A01,507293,Pappas; Elizabeth,30,0,30,0
1713504564135,EDS 139,A00,507294,Fargason; Sharon Gayle,30,0,30,0
1713504564135,EDS 139,B00,507313,Pappas; Elizabeth,30,0,30,0
1713504565163,EDS 201,A00,507315,Staff,18,0,30,12
1713504566193,EDS 203,A01,507317,Halter; Christopher P.,17,0,30,13
1713504567221,EDS 204R,A01,507319,Halter; Christopher P.,0,1,30,30
1713504567221,EDS 204R,B01,507331,Heinzman; Erica M.,22,0,30,8
1713504568247,EDS 206R,A00,507332,Staff,0,2,30,30
1713504568247,EDS 206R,B00,507343,Staff,23,0,30,7
1713504569275,EDS 250,A00,507344,Hemans; Patricia Ann Benitez,27,0,40,13
1713504570300,EDS 281,A00,507345,Daly; Alan J.,18,0,18,0
1713504571328,EDS 284,A00,507350,Daly; Alan J.,16,0,16,0
1713504572356,EDS 286,A00,507359,Fine; Sarah,18,0,18,0
1713504573384,EDS 289C,A01,507361,Daly; Alan J.,18,0,18,0
1713504574408,EDS 290,A00,507366,Hofstetter; Carolyn,15,0,15,0
1713504575433,LIGM 5A,A00,507421,Fischer-Grunski; Eva K,20,0,20,0
1713504576463,LIGM 5B,A00,507423,Fischer-Grunski; Eva K,20,0,20,0
1713504577491,LIGM 5C,A00,507425,Fischer-Grunski; Eva K,20,0,20,0
1713504578517,LIIT 5AS,A00,507427,Carnelos; Chiara,20,0,20,0
1713504579543,LIIT 5BS,A00,507430,Carnelos; Chiara,20,0,20,0
1713504580568,LIIT 5CS,A00,507432,Carnelos; Chiara,20,0,20,0
1713504581595,LISP 5A,A00,507541,Munoz Sanchez; Alicia,14,0,20,6
1713504582619,LISP 5B,A00,507671,Munoz Sanchez; Alicia,12,0,20,8
1713504583647,LISP 5C,A00,507696,Munoz Sanchez; Alicia,11,0,20,9
1713504584673,MAE 197,001,528363,Boechler; Nicholas Sebastia,9998,0,9999,1
1713504585700,MATH 197,001,523477,Kedlaya; Kiran S.,9999,0,9999,0
1713504585700,MATH 197,002,563811,Zhang; Danna,9998,0,9999,1
1713504586728,MCWP 40R,A00,518780,Staff,13,0,20,7
1713504586728,MCWP 40R,B00,518781,Staff,11,0,20,9
1713504586728,MCWP 40R,C00,518783,Staff,8,0,20,12
1713504587757,MCWP 50R,A00,518791,Staff,7,0,20,13
1713504587757,MCWP 50R,B00,518792,Staff,3,0,20,17
1713504587757,MCWP 50R,C00,518793,Staff,5,0,20,15
1713504587757,MCWP 50R,D00,518794,Staff,0,0,20,20
1713504587757,MCWP 50R,E00,518795,Staff,0,0,20,20
1713504587757,MCWP 50R,F00,518796,Staff,11,0,20,9
1713504587757,MCWP 50R,G00,518797,Staff,10,0,20,10
1713504588784,MMW 12R,A01,514034,Herbst; Matthew,2,0,16,14
1713504588784,MMW 12R,A02,514035,Herbst; Matthew,13,0,16,3
1713504589808,MMW 13R,A01,514037,Staff,0,8,16,16
1713504589808,MMW 13R,A02,514039,Staff,0,7,16,16
1713504591862,SIO 295LS,A00,523233,Staff,15,0,30,15
1713504592888,SIO 295S,A00,523232,Staff,15,0,30,15
1713504593918,SOCI 117,A01,494376,Staff,0,2,5,5
1713504594949,WES 237B,A00,494380,Staff,19,0,20,1
1713504597033,AESE 279B,A00,494370,Wade; Jon P,33,0,33,0
1713504598058,AIP 197,001,627712,Vespa; Emanuel Ignacio,9999,0,9999,0
1713504599084,ANAR 135S,A00,494369,Braswell; Geoffrey E.,0,0,0,0
1713504600112,CAT 124RS,A01,519847,Geibel; William,6,0,20,14
1713504601137,CAT 125RS,A01,515971,Geibel; William,6,0,20,14
1713504602166,CLRE 250,A00,511389,Morris; Sheldon,9996,0,9999,3
1713504603196,CLRE 251,A00,507176,Mehta; Ravindra L.,9996,0,9999,3
1713504603196,CLRE 251,B00,511410,Mehta; Ravindra L.,9998,0,9999,1
1713504604222,CLRE 252,A00,507189,Cuomo; Raphael Eduardo,9998,0,9999,1
1713504605254,CLRE 253,A00,507199,Vaida; Florin,9997,0,9999,2
1713504605254,CLRE 253,B00,507202,Vaida; Florin,9999,0,9999,0
1713504606279,CLRE 259,A00,507211,Patel; Hemal,9996,0,9999,3
1713504607305,CLRE 260,A00,507221,Cuomo; Raphael Eduardo,9999,0,9999,0
1713504608333,CLRE 297,001,507242,Cuomo; Raphael Eduardo,9999,0,9999,0
1713504609363,CSE 191,A00,516875,Minnes Kemp; Mor Mia,9999,0,9999,0
1713504610387,CSS 201S,A01,494383,Staff,35,0,35,0
1713504611413,CSS 202S,A01,494387,Staff,35,0,35,0
1713504612439,EAP 100,A00,516065,Staff,9792,0,9999,207
1713504613464,ECE 45,A01,507414,Staff,37,0,60,23
1713504614491,ECE 100,A01,507416,Baghdadchi; Saharnaz,0,0,20,20
1713504614491,ECE 100,A02,507418,Baghdadchi; Saharnaz,19,0,20,1
1713504615519,ECE 111,A01,507420,Staff,27,0,50,23
1713504616544,ECE 197,001,548057,Sievenpiper; Daniel F.,9998,0,9999,1
1713504617572,EDS 115,A00,507243,Choi; Bailey Miyeon,27,0,28,1
1713504618600,EDS 117,A01,494379,Staff,15,0,25,10
1713504619627,EDS 125,A00,507246,Hopkins; Megan Beth,27,0,30,3
1713504620653,EDS 128A,A01,507264,Fargason; Sharon Gayle,26,0,26,0
1713504621681,EDS 128B,A01,507293,Pappas; Elizabeth,30,0,30,0
1713504622706,EDS 139,A00,507294,Fargason; Sharon Gayle,30,0,30,0
1713504622706,EDS 139,B00,507313,Pappas; Elizabeth,30,0,30,0
1713504623731,EDS 201,A00,507315,Staff,18,0,30,12
1713504624760,EDS 203,A01,507317,Halter; Christopher P.,17,0,30,13
1713504625792,EDS 204R,A01,507319,Halter; Christopher P.,0,1,30,30
1713504625792,EDS 204R,B01,507331,Heinzman; Erica M.,22,0,30,8
1713504626817,EDS 206R,A00,507332,Staff,0,2,30,30
1713504626817,EDS 206R,B00,507343,Staff,23,0,30,7
1713504627846,EDS 250,A00,507344,Hemans; Patricia Ann Benitez,27,0,40,13
1713504628873,EDS 281,A00,507345,Daly; Alan J.,18,0,18,0
1713504629900,EDS 284,A00,507350,Daly; Alan J.,16,0,16,0
1713504630926,EDS 286,A00,507359,Fine; Sarah,18,0,18,0
1713504631955,EDS 289C,A01,507361,Daly; Alan J.,18,0,18,0
1713504632980,EDS 290,A00,507366,Hofstetter; Carolyn,15,0,15,0
1713504634005,LIGM 5A,A00,507421,Fischer-Grunski; Eva K,20,0,20,0
1713504635035,LIGM 5B,A00,507423,Fischer-Grunski; Eva K,20,0,20,0
1713504636064,LIGM 5C,A00,507425,Fischer-Grunski; Eva K,20,0,20,0
1713504637090,LIIT 5AS,A00,507427,Carnelos; Chiara,20,0,20,0
1713504638174,LIIT 5BS,A00,507430,Carnelos; Chiara,20,0,20,0
1713504639203,LIIT 5CS,A00,507432,Carnelos; Chiara,20,0,20,0
1713504640234,LISP 5A,A00,507541,Munoz Sanchez; Alicia,14,0,20,6
1713504641263,LISP 5B,A00,507671,Munoz Sanchez; Alicia,12,0,20,8
1713504642289,LISP 5C,A00,507696,Munoz Sanchez; Alicia,11,0,20,9
1713504643315,MAE 197,001,528363,Boechler; Nicholas Sebastia,9998,0,9999,1
1713504644341,MATH 197,001,523477,Kedlaya; Kiran S.,9999,0,9999,0
1713504644341,MATH 197,002,563811,Zhang; Danna,9998,0,9999,1
1713504645366,MCWP 40R,A00,518780,Staff,13,0,20,7
1713504645366,MCWP 40R,B00,518781,Staff,11,0,20,9
1713504645366,MCWP 40R,C00,518783,Staff,8,0,20,12
1713504646393,MCWP 50R,A00,518791,Staff,7,0,20,13
1713504646393,MCWP 50R,B00,518792,Staff,3,0,20,17
1713504646393,MCWP 50R,C00,518793,Staff,5,0,20,15
1713504646393,MCWP 50R,D00,518794,Staff,0,0,20,20
1713504646393,MCWP 50R,E00,518795,Staff,0,0,20,20
1713504646393,MCWP 50R,F00,518796,Staff,11,0,20,9
1713504646393,MCWP 50R,G00,518797,Staff,10,0,20,10
1713504647421,MMW 12R,A01,514034,Herbst; Matthew,2,0,16,14
1713504647421,MMW 12R,A02,514035,Herbst; Matthew,13,0,16,3
1713504648451,MMW 13R,A01,514037,Staff,0,8,16,16
1713504648451,MMW 13R,A02,514039,Staff,0,7,16,16
1713504650499,SIO 295LS,A00,523233,Staff,15,0,30,15
1713504651524,SIO 295S,A00,523232,Staff,15,0,30,15
1713504652552,SOCI 117,A01,494376,Staff,0,2,5,5
1713504653577,WES 237B,A00,494380,Staff,19,0,20,1
1713504655637,AESE 279B,A00,494370,Wade; Jon P,33,0,33,0
1713504656663,AIP 197,001,627712,Vespa; Emanuel Ignacio,9999,0,9999,0
1713504657687,ANAR 135S,A00,494369,Braswell; Geoffrey E.,0,0,0,0
1713504658713,CAT 124RS,A01,519847,Geibel; William,6,0,20,14
1713504659743,CAT 125RS,A01,515971,Geibel; William,6,0,20,14
1713504660768,CLRE 250,A00,511389,Morris; Sheldon,9996,0,9999,3
1713504661794,CLRE 251,A00,507176,Mehta; Ravindra L.,9996,0,9999,3
1713504661794,CLRE 251,B00,511410,Mehta; Ravindra L.,9998,0,9999,1
1713504662820,CLRE 252,A00,507189,Cuomo; Raphael Eduardo,9998,0,9999,1
1713504663847,CLRE 253,A00,507199,Vaida; Florin,9997,0,9999,2
1713504663847,CLRE 253,B00,507202,Vaida; Florin,9999,0,9999,0
1713504664873,CLRE 259,A00,507211,Patel; Hemal,9996,0,9999,3
1713504665897,CLRE 260,A00,507221,Cuomo; Raphael Eduardo,9999,0,9999,0
1713504666923,CLRE 297,001,507242,Cuomo; Raphael Eduardo,9999,0,9999,0
1713504667949,CSE 191,A00,516875,Minnes Kemp; Mor Mia,9999,0,9999,0
1713504668975,CSS 201S,A01,494383,Staff,35,0,35,0
1713504670001,CSS 202S,A01,494387,Staff,35,0,35,0
1713504671028,EAP 100,A00,516065,Staff,9792,0,9999,207
1713504672092,ECE 45,A01,507414,Staff,37,0,60,23
1713504673122,ECE 100,A01,507416,Baghdadchi; Saharnaz,0,0,20,20
1713504673122,ECE 100,A02,507418,Baghdadchi; Saharnaz,19,0,20,1
1713504674150,ECE 111,A01,507420,Staff,27,0,50,23
1713504675176,ECE 197,001,548057,Sievenpiper; Daniel F.,9998,0,9999,1
1713504676203,EDS 115,A00,507243,Choi; Bailey Miyeon,27,0,28,1
1713504677232,EDS 117,A01,494379,Staff,15,0,25,10
1713504678258,EDS 125,A00,507246,Hopkins; Megan Beth,27,0,30,3
1713504679284,EDS 128A,A01,507264,Fargason; Sharon Gayle,26,0,26,0
1713504680313,EDS 128B,A01,507293,Pappas; Elizabeth,30,0,30,0
1713504681337,EDS 139,A00,507294,Fargason; Sharon Gayle,30,0,30,0
1713504681337,EDS 139,B00,507313,Pappas; Elizabeth,30,0,30,0
1713504682362,EDS 201,A00,507315,Staff,18,0,30,12
1713504683387,EDS 203,A01,507317,Halter; Christopher P.,17,0,30,13
1713504684413,EDS 204R,A01,507319,Halter; Christopher P.,0,1,30,30
1713504684413,EDS 204R,B01,507331,Heinzman; Erica M.,22,0,30,8
1713504685437,EDS 206R,A00,507332,Staff,0,2,30,30
1713504685437,EDS 206R,B00,507343,Staff,23,0,30,7
1713504686466,EDS 250,A00,507344,Hemans; Patricia Ann Benitez,27,0,40,13
1713504687493,EDS 281,A00,507345,Daly; Alan J.,18,0,18,0
1713504688521,EDS 284,A00,507350,Daly; Alan J.,16,0,16,0
1713504689549,EDS 286,A00,507359,Fine; Sarah,18,0,18,0
1713504690576,EDS 289C,A01,507361,Daly; Alan J.,18,0,18,0
1713504691600,EDS 290,A00,507366,Hofstetter; Carolyn,15,0,15,0
1713504692625,LIGM 5A,A00,507421,Fischer-Grunski; Eva K,20,0,20,0
1713504693651,LIGM 5B,A00,507423,Fischer-Grunski; Eva K,20,0,20,0
1713504694680,LIGM 5C,A00,507425,Fischer-Grunski; Eva K,20,0,20,0
1713504695709,LIIT 5AS,A00,507427,Carnelos; Chiara,20,0,20,0
1713504696740,LIIT 5BS,A00,507430,Carnelos; Chiara,20,0,20,0
1713504697769,LIIT 5CS,A00,507432,Carnelos; Chiara,20,0,20,0
1713504698795,LISP 5A,A00,507541,Munoz Sanchez; Alicia,14,0,20,6
1713504699821,LISP 5B,A00,507671,Munoz Sanchez; Alicia,12,0,20,8
1713504700850,LISP 5C,A00,507696,Munoz Sanchez; Alicia,11,0,20,9
1713504701889,MAE 197,001,528363,Boechler; Nicholas Sebastia,9998,0,9999,1
1713504702917,MATH 197,001,523477,Kedlaya; Kiran S.,9999,0,9999,0
1713504702917,MATH 197,002,563811,Zhang; Danna,9998,0,9999,1
1713504703944,MCWP 40R,A00,518780,Staff,13,0,20,7
1713504703944,MCWP 40R,B00,518781,Staff,11,0,20,9
1713504703944,MCWP 40R,C00,518783,Staff,8,0,20,12
1713504704970,MCWP 50R,A00,518791,Staff,7,0,20,13
1713504704970,MCWP 50R,B00,518792,Staff,3,0,20,17
1713504704970,MCWP 50R,C00,518793,Staff,5,0,20,15
1713504704970,MCWP 50R,D00,518794,Staff,0,0,20,20
1713504704970,MCWP 50R,E00,518795,Staff,0,0,20,20
1713504704970,MCWP 50R,F00,518796,Staff,11,0,20,9
1713504704970,MCWP 50R,G00,518797,Staff,10,0,20,10
1713504705998,MMW 12R,A01,514034,Herbst; Matthew,2,0,16,14
1713504705998,MMW 12R,A02,514035,Herbst; Matthew,13,0,16,3
1713504707022,MMW 13R,A01,514037,Staff,0,8,16,16
1713504707022,MMW 13R,A02,514039,Staff,0,7,16,16
1713504709074,SIO 295LS,A00,523233,Staff,15,0,30,15
1713504710102,SIO 295S,A00,523232,Staff,15,0,30,15
1713504711128,SOCI 117,A01,494376,Staff,0,2,5,5
1713504712153,WES 237B,A00,494380,Staff,19,0,20,1
1713504714221,AESE 279B,A00,494370,Wade; Jon P,33,0,33,0
1713504715247,AIP 197,001,627712,Vespa; Emanuel Ignacio,9999,0,9999,0
1713504716272,ANAR 135S,A00,494369,Braswell; Geoffrey E.,0,0,0,0
1713504717300,CAT 124RS,A01,519847,Geibel; William,6,0,20,14
1713504718325,CAT 125RS,A01,515971,Geibel; William,6,0,20,14
1713504719354,CLRE 250,A00,511389,Morris; Sheldon,9996,0,9999,3
1713504720384,CLRE 251,A00,507176,Mehta; Ravindra L.,9996,0,9999,3
1713504720384,CLRE 251,B00,511410,Mehta; Ravindra L.,9998,0,9999,1
1713504721409,CLRE 252,A00,507189,Cuomo; Raphael Eduardo,9998,0,9999,1
1713504722435,CLRE 253,A00,507199,Vaida; Florin,9997,0,9999,2
1713504722435,CLRE 253,B00,507202,Vaida; Florin,9999,0,9999,0
1713504723464,CLRE 259,A00,507211,Patel; Hemal,9996,0,9999,3
1713504724491,CLRE 260,A00,507221,Cuomo; Raphael Eduardo,9999,0,9999,0
1713504725515,CLRE 297,001,507242,Cuomo; Raphael Eduardo,9999,0,9999,0
1713504726544,CSE 191,A00,516875,Minnes Kemp; Mor Mia,9999,0,9999,0
1713504727571,CSS 201S,A01,494383,Staff,35,0,35,0
1713504728596,CSS 202S,A01,494387,Staff,35,0,35,0
1713504729621,EAP 100,A00,516065,Staff,9792,0,9999,207
1713504730649,ECE 45,A01,507414,Staff,37,0,60,23
1713504731678,ECE 100,A01,507416,Baghdadchi; Saharnaz,0,0,20,20
1713504731678,ECE 100,A02,507418,Baghdadchi; Saharnaz,19,0,20,1
1713504732704,ECE 111,A01,507420,Staff,27,0,50,23
1713504733730,ECE 197,001,548057,Sievenpiper; Daniel F.,9998,0,9999,1
1713504734758,EDS 115,A00,507243,Choi; Bailey Miyeon,27,0,28,1
1713504735782,EDS 117,A01,494379,Staff,15,0,25,10
1713504736808,EDS 125,A00,507246,Hopkins; Megan Beth,27,0,30,3
1713504737838,EDS 128A,A01,507264,Fargason; Sharon Gayle,26,0,26,0
1713504738863,EDS 128B,A01,507293,Pappas; Elizabeth,30,0,30,0
1713504739891,EDS 139,A00,507294,Fargason; Sharon Gayle,30,0,30,0
1713504739891,EDS 139,B00,507313,Pappas; Elizabeth,30,0,30,0
1713504740918,EDS 201,A00,507315,Staff,18,0,30,12
1713504742000,EDS 203,A01,507317,Halter; Christopher P.,17,0,30,13
1713504743027,EDS 204R,A01,507319,Halter; Christopher P.,0,1,30,30
1713504743027,EDS 204R,B01,507331,Heinzman; Erica M.,22,0,30,8
1713504744081,EDS 206R,A00,507332,Staff,0,2,30,30
1713504744081,EDS 206R,B00,507343,Staff,23,0,30,7
1713504745107,EDS 250,A00,507344,Hemans; Patricia Ann Benitez,27,0,40,13
1713504746135,EDS 281,A00,507345,Daly; Alan J.,18,0,18,0
1713504747161,EDS 284,A00,507350,Daly; Alan J.,16,0,16,0
1713504748187,EDS 286,A00,507359,Fine; Sarah,18,0,18,0
1713504749215,EDS 289C,A01,507361,Daly; Alan J.,18,0,18,0
1713504750244,EDS 290,A00,507366,Hofstetter; Carolyn,15,0,15,0
1713504751272,LIGM 5A,A00,507421,Fischer-Grunski; Eva K,20,0,20,0
1713504752301,LIGM 5B,A00,507423,Fischer-Grunski; Eva K,20,0,20,0
1713504753331,LIGM 5C,A00,507425,Fischer-Grunski; Eva K,20,0,20,0
1713504754357,LIIT 5AS,A00,507427,Carnelos; Chiara,20,0,20,0
1713504755385,LIIT 5BS,A00,507430,Carnelos; Chiara,20,0,20,0
1713504756411,LIIT 5CS,A00,507432,Carnelos; Chiara,20,0,20,0
1713504757436,LISP 5A,A00,507541,Munoz Sanchez; Alicia,14,0,20,6
1713504758461,LISP 5B,A00,507671,Munoz Sanchez; Alicia,12,0,20,8
1713504759487,LISP 5C,A00,507696,Munoz Sanchez; Alicia,11,0,20,9
1713504760512,MAE 197,001,528363,Boechler; Nicholas Sebastia,9998,0,9999,1
1713504761537,MATH 197,001,523477,Kedlaya; Kiran S.,9999,0,9999,0
1713504761537,MATH 197,002,563811,Zhang; Danna,9998,0,9999,1
1713504762565,MCWP 40R,A00,518780,Staff,13,0,20,7
1713504762565,MCWP 40R,B00,518781,Staff,11,0,20,9
1713504762565,MCWP 40R,C00,518783,Staff,8,0,20,12
1713504763594,MCWP 50R,A00,518791,Staff,7,0,20,13
1713504763594,MCWP 50R,B00,518792,Staff,3,0,20,17
1713504763594,MCWP 50R,C00,518793,Staff,5,0,20,15
1713504763594,MCWP 50R,D00,518794,Staff,0,0,20,20
1713504763594,MCWP 50R,E00,518795,Staff,0,0,20,20
1713504763594,MCWP 50R,F00,518796,Staff,11,0,20,9
1713504763594,MCWP 50R,G00,518797,Staff,10,0,20,10
1713504764620,MMW 12R,A01,514034,Herbst; Matthew,1,0,16,15
1713504764620,MMW 12R,A02,514035,Herbst; Matthew,13,0,16,3
1713504765647,MMW 13R,A01,514037,Staff,0,8,16,16
1713504765647,MMW 13R,A02,514039,Staff,0,7,16,16
1713504767696,SIO 295LS,A00,523233,Staff,15,0,30,15
1713504768721,SIO 295S,A00,523232,Staff,15,0,30,15
1713504769749,SOCI 117,A01,494376,Staff,0,2,5,5
1713504770775,WES 237B,A00,494380,Staff,19,0,20,1
1713504772838,AESE 279B,A00,494370,Wade; Jon P,33,0,33,0
1713504773873,AIP 197,001,627712,Vespa; Emanuel Ignacio,9999,0,9999,0
1713504774897,ANAR 135S,A00,494369,Braswell; Geoffrey E.,0,0,0,0
1713504775923,CAT 124RS,A01,519847,Geibel; William,6,0,20,14
1713504776949,CAT 125RS,A01,515971,Geibel; William,6,0,20,14
1713504777977,CLRE 250,A00,511389,Morris; Sheldon,9996,0,9999,3
1713504779002,CLRE 251,A00,507176,Mehta; Ravindra L.,9996,0,9999,3
1713504779002,CLRE 251,B00,511410,Mehta; Ravindra L.,9998,0,9999,1
1713504780029,CLRE 252,A00,507189,Cuomo; Raphael Eduardo,9998,0,9999,1
1713504781056,CLRE 253,A00,507199,Vaida; Florin,9997,0,9999,2
1713504781056,CLRE 253,B00,507202,Vaida; Florin,9999,0,9999,0
1713504782083,CLRE 259,A00,507211,Patel; Hemal,9996,0,9999,3
1713504783111,CLRE 260,A00,507221,Cuomo; Raphael Eduardo,9999,0,9999,0
1713504784139,CLRE 297,001,507242,Cuomo; Raphael Eduardo,9999,0,9999,0
1713504785164,CSE 191,A00,516875,Minnes Kemp; Mor Mia,9999,0,9999,0
1713504786191,CSS 201S,A01,494383,Staff,35,0,35,0
1713504787217,CSS 202S,A01,494387,Staff,35,0,35,0
1713504788243,EAP 100,A00,516065,Staff,9792,0,9999,207
1713504789270,ECE 45,A01,507414,Staff,37,0,60,23
1713504790297,ECE 100,A01,507416,Baghdadchi; Saharnaz,0,0,20,20
1713504790297,ECE 100,A02,507418,Baghdadchi; Saharnaz,19,0,20,1
1713504791323,ECE 111,A01,507420,Staff,27,0,50,23
1713504792352,ECE 197,001,548057,Sievenpiper; Daniel F.,9998,0,9999,1
1713504793379,EDS 115,A00,507243,Choi; Bailey Miyeon,27,0,28,1
1713504794408,EDS 117,A01,494379,Staff,15,0,25,10
1713504795433,EDS 125,A00,507246,Hopkins; Megan Beth,27,0,30,3
1713504796461,EDS 128A,A01,507264,Fargason; Sharon Gayle,26,0,26,0
1713504797490,EDS 128B,A01,507293,Pappas; Elizabeth,30,0,30,0
1713504798515,EDS 139,A00,507294,Fargason; Sharon Gayle,30,0,30,0
1713504798515,EDS 139,B00,507313,Pappas; Elizabeth,30,0,30,0
1713504799542,EDS 201,A00,507315,Staff,18,0,30,12
1713504800568,EDS 203,A01,507317,Halter; Christopher P.,17,0,30,13
1713504801595,EDS 204R,A01,507319,Halter; Christopher P.,0,1,30,30
1713504801595,EDS 204R,B01,507331,Heinzman; Erica M.,22,0,30,8
1713504802620,EDS 206R,A00,507332,Staff,0,2,30,30
1713504802620,EDS 206R,B00,507343,Staff,23,0,30,7
1713504803650,EDS 250,A00,507344,Hemans; Patricia Ann Benitez,27,0,40,13
1713504804676,EDS 281,A00,507345,Daly; Alan J.,18,0,18,0
1713504805702,EDS 284,A00,507350,Daly; Alan J.,16,0,16,0
1713504806730,EDS 286,A00,507359,Fine; Sarah,18,0,18,0
1713504807755,EDS 289C,A01,507361,Daly; Alan J.,18,0,18,0
1713504808780,EDS 290,A00,507366,Hofstetter; Carolyn,15,0,15,0
1713504809811,LIGM 5A,A00,507421,Fischer-Grunski; Eva K,20,0,20,0
1713504810837,LIGM 5B,A00,507423,Fischer-Grunski; Eva K,20,0,20,0
1713504811867,LIGM 5C,A00,507425,Fischer-Grunski; Eva K,20,0,20,0
1713504812899,LIIT 5AS,A00,507427,Carnelos; Chiara,20,0,20,0
1713504813928,LIIT 5BS,A00,507430,Carnelos; Chiara,20,0,20,0
1713504814953,LIIT 5CS,A00,507432,Carnelos; Chiara,20,0,20,0
1713504815979,LISP 5A,A00,507541,Munoz Sanchez; Alicia,14,0,20,6
1713504817005,LISP 5B,A00,507671,Munoz Sanchez; Alicia,12,0,20,8
1713504818031,LISP 5C,A00,507696,Munoz Sanchez; Alicia,11,0,20,9
1713504819056,MAE 197,001,528363,Boechler; Nicholas Sebastia,9998,0,9999,1
1713504820083,MATH 197,001,523477,Kedlaya; Kiran S.,9999,0,9999,0
1713504820083,MATH 197,002,563811,Zhang; Danna,9998,0,9999,1
1713504821108,MCWP 40R,A00,518780,Staff,13,0,20,7
1713504821108,MCWP 40R,B00,518781,Staff,11,0,20,9
1713504821108,MCWP 40R,C00,518783,Staff,8,0,20,12
1713504822133,MCWP 50R,A00,518791,Staff,7,0,20,13
1713504822133,MCWP 50R,B00,518792,Staff,3,0,20,17
1713504822133,MCWP 50R,C00,518793,Staff,5,0,20,15
1713504822133,MCWP 50R,D00,518794,Staff,0,0,20,20
1713504822133,MCWP 50R,E00,518795,Staff,0,0,20,20
1713504822133,MCWP 50R,F00,518796,Staff,11,0,20,9
1713504822133,MCWP 50R,G00,518797,Staff,10,0,20,10
1713504823163,MMW 12R,A01,514034,Herbst; Matthew,1,0,16,15
1713504823163,MMW 12R,A02,514035,Herbst; Matthew,13,0,16,3
1713504824188,MMW 13R,A01,514037,Staff,0,8,16,16
1713504824188,MMW 13R,A02,514039,Staff,0,7,16,16
1713504826240,SIO 295LS,A00,523233,Staff,15,0,30,15
1713504827265,SIO 295S,A00,523232,Staff,15,0,30,15
1713504828291,SOCI 117,A01,494376,Staff,0,2,5,5
1713504829319,WES 237B,A00,494380,Staff,19,0,20,1
1713504831387,AESE 279B,A00,494370,Wade; Jon P,33,0,33,0
1713504832410,AIP 197,001,627712,Vespa; Emanuel Ignacio,9999,0,9999,0
1713504833436,ANAR 135S,A00,494369,Braswell; Geoffrey E.,0,0,0,0
1713504834461,CAT 124RS,A01,519847,Geibel; William,6,0,20,14
1713504835485,CAT 125RS,A01,515971,Geibel; William,6,0,20,14
1713504836515,CLRE 250,A00,511389,Morris; Sheldon,9996,0,9999,3
1713504837541,CLRE 251,A00,507176,Mehta; Ravindra L.,9996,0,9999,3
1713504837541,CLRE 251,B00,511410,Mehta; Ravindra L.,9998,0,9999,1
1713504838571,CLRE 252,A00,507189,Cuomo; Raphael Eduardo,9998,0,9999,1
1713504839597,CLRE 253,A00,507199,Vaida; Florin,9997,0,9999,2
1713504839597,CLRE 253,B00,507202,Vaida; Florin,9999,0,9999,0
1713504840622,CLRE 259,A00,507211,Patel; Hemal,9996,0,9999,3
1713504841648,CLRE 260,A00,507221,Cuomo; Raphael Eduardo,9999,0,9999,0
1713504842673,CLRE 297,001,507242,Cuomo; Raphael Eduardo,9999,0,9999,0
1713504843697,CSE 191,A00,516875,Minnes Kemp; Mor Mia,9999,0,9999,0
1713504844724,CSS 201S,A01,494383,Staff,35,0,35,0
1713504845804,CSS 202S,A01,494387,Staff,35,0,35,0
1713504846831,EAP 100,A00,516065,Staff,9792,0,9999,207
1713504847858,ECE 45,A01,507414,Staff,37,0,60,23
1713504848884,ECE 100,A01,507416,Baghdadchi; Saharnaz,0,0,20,20
1713504848884,ECE 100,A02,507418,Baghdadchi; Saharnaz,19,0,20,1
1713504849909,ECE 111,A01,507420,Staff,27,0,50,23
1713504850939,ECE 197,001,548057,Sievenpiper; Daniel F.,9998,0,9999,1
1713504851967,EDS 115,A00,507243,Choi; Bailey Miyeon,27,0,28,1
1713504852992,EDS 117,A01,494379,Staff,15,0,25,10
1713504854020,EDS 125,A00,507246,Hopkins; Megan Beth,27,0,30,3
1713504855047,EDS 128A,A01,507264,Fargason; Sharon Gayle,26,0,26,0
1713504856076,EDS 128B,A01,507293,Pappas; Elizabeth,30,0,30,0
1713504857101,EDS 139,A00,507294,Fargason; Sharon Gayle,30,0,30,0
1713504857101,EDS 139,B00,507313,Pappas; Elizabeth,30,0,30,0
1713504858127,EDS 201,A00,507315,Staff,18,0,30,12
1713504859152,EDS 203,A01,507317,Halter; Christopher P.,17,0,30,13
1713504860183,EDS 204R,A01,507319,Halter; Christopher P.,0,1,30,30
1713504860183,EDS 204R,B01,507331,Heinzman; Erica M.,22,0,30,8
1713504861208,EDS 206R,A00,507332,Staff,0,2,30,30
1713504861208,EDS 206R,B00,507343,Staff,23,0,30,7
1713504862237,EDS 250,A00,507344,Hemans; Patricia Ann Benitez,27,0,40,13
1713504863263,EDS 281,A00,507345,Daly; Alan J.,18,0,18,0
1713504864289,EDS 284,A00,507350,Daly; Alan J.,16,0,16,0
1713504865320,EDS 286,A00,507359,Fine; Sarah,18,0,18,0
1713504866348,EDS 289C,A01,507361,Daly; Alan J.,18,0,18,0
1713504867374,EDS 290,A00,507366,Hofstetter; Carolyn,15,0,15,0
1713504868403,LIGM 5A,A00,507421,Fischer-Grunski; Eva K,20,0,20,0
1713504869428,LIGM 5B,A00,507423,Fischer-Grunski; Eva K,20,0,20,0
1713504870457,LIGM 5C,A00,507425,Fischer-Grunski; Eva K,20,0,20,0
1713504871482,LIIT 5AS,A00,507427,Carnelos; Chiara,20,0,20,0
1713504872512,LIIT 5BS,A00,507430,Carnelos; Chiara,20,0,20,0
1713504873537,LIIT 5CS,A00,507432,Carnelos; Chiara,20,0,20,0
1713504874562,LISP 5A,A00,507541,Munoz Sanchez; Alicia,14,0,20,6
1713504875589,LISP 5B,A00,507671,Munoz Sanchez; Alicia,12,0,20,8
1713504876614,LISP 5C,A00,507696,Munoz Sanchez; Alicia,11,0,20,9
1713504877642,MAE 197,001,528363,Boechler; Nicholas Sebastia,9998,0,9999,1
1713504878666,MATH 197,001,523477,Kedlaya; Kiran S.,9999,0,9999,0
1713504878666,MATH 197,002,563811,Zhang; Danna,9998,0,9999,1
1713504879695,MCWP 40R,A00,518780,Staff,13,0,20,7
1713504879695,MCWP 40R,B00,518781,Staff,11,0,20,9
1713504879695,MCWP 40R,C00,518783,Staff,8,0,20,12
1713504880723,MCWP 50R,A00,518791,Staff,7,0,20,13
1713504880723,MCWP 50R,B00,518792,Staff,3,0,20,17
1713504880723,MCWP 50R,C00,518793,Staff,5,0,20,15
1713504880723,MCWP 50R,D00,518794,Staff,0,0,20,20
1713504880723,MCWP 50R,E00,518795,Staff,0,0,20,20
1713504880723,MCWP 50R,F00,518796,Staff,11,0,20,9
1713504880723,MCWP 50R,G00,518797,Staff,10,0,20,10
1713504881749,MMW 12R,A01,514034,Herbst; Matthew,1,0,16,15
1713504881749,MMW 12R,A02,514035,Herbst; Matthew,13,0,16,3
1713504882774,MMW 13R,A01,514037,Staff,0,8,16,16
1713504882774,MMW 13R,A02,514039,Staff,0,7,16,16
1713504884827,SIO 295LS,A00,523233,Staff,15,0,30,15
1713504885855,SIO 295S,A00,523232,Staff,15,0,30,15
1713504886886,SOCI 117,A01,494376,Staff,0,2,5,5
1713504887912,WES 237B,A00,494380,Staff,19,0,20,1
1713504889983,AESE 279B,A00,494370,Wade; Jon P,33,0,33,0
1713504891015,AIP 197,001,627712,Vespa; Emanuel Ignacio,9999,0,9999,0
1713504892039,ANAR 135S,A00,494369,Braswell; Geoffrey E.,0,0,0,0
1713504893064,CAT 124RS,A01,519847,Geibel; William,6,0,20,14
1713504894089,CAT 125RS,A01,515971,Geibel; William,6,0,20,14
1713504895120,CLRE 250,A00,511389,Morris; Sheldon,9996,0,9999,3
1713504896149,CLRE 251,A00,507176,Mehta; Ravindra L.,9996,0,9999,3
1713504896149,CLRE 251,B00,511410,Mehta; Ravindra L.,9998,0,9999,1
1713504897181,CLRE 252,A00,507189,Cuomo; Raphael Eduardo,9998,0,9999,1
1713504898211,CLRE 253,A00,507199,Vaida; Florin,9997,0,9999,2
1713504898211,CLRE 253,B00,507202,Vaida; Florin,9999,0,9999,0
1713504899237,CLRE 259,A00,507211,Patel; Hemal,9996,0,9999,3
1713504900263,CLRE 260,A00,507221,Cuomo; Raphael Eduardo,9999,0,9999,0
1713504901291,CLRE 297,001,507242,Cuomo; Raphael Eduardo,9999,0,9999,0
1713504902316,CSE 191,A00,516875,Minnes Kemp; Mor Mia,9999,0,9999,0
1713504903343,CSS 201S,A01,494383,Staff,35,0,35,0
1713504904369,CSS 202S,A01,494387,Staff,35,0,35,0
1713504905397,EAP 100,A00,516065,Staff,9792,0,9999,207
1713504906423,ECE 45,A01,507414,Staff,37,0,60,23
1713504907450,ECE 100,A01,507416,Baghdadchi; Saharnaz,0,0,20,20
1713504907450,ECE 100,A02,507418,Baghdadchi; Saharnaz,19,0,20,1
1713504908478,ECE 111,A01,507420,Staff,27,0,50,23
1713504909502,ECE 197,001,548057,Sievenpiper; Daniel F.,9998,0,9999,1
1713504910549,EDS 115,A00,507243,Choi; Bailey Miyeon,27,0,28,1
1713504911579,EDS 117,A01,494379,Staff,15,0,25,10
1713504912608,EDS 125,A00,507246,Hopkins; Megan Beth,27,0,30,3
1713504913634,EDS 128A,A01,507264,Fargason; Sharon Gayle,26,0,26,0
1713504914664,EDS 128B,A01,507293,Pappas; Elizabeth,30,0,30,0
1713504915690,EDS 139,A00,507294,Fargason; Sharon Gayle,30,0,30,0
1713504915690,EDS 139,B00,507313,Pappas; Elizabeth,30,0,30,0
1713504916715,EDS 201,A00,507315,Staff,18,0,30,12
1713504917740,EDS 203,A01,507317,Halter; Christopher P.,17,0,30,13
1713504918766,EDS 204R,A01,507319,Halter; Christopher P.,0,1,30,30
1713504918766,EDS 204R,B01,507331,Heinzman; Erica M.,22,0,30,8
1713504919790,EDS 206R,A00,507332,Staff,0,2,30,30
1713504919790,EDS 206R,B00,507343,Staff,23,0,30,7
1713504920818,EDS 250,A00,507344,Hemans; Patricia Ann Benitez,27,0,40,13
1713504921846,EDS 281,A00,507345,Daly; Alan J.,18,0,18,0
1713504922873,EDS 284,A00,507350,Daly; Alan J.,16,0,16,0
1713504923899,EDS 286,A00,507359,Fine; Sarah,18,0,18,0
1713504924924,EDS 289C,A01,507361,Daly; Alan J.,18,0,18,0
1713504925951,EDS 290,A00,507366,Hofstetter; Carolyn,15,0,15,0
1713504926975,LIGM 5A,A00,507421,Fischer-Grunski; Eva K,20,0,20,0
1713504928000,LIGM 5B,A00,507423,Fischer-Grunski; Eva K,20,0,20,0
1713504929025,LIGM 5C,A00,507425,Fischer-Grunski; Eva K,20,0,20,0
1713504930050,LIIT 5AS,A00,507427,Carnelos; Chiara,20,0,20,0
1713504931076,LIIT 5BS,A00,507430,Carnelos; Chiara,20,0,20,0
1713504932105,LIIT 5CS,A00,507432,Carnelos; Chiara,20,0,20,0
1713504933131,LISP 5A,A00,507541,Munoz Sanchez; Alicia,14,0,20,6
1713504934162,LISP 5B,A00,507671,Munoz Sanchez; Alicia,12,0,20,8
1713504935187,LISP 5C,A00,507696,Munoz Sanchez; Alicia,11,0,20,9
1713504936213,MAE 197,001,528363,Boechler; Nicholas Sebastia,9998,0,9999,1
1713504937241,MATH 197,001,523477,Kedlaya; Kiran S.,9999,0,9999,0
1713504937241,MATH 197,002,563811,Zhang; Danna,9998,0,9999,1
1713504938265,MCWP 40R,A00,518780,Staff,13,0,20,7
1713504938265,MCWP 40R,B00,518781,Staff,11,0,20,9
1713504938265,MCWP 40R,C00,518783,Staff,8,0,20,12
1713504939297,MCWP 50R,A00,518791,Staff,7,0,20,13
1713504939297,MCWP 50R,B00,518792,Staff,3,0,20,17
1713504939297,MCWP 50R,C00,518793,Staff,5,0,20,15
1713504939297,MCWP 50R,D00,518794,Staff,0,0,20,20
1713504939297,MCWP 50R,E00,518795,Staff,0,0,20,20
1713504939297,MCWP 50R,F00,518796,Staff,11,0,20,9
1713504939297,MCWP 50R,G00,518797,Staff,10,0,20,10
1713504940323,MMW 12R,A01,514034,Herbst; Matthew,1,0,16,15
1713504940323,MMW 12R,A02,514035,Herbst; Matthew,13,0,16,3
1713504941348,MMW 13R,A01,514037,Staff,0,8,16,16
1713504941348,MMW 13R,A02,514039,Staff,0,7,16,16
1713504943401,SIO 295LS,A00,523233,Staff,15,0,30,15
1713504944427,SIO 295S,A00,523232,Staff,15,0,30,15
1713504945455,SOCI 117,A01,494376,Staff,0,2,5,5
1713504946483,WES 237B,A00,494380,Staff,19,0,20,1
1713504948551,AESE 279B,A00,494370,Wade; Jon P,33,0,33,0
1713504949628,AIP 197,001,627712,Vespa; Emanuel Ignacio,9999,0,9999,0
1713504950656,ANAR 135S,A00,494369,Braswell; Geoffrey E.,0,0,0,0
1713504951682,CAT 124RS,A01,519847,Geibel; William,6,0,20,14
1713504952711,CAT 125RS,A01,515971,Geibel; William,6,0,20,14
1713504953735,CLRE 250,A00,511389,Morris; Sheldon,9996,0,9999,3
1713504954765,CLRE 251,A00,507176,Mehta; Ravindra L.,9996,0,9999,3
1713504954765,CLRE 251,B00,511410,Mehta; Ravindra L.,9998,0,9999,1
1713504955795,CLRE 252,A00,507189,Cuomo; Raphael Eduardo,9998,0,9999,1
1713504956823,CLRE 253,A00,507199,Vaida; Florin,9997,0,9999,2
1713504956823,CLRE 253,B00,507202,Vaida; Florin,9999,0,9999,0
1713504957852,CLRE 259,A00,507211,Patel; Hemal,9996,0,9999,3
1713504958881,CLRE 260,A00,507221,Cuomo; Raphael Eduardo,9999,0,9999,0
1713504959909,CLRE 297,001,507242,Cuomo; Raphael Eduardo,9999,0,9999,0
1713504960935,CSE 191,A00,516875,Minnes Kemp; Mor Mia,9999,0,9999,0
1713504961961,CSS 201S,A01,494383,Staff,35,0,35,0
1713504962991,CSS 202S,A01,494387,Staff,35,0,35,0
1713504964017,EAP 100,A00,516065,Staff,9792,0,9999,207
1713504965043,ECE 45,A01,507414,Staff,37,0,60,23
1713504966069,ECE 100,A01,507416,Baghdadchi; Saharnaz,0,0,20,20
1713504966069,ECE 100,A02,507418,Baghdadchi; Saharnaz,19,0,20,1
1713504967094,ECE 111,A01,507420,Staff,27,0,50,23
1713504968121,ECE 197,001,548057,Sievenpiper; Daniel F.,9998,0,9999,1
1713504969150,EDS 115,A00,507243,Choi; Bailey Miyeon,27,0,28,1
1713504970174,EDS 117,A01,494379,Staff,15,0,25,10
1713504971202,EDS 125,A00,507246,Hopkins; Megan Beth,27,0,30,3
1713504972228,EDS 128A,A01,507264,Fargason; Sharon Gayle,26,0,26,0
1713504973254,EDS 128B,A01,507293,Pappas; Elizabeth,30,0,30,0
1713504974280,EDS 139,A00,507294,Fargason; Sharon Gayle,30,0,30,0
1713504974280,EDS 139,B00,507313,Pappas; Elizabeth,30,0,30,0
1713504975304,EDS 201,A00,507315,Staff,18,0,30,12
1713504976328,EDS 203,A01,507317,Halter; Christopher P.,17,0,30,13
1713504977357,EDS 204R,A01,507319,Halter; Christopher P.,0,1,30,30
1713504977357,EDS 204R,B01,507331,Heinzman; Erica M.,22,0,30,8
1713504978383,EDS 206R,A00,507332,Staff,0,2,30,30
1713504978383,EDS 206R,B00,507343,Staff,23,0,30,7
1713504979411,EDS 250,A00,507344,Hemans; Patricia Ann Benitez,27,0,40,13
1713504980441,EDS 281,A00,507345,Daly; Alan J.,18,0,18,0
1713504981467,EDS 284,A00,507350,Daly; Alan J.,16,0,16,0
1713504982493,EDS 286,A00,507359,Fine; Sarah,18,0,18,0
1713504983518,EDS 289C,A01,507361,Daly; Alan J.,18,0,18,0
1713504984546,EDS 290,A00,507366,Hofstetter; Carolyn,15,0,15,0
1713504985577,LIGM 5A,A00,507421,Fischer-Grunski; Eva K,20,0,20,0
1713504986606,LIGM 5B,A00,507423,Fischer-Grunski; Eva K,20,0,20,0
1713504987631,LIGM 5C,A00,507425,Fischer-Grunski; Eva K,20,0,20,0
1713504988660,LIIT 5AS,A00,507427,Carnelos; Chiara,20,0,20,0
1713504989686,LIIT 5BS,A00,507430,Carnelos; Chiara,20,0,20,0
1713504990710,LIIT 5CS,A00,507432,Carnelos; Chiara,20,0,20,0
1713504991736,LISP 5A,A00,507541,Munoz Sanchez; Alicia,14,0,20,6
1713504992761,LISP 5B,A00,507671,Munoz Sanchez; Alicia,12,0,20,8
1713504993793,LISP 5C,A00,507696,Munoz Sanchez; Alicia,11,0,20,9
1713504994822,MAE 197,001,528363,Boechler; Nicholas Sebastia,9998,0,9999,1
1713504995848,MATH 197,001,523477,Kedlaya; Kiran S.,9999,0,9999,0
1713504995848,MATH 197,002,563811,Zhang; Danna,9998,0,9999,1
1713504996877,MCWP 40R,A00,518780,Staff,13,0,20,7
1713504996877,MCWP 40R,B00,518781,Staff,11,0,20,9
1713504996877,MCWP 40R,C00,518783,Staff,8,0,20,12
1713504997904,MCWP 50R,A00,518791,Staff,7,0,20,13
1713504997904,MCWP 50R,B00,518792,Staff,3,0,20,17
1713504997904,MCWP 50R,C00,518793,Staff,5,0,20,15
1713504997904,MCWP 50R,D00,518794,Staff,0,0,20,20
1713504997904,MCWP 50R,E00,518795,Staff,0,0,20,20
1713504997904,MCWP 50R,F00,518796,Staff,11,0,20,9
1713504997904,MCWP 50R,G00,518797,Staff,10,0,20,10
1713504998932,MMW 12R,A01,514034,Herbst; Matthew,1,0,16,15
1713504998932,MMW 12R,A02,514035,Herbst; Matthew,13,0,16,3
1713504999957,MMW 13R,A01,514037,Staff,0,8,16,16
1713504999957,MMW 13R,A02,514039,Staff,0,7,16,16
1713505002009,SIO 295LS,A00,523233,Staff,15,0,30,15
1713505003035,SIO 295S,A00,523232,Staff,15,0,30,15
1713505004060,SOCI 117,A01,494376,Staff,0,2,5,5
1713505005088,WES 237B,A00,494380,Staff,19,0,20,1
1713505007158,AESE 279B,A00,494370,Wade; Jon P,33,0,33,0
1713505008183,AIP 197,001,627712,Vespa; Emanuel Ignacio,9999,0,9999,0
1713505009211,ANAR 135S,A00,494369,Braswell; Geoffrey E.,0,0,0,0
1713505010236,CAT 124RS,A01,519847,Geibel; William,6,0,20,14
1713505011261,CAT 125RS,A01,515971,Geibel; William,6,0,20,14
1713505012289,CLRE 250,A00,511389,Morris; Sheldon,9996,0,9999,3
1713505013316,CLRE 251,A00,507176,Mehta; Ravindra L.,9996,0,9999,3
1713505013316,CLRE 251,B00,511410,Mehta; Ravindra L.,9998,0,9999,1
1713505014346,CLRE 252,A00,507189,Cuomo; Raphael Eduardo,9998,0,9999,1
1713505015376,CLRE 253,A00,507199,Vaida; Florin,9997,0,9999,2
1713505015376,CLRE 253,B00,507202,Vaida; Florin,9999,0,9999,0
1713505016401,CLRE 259,A00,507211,Patel; Hemal,9996,0,9999,3
1713505017426,CLRE 260,A00,507221,Cuomo; Raphael Eduardo,9999,0,9999,0
1713505018449,CLRE 297,001,507242,Cuomo; Raphael Eduardo,9999,0,9999,0
1713505019474,CSE 191,A00,516875,Minnes Kemp; Mor Mia,9999,0,9999,0
1713505020501,CSS 201S,A01,494383,Staff,35,0,35,0
1713505021530,CSS 202S,A01,494387,Staff,35,0,35,0
1713505022559,EAP 100,A00,516065,Staff,9792,0,9999,207
1713505023591,ECE 45,A01,507414,Staff,37,0,60,23
1713505024617,ECE 100,A01,507416,Baghdadchi; Saharnaz,0,0,20,20
1713505024617,ECE 100,A02,507418,Baghdadchi; Saharnaz,19,0,20,1
1713505025643,ECE 111,A01,507420,Staff,27,0,50,23
1713505026669,ECE 197,001,548057,Sievenpiper; Daniel F.,9998,0,9999,1
1713505027695,EDS 115,A00,507243,Choi; Bailey Miyeon,27,0,28,1
1713505028722,EDS 117,A01,494379,Staff,15,0,25,10
1713505029751,EDS 125,A00,507246,Hopkins; Megan Beth,27,0,30,3
1713505030776,EDS 128A,A01,507264,Fargason; Sharon Gayle,26,0,26,0
1713505031802,EDS 128B,A01,507293,Pappas; Elizabeth,30,0,30,0
1713505032826,EDS 139,A00,507294,Fargason; Sharon Gayle,30,0,30,0
1713505032826,EDS 139,B00,507313,Pappas; Elizabeth,30,0,30,0
1713505033851,EDS 201,A00,507315,Staff,18,0,30,12
1713505034875,EDS 203,A01,507317,Halter; Christopher P.,17,0,30,13
1713505035903,EDS 204R,A01,507319,Halter; Christopher P.,0,1,30,30
1713505035903,EDS 204R,B01,507331,Heinzman; Erica M.,22,0,30,8
1713505036929,EDS 206R,A00,507332,Staff,0,2,30,30
1713505036929,EDS 206R,B00,507343,Staff,23,0,30,7
1713505037952,EDS 250,A00,507344,Hemans; Patricia Ann Benitez,27,0,40,13
1713505038981,EDS 281,A00,507345,Daly; Alan J.,18,0,18,0
1713505040005,EDS 284,A00,507350,Daly; Alan J.,16,0,16,0
1713505041031,EDS 286,A00,507359,Fine; Sarah,18,0,18,0
1713505042059,EDS 289C,A01,507361,Daly; Alan J.,18,0,18,0
1713505043083,EDS 290,A00,507366,Hofstetter; Carolyn,15,0,15,0
1713505044108,LIGM 5A,A00,507421,Fischer-Grunski; Eva K,20,0,20,0
1713505045138,LIGM 5B,A00,507423,Fischer-Grunski; Eva K,20,0,20,0
1713505046162,LIGM 5C,A00,507425,Fischer-Grunski; Eva K,20,0,20,0
1713505047187,LIIT 5AS,A00,507427,Carnelos; Chiara,20,0,20,0
1713505048212,LIIT 5BS,A00,507430,Carnelos; Chiara,20,0,20,0
1713505049237,LIIT 5CS,A00,507432,Carnelos; Chiara,20,0,20,0
1713505050263,LISP 5A,A00,507541,Munoz Sanchez; Alicia,14,0,20,6
1713505051288,LISP 5B,A00,507671,Munoz Sanchez; Alicia,12,0,20,8
1713505052315,LISP 5C,A00,507696,Munoz Sanchez; Alicia,11,0,20,9
1713505053397,MAE 197,001,528363,Boechler; Nicholas Sebastia,9998,0,9999,1
1713505054427,MATH 197,001,523477,Kedlaya; Kiran S.,9999,0,9999,0
1713505054427,MATH 197,002,563811,Zhang; Danna,9998,0,9999,1
1713505055453,MCWP 40R,A00,518780,Staff,13,0,20,7
1713505055453,MCWP 40R,B00,518781,Staff,11,0,20,9
1713505055453,MCWP 40R,C00,518783,Staff,8,0,20,12
1713505056478,MCWP 50R,A00,518791,Staff,7,0,20,13
1713505056478,MCWP 50R,B00,518792,Staff,3,0,20,17
1713505056478,MCWP 50R,C00,518793,Staff,5,0,20,15
1713505056478,MCWP 50R,D00,518794,Staff,0,0,20,20
1713505056478,MCWP 50R,E00,518795,Staff,0,0,20,20
1713505056478,MCWP 50R,F00,518796,Staff,11,0,20,9
1713505056478,MCWP 50R,G00,518797,Staff,10,0,20,10
1713505057502,MMW 12R,A01,514034,Herbst; Matthew,1,0,16,15
1713505057502,MMW 12R,A02,514035,Herbst; Matthew,13,0,16,3
1713505058527,MMW 13R,A01,514037,Staff,0,8,16,16
1713505058527,MMW 13R,A02,514039,Staff,0,7,16,16
1713505060583,SIO 295LS,A00,523233,Staff,15,0,30,15
1713505061608,SIO 295S,A00,523232,Staff,15,0,30,15
1713505062637,SOCI 117,A01,494376,Staff,0,2,5,5
1713505063662,WES 237B,A00,494380,Staff,19,0,20,1
1713505065727,AESE 279B,A00,494370,Wade; Jon P,33,0,33,0
1713505066753,AIP 197,001,627712,Vespa; Emanuel Ignacio,9999,0,9999,0
1713505067781,ANAR 135S,A00,494369,Braswell; Geoffrey E.,0,0,0,0
1713505068808,CAT 124RS,A01,519847,Geibel; William,6,0,20,14
1713505069833,CAT 125RS,A01,515971,Geibel; William,6,0,20,14
1713505070862,CLRE 250,A00,511389,Morris; Sheldon,9996,0,9999,3
1713505071892,CLRE 251,A00,507176,Mehta; Ravindra L.,9996,0,9999,3
1713505071892,CLRE 251,B00,511410,Mehta; Ravindra L.,9998,0,9999,1
1713505072918,CLRE 252,A00,507189,Cuomo; Raphael Eduardo,9998,0,9999,1
1713505073943,CLRE 253,A00,507199,Vaida; Florin,9997,0,9999,2
1713505073943,CLRE 253,B00,507202,Vaida; Florin,9999,0,9999,0
1713505074972,CLRE 259,A00,507211,Patel; Hemal,9996,0,9999,3
1713505076001,CLRE 260,A00,507221,Cuomo; Raphael Eduardo,9999,0,9999,0
1713505077026,CLRE 297,001,507242,Cuomo; Raphael Eduardo,9999,0,9999,0
1713505078052,CSE 191,A00,516875,Minnes Kemp; Mor Mia,9999,0,9999,0
1713505079082,CSS 201S,A01,494383,Staff,35,0,35,0
1713505080108,CSS 202S,A01,494387,Staff,35,0,35,0
1713505081137,EAP 100,A00,516065,Staff,9792,0,9999,207
1713505082166,ECE 45,A01,507414,Staff,37,0,60,23
1713505083198,ECE 100,A01,507416,Baghdadchi; Saharnaz,0,0,20,20
1713505083198,ECE 100,A02,507418,Baghdadchi; Saharnaz,19,0,20,1
1713505084224,ECE 111,A01,507420,Staff,27,0,50,23
1713505085249,ECE 197,001,548057,Sievenpiper; Daniel F.,9998,0,9999,1
1713505086280,EDS 115,A00,507243,Choi; Bailey Miyeon,27,0,28,1
1713505087307,EDS 117,A01,494379,Staff,15,0,25,10
1713505088332,EDS 125,A00,507246,Hopkins; Megan Beth,27,0,30,3
1713505089362,EDS 128A,A01,507264,Fargason; Sharon Gayle,26,0,26,0
1713505090391,EDS 128B,A01,507293,Pappas; Elizabeth,30,0,30,0
1713505091417,EDS 139,A00,507294,Fargason; Sharon Gayle,30,0,30,0
1713505091417,EDS 139,B00,507313,Pappas; Elizabeth,30,0,30,0
1713505092447,EDS 201,A00,507315,Staff,18,0,30,12
1713505093476,EDS 203,A01,507317,Halter; Christopher P.,17,0,30,13
1713505094503,EDS 204R,A01,507319,Halter; Christopher P.,0,1,30,30
1713505094503,EDS 204R,B01,507331,Heinzman; Erica M.,22,0,30,8
1713505095532,EDS 206R,A00,507332,Staff,0,2,30,30
1713505095532,EDS 206R,B00,507343,Staff,23,0,30,7
1713505096561,EDS 250,A00,507344,Hemans; Patricia Ann Benitez,27,0,40,13
1713505097587,EDS 281,A00,507345,Daly; Alan J.,18,0,18,0
1713505098616,EDS 284,A00,507350,Daly; Alan J.,16,0,16,0
1713505099640,EDS 286,A00,507359,Fine; Sarah,18,0,18,0
1713505100667,EDS 289C,A01,507361,Daly; Alan J.,18,0,18,0
1713505101693,EDS 290,A00,507366,Hofstetter; Carolyn,15,0,15,0
1713505102723,LIGM 5A,A00,507421,Fischer-Grunski; Eva K,20,0,20,0
1713505103749,LIGM 5B,A00,507423,Fischer-Grunski; Eva K,20,0,20,0
1713505104780,LIGM 5C,A00,507425,Fischer-Grunski; Eva K,20,0,20,0
1713505105806,LIIT 5AS,A00,507427,Carnelos; Chiara,20,0,20,0
1713505106831,LIIT 5BS,A00,507430,Carnelos; Chiara,20,0,20,0
1713505107860,LIIT 5CS,A00,507432,Carnelos; Chiara,20,0,20,0
1713505108889,LISP 5A,A00,507541,Munoz Sanchez; Alicia,14,0,20,6
1713505109917,LISP 5B,A00,507671,Munoz Sanchez; Alicia,12,0,20,8
1713505110947,LISP 5C,A00,507696,Munoz Sanchez; Alicia,11,0,20,9
1713505111973,MAE 197,001,528363,Boechler; Nicholas Sebastia,9998,0,9999,1
1713505112999,MATH 197,001,523477,Kedlaya; Kiran S.,9999,0,9999,0
1713505112999,MATH 197,002,563811,Zhang; Danna,9998,0,9999,1
1713505114024,MCWP 40R,A00,518780,Staff,13,0,20,7
1713505114024,MCWP 40R,B00,518781,Staff,11,0,20,9
1713505114024,MCWP 40R,C00,518783,Staff,8,0,20,12
1713505115054,MCWP 50R,A00,518791,Staff,7,0,20,13
1713505115054,MCWP 50R,B00,518792,Staff,3,0,20,17
1713505115054,MCWP 50R,C00,518793,Staff,5,0,20,15
1713505115054,MCWP 50R,D00,518794,Staff,0,0,20,20
1713505115054,MCWP 50R,E00,518795,Staff,0,0,20,20
1713505115054,MCWP 50R,F00,518796,Staff,11,0,20,9
1713505115054,MCWP 50R,G00,518797,Staff,10,0,20,10
1713505116080,MMW 12R,A01,514034,Herbst; Matthew,1,0,16,15
1713505116080,MMW 12R,A02,514035,Herbst; Matthew,13,0,16,3
1713505117110,MMW 13R,A01,514037,Staff,0,8,16,16
1713505117110,MMW 13R,A02,514039,Staff,0,7,16,16
1713505119163,SIO 295LS,A00,523233,Staff,15,0,30,15
1713505120189,SIO 295S,A00,523232,Staff,15,0,30,15
1713505121214,SOCI 117,A01,494376,Staff,0,2,5,5
1713505122241,WES 237B,A00,494380,Staff,19,0,20,1
1713505124310,AESE 279B,A00,494370,Wade; Jon P,33,0,33,0
1713505125335,AIP 197,001,627712,Vespa; Emanuel Ignacio,9999,0,9999,0
1713505126360,ANAR 135S,A00,494369,Braswell; Geoffrey E.,0,0,0,0
1713505127390,CAT 124RS,A01,519847,Geibel; William,6,0,20,14
1713505128417,CAT 125RS,A01,515971,Geibel; William,6,0,20,14
1713505129446,CLRE 250,A00,511389,Morris; Sheldon,9996,0,9999,3
1713505130474,CLRE 251,A00,507176,Mehta; Ravindra L.,9996,0,9999,3
1713505130474,CLRE 251,B00,511410,Mehta; Ravindra L.,9998,0,9999,1
1713505131503,CLRE 252,A00,507189,Cuomo; Raphael Eduardo,9998,0,9999,1
1713505132529,CLRE 253,A00,507199,Vaida; Florin,9997,0,9999,2
1713505132529,CLRE 253,B00,507202,Vaida; Florin,9999,0,9999,0
1713505133556,CLRE 259,A00,507211,Patel; Hemal,9996,0,9999,3
1713505134584,CLRE 260,A00,507221,Cuomo; Raphael Eduardo,9999,0,9999,0
1713505135666,CLRE 297,001,507242,Cuomo; Raphael Eduardo,9999,0,9999,0
1713505136692,CSE 191,A00,516875,Minnes Kemp; Mor Mia,9999,0,9999,0
1713505137721,CSS 201S,A01,494383,Staff,35,0,35,0
1713505138745,CSS 202S,A01,494387,Staff,35,0,35,0
1713505139770,EAP 100,A00,516065,Staff,9792,0,9999,207
1713505140801,ECE 45,A01,507414,Staff,37,0,60,23
1713505141827,ECE 100,A01,507416,Baghdadchi; Saharnaz,0,0,20,20
1713505141827,ECE 100,A02,507418,Baghdadchi; Saharnaz,19,0,20,1
1713505142853,ECE 111,A01,507420,Staff,27,0,50,23
1713505143879,ECE 197,001,548057,Sievenpiper; Daniel F.,9998,0,9999,1
1713505144908,EDS 115,A00,507243,Choi; Bailey Miyeon,27,0,28,1
1713505145934,EDS 117,A01,494379,Staff,15,0,25,10
1713505146960,EDS 125,A00,507246,Hopkins; Megan Beth,27,0,30,3
1713505147988,EDS 128A,A01,507264,Fargason; Sharon Gayle,26,0,26,0
1713505149013,EDS 128B,A01,507293,Pappas; Elizabeth,30,0,30,0
1713505150042,EDS 139,A00,507294,Fargason; Sharon Gayle,30,0,30,0
1713505150042,EDS 139,B00,507313,Pappas; Elizabeth,30,0,30,0
1713505151070,EDS 201,A00,507315,Staff,18,0,30,12
1713505152096,EDS 203,A01,507317,Halter; Christopher P.,17,0,30,13
1713505153123,EDS 204R,A01,507319,Halter; Christopher P.,0,1,30,30
1713505153123,EDS 204R,B01,507331,Heinzman; Erica M.,22,0,30,8
1713505154155,EDS 206R,A00,507332,Staff,0,2,30,30
1713505154155,EDS 206R,B00,507343,Staff,23,0,30,7
1713505155185,EDS 250,A00,507344,Hemans; Patricia Ann Benitez,27,0,40,13
1713505156211,EDS 281,A00,507345,Daly; Alan J.,18,0,18,0
1713505157292,EDS 284,A00,507350,Daly; Alan J.,16,0,16,0
1713505158320,EDS 286,A00,507359,Fine; Sarah,18,0,18,0
1713505159345,EDS 289C,A01,507361,Daly; Alan J.,18,0,18,0
1713505160373,EDS 290,A00,507366,Hofstetter; Carolyn,15,0,15,0
1713505161399,LIGM 5A,A00,507421,Fischer-Grunski; Eva K,20,0,20,0
1713505162428,LIGM 5B,A00,507423,Fischer-Grunski; Eva K,20,0,20,0
1713505163454,LIGM 5C,A00,507425,Fischer-Grunski; Eva K,20,0,20,0
1713505164480,LIIT 5AS,A00,507427,Carnelos; Chiara,20,0,20,0
1713505165506,LIIT 5BS,A00,507430,Carnelos; Chiara,20,0,20,0
1713505166535,LIIT 5CS,A00,507432,Carnelos; Chiara,20,0,20,0
1713505167560,LISP 5A,A00,507541,Munoz Sanchez; Alicia,14,0,20,6
1713505168590,LISP 5B,A00,507671,Munoz Sanchez; Alicia,12,0,20,8
1713505169616,LISP 5C,A00,507696,Munoz Sanchez; Alicia,11,0,20,9
1713505170642,MAE 197,001,528363,Boechler; Nicholas Sebastia,9998,0,9999,1
1713505171670,MATH 197,001,523477,Kedlaya; Kiran S.,9999,0,9999,0
1713505171670,MATH 197,002,563811,Zhang; Danna,9998,0,9999,1
1713505172695,MCWP 40R,A00,518780,Staff,13,0,20,7
1713505172695,MCWP 40R,B00,518781,Staff,11,0,20,9
1713505172695,MCWP 40R,C00,518783,Staff,8,0,20,12
1713505173724,MCWP 50R,A00,518791,Staff,7,0,20,13
1713505173724,MCWP 50R,B00,518792,Staff,3,0,20,17
1713505173724,MCWP 50R,C00,518793,Staff,5,0,20,15
1713505173724,MCWP 50R,D00,518794,Staff,0,0,20,20
1713505173724,MCWP 50R,E00,518795,Staff,0,0,20,20
1713505173724,MCWP 50R,F00,518796,Staff,11,0,20,9
1713505173724,MCWP 50R,G00,518797,Staff,10,0,20,10
1713505174752,MMW 12R,A01,514034,Herbst; Matthew,1,0,16,15
1713505174752,MMW 12R,A02,514035,Herbst; Matthew,13,0,16,3
1713505175776,MMW 13R,A01,514037,Staff,0,8,16,16
1713505175776,MMW 13R,A02,514039,Staff,0,7,16,16
1713505177831,SIO 295LS,A00,523233,Staff,15,0,30,15
1713505178856,SIO 295S,A00,523232,Staff,15,0,30,15
1713505179882,SOCI 117,A01,494376,Staff,0,2,5,5
1713505180911,WES 237B,A00,494380,Staff,19,0,20,1
1713505182982,AESE 279B,A00,494370,Wade; Jon P,33,0,33,0
1713505184007,AIP 197,001,627712,Vespa; Emanuel Ignacio,9999,0,9999,0
1713505185035,ANAR 135S,A00,494369,Braswell; Geoffrey E.,0,0,0,0
1713505186061,CAT 124RS,A01,519847,Geibel; William,6,0,20,14
1713505187089,CAT 125RS,A01,515971,Geibel; William,6,0,20,14
1713505188114,CLRE 250,A00,511389,Morris; Sheldon,9996,0,9999,3
1713505189141,CLRE 251,A00,507176,Mehta; Ravindra L.,9996,0,9999,3
1713505189141,CLRE 251,B00,511410,Mehta; Ravindra L.,9998,0,9999,1
1713505190171,CLRE 252,A00,507189,Cuomo; Raphael Eduardo,9998,0,9999,1
1713505191196,CLRE 253,A00,507199,Vaida; Florin,9997,0,9999,2
1713505191196,CLRE 253,B00,507202,Vaida; Florin,9999,0,9999,0
1713505192224,CLRE 259,A00,507211,Patel; Hemal,9996,0,9999,3
1713505193251,CLRE 260,A00,507221,Cuomo; Raphael Eduardo,9999,0,9999,0
1713505194278,CLRE 297,001,507242,Cuomo; Raphael Eduardo,9999,0,9999,0
1713505195303,CSE 191,A00,516875,Minnes Kemp; Mor Mia,9999,0,9999,0
1713505196330,CSS 201S,A01,494383,Staff,35,0,35,0
1713505197356,CSS 202S,A01,494387,Staff,35,0,35,0
1713505198382,EAP 100,A00,516065,Staff,9792,0,9999,207
1713505199408,ECE 45,A01,507414,Staff,37,0,60,23
1713505200437,ECE 100,A01,507416,Baghdadchi; Saharnaz,0,0,20,20
1713505200437,ECE 100,A02,507418,Baghdadchi; Saharnaz,19,0,20,1
1713505201462,ECE 111,A01,507420,Staff,27,0,50,23
1713505202487,ECE 197,001,548057,Sievenpiper; Daniel F.,9998,0,9999,1
1713505203513,EDS 115,A00,507243,Choi; Bailey Miyeon,27,0,28,1
1713505204541,EDS 117,A01,494379,Staff,15,0,25,10
1713505205565,EDS 125,A00,507246,Hopkins; Megan Beth,27,0,30,3
1713505206591,EDS 128A,A01,507264,Fargason; Sharon Gayle,26,0,26,0
1713505207618,EDS 128B,A01,507293,Pappas; Elizabeth,30,0,30,0
1713505208643,EDS 139,A00,507294,Fargason; Sharon Gayle,30,0,30,0
1713505208643,EDS 139,B00,507313,Pappas; Elizabeth,30,0,30,0
1713505209671,EDS 201,A00,507315,Staff,18,0,30,12
1713505210699,EDS 203,A01,507317,Halter; Christopher P.,17,0,30,13
1713505211726,EDS 204R,A01,507319,Halter; Christopher P.,0,1,30,30
1713505211726,EDS 204R,B01,507331,Heinzman; Erica M.,22,0,30,8
1713505212751,EDS 206R,A00,507332,Staff,0,2,30,30
1713505212751,EDS 206R,B00,507343,Staff,23,0,30,7
1713505213779,EDS 250,A00,507344,Hemans; Patricia Ann Benitez,27,0,40,13
1713505214804,EDS 281,A00,507345,Daly; Alan J.,18,0,18,0
1713505215828,EDS 284,A00,507350,Daly; Alan J.,16,0,16,0
1713505216852,EDS 286,A00,507359,Fine; Sarah,18,0,18,0
1713505217880,EDS 289C,A01,507361,Daly; Alan J.,18,0,18,0
1713505218905,EDS 290,A00,507366,Hofstetter; Carolyn,15,0,15,0
1713505219931,LIGM 5A,A00,507421,Fischer-Grunski; Eva K,20,0,20,0
1713505220960,LIGM 5B,A00,507423,Fischer-Grunski; Eva K,20,0,20,0
1713505221985,LIGM 5C,A00,507425,Fischer-Grunski; Eva K,20,0,20,0
1713505223013,LIIT 5AS,A00,507427,Carnelos; Chiara,20,0,20,0
1713505224043,LIIT 5BS,A00,507430,Carnelos; Chiara,20,0,20,0
1713505225068,LIIT 5CS,A00,507432,Carnelos; Chiara,20,0,20,0
1713505226093,LISP 5A,A00,507541,Munoz Sanchez; Alicia,14,0,20,6
1713505227121,LISP 5B,A00,507671,Munoz Sanchez; Alicia,12,0,20,8
1713505228147,LISP 5C,A00,507696,Munoz Sanchez; Alicia,11,0,20,9
1713505229172,MAE 197,001,528363,Boechler; Nicholas Sebastia,9998,0,9999,1
1713505230198,MATH 197,001,523477,Kedlaya; Kiran S.,9999,0,9999,0
1713505230198,MATH 197,002,563811,Zhang; Danna,9998,0,9999,1
1713505231223,MCWP 40R,A00,518780,Staff,13,0,20,7
1713505231223,MCWP 40R,B00,518781,Staff,11,0,20,9
1713505231223,MCWP 40R,C00,518783,Staff,8,0,20,12
1713505232252,MCWP 50R,A00,518791,Staff,7,0,20,13
1713505232252,MCWP 50R,B00,518792,Staff,3,0,20,17
1713505232252,MCWP 50R,C00,518793,Staff,5,0,20,15
1713505232252,MCWP 50R,D00,518794,Staff,0,0,20,20
1713505232252,MCWP 50R,E00,518795,Staff,0,0,20,20
1713505232252,MCWP 50R,F00,518796,Staff,11,0,20,9
1713505232252,MCWP 50R,G00,518797,Staff,10,0,20,10
1713505233280,MMW 12R,A01,514034,Herbst; Matthew,1,0,16,15
1713505233280,MMW 12R,A02,514035,Herbst; Matthew,13,0,16,3
1713505234309,MMW 13R,A01,514037,Staff,0,8,16,16
1713505234309,MMW 13R,A02,514039,Staff,0,7,16,16
1713505236363,SIO 295LS,A00,523233,Staff,15,0,30,15
1713505237387,SIO 295S,A00,523232,Staff,15,0,30,15
1713505238416,SOCI 117,A01,494376,Staff,0,2,5,5
1713505239441,WES 237B,A00,494380,Staff,19,0,20,1
1713505241735,AESE 279B,A00,494370,Wade; Jon P,33,0,33,0
1713505242763,AIP 197,001,627712,Vespa; Emanuel Ignacio,9999,0,9999,0
1713505243787,ANAR 135S,A00,494369,Braswell; Geoffrey E.,0,0,0,0
1713505244816,CAT 124RS,A01,519847,Geibel; William,6,0,20,14
1713505245844,CAT 125RS,A01,515971,Geibel; William,6,0,20,14
1713505246875,CLRE 250,A00,511389,Morris; Sheldon,9996,0,9999,3
1713505247903,CLRE 251,A00,507176,Mehta; Ravindra L.,9996,0,9999,3
1713505247903,CLRE 251,B00,511410,Mehta; Ravindra L.,9998,0,9999,1
1713505248928,CLRE 252,A00,507189,Cuomo; Raphael Eduardo,9998,0,9999,1
1713505249957,CLRE 253,A00,507199,Vaida; Florin,9997,0,9999,2
1713505249957,CLRE 253,B00,507202,Vaida; Florin,9999,0,9999,0
1713505250980,CLRE 259,A00,507211,Patel; Hemal,9996,0,9999,3
1713505252008,CLRE 260,A00,507221,Cuomo; Raphael Eduardo,9999,0,9999,0
1713505253035,CLRE 297,001,507242,Cuomo; Raphael Eduardo,9999,0,9999,0
1713505254063,CSE 191,A00,516875,Minnes Kemp; Mor Mia,9999,0,9999,0
1713505255093,CSS 201S,A01,494383,Staff,35,0,35,0
1713505256122,CSS 202S,A01,494387,Staff,35,0,35,0
1713505257147,EAP 100,A00,516065,Staff,9792,0,9999,207
1713505258178,ECE 45,A01,507414,Staff,37,0,60,23
1713505259206,ECE 100,A01,507416,Baghdadchi; Saharnaz,0,0,20,20
1713505259206,ECE 100,A02,507418,Baghdadchi; Saharnaz,19,0,20,1
1713505260231,ECE 111,A01,507420,Staff,27,0,50,23
1713505261310,ECE 197,001,548057,Sievenpiper; Daniel F.,9998,0,9999,1
1713505262335,EDS 115,A00,507243,Choi; Bailey Miyeon,27,0,28,1
1713505263361,EDS 117,A01,494379,Staff,15,0,25,10
1713505264385,EDS 125,A00,507246,Hopkins; Megan Beth,27,0,30,3
1713505265415,EDS 128A,A01,507264,Fargason; Sharon Gayle,26,0,26,0
1713505266442,EDS 128B,A01,507293,Pappas; Elizabeth,30,0,30,0
1713505267465,EDS 139,A00,507294,Fargason; Sharon Gayle,30,0,30,0
1713505267465,EDS 139,B00,507313,Pappas; Elizabeth,30,0,30,0
1713505268493,EDS 201,A00,507315,Staff,18,0,30,12
1713505269518,EDS 203,A01,507317,Halter; Christopher P.,17,0,30,13
1713505270542,EDS 204R,A01,507319,Halter; Christopher P.,0,1,30,30
1713505270542,EDS 204R,B01,507331,Heinzman; Erica M.,22,0,30,8
1713505271567,EDS 206R,A00,507332,Staff,0,2,30,30
1713505271567,EDS 206R,B00,507343,Staff,23,0,30,7
1713505272592,EDS 250,A00,507344,Hemans; Patricia Ann Benitez,27,0,40,13
1713505273617,EDS 281,A00,507345,Daly; Alan J.,18,0,18,0
1713505274642,EDS 284,A00,507350,Daly; Alan J.,16,0,16,0
1713505275668,EDS 286,A00,507359,Fine; Sarah,18,0,18,0
1713505276695,EDS 289C,A01,507361,Daly; Alan J.,18,0,18,0
1713505277719,EDS 290,A00,507366,Hofstetter; Carolyn,15,0,15,0
1713505278749,LIGM 5A,A00,507421,Fischer-Grunski; Eva K,20,0,20,0
1713505279776,LIGM 5B,A00,507423,Fischer-Grunski; Eva K,20,0,20,0
1713505280804,LIGM 5C,A00,507425,Fischer-Grunski; Eva K,20,0,20,0
1713505281830,LIIT 5AS,A00,507427,Carnelos; Chiara,20,0,20,0
1713505282855,LIIT 5BS,A00,507430,Carnelos; Chiara,20,0,20,0
1713505283881,LIIT 5CS,A00,507432,Carnelos; Chiara,20,0,20,0
1713505284912,LISP 5A,A00,507541,Munoz Sanchez; Alicia,14,0,20,6
1713505285936,LISP 5B,A00,507671,Munoz Sanchez; Alicia,12,0,20,8
1713505286965,LISP 5C,A00,507696,Munoz Sanchez; Alicia,11,0,20,9
1713505287990,MAE 197,001,528363,Boechler; Nicholas Sebastia,9998,0,9999,1
1713505289020,MATH 197,001,523477,Kedlaya; Kiran S.,9999,0,9999,0
1713505289020,MATH 197,002,563811,Zhang; Danna,9998,0,9999,1
1713505290049,MCWP 40R,A00,518780,Staff,13,0,20,7
1713505290049,MCWP 40R,B00,518781,Staff,11,0,20,9
1713505290049,MCWP 40R,C00,518783,Staff,8,0,20,12
1713505291075,MCWP 50R,A00,518791,Staff,7,0,20,13
1713505291075,MCWP 50R,B00,518792,Staff,3,0,20,17
1713505291075,MCWP 50R,C00,518793,Staff,5,0,20,15
1713505291075,MCWP 50R,D00,518794,Staff,0,0,20,20
1713505291075,MCWP 50R,E00,518795,Staff,0,0,20,20
1713505291075,MCWP 50R,F00,518796,Staff,11,0,20,9
1713505291075,MCWP 50R,G00,518797,Staff,10,0,20,10
1713505292101,MMW 12R,A01,514034,Herbst; Matthew,1,0,16,15
1713505292101,MMW 12R,A02,514035,Herbst; Matthew,13,0,16,3
1713505293126,MMW 13R,A01,514037,Staff,0,8,16,16
1713505293126,MMW 13R,A02,514039,Staff,0,7,16,16
1713505295179,SIO 295LS,A00,523233,Staff,15,0,30,15
1713505296203,SIO 295S,A00,523232,Staff,15,0,30,15
1713505297231,SOCI 117,A01,494376,Staff,0,2,5,5
1713505298256,WES 237B,A00,494380,Staff,19,0,20,1
1713505300338,AESE 279B,A00,494370,Wade; Jon P,33,0,33,0
1713505301365,AIP 197,001,627712,Vespa; Emanuel Ignacio,9999,0,9999,0
1713505302391,ANAR 135S,A00,494369,Braswell; Geoffrey E.,0,0,0,0
1713505303417,CAT 124RS,A01,519847,Geibel; William,6,0,20,14
1713505304445,CAT 125RS,A01,515971,Geibel; William,6,0,20,14
1713505305473,CLRE 250,A00,511389,Morris; Sheldon,9996,0,9999,3
1713505306499,CLRE 251,A00,507176,Mehta; Ravindra L.,9996,0,9999,3
1713505306499,CLRE 251,B00,511410,Mehta; Ravindra L.,9998,0,9999,1
1713505307528,CLRE 252,A00,507189,Cuomo; Raphael Eduardo,9998,0,9999,1
1713505308556,CLRE 253,A00,507199,Vaida; Florin,9997,0,9999,2
1713505308556,CLRE 253,B00,507202,Vaida; Florin,9999,0,9999,0
1713505309582,CLRE 259,A00,507211,Patel; Hemal,9996,0,9999,3
1713505310607,CLRE 260,A00,507221,Cuomo; Raphael Eduardo,9999,0,9999,0
1713505311635,CLRE 297,001,507242,Cuomo; Raphael Eduardo,9999,0,9999,0
1713505312660,CSE 191,A00,516875,Minnes Kemp; Mor Mia,9999,0,9999,0
1713505313687,CSS 201S,A01,494383,Staff,35,0,35,0
1713505314718,CSS 202S,A01,494387,Staff,35,0,35,0
1713505315742,EAP 100,A00,516065,Staff,9792,0,9999,207
1713505316769,ECE 45,A01,507414,Staff,37,0,60,23
1713505317795,ECE 100,A01,507416,Baghdadchi; Saharnaz,0,0,20,20
1713505317795,ECE 100,A02,507418,Baghdadchi; Saharnaz,19,0,20,1
1713505318821,ECE 111,A01,507420,Staff,27,0,50,23
1713505319849,ECE 197,001,548057,Sievenpiper; Daniel F.,9998,0,9999,1
1713505320875,EDS 115,A00,507243,Choi; Bailey Miyeon,27,0,28,1
1713505321905,EDS 117,A01,494379,Staff,15,0,25,10
1713505322931,EDS 125,A00,507246,Hopkins; Megan Beth,27,0,30,3
1713505323956,EDS 128A,A01,507264,Fargason; Sharon Gayle,26,0,26,0
1713505324981,EDS 128B,A01,507293,Pappas; Elizabeth,30,0,30,0
1713505326009,EDS 139,A00,507294,Fargason; Sharon Gayle,30,0,30,0
1713505326009,EDS 139,B00,507313,Pappas; Elizabeth,30,0,30,0
1713505327033,EDS 201,A00,507315,Staff,18,0,30,12
1713505328063,EDS 203,A01,507317,Halter; Christopher P.,17,0,30,13
1713505329091,EDS 204R,A01,507319,Halter; Christopher P.,0,1,30,30
1713505329091,EDS 204R,B01,507331,Heinzman; Erica M.,22,0,30,8
1713505330121,EDS 206R,A00,507332,Staff,0,2,30,30
1713505330121,EDS 206R,B00,507343,Staff,23,0,30,7
1713505331356,EDS 250,A00,507344,Hemans; Patricia Ann Benitez,27,0,40,13
1713505332382,EDS 281,A00,507345,Daly; Alan J.,18,0,18,0
1713505333408,EDS 284,A00,507350,Daly; Alan J.,16,0,16,0
1713505334435,EDS 286,A00,507359,Fine; Sarah,18,0,18,0
1713505335459,EDS 289C,A01,507361,Daly; Alan J.,18,0,18,0
1713505336487,EDS 290,A00,507366,Hofstetter; Carolyn,15,0,15,0
1713505337514,LIGM 5A,A00,507421,Fischer-Grunski; Eva K,20,0,20,0
1713505338541,LIGM 5B,A00,507423,Fischer-Grunski; Eva K,20,0,20,0
1713505339567,LIGM 5C,A00,507425,Fischer-Grunski; Eva K,20,0,20,0
1713505340594,LIIT 5AS,A00,507427,Carnelos; Chiara,20,0,20,0
1713505341623,LIIT 5BS,A00,507430,Carnelos; Chiara,20,0,20,0
1713505342653,LIIT 5CS,A00,507432,Carnelos; Chiara,20,0,20,0
1713505343685,LISP 5A,A00,507541,Munoz Sanchez; Alicia,14,0,20,6
1713505344714,LISP 5B,A00,507671,Munoz Sanchez; Alicia,12,0,20,8
1713505345743,LISP 5C,A00,507696,Munoz Sanchez; Alicia,11,0,20,9
1713505346771,MAE 197,001,528363,Boechler; Nicholas Sebastia,9998,0,9999,1
1713505347800,MATH 197,001,523477,Kedlaya; Kiran S.,9999,0,9999,0
1713505347800,MATH 197,002,563811,Zhang; Danna,9998,0,9999,1
1713505348825,MCWP 40R,A00,518780,Staff,13,0,20,7
1713505348825,MCWP 40R,B00,518781,Staff,11,0,20,9
1713505348825,MCWP 40R,C00,518783,Staff,8,0,20,12
1713505349851,MCWP 50R,A00,518791,Staff,7,0,20,13
1713505349851,MCWP 50R,B00,518792,Staff,3,0,20,17
1713505349851,MCWP 50R,C00,518793,Staff,5,0,20,15
1713505349851,MCWP 50R,D00,518794,Staff,0,0,20,20
1713505349851,MCWP 50R,E00,518795,Staff,0,0,20,20
1713505349851,MCWP 50R,F00,518796,Staff,11,0,20,9
1713505349851,MCWP 50R,G00,518797,Staff,10,0,20,10
1713505350876,MMW 12R,A01,514034,Herbst; Matthew,1,0,16,15
1713505350876,MMW 12R,A02,514035,Herbst; Matthew,13,0,16,3
1713505351902,MMW 13R,A01,514037,Staff,0,8,16,16
1713505351902,MMW 13R,A02,514039,Staff,0,7,16,16
1713505353952,SIO 295LS,A00,523233,Staff,15,0,30,15
1713505354980,SIO 295S,A00,523232,Staff,15,0,30,15
1713505356007,SOCI 117,A01,494376,Staff,0,2,5,5
1713505357033,WES 237B,A00,494380,Staff,19,0,20,1
1713505359101,AESE 279B,A00,494370,Wade; Jon P,33,0,33,0
1713505360128,AIP 197,001,627712,Vespa; Emanuel Ignacio,9999,0,9999,0
1713505361155,ANAR 135S,A00,494369,Braswell; Geoffrey E.,0,0,0,0
1713505362179,CAT 124RS,A01,519847,Geibel; William,6,0,20,14
1713505363208,CAT 125RS,A01,515971,Geibel; William,6,0,20,14
1713505364234,CLRE 250,A00,511389,Morris; Sheldon,9996,0,9999,3
1713505365315,CLRE 251,A00,507176,Mehta; Ravindra L.,9996,0,9999,3
1713505365315,CLRE 251,B00,511410,Mehta; Ravindra L.,9998,0,9999,1
1713505366343,CLRE 252,A00,507189,Cuomo; Raphael Eduardo,9998,0,9999,1
1713505367369,CLRE 253,A00,507199,Vaida; Florin,9997,0,9999,2
1713505367369,CLRE 253,B00,507202,Vaida; Florin,9999,0,9999,0
1713505368396,CLRE 259,A00,507211,Patel; Hemal,9996,0,9999,3
1713505369421,CLRE 260,A00,507221,Cuomo; Raphael Eduardo,9999,0,9999,0
1713505370446,CLRE 297,001,507242,Cuomo; Raphael Eduardo,9999,0,9999,0
1713505371472,CSE 191,A00,516875,Minnes Kemp; Mor Mia,9999,0,9999,0
1713505372507,CSS 201S,A01,494383,Staff,35,0,35,0
1713505373533,CSS 202S,A01,494387,Staff,35,0,35,0
1713505374559,EAP 100,A00,516065,Staff,9792,0,9999,207
1713505375588,ECE 45,A01,507414,Staff,37,0,60,23
1713505376617,ECE 100,A01,507416,Baghdadchi; Saharnaz,0,0,20,20
1713505376617,ECE 100,A02,507418,Baghdadchi; Saharnaz,19,0,20,1
1713505377645,ECE 111,A01,507420,Staff,27,0,50,23
1713505378670,ECE 197,001,548057,Sievenpiper; Daniel F.,9998,0,9999,1
1713505379701,EDS 115,A00,507243,Choi; Bailey Miyeon,27,0,28,1
1713505380727,EDS 117,A01,494379,Staff,15,0,25,10
1713505381756,EDS 125,A00,507246,Hopkins; Megan Beth,27,0,30,3
1713505382780,EDS 128A,A01,507264,Fargason; Sharon Gayle,26,0,26,0
1713505383805,EDS 128B,A01,507293,Pappas; Elizabeth,30,0,30,0
1713505384835,EDS 139,A00,507294,Fargason; Sharon Gayle,30,0,30,0
1713505384835,EDS 139,B00,507313,Pappas; Elizabeth,30,0,30,0
1713505385864,EDS 201,A00,507315,Staff,18,0,30,12
1713505386890,EDS 203,A01,507317,Halter; Christopher P.,17,0,30,13
1713505387919,EDS 204R,A01,507319,Halter; Christopher P.,0,1,30,30
1713505387919,EDS 204R,B01,507331,Heinzman; Erica M.,22,0,30,8
1713505388944,EDS 206R,A00,507332,Staff,0,2,30,30
1713505388944,EDS 206R,B00,507343,Staff,23,0,30,7
1713505389968,EDS 250,A00,507344,Hemans; Patricia Ann Benitez,27,0,40,13
1713505390996,EDS 281,A00,507345,Daly; Alan J.,18,0,18,0
1713505392021,EDS 284,A00,507350,Daly; Alan J.,16,0,16,0
1713505393048,EDS 286,A00,507359,Fine; Sarah,18,0,18,0
1713505394078,EDS 289C,A01,507361,Daly; Alan J.,18,0,18,0
1713505395104,EDS 290,A00,507366,Hofstetter; Carolyn,15,0,15,0
1713505396127,LIGM 5A,A00,507421,Fischer-Grunski; Eva K,20,0,20,0
1713505397151,LIGM 5B,A00,507423,Fischer-Grunski; Eva K,20,0,20,0
1713505398177,LIGM 5C,A00,507425,Fischer-Grunski; Eva K,20,0,20,0
1713505399202,LIIT 5AS,A00,507427,Carnelos; Chiara,20,0,20,0
1713505400227,LIIT 5BS,A00,507430,Carnelos; Chiara,20,0,20,0
1713505401252,LIIT 5CS,A00,507432,Carnelos; Chiara,20,0,20,0
1713505402281,LISP 5A,A00,507541,Munoz Sanchez; Alicia,14,0,20,6
1713505403305,LISP 5B,A00,507671,Munoz Sanchez; Alicia,12,0,20,8
1713505404331,LISP 5C,A00,507696,Munoz Sanchez; Alicia,11,0,20,9
1713505405357,MAE 197,001,528363,Boechler; Nicholas Sebastia,9998,0,9999,1
1713505406387,MATH 197,001,523477,Kedlaya; Kiran S.,9999,0,9999,0
1713505406387,MATH 197,002,563811,Zhang; Danna,9998,0,9999,1
1713505407415,MCWP 40R,A00,518780,Staff,13,0,20,7
1713505407415,MCWP 40R,B00,518781,Staff,11,0,20,9
1713505407415,MCWP 40R,C00,518783,Staff,8,0,20,12
1713505408445,MCWP 50R,A00,518791,Staff,7,0,20,13
1713505408445,MCWP 50R,B00,518792,Staff,3,0,20,17
1713505408445,MCWP 50R,C00,518793,Staff,5,0,20,15
1713505408445,MCWP 50R,D00,518794,Staff,0,0,20,20
1713505408445,MCWP 50R,E00,518795,Staff,0,0,20,20
1713505408445,MCWP 50R,F00,518796,Staff,11,0,20,9
1713505408445,MCWP 50R,G00,518797,Staff,10,0,20,10
1713505409469,MMW 12R,A01,514034,Herbst; Matthew,1,0,16,15
1713505409469,MMW 12R,A02,514035,Herbst; Matthew,13,0,16,3
1713505410495,MMW 13R,A01,514037,Staff,0,8,16,16
1713505410495,MMW 13R,A02,514039,Staff,0,7,16,16
1713505412547,SIO 295LS,A00,523233,Staff,15,0,30,15
1713505413576,SIO 295S,A00,523232,Staff,15,0,30,15
1713505414601,SOCI 117,A01,494376,Staff,0,2,5,5
1713505415626,WES 237B,A00,494380,Staff,19,0,20,1
1713505417690,AESE 279B,A00,494370,Wade; Jon P,33,0,33,0
1713505418714,AIP 197,001,627712,Vespa; Emanuel Ignacio,9999,0,9999,0
1713505419743,ANAR 135S,A00,494369,Braswell; Geoffrey E.,0,0,0,0
1713505420769,CAT 124RS,A01,519847,Geibel; William,6,0,20,14
1713505421795,CAT 125RS,A01,515971,Geibel; William,6,0,20,14
1713505422825,CLRE 250,A00,511389,Morris; Sheldon,9996,0,9999,3
1713505423862,CLRE 251,A00,507176,Mehta; Ravindra L.,9996,0,9999,3
1713505423862,CLRE 251,B00,511410,Mehta; Ravindra L.,9998,0,9999,1
1713505424888,CLRE 252,A00,507189,Cuomo; Raphael Eduardo,9998,0,9999,1
1713505425919,CLRE 253,A00,507199,Vaida; Florin,9997,0,9999,2
1713505425919,CLRE 253,B00,507202,Vaida; Florin,9999,0,9999,0
1713505426946,CLRE 259,A00,507211,Patel; Hemal,9996,0,9999,3
1713505427974,CLRE 260,A00,507221,Cuomo; Raphael Eduardo,9999,0,9999,0
1713505428999,CLRE 297,001,507242,Cuomo; Raphael Eduardo,9999,0,9999,0
1713505430026,CSE 191,A00,516875,Minnes Kemp; Mor Mia,9999,0,9999,0
1713505431053,CSS 201S,A01,494383,Staff,35,0,35,0
1713505432078,CSS 202S,A01,494387,Staff,35,0,35,0
1713505433106,EAP 100,A00,516065,Staff,9792,0,9999,207
1713505434133,ECE 45,A01,507414,Staff,37,0,60,23
1713505435159,ECE 100,A01,507416,Baghdadchi; Saharnaz,0,0,20,20
1713505435159,ECE 100,A02,507418,Baghdadchi; Saharnaz,19,0,20,1
1713505436185,ECE 111,A01,507420,Staff,27,0,50,23
1713505437214,ECE 197,001,548057,Sievenpiper; Daniel F.,9998,0,9999,1
1713505438239,EDS 115,A00,507243,Choi; Bailey Miyeon,27,0,28,1
1713505439266,EDS 117,A01,494379,Staff,15,0,25,10
1713505440292,EDS 125,A00,507246,Hopkins; Megan Beth,27,0,30,3
1713505441323,EDS 128A,A01,507264,Fargason; Sharon Gayle,26,0,26,0
1713505442351,EDS 128B,A01,507293,Pappas; Elizabeth,30,0,30,0
1713505443379,EDS 139,A00,507294,Fargason; Sharon Gayle,30,0,30,0
1713505443379,EDS 139,B00,507313,Pappas; Elizabeth,30,0,30,0
1713505444406,EDS 201,A00,507315,Staff,18,0,30,12
1713505445444,EDS 203,A01,507317,Halter; Christopher P.,17,0,30,13
1713505446468,EDS 204R,A01,507319,Halter; Christopher P.,0,1,30,30
1713505446468,EDS 204R,B01,507331,Heinzman; Erica M.,22,0,30,8
1713505447495,EDS 206R,A00,507332,Staff,0,2,30,30
1713505447495,EDS 206R,B00,507343,Staff,23,0,30,7
1713505448524,EDS 250,A00,507344,Hemans; Patricia Ann Benitez,27,0,40,13
1713505449553,EDS 281,A00,507345,Daly; Alan J.,18,0,18,0
1713505450576,EDS 284,A00,507350,Daly; Alan J.,16,0,16,0
1713505451604,EDS 286,A00,507359,Fine; Sarah,18,0,18,0
1713505452632,EDS 289C,A01,507361,Daly; Alan J.,18,0,18,0
1713505453655,EDS 290,A00,507366,Hofstetter; Carolyn,15,0,15,0
1713505454680,LIGM 5A,A00,507421,Fischer-Grunski; Eva K,20,0,20,0
1713505455705,LIGM 5B,A00,507423,Fischer-Grunski; Eva K,20,0,20,0
1713505456732,LIGM 5C,A00,507425,Fischer-Grunski; Eva K,20,0,20,0
1713505457757,LIIT 5AS,A00,507427,Carnelos; Chiara,20,0,20,0
1713505458787,LIIT 5BS,A00,507430,Carnelos; Chiara,20,0,20,0
1713505459817,LIIT 5CS,A00,507432,Carnelos; Chiara,20,0,20,0
1713505460844,LISP 5A,A00,507541,Munoz Sanchez; Alicia,14,0,20,6
1713505461870,LISP 5B,A00,507671,Munoz Sanchez; Alicia,12,0,20,8
1713505462896,LISP 5C,A00,507696,Munoz Sanchez; Alicia,11,0,20,9
1713505463920,MAE 197,001,528363,Boechler; Nicholas Sebastia,9998,0,9999,1
1713505464947,MATH 197,001,523477,Kedlaya; Kiran S.,9999,0,9999,0
1713505464947,MATH 197,002,563811,Zhang; Danna,9998,0,9999,1
1713505465977,MCWP 40R,A00,518780,Staff,13,0,20,7
1713505465977,MCWP 40R,B00,518781,Staff,11,0,20,9
1713505465977,MCWP 40R,C00,518783,Staff,8,0,20,12
1713505467005,MCWP 50R,A00,518791,Staff,7,0,20,13
1713505467005,MCWP 50R,B00,518792,Staff,3,0,20,17
1713505467005,MCWP 50R,C00,518793,Staff,5,0,20,15
1713505467005,MCWP 50R,D00,518794,Staff,0,0,20,20
1713505467005,MCWP 50R,E00,518795,Staff,0,0,20,20
1713505467005,MCWP 50R,F00,518796,Staff,11,0,20,9
1713505467005,MCWP 50R,G00,518797,Staff,10,0,20,10
1713505468034,MMW 12R,A01,514034,Herbst; Matthew,1,0,16,15
1713505468034,MMW 12R,A02,514035,Herbst; Matthew,13,0,16,3
1713505469119,MMW 13R,A01,514037,Staff,0,8,16,16
1713505469119,MMW 13R,A02,514039,Staff,0,7,16,16
1713505471176,SIO 295LS,A00,523233,Staff,15,0,30,15
1713505472205,SIO 295S,A00,523232,Staff,15,0,30,15
1713505473231,SOCI 117,A01,494376,Staff,0,2,5,5
1713505474257,WES 237B,A00,494380,Staff,19,0,20,1
1713505476328,AESE 279B,A00,494370,Wade; Jon P,33,0,33,0
1713505477356,AIP 197,001,627712,Vespa; Emanuel Ignacio,9999,0,9999,0
1713505478383,ANAR 135S,A00,494369,Braswell; Geoffrey E.,0,0,0,0
1713505479411,CAT 124RS,A01,519847,Geibel; William,6,0,20,14
1713505480436,CAT 125RS,A01,515971,Geibel; William,6,0,20,14
1713505481463,CLRE 250,A00,511389,Morris; Sheldon,9996,0,9999,3
1713505482488,CLRE 251,A00,507176,Mehta; Ravindra L.,9996,0,9999,3
1713505482488,CLRE 251,B00,511410,Mehta; Ravindra L.,9998,0,9999,1
1713505483512,CLRE 252,A00,507189,Cuomo; Raphael Eduardo,9998,0,9999,1
1713505484539,CLRE 253,A00,507199,Vaida; Florin,9997,0,9999,2
1713505484539,CLRE 253,B00,507202,Vaida; Florin,9999,0,9999,0
1713505485566,CLRE 259,A00,507211,Patel; Hemal,9996,0,9999,3
1713505486594,CLRE 260,A00,507221,Cuomo; Raphael Eduardo,9999,0,9999,0
1713505487624,CLRE 297,001,507242,Cuomo; Raphael Eduardo,9999,0,9999,0
1713505488649,CSE 191,A00,516875,Minnes Kemp; Mor Mia,9999,0,9999,0
1713505489675,CSS 201S,A01,494383,Staff,35,0,35,0
1713505490704,CSS 202S,A01,494387,Staff,35,0,35,0
1713505491729,EAP 100,A00,516065,Staff,9792,0,9999,207
1713505492755,ECE 45,A01,507414,Staff,37,0,60,23
1713505493781,ECE 100,A01,507416,Baghdadchi; Saharnaz,0,0,20,20
1713505493781,ECE 100,A02,507418,Baghdadchi; Saharnaz,19,0,20,1
1713505494807,ECE 111,A01,507420,Staff,27,0,50,23
1713505495836,ECE 197,001,548057,Sievenpiper; Daniel F.,9998,0,9999,1
1713505496866,EDS 115,A00,507243,Choi; Bailey Miyeon,27,0,28,1
1713505497895,EDS 117,A01,494379,Staff,15,0,25,10
1713505498921,EDS 125,A00,507246,Hopkins; Megan Beth,27,0,30,3
1713505499947,EDS 128A,A01,507264,Fargason; Sharon Gayle,26,0,26,0
1713505500981,EDS 128B,A01,507293,Pappas; Elizabeth,30,0,30,0
1713505502007,EDS 139,A00,507294,Fargason; Sharon Gayle,30,0,30,0
1713505502007,EDS 139,B00,507313,Pappas; Elizabeth,30,0,30,0
1713505503034,EDS 201,A00,507315,Staff,18,0,30,12
1713505504059,EDS 203,A01,507317,Halter; Christopher P.,17,0,30,13
1713505505087,EDS 204R,A01,507319,Halter; Christopher P.,0,1,30,30
1713505505087,EDS 204R,B01,507331,Heinzman; Erica M.,22,0,30,8
1713505506112,EDS 206R,A00,507332,Staff,0,2,30,30
1713505506112,EDS 206R,B00,507343,Staff,23,0,30,7
1713505507137,EDS 250,A00,507344,Hemans; Patricia Ann Benitez,27,0,40,13
1713505508162,EDS 281,A00,507345,Daly; Alan J.,18,0,18,0
1713505509186,EDS 284,A00,507350,Daly; Alan J.,16,0,16,0
1713505510211,EDS 286,A00,507359,Fine; Sarah,18,0,18,0
1713505511241,EDS 289C,A01,507361,Daly; Alan J.,18,0,18,0
1713505512269,EDS 290,A00,507366,Hofstetter; Carolyn,15,0,15,0
1713505513294,LIGM 5A,A00,507421,Fischer-Grunski; Eva K,20,0,20,0
1713505514323,LIGM 5B,A00,507423,Fischer-Grunski; Eva K,20,0,20,0
1713505515352,LIGM 5C,A00,507425,Fischer-Grunski; Eva K,20,0,20,0
1713505516380,LIIT 5AS,A00,507427,Carnelos; Chiara,20,0,20,0
1713505517410,LIIT 5BS,A00,507430,Carnelos; Chiara,20,0,20,0
1713505518439,LIIT 5CS,A00,507432,Carnelos; Chiara,20,0,20,0
1713505519463,LISP 5A,A00,507541,Munoz Sanchez; Alicia,14,0,20,6
1713505520492,LISP 5B,A00,507671,Munoz Sanchez; Alicia,12,0,20,8
1713505521518,LISP 5C,A00,507696,Munoz Sanchez; Alicia,11,0,20,9
1713505522543,MAE 197,001,528363,Boechler; Nicholas Sebastia,9998,0,9999,1
1713505523577,MATH 197,001,523477,Kedlaya; Kiran S.,9999,0,9999,0
1713505523577,MATH 197,002,563811,Zhang; Danna,9998,0,9999,1
1713505524606,MCWP 40R,A00,518780,Staff,13,0,20,7
1713505524606,MCWP 40R,B00,518781,Staff,11,0,20,9
1713505524606,MCWP 40R,C00,518783,Staff,8,0,20,12
1713505525633,MCWP 50R,A00,518791,Staff,7,0,20,13
1713505525633,MCWP 50R,B00,518792,Staff,3,0,20,17
1713505525633,MCWP 50R,C00,518793,Staff,5,0,20,15
1713505525633,MCWP 50R,D00,518794,Staff,0,0,20,20
1713505525633,MCWP 50R,E00,518795,Staff,0,0,20,20
1713505525633,MCWP 50R,F00,518796,Staff,11,0,20,9
1713505525633,MCWP 50R,G00,518797,Staff,10,0,20,10
1713505526661,MMW 12R,A01,514034,Herbst; Matthew,1,0,16,15
1713505526661,MMW 12R,A02,514035,Herbst; Matthew,13,0,16,3
1713505527691,MMW 13R,A01,514037,Staff,0,8,16,16
1713505527691,MMW 13R,A02,514039,Staff,0,7,16,16
1713505529743,SIO 295LS,A00,523233,Staff,15,0,30,15
1713505530771,SIO 295S,A00,523232,Staff,15,0,30,15
1713505531797,SOCI 117,A01,494376,Staff,0,2,5,5
1713505532820,WES 237B,A00,494380,Staff,19,0,20,1
1713505534877,AESE 279B,A00,494370,Wade; Jon P,33,0,33,0
1713505535903,AIP 197,001,627712,Vespa; Emanuel Ignacio,9999,0,9999,0
1713505536929,ANAR 135S,A00,494369,Braswell; Geoffrey E.,0,0,0,0
1713505537963,CAT 124RS,A01,519847,Geibel; William,6,0,20,14
1713505538988,CAT 125RS,A01,515971,Geibel; William,6,0,20,14
1713505540016,CLRE 250,A00,511389,Morris; Sheldon,9996,0,9999,3
1713505541044,CLRE 251,A00,507176,Mehta; Ravindra L.,9996,0,9999,3
1713505541044,CLRE 251,B00,511410,Mehta; Ravindra L.,9998,0,9999,1
1713505542070,CLRE 252,A00,507189,Cuomo; Raphael Eduardo,9998,0,9999,1
1713505543095,CLRE 253,A00,507199,Vaida; Florin,9997,0,9999,2
1713505543095,CLRE 253,B00,507202,Vaida; Florin,9999,0,9999,0
1713505544122,CLRE 259,A00,507211,Patel; Hemal,9996,0,9999,3
1713505545148,CLRE 260,A00,507221,Cuomo; Raphael Eduardo,9999,0,9999,0
1713505546172,CLRE 297,001,507242,Cuomo; Raphael Eduardo,9999,0,9999,0
1713505547197,CSE 191,A00,516875,Minnes Kemp; Mor Mia,9999,0,9999,0
1713505548223,CSS 201S,A01,494383,Staff,35,0,35,0
1713505549250,CSS 202S,A01,494387,Staff,35,0,35,0
1713505550273,EAP 100,A00,516065,Staff,9792,0,9999,207
1713505551302,ECE 45,A01,507414,Staff,37,0,60,23
1713505552331,ECE 100,A01,507416,Baghdadchi; Saharnaz,0,0,20,20
1713505552331,ECE 100,A02,507418,Baghdadchi; Saharnaz,19,0,20,1
1713505553357,ECE 111,A01,507420,Staff,27,0,50,23
1713505554381,ECE 197,001,548057,Sievenpiper; Daniel F.,9998,0,9999,1
1713505555407,EDS 115,A00,507243,Choi; Bailey Miyeon,27,0,28,1
1713505556433,EDS 117,A01,494379,Staff,15,0,25,10
1713505557459,EDS 125,A00,507246,Hopkins; Megan Beth,27,0,30,3
1713505558487,EDS 128A,A01,507264,Fargason; Sharon Gayle,26,0,26,0
1713505559516,EDS 128B,A01,507293,Pappas; Elizabeth,30,0,30,0
1713505560597,EDS 139,A00,507294,Fargason; Sharon Gayle,30,0,30,0
1713505560597,EDS 139,B00,507313,Pappas; Elizabeth,30,0,30,0
1713505561624,EDS 201,A00,507315,Staff,18,0,30,12
1713505562649,EDS 203,A01,507317,Halter; Christopher P.,17,0,30,13
1713505563677,EDS 204R,A01,507319,Halter; Christopher P.,0,1,30,30
1713505563677,EDS 204R,B01,507331,Heinzman; Erica M.,22,0,30,8
1713505564702,EDS 206R,A00,507332,Staff,0,2,30,30
1713505564702,EDS 206R,B00,507343,Staff,23,0,30,7
1713505565727,EDS 250,A00,507344,Hemans; Patricia Ann Benitez,27,0,40,13
1713505566754,EDS 281,A00,507345,Daly; Alan J.,18,0,18,0
1713505567778,EDS 284,A00,507350,Daly; Alan J.,16,0,16,0
1713505568803,EDS 286,A00,507359,Fine; Sarah,18,0,18,0
1713505569884,EDS 289C,A01,507361,Daly; Alan J.,18,0,18,0
1713505570912,EDS 290,A00,507366,Hofstetter; Carolyn,15,0,15,0
1713505571938,LIGM 5A,A00,507421,Fischer-Grunski; Eva K,20,0,20,0
1713505573020,LIGM 5B,A00,507423,Fischer-Grunski; Eva K,20,0,20,0
1713505574045,LIGM 5C,A00,507425,Fischer-Grunski; Eva K,20,0,20,0
1713505575071,LIIT 5AS,A00,507427,Carnelos; Chiara,20,0,20,0
1713505576099,LIIT 5BS,A00,507430,Carnelos; Chiara,20,0,20,0
1713505577124,LIIT 5CS,A00,507432,Carnelos; Chiara,20,0,20,0
1713505578149,LISP 5A,A00,507541,Munoz Sanchez; Alicia,14,0,20,6
1713505579174,LISP 5B,A00,507671,Munoz Sanchez; Alicia,12,0,20,8
1713505580199,LISP 5C,A00,507696,Munoz Sanchez; Alicia,11,0,20,9
1713505581223,MAE 197,001,528363,Boechler; Nicholas Sebastia,9998,0,9999,1
1713505582252,MATH 197,001,523477,Kedlaya; Kiran S.,9999,0,9999,0
1713505582252,MATH 197,002,563811,Zhang; Danna,9998,0,9999,1
1713505583281,MCWP 40R,A00,518780,Staff,13,0,20,7
1713505583281,MCWP 40R,B00,518781,Staff,11,0,20,9
1713505583281,MCWP 40R,C00,518783,Staff,8,0,20,12
1713505584311,MCWP 50R,A00,518791,Staff,7,0,20,13
1713505584311,MCWP 50R,B00,518792,Staff,3,0,20,17
1713505584311,MCWP 50R,C00,518793,Staff,5,0,20,15
1713505584311,MCWP 50R,D00,518794,Staff,0,0,20,20
1713505584311,MCWP 50R,E00,518795,Staff,0,0,20,20
1713505584311,MCWP 50R,F00,518796,Staff,11,0,20,9
1713505584311,MCWP 50R,G00,518797,Staff,10,0,20,10
1713505585339,MMW 12R,A01,514034,Herbst; Matthew,1,0,16,15
1713505585339,MMW 12R,A02,514035,Herbst; Matthew,13,0,16,3
1713505586365,MMW 13R,A01,514037,Staff,0,8,16,16
1713505586365,MMW 13R,A02,514039,Staff,0,7,16,16
1713505588413,SIO 295LS,A00,523233,Staff,15,0,30,15
1713505589439,SIO 295S,A00,523232,Staff,15,0,30,15
1713505590466,SOCI 117,A01,494376,Staff,0,2,5,5
1713505591493,WES 237B,A00,494380,Staff,19,0,20,1
1713505593553,AESE 279B,A00,494370,Wade; Jon P,33,0,33,0
1713505594577,AIP 197,001,627712,Vespa; Emanuel Ignacio,9999,0,9999,0
1713505595604,ANAR 135S,A00,494369,Braswell; Geoffrey E.,0,0,0,0
1713505596632,CAT 124RS,A01,519847,Geibel; William,6,0,20,14
1713505597661,CAT 125RS,A01,515971,Geibel; William,6,0,20,14
1713505598685,CLRE 250,A00,511389,Morris; Sheldon,9996,0,9999,3
1713505599712,CLRE 251,A00,507176,Mehta; Ravindra L.,9996,0,9999,3
1713505599712,CLRE 251,B00,511410,Mehta; Ravindra L.,9998,0,9999,1
1713505600741,CLRE 252,A00,507189,Cuomo; Raphael Eduardo,9998,0,9999,1
1713505601769,CLRE 253,A00,507199,Vaida; Florin,9997,0,9999,2
1713505601769,CLRE 253,B00,507202,Vaida; Florin,9999,0,9999,0
1713505602794,CLRE 259,A00,507211,Patel; Hemal,9996,0,9999,3
1713505603818,CLRE 260,A00,507221,Cuomo; Raphael Eduardo,9999,0,9999,0
1713505604843,CLRE 297,001,507242,Cuomo; Raphael Eduardo,9999,0,9999,0
1713505605869,CSE 191,A00,516875,Minnes Kemp; Mor Mia,9999,0,9999,0
1713505606899,CSS 201S,A01,494383,Staff,35,0,35,0
1713505607925,CSS 202S,A01,494387,Staff,35,0,35,0
1713505608950,EAP 100,A00,516065,Staff,9792,0,9999,207
1713505609981,ECE 45,A01,507414,Staff,37,0,60,23
1713505611006,ECE 100,A01,507416,Baghdadchi; Saharnaz,0,0,20,20
1713505611006,ECE 100,A02,507418,Baghdadchi; Saharnaz,19,0,20,1
1713505612030,ECE 111,A01,507420,Staff,27,0,50,23
1713505613058,ECE 197,001,548057,Sievenpiper; Daniel F.,9998,0,9999,1
1713505614084,EDS 115,A00,507243,Choi; Bailey Miyeon,27,0,28,1
1713505615112,EDS 117,A01,494379,Staff,15,0,25,10
1713505616139,EDS 125,A00,507246,Hopkins; Megan Beth,27,0,30,3
1713505617167,EDS 128A,A01,507264,Fargason; Sharon Gayle,26,0,26,0
1713505618192,EDS 128B,A01,507293,Pappas; Elizabeth,30,0,30,0
1713505619217,EDS 139,A00,507294,Fargason; Sharon Gayle,30,0,30,0
1713505619217,EDS 139,B00,507313,Pappas; Elizabeth,30,0,30,0
1713505620243,EDS 201,A00,507315,Staff,18,0,30,12
1713505621268,EDS 203,A01,507317,Halter; Christopher P.,17,0,30,13
1713505622293,EDS 204R,A01,507319,Halter; Christopher P.,0,1,30,30
1713505622293,EDS 204R,B01,507331,Heinzman; Erica M.,22,0,30,8
1713505623319,EDS 206R,A00,507332,Staff,0,2,30,30
1713505623319,EDS 206R,B00,507343,Staff,23,0,30,7
1713505624346,EDS 250,A00,507344,Hemans; Patricia Ann Benitez,27,0,40,13
1713505625371,EDS 281,A00,507345,Daly; Alan J.,18,0,18,0
1713505626395,EDS 284,A00,507350,Daly; Alan J.,16,0,16,0
1713505627419,EDS 286,A00,507359,Fine; Sarah,18,0,18,0
1713505628444,EDS 289C,A01,507361,Daly; Alan J.,18,0,18,0
1713505629469,EDS 290,A00,507366,Hofstetter; Carolyn,15,0,15,0
1713505630496,LIGM 5A,A00,507421,Fischer-Grunski; Eva K,20,0,20,0
1713505631524,LIGM 5B,A00,507423,Fischer-Grunski; Eva K,20,0,20,0
1713505632553,LIGM 5C,A00,507425,Fischer-Grunski; Eva K,20,0,20,0
1713505633580,LIIT 5AS,A00,507427,Carnelos; Chiara,20,0,20,0
1713505634603,LIIT 5BS,A00,507430,Carnelos; Chiara,20,0,20,0
1713505635628,LIIT 5CS,A00,507432,Carnelos; Chiara,20,0,20,0
1713505636658,LISP 5A,A00,507541,Munoz Sanchez; Alicia,14,0,20,6
1713505637683,LISP 5B,A00,507671,Munoz Sanchez; Alicia,12,0,20,8
1713505638708,LISP 5C,A00,507696,Munoz Sanchez; Alicia,11,0,20,9
1713505639732,MAE 197,001,528363,Boechler; Nicholas Sebastia,9998,0,9999,1
1713505640759,MATH 197,001,523477,Kedlaya; Kiran S.,9999,0,9999,0
1713505640759,MATH 197,002,563811,Zhang; Danna,9998,0,9999,1
1713505641786,MCWP 40R,A00,518780,Staff,13,0,20,7
1713505641786,MCWP 40R,B00,518781,Staff,11,0,20,9
1713505641786,MCWP 40R,C00,518783,Staff,8,0,20,12
1713505642816,MCWP 50R,A00,518791,Staff,7,0,20,13
1713505642816,MCWP 50R,B00,518792,Staff,3,0,20,17
1713505642816,MCWP 50R,C00,518793,Staff,5,0,20,15
1713505642816,MCWP 50R,D00,518794,Staff,0,0,20,20
1713505642816,MCWP 50R,E00,518795,Staff,0,0,20,20
1713505642816,MCWP 50R,F00,518796,Staff,11,0,20,9
1713505642816,MCWP 50R,G00,518797,Staff,10,0,20,10
1713505643844,MMW 12R,A01,514034,Herbst; Matthew,1,0,16,15
1713505643844,MMW 12R,A02,514035,Herbst; Matthew,13,0,16,3
1713505644872,MMW 13R,A01,514037,Staff,0,8,16,16
1713505644872,MMW 13R,A02,514039,Staff,0,7,16,16
1713505646925,SIO 295LS,A00,523233,Staff,15,0,30,15
1713505647952,SIO 295S,A00,523232,Staff,15,0,30,15
1713505648976,SOCI 117,A01,494376,Staff,0,2,5,5
1713505650000,WES 237B,A00,494380,Staff,19,0,20,1
1713505652066,AESE 279B,A00,494370,Wade; Jon P,33,0,33,0
1713505653091,AIP 197,001,627712,Vespa; Emanuel Ignacio,9999,0,9999,0
1713505654115,ANAR 135S,A00,494369,Braswell; Geoffrey E.,0,0,0,0
1713505655140,CAT 124RS,A01,519847,Geibel; William,6,0,20,14
1713505656167,CAT 125RS,A01,515971,Geibel; William,6,0,20,14
1713505657195,CLRE 250,A00,511389,Morris; Sheldon,9996,0,9999,3
1713505658221,CLRE 251,A00,507176,Mehta; Ravindra L.,9996,0,9999,3
1713505658221,CLRE 251,B00,511410,Mehta; Ravindra L.,9998,0,9999,1
1713505659246,CLRE 252,A00,507189,Cuomo; Raphael Eduardo,9998,0,9999,1
1713505660275,CLRE 253,A00,507199,Vaida; Florin,9997,0,9999,2
1713505660275,CLRE 253,B00,507202,Vaida; Florin,9999,0,9999,0
1713505661299,CLRE 259,A00,507211,Patel; Hemal,9996,0,9999,3
1713505662324,CLRE 260,A00,507221,Cuomo; Raphael Eduardo,9999,0,9999,0
1713505663352,CLRE 297,001,507242,Cuomo; Raphael Eduardo,9999,0,9999,0
1713505664382,CSE 191,A00,516875,Minnes Kemp; Mor Mia,9999,0,9999,0
1713505665411,CSS 201S,A01,494383,Staff,35,0,35,0
1713505666436,CSS 202S,A01,494387,Staff,35,0,35,0
1713505667462,EAP 100,A00,516065,Staff,9792,0,9999,207
1713505668490,ECE 45,A01,507414,Staff,37,0,60,23
1713505669516,ECE 100,A01,507416,Baghdadchi; Saharnaz,0,0,20,20
1713505669516,ECE 100,A02,507418,Baghdadchi; Saharnaz,19,0,20,1
1713505670541,ECE 111,A01,507420,Staff,27,0,50,23
1713505671571,ECE 197,001,548057,Sievenpiper; Daniel F.,9998,0,9999,1
1713505672596,EDS 115,A00,507243,Choi; Bailey Miyeon,27,0,28,1
1713505673624,EDS 117,A01,494379,Staff,15,0,25,10
1713505674651,EDS 125,A00,507246,Hopkins; Megan Beth,27,0,30,3
1713505675680,EDS 128A,A01,507264,Fargason; Sharon Gayle,26,0,26,0
1713505676782,EDS 128B,A01,507293,Pappas; Elizabeth,30,0,30,0
1713505677808,EDS 139,A00,507294,Fargason; Sharon Gayle,30,0,30,0
1713505677808,EDS 139,B00,507313,Pappas; Elizabeth,30,0,30,0
1713505678836,EDS 201,A00,507315,Staff,18,0,30,12
1713505679861,EDS 203,A01,507317,Halter; Christopher P.,17,0,30,13
1713505680889,EDS 204R,A01,507319,Halter; Christopher P.,0,1,30,30
1713505680889,EDS 204R,B01,507331,Heinzman; Erica M.,22,0,30,8
1713505681914,EDS 206R,A00,507332,Staff,0,2,30,30
1713505681914,EDS 206R,B00,507343,Staff,23,0,30,7
1713505682942,EDS 250,A00,507344,Hemans; Patricia Ann Benitez,27,0,40,13
1713505683966,EDS 281,A00,507345,Daly; Alan J.,18,0,18,0
1713505684990,EDS 284,A00,507350,Daly; Alan J.,16,0,16,0
1713505686015,EDS 286,A00,507359,Fine; Sarah,18,0,18,0
1713505687043,EDS 289C,A01,507361,Daly; Alan J.,18,0,18,0
1713505688072,EDS 290,A00,507366,Hofstetter; Carolyn,15,0,15,0
1713505689102,LIGM 5A,A00,507421,Fischer-Grunski; Eva K,20,0,20,0
1713505690128,LIGM 5B,A00,507423,Fischer-Grunski; Eva K,20,0,20,0
1713505691153,LIGM 5C,A00,507425,Fischer-Grunski; Eva K,20,0,20,0
1713505692180,LIIT 5AS,A00,507427,Carnelos; Chiara,20,0,20,0
1713505693210,LIIT 5BS,A00,507430,Carnelos; Chiara,20,0,20,0
1713505694240,LIIT 5CS,A00,507432,Carnelos; Chiara,20,0,20,0
1713505695271,LISP 5A,A00,507541,Munoz Sanchez; Alicia,14,0,20,6
1713505696297,LISP 5B,A00,507671,Munoz Sanchez; Alicia,12,0,20,8
1713505697326,LISP 5C,A00,507696,Munoz Sanchez; Alicia,11,0,20,9
1713505698353,MAE 197,001,528363,Boechler; Nicholas Sebastia,9998,0,9999,1
1713505699381,MATH 197,001,523477,Kedlaya; Kiran S.,9999,0,9999,0
1713505699381,MATH 197,002,563811,Zhang; Danna,9998,0,9999,1
1713505700410,MCWP 40R,A00,518780,Staff,13,0,20,7
1713505700410,MCWP 40R,B00,518781,Staff,11,0,20,9
1713505700410,MCWP 40R,C00,518783,Staff,8,0,20,12
1713505701434,MCWP 50R,A00,518791,Staff,7,0,20,13
1713505701434,MCWP 50R,B00,518792,Staff,3,0,20,17
1713505701434,MCWP 50R,C00,518793,Staff,5,0,20,15
1713505701434,MCWP 50R,D00,518794,Staff,0,0,20,20
1713505701434,MCWP 50R,E00,518795,Staff,0,0,20,20
1713505701434,MCWP 50R,F00,518796,Staff,11,0,20,9
1713505701434,MCWP 50R,G00,518797,Staff,10,0,20,10
1713505702459,MMW 12R,A01,514034,Herbst; Matthew,1,0,16,15
1713505702459,MMW 12R,A02,514035,Herbst; Matthew,13,0,16,3
1713505703484,MMW 13R,A01,514037,Staff,0,8,16,16
1713505703484,MMW 13R,A02,514039,Staff,0,7,16,16
1713505705535,SIO 295LS,A00,523233,Staff,15,0,30,15
1713505706565,SIO 295S,A00,523232,Staff,15,0,30,15
1713505707589,SOCI 117,A01,494376,Staff,0,2,5,5
1713505708613,WES 237B,A00,494380,Staff,19,0,20,1
1713505710687,AESE 279B,A00,494370,Wade; Jon P,33,0,33,0
1713505711712,AIP 197,001,627712,Vespa; Emanuel Ignacio,9999,0,9999,0
1713505712736,ANAR 135S,A00,494369,Braswell; Geoffrey E.,0,0,0,0
1713505713761,CAT 124RS,A01,519847,Geibel; William,6,0,20,14
1713505714791,CAT 125RS,A01,515971,Geibel; William,6,0,20,14
1713505715819,CLRE 250,A00,511389,Morris; Sheldon,9996,0,9999,3
1713505716849,CLRE 251,A00,507176,Mehta; Ravindra L.,9996,0,9999,3
1713505716849,CLRE 251,B00,511410,Mehta; Ravindra L.,9998,0,9999,1
1713505717874,CLRE 252,A00,507189,Cuomo; Raphael Eduardo,9998,0,9999,1
1713505718900,CLRE 253,A00,507199,Vaida; Florin,9997,0,9999,2
1713505718900,CLRE 253,B00,507202,Vaida; Florin,9999,0,9999,0
1713505719927,CLRE 259,A00,507211,Patel; Hemal,9996,0,9999,3
1713505720955,CLRE 260,A00,507221,Cuomo; Raphael Eduardo,9999,0,9999,0
1713505721982,CLRE 297,001,507242,Cuomo; Raphael Eduardo,9999,0,9999,0
1713505723009,CSE 191,A00,516875,Minnes Kemp; Mor Mia,9999,0,9999,0
1713505724038,CSS 201S,A01,494383,Staff,35,0,35,0
1713505725063,CSS 202S,A01,494387,Staff,35,0,35,0
1713505726088,EAP 100,A00,516065,Staff,9792,0,9999,207
1713505727114,ECE 45,A01,507414,Staff,37,0,60,23
1713505728140,ECE 100,A01,507416,Baghdadchi; Saharnaz,0,0,20,20
1713505728140,ECE 100,A02,507418,Baghdadchi; Saharnaz,19,0,20,1
1713505729169,ECE 111,A01,507420,Staff,27,0,50,23
1713505730193,ECE 197,001,548057,Sievenpiper; Daniel F.,9998,0,9999,1
1713505731221,EDS 115,A00,507243,Choi; Bailey Miyeon,27,0,28,1
1713505732249,EDS 117,A01,494379,Staff,15,0,25,10
1713505733278,EDS 125,A00,507246,Hopkins; Megan Beth,27,0,30,3
1713505734308,EDS 128A,A01,507264,Fargason; Sharon Gayle,26,0,26,0
1713505735336,EDS 128B,A01,507293,Pappas; Elizabeth,30,0,30,0
1713505736362,EDS 139,A00,507294,Fargason; Sharon Gayle,30,0,30,0
1713505736362,EDS 139,B00,507313,Pappas; Elizabeth,30,0,30,0
1713505737386,EDS 201,A00,507315,Staff,18,0,30,12
1713505738416,EDS 203,A01,507317,Halter; Christopher P.,17,0,30,13
1713505739443,EDS 204R,A01,507319,Halter; Christopher P.,0,1,30,30
1713505739443,EDS 204R,B01,507331,Heinzman; Erica M.,22,0,30,8
1713505740471,EDS 206R,A00,507332,Staff,0,2,30,30
1713505740471,EDS 206R,B00,507343,Staff,23,0,30,7
1713505741496,EDS 250,A00,507344,Hemans; Patricia Ann Benitez,27,0,40,13
1713505742526,EDS 281,A00,507345,Daly; Alan J.,18,0,18,0
1713505743554,EDS 284,A00,507350,Daly; Alan J.,16,0,16,0
1713505744583,EDS 286,A00,507359,Fine; Sarah,18,0,18,0
1713505745616,EDS 289C,A01,507361,Daly; Alan J.,18,0,18,0
1713505746642,EDS 290,A00,507366,Hofstetter; Carolyn,15,0,15,0
1713505747668,LIGM 5A,A00,507421,Fischer-Grunski; Eva K,20,0,20,0
1713505748693,LIGM 5B,A00,507423,Fischer-Grunski; Eva K,20,0,20,0
1713505749719,LIGM 5C,A00,507425,Fischer-Grunski; Eva K,20,0,20,0
1713505750745,LIIT 5AS,A00,507427,Carnelos; Chiara,20,0,20,0
1713505751771,LIIT 5BS,A00,507430,Carnelos; Chiara,20,0,20,0
1713505752801,LIIT 5CS,A00,507432,Carnelos; Chiara,20,0,20,0
1713505753826,LISP 5A,A00,507541,Munoz Sanchez; Alicia,14,0,20,6
1713505754860,LISP 5B,A00,507671,Munoz Sanchez; Alicia,12,0,20,8
1713505755885,LISP 5C,A00,507696,Munoz Sanchez; Alicia,11,0,20,9
1713505756911,MAE 197,001,528363,Boechler; Nicholas Sebastia,9998,0,9999,1
1713505757939,MATH 197,001,523477,Kedlaya; Kiran S.,9999,0,9999,0
1713505757939,MATH 197,002,563811,Zhang; Danna,9998,0,9999,1
1713505758964,MCWP 40R,A00,518780,Staff,13,0,20,7
1713505758964,MCWP 40R,B00,518781,Staff,11,0,20,9
1713505758964,MCWP 40R,C00,518783,Staff,8,0,20,12
1713505759990,MCWP 50R,A00,518791,Staff,7,0,20,13
1713505759990,MCWP 50R,B00,518792,Staff,3,0,20,17
1713505759990,MCWP 50R,C00,518793,Staff,5,0,20,15
1713505759990,MCWP 50R,D00,518794,Staff,0,0,20,20
1713505759990,MCWP 50R,E00,518795,Staff,0,0,20,20
1713505759990,MCWP 50R,F00,518796,Staff,11,0,20,9
1713505759990,MCWP 50R,G00,518797,Staff,10,0,20,10
1713505761016,MMW 12R,A01,514034,Herbst; Matthew,1,0,16,15
1713505761016,MMW 12R,A02,514035,Herbst; Matthew,13,0,16,3
1713505762044,MMW 13R,A01,514037,Staff,0,8,16,16
1713505762044,MMW 13R,A02,514039,Staff,0,7,16,16
1713505764094,SIO 295LS,A00,523233,Staff,15,0,30,15
1713505765119,SIO 295S,A00,523232,Staff,15,0,30,15
1713505766144,SOCI 117,A01,494376,Staff,0,2,5,5
1713505767170,WES 237B,A00,494380,Staff,19,0,20,1
1713505769238,AESE 279B,A00,494370,Wade; Jon P,33,0,33,0
1713505770262,AIP 197,001,627712,Vespa; Emanuel Ignacio,9999,0,9999,0
1713505771287,ANAR 135S,A00,494369,Braswell; Geoffrey E.,0,0,0,0
1713505772315,CAT 124RS,A01,519847,Geibel; William,6,0,20,14
1713505773341,CAT 125RS,A01,515971,Geibel; William,6,0,20,14
1713505774365,CLRE 250,A00,511389,Morris; Sheldon,9996,0,9999,3
1713505775392,CLRE 251,A00,507176,Mehta; Ravindra L.,9996,0,9999,3
1713505775392,CLRE 251,B00,511410,Mehta; Ravindra L.,9998,0,9999,1
1713505776423,CLRE 252,A00,507189,Cuomo; Raphael Eduardo,9998,0,9999,1
1713505777449,CLRE 253,A00,507199,Vaida; Florin,9997,0,9999,2
1713505777449,CLRE 253,B00,507202,Vaida; Florin,9999,0,9999,0
1713505778478,CLRE 259,A00,507211,Patel; Hemal,9996,0,9999,3
1713505779505,CLRE 260,A00,507221,Cuomo; Raphael Eduardo,9999,0,9999,0
1713505780585,CLRE 297,001,507242,Cuomo; Raphael Eduardo,9999,0,9999,0
1713505781614,CSE 191,A00,516875,Minnes Kemp; Mor Mia,9999,0,9999,0
1713505782644,CSS 201S,A01,494383,Staff,35,0,35,0
1713505783676,CSS 202S,A01,494387,Staff,35,0,35,0
1713505784702,EAP 100,A00,516065,Staff,9792,0,9999,207
1713505785730,ECE 45,A01,507414,Staff,37,0,60,23
1713505786760,ECE 100,A01,507416,Baghdadchi; Saharnaz,0,0,20,20
1713505786760,ECE 100,A02,507418,Baghdadchi; Saharnaz,19,0,20,1
1713505787785,ECE 111,A01,507420,Staff,27,0,50,23
1713505788811,ECE 197,001,548057,Sievenpiper; Daniel F.,9998,0,9999,1
1713505789840,EDS 115,A00,507243,Choi; Bailey Miyeon,27,0,28,1
1713505790869,EDS 117,A01,494379,Staff,15,0,25,10
1713505791899,EDS 125,A00,507246,Hopkins; Megan Beth,27,0,30,3
1713505792925,EDS 128A,A01,507264,Fargason; Sharon Gayle,26,0,26,0
1713505793954,EDS 128B,A01,507293,Pappas; Elizabeth,30,0,30,0
1713505794979,EDS 139,A00,507294,Fargason; Sharon Gayle,30,0,30,0
1713505794979,EDS 139,B00,507313,Pappas; Elizabeth,30,0,30,0
1713505796003,EDS 201,A00,507315,Staff,18,0,30,12
1713505797033,EDS 203,A01,507317,Halter; Christopher P.,17,0,30,13
1713505798059,EDS 204R,A01,507319,Halter; Christopher P.,0,1,30,30
1713505798059,EDS 204R,B01,507331,Heinzman; Erica M.,22,0,30,8
1713505799084,EDS 206R,A00,507332,Staff,0,2,30,30
1713505799084,EDS 206R,B00,507343,Staff,23,0,30,7
1713505800113,EDS 250,A00,507344,Hemans; Patricia Ann Benitez,27,0,40,13
1713505801137,EDS 281,A00,507345,Daly; Alan J.,18,0,18,0
1713505802165,EDS 284,A00,507350,Daly; Alan J.,16,0,16,0
1713505803193,EDS 286,A00,507359,Fine; Sarah,18,0,18,0
1713505804217,EDS 289C,A01,507361,Daly; Alan J.,18,0,18,0
1713505805246,EDS 290,A00,507366,Hofstetter; Carolyn,15,0,15,0
1713505806272,LIGM 5A,A00,507421,Fischer-Grunski; Eva K,20,0,20,0
1713505807297,LIGM 5B,A00,507423,Fischer-Grunski; Eva K,20,0,20,0
1713505808322,LIGM 5C,A00,507425,Fischer-Grunski; Eva K,20,0,20,0
1713505809348,LIIT 5AS,A00,507427,Carnelos; Chiara,20,0,20,0
1713505810372,LIIT 5BS,A00,507430,Carnelos; Chiara,20,0,20,0
1713505811398,LIIT 5CS,A00,507432,Carnelos; Chiara,20,0,20,0
1713505812423,LISP 5A,A00,507541,Munoz Sanchez; Alicia,14,0,20,6
1713505813450,LISP 5B,A00,507671,Munoz Sanchez; Alicia,12,0,20,8
1713505814475,LISP 5C,A00,507696,Munoz Sanchez; Alicia,11,0,20,9
1713505815501,MAE 197,001,528363,Boechler; Nicholas Sebastia,9998,0,9999,1
1713505816526,MATH 197,001,523477,Kedlaya; Kiran S.,9999,0,9999,0
1713505816526,MATH 197,002,563811,Zhang; Danna,9998,0,9999,1
1713505817551,MCWP 40R,A00,518780,Staff,13,0,20,7
1713505817551,MCWP 40R,B00,518781,Staff,11,0,20,9
1713505817551,MCWP 40R,C00,518783,Staff,8,0,20,12
1713505818581,MCWP 50R,A00,518791,Staff,7,0,20,13
1713505818581,MCWP 50R,B00,518792,Staff,3,0,20,17
1713505818581,MCWP 50R,C00,518793,Staff,5,0,20,15
1713505818581,MCWP 50R,D00,518794,Staff,0,0,20,20
1713505818581,MCWP 50R,E00,518795,Staff,0,0,20,20
1713505818581,MCWP 50R,F00,518796,Staff,11,0,20,9
1713505818581,MCWP 50R,G00,518797,Staff,10,0,20,10
1713505819608,MMW 12R,A01,514034,Herbst; Matthew,1,0,16,15
1713505819608,MMW 12R,A02,514035,Herbst; Matthew,13,0,16,3
1713505820636,MMW 13R,A01,514037,Staff,0,8,16,16
1713505820636,MMW 13R,A02,514039,Staff,0,7,16,16
1713505822685,SIO 295LS,A00,523233,Staff,15,0,30,15
1713505823713,SIO 295S,A00,523232,Staff,15,0,30,15
1713505824737,SOCI 117,A01,494376,Staff,0,2,5,5
1713505825762,WES 237B,A00,494380,Staff,19,0,20,1
1713505827827,AESE 279B,A00,494370,Wade; Jon P,33,0,33,0
1713505828855,AIP 197,001,627712,Vespa; Emanuel Ignacio,9999,0,9999,0
1713505829879,ANAR 135S,A00,494369,Braswell; Geoffrey E.,0,0,0,0
1713505830904,CAT 124RS,A01,519847,Geibel; William,6,0,20,14
1713505831930,CAT 125RS,A01,515971,Geibel; William,6,0,20,14
1713505832956,CLRE 250,A00,511389,Morris; Sheldon,9996,0,9999,3
1713505833988,CLRE 251,A00,507176,Mehta; Ravindra L.,9996,0,9999,3
1713505833988,CLRE 251,B00,511410,Mehta; Ravindra L.,9998,0,9999,1
1713505835017,CLRE 252,A00,507189,Cuomo; Raphael Eduardo,9998,0,9999,1
1713505836044,CLRE 253,A00,507199,Vaida; Florin,9997,0,9999,2
1713505836044,CLRE 253,B00,507202,Vaida; Florin,9999,0,9999,0
1713505837072,CLRE 259,A00,507211,Patel; Hemal,9996,0,9999,3
1713505838099,CLRE 260,A00,507221,Cuomo; Raphael Eduardo,9999,0,9999,0
1713505839124,CLRE 297,001,507242,Cuomo; Raphael Eduardo,9999,0,9999,0
1713505840151,CSE 191,A00,516875,Minnes Kemp; Mor Mia,9999,0,9999,0
1713505841181,CSS 201S,A01,494383,Staff,35,0,35,0
1713505842206,CSS 202S,A01,494387,Staff,35,0,35,0
1713505843232,EAP 100,A00,516065,Staff,9792,0,9999,207
1713505844262,ECE 45,A01,507414,Staff,37,0,60,23
1713505845288,ECE 100,A01,507416,Baghdadchi; Saharnaz,0,0,20,20
1713505845288,ECE 100,A02,507418,Baghdadchi; Saharnaz,19,0,20,1
1713505846314,ECE 111,A01,507420,Staff,27,0,50,23
1713505847345,ECE 197,001,548057,Sievenpiper; Daniel F.,9998,0,9999,1
1713505848370,EDS 115,A00,507243,Choi; Bailey Miyeon,27,0,28,1
1713505849397,EDS 117,A01,494379,Staff,15,0,25,10
1713505850426,EDS 125,A00,507246,Hopkins; Megan Beth,27,0,30,3
1713505851451,EDS 128A,A01,507264,Fargason; Sharon Gayle,26,0,26,0
1713505852476,EDS 128B,A01,507293,Pappas; Elizabeth,30,0,30,0
1713505853503,EDS 139,A00,507294,Fargason; Sharon Gayle,30,0,30,0
1713505853503,EDS 139,B00,507313,Pappas; Elizabeth,30,0,30,0
1713505854529,EDS 201,A00,507315,Staff,18,0,30,12
1713505855556,EDS 203,A01,507317,Halter; Christopher P.,17,0,30,13
1713505856580,EDS 204R,A01,507319,Halter; Christopher P.,0,1,30,30
1713505856580,EDS 204R,B01,507331,Heinzman; Erica M.,22,0,30,8
1713505857606,EDS 206R,A00,507332,Staff,0,2,30,30
1713505857606,EDS 206R,B00,507343,Staff,23,0,30,7
1713505858632,EDS 250,A00,507344,Hemans; Patricia Ann Benitez,27,0,40,13
1713505859657,EDS 281,A00,507345,Daly; Alan J.,18,0,18,0
1713505860682,EDS 284,A00,507350,Daly; Alan J.,16,0,16,0
1713505861711,EDS 286,A00,507359,Fine; Sarah,18,0,18,0
1713505862740,EDS 289C,A01,507361,Daly; Alan J.,18,0,18,0
1713505863768,EDS 290,A00,507366,Hofstetter; Carolyn,15,0,15,0
1713505864798,LIGM 5A,A00,507421,Fischer-Grunski; Eva K,20,0,20,0
1713505865826,LIGM 5B,A00,507423,Fischer-Grunski; Eva K,20,0,20,0
1713505866851,LIGM 5C,A00,507425,Fischer-Grunski; Eva K,20,0,20,0
1713505867877,LIIT 5AS,A00,507427,Carnelos; Chiara,20,0,20,0
1713505868903,LIIT 5BS,A00,507430,Carnelos; Chiara,20,0,20,0
1713505869932,LIIT 5CS,A00,507432,Carnelos; Chiara,20,0,20,0
1713505870961,LISP 5A,A00,507541,Munoz Sanchez; Alicia,14,0,20,6
1713505871991,LISP 5B,A00,507671,Munoz Sanchez; Alicia,12,0,20,8
1713505873022,LISP 5C,A00,507696,Munoz Sanchez; Alicia,11,0,20,9
1713505874047,MAE 197,001,528363,Boechler; Nicholas Sebastia,9998,0,9999,1
1713505875073,MATH 197,001,523477,Kedlaya; Kiran S.,9999,0,9999,0
1713505875073,MATH 197,002,563811,Zhang; Danna,9998,0,9999,1
1713505876101,MCWP 40R,A00,518780,Staff,13,0,20,7
1713505876101,MCWP 40R,B00,518781,Staff,11,0,20,9
1713505876101,MCWP 40R,C00,518783,Staff,8,0,20,12
1713505877131,MCWP 50R,A00,518791,Staff,7,0,20,13
1713505877131,MCWP 50R,B00,518792,Staff,3,0,20,17
1713505877131,MCWP 50R,C00,518793,Staff,5,0,20,15
1713505877131,MCWP 50R,D00,518794,Staff,0,0,20,20
1713505877131,MCWP 50R,E00,518795,Staff,0,0,20,20
1713505877131,MCWP 50R,F00,518796,Staff,11,0,20,9
1713505877131,MCWP 50R,G00,518797,Staff,10,0,20,10
1713505878157,MMW 12R,A01,514034,Herbst; Matthew,1,0,16,15
1713505878157,MMW 12R,A02,514035,Herbst; Matthew,13,0,16,3
1713505879182,MMW 13R,A01,514037,Staff,0,8,16,16
1713505879182,MMW 13R,A02,514039,Staff,0,7,16,16
1713505881234,SIO 295LS,A00,523233,Staff,15,0,30,15
1713505882259,SIO 295S,A00,523232,Staff,15,0,30,15
1713505883284,SOCI 117,A01,494376,Staff,0,2,5,5
1713505884363,WES 237B,A00,494380,Staff,19,0,20,1
1713505886447,AESE 279B,A00,494370,Wade; Jon P,33,0,33,0
1713505887479,AIP 197,001,627712,Vespa; Emanuel Ignacio,9999,0,9999,0
1713505888503,ANAR 135S,A00,494369,Braswell; Geoffrey E.,0,0,0,0
1713505889530,CAT 124RS,A01,519847,Geibel; William,6,0,20,14
1713505890557,CAT 125RS,A01,515971,Geibel; William,6,0,20,14
1713505891588,CLRE 250,A00,511389,Morris; Sheldon,9996,0,9999,3
1713505892614,CLRE 251,A00,507176,Mehta; Ravindra L.,9996,0,9999,3
1713505892614,CLRE 251,B00,511410,Mehta; Ravindra L.,9998,0,9999,1
1713505893639,CLRE 252,A00,507189,Cuomo; Raphael Eduardo,9998,0,9999,1
1713505894664,CLRE 253,A00,507199,Vaida; Florin,9997,0,9999,2
1713505894664,CLRE 253,B00,507202,Vaida; Florin,9999,0,9999,0
1713505895708,CLRE 259,A00,507211,Patel; Hemal,9996,0,9999,3
1713505896736,CLRE 260,A00,507221,Cuomo; Raphael Eduardo,9999,0,9999,0
1713505897764,CLRE 297,001,507242,Cuomo; Raphael Eduardo,9999,0,9999,0
1713505898794,CSE 191,A00,516875,Minnes Kemp; Mor Mia,9999,0,9999,0
1713505899823,CSS 201S,A01,494383,Staff,35,0,35,0
1713505900851,CSS 202S,A01,494387,Staff,35,0,35,0
1713505901879,EAP 100,A00,516065,Staff,9792,0,9999,207
1713505902907,ECE 45,A01,507414,Staff,37,0,60,23
1713505903933,ECE 100,A01,507416,Baghdadchi; Saharnaz,0,0,20,20
1713505903933,ECE 100,A02,507418,Baghdadchi; Saharnaz,19,0,20,1
1713505904957,ECE 111,A01,507420,Staff,27,0,50,23
1713505905982,ECE 197,001,548057,Sievenpiper; Daniel F.,9998,0,9999,1
1713505907010,EDS 115,A00,507243,Choi; Bailey Miyeon,27,0,28,1
1713505908036,EDS 117,A01,494379,Staff,15,0,25,10
1713505909061,EDS 125,A00,507246,Hopkins; Megan Beth,27,0,30,3
1713505910088,EDS 128A,A01,507264,Fargason; Sharon Gayle,26,0,26,0
1713505911116,EDS 128B,A01,507293,Pappas; Elizabeth,30,0,30,0
1713505912142,EDS 139,A00,507294,Fargason; Sharon Gayle,30,0,30,0
1713505912142,EDS 139,B00,507313,Pappas; Elizabeth,30,0,30,0
1713505913168,EDS 201,A00,507315,Staff,18,0,30,12
1713505914194,EDS 203,A01,507317,Halter; Christopher P.,17,0,30,13
1713505915220,EDS 204R,A01,507319,Halter; Christopher P.,0,1,30,30
1713505915220,EDS 204R,B01,507331,Heinzman; Erica M.,22,0,30,8
1713505916247,EDS 206R,A00,507332,Staff,0,2,30,30
1713505916247,EDS 206R,B00,507343,Staff,23,0,30,7
1713505917275,EDS 250,A00,507344,Hemans; Patricia Ann Benitez,27,0,40,13
1713505918302,EDS 281,A00,507345,Daly; Alan J.,18,0,18,0
1713505919328,EDS 284,A00,507350,Daly; Alan J.,16,0,16,0
1713505920354,EDS 286,A00,507359,Fine; Sarah,18,0,18,0
1713505921381,EDS 289C,A01,507361,Daly; Alan J.,18,0,18,0
1713505922406,EDS 290,A00,507366,Hofstetter; Carolyn,15,0,15,0
1713505923436,LIGM 5A,A00,507421,Fischer-Grunski; Eva K,20,0,20,0
1713505924460,LIGM 5B,A00,507423,Fischer-Grunski; Eva K,20,0,20,0
1713505925488,LIGM 5C,A00,507425,Fischer-Grunski; Eva K,20,0,20,0
1713505926518,LIIT 5AS,A00,507427,Carnelos; Chiara,20,0,20,0
1713505927543,LIIT 5BS,A00,507430,Carnelos; Chiara,20,0,20,0
1713505928570,LIIT 5CS,A00,507432,Carnelos; Chiara,20,0,20,0
1713505929598,LISP 5A,A00,507541,Munoz Sanchez; Alicia,14,0,20,6
1713505930624,LISP 5B,A00,507671,Munoz Sanchez; Alicia,12,0,20,8
1713505931651,LISP 5C,A00,507696,Munoz Sanchez; Alicia,11,0,20,9
1713505932677,MAE 197,001,528363,Boechler; Nicholas Sebastia,9998,0,9999,1
1713505933705,MATH 197,001,523477,Kedlaya; Kiran S.,9999,0,9999,0
1713505933705,MATH 197,002,563811,Zhang; Danna,9998,0,9999,1
1713505934731,MCWP 40R,A00,518780,Staff,13,0,20,7
1713505934731,MCWP 40R,B00,518781,Staff,11,0,20,9
1713505934731,MCWP 40R,C00,518783,Staff,8,0,20,12
1713505935756,MCWP 50R,A00,518791,Staff,7,0,20,13
1713505935756,MCWP 50R,B00,518792,Staff,3,0,20,17
1713505935756,MCWP 50R,C00,518793,Staff,5,0,20,15
1713505935756,MCWP 50R,D00,518794,Staff,0,0,20,20
1713505935756,MCWP 50R,E00,518795,Staff,0,0,20,20
1713505935756,MCWP 50R,F00,518796,Staff,11,0,20,9
1713505935756,MCWP 50R,G00,518797,Staff,10,0,20,10
1713505936785,MMW 12R,A01,514034,Herbst; Matthew,1,0,16,15
1713505936785,MMW 12R,A02,514035,Herbst; Matthew,13,0,16,3
1713505937810,MMW 13R,A01,514037,Staff,0,8,16,16
1713505937810,MMW 13R,A02,514039,Staff,0,7,16,16
1713505939864,SIO 295LS,A00,523233,Staff,15,0,30,15
1713505940889,SIO 295S,A00,523232,Staff,15,0,30,15
1713505941916,SOCI 117,A01,494376,Staff,0,2,5,5
1713505942945,WES 237B,A00,494380,Staff,19,0,20,1
1713505945012,AESE 279B,A00,494370,Wade; Jon P,33,0,33,0
1713505946037,AIP 197,001,627712,Vespa; Emanuel Ignacio,9999,0,9999,0
1713505947063,ANAR 135S,A00,494369,Braswell; Geoffrey E.,0,0,0,0
1713505948088,CAT 124RS,A01,519847,Geibel; William,6,0,20,14
1713505949116,CAT 125RS,A01,515971,Geibel; William,6,0,20,14
1713505950144,CLRE 250,A00,511389,Morris; Sheldon,9996,0,9999,3
1713505951174,CLRE 251,A00,507176,Mehta; Ravindra L.,9996,0,9999,3
1713505951174,CLRE 251,B00,511410,Mehta; Ravindra L.,9998,0,9999,1
1713505952202,CLRE 252,A00,507189,Cuomo; Raphael Eduardo,9998,0,9999,1
1713505953231,CLRE 253,A00,507199,Vaida; Florin,9997,0,9999,2
1713505953231,CLRE 253,B00,507202,Vaida; Florin,9999,0,9999,0
1713505954259,CLRE 259,A00,507211,Patel; Hemal,9996,0,9999,3
1713505955290,CLRE 260,A00,507221,Cuomo; Raphael Eduardo,9999,0,9999,0
1713505956319,CLRE 297,001,507242,Cuomo; Raphael Eduardo,9999,0,9999,0
1713505957347,CSE 191,A00,516875,Minnes Kemp; Mor Mia,9999,0,9999,0
1713505958372,CSS 201S,A01,494383,Staff,35,0,35,0
1713505959401,CSS 202S,A01,494387,Staff,35,0,35,0
1713505960426,EAP 100,A00,516065,Staff,9792,0,9999,207
1713505961452,ECE 45,A01,507414,Staff,37,0,60,23
1713505962479,ECE 100,A01,507416,Baghdadchi; Saharnaz,0,0,20,20
1713505962479,ECE 100,A02,507418,Baghdadchi; Saharnaz,19,0,20,1
1713505963504,ECE 111,A01,507420,Staff,27,0,50,23
1713505964529,ECE 197,001,548057,Sievenpiper; Daniel F.,9998,0,9999,1
1713505965554,EDS 115,A00,507243,Choi; Bailey Miyeon,27,0,28,1
1713505966578,EDS 117,A01,494379,Staff,15,0,25,10
1713505967608,EDS 125,A00,507246,Hopkins; Megan Beth,27,0,30,3
1713505968635,EDS 128A,A01,507264,Fargason; Sharon Gayle,26,0,26,0
1713505969660,EDS 128B,A01,507293,Pappas; Elizabeth,30,0,30,0
1713505970687,EDS 139,A00,507294,Fargason; Sharon Gayle,30,0,30,0
1713505970687,EDS 139,B00,507313,Pappas; Elizabeth,30,0,30,0
1713505971715,EDS 201,A00,507315,Staff,18,0,30,12
1713505972744,EDS 203,A01,507317,Halter; Christopher P.,17,0,30,13
1713505973772,EDS 204R,A01,507319,Halter; Christopher P.,0,1,30,30
1713505973772,EDS 204R,B01,507331,Heinzman; Erica M.,22,0,30,8
1713505974800,EDS 206R,A00,507332,Staff,0,2,30,30
1713505974800,EDS 206R,B00,507343,Staff,23,0,30,7
1713505975828,EDS 250,A00,507344,Hemans; Patricia Ann Benitez,27,0,40,13
1713505976853,EDS 281,A00,507345,Daly; Alan J.,18,0,18,0
1713505977881,EDS 284,A00,507350,Daly; Alan J.,16,0,16,0
1713505978905,EDS 286,A00,507359,Fine; Sarah,18,0,18,0
1713505979934,EDS 289C,A01,507361,Daly; Alan J.,18,0,18,0
1713505980962,EDS 290,A00,507366,Hofstetter; Carolyn,15,0,15,0
1713505981988,LIGM 5A,A00,507421,Fischer-Grunski; Eva K,20,0,20,0
1713505983017,LIGM 5B,A00,507423,Fischer-Grunski; Eva K,20,0,20,0
1713505984041,LIGM 5C,A00,507425,Fischer-Grunski; Eva K,20,0,20,0
1713505985070,LIIT 5AS,A00,507427,Carnelos; Chiara,20,0,20,0
1713505986099,LIIT 5BS,A00,507430,Carnelos; Chiara,20,0,20,0
1713505987127,LIIT 5CS,A00,507432,Carnelos; Chiara,20,0,20,0
1713505988208,LISP 5A,A00,507541,Munoz Sanchez; Alicia,14,0,20,6
1713505989231,LISP 5B,A00,507671,Munoz Sanchez; Alicia,12,0,20,8
1713505990261,LISP 5C,A00,507696,Munoz Sanchez; Alicia,11,0,20,9
1713505991286,MAE 197,001,528363,Boechler; Nicholas Sebastia,9998,0,9999,1
1713505992311,MATH 197,001,523477,Kedlaya; Kiran S.,9999,0,9999,0
1713505992311,MATH 197,002,563811,Zhang; Danna,9998,0,9999,1
1713505993339,MCWP 40R,A00,518780,Staff,13,0,20,7
1713505993339,MCWP 40R,B00,518781,Staff,11,0,20,9
1713505993339,MCWP 40R,C00,518783,Staff,8,0,20,12
1713505994367,MCWP 50R,A00,518791,Staff,7,0,20,13
1713505994367,MCWP 50R,B00,518792,Staff,3,0,20,17
1713505994367,MCWP 50R,C00,518793,Staff,5,0,20,15
1713505994367,MCWP 50R,D00,518794,Staff,0,0,20,20
1713505994367,MCWP 50R,E00,518795,Staff,0,0,20,20
1713505994367,MCWP 50R,F00,518796,Staff,11,0,20,9
1713505994367,MCWP 50R,G00,518797,Staff,10,0,20,10
1713505995393,MMW 12R,A01,514034,Herbst; Matthew,1,0,16,15
1713505995393,MMW 12R,A02,514035,Herbst; Matthew,13,0,16,3
1713505996420,MMW 13R,A01,514037,Staff,0,8,16,16
1713505996420,MMW 13R,A02,514039,Staff,0,7,16,16
1713505998472,SIO 295LS,A00,523233,Staff,15,0,30,15
1713505999495,SIO 295S,A00,523232,Staff,15,0,30,15
1713506000520,SOCI 117,A01,494376,Staff,0,2,5,5
1713506001545,WES 237B,A00,494380,Staff,19,0,20,1
1713506003627,AESE 279B,A00,494370,Wade; Jon P,33,0,33,0
1713506004652,AIP 197,001,627712,Vespa; Emanuel Ignacio,9999,0,9999,0
1713506005676,ANAR 135S,A00,494369,Braswell; Geoffrey E.,0,0,0,0
1713506006701,CAT 124RS,A01,519847,Geibel; William,6,0,20,14
1713506007726,CAT 125RS,A01,515971,Geibel; William,6,0,20,14
1713506008750,CLRE 250,A00,511389,Morris; Sheldon,9996,0,9999,3
1713506009777,CLRE 251,A00,507176,Mehta; Ravindra L.,9996,0,9999,3
1713506009777,CLRE 251,B00,511410,Mehta; Ravindra L.,9998,0,9999,1
1713506010803,CLRE 252,A00,507189,Cuomo; Raphael Eduardo,9998,0,9999,1
1713506011828,CLRE 253,A00,507199,Vaida; Florin,9997,0,9999,2
1713506011828,CLRE 253,B00,507202,Vaida; Florin,9999,0,9999,0
1713506012853,CLRE 259,A00,507211,Patel; Hemal,9996,0,9999,3
1713506013879,CLRE 260,A00,507221,Cuomo; Raphael Eduardo,9999,0,9999,0
1713506014905,CLRE 297,001,507242,Cuomo; Raphael Eduardo,9999,0,9999,0
1713506015934,CSE 191,A00,516875,Minnes Kemp; Mor Mia,9999,0,9999,0
1713506016963,CSS 201S,A01,494383,Staff,35,0,35,0
1713506017994,CSS 202S,A01,494387,Staff,35,0,35,0
1713506019023,EAP 100,A00,516065,Staff,9792,0,9999,207
1713506020049,ECE 45,A01,507414,Staff,37,0,60,23
1713506021075,ECE 100,A01,507416,Baghdadchi; Saharnaz,0,0,20,20
1713506021075,ECE 100,A02,507418,Baghdadchi; Saharnaz,19,0,20,1
1713506022104,ECE 111,A01,507420,Staff,27,0,50,23
1713506023129,ECE 197,001,548057,Sievenpiper; Daniel F.,9998,0,9999,1
1713506024156,EDS 115,A00,507243,Choi; Bailey Miyeon,27,0,28,1
1713506025181,EDS 117,A01,494379,Staff,15,0,25,10
1713506026206,EDS 125,A00,507246,Hopkins; Megan Beth,27,0,30,3
1713506027232,EDS 128A,A01,507264,Fargason; Sharon Gayle,26,0,26,0
1713506028259,EDS 128B,A01,507293,Pappas; Elizabeth,30,0,30,0
1713506029283,EDS 139,A00,507294,Fargason; Sharon Gayle,30,0,30,0
1713506029283,EDS 139,B00,507313,Pappas; Elizabeth,30,0,30,0
1713506030312,EDS 201,A00,507315,Staff,18,0,30,12
1713506031340,EDS 203,A01,507317,Halter; Christopher P.,17,0,30,13
1713506032364,EDS 204R,A01,507319,Halter; Christopher P.,0,1,30,30
1713506032364,EDS 204R,B01,507331,Heinzman; Erica M.,22,0,30,8
1713506033390,EDS 206R,A00,507332,Staff,0,2,30,30
1713506033390,EDS 206R,B00,507343,Staff,23,0,30,7
1713506034417,EDS 250,A00,507344,Hemans; Patricia Ann Benitez,27,0,40,13
1713506035442,EDS 281,A00,507345,Daly; Alan J.,18,0,18,0
1713506036470,EDS 284,A00,507350,Daly; Alan J.,16,0,16,0
1713506037498,EDS 286,A00,507359,Fine; Sarah,18,0,18,0
1713506038523,EDS 289C,A01,507361,Daly; Alan J.,18,0,18,0
1713506039551,EDS 290,A00,507366,Hofstetter; Carolyn,15,0,15,0
1713506040578,LIGM 5A,A00,507421,Fischer-Grunski; Eva K,20,0,20,0
1713506041604,LIGM 5B,A00,507423,Fischer-Grunski; Eva K,20,0,20,0
1713506042629,LIGM 5C,A00,507425,Fischer-Grunski; Eva K,20,0,20,0
1713506043654,LIIT 5AS,A00,507427,Carnelos; Chiara,20,0,20,0
1713506044679,LIIT 5BS,A00,507430,Carnelos; Chiara,20,0,20,0
1713506045705,LIIT 5CS,A00,507432,Carnelos; Chiara,20,0,20,0
1713506046728,LISP 5A,A00,507541,Munoz Sanchez; Alicia,14,0,20,6
1713506047756,LISP 5B,A00,507671,Munoz Sanchez; Alicia,12,0,20,8
1713506048782,LISP 5C,A00,507696,Munoz Sanchez; Alicia,11,0,20,9
1713506049811,MAE 197,001,528363,Boechler; Nicholas Sebastia,9998,0,9999,1
1713506050838,MATH 197,001,523477,Kedlaya; Kiran S.,9999,0,9999,0
1713506050838,MATH 197,002,563811,Zhang; Danna,9998,0,9999,1
1713506051867,MCWP 40R,A00,518780,Staff,13,0,20,7
1713506051867,MCWP 40R,B00,518781,Staff,11,0,20,9
1713506051867,MCWP 40R,C00,518783,Staff,8,0,20,12
1713506052892,MCWP 50R,A00,518791,Staff,7,0,20,13
1713506052892,MCWP 50R,B00,518792,Staff,3,0,20,17
1713506052892,MCWP 50R,C00,518793,Staff,5,0,20,15
1713506052892,MCWP 50R,D00,518794,Staff,0,0,20,20
1713506052892,MCWP 50R,E00,518795,Staff,0,0,20,20
1713506052892,MCWP 50R,F00,518796,Staff,11,0,20,9
1713506052892,MCWP 50R,G00,518797,Staff,10,0,20,10
1713506053921,MMW 12R,A01,514034,Herbst; Matthew,1,0,16,15
1713506053921,MMW 12R,A02,514035,Herbst; Matthew,13,0,16,3
1713506054953,MMW 13R,A01,514037,Staff,0,8,16,16
1713506054953,MMW 13R,A02,514039,Staff,0,7,16,16
1713506057010,SIO 295LS,A00,523233,Staff,15,0,30,15
1713506058036,SIO 295S,A00,523232,Staff,15,0,30,15
1713506059062,SOCI 117,A01,494376,Staff,0,2,5,5
1713506060090,WES 237B,A00,494380,Staff,19,0,20,1
1713506062159,AESE 279B,A00,494370,Wade; Jon P,33,0,33,0
1713506063186,AIP 197,001,627712,Vespa; Emanuel Ignacio,9999,0,9999,0
1713506064215,ANAR 135S,A00,494369,Braswell; Geoffrey E.,0,0,0,0
1713506065239,CAT 124RS,A01,519847,Geibel; William,6,0,20,14
1713506066264,CAT 125RS,A01,515971,Geibel; William,6,0,20,14
1713506067290,CLRE 250,A00,511389,Morris; Sheldon,9996,0,9999,3
1713506068316,CLRE 251,A00,507176,Mehta; Ravindra L.,9996,0,9999,3
1713506068316,CLRE 251,B00,511410,Mehta; Ravindra L.,9998,0,9999,1
1713506069344,CLRE 252,A00,507189,Cuomo; Raphael Eduardo,9998,0,9999,1
1713506070372,CLRE 253,A00,507199,Vaida; Florin,9997,0,9999,2
1713506070372,CLRE 253,B00,507202,Vaida; Florin,9999,0,9999,0
1713506071398,CLRE 259,A00,507211,Patel; Hemal,9996,0,9999,3
1713506072426,CLRE 260,A00,507221,Cuomo; Raphael Eduardo,9999,0,9999,0
1713506073450,CLRE 297,001,507242,Cuomo; Raphael Eduardo,9999,0,9999,0
1713506074478,CSE 191,A00,516875,Minnes Kemp; Mor Mia,9999,0,9999,0
1713506075503,CSS 201S,A01,494383,Staff,35,0,35,0
1713506076532,CSS 202S,A01,494387,Staff,35,0,35,0
1713506077555,EAP 100,A00,516065,Staff,9792,0,9999,207
1713506078582,ECE 45,A01,507414,Staff,37,0,60,23
1713506079611,ECE 100,A01,507416,Baghdadchi; Saharnaz,0,0,20,20
1713506079611,ECE 100,A02,507418,Baghdadchi; Saharnaz,19,0,20,1
1713506080639,ECE 111,A01,507420,Staff,27,0,50,23
1713506081667,ECE 197,001,548057,Sievenpiper; Daniel F.,9998,0,9999,1
1713506082698,EDS 115,A00,507243,Choi; Bailey Miyeon,27,0,28,1
1713506083723,EDS 117,A01,494379,Staff,15,0,25,10
1713506084748,EDS 125,A00,507246,Hopkins; Megan Beth,27,0,30,3
1713506085785,EDS 128A,A01,507264,Fargason; Sharon Gayle,26,0,26,0
1713506086815,EDS 128B,A01,507293,Pappas; Elizabeth,30,0,30,0
1713506087840,EDS 139,A00,507294,Fargason; Sharon Gayle,30,0,30,0
1713506087840,EDS 139,B00,507313,Pappas; Elizabeth,30,0,30,0
1713506088868,EDS 201,A00,507315,Staff,18,0,30,12
1713506089894,EDS 203,A01,507317,Halter; Christopher P.,17,0,30,13
1713506090920,EDS 204R,A01,507319,Halter; Christopher P.,0,1,30,30
1713506090920,EDS 204R,B01,507331,Heinzman; Erica M.,22,0,30,8
1713506091999,EDS 206R,A00,507332,Staff,0,2,30,30
1713506091999,EDS 206R,B00,507343,Staff,23,0,30,7
1713506093025,EDS 250,A00,507344,Hemans; Patricia Ann Benitez,27,0,40,13
1713506094056,EDS 281,A00,507345,Daly; Alan J.,18,0,18,0
1713506095080,EDS 284,A00,507350,Daly; Alan J.,16,0,16,0
1713506096106,EDS 286,A00,507359,Fine; Sarah,18,0,18,0
1713506097130,EDS 289C,A01,507361,Daly; Alan J.,18,0,18,0
1713506098155,EDS 290,A00,507366,Hofstetter; Carolyn,15,0,15,0
1713506099180,LIGM 5A,A00,507421,Fischer-Grunski; Eva K,20,0,20,0
1713506100206,LIGM 5B,A00,507423,Fischer-Grunski; Eva K,20,0,20,0
1713506101230,LIGM 5C,A00,507425,Fischer-Grunski; Eva K,20,0,20,0
1713506102255,LIIT 5AS,A00,507427,Carnelos; Chiara,20,0,20,0
1713506103281,LIIT 5BS,A00,507430,Carnelos; Chiara,20,0,20,0
1713506104306,LIIT 5CS,A00,507432,Carnelos; Chiara,20,0,20,0
1713506105332,LISP 5A,A00,507541,Munoz Sanchez; Alicia,14,0,20,6
1713506106361,LISP 5B,A00,507671,Munoz Sanchez; Alicia,12,0,20,8
1713506107384,LISP 5C,A00,507696,Munoz Sanchez; Alicia,11,0,20,9
1713506108414,MAE 197,001,528363,Boechler; Nicholas Sebastia,9998,0,9999,1
1713506109440,MATH 197,001,523477,Kedlaya; Kiran S.,9999,0,9999,0
1713506109440,MATH 197,002,563811,Zhang; Danna,9998,0,9999,1
1713506110465,MCWP 40R,A00,518780,Staff,13,0,20,7
1713506110465,MCWP 40R,B00,518781,Staff,11,0,20,9
1713506110465,MCWP 40R,C00,518783,Staff,8,0,20,12
1713506111491,MCWP 50R,A00,518791,Staff,7,0,20,13
1713506111491,MCWP 50R,B00,518792,Staff,3,0,20,17
1713506111491,MCWP 50R,C00,518793,Staff,5,0,20,15
1713506111491,MCWP 50R,D00,518794,Staff,0,0,20,20
1713506111491,MCWP 50R,E00,518795,Staff,0,0,20,20
1713506111491,MCWP 50R,F00,518796,Staff,11,0,20,9
1713506111491,MCWP 50R,G00,518797,Staff,10,0,20,10
1713506112517,MMW 12R,A01,514034,Herbst; Matthew,1,0,16,15
1713506112517,MMW 12R,A02,514035,Herbst; Matthew,13,0,16,3
1713506113543,MMW 13R,A01,514037,Staff,0,8,16,16
1713506113543,MMW 13R,A02,514039,Staff,0,7,16,16
1713506115595,SIO 295LS,A00,523233,Staff,15,0,30,15
1713506116619,SIO 295S,A00,523232,Staff,15,0,30,15
1713506117646,SOCI 117,A01,494376,Staff,0,2,5,5
1713506118670,WES 237B,A00,494380,Staff,19,0,20,1
1713506120739,AESE 279B,A00,494370,Wade; Jon P,33,0,33,0
1713506121765,AIP 197,001,627712,Vespa; Emanuel Ignacio,9999,0,9999,0
1713506122795,ANAR 135S,A00,494369,Braswell; Geoffrey E.,0,0,0,0
1713506123820,CAT 124RS,A01,519847,Geibel; William,6,0,20,14
1713506124849,CAT 125RS,A01,515971,Geibel; William,6,0,20,14
1713506125875,CLRE 250,A00,511389,Morris; Sheldon,9996,0,9999,3
1713506126902,CLRE 251,A00,507176,Mehta; Ravindra L.,9996,0,9999,3
1713506126902,CLRE 251,B00,511410,Mehta; Ravindra L.,9998,0,9999,1
1713506127928,CLRE 252,A00,507189,Cuomo; Raphael Eduardo,9998,0,9999,1
1713506128954,CLRE 253,A00,507199,Vaida; Florin,9997,0,9999,2
1713506128954,CLRE 253,B00,507202,Vaida; Florin,9999,0,9999,0
1713506129982,CLRE 259,A00,507211,Patel; Hemal,9996,0,9999,3
1713506131009,CLRE 260,A00,507221,Cuomo; Raphael Eduardo,9999,0,9999,0
1713506132038,CLRE 297,001,507242,Cuomo; Raphael Eduardo,9999,0,9999,0
1713506133067,CSE 191,A00,516875,Minnes Kemp; Mor Mia,9999,0,9999,0
1713506134095,CSS 201S,A01,494383,Staff,35,0,35,0
1713506135120,CSS 202S,A01,494387,Staff,35,0,35,0
1713506136144,EAP 100,A00,516065,Staff,9792,0,9999,207
1713506137170,ECE 45,A01,507414,Staff,37,0,60,23
1713506138199,ECE 100,A01,507416,Baghdadchi; Saharnaz,0,0,20,20
1713506138199,ECE 100,A02,507418,Baghdadchi; Saharnaz,19,0,20,1
1713506139228,ECE 111,A01,507420,Staff,27,0,50,23
1713506140254,ECE 197,001,548057,Sievenpiper; Daniel F.,9998,0,9999,1
1713506141280,EDS 115,A00,507243,Choi; Bailey Miyeon,27,0,28,1
1713506142310,EDS 117,A01,494379,Staff,15,0,25,10
1713506143337,EDS 125,A00,507246,Hopkins; Megan Beth,27,0,30,3
1713506144363,EDS 128A,A01,507264,Fargason; Sharon Gayle,26,0,26,0
1713506145388,EDS 128B,A01,507293,Pappas; Elizabeth,30,0,30,0
1713506146414,EDS 139,A00,507294,Fargason; Sharon Gayle,30,0,30,0
1713506146414,EDS 139,B00,507313,Pappas; Elizabeth,30,0,30,0
1713506147440,EDS 201,A00,507315,Staff,18,0,30,12
1713506148466,EDS 203,A01,507317,Halter; Christopher P.,17,0,30,13
1713506149491,EDS 204R,A01,507319,Halter; Christopher P.,0,1,30,30
1713506149491,EDS 204R,B01,507331,Heinzman; Erica M.,22,0,30,8
1713506150517,EDS 206R,A00,507332,Staff,0,2,30,30
1713506150517,EDS 206R,B00,507343,Staff,23,0,30,7
1713506151544,EDS 250,A00,507344,Hemans; Patricia Ann Benitez,27,0,40,13
1713506152570,EDS 281,A00,507345,Daly; Alan J.,18,0,18,0
1713506153598,EDS 284,A00,507350,Daly; Alan J.,16,0,16,0
1713506154628,EDS 286,A00,507359,Fine; Sarah,18,0,18,0
1713506155651,EDS 289C,A01,507361,Daly; Alan J.,18,0,18,0
1713506156680,EDS 290,A00,507366,Hofstetter; Carolyn,15,0,15,0
1713506157707,LIGM 5A,A00,507421,Fischer-Grunski; Eva K,20,0,20,0
1713506158733,LIGM 5B,A00,507423,Fischer-Grunski; Eva K,20,0,20,0
1713506159759,LIGM 5C,A00,507425,Fischer-Grunski; Eva K,20,0,20,0
1713506160789,LIIT 5AS,A00,507427,Carnelos; Chiara,20,0,20,0
1713506161815,LIIT 5BS,A00,507430,Carnelos; Chiara,20,0,20,0
1713506162841,LIIT 5CS,A00,507432,Carnelos; Chiara,20,0,20,0
1713506163870,LISP 5A,A00,507541,Munoz Sanchez; Alicia,14,0,20,6
1713506164896,LISP 5B,A00,507671,Munoz Sanchez; Alicia,12,0,20,8
1713506165927,LISP 5C,A00,507696,Munoz Sanchez; Alicia,11,0,20,9
1713506166953,MAE 197,001,528363,Boechler; Nicholas Sebastia,9998,0,9999,1
1713506167979,MATH 197,001,523477,Kedlaya; Kiran S.,9999,0,9999,0
1713506167979,MATH 197,002,563811,Zhang; Danna,9998,0,9999,1
1713506169004,MCWP 40R,A00,518780,Staff,13,0,20,7
1713506169004,MCWP 40R,B00,518781,Staff,11,0,20,9
1713506169004,MCWP 40R,C00,518783,Staff,8,0,20,12
1713506170030,MCWP 50R,A00,518791,Staff,7,0,20,13
1713506170030,MCWP 50R,B00,518792,Staff,3,0,20,17
1713506170030,MCWP 50R,C00,518793,Staff,5,0,20,15
1713506170030,MCWP 50R,D00,518794,Staff,0,0,20,20
1713506170030,MCWP 50R,E00,518795,Staff,0,0,20,20
1713506170030,MCWP 50R,F00,518796,Staff,11,0,20,9
1713506170030,MCWP 50R,G00,518797,Staff,10,0,20,10
1713506171059,MMW 12R,A01,514034,Herbst; Matthew,1,0,16,15
1713506171059,MMW 12R,A02,514035,Herbst; Matthew,13,0,16,3
1713506172086,MMW 13R,A01,514037,Staff,0,8,16,16
1713506172086,MMW 13R,A02,514039,Staff,0,7,16,16
1713506174139,SIO 295LS,A00,523233,Staff,15,0,30,15
1713506175169,SIO 295S,A00,523232,Staff,15,0,30,15
1713506176197,SOCI 117,A01,494376,Staff,0,2,5,5
1713506177224,WES 237B,A00,494380,Staff,19,0,20,1
1713506179288,AESE 279B,A00,494370,Wade; Jon P,33,0,33,0
1713506180312,AIP 197,001,627712,Vespa; Emanuel Ignacio,9999,0,9999,0
1713506181336,ANAR 135S,A00,494369,Braswell; Geoffrey E.,0,0,0,0
1713506182361,CAT 124RS,A01,519847,Geibel; William,6,0,20,14
1713506183388,CAT 125RS,A01,515971,Geibel; William,6,0,20,14
1713506184415,CLRE 250,A00,511389,Morris; Sheldon,9996,0,9999,3
1713506185440,CLRE 251,A00,507176,Mehta; Ravindra L.,9996,0,9999,3
1713506185440,CLRE 251,B00,511410,Mehta; Ravindra L.,9998,0,9999,1
1713506186467,CLRE 252,A00,507189,Cuomo; Raphael Eduardo,9998,0,9999,1
1713506187494,CLRE 253,A00,507199,Vaida; Florin,9997,0,9999,2
1713506187494,CLRE 253,B00,507202,Vaida; Florin,9999,0,9999,0
1713506188523,CLRE 259,A00,507211,Patel; Hemal,9996,0,9999,3
1713506189548,CLRE 260,A00,507221,Cuomo; Raphael Eduardo,9999,0,9999,0
1713506190576,CLRE 297,001,507242,Cuomo; Raphael Eduardo,9999,0,9999,0
1713506191602,CSE 191,A00,516875,Minnes Kemp; Mor Mia,9999,0,9999,0
1713506192627,CSS 201S,A01,494383,Staff,35,0,35,0
1713506193653,CSS 202S,A01,494387,Staff,35,0,35,0
1713506194677,EAP 100,A00,516065,Staff,9792,0,9999,207
1713506195757,ECE 45,A01,507414,Staff,37,0,60,23
1713506196782,ECE 100,A01,507416,Baghdadchi; Saharnaz,0,0,20,20
1713506196782,ECE 100,A02,507418,Baghdadchi; Saharnaz,19,0,20,1
1713506197808,ECE 111,A01,507420,Staff,27,0,50,23
1713506198833,ECE 197,001,548057,Sievenpiper; Daniel F.,9998,0,9999,1
1713506199859,EDS 115,A00,507243,Choi; Bailey Miyeon,27,0,28,1
1713506200883,EDS 117,A01,494379,Staff,15,0,25,10
1713506201912,EDS 125,A00,507246,Hopkins; Megan Beth,27,0,30,3
1713506202937,EDS 128A,A01,507264,Fargason; Sharon Gayle,26,0,26,0
1713506203962,EDS 128B,A01,507293,Pappas; Elizabeth,30,0,30,0
1713506204987,EDS 139,A00,507294,Fargason; Sharon Gayle,30,0,30,0
1713506204987,EDS 139,B00,507313,Pappas; Elizabeth,30,0,30,0
1713506206015,EDS 201,A00,507315,Staff,18,0,30,12
1713506207040,EDS 203,A01,507317,Halter; Christopher P.,17,0,30,13
1713506208065,EDS 204R,A01,507319,Halter; Christopher P.,0,1,30,30
1713506208065,EDS 204R,B01,507331,Heinzman; Erica M.,22,0,30,8
1713506209090,EDS 206R,A00,507332,Staff,0,2,30,30
1713506209090,EDS 206R,B00,507343,Staff,23,0,30,7
1713506210118,EDS 250,A00,507344,Hemans; Patricia Ann Benitez,27,0,40,13
1713506211142,EDS 281,A00,507345,Daly; Alan J.,18,0,18,0
1713506212169,EDS 284,A00,507350,Daly; Alan J.,16,0,16,0
1713506213197,EDS 286,A00,507359,Fine; Sarah,18,0,18,0
1713506214220,EDS 289C,A01,507361,Daly; Alan J.,18,0,18,0
1713506215247,EDS 290,A00,507366,Hofstetter; Carolyn,15,0,15,0
1713506216273,LIGM 5A,A00,507421,Fischer-Grunski; Eva K,20,0,20,0
1713506217304,LIGM 5B,A00,507423,Fischer-Grunski; Eva K,20,0,20,0
1713506218336,LIGM 5C,A00,507425,Fischer-Grunski; Eva K,20,0,20,0
1713506219364,LIIT 5AS,A00,507427,Carnelos; Chiara,20,0,20,0
1713506220394,LIIT 5BS,A00,507430,Carnelos; Chiara,20,0,20,0
1713506221419,LIIT 5CS,A00,507432,Carnelos; Chiara,20,0,20,0
1713506222443,LISP 5A,A00,507541,Munoz Sanchez; Alicia,14,0,20,6
1713506223472,LISP 5B,A00,507671,Munoz Sanchez; Alicia,12,0,20,8
1713506224497,LISP 5C,A00,507696,Munoz Sanchez; Alicia,11,0,20,9
1713506225523,MAE 197,001,528363,Boechler; Nicholas Sebastia,9998,0,9999,1
1713506226551,MATH 197,001,523477,Kedlaya; Kiran S.,9999,0,9999,0
1713506226551,MATH 197,002,563811,Zhang; Danna,9998,0,9999,1
1713506227583,MCWP 40R,A00,518780,Staff,13,0,20,7
1713506227583,MCWP 40R,B00,518781,Staff,11,0,20,9
1713506227583,MCWP 40R,C00,518783,Staff,8,0,20,12
1713506228612,MCWP 50R,A00,518791,Staff,7,0,20,13
1713506228612,MCWP 50R,B00,518792,Staff,3,0,20,17
1713506228612,MCWP 50R,C00,518793,Staff,5,0,20,15
1713506228612,MCWP 50R,D00,518794,Staff,0,0,20,20
1713506228612,MCWP 50R,E00,518795,Staff,0,0,20,20
1713506228612,MCWP 50R,F00,518796,Staff,11,0,20,9
1713506228612,MCWP 50R,G00,518797,Staff,10,0,20,10
1713506229638,MMW 12R,A01,514034,Herbst; Matthew,1,0,16,15
1713506229638,MMW 12R,A02,514035,Herbst; Matthew,13,0,16,3
1713506230665,MMW 13R,A01,514037,Staff,0,8,16,16
1713506230665,MMW 13R,A02,514039,Staff,0,7,16,16
1713506232721,SIO 295LS,A00,523233,Staff,15,0,30,15
1713506233746,SIO 295S,A00,523232,Staff,15,0,30,15
1713506234774,SOCI 117,A01,494376,Staff,0,2,5,5
1713506235798,WES 237B,A00,494380,Staff,19,0,20,1
1713506237865,AESE 279B,A00,494370,Wade; Jon P,33,0,33,0
1713506238893,AIP 197,001,627712,Vespa; Emanuel Ignacio,9999,0,9999,0
1713506239921,ANAR 135S,A00,494369,Braswell; Geoffrey E.,0,0,0,0
1713506240945,CAT 124RS,A01,519847,Geibel; William,6,0,20,14
1713506241970,CAT 125RS,A01,515971,Geibel; William,6,0,20,14
1713506242995,CLRE 250,A00,511389,Morris; Sheldon,9996,0,9999,3
1713506244031,CLRE 251,A00,507176,Mehta; Ravindra L.,9996,0,9999,3
1713506244031,CLRE 251,B00,511410,Mehta; Ravindra L.,9998,0,9999,1
1713506245055,CLRE 252,A00,507189,Cuomo; Raphael Eduardo,9998,0,9999,1
1713506246082,CLRE 253,A00,507199,Vaida; Florin,9997,0,9999,2
1713506246082,CLRE 253,B00,507202,Vaida; Florin,9999,0,9999,0
1713506247110,CLRE 259,A00,507211,Patel; Hemal,9996,0,9999,3
1713506248135,CLRE 260,A00,507221,Cuomo; Raphael Eduardo,9999,0,9999,0
1713506249159,CLRE 297,001,507242,Cuomo; Raphael Eduardo,9999,0,9999,0
1713506250190,CSE 191,A00,516875,Minnes Kemp; Mor Mia,9999,0,9999,0
1713506251217,CSS 201S,A01,494383,Staff,35,0,35,0
1713506252246,CSS 202S,A01,494387,Staff,35,0,35,0
1713506253270,EAP 100,A00,516065,Staff,9792,0,9999,207
1713506254301,ECE 45,A01,507414,Staff,37,0,60,23
1713506255327,ECE 100,A01,507416,Baghdadchi; Saharnaz,0,0,20,20
1713506255327,ECE 100,A02,507418,Baghdadchi; Saharnaz,19,0,20,1
1713506256351,ECE 111,A01,507420,Staff,27,0,50,23
1713506257379,ECE 197,001,548057,Sievenpiper; Daniel F.,9998,0,9999,1
1713506258407,EDS 115,A00,507243,Choi; Bailey Miyeon,27,0,28,1
1713506259438,EDS 117,A01,494379,Staff,15,0,25,10
1713506260463,EDS 125,A00,507246,Hopkins; Megan Beth,27,0,30,3
1713506261490,EDS 128A,A01,507264,Fargason; Sharon Gayle,26,0,26,0
1713506262516,EDS 128B,A01,507293,Pappas; Elizabeth,30,0,30,0
1713506263543,EDS 139,A00,507294,Fargason; Sharon Gayle,30,0,30,0
1713506263543,EDS 139,B00,507313,Pappas; Elizabeth,30,0,30,0
1713506264573,EDS 201,A00,507315,Staff,18,0,30,12
1713506265602,EDS 203,A01,507317,Halter; Christopher P.,17,0,30,13
1713506266632,EDS 204R,A01,507319,Halter; Christopher P.,0,1,30,30
1713506266632,EDS 204R,B01,507331,Heinzman; Erica M.,22,0,30,8
1713506267658,EDS 206R,A00,507332,Staff,0,2,30,30
1713506267658,EDS 206R,B00,507343,Staff,23,0,30,7
1713506268687,EDS 250,A00,507344,Hemans; Patricia Ann Benitez,27,0,40,13
1713506269715,EDS 281,A00,507345,Daly; Alan J.,18,0,18,0
1713506270740,EDS 284,A00,507350,Daly; Alan J.,16,0,16,0
1713506271766,EDS 286,A00,507359,Fine; Sarah,18,0,18,0
1713506272794,EDS 289C,A01,507361,Daly; Alan J.,18,0,18,0
1713506273821,EDS 290,A00,507366,Hofstetter; Carolyn,15,0,15,0
1713506274847,LIGM 5A,A00,507421,Fischer-Grunski; Eva K,20,0,20,0
1713506275879,LIGM 5B,A00,507423,Fischer-Grunski; Eva K,20,0,20,0
1713506276905,LIGM 5C,A00,507425,Fischer-Grunski; Eva K,20,0,20,0
1713506277935,LIIT 5AS,A00,507427,Carnelos; Chiara,20,0,20,0
1713506278963,LIIT 5BS,A00,507430,Carnelos; Chiara,20,0,20,0
1713506279988,LIIT 5CS,A00,507432,Carnelos; Chiara,20,0,20,0
1713506281015,LISP 5A,A00,507541,Munoz Sanchez; Alicia,14,0,20,6
1713506282043,LISP 5B,A00,507671,Munoz Sanchez; Alicia,12,0,20,8
1713506283069,LISP 5C,A00,507696,Munoz Sanchez; Alicia,11,0,20,9
1713506284093,MAE 197,001,528363,Boechler; Nicholas Sebastia,9998,0,9999,1
1713506285119,MATH 197,001,523477,Kedlaya; Kiran S.,9999,0,9999,0
1713506285119,MATH 197,002,563811,Zhang; Danna,9998,0,9999,1
1713506286145,MCWP 40R,A00,518780,Staff,13,0,20,7
1713506286145,MCWP 40R,B00,518781,Staff,11,0,20,9
1713506286145,MCWP 40R,C00,518783,Staff,8,0,20,12
1713506287172,MCWP 50R,A00,518791,Staff,7,0,20,13
1713506287172,MCWP 50R,B00,518792,Staff,3,0,20,17
1713506287172,MCWP 50R,C00,518793,Staff,5,0,20,15
1713506287172,MCWP 50R,D00,518794,Staff,0,0,20,20
1713506287172,MCWP 50R,E00,518795,Staff,0,0,20,20
1713506287172,MCWP 50R,F00,518796,Staff,11,0,20,9
1713506287172,MCWP 50R,G00,518797,Staff,10,0,20,10
1713506288201,MMW 12R,A01,514034,Herbst; Matthew,1,0,16,15
1713506288201,MMW 12R,A02,514035,Herbst; Matthew,13,0,16,3
1713506289224,MMW 13R,A01,514037,Staff,0,8,16,16
1713506289224,MMW 13R,A02,514039,Staff,0,7,16,16
1713506291280,SIO 295LS,A00,523233,Staff,15,0,30,15
1713506292306,SIO 295S,A00,523232,Staff,15,0,30,15
1713506293332,SOCI 117,A01,494376,Staff,0,2,5,5
1713506294361,WES 237B,A00,494380,Staff,19,0,20,1
1713506296436,AESE 279B,A00,494370,Wade; Jon P,33,0,33,0
1713506297461,AIP 197,001,627712,Vespa; Emanuel Ignacio,9999,0,9999,0
1713506298488,ANAR 135S,A00,494369,Braswell; Geoffrey E.,0,0,0,0
1713506299569,CAT 124RS,A01,519847,Geibel; William,6,0,20,14
1713506300597,CAT 125RS,A01,515971,Geibel; William,6,0,20,14
1713506301621,CLRE 250,A00,511389,Morris; Sheldon,9996,0,9999,3
1713506302650,CLRE 251,A00,507176,Mehta; Ravindra L.,9996,0,9999,3
1713506302650,CLRE 251,B00,511410,Mehta; Ravindra L.,9998,0,9999,1
1713506303676,CLRE 252,A00,507189,Cuomo; Raphael Eduardo,9998,0,9999,1
1713506304705,CLRE 253,A00,507199,Vaida; Florin,9997,0,9999,2
1713506304705,CLRE 253,B00,507202,Vaida; Florin,9999,0,9999,0
1713506305729,CLRE 259,A00,507211,Patel; Hemal,9996,0,9999,3
1713506306756,CLRE 260,A00,507221,Cuomo; Raphael Eduardo,9999,0,9999,0
1713506307782,CLRE 297,001,507242,Cuomo; Raphael Eduardo,9999,0,9999,0
1713506308808,CSE 191,A00,516875,Minnes Kemp; Mor Mia,9999,0,9999,0
1713506309838,CSS 201S,A01,494383,Staff,35,0,35,0
1713506310865,CSS 202S,A01,494387,Staff,35,0,35,0
1713506311894,EAP 100,A00,516065,Staff,9792,0,9999,207
1713506312923,ECE 45,A01,507414,Staff,37,0,60,23
1713506313954,ECE 100,A01,507416,Baghdadchi; Saharnaz,0,0,20,20
1713506313954,ECE 100,A02,507418,Baghdadchi; Saharnaz,19,0,20,1
1713506314978,ECE 111,A01,507420,Staff,27,0,50,23
1713506316008,ECE 197,001,548057,Sievenpiper; Daniel F.,9998,0,9999,1
1713506317035,EDS 115,A00,507243,Choi; Bailey Miyeon,27,0,28,1
1713506318062,EDS 117,A01,494379,Staff,15,0,25,10
1713506319087,EDS 125,A00,507246,Hopkins; Megan Beth,27,0,30,3
1713506320116,EDS 128A,A01,507264,Fargason; Sharon Gayle,26,0,26,0
1713506321142,EDS 128B,A01,507293,Pappas; Elizabeth,30,0,30,0
1713506322171,EDS 139,A00,507294,Fargason; Sharon Gayle,30,0,30,0
1713506322171,EDS 139,B00,507313,Pappas; Elizabeth,30,0,30,0
1713506323194,EDS 201,A00,507315,Staff,18,0,30,12
1713506324222,EDS 203,A01,507317,Halter; Christopher P.,17,0,30,13
1713506325247,EDS 204R,A01,507319,Halter; Christopher P.,0,1,30,30
1713506325247,EDS 204R,B01,507331,Heinzman; Erica M.,22,0,30,8
1713506326272,EDS 206R,A00,507332,Staff,0,2,30,30
1713506326272,EDS 206R,B00,507343,Staff,23,0,30,7
1713506327302,EDS 250,A00,507344,Hemans; Patricia Ann Benitez,27,0,40,13
1713506328328,EDS 281,A00,507345,Daly; Alan J.,18,0,18,0
1713506329354,EDS 284,A00,507350,Daly; Alan J.,16,0,16,0
1713506330379,EDS 286,A00,507359,Fine; Sarah,18,0,18,0
1713506331405,EDS 289C,A01,507361,Daly; Alan J.,18,0,18,0
1713506332434,EDS 290,A00,507366,Hofstetter; Carolyn,15,0,15,0
1713506333464,LIGM 5A,A00,507421,Fischer-Grunski; Eva K,20,0,20,0
1713506334490,LIGM 5B,A00,507423,Fischer-Grunski; Eva K,20,0,20,0
1713506335519,LIGM 5C,A00,507425,Fischer-Grunski; Eva K,20,0,20,0
1713506336544,LIIT 5AS,A00,507427,Carnelos; Chiara,20,0,20,0
1713506337571,LIIT 5BS,A00,507430,Carnelos; Chiara,20,0,20,0
1713506338597,LIIT 5CS,A00,507432,Carnelos; Chiara,20,0,20,0
1713506339629,LISP 5A,A00,507541,Munoz Sanchez; Alicia,14,0,20,6
1713506340658,LISP 5B,A00,507671,Munoz Sanchez; Alicia,12,0,20,8
1713506341686,LISP 5C,A00,507696,Munoz Sanchez; Alicia,11,0,20,9
1713506342713,MAE 197,001,528363,Boechler; Nicholas Sebastia,9998,0,9999,1
1713506343743,MATH 197,001,523477,Kedlaya; Kiran S.,9999,0,9999,0
1713506343743,MATH 197,002,563811,Zhang; Danna,9998,0,9999,1
1713506344768,MCWP 40R,A00,518780,Staff,13,0,20,7
1713506344768,MCWP 40R,B00,518781,Staff,11,0,20,9
1713506344768,MCWP 40R,C00,518783,Staff,8,0,20,12
1713506345796,MCWP 50R,A00,518791,Staff,7,0,20,13
1713506345796,MCWP 50R,B00,518792,Staff,3,0,20,17
1713506345796,MCWP 50R,C00,518793,Staff,5,0,20,15
1713506345796,MCWP 50R,D00,518794,Staff,0,0,20,20
1713506345796,MCWP 50R,E00,518795,Staff,0,0,20,20
1713506345796,MCWP 50R,F00,518796,Staff,11,0,20,9
1713506345796,MCWP 50R,G00,518797,Staff,10,0,20,10
1713506346824,MMW 12R,A01,514034,Herbst; Matthew,1,0,16,15
1713506346824,MMW 12R,A02,514035,Herbst; Matthew,13,0,16,3
1713506347854,MMW 13R,A01,514037,Staff,0,8,16,16
1713506347854,MMW 13R,A02,514039,Staff,0,7,16,16
1713506349910,SIO 295LS,A00,523233,Staff,15,0,30,15
1713506350935,SIO 295S,A00,523232,Staff,15,0,30,15
1713506351960,SOCI 117,A01,494376,Staff,0,2,5,5
1713506352985,WES 237B,A00,494380,Staff,19,0,20,1
1713506355063,AESE 279B,A00,494370,Wade; Jon P,33,0,33,0
1713506356088,AIP 197,001,627712,Vespa; Emanuel Ignacio,9999,0,9999,0
1713506357115,ANAR 135S,A00,494369,Braswell; Geoffrey E.,0,0,0,0
1713506358143,CAT 124RS,A01,519847,Geibel; William,6,0,20,14
1713506359169,CAT 125RS,A01,515971,Geibel; William,6,0,20,14
1713506360195,CLRE 250,A00,511389,Morris; Sheldon,9996,0,9999,3
1713506361225,CLRE 251,A00,507176,Mehta; Ravindra L.,9996,0,9999,3
1713506361225,CLRE 251,B00,511410,Mehta; Ravindra L.,9998,0,9999,1
1713506362254,CLRE 252,A00,507189,Cuomo; Raphael Eduardo,9998,0,9999,1
1713506363280,CLRE 253,A00,507199,Vaida; Florin,9997,0,9999,2
1713506363280,CLRE 253,B00,507202,Vaida; Florin,9999,0,9999,0
1713506364305,CLRE 259,A00,507211,Patel; Hemal,9996,0,9999,3
1713506365329,CLRE 260,A00,507221,Cuomo; Raphael Eduardo,9999,0,9999,0
1713506366359,CLRE 297,001,507242,Cuomo; Raphael Eduardo,9999,0,9999,0
1713506367385,CSE 191,A00,516875,Minnes Kemp; Mor Mia,9999,0,9999,0
1713506368410,CSS 201S,A01,494383,Staff,35,0,35,0
1713506369435,CSS 202S,A01,494387,Staff,35,0,35,0
1713506370461,EAP 100,A00,516065,Staff,9792,0,9999,207
1713506371488,ECE 45,A01,507414,Staff,37,0,60,23
1713506372517,ECE 100,A01,507416,Baghdadchi; Saharnaz,0,0,20,20
1713506372517,ECE 100,A02,507418,Baghdadchi; Saharnaz,19,0,20,1
1713506373545,ECE 111,A01,507420,Staff,27,0,50,23
1713506374573,ECE 197,001,548057,Sievenpiper; Daniel F.,9998,0,9999,1
1713506375598,EDS 115,A00,507243,Choi; Bailey Miyeon,27,0,28,1
1713506376626,EDS 117,A01,494379,Staff,15,0,25,10
1713506377652,EDS 125,A00,507246,Hopkins; Megan Beth,27,0,30,3
1713506378680,EDS 128A,A01,507264,Fargason; Sharon Gayle,26,0,26,0
1713506379708,EDS 128B,A01,507293,Pappas; Elizabeth,30,0,30,0
1713506380737,EDS 139,A00,507294,Fargason; Sharon Gayle,30,0,30,0
1713506380737,EDS 139,B00,507313,Pappas; Elizabeth,30,0,30,0
1713506381766,EDS 201,A00,507315,Staff,18,0,30,12
1713506382796,EDS 203,A01,507317,Halter; Christopher P.,17,0,30,13
1713506383821,EDS 204R,A01,507319,Halter; Christopher P.,0,1,30,30
1713506383821,EDS 204R,B01,507331,Heinzman; Erica M.,22,0,30,8
1713506384850,EDS 206R,A00,507332,Staff,0,2,30,30
1713506384850,EDS 206R,B00,507343,Staff,23,0,30,7
1713506385875,EDS 250,A00,507344,Hemans; Patricia Ann Benitez,27,0,40,13
1713506386904,EDS 281,A00,507345,Daly; Alan J.,18,0,18,0
1713506387931,EDS 284,A00,507350,Daly; Alan J.,16,0,16,0
1713506388958,EDS 286,A00,507359,Fine; Sarah,18,0,18,0
1713506389983,EDS 289C,A01,507361,Daly; Alan J.,18,0,18,0
1713506391012,EDS 290,A00,507366,Hofstetter; Carolyn,15,0,15,0
1713506392037,LIGM 5A,A00,507421,Fischer-Grunski; Eva K,20,0,20,0
1713506393062,LIGM 5B,A00,507423,Fischer-Grunski; Eva K,20,0,20,0
1713506394087,LIGM 5C,A00,507425,Fischer-Grunski; Eva K,20,0,20,0
1713506395112,LIIT 5AS,A00,507427,Carnelos; Chiara,20,0,20,0
1713506396139,LIIT 5BS,A00,507430,Carnelos; Chiara,20,0,20,0
1713506397165,LIIT 5CS,A00,507432,Carnelos; Chiara,20,0,20,0
1713506398192,LISP 5A,A00,507541,Munoz Sanchez; Alicia,14,0,20,6
1713506399222,LISP 5B,A00,507671,Munoz Sanchez; Alicia,12,0,20,8
1713506400249,LISP 5C,A00,507696,Munoz Sanchez; Alicia,11,0,20,9
1713506401273,MAE 197,001,528363,Boechler; Nicholas Sebastia,9998,0,9999,1
1713506402300,MATH 197,001,523477,Kedlaya; Kiran S.,9999,0,9999,0
1713506402300,MATH 197,002,563811,Zhang; Danna,9998,0,9999,1
1713506403382,MCWP 40R,A00,518780,Staff,13,0,20,7
1713506403382,MCWP 40R,B00,518781,Staff,11,0,20,9
1713506403382,MCWP 40R,C00,518783,Staff,8,0,20,12
1713506404655,MCWP 50R,A00,518791,Staff,7,0,20,13
1713506404655,MCWP 50R,B00,518792,Staff,3,0,20,17
1713506404655,MCWP 50R,C00,518793,Staff,5,0,20,15
1713506404655,MCWP 50R,D00,518794,Staff,0,0,20,20
1713506404655,MCWP 50R,E00,518795,Staff,0,0,20,20
1713506404655,MCWP 50R,F00,518796,Staff,11,0,20,9
1713506404655,MCWP 50R,G00,518797,Staff,10,0,20,10
1713506405680,MMW 12R,A01,514034,Herbst; Matthew,1,0,16,15
1713506405680,MMW 12R,A02,514035,Herbst; Matthew,13,0,16,3
1713506406705,MMW 13R,A01,514037,Staff,0,8,16,16
1713506406705,MMW 13R,A02,514039,Staff,0,7,16,16
1713506408758,SIO 295LS,A00,523233,Staff,15,0,30,15
1713506409782,SIO 295S,A00,523232,Staff,15,0,30,15
1713506410811,SOCI 117,A01,494376,Staff,0,2,5,5
1713506411836,WES 237B,A00,494380,Staff,19,0,20,1
1713506413908,AESE 279B,A00,494370,Wade; Jon P,33,0,33,0
1713506414933,AIP 197,001,627712,Vespa; Emanuel Ignacio,9999,0,9999,0
1713506415961,ANAR 135S,A00,494369,Braswell; Geoffrey E.,0,0,0,0
1713506416989,CAT 124RS,A01,519847,Geibel; William,6,0,20,14
1713506418017,CAT 125RS,A01,515971,Geibel; William,6,0,20,14
1713506419042,CLRE 250,A00,511389,Morris; Sheldon,9996,0,9999,3
1713506420070,CLRE 251,A00,507176,Mehta; Ravindra L.,9996,0,9999,3
1713506420070,CLRE 251,B00,511410,Mehta; Ravindra L.,9998,0,9999,1
1713506421095,CLRE 252,A00,507189,Cuomo; Raphael Eduardo,9998,0,9999,1
1713506422124,CLRE 253,A00,507199,Vaida; Florin,9997,0,9999,2
1713506422124,CLRE 253,B00,507202,Vaida; Florin,9999,0,9999,0
1713506423152,CLRE 259,A00,507211,Patel; Hemal,9996,0,9999,3
1713506424181,CLRE 260,A00,507221,Cuomo; Raphael Eduardo,9999,0,9999,0
1713506425206,CLRE 297,001,507242,Cuomo; Raphael Eduardo,9999,0,9999,0
1713506426234,CSE 191,A00,516875,Minnes Kemp; Mor Mia,9999,0,9999,0
1713506427262,CSS 201S,A01,494383,Staff,35,0,35,0
1713506428286,CSS 202S,A01,494387,Staff,35,0,35,0
1713506429311,EAP 100,A00,516065,Staff,9792,0,9999,207
1713506430341,ECE 45,A01,507414,Staff,37,0,60,23
1713506431368,ECE 100,A01,507416,Baghdadchi; Saharnaz,0,0,20,20
1713506431368,ECE 100,A02,507418,Baghdadchi; Saharnaz,19,0,20,1
1713506432394,ECE 111,A01,507420,Staff,27,0,50,23
1713506433423,ECE 197,001,548057,Sievenpiper; Daniel F.,9998,0,9999,1
1713506434452,EDS 115,A00,507243,Choi; Bailey Miyeon,27,0,28,1
1713506435480,EDS 117,A01,494379,Staff,15,0,25,10
1713506436506,EDS 125,A00,507246,Hopkins; Megan Beth,27,0,30,3
1713506437535,EDS 128A,A01,507264,Fargason; Sharon Gayle,26,0,26,0
1713506438560,EDS 128B,A01,507293,Pappas; Elizabeth,30,0,30,0
1713506439590,EDS 139,A00,507294,Fargason; Sharon Gayle,30,0,30,0
1713506439590,EDS 139,B00,507313,Pappas; Elizabeth,30,0,30,0
1713506440615,EDS 201,A00,507315,Staff,18,0,30,12
1713506441644,EDS 203,A01,507317,Halter; Christopher P.,17,0,30,13
1713506442670,EDS 204R,A01,507319,Halter; Christopher P.,0,1,30,30
1713506442670,EDS 204R,B01,507331,Heinzman; Erica M.,22,0,30,8
1713506443696,EDS 206R,A00,507332,Staff,0,2,30,30
1713506443696,EDS 206R,B00,507343,Staff,23,0,30,7
1713506444724,EDS 250,A00,507344,Hemans; Patricia Ann Benitez,27,0,40,13
1713506445752,EDS 281,A00,507345,Daly; Alan J.,18,0,18,0
1713506446779,EDS 284,A00,507350,Daly; Alan J.,16,0,16,0
1713506447805,EDS 286,A00,507359,Fine; Sarah,18,0,18,0
1713506448830,EDS 289C,A01,507361,Daly; Alan J.,18,0,18,0
1713506449857,EDS 290,A00,507366,Hofstetter; Carolyn,15,0,15,0
1713506450887,LIGM 5A,A00,507421,Fischer-Grunski; Eva K,20,0,20,0
1713506451914,LIGM 5B,A00,507423,Fischer-Grunski; Eva K,20,0,20,0
1713506452940,LIGM 5C,A00,507425,Fischer-Grunski; Eva K,20,0,20,0
1713506453969,LIIT 5AS,A00,507427,Carnelos; Chiara,20,0,20,0
1713506454998,LIIT 5BS,A00,507430,Carnelos; Chiara,20,0,20,0
1713506456024,LIIT 5CS,A00,507432,Carnelos; Chiara,20,0,20,0
1713506457054,LISP 5A,A00,507541,Munoz Sanchez; Alicia,14,0,20,6
1713506458083,LISP 5B,A00,507671,Munoz Sanchez; Alicia,12,0,20,8
1713506459109,LISP 5C,A00,507696,Munoz Sanchez; Alicia,11,0,20,9
1713506460179,MAE 197,001,528363,Boechler; Nicholas Sebastia,9998,0,9999,1
1713506461208,MATH 197,001,523477,Kedlaya; Kiran S.,9999,0,9999,0
1713506461208,MATH 197,002,563811,Zhang; Danna,9998,0,9999,1
1713506462236,MCWP 40R,A00,518780,Staff,13,0,20,7
1713506462236,MCWP 40R,B00,518781,Staff,11,0,20,9
1713506462236,MCWP 40R,C00,518783,Staff,8,0,20,12
1713506463267,MCWP 50R,A00,518791,Staff,7,0,20,13
1713506463267,MCWP 50R,B00,518792,Staff,3,0,20,17
1713506463267,MCWP 50R,C00,518793,Staff,5,0,20,15
1713506463267,MCWP 50R,D00,518794,Staff,0,0,20,20
1713506463267,MCWP 50R,E00,518795,Staff,0,0,20,20
1713506463267,MCWP 50R,F00,518796,Staff,11,0,20,9
1713506463267,MCWP 50R,G00,518797,Staff,10,0,20,10
1713506464296,MMW 12R,A01,514034,Herbst; Matthew,1,0,16,15
1713506464296,MMW 12R,A02,514035,Herbst; Matthew,13,0,16,3
1713506465325,MMW 13R,A01,514037,Staff,0,8,16,16
1713506465325,MMW 13R,A02,514039,Staff,0,7,16,16
1713506467379,SIO 295LS,A00,523233,Staff,15,0,30,15
1713506468404,SIO 295S,A00,523232,Staff,15,0,30,15
1713506469430,SOCI 117,A01,494376,Staff,0,2,5,5
1713506470454,WES 237B,A00,494380,Staff,19,0,20,1
1713506472518,AESE 279B,A00,494370,Wade; Jon P,33,0,33,0
1713506473544,AIP 197,001,627712,Vespa; Emanuel Ignacio,9999,0,9999,0
1713506474572,ANAR 135S,A00,494369,Braswell; Geoffrey E.,0,0,0,0
1713506475597,CAT 124RS,A01,519847,Geibel; William,6,0,20,14
1713506476620,CAT 125RS,A01,515971,Geibel; William,6,0,20,14
1713506477646,CLRE 250,A00,511389,Morris; Sheldon,9996,0,9999,3
1713506478676,CLRE 251,A00,507176,Mehta; Ravindra L.,9996,0,9999,3
1713506478676,CLRE 251,B00,511410,Mehta; Ravindra L.,9998,0,9999,1
1713506479704,CLRE 252,A00,507189,Cuomo; Raphael Eduardo,9998,0,9999,1
1713506480729,CLRE 253,A00,507199,Vaida; Florin,9997,0,9999,2
1713506480729,CLRE 253,B00,507202,Vaida; Florin,9999,0,9999,0
1713506481754,CLRE 259,A00,507211,Patel; Hemal,9996,0,9999,3
1713506482779,CLRE 260,A00,507221,Cuomo; Raphael Eduardo,9999,0,9999,0
1713506483803,CLRE 297,001,507242,Cuomo; Raphael Eduardo,9999,0,9999,0
1713506484830,CSE 191,A00,516875,Minnes Kemp; Mor Mia,9999,0,9999,0
1713506485855,CSS 201S,A01,494383,Staff,35,0,35,0
1713506486881,CSS 202S,A01,494387,Staff,35,0,35,0
1713506487906,EAP 100,A00,516065,Staff,9792,0,9999,207
1713506488931,ECE 45,A01,507414,Staff,37,0,60,23
1713506489961,ECE 100,A01,507416,Baghdadchi; Saharnaz,0,0,20,20
1713506489961,ECE 100,A02,507418,Baghdadchi; Saharnaz,19,0,20,1
1713506490989,ECE 111,A01,507420,Staff,27,0,50,23
1713506492016,ECE 197,001,548057,Sievenpiper; Daniel F.,9998,0,9999,1
1713506493041,EDS 115,A00,507243,Choi; Bailey Miyeon,27,0,28,1
1713506494073,EDS 117,A01,494379,Staff,15,0,25,10
1713506495102,EDS 125,A00,507246,Hopkins; Megan Beth,27,0,30,3
1713506496128,EDS 128A,A01,507264,Fargason; Sharon Gayle,26,0,26,0
1713506497153,EDS 128B,A01,507293,Pappas; Elizabeth,30,0,30,0
1713506498178,EDS 139,A00,507294,Fargason; Sharon Gayle,30,0,30,0
1713506498178,EDS 139,B00,507313,Pappas; Elizabeth,30,0,30,0
1713506499206,EDS 201,A00,507315,Staff,18,0,30,12
1713506500230,EDS 203,A01,507317,Halter; Christopher P.,17,0,30,13
1713506501254,EDS 204R,A01,507319,Halter; Christopher P.,0,1,30,30
1713506501254,EDS 204R,B01,507331,Heinzman; Erica M.,22,0,30,8
1713506502281,EDS 206R,A00,507332,Staff,0,2,30,30
1713506502281,EDS 206R,B00,507343,Staff,23,0,30,7
1713506503306,EDS 250,A00,507344,Hemans; Patricia Ann Benitez,27,0,40,13
1713506504331,EDS 281,A00,507345,Daly; Alan J.,18,0,18,0
1713506505355,EDS 284,A00,507350,Daly; Alan J.,16,0,16,0
1713506506379,EDS 286,A00,507359,Fine; Sarah,18,0,18,0
1713506507462,EDS 289C,A01,507361,Daly; Alan J.,18,0,18,0
1713506508489,EDS 290,A00,507366,Hofstetter; Carolyn,15,0,15,0
1713506509515,LIGM 5A,A00,507421,Fischer-Grunski; Eva K,20,0,20,0
1713506510540,LIGM 5B,A00,507423,Fischer-Grunski; Eva K,20,0,20,0
1713506511570,LIGM 5C,A00,507425,Fischer-Grunski; Eva K,20,0,20,0
1713506512595,LIIT 5AS,A00,507427,Carnelos; Chiara,20,0,20,0
1713506513626,LIIT 5BS,A00,507430,Carnelos; Chiara,20,0,20,0
1713506514655,LIIT 5CS,A00,507432,Carnelos; Chiara,20,0,20,0
1713506515680,LISP 5A,A00,507541,Munoz Sanchez; Alicia,14,0,20,6
1713506516705,LISP 5B,A00,507671,Munoz Sanchez; Alicia,12,0,20,8
1713506517733,LISP 5C,A00,507696,Munoz Sanchez; Alicia,11,0,20,9
1713506518758,MAE 197,001,528363,Boechler; Nicholas Sebastia,9998,0,9999,1
1713506519784,MATH 197,001,523477,Kedlaya; Kiran S.,9999,0,9999,0
1713506519784,MATH 197,002,563811,Zhang; Danna,9998,0,9999,1
1713506520809,MCWP 40R,A00,518780,Staff,13,0,20,7
1713506520809,MCWP 40R,B00,518781,Staff,11,0,20,9
1713506520809,MCWP 40R,C00,518783,Staff,8,0,20,12
1713506521836,MCWP 50R,A00,518791,Staff,7,0,20,13
1713506521836,MCWP 50R,B00,518792,Staff,3,0,20,17
1713506521836,MCWP 50R,C00,518793,Staff,5,0,20,15
1713506521836,MCWP 50R,D00,518794,Staff,0,0,20,20
1713506521836,MCWP 50R,E00,518795,Staff,0,0,20,20
1713506521836,MCWP 50R,F00,518796,Staff,11,0,20,9
1713506521836,MCWP 50R,G00,518797,Staff,10,0,20,10
1713506522860,MMW 12R,A01,514034,Herbst; Matthew,1,0,16,15
1713506522860,MMW 12R,A02,514035,Herbst; Matthew,13,0,16,3
1713506523893,MMW 13R,A01,514037,Staff,0,8,16,16
1713506523893,MMW 13R,A02,514039,Staff,0,7,16,16
1713506525945,SIO 295LS,A00,523233,Staff,15,0,30,15
1713506526973,SIO 295S,A00,523232,Staff,15,0,30,15
1713506527998,SOCI 117,A01,494376,Staff,0,2,5,5
1713506529023,WES 237B,A00,494380,Staff,19,0,20,1
1713506531096,AESE 279B,A00,494370,Wade; Jon P,33,0,33,0
1713506532120,AIP 197,001,627712,Vespa; Emanuel Ignacio,9999,0,9999,0
1713506533147,ANAR 135S,A00,494369,Braswell; Geoffrey E.,0,0,0,0
1713506534172,CAT 124RS,A01,519847,Geibel; William,6,0,20,14
1713506535200,CAT 125RS,A01,515971,Geibel; William,6,0,20,14
1713506536226,CLRE 250,A00,511389,Morris; Sheldon,9996,0,9999,3
1713506537252,CLRE 251,A00,507176,Mehta; Ravindra L.,9996,0,9999,3
1713506537252,CLRE 251,B00,511410,Mehta; Ravindra L.,9998,0,9999,1
1713506538281,CLRE 252,A00,507189,Cuomo; Raphael Eduardo,9998,0,9999,1
1713506539306,CLRE 253,A00,507199,Vaida; Florin,9997,0,9999,2
1713506539306,CLRE 253,B00,507202,Vaida; Florin,9999,0,9999,0
1713506540335,CLRE 259,A00,507211,Patel; Hemal,9996,0,9999,3
1713506541364,CLRE 260,A00,507221,Cuomo; Raphael Eduardo,9999,0,9999,0
1713506542389,CLRE 297,001,507242,Cuomo; Raphael Eduardo,9999,0,9999,0
1713506543419,CSE 191,A00,516875,Minnes Kemp; Mor Mia,9999,0,9999,0
1713506544444,CSS 201S,A01,494383,Staff,35,0,35,0
1713506545474,CSS 202S,A01,494387,Staff,35,0,35,0
1713506546499,EAP 100,A00,516065,Staff,9792,0,9999,207
1713506547525,ECE 45,A01,507414,Staff,37,0,60,23
1713506548551,ECE 100,A01,507416,Baghdadchi; Saharnaz,0,0,20,20
1713506548551,ECE 100,A02,507418,Baghdadchi; Saharnaz,19,0,20,1
1713506549576,ECE 111,A01,507420,Staff,27,0,50,23
1713506550600,ECE 197,001,548057,Sievenpiper; Daniel F.,9998,0,9999,1
1713506551629,EDS 115,A00,507243,Choi; Bailey Miyeon,27,0,28,1
1713506552654,EDS 117,A01,494379,Staff,15,0,25,10
1713506553683,EDS 125,A00,507246,Hopkins; Megan Beth,27,0,30,3
1713506554707,EDS 128A,A01,507264,Fargason; Sharon Gayle,26,0,26,0
1713506555734,EDS 128B,A01,507293,Pappas; Elizabeth,30,0,30,0
1713506556760,EDS 139,A00,507294,Fargason; Sharon Gayle,30,0,30,0
1713506556760,EDS 139,B00,507313,Pappas; Elizabeth,30,0,30,0
1713506557785,EDS 201,A00,507315,Staff,18,0,30,12
1713506558812,EDS 203,A01,507317,Halter; Christopher P.,17,0,30,13
1713506559841,EDS 204R,A01,507319,Halter; Christopher P.,0,1,30,30
1713506559841,EDS 204R,B01,507331,Heinzman; Erica M.,22,0,30,8
1713506560869,EDS 206R,A00,507332,Staff,0,2,30,30
1713506560869,EDS 206R,B00,507343,Staff,23,0,30,7
1713506561894,EDS 250,A00,507344,Hemans; Patricia Ann Benitez,27,0,40,13
1713506562919,EDS 281,A00,507345,Daly; Alan J.,18,0,18,0
1713506563947,EDS 284,A00,507350,Daly; Alan J.,16,0,16,0
1713506564974,EDS 286,A00,507359,Fine; Sarah,18,0,18,0
1713506565999,EDS 289C,A01,507361,Daly; Alan J.,18,0,18,0
1713506567029,EDS 290,A00,507366,Hofstetter; Carolyn,15,0,15,0
1713506568055,LIGM 5A,A00,507421,Fischer-Grunski; Eva K,20,0,20,0
1713506569080,LIGM 5B,A00,507423,Fischer-Grunski; Eva K,20,0,20,0
1713506570110,LIGM 5C,A00,507425,Fischer-Grunski; Eva K,20,0,20,0
1713506571135,LIIT 5AS,A00,507427,Carnelos; Chiara,20,0,20,0
1713506572166,LIIT 5BS,A00,507430,Carnelos; Chiara,20,0,20,0
1713506573195,LIIT 5CS,A00,507432,Carnelos; Chiara,20,0,20,0
1713506574222,LISP 5A,A00,507541,Munoz Sanchez; Alicia,14,0,20,6
1713506575251,LISP 5B,A00,507671,Munoz Sanchez; Alicia,12,0,20,8
1713506576279,LISP 5C,A00,507696,Munoz Sanchez; Alicia,11,0,20,9
1713506577308,MAE 197,001,528363,Boechler; Nicholas Sebastia,9998,0,9999,1
1713506578333,MATH 197,001,523477,Kedlaya; Kiran S.,9999,0,9999,0
1713506578333,MATH 197,002,563811,Zhang; Danna,9998,0,9999,1
1713506579359,MCWP 40R,A00,518780,Staff,13,0,20,7
1713506579359,MCWP 40R,B00,518781,Staff,11,0,20,9
1713506579359,MCWP 40R,C00,518783,Staff,8,0,20,12
1713506580386,MCWP 50R,A00,518791,Staff,7,0,20,13
1713506580386,MCWP 50R,B00,518792,Staff,3,0,20,17
1713506580386,MCWP 50R,C00,518793,Staff,5,0,20,15
1713506580386,MCWP 50R,D00,518794,Staff,0,0,20,20
1713506580386,MCWP 50R,E00,518795,Staff,0,0,20,20
1713506580386,MCWP 50R,F00,518796,Staff,11,0,20,9
1713506580386,MCWP 50R,G00,518797,Staff,10,0,20,10
1713506581415,MMW 12R,A01,514034,Herbst; Matthew,1,0,16,15
1713506581415,MMW 12R,A02,514035,Herbst; Matthew,13,0,16,3
1713506582441,MMW 13R,A01,514037,Staff,0,8,16,16
1713506582441,MMW 13R,A02,514039,Staff,0,7,16,16
1713506584499,SIO 295LS,A00,523233,Staff,15,0,30,15
1713506585525,SIO 295S,A00,523232,Staff,15,0,30,15
1713506586553,SOCI 117,A01,494376,Staff,0,2,5,5
1713506587578,WES 237B,A00,494380,Staff,19,0,20,1
1713506589651,AESE 279B,A00,494370,Wade; Jon P,33,0,33,0
1713506590676,AIP 197,001,627712,Vespa; Emanuel Ignacio,9999,0,9999,0
1713506591703,ANAR 135S,A00,494369,Braswell; Geoffrey E.,0,0,0,0
1713506592729,CAT 124RS,A01,519847,Geibel; William,6,0,20,14
1713506593754,CAT 125RS,A01,515971,Geibel; William,6,0,20,14
1713506594780,CLRE 250,A00,511389,Morris; Sheldon,9996,0,9999,3
1713506595807,CLRE 251,A00,507176,Mehta; Ravindra L.,9996,0,9999,3
1713506595807,CLRE 251,B00,511410,Mehta; Ravindra L.,9998,0,9999,1
1713506596834,CLRE 252,A00,507189,Cuomo; Raphael Eduardo,9998,0,9999,1
1713506597860,CLRE 253,A00,507199,Vaida; Florin,9997,0,9999,2
1713506597860,CLRE 253,B00,507202,Vaida; Florin,9999,0,9999,0
1713506598884,CLRE 259,A00,507211,Patel; Hemal,9996,0,9999,3
1713506599912,CLRE 260,A00,507221,Cuomo; Raphael Eduardo,9999,0,9999,0
1713506600939,CLRE 297,001,507242,Cuomo; Raphael Eduardo,9999,0,9999,0
1713506601965,CSE 191,A00,516875,Minnes Kemp; Mor Mia,9999,0,9999,0
1713506602992,CSS 201S,A01,494383,Staff,35,0,35,0
1713506604023,CSS 202S,A01,494387,Staff,35,0,35,0
1713506605050,EAP 100,A00,516065,Staff,9792,0,9999,207
1713506606080,ECE 45,A01,507414,Staff,37,0,60,23
1713506607111,ECE 100,A01,507416,Baghdadchi; Saharnaz,0,0,20,20
1713506607111,ECE 100,A02,507418,Baghdadchi; Saharnaz,19,0,20,1
1713506608137,ECE 111,A01,507420,Staff,27,0,50,23
1713506609163,ECE 197,001,548057,Sievenpiper; Daniel F.,9998,0,9999,1
1713506610188,EDS 115,A00,507243,Choi; Bailey Miyeon,27,0,28,1
1713506611272,EDS 117,A01,494379,Staff,15,0,25,10
1713506612302,EDS 125,A00,507246,Hopkins; Megan Beth,27,0,30,3
1713506613352,EDS 128A,A01,507264,Fargason; Sharon Gayle,26,0,26,0
1713506614381,EDS 128B,A01,507293,Pappas; Elizabeth,30,0,30,0
1713506615406,EDS 139,A00,507294,Fargason; Sharon Gayle,30,0,30,0
1713506615406,EDS 139,B00,507313,Pappas; Elizabeth,30,0,30,0
1713506616435,EDS 201,A00,507315,Staff,18,0,30,12
1713506617459,EDS 203,A01,507317,Halter; Christopher P.,17,0,30,13
1713506618489,EDS 204R,A01,507319,Halter; Christopher P.,0,1,30,30
1713506618489,EDS 204R,B01,507331,Heinzman; Erica M.,22,0,30,8
1713506619518,EDS 206R,A00,507332,Staff,0,2,30,30
1713506619518,EDS 206R,B00,507343,Staff,23,0,30,7
1713506620546,EDS 250,A00,507344,Hemans; Patricia Ann Benitez,27,0,40,13
1713506621574,EDS 281,A00,507345,Daly; Alan J.,18,0,18,0
1713506622600,EDS 284,A00,507350,Daly; Alan J.,16,0,16,0
1713506623624,EDS 286,A00,507359,Fine; Sarah,18,0,18,0
1713506624650,EDS 289C,A01,507361,Daly; Alan J.,18,0,18,0
1713506625676,EDS 290,A00,507366,Hofstetter; Carolyn,15,0,15,0
1713506626709,LIGM 5A,A00,507421,Fischer-Grunski; Eva K,20,0,20,0
1713506627735,LIGM 5B,A00,507423,Fischer-Grunski; Eva K,20,0,20,0
1713506628765,LIGM 5C,A00,507425,Fischer-Grunski; Eva K,20,0,20,0
1713506629791,LIIT 5AS,A00,507427,Carnelos; Chiara,20,0,20,0
1713506630820,LIIT 5BS,A00,507430,Carnelos; Chiara,20,0,20,0
1713506631846,LIIT 5CS,A00,507432,Carnelos; Chiara,20,0,20,0
1713506632872,LISP 5A,A00,507541,Munoz Sanchez; Alicia,14,0,20,6
1713506633903,LISP 5B,A00,507671,Munoz Sanchez; Alicia,12,0,20,8
1713506634931,LISP 5C,A00,507696,Munoz Sanchez; Alicia,11,0,20,9
1713506635958,MAE 197,001,528363,Boechler; Nicholas Sebastia,9998,0,9999,1
1713506636987,MATH 197,001,523477,Kedlaya; Kiran S.,9999,0,9999,0
1713506636987,MATH 197,002,563811,Zhang; Danna,9998,0,9999,1
1713506638012,MCWP 40R,A00,518780,Staff,13,0,20,7
1713506638012,MCWP 40R,B00,518781,Staff,11,0,20,9
1713506638012,MCWP 40R,C00,518783,Staff,8,0,20,12
1713506639039,MCWP 50R,A00,518791,Staff,7,0,20,13
1713506639039,MCWP 50R,B00,518792,Staff,3,0,20,17
1713506639039,MCWP 50R,C00,518793,Staff,5,0,20,15
1713506639039,MCWP 50R,D00,518794,Staff,0,0,20,20
1713506639039,MCWP 50R,E00,518795,Staff,0,0,20,20
1713506639039,MCWP 50R,F00,518796,Staff,11,0,20,9
1713506639039,MCWP 50R,G00,518797,Staff,10,0,20,10
1713506640065,MMW 12R,A01,514034,Herbst; Matthew,1,0,16,15
1713506640065,MMW 12R,A02,514035,Herbst; Matthew,13,0,16,3
1713506641091,MMW 13R,A01,514037,Staff,0,8,16,16
1713506641091,MMW 13R,A02,514039,Staff,0,7,16,16
1713506643146,SIO 295LS,A00,523233,Staff,15,0,30,15
1713506644171,SIO 295S,A00,523232,Staff,15,0,30,15
1713506645200,SOCI 117,A01,494376,Staff,0,2,5,5
1713506646228,WES 237B,A00,494380,Staff,19,0,20,1
1713506648299,AESE 279B,A00,494370,Wade; Jon P,33,0,33,0
1713506649325,AIP 197,001,627712,Vespa; Emanuel Ignacio,9999,0,9999,0
1713506650351,ANAR 135S,A00,494369,Braswell; Geoffrey E.,0,0,0,0
1713506651379,CAT 124RS,A01,519847,Geibel; William,6,0,20,14
1713506652405,CAT 125RS,A01,515971,Geibel; William,6,0,20,14
1713506653430,CLRE 250,A00,511389,Morris; Sheldon,9996,0,9999,3
1713506654457,CLRE 251,A00,507176,Mehta; Ravindra L.,9996,0,9999,3
1713506654457,CLRE 251,B00,511410,Mehta; Ravindra L.,9998,0,9999,1
1713506655483,CLRE 252,A00,507189,Cuomo; Raphael Eduardo,9998,0,9999,1
1713506656508,CLRE 253,A00,507199,Vaida; Florin,9997,0,9999,2
1713506656508,CLRE 253,B00,507202,Vaida; Florin,9999,0,9999,0
1713506657537,CLRE 259,A00,507211,Patel; Hemal,9996,0,9999,3
1713506658563,CLRE 260,A00,507221,Cuomo; Raphael Eduardo,9999,0,9999,0
1713506659591,CLRE 297,001,507242,Cuomo; Raphael Eduardo,9999,0,9999,0
1713506660620,CSE 191,A00,516875,Minnes Kemp; Mor Mia,9999,0,9999,0
1713506661650,CSS 201S,A01,494383,Staff,35,0,35,0
1713506662678,CSS 202S,A01,494387,Staff,35,0,35,0
1713506663704,EAP 100,A00,516065,Staff,9792,0,9999,207
1713506664731,ECE 45,A01,507414,Staff,37,0,60,23
1713506665762,ECE 100,A01,507416,Baghdadchi; Saharnaz,0,0,20,20
1713506665762,ECE 100,A02,507418,Baghdadchi; Saharnaz,19,0,20,1
1713506666789,ECE 111,A01,507420,Staff,27,0,50,23
1713506667817,ECE 197,001,548057,Sievenpiper; Daniel F.,9998,0,9999,1
1713506668847,EDS 115,A00,507243,Choi; Bailey Miyeon,27,0,28,1
1713506669876,EDS 117,A01,494379,Staff,15,0,25,10
1713506670905,EDS 125,A00,507246,Hopkins; Megan Beth,27,0,30,3
1713506671929,EDS 128A,A01,507264,Fargason; Sharon Gayle,26,0,26,0
1713506672958,EDS 128B,A01,507293,Pappas; Elizabeth,30,0,30,0
1713506673982,EDS 139,A00,507294,Fargason; Sharon Gayle,30,0,30,0
1713506673982,EDS 139,B00,507313,Pappas; Elizabeth,30,0,30,0
1713506675010,EDS 201,A00,507315,Staff,18,0,30,12
1713506676036,EDS 203,A01,507317,Halter; Christopher P.,17,0,30,13
1713506677060,EDS 204R,A01,507319,Halter; Christopher P.,0,1,30,30
1713506677060,EDS 204R,B01,507331,Heinzman; Erica M.,22,0,30,8
1713506678088,EDS 206R,A00,507332,Staff,0,2,30,30
1713506678088,EDS 206R,B00,507343,Staff,23,0,30,7
1713506679114,EDS 250,A00,507344,Hemans; Patricia Ann Benitez,27,0,40,13
1713506680141,EDS 281,A00,507345,Daly; Alan J.,18,0,18,0
1713506681168,EDS 284,A00,507350,Daly; Alan J.,16,0,16,0
1713506682193,EDS 286,A00,507359,Fine; Sarah,18,0,18,0
1713506683218,EDS 289C,A01,507361,Daly; Alan J.,18,0,18,0
1713506684243,EDS 290,A00,507366,Hofstetter; Carolyn,15,0,15,0
1713506685272,LIGM 5A,A00,507421,Fischer-Grunski; Eva K,20,0,20,0
1713506686298,LIGM 5B,A00,507423,Fischer-Grunski; Eva K,20,0,20,0
1713506687324,LIGM 5C,A00,507425,Fischer-Grunski; Eva K,20,0,20,0
1713506688350,LIIT 5AS,A00,507427,Carnelos; Chiara,20,0,20,0
1713506689377,LIIT 5BS,A00,507430,Carnelos; Chiara,20,0,20,0
1713506690403,LIIT 5CS,A00,507432,Carnelos; Chiara,20,0,20,0
1713506691429,LISP 5A,A00,507541,Munoz Sanchez; Alicia,14,0,20,6
1713506692455,LISP 5B,A00,507671,Munoz Sanchez; Alicia,12,0,20,8
1713506693480,LISP 5C,A00,507696,Munoz Sanchez; Alicia,11,0,20,9
1713506694507,MAE 197,001,528363,Boechler; Nicholas Sebastia,9998,0,9999,1
1713506695533,MATH 197,001,523477,Kedlaya; Kiran S.,9999,0,9999,0
1713506695533,MATH 197,002,563811,Zhang; Danna,9998,0,9999,1
1713506696557,MCWP 40R,A00,518780,Staff,13,0,20,7
1713506696557,MCWP 40R,B00,518781,Staff,11,0,20,9
1713506696557,MCWP 40R,C00,518783,Staff,8,0,20,12
1713506697584,MCWP 50R,A00,518791,Staff,7,0,20,13
1713506697584,MCWP 50R,B00,518792,Staff,3,0,20,17
1713506697584,MCWP 50R,C00,518793,Staff,5,0,20,15
1713506697584,MCWP 50R,D00,518794,Staff,0,0,20,20
1713506697584,MCWP 50R,E00,518795,Staff,0,0,20,20
1713506697584,MCWP 50R,F00,518796,Staff,11,0,20,9
1713506697584,MCWP 50R,G00,518797,Staff,10,0,20,10
1713506698611,MMW 12R,A01,514034,Herbst; Matthew,1,0,16,15
1713506698611,MMW 12R,A02,514035,Herbst; Matthew,13,0,16,3
1713506699639,MMW 13R,A01,514037,Staff,0,8,16,16
1713506699639,MMW 13R,A02,514039,Staff,0,7,16,16
1713506701688,SIO 295LS,A00,523233,Staff,15,0,30,15
1713506702714,SIO 295S,A00,523232,Staff,15,0,30,15
1713506703741,SOCI 117,A01,494376,Staff,0,2,5,5
1713506704768,WES 237B,A00,494380,Staff,19,0,20,1
1713506706841,AESE 279B,A00,494370,Wade; Jon P,33,0,33,0
1713506707867,AIP 197,001,627712,Vespa; Emanuel Ignacio,9999,0,9999,0
1713506708892,ANAR 135S,A00,494369,Braswell; Geoffrey E.,0,0,0,0
1713506709916,CAT 124RS,A01,519847,Geibel; William,6,0,20,14
1713506710941,CAT 125RS,A01,515971,Geibel; William,6,0,20,14
1713506711966,CLRE 250,A00,511389,Morris; Sheldon,9996,0,9999,3
1713506712993,CLRE 251,A00,507176,Mehta; Ravindra L.,9996,0,9999,3
1713506712993,CLRE 251,B00,511410,Mehta; Ravindra L.,9998,0,9999,1
1713506714020,CLRE 252,A00,507189,Cuomo; Raphael Eduardo,9998,0,9999,1
1713506715104,CLRE 253,A00,507199,Vaida; Florin,9997,0,9999,2
1713506715104,CLRE 253,B00,507202,Vaida; Florin,9999,0,9999,0
1713506716133,CLRE 259,A00,507211,Patel; Hemal,9996,0,9999,3
1713506717161,CLRE 260,A00,507221,Cuomo; Raphael Eduardo,9999,0,9999,0
1713506718186,CLRE 297,001,507242,Cuomo; Raphael Eduardo,9999,0,9999,0
1713506719212,CSE 191,A00,516875,Minnes Kemp; Mor Mia,9999,0,9999,0
1713506720238,CSS 201S,A01,494383,Staff,35,0,35,0
1713506721269,CSS 202S,A01,494387,Staff,35,0,35,0
1713506722296,EAP 100,A00,516065,Staff,9792,0,9999,207
1713506723325,ECE 45,A01,507414,Staff,37,0,60,23
1713506724353,ECE 100,A01,507416,Baghdadchi; Saharnaz,0,0,20,20
1713506724353,ECE 100,A02,507418,Baghdadchi; Saharnaz,19,0,20,1
1713506725381,ECE 111,A01,507420,Staff,27,0,50,23
1713506726410,ECE 197,001,548057,Sievenpiper; Daniel F.,9998,0,9999,1
1713506727436,EDS 115,A00,507243,Choi; Bailey Miyeon,27,0,28,1
1713506728463,EDS 117,A01,494379,Staff,15,0,25,10
1713506729488,EDS 125,A00,507246,Hopkins; Megan Beth,27,0,30,3
1713506730519,EDS 128A,A01,507264,Fargason; Sharon Gayle,26,0,26,0
1713506731544,EDS 128B,A01,507293,Pappas; Elizabeth,30,0,30,0
1713506732571,EDS 139,A00,507294,Fargason; Sharon Gayle,30,0,30,0
1713506732571,EDS 139,B00,507313,Pappas; Elizabeth,30,0,30,0
1713506733597,EDS 201,A00,507315,Staff,18,0,30,12
1713506734622,EDS 203,A01,507317,Halter; Christopher P.,17,0,30,13
1713506735648,EDS 204R,A01,507319,Halter; Christopher P.,0,1,30,30
1713506735648,EDS 204R,B01,507331,Heinzman; Erica M.,22,0,30,8
1713506736674,EDS 206R,A00,507332,Staff,0,2,30,30
1713506736674,EDS 206R,B00,507343,Staff,23,0,30,7
1713506737702,EDS 250,A00,507344,Hemans; Patricia Ann Benitez,27,0,40,13
1713506738727,EDS 281,A00,507345,Daly; Alan J.,18,0,18,0
1713506739752,EDS 284,A00,507350,Daly; Alan J.,16,0,16,0
1713506740779,EDS 286,A00,507359,Fine; Sarah,18,0,18,0
1713506741808,EDS 289C,A01,507361,Daly; Alan J.,18,0,18,0
1713506742836,EDS 290,A00,507366,Hofstetter; Carolyn,15,0,15,0
1713506743867,LIGM 5A,A00,507421,Fischer-Grunski; Eva K,20,0,20,0
1713506744894,LIGM 5B,A00,507423,Fischer-Grunski; Eva K,20,0,20,0
1713506745923,LIGM 5C,A00,507425,Fischer-Grunski; Eva K,20,0,20,0
1713506746952,LIIT 5AS,A00,507427,Carnelos; Chiara,20,0,20,0
1713506747987,LIIT 5BS,A00,507430,Carnelos; Chiara,20,0,20,0
1713506749016,LIIT 5CS,A00,507432,Carnelos; Chiara,20,0,20,0
1713506750041,LISP 5A,A00,507541,Munoz Sanchez; Alicia,14,0,20,6
1713506751071,LISP 5B,A00,507671,Munoz Sanchez; Alicia,12,0,20,8
1713506752099,LISP 5C,A00,507696,Munoz Sanchez; Alicia,11,0,20,9
1713506753131,MAE 197,001,528363,Boechler; Nicholas Sebastia,9998,0,9999,1
1713506754167,MATH 197,001,523477,Kedlaya; Kiran S.,9999,0,9999,0
1713506754167,MATH 197,002,563811,Zhang; Danna,9998,0,9999,1
1713506755192,MCWP 40R,A00,518780,Staff,13,0,20,7
1713506755192,MCWP 40R,B00,518781,Staff,11,0,20,9
1713506755192,MCWP 40R,C00,518783,Staff,8,0,20,12
1713506756218,MCWP 50R,A00,518791,Staff,7,0,20,13
1713506756218,MCWP 50R,B00,518792,Staff,3,0,20,17
1713506756218,MCWP 50R,C00,518793,Staff,5,0,20,15
1713506756218,MCWP 50R,D00,518794,Staff,0,0,20,20
1713506756218,MCWP 50R,E00,518795,Staff,0,0,20,20
1713506756218,MCWP 50R,F00,518796,Staff,11,0,20,9
1713506756218,MCWP 50R,G00,518797,Staff,10,0,20,10
1713506757249,MMW 12R,A01,514034,Herbst; Matthew,1,0,16,15
1713506757249,MMW 12R,A02,514035,Herbst; Matthew,13,0,16,3
1713506758274,MMW 13R,A01,514037,Staff,0,8,16,16
1713506758274,MMW 13R,A02,514039,Staff,0,7,16,16
1713506760328,SIO 295LS,A00,523233,Staff,15,0,30,15
1713506761362,SIO 295S,A00,523232,Staff,15,0,30,15
1713506762389,SOCI 117,A01,494376,Staff,0,2,5,5
1713506763419,WES 237B,A00,494380,Staff,19,0,20,1
1713506765493,AESE 279B,A00,494370,Wade; Jon P,33,0,33,0
1713506766522,AIP 197,001,627712,Vespa; Emanuel Ignacio,9999,0,9999,0
1713506767548,ANAR 135S,A00,494369,Braswell; Geoffrey E.,0,0,0,0
1713506768573,CAT 124RS,A01,519847,Geibel; William,6,0,20,14
1713506769598,CAT 125RS,A01,515971,Geibel; William,6,0,20,14
1713506770626,CLRE 250,A00,511389,Morris; Sheldon,9996,0,9999,3
1713506771653,CLRE 251,A00,507176,Mehta; Ravindra L.,9996,0,9999,3
1713506771653,CLRE 251,B00,511410,Mehta; Ravindra L.,9998,0,9999,1
1713506772678,CLRE 252,A00,507189,Cuomo; Raphael Eduardo,9998,0,9999,1
1713506773712,CLRE 253,A00,507199,Vaida; Florin,9997,0,9999,2
1713506773712,CLRE 253,B00,507202,Vaida; Florin,9999,0,9999,0
1713506774741,CLRE 259,A00,507211,Patel; Hemal,9996,0,9999,3
1713506775769,CLRE 260,A00,507221,Cuomo; Raphael Eduardo,9999,0,9999,0
1713506776795,CLRE 297,001,507242,Cuomo; Raphael Eduardo,9999,0,9999,0
1713506777820,CSE 191,A00,516875,Minnes Kemp; Mor Mia,9999,0,9999,0
1713506778846,CSS 201S,A01,494383,Staff,35,0,35,0
1713506779875,CSS 202S,A01,494387,Staff,35,0,35,0
1713506780901,EAP 100,A00,516065,Staff,9792,0,9999,207
1713506781933,ECE 45,A01,507414,Staff,37,0,60,23
1713506782961,ECE 100,A01,507416,Baghdadchi; Saharnaz,0,0,20,20
1713506782961,ECE 100,A02,507418,Baghdadchi; Saharnaz,19,0,20,1
1713506783986,ECE 111,A01,507420,Staff,27,0,50,23
1713506785015,ECE 197,001,548057,Sievenpiper; Daniel F.,9998,0,9999,1
1713506786040,EDS 115,A00,507243,Choi; Bailey Miyeon,27,0,28,1
1713506787064,EDS 117,A01,494379,Staff,15,0,25,10
1713506788095,EDS 125,A00,507246,Hopkins; Megan Beth,27,0,30,3
1713506789127,EDS 128A,A01,507264,Fargason; Sharon Gayle,26,0,26,0
1713506790153,EDS 128B,A01,507293,Pappas; Elizabeth,30,0,30,0
1713506791185,EDS 139,A00,507294,Fargason; Sharon Gayle,30,0,30,0
1713506791185,EDS 139,B00,507313,Pappas; Elizabeth,30,0,30,0
1713506792216,EDS 201,A00,507315,Staff,18,0,30,12
1713506793242,EDS 203,A01,507317,Halter; Christopher P.,17,0,30,13
1713506794271,EDS 204R,A01,507319,Halter; Christopher P.,0,1,30,30
1713506794271,EDS 204R,B01,507331,Heinzman; Erica M.,22,0,30,8
1713506795296,EDS 206R,A00,507332,Staff,0,2,30,30
1713506795296,EDS 206R,B00,507343,Staff,23,0,30,7
1713506796322,EDS 250,A00,507344,Hemans; Patricia Ann Benitez,27,0,40,13
1713506797349,EDS 281,A00,507345,Daly; Alan J.,18,0,18,0
1713506798376,EDS 284,A00,507350,Daly; Alan J.,16,0,16,0
1713506799405,EDS 286,A00,507359,Fine; Sarah,18,0,18,0
1713506800433,EDS 289C,A01,507361,Daly; Alan J.,18,0,18,0
1713506801458,EDS 290,A00,507366,Hofstetter; Carolyn,15,0,15,0
1713506802483,LIGM 5A,A00,507421,Fischer-Grunski; Eva K,20,0,20,0
1713506803508,LIGM 5B,A00,507423,Fischer-Grunski; Eva K,20,0,20,0
1713506804536,LIGM 5C,A00,507425,Fischer-Grunski; Eva K,20,0,20,0
1713506805561,LIIT 5AS,A00,507427,Carnelos; Chiara,20,0,20,0
1713506806586,LIIT 5BS,A00,507430,Carnelos; Chiara,20,0,20,0
1713506807612,LIIT 5CS,A00,507432,Carnelos; Chiara,20,0,20,0
1713506808643,LISP 5A,A00,507541,Munoz Sanchez; Alicia,14,0,20,6
1713506809670,LISP 5B,A00,507671,Munoz Sanchez; Alicia,12,0,20,8
1713506810700,LISP 5C,A00,507696,Munoz Sanchez; Alicia,11,0,20,9
1713506811728,MAE 197,001,528363,Boechler; Nicholas Sebastia,9998,0,9999,1
1713506812756,MATH 197,001,523477,Kedlaya; Kiran S.,9999,0,9999,0
1713506812756,MATH 197,002,563811,Zhang; Danna,9998,0,9999,1
1713506813794,MCWP 40R,A00,518780,Staff,13,0,20,7
1713506813794,MCWP 40R,B00,518781,Staff,11,0,20,9
1713506813794,MCWP 40R,C00,518783,Staff,8,0,20,12
1713506814829,MCWP 50R,A00,518791,Staff,7,0,20,13
1713506814829,MCWP 50R,B00,518792,Staff,3,0,20,17
1713506814829,MCWP 50R,C00,518793,Staff,5,0,20,15
1713506814829,MCWP 50R,D00,518794,Staff,0,0,20,20
1713506814829,MCWP 50R,E00,518795,Staff,0,0,20,20
1713506814829,MCWP 50R,F00,518796,Staff,11,0,20,9
1713506814829,MCWP 50R,G00,518797,Staff,10,0,20,10
1713506815855,MMW 12R,A01,514034,Herbst; Matthew,1,0,16,15
1713506815855,MMW 12R,A02,514035,Herbst; Matthew,13,0,16,3
1713506816885,MMW 13R,A01,514037,Staff,0,8,16,16
1713506816885,MMW 13R,A02,514039,Staff,0,7,16,16
1713506819008,SIO 295LS,A00,523233,Staff,15,0,30,15
1713506820041,SIO 295S,A00,523232,Staff,15,0,30,15
1713506821069,SOCI 117,A01,494376,Staff,0,2,5,5
1713506822096,WES 237B,A00,494380,Staff,19,0,20,1
1713506824159,AESE 279B,A00,494370,Wade; Jon P,33,0,33,0
1713506825185,AIP 197,001,627712,Vespa; Emanuel Ignacio,9999,0,9999,0
1713506826219,ANAR 135S,A00,494369,Braswell; Geoffrey E.,0,0,0,0
1713506827248,CAT 124RS,A01,519847,Geibel; William,6,0,20,14
1713506828273,CAT 125RS,A01,515971,Geibel; William,6,0,20,14
1713506829300,CLRE 250,A00,511389,Morris; Sheldon,9996,0,9999,3
1713506830324,CLRE 251,A00,507176,Mehta; Ravindra L.,9996,0,9999,3
1713506830324,CLRE 251,B00,511410,Mehta; Ravindra L.,9998,0,9999,1
1713506831351,CLRE 252,A00,507189,Cuomo; Raphael Eduardo,9998,0,9999,1
1713506832377,CLRE 253,A00,507199,Vaida; Florin,9997,0,9999,2
1713506832377,CLRE 253,B00,507202,Vaida; Florin,9999,0,9999,0
1713506833405,CLRE 259,A00,507211,Patel; Hemal,9996,0,9999,3
1713506834430,CLRE 260,A00,507221,Cuomo; Raphael Eduardo,9999,0,9999,0
1713506835458,CLRE 297,001,507242,Cuomo; Raphael Eduardo,9999,0,9999,0
1713506836482,CSE 191,A00,516875,Minnes Kemp; Mor Mia,9999,0,9999,0
1713506837512,CSS 201S,A01,494383,Staff,35,0,35,0
1713506838538,CSS 202S,A01,494387,Staff,35,0,35,0
1713506839566,EAP 100,A00,516065,Staff,9792,0,9999,207
1713506840593,ECE 45,A01,507414,Staff,37,0,60,23
1713506841622,ECE 100,A01,507416,Baghdadchi; Saharnaz,0,0,20,20
1713506841622,ECE 100,A02,507418,Baghdadchi; Saharnaz,19,0,20,1
1713506842646,ECE 111,A01,507420,Staff,27,0,50,23
1713506843675,ECE 197,001,548057,Sievenpiper; Daniel F.,9998,0,9999,1
1713506844701,EDS 115,A00,507243,Choi; Bailey Miyeon,27,0,28,1
1713506845729,EDS 117,A01,494379,Staff,15,0,25,10
1713506846754,EDS 125,A00,507246,Hopkins; Megan Beth,27,0,30,3
1713506847782,EDS 128A,A01,507264,Fargason; Sharon Gayle,26,0,26,0
1713506848807,EDS 128B,A01,507293,Pappas; Elizabeth,30,0,30,0
1713506849835,EDS 139,A00,507294,Fargason; Sharon Gayle,30,0,30,0
1713506849835,EDS 139,B00,507313,Pappas; Elizabeth,30,0,30,0
1713506850860,EDS 201,A00,507315,Staff,18,0,30,12
1713506851885,EDS 203,A01,507317,Halter; Christopher P.,17,0,30,13
1713506852914,EDS 204R,A01,507319,Halter; Christopher P.,0,1,30,30
1713506852914,EDS 204R,B01,507331,Heinzman; Erica M.,22,0,30,8
1713506853942,EDS 206R,A00,507332,Staff,0,2,30,30
1713506853942,EDS 206R,B00,507343,Staff,23,0,30,7
1713506854967,EDS 250,A00,507344,Hemans; Patricia Ann Benitez,27,0,40,13
1713506855993,EDS 281,A00,507345,Daly; Alan J.,18,0,18,0
1713506857020,EDS 284,A00,507350,Daly; Alan J.,16,0,16,0
1713506858053,EDS 286,A00,507359,Fine; Sarah,18,0,18,0
1713506859081,EDS 289C,A01,507361,Daly; Alan J.,18,0,18,0
1713506860113,EDS 290,A00,507366,Hofstetter; Carolyn,15,0,15,0
1713506861150,LIGM 5A,A00,507421,Fischer-Grunski; Eva K,20,0,20,0
1713506862176,LIGM 5B,A00,507423,Fischer-Grunski; Eva K,20,0,20,0
1713506863214,LIGM 5C,A00,507425,Fischer-Grunski; Eva K,20,0,20,0
1713506864251,LIIT 5AS,A00,507427,Carnelos; Chiara,20,0,20,0
1713506865279,LIIT 5BS,A00,507430,Carnelos; Chiara,20,0,20,0
1713506866309,LIIT 5CS,A00,507432,Carnelos; Chiara,20,0,20,0
1713506867339,LISP 5A,A00,507541,Munoz Sanchez; Alicia,14,0,20,6
1713506868370,LISP 5B,A00,507671,Munoz Sanchez; Alicia,12,0,20,8
1713506869394,LISP 5C,A00,507696,Munoz Sanchez; Alicia,11,0,20,9
1713506870421,MAE 197,001,528363,Boechler; Nicholas Sebastia,9998,0,9999,1
1713506871451,MATH 197,001,523477,Kedlaya; Kiran S.,9999,0,9999,0
1713506871451,MATH 197,002,563811,Zhang; Danna,9998,0,9999,1
1713506872475,MCWP 40R,A00,518780,Staff,13,0,20,7
1713506872475,MCWP 40R,B00,518781,Staff,11,0,20,9
1713506872475,MCWP 40R,C00,518783,Staff,8,0,20,12
1713506873506,MCWP 50R,A00,518791,Staff,7,0,20,13
1713506873506,MCWP 50R,B00,518792,Staff,3,0,20,17
1713506873506,MCWP 50R,C00,518793,Staff,5,0,20,15
1713506873506,MCWP 50R,D00,518794,Staff,0,0,20,20
1713506873506,MCWP 50R,E00,518795,Staff,0,0,20,20
1713506873506,MCWP 50R,F00,518796,Staff,11,0,20,9
1713506873506,MCWP 50R,G00,518797,Staff,10,0,20,10
1713506874535,MMW 12R,A01,514034,Herbst; Matthew,1,0,16,15
1713506874535,MMW 12R,A02,514035,Herbst; Matthew,13,0,16,3
1713506875560,MMW 13R,A01,514037,Staff,0,8,16,16
1713506875560,MMW 13R,A02,514039,Staff,0,7,16,16
1713506877613,SIO 295LS,A00,523233,Staff,15,0,30,15
1713506878641,SIO 295S,A00,523232,Staff,15,0,30,15
1713506879667,SOCI 117,A01,494376,Staff,0,2,5,5
1713506880691,WES 237B,A00,494380,Staff,19,0,20,1
1713506882768,AESE 279B,A00,494370,Wade; Jon P,33,0,33,0
1713506883794,AIP 197,001,627712,Vespa; Emanuel Ignacio,9999,0,9999,0
1713506884825,ANAR 135S,A00,494369,Braswell; Geoffrey E.,0,0,0,0
1713506885855,CAT 124RS,A01,519847,Geibel; William,6,0,20,14
1713506886881,CAT 125RS,A01,515971,Geibel; William,6,0,20,14
1713506887908,CLRE 250,A00,511389,Morris; Sheldon,9996,0,9999,3
1713506888934,CLRE 251,A00,507176,Mehta; Ravindra L.,9996,0,9999,3
1713506888934,CLRE 251,B00,511410,Mehta; Ravindra L.,9998,0,9999,1
1713506889960,CLRE 252,A00,507189,Cuomo; Raphael Eduardo,9998,0,9999,1
1713506890991,CLRE 253,A00,507199,Vaida; Florin,9997,0,9999,2
1713506890991,CLRE 253,B00,507202,Vaida; Florin,9999,0,9999,0
1713506892018,CLRE 259,A00,507211,Patel; Hemal,9996,0,9999,3
1713506893043,CLRE 260,A00,507221,Cuomo; Raphael Eduardo,9999,0,9999,0
1713506894068,CLRE 297,001,507242,Cuomo; Raphael Eduardo,9999,0,9999,0
1713506895097,CSE 191,A00,516875,Minnes Kemp; Mor Mia,9999,0,9999,0
1713506896122,CSS 201S,A01,494383,Staff,35,0,35,0
1713506897148,CSS 202S,A01,494387,Staff,35,0,35,0
1713506898174,EAP 100,A00,516065,Staff,9792,0,9999,207
1713506899198,ECE 45,A01,507414,Staff,37,0,60,23
1713506900228,ECE 100,A01,507416,Baghdadchi; Saharnaz,0,0,20,20
1713506900228,ECE 100,A02,507418,Baghdadchi; Saharnaz,19,0,20,1
1713506901267,ECE 111,A01,507420,Staff,27,0,50,23
1713506902292,ECE 197,001,548057,Sievenpiper; Daniel F.,9998,0,9999,1
1713506903320,EDS 115,A00,507243,Choi; Bailey Miyeon,27,0,28,1
1713506904347,EDS 117,A01,494379,Staff,15,0,25,10
1713506905372,EDS 125,A00,507246,Hopkins; Megan Beth,27,0,30,3
1713506906402,EDS 128A,A01,507264,Fargason; Sharon Gayle,26,0,26,0
1713506907428,EDS 128B,A01,507293,Pappas; Elizabeth,30,0,30,0
1713506908451,EDS 139,A00,507294,Fargason; Sharon Gayle,30,0,30,0
1713506908451,EDS 139,B00,507313,Pappas; Elizabeth,30,0,30,0
1713506909477,EDS 201,A00,507315,Staff,18,0,30,12
1713506910502,EDS 203,A01,507317,Halter; Christopher P.,17,0,30,13
1713506911528,EDS 204R,A01,507319,Halter; Christopher P.,0,1,30,30
1713506911528,EDS 204R,B01,507331,Heinzman; Erica M.,22,0,30,8
1713506912552,EDS 206R,A00,507332,Staff,0,2,30,30
1713506912552,EDS 206R,B00,507343,Staff,23,0,30,7
1713506913578,EDS 250,A00,507344,Hemans; Patricia Ann Benitez,27,0,40,13
1713506914602,EDS 281,A00,507345,Daly; Alan J.,18,0,18,0
1713506915628,EDS 284,A00,507350,Daly; Alan J.,16,0,16,0
1713506916655,EDS 286,A00,507359,Fine; Sarah,18,0,18,0
1713506917684,EDS 289C,A01,507361,Daly; Alan J.,18,0,18,0
1713506918710,EDS 290,A00,507366,Hofstetter; Carolyn,15,0,15,0
1713506919739,LIGM 5A,A00,507421,Fischer-Grunski; Eva K,20,0,20,0
1713506920768,LIGM 5B,A00,507423,Fischer-Grunski; Eva K,20,0,20,0
1713506921802,LIGM 5C,A00,507425,Fischer-Grunski; Eva K,20,0,20,0
1713506922893,LIIT 5AS,A00,507427,Carnelos; Chiara,20,0,20,0
1713506923921,LIIT 5BS,A00,507430,Carnelos; Chiara,20,0,20,0
1713506924954,LIIT 5CS,A00,507432,Carnelos; Chiara,20,0,20,0
1713506925985,LISP 5A,A00,507541,Munoz Sanchez; Alicia,14,0,20,6
1713506927011,LISP 5B,A00,507671,Munoz Sanchez; Alicia,12,0,20,8
1713506928045,LISP 5C,A00,507696,Munoz Sanchez; Alicia,11,0,20,9
1713506929071,MAE 197,001,528363,Boechler; Nicholas Sebastia,9998,0,9999,1
1713506930098,MATH 197,001,523477,Kedlaya; Kiran S.,9999,0,9999,0
1713506930098,MATH 197,002,563811,Zhang; Danna,9998,0,9999,1
1713506931125,MCWP 40R,A00,518780,Staff,13,0,20,7
1713506931125,MCWP 40R,B00,518781,Staff,11,0,20,9
1713506931125,MCWP 40R,C00,518783,Staff,8,0,20,12
1713506932154,MCWP 50R,A00,518791,Staff,7,0,20,13
1713506932154,MCWP 50R,B00,518792,Staff,3,0,20,17
1713506932154,MCWP 50R,C00,518793,Staff,5,0,20,15
1713506932154,MCWP 50R,D00,518794,Staff,0,0,20,20
1713506932154,MCWP 50R,E00,518795,Staff,0,0,20,20
1713506932154,MCWP 50R,F00,518796,Staff,11,0,20,9
1713506932154,MCWP 50R,G00,518797,Staff,10,0,20,10
1713506933182,MMW 12R,A01,514034,Herbst; Matthew,1,0,16,15
1713506933182,MMW 12R,A02,514035,Herbst; Matthew,13,0,16,3
1713506934207,MMW 13R,A01,514037,Staff,0,8,16,16
1713506934207,MMW 13R,A02,514039,Staff,0,7,16,16
1713506936256,SIO 295LS,A00,523233,Staff,15,0,30,15
1713506937282,SIO 295S,A00,523232,Staff,15,0,30,15
1713506938307,SOCI 117,A01,494376,Staff,0,2,5,5
1713506939335,WES 237B,A00,494380,Staff,19,0,20,1
1713506941409,AESE 279B,A00,494370,Wade; Jon P,33,0,33,0
1713506942436,AIP 197,001,627712,Vespa; Emanuel Ignacio,9999,0,9999,0
1713506943461,ANAR 135S,A00,494369,Braswell; Geoffrey E.,0,0,0,0
1713506944486,CAT 124RS,A01,519847,Geibel; William,6,0,20,14
1713506945514,CAT 125RS,A01,515971,Geibel; William,6,0,20,14
1713506946546,CLRE 250,A00,511389,Morris; Sheldon,9996,0,9999,3
1713506947571,CLRE 251,A00,507176,Mehta; Ravindra L.,9996,0,9999,3
1713506947571,CLRE 251,B00,511410,Mehta; Ravindra L.,9998,0,9999,1
1713506948596,CLRE 252,A00,507189,Cuomo; Raphael Eduardo,9998,0,9999,1
1713506949626,CLRE 253,A00,507199,Vaida; Florin,9997,0,9999,2
1713506949626,CLRE 253,B00,507202,Vaida; Florin,9999,0,9999,0
1713506950655,CLRE 259,A00,507211,Patel; Hemal,9996,0,9999,3
1713506951682,CLRE 260,A00,507221,Cuomo; Raphael Eduardo,9999,0,9999,0
1713506952706,CLRE 297,001,507242,Cuomo; Raphael Eduardo,9999,0,9999,0
1713506953731,CSE 191,A00,516875,Minnes Kemp; Mor Mia,9999,0,9999,0
1713506954761,CSS 201S,A01,494383,Staff,35,0,35,0
1713506955788,CSS 202S,A01,494387,Staff,35,0,35,0
1713506956814,EAP 100,A00,516065,Staff,9792,0,9999,207
1713506957841,ECE 45,A01,507414,Staff,37,0,60,23
1713506958871,ECE 100,A01,507416,Baghdadchi; Saharnaz,0,0,20,20
1713506958871,ECE 100,A02,507418,Baghdadchi; Saharnaz,19,0,20,1
1713506959896,ECE 111,A01,507420,Staff,27,0,50,23
1713506960926,ECE 197,001,548057,Sievenpiper; Daniel F.,9998,0,9999,1
1713506961951,EDS 115,A00,507243,Choi; Bailey Miyeon,27,0,28,1
1713506962978,EDS 117,A01,494379,Staff,15,0,25,10
1713506964005,EDS 125,A00,507246,Hopkins; Megan Beth,27,0,30,3
1713506965040,EDS 128A,A01,507264,Fargason; Sharon Gayle,26,0,26,0
1713506966079,EDS 128B,A01,507293,Pappas; Elizabeth,30,0,30,0
1713506967110,EDS 139,A00,507294,Fargason; Sharon Gayle,30,0,30,0
1713506967110,EDS 139,B00,507313,Pappas; Elizabeth,30,0,30,0
1713506968136,EDS 201,A00,507315,Staff,18,0,30,12
1713506969162,EDS 203,A01,507317,Halter; Christopher P.,17,0,30,13
1713506970199,EDS 204R,A01,507319,Halter; Christopher P.,0,1,30,30
1713506970199,EDS 204R,B01,507331,Heinzman; Erica M.,22,0,30,8
1713506971223,EDS 206R,A00,507332,Staff,0,2,30,30
1713506971223,EDS 206R,B00,507343,Staff,23,0,30,7
1713506972252,EDS 250,A00,507344,Hemans; Patricia Ann Benitez,27,0,40,13
1713506973277,EDS 281,A00,507345,Daly; Alan J.,18,0,18,0
1713506974306,EDS 284,A00,507350,Daly; Alan J.,16,0,16,0
1713506975331,EDS 286,A00,507359,Fine; Sarah,18,0,18,0
1713506976357,EDS 289C,A01,507361,Daly; Alan J.,18,0,18,0
1713506977382,EDS 290,A00,507366,Hofstetter; Carolyn,15,0,15,0
1713506978409,LIGM 5A,A00,507421,Fischer-Grunski; Eva K,20,0,20,0
1713506979433,LIGM 5B,A00,507423,Fischer-Grunski; Eva K,20,0,20,0
1713506980459,LIGM 5C,A00,507425,Fischer-Grunski; Eva K,20,0,20,0
1713506981489,LIIT 5AS,A00,507427,Carnelos; Chiara,20,0,20,0
1713506982514,LIIT 5BS,A00,507430,Carnelos; Chiara,20,0,20,0
1713506983545,LIIT 5CS,A00,507432,Carnelos; Chiara,20,0,20,0
1713506984572,LISP 5A,A00,507541,Munoz Sanchez; Alicia,14,0,20,6
1713506985602,LISP 5B,A00,507671,Munoz Sanchez; Alicia,12,0,20,8
1713506986628,LISP 5C,A00,507696,Munoz Sanchez; Alicia,11,0,20,9
1713506987655,MAE 197,001,528363,Boechler; Nicholas Sebastia,9998,0,9999,1
1713506988681,MATH 197,001,523477,Kedlaya; Kiran S.,9999,0,9999,0
1713506988681,MATH 197,002,563811,Zhang; Danna,9998,0,9999,1
1713506989708,MCWP 40R,A00,518780,Staff,13,0,20,7
1713506989708,MCWP 40R,B00,518781,Staff,11,0,20,9
1713506989708,MCWP 40R,C00,518783,Staff,8,0,20,12
1713506990739,MCWP 50R,A00,518791,Staff,7,0,20,13
1713506990739,MCWP 50R,B00,518792,Staff,3,0,20,17
1713506990739,MCWP 50R,C00,518793,Staff,5,0,20,15
1713506990739,MCWP 50R,D00,518794,Staff,0,0,20,20
1713506990739,MCWP 50R,E00,518795,Staff,0,0,20,20
1713506990739,MCWP 50R,F00,518796,Staff,11,0,20,9
1713506990739,MCWP 50R,G00,518797,Staff,10,0,20,10
1713506991764,MMW 12R,A01,514034,Herbst; Matthew,1,0,16,15
1713506991764,MMW 12R,A02,514035,Herbst; Matthew,13,0,16,3
1713506992790,MMW 13R,A01,514037,Staff,0,8,16,16
1713506992790,MMW 13R,A02,514039,Staff,0,7,16,16
1713506994885,SIO 295LS,A00,523233,Staff,15,0,30,15
1713506995914,SIO 295S,A00,523232,Staff,15,0,30,15
1713506996939,SOCI 117,A01,494376,Staff,0,2,5,5
1713506997967,WES 237B,A00,494380,Staff,19,0,20,1
1713507000036,AESE 279B,A00,494370,Wade; Jon P,33,0,33,0
1713507001062,AIP 197,001,627712,Vespa; Emanuel Ignacio,9999,0,9999,0
1713507002091,ANAR 135S,A00,494369,Braswell; Geoffrey E.,0,0,0,0
1713507003121,CAT 124RS,A01,519847,Geibel; William,6,0,20,14
1713507004151,CAT 125RS,A01,515971,Geibel; William,6,0,20,14
1713507005182,CLRE 250,A00,511389,Morris; Sheldon,9996,0,9999,3
1713507006213,CLRE 251,A00,507176,Mehta; Ravindra L.,9996,0,9999,3
1713507006213,CLRE 251,B00,511410,Mehta; Ravindra L.,9998,0,9999,1
1713507007240,CLRE 252,A00,507189,Cuomo; Raphael Eduardo,9998,0,9999,1
1713507008270,CLRE 253,A00,507199,Vaida; Florin,9997,0,9999,2
1713507008270,CLRE 253,B00,507202,Vaida; Florin,9999,0,9999,0
1713507009295,CLRE 259,A00,507211,Patel; Hemal,9996,0,9999,3
1713507010323,CLRE 260,A00,507221,Cuomo; Raphael Eduardo,9999,0,9999,0
1713507011351,CLRE 297,001,507242,Cuomo; Raphael Eduardo,9999,0,9999,0
1713507012381,CSE 191,A00,516875,Minnes Kemp; Mor Mia,9999,0,9999,0
1713507013410,CSS 201S,A01,494383,Staff,35,0,35,0
1713507014437,CSS 202S,A01,494387,Staff,35,0,35,0
1713507015462,EAP 100,A00,516065,Staff,9792,0,9999,207
1713507016491,ECE 45,A01,507414,Staff,37,0,60,23
1713507017517,ECE 100,A01,507416,Baghdadchi; Saharnaz,0,0,20,20
1713507017517,ECE 100,A02,507418,Baghdadchi; Saharnaz,19,0,20,1
1713507018543,ECE 111,A01,507420,Staff,27,0,50,23
1713507019573,ECE 197,001,548057,Sievenpiper; Daniel F.,9998,0,9999,1
1713507020598,EDS 115,A00,507243,Choi; Bailey Miyeon,27,0,28,1
1713507021627,EDS 117,A01,494379,Staff,15,0,25,10
1713507022652,EDS 125,A00,507246,Hopkins; Megan Beth,27,0,30,3
1713507023678,EDS 128A,A01,507264,Fargason; Sharon Gayle,26,0,26,0
1713507024707,EDS 128B,A01,507293,Pappas; Elizabeth,30,0,30,0
1713507025735,EDS 139,A00,507294,Fargason; Sharon Gayle,30,0,30,0
1713507025735,EDS 139,B00,507313,Pappas; Elizabeth,30,0,30,0
1713507026818,EDS 201,A00,507315,Staff,18,0,30,12
1713507027845,EDS 203,A01,507317,Halter; Christopher P.,17,0,30,13
1713507028872,EDS 204R,A01,507319,Halter; Christopher P.,0,1,30,30
1713507028872,EDS 204R,B01,507331,Heinzman; Erica M.,22,0,30,8
1713507029898,EDS 206R,A00,507332,Staff,0,2,30,30
1713507029898,EDS 206R,B00,507343,Staff,23,0,30,7
1713507030927,EDS 250,A00,507344,Hemans; Patricia Ann Benitez,27,0,40,13
1713507031954,EDS 281,A00,507345,Daly; Alan J.,18,0,18,0
1713507032982,EDS 284,A00,507350,Daly; Alan J.,16,0,16,0
1713507034007,EDS 286,A00,507359,Fine; Sarah,18,0,18,0
1713507035033,EDS 289C,A01,507361,Daly; Alan J.,18,0,18,0
1713507036063,EDS 290,A00,507366,Hofstetter; Carolyn,15,0,15,0
1713507037091,LIGM 5A,A00,507421,Fischer-Grunski; Eva K,20,0,20,0
1713507038116,LIGM 5B,A00,507423,Fischer-Grunski; Eva K,20,0,20,0
1713507039147,LIGM 5C,A00,507425,Fischer-Grunski; Eva K,20,0,20,0
1713507040173,LIIT 5AS,A00,507427,Carnelos; Chiara,20,0,20,0
1713507041200,LIIT 5BS,A00,507430,Carnelos; Chiara,20,0,20,0
1713507042233,LIIT 5CS,A00,507432,Carnelos; Chiara,20,0,20,0
1713507043259,LISP 5A,A00,507541,Munoz Sanchez; Alicia,14,0,20,6
1713507044285,LISP 5B,A00,507671,Munoz Sanchez; Alicia,12,0,20,8
1713507045310,LISP 5C,A00,507696,Munoz Sanchez; Alicia,11,0,20,9
1713507046338,MAE 197,001,528363,Boechler; Nicholas Sebastia,9998,0,9999,1
1713507047363,MATH 197,001,523477,Kedlaya; Kiran S.,9999,0,9999,0
1713507047363,MATH 197,002,563811,Zhang; Danna,9998,0,9999,1
1713507048389,MCWP 40R,A00,518780,Staff,13,0,20,7
1713507048389,MCWP 40R,B00,518781,Staff,11,0,20,9
1713507048389,MCWP 40R,C00,518783,Staff,8,0,20,12
1713507049414,MCWP 50R,A00,518791,Staff,7,0,20,13
1713507049414,MCWP 50R,B00,518792,Staff,3,0,20,17
1713507049414,MCWP 50R,C00,518793,Staff,5,0,20,15
1713507049414,MCWP 50R,D00,518794,Staff,0,0,20,20
1713507049414,MCWP 50R,E00,518795,Staff,0,0,20,20
1713507049414,MCWP 50R,F00,518796,Staff,11,0,20,9
1713507049414,MCWP 50R,G00,518797,Staff,10,0,20,10
1713507050444,MMW 12R,A01,514034,Herbst; Matthew,1,0,16,15
1713507050444,MMW 12R,A02,514035,Herbst; Matthew,13,0,16,3
1713507051469,MMW 13R,A01,514037,Staff,0,8,16,16
1713507051469,MMW 13R,A02,514039,Staff,0,7,16,16
1713507053522,SIO 295LS,A00,523233,Staff,15,0,30,15
1713507054547,SIO 295S,A00,523232,Staff,15,0,30,15
1713507055573,SOCI 117,A01,494376,Staff,0,2,5,5
1713507056600,WES 237B,A00,494380,Staff,19,0,20,1
1713507058668,AESE 279B,A00,494370,Wade; Jon P,33,0,33,0
1713507059692,AIP 197,001,627712,Vespa; Emanuel Ignacio,9999,0,9999,0
1713507060718,ANAR 135S,A00,494369,Braswell; Geoffrey E.,0,0,0,0
1713507061745,CAT 124RS,A01,519847,Geibel; William,6,0,20,14
1713507062770,CAT 125RS,A01,515971,Geibel; William,6,0,20,14
1713507063796,CLRE 250,A00,511389,Morris; Sheldon,9996,0,9999,3
1713507064823,CLRE 251,A00,507176,Mehta; Ravindra L.,9996,0,9999,3
1713507064823,CLRE 251,B00,511410,Mehta; Ravindra L.,9998,0,9999,1
1713507065848,CLRE 252,A00,507189,Cuomo; Raphael Eduardo,9998,0,9999,1
1713507066877,CLRE 253,A00,507199,Vaida; Florin,9997,0,9999,2
1713507066877,CLRE 253,B00,507202,Vaida; Florin,9999,0,9999,0
1713507067906,CLRE 259,A00,507211,Patel; Hemal,9996,0,9999,3
1713507068931,CLRE 260,A00,507221,Cuomo; Raphael Eduardo,9999,0,9999,0
1713507069955,CLRE 297,001,507242,Cuomo; Raphael Eduardo,9999,0,9999,0
1713507070980,CSE 191,A00,516875,Minnes Kemp; Mor Mia,9999,0,9999,0
1713507072011,CSS 201S,A01,494383,Staff,35,0,35,0
1713507073040,CSS 202S,A01,494387,Staff,35,0,35,0
1713507074068,EAP 100,A00,516065,Staff,9792,0,9999,207
1713507075094,ECE 45,A01,507414,Staff,37,0,60,23
1713507076119,ECE 100,A01,507416,Baghdadchi; Saharnaz,0,0,20,20
1713507076119,ECE 100,A02,507418,Baghdadchi; Saharnaz,19,0,20,1
1713507077148,ECE 111,A01,507420,Staff,27,0,50,23
1713507078172,ECE 197,001,548057,Sievenpiper; Daniel F.,9998,0,9999,1
1713507079198,EDS 115,A00,507243,Choi; Bailey Miyeon,27,0,28,1
1713507080227,EDS 117,A01,494379,Staff,15,0,25,10
1713507081256,EDS 125,A00,507246,Hopkins; Megan Beth,27,0,30,3
1713507082281,EDS 128A,A01,507264,Fargason; Sharon Gayle,26,0,26,0
1713507083311,EDS 128B,A01,507293,Pappas; Elizabeth,30,0,30,0
1713507084339,EDS 139,A00,507294,Fargason; Sharon Gayle,30,0,30,0
1713507084339,EDS 139,B00,507313,Pappas; Elizabeth,30,0,30,0
1713507085365,EDS 201,A00,507315,Staff,18,0,30,12
1713507086394,EDS 203,A01,507317,Halter; Christopher P.,17,0,30,13
1713507087419,EDS 204R,A01,507319,Halter; Christopher P.,0,1,30,30
1713507087419,EDS 204R,B01,507331,Heinzman; Erica M.,22,0,30,8
1713507088443,EDS 206R,A00,507332,Staff,0,2,30,30
1713507088443,EDS 206R,B00,507343,Staff,23,0,30,7
1713507089471,EDS 250,A00,507344,Hemans; Patricia Ann Benitez,27,0,40,13
1713507090499,EDS 281,A00,507345,Daly; Alan J.,18,0,18,0
1713507091525,EDS 284,A00,507350,Daly; Alan J.,16,0,16,0
1713507092550,EDS 286,A00,507359,Fine; Sarah,18,0,18,0
1713507093576,EDS 289C,A01,507361,Daly; Alan J.,18,0,18,0
1713507094602,EDS 290,A00,507366,Hofstetter; Carolyn,15,0,15,0
1713507095630,LIGM 5A,A00,507421,Fischer-Grunski; Eva K,20,0,20,0
1713507096659,LIGM 5B,A00,507423,Fischer-Grunski; Eva K,20,0,20,0
1713507097683,LIGM 5C,A00,507425,Fischer-Grunski; Eva K,20,0,20,0
1713507098708,LIIT 5AS,A00,507427,Carnelos; Chiara,20,0,20,0
1713507099737,LIIT 5BS,A00,507430,Carnelos; Chiara,20,0,20,0
1713507100765,LIIT 5CS,A00,507432,Carnelos; Chiara,20,0,20,0
1713507101792,LISP 5A,A00,507541,Munoz Sanchez; Alicia,14,0,20,6
1713507102821,LISP 5B,A00,507671,Munoz Sanchez; Alicia,12,0,20,8
1713507103846,LISP 5C,A00,507696,Munoz Sanchez; Alicia,11,0,20,9
1713507104871,MAE 197,001,528363,Boechler; Nicholas Sebastia,9998,0,9999,1
1713507105895,MATH 197,001,523477,Kedlaya; Kiran S.,9999,0,9999,0
1713507105895,MATH 197,002,563811,Zhang; Danna,9998,0,9999,1
1713507106920,MCWP 40R,A00,518780,Staff,13,0,20,7
1713507106920,MCWP 40R,B00,518781,Staff,11,0,20,9
1713507106920,MCWP 40R,C00,518783,Staff,8,0,20,12
1713507107946,MCWP 50R,A00,518791,Staff,7,0,20,13
1713507107946,MCWP 50R,B00,518792,Staff,3,0,20,17
1713507107946,MCWP 50R,C00,518793,Staff,5,0,20,15
1713507107946,MCWP 50R,D00,518794,Staff,0,0,20,20
1713507107946,MCWP 50R,E00,518795,Staff,0,0,20,20
1713507107946,MCWP 50R,F00,518796,Staff,11,0,20,9
1713507107946,MCWP 50R,G00,518797,Staff,10,0,20,10
1713507108972,MMW 12R,A01,514034,Herbst; Matthew,1,0,16,15
1713507108972,MMW 12R,A02,514035,Herbst; Matthew,13,0,16,3
1713507109997,MMW 13R,A01,514037,Staff,0,8,16,16
1713507109997,MMW 13R,A02,514039,Staff,0,7,16,16
1713507112052,SIO 295LS,A00,523233,Staff,15,0,30,15
1713507113078,SIO 295S,A00,523232,Staff,15,0,30,15
1713507114106,SOCI 117,A01,494376,Staff,0,2,5,5
1713507115134,WES 237B,A00,494380,Staff,19,0,20,1
1713507117201,AESE 279B,A00,494370,Wade; Jon P,33,0,33,0
1713507118226,AIP 197,001,627712,Vespa; Emanuel Ignacio,9999,0,9999,0
1713507119256,ANAR 135S,A00,494369,Braswell; Geoffrey E.,0,0,0,0
1713507120280,CAT 124RS,A01,519847,Geibel; William,6,0,20,14
1713507121306,CAT 125RS,A01,515971,Geibel; William,6,0,20,14
1713507122337,CLRE 250,A00,511389,Morris; Sheldon,9996,0,9999,3
1713507123366,CLRE 251,A00,507176,Mehta; Ravindra L.,9996,0,9999,3
1713507123366,CLRE 251,B00,511410,Mehta; Ravindra L.,9998,0,9999,1
1713507124394,CLRE 252,A00,507189,Cuomo; Raphael Eduardo,9998,0,9999,1
1713507125420,CLRE 253,A00,507199,Vaida; Florin,9997,0,9999,2
1713507125420,CLRE 253,B00,507202,Vaida; Florin,9999,0,9999,0
1713507126451,CLRE 259,A00,507211,Patel; Hemal,9996,0,9999,3
1713507127477,CLRE 260,A00,507221,Cuomo; Raphael Eduardo,9999,0,9999,0
1713507128504,CLRE 297,001,507242,Cuomo; Raphael Eduardo,9999,0,9999,0
1713507129529,CSE 191,A00,516875,Minnes Kemp; Mor Mia,9999,0,9999,0
1713507130608,CSS 201S,A01,494383,Staff,35,0,35,0
1713507131633,CSS 202S,A01,494387,Staff,35,0,35,0
1713507132657,EAP 100,A00,516065,Staff,9792,0,9999,207
1713507133682,ECE 45,A01,507414,Staff,37,0,60,23
1713507134709,ECE 100,A01,507416,Baghdadchi; Saharnaz,0,0,20,20
1713507134709,ECE 100,A02,507418,Baghdadchi; Saharnaz,19,0,20,1
1713507135733,ECE 111,A01,507420,Staff,27,0,50,23
1713507136760,ECE 197,001,548057,Sievenpiper; Daniel F.,9998,0,9999,1
1713507137786,EDS 115,A00,507243,Choi; Bailey Miyeon,27,0,28,1
1713507138814,EDS 117,A01,494379,Staff,15,0,25,10
1713507139842,EDS 125,A00,507246,Hopkins; Megan Beth,27,0,30,3
1713507140867,EDS 128A,A01,507264,Fargason; Sharon Gayle,26,0,26,0
1713507141892,EDS 128B,A01,507293,Pappas; Elizabeth,30,0,30,0
1713507142917,EDS 139,A00,507294,Fargason; Sharon Gayle,30,0,30,0
1713507142917,EDS 139,B00,507313,Pappas; Elizabeth,30,0,30,0
1713507143942,EDS 201,A00,507315,Staff,18,0,30,12
1713507144968,EDS 203,A01,507317,Halter; Christopher P.,17,0,30,13
1713507145996,EDS 204R,A01,507319,Halter; Christopher P.,0,1,30,30
1713507145996,EDS 204R,B01,507331,Heinzman; Erica M.,22,0,30,8
1713507147026,EDS 206R,A00,507332,Staff,0,2,30,30
1713507147026,EDS 206R,B00,507343,Staff,23,0,30,7
1713507148054,EDS 250,A00,507344,Hemans; Patricia Ann Benitez,27,0,40,13
1713507149079,EDS 281,A00,507345,Daly; Alan J.,18,0,18,0
1713507150104,EDS 284,A00,507350,Daly; Alan J.,16,0,16,0
1713507151132,EDS 286,A00,507359,Fine; Sarah,18,0,18,0
1713507152161,EDS 289C,A01,507361,Daly; Alan J.,18,0,18,0
1713507153189,EDS 290,A00,507366,Hofstetter; Carolyn,15,0,15,0
1713507154221,LIGM 5A,A00,507421,Fischer-Grunski; Eva K,20,0,20,0
1713507155247,LIGM 5B,A00,507423,Fischer-Grunski; Eva K,20,0,20,0
1713507156277,LIGM 5C,A00,507425,Fischer-Grunski; Eva K,20,0,20,0
1713507157307,LIIT 5AS,A00,507427,Carnelos; Chiara,20,0,20,0
1713507158337,LIIT 5BS,A00,507430,Carnelos; Chiara,20,0,20,0
1713507159366,LIIT 5CS,A00,507432,Carnelos; Chiara,20,0,20,0
1713507160393,LISP 5A,A00,507541,Munoz Sanchez; Alicia,14,0,20,6
1713507161423,LISP 5B,A00,507671,Munoz Sanchez; Alicia,12,0,20,8
1713507162449,LISP 5C,A00,507696,Munoz Sanchez; Alicia,11,0,20,9
1713507163477,MAE 197,001,528363,Boechler; Nicholas Sebastia,9998,0,9999,1
1713507164502,MATH 197,001,523477,Kedlaya; Kiran S.,9999,0,9999,0
1713507164502,MATH 197,002,563811,Zhang; Danna,9998,0,9999,1
1713507165527,MCWP 40R,A00,518780,Staff,13,0,20,7
1713507165527,MCWP 40R,B00,518781,Staff,11,0,20,9
1713507165527,MCWP 40R,C00,518783,Staff,8,0,20,12
1713507166552,MCWP 50R,A00,518791,Staff,7,0,20,13
1713507166552,MCWP 50R,B00,518792,Staff,3,0,20,17
1713507166552,MCWP 50R,C00,518793,Staff,5,0,20,15
1713507166552,MCWP 50R,D00,518794,Staff,0,0,20,20
1713507166552,MCWP 50R,E00,518795,Staff,0,0,20,20
1713507166552,MCWP 50R,F00,518796,Staff,11,0,20,9
1713507166552,MCWP 50R,G00,518797,Staff,10,0,20,10
1713507167578,MMW 12R,A01,514034,Herbst; Matthew,1,0,16,15
1713507167578,MMW 12R,A02,514035,Herbst; Matthew,13,0,16,3
1713507168603,MMW 13R,A01,514037,Staff,0,8,16,16
1713507168603,MMW 13R,A02,514039,Staff,0,7,16,16
1713507170656,SIO 295LS,A00,523233,Staff,15,0,30,15
1713507171685,SIO 295S,A00,523232,Staff,15,0,30,15
1713507172715,SOCI 117,A01,494376,Staff,0,2,5,5
1713507173740,WES 237B,A00,494380,Staff,19,0,20,1
1713507175802,AESE 279B,A00,494370,Wade; Jon P,33,0,33,0
1713507176827,AIP 197,001,627712,Vespa; Emanuel Ignacio,9999,0,9999,0
1713507177856,ANAR 135S,A00,494369,Braswell; Geoffrey E.,0,0,0,0
1713507178882,CAT 124RS,A01,519847,Geibel; William,6,0,20,14
1713507179910,CAT 125RS,A01,515971,Geibel; William,6,0,20,14
1713507180936,CLRE 250,A00,511389,Morris; Sheldon,9996,0,9999,3
1713507181971,CLRE 251,A00,507176,Mehta; Ravindra L.,9996,0,9999,3
1713507181971,CLRE 251,B00,511410,Mehta; Ravindra L.,9998,0,9999,1
1713507182999,CLRE 252,A00,507189,Cuomo; Raphael Eduardo,9998,0,9999,1
1713507184026,CLRE 253,A00,507199,Vaida; Florin,9997,0,9999,2
1713507184026,CLRE 253,B00,507202,Vaida; Florin,9999,0,9999,0
1713507185052,CLRE 259,A00,507211,Patel; Hemal,9996,0,9999,3
1713507186081,CLRE 260,A00,507221,Cuomo; Raphael Eduardo,9999,0,9999,0
1713507187107,CLRE 297,001,507242,Cuomo; Raphael Eduardo,9999,0,9999,0
1713507188136,CSE 191,A00,516875,Minnes Kemp; Mor Mia,9999,0,9999,0
1713507189163,CSS 201S,A01,494383,Staff,35,0,35,0
1713507190193,CSS 202S,A01,494387,Staff,35,0,35,0
1713507191217,EAP 100,A00,516065,Staff,9792,0,9999,207
1713507192244,ECE 45,A01,507414,Staff,37,0,60,23
1713507193273,ECE 100,A01,507416,Baghdadchi; Saharnaz,0,0,20,20
1713507193273,ECE 100,A02,507418,Baghdadchi; Saharnaz,19,0,20,1
1713507194301,ECE 111,A01,507420,Staff,27,0,50,23
1713507195331,ECE 197,001,548057,Sievenpiper; Daniel F.,9998,0,9999,1
1713507196359,EDS 115,A00,507243,Choi; Bailey Miyeon,27,0,28,1
1713507197390,EDS 117,A01,494379,Staff,15,0,25,10
1713507198415,EDS 125,A00,507246,Hopkins; Megan Beth,27,0,30,3
1713507199442,EDS 128A,A01,507264,Fargason; Sharon Gayle,26,0,26,0
1713507200468,EDS 128B,A01,507293,Pappas; Elizabeth,30,0,30,0
1713507201496,EDS 139,A00,507294,Fargason; Sharon Gayle,30,0,30,0
1713507201496,EDS 139,B00,507313,Pappas; Elizabeth,30,0,30,0
1713507202522,EDS 201,A00,507315,Staff,18,0,30,12
1713507203552,EDS 203,A01,507317,Halter; Christopher P.,17,0,30,13
1713507204579,EDS 204R,A01,507319,Halter; Christopher P.,0,1,30,30
1713507204579,EDS 204R,B01,507331,Heinzman; Erica M.,22,0,30,8
1713507205607,EDS 206R,A00,507332,Staff,0,2,30,30
1713507205607,EDS 206R,B00,507343,Staff,23,0,30,7
1713507206635,EDS 250,A00,507344,Hemans; Patricia Ann Benitez,27,0,40,13
1713507207661,EDS 281,A00,507345,Daly; Alan J.,18,0,18,0
1713507208685,EDS 284,A00,507350,Daly; Alan J.,16,0,16,0
1713507209711,EDS 286,A00,507359,Fine; Sarah,18,0,18,0
1713507210741,EDS 289C,A01,507361,Daly; Alan J.,18,0,18,0
1713507211766,EDS 290,A00,507366,Hofstetter; Carolyn,15,0,15,0
1713507212794,LIGM 5A,A00,507421,Fischer-Grunski; Eva K,20,0,20,0
1713507213820,LIGM 5B,A00,507423,Fischer-Grunski; Eva K,20,0,20,0
1713507214850,LIGM 5C,A00,507425,Fischer-Grunski; Eva K,20,0,20,0
1713507215875,LIIT 5AS,A00,507427,Carnelos; Chiara,20,0,20,0
1713507216905,LIIT 5BS,A00,507430,Carnelos; Chiara,20,0,20,0
1713507217936,LIIT 5CS,A00,507432,Carnelos; Chiara,20,0,20,0
1713507218961,LISP 5A,A00,507541,Munoz Sanchez; Alicia,14,0,20,6
1713507219988,LISP 5B,A00,507671,Munoz Sanchez; Alicia,12,0,20,8
1713507221014,LISP 5C,A00,507696,Munoz Sanchez; Alicia,11,0,20,9
1713507222043,MAE 197,001,528363,Boechler; Nicholas Sebastia,9998,0,9999,1
1713507223075,MATH 197,001,523477,Kedlaya; Kiran S.,9999,0,9999,0
1713507223075,MATH 197,002,563811,Zhang; Danna,9998,0,9999,1
1713507224101,MCWP 40R,A00,518780,Staff,13,0,20,7
1713507224101,MCWP 40R,B00,518781,Staff,11,0,20,9
1713507224101,MCWP 40R,C00,518783,Staff,8,0,20,12
1713507225126,MCWP 50R,A00,518791,Staff,7,0,20,13
1713507225126,MCWP 50R,B00,518792,Staff,3,0,20,17
1713507225126,MCWP 50R,C00,518793,Staff,5,0,20,15
1713507225126,MCWP 50R,D00,518794,Staff,0,0,20,20
1713507225126,MCWP 50R,E00,518795,Staff,0,0,20,20
1713507225126,MCWP 50R,F00,518796,Staff,11,0,20,9
1713507225126,MCWP 50R,G00,518797,Staff,10,0,20,10
1713507226153,MMW 12R,A01,514034,Herbst; Matthew,1,0,16,15
1713507226153,MMW 12R,A02,514035,Herbst; Matthew,13,0,16,3
1713507227177,MMW 13R,A01,514037,Staff,0,8,16,16
1713507227177,MMW 13R,A02,514039,Staff,0,7,16,16
1713507229235,SIO 295LS,A00,523233,Staff,15,0,30,15
1713507230262,SIO 295S,A00,523232,Staff,15,0,30,15
1713507231288,SOCI 117,A01,494376,Staff,0,2,5,5
1713507232317,WES 237B,A00,494380,Staff,19,0,20,1
1713507234441,AESE 279B,A00,494370,Wade; Jon P,33,0,33,0
1713507235466,AIP 197,001,627712,Vespa; Emanuel Ignacio,9999,0,9999,0
1713507236492,ANAR 135S,A00,494369,Braswell; Geoffrey E.,0,0,0,0
1713507237521,CAT 124RS,A01,519847,Geibel; William,6,0,20,14
1713507238547,CAT 125RS,A01,515971,Geibel; William,6,0,20,14
1713507239575,CLRE 250,A00,511389,Morris; Sheldon,9996,0,9999,3
1713507240601,CLRE 251,A00,507176,Mehta; Ravindra L.,9996,0,9999,3
1713507240601,CLRE 251,B00,511410,Mehta; Ravindra L.,9998,0,9999,1
1713507241630,CLRE 252,A00,507189,Cuomo; Raphael Eduardo,9998,0,9999,1
1713507242658,CLRE 253,A00,507199,Vaida; Florin,9997,0,9999,2
1713507242658,CLRE 253,B00,507202,Vaida; Florin,9999,0,9999,0
1713507243684,CLRE 259,A00,507211,Patel; Hemal,9996,0,9999,3
1713507244708,CLRE 260,A00,507221,Cuomo; Raphael Eduardo,9999,0,9999,0
1713507245733,CLRE 297,001,507242,Cuomo; Raphael Eduardo,9999,0,9999,0
1713507246758,CSE 191,A00,516875,Minnes Kemp; Mor Mia,9999,0,9999,0
1713507247793,CSS 201S,A01,494383,Staff,35,0,35,0
1713507248823,CSS 202S,A01,494387,Staff,35,0,35,0
1713507249848,EAP 100,A00,516065,Staff,9792,0,9999,207
1713507250879,ECE 45,A01,507414,Staff,37,0,60,23
1713507251908,ECE 100,A01,507416,Baghdadchi; Saharnaz,0,0,20,20
1713507251908,ECE 100,A02,507418,Baghdadchi; Saharnaz,19,0,20,1
1713507252937,ECE 111,A01,507420,Staff,27,0,50,23
1713507253964,ECE 197,001,548057,Sievenpiper; Daniel F.,9998,0,9999,1
1713507254997,EDS 115,A00,507243,Choi; Bailey Miyeon,27,0,28,1
1713507256022,EDS 117,A01,494379,Staff,15,0,25,10
1713507257048,EDS 125,A00,507246,Hopkins; Megan Beth,27,0,30,3
1713507258078,EDS 128A,A01,507264,Fargason; Sharon Gayle,26,0,26,0
1713507259102,EDS 128B,A01,507293,Pappas; Elizabeth,30,0,30,0
1713507260128,EDS 139,A00,507294,Fargason; Sharon Gayle,30,0,30,0
1713507260128,EDS 139,B00,507313,Pappas; Elizabeth,30,0,30,0
1713507261157,EDS 201,A00,507315,Staff,18,0,30,12
1713507262186,EDS 203,A01,507317,Halter; Christopher P.,17,0,30,13
1713507263216,EDS 204R,A01,507319,Halter; Christopher P.,0,1,30,30
1713507263216,EDS 204R,B01,507331,Heinzman; Erica M.,22,0,30,8
1713507264245,EDS 206R,A00,507332,Staff,0,2,30,30
1713507264245,EDS 206R,B00,507343,Staff,23,0,30,7
1713507265272,EDS 250,A00,507344,Hemans; Patricia Ann Benitez,27,0,40,13
1713507266296,EDS 281,A00,507345,Daly; Alan J.,18,0,18,0
1713507267322,EDS 284,A00,507350,Daly; Alan J.,16,0,16,0
1713507268351,EDS 286,A00,507359,Fine; Sarah,18,0,18,0
1713507269380,EDS 289C,A01,507361,Daly; Alan J.,18,0,18,0
1713507270404,EDS 290,A00,507366,Hofstetter; Carolyn,15,0,15,0
1713507271434,LIGM 5A,A00,507421,Fischer-Grunski; Eva K,20,0,20,0
1713507272460,LIGM 5B,A00,507423,Fischer-Grunski; Eva K,20,0,20,0
1713507273486,LIGM 5C,A00,507425,Fischer-Grunski; Eva K,20,0,20,0
1713507274515,LIIT 5AS,A00,507427,Carnelos; Chiara,20,0,20,0
1713507275543,LIIT 5BS,A00,507430,Carnelos; Chiara,20,0,20,0
1713507276568,LIIT 5CS,A00,507432,Carnelos; Chiara,20,0,20,0
1713507277596,LISP 5A,A00,507541,Munoz Sanchez; Alicia,14,0,20,6
1713507278624,LISP 5B,A00,507671,Munoz Sanchez; Alicia,12,0,20,8
1713507279653,LISP 5C,A00,507696,Munoz Sanchez; Alicia,11,0,20,9
1713507280681,MAE 197,001,528363,Boechler; Nicholas Sebastia,9998,0,9999,1
1713507281710,MATH 197,001,523477,Kedlaya; Kiran S.,9999,0,9999,0
1713507281710,MATH 197,002,563811,Zhang; Danna,9998,0,9999,1
1713507282739,MCWP 40R,A00,518780,Staff,13,0,20,7
1713507282739,MCWP 40R,B00,518781,Staff,11,0,20,9
1713507282739,MCWP 40R,C00,518783,Staff,8,0,20,12
1713507283767,MCWP 50R,A00,518791,Staff,7,0,20,13
1713507283767,MCWP 50R,B00,518792,Staff,3,0,20,17
1713507283767,MCWP 50R,C00,518793,Staff,5,0,20,15
1713507283767,MCWP 50R,D00,518794,Staff,0,0,20,20
1713507283767,MCWP 50R,E00,518795,Staff,0,0,20,20
1713507283767,MCWP 50R,F00,518796,Staff,11,0,20,9
1713507283767,MCWP 50R,G00,518797,Staff,10,0,20,10
1713507284794,MMW 12R,A01,514034,Herbst; Matthew,1,0,16,15
1713507284794,MMW 12R,A02,514035,Herbst; Matthew,13,0,16,3
1713507285823,MMW 13R,A01,514037,Staff,0,8,16,16
1713507285823,MMW 13R,A02,514039,Staff,0,7,16,16
1713507287877,SIO 295LS,A00,523233,Staff,15,0,30,15
1713507288904,SIO 295S,A00,523232,Staff,15,0,30,15
1713507289931,SOCI 117,A01,494376,Staff,0,2,5,5
1713507290955,WES 237B,A00,494380,Staff,19,0,20,1
1713507293015,AESE 279B,A00,494370,Wade; Jon P,33,0,33,0
1713507294041,AIP 197,001,627712,Vespa; Emanuel Ignacio,9999,0,9999,0
1713507295071,ANAR 135S,A00,494369,Braswell; Geoffrey E.,0,0,0,0
1713507296098,CAT 124RS,A01,519847,Geibel; William,6,0,20,14
1713507297127,CAT 125RS,A01,515971,Geibel; William,6,0,20,14
1713507298156,CLRE 250,A00,511389,Morris; Sheldon,9996,0,9999,3
1713507299186,CLRE 251,A00,507176,Mehta; Ravindra L.,9996,0,9999,3
1713507299186,CLRE 251,B00,511410,Mehta; Ravindra L.,9998,0,9999,1
1713507300210,CLRE 252,A00,507189,Cuomo; Raphael Eduardo,9998,0,9999,1
1713507301235,CLRE 253,A00,507199,Vaida; Florin,9997,0,9999,2
1713507301235,CLRE 253,B00,507202,Vaida; Florin,9999,0,9999,0
1713507302260,CLRE 259,A00,507211,Patel; Hemal,9996,0,9999,3
1713507303288,CLRE 260,A00,507221,Cuomo; Raphael Eduardo,9999,0,9999,0
1713507304316,CLRE 297,001,507242,Cuomo; Raphael Eduardo,9999,0,9999,0
1713507305345,CSE 191,A00,516875,Minnes Kemp; Mor Mia,9999,0,9999,0
1713507306371,CSS 201S,A01,494383,Staff,35,0,35,0
1713507307397,CSS 202S,A01,494387,Staff,35,0,35,0
1713507308421,EAP 100,A00,516065,Staff,9792,0,9999,207
1713507309531,ECE 45,A01,507414,Staff,37,0,60,23
1713507310555,ECE 100,A01,507416,Baghdadchi; Saharnaz,0,0,20,20
1713507310555,ECE 100,A02,507418,Baghdadchi; Saharnaz,19,0,20,1
1713507311585,ECE 111,A01,507420,Staff,27,0,50,23
1713507312609,ECE 197,001,548057,Sievenpiper; Daniel F.,9998,0,9999,1
1713507313638,EDS 115,A00,507243,Choi; Bailey Miyeon,27,0,28,1
1713507314662,EDS 117,A01,494379,Staff,15,0,25,10
1713507315688,EDS 125,A00,507246,Hopkins; Megan Beth,27,0,30,3
1713507316717,EDS 128A,A01,507264,Fargason; Sharon Gayle,26,0,26,0
1713507317742,EDS 128B,A01,507293,Pappas; Elizabeth,30,0,30,0
1713507318771,EDS 139,A00,507294,Fargason; Sharon Gayle,30,0,30,0
1713507318771,EDS 139,B00,507313,Pappas; Elizabeth,30,0,30,0
1713507319796,EDS 201,A00,507315,Staff,18,0,30,12
1713507320821,EDS 203,A01,507317,Halter; Christopher P.,17,0,30,13
1713507321847,EDS 204R,A01,507319,Halter; Christopher P.,0,1,30,30
1713507321847,EDS 204R,B01,507331,Heinzman; Erica M.,22,0,30,8
1713507322873,EDS 206R,A00,507332,Staff,0,2,30,30
1713507322873,EDS 206R,B00,507343,Staff,23,0,30,7
1713507323900,EDS 250,A00,507344,Hemans; Patricia Ann Benitez,27,0,40,13
1713507324926,EDS 281,A00,507345,Daly; Alan J.,18,0,18,0
1713507325951,EDS 284,A00,507350,Daly; Alan J.,16,0,16,0
1713507326977,EDS 286,A00,507359,Fine; Sarah,18,0,18,0
1713507328002,EDS 289C,A01,507361,Daly; Alan J.,18,0,18,0
1713507329027,EDS 290,A00,507366,Hofstetter; Carolyn,15,0,15,0
1713507330052,LIGM 5A,A00,507421,Fischer-Grunski; Eva K,20,0,20,0
1713507331078,LIGM 5B,A00,507423,Fischer-Grunski; Eva K,20,0,20,0
1713507332107,LIGM 5C,A00,507425,Fischer-Grunski; Eva K,20,0,20,0
1713507333132,LIIT 5AS,A00,507427,Carnelos; Chiara,20,0,20,0
1713507334158,LIIT 5BS,A00,507430,Carnelos; Chiara,20,0,20,0
1713507335188,LIIT 5CS,A00,507432,Carnelos; Chiara,20,0,20,0
1713507336215,LISP 5A,A00,507541,Munoz Sanchez; Alicia,14,0,20,6
1713507337245,LISP 5B,A00,507671,Munoz Sanchez; Alicia,12,0,20,8
1713507338327,LISP 5C,A00,507696,Munoz Sanchez; Alicia,11,0,20,9
1713507339357,MAE 197,001,528363,Boechler; Nicholas Sebastia,9998,0,9999,1
1713507340386,MATH 197,001,523477,Kedlaya; Kiran S.,9999,0,9999,0
1713507340386,MATH 197,002,563811,Zhang; Danna,9998,0,9999,1
1713507341416,MCWP 40R,A00,518780,Staff,13,0,20,7
1713507341416,MCWP 40R,B00,518781,Staff,11,0,20,9
1713507341416,MCWP 40R,C00,518783,Staff,8,0,20,12
1713507342443,MCWP 50R,A00,518791,Staff,7,0,20,13
1713507342443,MCWP 50R,B00,518792,Staff,3,0,20,17
1713507342443,MCWP 50R,C00,518793,Staff,5,0,20,15
1713507342443,MCWP 50R,D00,518794,Staff,0,0,20,20
1713507342443,MCWP 50R,E00,518795,Staff,0,0,20,20
1713507342443,MCWP 50R,F00,518796,Staff,11,0,20,9
1713507342443,MCWP 50R,G00,518797,Staff,10,0,20,10
1713507343474,MMW 12R,A01,514034,Herbst; Matthew,1,0,16,15
1713507343474,MMW 12R,A02,514035,Herbst; Matthew,13,0,16,3
1713507344502,MMW 13R,A01,514037,Staff,0,8,16,16
1713507344502,MMW 13R,A02,514039,Staff,0,7,16,16
1713507346562,SIO 295LS,A00,523233,Staff,15,0,30,15
1713507347589,SIO 295S,A00,523232,Staff,15,0,30,15
1713507348613,SOCI 117,A01,494376,Staff,0,2,5,5
1713507349639,WES 237B,A00,494380,Staff,19,0,20,1
1713507351697,AESE 279B,A00,494370,Wade; Jon P,33,0,33,0
1713507352724,AIP 197,001,627712,Vespa; Emanuel Ignacio,9999,0,9999,0
1713507353755,ANAR 135S,A00,494369,Braswell; Geoffrey E.,0,0,0,0
1713507354782,CAT 124RS,A01,519847,Geibel; William,6,0,20,14
1713507355807,CAT 125RS,A01,515971,Geibel; William,6,0,20,14
1713507356834,CLRE 250,A00,511389,Morris; Sheldon,9996,0,9999,3
1713507357865,CLRE 251,A00,507176,Mehta; Ravindra L.,9996,0,9999,3
1713507357865,CLRE 251,B00,511410,Mehta; Ravindra L.,9998,0,9999,1
1713507358895,CLRE 252,A00,507189,Cuomo; Raphael Eduardo,9998,0,9999,1
1713507359922,CLRE 253,A00,507199,Vaida; Florin,9997,0,9999,2
1713507359922,CLRE 253,B00,507202,Vaida; Florin,9999,0,9999,0
1713507360949,CLRE 259,A00,507211,Patel; Hemal,9996,0,9999,3
1713507361974,CLRE 260,A00,507221,Cuomo; Raphael Eduardo,9999,0,9999,0
1713507363000,CLRE 297,001,507242,Cuomo; Raphael Eduardo,9999,0,9999,0
1713507364025,CSE 191,A00,516875,Minnes Kemp; Mor Mia,9999,0,9999,0
1713507365054,CSS 201S,A01,494383,Staff,35,0,35,0
1713507366083,CSS 202S,A01,494387,Staff,35,0,35,0
1713507367111,EAP 100,A00,516065,Staff,9792,0,9999,207
1713507368138,ECE 45,A01,507414,Staff,37,0,60,23
1713507369165,ECE 100,A01,507416,Baghdadchi; Saharnaz,0,0,20,20
1713507369165,ECE 100,A02,507418,Baghdadchi; Saharnaz,19,0,20,1
1713507370191,ECE 111,A01,507420,Staff,27,0,50,23
1713507371216,ECE 197,001,548057,Sievenpiper; Daniel F.,9998,0,9999,1
1713507372241,EDS 115,A00,507243,Choi; Bailey Miyeon,27,0,28,1
1713507373270,EDS 117,A01,494379,Staff,15,0,25,10
1713507374300,EDS 125,A00,507246,Hopkins; Megan Beth,27,0,30,3
1713507375330,EDS 128A,A01,507264,Fargason; Sharon Gayle,26,0,26,0
1713507376358,EDS 128B,A01,507293,Pappas; Elizabeth,30,0,30,0
1713507377387,EDS 139,A00,507294,Fargason; Sharon Gayle,30,0,30,0
1713507377387,EDS 139,B00,507313,Pappas; Elizabeth,30,0,30,0
1713507378415,EDS 201,A00,507315,Staff,18,0,30,12
1713507379446,EDS 203,A01,507317,Halter; Christopher P.,17,0,30,13
1713507380471,EDS 204R,A01,507319,Halter; Christopher P.,0,1,30,30
1713507380471,EDS 204R,B01,507331,Heinzman; Erica M.,22,0,30,8
1713507381496,EDS 206R,A00,507332,Staff,0,2,30,30
1713507381496,EDS 206R,B00,507343,Staff,23,0,30,7
1713507382524,EDS 250,A00,507344,Hemans; Patricia Ann Benitez,27,0,40,13
1713507383547,EDS 281,A00,507345,Daly; Alan J.,18,0,18,0
1713507384579,EDS 284,A00,507350,Daly; Alan J.,16,0,16,0
1713507385605,EDS 286,A00,507359,Fine; Sarah,18,0,18,0
1713507386630,EDS 289C,A01,507361,Daly; Alan J.,18,0,18,0
1713507387655,EDS 290,A00,507366,Hofstetter; Carolyn,15,0,15,0
1713507388683,LIGM 5A,A00,507421,Fischer-Grunski; Eva K,20,0,20,0
1713507389709,LIGM 5B,A00,507423,Fischer-Grunski; Eva K,20,0,20,0
1713507390734,LIGM 5C,A00,507425,Fischer-Grunski; Eva K,20,0,20,0
1713507391761,LIIT 5AS,A00,507427,Carnelos; Chiara,20,0,20,0
1713507392787,LIIT 5BS,A00,507430,Carnelos; Chiara,20,0,20,0
1713507393813,LIIT 5CS,A00,507432,Carnelos; Chiara,20,0,20,0
1713507394839,LISP 5A,A00,507541,Munoz Sanchez; Alicia,14,0,20,6
1713507395866,LISP 5B,A00,507671,Munoz Sanchez; Alicia,12,0,20,8
1713507396891,LISP 5C,A00,507696,Munoz Sanchez; Alicia,11,0,20,9
1713507397918,MAE 197,001,528363,Boechler; Nicholas Sebastia,9998,0,9999,1
1713507398943,MATH 197,001,523477,Kedlaya; Kiran S.,9999,0,9999,0
1713507398943,MATH 197,002,563811,Zhang; Danna,9998,0,9999,1
1713507399968,MCWP 40R,A00,518780,Staff,13,0,20,7
1713507399968,MCWP 40R,B00,518781,Staff,11,0,20,9
1713507399968,MCWP 40R,C00,518783,Staff,8,0,20,12
1713507400993,MCWP 50R,A00,518791,Staff,7,0,20,13
1713507400993,MCWP 50R,B00,518792,Staff,3,0,20,17
1713507400993,MCWP 50R,C00,518793,Staff,5,0,20,15
1713507400993,MCWP 50R,D00,518794,Staff,0,0,20,20
1713507400993,MCWP 50R,E00,518795,Staff,0,0,20,20
1713507400993,MCWP 50R,F00,518796,Staff,11,0,20,9
1713507400993,MCWP 50R,G00,518797,Staff,10,0,20,10
1713507402019,MMW 12R,A01,514034,Herbst; Matthew,1,0,16,15
1713507402019,MMW 12R,A02,514035,Herbst; Matthew,13,0,16,3
1713507403044,MMW 13R,A01,514037,Staff,0,8,16,16
1713507403044,MMW 13R,A02,514039,Staff,0,7,16,16
1713507405098,SIO 295LS,A00,523233,Staff,15,0,30,15
1713507406127,SIO 295S,A00,523232,Staff,15,0,30,15
1713507407154,SOCI 117,A01,494376,Staff,0,2,5,5
1713507408182,WES 237B,A00,494380,Staff,19,0,20,1
1713507410246,AESE 279B,A00,494370,Wade; Jon P,33,0,33,0
1713507411275,AIP 197,001,627712,Vespa; Emanuel Ignacio,9999,0,9999,0
1713507412304,ANAR 135S,A00,494369,Braswell; Geoffrey E.,0,0,0,0
1713507413334,CAT 124RS,A01,519847,Geibel; William,6,0,20,14
1713507414360,CAT 125RS,A01,515971,Geibel; William,6,0,20,14
1713507415385,CLRE 250,A00,511389,Morris; Sheldon,9996,0,9999,3
1713507416410,CLRE 251,A00,507176,Mehta; Ravindra L.,9996,0,9999,3
1713507416410,CLRE 251,B00,511410,Mehta; Ravindra L.,9998,0,9999,1
1713507417436,CLRE 252,A00,507189,Cuomo; Raphael Eduardo,9998,0,9999,1
1713507418463,CLRE 253,A00,507199,Vaida; Florin,9997,0,9999,2
1713507418463,CLRE 253,B00,507202,Vaida; Florin,9999,0,9999,0
1713507419488,CLRE 259,A00,507211,Patel; Hemal,9996,0,9999,3
1713507420516,CLRE 260,A00,507221,Cuomo; Raphael Eduardo,9999,0,9999,0
1713507421546,CLRE 297,001,507242,Cuomo; Raphael Eduardo,9999,0,9999,0
1713507422573,CSE 191,A00,516875,Minnes Kemp; Mor Mia,9999,0,9999,0
1713507423602,CSS 201S,A01,494383,Staff,35,0,35,0
1713507424627,CSS 202S,A01,494387,Staff,35,0,35,0
1713507425655,EAP 100,A00,516065,Staff,9792,0,9999,207
1713507426683,ECE 45,A01,507414,Staff,37,0,60,23
1713507427707,ECE 100,A01,507416,Baghdadchi; Saharnaz,0,0,20,20
1713507427707,ECE 100,A02,507418,Baghdadchi; Saharnaz,19,0,20,1
1713507428734,ECE 111,A01,507420,Staff,27,0,50,23
1713507429761,ECE 197,001,548057,Sievenpiper; Daniel F.,9998,0,9999,1
1713507430790,EDS 115,A00,507243,Choi; Bailey Miyeon,27,0,28,1
1713507431815,EDS 117,A01,494379,Staff,15,0,25,10
1713507432840,EDS 125,A00,507246,Hopkins; Megan Beth,27,0,30,3
1713507433869,EDS 128A,A01,507264,Fargason; Sharon Gayle,26,0,26,0
1713507434892,EDS 128B,A01,507293,Pappas; Elizabeth,30,0,30,0
1713507435917,EDS 139,A00,507294,Fargason; Sharon Gayle,30,0,30,0
1713507435917,EDS 139,B00,507313,Pappas; Elizabeth,30,0,30,0
1713507436942,EDS 201,A00,507315,Staff,18,0,30,12
1713507437971,EDS 203,A01,507317,Halter; Christopher P.,17,0,30,13
1713507439000,EDS 204R,A01,507319,Halter; Christopher P.,0,1,30,30
1713507439000,EDS 204R,B01,507331,Heinzman; Erica M.,22,0,30,8
1713507440030,EDS 206R,A00,507332,Staff,0,2,30,30
1713507440030,EDS 206R,B00,507343,Staff,23,0,30,7
1713507441059,EDS 250,A00,507344,Hemans; Patricia Ann Benitez,27,0,40,13
1713507442141,EDS 281,A00,507345,Daly; Alan J.,18,0,18,0
1713507443170,EDS 284,A00,507350,Daly; Alan J.,16,0,16,0
1713507444196,EDS 286,A00,507359,Fine; Sarah,18,0,18,0
1713507445221,EDS 289C,A01,507361,Daly; Alan J.,18,0,18,0
1713507446245,EDS 290,A00,507366,Hofstetter; Carolyn,15,0,15,0
1713507447276,LIGM 5A,A00,507421,Fischer-Grunski; Eva K,20,0,20,0
1713507448306,LIGM 5B,A00,507423,Fischer-Grunski; Eva K,20,0,20,0
1713507449335,LIGM 5C,A00,507425,Fischer-Grunski; Eva K,20,0,20,0
1713507450366,LIIT 5AS,A00,507427,Carnelos; Chiara,20,0,20,0
1713507451390,LIIT 5BS,A00,507430,Carnelos; Chiara,20,0,20,0
1713507452419,LIIT 5CS,A00,507432,Carnelos; Chiara,20,0,20,0
1713507453444,LISP 5A,A00,507541,Munoz Sanchez; Alicia,14,0,20,6
1713507454472,LISP 5B,A00,507671,Munoz Sanchez; Alicia,12,0,20,8
1713507455506,LISP 5C,A00,507696,Munoz Sanchez; Alicia,11,0,20,9
1713507456536,MAE 197,001,528363,Boechler; Nicholas Sebastia,9998,0,9999,1
1713507457560,MATH 197,001,523477,Kedlaya; Kiran S.,9999,0,9999,0
1713507457560,MATH 197,002,563811,Zhang; Danna,9998,0,9999,1
1713507458584,MCWP 40R,A00,518780,Staff,13,0,20,7
1713507458584,MCWP 40R,B00,518781,Staff,11,0,20,9
1713507458584,MCWP 40R,C00,518783,Staff,8,0,20,12
1713507459614,MCWP 50R,A00,518791,Staff,7,0,20,13
1713507459614,MCWP 50R,B00,518792,Staff,3,0,20,17
1713507459614,MCWP 50R,C00,518793,Staff,5,0,20,15
1713507459614,MCWP 50R,D00,518794,Staff,0,0,20,20
1713507459614,MCWP 50R,E00,518795,Staff,0,0,20,20
1713507459614,MCWP 50R,F00,518796,Staff,11,0,20,9
1713507459614,MCWP 50R,G00,518797,Staff,10,0,20,10
1713507460641,MMW 12R,A01,514034,Herbst; Matthew,1,0,16,15
1713507460641,MMW 12R,A02,514035,Herbst; Matthew,13,0,16,3
1713507461669,MMW 13R,A01,514037,Staff,0,8,16,16
1713507461669,MMW 13R,A02,514039,Staff,0,7,16,16
1713507463720,SIO 295LS,A00,523233,Staff,15,0,30,15
1713507464746,SIO 295S,A00,523232,Staff,15,0,30,15
1713507465771,SOCI 117,A01,494376,Staff,0,2,5,5
1713507466800,WES 237B,A00,494380,Staff,19,0,20,1
1713507468871,AESE 279B,A00,494370,Wade; Jon P,33,0,33,0
1713507469902,AIP 197,001,627712,Vespa; Emanuel Ignacio,9999,0,9999,0
1713507470931,ANAR 135S,A00,494369,Braswell; Geoffrey E.,0,0,0,0
1713507471956,CAT 124RS,A01,519847,Geibel; William,6,0,20,14
1713507472982,CAT 125RS,A01,515971,Geibel; William,6,0,20,14
1713507474008,CLRE 250,A00,511389,Morris; Sheldon,9996,0,9999,3
1713507475037,CLRE 251,A00,507176,Mehta; Ravindra L.,9996,0,9999,3
1713507475037,CLRE 251,B00,511410,Mehta; Ravindra L.,9998,0,9999,1
1713507476068,CLRE 252,A00,507189,Cuomo; Raphael Eduardo,9998,0,9999,1
1713507477093,CLRE 253,A00,507199,Vaida; Florin,9997,0,9999,2
1713507477093,CLRE 253,B00,507202,Vaida; Florin,9999,0,9999,0
1713507478120,CLRE 259,A00,507211,Patel; Hemal,9996,0,9999,3
1713507479150,CLRE 260,A00,507221,Cuomo; Raphael Eduardo,9999,0,9999,0
1713507480174,CLRE 297,001,507242,Cuomo; Raphael Eduardo,9999,0,9999,0
1713507481204,CSE 191,A00,516875,Minnes Kemp; Mor Mia,9999,0,9999,0
1713507482234,CSS 201S,A01,494383,Staff,35,0,35,0
1713507483263,CSS 202S,A01,494387,Staff,35,0,35,0
1713507484293,EAP 100,A00,516065,Staff,9792,0,9999,207
1713507485321,ECE 45,A01,507414,Staff,37,0,60,23
1713507486351,ECE 100,A01,507416,Baghdadchi; Saharnaz,0,0,20,20
1713507486351,ECE 100,A02,507418,Baghdadchi; Saharnaz,19,0,20,1
1713507487378,ECE 111,A01,507420,Staff,27,0,50,23
1713507488407,ECE 197,001,548057,Sievenpiper; Daniel F.,9998,0,9999,1
1713507489435,EDS 115,A00,507243,Choi; Bailey Miyeon,27,0,28,1
1713507490463,EDS 117,A01,494379,Staff,15,0,25,10
1713507491493,EDS 125,A00,507246,Hopkins; Megan Beth,27,0,30,3
1713507492517,EDS 128A,A01,507264,Fargason; Sharon Gayle,26,0,26,0
1713507493542,EDS 128B,A01,507293,Pappas; Elizabeth,30,0,30,0
1713507494568,EDS 139,A00,507294,Fargason; Sharon Gayle,30,0,30,0
1713507494568,EDS 139,B00,507313,Pappas; Elizabeth,30,0,30,0
1713507495595,EDS 201,A00,507315,Staff,18,0,30,12
1713507496624,EDS 203,A01,507317,Halter; Christopher P.,17,0,30,13
1713507497650,EDS 204R,A01,507319,Halter; Christopher P.,0,1,30,30
1713507497650,EDS 204R,B01,507331,Heinzman; Erica M.,22,0,30,8
1713507498674,EDS 206R,A00,507332,Staff,0,2,30,30
1713507498674,EDS 206R,B00,507343,Staff,23,0,30,7
1713507499702,EDS 250,A00,507344,Hemans; Patricia Ann Benitez,27,0,40,13
1713507500727,EDS 281,A00,507345,Daly; Alan J.,18,0,18,0
1713507501753,EDS 284,A00,507350,Daly; Alan J.,16,0,16,0
1713507502782,EDS 286,A00,507359,Fine; Sarah,18,0,18,0
1713507503807,EDS 289C,A01,507361,Daly; Alan J.,18,0,18,0
1713507504832,EDS 290,A00,507366,Hofstetter; Carolyn,15,0,15,0
1713507505859,LIGM 5A,A00,507421,Fischer-Grunski; Eva K,20,0,20,0
1713507506890,LIGM 5B,A00,507423,Fischer-Grunski; Eva K,20,0,20,0
1713507507920,LIGM 5C,A00,507425,Fischer-Grunski; Eva K,20,0,20,0
1713507508952,LIIT 5AS,A00,507427,Carnelos; Chiara,20,0,20,0
1713507509980,LIIT 5BS,A00,507430,Carnelos; Chiara,20,0,20,0
1713507511010,LIIT 5CS,A00,507432,Carnelos; Chiara,20,0,20,0
1713507512041,LISP 5A,A00,507541,Munoz Sanchez; Alicia,14,0,20,6
1713507513067,LISP 5B,A00,507671,Munoz Sanchez; Alicia,12,0,20,8
1713507514093,LISP 5C,A00,507696,Munoz Sanchez; Alicia,11,0,20,9
1713507515119,MAE 197,001,528363,Boechler; Nicholas Sebastia,9998,0,9999,1
1713507516146,MATH 197,001,523477,Kedlaya; Kiran S.,9999,0,9999,0
1713507516146,MATH 197,002,563811,Zhang; Danna,9998,0,9999,1
1713507517171,MCWP 40R,A00,518780,Staff,13,0,20,7
1713507517171,MCWP 40R,B00,518781,Staff,11,0,20,9
1713507517171,MCWP 40R,C00,518783,Staff,8,0,20,12
1713507518198,MCWP 50R,A00,518791,Staff,7,0,20,13
1713507518198,MCWP 50R,B00,518792,Staff,3,0,20,17
1713507518198,MCWP 50R,C00,518793,Staff,5,0,20,15
1713507518198,MCWP 50R,D00,518794,Staff,0,0,20,20
1713507518198,MCWP 50R,E00,518795,Staff,0,0,20,20
1713507518198,MCWP 50R,F00,518796,Staff,11,0,20,9
1713507518198,MCWP 50R,G00,518797,Staff,10,0,20,10
1713507519224,MMW 12R,A01,514034,Herbst; Matthew,1,0,16,15
1713507519224,MMW 12R,A02,514035,Herbst; Matthew,13,0,16,3
1713507520250,MMW 13R,A01,514037,Staff,0,8,16,16
1713507520250,MMW 13R,A02,514039,Staff,0,7,16,16
1713507522303,SIO 295LS,A00,523233,Staff,15,0,30,15
1713507523334,SIO 295S,A00,523232,Staff,15,0,30,15
1713507524361,SOCI 117,A01,494376,Staff,0,2,5,5
1713507525386,WES 237B,A00,494380,Staff,19,0,20,1
1713507527466,AESE 279B,A00,494370,Wade; Jon P,33,0,33,0
1713507528491,AIP 197,001,627712,Vespa; Emanuel Ignacio,9999,0,9999,0
1713507529520,ANAR 135S,A00,494369,Braswell; Geoffrey E.,0,0,0,0
1713507530545,CAT 124RS,A01,519847,Geibel; William,6,0,20,14
1713507531572,CAT 125RS,A01,515971,Geibel; William,6,0,20,14
1713507532598,CLRE 250,A00,511389,Morris; Sheldon,9996,0,9999,3
1713507533628,CLRE 251,A00,507176,Mehta; Ravindra L.,9996,0,9999,3
1713507533628,CLRE 251,B00,511410,Mehta; Ravindra L.,9998,0,9999,1
1713507534653,CLRE 252,A00,507189,Cuomo; Raphael Eduardo,9998,0,9999,1
1713507535684,CLRE 253,A00,507199,Vaida; Florin,9997,0,9999,2
1713507535684,CLRE 253,B00,507202,Vaida; Florin,9999,0,9999,0
1713507536713,CLRE 259,A00,507211,Patel; Hemal,9996,0,9999,3
1713507537739,CLRE 260,A00,507221,Cuomo; Raphael Eduardo,9999,0,9999,0
1713507538765,CLRE 297,001,507242,Cuomo; Raphael Eduardo,9999,0,9999,0
1713507539791,CSE 191,A00,516875,Minnes Kemp; Mor Mia,9999,0,9999,0
1713507540823,CSS 201S,A01,494383,Staff,35,0,35,0
1713507541849,CSS 202S,A01,494387,Staff,35,0,35,0
1713507542876,EAP 100,A00,516065,Staff,9792,0,9999,207
1713507543904,ECE 45,A01,507414,Staff,37,0,60,23
1713507544932,ECE 100,A01,507416,Baghdadchi; Saharnaz,0,0,20,20
1713507544932,ECE 100,A02,507418,Baghdadchi; Saharnaz,19,0,20,1
1713507546014,ECE 111,A01,507420,Staff,27,0,50,23
1713507547042,ECE 197,001,548057,Sievenpiper; Daniel F.,9998,0,9999,1
1713507548068,EDS 115,A00,507243,Choi; Bailey Miyeon,27,0,28,1
1713507549095,EDS 117,A01,494379,Staff,15,0,25,10
1713507550121,EDS 125,A00,507246,Hopkins; Megan Beth,27,0,30,3
1713507551146,EDS 128A,A01,507264,Fargason; Sharon Gayle,26,0,26,0
1713507552175,EDS 128B,A01,507293,Pappas; Elizabeth,30,0,30,0
1713507553205,EDS 139,A00,507294,Fargason; Sharon Gayle,30,0,30,0
1713507553205,EDS 139,B00,507313,Pappas; Elizabeth,30,0,30,0
1713507554231,EDS 201,A00,507315,Staff,18,0,30,12
1713507555258,EDS 203,A01,507317,Halter; Christopher P.,17,0,30,13
1713507556288,EDS 204R,A01,507319,Halter; Christopher P.,0,1,30,30
1713507556288,EDS 204R,B01,507331,Heinzman; Erica M.,22,0,30,8
1713507557318,EDS 206R,A00,507332,Staff,0,2,30,30
1713507557318,EDS 206R,B00,507343,Staff,23,0,30,7
1713507558343,EDS 250,A00,507344,Hemans; Patricia Ann Benitez,27,0,40,13
1713507559369,EDS 281,A00,507345,Daly; Alan J.,18,0,18,0
1713507560398,EDS 284,A00,507350,Daly; Alan J.,16,0,16,0
1713507561424,EDS 286,A00,507359,Fine; Sarah,18,0,18,0
1713507562457,EDS 289C,A01,507361,Daly; Alan J.,18,0,18,0
1713507563485,EDS 290,A00,507366,Hofstetter; Carolyn,15,0,15,0
1713507564514,LIGM 5A,A00,507421,Fischer-Grunski; Eva K,20,0,20,0
1713507565544,LIGM 5B,A00,507423,Fischer-Grunski; Eva K,20,0,20,0
1713507566570,LIGM 5C,A00,507425,Fischer-Grunski; Eva K,20,0,20,0
1713507567597,LIIT 5AS,A00,507427,Carnelos; Chiara,20,0,20,0
1713507568622,LIIT 5BS,A00,507430,Carnelos; Chiara,20,0,20,0
1713507569652,LIIT 5CS,A00,507432,Carnelos; Chiara,20,0,20,0
1713507570680,LISP 5A,A00,507541,Munoz Sanchez; Alicia,14,0,20,6
1713507571705,LISP 5B,A00,507671,Munoz Sanchez; Alicia,12,0,20,8
1713507572736,LISP 5C,A00,507696,Munoz Sanchez; Alicia,11,0,20,9
1713507573762,MAE 197,001,528363,Boechler; Nicholas Sebastia,9998,0,9999,1
1713507574792,MATH 197,001,523477,Kedlaya; Kiran S.,9999,0,9999,0
1713507574792,MATH 197,002,563811,Zhang; Danna,9998,0,9999,1
1713507575818,MCWP 40R,A00,518780,Staff,13,0,20,7
1713507575818,MCWP 40R,B00,518781,Staff,11,0,20,9
1713507575818,MCWP 40R,C00,518783,Staff,8,0,20,12
1713507576844,MCWP 50R,A00,518791,Staff,7,0,20,13
1713507576844,MCWP 50R,B00,518792,Staff,3,0,20,17
1713507576844,MCWP 50R,C00,518793,Staff,5,0,20,15
1713507576844,MCWP 50R,D00,518794,Staff,0,0,20,20
1713507576844,MCWP 50R,E00,518795,Staff,0,0,20,20
1713507576844,MCWP 50R,F00,518796,Staff,11,0,20,9
1713507576844,MCWP 50R,G00,518797,Staff,10,0,20,10
1713507577873,MMW 12R,A01,514034,Herbst; Matthew,1,0,16,15
1713507577873,MMW 12R,A02,514035,Herbst; Matthew,13,0,16,3
1713507578905,MMW 13R,A01,514037,Staff,0,8,16,16
1713507578905,MMW 13R,A02,514039,Staff,0,7,16,16
1713507580958,SIO 295LS,A00,523233,Staff,15,0,30,15
1713507581984,SIO 295S,A00,523232,Staff,15,0,30,15
1713507583017,SOCI 117,A01,494376,Staff,0,2,5,5
1713507584044,WES 237B,A00,494380,Staff,19,0,20,1
1713507586125,AESE 279B,A00,494370,Wade; Jon P,33,0,33,0
1713507587154,AIP 197,001,627712,Vespa; Emanuel Ignacio,9999,0,9999,0
1713507588179,ANAR 135S,A00,494369,Braswell; Geoffrey E.,0,0,0,0
1713507589206,CAT 124RS,A01,519847,Geibel; William,6,0,20,14
1713507590231,CAT 125RS,A01,515971,Geibel; William,6,0,20,14
1713507591259,CLRE 250,A00,511389,Morris; Sheldon,9996,0,9999,3
1713507592290,CLRE 251,A00,507176,Mehta; Ravindra L.,9996,0,9999,3
1713507592290,CLRE 251,B00,511410,Mehta; Ravindra L.,9998,0,9999,1
1713507593316,CLRE 252,A00,507189,Cuomo; Raphael Eduardo,9998,0,9999,1
1713507594345,CLRE 253,A00,507199,Vaida; Florin,9997,0,9999,2
1713507594345,CLRE 253,B00,507202,Vaida; Florin,9999,0,9999,0
1713507595373,CLRE 259,A00,507211,Patel; Hemal,9996,0,9999,3
1713507596398,CLRE 260,A00,507221,Cuomo; Raphael Eduardo,9999,0,9999,0
1713507597425,CLRE 297,001,507242,Cuomo; Raphael Eduardo,9999,0,9999,0
1713507598450,CSE 191,A00,516875,Minnes Kemp; Mor Mia,9999,0,9999,0
1713507599479,CSS 201S,A01,494383,Staff,35,0,35,0
1713507600503,CSS 202S,A01,494387,Staff,35,0,35,0
1713507601532,EAP 100,A00,516065,Staff,9792,0,9999,207
1713507602562,ECE 45,A01,507414,Staff,37,0,60,23
1713507603594,ECE 100,A01,507416,Baghdadchi; Saharnaz,0,0,20,20
1713507603594,ECE 100,A02,507418,Baghdadchi; Saharnaz,19,0,20,1
1713507604624,ECE 111,A01,507420,Staff,27,0,50,23
1713507605654,ECE 197,001,548057,Sievenpiper; Daniel F.,9998,0,9999,1
1713507606680,EDS 115,A00,507243,Choi; Bailey Miyeon,27,0,28,1
1713507607710,EDS 117,A01,494379,Staff,15,0,25,10
1713507608743,EDS 125,A00,507246,Hopkins; Megan Beth,27,0,30,3
1713507609769,EDS 128A,A01,507264,Fargason; Sharon Gayle,26,0,26,0
1713507610796,EDS 128B,A01,507293,Pappas; Elizabeth,30,0,30,0
1713507611822,EDS 139,A00,507294,Fargason; Sharon Gayle,30,0,30,0
1713507611822,EDS 139,B00,507313,Pappas; Elizabeth,30,0,30,0
1713507612848,EDS 201,A00,507315,Staff,18,0,30,12
1713507613874,EDS 203,A01,507317,Halter; Christopher P.,17,0,30,13
1713507614898,EDS 204R,A01,507319,Halter; Christopher P.,0,1,30,30
1713507614898,EDS 204R,B01,507331,Heinzman; Erica M.,22,0,30,8
1713507615923,EDS 206R,A00,507332,Staff,0,2,30,30
1713507615923,EDS 206R,B00,507343,Staff,23,0,30,7
1713507616953,EDS 250,A00,507344,Hemans; Patricia Ann Benitez,27,0,40,13
1713507617978,EDS 281,A00,507345,Daly; Alan J.,18,0,18,0
1713507619003,EDS 284,A00,507350,Daly; Alan J.,16,0,16,0
1713507620034,EDS 286,A00,507359,Fine; Sarah,18,0,18,0
1713507621063,EDS 289C,A01,507361,Daly; Alan J.,18,0,18,0
1713507622087,EDS 290,A00,507366,Hofstetter; Carolyn,15,0,15,0
1713507623115,LIGM 5A,A00,507421,Fischer-Grunski; Eva K,20,0,20,0
1713507624140,LIGM 5B,A00,507423,Fischer-Grunski; Eva K,20,0,20,0
1713507625168,LIGM 5C,A00,507425,Fischer-Grunski; Eva K,20,0,20,0
1713507626194,LIIT 5AS,A00,507427,Carnelos; Chiara,20,0,20,0
1713507627222,LIIT 5BS,A00,507430,Carnelos; Chiara,20,0,20,0
1713507628248,LIIT 5CS,A00,507432,Carnelos; Chiara,20,0,20,0
1713507629280,LISP 5A,A00,507541,Munoz Sanchez; Alicia,14,0,20,6
1713507630310,LISP 5B,A00,507671,Munoz Sanchez; Alicia,12,0,20,8
1713507631335,LISP 5C,A00,507696,Munoz Sanchez; Alicia,11,0,20,9
1713507632364,MAE 197,001,528363,Boechler; Nicholas Sebastia,9998,0,9999,1
1713507633389,MATH 197,001,523477,Kedlaya; Kiran S.,9999,0,9999,0
1713507633389,MATH 197,002,563811,Zhang; Danna,9998,0,9999,1
1713507634415,MCWP 40R,A00,518780,Staff,13,0,20,7
1713507634415,MCWP 40R,B00,518781,Staff,11,0,20,9
1713507634415,MCWP 40R,C00,518783,Staff,8,0,20,12
1713507635444,MCWP 50R,A00,518791,Staff,7,0,20,13
1713507635444,MCWP 50R,B00,518792,Staff,3,0,20,17
1713507635444,MCWP 50R,C00,518793,Staff,5,0,20,15
1713507635444,MCWP 50R,D00,518794,Staff,0,0,20,20
1713507635444,MCWP 50R,E00,518795,Staff,0,0,20,20
1713507635444,MCWP 50R,F00,518796,Staff,11,0,20,9
1713507635444,MCWP 50R,G00,518797,Staff,10,0,20,10
1713507636472,MMW 12R,A01,514034,Herbst; Matthew,1,0,16,15
1713507636472,MMW 12R,A02,514035,Herbst; Matthew,13,0,16,3
1713507637499,MMW 13R,A01,514037,Staff,0,8,16,16
1713507637499,MMW 13R,A02,514039,Staff,0,7,16,16
1713507639555,SIO 295LS,A00,523233,Staff,15,0,30,15
1713507640581,SIO 295S,A00,523232,Staff,15,0,30,15
1713507641605,SOCI 117,A01,494376,Staff,0,2,5,5
1713507642630,WES 237B,A00,494380,Staff,19,0,20,1
1713507644695,AESE 279B,A00,494370,Wade; Jon P,33,0,33,0
1713507645720,AIP 197,001,627712,Vespa; Emanuel Ignacio,9999,0,9999,0
1713507646745,ANAR 135S,A00,494369,Braswell; Geoffrey E.,0,0,0,0
1713507647771,CAT 124RS,A01,519847,Geibel; William,6,0,20,14
1713507648796,CAT 125RS,A01,515971,Geibel; William,6,0,20,14
1713507649881,CLRE 250,A00,511389,Morris; Sheldon,9996,0,9999,3
1713507650910,CLRE 251,A00,507176,Mehta; Ravindra L.,9996,0,9999,3
1713507650910,CLRE 251,B00,511410,Mehta; Ravindra L.,9998,0,9999,1
1713507651937,CLRE 252,A00,507189,Cuomo; Raphael Eduardo,9998,0,9999,1
1713507652969,CLRE 253,A00,507199,Vaida; Florin,9997,0,9999,2
1713507652969,CLRE 253,B00,507202,Vaida; Florin,9999,0,9999,0
1713507653999,CLRE 259,A00,507211,Patel; Hemal,9996,0,9999,3
1713507655031,CLRE 260,A00,507221,Cuomo; Raphael Eduardo,9999,0,9999,0
1713507656057,CLRE 297,001,507242,Cuomo; Raphael Eduardo,9999,0,9999,0
1713507657088,CSE 191,A00,516875,Minnes Kemp; Mor Mia,9999,0,9999,0
1713507658115,CSS 201S,A01,494383,Staff,35,0,35,0
1713507659150,CSS 202S,A01,494387,Staff,35,0,35,0
1713507660176,EAP 100,A00,516065,Staff,9792,0,9999,207
1713507661202,ECE 45,A01,507414,Staff,37,0,60,23
1713507662232,ECE 100,A01,507416,Baghdadchi; Saharnaz,0,0,20,20
1713507662232,ECE 100,A02,507418,Baghdadchi; Saharnaz,19,0,20,1
1713507663266,ECE 111,A01,507420,Staff,27,0,50,23
1713507664301,ECE 197,001,548057,Sievenpiper; Daniel F.,9998,0,9999,1
1713507665329,EDS 115,A00,507243,Choi; Bailey Miyeon,27,0,28,1
1713507666355,EDS 117,A01,494379,Staff,15,0,25,10
1713507667379,EDS 125,A00,507246,Hopkins; Megan Beth,27,0,30,3
1713507668407,EDS 128A,A01,507264,Fargason; Sharon Gayle,26,0,26,0
1713507669431,EDS 128B,A01,507293,Pappas; Elizabeth,30,0,30,0
1713507670455,EDS 139,A00,507294,Fargason; Sharon Gayle,30,0,30,0
1713507670455,EDS 139,B00,507313,Pappas; Elizabeth,30,0,30,0
1713507671481,EDS 201,A00,507315,Staff,18,0,30,12
1713507672511,EDS 203,A01,507317,Halter; Christopher P.,17,0,30,13
1713507673536,EDS 204R,A01,507319,Halter; Christopher P.,0,1,30,30
1713507673536,EDS 204R,B01,507331,Heinzman; Erica M.,22,0,30,8
1713507674566,EDS 206R,A00,507332,Staff,0,2,30,30
1713507674566,EDS 206R,B00,507343,Staff,23,0,30,7
1713507675592,EDS 250,A00,507344,Hemans; Patricia Ann Benitez,27,0,40,13
1713507676621,EDS 281,A00,507345,Daly; Alan J.,18,0,18,0
1713507677647,EDS 284,A00,507350,Daly; Alan J.,16,0,16,0
1713507678676,EDS 286,A00,507359,Fine; Sarah,18,0,18,0
1713507679704,EDS 289C,A01,507361,Daly; Alan J.,18,0,18,0
1713507680728,EDS 290,A00,507366,Hofstetter; Carolyn,15,0,15,0
1713507681758,LIGM 5A,A00,507421,Fischer-Grunski; Eva K,20,0,20,0
1713507682785,LIGM 5B,A00,507423,Fischer-Grunski; Eva K,20,0,20,0
1713507683810,LIGM 5C,A00,507425,Fischer-Grunski; Eva K,20,0,20,0
1713507684836,LIIT 5AS,A00,507427,Carnelos; Chiara,20,0,20,0
1713507685862,LIIT 5BS,A00,507430,Carnelos; Chiara,20,0,20,0
1713507686892,LIIT 5CS,A00,507432,Carnelos; Chiara,20,0,20,0
1713507687916,LISP 5A,A00,507541,Munoz Sanchez; Alicia,14,0,20,6
1713507688946,LISP 5B,A00,507671,Munoz Sanchez; Alicia,12,0,20,8
1713507689979,LISP 5C,A00,507696,Munoz Sanchez; Alicia,11,0,20,9
1713507691006,MAE 197,001,528363,Boechler; Nicholas Sebastia,9998,0,9999,1
1713507692030,MATH 197,001,523477,Kedlaya; Kiran S.,9999,0,9999,0
1713507692030,MATH 197,002,563811,Zhang; Danna,9998,0,9999,1
1713507693061,MCWP 40R,A00,518780,Staff,13,0,20,7
1713507693061,MCWP 40R,B00,518781,Staff,11,0,20,9
1713507693061,MCWP 40R,C00,518783,Staff,8,0,20,12
1713507694085,MCWP 50R,A00,518791,Staff,7,0,20,13
1713507694085,MCWP 50R,B00,518792,Staff,3,0,20,17
1713507694085,MCWP 50R,C00,518793,Staff,5,0,20,15
1713507694085,MCWP 50R,D00,518794,Staff,0,0,20,20
1713507694085,MCWP 50R,E00,518795,Staff,0,0,20,20
1713507694085,MCWP 50R,F00,518796,Staff,11,0,20,9
1713507694085,MCWP 50R,G00,518797,Staff,10,0,20,10
1713507695111,MMW 12R,A01,514034,Herbst; Matthew,1,0,16,15
1713507695111,MMW 12R,A02,514035,Herbst; Matthew,13,0,16,3
1713507696138,MMW 13R,A01,514037,Staff,0,8,16,16
1713507696138,MMW 13R,A02,514039,Staff,0,7,16,16
1713507698190,SIO 295LS,A00,523233,Staff,15,0,30,15
1713507699217,SIO 295S,A00,523232,Staff,15,0,30,15
1713507700243,SOCI 117,A01,494376,Staff,0,2,5,5
1713507701270,WES 237B,A00,494380,Staff,19,0,20,1
1713507703347,AESE 279B,A00,494370,Wade; Jon P,33,0,33,0
1713507704378,AIP 197,001,627712,Vespa; Emanuel Ignacio,9999,0,9999,0
1713507705403,ANAR 135S,A00,494369,Braswell; Geoffrey E.,0,0,0,0
1713507706429,CAT 124RS,A01,519847,Geibel; William,6,0,20,14
1713507707454,CAT 125RS,A01,515971,Geibel; William,6,0,20,14
1713507708480,CLRE 250,A00,511389,Morris; Sheldon,9996,0,9999,3
1713507709510,CLRE 251,A00,507176,Mehta; Ravindra L.,9996,0,9999,3
1713507709510,CLRE 251,B00,511410,Mehta; Ravindra L.,9998,0,9999,1
1713507710534,CLRE 252,A00,507189,Cuomo; Raphael Eduardo,9998,0,9999,1
1713507711566,CLRE 253,A00,507199,Vaida; Florin,9997,0,9999,2
1713507711566,CLRE 253,B00,507202,Vaida; Florin,9999,0,9999,0
1713507712602,CLRE 259,A00,507211,Patel; Hemal,9996,0,9999,3
1713507713627,CLRE 260,A00,507221,Cuomo; Raphael Eduardo,9999,0,9999,0
1713507714652,CLRE 297,001,507242,Cuomo; Raphael Eduardo,9999,0,9999,0
1713507715679,CSE 191,A00,516875,Minnes Kemp; Mor Mia,9999,0,9999,0
1713507716705,CSS 201S,A01,494383,Staff,35,0,35,0
1713507717731,CSS 202S,A01,494387,Staff,35,0,35,0
1713507718756,EAP 100,A00,516065,Staff,9792,0,9999,207
1713507719786,ECE 45,A01,507414,Staff,37,0,60,23
1713507720816,ECE 100,A01,507416,Baghdadchi; Saharnaz,0,0,20,20
1713507720816,ECE 100,A02,507418,Baghdadchi; Saharnaz,19,0,20,1
1713507721841,ECE 111,A01,507420,Staff,27,0,50,23
1713507722868,ECE 197,001,548057,Sievenpiper; Daniel F.,9998,0,9999,1
1713507723902,EDS 115,A00,507243,Choi; Bailey Miyeon,27,0,28,1
1713507724939,EDS 117,A01,494379,Staff,15,0,25,10
1713507725966,EDS 125,A00,507246,Hopkins; Megan Beth,27,0,30,3
1713507726995,EDS 128A,A01,507264,Fargason; Sharon Gayle,26,0,26,0
1713507728024,EDS 128B,A01,507293,Pappas; Elizabeth,30,0,30,0
1713507729056,EDS 139,A00,507294,Fargason; Sharon Gayle,30,0,30,0
1713507729056,EDS 139,B00,507313,Pappas; Elizabeth,30,0,30,0
1713507730090,EDS 201,A00,507315,Staff,18,0,30,12
1713507731120,EDS 203,A01,507317,Halter; Christopher P.,17,0,30,13
1713507732146,EDS 204R,A01,507319,Halter; Christopher P.,0,1,30,30
1713507732146,EDS 204R,B01,507331,Heinzman; Erica M.,22,0,30,8
1713507733171,EDS 206R,A00,507332,Staff,0,2,30,30
1713507733171,EDS 206R,B00,507343,Staff,23,0,30,7
1713507734198,EDS 250,A00,507344,Hemans; Patricia Ann Benitez,27,0,40,13
1713507735230,EDS 281,A00,507345,Daly; Alan J.,18,0,18,0
1713507736259,EDS 284,A00,507350,Daly; Alan J.,16,0,16,0
1713507737296,EDS 286,A00,507359,Fine; Sarah,18,0,18,0
1713507738326,EDS 289C,A01,507361,Daly; Alan J.,18,0,18,0
1713507739351,EDS 290,A00,507366,Hofstetter; Carolyn,15,0,15,0
1713507740377,LIGM 5A,A00,507421,Fischer-Grunski; Eva K,20,0,20,0
1713507741411,LIGM 5B,A00,507423,Fischer-Grunski; Eva K,20,0,20,0
1713507742441,LIGM 5C,A00,507425,Fischer-Grunski; Eva K,20,0,20,0
1713507743467,LIIT 5AS,A00,507427,Carnelos; Chiara,20,0,20,0
1713507744496,LIIT 5BS,A00,507430,Carnelos; Chiara,20,0,20,0
1713507745520,LIIT 5CS,A00,507432,Carnelos; Chiara,20,0,20,0
1713507746552,LISP 5A,A00,507541,Munoz Sanchez; Alicia,14,0,20,6
1713507747586,LISP 5B,A00,507671,Munoz Sanchez; Alicia,12,0,20,8
1713507748611,LISP 5C,A00,507696,Munoz Sanchez; Alicia,11,0,20,9
1713507749636,MAE 197,001,528363,Boechler; Nicholas Sebastia,9998,0,9999,1
1713507750663,MATH 197,001,523477,Kedlaya; Kiran S.,9999,0,9999,0
1713507750663,MATH 197,002,563811,Zhang; Danna,9998,0,9999,1
1713507751692,MCWP 40R,A00,518780,Staff,13,0,20,7
1713507751692,MCWP 40R,B00,518781,Staff,11,0,20,9
1713507751692,MCWP 40R,C00,518783,Staff,8,0,20,12
1713507752717,MCWP 50R,A00,518791,Staff,7,0,20,13
1713507752717,MCWP 50R,B00,518792,Staff,3,0,20,17
1713507752717,MCWP 50R,C00,518793,Staff,5,0,20,15
1713507752717,MCWP 50R,D00,518794,Staff,0,0,20,20
1713507752717,MCWP 50R,E00,518795,Staff,0,0,20,20
1713507752717,MCWP 50R,F00,518796,Staff,11,0,20,9
1713507752717,MCWP 50R,G00,518797,Staff,10,0,20,10
1713507753801,MMW 12R,A01,514034,Herbst; Matthew,1,0,16,15
1713507753801,MMW 12R,A02,514035,Herbst; Matthew,13,0,16,3
1713507754827,MMW 13R,A01,514037,Staff,0,8,16,16
1713507754827,MMW 13R,A02,514039,Staff,0,7,16,16
1713507756899,SIO 295LS,A00,523233,Staff,15,0,30,15
1713507757928,SIO 295S,A00,523232,Staff,15,0,30,15
1713507758958,SOCI 117,A01,494376,Staff,0,2,5,5
1713507759989,WES 237B,A00,494380,Staff,19,0,20,1
1713507762059,AESE 279B,A00,494370,Wade; Jon P,33,0,33,0
1713507763088,AIP 197,001,627712,Vespa; Emanuel Ignacio,9999,0,9999,0
1713507764113,ANAR 135S,A00,494369,Braswell; Geoffrey E.,0,0,0,0
1713507765140,CAT 124RS,A01,519847,Geibel; William,6,0,20,14
1713507766165,CAT 125RS,A01,515971,Geibel; William,6,0,20,14
1713507767190,CLRE 250,A00,511389,Morris; Sheldon,9996,0,9999,3
1713507768217,CLRE 251,A00,507176,Mehta; Ravindra L.,9996,0,9999,3
1713507768217,CLRE 251,B00,511410,Mehta; Ravindra L.,9998,0,9999,1
1713507769243,CLRE 252,A00,507189,Cuomo; Raphael Eduardo,9998,0,9999,1
1713507770268,CLRE 253,A00,507199,Vaida; Florin,9997,0,9999,2
1713507770268,CLRE 253,B00,507202,Vaida; Florin,9999,0,9999,0
1713507771293,CLRE 259,A00,507211,Patel; Hemal,9996,0,9999,3
1713507772319,CLRE 260,A00,507221,Cuomo; Raphael Eduardo,9999,0,9999,0
1713507773345,CLRE 297,001,507242,Cuomo; Raphael Eduardo,9999,0,9999,0
1713507774372,CSE 191,A00,516875,Minnes Kemp; Mor Mia,9999,0,9999,0
1713507775401,CSS 201S,A01,494383,Staff,35,0,35,0
1713507776426,CSS 202S,A01,494387,Staff,35,0,35,0
1713507777452,EAP 100,A00,516065,Staff,9792,0,9999,207
1713507778482,ECE 45,A01,507414,Staff,37,0,60,23
1713507779514,ECE 100,A01,507416,Baghdadchi; Saharnaz,0,0,20,20
1713507779514,ECE 100,A02,507418,Baghdadchi; Saharnaz,19,0,20,1
1713507780587,ECE 111,A01,507420,Staff,27,0,50,23
1713507781632,ECE 197,001,548057,Sievenpiper; Daniel F.,9998,0,9999,1
1713507782662,EDS 115,A00,507243,Choi; Bailey Miyeon,27,0,28,1
1713507783688,EDS 117,A01,494379,Staff,15,0,25,10
1713507784716,EDS 125,A00,507246,Hopkins; Megan Beth,27,0,30,3
1713507785742,EDS 128A,A01,507264,Fargason; Sharon Gayle,26,0,26,0
1713507786772,EDS 128B,A01,507293,Pappas; Elizabeth,30,0,30,0
1713507787798,EDS 139,A00,507294,Fargason; Sharon Gayle,30,0,30,0
1713507787798,EDS 139,B00,507313,Pappas; Elizabeth,30,0,30,0
1713507788825,EDS 201,A00,507315,Staff,18,0,30,12
1713507789851,EDS 203,A01,507317,Halter; Christopher P.,17,0,30,13
1713507790877,EDS 204R,A01,507319,Halter; Christopher P.,0,1,30,30
1713507790877,EDS 204R,B01,507331,Heinzman; Erica M.,22,0,30,8
1713507791905,EDS 206R,A00,507332,Staff,0,2,30,30
1713507791905,EDS 206R,B00,507343,Staff,23,0,30,7
1713507792930,EDS 250,A00,507344,Hemans; Patricia Ann Benitez,27,0,40,13
1713507793956,EDS 281,A00,507345,Daly; Alan J.,18,0,18,0
1713507794982,EDS 284,A00,507350,Daly; Alan J.,16,0,16,0
1713507796008,EDS 286,A00,507359,Fine; Sarah,18,0,18,0
1713507797034,EDS 289C,A01,507361,Daly; Alan J.,18,0,18,0
1713507798065,EDS 290,A00,507366,Hofstetter; Carolyn,15,0,15,0
1713507799092,LIGM 5A,A00,507421,Fischer-Grunski; Eva K,20,0,20,0
1713507800117,LIGM 5B,A00,507423,Fischer-Grunski; Eva K,20,0,20,0
1713507801194,LIGM 5C,A00,507425,Fischer-Grunski; Eva K,20,0,20,0
1713507802220,LIIT 5AS,A00,507427,Carnelos; Chiara,20,0,20,0
1713507803251,LIIT 5BS,A00,507430,Carnelos; Chiara,20,0,20,0
1713507804282,LIIT 5CS,A00,507432,Carnelos; Chiara,20,0,20,0
1713507805310,LISP 5A,A00,507541,Munoz Sanchez; Alicia,14,0,20,6
1713507806341,LISP 5B,A00,507671,Munoz Sanchez; Alicia,12,0,20,8
1713507807366,LISP 5C,A00,507696,Munoz Sanchez; Alicia,11,0,20,9
1713507808392,MAE 197,001,528363,Boechler; Nicholas Sebastia,9998,0,9999,1
1713507809420,MATH 197,001,523477,Kedlaya; Kiran S.,9999,0,9999,0
1713507809420,MATH 197,002,563811,Zhang; Danna,9998,0,9999,1
1713507810447,MCWP 40R,A00,518780,Staff,13,0,20,7
1713507810447,MCWP 40R,B00,518781,Staff,11,0,20,9
1713507810447,MCWP 40R,C00,518783,Staff,8,0,20,12
1713507811473,MCWP 50R,A00,518791,Staff,7,0,20,13
1713507811473,MCWP 50R,B00,518792,Staff,3,0,20,17
1713507811473,MCWP 50R,C00,518793,Staff,5,0,20,15
1713507811473,MCWP 50R,D00,518794,Staff,0,0,20,20
1713507811473,MCWP 50R,E00,518795,Staff,0,0,20,20
1713507811473,MCWP 50R,F00,518796,Staff,11,0,20,9
1713507811473,MCWP 50R,G00,518797,Staff,10,0,20,10
1713507812503,MMW 12R,A01,514034,Herbst; Matthew,1,0,16,15
1713507812503,MMW 12R,A02,514035,Herbst; Matthew,13,0,16,3
1713507813529,MMW 13R,A01,514037,Staff,0,8,16,16
1713507813529,MMW 13R,A02,514039,Staff,0,7,16,16
1713507815586,SIO 295LS,A00,523233,Staff,15,0,30,15
1713507816614,SIO 295S,A00,523232,Staff,15,0,30,15
1713507817641,SOCI 117,A01,494376,Staff,0,2,5,5
1713507818674,WES 237B,A00,494380,Staff,19,0,20,1
1713507820741,AESE 279B,A00,494370,Wade; Jon P,33,0,33,0
1713507821784,AIP 197,001,627712,Vespa; Emanuel Ignacio,9999,0,9999,0
1713507822810,ANAR 135S,A00,494369,Braswell; Geoffrey E.,0,0,0,0
1713507823837,CAT 124RS,A01,519847,Geibel; William,6,0,20,14
1713507824867,CAT 125RS,A01,515971,Geibel; William,6,0,20,14
1713507825893,CLRE 250,A00,511389,Morris; Sheldon,9996,0,9999,3
1713507826946,CLRE 251,A00,507176,Mehta; Ravindra L.,9996,0,9999,3
1713507826946,CLRE 251,B00,511410,Mehta; Ravindra L.,9998,0,9999,1
1713507827975,CLRE 252,A00,507189,Cuomo; Raphael Eduardo,9998,0,9999,1
1713507829000,CLRE 253,A00,507199,Vaida; Florin,9997,0,9999,2
1713507829000,CLRE 253,B00,507202,Vaida; Florin,9999,0,9999,0
1713507830032,CLRE 259,A00,507211,Patel; Hemal,9996,0,9999,3
1713507831058,CLRE 260,A00,507221,Cuomo; Raphael Eduardo,9999,0,9999,0
1713507832084,CLRE 297,001,507242,Cuomo; Raphael Eduardo,9999,0,9999,0
1713507833110,CSE 191,A00,516875,Minnes Kemp; Mor Mia,9999,0,9999,0
1713507834141,CSS 201S,A01,494383,Staff,35,0,35,0
1713507835173,CSS 202S,A01,494387,Staff,35,0,35,0
1713507836202,EAP 100,A00,516065,Staff,9792,0,9999,207
1713507837230,ECE 45,A01,507414,Staff,37,0,60,23
1713507838255,ECE 100,A01,507416,Baghdadchi; Saharnaz,0,0,20,20
1713507838255,ECE 100,A02,507418,Baghdadchi; Saharnaz,19,0,20,1
1713507839283,ECE 111,A01,507420,Staff,27,0,50,23
1713507840309,ECE 197,001,548057,Sievenpiper; Daniel F.,9998,0,9999,1
1713507841335,EDS 115,A00,507243,Choi; Bailey Miyeon,27,0,28,1
1713507842361,EDS 117,A01,494379,Staff,15,0,25,10
1713507843388,EDS 125,A00,507246,Hopkins; Megan Beth,27,0,30,3
1713507844414,EDS 128A,A01,507264,Fargason; Sharon Gayle,26,0,26,0
1713507845439,EDS 128B,A01,507293,Pappas; Elizabeth,30,0,30,0
1713507846467,EDS 139,A00,507294,Fargason; Sharon Gayle,30,0,30,0
1713507846467,EDS 139,B00,507313,Pappas; Elizabeth,30,0,30,0
1713507847492,EDS 201,A00,507315,Staff,18,0,30,12
1713507848522,EDS 203,A01,507317,Halter; Christopher P.,17,0,30,13
1713507849554,EDS 204R,A01,507319,Halter; Christopher P.,0,1,30,30
1713507849554,EDS 204R,B01,507331,Heinzman; Erica M.,22,0,30,8
1713507850585,EDS 206R,A00,507332,Staff,0,2,30,30
1713507850585,EDS 206R,B00,507343,Staff,23,0,30,7
1713507851613,EDS 250,A00,507344,Hemans; Patricia Ann Benitez,27,0,40,13
1713507852649,EDS 281,A00,507345,Daly; Alan J.,18,0,18,0
1713507853675,EDS 284,A00,507350,Daly; Alan J.,16,0,16,0
1713507854701,EDS 286,A00,507359,Fine; Sarah,18,0,18,0
1713507855730,EDS 289C,A01,507361,Daly; Alan J.,18,0,18,0
1713507856754,EDS 290,A00,507366,Hofstetter; Carolyn,15,0,15,0
1713507857848,LIGM 5A,A00,507421,Fischer-Grunski; Eva K,20,0,20,0
1713507858874,LIGM 5B,A00,507423,Fischer-Grunski; Eva K,20,0,20,0
1713507859900,LIGM 5C,A00,507425,Fischer-Grunski; Eva K,20,0,20,0
1713507860926,LIIT 5AS,A00,507427,Carnelos; Chiara,20,0,20,0
1713507861960,LIIT 5BS,A00,507430,Carnelos; Chiara,20,0,20,0
1713507862987,LIIT 5CS,A00,507432,Carnelos; Chiara,20,0,20,0
1713507864030,LISP 5A,A00,507541,Munoz Sanchez; Alicia,14,0,20,6
1713507865057,LISP 5B,A00,507671,Munoz Sanchez; Alicia,12,0,20,8
1713507866093,LISP 5C,A00,507696,Munoz Sanchez; Alicia,11,0,20,9
1713507867120,MAE 197,001,528363,Boechler; Nicholas Sebastia,9998,0,9999,1
1713507868146,MATH 197,001,523477,Kedlaya; Kiran S.,9999,0,9999,0
1713507868146,MATH 197,002,563811,Zhang; Danna,9998,0,9999,1
1713507869172,MCWP 40R,A00,518780,Staff,13,0,20,7
1713507869172,MCWP 40R,B00,518781,Staff,11,0,20,9
1713507869172,MCWP 40R,C00,518783,Staff,8,0,20,12
1713507870203,MCWP 50R,A00,518791,Staff,7,0,20,13
1713507870203,MCWP 50R,B00,518792,Staff,3,0,20,17
1713507870203,MCWP 50R,C00,518793,Staff,5,0,20,15
1713507870203,MCWP 50R,D00,518794,Staff,0,0,20,20
1713507870203,MCWP 50R,E00,518795,Staff,0,0,20,20
1713507870203,MCWP 50R,F00,518796,Staff,11,0,20,9
1713507870203,MCWP 50R,G00,518797,Staff,10,0,20,10
1713507871233,MMW 12R,A01,514034,Herbst; Matthew,1,0,16,15
1713507871233,MMW 12R,A02,514035,Herbst; Matthew,13,0,16,3
1713507872271,MMW 13R,A01,514037,Staff,0,8,16,16
1713507872271,MMW 13R,A02,514039,Staff,0,7,16,16
1713507874322,SIO 295LS,A00,523233,Staff,15,0,30,15
1713507875352,SIO 295S,A00,523232,Staff,15,0,30,15
1713507876382,SOCI 117,A01,494376,Staff,0,2,5,5
1713507877411,WES 237B,A00,494380,Staff,19,0,20,1
1713507879482,AESE 279B,A00,494370,Wade; Jon P,33,0,33,0
1713507880515,AIP 197,001,627712,Vespa; Emanuel Ignacio,9999,0,9999,0
1713507881541,ANAR 135S,A00,494369,Braswell; Geoffrey E.,0,0,0,0
1713507882566,CAT 124RS,A01,519847,Geibel; William,6,0,20,14
1713507883591,CAT 125RS,A01,515971,Geibel; William,6,0,20,14
1713507884621,CLRE 250,A00,511389,Morris; Sheldon,9996,0,9999,3
1713507885652,CLRE 251,A00,507176,Mehta; Ravindra L.,9996,0,9999,3
1713507885652,CLRE 251,B00,511410,Mehta; Ravindra L.,9998,0,9999,1
1713507886682,CLRE 252,A00,507189,Cuomo; Raphael Eduardo,9998,0,9999,1
1713507887713,CLRE 253,A00,507199,Vaida; Florin,9997,0,9999,2
1713507887713,CLRE 253,B00,507202,Vaida; Florin,9999,0,9999,0
1713507888744,CLRE 259,A00,507211,Patel; Hemal,9996,0,9999,3
1713507889776,CLRE 260,A00,507221,Cuomo; Raphael Eduardo,9999,0,9999,0
1713507890803,CLRE 297,001,507242,Cuomo; Raphael Eduardo,9999,0,9999,0
1713507891832,CSE 191,A00,516875,Minnes Kemp; Mor Mia,9999,0,9999,0
1713507892864,CSS 201S,A01,494383,Staff,35,0,35,0
1713507893889,CSS 202S,A01,494387,Staff,35,0,35,0
1713507894914,EAP 100,A00,516065,Staff,9792,0,9999,207
1713507895941,ECE 45,A01,507414,Staff,37,0,60,23
1713507896974,ECE 100,A01,507416,Baghdadchi; Saharnaz,0,0,20,20
1713507896974,ECE 100,A02,507418,Baghdadchi; Saharnaz,19,0,20,1
1713507897999,ECE 111,A01,507420,Staff,27,0,50,23
1713507899026,ECE 197,001,548057,Sievenpiper; Daniel F.,9998,0,9999,1
1713507900069,EDS 115,A00,507243,Choi; Bailey Miyeon,27,0,28,1
1713507901096,EDS 117,A01,494379,Staff,15,0,25,10
1713507902124,EDS 125,A00,507246,Hopkins; Megan Beth,27,0,30,3
1713507903277,EDS 128A,A01,507264,Fargason; Sharon Gayle,26,0,26,0
1713507904305,EDS 128B,A01,507293,Pappas; Elizabeth,30,0,30,0
1713507905330,EDS 139,A00,507294,Fargason; Sharon Gayle,30,0,30,0
1713507905330,EDS 139,B00,507313,Pappas; Elizabeth,30,0,30,0
1713507906361,EDS 201,A00,507315,Staff,18,0,30,12
1713507907386,EDS 203,A01,507317,Halter; Christopher P.,17,0,30,13
1713507908410,EDS 204R,A01,507319,Halter; Christopher P.,0,1,30,30
1713507908410,EDS 204R,B01,507331,Heinzman; Erica M.,22,0,30,8
1713507909436,EDS 206R,A00,507332,Staff,0,2,30,30
1713507909436,EDS 206R,B00,507343,Staff,23,0,30,7
1713507910463,EDS 250,A00,507344,Hemans; Patricia Ann Benitez,27,0,40,13
1713507911487,EDS 281,A00,507345,Daly; Alan J.,18,0,18,0
1713507912513,EDS 284,A00,507350,Daly; Alan J.,16,0,16,0
1713507913537,EDS 286,A00,507359,Fine; Sarah,18,0,18,0
1713507914590,EDS 289C,A01,507361,Daly; Alan J.,18,0,18,0
1713507915620,EDS 290,A00,507366,Hofstetter; Carolyn,15,0,15,0
1713507916649,LIGM 5A,A00,507421,Fischer-Grunski; Eva K,20,0,20,0
1713507917679,LIGM 5B,A00,507423,Fischer-Grunski; Eva K,20,0,20,0
1713507918717,LIGM 5C,A00,507425,Fischer-Grunski; Eva K,20,0,20,0
1713507919743,LIIT 5AS,A00,507427,Carnelos; Chiara,20,0,20,0
1713507920777,LIIT 5BS,A00,507430,Carnelos; Chiara,20,0,20,0
1713507921802,LIIT 5CS,A00,507432,Carnelos; Chiara,20,0,20,0
1713507922830,LISP 5A,A00,507541,Munoz Sanchez; Alicia,14,0,20,6
1713507923878,LISP 5B,A00,507671,Munoz Sanchez; Alicia,12,0,20,8
1713507924902,LISP 5C,A00,507696,Munoz Sanchez; Alicia,11,0,20,9
1713507925928,MAE 197,001,528363,Boechler; Nicholas Sebastia,9998,0,9999,1
1713507926956,MATH 197,001,523477,Kedlaya; Kiran S.,9999,0,9999,0
1713507926956,MATH 197,002,563811,Zhang; Danna,9998,0,9999,1
1713507927982,MCWP 40R,A00,518780,Staff,13,0,20,7
1713507927982,MCWP 40R,B00,518781,Staff,11,0,20,9
1713507927982,MCWP 40R,C00,518783,Staff,8,0,20,12
1713507929009,MCWP 50R,A00,518791,Staff,7,0,20,13
1713507929009,MCWP 50R,B00,518792,Staff,3,0,20,17
1713507929009,MCWP 50R,C00,518793,Staff,5,0,20,15
1713507929009,MCWP 50R,D00,518794,Staff,0,0,20,20
1713507929009,MCWP 50R,E00,518795,Staff,0,0,20,20
1713507929009,MCWP 50R,F00,518796,Staff,11,0,20,9
1713507929009,MCWP 50R,G00,518797,Staff,10,0,20,10
1713507930055,MMW 12R,A01,514034,Herbst; Matthew,1,0,16,15
1713507930055,MMW 12R,A02,514035,Herbst; Matthew,13,0,16,3
1713507931086,MMW 13R,A01,514037,Staff,0,8,16,16
1713507931086,MMW 13R,A02,514039,Staff,0,7,16,16
1713507933142,SIO 295LS,A00,523233,Staff,15,0,30,15
1713507934175,SIO 295S,A00,523232,Staff,15,0,30,15
1713507935203,SOCI 117,A01,494376,Staff,0,2,5,5
1713507936237,WES 237B,A00,494380,Staff,19,0,20,1
1713507938299,AESE 279B,A00,494370,Wade; Jon P,33,0,33,0
1713507939330,AIP 197,001,627712,Vespa; Emanuel Ignacio,9999,0,9999,0
1713507940355,ANAR 135S,A00,494369,Braswell; Geoffrey E.,0,0,0,0
1713507941386,CAT 124RS,A01,519847,Geibel; William,6,0,20,14
1713507942417,CAT 125RS,A01,515971,Geibel; William,6,0,20,14
1713507943441,CLRE 250,A00,511389,Morris; Sheldon,9996,0,9999,3
1713507944467,CLRE 251,A00,507176,Mehta; Ravindra L.,9996,0,9999,3
1713507944467,CLRE 251,B00,511410,Mehta; Ravindra L.,9998,0,9999,1
1713507945492,CLRE 252,A00,507189,Cuomo; Raphael Eduardo,9998,0,9999,1
1713507946517,CLRE 253,A00,507199,Vaida; Florin,9997,0,9999,2
1713507946517,CLRE 253,B00,507202,Vaida; Florin,9999,0,9999,0
1713507947544,CLRE 259,A00,507211,Patel; Hemal,9996,0,9999,3
1713507948572,CLRE 260,A00,507221,Cuomo; Raphael Eduardo,9999,0,9999,0
1713507949602,CLRE 297,001,507242,Cuomo; Raphael Eduardo,9999,0,9999,0
1713507950632,CSE 191,A00,516875,Minnes Kemp; Mor Mia,9999,0,9999,0
1713507951663,CSS 201S,A01,494383,Staff,35,0,35,0
1713507952693,CSS 202S,A01,494387,Staff,35,0,35,0
1713507953722,EAP 100,A00,516065,Staff,9792,0,9999,207
1713507954752,ECE 45,A01,507414,Staff,37,0,60,23
1713507955779,ECE 100,A01,507416,Baghdadchi; Saharnaz,0,0,20,20
1713507955779,ECE 100,A02,507418,Baghdadchi; Saharnaz,19,0,20,1
1713507956804,ECE 111,A01,507420,Staff,27,0,50,23
1713507957828,ECE 197,001,548057,Sievenpiper; Daniel F.,9998,0,9999,1
1713507958854,EDS 115,A00,507243,Choi; Bailey Miyeon,27,0,28,1
1713507959879,EDS 117,A01,494379,Staff,15,0,25,10
1713507960903,EDS 125,A00,507246,Hopkins; Megan Beth,27,0,30,3
1713507962006,EDS 128A,A01,507264,Fargason; Sharon Gayle,26,0,26,0
1713507963040,EDS 128B,A01,507293,Pappas; Elizabeth,30,0,30,0
1713507964072,EDS 139,A00,507294,Fargason; Sharon Gayle,30,0,30,0
1713507964072,EDS 139,B00,507313,Pappas; Elizabeth,30,0,30,0
1713507965098,EDS 201,A00,507315,Staff,18,0,30,12
1713507966125,EDS 203,A01,507317,Halter; Christopher P.,17,0,30,13
1713507967156,EDS 204R,A01,507319,Halter; Christopher P.,0,1,30,30
1713507967156,EDS 204R,B01,507331,Heinzman; Erica M.,22,0,30,8
1713507968199,EDS 206R,A00,507332,Staff,0,2,30,30
1713507968199,EDS 206R,B00,507343,Staff,23,0,30,7
1713507969225,EDS 250,A00,507344,Hemans; Patricia Ann Benitez,27,0,40,13
1713507970251,EDS 281,A00,507345,Daly; Alan J.,18,0,18,0
1713507971277,EDS 284,A00,507350,Daly; Alan J.,16,0,16,0
1713507972304,EDS 286,A00,507359,Fine; Sarah,18,0,18,0
1713507973334,EDS 289C,A01,507361,Daly; Alan J.,18,0,18,0
1713507974363,EDS 290,A00,507366,Hofstetter; Carolyn,15,0,15,0
1713507975388,LIGM 5A,A00,507421,Fischer-Grunski; Eva K,20,0,20,0
1713507976413,LIGM 5B,A00,507423,Fischer-Grunski; Eva K,20,0,20,0
1713507977439,LIGM 5C,A00,507425,Fischer-Grunski; Eva K,20,0,20,0
1713507978467,LIIT 5AS,A00,507427,Carnelos; Chiara,20,0,20,0
1713507979496,LIIT 5BS,A00,507430,Carnelos; Chiara,20,0,20,0
1713507980529,LIIT 5CS,A00,507432,Carnelos; Chiara,20,0,20,0
1713507981555,LISP 5A,A00,507541,Munoz Sanchez; Alicia,14,0,20,6
1713507982584,LISP 5B,A00,507671,Munoz Sanchez; Alicia,12,0,20,8
1713507983611,LISP 5C,A00,507696,Munoz Sanchez; Alicia,11,0,20,9
1713507984638,MAE 197,001,528363,Boechler; Nicholas Sebastia,9998,0,9999,1
1713507985665,MATH 197,001,523477,Kedlaya; Kiran S.,9999,0,9999,0
1713507985665,MATH 197,002,563811,Zhang; Danna,9998,0,9999,1
1713507986689,MCWP 40R,A00,518780,Staff,13,0,20,7
1713507986689,MCWP 40R,B00,518781,Staff,11,0,20,9
1713507986689,MCWP 40R,C00,518783,Staff,8,0,20,12
1713507987716,MCWP 50R,A00,518791,Staff,7,0,20,13
1713507987716,MCWP 50R,B00,518792,Staff,3,0,20,17
1713507987716,MCWP 50R,C00,518793,Staff,5,0,20,15
1713507987716,MCWP 50R,D00,518794,Staff,0,0,20,20
1713507987716,MCWP 50R,E00,518795,Staff,0,0,20,20
1713507987716,MCWP 50R,F00,518796,Staff,11,0,20,9
1713507987716,MCWP 50R,G00,518797,Staff,10,0,20,10
1713507988740,MMW 12R,A01,514034,Herbst; Matthew,1,0,16,15
1713507988740,MMW 12R,A02,514035,Herbst; Matthew,13,0,16,3
1713507989765,MMW 13R,A01,514037,Staff,0,8,16,16
1713507989765,MMW 13R,A02,514039,Staff,0,7,16,16
1713507991816,SIO 295LS,A00,523233,Staff,15,0,30,15
1713507992841,SIO 295S,A00,523232,Staff,15,0,30,15
1713507993867,SOCI 117,A01,494376,Staff,0,2,5,5
1713507994893,WES 237B,A00,494380,Staff,19,0,20,1
1713507996960,AESE 279B,A00,494370,Wade; Jon P,33,0,33,0
1713507997988,AIP 197,001,627712,Vespa; Emanuel Ignacio,9999,0,9999,0
1713507999018,ANAR 135S,A00,494369,Braswell; Geoffrey E.,0,0,0,0
1713508000048,CAT 124RS,A01,519847,Geibel; William,6,0,20,14
1713508001072,CAT 125RS,A01,515971,Geibel; William,6,0,20,14
1713508002100,CLRE 250,A00,511389,Morris; Sheldon,9996,0,9999,3
1713508003126,CLRE 251,A00,507176,Mehta; Ravindra L.,9996,0,9999,3
1713508003126,CLRE 251,B00,511410,Mehta; Ravindra L.,9998,0,9999,1
1713508004151,CLRE 252,A00,507189,Cuomo; Raphael Eduardo,9998,0,9999,1
1713508005177,CLRE 253,A00,507199,Vaida; Florin,9997,0,9999,2
1713508005177,CLRE 253,B00,507202,Vaida; Florin,9999,0,9999,0
1713508006206,CLRE 259,A00,507211,Patel; Hemal,9996,0,9999,3
1713508007233,CLRE 260,A00,507221,Cuomo; Raphael Eduardo,9999,0,9999,0
1713508008260,CLRE 297,001,507242,Cuomo; Raphael Eduardo,9999,0,9999,0
1713508009284,CSE 191,A00,516875,Minnes Kemp; Mor Mia,9999,0,9999,0
1713508010313,CSS 201S,A01,494383,Staff,35,0,35,0
1713508011340,CSS 202S,A01,494387,Staff,35,0,35,0
1713508012365,EAP 100,A00,516065,Staff,9792,0,9999,207
1713508013393,ECE 45,A01,507414,Staff,37,0,60,23
1713508014419,ECE 100,A01,507416,Baghdadchi; Saharnaz,0,0,20,20
1713508014419,ECE 100,A02,507418,Baghdadchi; Saharnaz,19,0,20,1
1713508015444,ECE 111,A01,507420,Staff,27,0,50,23
1713508016469,ECE 197,001,548057,Sievenpiper; Daniel F.,9998,0,9999,1
1713508017496,EDS 115,A00,507243,Choi; Bailey Miyeon,27,0,28,1
1713508018521,EDS 117,A01,494379,Staff,15,0,25,10
1713508019547,EDS 125,A00,507246,Hopkins; Megan Beth,27,0,30,3
1713508020573,EDS 128A,A01,507264,Fargason; Sharon Gayle,26,0,26,0
1713508021603,EDS 128B,A01,507293,Pappas; Elizabeth,30,0,30,0
1713508022628,EDS 139,A00,507294,Fargason; Sharon Gayle,30,0,30,0
1713508022628,EDS 139,B00,507313,Pappas; Elizabeth,30,0,30,0
1713508023653,EDS 201,A00,507315,Staff,18,0,30,12
1713508024682,EDS 203,A01,507317,Halter; Christopher P.,17,0,30,13
1713508025707,EDS 204R,A01,507319,Halter; Christopher P.,0,1,30,30
1713508025707,EDS 204R,B01,507331,Heinzman; Erica M.,22,0,30,8
1713508026733,EDS 206R,A00,507332,Staff,0,2,30,30
1713508026733,EDS 206R,B00,507343,Staff,23,0,30,7
1713508027763,EDS 250,A00,507344,Hemans; Patricia Ann Benitez,27,0,40,13
1713508028791,EDS 281,A00,507345,Daly; Alan J.,18,0,18,0
1713508029816,EDS 284,A00,507350,Daly; Alan J.,16,0,16,0
1713508030841,EDS 286,A00,507359,Fine; Sarah,18,0,18,0
1713508031869,EDS 289C,A01,507361,Daly; Alan J.,18,0,18,0
1713508032895,EDS 290,A00,507366,Hofstetter; Carolyn,15,0,15,0
1713508033926,LIGM 5A,A00,507421,Fischer-Grunski; Eva K,20,0,20,0
1713508034952,LIGM 5B,A00,507423,Fischer-Grunski; Eva K,20,0,20,0
1713508035983,LIGM 5C,A00,507425,Fischer-Grunski; Eva K,20,0,20,0
1713508037010,LIIT 5AS,A00,507427,Carnelos; Chiara,20,0,20,0
1713508038036,LIIT 5BS,A00,507430,Carnelos; Chiara,20,0,20,0
1713508039060,LIIT 5CS,A00,507432,Carnelos; Chiara,20,0,20,0
1713508040086,LISP 5A,A00,507541,Munoz Sanchez; Alicia,14,0,20,6
1713508041114,LISP 5B,A00,507671,Munoz Sanchez; Alicia,12,0,20,8
1713508042141,LISP 5C,A00,507696,Munoz Sanchez; Alicia,11,0,20,9
1713508043174,MAE 197,001,528363,Boechler; Nicholas Sebastia,9998,0,9999,1
1713508044198,MATH 197,001,523477,Kedlaya; Kiran S.,9999,0,9999,0
1713508044198,MATH 197,002,563811,Zhang; Danna,9998,0,9999,1
1713508045224,MCWP 40R,A00,518780,Staff,13,0,20,7
1713508045224,MCWP 40R,B00,518781,Staff,11,0,20,9
1713508045224,MCWP 40R,C00,518783,Staff,8,0,20,12
1713508046250,MCWP 50R,A00,518791,Staff,7,0,20,13
1713508046250,MCWP 50R,B00,518792,Staff,3,0,20,17
1713508046250,MCWP 50R,C00,518793,Staff,5,0,20,15
1713508046250,MCWP 50R,D00,518794,Staff,0,0,20,20
1713508046250,MCWP 50R,E00,518795,Staff,0,0,20,20
1713508046250,MCWP 50R,F00,518796,Staff,11,0,20,9
1713508046250,MCWP 50R,G00,518797,Staff,10,0,20,10
1713508047277,MMW 12R,A01,514034,Herbst; Matthew,1,0,16,15
1713508047277,MMW 12R,A02,514035,Herbst; Matthew,13,0,16,3
1713508048301,MMW 13R,A01,514037,Staff,0,8,16,16
1713508048301,MMW 13R,A02,514039,Staff,0,7,16,16
1713508050357,SIO 295LS,A00,523233,Staff,15,0,30,15
1713508051385,SIO 295S,A00,523232,Staff,15,0,30,15
1713508052414,SOCI 117,A01,494376,Staff,0,2,5,5
1713508053440,WES 237B,A00,494380,Staff,19,0,20,1
1713508055501,AESE 279B,A00,494370,Wade; Jon P,33,0,33,0
1713508056527,AIP 197,001,627712,Vespa; Emanuel Ignacio,9999,0,9999,0
1713508057550,ANAR 135S,A00,494369,Braswell; Geoffrey E.,0,0,0,0
1713508058588,CAT 124RS,A01,519847,Geibel; William,6,0,20,14
1713508059613,CAT 125RS,A01,515971,Geibel; William,6,0,20,14
1713508060637,CLRE 250,A00,511389,Morris; Sheldon,9996,0,9999,3
1713508061663,CLRE 251,A00,507176,Mehta; Ravindra L.,9996,0,9999,3
1713508061663,CLRE 251,B00,511410,Mehta; Ravindra L.,9998,0,9999,1
1713508062690,CLRE 252,A00,507189,Cuomo; Raphael Eduardo,9998,0,9999,1
1713508063720,CLRE 253,A00,507199,Vaida; Florin,9997,0,9999,2
1713508063720,CLRE 253,B00,507202,Vaida; Florin,9999,0,9999,0
1713508064746,CLRE 259,A00,507211,Patel; Hemal,9996,0,9999,3
1713508065833,CLRE 260,A00,507221,Cuomo; Raphael Eduardo,9999,0,9999,0
1713508066858,CLRE 297,001,507242,Cuomo; Raphael Eduardo,9999,0,9999,0
1713508067884,CSE 191,A00,516875,Minnes Kemp; Mor Mia,9999,0,9999,0
1713508068910,CSS 201S,A01,494383,Staff,35,0,35,0
1713508069935,CSS 202S,A01,494387,Staff,35,0,35,0
1713508070962,EAP 100,A00,516065,Staff,9792,0,9999,207
1713508071988,ECE 45,A01,507414,Staff,37,0,60,23
1713508073013,ECE 100,A01,507416,Baghdadchi; Saharnaz,0,0,20,20
1713508073013,ECE 100,A02,507418,Baghdadchi; Saharnaz,19,0,20,1
1713508074043,ECE 111,A01,507420,Staff,27,0,50,23
1713508075071,ECE 197,001,548057,Sievenpiper; Daniel F.,9998,0,9999,1
1713508076096,EDS 115,A00,507243,Choi; Bailey Miyeon,27,0,28,1
1713508077130,EDS 117,A01,494379,Staff,15,0,25,10
1713508078158,EDS 125,A00,507246,Hopkins; Megan Beth,27,0,30,3
1713508079187,EDS 128A,A01,507264,Fargason; Sharon Gayle,26,0,26,0
1713508080215,EDS 128B,A01,507293,Pappas; Elizabeth,30,0,30,0
1713508081245,EDS 139,A00,507294,Fargason; Sharon Gayle,30,0,30,0
1713508081245,EDS 139,B00,507313,Pappas; Elizabeth,30,0,30,0
1713508082271,EDS 201,A00,507315,Staff,18,0,30,12
1713508083296,EDS 203,A01,507317,Halter; Christopher P.,17,0,30,13
1713508084321,EDS 204R,A01,507319,Halter; Christopher P.,0,1,30,30
1713508084321,EDS 204R,B01,507331,Heinzman; Erica M.,22,0,30,8
1713508085347,EDS 206R,A00,507332,Staff,0,2,30,30
1713508085347,EDS 206R,B00,507343,Staff,23,0,30,7
1713508086373,EDS 250,A00,507344,Hemans; Patricia Ann Benitez,27,0,40,13
1713508087402,EDS 281,A00,507345,Daly; Alan J.,18,0,18,0
1713508088433,EDS 284,A00,507350,Daly; Alan J.,16,0,16,0
1713508089457,EDS 286,A00,507359,Fine; Sarah,18,0,18,0
1713508090485,EDS 289C,A01,507361,Daly; Alan J.,18,0,18,0
1713508091513,EDS 290,A00,507366,Hofstetter; Carolyn,15,0,15,0
1713508092539,LIGM 5A,A00,507421,Fischer-Grunski; Eva K,20,0,20,0
1713508093565,LIGM 5B,A00,507423,Fischer-Grunski; Eva K,20,0,20,0
1713508094591,LIGM 5C,A00,507425,Fischer-Grunski; Eva K,20,0,20,0
1713508095622,LIIT 5AS,A00,507427,Carnelos; Chiara,20,0,20,0
1713508096648,LIIT 5BS,A00,507430,Carnelos; Chiara,20,0,20,0
1713508097674,LIIT 5CS,A00,507432,Carnelos; Chiara,20,0,20,0
1713508098701,LISP 5A,A00,507541,Munoz Sanchez; Alicia,14,0,20,6
1713508099732,LISP 5B,A00,507671,Munoz Sanchez; Alicia,12,0,20,8
1713508100757,LISP 5C,A00,507696,Munoz Sanchez; Alicia,11,0,20,9
1713508101783,MAE 197,001,528363,Boechler; Nicholas Sebastia,9998,0,9999,1
1713508102809,MATH 197,001,523477,Kedlaya; Kiran S.,9999,0,9999,0
1713508102809,MATH 197,002,563811,Zhang; Danna,9998,0,9999,1
1713508103856,MCWP 40R,A00,518780,Staff,13,0,20,7
1713508103856,MCWP 40R,B00,518781,Staff,11,0,20,9
1713508103856,MCWP 40R,C00,518783,Staff,8,0,20,12
1713508104886,MCWP 50R,A00,518791,Staff,7,0,20,13
1713508104886,MCWP 50R,B00,518792,Staff,3,0,20,17
1713508104886,MCWP 50R,C00,518793,Staff,5,0,20,15
1713508104886,MCWP 50R,D00,518794,Staff,0,0,20,20
1713508104886,MCWP 50R,E00,518795,Staff,0,0,20,20
1713508104886,MCWP 50R,F00,518796,Staff,11,0,20,9
1713508104886,MCWP 50R,G00,518797,Staff,10,0,20,10
1713508105913,MMW 12R,A01,514034,Herbst; Matthew,1,0,16,15
1713508105913,MMW 12R,A02,514035,Herbst; Matthew,13,0,16,3
1713508106939,MMW 13R,A01,514037,Staff,0,8,16,16
1713508106939,MMW 13R,A02,514039,Staff,0,7,16,16
1713508108996,SIO 295LS,A00,523233,Staff,15,0,30,15
1713508110022,SIO 295S,A00,523232,Staff,15,0,30,15
1713508111050,SOCI 117,A01,494376,Staff,0,2,5,5
1713508112079,WES 237B,A00,494380,Staff,19,0,20,1
1713508114146,AESE 279B,A00,494370,Wade; Jon P,33,0,33,0
1713508115175,AIP 197,001,627712,Vespa; Emanuel Ignacio,9999,0,9999,0
1713508116203,ANAR 135S,A00,494369,Braswell; Geoffrey E.,0,0,0,0
1713508117230,CAT 124RS,A01,519847,Geibel; William,6,0,20,14
1713508118256,CAT 125RS,A01,515971,Geibel; William,6,0,20,14
1713508119281,CLRE 250,A00,511389,Morris; Sheldon,9996,0,9999,3
1713508120305,CLRE 251,A00,507176,Mehta; Ravindra L.,9996,0,9999,3
1713508120305,CLRE 251,B00,511410,Mehta; Ravindra L.,9998,0,9999,1
1713508121331,CLRE 252,A00,507189,Cuomo; Raphael Eduardo,9998,0,9999,1
1713508122362,CLRE 253,A00,507199,Vaida; Florin,9997,0,9999,2
1713508122362,CLRE 253,B00,507202,Vaida; Florin,9999,0,9999,0
1713508123387,CLRE 259,A00,507211,Patel; Hemal,9996,0,9999,3
1713508124412,CLRE 260,A00,507221,Cuomo; Raphael Eduardo,9999,0,9999,0
1713508125439,CLRE 297,001,507242,Cuomo; Raphael Eduardo,9999,0,9999,0
1713508126467,CSE 191,A00,516875,Minnes Kemp; Mor Mia,9999,0,9999,0
1713508127498,CSS 201S,A01,494383,Staff,35,0,35,0
1713508128523,CSS 202S,A01,494387,Staff,35,0,35,0
1713508129548,EAP 100,A00,516065,Staff,9792,0,9999,207
1713508130575,ECE 45,A01,507414,Staff,37,0,60,23
1713508131601,ECE 100,A01,507416,Baghdadchi; Saharnaz,0,0,20,20
1713508131601,ECE 100,A02,507418,Baghdadchi; Saharnaz,19,0,20,1
1713508132628,ECE 111,A01,507420,Staff,27,0,50,23
1713508133658,ECE 197,001,548057,Sievenpiper; Daniel F.,9998,0,9999,1
1713508134685,EDS 115,A00,507243,Choi; Bailey Miyeon,27,0,28,1
1713508135711,EDS 117,A01,494379,Staff,15,0,25,10
1713508136736,EDS 125,A00,507246,Hopkins; Megan Beth,27,0,30,3
1713508137765,EDS 128A,A01,507264,Fargason; Sharon Gayle,26,0,26,0
1713508138793,EDS 128B,A01,507293,Pappas; Elizabeth,30,0,30,0
1713508139820,EDS 139,A00,507294,Fargason; Sharon Gayle,30,0,30,0
1713508139820,EDS 139,B00,507313,Pappas; Elizabeth,30,0,30,0
1713508140846,EDS 201,A00,507315,Staff,18,0,30,12
1713508141871,EDS 203,A01,507317,Halter; Christopher P.,17,0,30,13
1713508142897,EDS 204R,A01,507319,Halter; Christopher P.,0,1,30,30
1713508142897,EDS 204R,B01,507331,Heinzman; Erica M.,22,0,30,8
1713508143923,EDS 206R,A00,507332,Staff,0,2,30,30
1713508143923,EDS 206R,B00,507343,Staff,23,0,30,7
1713508144948,EDS 250,A00,507344,Hemans; Patricia Ann Benitez,27,0,40,13
1713508145974,EDS 281,A00,507345,Daly; Alan J.,18,0,18,0
1713508147003,EDS 284,A00,507350,Daly; Alan J.,16,0,16,0
1713508148029,EDS 286,A00,507359,Fine; Sarah,18,0,18,0
1713508149058,EDS 289C,A01,507361,Daly; Alan J.,18,0,18,0
1713508150083,EDS 290,A00,507366,Hofstetter; Carolyn,15,0,15,0
1713508151107,LIGM 5A,A00,507421,Fischer-Grunski; Eva K,20,0,20,0
1713508152133,LIGM 5B,A00,507423,Fischer-Grunski; Eva K,20,0,20,0
1713508153163,LIGM 5C,A00,507425,Fischer-Grunski; Eva K,20,0,20,0
1713508154189,LIIT 5AS,A00,507427,Carnelos; Chiara,20,0,20,0
1713508155214,LIIT 5BS,A00,507430,Carnelos; Chiara,20,0,20,0
1713508156239,LIIT 5CS,A00,507432,Carnelos; Chiara,20,0,20,0
1713508157264,LISP 5A,A00,507541,Munoz Sanchez; Alicia,14,0,20,6
1713508158295,LISP 5B,A00,507671,Munoz Sanchez; Alicia,12,0,20,8
1713508159323,LISP 5C,A00,507696,Munoz Sanchez; Alicia,11,0,20,9
1713508160349,MAE 197,001,528363,Boechler; Nicholas Sebastia,9998,0,9999,1
1713508161377,MATH 197,001,523477,Kedlaya; Kiran S.,9999,0,9999,0
1713508161377,MATH 197,002,563811,Zhang; Danna,9998,0,9999,1
1713508162402,MCWP 40R,A00,518780,Staff,13,0,20,7
1713508162402,MCWP 40R,B00,518781,Staff,11,0,20,9
1713508162402,MCWP 40R,C00,518783,Staff,8,0,20,12
1713508163427,MCWP 50R,A00,518791,Staff,7,0,20,13
1713508163427,MCWP 50R,B00,518792,Staff,3,0,20,17
1713508163427,MCWP 50R,C00,518793,Staff,5,0,20,15
1713508163427,MCWP 50R,D00,518794,Staff,0,0,20,20
1713508163427,MCWP 50R,E00,518795,Staff,0,0,20,20
1713508163427,MCWP 50R,F00,518796,Staff,11,0,20,9
1713508163427,MCWP 50R,G00,518797,Staff,10,0,20,10
1713508164459,MMW 12R,A01,514034,Herbst; Matthew,1,0,16,15
1713508164459,MMW 12R,A02,514035,Herbst; Matthew,13,0,16,3
1713508165485,MMW 13R,A01,514037,Staff,0,8,16,16
1713508165485,MMW 13R,A02,514039,Staff,0,7,16,16
1713508167538,SIO 295LS,A00,523233,Staff,15,0,30,15
1713508168565,SIO 295S,A00,523232,Staff,15,0,30,15
1713508169647,SOCI 117,A01,494376,Staff,0,2,5,5
1713508170674,WES 237B,A00,494380,Staff,19,0,20,1
1713508172746,AESE 279B,A00,494370,Wade; Jon P,33,0,33,0
1713508173777,AIP 197,001,627712,Vespa; Emanuel Ignacio,9999,0,9999,0
1713508174802,ANAR 135S,A00,494369,Braswell; Geoffrey E.,0,0,0,0
1713508175828,CAT 124RS,A01,519847,Geibel; William,6,0,20,14
1713508176857,CAT 125RS,A01,515971,Geibel; William,6,0,20,14
1713508177886,CLRE 250,A00,511389,Morris; Sheldon,9996,0,9999,3
1713508178911,CLRE 251,A00,507176,Mehta; Ravindra L.,9996,0,9999,3
1713508178911,CLRE 251,B00,511410,Mehta; Ravindra L.,9998,0,9999,1
1713508179938,CLRE 252,A00,507189,Cuomo; Raphael Eduardo,9998,0,9999,1
1713508180968,CLRE 253,A00,507199,Vaida; Florin,9997,0,9999,2
1713508180968,CLRE 253,B00,507202,Vaida; Florin,9999,0,9999,0
1713508181997,CLRE 259,A00,507211,Patel; Hemal,9996,0,9999,3
1713508183023,CLRE 260,A00,507221,Cuomo; Raphael Eduardo,9999,0,9999,0
1713508184049,CLRE 297,001,507242,Cuomo; Raphael Eduardo,9999,0,9999,0
1713508185078,CSE 191,A00,516875,Minnes Kemp; Mor Mia,9999,0,9999,0
1713508186104,CSS 201S,A01,494383,Staff,35,0,35,0
1713508187132,CSS 202S,A01,494387,Staff,35,0,35,0
1713508188160,EAP 100,A00,516065,Staff,9792,0,9999,207
1713508189186,ECE 45,A01,507414,Staff,37,0,60,23
1713508190212,ECE 100,A01,507416,Baghdadchi; Saharnaz,0,0,20,20
1713508190212,ECE 100,A02,507418,Baghdadchi; Saharnaz,19,0,20,1
1713508191242,ECE 111,A01,507420,Staff,27,0,50,23
1713508192266,ECE 197,001,548057,Sievenpiper; Daniel F.,9998,0,9999,1
1713508193296,EDS 115,A00,507243,Choi; Bailey Miyeon,27,0,28,1
1713508194323,EDS 117,A01,494379,Staff,15,0,25,10
1713508195349,EDS 125,A00,507246,Hopkins; Megan Beth,27,0,30,3
1713508196376,EDS 128A,A01,507264,Fargason; Sharon Gayle,26,0,26,0
1713508197402,EDS 128B,A01,507293,Pappas; Elizabeth,30,0,30,0
1713508198430,EDS 139,A00,507294,Fargason; Sharon Gayle,30,0,30,0
1713508198430,EDS 139,B00,507313,Pappas; Elizabeth,30,0,30,0
1713508199456,EDS 201,A00,507315,Staff,18,0,30,12
1713508200483,EDS 203,A01,507317,Halter; Christopher P.,17,0,30,13
1713508201512,EDS 204R,A01,507319,Halter; Christopher P.,0,1,30,30
1713508201512,EDS 204R,B01,507331,Heinzman; Erica M.,22,0,30,8
1713508202544,EDS 206R,A00,507332,Staff,0,2,30,30
1713508202544,EDS 206R,B00,507343,Staff,23,0,30,7
1713508203570,EDS 250,A00,507344,Hemans; Patricia Ann Benitez,27,0,40,13
1713508204598,EDS 281,A00,507345,Daly; Alan J.,18,0,18,0
1713508205624,EDS 284,A00,507350,Daly; Alan J.,16,0,16,0
1713508206649,EDS 286,A00,507359,Fine; Sarah,18,0,18,0
1713508207673,EDS 289C,A01,507361,Daly; Alan J.,18,0,18,0
1713508208699,EDS 290,A00,507366,Hofstetter; Carolyn,15,0,15,0
1713508209726,LIGM 5A,A00,507421,Fischer-Grunski; Eva K,20,0,20,0
1713508210760,LIGM 5B,A00,507423,Fischer-Grunski; Eva K,20,0,20,0
1713508211793,LIGM 5C,A00,507425,Fischer-Grunski; Eva K,20,0,20,0
1713508212820,LIIT 5AS,A00,507427,Carnelos; Chiara,20,0,20,0
1713508213845,LIIT 5BS,A00,507430,Carnelos; Chiara,20,0,20,0
1713508214872,LIIT 5CS,A00,507432,Carnelos; Chiara,20,0,20,0
1713508215898,LISP 5A,A00,507541,Munoz Sanchez; Alicia,14,0,20,6
1713508216924,LISP 5B,A00,507671,Munoz Sanchez; Alicia,12,0,20,8
1713508217956,LISP 5C,A00,507696,Munoz Sanchez; Alicia,11,0,20,9
1713508218981,MAE 197,001,528363,Boechler; Nicholas Sebastia,9998,0,9999,1
1713508220010,MATH 197,001,523477,Kedlaya; Kiran S.,9999,0,9999,0
1713508220010,MATH 197,002,563811,Zhang; Danna,9998,0,9999,1
1713508221040,MCWP 40R,A00,518780,Staff,13,0,20,7
1713508221040,MCWP 40R,B00,518781,Staff,11,0,20,9
1713508221040,MCWP 40R,C00,518783,Staff,8,0,20,12
1713508222067,MCWP 50R,A00,518791,Staff,7,0,20,13
1713508222067,MCWP 50R,B00,518792,Staff,3,0,20,17
1713508222067,MCWP 50R,C00,518793,Staff,5,0,20,15
1713508222067,MCWP 50R,D00,518794,Staff,0,0,20,20
1713508222067,MCWP 50R,E00,518795,Staff,0,0,20,20
1713508222067,MCWP 50R,F00,518796,Staff,11,0,20,9
1713508222067,MCWP 50R,G00,518797,Staff,10,0,20,10
1713508223096,MMW 12R,A01,514034,Herbst; Matthew,1,0,16,15
1713508223096,MMW 12R,A02,514035,Herbst; Matthew,13,0,16,3
1713508224124,MMW 13R,A01,514037,Staff,0,8,16,16
1713508224124,MMW 13R,A02,514039,Staff,0,7,16,16
1713508226179,SIO 295LS,A00,523233,Staff,15,0,30,15
1713508227204,SIO 295S,A00,523232,Staff,15,0,30,15
1713508228230,SOCI 117,A01,494376,Staff,0,2,5,5
1713508229256,WES 237B,A00,494380,Staff,19,0,20,1
1713508231337,AESE 279B,A00,494370,Wade; Jon P,33,0,33,0
1713508232363,AIP 197,001,627712,Vespa; Emanuel Ignacio,9999,0,9999,0
1713508233388,ANAR 135S,A00,494369,Braswell; Geoffrey E.,0,0,0,0
1713508234419,CAT 124RS,A01,519847,Geibel; William,6,0,20,14
1713508235444,CAT 125RS,A01,515971,Geibel; William,6,0,20,14
1713508236469,CLRE 250,A00,511389,Morris; Sheldon,9996,0,9999,3
1713508237493,CLRE 251,A00,507176,Mehta; Ravindra L.,9996,0,9999,3
1713508237493,CLRE 251,B00,511410,Mehta; Ravindra L.,9998,0,9999,1
1713508238523,CLRE 252,A00,507189,Cuomo; Raphael Eduardo,9998,0,9999,1
1713508239549,CLRE 253,A00,507199,Vaida; Florin,9997,0,9999,2
1713508239549,CLRE 253,B00,507202,Vaida; Florin,9999,0,9999,0
1713508240579,CLRE 259,A00,507211,Patel; Hemal,9996,0,9999,3
1713508241605,CLRE 260,A00,507221,Cuomo; Raphael Eduardo,9999,0,9999,0
1713508242634,CLRE 297,001,507242,Cuomo; Raphael Eduardo,9999,0,9999,0
1713508243661,CSE 191,A00,516875,Minnes Kemp; Mor Mia,9999,0,9999,0
1713508244689,CSS 201S,A01,494383,Staff,35,0,35,0
1713508245714,CSS 202S,A01,494387,Staff,35,0,35,0
1713508246740,EAP 100,A00,516065,Staff,9792,0,9999,207
1713508247766,ECE 45,A01,507414,Staff,37,0,60,23
1713508248792,ECE 100,A01,507416,Baghdadchi; Saharnaz,0,0,20,20
1713508248792,ECE 100,A02,507418,Baghdadchi; Saharnaz,19,0,20,1
1713508249817,ECE 111,A01,507420,Staff,27,0,50,23
1713508250845,ECE 197,001,548057,Sievenpiper; Daniel F.,9998,0,9999,1
1713508251871,EDS 115,A00,507243,Choi; Bailey Miyeon,27,0,28,1
1713508252899,EDS 117,A01,494379,Staff,15,0,25,10
1713508253922,EDS 125,A00,507246,Hopkins; Megan Beth,27,0,30,3
1713508254948,EDS 128A,A01,507264,Fargason; Sharon Gayle,26,0,26,0
1713508255975,EDS 128B,A01,507293,Pappas; Elizabeth,30,0,30,0
1713508257004,EDS 139,A00,507294,Fargason; Sharon Gayle,30,0,30,0
1713508257004,EDS 139,B00,507313,Pappas; Elizabeth,30,0,30,0
1713508258034,EDS 201,A00,507315,Staff,18,0,30,12
1713508259065,EDS 203,A01,507317,Halter; Christopher P.,17,0,30,13
1713508260238,EDS 204R,A01,507319,Halter; Christopher P.,0,1,30,30
1713508260238,EDS 204R,B01,507331,Heinzman; Erica M.,22,0,30,8
1713508261262,EDS 206R,A00,507332,Staff,0,2,30,30
1713508261262,EDS 206R,B00,507343,Staff,23,0,30,7
1713508262289,EDS 250,A00,507344,Hemans; Patricia Ann Benitez,27,0,40,13
1713508263317,EDS 281,A00,507345,Daly; Alan J.,18,0,18,0
1713508264342,EDS 284,A00,507350,Daly; Alan J.,16,0,16,0
1713508265366,EDS 286,A00,507359,Fine; Sarah,18,0,18,0
1713508266397,EDS 289C,A01,507361,Daly; Alan J.,18,0,18,0
1713508267426,EDS 290,A00,507366,Hofstetter; Carolyn,15,0,15,0
1713508268451,LIGM 5A,A00,507421,Fischer-Grunski; Eva K,20,0,20,0
1713508269480,LIGM 5B,A00,507423,Fischer-Grunski; Eva K,20,0,20,0
1713508270504,LIGM 5C,A00,507425,Fischer-Grunski; Eva K,20,0,20,0
1713508271530,LIIT 5AS,A00,507427,Carnelos; Chiara,20,0,20,0
1713508272559,LIIT 5BS,A00,507430,Carnelos; Chiara,20,0,20,0
1713508273641,LIIT 5CS,A00,507432,Carnelos; Chiara,20,0,20,0
1713508274669,LISP 5A,A00,507541,Munoz Sanchez; Alicia,14,0,20,6
1713508275695,LISP 5B,A00,507671,Munoz Sanchez; Alicia,12,0,20,8
1713508276736,LISP 5C,A00,507696,Munoz Sanchez; Alicia,11,0,20,9
1713508277761,MAE 197,001,528363,Boechler; Nicholas Sebastia,9998,0,9999,1
1713508278786,MATH 197,001,523477,Kedlaya; Kiran S.,9999,0,9999,0
1713508278786,MATH 197,002,563811,Zhang; Danna,9998,0,9999,1
1713508279818,MCWP 40R,A00,518780,Staff,13,0,20,7
1713508279818,MCWP 40R,B00,518781,Staff,11,0,20,9
1713508279818,MCWP 40R,C00,518783,Staff,8,0,20,12
1713508280845,MCWP 50R,A00,518791,Staff,7,0,20,13
1713508280845,MCWP 50R,B00,518792,Staff,3,0,20,17
1713508280845,MCWP 50R,C00,518793,Staff,5,0,20,15
1713508280845,MCWP 50R,D00,518794,Staff,0,0,20,20
1713508280845,MCWP 50R,E00,518795,Staff,0,0,20,20
1713508280845,MCWP 50R,F00,518796,Staff,11,0,20,9
1713508280845,MCWP 50R,G00,518797,Staff,10,0,20,10
1713508281877,MMW 12R,A01,514034,Herbst; Matthew,1,0,16,15
1713508281877,MMW 12R,A02,514035,Herbst; Matthew,13,0,16,3
1713508282906,MMW 13R,A01,514037,Staff,0,8,16,16
1713508282906,MMW 13R,A02,514039,Staff,0,7,16,16
1713508284957,SIO 295LS,A00,523233,Staff,15,0,30,15
1713508285980,SIO 295S,A00,523232,Staff,15,0,30,15
1713508287006,SOCI 117,A01,494376,Staff,0,2,5,5
1713508288031,WES 237B,A00,494380,Staff,19,0,20,1
1713508290105,AESE 279B,A00,494370,Wade; Jon P,33,0,33,0
1713508291129,AIP 197,001,627712,Vespa; Emanuel Ignacio,9999,0,9999,0
1713508292154,ANAR 135S,A00,494369,Braswell; Geoffrey E.,0,0,0,0
1713508293179,CAT 124RS,A01,519847,Geibel; William,6,0,20,14
1713508294216,CAT 125RS,A01,515971,Geibel; William,6,0,20,14
1713508295246,CLRE 250,A00,511389,Morris; Sheldon,9996,0,9999,3
1713508296273,CLRE 251,A00,507176,Mehta; Ravindra L.,9996,0,9999,3
1713508296273,CLRE 251,B00,511410,Mehta; Ravindra L.,9998,0,9999,1
1713508297300,CLRE 252,A00,507189,Cuomo; Raphael Eduardo,9998,0,9999,1
1713508298325,CLRE 253,A00,507199,Vaida; Florin,9997,0,9999,2
1713508298325,CLRE 253,B00,507202,Vaida; Florin,9999,0,9999,0
1713508299349,CLRE 259,A00,507211,Patel; Hemal,9996,0,9999,3
1713508300386,CLRE 260,A00,507221,Cuomo; Raphael Eduardo,9999,0,9999,0
1713508301413,CLRE 297,001,507242,Cuomo; Raphael Eduardo,9999,0,9999,0
1713508302442,CSE 191,A00,516875,Minnes Kemp; Mor Mia,9999,0,9999,0
1713508303468,CSS 201S,A01,494383,Staff,35,0,35,0
1713508304493,CSS 202S,A01,494387,Staff,35,0,35,0
1713508305518,EAP 100,A00,516065,Staff,9792,0,9999,207
1713508306545,ECE 45,A01,507414,Staff,37,0,60,23
1713508307571,ECE 100,A01,507416,Baghdadchi; Saharnaz,0,0,20,20
1713508307571,ECE 100,A02,507418,Baghdadchi; Saharnaz,19,0,20,1
1713508308599,ECE 111,A01,507420,Staff,27,0,50,23
1713508309626,ECE 197,001,548057,Sievenpiper; Daniel F.,9998,0,9999,1
1713508310656,EDS 115,A00,507243,Choi; Bailey Miyeon,27,0,28,1
1713508311685,EDS 117,A01,494379,Staff,15,0,25,10
1713508312712,EDS 125,A00,507246,Hopkins; Megan Beth,27,0,30,3
1713508313737,EDS 128A,A01,507264,Fargason; Sharon Gayle,26,0,26,0
1713508314767,EDS 128B,A01,507293,Pappas; Elizabeth,30,0,30,0
1713508315792,EDS 139,A00,507294,Fargason; Sharon Gayle,30,0,30,0
1713508315792,EDS 139,B00,507313,Pappas; Elizabeth,30,0,30,0
1713508316817,EDS 201,A00,507315,Staff,18,0,30,12
1713508317847,EDS 203,A01,507317,Halter; Christopher P.,17,0,30,13
1713508318873,EDS 204R,A01,507319,Halter; Christopher P.,0,1,30,30
1713508318873,EDS 204R,B01,507331,Heinzman; Erica M.,22,0,30,8
1713508319899,EDS 206R,A00,507332,Staff,0,2,30,30
1713508319899,EDS 206R,B00,507343,Staff,23,0,30,7
1713508320925,EDS 250,A00,507344,Hemans; Patricia Ann Benitez,27,0,40,13
1713508321953,EDS 281,A00,507345,Daly; Alan J.,18,0,18,0
1713508322983,EDS 284,A00,507350,Daly; Alan J.,16,0,16,0
1713508324009,EDS 286,A00,507359,Fine; Sarah,18,0,18,0
1713508325038,EDS 289C,A01,507361,Daly; Alan J.,18,0,18,0
1713508326063,EDS 290,A00,507366,Hofstetter; Carolyn,15,0,15,0
1713508327089,LIGM 5A,A00,507421,Fischer-Grunski; Eva K,20,0,20,0
1713508328115,LIGM 5B,A00,507423,Fischer-Grunski; Eva K,20,0,20,0
1713508329145,LIGM 5C,A00,507425,Fischer-Grunski; Eva K,20,0,20,0
1713508330170,LIIT 5AS,A00,507427,Carnelos; Chiara,20,0,20,0
1713508331200,LIIT 5BS,A00,507430,Carnelos; Chiara,20,0,20,0
1713508332230,LIIT 5CS,A00,507432,Carnelos; Chiara,20,0,20,0
1713508333255,LISP 5A,A00,507541,Munoz Sanchez; Alicia,14,0,20,6
1713508334279,LISP 5B,A00,507671,Munoz Sanchez; Alicia,12,0,20,8
1713508335305,LISP 5C,A00,507696,Munoz Sanchez; Alicia,11,0,20,9
1713508336332,MAE 197,001,528363,Boechler; Nicholas Sebastia,9998,0,9999,1
1713508337385,MATH 197,001,523477,Kedlaya; Kiran S.,9999,0,9999,0
1713508337385,MATH 197,002,563811,Zhang; Danna,9998,0,9999,1
1713508338410,MCWP 40R,A00,518780,Staff,13,0,20,7
1713508338410,MCWP 40R,B00,518781,Staff,11,0,20,9
1713508338410,MCWP 40R,C00,518783,Staff,8,0,20,12
1713508339434,MCWP 50R,A00,518791,Staff,7,0,20,13
1713508339434,MCWP 50R,B00,518792,Staff,3,0,20,17
1713508339434,MCWP 50R,C00,518793,Staff,5,0,20,15
1713508339434,MCWP 50R,D00,518794,Staff,0,0,20,20
1713508339434,MCWP 50R,E00,518795,Staff,0,0,20,20
1713508339434,MCWP 50R,F00,518796,Staff,11,0,20,9
1713508339434,MCWP 50R,G00,518797,Staff,10,0,20,10
1713508340463,MMW 12R,A01,514034,Herbst; Matthew,1,0,16,15
1713508340463,MMW 12R,A02,514035,Herbst; Matthew,13,0,16,3
1713508341490,MMW 13R,A01,514037,Staff,0,8,16,16
1713508341490,MMW 13R,A02,514039,Staff,0,7,16,16
1713508343540,SIO 295LS,A00,523233,Staff,15,0,30,15
1713508344568,SIO 295S,A00,523232,Staff,15,0,30,15
1713508345594,SOCI 117,A01,494376,Staff,0,2,5,5
1713508346620,WES 237B,A00,494380,Staff,19,0,20,1
1713508348678,AESE 279B,A00,494370,Wade; Jon P,33,0,33,0
1713508349703,AIP 197,001,627712,Vespa; Emanuel Ignacio,9999,0,9999,0
1713508350732,ANAR 135S,A00,494369,Braswell; Geoffrey E.,0,0,0,0
1713508351757,CAT 124RS,A01,519847,Geibel; William,6,0,20,14
1713508352782,CAT 125RS,A01,515971,Geibel; William,6,0,20,14
1713508353808,CLRE 250,A00,511389,Morris; Sheldon,9996,0,9999,3
1713508354838,CLRE 251,A00,507176,Mehta; Ravindra L.,9996,0,9999,3
1713508354838,CLRE 251,B00,511410,Mehta; Ravindra L.,9998,0,9999,1
1713508355863,CLRE 252,A00,507189,Cuomo; Raphael Eduardo,9998,0,9999,1
1713508356889,CLRE 253,A00,507199,Vaida; Florin,9997,0,9999,2
1713508356889,CLRE 253,B00,507202,Vaida; Florin,9999,0,9999,0
1713508357915,CLRE 259,A00,507211,Patel; Hemal,9996,0,9999,3
1713508358940,CLRE 260,A00,507221,Cuomo; Raphael Eduardo,9999,0,9999,0
1713508359968,CLRE 297,001,507242,Cuomo; Raphael Eduardo,9999,0,9999,0
1713508360997,CSE 191,A00,516875,Minnes Kemp; Mor Mia,9999,0,9999,0
1713508362021,CSS 201S,A01,494383,Staff,35,0,35,0
1713508363048,CSS 202S,A01,494387,Staff,35,0,35,0
1713508364074,EAP 100,A00,516065,Staff,9792,0,9999,207
1713508365103,ECE 45,A01,507414,Staff,37,0,60,23
1713508366134,ECE 100,A01,507416,Baghdadchi; Saharnaz,0,0,20,20
1713508366134,ECE 100,A02,507418,Baghdadchi; Saharnaz,19,0,20,1
1713508367161,ECE 111,A01,507420,Staff,27,0,50,23
1713508368186,ECE 197,001,548057,Sievenpiper; Daniel F.,9998,0,9999,1
1713508369219,EDS 115,A00,507243,Choi; Bailey Miyeon,27,0,28,1
1713508370245,EDS 117,A01,494379,Staff,15,0,25,10
1713508371270,EDS 125,A00,507246,Hopkins; Megan Beth,27,0,30,3
1713508372298,EDS 128A,A01,507264,Fargason; Sharon Gayle,26,0,26,0
1713508373324,EDS 128B,A01,507293,Pappas; Elizabeth,30,0,30,0
1713508374354,EDS 139,A00,507294,Fargason; Sharon Gayle,30,0,30,0
1713508374354,EDS 139,B00,507313,Pappas; Elizabeth,30,0,30,0
1713508375380,EDS 201,A00,507315,Staff,18,0,30,12
1713508376411,EDS 203,A01,507317,Halter; Christopher P.,17,0,30,13
1713508377490,EDS 204R,A01,507319,Halter; Christopher P.,0,1,30,30
1713508377490,EDS 204R,B01,507331,Heinzman; Erica M.,22,0,30,8
1713508378519,EDS 206R,A00,507332,Staff,0,2,30,30
1713508378519,EDS 206R,B00,507343,Staff,23,0,30,7
1713508379552,EDS 250,A00,507344,Hemans; Patricia Ann Benitez,27,0,40,13
1713508380584,EDS 281,A00,507345,Daly; Alan J.,18,0,18,0
1713508381614,EDS 284,A00,507350,Daly; Alan J.,16,0,16,0
1713508382643,EDS 286,A00,507359,Fine; Sarah,18,0,18,0
1713508383674,EDS 289C,A01,507361,Daly; Alan J.,18,0,18,0
1713508384703,EDS 290,A00,507366,Hofstetter; Carolyn,15,0,15,0
1713508385728,LIGM 5A,A00,507421,Fischer-Grunski; Eva K,20,0,20,0
1713508386753,LIGM 5B,A00,507423,Fischer-Grunski; Eva K,20,0,20,0
1713508387779,LIGM 5C,A00,507425,Fischer-Grunski; Eva K,20,0,20,0
1713508388806,LIIT 5AS,A00,507427,Carnelos; Chiara,20,0,20,0
1713508389833,LIIT 5BS,A00,507430,Carnelos; Chiara,20,0,20,0
1713508390862,LIIT 5CS,A00,507432,Carnelos; Chiara,20,0,20,0
1713508391887,LISP 5A,A00,507541,Munoz Sanchez; Alicia,14,0,20,6
1713508392914,LISP 5B,A00,507671,Munoz Sanchez; Alicia,12,0,20,8
1713508393940,LISP 5C,A00,507696,Munoz Sanchez; Alicia,11,0,20,9
1713508394966,MAE 197,001,528363,Boechler; Nicholas Sebastia,9998,0,9999,1
1713508395990,MATH 197,001,523477,Kedlaya; Kiran S.,9999,0,9999,0
1713508395990,MATH 197,002,563811,Zhang; Danna,9998,0,9999,1
1713508397021,MCWP 40R,A00,518780,Staff,13,0,20,7
1713508397021,MCWP 40R,B00,518781,Staff,11,0,20,9
1713508397021,MCWP 40R,C00,518783,Staff,8,0,20,12
1713508398047,MCWP 50R,A00,518791,Staff,7,0,20,13
1713508398047,MCWP 50R,B00,518792,Staff,3,0,20,17
1713508398047,MCWP 50R,C00,518793,Staff,5,0,20,15
1713508398047,MCWP 50R,D00,518794,Staff,0,0,20,20
1713508398047,MCWP 50R,E00,518795,Staff,0,0,20,20
1713508398047,MCWP 50R,F00,518796,Staff,11,0,20,9
1713508398047,MCWP 50R,G00,518797,Staff,10,0,20,10
1713508399072,MMW 12R,A01,514034,Herbst; Matthew,1,0,16,15
1713508399072,MMW 12R,A02,514035,Herbst; Matthew,13,0,16,3
1713508400096,MMW 13R,A01,514037,Staff,0,8,16,16
1713508400096,MMW 13R,A02,514039,Staff,0,7,16,16
1713508402146,SIO 295LS,A00,523233,Staff,15,0,30,15
1713508403176,SIO 295S,A00,523232,Staff,15,0,30,15
1713508404202,SOCI 117,A01,494376,Staff,0,2,5,5
1713508405227,WES 237B,A00,494380,Staff,19,0,20,1
1713508407306,AESE 279B,A00,494370,Wade; Jon P,33,0,33,0
1713508408336,AIP 197,001,627712,Vespa; Emanuel Ignacio,9999,0,9999,0
1713508409362,ANAR 135S,A00,494369,Braswell; Geoffrey E.,0,0,0,0
1713508410388,CAT 124RS,A01,519847,Geibel; William,6,0,20,14
1713508411413,CAT 125RS,A01,515971,Geibel; William,6,0,20,14
1713508412445,CLRE 250,A00,511389,Morris; Sheldon,9996,0,9999,3
1713508413472,CLRE 251,A00,507176,Mehta; Ravindra L.,9996,0,9999,3
1713508413472,CLRE 251,B00,511410,Mehta; Ravindra L.,9998,0,9999,1
1713508414497,CLRE 252,A00,507189,Cuomo; Raphael Eduardo,9998,0,9999,1
1713508415528,CLRE 253,A00,507199,Vaida; Florin,9997,0,9999,2
1713508415528,CLRE 253,B00,507202,Vaida; Florin,9999,0,9999,0
1713508416553,CLRE 259,A00,507211,Patel; Hemal,9996,0,9999,3
1713508417580,CLRE 260,A00,507221,Cuomo; Raphael Eduardo,9999,0,9999,0
1713508418607,CLRE 297,001,507242,Cuomo; Raphael Eduardo,9999,0,9999,0
1713508419633,CSE 191,A00,516875,Minnes Kemp; Mor Mia,9999,0,9999,0
1713508420659,CSS 201S,A01,494383,Staff,35,0,35,0
1713508421691,CSS 202S,A01,494387,Staff,35,0,35,0
1713508422718,EAP 100,A00,516065,Staff,9792,0,9999,207
1713508423744,ECE 45,A01,507414,Staff,37,0,60,23
1713508424773,ECE 100,A01,507416,Baghdadchi; Saharnaz,0,0,20,20
1713508424773,ECE 100,A02,507418,Baghdadchi; Saharnaz,19,0,20,1
1713508425803,ECE 111,A01,507420,Staff,27,0,50,23
1713508426831,ECE 197,001,548057,Sievenpiper; Daniel F.,9998,0,9999,1
1713508427856,EDS 115,A00,507243,Choi; Bailey Miyeon,27,0,28,1
1713508428885,EDS 117,A01,494379,Staff,15,0,25,10
1713508429910,EDS 125,A00,507246,Hopkins; Megan Beth,27,0,30,3
1713508430936,EDS 128A,A01,507264,Fargason; Sharon Gayle,26,0,26,0
1713508431960,EDS 128B,A01,507293,Pappas; Elizabeth,30,0,30,0
1713508432985,EDS 139,A00,507294,Fargason; Sharon Gayle,30,0,30,0
1713508432985,EDS 139,B00,507313,Pappas; Elizabeth,30,0,30,0
1713508434013,EDS 201,A00,507315,Staff,18,0,30,12
1713508435043,EDS 203,A01,507317,Halter; Christopher P.,17,0,30,13
1713508436068,EDS 204R,A01,507319,Halter; Christopher P.,0,1,30,30
1713508436068,EDS 204R,B01,507331,Heinzman; Erica M.,22,0,30,8
1713508437096,EDS 206R,A00,507332,Staff,0,2,30,30
1713508437096,EDS 206R,B00,507343,Staff,23,0,30,7
1713508438125,EDS 250,A00,507344,Hemans; Patricia Ann Benitez,27,0,40,13
1713508439152,EDS 281,A00,507345,Daly; Alan J.,18,0,18,0
1713508440180,EDS 284,A00,507350,Daly; Alan J.,16,0,16,0
1713508441207,EDS 286,A00,507359,Fine; Sarah,18,0,18,0
1713508442241,EDS 289C,A01,507361,Daly; Alan J.,18,0,18,0
1713508443267,EDS 290,A00,507366,Hofstetter; Carolyn,15,0,15,0
1713508444298,LIGM 5A,A00,507421,Fischer-Grunski; Eva K,20,0,20,0
1713508445327,LIGM 5B,A00,507423,Fischer-Grunski; Eva K,20,0,20,0
1713508446353,LIGM 5C,A00,507425,Fischer-Grunski; Eva K,20,0,20,0
1713508447379,LIIT 5AS,A00,507427,Carnelos; Chiara,20,0,20,0
1713508448409,LIIT 5BS,A00,507430,Carnelos; Chiara,20,0,20,0
1713508449436,LIIT 5CS,A00,507432,Carnelos; Chiara,20,0,20,0
1713508450462,LISP 5A,A00,507541,Munoz Sanchez; Alicia,14,0,20,6
1713508451488,LISP 5B,A00,507671,Munoz Sanchez; Alicia,12,0,20,8
1713508452516,LISP 5C,A00,507696,Munoz Sanchez; Alicia,11,0,20,9
1713508453550,MAE 197,001,528363,Boechler; Nicholas Sebastia,9998,0,9999,1
1713508454586,MATH 197,001,523477,Kedlaya; Kiran S.,9999,0,9999,0
1713508454586,MATH 197,002,563811,Zhang; Danna,9998,0,9999,1
1713508455611,MCWP 40R,A00,518780,Staff,13,0,20,7
1713508455611,MCWP 40R,B00,518781,Staff,11,0,20,9
1713508455611,MCWP 40R,C00,518783,Staff,8,0,20,12
1713508456642,MCWP 50R,A00,518791,Staff,7,0,20,13
1713508456642,MCWP 50R,B00,518792,Staff,3,0,20,17
1713508456642,MCWP 50R,C00,518793,Staff,5,0,20,15
1713508456642,MCWP 50R,D00,518794,Staff,0,0,20,20
1713508456642,MCWP 50R,E00,518795,Staff,0,0,20,20
1713508456642,MCWP 50R,F00,518796,Staff,11,0,20,9
1713508456642,MCWP 50R,G00,518797,Staff,10,0,20,10
1713508457667,MMW 12R,A01,514034,Herbst; Matthew,1,0,16,15
1713508457667,MMW 12R,A02,514035,Herbst; Matthew,13,0,16,3
1713508458692,MMW 13R,A01,514037,Staff,0,8,16,16
1713508458692,MMW 13R,A02,514039,Staff,0,7,16,16
1713508460743,SIO 295LS,A00,523233,Staff,15,0,30,15
1713508461768,SIO 295S,A00,523232,Staff,15,0,30,15
1713508462795,SOCI 117,A01,494376,Staff,0,2,5,5
1713508463822,WES 237B,A00,494380,Staff,19,0,20,1
1713508465896,AESE 279B,A00,494370,Wade; Jon P,33,0,33,0
1713508466926,AIP 197,001,627712,Vespa; Emanuel Ignacio,9999,0,9999,0
1713508467950,ANAR 135S,A00,494369,Braswell; Geoffrey E.,0,0,0,0
1713508468981,CAT 124RS,A01,519847,Geibel; William,6,0,20,14
1713508470011,CAT 125RS,A01,515971,Geibel; William,6,0,20,14
1713508471037,CLRE 250,A00,511389,Morris; Sheldon,9996,0,9999,3
1713508472061,CLRE 251,A00,507176,Mehta; Ravindra L.,9996,0,9999,3
1713508472061,CLRE 251,B00,511410,Mehta; Ravindra L.,9998,0,9999,1
1713508473087,CLRE 252,A00,507189,Cuomo; Raphael Eduardo,9998,0,9999,1
1713508474114,CLRE 253,A00,507199,Vaida; Florin,9997,0,9999,2
1713508474114,CLRE 253,B00,507202,Vaida; Florin,9999,0,9999,0
1713508475143,CLRE 259,A00,507211,Patel; Hemal,9996,0,9999,3
1713508476168,CLRE 260,A00,507221,Cuomo; Raphael Eduardo,9999,0,9999,0
1713508477193,CLRE 297,001,507242,Cuomo; Raphael Eduardo,9999,0,9999,0
1713508478218,CSE 191,A00,516875,Minnes Kemp; Mor Mia,9999,0,9999,0
1713508479245,CSS 201S,A01,494383,Staff,35,0,35,0
1713508480276,CSS 202S,A01,494387,Staff,35,0,35,0
1713508481354,EAP 100,A00,516065,Staff,9792,0,9999,207
1713508482384,ECE 45,A01,507414,Staff,37,0,60,23
1713508483410,ECE 100,A01,507416,Baghdadchi; Saharnaz,0,0,20,20
1713508483410,ECE 100,A02,507418,Baghdadchi; Saharnaz,19,0,20,1
1713508484435,ECE 111,A01,507420,Staff,27,0,50,23
1713508485465,ECE 197,001,548057,Sievenpiper; Daniel F.,9998,0,9999,1
1713508486492,EDS 115,A00,507243,Choi; Bailey Miyeon,27,0,28,1
1713508487517,EDS 117,A01,494379,Staff,15,0,25,10
1713508488544,EDS 125,A00,507246,Hopkins; Megan Beth,27,0,30,3
1713508489569,EDS 128A,A01,507264,Fargason; Sharon Gayle,26,0,26,0
1713508490599,EDS 128B,A01,507293,Pappas; Elizabeth,30,0,30,0
1713508491627,EDS 139,A00,507294,Fargason; Sharon Gayle,30,0,30,0
1713508491627,EDS 139,B00,507313,Pappas; Elizabeth,30,0,30,0
1713508492657,EDS 201,A00,507315,Staff,18,0,30,12
1713508493682,EDS 203,A01,507317,Halter; Christopher P.,17,0,30,13
1713508494708,EDS 204R,A01,507319,Halter; Christopher P.,0,1,30,30
1713508494708,EDS 204R,B01,507331,Heinzman; Erica M.,22,0,30,8
1713508495735,EDS 206R,A00,507332,Staff,0,2,30,30
1713508495735,EDS 206R,B00,507343,Staff,23,0,30,7
1713508496764,EDS 250,A00,507344,Hemans; Patricia Ann Benitez,27,0,40,13
1713508497795,EDS 281,A00,507345,Daly; Alan J.,18,0,18,0
1713508498821,EDS 284,A00,507350,Daly; Alan J.,16,0,16,0
1713508499844,EDS 286,A00,507359,Fine; Sarah,18,0,18,0
1713508500870,EDS 289C,A01,507361,Daly; Alan J.,18,0,18,0
1713508501895,EDS 290,A00,507366,Hofstetter; Carolyn,15,0,15,0
1713508502921,LIGM 5A,A00,507421,Fischer-Grunski; Eva K,20,0,20,0
1713508503948,LIGM 5B,A00,507423,Fischer-Grunski; Eva K,20,0,20,0
1713508504980,LIGM 5C,A00,507425,Fischer-Grunski; Eva K,20,0,20,0
1713508506011,LIIT 5AS,A00,507427,Carnelos; Chiara,20,0,20,0
1713508507036,LIIT 5BS,A00,507430,Carnelos; Chiara,20,0,20,0
1713508508061,LIIT 5CS,A00,507432,Carnelos; Chiara,20,0,20,0
1713508509096,LISP 5A,A00,507541,Munoz Sanchez; Alicia,14,0,20,6
1713508510122,LISP 5B,A00,507671,Munoz Sanchez; Alicia,12,0,20,8
1713508511149,LISP 5C,A00,507696,Munoz Sanchez; Alicia,11,0,20,9
1713508512174,MAE 197,001,528363,Boechler; Nicholas Sebastia,9998,0,9999,1
1713508513200,MATH 197,001,523477,Kedlaya; Kiran S.,9999,0,9999,0
1713508513200,MATH 197,002,563811,Zhang; Danna,9998,0,9999,1
1713508514230,MCWP 40R,A00,518780,Staff,13,0,20,7
1713508514230,MCWP 40R,B00,518781,Staff,11,0,20,9
1713508514230,MCWP 40R,C00,518783,Staff,8,0,20,12
1713508515258,MCWP 50R,A00,518791,Staff,7,0,20,13
1713508515258,MCWP 50R,B00,518792,Staff,3,0,20,17
1713508515258,MCWP 50R,C00,518793,Staff,5,0,20,15
1713508515258,MCWP 50R,D00,518794,Staff,0,0,20,20
1713508515258,MCWP 50R,E00,518795,Staff,0,0,20,20
1713508515258,MCWP 50R,F00,518796,Staff,11,0,20,9
1713508515258,MCWP 50R,G00,518797,Staff,10,0,20,10
1713508516289,MMW 12R,A01,514034,Herbst; Matthew,1,0,16,15
1713508516289,MMW 12R,A02,514035,Herbst; Matthew,13,0,16,3
1713508517313,MMW 13R,A01,514037,Staff,0,8,16,16
1713508517313,MMW 13R,A02,514039,Staff,0,7,16,16
1713508519373,SIO 295LS,A00,523233,Staff,15,0,30,15
1713508520401,SIO 295S,A00,523232,Staff,15,0,30,15
1713508521426,SOCI 117,A01,494376,Staff,0,2,5,5
1713508522451,WES 237B,A00,494380,Staff,19,0,20,1
1713508524518,AESE 279B,A00,494370,Wade; Jon P,33,0,33,0
1713508525544,AIP 197,001,627712,Vespa; Emanuel Ignacio,9999,0,9999,0
1713508526575,ANAR 135S,A00,494369,Braswell; Geoffrey E.,0,0,0,0
1713508527606,CAT 124RS,A01,519847,Geibel; William,6,0,20,14
1713508528631,CAT 125RS,A01,515971,Geibel; William,6,0,20,14
1713508529661,CLRE 250,A00,511389,Morris; Sheldon,9996,0,9999,3
1713508530688,CLRE 251,A00,507176,Mehta; Ravindra L.,9996,0,9999,3
1713508530688,CLRE 251,B00,511410,Mehta; Ravindra L.,9998,0,9999,1
1713508531717,CLRE 252,A00,507189,Cuomo; Raphael Eduardo,9998,0,9999,1
1713508532745,CLRE 253,A00,507199,Vaida; Florin,9997,0,9999,2
1713508532745,CLRE 253,B00,507202,Vaida; Florin,9999,0,9999,0
1713508533771,CLRE 259,A00,507211,Patel; Hemal,9996,0,9999,3
1713508534801,CLRE 260,A00,507221,Cuomo; Raphael Eduardo,9999,0,9999,0
1713508535830,CLRE 297,001,507242,Cuomo; Raphael Eduardo,9999,0,9999,0
1713508536860,CSE 191,A00,516875,Minnes Kemp; Mor Mia,9999,0,9999,0
1713508537894,CSS 201S,A01,494383,Staff,35,0,35,0
1713508538926,CSS 202S,A01,494387,Staff,35,0,35,0
1713508539954,EAP 100,A00,516065,Staff,9792,0,9999,207
1713508540983,ECE 45,A01,507414,Staff,37,0,60,23
1713508542007,ECE 100,A01,507416,Baghdadchi; Saharnaz,0,0,20,20
1713508542007,ECE 100,A02,507418,Baghdadchi; Saharnaz,19,0,20,1
1713508543036,ECE 111,A01,507420,Staff,27,0,50,23
1713508544063,ECE 197,001,548057,Sievenpiper; Daniel F.,9998,0,9999,1
1713508545091,EDS 115,A00,507243,Choi; Bailey Miyeon,27,0,28,1
1713508546116,EDS 117,A01,494379,Staff,15,0,25,10
1713508547141,EDS 125,A00,507246,Hopkins; Megan Beth,27,0,30,3
1713508548167,EDS 128A,A01,507264,Fargason; Sharon Gayle,26,0,26,0
1713508549194,EDS 128B,A01,507293,Pappas; Elizabeth,30,0,30,0
1713508550220,EDS 139,A00,507294,Fargason; Sharon Gayle,30,0,30,0
1713508550220,EDS 139,B00,507313,Pappas; Elizabeth,30,0,30,0
1713508551249,EDS 201,A00,507315,Staff,18,0,30,12
1713508552281,EDS 203,A01,507317,Halter; Christopher P.,17,0,30,13
1713508553311,EDS 204R,A01,507319,Halter; Christopher P.,0,1,30,30
1713508553311,EDS 204R,B01,507331,Heinzman; Erica M.,22,0,30,8
1713508554338,EDS 206R,A00,507332,Staff,0,2,30,30
1713508554338,EDS 206R,B00,507343,Staff,23,0,30,7
1713508555364,EDS 250,A00,507344,Hemans; Patricia Ann Benitez,27,0,40,13
1713508556390,EDS 281,A00,507345,Daly; Alan J.,18,0,18,0
1713508557414,EDS 284,A00,507350,Daly; Alan J.,16,0,16,0
1713508558440,EDS 286,A00,507359,Fine; Sarah,18,0,18,0
1713508559466,EDS 289C,A01,507361,Daly; Alan J.,18,0,18,0
1713508560497,EDS 290,A00,507366,Hofstetter; Carolyn,15,0,15,0
1713508561523,LIGM 5A,A00,507421,Fischer-Grunski; Eva K,20,0,20,0
1713508562553,LIGM 5B,A00,507423,Fischer-Grunski; Eva K,20,0,20,0
1713508563584,LIGM 5C,A00,507425,Fischer-Grunski; Eva K,20,0,20,0
1713508564610,LIIT 5AS,A00,507427,Carnelos; Chiara,20,0,20,0
1713508565640,LIIT 5BS,A00,507430,Carnelos; Chiara,20,0,20,0
1713508566664,LIIT 5CS,A00,507432,Carnelos; Chiara,20,0,20,0
1713508567688,LISP 5A,A00,507541,Munoz Sanchez; Alicia,14,0,20,6
1713508568725,LISP 5B,A00,507671,Munoz Sanchez; Alicia,12,0,20,8
1713508569750,LISP 5C,A00,507696,Munoz Sanchez; Alicia,11,0,20,9
1713508570774,MAE 197,001,528363,Boechler; Nicholas Sebastia,9998,0,9999,1
1713508571798,MATH 197,001,523477,Kedlaya; Kiran S.,9999,0,9999,0
1713508571798,MATH 197,002,563811,Zhang; Danna,9998,0,9999,1
1713508572822,MCWP 40R,A00,518780,Staff,13,0,20,7
1713508572822,MCWP 40R,B00,518781,Staff,11,0,20,9
1713508572822,MCWP 40R,C00,518783,Staff,8,0,20,12
1713508573849,MCWP 50R,A00,518791,Staff,7,0,20,13
1713508573849,MCWP 50R,B00,518792,Staff,3,0,20,17
1713508573849,MCWP 50R,C00,518793,Staff,5,0,20,15
1713508573849,MCWP 50R,D00,518794,Staff,0,0,20,20
1713508573849,MCWP 50R,E00,518795,Staff,0,0,20,20
1713508573849,MCWP 50R,F00,518796,Staff,11,0,20,9
1713508573849,MCWP 50R,G00,518797,Staff,10,0,20,10
1713508574878,MMW 12R,A01,514034,Herbst; Matthew,1,0,16,15
1713508574878,MMW 12R,A02,514035,Herbst; Matthew,13,0,16,3
1713508575903,MMW 13R,A01,514037,Staff,0,8,16,16
1713508575903,MMW 13R,A02,514039,Staff,0,7,16,16
1713508577957,SIO 295LS,A00,523233,Staff,15,0,30,15
1713508578982,SIO 295S,A00,523232,Staff,15,0,30,15
1713508580009,SOCI 117,A01,494376,Staff,0,2,5,5
1713508581039,WES 237B,A00,494380,Staff,19,0,20,1
1713508583117,AESE 279B,A00,494370,Wade; Jon P,33,0,33,0
1713508584145,AIP 197,001,627712,Vespa; Emanuel Ignacio,9999,0,9999,0
1713508585225,ANAR 135S,A00,494369,Braswell; Geoffrey E.,0,0,0,0
1713508586250,CAT 124RS,A01,519847,Geibel; William,6,0,20,14
1713508587278,CAT 125RS,A01,515971,Geibel; William,6,0,20,14
1713508588305,CLRE 250,A00,511389,Morris; Sheldon,9996,0,9999,3
1713508589331,CLRE 251,A00,507176,Mehta; Ravindra L.,9996,0,9999,3
1713508589331,CLRE 251,B00,511410,Mehta; Ravindra L.,9998,0,9999,1
1713508590361,CLRE 252,A00,507189,Cuomo; Raphael Eduardo,9998,0,9999,1
1713508591386,CLRE 253,A00,507199,Vaida; Florin,9997,0,9999,2
1713508591386,CLRE 253,B00,507202,Vaida; Florin,9999,0,9999,0
1713508592414,CLRE 259,A00,507211,Patel; Hemal,9996,0,9999,3
1713508593441,CLRE 260,A00,507221,Cuomo; Raphael Eduardo,9999,0,9999,0
1713508594470,CLRE 297,001,507242,Cuomo; Raphael Eduardo,9999,0,9999,0
1713508595500,CSE 191,A00,516875,Minnes Kemp; Mor Mia,9999,0,9999,0
1713508596531,CSS 201S,A01,494383,Staff,35,0,35,0
1713508597557,CSS 202S,A01,494387,Staff,35,0,35,0
1713508598582,EAP 100,A00,516065,Staff,9792,0,9999,207
1713508599609,ECE 45,A01,507414,Staff,37,0,60,23
1713508600638,ECE 100,A01,507416,Baghdadchi; Saharnaz,0,0,20,20
1713508600638,ECE 100,A02,507418,Baghdadchi; Saharnaz,19,0,20,1
1713508601666,ECE 111,A01,507420,Staff,27,0,50,23
1713508602692,ECE 197,001,548057,Sievenpiper; Daniel F.,9998,0,9999,1
1713508603716,EDS 115,A00,507243,Choi; Bailey Miyeon,27,0,28,1
1713508604746,EDS 117,A01,494379,Staff,15,0,25,10
1713508605774,EDS 125,A00,507246,Hopkins; Megan Beth,27,0,30,3
1713508606800,EDS 128A,A01,507264,Fargason; Sharon Gayle,26,0,26,0
1713508607883,EDS 128B,A01,507293,Pappas; Elizabeth,30,0,30,0
1713508608910,EDS 139,A00,507294,Fargason; Sharon Gayle,30,0,30,0
1713508608910,EDS 139,B00,507313,Pappas; Elizabeth,30,0,30,0
1713508609937,EDS 201,A00,507315,Staff,18,0,30,12
1713508610967,EDS 203,A01,507317,Halter; Christopher P.,17,0,30,13
1713508611993,EDS 204R,A01,507319,Halter; Christopher P.,0,1,30,30
1713508611993,EDS 204R,B01,507331,Heinzman; Erica M.,22,0,30,8
1713508613021,EDS 206R,A00,507332,Staff,0,2,30,30
1713508613021,EDS 206R,B00,507343,Staff,23,0,30,7
1713508614047,EDS 250,A00,507344,Hemans; Patricia Ann Benitez,27,0,40,13
1713508615074,EDS 281,A00,507345,Daly; Alan J.,18,0,18,0
1713508616104,EDS 284,A00,507350,Daly; Alan J.,16,0,16,0
1713508617129,EDS 286,A00,507359,Fine; Sarah,18,0,18,0
1713508618156,EDS 289C,A01,507361,Daly; Alan J.,18,0,18,0
1713508619187,EDS 290,A00,507366,Hofstetter; Carolyn,15,0,15,0
1713508620211,LIGM 5A,A00,507421,Fischer-Grunski; Eva K,20,0,20,0
1713508621240,LIGM 5B,A00,507423,Fischer-Grunski; Eva K,20,0,20,0
1713508622270,LIGM 5C,A00,507425,Fischer-Grunski; Eva K,20,0,20,0
1713508623300,LIIT 5AS,A00,507427,Carnelos; Chiara,20,0,20,0
1713508624329,LIIT 5BS,A00,507430,Carnelos; Chiara,20,0,20,0
1713508625359,LIIT 5CS,A00,507432,Carnelos; Chiara,20,0,20,0
1713508626385,LISP 5A,A00,507541,Munoz Sanchez; Alicia,14,0,20,6
1713508627408,LISP 5B,A00,507671,Munoz Sanchez; Alicia,12,0,20,8
1713508628434,LISP 5C,A00,507696,Munoz Sanchez; Alicia,11,0,20,9
1713508629458,MAE 197,001,528363,Boechler; Nicholas Sebastia,9998,0,9999,1
1713508630488,MATH 197,001,523477,Kedlaya; Kiran S.,9999,0,9999,0
1713508630488,MATH 197,002,563811,Zhang; Danna,9998,0,9999,1
1713508631520,MCWP 40R,A00,518780,Staff,13,0,20,7
1713508631520,MCWP 40R,B00,518781,Staff,11,0,20,9
1713508631520,MCWP 40R,C00,518783,Staff,8,0,20,12
1713508632549,MCWP 50R,A00,518791,Staff,7,0,20,13
1713508632549,MCWP 50R,B00,518792,Staff,3,0,20,17
1713508632549,MCWP 50R,C00,518793,Staff,5,0,20,15
1713508632549,MCWP 50R,D00,518794,Staff,0,0,20,20
1713508632549,MCWP 50R,E00,518795,Staff,0,0,20,20
1713508632549,MCWP 50R,F00,518796,Staff,11,0,20,9
1713508632549,MCWP 50R,G00,518797,Staff,10,0,20,10
1713508633579,MMW 12R,A01,514034,Herbst; Matthew,1,0,16,15
1713508633579,MMW 12R,A02,514035,Herbst; Matthew,13,0,16,3
1713508634607,MMW 13R,A01,514037,Staff,0,8,16,16
1713508634607,MMW 13R,A02,514039,Staff,0,7,16,16
1713508636666,SIO 295LS,A00,523233,Staff,15,0,30,15
1713508637693,SIO 295S,A00,523232,Staff,15,0,30,15
1713508638717,SOCI 117,A01,494376,Staff,0,2,5,5
1713508639832,WES 237B,A00,494380,Staff,19,0,20,1
1713508641897,AESE 279B,A00,494370,Wade; Jon P,33,0,33,0
1713508642923,AIP 197,001,627712,Vespa; Emanuel Ignacio,9999,0,9999,0
1713508643950,ANAR 135S,A00,494369,Braswell; Geoffrey E.,0,0,0,0
1713508644977,CAT 124RS,A01,519847,Geibel; William,6,0,20,14
1713508646003,CAT 125RS,A01,515971,Geibel; William,6,0,20,14
1713508647032,CLRE 250,A00,511389,Morris; Sheldon,9996,0,9999,3
1713508648060,CLRE 251,A00,507176,Mehta; Ravindra L.,9996,0,9999,3
1713508648060,CLRE 251,B00,511410,Mehta; Ravindra L.,9998,0,9999,1
1713508649086,CLRE 252,A00,507189,Cuomo; Raphael Eduardo,9998,0,9999,1
1713508650112,CLRE 253,A00,507199,Vaida; Florin,9997,0,9999,2
1713508650112,CLRE 253,B00,507202,Vaida; Florin,9999,0,9999,0
1713508651138,CLRE 259,A00,507211,Patel; Hemal,9996,0,9999,3
1713508652165,CLRE 260,A00,507221,Cuomo; Raphael Eduardo,9999,0,9999,0
1713508653193,CLRE 297,001,507242,Cuomo; Raphael Eduardo,9999,0,9999,0
1713508654222,CSE 191,A00,516875,Minnes Kemp; Mor Mia,9999,0,9999,0
1713508655251,CSS 201S,A01,494383,Staff,35,0,35,0
1713508656277,CSS 202S,A01,494387,Staff,35,0,35,0
1713508657303,EAP 100,A00,516065,Staff,9792,0,9999,207
1713508658328,ECE 45,A01,507414,Staff,37,0,60,23
1713508659353,ECE 100,A01,507416,Baghdadchi; Saharnaz,0,0,20,20
1713508659353,ECE 100,A02,507418,Baghdadchi; Saharnaz,19,0,20,1
1713508660381,ECE 111,A01,507420,Staff,27,0,50,23
1713508661405,ECE 197,001,548057,Sievenpiper; Daniel F.,9998,0,9999,1
1713508662430,EDS 115,A00,507243,Choi; Bailey Miyeon,27,0,28,1
1713508663457,EDS 117,A01,494379,Staff,15,0,25,10
1713508664485,EDS 125,A00,507246,Hopkins; Megan Beth,27,0,30,3
1713508665509,EDS 128A,A01,507264,Fargason; Sharon Gayle,26,0,26,0
1713508666535,EDS 128B,A01,507293,Pappas; Elizabeth,30,0,30,0
1713508667561,EDS 139,A00,507294,Fargason; Sharon Gayle,30,0,30,0
1713508667561,EDS 139,B00,507313,Pappas; Elizabeth,30,0,30,0
1713508668586,EDS 201,A00,507315,Staff,18,0,30,12
1713508669611,EDS 203,A01,507317,Halter; Christopher P.,17,0,30,13
1713508670642,EDS 204R,A01,507319,Halter; Christopher P.,0,1,30,30
1713508670642,EDS 204R,B01,507331,Heinzman; Erica M.,22,0,30,8
1713508671667,EDS 206R,A00,507332,Staff,0,2,30,30
1713508671667,EDS 206R,B00,507343,Staff,23,0,30,7
1713508672695,EDS 250,A00,507344,Hemans; Patricia Ann Benitez,27,0,40,13
1713508673725,EDS 281,A00,507345,Daly; Alan J.,18,0,18,0
1713508674752,EDS 284,A00,507350,Daly; Alan J.,16,0,16,0
1713508675778,EDS 286,A00,507359,Fine; Sarah,18,0,18,0
1713508676806,EDS 289C,A01,507361,Daly; Alan J.,18,0,18,0
1713508677830,EDS 290,A00,507366,Hofstetter; Carolyn,15,0,15,0
1713508678862,LIGM 5A,A00,507421,Fischer-Grunski; Eva K,20,0,20,0
1713508679889,LIGM 5B,A00,507423,Fischer-Grunski; Eva K,20,0,20,0
1713508680915,LIGM 5C,A00,507425,Fischer-Grunski; Eva K,20,0,20,0
1713508681950,LIIT 5AS,A00,507427,Carnelos; Chiara,20,0,20,0
1713508682976,LIIT 5BS,A00,507430,Carnelos; Chiara,20,0,20,0
1713508684002,LIIT 5CS,A00,507432,Carnelos; Chiara,20,0,20,0
1713508685031,LISP 5A,A00,507541,Munoz Sanchez; Alicia,14,0,20,6
1713508686061,LISP 5B,A00,507671,Munoz Sanchez; Alicia,12,0,20,8
1713508687091,LISP 5C,A00,507696,Munoz Sanchez; Alicia,11,0,20,9
1713508688117,MAE 197,001,528363,Boechler; Nicholas Sebastia,9998,0,9999,1
1713508689196,MATH 197,001,523477,Kedlaya; Kiran S.,9999,0,9999,0
1713508689196,MATH 197,002,563811,Zhang; Danna,9998,0,9999,1
1713508690223,MCWP 40R,A00,518780,Staff,13,0,20,7
1713508690223,MCWP 40R,B00,518781,Staff,11,0,20,9
1713508690223,MCWP 40R,C00,518783,Staff,8,0,20,12
1713508691251,MCWP 50R,A00,518791,Staff,7,0,20,13
1713508691251,MCWP 50R,B00,518792,Staff,3,0,20,17
1713508691251,MCWP 50R,C00,518793,Staff,5,0,20,15
1713508691251,MCWP 50R,D00,518794,Staff,0,0,20,20
1713508691251,MCWP 50R,E00,518795,Staff,0,0,20,20
1713508691251,MCWP 50R,F00,518796,Staff,11,0,20,9
1713508691251,MCWP 50R,G00,518797,Staff,10,0,20,10
1713508692277,MMW 12R,A01,514034,Herbst; Matthew,1,0,16,15
1713508692277,MMW 12R,A02,514035,Herbst; Matthew,13,0,16,3
1713508693303,MMW 13R,A01,514037,Staff,0,8,16,16
1713508693303,MMW 13R,A02,514039,Staff,0,7,16,16
1713508695358,SIO 295LS,A00,523233,Staff,15,0,30,15
1713508696384,SIO 295S,A00,523232,Staff,15,0,30,15
1713508697412,SOCI 117,A01,494376,Staff,0,2,5,5
1713508698440,WES 237B,A00,494380,Staff,19,0,20,1
1713508700510,AESE 279B,A00,494370,Wade; Jon P,33,0,33,0
1713508701534,AIP 197,001,627712,Vespa; Emanuel Ignacio,9999,0,9999,0
1713508702563,ANAR 135S,A00,494369,Braswell; Geoffrey E.,0,0,0,0
1713508703594,CAT 124RS,A01,519847,Geibel; William,6,0,20,14
1713508704622,CAT 125RS,A01,515971,Geibel; William,6,0,20,14
1713508705650,CLRE 250,A00,511389,Morris; Sheldon,9996,0,9999,3
1713508706686,CLRE 251,A00,507176,Mehta; Ravindra L.,9996,0,9999,3
1713508706686,CLRE 251,B00,511410,Mehta; Ravindra L.,9998,0,9999,1
1713508707713,CLRE 252,A00,507189,Cuomo; Raphael Eduardo,9998,0,9999,1
1713508708742,CLRE 253,A00,507199,Vaida; Florin,9997,0,9999,2
1713508708742,CLRE 253,B00,507202,Vaida; Florin,9999,0,9999,0
1713508709769,CLRE 259,A00,507211,Patel; Hemal,9996,0,9999,3
1713508710798,CLRE 260,A00,507221,Cuomo; Raphael Eduardo,9999,0,9999,0
1713508711826,CLRE 297,001,507242,Cuomo; Raphael Eduardo,9999,0,9999,0
1713508712851,CSE 191,A00,516875,Minnes Kemp; Mor Mia,9999,0,9999,0
1713508713878,CSS 201S,A01,494383,Staff,35,0,35,0
1713508714904,CSS 202S,A01,494387,Staff,35,0,35,0
1713508715933,EAP 100,A00,516065,Staff,9792,0,9999,207
1713508716959,ECE 45,A01,507414,Staff,37,0,60,23
1713508717984,ECE 100,A01,507416,Baghdadchi; Saharnaz,0,0,20,20
1713508717984,ECE 100,A02,507418,Baghdadchi; Saharnaz,19,0,20,1
1713508719011,ECE 111,A01,507420,Staff,27,0,50,23
1713508720036,ECE 197,001,548057,Sievenpiper; Daniel F.,9998,0,9999,1
1713508721066,EDS 115,A00,507243,Choi; Bailey Miyeon,27,0,28,1
1713508722098,EDS 117,A01,494379,Staff,15,0,25,10
1713508723126,EDS 125,A00,507246,Hopkins; Megan Beth,27,0,30,3
1713508724151,EDS 128A,A01,507264,Fargason; Sharon Gayle,26,0,26,0
1713508725177,EDS 128B,A01,507293,Pappas; Elizabeth,30,0,30,0
1713508726206,EDS 139,A00,507294,Fargason; Sharon Gayle,30,0,30,0
1713508726206,EDS 139,B00,507313,Pappas; Elizabeth,30,0,30,0
1713508727231,EDS 201,A00,507315,Staff,18,0,30,12
1713508728257,EDS 203,A01,507317,Halter; Christopher P.,17,0,30,13
1713508729282,EDS 204R,A01,507319,Halter; Christopher P.,0,1,30,30
1713508729282,EDS 204R,B01,507331,Heinzman; Erica M.,22,0,30,8
1713508730308,EDS 206R,A00,507332,Staff,0,2,30,30
1713508730308,EDS 206R,B00,507343,Staff,23,0,30,7
1713508731333,EDS 250,A00,507344,Hemans; Patricia Ann Benitez,27,0,40,13
1713508732358,EDS 281,A00,507345,Daly; Alan J.,18,0,18,0
1713508733385,EDS 284,A00,507350,Daly; Alan J.,16,0,16,0
1713508734409,EDS 286,A00,507359,Fine; Sarah,18,0,18,0
1713508735437,EDS 289C,A01,507361,Daly; Alan J.,18,0,18,0
1713508736460,EDS 290,A00,507366,Hofstetter; Carolyn,15,0,15,0
1713508737489,LIGM 5A,A00,507421,Fischer-Grunski; Eva K,20,0,20,0
1713508738834,LIGM 5B,A00,507423,Fischer-Grunski; Eva K,20,0,20,0
1713508739868,LIGM 5C,A00,507425,Fischer-Grunski; Eva K,20,0,20,0
1713508740898,LIIT 5AS,A00,507427,Carnelos; Chiara,20,0,20,0
1713508741928,LIIT 5BS,A00,507430,Carnelos; Chiara,20,0,20,0
1713508742954,LIIT 5CS,A00,507432,Carnelos; Chiara,20,0,20,0
1713508743980,LISP 5A,A00,507541,Munoz Sanchez; Alicia,14,0,20,6
1713508745008,LISP 5B,A00,507671,Munoz Sanchez; Alicia,12,0,20,8
1713508746034,LISP 5C,A00,507696,Munoz Sanchez; Alicia,11,0,20,9
1713508747063,MAE 197,001,528363,Boechler; Nicholas Sebastia,9998,0,9999,1
1713508748094,MATH 197,001,523477,Kedlaya; Kiran S.,9999,0,9999,0
1713508748094,MATH 197,002,563811,Zhang; Danna,9998,0,9999,1
1713508749123,MCWP 40R,A00,518780,Staff,13,0,20,7
1713508749123,MCWP 40R,B00,518781,Staff,11,0,20,9
1713508749123,MCWP 40R,C00,518783,Staff,8,0,20,12
1713508750155,MCWP 50R,A00,518791,Staff,7,0,20,13
1713508750155,MCWP 50R,B00,518792,Staff,3,0,20,17
1713508750155,MCWP 50R,C00,518793,Staff,5,0,20,15
1713508750155,MCWP 50R,D00,518794,Staff,0,0,20,20
1713508750155,MCWP 50R,E00,518795,Staff,0,0,20,20
1713508750155,MCWP 50R,F00,518796,Staff,11,0,20,9
1713508750155,MCWP 50R,G00,518797,Staff,10,0,20,10
1713508751182,MMW 12R,A01,514034,Herbst; Matthew,1,0,16,15
1713508751182,MMW 12R,A02,514035,Herbst; Matthew,13,0,16,3
1713508752210,MMW 13R,A01,514037,Staff,0,8,16,16
1713508752210,MMW 13R,A02,514039,Staff,0,7,16,16
1713508754260,SIO 295LS,A00,523233,Staff,15,0,30,15
1713508755288,SIO 295S,A00,523232,Staff,15,0,30,15
1713508756312,SOCI 117,A01,494376,Staff,0,2,5,5
1713508757338,WES 237B,A00,494380,Staff,19,0,20,1
1713508759423,AESE 279B,A00,494370,Wade; Jon P,33,0,33,0
1713508760448,AIP 197,001,627712,Vespa; Emanuel Ignacio,9999,0,9999,0
1713508761473,ANAR 135S,A00,494369,Braswell; Geoffrey E.,0,0,0,0
1713508762498,CAT 124RS,A01,519847,Geibel; William,6,0,20,14
1713508763527,CAT 125RS,A01,515971,Geibel; William,6,0,20,14
1713508764554,CLRE 250,A00,511389,Morris; Sheldon,9996,0,9999,3
1713508765580,CLRE 251,A00,507176,Mehta; Ravindra L.,9996,0,9999,3
1713508765580,CLRE 251,B00,511410,Mehta; Ravindra L.,9998,0,9999,1
1713508766610,CLRE 252,A00,507189,Cuomo; Raphael Eduardo,9998,0,9999,1
1713508767646,CLRE 253,A00,507199,Vaida; Florin,9997,0,9999,2
1713508767646,CLRE 253,B00,507202,Vaida; Florin,9999,0,9999,0
1713508768672,CLRE 259,A00,507211,Patel; Hemal,9996,0,9999,3
1713508769697,CLRE 260,A00,507221,Cuomo; Raphael Eduardo,9999,0,9999,0
1713508770730,CLRE 297,001,507242,Cuomo; Raphael Eduardo,9999,0,9999,0
1713508771757,CSE 191,A00,516875,Minnes Kemp; Mor Mia,9999,0,9999,0
1713508772783,CSS 201S,A01,494383,Staff,35,0,35,0
1713508773809,CSS 202S,A01,494387,Staff,35,0,35,0
1713508774836,EAP 100,A00,516065,Staff,9792,0,9999,207
1713508775862,ECE 45,A01,507414,Staff,37,0,60,23
1713508776887,ECE 100,A01,507416,Baghdadchi; Saharnaz,0,0,20,20
1713508776887,ECE 100,A02,507418,Baghdadchi; Saharnaz,19,0,20,1
1713508777913,ECE 111,A01,507420,Staff,27,0,50,23
1713508778937,ECE 197,001,548057,Sievenpiper; Daniel F.,9998,0,9999,1
1713508779962,EDS 115,A00,507243,Choi; Bailey Miyeon,27,0,28,1
1713508780988,EDS 117,A01,494379,Staff,15,0,25,10
1713508782019,EDS 125,A00,507246,Hopkins; Megan Beth,27,0,30,3
1713508783045,EDS 128A,A01,507264,Fargason; Sharon Gayle,26,0,26,0
1713508784071,EDS 128B,A01,507293,Pappas; Elizabeth,30,0,30,0
1713508785097,EDS 139,A00,507294,Fargason; Sharon Gayle,30,0,30,0
1713508785097,EDS 139,B00,507313,Pappas; Elizabeth,30,0,30,0
1713508786123,EDS 201,A00,507315,Staff,18,0,30,12
1713508787149,EDS 203,A01,507317,Halter; Christopher P.,17,0,30,13
1713508788175,EDS 204R,A01,507319,Halter; Christopher P.,0,1,30,30
1713508788175,EDS 204R,B01,507331,Heinzman; Erica M.,22,0,30,8
1713508789203,EDS 206R,A00,507332,Staff,0,2,30,30
1713508789203,EDS 206R,B00,507343,Staff,23,0,30,7
1713508790235,EDS 250,A00,507344,Hemans; Patricia Ann Benitez,27,0,40,13
1713508791261,EDS 281,A00,507345,Daly; Alan J.,18,0,18,0
1713508792291,EDS 284,A00,507350,Daly; Alan J.,16,0,16,0
1713508793379,EDS 286,A00,507359,Fine; Sarah,18,0,18,0
1713508794405,EDS 289C,A01,507361,Daly; Alan J.,18,0,18,0
1713508795429,EDS 290,A00,507366,Hofstetter; Carolyn,15,0,15,0
1713508796456,LIGM 5A,A00,507421,Fischer-Grunski; Eva K,20,0,20,0
1713508797482,LIGM 5B,A00,507423,Fischer-Grunski; Eva K,20,0,20,0
1713508798508,LIGM 5C,A00,507425,Fischer-Grunski; Eva K,20,0,20,0
1713508799533,LIIT 5AS,A00,507427,Carnelos; Chiara,20,0,20,0
1713508800564,LIIT 5BS,A00,507430,Carnelos; Chiara,20,0,20,0
1713508801594,LIIT 5CS,A00,507432,Carnelos; Chiara,20,0,20,0
1713508802619,LISP 5A,A00,507541,Munoz Sanchez; Alicia,14,0,20,6
1713508803648,LISP 5B,A00,507671,Munoz Sanchez; Alicia,12,0,20,8
1713508804673,LISP 5C,A00,507696,Munoz Sanchez; Alicia,11,0,20,9
1713508805701,MAE 197,001,528363,Boechler; Nicholas Sebastia,9998,0,9999,1
1713508806727,MATH 197,001,523477,Kedlaya; Kiran S.,9999,0,9999,0
1713508806727,MATH 197,002,563811,Zhang; Danna,9998,0,9999,1
1713508807752,MCWP 40R,A00,518780,Staff,13,0,20,7
1713508807752,MCWP 40R,B00,518781,Staff,11,0,20,9
1713508807752,MCWP 40R,C00,518783,Staff,8,0,20,12
1713508808783,MCWP 50R,A00,518791,Staff,7,0,20,13
1713508808783,MCWP 50R,B00,518792,Staff,3,0,20,17
1713508808783,MCWP 50R,C00,518793,Staff,5,0,20,15
1713508808783,MCWP 50R,D00,518794,Staff,0,0,20,20
1713508808783,MCWP 50R,E00,518795,Staff,0,0,20,20
1713508808783,MCWP 50R,F00,518796,Staff,11,0,20,9
1713508808783,MCWP 50R,G00,518797,Staff,10,0,20,10
1713508809808,MMW 12R,A01,514034,Herbst; Matthew,1,0,16,15
1713508809808,MMW 12R,A02,514035,Herbst; Matthew,13,0,16,3
1713508810836,MMW 13R,A01,514037,Staff,0,8,16,16
1713508810836,MMW 13R,A02,514039,Staff,0,7,16,16
1713508812890,SIO 295LS,A00,523233,Staff,15,0,30,15
1713508813916,SIO 295S,A00,523232,Staff,15,0,30,15
1713508814940,SOCI 117,A01,494376,Staff,0,2,5,5
1713508815966,WES 237B,A00,494380,Staff,19,0,20,1
1713508818047,AESE 279B,A00,494370,Wade; Jon P,33,0,33,0
1713508819076,AIP 197,001,627712,Vespa; Emanuel Ignacio,9999,0,9999,0
1713508820100,ANAR 135S,A00,494369,Braswell; Geoffrey E.,0,0,0,0
1713508821125,CAT 124RS,A01,519847,Geibel; William,6,0,20,14
1713508822151,CAT 125RS,A01,515971,Geibel; William,6,0,20,14
1713508823181,CLRE 250,A00,511389,Morris; Sheldon,9996,0,9999,3
1713508824212,CLRE 251,A00,507176,Mehta; Ravindra L.,9996,0,9999,3
1713508824212,CLRE 251,B00,511410,Mehta; Ravindra L.,9998,0,9999,1
1713508825239,CLRE 252,A00,507189,Cuomo; Raphael Eduardo,9998,0,9999,1
1713508826266,CLRE 253,A00,507199,Vaida; Florin,9997,0,9999,2
1713508826266,CLRE 253,B00,507202,Vaida; Florin,9999,0,9999,0
1713508827294,CLRE 259,A00,507211,Patel; Hemal,9996,0,9999,3
1713508828320,CLRE 260,A00,507221,Cuomo; Raphael Eduardo,9999,0,9999,0
1713508829345,CLRE 297,001,507242,Cuomo; Raphael Eduardo,9999,0,9999,0
1713508830370,CSE 191,A00,516875,Minnes Kemp; Mor Mia,9999,0,9999,0
1713508831399,CSS 201S,A01,494383,Staff,35,0,35,0
1713508832430,CSS 202S,A01,494387,Staff,35,0,35,0
1713508833455,EAP 100,A00,516065,Staff,9792,0,9999,207
1713508834481,ECE 45,A01,507414,Staff,37,0,60,23
1713508835506,ECE 100,A01,507416,Baghdadchi; Saharnaz,0,0,20,20
1713508835506,ECE 100,A02,507418,Baghdadchi; Saharnaz,19,0,20,1
1713508836531,ECE 111,A01,507420,Staff,27,0,50,23
1713508837559,ECE 197,001,548057,Sievenpiper; Daniel F.,9998,0,9999,1
1713508838588,EDS 115,A00,507243,Choi; Bailey Miyeon,27,0,28,1
1713508839614,EDS 117,A01,494379,Staff,15,0,25,10
1713508840642,EDS 125,A00,507246,Hopkins; Megan Beth,27,0,30,3
1713508841671,EDS 128A,A01,507264,Fargason; Sharon Gayle,26,0,26,0
1713508842708,EDS 128B,A01,507293,Pappas; Elizabeth,30,0,30,0
1713508843733,EDS 139,A00,507294,Fargason; Sharon Gayle,30,0,30,0
1713508843733,EDS 139,B00,507313,Pappas; Elizabeth,30,0,30,0
1713508844761,EDS 201,A00,507315,Staff,18,0,30,12
1713508845791,EDS 203,A01,507317,Halter; Christopher P.,17,0,30,13
1713508846816,EDS 204R,A01,507319,Halter; Christopher P.,0,1,30,30
1713508846816,EDS 204R,B01,507331,Heinzman; Erica M.,22,0,30,8
1713508847845,EDS 206R,A00,507332,Staff,0,2,30,30
1713508847845,EDS 206R,B00,507343,Staff,23,0,30,7
1713508848872,EDS 250,A00,507344,Hemans; Patricia Ann Benitez,27,0,40,13
1713508849900,EDS 281,A00,507345,Daly; Alan J.,18,0,18,0
1713508850929,EDS 284,A00,507350,Daly; Alan J.,16,0,16,0
1713508851955,EDS 286,A00,507359,Fine; Sarah,18,0,18,0
1713508852980,EDS 289C,A01,507361,Daly; Alan J.,18,0,18,0
1713508854006,EDS 290,A00,507366,Hofstetter; Carolyn,15,0,15,0
1713508855035,LIGM 5A,A00,507421,Fischer-Grunski; Eva K,20,0,20,0
1713508856061,LIGM 5B,A00,507423,Fischer-Grunski; Eva K,20,0,20,0
1713508857091,LIGM 5C,A00,507425,Fischer-Grunski; Eva K,20,0,20,0
1713508858117,LIIT 5AS,A00,507427,Carnelos; Chiara,20,0,20,0
1713508859145,LIIT 5BS,A00,507430,Carnelos; Chiara,20,0,20,0
1713508860172,LIIT 5CS,A00,507432,Carnelos; Chiara,20,0,20,0
1713508861203,LISP 5A,A00,507541,Munoz Sanchez; Alicia,14,0,20,6
1713508862228,LISP 5B,A00,507671,Munoz Sanchez; Alicia,12,0,20,8
1713508863254,LISP 5C,A00,507696,Munoz Sanchez; Alicia,11,0,20,9
1713508864279,MAE 197,001,528363,Boechler; Nicholas Sebastia,9998,0,9999,1
1713508865310,MATH 197,001,523477,Kedlaya; Kiran S.,9999,0,9999,0
1713508865310,MATH 197,002,563811,Zhang; Danna,9998,0,9999,1
1713508866339,MCWP 40R,A00,518780,Staff,13,0,20,7
1713508866339,MCWP 40R,B00,518781,Staff,11,0,20,9
1713508866339,MCWP 40R,C00,518783,Staff,8,0,20,12
1713508867373,MCWP 50R,A00,518791,Staff,7,0,20,13
1713508867373,MCWP 50R,B00,518792,Staff,3,0,20,17
1713508867373,MCWP 50R,C00,518793,Staff,5,0,20,15
1713508867373,MCWP 50R,D00,518794,Staff,0,0,20,20
1713508867373,MCWP 50R,E00,518795,Staff,0,0,20,20
1713508867373,MCWP 50R,F00,518796,Staff,11,0,20,9
1713508867373,MCWP 50R,G00,518797,Staff,10,0,20,10
1713508868400,MMW 12R,A01,514034,Herbst; Matthew,1,0,16,15
1713508868400,MMW 12R,A02,514035,Herbst; Matthew,13,0,16,3
1713508869425,MMW 13R,A01,514037,Staff,0,8,16,16
1713508869425,MMW 13R,A02,514039,Staff,0,7,16,16
1713508871477,SIO 295LS,A00,523233,Staff,15,0,30,15
1713508872504,SIO 295S,A00,523232,Staff,15,0,30,15
1713508873529,SOCI 117,A01,494376,Staff,0,2,5,5
1713508874554,WES 237B,A00,494380,Staff,19,0,20,1
1713508876620,AESE 279B,A00,494370,Wade; Jon P,33,0,33,0
1713508877648,AIP 197,001,627712,Vespa; Emanuel Ignacio,9999,0,9999,0
1713508878683,ANAR 135S,A00,494369,Braswell; Geoffrey E.,0,0,0,0
1713508879714,CAT 124RS,A01,519847,Geibel; William,6,0,20,14
1713508880743,CAT 125RS,A01,515971,Geibel; William,6,0,20,14
1713508881769,CLRE 250,A00,511389,Morris; Sheldon,9996,0,9999,3
1713508882801,CLRE 251,A00,507176,Mehta; Ravindra L.,9996,0,9999,3
1713508882801,CLRE 251,B00,511410,Mehta; Ravindra L.,9998,0,9999,1
1713508883827,CLRE 252,A00,507189,Cuomo; Raphael Eduardo,9998,0,9999,1
1713508884852,CLRE 253,A00,507199,Vaida; Florin,9997,0,9999,2
1713508884852,CLRE 253,B00,507202,Vaida; Florin,9999,0,9999,0
1713508885880,CLRE 259,A00,507211,Patel; Hemal,9996,0,9999,3
1713508886909,CLRE 260,A00,507221,Cuomo; Raphael Eduardo,9999,0,9999,0
1713508887933,CLRE 297,001,507242,Cuomo; Raphael Eduardo,9999,0,9999,0
1713508888965,CSE 191,A00,516875,Minnes Kemp; Mor Mia,9999,0,9999,0
1713508889994,CSS 201S,A01,494383,Staff,35,0,35,0
1713508891018,CSS 202S,A01,494387,Staff,35,0,35,0
1713508892043,EAP 100,A00,516065,Staff,9792,0,9999,207
1713508893072,ECE 45,A01,507414,Staff,37,0,60,23
1713508894096,ECE 100,A01,507416,Baghdadchi; Saharnaz,0,0,20,20
1713508894096,ECE 100,A02,507418,Baghdadchi; Saharnaz,19,0,20,1
1713508895125,ECE 111,A01,507420,Staff,27,0,50,23
1713508896149,ECE 197,001,548057,Sievenpiper; Daniel F.,9998,0,9999,1
1713508897244,EDS 115,A00,507243,Choi; Bailey Miyeon,27,0,28,1
1713508898273,EDS 117,A01,494379,Staff,15,0,25,10
1713508899303,EDS 125,A00,507246,Hopkins; Megan Beth,27,0,30,3
1713508900327,EDS 128A,A01,507264,Fargason; Sharon Gayle,26,0,26,0
1713508901355,EDS 128B,A01,507293,Pappas; Elizabeth,30,0,30,0
1713508902381,EDS 139,A00,507294,Fargason; Sharon Gayle,30,0,30,0
1713508902381,EDS 139,B00,507313,Pappas; Elizabeth,30,0,30,0
1713508903407,EDS 201,A00,507315,Staff,18,0,30,12
1713508904437,EDS 203,A01,507317,Halter; Christopher P.,17,0,30,13
1713508905464,EDS 204R,A01,507319,Halter; Christopher P.,0,1,30,30
1713508905464,EDS 204R,B01,507331,Heinzman; Erica M.,22,0,30,8
1713508906488,EDS 206R,A00,507332,Staff,0,2,30,30
1713508906488,EDS 206R,B00,507343,Staff,23,0,30,7
1713508907512,EDS 250,A00,507344,Hemans; Patricia Ann Benitez,27,0,40,13
1713508908540,EDS 281,A00,507345,Daly; Alan J.,18,0,18,0
1713508909566,EDS 284,A00,507350,Daly; Alan J.,16,0,16,0
1713508910592,EDS 286,A00,507359,Fine; Sarah,18,0,18,0
1713508911621,EDS 289C,A01,507361,Daly; Alan J.,18,0,18,0
1713508912650,EDS 290,A00,507366,Hofstetter; Carolyn,15,0,15,0
1713508913681,LIGM 5A,A00,507421,Fischer-Grunski; Eva K,20,0,20,0
1713508914707,LIGM 5B,A00,507423,Fischer-Grunski; Eva K,20,0,20,0
1713508915737,LIGM 5C,A00,507425,Fischer-Grunski; Eva K,20,0,20,0
1713508916762,LIIT 5AS,A00,507427,Carnelos; Chiara,20,0,20,0
1713508917793,LIIT 5BS,A00,507430,Carnelos; Chiara,20,0,20,0
1713508918819,LIIT 5CS,A00,507432,Carnelos; Chiara,20,0,20,0
1713508919846,LISP 5A,A00,507541,Munoz Sanchez; Alicia,14,0,20,6
1713508920875,LISP 5B,A00,507671,Munoz Sanchez; Alicia,12,0,20,8
1713508921902,LISP 5C,A00,507696,Munoz Sanchez; Alicia,11,0,20,9
1713508922927,MAE 197,001,528363,Boechler; Nicholas Sebastia,9998,0,9999,1
1713508923953,MATH 197,001,523477,Kedlaya; Kiran S.,9999,0,9999,0
1713508923953,MATH 197,002,563811,Zhang; Danna,9998,0,9999,1
1713508924979,MCWP 40R,A00,518780,Staff,13,0,20,7
1713508924979,MCWP 40R,B00,518781,Staff,11,0,20,9
1713508924979,MCWP 40R,C00,518783,Staff,8,0,20,12
1713508926008,MCWP 50R,A00,518791,Staff,7,0,20,13
1713508926008,MCWP 50R,B00,518792,Staff,3,0,20,17
1713508926008,MCWP 50R,C00,518793,Staff,5,0,20,15
1713508926008,MCWP 50R,D00,518794,Staff,0,0,20,20
1713508926008,MCWP 50R,E00,518795,Staff,0,0,20,20
1713508926008,MCWP 50R,F00,518796,Staff,11,0,20,9
1713508926008,MCWP 50R,G00,518797,Staff,10,0,20,10
1713508927033,MMW 12R,A01,514034,Herbst; Matthew,1,0,16,15
1713508927033,MMW 12R,A02,514035,Herbst; Matthew,13,0,16,3
1713508928059,MMW 13R,A01,514037,Staff,0,8,16,16
1713508928059,MMW 13R,A02,514039,Staff,0,7,16,16
1713508930116,SIO 295LS,A00,523233,Staff,15,0,30,15
1713508931142,SIO 295S,A00,523232,Staff,15,0,30,15
1713508932171,SOCI 117,A01,494376,Staff,0,2,5,5
1713508933197,WES 237B,A00,494380,Staff,19,0,20,1
1713508935261,AESE 279B,A00,494370,Wade; Jon P,33,0,33,0
1713508936291,AIP 197,001,627712,Vespa; Emanuel Ignacio,9999,0,9999,0
1713508937315,ANAR 135S,A00,494369,Braswell; Geoffrey E.,0,0,0,0
1713508938340,CAT 124RS,A01,519847,Geibel; William,6,0,20,14
1713508939367,CAT 125RS,A01,515971,Geibel; William,6,0,20,14
1713508940399,CLRE 250,A00,511389,Morris; Sheldon,9996,0,9999,3
1713508941425,CLRE 251,A00,507176,Mehta; Ravindra L.,9996,0,9999,3
1713508941425,CLRE 251,B00,511410,Mehta; Ravindra L.,9998,0,9999,1
1713508942450,CLRE 252,A00,507189,Cuomo; Raphael Eduardo,9998,0,9999,1
1713508943476,CLRE 253,A00,507199,Vaida; Florin,9997,0,9999,2
1713508943476,CLRE 253,B00,507202,Vaida; Florin,9999,0,9999,0
1713508944501,CLRE 259,A00,507211,Patel; Hemal,9996,0,9999,3
1713508945526,CLRE 260,A00,507221,Cuomo; Raphael Eduardo,9999,0,9999,0
1713508946551,CLRE 297,001,507242,Cuomo; Raphael Eduardo,9999,0,9999,0
1713508947576,CSE 191,A00,516875,Minnes Kemp; Mor Mia,9999,0,9999,0
1713508948604,CSS 201S,A01,494383,Staff,35,0,35,0
1713508949631,CSS 202S,A01,494387,Staff,35,0,35,0
1713508950657,EAP 100,A00,516065,Staff,9792,0,9999,207
1713508951682,ECE 45,A01,507414,Staff,37,0,60,23
1713508952708,ECE 100,A01,507416,Baghdadchi; Saharnaz,0,0,20,20
1713508952708,ECE 100,A02,507418,Baghdadchi; Saharnaz,19,0,20,1
1713508953733,ECE 111,A01,507420,Staff,27,0,50,23
1713508954761,ECE 197,001,548057,Sievenpiper; Daniel F.,9998,0,9999,1
1713508955787,EDS 115,A00,507243,Choi; Bailey Miyeon,27,0,28,1
1713508956814,EDS 117,A01,494379,Staff,15,0,25,10
1713508957840,EDS 125,A00,507246,Hopkins; Megan Beth,27,0,30,3
1713508958867,EDS 128A,A01,507264,Fargason; Sharon Gayle,26,0,26,0
1713508959897,EDS 128B,A01,507293,Pappas; Elizabeth,30,0,30,0
1713508960923,EDS 139,A00,507294,Fargason; Sharon Gayle,30,0,30,0
1713508960923,EDS 139,B00,507313,Pappas; Elizabeth,30,0,30,0
1713508961950,EDS 201,A00,507315,Staff,18,0,30,12
1713508962982,EDS 203,A01,507317,Halter; Christopher P.,17,0,30,13
1713508964006,EDS 204R,A01,507319,Halter; Christopher P.,0,1,30,30
1713508964006,EDS 204R,B01,507331,Heinzman; Erica M.,22,0,30,8
1713508965032,EDS 206R,A00,507332,Staff,0,2,30,30
1713508965032,EDS 206R,B00,507343,Staff,23,0,30,7
1713508966061,EDS 250,A00,507344,Hemans; Patricia Ann Benitez,27,0,40,13
1713508967091,EDS 281,A00,507345,Daly; Alan J.,18,0,18,0
1713508968119,EDS 284,A00,507350,Daly; Alan J.,16,0,16,0
1713508969151,EDS 286,A00,507359,Fine; Sarah,18,0,18,0
1713508970176,EDS 289C,A01,507361,Daly; Alan J.,18,0,18,0
1713508971202,EDS 290,A00,507366,Hofstetter; Carolyn,15,0,15,0
1713508972227,LIGM 5A,A00,507421,Fischer-Grunski; Eva K,20,0,20,0
1713508973252,LIGM 5B,A00,507423,Fischer-Grunski; Eva K,20,0,20,0
1713508974277,LIGM 5C,A00,507425,Fischer-Grunski; Eva K,20,0,20,0
1713508975302,LIIT 5AS,A00,507427,Carnelos; Chiara,20,0,20,0
1713508976332,LIIT 5BS,A00,507430,Carnelos; Chiara,20,0,20,0
1713508977357,LIIT 5CS,A00,507432,Carnelos; Chiara,20,0,20,0
1713508978386,LISP 5A,A00,507541,Munoz Sanchez; Alicia,14,0,20,6
1713508979413,LISP 5B,A00,507671,Munoz Sanchez; Alicia,12,0,20,8
1713508980440,LISP 5C,A00,507696,Munoz Sanchez; Alicia,11,0,20,9
1713508981471,MAE 197,001,528363,Boechler; Nicholas Sebastia,9998,0,9999,1
1713508982499,MATH 197,001,523477,Kedlaya; Kiran S.,9999,0,9999,0
1713508982499,MATH 197,002,563811,Zhang; Danna,9998,0,9999,1
1713508983526,MCWP 40R,A00,518780,Staff,13,0,20,7
1713508983526,MCWP 40R,B00,518781,Staff,11,0,20,9
1713508983526,MCWP 40R,C00,518783,Staff,8,0,20,12
1713508984558,MCWP 50R,A00,518791,Staff,7,0,20,13
1713508984558,MCWP 50R,B00,518792,Staff,3,0,20,17
1713508984558,MCWP 50R,C00,518793,Staff,5,0,20,15
1713508984558,MCWP 50R,D00,518794,Staff,0,0,20,20
1713508984558,MCWP 50R,E00,518795,Staff,0,0,20,20
1713508984558,MCWP 50R,F00,518796,Staff,11,0,20,9
1713508984558,MCWP 50R,G00,518797,Staff,10,0,20,10
1713508985587,MMW 12R,A01,514034,Herbst; Matthew,1,0,16,15
1713508985587,MMW 12R,A02,514035,Herbst; Matthew,13,0,16,3
1713508986616,MMW 13R,A01,514037,Staff,0,8,16,16
1713508986616,MMW 13R,A02,514039,Staff,0,7,16,16
1713508988672,SIO 295LS,A00,523233,Staff,15,0,30,15
1713508989703,SIO 295S,A00,523232,Staff,15,0,30,15
1713508990728,SOCI 117,A01,494376,Staff,0,2,5,5
1713508991756,WES 237B,A00,494380,Staff,19,0,20,1
1713508993842,AESE 279B,A00,494370,Wade; Jon P,33,0,33,0
1713508994867,AIP 197,001,627712,Vespa; Emanuel Ignacio,9999,0,9999,0
1713508995892,ANAR 135S,A00,494369,Braswell; Geoffrey E.,0,0,0,0
1713508996917,CAT 124RS,A01,519847,Geibel; William,6,0,20,14
1713508997942,CAT 125RS,A01,515971,Geibel; William,6,0,20,14
1713508998972,CLRE 250,A00,511389,Morris; Sheldon,9996,0,9999,3
1713509000006,CLRE 251,A00,507176,Mehta; Ravindra L.,9996,0,9999,3
1713509000006,CLRE 251,B00,511410,Mehta; Ravindra L.,9998,0,9999,1
1713509001086,CLRE 252,A00,507189,Cuomo; Raphael Eduardo,9998,0,9999,1
1713509002112,CLRE 253,A00,507199,Vaida; Florin,9997,0,9999,2
1713509002112,CLRE 253,B00,507202,Vaida; Florin,9999,0,9999,0
1713509003141,CLRE 259,A00,507211,Patel; Hemal,9996,0,9999,3
1713509004167,CLRE 260,A00,507221,Cuomo; Raphael Eduardo,9999,0,9999,0
1713509005195,CLRE 297,001,507242,Cuomo; Raphael Eduardo,9999,0,9999,0
1713509006221,CSE 191,A00,516875,Minnes Kemp; Mor Mia,9999,0,9999,0
1713509007251,CSS 201S,A01,494383,Staff,35,0,35,0
1713509008277,CSS 202S,A01,494387,Staff,35,0,35,0
1713509009305,EAP 100,A00,516065,Staff,9792,0,9999,207
1713509010333,ECE 45,A01,507414,Staff,37,0,60,23
1713509011359,ECE 100,A01,507416,Baghdadchi; Saharnaz,0,0,20,20
1713509011359,ECE 100,A02,507418,Baghdadchi; Saharnaz,19,0,20,1
1713509012385,ECE 111,A01,507420,Staff,27,0,50,23
1713509013411,ECE 197,001,548057,Sievenpiper; Daniel F.,9998,0,9999,1
1713509014440,EDS 115,A00,507243,Choi; Bailey Miyeon,27,0,28,1
1713509015465,EDS 117,A01,494379,Staff,15,0,25,10
1713509016490,EDS 125,A00,507246,Hopkins; Megan Beth,27,0,30,3
1713509017513,EDS 128A,A01,507264,Fargason; Sharon Gayle,26,0,26,0
1713509018540,EDS 128B,A01,507293,Pappas; Elizabeth,30,0,30,0
1713509019569,EDS 139,A00,507294,Fargason; Sharon Gayle,30,0,30,0
1713509019569,EDS 139,B00,507313,Pappas; Elizabeth,30,0,30,0
1713509020597,EDS 201,A00,507315,Staff,18,0,30,12
1713509021627,EDS 203,A01,507317,Halter; Christopher P.,17,0,30,13
1713509022660,EDS 204R,A01,507319,Halter; Christopher P.,0,1,30,30
1713509022660,EDS 204R,B01,507331,Heinzman; Erica M.,22,0,30,8
1713509023685,EDS 206R,A00,507332,Staff,0,2,30,30
1713509023685,EDS 206R,B00,507343,Staff,23,0,30,7
1713509024714,EDS 250,A00,507344,Hemans; Patricia Ann Benitez,27,0,40,13
1713509025739,EDS 281,A00,507345,Daly; Alan J.,18,0,18,0
1713509026764,EDS 284,A00,507350,Daly; Alan J.,16,0,16,0
1713509027789,EDS 286,A00,507359,Fine; Sarah,18,0,18,0
1713509028814,EDS 289C,A01,507361,Daly; Alan J.,18,0,18,0
1713509029842,EDS 290,A00,507366,Hofstetter; Carolyn,15,0,15,0
1713509030868,LIGM 5A,A00,507421,Fischer-Grunski; Eva K,20,0,20,0
1713509031895,LIGM 5B,A00,507423,Fischer-Grunski; Eva K,20,0,20,0
1713509032921,LIGM 5C,A00,507425,Fischer-Grunski; Eva K,20,0,20,0
1713509033951,LIIT 5AS,A00,507427,Carnelos; Chiara,20,0,20,0
1713509034978,LIIT 5BS,A00,507430,Carnelos; Chiara,20,0,20,0
1713509036005,LIIT 5CS,A00,507432,Carnelos; Chiara,20,0,20,0
1713509037033,LISP 5A,A00,507541,Munoz Sanchez; Alicia,14,0,20,6
1713509038059,LISP 5B,A00,507671,Munoz Sanchez; Alicia,12,0,20,8
1713509039084,LISP 5C,A00,507696,Munoz Sanchez; Alicia,11,0,20,9
1713509040111,MAE 197,001,528363,Boechler; Nicholas Sebastia,9998,0,9999,1
1713509041141,MATH 197,001,523477,Kedlaya; Kiran S.,9999,0,9999,0
1713509041141,MATH 197,002,563811,Zhang; Danna,9998,0,9999,1
1713509042168,MCWP 40R,A00,518780,Staff,13,0,20,7
1713509042168,MCWP 40R,B00,518781,Staff,11,0,20,9
1713509042168,MCWP 40R,C00,518783,Staff,8,0,20,12
1713509043196,MCWP 50R,A00,518791,Staff,7,0,20,13
1713509043196,MCWP 50R,B00,518792,Staff,3,0,20,17
1713509043196,MCWP 50R,C00,518793,Staff,5,0,20,15
1713509043196,MCWP 50R,D00,518794,Staff,0,0,20,20
1713509043196,MCWP 50R,E00,518795,Staff,0,0,20,20
1713509043196,MCWP 50R,F00,518796,Staff,11,0,20,9
1713509043196,MCWP 50R,G00,518797,Staff,10,0,20,10
1713509044221,MMW 12R,A01,514034,Herbst; Matthew,1,0,16,15
1713509044221,MMW 12R,A02,514035,Herbst; Matthew,13,0,16,3
1713509045250,MMW 13R,A01,514037,Staff,0,8,16,16
1713509045250,MMW 13R,A02,514039,Staff,0,7,16,16
1713509047301,SIO 295LS,A00,523233,Staff,15,0,30,15
1713509048328,SIO 295S,A00,523232,Staff,15,0,30,15
1713509049356,SOCI 117,A01,494376,Staff,0,2,5,5
1713509050379,WES 237B,A00,494380,Staff,19,0,20,1
1713509052436,AESE 279B,A00,494370,Wade; Jon P,33,0,33,0
1713509053464,AIP 197,001,627712,Vespa; Emanuel Ignacio,9999,0,9999,0
1713509054494,ANAR 135S,A00,494369,Braswell; Geoffrey E.,0,0,0,0
1713509055521,CAT 124RS,A01,519847,Geibel; William,6,0,20,14
1713509056549,CAT 125RS,A01,515971,Geibel; William,6,0,20,14
1713509057576,CLRE 250,A00,511389,Morris; Sheldon,9996,0,9999,3
1713509058602,CLRE 251,A00,507176,Mehta; Ravindra L.,9996,0,9999,3
1713509058602,CLRE 251,B00,511410,Mehta; Ravindra L.,9998,0,9999,1
1713509059627,CLRE 252,A00,507189,Cuomo; Raphael Eduardo,9998,0,9999,1
1713509060653,CLRE 253,A00,507199,Vaida; Florin,9997,0,9999,2
1713509060653,CLRE 253,B00,507202,Vaida; Florin,9999,0,9999,0
1713509061680,CLRE 259,A00,507211,Patel; Hemal,9996,0,9999,3
1713509062706,CLRE 260,A00,507221,Cuomo; Raphael Eduardo,9999,0,9999,0
1713509063736,CLRE 297,001,507242,Cuomo; Raphael Eduardo,9999,0,9999,0
1713509064762,CSE 191,A00,516875,Minnes Kemp; Mor Mia,9999,0,9999,0
1713509065788,CSS 201S,A01,494383,Staff,35,0,35,0
1713509066812,CSS 202S,A01,494387,Staff,35,0,35,0
1713509067842,EAP 100,A00,516065,Staff,9792,0,9999,207
1713509068869,ECE 45,A01,507414,Staff,37,0,60,23
1713509069899,ECE 100,A01,507416,Baghdadchi; Saharnaz,0,0,20,20
1713509069899,ECE 100,A02,507418,Baghdadchi; Saharnaz,19,0,20,1
1713509070997,ECE 111,A01,507420,Staff,27,0,50,23
1713509072026,ECE 197,001,548057,Sievenpiper; Daniel F.,9998,0,9999,1
1713509073063,EDS 115,A00,507243,Choi; Bailey Miyeon,27,0,28,1
1713509074089,EDS 117,A01,494379,Staff,15,0,25,10
1713509075119,EDS 125,A00,507246,Hopkins; Megan Beth,27,0,30,3
1713509076145,EDS 128A,A01,507264,Fargason; Sharon Gayle,26,0,26,0
1713509077169,EDS 128B,A01,507293,Pappas; Elizabeth,30,0,30,0
1713509078199,EDS 139,A00,507294,Fargason; Sharon Gayle,30,0,30,0
1713509078199,EDS 139,B00,507313,Pappas; Elizabeth,30,0,30,0
1713509079225,EDS 201,A00,507315,Staff,18,0,30,12
1713509080255,EDS 203,A01,507317,Halter; Christopher P.,17,0,30,13
1713509081281,EDS 204R,A01,507319,Halter; Christopher P.,0,1,30,30
1713509081281,EDS 204R,B01,507331,Heinzman; Erica M.,22,0,30,8
1713509082306,EDS 206R,A00,507332,Staff,0,2,30,30
1713509082306,EDS 206R,B00,507343,Staff,23,0,30,7
1713509083331,EDS 250,A00,507344,Hemans; Patricia Ann Benitez,27,0,40,13
1713509084358,EDS 281,A00,507345,Daly; Alan J.,18,0,18,0
1713509085383,EDS 284,A00,507350,Daly; Alan J.,16,0,16,0
1713509086409,EDS 286,A00,507359,Fine; Sarah,18,0,18,0
1713509087446,EDS 289C,A01,507361,Daly; Alan J.,18,0,18,0
1713509088473,EDS 290,A00,507366,Hofstetter; Carolyn,15,0,15,0
1713509089499,LIGM 5A,A00,507421,Fischer-Grunski; Eva K,20,0,20,0
1713509090525,LIGM 5B,A00,507423,Fischer-Grunski; Eva K,20,0,20,0
1713509091555,LIGM 5C,A00,507425,Fischer-Grunski; Eva K,20,0,20,0
1713509092586,LIIT 5AS,A00,507427,Carnelos; Chiara,20,0,20,0
1713509093616,LIIT 5BS,A00,507430,Carnelos; Chiara,20,0,20,0
1713509094646,LIIT 5CS,A00,507432,Carnelos; Chiara,20,0,20,0
1713509095672,LISP 5A,A00,507541,Munoz Sanchez; Alicia,14,0,20,6
1713509096696,LISP 5B,A00,507671,Munoz Sanchez; Alicia,12,0,20,8
1713509097724,LISP 5C,A00,507696,Munoz Sanchez; Alicia,11,0,20,9
1713509098750,MAE 197,001,528363,Boechler; Nicholas Sebastia,9998,0,9999,1
1713509099775,MATH 197,001,523477,Kedlaya; Kiran S.,9999,0,9999,0
1713509099775,MATH 197,002,563811,Zhang; Danna,9998,0,9999,1
1713509100801,MCWP 40R,A00,518780,Staff,13,0,20,7
1713509100801,MCWP 40R,B00,518781,Staff,11,0,20,9
1713509100801,MCWP 40R,C00,518783,Staff,8,0,20,12
1713509101827,MCWP 50R,A00,518791,Staff,7,0,20,13
1713509101827,MCWP 50R,B00,518792,Staff,3,0,20,17
1713509101827,MCWP 50R,C00,518793,Staff,5,0,20,15
1713509101827,MCWP 50R,D00,518794,Staff,0,0,20,20
1713509101827,MCWP 50R,E00,518795,Staff,0,0,20,20
1713509101827,MCWP 50R,F00,518796,Staff,11,0,20,9
1713509101827,MCWP 50R,G00,518797,Staff,10,0,20,10
1713509102856,MMW 12R,A01,514034,Herbst; Matthew,1,0,16,15
1713509102856,MMW 12R,A02,514035,Herbst; Matthew,13,0,16,3
1713509103889,MMW 13R,A01,514037,Staff,0,8,16,16
1713509103889,MMW 13R,A02,514039,Staff,0,7,16,16
1713509105996,SIO 295LS,A00,523233,Staff,15,0,30,15
1713509107020,SIO 295S,A00,523232,Staff,15,0,30,15
1713509108046,SOCI 117,A01,494376,Staff,0,2,5,5
1713509109071,WES 237B,A00,494380,Staff,19,0,20,1
1713509111132,AESE 279B,A00,494370,Wade; Jon P,33,0,33,0
1713509112160,AIP 197,001,627712,Vespa; Emanuel Ignacio,9999,0,9999,0
1713509113186,ANAR 135S,A00,494369,Braswell; Geoffrey E.,0,0,0,0
1713509114211,CAT 124RS,A01,519847,Geibel; William,6,0,20,14
1713509115239,CAT 125RS,A01,515971,Geibel; William,6,0,20,14
1713509116265,CLRE 250,A00,511389,Morris; Sheldon,9996,0,9999,3
1713509117293,CLRE 251,A00,507176,Mehta; Ravindra L.,9996,0,9999,3
1713509117293,CLRE 251,B00,511410,Mehta; Ravindra L.,9998,0,9999,1
1713509118318,CLRE 252,A00,507189,Cuomo; Raphael Eduardo,9998,0,9999,1
1713509119343,CLRE 253,A00,507199,Vaida; Florin,9997,0,9999,2
1713509119343,CLRE 253,B00,507202,Vaida; Florin,9999,0,9999,0
1713509120371,CLRE 259,A00,507211,Patel; Hemal,9996,0,9999,3
1713509121396,CLRE 260,A00,507221,Cuomo; Raphael Eduardo,9999,0,9999,0
1713509122425,CLRE 297,001,507242,Cuomo; Raphael Eduardo,9999,0,9999,0
1713509123450,CSE 191,A00,516875,Minnes Kemp; Mor Mia,9999,0,9999,0
1713509124476,CSS 201S,A01,494383,Staff,35,0,35,0
1713509125505,CSS 202S,A01,494387,Staff,35,0,35,0
1713509126530,EAP 100,A00,516065,Staff,9792,0,9999,207
1713509127556,ECE 45,A01,507414,Staff,37,0,60,23
1713509128588,ECE 100,A01,507416,Baghdadchi; Saharnaz,0,0,20,20
1713509128588,ECE 100,A02,507418,Baghdadchi; Saharnaz,19,0,20,1
1713509129616,ECE 111,A01,507420,Staff,27,0,50,23
1713509130642,ECE 197,001,548057,Sievenpiper; Daniel F.,9998,0,9999,1
1713509131667,EDS 115,A00,507243,Choi; Bailey Miyeon,27,0,28,1
1713509132695,EDS 117,A01,494379,Staff,15,0,25,10
1713509133721,EDS 125,A00,507246,Hopkins; Megan Beth,27,0,30,3
1713509134751,EDS 128A,A01,507264,Fargason; Sharon Gayle,26,0,26,0
1713509135780,EDS 128B,A01,507293,Pappas; Elizabeth,30,0,30,0
1713509136809,EDS 139,A00,507294,Fargason; Sharon Gayle,30,0,30,0
1713509136809,EDS 139,B00,507313,Pappas; Elizabeth,30,0,30,0
1713509137834,EDS 201,A00,507315,Staff,18,0,30,12
1713509138863,EDS 203,A01,507317,Halter; Christopher P.,17,0,30,13
1713509139890,EDS 204R,A01,507319,Halter; Christopher P.,0,1,30,30
1713509139890,EDS 204R,B01,507331,Heinzman; Erica M.,22,0,30,8
1713509140916,EDS 206R,A00,507332,Staff,0,2,30,30
1713509140916,EDS 206R,B00,507343,Staff,23,0,30,7
1713509141941,EDS 250,A00,507344,Hemans; Patricia Ann Benitez,27,0,40,13
1713509142965,EDS 281,A00,507345,Daly; Alan J.,18,0,18,0
1713509143993,EDS 284,A00,507350,Daly; Alan J.,16,0,16,0
1713509145019,EDS 286,A00,507359,Fine; Sarah,18,0,18,0
1713509146045,EDS 289C,A01,507361,Daly; Alan J.,18,0,18,0
1713509147071,EDS 290,A00,507366,Hofstetter; Carolyn,15,0,15,0
1713509148100,LIGM 5A,A00,507421,Fischer-Grunski; Eva K,20,0,20,0
1713509149126,LIGM 5B,A00,507423,Fischer-Grunski; Eva K,20,0,20,0
1713509150151,LIGM 5C,A00,507425,Fischer-Grunski; Eva K,20,0,20,0
1713509151178,LIIT 5AS,A00,507427,Carnelos; Chiara,20,0,20,0
1713509152203,LIIT 5BS,A00,507430,Carnelos; Chiara,20,0,20,0
1713509153228,LIIT 5CS,A00,507432,Carnelos; Chiara,20,0,20,0
1713509154260,LISP 5A,A00,507541,Munoz Sanchez; Alicia,14,0,20,6
1713509155290,LISP 5B,A00,507671,Munoz Sanchez; Alicia,12,0,20,8
1713509156317,LISP 5C,A00,507696,Munoz Sanchez; Alicia,11,0,20,9
1713509157343,MAE 197,001,528363,Boechler; Nicholas Sebastia,9998,0,9999,1
1713509158369,MATH 197,001,523477,Kedlaya; Kiran S.,9999,0,9999,0
1713509158369,MATH 197,002,563811,Zhang; Danna,9998,0,9999,1
1713509159399,MCWP 40R,A00,518780,Staff,13,0,20,7
1713509159399,MCWP 40R,B00,518781,Staff,11,0,20,9
1713509159399,MCWP 40R,C00,518783,Staff,8,0,20,12
1713509160431,MCWP 50R,A00,518791,Staff,7,0,20,13
1713509160431,MCWP 50R,B00,518792,Staff,3,0,20,17
1713509160431,MCWP 50R,C00,518793,Staff,5,0,20,15
1713509160431,MCWP 50R,D00,518794,Staff,0,0,20,20
1713509160431,MCWP 50R,E00,518795,Staff,0,0,20,20
1713509160431,MCWP 50R,F00,518796,Staff,11,0,20,9
1713509160431,MCWP 50R,G00,518797,Staff,10,0,20,10
1713509161457,MMW 12R,A01,514034,Herbst; Matthew,1,0,16,15
1713509161457,MMW 12R,A02,514035,Herbst; Matthew,13,0,16,3
1713509162486,MMW 13R,A01,514037,Staff,0,8,16,16
1713509162486,MMW 13R,A02,514039,Staff,0,7,16,16
1713509164543,SIO 295LS,A00,523233,Staff,15,0,30,15
1713509165569,SIO 295S,A00,523232,Staff,15,0,30,15
1713509166594,SOCI 117,A01,494376,Staff,0,2,5,5
1713509167619,WES 237B,A00,494380,Staff,19,0,20,1
1713509169685,AESE 279B,A00,494370,Wade; Jon P,33,0,33,0
1713509170711,AIP 197,001,627712,Vespa; Emanuel Ignacio,9999,0,9999,0
1713509171736,ANAR 135S,A00,494369,Braswell; Geoffrey E.,0,0,0,0
1713509172761,CAT 124RS,A01,519847,Geibel; William,6,0,20,14
1713509173787,CAT 125RS,A01,515971,Geibel; William,6,0,20,14
1713509174815,CLRE 250,A00,511389,Morris; Sheldon,9996,0,9999,3
1713509175844,CLRE 251,A00,507176,Mehta; Ravindra L.,9996,0,9999,3
1713509175844,CLRE 251,B00,511410,Mehta; Ravindra L.,9998,0,9999,1
1713509176875,CLRE 252,A00,507189,Cuomo; Raphael Eduardo,9998,0,9999,1
1713509177900,CLRE 253,A00,507199,Vaida; Florin,9997,0,9999,2
1713509177900,CLRE 253,B00,507202,Vaida; Florin,9999,0,9999,0
1713509178930,CLRE 259,A00,507211,Patel; Hemal,9996,0,9999,3
1713509179955,CLRE 260,A00,507221,Cuomo; Raphael Eduardo,9999,0,9999,0
1713509180987,CLRE 297,001,507242,Cuomo; Raphael Eduardo,9999,0,9999,0
1713509182012,CSE 191,A00,516875,Minnes Kemp; Mor Mia,9999,0,9999,0
1713509183038,CSS 201S,A01,494383,Staff,35,0,35,0
1713509184064,CSS 202S,A01,494387,Staff,35,0,35,0
1713509185094,EAP 100,A00,516065,Staff,9792,0,9999,207
1713509186119,ECE 45,A01,507414,Staff,37,0,60,23
1713509187152,ECE 100,A01,507416,Baghdadchi; Saharnaz,0,0,20,20
1713509187152,ECE 100,A02,507418,Baghdadchi; Saharnaz,19,0,20,1
1713509188180,ECE 111,A01,507420,Staff,27,0,50,23
1713509189205,ECE 197,001,548057,Sievenpiper; Daniel F.,9998,0,9999,1
1713509190236,EDS 115,A00,507243,Choi; Bailey Miyeon,27,0,28,1
1713509191264,EDS 117,A01,494379,Staff,15,0,25,10
1713509192292,EDS 125,A00,507246,Hopkins; Megan Beth,27,0,30,3
1713509193318,EDS 128A,A01,507264,Fargason; Sharon Gayle,26,0,26,0
1713509194343,EDS 128B,A01,507293,Pappas; Elizabeth,30,0,30,0
1713509195367,EDS 139,A00,507294,Fargason; Sharon Gayle,30,0,30,0
1713509195367,EDS 139,B00,507313,Pappas; Elizabeth,30,0,30,0
1713509196394,EDS 201,A00,507315,Staff,18,0,30,12
1713509197419,EDS 203,A01,507317,Halter; Christopher P.,17,0,30,13
1713509198450,EDS 204R,A01,507319,Halter; Christopher P.,0,1,30,30
1713509198450,EDS 204R,B01,507331,Heinzman; Erica M.,22,0,30,8
1713509199475,EDS 206R,A00,507332,Staff,0,2,30,30
1713509199475,EDS 206R,B00,507343,Staff,23,0,30,7
1713509200502,EDS 250,A00,507344,Hemans; Patricia Ann Benitez,27,0,40,13
1713509201530,EDS 281,A00,507345,Daly; Alan J.,18,0,18,0
1713509202556,EDS 284,A00,507350,Daly; Alan J.,16,0,16,0
1713509203582,EDS 286,A00,507359,Fine; Sarah,18,0,18,0
1713509204609,EDS 289C,A01,507361,Daly; Alan J.,18,0,18,0
1713509205634,EDS 290,A00,507366,Hofstetter; Carolyn,15,0,15,0
1713509206659,LIGM 5A,A00,507421,Fischer-Grunski; Eva K,20,0,20,0
1713509207684,LIGM 5B,A00,507423,Fischer-Grunski; Eva K,20,0,20,0
1713509208763,LIGM 5C,A00,507425,Fischer-Grunski; Eva K,20,0,20,0
1713509209790,LIIT 5AS,A00,507427,Carnelos; Chiara,20,0,20,0
1713509210815,LIIT 5BS,A00,507430,Carnelos; Chiara,20,0,20,0
1713509211840,LIIT 5CS,A00,507432,Carnelos; Chiara,20,0,20,0
1713509212870,LISP 5A,A00,507541,Munoz Sanchez; Alicia,14,0,20,6
1713509213897,LISP 5B,A00,507671,Munoz Sanchez; Alicia,12,0,20,8
1713509214923,LISP 5C,A00,507696,Munoz Sanchez; Alicia,11,0,20,9
1713509215951,MAE 197,001,528363,Boechler; Nicholas Sebastia,9998,0,9999,1
1713509216980,MATH 197,001,523477,Kedlaya; Kiran S.,9999,0,9999,0
1713509216980,MATH 197,002,563811,Zhang; Danna,9998,0,9999,1
1713509218004,MCWP 40R,A00,518780,Staff,13,0,20,7
1713509218004,MCWP 40R,B00,518781,Staff,11,0,20,9
1713509218004,MCWP 40R,C00,518783,Staff,8,0,20,12
1713509219030,MCWP 50R,A00,518791,Staff,7,0,20,13
1713509219030,MCWP 50R,B00,518792,Staff,3,0,20,17
1713509219030,MCWP 50R,C00,518793,Staff,5,0,20,15
1713509219030,MCWP 50R,D00,518794,Staff,0,0,20,20
1713509219030,MCWP 50R,E00,518795,Staff,0,0,20,20
1713509219030,MCWP 50R,F00,518796,Staff,11,0,20,9
1713509219030,MCWP 50R,G00,518797,Staff,10,0,20,10
1713509220061,MMW 12R,A01,514034,Herbst; Matthew,1,0,16,15
1713509220061,MMW 12R,A02,514035,Herbst; Matthew,13,0,16,3
1713509221087,MMW 13R,A01,514037,Staff,0,8,16,16
1713509221087,MMW 13R,A02,514039,Staff,0,7,16,16
1713509223141,SIO 295LS,A00,523233,Staff,15,0,30,15
1713509224166,SIO 295S,A00,523232,Staff,15,0,30,15
1713509225192,SOCI 117,A01,494376,Staff,0,2,5,5
1713509226219,WES 237B,A00,494380,Staff,19,0,20,1
1713509228293,AESE 279B,A00,494370,Wade; Jon P,33,0,33,0
1713509229322,AIP 197,001,627712,Vespa; Emanuel Ignacio,9999,0,9999,0
1713509230351,ANAR 135S,A00,494369,Braswell; Geoffrey E.,0,0,0,0
1713509231377,CAT 124RS,A01,519847,Geibel; William,6,0,20,14
1713509232406,CAT 125RS,A01,515971,Geibel; William,6,0,20,14
1713509233431,CLRE 250,A00,511389,Morris; Sheldon,9996,0,9999,3
1713509234457,CLRE 251,A00,507176,Mehta; Ravindra L.,9996,0,9999,3
1713509234457,CLRE 251,B00,511410,Mehta; Ravindra L.,9998,0,9999,1
1713509235483,CLRE 252,A00,507189,Cuomo; Raphael Eduardo,9998,0,9999,1
1713509236510,CLRE 253,A00,507199,Vaida; Florin,9997,0,9999,2
1713509236510,CLRE 253,B00,507202,Vaida; Florin,9999,0,9999,0
1713509237536,CLRE 259,A00,507211,Patel; Hemal,9996,0,9999,3
1713509238561,CLRE 260,A00,507221,Cuomo; Raphael Eduardo,9999,0,9999,0
1713509239585,CLRE 297,001,507242,Cuomo; Raphael Eduardo,9999,0,9999,0
1713509240612,CSE 191,A00,516875,Minnes Kemp; Mor Mia,9999,0,9999,0
1713509241639,CSS 201S,A01,494383,Staff,35,0,35,0
1713509242666,CSS 202S,A01,494387,Staff,35,0,35,0
1713509243692,EAP 100,A00,516065,Staff,9792,0,9999,207
1713509244722,ECE 45,A01,507414,Staff,37,0,60,23
1713509245748,ECE 100,A01,507416,Baghdadchi; Saharnaz,0,0,20,20
1713509245748,ECE 100,A02,507418,Baghdadchi; Saharnaz,19,0,20,1
1713509246773,ECE 111,A01,507420,Staff,27,0,50,23
1713509247801,ECE 197,001,548057,Sievenpiper; Daniel F.,9998,0,9999,1
1713509248827,EDS 115,A00,507243,Choi; Bailey Miyeon,27,0,28,1
1713509249852,EDS 117,A01,494379,Staff,15,0,25,10
1713509250882,EDS 125,A00,507246,Hopkins; Megan Beth,27,0,30,3
1713509251911,EDS 128A,A01,507264,Fargason; Sharon Gayle,26,0,26,0
1713509252936,EDS 128B,A01,507293,Pappas; Elizabeth,30,0,30,0
1713509253961,EDS 139,A00,507294,Fargason; Sharon Gayle,30,0,30,0
1713509253961,EDS 139,B00,507313,Pappas; Elizabeth,30,0,30,0
1713509254990,EDS 201,A00,507315,Staff,18,0,30,12
1713509256015,EDS 203,A01,507317,Halter; Christopher P.,17,0,30,13
1713509257042,EDS 204R,A01,507319,Halter; Christopher P.,0,1,30,30
1713509257042,EDS 204R,B01,507331,Heinzman; Erica M.,22,0,30,8
1713509258066,EDS 206R,A00,507332,Staff,0,2,30,30
1713509258066,EDS 206R,B00,507343,Staff,23,0,30,7
1713509259091,EDS 250,A00,507344,Hemans; Patricia Ann Benitez,27,0,40,13
1713509260123,EDS 281,A00,507345,Daly; Alan J.,18,0,18,0
1713509261148,EDS 284,A00,507350,Daly; Alan J.,16,0,16,0
1713509262179,EDS 286,A00,507359,Fine; Sarah,18,0,18,0
1713509263205,EDS 289C,A01,507361,Daly; Alan J.,18,0,18,0
1713509264233,EDS 290,A00,507366,Hofstetter; Carolyn,15,0,15,0
1713509265263,LIGM 5A,A00,507421,Fischer-Grunski; Eva K,20,0,20,0
1713509266289,LIGM 5B,A00,507423,Fischer-Grunski; Eva K,20,0,20,0
1713509267317,LIGM 5C,A00,507425,Fischer-Grunski; Eva K,20,0,20,0
1713509268343,LIIT 5AS,A00,507427,Carnelos; Chiara,20,0,20,0
1713509269367,LIIT 5BS,A00,507430,Carnelos; Chiara,20,0,20,0
1713509270393,LIIT 5CS,A00,507432,Carnelos; Chiara,20,0,20,0
1713509271419,LISP 5A,A00,507541,Munoz Sanchez; Alicia,14,0,20,6
1713509272449,LISP 5B,A00,507671,Munoz Sanchez; Alicia,12,0,20,8
1713509273474,LISP 5C,A00,507696,Munoz Sanchez; Alicia,11,0,20,9
1713509274500,MAE 197,001,528363,Boechler; Nicholas Sebastia,9998,0,9999,1
1713509275530,MATH 197,001,523477,Kedlaya; Kiran S.,9999,0,9999,0
1713509275530,MATH 197,002,563811,Zhang; Danna,9998,0,9999,1
1713509276555,MCWP 40R,A00,518780,Staff,13,0,20,7
1713509276555,MCWP 40R,B00,518781,Staff,11,0,20,9
1713509276555,MCWP 40R,C00,518783,Staff,8,0,20,12
1713509277581,MCWP 50R,A00,518791,Staff,7,0,20,13
1713509277581,MCWP 50R,B00,518792,Staff,3,0,20,17
1713509277581,MCWP 50R,C00,518793,Staff,5,0,20,15
1713509277581,MCWP 50R,D00,518794,Staff,0,0,20,20
1713509277581,MCWP 50R,E00,518795,Staff,0,0,20,20
1713509277581,MCWP 50R,F00,518796,Staff,11,0,20,9
1713509277581,MCWP 50R,G00,518797,Staff,10,0,20,10
1713509278610,MMW 12R,A01,514034,Herbst; Matthew,1,0,16,15
1713509278610,MMW 12R,A02,514035,Herbst; Matthew,13,0,16,3
1713509279640,MMW 13R,A01,514037,Staff,0,8,16,16
1713509279640,MMW 13R,A02,514039,Staff,0,7,16,16
1713509281695,SIO 295LS,A00,523233,Staff,15,0,30,15
1713509282728,SIO 295S,A00,523232,Staff,15,0,30,15
1713509283753,SOCI 117,A01,494376,Staff,0,2,5,5
1713509284778,WES 237B,A00,494380,Staff,19,0,20,1
1713509286846,AESE 279B,A00,494370,Wade; Jon P,33,0,33,0
1713509287876,AIP 197,001,627712,Vespa; Emanuel Ignacio,9999,0,9999,0
1713509288900,ANAR 135S,A00,494369,Braswell; Geoffrey E.,0,0,0,0
1713509289929,CAT 124RS,A01,519847,Geibel; William,6,0,20,14
1713509290954,CAT 125RS,A01,515971,Geibel; William,6,0,20,14
1713509291980,CLRE 250,A00,511389,Morris; Sheldon,9996,0,9999,3
1713509293007,CLRE 251,A00,507176,Mehta; Ravindra L.,9996,0,9999,3
1713509293007,CLRE 251,B00,511410,Mehta; Ravindra L.,9998,0,9999,1
1713509294032,CLRE 252,A00,507189,Cuomo; Raphael Eduardo,9998,0,9999,1
1713509295058,CLRE 253,A00,507199,Vaida; Florin,9997,0,9999,2
1713509295058,CLRE 253,B00,507202,Vaida; Florin,9999,0,9999,0
1713509296086,CLRE 259,A00,507211,Patel; Hemal,9996,0,9999,3
1713509297113,CLRE 260,A00,507221,Cuomo; Raphael Eduardo,9999,0,9999,0
1713509298137,CLRE 297,001,507242,Cuomo; Raphael Eduardo,9999,0,9999,0
1713509299163,CSE 191,A00,516875,Minnes Kemp; Mor Mia,9999,0,9999,0
1713509300191,CSS 201S,A01,494383,Staff,35,0,35,0
1713509301219,CSS 202S,A01,494387,Staff,35,0,35,0
1713509302244,EAP 100,A00,516065,Staff,9792,0,9999,207
1713509303273,ECE 45,A01,507414,Staff,37,0,60,23
1713509304302,ECE 100,A01,507416,Baghdadchi; Saharnaz,0,0,20,20
1713509304302,ECE 100,A02,507418,Baghdadchi; Saharnaz,19,0,20,1
1713509305330,ECE 111,A01,507420,Staff,27,0,50,23
1713509306360,ECE 197,001,548057,Sievenpiper; Daniel F.,9998,0,9999,1
1713509307385,EDS 115,A00,507243,Choi; Bailey Miyeon,27,0,28,1
1713509308410,EDS 117,A01,494379,Staff,15,0,25,10
1713509309435,EDS 125,A00,507246,Hopkins; Megan Beth,27,0,30,3
1713509310462,EDS 128A,A01,507264,Fargason; Sharon Gayle,26,0,26,0
1713509311487,EDS 128B,A01,507293,Pappas; Elizabeth,30,0,30,0
1713509312567,EDS 139,A00,507294,Fargason; Sharon Gayle,30,0,30,0
1713509312567,EDS 139,B00,507313,Pappas; Elizabeth,30,0,30,0
1713509313596,EDS 201,A00,507315,Staff,18,0,30,12
1713509314622,EDS 203,A01,507317,Halter; Christopher P.,17,0,30,13
1713509315649,EDS 204R,A01,507319,Halter; Christopher P.,0,1,30,30
1713509315649,EDS 204R,B01,507331,Heinzman; Erica M.,22,0,30,8
1713509316674,EDS 206R,A00,507332,Staff,0,2,30,30
1713509316674,EDS 206R,B00,507343,Staff,23,0,30,7
1713509317701,EDS 250,A00,507344,Hemans; Patricia Ann Benitez,27,0,40,13
1713509318726,EDS 281,A00,507345,Daly; Alan J.,18,0,18,0
1713509319751,EDS 284,A00,507350,Daly; Alan J.,16,0,16,0
1713509320776,EDS 286,A00,507359,Fine; Sarah,18,0,18,0
1713509321802,EDS 289C,A01,507361,Daly; Alan J.,18,0,18,0
1713509322828,EDS 290,A00,507366,Hofstetter; Carolyn,15,0,15,0
1713509323855,LIGM 5A,A00,507421,Fischer-Grunski; Eva K,20,0,20,0
1713509324881,LIGM 5B,A00,507423,Fischer-Grunski; Eva K,20,0,20,0
1713509325942,LIGM 5C,A00,507425,Fischer-Grunski; Eva K,20,0,20,0
1713509326969,LIIT 5AS,A00,507427,Carnelos; Chiara,20,0,20,0
1713509327995,LIIT 5BS,A00,507430,Carnelos; Chiara,20,0,20,0
1713509329024,LIIT 5CS,A00,507432,Carnelos; Chiara,20,0,20,0
1713509330059,LISP 5A,A00,507541,Munoz Sanchez; Alicia,14,0,20,6
1713509331088,LISP 5B,A00,507671,Munoz Sanchez; Alicia,12,0,20,8
1713509332113,LISP 5C,A00,507696,Munoz Sanchez; Alicia,11,0,20,9
1713509333143,MAE 197,001,528363,Boechler; Nicholas Sebastia,9998,0,9999,1
1713509334171,MATH 197,001,523477,Kedlaya; Kiran S.,9999,0,9999,0
1713509334171,MATH 197,002,563811,Zhang; Danna,9998,0,9999,1
1713509335196,MCWP 40R,A00,518780,Staff,13,0,20,7
1713509335196,MCWP 40R,B00,518781,Staff,11,0,20,9
1713509335196,MCWP 40R,C00,518783,Staff,8,0,20,12
1713509336228,MCWP 50R,A00,518791,Staff,7,0,20,13
1713509336228,MCWP 50R,B00,518792,Staff,3,0,20,17
1713509336228,MCWP 50R,C00,518793,Staff,5,0,20,15
1713509336228,MCWP 50R,D00,518794,Staff,0,0,20,20
1713509336228,MCWP 50R,E00,518795,Staff,0,0,20,20
1713509336228,MCWP 50R,F00,518796,Staff,11,0,20,9
1713509336228,MCWP 50R,G00,518797,Staff,10,0,20,10
1713509337255,MMW 12R,A01,514034,Herbst; Matthew,1,0,16,15
1713509337255,MMW 12R,A02,514035,Herbst; Matthew,13,0,16,3
1713509338283,MMW 13R,A01,514037,Staff,0,8,16,16
1713509338283,MMW 13R,A02,514039,Staff,0,7,16,16
1713509340349,SIO 295LS,A00,523233,Staff,15,0,30,15
1713509341373,SIO 295S,A00,523232,Staff,15,0,30,15
1713509342400,SOCI 117,A01,494376,Staff,0,2,5,5
1713509343428,WES 237B,A00,494380,Staff,19,0,20,1
1713509345499,AESE 279B,A00,494370,Wade; Jon P,33,0,33,0
1713509346525,AIP 197,001,627712,Vespa; Emanuel Ignacio,9999,0,9999,0
1713509347551,ANAR 135S,A00,494369,Braswell; Geoffrey E.,0,0,0,0
1713509348578,CAT 124RS,A01,519847,Geibel; William,6,0,20,14
1713509349603,CAT 125RS,A01,515971,Geibel; William,6,0,20,14
1713509350630,CLRE 250,A00,511389,Morris; Sheldon,9996,0,9999,3
1713509351657,CLRE 251,A00,507176,Mehta; Ravindra L.,9996,0,9999,3
1713509351657,CLRE 251,B00,511410,Mehta; Ravindra L.,9998,0,9999,1
1713509352686,CLRE 252,A00,507189,Cuomo; Raphael Eduardo,9998,0,9999,1
1713509353712,CLRE 253,A00,507199,Vaida; Florin,9997,0,9999,2
1713509353712,CLRE 253,B00,507202,Vaida; Florin,9999,0,9999,0
1713509354738,CLRE 259,A00,507211,Patel; Hemal,9996,0,9999,3
1713509355766,CLRE 260,A00,507221,Cuomo; Raphael Eduardo,9999,0,9999,0
1713509356795,CLRE 297,001,507242,Cuomo; Raphael Eduardo,9999,0,9999,0
1713509357830,CSE 191,A00,516875,Minnes Kemp; Mor Mia,9999,0,9999,0
1713509358856,CSS 201S,A01,494383,Staff,35,0,35,0
1713509359881,CSS 202S,A01,494387,Staff,35,0,35,0
1713509360906,EAP 100,A00,516065,Staff,9792,0,9999,207
1713509361930,ECE 45,A01,507414,Staff,37,0,60,23
1713509362956,ECE 100,A01,507416,Baghdadchi; Saharnaz,0,0,20,20
1713509362956,ECE 100,A02,507418,Baghdadchi; Saharnaz,19,0,20,1
1713509363983,ECE 111,A01,507420,Staff,27,0,50,23
1713509365013,ECE 197,001,548057,Sievenpiper; Daniel F.,9998,0,9999,1
1713509366038,EDS 115,A00,507243,Choi; Bailey Miyeon,27,0,28,1
1713509367069,EDS 117,A01,494379,Staff,15,0,25,10
1713509368123,EDS 125,A00,507246,Hopkins; Megan Beth,27,0,30,3
1713509369149,EDS 128A,A01,507264,Fargason; Sharon Gayle,26,0,26,0
1713509370178,EDS 128B,A01,507293,Pappas; Elizabeth,30,0,30,0
1713509371204,EDS 139,A00,507294,Fargason; Sharon Gayle,30,0,30,0
1713509371204,EDS 139,B00,507313,Pappas; Elizabeth,30,0,30,0
1713509372231,EDS 201,A00,507315,Staff,18,0,30,12
1713509373257,EDS 203,A01,507317,Halter; Christopher P.,17,0,30,13
1713509374283,EDS 204R,A01,507319,Halter; Christopher P.,0,1,30,30
1713509374283,EDS 204R,B01,507331,Heinzman; Erica M.,22,0,30,8
1713509375308,EDS 206R,A00,507332,Staff,0,2,30,30
1713509375308,EDS 206R,B00,507343,Staff,23,0,30,7
1713509376334,EDS 250,A00,507344,Hemans; Patricia Ann Benitez,27,0,40,13
1713509377357,EDS 281,A00,507345,Daly; Alan J.,18,0,18,0
1713509378387,EDS 284,A00,507350,Daly; Alan J.,16,0,16,0
1713509379413,EDS 286,A00,507359,Fine; Sarah,18,0,18,0
1713509380439,EDS 289C,A01,507361,Daly; Alan J.,18,0,18,0
1713509381468,EDS 290,A00,507366,Hofstetter; Carolyn,15,0,15,0
1713509382494,LIGM 5A,A00,507421,Fischer-Grunski; Eva K,20,0,20,0
1713509383521,LIGM 5B,A00,507423,Fischer-Grunski; Eva K,20,0,20,0
1713509384547,LIGM 5C,A00,507425,Fischer-Grunski; Eva K,20,0,20,0
1713509385573,LIIT 5AS,A00,507427,Carnelos; Chiara,20,0,20,0
1713509386602,LIIT 5BS,A00,507430,Carnelos; Chiara,20,0,20,0
1713509387627,LIIT 5CS,A00,507432,Carnelos; Chiara,20,0,20,0
1713509388653,LISP 5A,A00,507541,Munoz Sanchez; Alicia,14,0,20,6
1713509389677,LISP 5B,A00,507671,Munoz Sanchez; Alicia,12,0,20,8
1713509390704,LISP 5C,A00,507696,Munoz Sanchez; Alicia,11,0,20,9
1713509391730,MAE 197,001,528363,Boechler; Nicholas Sebastia,9998,0,9999,1
1713509392755,MATH 197,001,523477,Kedlaya; Kiran S.,9999,0,9999,0
1713509392755,MATH 197,002,563811,Zhang; Danna,9998,0,9999,1
1713509393784,MCWP 40R,A00,518780,Staff,13,0,20,7
1713509393784,MCWP 40R,B00,518781,Staff,11,0,20,9
1713509393784,MCWP 40R,C00,518783,Staff,8,0,20,12
1713509394814,MCWP 50R,A00,518791,Staff,7,0,20,13
1713509394814,MCWP 50R,B00,518792,Staff,3,0,20,17
1713509394814,MCWP 50R,C00,518793,Staff,5,0,20,15
1713509394814,MCWP 50R,D00,518794,Staff,0,0,20,20
1713509394814,MCWP 50R,E00,518795,Staff,0,0,20,20
1713509394814,MCWP 50R,F00,518796,Staff,11,0,20,9
1713509394814,MCWP 50R,G00,518797,Staff,10,0,20,10
1713509395844,MMW 12R,A01,514034,Herbst; Matthew,1,0,16,15
1713509395844,MMW 12R,A02,514035,Herbst; Matthew,13,0,16,3
1713509396869,MMW 13R,A01,514037,Staff,0,8,16,16
1713509396869,MMW 13R,A02,514039,Staff,0,7,16,16
1713509398920,SIO 295LS,A00,523233,Staff,15,0,30,15
1713509399945,SIO 295S,A00,523232,Staff,15,0,30,15
1713509400974,SOCI 117,A01,494376,Staff,0,2,5,5
1713509402000,WES 237B,A00,494380,Staff,19,0,20,1
1713509404079,AESE 279B,A00,494370,Wade; Jon P,33,0,33,0
1713509405105,AIP 197,001,627712,Vespa; Emanuel Ignacio,9999,0,9999,0
1713509406131,ANAR 135S,A00,494369,Braswell; Geoffrey E.,0,0,0,0
1713509407156,CAT 124RS,A01,519847,Geibel; William,6,0,20,14
1713509408185,CAT 125RS,A01,515971,Geibel; William,6,0,20,14
1713509409213,CLRE 250,A00,511389,Morris; Sheldon,9996,0,9999,3
1713509410240,CLRE 251,A00,507176,Mehta; Ravindra L.,9996,0,9999,3
1713509410240,CLRE 251,B00,511410,Mehta; Ravindra L.,9998,0,9999,1
1713509411269,CLRE 252,A00,507189,Cuomo; Raphael Eduardo,9998,0,9999,1
1713509412296,CLRE 253,A00,507199,Vaida; Florin,9997,0,9999,2
1713509412296,CLRE 253,B00,507202,Vaida; Florin,9999,0,9999,0
1713509413320,CLRE 259,A00,507211,Patel; Hemal,9996,0,9999,3
1713509414349,CLRE 260,A00,507221,Cuomo; Raphael Eduardo,9999,0,9999,0
1713509415377,CLRE 297,001,507242,Cuomo; Raphael Eduardo,9999,0,9999,0
1713509416455,CSE 191,A00,516875,Minnes Kemp; Mor Mia,9999,0,9999,0
1713509417486,CSS 201S,A01,494383,Staff,35,0,35,0
1713509418511,CSS 202S,A01,494387,Staff,35,0,35,0
1713509419537,EAP 100,A00,516065,Staff,9792,0,9999,207
1713509420562,ECE 45,A01,507414,Staff,37,0,60,23
1713509421589,ECE 100,A01,507416,Baghdadchi; Saharnaz,0,0,20,20
1713509421589,ECE 100,A02,507418,Baghdadchi; Saharnaz,19,0,20,1
1713509422614,ECE 111,A01,507420,Staff,27,0,50,23
1713509423639,ECE 197,001,548057,Sievenpiper; Daniel F.,9998,0,9999,1
1713509424664,EDS 115,A00,507243,Choi; Bailey Miyeon,27,0,28,1
1713509425690,EDS 117,A01,494379,Staff,15,0,25,10
1713509426716,EDS 125,A00,507246,Hopkins; Megan Beth,27,0,30,3
1713509427742,EDS 128A,A01,507264,Fargason; Sharon Gayle,26,0,26,0
1713509428768,EDS 128B,A01,507293,Pappas; Elizabeth,30,0,30,0
1713509429792,EDS 139,A00,507294,Fargason; Sharon Gayle,30,0,30,0
1713509429792,EDS 139,B00,507313,Pappas; Elizabeth,30,0,30,0
1713509430818,EDS 201,A00,507315,Staff,18,0,30,12
1713509431847,EDS 203,A01,507317,Halter; Christopher P.,17,0,30,13
1713509432873,EDS 204R,A01,507319,Halter; Christopher P.,0,1,30,30
1713509432873,EDS 204R,B01,507331,Heinzman; Erica M.,22,0,30,8
1713509433898,EDS 206R,A00,507332,Staff,0,2,30,30
1713509433898,EDS 206R,B00,507343,Staff,23,0,30,7
1713509434930,EDS 250,A00,507344,Hemans; Patricia Ann Benitez,27,0,40,13
1713509435955,EDS 281,A00,507345,Daly; Alan J.,18,0,18,0
1713509436984,EDS 284,A00,507350,Daly; Alan J.,16,0,16,0
1713509438010,EDS 286,A00,507359,Fine; Sarah,18,0,18,0
1713509439035,EDS 289C,A01,507361,Daly; Alan J.,18,0,18,0
1713509440061,EDS 290,A00,507366,Hofstetter; Carolyn,15,0,15,0
1713509441088,LIGM 5A,A00,507421,Fischer-Grunski; Eva K,20,0,20,0
1713509442118,LIGM 5B,A00,507423,Fischer-Grunski; Eva K,20,0,20,0
1713509443144,LIGM 5C,A00,507425,Fischer-Grunski; Eva K,20,0,20,0
1713509444169,LIIT 5AS,A00,507427,Carnelos; Chiara,20,0,20,0
1713509445198,LIIT 5BS,A00,507430,Carnelos; Chiara,20,0,20,0
1713509446230,LIIT 5CS,A00,507432,Carnelos; Chiara,20,0,20,0
1713509447263,LISP 5A,A00,507541,Munoz Sanchez; Alicia,14,0,20,6
1713509448289,LISP 5B,A00,507671,Munoz Sanchez; Alicia,12,0,20,8
1713509449315,LISP 5C,A00,507696,Munoz Sanchez; Alicia,11,0,20,9
1713509450346,MAE 197,001,528363,Boechler; Nicholas Sebastia,9998,0,9999,1
1713509451372,MATH 197,001,523477,Kedlaya; Kiran S.,9999,0,9999,0
1713509451372,MATH 197,002,563811,Zhang; Danna,9998,0,9999,1
1713509452400,MCWP 40R,A00,518780,Staff,13,0,20,7
1713509452400,MCWP 40R,B00,518781,Staff,11,0,20,9
1713509452400,MCWP 40R,C00,518783,Staff,8,0,20,12
1713509453427,MCWP 50R,A00,518791,Staff,7,0,20,13
1713509453427,MCWP 50R,B00,518792,Staff,3,0,20,17
1713509453427,MCWP 50R,C00,518793,Staff,5,0,20,15
1713509453427,MCWP 50R,D00,518794,Staff,0,0,20,20
1713509453427,MCWP 50R,E00,518795,Staff,0,0,20,20
1713509453427,MCWP 50R,F00,518796,Staff,11,0,20,9
1713509453427,MCWP 50R,G00,518797,Staff,10,0,20,10
1713509454454,MMW 12R,A01,514034,Herbst; Matthew,1,0,16,15
1713509454454,MMW 12R,A02,514035,Herbst; Matthew,13,0,16,3
1713509455478,MMW 13R,A01,514037,Staff,0,8,16,16
1713509455478,MMW 13R,A02,514039,Staff,0,7,16,16
1713509457530,SIO 295LS,A00,523233,Staff,15,0,30,15
1713509458562,SIO 295S,A00,523232,Staff,15,0,30,15
1713509459592,SOCI 117,A01,494376,Staff,0,2,5,5
1713509460617,WES 237B,A00,494380,Staff,19,0,20,1
1713509462692,AESE 279B,A00,494370,Wade; Jon P,33,0,33,0
1713509463717,AIP 197,001,627712,Vespa; Emanuel Ignacio,9999,0,9999,0
1713509464742,ANAR 135S,A00,494369,Braswell; Geoffrey E.,0,0,0,0
1713509465772,CAT 124RS,A01,519847,Geibel; William,6,0,20,14
1713509466797,CAT 125RS,A01,515971,Geibel; William,6,0,20,14
1713509467826,CLRE 250,A00,511389,Morris; Sheldon,9996,0,9999,3
1713509468858,CLRE 251,A00,507176,Mehta; Ravindra L.,9996,0,9999,3
1713509468858,CLRE 251,B00,511410,Mehta; Ravindra L.,9998,0,9999,1
1713509469883,CLRE 252,A00,507189,Cuomo; Raphael Eduardo,9998,0,9999,1
1713509470914,CLRE 253,A00,507199,Vaida; Florin,9997,0,9999,2
1713509470914,CLRE 253,B00,507202,Vaida; Florin,9999,0,9999,0
1713509471939,CLRE 259,A00,507211,Patel; Hemal,9996,0,9999,3
1713509473024,CLRE 260,A00,507221,Cuomo; Raphael Eduardo,9999,0,9999,0
1713509474051,CLRE 297,001,507242,Cuomo; Raphael Eduardo,9999,0,9999,0
1713509475078,CSE 191,A00,516875,Minnes Kemp; Mor Mia,9999,0,9999,0
1713509476103,CSS 201S,A01,494383,Staff,35,0,35,0
1713509477129,CSS 202S,A01,494387,Staff,35,0,35,0
1713509478154,EAP 100,A00,516065,Staff,9792,0,9999,207
1713509479183,ECE 45,A01,507414,Staff,37,0,60,23
1713509480214,ECE 100,A01,507416,Baghdadchi; Saharnaz,0,0,20,20
1713509480214,ECE 100,A02,507418,Baghdadchi; Saharnaz,19,0,20,1
1713509481239,ECE 111,A01,507420,Staff,27,0,50,23
1713509482265,ECE 197,001,548057,Sievenpiper; Daniel F.,9998,0,9999,1
1713509483295,EDS 115,A00,507243,Choi; Bailey Miyeon,27,0,28,1
1713509484321,EDS 117,A01,494379,Staff,15,0,25,10
1713509485346,EDS 125,A00,507246,Hopkins; Megan Beth,27,0,30,3
1713509486377,EDS 128A,A01,507264,Fargason; Sharon Gayle,26,0,26,0
1713509487407,EDS 128B,A01,507293,Pappas; Elizabeth,30,0,30,0
1713509488434,EDS 139,A00,507294,Fargason; Sharon Gayle,30,0,30,0
1713509488434,EDS 139,B00,507313,Pappas; Elizabeth,30,0,30,0
1713509489462,EDS 201,A00,507315,Staff,18,0,30,12
1713509490493,EDS 203,A01,507317,Halter; Christopher P.,17,0,30,13
1713509492051,EDS 204R,A01,507319,Halter; Christopher P.,0,1,30,30
1713509492051,EDS 204R,B01,507331,Heinzman; Erica M.,22,0,30,8
1713509493080,EDS 206R,A00,507332,Staff,0,2,30,30
1713509493080,EDS 206R,B00,507343,Staff,23,0,30,7
1713509494108,EDS 250,A00,507344,Hemans; Patricia Ann Benitez,27,0,40,13
1713509495133,EDS 281,A00,507345,Daly; Alan J.,18,0,18,0
1713509496161,EDS 284,A00,507350,Daly; Alan J.,16,0,16,0
1713509497187,EDS 286,A00,507359,Fine; Sarah,18,0,18,0
1713509498212,EDS 289C,A01,507361,Daly; Alan J.,18,0,18,0
1713509499240,EDS 290,A00,507366,Hofstetter; Carolyn,15,0,15,0
1713509500270,LIGM 5A,A00,507421,Fischer-Grunski; Eva K,20,0,20,0
1713509501296,LIGM 5B,A00,507423,Fischer-Grunski; Eva K,20,0,20,0
1713509502322,LIGM 5C,A00,507425,Fischer-Grunski; Eva K,20,0,20,0
1713509503352,LIIT 5AS,A00,507427,Carnelos; Chiara,20,0,20,0
1713509504378,LIIT 5BS,A00,507430,Carnelos; Chiara,20,0,20,0
1713509505405,LIIT 5CS,A00,507432,Carnelos; Chiara,20,0,20,0
1713509506434,LISP 5A,A00,507541,Munoz Sanchez; Alicia,14,0,20,6
1713509507459,LISP 5B,A00,507671,Munoz Sanchez; Alicia,12,0,20,8
1713509508489,LISP 5C,A00,507696,Munoz Sanchez; Alicia,11,0,20,9
1713509509515,MAE 197,001,528363,Boechler; Nicholas Sebastia,9998,0,9999,1
1713509510544,MATH 197,001,523477,Kedlaya; Kiran S.,9999,0,9999,0
1713509510544,MATH 197,002,563811,Zhang; Danna,9998,0,9999,1
1713509511573,MCWP 40R,A00,518780,Staff,13,0,20,7
1713509511573,MCWP 40R,B00,518781,Staff,11,0,20,9
1713509511573,MCWP 40R,C00,518783,Staff,8,0,20,12
1713509512598,MCWP 50R,A00,518791,Staff,7,0,20,13
1713509512598,MCWP 50R,B00,518792,Staff,3,0,20,17
1713509512598,MCWP 50R,C00,518793,Staff,5,0,20,15
1713509512598,MCWP 50R,D00,518794,Staff,0,0,20,20
1713509512598,MCWP 50R,E00,518795,Staff,0,0,20,20
1713509512598,MCWP 50R,F00,518796,Staff,11,0,20,9
1713509512598,MCWP 50R,G00,518797,Staff,10,0,20,10
1713509513624,MMW 12R,A01,514034,Herbst; Matthew,1,0,16,15
1713509513624,MMW 12R,A02,514035,Herbst; Matthew,13,0,16,3
1713509514656,MMW 13R,A01,514037,Staff,0,8,16,16
1713509514656,MMW 13R,A02,514039,Staff,0,7,16,16
1713509516710,SIO 295LS,A00,523233,Staff,15,0,30,15
1713509517736,SIO 295S,A00,523232,Staff,15,0,30,15
1713509518762,SOCI 117,A01,494376,Staff,0,2,5,5
1713509519787,WES 237B,A00,494380,Staff,19,0,20,1
1713509521917,AESE 279B,A00,494370,Wade; Jon P,33,0,33,0
1713509522945,AIP 197,001,627712,Vespa; Emanuel Ignacio,9999,0,9999,0
1713509523971,ANAR 135S,A00,494369,Braswell; Geoffrey E.,0,0,0,0
1713509525001,CAT 124RS,A01,519847,Geibel; William,6,0,20,14
1713509526029,CAT 125RS,A01,515971,Geibel; William,6,0,20,14
1713509527064,CLRE 250,A00,511389,Morris; Sheldon,9996,0,9999,3
1713509528088,CLRE 251,A00,507176,Mehta; Ravindra L.,9996,0,9999,3
1713509528088,CLRE 251,B00,511410,Mehta; Ravindra L.,9998,0,9999,1
1713509529117,CLRE 252,A00,507189,Cuomo; Raphael Eduardo,9998,0,9999,1
1713509530142,CLRE 253,A00,507199,Vaida; Florin,9997,0,9999,2
1713509530142,CLRE 253,B00,507202,Vaida; Florin,9999,0,9999,0
1713509531173,CLRE 259,A00,507211,Patel; Hemal,9996,0,9999,3
1713509532199,CLRE 260,A00,507221,Cuomo; Raphael Eduardo,9999,0,9999,0
1713509533225,CLRE 297,001,507242,Cuomo; Raphael Eduardo,9999,0,9999,0
1713509534250,CSE 191,A00,516875,Minnes Kemp; Mor Mia,9999,0,9999,0
1713509535282,CSS 201S,A01,494383,Staff,35,0,35,0
1713509536308,CSS 202S,A01,494387,Staff,35,0,35,0
1713509537333,EAP 100,A00,516065,Staff,9792,0,9999,207
1713509538363,ECE 45,A01,507414,Staff,37,0,60,23
1713509539392,ECE 100,A01,507416,Baghdadchi; Saharnaz,0,0,20,20
1713509539392,ECE 100,A02,507418,Baghdadchi; Saharnaz,19,0,20,1
1713509540418,ECE 111,A01,507420,Staff,27,0,50,23
1713509541444,ECE 197,001,548057,Sievenpiper; Daniel F.,9998,0,9999,1
1713509542468,EDS 115,A00,507243,Choi; Bailey Miyeon,27,0,28,1
1713509543494,EDS 117,A01,494379,Staff,15,0,25,10
1713509544519,EDS 125,A00,507246,Hopkins; Megan Beth,27,0,30,3
1713509545549,EDS 128A,A01,507264,Fargason; Sharon Gayle,26,0,26,0
1713509546573,EDS 128B,A01,507293,Pappas; Elizabeth,30,0,30,0
1713509547601,EDS 139,A00,507294,Fargason; Sharon Gayle,30,0,30,0
1713509547601,EDS 139,B00,507313,Pappas; Elizabeth,30,0,30,0
1713509548625,EDS 201,A00,507315,Staff,18,0,30,12
1713509549650,EDS 203,A01,507317,Halter; Christopher P.,17,0,30,13
1713509550681,EDS 204R,A01,507319,Halter; Christopher P.,0,1,30,30
1713509550681,EDS 204R,B01,507331,Heinzman; Erica M.,22,0,30,8
1713509551706,EDS 206R,A00,507332,Staff,0,2,30,30
1713509551706,EDS 206R,B00,507343,Staff,23,0,30,7
1713509552735,EDS 250,A00,507344,Hemans; Patricia Ann Benitez,27,0,40,13
1713509553765,EDS 281,A00,507345,Daly; Alan J.,18,0,18,0
1713509554791,EDS 284,A00,507350,Daly; Alan J.,16,0,16,0
1713509555816,EDS 286,A00,507359,Fine; Sarah,18,0,18,0
1713509556844,EDS 289C,A01,507361,Daly; Alan J.,18,0,18,0
1713509557873,EDS 290,A00,507366,Hofstetter; Carolyn,15,0,15,0
1713509558903,LIGM 5A,A00,507421,Fischer-Grunski; Eva K,20,0,20,0
1713509559932,LIGM 5B,A00,507423,Fischer-Grunski; Eva K,20,0,20,0
1713509560958,LIGM 5C,A00,507425,Fischer-Grunski; Eva K,20,0,20,0
1713509561983,LIIT 5AS,A00,507427,Carnelos; Chiara,20,0,20,0
1713509563011,LIIT 5BS,A00,507430,Carnelos; Chiara,20,0,20,0
1713509564036,LIIT 5CS,A00,507432,Carnelos; Chiara,20,0,20,0
1713509565064,LISP 5A,A00,507541,Munoz Sanchez; Alicia,14,0,20,6
1713509566088,LISP 5B,A00,507671,Munoz Sanchez; Alicia,12,0,20,8
1713509567114,LISP 5C,A00,507696,Munoz Sanchez; Alicia,11,0,20,9
1713509568145,MAE 197,001,528363,Boechler; Nicholas Sebastia,9998,0,9999,1
1713509569170,MATH 197,001,523477,Kedlaya; Kiran S.,9999,0,9999,0
1713509569170,MATH 197,002,563811,Zhang; Danna,9998,0,9999,1
1713509570196,MCWP 40R,A00,518780,Staff,13,0,20,7
1713509570196,MCWP 40R,B00,518781,Staff,11,0,20,9
1713509570196,MCWP 40R,C00,518783,Staff,8,0,20,12
1713509571224,MCWP 50R,A00,518791,Staff,7,0,20,13
1713509571224,MCWP 50R,B00,518792,Staff,3,0,20,17
1713509571224,MCWP 50R,C00,518793,Staff,5,0,20,15
1713509571224,MCWP 50R,D00,518794,Staff,0,0,20,20
1713509571224,MCWP 50R,E00,518795,Staff,0,0,20,20
1713509571224,MCWP 50R,F00,518796,Staff,11,0,20,9
1713509571224,MCWP 50R,G00,518797,Staff,10,0,20,10
1713509572249,MMW 12R,A01,514034,Herbst; Matthew,1,0,16,15
1713509572249,MMW 12R,A02,514035,Herbst; Matthew,13,0,16,3
1713509573274,MMW 13R,A01,514037,Staff,0,8,16,16
1713509573274,MMW 13R,A02,514039,Staff,0,7,16,16
1713509575324,SIO 295LS,A00,523233,Staff,15,0,30,15
1713509576351,SIO 295S,A00,523232,Staff,15,0,30,15
1713509577378,SOCI 117,A01,494376,Staff,0,2,5,5
1713509578401,WES 237B,A00,494380,Staff,19,0,20,1
1713509580466,AESE 279B,A00,494370,Wade; Jon P,33,0,33,0
1713509581494,AIP 197,001,627712,Vespa; Emanuel Ignacio,9999,0,9999,0
1713509582523,ANAR 135S,A00,494369,Braswell; Geoffrey E.,0,0,0,0
1713509583550,CAT 124RS,A01,519847,Geibel; William,6,0,20,14
1713509584576,CAT 125RS,A01,515971,Geibel; William,6,0,20,14
1713509585605,CLRE 250,A00,511389,Morris; Sheldon,9996,0,9999,3
1713509586632,CLRE 251,A00,507176,Mehta; Ravindra L.,9996,0,9999,3
1713509586632,CLRE 251,B00,511410,Mehta; Ravindra L.,9998,0,9999,1
1713509587658,CLRE 252,A00,507189,Cuomo; Raphael Eduardo,9998,0,9999,1
1713509588684,CLRE 253,A00,507199,Vaida; Florin,9997,0,9999,2
1713509588684,CLRE 253,B00,507202,Vaida; Florin,9999,0,9999,0
1713509589710,CLRE 259,A00,507211,Patel; Hemal,9996,0,9999,3
1713509590736,CLRE 260,A00,507221,Cuomo; Raphael Eduardo,9999,0,9999,0
1713509591765,CLRE 297,001,507242,Cuomo; Raphael Eduardo,9999,0,9999,0
1713509592795,CSE 191,A00,516875,Minnes Kemp; Mor Mia,9999,0,9999,0
1713509593824,CSS 201S,A01,494383,Staff,35,0,35,0
1713509594854,CSS 202S,A01,494387,Staff,35,0,35,0
1713509595880,EAP 100,A00,516065,Staff,9792,0,9999,207
1713509596908,ECE 45,A01,507414,Staff,37,0,60,23
1713509597939,ECE 100,A01,507416,Baghdadchi; Saharnaz,0,0,20,20
1713509597939,ECE 100,A02,507418,Baghdadchi; Saharnaz,19,0,20,1
1713509598974,ECE 111,A01,507420,Staff,27,0,50,23
1713509600001,ECE 197,001,548057,Sievenpiper; Daniel F.,9998,0,9999,1
1713509601028,EDS 115,A00,507243,Choi; Bailey Miyeon,27,0,28,1
1713509602053,EDS 117,A01,494379,Staff,15,0,25,10
1713509603078,EDS 125,A00,507246,Hopkins; Megan Beth,27,0,30,3
1713509604108,EDS 128A,A01,507264,Fargason; Sharon Gayle,26,0,26,0
1713509605137,EDS 128B,A01,507293,Pappas; Elizabeth,30,0,30,0
1713509606164,EDS 139,A00,507294,Fargason; Sharon Gayle,30,0,30,0
1713509606164,EDS 139,B00,507313,Pappas; Elizabeth,30,0,30,0
1713509607190,EDS 201,A00,507315,Staff,18,0,30,12
1713509608222,EDS 203,A01,507317,Halter; Christopher P.,17,0,30,13
1713509609248,EDS 204R,A01,507319,Halter; Christopher P.,0,1,30,30
1713509609248,EDS 204R,B01,507331,Heinzman; Erica M.,22,0,30,8
1713509610271,EDS 206R,A00,507332,Staff,0,2,30,30
1713509610271,EDS 206R,B00,507343,Staff,23,0,30,7
1713509611297,EDS 250,A00,507344,Hemans; Patricia Ann Benitez,27,0,40,13
1713509612328,EDS 281,A00,507345,Daly; Alan J.,18,0,18,0
1713509613353,EDS 284,A00,507350,Daly; Alan J.,16,0,16,0
1713509614382,EDS 286,A00,507359,Fine; Sarah,18,0,18,0
1713509615410,EDS 289C,A01,507361,Daly; Alan J.,18,0,18,0
1713509616435,EDS 290,A00,507366,Hofstetter; Carolyn,15,0,15,0
1713509617464,LIGM 5A,A00,507421,Fischer-Grunski; Eva K,20,0,20,0
1713509618490,LIGM 5B,A00,507423,Fischer-Grunski; Eva K,20,0,20,0
1713509619519,LIGM 5C,A00,507425,Fischer-Grunski; Eva K,20,0,20,0
1713509620549,LIIT 5AS,A00,507427,Carnelos; Chiara,20,0,20,0
1713509621579,LIIT 5BS,A00,507430,Carnelos; Chiara,20,0,20,0
1713509622610,LIIT 5CS,A00,507432,Carnelos; Chiara,20,0,20,0
1713509623640,LISP 5A,A00,507541,Munoz Sanchez; Alicia,14,0,20,6
1713509624719,LISP 5B,A00,507671,Munoz Sanchez; Alicia,12,0,20,8
1713509625750,LISP 5C,A00,507696,Munoz Sanchez; Alicia,11,0,20,9
1713509626781,MAE 197,001,528363,Boechler; Nicholas Sebastia,9998,0,9999,1
1713509627810,MATH 197,001,523477,Kedlaya; Kiran S.,9999,0,9999,0
1713509627810,MATH 197,002,563811,Zhang; Danna,9998,0,9999,1
1713509628836,MCWP 40R,A00,518780,Staff,13,0,20,7
1713509628836,MCWP 40R,B00,518781,Staff,11,0,20,9
1713509628836,MCWP 40R,C00,518783,Staff,8,0,20,12
1713509629866,MCWP 50R,A00,518791,Staff,7,0,20,13
1713509629866,MCWP 50R,B00,518792,Staff,3,0,20,17
1713509629866,MCWP 50R,C00,518793,Staff,5,0,20,15
1713509629866,MCWP 50R,D00,518794,Staff,0,0,20,20
1713509629866,MCWP 50R,E00,518795,Staff,0,0,20,20
1713509629866,MCWP 50R,F00,518796,Staff,11,0,20,9
1713509629866,MCWP 50R,G00,518797,Staff,10,0,20,10
1713509630891,MMW 12R,A01,514034,Herbst; Matthew,1,0,16,15
1713509630891,MMW 12R,A02,514035,Herbst; Matthew,13,0,16,3
1713509631920,MMW 13R,A01,514037,Staff,0,8,16,16
1713509631920,MMW 13R,A02,514039,Staff,0,7,16,16
1713509633974,SIO 295LS,A00,523233,Staff,15,0,30,15
1713509635004,SIO 295S,A00,523232,Staff,15,0,30,15
1713509636029,SOCI 117,A01,494376,Staff,0,2,5,5
1713509637055,WES 237B,A00,494380,Staff,19,0,20,1
1713509639126,AESE 279B,A00,494370,Wade; Jon P,33,0,33,0
1713509640155,AIP 197,001,627712,Vespa; Emanuel Ignacio,9999,0,9999,0
1713509641184,ANAR 135S,A00,494369,Braswell; Geoffrey E.,0,0,0,0
1713509642209,CAT 124RS,A01,519847,Geibel; William,6,0,20,14
1713509643241,CAT 125RS,A01,515971,Geibel; William,6,0,20,14
1713509644272,CLRE 250,A00,511389,Morris; Sheldon,9996,0,9999,3
1713509645301,CLRE 251,A00,507176,Mehta; Ravindra L.,9996,0,9999,3
1713509645301,CLRE 251,B00,511410,Mehta; Ravindra L.,9998,0,9999,1
1713509646331,CLRE 252,A00,507189,Cuomo; Raphael Eduardo,9998,0,9999,1
1713509647356,CLRE 253,A00,507199,Vaida; Florin,9997,0,9999,2
1713509647356,CLRE 253,B00,507202,Vaida; Florin,9999,0,9999,0
1713509648383,CLRE 259,A00,507211,Patel; Hemal,9996,0,9999,3
1713509649411,CLRE 260,A00,507221,Cuomo; Raphael Eduardo,9999,0,9999,0
1713509650437,CLRE 297,001,507242,Cuomo; Raphael Eduardo,9999,0,9999,0
1713509651463,CSE 191,A00,516875,Minnes Kemp; Mor Mia,9999,0,9999,0
1713509652493,CSS 201S,A01,494383,Staff,35,0,35,0
1713509653518,CSS 202S,A01,494387,Staff,35,0,35,0
1713509654544,EAP 100,A00,516065,Staff,9792,0,9999,207
1713509655572,ECE 45,A01,507414,Staff,37,0,60,23
1713509656597,ECE 100,A01,507416,Baghdadchi; Saharnaz,0,0,20,20
1713509656597,ECE 100,A02,507418,Baghdadchi; Saharnaz,19,0,20,1
1713509657626,ECE 111,A01,507420,Staff,27,0,50,23
1713509658652,ECE 197,001,548057,Sievenpiper; Daniel F.,9998,0,9999,1
1713509659677,EDS 115,A00,507243,Choi; Bailey Miyeon,27,0,28,1
1713509660702,EDS 117,A01,494379,Staff,15,0,25,10
1713509661734,EDS 125,A00,507246,Hopkins; Megan Beth,27,0,30,3
1713509662770,EDS 128A,A01,507264,Fargason; Sharon Gayle,26,0,26,0
1713509663797,EDS 128B,A01,507293,Pappas; Elizabeth,30,0,30,0
1713509664825,EDS 139,A00,507294,Fargason; Sharon Gayle,30,0,30,0
1713509664825,EDS 139,B00,507313,Pappas; Elizabeth,30,0,30,0
1713509665850,EDS 201,A00,507315,Staff,18,0,30,12
1713509666876,EDS 203,A01,507317,Halter; Christopher P.,17,0,30,13
1713509667916,EDS 204R,A01,507319,Halter; Christopher P.,0,1,30,30
1713509667916,EDS 204R,B01,507331,Heinzman; Erica M.,22,0,30,8
1713509668946,EDS 206R,A00,507332,Staff,0,2,30,30
1713509668946,EDS 206R,B00,507343,Staff,23,0,30,7
1713509669970,EDS 250,A00,507344,Hemans; Patricia Ann Benitez,27,0,40,13
1713509670995,EDS 281,A00,507345,Daly; Alan J.,18,0,18,0
1713509672021,EDS 284,A00,507350,Daly; Alan J.,16,0,16,0
1713509673046,EDS 286,A00,507359,Fine; Sarah,18,0,18,0
1713509674076,EDS 289C,A01,507361,Daly; Alan J.,18,0,18,0
1713509675108,EDS 290,A00,507366,Hofstetter; Carolyn,15,0,15,0
1713509676141,LIGM 5A,A00,507421,Fischer-Grunski; Eva K,20,0,20,0
1713509677167,LIGM 5B,A00,507423,Fischer-Grunski; Eva K,20,0,20,0
1713509678198,LIGM 5C,A00,507425,Fischer-Grunski; Eva K,20,0,20,0
1713509679223,LIIT 5AS,A00,507427,Carnelos; Chiara,20,0,20,0
1713509680253,LIIT 5BS,A00,507430,Carnelos; Chiara,20,0,20,0
1713509681281,LIIT 5CS,A00,507432,Carnelos; Chiara,20,0,20,0
1713509682308,LISP 5A,A00,507541,Munoz Sanchez; Alicia,14,0,20,6
1713509683337,LISP 5B,A00,507671,Munoz Sanchez; Alicia,12,0,20,8
1713509684362,LISP 5C,A00,507696,Munoz Sanchez; Alicia,11,0,20,9
1713509685393,MAE 197,001,528363,Boechler; Nicholas Sebastia,9998,0,9999,1
1713509686419,MATH 197,001,523477,Kedlaya; Kiran S.,9999,0,9999,0
1713509686419,MATH 197,002,563811,Zhang; Danna,9998,0,9999,1
1713509687450,MCWP 40R,A00,518780,Staff,13,0,20,7
1713509687450,MCWP 40R,B00,518781,Staff,11,0,20,9
1713509687450,MCWP 40R,C00,518783,Staff,8,0,20,12
1713509688477,MCWP 50R,A00,518791,Staff,7,0,20,13
1713509688477,MCWP 50R,B00,518792,Staff,3,0,20,17
1713509688477,MCWP 50R,C00,518793,Staff,5,0,20,15
1713509688477,MCWP 50R,D00,518794,Staff,0,0,20,20
1713509688477,MCWP 50R,E00,518795,Staff,0,0,20,20
1713509688477,MCWP 50R,F00,518796,Staff,11,0,20,9
1713509688477,MCWP 50R,G00,518797,Staff,10,0,20,10
1713509689502,MMW 12R,A01,514034,Herbst; Matthew,1,0,16,15
1713509689502,MMW 12R,A02,514035,Herbst; Matthew,13,0,16,3
1713509690528,MMW 13R,A01,514037,Staff,0,8,16,16
1713509690528,MMW 13R,A02,514039,Staff,0,7,16,16
1713509692583,SIO 295LS,A00,523233,Staff,15,0,30,15
1713509693609,SIO 295S,A00,523232,Staff,15,0,30,15
1713509694635,SOCI 117,A01,494376,Staff,0,2,5,5
1713509695660,WES 237B,A00,494380,Staff,19,0,20,1
1713509697744,AESE 279B,A00,494370,Wade; Jon P,33,0,33,0
1713509698769,AIP 197,001,627712,Vespa; Emanuel Ignacio,9999,0,9999,0
1713509699800,ANAR 135S,A00,494369,Braswell; Geoffrey E.,0,0,0,0
1713509700825,CAT 124RS,A01,519847,Geibel; William,6,0,20,14
1713509701854,CAT 125RS,A01,515971,Geibel; William,6,0,20,14
1713509702880,CLRE 250,A00,511389,Morris; Sheldon,9996,0,9999,3
1713509703912,CLRE 251,A00,507176,Mehta; Ravindra L.,9996,0,9999,3
1713509703912,CLRE 251,B00,511410,Mehta; Ravindra L.,9998,0,9999,1
1713509704938,CLRE 252,A00,507189,Cuomo; Raphael Eduardo,9998,0,9999,1
1713509705963,CLRE 253,A00,507199,Vaida; Florin,9997,0,9999,2
1713509705963,CLRE 253,B00,507202,Vaida; Florin,9999,0,9999,0
1713509706988,CLRE 259,A00,507211,Patel; Hemal,9996,0,9999,3
1713509708012,CLRE 260,A00,507221,Cuomo; Raphael Eduardo,9999,0,9999,0
1713509709037,CLRE 297,001,507242,Cuomo; Raphael Eduardo,9999,0,9999,0
1713509710065,CSE 191,A00,516875,Minnes Kemp; Mor Mia,9999,0,9999,0
1713509711088,CSS 201S,A01,494383,Staff,35,0,35,0
1713509712112,CSS 202S,A01,494387,Staff,35,0,35,0
1713509713137,EAP 100,A00,516065,Staff,9792,0,9999,207
1713509714163,ECE 45,A01,507414,Staff,37,0,60,23
1713509715192,ECE 100,A01,507416,Baghdadchi; Saharnaz,0,0,20,20
1713509715192,ECE 100,A02,507418,Baghdadchi; Saharnaz,19,0,20,1
1713509716218,ECE 111,A01,507420,Staff,27,0,50,23
1713509717246,ECE 197,001,548057,Sievenpiper; Daniel F.,9998,0,9999,1
1713509718272,EDS 115,A00,507243,Choi; Bailey Miyeon,27,0,28,1
1713509719297,EDS 117,A01,494379,Staff,15,0,25,10
1713509720323,EDS 125,A00,507246,Hopkins; Megan Beth,27,0,30,3
1713509721352,EDS 128A,A01,507264,Fargason; Sharon Gayle,26,0,26,0
1713509722378,EDS 128B,A01,507293,Pappas; Elizabeth,30,0,30,0
1713509723407,EDS 139,A00,507294,Fargason; Sharon Gayle,30,0,30,0
1713509723407,EDS 139,B00,507313,Pappas; Elizabeth,30,0,30,0
1713509724436,EDS 201,A00,507315,Staff,18,0,30,12
1713509725461,EDS 203,A01,507317,Halter; Christopher P.,17,0,30,13
1713509726487,EDS 204R,A01,507319,Halter; Christopher P.,0,1,30,30
1713509726487,EDS 204R,B01,507331,Heinzman; Erica M.,22,0,30,8
1713509727513,EDS 206R,A00,507332,Staff,0,2,30,30
1713509727513,EDS 206R,B00,507343,Staff,23,0,30,7
1713509728596,EDS 250,A00,507344,Hemans; Patricia Ann Benitez,27,0,40,13
1713509729622,EDS 281,A00,507345,Daly; Alan J.,18,0,18,0
1713509730650,EDS 284,A00,507350,Daly; Alan J.,16,0,16,0
1713509731680,EDS 286,A00,507359,Fine; Sarah,18,0,18,0
1713509732705,EDS 289C,A01,507361,Daly; Alan J.,18,0,18,0
1713509733732,EDS 290,A00,507366,Hofstetter; Carolyn,15,0,15,0
1713509734763,LIGM 5A,A00,507421,Fischer-Grunski; Eva K,20,0,20,0
1713509735787,LIGM 5B,A00,507423,Fischer-Grunski; Eva K,20,0,20,0
1713509736812,LIGM 5C,A00,507425,Fischer-Grunski; Eva K,20,0,20,0
1713509737837,LIIT 5AS,A00,507427,Carnelos; Chiara,20,0,20,0
1713509738863,LIIT 5BS,A00,507430,Carnelos; Chiara,20,0,20,0
1713509739889,LIIT 5CS,A00,507432,Carnelos; Chiara,20,0,20,0
1713509740915,LISP 5A,A00,507541,Munoz Sanchez; Alicia,14,0,20,6
1713509741941,LISP 5B,A00,507671,Munoz Sanchez; Alicia,12,0,20,8
1713509742967,LISP 5C,A00,507696,Munoz Sanchez; Alicia,11,0,20,9
1713509743995,MAE 197,001,528363,Boechler; Nicholas Sebastia,9998,0,9999,1
1713509745023,MATH 197,001,523477,Kedlaya; Kiran S.,9999,0,9999,0
1713509745023,MATH 197,002,563811,Zhang; Danna,9998,0,9999,1
1713509746052,MCWP 40R,A00,518780,Staff,13,0,20,7
1713509746052,MCWP 40R,B00,518781,Staff,11,0,20,9
1713509746052,MCWP 40R,C00,518783,Staff,8,0,20,12
1713509747078,MCWP 50R,A00,518791,Staff,7,0,20,13
1713509747078,MCWP 50R,B00,518792,Staff,3,0,20,17
1713509747078,MCWP 50R,C00,518793,Staff,5,0,20,15
1713509747078,MCWP 50R,D00,518794,Staff,0,0,20,20
1713509747078,MCWP 50R,E00,518795,Staff,0,0,20,20
1713509747078,MCWP 50R,F00,518796,Staff,11,0,20,9
1713509747078,MCWP 50R,G00,518797,Staff,10,0,20,10
1713509748107,MMW 12R,A01,514034,Herbst; Matthew,1,0,16,15
1713509748107,MMW 12R,A02,514035,Herbst; Matthew,13,0,16,3
1713509749135,MMW 13R,A01,514037,Staff,0,8,16,16
1713509749135,MMW 13R,A02,514039,Staff,0,7,16,16
1713509751187,SIO 295LS,A00,523233,Staff,15,0,30,15
1713509752213,SIO 295S,A00,523232,Staff,15,0,30,15
1713509753240,SOCI 117,A01,494376,Staff,0,2,5,5
1713509754265,WES 237B,A00,494380,Staff,19,0,20,1
1713509756338,AESE 279B,A00,494370,Wade; Jon P,33,0,33,0
1713509757362,AIP 197,001,627712,Vespa; Emanuel Ignacio,9999,0,9999,0
1713509758408,ANAR 135S,A00,494369,Braswell; Geoffrey E.,0,0,0,0
1713509759434,CAT 124RS,A01,519847,Geibel; William,6,0,20,14
1713509760539,CAT 125RS,A01,515971,Geibel; William,6,0,20,14
1713509761564,CLRE 250,A00,511389,Morris; Sheldon,9996,0,9999,3
1713509762591,CLRE 251,A00,507176,Mehta; Ravindra L.,9996,0,9999,3
1713509762591,CLRE 251,B00,511410,Mehta; Ravindra L.,9998,0,9999,1
1713509763637,CLRE 252,A00,507189,Cuomo; Raphael Eduardo,9998,0,9999,1
1713509764672,CLRE 253,A00,507199,Vaida; Florin,9997,0,9999,2
1713509764672,CLRE 253,B00,507202,Vaida; Florin,9999,0,9999,0
1713509765703,CLRE 259,A00,507211,Patel; Hemal,9996,0,9999,3
1713509766730,CLRE 260,A00,507221,Cuomo; Raphael Eduardo,9999,0,9999,0
1713509767773,CLRE 297,001,507242,Cuomo; Raphael Eduardo,9999,0,9999,0
1713509768798,CSE 191,A00,516875,Minnes Kemp; Mor Mia,9999,0,9999,0
1713509769826,CSS 201S,A01,494383,Staff,35,0,35,0
1713509770857,CSS 202S,A01,494387,Staff,35,0,35,0
1713509771882,EAP 100,A00,516065,Staff,9792,0,9999,207
1713509772907,ECE 45,A01,507414,Staff,37,0,60,23
1713509773933,ECE 100,A01,507416,Baghdadchi; Saharnaz,0,0,20,20
1713509773933,ECE 100,A02,507418,Baghdadchi; Saharnaz,19,0,20,1
1713509774960,ECE 111,A01,507420,Staff,27,0,50,23
1713509775993,ECE 197,001,548057,Sievenpiper; Daniel F.,9998,0,9999,1
1713509777033,EDS 115,A00,507243,Choi; Bailey Miyeon,27,0,28,1
1713509778059,EDS 117,A01,494379,Staff,15,0,25,10
1713509779086,EDS 125,A00,507246,Hopkins; Megan Beth,27,0,30,3
1713509780112,EDS 128A,A01,507264,Fargason; Sharon Gayle,26,0,26,0
1713509781138,EDS 128B,A01,507293,Pappas; Elizabeth,30,0,30,0
1713509782164,EDS 139,A00,507294,Fargason; Sharon Gayle,30,0,30,0
1713509782164,EDS 139,B00,507313,Pappas; Elizabeth,30,0,30,0
1713509783189,EDS 201,A00,507315,Staff,18,0,30,12
1713509784224,EDS 203,A01,507317,Halter; Christopher P.,17,0,30,13
1713509785254,EDS 204R,A01,507319,Halter; Christopher P.,0,1,30,30
1713509785254,EDS 204R,B01,507331,Heinzman; Erica M.,22,0,30,8
1713509786290,EDS 206R,A00,507332,Staff,0,2,30,30
1713509786290,EDS 206R,B00,507343,Staff,23,0,30,7
1713509787316,EDS 250,A00,507344,Hemans; Patricia Ann Benitez,27,0,40,13
1713509788340,EDS 281,A00,507345,Daly; Alan J.,18,0,18,0
1713509789369,EDS 284,A00,507350,Daly; Alan J.,16,0,16,0
1713509790398,EDS 286,A00,507359,Fine; Sarah,18,0,18,0
1713509791424,EDS 289C,A01,507361,Daly; Alan J.,18,0,18,0
1713509792448,EDS 290,A00,507366,Hofstetter; Carolyn,15,0,15,0
1713509793474,LIGM 5A,A00,507421,Fischer-Grunski; Eva K,20,0,20,0
1713509794503,LIGM 5B,A00,507423,Fischer-Grunski; Eva K,20,0,20,0
1713509795528,LIGM 5C,A00,507425,Fischer-Grunski; Eva K,20,0,20,0
1713509796554,LIIT 5AS,A00,507427,Carnelos; Chiara,20,0,20,0
1713509797586,LIIT 5BS,A00,507430,Carnelos; Chiara,20,0,20,0
1713509798618,LIIT 5CS,A00,507432,Carnelos; Chiara,20,0,20,0
1713509799644,LISP 5A,A00,507541,Munoz Sanchez; Alicia,14,0,20,6
1713509800674,LISP 5B,A00,507671,Munoz Sanchez; Alicia,12,0,20,8
1713509801701,LISP 5C,A00,507696,Munoz Sanchez; Alicia,11,0,20,9
1713509802726,MAE 197,001,528363,Boechler; Nicholas Sebastia,9998,0,9999,1
1713509803753,MATH 197,001,523477,Kedlaya; Kiran S.,9999,0,9999,0
1713509803753,MATH 197,002,563811,Zhang; Danna,9998,0,9999,1
1713509804782,MCWP 40R,A00,518780,Staff,13,0,20,7
1713509804782,MCWP 40R,B00,518781,Staff,11,0,20,9
1713509804782,MCWP 40R,C00,518783,Staff,8,0,20,12
1713509805813,MCWP 50R,A00,518791,Staff,7,0,20,13
1713509805813,MCWP 50R,B00,518792,Staff,3,0,20,17
1713509805813,MCWP 50R,C00,518793,Staff,5,0,20,15
1713509805813,MCWP 50R,D00,518794,Staff,0,0,20,20
1713509805813,MCWP 50R,E00,518795,Staff,0,0,20,20
1713509805813,MCWP 50R,F00,518796,Staff,11,0,20,9
1713509805813,MCWP 50R,G00,518797,Staff,10,0,20,10
1713509806839,MMW 12R,A01,514034,Herbst; Matthew,1,0,16,15
1713509806839,MMW 12R,A02,514035,Herbst; Matthew,13,0,16,3
1713509807865,MMW 13R,A01,514037,Staff,0,8,16,16
1713509807865,MMW 13R,A02,514039,Staff,0,7,16,16
1713509809919,SIO 295LS,A00,523233,Staff,15,0,30,15
1713509810944,SIO 295S,A00,523232,Staff,15,0,30,15
1713509811974,SOCI 117,A01,494376,Staff,0,2,5,5
1713509812999,WES 237B,A00,494380,Staff,19,0,20,1
1713509815062,AESE 279B,A00,494370,Wade; Jon P,33,0,33,0
1713509816087,AIP 197,001,627712,Vespa; Emanuel Ignacio,9999,0,9999,0
1713509817113,ANAR 135S,A00,494369,Braswell; Geoffrey E.,0,0,0,0
1713509818142,CAT 124RS,A01,519847,Geibel; William,6,0,20,14
1713509819165,CAT 125RS,A01,515971,Geibel; William,6,0,20,14
1713509820195,CLRE 250,A00,511389,Morris; Sheldon,9996,0,9999,3
1713509821219,CLRE 251,A00,507176,Mehta; Ravindra L.,9996,0,9999,3
1713509821219,CLRE 251,B00,511410,Mehta; Ravindra L.,9998,0,9999,1
1713509822246,CLRE 252,A00,507189,Cuomo; Raphael Eduardo,9998,0,9999,1
1713509823276,CLRE 253,A00,507199,Vaida; Florin,9997,0,9999,2
1713509823276,CLRE 253,B00,507202,Vaida; Florin,9999,0,9999,0
1713509824302,CLRE 259,A00,507211,Patel; Hemal,9996,0,9999,3
1713509825327,CLRE 260,A00,507221,Cuomo; Raphael Eduardo,9999,0,9999,0
1713509826356,CLRE 297,001,507242,Cuomo; Raphael Eduardo,9999,0,9999,0
1713509827384,CSE 191,A00,516875,Minnes Kemp; Mor Mia,9999,0,9999,0
1713509828420,CSS 201S,A01,494383,Staff,35,0,35,0
1713509829449,CSS 202S,A01,494387,Staff,35,0,35,0
1713509830473,EAP 100,A00,516065,Staff,9792,0,9999,207
1713509831499,ECE 45,A01,507414,Staff,37,0,60,23
1713509832583,ECE 100,A01,507416,Baghdadchi; Saharnaz,0,0,20,20
1713509832583,ECE 100,A02,507418,Baghdadchi; Saharnaz,19,0,20,1
1713509833612,ECE 111,A01,507420,Staff,27,0,50,23
1713509834637,ECE 197,001,548057,Sievenpiper; Daniel F.,9998,0,9999,1
1713509835666,EDS 115,A00,507243,Choi; Bailey Miyeon,27,0,28,1
1713509836695,EDS 117,A01,494379,Staff,15,0,25,10
1713509837720,EDS 125,A00,507246,Hopkins; Megan Beth,27,0,30,3
1713509838746,EDS 128A,A01,507264,Fargason; Sharon Gayle,26,0,26,0
1713509839774,EDS 128B,A01,507293,Pappas; Elizabeth,30,0,30,0
1713509840799,EDS 139,A00,507294,Fargason; Sharon Gayle,30,0,30,0
1713509840799,EDS 139,B00,507313,Pappas; Elizabeth,30,0,30,0
1713509841823,EDS 201,A00,507315,Staff,18,0,30,12
1713509842854,EDS 203,A01,507317,Halter; Christopher P.,17,0,30,13
1713509843881,EDS 204R,A01,507319,Halter; Christopher P.,0,1,30,30
1713509843881,EDS 204R,B01,507331,Heinzman; Erica M.,22,0,30,8
1713509844910,EDS 206R,A00,507332,Staff,0,2,30,30
1713509844910,EDS 206R,B00,507343,Staff,23,0,30,7
1713509845934,EDS 250,A00,507344,Hemans; Patricia Ann Benitez,27,0,40,13
1713509846963,EDS 281,A00,507345,Daly; Alan J.,18,0,18,0
1713509847990,EDS 284,A00,507350,Daly; Alan J.,16,0,16,0
1713509849020,EDS 286,A00,507359,Fine; Sarah,18,0,18,0
1713509850045,EDS 289C,A01,507361,Daly; Alan J.,18,0,18,0
1713509851071,EDS 290,A00,507366,Hofstetter; Carolyn,15,0,15,0
1713509852104,LIGM 5A,A00,507421,Fischer-Grunski; Eva K,20,0,20,0
1713509853130,LIGM 5B,A00,507423,Fischer-Grunski; Eva K,20,0,20,0
1713509854160,LIGM 5C,A00,507425,Fischer-Grunski; Eva K,20,0,20,0
1713509855193,LIIT 5AS,A00,507427,Carnelos; Chiara,20,0,20,0
1713509856222,LIIT 5BS,A00,507430,Carnelos; Chiara,20,0,20,0
1713509857248,LIIT 5CS,A00,507432,Carnelos; Chiara,20,0,20,0
1713509858274,LISP 5A,A00,507541,Munoz Sanchez; Alicia,14,0,20,6
1713509859298,LISP 5B,A00,507671,Munoz Sanchez; Alicia,12,0,20,8
1713509860324,LISP 5C,A00,507696,Munoz Sanchez; Alicia,11,0,20,9
1713509861350,MAE 197,001,528363,Boechler; Nicholas Sebastia,9998,0,9999,1
1713509862380,MATH 197,001,523477,Kedlaya; Kiran S.,9999,0,9999,0
1713509862380,MATH 197,002,563811,Zhang; Danna,9998,0,9999,1
1713509863405,MCWP 40R,A00,518780,Staff,13,0,20,7
1713509863405,MCWP 40R,B00,518781,Staff,11,0,20,9
1713509863405,MCWP 40R,C00,518783,Staff,8,0,20,12
1713509864431,MCWP 50R,A00,518791,Staff,7,0,20,13
1713509864431,MCWP 50R,B00,518792,Staff,3,0,20,17
1713509864431,MCWP 50R,C00,518793,Staff,5,0,20,15
1713509864431,MCWP 50R,D00,518794,Staff,0,0,20,20
1713509864431,MCWP 50R,E00,518795,Staff,0,0,20,20
1713509864431,MCWP 50R,F00,518796,Staff,11,0,20,9
1713509864431,MCWP 50R,G00,518797,Staff,10,0,20,10
1713509865460,MMW 12R,A01,514034,Herbst; Matthew,1,0,16,15
1713509865460,MMW 12R,A02,514035,Herbst; Matthew,13,0,16,3
1713509866488,MMW 13R,A01,514037,Staff,0,8,16,16
1713509866488,MMW 13R,A02,514039,Staff,0,7,16,16
1713509868545,SIO 295LS,A00,523233,Staff,15,0,30,15
1713509869570,SIO 295S,A00,523232,Staff,15,0,30,15
1713509870597,SOCI 117,A01,494376,Staff,0,2,5,5
1713509871622,WES 237B,A00,494380,Staff,19,0,20,1
1713509873696,AESE 279B,A00,494370,Wade; Jon P,33,0,33,0
1713509874723,AIP 197,001,627712,Vespa; Emanuel Ignacio,9999,0,9999,0
1713509875752,ANAR 135S,A00,494369,Braswell; Geoffrey E.,0,0,0,0
1713509876777,CAT 124RS,A01,519847,Geibel; William,6,0,20,14
1713509877807,CAT 125RS,A01,515971,Geibel; William,6,0,20,14
1713509878834,CLRE 250,A00,511389,Morris; Sheldon,9996,0,9999,3
1713509879859,CLRE 251,A00,507176,Mehta; Ravindra L.,9996,0,9999,3
1713509879859,CLRE 251,B00,511410,Mehta; Ravindra L.,9998,0,9999,1
1713509880886,CLRE 252,A00,507189,Cuomo; Raphael Eduardo,9998,0,9999,1
1713509881913,CLRE 253,A00,507199,Vaida; Florin,9997,0,9999,2
1713509881913,CLRE 253,B00,507202,Vaida; Florin,9999,0,9999,0
1713509882938,CLRE 259,A00,507211,Patel; Hemal,9996,0,9999,3
1713509883962,CLRE 260,A00,507221,Cuomo; Raphael Eduardo,9999,0,9999,0
1713509884987,CLRE 297,001,507242,Cuomo; Raphael Eduardo,9999,0,9999,0
1713509886016,CSE 191,A00,516875,Minnes Kemp; Mor Mia,9999,0,9999,0
1713509887042,CSS 201S,A01,494383,Staff,35,0,35,0
1713509888068,CSS 202S,A01,494387,Staff,35,0,35,0
1713509889096,EAP 100,A00,516065,Staff,9792,0,9999,207
1713509890124,ECE 45,A01,507414,Staff,37,0,60,23
1713509891149,ECE 100,A01,507416,Baghdadchi; Saharnaz,0,0,20,20
1713509891149,ECE 100,A02,507418,Baghdadchi; Saharnaz,19,0,20,1
1713509892176,ECE 111,A01,507420,Staff,27,0,50,23
1713509893200,ECE 197,001,548057,Sievenpiper; Daniel F.,9998,0,9999,1
1713509894225,EDS 115,A00,507243,Choi; Bailey Miyeon,27,0,28,1
1713509895250,EDS 117,A01,494379,Staff,15,0,25,10
1713509896279,EDS 125,A00,507246,Hopkins; Megan Beth,27,0,30,3
1713509897303,EDS 128A,A01,507264,Fargason; Sharon Gayle,26,0,26,0
1713509898328,EDS 128B,A01,507293,Pappas; Elizabeth,30,0,30,0
1713509899354,EDS 139,A00,507294,Fargason; Sharon Gayle,30,0,30,0
1713509899354,EDS 139,B00,507313,Pappas; Elizabeth,30,0,30,0
1713509900383,EDS 201,A00,507315,Staff,18,0,30,12
1713509901413,EDS 203,A01,507317,Halter; Christopher P.,17,0,30,13
1713509902443,EDS 204R,A01,507319,Halter; Christopher P.,0,1,30,30
1713509902443,EDS 204R,B01,507331,Heinzman; Erica M.,22,0,30,8
1713509903468,EDS 206R,A00,507332,Staff,0,2,30,30
1713509903468,EDS 206R,B00,507343,Staff,23,0,30,7
1713509904494,EDS 250,A00,507344,Hemans; Patricia Ann Benitez,27,0,40,13
1713509905522,EDS 281,A00,507345,Daly; Alan J.,18,0,18,0
1713509906548,EDS 284,A00,507350,Daly; Alan J.,16,0,16,0
1713509907580,EDS 286,A00,507359,Fine; Sarah,18,0,18,0
1713509908605,EDS 289C,A01,507361,Daly; Alan J.,18,0,18,0
1713509909628,EDS 290,A00,507366,Hofstetter; Carolyn,15,0,15,0
1713509910653,LIGM 5A,A00,507421,Fischer-Grunski; Eva K,20,0,20,0
1713509911677,LIGM 5B,A00,507423,Fischer-Grunski; Eva K,20,0,20,0
1713509912708,LIGM 5C,A00,507425,Fischer-Grunski; Eva K,20,0,20,0
1713509913736,LIIT 5AS,A00,507427,Carnelos; Chiara,20,0,20,0
1713509914763,LIIT 5BS,A00,507430,Carnelos; Chiara,20,0,20,0
1713509915789,LIIT 5CS,A00,507432,Carnelos; Chiara,20,0,20,0
1713509916815,LISP 5A,A00,507541,Munoz Sanchez; Alicia,14,0,20,6
1713509917841,LISP 5B,A00,507671,Munoz Sanchez; Alicia,12,0,20,8
1713509918871,LISP 5C,A00,507696,Munoz Sanchez; Alicia,11,0,20,9
1713509919900,MAE 197,001,528363,Boechler; Nicholas Sebastia,9998,0,9999,1
1713509920932,MATH 197,001,523477,Kedlaya; Kiran S.,9999,0,9999,0
1713509920932,MATH 197,002,563811,Zhang; Danna,9998,0,9999,1
1713509921961,MCWP 40R,A00,518780,Staff,13,0,20,7
1713509921961,MCWP 40R,B00,518781,Staff,11,0,20,9
1713509921961,MCWP 40R,C00,518783,Staff,8,0,20,12
1713509922992,MCWP 50R,A00,518791,Staff,7,0,20,13
1713509922992,MCWP 50R,B00,518792,Staff,3,0,20,17
1713509922992,MCWP 50R,C00,518793,Staff,5,0,20,15
1713509922992,MCWP 50R,D00,518794,Staff,0,0,20,20
1713509922992,MCWP 50R,E00,518795,Staff,0,0,20,20
1713509922992,MCWP 50R,F00,518796,Staff,11,0,20,9
1713509922992,MCWP 50R,G00,518797,Staff,10,0,20,10
1713509924019,MMW 12R,A01,514034,Herbst; Matthew,1,0,16,15
1713509924019,MMW 12R,A02,514035,Herbst; Matthew,13,0,16,3
1713509925047,MMW 13R,A01,514037,Staff,0,8,16,16
1713509925047,MMW 13R,A02,514039,Staff,0,7,16,16
1713509927098,SIO 295LS,A00,523233,Staff,15,0,30,15
1713509928124,SIO 295S,A00,523232,Staff,15,0,30,15
1713509929150,SOCI 117,A01,494376,Staff,0,2,5,5
1713509930177,WES 237B,A00,494380,Staff,19,0,20,1
1713509932250,AESE 279B,A00,494370,Wade; Jon P,33,0,33,0
1713509933279,AIP 197,001,627712,Vespa; Emanuel Ignacio,9999,0,9999,0
1713509934304,ANAR 135S,A00,494369,Braswell; Geoffrey E.,0,0,0,0
1713509935334,CAT 124RS,A01,519847,Geibel; William,6,0,20,14
1713509936418,CAT 125RS,A01,515971,Geibel; William,6,0,20,14
1713509937444,CLRE 250,A00,511389,Morris; Sheldon,9996,0,9999,3
1713509938469,CLRE 251,A00,507176,Mehta; Ravindra L.,9996,0,9999,3
1713509938469,CLRE 251,B00,511410,Mehta; Ravindra L.,9998,0,9999,1
1713509939495,CLRE 252,A00,507189,Cuomo; Raphael Eduardo,9998,0,9999,1
1713509940522,CLRE 253,A00,507199,Vaida; Florin,9997,0,9999,2
1713509940522,CLRE 253,B00,507202,Vaida; Florin,9999,0,9999,0
1713509941546,CLRE 259,A00,507211,Patel; Hemal,9996,0,9999,3
1713509942570,CLRE 260,A00,507221,Cuomo; Raphael Eduardo,9999,0,9999,0
1713509943600,CLRE 297,001,507242,Cuomo; Raphael Eduardo,9999,0,9999,0
1713509944625,CSE 191,A00,516875,Minnes Kemp; Mor Mia,9999,0,9999,0
1713509945655,CSS 201S,A01,494383,Staff,35,0,35,0
1713509946680,CSS 202S,A01,494387,Staff,35,0,35,0
1713509947706,EAP 100,A00,516065,Staff,9792,0,9999,207
1713509948736,ECE 45,A01,507414,Staff,37,0,60,23
1713509949767,ECE 100,A01,507416,Baghdadchi; Saharnaz,0,0,20,20
1713509949767,ECE 100,A02,507418,Baghdadchi; Saharnaz,19,0,20,1
1713509950796,ECE 111,A01,507420,Staff,27,0,50,23
1713509951823,ECE 197,001,548057,Sievenpiper; Daniel F.,9998,0,9999,1
1713509952850,EDS 115,A00,507243,Choi; Bailey Miyeon,27,0,28,1
1713509953890,EDS 117,A01,494379,Staff,15,0,25,10
1713509954915,EDS 125,A00,507246,Hopkins; Megan Beth,27,0,30,3
1713509955941,EDS 128A,A01,507264,Fargason; Sharon Gayle,26,0,26,0
1713509956965,EDS 128B,A01,507293,Pappas; Elizabeth,30,0,30,0
1713509957991,EDS 139,A00,507294,Fargason; Sharon Gayle,30,0,30,0
1713509957991,EDS 139,B00,507313,Pappas; Elizabeth,30,0,30,0
1713509959017,EDS 201,A00,507315,Staff,18,0,30,12
1713509960047,EDS 203,A01,507317,Halter; Christopher P.,17,0,30,13
1713509961074,EDS 204R,A01,507319,Halter; Christopher P.,0,1,30,30
1713509961074,EDS 204R,B01,507331,Heinzman; Erica M.,22,0,30,8
1713509962098,EDS 206R,A00,507332,Staff,0,2,30,30
1713509962098,EDS 206R,B00,507343,Staff,23,0,30,7
1713509963125,EDS 250,A00,507344,Hemans; Patricia Ann Benitez,27,0,40,13
1713509964155,EDS 281,A00,507345,Daly; Alan J.,18,0,18,0
1713509965180,EDS 284,A00,507350,Daly; Alan J.,16,0,16,0
1713509966209,EDS 286,A00,507359,Fine; Sarah,18,0,18,0
1713509967240,EDS 289C,A01,507361,Daly; Alan J.,18,0,18,0
1713509968264,EDS 290,A00,507366,Hofstetter; Carolyn,15,0,15,0
1713509969296,LIGM 5A,A00,507421,Fischer-Grunski; Eva K,20,0,20,0
1713509970324,LIGM 5B,A00,507423,Fischer-Grunski; Eva K,20,0,20,0
1713509971353,LIGM 5C,A00,507425,Fischer-Grunski; Eva K,20,0,20,0
1713509972384,LIIT 5AS,A00,507427,Carnelos; Chiara,20,0,20,0
1713509973411,LIIT 5BS,A00,507430,Carnelos; Chiara,20,0,20,0
1713509974442,LIIT 5CS,A00,507432,Carnelos; Chiara,20,0,20,0
1713509975474,LISP 5A,A00,507541,Munoz Sanchez; Alicia,14,0,20,6
1713509976500,LISP 5B,A00,507671,Munoz Sanchez; Alicia,12,0,20,8
1713509977524,LISP 5C,A00,507696,Munoz Sanchez; Alicia,11,0,20,9
1713509978553,MAE 197,001,528363,Boechler; Nicholas Sebastia,9998,0,9999,1
1713509979581,MATH 197,001,523477,Kedlaya; Kiran S.,9999,0,9999,0
1713509979581,MATH 197,002,563811,Zhang; Danna,9998,0,9999,1
1713509980607,MCWP 40R,A00,518780,Staff,13,0,20,7
1713509980607,MCWP 40R,B00,518781,Staff,11,0,20,9
1713509980607,MCWP 40R,C00,518783,Staff,8,0,20,12
1713509981633,MCWP 50R,A00,518791,Staff,7,0,20,13
1713509981633,MCWP 50R,B00,518792,Staff,3,0,20,17
1713509981633,MCWP 50R,C00,518793,Staff,5,0,20,15
1713509981633,MCWP 50R,D00,518794,Staff,0,0,20,20
1713509981633,MCWP 50R,E00,518795,Staff,0,0,20,20
1713509981633,MCWP 50R,F00,518796,Staff,11,0,20,9
1713509981633,MCWP 50R,G00,518797,Staff,10,0,20,10
1713509982662,MMW 12R,A01,514034,Herbst; Matthew,1,0,16,15
1713509982662,MMW 12R,A02,514035,Herbst; Matthew,13,0,16,3
1713509983688,MMW 13R,A01,514037,Staff,0,8,16,16
1713509983688,MMW 13R,A02,514039,Staff,0,7,16,16
1713509985740,SIO 295LS,A00,523233,Staff,15,0,30,15
1713509986768,SIO 295S,A00,523232,Staff,15,0,30,15
1713509987800,SOCI 117,A01,494376,Staff,0,2,5,5
1713509988827,WES 237B,A00,494380,Staff,19,0,20,1
1713509990907,AESE 279B,A00,494370,Wade; Jon P,33,0,33,0
1713509991936,AIP 197,001,627712,Vespa; Emanuel Ignacio,9999,0,9999,0
1713509992964,ANAR 135S,A00,494369,Braswell; Geoffrey E.,0,0,0,0
1713509993990,CAT 124RS,A01,519847,Geibel; William,6,0,20,14
1713509995016,CAT 125RS,A01,515971,Geibel; William,6,0,20,14
1713509996041,CLRE 250,A00,511389,Morris; Sheldon,9996,0,9999,3
1713509997067,CLRE 251,A00,507176,Mehta; Ravindra L.,9996,0,9999,3
1713509997067,CLRE 251,B00,511410,Mehta; Ravindra L.,9998,0,9999,1
1713509998094,CLRE 252,A00,507189,Cuomo; Raphael Eduardo,9998,0,9999,1
1713509999121,CLRE 253,A00,507199,Vaida; Florin,9997,0,9999,2
1713509999121,CLRE 253,B00,507202,Vaida; Florin,9999,0,9999,0
1713510000146,CLRE 259,A00,507211,Patel; Hemal,9996,0,9999,3
1713510001172,CLRE 260,A00,507221,Cuomo; Raphael Eduardo,9999,0,9999,0
1713510002196,CLRE 297,001,507242,Cuomo; Raphael Eduardo,9999,0,9999,0
1713510003224,CSE 191,A00,516875,Minnes Kemp; Mor Mia,9999,0,9999,0
1713510004250,CSS 201S,A01,494383,Staff,35,0,35,0
1713510005278,CSS 202S,A01,494387,Staff,35,0,35,0
1713510006303,EAP 100,A00,516065,Staff,9792,0,9999,207
1713510007333,ECE 45,A01,507414,Staff,37,0,60,23
1713510008359,ECE 100,A01,507416,Baghdadchi; Saharnaz,0,0,20,20
1713510008359,ECE 100,A02,507418,Baghdadchi; Saharnaz,19,0,20,1
1713510009385,ECE 111,A01,507420,Staff,27,0,50,23
1713510010417,ECE 197,001,548057,Sievenpiper; Daniel F.,9998,0,9999,1
1713510011450,EDS 115,A00,507243,Choi; Bailey Miyeon,27,0,28,1
1713510012475,EDS 117,A01,494379,Staff,15,0,25,10
1713510013503,EDS 125,A00,507246,Hopkins; Megan Beth,27,0,30,3
1713510014528,EDS 128A,A01,507264,Fargason; Sharon Gayle,26,0,26,0
1713510015555,EDS 128B,A01,507293,Pappas; Elizabeth,30,0,30,0
1713510016580,EDS 139,A00,507294,Fargason; Sharon Gayle,30,0,30,0
1713510016580,EDS 139,B00,507313,Pappas; Elizabeth,30,0,30,0
1713510017605,EDS 201,A00,507315,Staff,18,0,30,12
1713510018635,EDS 203,A01,507317,Halter; Christopher P.,17,0,30,13
1713510019659,EDS 204R,A01,507319,Halter; Christopher P.,0,1,30,30
1713510019659,EDS 204R,B01,507331,Heinzman; Erica M.,22,0,30,8
1713510020689,EDS 206R,A00,507332,Staff,0,2,30,30
1713510020689,EDS 206R,B00,507343,Staff,23,0,30,7
1713510021715,EDS 250,A00,507344,Hemans; Patricia Ann Benitez,27,0,40,13
1713510022744,EDS 281,A00,507345,Daly; Alan J.,18,0,18,0
1713510023769,EDS 284,A00,507350,Daly; Alan J.,16,0,16,0
1713510024799,EDS 286,A00,507359,Fine; Sarah,18,0,18,0
1713510025827,EDS 289C,A01,507361,Daly; Alan J.,18,0,18,0
1713510026857,EDS 290,A00,507366,Hofstetter; Carolyn,15,0,15,0
1713510027888,LIGM 5A,A00,507421,Fischer-Grunski; Eva K,20,0,20,0
1713510028914,LIGM 5B,A00,507423,Fischer-Grunski; Eva K,20,0,20,0
1713510029940,LIGM 5C,A00,507425,Fischer-Grunski; Eva K,20,0,20,0
1713510030969,LIIT 5AS,A00,507427,Carnelos; Chiara,20,0,20,0
1713510031998,LIIT 5BS,A00,507430,Carnelos; Chiara,20,0,20,0
1713510033029,LIIT 5CS,A00,507432,Carnelos; Chiara,20,0,20,0
1713510034059,LISP 5A,A00,507541,Munoz Sanchez; Alicia,14,0,20,6
1713510035094,LISP 5B,A00,507671,Munoz Sanchez; Alicia,12,0,20,8
1713510036119,LISP 5C,A00,507696,Munoz Sanchez; Alicia,11,0,20,9
1713510037143,MAE 197,001,528363,Boechler; Nicholas Sebastia,9998,0,9999,1
1713510038179,MATH 197,001,523477,Kedlaya; Kiran S.,9999,0,9999,0
1713510038179,MATH 197,002,563811,Zhang; Danna,9998,0,9999,1
1713510039207,MCWP 40R,A00,518780,Staff,13,0,20,7
1713510039207,MCWP 40R,B00,518781,Staff,11,0,20,9
1713510039207,MCWP 40R,C00,518783,Staff,8,0,20,12
1713510040289,MCWP 50R,A00,518791,Staff,7,0,20,13
1713510040289,MCWP 50R,B00,518792,Staff,3,0,20,17
1713510040289,MCWP 50R,C00,518793,Staff,5,0,20,15
1713510040289,MCWP 50R,D00,518794,Staff,0,0,20,20
1713510040289,MCWP 50R,E00,518795,Staff,0,0,20,20
1713510040289,MCWP 50R,F00,518796,Staff,11,0,20,9
1713510040289,MCWP 50R,G00,518797,Staff,10,0,20,10
1713510041320,MMW 12R,A01,514034,Herbst; Matthew,1,0,16,15
1713510041320,MMW 12R,A02,514035,Herbst; Matthew,13,0,16,3
1713510042346,MMW 13R,A01,514037,Staff,0,8,16,16
1713510042346,MMW 13R,A02,514039,Staff,0,7,16,16
1713510044393,SIO 295LS,A00,523233,Staff,15,0,30,15
1713510045419,SIO 295S,A00,523232,Staff,15,0,30,15
1713510046445,SOCI 117,A01,494376,Staff,0,2,5,5
1713510047469,WES 237B,A00,494380,Staff,19,0,20,1
1713510049542,AESE 279B,A00,494370,Wade; Jon P,33,0,33,0
1713510050572,AIP 197,001,627712,Vespa; Emanuel Ignacio,9999,0,9999,0
1713510051597,ANAR 135S,A00,494369,Braswell; Geoffrey E.,0,0,0,0
1713510052623,CAT 124RS,A01,519847,Geibel; William,6,0,20,14
1713510053650,CAT 125RS,A01,515971,Geibel; William,6,0,20,14
1713510054676,CLRE 250,A00,511389,Morris; Sheldon,9996,0,9999,3
1713510055702,CLRE 251,A00,507176,Mehta; Ravindra L.,9996,0,9999,3
1713510055702,CLRE 251,B00,511410,Mehta; Ravindra L.,9998,0,9999,1
1713510056729,CLRE 252,A00,507189,Cuomo; Raphael Eduardo,9998,0,9999,1
1713510057754,CLRE 253,A00,507199,Vaida; Florin,9997,0,9999,2
1713510057754,CLRE 253,B00,507202,Vaida; Florin,9999,0,9999,0
1713510058780,CLRE 259,A00,507211,Patel; Hemal,9996,0,9999,3
1713510059806,CLRE 260,A00,507221,Cuomo; Raphael Eduardo,9999,0,9999,0
1713510060832,CLRE 297,001,507242,Cuomo; Raphael Eduardo,9999,0,9999,0
1713510061871,CSE 191,A00,516875,Minnes Kemp; Mor Mia,9999,0,9999,0
1713510062905,CSS 201S,A01,494383,Staff,35,0,35,0
1713510063930,CSS 202S,A01,494387,Staff,35,0,35,0
1713510064955,EAP 100,A00,516065,Staff,9792,0,9999,207
1713510065988,ECE 45,A01,507414,Staff,37,0,60,23
1713510067018,ECE 100,A01,507416,Baghdadchi; Saharnaz,0,0,20,20
1713510067018,ECE 100,A02,507418,Baghdadchi; Saharnaz,19,0,20,1
1713510068054,ECE 111,A01,507420,Staff,27,0,50,23
1713510069078,ECE 197,001,548057,Sievenpiper; Daniel F.,9998,0,9999,1
1713510070122,EDS 115,A00,507243,Choi; Bailey Miyeon,27,0,28,1
1713510071166,EDS 117,A01,494379,Staff,15,0,25,10
1713510072192,EDS 125,A00,507246,Hopkins; Megan Beth,27,0,30,3
1713510073511,EDS 128A,A01,507264,Fargason; Sharon Gayle,26,0,26,0
1713510074537,EDS 128B,A01,507293,Pappas; Elizabeth,30,0,30,0
1713510075591,EDS 139,A00,507294,Fargason; Sharon Gayle,30,0,30,0
1713510075591,EDS 139,B00,507313,Pappas; Elizabeth,30,0,30,0
1713510076698,EDS 201,A00,507315,Staff,18,0,30,12
1713510077722,EDS 203,A01,507317,Halter; Christopher P.,17,0,30,13
1713510078759,EDS 204R,A01,507319,Halter; Christopher P.,0,1,30,30
1713510078759,EDS 204R,B01,507331,Heinzman; Erica M.,22,0,30,8
1713510079785,EDS 206R,A00,507332,Staff,0,2,30,30
1713510079785,EDS 206R,B00,507343,Staff,23,0,30,7
1713510080823,EDS 250,A00,507344,Hemans; Patricia Ann Benitez,27,0,40,13
1713510081849,EDS 281,A00,507345,Daly; Alan J.,18,0,18,0
1713510082875,EDS 284,A00,507350,Daly; Alan J.,16,0,16,0
1713510083918,EDS 286,A00,507359,Fine; Sarah,18,0,18,0
1713510084944,EDS 289C,A01,507361,Daly; Alan J.,18,0,18,0
1713510085969,EDS 290,A00,507366,Hofstetter; Carolyn,15,0,15,0
1713510086996,LIGM 5A,A00,507421,Fischer-Grunski; Eva K,20,0,20,0
1713510088039,LIGM 5B,A00,507423,Fischer-Grunski; Eva K,20,0,20,0
1713510089074,LIGM 5C,A00,507425,Fischer-Grunski; Eva K,20,0,20,0
1713510090099,LIIT 5AS,A00,507427,Carnelos; Chiara,20,0,20,0
1713510091124,LIIT 5BS,A00,507430,Carnelos; Chiara,20,0,20,0
1713510092161,LIIT 5CS,A00,507432,Carnelos; Chiara,20,0,20,0
1713510093187,LISP 5A,A00,507541,Munoz Sanchez; Alicia,14,0,20,6
1713510094213,LISP 5B,A00,507671,Munoz Sanchez; Alicia,12,0,20,8
1713510095239,LISP 5C,A00,507696,Munoz Sanchez; Alicia,11,0,20,9
1713510096272,MAE 197,001,528363,Boechler; Nicholas Sebastia,9998,0,9999,1
1713510097300,MATH 197,001,523477,Kedlaya; Kiran S.,9999,0,9999,0
1713510097300,MATH 197,002,563811,Zhang; Danna,9998,0,9999,1
1713510098325,MCWP 40R,A00,518780,Staff,13,0,20,7
1713510098325,MCWP 40R,B00,518781,Staff,11,0,20,9
1713510098325,MCWP 40R,C00,518783,Staff,8,0,20,12
1713510099364,MCWP 50R,A00,518791,Staff,7,0,20,13
1713510099364,MCWP 50R,B00,518792,Staff,3,0,20,17
1713510099364,MCWP 50R,C00,518793,Staff,5,0,20,15
1713510099364,MCWP 50R,D00,518794,Staff,0,0,20,20
1713510099364,MCWP 50R,E00,518795,Staff,0,0,20,20
1713510099364,MCWP 50R,F00,518796,Staff,11,0,20,9
1713510099364,MCWP 50R,G00,518797,Staff,10,0,20,10
1713510100388,MMW 12R,A01,514034,Herbst; Matthew,1,0,16,15
1713510100388,MMW 12R,A02,514035,Herbst; Matthew,13,0,16,3
1713510101414,MMW 13R,A01,514037,Staff,0,8,16,16
1713510101414,MMW 13R,A02,514039,Staff,0,7,16,16
1713510103470,SIO 295LS,A00,523233,Staff,15,0,30,15
1713510104497,SIO 295S,A00,523232,Staff,15,0,30,15
1713510105529,SOCI 117,A01,494376,Staff,0,2,5,5
1713510106561,WES 237B,A00,494380,Staff,19,0,20,1
1713510108630,AESE 279B,A00,494370,Wade; Jon P,33,0,33,0
1713510109660,AIP 197,001,627712,Vespa; Emanuel Ignacio,9999,0,9999,0
1713510110692,ANAR 135S,A00,494369,Braswell; Geoffrey E.,0,0,0,0
1713510111724,CAT 124RS,A01,519847,Geibel; William,6,0,20,14
1713510112755,CAT 125RS,A01,515971,Geibel; William,6,0,20,14
1713510113786,CLRE 250,A00,511389,Morris; Sheldon,9996,0,9999,3
1713510114812,CLRE 251,A00,507176,Mehta; Ravindra L.,9996,0,9999,3
1713510114812,CLRE 251,B00,511410,Mehta; Ravindra L.,9998,0,9999,1
1713510115844,CLRE 252,A00,507189,Cuomo; Raphael Eduardo,9998,0,9999,1
1713510116871,CLRE 253,A00,507199,Vaida; Florin,9997,0,9999,2
1713510116871,CLRE 253,B00,507202,Vaida; Florin,9999,0,9999,0
1713510117897,CLRE 259,A00,507211,Patel; Hemal,9996,0,9999,3
1713510118922,CLRE 260,A00,507221,Cuomo; Raphael Eduardo,9999,0,9999,0
1713510119947,CLRE 297,001,507242,Cuomo; Raphael Eduardo,9999,0,9999,0
1713510120972,CSE 191,A00,516875,Minnes Kemp; Mor Mia,9999,0,9999,0
1713510122003,CSS 201S,A01,494383,Staff,35,0,35,0
1713510123034,CSS 202S,A01,494387,Staff,35,0,35,0
1713510124058,EAP 100,A00,516065,Staff,9792,0,9999,207
1713510125083,ECE 45,A01,507414,Staff,37,0,60,23
1713510126108,ECE 100,A01,507416,Baghdadchi; Saharnaz,0,0,20,20
1713510126108,ECE 100,A02,507418,Baghdadchi; Saharnaz,19,0,20,1
1713510127134,ECE 111,A01,507420,Staff,27,0,50,23
1713510128162,ECE 197,001,548057,Sievenpiper; Daniel F.,9998,0,9999,1
1713510129188,EDS 115,A00,507243,Choi; Bailey Miyeon,27,0,28,1
1713510130214,EDS 117,A01,494379,Staff,15,0,25,10
1713510131245,EDS 125,A00,507246,Hopkins; Megan Beth,27,0,30,3
1713510132272,EDS 128A,A01,507264,Fargason; Sharon Gayle,26,0,26,0
1713510133298,EDS 128B,A01,507293,Pappas; Elizabeth,30,0,30,0
1713510134324,EDS 139,A00,507294,Fargason; Sharon Gayle,30,0,30,0
1713510134324,EDS 139,B00,507313,Pappas; Elizabeth,30,0,30,0
1713510135349,EDS 201,A00,507315,Staff,18,0,30,12
1713510136374,EDS 203,A01,507317,Halter; Christopher P.,17,0,30,13
1713510137400,EDS 204R,A01,507319,Halter; Christopher P.,0,1,30,30
1713510137400,EDS 204R,B01,507331,Heinzman; Erica M.,22,0,30,8
1713510138426,EDS 206R,A00,507332,Staff,0,2,30,30
1713510138426,EDS 206R,B00,507343,Staff,23,0,30,7
1713510139450,EDS 250,A00,507344,Hemans; Patricia Ann Benitez,27,0,40,13
1713510140484,EDS 281,A00,507345,Daly; Alan J.,18,0,18,0
1713510141516,EDS 284,A00,507350,Daly; Alan J.,16,0,16,0
1713510142541,EDS 286,A00,507359,Fine; Sarah,18,0,18,0
1713510143573,EDS 289C,A01,507361,Daly; Alan J.,18,0,18,0
1713510144661,EDS 290,A00,507366,Hofstetter; Carolyn,15,0,15,0
1713510145687,LIGM 5A,A00,507421,Fischer-Grunski; Eva K,20,0,20,0
1713510146712,LIGM 5B,A00,507423,Fischer-Grunski; Eva K,20,0,20,0
1713510147739,LIGM 5C,A00,507425,Fischer-Grunski; Eva K,20,0,20,0
1713510148767,LIIT 5AS,A00,507427,Carnelos; Chiara,20,0,20,0
1713510149793,LIIT 5BS,A00,507430,Carnelos; Chiara,20,0,20,0
1713510150820,LIIT 5CS,A00,507432,Carnelos; Chiara,20,0,20,0
1713510151845,LISP 5A,A00,507541,Munoz Sanchez; Alicia,14,0,20,6
1713510152871,LISP 5B,A00,507671,Munoz Sanchez; Alicia,12,0,20,8
1713510153898,LISP 5C,A00,507696,Munoz Sanchez; Alicia,11,0,20,9
1713510154923,MAE 197,001,528363,Boechler; Nicholas Sebastia,9998,0,9999,1
1713510155950,MATH 197,001,523477,Kedlaya; Kiran S.,9999,0,9999,0
1713510155950,MATH 197,002,563811,Zhang; Danna,9998,0,9999,1
1713510156976,MCWP 40R,A00,518780,Staff,13,0,20,7
1713510156976,MCWP 40R,B00,518781,Staff,11,0,20,9
1713510156976,MCWP 40R,C00,518783,Staff,8,0,20,12
1713510158009,MCWP 50R,A00,518791,Staff,7,0,20,13
1713510158009,MCWP 50R,B00,518792,Staff,3,0,20,17
1713510158009,MCWP 50R,C00,518793,Staff,5,0,20,15
1713510158009,MCWP 50R,D00,518794,Staff,0,0,20,20
1713510158009,MCWP 50R,E00,518795,Staff,0,0,20,20
1713510158009,MCWP 50R,F00,518796,Staff,11,0,20,9
1713510158009,MCWP 50R,G00,518797,Staff,10,0,20,10
1713510159036,MMW 12R,A01,514034,Herbst; Matthew,1,0,16,15
1713510159036,MMW 12R,A02,514035,Herbst; Matthew,13,0,16,3
1713510160062,MMW 13R,A01,514037,Staff,0,8,16,16
1713510160062,MMW 13R,A02,514039,Staff,0,7,16,16
1713510162113,SIO 295LS,A00,523233,Staff,15,0,30,15
1713510163144,SIO 295S,A00,523232,Staff,15,0,30,15
1713510164170,SOCI 117,A01,494376,Staff,0,2,5,5
1713510165196,WES 237B,A00,494380,Staff,19,0,20,1
1713510167266,AESE 279B,A00,494370,Wade; Jon P,33,0,33,0
1713510168292,AIP 197,001,627712,Vespa; Emanuel Ignacio,9999,0,9999,0
1713510169322,ANAR 135S,A00,494369,Braswell; Geoffrey E.,0,0,0,0
1713510170350,CAT 124RS,A01,519847,Geibel; William,6,0,20,14
1713510171382,CAT 125RS,A01,515971,Geibel; William,6,0,20,14
1713510172407,CLRE 250,A00,511389,Morris; Sheldon,9996,0,9999,3
1713510173433,CLRE 251,A00,507176,Mehta; Ravindra L.,9996,0,9999,3
1713510173433,CLRE 251,B00,511410,Mehta; Ravindra L.,9998,0,9999,1
1713510174470,CLRE 252,A00,507189,Cuomo; Raphael Eduardo,9998,0,9999,1
1713510175503,CLRE 253,A00,507199,Vaida; Florin,9997,0,9999,2
1713510175503,CLRE 253,B00,507202,Vaida; Florin,9999,0,9999,0
1713510176527,CLRE 259,A00,507211,Patel; Hemal,9996,0,9999,3
1713510177553,CLRE 260,A00,507221,Cuomo; Raphael Eduardo,9999,0,9999,0
1713510178579,CLRE 297,001,507242,Cuomo; Raphael Eduardo,9999,0,9999,0
1713510179607,CSE 191,A00,516875,Minnes Kemp; Mor Mia,9999,0,9999,0
1713510180642,CSS 201S,A01,494383,Staff,35,0,35,0
1713510181667,CSS 202S,A01,494387,Staff,35,0,35,0
1713510182691,EAP 100,A00,516065,Staff,9792,0,9999,207
1713510183740,ECE 45,A01,507414,Staff,37,0,60,23
1713510184767,ECE 100,A01,507416,Baghdadchi; Saharnaz,0,0,20,20
1713510184767,ECE 100,A02,507418,Baghdadchi; Saharnaz,19,0,20,1
1713510185793,ECE 111,A01,507420,Staff,27,0,50,23
1713510186818,ECE 197,001,548057,Sievenpiper; Daniel F.,9998,0,9999,1
1713510187843,EDS 115,A00,507243,Choi; Bailey Miyeon,27,0,28,1
1713510188871,EDS 117,A01,494379,Staff,15,0,25,10
1713510189897,EDS 125,A00,507246,Hopkins; Megan Beth,27,0,30,3
1713510190928,EDS 128A,A01,507264,Fargason; Sharon Gayle,26,0,26,0
1713510191961,EDS 128B,A01,507293,Pappas; Elizabeth,30,0,30,0
1713510192992,EDS 139,A00,507294,Fargason; Sharon Gayle,30,0,30,0
1713510192992,EDS 139,B00,507313,Pappas; Elizabeth,30,0,30,0
1713510194018,EDS 201,A00,507315,Staff,18,0,30,12
1713510195054,EDS 203,A01,507317,Halter; Christopher P.,17,0,30,13
1713510196082,EDS 204R,A01,507319,Halter; Christopher P.,0,1,30,30
1713510196082,EDS 204R,B01,507331,Heinzman; Erica M.,22,0,30,8
1713510197114,EDS 206R,A00,507332,Staff,0,2,30,30
1713510197114,EDS 206R,B00,507343,Staff,23,0,30,7
1713510198151,EDS 250,A00,507344,Hemans; Patricia Ann Benitez,27,0,40,13
1713510199187,EDS 281,A00,507345,Daly; Alan J.,18,0,18,0
1713510200214,EDS 284,A00,507350,Daly; Alan J.,16,0,16,0
1713510201241,EDS 286,A00,507359,Fine; Sarah,18,0,18,0
1713510202267,EDS 289C,A01,507361,Daly; Alan J.,18,0,18,0
1713510203293,EDS 290,A00,507366,Hofstetter; Carolyn,15,0,15,0
1713510204320,LIGM 5A,A00,507421,Fischer-Grunski; Eva K,20,0,20,0
1713510205352,LIGM 5B,A00,507423,Fischer-Grunski; Eva K,20,0,20,0
1713510206382,LIGM 5C,A00,507425,Fischer-Grunski; Eva K,20,0,20,0
1713510207411,LIIT 5AS,A00,507427,Carnelos; Chiara,20,0,20,0
1713510208436,LIIT 5BS,A00,507430,Carnelos; Chiara,20,0,20,0
1713510209463,LIIT 5CS,A00,507432,Carnelos; Chiara,20,0,20,0
1713510210497,LISP 5A,A00,507541,Munoz Sanchez; Alicia,14,0,20,6
1713510211524,LISP 5B,A00,507671,Munoz Sanchez; Alicia,12,0,20,8
1713510212550,LISP 5C,A00,507696,Munoz Sanchez; Alicia,11,0,20,9
1713510213583,MAE 197,001,528363,Boechler; Nicholas Sebastia,9998,0,9999,1
1713510214618,MATH 197,001,523477,Kedlaya; Kiran S.,9999,0,9999,0
1713510214618,MATH 197,002,563811,Zhang; Danna,9998,0,9999,1
1713510215645,MCWP 40R,A00,518780,Staff,13,0,20,7
1713510215645,MCWP 40R,B00,518781,Staff,11,0,20,9
1713510215645,MCWP 40R,C00,518783,Staff,8,0,20,12
1713510216671,MCWP 50R,A00,518791,Staff,7,0,20,13
1713510216671,MCWP 50R,B00,518792,Staff,3,0,20,17
1713510216671,MCWP 50R,C00,518793,Staff,5,0,20,15
1713510216671,MCWP 50R,D00,518794,Staff,0,0,20,20
1713510216671,MCWP 50R,E00,518795,Staff,0,0,20,20
1713510216671,MCWP 50R,F00,518796,Staff,11,0,20,9
1713510216671,MCWP 50R,G00,518797,Staff,10,0,20,10
1713510217700,MMW 12R,A01,514034,Herbst; Matthew,1,0,16,15
1713510217700,MMW 12R,A02,514035,Herbst; Matthew,13,0,16,3
1713510218726,MMW 13R,A01,514037,Staff,0,8,16,16
1713510218726,MMW 13R,A02,514039,Staff,0,7,16,16
1713510220778,SIO 295LS,A00,523233,Staff,15,0,30,15
1713510221807,SIO 295S,A00,523232,Staff,15,0,30,15
1713510222834,SOCI 117,A01,494376,Staff,0,2,5,5
1713510223862,WES 237B,A00,494380,Staff,19,0,20,1
1713510225952,AESE 279B,A00,494370,Wade; Jon P,33,0,33,0
1713510226980,AIP 197,001,627712,Vespa; Emanuel Ignacio,9999,0,9999,0
1713510228007,ANAR 135S,A00,494369,Braswell; Geoffrey E.,0,0,0,0
1713510229042,CAT 124RS,A01,519847,Geibel; William,6,0,20,14
1713510230072,CAT 125RS,A01,515971,Geibel; William,6,0,20,14
1713510231104,CLRE 250,A00,511389,Morris; Sheldon,9996,0,9999,3
1713510232141,CLRE 251,A00,507176,Mehta; Ravindra L.,9996,0,9999,3
1713510232141,CLRE 251,B00,511410,Mehta; Ravindra L.,9998,0,9999,1
1713510233168,CLRE 252,A00,507189,Cuomo; Raphael Eduardo,9998,0,9999,1
1713510234195,CLRE 253,A00,507199,Vaida; Florin,9997,0,9999,2
1713510234195,CLRE 253,B00,507202,Vaida; Florin,9999,0,9999,0
1713510235226,CLRE 259,A00,507211,Patel; Hemal,9996,0,9999,3
1713510236257,CLRE 260,A00,507221,Cuomo; Raphael Eduardo,9999,0,9999,0
1713510237282,CLRE 297,001,507242,Cuomo; Raphael Eduardo,9999,0,9999,0
1713510238309,CSE 191,A00,516875,Minnes Kemp; Mor Mia,9999,0,9999,0
1713510239335,CSS 201S,A01,494383,Staff,35,0,35,0
1713510240370,CSS 202S,A01,494387,Staff,35,0,35,0
1713510241394,EAP 100,A00,516065,Staff,9792,0,9999,207
1713510242422,ECE 45,A01,507414,Staff,37,0,60,23
1713510243447,ECE 100,A01,507416,Baghdadchi; Saharnaz,0,0,20,20
1713510243447,ECE 100,A02,507418,Baghdadchi; Saharnaz,19,0,20,1
1713510244477,ECE 111,A01,507420,Staff,27,0,50,23
1713510245501,ECE 197,001,548057,Sievenpiper; Daniel F.,9998,0,9999,1
1713510246529,EDS 115,A00,507243,Choi; Bailey Miyeon,27,0,28,1
1713510247557,EDS 117,A01,494379,Staff,15,0,25,10
1713510248644,EDS 125,A00,507246,Hopkins; Megan Beth,27,0,30,3
1713510249678,EDS 128A,A01,507264,Fargason; Sharon Gayle,26,0,26,0
1713510250705,EDS 128B,A01,507293,Pappas; Elizabeth,30,0,30,0
1713510251732,EDS 139,A00,507294,Fargason; Sharon Gayle,30,0,30,0
1713510251732,EDS 139,B00,507313,Pappas; Elizabeth,30,0,30,0
1713510252758,EDS 201,A00,507315,Staff,18,0,30,12
1713510253795,EDS 203,A01,507317,Halter; Christopher P.,17,0,30,13
1713510254822,EDS 204R,A01,507319,Halter; Christopher P.,0,1,30,30
1713510254822,EDS 204R,B01,507331,Heinzman; Erica M.,22,0,30,8
1713510255987,EDS 206R,A00,507332,Staff,0,2,30,30
1713510255987,EDS 206R,B00,507343,Staff,23,0,30,7
1713510257012,EDS 250,A00,507344,Hemans; Patricia Ann Benitez,27,0,40,13
1713510258043,EDS 281,A00,507345,Daly; Alan J.,18,0,18,0
1713510259068,EDS 284,A00,507350,Daly; Alan J.,16,0,16,0
1713510260099,EDS 286,A00,507359,Fine; Sarah,18,0,18,0
1713510261125,EDS 289C,A01,507361,Daly; Alan J.,18,0,18,0
1713510262150,EDS 290,A00,507366,Hofstetter; Carolyn,15,0,15,0
1713510263176,LIGM 5A,A00,507421,Fischer-Grunski; Eva K,20,0,20,0
1713510264203,LIGM 5B,A00,507423,Fischer-Grunski; Eva K,20,0,20,0
1713510265233,LIGM 5C,A00,507425,Fischer-Grunski; Eva K,20,0,20,0
1713510266259,LIIT 5AS,A00,507427,Carnelos; Chiara,20,0,20,0
1713510267284,LIIT 5BS,A00,507430,Carnelos; Chiara,20,0,20,0
1713510268320,LIIT 5CS,A00,507432,Carnelos; Chiara,20,0,20,0
1713510269347,LISP 5A,A00,507541,Munoz Sanchez; Alicia,14,0,20,6
1713510270374,LISP 5B,A00,507671,Munoz Sanchez; Alicia,12,0,20,8
1713510271399,LISP 5C,A00,507696,Munoz Sanchez; Alicia,11,0,20,9
1713510272423,MAE 197,001,528363,Boechler; Nicholas Sebastia,9998,0,9999,1
1713510273457,MATH 197,001,523477,Kedlaya; Kiran S.,9999,0,9999,0
1713510273457,MATH 197,002,563811,Zhang; Danna,9998,0,9999,1
1713510274482,MCWP 40R,A00,518780,Staff,13,0,20,7
1713510274482,MCWP 40R,B00,518781,Staff,11,0,20,9
1713510274482,MCWP 40R,C00,518783,Staff,8,0,20,12
1713510275510,MCWP 50R,A00,518791,Staff,7,0,20,13
1713510275510,MCWP 50R,B00,518792,Staff,3,0,20,17
1713510275510,MCWP 50R,C00,518793,Staff,5,0,20,15
1713510275510,MCWP 50R,D00,518794,Staff,0,0,20,20
1713510275510,MCWP 50R,E00,518795,Staff,0,0,20,20
1713510275510,MCWP 50R,F00,518796,Staff,11,0,20,9
1713510275510,MCWP 50R,G00,518797,Staff,10,0,20,10
1713510276550,MMW 12R,A01,514034,Herbst; Matthew,1,0,16,15
1713510276550,MMW 12R,A02,514035,Herbst; Matthew,13,0,16,3
1713510277575,MMW 13R,A01,514037,Staff,0,8,16,16
1713510277575,MMW 13R,A02,514039,Staff,0,7,16,16
1713510279629,SIO 295LS,A00,523233,Staff,15,0,30,15
1713510280654,SIO 295S,A00,523232,Staff,15,0,30,15
1713510281680,SOCI 117,A01,494376,Staff,0,2,5,5
1713510282705,WES 237B,A00,494380,Staff,19,0,20,1
1713510284783,AESE 279B,A00,494370,Wade; Jon P,33,0,33,0
1713510285814,AIP 197,001,627712,Vespa; Emanuel Ignacio,9999,0,9999,0
1713510286839,ANAR 135S,A00,494369,Braswell; Geoffrey E.,0,0,0,0
1713510287868,CAT 124RS,A01,519847,Geibel; William,6,0,20,14
1713510288894,CAT 125RS,A01,515971,Geibel; William,6,0,20,14
1713510289928,CLRE 250,A00,511389,Morris; Sheldon,9996,0,9999,3
1713510290956,CLRE 251,A00,507176,Mehta; Ravindra L.,9996,0,9999,3
1713510290956,CLRE 251,B00,511410,Mehta; Ravindra L.,9998,0,9999,1
1713510291986,CLRE 252,A00,507189,Cuomo; Raphael Eduardo,9998,0,9999,1
1713510293013,CLRE 253,A00,507199,Vaida; Florin,9997,0,9999,2
1713510293013,CLRE 253,B00,507202,Vaida; Florin,9999,0,9999,0
1713510294039,CLRE 259,A00,507211,Patel; Hemal,9996,0,9999,3
1713510295070,CLRE 260,A00,507221,Cuomo; Raphael Eduardo,9999,0,9999,0
1713510296099,CLRE 297,001,507242,Cuomo; Raphael Eduardo,9999,0,9999,0
1713510297126,CSE 191,A00,516875,Minnes Kemp; Mor Mia,9999,0,9999,0
1713510298152,CSS 201S,A01,494383,Staff,35,0,35,0
1713510299184,CSS 202S,A01,494387,Staff,35,0,35,0
1713510300209,EAP 100,A00,516065,Staff,9792,0,9999,207
1713510301236,ECE 45,A01,507414,Staff,37,0,60,23
1713510302262,ECE 100,A01,507416,Baghdadchi; Saharnaz,0,0,20,20
1713510302262,ECE 100,A02,507418,Baghdadchi; Saharnaz,19,0,20,1
1713510303288,ECE 111,A01,507420,Staff,27,0,50,23
1713510304323,ECE 197,001,548057,Sievenpiper; Daniel F.,9998,0,9999,1
1713510305351,EDS 115,A00,507243,Choi; Bailey Miyeon,27,0,28,1
1713510306378,EDS 117,A01,494379,Staff,15,0,25,10
1713510307403,EDS 125,A00,507246,Hopkins; Megan Beth,27,0,30,3
1713510308438,EDS 128A,A01,507264,Fargason; Sharon Gayle,26,0,26,0
1713510309465,EDS 128B,A01,507293,Pappas; Elizabeth,30,0,30,0
1713510310494,EDS 139,A00,507294,Fargason; Sharon Gayle,30,0,30,0
1713510310494,EDS 139,B00,507313,Pappas; Elizabeth,30,0,30,0
1713510311520,EDS 201,A00,507315,Staff,18,0,30,12
1713510312547,EDS 203,A01,507317,Halter; Christopher P.,17,0,30,13
1713510313572,EDS 204R,A01,507319,Halter; Christopher P.,0,1,30,30
1713510313572,EDS 204R,B01,507331,Heinzman; Erica M.,22,0,30,8
1713510314603,EDS 206R,A00,507332,Staff,0,2,30,30
1713510314603,EDS 206R,B00,507343,Staff,23,0,30,7
1713510315630,EDS 250,A00,507344,Hemans; Patricia Ann Benitez,27,0,40,13
1713510316656,EDS 281,A00,507345,Daly; Alan J.,18,0,18,0
1713510317684,EDS 284,A00,507350,Daly; Alan J.,16,0,16,0
1713510318751,EDS 286,A00,507359,Fine; Sarah,18,0,18,0
1713510319776,EDS 289C,A01,507361,Daly; Alan J.,18,0,18,0
1713510320802,EDS 290,A00,507366,Hofstetter; Carolyn,15,0,15,0
1713510321834,LIGM 5A,A00,507421,Fischer-Grunski; Eva K,20,0,20,0
1713510322859,LIGM 5B,A00,507423,Fischer-Grunski; Eva K,20,0,20,0
1713510323904,LIGM 5C,A00,507425,Fischer-Grunski; Eva K,20,0,20,0
1713510324932,LIIT 5AS,A00,507427,Carnelos; Chiara,20,0,20,0
1713510325963,LIIT 5BS,A00,507430,Carnelos; Chiara,20,0,20,0
1713510326989,LIIT 5CS,A00,507432,Carnelos; Chiara,20,0,20,0
1713510328014,LISP 5A,A00,507541,Munoz Sanchez; Alicia,14,0,20,6
1713510329045,LISP 5B,A00,507671,Munoz Sanchez; Alicia,12,0,20,8
1713510330071,LISP 5C,A00,507696,Munoz Sanchez; Alicia,11,0,20,9
1713510331096,MAE 197,001,528363,Boechler; Nicholas Sebastia,9998,0,9999,1
1713510332123,MATH 197,001,523477,Kedlaya; Kiran S.,9999,0,9999,0
1713510332123,MATH 197,002,563811,Zhang; Danna,9998,0,9999,1
1713510333153,MCWP 40R,A00,518780,Staff,13,0,20,7
1713510333153,MCWP 40R,B00,518781,Staff,11,0,20,9
1713510333153,MCWP 40R,C00,518783,Staff,8,0,20,12
1713510334180,MCWP 50R,A00,518791,Staff,7,0,20,13
1713510334180,MCWP 50R,B00,518792,Staff,3,0,20,17
1713510334180,MCWP 50R,C00,518793,Staff,5,0,20,15
1713510334180,MCWP 50R,D00,518794,Staff,0,0,20,20
1713510334180,MCWP 50R,E00,518795,Staff,0,0,20,20
1713510334180,MCWP 50R,F00,518796,Staff,11,0,20,9
1713510334180,MCWP 50R,G00,518797,Staff,10,0,20,10
1713510335210,MMW 12R,A01,514034,Herbst; Matthew,1,0,16,15
1713510335210,MMW 12R,A02,514035,Herbst; Matthew,13,0,16,3
1713510336235,MMW 13R,A01,514037,Staff,0,8,16,16
1713510336235,MMW 13R,A02,514039,Staff,0,7,16,16
1713510338295,SIO 295LS,A00,523233,Staff,15,0,30,15
1713510339320,SIO 295S,A00,523232,Staff,15,0,30,15
1713510340347,SOCI 117,A01,494376,Staff,0,2,5,5
1713510341373,WES 237B,A00,494380,Staff,19,0,20,1
1713510343450,AESE 279B,A00,494370,Wade; Jon P,33,0,33,0
1713510344476,AIP 197,001,627712,Vespa; Emanuel Ignacio,9999,0,9999,0
1713510345502,ANAR 135S,A00,494369,Braswell; Geoffrey E.,0,0,0,0
1713510346535,CAT 124RS,A01,519847,Geibel; William,6,0,20,14
1713510347566,CAT 125RS,A01,515971,Geibel; William,6,0,20,14
1713510348593,CLRE 250,A00,511389,Morris; Sheldon,9996,0,9999,3
1713510349622,CLRE 251,A00,507176,Mehta; Ravindra L.,9996,0,9999,3
1713510349622,CLRE 251,B00,511410,Mehta; Ravindra L.,9998,0,9999,1
1713510350653,CLRE 252,A00,507189,Cuomo; Raphael Eduardo,9998,0,9999,1
1713510351687,CLRE 253,A00,507199,Vaida; Florin,9997,0,9999,2
1713510351687,CLRE 253,B00,507202,Vaida; Florin,9999,0,9999,0
1713510352774,CLRE 259,A00,507211,Patel; Hemal,9996,0,9999,3
1713510353800,CLRE 260,A00,507221,Cuomo; Raphael Eduardo,9999,0,9999,0
1713510354824,CLRE 297,001,507242,Cuomo; Raphael Eduardo,9999,0,9999,0
1713510355851,CSE 191,A00,516875,Minnes Kemp; Mor Mia,9999,0,9999,0
1713510356879,CSS 201S,A01,494383,Staff,35,0,35,0
1713510357908,CSS 202S,A01,494387,Staff,35,0,35,0
1713510358938,EAP 100,A00,516065,Staff,9792,0,9999,207
1713510359963,ECE 45,A01,507414,Staff,37,0,60,23
1713510360989,ECE 100,A01,507416,Baghdadchi; Saharnaz,0,0,20,20
1713510360989,ECE 100,A02,507418,Baghdadchi; Saharnaz,19,0,20,1
1713510362021,ECE 111,A01,507420,Staff,27,0,50,23
1713510363057,ECE 197,001,548057,Sievenpiper; Daniel F.,9998,0,9999,1
1713510364084,EDS 115,A00,507243,Choi; Bailey Miyeon,27,0,28,1
1713510365117,EDS 117,A01,494379,Staff,15,0,25,10
1713510366149,EDS 125,A00,507246,Hopkins; Megan Beth,27,0,30,3
1713510367182,EDS 128A,A01,507264,Fargason; Sharon Gayle,26,0,26,0
1713510368210,EDS 128B,A01,507293,Pappas; Elizabeth,30,0,30,0
1713510369237,EDS 139,A00,507294,Fargason; Sharon Gayle,30,0,30,0
1713510369237,EDS 139,B00,507313,Pappas; Elizabeth,30,0,30,0
1713510370267,EDS 201,A00,507315,Staff,18,0,30,12
1713510371293,EDS 203,A01,507317,Halter; Christopher P.,17,0,30,13
1713510372319,EDS 204R,A01,507319,Halter; Christopher P.,0,1,30,30
1713510372319,EDS 204R,B01,507331,Heinzman; Erica M.,22,0,30,8
1713510373345,EDS 206R,A00,507332,Staff,0,2,30,30
1713510373345,EDS 206R,B00,507343,Staff,23,0,30,7
1713510374371,EDS 250,A00,507344,Hemans; Patricia Ann Benitez,27,0,40,13
1713510375400,EDS 281,A00,507345,Daly; Alan J.,18,0,18,0
1713510376426,EDS 284,A00,507350,Daly; Alan J.,16,0,16,0
1713510377453,EDS 286,A00,507359,Fine; Sarah,18,0,18,0
1713510378478,EDS 289C,A01,507361,Daly; Alan J.,18,0,18,0
1713510379541,EDS 290,A00,507366,Hofstetter; Carolyn,15,0,15,0
1713510380569,LIGM 5A,A00,507421,Fischer-Grunski; Eva K,20,0,20,0
1713510381599,LIGM 5B,A00,507423,Fischer-Grunski; Eva K,20,0,20,0
1713510382626,LIGM 5C,A00,507425,Fischer-Grunski; Eva K,20,0,20,0
1713510383659,LIIT 5AS,A00,507427,Carnelos; Chiara,20,0,20,0
1713510384686,LIIT 5BS,A00,507430,Carnelos; Chiara,20,0,20,0
1713510385717,LIIT 5CS,A00,507432,Carnelos; Chiara,20,0,20,0
1713510386746,LISP 5A,A00,507541,Munoz Sanchez; Alicia,14,0,20,6
1713510387779,LISP 5B,A00,507671,Munoz Sanchez; Alicia,12,0,20,8
1713510388814,LISP 5C,A00,507696,Munoz Sanchez; Alicia,11,0,20,9
1713510389839,MAE 197,001,528363,Boechler; Nicholas Sebastia,9998,0,9999,1
1713510390867,MATH 197,001,523477,Kedlaya; Kiran S.,9999,0,9999,0
1713510390867,MATH 197,002,563811,Zhang; Danna,9998,0,9999,1
1713510391894,MCWP 40R,A00,518780,Staff,13,0,20,7
1713510391894,MCWP 40R,B00,518781,Staff,11,0,20,9
1713510391894,MCWP 40R,C00,518783,Staff,8,0,20,12
1713510392926,MCWP 50R,A00,518791,Staff,7,0,20,13
1713510392926,MCWP 50R,B00,518792,Staff,3,0,20,17
1713510392926,MCWP 50R,C00,518793,Staff,5,0,20,15
1713510392926,MCWP 50R,D00,518794,Staff,0,0,20,20
1713510392926,MCWP 50R,E00,518795,Staff,0,0,20,20
1713510392926,MCWP 50R,F00,518796,Staff,11,0,20,9
1713510392926,MCWP 50R,G00,518797,Staff,10,0,20,10
1713510393954,MMW 12R,A01,514034,Herbst; Matthew,1,0,16,15
1713510393954,MMW 12R,A02,514035,Herbst; Matthew,13,0,16,3
1713510394979,MMW 13R,A01,514037,Staff,0,8,16,16
1713510394979,MMW 13R,A02,514039,Staff,0,7,16,16
1713510397035,SIO 295LS,A00,523233,Staff,15,0,30,15
1713510398060,SIO 295S,A00,523232,Staff,15,0,30,15
1713510399090,SOCI 117,A01,494376,Staff,0,2,5,5
1713510400127,WES 237B,A00,494380,Staff,19,0,20,1
1713510402212,AESE 279B,A00,494370,Wade; Jon P,33,0,33,0
1713510403238,AIP 197,001,627712,Vespa; Emanuel Ignacio,9999,0,9999,0
1713510404264,ANAR 135S,A00,494369,Braswell; Geoffrey E.,0,0,0,0
1713510405292,CAT 124RS,A01,519847,Geibel; William,6,0,20,14
1713510406324,CAT 125RS,A01,515971,Geibel; William,6,0,20,14
1713510407350,CLRE 250,A00,511389,Morris; Sheldon,9996,0,9999,3
1713510408378,CLRE 251,A00,507176,Mehta; Ravindra L.,9996,0,9999,3
1713510408378,CLRE 251,B00,511410,Mehta; Ravindra L.,9998,0,9999,1
1713510409405,CLRE 252,A00,507189,Cuomo; Raphael Eduardo,9998,0,9999,1
1713510410430,CLRE 253,A00,507199,Vaida; Florin,9997,0,9999,2
1713510410430,CLRE 253,B00,507202,Vaida; Florin,9999,0,9999,0
1713510411455,CLRE 259,A00,507211,Patel; Hemal,9996,0,9999,3
1713510412481,CLRE 260,A00,507221,Cuomo; Raphael Eduardo,9999,0,9999,0
1713510413507,CLRE 297,001,507242,Cuomo; Raphael Eduardo,9999,0,9999,0
1713510414539,CSE 191,A00,516875,Minnes Kemp; Mor Mia,9999,0,9999,0
1713510415564,CSS 201S,A01,494383,Staff,35,0,35,0
1713510416592,CSS 202S,A01,494387,Staff,35,0,35,0
1713510417620,EAP 100,A00,516065,Staff,9792,0,9999,207
1713510418646,ECE 45,A01,507414,Staff,37,0,60,23
1713510419676,ECE 100,A01,507416,Baghdadchi; Saharnaz,0,0,20,20
1713510419676,ECE 100,A02,507418,Baghdadchi; Saharnaz,19,0,20,1
1713510420703,ECE 111,A01,507420,Staff,27,0,50,23
1713510421728,ECE 197,001,548057,Sievenpiper; Daniel F.,9998,0,9999,1
1713510422754,EDS 115,A00,507243,Choi; Bailey Miyeon,27,0,28,1
1713510423785,EDS 117,A01,494379,Staff,15,0,25,10
1713510424812,EDS 125,A00,507246,Hopkins; Megan Beth,27,0,30,3
1713510425845,EDS 128A,A01,507264,Fargason; Sharon Gayle,26,0,26,0
1713510426870,EDS 128B,A01,507293,Pappas; Elizabeth,30,0,30,0
1713510427895,EDS 139,A00,507294,Fargason; Sharon Gayle,30,0,30,0
1713510427895,EDS 139,B00,507313,Pappas; Elizabeth,30,0,30,0
1713510428921,EDS 201,A00,507315,Staff,18,0,30,12
1713510429950,EDS 203,A01,507317,Halter; Christopher P.,17,0,30,13
1713510430976,EDS 204R,A01,507319,Halter; Christopher P.,0,1,30,30
1713510430976,EDS 204R,B01,507331,Heinzman; Erica M.,22,0,30,8
1713510432002,EDS 206R,A00,507332,Staff,0,2,30,30
1713510432002,EDS 206R,B00,507343,Staff,23,0,30,7
1713510433027,EDS 250,A00,507344,Hemans; Patricia Ann Benitez,27,0,40,13
1713510434058,EDS 281,A00,507345,Daly; Alan J.,18,0,18,0
1713510435081,EDS 284,A00,507350,Daly; Alan J.,16,0,16,0
1713510436108,EDS 286,A00,507359,Fine; Sarah,18,0,18,0
1713510437131,EDS 289C,A01,507361,Daly; Alan J.,18,0,18,0
1713510438163,EDS 290,A00,507366,Hofstetter; Carolyn,15,0,15,0
1713510439191,LIGM 5A,A00,507421,Fischer-Grunski; Eva K,20,0,20,0
1713510440221,LIGM 5B,A00,507423,Fischer-Grunski; Eva K,20,0,20,0
1713510441246,LIGM 5C,A00,507425,Fischer-Grunski; Eva K,20,0,20,0
1713510442273,LIIT 5AS,A00,507427,Carnelos; Chiara,20,0,20,0
1713510443300,LIIT 5BS,A00,507430,Carnelos; Chiara,20,0,20,0
1713510444327,LIIT 5CS,A00,507432,Carnelos; Chiara,20,0,20,0
1713510445353,LISP 5A,A00,507541,Munoz Sanchez; Alicia,14,0,20,6
1713510446382,LISP 5B,A00,507671,Munoz Sanchez; Alicia,12,0,20,8
1713510447410,LISP 5C,A00,507696,Munoz Sanchez; Alicia,11,0,20,9
1713510448439,MAE 197,001,528363,Boechler; Nicholas Sebastia,9998,0,9999,1
1713510449473,MATH 197,001,523477,Kedlaya; Kiran S.,9999,0,9999,0
1713510449473,MATH 197,002,563811,Zhang; Danna,9998,0,9999,1
1713510450499,MCWP 40R,A00,518780,Staff,13,0,20,7
1713510450499,MCWP 40R,B00,518781,Staff,11,0,20,9
1713510450499,MCWP 40R,C00,518783,Staff,8,0,20,12
1713510451524,MCWP 50R,A00,518791,Staff,7,0,20,13
1713510451524,MCWP 50R,B00,518792,Staff,3,0,20,17
1713510451524,MCWP 50R,C00,518793,Staff,5,0,20,15
1713510451524,MCWP 50R,D00,518794,Staff,0,0,20,20
1713510451524,MCWP 50R,E00,518795,Staff,0,0,20,20
1713510451524,MCWP 50R,F00,518796,Staff,11,0,20,9
1713510451524,MCWP 50R,G00,518797,Staff,10,0,20,10
1713510452550,MMW 12R,A01,514034,Herbst; Matthew,1,0,16,15
1713510452550,MMW 12R,A02,514035,Herbst; Matthew,13,0,16,3
1713510453579,MMW 13R,A01,514037,Staff,0,8,16,16
1713510453579,MMW 13R,A02,514039,Staff,0,7,16,16
1713510455637,SIO 295LS,A00,523233,Staff,15,0,30,15
1713510456737,SIO 295S,A00,523232,Staff,15,0,30,15
1713510457762,SOCI 117,A01,494376,Staff,0,2,5,5
1713510458789,WES 237B,A00,494380,Staff,19,0,20,1
1713510460872,AESE 279B,A00,494370,Wade; Jon P,33,0,33,0
1713510461897,AIP 197,001,627712,Vespa; Emanuel Ignacio,9999,0,9999,0
1713510462923,ANAR 135S,A00,494369,Braswell; Geoffrey E.,0,0,0,0
1713510463953,CAT 124RS,A01,519847,Geibel; William,6,0,20,14
1713510464978,CAT 125RS,A01,515971,Geibel; William,6,0,20,14
1713510466008,CLRE 250,A00,511389,Morris; Sheldon,9996,0,9999,3
1713510467035,CLRE 251,A00,507176,Mehta; Ravindra L.,9996,0,9999,3
1713510467035,CLRE 251,B00,511410,Mehta; Ravindra L.,9998,0,9999,1
1713510468069,CLRE 252,A00,507189,Cuomo; Raphael Eduardo,9998,0,9999,1
1713510469101,CLRE 253,A00,507199,Vaida; Florin,9997,0,9999,2
1713510469101,CLRE 253,B00,507202,Vaida; Florin,9999,0,9999,0
1713510470128,CLRE 259,A00,507211,Patel; Hemal,9996,0,9999,3
1713510471152,CLRE 260,A00,507221,Cuomo; Raphael Eduardo,9999,0,9999,0
1713510472183,CLRE 297,001,507242,Cuomo; Raphael Eduardo,9999,0,9999,0
1713510473213,CSE 191,A00,516875,Minnes Kemp; Mor Mia,9999,0,9999,0
1713510474240,CSS 201S,A01,494383,Staff,35,0,35,0
1713510475266,CSS 202S,A01,494387,Staff,35,0,35,0
1713510476296,EAP 100,A00,516065,Staff,9792,0,9999,207
1713510477325,ECE 45,A01,507414,Staff,37,0,60,23
1713510478353,ECE 100,A01,507416,Baghdadchi; Saharnaz,0,0,20,20
1713510478353,ECE 100,A02,507418,Baghdadchi; Saharnaz,19,0,20,1
1713510479431,ECE 111,A01,507420,Staff,27,0,50,23
1713510480465,ECE 197,001,548057,Sievenpiper; Daniel F.,9998,0,9999,1
1713510481490,EDS 115,A00,507243,Choi; Bailey Miyeon,27,0,28,1
1713510482516,EDS 117,A01,494379,Staff,15,0,25,10
1713510483543,EDS 125,A00,507246,Hopkins; Megan Beth,27,0,30,3
1713510484573,EDS 128A,A01,507264,Fargason; Sharon Gayle,26,0,26,0
1713510485603,EDS 128B,A01,507293,Pappas; Elizabeth,30,0,30,0
1713510486629,EDS 139,A00,507294,Fargason; Sharon Gayle,30,0,30,0
1713510486629,EDS 139,B00,507313,Pappas; Elizabeth,30,0,30,0
1713510487657,EDS 201,A00,507315,Staff,18,0,30,12
1713510488684,EDS 203,A01,507317,Halter; Christopher P.,17,0,30,13
1713510489709,EDS 204R,A01,507319,Halter; Christopher P.,0,1,30,30
1713510489709,EDS 204R,B01,507331,Heinzman; Erica M.,22,0,30,8
1713510490736,EDS 206R,A00,507332,Staff,0,2,30,30
1713510490736,EDS 206R,B00,507343,Staff,23,0,30,7
1713510491762,EDS 250,A00,507344,Hemans; Patricia Ann Benitez,27,0,40,13
1713510492788,EDS 281,A00,507345,Daly; Alan J.,18,0,18,0
1713510493813,EDS 284,A00,507350,Daly; Alan J.,16,0,16,0
1713510494852,EDS 286,A00,507359,Fine; Sarah,18,0,18,0
1713510495883,EDS 289C,A01,507361,Daly; Alan J.,18,0,18,0
1713510496909,EDS 290,A00,507366,Hofstetter; Carolyn,15,0,15,0
1713510497938,LIGM 5A,A00,507421,Fischer-Grunski; Eva K,20,0,20,0
1713510498970,LIGM 5B,A00,507423,Fischer-Grunski; Eva K,20,0,20,0
1713510499998,LIGM 5C,A00,507425,Fischer-Grunski; Eva K,20,0,20,0
1713510501032,LIIT 5AS,A00,507427,Carnelos; Chiara,20,0,20,0
1713510502058,LIIT 5BS,A00,507430,Carnelos; Chiara,20,0,20,0
1713510503083,LIIT 5CS,A00,507432,Carnelos; Chiara,20,0,20,0
1713510504108,LISP 5A,A00,507541,Munoz Sanchez; Alicia,14,0,20,6
1713510505135,LISP 5B,A00,507671,Munoz Sanchez; Alicia,12,0,20,8
1713510506161,LISP 5C,A00,507696,Munoz Sanchez; Alicia,11,0,20,9
1713510507186,MAE 197,001,528363,Boechler; Nicholas Sebastia,9998,0,9999,1
1713510508221,MATH 197,001,523477,Kedlaya; Kiran S.,9999,0,9999,0
1713510508221,MATH 197,002,563811,Zhang; Danna,9998,0,9999,1
1713510509249,MCWP 40R,A00,518780,Staff,13,0,20,7
1713510509249,MCWP 40R,B00,518781,Staff,11,0,20,9
1713510509249,MCWP 40R,C00,518783,Staff,8,0,20,12
1713510510280,MCWP 50R,A00,518791,Staff,7,0,20,13
1713510510280,MCWP 50R,B00,518792,Staff,3,0,20,17
1713510510280,MCWP 50R,C00,518793,Staff,5,0,20,15
1713510510280,MCWP 50R,D00,518794,Staff,0,0,20,20
1713510510280,MCWP 50R,E00,518795,Staff,0,0,20,20
1713510510280,MCWP 50R,F00,518796,Staff,11,0,20,9
1713510510280,MCWP 50R,G00,518797,Staff,10,0,20,10
1713510511311,MMW 12R,A01,514034,Herbst; Matthew,1,0,16,15
1713510511311,MMW 12R,A02,514035,Herbst; Matthew,13,0,16,3
1713510512340,MMW 13R,A01,514037,Staff,0,8,16,16
1713510512340,MMW 13R,A02,514039,Staff,0,7,16,16
1713510514396,SIO 295LS,A00,523233,Staff,15,0,30,15
1713510515423,SIO 295S,A00,523232,Staff,15,0,30,15
1713510516456,SOCI 117,A01,494376,Staff,0,2,5,5
1713510517484,WES 237B,A00,494380,Staff,19,0,20,1
1713510519562,AESE 279B,A00,494370,Wade; Jon P,33,0,33,0
1713510520587,AIP 197,001,627712,Vespa; Emanuel Ignacio,9999,0,9999,0
1713510521612,ANAR 135S,A00,494369,Braswell; Geoffrey E.,0,0,0,0
1713510522644,CAT 124RS,A01,519847,Geibel; William,6,0,20,14
1713510523668,CAT 125RS,A01,515971,Geibel; William,6,0,20,14
1713510524695,CLRE 250,A00,511389,Morris; Sheldon,9996,0,9999,3
1713510525726,CLRE 251,A00,507176,Mehta; Ravindra L.,9996,0,9999,3
1713510525726,CLRE 251,B00,511410,Mehta; Ravindra L.,9998,0,9999,1
1713510526756,CLRE 252,A00,507189,Cuomo; Raphael Eduardo,9998,0,9999,1
1713510527787,CLRE 253,A00,507199,Vaida; Florin,9997,0,9999,2
1713510527787,CLRE 253,B00,507202,Vaida; Florin,9999,0,9999,0
1713510528826,CLRE 259,A00,507211,Patel; Hemal,9996,0,9999,3
1713510529855,CLRE 260,A00,507221,Cuomo; Raphael Eduardo,9999,0,9999,0
1713510530880,CLRE 297,001,507242,Cuomo; Raphael Eduardo,9999,0,9999,0
1713510531911,CSE 191,A00,516875,Minnes Kemp; Mor Mia,9999,0,9999,0
1713510532937,CSS 201S,A01,494383,Staff,35,0,35,0
1713510533967,CSS 202S,A01,494387,Staff,35,0,35,0
1713510535046,EAP 100,A00,516065,Staff,9792,0,9999,207
1713510536073,ECE 45,A01,507414,Staff,37,0,60,23
1713510537110,ECE 100,A01,507416,Baghdadchi; Saharnaz,0,0,20,20
1713510537110,ECE 100,A02,507418,Baghdadchi; Saharnaz,19,0,20,1
1713510538140,ECE 111,A01,507420,Staff,27,0,50,23
1713510539166,ECE 197,001,548057,Sievenpiper; Daniel F.,9998,0,9999,1
1713510540206,EDS 115,A00,507243,Choi; Bailey Miyeon,27,0,28,1
1713510541236,EDS 117,A01,494379,Staff,15,0,25,10
1713510542266,EDS 125,A00,507246,Hopkins; Megan Beth,27,0,30,3
1713510543306,EDS 128A,A01,507264,Fargason; Sharon Gayle,26,0,26,0
1713510544337,EDS 128B,A01,507293,Pappas; Elizabeth,30,0,30,0
1713510545368,EDS 139,A00,507294,Fargason; Sharon Gayle,30,0,30,0
1713510545368,EDS 139,B00,507313,Pappas; Elizabeth,30,0,30,0
1713510546397,EDS 201,A00,507315,Staff,18,0,30,12
1713510547423,EDS 203,A01,507317,Halter; Christopher P.,17,0,30,13
1713510548456,EDS 204R,A01,507319,Halter; Christopher P.,0,1,30,30
1713510548456,EDS 204R,B01,507331,Heinzman; Erica M.,22,0,30,8
1713510549486,EDS 206R,A00,507332,Staff,0,2,30,30
1713510549486,EDS 206R,B00,507343,Staff,23,0,30,7
1713510550514,EDS 250,A00,507344,Hemans; Patricia Ann Benitez,27,0,40,13
1713510551540,EDS 281,A00,507345,Daly; Alan J.,18,0,18,0
1713510552567,EDS 284,A00,507350,Daly; Alan J.,16,0,16,0
1713510553598,EDS 286,A00,507359,Fine; Sarah,18,0,18,0
1713510554624,EDS 289C,A01,507361,Daly; Alan J.,18,0,18,0
1713510555651,EDS 290,A00,507366,Hofstetter; Carolyn,15,0,15,0
1713510556677,LIGM 5A,A00,507421,Fischer-Grunski; Eva K,20,0,20,0
1713510557703,LIGM 5B,A00,507423,Fischer-Grunski; Eva K,20,0,20,0
1713510558734,LIGM 5C,A00,507425,Fischer-Grunski; Eva K,20,0,20,0
1713510559760,LIIT 5AS,A00,507427,Carnelos; Chiara,20,0,20,0
1713510560848,LIIT 5BS,A00,507430,Carnelos; Chiara,20,0,20,0
1713510561881,LIIT 5CS,A00,507432,Carnelos; Chiara,20,0,20,0
1713510562907,LISP 5A,A00,507541,Munoz Sanchez; Alicia,14,0,20,6
1713510563933,LISP 5B,A00,507671,Munoz Sanchez; Alicia,12,0,20,8
1713510564960,LISP 5C,A00,507696,Munoz Sanchez; Alicia,11,0,20,9
1713510565985,MAE 197,001,528363,Boechler; Nicholas Sebastia,9998,0,9999,1
1713510567013,MATH 197,001,523477,Kedlaya; Kiran S.,9999,0,9999,0
1713510567013,MATH 197,002,563811,Zhang; Danna,9998,0,9999,1
1713510568043,MCWP 40R,A00,518780,Staff,13,0,20,7
1713510568043,MCWP 40R,B00,518781,Staff,11,0,20,9
1713510568043,MCWP 40R,C00,518783,Staff,8,0,20,12
1713510569080,MCWP 50R,A00,518791,Staff,7,0,20,13
1713510569080,MCWP 50R,B00,518792,Staff,3,0,20,17
1713510569080,MCWP 50R,C00,518793,Staff,5,0,20,15
1713510569080,MCWP 50R,D00,518794,Staff,0,0,20,20
1713510569080,MCWP 50R,E00,518795,Staff,0,0,20,20
1713510569080,MCWP 50R,F00,518796,Staff,11,0,20,9
1713510569080,MCWP 50R,G00,518797,Staff,10,0,20,10
1713510570108,MMW 12R,A01,514034,Herbst; Matthew,1,0,16,15
1713510570108,MMW 12R,A02,514035,Herbst; Matthew,13,0,16,3
1713510571132,MMW 13R,A01,514037,Staff,0,8,16,16
1713510571132,MMW 13R,A02,514039,Staff,0,7,16,16
1713510573189,SIO 295LS,A00,523233,Staff,15,0,30,15
1713510574214,SIO 295S,A00,523232,Staff,15,0,30,15
1713510575241,SOCI 117,A01,494376,Staff,0,2,5,5
1713510576266,WES 237B,A00,494380,Staff,19,0,20,1
1713510578339,AESE 279B,A00,494370,Wade; Jon P,33,0,33,0
1713510579365,AIP 197,001,627712,Vespa; Emanuel Ignacio,9999,0,9999,0
1713510580394,ANAR 135S,A00,494369,Braswell; Geoffrey E.,0,0,0,0
1713510581420,CAT 124RS,A01,519847,Geibel; William,6,0,20,14
1713510582450,CAT 125RS,A01,515971,Geibel; William,6,0,20,14
1713510583480,CLRE 250,A00,511389,Morris; Sheldon,9996,0,9999,3
1713510584506,CLRE 251,A00,507176,Mehta; Ravindra L.,9996,0,9999,3
1713510584506,CLRE 251,B00,511410,Mehta; Ravindra L.,9998,0,9999,1
1713510585539,CLRE 252,A00,507189,Cuomo; Raphael Eduardo,9998,0,9999,1
1713510586570,CLRE 253,A00,507199,Vaida; Florin,9997,0,9999,2
1713510586570,CLRE 253,B00,507202,Vaida; Florin,9999,0,9999,0
1713510587600,CLRE 259,A00,507211,Patel; Hemal,9996,0,9999,3
1713510588628,CLRE 260,A00,507221,Cuomo; Raphael Eduardo,9999,0,9999,0
1713510589658,CLRE 297,001,507242,Cuomo; Raphael Eduardo,9999,0,9999,0
1713510590687,CSE 191,A00,516875,Minnes Kemp; Mor Mia,9999,0,9999,0
1713510591714,CSS 201S,A01,494383,Staff,35,0,35,0
1713510592740,CSS 202S,A01,494387,Staff,35,0,35,0
1713510593769,EAP 100,A00,516065,Staff,9792,0,9999,207
1713510594799,ECE 45,A01,507414,Staff,37,0,60,23
1713510595826,ECE 100,A01,507416,Baghdadchi; Saharnaz,0,0,20,20
1713510595826,ECE 100,A02,507418,Baghdadchi; Saharnaz,19,0,20,1
1713510596852,ECE 111,A01,507420,Staff,27,0,50,23
1713510597879,ECE 197,001,548057,Sievenpiper; Daniel F.,9998,0,9999,1
1713510598906,EDS 115,A00,507243,Choi; Bailey Miyeon,27,0,28,1
1713510599943,EDS 117,A01,494379,Staff,15,0,25,10
1713510600975,EDS 125,A00,507246,Hopkins; Megan Beth,27,0,30,3
1713510602002,EDS 128A,A01,507264,Fargason; Sharon Gayle,26,0,26,0
1713510603027,EDS 128B,A01,507293,Pappas; Elizabeth,30,0,30,0
1713510604053,EDS 139,A00,507294,Fargason; Sharon Gayle,30,0,30,0
1713510604053,EDS 139,B00,507313,Pappas; Elizabeth,30,0,30,0
1713510605078,EDS 201,A00,507315,Staff,18,0,30,12
1713510606112,EDS 203,A01,507317,Halter; Christopher P.,17,0,30,13
1713510607142,EDS 204R,A01,507319,Halter; Christopher P.,0,1,30,30
1713510607142,EDS 204R,B01,507331,Heinzman; Erica M.,22,0,30,8
1713510608168,EDS 206R,A00,507332,Staff,0,2,30,30
1713510608168,EDS 206R,B00,507343,Staff,23,0,30,7
1713510609194,EDS 250,A00,507344,Hemans; Patricia Ann Benitez,27,0,40,13
1713510610220,EDS 281,A00,507345,Daly; Alan J.,18,0,18,0
1713510611246,EDS 284,A00,507350,Daly; Alan J.,16,0,16,0
1713510612277,EDS 286,A00,507359,Fine; Sarah,18,0,18,0
1713510613302,EDS 289C,A01,507361,Daly; Alan J.,18,0,18,0
1713510614332,EDS 290,A00,507366,Hofstetter; Carolyn,15,0,15,0
1713510615358,LIGM 5A,A00,507421,Fischer-Grunski; Eva K,20,0,20,0
1713510616389,LIGM 5B,A00,507423,Fischer-Grunski; Eva K,20,0,20,0
1713510617418,LIGM 5C,A00,507425,Fischer-Grunski; Eva K,20,0,20,0
1713510618445,LIIT 5AS,A00,507427,Carnelos; Chiara,20,0,20,0
1713510619470,LIIT 5BS,A00,507430,Carnelos; Chiara,20,0,20,0
1713510620500,LIIT 5CS,A00,507432,Carnelos; Chiara,20,0,20,0
1713510621526,LISP 5A,A00,507541,Munoz Sanchez; Alicia,14,0,20,6
1713510622559,LISP 5B,A00,507671,Munoz Sanchez; Alicia,12,0,20,8
1713510623592,LISP 5C,A00,507696,Munoz Sanchez; Alicia,11,0,20,9
1713510624618,MAE 197,001,528363,Boechler; Nicholas Sebastia,9998,0,9999,1
1713510625643,MATH 197,001,523477,Kedlaya; Kiran S.,9999,0,9999,0
1713510625643,MATH 197,002,563811,Zhang; Danna,9998,0,9999,1
1713510626669,MCWP 40R,A00,518780,Staff,13,0,20,7
1713510626669,MCWP 40R,B00,518781,Staff,11,0,20,9
1713510626669,MCWP 40R,C00,518783,Staff,8,0,20,12
1713510627694,MCWP 50R,A00,518791,Staff,7,0,20,13
1713510627694,MCWP 50R,B00,518792,Staff,3,0,20,17
1713510627694,MCWP 50R,C00,518793,Staff,5,0,20,15
1713510627694,MCWP 50R,D00,518794,Staff,0,0,20,20
1713510627694,MCWP 50R,E00,518795,Staff,0,0,20,20
1713510627694,MCWP 50R,F00,518796,Staff,11,0,20,9
1713510627694,MCWP 50R,G00,518797,Staff,10,0,20,10
1713510628724,MMW 12R,A01,514034,Herbst; Matthew,1,0,16,15
1713510628724,MMW 12R,A02,514035,Herbst; Matthew,13,0,16,3
1713510629756,MMW 13R,A01,514037,Staff,0,8,16,16
1713510629756,MMW 13R,A02,514039,Staff,0,7,16,16
1713510631813,SIO 295LS,A00,523233,Staff,15,0,30,15
1713510632847,SIO 295S,A00,523232,Staff,15,0,30,15
1713510633871,SOCI 117,A01,494376,Staff,0,2,5,5
1713510634898,WES 237B,A00,494380,Staff,19,0,20,1
1713510636977,AESE 279B,A00,494370,Wade; Jon P,33,0,33,0
1713510638002,AIP 197,001,627712,Vespa; Emanuel Ignacio,9999,0,9999,0
1713510639028,ANAR 135S,A00,494369,Braswell; Geoffrey E.,0,0,0,0
1713510640055,CAT 124RS,A01,519847,Geibel; William,6,0,20,14
1713510641091,CAT 125RS,A01,515971,Geibel; William,6,0,20,14
1713510642119,CLRE 250,A00,511389,Morris; Sheldon,9996,0,9999,3
1713510643147,CLRE 251,A00,507176,Mehta; Ravindra L.,9996,0,9999,3
1713510643147,CLRE 251,B00,511410,Mehta; Ravindra L.,9998,0,9999,1
1713510644178,CLRE 252,A00,507189,Cuomo; Raphael Eduardo,9998,0,9999,1
1713510645206,CLRE 253,A00,507199,Vaida; Florin,9997,0,9999,2
1713510645206,CLRE 253,B00,507202,Vaida; Florin,9999,0,9999,0
1713510646235,CLRE 259,A00,507211,Patel; Hemal,9996,0,9999,3
1713510647264,CLRE 260,A00,507221,Cuomo; Raphael Eduardo,9999,0,9999,0
1713510648289,CLRE 297,001,507242,Cuomo; Raphael Eduardo,9999,0,9999,0
1713510649316,CSE 191,A00,516875,Minnes Kemp; Mor Mia,9999,0,9999,0
1713510650425,CSS 201S,A01,494383,Staff,35,0,35,0
1713510651449,CSS 202S,A01,494387,Staff,35,0,35,0
1713510652473,EAP 100,A00,516065,Staff,9792,0,9999,207
1713510653503,ECE 45,A01,507414,Staff,37,0,60,23
1713510654535,ECE 100,A01,507416,Baghdadchi; Saharnaz,0,0,20,20
1713510654535,ECE 100,A02,507418,Baghdadchi; Saharnaz,19,0,20,1
1713510655561,ECE 111,A01,507420,Staff,27,0,50,23
1713510656588,ECE 197,001,548057,Sievenpiper; Daniel F.,9998,0,9999,1
1713510657614,EDS 115,A00,507243,Choi; Bailey Miyeon,27,0,28,1
1713510658643,EDS 117,A01,494379,Staff,15,0,25,10
1713510659674,EDS 125,A00,507246,Hopkins; Megan Beth,27,0,30,3
1713510660715,EDS 128A,A01,507264,Fargason; Sharon Gayle,26,0,26,0
1713510661745,EDS 128B,A01,507293,Pappas; Elizabeth,30,0,30,0
1713510662774,EDS 139,A00,507294,Fargason; Sharon Gayle,30,0,30,0
1713510662774,EDS 139,B00,507313,Pappas; Elizabeth,30,0,30,0
1713510663799,EDS 201,A00,507315,Staff,18,0,30,12
1713510664879,EDS 203,A01,507317,Halter; Christopher P.,17,0,30,13
1713510665912,EDS 204R,A01,507319,Halter; Christopher P.,0,1,30,30
1713510665912,EDS 204R,B01,507331,Heinzman; Erica M.,22,0,30,8
1713510666942,EDS 206R,A00,507332,Staff,0,2,30,30
1713510666942,EDS 206R,B00,507343,Staff,23,0,30,7
1713510667969,EDS 250,A00,507344,Hemans; Patricia Ann Benitez,27,0,40,13
1713510668995,EDS 281,A00,507345,Daly; Alan J.,18,0,18,0
1713510670023,EDS 284,A00,507350,Daly; Alan J.,16,0,16,0
1713510671056,EDS 286,A00,507359,Fine; Sarah,18,0,18,0
1713510672083,EDS 289C,A01,507361,Daly; Alan J.,18,0,18,0
1713510673107,EDS 290,A00,507366,Hofstetter; Carolyn,15,0,15,0
1713510674132,LIGM 5A,A00,507421,Fischer-Grunski; Eva K,20,0,20,0
1713510675157,LIGM 5B,A00,507423,Fischer-Grunski; Eva K,20,0,20,0
1713510676191,LIGM 5C,A00,507425,Fischer-Grunski; Eva K,20,0,20,0
1713510677217,LIIT 5AS,A00,507427,Carnelos; Chiara,20,0,20,0
1713510678243,LIIT 5BS,A00,507430,Carnelos; Chiara,20,0,20,0
1713510679278,LIIT 5CS,A00,507432,Carnelos; Chiara,20,0,20,0
1713510680303,LISP 5A,A00,507541,Munoz Sanchez; Alicia,14,0,20,6
1713510681338,LISP 5B,A00,507671,Munoz Sanchez; Alicia,12,0,20,8
1713510682364,LISP 5C,A00,507696,Munoz Sanchez; Alicia,11,0,20,9
1713510683395,MAE 197,001,528363,Boechler; Nicholas Sebastia,9998,0,9999,1
1713510684428,MATH 197,001,523477,Kedlaya; Kiran S.,9999,0,9999,0
1713510684428,MATH 197,002,563811,Zhang; Danna,9998,0,9999,1
1713510685454,MCWP 40R,A00,518780,Staff,13,0,20,7
1713510685454,MCWP 40R,B00,518781,Staff,11,0,20,9
1713510685454,MCWP 40R,C00,518783,Staff,8,0,20,12
1713510686507,MCWP 50R,A00,518791,Staff,7,0,20,13
1713510686507,MCWP 50R,B00,518792,Staff,3,0,20,17
1713510686507,MCWP 50R,C00,518793,Staff,5,0,20,15
1713510686507,MCWP 50R,D00,518794,Staff,0,0,20,20
1713510686507,MCWP 50R,E00,518795,Staff,0,0,20,20
1713510686507,MCWP 50R,F00,518796,Staff,11,0,20,9
1713510686507,MCWP 50R,G00,518797,Staff,10,0,20,10
1713510687534,MMW 12R,A01,514034,Herbst; Matthew,1,0,16,15
1713510687534,MMW 12R,A02,514035,Herbst; Matthew,13,0,16,3
1713510688560,MMW 13R,A01,514037,Staff,0,8,16,16
1713510688560,MMW 13R,A02,514039,Staff,0,7,16,16
1713510690610,SIO 295LS,A00,523233,Staff,15,0,30,15
1713510691641,SIO 295S,A00,523232,Staff,15,0,30,15
1713510692676,SOCI 117,A01,494376,Staff,0,2,5,5
1713510693707,WES 237B,A00,494380,Staff,19,0,20,1
1713510695771,AESE 279B,A00,494370,Wade; Jon P,33,0,33,0
1713510697343,AIP 197,001,627712,Vespa; Emanuel Ignacio,9999,0,9999,0
1713510698369,ANAR 135S,A00,494369,Braswell; Geoffrey E.,0,0,0,0
1713510699394,CAT 124RS,A01,519847,Geibel; William,6,0,20,14
1713510700419,CAT 125RS,A01,515971,Geibel; William,6,0,20,14
1713510701443,CLRE 250,A00,511389,Morris; Sheldon,9996,0,9999,3
1713510702479,CLRE 251,A00,507176,Mehta; Ravindra L.,9996,0,9999,3
1713510702479,CLRE 251,B00,511410,Mehta; Ravindra L.,9998,0,9999,1
1713510703506,CLRE 252,A00,507189,Cuomo; Raphael Eduardo,9998,0,9999,1
1713510704532,CLRE 253,A00,507199,Vaida; Florin,9997,0,9999,2
1713510704532,CLRE 253,B00,507202,Vaida; Florin,9999,0,9999,0
1713510705558,CLRE 259,A00,507211,Patel; Hemal,9996,0,9999,3
1713510706589,CLRE 260,A00,507221,Cuomo; Raphael Eduardo,9999,0,9999,0
1713510707618,CLRE 297,001,507242,Cuomo; Raphael Eduardo,9999,0,9999,0
1713510708647,CSE 191,A00,516875,Minnes Kemp; Mor Mia,9999,0,9999,0
1713510709678,CSS 201S,A01,494383,Staff,35,0,35,0
1713510710713,CSS 202S,A01,494387,Staff,35,0,35,0
1713510711745,EAP 100,A00,516065,Staff,9792,0,9999,207
1713510712777,ECE 45,A01,507414,Staff,37,0,60,23
1713510713801,ECE 100,A01,507416,Baghdadchi; Saharnaz,0,0,20,20
1713510713801,ECE 100,A02,507418,Baghdadchi; Saharnaz,19,0,20,1
1713510714829,ECE 111,A01,507420,Staff,27,0,50,23
1713510715855,ECE 197,001,548057,Sievenpiper; Daniel F.,9998,0,9999,1
1713510716889,EDS 115,A00,507243,Choi; Bailey Miyeon,27,0,28,1
1713510717915,EDS 117,A01,494379,Staff,15,0,25,10
1713510718994,EDS 125,A00,507246,Hopkins; Megan Beth,27,0,30,3
1713510720021,EDS 128A,A01,507264,Fargason; Sharon Gayle,26,0,26,0
1713510721047,EDS 128B,A01,507293,Pappas; Elizabeth,30,0,30,0
1713510722072,EDS 139,A00,507294,Fargason; Sharon Gayle,30,0,30,0
1713510722072,EDS 139,B00,507313,Pappas; Elizabeth,30,0,30,0
1713510723109,EDS 201,A00,507315,Staff,18,0,30,12
1713510724135,EDS 203,A01,507317,Halter; Christopher P.,17,0,30,13
1713510725162,EDS 204R,A01,507319,Halter; Christopher P.,0,1,30,30
1713510725162,EDS 204R,B01,507331,Heinzman; Erica M.,22,0,30,8
1713510726188,EDS 206R,A00,507332,Staff,0,2,30,30
1713510726188,EDS 206R,B00,507343,Staff,23,0,30,7
1713510727215,EDS 250,A00,507344,Hemans; Patricia Ann Benitez,27,0,40,13
1713510728250,EDS 281,A00,507345,Daly; Alan J.,18,0,18,0
1713510729275,EDS 284,A00,507350,Daly; Alan J.,16,0,16,0
1713510730319,EDS 286,A00,507359,Fine; Sarah,18,0,18,0
1713510731345,EDS 289C,A01,507361,Daly; Alan J.,18,0,18,0
1713510732380,EDS 290,A00,507366,Hofstetter; Carolyn,15,0,15,0
1713510733406,LIGM 5A,A00,507421,Fischer-Grunski; Eva K,20,0,20,0
1713510734442,LIGM 5B,A00,507423,Fischer-Grunski; Eva K,20,0,20,0
1713510735466,LIGM 5C,A00,507425,Fischer-Grunski; Eva K,20,0,20,0
1713510736498,LIIT 5AS,A00,507427,Carnelos; Chiara,20,0,20,0
1713510737538,LIIT 5BS,A00,507430,Carnelos; Chiara,20,0,20,0
1713510738573,LIIT 5CS,A00,507432,Carnelos; Chiara,20,0,20,0
1713510739598,LISP 5A,A00,507541,Munoz Sanchez; Alicia,14,0,20,6
1713510740634,LISP 5B,A00,507671,Munoz Sanchez; Alicia,12,0,20,8
1713510741671,LISP 5C,A00,507696,Munoz Sanchez; Alicia,11,0,20,9
1713510742695,MAE 197,001,528363,Boechler; Nicholas Sebastia,9998,0,9999,1
1713510743722,MATH 197,001,523477,Kedlaya; Kiran S.,9999,0,9999,0
1713510743722,MATH 197,002,563811,Zhang; Danna,9998,0,9999,1
1713510744761,MCWP 40R,A00,518780,Staff,13,0,20,7
1713510744761,MCWP 40R,B00,518781,Staff,11,0,20,9
1713510744761,MCWP 40R,C00,518783,Staff,8,0,20,12
1713510745789,MCWP 50R,A00,518791,Staff,7,0,20,13
1713510745789,MCWP 50R,B00,518792,Staff,3,0,20,17
1713510745789,MCWP 50R,C00,518793,Staff,5,0,20,15
1713510745789,MCWP 50R,D00,518794,Staff,0,0,20,20
1713510745789,MCWP 50R,E00,518795,Staff,0,0,20,20
1713510745789,MCWP 50R,F00,518796,Staff,11,0,20,9
1713510745789,MCWP 50R,G00,518797,Staff,10,0,20,10
1713510746815,MMW 12R,A01,514034,Herbst; Matthew,1,0,16,15
1713510746815,MMW 12R,A02,514035,Herbst; Matthew,13,0,16,3
1713510747882,MMW 13R,A01,514037,Staff,0,8,16,16
1713510747882,MMW 13R,A02,514039,Staff,0,7,16,16
1713510749937,SIO 295LS,A00,523233,Staff,15,0,30,15
1713510750964,SIO 295S,A00,523232,Staff,15,0,30,15
1713510752000,SOCI 117,A01,494376,Staff,0,2,5,5
1713510753026,WES 237B,A00,494380,Staff,19,0,20,1
1713510755115,AESE 279B,A00,494370,Wade; Jon P,33,0,33,0
1713510756141,AIP 197,001,627712,Vespa; Emanuel Ignacio,9999,0,9999,0
1713510757172,ANAR 135S,A00,494369,Braswell; Geoffrey E.,0,0,0,0
1713510758205,CAT 124RS,A01,519847,Geibel; William,6,0,20,14
1713510759239,CAT 125RS,A01,515971,Geibel; William,6,0,20,14
1713510760266,CLRE 250,A00,511389,Morris; Sheldon,9996,0,9999,3
1713510761291,CLRE 251,A00,507176,Mehta; Ravindra L.,9996,0,9999,3
1713510761291,CLRE 251,B00,511410,Mehta; Ravindra L.,9998,0,9999,1
1713510762317,CLRE 252,A00,507189,Cuomo; Raphael Eduardo,9998,0,9999,1
1713510763343,CLRE 253,A00,507199,Vaida; Florin,9997,0,9999,2
1713510763343,CLRE 253,B00,507202,Vaida; Florin,9999,0,9999,0
1713510764368,CLRE 259,A00,507211,Patel; Hemal,9996,0,9999,3
1713510765394,CLRE 260,A00,507221,Cuomo; Raphael Eduardo,9999,0,9999,0
1713510766419,CLRE 297,001,507242,Cuomo; Raphael Eduardo,9999,0,9999,0
1713510767445,CSE 191,A00,516875,Minnes Kemp; Mor Mia,9999,0,9999,0
1713510768470,CSS 201S,A01,494383,Staff,35,0,35,0
1713510769557,CSS 202S,A01,494387,Staff,35,0,35,0
1713510770582,EAP 100,A00,516065,Staff,9792,0,9999,207
1713510771607,ECE 45,A01,507414,Staff,37,0,60,23
1713510772642,ECE 100,A01,507416,Baghdadchi; Saharnaz,0,0,20,20
1713510772642,ECE 100,A02,507418,Baghdadchi; Saharnaz,19,0,20,1
1713510773668,ECE 111,A01,507420,Staff,27,0,50,23
1713510774708,ECE 197,001,548057,Sievenpiper; Daniel F.,9998,0,9999,1
1713510775742,EDS 115,A00,507243,Choi; Bailey Miyeon,27,0,28,1
1713510776769,EDS 117,A01,494379,Staff,15,0,25,10
1713510777795,EDS 125,A00,507246,Hopkins; Megan Beth,27,0,30,3
1713510778834,EDS 128A,A01,507264,Fargason; Sharon Gayle,26,0,26,0
1713510779860,EDS 128B,A01,507293,Pappas; Elizabeth,30,0,30,0
1713510780887,EDS 139,A00,507294,Fargason; Sharon Gayle,30,0,30,0
1713510780887,EDS 139,B00,507313,Pappas; Elizabeth,30,0,30,0
1713510781911,EDS 201,A00,507315,Staff,18,0,30,12
1713510782938,EDS 203,A01,507317,Halter; Christopher P.,17,0,30,13
1713510783978,EDS 204R,A01,507319,Halter; Christopher P.,0,1,30,30
1713510783978,EDS 204R,B01,507331,Heinzman; Erica M.,22,0,30,8
1713510785004,EDS 206R,A00,507332,Staff,0,2,30,30
1713510785004,EDS 206R,B00,507343,Staff,23,0,30,7
1713510786041,EDS 250,A00,507344,Hemans; Patricia Ann Benitez,27,0,40,13
1713510787074,EDS 281,A00,507345,Daly; Alan J.,18,0,18,0
1713510788100,EDS 284,A00,507350,Daly; Alan J.,16,0,16,0
1713510789134,EDS 286,A00,507359,Fine; Sarah,18,0,18,0
1713510790161,EDS 289C,A01,507361,Daly; Alan J.,18,0,18,0
1713510791188,EDS 290,A00,507366,Hofstetter; Carolyn,15,0,15,0
1713510792224,LIGM 5A,A00,507421,Fischer-Grunski; Eva K,20,0,20,0
1713510793266,LIGM 5B,A00,507423,Fischer-Grunski; Eva K,20,0,20,0
1713510794315,LIGM 5C,A00,507425,Fischer-Grunski; Eva K,20,0,20,0
1713510795343,LIIT 5AS,A00,507427,Carnelos; Chiara,20,0,20,0
1713510796392,LIIT 5BS,A00,507430,Carnelos; Chiara,20,0,20,0
1713510797418,LIIT 5CS,A00,507432,Carnelos; Chiara,20,0,20,0
1713510798444,LISP 5A,A00,507541,Munoz Sanchez; Alicia,14,0,20,6
1713510799469,LISP 5B,A00,507671,Munoz Sanchez; Alicia,12,0,20,8
1713510800503,LISP 5C,A00,507696,Munoz Sanchez; Alicia,11,0,20,9
1713510801530,MAE 197,001,528363,Boechler; Nicholas Sebastia,9998,0,9999,1
1713510802556,MATH 197,001,523477,Kedlaya; Kiran S.,9999,0,9999,0
1713510802556,MATH 197,002,563811,Zhang; Danna,9998,0,9999,1
1713510803581,MCWP 40R,A00,518780,Staff,13,0,20,7
1713510803581,MCWP 40R,B00,518781,Staff,11,0,20,9
1713510803581,MCWP 40R,C00,518783,Staff,8,0,20,12
1713510804606,MCWP 50R,A00,518791,Staff,7,0,20,13
1713510804606,MCWP 50R,B00,518792,Staff,3,0,20,17
1713510804606,MCWP 50R,C00,518793,Staff,5,0,20,15
1713510804606,MCWP 50R,D00,518794,Staff,0,0,20,20
1713510804606,MCWP 50R,E00,518795,Staff,0,0,20,20
1713510804606,MCWP 50R,F00,518796,Staff,11,0,20,9
1713510804606,MCWP 50R,G00,518797,Staff,10,0,20,10
1713510805632,MMW 12R,A01,514034,Herbst; Matthew,1,0,16,15
1713510805632,MMW 12R,A02,514035,Herbst; Matthew,13,0,16,3
1713510806658,MMW 13R,A01,514037,Staff,0,8,16,16
1713510806658,MMW 13R,A02,514039,Staff,0,7,16,16
1713510808717,SIO 295LS,A00,523233,Staff,15,0,30,15
1713510809749,SIO 295S,A00,523232,Staff,15,0,30,15
1713510810775,SOCI 117,A01,494376,Staff,0,2,5,5
1713510811802,WES 237B,A00,494380,Staff,19,0,20,1
1713510813871,AESE 279B,A00,494370,Wade; Jon P,33,0,33,0
1713510814896,AIP 197,001,627712,Vespa; Emanuel Ignacio,9999,0,9999,0
1713510815931,ANAR 135S,A00,494369,Braswell; Geoffrey E.,0,0,0,0
1713510816957,CAT 124RS,A01,519847,Geibel; William,6,0,20,14
1713510817991,CAT 125RS,A01,515971,Geibel; William,6,0,20,14
1713510819016,CLRE 250,A00,511389,Morris; Sheldon,9996,0,9999,3
1713510820050,CLRE 251,A00,507176,Mehta; Ravindra L.,9996,0,9999,3
1713510820050,CLRE 251,B00,511410,Mehta; Ravindra L.,9998,0,9999,1
1713510821075,CLRE 252,A00,507189,Cuomo; Raphael Eduardo,9998,0,9999,1
1713510822102,CLRE 253,A00,507199,Vaida; Florin,9997,0,9999,2
1713510822102,CLRE 253,B00,507202,Vaida; Florin,9999,0,9999,0
1713510823135,CLRE 259,A00,507211,Patel; Hemal,9996,0,9999,3
1713510824159,CLRE 260,A00,507221,Cuomo; Raphael Eduardo,9999,0,9999,0
1713510825190,CLRE 297,001,507242,Cuomo; Raphael Eduardo,9999,0,9999,0
1713510826226,CSE 191,A00,516875,Minnes Kemp; Mor Mia,9999,0,9999,0
1713510827252,CSS 201S,A01,494383,Staff,35,0,35,0
1713510828280,CSS 202S,A01,494387,Staff,35,0,35,0
1713510829307,EAP 100,A00,516065,Staff,9792,0,9999,207
1713510830339,ECE 45,A01,507414,Staff,37,0,60,23
1713510831367,ECE 100,A01,507416,Baghdadchi; Saharnaz,0,0,20,20
1713510831367,ECE 100,A02,507418,Baghdadchi; Saharnaz,19,0,20,1
1713510832399,ECE 111,A01,507420,Staff,27,0,50,23
1713510833428,ECE 197,001,548057,Sievenpiper; Daniel F.,9998,0,9999,1
1713510834459,EDS 115,A00,507243,Choi; Bailey Miyeon,27,0,28,1
1713510835485,EDS 117,A01,494379,Staff,15,0,25,10
1713510836513,EDS 125,A00,507246,Hopkins; Megan Beth,27,0,30,3
1713510837551,EDS 128A,A01,507264,Fargason; Sharon Gayle,26,0,26,0
1713510838579,EDS 128B,A01,507293,Pappas; Elizabeth,30,0,30,0
1713510839607,EDS 139,A00,507294,Fargason; Sharon Gayle,30,0,30,0
1713510839607,EDS 139,B00,507313,Pappas; Elizabeth,30,0,30,0
1713510840635,EDS 201,A00,507315,Staff,18,0,30,12
1713510841668,EDS 203,A01,507317,Halter; Christopher P.,17,0,30,13
1713510842695,EDS 204R,A01,507319,Halter; Christopher P.,0,1,30,30
1713510842695,EDS 204R,B01,507331,Heinzman; Erica M.,22,0,30,8
1713510843727,EDS 206R,A00,507332,Staff,0,2,30,30
1713510843727,EDS 206R,B00,507343,Staff,23,0,30,7
1713510844760,EDS 250,A00,507344,Hemans; Patricia Ann Benitez,27,0,40,13
1713510845787,EDS 281,A00,507345,Daly; Alan J.,18,0,18,0
1713510846813,EDS 284,A00,507350,Daly; Alan J.,16,0,16,0
1713510847844,EDS 286,A00,507359,Fine; Sarah,18,0,18,0
1713510848874,EDS 289C,A01,507361,Daly; Alan J.,18,0,18,0
1713510849900,EDS 290,A00,507366,Hofstetter; Carolyn,15,0,15,0
1713510850933,LIGM 5A,A00,507421,Fischer-Grunski; Eva K,20,0,20,0
1713510851964,LIGM 5B,A00,507423,Fischer-Grunski; Eva K,20,0,20,0
1713510853007,LIGM 5C,A00,507425,Fischer-Grunski; Eva K,20,0,20,0
1713510854034,LIIT 5AS,A00,507427,Carnelos; Chiara,20,0,20,0
1713510855085,LIIT 5BS,A00,507430,Carnelos; Chiara,20,0,20,0
1713510856111,LIIT 5CS,A00,507432,Carnelos; Chiara,20,0,20,0
1713510857139,LISP 5A,A00,507541,Munoz Sanchez; Alicia,14,0,20,6
1713510858174,LISP 5B,A00,507671,Munoz Sanchez; Alicia,12,0,20,8
1713510859201,LISP 5C,A00,507696,Munoz Sanchez; Alicia,11,0,20,9
1713510860230,MAE 197,001,528363,Boechler; Nicholas Sebastia,9998,0,9999,1
1713510861257,MATH 197,001,523477,Kedlaya; Kiran S.,9999,0,9999,0
1713510861257,MATH 197,002,563811,Zhang; Danna,9998,0,9999,1
1713510862289,MCWP 40R,A00,518780,Staff,13,0,20,7
1713510862289,MCWP 40R,B00,518781,Staff,11,0,20,9
1713510862289,MCWP 40R,C00,518783,Staff,8,0,20,12
1713510863316,MCWP 50R,A00,518791,Staff,7,0,20,13
1713510863316,MCWP 50R,B00,518792,Staff,3,0,20,17
1713510863316,MCWP 50R,C00,518793,Staff,5,0,20,15
1713510863316,MCWP 50R,D00,518794,Staff,0,0,20,20
1713510863316,MCWP 50R,E00,518795,Staff,0,0,20,20
1713510863316,MCWP 50R,F00,518796,Staff,11,0,20,9
1713510863316,MCWP 50R,G00,518797,Staff,10,0,20,10
1713510864350,MMW 12R,A01,514034,Herbst; Matthew,1,0,16,15
1713510864350,MMW 12R,A02,514035,Herbst; Matthew,13,0,16,3
1713510865374,MMW 13R,A01,514037,Staff,0,8,16,16
1713510865374,MMW 13R,A02,514039,Staff,0,7,16,16
1713510867428,SIO 295LS,A00,523233,Staff,15,0,30,15
1713510868452,SIO 295S,A00,523232,Staff,15,0,30,15
1713510869478,SOCI 117,A01,494376,Staff,0,2,5,5
1713510870507,WES 237B,A00,494380,Staff,19,0,20,1
1713510872569,AESE 279B,A00,494370,Wade; Jon P,33,0,33,0
1713510873654,AIP 197,001,627712,Vespa; Emanuel Ignacio,9999,0,9999,0
1713510874688,ANAR 135S,A00,494369,Braswell; Geoffrey E.,0,0,0,0
1713510875714,CAT 124RS,A01,519847,Geibel; William,6,0,20,14
1713510876746,CAT 125RS,A01,515971,Geibel; William,6,0,20,14
1713510877772,CLRE 250,A00,511389,Morris; Sheldon,9996,0,9999,3
1713510878809,CLRE 251,A00,507176,Mehta; Ravindra L.,9996,0,9999,3
1713510878809,CLRE 251,B00,511410,Mehta; Ravindra L.,9998,0,9999,1
1713510879838,CLRE 252,A00,507189,Cuomo; Raphael Eduardo,9998,0,9999,1
1713510880877,CLRE 253,A00,507199,Vaida; Florin,9997,0,9999,2
1713510880877,CLRE 253,B00,507202,Vaida; Florin,9999,0,9999,0
1713510881903,CLRE 259,A00,507211,Patel; Hemal,9996,0,9999,3
1713510882929,CLRE 260,A00,507221,Cuomo; Raphael Eduardo,9999,0,9999,0
1713510883959,CLRE 297,001,507242,Cuomo; Raphael Eduardo,9999,0,9999,0
1713510884988,CSE 191,A00,516875,Minnes Kemp; Mor Mia,9999,0,9999,0
1713510886017,CSS 201S,A01,494383,Staff,35,0,35,0
1713510887044,CSS 202S,A01,494387,Staff,35,0,35,0
1713510888081,EAP 100,A00,516065,Staff,9792,0,9999,207
1713510889114,ECE 45,A01,507414,Staff,37,0,60,23
1713510890139,ECE 100,A01,507416,Baghdadchi; Saharnaz,0,0,20,20
1713510890139,ECE 100,A02,507418,Baghdadchi; Saharnaz,19,0,20,1
1713510891173,ECE 111,A01,507420,Staff,27,0,50,23
1713510892202,ECE 197,001,548057,Sievenpiper; Daniel F.,9998,0,9999,1
1713510893231,EDS 115,A00,507243,Choi; Bailey Miyeon,27,0,28,1
1713510894260,EDS 117,A01,494379,Staff,15,0,25,10
1713510895289,EDS 125,A00,507246,Hopkins; Megan Beth,27,0,30,3
1713510896315,EDS 128A,A01,507264,Fargason; Sharon Gayle,26,0,26,0
1713510897349,EDS 128B,A01,507293,Pappas; Elizabeth,30,0,30,0
1713510898376,EDS 139,A00,507294,Fargason; Sharon Gayle,30,0,30,0
1713510898376,EDS 139,B00,507313,Pappas; Elizabeth,30,0,30,0
1713510899406,EDS 201,A00,507315,Staff,18,0,30,12
1713510900433,EDS 203,A01,507317,Halter; Christopher P.,17,0,30,13
1713510901461,EDS 204R,A01,507319,Halter; Christopher P.,0,1,30,30
1713510901461,EDS 204R,B01,507331,Heinzman; Erica M.,22,0,30,8
1713510902487,EDS 206R,A00,507332,Staff,0,2,30,30
1713510902487,EDS 206R,B00,507343,Staff,23,0,30,7
1713510903513,EDS 250,A00,507344,Hemans; Patricia Ann Benitez,27,0,40,13
1713510904542,EDS 281,A00,507345,Daly; Alan J.,18,0,18,0
1713510905567,EDS 284,A00,507350,Daly; Alan J.,16,0,16,0
1713510906591,EDS 286,A00,507359,Fine; Sarah,18,0,18,0
1713510907615,EDS 289C,A01,507361,Daly; Alan J.,18,0,18,0
1713510908701,EDS 290,A00,507366,Hofstetter; Carolyn,15,0,15,0
1713510909730,LIGM 5A,A00,507421,Fischer-Grunski; Eva K,20,0,20,0
1713510910757,LIGM 5B,A00,507423,Fischer-Grunski; Eva K,20,0,20,0
1713510911785,LIGM 5C,A00,507425,Fischer-Grunski; Eva K,20,0,20,0
1713510912812,LIIT 5AS,A00,507427,Carnelos; Chiara,20,0,20,0
1713510913837,LIIT 5BS,A00,507430,Carnelos; Chiara,20,0,20,0
1713510914864,LIIT 5CS,A00,507432,Carnelos; Chiara,20,0,20,0
1713510915896,LISP 5A,A00,507541,Munoz Sanchez; Alicia,14,0,20,6
1713510916929,LISP 5B,A00,507671,Munoz Sanchez; Alicia,12,0,20,8
1713510917958,LISP 5C,A00,507696,Munoz Sanchez; Alicia,11,0,20,9
1713510918984,MAE 197,001,528363,Boechler; Nicholas Sebastia,9998,0,9999,1
1713510920010,MATH 197,001,523477,Kedlaya; Kiran S.,9999,0,9999,0
1713510920010,MATH 197,002,563811,Zhang; Danna,9998,0,9999,1
1713510921051,MCWP 40R,A00,518780,Staff,13,0,20,7
1713510921051,MCWP 40R,B00,518781,Staff,11,0,20,9
1713510921051,MCWP 40R,C00,518783,Staff,8,0,20,12
1713510922078,MCWP 50R,A00,518791,Staff,7,0,20,13
1713510922078,MCWP 50R,B00,518792,Staff,3,0,20,17
1713510922078,MCWP 50R,C00,518793,Staff,5,0,20,15
1713510922078,MCWP 50R,D00,518794,Staff,0,0,20,20
1713510922078,MCWP 50R,E00,518795,Staff,0,0,20,20
1713510922078,MCWP 50R,F00,518796,Staff,11,0,20,9
1713510922078,MCWP 50R,G00,518797,Staff,10,0,20,10
1713510923105,MMW 12R,A01,514034,Herbst; Matthew,1,0,16,15
1713510923105,MMW 12R,A02,514035,Herbst; Matthew,13,0,16,3
1713510924137,MMW 13R,A01,514037,Staff,0,8,16,16
1713510924137,MMW 13R,A02,514039,Staff,0,7,16,16
1713510926204,SIO 295LS,A00,523233,Staff,15,0,30,15
1713510927231,SIO 295S,A00,523232,Staff,15,0,30,15
1713510928261,SOCI 117,A01,494376,Staff,0,2,5,5
1713510929296,WES 237B,A00,494380,Staff,19,0,20,1
1713510931381,AESE 279B,A00,494370,Wade; Jon P,33,0,33,0
1713510932413,AIP 197,001,627712,Vespa; Emanuel Ignacio,9999,0,9999,0
1713510933437,ANAR 135S,A00,494369,Braswell; Geoffrey E.,0,0,0,0
1713510934461,CAT 124RS,A01,519847,Geibel; William,6,0,20,14
1713510935495,CAT 125RS,A01,515971,Geibel; William,6,0,20,14
1713510936523,CLRE 250,A00,511389,Morris; Sheldon,9996,0,9999,3
1713510937551,CLRE 251,A00,507176,Mehta; Ravindra L.,9996,0,9999,3
1713510937551,CLRE 251,B00,511410,Mehta; Ravindra L.,9998,0,9999,1
1713510938591,CLRE 252,A00,507189,Cuomo; Raphael Eduardo,9998,0,9999,1
1713510939618,CLRE 253,A00,507199,Vaida; Florin,9997,0,9999,2
1713510939618,CLRE 253,B00,507202,Vaida; Florin,9999,0,9999,0
1713510940643,CLRE 259,A00,507211,Patel; Hemal,9996,0,9999,3
1713510941668,CLRE 260,A00,507221,Cuomo; Raphael Eduardo,9999,0,9999,0
1713510942693,CLRE 297,001,507242,Cuomo; Raphael Eduardo,9999,0,9999,0
1713510943719,CSE 191,A00,516875,Minnes Kemp; Mor Mia,9999,0,9999,0
1713510944756,CSS 201S,A01,494383,Staff,35,0,35,0
1713510945783,CSS 202S,A01,494387,Staff,35,0,35,0
1713510946815,EAP 100,A00,516065,Staff,9792,0,9999,207
1713510947851,ECE 45,A01,507414,Staff,37,0,60,23
1713510948888,ECE 100,A01,507416,Baghdadchi; Saharnaz,0,0,20,20
1713510948888,ECE 100,A02,507418,Baghdadchi; Saharnaz,19,0,20,1
1713510949923,ECE 111,A01,507420,Staff,27,0,50,23
1713510950951,ECE 197,001,548057,Sievenpiper; Daniel F.,9998,0,9999,1
1713510951981,EDS 115,A00,507243,Choi; Bailey Miyeon,27,0,28,1
1713510953007,EDS 117,A01,494379,Staff,15,0,25,10
1713510954035,EDS 125,A00,507246,Hopkins; Megan Beth,27,0,30,3
1713510955060,EDS 128A,A01,507264,Fargason; Sharon Gayle,26,0,26,0
1713510956092,EDS 128B,A01,507293,Pappas; Elizabeth,30,0,30,0
1713510957119,EDS 139,A00,507294,Fargason; Sharon Gayle,30,0,30,0
1713510957119,EDS 139,B00,507313,Pappas; Elizabeth,30,0,30,0
1713510958214,EDS 201,A00,507315,Staff,18,0,30,12
1713510959239,EDS 203,A01,507317,Halter; Christopher P.,17,0,30,13
1713510960274,EDS 204R,A01,507319,Halter; Christopher P.,0,1,30,30
1713510960274,EDS 204R,B01,507331,Heinzman; Erica M.,22,0,30,8
1713510961305,EDS 206R,A00,507332,Staff,0,2,30,30
1713510961305,EDS 206R,B00,507343,Staff,23,0,30,7
1713510962332,EDS 250,A00,507344,Hemans; Patricia Ann Benitez,27,0,40,13
1713510963365,EDS 281,A00,507345,Daly; Alan J.,18,0,18,0
1713510964397,EDS 284,A00,507350,Daly; Alan J.,16,0,16,0
1713510965426,EDS 286,A00,507359,Fine; Sarah,18,0,18,0
1713510966455,EDS 289C,A01,507361,Daly; Alan J.,18,0,18,0
1713510967481,EDS 290,A00,507366,Hofstetter; Carolyn,15,0,15,0
1713510968508,LIGM 5A,A00,507421,Fischer-Grunski; Eva K,20,0,20,0
1713510969534,LIGM 5B,A00,507423,Fischer-Grunski; Eva K,20,0,20,0
1713510970560,LIGM 5C,A00,507425,Fischer-Grunski; Eva K,20,0,20,0
1713510971586,LIIT 5AS,A00,507427,Carnelos; Chiara,20,0,20,0
1713510972614,LIIT 5BS,A00,507430,Carnelos; Chiara,20,0,20,0
1713510973643,LIIT 5CS,A00,507432,Carnelos; Chiara,20,0,20,0
1713510974673,LISP 5A,A00,507541,Munoz Sanchez; Alicia,14,0,20,6
1713510975699,LISP 5B,A00,507671,Munoz Sanchez; Alicia,12,0,20,8
1713510976734,LISP 5C,A00,507696,Munoz Sanchez; Alicia,11,0,20,9
1713510977817,MAE 197,001,528363,Boechler; Nicholas Sebastia,9998,0,9999,1
1713510978843,MATH 197,001,523477,Kedlaya; Kiran S.,9999,0,9999,0
1713510978843,MATH 197,002,563811,Zhang; Danna,9998,0,9999,1
1713510979871,MCWP 40R,A00,518780,Staff,13,0,20,7
1713510979871,MCWP 40R,B00,518781,Staff,11,0,20,9
1713510979871,MCWP 40R,C00,518783,Staff,8,0,20,12
1713510980900,MCWP 50R,A00,518791,Staff,7,0,20,13
1713510980900,MCWP 50R,B00,518792,Staff,3,0,20,17
1713510980900,MCWP 50R,C00,518793,Staff,5,0,20,15
1713510980900,MCWP 50R,D00,518794,Staff,0,0,20,20
1713510980900,MCWP 50R,E00,518795,Staff,0,0,20,20
1713510980900,MCWP 50R,F00,518796,Staff,11,0,20,9
1713510980900,MCWP 50R,G00,518797,Staff,10,0,20,10
1713510981926,MMW 12R,A01,514034,Herbst; Matthew,1,0,16,15
1713510981926,MMW 12R,A02,514035,Herbst; Matthew,13,0,16,3
1713510982953,MMW 13R,A01,514037,Staff,0,8,16,16
1713510982953,MMW 13R,A02,514039,Staff,0,7,16,16
1713510985024,SIO 295LS,A00,523233,Staff,15,0,30,15
1713510986054,SIO 295S,A00,523232,Staff,15,0,30,15
1713510987094,SOCI 117,A01,494376,Staff,0,2,5,5
1713510988127,WES 237B,A00,494380,Staff,19,0,20,1
1713510990203,AESE 279B,A00,494370,Wade; Jon P,33,0,33,0
1713510991230,AIP 197,001,627712,Vespa; Emanuel Ignacio,9999,0,9999,0
1713510992255,ANAR 135S,A00,494369,Braswell; Geoffrey E.,0,0,0,0
1713510993280,CAT 124RS,A01,519847,Geibel; William,6,0,20,14
1713510994313,CAT 125RS,A01,515971,Geibel; William,6,0,20,14
1713510995338,CLRE 250,A00,511389,Morris; Sheldon,9996,0,9999,3
1713510996364,CLRE 251,A00,507176,Mehta; Ravindra L.,9996,0,9999,3
1713510996364,CLRE 251,B00,511410,Mehta; Ravindra L.,9998,0,9999,1
1713510997394,CLRE 252,A00,507189,Cuomo; Raphael Eduardo,9998,0,9999,1
1713510998421,CLRE 253,A00,507199,Vaida; Florin,9997,0,9999,2
1713510998421,CLRE 253,B00,507202,Vaida; Florin,9999,0,9999,0
1713510999446,CLRE 259,A00,507211,Patel; Hemal,9996,0,9999,3
1713511000475,CLRE 260,A00,507221,Cuomo; Raphael Eduardo,9999,0,9999,0
1713511001503,CLRE 297,001,507242,Cuomo; Raphael Eduardo,9999,0,9999,0
1713511002532,CSE 191,A00,516875,Minnes Kemp; Mor Mia,9999,0,9999,0
1713511003558,CSS 201S,A01,494383,Staff,35,0,35,0
1713511004588,CSS 202S,A01,494387,Staff,35,0,35,0
1713511005613,EAP 100,A00,516065,Staff,9792,0,9999,207
1713511006638,ECE 45,A01,507414,Staff,37,0,60,23
1713511007668,ECE 100,A01,507416,Baghdadchi; Saharnaz,0,0,20,20
1713511007668,ECE 100,A02,507418,Baghdadchi; Saharnaz,19,0,20,1
1713511008694,ECE 111,A01,507420,Staff,27,0,50,23
1713511009724,ECE 197,001,548057,Sievenpiper; Daniel F.,9998,0,9999,1
1713511010750,EDS 115,A00,507243,Choi; Bailey Miyeon,27,0,28,1
1713511011781,EDS 117,A01,494379,Staff,15,0,25,10
1713511012808,EDS 125,A00,507246,Hopkins; Megan Beth,27,0,30,3
1713511013841,EDS 128A,A01,507264,Fargason; Sharon Gayle,26,0,26,0
1713511014867,EDS 128B,A01,507293,Pappas; Elizabeth,30,0,30,0
1713511015897,EDS 139,A00,507294,Fargason; Sharon Gayle,30,0,30,0
1713511015897,EDS 139,B00,507313,Pappas; Elizabeth,30,0,30,0
1713511016923,EDS 201,A00,507315,Staff,18,0,30,12
1713511017950,EDS 203,A01,507317,Halter; Christopher P.,17,0,30,13
1713511018981,EDS 204R,A01,507319,Halter; Christopher P.,0,1,30,30
1713511018981,EDS 204R,B01,507331,Heinzman; Erica M.,22,0,30,8
1713511020012,EDS 206R,A00,507332,Staff,0,2,30,30
1713511020012,EDS 206R,B00,507343,Staff,23,0,30,7
1713511021079,EDS 250,A00,507344,Hemans; Patricia Ann Benitez,27,0,40,13
1713511022113,EDS 281,A00,507345,Daly; Alan J.,18,0,18,0
1713511023249,EDS 284,A00,507350,Daly; Alan J.,16,0,16,0
1713511024276,EDS 286,A00,507359,Fine; Sarah,18,0,18,0
1713511025306,EDS 289C,A01,507361,Daly; Alan J.,18,0,18,0
1713511026332,EDS 290,A00,507366,Hofstetter; Carolyn,15,0,15,0
1713511027367,LIGM 5A,A00,507421,Fischer-Grunski; Eva K,20,0,20,0
1713511028415,LIGM 5B,A00,507423,Fischer-Grunski; Eva K,20,0,20,0
1713511029451,LIGM 5C,A00,507425,Fischer-Grunski; Eva K,20,0,20,0
1713511030481,LIIT 5AS,A00,507427,Carnelos; Chiara,20,0,20,0
1713511031507,LIIT 5BS,A00,507430,Carnelos; Chiara,20,0,20,0
1713511032532,LIIT 5CS,A00,507432,Carnelos; Chiara,20,0,20,0
1713511033575,LISP 5A,A00,507541,Munoz Sanchez; Alicia,14,0,20,6
1713511034604,LISP 5B,A00,507671,Munoz Sanchez; Alicia,12,0,20,8
1713511035632,LISP 5C,A00,507696,Munoz Sanchez; Alicia,11,0,20,9
1713511036663,MAE 197,001,528363,Boechler; Nicholas Sebastia,9998,0,9999,1
1713511037688,MATH 197,001,523477,Kedlaya; Kiran S.,9999,0,9999,0
1713511037688,MATH 197,002,563811,Zhang; Danna,9998,0,9999,1
1713511038717,MCWP 40R,A00,518780,Staff,13,0,20,7
1713511038717,MCWP 40R,B00,518781,Staff,11,0,20,9
1713511038717,MCWP 40R,C00,518783,Staff,8,0,20,12
1713511039794,MCWP 50R,A00,518791,Staff,7,0,20,13
1713511039794,MCWP 50R,B00,518792,Staff,3,0,20,17
1713511039794,MCWP 50R,C00,518793,Staff,5,0,20,15
1713511039794,MCWP 50R,D00,518794,Staff,0,0,20,20
1713511039794,MCWP 50R,E00,518795,Staff,0,0,20,20
1713511039794,MCWP 50R,F00,518796,Staff,11,0,20,9
1713511039794,MCWP 50R,G00,518797,Staff,10,0,20,10
1713511040859,MMW 12R,A01,514034,Herbst; Matthew,1,0,16,15
1713511040859,MMW 12R,A02,514035,Herbst; Matthew,13,0,16,3
1713511041898,MMW 13R,A01,514037,Staff,0,8,16,16
1713511041898,MMW 13R,A02,514039,Staff,0,7,16,16
1713511044010,SIO 295LS,A00,523233,Staff,15,0,30,15
1713511045078,SIO 295S,A00,523232,Staff,15,0,30,15
1713511046168,SOCI 117,A01,494376,Staff,0,2,5,5
1713511047207,WES 237B,A00,494380,Staff,19,0,20,1
1713511049312,AESE 279B,A00,494370,Wade; Jon P,33,0,33,0
1713511050341,AIP 197,001,627712,Vespa; Emanuel Ignacio,9999,0,9999,0
1713511051370,ANAR 135S,A00,494369,Braswell; Geoffrey E.,0,0,0,0
1713511052396,CAT 124RS,A01,519847,Geibel; William,6,0,20,14
1713511053435,CAT 125RS,A01,515971,Geibel; William,6,0,20,14
1713511054462,CLRE 250,A00,511389,Morris; Sheldon,9996,0,9999,3
1713511055558,CLRE 251,A00,507176,Mehta; Ravindra L.,9996,0,9999,3
1713511055558,CLRE 251,B00,511410,Mehta; Ravindra L.,9998,0,9999,1
1713511056587,CLRE 252,A00,507189,Cuomo; Raphael Eduardo,9998,0,9999,1
1713511057610,CLRE 253,A00,507199,Vaida; Florin,9997,0,9999,2
1713511057610,CLRE 253,B00,507202,Vaida; Florin,9999,0,9999,0
1713511058634,CLRE 259,A00,507211,Patel; Hemal,9996,0,9999,3
1713511059659,CLRE 260,A00,507221,Cuomo; Raphael Eduardo,9999,0,9999,0
1713511060685,CLRE 297,001,507242,Cuomo; Raphael Eduardo,9999,0,9999,0
1713511061711,CSE 191,A00,516875,Minnes Kemp; Mor Mia,9999,0,9999,0
1713511062745,CSS 201S,A01,494383,Staff,35,0,35,0
1713511063796,CSS 202S,A01,494387,Staff,35,0,35,0
1713511064841,EAP 100,A00,516065,Staff,9792,0,9999,207
1713511065898,ECE 45,A01,507414,Staff,37,0,60,23
1713511066954,ECE 100,A01,507416,Baghdadchi; Saharnaz,0,0,20,20
1713511066954,ECE 100,A02,507418,Baghdadchi; Saharnaz,19,0,20,1
1713511068029,ECE 111,A01,507420,Staff,27,0,50,23
1713511069072,ECE 197,001,548057,Sievenpiper; Daniel F.,9998,0,9999,1
1713511070104,EDS 115,A00,507243,Choi; Bailey Miyeon,27,0,28,1
1713511071140,EDS 117,A01,494379,Staff,15,0,25,10
1713511072167,EDS 125,A00,507246,Hopkins; Megan Beth,27,0,30,3
1713511073193,EDS 128A,A01,507264,Fargason; Sharon Gayle,26,0,26,0
1713511074229,EDS 128B,A01,507293,Pappas; Elizabeth,30,0,30,0
1713511075257,EDS 139,A00,507294,Fargason; Sharon Gayle,30,0,30,0
1713511075257,EDS 139,B00,507313,Pappas; Elizabeth,30,0,30,0
1713511076306,EDS 201,A00,507315,Staff,18,0,30,12
1713511077332,EDS 203,A01,507317,Halter; Christopher P.,17,0,30,13
1713511078363,EDS 204R,A01,507319,Halter; Christopher P.,0,1,30,30
1713511078363,EDS 204R,B01,507331,Heinzman; Erica M.,22,0,30,8
1713511079392,EDS 206R,A00,507332,Staff,0,2,30,30
1713511079392,EDS 206R,B00,507343,Staff,23,0,30,7
1713511080422,EDS 250,A00,507344,Hemans; Patricia Ann Benitez,27,0,40,13
1713511081455,EDS 281,A00,507345,Daly; Alan J.,18,0,18,0
1713511082549,EDS 284,A00,507350,Daly; Alan J.,16,0,16,0
1713511083575,EDS 286,A00,507359,Fine; Sarah,18,0,18,0
1713511084605,EDS 289C,A01,507361,Daly; Alan J.,18,0,18,0
1713511085635,EDS 290,A00,507366,Hofstetter; Carolyn,15,0,15,0
1713511086660,LIGM 5A,A00,507421,Fischer-Grunski; Eva K,20,0,20,0
1713511087687,LIGM 5B,A00,507423,Fischer-Grunski; Eva K,20,0,20,0
1713511088722,LIGM 5C,A00,507425,Fischer-Grunski; Eva K,20,0,20,0
1713511089803,LIIT 5AS,A00,507427,Carnelos; Chiara,20,0,20,0
1713511090844,LIIT 5BS,A00,507430,Carnelos; Chiara,20,0,20,0
1713511091878,LIIT 5CS,A00,507432,Carnelos; Chiara,20,0,20,0
1713511092948,LISP 5A,A00,507541,Munoz Sanchez; Alicia,14,0,20,6
1713511093979,LISP 5B,A00,507671,Munoz Sanchez; Alicia,12,0,20,8
1713511095011,LISP 5C,A00,507696,Munoz Sanchez; Alicia,11,0,20,9
1713511096047,MAE 197,001,528363,Boechler; Nicholas Sebastia,9998,0,9999,1
1713511097077,MATH 197,001,523477,Kedlaya; Kiran S.,9999,0,9999,0
1713511097077,MATH 197,002,563811,Zhang; Danna,9998,0,9999,1
1713511098108,MCWP 40R,A00,518780,Staff,13,0,20,7
1713511098108,MCWP 40R,B00,518781,Staff,11,0,20,9
1713511098108,MCWP 40R,C00,518783,Staff,8,0,20,12
1713511099145,MCWP 50R,A00,518791,Staff,7,0,20,13
1713511099145,MCWP 50R,B00,518792,Staff,3,0,20,17
1713511099145,MCWP 50R,C00,518793,Staff,5,0,20,15
1713511099145,MCWP 50R,D00,518794,Staff,0,0,20,20
1713511099145,MCWP 50R,E00,518795,Staff,0,0,20,20
1713511099145,MCWP 50R,F00,518796,Staff,11,0,20,9
1713511099145,MCWP 50R,G00,518797,Staff,10,0,20,10
1713511100181,MMW 12R,A01,514034,Herbst; Matthew,1,0,16,15
1713511100181,MMW 12R,A02,514035,Herbst; Matthew,13,0,16,3
1713511101209,MMW 13R,A01,514037,Staff,0,8,16,16
1713511101209,MMW 13R,A02,514039,Staff,0,7,16,16
1713511103281,SIO 295LS,A00,523233,Staff,15,0,30,15
1713511104315,SIO 295S,A00,523232,Staff,15,0,30,15
1713511105340,SOCI 117,A01,494376,Staff,0,2,5,5
1713511106370,WES 237B,A00,494380,Staff,19,0,20,1
1713511108435,AESE 279B,A00,494370,Wade; Jon P,33,0,33,0
1713511109464,AIP 197,001,627712,Vespa; Emanuel Ignacio,9999,0,9999,0
1713511110490,ANAR 135S,A00,494369,Braswell; Geoffrey E.,0,0,0,0
1713511111518,CAT 124RS,A01,519847,Geibel; William,6,0,20,14
1713511112543,CAT 125RS,A01,515971,Geibel; William,6,0,20,14
1713511113573,CLRE 250,A00,511389,Morris; Sheldon,9996,0,9999,3
1713511114604,CLRE 251,A00,507176,Mehta; Ravindra L.,9996,0,9999,3
1713511114604,CLRE 251,B00,511410,Mehta; Ravindra L.,9998,0,9999,1
1713511115630,CLRE 252,A00,507189,Cuomo; Raphael Eduardo,9998,0,9999,1
1713511116661,CLRE 253,A00,507199,Vaida; Florin,9997,0,9999,2
1713511116661,CLRE 253,B00,507202,Vaida; Florin,9999,0,9999,0
1713511117687,CLRE 259,A00,507211,Patel; Hemal,9996,0,9999,3
1713511118713,CLRE 260,A00,507221,Cuomo; Raphael Eduardo,9999,0,9999,0
1713511119738,CLRE 297,001,507242,Cuomo; Raphael Eduardo,9999,0,9999,0
1713511120768,CSE 191,A00,516875,Minnes Kemp; Mor Mia,9999,0,9999,0
1713511121796,CSS 201S,A01,494383,Staff,35,0,35,0
1713511122828,CSS 202S,A01,494387,Staff,35,0,35,0
1713511123874,EAP 100,A00,516065,Staff,9792,0,9999,207
1713511124902,ECE 45,A01,507414,Staff,37,0,60,23
1713511125971,ECE 100,A01,507416,Baghdadchi; Saharnaz,0,0,20,20
1713511125971,ECE 100,A02,507418,Baghdadchi; Saharnaz,19,0,20,1
1713511127005,ECE 111,A01,507420,Staff,27,0,50,23
1713511128055,ECE 197,001,548057,Sievenpiper; Daniel F.,9998,0,9999,1
1713511129083,EDS 115,A00,507243,Choi; Bailey Miyeon,27,0,28,1
1713511130117,EDS 117,A01,494379,Staff,15,0,25,10
1713511131149,EDS 125,A00,507246,Hopkins; Megan Beth,27,0,30,3
1713511132180,EDS 128A,A01,507264,Fargason; Sharon Gayle,26,0,26,0
1713511133220,EDS 128B,A01,507293,Pappas; Elizabeth,30,0,30,0
1713511134253,EDS 139,A00,507294,Fargason; Sharon Gayle,30,0,30,0
1713511134253,EDS 139,B00,507313,Pappas; Elizabeth,30,0,30,0
1713511135347,EDS 201,A00,507315,Staff,18,0,30,12
1713511136449,EDS 203,A01,507317,Halter; Christopher P.,17,0,30,13
1713511137478,EDS 204R,A01,507319,Halter; Christopher P.,0,1,30,30
1713511137478,EDS 204R,B01,507331,Heinzman; Erica M.,22,0,30,8
1713511138519,EDS 206R,A00,507332,Staff,0,2,30,30
1713511138519,EDS 206R,B00,507343,Staff,23,0,30,7
1713511139551,EDS 250,A00,507344,Hemans; Patricia Ann Benitez,27,0,40,13
1713511140630,EDS 281,A00,507345,Daly; Alan J.,18,0,18,0
1713511141682,EDS 284,A00,507350,Daly; Alan J.,16,0,16,0
1713511142711,EDS 286,A00,507359,Fine; Sarah,18,0,18,0
1713511143741,EDS 289C,A01,507361,Daly; Alan J.,18,0,18,0
1713511144784,EDS 290,A00,507366,Hofstetter; Carolyn,15,0,15,0
1713511145818,LIGM 5A,A00,507421,Fischer-Grunski; Eva K,20,0,20,0
1713511146850,LIGM 5B,A00,507423,Fischer-Grunski; Eva K,20,0,20,0
1713511147880,LIGM 5C,A00,507425,Fischer-Grunski; Eva K,20,0,20,0
1713511148915,LIIT 5AS,A00,507427,Carnelos; Chiara,20,0,20,0
1713511149942,LIIT 5BS,A00,507430,Carnelos; Chiara,20,0,20,0
1713511150970,LIIT 5CS,A00,507432,Carnelos; Chiara,20,0,20,0
1713511151997,LISP 5A,A00,507541,Munoz Sanchez; Alicia,14,0,20,6
1713511153024,LISP 5B,A00,507671,Munoz Sanchez; Alicia,12,0,20,8
1713511154063,LISP 5C,A00,507696,Munoz Sanchez; Alicia,11,0,20,9
1713511155089,MAE 197,001,528363,Boechler; Nicholas Sebastia,9998,0,9999,1
1713511156120,MATH 197,001,523477,Kedlaya; Kiran S.,9999,0,9999,0
1713511156120,MATH 197,002,563811,Zhang; Danna,9998,0,9999,1
1713511157152,MCWP 40R,A00,518780,Staff,13,0,20,7
1713511157152,MCWP 40R,B00,518781,Staff,11,0,20,9
1713511157152,MCWP 40R,C00,518783,Staff,8,0,20,12
1713511158188,MCWP 50R,A00,518791,Staff,7,0,20,13
1713511158188,MCWP 50R,B00,518792,Staff,3,0,20,17
1713511158188,MCWP 50R,C00,518793,Staff,5,0,20,15
1713511158188,MCWP 50R,D00,518794,Staff,0,0,20,20
1713511158188,MCWP 50R,E00,518795,Staff,0,0,20,20
1713511158188,MCWP 50R,F00,518796,Staff,11,0,20,9
1713511158188,MCWP 50R,G00,518797,Staff,10,0,20,10
1713511159219,MMW 12R,A01,514034,Herbst; Matthew,1,0,16,15
1713511159219,MMW 12R,A02,514035,Herbst; Matthew,13,0,16,3
1713511160243,MMW 13R,A01,514037,Staff,0,8,16,16
1713511160243,MMW 13R,A02,514039,Staff,0,7,16,16
1713511162312,SIO 295LS,A00,523233,Staff,15,0,30,15
1713511163338,SIO 295S,A00,523232,Staff,15,0,30,15
1713511164363,SOCI 117,A01,494376,Staff,0,2,5,5
1713511165390,WES 237B,A00,494380,Staff,19,0,20,1
1713511167491,AESE 279B,A00,494370,Wade; Jon P,33,0,33,0
1713511168516,AIP 197,001,627712,Vespa; Emanuel Ignacio,9999,0,9999,0
1713511169545,ANAR 135S,A00,494369,Braswell; Geoffrey E.,0,0,0,0
1713511170574,CAT 124RS,A01,519847,Geibel; William,6,0,20,14
1713511171602,CAT 125RS,A01,515971,Geibel; William,6,0,20,14
1713511172627,CLRE 250,A00,511389,Morris; Sheldon,9996,0,9999,3
1713511173651,CLRE 251,A00,507176,Mehta; Ravindra L.,9996,0,9999,3
1713511173651,CLRE 251,B00,511410,Mehta; Ravindra L.,9998,0,9999,1
1713511174681,CLRE 252,A00,507189,Cuomo; Raphael Eduardo,9998,0,9999,1
1713511175711,CLRE 253,A00,507199,Vaida; Florin,9997,0,9999,2
1713511175711,CLRE 253,B00,507202,Vaida; Florin,9999,0,9999,0
1713511176738,CLRE 259,A00,507211,Patel; Hemal,9996,0,9999,3
1713511177762,CLRE 260,A00,507221,Cuomo; Raphael Eduardo,9999,0,9999,0
1713511178788,CLRE 297,001,507242,Cuomo; Raphael Eduardo,9999,0,9999,0
1713511179815,CSE 191,A00,516875,Minnes Kemp; Mor Mia,9999,0,9999,0
1713511180840,CSS 201S,A01,494383,Staff,35,0,35,0
1713511181873,CSS 202S,A01,494387,Staff,35,0,35,0
1713511182904,EAP 100,A00,516065,Staff,9792,0,9999,207
1713511183931,ECE 45,A01,507414,Staff,37,0,60,23
1713511184958,ECE 100,A01,507416,Baghdadchi; Saharnaz,0,0,20,20
1713511184958,ECE 100,A02,507418,Baghdadchi; Saharnaz,19,0,20,1
1713511185988,ECE 111,A01,507420,Staff,27,0,50,23
1713511187069,ECE 197,001,548057,Sievenpiper; Daniel F.,9998,0,9999,1
1713511188095,EDS 115,A00,507243,Choi; Bailey Miyeon,27,0,28,1
1713511189123,EDS 117,A01,494379,Staff,15,0,25,10
1713511190157,EDS 125,A00,507246,Hopkins; Megan Beth,27,0,30,3
1713511191184,EDS 128A,A01,507264,Fargason; Sharon Gayle,26,0,26,0
1713511192215,EDS 128B,A01,507293,Pappas; Elizabeth,30,0,30,0
1713511193244,EDS 139,A00,507294,Fargason; Sharon Gayle,30,0,30,0
1713511193244,EDS 139,B00,507313,Pappas; Elizabeth,30,0,30,0
1713511194422,EDS 201,A00,507315,Staff,18,0,30,12
1713511195452,EDS 203,A01,507317,Halter; Christopher P.,17,0,30,13
1713511196479,EDS 204R,A01,507319,Halter; Christopher P.,0,1,30,30
1713511196479,EDS 204R,B01,507331,Heinzman; Erica M.,22,0,30,8
1713511197503,EDS 206R,A00,507332,Staff,0,2,30,30
1713511197503,EDS 206R,B00,507343,Staff,23,0,30,7
1713511198530,EDS 250,A00,507344,Hemans; Patricia Ann Benitez,27,0,40,13
1713511199556,EDS 281,A00,507345,Daly; Alan J.,18,0,18,0
1713511200597,EDS 284,A00,507350,Daly; Alan J.,16,0,16,0
1713511201622,EDS 286,A00,507359,Fine; Sarah,18,0,18,0
1713511202652,EDS 289C,A01,507361,Daly; Alan J.,18,0,18,0
1713511203678,EDS 290,A00,507366,Hofstetter; Carolyn,15,0,15,0
1713511204707,LIGM 5A,A00,507421,Fischer-Grunski; Eva K,20,0,20,0
1713511205733,LIGM 5B,A00,507423,Fischer-Grunski; Eva K,20,0,20,0
1713511206760,LIGM 5C,A00,507425,Fischer-Grunski; Eva K,20,0,20,0
1713511207792,LIIT 5AS,A00,507427,Carnelos; Chiara,20,0,20,0
1713511208829,LIIT 5BS,A00,507430,Carnelos; Chiara,20,0,20,0
1713511209857,LIIT 5CS,A00,507432,Carnelos; Chiara,20,0,20,0
1713511210885,LISP 5A,A00,507541,Munoz Sanchez; Alicia,14,0,20,6
1713511211918,LISP 5B,A00,507671,Munoz Sanchez; Alicia,12,0,20,8
1713511212951,LISP 5C,A00,507696,Munoz Sanchez; Alicia,11,0,20,9
1713511213984,MAE 197,001,528363,Boechler; Nicholas Sebastia,9998,0,9999,1
1713511215009,MATH 197,001,523477,Kedlaya; Kiran S.,9999,0,9999,0
1713511215009,MATH 197,002,563811,Zhang; Danna,9998,0,9999,1
1713511216040,MCWP 40R,A00,518780,Staff,13,0,20,7
1713511216040,MCWP 40R,B00,518781,Staff,11,0,20,9
1713511216040,MCWP 40R,C00,518783,Staff,8,0,20,12
1713511217071,MCWP 50R,A00,518791,Staff,7,0,20,13
1713511217071,MCWP 50R,B00,518792,Staff,3,0,20,17
1713511217071,MCWP 50R,C00,518793,Staff,5,0,20,15
1713511217071,MCWP 50R,D00,518794,Staff,0,0,20,20
1713511217071,MCWP 50R,E00,518795,Staff,0,0,20,20
1713511217071,MCWP 50R,F00,518796,Staff,11,0,20,9
1713511217071,MCWP 50R,G00,518797,Staff,10,0,20,10
1713511218098,MMW 12R,A01,514034,Herbst; Matthew,1,0,16,15
1713511218098,MMW 12R,A02,514035,Herbst; Matthew,13,0,16,3
1713511219129,MMW 13R,A01,514037,Staff,0,8,16,16
1713511219129,MMW 13R,A02,514039,Staff,0,7,16,16
1713511221181,SIO 295LS,A00,523233,Staff,15,0,30,15
1713511222207,SIO 295S,A00,523232,Staff,15,0,30,15
1713511223232,SOCI 117,A01,494376,Staff,0,2,5,5
1713511224257,WES 237B,A00,494380,Staff,19,0,20,1
1713511226355,AESE 279B,A00,494370,Wade; Jon P,33,0,33,0
1713511227387,AIP 197,001,627712,Vespa; Emanuel Ignacio,9999,0,9999,0
1713511228419,ANAR 135S,A00,494369,Braswell; Geoffrey E.,0,0,0,0
1713511229451,CAT 124RS,A01,519847,Geibel; William,6,0,20,14
1713511230481,CAT 125RS,A01,515971,Geibel; William,6,0,20,14
1713511231507,CLRE 250,A00,511389,Morris; Sheldon,9996,0,9999,3
1713511232542,CLRE 251,A00,507176,Mehta; Ravindra L.,9996,0,9999,3
1713511232542,CLRE 251,B00,511410,Mehta; Ravindra L.,9998,0,9999,1
1713511233568,CLRE 252,A00,507189,Cuomo; Raphael Eduardo,9998,0,9999,1
1713511234594,CLRE 253,A00,507199,Vaida; Florin,9997,0,9999,2
1713511234594,CLRE 253,B00,507202,Vaida; Florin,9999,0,9999,0
1713511235618,CLRE 259,A00,507211,Patel; Hemal,9996,0,9999,3
1713511236643,CLRE 260,A00,507221,Cuomo; Raphael Eduardo,9999,0,9999,0
1713511237667,CLRE 297,001,507242,Cuomo; Raphael Eduardo,9999,0,9999,0
1713511238699,CSE 191,A00,516875,Minnes Kemp; Mor Mia,9999,0,9999,0
1713511239725,CSS 201S,A01,494383,Staff,35,0,35,0
1713511240752,CSS 202S,A01,494387,Staff,35,0,35,0
1713511241783,EAP 100,A00,516065,Staff,9792,0,9999,207
1713511242809,ECE 45,A01,507414,Staff,37,0,60,23
1713511243842,ECE 100,A01,507416,Baghdadchi; Saharnaz,0,0,20,20
1713511243842,ECE 100,A02,507418,Baghdadchi; Saharnaz,19,0,20,1
1713511244869,ECE 111,A01,507420,Staff,27,0,50,23
1713511245897,ECE 197,001,548057,Sievenpiper; Daniel F.,9998,0,9999,1
1713511246923,EDS 115,A00,507243,Choi; Bailey Miyeon,27,0,28,1
1713511247953,EDS 117,A01,494379,Staff,15,0,25,10
1713511248980,EDS 125,A00,507246,Hopkins; Megan Beth,27,0,30,3
1713511250004,EDS 128A,A01,507264,Fargason; Sharon Gayle,26,0,26,0
1713511251033,EDS 128B,A01,507293,Pappas; Elizabeth,30,0,30,0
1713511252059,EDS 139,A00,507294,Fargason; Sharon Gayle,30,0,30,0
1713511252059,EDS 139,B00,507313,Pappas; Elizabeth,30,0,30,0
1713511253086,EDS 201,A00,507315,Staff,18,0,30,12
1713511254113,EDS 203,A01,507317,Halter; Christopher P.,17,0,30,13
1713511255141,EDS 204R,A01,507319,Halter; Christopher P.,0,1,30,30
1713511255141,EDS 204R,B01,507331,Heinzman; Erica M.,22,0,30,8
1713511256170,EDS 206R,A00,507332,Staff,0,2,30,30
1713511256170,EDS 206R,B00,507343,Staff,23,0,30,7
1713511257202,EDS 250,A00,507344,Hemans; Patricia Ann Benitez,27,0,40,13
1713511258232,EDS 281,A00,507345,Daly; Alan J.,18,0,18,0
1713511259263,EDS 284,A00,507350,Daly; Alan J.,16,0,16,0
1713511260289,EDS 286,A00,507359,Fine; Sarah,18,0,18,0
1713511261315,EDS 289C,A01,507361,Daly; Alan J.,18,0,18,0
1713511262340,EDS 290,A00,507366,Hofstetter; Carolyn,15,0,15,0
1713511263367,LIGM 5A,A00,507421,Fischer-Grunski; Eva K,20,0,20,0
1713511264394,LIGM 5B,A00,507423,Fischer-Grunski; Eva K,20,0,20,0
1713511265420,LIGM 5C,A00,507425,Fischer-Grunski; Eva K,20,0,20,0
1713511266446,LIIT 5AS,A00,507427,Carnelos; Chiara,20,0,20,0
1713511267474,LIIT 5BS,A00,507430,Carnelos; Chiara,20,0,20,0
1713511268499,LIIT 5CS,A00,507432,Carnelos; Chiara,20,0,20,0
1713511269523,LISP 5A,A00,507541,Munoz Sanchez; Alicia,14,0,20,6
1713511270552,LISP 5B,A00,507671,Munoz Sanchez; Alicia,12,0,20,8
1713511271584,LISP 5C,A00,507696,Munoz Sanchez; Alicia,11,0,20,9
1713511272609,MAE 197,001,528363,Boechler; Nicholas Sebastia,9998,0,9999,1
1713511273638,MATH 197,001,523477,Kedlaya; Kiran S.,9999,0,9999,0
1713511273638,MATH 197,002,563811,Zhang; Danna,9998,0,9999,1
1713511274668,MCWP 40R,A00,518780,Staff,13,0,20,7
1713511274668,MCWP 40R,B00,518781,Staff,11,0,20,9
1713511274668,MCWP 40R,C00,518783,Staff,8,0,20,12
1713511275694,MCWP 50R,A00,518791,Staff,7,0,20,13
1713511275694,MCWP 50R,B00,518792,Staff,3,0,20,17
1713511275694,MCWP 50R,C00,518793,Staff,5,0,20,15
1713511275694,MCWP 50R,D00,518794,Staff,0,0,20,20
1713511275694,MCWP 50R,E00,518795,Staff,0,0,20,20
1713511275694,MCWP 50R,F00,518796,Staff,11,0,20,9
1713511275694,MCWP 50R,G00,518797,Staff,10,0,20,10
1713511276719,MMW 12R,A01,514034,Herbst; Matthew,1,0,16,15
1713511276719,MMW 12R,A02,514035,Herbst; Matthew,13,0,16,3
1713511277747,MMW 13R,A01,514037,Staff,0,8,16,16
1713511277747,MMW 13R,A02,514039,Staff,0,7,16,16
1713511279803,SIO 295LS,A00,523233,Staff,15,0,30,15
1713511280828,SIO 295S,A00,523232,Staff,15,0,30,15
1713511281854,SOCI 117,A01,494376,Staff,0,2,5,5
1713511282887,WES 237B,A00,494380,Staff,19,0,20,1
1713511284970,AESE 279B,A00,494370,Wade; Jon P,33,0,33,0
1713511285995,AIP 197,001,627712,Vespa; Emanuel Ignacio,9999,0,9999,0
1713511287021,ANAR 135S,A00,494369,Braswell; Geoffrey E.,0,0,0,0
1713511288050,CAT 124RS,A01,519847,Geibel; William,6,0,20,14
1713511289079,CAT 125RS,A01,515971,Geibel; William,6,0,20,14
1713511290105,CLRE 250,A00,511389,Morris; Sheldon,9996,0,9999,3
1713511291185,CLRE 251,A00,507176,Mehta; Ravindra L.,9996,0,9999,3
1713511291185,CLRE 251,B00,511410,Mehta; Ravindra L.,9998,0,9999,1
1713511292222,CLRE 252,A00,507189,Cuomo; Raphael Eduardo,9998,0,9999,1
1713511293251,CLRE 253,A00,507199,Vaida; Florin,9997,0,9999,2
1713511293251,CLRE 253,B00,507202,Vaida; Florin,9999,0,9999,0
1713511294278,CLRE 259,A00,507211,Patel; Hemal,9996,0,9999,3
1713511295310,CLRE 260,A00,507221,Cuomo; Raphael Eduardo,9999,0,9999,0
1713511296339,CLRE 297,001,507242,Cuomo; Raphael Eduardo,9999,0,9999,0
1713511297372,CSE 191,A00,516875,Minnes Kemp; Mor Mia,9999,0,9999,0
1713511298410,CSS 201S,A01,494383,Staff,35,0,35,0
1713511299436,CSS 202S,A01,494387,Staff,35,0,35,0
1713511300463,EAP 100,A00,516065,Staff,9792,0,9999,207
1713511301490,ECE 45,A01,507414,Staff,37,0,60,23
1713511302516,ECE 100,A01,507416,Baghdadchi; Saharnaz,0,0,20,20
1713511302516,ECE 100,A02,507418,Baghdadchi; Saharnaz,19,0,20,1
1713511303548,ECE 111,A01,507420,Staff,27,0,50,23
1713511304574,ECE 197,001,548057,Sievenpiper; Daniel F.,9998,0,9999,1
1713511305600,EDS 115,A00,507243,Choi; Bailey Miyeon,27,0,28,1
1713511306629,EDS 117,A01,494379,Staff,15,0,25,10
1713511307655,EDS 125,A00,507246,Hopkins; Megan Beth,27,0,30,3
1713511308682,EDS 128A,A01,507264,Fargason; Sharon Gayle,26,0,26,0
1713511309708,EDS 128B,A01,507293,Pappas; Elizabeth,30,0,30,0
1713511310737,EDS 139,A00,507294,Fargason; Sharon Gayle,30,0,30,0
1713511310737,EDS 139,B00,507313,Pappas; Elizabeth,30,0,30,0
1713511311766,EDS 201,A00,507315,Staff,18,0,30,12
1713511312793,EDS 203,A01,507317,Halter; Christopher P.,17,0,30,13
1713511313819,EDS 204R,A01,507319,Halter; Christopher P.,0,1,30,30
1713511313819,EDS 204R,B01,507331,Heinzman; Erica M.,22,0,30,8
1713511314843,EDS 206R,A00,507332,Staff,0,2,30,30
1713511314843,EDS 206R,B00,507343,Staff,23,0,30,7
1713511315871,EDS 250,A00,507344,Hemans; Patricia Ann Benitez,27,0,40,13
1713511316901,EDS 281,A00,507345,Daly; Alan J.,18,0,18,0
1713511317929,EDS 284,A00,507350,Daly; Alan J.,16,0,16,0
1713511318954,EDS 286,A00,507359,Fine; Sarah,18,0,18,0
1713511319980,EDS 289C,A01,507361,Daly; Alan J.,18,0,18,0
1713511321007,EDS 290,A00,507366,Hofstetter; Carolyn,15,0,15,0
1713511322038,LIGM 5A,A00,507421,Fischer-Grunski; Eva K,20,0,20,0
1713511323074,LIGM 5B,A00,507423,Fischer-Grunski; Eva K,20,0,20,0
1713511324106,LIGM 5C,A00,507425,Fischer-Grunski; Eva K,20,0,20,0
1713511325133,LIIT 5AS,A00,507427,Carnelos; Chiara,20,0,20,0
1713511326163,LIIT 5BS,A00,507430,Carnelos; Chiara,20,0,20,0
1713511327190,LIIT 5CS,A00,507432,Carnelos; Chiara,20,0,20,0
1713511328214,LISP 5A,A00,507541,Munoz Sanchez; Alicia,14,0,20,6
1713511329246,LISP 5B,A00,507671,Munoz Sanchez; Alicia,12,0,20,8
1713511330274,LISP 5C,A00,507696,Munoz Sanchez; Alicia,11,0,20,9
1713511331299,MAE 197,001,528363,Boechler; Nicholas Sebastia,9998,0,9999,1
1713511332323,MATH 197,001,523477,Kedlaya; Kiran S.,9999,0,9999,0
1713511332323,MATH 197,002,563811,Zhang; Danna,9998,0,9999,1
1713511333351,MCWP 40R,A00,518780,Staff,13,0,20,7
1713511333351,MCWP 40R,B00,518781,Staff,11,0,20,9
1713511333351,MCWP 40R,C00,518783,Staff,8,0,20,12
1713511334382,MCWP 50R,A00,518791,Staff,7,0,20,13
1713511334382,MCWP 50R,B00,518792,Staff,3,0,20,17
1713511334382,MCWP 50R,C00,518793,Staff,5,0,20,15
1713511334382,MCWP 50R,D00,518794,Staff,0,0,20,20
1713511334382,MCWP 50R,E00,518795,Staff,0,0,20,20
1713511334382,MCWP 50R,F00,518796,Staff,11,0,20,9
1713511334382,MCWP 50R,G00,518797,Staff,10,0,20,10
1713511335410,MMW 12R,A01,514034,Herbst; Matthew,1,0,16,15
1713511335410,MMW 12R,A02,514035,Herbst; Matthew,13,0,16,3
1713511336439,MMW 13R,A01,514037,Staff,0,8,16,16
1713511336439,MMW 13R,A02,514039,Staff,0,7,16,16
1713511338490,SIO 295LS,A00,523233,Staff,15,0,30,15
1713511339517,SIO 295S,A00,523232,Staff,15,0,30,15
1713511340546,SOCI 117,A01,494376,Staff,0,2,5,5
1713511341572,WES 237B,A00,494380,Staff,19,0,20,1
1713511343652,AESE 279B,A00,494370,Wade; Jon P,33,0,33,0
1713511344680,AIP 197,001,627712,Vespa; Emanuel Ignacio,9999,0,9999,0
1713511345708,ANAR 135S,A00,494369,Braswell; Geoffrey E.,0,0,0,0
1713511346734,CAT 124RS,A01,519847,Geibel; William,6,0,20,14
1713511347763,CAT 125RS,A01,515971,Geibel; William,6,0,20,14
1713511348793,CLRE 250,A00,511389,Morris; Sheldon,9996,0,9999,3
1713511349819,CLRE 251,A00,507176,Mehta; Ravindra L.,9996,0,9999,3
1713511349819,CLRE 251,B00,511410,Mehta; Ravindra L.,9998,0,9999,1
1713511350847,CLRE 252,A00,507189,Cuomo; Raphael Eduardo,9998,0,9999,1
1713511351877,CLRE 253,A00,507199,Vaida; Florin,9997,0,9999,2
1713511351877,CLRE 253,B00,507202,Vaida; Florin,9999,0,9999,0
1713511352907,CLRE 259,A00,507211,Patel; Hemal,9996,0,9999,3
1713511353932,CLRE 260,A00,507221,Cuomo; Raphael Eduardo,9999,0,9999,0
1713511354958,CLRE 297,001,507242,Cuomo; Raphael Eduardo,9999,0,9999,0
1713511355986,CSE 191,A00,516875,Minnes Kemp; Mor Mia,9999,0,9999,0
1713511357017,CSS 201S,A01,494383,Staff,35,0,35,0
1713511358047,CSS 202S,A01,494387,Staff,35,0,35,0
1713511359072,EAP 100,A00,516065,Staff,9792,0,9999,207
1713511360097,ECE 45,A01,507414,Staff,37,0,60,23
1713511361124,ECE 100,A01,507416,Baghdadchi; Saharnaz,0,0,20,20
1713511361124,ECE 100,A02,507418,Baghdadchi; Saharnaz,19,0,20,1
1713511362151,ECE 111,A01,507420,Staff,27,0,50,23
1713511363181,ECE 197,001,548057,Sievenpiper; Daniel F.,9998,0,9999,1
1713511364209,EDS 115,A00,507243,Choi; Bailey Miyeon,27,0,28,1
1713511365235,EDS 117,A01,494379,Staff,15,0,25,10
1713511366261,EDS 125,A00,507246,Hopkins; Megan Beth,27,0,30,3
1713511367289,EDS 128A,A01,507264,Fargason; Sharon Gayle,26,0,26,0
1713511368323,EDS 128B,A01,507293,Pappas; Elizabeth,30,0,30,0
1713511369353,EDS 139,A00,507294,Fargason; Sharon Gayle,30,0,30,0
1713511369353,EDS 139,B00,507313,Pappas; Elizabeth,30,0,30,0
1713511370386,EDS 201,A00,507315,Staff,18,0,30,12
1713511371412,EDS 203,A01,507317,Halter; Christopher P.,17,0,30,13
1713511372438,EDS 204R,A01,507319,Halter; Christopher P.,0,1,30,30
1713511372438,EDS 204R,B01,507331,Heinzman; Erica M.,22,0,30,8
1713511373467,EDS 206R,A00,507332,Staff,0,2,30,30
1713511373467,EDS 206R,B00,507343,Staff,23,0,30,7
1713511374494,EDS 250,A00,507344,Hemans; Patricia Ann Benitez,27,0,40,13
1713511375523,EDS 281,A00,507345,Daly; Alan J.,18,0,18,0
1713511376559,EDS 284,A00,507350,Daly; Alan J.,16,0,16,0
1713511377586,EDS 286,A00,507359,Fine; Sarah,18,0,18,0
1713511378612,EDS 289C,A01,507361,Daly; Alan J.,18,0,18,0
1713511379643,EDS 290,A00,507366,Hofstetter; Carolyn,15,0,15,0
1713511380677,LIGM 5A,A00,507421,Fischer-Grunski; Eva K,20,0,20,0
1713511381713,LIGM 5B,A00,507423,Fischer-Grunski; Eva K,20,0,20,0
1713511382746,LIGM 5C,A00,507425,Fischer-Grunski; Eva K,20,0,20,0
1713511383780,LIIT 5AS,A00,507427,Carnelos; Chiara,20,0,20,0
1713511384812,LIIT 5BS,A00,507430,Carnelos; Chiara,20,0,20,0
1713511385837,LIIT 5CS,A00,507432,Carnelos; Chiara,20,0,20,0
1713511386863,LISP 5A,A00,507541,Munoz Sanchez; Alicia,14,0,20,6
1713511387890,LISP 5B,A00,507671,Munoz Sanchez; Alicia,12,0,20,8
1713511388920,LISP 5C,A00,507696,Munoz Sanchez; Alicia,11,0,20,9
1713511389945,MAE 197,001,528363,Boechler; Nicholas Sebastia,9998,0,9999,1
1713511390975,MATH 197,001,523477,Kedlaya; Kiran S.,9999,0,9999,0
1713511390975,MATH 197,002,563811,Zhang; Danna,9998,0,9999,1
1713511392005,MCWP 40R,A00,518780,Staff,13,0,20,7
1713511392005,MCWP 40R,B00,518781,Staff,11,0,20,9
1713511392005,MCWP 40R,C00,518783,Staff,8,0,20,12
1713511393034,MCWP 50R,A00,518791,Staff,7,0,20,13
1713511393034,MCWP 50R,B00,518792,Staff,3,0,20,17
1713511393034,MCWP 50R,C00,518793,Staff,5,0,20,15
1713511393034,MCWP 50R,D00,518794,Staff,0,0,20,20
1713511393034,MCWP 50R,E00,518795,Staff,0,0,20,20
1713511393034,MCWP 50R,F00,518796,Staff,11,0,20,9
1713511393034,MCWP 50R,G00,518797,Staff,10,0,20,10
1713511394066,MMW 12R,A01,514034,Herbst; Matthew,1,0,16,15
1713511394066,MMW 12R,A02,514035,Herbst; Matthew,13,0,16,3
1713511395149,MMW 13R,A01,514037,Staff,0,8,16,16
1713511395149,MMW 13R,A02,514039,Staff,0,7,16,16
1713511397199,SIO 295LS,A00,523233,Staff,15,0,30,15
1713511398225,SIO 295S,A00,523232,Staff,15,0,30,15
1713511399251,SOCI 117,A01,494376,Staff,0,2,5,5
1713511400281,WES 237B,A00,494380,Staff,19,0,20,1
1713511402349,AESE 279B,A00,494370,Wade; Jon P,33,0,33,0
1713511403378,AIP 197,001,627712,Vespa; Emanuel Ignacio,9999,0,9999,0
1713511404409,ANAR 135S,A00,494369,Braswell; Geoffrey E.,0,0,0,0
1713511405436,CAT 124RS,A01,519847,Geibel; William,6,0,20,14
1713511406469,CAT 125RS,A01,515971,Geibel; William,6,0,20,14
1713511407496,CLRE 250,A00,511389,Morris; Sheldon,9996,0,9999,3
1713511408732,CLRE 251,A00,507176,Mehta; Ravindra L.,9996,0,9999,3
1713511408732,CLRE 251,B00,511410,Mehta; Ravindra L.,9998,0,9999,1
1713511409764,CLRE 252,A00,507189,Cuomo; Raphael Eduardo,9998,0,9999,1
1713511410792,CLRE 253,A00,507199,Vaida; Florin,9997,0,9999,2
1713511410792,CLRE 253,B00,507202,Vaida; Florin,9999,0,9999,0
1713511411820,CLRE 259,A00,507211,Patel; Hemal,9996,0,9999,3
1713511412849,CLRE 260,A00,507221,Cuomo; Raphael Eduardo,9999,0,9999,0
1713511413875,CLRE 297,001,507242,Cuomo; Raphael Eduardo,9999,0,9999,0
1713511414905,CSE 191,A00,516875,Minnes Kemp; Mor Mia,9999,0,9999,0
1713511415937,CSS 201S,A01,494383,Staff,35,0,35,0
1713511416964,CSS 202S,A01,494387,Staff,35,0,35,0
1713511417993,EAP 100,A00,516065,Staff,9792,0,9999,207
1713511419019,ECE 45,A01,507414,Staff,37,0,60,23
1713511420045,ECE 100,A01,507416,Baghdadchi; Saharnaz,0,0,20,20
1713511420045,ECE 100,A02,507418,Baghdadchi; Saharnaz,19,0,20,1
1713511421070,ECE 111,A01,507420,Staff,27,0,50,23
1713511422101,ECE 197,001,548057,Sievenpiper; Daniel F.,9998,0,9999,1
1713511423131,EDS 115,A00,507243,Choi; Bailey Miyeon,27,0,28,1
1713511424159,EDS 117,A01,494379,Staff,15,0,25,10
1713511425191,EDS 125,A00,507246,Hopkins; Megan Beth,27,0,30,3
1713511426223,EDS 128A,A01,507264,Fargason; Sharon Gayle,26,0,26,0
1713511427260,EDS 128B,A01,507293,Pappas; Elizabeth,30,0,30,0
1713511428292,EDS 139,A00,507294,Fargason; Sharon Gayle,30,0,30,0
1713511428292,EDS 139,B00,507313,Pappas; Elizabeth,30,0,30,0
1713511429317,EDS 201,A00,507315,Staff,18,0,30,12
1713511430345,EDS 203,A01,507317,Halter; Christopher P.,17,0,30,13
1713511431370,EDS 204R,A01,507319,Halter; Christopher P.,0,1,30,30
1713511431370,EDS 204R,B01,507331,Heinzman; Erica M.,22,0,30,8
1713511432401,EDS 206R,A00,507332,Staff,0,2,30,30
1713511432401,EDS 206R,B00,507343,Staff,23,0,30,7
1713511433431,EDS 250,A00,507344,Hemans; Patricia Ann Benitez,27,0,40,13
1713511434462,EDS 281,A00,507345,Daly; Alan J.,18,0,18,0
1713511435495,EDS 284,A00,507350,Daly; Alan J.,16,0,16,0
1713511436523,EDS 286,A00,507359,Fine; Sarah,18,0,18,0
1713511437550,EDS 289C,A01,507361,Daly; Alan J.,18,0,18,0
1713511438581,EDS 290,A00,507366,Hofstetter; Carolyn,15,0,15,0
1713511439610,LIGM 5A,A00,507421,Fischer-Grunski; Eva K,20,0,20,0
1713511440636,LIGM 5B,A00,507423,Fischer-Grunski; Eva K,20,0,20,0
1713511441671,LIGM 5C,A00,507425,Fischer-Grunski; Eva K,20,0,20,0
1713511442698,LIIT 5AS,A00,507427,Carnelos; Chiara,20,0,20,0
1713511443724,LIIT 5BS,A00,507430,Carnelos; Chiara,20,0,20,0
1713511444749,LIIT 5CS,A00,507432,Carnelos; Chiara,20,0,20,0
1713511445777,LISP 5A,A00,507541,Munoz Sanchez; Alicia,14,0,20,6
1713511446801,LISP 5B,A00,507671,Munoz Sanchez; Alicia,12,0,20,8
1713511447828,LISP 5C,A00,507696,Munoz Sanchez; Alicia,11,0,20,9
1713511448859,MAE 197,001,528363,Boechler; Nicholas Sebastia,9998,0,9999,1
1713511449893,MATH 197,001,523477,Kedlaya; Kiran S.,9999,0,9999,0
1713511449893,MATH 197,002,563811,Zhang; Danna,9998,0,9999,1
1713511450924,MCWP 40R,A00,518780,Staff,13,0,20,7
1713511450924,MCWP 40R,B00,518781,Staff,11,0,20,9
1713511450924,MCWP 40R,C00,518783,Staff,8,0,20,12
1713511451955,MCWP 50R,A00,518791,Staff,7,0,20,13
1713511451955,MCWP 50R,B00,518792,Staff,3,0,20,17
1713511451955,MCWP 50R,C00,518793,Staff,5,0,20,15
1713511451955,MCWP 50R,D00,518794,Staff,0,0,20,20
1713511451955,MCWP 50R,E00,518795,Staff,0,0,20,20
1713511451955,MCWP 50R,F00,518796,Staff,11,0,20,9
1713511451955,MCWP 50R,G00,518797,Staff,10,0,20,10
1713511452981,MMW 12R,A01,514034,Herbst; Matthew,1,0,16,15
1713511452981,MMW 12R,A02,514035,Herbst; Matthew,13,0,16,3
1713511454010,MMW 13R,A01,514037,Staff,0,8,16,16
1713511454010,MMW 13R,A02,514039,Staff,0,7,16,16
1713511456068,SIO 295LS,A00,523233,Staff,15,0,30,15
1713511457095,SIO 295S,A00,523232,Staff,15,0,30,15
1713511458133,SOCI 117,A01,494376,Staff,0,2,5,5
1713511459162,WES 237B,A00,494380,Staff,19,0,20,1
1713511461233,AESE 279B,A00,494370,Wade; Jon P,33,0,33,0
1713511462268,AIP 197,001,627712,Vespa; Emanuel Ignacio,9999,0,9999,0
1713511463298,ANAR 135S,A00,494369,Braswell; Geoffrey E.,0,0,0,0
1713511464326,CAT 124RS,A01,519847,Geibel; William,6,0,20,14
1713511465356,CAT 125RS,A01,515971,Geibel; William,6,0,20,14
1713511466388,CLRE 250,A00,511389,Morris; Sheldon,9996,0,9999,3
1713511467420,CLRE 251,A00,507176,Mehta; Ravindra L.,9996,0,9999,3
1713511467420,CLRE 251,B00,511410,Mehta; Ravindra L.,9998,0,9999,1
1713511468446,CLRE 252,A00,507189,Cuomo; Raphael Eduardo,9998,0,9999,1
1713511469474,CLRE 253,A00,507199,Vaida; Florin,9997,0,9999,2
1713511469474,CLRE 253,B00,507202,Vaida; Florin,9999,0,9999,0
1713511470501,CLRE 259,A00,507211,Patel; Hemal,9996,0,9999,3
1713511471536,CLRE 260,A00,507221,Cuomo; Raphael Eduardo,9999,0,9999,0
1713511472570,CLRE 297,001,507242,Cuomo; Raphael Eduardo,9999,0,9999,0
1713511473601,CSE 191,A00,516875,Minnes Kemp; Mor Mia,9999,0,9999,0
1713511474628,CSS 201S,A01,494383,Staff,35,0,35,0
1713511475656,CSS 202S,A01,494387,Staff,35,0,35,0
1713511476686,EAP 100,A00,516065,Staff,9792,0,9999,207
1713511477716,ECE 45,A01,507414,Staff,37,0,60,23
1713511478742,ECE 100,A01,507416,Baghdadchi; Saharnaz,0,0,20,20
1713511478742,ECE 100,A02,507418,Baghdadchi; Saharnaz,19,0,20,1
1713511479769,ECE 111,A01,507420,Staff,27,0,50,23
1713511480796,ECE 197,001,548057,Sievenpiper; Daniel F.,9998,0,9999,1
1713511481822,EDS 115,A00,507243,Choi; Bailey Miyeon,27,0,28,1
1713511482861,EDS 117,A01,494379,Staff,15,0,25,10
1713511483900,EDS 125,A00,507246,Hopkins; Megan Beth,27,0,30,3
1713511484932,EDS 128A,A01,507264,Fargason; Sharon Gayle,26,0,26,0
1713511485965,EDS 128B,A01,507293,Pappas; Elizabeth,30,0,30,0
1713511486993,EDS 139,A00,507294,Fargason; Sharon Gayle,30,0,30,0
1713511486993,EDS 139,B00,507313,Pappas; Elizabeth,30,0,30,0
1713511488021,EDS 201,A00,507315,Staff,18,0,30,12
1713511489052,EDS 203,A01,507317,Halter; Christopher P.,17,0,30,13
1713511490078,EDS 204R,A01,507319,Halter; Christopher P.,0,1,30,30
1713511490078,EDS 204R,B01,507331,Heinzman; Erica M.,22,0,30,8
1713511491113,EDS 206R,A00,507332,Staff,0,2,30,30
1713511491113,EDS 206R,B00,507343,Staff,23,0,30,7
1713511492146,EDS 250,A00,507344,Hemans; Patricia Ann Benitez,27,0,40,13
1713511493173,EDS 281,A00,507345,Daly; Alan J.,18,0,18,0
1713511494201,EDS 284,A00,507350,Daly; Alan J.,16,0,16,0
1713511495227,EDS 286,A00,507359,Fine; Sarah,18,0,18,0
1713511496263,EDS 289C,A01,507361,Daly; Alan J.,18,0,18,0
1713511497289,EDS 290,A00,507366,Hofstetter; Carolyn,15,0,15,0
1713511498315,LIGM 5A,A00,507421,Fischer-Grunski; Eva K,20,0,20,0
1713511499401,LIGM 5B,A00,507423,Fischer-Grunski; Eva K,20,0,20,0
1713511500453,LIGM 5C,A00,507425,Fischer-Grunski; Eva K,20,0,20,0
1713511501477,LIIT 5AS,A00,507427,Carnelos; Chiara,20,0,20,0
1713511502504,LIIT 5BS,A00,507430,Carnelos; Chiara,20,0,20,0
1713511503539,LIIT 5CS,A00,507432,Carnelos; Chiara,20,0,20,0
1713511504568,LISP 5A,A00,507541,Munoz Sanchez; Alicia,14,0,20,6
1713511505596,LISP 5B,A00,507671,Munoz Sanchez; Alicia,12,0,20,8
1713511506626,LISP 5C,A00,507696,Munoz Sanchez; Alicia,11,0,20,9
1713511507651,MAE 197,001,528363,Boechler; Nicholas Sebastia,9998,0,9999,1
1713511508679,MATH 197,001,523477,Kedlaya; Kiran S.,9999,0,9999,0
1713511508679,MATH 197,002,563811,Zhang; Danna,9998,0,9999,1
1713511509709,MCWP 40R,A00,518780,Staff,13,0,20,7
1713511509709,MCWP 40R,B00,518781,Staff,11,0,20,9
1713511509709,MCWP 40R,C00,518783,Staff,8,0,20,12
1713511510736,MCWP 50R,A00,518791,Staff,7,0,20,13
1713511510736,MCWP 50R,B00,518792,Staff,3,0,20,17
1713511510736,MCWP 50R,C00,518793,Staff,5,0,20,15
1713511510736,MCWP 50R,D00,518794,Staff,0,0,20,20
1713511510736,MCWP 50R,E00,518795,Staff,0,0,20,20
1713511510736,MCWP 50R,F00,518796,Staff,11,0,20,9
1713511510736,MCWP 50R,G00,518797,Staff,10,0,20,10
1713511511763,MMW 12R,A01,514034,Herbst; Matthew,1,0,16,15
1713511511763,MMW 12R,A02,514035,Herbst; Matthew,13,0,16,3
1713511512792,MMW 13R,A01,514037,Staff,0,8,16,16
1713511512792,MMW 13R,A02,514039,Staff,0,7,16,16
1713511514848,SIO 295LS,A00,523233,Staff,15,0,30,15
1713511515879,SIO 295S,A00,523232,Staff,15,0,30,15
1713511516909,SOCI 117,A01,494376,Staff,0,2,5,5
1713511517942,WES 237B,A00,494380,Staff,19,0,20,1
1713511520039,AESE 279B,A00,494370,Wade; Jon P,33,0,33,0
1713511521074,AIP 197,001,627712,Vespa; Emanuel Ignacio,9999,0,9999,0
1713511522108,ANAR 135S,A00,494369,Braswell; Geoffrey E.,0,0,0,0
1713511523141,CAT 124RS,A01,519847,Geibel; William,6,0,20,14
1713511524176,CAT 125RS,A01,515971,Geibel; William,6,0,20,14
1713511525210,CLRE 250,A00,511389,Morris; Sheldon,9996,0,9999,3
1713511526238,CLRE 251,A00,507176,Mehta; Ravindra L.,9996,0,9999,3
1713511526238,CLRE 251,B00,511410,Mehta; Ravindra L.,9998,0,9999,1
1713511527269,CLRE 252,A00,507189,Cuomo; Raphael Eduardo,9998,0,9999,1
1713511528304,CLRE 253,A00,507199,Vaida; Florin,9997,0,9999,2
1713511528304,CLRE 253,B00,507202,Vaida; Florin,9999,0,9999,0
1713511529332,CLRE 259,A00,507211,Patel; Hemal,9996,0,9999,3
1713511530363,CLRE 260,A00,507221,Cuomo; Raphael Eduardo,9999,0,9999,0
1713511531402,CLRE 297,001,507242,Cuomo; Raphael Eduardo,9999,0,9999,0
1713511532430,CSE 191,A00,516875,Minnes Kemp; Mor Mia,9999,0,9999,0
1713511533471,CSS 201S,A01,494383,Staff,35,0,35,0
1713511534496,CSS 202S,A01,494387,Staff,35,0,35,0
1713511535523,EAP 100,A00,516065,Staff,9792,0,9999,207
1713511536552,ECE 45,A01,507414,Staff,37,0,60,23
1713511537584,ECE 100,A01,507416,Baghdadchi; Saharnaz,0,0,20,20
1713511537584,ECE 100,A02,507418,Baghdadchi; Saharnaz,19,0,20,1
1713511538613,ECE 111,A01,507420,Staff,27,0,50,23
1713511539640,ECE 197,001,548057,Sievenpiper; Daniel F.,9998,0,9999,1
1713511540669,EDS 115,A00,507243,Choi; Bailey Miyeon,27,0,28,1
1713511541703,EDS 117,A01,494379,Staff,15,0,25,10
1713511542729,EDS 125,A00,507246,Hopkins; Megan Beth,27,0,30,3
1713511543760,EDS 128A,A01,507264,Fargason; Sharon Gayle,26,0,26,0
1713511544787,EDS 128B,A01,507293,Pappas; Elizabeth,30,0,30,0
1713511545814,EDS 139,A00,507294,Fargason; Sharon Gayle,30,0,30,0
1713511545814,EDS 139,B00,507313,Pappas; Elizabeth,30,0,30,0
1713511546848,EDS 201,A00,507315,Staff,18,0,30,12
1713511547882,EDS 203,A01,507317,Halter; Christopher P.,17,0,30,13
1713511548914,EDS 204R,A01,507319,Halter; Christopher P.,0,1,30,30
1713511548914,EDS 204R,B01,507331,Heinzman; Erica M.,22,0,30,8
1713511549941,EDS 206R,A00,507332,Staff,0,2,30,30
1713511549941,EDS 206R,B00,507343,Staff,23,0,30,7
1713511550975,EDS 250,A00,507344,Hemans; Patricia Ann Benitez,27,0,40,13
1713511552005,EDS 281,A00,507345,Daly; Alan J.,18,0,18,0
1713511553040,EDS 284,A00,507350,Daly; Alan J.,16,0,16,0
1713511554071,EDS 286,A00,507359,Fine; Sarah,18,0,18,0
1713511555101,EDS 289C,A01,507361,Daly; Alan J.,18,0,18,0
1713511556125,EDS 290,A00,507366,Hofstetter; Carolyn,15,0,15,0
1713511557153,LIGM 5A,A00,507421,Fischer-Grunski; Eva K,20,0,20,0
1713511558179,LIGM 5B,A00,507423,Fischer-Grunski; Eva K,20,0,20,0
1713511559206,LIGM 5C,A00,507425,Fischer-Grunski; Eva K,20,0,20,0
1713511560236,LIIT 5AS,A00,507427,Carnelos; Chiara,20,0,20,0
1713511561263,LIIT 5BS,A00,507430,Carnelos; Chiara,20,0,20,0
1713511562291,LIIT 5CS,A00,507432,Carnelos; Chiara,20,0,20,0
1713511563322,LISP 5A,A00,507541,Munoz Sanchez; Alicia,14,0,20,6
1713511564358,LISP 5B,A00,507671,Munoz Sanchez; Alicia,12,0,20,8
1713511565393,LISP 5C,A00,507696,Munoz Sanchez; Alicia,11,0,20,9
1713511566428,MAE 197,001,528363,Boechler; Nicholas Sebastia,9998,0,9999,1
1713511567454,MATH 197,001,523477,Kedlaya; Kiran S.,9999,0,9999,0
1713511567454,MATH 197,002,563811,Zhang; Danna,9998,0,9999,1
1713511568481,MCWP 40R,A00,518780,Staff,13,0,20,7
1713511568481,MCWP 40R,B00,518781,Staff,11,0,20,9
1713511568481,MCWP 40R,C00,518783,Staff,8,0,20,12
1713511569511,MCWP 50R,A00,518791,Staff,7,0,20,13
1713511569511,MCWP 50R,B00,518792,Staff,3,0,20,17
1713511569511,MCWP 50R,C00,518793,Staff,5,0,20,15
1713511569511,MCWP 50R,D00,518794,Staff,0,0,20,20
1713511569511,MCWP 50R,E00,518795,Staff,0,0,20,20
1713511569511,MCWP 50R,F00,518796,Staff,11,0,20,9
1713511569511,MCWP 50R,G00,518797,Staff,10,0,20,10
1713511570545,MMW 12R,A01,514034,Herbst; Matthew,1,0,16,15
1713511570545,MMW 12R,A02,514035,Herbst; Matthew,13,0,16,3
1713511571571,MMW 13R,A01,514037,Staff,0,8,16,16
1713511571571,MMW 13R,A02,514039,Staff,0,7,16,16
1713511573630,SIO 295LS,A00,523233,Staff,15,0,30,15
1713511574657,SIO 295S,A00,523232,Staff,15,0,30,15
1713511575685,SOCI 117,A01,494376,Staff,0,2,5,5
1713511576710,WES 237B,A00,494380,Staff,19,0,20,1
1713511578782,AESE 279B,A00,494370,Wade; Jon P,33,0,33,0
1713511579810,AIP 197,001,627712,Vespa; Emanuel Ignacio,9999,0,9999,0
1713511580838,ANAR 135S,A00,494369,Braswell; Geoffrey E.,0,0,0,0
1713511581864,CAT 124RS,A01,519847,Geibel; William,6,0,20,14
1713511582896,CAT 125RS,A01,515971,Geibel; William,6,0,20,14
1713511583926,CLRE 250,A00,511389,Morris; Sheldon,9996,0,9999,3
1713511584953,CLRE 251,A00,507176,Mehta; Ravindra L.,9996,0,9999,3
1713511584953,CLRE 251,B00,511410,Mehta; Ravindra L.,9998,0,9999,1
1713511585986,CLRE 252,A00,507189,Cuomo; Raphael Eduardo,9998,0,9999,1
1713511587020,CLRE 253,A00,507199,Vaida; Florin,9997,0,9999,2
1713511587020,CLRE 253,B00,507202,Vaida; Florin,9999,0,9999,0
1713511588046,CLRE 259,A00,507211,Patel; Hemal,9996,0,9999,3
1713511589074,CLRE 260,A00,507221,Cuomo; Raphael Eduardo,9999,0,9999,0
1713511590108,CLRE 297,001,507242,Cuomo; Raphael Eduardo,9999,0,9999,0
1713511591140,CSE 191,A00,516875,Minnes Kemp; Mor Mia,9999,0,9999,0
1713511592175,CSS 201S,A01,494383,Staff,35,0,35,0
1713511593209,CSS 202S,A01,494387,Staff,35,0,35,0
1713511594234,EAP 100,A00,516065,Staff,9792,0,9999,207
1713511595263,ECE 45,A01,507414,Staff,37,0,60,23
1713511596290,ECE 100,A01,507416,Baghdadchi; Saharnaz,0,0,20,20
1713511596290,ECE 100,A02,507418,Baghdadchi; Saharnaz,19,0,20,1
1713511597316,ECE 111,A01,507420,Staff,27,0,50,23
1713511598340,ECE 197,001,548057,Sievenpiper; Daniel F.,9998,0,9999,1
1713511599368,EDS 115,A00,507243,Choi; Bailey Miyeon,27,0,28,1
1713511600397,EDS 117,A01,494379,Staff,15,0,25,10
1713511601428,EDS 125,A00,507246,Hopkins; Megan Beth,27,0,30,3
1713511602459,EDS 128A,A01,507264,Fargason; Sharon Gayle,26,0,26,0
1713511603552,EDS 128B,A01,507293,Pappas; Elizabeth,30,0,30,0
1713511604585,EDS 139,A00,507294,Fargason; Sharon Gayle,30,0,30,0
1713511604585,EDS 139,B00,507313,Pappas; Elizabeth,30,0,30,0
1713511605613,EDS 201,A00,507315,Staff,18,0,30,12
1713511606642,EDS 203,A01,507317,Halter; Christopher P.,17,0,30,13
1713511607668,EDS 204R,A01,507319,Halter; Christopher P.,0,1,30,30
1713511607668,EDS 204R,B01,507331,Heinzman; Erica M.,22,0,30,8
1713511608706,EDS 206R,A00,507332,Staff,0,2,30,30
1713511608706,EDS 206R,B00,507343,Staff,23,0,30,7
1713511609731,EDS 250,A00,507344,Hemans; Patricia Ann Benitez,27,0,40,13
1713511610764,EDS 281,A00,507345,Daly; Alan J.,18,0,18,0
1713511611795,EDS 284,A00,507350,Daly; Alan J.,16,0,16,0
1713511612822,EDS 286,A00,507359,Fine; Sarah,18,0,18,0
1713511613848,EDS 289C,A01,507361,Daly; Alan J.,18,0,18,0
1713511614878,EDS 290,A00,507366,Hofstetter; Carolyn,15,0,15,0
1713511615912,LIGM 5A,A00,507421,Fischer-Grunski; Eva K,20,0,20,0
1713511616938,LIGM 5B,A00,507423,Fischer-Grunski; Eva K,20,0,20,0
1713511617965,LIGM 5C,A00,507425,Fischer-Grunski; Eva K,20,0,20,0
1713511618997,LIIT 5AS,A00,507427,Carnelos; Chiara,20,0,20,0
1713511620025,LIIT 5BS,A00,507430,Carnelos; Chiara,20,0,20,0
1713511621057,LIIT 5CS,A00,507432,Carnelos; Chiara,20,0,20,0
1713511622091,LISP 5A,A00,507541,Munoz Sanchez; Alicia,14,0,20,6
1713511623123,LISP 5B,A00,507671,Munoz Sanchez; Alicia,12,0,20,8
1713511624149,LISP 5C,A00,507696,Munoz Sanchez; Alicia,11,0,20,9
1713511625181,MAE 197,001,528363,Boechler; Nicholas Sebastia,9998,0,9999,1
1713511626208,MATH 197,001,523477,Kedlaya; Kiran S.,9999,0,9999,0
1713511626208,MATH 197,002,563811,Zhang; Danna,9998,0,9999,1
1713511627234,MCWP 40R,A00,518780,Staff,13,0,20,7
1713511627234,MCWP 40R,B00,518781,Staff,11,0,20,9
1713511627234,MCWP 40R,C00,518783,Staff,8,0,20,12
1713511628262,MCWP 50R,A00,518791,Staff,7,0,20,13
1713511628262,MCWP 50R,B00,518792,Staff,3,0,20,17
1713511628262,MCWP 50R,C00,518793,Staff,5,0,20,15
1713511628262,MCWP 50R,D00,518794,Staff,0,0,20,20
1713511628262,MCWP 50R,E00,518795,Staff,0,0,20,20
1713511628262,MCWP 50R,F00,518796,Staff,11,0,20,9
1713511628262,MCWP 50R,G00,518797,Staff,10,0,20,10
1713511629291,MMW 12R,A01,514034,Herbst; Matthew,1,0,16,15
1713511629291,MMW 12R,A02,514035,Herbst; Matthew,13,0,16,3
1713511630325,MMW 13R,A01,514037,Staff,0,8,16,16
1713511630325,MMW 13R,A02,514039,Staff,0,7,16,16
1713511632390,SIO 295LS,A00,523233,Staff,15,0,30,15
1713511633421,SIO 295S,A00,523232,Staff,15,0,30,15
1713511634448,SOCI 117,A01,494376,Staff,0,2,5,5
1713511635481,WES 237B,A00,494380,Staff,19,0,20,1
1713511637573,AESE 279B,A00,494370,Wade; Jon P,33,0,33,0
1713511638600,AIP 197,001,627712,Vespa; Emanuel Ignacio,9999,0,9999,0
1713511639627,ANAR 135S,A00,494369,Braswell; Geoffrey E.,0,0,0,0
1713511640660,CAT 124RS,A01,519847,Geibel; William,6,0,20,14
1713511641692,CAT 125RS,A01,515971,Geibel; William,6,0,20,14
1713511642718,CLRE 250,A00,511389,Morris; Sheldon,9996,0,9999,3
1713511643757,CLRE 251,A00,507176,Mehta; Ravindra L.,9996,0,9999,3
1713511643757,CLRE 251,B00,511410,Mehta; Ravindra L.,9998,0,9999,1
1713511644784,CLRE 252,A00,507189,Cuomo; Raphael Eduardo,9998,0,9999,1
1713511645817,CLRE 253,A00,507199,Vaida; Florin,9997,0,9999,2
1713511645817,CLRE 253,B00,507202,Vaida; Florin,9999,0,9999,0
1713511646853,CLRE 259,A00,507211,Patel; Hemal,9996,0,9999,3
1713511647884,CLRE 260,A00,507221,Cuomo; Raphael Eduardo,9999,0,9999,0
1713511648915,CLRE 297,001,507242,Cuomo; Raphael Eduardo,9999,0,9999,0
1713511649940,CSE 191,A00,516875,Minnes Kemp; Mor Mia,9999,0,9999,0
1713511650970,CSS 201S,A01,494383,Staff,35,0,35,0
1713511651995,CSS 202S,A01,494387,Staff,35,0,35,0
1713511653023,EAP 100,A00,516065,Staff,9792,0,9999,207
1713511654056,ECE 45,A01,507414,Staff,37,0,60,23
1713511655083,ECE 100,A01,507416,Baghdadchi; Saharnaz,0,0,20,20
1713511655083,ECE 100,A02,507418,Baghdadchi; Saharnaz,19,0,20,1
1713511656116,ECE 111,A01,507420,Staff,27,0,50,23
1713511657143,ECE 197,001,548057,Sievenpiper; Daniel F.,9998,0,9999,1
1713511658177,EDS 115,A00,507243,Choi; Bailey Miyeon,27,0,28,1
1713511659212,EDS 117,A01,494379,Staff,15,0,25,10
1713511660240,EDS 125,A00,507246,Hopkins; Megan Beth,27,0,30,3
1713511661271,EDS 128A,A01,507264,Fargason; Sharon Gayle,26,0,26,0
1713511662304,EDS 128B,A01,507293,Pappas; Elizabeth,30,0,30,0
1713511663329,EDS 139,A00,507294,Fargason; Sharon Gayle,30,0,30,0
1713511663329,EDS 139,B00,507313,Pappas; Elizabeth,30,0,30,0
1713511664358,EDS 201,A00,507315,Staff,18,0,30,12
1713511665384,EDS 203,A01,507317,Halter; Christopher P.,17,0,30,13
1713511666410,EDS 204R,A01,507319,Halter; Christopher P.,0,1,30,30
1713511666410,EDS 204R,B01,507331,Heinzman; Erica M.,22,0,30,8
1713511667441,EDS 206R,A00,507332,Staff,0,2,30,30
1713511667441,EDS 206R,B00,507343,Staff,23,0,30,7
1713511668467,EDS 250,A00,507344,Hemans; Patricia Ann Benitez,27,0,40,13
1713511669511,EDS 281,A00,507345,Daly; Alan J.,18,0,18,0
1713511670541,EDS 284,A00,507350,Daly; Alan J.,16,0,16,0
1713511671567,EDS 286,A00,507359,Fine; Sarah,18,0,18,0
1713511672596,EDS 289C,A01,507361,Daly; Alan J.,18,0,18,0
1713511673629,EDS 290,A00,507366,Hofstetter; Carolyn,15,0,15,0
1713511674654,LIGM 5A,A00,507421,Fischer-Grunski; Eva K,20,0,20,0
1713511675679,LIGM 5B,A00,507423,Fischer-Grunski; Eva K,20,0,20,0
1713511676707,LIGM 5C,A00,507425,Fischer-Grunski; Eva K,20,0,20,0
1713511677735,LIIT 5AS,A00,507427,Carnelos; Chiara,20,0,20,0
1713511678768,LIIT 5BS,A00,507430,Carnelos; Chiara,20,0,20,0
1713511679794,LIIT 5CS,A00,507432,Carnelos; Chiara,20,0,20,0
1713511680821,LISP 5A,A00,507541,Munoz Sanchez; Alicia,14,0,20,6
1713511681851,LISP 5B,A00,507671,Munoz Sanchez; Alicia,12,0,20,8
1713511682882,LISP 5C,A00,507696,Munoz Sanchez; Alicia,11,0,20,9
1713511683909,MAE 197,001,528363,Boechler; Nicholas Sebastia,9998,0,9999,1
1713511684941,MATH 197,001,523477,Kedlaya; Kiran S.,9999,0,9999,0
1713511684941,MATH 197,002,563811,Zhang; Danna,9998,0,9999,1
1713511685969,MCWP 40R,A00,518780,Staff,13,0,20,7
1713511685969,MCWP 40R,B00,518781,Staff,11,0,20,9
1713511685969,MCWP 40R,C00,518783,Staff,8,0,20,12
1713511687000,MCWP 50R,A00,518791,Staff,7,0,20,13
1713511687000,MCWP 50R,B00,518792,Staff,3,0,20,17
1713511687000,MCWP 50R,C00,518793,Staff,5,0,20,15
1713511687000,MCWP 50R,D00,518794,Staff,0,0,20,20
1713511687000,MCWP 50R,E00,518795,Staff,0,0,20,20
1713511687000,MCWP 50R,F00,518796,Staff,11,0,20,9
1713511687000,MCWP 50R,G00,518797,Staff,10,0,20,10
1713511688035,MMW 12R,A01,514034,Herbst; Matthew,1,0,16,15
1713511688035,MMW 12R,A02,514035,Herbst; Matthew,13,0,16,3
1713511689066,MMW 13R,A01,514037,Staff,0,8,16,16
1713511689066,MMW 13R,A02,514039,Staff,0,7,16,16
1713511691129,SIO 295LS,A00,523233,Staff,15,0,30,15
1713511692157,SIO 295S,A00,523232,Staff,15,0,30,15
1713511693183,SOCI 117,A01,494376,Staff,0,2,5,5
1713511694215,WES 237B,A00,494380,Staff,19,0,20,1
1713511696306,AESE 279B,A00,494370,Wade; Jon P,33,0,33,0
1713511697336,AIP 197,001,627712,Vespa; Emanuel Ignacio,9999,0,9999,0
1713511698367,ANAR 135S,A00,494369,Braswell; Geoffrey E.,0,0,0,0
1713511699395,CAT 124RS,A01,519847,Geibel; William,6,0,20,14
1713511700422,CAT 125RS,A01,515971,Geibel; William,6,0,20,14
1713511701457,CLRE 250,A00,511389,Morris; Sheldon,9996,0,9999,3
1713511702485,CLRE 251,A00,507176,Mehta; Ravindra L.,9996,0,9999,3
1713511702485,CLRE 251,B00,511410,Mehta; Ravindra L.,9998,0,9999,1
1713511703512,CLRE 252,A00,507189,Cuomo; Raphael Eduardo,9998,0,9999,1
1713511704544,CLRE 253,A00,507199,Vaida; Florin,9997,0,9999,2
1713511704544,CLRE 253,B00,507202,Vaida; Florin,9999,0,9999,0
1713511705569,CLRE 259,A00,507211,Patel; Hemal,9996,0,9999,3
1713511706598,CLRE 260,A00,507221,Cuomo; Raphael Eduardo,9999,0,9999,0
1713511707682,CLRE 297,001,507242,Cuomo; Raphael Eduardo,9999,0,9999,0
1713511708708,CSE 191,A00,516875,Minnes Kemp; Mor Mia,9999,0,9999,0
1713511709734,CSS 201S,A01,494383,Staff,35,0,35,0
1713511710760,CSS 202S,A01,494387,Staff,35,0,35,0
1713511711786,EAP 100,A00,516065,Staff,9792,0,9999,207
1713511712812,ECE 45,A01,507414,Staff,37,0,60,23
1713511713842,ECE 100,A01,507416,Baghdadchi; Saharnaz,0,0,20,20
1713511713842,ECE 100,A02,507418,Baghdadchi; Saharnaz,19,0,20,1
1713511714872,ECE 111,A01,507420,Staff,27,0,50,23
1713511715899,ECE 197,001,548057,Sievenpiper; Daniel F.,9998,0,9999,1
1713511716925,EDS 115,A00,507243,Choi; Bailey Miyeon,27,0,28,1
1713511717956,EDS 117,A01,494379,Staff,15,0,25,10
1713511718982,EDS 125,A00,507246,Hopkins; Megan Beth,27,0,30,3
1713511720015,EDS 128A,A01,507264,Fargason; Sharon Gayle,26,0,26,0
1713511721041,EDS 128B,A01,507293,Pappas; Elizabeth,30,0,30,0
1713511722066,EDS 139,A00,507294,Fargason; Sharon Gayle,30,0,30,0
1713511722066,EDS 139,B00,507313,Pappas; Elizabeth,30,0,30,0
1713511723093,EDS 201,A00,507315,Staff,18,0,30,12
1713511724120,EDS 203,A01,507317,Halter; Christopher P.,17,0,30,13
1713511725147,EDS 204R,A01,507319,Halter; Christopher P.,0,1,30,30
1713511725147,EDS 204R,B01,507331,Heinzman; Erica M.,22,0,30,8
1713511726176,EDS 206R,A00,507332,Staff,0,2,30,30
1713511726176,EDS 206R,B00,507343,Staff,23,0,30,7
1713511727203,EDS 250,A00,507344,Hemans; Patricia Ann Benitez,27,0,40,13
1713511728230,EDS 281,A00,507345,Daly; Alan J.,18,0,18,0
1713511729265,EDS 284,A00,507350,Daly; Alan J.,16,0,16,0
1713511730298,EDS 286,A00,507359,Fine; Sarah,18,0,18,0
1713511731323,EDS 289C,A01,507361,Daly; Alan J.,18,0,18,0
1713511732349,EDS 290,A00,507366,Hofstetter; Carolyn,15,0,15,0
1713511733381,LIGM 5A,A00,507421,Fischer-Grunski; Eva K,20,0,20,0
1713511734413,LIGM 5B,A00,507423,Fischer-Grunski; Eva K,20,0,20,0
1713511735438,LIGM 5C,A00,507425,Fischer-Grunski; Eva K,20,0,20,0
1713511736464,LIIT 5AS,A00,507427,Carnelos; Chiara,20,0,20,0
1713511737493,LIIT 5BS,A00,507430,Carnelos; Chiara,20,0,20,0
1713511738517,LIIT 5CS,A00,507432,Carnelos; Chiara,20,0,20,0
1713511739544,LISP 5A,A00,507541,Munoz Sanchez; Alicia,14,0,20,6
1713511740568,LISP 5B,A00,507671,Munoz Sanchez; Alicia,12,0,20,8
1713511741595,LISP 5C,A00,507696,Munoz Sanchez; Alicia,11,0,20,9
1713511742621,MAE 197,001,528363,Boechler; Nicholas Sebastia,9998,0,9999,1
1713511743646,MATH 197,001,523477,Kedlaya; Kiran S.,9999,0,9999,0
1713511743646,MATH 197,002,563811,Zhang; Danna,9998,0,9999,1
1713511744670,MCWP 40R,A00,518780,Staff,13,0,20,7
1713511744670,MCWP 40R,B00,518781,Staff,11,0,20,9
1713511744670,MCWP 40R,C00,518783,Staff,8,0,20,12
1713511745701,MCWP 50R,A00,518791,Staff,7,0,20,13
1713511745701,MCWP 50R,B00,518792,Staff,3,0,20,17
1713511745701,MCWP 50R,C00,518793,Staff,5,0,20,15
1713511745701,MCWP 50R,D00,518794,Staff,0,0,20,20
1713511745701,MCWP 50R,E00,518795,Staff,0,0,20,20
1713511745701,MCWP 50R,F00,518796,Staff,11,0,20,9
1713511745701,MCWP 50R,G00,518797,Staff,10,0,20,10
1713511746727,MMW 12R,A01,514034,Herbst; Matthew,1,0,16,15
1713511746727,MMW 12R,A02,514035,Herbst; Matthew,13,0,16,3
1713511747757,MMW 13R,A01,514037,Staff,0,8,16,16
1713511747757,MMW 13R,A02,514039,Staff,0,7,16,16
1713511749820,SIO 295LS,A00,523233,Staff,15,0,30,15
1713511750845,SIO 295S,A00,523232,Staff,15,0,30,15
1713511751872,SOCI 117,A01,494376,Staff,0,2,5,5
1713511752899,WES 237B,A00,494380,Staff,19,0,20,1
1713511754979,AESE 279B,A00,494370,Wade; Jon P,33,0,33,0
1713511756006,AIP 197,001,627712,Vespa; Emanuel Ignacio,9999,0,9999,0
1713511757030,ANAR 135S,A00,494369,Braswell; Geoffrey E.,0,0,0,0
1713511758057,CAT 124RS,A01,519847,Geibel; William,6,0,20,14
1713511759082,CAT 125RS,A01,515971,Geibel; William,6,0,20,14
1713511760108,CLRE 250,A00,511389,Morris; Sheldon,9996,0,9999,3
1713511761144,CLRE 251,A00,507176,Mehta; Ravindra L.,9996,0,9999,3
1713511761144,CLRE 251,B00,511410,Mehta; Ravindra L.,9998,0,9999,1
1713511762171,CLRE 252,A00,507189,Cuomo; Raphael Eduardo,9998,0,9999,1
1713511763204,CLRE 253,A00,507199,Vaida; Florin,9997,0,9999,2
1713511763204,CLRE 253,B00,507202,Vaida; Florin,9999,0,9999,0
1713511764231,CLRE 259,A00,507211,Patel; Hemal,9996,0,9999,3
1713511765262,CLRE 260,A00,507221,Cuomo; Raphael Eduardo,9999,0,9999,0
1713511766846,CLRE 297,001,507242,Cuomo; Raphael Eduardo,9999,0,9999,0
1713511767876,CSE 191,A00,516875,Minnes Kemp; Mor Mia,9999,0,9999,0
1713511768904,CSS 201S,A01,494383,Staff,35,0,35,0
1713511769929,CSS 202S,A01,494387,Staff,35,0,35,0
1713511770958,EAP 100,A00,516065,Staff,9792,0,9999,207
1713511771987,ECE 45,A01,507414,Staff,37,0,60,23
1713511773014,ECE 100,A01,507416,Baghdadchi; Saharnaz,0,0,20,20
1713511773014,ECE 100,A02,507418,Baghdadchi; Saharnaz,19,0,20,1
1713511774052,ECE 111,A01,507420,Staff,27,0,50,23
1713511775078,ECE 197,001,548057,Sievenpiper; Daniel F.,9998,0,9999,1
1713511776103,EDS 115,A00,507243,Choi; Bailey Miyeon,27,0,28,1
1713511777132,EDS 117,A01,494379,Staff,15,0,25,10
1713511778158,EDS 125,A00,507246,Hopkins; Megan Beth,27,0,30,3
1713511779183,EDS 128A,A01,507264,Fargason; Sharon Gayle,26,0,26,0
1713511780209,EDS 128B,A01,507293,Pappas; Elizabeth,30,0,30,0
1713511781235,EDS 139,A00,507294,Fargason; Sharon Gayle,30,0,30,0
1713511781235,EDS 139,B00,507313,Pappas; Elizabeth,30,0,30,0
1713511782265,EDS 201,A00,507315,Staff,18,0,30,12
1713511783295,EDS 203,A01,507317,Halter; Christopher P.,17,0,30,13
1713511784321,EDS 204R,A01,507319,Halter; Christopher P.,0,1,30,30
1713511784321,EDS 204R,B01,507331,Heinzman; Erica M.,22,0,30,8
1713511785355,EDS 206R,A00,507332,Staff,0,2,30,30
1713511785355,EDS 206R,B00,507343,Staff,23,0,30,7
1713511786384,EDS 250,A00,507344,Hemans; Patricia Ann Benitez,27,0,40,13
1713511787410,EDS 281,A00,507345,Daly; Alan J.,18,0,18,0
1713511788440,EDS 284,A00,507350,Daly; Alan J.,16,0,16,0
1713511789464,EDS 286,A00,507359,Fine; Sarah,18,0,18,0
1713511790493,EDS 289C,A01,507361,Daly; Alan J.,18,0,18,0
1713511791518,EDS 290,A00,507366,Hofstetter; Carolyn,15,0,15,0
1713511792546,LIGM 5A,A00,507421,Fischer-Grunski; Eva K,20,0,20,0
1713511793571,LIGM 5B,A00,507423,Fischer-Grunski; Eva K,20,0,20,0
1713511794597,LIGM 5C,A00,507425,Fischer-Grunski; Eva K,20,0,20,0
1713511795622,LIIT 5AS,A00,507427,Carnelos; Chiara,20,0,20,0
1713511796648,LIIT 5BS,A00,507430,Carnelos; Chiara,20,0,20,0
1713511797673,LIIT 5CS,A00,507432,Carnelos; Chiara,20,0,20,0
1713511798703,LISP 5A,A00,507541,Munoz Sanchez; Alicia,14,0,20,6
1713511799730,LISP 5B,A00,507671,Munoz Sanchez; Alicia,12,0,20,8
1713511800765,LISP 5C,A00,507696,Munoz Sanchez; Alicia,11,0,20,9
1713511801790,MAE 197,001,528363,Boechler; Nicholas Sebastia,9998,0,9999,1
1713511802815,MATH 197,001,523477,Kedlaya; Kiran S.,9999,0,9999,0
1713511802815,MATH 197,002,563811,Zhang; Danna,9998,0,9999,1
1713511803839,MCWP 40R,A00,518780,Staff,13,0,20,7
1713511803839,MCWP 40R,B00,518781,Staff,11,0,20,9
1713511803839,MCWP 40R,C00,518783,Staff,8,0,20,12
1713511804869,MCWP 50R,A00,518791,Staff,7,0,20,13
1713511804869,MCWP 50R,B00,518792,Staff,3,0,20,17
1713511804869,MCWP 50R,C00,518793,Staff,5,0,20,15
1713511804869,MCWP 50R,D00,518794,Staff,0,0,20,20
1713511804869,MCWP 50R,E00,518795,Staff,0,0,20,20
1713511804869,MCWP 50R,F00,518796,Staff,11,0,20,9
1713511804869,MCWP 50R,G00,518797,Staff,10,0,20,10
1713511805894,MMW 12R,A01,514034,Herbst; Matthew,1,0,16,15
1713511805894,MMW 12R,A02,514035,Herbst; Matthew,13,0,16,3
1713511806922,MMW 13R,A01,514037,Staff,0,8,16,16
1713511806922,MMW 13R,A02,514039,Staff,0,7,16,16
1713511808981,SIO 295LS,A00,523233,Staff,15,0,30,15
1713511810007,SIO 295S,A00,523232,Staff,15,0,30,15
1713511811032,SOCI 117,A01,494376,Staff,0,2,5,5
1713511812115,WES 237B,A00,494380,Staff,19,0,20,1
1713511814187,AESE 279B,A00,494370,Wade; Jon P,33,0,33,0
1713511815216,AIP 197,001,627712,Vespa; Emanuel Ignacio,9999,0,9999,0
1713511816244,ANAR 135S,A00,494369,Braswell; Geoffrey E.,0,0,0,0
1713511817270,CAT 124RS,A01,519847,Geibel; William,6,0,20,14
1713511818296,CAT 125RS,A01,515971,Geibel; William,6,0,20,14
1713511819321,CLRE 250,A00,511389,Morris; Sheldon,9996,0,9999,3
1713511820351,CLRE 251,A00,507176,Mehta; Ravindra L.,9996,0,9999,3
1713511820351,CLRE 251,B00,511410,Mehta; Ravindra L.,9998,0,9999,1
1713511821375,CLRE 252,A00,507189,Cuomo; Raphael Eduardo,9998,0,9999,1
1713511822406,CLRE 253,A00,507199,Vaida; Florin,9997,0,9999,2
1713511822406,CLRE 253,B00,507202,Vaida; Florin,9999,0,9999,0
1713511823435,CLRE 259,A00,507211,Patel; Hemal,9996,0,9999,3
1713511824461,CLRE 260,A00,507221,Cuomo; Raphael Eduardo,9999,0,9999,0
1713511825491,CLRE 297,001,507242,Cuomo; Raphael Eduardo,9999,0,9999,0
1713511826515,CSE 191,A00,516875,Minnes Kemp; Mor Mia,9999,0,9999,0
1713511827542,CSS 201S,A01,494383,Staff,35,0,35,0
1713511828573,CSS 202S,A01,494387,Staff,35,0,35,0
1713511829598,EAP 100,A00,516065,Staff,9792,0,9999,207
1713511830628,ECE 45,A01,507414,Staff,37,0,60,23
1713511831653,ECE 100,A01,507416,Baghdadchi; Saharnaz,0,0,20,20
1713511831653,ECE 100,A02,507418,Baghdadchi; Saharnaz,19,0,20,1
1713511832681,ECE 111,A01,507420,Staff,27,0,50,23
1713511833710,ECE 197,001,548057,Sievenpiper; Daniel F.,9998,0,9999,1
1713511834738,EDS 115,A00,507243,Choi; Bailey Miyeon,27,0,28,1
1713511835763,EDS 117,A01,494379,Staff,15,0,25,10
1713511836792,EDS 125,A00,507246,Hopkins; Megan Beth,27,0,30,3
1713511837825,EDS 128A,A01,507264,Fargason; Sharon Gayle,26,0,26,0
1713511838849,EDS 128B,A01,507293,Pappas; Elizabeth,30,0,30,0
1713511839898,EDS 139,A00,507294,Fargason; Sharon Gayle,30,0,30,0
1713511839898,EDS 139,B00,507313,Pappas; Elizabeth,30,0,30,0
1713511840924,EDS 201,A00,507315,Staff,18,0,30,12
1713511841949,EDS 203,A01,507317,Halter; Christopher P.,17,0,30,13
1713511842974,EDS 204R,A01,507319,Halter; Christopher P.,0,1,30,30
1713511842974,EDS 204R,B01,507331,Heinzman; Erica M.,22,0,30,8
1713511844002,EDS 206R,A00,507332,Staff,0,2,30,30
1713511844002,EDS 206R,B00,507343,Staff,23,0,30,7
1713511845029,EDS 250,A00,507344,Hemans; Patricia Ann Benitez,27,0,40,13
1713511846054,EDS 281,A00,507345,Daly; Alan J.,18,0,18,0
1713511847079,EDS 284,A00,507350,Daly; Alan J.,16,0,16,0
1713511848103,EDS 286,A00,507359,Fine; Sarah,18,0,18,0
1713511849131,EDS 289C,A01,507361,Daly; Alan J.,18,0,18,0
1713511850160,EDS 290,A00,507366,Hofstetter; Carolyn,15,0,15,0
1713511851191,LIGM 5A,A00,507421,Fischer-Grunski; Eva K,20,0,20,0
1713511852221,LIGM 5B,A00,507423,Fischer-Grunski; Eva K,20,0,20,0
1713511853250,LIGM 5C,A00,507425,Fischer-Grunski; Eva K,20,0,20,0
1713511854279,LIIT 5AS,A00,507427,Carnelos; Chiara,20,0,20,0
1713511855305,LIIT 5BS,A00,507430,Carnelos; Chiara,20,0,20,0
1713511856331,LIIT 5CS,A00,507432,Carnelos; Chiara,20,0,20,0
1713511857356,LISP 5A,A00,507541,Munoz Sanchez; Alicia,14,0,20,6
1713511858382,LISP 5B,A00,507671,Munoz Sanchez; Alicia,12,0,20,8
1713511859406,LISP 5C,A00,507696,Munoz Sanchez; Alicia,11,0,20,9
1713511860433,MAE 197,001,528363,Boechler; Nicholas Sebastia,9998,0,9999,1
1713511861457,MATH 197,001,523477,Kedlaya; Kiran S.,9999,0,9999,0
1713511861457,MATH 197,002,563811,Zhang; Danna,9998,0,9999,1
1713511862491,MCWP 40R,A00,518780,Staff,13,0,20,7
1713511862491,MCWP 40R,B00,518781,Staff,11,0,20,9
1713511862491,MCWP 40R,C00,518783,Staff,8,0,20,12
1713511863521,MCWP 50R,A00,518791,Staff,7,0,20,13
1713511863521,MCWP 50R,B00,518792,Staff,3,0,20,17
1713511863521,MCWP 50R,C00,518793,Staff,5,0,20,15
1713511863521,MCWP 50R,D00,518794,Staff,0,0,20,20
1713511863521,MCWP 50R,E00,518795,Staff,0,0,20,20
1713511863521,MCWP 50R,F00,518796,Staff,11,0,20,9
1713511863521,MCWP 50R,G00,518797,Staff,10,0,20,10
1713511864552,MMW 12R,A01,514034,Herbst; Matthew,1,0,16,15
1713511864552,MMW 12R,A02,514035,Herbst; Matthew,13,0,16,3
1713511865582,MMW 13R,A01,514037,Staff,0,8,16,16
1713511865582,MMW 13R,A02,514039,Staff,0,7,16,16
1713511867630,SIO 295LS,A00,523233,Staff,15,0,30,15
1713511868656,SIO 295S,A00,523232,Staff,15,0,30,15
1713511869685,SOCI 117,A01,494376,Staff,0,2,5,5
1713511870717,WES 237B,A00,494380,Staff,19,0,20,1
1713511872780,AESE 279B,A00,494370,Wade; Jon P,33,0,33,0
1713511873812,AIP 197,001,627712,Vespa; Emanuel Ignacio,9999,0,9999,0
1713511874837,ANAR 135S,A00,494369,Braswell; Geoffrey E.,0,0,0,0
1713511875862,CAT 124RS,A01,519847,Geibel; William,6,0,20,14
1713511876889,CAT 125RS,A01,515971,Geibel; William,6,0,20,14
1713511877920,CLRE 250,A00,511389,Morris; Sheldon,9996,0,9999,3
1713511878947,CLRE 251,A00,507176,Mehta; Ravindra L.,9996,0,9999,3
1713511878947,CLRE 251,B00,511410,Mehta; Ravindra L.,9998,0,9999,1
1713511879973,CLRE 252,A00,507189,Cuomo; Raphael Eduardo,9998,0,9999,1
1713511881003,CLRE 253,A00,507199,Vaida; Florin,9997,0,9999,2
1713511881003,CLRE 253,B00,507202,Vaida; Florin,9999,0,9999,0
1713511882032,CLRE 259,A00,507211,Patel; Hemal,9996,0,9999,3
1713511883058,CLRE 260,A00,507221,Cuomo; Raphael Eduardo,9999,0,9999,0
1713511884084,CLRE 297,001,507242,Cuomo; Raphael Eduardo,9999,0,9999,0
1713511885110,CSE 191,A00,516875,Minnes Kemp; Mor Mia,9999,0,9999,0
1713511886141,CSS 201S,A01,494383,Staff,35,0,35,0
1713511887172,CSS 202S,A01,494387,Staff,35,0,35,0
1713511888198,EAP 100,A00,516065,Staff,9792,0,9999,207
1713511889231,ECE 45,A01,507414,Staff,37,0,60,23
1713511890257,ECE 100,A01,507416,Baghdadchi; Saharnaz,0,0,20,20
1713511890257,ECE 100,A02,507418,Baghdadchi; Saharnaz,19,0,20,1
1713511891282,ECE 111,A01,507420,Staff,27,0,50,23
1713511892306,ECE 197,001,548057,Sievenpiper; Daniel F.,9998,0,9999,1
1713511893339,EDS 115,A00,507243,Choi; Bailey Miyeon,27,0,28,1
1713511894369,EDS 117,A01,494379,Staff,15,0,25,10
1713511895395,EDS 125,A00,507246,Hopkins; Megan Beth,27,0,30,3
1713511896430,EDS 128A,A01,507264,Fargason; Sharon Gayle,26,0,26,0
1713511897462,EDS 128B,A01,507293,Pappas; Elizabeth,30,0,30,0
1713511898491,EDS 139,A00,507294,Fargason; Sharon Gayle,30,0,30,0
1713511898491,EDS 139,B00,507313,Pappas; Elizabeth,30,0,30,0
1713511899518,EDS 201,A00,507315,Staff,18,0,30,12
1713511900543,EDS 203,A01,507317,Halter; Christopher P.,17,0,30,13
1713511901570,EDS 204R,A01,507319,Halter; Christopher P.,0,1,30,30
1713511901570,EDS 204R,B01,507331,Heinzman; Erica M.,22,0,30,8
1713511902596,EDS 206R,A00,507332,Staff,0,2,30,30
1713511902596,EDS 206R,B00,507343,Staff,23,0,30,7
1713511903620,EDS 250,A00,507344,Hemans; Patricia Ann Benitez,27,0,40,13
1713511904649,EDS 281,A00,507345,Daly; Alan J.,18,0,18,0
1713511905674,EDS 284,A00,507350,Daly; Alan J.,16,0,16,0
1713511906705,EDS 286,A00,507359,Fine; Sarah,18,0,18,0
1713511907731,EDS 289C,A01,507361,Daly; Alan J.,18,0,18,0
1713511908758,EDS 290,A00,507366,Hofstetter; Carolyn,15,0,15,0
1713511909787,LIGM 5A,A00,507421,Fischer-Grunski; Eva K,20,0,20,0
1713511910822,LIGM 5B,A00,507423,Fischer-Grunski; Eva K,20,0,20,0
1713511911857,LIGM 5C,A00,507425,Fischer-Grunski; Eva K,20,0,20,0
1713511912883,LIIT 5AS,A00,507427,Carnelos; Chiara,20,0,20,0
1713511913910,LIIT 5BS,A00,507430,Carnelos; Chiara,20,0,20,0
1713511914935,LIIT 5CS,A00,507432,Carnelos; Chiara,20,0,20,0
1713511916014,LISP 5A,A00,507541,Munoz Sanchez; Alicia,14,0,20,6
1713511917040,LISP 5B,A00,507671,Munoz Sanchez; Alicia,12,0,20,8
1713511918084,LISP 5C,A00,507696,Munoz Sanchez; Alicia,11,0,20,9
1713511919109,MAE 197,001,528363,Boechler; Nicholas Sebastia,9998,0,9999,1
1713511920135,MATH 197,001,523477,Kedlaya; Kiran S.,9999,0,9999,0
1713511920135,MATH 197,002,563811,Zhang; Danna,9998,0,9999,1
1713511921162,MCWP 40R,A00,518780,Staff,13,0,20,7
1713511921162,MCWP 40R,B00,518781,Staff,11,0,20,9
1713511921162,MCWP 40R,C00,518783,Staff,8,0,20,12
1713511922194,MCWP 50R,A00,518791,Staff,7,0,20,13
1713511922194,MCWP 50R,B00,518792,Staff,3,0,20,17
1713511922194,MCWP 50R,C00,518793,Staff,5,0,20,15
1713511922194,MCWP 50R,D00,518794,Staff,0,0,20,20
1713511922194,MCWP 50R,E00,518795,Staff,0,0,20,20
1713511922194,MCWP 50R,F00,518796,Staff,11,0,20,9
1713511922194,MCWP 50R,G00,518797,Staff,10,0,20,10
1713511923233,MMW 12R,A01,514034,Herbst; Matthew,1,0,16,15
1713511923233,MMW 12R,A02,514035,Herbst; Matthew,13,0,16,3
1713511924259,MMW 13R,A01,514037,Staff,0,8,16,16
1713511924259,MMW 13R,A02,514039,Staff,0,7,16,16
1713511926318,SIO 295LS,A00,523233,Staff,15,0,30,15
1713511927349,SIO 295S,A00,523232,Staff,15,0,30,15
1713511928381,SOCI 117,A01,494376,Staff,0,2,5,5
1713511929407,WES 237B,A00,494380,Staff,19,0,20,1
1713511931491,AESE 279B,A00,494370,Wade; Jon P,33,0,33,0
1713511932522,AIP 197,001,627712,Vespa; Emanuel Ignacio,9999,0,9999,0
1713511933547,ANAR 135S,A00,494369,Braswell; Geoffrey E.,0,0,0,0
1713511934583,CAT 124RS,A01,519847,Geibel; William,6,0,20,14
1713511935632,CAT 125RS,A01,515971,Geibel; William,6,0,20,14
1713511936658,CLRE 250,A00,511389,Morris; Sheldon,9996,0,9999,3
1713511937685,CLRE 251,A00,507176,Mehta; Ravindra L.,9996,0,9999,3
1713511937685,CLRE 251,B00,511410,Mehta; Ravindra L.,9998,0,9999,1
1713511938710,CLRE 252,A00,507189,Cuomo; Raphael Eduardo,9998,0,9999,1
1713511939737,CLRE 253,A00,507199,Vaida; Florin,9997,0,9999,2
1713511939737,CLRE 253,B00,507202,Vaida; Florin,9999,0,9999,0
1713511940770,CLRE 259,A00,507211,Patel; Hemal,9996,0,9999,3
1713511941797,CLRE 260,A00,507221,Cuomo; Raphael Eduardo,9999,0,9999,0
1713511942826,CLRE 297,001,507242,Cuomo; Raphael Eduardo,9999,0,9999,0
1713511943864,CSE 191,A00,516875,Minnes Kemp; Mor Mia,9999,0,9999,0
1713511944891,CSS 201S,A01,494383,Staff,35,0,35,0
1713511945928,CSS 202S,A01,494387,Staff,35,0,35,0
1713511946963,EAP 100,A00,516065,Staff,9792,0,9999,207
1713511947999,ECE 45,A01,507414,Staff,37,0,60,23
1713511949026,ECE 100,A01,507416,Baghdadchi; Saharnaz,0,0,20,20
1713511949026,ECE 100,A02,507418,Baghdadchi; Saharnaz,19,0,20,1
1713511950056,ECE 111,A01,507420,Staff,27,0,50,23
1713511951079,ECE 197,001,548057,Sievenpiper; Daniel F.,9998,0,9999,1
1713511952103,EDS 115,A00,507243,Choi; Bailey Miyeon,27,0,28,1
1713511953130,EDS 117,A01,494379,Staff,15,0,25,10
1713511954164,EDS 125,A00,507246,Hopkins; Megan Beth,27,0,30,3
1713511955197,EDS 128A,A01,507264,Fargason; Sharon Gayle,26,0,26,0
1713511956223,EDS 128B,A01,507293,Pappas; Elizabeth,30,0,30,0
1713511957251,EDS 139,A00,507294,Fargason; Sharon Gayle,30,0,30,0
1713511957251,EDS 139,B00,507313,Pappas; Elizabeth,30,0,30,0
1713511958277,EDS 201,A00,507315,Staff,18,0,30,12
1713511959303,EDS 203,A01,507317,Halter; Christopher P.,17,0,30,13
1713511960337,EDS 204R,A01,507319,Halter; Christopher P.,0,1,30,30
1713511960337,EDS 204R,B01,507331,Heinzman; Erica M.,22,0,30,8
1713511961362,EDS 206R,A00,507332,Staff,0,2,30,30
1713511961362,EDS 206R,B00,507343,Staff,23,0,30,7
1713511962387,EDS 250,A00,507344,Hemans; Patricia Ann Benitez,27,0,40,13
1713511963416,EDS 281,A00,507345,Daly; Alan J.,18,0,18,0
1713511964441,EDS 284,A00,507350,Daly; Alan J.,16,0,16,0
1713511965468,EDS 286,A00,507359,Fine; Sarah,18,0,18,0
1713511966494,EDS 289C,A01,507361,Daly; Alan J.,18,0,18,0
1713511967520,EDS 290,A00,507366,Hofstetter; Carolyn,15,0,15,0
1713511968551,LIGM 5A,A00,507421,Fischer-Grunski; Eva K,20,0,20,0
1713511969576,LIGM 5B,A00,507423,Fischer-Grunski; Eva K,20,0,20,0
1713511970603,LIGM 5C,A00,507425,Fischer-Grunski; Eva K,20,0,20,0
1713511971629,LIIT 5AS,A00,507427,Carnelos; Chiara,20,0,20,0
1713511972657,LIIT 5BS,A00,507430,Carnelos; Chiara,20,0,20,0
1713511973684,LIIT 5CS,A00,507432,Carnelos; Chiara,20,0,20,0
1713511974716,LISP 5A,A00,507541,Munoz Sanchez; Alicia,14,0,20,6
1713511975744,LISP 5B,A00,507671,Munoz Sanchez; Alicia,12,0,20,8
1713511976770,LISP 5C,A00,507696,Munoz Sanchez; Alicia,11,0,20,9
1713511977801,MAE 197,001,528363,Boechler; Nicholas Sebastia,9998,0,9999,1
1713511978827,MATH 197,001,523477,Kedlaya; Kiran S.,9999,0,9999,0
1713511978827,MATH 197,002,563811,Zhang; Danna,9998,0,9999,1
1713511979853,MCWP 40R,A00,518780,Staff,13,0,20,7
1713511979853,MCWP 40R,B00,518781,Staff,11,0,20,9
1713511979853,MCWP 40R,C00,518783,Staff,8,0,20,12
1713511980888,MCWP 50R,A00,518791,Staff,7,0,20,13
1713511980888,MCWP 50R,B00,518792,Staff,3,0,20,17
1713511980888,MCWP 50R,C00,518793,Staff,5,0,20,15
1713511980888,MCWP 50R,D00,518794,Staff,0,0,20,20
1713511980888,MCWP 50R,E00,518795,Staff,0,0,20,20
1713511980888,MCWP 50R,F00,518796,Staff,11,0,20,9
1713511980888,MCWP 50R,G00,518797,Staff,10,0,20,10
1713511981920,MMW 12R,A01,514034,Herbst; Matthew,1,0,16,15
1713511981920,MMW 12R,A02,514035,Herbst; Matthew,13,0,16,3
1713511982946,MMW 13R,A01,514037,Staff,0,8,16,16
1713511982946,MMW 13R,A02,514039,Staff,0,7,16,16
1713511985004,SIO 295LS,A00,523233,Staff,15,0,30,15
1713511986030,SIO 295S,A00,523232,Staff,15,0,30,15
1713511987056,SOCI 117,A01,494376,Staff,0,2,5,5
1713511988082,WES 237B,A00,494380,Staff,19,0,20,1
1713511990153,AESE 279B,A00,494370,Wade; Jon P,33,0,33,0
1713511991182,AIP 197,001,627712,Vespa; Emanuel Ignacio,9999,0,9999,0
1713511992207,ANAR 135S,A00,494369,Braswell; Geoffrey E.,0,0,0,0
1713511993240,CAT 124RS,A01,519847,Geibel; William,6,0,20,14
1713511994269,CAT 125RS,A01,515971,Geibel; William,6,0,20,14
1713511995300,CLRE 250,A00,511389,Morris; Sheldon,9996,0,9999,3
1713511996327,CLRE 251,A00,507176,Mehta; Ravindra L.,9996,0,9999,3
1713511996327,CLRE 251,B00,511410,Mehta; Ravindra L.,9998,0,9999,1
1713511997358,CLRE 252,A00,507189,Cuomo; Raphael Eduardo,9998,0,9999,1
1713511998389,CLRE 253,A00,507199,Vaida; Florin,9997,0,9999,2
1713511998389,CLRE 253,B00,507202,Vaida; Florin,9999,0,9999,0
1713511999419,CLRE 259,A00,507211,Patel; Hemal,9996,0,9999,3
1713512000451,CLRE 260,A00,507221,Cuomo; Raphael Eduardo,9999,0,9999,0
1713512001478,CLRE 297,001,507242,Cuomo; Raphael Eduardo,9999,0,9999,0
1713512002503,CSE 191,A00,516875,Minnes Kemp; Mor Mia,9999,0,9999,0
1713512003600,CSS 201S,A01,494383,Staff,35,0,35,0
1713512004626,CSS 202S,A01,494387,Staff,35,0,35,0
1713512005655,EAP 100,A00,516065,Staff,9792,0,9999,207
1713512006686,ECE 45,A01,507414,Staff,37,0,60,23
1713512007716,ECE 100,A01,507416,Baghdadchi; Saharnaz,0,0,20,20
1713512007716,ECE 100,A02,507418,Baghdadchi; Saharnaz,19,0,20,1
1713512008743,ECE 111,A01,507420,Staff,27,0,50,23
1713512009769,ECE 197,001,548057,Sievenpiper; Daniel F.,9998,0,9999,1
1713512010794,EDS 115,A00,507243,Choi; Bailey Miyeon,27,0,28,1
1713512011824,EDS 117,A01,494379,Staff,15,0,25,10
1713512012851,EDS 125,A00,507246,Hopkins; Megan Beth,27,0,30,3
1713512013881,EDS 128A,A01,507264,Fargason; Sharon Gayle,26,0,26,0
1713512014907,EDS 128B,A01,507293,Pappas; Elizabeth,30,0,30,0
1713512015935,EDS 139,A00,507294,Fargason; Sharon Gayle,30,0,30,0
1713512015935,EDS 139,B00,507313,Pappas; Elizabeth,30,0,30,0
1713512016961,EDS 201,A00,507315,Staff,18,0,30,12
1713512017986,EDS 203,A01,507317,Halter; Christopher P.,17,0,30,13
1713512019014,EDS 204R,A01,507319,Halter; Christopher P.,0,1,30,30
1713512019014,EDS 204R,B01,507331,Heinzman; Erica M.,22,0,30,8
1713512020095,EDS 206R,A00,507332,Staff,0,2,30,30
1713512020095,EDS 206R,B00,507343,Staff,23,0,30,7
1713512021123,EDS 250,A00,507344,Hemans; Patricia Ann Benitez,27,0,40,13
1713512022148,EDS 281,A00,507345,Daly; Alan J.,18,0,18,0
1713512023178,EDS 284,A00,507350,Daly; Alan J.,16,0,16,0
1713512024205,EDS 286,A00,507359,Fine; Sarah,18,0,18,0
1713512025231,EDS 289C,A01,507361,Daly; Alan J.,18,0,18,0
1713512026257,EDS 290,A00,507366,Hofstetter; Carolyn,15,0,15,0
1713512027287,LIGM 5A,A00,507421,Fischer-Grunski; Eva K,20,0,20,0
1713512028314,LIGM 5B,A00,507423,Fischer-Grunski; Eva K,20,0,20,0
1713512029342,LIGM 5C,A00,507425,Fischer-Grunski; Eva K,20,0,20,0
1713512030374,LIIT 5AS,A00,507427,Carnelos; Chiara,20,0,20,0
1713512031400,LIIT 5BS,A00,507430,Carnelos; Chiara,20,0,20,0
1713512032429,LIIT 5CS,A00,507432,Carnelos; Chiara,20,0,20,0
1713512033461,LISP 5A,A00,507541,Munoz Sanchez; Alicia,14,0,20,6
1713512034490,LISP 5B,A00,507671,Munoz Sanchez; Alicia,12,0,20,8
1713512035515,LISP 5C,A00,507696,Munoz Sanchez; Alicia,11,0,20,9
1713512036543,MAE 197,001,528363,Boechler; Nicholas Sebastia,9998,0,9999,1
1713512037574,MATH 197,001,523477,Kedlaya; Kiran S.,9999,0,9999,0
1713512037574,MATH 197,002,563811,Zhang; Danna,9998,0,9999,1
1713512038602,MCWP 40R,A00,518780,Staff,13,0,20,7
1713512038602,MCWP 40R,B00,518781,Staff,11,0,20,9
1713512038602,MCWP 40R,C00,518783,Staff,8,0,20,12
1713512039633,MCWP 50R,A00,518791,Staff,7,0,20,13
1713512039633,MCWP 50R,B00,518792,Staff,3,0,20,17
1713512039633,MCWP 50R,C00,518793,Staff,5,0,20,15
1713512039633,MCWP 50R,D00,518794,Staff,0,0,20,20
1713512039633,MCWP 50R,E00,518795,Staff,0,0,20,20
1713512039633,MCWP 50R,F00,518796,Staff,11,0,20,9
1713512039633,MCWP 50R,G00,518797,Staff,10,0,20,10
1713512040661,MMW 12R,A01,514034,Herbst; Matthew,1,0,16,15
1713512040661,MMW 12R,A02,514035,Herbst; Matthew,13,0,16,3
1713512041691,MMW 13R,A01,514037,Staff,0,8,16,16
1713512041691,MMW 13R,A02,514039,Staff,0,7,16,16
1713512043748,SIO 295LS,A00,523233,Staff,15,0,30,15
1713512044775,SIO 295S,A00,523232,Staff,15,0,30,15
1713512045803,SOCI 117,A01,494376,Staff,0,2,5,5
1713512046834,WES 237B,A00,494380,Staff,19,0,20,1
1713512048918,AESE 279B,A00,494370,Wade; Jon P,33,0,33,0
1713512049949,AIP 197,001,627712,Vespa; Emanuel Ignacio,9999,0,9999,0
1713512050977,ANAR 135S,A00,494369,Braswell; Geoffrey E.,0,0,0,0
1713512052004,CAT 124RS,A01,519847,Geibel; William,6,0,20,14
1713512053031,CAT 125RS,A01,515971,Geibel; William,6,0,20,14
1713512054058,CLRE 250,A00,511389,Morris; Sheldon,9996,0,9999,3
1713512055085,CLRE 251,A00,507176,Mehta; Ravindra L.,9996,0,9999,3
1713512055085,CLRE 251,B00,511410,Mehta; Ravindra L.,9998,0,9999,1
1713512056112,CLRE 252,A00,507189,Cuomo; Raphael Eduardo,9998,0,9999,1
1713512057143,CLRE 253,A00,507199,Vaida; Florin,9997,0,9999,2
1713512057143,CLRE 253,B00,507202,Vaida; Florin,9999,0,9999,0
1713512058168,CLRE 259,A00,507211,Patel; Hemal,9996,0,9999,3
1713512059194,CLRE 260,A00,507221,Cuomo; Raphael Eduardo,9999,0,9999,0
1713512060218,CLRE 297,001,507242,Cuomo; Raphael Eduardo,9999,0,9999,0
1713512061243,CSE 191,A00,516875,Minnes Kemp; Mor Mia,9999,0,9999,0
1713512062270,CSS 201S,A01,494383,Staff,35,0,35,0
1713512063309,CSS 202S,A01,494387,Staff,35,0,35,0
1713512064338,EAP 100,A00,516065,Staff,9792,0,9999,207
1713512065367,ECE 45,A01,507414,Staff,37,0,60,23
1713512066394,ECE 100,A01,507416,Baghdadchi; Saharnaz,0,0,20,20
1713512066394,ECE 100,A02,507418,Baghdadchi; Saharnaz,19,0,20,1
1713512067420,ECE 111,A01,507420,Staff,27,0,50,23
1713512068449,ECE 197,001,548057,Sievenpiper; Daniel F.,9998,0,9999,1
1713512069479,EDS 115,A00,507243,Choi; Bailey Miyeon,27,0,28,1
1713512070504,EDS 117,A01,494379,Staff,15,0,25,10
1713512071529,EDS 125,A00,507246,Hopkins; Megan Beth,27,0,30,3
1713512072558,EDS 128A,A01,507264,Fargason; Sharon Gayle,26,0,26,0
1713512073584,EDS 128B,A01,507293,Pappas; Elizabeth,30,0,30,0
1713512074612,EDS 139,A00,507294,Fargason; Sharon Gayle,30,0,30,0
1713512074612,EDS 139,B00,507313,Pappas; Elizabeth,30,0,30,0
1713512075638,EDS 201,A00,507315,Staff,18,0,30,12
1713512076668,EDS 203,A01,507317,Halter; Christopher P.,17,0,30,13
1713512077696,EDS 204R,A01,507319,Halter; Christopher P.,0,1,30,30
1713512077696,EDS 204R,B01,507331,Heinzman; Erica M.,22,0,30,8
1713512078722,EDS 206R,A00,507332,Staff,0,2,30,30
1713512078722,EDS 206R,B00,507343,Staff,23,0,30,7
1713512079753,EDS 250,A00,507344,Hemans; Patricia Ann Benitez,27,0,40,13
1713512080782,EDS 281,A00,507345,Daly; Alan J.,18,0,18,0
1713512081807,EDS 284,A00,507350,Daly; Alan J.,16,0,16,0
1713512082834,EDS 286,A00,507359,Fine; Sarah,18,0,18,0
1713512083861,EDS 289C,A01,507361,Daly; Alan J.,18,0,18,0
1713512084888,EDS 290,A00,507366,Hofstetter; Carolyn,15,0,15,0
1713512085925,LIGM 5A,A00,507421,Fischer-Grunski; Eva K,20,0,20,0
1713512086952,LIGM 5B,A00,507423,Fischer-Grunski; Eva K,20,0,20,0
1713512087979,LIGM 5C,A00,507425,Fischer-Grunski; Eva K,20,0,20,0
1713512089014,LIIT 5AS,A00,507427,Carnelos; Chiara,20,0,20,0
1713512090040,LIIT 5BS,A00,507430,Carnelos; Chiara,20,0,20,0
1713512091069,LIIT 5CS,A00,507432,Carnelos; Chiara,20,0,20,0
1713512092094,LISP 5A,A00,507541,Munoz Sanchez; Alicia,14,0,20,6
1713512093123,LISP 5B,A00,507671,Munoz Sanchez; Alicia,12,0,20,8
1713512094154,LISP 5C,A00,507696,Munoz Sanchez; Alicia,11,0,20,9
1713512095183,MAE 197,001,528363,Boechler; Nicholas Sebastia,9998,0,9999,1
1713512096208,MATH 197,001,523477,Kedlaya; Kiran S.,9999,0,9999,0
1713512096208,MATH 197,002,563811,Zhang; Danna,9998,0,9999,1
1713512097234,MCWP 40R,A00,518780,Staff,13,0,20,7
1713512097234,MCWP 40R,B00,518781,Staff,11,0,20,9
1713512097234,MCWP 40R,C00,518783,Staff,8,0,20,12
1713512098262,MCWP 50R,A00,518791,Staff,7,0,20,13
1713512098262,MCWP 50R,B00,518792,Staff,3,0,20,17
1713512098262,MCWP 50R,C00,518793,Staff,5,0,20,15
1713512098262,MCWP 50R,D00,518794,Staff,0,0,20,20
1713512098262,MCWP 50R,E00,518795,Staff,0,0,20,20
1713512098262,MCWP 50R,F00,518796,Staff,11,0,20,9
1713512098262,MCWP 50R,G00,518797,Staff,10,0,20,10
1713512099296,MMW 12R,A01,514034,Herbst; Matthew,1,0,16,15
1713512099296,MMW 12R,A02,514035,Herbst; Matthew,13,0,16,3
1713512100321,MMW 13R,A01,514037,Staff,0,8,16,16
1713512100321,MMW 13R,A02,514039,Staff,0,7,16,16
1713512102375,SIO 295LS,A00,523233,Staff,15,0,30,15
1713512103413,SIO 295S,A00,523232,Staff,15,0,30,15
1713512104440,SOCI 117,A01,494376,Staff,0,2,5,5
1713512105466,WES 237B,A00,494380,Staff,19,0,20,1
1713512107544,AESE 279B,A00,494370,Wade; Jon P,33,0,33,0
1713512108573,AIP 197,001,627712,Vespa; Emanuel Ignacio,9999,0,9999,0
1713512109605,ANAR 135S,A00,494369,Braswell; Geoffrey E.,0,0,0,0
1713512110630,CAT 124RS,A01,519847,Geibel; William,6,0,20,14
1713512111663,CAT 125RS,A01,515971,Geibel; William,6,0,20,14
1713512112692,CLRE 250,A00,511389,Morris; Sheldon,9996,0,9999,3
1713512113718,CLRE 251,A00,507176,Mehta; Ravindra L.,9996,0,9999,3
1713512113718,CLRE 251,B00,511410,Mehta; Ravindra L.,9998,0,9999,1
1713512114749,CLRE 252,A00,507189,Cuomo; Raphael Eduardo,9998,0,9999,1
1713512115783,CLRE 253,A00,507199,Vaida; Florin,9997,0,9999,2
1713512115783,CLRE 253,B00,507202,Vaida; Florin,9999,0,9999,0
1713512116819,CLRE 259,A00,507211,Patel; Hemal,9996,0,9999,3
1713512117846,CLRE 260,A00,507221,Cuomo; Raphael Eduardo,9999,0,9999,0
1713512118877,CLRE 297,001,507242,Cuomo; Raphael Eduardo,9999,0,9999,0
1713512119903,CSE 191,A00,516875,Minnes Kemp; Mor Mia,9999,0,9999,0
1713512120934,CSS 201S,A01,494383,Staff,35,0,35,0
1713512121968,CSS 202S,A01,494387,Staff,35,0,35,0
1713512123010,EAP 100,A00,516065,Staff,9792,0,9999,207
1713512124093,ECE 45,A01,507414,Staff,37,0,60,23
1713512125120,ECE 100,A01,507416,Baghdadchi; Saharnaz,0,0,20,20
1713512125120,ECE 100,A02,507418,Baghdadchi; Saharnaz,19,0,20,1
1713512126151,ECE 111,A01,507420,Staff,27,0,50,23
1713512127184,ECE 197,001,548057,Sievenpiper; Daniel F.,9998,0,9999,1
1713512128210,EDS 115,A00,507243,Choi; Bailey Miyeon,27,0,28,1
1713512129238,EDS 117,A01,494379,Staff,15,0,25,10
1713512130265,EDS 125,A00,507246,Hopkins; Megan Beth,27,0,30,3
1713512131291,EDS 128A,A01,507264,Fargason; Sharon Gayle,26,0,26,0
1713512132325,EDS 128B,A01,507293,Pappas; Elizabeth,30,0,30,0
1713512133365,EDS 139,A00,507294,Fargason; Sharon Gayle,30,0,30,0
1713512133365,EDS 139,B00,507313,Pappas; Elizabeth,30,0,30,0
1713512134393,EDS 201,A00,507315,Staff,18,0,30,12
1713512135420,EDS 203,A01,507317,Halter; Christopher P.,17,0,30,13
1713512136448,EDS 204R,A01,507319,Halter; Christopher P.,0,1,30,30
1713512136448,EDS 204R,B01,507331,Heinzman; Erica M.,22,0,30,8
1713512137478,EDS 206R,A00,507332,Staff,0,2,30,30
1713512137478,EDS 206R,B00,507343,Staff,23,0,30,7
1713512138508,EDS 250,A00,507344,Hemans; Patricia Ann Benitez,27,0,40,13
1713512139534,EDS 281,A00,507345,Daly; Alan J.,18,0,18,0
1713512140561,EDS 284,A00,507350,Daly; Alan J.,16,0,16,0
1713512141592,EDS 286,A00,507359,Fine; Sarah,18,0,18,0
1713512142622,EDS 289C,A01,507361,Daly; Alan J.,18,0,18,0
1713512143646,EDS 290,A00,507366,Hofstetter; Carolyn,15,0,15,0
1713512144680,LIGM 5A,A00,507421,Fischer-Grunski; Eva K,20,0,20,0
1713512145714,LIGM 5B,A00,507423,Fischer-Grunski; Eva K,20,0,20,0
1713512146740,LIGM 5C,A00,507425,Fischer-Grunski; Eva K,20,0,20,0
1713512147767,LIIT 5AS,A00,507427,Carnelos; Chiara,20,0,20,0
1713512148800,LIIT 5BS,A00,507430,Carnelos; Chiara,20,0,20,0
1713512149829,LIIT 5CS,A00,507432,Carnelos; Chiara,20,0,20,0
1713512150858,LISP 5A,A00,507541,Munoz Sanchez; Alicia,14,0,20,6
1713512151894,LISP 5B,A00,507671,Munoz Sanchez; Alicia,12,0,20,8
1713512152924,LISP 5C,A00,507696,Munoz Sanchez; Alicia,11,0,20,9
1713512153951,MAE 197,001,528363,Boechler; Nicholas Sebastia,9998,0,9999,1
1713512154982,MATH 197,001,523477,Kedlaya; Kiran S.,9999,0,9999,0
1713512154982,MATH 197,002,563811,Zhang; Danna,9998,0,9999,1
1713512156017,MCWP 40R,A00,518780,Staff,13,0,20,7
1713512156017,MCWP 40R,B00,518781,Staff,11,0,20,9
1713512156017,MCWP 40R,C00,518783,Staff,8,0,20,12
1713512157050,MCWP 50R,A00,518791,Staff,7,0,20,13
1713512157050,MCWP 50R,B00,518792,Staff,3,0,20,17
1713512157050,MCWP 50R,C00,518793,Staff,5,0,20,15
1713512157050,MCWP 50R,D00,518794,Staff,0,0,20,20
1713512157050,MCWP 50R,E00,518795,Staff,0,0,20,20
1713512157050,MCWP 50R,F00,518796,Staff,11,0,20,9
1713512157050,MCWP 50R,G00,518797,Staff,10,0,20,10
1713512158077,MMW 12R,A01,514034,Herbst; Matthew,1,0,16,15
1713512158077,MMW 12R,A02,514035,Herbst; Matthew,13,0,16,3
1713512159102,MMW 13R,A01,514037,Staff,0,8,16,16
1713512159102,MMW 13R,A02,514039,Staff,0,7,16,16
1713512161164,SIO 295LS,A00,523233,Staff,15,0,30,15
1713512162190,SIO 295S,A00,523232,Staff,15,0,30,15
1713512163221,SOCI 117,A01,494376,Staff,0,2,5,5
1713512164252,WES 237B,A00,494380,Staff,19,0,20,1
1713512166327,AESE 279B,A00,494370,Wade; Jon P,33,0,33,0
1713512167352,AIP 197,001,627712,Vespa; Emanuel Ignacio,9999,0,9999,0
1713512168378,ANAR 135S,A00,494369,Braswell; Geoffrey E.,0,0,0,0
1713512169405,CAT 124RS,A01,519847,Geibel; William,6,0,20,14
1713512170439,CAT 125RS,A01,515971,Geibel; William,6,0,20,14
1713512171469,CLRE 250,A00,511389,Morris; Sheldon,9996,0,9999,3
1713512172497,CLRE 251,A00,507176,Mehta; Ravindra L.,9996,0,9999,3
1713512172497,CLRE 251,B00,511410,Mehta; Ravindra L.,9998,0,9999,1
1713512173525,CLRE 252,A00,507189,Cuomo; Raphael Eduardo,9998,0,9999,1
1713512174562,CLRE 253,A00,507199,Vaida; Florin,9997,0,9999,2
1713512174562,CLRE 253,B00,507202,Vaida; Florin,9999,0,9999,0
1713512175593,CLRE 259,A00,507211,Patel; Hemal,9996,0,9999,3
1713512176619,CLRE 260,A00,507221,Cuomo; Raphael Eduardo,9999,0,9999,0
1713512177646,CLRE 297,001,507242,Cuomo; Raphael Eduardo,9999,0,9999,0
1713512178674,CSE 191,A00,516875,Minnes Kemp; Mor Mia,9999,0,9999,0
1713512179707,CSS 201S,A01,494383,Staff,35,0,35,0
1713512180741,CSS 202S,A01,494387,Staff,35,0,35,0
1713512181771,EAP 100,A00,516065,Staff,9792,0,9999,207
1713512182798,ECE 45,A01,507414,Staff,37,0,60,23
1713512183825,ECE 100,A01,507416,Baghdadchi; Saharnaz,0,0,20,20
1713512183825,ECE 100,A02,507418,Baghdadchi; Saharnaz,19,0,20,1
1713512184856,ECE 111,A01,507420,Staff,27,0,50,23
1713512185885,ECE 197,001,548057,Sievenpiper; Daniel F.,9998,0,9999,1
1713512186916,EDS 115,A00,507243,Choi; Bailey Miyeon,27,0,28,1
1713512187946,EDS 117,A01,494379,Staff,15,0,25,10
1713512188974,EDS 125,A00,507246,Hopkins; Megan Beth,27,0,30,3
1713512190005,EDS 128A,A01,507264,Fargason; Sharon Gayle,26,0,26,0
1713512191035,EDS 128B,A01,507293,Pappas; Elizabeth,30,0,30,0
1713512192060,EDS 139,A00,507294,Fargason; Sharon Gayle,30,0,30,0
1713512192060,EDS 139,B00,507313,Pappas; Elizabeth,30,0,30,0
1713512193087,EDS 201,A00,507315,Staff,18,0,30,12
1713512194112,EDS 203,A01,507317,Halter; Christopher P.,17,0,30,13
1713512195146,EDS 204R,A01,507319,Halter; Christopher P.,0,1,30,30
1713512195146,EDS 204R,B01,507331,Heinzman; Erica M.,22,0,30,8
1713512196173,EDS 206R,A00,507332,Staff,0,2,30,30
1713512196173,EDS 206R,B00,507343,Staff,23,0,30,7
1713512197207,EDS 250,A00,507344,Hemans; Patricia Ann Benitez,27,0,40,13
1713512198236,EDS 281,A00,507345,Daly; Alan J.,18,0,18,0
1713512199262,EDS 284,A00,507350,Daly; Alan J.,16,0,16,0
1713512200288,EDS 286,A00,507359,Fine; Sarah,18,0,18,0
1713512201317,EDS 289C,A01,507361,Daly; Alan J.,18,0,18,0
1713512202347,EDS 290,A00,507366,Hofstetter; Carolyn,15,0,15,0
1713512203378,LIGM 5A,A00,507421,Fischer-Grunski; Eva K,20,0,20,0
1713512204407,LIGM 5B,A00,507423,Fischer-Grunski; Eva K,20,0,20,0
1713512205438,LIGM 5C,A00,507425,Fischer-Grunski; Eva K,20,0,20,0
1713512206464,LIIT 5AS,A00,507427,Carnelos; Chiara,20,0,20,0
1713512207490,LIIT 5BS,A00,507430,Carnelos; Chiara,20,0,20,0
1713512208523,LIIT 5CS,A00,507432,Carnelos; Chiara,20,0,20,0
1713512209550,LISP 5A,A00,507541,Munoz Sanchez; Alicia,14,0,20,6
1713512210575,LISP 5B,A00,507671,Munoz Sanchez; Alicia,12,0,20,8
1713512211604,LISP 5C,A00,507696,Munoz Sanchez; Alicia,11,0,20,9
1713512212627,MAE 197,001,528363,Boechler; Nicholas Sebastia,9998,0,9999,1
1713512213656,MATH 197,001,523477,Kedlaya; Kiran S.,9999,0,9999,0
1713512213656,MATH 197,002,563811,Zhang; Danna,9998,0,9999,1
1713512214681,MCWP 40R,A00,518780,Staff,13,0,20,7
1713512214681,MCWP 40R,B00,518781,Staff,11,0,20,9
1713512214681,MCWP 40R,C00,518783,Staff,8,0,20,12
1713512215708,MCWP 50R,A00,518791,Staff,7,0,20,13
1713512215708,MCWP 50R,B00,518792,Staff,3,0,20,17
1713512215708,MCWP 50R,C00,518793,Staff,5,0,20,15
1713512215708,MCWP 50R,D00,518794,Staff,0,0,20,20
1713512215708,MCWP 50R,E00,518795,Staff,0,0,20,20
1713512215708,MCWP 50R,F00,518796,Staff,11,0,20,9
1713512215708,MCWP 50R,G00,518797,Staff,10,0,20,10
1713512216739,MMW 12R,A01,514034,Herbst; Matthew,1,0,16,15
1713512216739,MMW 12R,A02,514035,Herbst; Matthew,13,0,16,3
1713512217765,MMW 13R,A01,514037,Staff,0,8,16,16
1713512217765,MMW 13R,A02,514039,Staff,0,7,16,16
1713512219822,SIO 295LS,A00,523233,Staff,15,0,30,15
1713512220854,SIO 295S,A00,523232,Staff,15,0,30,15
1713512221885,SOCI 117,A01,494376,Staff,0,2,5,5
1713512222913,WES 237B,A00,494380,Staff,19,0,20,1
1713512224978,AESE 279B,A00,494370,Wade; Jon P,33,0,33,0
1713512226003,AIP 197,001,627712,Vespa; Emanuel Ignacio,9999,0,9999,0
1713512227034,ANAR 135S,A00,494369,Braswell; Geoffrey E.,0,0,0,0
1713512228118,CAT 124RS,A01,519847,Geibel; William,6,0,20,14
1713512229147,CAT 125RS,A01,515971,Geibel; William,6,0,20,14
1713512230172,CLRE 250,A00,511389,Morris; Sheldon,9996,0,9999,3
1713512231197,CLRE 251,A00,507176,Mehta; Ravindra L.,9996,0,9999,3
1713512231197,CLRE 251,B00,511410,Mehta; Ravindra L.,9998,0,9999,1
1713512232225,CLRE 252,A00,507189,Cuomo; Raphael Eduardo,9998,0,9999,1
1713512233252,CLRE 253,A00,507199,Vaida; Florin,9997,0,9999,2
1713512233252,CLRE 253,B00,507202,Vaida; Florin,9999,0,9999,0
1713512234277,CLRE 259,A00,507211,Patel; Hemal,9996,0,9999,3
1713512235307,CLRE 260,A00,507221,Cuomo; Raphael Eduardo,9999,0,9999,0
1713512236333,CLRE 297,001,507242,Cuomo; Raphael Eduardo,9999,0,9999,0
1713512237362,CSE 191,A00,516875,Minnes Kemp; Mor Mia,9999,0,9999,0
1713512238388,CSS 201S,A01,494383,Staff,35,0,35,0
1713512239412,CSS 202S,A01,494387,Staff,35,0,35,0
1713512240441,EAP 100,A00,516065,Staff,9792,0,9999,207
1713512241468,ECE 45,A01,507414,Staff,37,0,60,23
1713512242494,ECE 100,A01,507416,Baghdadchi; Saharnaz,0,0,20,20
1713512242494,ECE 100,A02,507418,Baghdadchi; Saharnaz,19,0,20,1
1713512243520,ECE 111,A01,507420,Staff,27,0,50,23
1713512244544,ECE 197,001,548057,Sievenpiper; Daniel F.,9998,0,9999,1
1713512245574,EDS 115,A00,507243,Choi; Bailey Miyeon,27,0,28,1
1713512246601,EDS 117,A01,494379,Staff,15,0,25,10
1713512247627,EDS 125,A00,507246,Hopkins; Megan Beth,27,0,30,3
1713512248653,EDS 128A,A01,507264,Fargason; Sharon Gayle,26,0,26,0
1713512249683,EDS 128B,A01,507293,Pappas; Elizabeth,30,0,30,0
1713512250712,EDS 139,A00,507294,Fargason; Sharon Gayle,30,0,30,0
1713512250712,EDS 139,B00,507313,Pappas; Elizabeth,30,0,30,0
1713512251744,EDS 201,A00,507315,Staff,18,0,30,12
1713512252776,EDS 203,A01,507317,Halter; Christopher P.,17,0,30,13
1713512253804,EDS 204R,A01,507319,Halter; Christopher P.,0,1,30,30
1713512253804,EDS 204R,B01,507331,Heinzman; Erica M.,22,0,30,8
1713512254832,EDS 206R,A00,507332,Staff,0,2,30,30
1713512254832,EDS 206R,B00,507343,Staff,23,0,30,7
1713512255859,EDS 250,A00,507344,Hemans; Patricia Ann Benitez,27,0,40,13
1713512256887,EDS 281,A00,507345,Daly; Alan J.,18,0,18,0
1713512257914,EDS 284,A00,507350,Daly; Alan J.,16,0,16,0
1713512258941,EDS 286,A00,507359,Fine; Sarah,18,0,18,0
1713512259967,EDS 289C,A01,507361,Daly; Alan J.,18,0,18,0
1713512260997,EDS 290,A00,507366,Hofstetter; Carolyn,15,0,15,0
1713512262023,LIGM 5A,A00,507421,Fischer-Grunski; Eva K,20,0,20,0
1713512263052,LIGM 5B,A00,507423,Fischer-Grunski; Eva K,20,0,20,0
1713512264078,LIGM 5C,A00,507425,Fischer-Grunski; Eva K,20,0,20,0
1713512265104,LIIT 5AS,A00,507427,Carnelos; Chiara,20,0,20,0
1713512266134,LIIT 5BS,A00,507430,Carnelos; Chiara,20,0,20,0
1713512267161,LIIT 5CS,A00,507432,Carnelos; Chiara,20,0,20,0
1713512268188,LISP 5A,A00,507541,Munoz Sanchez; Alicia,14,0,20,6
1713512269213,LISP 5B,A00,507671,Munoz Sanchez; Alicia,12,0,20,8
1713512270249,LISP 5C,A00,507696,Munoz Sanchez; Alicia,11,0,20,9
1713512271275,MAE 197,001,528363,Boechler; Nicholas Sebastia,9998,0,9999,1
1713512272306,MATH 197,001,523477,Kedlaya; Kiran S.,9999,0,9999,0
1713512272306,MATH 197,002,563811,Zhang; Danna,9998,0,9999,1
1713512273336,MCWP 40R,A00,518780,Staff,13,0,20,7
1713512273336,MCWP 40R,B00,518781,Staff,11,0,20,9
1713512273336,MCWP 40R,C00,518783,Staff,8,0,20,12
1713512274364,MCWP 50R,A00,518791,Staff,7,0,20,13
1713512274364,MCWP 50R,B00,518792,Staff,3,0,20,17
1713512274364,MCWP 50R,C00,518793,Staff,5,0,20,15
1713512274364,MCWP 50R,D00,518794,Staff,0,0,20,20
1713512274364,MCWP 50R,E00,518795,Staff,0,0,20,20
1713512274364,MCWP 50R,F00,518796,Staff,11,0,20,9
1713512274364,MCWP 50R,G00,518797,Staff,10,0,20,10
1713512275394,MMW 12R,A01,514034,Herbst; Matthew,1,0,16,15
1713512275394,MMW 12R,A02,514035,Herbst; Matthew,13,0,16,3
1713512276425,MMW 13R,A01,514037,Staff,0,8,16,16
1713512276425,MMW 13R,A02,514039,Staff,0,7,16,16
1713512278483,SIO 295LS,A00,523233,Staff,15,0,30,15
1713512279512,SIO 295S,A00,523232,Staff,15,0,30,15
1713512280543,SOCI 117,A01,494376,Staff,0,2,5,5
1713512281575,WES 237B,A00,494380,Staff,19,0,20,1
1713512283644,AESE 279B,A00,494370,Wade; Jon P,33,0,33,0
1713512284673,AIP 197,001,627712,Vespa; Emanuel Ignacio,9999,0,9999,0
1713512285704,ANAR 135S,A00,494369,Braswell; Geoffrey E.,0,0,0,0
1713512286730,CAT 124RS,A01,519847,Geibel; William,6,0,20,14
1713512287758,CAT 125RS,A01,515971,Geibel; William,6,0,20,14
1713512288784,CLRE 250,A00,511389,Morris; Sheldon,9996,0,9999,3
1713512289811,CLRE 251,A00,507176,Mehta; Ravindra L.,9996,0,9999,3
1713512289811,CLRE 251,B00,511410,Mehta; Ravindra L.,9998,0,9999,1
1713512290838,CLRE 252,A00,507189,Cuomo; Raphael Eduardo,9998,0,9999,1
1713512291869,CLRE 253,A00,507199,Vaida; Florin,9997,0,9999,2
1713512291869,CLRE 253,B00,507202,Vaida; Florin,9999,0,9999,0
1713512292896,CLRE 259,A00,507211,Patel; Hemal,9996,0,9999,3
1713512293924,CLRE 260,A00,507221,Cuomo; Raphael Eduardo,9999,0,9999,0
1713512294951,CLRE 297,001,507242,Cuomo; Raphael Eduardo,9999,0,9999,0
1713512295980,CSE 191,A00,516875,Minnes Kemp; Mor Mia,9999,0,9999,0
1713512297006,CSS 201S,A01,494383,Staff,35,0,35,0
1713512298033,CSS 202S,A01,494387,Staff,35,0,35,0
1713512299062,EAP 100,A00,516065,Staff,9792,0,9999,207
1713512300087,ECE 45,A01,507414,Staff,37,0,60,23
1713512301114,ECE 100,A01,507416,Baghdadchi; Saharnaz,0,0,20,20
1713512301114,ECE 100,A02,507418,Baghdadchi; Saharnaz,19,0,20,1
1713512302144,ECE 111,A01,507420,Staff,27,0,50,23
1713512303171,ECE 197,001,548057,Sievenpiper; Daniel F.,9998,0,9999,1
1713512304199,EDS 115,A00,507243,Choi; Bailey Miyeon,27,0,28,1
1713512305224,EDS 117,A01,494379,Staff,15,0,25,10
1713512306251,EDS 125,A00,507246,Hopkins; Megan Beth,27,0,30,3
1713512307278,EDS 128A,A01,507264,Fargason; Sharon Gayle,26,0,26,0
1713512308308,EDS 128B,A01,507293,Pappas; Elizabeth,30,0,30,0
1713512309340,EDS 139,A00,507294,Fargason; Sharon Gayle,30,0,30,0
1713512309340,EDS 139,B00,507313,Pappas; Elizabeth,30,0,30,0
1713512310371,EDS 201,A00,507315,Staff,18,0,30,12
1713512311399,EDS 203,A01,507317,Halter; Christopher P.,17,0,30,13
1713512312430,EDS 204R,A01,507319,Halter; Christopher P.,0,1,30,30
1713512312430,EDS 204R,B01,507331,Heinzman; Erica M.,22,0,30,8
1713512313461,EDS 206R,A00,507332,Staff,0,2,30,30
1713512313461,EDS 206R,B00,507343,Staff,23,0,30,7
1713512314486,EDS 250,A00,507344,Hemans; Patricia Ann Benitez,27,0,40,13
1713512315514,EDS 281,A00,507345,Daly; Alan J.,18,0,18,0
1713512316541,EDS 284,A00,507350,Daly; Alan J.,16,0,16,0
1713512317568,EDS 286,A00,507359,Fine; Sarah,18,0,18,0
1713512318594,EDS 289C,A01,507361,Daly; Alan J.,18,0,18,0
1713512319620,EDS 290,A00,507366,Hofstetter; Carolyn,15,0,15,0
1713512320646,LIGM 5A,A00,507421,Fischer-Grunski; Eva K,20,0,20,0
1713512321675,LIGM 5B,A00,507423,Fischer-Grunski; Eva K,20,0,20,0
1713512322702,LIGM 5C,A00,507425,Fischer-Grunski; Eva K,20,0,20,0
1713512323728,LIIT 5AS,A00,507427,Carnelos; Chiara,20,0,20,0
1713512324759,LIIT 5BS,A00,507430,Carnelos; Chiara,20,0,20,0
1713512325785,LIIT 5CS,A00,507432,Carnelos; Chiara,20,0,20,0
1713512326818,LISP 5A,A00,507541,Munoz Sanchez; Alicia,14,0,20,6
1713512327849,LISP 5B,A00,507671,Munoz Sanchez; Alicia,12,0,20,8
1713512328880,LISP 5C,A00,507696,Munoz Sanchez; Alicia,11,0,20,9
1713512329908,MAE 197,001,528363,Boechler; Nicholas Sebastia,9998,0,9999,1
1713512330936,MATH 197,001,523477,Kedlaya; Kiran S.,9999,0,9999,0
1713512330936,MATH 197,002,563811,Zhang; Danna,9998,0,9999,1
1713512332021,MCWP 40R,A00,518780,Staff,13,0,20,7
1713512332021,MCWP 40R,B00,518781,Staff,11,0,20,9
1713512332021,MCWP 40R,C00,518783,Staff,8,0,20,12
1713512333052,MCWP 50R,A00,518791,Staff,7,0,20,13
1713512333052,MCWP 50R,B00,518792,Staff,3,0,20,17
1713512333052,MCWP 50R,C00,518793,Staff,5,0,20,15
1713512333052,MCWP 50R,D00,518794,Staff,0,0,20,20
1713512333052,MCWP 50R,E00,518795,Staff,0,0,20,20
1713512333052,MCWP 50R,F00,518796,Staff,11,0,20,9
1713512333052,MCWP 50R,G00,518797,Staff,10,0,20,10
1713512334081,MMW 12R,A01,514034,Herbst; Matthew,1,0,16,15
1713512334081,MMW 12R,A02,514035,Herbst; Matthew,13,0,16,3
1713512335107,MMW 13R,A01,514037,Staff,0,8,16,16
1713512335107,MMW 13R,A02,514039,Staff,0,7,16,16
1713512337161,SIO 295LS,A00,523233,Staff,15,0,30,15
1713512338188,SIO 295S,A00,523232,Staff,15,0,30,15
1713512339215,SOCI 117,A01,494376,Staff,0,2,5,5
1713512340240,WES 237B,A00,494380,Staff,19,0,20,1
1713512342298,AESE 279B,A00,494370,Wade; Jon P,33,0,33,0
1713512343324,AIP 197,001,627712,Vespa; Emanuel Ignacio,9999,0,9999,0
1713512344351,ANAR 135S,A00,494369,Braswell; Geoffrey E.,0,0,0,0
1713512345381,CAT 124RS,A01,519847,Geibel; William,6,0,20,14
1713512346408,CAT 125RS,A01,515971,Geibel; William,6,0,20,14
1713512347433,CLRE 250,A00,511389,Morris; Sheldon,9996,0,9999,3
1713512348465,CLRE 251,A00,507176,Mehta; Ravindra L.,9996,0,9999,3
1713512348465,CLRE 251,B00,511410,Mehta; Ravindra L.,9998,0,9999,1
1713512349493,CLRE 252,A00,507189,Cuomo; Raphael Eduardo,9998,0,9999,1
1713512350518,CLRE 253,A00,507199,Vaida; Florin,9997,0,9999,2
1713512350518,CLRE 253,B00,507202,Vaida; Florin,9999,0,9999,0
1713512351545,CLRE 259,A00,507211,Patel; Hemal,9996,0,9999,3
1713512352575,CLRE 260,A00,507221,Cuomo; Raphael Eduardo,9999,0,9999,0
1713512353601,CLRE 297,001,507242,Cuomo; Raphael Eduardo,9999,0,9999,0
1713512354632,CSE 191,A00,516875,Minnes Kemp; Mor Mia,9999,0,9999,0
1713512355667,CSS 201S,A01,494383,Staff,35,0,35,0
1713512356695,CSS 202S,A01,494387,Staff,35,0,35,0
1713512357722,EAP 100,A00,516065,Staff,9792,0,9999,207
1713512358750,ECE 45,A01,507414,Staff,37,0,60,23
1713512359773,ECE 100,A01,507416,Baghdadchi; Saharnaz,0,0,20,20
1713512359773,ECE 100,A02,507418,Baghdadchi; Saharnaz,19,0,20,1
1713512360799,ECE 111,A01,507420,Staff,27,0,50,23
1713512361828,ECE 197,001,548057,Sievenpiper; Daniel F.,9998,0,9999,1
1713512362852,EDS 115,A00,507243,Choi; Bailey Miyeon,27,0,28,1
1713512363891,EDS 117,A01,494379,Staff,15,0,25,10
1713512364917,EDS 125,A00,507246,Hopkins; Megan Beth,27,0,30,3
1713512365945,EDS 128A,A01,507264,Fargason; Sharon Gayle,26,0,26,0
1713512366971,EDS 128B,A01,507293,Pappas; Elizabeth,30,0,30,0
1713512367998,EDS 139,A00,507294,Fargason; Sharon Gayle,30,0,30,0
1713512367998,EDS 139,B00,507313,Pappas; Elizabeth,30,0,30,0
1713512369024,EDS 201,A00,507315,Staff,18,0,30,12
1713512370053,EDS 203,A01,507317,Halter; Christopher P.,17,0,30,13
1713512371080,EDS 204R,A01,507319,Halter; Christopher P.,0,1,30,30
1713512371080,EDS 204R,B01,507331,Heinzman; Erica M.,22,0,30,8
1713512372107,EDS 206R,A00,507332,Staff,0,2,30,30
1713512372107,EDS 206R,B00,507343,Staff,23,0,30,7
1713512373139,EDS 250,A00,507344,Hemans; Patricia Ann Benitez,27,0,40,13
1713512374165,EDS 281,A00,507345,Daly; Alan J.,18,0,18,0
1713512375191,EDS 284,A00,507350,Daly; Alan J.,16,0,16,0
1713512376218,EDS 286,A00,507359,Fine; Sarah,18,0,18,0
1713512377244,EDS 289C,A01,507361,Daly; Alan J.,18,0,18,0
1713512378271,EDS 290,A00,507366,Hofstetter; Carolyn,15,0,15,0
1713512379303,LIGM 5A,A00,507421,Fischer-Grunski; Eva K,20,0,20,0
1713512380354,LIGM 5B,A00,507423,Fischer-Grunski; Eva K,20,0,20,0
1713512381380,LIGM 5C,A00,507425,Fischer-Grunski; Eva K,20,0,20,0
1713512382409,LIIT 5AS,A00,507427,Carnelos; Chiara,20,0,20,0
1713512383436,LIIT 5BS,A00,507430,Carnelos; Chiara,20,0,20,0
1713512384463,LIIT 5CS,A00,507432,Carnelos; Chiara,20,0,20,0
1713512385493,LISP 5A,A00,507541,Munoz Sanchez; Alicia,14,0,20,6
1713512386518,LISP 5B,A00,507671,Munoz Sanchez; Alicia,12,0,20,8
1713512387545,LISP 5C,A00,507696,Munoz Sanchez; Alicia,11,0,20,9
1713512388574,MAE 197,001,528363,Boechler; Nicholas Sebastia,9998,0,9999,1
1713512389602,MATH 197,001,523477,Kedlaya; Kiran S.,9999,0,9999,0
1713512389602,MATH 197,002,563811,Zhang; Danna,9998,0,9999,1
1713512390628,MCWP 40R,A00,518780,Staff,13,0,20,7
1713512390628,MCWP 40R,B00,518781,Staff,11,0,20,9
1713512390628,MCWP 40R,C00,518783,Staff,8,0,20,12
1713512391654,MCWP 50R,A00,518791,Staff,7,0,20,13
1713512391654,MCWP 50R,B00,518792,Staff,3,0,20,17
1713512391654,MCWP 50R,C00,518793,Staff,5,0,20,15
1713512391654,MCWP 50R,D00,518794,Staff,0,0,20,20
1713512391654,MCWP 50R,E00,518795,Staff,0,0,20,20
1713512391654,MCWP 50R,F00,518796,Staff,11,0,20,9
1713512391654,MCWP 50R,G00,518797,Staff,10,0,20,10
1713512392680,MMW 12R,A01,514034,Herbst; Matthew,1,0,16,15
1713512392680,MMW 12R,A02,514035,Herbst; Matthew,13,0,16,3
1713512393710,MMW 13R,A01,514037,Staff,0,8,16,16
1713512393710,MMW 13R,A02,514039,Staff,0,7,16,16
1713512395768,SIO 295LS,A00,523233,Staff,15,0,30,15
1713512396797,SIO 295S,A00,523232,Staff,15,0,30,15
1713512397823,SOCI 117,A01,494376,Staff,0,2,5,5
1713512398848,WES 237B,A00,494380,Staff,19,0,20,1
1713512400937,AESE 279B,A00,494370,Wade; Jon P,33,0,33,0
1713512401963,AIP 197,001,627712,Vespa; Emanuel Ignacio,9999,0,9999,0
1713512402990,ANAR 135S,A00,494369,Braswell; Geoffrey E.,0,0,0,0
1713512404015,CAT 124RS,A01,519847,Geibel; William,6,0,20,14
1713512405045,CAT 125RS,A01,515971,Geibel; William,6,0,20,14
1713512406073,CLRE 250,A00,511389,Morris; Sheldon,9996,0,9999,3
1713512407102,CLRE 251,A00,507176,Mehta; Ravindra L.,9996,0,9999,3
1713512407102,CLRE 251,B00,511410,Mehta; Ravindra L.,9998,0,9999,1
1713512408135,CLRE 252,A00,507189,Cuomo; Raphael Eduardo,9998,0,9999,1
1713512409161,CLRE 253,A00,507199,Vaida; Florin,9997,0,9999,2
1713512409161,CLRE 253,B00,507202,Vaida; Florin,9999,0,9999,0
1713512410192,CLRE 259,A00,507211,Patel; Hemal,9996,0,9999,3
1713512411222,CLRE 260,A00,507221,Cuomo; Raphael Eduardo,9999,0,9999,0
1713512412251,CLRE 297,001,507242,Cuomo; Raphael Eduardo,9999,0,9999,0
1713512413284,CSE 191,A00,516875,Minnes Kemp; Mor Mia,9999,0,9999,0
1713512414315,CSS 201S,A01,494383,Staff,35,0,35,0
1713512415341,CSS 202S,A01,494387,Staff,35,0,35,0
1713512416366,EAP 100,A00,516065,Staff,9792,0,9999,207
1713512417391,ECE 45,A01,507414,Staff,37,0,60,23
1713512418424,ECE 100,A01,507416,Baghdadchi; Saharnaz,0,0,20,20
1713512418424,ECE 100,A02,507418,Baghdadchi; Saharnaz,19,0,20,1
1713512419450,ECE 111,A01,507420,Staff,27,0,50,23
1713512420475,ECE 197,001,548057,Sievenpiper; Daniel F.,9998,0,9999,1
1713512421505,EDS 115,A00,507243,Choi; Bailey Miyeon,27,0,28,1
1713512422530,EDS 117,A01,494379,Staff,15,0,25,10
1713512423560,EDS 125,A00,507246,Hopkins; Megan Beth,27,0,30,3
1713512424590,EDS 128A,A01,507264,Fargason; Sharon Gayle,26,0,26,0
1713512425617,EDS 128B,A01,507293,Pappas; Elizabeth,30,0,30,0
1713512426643,EDS 139,A00,507294,Fargason; Sharon Gayle,30,0,30,0
1713512426643,EDS 139,B00,507313,Pappas; Elizabeth,30,0,30,0
1713512427670,EDS 201,A00,507315,Staff,18,0,30,12
1713512428718,EDS 203,A01,507317,Halter; Christopher P.,17,0,30,13
1713512429750,EDS 204R,A01,507319,Halter; Christopher P.,0,1,30,30
1713512429750,EDS 204R,B01,507331,Heinzman; Erica M.,22,0,30,8
1713512430776,EDS 206R,A00,507332,Staff,0,2,30,30
1713512430776,EDS 206R,B00,507343,Staff,23,0,30,7
1713512431804,EDS 250,A00,507344,Hemans; Patricia Ann Benitez,27,0,40,13
1713512432829,EDS 281,A00,507345,Daly; Alan J.,18,0,18,0
1713512433858,EDS 284,A00,507350,Daly; Alan J.,16,0,16,0
1713512434885,EDS 286,A00,507359,Fine; Sarah,18,0,18,0
1713512435968,EDS 289C,A01,507361,Daly; Alan J.,18,0,18,0
1713512436993,EDS 290,A00,507366,Hofstetter; Carolyn,15,0,15,0
1713512438022,LIGM 5A,A00,507421,Fischer-Grunski; Eva K,20,0,20,0
1713512439051,LIGM 5B,A00,507423,Fischer-Grunski; Eva K,20,0,20,0
1713512440081,LIGM 5C,A00,507425,Fischer-Grunski; Eva K,20,0,20,0
1713512441106,LIIT 5AS,A00,507427,Carnelos; Chiara,20,0,20,0
1713512442137,LIIT 5BS,A00,507430,Carnelos; Chiara,20,0,20,0
1713512443163,LIIT 5CS,A00,507432,Carnelos; Chiara,20,0,20,0
1713512444193,LISP 5A,A00,507541,Munoz Sanchez; Alicia,14,0,20,6
1713512445220,LISP 5B,A00,507671,Munoz Sanchez; Alicia,12,0,20,8
1713512446252,LISP 5C,A00,507696,Munoz Sanchez; Alicia,11,0,20,9
1713512447281,MAE 197,001,528363,Boechler; Nicholas Sebastia,9998,0,9999,1
1713512448308,MATH 197,001,523477,Kedlaya; Kiran S.,9999,0,9999,0
1713512448308,MATH 197,002,563811,Zhang; Danna,9998,0,9999,1
1713512449338,MCWP 40R,A00,518780,Staff,13,0,20,7
1713512449338,MCWP 40R,B00,518781,Staff,11,0,20,9
1713512449338,MCWP 40R,C00,518783,Staff,8,0,20,12
1713512450373,MCWP 50R,A00,518791,Staff,7,0,20,13
1713512450373,MCWP 50R,B00,518792,Staff,3,0,20,17
1713512450373,MCWP 50R,C00,518793,Staff,5,0,20,15
1713512450373,MCWP 50R,D00,518794,Staff,0,0,20,20
1713512450373,MCWP 50R,E00,518795,Staff,0,0,20,20
1713512450373,MCWP 50R,F00,518796,Staff,11,0,20,9
1713512450373,MCWP 50R,G00,518797,Staff,10,0,20,10
1713512451402,MMW 12R,A01,514034,Herbst; Matthew,1,0,16,15
1713512451402,MMW 12R,A02,514035,Herbst; Matthew,13,0,16,3
1713512452426,MMW 13R,A01,514037,Staff,0,8,16,16
1713512452426,MMW 13R,A02,514039,Staff,0,7,16,16
1713512454477,SIO 295LS,A00,523233,Staff,15,0,30,15
1713512455503,SIO 295S,A00,523232,Staff,15,0,30,15
1713512456528,SOCI 117,A01,494376,Staff,0,2,5,5
1713512457556,WES 237B,A00,494380,Staff,19,0,20,1
1713512459629,AESE 279B,A00,494370,Wade; Jon P,33,0,33,0
1713512460655,AIP 197,001,627712,Vespa; Emanuel Ignacio,9999,0,9999,0
1713512461681,ANAR 135S,A00,494369,Braswell; Geoffrey E.,0,0,0,0
1713512462710,CAT 124RS,A01,519847,Geibel; William,6,0,20,14
1713512463739,CAT 125RS,A01,515971,Geibel; William,6,0,20,14
1713512464765,CLRE 250,A00,511389,Morris; Sheldon,9996,0,9999,3
1713512465794,CLRE 251,A00,507176,Mehta; Ravindra L.,9996,0,9999,3
1713512465794,CLRE 251,B00,511410,Mehta; Ravindra L.,9998,0,9999,1
1713512466832,CLRE 252,A00,507189,Cuomo; Raphael Eduardo,9998,0,9999,1
1713512467860,CLRE 253,A00,507199,Vaida; Florin,9997,0,9999,2
1713512467860,CLRE 253,B00,507202,Vaida; Florin,9999,0,9999,0
1713512468892,CLRE 259,A00,507211,Patel; Hemal,9996,0,9999,3
1713512469922,CLRE 260,A00,507221,Cuomo; Raphael Eduardo,9999,0,9999,0
1713512470951,CLRE 297,001,507242,Cuomo; Raphael Eduardo,9999,0,9999,0
1713512471977,CSE 191,A00,516875,Minnes Kemp; Mor Mia,9999,0,9999,0
1713512473011,CSS 201S,A01,494383,Staff,35,0,35,0
1713512474044,CSS 202S,A01,494387,Staff,35,0,35,0
1713512475069,EAP 100,A00,516065,Staff,9792,0,9999,207
1713512476095,ECE 45,A01,507414,Staff,37,0,60,23
1713512477122,ECE 100,A01,507416,Baghdadchi; Saharnaz,0,0,20,20
1713512477122,ECE 100,A02,507418,Baghdadchi; Saharnaz,19,0,20,1
1713512478152,ECE 111,A01,507420,Staff,27,0,50,23
1713512479181,ECE 197,001,548057,Sievenpiper; Daniel F.,9998,0,9999,1
1713512480206,EDS 115,A00,507243,Choi; Bailey Miyeon,27,0,28,1
1713512481237,EDS 117,A01,494379,Staff,15,0,25,10
1713512482266,EDS 125,A00,507246,Hopkins; Megan Beth,27,0,30,3
1713512483296,EDS 128A,A01,507264,Fargason; Sharon Gayle,26,0,26,0
1713512484381,EDS 128B,A01,507293,Pappas; Elizabeth,30,0,30,0
1713512485407,EDS 139,A00,507294,Fargason; Sharon Gayle,30,0,30,0
1713512485407,EDS 139,B00,507313,Pappas; Elizabeth,30,0,30,0
1713512486436,EDS 201,A00,507315,Staff,18,0,30,12
1713512487466,EDS 203,A01,507317,Halter; Christopher P.,17,0,30,13
1713512488495,EDS 204R,A01,507319,Halter; Christopher P.,0,1,30,30
1713512488495,EDS 204R,B01,507331,Heinzman; Erica M.,22,0,30,8
1713512489525,EDS 206R,A00,507332,Staff,0,2,30,30
1713512489525,EDS 206R,B00,507343,Staff,23,0,30,7
1713512490550,EDS 250,A00,507344,Hemans; Patricia Ann Benitez,27,0,40,13
1713512491575,EDS 281,A00,507345,Daly; Alan J.,18,0,18,0
1713512492601,EDS 284,A00,507350,Daly; Alan J.,16,0,16,0
1713512493631,EDS 286,A00,507359,Fine; Sarah,18,0,18,0
1713512494660,EDS 289C,A01,507361,Daly; Alan J.,18,0,18,0
1713512495685,EDS 290,A00,507366,Hofstetter; Carolyn,15,0,15,0
1713512496710,LIGM 5A,A00,507421,Fischer-Grunski; Eva K,20,0,20,0
1713512497739,LIGM 5B,A00,507423,Fischer-Grunski; Eva K,20,0,20,0
1713512498765,LIGM 5C,A00,507425,Fischer-Grunski; Eva K,20,0,20,0
1713512499791,LIIT 5AS,A00,507427,Carnelos; Chiara,20,0,20,0
1713512500819,LIIT 5BS,A00,507430,Carnelos; Chiara,20,0,20,0
1713512501845,LIIT 5CS,A00,507432,Carnelos; Chiara,20,0,20,0
1713512502871,LISP 5A,A00,507541,Munoz Sanchez; Alicia,14,0,20,6
1713512503897,LISP 5B,A00,507671,Munoz Sanchez; Alicia,12,0,20,8
1713512504929,LISP 5C,A00,507696,Munoz Sanchez; Alicia,11,0,20,9
1713512505954,MAE 197,001,528363,Boechler; Nicholas Sebastia,9998,0,9999,1
1713512506985,MATH 197,001,523477,Kedlaya; Kiran S.,9999,0,9999,0
1713512506985,MATH 197,002,563811,Zhang; Danna,9998,0,9999,1
1713512508014,MCWP 40R,A00,518780,Staff,13,0,20,7
1713512508014,MCWP 40R,B00,518781,Staff,11,0,20,9
1713512508014,MCWP 40R,C00,518783,Staff,8,0,20,12
1713512509044,MCWP 50R,A00,518791,Staff,7,0,20,13
1713512509044,MCWP 50R,B00,518792,Staff,3,0,20,17
1713512509044,MCWP 50R,C00,518793,Staff,5,0,20,15
1713512509044,MCWP 50R,D00,518794,Staff,0,0,20,20
1713512509044,MCWP 50R,E00,518795,Staff,0,0,20,20
1713512509044,MCWP 50R,F00,518796,Staff,11,0,20,9
1713512509044,MCWP 50R,G00,518797,Staff,10,0,20,10
1713512510071,MMW 12R,A01,514034,Herbst; Matthew,1,0,16,15
1713512510071,MMW 12R,A02,514035,Herbst; Matthew,13,0,16,3
1713512511101,MMW 13R,A01,514037,Staff,0,8,16,16
1713512511101,MMW 13R,A02,514039,Staff,0,7,16,16
1713512513152,SIO 295LS,A00,523233,Staff,15,0,30,15
1713512514181,SIO 295S,A00,523232,Staff,15,0,30,15
1713512515207,SOCI 117,A01,494376,Staff,0,2,5,5
1713512516232,WES 237B,A00,494380,Staff,19,0,20,1
1713512518291,AESE 279B,A00,494370,Wade; Jon P,33,0,33,0
1713512519320,AIP 197,001,627712,Vespa; Emanuel Ignacio,9999,0,9999,0
1713512520346,ANAR 135S,A00,494369,Braswell; Geoffrey E.,0,0,0,0
1713512521375,CAT 124RS,A01,519847,Geibel; William,6,0,20,14
1713512522400,CAT 125RS,A01,515971,Geibel; William,6,0,20,14
1713512523434,CLRE 250,A00,511389,Morris; Sheldon,9996,0,9999,3
1713512524467,CLRE 251,A00,507176,Mehta; Ravindra L.,9996,0,9999,3
1713512524467,CLRE 251,B00,511410,Mehta; Ravindra L.,9998,0,9999,1
1713512525494,CLRE 252,A00,507189,Cuomo; Raphael Eduardo,9998,0,9999,1
1713512526523,CLRE 253,A00,507199,Vaida; Florin,9997,0,9999,2
1713512526523,CLRE 253,B00,507202,Vaida; Florin,9999,0,9999,0
1713512527548,CLRE 259,A00,507211,Patel; Hemal,9996,0,9999,3
1713512528577,CLRE 260,A00,507221,Cuomo; Raphael Eduardo,9999,0,9999,0
1713512529603,CLRE 297,001,507242,Cuomo; Raphael Eduardo,9999,0,9999,0
1713512530627,CSE 191,A00,516875,Minnes Kemp; Mor Mia,9999,0,9999,0
1713512531654,CSS 201S,A01,494383,Staff,35,0,35,0
1713512532686,CSS 202S,A01,494387,Staff,35,0,35,0
1713512533713,EAP 100,A00,516065,Staff,9792,0,9999,207
1713512534745,ECE 45,A01,507414,Staff,37,0,60,23
1713512535775,ECE 100,A01,507416,Baghdadchi; Saharnaz,0,0,20,20
1713512535775,ECE 100,A02,507418,Baghdadchi; Saharnaz,19,0,20,1
1713512536806,ECE 111,A01,507420,Staff,27,0,50,23
1713512537832,ECE 197,001,548057,Sievenpiper; Daniel F.,9998,0,9999,1
1713512538860,EDS 115,A00,507243,Choi; Bailey Miyeon,27,0,28,1
1713512539941,EDS 117,A01,494379,Staff,15,0,25,10
1713512540967,EDS 125,A00,507246,Hopkins; Megan Beth,27,0,30,3
1713512541992,EDS 128A,A01,507264,Fargason; Sharon Gayle,26,0,26,0
1713512543018,EDS 128B,A01,507293,Pappas; Elizabeth,30,0,30,0
1713512544048,EDS 139,A00,507294,Fargason; Sharon Gayle,30,0,30,0
1713512544048,EDS 139,B00,507313,Pappas; Elizabeth,30,0,30,0
1713512545074,EDS 201,A00,507315,Staff,18,0,30,12
1713512546099,EDS 203,A01,507317,Halter; Christopher P.,17,0,30,13
1713512547127,EDS 204R,A01,507319,Halter; Christopher P.,0,1,30,30
1713512547127,EDS 204R,B01,507331,Heinzman; Erica M.,22,0,30,8
1713512548153,EDS 206R,A00,507332,Staff,0,2,30,30
1713512548153,EDS 206R,B00,507343,Staff,23,0,30,7
1713512549179,EDS 250,A00,507344,Hemans; Patricia Ann Benitez,27,0,40,13
1713512550205,EDS 281,A00,507345,Daly; Alan J.,18,0,18,0
1713512551235,EDS 284,A00,507350,Daly; Alan J.,16,0,16,0
1713512552262,EDS 286,A00,507359,Fine; Sarah,18,0,18,0
1713512553291,EDS 289C,A01,507361,Daly; Alan J.,18,0,18,0
1713512554320,EDS 290,A00,507366,Hofstetter; Carolyn,15,0,15,0
1713512555351,LIGM 5A,A00,507421,Fischer-Grunski; Eva K,20,0,20,0
1713512556378,LIGM 5B,A00,507423,Fischer-Grunski; Eva K,20,0,20,0
1713512557404,LIGM 5C,A00,507425,Fischer-Grunski; Eva K,20,0,20,0
1713512558431,LIIT 5AS,A00,507427,Carnelos; Chiara,20,0,20,0
1713512559457,LIIT 5BS,A00,507430,Carnelos; Chiara,20,0,20,0
1713512560483,LIIT 5CS,A00,507432,Carnelos; Chiara,20,0,20,0
1713512561514,LISP 5A,A00,507541,Munoz Sanchez; Alicia,14,0,20,6
1713512562544,LISP 5B,A00,507671,Munoz Sanchez; Alicia,12,0,20,8
1713512563571,LISP 5C,A00,507696,Munoz Sanchez; Alicia,11,0,20,9
1713512564596,MAE 197,001,528363,Boechler; Nicholas Sebastia,9998,0,9999,1
1713512565624,MATH 197,001,523477,Kedlaya; Kiran S.,9999,0,9999,0
1713512565624,MATH 197,002,563811,Zhang; Danna,9998,0,9999,1
1713512566650,MCWP 40R,A00,518780,Staff,13,0,20,7
1713512566650,MCWP 40R,B00,518781,Staff,11,0,20,9
1713512566650,MCWP 40R,C00,518783,Staff,8,0,20,12
1713512567685,MCWP 50R,A00,518791,Staff,7,0,20,13
1713512567685,MCWP 50R,B00,518792,Staff,3,0,20,17
1713512567685,MCWP 50R,C00,518793,Staff,5,0,20,15
1713512567685,MCWP 50R,D00,518794,Staff,0,0,20,20
1713512567685,MCWP 50R,E00,518795,Staff,0,0,20,20
1713512567685,MCWP 50R,F00,518796,Staff,11,0,20,9
1713512567685,MCWP 50R,G00,518797,Staff,10,0,20,10
1713512568711,MMW 12R,A01,514034,Herbst; Matthew,1,0,16,15
1713512568711,MMW 12R,A02,514035,Herbst; Matthew,13,0,16,3
1713512569736,MMW 13R,A01,514037,Staff,0,8,16,16
1713512569736,MMW 13R,A02,514039,Staff,0,7,16,16
1713512571794,SIO 295LS,A00,523233,Staff,15,0,30,15
1713512572820,SIO 295S,A00,523232,Staff,15,0,30,15
1713512573859,SOCI 117,A01,494376,Staff,0,2,5,5
1713512574890,WES 237B,A00,494380,Staff,19,0,20,1
1713512576962,AESE 279B,A00,494370,Wade; Jon P,33,0,33,0
1713512577991,AIP 197,001,627712,Vespa; Emanuel Ignacio,9999,0,9999,0
1713512579018,ANAR 135S,A00,494369,Braswell; Geoffrey E.,0,0,0,0
1713512580043,CAT 124RS,A01,519847,Geibel; William,6,0,20,14
1713512581069,CAT 125RS,A01,515971,Geibel; William,6,0,20,14
1713512582099,CLRE 250,A00,511389,Morris; Sheldon,9996,0,9999,3
1713512583127,CLRE 251,A00,507176,Mehta; Ravindra L.,9996,0,9999,3
1713512583127,CLRE 251,B00,511410,Mehta; Ravindra L.,9998,0,9999,1
1713512584159,CLRE 252,A00,507189,Cuomo; Raphael Eduardo,9998,0,9999,1
1713512585192,CLRE 253,A00,507199,Vaida; Florin,9997,0,9999,2
1713512585192,CLRE 253,B00,507202,Vaida; Florin,9999,0,9999,0
1713512586219,CLRE 259,A00,507211,Patel; Hemal,9996,0,9999,3
1713512587249,CLRE 260,A00,507221,Cuomo; Raphael Eduardo,9999,0,9999,0
1713512588279,CLRE 297,001,507242,Cuomo; Raphael Eduardo,9999,0,9999,0
1713512589311,CSE 191,A00,516875,Minnes Kemp; Mor Mia,9999,0,9999,0
1713512590338,CSS 201S,A01,494383,Staff,35,0,35,0
1713512591369,CSS 202S,A01,494387,Staff,35,0,35,0
1713512592396,EAP 100,A00,516065,Staff,9792,0,9999,207
1713512593425,ECE 45,A01,507414,Staff,37,0,60,23
1713512594458,ECE 100,A01,507416,Baghdadchi; Saharnaz,0,0,20,20
1713512594458,ECE 100,A02,507418,Baghdadchi; Saharnaz,19,0,20,1
1713512595482,ECE 111,A01,507420,Staff,27,0,50,23
1713512596509,ECE 197,001,548057,Sievenpiper; Daniel F.,9998,0,9999,1
1713512597536,EDS 115,A00,507243,Choi; Bailey Miyeon,27,0,28,1
1713512598569,EDS 117,A01,494379,Staff,15,0,25,10
1713512599596,EDS 125,A00,507246,Hopkins; Megan Beth,27,0,30,3
1713512600625,EDS 128A,A01,507264,Fargason; Sharon Gayle,26,0,26,0
1713512601652,EDS 128B,A01,507293,Pappas; Elizabeth,30,0,30,0
1713512602677,EDS 139,A00,507294,Fargason; Sharon Gayle,30,0,30,0
1713512602677,EDS 139,B00,507313,Pappas; Elizabeth,30,0,30,0
1713512603709,EDS 201,A00,507315,Staff,18,0,30,12
1713512604736,EDS 203,A01,507317,Halter; Christopher P.,17,0,30,13
1713512605768,EDS 204R,A01,507319,Halter; Christopher P.,0,1,30,30
1713512605768,EDS 204R,B01,507331,Heinzman; Erica M.,22,0,30,8
1713512606792,EDS 206R,A00,507332,Staff,0,2,30,30
1713512606792,EDS 206R,B00,507343,Staff,23,0,30,7
1713512607823,EDS 250,A00,507344,Hemans; Patricia Ann Benitez,27,0,40,13
1713512608848,EDS 281,A00,507345,Daly; Alan J.,18,0,18,0
1713512609874,EDS 284,A00,507350,Daly; Alan J.,16,0,16,0
1713512610904,EDS 286,A00,507359,Fine; Sarah,18,0,18,0
1713512611932,EDS 289C,A01,507361,Daly; Alan J.,18,0,18,0
1713512612959,EDS 290,A00,507366,Hofstetter; Carolyn,15,0,15,0
1713512613988,LIGM 5A,A00,507421,Fischer-Grunski; Eva K,20,0,20,0
1713512615018,LIGM 5B,A00,507423,Fischer-Grunski; Eva K,20,0,20,0
1713512616045,LIGM 5C,A00,507425,Fischer-Grunski; Eva K,20,0,20,0
1713512617071,LIIT 5AS,A00,507427,Carnelos; Chiara,20,0,20,0
1713512618106,LIIT 5BS,A00,507430,Carnelos; Chiara,20,0,20,0
1713512619137,LIIT 5CS,A00,507432,Carnelos; Chiara,20,0,20,0
1713512620165,LISP 5A,A00,507541,Munoz Sanchez; Alicia,14,0,20,6
1713512621191,LISP 5B,A00,507671,Munoz Sanchez; Alicia,12,0,20,8
1713512622223,LISP 5C,A00,507696,Munoz Sanchez; Alicia,11,0,20,9
1713512623253,MAE 197,001,528363,Boechler; Nicholas Sebastia,9998,0,9999,1
1713512624280,MATH 197,001,523477,Kedlaya; Kiran S.,9999,0,9999,0
1713512624280,MATH 197,002,563811,Zhang; Danna,9998,0,9999,1
1713512625306,MCWP 40R,A00,518780,Staff,13,0,20,7
1713512625306,MCWP 40R,B00,518781,Staff,11,0,20,9
1713512625306,MCWP 40R,C00,518783,Staff,8,0,20,12
1713512626332,MCWP 50R,A00,518791,Staff,7,0,20,13
1713512626332,MCWP 50R,B00,518792,Staff,3,0,20,17
1713512626332,MCWP 50R,C00,518793,Staff,5,0,20,15
1713512626332,MCWP 50R,D00,518794,Staff,0,0,20,20
1713512626332,MCWP 50R,E00,518795,Staff,0,0,20,20
1713512626332,MCWP 50R,F00,518796,Staff,11,0,20,9
1713512626332,MCWP 50R,G00,518797,Staff,10,0,20,10
1713512627356,MMW 12R,A01,514034,Herbst; Matthew,1,0,16,15
1713512627356,MMW 12R,A02,514035,Herbst; Matthew,13,0,16,3
1713512628382,MMW 13R,A01,514037,Staff,0,8,16,16
1713512628382,MMW 13R,A02,514039,Staff,0,7,16,16
1713512630491,SIO 295LS,A00,523233,Staff,15,0,30,15
1713512631519,SIO 295S,A00,523232,Staff,15,0,30,15
1713512632564,SOCI 117,A01,494376,Staff,0,2,5,5
1713512633593,WES 237B,A00,494380,Staff,19,0,20,1
1713512635678,AESE 279B,A00,494370,Wade; Jon P,33,0,33,0
1713512636710,AIP 197,001,627712,Vespa; Emanuel Ignacio,9999,0,9999,0
1713512637736,ANAR 135S,A00,494369,Braswell; Geoffrey E.,0,0,0,0
1713512638776,CAT 124RS,A01,519847,Geibel; William,6,0,20,14
1713512639811,CAT 125RS,A01,515971,Geibel; William,6,0,20,14
1713512640841,CLRE 250,A00,511389,Morris; Sheldon,9996,0,9999,3
1713512641870,CLRE 251,A00,507176,Mehta; Ravindra L.,9996,0,9999,3
1713512641870,CLRE 251,B00,511410,Mehta; Ravindra L.,9998,0,9999,1
1713512642897,CLRE 252,A00,507189,Cuomo; Raphael Eduardo,9998,0,9999,1
1713512643976,CLRE 253,A00,507199,Vaida; Florin,9997,0,9999,2
1713512643976,CLRE 253,B00,507202,Vaida; Florin,9999,0,9999,0
1713512645003,CLRE 259,A00,507211,Patel; Hemal,9996,0,9999,3
1713512646029,CLRE 260,A00,507221,Cuomo; Raphael Eduardo,9999,0,9999,0
1713512647055,CLRE 297,001,507242,Cuomo; Raphael Eduardo,9999,0,9999,0
1713512648080,CSE 191,A00,516875,Minnes Kemp; Mor Mia,9999,0,9999,0
1713512649110,CSS 201S,A01,494383,Staff,35,0,35,0
1713512650140,CSS 202S,A01,494387,Staff,35,0,35,0
1713512651167,EAP 100,A00,516065,Staff,9792,0,9999,207
1713512652194,ECE 45,A01,507414,Staff,37,0,60,23
1713512653223,ECE 100,A01,507416,Baghdadchi; Saharnaz,0,0,20,20
1713512653223,ECE 100,A02,507418,Baghdadchi; Saharnaz,19,0,20,1
1713512654254,ECE 111,A01,507420,Staff,27,0,50,23
1713512655282,ECE 197,001,548057,Sievenpiper; Daniel F.,9998,0,9999,1
1713512656309,EDS 115,A00,507243,Choi; Bailey Miyeon,27,0,28,1
1713512657335,EDS 117,A01,494379,Staff,15,0,25,10
1713512658367,EDS 125,A00,507246,Hopkins; Megan Beth,27,0,30,3
1713512659397,EDS 128A,A01,507264,Fargason; Sharon Gayle,26,0,26,0
1713512660423,EDS 128B,A01,507293,Pappas; Elizabeth,30,0,30,0
1713512661448,EDS 139,A00,507294,Fargason; Sharon Gayle,30,0,30,0
1713512661448,EDS 139,B00,507313,Pappas; Elizabeth,30,0,30,0
1713512662473,EDS 201,A00,507315,Staff,18,0,30,12
1713512663523,EDS 203,A01,507317,Halter; Christopher P.,17,0,30,13
1713512664550,EDS 204R,A01,507319,Halter; Christopher P.,0,1,30,30
1713512664550,EDS 204R,B01,507331,Heinzman; Erica M.,22,0,30,8
1713512665576,EDS 206R,A00,507332,Staff,0,2,30,30
1713512665576,EDS 206R,B00,507343,Staff,23,0,30,7
1713512666604,EDS 250,A00,507344,Hemans; Patricia Ann Benitez,27,0,40,13
1713512667635,EDS 281,A00,507345,Daly; Alan J.,18,0,18,0
1713512668665,EDS 284,A00,507350,Daly; Alan J.,16,0,16,0
1713512669695,EDS 286,A00,507359,Fine; Sarah,18,0,18,0
1713512670722,EDS 289C,A01,507361,Daly; Alan J.,18,0,18,0
1713512671751,EDS 290,A00,507366,Hofstetter; Carolyn,15,0,15,0
1713512672814,LIGM 5A,A00,507421,Fischer-Grunski; Eva K,20,0,20,0
1713512673846,LIGM 5B,A00,507423,Fischer-Grunski; Eva K,20,0,20,0
1713512674876,LIGM 5C,A00,507425,Fischer-Grunski; Eva K,20,0,20,0
1713512675905,LIIT 5AS,A00,507427,Carnelos; Chiara,20,0,20,0
1713512676929,LIIT 5BS,A00,507430,Carnelos; Chiara,20,0,20,0
1713512677957,LIIT 5CS,A00,507432,Carnelos; Chiara,20,0,20,0
1713512678988,LISP 5A,A00,507541,Munoz Sanchez; Alicia,14,0,20,6
1713512680015,LISP 5B,A00,507671,Munoz Sanchez; Alicia,12,0,20,8
1713512681043,LISP 5C,A00,507696,Munoz Sanchez; Alicia,11,0,20,9
1713512682076,MAE 197,001,528363,Boechler; Nicholas Sebastia,9998,0,9999,1
1713512683102,MATH 197,001,523477,Kedlaya; Kiran S.,9999,0,9999,0
1713512683102,MATH 197,002,563811,Zhang; Danna,9998,0,9999,1
1713512684151,MCWP 40R,A00,518780,Staff,13,0,20,7
1713512684151,MCWP 40R,B00,518781,Staff,11,0,20,9
1713512684151,MCWP 40R,C00,518783,Staff,8,0,20,12
1713512685181,MCWP 50R,A00,518791,Staff,7,0,20,13
1713512685181,MCWP 50R,B00,518792,Staff,3,0,20,17
1713512685181,MCWP 50R,C00,518793,Staff,5,0,20,15
1713512685181,MCWP 50R,D00,518794,Staff,0,0,20,20
1713512685181,MCWP 50R,E00,518795,Staff,0,0,20,20
1713512685181,MCWP 50R,F00,518796,Staff,11,0,20,9
1713512685181,MCWP 50R,G00,518797,Staff,10,0,20,10
1713512686210,MMW 12R,A01,514034,Herbst; Matthew,1,0,16,15
1713512686210,MMW 12R,A02,514035,Herbst; Matthew,13,0,16,3
1713512687235,MMW 13R,A01,514037,Staff,0,8,16,16
1713512687235,MMW 13R,A02,514039,Staff,0,7,16,16
1713512689296,SIO 295LS,A00,523233,Staff,15,0,30,15
1713512690326,SIO 295S,A00,523232,Staff,15,0,30,15
1713512691356,SOCI 117,A01,494376,Staff,0,2,5,5
1713512692386,WES 237B,A00,494380,Staff,19,0,20,1
1713512694477,AESE 279B,A00,494370,Wade; Jon P,33,0,33,0
1713512695505,AIP 197,001,627712,Vespa; Emanuel Ignacio,9999,0,9999,0
1713512696530,ANAR 135S,A00,494369,Braswell; Geoffrey E.,0,0,0,0
1713512697558,CAT 124RS,A01,519847,Geibel; William,6,0,20,14
1713512698586,CAT 125RS,A01,515971,Geibel; William,6,0,20,14
1713512699612,CLRE 250,A00,511389,Morris; Sheldon,9996,0,9999,3
1713512700648,CLRE 251,A00,507176,Mehta; Ravindra L.,9996,0,9999,3
1713512700648,CLRE 251,B00,511410,Mehta; Ravindra L.,9998,0,9999,1
1713512701681,CLRE 252,A00,507189,Cuomo; Raphael Eduardo,9998,0,9999,1
1713512702706,CLRE 253,A00,507199,Vaida; Florin,9997,0,9999,2
1713512702706,CLRE 253,B00,507202,Vaida; Florin,9999,0,9999,0
1713512703736,CLRE 259,A00,507211,Patel; Hemal,9996,0,9999,3
1713512704764,CLRE 260,A00,507221,Cuomo; Raphael Eduardo,9999,0,9999,0
1713512705799,CLRE 297,001,507242,Cuomo; Raphael Eduardo,9999,0,9999,0
1713512706828,CSE 191,A00,516875,Minnes Kemp; Mor Mia,9999,0,9999,0
1713512707853,CSS 201S,A01,494383,Staff,35,0,35,0
1713512708878,CSS 202S,A01,494387,Staff,35,0,35,0
1713512709906,EAP 100,A00,516065,Staff,9792,0,9999,207
1713512710934,ECE 45,A01,507414,Staff,37,0,60,23
1713512711966,ECE 100,A01,507416,Baghdadchi; Saharnaz,0,0,20,20
1713512711966,ECE 100,A02,507418,Baghdadchi; Saharnaz,19,0,20,1
1713512713004,ECE 111,A01,507420,Staff,27,0,50,23
1713512714028,ECE 197,001,548057,Sievenpiper; Daniel F.,9998,0,9999,1
1713512715054,EDS 115,A00,507243,Choi; Bailey Miyeon,27,0,28,1
1713512716084,EDS 117,A01,494379,Staff,15,0,25,10
1713512717114,EDS 125,A00,507246,Hopkins; Megan Beth,27,0,30,3
1713512718143,EDS 128A,A01,507264,Fargason; Sharon Gayle,26,0,26,0
1713512719173,EDS 128B,A01,507293,Pappas; Elizabeth,30,0,30,0
1713512720202,EDS 139,A00,507294,Fargason; Sharon Gayle,30,0,30,0
1713512720202,EDS 139,B00,507313,Pappas; Elizabeth,30,0,30,0
1713512721228,EDS 201,A00,507315,Staff,18,0,30,12
1713512722254,EDS 203,A01,507317,Halter; Christopher P.,17,0,30,13
1713512723279,EDS 204R,A01,507319,Halter; Christopher P.,0,1,30,30
1713512723279,EDS 204R,B01,507331,Heinzman; Erica M.,22,0,30,8
1713512724309,EDS 206R,A00,507332,Staff,0,2,30,30
1713512724309,EDS 206R,B00,507343,Staff,23,0,30,7
1713512725339,EDS 250,A00,507344,Hemans; Patricia Ann Benitez,27,0,40,13
1713512726367,EDS 281,A00,507345,Daly; Alan J.,18,0,18,0
1713512727391,EDS 284,A00,507350,Daly; Alan J.,16,0,16,0
1713512728434,EDS 286,A00,507359,Fine; Sarah,18,0,18,0
1713512729460,EDS 289C,A01,507361,Daly; Alan J.,18,0,18,0
1713512730487,EDS 290,A00,507366,Hofstetter; Carolyn,15,0,15,0
1713512731521,LIGM 5A,A00,507421,Fischer-Grunski; Eva K,20,0,20,0
1713512732551,LIGM 5B,A00,507423,Fischer-Grunski; Eva K,20,0,20,0
1713512733576,LIGM 5C,A00,507425,Fischer-Grunski; Eva K,20,0,20,0
1713512734606,LIIT 5AS,A00,507427,Carnelos; Chiara,20,0,20,0
1713512735636,LIIT 5BS,A00,507430,Carnelos; Chiara,20,0,20,0
1713512736668,LIIT 5CS,A00,507432,Carnelos; Chiara,20,0,20,0
1713512737694,LISP 5A,A00,507541,Munoz Sanchez; Alicia,14,0,20,6
1713512738721,LISP 5B,A00,507671,Munoz Sanchez; Alicia,12,0,20,8
1713512739751,LISP 5C,A00,507696,Munoz Sanchez; Alicia,11,0,20,9
1713512740780,MAE 197,001,528363,Boechler; Nicholas Sebastia,9998,0,9999,1
1713512741809,MATH 197,001,523477,Kedlaya; Kiran S.,9999,0,9999,0
1713512741809,MATH 197,002,563811,Zhang; Danna,9998,0,9999,1
1713512742834,MCWP 40R,A00,518780,Staff,13,0,20,7
1713512742834,MCWP 40R,B00,518781,Staff,11,0,20,9
1713512742834,MCWP 40R,C00,518783,Staff,8,0,20,12
1713512743859,MCWP 50R,A00,518791,Staff,7,0,20,13
1713512743859,MCWP 50R,B00,518792,Staff,3,0,20,17
1713512743859,MCWP 50R,C00,518793,Staff,5,0,20,15
1713512743859,MCWP 50R,D00,518794,Staff,0,0,20,20
1713512743859,MCWP 50R,E00,518795,Staff,0,0,20,20
1713512743859,MCWP 50R,F00,518796,Staff,11,0,20,9
1713512743859,MCWP 50R,G00,518797,Staff,10,0,20,10
1713512744885,MMW 12R,A01,514034,Herbst; Matthew,1,0,16,15
1713512744885,MMW 12R,A02,514035,Herbst; Matthew,13,0,16,3
1713512745911,MMW 13R,A01,514037,Staff,0,8,16,16
1713512745911,MMW 13R,A02,514039,Staff,0,7,16,16
1713512748019,SIO 295LS,A00,523233,Staff,15,0,30,15
1713512749044,SIO 295S,A00,523232,Staff,15,0,30,15
1713512750074,SOCI 117,A01,494376,Staff,0,2,5,5
1713512751106,WES 237B,A00,494380,Staff,19,0,20,1
1713512753189,AESE 279B,A00,494370,Wade; Jon P,33,0,33,0
1713512754217,AIP 197,001,627712,Vespa; Emanuel Ignacio,9999,0,9999,0
1713512755245,ANAR 135S,A00,494369,Braswell; Geoffrey E.,0,0,0,0
1713512756275,CAT 124RS,A01,519847,Geibel; William,6,0,20,14
1713512757301,CAT 125RS,A01,515971,Geibel; William,6,0,20,14
1713512758332,CLRE 250,A00,511389,Morris; Sheldon,9996,0,9999,3
1713512759359,CLRE 251,A00,507176,Mehta; Ravindra L.,9996,0,9999,3
1713512759359,CLRE 251,B00,511410,Mehta; Ravindra L.,9998,0,9999,1
1713512760387,CLRE 252,A00,507189,Cuomo; Raphael Eduardo,9998,0,9999,1
1713512761429,CLRE 253,A00,507199,Vaida; Florin,9997,0,9999,2
1713512761429,CLRE 253,B00,507202,Vaida; Florin,9999,0,9999,0
1713512762460,CLRE 259,A00,507211,Patel; Hemal,9996,0,9999,3
1713512763490,CLRE 260,A00,507221,Cuomo; Raphael Eduardo,9999,0,9999,0
1713512764519,CLRE 297,001,507242,Cuomo; Raphael Eduardo,9999,0,9999,0
1713512765552,CSE 191,A00,516875,Minnes Kemp; Mor Mia,9999,0,9999,0
1713512766612,CSS 201S,A01,494383,Staff,35,0,35,0
1713512767642,CSS 202S,A01,494387,Staff,35,0,35,0
1713512768677,EAP 100,A00,516065,Staff,9792,0,9999,207
1713512769710,ECE 45,A01,507414,Staff,37,0,60,23
1713512770736,ECE 100,A01,507416,Baghdadchi; Saharnaz,0,0,20,20
1713512770736,ECE 100,A02,507418,Baghdadchi; Saharnaz,19,0,20,1
1713512771767,ECE 111,A01,507420,Staff,27,0,50,23
1713512772794,ECE 197,001,548057,Sievenpiper; Daniel F.,9998,0,9999,1
1713512773828,EDS 115,A00,507243,Choi; Bailey Miyeon,27,0,28,1
1713512774855,EDS 117,A01,494379,Staff,15,0,25,10
1713512775882,EDS 125,A00,507246,Hopkins; Megan Beth,27,0,30,3
1713512776910,EDS 128A,A01,507264,Fargason; Sharon Gayle,26,0,26,0
1713512777938,EDS 128B,A01,507293,Pappas; Elizabeth,30,0,30,0
1713512778966,EDS 139,A00,507294,Fargason; Sharon Gayle,30,0,30,0
1713512778966,EDS 139,B00,507313,Pappas; Elizabeth,30,0,30,0
1713512779997,EDS 201,A00,507315,Staff,18,0,30,12
1713512781067,EDS 203,A01,507317,Halter; Christopher P.,17,0,30,13
1713512782093,EDS 204R,A01,507319,Halter; Christopher P.,0,1,30,30
1713512782093,EDS 204R,B01,507331,Heinzman; Erica M.,22,0,30,8
1713512783140,EDS 206R,A00,507332,Staff,0,2,30,30
1713512783140,EDS 206R,B00,507343,Staff,23,0,30,7
1713512784167,EDS 250,A00,507344,Hemans; Patricia Ann Benitez,27,0,40,13
1713512785193,EDS 281,A00,507345,Daly; Alan J.,18,0,18,0
1713512786219,EDS 284,A00,507350,Daly; Alan J.,16,0,16,0
1713512787254,EDS 286,A00,507359,Fine; Sarah,18,0,18,0
1713512788281,EDS 289C,A01,507361,Daly; Alan J.,18,0,18,0
1713512789307,EDS 290,A00,507366,Hofstetter; Carolyn,15,0,15,0
1713512790335,LIGM 5A,A00,507421,Fischer-Grunski; Eva K,20,0,20,0
1713512791361,LIGM 5B,A00,507423,Fischer-Grunski; Eva K,20,0,20,0
1713512792391,LIGM 5C,A00,507425,Fischer-Grunski; Eva K,20,0,20,0
1713512793417,LIIT 5AS,A00,507427,Carnelos; Chiara,20,0,20,0
1713512794443,LIIT 5BS,A00,507430,Carnelos; Chiara,20,0,20,0
1713512795468,LIIT 5CS,A00,507432,Carnelos; Chiara,20,0,20,0
1713512796495,LISP 5A,A00,507541,Munoz Sanchez; Alicia,14,0,20,6
1713512797524,LISP 5B,A00,507671,Munoz Sanchez; Alicia,12,0,20,8
1713512798550,LISP 5C,A00,507696,Munoz Sanchez; Alicia,11,0,20,9
1713512799576,MAE 197,001,528363,Boechler; Nicholas Sebastia,9998,0,9999,1
1713512800624,MATH 197,001,523477,Kedlaya; Kiran S.,9999,0,9999,0
1713512800624,MATH 197,002,563811,Zhang; Danna,9998,0,9999,1
1713512801656,MCWP 40R,A00,518780,Staff,13,0,20,7
1713512801656,MCWP 40R,B00,518781,Staff,11,0,20,9
1713512801656,MCWP 40R,C00,518783,Staff,8,0,20,12
1713512802687,MCWP 50R,A00,518791,Staff,7,0,20,13
1713512802687,MCWP 50R,B00,518792,Staff,3,0,20,17
1713512802687,MCWP 50R,C00,518793,Staff,5,0,20,15
1713512802687,MCWP 50R,D00,518794,Staff,0,0,20,20
1713512802687,MCWP 50R,E00,518795,Staff,0,0,20,20
1713512802687,MCWP 50R,F00,518796,Staff,11,0,20,9
1713512802687,MCWP 50R,G00,518797,Staff,10,0,20,10
1713512803711,MMW 12R,A01,514034,Herbst; Matthew,1,0,16,15
1713512803711,MMW 12R,A02,514035,Herbst; Matthew,13,0,16,3
1713512804741,MMW 13R,A01,514037,Staff,0,8,16,16
1713512804741,MMW 13R,A02,514039,Staff,0,7,16,16
1713512806797,SIO 295LS,A00,523233,Staff,15,0,30,15
1713512807823,SIO 295S,A00,523232,Staff,15,0,30,15
1713512808853,SOCI 117,A01,494376,Staff,0,2,5,5
1713512809878,WES 237B,A00,494380,Staff,19,0,20,1
1713512811956,AESE 279B,A00,494370,Wade; Jon P,33,0,33,0
1713512812985,AIP 197,001,627712,Vespa; Emanuel Ignacio,9999,0,9999,0
1713512814012,ANAR 135S,A00,494369,Braswell; Geoffrey E.,0,0,0,0
1713512815038,CAT 124RS,A01,519847,Geibel; William,6,0,20,14
1713512816069,CAT 125RS,A01,515971,Geibel; William,6,0,20,14
1713512817145,CLRE 250,A00,511389,Morris; Sheldon,9996,0,9999,3
1713512818170,CLRE 251,A00,507176,Mehta; Ravindra L.,9996,0,9999,3
1713512818170,CLRE 251,B00,511410,Mehta; Ravindra L.,9998,0,9999,1
1713512819201,CLRE 252,A00,507189,Cuomo; Raphael Eduardo,9998,0,9999,1
1713512820227,CLRE 253,A00,507199,Vaida; Florin,9997,0,9999,2
1713512820227,CLRE 253,B00,507202,Vaida; Florin,9999,0,9999,0
1713512821252,CLRE 259,A00,507211,Patel; Hemal,9996,0,9999,3
1713512822277,CLRE 260,A00,507221,Cuomo; Raphael Eduardo,9999,0,9999,0
1713512823303,CLRE 297,001,507242,Cuomo; Raphael Eduardo,9999,0,9999,0
1713512824329,CSE 191,A00,516875,Minnes Kemp; Mor Mia,9999,0,9999,0
1713512825355,CSS 201S,A01,494383,Staff,35,0,35,0
1713512826382,CSS 202S,A01,494387,Staff,35,0,35,0
1713512827407,EAP 100,A00,516065,Staff,9792,0,9999,207
1713512828435,ECE 45,A01,507414,Staff,37,0,60,23
1713512829463,ECE 100,A01,507416,Baghdadchi; Saharnaz,0,0,20,20
1713512829463,ECE 100,A02,507418,Baghdadchi; Saharnaz,19,0,20,1
1713512830487,ECE 111,A01,507420,Staff,27,0,50,23
1713512831517,ECE 197,001,548057,Sievenpiper; Daniel F.,9998,0,9999,1
1713512832547,EDS 115,A00,507243,Choi; Bailey Miyeon,27,0,28,1
1713512833573,EDS 117,A01,494379,Staff,15,0,25,10
1713512834598,EDS 125,A00,507246,Hopkins; Megan Beth,27,0,30,3
1713512835625,EDS 128A,A01,507264,Fargason; Sharon Gayle,26,0,26,0
1713512836652,EDS 128B,A01,507293,Pappas; Elizabeth,30,0,30,0
1713512837678,EDS 139,A00,507294,Fargason; Sharon Gayle,30,0,30,0
1713512837678,EDS 139,B00,507313,Pappas; Elizabeth,30,0,30,0
1713512838704,EDS 201,A00,507315,Staff,18,0,30,12
1713512839730,EDS 203,A01,507317,Halter; Christopher P.,17,0,30,13
1713512840758,EDS 204R,A01,507319,Halter; Christopher P.,0,1,30,30
1713512840758,EDS 204R,B01,507331,Heinzman; Erica M.,22,0,30,8
1713512841785,EDS 206R,A00,507332,Staff,0,2,30,30
1713512841785,EDS 206R,B00,507343,Staff,23,0,30,7
1713512842816,EDS 250,A00,507344,Hemans; Patricia Ann Benitez,27,0,40,13
1713512843842,EDS 281,A00,507345,Daly; Alan J.,18,0,18,0
1713512844875,EDS 284,A00,507350,Daly; Alan J.,16,0,16,0
1713512845907,EDS 286,A00,507359,Fine; Sarah,18,0,18,0
1713512846936,EDS 289C,A01,507361,Daly; Alan J.,18,0,18,0
1713512847962,EDS 290,A00,507366,Hofstetter; Carolyn,15,0,15,0
1713512848994,LIGM 5A,A00,507421,Fischer-Grunski; Eva K,20,0,20,0
1713512850026,LIGM 5B,A00,507423,Fischer-Grunski; Eva K,20,0,20,0
1713512851058,LIGM 5C,A00,507425,Fischer-Grunski; Eva K,20,0,20,0
1713512852140,LIIT 5AS,A00,507427,Carnelos; Chiara,20,0,20,0
1713512853167,LIIT 5BS,A00,507430,Carnelos; Chiara,20,0,20,0
1713512854193,LIIT 5CS,A00,507432,Carnelos; Chiara,20,0,20,0
1713512855218,LISP 5A,A00,507541,Munoz Sanchez; Alicia,14,0,20,6
1713512856245,LISP 5B,A00,507671,Munoz Sanchez; Alicia,12,0,20,8
1713512857273,LISP 5C,A00,507696,Munoz Sanchez; Alicia,11,0,20,9
1713512858300,MAE 197,001,528363,Boechler; Nicholas Sebastia,9998,0,9999,1
1713512859330,MATH 197,001,523477,Kedlaya; Kiran S.,9999,0,9999,0
1713512859330,MATH 197,002,563811,Zhang; Danna,9998,0,9999,1
1713512860359,MCWP 40R,A00,518780,Staff,13,0,20,7
1713512860359,MCWP 40R,B00,518781,Staff,11,0,20,9
1713512860359,MCWP 40R,C00,518783,Staff,8,0,20,12
1713512861398,MCWP 50R,A00,518791,Staff,7,0,20,13
1713512861398,MCWP 50R,B00,518792,Staff,3,0,20,17
1713512861398,MCWP 50R,C00,518793,Staff,5,0,20,15
1713512861398,MCWP 50R,D00,518794,Staff,0,0,20,20
1713512861398,MCWP 50R,E00,518795,Staff,0,0,20,20
1713512861398,MCWP 50R,F00,518796,Staff,11,0,20,9
1713512861398,MCWP 50R,G00,518797,Staff,10,0,20,10
1713512862425,MMW 12R,A01,514034,Herbst; Matthew,1,0,16,15
1713512862425,MMW 12R,A02,514035,Herbst; Matthew,13,0,16,3
1713512863451,MMW 13R,A01,514037,Staff,0,8,16,16
1713512863451,MMW 13R,A02,514039,Staff,0,7,16,16
1713512865507,SIO 295LS,A00,523233,Staff,15,0,30,15
1713512866536,SIO 295S,A00,523232,Staff,15,0,30,15
1713512867563,SOCI 117,A01,494376,Staff,0,2,5,5
1713512868591,WES 237B,A00,494380,Staff,19,0,20,1
1713512870671,AESE 279B,A00,494370,Wade; Jon P,33,0,33,0
1713512871696,AIP 197,001,627712,Vespa; Emanuel Ignacio,9999,0,9999,0
1713512872722,ANAR 135S,A00,494369,Braswell; Geoffrey E.,0,0,0,0
1713512873749,CAT 124RS,A01,519847,Geibel; William,6,0,20,14
1713512874776,CAT 125RS,A01,515971,Geibel; William,6,0,20,14
1713512875806,CLRE 250,A00,511389,Morris; Sheldon,9996,0,9999,3
1713512876834,CLRE 251,A00,507176,Mehta; Ravindra L.,9996,0,9999,3
1713512876834,CLRE 251,B00,511410,Mehta; Ravindra L.,9998,0,9999,1
1713512877862,CLRE 252,A00,507189,Cuomo; Raphael Eduardo,9998,0,9999,1
1713512878889,CLRE 253,A00,507199,Vaida; Florin,9997,0,9999,2
1713512878889,CLRE 253,B00,507202,Vaida; Florin,9999,0,9999,0
1713512879916,CLRE 259,A00,507211,Patel; Hemal,9996,0,9999,3
1713512880942,CLRE 260,A00,507221,Cuomo; Raphael Eduardo,9999,0,9999,0
1713512881968,CLRE 297,001,507242,Cuomo; Raphael Eduardo,9999,0,9999,0
1713512882999,CSE 191,A00,516875,Minnes Kemp; Mor Mia,9999,0,9999,0
1713512884025,CSS 201S,A01,494383,Staff,35,0,35,0
1713512885052,CSS 202S,A01,494387,Staff,35,0,35,0
1713512886077,EAP 100,A00,516065,Staff,9792,0,9999,207
1713512887112,ECE 45,A01,507414,Staff,37,0,60,23
1713512888146,ECE 100,A01,507416,Baghdadchi; Saharnaz,0,0,20,20
1713512888146,ECE 100,A02,507418,Baghdadchi; Saharnaz,19,0,20,1
1713512889178,ECE 111,A01,507420,Staff,27,0,50,23
1713512890203,ECE 197,001,548057,Sievenpiper; Daniel F.,9998,0,9999,1
1713512891232,EDS 115,A00,507243,Choi; Bailey Miyeon,27,0,28,1
1713512892259,EDS 117,A01,494379,Staff,15,0,25,10
1713512893285,EDS 125,A00,507246,Hopkins; Megan Beth,27,0,30,3
1713512894313,EDS 128A,A01,507264,Fargason; Sharon Gayle,26,0,26,0
1713512895337,EDS 128B,A01,507293,Pappas; Elizabeth,30,0,30,0
1713512896361,EDS 139,A00,507294,Fargason; Sharon Gayle,30,0,30,0
1713512896361,EDS 139,B00,507313,Pappas; Elizabeth,30,0,30,0
1713512897390,EDS 201,A00,507315,Staff,18,0,30,12
1713512898441,EDS 203,A01,507317,Halter; Christopher P.,17,0,30,13
1713512899470,EDS 204R,A01,507319,Halter; Christopher P.,0,1,30,30
1713512899470,EDS 204R,B01,507331,Heinzman; Erica M.,22,0,30,8
1713512900498,EDS 206R,A00,507332,Staff,0,2,30,30
1713512900498,EDS 206R,B00,507343,Staff,23,0,30,7
1713512901531,EDS 250,A00,507344,Hemans; Patricia Ann Benitez,27,0,40,13
1713512902561,EDS 281,A00,507345,Daly; Alan J.,18,0,18,0
1713512903586,EDS 284,A00,507350,Daly; Alan J.,16,0,16,0
1713512904618,EDS 286,A00,507359,Fine; Sarah,18,0,18,0
1713512905647,EDS 289C,A01,507361,Daly; Alan J.,18,0,18,0
1713512906679,EDS 290,A00,507366,Hofstetter; Carolyn,15,0,15,0
1713512907709,LIGM 5A,A00,507421,Fischer-Grunski; Eva K,20,0,20,0
1713512908736,LIGM 5B,A00,507423,Fischer-Grunski; Eva K,20,0,20,0
1713512909763,LIGM 5C,A00,507425,Fischer-Grunski; Eva K,20,0,20,0
1713512910796,LIIT 5AS,A00,507427,Carnelos; Chiara,20,0,20,0
1713512911828,LIIT 5BS,A00,507430,Carnelos; Chiara,20,0,20,0
1713512912857,LIIT 5CS,A00,507432,Carnelos; Chiara,20,0,20,0
1713512913892,LISP 5A,A00,507541,Munoz Sanchez; Alicia,14,0,20,6
1713512914919,LISP 5B,A00,507671,Munoz Sanchez; Alicia,12,0,20,8
1713512915949,LISP 5C,A00,507696,Munoz Sanchez; Alicia,11,0,20,9
1713512916979,MAE 197,001,528363,Boechler; Nicholas Sebastia,9998,0,9999,1
1713512918004,MATH 197,001,523477,Kedlaya; Kiran S.,9999,0,9999,0
1713512918004,MATH 197,002,563811,Zhang; Danna,9998,0,9999,1
1713512919030,MCWP 40R,A00,518780,Staff,13,0,20,7
1713512919030,MCWP 40R,B00,518781,Staff,11,0,20,9
1713512919030,MCWP 40R,C00,518783,Staff,8,0,20,12
1713512920057,MCWP 50R,A00,518791,Staff,7,0,20,13
1713512920057,MCWP 50R,B00,518792,Staff,3,0,20,17
1713512920057,MCWP 50R,C00,518793,Staff,5,0,20,15
1713512920057,MCWP 50R,D00,518794,Staff,0,0,20,20
1713512920057,MCWP 50R,E00,518795,Staff,0,0,20,20
1713512920057,MCWP 50R,F00,518796,Staff,11,0,20,9
1713512920057,MCWP 50R,G00,518797,Staff,10,0,20,10
1713512921083,MMW 12R,A01,514034,Herbst; Matthew,1,0,16,15
1713512921083,MMW 12R,A02,514035,Herbst; Matthew,13,0,16,3
1713512922112,MMW 13R,A01,514037,Staff,0,8,16,16
1713512922112,MMW 13R,A02,514039,Staff,0,7,16,16
1713512924163,SIO 295LS,A00,523233,Staff,15,0,30,15
1713512925191,SIO 295S,A00,523232,Staff,15,0,30,15
1713512926217,SOCI 117,A01,494376,Staff,0,2,5,5
1713512927245,WES 237B,A00,494380,Staff,19,0,20,1
1713512929326,AESE 279B,A00,494370,Wade; Jon P,33,0,33,0
1713512930353,AIP 197,001,627712,Vespa; Emanuel Ignacio,9999,0,9999,0
1713512931384,ANAR 135S,A00,494369,Braswell; Geoffrey E.,0,0,0,0
1713512932410,CAT 124RS,A01,519847,Geibel; William,6,0,20,14
1713512933437,CAT 125RS,A01,515971,Geibel; William,6,0,20,14
1713512934465,CLRE 250,A00,511389,Morris; Sheldon,9996,0,9999,3
1713512935544,CLRE 251,A00,507176,Mehta; Ravindra L.,9996,0,9999,3
1713512935544,CLRE 251,B00,511410,Mehta; Ravindra L.,9998,0,9999,1
1713512936571,CLRE 252,A00,507189,Cuomo; Raphael Eduardo,9998,0,9999,1
1713512937630,CLRE 253,A00,507199,Vaida; Florin,9997,0,9999,2
1713512937630,CLRE 253,B00,507202,Vaida; Florin,9999,0,9999,0
1713512938659,CLRE 259,A00,507211,Patel; Hemal,9996,0,9999,3
1713512939684,CLRE 260,A00,507221,Cuomo; Raphael Eduardo,9999,0,9999,0
1713512940720,CLRE 297,001,507242,Cuomo; Raphael Eduardo,9999,0,9999,0
1713512941749,CSE 191,A00,516875,Minnes Kemp; Mor Mia,9999,0,9999,0
1713512942777,CSS 201S,A01,494383,Staff,35,0,35,0
1713512943803,CSS 202S,A01,494387,Staff,35,0,35,0
1713512944832,EAP 100,A00,516065,Staff,9792,0,9999,207
1713512945862,ECE 45,A01,507414,Staff,37,0,60,23
1713512946889,ECE 100,A01,507416,Baghdadchi; Saharnaz,0,0,20,20
1713512946889,ECE 100,A02,507418,Baghdadchi; Saharnaz,19,0,20,1
1713512947917,ECE 111,A01,507420,Staff,27,0,50,23
1713512948944,ECE 197,001,548057,Sievenpiper; Daniel F.,9998,0,9999,1
1713512949971,EDS 115,A00,507243,Choi; Bailey Miyeon,27,0,28,1
1713512951000,EDS 117,A01,494379,Staff,15,0,25,10
1713512952028,EDS 125,A00,507246,Hopkins; Megan Beth,27,0,30,3
1713512953056,EDS 128A,A01,507264,Fargason; Sharon Gayle,26,0,26,0
1713512954080,EDS 128B,A01,507293,Pappas; Elizabeth,30,0,30,0
1713512955114,EDS 139,A00,507294,Fargason; Sharon Gayle,30,0,30,0
1713512955114,EDS 139,B00,507313,Pappas; Elizabeth,30,0,30,0
1713512956194,EDS 201,A00,507315,Staff,18,0,30,12
1713512957221,EDS 203,A01,507317,Halter; Christopher P.,17,0,30,13
1713512958248,EDS 204R,A01,507319,Halter; Christopher P.,0,1,30,30
1713512958248,EDS 204R,B01,507331,Heinzman; Erica M.,22,0,30,8
1713512959277,EDS 206R,A00,507332,Staff,0,2,30,30
1713512959277,EDS 206R,B00,507343,Staff,23,0,30,7
1713512960305,EDS 250,A00,507344,Hemans; Patricia Ann Benitez,27,0,40,13
1713512961330,EDS 281,A00,507345,Daly; Alan J.,18,0,18,0
1713512962356,EDS 284,A00,507350,Daly; Alan J.,16,0,16,0
1713512963385,EDS 286,A00,507359,Fine; Sarah,18,0,18,0
1713512964410,EDS 289C,A01,507361,Daly; Alan J.,18,0,18,0
1713512965440,EDS 290,A00,507366,Hofstetter; Carolyn,15,0,15,0
1713512966468,LIGM 5A,A00,507421,Fischer-Grunski; Eva K,20,0,20,0
1713512967500,LIGM 5B,A00,507423,Fischer-Grunski; Eva K,20,0,20,0
1713512968527,LIGM 5C,A00,507425,Fischer-Grunski; Eva K,20,0,20,0
1713512969554,LIIT 5AS,A00,507427,Carnelos; Chiara,20,0,20,0
1713512970582,LIIT 5BS,A00,507430,Carnelos; Chiara,20,0,20,0
1713512971608,LIIT 5CS,A00,507432,Carnelos; Chiara,20,0,20,0
1713512972637,LISP 5A,A00,507541,Munoz Sanchez; Alicia,14,0,20,6
1713512973666,LISP 5B,A00,507671,Munoz Sanchez; Alicia,12,0,20,8
1713512974695,LISP 5C,A00,507696,Munoz Sanchez; Alicia,11,0,20,9
1713512975724,MAE 197,001,528363,Boechler; Nicholas Sebastia,9998,0,9999,1
1713512976750,MATH 197,001,523477,Kedlaya; Kiran S.,9999,0,9999,0
1713512976750,MATH 197,002,563811,Zhang; Danna,9998,0,9999,1
1713512977781,MCWP 40R,A00,518780,Staff,13,0,20,7
1713512977781,MCWP 40R,B00,518781,Staff,11,0,20,9
1713512977781,MCWP 40R,C00,518783,Staff,8,0,20,12
1713512978806,MCWP 50R,A00,518791,Staff,7,0,20,13
1713512978806,MCWP 50R,B00,518792,Staff,3,0,20,17
1713512978806,MCWP 50R,C00,518793,Staff,5,0,20,15
1713512978806,MCWP 50R,D00,518794,Staff,0,0,20,20
1713512978806,MCWP 50R,E00,518795,Staff,0,0,20,20
1713512978806,MCWP 50R,F00,518796,Staff,11,0,20,9
1713512978806,MCWP 50R,G00,518797,Staff,10,0,20,10
1713512979830,MMW 12R,A01,514034,Herbst; Matthew,1,0,16,15
1713512979830,MMW 12R,A02,514035,Herbst; Matthew,13,0,16,3
1713512980858,MMW 13R,A01,514037,Staff,0,8,16,16
1713512980858,MMW 13R,A02,514039,Staff,0,7,16,16
1713512982913,SIO 295LS,A00,523233,Staff,15,0,30,15
1713512983942,SIO 295S,A00,523232,Staff,15,0,30,15
1713512984966,SOCI 117,A01,494376,Staff,0,2,5,5
1713512985995,WES 237B,A00,494380,Staff,19,0,20,1
1713512988066,AESE 279B,A00,494370,Wade; Jon P,33,0,33,0
1713512989092,AIP 197,001,627712,Vespa; Emanuel Ignacio,9999,0,9999,0
1713512990121,ANAR 135S,A00,494369,Braswell; Geoffrey E.,0,0,0,0
1713512991150,CAT 124RS,A01,519847,Geibel; William,6,0,20,14
1713512992182,CAT 125RS,A01,515971,Geibel; William,6,0,20,14
1713512993211,CLRE 250,A00,511389,Morris; Sheldon,9996,0,9999,3
1713512994241,CLRE 251,A00,507176,Mehta; Ravindra L.,9996,0,9999,3
1713512994241,CLRE 251,B00,511410,Mehta; Ravindra L.,9998,0,9999,1
1713512995270,CLRE 252,A00,507189,Cuomo; Raphael Eduardo,9998,0,9999,1
1713512996296,CLRE 253,A00,507199,Vaida; Florin,9997,0,9999,2
1713512996296,CLRE 253,B00,507202,Vaida; Florin,9999,0,9999,0
1713512997325,CLRE 259,A00,507211,Patel; Hemal,9996,0,9999,3
1713512998352,CLRE 260,A00,507221,Cuomo; Raphael Eduardo,9999,0,9999,0
1713512999381,CLRE 297,001,507242,Cuomo; Raphael Eduardo,9999,0,9999,0
1713513000407,CSE 191,A00,516875,Minnes Kemp; Mor Mia,9999,0,9999,0
1713513001432,CSS 201S,A01,494383,Staff,35,0,35,0
1713513002458,CSS 202S,A01,494387,Staff,35,0,35,0
1713513003482,EAP 100,A00,516065,Staff,9792,0,9999,207
1713513004507,ECE 45,A01,507414,Staff,37,0,60,23
1713513005534,ECE 100,A01,507416,Baghdadchi; Saharnaz,0,0,20,20
1713513005534,ECE 100,A02,507418,Baghdadchi; Saharnaz,19,0,20,1
1713513006559,ECE 111,A01,507420,Staff,27,0,50,23
1713513007583,ECE 197,001,548057,Sievenpiper; Daniel F.,9998,0,9999,1
1713513008619,EDS 115,A00,507243,Choi; Bailey Miyeon,27,0,28,1
1713513009645,EDS 117,A01,494379,Staff,15,0,25,10
1713513010680,EDS 125,A00,507246,Hopkins; Megan Beth,27,0,30,3
1713513011710,EDS 128A,A01,507264,Fargason; Sharon Gayle,26,0,26,0
1713513012736,EDS 128B,A01,507293,Pappas; Elizabeth,30,0,30,0
1713513013761,EDS 139,A00,507294,Fargason; Sharon Gayle,30,0,30,0
1713513013761,EDS 139,B00,507313,Pappas; Elizabeth,30,0,30,0
1713513014786,EDS 201,A00,507315,Staff,18,0,30,12
1713513015818,EDS 203,A01,507317,Halter; Christopher P.,17,0,30,13
1713513016844,EDS 204R,A01,507319,Halter; Christopher P.,0,1,30,30
1713513016844,EDS 204R,B01,507331,Heinzman; Erica M.,22,0,30,8
1713513017875,EDS 206R,A00,507332,Staff,0,2,30,30
1713513017875,EDS 206R,B00,507343,Staff,23,0,30,7
1713513018902,EDS 250,A00,507344,Hemans; Patricia Ann Benitez,27,0,40,13
1713513019932,EDS 281,A00,507345,Daly; Alan J.,18,0,18,0
1713513020958,EDS 284,A00,507350,Daly; Alan J.,16,0,16,0
1713513021988,EDS 286,A00,507359,Fine; Sarah,18,0,18,0
1713513023014,EDS 289C,A01,507361,Daly; Alan J.,18,0,18,0
1713513024044,EDS 290,A00,507366,Hofstetter; Carolyn,15,0,15,0
1713513025074,LIGM 5A,A00,507421,Fischer-Grunski; Eva K,20,0,20,0
1713513026105,LIGM 5B,A00,507423,Fischer-Grunski; Eva K,20,0,20,0
1713513027132,LIGM 5C,A00,507425,Fischer-Grunski; Eva K,20,0,20,0
1713513028164,LIIT 5AS,A00,507427,Carnelos; Chiara,20,0,20,0
1713513029194,LIIT 5BS,A00,507430,Carnelos; Chiara,20,0,20,0
1713513030221,LIIT 5CS,A00,507432,Carnelos; Chiara,20,0,20,0
1713513031252,LISP 5A,A00,507541,Munoz Sanchez; Alicia,14,0,20,6
1713513032277,LISP 5B,A00,507671,Munoz Sanchez; Alicia,12,0,20,8
1713513033307,LISP 5C,A00,507696,Munoz Sanchez; Alicia,11,0,20,9
1713513034335,MAE 197,001,528363,Boechler; Nicholas Sebastia,9998,0,9999,1
1713513035363,MATH 197,001,523477,Kedlaya; Kiran S.,9999,0,9999,0
1713513035363,MATH 197,002,563811,Zhang; Danna,9998,0,9999,1
1713513036393,MCWP 40R,A00,518780,Staff,13,0,20,7
1713513036393,MCWP 40R,B00,518781,Staff,11,0,20,9
1713513036393,MCWP 40R,C00,518783,Staff,8,0,20,12
1713513037420,MCWP 50R,A00,518791,Staff,7,0,20,13
1713513037420,MCWP 50R,B00,518792,Staff,3,0,20,17
1713513037420,MCWP 50R,C00,518793,Staff,5,0,20,15
1713513037420,MCWP 50R,D00,518794,Staff,0,0,20,20
1713513037420,MCWP 50R,E00,518795,Staff,0,0,20,20
1713513037420,MCWP 50R,F00,518796,Staff,11,0,20,9
1713513037420,MCWP 50R,G00,518797,Staff,10,0,20,10
1713513038447,MMW 12R,A01,514034,Herbst; Matthew,1,0,16,15
1713513038447,MMW 12R,A02,514035,Herbst; Matthew,13,0,16,3
1713513039479,MMW 13R,A01,514037,Staff,0,8,16,16
1713513039479,MMW 13R,A02,514039,Staff,0,7,16,16
1713513041549,SIO 295LS,A00,523233,Staff,15,0,30,15
1713513042575,SIO 295S,A00,523232,Staff,15,0,30,15
1713513043610,SOCI 117,A01,494376,Staff,0,2,5,5
1713513044639,WES 237B,A00,494380,Staff,19,0,20,1
1713513047745,AESE 279B,A00,494370,Wade; Jon P,33,0,33,0
1713513048770,AIP 197,001,627712,Vespa; Emanuel Ignacio,9999,0,9999,0
1713513049794,ANAR 135S,A00,494369,Braswell; Geoffrey E.,0,0,0,0
1713513050820,CAT 124RS,A01,519847,Geibel; William,6,0,20,14
1713513051846,CAT 125RS,A01,515971,Geibel; William,6,0,20,14
1713513052875,CLRE 250,A00,511389,Morris; Sheldon,9996,0,9999,3
1713513053901,CLRE 251,A00,507176,Mehta; Ravindra L.,9996,0,9999,3
1713513053901,CLRE 251,B00,511410,Mehta; Ravindra L.,9998,0,9999,1
1713513054927,CLRE 252,A00,507189,Cuomo; Raphael Eduardo,9998,0,9999,1
1713513055953,CLRE 253,A00,507199,Vaida; Florin,9997,0,9999,2
1713513055953,CLRE 253,B00,507202,Vaida; Florin,9999,0,9999,0
1713513056980,CLRE 259,A00,507211,Patel; Hemal,9996,0,9999,3
1713513058005,CLRE 260,A00,507221,Cuomo; Raphael Eduardo,9999,0,9999,0
1713513059029,CLRE 297,001,507242,Cuomo; Raphael Eduardo,9999,0,9999,0
1713513060058,CSE 191,A00,516875,Minnes Kemp; Mor Mia,9999,0,9999,0
1713513061138,CSS 201S,A01,494383,Staff,35,0,35,0
1713513062169,CSS 202S,A01,494387,Staff,35,0,35,0
1713513063198,EAP 100,A00,516065,Staff,9792,0,9999,207
1713513064224,ECE 45,A01,507414,Staff,37,0,60,23
1713513065250,ECE 100,A01,507416,Baghdadchi; Saharnaz,0,0,20,20
1713513065250,ECE 100,A02,507418,Baghdadchi; Saharnaz,19,0,20,1
1713513066275,ECE 111,A01,507420,Staff,27,0,50,23
1713513067299,ECE 197,001,548057,Sievenpiper; Daniel F.,9998,0,9999,1
1713513068330,EDS 115,A00,507243,Choi; Bailey Miyeon,27,0,28,1
1713513069359,EDS 117,A01,494379,Staff,15,0,25,10
1713513070388,EDS 125,A00,507246,Hopkins; Megan Beth,27,0,30,3
1713513071417,EDS 128A,A01,507264,Fargason; Sharon Gayle,26,0,26,0
1713513072443,EDS 128B,A01,507293,Pappas; Elizabeth,30,0,30,0
1713513073472,EDS 139,A00,507294,Fargason; Sharon Gayle,30,0,30,0
1713513073472,EDS 139,B00,507313,Pappas; Elizabeth,30,0,30,0
1713513074497,EDS 201,A00,507315,Staff,18,0,30,12
1713513075523,EDS 203,A01,507317,Halter; Christopher P.,17,0,30,13
1713513076550,EDS 204R,A01,507319,Halter; Christopher P.,0,1,30,30
1713513076550,EDS 204R,B01,507331,Heinzman; Erica M.,22,0,30,8
1713513077575,EDS 206R,A00,507332,Staff,0,2,30,30
1713513077575,EDS 206R,B00,507343,Staff,23,0,30,7
1713513078606,EDS 250,A00,507344,Hemans; Patricia Ann Benitez,27,0,40,13
1713513079634,EDS 281,A00,507345,Daly; Alan J.,18,0,18,0
1713513080660,EDS 284,A00,507350,Daly; Alan J.,16,0,16,0
1713513081688,EDS 286,A00,507359,Fine; Sarah,18,0,18,0
1713513082714,EDS 289C,A01,507361,Daly; Alan J.,18,0,18,0
1713513083743,EDS 290,A00,507366,Hofstetter; Carolyn,15,0,15,0
1713513084769,LIGM 5A,A00,507421,Fischer-Grunski; Eva K,20,0,20,0
1713513085794,LIGM 5B,A00,507423,Fischer-Grunski; Eva K,20,0,20,0
1713513086829,LIGM 5C,A00,507425,Fischer-Grunski; Eva K,20,0,20,0
1713513087855,LIIT 5AS,A00,507427,Carnelos; Chiara,20,0,20,0
1713513088882,LIIT 5BS,A00,507430,Carnelos; Chiara,20,0,20,0
1713513089908,LIIT 5CS,A00,507432,Carnelos; Chiara,20,0,20,0
1713513090938,LISP 5A,A00,507541,Munoz Sanchez; Alicia,14,0,20,6
1713513091971,LISP 5B,A00,507671,Munoz Sanchez; Alicia,12,0,20,8
1713513093000,LISP 5C,A00,507696,Munoz Sanchez; Alicia,11,0,20,9
1713513094026,MAE 197,001,528363,Boechler; Nicholas Sebastia,9998,0,9999,1
1713513095052,MATH 197,001,523477,Kedlaya; Kiran S.,9999,0,9999,0
1713513095052,MATH 197,002,563811,Zhang; Danna,9998,0,9999,1
1713513096078,MCWP 40R,A00,518780,Staff,13,0,20,7
1713513096078,MCWP 40R,B00,518781,Staff,11,0,20,9
1713513096078,MCWP 40R,C00,518783,Staff,8,0,20,12
1713513097116,MCWP 50R,A00,518791,Staff,7,0,20,13
1713513097116,MCWP 50R,B00,518792,Staff,3,0,20,17
1713513097116,MCWP 50R,C00,518793,Staff,5,0,20,15
1713513097116,MCWP 50R,D00,518794,Staff,0,0,20,20
1713513097116,MCWP 50R,E00,518795,Staff,0,0,20,20
1713513097116,MCWP 50R,F00,518796,Staff,10,0,20,10
1713513097116,MCWP 50R,G00,518797,Staff,10,0,20,10
1713513098142,MMW 12R,A01,514034,Herbst; Matthew,1,0,16,15
1713513098142,MMW 12R,A02,514035,Herbst; Matthew,13,0,16,3
1713513099169,MMW 13R,A01,514037,Staff,0,8,16,16
1713513099169,MMW 13R,A02,514039,Staff,0,7,16,16
1713513101223,SIO 295LS,A00,523233,Staff,15,0,30,15
1713513102252,SIO 295S,A00,523232,Staff,15,0,30,15
1713513103278,SOCI 117,A01,494376,Staff,0,2,5,5
1713513104304,WES 237B,A00,494380,Staff,19,0,20,1
1713513106370,AESE 279B,A00,494370,Wade; Jon P,33,0,33,0
1713513107396,AIP 197,001,627712,Vespa; Emanuel Ignacio,9999,0,9999,0
1713513108423,ANAR 135S,A00,494369,Braswell; Geoffrey E.,0,0,0,0
1713513109450,CAT 124RS,A01,519847,Geibel; William,6,0,20,14
1713513110479,CAT 125RS,A01,515971,Geibel; William,6,0,20,14
1713513111505,CLRE 250,A00,511389,Morris; Sheldon,9996,0,9999,3
1713513112532,CLRE 251,A00,507176,Mehta; Ravindra L.,9996,0,9999,3
1713513112532,CLRE 251,B00,511410,Mehta; Ravindra L.,9998,0,9999,1
1713513113559,CLRE 252,A00,507189,Cuomo; Raphael Eduardo,9998,0,9999,1
1713513114588,CLRE 253,A00,507199,Vaida; Florin,9997,0,9999,2
1713513114588,CLRE 253,B00,507202,Vaida; Florin,9999,0,9999,0
1713513115612,CLRE 259,A00,507211,Patel; Hemal,9996,0,9999,3
1713513116640,CLRE 260,A00,507221,Cuomo; Raphael Eduardo,9999,0,9999,0
1713513117669,CLRE 297,001,507242,Cuomo; Raphael Eduardo,9999,0,9999,0
1713513118696,CSE 191,A00,516875,Minnes Kemp; Mor Mia,9999,0,9999,0
1713513119727,CSS 201S,A01,494383,Staff,35,0,35,0
1713513120754,CSS 202S,A01,494387,Staff,35,0,35,0
1713513121779,EAP 100,A00,516065,Staff,9792,0,9999,207
1713513122806,ECE 45,A01,507414,Staff,37,0,60,23
1713513123835,ECE 100,A01,507416,Baghdadchi; Saharnaz,0,0,20,20
1713513123835,ECE 100,A02,507418,Baghdadchi; Saharnaz,19,0,20,1
1713513124862,ECE 111,A01,507420,Staff,27,0,50,23
1713513125887,ECE 197,001,548057,Sievenpiper; Daniel F.,9998,0,9999,1
1713513126914,EDS 115,A00,507243,Choi; Bailey Miyeon,27,0,28,1
1713513127941,EDS 117,A01,494379,Staff,15,0,25,10
1713513128971,EDS 125,A00,507246,Hopkins; Megan Beth,27,0,30,3
1713513130001,EDS 128A,A01,507264,Fargason; Sharon Gayle,26,0,26,0
1713513131030,EDS 128B,A01,507293,Pappas; Elizabeth,30,0,30,0
1713513132054,EDS 139,A00,507294,Fargason; Sharon Gayle,30,0,30,0
1713513132054,EDS 139,B00,507313,Pappas; Elizabeth,30,0,30,0
1713513133088,EDS 201,A00,507315,Staff,18,0,30,12
1713513134115,EDS 203,A01,507317,Halter; Christopher P.,17,0,30,13
1713513135142,EDS 204R,A01,507319,Halter; Christopher P.,0,1,30,30
1713513135142,EDS 204R,B01,507331,Heinzman; Erica M.,22,0,30,8
1713513136171,EDS 206R,A00,507332,Staff,0,2,30,30
1713513136171,EDS 206R,B00,507343,Staff,23,0,30,7
1713513137196,EDS 250,A00,507344,Hemans; Patricia Ann Benitez,27,0,40,13
1713513138222,EDS 281,A00,507345,Daly; Alan J.,18,0,18,0
1713513139249,EDS 284,A00,507350,Daly; Alan J.,16,0,16,0
1713513140274,EDS 286,A00,507359,Fine; Sarah,18,0,18,0
1713513141303,EDS 289C,A01,507361,Daly; Alan J.,18,0,18,0
1713513142331,EDS 290,A00,507366,Hofstetter; Carolyn,15,0,15,0
1713513143361,LIGM 5A,A00,507421,Fischer-Grunski; Eva K,20,0,20,0
1713513144388,LIGM 5B,A00,507423,Fischer-Grunski; Eva K,20,0,20,0
1713513145420,LIGM 5C,A00,507425,Fischer-Grunski; Eva K,20,0,20,0
1713513146445,LIIT 5AS,A00,507427,Carnelos; Chiara,20,0,20,0
1713513147475,LIIT 5BS,A00,507430,Carnelos; Chiara,20,0,20,0
1713513148501,LIIT 5CS,A00,507432,Carnelos; Chiara,20,0,20,0
1713513149526,LISP 5A,A00,507541,Munoz Sanchez; Alicia,14,0,20,6
1713513150557,LISP 5B,A00,507671,Munoz Sanchez; Alicia,12,0,20,8
1713513151587,LISP 5C,A00,507696,Munoz Sanchez; Alicia,11,0,20,9
1713513152615,MAE 197,001,528363,Boechler; Nicholas Sebastia,9998,0,9999,1
1713513153644,MATH 197,001,523477,Kedlaya; Kiran S.,9999,0,9999,0
1713513153644,MATH 197,002,563811,Zhang; Danna,9998,0,9999,1
1713513154673,MCWP 40R,A00,518780,Staff,13,0,20,7
1713513154673,MCWP 40R,B00,518781,Staff,11,0,20,9
1713513154673,MCWP 40R,C00,518783,Staff,8,0,20,12
1713513155703,MCWP 50R,A00,518791,Staff,7,0,20,13
1713513155703,MCWP 50R,B00,518792,Staff,3,0,20,17
1713513155703,MCWP 50R,C00,518793,Staff,5,0,20,15
1713513155703,MCWP 50R,D00,518794,Staff,0,0,20,20
1713513155703,MCWP 50R,E00,518795,Staff,0,0,20,20
1713513155703,MCWP 50R,F00,518796,Staff,10,0,20,10
1713513155703,MCWP 50R,G00,518797,Staff,10,0,20,10
1713513156731,MMW 12R,A01,514034,Herbst; Matthew,1,0,16,15
1713513156731,MMW 12R,A02,514035,Herbst; Matthew,13,0,16,3
1713513157757,MMW 13R,A01,514037,Staff,0,8,16,16
1713513157757,MMW 13R,A02,514039,Staff,0,7,16,16
1713513159815,SIO 295LS,A00,523233,Staff,15,0,30,15
1713513160884,SIO 295S,A00,523232,Staff,15,0,30,15
1713513161911,SOCI 117,A01,494376,Staff,0,2,5,5
1713513162937,WES 237B,A00,494380,Staff,19,0,20,1
1713513165064,AESE 279B,A00,494370,Wade; Jon P,33,0,33,0
1713513166094,AIP 197,001,627712,Vespa; Emanuel Ignacio,9999,0,9999,0
1713513167119,ANAR 135S,A00,494369,Braswell; Geoffrey E.,0,0,0,0
1713513168144,CAT 124RS,A01,519847,Geibel; William,6,0,20,14
1713513169170,CAT 125RS,A01,515971,Geibel; William,6,0,20,14
1713513170197,CLRE 250,A00,511389,Morris; Sheldon,9996,0,9999,3
1713513171226,CLRE 251,A00,507176,Mehta; Ravindra L.,9996,0,9999,3
1713513171226,CLRE 251,B00,511410,Mehta; Ravindra L.,9998,0,9999,1
1713513172252,CLRE 252,A00,507189,Cuomo; Raphael Eduardo,9998,0,9999,1
1713513173278,CLRE 253,A00,507199,Vaida; Florin,9997,0,9999,2
1713513173278,CLRE 253,B00,507202,Vaida; Florin,9999,0,9999,0
1713513174307,CLRE 259,A00,507211,Patel; Hemal,9996,0,9999,3
1713513175338,CLRE 260,A00,507221,Cuomo; Raphael Eduardo,9999,0,9999,0
1713513176364,CLRE 297,001,507242,Cuomo; Raphael Eduardo,9999,0,9999,0
1713513177388,CSE 191,A00,516875,Minnes Kemp; Mor Mia,9999,0,9999,0
1713513178418,CSS 201S,A01,494383,Staff,35,0,35,0
1713513179445,CSS 202S,A01,494387,Staff,35,0,35,0
1713513180471,EAP 100,A00,516065,Staff,9792,0,9999,207
1713513181500,ECE 45,A01,507414,Staff,37,0,60,23
1713513182526,ECE 100,A01,507416,Baghdadchi; Saharnaz,0,0,20,20
1713513182526,ECE 100,A02,507418,Baghdadchi; Saharnaz,19,0,20,1
1713513183557,ECE 111,A01,507420,Staff,27,0,50,23
1713513184583,ECE 197,001,548057,Sievenpiper; Daniel F.,9998,0,9999,1
1713513185611,EDS 115,A00,507243,Choi; Bailey Miyeon,27,0,28,1
1713513186641,EDS 117,A01,494379,Staff,15,0,25,10
1713513187666,EDS 125,A00,507246,Hopkins; Megan Beth,27,0,30,3
1713513188693,EDS 128A,A01,507264,Fargason; Sharon Gayle,26,0,26,0
1713513189720,EDS 128B,A01,507293,Pappas; Elizabeth,30,0,30,0
1713513190755,EDS 139,A00,507294,Fargason; Sharon Gayle,30,0,30,0
1713513190755,EDS 139,B00,507313,Pappas; Elizabeth,30,0,30,0
1713513191784,EDS 201,A00,507315,Staff,18,0,30,12
1713513192813,EDS 203,A01,507317,Halter; Christopher P.,17,0,30,13
1713513193840,EDS 204R,A01,507319,Halter; Christopher P.,0,1,30,30
1713513193840,EDS 204R,B01,507331,Heinzman; Erica M.,22,0,30,8
1713513194867,EDS 206R,A00,507332,Staff,0,2,30,30
1713513194867,EDS 206R,B00,507343,Staff,23,0,30,7
1713513195893,EDS 250,A00,507344,Hemans; Patricia Ann Benitez,27,0,40,13
1713513196916,EDS 281,A00,507345,Daly; Alan J.,18,0,18,0
1713513197945,EDS 284,A00,507350,Daly; Alan J.,16,0,16,0
1713513198972,EDS 286,A00,507359,Fine; Sarah,18,0,18,0
1713513199996,EDS 289C,A01,507361,Daly; Alan J.,18,0,18,0
1713513201022,EDS 290,A00,507366,Hofstetter; Carolyn,15,0,15,0
1713513202048,LIGM 5A,A00,507421,Fischer-Grunski; Eva K,20,0,20,0
1713513203077,LIGM 5B,A00,507423,Fischer-Grunski; Eva K,20,0,20,0
1713513204109,LIGM 5C,A00,507425,Fischer-Grunski; Eva K,20,0,20,0
1713513205135,LIIT 5AS,A00,507427,Carnelos; Chiara,20,0,20,0
1713513206165,LIIT 5BS,A00,507430,Carnelos; Chiara,20,0,20,0
1713513207193,LIIT 5CS,A00,507432,Carnelos; Chiara,20,0,20,0
1713513208224,LISP 5A,A00,507541,Munoz Sanchez; Alicia,14,0,20,6
1713513209251,LISP 5B,A00,507671,Munoz Sanchez; Alicia,12,0,20,8
1713513210278,LISP 5C,A00,507696,Munoz Sanchez; Alicia,11,0,20,9
1713513211303,MAE 197,001,528363,Boechler; Nicholas Sebastia,9998,0,9999,1
1713513212330,MATH 197,001,523477,Kedlaya; Kiran S.,9999,0,9999,0
1713513212330,MATH 197,002,563811,Zhang; Danna,9998,0,9999,1
1713513213356,MCWP 40R,A00,518780,Staff,13,0,20,7
1713513213356,MCWP 40R,B00,518781,Staff,11,0,20,9
1713513213356,MCWP 40R,C00,518783,Staff,8,0,20,12
1713513214388,MCWP 50R,A00,518791,Staff,7,0,20,13
1713513214388,MCWP 50R,B00,518792,Staff,3,0,20,17
1713513214388,MCWP 50R,C00,518793,Staff,5,0,20,15
1713513214388,MCWP 50R,D00,518794,Staff,0,0,20,20
1713513214388,MCWP 50R,E00,518795,Staff,0,0,20,20
1713513214388,MCWP 50R,F00,518796,Staff,10,0,20,10
1713513214388,MCWP 50R,G00,518797,Staff,10,0,20,10
1713513215417,MMW 12R,A01,514034,Herbst; Matthew,1,0,16,15
1713513215417,MMW 12R,A02,514035,Herbst; Matthew,13,0,16,3
1713513216447,MMW 13R,A01,514037,Staff,0,8,16,16
1713513216447,MMW 13R,A02,514039,Staff,0,7,16,16
1713513218498,SIO 295LS,A00,523233,Staff,15,0,30,15
1713513219524,SIO 295S,A00,523232,Staff,15,0,30,15
1713513220549,SOCI 117,A01,494376,Staff,0,2,5,5
1713513221575,WES 237B,A00,494380,Staff,19,0,20,1
1713513223668,AESE 279B,A00,494370,Wade; Jon P,33,0,33,0
1713513224696,AIP 197,001,627712,Vespa; Emanuel Ignacio,9999,0,9999,0
1713513225723,ANAR 135S,A00,494369,Braswell; Geoffrey E.,0,0,0,0
1713513226751,CAT 124RS,A01,519847,Geibel; William,6,0,20,14
1713513227782,CAT 125RS,A01,515971,Geibel; William,6,0,20,14
1713513228811,CLRE 250,A00,511389,Morris; Sheldon,9996,0,9999,3
1713513229836,CLRE 251,A00,507176,Mehta; Ravindra L.,9996,0,9999,3
1713513229836,CLRE 251,B00,511410,Mehta; Ravindra L.,9998,0,9999,1
1713513230863,CLRE 252,A00,507189,Cuomo; Raphael Eduardo,9998,0,9999,1
1713513231889,CLRE 253,A00,507199,Vaida; Florin,9997,0,9999,2
1713513231889,CLRE 253,B00,507202,Vaida; Florin,9999,0,9999,0
1713513232914,CLRE 259,A00,507211,Patel; Hemal,9996,0,9999,3
1713513233944,CLRE 260,A00,507221,Cuomo; Raphael Eduardo,9999,0,9999,0
1713513234970,CLRE 297,001,507242,Cuomo; Raphael Eduardo,9999,0,9999,0
1713513235995,CSE 191,A00,516875,Minnes Kemp; Mor Mia,9999,0,9999,0
1713513237026,CSS 201S,A01,494383,Staff,35,0,35,0
1713513238053,CSS 202S,A01,494387,Staff,35,0,35,0
1713513239085,EAP 100,A00,516065,Staff,9792,0,9999,207
1713513240115,ECE 45,A01,507414,Staff,37,0,60,23
1713513241148,ECE 100,A01,507416,Baghdadchi; Saharnaz,0,0,20,20
1713513241148,ECE 100,A02,507418,Baghdadchi; Saharnaz,19,0,20,1
1713513242173,ECE 111,A01,507420,Staff,27,0,50,23
1713513243198,ECE 197,001,548057,Sievenpiper; Daniel F.,9998,0,9999,1
1713513244225,EDS 115,A00,507243,Choi; Bailey Miyeon,27,0,28,1
1713513245251,EDS 117,A01,494379,Staff,15,0,25,10
1713513246278,EDS 125,A00,507246,Hopkins; Megan Beth,27,0,30,3
1713513247302,EDS 128A,A01,507264,Fargason; Sharon Gayle,26,0,26,0
1713513248332,EDS 128B,A01,507293,Pappas; Elizabeth,30,0,30,0
1713513249362,EDS 139,A00,507294,Fargason; Sharon Gayle,30,0,30,0
1713513249362,EDS 139,B00,507313,Pappas; Elizabeth,30,0,30,0
1713513250392,EDS 201,A00,507315,Staff,18,0,30,12
1713513251419,EDS 203,A01,507317,Halter; Christopher P.,17,0,30,13
1713513252445,EDS 204R,A01,507319,Halter; Christopher P.,0,1,30,30
1713513252445,EDS 204R,B01,507331,Heinzman; Erica M.,22,0,30,8
1713513253474,EDS 206R,A00,507332,Staff,0,2,30,30
1713513253474,EDS 206R,B00,507343,Staff,23,0,30,7
1713513254501,EDS 250,A00,507344,Hemans; Patricia Ann Benitez,27,0,40,13
1713513255531,EDS 281,A00,507345,Daly; Alan J.,18,0,18,0
1713513256555,EDS 284,A00,507350,Daly; Alan J.,16,0,16,0
1713513257584,EDS 286,A00,507359,Fine; Sarah,18,0,18,0
1713513258612,EDS 289C,A01,507361,Daly; Alan J.,18,0,18,0
1713513259638,EDS 290,A00,507366,Hofstetter; Carolyn,15,0,15,0
1713513260668,LIGM 5A,A00,507421,Fischer-Grunski; Eva K,20,0,20,0
1713513261699,LIGM 5B,A00,507423,Fischer-Grunski; Eva K,20,0,20,0
1713513262725,LIGM 5C,A00,507425,Fischer-Grunski; Eva K,20,0,20,0
1713513263751,LIIT 5AS,A00,507427,Carnelos; Chiara,20,0,20,0
1713513264777,LIIT 5BS,A00,507430,Carnelos; Chiara,20,0,20,0
1713513265804,LIIT 5CS,A00,507432,Carnelos; Chiara,20,0,20,0
1713513266833,LISP 5A,A00,507541,Munoz Sanchez; Alicia,14,0,20,6
1713513267861,LISP 5B,A00,507671,Munoz Sanchez; Alicia,12,0,20,8
1713513268943,LISP 5C,A00,507696,Munoz Sanchez; Alicia,11,0,20,9
1713513269968,MAE 197,001,528363,Boechler; Nicholas Sebastia,9998,0,9999,1
1713513270996,MATH 197,001,523477,Kedlaya; Kiran S.,9999,0,9999,0
1713513270996,MATH 197,002,563811,Zhang; Danna,9998,0,9999,1
1713513272028,MCWP 40R,A00,518780,Staff,13,0,20,7
1713513272028,MCWP 40R,B00,518781,Staff,11,0,20,9
1713513272028,MCWP 40R,C00,518783,Staff,8,0,20,12
1713513273056,MCWP 50R,A00,518791,Staff,7,0,20,13
1713513273056,MCWP 50R,B00,518792,Staff,3,0,20,17
1713513273056,MCWP 50R,C00,518793,Staff,5,0,20,15
1713513273056,MCWP 50R,D00,518794,Staff,0,0,20,20
1713513273056,MCWP 50R,E00,518795,Staff,0,0,20,20
1713513273056,MCWP 50R,F00,518796,Staff,10,0,20,10
1713513273056,MCWP 50R,G00,518797,Staff,10,0,20,10
1713513274082,MMW 12R,A01,514034,Herbst; Matthew,1,0,16,15
1713513274082,MMW 12R,A02,514035,Herbst; Matthew,13,0,16,3
1713513275112,MMW 13R,A01,514037,Staff,0,8,16,16
1713513275112,MMW 13R,A02,514039,Staff,0,7,16,16
1713513277168,SIO 295LS,A00,523233,Staff,15,0,30,15
1713513278193,SIO 295S,A00,523232,Staff,15,0,30,15
1713513279221,SOCI 117,A01,494376,Staff,0,2,5,5
1713513280250,WES 237B,A00,494380,Staff,19,0,20,1
1713513282314,AESE 279B,A00,494370,Wade; Jon P,33,0,33,0
1713513283340,AIP 197,001,627712,Vespa; Emanuel Ignacio,9999,0,9999,0
1713513284366,ANAR 135S,A00,494369,Braswell; Geoffrey E.,0,0,0,0
1713513285391,CAT 124RS,A01,519847,Geibel; William,6,0,20,14
1713513286421,CAT 125RS,A01,515971,Geibel; William,6,0,20,14
1713513287447,CLRE 250,A00,511389,Morris; Sheldon,9996,0,9999,3
1713513288473,CLRE 251,A00,507176,Mehta; Ravindra L.,9996,0,9999,3
1713513288473,CLRE 251,B00,511410,Mehta; Ravindra L.,9998,0,9999,1
1713513289497,CLRE 252,A00,507189,Cuomo; Raphael Eduardo,9998,0,9999,1
1713513290529,CLRE 253,A00,507199,Vaida; Florin,9997,0,9999,2
1713513290529,CLRE 253,B00,507202,Vaida; Florin,9999,0,9999,0
1713513291554,CLRE 259,A00,507211,Patel; Hemal,9996,0,9999,3
1713513292582,CLRE 260,A00,507221,Cuomo; Raphael Eduardo,9999,0,9999,0
1713513293612,CLRE 297,001,507242,Cuomo; Raphael Eduardo,9999,0,9999,0
1713513294638,CSE 191,A00,516875,Minnes Kemp; Mor Mia,9999,0,9999,0
1713513295663,CSS 201S,A01,494383,Staff,35,0,35,0
1713513296690,CSS 202S,A01,494387,Staff,35,0,35,0
1713513297716,EAP 100,A00,516065,Staff,9792,0,9999,207
1713513298742,ECE 45,A01,507414,Staff,37,0,60,23
1713513299767,ECE 100,A01,507416,Baghdadchi; Saharnaz,0,0,20,20
1713513299767,ECE 100,A02,507418,Baghdadchi; Saharnaz,19,0,20,1
1713513300795,ECE 111,A01,507420,Staff,27,0,50,23
1713513301822,ECE 197,001,548057,Sievenpiper; Daniel F.,9998,0,9999,1
1713513302849,EDS 115,A00,507243,Choi; Bailey Miyeon,27,0,28,1
1713513303876,EDS 117,A01,494379,Staff,15,0,25,10
1713513304901,EDS 125,A00,507246,Hopkins; Megan Beth,27,0,30,3
1713513305928,EDS 128A,A01,507264,Fargason; Sharon Gayle,26,0,26,0
1713513316158,EDS 128B,A01,507293,Pappas; Elizabeth,30,0,30,0
1713513317185,EDS 139,A00,507294,Fargason; Sharon Gayle,30,0,30,0
1713513317185,EDS 139,B00,507313,Pappas; Elizabeth,30,0,30,0
1713513318210,EDS 201,A00,507315,Staff,18,0,30,12
1713513319236,EDS 203,A01,507317,Halter; Christopher P.,17,0,30,13
1713513320262,EDS 204R,A01,507319,Halter; Christopher P.,0,1,30,30
1713513320262,EDS 204R,B01,507331,Heinzman; Erica M.,22,0,30,8
1713513321289,EDS 206R,A00,507332,Staff,0,2,30,30
1713513321289,EDS 206R,B00,507343,Staff,23,0,30,7
1713513322315,EDS 250,A00,507344,Hemans; Patricia Ann Benitez,27,0,40,13
1713513323342,EDS 281,A00,507345,Daly; Alan J.,18,0,18,0
1713513324372,EDS 284,A00,507350,Daly; Alan J.,16,0,16,0
1713513325402,EDS 286,A00,507359,Fine; Sarah,18,0,18,0
1713513326429,EDS 289C,A01,507361,Daly; Alan J.,18,0,18,0
1713513327457,EDS 290,A00,507366,Hofstetter; Carolyn,15,0,15,0
1713513328482,LIGM 5A,A00,507421,Fischer-Grunski; Eva K,20,0,20,0
1713513329508,LIGM 5B,A00,507423,Fischer-Grunski; Eva K,20,0,20,0
1713513330533,LIGM 5C,A00,507425,Fischer-Grunski; Eva K,20,0,20,0
1713513331560,LIIT 5AS,A00,507427,Carnelos; Chiara,20,0,20,0
1713513332591,LIIT 5BS,A00,507430,Carnelos; Chiara,20,0,20,0
1713513333621,LIIT 5CS,A00,507432,Carnelos; Chiara,20,0,20,0
1713513334647,LISP 5A,A00,507541,Munoz Sanchez; Alicia,14,0,20,6
1713513335672,LISP 5B,A00,507671,Munoz Sanchez; Alicia,12,0,20,8
1713513336699,LISP 5C,A00,507696,Munoz Sanchez; Alicia,11,0,20,9
1713513337723,MAE 197,001,528363,Boechler; Nicholas Sebastia,9998,0,9999,1
1713513338751,MATH 197,001,523477,Kedlaya; Kiran S.,9999,0,9999,0
1713513338751,MATH 197,002,563811,Zhang; Danna,9998,0,9999,1
1713513339780,MCWP 40R,A00,518780,Staff,13,0,20,7
1713513339780,MCWP 40R,B00,518781,Staff,11,0,20,9
1713513339780,MCWP 40R,C00,518783,Staff,8,0,20,12
1713513340807,MCWP 50R,A00,518791,Staff,7,0,20,13
1713513340807,MCWP 50R,B00,518792,Staff,3,0,20,17
1713513340807,MCWP 50R,C00,518793,Staff,5,0,20,15
1713513340807,MCWP 50R,D00,518794,Staff,0,0,20,20
1713513340807,MCWP 50R,E00,518795,Staff,0,0,20,20
1713513340807,MCWP 50R,F00,518796,Staff,10,0,20,10
1713513340807,MCWP 50R,G00,518797,Staff,10,0,20,10
1713513341838,MMW 12R,A01,514034,Herbst; Matthew,1,0,16,15
1713513341838,MMW 12R,A02,514035,Herbst; Matthew,13,0,16,3
1713513342862,MMW 13R,A01,514037,Staff,0,8,16,16
1713513342862,MMW 13R,A02,514039,Staff,0,7,16,16
1713513344920,SIO 295LS,A00,523233,Staff,15,0,30,15
1713513345947,SIO 295S,A00,523232,Staff,15,0,30,15
1713513346973,SOCI 117,A01,494376,Staff,0,2,5,5
1713513347997,WES 237B,A00,494380,Staff,19,0,20,1
1713513350071,AESE 279B,A00,494370,Wade; Jon P,33,0,33,0
1713513351096,AIP 197,001,627712,Vespa; Emanuel Ignacio,9999,0,9999,0
1713513352122,ANAR 135S,A00,494369,Braswell; Geoffrey E.,0,0,0,0
1713513353148,CAT 124RS,A01,519847,Geibel; William,6,0,20,14
1713513354173,CAT 125RS,A01,515971,Geibel; William,6,0,20,14
1713513355199,CLRE 250,A00,511389,Morris; Sheldon,9996,0,9999,3
1713513356228,CLRE 251,A00,507176,Mehta; Ravindra L.,9996,0,9999,3
1713513356228,CLRE 251,B00,511410,Mehta; Ravindra L.,9998,0,9999,1
1713513357258,CLRE 252,A00,507189,Cuomo; Raphael Eduardo,9998,0,9999,1
1713513358284,CLRE 253,A00,507199,Vaida; Florin,9997,0,9999,2
1713513358284,CLRE 253,B00,507202,Vaida; Florin,9999,0,9999,0
1713513359310,CLRE 259,A00,507211,Patel; Hemal,9996,0,9999,3
1713513360342,CLRE 260,A00,507221,Cuomo; Raphael Eduardo,9999,0,9999,0
1713513361375,CLRE 297,001,507242,Cuomo; Raphael Eduardo,9999,0,9999,0
1713513362404,CSE 191,A00,516875,Minnes Kemp; Mor Mia,9999,0,9999,0
1713513363430,CSS 201S,A01,494383,Staff,35,0,35,0
1713513364458,CSS 202S,A01,494387,Staff,35,0,35,0
1713513365483,EAP 100,A00,516065,Staff,9792,0,9999,207
1713513366516,ECE 45,A01,507414,Staff,37,0,60,23
1713513367550,ECE 100,A01,507416,Baghdadchi; Saharnaz,0,0,20,20
1713513367550,ECE 100,A02,507418,Baghdadchi; Saharnaz,19,0,20,1
1713513368581,ECE 111,A01,507420,Staff,27,0,50,23
1713513369611,ECE 197,001,548057,Sievenpiper; Daniel F.,9998,0,9999,1
1713513370642,EDS 115,A00,507243,Choi; Bailey Miyeon,27,0,28,1
1713513371668,EDS 117,A01,494379,Staff,15,0,25,10
1713513372692,EDS 125,A00,507246,Hopkins; Megan Beth,27,0,30,3
1713513373718,EDS 128A,A01,507264,Fargason; Sharon Gayle,26,0,26,0
1713513374744,EDS 128B,A01,507293,Pappas; Elizabeth,30,0,30,0
1713513375773,EDS 139,A00,507294,Fargason; Sharon Gayle,30,0,30,0
1713513375773,EDS 139,B00,507313,Pappas; Elizabeth,30,0,30,0
1713513376802,EDS 201,A00,507315,Staff,18,0,30,12
1713513377827,EDS 203,A01,507317,Halter; Christopher P.,17,0,30,13
1713513378854,EDS 204R,A01,507319,Halter; Christopher P.,0,1,30,30
1713513378854,EDS 204R,B01,507331,Heinzman; Erica M.,22,0,30,8
1713513379880,EDS 206R,A00,507332,Staff,0,2,30,30
1713513379880,EDS 206R,B00,507343,Staff,23,0,30,7
1713513380912,EDS 250,A00,507344,Hemans; Patricia Ann Benitez,27,0,40,13
1713513381998,EDS 281,A00,507345,Daly; Alan J.,18,0,18,0
1713513383025,EDS 284,A00,507350,Daly; Alan J.,16,0,16,0
1713513384052,EDS 286,A00,507359,Fine; Sarah,18,0,18,0
1713513385080,EDS 289C,A01,507361,Daly; Alan J.,18,0,18,0
1713513386105,EDS 290,A00,507366,Hofstetter; Carolyn,15,0,15,0
1713513387132,LIGM 5A,A00,507421,Fischer-Grunski; Eva K,20,0,20,0
1713513388158,LIGM 5B,A00,507423,Fischer-Grunski; Eva K,20,0,20,0
1713513389183,LIGM 5C,A00,507425,Fischer-Grunski; Eva K,20,0,20,0
1713513390214,LIIT 5AS,A00,507427,Carnelos; Chiara,20,0,20,0
1713513391240,LIIT 5BS,A00,507430,Carnelos; Chiara,20,0,20,0
1713513392268,LIIT 5CS,A00,507432,Carnelos; Chiara,20,0,20,0
1713513393295,LISP 5A,A00,507541,Munoz Sanchez; Alicia,14,0,20,6
1713513394321,LISP 5B,A00,507671,Munoz Sanchez; Alicia,12,0,20,8
1713513395347,LISP 5C,A00,507696,Munoz Sanchez; Alicia,11,0,20,9
1713513396372,MAE 197,001,528363,Boechler; Nicholas Sebastia,9998,0,9999,1
1713513397398,MATH 197,001,523477,Kedlaya; Kiran S.,9999,0,9999,0
1713513397398,MATH 197,002,563811,Zhang; Danna,9998,0,9999,1
1713513398429,MCWP 40R,A00,518780,Staff,13,0,20,7
1713513398429,MCWP 40R,B00,518781,Staff,11,0,20,9
1713513398429,MCWP 40R,C00,518783,Staff,8,0,20,12
1713513399458,MCWP 50R,A00,518791,Staff,7,0,20,13
1713513399458,MCWP 50R,B00,518792,Staff,3,0,20,17
1713513399458,MCWP 50R,C00,518793,Staff,5,0,20,15
1713513399458,MCWP 50R,D00,518794,Staff,0,0,20,20
1713513399458,MCWP 50R,E00,518795,Staff,0,0,20,20
1713513399458,MCWP 50R,F00,518796,Staff,10,0,20,10
1713513399458,MCWP 50R,G00,518797,Staff,10,0,20,10
1713513400489,MMW 12R,A01,514034,Herbst; Matthew,1,0,16,15
1713513400489,MMW 12R,A02,514035,Herbst; Matthew,13,0,16,3
1713513401515,MMW 13R,A01,514037,Staff,0,8,16,16
1713513401515,MMW 13R,A02,514039,Staff,0,7,16,16
1713513403565,SIO 295LS,A00,523233,Staff,15,0,30,15
1713513404594,SIO 295S,A00,523232,Staff,15,0,30,15
1713513405621,SOCI 117,A01,494376,Staff,0,2,5,5
1713513406651,WES 237B,A00,494380,Staff,19,0,20,1
1713513408726,AESE 279B,A00,494370,Wade; Jon P,33,0,33,0
1713513409751,AIP 197,001,627712,Vespa; Emanuel Ignacio,9999,0,9999,0
1713513410777,ANAR 135S,A00,494369,Braswell; Geoffrey E.,0,0,0,0
1713513411807,CAT 124RS,A01,519847,Geibel; William,6,0,20,14
1713513412836,CAT 125RS,A01,515971,Geibel; William,6,0,20,14
1713513413872,CLRE 250,A00,511389,Morris; Sheldon,9996,0,9999,3
1713513414900,CLRE 251,A00,507176,Mehta; Ravindra L.,9996,0,9999,3
1713513414900,CLRE 251,B00,511410,Mehta; Ravindra L.,9998,0,9999,1
1713513415925,CLRE 252,A00,507189,Cuomo; Raphael Eduardo,9998,0,9999,1
1713513416957,CLRE 253,A00,507199,Vaida; Florin,9997,0,9999,2
1713513416957,CLRE 253,B00,507202,Vaida; Florin,9999,0,9999,0
1713513417981,CLRE 259,A00,507211,Patel; Hemal,9996,0,9999,3
1713513419005,CLRE 260,A00,507221,Cuomo; Raphael Eduardo,9999,0,9999,0
1713513420063,CLRE 297,001,507242,Cuomo; Raphael Eduardo,9999,0,9999,0
1713513421095,CSE 191,A00,516875,Minnes Kemp; Mor Mia,9999,0,9999,0
1713513422121,CSS 201S,A01,494383,Staff,35,0,35,0
1713513423148,CSS 202S,A01,494387,Staff,35,0,35,0
1713513424176,EAP 100,A00,516065,Staff,9792,0,9999,207
1713513425202,ECE 45,A01,507414,Staff,37,0,60,23
1713513426233,ECE 100,A01,507416,Baghdadchi; Saharnaz,0,0,20,20
1713513426233,ECE 100,A02,507418,Baghdadchi; Saharnaz,19,0,20,1
1713513427257,ECE 111,A01,507420,Staff,27,0,50,23
1713513428283,ECE 197,001,548057,Sievenpiper; Daniel F.,9998,0,9999,1
1713513429307,EDS 115,A00,507243,Choi; Bailey Miyeon,27,0,28,1
1713513430338,EDS 117,A01,494379,Staff,15,0,25,10
1713513431366,EDS 125,A00,507246,Hopkins; Megan Beth,27,0,30,3
1713513432391,EDS 128A,A01,507264,Fargason; Sharon Gayle,26,0,26,0
1713513433418,EDS 128B,A01,507293,Pappas; Elizabeth,30,0,30,0
1713513434444,EDS 139,A00,507294,Fargason; Sharon Gayle,30,0,30,0
1713513434444,EDS 139,B00,507313,Pappas; Elizabeth,30,0,30,0
1713513435476,EDS 201,A00,507315,Staff,18,0,30,12
1713513436501,EDS 203,A01,507317,Halter; Christopher P.,17,0,30,13
1713513437527,EDS 204R,A01,507319,Halter; Christopher P.,0,1,30,30
1713513437527,EDS 204R,B01,507331,Heinzman; Erica M.,22,0,30,8
1713513438553,EDS 206R,A00,507332,Staff,0,2,30,30
1713513438553,EDS 206R,B00,507343,Staff,23,0,30,7
1713513439582,EDS 250,A00,507344,Hemans; Patricia Ann Benitez,27,0,40,13
1713513440610,EDS 281,A00,507345,Daly; Alan J.,18,0,18,0
1713513441634,EDS 284,A00,507350,Daly; Alan J.,16,0,16,0
1713513442659,EDS 286,A00,507359,Fine; Sarah,18,0,18,0
1713513443689,EDS 289C,A01,507361,Daly; Alan J.,18,0,18,0
1713513444714,EDS 290,A00,507366,Hofstetter; Carolyn,15,0,15,0
1713513445745,LIGM 5A,A00,507421,Fischer-Grunski; Eva K,20,0,20,0
1713513446771,LIGM 5B,A00,507423,Fischer-Grunski; Eva K,20,0,20,0
1713513447798,LIGM 5C,A00,507425,Fischer-Grunski; Eva K,20,0,20,0
1713513448823,LIIT 5AS,A00,507427,Carnelos; Chiara,20,0,20,0
1713513449849,LIIT 5BS,A00,507430,Carnelos; Chiara,20,0,20,0
1713513450875,LIIT 5CS,A00,507432,Carnelos; Chiara,20,0,20,0
1713513451908,LISP 5A,A00,507541,Munoz Sanchez; Alicia,14,0,20,6
1713513452939,LISP 5B,A00,507671,Munoz Sanchez; Alicia,12,0,20,8
1713513453966,LISP 5C,A00,507696,Munoz Sanchez; Alicia,11,0,20,9
1713513454995,MAE 197,001,528363,Boechler; Nicholas Sebastia,9998,0,9999,1
1713513456028,MATH 197,001,523477,Kedlaya; Kiran S.,9999,0,9999,0
1713513456028,MATH 197,002,563811,Zhang; Danna,9998,0,9999,1
1713513457057,MCWP 40R,A00,518780,Staff,13,0,20,7
1713513457057,MCWP 40R,B00,518781,Staff,11,0,20,9
1713513457057,MCWP 40R,C00,518783,Staff,8,0,20,12
1713513458087,MCWP 50R,A00,518791,Staff,7,0,20,13
1713513458087,MCWP 50R,B00,518792,Staff,3,0,20,17
1713513458087,MCWP 50R,C00,518793,Staff,5,0,20,15
1713513458087,MCWP 50R,D00,518794,Staff,0,0,20,20
1713513458087,MCWP 50R,E00,518795,Staff,0,0,20,20
1713513458087,MCWP 50R,F00,518796,Staff,10,0,20,10
1713513458087,MCWP 50R,G00,518797,Staff,10,0,20,10
1713513459115,MMW 12R,A01,514034,Herbst; Matthew,1,0,16,15
1713513459115,MMW 12R,A02,514035,Herbst; Matthew,13,0,16,3
1713513460143,MMW 13R,A01,514037,Staff,0,8,16,16
1713513460143,MMW 13R,A02,514039,Staff,0,7,16,16
1713513462195,SIO 295LS,A00,523233,Staff,15,0,30,15
1713513463224,SIO 295S,A00,523232,Staff,15,0,30,15
1713513464257,SOCI 117,A01,494376,Staff,0,2,5,5
1713513465284,WES 237B,A00,494380,Staff,19,0,20,1
1713513467361,AESE 279B,A00,494370,Wade; Jon P,33,0,33,0
1713513468394,AIP 197,001,627712,Vespa; Emanuel Ignacio,9999,0,9999,0
1713513469426,ANAR 135S,A00,494369,Braswell; Geoffrey E.,0,0,0,0
1713513470456,CAT 124RS,A01,519847,Geibel; William,6,0,20,14
1713513471480,CAT 125RS,A01,515971,Geibel; William,6,0,20,14
1713513472505,CLRE 250,A00,511389,Morris; Sheldon,9996,0,9999,3
1713513473531,CLRE 251,A00,507176,Mehta; Ravindra L.,9996,0,9999,3
1713513473531,CLRE 251,B00,511410,Mehta; Ravindra L.,9998,0,9999,1
1713513474556,CLRE 252,A00,507189,Cuomo; Raphael Eduardo,9998,0,9999,1
1713513475581,CLRE 253,A00,507199,Vaida; Florin,9997,0,9999,2
1713513475581,CLRE 253,B00,507202,Vaida; Florin,9999,0,9999,0
1713513476607,CLRE 259,A00,507211,Patel; Hemal,9996,0,9999,3
1713513477631,CLRE 260,A00,507221,Cuomo; Raphael Eduardo,9999,0,9999,0
1713513478656,CLRE 297,001,507242,Cuomo; Raphael Eduardo,9999,0,9999,0
1713513479682,CSE 191,A00,516875,Minnes Kemp; Mor Mia,9999,0,9999,0
1713513480714,CSS 201S,A01,494383,Staff,35,0,35,0
1713513481740,CSS 202S,A01,494387,Staff,35,0,35,0
1713513482766,EAP 100,A00,516065,Staff,9792,0,9999,207
1713513483792,ECE 45,A01,507414,Staff,37,0,60,23
1713513484819,ECE 100,A01,507416,Baghdadchi; Saharnaz,0,0,20,20
1713513484819,ECE 100,A02,507418,Baghdadchi; Saharnaz,19,0,20,1
1713513485914,ECE 111,A01,507420,Staff,27,0,50,23
1713513486944,ECE 197,001,548057,Sievenpiper; Daniel F.,9998,0,9999,1
1713513487969,EDS 115,A00,507243,Choi; Bailey Miyeon,27,0,28,1
1713513488994,EDS 117,A01,494379,Staff,15,0,25,10
1713513490023,EDS 125,A00,507246,Hopkins; Megan Beth,27,0,30,3
1713513491076,EDS 128A,A01,507264,Fargason; Sharon Gayle,26,0,26,0
1713513492107,EDS 128B,A01,507293,Pappas; Elizabeth,30,0,30,0
1713513493137,EDS 139,A00,507294,Fargason; Sharon Gayle,30,0,30,0
1713513493137,EDS 139,B00,507313,Pappas; Elizabeth,30,0,30,0
1713513494163,EDS 201,A00,507315,Staff,18,0,30,12
1713513495189,EDS 203,A01,507317,Halter; Christopher P.,17,0,30,13
1713513496216,EDS 204R,A01,507319,Halter; Christopher P.,0,1,30,30
1713513496216,EDS 204R,B01,507331,Heinzman; Erica M.,22,0,30,8
1713513497242,EDS 206R,A00,507332,Staff,0,2,30,30
1713513497242,EDS 206R,B00,507343,Staff,23,0,30,7
1713513498272,EDS 250,A00,507344,Hemans; Patricia Ann Benitez,27,0,40,13
1713513499297,EDS 281,A00,507345,Daly; Alan J.,18,0,18,0
1713513500325,EDS 284,A00,507350,Daly; Alan J.,16,0,16,0
1713513501351,EDS 286,A00,507359,Fine; Sarah,18,0,18,0
1713513502380,EDS 289C,A01,507361,Daly; Alan J.,18,0,18,0
1713513503409,EDS 290,A00,507366,Hofstetter; Carolyn,15,0,15,0
1713513504440,LIGM 5A,A00,507421,Fischer-Grunski; Eva K,20,0,20,0
1713513505471,LIGM 5B,A00,507423,Fischer-Grunski; Eva K,20,0,20,0
1713513506497,LIGM 5C,A00,507425,Fischer-Grunski; Eva K,20,0,20,0
1713513507527,LIIT 5AS,A00,507427,Carnelos; Chiara,20,0,20,0
1713513508558,LIIT 5BS,A00,507430,Carnelos; Chiara,20,0,20,0
1713513509583,LIIT 5CS,A00,507432,Carnelos; Chiara,20,0,20,0
1713513510612,LISP 5A,A00,507541,Munoz Sanchez; Alicia,14,0,20,6
1713513511642,LISP 5B,A00,507671,Munoz Sanchez; Alicia,12,0,20,8
1713513512670,LISP 5C,A00,507696,Munoz Sanchez; Alicia,11,0,20,9
1713513513696,MAE 197,001,528363,Boechler; Nicholas Sebastia,9998,0,9999,1
1713513514720,MATH 197,001,523477,Kedlaya; Kiran S.,9999,0,9999,0
1713513514720,MATH 197,002,563811,Zhang; Danna,9998,0,9999,1
1713513515746,MCWP 40R,A00,518780,Staff,13,0,20,7
1713513515746,MCWP 40R,B00,518781,Staff,11,0,20,9
1713513515746,MCWP 40R,C00,518783,Staff,8,0,20,12
1713513516772,MCWP 50R,A00,518791,Staff,7,0,20,13
1713513516772,MCWP 50R,B00,518792,Staff,3,0,20,17
1713513516772,MCWP 50R,C00,518793,Staff,5,0,20,15
1713513516772,MCWP 50R,D00,518794,Staff,0,0,20,20
1713513516772,MCWP 50R,E00,518795,Staff,0,0,20,20
1713513516772,MCWP 50R,F00,518796,Staff,10,0,20,10
1713513516772,MCWP 50R,G00,518797,Staff,10,0,20,10
1713513517798,MMW 12R,A01,514034,Herbst; Matthew,1,0,16,15
1713513517798,MMW 12R,A02,514035,Herbst; Matthew,13,0,16,3
1713513518821,MMW 13R,A01,514037,Staff,0,8,16,16
1713513518821,MMW 13R,A02,514039,Staff,0,7,16,16
1713513520876,SIO 295LS,A00,523233,Staff,15,0,30,15
1713513521905,SIO 295S,A00,523232,Staff,15,0,30,15
1713513522938,SOCI 117,A01,494376,Staff,0,2,5,5
1713513523969,WES 237B,A00,494380,Staff,19,0,20,1
1713513526043,AESE 279B,A00,494370,Wade; Jon P,33,0,33,0
1713513527069,AIP 197,001,627712,Vespa; Emanuel Ignacio,9999,0,9999,0
1713513528109,ANAR 135S,A00,494369,Braswell; Geoffrey E.,0,0,0,0
1713513529141,CAT 124RS,A01,519847,Geibel; William,6,0,20,14
1713513530171,CAT 125RS,A01,515971,Geibel; William,6,0,20,14
1713513531202,CLRE 250,A00,511389,Morris; Sheldon,9996,0,9999,3
1713513532229,CLRE 251,A00,507176,Mehta; Ravindra L.,9996,0,9999,3
1713513532229,CLRE 251,B00,511410,Mehta; Ravindra L.,9998,0,9999,1
1713513533255,CLRE 252,A00,507189,Cuomo; Raphael Eduardo,9998,0,9999,1
1713513534285,CLRE 253,A00,507199,Vaida; Florin,9997,0,9999,2
1713513534285,CLRE 253,B00,507202,Vaida; Florin,9999,0,9999,0
1713513535310,CLRE 259,A00,507211,Patel; Hemal,9996,0,9999,3
1713513536336,CLRE 260,A00,507221,Cuomo; Raphael Eduardo,9999,0,9999,0
1713513537368,CLRE 297,001,507242,Cuomo; Raphael Eduardo,9999,0,9999,0
1713513538394,CSE 191,A00,516875,Minnes Kemp; Mor Mia,9999,0,9999,0
1713513539424,CSS 201S,A01,494383,Staff,35,0,35,0
1713513540458,CSS 202S,A01,494387,Staff,35,0,35,0
1713513541484,EAP 100,A00,516065,Staff,9792,0,9999,207
1713513542510,ECE 45,A01,507414,Staff,37,0,60,23
1713513543537,ECE 100,A01,507416,Baghdadchi; Saharnaz,0,0,20,20
1713513543537,ECE 100,A02,507418,Baghdadchi; Saharnaz,19,0,20,1
1713513544563,ECE 111,A01,507420,Staff,27,0,50,23
1713513545588,ECE 197,001,548057,Sievenpiper; Daniel F.,9998,0,9999,1
1713513546615,EDS 115,A00,507243,Choi; Bailey Miyeon,27,0,28,1
1713513547642,EDS 117,A01,494379,Staff,15,0,25,10
1713513548667,EDS 125,A00,507246,Hopkins; Megan Beth,27,0,30,3
1713513549692,EDS 128A,A01,507264,Fargason; Sharon Gayle,26,0,26,0
1713513550723,EDS 128B,A01,507293,Pappas; Elizabeth,30,0,30,0
1713513551748,EDS 139,A00,507294,Fargason; Sharon Gayle,30,0,30,0
1713513551748,EDS 139,B00,507313,Pappas; Elizabeth,30,0,30,0
1713513552777,EDS 201,A00,507315,Staff,18,0,30,12
1713513553803,EDS 203,A01,507317,Halter; Christopher P.,17,0,30,13
1713513554835,EDS 204R,A01,507319,Halter; Christopher P.,0,1,30,30
1713513554835,EDS 204R,B01,507331,Heinzman; Erica M.,22,0,30,8
1713513555866,EDS 206R,A00,507332,Staff,0,2,30,30
1713513555866,EDS 206R,B00,507343,Staff,23,0,30,7
1713513556893,EDS 250,A00,507344,Hemans; Patricia Ann Benitez,27,0,40,13
1713513557918,EDS 281,A00,507345,Daly; Alan J.,18,0,18,0
1713513558948,EDS 284,A00,507350,Daly; Alan J.,16,0,16,0
1713513559974,EDS 286,A00,507359,Fine; Sarah,18,0,18,0
1713513560999,EDS 289C,A01,507361,Daly; Alan J.,18,0,18,0
1713513562029,EDS 290,A00,507366,Hofstetter; Carolyn,15,0,15,0
1713513563066,LIGM 5A,A00,507421,Fischer-Grunski; Eva K,20,0,20,0
1713513564091,LIGM 5B,A00,507423,Fischer-Grunski; Eva K,20,0,20,0
1713513565122,LIGM 5C,A00,507425,Fischer-Grunski; Eva K,20,0,20,0
1713513566182,LIIT 5AS,A00,507427,Carnelos; Chiara,20,0,20,0
1713513567207,LIIT 5BS,A00,507430,Carnelos; Chiara,20,0,20,0
1713513568252,LIIT 5CS,A00,507432,Carnelos; Chiara,20,0,20,0
1713513569278,LISP 5A,A00,507541,Munoz Sanchez; Alicia,14,0,20,6
1713513570310,LISP 5B,A00,507671,Munoz Sanchez; Alicia,12,0,20,8
1713513571335,LISP 5C,A00,507696,Munoz Sanchez; Alicia,11,0,20,9
1713513572361,MAE 197,001,528363,Boechler; Nicholas Sebastia,9998,0,9999,1
1713513573390,MATH 197,001,523477,Kedlaya; Kiran S.,9999,0,9999,0
1713513573390,MATH 197,002,563811,Zhang; Danna,9998,0,9999,1
1713513574420,MCWP 40R,A00,518780,Staff,13,0,20,7
1713513574420,MCWP 40R,B00,518781,Staff,11,0,20,9
1713513574420,MCWP 40R,C00,518783,Staff,8,0,20,12
1713513575449,MCWP 50R,A00,518791,Staff,7,0,20,13
1713513575449,MCWP 50R,B00,518792,Staff,3,0,20,17
1713513575449,MCWP 50R,C00,518793,Staff,5,0,20,15
1713513575449,MCWP 50R,D00,518794,Staff,0,0,20,20
1713513575449,MCWP 50R,E00,518795,Staff,0,0,20,20
1713513575449,MCWP 50R,F00,518796,Staff,10,0,20,10
1713513575449,MCWP 50R,G00,518797,Staff,10,0,20,10
1713513576474,MMW 12R,A01,514034,Herbst; Matthew,1,0,16,15
1713513576474,MMW 12R,A02,514035,Herbst; Matthew,13,0,16,3
1713513577500,MMW 13R,A01,514037,Staff,0,8,16,16
1713513577500,MMW 13R,A02,514039,Staff,0,7,16,16
1713513579550,SIO 295LS,A00,523233,Staff,15,0,30,15
1713513580575,SIO 295S,A00,523232,Staff,15,0,30,15
1713513581602,SOCI 117,A01,494376,Staff,0,2,5,5
1713513582628,WES 237B,A00,494380,Staff,19,0,20,1
1713513584703,AESE 279B,A00,494370,Wade; Jon P,33,0,33,0
1713513585730,AIP 197,001,627712,Vespa; Emanuel Ignacio,9999,0,9999,0
1713513586756,ANAR 135S,A00,494369,Braswell; Geoffrey E.,0,0,0,0
1713513587788,CAT 124RS,A01,519847,Geibel; William,6,0,20,14
1713513588818,CAT 125RS,A01,515971,Geibel; William,6,0,20,14
1713513589899,CLRE 250,A00,511389,Morris; Sheldon,9996,0,9999,3
1713513590925,CLRE 251,A00,507176,Mehta; Ravindra L.,9996,0,9999,3
1713513590925,CLRE 251,B00,511410,Mehta; Ravindra L.,9998,0,9999,1
1713513591955,CLRE 252,A00,507189,Cuomo; Raphael Eduardo,9998,0,9999,1
1713513592981,CLRE 253,A00,507199,Vaida; Florin,9997,0,9999,2
1713513592981,CLRE 253,B00,507202,Vaida; Florin,9999,0,9999,0
1713513594007,CLRE 259,A00,507211,Patel; Hemal,9996,0,9999,3
1713513595040,CLRE 260,A00,507221,Cuomo; Raphael Eduardo,9999,0,9999,0
1713513596066,CLRE 297,001,507242,Cuomo; Raphael Eduardo,9999,0,9999,0
1713513597093,CSE 191,A00,516875,Minnes Kemp; Mor Mia,9999,0,9999,0
1713513598120,CSS 201S,A01,494383,Staff,35,0,35,0
1713513599151,CSS 202S,A01,494387,Staff,35,0,35,0
1713513600178,EAP 100,A00,516065,Staff,9792,0,9999,207
1713513601207,ECE 45,A01,507414,Staff,37,0,60,23
1713513602240,ECE 100,A01,507416,Baghdadchi; Saharnaz,0,0,20,20
1713513602240,ECE 100,A02,507418,Baghdadchi; Saharnaz,19,0,20,1
1713513603265,ECE 111,A01,507420,Staff,27,0,50,23
1713513604291,ECE 197,001,548057,Sievenpiper; Daniel F.,9998,0,9999,1
1713513605318,EDS 115,A00,507243,Choi; Bailey Miyeon,27,0,28,1
1713513606348,EDS 117,A01,494379,Staff,15,0,25,10
1713513607374,EDS 125,A00,507246,Hopkins; Megan Beth,27,0,30,3
1713513608400,EDS 128A,A01,507264,Fargason; Sharon Gayle,26,0,26,0
1713513609432,EDS 128B,A01,507293,Pappas; Elizabeth,30,0,30,0
1713513610457,EDS 139,A00,507294,Fargason; Sharon Gayle,30,0,30,0
1713513610457,EDS 139,B00,507313,Pappas; Elizabeth,30,0,30,0
1713513611489,EDS 201,A00,507315,Staff,18,0,30,12
1713513612515,EDS 203,A01,507317,Halter; Christopher P.,17,0,30,13
1713513613541,EDS 204R,A01,507319,Halter; Christopher P.,0,1,30,30
1713513613541,EDS 204R,B01,507331,Heinzman; Erica M.,22,0,30,8
1713513614573,EDS 206R,A00,507332,Staff,0,2,30,30
1713513614573,EDS 206R,B00,507343,Staff,23,0,30,7
1713513615599,EDS 250,A00,507344,Hemans; Patricia Ann Benitez,27,0,40,13
1713513616630,EDS 281,A00,507345,Daly; Alan J.,18,0,18,0
1713513617658,EDS 284,A00,507350,Daly; Alan J.,16,0,16,0
1713513618689,EDS 286,A00,507359,Fine; Sarah,18,0,18,0
1713513619713,EDS 289C,A01,507361,Daly; Alan J.,18,0,18,0
1713513620747,EDS 290,A00,507366,Hofstetter; Carolyn,15,0,15,0
1713513621781,LIGM 5A,A00,507421,Fischer-Grunski; Eva K,20,0,20,0
1713513622806,LIGM 5B,A00,507423,Fischer-Grunski; Eva K,20,0,20,0
1713513623843,LIGM 5C,A00,507425,Fischer-Grunski; Eva K,20,0,20,0
1713513624869,LIIT 5AS,A00,507427,Carnelos; Chiara,20,0,20,0
1713513625901,LIIT 5BS,A00,507430,Carnelos; Chiara,20,0,20,0
1713513626931,LIIT 5CS,A00,507432,Carnelos; Chiara,20,0,20,0
1713513627958,LISP 5A,A00,507541,Munoz Sanchez; Alicia,14,0,20,6
1713513628988,LISP 5B,A00,507671,Munoz Sanchez; Alicia,12,0,20,8
1713513630019,LISP 5C,A00,507696,Munoz Sanchez; Alicia,11,0,20,9
1713513631045,MAE 197,001,528363,Boechler; Nicholas Sebastia,9998,0,9999,1
1713513632071,MATH 197,001,523477,Kedlaya; Kiran S.,9999,0,9999,0
1713513632071,MATH 197,002,563811,Zhang; Danna,9998,0,9999,1
1713513633098,MCWP 40R,A00,518780,Staff,13,0,20,7
1713513633098,MCWP 40R,B00,518781,Staff,11,0,20,9
1713513633098,MCWP 40R,C00,518783,Staff,8,0,20,12
1713513634133,MCWP 50R,A00,518791,Staff,7,0,20,13
1713513634133,MCWP 50R,B00,518792,Staff,3,0,20,17
1713513634133,MCWP 50R,C00,518793,Staff,5,0,20,15
1713513634133,MCWP 50R,D00,518794,Staff,0,0,20,20
1713513634133,MCWP 50R,E00,518795,Staff,0,0,20,20
1713513634133,MCWP 50R,F00,518796,Staff,10,0,20,10
1713513634133,MCWP 50R,G00,518797,Staff,10,0,20,10
1713513635160,MMW 12R,A01,514034,Herbst; Matthew,1,0,16,15
1713513635160,MMW 12R,A02,514035,Herbst; Matthew,13,0,16,3
1713513636184,MMW 13R,A01,514037,Staff,0,8,16,16
1713513636184,MMW 13R,A02,514039,Staff,0,7,16,16
1713513638239,SIO 295LS,A00,523233,Staff,15,0,30,15
1713513639265,SIO 295S,A00,523232,Staff,15,0,30,15
1713513640294,SOCI 117,A01,494376,Staff,0,2,5,5
1713513641322,WES 237B,A00,494380,Staff,19,0,20,1
1713513643394,AESE 279B,A00,494370,Wade; Jon P,33,0,33,0
1713513644429,AIP 197,001,627712,Vespa; Emanuel Ignacio,9999,0,9999,0
1713513645456,ANAR 135S,A00,494369,Braswell; Geoffrey E.,0,0,0,0
1713513646481,CAT 124RS,A01,519847,Geibel; William,6,0,20,14
1713513647506,CAT 125RS,A01,515971,Geibel; William,6,0,20,14
1713513648533,CLRE 250,A00,511389,Morris; Sheldon,9996,0,9999,3
1713513649558,CLRE 251,A00,507176,Mehta; Ravindra L.,9996,0,9999,3
1713513649558,CLRE 251,B00,511410,Mehta; Ravindra L.,9998,0,9999,1
1713513650590,CLRE 252,A00,507189,Cuomo; Raphael Eduardo,9998,0,9999,1
1713513651623,CLRE 253,A00,507199,Vaida; Florin,9997,0,9999,2
1713513651623,CLRE 253,B00,507202,Vaida; Florin,9999,0,9999,0
1713513652652,CLRE 259,A00,507211,Patel; Hemal,9996,0,9999,3
1713513653679,CLRE 260,A00,507221,Cuomo; Raphael Eduardo,9999,0,9999,0
1713513654723,CLRE 297,001,507242,Cuomo; Raphael Eduardo,9999,0,9999,0
1713513655749,CSE 191,A00,516875,Minnes Kemp; Mor Mia,9999,0,9999,0
1713513656777,CSS 201S,A01,494383,Staff,35,0,35,0
1713513657805,CSS 202S,A01,494387,Staff,35,0,35,0
1713513658833,EAP 100,A00,516065,Staff,9792,0,9999,207
1713513659859,ECE 45,A01,507414,Staff,37,0,60,23
1713513660887,ECE 100,A01,507416,Baghdadchi; Saharnaz,0,0,20,20
1713513660887,ECE 100,A02,507418,Baghdadchi; Saharnaz,19,0,20,1
1713513661911,ECE 111,A01,507420,Staff,27,0,50,23
1713513662937,ECE 197,001,548057,Sievenpiper; Daniel F.,9998,0,9999,1
1713513663967,EDS 115,A00,507243,Choi; Bailey Miyeon,27,0,28,1
1713513665000,EDS 117,A01,494379,Staff,15,0,25,10
1713513666029,EDS 125,A00,507246,Hopkins; Megan Beth,27,0,30,3
1713513667056,EDS 128A,A01,507264,Fargason; Sharon Gayle,26,0,26,0
1713513668087,EDS 128B,A01,507293,Pappas; Elizabeth,30,0,30,0
1713513669117,EDS 139,A00,507294,Fargason; Sharon Gayle,30,0,30,0
1713513669117,EDS 139,B00,507313,Pappas; Elizabeth,30,0,30,0
1713513670142,EDS 201,A00,507315,Staff,18,0,30,12
1713513671175,EDS 203,A01,507317,Halter; Christopher P.,17,0,30,13
1713513672206,EDS 204R,A01,507319,Halter; Christopher P.,0,1,30,30
1713513672206,EDS 204R,B01,507331,Heinzman; Erica M.,22,0,30,8
1713513673236,EDS 206R,A00,507332,Staff,0,2,30,30
1713513673236,EDS 206R,B00,507343,Staff,23,0,30,7
1713513674264,EDS 250,A00,507344,Hemans; Patricia Ann Benitez,27,0,40,13
1713513675290,EDS 281,A00,507345,Daly; Alan J.,18,0,18,0
1713513676321,EDS 284,A00,507350,Daly; Alan J.,16,0,16,0
1713513677346,EDS 286,A00,507359,Fine; Sarah,18,0,18,0
1713513678376,EDS 289C,A01,507361,Daly; Alan J.,18,0,18,0
1713513679404,EDS 290,A00,507366,Hofstetter; Carolyn,15,0,15,0
1713513680435,LIGM 5A,A00,507421,Fischer-Grunski; Eva K,20,0,20,0
1713513681461,LIGM 5B,A00,507423,Fischer-Grunski; Eva K,20,0,20,0
1713513682486,LIGM 5C,A00,507425,Fischer-Grunski; Eva K,20,0,20,0
1713513683510,LIIT 5AS,A00,507427,Carnelos; Chiara,20,0,20,0
1713513684541,LIIT 5BS,A00,507430,Carnelos; Chiara,20,0,20,0
1713513685572,LIIT 5CS,A00,507432,Carnelos; Chiara,20,0,20,0
1713513686600,LISP 5A,A00,507541,Munoz Sanchez; Alicia,14,0,20,6
1713513687626,LISP 5B,A00,507671,Munoz Sanchez; Alicia,12,0,20,8
1713513688650,LISP 5C,A00,507696,Munoz Sanchez; Alicia,11,0,20,9
1713513689676,MAE 197,001,528363,Boechler; Nicholas Sebastia,9998,0,9999,1
1713513690702,MATH 197,001,523477,Kedlaya; Kiran S.,9999,0,9999,0
1713513690702,MATH 197,002,563811,Zhang; Danna,9998,0,9999,1
1713513691733,MCWP 40R,A00,518780,Staff,13,0,20,7
1713513691733,MCWP 40R,B00,518781,Staff,11,0,20,9
1713513691733,MCWP 40R,C00,518783,Staff,8,0,20,12
1713513692761,MCWP 50R,A00,518791,Staff,7,0,20,13
1713513692761,MCWP 50R,B00,518792,Staff,3,0,20,17
1713513692761,MCWP 50R,C00,518793,Staff,5,0,20,15
1713513692761,MCWP 50R,D00,518794,Staff,0,0,20,20
1713513692761,MCWP 50R,E00,518795,Staff,0,0,20,20
1713513692761,MCWP 50R,F00,518796,Staff,10,0,20,10
1713513692761,MCWP 50R,G00,518797,Staff,10,0,20,10
1713513693855,MMW 12R,A01,514034,Herbst; Matthew,1,0,16,15
1713513693855,MMW 12R,A02,514035,Herbst; Matthew,13,0,16,3
1713513694882,MMW 13R,A01,514037,Staff,0,8,16,16
1713513694882,MMW 13R,A02,514039,Staff,0,7,16,16
1713513696935,SIO 295LS,A00,523233,Staff,15,0,30,15
1713513697967,SIO 295S,A00,523232,Staff,15,0,30,15
1713513698999,SOCI 117,A01,494376,Staff,0,2,5,5
1713513700031,WES 237B,A00,494380,Staff,19,0,20,1
1713513702130,AESE 279B,A00,494370,Wade; Jon P,33,0,33,0
1713513703155,AIP 197,001,627712,Vespa; Emanuel Ignacio,9999,0,9999,0
1713513704179,ANAR 135S,A00,494369,Braswell; Geoffrey E.,0,0,0,0
1713513705210,CAT 124RS,A01,519847,Geibel; William,6,0,20,14
1713513706239,CAT 125RS,A01,515971,Geibel; William,6,0,20,14
1713513707264,CLRE 250,A00,511389,Morris; Sheldon,9996,0,9999,3
1713513708291,CLRE 251,A00,507176,Mehta; Ravindra L.,9996,0,9999,3
1713513708291,CLRE 251,B00,511410,Mehta; Ravindra L.,9998,0,9999,1
1713513709319,CLRE 252,A00,507189,Cuomo; Raphael Eduardo,9998,0,9999,1
1713513710348,CLRE 253,A00,507199,Vaida; Florin,9997,0,9999,2
1713513710348,CLRE 253,B00,507202,Vaida; Florin,9999,0,9999,0
1713513711373,CLRE 259,A00,507211,Patel; Hemal,9996,0,9999,3
1713513712397,CLRE 260,A00,507221,Cuomo; Raphael Eduardo,9999,0,9999,0
1713513713422,CLRE 297,001,507242,Cuomo; Raphael Eduardo,9999,0,9999,0
1713513714450,CSE 191,A00,516875,Minnes Kemp; Mor Mia,9999,0,9999,0
1713513715476,CSS 201S,A01,494383,Staff,35,0,35,0
1713513716506,CSS 202S,A01,494387,Staff,35,0,35,0
1713513717534,EAP 100,A00,516065,Staff,9792,0,9999,207
1713513718564,ECE 45,A01,507414,Staff,37,0,60,23
1713513719590,ECE 100,A01,507416,Baghdadchi; Saharnaz,0,0,20,20
1713513719590,ECE 100,A02,507418,Baghdadchi; Saharnaz,19,0,20,1
1713513720620,ECE 111,A01,507420,Staff,27,0,50,23
1713513721649,ECE 197,001,548057,Sievenpiper; Daniel F.,9998,0,9999,1
1713513722675,EDS 115,A00,507243,Choi; Bailey Miyeon,27,0,28,1
1713513723720,EDS 117,A01,494379,Staff,15,0,25,10
1713513724748,EDS 125,A00,507246,Hopkins; Megan Beth,27,0,30,3
1713513725773,EDS 128A,A01,507264,Fargason; Sharon Gayle,26,0,26,0
1713513726796,EDS 128B,A01,507293,Pappas; Elizabeth,30,0,30,0
1713513727822,EDS 139,A00,507294,Fargason; Sharon Gayle,30,0,30,0
1713513727822,EDS 139,B00,507313,Pappas; Elizabeth,30,0,30,0
1713513728845,EDS 201,A00,507315,Staff,18,0,30,12
1713513729872,EDS 203,A01,507317,Halter; Christopher P.,17,0,30,13
1713513730898,EDS 204R,A01,507319,Halter; Christopher P.,0,1,30,30
1713513730898,EDS 204R,B01,507331,Heinzman; Erica M.,22,0,30,8
1713513731927,EDS 206R,A00,507332,Staff,0,2,30,30
1713513731927,EDS 206R,B00,507343,Staff,23,0,30,7
1713513732954,EDS 250,A00,507344,Hemans; Patricia Ann Benitez,27,0,40,13
1713513733982,EDS 281,A00,507345,Daly; Alan J.,18,0,18,0
1713513735007,EDS 284,A00,507350,Daly; Alan J.,16,0,16,0
1713513736034,EDS 286,A00,507359,Fine; Sarah,18,0,18,0
1713513737059,EDS 289C,A01,507361,Daly; Alan J.,18,0,18,0
1713513738084,EDS 290,A00,507366,Hofstetter; Carolyn,15,0,15,0
1713513739117,LIGM 5A,A00,507421,Fischer-Grunski; Eva K,20,0,20,0
1713513740142,LIGM 5B,A00,507423,Fischer-Grunski; Eva K,20,0,20,0
1713513741167,LIGM 5C,A00,507425,Fischer-Grunski; Eva K,20,0,20,0
1713513742197,LIIT 5AS,A00,507427,Carnelos; Chiara,20,0,20,0
1713513743228,LIIT 5BS,A00,507430,Carnelos; Chiara,20,0,20,0
1713513744259,LIIT 5CS,A00,507432,Carnelos; Chiara,20,0,20,0
1713513745286,LISP 5A,A00,507541,Munoz Sanchez; Alicia,14,0,20,6
1713513746312,LISP 5B,A00,507671,Munoz Sanchez; Alicia,12,0,20,8
1713513747342,LISP 5C,A00,507696,Munoz Sanchez; Alicia,11,0,20,9
1713513748371,MAE 197,001,528363,Boechler; Nicholas Sebastia,9998,0,9999,1
1713513749397,MATH 197,001,523477,Kedlaya; Kiran S.,9999,0,9999,0
1713513749397,MATH 197,002,563811,Zhang; Danna,9998,0,9999,1
1713513750427,MCWP 40R,A00,518780,Staff,13,0,20,7
1713513750427,MCWP 40R,B00,518781,Staff,11,0,20,9
1713513750427,MCWP 40R,C00,518783,Staff,8,0,20,12
1713513751455,MCWP 50R,A00,518791,Staff,7,0,20,13
1713513751455,MCWP 50R,B00,518792,Staff,3,0,20,17
1713513751455,MCWP 50R,C00,518793,Staff,5,0,20,15
1713513751455,MCWP 50R,D00,518794,Staff,0,0,20,20
1713513751455,MCWP 50R,E00,518795,Staff,0,0,20,20
1713513751455,MCWP 50R,F00,518796,Staff,10,0,20,10
1713513751455,MCWP 50R,G00,518797,Staff,10,0,20,10
1713513752480,MMW 12R,A01,514034,Herbst; Matthew,1,0,16,15
1713513752480,MMW 12R,A02,514035,Herbst; Matthew,13,0,16,3
1713513753505,MMW 13R,A01,514037,Staff,0,8,16,16
1713513753505,MMW 13R,A02,514039,Staff,0,7,16,16
1713513755559,SIO 295LS,A00,523233,Staff,15,0,30,15
1713513756584,SIO 295S,A00,523232,Staff,15,0,30,15
1713513757607,SOCI 117,A01,494376,Staff,0,2,5,5
1713513758633,WES 237B,A00,494380,Staff,19,0,20,1
1713513760703,AESE 279B,A00,494370,Wade; Jon P,33,0,33,0
1713513761730,AIP 197,001,627712,Vespa; Emanuel Ignacio,9999,0,9999,0
1713513762759,ANAR 135S,A00,494369,Braswell; Geoffrey E.,0,0,0,0
1713513763790,CAT 124RS,A01,519847,Geibel; William,6,0,20,14
1713513764815,CAT 125RS,A01,515971,Geibel; William,6,0,20,14
1713513765840,CLRE 250,A00,511389,Morris; Sheldon,9996,0,9999,3
1713513766873,CLRE 251,A00,507176,Mehta; Ravindra L.,9996,0,9999,3
1713513766873,CLRE 251,B00,511410,Mehta; Ravindra L.,9998,0,9999,1
1713513767900,CLRE 252,A00,507189,Cuomo; Raphael Eduardo,9998,0,9999,1
1713513768930,CLRE 253,A00,507199,Vaida; Florin,9997,0,9999,2
1713513768930,CLRE 253,B00,507202,Vaida; Florin,9999,0,9999,0
1713513769955,CLRE 259,A00,507211,Patel; Hemal,9996,0,9999,3
1713513770981,CLRE 260,A00,507221,Cuomo; Raphael Eduardo,9999,0,9999,0
1713513772006,CLRE 297,001,507242,Cuomo; Raphael Eduardo,9999,0,9999,0
1713513773035,CSE 191,A00,516875,Minnes Kemp; Mor Mia,9999,0,9999,0
1713513774065,CSS 201S,A01,494383,Staff,35,0,35,0
1713513775091,CSS 202S,A01,494387,Staff,35,0,35,0
1713513776120,EAP 100,A00,516065,Staff,9792,0,9999,207
1713513777146,ECE 45,A01,507414,Staff,37,0,60,23
1713513778175,ECE 100,A01,507416,Baghdadchi; Saharnaz,0,0,20,20
1713513778175,ECE 100,A02,507418,Baghdadchi; Saharnaz,19,0,20,1
1713513779202,ECE 111,A01,507420,Staff,27,0,50,23
1713513780228,ECE 197,001,548057,Sievenpiper; Daniel F.,9998,0,9999,1
1713513781258,EDS 115,A00,507243,Choi; Bailey Miyeon,27,0,28,1
1713513782284,EDS 117,A01,494379,Staff,15,0,25,10
1713513783317,EDS 125,A00,507246,Hopkins; Megan Beth,27,0,30,3
1713513784342,EDS 128A,A01,507264,Fargason; Sharon Gayle,26,0,26,0
1713513785371,EDS 128B,A01,507293,Pappas; Elizabeth,30,0,30,0
1713513786400,EDS 139,A00,507294,Fargason; Sharon Gayle,30,0,30,0
1713513786400,EDS 139,B00,507313,Pappas; Elizabeth,30,0,30,0
1713513787424,EDS 201,A00,507315,Staff,18,0,30,12
1713513788455,EDS 203,A01,507317,Halter; Christopher P.,17,0,30,13
1713513789486,EDS 204R,A01,507319,Halter; Christopher P.,0,1,30,30
1713513789486,EDS 204R,B01,507331,Heinzman; Erica M.,22,0,30,8
1713513790512,EDS 206R,A00,507332,Staff,0,2,30,30
1713513790512,EDS 206R,B00,507343,Staff,23,0,30,7
1713513791539,EDS 250,A00,507344,Hemans; Patricia Ann Benitez,27,0,40,13
1713513792569,EDS 281,A00,507345,Daly; Alan J.,18,0,18,0
1713513793596,EDS 284,A00,507350,Daly; Alan J.,16,0,16,0
1713513794623,EDS 286,A00,507359,Fine; Sarah,18,0,18,0
1713513795652,EDS 289C,A01,507361,Daly; Alan J.,18,0,18,0
1713513796678,EDS 290,A00,507366,Hofstetter; Carolyn,15,0,15,0
1713513797761,LIGM 5A,A00,507421,Fischer-Grunski; Eva K,20,0,20,0
1713513798788,LIGM 5B,A00,507423,Fischer-Grunski; Eva K,20,0,20,0
1713513799847,LIGM 5C,A00,507425,Fischer-Grunski; Eva K,20,0,20,0
1713513800872,LIIT 5AS,A00,507427,Carnelos; Chiara,20,0,20,0
1713513801897,LIIT 5BS,A00,507430,Carnelos; Chiara,20,0,20,0
1713513802923,LIIT 5CS,A00,507432,Carnelos; Chiara,20,0,20,0
1713513803953,LISP 5A,A00,507541,Munoz Sanchez; Alicia,14,0,20,6
1713513804999,LISP 5B,A00,507671,Munoz Sanchez; Alicia,12,0,20,8
1713513806025,LISP 5C,A00,507696,Munoz Sanchez; Alicia,11,0,20,9
1713513807051,MAE 197,001,528363,Boechler; Nicholas Sebastia,9998,0,9999,1
1713513808085,MATH 197,001,523477,Kedlaya; Kiran S.,9999,0,9999,0
1713513808085,MATH 197,002,563811,Zhang; Danna,9998,0,9999,1
1713513809115,MCWP 40R,A00,518780,Staff,13,0,20,7
1713513809115,MCWP 40R,B00,518781,Staff,11,0,20,9
1713513809115,MCWP 40R,C00,518783,Staff,8,0,20,12
1713513810141,MCWP 50R,A00,518791,Staff,7,0,20,13
1713513810141,MCWP 50R,B00,518792,Staff,3,0,20,17
1713513810141,MCWP 50R,C00,518793,Staff,5,0,20,15
1713513810141,MCWP 50R,D00,518794,Staff,0,0,20,20
1713513810141,MCWP 50R,E00,518795,Staff,0,0,20,20
1713513810141,MCWP 50R,F00,518796,Staff,10,0,20,10
1713513810141,MCWP 50R,G00,518797,Staff,10,0,20,10
1713513811172,MMW 12R,A01,514034,Herbst; Matthew,1,0,16,15
1713513811172,MMW 12R,A02,514035,Herbst; Matthew,13,0,16,3
1713513812201,MMW 13R,A01,514037,Staff,0,8,16,16
1713513812201,MMW 13R,A02,514039,Staff,0,7,16,16
1713513814254,SIO 295LS,A00,523233,Staff,15,0,30,15
1713513815284,SIO 295S,A00,523232,Staff,15,0,30,15
1713513816311,SOCI 117,A01,494376,Staff,0,2,5,5
1713513817335,WES 237B,A00,494380,Staff,19,0,20,1
1713513819413,AESE 279B,A00,494370,Wade; Jon P,33,0,33,0
1713513820442,AIP 197,001,627712,Vespa; Emanuel Ignacio,9999,0,9999,0
1713513821466,ANAR 135S,A00,494369,Braswell; Geoffrey E.,0,0,0,0
1713513822491,CAT 124RS,A01,519847,Geibel; William,6,0,20,14
1713513823520,CAT 125RS,A01,515971,Geibel; William,6,0,20,14
1713513824549,CLRE 250,A00,511389,Morris; Sheldon,9996,0,9999,3
1713513825575,CLRE 251,A00,507176,Mehta; Ravindra L.,9996,0,9999,3
1713513825575,CLRE 251,B00,511410,Mehta; Ravindra L.,9998,0,9999,1
1713513826601,CLRE 252,A00,507189,Cuomo; Raphael Eduardo,9998,0,9999,1
1713513827631,CLRE 253,A00,507199,Vaida; Florin,9997,0,9999,2
1713513827631,CLRE 253,B00,507202,Vaida; Florin,9999,0,9999,0
1713513828662,CLRE 259,A00,507211,Patel; Hemal,9996,0,9999,3
1713513829687,CLRE 260,A00,507221,Cuomo; Raphael Eduardo,9999,0,9999,0
1713513830713,CLRE 297,001,507242,Cuomo; Raphael Eduardo,9999,0,9999,0
1713513831739,CSE 191,A00,516875,Minnes Kemp; Mor Mia,9999,0,9999,0
1713513832771,CSS 201S,A01,494383,Staff,35,0,35,0
1713513833797,CSS 202S,A01,494387,Staff,35,0,35,0
1713513834822,EAP 100,A00,516065,Staff,9792,0,9999,207
1713513835849,ECE 45,A01,507414,Staff,37,0,60,23
1713513836878,ECE 100,A01,507416,Baghdadchi; Saharnaz,0,0,20,20
1713513836878,ECE 100,A02,507418,Baghdadchi; Saharnaz,19,0,20,1
1713513837904,ECE 111,A01,507420,Staff,27,0,50,23
1713513838934,ECE 197,001,548057,Sievenpiper; Daniel F.,9998,0,9999,1
1713513839959,EDS 115,A00,507243,Choi; Bailey Miyeon,27,0,28,1
1713513840985,EDS 117,A01,494379,Staff,15,0,25,10
1713513842014,EDS 125,A00,507246,Hopkins; Megan Beth,27,0,30,3
1713513843045,EDS 128A,A01,507264,Fargason; Sharon Gayle,26,0,26,0
1713513844075,EDS 128B,A01,507293,Pappas; Elizabeth,30,0,30,0
1713513845099,EDS 139,A00,507294,Fargason; Sharon Gayle,30,0,30,0
1713513845099,EDS 139,B00,507313,Pappas; Elizabeth,30,0,30,0
1713513846123,EDS 201,A00,507315,Staff,18,0,30,12
1713513847148,EDS 203,A01,507317,Halter; Christopher P.,17,0,30,13
1713513848183,EDS 204R,A01,507319,Halter; Christopher P.,0,1,30,30
1713513848183,EDS 204R,B01,507331,Heinzman; Erica M.,22,0,30,8
1713513849213,EDS 206R,A00,507332,Staff,0,2,30,30
1713513849213,EDS 206R,B00,507343,Staff,23,0,30,7
1713513850242,EDS 250,A00,507344,Hemans; Patricia Ann Benitez,27,0,40,13
1713513851267,EDS 281,A00,507345,Daly; Alan J.,18,0,18,0
1713513852292,EDS 284,A00,507350,Daly; Alan J.,16,0,16,0
1713513853323,EDS 286,A00,507359,Fine; Sarah,18,0,18,0
1713513854350,EDS 289C,A01,507361,Daly; Alan J.,18,0,18,0
1713513855375,EDS 290,A00,507366,Hofstetter; Carolyn,15,0,15,0
1713513856401,LIGM 5A,A00,507421,Fischer-Grunski; Eva K,20,0,20,0
1713513857425,LIGM 5B,A00,507423,Fischer-Grunski; Eva K,20,0,20,0
1713513858451,LIGM 5C,A00,507425,Fischer-Grunski; Eva K,20,0,20,0
1713513859476,LIIT 5AS,A00,507427,Carnelos; Chiara,20,0,20,0
1713513860507,LIIT 5BS,A00,507430,Carnelos; Chiara,20,0,20,0
1713513861538,LIIT 5CS,A00,507432,Carnelos; Chiara,20,0,20,0
1713513862571,LISP 5A,A00,507541,Munoz Sanchez; Alicia,14,0,20,6
1713513863602,LISP 5B,A00,507671,Munoz Sanchez; Alicia,12,0,20,8
1713513864628,LISP 5C,A00,507696,Munoz Sanchez; Alicia,11,0,20,9
1713513865660,MAE 197,001,528363,Boechler; Nicholas Sebastia,9998,0,9999,1
1713513866691,MATH 197,001,523477,Kedlaya; Kiran S.,9999,0,9999,0
1713513866691,MATH 197,002,563811,Zhang; Danna,9998,0,9999,1
1713513867716,MCWP 40R,A00,518780,Staff,13,0,20,7
1713513867716,MCWP 40R,B00,518781,Staff,11,0,20,9
1713513867716,MCWP 40R,C00,518783,Staff,8,0,20,12
1713513868742,MCWP 50R,A00,518791,Staff,7,0,20,13
1713513868742,MCWP 50R,B00,518792,Staff,3,0,20,17
1713513868742,MCWP 50R,C00,518793,Staff,5,0,20,15
1713513868742,MCWP 50R,D00,518794,Staff,0,0,20,20
1713513868742,MCWP 50R,E00,518795,Staff,0,0,20,20
1713513868742,MCWP 50R,F00,518796,Staff,10,0,20,10
1713513868742,MCWP 50R,G00,518797,Staff,10,0,20,10
1713513869773,MMW 12R,A01,514034,Herbst; Matthew,1,0,16,15
1713513869773,MMW 12R,A02,514035,Herbst; Matthew,13,0,16,3
1713513870799,MMW 13R,A01,514037,Staff,0,8,16,16
1713513870799,MMW 13R,A02,514039,Staff,0,7,16,16
1713513872853,SIO 295LS,A00,523233,Staff,15,0,30,15
1713513873877,SIO 295S,A00,523232,Staff,15,0,30,15
1713513874909,SOCI 117,A01,494376,Staff,0,2,5,5
1713513875936,WES 237B,A00,494380,Staff,19,0,20,1
1713513878055,AESE 279B,A00,494370,Wade; Jon P,33,0,33,0
1713513879080,AIP 197,001,627712,Vespa; Emanuel Ignacio,9999,0,9999,0
1713513880106,ANAR 135S,A00,494369,Braswell; Geoffrey E.,0,0,0,0
1713513881132,CAT 124RS,A01,519847,Geibel; William,6,0,20,14
1713513882159,CAT 125RS,A01,515971,Geibel; William,6,0,20,14
1713513883189,CLRE 250,A00,511389,Morris; Sheldon,9996,0,9999,3
1713513884218,CLRE 251,A00,507176,Mehta; Ravindra L.,9996,0,9999,3
1713513884218,CLRE 251,B00,511410,Mehta; Ravindra L.,9998,0,9999,1
1713513885245,CLRE 252,A00,507189,Cuomo; Raphael Eduardo,9998,0,9999,1
1713513886276,CLRE 253,A00,507199,Vaida; Florin,9997,0,9999,2
1713513886276,CLRE 253,B00,507202,Vaida; Florin,9999,0,9999,0
1713513887301,CLRE 259,A00,507211,Patel; Hemal,9996,0,9999,3
1713513888328,CLRE 260,A00,507221,Cuomo; Raphael Eduardo,9999,0,9999,0
1713513889354,CLRE 297,001,507242,Cuomo; Raphael Eduardo,9999,0,9999,0
1713513890383,CSE 191,A00,516875,Minnes Kemp; Mor Mia,9999,0,9999,0
1713513891408,CSS 201S,A01,494383,Staff,35,0,35,0
1713513892435,CSS 202S,A01,494387,Staff,35,0,35,0
1713513893460,EAP 100,A00,516065,Staff,9792,0,9999,207
1713513894491,ECE 45,A01,507414,Staff,37,0,60,23
1713513895517,ECE 100,A01,507416,Baghdadchi; Saharnaz,0,0,20,20
1713513895517,ECE 100,A02,507418,Baghdadchi; Saharnaz,19,0,20,1
1713513896547,ECE 111,A01,507420,Staff,27,0,50,23
1713513897581,ECE 197,001,548057,Sievenpiper; Daniel F.,9998,0,9999,1
1713513898605,EDS 115,A00,507243,Choi; Bailey Miyeon,27,0,28,1
1713513899634,EDS 117,A01,494379,Staff,15,0,25,10
1713513900657,EDS 125,A00,507246,Hopkins; Megan Beth,27,0,30,3
1713513901739,EDS 128A,A01,507264,Fargason; Sharon Gayle,26,0,26,0
1713513902764,EDS 128B,A01,507293,Pappas; Elizabeth,30,0,30,0
1713513903795,EDS 139,A00,507294,Fargason; Sharon Gayle,30,0,30,0
1713513903795,EDS 139,B00,507313,Pappas; Elizabeth,30,0,30,0
1713513904820,EDS 201,A00,507315,Staff,18,0,30,12
1713513905857,EDS 203,A01,507317,Halter; Christopher P.,17,0,30,13
1713513906883,EDS 204R,A01,507319,Halter; Christopher P.,0,1,30,30
1713513906883,EDS 204R,B01,507331,Heinzman; Erica M.,22,0,30,8
1713513907908,EDS 206R,A00,507332,Staff,0,2,30,30
1713513907908,EDS 206R,B00,507343,Staff,23,0,30,7
1713513908936,EDS 250,A00,507344,Hemans; Patricia Ann Benitez,27,0,40,13
1713513909960,EDS 281,A00,507345,Daly; Alan J.,18,0,18,0
1713513910985,EDS 284,A00,507350,Daly; Alan J.,16,0,16,0
1713513912010,EDS 286,A00,507359,Fine; Sarah,18,0,18,0
1713513913035,EDS 289C,A01,507361,Daly; Alan J.,18,0,18,0
1713513914065,EDS 290,A00,507366,Hofstetter; Carolyn,15,0,15,0
1713513915090,LIGM 5A,A00,507421,Fischer-Grunski; Eva K,20,0,20,0
1713513916116,LIGM 5B,A00,507423,Fischer-Grunski; Eva K,20,0,20,0
1713513917141,LIGM 5C,A00,507425,Fischer-Grunski; Eva K,20,0,20,0
1713513918172,LIIT 5AS,A00,507427,Carnelos; Chiara,20,0,20,0
1713513919201,LIIT 5BS,A00,507430,Carnelos; Chiara,20,0,20,0
1713513920228,LIIT 5CS,A00,507432,Carnelos; Chiara,20,0,20,0
1713513921254,LISP 5A,A00,507541,Munoz Sanchez; Alicia,14,0,20,6
1713513922282,LISP 5B,A00,507671,Munoz Sanchez; Alicia,12,0,20,8
1713513923313,LISP 5C,A00,507696,Munoz Sanchez; Alicia,11,0,20,9
1713513924339,MAE 197,001,528363,Boechler; Nicholas Sebastia,9998,0,9999,1
1713513925370,MATH 197,001,523477,Kedlaya; Kiran S.,9999,0,9999,0
1713513925370,MATH 197,002,563811,Zhang; Danna,9998,0,9999,1
1713513926397,MCWP 40R,A00,518780,Staff,13,0,20,7
1713513926397,MCWP 40R,B00,518781,Staff,11,0,20,9
1713513926397,MCWP 40R,C00,518783,Staff,8,0,20,12
1713513927423,MCWP 50R,A00,518791,Staff,7,0,20,13
1713513927423,MCWP 50R,B00,518792,Staff,3,0,20,17
1713513927423,MCWP 50R,C00,518793,Staff,5,0,20,15
1713513927423,MCWP 50R,D00,518794,Staff,0,0,20,20
1713513927423,MCWP 50R,E00,518795,Staff,0,0,20,20
1713513927423,MCWP 50R,F00,518796,Staff,10,0,20,10
1713513927423,MCWP 50R,G00,518797,Staff,10,0,20,10
1713513928456,MMW 12R,A01,514034,Herbst; Matthew,1,0,16,15
1713513928456,MMW 12R,A02,514035,Herbst; Matthew,13,0,16,3
1713513929480,MMW 13R,A01,514037,Staff,0,8,16,16
1713513929480,MMW 13R,A02,514039,Staff,0,7,16,16
1713513931534,SIO 295LS,A00,523233,Staff,15,0,30,15
1713513932559,SIO 295S,A00,523232,Staff,15,0,30,15
1713513933585,SOCI 117,A01,494376,Staff,0,2,5,5
1713513934622,WES 237B,A00,494380,Staff,19,0,20,1
1713513936698,AESE 279B,A00,494370,Wade; Jon P,33,0,33,0
1713513937727,AIP 197,001,627712,Vespa; Emanuel Ignacio,9999,0,9999,0
1713513938756,ANAR 135S,A00,494369,Braswell; Geoffrey E.,0,0,0,0
1713513939782,CAT 124RS,A01,519847,Geibel; William,6,0,20,14
1713513940809,CAT 125RS,A01,515971,Geibel; William,6,0,20,14
1713513941838,CLRE 250,A00,511389,Morris; Sheldon,9996,0,9999,3
1713513942871,CLRE 251,A00,507176,Mehta; Ravindra L.,9996,0,9999,3
1713513942871,CLRE 251,B00,511410,Mehta; Ravindra L.,9998,0,9999,1
1713513943905,CLRE 252,A00,507189,Cuomo; Raphael Eduardo,9998,0,9999,1
1713513944931,CLRE 253,A00,507199,Vaida; Florin,9997,0,9999,2
1713513944931,CLRE 253,B00,507202,Vaida; Florin,9999,0,9999,0
1713513945960,CLRE 259,A00,507211,Patel; Hemal,9996,0,9999,3
1713513946989,CLRE 260,A00,507221,Cuomo; Raphael Eduardo,9999,0,9999,0
1713513948017,CLRE 297,001,507242,Cuomo; Raphael Eduardo,9999,0,9999,0
1713513949047,CSE 191,A00,516875,Minnes Kemp; Mor Mia,9999,0,9999,0
1713513950074,CSS 201S,A01,494383,Staff,35,0,35,0
1713513951099,CSS 202S,A01,494387,Staff,35,0,35,0
1713513952128,EAP 100,A00,516065,Staff,9792,0,9999,207
1713513953155,ECE 45,A01,507414,Staff,37,0,60,23
1713513954181,ECE 100,A01,507416,Baghdadchi; Saharnaz,0,0,20,20
1713513954181,ECE 100,A02,507418,Baghdadchi; Saharnaz,19,0,20,1
1713513955210,ECE 111,A01,507420,Staff,27,0,50,23
1713513956239,ECE 197,001,548057,Sievenpiper; Daniel F.,9998,0,9999,1
1713513957268,EDS 115,A00,507243,Choi; Bailey Miyeon,27,0,28,1
1713513958294,EDS 117,A01,494379,Staff,15,0,25,10
1713513959321,EDS 125,A00,507246,Hopkins; Megan Beth,27,0,30,3
1713513960352,EDS 128A,A01,507264,Fargason; Sharon Gayle,26,0,26,0
1713513961378,EDS 128B,A01,507293,Pappas; Elizabeth,30,0,30,0
1713513962403,EDS 139,A00,507294,Fargason; Sharon Gayle,30,0,30,0
1713513962403,EDS 139,B00,507313,Pappas; Elizabeth,30,0,30,0
1713513963432,EDS 201,A00,507315,Staff,18,0,30,12
1713513964462,EDS 203,A01,507317,Halter; Christopher P.,17,0,30,13
1713513965491,EDS 204R,A01,507319,Halter; Christopher P.,0,1,30,30
1713513965491,EDS 204R,B01,507331,Heinzman; Erica M.,22,0,30,8
1713513966516,EDS 206R,A00,507332,Staff,0,2,30,30
1713513966516,EDS 206R,B00,507343,Staff,23,0,30,7
1713513967546,EDS 250,A00,507344,Hemans; Patricia Ann Benitez,27,0,40,13
1713513968572,EDS 281,A00,507345,Daly; Alan J.,18,0,18,0
1713513969596,EDS 284,A00,507350,Daly; Alan J.,16,0,16,0
1713513970627,EDS 286,A00,507359,Fine; Sarah,18,0,18,0
1713513971652,EDS 289C,A01,507361,Daly; Alan J.,18,0,18,0
1713513972681,EDS 290,A00,507366,Hofstetter; Carolyn,15,0,15,0
1713513973706,LIGM 5A,A00,507421,Fischer-Grunski; Eva K,20,0,20,0
1713513974738,LIGM 5B,A00,507423,Fischer-Grunski; Eva K,20,0,20,0
1713513975767,LIGM 5C,A00,507425,Fischer-Grunski; Eva K,20,0,20,0
1713513976797,LIIT 5AS,A00,507427,Carnelos; Chiara,20,0,20,0
1713513977822,LIIT 5BS,A00,507430,Carnelos; Chiara,20,0,20,0
1713513978852,LIIT 5CS,A00,507432,Carnelos; Chiara,20,0,20,0
1713513979882,LISP 5A,A00,507541,Munoz Sanchez; Alicia,14,0,20,6
1713513980908,LISP 5B,A00,507671,Munoz Sanchez; Alicia,12,0,20,8
1713513981939,LISP 5C,A00,507696,Munoz Sanchez; Alicia,11,0,20,9
1713513982964,MAE 197,001,528363,Boechler; Nicholas Sebastia,9998,0,9999,1
1713513983991,MATH 197,001,523477,Kedlaya; Kiran S.,9999,0,9999,0
1713513983991,MATH 197,002,563811,Zhang; Danna,9998,0,9999,1
1713513985017,MCWP 40R,A00,518780,Staff,13,0,20,7
1713513985017,MCWP 40R,B00,518781,Staff,11,0,20,9
1713513985017,MCWP 40R,C00,518783,Staff,8,0,20,12
1713513986043,MCWP 50R,A00,518791,Staff,7,0,20,13
1713513986043,MCWP 50R,B00,518792,Staff,3,0,20,17
1713513986043,MCWP 50R,C00,518793,Staff,5,0,20,15
1713513986043,MCWP 50R,D00,518794,Staff,0,0,20,20
1713513986043,MCWP 50R,E00,518795,Staff,0,0,20,20
1713513986043,MCWP 50R,F00,518796,Staff,10,0,20,10
1713513986043,MCWP 50R,G00,518797,Staff,10,0,20,10
1713513987070,MMW 12R,A01,514034,Herbst; Matthew,1,0,16,15
1713513987070,MMW 12R,A02,514035,Herbst; Matthew,13,0,16,3
1713513988100,MMW 13R,A01,514037,Staff,0,8,16,16
1713513988100,MMW 13R,A02,514039,Staff,0,7,16,16
1713513990155,SIO 295LS,A00,523233,Staff,15,0,30,15
1713513991180,SIO 295S,A00,523232,Staff,15,0,30,15
1713513992203,SOCI 117,A01,494376,Staff,0,2,5,5
1713513993228,WES 237B,A00,494380,Staff,19,0,20,1
1713513995298,AESE 279B,A00,494370,Wade; Jon P,33,0,33,0
1713513996327,AIP 197,001,627712,Vespa; Emanuel Ignacio,9999,0,9999,0
1713513997353,ANAR 135S,A00,494369,Braswell; Geoffrey E.,0,0,0,0
1713513998382,CAT 124RS,A01,519847,Geibel; William,6,0,20,14
1713513999410,CAT 125RS,A01,515971,Geibel; William,6,0,20,14
1713514000441,CLRE 250,A00,511389,Morris; Sheldon,9996,0,9999,3
1713514001471,CLRE 251,A00,507176,Mehta; Ravindra L.,9996,0,9999,3
1713514001471,CLRE 251,B00,511410,Mehta; Ravindra L.,9998,0,9999,1
1713514002495,CLRE 252,A00,507189,Cuomo; Raphael Eduardo,9998,0,9999,1
1713514003525,CLRE 253,A00,507199,Vaida; Florin,9997,0,9999,2
1713514003525,CLRE 253,B00,507202,Vaida; Florin,9999,0,9999,0
1713514004554,CLRE 259,A00,507211,Patel; Hemal,9996,0,9999,3
1713514005638,CLRE 260,A00,507221,Cuomo; Raphael Eduardo,9999,0,9999,0
1713514006664,CLRE 297,001,507242,Cuomo; Raphael Eduardo,9999,0,9999,0
1713514007696,CSE 191,A00,516875,Minnes Kemp; Mor Mia,9999,0,9999,0
1713514008723,CSS 201S,A01,494383,Staff,35,0,35,0
1713514009748,CSS 202S,A01,494387,Staff,35,0,35,0
1713514010774,EAP 100,A00,516065,Staff,9792,0,9999,207
1713514011800,ECE 45,A01,507414,Staff,37,0,60,23
1713514012828,ECE 100,A01,507416,Baghdadchi; Saharnaz,0,0,20,20
1713514012828,ECE 100,A02,507418,Baghdadchi; Saharnaz,19,0,20,1
1713514013854,ECE 111,A01,507420,Staff,27,0,50,23
1713514014880,ECE 197,001,548057,Sievenpiper; Daniel F.,9998,0,9999,1
1713514015906,EDS 115,A00,507243,Choi; Bailey Miyeon,27,0,28,1
1713514016933,EDS 117,A01,494379,Staff,15,0,25,10
1713514017960,EDS 125,A00,507246,Hopkins; Megan Beth,27,0,30,3
1713514018984,EDS 128A,A01,507264,Fargason; Sharon Gayle,26,0,26,0
1713514020011,EDS 128B,A01,507293,Pappas; Elizabeth,30,0,30,0
1713514021036,EDS 139,A00,507294,Fargason; Sharon Gayle,30,0,30,0
1713514021036,EDS 139,B00,507313,Pappas; Elizabeth,30,0,30,0
1713514022062,EDS 201,A00,507315,Staff,18,0,30,12
1713514023089,EDS 203,A01,507317,Halter; Christopher P.,17,0,30,13
1713514024120,EDS 204R,A01,507319,Halter; Christopher P.,0,1,30,30
1713514024120,EDS 204R,B01,507331,Heinzman; Erica M.,22,0,30,8
1713514025148,EDS 206R,A00,507332,Staff,0,2,30,30
1713514025148,EDS 206R,B00,507343,Staff,23,0,30,7
1713514026174,EDS 250,A00,507344,Hemans; Patricia Ann Benitez,27,0,40,13
1713514027200,EDS 281,A00,507345,Daly; Alan J.,18,0,18,0
1713514028230,EDS 284,A00,507350,Daly; Alan J.,16,0,16,0
1713514029260,EDS 286,A00,507359,Fine; Sarah,18,0,18,0
1713514030287,EDS 289C,A01,507361,Daly; Alan J.,18,0,18,0
1713514031317,EDS 290,A00,507366,Hofstetter; Carolyn,15,0,15,0
1713514032348,LIGM 5A,A00,507421,Fischer-Grunski; Eva K,20,0,20,0
1713514033374,LIGM 5B,A00,507423,Fischer-Grunski; Eva K,20,0,20,0
1713514034399,LIGM 5C,A00,507425,Fischer-Grunski; Eva K,20,0,20,0
1713514035425,LIIT 5AS,A00,507427,Carnelos; Chiara,20,0,20,0
1713514036451,LIIT 5BS,A00,507430,Carnelos; Chiara,20,0,20,0
1713514037475,LIIT 5CS,A00,507432,Carnelos; Chiara,20,0,20,0
1713514038504,LISP 5A,A00,507541,Munoz Sanchez; Alicia,14,0,20,6
1713514039533,LISP 5B,A00,507671,Munoz Sanchez; Alicia,12,0,20,8
1713514040563,LISP 5C,A00,507696,Munoz Sanchez; Alicia,11,0,20,9
1713514041588,MAE 197,001,528363,Boechler; Nicholas Sebastia,9998,0,9999,1
1713514042613,MATH 197,001,523477,Kedlaya; Kiran S.,9999,0,9999,0
1713514042613,MATH 197,002,563811,Zhang; Danna,9998,0,9999,1
1713514043643,MCWP 40R,A00,518780,Staff,13,0,20,7
1713514043643,MCWP 40R,B00,518781,Staff,11,0,20,9
1713514043643,MCWP 40R,C00,518783,Staff,8,0,20,12
1713514044671,MCWP 50R,A00,518791,Staff,7,0,20,13
1713514044671,MCWP 50R,B00,518792,Staff,3,0,20,17
1713514044671,MCWP 50R,C00,518793,Staff,5,0,20,15
1713514044671,MCWP 50R,D00,518794,Staff,0,0,20,20
1713514044671,MCWP 50R,E00,518795,Staff,0,0,20,20
1713514044671,MCWP 50R,F00,518796,Staff,10,0,20,10
1713514044671,MCWP 50R,G00,518797,Staff,10,0,20,10
1713514045695,MMW 12R,A01,514034,Herbst; Matthew,1,0,16,15
1713514045695,MMW 12R,A02,514035,Herbst; Matthew,13,0,16,3
1713514046722,MMW 13R,A01,514037,Staff,0,8,16,16
1713514046722,MMW 13R,A02,514039,Staff,0,7,16,16
1713514048775,SIO 295LS,A00,523233,Staff,15,0,30,15
1713514049803,SIO 295S,A00,523232,Staff,15,0,30,15
1713514050828,SOCI 117,A01,494376,Staff,0,2,5,5
1713514051856,WES 237B,A00,494380,Staff,19,0,20,1
1713514053930,AESE 279B,A00,494370,Wade; Jon P,33,0,33,0
1713514054959,AIP 197,001,627712,Vespa; Emanuel Ignacio,9999,0,9999,0
1713514055985,ANAR 135S,A00,494369,Braswell; Geoffrey E.,0,0,0,0
1713514057015,CAT 124RS,A01,519847,Geibel; William,6,0,20,14
1713514058040,CAT 125RS,A01,515971,Geibel; William,6,0,20,14
1713514059069,CLRE 250,A00,511389,Morris; Sheldon,9996,0,9999,3
1713514060093,CLRE 251,A00,507176,Mehta; Ravindra L.,9996,0,9999,3
1713514060093,CLRE 251,B00,511410,Mehta; Ravindra L.,9998,0,9999,1
1713514061121,CLRE 252,A00,507189,Cuomo; Raphael Eduardo,9998,0,9999,1
1713514062146,CLRE 253,A00,507199,Vaida; Florin,9997,0,9999,2
1713514062146,CLRE 253,B00,507202,Vaida; Florin,9999,0,9999,0
1713514063175,CLRE 259,A00,507211,Patel; Hemal,9996,0,9999,3
1713514064201,CLRE 260,A00,507221,Cuomo; Raphael Eduardo,9999,0,9999,0
1713514065225,CLRE 297,001,507242,Cuomo; Raphael Eduardo,9999,0,9999,0
1713514066250,CSE 191,A00,516875,Minnes Kemp; Mor Mia,9999,0,9999,0
1713514067275,CSS 201S,A01,494383,Staff,35,0,35,0
1713514068301,CSS 202S,A01,494387,Staff,35,0,35,0
1713514069324,EAP 100,A00,516065,Staff,9792,0,9999,207
1713514070350,ECE 45,A01,507414,Staff,37,0,60,23
1713514071381,ECE 100,A01,507416,Baghdadchi; Saharnaz,0,0,20,20
1713514071381,ECE 100,A02,507418,Baghdadchi; Saharnaz,19,0,20,1
1713514072410,ECE 111,A01,507420,Staff,27,0,50,23
1713514073436,ECE 197,001,548057,Sievenpiper; Daniel F.,9998,0,9999,1
1713514074463,EDS 115,A00,507243,Choi; Bailey Miyeon,27,0,28,1
1713514075494,EDS 117,A01,494379,Staff,15,0,25,10
1713514076521,EDS 125,A00,507246,Hopkins; Megan Beth,27,0,30,3
1713514077547,EDS 128A,A01,507264,Fargason; Sharon Gayle,26,0,26,0
1713514078574,EDS 128B,A01,507293,Pappas; Elizabeth,30,0,30,0
1713514079603,EDS 139,A00,507294,Fargason; Sharon Gayle,30,0,30,0
1713514079603,EDS 139,B00,507313,Pappas; Elizabeth,30,0,30,0
1713514080629,EDS 201,A00,507315,Staff,18,0,30,12
1713514081659,EDS 203,A01,507317,Halter; Christopher P.,17,0,30,13
1713514082685,EDS 204R,A01,507319,Halter; Christopher P.,0,1,30,30
1713514082685,EDS 204R,B01,507331,Heinzman; Erica M.,22,0,30,8
1713514083712,EDS 206R,A00,507332,Staff,0,2,30,30
1713514083712,EDS 206R,B00,507343,Staff,23,0,30,7
1713514084738,EDS 250,A00,507344,Hemans; Patricia Ann Benitez,27,0,40,13
1713514085763,EDS 281,A00,507345,Daly; Alan J.,18,0,18,0
1713514086791,EDS 284,A00,507350,Daly; Alan J.,16,0,16,0
1713514087820,EDS 286,A00,507359,Fine; Sarah,18,0,18,0
1713514088846,EDS 289C,A01,507361,Daly; Alan J.,18,0,18,0
1713514089874,EDS 290,A00,507366,Hofstetter; Carolyn,15,0,15,0
1713514090903,LIGM 5A,A00,507421,Fischer-Grunski; Eva K,20,0,20,0
1713514091928,LIGM 5B,A00,507423,Fischer-Grunski; Eva K,20,0,20,0
1713514092960,LIGM 5C,A00,507425,Fischer-Grunski; Eva K,20,0,20,0
1713514093987,LIIT 5AS,A00,507427,Carnelos; Chiara,20,0,20,0
1713514095013,LIIT 5BS,A00,507430,Carnelos; Chiara,20,0,20,0
1713514096038,LIIT 5CS,A00,507432,Carnelos; Chiara,20,0,20,0
1713514097069,LISP 5A,A00,507541,Munoz Sanchez; Alicia,14,0,20,6
1713514098101,LISP 5B,A00,507671,Munoz Sanchez; Alicia,12,0,20,8
1713514099126,LISP 5C,A00,507696,Munoz Sanchez; Alicia,11,0,20,9
1713514100152,MAE 197,001,528363,Boechler; Nicholas Sebastia,9998,0,9999,1
1713514101180,MATH 197,001,523477,Kedlaya; Kiran S.,9999,0,9999,0
1713514101180,MATH 197,002,563811,Zhang; Danna,9998,0,9999,1
1713514102206,MCWP 40R,A00,518780,Staff,13,0,20,7
1713514102206,MCWP 40R,B00,518781,Staff,11,0,20,9
1713514102206,MCWP 40R,C00,518783,Staff,8,0,20,12
1713514103237,MCWP 50R,A00,518791,Staff,7,0,20,13
1713514103237,MCWP 50R,B00,518792,Staff,3,0,20,17
1713514103237,MCWP 50R,C00,518793,Staff,5,0,20,15
1713514103237,MCWP 50R,D00,518794,Staff,0,0,20,20
1713514103237,MCWP 50R,E00,518795,Staff,0,0,20,20
1713514103237,MCWP 50R,F00,518796,Staff,10,0,20,10
1713514103237,MCWP 50R,G00,518797,Staff,10,0,20,10
1713514104262,MMW 12R,A01,514034,Herbst; Matthew,1,0,16,15
1713514104262,MMW 12R,A02,514035,Herbst; Matthew,13,0,16,3
1713514105289,MMW 13R,A01,514037,Staff,0,8,16,16
1713514105289,MMW 13R,A02,514039,Staff,0,7,16,16
1713514107345,SIO 295LS,A00,523233,Staff,15,0,30,15
1713514108374,SIO 295S,A00,523232,Staff,15,0,30,15
1713514109474,SOCI 117,A01,494376,Staff,0,2,5,5
1713514110501,WES 237B,A00,494380,Staff,19,0,20,1
1713514112569,AESE 279B,A00,494370,Wade; Jon P,33,0,33,0
1713514113597,AIP 197,001,627712,Vespa; Emanuel Ignacio,9999,0,9999,0
1713514114627,ANAR 135S,A00,494369,Braswell; Geoffrey E.,0,0,0,0
1713514115652,CAT 124RS,A01,519847,Geibel; William,6,0,20,14
1713514116677,CAT 125RS,A01,515971,Geibel; William,6,0,20,14
1713514117705,CLRE 250,A00,511389,Morris; Sheldon,9996,0,9999,3
1713514118731,CLRE 251,A00,507176,Mehta; Ravindra L.,9996,0,9999,3
1713514118731,CLRE 251,B00,511410,Mehta; Ravindra L.,9998,0,9999,1
1713514119757,CLRE 252,A00,507189,Cuomo; Raphael Eduardo,9998,0,9999,1
1713514120794,CLRE 253,A00,507199,Vaida; Florin,9997,0,9999,2
1713514120794,CLRE 253,B00,507202,Vaida; Florin,9999,0,9999,0
1713514121831,CLRE 259,A00,507211,Patel; Hemal,9996,0,9999,3
1713514122857,CLRE 260,A00,507221,Cuomo; Raphael Eduardo,9999,0,9999,0
1713514123893,CLRE 297,001,507242,Cuomo; Raphael Eduardo,9999,0,9999,0
1713514124918,CSE 191,A00,516875,Minnes Kemp; Mor Mia,9999,0,9999,0
1713514125944,CSS 201S,A01,494383,Staff,35,0,35,0
1713514126977,CSS 202S,A01,494387,Staff,35,0,35,0
1713514128006,EAP 100,A00,516065,Staff,9792,0,9999,207
1713514129032,ECE 45,A01,507414,Staff,37,0,60,23
1713514130066,ECE 100,A01,507416,Baghdadchi; Saharnaz,0,0,20,20
1713514130066,ECE 100,A02,507418,Baghdadchi; Saharnaz,19,0,20,1
1713514131093,ECE 111,A01,507420,Staff,27,0,50,23
1713514132118,ECE 197,001,548057,Sievenpiper; Daniel F.,9998,0,9999,1
1713514133148,EDS 115,A00,507243,Choi; Bailey Miyeon,27,0,28,1
1713514134179,EDS 117,A01,494379,Staff,15,0,25,10
1713514135205,EDS 125,A00,507246,Hopkins; Megan Beth,27,0,30,3
1713514136242,EDS 128A,A01,507264,Fargason; Sharon Gayle,26,0,26,0
1713514137272,EDS 128B,A01,507293,Pappas; Elizabeth,30,0,30,0
1713514138301,EDS 139,A00,507294,Fargason; Sharon Gayle,30,0,30,0
1713514138301,EDS 139,B00,507313,Pappas; Elizabeth,30,0,30,0
1713514139327,EDS 201,A00,507315,Staff,18,0,30,12
1713514140354,EDS 203,A01,507317,Halter; Christopher P.,17,0,30,13
1713514141381,EDS 204R,A01,507319,Halter; Christopher P.,0,1,30,30
1713514141381,EDS 204R,B01,507331,Heinzman; Erica M.,22,0,30,8
1713514142410,EDS 206R,A00,507332,Staff,0,2,30,30
1713514142410,EDS 206R,B00,507343,Staff,23,0,30,7
1713514143441,EDS 250,A00,507344,Hemans; Patricia Ann Benitez,27,0,40,13
1713514144468,EDS 281,A00,507345,Daly; Alan J.,18,0,18,0
1713514145494,EDS 284,A00,507350,Daly; Alan J.,16,0,16,0
1713514146521,EDS 286,A00,507359,Fine; Sarah,18,0,18,0
1713514147550,EDS 289C,A01,507361,Daly; Alan J.,18,0,18,0
1713514148579,EDS 290,A00,507366,Hofstetter; Carolyn,15,0,15,0
1713514149622,LIGM 5A,A00,507421,Fischer-Grunski; Eva K,20,0,20,0
1713514150652,LIGM 5B,A00,507423,Fischer-Grunski; Eva K,20,0,20,0
1713514151678,LIGM 5C,A00,507425,Fischer-Grunski; Eva K,20,0,20,0
1713514152704,LIIT 5AS,A00,507427,Carnelos; Chiara,20,0,20,0
1713514153741,LIIT 5BS,A00,507430,Carnelos; Chiara,20,0,20,0
1713514154768,LIIT 5CS,A00,507432,Carnelos; Chiara,20,0,20,0
1713514155798,LISP 5A,A00,507541,Munoz Sanchez; Alicia,14,0,20,6
1713514156826,LISP 5B,A00,507671,Munoz Sanchez; Alicia,12,0,20,8
1713514157855,LISP 5C,A00,507696,Munoz Sanchez; Alicia,11,0,20,9
1713514158879,MAE 197,001,528363,Boechler; Nicholas Sebastia,9998,0,9999,1
1713514159904,MATH 197,001,523477,Kedlaya; Kiran S.,9999,0,9999,0
1713514159904,MATH 197,002,563811,Zhang; Danna,9998,0,9999,1
1713514160935,MCWP 40R,A00,518780,Staff,13,0,20,7
1713514160935,MCWP 40R,B00,518781,Staff,11,0,20,9
1713514160935,MCWP 40R,C00,518783,Staff,8,0,20,12
1713514161961,MCWP 50R,A00,518791,Staff,7,0,20,13
1713514161961,MCWP 50R,B00,518792,Staff,3,0,20,17
1713514161961,MCWP 50R,C00,518793,Staff,5,0,20,15
1713514161961,MCWP 50R,D00,518794,Staff,0,0,20,20
1713514161961,MCWP 50R,E00,518795,Staff,0,0,20,20
1713514161961,MCWP 50R,F00,518796,Staff,10,0,20,10
1713514161961,MCWP 50R,G00,518797,Staff,10,0,20,10
1713514162988,MMW 12R,A01,514034,Herbst; Matthew,1,0,16,15
1713514162988,MMW 12R,A02,514035,Herbst; Matthew,13,0,16,3
1713514164018,MMW 13R,A01,514037,Staff,0,8,16,16
1713514164018,MMW 13R,A02,514039,Staff,0,7,16,16
1713514166076,SIO 295LS,A00,523233,Staff,15,0,30,15
1713514167100,SIO 295S,A00,523232,Staff,15,0,30,15
1713514168126,SOCI 117,A01,494376,Staff,0,2,5,5
1713514169154,WES 237B,A00,494380,Staff,19,0,20,1
1713514171229,AESE 279B,A00,494370,Wade; Jon P,33,0,33,0
1713514172255,AIP 197,001,627712,Vespa; Emanuel Ignacio,9999,0,9999,0
1713514173281,ANAR 135S,A00,494369,Braswell; Geoffrey E.,0,0,0,0
1713514174307,CAT 124RS,A01,519847,Geibel; William,6,0,20,14
1713514175335,CAT 125RS,A01,515971,Geibel; William,6,0,20,14
1713514176361,CLRE 250,A00,511389,Morris; Sheldon,9996,0,9999,3
1713514177385,CLRE 251,A00,507176,Mehta; Ravindra L.,9996,0,9999,3
1713514177385,CLRE 251,B00,511410,Mehta; Ravindra L.,9998,0,9999,1
1713514178416,CLRE 252,A00,507189,Cuomo; Raphael Eduardo,9998,0,9999,1
1713514179442,CLRE 253,A00,507199,Vaida; Florin,9997,0,9999,2
1713514179442,CLRE 253,B00,507202,Vaida; Florin,9999,0,9999,0
1713514180469,CLRE 259,A00,507211,Patel; Hemal,9996,0,9999,3
1713514181499,CLRE 260,A00,507221,Cuomo; Raphael Eduardo,9999,0,9999,0
1713514182525,CLRE 297,001,507242,Cuomo; Raphael Eduardo,9999,0,9999,0
1713514183551,CSE 191,A00,516875,Minnes Kemp; Mor Mia,9999,0,9999,0
1713514184581,CSS 201S,A01,494383,Staff,35,0,35,0
1713514185607,CSS 202S,A01,494387,Staff,35,0,35,0
1713514186637,EAP 100,A00,516065,Staff,9792,0,9999,207
1713514187664,ECE 45,A01,507414,Staff,37,0,60,23
1713514188690,ECE 100,A01,507416,Baghdadchi; Saharnaz,0,0,20,20
1713514188690,ECE 100,A02,507418,Baghdadchi; Saharnaz,19,0,20,1
1713514189716,ECE 111,A01,507420,Staff,27,0,50,23
1713514190744,ECE 197,001,548057,Sievenpiper; Daniel F.,9998,0,9999,1
1713514191770,EDS 115,A00,507243,Choi; Bailey Miyeon,27,0,28,1
1713514192801,EDS 117,A01,494379,Staff,15,0,25,10
1713514193827,EDS 125,A00,507246,Hopkins; Megan Beth,27,0,30,3
1713514194853,EDS 128A,A01,507264,Fargason; Sharon Gayle,26,0,26,0
1713514195888,EDS 128B,A01,507293,Pappas; Elizabeth,30,0,30,0
1713514196914,EDS 139,A00,507294,Fargason; Sharon Gayle,30,0,30,0
1713514196914,EDS 139,B00,507313,Pappas; Elizabeth,30,0,30,0
1713514197944,EDS 201,A00,507315,Staff,18,0,30,12
1713514198969,EDS 203,A01,507317,Halter; Christopher P.,17,0,30,13
1713514199994,EDS 204R,A01,507319,Halter; Christopher P.,0,1,30,30
1713514199994,EDS 204R,B01,507331,Heinzman; Erica M.,22,0,30,8
1713514201020,EDS 206R,A00,507332,Staff,0,2,30,30
1713514201020,EDS 206R,B00,507343,Staff,23,0,30,7
1713514202049,EDS 250,A00,507344,Hemans; Patricia Ann Benitez,27,0,40,13
1713514203075,EDS 281,A00,507345,Daly; Alan J.,18,0,18,0
1713514204104,EDS 284,A00,507350,Daly; Alan J.,16,0,16,0
1713514205130,EDS 286,A00,507359,Fine; Sarah,18,0,18,0
1713514206156,EDS 289C,A01,507361,Daly; Alan J.,18,0,18,0
1713514207181,EDS 290,A00,507366,Hofstetter; Carolyn,15,0,15,0
1713514208211,LIGM 5A,A00,507421,Fischer-Grunski; Eva K,20,0,20,0
1713514209236,LIGM 5B,A00,507423,Fischer-Grunski; Eva K,20,0,20,0
1713514210261,LIGM 5C,A00,507425,Fischer-Grunski; Eva K,20,0,20,0
1713514211286,LIIT 5AS,A00,507427,Carnelos; Chiara,20,0,20,0
1713514212318,LIIT 5BS,A00,507430,Carnelos; Chiara,20,0,20,0
1713514213401,LIIT 5CS,A00,507432,Carnelos; Chiara,20,0,20,0
1713514214432,LISP 5A,A00,507541,Munoz Sanchez; Alicia,14,0,20,6
1713514215458,LISP 5B,A00,507671,Munoz Sanchez; Alicia,12,0,20,8
1713514216487,LISP 5C,A00,507696,Munoz Sanchez; Alicia,11,0,20,9
1713514217516,MAE 197,001,528363,Boechler; Nicholas Sebastia,9998,0,9999,1
1713514218545,MATH 197,001,523477,Kedlaya; Kiran S.,9999,0,9999,0
1713514218545,MATH 197,002,563811,Zhang; Danna,9998,0,9999,1
1713514219575,MCWP 40R,A00,518780,Staff,13,0,20,7
1713514219575,MCWP 40R,B00,518781,Staff,11,0,20,9
1713514219575,MCWP 40R,C00,518783,Staff,8,0,20,12
1713514220600,MCWP 50R,A00,518791,Staff,7,0,20,13
1713514220600,MCWP 50R,B00,518792,Staff,3,0,20,17
1713514220600,MCWP 50R,C00,518793,Staff,5,0,20,15
1713514220600,MCWP 50R,D00,518794,Staff,0,0,20,20
1713514220600,MCWP 50R,E00,518795,Staff,0,0,20,20
1713514220600,MCWP 50R,F00,518796,Staff,10,0,20,10
1713514220600,MCWP 50R,G00,518797,Staff,10,0,20,10
1713514221629,MMW 12R,A01,514034,Herbst; Matthew,1,0,16,15
1713514221629,MMW 12R,A02,514035,Herbst; Matthew,13,0,16,3
1713514222653,MMW 13R,A01,514037,Staff,0,8,16,16
1713514222653,MMW 13R,A02,514039,Staff,0,7,16,16
1713514224707,SIO 295LS,A00,523233,Staff,15,0,30,15
1713514225732,SIO 295S,A00,523232,Staff,15,0,30,15
1713514226758,SOCI 117,A01,494376,Staff,0,2,5,5
1713514227783,WES 237B,A00,494380,Staff,19,0,20,1
1713514229859,AESE 279B,A00,494370,Wade; Jon P,33,0,33,0
1713514230884,AIP 197,001,627712,Vespa; Emanuel Ignacio,9999,0,9999,0
1713514231909,ANAR 135S,A00,494369,Braswell; Geoffrey E.,0,0,0,0
1713514232938,CAT 124RS,A01,519847,Geibel; William,6,0,20,14
1713514233963,CAT 125RS,A01,515971,Geibel; William,6,0,20,14
1713514234988,CLRE 250,A00,511389,Morris; Sheldon,9996,0,9999,3
1713514236015,CLRE 251,A00,507176,Mehta; Ravindra L.,9996,0,9999,3
1713514236015,CLRE 251,B00,511410,Mehta; Ravindra L.,9998,0,9999,1
1713514237041,CLRE 252,A00,507189,Cuomo; Raphael Eduardo,9998,0,9999,1
1713514238071,CLRE 253,A00,507199,Vaida; Florin,9997,0,9999,2
1713514238071,CLRE 253,B00,507202,Vaida; Florin,9999,0,9999,0
1713514239098,CLRE 259,A00,507211,Patel; Hemal,9996,0,9999,3
1713514240124,CLRE 260,A00,507221,Cuomo; Raphael Eduardo,9999,0,9999,0
1713514241153,CLRE 297,001,507242,Cuomo; Raphael Eduardo,9999,0,9999,0
1713514242183,CSE 191,A00,516875,Minnes Kemp; Mor Mia,9999,0,9999,0
1713514243209,CSS 201S,A01,494383,Staff,35,0,35,0
1713514244237,CSS 202S,A01,494387,Staff,35,0,35,0
1713514245264,EAP 100,A00,516065,Staff,9792,0,9999,207
1713514246295,ECE 45,A01,507414,Staff,37,0,60,23
1713514247321,ECE 100,A01,507416,Baghdadchi; Saharnaz,0,0,20,20
1713514247321,ECE 100,A02,507418,Baghdadchi; Saharnaz,19,0,20,1
1713514248350,ECE 111,A01,507420,Staff,27,0,50,23
1713514249377,ECE 197,001,548057,Sievenpiper; Daniel F.,9998,0,9999,1
1713514250408,EDS 115,A00,507243,Choi; Bailey Miyeon,27,0,28,1
1713514251437,EDS 117,A01,494379,Staff,15,0,25,10
1713514252462,EDS 125,A00,507246,Hopkins; Megan Beth,27,0,30,3
1713514253488,EDS 128A,A01,507264,Fargason; Sharon Gayle,26,0,26,0
1713514254516,EDS 128B,A01,507293,Pappas; Elizabeth,30,0,30,0
1713514255545,EDS 139,A00,507294,Fargason; Sharon Gayle,30,0,30,0
1713514255545,EDS 139,B00,507313,Pappas; Elizabeth,30,0,30,0
1713514256573,EDS 201,A00,507315,Staff,18,0,30,12
1713514257598,EDS 203,A01,507317,Halter; Christopher P.,17,0,30,13
1713514258626,EDS 204R,A01,507319,Halter; Christopher P.,0,1,30,30
1713514258626,EDS 204R,B01,507331,Heinzman; Erica M.,22,0,30,8
1713514259657,EDS 206R,A00,507332,Staff,0,2,30,30
1713514259657,EDS 206R,B00,507343,Staff,23,0,30,7
1713514260684,EDS 250,A00,507344,Hemans; Patricia Ann Benitez,27,0,40,13
1713514261710,EDS 281,A00,507345,Daly; Alan J.,18,0,18,0
1713514262736,EDS 284,A00,507350,Daly; Alan J.,16,0,16,0
1713514263763,EDS 286,A00,507359,Fine; Sarah,18,0,18,0
1713514264802,EDS 289C,A01,507361,Daly; Alan J.,18,0,18,0
1713514265832,EDS 290,A00,507366,Hofstetter; Carolyn,15,0,15,0
1713514266864,LIGM 5A,A00,507421,Fischer-Grunski; Eva K,20,0,20,0
1713514267889,LIGM 5B,A00,507423,Fischer-Grunski; Eva K,20,0,20,0
1713514268915,LIGM 5C,A00,507425,Fischer-Grunski; Eva K,20,0,20,0
1713514269940,LIIT 5AS,A00,507427,Carnelos; Chiara,20,0,20,0
1713514270970,LIIT 5BS,A00,507430,Carnelos; Chiara,20,0,20,0
1713514271996,LIIT 5CS,A00,507432,Carnelos; Chiara,20,0,20,0
1713514273027,LISP 5A,A00,507541,Munoz Sanchez; Alicia,14,0,20,6
1713514274054,LISP 5B,A00,507671,Munoz Sanchez; Alicia,12,0,20,8
1713514275080,LISP 5C,A00,507696,Munoz Sanchez; Alicia,11,0,20,9
1713514276110,MAE 197,001,528363,Boechler; Nicholas Sebastia,9998,0,9999,1
1713514277136,MATH 197,001,523477,Kedlaya; Kiran S.,9999,0,9999,0
1713514277136,MATH 197,002,563811,Zhang; Danna,9998,0,9999,1
1713514278171,MCWP 40R,A00,518780,Staff,13,0,20,7
1713514278171,MCWP 40R,B00,518781,Staff,11,0,20,9
1713514278171,MCWP 40R,C00,518783,Staff,8,0,20,12
1713514279201,MCWP 50R,A00,518791,Staff,7,0,20,13
1713514279201,MCWP 50R,B00,518792,Staff,3,0,20,17
1713514279201,MCWP 50R,C00,518793,Staff,5,0,20,15
1713514279201,MCWP 50R,D00,518794,Staff,0,0,20,20
1713514279201,MCWP 50R,E00,518795,Staff,0,0,20,20
1713514279201,MCWP 50R,F00,518796,Staff,10,0,20,10
1713514279201,MCWP 50R,G00,518797,Staff,10,0,20,10
1713514280226,MMW 12R,A01,514034,Herbst; Matthew,1,0,16,15
1713514280226,MMW 12R,A02,514035,Herbst; Matthew,13,0,16,3
1713514281251,MMW 13R,A01,514037,Staff,0,8,16,16
1713514281251,MMW 13R,A02,514039,Staff,0,7,16,16
1713514283306,SIO 295LS,A00,523233,Staff,15,0,30,15
1713514284331,SIO 295S,A00,523232,Staff,15,0,30,15
1713514285361,SOCI 117,A01,494376,Staff,0,2,5,5
1713514286386,WES 237B,A00,494380,Staff,19,0,20,1
1713514288487,AESE 279B,A00,494370,Wade; Jon P,33,0,33,0
1713514289513,AIP 197,001,627712,Vespa; Emanuel Ignacio,9999,0,9999,0
1713514290539,ANAR 135S,A00,494369,Braswell; Geoffrey E.,0,0,0,0
1713514291567,CAT 124RS,A01,519847,Geibel; William,6,0,20,14
1713514292593,CAT 125RS,A01,515971,Geibel; William,6,0,20,14
1713514293622,CLRE 250,A00,511389,Morris; Sheldon,9996,0,9999,3
1713514294653,CLRE 251,A00,507176,Mehta; Ravindra L.,9996,0,9999,3
1713514294653,CLRE 251,B00,511410,Mehta; Ravindra L.,9998,0,9999,1
1713514295680,CLRE 252,A00,507189,Cuomo; Raphael Eduardo,9998,0,9999,1
1713514296706,CLRE 253,A00,507199,Vaida; Florin,9997,0,9999,2
1713514296706,CLRE 253,B00,507202,Vaida; Florin,9999,0,9999,0
1713514297736,CLRE 259,A00,507211,Patel; Hemal,9996,0,9999,3
1713514298761,CLRE 260,A00,507221,Cuomo; Raphael Eduardo,9999,0,9999,0
1713514299788,CLRE 297,001,507242,Cuomo; Raphael Eduardo,9999,0,9999,0
1713514300813,CSE 191,A00,516875,Minnes Kemp; Mor Mia,9999,0,9999,0
1713514301840,CSS 201S,A01,494383,Staff,35,0,35,0
1713514302871,CSS 202S,A01,494387,Staff,35,0,35,0
1713514303903,EAP 100,A00,516065,Staff,9792,0,9999,207
1713514304929,ECE 45,A01,507414,Staff,37,0,60,23
1713514305955,ECE 100,A01,507416,Baghdadchi; Saharnaz,0,0,20,20
1713514305955,ECE 100,A02,507418,Baghdadchi; Saharnaz,19,0,20,1
1713514306982,ECE 111,A01,507420,Staff,27,0,50,23
1713514308022,ECE 197,001,548057,Sievenpiper; Daniel F.,9998,0,9999,1
1713514309048,EDS 115,A00,507243,Choi; Bailey Miyeon,27,0,28,1
1713514310074,EDS 117,A01,494379,Staff,15,0,25,10
1713514311105,EDS 125,A00,507246,Hopkins; Megan Beth,27,0,30,3
1713514312132,EDS 128A,A01,507264,Fargason; Sharon Gayle,26,0,26,0
1713514313173,EDS 128B,A01,507293,Pappas; Elizabeth,30,0,30,0
1713514314199,EDS 139,A00,507294,Fargason; Sharon Gayle,30,0,30,0
1713514314199,EDS 139,B00,507313,Pappas; Elizabeth,30,0,30,0
1713514315223,EDS 201,A00,507315,Staff,18,0,30,12
1713514316249,EDS 203,A01,507317,Halter; Christopher P.,17,0,30,13
1713514317328,EDS 204R,A01,507319,Halter; Christopher P.,0,1,30,30
1713514317328,EDS 204R,B01,507331,Heinzman; Erica M.,22,0,30,8
1713514318353,EDS 206R,A00,507332,Staff,0,2,30,30
1713514318353,EDS 206R,B00,507343,Staff,23,0,30,7
1713514319379,EDS 250,A00,507344,Hemans; Patricia Ann Benitez,27,0,40,13
1713514320412,EDS 281,A00,507345,Daly; Alan J.,18,0,18,0
1713514321442,EDS 284,A00,507350,Daly; Alan J.,16,0,16,0
1713514322470,EDS 286,A00,507359,Fine; Sarah,18,0,18,0
1713514323496,EDS 289C,A01,507361,Daly; Alan J.,18,0,18,0
1713514324527,EDS 290,A00,507366,Hofstetter; Carolyn,15,0,15,0
1713514325555,LIGM 5A,A00,507421,Fischer-Grunski; Eva K,20,0,20,0
1713514326581,LIGM 5B,A00,507423,Fischer-Grunski; Eva K,20,0,20,0
1713514327606,LIGM 5C,A00,507425,Fischer-Grunski; Eva K,20,0,20,0
1713514328636,LIIT 5AS,A00,507427,Carnelos; Chiara,20,0,20,0
1713514329662,LIIT 5BS,A00,507430,Carnelos; Chiara,20,0,20,0
1713514330691,LIIT 5CS,A00,507432,Carnelos; Chiara,20,0,20,0
1713514331718,LISP 5A,A00,507541,Munoz Sanchez; Alicia,14,0,20,6
1713514332745,LISP 5B,A00,507671,Munoz Sanchez; Alicia,12,0,20,8
1713514333776,LISP 5C,A00,507696,Munoz Sanchez; Alicia,11,0,20,9
1713514334805,MAE 197,001,528363,Boechler; Nicholas Sebastia,9998,0,9999,1
1713514335838,MATH 197,001,523477,Kedlaya; Kiran S.,9999,0,9999,0
1713514335838,MATH 197,002,563811,Zhang; Danna,9998,0,9999,1
1713514336863,MCWP 40R,A00,518780,Staff,13,0,20,7
1713514336863,MCWP 40R,B00,518781,Staff,11,0,20,9
1713514336863,MCWP 40R,C00,518783,Staff,8,0,20,12
1713514337889,MCWP 50R,A00,518791,Staff,7,0,20,13
1713514337889,MCWP 50R,B00,518792,Staff,3,0,20,17
1713514337889,MCWP 50R,C00,518793,Staff,5,0,20,15
1713514337889,MCWP 50R,D00,518794,Staff,0,0,20,20
1713514337889,MCWP 50R,E00,518795,Staff,0,0,20,20
1713514337889,MCWP 50R,F00,518796,Staff,10,0,20,10
1713514337889,MCWP 50R,G00,518797,Staff,10,0,20,10
1713514338921,MMW 12R,A01,514034,Herbst; Matthew,1,0,16,15
1713514338921,MMW 12R,A02,514035,Herbst; Matthew,13,0,16,3
1713514339947,MMW 13R,A01,514037,Staff,0,8,16,16
1713514339947,MMW 13R,A02,514039,Staff,0,7,16,16
1713514342001,SIO 295LS,A00,523233,Staff,15,0,30,15
1713514343026,SIO 295S,A00,523232,Staff,15,0,30,15
1713514344059,SOCI 117,A01,494376,Staff,0,2,5,5
1713514345086,WES 237B,A00,494380,Staff,19,0,20,1
1713514347158,AESE 279B,A00,494370,Wade; Jon P,33,0,33,0
1713514348187,AIP 197,001,627712,Vespa; Emanuel Ignacio,9999,0,9999,0
1713514349211,ANAR 135S,A00,494369,Braswell; Geoffrey E.,0,0,0,0
1713514350244,CAT 124RS,A01,519847,Geibel; William,6,0,20,14
1713514351272,CAT 125RS,A01,515971,Geibel; William,6,0,20,14
1713514352299,CLRE 250,A00,511389,Morris; Sheldon,9996,0,9999,3
1713514353331,CLRE 251,A00,507176,Mehta; Ravindra L.,9996,0,9999,3
1713514353331,CLRE 251,B00,511410,Mehta; Ravindra L.,9998,0,9999,1
1713514354359,CLRE 252,A00,507189,Cuomo; Raphael Eduardo,9998,0,9999,1
1713514355386,CLRE 253,A00,507199,Vaida; Florin,9997,0,9999,2
1713514355386,CLRE 253,B00,507202,Vaida; Florin,9999,0,9999,0
1713514356413,CLRE 259,A00,507211,Patel; Hemal,9996,0,9999,3
1713514357440,CLRE 260,A00,507221,Cuomo; Raphael Eduardo,9999,0,9999,0
1713514358469,CLRE 297,001,507242,Cuomo; Raphael Eduardo,9999,0,9999,0
1713514359495,CSE 191,A00,516875,Minnes Kemp; Mor Mia,9999,0,9999,0
1713514360527,CSS 201S,A01,494383,Staff,35,0,35,0
1713514361553,CSS 202S,A01,494387,Staff,35,0,35,0
1713514362579,EAP 100,A00,516065,Staff,9792,0,9999,207
1713514363605,ECE 45,A01,507414,Staff,37,0,60,23
1713514364634,ECE 100,A01,507416,Baghdadchi; Saharnaz,0,0,20,20
1713514364634,ECE 100,A02,507418,Baghdadchi; Saharnaz,19,0,20,1
1713514365663,ECE 111,A01,507420,Staff,27,0,50,23
1713514366690,ECE 197,001,548057,Sievenpiper; Daniel F.,9998,0,9999,1
1713514367721,EDS 115,A00,507243,Choi; Bailey Miyeon,27,0,28,1
1713514368752,EDS 117,A01,494379,Staff,15,0,25,10
1713514369782,EDS 125,A00,507246,Hopkins; Megan Beth,27,0,30,3
1713514370808,EDS 128A,A01,507264,Fargason; Sharon Gayle,26,0,26,0
1713514371840,EDS 128B,A01,507293,Pappas; Elizabeth,30,0,30,0
1713514372867,EDS 139,A00,507294,Fargason; Sharon Gayle,30,0,30,0
1713514372867,EDS 139,B00,507313,Pappas; Elizabeth,30,0,30,0
1713514373898,EDS 201,A00,507315,Staff,18,0,30,12
1713514374932,EDS 203,A01,507317,Halter; Christopher P.,17,0,30,13
1713514375957,EDS 204R,A01,507319,Halter; Christopher P.,0,1,30,30
1713514375957,EDS 204R,B01,507331,Heinzman; Erica M.,22,0,30,8
1713514376981,EDS 206R,A00,507332,Staff,0,2,30,30
1713514376981,EDS 206R,B00,507343,Staff,23,0,30,7
1713514378012,EDS 250,A00,507344,Hemans; Patricia Ann Benitez,27,0,40,13
1713514379038,EDS 281,A00,507345,Daly; Alan J.,18,0,18,0
1713514380076,EDS 284,A00,507350,Daly; Alan J.,16,0,16,0
1713514381102,EDS 286,A00,507359,Fine; Sarah,18,0,18,0
1713514382132,EDS 289C,A01,507361,Daly; Alan J.,18,0,18,0
1713514383161,EDS 290,A00,507366,Hofstetter; Carolyn,15,0,15,0
1713514384196,LIGM 5A,A00,507421,Fischer-Grunski; Eva K,20,0,20,0
1713514385228,LIGM 5B,A00,507423,Fischer-Grunski; Eva K,20,0,20,0
1713514386262,LIGM 5C,A00,507425,Fischer-Grunski; Eva K,20,0,20,0
1713514387288,LIIT 5AS,A00,507427,Carnelos; Chiara,20,0,20,0
1713514388315,LIIT 5BS,A00,507430,Carnelos; Chiara,20,0,20,0
1713514389340,LIIT 5CS,A00,507432,Carnelos; Chiara,20,0,20,0
1713514390373,LISP 5A,A00,507541,Munoz Sanchez; Alicia,14,0,20,6
1713514391398,LISP 5B,A00,507671,Munoz Sanchez; Alicia,12,0,20,8
1713514392425,LISP 5C,A00,507696,Munoz Sanchez; Alicia,11,0,20,9
1713514393449,MAE 197,001,528363,Boechler; Nicholas Sebastia,9998,0,9999,1
1713514394481,MATH 197,001,523477,Kedlaya; Kiran S.,9999,0,9999,0
1713514394481,MATH 197,002,563811,Zhang; Danna,9998,0,9999,1
1713514395510,MCWP 40R,A00,518780,Staff,13,0,20,7
1713514395510,MCWP 40R,B00,518781,Staff,11,0,20,9
1713514395510,MCWP 40R,C00,518783,Staff,8,0,20,12
1713514396535,MCWP 50R,A00,518791,Staff,7,0,20,13
1713514396535,MCWP 50R,B00,518792,Staff,3,0,20,17
1713514396535,MCWP 50R,C00,518793,Staff,5,0,20,15
1713514396535,MCWP 50R,D00,518794,Staff,0,0,20,20
1713514396535,MCWP 50R,E00,518795,Staff,0,0,20,20
1713514396535,MCWP 50R,F00,518796,Staff,10,0,20,10
1713514396535,MCWP 50R,G00,518797,Staff,10,0,20,10
1713514397561,MMW 12R,A01,514034,Herbst; Matthew,1,0,16,15
1713514397561,MMW 12R,A02,514035,Herbst; Matthew,13,0,16,3
1713514398591,MMW 13R,A01,514037,Staff,0,8,16,16
1713514398591,MMW 13R,A02,514039,Staff,0,7,16,16
1713514400645,SIO 295LS,A00,523233,Staff,15,0,30,15
1713514401682,SIO 295S,A00,523232,Staff,15,0,30,15
1713514402708,SOCI 117,A01,494376,Staff,0,2,5,5
1713514403734,WES 237B,A00,494380,Staff,19,0,20,1
1713514405794,AESE 279B,A00,494370,Wade; Jon P,33,0,33,0
1713514406824,AIP 197,001,627712,Vespa; Emanuel Ignacio,9999,0,9999,0
1713514407850,ANAR 135S,A00,494369,Braswell; Geoffrey E.,0,0,0,0
1713514408882,CAT 124RS,A01,519847,Geibel; William,6,0,20,14
1713514409911,CAT 125RS,A01,515971,Geibel; William,6,0,20,14
1713514410948,CLRE 250,A00,511389,Morris; Sheldon,9996,0,9999,3
1713514411972,CLRE 251,A00,507176,Mehta; Ravindra L.,9996,0,9999,3
1713514411972,CLRE 251,B00,511410,Mehta; Ravindra L.,9998,0,9999,1
1713514412997,CLRE 252,A00,507189,Cuomo; Raphael Eduardo,9998,0,9999,1
1713514414023,CLRE 253,A00,507199,Vaida; Florin,9997,0,9999,2
1713514414023,CLRE 253,B00,507202,Vaida; Florin,9999,0,9999,0
1713514415049,CLRE 259,A00,507211,Patel; Hemal,9996,0,9999,3
1713514416077,CLRE 260,A00,507221,Cuomo; Raphael Eduardo,9999,0,9999,0
1713514417102,CLRE 297,001,507242,Cuomo; Raphael Eduardo,9999,0,9999,0
1713514418128,CSE 191,A00,516875,Minnes Kemp; Mor Mia,9999,0,9999,0
1713514419161,CSS 201S,A01,494383,Staff,35,0,35,0
1713514420188,CSS 202S,A01,494387,Staff,35,0,35,0
1713514421271,EAP 100,A00,516065,Staff,9792,0,9999,207
1713514422302,ECE 45,A01,507414,Staff,37,0,60,23
1713514423328,ECE 100,A01,507416,Baghdadchi; Saharnaz,0,0,20,20
1713514423328,ECE 100,A02,507418,Baghdadchi; Saharnaz,19,0,20,1
1713514424355,ECE 111,A01,507420,Staff,27,0,50,23
1713514425383,ECE 197,001,548057,Sievenpiper; Daniel F.,9998,0,9999,1
1713514426409,EDS 115,A00,507243,Choi; Bailey Miyeon,27,0,28,1
1713514427435,EDS 117,A01,494379,Staff,15,0,25,10
1713514428460,EDS 125,A00,507246,Hopkins; Megan Beth,27,0,30,3
1713514429486,EDS 128A,A01,507264,Fargason; Sharon Gayle,26,0,26,0
1713514430512,EDS 128B,A01,507293,Pappas; Elizabeth,30,0,30,0
1713514431537,EDS 139,A00,507294,Fargason; Sharon Gayle,30,0,30,0
1713514431537,EDS 139,B00,507313,Pappas; Elizabeth,30,0,30,0
1713514432563,EDS 201,A00,507315,Staff,18,0,30,12
1713514433594,EDS 203,A01,507317,Halter; Christopher P.,17,0,30,13
1713514434620,EDS 204R,A01,507319,Halter; Christopher P.,0,1,30,30
1713514434620,EDS 204R,B01,507331,Heinzman; Erica M.,22,0,30,8
1713514435651,EDS 206R,A00,507332,Staff,0,2,30,30
1713514435651,EDS 206R,B00,507343,Staff,23,0,30,7
1713514436678,EDS 250,A00,507344,Hemans; Patricia Ann Benitez,27,0,40,13
1713514437705,EDS 281,A00,507345,Daly; Alan J.,18,0,18,0
1713514438736,EDS 284,A00,507350,Daly; Alan J.,16,0,16,0
1713514439766,EDS 286,A00,507359,Fine; Sarah,18,0,18,0
1713514440792,EDS 289C,A01,507361,Daly; Alan J.,18,0,18,0
1713514441823,EDS 290,A00,507366,Hofstetter; Carolyn,15,0,15,0
1713514442855,LIGM 5A,A00,507421,Fischer-Grunski; Eva K,20,0,20,0
1713514443881,LIGM 5B,A00,507423,Fischer-Grunski; Eva K,20,0,20,0
1713514444905,LIGM 5C,A00,507425,Fischer-Grunski; Eva K,20,0,20,0
1713514445930,LIIT 5AS,A00,507427,Carnelos; Chiara,20,0,20,0
1713514446956,LIIT 5BS,A00,507430,Carnelos; Chiara,20,0,20,0
1713514447983,LIIT 5CS,A00,507432,Carnelos; Chiara,20,0,20,0
1713514449016,LISP 5A,A00,507541,Munoz Sanchez; Alicia,14,0,20,6
1713514450042,LISP 5B,A00,507671,Munoz Sanchez; Alicia,12,0,20,8
1713514451067,LISP 5C,A00,507696,Munoz Sanchez; Alicia,11,0,20,9
1713514452093,MAE 197,001,528363,Boechler; Nicholas Sebastia,9998,0,9999,1
1713514453119,MATH 197,001,523477,Kedlaya; Kiran S.,9999,0,9999,0
1713514453119,MATH 197,002,563811,Zhang; Danna,9998,0,9999,1
1713514454144,MCWP 40R,A00,518780,Staff,13,0,20,7
1713514454144,MCWP 40R,B00,518781,Staff,11,0,20,9
1713514454144,MCWP 40R,C00,518783,Staff,8,0,20,12
1713514455170,MCWP 50R,A00,518791,Staff,7,0,20,13
1713514455170,MCWP 50R,B00,518792,Staff,3,0,20,17
1713514455170,MCWP 50R,C00,518793,Staff,5,0,20,15
1713514455170,MCWP 50R,D00,518794,Staff,0,0,20,20
1713514455170,MCWP 50R,E00,518795,Staff,0,0,20,20
1713514455170,MCWP 50R,F00,518796,Staff,10,0,20,10
1713514455170,MCWP 50R,G00,518797,Staff,10,0,20,10
1713514456198,MMW 12R,A01,514034,Herbst; Matthew,1,0,16,15
1713514456198,MMW 12R,A02,514035,Herbst; Matthew,13,0,16,3
1713514457225,MMW 13R,A01,514037,Staff,0,8,16,16
1713514457225,MMW 13R,A02,514039,Staff,0,7,16,16
1713514459283,SIO 295LS,A00,523233,Staff,15,0,30,15
1713514460308,SIO 295S,A00,523232,Staff,15,0,30,15
1713514461335,SOCI 117,A01,494376,Staff,0,2,5,5
1713514462361,WES 237B,A00,494380,Staff,19,0,20,1
1713514464442,AESE 279B,A00,494370,Wade; Jon P,33,0,33,0
1713514465468,AIP 197,001,627712,Vespa; Emanuel Ignacio,9999,0,9999,0
1713514466497,ANAR 135S,A00,494369,Braswell; Geoffrey E.,0,0,0,0
1713514467525,CAT 124RS,A01,519847,Geibel; William,6,0,20,14
1713514468557,CAT 125RS,A01,515971,Geibel; William,6,0,20,14
1713514469582,CLRE 250,A00,511389,Morris; Sheldon,9996,0,9999,3
1713514470609,CLRE 251,A00,507176,Mehta; Ravindra L.,9996,0,9999,3
1713514470609,CLRE 251,B00,511410,Mehta; Ravindra L.,9998,0,9999,1
1713514471640,CLRE 252,A00,507189,Cuomo; Raphael Eduardo,9998,0,9999,1
1713514472666,CLRE 253,A00,507199,Vaida; Florin,9997,0,9999,2
1713514472666,CLRE 253,B00,507202,Vaida; Florin,9999,0,9999,0
1713514473696,CLRE 259,A00,507211,Patel; Hemal,9996,0,9999,3
1713514474721,CLRE 260,A00,507221,Cuomo; Raphael Eduardo,9999,0,9999,0
1713514475751,CLRE 297,001,507242,Cuomo; Raphael Eduardo,9999,0,9999,0
1713514476776,CSE 191,A00,516875,Minnes Kemp; Mor Mia,9999,0,9999,0
1713514477803,CSS 201S,A01,494383,Staff,35,0,35,0
1713514478831,CSS 202S,A01,494387,Staff,35,0,35,0
1713514479858,EAP 100,A00,516065,Staff,9792,0,9999,207
1713514480889,ECE 45,A01,507414,Staff,37,0,60,23
1713514481923,ECE 100,A01,507416,Baghdadchi; Saharnaz,0,0,20,20
1713514481923,ECE 100,A02,507418,Baghdadchi; Saharnaz,19,0,20,1
1713514482947,ECE 111,A01,507420,Staff,27,0,50,23
1713514483974,ECE 197,001,548057,Sievenpiper; Daniel F.,9998,0,9999,1
1713514485007,EDS 115,A00,507243,Choi; Bailey Miyeon,27,0,28,1
1713514486035,EDS 117,A01,494379,Staff,15,0,25,10
1713514487067,EDS 125,A00,507246,Hopkins; Megan Beth,27,0,30,3
1713514488096,EDS 128A,A01,507264,Fargason; Sharon Gayle,26,0,26,0
1713514489127,EDS 128B,A01,507293,Pappas; Elizabeth,30,0,30,0
1713514490157,EDS 139,A00,507294,Fargason; Sharon Gayle,30,0,30,0
1713514490157,EDS 139,B00,507313,Pappas; Elizabeth,30,0,30,0
1713514491183,EDS 201,A00,507315,Staff,18,0,30,12
1713514492215,EDS 203,A01,507317,Halter; Christopher P.,17,0,30,13
1713514493241,EDS 204R,A01,507319,Halter; Christopher P.,0,1,30,30
1713514493241,EDS 204R,B01,507331,Heinzman; Erica M.,22,0,30,8
1713514494267,EDS 206R,A00,507332,Staff,0,2,30,30
1713514494267,EDS 206R,B00,507343,Staff,23,0,30,7
1713514495297,EDS 250,A00,507344,Hemans; Patricia Ann Benitez,27,0,40,13
1713514496328,EDS 281,A00,507345,Daly; Alan J.,18,0,18,0
1713514497358,EDS 284,A00,507350,Daly; Alan J.,16,0,16,0
1713514498384,EDS 286,A00,507359,Fine; Sarah,18,0,18,0
1713514499410,EDS 289C,A01,507361,Daly; Alan J.,18,0,18,0
1713514500435,EDS 290,A00,507366,Hofstetter; Carolyn,15,0,15,0
1713514501461,LIGM 5A,A00,507421,Fischer-Grunski; Eva K,20,0,20,0
1713514502485,LIGM 5B,A00,507423,Fischer-Grunski; Eva K,20,0,20,0
1713514503511,LIGM 5C,A00,507425,Fischer-Grunski; Eva K,20,0,20,0
1713514504542,LIIT 5AS,A00,507427,Carnelos; Chiara,20,0,20,0
1713514505574,LIIT 5BS,A00,507430,Carnelos; Chiara,20,0,20,0
1713514506603,LIIT 5CS,A00,507432,Carnelos; Chiara,20,0,20,0
1713514507633,LISP 5A,A00,507541,Munoz Sanchez; Alicia,14,0,20,6
1713514508665,LISP 5B,A00,507671,Munoz Sanchez; Alicia,12,0,20,8
1713514509690,LISP 5C,A00,507696,Munoz Sanchez; Alicia,11,0,20,9
1713514510722,MAE 197,001,528363,Boechler; Nicholas Sebastia,9998,0,9999,1
1713514511748,MATH 197,001,523477,Kedlaya; Kiran S.,9999,0,9999,0
1713514511748,MATH 197,002,563811,Zhang; Danna,9998,0,9999,1
1713514512775,MCWP 40R,A00,518780,Staff,13,0,20,7
1713514512775,MCWP 40R,B00,518781,Staff,11,0,20,9
1713514512775,MCWP 40R,C00,518783,Staff,8,0,20,12
1713514513802,MCWP 50R,A00,518791,Staff,7,0,20,13
1713514513802,MCWP 50R,B00,518792,Staff,3,0,20,17
1713514513802,MCWP 50R,C00,518793,Staff,5,0,20,15
1713514513802,MCWP 50R,D00,518794,Staff,0,0,20,20
1713514513802,MCWP 50R,E00,518795,Staff,0,0,20,20
1713514513802,MCWP 50R,F00,518796,Staff,10,0,20,10
1713514513802,MCWP 50R,G00,518797,Staff,10,0,20,10
1713514514828,MMW 12R,A01,514034,Herbst; Matthew,1,0,16,15
1713514514828,MMW 12R,A02,514035,Herbst; Matthew,13,0,16,3
1713514515858,MMW 13R,A01,514037,Staff,0,8,16,16
1713514515858,MMW 13R,A02,514039,Staff,0,7,16,16
1713514517922,SIO 295LS,A00,523233,Staff,15,0,30,15
1713514518952,SIO 295S,A00,523232,Staff,15,0,30,15
1713514519978,SOCI 117,A01,494376,Staff,0,2,5,5
1713514521098,WES 237B,A00,494380,Staff,19,0,20,1
1713514523170,AESE 279B,A00,494370,Wade; Jon P,33,0,33,0
1713514524195,AIP 197,001,627712,Vespa; Emanuel Ignacio,9999,0,9999,0
1713514525275,ANAR 135S,A00,494369,Braswell; Geoffrey E.,0,0,0,0
1713514526301,CAT 124RS,A01,519847,Geibel; William,6,0,20,14
1713514527328,CAT 125RS,A01,515971,Geibel; William,6,0,20,14
1713514528382,CLRE 250,A00,511389,Morris; Sheldon,9996,0,9999,3
1713514529407,CLRE 251,A00,507176,Mehta; Ravindra L.,9996,0,9999,3
1713514529407,CLRE 251,B00,511410,Mehta; Ravindra L.,9998,0,9999,1
1713514530433,CLRE 252,A00,507189,Cuomo; Raphael Eduardo,9998,0,9999,1
1713514531459,CLRE 253,A00,507199,Vaida; Florin,9997,0,9999,2
1713514531459,CLRE 253,B00,507202,Vaida; Florin,9999,0,9999,0
1713514532490,CLRE 259,A00,507211,Patel; Hemal,9996,0,9999,3
1713514533518,CLRE 260,A00,507221,Cuomo; Raphael Eduardo,9999,0,9999,0
1713514534548,CLRE 297,001,507242,Cuomo; Raphael Eduardo,9999,0,9999,0
1713514535573,CSE 191,A00,516875,Minnes Kemp; Mor Mia,9999,0,9999,0
1713514536598,CSS 201S,A01,494383,Staff,35,0,35,0
1713514537622,CSS 202S,A01,494387,Staff,35,0,35,0
1713514538648,EAP 100,A00,516065,Staff,9792,0,9999,207
1713514539676,ECE 45,A01,507414,Staff,37,0,60,23
1713514540703,ECE 100,A01,507416,Baghdadchi; Saharnaz,0,0,20,20
1713514540703,ECE 100,A02,507418,Baghdadchi; Saharnaz,19,0,20,1
1713514541729,ECE 111,A01,507420,Staff,27,0,50,23
1713514542759,ECE 197,001,548057,Sievenpiper; Daniel F.,9998,0,9999,1
1713514543787,EDS 115,A00,507243,Choi; Bailey Miyeon,27,0,28,1
1713514544819,EDS 117,A01,494379,Staff,15,0,25,10
1713514545845,EDS 125,A00,507246,Hopkins; Megan Beth,27,0,30,3
1713514546874,EDS 128A,A01,507264,Fargason; Sharon Gayle,26,0,26,0
1713514547906,EDS 128B,A01,507293,Pappas; Elizabeth,30,0,30,0
1713514548931,EDS 139,A00,507294,Fargason; Sharon Gayle,30,0,30,0
1713514548931,EDS 139,B00,507313,Pappas; Elizabeth,30,0,30,0
1713514549956,EDS 201,A00,507315,Staff,18,0,30,12
1713514550981,EDS 203,A01,507317,Halter; Christopher P.,17,0,30,13
1713514552008,EDS 204R,A01,507319,Halter; Christopher P.,0,1,30,30
1713514552008,EDS 204R,B01,507331,Heinzman; Erica M.,22,0,30,8
1713514553044,EDS 206R,A00,507332,Staff,0,2,30,30
1713514553044,EDS 206R,B00,507343,Staff,23,0,30,7
1713514554071,EDS 250,A00,507344,Hemans; Patricia Ann Benitez,27,0,40,13
1713514555099,EDS 281,A00,507345,Daly; Alan J.,18,0,18,0
1713514556123,EDS 284,A00,507350,Daly; Alan J.,16,0,16,0
1713514557155,EDS 286,A00,507359,Fine; Sarah,18,0,18,0
1713514558182,EDS 289C,A01,507361,Daly; Alan J.,18,0,18,0
1713514559209,EDS 290,A00,507366,Hofstetter; Carolyn,15,0,15,0
1713514560249,LIGM 5A,A00,507421,Fischer-Grunski; Eva K,20,0,20,0
1713514561276,LIGM 5B,A00,507423,Fischer-Grunski; Eva K,20,0,20,0
1713514562304,LIGM 5C,A00,507425,Fischer-Grunski; Eva K,20,0,20,0
1713514563331,LIIT 5AS,A00,507427,Carnelos; Chiara,20,0,20,0
1713514564356,LIIT 5BS,A00,507430,Carnelos; Chiara,20,0,20,0
1713514565393,LIIT 5CS,A00,507432,Carnelos; Chiara,20,0,20,0
1713514566426,LISP 5A,A00,507541,Munoz Sanchez; Alicia,14,0,20,6
1713514567459,LISP 5B,A00,507671,Munoz Sanchez; Alicia,12,0,20,8
1713514568485,LISP 5C,A00,507696,Munoz Sanchez; Alicia,11,0,20,9
1713514569511,MAE 197,001,528363,Boechler; Nicholas Sebastia,9998,0,9999,1
1713514570537,MATH 197,001,523477,Kedlaya; Kiran S.,9999,0,9999,0
1713514570537,MATH 197,002,563811,Zhang; Danna,9998,0,9999,1
1713514571564,MCWP 40R,A00,518780,Staff,13,0,20,7
1713514571564,MCWP 40R,B00,518781,Staff,11,0,20,9
1713514571564,MCWP 40R,C00,518783,Staff,8,0,20,12
1713514572598,MCWP 50R,A00,518791,Staff,7,0,20,13
1713514572598,MCWP 50R,B00,518792,Staff,3,0,20,17
1713514572598,MCWP 50R,C00,518793,Staff,5,0,20,15
1713514572598,MCWP 50R,D00,518794,Staff,0,0,20,20
1713514572598,MCWP 50R,E00,518795,Staff,0,0,20,20
1713514572598,MCWP 50R,F00,518796,Staff,10,0,20,10
1713514572598,MCWP 50R,G00,518797,Staff,10,0,20,10
1713514573631,MMW 12R,A01,514034,Herbst; Matthew,1,0,16,15
1713514573631,MMW 12R,A02,514035,Herbst; Matthew,13,0,16,3
1713514574660,MMW 13R,A01,514037,Staff,0,8,16,16
1713514574660,MMW 13R,A02,514039,Staff,0,7,16,16
1713514576724,SIO 295LS,A00,523233,Staff,15,0,30,15
1713514577757,SIO 295S,A00,523232,Staff,15,0,30,15
1713514578783,SOCI 117,A01,494376,Staff,0,2,5,5
1713514579808,WES 237B,A00,494380,Staff,19,0,20,1
1713514581920,AESE 279B,A00,494370,Wade; Jon P,33,0,33,0
1713514582948,AIP 197,001,627712,Vespa; Emanuel Ignacio,9999,0,9999,0
1713514583982,ANAR 135S,A00,494369,Braswell; Geoffrey E.,0,0,0,0
1713514585009,CAT 124RS,A01,519847,Geibel; William,6,0,20,14
1713514586035,CAT 125RS,A01,515971,Geibel; William,6,0,20,14
1713514587068,CLRE 250,A00,511389,Morris; Sheldon,9996,0,9999,3
1713514588095,CLRE 251,A00,507176,Mehta; Ravindra L.,9996,0,9999,3
1713514588095,CLRE 251,B00,511410,Mehta; Ravindra L.,9998,0,9999,1
1713514589126,CLRE 252,A00,507189,Cuomo; Raphael Eduardo,9998,0,9999,1
1713514590161,CLRE 253,A00,507199,Vaida; Florin,9997,0,9999,2
1713514590161,CLRE 253,B00,507202,Vaida; Florin,9999,0,9999,0
1713514591186,CLRE 259,A00,507211,Patel; Hemal,9996,0,9999,3
1713514592217,CLRE 260,A00,507221,Cuomo; Raphael Eduardo,9999,0,9999,0
1713514593250,CLRE 297,001,507242,Cuomo; Raphael Eduardo,9999,0,9999,0
1713514594280,CSE 191,A00,516875,Minnes Kemp; Mor Mia,9999,0,9999,0
1713514595313,CSS 201S,A01,494383,Staff,35,0,35,0
1713514596338,CSS 202S,A01,494387,Staff,35,0,35,0
1713514597369,EAP 100,A00,516065,Staff,9792,0,9999,207
1713514598393,ECE 45,A01,507414,Staff,37,0,60,23
1713514599426,ECE 100,A01,507416,Baghdadchi; Saharnaz,0,0,20,20
1713514599426,ECE 100,A02,507418,Baghdadchi; Saharnaz,19,0,20,1
1713514600457,ECE 111,A01,507420,Staff,27,0,50,23
1713514601482,ECE 197,001,548057,Sievenpiper; Daniel F.,9998,0,9999,1
1713514602508,EDS 115,A00,507243,Choi; Bailey Miyeon,27,0,28,1
1713514603534,EDS 117,A01,494379,Staff,15,0,25,10
1713514604563,EDS 125,A00,507246,Hopkins; Megan Beth,27,0,30,3
1713514605594,EDS 128A,A01,507264,Fargason; Sharon Gayle,26,0,26,0
1713514606625,EDS 128B,A01,507293,Pappas; Elizabeth,30,0,30,0
1713514607650,EDS 139,A00,507294,Fargason; Sharon Gayle,30,0,30,0
1713514607650,EDS 139,B00,507313,Pappas; Elizabeth,30,0,30,0
1713514608679,EDS 201,A00,507315,Staff,18,0,30,12
1713514609712,EDS 203,A01,507317,Halter; Christopher P.,17,0,30,13
1713514610739,EDS 204R,A01,507319,Halter; Christopher P.,0,1,30,30
1713514610739,EDS 204R,B01,507331,Heinzman; Erica M.,22,0,30,8
1713514611770,EDS 206R,A00,507332,Staff,0,2,30,30
1713514611770,EDS 206R,B00,507343,Staff,23,0,30,7
1713514612796,EDS 250,A00,507344,Hemans; Patricia Ann Benitez,27,0,40,13
1713514613822,EDS 281,A00,507345,Daly; Alan J.,18,0,18,0
1713514614848,EDS 284,A00,507350,Daly; Alan J.,16,0,16,0
1713514615875,EDS 286,A00,507359,Fine; Sarah,18,0,18,0
1713514616901,EDS 289C,A01,507361,Daly; Alan J.,18,0,18,0
1713514617928,EDS 290,A00,507366,Hofstetter; Carolyn,15,0,15,0
1713514618960,LIGM 5A,A00,507421,Fischer-Grunski; Eva K,20,0,20,0
1713514619985,LIGM 5B,A00,507423,Fischer-Grunski; Eva K,20,0,20,0
1713514621019,LIGM 5C,A00,507425,Fischer-Grunski; Eva K,20,0,20,0
1713514622043,LIIT 5AS,A00,507427,Carnelos; Chiara,20,0,20,0
1713514623087,LIIT 5BS,A00,507430,Carnelos; Chiara,20,0,20,0
1713514624114,LIIT 5CS,A00,507432,Carnelos; Chiara,20,0,20,0
1713514625151,LISP 5A,A00,507541,Munoz Sanchez; Alicia,14,0,20,6
1713514626176,LISP 5B,A00,507671,Munoz Sanchez; Alicia,12,0,20,8
1713514627207,LISP 5C,A00,507696,Munoz Sanchez; Alicia,11,0,20,9
1713514628236,MAE 197,001,528363,Boechler; Nicholas Sebastia,9998,0,9999,1
1713514629317,MATH 197,001,523477,Kedlaya; Kiran S.,9999,0,9999,0
1713514629317,MATH 197,002,563811,Zhang; Danna,9998,0,9999,1
1713514630343,MCWP 40R,A00,518780,Staff,13,0,20,7
1713514630343,MCWP 40R,B00,518781,Staff,11,0,20,9
1713514630343,MCWP 40R,C00,518783,Staff,8,0,20,12
1713514631370,MCWP 50R,A00,518791,Staff,7,0,20,13
1713514631370,MCWP 50R,B00,518792,Staff,3,0,20,17
1713514631370,MCWP 50R,C00,518793,Staff,5,0,20,15
1713514631370,MCWP 50R,D00,518794,Staff,0,0,20,20
1713514631370,MCWP 50R,E00,518795,Staff,0,0,20,20
1713514631370,MCWP 50R,F00,518796,Staff,10,0,20,10
1713514631370,MCWP 50R,G00,518797,Staff,10,0,20,10
1713514632396,MMW 12R,A01,514034,Herbst; Matthew,1,0,16,15
1713514632396,MMW 12R,A02,514035,Herbst; Matthew,13,0,16,3
1713514633426,MMW 13R,A01,514037,Staff,0,8,16,16
1713514633426,MMW 13R,A02,514039,Staff,0,7,16,16
1713514635484,SIO 295LS,A00,523233,Staff,15,0,30,15
1713514636509,SIO 295S,A00,523232,Staff,15,0,30,15
1713514637543,SOCI 117,A01,494376,Staff,0,2,5,5
1713514638567,WES 237B,A00,494380,Staff,19,0,20,1
1713514640633,AESE 279B,A00,494370,Wade; Jon P,33,0,33,0
1713514641659,AIP 197,001,627712,Vespa; Emanuel Ignacio,9999,0,9999,0
1713514642689,ANAR 135S,A00,494369,Braswell; Geoffrey E.,0,0,0,0
1713514643720,CAT 124RS,A01,519847,Geibel; William,6,0,20,14
1713514644747,CAT 125RS,A01,515971,Geibel; William,6,0,20,14
1713514645773,CLRE 250,A00,511389,Morris; Sheldon,9996,0,9999,3
1713514646800,CLRE 251,A00,507176,Mehta; Ravindra L.,9996,0,9999,3
1713514646800,CLRE 251,B00,511410,Mehta; Ravindra L.,9998,0,9999,1
1713514647825,CLRE 252,A00,507189,Cuomo; Raphael Eduardo,9998,0,9999,1
1713514648852,CLRE 253,A00,507199,Vaida; Florin,9997,0,9999,2
1713514648852,CLRE 253,B00,507202,Vaida; Florin,9999,0,9999,0
1713514649877,CLRE 259,A00,507211,Patel; Hemal,9996,0,9999,3
1713514650905,CLRE 260,A00,507221,Cuomo; Raphael Eduardo,9999,0,9999,0
1713514651933,CLRE 297,001,507242,Cuomo; Raphael Eduardo,9999,0,9999,0
1713514652962,CSE 191,A00,516875,Minnes Kemp; Mor Mia,9999,0,9999,0
1713514653995,CSS 201S,A01,494383,Staff,35,0,35,0
1713514655028,CSS 202S,A01,494387,Staff,35,0,35,0
1713514656053,EAP 100,A00,516065,Staff,9792,0,9999,207
1713514657084,ECE 45,A01,507414,Staff,37,0,60,23
1713514658109,ECE 100,A01,507416,Baghdadchi; Saharnaz,0,0,20,20
1713514658109,ECE 100,A02,507418,Baghdadchi; Saharnaz,19,0,20,1
1713514659136,ECE 111,A01,507420,Staff,27,0,50,23
1713514660161,ECE 197,001,548057,Sievenpiper; Daniel F.,9998,0,9999,1
1713514661187,EDS 115,A00,507243,Choi; Bailey Miyeon,27,0,28,1
1713514662213,EDS 117,A01,494379,Staff,15,0,25,10
1713514663238,EDS 125,A00,507246,Hopkins; Megan Beth,27,0,30,3
1713514664265,EDS 128A,A01,507264,Fargason; Sharon Gayle,26,0,26,0
1713514665297,EDS 128B,A01,507293,Pappas; Elizabeth,30,0,30,0
1713514666323,EDS 139,A00,507294,Fargason; Sharon Gayle,30,0,30,0
1713514666323,EDS 139,B00,507313,Pappas; Elizabeth,30,0,30,0
1713514667353,EDS 201,A00,507315,Staff,18,0,30,12
1713514668388,EDS 203,A01,507317,Halter; Christopher P.,17,0,30,13
1713514669412,EDS 204R,A01,507319,Halter; Christopher P.,0,1,30,30
1713514669412,EDS 204R,B01,507331,Heinzman; Erica M.,22,0,30,8
1713514670444,EDS 206R,A00,507332,Staff,0,2,30,30
1713514670444,EDS 206R,B00,507343,Staff,23,0,30,7
1713514671475,EDS 250,A00,507344,Hemans; Patricia Ann Benitez,27,0,40,13
1713514672501,EDS 281,A00,507345,Daly; Alan J.,18,0,18,0
1713514673526,EDS 284,A00,507350,Daly; Alan J.,16,0,16,0
1713514674556,EDS 286,A00,507359,Fine; Sarah,18,0,18,0
1713514675581,EDS 289C,A01,507361,Daly; Alan J.,18,0,18,0
1713514676607,EDS 290,A00,507366,Hofstetter; Carolyn,15,0,15,0
1713514677640,LIGM 5A,A00,507421,Fischer-Grunski; Eva K,20,0,20,0
1713514678665,LIGM 5B,A00,507423,Fischer-Grunski; Eva K,20,0,20,0
1713514679692,LIGM 5C,A00,507425,Fischer-Grunski; Eva K,20,0,20,0
1713514680717,LIIT 5AS,A00,507427,Carnelos; Chiara,20,0,20,0
1713514681749,LIIT 5BS,A00,507430,Carnelos; Chiara,20,0,20,0
1713514682784,LIIT 5CS,A00,507432,Carnelos; Chiara,20,0,20,0
1713514683816,LISP 5A,A00,507541,Munoz Sanchez; Alicia,14,0,20,6
1713514684842,LISP 5B,A00,507671,Munoz Sanchez; Alicia,12,0,20,8
1713514685868,LISP 5C,A00,507696,Munoz Sanchez; Alicia,11,0,20,9
1713514686898,MAE 197,001,528363,Boechler; Nicholas Sebastia,9998,0,9999,1
1713514687925,MATH 197,001,523477,Kedlaya; Kiran S.,9999,0,9999,0
1713514687925,MATH 197,002,563811,Zhang; Danna,9998,0,9999,1
1713514688949,MCWP 40R,A00,518780,Staff,13,0,20,7
1713514688949,MCWP 40R,B00,518781,Staff,11,0,20,9
1713514688949,MCWP 40R,C00,518783,Staff,8,0,20,12
1713514689976,MCWP 50R,A00,518791,Staff,7,0,20,13
1713514689976,MCWP 50R,B00,518792,Staff,3,0,20,17
1713514689976,MCWP 50R,C00,518793,Staff,5,0,20,15
1713514689976,MCWP 50R,D00,518794,Staff,0,0,20,20
1713514689976,MCWP 50R,E00,518795,Staff,0,0,20,20
1713514689976,MCWP 50R,F00,518796,Staff,10,0,20,10
1713514689976,MCWP 50R,G00,518797,Staff,10,0,20,10
1713514691001,MMW 12R,A01,514034,Herbst; Matthew,1,0,16,15
1713514691001,MMW 12R,A02,514035,Herbst; Matthew,13,0,16,3
1713514692030,MMW 13R,A01,514037,Staff,0,8,16,16
1713514692030,MMW 13R,A02,514039,Staff,0,7,16,16
1713514694086,SIO 295LS,A00,523233,Staff,15,0,30,15
1713514695115,SIO 295S,A00,523232,Staff,15,0,30,15
1713514696141,SOCI 117,A01,494376,Staff,0,2,5,5
1713514697167,WES 237B,A00,494380,Staff,19,0,20,1
1713514699258,AESE 279B,A00,494370,Wade; Jon P,33,0,33,0
1713514700286,AIP 197,001,627712,Vespa; Emanuel Ignacio,9999,0,9999,0
1713514701313,ANAR 135S,A00,494369,Braswell; Geoffrey E.,0,0,0,0
1713514702339,CAT 124RS,A01,519847,Geibel; William,6,0,20,14
1713514703365,CAT 125RS,A01,515971,Geibel; William,6,0,20,14
1713514704391,CLRE 250,A00,511389,Morris; Sheldon,9996,0,9999,3
1713514705415,CLRE 251,A00,507176,Mehta; Ravindra L.,9996,0,9999,3
1713514705415,CLRE 251,B00,511410,Mehta; Ravindra L.,9998,0,9999,1
1713514706441,CLRE 252,A00,507189,Cuomo; Raphael Eduardo,9998,0,9999,1
1713514707475,CLRE 253,A00,507199,Vaida; Florin,9997,0,9999,2
1713514707475,CLRE 253,B00,507202,Vaida; Florin,9999,0,9999,0
1713514708506,CLRE 259,A00,507211,Patel; Hemal,9996,0,9999,3
1713514709533,CLRE 260,A00,507221,Cuomo; Raphael Eduardo,9999,0,9999,0
1713514710558,CLRE 297,001,507242,Cuomo; Raphael Eduardo,9999,0,9999,0
1713514711588,CSE 191,A00,516875,Minnes Kemp; Mor Mia,9999,0,9999,0
1713514712616,CSS 201S,A01,494383,Staff,35,0,35,0
1713514713642,CSS 202S,A01,494387,Staff,35,0,35,0
1713514714667,EAP 100,A00,516065,Staff,9792,0,9999,207
1713514715697,ECE 45,A01,507414,Staff,37,0,60,23
1713514716727,ECE 100,A01,507416,Baghdadchi; Saharnaz,0,0,20,20
1713514716727,ECE 100,A02,507418,Baghdadchi; Saharnaz,19,0,20,1
1713514717752,ECE 111,A01,507420,Staff,27,0,50,23
1713514718778,ECE 197,001,548057,Sievenpiper; Daniel F.,9998,0,9999,1
1713514719808,EDS 115,A00,507243,Choi; Bailey Miyeon,27,0,28,1
1713514720834,EDS 117,A01,494379,Staff,15,0,25,10
1713514721864,EDS 125,A00,507246,Hopkins; Megan Beth,27,0,30,3
1713514722895,EDS 128A,A01,507264,Fargason; Sharon Gayle,26,0,26,0
1713514723924,EDS 128B,A01,507293,Pappas; Elizabeth,30,0,30,0
1713514724951,EDS 139,A00,507294,Fargason; Sharon Gayle,30,0,30,0
1713514724951,EDS 139,B00,507313,Pappas; Elizabeth,30,0,30,0
1713514725976,EDS 201,A00,507315,Staff,18,0,30,12
1713514727004,EDS 203,A01,507317,Halter; Christopher P.,17,0,30,13
1713514728032,EDS 204R,A01,507319,Halter; Christopher P.,0,1,30,30
1713514728032,EDS 204R,B01,507331,Heinzman; Erica M.,22,0,30,8
1713514729057,EDS 206R,A00,507332,Staff,0,2,30,30
1713514729057,EDS 206R,B00,507343,Staff,23,0,30,7
1713514730083,EDS 250,A00,507344,Hemans; Patricia Ann Benitez,27,0,40,13
1713514731109,EDS 281,A00,507345,Daly; Alan J.,18,0,18,0
1713514732136,EDS 284,A00,507350,Daly; Alan J.,16,0,16,0
1713514733215,EDS 286,A00,507359,Fine; Sarah,18,0,18,0
1713514734246,EDS 289C,A01,507361,Daly; Alan J.,18,0,18,0
1713514735272,EDS 290,A00,507366,Hofstetter; Carolyn,15,0,15,0
1713514736305,LIGM 5A,A00,507421,Fischer-Grunski; Eva K,20,0,20,0
1713514737336,LIGM 5B,A00,507423,Fischer-Grunski; Eva K,20,0,20,0
1713514738368,LIGM 5C,A00,507425,Fischer-Grunski; Eva K,20,0,20,0
1713514739400,LIIT 5AS,A00,507427,Carnelos; Chiara,20,0,20,0
1713514740448,LIIT 5BS,A00,507430,Carnelos; Chiara,20,0,20,0
1713514741478,LIIT 5CS,A00,507432,Carnelos; Chiara,20,0,20,0
1713514742505,LISP 5A,A00,507541,Munoz Sanchez; Alicia,14,0,20,6
1713514743531,LISP 5B,A00,507671,Munoz Sanchez; Alicia,12,0,20,8
1713514744557,LISP 5C,A00,507696,Munoz Sanchez; Alicia,11,0,20,9
1713514745586,MAE 197,001,528363,Boechler; Nicholas Sebastia,9998,0,9999,1
1713514746620,MATH 197,001,523477,Kedlaya; Kiran S.,9999,0,9999,0
1713514746620,MATH 197,002,563811,Zhang; Danna,9998,0,9999,1
1713514747645,MCWP 40R,A00,518780,Staff,13,0,20,7
1713514747645,MCWP 40R,B00,518781,Staff,11,0,20,9
1713514747645,MCWP 40R,C00,518783,Staff,8,0,20,12
1713514748671,MCWP 50R,A00,518791,Staff,7,0,20,13
1713514748671,MCWP 50R,B00,518792,Staff,3,0,20,17
1713514748671,MCWP 50R,C00,518793,Staff,5,0,20,15
1713514748671,MCWP 50R,D00,518794,Staff,0,0,20,20
1713514748671,MCWP 50R,E00,518795,Staff,0,0,20,20
1713514748671,MCWP 50R,F00,518796,Staff,10,0,20,10
1713514748671,MCWP 50R,G00,518797,Staff,10,0,20,10
1713514749704,MMW 12R,A01,514034,Herbst; Matthew,1,0,16,15
1713514749704,MMW 12R,A02,514035,Herbst; Matthew,13,0,16,3
1713514750734,MMW 13R,A01,514037,Staff,0,8,16,16
1713514750734,MMW 13R,A02,514039,Staff,0,7,16,16
1713514752790,SIO 295LS,A00,523233,Staff,15,0,30,15
1713514753815,SIO 295S,A00,523232,Staff,15,0,30,15
1713514754841,SOCI 117,A01,494376,Staff,0,2,5,5
1713514755868,WES 237B,A00,494380,Staff,19,0,20,1
1713514757933,AESE 279B,A00,494370,Wade; Jon P,33,0,33,0
1713514758964,AIP 197,001,627712,Vespa; Emanuel Ignacio,9999,0,9999,0
1713514759998,ANAR 135S,A00,494369,Braswell; Geoffrey E.,0,0,0,0
1713514761024,CAT 124RS,A01,519847,Geibel; William,6,0,20,14
1713514762061,CAT 125RS,A01,515971,Geibel; William,6,0,20,14
1713514763087,CLRE 250,A00,511389,Morris; Sheldon,9996,0,9999,3
1713514764114,CLRE 251,A00,507176,Mehta; Ravindra L.,9996,0,9999,3
1713514764114,CLRE 251,B00,511410,Mehta; Ravindra L.,9998,0,9999,1
1713514765155,CLRE 252,A00,507189,Cuomo; Raphael Eduardo,9998,0,9999,1
1713514766191,CLRE 253,A00,507199,Vaida; Florin,9997,0,9999,2
1713514766191,CLRE 253,B00,507202,Vaida; Florin,9999,0,9999,0
1713514767234,CLRE 259,A00,507211,Patel; Hemal,9996,0,9999,3
1713514768266,CLRE 260,A00,507221,Cuomo; Raphael Eduardo,9999,0,9999,0
1713514769292,CLRE 297,001,507242,Cuomo; Raphael Eduardo,9999,0,9999,0
1713514770321,CSE 191,A00,516875,Minnes Kemp; Mor Mia,9999,0,9999,0
1713514771348,CSS 201S,A01,494383,Staff,35,0,35,0
1713514772378,CSS 202S,A01,494387,Staff,35,0,35,0
1713514773404,EAP 100,A00,516065,Staff,9792,0,9999,207
1713514774436,ECE 45,A01,507414,Staff,37,0,60,23
1713514775462,ECE 100,A01,507416,Baghdadchi; Saharnaz,0,0,20,20
1713514775462,ECE 100,A02,507418,Baghdadchi; Saharnaz,19,0,20,1
1713514776490,ECE 111,A01,507420,Staff,27,0,50,23
1713514777516,ECE 197,001,548057,Sievenpiper; Daniel F.,9998,0,9999,1
1713514778541,EDS 115,A00,507243,Choi; Bailey Miyeon,27,0,28,1
1713514779580,EDS 117,A01,494379,Staff,15,0,25,10
1713514780617,EDS 125,A00,507246,Hopkins; Megan Beth,27,0,30,3
1713514781653,EDS 128A,A01,507264,Fargason; Sharon Gayle,26,0,26,0
1713514782686,EDS 128B,A01,507293,Pappas; Elizabeth,30,0,30,0
1713514783744,EDS 139,A00,507294,Fargason; Sharon Gayle,30,0,30,0
1713514783744,EDS 139,B00,507313,Pappas; Elizabeth,30,0,30,0
1713514784776,EDS 201,A00,507315,Staff,18,0,30,12
1713514785800,EDS 203,A01,507317,Halter; Christopher P.,17,0,30,13
1713514786831,EDS 204R,A01,507319,Halter; Christopher P.,0,1,30,30
1713514786831,EDS 204R,B01,507331,Heinzman; Erica M.,22,0,30,8
1713514787857,EDS 206R,A00,507332,Staff,0,2,30,30
1713514787857,EDS 206R,B00,507343,Staff,23,0,30,7
1713514788881,EDS 250,A00,507344,Hemans; Patricia Ann Benitez,27,0,40,13
1713514789907,EDS 281,A00,507345,Daly; Alan J.,18,0,18,0
1713514790933,EDS 284,A00,507350,Daly; Alan J.,16,0,16,0
1713514791961,EDS 286,A00,507359,Fine; Sarah,18,0,18,0
1713514792997,EDS 289C,A01,507361,Daly; Alan J.,18,0,18,0
1713514794034,EDS 290,A00,507366,Hofstetter; Carolyn,15,0,15,0
1713514795061,LIGM 5A,A00,507421,Fischer-Grunski; Eva K,20,0,20,0
1713514796093,LIGM 5B,A00,507423,Fischer-Grunski; Eva K,20,0,20,0
1713514797126,LIGM 5C,A00,507425,Fischer-Grunski; Eva K,20,0,20,0
1713514798152,LIIT 5AS,A00,507427,Carnelos; Chiara,20,0,20,0
1713514799176,LIIT 5BS,A00,507430,Carnelos; Chiara,20,0,20,0
1713514800214,LIIT 5CS,A00,507432,Carnelos; Chiara,20,0,20,0
1713514801240,LISP 5A,A00,507541,Munoz Sanchez; Alicia,14,0,20,6
1713514802265,LISP 5B,A00,507671,Munoz Sanchez; Alicia,12,0,20,8
1713514803291,LISP 5C,A00,507696,Munoz Sanchez; Alicia,11,0,20,9
1713514804323,MAE 197,001,528363,Boechler; Nicholas Sebastia,9998,0,9999,1
1713514805349,MATH 197,001,523477,Kedlaya; Kiran S.,9999,0,9999,0
1713514805349,MATH 197,002,563811,Zhang; Danna,9998,0,9999,1
1713514806376,MCWP 40R,A00,518780,Staff,13,0,20,7
1713514806376,MCWP 40R,B00,518781,Staff,11,0,20,9
1713514806376,MCWP 40R,C00,518783,Staff,8,0,20,12
1713514807402,MCWP 50R,A00,518791,Staff,7,0,20,13
1713514807402,MCWP 50R,B00,518792,Staff,3,0,20,17
1713514807402,MCWP 50R,C00,518793,Staff,5,0,20,15
1713514807402,MCWP 50R,D00,518794,Staff,0,0,20,20
1713514807402,MCWP 50R,E00,518795,Staff,0,0,20,20
1713514807402,MCWP 50R,F00,518796,Staff,10,0,20,10
1713514807402,MCWP 50R,G00,518797,Staff,10,0,20,10
1713514808434,MMW 12R,A01,514034,Herbst; Matthew,1,0,16,15
1713514808434,MMW 12R,A02,514035,Herbst; Matthew,13,0,16,3
1713514809461,MMW 13R,A01,514037,Staff,0,8,16,16
1713514809461,MMW 13R,A02,514039,Staff,0,7,16,16
1713514811520,SIO 295LS,A00,523233,Staff,15,0,30,15
1713514812562,SIO 295S,A00,523232,Staff,15,0,30,15
1713514813589,SOCI 117,A01,494376,Staff,0,2,5,5
1713514814617,WES 237B,A00,494380,Staff,19,0,20,1
1713514816685,AESE 279B,A00,494370,Wade; Jon P,33,0,33,0
1713514817711,AIP 197,001,627712,Vespa; Emanuel Ignacio,9999,0,9999,0
1713514818738,ANAR 135S,A00,494369,Braswell; Geoffrey E.,0,0,0,0
1713514819766,CAT 124RS,A01,519847,Geibel; William,6,0,20,14
1713514820793,CAT 125RS,A01,515971,Geibel; William,6,0,20,14
1713514821818,CLRE 250,A00,511389,Morris; Sheldon,9996,0,9999,3
1713514822845,CLRE 251,A00,507176,Mehta; Ravindra L.,9996,0,9999,3
1713514822845,CLRE 251,B00,511410,Mehta; Ravindra L.,9998,0,9999,1
1713514823872,CLRE 252,A00,507189,Cuomo; Raphael Eduardo,9998,0,9999,1
1713514824897,CLRE 253,A00,507199,Vaida; Florin,9997,0,9999,2
1713514824897,CLRE 253,B00,507202,Vaida; Florin,9999,0,9999,0
1713514825925,CLRE 259,A00,507211,Patel; Hemal,9996,0,9999,3
1713514826949,CLRE 260,A00,507221,Cuomo; Raphael Eduardo,9999,0,9999,0
1713514827980,CLRE 297,001,507242,Cuomo; Raphael Eduardo,9999,0,9999,0
1713514829005,CSE 191,A00,516875,Minnes Kemp; Mor Mia,9999,0,9999,0
1713514830046,CSS 201S,A01,494383,Staff,35,0,35,0
1713514831076,CSS 202S,A01,494387,Staff,35,0,35,0
1713514832101,EAP 100,A00,516065,Staff,9792,0,9999,207
1713514833135,ECE 45,A01,507414,Staff,37,0,60,23
1713514834165,ECE 100,A01,507416,Baghdadchi; Saharnaz,0,0,20,20
1713514834165,ECE 100,A02,507418,Baghdadchi; Saharnaz,19,0,20,1
1713514835197,ECE 111,A01,507420,Staff,27,0,50,23
1713514836222,ECE 197,001,548057,Sievenpiper; Daniel F.,9998,0,9999,1
1713514837303,EDS 115,A00,507243,Choi; Bailey Miyeon,27,0,28,1
1713514838338,EDS 117,A01,494379,Staff,15,0,25,10
1713514839364,EDS 125,A00,507246,Hopkins; Megan Beth,27,0,30,3
1713514840391,EDS 128A,A01,507264,Fargason; Sharon Gayle,26,0,26,0
1713514841417,EDS 128B,A01,507293,Pappas; Elizabeth,30,0,30,0
1713514842449,EDS 139,A00,507294,Fargason; Sharon Gayle,30,0,30,0
1713514842449,EDS 139,B00,507313,Pappas; Elizabeth,30,0,30,0
1713514843473,EDS 201,A00,507315,Staff,18,0,30,12
1713514844504,EDS 203,A01,507317,Halter; Christopher P.,17,0,30,13
1713514845530,EDS 204R,A01,507319,Halter; Christopher P.,0,1,30,30
1713514845530,EDS 204R,B01,507331,Heinzman; Erica M.,22,0,30,8
1713514846559,EDS 206R,A00,507332,Staff,0,2,30,30
1713514846559,EDS 206R,B00,507343,Staff,23,0,30,7
1713514847591,EDS 250,A00,507344,Hemans; Patricia Ann Benitez,27,0,40,13
1713514848622,EDS 281,A00,507345,Daly; Alan J.,18,0,18,0
1713514849647,EDS 284,A00,507350,Daly; Alan J.,16,0,16,0
1713514850674,EDS 286,A00,507359,Fine; Sarah,18,0,18,0
1713514851701,EDS 289C,A01,507361,Daly; Alan J.,18,0,18,0
1713514852733,EDS 290,A00,507366,Hofstetter; Carolyn,15,0,15,0
1713514853768,LIGM 5A,A00,507421,Fischer-Grunski; Eva K,20,0,20,0
1713514854800,LIGM 5B,A00,507423,Fischer-Grunski; Eva K,20,0,20,0
1713514855827,LIGM 5C,A00,507425,Fischer-Grunski; Eva K,20,0,20,0
1713514856855,LIIT 5AS,A00,507427,Carnelos; Chiara,20,0,20,0
1713514857879,LIIT 5BS,A00,507430,Carnelos; Chiara,20,0,20,0
1713514858906,LIIT 5CS,A00,507432,Carnelos; Chiara,20,0,20,0
1713514859930,LISP 5A,A00,507541,Munoz Sanchez; Alicia,14,0,20,6
1713514860962,LISP 5B,A00,507671,Munoz Sanchez; Alicia,12,0,20,8
1713514861995,LISP 5C,A00,507696,Munoz Sanchez; Alicia,11,0,20,9
1713514863034,MAE 197,001,528363,Boechler; Nicholas Sebastia,9998,0,9999,1
1713514864065,MATH 197,001,523477,Kedlaya; Kiran S.,9999,0,9999,0
1713514864065,MATH 197,002,563811,Zhang; Danna,9998,0,9999,1
1713514865092,MCWP 40R,A00,518780,Staff,13,0,20,7
1713514865092,MCWP 40R,B00,518781,Staff,11,0,20,9
1713514865092,MCWP 40R,C00,518783,Staff,8,0,20,12
1713514866127,MCWP 50R,A00,518791,Staff,7,0,20,13
1713514866127,MCWP 50R,B00,518792,Staff,3,0,20,17
1713514866127,MCWP 50R,C00,518793,Staff,5,0,20,15
1713514866127,MCWP 50R,D00,518794,Staff,0,0,20,20
1713514866127,MCWP 50R,E00,518795,Staff,0,0,20,20
1713514866127,MCWP 50R,F00,518796,Staff,10,0,20,10
1713514866127,MCWP 50R,G00,518797,Staff,10,0,20,10
1713514867156,MMW 12R,A01,514034,Herbst; Matthew,1,0,16,15
1713514867156,MMW 12R,A02,514035,Herbst; Matthew,13,0,16,3
1713514868182,MMW 13R,A01,514037,Staff,0,8,16,16
1713514868182,MMW 13R,A02,514039,Staff,0,7,16,16
1713514870237,SIO 295LS,A00,523233,Staff,15,0,30,15
1713514871263,SIO 295S,A00,523232,Staff,15,0,30,15
1713514872289,SOCI 117,A01,494376,Staff,0,2,5,5
1713514873320,WES 237B,A00,494380,Staff,19,0,20,1
1713514875404,AESE 279B,A00,494370,Wade; Jon P,33,0,33,0
1713514876445,AIP 197,001,627712,Vespa; Emanuel Ignacio,9999,0,9999,0
1713514877469,ANAR 135S,A00,494369,Braswell; Geoffrey E.,0,0,0,0
1713514878495,CAT 124RS,A01,519847,Geibel; William,6,0,20,14
1713514879521,CAT 125RS,A01,515971,Geibel; William,6,0,20,14
1713514880547,CLRE 250,A00,511389,Morris; Sheldon,9996,0,9999,3
1713514881586,CLRE 251,A00,507176,Mehta; Ravindra L.,9996,0,9999,3
1713514881586,CLRE 251,B00,511410,Mehta; Ravindra L.,9998,0,9999,1
1713514882615,CLRE 252,A00,507189,Cuomo; Raphael Eduardo,9998,0,9999,1
1713514883640,CLRE 253,A00,507199,Vaida; Florin,9997,0,9999,2
1713514883640,CLRE 253,B00,507202,Vaida; Florin,9999,0,9999,0
1713514884673,CLRE 259,A00,507211,Patel; Hemal,9996,0,9999,3
1713514885699,CLRE 260,A00,507221,Cuomo; Raphael Eduardo,9999,0,9999,0
1713514886725,CLRE 297,001,507242,Cuomo; Raphael Eduardo,9999,0,9999,0
1713514887768,CSE 191,A00,516875,Minnes Kemp; Mor Mia,9999,0,9999,0
1713514888801,CSS 201S,A01,494383,Staff,35,0,35,0
1713514889826,CSS 202S,A01,494387,Staff,35,0,35,0
1713514890856,EAP 100,A00,516065,Staff,9792,0,9999,207
1713514891886,ECE 45,A01,507414,Staff,37,0,60,23
1713514892912,ECE 100,A01,507416,Baghdadchi; Saharnaz,0,0,20,20
1713514892912,ECE 100,A02,507418,Baghdadchi; Saharnaz,19,0,20,1
1713514893940,ECE 111,A01,507420,Staff,27,0,50,23
1713514894969,ECE 197,001,548057,Sievenpiper; Daniel F.,9998,0,9999,1
1713514895995,EDS 115,A00,507243,Choi; Bailey Miyeon,27,0,28,1
1713514897023,EDS 117,A01,494379,Staff,15,0,25,10
1713514898047,EDS 125,A00,507246,Hopkins; Megan Beth,27,0,30,3
1713514899077,EDS 128A,A01,507264,Fargason; Sharon Gayle,26,0,26,0
1713514900101,EDS 128B,A01,507293,Pappas; Elizabeth,30,0,30,0
1713514901125,EDS 139,A00,507294,Fargason; Sharon Gayle,30,0,30,0
1713514901125,EDS 139,B00,507313,Pappas; Elizabeth,30,0,30,0
1713514902152,EDS 201,A00,507315,Staff,18,0,30,12
1713514903177,EDS 203,A01,507317,Halter; Christopher P.,17,0,30,13
1713514904202,EDS 204R,A01,507319,Halter; Christopher P.,0,1,30,30
1713514904202,EDS 204R,B01,507331,Heinzman; Erica M.,22,0,30,8
1713514905228,EDS 206R,A00,507332,Staff,0,2,30,30
1713514905228,EDS 206R,B00,507343,Staff,23,0,30,7
1713514906258,EDS 250,A00,507344,Hemans; Patricia Ann Benitez,27,0,40,13
1713514907283,EDS 281,A00,507345,Daly; Alan J.,18,0,18,0
1713514908309,EDS 284,A00,507350,Daly; Alan J.,16,0,16,0
1713514909333,EDS 286,A00,507359,Fine; Sarah,18,0,18,0
1713514910359,EDS 289C,A01,507361,Daly; Alan J.,18,0,18,0
1713514911389,EDS 290,A00,507366,Hofstetter; Carolyn,15,0,15,0
1713514912412,LIGM 5A,A00,507421,Fischer-Grunski; Eva K,20,0,20,0
1713514913438,LIGM 5B,A00,507423,Fischer-Grunski; Eva K,20,0,20,0
1713514914470,LIGM 5C,A00,507425,Fischer-Grunski; Eva K,20,0,20,0
1713514915507,LIIT 5AS,A00,507427,Carnelos; Chiara,20,0,20,0
1713514916540,LIIT 5BS,A00,507430,Carnelos; Chiara,20,0,20,0
1713514917570,LIIT 5CS,A00,507432,Carnelos; Chiara,20,0,20,0
1713514918596,LISP 5A,A00,507541,Munoz Sanchez; Alicia,14,0,20,6
1713514919622,LISP 5B,A00,507671,Munoz Sanchez; Alicia,12,0,20,8
1713514920649,LISP 5C,A00,507696,Munoz Sanchez; Alicia,11,0,20,9
1713514921674,MAE 197,001,528363,Boechler; Nicholas Sebastia,9998,0,9999,1
1713514922765,MATH 197,001,523477,Kedlaya; Kiran S.,9999,0,9999,0
1713514922765,MATH 197,002,563811,Zhang; Danna,9998,0,9999,1
1713514923796,MCWP 40R,A00,518780,Staff,13,0,20,7
1713514923796,MCWP 40R,B00,518781,Staff,11,0,20,9
1713514923796,MCWP 40R,C00,518783,Staff,8,0,20,12
1713514924828,MCWP 50R,A00,518791,Staff,7,0,20,13
1713514924828,MCWP 50R,B00,518792,Staff,3,0,20,17
1713514924828,MCWP 50R,C00,518793,Staff,5,0,20,15
1713514924828,MCWP 50R,D00,518794,Staff,0,0,20,20
1713514924828,MCWP 50R,E00,518795,Staff,0,0,20,20
1713514924828,MCWP 50R,F00,518796,Staff,10,0,20,10
1713514924828,MCWP 50R,G00,518797,Staff,10,0,20,10
1713514925853,MMW 12R,A01,514034,Herbst; Matthew,1,0,16,15
1713514925853,MMW 12R,A02,514035,Herbst; Matthew,13,0,16,3
1713514926882,MMW 13R,A01,514037,Staff,0,8,16,16
1713514926882,MMW 13R,A02,514039,Staff,0,7,16,16
1713514928935,SIO 295LS,A00,523233,Staff,15,0,30,15
1713514929967,SIO 295S,A00,523232,Staff,15,0,30,15
1713514930998,SOCI 117,A01,494376,Staff,0,2,5,5
1713514932028,WES 237B,A00,494380,Staff,19,0,20,1
1713514934106,AESE 279B,A00,494370,Wade; Jon P,33,0,33,0
1713514935136,AIP 197,001,627712,Vespa; Emanuel Ignacio,9999,0,9999,0
1713514936166,ANAR 135S,A00,494369,Braswell; Geoffrey E.,0,0,0,0
1713514937196,CAT 124RS,A01,519847,Geibel; William,6,0,20,14
1713514938235,CAT 125RS,A01,515971,Geibel; William,6,0,20,14
1713514939264,CLRE 250,A00,511389,Morris; Sheldon,9996,0,9999,3
1713514940292,CLRE 251,A00,507176,Mehta; Ravindra L.,9996,0,9999,3
1713514940292,CLRE 251,B00,511410,Mehta; Ravindra L.,9998,0,9999,1
1713514941376,CLRE 252,A00,507189,Cuomo; Raphael Eduardo,9998,0,9999,1
1713514942406,CLRE 253,A00,507199,Vaida; Florin,9997,0,9999,2
1713514942406,CLRE 253,B00,507202,Vaida; Florin,9999,0,9999,0
1713514943432,CLRE 259,A00,507211,Patel; Hemal,9996,0,9999,3
1713514944462,CLRE 260,A00,507221,Cuomo; Raphael Eduardo,9999,0,9999,0
1713514945487,CLRE 297,001,507242,Cuomo; Raphael Eduardo,9999,0,9999,0
1713514946517,CSE 191,A00,516875,Minnes Kemp; Mor Mia,9999,0,9999,0
1713514947543,CSS 201S,A01,494383,Staff,35,0,35,0
1713514948575,CSS 202S,A01,494387,Staff,35,0,35,0
1713514949600,EAP 100,A00,516065,Staff,9792,0,9999,207
1713514950626,ECE 45,A01,507414,Staff,37,0,60,23
1713514951655,ECE 100,A01,507416,Baghdadchi; Saharnaz,0,0,20,20
1713514951655,ECE 100,A02,507418,Baghdadchi; Saharnaz,19,0,20,1
1713514952679,ECE 111,A01,507420,Staff,27,0,50,23
1713514953712,ECE 197,001,548057,Sievenpiper; Daniel F.,9998,0,9999,1
1713514954743,EDS 115,A00,507243,Choi; Bailey Miyeon,27,0,28,1
1713514955769,EDS 117,A01,494379,Staff,15,0,25,10
1713514956794,EDS 125,A00,507246,Hopkins; Megan Beth,27,0,30,3
1713514957826,EDS 128A,A01,507264,Fargason; Sharon Gayle,26,0,26,0
1713514958853,EDS 128B,A01,507293,Pappas; Elizabeth,30,0,30,0
1713514959879,EDS 139,A00,507294,Fargason; Sharon Gayle,30,0,30,0
1713514959879,EDS 139,B00,507313,Pappas; Elizabeth,30,0,30,0
1713514960904,EDS 201,A00,507315,Staff,18,0,30,12
1713514961929,EDS 203,A01,507317,Halter; Christopher P.,17,0,30,13
1713514962955,EDS 204R,A01,507319,Halter; Christopher P.,0,1,30,30
1713514962955,EDS 204R,B01,507331,Heinzman; Erica M.,22,0,30,8
1713514963981,EDS 206R,A00,507332,Staff,0,2,30,30
1713514963981,EDS 206R,B00,507343,Staff,23,0,30,7
1713514965010,EDS 250,A00,507344,Hemans; Patricia Ann Benitez,27,0,40,13
1713514966041,EDS 281,A00,507345,Daly; Alan J.,18,0,18,0
1713514967067,EDS 284,A00,507350,Daly; Alan J.,16,0,16,0
1713514968093,EDS 286,A00,507359,Fine; Sarah,18,0,18,0
1713514969119,EDS 289C,A01,507361,Daly; Alan J.,18,0,18,0
1713514970145,EDS 290,A00,507366,Hofstetter; Carolyn,15,0,15,0
1713514971177,LIGM 5A,A00,507421,Fischer-Grunski; Eva K,20,0,20,0
1713514972205,LIGM 5B,A00,507423,Fischer-Grunski; Eva K,20,0,20,0
1713514973231,LIGM 5C,A00,507425,Fischer-Grunski; Eva K,20,0,20,0
1713514974258,LIIT 5AS,A00,507427,Carnelos; Chiara,20,0,20,0
1713514975283,LIIT 5BS,A00,507430,Carnelos; Chiara,20,0,20,0
1713514976310,LIIT 5CS,A00,507432,Carnelos; Chiara,20,0,20,0
1713514977337,LISP 5A,A00,507541,Munoz Sanchez; Alicia,14,0,20,6
1713514978362,LISP 5B,A00,507671,Munoz Sanchez; Alicia,12,0,20,8
1713514979392,LISP 5C,A00,507696,Munoz Sanchez; Alicia,11,0,20,9
1713514980418,MAE 197,001,528363,Boechler; Nicholas Sebastia,9998,0,9999,1
1713514981444,MATH 197,001,523477,Kedlaya; Kiran S.,9999,0,9999,0
1713514981444,MATH 197,002,563811,Zhang; Danna,9998,0,9999,1
1713514982470,MCWP 40R,A00,518780,Staff,13,0,20,7
1713514982470,MCWP 40R,B00,518781,Staff,11,0,20,9
1713514982470,MCWP 40R,C00,518783,Staff,8,0,20,12
1713514983496,MCWP 50R,A00,518791,Staff,7,0,20,13
1713514983496,MCWP 50R,B00,518792,Staff,3,0,20,17
1713514983496,MCWP 50R,C00,518793,Staff,5,0,20,15
1713514983496,MCWP 50R,D00,518794,Staff,0,0,20,20
1713514983496,MCWP 50R,E00,518795,Staff,0,0,20,20
1713514983496,MCWP 50R,F00,518796,Staff,10,0,20,10
1713514983496,MCWP 50R,G00,518797,Staff,10,0,20,10
1713514984527,MMW 12R,A01,514034,Herbst; Matthew,1,0,16,15
1713514984527,MMW 12R,A02,514035,Herbst; Matthew,13,0,16,3
1713514985553,MMW 13R,A01,514037,Staff,0,8,16,16
1713514985553,MMW 13R,A02,514039,Staff,0,7,16,16
1713514987610,SIO 295LS,A00,523233,Staff,15,0,30,15
1713514988642,SIO 295S,A00,523232,Staff,15,0,30,15
1713514989669,SOCI 117,A01,494376,Staff,0,2,5,5
1713514990700,WES 237B,A00,494380,Staff,19,0,20,1
1713514992769,AESE 279B,A00,494370,Wade; Jon P,33,0,33,0
1713514993800,AIP 197,001,627712,Vespa; Emanuel Ignacio,9999,0,9999,0
1713514994829,ANAR 135S,A00,494369,Braswell; Geoffrey E.,0,0,0,0
1713514995860,CAT 124RS,A01,519847,Geibel; William,6,0,20,14
1713514996886,CAT 125RS,A01,515971,Geibel; William,6,0,20,14
1713514997913,CLRE 250,A00,511389,Morris; Sheldon,9996,0,9999,3
1713514998941,CLRE 251,A00,507176,Mehta; Ravindra L.,9996,0,9999,3
1713514998941,CLRE 251,B00,511410,Mehta; Ravindra L.,9998,0,9999,1
1713514999970,CLRE 252,A00,507189,Cuomo; Raphael Eduardo,9998,0,9999,1
1713515001000,CLRE 253,A00,507199,Vaida; Florin,9997,0,9999,2
1713515001000,CLRE 253,B00,507202,Vaida; Florin,9999,0,9999,0
1713515002026,CLRE 259,A00,507211,Patel; Hemal,9996,0,9999,3
1713515003056,CLRE 260,A00,507221,Cuomo; Raphael Eduardo,9999,0,9999,0
1713515004085,CLRE 297,001,507242,Cuomo; Raphael Eduardo,9999,0,9999,0
1713515005116,CSE 191,A00,516875,Minnes Kemp; Mor Mia,9999,0,9999,0
1713515006144,CSS 201S,A01,494383,Staff,35,0,35,0
1713515007189,CSS 202S,A01,494387,Staff,35,0,35,0
1713515008215,EAP 100,A00,516065,Staff,9792,0,9999,207
1713515009242,ECE 45,A01,507414,Staff,37,0,60,23
1713515010273,ECE 100,A01,507416,Baghdadchi; Saharnaz,0,0,20,20
1713515010273,ECE 100,A02,507418,Baghdadchi; Saharnaz,19,0,20,1
1713515011299,ECE 111,A01,507420,Staff,27,0,50,23
1713515012325,ECE 197,001,548057,Sievenpiper; Daniel F.,9998,0,9999,1
1713515013358,EDS 115,A00,507243,Choi; Bailey Miyeon,27,0,28,1
1713515014384,EDS 117,A01,494379,Staff,15,0,25,10
1713515015411,EDS 125,A00,507246,Hopkins; Megan Beth,27,0,30,3
1713515016436,EDS 128A,A01,507264,Fargason; Sharon Gayle,26,0,26,0
1713515017461,EDS 128B,A01,507293,Pappas; Elizabeth,30,0,30,0
1713515018486,EDS 139,A00,507294,Fargason; Sharon Gayle,30,0,30,0
1713515018486,EDS 139,B00,507313,Pappas; Elizabeth,30,0,30,0
1713515019516,EDS 201,A00,507315,Staff,18,0,30,12
1713515020541,EDS 203,A01,507317,Halter; Christopher P.,17,0,30,13
1713515021568,EDS 204R,A01,507319,Halter; Christopher P.,0,1,30,30
1713515021568,EDS 204R,B01,507331,Heinzman; Erica M.,22,0,30,8
1713515022594,EDS 206R,A00,507332,Staff,0,2,30,30
1713515022594,EDS 206R,B00,507343,Staff,23,0,30,7
1713515023627,EDS 250,A00,507344,Hemans; Patricia Ann Benitez,27,0,40,13
1713515024657,EDS 281,A00,507345,Daly; Alan J.,18,0,18,0
1713515025683,EDS 284,A00,507350,Daly; Alan J.,16,0,16,0
1713515026710,EDS 286,A00,507359,Fine; Sarah,18,0,18,0
1713515027736,EDS 289C,A01,507361,Daly; Alan J.,18,0,18,0
1713515028765,EDS 290,A00,507366,Hofstetter; Carolyn,15,0,15,0
1713515029797,LIGM 5A,A00,507421,Fischer-Grunski; Eva K,20,0,20,0
1713515030827,LIGM 5B,A00,507423,Fischer-Grunski; Eva K,20,0,20,0
1713515031853,LIGM 5C,A00,507425,Fischer-Grunski; Eva K,20,0,20,0
1713515032880,LIIT 5AS,A00,507427,Carnelos; Chiara,20,0,20,0
1713515033906,LIIT 5BS,A00,507430,Carnelos; Chiara,20,0,20,0
1713515034932,LIIT 5CS,A00,507432,Carnelos; Chiara,20,0,20,0
1713515035963,LISP 5A,A00,507541,Munoz Sanchez; Alicia,14,0,20,6
1713515036990,LISP 5B,A00,507671,Munoz Sanchez; Alicia,12,0,20,8
1713515038027,LISP 5C,A00,507696,Munoz Sanchez; Alicia,11,0,20,9
1713515039052,MAE 197,001,528363,Boechler; Nicholas Sebastia,9998,0,9999,1
1713515040088,MATH 197,001,523477,Kedlaya; Kiran S.,9999,0,9999,0
1713515040088,MATH 197,002,563811,Zhang; Danna,9998,0,9999,1
1713515041120,MCWP 40R,A00,518780,Staff,13,0,20,7
1713515041120,MCWP 40R,B00,518781,Staff,11,0,20,9
1713515041120,MCWP 40R,C00,518783,Staff,8,0,20,12
1713515042148,MCWP 50R,A00,518791,Staff,7,0,20,13
1713515042148,MCWP 50R,B00,518792,Staff,3,0,20,17
1713515042148,MCWP 50R,C00,518793,Staff,5,0,20,15
1713515042148,MCWP 50R,D00,518794,Staff,0,0,20,20
1713515042148,MCWP 50R,E00,518795,Staff,0,0,20,20
1713515042148,MCWP 50R,F00,518796,Staff,10,0,20,10
1713515042148,MCWP 50R,G00,518797,Staff,10,0,20,10
1713515043191,MMW 12R,A01,514034,Herbst; Matthew,1,0,16,15
1713515043191,MMW 12R,A02,514035,Herbst; Matthew,13,0,16,3
1713515044217,MMW 13R,A01,514037,Staff,0,8,16,16
1713515044217,MMW 13R,A02,514039,Staff,0,7,16,16
1713515046330,SIO 295LS,A00,523233,Staff,15,0,30,15
1713515047359,SIO 295S,A00,523232,Staff,15,0,30,15
1713515048389,SOCI 117,A01,494376,Staff,0,2,5,5
1713515049418,WES 237B,A00,494380,Staff,19,0,20,1
1713515051493,AESE 279B,A00,494370,Wade; Jon P,33,0,33,0
1713515052519,AIP 197,001,627712,Vespa; Emanuel Ignacio,9999,0,9999,0
1713515053545,ANAR 135S,A00,494369,Braswell; Geoffrey E.,0,0,0,0
1713515054572,CAT 124RS,A01,519847,Geibel; William,6,0,20,14
1713515055600,CAT 125RS,A01,515971,Geibel; William,6,0,20,14
1713515056630,CLRE 250,A00,511389,Morris; Sheldon,9996,0,9999,3
1713515057658,CLRE 251,A00,507176,Mehta; Ravindra L.,9996,0,9999,3
1713515057658,CLRE 251,B00,511410,Mehta; Ravindra L.,9998,0,9999,1
1713515058686,CLRE 252,A00,507189,Cuomo; Raphael Eduardo,9998,0,9999,1
1713515059715,CLRE 253,A00,507199,Vaida; Florin,9997,0,9999,2
1713515059715,CLRE 253,B00,507202,Vaida; Florin,9999,0,9999,0
1713515060741,CLRE 259,A00,507211,Patel; Hemal,9996,0,9999,3
1713515061766,CLRE 260,A00,507221,Cuomo; Raphael Eduardo,9999,0,9999,0
1713515062792,CLRE 297,001,507242,Cuomo; Raphael Eduardo,9999,0,9999,0
1713515063822,CSE 191,A00,516875,Minnes Kemp; Mor Mia,9999,0,9999,0
1713515064848,CSS 201S,A01,494383,Staff,35,0,35,0
1713515065875,CSS 202S,A01,494387,Staff,35,0,35,0
1713515066901,EAP 100,A00,516065,Staff,9792,0,9999,207
1713515067927,ECE 45,A01,507414,Staff,37,0,60,23
1713515068957,ECE 100,A01,507416,Baghdadchi; Saharnaz,0,0,20,20
1713515068957,ECE 100,A02,507418,Baghdadchi; Saharnaz,19,0,20,1
1713515069987,ECE 111,A01,507420,Staff,27,0,50,23
1713515071012,ECE 197,001,548057,Sievenpiper; Daniel F.,9998,0,9999,1
1713515072044,EDS 115,A00,507243,Choi; Bailey Miyeon,27,0,28,1
1713515073072,EDS 117,A01,494379,Staff,15,0,25,10
1713515074098,EDS 125,A00,507246,Hopkins; Megan Beth,27,0,30,3
1713515075124,EDS 128A,A01,507264,Fargason; Sharon Gayle,26,0,26,0
1713515076151,EDS 128B,A01,507293,Pappas; Elizabeth,30,0,30,0
1713515077176,EDS 139,A00,507294,Fargason; Sharon Gayle,30,0,30,0
1713515077176,EDS 139,B00,507313,Pappas; Elizabeth,30,0,30,0
1713515078206,EDS 201,A00,507315,Staff,18,0,30,12
1713515079237,EDS 203,A01,507317,Halter; Christopher P.,17,0,30,13
1713515080262,EDS 204R,A01,507319,Halter; Christopher P.,0,1,30,30
1713515080262,EDS 204R,B01,507331,Heinzman; Erica M.,22,0,30,8
1713515081292,EDS 206R,A00,507332,Staff,0,2,30,30
1713515081292,EDS 206R,B00,507343,Staff,23,0,30,7
1713515082323,EDS 250,A00,507344,Hemans; Patricia Ann Benitez,27,0,40,13
1713515083354,EDS 281,A00,507345,Daly; Alan J.,18,0,18,0
1713515084385,EDS 284,A00,507350,Daly; Alan J.,16,0,16,0
1713515085410,EDS 286,A00,507359,Fine; Sarah,18,0,18,0
1713515086435,EDS 289C,A01,507361,Daly; Alan J.,18,0,18,0
1713515087464,EDS 290,A00,507366,Hofstetter; Carolyn,15,0,15,0
1713515088491,LIGM 5A,A00,507421,Fischer-Grunski; Eva K,20,0,20,0
1713515089522,LIGM 5B,A00,507423,Fischer-Grunski; Eva K,20,0,20,0
1713515090549,LIGM 5C,A00,507425,Fischer-Grunski; Eva K,20,0,20,0
1713515091575,LIIT 5AS,A00,507427,Carnelos; Chiara,20,0,20,0
1713515092601,LIIT 5BS,A00,507430,Carnelos; Chiara,20,0,20,0
1713515093632,LIIT 5CS,A00,507432,Carnelos; Chiara,20,0,20,0
1713515094663,LISP 5A,A00,507541,Munoz Sanchez; Alicia,14,0,20,6
1713515095689,LISP 5B,A00,507671,Munoz Sanchez; Alicia,12,0,20,8
1713515096722,LISP 5C,A00,507696,Munoz Sanchez; Alicia,11,0,20,9
1713515097751,MAE 197,001,528363,Boechler; Nicholas Sebastia,9998,0,9999,1
1713515098780,MATH 197,001,523477,Kedlaya; Kiran S.,9999,0,9999,0
1713515098780,MATH 197,002,563811,Zhang; Danna,9998,0,9999,1
1713515099807,MCWP 40R,A00,518780,Staff,13,0,20,7
1713515099807,MCWP 40R,B00,518781,Staff,11,0,20,9
1713515099807,MCWP 40R,C00,518783,Staff,8,0,20,12
1713515100835,MCWP 50R,A00,518791,Staff,7,0,20,13
1713515100835,MCWP 50R,B00,518792,Staff,3,0,20,17
1713515100835,MCWP 50R,C00,518793,Staff,5,0,20,15
1713515100835,MCWP 50R,D00,518794,Staff,0,0,20,20
1713515100835,MCWP 50R,E00,518795,Staff,0,0,20,20
1713515100835,MCWP 50R,F00,518796,Staff,10,0,20,10
1713515100835,MCWP 50R,G00,518797,Staff,10,0,20,10
1713515101868,MMW 12R,A01,514034,Herbst; Matthew,1,0,16,15
1713515101868,MMW 12R,A02,514035,Herbst; Matthew,13,0,16,3
1713515102898,MMW 13R,A01,514037,Staff,0,8,16,16
1713515102898,MMW 13R,A02,514039,Staff,0,7,16,16
1713515104952,SIO 295LS,A00,523233,Staff,15,0,30,15
1713515105982,SIO 295S,A00,523232,Staff,15,0,30,15
1713515107007,SOCI 117,A01,494376,Staff,0,2,5,5
1713515108041,WES 237B,A00,494380,Staff,19,0,20,1
1713515110104,AESE 279B,A00,494370,Wade; Jon P,33,0,33,0
1713515111131,AIP 197,001,627712,Vespa; Emanuel Ignacio,9999,0,9999,0
1713515112156,ANAR 135S,A00,494369,Braswell; Geoffrey E.,0,0,0,0
1713515113181,CAT 124RS,A01,519847,Geibel; William,6,0,20,14
1713515114206,CAT 125RS,A01,515971,Geibel; William,6,0,20,14
1713515115236,CLRE 250,A00,511389,Morris; Sheldon,9996,0,9999,3
1713515116263,CLRE 251,A00,507176,Mehta; Ravindra L.,9996,0,9999,3
1713515116263,CLRE 251,B00,511410,Mehta; Ravindra L.,9998,0,9999,1
1713515117289,CLRE 252,A00,507189,Cuomo; Raphael Eduardo,9998,0,9999,1
1713515118320,CLRE 253,A00,507199,Vaida; Florin,9997,0,9999,2
1713515118320,CLRE 253,B00,507202,Vaida; Florin,9999,0,9999,0
1713515119345,CLRE 259,A00,507211,Patel; Hemal,9996,0,9999,3
1713515120373,CLRE 260,A00,507221,Cuomo; Raphael Eduardo,9999,0,9999,0
1713515121399,CLRE 297,001,507242,Cuomo; Raphael Eduardo,9999,0,9999,0
1713515122423,CSE 191,A00,516875,Minnes Kemp; Mor Mia,9999,0,9999,0
1713515123448,CSS 201S,A01,494383,Staff,35,0,35,0
1713515124472,CSS 202S,A01,494387,Staff,35,0,35,0
1713515125502,EAP 100,A00,516065,Staff,9792,0,9999,207
1713515126534,ECE 45,A01,507414,Staff,37,0,60,23
1713515127573,ECE 100,A01,507416,Baghdadchi; Saharnaz,0,0,20,20
1713515127573,ECE 100,A02,507418,Baghdadchi; Saharnaz,19,0,20,1
1713515128604,ECE 111,A01,507420,Staff,27,0,50,23
1713515129633,ECE 197,001,548057,Sievenpiper; Daniel F.,9998,0,9999,1
1713515130658,EDS 115,A00,507243,Choi; Bailey Miyeon,27,0,28,1
1713515131685,EDS 117,A01,494379,Staff,14,0,25,11
1713515132711,EDS 125,A00,507246,Hopkins; Megan Beth,27,0,30,3
1713515133741,EDS 128A,A01,507264,Fargason; Sharon Gayle,26,0,26,0
1713515134771,EDS 128B,A01,507293,Pappas; Elizabeth,30,0,30,0
1713515135796,EDS 139,A00,507294,Fargason; Sharon Gayle,30,0,30,0
1713515135796,EDS 139,B00,507313,Pappas; Elizabeth,30,0,30,0
1713515136822,EDS 201,A00,507315,Staff,18,0,30,12
1713515137848,EDS 203,A01,507317,Halter; Christopher P.,17,0,30,13
1713515138875,EDS 204R,A01,507319,Halter; Christopher P.,0,1,30,30
1713515138875,EDS 204R,B01,507331,Heinzman; Erica M.,22,0,30,8
1713515139900,EDS 206R,A00,507332,Staff,0,2,30,30
1713515139900,EDS 206R,B00,507343,Staff,23,0,30,7
1713515140929,EDS 250,A00,507344,Hemans; Patricia Ann Benitez,27,0,40,13
1713515141954,EDS 281,A00,507345,Daly; Alan J.,18,0,18,0
1713515142982,EDS 284,A00,507350,Daly; Alan J.,16,0,16,0
1713515144014,EDS 286,A00,507359,Fine; Sarah,18,0,18,0
1713515145039,EDS 289C,A01,507361,Daly; Alan J.,18,0,18,0
1713515146064,EDS 290,A00,507366,Hofstetter; Carolyn,15,0,15,0
1713515147094,LIGM 5A,A00,507421,Fischer-Grunski; Eva K,20,0,20,0
1713515148124,LIGM 5B,A00,507423,Fischer-Grunski; Eva K,20,0,20,0
1713515149210,LIGM 5C,A00,507425,Fischer-Grunski; Eva K,20,0,20,0
1713515150238,LIIT 5AS,A00,507427,Carnelos; Chiara,20,0,20,0
1713515151265,LIIT 5BS,A00,507430,Carnelos; Chiara,20,0,20,0
1713515152292,LIIT 5CS,A00,507432,Carnelos; Chiara,20,0,20,0
1713515153319,LISP 5A,A00,507541,Munoz Sanchez; Alicia,14,0,20,6
1713515154348,LISP 5B,A00,507671,Munoz Sanchez; Alicia,12,0,20,8
1713515155373,LISP 5C,A00,507696,Munoz Sanchez; Alicia,11,0,20,9
1713515156399,MAE 197,001,528363,Boechler; Nicholas Sebastia,9998,0,9999,1
1713515157426,MATH 197,001,523477,Kedlaya; Kiran S.,9999,0,9999,0
1713515157426,MATH 197,002,563811,Zhang; Danna,9998,0,9999,1
1713515158452,MCWP 40R,A00,518780,Staff,13,0,20,7
1713515158452,MCWP 40R,B00,518781,Staff,11,0,20,9
1713515158452,MCWP 40R,C00,518783,Staff,8,0,20,12
1713515159477,MCWP 50R,A00,518791,Staff,7,0,20,13
1713515159477,MCWP 50R,B00,518792,Staff,3,0,20,17
1713515159477,MCWP 50R,C00,518793,Staff,5,0,20,15
1713515159477,MCWP 50R,D00,518794,Staff,0,0,20,20
1713515159477,MCWP 50R,E00,518795,Staff,0,0,20,20
1713515159477,MCWP 50R,F00,518796,Staff,10,0,20,10
1713515159477,MCWP 50R,G00,518797,Staff,10,0,20,10
1713515160503,MMW 12R,A01,514034,Herbst; Matthew,1,0,16,15
1713515160503,MMW 12R,A02,514035,Herbst; Matthew,13,0,16,3
1713515161529,MMW 13R,A01,514037,Staff,0,8,16,16
1713515161529,MMW 13R,A02,514039,Staff,0,7,16,16
1713515163585,SIO 295LS,A00,523233,Staff,15,0,30,15
1713515164610,SIO 295S,A00,523232,Staff,15,0,30,15
1713515165636,SOCI 117,A01,494376,Staff,0,2,5,5
1713515166661,WES 237B,A00,494380,Staff,19,0,20,1
1713515168737,AESE 279B,A00,494370,Wade; Jon P,33,0,33,0
1713515169773,AIP 197,001,627712,Vespa; Emanuel Ignacio,9999,0,9999,0
1713515170797,ANAR 135S,A00,494369,Braswell; Geoffrey E.,0,0,0,0
1713515171832,CAT 124RS,A01,519847,Geibel; William,6,0,20,14
1713515172857,CAT 125RS,A01,515971,Geibel; William,6,0,20,14
1713515173888,CLRE 250,A00,511389,Morris; Sheldon,9996,0,9999,3
1713515174920,CLRE 251,A00,507176,Mehta; Ravindra L.,9996,0,9999,3
1713515174920,CLRE 251,B00,511410,Mehta; Ravindra L.,9998,0,9999,1
1713515175946,CLRE 252,A00,507189,Cuomo; Raphael Eduardo,9998,0,9999,1
1713515176971,CLRE 253,A00,507199,Vaida; Florin,9997,0,9999,2
1713515176971,CLRE 253,B00,507202,Vaida; Florin,9999,0,9999,0
1713515177996,CLRE 259,A00,507211,Patel; Hemal,9996,0,9999,3
1713515179021,CLRE 260,A00,507221,Cuomo; Raphael Eduardo,9999,0,9999,0
1713515180046,CLRE 297,001,507242,Cuomo; Raphael Eduardo,9999,0,9999,0
1713515181071,CSE 191,A00,516875,Minnes Kemp; Mor Mia,9999,0,9999,0
1713515182098,CSS 201S,A01,494383,Staff,35,0,35,0
1713515183124,CSS 202S,A01,494387,Staff,35,0,35,0
1713515184150,EAP 100,A00,516065,Staff,9792,0,9999,207
1713515185177,ECE 45,A01,507414,Staff,37,0,60,23
1713515186211,ECE 100,A01,507416,Baghdadchi; Saharnaz,0,0,20,20
1713515186211,ECE 100,A02,507418,Baghdadchi; Saharnaz,19,0,20,1
1713515187244,ECE 111,A01,507420,Staff,27,0,50,23
1713515188270,ECE 197,001,548057,Sievenpiper; Daniel F.,9998,0,9999,1
1713515189296,EDS 115,A00,507243,Choi; Bailey Miyeon,27,0,28,1
1713515190324,EDS 117,A01,494379,Staff,14,0,25,11
1713515191353,EDS 125,A00,507246,Hopkins; Megan Beth,27,0,30,3
1713515192378,EDS 128A,A01,507264,Fargason; Sharon Gayle,26,0,26,0
1713515193403,EDS 128B,A01,507293,Pappas; Elizabeth,30,0,30,0
1713515194429,EDS 139,A00,507294,Fargason; Sharon Gayle,30,0,30,0
1713515194429,EDS 139,B00,507313,Pappas; Elizabeth,30,0,30,0
1713515195453,EDS 201,A00,507315,Staff,18,0,30,12
1713515196480,EDS 203,A01,507317,Halter; Christopher P.,17,0,30,13
1713515197509,EDS 204R,A01,507319,Halter; Christopher P.,0,1,30,30
1713515197509,EDS 204R,B01,507331,Heinzman; Erica M.,22,0,30,8
1713515198534,EDS 206R,A00,507332,Staff,0,2,30,30
1713515198534,EDS 206R,B00,507343,Staff,23,0,30,7
1713515199560,EDS 250,A00,507344,Hemans; Patricia Ann Benitez,27,0,40,13
1713515200584,EDS 281,A00,507345,Daly; Alan J.,18,0,18,0
1713515201610,EDS 284,A00,507350,Daly; Alan J.,16,0,16,0
1713515202640,EDS 286,A00,507359,Fine; Sarah,18,0,18,0
1713515203665,EDS 289C,A01,507361,Daly; Alan J.,18,0,18,0
1713515204694,EDS 290,A00,507366,Hofstetter; Carolyn,15,0,15,0
1713515205720,LIGM 5A,A00,507421,Fischer-Grunski; Eva K,20,0,20,0
1713515206747,LIGM 5B,A00,507423,Fischer-Grunski; Eva K,20,0,20,0
1713515207772,LIGM 5C,A00,507425,Fischer-Grunski; Eva K,20,0,20,0
1713515208798,LIIT 5AS,A00,507427,Carnelos; Chiara,20,0,20,0
1713515209830,LIIT 5BS,A00,507430,Carnelos; Chiara,20,0,20,0
1713515210855,LIIT 5CS,A00,507432,Carnelos; Chiara,20,0,20,0
1713515211891,LISP 5A,A00,507541,Munoz Sanchez; Alicia,14,0,20,6
1713515212922,LISP 5B,A00,507671,Munoz Sanchez; Alicia,12,0,20,8
1713515213947,LISP 5C,A00,507696,Munoz Sanchez; Alicia,11,0,20,9
1713515214973,MAE 197,001,528363,Boechler; Nicholas Sebastia,9998,0,9999,1
1713515215999,MATH 197,001,523477,Kedlaya; Kiran S.,9999,0,9999,0
1713515215999,MATH 197,002,563811,Zhang; Danna,9998,0,9999,1
1713515217025,MCWP 40R,A00,518780,Staff,13,0,20,7
1713515217025,MCWP 40R,B00,518781,Staff,11,0,20,9
1713515217025,MCWP 40R,C00,518783,Staff,8,0,20,12
1713515218055,MCWP 50R,A00,518791,Staff,7,0,20,13
1713515218055,MCWP 50R,B00,518792,Staff,3,0,20,17
1713515218055,MCWP 50R,C00,518793,Staff,5,0,20,15
1713515218055,MCWP 50R,D00,518794,Staff,0,0,20,20
1713515218055,MCWP 50R,E00,518795,Staff,0,0,20,20
1713515218055,MCWP 50R,F00,518796,Staff,10,0,20,10
1713515218055,MCWP 50R,G00,518797,Staff,10,0,20,10
1713515219087,MMW 12R,A01,514034,Herbst; Matthew,1,0,16,15
1713515219087,MMW 12R,A02,514035,Herbst; Matthew,13,0,16,3
1713515220118,MMW 13R,A01,514037,Staff,0,8,16,16
1713515220118,MMW 13R,A02,514039,Staff,0,7,16,16
1713515222181,SIO 295LS,A00,523233,Staff,15,0,30,15
1713515223208,SIO 295S,A00,523232,Staff,15,0,30,15
1713515224235,SOCI 117,A01,494376,Staff,0,2,5,5
1713515225261,WES 237B,A00,494380,Staff,19,0,20,1
1713515227331,AESE 279B,A00,494370,Wade; Jon P,33,0,33,0
1713515228363,AIP 197,001,627712,Vespa; Emanuel Ignacio,9999,0,9999,0
1713515229390,ANAR 135S,A00,494369,Braswell; Geoffrey E.,0,0,0,0
1713515230421,CAT 124RS,A01,519847,Geibel; William,6,0,20,14
1713515231453,CAT 125RS,A01,515971,Geibel; William,6,0,20,14
1713515232485,CLRE 250,A00,511389,Morris; Sheldon,9996,0,9999,3
1713515233514,CLRE 251,A00,507176,Mehta; Ravindra L.,9996,0,9999,3
1713515233514,CLRE 251,B00,511410,Mehta; Ravindra L.,9998,0,9999,1
1713515234539,CLRE 252,A00,507189,Cuomo; Raphael Eduardo,9998,0,9999,1
1713515235569,CLRE 253,A00,507199,Vaida; Florin,9997,0,9999,2
1713515235569,CLRE 253,B00,507202,Vaida; Florin,9999,0,9999,0
1713515236594,CLRE 259,A00,507211,Patel; Hemal,9996,0,9999,3
1713515237621,CLRE 260,A00,507221,Cuomo; Raphael Eduardo,9999,0,9999,0
1713515238651,CLRE 297,001,507242,Cuomo; Raphael Eduardo,9999,0,9999,0
1713515239677,CSE 191,A00,516875,Minnes Kemp; Mor Mia,9999,0,9999,0
1713515240702,CSS 201S,A01,494383,Staff,35,0,35,0
1713515241728,CSS 202S,A01,494387,Staff,35,0,35,0
1713515242753,EAP 100,A00,516065,Staff,9792,0,9999,207
1713515243784,ECE 45,A01,507414,Staff,37,0,60,23
1713515244812,ECE 100,A01,507416,Baghdadchi; Saharnaz,0,0,20,20
1713515244812,ECE 100,A02,507418,Baghdadchi; Saharnaz,19,0,20,1
1713515245841,ECE 111,A01,507420,Staff,27,0,50,23
1713515246867,ECE 197,001,548057,Sievenpiper; Daniel F.,9998,0,9999,1
1713515247897,EDS 115,A00,507243,Choi; Bailey Miyeon,27,0,28,1
1713515248923,EDS 117,A01,494379,Staff,14,0,25,11
1713515249950,EDS 125,A00,507246,Hopkins; Megan Beth,27,0,30,3
1713515250981,EDS 128A,A01,507264,Fargason; Sharon Gayle,26,0,26,0
1713515252007,EDS 128B,A01,507293,Pappas; Elizabeth,30,0,30,0
1713515253089,EDS 139,A00,507294,Fargason; Sharon Gayle,30,0,30,0
1713515253089,EDS 139,B00,507313,Pappas; Elizabeth,30,0,30,0
1713515254115,EDS 201,A00,507315,Staff,18,0,30,12
1713515255144,EDS 203,A01,507317,Halter; Christopher P.,17,0,30,13
1713515256170,EDS 204R,A01,507319,Halter; Christopher P.,0,1,30,30
1713515256170,EDS 204R,B01,507331,Heinzman; Erica M.,22,0,30,8
1713515257195,EDS 206R,A00,507332,Staff,0,2,30,30
1713515257195,EDS 206R,B00,507343,Staff,23,0,30,7
1713515258225,EDS 250,A00,507344,Hemans; Patricia Ann Benitez,27,0,40,13
1713515259256,EDS 281,A00,507345,Daly; Alan J.,18,0,18,0
1713515260281,EDS 284,A00,507350,Daly; Alan J.,16,0,16,0
1713515261307,EDS 286,A00,507359,Fine; Sarah,18,0,18,0
1713515262332,EDS 289C,A01,507361,Daly; Alan J.,18,0,18,0
1713515263356,EDS 290,A00,507366,Hofstetter; Carolyn,15,0,15,0
1713515264382,LIGM 5A,A00,507421,Fischer-Grunski; Eva K,20,0,20,0
1713515265416,LIGM 5B,A00,507423,Fischer-Grunski; Eva K,20,0,20,0
1713515266442,LIGM 5C,A00,507425,Fischer-Grunski; Eva K,20,0,20,0
1713515267473,LIIT 5AS,A00,507427,Carnelos; Chiara,20,0,20,0
1713515268505,LIIT 5BS,A00,507430,Carnelos; Chiara,20,0,20,0
1713515269529,LIIT 5CS,A00,507432,Carnelos; Chiara,20,0,20,0
1713515270562,LISP 5A,A00,507541,Munoz Sanchez; Alicia,14,0,20,6
1713515271588,LISP 5B,A00,507671,Munoz Sanchez; Alicia,12,0,20,8
1713515272614,LISP 5C,A00,507696,Munoz Sanchez; Alicia,11,0,20,9
1713515273640,MAE 197,001,528363,Boechler; Nicholas Sebastia,9998,0,9999,1
1713515274667,MATH 197,001,523477,Kedlaya; Kiran S.,9999,0,9999,0
1713515274667,MATH 197,002,563811,Zhang; Danna,9998,0,9999,1
1713515275698,MCWP 40R,A00,518780,Staff,13,0,20,7
1713515275698,MCWP 40R,B00,518781,Staff,11,0,20,9
1713515275698,MCWP 40R,C00,518783,Staff,8,0,20,12
1713515276724,MCWP 50R,A00,518791,Staff,7,0,20,13
1713515276724,MCWP 50R,B00,518792,Staff,3,0,20,17
1713515276724,MCWP 50R,C00,518793,Staff,5,0,20,15
1713515276724,MCWP 50R,D00,518794,Staff,0,0,20,20
1713515276724,MCWP 50R,E00,518795,Staff,0,0,20,20
1713515276724,MCWP 50R,F00,518796,Staff,10,0,20,10
1713515276724,MCWP 50R,G00,518797,Staff,10,0,20,10
1713515277749,MMW 12R,A01,514034,Herbst; Matthew,1,0,16,15
1713515277749,MMW 12R,A02,514035,Herbst; Matthew,13,0,16,3
1713515278774,MMW 13R,A01,514037,Staff,0,8,16,16
1713515278774,MMW 13R,A02,514039,Staff,0,7,16,16
1713515280826,SIO 295LS,A00,523233,Staff,15,0,30,15
1713515281852,SIO 295S,A00,523232,Staff,15,0,30,15
1713515282884,SOCI 117,A01,494376,Staff,0,2,5,5
1713515283913,WES 237B,A00,494380,Staff,19,0,20,1
1713515285977,AESE 279B,A00,494370,Wade; Jon P,33,0,33,0
1713515287007,AIP 197,001,627712,Vespa; Emanuel Ignacio,9999,0,9999,0
1713515288034,ANAR 135S,A00,494369,Braswell; Geoffrey E.,0,0,0,0
1713515289062,CAT 124RS,A01,519847,Geibel; William,6,0,20,14
1713515290088,CAT 125RS,A01,515971,Geibel; William,6,0,20,14
1713515291114,CLRE 250,A00,511389,Morris; Sheldon,9996,0,9999,3
1713515292140,CLRE 251,A00,507176,Mehta; Ravindra L.,9996,0,9999,3
1713515292140,CLRE 251,B00,511410,Mehta; Ravindra L.,9998,0,9999,1
1713515293167,CLRE 252,A00,507189,Cuomo; Raphael Eduardo,9998,0,9999,1
1713515294197,CLRE 253,A00,507199,Vaida; Florin,9997,0,9999,2
1713515294197,CLRE 253,B00,507202,Vaida; Florin,9999,0,9999,0
1713515295224,CLRE 259,A00,507211,Patel; Hemal,9996,0,9999,3
1713515296250,CLRE 260,A00,507221,Cuomo; Raphael Eduardo,9999,0,9999,0
1713515297276,CLRE 297,001,507242,Cuomo; Raphael Eduardo,9999,0,9999,0
1713515298301,CSE 191,A00,516875,Minnes Kemp; Mor Mia,9999,0,9999,0
1713515299328,CSS 201S,A01,494383,Staff,35,0,35,0
1713515300355,CSS 202S,A01,494387,Staff,35,0,35,0
1713515301386,EAP 100,A00,516065,Staff,9792,0,9999,207
1713515302417,ECE 45,A01,507414,Staff,37,0,60,23
1713515303449,ECE 100,A01,507416,Baghdadchi; Saharnaz,0,0,20,20
1713515303449,ECE 100,A02,507418,Baghdadchi; Saharnaz,19,0,20,1
1713515304474,ECE 111,A01,507420,Staff,27,0,50,23
1713515305501,ECE 197,001,548057,Sievenpiper; Daniel F.,9998,0,9999,1
1713515306529,EDS 115,A00,507243,Choi; Bailey Miyeon,27,0,28,1
1713515307562,EDS 117,A01,494379,Staff,14,0,25,11
1713515308593,EDS 125,A00,507246,Hopkins; Megan Beth,27,0,30,3
1713515309619,EDS 128A,A01,507264,Fargason; Sharon Gayle,26,0,26,0
1713515310649,EDS 128B,A01,507293,Pappas; Elizabeth,30,0,30,0
1713515311673,EDS 139,A00,507294,Fargason; Sharon Gayle,30,0,30,0
1713515311673,EDS 139,B00,507313,Pappas; Elizabeth,30,0,30,0
1713515312702,EDS 201,A00,507315,Staff,18,0,30,12
1713515313729,EDS 203,A01,507317,Halter; Christopher P.,17,0,30,13
1713515314755,EDS 204R,A01,507319,Halter; Christopher P.,0,1,30,30
1713515314755,EDS 204R,B01,507331,Heinzman; Erica M.,22,0,30,8
1713515315784,EDS 206R,A00,507332,Staff,0,2,30,30
1713515315784,EDS 206R,B00,507343,Staff,23,0,30,7
1713515316810,EDS 250,A00,507344,Hemans; Patricia Ann Benitez,27,0,40,13
1713515317840,EDS 281,A00,507345,Daly; Alan J.,18,0,18,0
1713515318868,EDS 284,A00,507350,Daly; Alan J.,16,0,16,0
1713515319899,EDS 286,A00,507359,Fine; Sarah,18,0,18,0
1713515320925,EDS 289C,A01,507361,Daly; Alan J.,18,0,18,0
1713515321955,EDS 290,A00,507366,Hofstetter; Carolyn,15,0,15,0
1713515322983,LIGM 5A,A00,507421,Fischer-Grunski; Eva K,20,0,20,0
1713515324016,LIGM 5B,A00,507423,Fischer-Grunski; Eva K,20,0,20,0
1713515325043,LIGM 5C,A00,507425,Fischer-Grunski; Eva K,20,0,20,0
1713515326067,LIIT 5AS,A00,507427,Carnelos; Chiara,20,0,20,0
1713515327096,LIIT 5BS,A00,507430,Carnelos; Chiara,20,0,20,0
1713515328127,LIIT 5CS,A00,507432,Carnelos; Chiara,20,0,20,0
1713515329155,LISP 5A,A00,507541,Munoz Sanchez; Alicia,14,0,20,6
1713515330186,LISP 5B,A00,507671,Munoz Sanchez; Alicia,12,0,20,8
1713515331217,LISP 5C,A00,507696,Munoz Sanchez; Alicia,11,0,20,9
1713515332248,MAE 197,001,528363,Boechler; Nicholas Sebastia,9998,0,9999,1
1713515333273,MATH 197,001,523477,Kedlaya; Kiran S.,9999,0,9999,0
1713515333273,MATH 197,002,563811,Zhang; Danna,9998,0,9999,1
1713515334299,MCWP 40R,A00,518780,Staff,13,0,20,7
1713515334299,MCWP 40R,B00,518781,Staff,11,0,20,9
1713515334299,MCWP 40R,C00,518783,Staff,8,0,20,12
1713515335327,MCWP 50R,A00,518791,Staff,7,0,20,13
1713515335327,MCWP 50R,B00,518792,Staff,3,0,20,17
1713515335327,MCWP 50R,C00,518793,Staff,5,0,20,15
1713515335327,MCWP 50R,D00,518794,Staff,0,0,20,20
1713515335327,MCWP 50R,E00,518795,Staff,0,0,20,20
1713515335327,MCWP 50R,F00,518796,Staff,10,0,20,10
1713515335327,MCWP 50R,G00,518797,Staff,10,0,20,10
1713515336353,MMW 12R,A01,514034,Herbst; Matthew,1,0,16,15
1713515336353,MMW 12R,A02,514035,Herbst; Matthew,13,0,16,3
1713515337378,MMW 13R,A01,514037,Staff,0,8,16,16
1713515337378,MMW 13R,A02,514039,Staff,0,7,16,16
1713515339428,SIO 295LS,A00,523233,Staff,15,0,30,15
1713515340464,SIO 295S,A00,523232,Staff,15,0,30,15
1713515341489,SOCI 117,A01,494376,Staff,0,2,5,5
1713515342515,WES 237B,A00,494380,Staff,19,0,20,1
1713515344582,AESE 279B,A00,494370,Wade; Jon P,33,0,33,0
1713515345609,AIP 197,001,627712,Vespa; Emanuel Ignacio,9999,0,9999,0
1713515346638,ANAR 135S,A00,494369,Braswell; Geoffrey E.,0,0,0,0
1713515347668,CAT 124RS,A01,519847,Geibel; William,6,0,20,14
1713515348700,CAT 125RS,A01,515971,Geibel; William,6,0,20,14
1713515349730,CLRE 250,A00,511389,Morris; Sheldon,9996,0,9999,3
1713515350758,CLRE 251,A00,507176,Mehta; Ravindra L.,9996,0,9999,3
1713515350758,CLRE 251,B00,511410,Mehta; Ravindra L.,9998,0,9999,1
1713515351784,CLRE 252,A00,507189,Cuomo; Raphael Eduardo,9998,0,9999,1
1713515352816,CLRE 253,A00,507199,Vaida; Florin,9997,0,9999,2
1713515352816,CLRE 253,B00,507202,Vaida; Florin,9999,0,9999,0
1713515353860,CLRE 259,A00,507211,Patel; Hemal,9996,0,9999,3
1713515354887,CLRE 260,A00,507221,Cuomo; Raphael Eduardo,9999,0,9999,0
1713515355919,CLRE 297,001,507242,Cuomo; Raphael Eduardo,9999,0,9999,0
1713515356999,CSE 191,A00,516875,Minnes Kemp; Mor Mia,9999,0,9999,0
1713515358025,CSS 201S,A01,494383,Staff,35,0,35,0
1713515359055,CSS 202S,A01,494387,Staff,35,0,35,0
1713515360080,EAP 100,A00,516065,Staff,9792,0,9999,207
1713515361109,ECE 45,A01,507414,Staff,37,0,60,23
1713515362140,ECE 100,A01,507416,Baghdadchi; Saharnaz,0,0,20,20
1713515362140,ECE 100,A02,507418,Baghdadchi; Saharnaz,19,0,20,1
1713515363167,ECE 111,A01,507420,Staff,27,0,50,23
1713515364192,ECE 197,001,548057,Sievenpiper; Daniel F.,9998,0,9999,1
1713515365223,EDS 115,A00,507243,Choi; Bailey Miyeon,27,0,28,1
1713515366255,EDS 117,A01,494379,Staff,14,0,25,11
1713515367288,EDS 125,A00,507246,Hopkins; Megan Beth,27,0,30,3
1713515368322,EDS 128A,A01,507264,Fargason; Sharon Gayle,26,0,26,0
1713515369349,EDS 128B,A01,507293,Pappas; Elizabeth,30,0,30,0
1713515370380,EDS 139,A00,507294,Fargason; Sharon Gayle,30,0,30,0
1713515370380,EDS 139,B00,507313,Pappas; Elizabeth,30,0,30,0
1713515371405,EDS 201,A00,507315,Staff,18,0,30,12
1713515372430,EDS 203,A01,507317,Halter; Christopher P.,17,0,30,13
1713515373458,EDS 204R,A01,507319,Halter; Christopher P.,0,1,30,30
1713515373458,EDS 204R,B01,507331,Heinzman; Erica M.,22,0,30,8
1713515374486,EDS 206R,A00,507332,Staff,0,2,30,30
1713515374486,EDS 206R,B00,507343,Staff,23,0,30,7
1713515375512,EDS 250,A00,507344,Hemans; Patricia Ann Benitez,27,0,40,13
1713515376538,EDS 281,A00,507345,Daly; Alan J.,18,0,18,0
1713515377563,EDS 284,A00,507350,Daly; Alan J.,16,0,16,0
1713515378588,EDS 286,A00,507359,Fine; Sarah,18,0,18,0
1713515379615,EDS 289C,A01,507361,Daly; Alan J.,18,0,18,0
1713515380640,EDS 290,A00,507366,Hofstetter; Carolyn,15,0,15,0
1713515381671,LIGM 5A,A00,507421,Fischer-Grunski; Eva K,20,0,20,0
1713515382697,LIGM 5B,A00,507423,Fischer-Grunski; Eva K,20,0,20,0
1713515383727,LIGM 5C,A00,507425,Fischer-Grunski; Eva K,20,0,20,0
1713515384753,LIIT 5AS,A00,507427,Carnelos; Chiara,20,0,20,0
1713515385778,LIIT 5BS,A00,507430,Carnelos; Chiara,20,0,20,0
1713515386809,LIIT 5CS,A00,507432,Carnelos; Chiara,20,0,20,0
1713515387836,LISP 5A,A00,507541,Munoz Sanchez; Alicia,14,0,20,6
1713515388868,LISP 5B,A00,507671,Munoz Sanchez; Alicia,12,0,20,8
1713515389895,LISP 5C,A00,507696,Munoz Sanchez; Alicia,11,0,20,9
1713515390921,MAE 197,001,528363,Boechler; Nicholas Sebastia,9998,0,9999,1
1713515391953,MATH 197,001,523477,Kedlaya; Kiran S.,9999,0,9999,0
1713515391953,MATH 197,002,563811,Zhang; Danna,9998,0,9999,1
1713515392984,MCWP 40R,A00,518780,Staff,13,0,20,7
1713515392984,MCWP 40R,B00,518781,Staff,11,0,20,9
1713515392984,MCWP 40R,C00,518783,Staff,8,0,20,12
1713515394016,MCWP 50R,A00,518791,Staff,7,0,20,13
1713515394016,MCWP 50R,B00,518792,Staff,3,0,20,17
1713515394016,MCWP 50R,C00,518793,Staff,5,0,20,15
1713515394016,MCWP 50R,D00,518794,Staff,0,0,20,20
1713515394016,MCWP 50R,E00,518795,Staff,0,0,20,20
1713515394016,MCWP 50R,F00,518796,Staff,10,0,20,10
1713515394016,MCWP 50R,G00,518797,Staff,10,0,20,10
1713515395043,MMW 12R,A01,514034,Herbst; Matthew,1,0,16,15
1713515395043,MMW 12R,A02,514035,Herbst; Matthew,13,0,16,3
1713515396068,MMW 13R,A01,514037,Staff,0,8,16,16
1713515396068,MMW 13R,A02,514039,Staff,0,7,16,16
1713515398124,SIO 295LS,A00,523233,Staff,15,0,30,15
1713515399151,SIO 295S,A00,523232,Staff,15,0,30,15
1713515400177,SOCI 117,A01,494376,Staff,0,2,5,5
1713515401205,WES 237B,A00,494380,Staff,19,0,20,1
1713515403279,AESE 279B,A00,494370,Wade; Jon P,33,0,33,0
1713515404308,AIP 197,001,627712,Vespa; Emanuel Ignacio,9999,0,9999,0
1713515405333,ANAR 135S,A00,494369,Braswell; Geoffrey E.,0,0,0,0
1713515406358,CAT 124RS,A01,519847,Geibel; William,6,0,20,14
1713515407387,CAT 125RS,A01,515971,Geibel; William,6,0,20,14
1713515408416,CLRE 250,A00,511389,Morris; Sheldon,9996,0,9999,3
1713515409446,CLRE 251,A00,507176,Mehta; Ravindra L.,9996,0,9999,3
1713515409446,CLRE 251,B00,511410,Mehta; Ravindra L.,9998,0,9999,1
1713515410477,CLRE 252,A00,507189,Cuomo; Raphael Eduardo,9998,0,9999,1
1713515411509,CLRE 253,A00,507199,Vaida; Florin,9997,0,9999,2
1713515411509,CLRE 253,B00,507202,Vaida; Florin,9999,0,9999,0
1713515412540,CLRE 259,A00,507211,Patel; Hemal,9996,0,9999,3
1713515413564,CLRE 260,A00,507221,Cuomo; Raphael Eduardo,9999,0,9999,0
1713515414592,CLRE 297,001,507242,Cuomo; Raphael Eduardo,9999,0,9999,0
1713515415621,CSE 191,A00,516875,Minnes Kemp; Mor Mia,9999,0,9999,0
1713515416646,CSS 201S,A01,494383,Staff,35,0,35,0
1713515417679,CSS 202S,A01,494387,Staff,35,0,35,0
1713515418704,EAP 100,A00,516065,Staff,9792,0,9999,207
1713515419734,ECE 45,A01,507414,Staff,37,0,60,23
1713515420766,ECE 100,A01,507416,Baghdadchi; Saharnaz,0,0,20,20
1713515420766,ECE 100,A02,507418,Baghdadchi; Saharnaz,19,0,20,1
1713515421799,ECE 111,A01,507420,Staff,27,0,50,23
1713515422826,ECE 197,001,548057,Sievenpiper; Daniel F.,9998,0,9999,1
1713515423851,EDS 115,A00,507243,Choi; Bailey Miyeon,27,0,28,1
1713515424876,EDS 117,A01,494379,Staff,14,0,25,11
1713515425902,EDS 125,A00,507246,Hopkins; Megan Beth,27,0,30,3
1713515426927,EDS 128A,A01,507264,Fargason; Sharon Gayle,26,0,26,0
1713515427954,EDS 128B,A01,507293,Pappas; Elizabeth,30,0,30,0
1713515428984,EDS 139,A00,507294,Fargason; Sharon Gayle,30,0,30,0
1713515428984,EDS 139,B00,507313,Pappas; Elizabeth,30,0,30,0
1713515430011,EDS 201,A00,507315,Staff,18,0,30,12
1713515431042,EDS 203,A01,507317,Halter; Christopher P.,17,0,30,13
1713515432070,EDS 204R,A01,507319,Halter; Christopher P.,0,1,30,30
1713515432070,EDS 204R,B01,507331,Heinzman; Erica M.,22,0,30,8
1713515433095,EDS 206R,A00,507332,Staff,0,2,30,30
1713515433095,EDS 206R,B00,507343,Staff,23,0,30,7
1713515434122,EDS 250,A00,507344,Hemans; Patricia Ann Benitez,27,0,40,13
1713515435147,EDS 281,A00,507345,Daly; Alan J.,18,0,18,0
1713515436179,EDS 284,A00,507350,Daly; Alan J.,16,0,16,0
1713515437209,EDS 286,A00,507359,Fine; Sarah,18,0,18,0
1713515438234,EDS 289C,A01,507361,Daly; Alan J.,18,0,18,0
1713515439260,EDS 290,A00,507366,Hofstetter; Carolyn,15,0,15,0
1713515440292,LIGM 5A,A00,507421,Fischer-Grunski; Eva K,20,0,20,0
1713515441325,LIGM 5B,A00,507423,Fischer-Grunski; Eva K,20,0,20,0
1713515442355,LIGM 5C,A00,507425,Fischer-Grunski; Eva K,20,0,20,0
1713515443388,LIIT 5AS,A00,507427,Carnelos; Chiara,20,0,20,0
1713515444420,LIIT 5BS,A00,507430,Carnelos; Chiara,20,0,20,0
1713515445449,LIIT 5CS,A00,507432,Carnelos; Chiara,20,0,20,0
1713515446479,LISP 5A,A00,507541,Munoz Sanchez; Alicia,14,0,20,6
1713515447504,LISP 5B,A00,507671,Munoz Sanchez; Alicia,12,0,20,8
1713515448532,LISP 5C,A00,507696,Munoz Sanchez; Alicia,11,0,20,9
1713515449559,MAE 197,001,528363,Boechler; Nicholas Sebastia,9998,0,9999,1
1713515450590,MATH 197,001,523477,Kedlaya; Kiran S.,9999,0,9999,0
1713515450590,MATH 197,002,563811,Zhang; Danna,9998,0,9999,1
1713515451616,MCWP 40R,A00,518780,Staff,13,0,20,7
1713515451616,MCWP 40R,B00,518781,Staff,11,0,20,9
1713515451616,MCWP 40R,C00,518783,Staff,8,0,20,12
1713515452647,MCWP 50R,A00,518791,Staff,7,0,20,13
1713515452647,MCWP 50R,B00,518792,Staff,3,0,20,17
1713515452647,MCWP 50R,C00,518793,Staff,5,0,20,15
1713515452647,MCWP 50R,D00,518794,Staff,0,0,20,20
1713515452647,MCWP 50R,E00,518795,Staff,0,0,20,20
1713515452647,MCWP 50R,F00,518796,Staff,10,0,20,10
1713515452647,MCWP 50R,G00,518797,Staff,10,0,20,10
1713515453683,MMW 12R,A01,514034,Herbst; Matthew,1,0,16,15
1713515453683,MMW 12R,A02,514035,Herbst; Matthew,13,0,16,3
1713515454709,MMW 13R,A01,514037,Staff,0,8,16,16
1713515454709,MMW 13R,A02,514039,Staff,0,7,16,16
1713515456769,SIO 295LS,A00,523233,Staff,15,0,30,15
1713515457799,SIO 295S,A00,523232,Staff,15,0,30,15
1713515458824,SOCI 117,A01,494376,Staff,0,2,5,5
1713515459850,WES 237B,A00,494380,Staff,19,0,20,1
1713515461980,AESE 279B,A00,494370,Wade; Jon P,33,0,33,0
1713515463006,AIP 197,001,627712,Vespa; Emanuel Ignacio,9999,0,9999,0
1713515464032,ANAR 135S,A00,494369,Braswell; Geoffrey E.,0,0,0,0
1713515465124,CAT 124RS,A01,519847,Geibel; William,6,0,20,14
1713515466149,CAT 125RS,A01,515971,Geibel; William,6,0,20,14
1713515467176,CLRE 250,A00,511389,Morris; Sheldon,9996,0,9999,3
1713515468209,CLRE 251,A00,507176,Mehta; Ravindra L.,9996,0,9999,3
1713515468209,CLRE 251,B00,511410,Mehta; Ravindra L.,9998,0,9999,1
1713515469241,CLRE 252,A00,507189,Cuomo; Raphael Eduardo,9998,0,9999,1
1713515470267,CLRE 253,A00,507199,Vaida; Florin,9997,0,9999,2
1713515470267,CLRE 253,B00,507202,Vaida; Florin,9999,0,9999,0
1713515471301,CLRE 259,A00,507211,Patel; Hemal,9996,0,9999,3
1713515472327,CLRE 260,A00,507221,Cuomo; Raphael Eduardo,9999,0,9999,0
1713515473358,CLRE 297,001,507242,Cuomo; Raphael Eduardo,9999,0,9999,0
1713515474384,CSE 191,A00,516875,Minnes Kemp; Mor Mia,9999,0,9999,0
1713515475412,CSS 201S,A01,494383,Staff,35,0,35,0
1713515476442,CSS 202S,A01,494387,Staff,35,0,35,0
1713515477467,EAP 100,A00,516065,Staff,9792,0,9999,207
1713515478494,ECE 45,A01,507414,Staff,37,0,60,23
1713515479529,ECE 100,A01,507416,Baghdadchi; Saharnaz,0,0,20,20
1713515479529,ECE 100,A02,507418,Baghdadchi; Saharnaz,19,0,20,1
1713515480559,ECE 111,A01,507420,Staff,27,0,50,23
1713515481586,ECE 197,001,548057,Sievenpiper; Daniel F.,9998,0,9999,1
1713515482641,EDS 115,A00,507243,Choi; Bailey Miyeon,27,0,28,1
1713515483673,EDS 117,A01,494379,Staff,14,0,25,11
1713515484698,EDS 125,A00,507246,Hopkins; Megan Beth,27,0,30,3
1713515485735,EDS 128A,A01,507264,Fargason; Sharon Gayle,26,0,26,0
1713515486762,EDS 128B,A01,507293,Pappas; Elizabeth,30,0,30,0
1713515487794,EDS 139,A00,507294,Fargason; Sharon Gayle,30,0,30,0
1713515487794,EDS 139,B00,507313,Pappas; Elizabeth,30,0,30,0
1713515488820,EDS 201,A00,507315,Staff,18,0,30,12
1713515489851,EDS 203,A01,507317,Halter; Christopher P.,17,0,30,13
1713515490885,EDS 204R,A01,507319,Halter; Christopher P.,0,1,30,30
1713515490885,EDS 204R,B01,507331,Heinzman; Erica M.,22,0,30,8
1713515491918,EDS 206R,A00,507332,Staff,0,2,30,30
1713515491918,EDS 206R,B00,507343,Staff,23,0,30,7
1713515492944,EDS 250,A00,507344,Hemans; Patricia Ann Benitez,27,0,40,13
1713515493969,EDS 281,A00,507345,Daly; Alan J.,18,0,18,0
1713515494999,EDS 284,A00,507350,Daly; Alan J.,16,0,16,0
1713515496030,EDS 286,A00,507359,Fine; Sarah,18,0,18,0
1713515497061,EDS 289C,A01,507361,Daly; Alan J.,18,0,18,0
1713515498087,EDS 290,A00,507366,Hofstetter; Carolyn,15,0,15,0
1713515499113,LIGM 5A,A00,507421,Fischer-Grunski; Eva K,20,0,20,0
1713515500145,LIGM 5B,A00,507423,Fischer-Grunski; Eva K,20,0,20,0
1713515501170,LIGM 5C,A00,507425,Fischer-Grunski; Eva K,20,0,20,0
1713515502196,LIIT 5AS,A00,507427,Carnelos; Chiara,20,0,20,0
1713515503229,LIIT 5BS,A00,507430,Carnelos; Chiara,20,0,20,0
1713515504262,LIIT 5CS,A00,507432,Carnelos; Chiara,20,0,20,0
1713515505289,LISP 5A,A00,507541,Munoz Sanchez; Alicia,14,0,20,6
1713515506315,LISP 5B,A00,507671,Munoz Sanchez; Alicia,12,0,20,8
1713515507341,LISP 5C,A00,507696,Munoz Sanchez; Alicia,11,0,20,9
1713515508367,MAE 197,001,528363,Boechler; Nicholas Sebastia,9998,0,9999,1
1713515509392,MATH 197,001,523477,Kedlaya; Kiran S.,9999,0,9999,0
1713515509392,MATH 197,002,563811,Zhang; Danna,9998,0,9999,1
1713515510425,MCWP 40R,A00,518780,Staff,13,0,20,7
1713515510425,MCWP 40R,B00,518781,Staff,11,0,20,9
1713515510425,MCWP 40R,C00,518783,Staff,8,0,20,12
1713515511458,MCWP 50R,A00,518791,Staff,7,0,20,13
1713515511458,MCWP 50R,B00,518792,Staff,3,0,20,17
1713515511458,MCWP 50R,C00,518793,Staff,5,0,20,15
1713515511458,MCWP 50R,D00,518794,Staff,0,0,20,20
1713515511458,MCWP 50R,E00,518795,Staff,0,0,20,20
1713515511458,MCWP 50R,F00,518796,Staff,10,0,20,10
1713515511458,MCWP 50R,G00,518797,Staff,10,0,20,10
1713515512482,MMW 12R,A01,514034,Herbst; Matthew,1,0,16,15
1713515512482,MMW 12R,A02,514035,Herbst; Matthew,13,0,16,3
1713515513515,MMW 13R,A01,514037,Staff,0,8,16,16
1713515513515,MMW 13R,A02,514039,Staff,0,7,16,16
1713515515577,SIO 295LS,A00,523233,Staff,15,0,30,15
1713515516603,SIO 295S,A00,523232,Staff,15,0,30,15
1713515517636,SOCI 117,A01,494376,Staff,0,2,5,5
1713515518667,WES 237B,A00,494380,Staff,19,0,20,1
1713515520746,AESE 279B,A00,494370,Wade; Jon P,33,0,33,0
1713515521773,AIP 197,001,627712,Vespa; Emanuel Ignacio,9999,0,9999,0
1713515522797,ANAR 135S,A00,494369,Braswell; Geoffrey E.,0,0,0,0
1713515523829,CAT 124RS,A01,519847,Geibel; William,6,0,20,14
1713515524854,CAT 125RS,A01,515971,Geibel; William,6,0,20,14
1713515525880,CLRE 250,A00,511389,Morris; Sheldon,9996,0,9999,3
1713515526907,CLRE 251,A00,507176,Mehta; Ravindra L.,9996,0,9999,3
1713515526907,CLRE 251,B00,511410,Mehta; Ravindra L.,9998,0,9999,1
1713515527932,CLRE 252,A00,507189,Cuomo; Raphael Eduardo,9998,0,9999,1
1713515528963,CLRE 253,A00,507199,Vaida; Florin,9997,0,9999,2
1713515528963,CLRE 253,B00,507202,Vaida; Florin,9999,0,9999,0
1713515529991,CLRE 259,A00,507211,Patel; Hemal,9996,0,9999,3
1713515531024,CLRE 260,A00,507221,Cuomo; Raphael Eduardo,9999,0,9999,0
1713515532049,CLRE 297,001,507242,Cuomo; Raphael Eduardo,9999,0,9999,0
1713515533086,CSE 191,A00,516875,Minnes Kemp; Mor Mia,9999,0,9999,0
1713515534112,CSS 201S,A01,494383,Staff,35,0,35,0
1713515535149,CSS 202S,A01,494387,Staff,35,0,35,0
1713515536175,EAP 100,A00,516065,Staff,9792,0,9999,207
1713515537206,ECE 45,A01,507414,Staff,37,0,60,23
1713515538232,ECE 100,A01,507416,Baghdadchi; Saharnaz,0,0,20,20
1713515538232,ECE 100,A02,507418,Baghdadchi; Saharnaz,19,0,20,1
1713515539257,ECE 111,A01,507420,Staff,27,0,50,23
1713515540282,ECE 197,001,548057,Sievenpiper; Daniel F.,9998,0,9999,1
1713515541308,EDS 115,A00,507243,Choi; Bailey Miyeon,27,0,28,1
1713515542334,EDS 117,A01,494379,Staff,14,0,25,11
1713515543360,EDS 125,A00,507246,Hopkins; Megan Beth,27,0,30,3
1713515544386,EDS 128A,A01,507264,Fargason; Sharon Gayle,26,0,26,0
1713515545411,EDS 128B,A01,507293,Pappas; Elizabeth,30,0,30,0
1713515546437,EDS 139,A00,507294,Fargason; Sharon Gayle,30,0,30,0
1713515546437,EDS 139,B00,507313,Pappas; Elizabeth,30,0,30,0
1713515547467,EDS 201,A00,507315,Staff,18,0,30,12
1713515548492,EDS 203,A01,507317,Halter; Christopher P.,17,0,30,13
1713515549526,EDS 204R,A01,507319,Halter; Christopher P.,0,1,30,30
1713515549526,EDS 204R,B01,507331,Heinzman; Erica M.,22,0,30,8
1713515550552,EDS 206R,A00,507332,Staff,0,2,30,30
1713515550552,EDS 206R,B00,507343,Staff,23,0,30,7
1713515551576,EDS 250,A00,507344,Hemans; Patricia Ann Benitez,27,0,40,13
1713515552608,EDS 281,A00,507345,Daly; Alan J.,18,0,18,0
1713515553633,EDS 284,A00,507350,Daly; Alan J.,16,0,16,0
1713515554665,EDS 286,A00,507359,Fine; Sarah,18,0,18,0
1713515555692,EDS 289C,A01,507361,Daly; Alan J.,18,0,18,0
1713515556723,EDS 290,A00,507366,Hofstetter; Carolyn,15,0,15,0
1713515557749,LIGM 5A,A00,507421,Fischer-Grunski; Eva K,20,0,20,0
1713515558775,LIGM 5B,A00,507423,Fischer-Grunski; Eva K,20,0,20,0
1713515559802,LIGM 5C,A00,507425,Fischer-Grunski; Eva K,20,0,20,0
1713515560828,LIIT 5AS,A00,507427,Carnelos; Chiara,20,0,20,0
1713515561861,LIIT 5BS,A00,507430,Carnelos; Chiara,20,0,20,0
1713515562887,LIIT 5CS,A00,507432,Carnelos; Chiara,20,0,20,0
1713515563913,LISP 5A,A00,507541,Munoz Sanchez; Alicia,14,0,20,6
1713515564994,LISP 5B,A00,507671,Munoz Sanchez; Alicia,12,0,20,8
1713515566021,LISP 5C,A00,507696,Munoz Sanchez; Alicia,11,0,20,9
1713515567046,MAE 197,001,528363,Boechler; Nicholas Sebastia,9998,0,9999,1
1713515568076,MATH 197,001,523477,Kedlaya; Kiran S.,9999,0,9999,0
1713515568076,MATH 197,002,563811,Zhang; Danna,9998,0,9999,1
1713515569113,MCWP 40R,A00,518780,Staff,13,0,20,7
1713515569113,MCWP 40R,B00,518781,Staff,11,0,20,9
1713515569113,MCWP 40R,C00,518783,Staff,8,0,20,12
1713515570150,MCWP 50R,A00,518791,Staff,7,0,20,13
1713515570150,MCWP 50R,B00,518792,Staff,3,0,20,17
1713515570150,MCWP 50R,C00,518793,Staff,5,0,20,15
1713515570150,MCWP 50R,D00,518794,Staff,0,0,20,20
1713515570150,MCWP 50R,E00,518795,Staff,0,0,20,20
1713515570150,MCWP 50R,F00,518796,Staff,10,0,20,10
1713515570150,MCWP 50R,G00,518797,Staff,10,0,20,10
1713515571182,MMW 12R,A01,514034,Herbst; Matthew,1,0,16,15
1713515571182,MMW 12R,A02,514035,Herbst; Matthew,13,0,16,3
1713515572213,MMW 13R,A01,514037,Staff,0,8,16,16
1713515572213,MMW 13R,A02,514039,Staff,0,7,16,16
1713515574291,SIO 295LS,A00,523233,Staff,15,0,30,15
1713515575317,SIO 295S,A00,523232,Staff,15,0,30,15
1713515576344,SOCI 117,A01,494376,Staff,0,2,5,5
1713515577370,WES 237B,A00,494380,Staff,19,0,20,1
1713515579435,AESE 279B,A00,494370,Wade; Jon P,33,0,33,0
1713515580462,AIP 197,001,627712,Vespa; Emanuel Ignacio,9999,0,9999,0
1713515581488,ANAR 135S,A00,494369,Braswell; Geoffrey E.,0,0,0,0
1713515582513,CAT 124RS,A01,519847,Geibel; William,6,0,20,14
1713515583547,CAT 125RS,A01,515971,Geibel; William,6,0,20,14
1713515584578,CLRE 250,A00,511389,Morris; Sheldon,9996,0,9999,3
1713515585605,CLRE 251,A00,507176,Mehta; Ravindra L.,9996,0,9999,3
1713515585605,CLRE 251,B00,511410,Mehta; Ravindra L.,9998,0,9999,1
1713515586638,CLRE 252,A00,507189,Cuomo; Raphael Eduardo,9998,0,9999,1
1713515587664,CLRE 253,A00,507199,Vaida; Florin,9997,0,9999,2
1713515587664,CLRE 253,B00,507202,Vaida; Florin,9999,0,9999,0
1713515588691,CLRE 259,A00,507211,Patel; Hemal,9996,0,9999,3
1713515589722,CLRE 260,A00,507221,Cuomo; Raphael Eduardo,9999,0,9999,0
1713515590747,CLRE 297,001,507242,Cuomo; Raphael Eduardo,9999,0,9999,0
1713515591773,CSE 191,A00,516875,Minnes Kemp; Mor Mia,9999,0,9999,0
1713515592805,CSS 201S,A01,494383,Staff,35,0,35,0
1713515593837,CSS 202S,A01,494387,Staff,35,0,35,0
1713515594863,EAP 100,A00,516065,Staff,9792,0,9999,207
1713515595893,ECE 45,A01,507414,Staff,37,0,60,23
1713515596919,ECE 100,A01,507416,Baghdadchi; Saharnaz,0,0,20,20
1713515596919,ECE 100,A02,507418,Baghdadchi; Saharnaz,19,0,20,1
1713515597952,ECE 111,A01,507420,Staff,27,0,50,23
1713515598982,ECE 197,001,548057,Sievenpiper; Daniel F.,9998,0,9999,1
1713515600017,EDS 115,A00,507243,Choi; Bailey Miyeon,27,0,28,1
1713515601047,EDS 117,A01,494379,Staff,14,0,25,11
1713515602075,EDS 125,A00,507246,Hopkins; Megan Beth,27,0,30,3
1713515603112,EDS 128A,A01,507264,Fargason; Sharon Gayle,26,0,26,0
1713515604138,EDS 128B,A01,507293,Pappas; Elizabeth,30,0,30,0
1713515605168,EDS 139,A00,507294,Fargason; Sharon Gayle,30,0,30,0
1713515605168,EDS 139,B00,507313,Pappas; Elizabeth,30,0,30,0
1713515606200,EDS 201,A00,507315,Staff,18,0,30,12
1713515607236,EDS 203,A01,507317,Halter; Christopher P.,17,0,30,13
1713515608273,EDS 204R,A01,507319,Halter; Christopher P.,0,1,30,30
1713515608273,EDS 204R,B01,507331,Heinzman; Erica M.,22,0,30,8
1713515609299,EDS 206R,A00,507332,Staff,0,2,30,30
1713515609299,EDS 206R,B00,507343,Staff,23,0,30,7
1713515610325,EDS 250,A00,507344,Hemans; Patricia Ann Benitez,27,0,40,13
1713515611352,EDS 281,A00,507345,Daly; Alan J.,18,0,18,0
1713515612377,EDS 284,A00,507350,Daly; Alan J.,16,0,16,0
1713515613403,EDS 286,A00,507359,Fine; Sarah,18,0,18,0
1713515614429,EDS 289C,A01,507361,Daly; Alan J.,18,0,18,0
1713515615460,EDS 290,A00,507366,Hofstetter; Carolyn,15,0,15,0
1713515616486,LIGM 5A,A00,507421,Fischer-Grunski; Eva K,20,0,20,0
1713515617521,LIGM 5B,A00,507423,Fischer-Grunski; Eva K,20,0,20,0
1713515618556,LIGM 5C,A00,507425,Fischer-Grunski; Eva K,20,0,20,0
1713515619592,LIIT 5AS,A00,507427,Carnelos; Chiara,20,0,20,0
1713515620619,LIIT 5BS,A00,507430,Carnelos; Chiara,20,0,20,0
1713515621656,LIIT 5CS,A00,507432,Carnelos; Chiara,20,0,20,0
1713515622693,LISP 5A,A00,507541,Munoz Sanchez; Alicia,14,0,20,6
1713515623718,LISP 5B,A00,507671,Munoz Sanchez; Alicia,12,0,20,8
1713515624753,LISP 5C,A00,507696,Munoz Sanchez; Alicia,11,0,20,9
1713515625788,MAE 197,001,528363,Boechler; Nicholas Sebastia,9998,0,9999,1
1713515626815,MATH 197,001,523477,Kedlaya; Kiran S.,9999,0,9999,0
1713515626815,MATH 197,002,563811,Zhang; Danna,9998,0,9999,1
1713515627842,MCWP 40R,A00,518780,Staff,13,0,20,7
1713515627842,MCWP 40R,B00,518781,Staff,11,0,20,9
1713515627842,MCWP 40R,C00,518783,Staff,8,0,20,12
1713515628869,MCWP 50R,A00,518791,Staff,7,0,20,13
1713515628869,MCWP 50R,B00,518792,Staff,3,0,20,17
1713515628869,MCWP 50R,C00,518793,Staff,5,0,20,15
1713515628869,MCWP 50R,D00,518794,Staff,0,0,20,20
1713515628869,MCWP 50R,E00,518795,Staff,0,0,20,20
1713515628869,MCWP 50R,F00,518796,Staff,10,0,20,10
1713515628869,MCWP 50R,G00,518797,Staff,10,0,20,10
1713515629904,MMW 12R,A01,514034,Herbst; Matthew,1,0,16,15
1713515629904,MMW 12R,A02,514035,Herbst; Matthew,13,0,16,3
1713515630932,MMW 13R,A01,514037,Staff,0,8,16,16
1713515630932,MMW 13R,A02,514039,Staff,0,7,16,16
1713515632990,SIO 295LS,A00,523233,Staff,15,0,30,15
1713515634014,SIO 295S,A00,523232,Staff,15,0,30,15
1713515635048,SOCI 117,A01,494376,Staff,0,2,5,5
1713515636083,WES 237B,A00,494380,Staff,19,0,20,1
1713515638158,AESE 279B,A00,494370,Wade; Jon P,33,0,33,0
1713515639184,AIP 197,001,627712,Vespa; Emanuel Ignacio,9999,0,9999,0
1713515640209,ANAR 135S,A00,494369,Braswell; Geoffrey E.,0,0,0,0
1713515641233,CAT 124RS,A01,519847,Geibel; William,6,0,20,14
1713515642259,CAT 125RS,A01,515971,Geibel; William,6,0,20,14
1713515643299,CLRE 250,A00,511389,Morris; Sheldon,9996,0,9999,3
1713515644325,CLRE 251,A00,507176,Mehta; Ravindra L.,9996,0,9999,3
1713515644325,CLRE 251,B00,511410,Mehta; Ravindra L.,9998,0,9999,1
1713515645350,CLRE 252,A00,507189,Cuomo; Raphael Eduardo,9998,0,9999,1
1713515646386,CLRE 253,A00,507199,Vaida; Florin,9997,0,9999,2
1713515646386,CLRE 253,B00,507202,Vaida; Florin,9999,0,9999,0
1713515647410,CLRE 259,A00,507211,Patel; Hemal,9996,0,9999,3
1713515648435,CLRE 260,A00,507221,Cuomo; Raphael Eduardo,9999,0,9999,0
1713515649466,CLRE 297,001,507242,Cuomo; Raphael Eduardo,9999,0,9999,0
1713515650492,CSE 191,A00,516875,Minnes Kemp; Mor Mia,9999,0,9999,0
1713515651529,CSS 201S,A01,494383,Staff,35,0,35,0
1713515652557,CSS 202S,A01,494387,Staff,35,0,35,0
1713515653583,EAP 100,A00,516065,Staff,9792,0,9999,207
1713515654617,ECE 45,A01,507414,Staff,37,0,60,23
1713515655644,ECE 100,A01,507416,Baghdadchi; Saharnaz,0,0,20,20
1713515655644,ECE 100,A02,507418,Baghdadchi; Saharnaz,19,0,20,1
1713515656668,ECE 111,A01,507420,Staff,27,0,50,23
1713515657694,ECE 197,001,548057,Sievenpiper; Daniel F.,9998,0,9999,1
1713515658727,EDS 115,A00,507243,Choi; Bailey Miyeon,27,0,28,1
1713515659758,EDS 117,A01,494379,Staff,14,0,25,11
1713515660785,EDS 125,A00,507246,Hopkins; Megan Beth,27,0,30,3
1713515661811,EDS 128A,A01,507264,Fargason; Sharon Gayle,26,0,26,0
1713515662840,EDS 128B,A01,507293,Pappas; Elizabeth,30,0,30,0
1713515663873,EDS 139,A00,507294,Fargason; Sharon Gayle,30,0,30,0
1713515663873,EDS 139,B00,507313,Pappas; Elizabeth,30,0,30,0
1713515664899,EDS 201,A00,507315,Staff,18,0,30,12
1713515665932,EDS 203,A01,507317,Halter; Christopher P.,17,0,30,13
1713515666960,EDS 204R,A01,507319,Halter; Christopher P.,0,1,30,30
1713515666960,EDS 204R,B01,507331,Heinzman; Erica M.,22,0,30,8
1713515667987,EDS 206R,A00,507332,Staff,0,2,30,30
1713515667987,EDS 206R,B00,507343,Staff,23,0,30,7
1713515669066,EDS 250,A00,507344,Hemans; Patricia Ann Benitez,27,0,40,13
1713515670098,EDS 281,A00,507345,Daly; Alan J.,18,0,18,0
1713515671124,EDS 284,A00,507350,Daly; Alan J.,16,0,16,0
1713515672152,EDS 286,A00,507359,Fine; Sarah,18,0,18,0
1713515673178,EDS 289C,A01,507361,Daly; Alan J.,18,0,18,0
1713515674204,EDS 290,A00,507366,Hofstetter; Carolyn,15,0,15,0
1713515675230,LIGM 5A,A00,507421,Fischer-Grunski; Eva K,20,0,20,0
1713515676261,LIGM 5B,A00,507423,Fischer-Grunski; Eva K,20,0,20,0
1713515677287,LIGM 5C,A00,507425,Fischer-Grunski; Eva K,20,0,20,0
1713515678313,LIIT 5AS,A00,507427,Carnelos; Chiara,20,0,20,0
1713515679339,LIIT 5BS,A00,507430,Carnelos; Chiara,20,0,20,0
1713515680370,LIIT 5CS,A00,507432,Carnelos; Chiara,20,0,20,0
1713515681396,LISP 5A,A00,507541,Munoz Sanchez; Alicia,14,0,20,6
1713515682424,LISP 5B,A00,507671,Munoz Sanchez; Alicia,12,0,20,8
1713515683450,LISP 5C,A00,507696,Munoz Sanchez; Alicia,11,0,20,9
1713515684477,MAE 197,001,528363,Boechler; Nicholas Sebastia,9998,0,9999,1
1713515685507,MATH 197,001,523477,Kedlaya; Kiran S.,9999,0,9999,0
1713515685507,MATH 197,002,563811,Zhang; Danna,9998,0,9999,1
1713515686533,MCWP 40R,A00,518780,Staff,13,0,20,7
1713515686533,MCWP 40R,B00,518781,Staff,11,0,20,9
1713515686533,MCWP 40R,C00,518783,Staff,8,0,20,12
1713515687559,MCWP 50R,A00,518791,Staff,7,0,20,13
1713515687559,MCWP 50R,B00,518792,Staff,3,0,20,17
1713515687559,MCWP 50R,C00,518793,Staff,5,0,20,15
1713515687559,MCWP 50R,D00,518794,Staff,0,0,20,20
1713515687559,MCWP 50R,E00,518795,Staff,0,0,20,20
1713515687559,MCWP 50R,F00,518796,Staff,10,0,20,10
1713515687559,MCWP 50R,G00,518797,Staff,10,0,20,10
1713515688587,MMW 12R,A01,514034,Herbst; Matthew,1,0,16,15
1713515688587,MMW 12R,A02,514035,Herbst; Matthew,13,0,16,3
1713515689613,MMW 13R,A01,514037,Staff,0,8,16,16
1713515689613,MMW 13R,A02,514039,Staff,0,7,16,16
1713515691664,SIO 295LS,A00,523233,Staff,15,0,30,15
1713515692687,SIO 295S,A00,523232,Staff,15,0,30,15
1713515693714,SOCI 117,A01,494376,Staff,0,2,5,5
1713515694741,WES 237B,A00,494380,Staff,19,0,20,1
1713515696864,AESE 279B,A00,494370,Wade; Jon P,33,0,33,0
1713515697889,AIP 197,001,627712,Vespa; Emanuel Ignacio,9999,0,9999,0
1713515698920,ANAR 135S,A00,494369,Braswell; Geoffrey E.,0,0,0,0
1713515699946,CAT 124RS,A01,519847,Geibel; William,6,0,20,14
1713515700972,CAT 125RS,A01,515971,Geibel; William,6,0,20,14
1713515702008,CLRE 250,A00,511389,Morris; Sheldon,9996,0,9999,3
1713515703045,CLRE 251,A00,507176,Mehta; Ravindra L.,9996,0,9999,3
1713515703045,CLRE 251,B00,511410,Mehta; Ravindra L.,9998,0,9999,1
1713515704072,CLRE 252,A00,507189,Cuomo; Raphael Eduardo,9998,0,9999,1
1713515705099,CLRE 253,A00,507199,Vaida; Florin,9997,0,9999,2
1713515705099,CLRE 253,B00,507202,Vaida; Florin,9999,0,9999,0
1713515706125,CLRE 259,A00,507211,Patel; Hemal,9996,0,9999,3
1713515707151,CLRE 260,A00,507221,Cuomo; Raphael Eduardo,9999,0,9999,0
1713515708175,CLRE 297,001,507242,Cuomo; Raphael Eduardo,9999,0,9999,0
1713515709202,CSE 191,A00,516875,Minnes Kemp; Mor Mia,9999,0,9999,0
1713515710232,CSS 201S,A01,494383,Staff,35,0,35,0
1713515711258,CSS 202S,A01,494387,Staff,35,0,35,0
1713515712285,EAP 100,A00,516065,Staff,9792,0,9999,207
1713515713312,ECE 45,A01,507414,Staff,37,0,60,23
1713515714338,ECE 100,A01,507416,Baghdadchi; Saharnaz,0,0,20,20
1713515714338,ECE 100,A02,507418,Baghdadchi; Saharnaz,19,0,20,1
1713515715362,ECE 111,A01,507420,Staff,27,0,50,23
1713515716387,ECE 197,001,548057,Sievenpiper; Daniel F.,9998,0,9999,1
1713515717414,EDS 115,A00,507243,Choi; Bailey Miyeon,27,0,28,1
1713515718442,EDS 117,A01,494379,Staff,14,0,25,11
1713515719474,EDS 125,A00,507246,Hopkins; Megan Beth,27,0,30,3
1713515720505,EDS 128A,A01,507264,Fargason; Sharon Gayle,26,0,26,0
1713515721536,EDS 128B,A01,507293,Pappas; Elizabeth,30,0,30,0
1713515722568,EDS 139,A00,507294,Fargason; Sharon Gayle,30,0,30,0
1713515722568,EDS 139,B00,507313,Pappas; Elizabeth,30,0,30,0
1713515723598,EDS 201,A00,507315,Staff,18,0,30,12
1713515724631,EDS 203,A01,507317,Halter; Christopher P.,17,0,30,13
1713515725656,EDS 204R,A01,507319,Halter; Christopher P.,0,1,30,30
1713515725656,EDS 204R,B01,507331,Heinzman; Erica M.,22,0,30,8
1713515726683,EDS 206R,A00,507332,Staff,0,2,30,30
1713515726683,EDS 206R,B00,507343,Staff,23,0,30,7
1713515727714,EDS 250,A00,507344,Hemans; Patricia Ann Benitez,27,0,40,13
1713515728739,EDS 281,A00,507345,Daly; Alan J.,18,0,18,0
1713515729764,EDS 284,A00,507350,Daly; Alan J.,16,0,16,0
1713515730796,EDS 286,A00,507359,Fine; Sarah,18,0,18,0
1713515731824,EDS 289C,A01,507361,Daly; Alan J.,18,0,18,0
1713515732858,EDS 290,A00,507366,Hofstetter; Carolyn,15,0,15,0
1713515733884,LIGM 5A,A00,507421,Fischer-Grunski; Eva K,20,0,20,0
1713515734915,LIGM 5B,A00,507423,Fischer-Grunski; Eva K,20,0,20,0
1713515735939,LIGM 5C,A00,507425,Fischer-Grunski; Eva K,20,0,20,0
1713515736965,LIIT 5AS,A00,507427,Carnelos; Chiara,20,0,20,0
1713515737998,LIIT 5BS,A00,507430,Carnelos; Chiara,20,0,20,0
1713515739024,LIIT 5CS,A00,507432,Carnelos; Chiara,20,0,20,0
1713515740050,LISP 5A,A00,507541,Munoz Sanchez; Alicia,14,0,20,6
1713515741079,LISP 5B,A00,507671,Munoz Sanchez; Alicia,12,0,20,8
1713515742105,LISP 5C,A00,507696,Munoz Sanchez; Alicia,11,0,20,9
1713515743133,MAE 197,001,528363,Boechler; Nicholas Sebastia,9998,0,9999,1
1713515744158,MATH 197,001,523477,Kedlaya; Kiran S.,9999,0,9999,0
1713515744158,MATH 197,002,563811,Zhang; Danna,9998,0,9999,1
1713515745183,MCWP 40R,A00,518780,Staff,13,0,20,7
1713515745183,MCWP 40R,B00,518781,Staff,11,0,20,9
1713515745183,MCWP 40R,C00,518783,Staff,8,0,20,12
1713515746215,MCWP 50R,A00,518791,Staff,7,0,20,13
1713515746215,MCWP 50R,B00,518792,Staff,3,0,20,17
1713515746215,MCWP 50R,C00,518793,Staff,5,0,20,15
1713515746215,MCWP 50R,D00,518794,Staff,0,0,20,20
1713515746215,MCWP 50R,E00,518795,Staff,0,0,20,20
1713515746215,MCWP 50R,F00,518796,Staff,10,0,20,10
1713515746215,MCWP 50R,G00,518797,Staff,10,0,20,10
1713515747247,MMW 12R,A01,514034,Herbst; Matthew,1,0,16,15
1713515747247,MMW 12R,A02,514035,Herbst; Matthew,13,0,16,3
1713515748280,MMW 13R,A01,514037,Staff,0,8,16,16
1713515748280,MMW 13R,A02,514039,Staff,0,7,16,16
1713515750334,SIO 295LS,A00,523233,Staff,15,0,30,15
1713515751364,SIO 295S,A00,523232,Staff,15,0,30,15
1713515752390,SOCI 117,A01,494376,Staff,0,2,5,5
1713515753416,WES 237B,A00,494380,Staff,19,0,20,1
1713515755490,AESE 279B,A00,494370,Wade; Jon P,33,0,33,0
1713515756520,AIP 197,001,627712,Vespa; Emanuel Ignacio,9999,0,9999,0
1713515757551,ANAR 135S,A00,494369,Braswell; Geoffrey E.,0,0,0,0
1713515758579,CAT 124RS,A01,519847,Geibel; William,6,0,20,14
1713515759608,CAT 125RS,A01,515971,Geibel; William,6,0,20,14
1713515760637,CLRE 250,A00,511389,Morris; Sheldon,9996,0,9999,3
1713515761670,CLRE 251,A00,507176,Mehta; Ravindra L.,9996,0,9999,3
1713515761670,CLRE 251,B00,511410,Mehta; Ravindra L.,9998,0,9999,1
1713515762696,CLRE 252,A00,507189,Cuomo; Raphael Eduardo,9998,0,9999,1
1713515763723,CLRE 253,A00,507199,Vaida; Florin,9997,0,9999,2
1713515763723,CLRE 253,B00,507202,Vaida; Florin,9999,0,9999,0
1713515764749,CLRE 259,A00,507211,Patel; Hemal,9996,0,9999,3
1713515765775,CLRE 260,A00,507221,Cuomo; Raphael Eduardo,9999,0,9999,0
1713515766799,CLRE 297,001,507242,Cuomo; Raphael Eduardo,9999,0,9999,0
1713515767825,CSE 191,A00,516875,Minnes Kemp; Mor Mia,9999,0,9999,0
1713515768855,CSS 201S,A01,494383,Staff,35,0,35,0
1713515769885,CSS 202S,A01,494387,Staff,35,0,35,0
1713515770912,EAP 100,A00,516065,Staff,9792,0,9999,207
1713515771942,ECE 45,A01,507414,Staff,37,0,60,23
1713515773030,ECE 100,A01,507416,Baghdadchi; Saharnaz,0,0,20,20
1713515773030,ECE 100,A02,507418,Baghdadchi; Saharnaz,19,0,20,1
1713515774056,ECE 111,A01,507420,Staff,27,0,50,23
1713515775087,ECE 197,001,548057,Sievenpiper; Daniel F.,9998,0,9999,1
1713515776113,EDS 115,A00,507243,Choi; Bailey Miyeon,27,0,28,1
1713515777139,EDS 117,A01,494379,Staff,14,0,25,11
1713515778173,EDS 125,A00,507246,Hopkins; Megan Beth,27,0,30,3
1713515779205,EDS 128A,A01,507264,Fargason; Sharon Gayle,26,0,26,0
1713515780230,EDS 128B,A01,507293,Pappas; Elizabeth,30,0,30,0
1713515781255,EDS 139,A00,507294,Fargason; Sharon Gayle,30,0,30,0
1713515781255,EDS 139,B00,507313,Pappas; Elizabeth,30,0,30,0
1713515782280,EDS 201,A00,507315,Staff,18,0,30,12
1713515783307,EDS 203,A01,507317,Halter; Christopher P.,17,0,30,13
1713515784338,EDS 204R,A01,507319,Halter; Christopher P.,0,1,30,30
1713515784338,EDS 204R,B01,507331,Heinzman; Erica M.,22,0,30,8
1713515785368,EDS 206R,A00,507332,Staff,0,2,30,30
1713515785368,EDS 206R,B00,507343,Staff,23,0,30,7
1713515786394,EDS 250,A00,507344,Hemans; Patricia Ann Benitez,27,0,40,13
1713515787419,EDS 281,A00,507345,Daly; Alan J.,18,0,18,0
1713515788445,EDS 284,A00,507350,Daly; Alan J.,16,0,16,0
1713515789474,EDS 286,A00,507359,Fine; Sarah,18,0,18,0
1713515790506,EDS 289C,A01,507361,Daly; Alan J.,18,0,18,0
1713515791533,EDS 290,A00,507366,Hofstetter; Carolyn,15,0,15,0
1713515792559,LIGM 5A,A00,507421,Fischer-Grunski; Eva K,20,0,20,0
1713515793590,LIGM 5B,A00,507423,Fischer-Grunski; Eva K,20,0,20,0
1713515794615,LIGM 5C,A00,507425,Fischer-Grunski; Eva K,20,0,20,0
1713515795641,LIIT 5AS,A00,507427,Carnelos; Chiara,20,0,20,0
1713515796665,LIIT 5BS,A00,507430,Carnelos; Chiara,20,0,20,0
1713515797690,LIIT 5CS,A00,507432,Carnelos; Chiara,20,0,20,0
1713515798718,LISP 5A,A00,507541,Munoz Sanchez; Alicia,14,0,20,6
1713515799750,LISP 5B,A00,507671,Munoz Sanchez; Alicia,12,0,20,8
1713515800777,LISP 5C,A00,507696,Munoz Sanchez; Alicia,11,0,20,9
1713515801802,MAE 197,001,528363,Boechler; Nicholas Sebastia,9998,0,9999,1
1713515802827,MATH 197,001,523477,Kedlaya; Kiran S.,9999,0,9999,0
1713515802827,MATH 197,002,563811,Zhang; Danna,9998,0,9999,1
1713515803861,MCWP 40R,A00,518780,Staff,13,0,20,7
1713515803861,MCWP 40R,B00,518781,Staff,11,0,20,9
1713515803861,MCWP 40R,C00,518783,Staff,8,0,20,12
1713515804891,MCWP 50R,A00,518791,Staff,7,0,20,13
1713515804891,MCWP 50R,B00,518792,Staff,3,0,20,17
1713515804891,MCWP 50R,C00,518793,Staff,5,0,20,15
1713515804891,MCWP 50R,D00,518794,Staff,0,0,20,20
1713515804891,MCWP 50R,E00,518795,Staff,0,0,20,20
1713515804891,MCWP 50R,F00,518796,Staff,10,0,20,10
1713515804891,MCWP 50R,G00,518797,Staff,10,0,20,10
1713515805917,MMW 12R,A01,514034,Herbst; Matthew,1,0,16,15
1713515805917,MMW 12R,A02,514035,Herbst; Matthew,13,0,16,3
1713515806943,MMW 13R,A01,514037,Staff,0,8,16,16
1713515806943,MMW 13R,A02,514039,Staff,0,7,16,16
1713515808994,SIO 295LS,A00,523233,Staff,15,0,30,15
1713515810019,SIO 295S,A00,523232,Staff,15,0,30,15
1713515811044,SOCI 117,A01,494376,Staff,0,2,5,5
1713515812071,WES 237B,A00,494380,Staff,19,0,20,1
1713515814141,AESE 279B,A00,494370,Wade; Jon P,33,0,33,0
1713515815168,AIP 197,001,627712,Vespa; Emanuel Ignacio,9999,0,9999,0
1713515816194,ANAR 135S,A00,494369,Braswell; Geoffrey E.,0,0,0,0
1713515817220,CAT 124RS,A01,519847,Geibel; William,6,0,20,14
1713515818251,CAT 125RS,A01,515971,Geibel; William,6,0,20,14
1713515819281,CLRE 250,A00,511389,Morris; Sheldon,9996,0,9999,3
1713515820321,CLRE 251,A00,507176,Mehta; Ravindra L.,9996,0,9999,3
1713515820321,CLRE 251,B00,511410,Mehta; Ravindra L.,9998,0,9999,1
1713515821345,CLRE 252,A00,507189,Cuomo; Raphael Eduardo,9998,0,9999,1
1713515822373,CLRE 253,A00,507199,Vaida; Florin,9997,0,9999,2
1713515822373,CLRE 253,B00,507202,Vaida; Florin,9999,0,9999,0
1713515823399,CLRE 259,A00,507211,Patel; Hemal,9996,0,9999,3
1713515824424,CLRE 260,A00,507221,Cuomo; Raphael Eduardo,9999,0,9999,0
1713515825459,CLRE 297,001,507242,Cuomo; Raphael Eduardo,9999,0,9999,0
1713515826487,CSE 191,A00,516875,Minnes Kemp; Mor Mia,9999,0,9999,0
1713515827511,CSS 201S,A01,494383,Staff,35,0,35,0
1713515828537,CSS 202S,A01,494387,Staff,35,0,35,0
1713515829562,EAP 100,A00,516065,Staff,9792,0,9999,207
1713515830588,ECE 45,A01,507414,Staff,37,0,60,23
1713515831620,ECE 100,A01,507416,Baghdadchi; Saharnaz,0,0,20,20
1713515831620,ECE 100,A02,507418,Baghdadchi; Saharnaz,19,0,20,1
1713515832653,ECE 111,A01,507420,Staff,27,0,50,23
1713515833677,ECE 197,001,548057,Sievenpiper; Daniel F.,9998,0,9999,1
1713515834703,EDS 115,A00,507243,Choi; Bailey Miyeon,27,0,28,1
1713515835736,EDS 117,A01,494379,Staff,14,0,25,11
1713515836763,EDS 125,A00,507246,Hopkins; Megan Beth,27,0,30,3
1713515837794,EDS 128A,A01,507264,Fargason; Sharon Gayle,26,0,26,0
1713515838821,EDS 128B,A01,507293,Pappas; Elizabeth,30,0,30,0
1713515839846,EDS 139,A00,507294,Fargason; Sharon Gayle,30,0,30,0
1713515839846,EDS 139,B00,507313,Pappas; Elizabeth,30,0,30,0
1713515840871,EDS 201,A00,507315,Staff,18,0,30,12
1713515841903,EDS 203,A01,507317,Halter; Christopher P.,17,0,30,13
1713515842930,EDS 204R,A01,507319,Halter; Christopher P.,0,1,30,30
1713515842930,EDS 204R,B01,507331,Heinzman; Erica M.,22,0,30,8
1713515843958,EDS 206R,A00,507332,Staff,0,2,30,30
1713515843958,EDS 206R,B00,507343,Staff,23,0,30,7
1713515844984,EDS 250,A00,507344,Hemans; Patricia Ann Benitez,27,0,40,13
1713515846010,EDS 281,A00,507345,Daly; Alan J.,18,0,18,0
1713515847035,EDS 284,A00,507350,Daly; Alan J.,16,0,16,0
1713515848065,EDS 286,A00,507359,Fine; Sarah,18,0,18,0
1713515849091,EDS 289C,A01,507361,Daly; Alan J.,18,0,18,0
1713515850116,EDS 290,A00,507366,Hofstetter; Carolyn,15,0,15,0
1713515851143,LIGM 5A,A00,507421,Fischer-Grunski; Eva K,20,0,20,0
1713515852177,LIGM 5B,A00,507423,Fischer-Grunski; Eva K,20,0,20,0
1713515853202,LIGM 5C,A00,507425,Fischer-Grunski; Eva K,20,0,20,0
1713515854233,LIIT 5AS,A00,507427,Carnelos; Chiara,20,0,20,0
1713515855259,LIIT 5BS,A00,507430,Carnelos; Chiara,20,0,20,0
1713515856292,LIIT 5CS,A00,507432,Carnelos; Chiara,20,0,20,0
1713515857325,LISP 5A,A00,507541,Munoz Sanchez; Alicia,14,0,20,6
1713515858351,LISP 5B,A00,507671,Munoz Sanchez; Alicia,12,0,20,8
1713515859380,LISP 5C,A00,507696,Munoz Sanchez; Alicia,11,0,20,9
1713515860411,MAE 197,001,528363,Boechler; Nicholas Sebastia,9998,0,9999,1
1713515861444,MATH 197,001,523477,Kedlaya; Kiran S.,9999,0,9999,0
1713515861444,MATH 197,002,563811,Zhang; Danna,9998,0,9999,1
1713515862472,MCWP 40R,A00,518780,Staff,13,0,20,7
1713515862472,MCWP 40R,B00,518781,Staff,11,0,20,9
1713515862472,MCWP 40R,C00,518783,Staff,8,0,20,12
1713515863505,MCWP 50R,A00,518791,Staff,7,0,20,13
1713515863505,MCWP 50R,B00,518792,Staff,3,0,20,17
1713515863505,MCWP 50R,C00,518793,Staff,5,0,20,15
1713515863505,MCWP 50R,D00,518794,Staff,0,0,20,20
1713515863505,MCWP 50R,E00,518795,Staff,0,0,20,20
1713515863505,MCWP 50R,F00,518796,Staff,10,0,20,10
1713515863505,MCWP 50R,G00,518797,Staff,10,0,20,10
1713515864531,MMW 12R,A01,514034,Herbst; Matthew,1,0,16,15
1713515864531,MMW 12R,A02,514035,Herbst; Matthew,13,0,16,3
1713515865562,MMW 13R,A01,514037,Staff,0,8,16,16
1713515865562,MMW 13R,A02,514039,Staff,0,7,16,16
1713515867614,SIO 295LS,A00,523233,Staff,15,0,30,15
1713515868645,SIO 295S,A00,523232,Staff,15,0,30,15
1713515869669,SOCI 117,A01,494376,Staff,0,2,5,5
1713515870751,WES 237B,A00,494380,Staff,19,0,20,1
1713515872818,AESE 279B,A00,494370,Wade; Jon P,33,0,33,0
1713515873843,AIP 197,001,627712,Vespa; Emanuel Ignacio,9999,0,9999,0
1713515874868,ANAR 135S,A00,494369,Braswell; Geoffrey E.,0,0,0,0
1713515875898,CAT 124RS,A01,519847,Geibel; William,6,0,20,14
1713515876978,CAT 125RS,A01,515971,Geibel; William,6,0,20,14
1713515878003,CLRE 250,A00,511389,Morris; Sheldon,9996,0,9999,3
1713515879044,CLRE 251,A00,507176,Mehta; Ravindra L.,9996,0,9999,3
1713515879044,CLRE 251,B00,511410,Mehta; Ravindra L.,9998,0,9999,1
1713515880068,CLRE 252,A00,507189,Cuomo; Raphael Eduardo,9998,0,9999,1
1713515881094,CLRE 253,A00,507199,Vaida; Florin,9997,0,9999,2
1713515881094,CLRE 253,B00,507202,Vaida; Florin,9999,0,9999,0
1713515882120,CLRE 259,A00,507211,Patel; Hemal,9996,0,9999,3
1713515883160,CLRE 260,A00,507221,Cuomo; Raphael Eduardo,9999,0,9999,0
1713515884186,CLRE 297,001,507242,Cuomo; Raphael Eduardo,9999,0,9999,0
1713515885216,CSE 191,A00,516875,Minnes Kemp; Mor Mia,9999,0,9999,0
1713515886244,CSS 201S,A01,494383,Staff,35,0,35,0
1713515887269,CSS 202S,A01,494387,Staff,35,0,35,0
1713515888298,EAP 100,A00,516065,Staff,9792,0,9999,207
1713515889327,ECE 45,A01,507414,Staff,37,0,60,23
1713515890353,ECE 100,A01,507416,Baghdadchi; Saharnaz,0,0,20,20
1713515890353,ECE 100,A02,507418,Baghdadchi; Saharnaz,19,0,20,1
1713515891383,ECE 111,A01,507420,Staff,27,0,50,23
1713515892410,ECE 197,001,548057,Sievenpiper; Daniel F.,9998,0,9999,1
1713515893436,EDS 115,A00,507243,Choi; Bailey Miyeon,27,0,28,1
1713515894463,EDS 117,A01,494379,Staff,14,0,25,11
1713515895489,EDS 125,A00,507246,Hopkins; Megan Beth,27,0,30,3
1713515896520,EDS 128A,A01,507264,Fargason; Sharon Gayle,26,0,26,0
1713515897545,EDS 128B,A01,507293,Pappas; Elizabeth,30,0,30,0
1713515898584,EDS 139,A00,507294,Fargason; Sharon Gayle,30,0,30,0
1713515898584,EDS 139,B00,507313,Pappas; Elizabeth,30,0,30,0
1713515899608,EDS 201,A00,507315,Staff,18,0,30,12
1713515900634,EDS 203,A01,507317,Halter; Christopher P.,17,0,30,13
1713515901667,EDS 204R,A01,507319,Halter; Christopher P.,0,1,30,30
1713515901667,EDS 204R,B01,507331,Heinzman; Erica M.,22,0,30,8
1713515902692,EDS 206R,A00,507332,Staff,0,2,30,30
1713515902692,EDS 206R,B00,507343,Staff,23,0,30,7
1713515903724,EDS 250,A00,507344,Hemans; Patricia Ann Benitez,27,0,40,13
1713515904750,EDS 281,A00,507345,Daly; Alan J.,18,0,18,0
1713515905783,EDS 284,A00,507350,Daly; Alan J.,16,0,16,0
1713515906818,EDS 286,A00,507359,Fine; Sarah,18,0,18,0
1713515907845,EDS 289C,A01,507361,Daly; Alan J.,18,0,18,0
1713515908872,EDS 290,A00,507366,Hofstetter; Carolyn,15,0,15,0
1713515909905,LIGM 5A,A00,507421,Fischer-Grunski; Eva K,20,0,20,0
1713515910939,LIGM 5B,A00,507423,Fischer-Grunski; Eva K,20,0,20,0
1713515911967,LIGM 5C,A00,507425,Fischer-Grunski; Eva K,20,0,20,0
1713515912994,LIIT 5AS,A00,507427,Carnelos; Chiara,20,0,20,0
1713515914023,LIIT 5BS,A00,507430,Carnelos; Chiara,20,0,20,0
1713515915053,LIIT 5CS,A00,507432,Carnelos; Chiara,20,0,20,0
1713515916084,LISP 5A,A00,507541,Munoz Sanchez; Alicia,14,0,20,6
1713515917111,LISP 5B,A00,507671,Munoz Sanchez; Alicia,12,0,20,8
1713515918144,LISP 5C,A00,507696,Munoz Sanchez; Alicia,11,0,20,9
1713515919174,MAE 197,001,528363,Boechler; Nicholas Sebastia,9998,0,9999,1
1713515920200,MATH 197,001,523477,Kedlaya; Kiran S.,9999,0,9999,0
1713515920200,MATH 197,002,563811,Zhang; Danna,9998,0,9999,1
1713515921229,MCWP 40R,A00,518780,Staff,13,0,20,7
1713515921229,MCWP 40R,B00,518781,Staff,11,0,20,9
1713515921229,MCWP 40R,C00,518783,Staff,8,0,20,12
1713515922255,MCWP 50R,A00,518791,Staff,7,0,20,13
1713515922255,MCWP 50R,B00,518792,Staff,3,0,20,17
1713515922255,MCWP 50R,C00,518793,Staff,5,0,20,15
1713515922255,MCWP 50R,D00,518794,Staff,0,0,20,20
1713515922255,MCWP 50R,E00,518795,Staff,0,0,20,20
1713515922255,MCWP 50R,F00,518796,Staff,10,0,20,10
1713515922255,MCWP 50R,G00,518797,Staff,10,0,20,10
1713515923293,MMW 12R,A01,514034,Herbst; Matthew,1,0,16,15
1713515923293,MMW 12R,A02,514035,Herbst; Matthew,13,0,16,3
1713515924319,MMW 13R,A01,514037,Staff,0,8,16,16
1713515924319,MMW 13R,A02,514039,Staff,0,7,16,16
1713515926371,SIO 295LS,A00,523233,Staff,15,0,30,15
1713515927402,SIO 295S,A00,523232,Staff,15,0,30,15
1713515928435,SOCI 117,A01,494376,Staff,0,2,5,5
1713515929461,WES 237B,A00,494380,Staff,19,0,20,1
1713515931536,AESE 279B,A00,494370,Wade; Jon P,33,0,33,0
1713515932567,AIP 197,001,627712,Vespa; Emanuel Ignacio,9999,0,9999,0
1713515933595,ANAR 135S,A00,494369,Braswell; Geoffrey E.,0,0,0,0
1713515934623,CAT 124RS,A01,519847,Geibel; William,6,0,20,14
1713515935648,CAT 125RS,A01,515971,Geibel; William,6,0,20,14
1713515936675,CLRE 250,A00,511389,Morris; Sheldon,9996,0,9999,3
1713515937703,CLRE 251,A00,507176,Mehta; Ravindra L.,9996,0,9999,3
1713515937703,CLRE 251,B00,511410,Mehta; Ravindra L.,9998,0,9999,1
1713515938733,CLRE 252,A00,507189,Cuomo; Raphael Eduardo,9998,0,9999,1
1713515939761,CLRE 253,A00,507199,Vaida; Florin,9997,0,9999,2
1713515939761,CLRE 253,B00,507202,Vaida; Florin,9999,0,9999,0
1713515940789,CLRE 259,A00,507211,Patel; Hemal,9996,0,9999,3
1713515941816,CLRE 260,A00,507221,Cuomo; Raphael Eduardo,9999,0,9999,0
1713515942842,CLRE 297,001,507242,Cuomo; Raphael Eduardo,9999,0,9999,0
1713515943874,CSE 191,A00,516875,Minnes Kemp; Mor Mia,9999,0,9999,0
1713515944906,CSS 201S,A01,494383,Staff,35,0,35,0
1713515945932,CSS 202S,A01,494387,Staff,35,0,35,0
1713515946959,EAP 100,A00,516065,Staff,9792,0,9999,207
1713515947986,ECE 45,A01,507414,Staff,37,0,60,23
1713515949016,ECE 100,A01,507416,Baghdadchi; Saharnaz,0,0,20,20
1713515949016,ECE 100,A02,507418,Baghdadchi; Saharnaz,19,0,20,1
1713515950042,ECE 111,A01,507420,Staff,27,0,50,23
1713515951072,ECE 197,001,548057,Sievenpiper; Daniel F.,9998,0,9999,1
1713515952103,EDS 115,A00,507243,Choi; Bailey Miyeon,27,0,28,1
1713515953132,EDS 117,A01,494379,Staff,14,0,25,11
1713515954158,EDS 125,A00,507246,Hopkins; Megan Beth,27,0,30,3
1713515955187,EDS 128A,A01,507264,Fargason; Sharon Gayle,26,0,26,0
1713515956219,EDS 128B,A01,507293,Pappas; Elizabeth,30,0,30,0
1713515957249,EDS 139,A00,507294,Fargason; Sharon Gayle,30,0,30,0
1713515957249,EDS 139,B00,507313,Pappas; Elizabeth,30,0,30,0
1713515958278,EDS 201,A00,507315,Staff,18,0,30,12
1713515959309,EDS 203,A01,507317,Halter; Christopher P.,17,0,30,13
1713515960335,EDS 204R,A01,507319,Halter; Christopher P.,0,1,30,30
1713515960335,EDS 204R,B01,507331,Heinzman; Erica M.,22,0,30,8
1713515961361,EDS 206R,A00,507332,Staff,0,2,30,30
1713515961361,EDS 206R,B00,507343,Staff,23,0,30,7
1713515962386,EDS 250,A00,507344,Hemans; Patricia Ann Benitez,27,0,40,13
1713515963413,EDS 281,A00,507345,Daly; Alan J.,18,0,18,0
1713515964443,EDS 284,A00,507350,Daly; Alan J.,16,0,16,0
1713515965473,EDS 286,A00,507359,Fine; Sarah,18,0,18,0
1713515966499,EDS 289C,A01,507361,Daly; Alan J.,18,0,18,0
1713515967530,EDS 290,A00,507366,Hofstetter; Carolyn,15,0,15,0
1713515968557,LIGM 5A,A00,507421,Fischer-Grunski; Eva K,20,0,20,0
1713515969585,LIGM 5B,A00,507423,Fischer-Grunski; Eva K,20,0,20,0
1713515970612,LIGM 5C,A00,507425,Fischer-Grunski; Eva K,20,0,20,0
1713515971639,LIIT 5AS,A00,507427,Carnelos; Chiara,20,0,20,0
1713515972666,LIIT 5BS,A00,507430,Carnelos; Chiara,20,0,20,0
1713515973691,LIIT 5CS,A00,507432,Carnelos; Chiara,20,0,20,0
1713515974716,LISP 5A,A00,507541,Munoz Sanchez; Alicia,14,0,20,6
1713515975743,LISP 5B,A00,507671,Munoz Sanchez; Alicia,12,0,20,8
1713515976770,LISP 5C,A00,507696,Munoz Sanchez; Alicia,11,0,20,9
1713515977802,MAE 197,001,528363,Boechler; Nicholas Sebastia,9998,0,9999,1
1713515978828,MATH 197,001,523477,Kedlaya; Kiran S.,9999,0,9999,0
1713515978828,MATH 197,002,563811,Zhang; Danna,9998,0,9999,1
1713515979856,MCWP 40R,A00,518780,Staff,13,0,20,7
1713515979856,MCWP 40R,B00,518781,Staff,11,0,20,9
1713515979856,MCWP 40R,C00,518783,Staff,8,0,20,12
1713515980940,MCWP 50R,A00,518791,Staff,7,0,20,13
1713515980940,MCWP 50R,B00,518792,Staff,3,0,20,17
1713515980940,MCWP 50R,C00,518793,Staff,5,0,20,15
1713515980940,MCWP 50R,D00,518794,Staff,0,0,20,20
1713515980940,MCWP 50R,E00,518795,Staff,0,0,20,20
1713515980940,MCWP 50R,F00,518796,Staff,10,0,20,10
1713515980940,MCWP 50R,G00,518797,Staff,10,0,20,10
1713515981964,MMW 12R,A01,514034,Herbst; Matthew,1,0,16,15
1713515981964,MMW 12R,A02,514035,Herbst; Matthew,13,0,16,3
1713515982999,MMW 13R,A01,514037,Staff,0,8,16,16
1713515982999,MMW 13R,A02,514039,Staff,0,7,16,16
1713515985060,SIO 295LS,A00,523233,Staff,15,0,30,15
1713515986092,SIO 295S,A00,523232,Staff,15,0,30,15
1713515987117,SOCI 117,A01,494376,Staff,0,2,5,5
1713515988142,WES 237B,A00,494380,Staff,19,0,20,1
1713515990207,AESE 279B,A00,494370,Wade; Jon P,33,0,33,0
1713515991236,AIP 197,001,627712,Vespa; Emanuel Ignacio,9999,0,9999,0
1713515992262,ANAR 135S,A00,494369,Braswell; Geoffrey E.,0,0,0,0
1713515993291,CAT 124RS,A01,519847,Geibel; William,6,0,20,14
1713515994316,CAT 125RS,A01,515971,Geibel; William,6,0,20,14
1713515995342,CLRE 250,A00,511389,Morris; Sheldon,9996,0,9999,3
1713515996368,CLRE 251,A00,507176,Mehta; Ravindra L.,9996,0,9999,3
1713515996368,CLRE 251,B00,511410,Mehta; Ravindra L.,9998,0,9999,1
1713515997394,CLRE 252,A00,507189,Cuomo; Raphael Eduardo,9998,0,9999,1
1713515998421,CLRE 253,A00,507199,Vaida; Florin,9997,0,9999,2
1713515998421,CLRE 253,B00,507202,Vaida; Florin,9999,0,9999,0
1713515999447,CLRE 259,A00,507211,Patel; Hemal,9996,0,9999,3
1713516000472,CLRE 260,A00,507221,Cuomo; Raphael Eduardo,9999,0,9999,0
1713516001502,CLRE 297,001,507242,Cuomo; Raphael Eduardo,9999,0,9999,0
1713516002529,CSE 191,A00,516875,Minnes Kemp; Mor Mia,9999,0,9999,0
1713516003561,CSS 201S,A01,494383,Staff,35,0,35,0
1713516004589,CSS 202S,A01,494387,Staff,35,0,35,0
1713516005614,EAP 100,A00,516065,Staff,9792,0,9999,207
1713516006645,ECE 45,A01,507414,Staff,37,0,60,23
1713516007671,ECE 100,A01,507416,Baghdadchi; Saharnaz,0,0,20,20
1713516007671,ECE 100,A02,507418,Baghdadchi; Saharnaz,19,0,20,1
1713516008698,ECE 111,A01,507420,Staff,27,0,50,23
1713516009725,ECE 197,001,548057,Sievenpiper; Daniel F.,9998,0,9999,1
1713516010755,EDS 115,A00,507243,Choi; Bailey Miyeon,27,0,28,1
1713516011784,EDS 117,A01,494379,Staff,14,0,25,11
1713516012816,EDS 125,A00,507246,Hopkins; Megan Beth,27,0,30,3
1713516013843,EDS 128A,A01,507264,Fargason; Sharon Gayle,26,0,26,0
1713516014868,EDS 128B,A01,507293,Pappas; Elizabeth,30,0,30,0
1713516015897,EDS 139,A00,507294,Fargason; Sharon Gayle,30,0,30,0
1713516015897,EDS 139,B00,507313,Pappas; Elizabeth,30,0,30,0
1713516016923,EDS 201,A00,507315,Staff,18,0,30,12
1713516017953,EDS 203,A01,507317,Halter; Christopher P.,17,0,30,13
1713516018980,EDS 204R,A01,507319,Halter; Christopher P.,0,1,30,30
1713516018980,EDS 204R,B01,507331,Heinzman; Erica M.,22,0,30,8
1713516020008,EDS 206R,A00,507332,Staff,0,2,30,30
1713516020008,EDS 206R,B00,507343,Staff,23,0,30,7
1713516021034,EDS 250,A00,507344,Hemans; Patricia Ann Benitez,27,0,40,13
1713516022059,EDS 281,A00,507345,Daly; Alan J.,18,0,18,0
1713516023086,EDS 284,A00,507350,Daly; Alan J.,16,0,16,0
1713516024113,EDS 286,A00,507359,Fine; Sarah,18,0,18,0
1713516025144,EDS 289C,A01,507361,Daly; Alan J.,18,0,18,0
1713516026177,EDS 290,A00,507366,Hofstetter; Carolyn,15,0,15,0
1713516027205,LIGM 5A,A00,507421,Fischer-Grunski; Eva K,20,0,20,0
1713516028229,LIGM 5B,A00,507423,Fischer-Grunski; Eva K,20,0,20,0
1713516029262,LIGM 5C,A00,507425,Fischer-Grunski; Eva K,20,0,20,0
1713516030291,LIIT 5AS,A00,507427,Carnelos; Chiara,20,0,20,0
1713516031323,LIIT 5BS,A00,507430,Carnelos; Chiara,20,0,20,0
1713516032349,LIIT 5CS,A00,507432,Carnelos; Chiara,20,0,20,0
1713516033376,LISP 5A,A00,507541,Munoz Sanchez; Alicia,14,0,20,6
1713516034402,LISP 5B,A00,507671,Munoz Sanchez; Alicia,12,0,20,8
1713516035432,LISP 5C,A00,507696,Munoz Sanchez; Alicia,11,0,20,9
1713516036457,MAE 197,001,528363,Boechler; Nicholas Sebastia,9998,0,9999,1
1713516037486,MATH 197,001,523477,Kedlaya; Kiran S.,9999,0,9999,0
1713516037486,MATH 197,002,563811,Zhang; Danna,9998,0,9999,1
1713516038515,MCWP 40R,A00,518780,Staff,13,0,20,7
1713516038515,MCWP 40R,B00,518781,Staff,11,0,20,9
1713516038515,MCWP 40R,C00,518783,Staff,8,0,20,12
1713516039543,MCWP 50R,A00,518791,Staff,7,0,20,13
1713516039543,MCWP 50R,B00,518792,Staff,3,0,20,17
1713516039543,MCWP 50R,C00,518793,Staff,5,0,20,15
1713516039543,MCWP 50R,D00,518794,Staff,0,0,20,20
1713516039543,MCWP 50R,E00,518795,Staff,0,0,20,20
1713516039543,MCWP 50R,F00,518796,Staff,10,0,20,10
1713516039543,MCWP 50R,G00,518797,Staff,10,0,20,10
1713516040567,MMW 12R,A01,514034,Herbst; Matthew,1,0,16,15
1713516040567,MMW 12R,A02,514035,Herbst; Matthew,13,0,16,3
1713516041593,MMW 13R,A01,514037,Staff,0,8,16,16
1713516041593,MMW 13R,A02,514039,Staff,0,7,16,16
1713516043651,SIO 295LS,A00,523233,Staff,15,0,30,15
1713516044680,SIO 295S,A00,523232,Staff,15,0,30,15
1713516045706,SOCI 117,A01,494376,Staff,0,2,5,5
1713516046732,WES 237B,A00,494380,Staff,19,0,20,1
1713516048815,AESE 279B,A00,494370,Wade; Jon P,33,0,33,0
1713516049845,AIP 197,001,627712,Vespa; Emanuel Ignacio,9999,0,9999,0
1713516050871,ANAR 135S,A00,494369,Braswell; Geoffrey E.,0,0,0,0
1713516051902,CAT 124RS,A01,519847,Geibel; William,6,0,20,14
1713516052927,CAT 125RS,A01,515971,Geibel; William,6,0,20,14
1713516053958,CLRE 250,A00,511389,Morris; Sheldon,9996,0,9999,3
1713516054986,CLRE 251,A00,507176,Mehta; Ravindra L.,9996,0,9999,3
1713516054986,CLRE 251,B00,511410,Mehta; Ravindra L.,9998,0,9999,1
1713516056012,CLRE 252,A00,507189,Cuomo; Raphael Eduardo,9998,0,9999,1
1713516057039,CLRE 253,A00,507199,Vaida; Florin,9997,0,9999,2
1713516057039,CLRE 253,B00,507202,Vaida; Florin,9999,0,9999,0
1713516058063,CLRE 259,A00,507211,Patel; Hemal,9996,0,9999,3
1713516059093,CLRE 260,A00,507221,Cuomo; Raphael Eduardo,9999,0,9999,0
1713516060144,CLRE 297,001,507242,Cuomo; Raphael Eduardo,9999,0,9999,0
1713516061176,CSE 191,A00,516875,Minnes Kemp; Mor Mia,9999,0,9999,0
1713516062208,CSS 201S,A01,494383,Staff,35,0,35,0
1713516063235,CSS 202S,A01,494387,Staff,35,0,35,0
1713516064262,EAP 100,A00,516065,Staff,9792,0,9999,207
1713516065292,ECE 45,A01,507414,Staff,37,0,60,23
1713516066333,ECE 100,A01,507416,Baghdadchi; Saharnaz,0,0,20,20
1713516066333,ECE 100,A02,507418,Baghdadchi; Saharnaz,19,0,20,1
1713516067372,ECE 111,A01,507420,Staff,27,0,50,23
1713516068407,ECE 197,001,548057,Sievenpiper; Daniel F.,9998,0,9999,1
1713516069433,EDS 115,A00,507243,Choi; Bailey Miyeon,27,0,28,1
1713516070464,EDS 117,A01,494379,Staff,14,0,25,11
1713516071489,EDS 125,A00,507246,Hopkins; Megan Beth,27,0,30,3
1713516072515,EDS 128A,A01,507264,Fargason; Sharon Gayle,26,0,26,0
1713516073545,EDS 128B,A01,507293,Pappas; Elizabeth,30,0,30,0
1713516074578,EDS 139,A00,507294,Fargason; Sharon Gayle,30,0,30,0
1713516074578,EDS 139,B00,507313,Pappas; Elizabeth,30,0,30,0
1713516075604,EDS 201,A00,507315,Staff,18,0,30,12
1713516076635,EDS 203,A01,507317,Halter; Christopher P.,17,0,30,13
1713516077668,EDS 204R,A01,507319,Halter; Christopher P.,0,1,30,30
1713516077668,EDS 204R,B01,507331,Heinzman; Erica M.,22,0,30,8
1713516078709,EDS 206R,A00,507332,Staff,0,2,30,30
1713516078709,EDS 206R,B00,507343,Staff,23,0,30,7
1713516079739,EDS 250,A00,507344,Hemans; Patricia Ann Benitez,27,0,40,13
1713516080765,EDS 281,A00,507345,Daly; Alan J.,18,0,18,0
1713516081794,EDS 284,A00,507350,Daly; Alan J.,16,0,16,0
1713516082825,EDS 286,A00,507359,Fine; Sarah,18,0,18,0
1713516083850,EDS 289C,A01,507361,Daly; Alan J.,18,0,18,0
1713516084932,EDS 290,A00,507366,Hofstetter; Carolyn,15,0,15,0
1713516085959,LIGM 5A,A00,507421,Fischer-Grunski; Eva K,20,0,20,0
1713516086993,LIGM 5B,A00,507423,Fischer-Grunski; Eva K,20,0,20,0
1713516088020,LIGM 5C,A00,507425,Fischer-Grunski; Eva K,20,0,20,0
1713516089051,LIIT 5AS,A00,507427,Carnelos; Chiara,20,0,20,0
1713516090077,LIIT 5BS,A00,507430,Carnelos; Chiara,20,0,20,0
1713516091103,LIIT 5CS,A00,507432,Carnelos; Chiara,20,0,20,0
1713516092128,LISP 5A,A00,507541,Munoz Sanchez; Alicia,14,0,20,6
1713516093161,LISP 5B,A00,507671,Munoz Sanchez; Alicia,12,0,20,8
1713516094192,LISP 5C,A00,507696,Munoz Sanchez; Alicia,11,0,20,9
1713516095217,MAE 197,001,528363,Boechler; Nicholas Sebastia,9998,0,9999,1
1713516096249,MATH 197,001,523477,Kedlaya; Kiran S.,9999,0,9999,0
1713516096249,MATH 197,002,563811,Zhang; Danna,9998,0,9999,1
1713516097277,MCWP 40R,A00,518780,Staff,13,0,20,7
1713516097277,MCWP 40R,B00,518781,Staff,11,0,20,9
1713516097277,MCWP 40R,C00,518783,Staff,8,0,20,12
1713516098304,MCWP 50R,A00,518791,Staff,7,0,20,13
1713516098304,MCWP 50R,B00,518792,Staff,3,0,20,17
1713516098304,MCWP 50R,C00,518793,Staff,5,0,20,15
1713516098304,MCWP 50R,D00,518794,Staff,0,0,20,20
1713516098304,MCWP 50R,E00,518795,Staff,0,0,20,20
1713516098304,MCWP 50R,F00,518796,Staff,10,0,20,10
1713516098304,MCWP 50R,G00,518797,Staff,10,0,20,10
1713516099330,MMW 12R,A01,514034,Herbst; Matthew,1,0,16,15
1713516099330,MMW 12R,A02,514035,Herbst; Matthew,13,0,16,3
1713516100358,MMW 13R,A01,514037,Staff,0,8,16,16
1713516100358,MMW 13R,A02,514039,Staff,0,7,16,16
1713516102408,SIO 295LS,A00,523233,Staff,15,0,30,15
1713516103433,SIO 295S,A00,523232,Staff,15,0,30,15
1713516104459,SOCI 117,A01,494376,Staff,0,2,5,5
1713516105484,WES 237B,A00,494380,Staff,19,0,20,1
1713516107551,AESE 279B,A00,494370,Wade; Jon P,33,0,33,0
1713516108576,AIP 197,001,627712,Vespa; Emanuel Ignacio,9999,0,9999,0
1713516109607,ANAR 135S,A00,494369,Braswell; Geoffrey E.,0,0,0,0
1713516110636,CAT 124RS,A01,519847,Geibel; William,6,0,20,14
1713516111662,CAT 125RS,A01,515971,Geibel; William,6,0,20,14
1713516112687,CLRE 250,A00,511389,Morris; Sheldon,9996,0,9999,3
1713516113721,CLRE 251,A00,507176,Mehta; Ravindra L.,9996,0,9999,3
1713516113721,CLRE 251,B00,511410,Mehta; Ravindra L.,9998,0,9999,1
1713516114750,CLRE 252,A00,507189,Cuomo; Raphael Eduardo,9998,0,9999,1
1713516115780,CLRE 253,A00,507199,Vaida; Florin,9997,0,9999,2
1713516115780,CLRE 253,B00,507202,Vaida; Florin,9999,0,9999,0
1713516116806,CLRE 259,A00,507211,Patel; Hemal,9996,0,9999,3
1713516117831,CLRE 260,A00,507221,Cuomo; Raphael Eduardo,9999,0,9999,0
1713516118860,CLRE 297,001,507242,Cuomo; Raphael Eduardo,9999,0,9999,0
1713516119892,CSE 191,A00,516875,Minnes Kemp; Mor Mia,9999,0,9999,0
1713516120919,CSS 201S,A01,494383,Staff,35,0,35,0
1713516121946,CSS 202S,A01,494387,Staff,35,0,35,0
1713516122972,EAP 100,A00,516065,Staff,9792,0,9999,207
1713516124000,ECE 45,A01,507414,Staff,37,0,60,23
1713516125026,ECE 100,A01,507416,Baghdadchi; Saharnaz,0,0,20,20
1713516125026,ECE 100,A02,507418,Baghdadchi; Saharnaz,19,0,20,1
1713516126055,ECE 111,A01,507420,Staff,27,0,50,23
1713516127085,ECE 197,001,548057,Sievenpiper; Daniel F.,9998,0,9999,1
1713516128114,EDS 115,A00,507243,Choi; Bailey Miyeon,27,0,28,1
1713516129140,EDS 117,A01,494379,Staff,14,0,25,11
1713516130170,EDS 125,A00,507246,Hopkins; Megan Beth,27,0,30,3
1713516131202,EDS 128A,A01,507264,Fargason; Sharon Gayle,26,0,26,0
1713516132228,EDS 128B,A01,507293,Pappas; Elizabeth,30,0,30,0
1713516133259,EDS 139,A00,507294,Fargason; Sharon Gayle,30,0,30,0
1713516133259,EDS 139,B00,507313,Pappas; Elizabeth,30,0,30,0
1713516134290,EDS 201,A00,507315,Staff,18,0,30,12
1713516135315,EDS 203,A01,507317,Halter; Christopher P.,17,0,30,13
1713516136339,EDS 204R,A01,507319,Halter; Christopher P.,0,1,30,30
1713516136339,EDS 204R,B01,507331,Heinzman; Erica M.,22,0,30,8
1713516137365,EDS 206R,A00,507332,Staff,0,2,30,30
1713516137365,EDS 206R,B00,507343,Staff,23,0,30,7
1713516138391,EDS 250,A00,507344,Hemans; Patricia Ann Benitez,27,0,40,13
1713516139417,EDS 281,A00,507345,Daly; Alan J.,18,0,18,0
1713516140446,EDS 284,A00,507350,Daly; Alan J.,16,0,16,0
1713516141471,EDS 286,A00,507359,Fine; Sarah,18,0,18,0
1713516142497,EDS 289C,A01,507361,Daly; Alan J.,18,0,18,0
1713516143528,EDS 290,A00,507366,Hofstetter; Carolyn,15,0,15,0
1713516144560,LIGM 5A,A00,507421,Fischer-Grunski; Eva K,20,0,20,0
1713516145592,LIGM 5B,A00,507423,Fischer-Grunski; Eva K,20,0,20,0
1713516146619,LIGM 5C,A00,507425,Fischer-Grunski; Eva K,20,0,20,0
1713516147645,LIIT 5AS,A00,507427,Carnelos; Chiara,20,0,20,0
1713516148670,LIIT 5BS,A00,507430,Carnelos; Chiara,20,0,20,0
1713516149696,LIIT 5CS,A00,507432,Carnelos; Chiara,20,0,20,0
1713516150726,LISP 5A,A00,507541,Munoz Sanchez; Alicia,14,0,20,6
1713516151755,LISP 5B,A00,507671,Munoz Sanchez; Alicia,12,0,20,8
1713516152782,LISP 5C,A00,507696,Munoz Sanchez; Alicia,11,0,20,9
1713516153809,MAE 197,001,528363,Boechler; Nicholas Sebastia,9998,0,9999,1
1713516154835,MATH 197,001,523477,Kedlaya; Kiran S.,9999,0,9999,0
1713516154835,MATH 197,002,563811,Zhang; Danna,9998,0,9999,1
1713516155861,MCWP 40R,A00,518780,Staff,13,0,20,7
1713516155861,MCWP 40R,B00,518781,Staff,11,0,20,9
1713516155861,MCWP 40R,C00,518783,Staff,8,0,20,12
1713516156892,MCWP 50R,A00,518791,Staff,7,0,20,13
1713516156892,MCWP 50R,B00,518792,Staff,3,0,20,17
1713516156892,MCWP 50R,C00,518793,Staff,5,0,20,15
1713516156892,MCWP 50R,D00,518794,Staff,0,0,20,20
1713516156892,MCWP 50R,E00,518795,Staff,0,0,20,20
1713516156892,MCWP 50R,F00,518796,Staff,10,0,20,10
1713516156892,MCWP 50R,G00,518797,Staff,10,0,20,10
1713516157918,MMW 12R,A01,514034,Herbst; Matthew,1,0,16,15
1713516157918,MMW 12R,A02,514035,Herbst; Matthew,13,0,16,3
1713516158949,MMW 13R,A01,514037,Staff,0,8,16,16
1713516158949,MMW 13R,A02,514039,Staff,0,7,16,16
1713516161005,SIO 295LS,A00,523233,Staff,15,0,30,15
1713516162030,SIO 295S,A00,523232,Staff,15,0,30,15
1713516163059,SOCI 117,A01,494376,Staff,0,2,5,5
1713516164085,WES 237B,A00,494380,Staff,19,0,20,1
1713516166147,AESE 279B,A00,494370,Wade; Jon P,33,0,33,0
1713516167172,AIP 197,001,627712,Vespa; Emanuel Ignacio,9999,0,9999,0
1713516168200,ANAR 135S,A00,494369,Braswell; Geoffrey E.,0,0,0,0
1713516169231,CAT 124RS,A01,519847,Geibel; William,6,0,20,14
1713516170261,CAT 125RS,A01,515971,Geibel; William,6,0,20,14
1713516171292,CLRE 250,A00,511389,Morris; Sheldon,9996,0,9999,3
1713516172320,CLRE 251,A00,507176,Mehta; Ravindra L.,9996,0,9999,3
1713516172320,CLRE 251,B00,511410,Mehta; Ravindra L.,9998,0,9999,1
1713516173346,CLRE 252,A00,507189,Cuomo; Raphael Eduardo,9998,0,9999,1
1713516174371,CLRE 253,A00,507199,Vaida; Florin,9997,0,9999,2
1713516174371,CLRE 253,B00,507202,Vaida; Florin,9999,0,9999,0
1713516175396,CLRE 259,A00,507211,Patel; Hemal,9996,0,9999,3
1713516176422,CLRE 260,A00,507221,Cuomo; Raphael Eduardo,9999,0,9999,0
1713516177452,CLRE 297,001,507242,Cuomo; Raphael Eduardo,9999,0,9999,0
1713516178477,CSE 191,A00,516875,Minnes Kemp; Mor Mia,9999,0,9999,0
1713516179504,CSS 201S,A01,494383,Staff,35,0,35,0
1713516180541,CSS 202S,A01,494387,Staff,35,0,35,0
1713516181567,EAP 100,A00,516065,Staff,9792,0,9999,207
1713516182597,ECE 45,A01,507414,Staff,37,0,60,23
1713516183623,ECE 100,A01,507416,Baghdadchi; Saharnaz,0,0,20,20
1713516183623,ECE 100,A02,507418,Baghdadchi; Saharnaz,19,0,20,1
1713516184649,ECE 111,A01,507420,Staff,27,0,50,23
1713516185678,ECE 197,001,548057,Sievenpiper; Daniel F.,9998,0,9999,1
1713516186704,EDS 115,A00,507243,Choi; Bailey Miyeon,27,0,28,1
1713516187730,EDS 117,A01,494379,Staff,14,0,25,11
1713516188814,EDS 125,A00,507246,Hopkins; Megan Beth,27,0,30,3
1713516189841,EDS 128A,A01,507264,Fargason; Sharon Gayle,26,0,26,0
1713516190868,EDS 128B,A01,507293,Pappas; Elizabeth,30,0,30,0
1713516191893,EDS 139,A00,507294,Fargason; Sharon Gayle,30,0,30,0
1713516191893,EDS 139,B00,507313,Pappas; Elizabeth,30,0,30,0
1713516192920,EDS 201,A00,507315,Staff,18,0,30,12
1713516193944,EDS 203,A01,507317,Halter; Christopher P.,17,0,30,13
1713516194970,EDS 204R,A01,507319,Halter; Christopher P.,0,1,30,30
1713516194970,EDS 204R,B01,507331,Heinzman; Erica M.,22,0,30,8
1713516195999,EDS 206R,A00,507332,Staff,0,2,30,30
1713516195999,EDS 206R,B00,507343,Staff,23,0,30,7
1713516197030,EDS 250,A00,507344,Hemans; Patricia Ann Benitez,27,0,40,13
1713516198059,EDS 281,A00,507345,Daly; Alan J.,18,0,18,0
1713516199088,EDS 284,A00,507350,Daly; Alan J.,16,0,16,0
1713516200117,EDS 286,A00,507359,Fine; Sarah,18,0,18,0
1713516201142,EDS 289C,A01,507361,Daly; Alan J.,18,0,18,0
1713516202172,EDS 290,A00,507366,Hofstetter; Carolyn,15,0,15,0
1713516203243,LIGM 5A,A00,507421,Fischer-Grunski; Eva K,20,0,20,0
1713516204274,LIGM 5B,A00,507423,Fischer-Grunski; Eva K,20,0,20,0
1713516205300,LIGM 5C,A00,507425,Fischer-Grunski; Eva K,20,0,20,0
1713516206327,LIIT 5AS,A00,507427,Carnelos; Chiara,20,0,20,0
1713516207353,LIIT 5BS,A00,507430,Carnelos; Chiara,20,0,20,0
1713516208378,LIIT 5CS,A00,507432,Carnelos; Chiara,20,0,20,0
1713516209404,LISP 5A,A00,507541,Munoz Sanchez; Alicia,14,0,20,6
1713516210430,LISP 5B,A00,507671,Munoz Sanchez; Alicia,12,0,20,8
1713516211456,LISP 5C,A00,507696,Munoz Sanchez; Alicia,11,0,20,9
1713516212487,MAE 197,001,528363,Boechler; Nicholas Sebastia,9998,0,9999,1
1713516213518,MATH 197,001,523477,Kedlaya; Kiran S.,9999,0,9999,0
1713516213518,MATH 197,002,563811,Zhang; Danna,9998,0,9999,1
1713516214550,MCWP 40R,A00,518780,Staff,13,0,20,7
1713516214550,MCWP 40R,B00,518781,Staff,11,0,20,9
1713516214550,MCWP 40R,C00,518783,Staff,8,0,20,12
1713516215577,MCWP 50R,A00,518791,Staff,7,0,20,13
1713516215577,MCWP 50R,B00,518792,Staff,3,0,20,17
1713516215577,MCWP 50R,C00,518793,Staff,5,0,20,15
1713516215577,MCWP 50R,D00,518794,Staff,0,0,20,20
1713516215577,MCWP 50R,E00,518795,Staff,0,0,20,20
1713516215577,MCWP 50R,F00,518796,Staff,10,0,20,10
1713516215577,MCWP 50R,G00,518797,Staff,10,0,20,10
1713516216603,MMW 12R,A01,514034,Herbst; Matthew,1,0,16,15
1713516216603,MMW 12R,A02,514035,Herbst; Matthew,13,0,16,3
1713516217632,MMW 13R,A01,514037,Staff,0,8,16,16
1713516217632,MMW 13R,A02,514039,Staff,0,7,16,16
1713516219687,SIO 295LS,A00,523233,Staff,15,0,30,15
1713516220716,SIO 295S,A00,523232,Staff,15,0,30,15
1713516221749,SOCI 117,A01,494376,Staff,0,2,5,5
1713516222775,WES 237B,A00,494380,Staff,19,0,20,1
1713516224852,AESE 279B,A00,494370,Wade; Jon P,33,0,33,0
1713516225878,AIP 197,001,627712,Vespa; Emanuel Ignacio,9999,0,9999,0
1713516226905,ANAR 135S,A00,494369,Braswell; Geoffrey E.,0,0,0,0
1713516227931,CAT 124RS,A01,519847,Geibel; William,6,0,20,14
1713516228957,CAT 125RS,A01,515971,Geibel; William,6,0,20,14
1713516229982,CLRE 250,A00,511389,Morris; Sheldon,9996,0,9999,3
1713516231008,CLRE 251,A00,507176,Mehta; Ravindra L.,9996,0,9999,3
1713516231008,CLRE 251,B00,511410,Mehta; Ravindra L.,9998,0,9999,1
1713516232035,CLRE 252,A00,507189,Cuomo; Raphael Eduardo,9998,0,9999,1
1713516233065,CLRE 253,A00,507199,Vaida; Florin,9997,0,9999,2
1713516233065,CLRE 253,B00,507202,Vaida; Florin,9999,0,9999,0
1713516234091,CLRE 259,A00,507211,Patel; Hemal,9996,0,9999,3
1713516235120,CLRE 260,A00,507221,Cuomo; Raphael Eduardo,9999,0,9999,0
1713516236145,CLRE 297,001,507242,Cuomo; Raphael Eduardo,9999,0,9999,0
1713516237174,CSE 191,A00,516875,Minnes Kemp; Mor Mia,9999,0,9999,0
1713516238207,CSS 201S,A01,494383,Staff,35,0,35,0
1713516239233,CSS 202S,A01,494387,Staff,35,0,35,0
1713516240262,EAP 100,A00,516065,Staff,9792,0,9999,207
1713516241289,ECE 45,A01,507414,Staff,37,0,60,23
1713516242316,ECE 100,A01,507416,Baghdadchi; Saharnaz,0,0,20,20
1713516242316,ECE 100,A02,507418,Baghdadchi; Saharnaz,19,0,20,1
1713516243342,ECE 111,A01,507420,Staff,27,0,50,23
1713516244372,ECE 197,001,548057,Sievenpiper; Daniel F.,9998,0,9999,1
1713516245411,EDS 115,A00,507243,Choi; Bailey Miyeon,27,0,28,1
1713516246443,EDS 117,A01,494379,Staff,14,0,25,11
1713516247473,EDS 125,A00,507246,Hopkins; Megan Beth,27,0,30,3
1713516248500,EDS 128A,A01,507264,Fargason; Sharon Gayle,26,0,26,0
1713516249527,EDS 128B,A01,507293,Pappas; Elizabeth,30,0,30,0
1713516250554,EDS 139,A00,507294,Fargason; Sharon Gayle,30,0,30,0
1713516250554,EDS 139,B00,507313,Pappas; Elizabeth,30,0,30,0
1713516251584,EDS 201,A00,507315,Staff,18,0,30,12
1713516252610,EDS 203,A01,507317,Halter; Christopher P.,17,0,30,13
1713516253637,EDS 204R,A01,507319,Halter; Christopher P.,0,1,30,30
1713516253637,EDS 204R,B01,507331,Heinzman; Erica M.,22,0,30,8
1713516254662,EDS 206R,A00,507332,Staff,0,2,30,30
1713516254662,EDS 206R,B00,507343,Staff,23,0,30,7
1713516255692,EDS 250,A00,507344,Hemans; Patricia Ann Benitez,27,0,40,13
1713516256715,EDS 281,A00,507345,Daly; Alan J.,18,0,18,0
1713516257740,EDS 284,A00,507350,Daly; Alan J.,16,0,16,0
1713516258766,EDS 286,A00,507359,Fine; Sarah,18,0,18,0
1713516259793,EDS 289C,A01,507361,Daly; Alan J.,18,0,18,0
1713516260820,EDS 290,A00,507366,Hofstetter; Carolyn,15,0,15,0
1713516261850,LIGM 5A,A00,507421,Fischer-Grunski; Eva K,20,0,20,0
1713516262879,LIGM 5B,A00,507423,Fischer-Grunski; Eva K,20,0,20,0
1713516263906,LIGM 5C,A00,507425,Fischer-Grunski; Eva K,20,0,20,0
1713516264936,LIIT 5AS,A00,507427,Carnelos; Chiara,20,0,20,0
1713516265963,LIIT 5BS,A00,507430,Carnelos; Chiara,20,0,20,0
1713516266988,LIIT 5CS,A00,507432,Carnelos; Chiara,20,0,20,0
1713516268020,LISP 5A,A00,507541,Munoz Sanchez; Alicia,14,0,20,6
1713516269048,LISP 5B,A00,507671,Munoz Sanchez; Alicia,12,0,20,8
1713516270080,LISP 5C,A00,507696,Munoz Sanchez; Alicia,11,0,20,9
1713516271104,MAE 197,001,528363,Boechler; Nicholas Sebastia,9998,0,9999,1
1713516272132,MATH 197,001,523477,Kedlaya; Kiran S.,9999,0,9999,0
1713516272132,MATH 197,002,563811,Zhang; Danna,9998,0,9999,1
1713516273160,MCWP 40R,A00,518780,Staff,13,0,20,7
1713516273160,MCWP 40R,B00,518781,Staff,11,0,20,9
1713516273160,MCWP 40R,C00,518783,Staff,8,0,20,12
1713516274187,MCWP 50R,A00,518791,Staff,7,0,20,13
1713516274187,MCWP 50R,B00,518792,Staff,3,0,20,17
1713516274187,MCWP 50R,C00,518793,Staff,5,0,20,15
1713516274187,MCWP 50R,D00,518794,Staff,0,0,20,20
1713516274187,MCWP 50R,E00,518795,Staff,0,0,20,20
1713516274187,MCWP 50R,F00,518796,Staff,10,0,20,10
1713516274187,MCWP 50R,G00,518797,Staff,10,0,20,10
1713516275213,MMW 12R,A01,514034,Herbst; Matthew,1,0,16,15
1713516275213,MMW 12R,A02,514035,Herbst; Matthew,13,0,16,3
1713516276238,MMW 13R,A01,514037,Staff,0,8,16,16
1713516276238,MMW 13R,A02,514039,Staff,0,7,16,16
1713516278292,SIO 295LS,A00,523233,Staff,15,0,30,15
1713516279320,SIO 295S,A00,523232,Staff,15,0,30,15
1713516280348,SOCI 117,A01,494376,Staff,0,2,5,5
1713516281376,WES 237B,A00,494380,Staff,19,0,20,1
1713516283457,AESE 279B,A00,494370,Wade; Jon P,33,0,33,0
1713516284486,AIP 197,001,627712,Vespa; Emanuel Ignacio,9999,0,9999,0
1713516285515,ANAR 135S,A00,494369,Braswell; Geoffrey E.,0,0,0,0
1713516286541,CAT 124RS,A01,519847,Geibel; William,6,0,20,14
1713516287567,CAT 125RS,A01,515971,Geibel; William,6,0,20,14
1713516288593,CLRE 250,A00,511389,Morris; Sheldon,9996,0,9999,3
1713516289622,CLRE 251,A00,507176,Mehta; Ravindra L.,9996,0,9999,3
1713516289622,CLRE 251,B00,511410,Mehta; Ravindra L.,9998,0,9999,1
1713516290651,CLRE 252,A00,507189,Cuomo; Raphael Eduardo,9998,0,9999,1
1713516291682,CLRE 253,A00,507199,Vaida; Florin,9997,0,9999,2
1713516291682,CLRE 253,B00,507202,Vaida; Florin,9999,0,9999,0
1713516292769,CLRE 259,A00,507211,Patel; Hemal,9996,0,9999,3
1713516293796,CLRE 260,A00,507221,Cuomo; Raphael Eduardo,9999,0,9999,0
1713516294821,CLRE 297,001,507242,Cuomo; Raphael Eduardo,9999,0,9999,0
1713516295848,CSE 191,A00,516875,Minnes Kemp; Mor Mia,9999,0,9999,0
1713516296877,CSS 201S,A01,494383,Staff,35,0,35,0
1713516297903,CSS 202S,A01,494387,Staff,35,0,35,0
1713516298930,EAP 100,A00,516065,Staff,9792,0,9999,207
1713516299961,ECE 45,A01,507414,Staff,37,0,60,23
1713516300988,ECE 100,A01,507416,Baghdadchi; Saharnaz,0,0,20,20
1713516300988,ECE 100,A02,507418,Baghdadchi; Saharnaz,19,0,20,1
1713516302013,ECE 111,A01,507420,Staff,27,0,50,23
1713516303038,ECE 197,001,548057,Sievenpiper; Daniel F.,9998,0,9999,1
1713516304068,EDS 115,A00,507243,Choi; Bailey Miyeon,27,0,28,1
1713516305094,EDS 117,A01,494379,Staff,14,0,25,11
1713516306124,EDS 125,A00,507246,Hopkins; Megan Beth,27,0,30,3
1713516307154,EDS 128A,A01,507264,Fargason; Sharon Gayle,26,0,26,0
1713516308179,EDS 128B,A01,507293,Pappas; Elizabeth,30,0,30,0
1713516309212,EDS 139,A00,507294,Fargason; Sharon Gayle,30,0,30,0
1713516309212,EDS 139,B00,507313,Pappas; Elizabeth,30,0,30,0
1713516310237,EDS 201,A00,507315,Staff,18,0,30,12
1713516311264,EDS 203,A01,507317,Halter; Christopher P.,17,0,30,13
1713516312291,EDS 204R,A01,507319,Halter; Christopher P.,0,1,30,30
1713516312291,EDS 204R,B01,507331,Heinzman; Erica M.,22,0,30,8
1713516313318,EDS 206R,A00,507332,Staff,0,2,30,30
1713516313318,EDS 206R,B00,507343,Staff,23,0,30,7
1713516314349,EDS 250,A00,507344,Hemans; Patricia Ann Benitez,27,0,40,13
1713516315379,EDS 281,A00,507345,Daly; Alan J.,18,0,18,0
1713516316409,EDS 284,A00,507350,Daly; Alan J.,16,0,16,0
1713516317434,EDS 286,A00,507359,Fine; Sarah,18,0,18,0
1713516318460,EDS 289C,A01,507361,Daly; Alan J.,18,0,18,0
1713516319489,EDS 290,A00,507366,Hofstetter; Carolyn,15,0,15,0
1713516320520,LIGM 5A,A00,507421,Fischer-Grunski; Eva K,20,0,20,0
1713516321550,LIGM 5B,A00,507423,Fischer-Grunski; Eva K,20,0,20,0
1713516322580,LIGM 5C,A00,507425,Fischer-Grunski; Eva K,20,0,20,0
1713516323611,LIIT 5AS,A00,507427,Carnelos; Chiara,20,0,20,0
1713516324642,LIIT 5BS,A00,507430,Carnelos; Chiara,20,0,20,0
1713516325671,LIIT 5CS,A00,507432,Carnelos; Chiara,20,0,20,0
1713516326702,LISP 5A,A00,507541,Munoz Sanchez; Alicia,14,0,20,6
1713516327732,LISP 5B,A00,507671,Munoz Sanchez; Alicia,12,0,20,8
1713516328759,LISP 5C,A00,507696,Munoz Sanchez; Alicia,11,0,20,9
1713516329785,MAE 197,001,528363,Boechler; Nicholas Sebastia,9998,0,9999,1
1713516330811,MATH 197,001,523477,Kedlaya; Kiran S.,9999,0,9999,0
1713516330811,MATH 197,002,563811,Zhang; Danna,9998,0,9999,1
1713516331836,MCWP 40R,A00,518780,Staff,13,0,20,7
1713516331836,MCWP 40R,B00,518781,Staff,11,0,20,9
1713516331836,MCWP 40R,C00,518783,Staff,8,0,20,12
1713516332863,MCWP 50R,A00,518791,Staff,7,0,20,13
1713516332863,MCWP 50R,B00,518792,Staff,3,0,20,17
1713516332863,MCWP 50R,C00,518793,Staff,5,0,20,15
1713516332863,MCWP 50R,D00,518794,Staff,0,0,20,20
1713516332863,MCWP 50R,E00,518795,Staff,0,0,20,20
1713516332863,MCWP 50R,F00,518796,Staff,10,0,20,10
1713516332863,MCWP 50R,G00,518797,Staff,10,0,20,10
1713516333895,MMW 12R,A01,514034,Herbst; Matthew,1,0,16,15
1713516333895,MMW 12R,A02,514035,Herbst; Matthew,13,0,16,3
1713516334926,MMW 13R,A01,514037,Staff,0,8,16,16
1713516334926,MMW 13R,A02,514039,Staff,0,7,16,16
1713516336984,SIO 295LS,A00,523233,Staff,15,0,30,15
1713516338015,SIO 295S,A00,523232,Staff,15,0,30,15
1713516339048,SOCI 117,A01,494376,Staff,0,2,5,5
1713516340078,WES 237B,A00,494380,Staff,19,0,20,1
1713516342141,AESE 279B,A00,494370,Wade; Jon P,33,0,33,0
1713516343169,AIP 197,001,627712,Vespa; Emanuel Ignacio,9999,0,9999,0
1713516344198,ANAR 135S,A00,494369,Braswell; Geoffrey E.,0,0,0,0
1713516345225,CAT 124RS,A01,519847,Geibel; William,6,0,20,14
1713516346255,CAT 125RS,A01,515971,Geibel; William,6,0,20,14
1713516347286,CLRE 250,A00,511389,Morris; Sheldon,9996,0,9999,3
1713516348313,CLRE 251,A00,507176,Mehta; Ravindra L.,9996,0,9999,3
1713516348313,CLRE 251,B00,511410,Mehta; Ravindra L.,9998,0,9999,1
1713516349338,CLRE 252,A00,507189,Cuomo; Raphael Eduardo,9998,0,9999,1
1713516350370,CLRE 253,A00,507199,Vaida; Florin,9997,0,9999,2
1713516350370,CLRE 253,B00,507202,Vaida; Florin,9999,0,9999,0
1713516351397,CLRE 259,A00,507211,Patel; Hemal,9996,0,9999,3
1713516352422,CLRE 260,A00,507221,Cuomo; Raphael Eduardo,9999,0,9999,0
1713516353448,CLRE 297,001,507242,Cuomo; Raphael Eduardo,9999,0,9999,0
1713516354478,CSE 191,A00,516875,Minnes Kemp; Mor Mia,9999,0,9999,0
1713516355504,CSS 201S,A01,494383,Staff,35,0,35,0
1713516356530,CSS 202S,A01,494387,Staff,35,0,35,0
1713516357559,EAP 100,A00,516065,Staff,9792,0,9999,207
1713516358590,ECE 45,A01,507414,Staff,37,0,60,23
1713516359619,ECE 100,A01,507416,Baghdadchi; Saharnaz,0,0,20,20
1713516359619,ECE 100,A02,507418,Baghdadchi; Saharnaz,19,0,20,1
1713516360645,ECE 111,A01,507420,Staff,27,0,50,23
1713516361671,ECE 197,001,548057,Sievenpiper; Daniel F.,9998,0,9999,1
1713516362697,EDS 115,A00,507243,Choi; Bailey Miyeon,27,0,28,1
1713516363728,EDS 117,A01,494379,Staff,14,0,25,11
1713516364753,EDS 125,A00,507246,Hopkins; Megan Beth,27,0,30,3
1713516365780,EDS 128A,A01,507264,Fargason; Sharon Gayle,26,0,26,0
1713516366810,EDS 128B,A01,507293,Pappas; Elizabeth,30,0,30,0
1713516367837,EDS 139,A00,507294,Fargason; Sharon Gayle,30,0,30,0
1713516367837,EDS 139,B00,507313,Pappas; Elizabeth,30,0,30,0
1713516368863,EDS 201,A00,507315,Staff,18,0,30,12
1713516369888,EDS 203,A01,507317,Halter; Christopher P.,17,0,30,13
1713516370916,EDS 204R,A01,507319,Halter; Christopher P.,0,1,30,30
1713516370916,EDS 204R,B01,507331,Heinzman; Erica M.,22,0,30,8
1713516371945,EDS 206R,A00,507332,Staff,0,2,30,30
1713516371945,EDS 206R,B00,507343,Staff,23,0,30,7
1713516372977,EDS 250,A00,507344,Hemans; Patricia Ann Benitez,27,0,40,13
1713516374007,EDS 281,A00,507345,Daly; Alan J.,18,0,18,0
1713516375033,EDS 284,A00,507350,Daly; Alan J.,16,0,16,0
1713516376061,EDS 286,A00,507359,Fine; Sarah,18,0,18,0
1713516377091,EDS 289C,A01,507361,Daly; Alan J.,18,0,18,0
1713516378116,EDS 290,A00,507366,Hofstetter; Carolyn,15,0,15,0
1713516379142,LIGM 5A,A00,507421,Fischer-Grunski; Eva K,20,0,20,0
1713516380169,LIGM 5B,A00,507423,Fischer-Grunski; Eva K,20,0,20,0
1713516381195,LIGM 5C,A00,507425,Fischer-Grunski; Eva K,20,0,20,0
1713516382227,LIIT 5AS,A00,507427,Carnelos; Chiara,20,0,20,0
1713516383253,LIIT 5BS,A00,507430,Carnelos; Chiara,20,0,20,0
1713516384283,LIIT 5CS,A00,507432,Carnelos; Chiara,20,0,20,0
1713516385314,LISP 5A,A00,507541,Munoz Sanchez; Alicia,14,0,20,6
1713516386346,LISP 5B,A00,507671,Munoz Sanchez; Alicia,12,0,20,8
1713516387373,LISP 5C,A00,507696,Munoz Sanchez; Alicia,11,0,20,9
1713516388399,MAE 197,001,528363,Boechler; Nicholas Sebastia,9998,0,9999,1
1713516389431,MATH 197,001,523477,Kedlaya; Kiran S.,9999,0,9999,0
1713516389431,MATH 197,002,563811,Zhang; Danna,9998,0,9999,1
1713516390458,MCWP 40R,A00,518780,Staff,13,0,20,7
1713516390458,MCWP 40R,B00,518781,Staff,11,0,20,9
1713516390458,MCWP 40R,C00,518783,Staff,8,0,20,12
1713516391489,MCWP 50R,A00,518791,Staff,7,0,20,13
1713516391489,MCWP 50R,B00,518792,Staff,3,0,20,17
1713516391489,MCWP 50R,C00,518793,Staff,5,0,20,15
1713516391489,MCWP 50R,D00,518794,Staff,0,0,20,20
1713516391489,MCWP 50R,E00,518795,Staff,0,0,20,20
1713516391489,MCWP 50R,F00,518796,Staff,10,0,20,10
1713516391489,MCWP 50R,G00,518797,Staff,10,0,20,10
1713516392514,MMW 12R,A01,514034,Herbst; Matthew,1,0,16,15
1713516392514,MMW 12R,A02,514035,Herbst; Matthew,13,0,16,3
1713516393541,MMW 13R,A01,514037,Staff,0,8,16,16
1713516393541,MMW 13R,A02,514039,Staff,0,7,16,16
1713516395593,SIO 295LS,A00,523233,Staff,15,0,30,15
1713516396674,SIO 295S,A00,523232,Staff,15,0,30,15
1713516397700,SOCI 117,A01,494376,Staff,0,2,5,5
1713516398731,WES 237B,A00,494380,Staff,19,0,20,1
1713516400817,AESE 279B,A00,494370,Wade; Jon P,33,0,33,0
1713516401848,AIP 197,001,627712,Vespa; Emanuel Ignacio,9999,0,9999,0
1713516402874,ANAR 135S,A00,494369,Braswell; Geoffrey E.,0,0,0,0
1713516403900,CAT 124RS,A01,519847,Geibel; William,6,0,20,14
1713516404931,CAT 125RS,A01,515971,Geibel; William,6,0,20,14
1713516405958,CLRE 250,A00,511389,Morris; Sheldon,9996,0,9999,3
1713516406994,CLRE 251,A00,507176,Mehta; Ravindra L.,9996,0,9999,3
1713516406994,CLRE 251,B00,511410,Mehta; Ravindra L.,9998,0,9999,1
1713516408028,CLRE 252,A00,507189,Cuomo; Raphael Eduardo,9998,0,9999,1
1713516409054,CLRE 253,A00,507199,Vaida; Florin,9997,0,9999,2
1713516409054,CLRE 253,B00,507202,Vaida; Florin,9999,0,9999,0
1713516410078,CLRE 259,A00,507211,Patel; Hemal,9996,0,9999,3
1713516411108,CLRE 260,A00,507221,Cuomo; Raphael Eduardo,9999,0,9999,0
1713516412134,CLRE 297,001,507242,Cuomo; Raphael Eduardo,9999,0,9999,0
1713516413160,CSE 191,A00,516875,Minnes Kemp; Mor Mia,9999,0,9999,0
1713516414186,CSS 201S,A01,494383,Staff,35,0,35,0
1713516415212,CSS 202S,A01,494387,Staff,35,0,35,0
1713516416240,EAP 100,A00,516065,Staff,9792,0,9999,207
1713516417268,ECE 45,A01,507414,Staff,37,0,60,23
1713516418294,ECE 100,A01,507416,Baghdadchi; Saharnaz,0,0,20,20
1713516418294,ECE 100,A02,507418,Baghdadchi; Saharnaz,19,0,20,1
1713516419317,ECE 111,A01,507420,Staff,27,0,50,23
1713516420342,ECE 197,001,548057,Sievenpiper; Daniel F.,9998,0,9999,1
1713516421368,EDS 115,A00,507243,Choi; Bailey Miyeon,27,0,28,1
1713516422396,EDS 117,A01,494379,Staff,14,0,25,11
1713516423432,EDS 125,A00,507246,Hopkins; Megan Beth,27,0,30,3
1713516424457,EDS 128A,A01,507264,Fargason; Sharon Gayle,26,0,26,0
1713516425484,EDS 128B,A01,507293,Pappas; Elizabeth,30,0,30,0
1713516426514,EDS 139,A00,507294,Fargason; Sharon Gayle,30,0,30,0
1713516426514,EDS 139,B00,507313,Pappas; Elizabeth,30,0,30,0
1713516427539,EDS 201,A00,507315,Staff,18,0,30,12
1713516428565,EDS 203,A01,507317,Halter; Christopher P.,17,0,30,13
1713516429591,EDS 204R,A01,507319,Halter; Christopher P.,0,1,30,30
1713516429591,EDS 204R,B01,507331,Heinzman; Erica M.,22,0,30,8
1713516430620,EDS 206R,A00,507332,Staff,0,2,30,30
1713516430620,EDS 206R,B00,507343,Staff,23,0,30,7
1713516431647,EDS 250,A00,507344,Hemans; Patricia Ann Benitez,27,0,40,13
1713516432673,EDS 281,A00,507345,Daly; Alan J.,18,0,18,0
1713516433703,EDS 284,A00,507350,Daly; Alan J.,16,0,16,0
1713516434737,EDS 286,A00,507359,Fine; Sarah,18,0,18,0
1713516435768,EDS 289C,A01,507361,Daly; Alan J.,18,0,18,0
1713516436794,EDS 290,A00,507366,Hofstetter; Carolyn,15,0,15,0
1713516437824,LIGM 5A,A00,507421,Fischer-Grunski; Eva K,20,0,20,0
1713516438855,LIGM 5B,A00,507423,Fischer-Grunski; Eva K,20,0,20,0
1713516439886,LIGM 5C,A00,507425,Fischer-Grunski; Eva K,20,0,20,0
1713516440916,LIIT 5AS,A00,507427,Carnelos; Chiara,20,0,20,0
1713516441953,LIIT 5BS,A00,507430,Carnelos; Chiara,20,0,20,0
1713516442980,LIIT 5CS,A00,507432,Carnelos; Chiara,20,0,20,0
1713516444016,LISP 5A,A00,507541,Munoz Sanchez; Alicia,14,0,20,6
1713516445041,LISP 5B,A00,507671,Munoz Sanchez; Alicia,12,0,20,8
1713516446069,LISP 5C,A00,507696,Munoz Sanchez; Alicia,11,0,20,9
1713516447099,MAE 197,001,528363,Boechler; Nicholas Sebastia,9998,0,9999,1
1713516448126,MATH 197,001,523477,Kedlaya; Kiran S.,9999,0,9999,0
1713516448126,MATH 197,002,563811,Zhang; Danna,9998,0,9999,1
1713516449163,MCWP 40R,A00,518780,Staff,13,0,20,7
1713516449163,MCWP 40R,B00,518781,Staff,11,0,20,9
1713516449163,MCWP 40R,C00,518783,Staff,8,0,20,12
1713516450190,MCWP 50R,A00,518791,Staff,7,0,20,13
1713516450190,MCWP 50R,B00,518792,Staff,3,0,20,17
1713516450190,MCWP 50R,C00,518793,Staff,5,0,20,15
1713516450190,MCWP 50R,D00,518794,Staff,0,0,20,20
1713516450190,MCWP 50R,E00,518795,Staff,0,0,20,20
1713516450190,MCWP 50R,F00,518796,Staff,10,0,20,10
1713516450190,MCWP 50R,G00,518797,Staff,10,0,20,10
1713516451216,MMW 12R,A01,514034,Herbst; Matthew,1,0,16,15
1713516451216,MMW 12R,A02,514035,Herbst; Matthew,13,0,16,3
1713516452240,MMW 13R,A01,514037,Staff,0,8,16,16
1713516452240,MMW 13R,A02,514039,Staff,0,7,16,16
1713516454325,SIO 295LS,A00,523233,Staff,15,0,30,15
1713516455350,SIO 295S,A00,523232,Staff,15,0,30,15
1713516456382,SOCI 117,A01,494376,Staff,0,2,5,5
1713516457408,WES 237B,A00,494380,Staff,19,0,20,1
1713516459516,AESE 279B,A00,494370,Wade; Jon P,33,0,33,0
1713516460543,AIP 197,001,627712,Vespa; Emanuel Ignacio,9999,0,9999,0
1713516461575,ANAR 135S,A00,494369,Braswell; Geoffrey E.,0,0,0,0
1713516462600,CAT 124RS,A01,519847,Geibel; William,6,0,20,14
1713516463624,CAT 125RS,A01,515971,Geibel; William,6,0,20,14
1713516464650,CLRE 250,A00,511389,Morris; Sheldon,9996,0,9999,3
1713516465678,CLRE 251,A00,507176,Mehta; Ravindra L.,9996,0,9999,3
1713516465678,CLRE 251,B00,511410,Mehta; Ravindra L.,9998,0,9999,1
1713516466710,CLRE 252,A00,507189,Cuomo; Raphael Eduardo,9998,0,9999,1
1713516467736,CLRE 253,A00,507199,Vaida; Florin,9997,0,9999,2
1713516467736,CLRE 253,B00,507202,Vaida; Florin,9999,0,9999,0
1713516468767,CLRE 259,A00,507211,Patel; Hemal,9996,0,9999,3
1713516469797,CLRE 260,A00,507221,Cuomo; Raphael Eduardo,9999,0,9999,0
1713516470826,CLRE 297,001,507242,Cuomo; Raphael Eduardo,9999,0,9999,0
1713516471857,CSE 191,A00,516875,Minnes Kemp; Mor Mia,9999,0,9999,0
1713516472885,CSS 201S,A01,494383,Staff,35,0,35,0
1713516473912,CSS 202S,A01,494387,Staff,35,0,35,0
1713516474939,EAP 100,A00,516065,Staff,9792,0,9999,207
1713516475965,ECE 45,A01,507414,Staff,37,0,60,23
1713516476992,ECE 100,A01,507416,Baghdadchi; Saharnaz,0,0,20,20
1713516476992,ECE 100,A02,507418,Baghdadchi; Saharnaz,19,0,20,1
1713516478020,ECE 111,A01,507420,Staff,27,0,50,23
1713516479047,ECE 197,001,548057,Sievenpiper; Daniel F.,9998,0,9999,1
1713516480084,EDS 115,A00,507243,Choi; Bailey Miyeon,27,0,28,1
1713516481120,EDS 117,A01,494379,Staff,14,0,25,11
1713516482146,EDS 125,A00,507246,Hopkins; Megan Beth,27,0,30,3
1713516483173,EDS 128A,A01,507264,Fargason; Sharon Gayle,26,0,26,0
1713516484204,EDS 128B,A01,507293,Pappas; Elizabeth,30,0,30,0
1713516485237,EDS 139,A00,507294,Fargason; Sharon Gayle,30,0,30,0
1713516485237,EDS 139,B00,507313,Pappas; Elizabeth,30,0,30,0
1713516486268,EDS 201,A00,507315,Staff,18,0,30,12
1713516487299,EDS 203,A01,507317,Halter; Christopher P.,17,0,30,13
1713516488330,EDS 204R,A01,507319,Halter; Christopher P.,0,1,30,30
1713516488330,EDS 204R,B01,507331,Heinzman; Erica M.,22,0,30,8
1713516489355,EDS 206R,A00,507332,Staff,0,2,30,30
1713516489355,EDS 206R,B00,507343,Staff,23,0,30,7
1713516490381,EDS 250,A00,507344,Hemans; Patricia Ann Benitez,27,0,40,13
1713516491412,EDS 281,A00,507345,Daly; Alan J.,18,0,18,0
1713516492438,EDS 284,A00,507350,Daly; Alan J.,16,0,16,0
1713516493463,EDS 286,A00,507359,Fine; Sarah,18,0,18,0
1713516494492,EDS 289C,A01,507361,Daly; Alan J.,18,0,18,0
1713516495521,EDS 290,A00,507366,Hofstetter; Carolyn,15,0,15,0
1713516496553,LIGM 5A,A00,507421,Fischer-Grunski; Eva K,20,0,20,0
1713516497579,LIGM 5B,A00,507423,Fischer-Grunski; Eva K,20,0,20,0
1713516498609,LIGM 5C,A00,507425,Fischer-Grunski; Eva K,20,0,20,0
1713516499634,LIIT 5AS,A00,507427,Carnelos; Chiara,20,0,20,0
1713516500718,LIIT 5BS,A00,507430,Carnelos; Chiara,20,0,20,0
1713516501744,LIIT 5CS,A00,507432,Carnelos; Chiara,20,0,20,0
1713516502770,LISP 5A,A00,507541,Munoz Sanchez; Alicia,14,0,20,6
1713516503801,LISP 5B,A00,507671,Munoz Sanchez; Alicia,12,0,20,8
1713516504828,LISP 5C,A00,507696,Munoz Sanchez; Alicia,11,0,20,9
1713516505859,MAE 197,001,528363,Boechler; Nicholas Sebastia,9998,0,9999,1
1713516506886,MATH 197,001,523477,Kedlaya; Kiran S.,9999,0,9999,0
1713516506886,MATH 197,002,563811,Zhang; Danna,9998,0,9999,1
1713516507913,MCWP 40R,A00,518780,Staff,13,0,20,7
1713516507913,MCWP 40R,B00,518781,Staff,11,0,20,9
1713516507913,MCWP 40R,C00,518783,Staff,8,0,20,12
1713516508944,MCWP 50R,A00,518791,Staff,7,0,20,13
1713516508944,MCWP 50R,B00,518792,Staff,3,0,20,17
1713516508944,MCWP 50R,C00,518793,Staff,5,0,20,15
1713516508944,MCWP 50R,D00,518794,Staff,0,0,20,20
1713516508944,MCWP 50R,E00,518795,Staff,0,0,20,20
1713516508944,MCWP 50R,F00,518796,Staff,10,0,20,10
1713516508944,MCWP 50R,G00,518797,Staff,10,0,20,10
1713516509971,MMW 12R,A01,514034,Herbst; Matthew,1,0,16,15
1713516509971,MMW 12R,A02,514035,Herbst; Matthew,13,0,16,3
1713516511001,MMW 13R,A01,514037,Staff,0,8,16,16
1713516511001,MMW 13R,A02,514039,Staff,0,7,16,16
1713516513056,SIO 295LS,A00,523233,Staff,15,0,30,15
1713516514081,SIO 295S,A00,523232,Staff,15,0,30,15
1713516515114,SOCI 117,A01,494376,Staff,0,2,5,5
1713516516141,WES 237B,A00,494380,Staff,19,0,20,1
1713516518202,AESE 279B,A00,494370,Wade; Jon P,33,0,33,0
1713516519228,AIP 197,001,627712,Vespa; Emanuel Ignacio,9999,0,9999,0
1713516520256,ANAR 135S,A00,494369,Braswell; Geoffrey E.,0,0,0,0
1713516521284,CAT 124RS,A01,519847,Geibel; William,6,0,20,14
1713516522310,CAT 125RS,A01,515971,Geibel; William,6,0,20,14
1713516523335,CLRE 250,A00,511389,Morris; Sheldon,9996,0,9999,3
1713516524362,CLRE 251,A00,507176,Mehta; Ravindra L.,9996,0,9999,3
1713516524362,CLRE 251,B00,511410,Mehta; Ravindra L.,9998,0,9999,1
1713516525393,CLRE 252,A00,507189,Cuomo; Raphael Eduardo,9998,0,9999,1
1713516526421,CLRE 253,A00,507199,Vaida; Florin,9997,0,9999,2
1713516526421,CLRE 253,B00,507202,Vaida; Florin,9999,0,9999,0
1713516527452,CLRE 259,A00,507211,Patel; Hemal,9996,0,9999,3
1713516528477,CLRE 260,A00,507221,Cuomo; Raphael Eduardo,9999,0,9999,0
1713516529503,CLRE 297,001,507242,Cuomo; Raphael Eduardo,9999,0,9999,0
1713516530534,CSE 191,A00,516875,Minnes Kemp; Mor Mia,9999,0,9999,0
1713516531565,CSS 201S,A01,494383,Staff,35,0,35,0
1713516532592,CSS 202S,A01,494387,Staff,35,0,35,0
1713516533622,EAP 100,A00,516065,Staff,9792,0,9999,207
1713516534649,ECE 45,A01,507414,Staff,37,0,60,23
1713516535676,ECE 100,A01,507416,Baghdadchi; Saharnaz,0,0,20,20
1713516535676,ECE 100,A02,507418,Baghdadchi; Saharnaz,19,0,20,1
1713516536701,ECE 111,A01,507420,Staff,27,0,50,23
1713516537727,ECE 197,001,548057,Sievenpiper; Daniel F.,9998,0,9999,1
1713516538757,EDS 115,A00,507243,Choi; Bailey Miyeon,27,0,28,1
1713516539784,EDS 117,A01,494379,Staff,14,0,25,11
1713516540810,EDS 125,A00,507246,Hopkins; Megan Beth,27,0,30,3
1713516541836,EDS 128A,A01,507264,Fargason; Sharon Gayle,26,0,26,0
1713516542862,EDS 128B,A01,507293,Pappas; Elizabeth,30,0,30,0
1713516543892,EDS 139,A00,507294,Fargason; Sharon Gayle,30,0,30,0
1713516543892,EDS 139,B00,507313,Pappas; Elizabeth,30,0,30,0
1713516544921,EDS 201,A00,507315,Staff,18,0,30,12
1713516545951,EDS 203,A01,507317,Halter; Christopher P.,17,0,30,13
1713516546982,EDS 204R,A01,507319,Halter; Christopher P.,0,1,30,30
1713516546982,EDS 204R,B01,507331,Heinzman; Erica M.,22,0,30,8
1713516548009,EDS 206R,A00,507332,Staff,0,2,30,30
1713516548009,EDS 206R,B00,507343,Staff,23,0,30,7
1713516549036,EDS 250,A00,507344,Hemans; Patricia Ann Benitez,27,0,40,13
1713516550062,EDS 281,A00,507345,Daly; Alan J.,18,0,18,0
1713516551089,EDS 284,A00,507350,Daly; Alan J.,16,0,16,0
1713516552115,EDS 286,A00,507359,Fine; Sarah,18,0,18,0
1713516553142,EDS 289C,A01,507361,Daly; Alan J.,18,0,18,0
1713516554169,EDS 290,A00,507366,Hofstetter; Carolyn,15,0,15,0
1713516555200,LIGM 5A,A00,507421,Fischer-Grunski; Eva K,20,0,20,0
1713516556230,LIGM 5B,A00,507423,Fischer-Grunski; Eva K,20,0,20,0
1713516557258,LIGM 5C,A00,507425,Fischer-Grunski; Eva K,20,0,20,0
1713516558290,LIIT 5AS,A00,507427,Carnelos; Chiara,20,0,20,0
1713516559316,LIIT 5BS,A00,507430,Carnelos; Chiara,20,0,20,0
1713516560344,LIIT 5CS,A00,507432,Carnelos; Chiara,20,0,20,0
1713516561373,LISP 5A,A00,507541,Munoz Sanchez; Alicia,14,0,20,6
1713516562403,LISP 5B,A00,507671,Munoz Sanchez; Alicia,12,0,20,8
1713516563434,LISP 5C,A00,507696,Munoz Sanchez; Alicia,11,0,20,9
1713516564460,MAE 197,001,528363,Boechler; Nicholas Sebastia,9998,0,9999,1
1713516565486,MATH 197,001,523477,Kedlaya; Kiran S.,9999,0,9999,0
1713516565486,MATH 197,002,563811,Zhang; Danna,9998,0,9999,1
1713516566517,MCWP 40R,A00,518780,Staff,13,0,20,7
1713516566517,MCWP 40R,B00,518781,Staff,11,0,20,9
1713516566517,MCWP 40R,C00,518783,Staff,8,0,20,12
1713516567550,MCWP 50R,A00,518791,Staff,7,0,20,13
1713516567550,MCWP 50R,B00,518792,Staff,3,0,20,17
1713516567550,MCWP 50R,C00,518793,Staff,5,0,20,15
1713516567550,MCWP 50R,D00,518794,Staff,0,0,20,20
1713516567550,MCWP 50R,E00,518795,Staff,0,0,20,20
1713516567550,MCWP 50R,F00,518796,Staff,10,0,20,10
1713516567550,MCWP 50R,G00,518797,Staff,10,0,20,10
1713516568575,MMW 12R,A01,514034,Herbst; Matthew,1,0,16,15
1713516568575,MMW 12R,A02,514035,Herbst; Matthew,13,0,16,3
1713516569602,MMW 13R,A01,514037,Staff,0,8,16,16
1713516569602,MMW 13R,A02,514039,Staff,0,7,16,16
1713516571659,SIO 295LS,A00,523233,Staff,15,0,30,15
1713516572684,SIO 295S,A00,523232,Staff,15,0,30,15
1713516573716,SOCI 117,A01,494376,Staff,0,2,5,5
1713516574742,WES 237B,A00,494380,Staff,19,0,20,1
1713516576812,AESE 279B,A00,494370,Wade; Jon P,33,0,33,0
1713516577838,AIP 197,001,627712,Vespa; Emanuel Ignacio,9999,0,9999,0
1713516578865,ANAR 135S,A00,494369,Braswell; Geoffrey E.,0,0,0,0
1713516579891,CAT 124RS,A01,519847,Geibel; William,6,0,20,14
1713516580916,CAT 125RS,A01,515971,Geibel; William,6,0,20,14
1713516581943,CLRE 250,A00,511389,Morris; Sheldon,9996,0,9999,3
1713516582968,CLRE 251,A00,507176,Mehta; Ravindra L.,9996,0,9999,3
1713516582968,CLRE 251,B00,511410,Mehta; Ravindra L.,9998,0,9999,1
1713516583994,CLRE 252,A00,507189,Cuomo; Raphael Eduardo,9998,0,9999,1
1713516585020,CLRE 253,A00,507199,Vaida; Florin,9997,0,9999,2
1713516585020,CLRE 253,B00,507202,Vaida; Florin,9999,0,9999,0
1713516586049,CLRE 259,A00,507211,Patel; Hemal,9996,0,9999,3
1713516587075,CLRE 260,A00,507221,Cuomo; Raphael Eduardo,9999,0,9999,0
1713516588101,CLRE 297,001,507242,Cuomo; Raphael Eduardo,9999,0,9999,0
1713516589130,CSE 191,A00,516875,Minnes Kemp; Mor Mia,9999,0,9999,0
1713516590164,CSS 201S,A01,494383,Staff,35,0,35,0
1713516591190,CSS 202S,A01,494387,Staff,35,0,35,0
1713516592216,EAP 100,A00,516065,Staff,9792,0,9999,207
1713516593243,ECE 45,A01,507414,Staff,37,0,60,23
1713516594272,ECE 100,A01,507416,Baghdadchi; Saharnaz,0,0,20,20
1713516594272,ECE 100,A02,507418,Baghdadchi; Saharnaz,19,0,20,1
1713516595304,ECE 111,A01,507420,Staff,27,0,50,23
1713516596330,ECE 197,001,548057,Sievenpiper; Daniel F.,9998,0,9999,1
1713516597354,EDS 115,A00,507243,Choi; Bailey Miyeon,27,0,28,1
1713516598381,EDS 117,A01,494379,Staff,14,0,25,11
1713516599412,EDS 125,A00,507246,Hopkins; Megan Beth,27,0,30,3
1713516600436,EDS 128A,A01,507264,Fargason; Sharon Gayle,26,0,26,0
1713516601468,EDS 128B,A01,507293,Pappas; Elizabeth,30,0,30,0
1713516602496,EDS 139,A00,507294,Fargason; Sharon Gayle,30,0,30,0
1713516602496,EDS 139,B00,507313,Pappas; Elizabeth,30,0,30,0
1713516603532,EDS 201,A00,507315,Staff,18,0,30,12
1713516604615,EDS 203,A01,507317,Halter; Christopher P.,17,0,30,13
1713516605648,EDS 204R,A01,507319,Halter; Christopher P.,0,1,30,30
1713516605648,EDS 204R,B01,507331,Heinzman; Erica M.,22,0,30,8
1713516606674,EDS 206R,A00,507332,Staff,0,2,30,30
1713516606674,EDS 206R,B00,507343,Staff,23,0,30,7
1713516607704,EDS 250,A00,507344,Hemans; Patricia Ann Benitez,27,0,40,13
1713516608730,EDS 281,A00,507345,Daly; Alan J.,18,0,18,0
1713516609756,EDS 284,A00,507350,Daly; Alan J.,16,0,16,0
1713516610788,EDS 286,A00,507359,Fine; Sarah,18,0,18,0
1713516611813,EDS 289C,A01,507361,Daly; Alan J.,18,0,18,0
1713516612839,EDS 290,A00,507366,Hofstetter; Carolyn,15,0,15,0
1713516613875,LIGM 5A,A00,507421,Fischer-Grunski; Eva K,20,0,20,0
1713516614910,LIGM 5B,A00,507423,Fischer-Grunski; Eva K,20,0,20,0
1713516615940,LIGM 5C,A00,507425,Fischer-Grunski; Eva K,20,0,20,0
1713516616974,LIIT 5AS,A00,507427,Carnelos; Chiara,20,0,20,0
1713516617999,LIIT 5BS,A00,507430,Carnelos; Chiara,20,0,20,0
1713516619026,LIIT 5CS,A00,507432,Carnelos; Chiara,20,0,20,0
1713516620059,LISP 5A,A00,507541,Munoz Sanchez; Alicia,14,0,20,6
1713516621085,LISP 5B,A00,507671,Munoz Sanchez; Alicia,12,0,20,8
1713516622116,LISP 5C,A00,507696,Munoz Sanchez; Alicia,11,0,20,9
1713516623147,MAE 197,001,528363,Boechler; Nicholas Sebastia,9998,0,9999,1
1713516624173,MATH 197,001,523477,Kedlaya; Kiran S.,9999,0,9999,0
1713516624173,MATH 197,002,563811,Zhang; Danna,9998,0,9999,1
1713516625199,MCWP 40R,A00,518780,Staff,13,0,20,7
1713516625199,MCWP 40R,B00,518781,Staff,11,0,20,9
1713516625199,MCWP 40R,C00,518783,Staff,8,0,20,12
1713516626226,MCWP 50R,A00,518791,Staff,7,0,20,13
1713516626226,MCWP 50R,B00,518792,Staff,3,0,20,17
1713516626226,MCWP 50R,C00,518793,Staff,5,0,20,15
1713516626226,MCWP 50R,D00,518794,Staff,0,0,20,20
1713516626226,MCWP 50R,E00,518795,Staff,0,0,20,20
1713516626226,MCWP 50R,F00,518796,Staff,10,0,20,10
1713516626226,MCWP 50R,G00,518797,Staff,10,0,20,10
1713516627253,MMW 12R,A01,514034,Herbst; Matthew,1,0,16,15
1713516627253,MMW 12R,A02,514035,Herbst; Matthew,13,0,16,3
1713516628283,MMW 13R,A01,514037,Staff,0,8,16,16
1713516628283,MMW 13R,A02,514039,Staff,0,7,16,16
1713516630334,SIO 295LS,A00,523233,Staff,15,0,30,15
1713516631359,SIO 295S,A00,523232,Staff,15,0,30,15
1713516632390,SOCI 117,A01,494376,Staff,0,2,5,5
1713516633418,WES 237B,A00,494380,Staff,19,0,20,1
1713516635495,AESE 279B,A00,494370,Wade; Jon P,33,0,33,0
1713516636520,AIP 197,001,627712,Vespa; Emanuel Ignacio,9999,0,9999,0
1713516637548,ANAR 135S,A00,494369,Braswell; Geoffrey E.,0,0,0,0
1713516638578,CAT 124RS,A01,519847,Geibel; William,6,0,20,14
1713516639604,CAT 125RS,A01,515971,Geibel; William,6,0,20,14
1713516640631,CLRE 250,A00,511389,Morris; Sheldon,9996,0,9999,3
1713516641658,CLRE 251,A00,507176,Mehta; Ravindra L.,9996,0,9999,3
1713516641658,CLRE 251,B00,511410,Mehta; Ravindra L.,9998,0,9999,1
1713516642685,CLRE 252,A00,507189,Cuomo; Raphael Eduardo,9998,0,9999,1
1713516643711,CLRE 253,A00,507199,Vaida; Florin,9997,0,9999,2
1713516643711,CLRE 253,B00,507202,Vaida; Florin,9999,0,9999,0
1713516644738,CLRE 259,A00,507211,Patel; Hemal,9996,0,9999,3
1713516645765,CLRE 260,A00,507221,Cuomo; Raphael Eduardo,9999,0,9999,0
1713516646796,CLRE 297,001,507242,Cuomo; Raphael Eduardo,9999,0,9999,0
1713516647825,CSE 191,A00,516875,Minnes Kemp; Mor Mia,9999,0,9999,0
1713516648854,CSS 201S,A01,494383,Staff,35,0,35,0
1713516649879,CSS 202S,A01,494387,Staff,35,0,35,0
1713516650908,EAP 100,A00,516065,Staff,9792,0,9999,207
1713516651938,ECE 45,A01,507414,Staff,37,0,60,23
1713516652966,ECE 100,A01,507416,Baghdadchi; Saharnaz,0,0,20,20
1713516652966,ECE 100,A02,507418,Baghdadchi; Saharnaz,19,0,20,1
1713516653996,ECE 111,A01,507420,Staff,27,0,50,23
1713516655023,ECE 197,001,548057,Sievenpiper; Daniel F.,9998,0,9999,1
1713516656050,EDS 115,A00,507243,Choi; Bailey Miyeon,27,0,28,1
1713516657077,EDS 117,A01,494379,Staff,14,0,25,11
1713516658104,EDS 125,A00,507246,Hopkins; Megan Beth,27,0,30,3
1713516659133,EDS 128A,A01,507264,Fargason; Sharon Gayle,26,0,26,0
1713516660168,EDS 128B,A01,507293,Pappas; Elizabeth,30,0,30,0
1713516661193,EDS 139,A00,507294,Fargason; Sharon Gayle,30,0,30,0
1713516661193,EDS 139,B00,507313,Pappas; Elizabeth,30,0,30,0
1713516662219,EDS 201,A00,507315,Staff,18,0,30,12
1713516663246,EDS 203,A01,507317,Halter; Christopher P.,17,0,30,13
1713516664276,EDS 204R,A01,507319,Halter; Christopher P.,0,1,30,30
1713516664276,EDS 204R,B01,507331,Heinzman; Erica M.,22,0,30,8
1713516665308,EDS 206R,A00,507332,Staff,0,2,30,30
1713516665308,EDS 206R,B00,507343,Staff,23,0,30,7
1713516666335,EDS 250,A00,507344,Hemans; Patricia Ann Benitez,27,0,40,13
1713516667359,EDS 281,A00,507345,Daly; Alan J.,18,0,18,0
1713516668385,EDS 284,A00,507350,Daly; Alan J.,16,0,16,0
1713516669413,EDS 286,A00,507359,Fine; Sarah,18,0,18,0
1713516670441,EDS 289C,A01,507361,Daly; Alan J.,18,0,18,0
1713516671472,EDS 290,A00,507366,Hofstetter; Carolyn,15,0,15,0
1713516672507,LIGM 5A,A00,507421,Fischer-Grunski; Eva K,20,0,20,0
1713516673532,LIGM 5B,A00,507423,Fischer-Grunski; Eva K,20,0,20,0
1713516674558,LIGM 5C,A00,507425,Fischer-Grunski; Eva K,20,0,20,0
1713516675589,LIIT 5AS,A00,507427,Carnelos; Chiara,20,0,20,0
1713516676614,LIIT 5BS,A00,507430,Carnelos; Chiara,20,0,20,0
1713516677640,LIIT 5CS,A00,507432,Carnelos; Chiara,20,0,20,0
1713516678666,LISP 5A,A00,507541,Munoz Sanchez; Alicia,14,0,20,6
1713516679694,LISP 5B,A00,507671,Munoz Sanchez; Alicia,12,0,20,8
1713516680724,LISP 5C,A00,507696,Munoz Sanchez; Alicia,11,0,20,9
1713516681753,MAE 197,001,528363,Boechler; Nicholas Sebastia,9998,0,9999,1
1713516682779,MATH 197,001,523477,Kedlaya; Kiran S.,9999,0,9999,0
1713516682779,MATH 197,002,563811,Zhang; Danna,9998,0,9999,1
1713516683817,MCWP 40R,A00,518780,Staff,13,0,20,7
1713516683817,MCWP 40R,B00,518781,Staff,11,0,20,9
1713516683817,MCWP 40R,C00,518783,Staff,8,0,20,12
1713516684843,MCWP 50R,A00,518791,Staff,7,0,20,13
1713516684843,MCWP 50R,B00,518792,Staff,3,0,20,17
1713516684843,MCWP 50R,C00,518793,Staff,5,0,20,15
1713516684843,MCWP 50R,D00,518794,Staff,0,0,20,20
1713516684843,MCWP 50R,E00,518795,Staff,0,0,20,20
1713516684843,MCWP 50R,F00,518796,Staff,10,0,20,10
1713516684843,MCWP 50R,G00,518797,Staff,10,0,20,10
1713516685872,MMW 12R,A01,514034,Herbst; Matthew,1,0,16,15
1713516685872,MMW 12R,A02,514035,Herbst; Matthew,13,0,16,3
1713516686897,MMW 13R,A01,514037,Staff,0,8,16,16
1713516686897,MMW 13R,A02,514039,Staff,0,7,16,16
1713516688949,SIO 295LS,A00,523233,Staff,15,0,30,15
1713516689976,SIO 295S,A00,523232,Staff,15,0,30,15
1713516691005,SOCI 117,A01,494376,Staff,0,2,5,5
1713516692030,WES 237B,A00,494380,Staff,19,0,20,1
1713516694090,AESE 279B,A00,494370,Wade; Jon P,33,0,33,0
1713516695116,AIP 197,001,627712,Vespa; Emanuel Ignacio,9999,0,9999,0
1713516696146,ANAR 135S,A00,494369,Braswell; Geoffrey E.,0,0,0,0
1713516697178,CAT 124RS,A01,519847,Geibel; William,6,0,20,14
1713516698203,CAT 125RS,A01,515971,Geibel; William,6,0,20,14
1713516699229,CLRE 250,A00,511389,Morris; Sheldon,9996,0,9999,3
1713516700260,CLRE 251,A00,507176,Mehta; Ravindra L.,9996,0,9999,3
1713516700260,CLRE 251,B00,511410,Mehta; Ravindra L.,9998,0,9999,1
1713516701288,CLRE 252,A00,507189,Cuomo; Raphael Eduardo,9998,0,9999,1
1713516702313,CLRE 253,A00,507199,Vaida; Florin,9997,0,9999,2
1713516702313,CLRE 253,B00,507202,Vaida; Florin,9999,0,9999,0
1713516703341,CLRE 259,A00,507211,Patel; Hemal,9996,0,9999,3
1713516704368,CLRE 260,A00,507221,Cuomo; Raphael Eduardo,9999,0,9999,0
1713516705398,CLRE 297,001,507242,Cuomo; Raphael Eduardo,9999,0,9999,0
1713516706430,CSE 191,A00,516875,Minnes Kemp; Mor Mia,9999,0,9999,0
1713516707456,CSS 201S,A01,494383,Staff,35,0,35,0
1713516708543,CSS 202S,A01,494387,Staff,35,0,35,0
1713516709569,EAP 100,A00,516065,Staff,9792,0,9999,207
1713516710596,ECE 45,A01,507414,Staff,37,0,60,23
1713516711623,ECE 100,A01,507416,Baghdadchi; Saharnaz,0,0,20,20
1713516711623,ECE 100,A02,507418,Baghdadchi; Saharnaz,19,0,20,1
1713516712648,ECE 111,A01,507420,Staff,27,0,50,23
1713516713675,ECE 197,001,548057,Sievenpiper; Daniel F.,9998,0,9999,1
1713516714701,EDS 115,A00,507243,Choi; Bailey Miyeon,27,0,28,1
1713516715726,EDS 117,A01,494379,Staff,14,0,25,11
1713516716760,EDS 125,A00,507246,Hopkins; Megan Beth,27,0,30,3
1713516717795,EDS 128A,A01,507264,Fargason; Sharon Gayle,26,0,26,0
1713516718821,EDS 128B,A01,507293,Pappas; Elizabeth,30,0,30,0
1713516719846,EDS 139,A00,507294,Fargason; Sharon Gayle,30,0,30,0
1713516719846,EDS 139,B00,507313,Pappas; Elizabeth,30,0,30,0
1713516720877,EDS 201,A00,507315,Staff,18,0,30,12
1713516721902,EDS 203,A01,507317,Halter; Christopher P.,17,0,30,13
1713516722929,EDS 204R,A01,507319,Halter; Christopher P.,0,1,30,30
1713516722929,EDS 204R,B01,507331,Heinzman; Erica M.,22,0,30,8
1713516723954,EDS 206R,A00,507332,Staff,0,2,30,30
1713516723954,EDS 206R,B00,507343,Staff,23,0,30,7
1713516724981,EDS 250,A00,507344,Hemans; Patricia Ann Benitez,27,0,40,13
1713516726005,EDS 281,A00,507345,Daly; Alan J.,18,0,18,0
1713516727035,EDS 284,A00,507350,Daly; Alan J.,16,0,16,0
1713516728060,EDS 286,A00,507359,Fine; Sarah,18,0,18,0
1713516729090,EDS 289C,A01,507361,Daly; Alan J.,18,0,18,0
1713516730117,EDS 290,A00,507366,Hofstetter; Carolyn,15,0,15,0
1713516731149,LIGM 5A,A00,507421,Fischer-Grunski; Eva K,20,0,20,0
1713516732179,LIGM 5B,A00,507423,Fischer-Grunski; Eva K,20,0,20,0
1713516733205,LIGM 5C,A00,507425,Fischer-Grunski; Eva K,20,0,20,0
1713516734231,LIIT 5AS,A00,507427,Carnelos; Chiara,20,0,20,0
1713516735258,LIIT 5BS,A00,507430,Carnelos; Chiara,20,0,20,0
1713516736290,LIIT 5CS,A00,507432,Carnelos; Chiara,20,0,20,0
1713516737321,LISP 5A,A00,507541,Munoz Sanchez; Alicia,14,0,20,6
1713516738347,LISP 5B,A00,507671,Munoz Sanchez; Alicia,12,0,20,8
1713516739372,LISP 5C,A00,507696,Munoz Sanchez; Alicia,11,0,20,9
1713516740404,MAE 197,001,528363,Boechler; Nicholas Sebastia,9998,0,9999,1
1713516741430,MATH 197,001,523477,Kedlaya; Kiran S.,9999,0,9999,0
1713516741430,MATH 197,002,563811,Zhang; Danna,9998,0,9999,1
1713516742460,MCWP 40R,A00,518780,Staff,13,0,20,7
1713516742460,MCWP 40R,B00,518781,Staff,11,0,20,9
1713516742460,MCWP 40R,C00,518783,Staff,8,0,20,12
1713516743488,MCWP 50R,A00,518791,Staff,7,0,20,13
1713516743488,MCWP 50R,B00,518792,Staff,3,0,20,17
1713516743488,MCWP 50R,C00,518793,Staff,5,0,20,15
1713516743488,MCWP 50R,D00,518794,Staff,0,0,20,20
1713516743488,MCWP 50R,E00,518795,Staff,0,0,20,20
1713516743488,MCWP 50R,F00,518796,Staff,10,0,20,10
1713516743488,MCWP 50R,G00,518797,Staff,10,0,20,10
1713516744513,MMW 12R,A01,514034,Herbst; Matthew,1,0,16,15
1713516744513,MMW 12R,A02,514035,Herbst; Matthew,13,0,16,3
1713516745547,MMW 13R,A01,514037,Staff,0,8,16,16
1713516745547,MMW 13R,A02,514039,Staff,0,7,16,16
1713516747600,SIO 295LS,A00,523233,Staff,15,0,30,15
1713516748624,SIO 295S,A00,523232,Staff,15,0,30,15
1713516749649,SOCI 117,A01,494376,Staff,0,2,5,5
1713516750679,WES 237B,A00,494380,Staff,19,0,20,1
1713516752742,AESE 279B,A00,494370,Wade; Jon P,33,0,33,0
1713516753772,AIP 197,001,627712,Vespa; Emanuel Ignacio,9999,0,9999,0
1713516754800,ANAR 135S,A00,494369,Braswell; Geoffrey E.,0,0,0,0
1713516755832,CAT 124RS,A01,519847,Geibel; William,6,0,20,14
1713516756864,CAT 125RS,A01,515971,Geibel; William,6,0,20,14
1713516757889,CLRE 250,A00,511389,Morris; Sheldon,9996,0,9999,3
1713516758915,CLRE 251,A00,507176,Mehta; Ravindra L.,9996,0,9999,3
1713516758915,CLRE 251,B00,511410,Mehta; Ravindra L.,9998,0,9999,1
1713516759943,CLRE 252,A00,507189,Cuomo; Raphael Eduardo,9998,0,9999,1
1713516760977,CLRE 253,A00,507199,Vaida; Florin,9997,0,9999,2
1713516760977,CLRE 253,B00,507202,Vaida; Florin,9999,0,9999,0
1713516762008,CLRE 259,A00,507211,Patel; Hemal,9996,0,9999,3
1713516763039,CLRE 260,A00,507221,Cuomo; Raphael Eduardo,9999,0,9999,0
1713516764069,CLRE 297,001,507242,Cuomo; Raphael Eduardo,9999,0,9999,0
1713516765096,CSE 191,A00,516875,Minnes Kemp; Mor Mia,9999,0,9999,0
1713516766128,CSS 201S,A01,494383,Staff,35,0,35,0
1713516767155,CSS 202S,A01,494387,Staff,35,0,35,0
1713516768184,EAP 100,A00,516065,Staff,9792,0,9999,207
1713516769211,ECE 45,A01,507414,Staff,37,0,60,23
1713516770237,ECE 100,A01,507416,Baghdadchi; Saharnaz,0,0,20,20
1713516770237,ECE 100,A02,507418,Baghdadchi; Saharnaz,19,0,20,1
1713516771264,ECE 111,A01,507420,Staff,27,0,50,23
1713516772289,ECE 197,001,548057,Sievenpiper; Daniel F.,9998,0,9999,1
1713516773316,EDS 115,A00,507243,Choi; Bailey Miyeon,27,0,28,1
1713516774342,EDS 117,A01,494379,Staff,14,0,25,11
1713516775373,EDS 125,A00,507246,Hopkins; Megan Beth,27,0,30,3
1713516776406,EDS 128A,A01,507264,Fargason; Sharon Gayle,26,0,26,0
1713516777433,EDS 128B,A01,507293,Pappas; Elizabeth,30,0,30,0
1713516778457,EDS 139,A00,507294,Fargason; Sharon Gayle,30,0,30,0
1713516778457,EDS 139,B00,507313,Pappas; Elizabeth,30,0,30,0
1713516779482,EDS 201,A00,507315,Staff,18,0,30,12
1713516780519,EDS 203,A01,507317,Halter; Christopher P.,17,0,30,13
1713516781548,EDS 204R,A01,507319,Halter; Christopher P.,0,1,30,30
1713516781548,EDS 204R,B01,507331,Heinzman; Erica M.,22,0,30,8
1713516782574,EDS 206R,A00,507332,Staff,0,2,30,30
1713516782574,EDS 206R,B00,507343,Staff,23,0,30,7
1713516783604,EDS 250,A00,507344,Hemans; Patricia Ann Benitez,27,0,40,13
1713516784631,EDS 281,A00,507345,Daly; Alan J.,18,0,18,0
1713516785656,EDS 284,A00,507350,Daly; Alan J.,16,0,16,0
1713516786682,EDS 286,A00,507359,Fine; Sarah,18,0,18,0
1713516787708,EDS 289C,A01,507361,Daly; Alan J.,18,0,18,0
1713516788738,EDS 290,A00,507366,Hofstetter; Carolyn,15,0,15,0
1713516789764,LIGM 5A,A00,507421,Fischer-Grunski; Eva K,20,0,20,0
1713516790791,LIGM 5B,A00,507423,Fischer-Grunski; Eva K,20,0,20,0
1713516791816,LIGM 5C,A00,507425,Fischer-Grunski; Eva K,20,0,20,0
1713516792850,LIIT 5AS,A00,507427,Carnelos; Chiara,20,0,20,0
1713516793877,LIIT 5BS,A00,507430,Carnelos; Chiara,20,0,20,0
1713516794903,LIIT 5CS,A00,507432,Carnelos; Chiara,20,0,20,0
1713516795936,LISP 5A,A00,507541,Munoz Sanchez; Alicia,14,0,20,6
1713516796967,LISP 5B,A00,507671,Munoz Sanchez; Alicia,12,0,20,8
1713516797999,LISP 5C,A00,507696,Munoz Sanchez; Alicia,11,0,20,9
1713516799027,MAE 197,001,528363,Boechler; Nicholas Sebastia,9998,0,9999,1
1713516800053,MATH 197,001,523477,Kedlaya; Kiran S.,9999,0,9999,0
1713516800053,MATH 197,002,563811,Zhang; Danna,9998,0,9999,1
1713516801079,MCWP 40R,A00,518780,Staff,13,0,20,7
1713516801079,MCWP 40R,B00,518781,Staff,11,0,20,9
1713516801079,MCWP 40R,C00,518783,Staff,8,0,20,12
1713516802106,MCWP 50R,A00,518791,Staff,7,0,20,13
1713516802106,MCWP 50R,B00,518792,Staff,3,0,20,17
1713516802106,MCWP 50R,C00,518793,Staff,5,0,20,15
1713516802106,MCWP 50R,D00,518794,Staff,0,0,20,20
1713516802106,MCWP 50R,E00,518795,Staff,0,0,20,20
1713516802106,MCWP 50R,F00,518796,Staff,10,0,20,10
1713516802106,MCWP 50R,G00,518797,Staff,10,0,20,10
1713516803132,MMW 12R,A01,514034,Herbst; Matthew,1,0,16,15
1713516803132,MMW 12R,A02,514035,Herbst; Matthew,13,0,16,3
1713516804158,MMW 13R,A01,514037,Staff,0,8,16,16
1713516804158,MMW 13R,A02,514039,Staff,0,7,16,16
1713516806219,SIO 295LS,A00,523233,Staff,15,0,30,15
1713516807246,SIO 295S,A00,523232,Staff,15,0,30,15
1713516808278,SOCI 117,A01,494376,Staff,0,2,5,5
1713516809308,WES 237B,A00,494380,Staff,19,0,20,1
1713516811383,AESE 279B,A00,494370,Wade; Jon P,33,0,33,0
1713516812465,AIP 197,001,627712,Vespa; Emanuel Ignacio,9999,0,9999,0
1713516813491,ANAR 135S,A00,494369,Braswell; Geoffrey E.,0,0,0,0
1713516814521,CAT 124RS,A01,519847,Geibel; William,6,0,20,14
1713516815552,CAT 125RS,A01,515971,Geibel; William,6,0,20,14
1713516816578,CLRE 250,A00,511389,Morris; Sheldon,9996,0,9999,3
1713516817604,CLRE 251,A00,507176,Mehta; Ravindra L.,9996,0,9999,3
1713516817604,CLRE 251,B00,511410,Mehta; Ravindra L.,9998,0,9999,1
1713516818631,CLRE 252,A00,507189,Cuomo; Raphael Eduardo,9998,0,9999,1
1713516819657,CLRE 253,A00,507199,Vaida; Florin,9997,0,9999,2
1713516819657,CLRE 253,B00,507202,Vaida; Florin,9999,0,9999,0
1713516820688,CLRE 259,A00,507211,Patel; Hemal,9996,0,9999,3
1713516821715,CLRE 260,A00,507221,Cuomo; Raphael Eduardo,9999,0,9999,0
1713516822741,CLRE 297,001,507242,Cuomo; Raphael Eduardo,9999,0,9999,0
1713516823772,CSE 191,A00,516875,Minnes Kemp; Mor Mia,9999,0,9999,0
1713516824799,CSS 201S,A01,494383,Staff,35,0,35,0
1713516825826,CSS 202S,A01,494387,Staff,35,0,35,0
1713516826856,EAP 100,A00,516065,Staff,9792,0,9999,207
1713516827882,ECE 45,A01,507414,Staff,37,0,60,23
1713516828912,ECE 100,A01,507416,Baghdadchi; Saharnaz,0,0,20,20
1713516828912,ECE 100,A02,507418,Baghdadchi; Saharnaz,19,0,20,1
1713516829938,ECE 111,A01,507420,Staff,27,0,50,23
1713516830964,ECE 197,001,548057,Sievenpiper; Daniel F.,9998,0,9999,1
1713516831996,EDS 115,A00,507243,Choi; Bailey Miyeon,27,0,28,1
1713516833023,EDS 117,A01,494379,Staff,14,0,25,11
1713516834049,EDS 125,A00,507246,Hopkins; Megan Beth,27,0,30,3
1713516835079,EDS 128A,A01,507264,Fargason; Sharon Gayle,26,0,26,0
1713516836105,EDS 128B,A01,507293,Pappas; Elizabeth,30,0,30,0
1713516837131,EDS 139,A00,507294,Fargason; Sharon Gayle,30,0,30,0
1713516837131,EDS 139,B00,507313,Pappas; Elizabeth,30,0,30,0
1713516838155,EDS 201,A00,507315,Staff,18,0,30,12
1713516839186,EDS 203,A01,507317,Halter; Christopher P.,17,0,30,13
1713516840218,EDS 204R,A01,507319,Halter; Christopher P.,0,1,30,30
1713516840218,EDS 204R,B01,507331,Heinzman; Erica M.,22,0,30,8
1713516841247,EDS 206R,A00,507332,Staff,0,2,30,30
1713516841247,EDS 206R,B00,507343,Staff,23,0,30,7
1713516842273,EDS 250,A00,507344,Hemans; Patricia Ann Benitez,27,0,40,13
1713516843304,EDS 281,A00,507345,Daly; Alan J.,18,0,18,0
1713516844331,EDS 284,A00,507350,Daly; Alan J.,16,0,16,0
1713516845356,EDS 286,A00,507359,Fine; Sarah,18,0,18,0
1713516846381,EDS 289C,A01,507361,Daly; Alan J.,18,0,18,0
1713516847405,EDS 290,A00,507366,Hofstetter; Carolyn,15,0,15,0
1713516848431,LIGM 5A,A00,507421,Fischer-Grunski; Eva K,20,0,20,0
1713516849463,LIGM 5B,A00,507423,Fischer-Grunski; Eva K,20,0,20,0
1713516850494,LIGM 5C,A00,507425,Fischer-Grunski; Eva K,20,0,20,0
1713516851519,LIIT 5AS,A00,507427,Carnelos; Chiara,20,0,20,0
1713516852544,LIIT 5BS,A00,507430,Carnelos; Chiara,20,0,20,0
1713516853577,LIIT 5CS,A00,507432,Carnelos; Chiara,20,0,20,0
1713516854609,LISP 5A,A00,507541,Munoz Sanchez; Alicia,14,0,20,6
1713516855635,LISP 5B,A00,507671,Munoz Sanchez; Alicia,12,0,20,8
1713516856661,LISP 5C,A00,507696,Munoz Sanchez; Alicia,11,0,20,9
1713516857691,MAE 197,001,528363,Boechler; Nicholas Sebastia,9998,0,9999,1
1713516858725,MATH 197,001,523477,Kedlaya; Kiran S.,9999,0,9999,0
1713516858725,MATH 197,002,563811,Zhang; Danna,9998,0,9999,1
1713516859756,MCWP 40R,A00,518780,Staff,13,0,20,7
1713516859756,MCWP 40R,B00,518781,Staff,11,0,20,9
1713516859756,MCWP 40R,C00,518783,Staff,8,0,20,12
1713516860792,MCWP 50R,A00,518791,Staff,7,0,20,13
1713516860792,MCWP 50R,B00,518792,Staff,3,0,20,17
1713516860792,MCWP 50R,C00,518793,Staff,5,0,20,15
1713516860792,MCWP 50R,D00,518794,Staff,0,0,20,20
1713516860792,MCWP 50R,E00,518795,Staff,0,0,20,20
1713516860792,MCWP 50R,F00,518796,Staff,10,0,20,10
1713516860792,MCWP 50R,G00,518797,Staff,10,0,20,10
1713516861817,MMW 12R,A01,514034,Herbst; Matthew,1,0,16,15
1713516861817,MMW 12R,A02,514035,Herbst; Matthew,13,0,16,3
1713516862843,MMW 13R,A01,514037,Staff,0,8,16,16
1713516862843,MMW 13R,A02,514039,Staff,0,7,16,16
1713516864899,SIO 295LS,A00,523233,Staff,15,0,30,15
1713516865926,SIO 295S,A00,523232,Staff,15,0,30,15
1713516866953,SOCI 117,A01,494376,Staff,0,2,5,5
1713516867977,WES 237B,A00,494380,Staff,19,0,20,1
1713516870039,AESE 279B,A00,494370,Wade; Jon P,33,0,33,0
1713516871070,AIP 197,001,627712,Vespa; Emanuel Ignacio,9999,0,9999,0
1713516872100,ANAR 135S,A00,494369,Braswell; Geoffrey E.,0,0,0,0
1713516873129,CAT 124RS,A01,519847,Geibel; William,6,0,20,14
1713516874157,CAT 125RS,A01,515971,Geibel; William,6,0,20,14
1713516875188,CLRE 250,A00,511389,Morris; Sheldon,9996,0,9999,3
1713516876214,CLRE 251,A00,507176,Mehta; Ravindra L.,9996,0,9999,3
1713516876214,CLRE 251,B00,511410,Mehta; Ravindra L.,9998,0,9999,1
1713516877244,CLRE 252,A00,507189,Cuomo; Raphael Eduardo,9998,0,9999,1
1713516878271,CLRE 253,A00,507199,Vaida; Florin,9997,0,9999,2
1713516878271,CLRE 253,B00,507202,Vaida; Florin,9999,0,9999,0
1713516879301,CLRE 259,A00,507211,Patel; Hemal,9996,0,9999,3
1713516880329,CLRE 260,A00,507221,Cuomo; Raphael Eduardo,9999,0,9999,0
1713516881359,CLRE 297,001,507242,Cuomo; Raphael Eduardo,9999,0,9999,0
1713516882389,CSE 191,A00,516875,Minnes Kemp; Mor Mia,9999,0,9999,0
1713516883416,CSS 201S,A01,494383,Staff,35,0,35,0
1713516884444,CSS 202S,A01,494387,Staff,35,0,35,0
1713516885474,EAP 100,A00,516065,Staff,9792,0,9999,207
1713516886498,ECE 45,A01,507414,Staff,37,0,60,23
1713516887529,ECE 100,A01,507416,Baghdadchi; Saharnaz,0,0,20,20
1713516887529,ECE 100,A02,507418,Baghdadchi; Saharnaz,19,0,20,1
1713516888558,ECE 111,A01,507420,Staff,27,0,50,23
1713516889592,ECE 197,001,548057,Sievenpiper; Daniel F.,9998,0,9999,1
1713516890618,EDS 115,A00,507243,Choi; Bailey Miyeon,27,0,28,1
1713516891644,EDS 117,A01,494379,Staff,14,0,25,11
1713516892669,EDS 125,A00,507246,Hopkins; Megan Beth,27,0,30,3
1713516893698,EDS 128A,A01,507264,Fargason; Sharon Gayle,26,0,26,0
1713516894725,EDS 128B,A01,507293,Pappas; Elizabeth,30,0,30,0
1713516895751,EDS 139,A00,507294,Fargason; Sharon Gayle,30,0,30,0
1713516895751,EDS 139,B00,507313,Pappas; Elizabeth,30,0,30,0
1713516896776,EDS 201,A00,507315,Staff,18,0,30,12
1713516897802,EDS 203,A01,507317,Halter; Christopher P.,17,0,30,13
1713516898836,EDS 204R,A01,507319,Halter; Christopher P.,0,1,30,30
1713516898836,EDS 204R,B01,507331,Heinzman; Erica M.,22,0,30,8
1713516899865,EDS 206R,A00,507332,Staff,0,2,30,30
1713516899865,EDS 206R,B00,507343,Staff,23,0,30,7
1713516900895,EDS 250,A00,507344,Hemans; Patricia Ann Benitez,27,0,40,13
1713516901926,EDS 281,A00,507345,Daly; Alan J.,18,0,18,0
1713516902952,EDS 284,A00,507350,Daly; Alan J.,16,0,16,0
1713516903986,EDS 286,A00,507359,Fine; Sarah,18,0,18,0
1713516905012,EDS 289C,A01,507361,Daly; Alan J.,18,0,18,0
1713516906044,EDS 290,A00,507366,Hofstetter; Carolyn,15,0,15,0
1713516907076,LIGM 5A,A00,507421,Fischer-Grunski; Eva K,20,0,20,0
1713516908101,LIGM 5B,A00,507423,Fischer-Grunski; Eva K,20,0,20,0
1713516909132,LIGM 5C,A00,507425,Fischer-Grunski; Eva K,20,0,20,0
1713516910164,LIIT 5AS,A00,507427,Carnelos; Chiara,20,0,20,0
1713516911195,LIIT 5BS,A00,507430,Carnelos; Chiara,20,0,20,0
1713516912220,LIIT 5CS,A00,507432,Carnelos; Chiara,20,0,20,0
1713516913246,LISP 5A,A00,507541,Munoz Sanchez; Alicia,14,0,20,6
1713516914270,LISP 5B,A00,507671,Munoz Sanchez; Alicia,12,0,20,8
1713516915296,LISP 5C,A00,507696,Munoz Sanchez; Alicia,11,0,20,9
1713516916374,MAE 197,001,528363,Boechler; Nicholas Sebastia,9998,0,9999,1
1713516917405,MATH 197,001,523477,Kedlaya; Kiran S.,9999,0,9999,0
1713516917405,MATH 197,002,563811,Zhang; Danna,9998,0,9999,1
1713516918436,MCWP 40R,A00,518780,Staff,13,0,20,7
1713516918436,MCWP 40R,B00,518781,Staff,11,0,20,9
1713516918436,MCWP 40R,C00,518783,Staff,8,0,20,12
1713516919462,MCWP 50R,A00,518791,Staff,7,0,20,13
1713516919462,MCWP 50R,B00,518792,Staff,3,0,20,17
1713516919462,MCWP 50R,C00,518793,Staff,5,0,20,15
1713516919462,MCWP 50R,D00,518794,Staff,0,0,20,20
1713516919462,MCWP 50R,E00,518795,Staff,0,0,20,20
1713516919462,MCWP 50R,F00,518796,Staff,10,0,20,10
1713516919462,MCWP 50R,G00,518797,Staff,10,0,20,10
1713516920489,MMW 12R,A01,514034,Herbst; Matthew,1,0,16,15
1713516920489,MMW 12R,A02,514035,Herbst; Matthew,13,0,16,3
1713516921515,MMW 13R,A01,514037,Staff,0,8,16,16
1713516921515,MMW 13R,A02,514039,Staff,0,7,16,16
1713516923566,SIO 295LS,A00,523233,Staff,15,0,30,15
1713516924590,SIO 295S,A00,523232,Staff,15,0,30,15
1713516925620,SOCI 117,A01,494376,Staff,0,2,5,5
1713516926648,WES 237B,A00,494380,Staff,19,0,20,1
1713516928725,AESE 279B,A00,494370,Wade; Jon P,33,0,33,0
1713516929751,AIP 197,001,627712,Vespa; Emanuel Ignacio,9999,0,9999,0
1713516930775,ANAR 135S,A00,494369,Braswell; Geoffrey E.,0,0,0,0
1713516931806,CAT 124RS,A01,519847,Geibel; William,6,0,20,14
1713516932831,CAT 125RS,A01,515971,Geibel; William,6,0,20,14
1713516933868,CLRE 250,A00,511389,Morris; Sheldon,9996,0,9999,3
1713516934897,CLRE 251,A00,507176,Mehta; Ravindra L.,9996,0,9999,3
1713516934897,CLRE 251,B00,511410,Mehta; Ravindra L.,9998,0,9999,1
1713516935932,CLRE 252,A00,507189,Cuomo; Raphael Eduardo,9998,0,9999,1
1713516936958,CLRE 253,A00,507199,Vaida; Florin,9997,0,9999,2
1713516936958,CLRE 253,B00,507202,Vaida; Florin,9999,0,9999,0
1713516937984,CLRE 259,A00,507211,Patel; Hemal,9996,0,9999,3
1713516939015,CLRE 260,A00,507221,Cuomo; Raphael Eduardo,9999,0,9999,0
1713516940046,CLRE 297,001,507242,Cuomo; Raphael Eduardo,9999,0,9999,0
1713516941072,CSE 191,A00,516875,Minnes Kemp; Mor Mia,9999,0,9999,0
1713516942110,CSS 201S,A01,494383,Staff,35,0,35,0
1713516943137,CSS 202S,A01,494387,Staff,35,0,35,0
1713516944168,EAP 100,A00,516065,Staff,9792,0,9999,207
1713516945200,ECE 45,A01,507414,Staff,37,0,60,23
1713516946231,ECE 100,A01,507416,Baghdadchi; Saharnaz,0,0,20,20
1713516946231,ECE 100,A02,507418,Baghdadchi; Saharnaz,19,0,20,1
1713516947263,ECE 111,A01,507420,Staff,27,0,50,23
1713516948295,ECE 197,001,548057,Sievenpiper; Daniel F.,9998,0,9999,1
1713516949321,EDS 115,A00,507243,Choi; Bailey Miyeon,27,0,28,1
1713516950349,EDS 117,A01,494379,Staff,14,0,25,11
1713516951379,EDS 125,A00,507246,Hopkins; Megan Beth,27,0,30,3
1713516952407,EDS 128A,A01,507264,Fargason; Sharon Gayle,26,0,26,0
1713516953434,EDS 128B,A01,507293,Pappas; Elizabeth,30,0,30,0
1713516954462,EDS 139,A00,507294,Fargason; Sharon Gayle,30,0,30,0
1713516954462,EDS 139,B00,507313,Pappas; Elizabeth,30,0,30,0
1713516955487,EDS 201,A00,507315,Staff,18,0,30,12
1713516956521,EDS 203,A01,507317,Halter; Christopher P.,17,0,30,13
1713516957555,EDS 204R,A01,507319,Halter; Christopher P.,0,1,30,30
1713516957555,EDS 204R,B01,507331,Heinzman; Erica M.,22,0,30,8
1713516958594,EDS 206R,A00,507332,Staff,0,2,30,30
1713516958594,EDS 206R,B00,507343,Staff,23,0,30,7
1713516959621,EDS 250,A00,507344,Hemans; Patricia Ann Benitez,27,0,40,13
1713516960649,EDS 281,A00,507345,Daly; Alan J.,18,0,18,0
1713516961677,EDS 284,A00,507350,Daly; Alan J.,16,0,16,0
1713516962709,EDS 286,A00,507359,Fine; Sarah,18,0,18,0
1713516963740,EDS 289C,A01,507361,Daly; Alan J.,18,0,18,0
1713516964772,EDS 290,A00,507366,Hofstetter; Carolyn,15,0,15,0
1713516965808,LIGM 5A,A00,507421,Fischer-Grunski; Eva K,20,0,20,0
1713516966841,LIGM 5B,A00,507423,Fischer-Grunski; Eva K,20,0,20,0
1713516967869,LIGM 5C,A00,507425,Fischer-Grunski; Eva K,20,0,20,0
1713516968895,LIIT 5AS,A00,507427,Carnelos; Chiara,20,0,20,0
1713516969922,LIIT 5BS,A00,507430,Carnelos; Chiara,20,0,20,0
1713516970956,LIIT 5CS,A00,507432,Carnelos; Chiara,20,0,20,0
1713516971983,LISP 5A,A00,507541,Munoz Sanchez; Alicia,14,0,20,6
1713516973009,LISP 5B,A00,507671,Munoz Sanchez; Alicia,12,0,20,8
1713516974036,LISP 5C,A00,507696,Munoz Sanchez; Alicia,11,0,20,9
1713516975065,MAE 197,001,528363,Boechler; Nicholas Sebastia,9998,0,9999,1
1713516976090,MATH 197,001,523477,Kedlaya; Kiran S.,9999,0,9999,0
1713516976090,MATH 197,002,563811,Zhang; Danna,9998,0,9999,1
1713516977117,MCWP 40R,A00,518780,Staff,13,0,20,7
1713516977117,MCWP 40R,B00,518781,Staff,11,0,20,9
1713516977117,MCWP 40R,C00,518783,Staff,8,0,20,12
1713516978148,MCWP 50R,A00,518791,Staff,7,0,20,13
1713516978148,MCWP 50R,B00,518792,Staff,3,0,20,17
1713516978148,MCWP 50R,C00,518793,Staff,5,0,20,15
1713516978148,MCWP 50R,D00,518794,Staff,0,0,20,20
1713516978148,MCWP 50R,E00,518795,Staff,0,0,20,20
1713516978148,MCWP 50R,F00,518796,Staff,10,0,20,10
1713516978148,MCWP 50R,G00,518797,Staff,10,0,20,10
1713516979177,MMW 12R,A01,514034,Herbst; Matthew,1,0,16,15
1713516979177,MMW 12R,A02,514035,Herbst; Matthew,13,0,16,3
1713516980207,MMW 13R,A01,514037,Staff,0,8,16,16
1713516980207,MMW 13R,A02,514039,Staff,0,7,16,16
1713516982268,SIO 295LS,A00,523233,Staff,15,0,30,15
1713516983297,SIO 295S,A00,523232,Staff,15,0,30,15
1713516984322,SOCI 117,A01,494376,Staff,0,2,5,5
1713516985346,WES 237B,A00,494380,Staff,19,0,20,1
1713516987423,AESE 279B,A00,494370,Wade; Jon P,33,0,33,0
1713516988449,AIP 197,001,627712,Vespa; Emanuel Ignacio,9999,0,9999,0
1713516989473,ANAR 135S,A00,494369,Braswell; Geoffrey E.,0,0,0,0
1713516990505,CAT 124RS,A01,519847,Geibel; William,6,0,20,14
1713516991743,CAT 125RS,A01,515971,Geibel; William,6,0,20,14
1713516992776,CLRE 250,A00,511389,Morris; Sheldon,9996,0,9999,3
1713516993811,CLRE 251,A00,507176,Mehta; Ravindra L.,9996,0,9999,3
1713516993811,CLRE 251,B00,511410,Mehta; Ravindra L.,9998,0,9999,1
1713516994837,CLRE 252,A00,507189,Cuomo; Raphael Eduardo,9998,0,9999,1
1713516995869,CLRE 253,A00,507199,Vaida; Florin,9997,0,9999,2
1713516995869,CLRE 253,B00,507202,Vaida; Florin,9999,0,9999,0
1713516996897,CLRE 259,A00,507211,Patel; Hemal,9996,0,9999,3
1713516997931,CLRE 260,A00,507221,Cuomo; Raphael Eduardo,9999,0,9999,0
1713516998957,CLRE 297,001,507242,Cuomo; Raphael Eduardo,9999,0,9999,0
1713516999983,CSE 191,A00,516875,Minnes Kemp; Mor Mia,9999,0,9999,0
1713517001009,CSS 201S,A01,494383,Staff,35,0,35,0
1713517002038,CSS 202S,A01,494387,Staff,35,0,35,0
1713517003070,EAP 100,A00,516065,Staff,9792,0,9999,207
1713517004097,ECE 45,A01,507414,Staff,37,0,60,23
1713517005142,ECE 100,A01,507416,Baghdadchi; Saharnaz,0,0,20,20
1713517005142,ECE 100,A02,507418,Baghdadchi; Saharnaz,19,0,20,1
1713517006167,ECE 111,A01,507420,Staff,27,0,50,23
1713517007193,ECE 197,001,548057,Sievenpiper; Daniel F.,9998,0,9999,1
1713517008220,EDS 115,A00,507243,Choi; Bailey Miyeon,27,0,28,1
1713517009247,EDS 117,A01,494379,Staff,14,0,25,11
1713517010296,EDS 125,A00,507246,Hopkins; Megan Beth,27,0,30,3
1713517011329,EDS 128A,A01,507264,Fargason; Sharon Gayle,26,0,26,0
1713517012360,EDS 128B,A01,507293,Pappas; Elizabeth,30,0,30,0
1713517013396,EDS 139,A00,507294,Fargason; Sharon Gayle,30,0,30,0
1713517013396,EDS 139,B00,507313,Pappas; Elizabeth,30,0,30,0
1713517014420,EDS 201,A00,507315,Staff,18,0,30,12
1713517015450,EDS 203,A01,507317,Halter; Christopher P.,17,0,30,13
1713517016476,EDS 204R,A01,507319,Halter; Christopher P.,0,1,30,30
1713517016476,EDS 204R,B01,507331,Heinzman; Erica M.,22,0,30,8
1713517017505,EDS 206R,A00,507332,Staff,0,2,30,30
1713517017505,EDS 206R,B00,507343,Staff,23,0,30,7
1713517018536,EDS 250,A00,507344,Hemans; Patricia Ann Benitez,27,0,40,13
1713517019560,EDS 281,A00,507345,Daly; Alan J.,18,0,18,0
1713517020652,EDS 284,A00,507350,Daly; Alan J.,16,0,16,0
1713517021681,EDS 286,A00,507359,Fine; Sarah,18,0,18,0
1713517022707,EDS 289C,A01,507361,Daly; Alan J.,18,0,18,0
1713517023732,EDS 290,A00,507366,Hofstetter; Carolyn,15,0,15,0
1713517024759,LIGM 5A,A00,507421,Fischer-Grunski; Eva K,20,0,20,0
1713517025792,LIGM 5B,A00,507423,Fischer-Grunski; Eva K,20,0,20,0
1713517026819,LIGM 5C,A00,507425,Fischer-Grunski; Eva K,20,0,20,0
1713517027845,LIIT 5AS,A00,507427,Carnelos; Chiara,20,0,20,0
1713517028872,LIIT 5BS,A00,507430,Carnelos; Chiara,20,0,20,0
1713517029899,LIIT 5CS,A00,507432,Carnelos; Chiara,20,0,20,0
1713517030923,LISP 5A,A00,507541,Munoz Sanchez; Alicia,14,0,20,6
1713517031949,LISP 5B,A00,507671,Munoz Sanchez; Alicia,12,0,20,8
1713517032975,LISP 5C,A00,507696,Munoz Sanchez; Alicia,11,0,20,9
1713517034001,MAE 197,001,528363,Boechler; Nicholas Sebastia,9998,0,9999,1
1713517035031,MATH 197,001,523477,Kedlaya; Kiran S.,9999,0,9999,0
1713517035031,MATH 197,002,563811,Zhang; Danna,9998,0,9999,1
1713517036061,MCWP 40R,A00,518780,Staff,13,0,20,7
1713517036061,MCWP 40R,B00,518781,Staff,11,0,20,9
1713517036061,MCWP 40R,C00,518783,Staff,8,0,20,12
1713517037088,MCWP 50R,A00,518791,Staff,7,0,20,13
1713517037088,MCWP 50R,B00,518792,Staff,3,0,20,17
1713517037088,MCWP 50R,C00,518793,Staff,5,0,20,15
1713517037088,MCWP 50R,D00,518794,Staff,0,0,20,20
1713517037088,MCWP 50R,E00,518795,Staff,0,0,20,20
1713517037088,MCWP 50R,F00,518796,Staff,10,0,20,10
1713517037088,MCWP 50R,G00,518797,Staff,10,0,20,10
1713517038114,MMW 12R,A01,514034,Herbst; Matthew,1,0,16,15
1713517038114,MMW 12R,A02,514035,Herbst; Matthew,13,0,16,3
1713517039141,MMW 13R,A01,514037,Staff,0,8,16,16
1713517039141,MMW 13R,A02,514039,Staff,0,7,16,16
1713517041194,SIO 295LS,A00,523233,Staff,15,0,30,15
1713517042220,SIO 295S,A00,523232,Staff,15,0,30,15
1713517043262,SOCI 117,A01,494376,Staff,0,2,5,5
1713517044292,WES 237B,A00,494380,Staff,19,0,20,1
1713517046349,AESE 279B,A00,494370,Wade; Jon P,33,0,33,0
1713517047375,AIP 197,001,627712,Vespa; Emanuel Ignacio,9999,0,9999,0
1713517048404,ANAR 135S,A00,494369,Braswell; Geoffrey E.,0,0,0,0
1713517049441,CAT 124RS,A01,519847,Geibel; William,6,0,20,14
1713517050465,CAT 125RS,A01,515971,Geibel; William,6,0,20,14
1713517051496,CLRE 250,A00,511389,Morris; Sheldon,9996,0,9999,3
1713517052523,CLRE 251,A00,507176,Mehta; Ravindra L.,9996,0,9999,3
1713517052523,CLRE 251,B00,511410,Mehta; Ravindra L.,9998,0,9999,1
1713517053549,CLRE 252,A00,507189,Cuomo; Raphael Eduardo,9998,0,9999,1
1713517054576,CLRE 253,A00,507199,Vaida; Florin,9997,0,9999,2
1713517054576,CLRE 253,B00,507202,Vaida; Florin,9999,0,9999,0
1713517055601,CLRE 259,A00,507211,Patel; Hemal,9996,0,9999,3
1713517056627,CLRE 260,A00,507221,Cuomo; Raphael Eduardo,9999,0,9999,0
1713517057651,CLRE 297,001,507242,Cuomo; Raphael Eduardo,9999,0,9999,0
1713517058680,CSE 191,A00,516875,Minnes Kemp; Mor Mia,9999,0,9999,0
1713517059708,CSS 201S,A01,494383,Staff,35,0,35,0
1713517060738,CSS 202S,A01,494387,Staff,35,0,35,0
1713517061766,EAP 100,A00,516065,Staff,9792,0,9999,207
1713517062793,ECE 45,A01,507414,Staff,37,0,60,23
1713517063819,ECE 100,A01,507416,Baghdadchi; Saharnaz,0,0,20,20
1713517063819,ECE 100,A02,507418,Baghdadchi; Saharnaz,19,0,20,1
1713517064844,ECE 111,A01,507420,Staff,27,0,50,23
1713517065870,ECE 197,001,548057,Sievenpiper; Daniel F.,9998,0,9999,1
1713517066896,EDS 115,A00,507243,Choi; Bailey Miyeon,27,0,28,1
1713517067926,EDS 117,A01,494379,Staff,14,0,25,11
1713517068951,EDS 125,A00,507246,Hopkins; Megan Beth,27,0,30,3
1713517069977,EDS 128A,A01,507264,Fargason; Sharon Gayle,26,0,26,0
1713517071002,EDS 128B,A01,507293,Pappas; Elizabeth,30,0,30,0
1713517072028,EDS 139,A00,507294,Fargason; Sharon Gayle,30,0,30,0
1713517072028,EDS 139,B00,507313,Pappas; Elizabeth,30,0,30,0
1713517073053,EDS 201,A00,507315,Staff,18,0,30,12
1713517074083,EDS 203,A01,507317,Halter; Christopher P.,17,0,30,13
1713517075113,EDS 204R,A01,507319,Halter; Christopher P.,0,1,30,30
1713517075113,EDS 204R,B01,507331,Heinzman; Erica M.,22,0,30,8
1713517076142,EDS 206R,A00,507332,Staff,0,2,30,30
1713517076142,EDS 206R,B00,507343,Staff,23,0,30,7
1713517077168,EDS 250,A00,507344,Hemans; Patricia Ann Benitez,27,0,40,13
1713517078198,EDS 281,A00,507345,Daly; Alan J.,18,0,18,0
1713517079223,EDS 284,A00,507350,Daly; Alan J.,16,0,16,0
1713517080254,EDS 286,A00,507359,Fine; Sarah,18,0,18,0
1713517081280,EDS 289C,A01,507361,Daly; Alan J.,18,0,18,0
1713517082306,EDS 290,A00,507366,Hofstetter; Carolyn,15,0,15,0
1713517083337,LIGM 5A,A00,507421,Fischer-Grunski; Eva K,20,0,20,0
1713517084362,LIGM 5B,A00,507423,Fischer-Grunski; Eva K,20,0,20,0
1713517085393,LIGM 5C,A00,507425,Fischer-Grunski; Eva K,20,0,20,0
1713517086420,LIIT 5AS,A00,507427,Carnelos; Chiara,20,0,20,0
1713517087446,LIIT 5BS,A00,507430,Carnelos; Chiara,20,0,20,0
1713517088472,LIIT 5CS,A00,507432,Carnelos; Chiara,20,0,20,0
1713517089506,LISP 5A,A00,507541,Munoz Sanchez; Alicia,14,0,20,6
1713517090533,LISP 5B,A00,507671,Munoz Sanchez; Alicia,12,0,20,8
1713517091559,LISP 5C,A00,507696,Munoz Sanchez; Alicia,11,0,20,9
1713517092585,MAE 197,001,528363,Boechler; Nicholas Sebastia,9998,0,9999,1
1713517093612,MATH 197,001,523477,Kedlaya; Kiran S.,9999,0,9999,0
1713517093612,MATH 197,002,563811,Zhang; Danna,9998,0,9999,1
1713517094642,MCWP 40R,A00,518780,Staff,13,0,20,7
1713517094642,MCWP 40R,B00,518781,Staff,11,0,20,9
1713517094642,MCWP 40R,C00,518783,Staff,8,0,20,12
1713517095670,MCWP 50R,A00,518791,Staff,7,0,20,13
1713517095670,MCWP 50R,B00,518792,Staff,3,0,20,17
1713517095670,MCWP 50R,C00,518793,Staff,5,0,20,15
1713517095670,MCWP 50R,D00,518794,Staff,0,0,20,20
1713517095670,MCWP 50R,E00,518795,Staff,0,0,20,20
1713517095670,MCWP 50R,F00,518796,Staff,10,0,20,10
1713517095670,MCWP 50R,G00,518797,Staff,10,0,20,10
1713517096700,MMW 12R,A01,514034,Herbst; Matthew,1,0,16,15
1713517096700,MMW 12R,A02,514035,Herbst; Matthew,13,0,16,3
1713517097729,MMW 13R,A01,514037,Staff,0,8,16,16
1713517097729,MMW 13R,A02,514039,Staff,0,7,16,16
1713517099784,SIO 295LS,A00,523233,Staff,15,0,30,15
1713517100816,SIO 295S,A00,523232,Staff,15,0,30,15
1713517101850,SOCI 117,A01,494376,Staff,0,2,5,5
1713517102880,WES 237B,A00,494380,Staff,19,0,20,1
1713517104962,AESE 279B,A00,494370,Wade; Jon P,33,0,33,0
1713517105991,AIP 197,001,627712,Vespa; Emanuel Ignacio,9999,0,9999,0
1713517107023,ANAR 135S,A00,494369,Braswell; Geoffrey E.,0,0,0,0
1713517108049,CAT 124RS,A01,519847,Geibel; William,6,0,20,14
1713517109075,CAT 125RS,A01,515971,Geibel; William,6,0,20,14
1713517110101,CLRE 250,A00,511389,Morris; Sheldon,9996,0,9999,3
1713517111133,CLRE 251,A00,507176,Mehta; Ravindra L.,9996,0,9999,3
1713517111133,CLRE 251,B00,511410,Mehta; Ravindra L.,9998,0,9999,1
1713517112160,CLRE 252,A00,507189,Cuomo; Raphael Eduardo,9998,0,9999,1
1713517113192,CLRE 253,A00,507199,Vaida; Florin,9997,0,9999,2
1713517113192,CLRE 253,B00,507202,Vaida; Florin,9999,0,9999,0
1713517114216,CLRE 259,A00,507211,Patel; Hemal,9996,0,9999,3
1713517115245,CLRE 260,A00,507221,Cuomo; Raphael Eduardo,9999,0,9999,0
1713517116271,CLRE 297,001,507242,Cuomo; Raphael Eduardo,9999,0,9999,0
1713517117301,CSE 191,A00,516875,Minnes Kemp; Mor Mia,9999,0,9999,0
1713517118327,CSS 201S,A01,494383,Staff,35,0,35,0
1713517119354,CSS 202S,A01,494387,Staff,35,0,35,0
1713517120379,EAP 100,A00,516065,Staff,9792,0,9999,207
1713517121409,ECE 45,A01,507414,Staff,37,0,60,23
1713517122438,ECE 100,A01,507416,Baghdadchi; Saharnaz,0,0,20,20
1713517122438,ECE 100,A02,507418,Baghdadchi; Saharnaz,19,0,20,1
1713517123464,ECE 111,A01,507420,Staff,27,0,50,23
1713517124548,ECE 197,001,548057,Sievenpiper; Daniel F.,9998,0,9999,1
1713517125578,EDS 115,A00,507243,Choi; Bailey Miyeon,27,0,28,1
1713517126604,EDS 117,A01,494379,Staff,14,0,25,11
1713517127633,EDS 125,A00,507246,Hopkins; Megan Beth,27,0,30,3
1713517128660,EDS 128A,A01,507264,Fargason; Sharon Gayle,26,0,26,0
1713517129686,EDS 128B,A01,507293,Pappas; Elizabeth,30,0,30,0
1713517130712,EDS 139,A00,507294,Fargason; Sharon Gayle,30,0,30,0
1713517130712,EDS 139,B00,507313,Pappas; Elizabeth,30,0,30,0
1713517131738,EDS 201,A00,507315,Staff,18,0,30,12
1713517132768,EDS 203,A01,507317,Halter; Christopher P.,17,0,30,13
1713517133796,EDS 204R,A01,507319,Halter; Christopher P.,0,1,30,30
1713517133796,EDS 204R,B01,507331,Heinzman; Erica M.,22,0,30,8
1713517134824,EDS 206R,A00,507332,Staff,0,2,30,30
1713517134824,EDS 206R,B00,507343,Staff,23,0,30,7
1713517135850,EDS 250,A00,507344,Hemans; Patricia Ann Benitez,27,0,40,13
1713517136880,EDS 281,A00,507345,Daly; Alan J.,18,0,18,0
1713517137909,EDS 284,A00,507350,Daly; Alan J.,16,0,16,0
1713517138935,EDS 286,A00,507359,Fine; Sarah,18,0,18,0
1713517139964,EDS 289C,A01,507361,Daly; Alan J.,18,0,18,0
1713517140990,EDS 290,A00,507366,Hofstetter; Carolyn,15,0,15,0
1713517142018,LIGM 5A,A00,507421,Fischer-Grunski; Eva K,20,0,20,0
1713517143045,LIGM 5B,A00,507423,Fischer-Grunski; Eva K,20,0,20,0
1713517144072,LIGM 5C,A00,507425,Fischer-Grunski; Eva K,20,0,20,0
1713517145103,LIIT 5AS,A00,507427,Carnelos; Chiara,20,0,20,0
1713517146130,LIIT 5BS,A00,507430,Carnelos; Chiara,20,0,20,0
1713517147158,LIIT 5CS,A00,507432,Carnelos; Chiara,20,0,20,0
1713517148189,LISP 5A,A00,507541,Munoz Sanchez; Alicia,14,0,20,6
1713517149215,LISP 5B,A00,507671,Munoz Sanchez; Alicia,12,0,20,8
1713517150241,LISP 5C,A00,507696,Munoz Sanchez; Alicia,11,0,20,9
1713517151267,MAE 197,001,528363,Boechler; Nicholas Sebastia,9998,0,9999,1
1713517152293,MATH 197,001,523477,Kedlaya; Kiran S.,9999,0,9999,0
1713517152293,MATH 197,002,563811,Zhang; Danna,9998,0,9999,1
1713517153318,MCWP 40R,A00,518780,Staff,13,0,20,7
1713517153318,MCWP 40R,B00,518781,Staff,11,0,20,9
1713517153318,MCWP 40R,C00,518783,Staff,8,0,20,12
1713517154351,MCWP 50R,A00,518791,Staff,7,0,20,13
1713517154351,MCWP 50R,B00,518792,Staff,3,0,20,17
1713517154351,MCWP 50R,C00,518793,Staff,5,0,20,15
1713517154351,MCWP 50R,D00,518794,Staff,0,0,20,20
1713517154351,MCWP 50R,E00,518795,Staff,0,0,20,20
1713517154351,MCWP 50R,F00,518796,Staff,10,0,20,10
1713517154351,MCWP 50R,G00,518797,Staff,10,0,20,10
1713517155378,MMW 12R,A01,514034,Herbst; Matthew,1,0,16,15
1713517155378,MMW 12R,A02,514035,Herbst; Matthew,13,0,16,3
1713517156407,MMW 13R,A01,514037,Staff,0,8,16,16
1713517156407,MMW 13R,A02,514039,Staff,0,7,16,16
1713517158459,SIO 295LS,A00,523233,Staff,15,0,30,15
1713517159485,SIO 295S,A00,523232,Staff,15,0,30,15
1713517160512,SOCI 117,A01,494376,Staff,0,2,5,5
1713517161543,WES 237B,A00,494380,Staff,19,0,20,1
1713517163619,AESE 279B,A00,494370,Wade; Jon P,33,0,33,0
1713517164645,AIP 197,001,627712,Vespa; Emanuel Ignacio,9999,0,9999,0
1713517165673,ANAR 135S,A00,494369,Braswell; Geoffrey E.,0,0,0,0
1713517166700,CAT 124RS,A01,519847,Geibel; William,6,0,20,14
1713517167729,CAT 125RS,A01,515971,Geibel; William,6,0,20,14
1713517168754,CLRE 250,A00,511389,Morris; Sheldon,9996,0,9999,3
1713517169782,CLRE 251,A00,507176,Mehta; Ravindra L.,9996,0,9999,3
1713517169782,CLRE 251,B00,511410,Mehta; Ravindra L.,9998,0,9999,1
1713517170812,CLRE 252,A00,507189,Cuomo; Raphael Eduardo,9998,0,9999,1
1713517171837,CLRE 253,A00,507199,Vaida; Florin,9997,0,9999,2
1713517171837,CLRE 253,B00,507202,Vaida; Florin,9999,0,9999,0
1713517172867,CLRE 259,A00,507211,Patel; Hemal,9996,0,9999,3
1713517173893,CLRE 260,A00,507221,Cuomo; Raphael Eduardo,9999,0,9999,0
1713517174918,CLRE 297,001,507242,Cuomo; Raphael Eduardo,9999,0,9999,0
1713517175945,CSE 191,A00,516875,Minnes Kemp; Mor Mia,9999,0,9999,0
1713517176972,CSS 201S,A01,494383,Staff,35,0,35,0
1713517178004,CSS 202S,A01,494387,Staff,35,0,35,0
1713517179033,EAP 100,A00,516065,Staff,9792,0,9999,207
1713517180064,ECE 45,A01,507414,Staff,37,0,60,23
1713517181091,ECE 100,A01,507416,Baghdadchi; Saharnaz,0,0,20,20
1713517181091,ECE 100,A02,507418,Baghdadchi; Saharnaz,19,0,20,1
1713517182119,ECE 111,A01,507420,Staff,27,0,50,23
1713517183145,ECE 197,001,548057,Sievenpiper; Daniel F.,9998,0,9999,1
1713517184172,EDS 115,A00,507243,Choi; Bailey Miyeon,27,0,28,1
1713517185198,EDS 117,A01,494379,Staff,14,0,25,11
1713517186228,EDS 125,A00,507246,Hopkins; Megan Beth,27,0,30,3
1713517187259,EDS 128A,A01,507264,Fargason; Sharon Gayle,26,0,26,0
1713517188285,EDS 128B,A01,507293,Pappas; Elizabeth,30,0,30,0
1713517189312,EDS 139,A00,507294,Fargason; Sharon Gayle,30,0,30,0
1713517189312,EDS 139,B00,507313,Pappas; Elizabeth,30,0,30,0
1713517190341,EDS 201,A00,507315,Staff,18,0,30,12
1713517191367,EDS 203,A01,507317,Halter; Christopher P.,17,0,30,13
1713517192400,EDS 204R,A01,507319,Halter; Christopher P.,0,1,30,30
1713517192400,EDS 204R,B01,507331,Heinzman; Erica M.,22,0,30,8
1713517193429,EDS 206R,A00,507332,Staff,0,2,30,30
1713517193429,EDS 206R,B00,507343,Staff,23,0,30,7
1713517194454,EDS 250,A00,507344,Hemans; Patricia Ann Benitez,27,0,40,13
1713517195482,EDS 281,A00,507345,Daly; Alan J.,18,0,18,0
1713517196509,EDS 284,A00,507350,Daly; Alan J.,16,0,16,0
1713517197535,EDS 286,A00,507359,Fine; Sarah,18,0,18,0
1713517198564,EDS 289C,A01,507361,Daly; Alan J.,18,0,18,0
1713517199593,EDS 290,A00,507366,Hofstetter; Carolyn,15,0,15,0
1713517200618,LIGM 5A,A00,507421,Fischer-Grunski; Eva K,20,0,20,0
1713517201652,LIGM 5B,A00,507423,Fischer-Grunski; Eva K,20,0,20,0
1713517202683,LIGM 5C,A00,507425,Fischer-Grunski; Eva K,20,0,20,0
1713517203710,LIIT 5AS,A00,507427,Carnelos; Chiara,20,0,20,0
1713517204734,LIIT 5BS,A00,507430,Carnelos; Chiara,20,0,20,0
1713517205763,LIIT 5CS,A00,507432,Carnelos; Chiara,20,0,20,0
1713517206797,LISP 5A,A00,507541,Munoz Sanchez; Alicia,14,0,20,6
1713517207827,LISP 5B,A00,507671,Munoz Sanchez; Alicia,12,0,20,8
1713517208858,LISP 5C,A00,507696,Munoz Sanchez; Alicia,11,0,20,9
1713517209883,MAE 197,001,528363,Boechler; Nicholas Sebastia,9998,0,9999,1
1713517210915,MATH 197,001,523477,Kedlaya; Kiran S.,9999,0,9999,0
1713517210915,MATH 197,002,563811,Zhang; Danna,9998,0,9999,1
1713517211941,MCWP 40R,A00,518780,Staff,13,0,20,7
1713517211941,MCWP 40R,B00,518781,Staff,11,0,20,9
1713517211941,MCWP 40R,C00,518783,Staff,8,0,20,12
1713517212968,MCWP 50R,A00,518791,Staff,7,0,20,13
1713517212968,MCWP 50R,B00,518792,Staff,3,0,20,17
1713517212968,MCWP 50R,C00,518793,Staff,5,0,20,15
1713517212968,MCWP 50R,D00,518794,Staff,0,0,20,20
1713517212968,MCWP 50R,E00,518795,Staff,0,0,20,20
1713517212968,MCWP 50R,F00,518796,Staff,10,0,20,10
1713517212968,MCWP 50R,G00,518797,Staff,10,0,20,10
1713517214004,MMW 12R,A01,514034,Herbst; Matthew,1,0,16,15
1713517214004,MMW 12R,A02,514035,Herbst; Matthew,13,0,16,3
1713517215031,MMW 13R,A01,514037,Staff,0,8,16,16
1713517215031,MMW 13R,A02,514039,Staff,0,7,16,16
1713517217092,SIO 295LS,A00,523233,Staff,15,0,30,15
1713517218117,SIO 295S,A00,523232,Staff,15,0,30,15
1713517219142,SOCI 117,A01,494376,Staff,0,2,5,5
1713517220168,WES 237B,A00,494380,Staff,19,0,20,1
1713517222263,AESE 279B,A00,494370,Wade; Jon P,33,0,33,0
1713517223290,AIP 197,001,627712,Vespa; Emanuel Ignacio,9999,0,9999,0
1713517224316,ANAR 135S,A00,494369,Braswell; Geoffrey E.,0,0,0,0
1713517225346,CAT 124RS,A01,519847,Geibel; William,6,0,20,14
1713517226377,CAT 125RS,A01,515971,Geibel; William,6,0,20,14
1713517227404,CLRE 250,A00,511389,Morris; Sheldon,9996,0,9999,3
1713517228486,CLRE 251,A00,507176,Mehta; Ravindra L.,9996,0,9999,3
1713517228486,CLRE 251,B00,511410,Mehta; Ravindra L.,9998,0,9999,1
1713517229513,CLRE 252,A00,507189,Cuomo; Raphael Eduardo,9998,0,9999,1
1713517230541,CLRE 253,A00,507199,Vaida; Florin,9997,0,9999,2
1713517230541,CLRE 253,B00,507202,Vaida; Florin,9999,0,9999,0
1713517231568,CLRE 259,A00,507211,Patel; Hemal,9996,0,9999,3
1713517232598,CLRE 260,A00,507221,Cuomo; Raphael Eduardo,9999,0,9999,0
1713517233628,CLRE 297,001,507242,Cuomo; Raphael Eduardo,9999,0,9999,0
1713517234652,CSE 191,A00,516875,Minnes Kemp; Mor Mia,9999,0,9999,0
1713517235677,CSS 201S,A01,494383,Staff,35,0,35,0
1713517236703,CSS 202S,A01,494387,Staff,35,0,35,0
1713517237728,EAP 100,A00,516065,Staff,9792,0,9999,207
1713517238758,ECE 45,A01,507414,Staff,37,0,60,23
1713517239799,ECE 100,A01,507416,Baghdadchi; Saharnaz,0,0,20,20
1713517239799,ECE 100,A02,507418,Baghdadchi; Saharnaz,19,0,20,1
1713517240826,ECE 111,A01,507420,Staff,27,0,50,23
1713517241852,ECE 197,001,548057,Sievenpiper; Daniel F.,9998,0,9999,1
1713517242882,EDS 115,A00,507243,Choi; Bailey Miyeon,27,0,28,1
1713517243909,EDS 117,A01,494379,Staff,14,0,25,11
1713517244940,EDS 125,A00,507246,Hopkins; Megan Beth,27,0,30,3
1713517245966,EDS 128A,A01,507264,Fargason; Sharon Gayle,26,0,26,0
1713517246998,EDS 128B,A01,507293,Pappas; Elizabeth,30,0,30,0
1713517248024,EDS 139,A00,507294,Fargason; Sharon Gayle,30,0,30,0
1713517248024,EDS 139,B00,507313,Pappas; Elizabeth,30,0,30,0
1713517249055,EDS 201,A00,507315,Staff,18,0,30,12
1713517250082,EDS 203,A01,507317,Halter; Christopher P.,17,0,30,13
1713517251116,EDS 204R,A01,507319,Halter; Christopher P.,0,1,30,30
1713517251116,EDS 204R,B01,507331,Heinzman; Erica M.,22,0,30,8
1713517252142,EDS 206R,A00,507332,Staff,0,2,30,30
1713517252142,EDS 206R,B00,507343,Staff,23,0,30,7
1713517253172,EDS 250,A00,507344,Hemans; Patricia Ann Benitez,27,0,40,13
1713517254204,EDS 281,A00,507345,Daly; Alan J.,18,0,18,0
1713517255229,EDS 284,A00,507350,Daly; Alan J.,16,0,16,0
1713517256255,EDS 286,A00,507359,Fine; Sarah,18,0,18,0
1713517257280,EDS 289C,A01,507361,Daly; Alan J.,18,0,18,0
1713517258306,EDS 290,A00,507366,Hofstetter; Carolyn,15,0,15,0
1713517259333,LIGM 5A,A00,507421,Fischer-Grunski; Eva K,20,0,20,0
1713517260360,LIGM 5B,A00,507423,Fischer-Grunski; Eva K,20,0,20,0
1713517261387,LIGM 5C,A00,507425,Fischer-Grunski; Eva K,20,0,20,0
1713517262418,LIIT 5AS,A00,507427,Carnelos; Chiara,20,0,20,0
1713517263450,LIIT 5BS,A00,507430,Carnelos; Chiara,20,0,20,0
1713517264481,LIIT 5CS,A00,507432,Carnelos; Chiara,20,0,20,0
1713517265510,LISP 5A,A00,507541,Munoz Sanchez; Alicia,14,0,20,6
1713517266542,LISP 5B,A00,507671,Munoz Sanchez; Alicia,12,0,20,8
1713517267571,LISP 5C,A00,507696,Munoz Sanchez; Alicia,11,0,20,9
1713517268606,MAE 197,001,528363,Boechler; Nicholas Sebastia,9998,0,9999,1
1713517269643,MATH 197,001,523477,Kedlaya; Kiran S.,9999,0,9999,0
1713517269643,MATH 197,002,563811,Zhang; Danna,9998,0,9999,1
1713517270673,MCWP 40R,A00,518780,Staff,13,0,20,7
1713517270673,MCWP 40R,B00,518781,Staff,11,0,20,9
1713517270673,MCWP 40R,C00,518783,Staff,8,0,20,12
1713517271703,MCWP 50R,A00,518791,Staff,7,0,20,13
1713517271703,MCWP 50R,B00,518792,Staff,3,0,20,17
1713517271703,MCWP 50R,C00,518793,Staff,5,0,20,15
1713517271703,MCWP 50R,D00,518794,Staff,0,0,20,20
1713517271703,MCWP 50R,E00,518795,Staff,0,0,20,20
1713517271703,MCWP 50R,F00,518796,Staff,10,0,20,10
1713517271703,MCWP 50R,G00,518797,Staff,10,0,20,10
1713517272734,MMW 12R,A01,514034,Herbst; Matthew,1,0,16,15
1713517272734,MMW 12R,A02,514035,Herbst; Matthew,13,0,16,3
1713517273764,MMW 13R,A01,514037,Staff,0,8,16,16
1713517273764,MMW 13R,A02,514039,Staff,0,7,16,16
1713517275815,SIO 295LS,A00,523233,Staff,15,0,30,15
1713517276842,SIO 295S,A00,523232,Staff,15,0,30,15
1713517277875,SOCI 117,A01,494376,Staff,0,2,5,5
1713517278904,WES 237B,A00,494380,Staff,19,0,20,1
1713517280973,AESE 279B,A00,494370,Wade; Jon P,33,0,33,0
1713517282007,AIP 197,001,627712,Vespa; Emanuel Ignacio,9999,0,9999,0
1713517283032,ANAR 135S,A00,494369,Braswell; Geoffrey E.,0,0,0,0
1713517284064,CAT 124RS,A01,519847,Geibel; William,6,0,20,14
1713517285090,CAT 125RS,A01,515971,Geibel; William,6,0,20,14
1713517286122,CLRE 250,A00,511389,Morris; Sheldon,9996,0,9999,3
1713517287157,CLRE 251,A00,507176,Mehta; Ravindra L.,9996,0,9999,3
1713517287157,CLRE 251,B00,511410,Mehta; Ravindra L.,9998,0,9999,1
1713517288182,CLRE 252,A00,507189,Cuomo; Raphael Eduardo,9998,0,9999,1
1713517289216,CLRE 253,A00,507199,Vaida; Florin,9997,0,9999,2
1713517289216,CLRE 253,B00,507202,Vaida; Florin,9999,0,9999,0
1713517290244,CLRE 259,A00,507211,Patel; Hemal,9996,0,9999,3
1713517291269,CLRE 260,A00,507221,Cuomo; Raphael Eduardo,9999,0,9999,0
1713517292293,CLRE 297,001,507242,Cuomo; Raphael Eduardo,9999,0,9999,0
1713517293318,CSE 191,A00,516875,Minnes Kemp; Mor Mia,9999,0,9999,0
1713517294346,CSS 201S,A01,494383,Staff,35,0,35,0
1713517295378,CSS 202S,A01,494387,Staff,35,0,35,0
1713517296408,EAP 100,A00,516065,Staff,9792,0,9999,207
1713517297432,ECE 45,A01,507414,Staff,37,0,60,23
1713517298463,ECE 100,A01,507416,Baghdadchi; Saharnaz,0,0,20,20
1713517298463,ECE 100,A02,507418,Baghdadchi; Saharnaz,19,0,20,1
1713517299489,ECE 111,A01,507420,Staff,27,0,50,23
1713517300520,ECE 197,001,548057,Sievenpiper; Daniel F.,9998,0,9999,1
1713517301546,EDS 115,A00,507243,Choi; Bailey Miyeon,27,0,28,1
1713517302580,EDS 117,A01,494379,Staff,14,0,25,11
1713517303612,EDS 125,A00,507246,Hopkins; Megan Beth,27,0,30,3
1713517304640,EDS 128A,A01,507264,Fargason; Sharon Gayle,26,0,26,0
1713517305667,EDS 128B,A01,507293,Pappas; Elizabeth,30,0,30,0
1713517306692,EDS 139,A00,507294,Fargason; Sharon Gayle,30,0,30,0
1713517306692,EDS 139,B00,507313,Pappas; Elizabeth,30,0,30,0
1713517307724,EDS 201,A00,507315,Staff,18,0,30,12
1713517308755,EDS 203,A01,507317,Halter; Christopher P.,17,0,30,13
1713517309786,EDS 204R,A01,507319,Halter; Christopher P.,0,1,30,30
1713517309786,EDS 204R,B01,507331,Heinzman; Erica M.,22,0,30,8
1713517310812,EDS 206R,A00,507332,Staff,0,2,30,30
1713517310812,EDS 206R,B00,507343,Staff,23,0,30,7
1713517311837,EDS 250,A00,507344,Hemans; Patricia Ann Benitez,27,0,40,13
1713517312862,EDS 281,A00,507345,Daly; Alan J.,18,0,18,0
1713517313887,EDS 284,A00,507350,Daly; Alan J.,16,0,16,0
1713517314913,EDS 286,A00,507359,Fine; Sarah,18,0,18,0
1713517315942,EDS 289C,A01,507361,Daly; Alan J.,18,0,18,0
1713517316968,EDS 290,A00,507366,Hofstetter; Carolyn,15,0,15,0
1713517317993,LIGM 5A,A00,507421,Fischer-Grunski; Eva K,20,0,20,0
1713517319029,LIGM 5B,A00,507423,Fischer-Grunski; Eva K,20,0,20,0
1713517320060,LIGM 5C,A00,507425,Fischer-Grunski; Eva K,20,0,20,0
1713517321092,LIIT 5AS,A00,507427,Carnelos; Chiara,20,0,20,0
1713517322122,LIIT 5BS,A00,507430,Carnelos; Chiara,20,0,20,0
1713517323176,LIIT 5CS,A00,507432,Carnelos; Chiara,20,0,20,0
1713517324202,LISP 5A,A00,507541,Munoz Sanchez; Alicia,14,0,20,6
1713517325233,LISP 5B,A00,507671,Munoz Sanchez; Alicia,12,0,20,8
1713517326264,LISP 5C,A00,507696,Munoz Sanchez; Alicia,11,0,20,9
1713517327294,MAE 197,001,528363,Boechler; Nicholas Sebastia,9998,0,9999,1
1713517328320,MATH 197,001,523477,Kedlaya; Kiran S.,9999,0,9999,0
1713517328320,MATH 197,002,563811,Zhang; Danna,9998,0,9999,1
1713517329352,MCWP 40R,A00,518780,Staff,13,0,20,7
1713517329352,MCWP 40R,B00,518781,Staff,11,0,20,9
1713517329352,MCWP 40R,C00,518783,Staff,8,0,20,12
1713517330379,MCWP 50R,A00,518791,Staff,7,0,20,13
1713517330379,MCWP 50R,B00,518792,Staff,3,0,20,17
1713517330379,MCWP 50R,C00,518793,Staff,5,0,20,15
1713517330379,MCWP 50R,D00,518794,Staff,0,0,20,20
1713517330379,MCWP 50R,E00,518795,Staff,0,0,20,20
1713517330379,MCWP 50R,F00,518796,Staff,10,0,20,10
1713517330379,MCWP 50R,G00,518797,Staff,10,0,20,10
1713517331406,MMW 12R,A01,514034,Herbst; Matthew,1,0,16,15
1713517331406,MMW 12R,A02,514035,Herbst; Matthew,13,0,16,3
1713517332487,MMW 13R,A01,514037,Staff,0,8,16,16
1713517332487,MMW 13R,A02,514039,Staff,0,7,16,16
1713517334540,SIO 295LS,A00,523233,Staff,15,0,30,15
1713517335567,SIO 295S,A00,523232,Staff,15,0,30,15
1713517336597,SOCI 117,A01,494376,Staff,0,2,5,5
1713517337623,WES 237B,A00,494380,Staff,19,0,20,1
1713517339682,AESE 279B,A00,494370,Wade; Jon P,33,0,33,0
1713517340711,AIP 197,001,627712,Vespa; Emanuel Ignacio,9999,0,9999,0
1713517341737,ANAR 135S,A00,494369,Braswell; Geoffrey E.,0,0,0,0
1713517342767,CAT 124RS,A01,519847,Geibel; William,6,0,20,14
1713517343797,CAT 125RS,A01,515971,Geibel; William,6,0,20,14
1713517344827,CLRE 250,A00,511389,Morris; Sheldon,9996,0,9999,3
1713517345856,CLRE 251,A00,507176,Mehta; Ravindra L.,9996,0,9999,3
1713517345856,CLRE 251,B00,511410,Mehta; Ravindra L.,9998,0,9999,1
1713517346881,CLRE 252,A00,507189,Cuomo; Raphael Eduardo,9998,0,9999,1
1713517347908,CLRE 253,A00,507199,Vaida; Florin,9997,0,9999,2
1713517347908,CLRE 253,B00,507202,Vaida; Florin,9999,0,9999,0
1713517348933,CLRE 259,A00,507211,Patel; Hemal,9996,0,9999,3
1713517349964,CLRE 260,A00,507221,Cuomo; Raphael Eduardo,9999,0,9999,0
1713517350989,CLRE 297,001,507242,Cuomo; Raphael Eduardo,9999,0,9999,0
1713517352016,CSE 191,A00,516875,Minnes Kemp; Mor Mia,9999,0,9999,0
1713517353043,CSS 201S,A01,494383,Staff,35,0,35,0
1713517354095,CSS 202S,A01,494387,Staff,35,0,35,0
1713517355121,EAP 100,A00,516065,Staff,9792,0,9999,207
1713517356151,ECE 45,A01,507414,Staff,37,0,60,23
1713517357176,ECE 100,A01,507416,Baghdadchi; Saharnaz,0,0,20,20
1713517357176,ECE 100,A02,507418,Baghdadchi; Saharnaz,19,0,20,1
1713517358208,ECE 111,A01,507420,Staff,27,0,50,23
1713517359234,ECE 197,001,548057,Sievenpiper; Daniel F.,9998,0,9999,1
1713517360265,EDS 115,A00,507243,Choi; Bailey Miyeon,27,0,28,1
1713517361291,EDS 117,A01,494379,Staff,14,0,25,11
1713517362321,EDS 125,A00,507246,Hopkins; Megan Beth,27,0,30,3
1713517363351,EDS 128A,A01,507264,Fargason; Sharon Gayle,26,0,26,0
1713517364377,EDS 128B,A01,507293,Pappas; Elizabeth,30,0,30,0
1713517365403,EDS 139,A00,507294,Fargason; Sharon Gayle,30,0,30,0
1713517365403,EDS 139,B00,507313,Pappas; Elizabeth,30,0,30,0
1713517366433,EDS 201,A00,507315,Staff,18,0,30,12
1713517367459,EDS 203,A01,507317,Halter; Christopher P.,17,0,30,13
1713517368486,EDS 204R,A01,507319,Halter; Christopher P.,0,1,30,30
1713517368486,EDS 204R,B01,507331,Heinzman; Erica M.,22,0,30,8
1713517369511,EDS 206R,A00,507332,Staff,0,2,30,30
1713517369511,EDS 206R,B00,507343,Staff,23,0,30,7
1713517370538,EDS 250,A00,507344,Hemans; Patricia Ann Benitez,27,0,40,13
1713517371566,EDS 281,A00,507345,Daly; Alan J.,18,0,18,0
1713517372594,EDS 284,A00,507350,Daly; Alan J.,16,0,16,0
1713517373621,EDS 286,A00,507359,Fine; Sarah,18,0,18,0
1713517374651,EDS 289C,A01,507361,Daly; Alan J.,18,0,18,0
1713517375682,EDS 290,A00,507366,Hofstetter; Carolyn,15,0,15,0
1713517376708,LIGM 5A,A00,507421,Fischer-Grunski; Eva K,20,0,20,0
1713517377735,LIGM 5B,A00,507423,Fischer-Grunski; Eva K,20,0,20,0
1713517378767,LIGM 5C,A00,507425,Fischer-Grunski; Eva K,20,0,20,0
1713517379793,LIIT 5AS,A00,507427,Carnelos; Chiara,20,0,20,0
1713517380819,LIIT 5BS,A00,507430,Carnelos; Chiara,20,0,20,0
1713517381850,LIIT 5CS,A00,507432,Carnelos; Chiara,20,0,20,0
1713517382878,LISP 5A,A00,507541,Munoz Sanchez; Alicia,14,0,20,6
1713517383904,LISP 5B,A00,507671,Munoz Sanchez; Alicia,12,0,20,8
1713517384928,LISP 5C,A00,507696,Munoz Sanchez; Alicia,11,0,20,9
1713517385955,MAE 197,001,528363,Boechler; Nicholas Sebastia,9998,0,9999,1
1713517386981,MATH 197,001,523477,Kedlaya; Kiran S.,9999,0,9999,0
1713517386981,MATH 197,002,563811,Zhang; Danna,9998,0,9999,1
1713517388009,MCWP 40R,A00,518780,Staff,13,0,20,7
1713517388009,MCWP 40R,B00,518781,Staff,11,0,20,9
1713517388009,MCWP 40R,C00,518783,Staff,8,0,20,12
1713517389036,MCWP 50R,A00,518791,Staff,7,0,20,13
1713517389036,MCWP 50R,B00,518792,Staff,3,0,20,17
1713517389036,MCWP 50R,C00,518793,Staff,5,0,20,15
1713517389036,MCWP 50R,D00,518794,Staff,0,0,20,20
1713517389036,MCWP 50R,E00,518795,Staff,0,0,20,20
1713517389036,MCWP 50R,F00,518796,Staff,10,0,20,10
1713517389036,MCWP 50R,G00,518797,Staff,10,0,20,10
1713517390064,MMW 12R,A01,514034,Herbst; Matthew,1,0,16,15
1713517390064,MMW 12R,A02,514035,Herbst; Matthew,13,0,16,3
1713517391090,MMW 13R,A01,514037,Staff,0,8,16,16
1713517391090,MMW 13R,A02,514039,Staff,0,7,16,16
1713517393151,SIO 295LS,A00,523233,Staff,15,0,30,15
1713517394179,SIO 295S,A00,523232,Staff,15,0,30,15
1713517395209,SOCI 117,A01,494376,Staff,0,2,5,5
1713517396234,WES 237B,A00,494380,Staff,19,0,20,1
1713517398310,AESE 279B,A00,494370,Wade; Jon P,33,0,33,0
1713517399338,AIP 197,001,627712,Vespa; Emanuel Ignacio,9999,0,9999,0
1713517400369,ANAR 135S,A00,494369,Braswell; Geoffrey E.,0,0,0,0
1713517401395,CAT 124RS,A01,519847,Geibel; William,6,0,20,14
1713517402421,CAT 125RS,A01,515971,Geibel; William,6,0,20,14
1713517403453,CLRE 250,A00,511389,Morris; Sheldon,9996,0,9999,3
1713517404480,CLRE 251,A00,507176,Mehta; Ravindra L.,9996,0,9999,3
1713517404480,CLRE 251,B00,511410,Mehta; Ravindra L.,9998,0,9999,1
1713517405510,CLRE 252,A00,507189,Cuomo; Raphael Eduardo,9998,0,9999,1
1713517406536,CLRE 253,A00,507199,Vaida; Florin,9997,0,9999,2
1713517406536,CLRE 253,B00,507202,Vaida; Florin,9999,0,9999,0
1713517407568,CLRE 259,A00,507211,Patel; Hemal,9996,0,9999,3
1713517408596,CLRE 260,A00,507221,Cuomo; Raphael Eduardo,9999,0,9999,0
1713517409627,CLRE 297,001,507242,Cuomo; Raphael Eduardo,9999,0,9999,0
1713517410652,CSE 191,A00,516875,Minnes Kemp; Mor Mia,9999,0,9999,0
1713517411683,CSS 201S,A01,494383,Staff,35,0,35,0
1713517412715,CSS 202S,A01,494387,Staff,35,0,35,0
1713517413747,EAP 100,A00,516065,Staff,9792,0,9999,207
1713517414778,ECE 45,A01,507414,Staff,37,0,60,23
1713517415808,ECE 100,A01,507416,Baghdadchi; Saharnaz,0,0,20,20
1713517415808,ECE 100,A02,507418,Baghdadchi; Saharnaz,19,0,20,1
1713517416837,ECE 111,A01,507420,Staff,27,0,50,23
1713517417870,ECE 197,001,548057,Sievenpiper; Daniel F.,9998,0,9999,1
1713517418901,EDS 115,A00,507243,Choi; Bailey Miyeon,27,0,28,1
1713517419930,EDS 117,A01,494379,Staff,14,0,25,11
1713517420966,EDS 125,A00,507246,Hopkins; Megan Beth,27,0,30,3
1713517421993,EDS 128A,A01,507264,Fargason; Sharon Gayle,26,0,26,0
1713517423020,EDS 128B,A01,507293,Pappas; Elizabeth,30,0,30,0
1713517424051,EDS 139,A00,507294,Fargason; Sharon Gayle,30,0,30,0
1713517424051,EDS 139,B00,507313,Pappas; Elizabeth,30,0,30,0
1713517425076,EDS 201,A00,507315,Staff,18,0,30,12
1713517426103,EDS 203,A01,507317,Halter; Christopher P.,17,0,30,13
1713517427134,EDS 204R,A01,507319,Halter; Christopher P.,0,1,30,30
1713517427134,EDS 204R,B01,507331,Heinzman; Erica M.,22,0,30,8
1713517428164,EDS 206R,A00,507332,Staff,0,2,30,30
1713517428164,EDS 206R,B00,507343,Staff,23,0,30,7
1713517429189,EDS 250,A00,507344,Hemans; Patricia Ann Benitez,27,0,40,13
1713517430218,EDS 281,A00,507345,Daly; Alan J.,18,0,18,0
1713517431245,EDS 284,A00,507350,Daly; Alan J.,16,0,16,0
1713517432274,EDS 286,A00,507359,Fine; Sarah,18,0,18,0
1713517433304,EDS 289C,A01,507361,Daly; Alan J.,18,0,18,0
1713517434335,EDS 290,A00,507366,Hofstetter; Carolyn,15,0,15,0
1713517435364,LIGM 5A,A00,507421,Fischer-Grunski; Eva K,20,0,20,0
1713517436445,LIGM 5B,A00,507423,Fischer-Grunski; Eva K,20,0,20,0
1713517437472,LIGM 5C,A00,507425,Fischer-Grunski; Eva K,20,0,20,0
1713517438504,LIIT 5AS,A00,507427,Carnelos; Chiara,20,0,20,0
1713517439532,LIIT 5BS,A00,507430,Carnelos; Chiara,20,0,20,0
1713517440558,LIIT 5CS,A00,507432,Carnelos; Chiara,20,0,20,0
1713517441583,LISP 5A,A00,507541,Munoz Sanchez; Alicia,14,0,20,6
1713517442615,LISP 5B,A00,507671,Munoz Sanchez; Alicia,12,0,20,8
1713517443647,LISP 5C,A00,507696,Munoz Sanchez; Alicia,11,0,20,9
1713517444672,MAE 197,001,528363,Boechler; Nicholas Sebastia,9998,0,9999,1
1713517445699,MATH 197,001,523477,Kedlaya; Kiran S.,9999,0,9999,0
1713517445699,MATH 197,002,563811,Zhang; Danna,9998,0,9999,1
1713517446731,MCWP 40R,A00,518780,Staff,13,0,20,7
1713517446731,MCWP 40R,B00,518781,Staff,11,0,20,9
1713517446731,MCWP 40R,C00,518783,Staff,8,0,20,12
1713517447757,MCWP 50R,A00,518791,Staff,7,0,20,13
1713517447757,MCWP 50R,B00,518792,Staff,3,0,20,17
1713517447757,MCWP 50R,C00,518793,Staff,5,0,20,15
1713517447757,MCWP 50R,D00,518794,Staff,0,0,20,20
1713517447757,MCWP 50R,E00,518795,Staff,0,0,20,20
1713517447757,MCWP 50R,F00,518796,Staff,10,0,20,10
1713517447757,MCWP 50R,G00,518797,Staff,10,0,20,10
1713517448784,MMW 12R,A01,514034,Herbst; Matthew,1,0,16,15
1713517448784,MMW 12R,A02,514035,Herbst; Matthew,13,0,16,3
1713517449811,MMW 13R,A01,514037,Staff,0,8,16,16
1713517449811,MMW 13R,A02,514039,Staff,0,7,16,16
1713517451861,SIO 295LS,A00,523233,Staff,15,0,30,15
1713517452887,SIO 295S,A00,523232,Staff,15,0,30,15
1713517453912,SOCI 117,A01,494376,Staff,0,2,5,5
1713517454939,WES 237B,A00,494380,Staff,19,0,20,1
1713517457008,AESE 279B,A00,494370,Wade; Jon P,33,0,33,0
1713517458036,AIP 197,001,627712,Vespa; Emanuel Ignacio,9999,0,9999,0
1713517459063,ANAR 135S,A00,494369,Braswell; Geoffrey E.,0,0,0,0
1713517460088,CAT 124RS,A01,519847,Geibel; William,6,0,20,14
1713517461114,CAT 125RS,A01,515971,Geibel; William,6,0,20,14
1713517462141,CLRE 250,A00,511389,Morris; Sheldon,9996,0,9999,3
1713517463174,CLRE 251,A00,507176,Mehta; Ravindra L.,9996,0,9999,3
1713517463174,CLRE 251,B00,511410,Mehta; Ravindra L.,9998,0,9999,1
1713517464200,CLRE 252,A00,507189,Cuomo; Raphael Eduardo,9998,0,9999,1
1713517465227,CLRE 253,A00,507199,Vaida; Florin,9997,0,9999,2
1713517465227,CLRE 253,B00,507202,Vaida; Florin,9999,0,9999,0
1713517466250,CLRE 259,A00,507211,Patel; Hemal,9996,0,9999,3
1713517467281,CLRE 260,A00,507221,Cuomo; Raphael Eduardo,9999,0,9999,0
1713517468310,CLRE 297,001,507242,Cuomo; Raphael Eduardo,9999,0,9999,0
1713517469336,CSE 191,A00,516875,Minnes Kemp; Mor Mia,9999,0,9999,0
1713517470368,CSS 201S,A01,494383,Staff,35,0,35,0
1713517471399,CSS 202S,A01,494387,Staff,35,0,35,0
1713517472429,EAP 100,A00,516065,Staff,9792,0,9999,207
1713517473455,ECE 45,A01,507414,Staff,37,0,60,23
1713517474482,ECE 100,A01,507416,Baghdadchi; Saharnaz,0,0,20,20
1713517474482,ECE 100,A02,507418,Baghdadchi; Saharnaz,19,0,20,1
1713517475509,ECE 111,A01,507420,Staff,27,0,50,23
1713517476536,ECE 197,001,548057,Sievenpiper; Daniel F.,9998,0,9999,1
1713517477560,EDS 115,A00,507243,Choi; Bailey Miyeon,27,0,28,1
1713517478588,EDS 117,A01,494379,Staff,14,0,25,11
1713517479619,EDS 125,A00,507246,Hopkins; Megan Beth,27,0,30,3
1713517480643,EDS 128A,A01,507264,Fargason; Sharon Gayle,26,0,26,0
1713517481668,EDS 128B,A01,507293,Pappas; Elizabeth,30,0,30,0
1713517482693,EDS 139,A00,507294,Fargason; Sharon Gayle,30,0,30,0
1713517482693,EDS 139,B00,507313,Pappas; Elizabeth,30,0,30,0
1713517483719,EDS 201,A00,507315,Staff,18,0,30,12
1713517484753,EDS 203,A01,507317,Halter; Christopher P.,17,0,30,13
1713517485780,EDS 204R,A01,507319,Halter; Christopher P.,0,1,30,30
1713517485780,EDS 204R,B01,507331,Heinzman; Erica M.,22,0,30,8
1713517486809,EDS 206R,A00,507332,Staff,0,2,30,30
1713517486809,EDS 206R,B00,507343,Staff,23,0,30,7
1713517487836,EDS 250,A00,507344,Hemans; Patricia Ann Benitez,27,0,40,13
1713517488864,EDS 281,A00,507345,Daly; Alan J.,18,0,18,0
1713517489890,EDS 284,A00,507350,Daly; Alan J.,16,0,16,0
1713517490917,EDS 286,A00,507359,Fine; Sarah,18,0,18,0
1713517491945,EDS 289C,A01,507361,Daly; Alan J.,18,0,18,0
1713517492971,EDS 290,A00,507366,Hofstetter; Carolyn,15,0,15,0
1713517493998,LIGM 5A,A00,507421,Fischer-Grunski; Eva K,20,0,20,0
1713517495028,LIGM 5B,A00,507423,Fischer-Grunski; Eva K,20,0,20,0
1713517496060,LIGM 5C,A00,507425,Fischer-Grunski; Eva K,20,0,20,0
1713517497084,LIIT 5AS,A00,507427,Carnelos; Chiara,20,0,20,0
1713517498111,LIIT 5BS,A00,507430,Carnelos; Chiara,20,0,20,0
1713517499137,LIIT 5CS,A00,507432,Carnelos; Chiara,20,0,20,0
1713517500164,LISP 5A,A00,507541,Munoz Sanchez; Alicia,14,0,20,6
1713517501188,LISP 5B,A00,507671,Munoz Sanchez; Alicia,12,0,20,8
1713517502214,LISP 5C,A00,507696,Munoz Sanchez; Alicia,11,0,20,9
1713517503244,MAE 197,001,528363,Boechler; Nicholas Sebastia,9998,0,9999,1
1713517504276,MATH 197,001,523477,Kedlaya; Kiran S.,9999,0,9999,0
1713517504276,MATH 197,002,563811,Zhang; Danna,9998,0,9999,1
1713517505302,MCWP 40R,A00,518780,Staff,13,0,20,7
1713517505302,MCWP 40R,B00,518781,Staff,11,0,20,9
1713517505302,MCWP 40R,C00,518783,Staff,8,0,20,12
1713517506330,MCWP 50R,A00,518791,Staff,7,0,20,13
1713517506330,MCWP 50R,B00,518792,Staff,3,0,20,17
1713517506330,MCWP 50R,C00,518793,Staff,5,0,20,15
1713517506330,MCWP 50R,D00,518794,Staff,0,0,20,20
1713517506330,MCWP 50R,E00,518795,Staff,0,0,20,20
1713517506330,MCWP 50R,F00,518796,Staff,10,0,20,10
1713517506330,MCWP 50R,G00,518797,Staff,10,0,20,10
1713517507362,MMW 12R,A01,514034,Herbst; Matthew,1,0,16,15
1713517507362,MMW 12R,A02,514035,Herbst; Matthew,13,0,16,3
1713517508389,MMW 13R,A01,514037,Staff,0,8,16,16
1713517508389,MMW 13R,A02,514039,Staff,0,7,16,16
1713517510444,SIO 295LS,A00,523233,Staff,15,0,30,15
1713517511471,SIO 295S,A00,523232,Staff,15,0,30,15
1713517512506,SOCI 117,A01,494376,Staff,0,2,5,5
1713517513530,WES 237B,A00,494380,Staff,19,0,20,1
1713517515615,AESE 279B,A00,494370,Wade; Jon P,33,0,33,0
1713517516641,AIP 197,001,627712,Vespa; Emanuel Ignacio,9999,0,9999,0
1713517517667,ANAR 135S,A00,494369,Braswell; Geoffrey E.,0,0,0,0
1713517518697,CAT 124RS,A01,519847,Geibel; William,6,0,20,14
1713517519726,CAT 125RS,A01,515971,Geibel; William,6,0,20,14
1713517520752,CLRE 250,A00,511389,Morris; Sheldon,9996,0,9999,3
1713517521778,CLRE 251,A00,507176,Mehta; Ravindra L.,9996,0,9999,3
1713517521778,CLRE 251,B00,511410,Mehta; Ravindra L.,9998,0,9999,1
1713517522808,CLRE 252,A00,507189,Cuomo; Raphael Eduardo,9998,0,9999,1
1713517523834,CLRE 253,A00,507199,Vaida; Florin,9997,0,9999,2
1713517523834,CLRE 253,B00,507202,Vaida; Florin,9999,0,9999,0
1713517524864,CLRE 259,A00,507211,Patel; Hemal,9996,0,9999,3
1713517525887,CLRE 260,A00,507221,Cuomo; Raphael Eduardo,9999,0,9999,0
1713517526913,CLRE 297,001,507242,Cuomo; Raphael Eduardo,9999,0,9999,0
1713517527939,CSE 191,A00,516875,Minnes Kemp; Mor Mia,9999,0,9999,0
1713517528966,CSS 201S,A01,494383,Staff,35,0,35,0
1713517529997,CSS 202S,A01,494387,Staff,35,0,35,0
1713517531023,EAP 100,A00,516065,Staff,9792,0,9999,207
1713517532051,ECE 45,A01,507414,Staff,37,0,60,23
1713517533082,ECE 100,A01,507416,Baghdadchi; Saharnaz,0,0,20,20
1713517533082,ECE 100,A02,507418,Baghdadchi; Saharnaz,19,0,20,1
1713517534107,ECE 111,A01,507420,Staff,27,0,50,23
1713517535133,ECE 197,001,548057,Sievenpiper; Daniel F.,9998,0,9999,1
1713517536159,EDS 115,A00,507243,Choi; Bailey Miyeon,27,0,28,1
1713517537188,EDS 117,A01,494379,Staff,14,0,25,11
1713517538215,EDS 125,A00,507246,Hopkins; Megan Beth,27,0,30,3
1713517539240,EDS 128A,A01,507264,Fargason; Sharon Gayle,26,0,26,0
1713517540320,EDS 128B,A01,507293,Pappas; Elizabeth,30,0,30,0
1713517541349,EDS 139,A00,507294,Fargason; Sharon Gayle,30,0,30,0
1713517541349,EDS 139,B00,507313,Pappas; Elizabeth,30,0,30,0
1713517542377,EDS 201,A00,507315,Staff,18,0,30,12
1713517543401,EDS 203,A01,507317,Halter; Christopher P.,17,0,30,13
1713517544432,EDS 204R,A01,507319,Halter; Christopher P.,0,1,30,30
1713517544432,EDS 204R,B01,507331,Heinzman; Erica M.,22,0,30,8
1713517545457,EDS 206R,A00,507332,Staff,0,2,30,30
1713517545457,EDS 206R,B00,507343,Staff,23,0,30,7
1713517546482,EDS 250,A00,507344,Hemans; Patricia Ann Benitez,27,0,40,13
1713517547506,EDS 281,A00,507345,Daly; Alan J.,18,0,18,0
1713517548531,EDS 284,A00,507350,Daly; Alan J.,16,0,16,0
1713517549555,EDS 286,A00,507359,Fine; Sarah,18,0,18,0
1713517550581,EDS 289C,A01,507361,Daly; Alan J.,18,0,18,0
1713517551610,EDS 290,A00,507366,Hofstetter; Carolyn,15,0,15,0
1713517552637,LIGM 5A,A00,507421,Fischer-Grunski; Eva K,20,0,20,0
1713517553669,LIGM 5B,A00,507423,Fischer-Grunski; Eva K,20,0,20,0
1713517554695,LIGM 5C,A00,507425,Fischer-Grunski; Eva K,20,0,20,0
1713517555724,LIIT 5AS,A00,507427,Carnelos; Chiara,20,0,20,0
1713517556753,LIIT 5BS,A00,507430,Carnelos; Chiara,20,0,20,0
1713517557784,LIIT 5CS,A00,507432,Carnelos; Chiara,20,0,20,0
1713517558818,LISP 5A,A00,507541,Munoz Sanchez; Alicia,14,0,20,6
1713517559846,LISP 5B,A00,507671,Munoz Sanchez; Alicia,12,0,20,8
1713517560873,LISP 5C,A00,507696,Munoz Sanchez; Alicia,11,0,20,9
1713517561899,MAE 197,001,528363,Boechler; Nicholas Sebastia,9998,0,9999,1
1713517562926,MATH 197,001,523477,Kedlaya; Kiran S.,9999,0,9999,0
1713517562926,MATH 197,002,563811,Zhang; Danna,9998,0,9999,1
1713517563958,MCWP 40R,A00,518780,Staff,13,0,20,7
1713517563958,MCWP 40R,B00,518781,Staff,11,0,20,9
1713517563958,MCWP 40R,C00,518783,Staff,8,0,20,12
1713517564984,MCWP 50R,A00,518791,Staff,7,0,20,13
1713517564984,MCWP 50R,B00,518792,Staff,3,0,20,17
1713517564984,MCWP 50R,C00,518793,Staff,5,0,20,15
1713517564984,MCWP 50R,D00,518794,Staff,0,0,20,20
1713517564984,MCWP 50R,E00,518795,Staff,0,0,20,20
1713517564984,MCWP 50R,F00,518796,Staff,10,0,20,10
1713517564984,MCWP 50R,G00,518797,Staff,10,0,20,10
1713517566015,MMW 12R,A01,514034,Herbst; Matthew,1,0,16,15
1713517566015,MMW 12R,A02,514035,Herbst; Matthew,13,0,16,3
1713517567043,MMW 13R,A01,514037,Staff,0,8,16,16
1713517567043,MMW 13R,A02,514039,Staff,0,7,16,16
1713517569117,SIO 295LS,A00,523233,Staff,15,0,30,15
1713517570142,SIO 295S,A00,523232,Staff,15,0,30,15
1713517571167,SOCI 117,A01,494376,Staff,0,2,5,5
1713517572195,WES 237B,A00,494380,Staff,19,0,20,1
1713517574268,AESE 279B,A00,494370,Wade; Jon P,33,0,33,0
1713517575298,AIP 197,001,627712,Vespa; Emanuel Ignacio,9999,0,9999,0
1713517576325,ANAR 135S,A00,494369,Braswell; Geoffrey E.,0,0,0,0
1713517577356,CAT 124RS,A01,519847,Geibel; William,6,0,20,14
1713517578383,CAT 125RS,A01,515971,Geibel; William,6,0,20,14
1713517579414,CLRE 250,A00,511389,Morris; Sheldon,9996,0,9999,3
1713517580440,CLRE 251,A00,507176,Mehta; Ravindra L.,9996,0,9999,3
1713517580440,CLRE 251,B00,511410,Mehta; Ravindra L.,9998,0,9999,1
1713517581466,CLRE 252,A00,507189,Cuomo; Raphael Eduardo,9998,0,9999,1
1713517582493,CLRE 253,A00,507199,Vaida; Florin,9997,0,9999,2
1713517582493,CLRE 253,B00,507202,Vaida; Florin,9999,0,9999,0
1713517583519,CLRE 259,A00,507211,Patel; Hemal,9996,0,9999,3
1713517584548,CLRE 260,A00,507221,Cuomo; Raphael Eduardo,9999,0,9999,0
1713517585576,CLRE 297,001,507242,Cuomo; Raphael Eduardo,9999,0,9999,0
1713517586601,CSE 191,A00,516875,Minnes Kemp; Mor Mia,9999,0,9999,0
1713517587630,CSS 201S,A01,494383,Staff,35,0,35,0
1713517588659,CSS 202S,A01,494387,Staff,35,0,35,0
1713517589684,EAP 100,A00,516065,Staff,9792,0,9999,207
1713517590714,ECE 45,A01,507414,Staff,37,0,60,23
1713517591738,ECE 100,A01,507416,Baghdadchi; Saharnaz,0,0,20,20
1713517591738,ECE 100,A02,507418,Baghdadchi; Saharnaz,19,0,20,1
1713517592764,ECE 111,A01,507420,Staff,27,0,50,23
1713517593794,ECE 197,001,548057,Sievenpiper; Daniel F.,9998,0,9999,1
1713517594820,EDS 115,A00,507243,Choi; Bailey Miyeon,27,0,28,1
1713517595850,EDS 117,A01,494379,Staff,14,0,25,11
1713517596875,EDS 125,A00,507246,Hopkins; Megan Beth,27,0,30,3
1713517597902,EDS 128A,A01,507264,Fargason; Sharon Gayle,26,0,26,0
1713517598930,EDS 128B,A01,507293,Pappas; Elizabeth,30,0,30,0
1713517599958,EDS 139,A00,507294,Fargason; Sharon Gayle,30,0,30,0
1713517599958,EDS 139,B00,507313,Pappas; Elizabeth,30,0,30,0
1713517600981,EDS 201,A00,507315,Staff,18,0,30,12
1713517602011,EDS 203,A01,507317,Halter; Christopher P.,17,0,30,13
1713517603039,EDS 204R,A01,507319,Halter; Christopher P.,0,1,30,30
1713517603039,EDS 204R,B01,507331,Heinzman; Erica M.,22,0,30,8
1713517604069,EDS 206R,A00,507332,Staff,0,2,30,30
1713517604069,EDS 206R,B00,507343,Staff,23,0,30,7
1713517605095,EDS 250,A00,507344,Hemans; Patricia Ann Benitez,27,0,40,13
1713517606120,EDS 281,A00,507345,Daly; Alan J.,18,0,18,0
1713517607146,EDS 284,A00,507350,Daly; Alan J.,16,0,16,0
1713517608176,EDS 286,A00,507359,Fine; Sarah,18,0,18,0
1713517609202,EDS 289C,A01,507361,Daly; Alan J.,18,0,18,0
1713517610227,EDS 290,A00,507366,Hofstetter; Carolyn,15,0,15,0
1713517611255,LIGM 5A,A00,507421,Fischer-Grunski; Eva K,20,0,20,0
1713517612285,LIGM 5B,A00,507423,Fischer-Grunski; Eva K,20,0,20,0
1713517613310,LIGM 5C,A00,507425,Fischer-Grunski; Eva K,20,0,20,0
1713517614337,LIIT 5AS,A00,507427,Carnelos; Chiara,20,0,20,0
1713517615366,LIIT 5BS,A00,507430,Carnelos; Chiara,20,0,20,0
1713517616393,LIIT 5CS,A00,507432,Carnelos; Chiara,20,0,20,0
1713517617417,LISP 5A,A00,507541,Munoz Sanchez; Alicia,14,0,20,6
1713517618444,LISP 5B,A00,507671,Munoz Sanchez; Alicia,12,0,20,8
1713517619469,LISP 5C,A00,507696,Munoz Sanchez; Alicia,11,0,20,9
1713517620498,MAE 197,001,528363,Boechler; Nicholas Sebastia,9998,0,9999,1
1713517621524,MATH 197,001,523477,Kedlaya; Kiran S.,9999,0,9999,0
1713517621524,MATH 197,002,563811,Zhang; Danna,9998,0,9999,1
1713517622554,MCWP 40R,A00,518780,Staff,13,0,20,7
1713517622554,MCWP 40R,B00,518781,Staff,11,0,20,9
1713517622554,MCWP 40R,C00,518783,Staff,8,0,20,12
1713517623581,MCWP 50R,A00,518791,Staff,7,0,20,13
1713517623581,MCWP 50R,B00,518792,Staff,3,0,20,17
1713517623581,MCWP 50R,C00,518793,Staff,5,0,20,15
1713517623581,MCWP 50R,D00,518794,Staff,0,0,20,20
1713517623581,MCWP 50R,E00,518795,Staff,0,0,20,20
1713517623581,MCWP 50R,F00,518796,Staff,10,0,20,10
1713517623581,MCWP 50R,G00,518797,Staff,10,0,20,10
1713517624606,MMW 12R,A01,514034,Herbst; Matthew,1,0,16,15
1713517624606,MMW 12R,A02,514035,Herbst; Matthew,13,0,16,3
1713517625634,MMW 13R,A01,514037,Staff,0,8,16,16
1713517625634,MMW 13R,A02,514039,Staff,0,7,16,16
1713517627686,SIO 295LS,A00,523233,Staff,15,0,30,15
1713517628711,SIO 295S,A00,523232,Staff,15,0,30,15
1713517629738,SOCI 117,A01,494376,Staff,0,2,5,5
1713517630765,WES 237B,A00,494380,Staff,19,0,20,1
1713517632835,AESE 279B,A00,494370,Wade; Jon P,33,0,33,0
1713517633864,AIP 197,001,627712,Vespa; Emanuel Ignacio,9999,0,9999,0
1713517634890,ANAR 135S,A00,494369,Braswell; Geoffrey E.,0,0,0,0
1713517635914,CAT 124RS,A01,519847,Geibel; William,6,0,20,14
1713517636940,CAT 125RS,A01,515971,Geibel; William,6,0,20,14
1713517637966,CLRE 250,A00,511389,Morris; Sheldon,9996,0,9999,3
1713517638992,CLRE 251,A00,507176,Mehta; Ravindra L.,9996,0,9999,3
1713517638992,CLRE 251,B00,511410,Mehta; Ravindra L.,9998,0,9999,1
1713517640022,CLRE 252,A00,507189,Cuomo; Raphael Eduardo,9998,0,9999,1
1713517641047,CLRE 253,A00,507199,Vaida; Florin,9997,0,9999,2
1713517641047,CLRE 253,B00,507202,Vaida; Florin,9999,0,9999,0
1713517642074,CLRE 259,A00,507211,Patel; Hemal,9996,0,9999,3
1713517643100,CLRE 260,A00,507221,Cuomo; Raphael Eduardo,9999,0,9999,0
1713517644185,CLRE 297,001,507242,Cuomo; Raphael Eduardo,9999,0,9999,0
1713517645217,CSE 191,A00,516875,Minnes Kemp; Mor Mia,9999,0,9999,0
1713517646243,CSS 201S,A01,494383,Staff,35,0,35,0
1713517647274,CSS 202S,A01,494387,Staff,35,0,35,0
1713517648300,EAP 100,A00,516065,Staff,9792,0,9999,207
1713517649328,ECE 45,A01,507414,Staff,37,0,60,23
1713517650353,ECE 100,A01,507416,Baghdadchi; Saharnaz,0,0,20,20
1713517650353,ECE 100,A02,507418,Baghdadchi; Saharnaz,19,0,20,1
1713517651379,ECE 111,A01,507420,Staff,27,0,50,23
1713517652405,ECE 197,001,548057,Sievenpiper; Daniel F.,9998,0,9999,1
1713517653431,EDS 115,A00,507243,Choi; Bailey Miyeon,27,0,28,1
1713517654457,EDS 117,A01,494379,Staff,14,0,25,11
1713517655487,EDS 125,A00,507246,Hopkins; Megan Beth,27,0,30,3
1713517656517,EDS 128A,A01,507264,Fargason; Sharon Gayle,26,0,26,0
1713517657541,EDS 128B,A01,507293,Pappas; Elizabeth,30,0,30,0
1713517658570,EDS 139,A00,507294,Fargason; Sharon Gayle,30,0,30,0
1713517658570,EDS 139,B00,507313,Pappas; Elizabeth,30,0,30,0
1713517659595,EDS 201,A00,507315,Staff,18,0,30,12
1713517660621,EDS 203,A01,507317,Halter; Christopher P.,17,0,30,13
1713517661647,EDS 204R,A01,507319,Halter; Christopher P.,0,1,30,30
1713517661647,EDS 204R,B01,507331,Heinzman; Erica M.,22,0,30,8
1713517662676,EDS 206R,A00,507332,Staff,0,2,30,30
1713517662676,EDS 206R,B00,507343,Staff,23,0,30,7
1713517663706,EDS 250,A00,507344,Hemans; Patricia Ann Benitez,27,0,40,13
1713517664730,EDS 281,A00,507345,Daly; Alan J.,18,0,18,0
1713517665758,EDS 284,A00,507350,Daly; Alan J.,16,0,16,0
1713517666790,EDS 286,A00,507359,Fine; Sarah,18,0,18,0
1713517667815,EDS 289C,A01,507361,Daly; Alan J.,18,0,18,0
1713517668842,EDS 290,A00,507366,Hofstetter; Carolyn,15,0,15,0
1713517669874,LIGM 5A,A00,507421,Fischer-Grunski; Eva K,20,0,20,0
1713517670900,LIGM 5B,A00,507423,Fischer-Grunski; Eva K,20,0,20,0
1713517671928,LIGM 5C,A00,507425,Fischer-Grunski; Eva K,20,0,20,0
1713517672958,LIIT 5AS,A00,507427,Carnelos; Chiara,20,0,20,0
1713517673983,LIIT 5BS,A00,507430,Carnelos; Chiara,20,0,20,0
1713517675015,LIIT 5CS,A00,507432,Carnelos; Chiara,20,0,20,0
1713517676042,LISP 5A,A00,507541,Munoz Sanchez; Alicia,14,0,20,6
1713517677073,LISP 5B,A00,507671,Munoz Sanchez; Alicia,12,0,20,8
1713517678105,LISP 5C,A00,507696,Munoz Sanchez; Alicia,11,0,20,9
1713517679131,MAE 197,001,528363,Boechler; Nicholas Sebastia,9998,0,9999,1
1713517680161,MATH 197,001,523477,Kedlaya; Kiran S.,9999,0,9999,0
1713517680161,MATH 197,002,563811,Zhang; Danna,9998,0,9999,1
1713517681186,MCWP 40R,A00,518780,Staff,13,0,20,7
1713517681186,MCWP 40R,B00,518781,Staff,11,0,20,9
1713517681186,MCWP 40R,C00,518783,Staff,8,0,20,12
1713517682213,MCWP 50R,A00,518791,Staff,7,0,20,13
1713517682213,MCWP 50R,B00,518792,Staff,3,0,20,17
1713517682213,MCWP 50R,C00,518793,Staff,5,0,20,15
1713517682213,MCWP 50R,D00,518794,Staff,0,0,20,20
1713517682213,MCWP 50R,E00,518795,Staff,0,0,20,20
1713517682213,MCWP 50R,F00,518796,Staff,10,0,20,10
1713517682213,MCWP 50R,G00,518797,Staff,10,0,20,10
1713517683247,MMW 12R,A01,514034,Herbst; Matthew,1,0,16,15
1713517683247,MMW 12R,A02,514035,Herbst; Matthew,13,0,16,3
1713517684331,MMW 13R,A01,514037,Staff,0,8,16,16
1713517684331,MMW 13R,A02,514039,Staff,0,7,16,16
1713517686384,SIO 295LS,A00,523233,Staff,15,0,30,15
1713517687413,SIO 295S,A00,523232,Staff,15,0,30,15
1713517688438,SOCI 117,A01,494376,Staff,0,2,5,5
1713517689464,WES 237B,A00,494380,Staff,19,0,20,1
1713517691536,AESE 279B,A00,494370,Wade; Jon P,33,0,33,0
1713517692565,AIP 197,001,627712,Vespa; Emanuel Ignacio,9999,0,9999,0
1713517693590,ANAR 135S,A00,494369,Braswell; Geoffrey E.,0,0,0,0
1713517694615,CAT 124RS,A01,519847,Geibel; William,6,0,20,14
1713517695645,CAT 125RS,A01,515971,Geibel; William,6,0,20,14
1713517696670,CLRE 250,A00,511389,Morris; Sheldon,9996,0,9999,3
1713517697696,CLRE 251,A00,507176,Mehta; Ravindra L.,9996,0,9999,3
1713517697696,CLRE 251,B00,511410,Mehta; Ravindra L.,9998,0,9999,1
1713517698722,CLRE 252,A00,507189,Cuomo; Raphael Eduardo,9998,0,9999,1
1713517699747,CLRE 253,A00,507199,Vaida; Florin,9997,0,9999,2
1713517699747,CLRE 253,B00,507202,Vaida; Florin,9999,0,9999,0
1713517700772,CLRE 259,A00,507211,Patel; Hemal,9996,0,9999,3
1713517701796,CLRE 260,A00,507221,Cuomo; Raphael Eduardo,9999,0,9999,0
1713517702822,CLRE 297,001,507242,Cuomo; Raphael Eduardo,9999,0,9999,0
1713517703860,CSE 191,A00,516875,Minnes Kemp; Mor Mia,9999,0,9999,0
1713517704886,CSS 201S,A01,494383,Staff,35,0,35,0
1713517705913,CSS 202S,A01,494387,Staff,35,0,35,0
1713517706939,EAP 100,A00,516065,Staff,9792,0,9999,207
1713517707965,ECE 45,A01,507414,Staff,37,0,60,23
1713517708990,ECE 100,A01,507416,Baghdadchi; Saharnaz,0,0,20,20
1713517708990,ECE 100,A02,507418,Baghdadchi; Saharnaz,19,0,20,1
1713517710017,ECE 111,A01,507420,Staff,27,0,50,23
1713517711042,ECE 197,001,548057,Sievenpiper; Daniel F.,9998,0,9999,1
1713517712073,EDS 115,A00,507243,Choi; Bailey Miyeon,27,0,28,1
1713517713104,EDS 117,A01,494379,Staff,14,0,25,11
1713517714133,EDS 125,A00,507246,Hopkins; Megan Beth,27,0,30,3
1713517715158,EDS 128A,A01,507264,Fargason; Sharon Gayle,26,0,26,0
1713517716189,EDS 128B,A01,507293,Pappas; Elizabeth,30,0,30,0
1713517717214,EDS 139,A00,507294,Fargason; Sharon Gayle,30,0,30,0
1713517717214,EDS 139,B00,507313,Pappas; Elizabeth,30,0,30,0
1713517718242,EDS 201,A00,507315,Staff,18,0,30,12
1713517719269,EDS 203,A01,507317,Halter; Christopher P.,17,0,30,13
1713517720301,EDS 204R,A01,507319,Halter; Christopher P.,0,1,30,30
1713517720301,EDS 204R,B01,507331,Heinzman; Erica M.,22,0,30,8
1713517721331,EDS 206R,A00,507332,Staff,0,2,30,30
1713517721331,EDS 206R,B00,507343,Staff,23,0,30,7
1713517722356,EDS 250,A00,507344,Hemans; Patricia Ann Benitez,27,0,40,13
1713517723381,EDS 281,A00,507345,Daly; Alan J.,18,0,18,0
1713517724409,EDS 284,A00,507350,Daly; Alan J.,16,0,16,0
1713517725438,EDS 286,A00,507359,Fine; Sarah,18,0,18,0
1713517726466,EDS 289C,A01,507361,Daly; Alan J.,18,0,18,0
1713517727492,EDS 290,A00,507366,Hofstetter; Carolyn,15,0,15,0
1713517728525,LIGM 5A,A00,507421,Fischer-Grunski; Eva K,20,0,20,0
1713517729556,LIGM 5B,A00,507423,Fischer-Grunski; Eva K,20,0,20,0
1713517730581,LIGM 5C,A00,507425,Fischer-Grunski; Eva K,20,0,20,0
1713517731611,LIIT 5AS,A00,507427,Carnelos; Chiara,20,0,20,0
1713517732644,LIIT 5BS,A00,507430,Carnelos; Chiara,20,0,20,0
1713517733670,LIIT 5CS,A00,507432,Carnelos; Chiara,20,0,20,0
1713517734696,LISP 5A,A00,507541,Munoz Sanchez; Alicia,14,0,20,6
1713517735721,LISP 5B,A00,507671,Munoz Sanchez; Alicia,12,0,20,8
1713517736748,LISP 5C,A00,507696,Munoz Sanchez; Alicia,11,0,20,9
1713517737777,MAE 197,001,528363,Boechler; Nicholas Sebastia,9998,0,9999,1
1713517738815,MATH 197,001,523477,Kedlaya; Kiran S.,9999,0,9999,0
1713517738815,MATH 197,002,563811,Zhang; Danna,9998,0,9999,1
1713517739845,MCWP 40R,A00,518780,Staff,13,0,20,7
1713517739845,MCWP 40R,B00,518781,Staff,11,0,20,9
1713517739845,MCWP 40R,C00,518783,Staff,8,0,20,12
1713517740872,MCWP 50R,A00,518791,Staff,7,0,20,13
1713517740872,MCWP 50R,B00,518792,Staff,3,0,20,17
1713517740872,MCWP 50R,C00,518793,Staff,5,0,20,15
1713517740872,MCWP 50R,D00,518794,Staff,0,0,20,20
1713517740872,MCWP 50R,E00,518795,Staff,0,0,20,20
1713517740872,MCWP 50R,F00,518796,Staff,10,0,20,10
1713517740872,MCWP 50R,G00,518797,Staff,10,0,20,10
1713517741900,MMW 12R,A01,514034,Herbst; Matthew,1,0,16,15
1713517741900,MMW 12R,A02,514035,Herbst; Matthew,13,0,16,3
1713517742925,MMW 13R,A01,514037,Staff,0,8,16,16
1713517742925,MMW 13R,A02,514039,Staff,0,7,16,16
1713517744976,SIO 295LS,A00,523233,Staff,15,0,30,15
1713517746006,SIO 295S,A00,523232,Staff,15,0,30,15
1713517747037,SOCI 117,A01,494376,Staff,0,2,5,5
1713517748119,WES 237B,A00,494380,Staff,19,0,20,1
1713517750202,AESE 279B,A00,494370,Wade; Jon P,33,0,33,0
1713517751233,AIP 197,001,627712,Vespa; Emanuel Ignacio,9999,0,9999,0
1713517752262,ANAR 135S,A00,494369,Braswell; Geoffrey E.,0,0,0,0
1713517753291,CAT 124RS,A01,519847,Geibel; William,6,0,20,14
1713517754321,CAT 125RS,A01,515971,Geibel; William,6,0,20,14
1713517755348,CLRE 250,A00,511389,Morris; Sheldon,9996,0,9999,3
1713517756374,CLRE 251,A00,507176,Mehta; Ravindra L.,9996,0,9999,3
1713517756374,CLRE 251,B00,511410,Mehta; Ravindra L.,9998,0,9999,1
1713517757399,CLRE 252,A00,507189,Cuomo; Raphael Eduardo,9998,0,9999,1
1713517758426,CLRE 253,A00,507199,Vaida; Florin,9997,0,9999,2
1713517758426,CLRE 253,B00,507202,Vaida; Florin,9999,0,9999,0
1713517759452,CLRE 259,A00,507211,Patel; Hemal,9996,0,9999,3
1713517760481,CLRE 260,A00,507221,Cuomo; Raphael Eduardo,9999,0,9999,0
1713517761511,CLRE 297,001,507242,Cuomo; Raphael Eduardo,9999,0,9999,0
1713517762542,CSE 191,A00,516875,Minnes Kemp; Mor Mia,9999,0,9999,0
1713517763573,CSS 201S,A01,494383,Staff,35,0,35,0
1713517764603,CSS 202S,A01,494387,Staff,35,0,35,0
1713517765628,EAP 100,A00,516065,Staff,9792,0,9999,207
1713517766655,ECE 45,A01,507414,Staff,37,0,60,23
1713517767681,ECE 100,A01,507416,Baghdadchi; Saharnaz,0,0,20,20
1713517767681,ECE 100,A02,507418,Baghdadchi; Saharnaz,19,0,20,1
1713517768706,ECE 111,A01,507420,Staff,27,0,50,23
1713517769736,ECE 197,001,548057,Sievenpiper; Daniel F.,9998,0,9999,1
1713517770768,EDS 115,A00,507243,Choi; Bailey Miyeon,27,0,28,1
1713517771795,EDS 117,A01,494379,Staff,14,0,25,11
1713517772824,EDS 125,A00,507246,Hopkins; Megan Beth,27,0,30,3
1713517773861,EDS 128A,A01,507264,Fargason; Sharon Gayle,26,0,26,0
1713517774887,EDS 128B,A01,507293,Pappas; Elizabeth,30,0,30,0
1713517775916,EDS 139,A00,507294,Fargason; Sharon Gayle,30,0,30,0
1713517775916,EDS 139,B00,507313,Pappas; Elizabeth,30,0,30,0
1713517776947,EDS 201,A00,507315,Staff,18,0,30,12
1713517777974,EDS 203,A01,507317,Halter; Christopher P.,17,0,30,13
1713517779003,EDS 204R,A01,507319,Halter; Christopher P.,0,1,30,30
1713517779003,EDS 204R,B01,507331,Heinzman; Erica M.,22,0,30,8
1713517780028,EDS 206R,A00,507332,Staff,0,2,30,30
1713517780028,EDS 206R,B00,507343,Staff,23,0,30,7
1713517781054,EDS 250,A00,507344,Hemans; Patricia Ann Benitez,27,0,40,13
1713517782080,EDS 281,A00,507345,Daly; Alan J.,18,0,18,0
1713517783107,EDS 284,A00,507350,Daly; Alan J.,16,0,16,0
1713517784136,EDS 286,A00,507359,Fine; Sarah,18,0,18,0
1713517785162,EDS 289C,A01,507361,Daly; Alan J.,18,0,18,0
1713517786192,EDS 290,A00,507366,Hofstetter; Carolyn,15,0,15,0
1713517787217,LIGM 5A,A00,507421,Fischer-Grunski; Eva K,20,0,20,0
1713517788248,LIGM 5B,A00,507423,Fischer-Grunski; Eva K,20,0,20,0
1713517789279,LIGM 5C,A00,507425,Fischer-Grunski; Eva K,20,0,20,0
1713517790306,LIIT 5AS,A00,507427,Carnelos; Chiara,20,0,20,0
1713517791336,LIIT 5BS,A00,507430,Carnelos; Chiara,20,0,20,0
1713517792362,LIIT 5CS,A00,507432,Carnelos; Chiara,20,0,20,0
1713517793389,LISP 5A,A00,507541,Munoz Sanchez; Alicia,14,0,20,6
1713517794419,LISP 5B,A00,507671,Munoz Sanchez; Alicia,12,0,20,8
1713517795449,LISP 5C,A00,507696,Munoz Sanchez; Alicia,11,0,20,9
1713517796480,MAE 197,001,528363,Boechler; Nicholas Sebastia,9998,0,9999,1
1713517797509,MATH 197,001,523477,Kedlaya; Kiran S.,9999,0,9999,0
1713517797509,MATH 197,002,563811,Zhang; Danna,9998,0,9999,1
1713517798534,MCWP 40R,A00,518780,Staff,13,0,20,7
1713517798534,MCWP 40R,B00,518781,Staff,11,0,20,9
1713517798534,MCWP 40R,C00,518783,Staff,8,0,20,12
1713517799565,MCWP 50R,A00,518791,Staff,7,0,20,13
1713517799565,MCWP 50R,B00,518792,Staff,3,0,20,17
1713517799565,MCWP 50R,C00,518793,Staff,5,0,20,15
1713517799565,MCWP 50R,D00,518794,Staff,0,0,20,20
1713517799565,MCWP 50R,E00,518795,Staff,0,0,20,20
1713517799565,MCWP 50R,F00,518796,Staff,10,0,20,10
1713517799565,MCWP 50R,G00,518797,Staff,10,0,20,10
1713517800590,MMW 12R,A01,514034,Herbst; Matthew,1,0,16,15
1713517800590,MMW 12R,A02,514035,Herbst; Matthew,13,0,16,3
1713517801615,MMW 13R,A01,514037,Staff,0,8,16,16
1713517801615,MMW 13R,A02,514039,Staff,0,7,16,16
1713517803672,SIO 295LS,A00,523233,Staff,15,0,30,15
1713517804697,SIO 295S,A00,523232,Staff,15,0,30,15
1713517805724,SOCI 117,A01,494376,Staff,0,2,5,5
1713517806754,WES 237B,A00,494380,Staff,19,0,20,1
1713517808822,AESE 279B,A00,494370,Wade; Jon P,33,0,33,0
1713517809847,AIP 197,001,627712,Vespa; Emanuel Ignacio,9999,0,9999,0
1713517810874,ANAR 135S,A00,494369,Braswell; Geoffrey E.,0,0,0,0
1713517811901,CAT 124RS,A01,519847,Geibel; William,6,0,20,14
1713517812928,CAT 125RS,A01,515971,Geibel; William,6,0,20,14
1713517813954,CLRE 250,A00,511389,Morris; Sheldon,9996,0,9999,3
1713517814982,CLRE 251,A00,507176,Mehta; Ravindra L.,9996,0,9999,3
1713517814982,CLRE 251,B00,511410,Mehta; Ravindra L.,9998,0,9999,1
1713517816007,CLRE 252,A00,507189,Cuomo; Raphael Eduardo,9998,0,9999,1
1713517817038,CLRE 253,A00,507199,Vaida; Florin,9997,0,9999,2
1713517817038,CLRE 253,B00,507202,Vaida; Florin,9999,0,9999,0
1713517818065,CLRE 259,A00,507211,Patel; Hemal,9996,0,9999,3
1713517819090,CLRE 260,A00,507221,Cuomo; Raphael Eduardo,9999,0,9999,0
1713517820116,CLRE 297,001,507242,Cuomo; Raphael Eduardo,9999,0,9999,0
1713517821141,CSE 191,A00,516875,Minnes Kemp; Mor Mia,9999,0,9999,0
1713517822168,CSS 201S,A01,494383,Staff,35,0,35,0
1713517823194,CSS 202S,A01,494387,Staff,35,0,35,0
1713517824223,EAP 100,A00,516065,Staff,9792,0,9999,207
1713517825249,ECE 45,A01,507414,Staff,37,0,60,23
1713517826278,ECE 100,A01,507416,Baghdadchi; Saharnaz,0,0,20,20
1713517826278,ECE 100,A02,507418,Baghdadchi; Saharnaz,19,0,20,1
1713517827304,ECE 111,A01,507420,Staff,27,0,50,23
1713517828330,ECE 197,001,548057,Sievenpiper; Daniel F.,9998,0,9999,1
1713517829359,EDS 115,A00,507243,Choi; Bailey Miyeon,27,0,28,1
1713517830385,EDS 117,A01,494379,Staff,14,0,25,11
1713517831410,EDS 125,A00,507246,Hopkins; Megan Beth,27,0,30,3
1713517832435,EDS 128A,A01,507264,Fargason; Sharon Gayle,26,0,26,0
1713517833464,EDS 128B,A01,507293,Pappas; Elizabeth,30,0,30,0
1713517834493,EDS 139,A00,507294,Fargason; Sharon Gayle,30,0,30,0
1713517834493,EDS 139,B00,507313,Pappas; Elizabeth,30,0,30,0
1713517835519,EDS 201,A00,507315,Staff,18,0,30,12
1713517836544,EDS 203,A01,507317,Halter; Christopher P.,17,0,30,13
1713517837569,EDS 204R,A01,507319,Halter; Christopher P.,0,1,30,30
1713517837569,EDS 204R,B01,507331,Heinzman; Erica M.,22,0,30,8
1713517838598,EDS 206R,A00,507332,Staff,0,2,30,30
1713517838598,EDS 206R,B00,507343,Staff,23,0,30,7
1713517839625,EDS 250,A00,507344,Hemans; Patricia Ann Benitez,27,0,40,13
1713517840650,EDS 281,A00,507345,Daly; Alan J.,18,0,18,0
1713517841676,EDS 284,A00,507350,Daly; Alan J.,16,0,16,0
1713517842705,EDS 286,A00,507359,Fine; Sarah,18,0,18,0
1713517843731,EDS 289C,A01,507361,Daly; Alan J.,18,0,18,0
1713517844759,EDS 290,A00,507366,Hofstetter; Carolyn,15,0,15,0
1713517845786,LIGM 5A,A00,507421,Fischer-Grunski; Eva K,20,0,20,0
1713517846816,LIGM 5B,A00,507423,Fischer-Grunski; Eva K,20,0,20,0
1713517847844,LIGM 5C,A00,507425,Fischer-Grunski; Eva K,20,0,20,0
1713517848871,LIIT 5AS,A00,507427,Carnelos; Chiara,20,0,20,0
1713517849897,LIIT 5BS,A00,507430,Carnelos; Chiara,20,0,20,0
1713517850929,LIIT 5CS,A00,507432,Carnelos; Chiara,20,0,20,0
1713517852011,LISP 5A,A00,507541,Munoz Sanchez; Alicia,14,0,20,6
1713517853037,LISP 5B,A00,507671,Munoz Sanchez; Alicia,12,0,20,8
1713517854068,LISP 5C,A00,507696,Munoz Sanchez; Alicia,11,0,20,9
1713517855094,MAE 197,001,528363,Boechler; Nicholas Sebastia,9998,0,9999,1
1713517856120,MATH 197,001,523477,Kedlaya; Kiran S.,9999,0,9999,0
1713517856120,MATH 197,002,563811,Zhang; Danna,9998,0,9999,1
1713517857150,MCWP 40R,A00,518780,Staff,13,0,20,7
1713517857150,MCWP 40R,B00,518781,Staff,11,0,20,9
1713517857150,MCWP 40R,C00,518783,Staff,8,0,20,12
1713517858180,MCWP 50R,A00,518791,Staff,7,0,20,13
1713517858180,MCWP 50R,B00,518792,Staff,3,0,20,17
1713517858180,MCWP 50R,C00,518793,Staff,5,0,20,15
1713517858180,MCWP 50R,D00,518794,Staff,0,0,20,20
1713517858180,MCWP 50R,E00,518795,Staff,0,0,20,20
1713517858180,MCWP 50R,F00,518796,Staff,10,0,20,10
1713517858180,MCWP 50R,G00,518797,Staff,10,0,20,10
1713517859210,MMW 12R,A01,514034,Herbst; Matthew,1,0,16,15
1713517859210,MMW 12R,A02,514035,Herbst; Matthew,13,0,16,3
1713517860237,MMW 13R,A01,514037,Staff,0,8,16,16
1713517860237,MMW 13R,A02,514039,Staff,0,7,16,16
1713517862294,SIO 295LS,A00,523233,Staff,15,0,30,15
1713517863321,SIO 295S,A00,523232,Staff,15,0,30,15
1713517864346,SOCI 117,A01,494376,Staff,0,2,5,5
1713517865371,WES 237B,A00,494380,Staff,19,0,20,1
1713517867434,AESE 279B,A00,494370,Wade; Jon P,33,0,33,0
1713517868460,AIP 197,001,627712,Vespa; Emanuel Ignacio,9999,0,9999,0
1713517869486,ANAR 135S,A00,494369,Braswell; Geoffrey E.,0,0,0,0
1713517870510,CAT 124RS,A01,519847,Geibel; William,6,0,20,14
1713517871539,CAT 125RS,A01,515971,Geibel; William,6,0,20,14
1713517872568,CLRE 250,A00,511389,Morris; Sheldon,9996,0,9999,3
1713517873599,CLRE 251,A00,507176,Mehta; Ravindra L.,9996,0,9999,3
1713517873599,CLRE 251,B00,511410,Mehta; Ravindra L.,9998,0,9999,1
1713517874627,CLRE 252,A00,507189,Cuomo; Raphael Eduardo,9998,0,9999,1
1713517875659,CLRE 253,A00,507199,Vaida; Florin,9997,0,9999,2
1713517875659,CLRE 253,B00,507202,Vaida; Florin,9999,0,9999,0
1713517876683,CLRE 259,A00,507211,Patel; Hemal,9996,0,9999,3
1713517877707,CLRE 260,A00,507221,Cuomo; Raphael Eduardo,9999,0,9999,0
1713517878738,CLRE 297,001,507242,Cuomo; Raphael Eduardo,9999,0,9999,0
1713517879766,CSE 191,A00,516875,Minnes Kemp; Mor Mia,9999,0,9999,0
1713517880791,CSS 201S,A01,494383,Staff,35,0,35,0
1713517881818,CSS 202S,A01,494387,Staff,35,0,35,0
1713517882843,EAP 100,A00,516065,Staff,9792,0,9999,207
1713517883871,ECE 45,A01,507414,Staff,37,0,60,23
1713517884897,ECE 100,A01,507416,Baghdadchi; Saharnaz,0,0,20,20
1713517884897,ECE 100,A02,507418,Baghdadchi; Saharnaz,19,0,20,1
1713517885923,ECE 111,A01,507420,Staff,27,0,50,23
1713517886953,ECE 197,001,548057,Sievenpiper; Daniel F.,9998,0,9999,1
1713517887984,EDS 115,A00,507243,Choi; Bailey Miyeon,27,0,28,1
1713517889015,EDS 117,A01,494379,Staff,14,0,25,11
1713517890041,EDS 125,A00,507246,Hopkins; Megan Beth,27,0,30,3
1713517891066,EDS 128A,A01,507264,Fargason; Sharon Gayle,26,0,26,0
1713517892092,EDS 128B,A01,507293,Pappas; Elizabeth,30,0,30,0
1713517893119,EDS 139,A00,507294,Fargason; Sharon Gayle,30,0,30,0
1713517893119,EDS 139,B00,507313,Pappas; Elizabeth,30,0,30,0
1713517894144,EDS 201,A00,507315,Staff,18,0,30,12
1713517895174,EDS 203,A01,507317,Halter; Christopher P.,17,0,30,13
1713517896200,EDS 204R,A01,507319,Halter; Christopher P.,0,1,30,30
1713517896200,EDS 204R,B01,507331,Heinzman; Erica M.,22,0,30,8
1713517897226,EDS 206R,A00,507332,Staff,0,2,30,30
1713517897226,EDS 206R,B00,507343,Staff,23,0,30,7
1713517898255,EDS 250,A00,507344,Hemans; Patricia Ann Benitez,27,0,40,13
1713517899280,EDS 281,A00,507345,Daly; Alan J.,18,0,18,0
1713517900310,EDS 284,A00,507350,Daly; Alan J.,16,0,16,0
1713517901335,EDS 286,A00,507359,Fine; Sarah,18,0,18,0
1713517902360,EDS 289C,A01,507361,Daly; Alan J.,18,0,18,0
1713517903384,EDS 290,A00,507366,Hofstetter; Carolyn,15,0,15,0
1713517904412,LIGM 5A,A00,507421,Fischer-Grunski; Eva K,20,0,20,0
1713517905438,LIGM 5B,A00,507423,Fischer-Grunski; Eva K,20,0,20,0
1713517906467,LIGM 5C,A00,507425,Fischer-Grunski; Eva K,20,0,20,0
1713517907493,LIIT 5AS,A00,507427,Carnelos; Chiara,20,0,20,0
1713517908518,LIIT 5BS,A00,507430,Carnelos; Chiara,20,0,20,0
1713517909544,LIIT 5CS,A00,507432,Carnelos; Chiara,20,0,20,0
1713517910571,LISP 5A,A00,507541,Munoz Sanchez; Alicia,14,0,20,6
1713517911598,LISP 5B,A00,507671,Munoz Sanchez; Alicia,12,0,20,8
1713517912628,LISP 5C,A00,507696,Munoz Sanchez; Alicia,11,0,20,9
1713517913653,MAE 197,001,528363,Boechler; Nicholas Sebastia,9998,0,9999,1
1713517914680,MATH 197,001,523477,Kedlaya; Kiran S.,9999,0,9999,0
1713517914680,MATH 197,002,563811,Zhang; Danna,9998,0,9999,1
1713517915704,MCWP 40R,A00,518780,Staff,13,0,20,7
1713517915704,MCWP 40R,B00,518781,Staff,11,0,20,9
1713517915704,MCWP 40R,C00,518783,Staff,8,0,20,12
1713517916732,MCWP 50R,A00,518791,Staff,7,0,20,13
1713517916732,MCWP 50R,B00,518792,Staff,3,0,20,17
1713517916732,MCWP 50R,C00,518793,Staff,5,0,20,15
1713517916732,MCWP 50R,D00,518794,Staff,0,0,20,20
1713517916732,MCWP 50R,E00,518795,Staff,0,0,20,20
1713517916732,MCWP 50R,F00,518796,Staff,10,0,20,10
1713517916732,MCWP 50R,G00,518797,Staff,10,0,20,10
1713517917760,MMW 12R,A01,514034,Herbst; Matthew,1,0,16,15
1713517917760,MMW 12R,A02,514035,Herbst; Matthew,13,0,16,3
1713517918791,MMW 13R,A01,514037,Staff,0,8,16,16
1713517918791,MMW 13R,A02,514039,Staff,0,7,16,16
1713517920845,SIO 295LS,A00,523233,Staff,15,0,30,15
1713517921874,SIO 295S,A00,523232,Staff,15,0,30,15
1713517922903,SOCI 117,A01,494376,Staff,0,2,5,5
1713517923932,WES 237B,A00,494380,Staff,19,0,20,1
1713517926005,AESE 279B,A00,494370,Wade; Jon P,33,0,33,0
1713517927031,AIP 197,001,627712,Vespa; Emanuel Ignacio,9999,0,9999,0
1713517928057,ANAR 135S,A00,494369,Braswell; Geoffrey E.,0,0,0,0
1713517929083,CAT 124RS,A01,519847,Geibel; William,6,0,20,14
1713517930109,CAT 125RS,A01,515971,Geibel; William,6,0,20,14
1713517931140,CLRE 250,A00,511389,Morris; Sheldon,9996,0,9999,3
1713517932167,CLRE 251,A00,507176,Mehta; Ravindra L.,9996,0,9999,3
1713517932167,CLRE 251,B00,511410,Mehta; Ravindra L.,9998,0,9999,1
1713517933196,CLRE 252,A00,507189,Cuomo; Raphael Eduardo,9998,0,9999,1
1713517934226,CLRE 253,A00,507199,Vaida; Florin,9997,0,9999,2
1713517934226,CLRE 253,B00,507202,Vaida; Florin,9999,0,9999,0
1713517935253,CLRE 259,A00,507211,Patel; Hemal,9996,0,9999,3
1713517936279,CLRE 260,A00,507221,Cuomo; Raphael Eduardo,9999,0,9999,0
1713517937305,CLRE 297,001,507242,Cuomo; Raphael Eduardo,9999,0,9999,0
1713517938329,CSE 191,A00,516875,Minnes Kemp; Mor Mia,9999,0,9999,0
1713517939359,CSS 201S,A01,494383,Staff,35,0,35,0
1713517940385,CSS 202S,A01,494387,Staff,35,0,35,0
1713517941412,EAP 100,A00,516065,Staff,9792,0,9999,207
1713517942437,ECE 45,A01,507414,Staff,37,0,60,23
1713517943468,ECE 100,A01,507416,Baghdadchi; Saharnaz,0,0,20,20
1713517943468,ECE 100,A02,507418,Baghdadchi; Saharnaz,19,0,20,1
1713517944496,ECE 111,A01,507420,Staff,27,0,50,23
1713517945524,ECE 197,001,548057,Sievenpiper; Daniel F.,9998,0,9999,1
1713517946556,EDS 115,A00,507243,Choi; Bailey Miyeon,27,0,28,1
1713517947580,EDS 117,A01,494379,Staff,14,0,25,11
1713517948604,EDS 125,A00,507246,Hopkins; Megan Beth,27,0,30,3
1713517949629,EDS 128A,A01,507264,Fargason; Sharon Gayle,26,0,26,0
1713517950655,EDS 128B,A01,507293,Pappas; Elizabeth,30,0,30,0
1713517951684,EDS 139,A00,507294,Fargason; Sharon Gayle,30,0,30,0
1713517951684,EDS 139,B00,507313,Pappas; Elizabeth,30,0,30,0
1713517952709,EDS 201,A00,507315,Staff,18,0,30,12
1713517953738,EDS 203,A01,507317,Halter; Christopher P.,17,0,30,13
1713517954764,EDS 204R,A01,507319,Halter; Christopher P.,0,1,30,30
1713517954764,EDS 204R,B01,507331,Heinzman; Erica M.,22,0,30,8
1713517955845,EDS 206R,A00,507332,Staff,0,2,30,30
1713517955845,EDS 206R,B00,507343,Staff,23,0,30,7
1713517956871,EDS 250,A00,507344,Hemans; Patricia Ann Benitez,27,0,40,13
1713517957895,EDS 281,A00,507345,Daly; Alan J.,18,0,18,0
1713517958919,EDS 284,A00,507350,Daly; Alan J.,16,0,16,0
1713517959947,EDS 286,A00,507359,Fine; Sarah,18,0,18,0
1713517960976,EDS 289C,A01,507361,Daly; Alan J.,18,0,18,0
1713517962002,EDS 290,A00,507366,Hofstetter; Carolyn,15,0,15,0
1713517963031,LIGM 5A,A00,507421,Fischer-Grunski; Eva K,20,0,20,0
1713517964057,LIGM 5B,A00,507423,Fischer-Grunski; Eva K,20,0,20,0
1713517965084,LIGM 5C,A00,507425,Fischer-Grunski; Eva K,20,0,20,0
1713517966109,LIIT 5AS,A00,507427,Carnelos; Chiara,20,0,20,0
1713517967134,LIIT 5BS,A00,507430,Carnelos; Chiara,20,0,20,0
1713517968164,LIIT 5CS,A00,507432,Carnelos; Chiara,20,0,20,0
1713517969191,LISP 5A,A00,507541,Munoz Sanchez; Alicia,14,0,20,6
1713517970217,LISP 5B,A00,507671,Munoz Sanchez; Alicia,12,0,20,8
1713517971249,LISP 5C,A00,507696,Munoz Sanchez; Alicia,11,0,20,9
1713517972275,MAE 197,001,528363,Boechler; Nicholas Sebastia,9998,0,9999,1
1713517973301,MATH 197,001,523477,Kedlaya; Kiran S.,9999,0,9999,0
1713517973301,MATH 197,002,563811,Zhang; Danna,9998,0,9999,1
1713517974332,MCWP 40R,A00,518780,Staff,13,0,20,7
1713517974332,MCWP 40R,B00,518781,Staff,11,0,20,9
1713517974332,MCWP 40R,C00,518783,Staff,8,0,20,12
1713517975363,MCWP 50R,A00,518791,Staff,7,0,20,13
1713517975363,MCWP 50R,B00,518792,Staff,3,0,20,17
1713517975363,MCWP 50R,C00,518793,Staff,5,0,20,15
1713517975363,MCWP 50R,D00,518794,Staff,0,0,20,20
1713517975363,MCWP 50R,E00,518795,Staff,0,0,20,20
1713517975363,MCWP 50R,F00,518796,Staff,10,0,20,10
1713517975363,MCWP 50R,G00,518797,Staff,10,0,20,10
1713517976393,MMW 12R,A01,514034,Herbst; Matthew,1,0,16,15
1713517976393,MMW 12R,A02,514035,Herbst; Matthew,13,0,16,3
1713517977422,MMW 13R,A01,514037,Staff,0,8,16,16
1713517977422,MMW 13R,A02,514039,Staff,0,7,16,16
1713517979480,SIO 295LS,A00,523233,Staff,15,0,30,15
1713517980508,SIO 295S,A00,523232,Staff,15,0,30,15
1713517981532,SOCI 117,A01,494376,Staff,0,2,5,5
1713517982557,WES 237B,A00,494380,Staff,19,0,20,1
1713517984620,AESE 279B,A00,494370,Wade; Jon P,33,0,33,0
1713517985644,AIP 197,001,627712,Vespa; Emanuel Ignacio,9999,0,9999,0
1713517986670,ANAR 135S,A00,494369,Braswell; Geoffrey E.,0,0,0,0
1713517987700,CAT 124RS,A01,519847,Geibel; William,6,0,20,14
1713517988725,CAT 125RS,A01,515971,Geibel; William,6,0,20,14
1713517989756,CLRE 250,A00,511389,Morris; Sheldon,9996,0,9999,3
1713517990788,CLRE 251,A00,507176,Mehta; Ravindra L.,9996,0,9999,3
1713517990788,CLRE 251,B00,511410,Mehta; Ravindra L.,9998,0,9999,1
1713517991814,CLRE 252,A00,507189,Cuomo; Raphael Eduardo,9998,0,9999,1
1713517992839,CLRE 253,A00,507199,Vaida; Florin,9997,0,9999,2
1713517992839,CLRE 253,B00,507202,Vaida; Florin,9999,0,9999,0
1713517993865,CLRE 259,A00,507211,Patel; Hemal,9996,0,9999,3
1713517994890,CLRE 260,A00,507221,Cuomo; Raphael Eduardo,9999,0,9999,0
1713517995915,CLRE 297,001,507242,Cuomo; Raphael Eduardo,9999,0,9999,0
1713517996941,CSE 191,A00,516875,Minnes Kemp; Mor Mia,9999,0,9999,0
1713517997971,CSS 201S,A01,494383,Staff,35,0,35,0
1713517999001,CSS 202S,A01,494387,Staff,35,0,35,0
1713518000027,EAP 100,A00,516065,Staff,9792,0,9999,207
1713518001060,ECE 45,A01,507414,Staff,37,0,60,23
1713518002086,ECE 100,A01,507416,Baghdadchi; Saharnaz,0,0,20,20
1713518002086,ECE 100,A02,507418,Baghdadchi; Saharnaz,19,0,20,1
1713518003116,ECE 111,A01,507420,Staff,27,0,50,23
1713518004141,ECE 197,001,548057,Sievenpiper; Daniel F.,9998,0,9999,1
1713518005165,EDS 115,A00,507243,Choi; Bailey Miyeon,27,0,28,1
1713518006190,EDS 117,A01,494379,Staff,14,0,25,11
1713518007219,EDS 125,A00,507246,Hopkins; Megan Beth,27,0,30,3
1713518008246,EDS 128A,A01,507264,Fargason; Sharon Gayle,26,0,26,0
1713518009279,EDS 128B,A01,507293,Pappas; Elizabeth,30,0,30,0
1713518010304,EDS 139,A00,507294,Fargason; Sharon Gayle,30,0,30,0
1713518010304,EDS 139,B00,507313,Pappas; Elizabeth,30,0,30,0
1713518011329,EDS 201,A00,507315,Staff,18,0,30,12
1713518012357,EDS 203,A01,507317,Halter; Christopher P.,17,0,30,13
1713518013383,EDS 204R,A01,507319,Halter; Christopher P.,0,1,30,30
1713518013383,EDS 204R,B01,507331,Heinzman; Erica M.,22,0,30,8
1713518014407,EDS 206R,A00,507332,Staff,0,2,30,30
1713518014407,EDS 206R,B00,507343,Staff,23,0,30,7
1713518015432,EDS 250,A00,507344,Hemans; Patricia Ann Benitez,27,0,40,13
1713518016458,EDS 281,A00,507345,Daly; Alan J.,18,0,18,0
1713518017481,EDS 284,A00,507350,Daly; Alan J.,16,0,16,0
1713518018511,EDS 286,A00,507359,Fine; Sarah,18,0,18,0
1713518019542,EDS 289C,A01,507361,Daly; Alan J.,18,0,18,0
1713518020573,EDS 290,A00,507366,Hofstetter; Carolyn,15,0,15,0
1713518021598,LIGM 5A,A00,507421,Fischer-Grunski; Eva K,20,0,20,0
1713518022624,LIGM 5B,A00,507423,Fischer-Grunski; Eva K,20,0,20,0
1713518023656,LIGM 5C,A00,507425,Fischer-Grunski; Eva K,20,0,20,0
1713518024682,LIIT 5AS,A00,507427,Carnelos; Chiara,20,0,20,0
1713518025707,LIIT 5BS,A00,507430,Carnelos; Chiara,20,0,20,0
1713518026734,LIIT 5CS,A00,507432,Carnelos; Chiara,20,0,20,0
1713518027765,LISP 5A,A00,507541,Munoz Sanchez; Alicia,14,0,20,6
1713518028797,LISP 5B,A00,507671,Munoz Sanchez; Alicia,12,0,20,8
1713518029826,LISP 5C,A00,507696,Munoz Sanchez; Alicia,11,0,20,9
1713518030854,MAE 197,001,528363,Boechler; Nicholas Sebastia,9998,0,9999,1
1713518031887,MATH 197,001,523477,Kedlaya; Kiran S.,9999,0,9999,0
1713518031887,MATH 197,002,563811,Zhang; Danna,9998,0,9999,1
1713518032912,MCWP 40R,A00,518780,Staff,13,0,20,7
1713518032912,MCWP 40R,B00,518781,Staff,11,0,20,9
1713518032912,MCWP 40R,C00,518783,Staff,8,0,20,12
1713518033938,MCWP 50R,A00,518791,Staff,7,0,20,13
1713518033938,MCWP 50R,B00,518792,Staff,3,0,20,17
1713518033938,MCWP 50R,C00,518793,Staff,5,0,20,15
1713518033938,MCWP 50R,D00,518794,Staff,0,0,20,20
1713518033938,MCWP 50R,E00,518795,Staff,0,0,20,20
1713518033938,MCWP 50R,F00,518796,Staff,10,0,20,10
1713518033938,MCWP 50R,G00,518797,Staff,10,0,20,10
1713518034966,MMW 12R,A01,514034,Herbst; Matthew,1,0,16,15
1713518034966,MMW 12R,A02,514035,Herbst; Matthew,13,0,16,3
1713518035993,MMW 13R,A01,514037,Staff,0,8,16,16
1713518035993,MMW 13R,A02,514039,Staff,0,7,16,16
1713518038053,SIO 295LS,A00,523233,Staff,15,0,30,15
1713518039079,SIO 295S,A00,523232,Staff,15,0,30,15
1713518040106,SOCI 117,A01,494376,Staff,0,2,5,5
1713518041132,WES 237B,A00,494380,Staff,19,0,20,1
1713518043219,AESE 279B,A00,494370,Wade; Jon P,33,0,33,0
1713518044249,AIP 197,001,627712,Vespa; Emanuel Ignacio,9999,0,9999,0
1713518045275,ANAR 135S,A00,494369,Braswell; Geoffrey E.,0,0,0,0
1713518046305,CAT 124RS,A01,519847,Geibel; William,6,0,20,14
1713518047330,CAT 125RS,A01,515971,Geibel; William,6,0,20,14
1713518048355,CLRE 250,A00,511389,Morris; Sheldon,9996,0,9999,3
1713518049383,CLRE 251,A00,507176,Mehta; Ravindra L.,9996,0,9999,3
1713518049383,CLRE 251,B00,511410,Mehta; Ravindra L.,9998,0,9999,1
1713518050409,CLRE 252,A00,507189,Cuomo; Raphael Eduardo,9998,0,9999,1
1713518051435,CLRE 253,A00,507199,Vaida; Florin,9997,0,9999,2
1713518051435,CLRE 253,B00,507202,Vaida; Florin,9999,0,9999,0
1713518052461,CLRE 259,A00,507211,Patel; Hemal,9996,0,9999,3
1713518053486,CLRE 260,A00,507221,Cuomo; Raphael Eduardo,9999,0,9999,0
1713518054511,CLRE 297,001,507242,Cuomo; Raphael Eduardo,9999,0,9999,0
1713518055536,CSE 191,A00,516875,Minnes Kemp; Mor Mia,9999,0,9999,0
1713518056566,CSS 201S,A01,494383,Staff,35,0,35,0
1713518057590,CSS 202S,A01,494387,Staff,35,0,35,0
1713518058615,EAP 100,A00,516065,Staff,9792,0,9999,207
1713518059693,ECE 45,A01,507414,Staff,37,0,60,23
1713518060723,ECE 100,A01,507416,Baghdadchi; Saharnaz,0,0,20,20
1713518060723,ECE 100,A02,507418,Baghdadchi; Saharnaz,19,0,20,1
1713518061749,ECE 111,A01,507420,Staff,27,0,50,23
1713518062775,ECE 197,001,548057,Sievenpiper; Daniel F.,9998,0,9999,1
1713518063805,EDS 115,A00,507243,Choi; Bailey Miyeon,27,0,28,1
1713518064831,EDS 117,A01,494379,Staff,14,0,25,11
1713518065857,EDS 125,A00,507246,Hopkins; Megan Beth,27,0,30,3
1713518066888,EDS 128A,A01,507264,Fargason; Sharon Gayle,26,0,26,0
1713518067921,EDS 128B,A01,507293,Pappas; Elizabeth,30,0,30,0
1713518068949,EDS 139,A00,507294,Fargason; Sharon Gayle,30,0,30,0
1713518068949,EDS 139,B00,507313,Pappas; Elizabeth,30,0,30,0
1713518069976,EDS 201,A00,507315,Staff,18,0,30,12
1713518071002,EDS 203,A01,507317,Halter; Christopher P.,17,0,30,13
1713518072033,EDS 204R,A01,507319,Halter; Christopher P.,0,1,30,30
1713518072033,EDS 204R,B01,507331,Heinzman; Erica M.,22,0,30,8
1713518073060,EDS 206R,A00,507332,Staff,0,2,30,30
1713518073060,EDS 206R,B00,507343,Staff,23,0,30,7
1713518074090,EDS 250,A00,507344,Hemans; Patricia Ann Benitez,27,0,40,13
1713518075119,EDS 281,A00,507345,Daly; Alan J.,18,0,18,0
1713518076145,EDS 284,A00,507350,Daly; Alan J.,16,0,16,0
1713518077171,EDS 286,A00,507359,Fine; Sarah,18,0,18,0
1713518078199,EDS 289C,A01,507361,Daly; Alan J.,18,0,18,0
1713518079224,EDS 290,A00,507366,Hofstetter; Carolyn,15,0,15,0
1713518080255,LIGM 5A,A00,507421,Fischer-Grunski; Eva K,20,0,20,0
1713518081291,LIGM 5B,A00,507423,Fischer-Grunski; Eva K,20,0,20,0
1713518082322,LIGM 5C,A00,507425,Fischer-Grunski; Eva K,20,0,20,0
1713518083347,LIIT 5AS,A00,507427,Carnelos; Chiara,20,0,20,0
1713518084372,LIIT 5BS,A00,507430,Carnelos; Chiara,20,0,20,0
1713518085402,LIIT 5CS,A00,507432,Carnelos; Chiara,20,0,20,0
1713518086433,LISP 5A,A00,507541,Munoz Sanchez; Alicia,14,0,20,6
1713518087458,LISP 5B,A00,507671,Munoz Sanchez; Alicia,12,0,20,8
1713518088484,LISP 5C,A00,507696,Munoz Sanchez; Alicia,11,0,20,9
1713518089514,MAE 197,001,528363,Boechler; Nicholas Sebastia,9998,0,9999,1
1713518090541,MATH 197,001,523477,Kedlaya; Kiran S.,9999,0,9999,0
1713518090541,MATH 197,002,563811,Zhang; Danna,9998,0,9999,1
1713518091568,MCWP 40R,A00,518780,Staff,13,0,20,7
1713518091568,MCWP 40R,B00,518781,Staff,11,0,20,9
1713518091568,MCWP 40R,C00,518783,Staff,8,0,20,12
1713518092599,MCWP 50R,A00,518791,Staff,7,0,20,13
1713518092599,MCWP 50R,B00,518792,Staff,3,0,20,17
1713518092599,MCWP 50R,C00,518793,Staff,5,0,20,15
1713518092599,MCWP 50R,D00,518794,Staff,0,0,20,20
1713518092599,MCWP 50R,E00,518795,Staff,0,0,20,20
1713518092599,MCWP 50R,F00,518796,Staff,10,0,20,10
1713518092599,MCWP 50R,G00,518797,Staff,10,0,20,10
1713518093624,MMW 12R,A01,514034,Herbst; Matthew,1,0,16,15
1713518093624,MMW 12R,A02,514035,Herbst; Matthew,13,0,16,3
1713518094656,MMW 13R,A01,514037,Staff,0,8,16,16
1713518094656,MMW 13R,A02,514039,Staff,0,7,16,16
1713518096714,SIO 295LS,A00,523233,Staff,15,0,30,15
1713518097743,SIO 295S,A00,523232,Staff,15,0,30,15
1713518098772,SOCI 117,A01,494376,Staff,0,2,5,5
1713518099801,WES 237B,A00,494380,Staff,19,0,20,1
1713518101866,AESE 279B,A00,494370,Wade; Jon P,33,0,33,0
1713518102892,AIP 197,001,627712,Vespa; Emanuel Ignacio,9999,0,9999,0
1713518103922,ANAR 135S,A00,494369,Braswell; Geoffrey E.,0,0,0,0
1713518104949,CAT 124RS,A01,519847,Geibel; William,6,0,20,14
1713518105977,CAT 125RS,A01,515971,Geibel; William,6,0,20,14
1713518107008,CLRE 250,A00,511389,Morris; Sheldon,9996,0,9999,3
1713518108043,CLRE 251,A00,507176,Mehta; Ravindra L.,9996,0,9999,3
1713518108043,CLRE 251,B00,511410,Mehta; Ravindra L.,9998,0,9999,1
1713518109072,CLRE 252,A00,507189,Cuomo; Raphael Eduardo,9998,0,9999,1
1713518110097,CLRE 253,A00,507199,Vaida; Florin,9997,0,9999,2
1713518110097,CLRE 253,B00,507202,Vaida; Florin,9999,0,9999,0
1713518111123,CLRE 259,A00,507211,Patel; Hemal,9996,0,9999,3
1713518112148,CLRE 260,A00,507221,Cuomo; Raphael Eduardo,9999,0,9999,0
1713518113177,CLRE 297,001,507242,Cuomo; Raphael Eduardo,9999,0,9999,0
1713518114205,CSE 191,A00,516875,Minnes Kemp; Mor Mia,9999,0,9999,0
1713518115230,CSS 201S,A01,494383,Staff,35,0,35,0
1713518116260,CSS 202S,A01,494387,Staff,35,0,35,0
1713518117286,EAP 100,A00,516065,Staff,9792,0,9999,207
1713518118312,ECE 45,A01,507414,Staff,37,0,60,23
1713518119342,ECE 100,A01,507416,Baghdadchi; Saharnaz,0,0,20,20
1713518119342,ECE 100,A02,507418,Baghdadchi; Saharnaz,19,0,20,1
1713518120371,ECE 111,A01,507420,Staff,27,0,50,23
1713518121399,ECE 197,001,548057,Sievenpiper; Daniel F.,9998,0,9999,1
1713518122426,EDS 115,A00,507243,Choi; Bailey Miyeon,27,0,28,1
1713518123451,EDS 117,A01,494379,Staff,14,0,25,11
1713518124481,EDS 125,A00,507246,Hopkins; Megan Beth,27,0,30,3
1713518125509,EDS 128A,A01,507264,Fargason; Sharon Gayle,26,0,26,0
1713518126533,EDS 128B,A01,507293,Pappas; Elizabeth,30,0,30,0
1713518127558,EDS 139,A00,507294,Fargason; Sharon Gayle,30,0,30,0
1713518127558,EDS 139,B00,507313,Pappas; Elizabeth,30,0,30,0
1713518128583,EDS 201,A00,507315,Staff,18,0,30,12
1713518129611,EDS 203,A01,507317,Halter; Christopher P.,17,0,30,13
1713518130641,EDS 204R,A01,507319,Halter; Christopher P.,0,1,30,30
1713518130641,EDS 204R,B01,507331,Heinzman; Erica M.,22,0,30,8
1713518131670,EDS 206R,A00,507332,Staff,0,2,30,30
1713518131670,EDS 206R,B00,507343,Staff,23,0,30,7
1713518132696,EDS 250,A00,507344,Hemans; Patricia Ann Benitez,27,0,40,13
1713518133724,EDS 281,A00,507345,Daly; Alan J.,18,0,18,0
1713518134748,EDS 284,A00,507350,Daly; Alan J.,16,0,16,0
1713518135779,EDS 286,A00,507359,Fine; Sarah,18,0,18,0
1713518136807,EDS 289C,A01,507361,Daly; Alan J.,18,0,18,0
1713518137833,EDS 290,A00,507366,Hofstetter; Carolyn,15,0,15,0
1713518138864,LIGM 5A,A00,507421,Fischer-Grunski; Eva K,20,0,20,0
1713518139893,LIGM 5B,A00,507423,Fischer-Grunski; Eva K,20,0,20,0
1713518140925,LIGM 5C,A00,507425,Fischer-Grunski; Eva K,20,0,20,0
1713518141956,LIIT 5AS,A00,507427,Carnelos; Chiara,20,0,20,0
1713518142986,LIIT 5BS,A00,507430,Carnelos; Chiara,20,0,20,0
1713518144021,LIIT 5CS,A00,507432,Carnelos; Chiara,20,0,20,0
1713518145050,LISP 5A,A00,507541,Munoz Sanchez; Alicia,14,0,20,6
1713518146075,LISP 5B,A00,507671,Munoz Sanchez; Alicia,12,0,20,8
1713518147105,LISP 5C,A00,507696,Munoz Sanchez; Alicia,11,0,20,9
1713518148135,MAE 197,001,528363,Boechler; Nicholas Sebastia,9998,0,9999,1
1713518149166,MATH 197,001,523477,Kedlaya; Kiran S.,9999,0,9999,0
1713518149166,MATH 197,002,563811,Zhang; Danna,9998,0,9999,1
1713518150193,MCWP 40R,A00,518780,Staff,13,0,20,7
1713518150193,MCWP 40R,B00,518781,Staff,11,0,20,9
1713518150193,MCWP 40R,C00,518783,Staff,8,0,20,12
1713518151219,MCWP 50R,A00,518791,Staff,7,0,20,13
1713518151219,MCWP 50R,B00,518792,Staff,3,0,20,17
1713518151219,MCWP 50R,C00,518793,Staff,5,0,20,15
1713518151219,MCWP 50R,D00,518794,Staff,0,0,20,20
1713518151219,MCWP 50R,E00,518795,Staff,0,0,20,20
1713518151219,MCWP 50R,F00,518796,Staff,10,0,20,10
1713518151219,MCWP 50R,G00,518797,Staff,10,0,20,10
1713518152250,MMW 12R,A01,514034,Herbst; Matthew,1,0,16,15
1713518152250,MMW 12R,A02,514035,Herbst; Matthew,13,0,16,3
1713518153279,MMW 13R,A01,514037,Staff,0,8,16,16
1713518153279,MMW 13R,A02,514039,Staff,0,7,16,16
1713518155330,SIO 295LS,A00,523233,Staff,15,0,30,15
1713518156358,SIO 295S,A00,523232,Staff,15,0,30,15
1713518157384,SOCI 117,A01,494376,Staff,0,2,5,5
1713518158410,WES 237B,A00,494380,Staff,19,0,20,1
1713518160481,AESE 279B,A00,494370,Wade; Jon P,33,0,33,0
1713518161510,AIP 197,001,627712,Vespa; Emanuel Ignacio,9999,0,9999,0
1713518162536,ANAR 135S,A00,494369,Braswell; Geoffrey E.,0,0,0,0
1713518163619,CAT 124RS,A01,519847,Geibel; William,6,0,20,14
1713518164644,CAT 125RS,A01,515971,Geibel; William,6,0,20,14
1713518165675,CLRE 250,A00,511389,Morris; Sheldon,9996,0,9999,3
1713518166703,CLRE 251,A00,507176,Mehta; Ravindra L.,9996,0,9999,3
1713518166703,CLRE 251,B00,511410,Mehta; Ravindra L.,9998,0,9999,1
1713518167729,CLRE 252,A00,507189,Cuomo; Raphael Eduardo,9998,0,9999,1
1713518168755,CLRE 253,A00,507199,Vaida; Florin,9997,0,9999,2
1713518168755,CLRE 253,B00,507202,Vaida; Florin,9999,0,9999,0
1713518169781,CLRE 259,A00,507211,Patel; Hemal,9996,0,9999,3
1713518170806,CLRE 260,A00,507221,Cuomo; Raphael Eduardo,9999,0,9999,0
1713518171837,CLRE 297,001,507242,Cuomo; Raphael Eduardo,9999,0,9999,0
1713518172865,CSE 191,A00,516875,Minnes Kemp; Mor Mia,9999,0,9999,0
1713518173901,CSS 201S,A01,494383,Staff,35,0,35,0
1713518174927,CSS 202S,A01,494387,Staff,35,0,35,0
1713518175953,EAP 100,A00,516065,Staff,9792,0,9999,207
1713518176979,ECE 45,A01,507414,Staff,37,0,60,23
1713518178005,ECE 100,A01,507416,Baghdadchi; Saharnaz,0,0,20,20
1713518178005,ECE 100,A02,507418,Baghdadchi; Saharnaz,19,0,20,1
1713518179030,ECE 111,A01,507420,Staff,27,0,50,23
1713518180059,ECE 197,001,548057,Sievenpiper; Daniel F.,9998,0,9999,1
1713518181090,EDS 115,A00,507243,Choi; Bailey Miyeon,27,0,28,1
1713518182117,EDS 117,A01,494379,Staff,14,0,25,11
1713518183152,EDS 125,A00,507246,Hopkins; Megan Beth,27,0,30,3
1713518184182,EDS 128A,A01,507264,Fargason; Sharon Gayle,26,0,26,0
1713518185208,EDS 128B,A01,507293,Pappas; Elizabeth,30,0,30,0
1713518186236,EDS 139,A00,507294,Fargason; Sharon Gayle,30,0,30,0
1713518186236,EDS 139,B00,507313,Pappas; Elizabeth,30,0,30,0
1713518187266,EDS 201,A00,507315,Staff,18,0,30,12
1713518188291,EDS 203,A01,507317,Halter; Christopher P.,17,0,30,13
1713518189320,EDS 204R,A01,507319,Halter; Christopher P.,0,1,30,30
1713518189320,EDS 204R,B01,507331,Heinzman; Erica M.,22,0,30,8
1713518190348,EDS 206R,A00,507332,Staff,0,2,30,30
1713518190348,EDS 206R,B00,507343,Staff,23,0,30,7
1713518191373,EDS 250,A00,507344,Hemans; Patricia Ann Benitez,27,0,40,13
1713518192403,EDS 281,A00,507345,Daly; Alan J.,18,0,18,0
1713518193431,EDS 284,A00,507350,Daly; Alan J.,16,0,16,0
1713518194461,EDS 286,A00,507359,Fine; Sarah,18,0,18,0
1713518195485,EDS 289C,A01,507361,Daly; Alan J.,18,0,18,0
1713518196512,EDS 290,A00,507366,Hofstetter; Carolyn,15,0,15,0
1713518197538,LIGM 5A,A00,507421,Fischer-Grunski; Eva K,20,0,20,0
1713518198565,LIGM 5B,A00,507423,Fischer-Grunski; Eva K,20,0,20,0
1713518199588,LIGM 5C,A00,507425,Fischer-Grunski; Eva K,20,0,20,0
1713518200614,LIIT 5AS,A00,507427,Carnelos; Chiara,20,0,20,0
1713518201640,LIIT 5BS,A00,507430,Carnelos; Chiara,20,0,20,0
1713518202665,LIIT 5CS,A00,507432,Carnelos; Chiara,20,0,20,0
1713518203689,LISP 5A,A00,507541,Munoz Sanchez; Alicia,14,0,20,6
1713518204722,LISP 5B,A00,507671,Munoz Sanchez; Alicia,12,0,20,8
1713518205751,LISP 5C,A00,507696,Munoz Sanchez; Alicia,11,0,20,9
1713518206779,MAE 197,001,528363,Boechler; Nicholas Sebastia,9998,0,9999,1
1713518207805,MATH 197,001,523477,Kedlaya; Kiran S.,9999,0,9999,0
1713518207805,MATH 197,002,563811,Zhang; Danna,9998,0,9999,1
1713518208832,MCWP 40R,A00,518780,Staff,13,0,20,7
1713518208832,MCWP 40R,B00,518781,Staff,11,0,20,9
1713518208832,MCWP 40R,C00,518783,Staff,8,0,20,12
1713518209859,MCWP 50R,A00,518791,Staff,7,0,20,13
1713518209859,MCWP 50R,B00,518792,Staff,3,0,20,17
1713518209859,MCWP 50R,C00,518793,Staff,5,0,20,15
1713518209859,MCWP 50R,D00,518794,Staff,0,0,20,20
1713518209859,MCWP 50R,E00,518795,Staff,0,0,20,20
1713518209859,MCWP 50R,F00,518796,Staff,10,0,20,10
1713518209859,MCWP 50R,G00,518797,Staff,10,0,20,10
1713518210888,MMW 12R,A01,514034,Herbst; Matthew,1,0,16,15
1713518210888,MMW 12R,A02,514035,Herbst; Matthew,13,0,16,3
1713518211913,MMW 13R,A01,514037,Staff,0,8,16,16
1713518211913,MMW 13R,A02,514039,Staff,0,7,16,16
1713518213966,SIO 295LS,A00,523233,Staff,15,0,30,15
1713518214992,SIO 295S,A00,523232,Staff,15,0,30,15
1713518216018,SOCI 117,A01,494376,Staff,0,2,5,5
1713518217044,WES 237B,A00,494380,Staff,19,0,20,1
1713518219113,AESE 279B,A00,494370,Wade; Jon P,33,0,33,0
1713518220148,AIP 197,001,627712,Vespa; Emanuel Ignacio,9999,0,9999,0
1713518221179,ANAR 135S,A00,494369,Braswell; Geoffrey E.,0,0,0,0
1713518222204,CAT 124RS,A01,519847,Geibel; William,6,0,20,14
1713518223229,CAT 125RS,A01,515971,Geibel; William,6,0,20,14
1713518224255,CLRE 250,A00,511389,Morris; Sheldon,9996,0,9999,3
1713518225284,CLRE 251,A00,507176,Mehta; Ravindra L.,9996,0,9999,3
1713518225284,CLRE 251,B00,511410,Mehta; Ravindra L.,9998,0,9999,1
1713518226310,CLRE 252,A00,507189,Cuomo; Raphael Eduardo,9998,0,9999,1
1713518227340,CLRE 253,A00,507199,Vaida; Florin,9997,0,9999,2
1713518227340,CLRE 253,B00,507202,Vaida; Florin,9999,0,9999,0
1713518228366,CLRE 259,A00,507211,Patel; Hemal,9996,0,9999,3
1713518229391,CLRE 260,A00,507221,Cuomo; Raphael Eduardo,9999,0,9999,0
1713518230416,CLRE 297,001,507242,Cuomo; Raphael Eduardo,9999,0,9999,0
1713518231441,CSE 191,A00,516875,Minnes Kemp; Mor Mia,9999,0,9999,0
1713518232476,CSS 201S,A01,494383,Staff,35,0,35,0
1713518233503,CSS 202S,A01,494387,Staff,35,0,35,0
1713518234532,EAP 100,A00,516065,Staff,9792,0,9999,207
1713518235558,ECE 45,A01,507414,Staff,37,0,60,23
1713518236584,ECE 100,A01,507416,Baghdadchi; Saharnaz,0,0,20,20
1713518236584,ECE 100,A02,507418,Baghdadchi; Saharnaz,19,0,20,1
1713518237613,ECE 111,A01,507420,Staff,27,0,50,23
1713518238641,ECE 197,001,548057,Sievenpiper; Daniel F.,9998,0,9999,1
1713518239669,EDS 115,A00,507243,Choi; Bailey Miyeon,27,0,28,1
1713518240697,EDS 117,A01,494379,Staff,14,0,25,11
1713518241722,EDS 125,A00,507246,Hopkins; Megan Beth,27,0,30,3
1713518242753,EDS 128A,A01,507264,Fargason; Sharon Gayle,26,0,26,0
1713518243778,EDS 128B,A01,507293,Pappas; Elizabeth,30,0,30,0
1713518244802,EDS 139,A00,507294,Fargason; Sharon Gayle,30,0,30,0
1713518244802,EDS 139,B00,507313,Pappas; Elizabeth,30,0,30,0
1713518245830,EDS 201,A00,507315,Staff,18,0,30,12
1713518246857,EDS 203,A01,507317,Halter; Christopher P.,17,0,30,13
1713518247882,EDS 204R,A01,507319,Halter; Christopher P.,0,1,30,30
1713518247882,EDS 204R,B01,507331,Heinzman; Erica M.,22,0,30,8
1713518248908,EDS 206R,A00,507332,Staff,0,2,30,30
1713518248908,EDS 206R,B00,507343,Staff,23,0,30,7
1713518249934,EDS 250,A00,507344,Hemans; Patricia Ann Benitez,27,0,40,13
1713518250959,EDS 281,A00,507345,Daly; Alan J.,18,0,18,0
1713518251988,EDS 284,A00,507350,Daly; Alan J.,16,0,16,0
1713518253014,EDS 286,A00,507359,Fine; Sarah,18,0,18,0
1713518254039,EDS 289C,A01,507361,Daly; Alan J.,18,0,18,0
1713518255064,EDS 290,A00,507366,Hofstetter; Carolyn,15,0,15,0
1713518256089,LIGM 5A,A00,507421,Fischer-Grunski; Eva K,20,0,20,0
1713518257114,LIGM 5B,A00,507423,Fischer-Grunski; Eva K,20,0,20,0
1713518258140,LIGM 5C,A00,507425,Fischer-Grunski; Eva K,20,0,20,0
1713518259166,LIIT 5AS,A00,507427,Carnelos; Chiara,20,0,20,0
1713518260194,LIIT 5BS,A00,507430,Carnelos; Chiara,20,0,20,0
1713518261220,LIIT 5CS,A00,507432,Carnelos; Chiara,20,0,20,0
1713518262251,LISP 5A,A00,507541,Munoz Sanchez; Alicia,14,0,20,6
1713518263276,LISP 5B,A00,507671,Munoz Sanchez; Alicia,12,0,20,8
1713518264306,LISP 5C,A00,507696,Munoz Sanchez; Alicia,11,0,20,9
1713518265334,MAE 197,001,528363,Boechler; Nicholas Sebastia,9998,0,9999,1
1713518266360,MATH 197,001,523477,Kedlaya; Kiran S.,9999,0,9999,0
1713518266360,MATH 197,002,563811,Zhang; Danna,9998,0,9999,1
1713518267443,MCWP 40R,A00,518780,Staff,13,0,20,7
1713518267443,MCWP 40R,B00,518781,Staff,11,0,20,9
1713518267443,MCWP 40R,C00,518783,Staff,8,0,20,12
1713518268469,MCWP 50R,A00,518791,Staff,7,0,20,13
1713518268469,MCWP 50R,B00,518792,Staff,3,0,20,17
1713518268469,MCWP 50R,C00,518793,Staff,5,0,20,15
1713518268469,MCWP 50R,D00,518794,Staff,0,0,20,20
1713518268469,MCWP 50R,E00,518795,Staff,0,0,20,20
1713518268469,MCWP 50R,F00,518796,Staff,10,0,20,10
1713518268469,MCWP 50R,G00,518797,Staff,10,0,20,10
1713518269495,MMW 12R,A01,514034,Herbst; Matthew,1,0,16,15
1713518269495,MMW 12R,A02,514035,Herbst; Matthew,13,0,16,3
1713518270520,MMW 13R,A01,514037,Staff,0,8,16,16
1713518270520,MMW 13R,A02,514039,Staff,0,7,16,16
1713518272578,SIO 295LS,A00,523233,Staff,15,0,30,15
1713518273606,SIO 295S,A00,523232,Staff,15,0,30,15
1713518274636,SOCI 117,A01,494376,Staff,0,2,5,5
1713518275665,WES 237B,A00,494380,Staff,19,0,20,1
1713518277739,AESE 279B,A00,494370,Wade; Jon P,33,0,33,0
1713518278765,AIP 197,001,627712,Vespa; Emanuel Ignacio,9999,0,9999,0
1713518279791,ANAR 135S,A00,494369,Braswell; Geoffrey E.,0,0,0,0
1713518280820,CAT 124RS,A01,519847,Geibel; William,6,0,20,14
1713518281844,CAT 125RS,A01,515971,Geibel; William,6,0,20,14
1713518282870,CLRE 250,A00,511389,Morris; Sheldon,9996,0,9999,3
1713518283906,CLRE 251,A00,507176,Mehta; Ravindra L.,9996,0,9999,3
1713518283906,CLRE 251,B00,511410,Mehta; Ravindra L.,9998,0,9999,1
1713518284931,CLRE 252,A00,507189,Cuomo; Raphael Eduardo,9998,0,9999,1
1713518285958,CLRE 253,A00,507199,Vaida; Florin,9997,0,9999,2
1713518285958,CLRE 253,B00,507202,Vaida; Florin,9999,0,9999,0
1713518286982,CLRE 259,A00,507211,Patel; Hemal,9996,0,9999,3
1713518288008,CLRE 260,A00,507221,Cuomo; Raphael Eduardo,9999,0,9999,0
1713518289033,CLRE 297,001,507242,Cuomo; Raphael Eduardo,9999,0,9999,0
1713518290059,CSE 191,A00,516875,Minnes Kemp; Mor Mia,9999,0,9999,0
1713518291085,CSS 201S,A01,494383,Staff,35,0,35,0
1713518292114,CSS 202S,A01,494387,Staff,35,0,35,0
1713518293140,EAP 100,A00,516065,Staff,9792,0,9999,207
1713518294170,ECE 45,A01,507414,Staff,37,0,60,23
1713518295195,ECE 100,A01,507416,Baghdadchi; Saharnaz,0,0,20,20
1713518295195,ECE 100,A02,507418,Baghdadchi; Saharnaz,19,0,20,1
1713518296223,ECE 111,A01,507420,Staff,27,0,50,23
1713518297248,ECE 197,001,548057,Sievenpiper; Daniel F.,9998,0,9999,1
1713518298274,EDS 115,A00,507243,Choi; Bailey Miyeon,27,0,28,1
1713518299298,EDS 117,A01,494379,Staff,14,0,25,11
1713518300324,EDS 125,A00,507246,Hopkins; Megan Beth,27,0,30,3
1713518301349,EDS 128A,A01,507264,Fargason; Sharon Gayle,26,0,26,0
1713518302374,EDS 128B,A01,507293,Pappas; Elizabeth,30,0,30,0
1713518303405,EDS 139,A00,507294,Fargason; Sharon Gayle,30,0,30,0
1713518303405,EDS 139,B00,507313,Pappas; Elizabeth,30,0,30,0
1713518304434,EDS 201,A00,507315,Staff,18,0,30,12
1713518305460,EDS 203,A01,507317,Halter; Christopher P.,17,0,30,13
1713518306486,EDS 204R,A01,507319,Halter; Christopher P.,0,1,30,30
1713518306486,EDS 204R,B01,507331,Heinzman; Erica M.,22,0,30,8
1713518307517,EDS 206R,A00,507332,Staff,0,2,30,30
1713518307517,EDS 206R,B00,507343,Staff,23,0,30,7
1713518308545,EDS 250,A00,507344,Hemans; Patricia Ann Benitez,27,0,40,13
1713518309571,EDS 281,A00,507345,Daly; Alan J.,18,0,18,0
1713518310602,EDS 284,A00,507350,Daly; Alan J.,16,0,16,0
1713518311628,EDS 286,A00,507359,Fine; Sarah,18,0,18,0
1713518312654,EDS 289C,A01,507361,Daly; Alan J.,18,0,18,0
1713518313679,EDS 290,A00,507366,Hofstetter; Carolyn,15,0,15,0
1713518314705,LIGM 5A,A00,507421,Fischer-Grunski; Eva K,20,0,20,0
1713518315734,LIGM 5B,A00,507423,Fischer-Grunski; Eva K,20,0,20,0
1713518316760,LIGM 5C,A00,507425,Fischer-Grunski; Eva K,20,0,20,0
1713518317785,LIIT 5AS,A00,507427,Carnelos; Chiara,20,0,20,0
1713518318810,LIIT 5BS,A00,507430,Carnelos; Chiara,20,0,20,0
1713518319836,LIIT 5CS,A00,507432,Carnelos; Chiara,20,0,20,0
1713518320863,LISP 5A,A00,507541,Munoz Sanchez; Alicia,14,0,20,6
1713518321889,LISP 5B,A00,507671,Munoz Sanchez; Alicia,12,0,20,8
1713518322916,LISP 5C,A00,507696,Munoz Sanchez; Alicia,11,0,20,9
1713518323942,MAE 197,001,528363,Boechler; Nicholas Sebastia,9998,0,9999,1
1713518324969,MATH 197,001,523477,Kedlaya; Kiran S.,9999,0,9999,0
1713518324969,MATH 197,002,563811,Zhang; Danna,9998,0,9999,1
1713518325995,MCWP 40R,A00,518780,Staff,13,0,20,7
1713518325995,MCWP 40R,B00,518781,Staff,11,0,20,9
1713518325995,MCWP 40R,C00,518783,Staff,8,0,20,12
1713518327023,MCWP 50R,A00,518791,Staff,7,0,20,13
1713518327023,MCWP 50R,B00,518792,Staff,3,0,20,17
1713518327023,MCWP 50R,C00,518793,Staff,5,0,20,15
1713518327023,MCWP 50R,D00,518794,Staff,0,0,20,20
1713518327023,MCWP 50R,E00,518795,Staff,0,0,20,20
1713518327023,MCWP 50R,F00,518796,Staff,10,0,20,10
1713518327023,MCWP 50R,G00,518797,Staff,10,0,20,10
1713518328050,MMW 12R,A01,514034,Herbst; Matthew,1,0,16,15
1713518328050,MMW 12R,A02,514035,Herbst; Matthew,13,0,16,3
1713518329078,MMW 13R,A01,514037,Staff,0,8,16,16
1713518329078,MMW 13R,A02,514039,Staff,0,7,16,16
1713518331137,SIO 295LS,A00,523233,Staff,15,0,30,15
1713518332167,SIO 295S,A00,523232,Staff,15,0,30,15
1713518333193,SOCI 117,A01,494376,Staff,0,2,5,5
1713518334222,WES 237B,A00,494380,Staff,19,0,20,1
1713518336295,AESE 279B,A00,494370,Wade; Jon P,33,0,33,0
1713518337321,AIP 197,001,627712,Vespa; Emanuel Ignacio,9999,0,9999,0
1713518338352,ANAR 135S,A00,494369,Braswell; Geoffrey E.,0,0,0,0
1713518339381,CAT 124RS,A01,519847,Geibel; William,6,0,20,14
1713518340423,CAT 125RS,A01,515971,Geibel; William,6,0,20,14
1713518341450,CLRE 250,A00,511389,Morris; Sheldon,9996,0,9999,3
1713518342482,CLRE 251,A00,507176,Mehta; Ravindra L.,9996,0,9999,3
1713518342482,CLRE 251,B00,511410,Mehta; Ravindra L.,9998,0,9999,1
1713518343511,CLRE 252,A00,507189,Cuomo; Raphael Eduardo,9998,0,9999,1
1713518344538,CLRE 253,A00,507199,Vaida; Florin,9997,0,9999,2
1713518344538,CLRE 253,B00,507202,Vaida; Florin,9999,0,9999,0
1713518345565,CLRE 259,A00,507211,Patel; Hemal,9996,0,9999,3
1713518346593,CLRE 260,A00,507221,Cuomo; Raphael Eduardo,9999,0,9999,0
1713518347620,CLRE 297,001,507242,Cuomo; Raphael Eduardo,9999,0,9999,0
1713518348645,CSE 191,A00,516875,Minnes Kemp; Mor Mia,9999,0,9999,0
1713518349673,CSS 201S,A01,494383,Staff,35,0,35,0
1713518350703,CSS 202S,A01,494387,Staff,35,0,35,0
1713518351731,EAP 100,A00,516065,Staff,9792,0,9999,207
1713518352760,ECE 45,A01,507414,Staff,37,0,60,23
1713518353787,ECE 100,A01,507416,Baghdadchi; Saharnaz,0,0,20,20
1713518353787,ECE 100,A02,507418,Baghdadchi; Saharnaz,19,0,20,1
1713518354813,ECE 111,A01,507420,Staff,27,0,50,23
1713518355843,ECE 197,001,548057,Sievenpiper; Daniel F.,9998,0,9999,1
1713518356868,EDS 115,A00,507243,Choi; Bailey Miyeon,27,0,28,1
1713518357897,EDS 117,A01,494379,Staff,14,0,25,11
1713518358929,EDS 125,A00,507246,Hopkins; Megan Beth,27,0,30,3
1713518359958,EDS 128A,A01,507264,Fargason; Sharon Gayle,26,0,26,0
1713518360986,EDS 128B,A01,507293,Pappas; Elizabeth,30,0,30,0
1713518362015,EDS 139,A00,507294,Fargason; Sharon Gayle,30,0,30,0
1713518362015,EDS 139,B00,507313,Pappas; Elizabeth,30,0,30,0
1713518363041,EDS 201,A00,507315,Staff,18,0,30,12
1713518364072,EDS 203,A01,507317,Halter; Christopher P.,17,0,30,13
1713518365098,EDS 204R,A01,507319,Halter; Christopher P.,0,1,30,30
1713518365098,EDS 204R,B01,507331,Heinzman; Erica M.,22,0,30,8
1713518366127,EDS 206R,A00,507332,Staff,0,2,30,30
1713518366127,EDS 206R,B00,507343,Staff,23,0,30,7
1713518367156,EDS 250,A00,507344,Hemans; Patricia Ann Benitez,27,0,40,13
1713518368180,EDS 281,A00,507345,Daly; Alan J.,18,0,18,0
1713518369210,EDS 284,A00,507350,Daly; Alan J.,16,0,16,0
1713518370234,EDS 286,A00,507359,Fine; Sarah,18,0,18,0
1713518371318,EDS 289C,A01,507361,Daly; Alan J.,18,0,18,0
1713518372344,EDS 290,A00,507366,Hofstetter; Carolyn,15,0,15,0
1713518373370,LIGM 5A,A00,507421,Fischer-Grunski; Eva K,20,0,20,0
1713518374398,LIGM 5B,A00,507423,Fischer-Grunski; Eva K,20,0,20,0
1713518375428,LIGM 5C,A00,507425,Fischer-Grunski; Eva K,20,0,20,0
1713518376453,LIIT 5AS,A00,507427,Carnelos; Chiara,20,0,20,0
1713518377484,LIIT 5BS,A00,507430,Carnelos; Chiara,20,0,20,0
1713518378511,LIIT 5CS,A00,507432,Carnelos; Chiara,20,0,20,0
1713518379541,LISP 5A,A00,507541,Munoz Sanchez; Alicia,14,0,20,6
1713518380570,LISP 5B,A00,507671,Munoz Sanchez; Alicia,12,0,20,8
1713518381596,LISP 5C,A00,507696,Munoz Sanchez; Alicia,11,0,20,9
1713518382621,MAE 197,001,528363,Boechler; Nicholas Sebastia,9998,0,9999,1
1713518383645,MATH 197,001,523477,Kedlaya; Kiran S.,9999,0,9999,0
1713518383645,MATH 197,002,563811,Zhang; Danna,9998,0,9999,1
1713518384675,MCWP 40R,A00,518780,Staff,13,0,20,7
1713518384675,MCWP 40R,B00,518781,Staff,11,0,20,9
1713518384675,MCWP 40R,C00,518783,Staff,8,0,20,12
1713518385707,MCWP 50R,A00,518791,Staff,7,0,20,13
1713518385707,MCWP 50R,B00,518792,Staff,3,0,20,17
1713518385707,MCWP 50R,C00,518793,Staff,5,0,20,15
1713518385707,MCWP 50R,D00,518794,Staff,0,0,20,20
1713518385707,MCWP 50R,E00,518795,Staff,0,0,20,20
1713518385707,MCWP 50R,F00,518796,Staff,10,0,20,10
1713518385707,MCWP 50R,G00,518797,Staff,10,0,20,10
1713518386737,MMW 12R,A01,514034,Herbst; Matthew,1,0,16,15
1713518386737,MMW 12R,A02,514035,Herbst; Matthew,13,0,16,3
1713518387762,MMW 13R,A01,514037,Staff,0,8,16,16
1713518387762,MMW 13R,A02,514039,Staff,0,7,16,16
1713518389813,SIO 295LS,A00,523233,Staff,15,0,30,15
1713518390843,SIO 295S,A00,523232,Staff,15,0,30,15
1713518391872,SOCI 117,A01,494376,Staff,0,2,5,5
1713518392897,WES 237B,A00,494380,Staff,19,0,20,1
1713518394959,AESE 279B,A00,494370,Wade; Jon P,33,0,33,0
1713518395984,AIP 197,001,627712,Vespa; Emanuel Ignacio,9999,0,9999,0
1713518397010,ANAR 135S,A00,494369,Braswell; Geoffrey E.,0,0,0,0
1713518398040,CAT 124RS,A01,519847,Geibel; William,6,0,20,14
1713518399065,CAT 125RS,A01,515971,Geibel; William,6,0,20,14
1713518400091,CLRE 250,A00,511389,Morris; Sheldon,9996,0,9999,3
1713518401125,CLRE 251,A00,507176,Mehta; Ravindra L.,9996,0,9999,3
1713518401125,CLRE 251,B00,511410,Mehta; Ravindra L.,9998,0,9999,1
1713518402152,CLRE 252,A00,507189,Cuomo; Raphael Eduardo,9998,0,9999,1
1713518403192,CLRE 253,A00,507199,Vaida; Florin,9997,0,9999,2
1713518403192,CLRE 253,B00,507202,Vaida; Florin,9999,0,9999,0
1713518404220,CLRE 259,A00,507211,Patel; Hemal,9996,0,9999,3
1713518405245,CLRE 260,A00,507221,Cuomo; Raphael Eduardo,9999,0,9999,0
1713518406270,CLRE 297,001,507242,Cuomo; Raphael Eduardo,9999,0,9999,0
1713518407295,CSE 191,A00,516875,Minnes Kemp; Mor Mia,9999,0,9999,0
1713518408320,CSS 201S,A01,494383,Staff,35,0,35,0
1713518409345,CSS 202S,A01,494387,Staff,35,0,35,0
1713518410375,EAP 100,A00,516065,Staff,9792,0,9999,207
1713518411404,ECE 45,A01,507414,Staff,37,0,60,23
1713518412434,ECE 100,A01,507416,Baghdadchi; Saharnaz,0,0,20,20
1713518412434,ECE 100,A02,507418,Baghdadchi; Saharnaz,19,0,20,1
1713518413462,ECE 111,A01,507420,Staff,27,0,50,23
1713518414487,ECE 197,001,548057,Sievenpiper; Daniel F.,9998,0,9999,1
1713518415515,EDS 115,A00,507243,Choi; Bailey Miyeon,27,0,28,1
1713518416541,EDS 117,A01,494379,Staff,14,0,25,11
1713518417565,EDS 125,A00,507246,Hopkins; Megan Beth,27,0,30,3
1713518418590,EDS 128A,A01,507264,Fargason; Sharon Gayle,26,0,26,0
1713518419618,EDS 128B,A01,507293,Pappas; Elizabeth,30,0,30,0
1713518420645,EDS 139,A00,507294,Fargason; Sharon Gayle,30,0,30,0
1713518420645,EDS 139,B00,507313,Pappas; Elizabeth,30,0,30,0
1713518421670,EDS 201,A00,507315,Staff,18,0,30,12
1713518422699,EDS 203,A01,507317,Halter; Christopher P.,17,0,30,13
1713518423723,EDS 204R,A01,507319,Halter; Christopher P.,0,1,30,30
1713518423723,EDS 204R,B01,507331,Heinzman; Erica M.,22,0,30,8
1713518424753,EDS 206R,A00,507332,Staff,0,2,30,30
1713518424753,EDS 206R,B00,507343,Staff,23,0,30,7
1713518425782,EDS 250,A00,507344,Hemans; Patricia Ann Benitez,27,0,40,13
1713518426808,EDS 281,A00,507345,Daly; Alan J.,18,0,18,0
1713518427835,EDS 284,A00,507350,Daly; Alan J.,16,0,16,0
1713518428861,EDS 286,A00,507359,Fine; Sarah,18,0,18,0
1713518429890,EDS 289C,A01,507361,Daly; Alan J.,18,0,18,0
1713518430914,EDS 290,A00,507366,Hofstetter; Carolyn,15,0,15,0
1713518431945,LIGM 5A,A00,507421,Fischer-Grunski; Eva K,20,0,20,0
1713518432973,LIGM 5B,A00,507423,Fischer-Grunski; Eva K,20,0,20,0
1713518433998,LIGM 5C,A00,507425,Fischer-Grunski; Eva K,20,0,20,0
1713518435025,LIIT 5AS,A00,507427,Carnelos; Chiara,20,0,20,0
1713518436051,LIIT 5BS,A00,507430,Carnelos; Chiara,20,0,20,0
1713518437076,LIIT 5CS,A00,507432,Carnelos; Chiara,20,0,20,0
1713518438101,LISP 5A,A00,507541,Munoz Sanchez; Alicia,14,0,20,6
1713518439126,LISP 5B,A00,507671,Munoz Sanchez; Alicia,12,0,20,8
1713518440151,LISP 5C,A00,507696,Munoz Sanchez; Alicia,11,0,20,9
1713518441178,MAE 197,001,528363,Boechler; Nicholas Sebastia,9998,0,9999,1
1713518442203,MATH 197,001,523477,Kedlaya; Kiran S.,9999,0,9999,0
1713518442203,MATH 197,002,563811,Zhang; Danna,9998,0,9999,1
1713518443227,MCWP 40R,A00,518780,Staff,13,0,20,7
1713518443227,MCWP 40R,B00,518781,Staff,11,0,20,9
1713518443227,MCWP 40R,C00,518783,Staff,8,0,20,12
1713518444257,MCWP 50R,A00,518791,Staff,7,0,20,13
1713518444257,MCWP 50R,B00,518792,Staff,3,0,20,17
1713518444257,MCWP 50R,C00,518793,Staff,5,0,20,15
1713518444257,MCWP 50R,D00,518794,Staff,0,0,20,20
1713518444257,MCWP 50R,E00,518795,Staff,0,0,20,20
1713518444257,MCWP 50R,F00,518796,Staff,10,0,20,10
1713518444257,MCWP 50R,G00,518797,Staff,10,0,20,10
1713518445283,MMW 12R,A01,514034,Herbst; Matthew,1,0,16,15
1713518445283,MMW 12R,A02,514035,Herbst; Matthew,13,0,16,3
1713518446314,MMW 13R,A01,514037,Staff,0,8,16,16
1713518446314,MMW 13R,A02,514039,Staff,0,7,16,16
1713518448369,SIO 295LS,A00,523233,Staff,15,0,30,15
1713518449398,SIO 295S,A00,523232,Staff,15,0,30,15
1713518450427,SOCI 117,A01,494376,Staff,0,2,5,5
1713518451454,WES 237B,A00,494380,Staff,19,0,20,1
1713518453526,AESE 279B,A00,494370,Wade; Jon P,33,0,33,0
1713518454555,AIP 197,001,627712,Vespa; Emanuel Ignacio,9999,0,9999,0
1713518455584,ANAR 135S,A00,494369,Braswell; Geoffrey E.,0,0,0,0
1713518456613,CAT 124RS,A01,519847,Geibel; William,6,0,20,14
1713518457642,CAT 125RS,A01,515971,Geibel; William,6,0,20,14
1713518458668,CLRE 250,A00,511389,Morris; Sheldon,9996,0,9999,3
1713518459695,CLRE 251,A00,507176,Mehta; Ravindra L.,9996,0,9999,3
1713518459695,CLRE 251,B00,511410,Mehta; Ravindra L.,9998,0,9999,1
1713518460724,CLRE 252,A00,507189,Cuomo; Raphael Eduardo,9998,0,9999,1
1713518461750,CLRE 253,A00,507199,Vaida; Florin,9997,0,9999,2
1713518461750,CLRE 253,B00,507202,Vaida; Florin,9999,0,9999,0
1713518462778,CLRE 259,A00,507211,Patel; Hemal,9996,0,9999,3
1713518463806,CLRE 260,A00,507221,Cuomo; Raphael Eduardo,9999,0,9999,0
1713518464831,CLRE 297,001,507242,Cuomo; Raphael Eduardo,9999,0,9999,0
1713518465857,CSE 191,A00,516875,Minnes Kemp; Mor Mia,9999,0,9999,0
1713518466882,CSS 201S,A01,494383,Staff,35,0,35,0
1713518467909,CSS 202S,A01,494387,Staff,35,0,35,0
1713518468939,EAP 100,A00,516065,Staff,9792,0,9999,207
1713518469965,ECE 45,A01,507414,Staff,37,0,60,23
1713518470993,ECE 100,A01,507416,Baghdadchi; Saharnaz,0,0,20,20
1713518470993,ECE 100,A02,507418,Baghdadchi; Saharnaz,19,0,20,1
1713518472026,ECE 111,A01,507420,Staff,27,0,50,23
1713518473052,ECE 197,001,548057,Sievenpiper; Daniel F.,9998,0,9999,1
1713518474078,EDS 115,A00,507243,Choi; Bailey Miyeon,27,0,28,1
1713518475162,EDS 117,A01,494379,Staff,14,0,25,11
1713518476193,EDS 125,A00,507246,Hopkins; Megan Beth,27,0,30,3
1713518477224,EDS 128A,A01,507264,Fargason; Sharon Gayle,26,0,26,0
1713518478251,EDS 128B,A01,507293,Pappas; Elizabeth,30,0,30,0
1713518479278,EDS 139,A00,507294,Fargason; Sharon Gayle,30,0,30,0
1713518479278,EDS 139,B00,507313,Pappas; Elizabeth,30,0,30,0
1713518480303,EDS 201,A00,507315,Staff,18,0,30,12
1713518481330,EDS 203,A01,507317,Halter; Christopher P.,17,0,30,13
1713518482356,EDS 204R,A01,507319,Halter; Christopher P.,0,1,30,30
1713518482356,EDS 204R,B01,507331,Heinzman; Erica M.,22,0,30,8
1713518483386,EDS 206R,A00,507332,Staff,0,2,30,30
1713518483386,EDS 206R,B00,507343,Staff,23,0,30,7
1713518484411,EDS 250,A00,507344,Hemans; Patricia Ann Benitez,27,0,40,13
1713518485438,EDS 281,A00,507345,Daly; Alan J.,18,0,18,0
1713518486464,EDS 284,A00,507350,Daly; Alan J.,16,0,16,0
1713518487489,EDS 286,A00,507359,Fine; Sarah,18,0,18,0
1713518488514,EDS 289C,A01,507361,Daly; Alan J.,18,0,18,0
1713518489538,EDS 290,A00,507366,Hofstetter; Carolyn,15,0,15,0
1713518490566,LIGM 5A,A00,507421,Fischer-Grunski; Eva K,20,0,20,0
1713518491592,LIGM 5B,A00,507423,Fischer-Grunski; Eva K,20,0,20,0
1713518492616,LIGM 5C,A00,507425,Fischer-Grunski; Eva K,20,0,20,0
1713518493644,LIIT 5AS,A00,507427,Carnelos; Chiara,20,0,20,0
1713518494669,LIIT 5BS,A00,507430,Carnelos; Chiara,20,0,20,0
1713518495700,LIIT 5CS,A00,507432,Carnelos; Chiara,20,0,20,0
1713518496726,LISP 5A,A00,507541,Munoz Sanchez; Alicia,14,0,20,6
1713518497756,LISP 5B,A00,507671,Munoz Sanchez; Alicia,12,0,20,8
1713518498787,LISP 5C,A00,507696,Munoz Sanchez; Alicia,11,0,20,9
1713518499813,MAE 197,001,528363,Boechler; Nicholas Sebastia,9998,0,9999,1
1713518500837,MATH 197,001,523477,Kedlaya; Kiran S.,9999,0,9999,0
1713518500837,MATH 197,002,563811,Zhang; Danna,9998,0,9999,1
1713518501865,MCWP 40R,A00,518780,Staff,13,0,20,7
1713518501865,MCWP 40R,B00,518781,Staff,11,0,20,9
1713518501865,MCWP 40R,C00,518783,Staff,8,0,20,12
1713518502894,MCWP 50R,A00,518791,Staff,7,0,20,13
1713518502894,MCWP 50R,B00,518792,Staff,3,0,20,17
1713518502894,MCWP 50R,C00,518793,Staff,5,0,20,15
1713518502894,MCWP 50R,D00,518794,Staff,0,0,20,20
1713518502894,MCWP 50R,E00,518795,Staff,0,0,20,20
1713518502894,MCWP 50R,F00,518796,Staff,10,0,20,10
1713518502894,MCWP 50R,G00,518797,Staff,10,0,20,10
1713518503923,MMW 12R,A01,514034,Herbst; Matthew,1,0,16,15
1713518503923,MMW 12R,A02,514035,Herbst; Matthew,13,0,16,3
1713518504948,MMW 13R,A01,514037,Staff,0,8,16,16
1713518504948,MMW 13R,A02,514039,Staff,0,7,16,16
1713518506998,SIO 295LS,A00,523233,Staff,15,0,30,15
1713518508027,SIO 295S,A00,523232,Staff,15,0,30,15
1713518509053,SOCI 117,A01,494376,Staff,0,2,5,5
1713518510082,WES 237B,A00,494380,Staff,19,0,20,1
1713518512142,AESE 279B,A00,494370,Wade; Jon P,33,0,33,0
1713518513171,AIP 197,001,627712,Vespa; Emanuel Ignacio,9999,0,9999,0
1713518514195,ANAR 135S,A00,494369,Braswell; Geoffrey E.,0,0,0,0
1713518515219,CAT 124RS,A01,519847,Geibel; William,6,0,20,14
1713518516249,CAT 125RS,A01,515971,Geibel; William,6,0,20,14
1713518517273,CLRE 250,A00,511389,Morris; Sheldon,9996,0,9999,3
1713518518303,CLRE 251,A00,507176,Mehta; Ravindra L.,9996,0,9999,3
1713518518303,CLRE 251,B00,511410,Mehta; Ravindra L.,9998,0,9999,1
1713518519327,CLRE 252,A00,507189,Cuomo; Raphael Eduardo,9998,0,9999,1
1713518520353,CLRE 253,A00,507199,Vaida; Florin,9997,0,9999,2
1713518520353,CLRE 253,B00,507202,Vaida; Florin,9999,0,9999,0
1713518521380,CLRE 259,A00,507211,Patel; Hemal,9996,0,9999,3
1713518522408,CLRE 260,A00,507221,Cuomo; Raphael Eduardo,9999,0,9999,0
1713518523437,CLRE 297,001,507242,Cuomo; Raphael Eduardo,9999,0,9999,0
1713518524465,CSE 191,A00,516875,Minnes Kemp; Mor Mia,9999,0,9999,0
1713518525491,CSS 201S,A01,494383,Staff,35,0,35,0
1713518526517,CSS 202S,A01,494387,Staff,35,0,35,0
1713518527541,EAP 100,A00,516065,Staff,9792,0,9999,207
1713518528567,ECE 45,A01,507414,Staff,37,0,60,23
1713518529598,ECE 100,A01,507416,Baghdadchi; Saharnaz,0,0,20,20
1713518529598,ECE 100,A02,507418,Baghdadchi; Saharnaz,19,0,20,1
1713518530622,ECE 111,A01,507420,Staff,27,0,50,23
1713518531648,ECE 197,001,548057,Sievenpiper; Daniel F.,9998,0,9999,1
1713518532674,EDS 115,A00,507243,Choi; Bailey Miyeon,27,0,28,1
1713518533703,EDS 117,A01,494379,Staff,14,0,25,11
1713518534733,EDS 125,A00,507246,Hopkins; Megan Beth,27,0,30,3
1713518535761,EDS 128A,A01,507264,Fargason; Sharon Gayle,26,0,26,0
1713518536786,EDS 128B,A01,507293,Pappas; Elizabeth,30,0,30,0
1713518537811,EDS 139,A00,507294,Fargason; Sharon Gayle,30,0,30,0
1713518537811,EDS 139,B00,507313,Pappas; Elizabeth,30,0,30,0
1713518538841,EDS 201,A00,507315,Staff,18,0,30,12
1713518539869,EDS 203,A01,507317,Halter; Christopher P.,17,0,30,13
1713518540894,EDS 204R,A01,507319,Halter; Christopher P.,0,1,30,30
1713518540894,EDS 204R,B01,507331,Heinzman; Erica M.,22,0,30,8
1713518541923,EDS 206R,A00,507332,Staff,0,2,30,30
1713518541923,EDS 206R,B00,507343,Staff,23,0,30,7
1713518542949,EDS 250,A00,507344,Hemans; Patricia Ann Benitez,27,0,40,13
1713518543974,EDS 281,A00,507345,Daly; Alan J.,18,0,18,0
1713518545001,EDS 284,A00,507350,Daly; Alan J.,16,0,16,0
1713518546027,EDS 286,A00,507359,Fine; Sarah,18,0,18,0
1713518547056,EDS 289C,A01,507361,Daly; Alan J.,18,0,18,0
1713518548081,EDS 290,A00,507366,Hofstetter; Carolyn,15,0,15,0
1713518549111,LIGM 5A,A00,507421,Fischer-Grunski; Eva K,20,0,20,0
1713518550136,LIGM 5B,A00,507423,Fischer-Grunski; Eva K,20,0,20,0
1713518551165,LIGM 5C,A00,507425,Fischer-Grunski; Eva K,20,0,20,0
1713518552190,LIIT 5AS,A00,507427,Carnelos; Chiara,20,0,20,0
1713518553219,LIIT 5BS,A00,507430,Carnelos; Chiara,20,0,20,0
1713518554249,LIIT 5CS,A00,507432,Carnelos; Chiara,20,0,20,0
1713518555275,LISP 5A,A00,507541,Munoz Sanchez; Alicia,14,0,20,6
1713518556305,LISP 5B,A00,507671,Munoz Sanchez; Alicia,12,0,20,8
1713518557335,LISP 5C,A00,507696,Munoz Sanchez; Alicia,11,0,20,9
1713518558360,MAE 197,001,528363,Boechler; Nicholas Sebastia,9998,0,9999,1
1713518559386,MATH 197,001,523477,Kedlaya; Kiran S.,9999,0,9999,0
1713518559386,MATH 197,002,563811,Zhang; Danna,9998,0,9999,1
1713518560412,MCWP 40R,A00,518780,Staff,13,0,20,7
1713518560412,MCWP 40R,B00,518781,Staff,11,0,20,9
1713518560412,MCWP 40R,C00,518783,Staff,8,0,20,12
1713518561445,MCWP 50R,A00,518791,Staff,7,0,20,13
1713518561445,MCWP 50R,B00,518792,Staff,3,0,20,17
1713518561445,MCWP 50R,C00,518793,Staff,5,0,20,15
1713518561445,MCWP 50R,D00,518794,Staff,0,0,20,20
1713518561445,MCWP 50R,E00,518795,Staff,0,0,20,20
1713518561445,MCWP 50R,F00,518796,Staff,10,0,20,10
1713518561445,MCWP 50R,G00,518797,Staff,10,0,20,10
1713518562473,MMW 12R,A01,514034,Herbst; Matthew,1,0,16,15
1713518562473,MMW 12R,A02,514035,Herbst; Matthew,13,0,16,3
1713518563498,MMW 13R,A01,514037,Staff,0,8,16,16
1713518563498,MMW 13R,A02,514039,Staff,0,7,16,16
1713518565559,SIO 295LS,A00,523233,Staff,15,0,30,15
1713518566585,SIO 295S,A00,523232,Staff,15,0,30,15
1713518567610,SOCI 117,A01,494376,Staff,0,2,5,5
1713518568642,WES 237B,A00,494380,Staff,19,0,20,1
1713518570707,AESE 279B,A00,494370,Wade; Jon P,33,0,33,0
1713518571732,AIP 197,001,627712,Vespa; Emanuel Ignacio,9999,0,9999,0
1713518572757,ANAR 135S,A00,494369,Braswell; Geoffrey E.,0,0,0,0
1713518573786,CAT 124RS,A01,519847,Geibel; William,6,0,20,14
1713518574816,CAT 125RS,A01,515971,Geibel; William,6,0,20,14
1713518575845,CLRE 250,A00,511389,Morris; Sheldon,9996,0,9999,3
1713518576878,CLRE 251,A00,507176,Mehta; Ravindra L.,9996,0,9999,3
1713518576878,CLRE 251,B00,511410,Mehta; Ravindra L.,9998,0,9999,1
1713518577907,CLRE 252,A00,507189,Cuomo; Raphael Eduardo,9998,0,9999,1
1713518578992,CLRE 253,A00,507199,Vaida; Florin,9997,0,9999,2
1713518578992,CLRE 253,B00,507202,Vaida; Florin,9999,0,9999,0
1713518580022,CLRE 259,A00,507211,Patel; Hemal,9996,0,9999,3
1713518581047,CLRE 260,A00,507221,Cuomo; Raphael Eduardo,9999,0,9999,0
1713518582078,CLRE 297,001,507242,Cuomo; Raphael Eduardo,9999,0,9999,0
1713518583104,CSE 191,A00,516875,Minnes Kemp; Mor Mia,9999,0,9999,0
1713518584136,CSS 201S,A01,494383,Staff,35,0,35,0
1713518585166,CSS 202S,A01,494387,Staff,35,0,35,0
1713518586196,EAP 100,A00,516065,Staff,9792,0,9999,207
1713518587222,ECE 45,A01,507414,Staff,37,0,60,23
1713518588248,ECE 100,A01,507416,Baghdadchi; Saharnaz,0,0,20,20
1713518588248,ECE 100,A02,507418,Baghdadchi; Saharnaz,19,0,20,1
1713518589272,ECE 111,A01,507420,Staff,27,0,50,23
1713518590299,ECE 197,001,548057,Sievenpiper; Daniel F.,9998,0,9999,1
1713518591324,EDS 115,A00,507243,Choi; Bailey Miyeon,27,0,28,1
1713518592352,EDS 117,A01,494379,Staff,14,0,25,11
1713518593377,EDS 125,A00,507246,Hopkins; Megan Beth,27,0,30,3
1713518594403,EDS 128A,A01,507264,Fargason; Sharon Gayle,26,0,26,0
1713518595429,EDS 128B,A01,507293,Pappas; Elizabeth,30,0,30,0
1713518596454,EDS 139,A00,507294,Fargason; Sharon Gayle,30,0,30,0
1713518596454,EDS 139,B00,507313,Pappas; Elizabeth,30,0,30,0
1713518597477,EDS 201,A00,507315,Staff,18,0,30,12
1713518598502,EDS 203,A01,507317,Halter; Christopher P.,17,0,30,13
1713518599527,EDS 204R,A01,507319,Halter; Christopher P.,0,1,30,30
1713518599527,EDS 204R,B01,507331,Heinzman; Erica M.,22,0,30,8
1713518600555,EDS 206R,A00,507332,Staff,0,2,30,30
1713518600555,EDS 206R,B00,507343,Staff,23,0,30,7
1713518601584,EDS 250,A00,507344,Hemans; Patricia Ann Benitez,27,0,40,13
1713518602611,EDS 281,A00,507345,Daly; Alan J.,18,0,18,0
1713518603637,EDS 284,A00,507350,Daly; Alan J.,16,0,16,0
1713518604664,EDS 286,A00,507359,Fine; Sarah,18,0,18,0
1713518605693,EDS 289C,A01,507361,Daly; Alan J.,18,0,18,0
1713518606724,EDS 290,A00,507366,Hofstetter; Carolyn,15,0,15,0
1713518607750,LIGM 5A,A00,507421,Fischer-Grunski; Eva K,20,0,20,0
1713518608777,LIGM 5B,A00,507423,Fischer-Grunski; Eva K,20,0,20,0
1713518609807,LIGM 5C,A00,507425,Fischer-Grunski; Eva K,20,0,20,0
1713518610831,LIIT 5AS,A00,507427,Carnelos; Chiara,20,0,20,0
1713518611860,LIIT 5BS,A00,507430,Carnelos; Chiara,20,0,20,0
1713518612886,LIIT 5CS,A00,507432,Carnelos; Chiara,20,0,20,0
1713518613916,LISP 5A,A00,507541,Munoz Sanchez; Alicia,14,0,20,6
1713518614947,LISP 5B,A00,507671,Munoz Sanchez; Alicia,12,0,20,8
1713518615973,LISP 5C,A00,507696,Munoz Sanchez; Alicia,11,0,20,9
1713518616998,MAE 197,001,528363,Boechler; Nicholas Sebastia,9998,0,9999,1
1713518618023,MATH 197,001,523477,Kedlaya; Kiran S.,9999,0,9999,0
1713518618023,MATH 197,002,563811,Zhang; Danna,9998,0,9999,1
1713518619054,MCWP 40R,A00,518780,Staff,13,0,20,7
1713518619054,MCWP 40R,B00,518781,Staff,11,0,20,9
1713518619054,MCWP 40R,C00,518783,Staff,8,0,20,12
1713518620084,MCWP 50R,A00,518791,Staff,7,0,20,13
1713518620084,MCWP 50R,B00,518792,Staff,3,0,20,17
1713518620084,MCWP 50R,C00,518793,Staff,5,0,20,15
1713518620084,MCWP 50R,D00,518794,Staff,0,0,20,20
1713518620084,MCWP 50R,E00,518795,Staff,0,0,20,20
1713518620084,MCWP 50R,F00,518796,Staff,10,0,20,10
1713518620084,MCWP 50R,G00,518797,Staff,10,0,20,10
1713518621110,MMW 12R,A01,514034,Herbst; Matthew,1,0,16,15
1713518621110,MMW 12R,A02,514035,Herbst; Matthew,13,0,16,3
1713518622139,MMW 13R,A01,514037,Staff,0,8,16,16
1713518622139,MMW 13R,A02,514039,Staff,0,7,16,16
1713518624193,SIO 295LS,A00,523233,Staff,15,0,30,15
1713518625222,SIO 295S,A00,523232,Staff,15,0,30,15
1713518626251,SOCI 117,A01,494376,Staff,0,2,5,5
1713518627278,WES 237B,A00,494380,Staff,19,0,20,1
1713518629346,AESE 279B,A00,494370,Wade; Jon P,33,0,33,0
1713518630373,AIP 197,001,627712,Vespa; Emanuel Ignacio,9999,0,9999,0
1713518631399,ANAR 135S,A00,494369,Braswell; Geoffrey E.,0,0,0,0
1713518632428,CAT 124RS,A01,519847,Geibel; William,6,0,20,14
1713518633454,CAT 125RS,A01,515971,Geibel; William,6,0,20,14
1713518634483,CLRE 250,A00,511389,Morris; Sheldon,9996,0,9999,3
1713518635515,CLRE 251,A00,507176,Mehta; Ravindra L.,9996,0,9999,3
1713518635515,CLRE 251,B00,511410,Mehta; Ravindra L.,9998,0,9999,1
1713518636545,CLRE 252,A00,507189,Cuomo; Raphael Eduardo,9998,0,9999,1
1713518637574,CLRE 253,A00,507199,Vaida; Florin,9997,0,9999,2
1713518637574,CLRE 253,B00,507202,Vaida; Florin,9999,0,9999,0
1713518638601,CLRE 259,A00,507211,Patel; Hemal,9996,0,9999,3
1713518639626,CLRE 260,A00,507221,Cuomo; Raphael Eduardo,9999,0,9999,0
1713518640652,CLRE 297,001,507242,Cuomo; Raphael Eduardo,9999,0,9999,0
1713518641678,CSE 191,A00,516875,Minnes Kemp; Mor Mia,9999,0,9999,0
1713518642703,CSS 201S,A01,494383,Staff,35,0,35,0
1713518643729,CSS 202S,A01,494387,Staff,35,0,35,0
1713518644754,EAP 100,A00,516065,Staff,9792,0,9999,207
1713518645783,ECE 45,A01,507414,Staff,37,0,60,23
1713518646813,ECE 100,A01,507416,Baghdadchi; Saharnaz,0,0,20,20
1713518646813,ECE 100,A02,507418,Baghdadchi; Saharnaz,19,0,20,1
1713518647837,ECE 111,A01,507420,Staff,27,0,50,23
1713518648863,ECE 197,001,548057,Sievenpiper; Daniel F.,9998,0,9999,1
1713518649890,EDS 115,A00,507243,Choi; Bailey Miyeon,27,0,28,1
1713518650916,EDS 117,A01,494379,Staff,14,0,25,11
1713518651942,EDS 125,A00,507246,Hopkins; Megan Beth,27,0,30,3
1713518652968,EDS 128A,A01,507264,Fargason; Sharon Gayle,26,0,26,0
1713518653999,EDS 128B,A01,507293,Pappas; Elizabeth,30,0,30,0
1713518655030,EDS 139,A00,507294,Fargason; Sharon Gayle,30,0,30,0
1713518655030,EDS 139,B00,507313,Pappas; Elizabeth,30,0,30,0
1713518656059,EDS 201,A00,507315,Staff,18,0,30,12
1713518657085,EDS 203,A01,507317,Halter; Christopher P.,17,0,30,13
1713518658114,EDS 204R,A01,507319,Halter; Christopher P.,0,1,30,30
1713518658114,EDS 204R,B01,507331,Heinzman; Erica M.,22,0,30,8
1713518659142,EDS 206R,A00,507332,Staff,0,2,30,30
1713518659142,EDS 206R,B00,507343,Staff,23,0,30,7
1713518660168,EDS 250,A00,507344,Hemans; Patricia Ann Benitez,27,0,40,13
1713518661197,EDS 281,A00,507345,Daly; Alan J.,18,0,18,0
1713518662222,EDS 284,A00,507350,Daly; Alan J.,16,0,16,0
1713518663249,EDS 286,A00,507359,Fine; Sarah,18,0,18,0
1713518664278,EDS 289C,A01,507361,Daly; Alan J.,18,0,18,0
1713518665306,EDS 290,A00,507366,Hofstetter; Carolyn,15,0,15,0
1713518666338,LIGM 5A,A00,507421,Fischer-Grunski; Eva K,20,0,20,0
1713518667364,LIGM 5B,A00,507423,Fischer-Grunski; Eva K,20,0,20,0
1713518668390,LIGM 5C,A00,507425,Fischer-Grunski; Eva K,20,0,20,0
1713518669416,LIIT 5AS,A00,507427,Carnelos; Chiara,20,0,20,0
1713518670446,LIIT 5BS,A00,507430,Carnelos; Chiara,20,0,20,0
1713518671471,LIIT 5CS,A00,507432,Carnelos; Chiara,20,0,20,0
1713518672498,LISP 5A,A00,507541,Munoz Sanchez; Alicia,14,0,20,6
1713518673522,LISP 5B,A00,507671,Munoz Sanchez; Alicia,12,0,20,8
1713518674546,LISP 5C,A00,507696,Munoz Sanchez; Alicia,11,0,20,9
1713518675572,MAE 197,001,528363,Boechler; Nicholas Sebastia,9998,0,9999,1
1713518676598,MATH 197,001,523477,Kedlaya; Kiran S.,9999,0,9999,0
1713518676598,MATH 197,002,563811,Zhang; Danna,9998,0,9999,1
1713518677623,MCWP 40R,A00,518780,Staff,13,0,20,7
1713518677623,MCWP 40R,B00,518781,Staff,11,0,20,9
1713518677623,MCWP 40R,C00,518783,Staff,8,0,20,12
1713518678655,MCWP 50R,A00,518791,Staff,7,0,20,13
1713518678655,MCWP 50R,B00,518792,Staff,3,0,20,17
1713518678655,MCWP 50R,C00,518793,Staff,5,0,20,15
1713518678655,MCWP 50R,D00,518794,Staff,0,0,20,20
1713518678655,MCWP 50R,E00,518795,Staff,0,0,20,20
1713518678655,MCWP 50R,F00,518796,Staff,10,0,20,10
1713518678655,MCWP 50R,G00,518797,Staff,10,0,20,10
1713518679683,MMW 12R,A01,514034,Herbst; Matthew,1,0,16,15
1713518679683,MMW 12R,A02,514035,Herbst; Matthew,13,0,16,3
1713518680707,MMW 13R,A01,514037,Staff,0,8,16,16
1713518680707,MMW 13R,A02,514039,Staff,0,7,16,16
1713518682818,SIO 295LS,A00,523233,Staff,15,0,30,15
1713518683844,SIO 295S,A00,523232,Staff,15,0,30,15
1713518684869,SOCI 117,A01,494376,Staff,0,2,5,5
1713518685897,WES 237B,A00,494380,Staff,19,0,20,1
1713518687973,AESE 279B,A00,494370,Wade; Jon P,33,0,33,0
1713518689006,AIP 197,001,627712,Vespa; Emanuel Ignacio,9999,0,9999,0
1713518690030,ANAR 135S,A00,494369,Braswell; Geoffrey E.,0,0,0,0
1713518691056,CAT 124RS,A01,519847,Geibel; William,6,0,20,14
1713518692082,CAT 125RS,A01,515971,Geibel; William,6,0,20,14
1713518693107,CLRE 250,A00,511389,Morris; Sheldon,9996,0,9999,3
1713518694137,CLRE 251,A00,507176,Mehta; Ravindra L.,9996,0,9999,3
1713518694137,CLRE 251,B00,511410,Mehta; Ravindra L.,9998,0,9999,1
1713518695166,CLRE 252,A00,507189,Cuomo; Raphael Eduardo,9998,0,9999,1
1713518696193,CLRE 253,A00,507199,Vaida; Florin,9997,0,9999,2
1713518696193,CLRE 253,B00,507202,Vaida; Florin,9999,0,9999,0
1713518697218,CLRE 259,A00,507211,Patel; Hemal,9996,0,9999,3
1713518698249,CLRE 260,A00,507221,Cuomo; Raphael Eduardo,9999,0,9999,0
1713518699275,CLRE 297,001,507242,Cuomo; Raphael Eduardo,9999,0,9999,0
1713518700310,CSE 191,A00,516875,Minnes Kemp; Mor Mia,9999,0,9999,0
1713518701336,CSS 201S,A01,494383,Staff,35,0,35,0
1713518702367,CSS 202S,A01,494387,Staff,35,0,35,0
1713518703399,EAP 100,A00,516065,Staff,9792,0,9999,207
1713518704435,ECE 45,A01,507414,Staff,37,0,60,23
1713518705460,ECE 100,A01,507416,Baghdadchi; Saharnaz,0,0,20,20
1713518705460,ECE 100,A02,507418,Baghdadchi; Saharnaz,19,0,20,1
1713518706488,ECE 111,A01,507420,Staff,27,0,50,23
1713518707512,ECE 197,001,548057,Sievenpiper; Daniel F.,9998,0,9999,1
1713518708537,EDS 115,A00,507243,Choi; Bailey Miyeon,27,0,28,1
1713518709568,EDS 117,A01,494379,Staff,14,0,25,11
1713518710593,EDS 125,A00,507246,Hopkins; Megan Beth,27,0,30,3
1713518711624,EDS 128A,A01,507264,Fargason; Sharon Gayle,26,0,26,0
1713518712652,EDS 128B,A01,507293,Pappas; Elizabeth,30,0,30,0
1713518713680,EDS 139,A00,507294,Fargason; Sharon Gayle,30,0,30,0
1713518713680,EDS 139,B00,507313,Pappas; Elizabeth,30,0,30,0
1713518714707,EDS 201,A00,507315,Staff,18,0,30,12
1713518715733,EDS 203,A01,507317,Halter; Christopher P.,17,0,30,13
1713518716765,EDS 204R,A01,507319,Halter; Christopher P.,0,1,30,30
1713518716765,EDS 204R,B01,507331,Heinzman; Erica M.,22,0,30,8
1713518717791,EDS 206R,A00,507332,Staff,0,2,30,30
1713518717791,EDS 206R,B00,507343,Staff,23,0,30,7
1713518718820,EDS 250,A00,507344,Hemans; Patricia Ann Benitez,27,0,40,13
1713518719844,EDS 281,A00,507345,Daly; Alan J.,18,0,18,0
1713518720874,EDS 284,A00,507350,Daly; Alan J.,16,0,16,0
1713518721903,EDS 286,A00,507359,Fine; Sarah,18,0,18,0
1713518722930,EDS 289C,A01,507361,Daly; Alan J.,18,0,18,0
1713518723958,EDS 290,A00,507366,Hofstetter; Carolyn,15,0,15,0
1713518724983,LIGM 5A,A00,507421,Fischer-Grunski; Eva K,20,0,20,0
1713518726007,LIGM 5B,A00,507423,Fischer-Grunski; Eva K,20,0,20,0
1713518727033,LIGM 5C,A00,507425,Fischer-Grunski; Eva K,20,0,20,0
1713518728059,LIIT 5AS,A00,507427,Carnelos; Chiara,20,0,20,0
1713518729085,LIIT 5BS,A00,507430,Carnelos; Chiara,20,0,20,0
1713518730111,LIIT 5CS,A00,507432,Carnelos; Chiara,20,0,20,0
1713518731137,LISP 5A,A00,507541,Munoz Sanchez; Alicia,14,0,20,6
1713518732164,LISP 5B,A00,507671,Munoz Sanchez; Alicia,12,0,20,8
1713518733190,LISP 5C,A00,507696,Munoz Sanchez; Alicia,11,0,20,9
1713518734219,MAE 197,001,528363,Boechler; Nicholas Sebastia,9998,0,9999,1
1713518735250,MATH 197,001,523477,Kedlaya; Kiran S.,9999,0,9999,0
1713518735250,MATH 197,002,563811,Zhang; Danna,9998,0,9999,1
1713518736282,MCWP 40R,A00,518780,Staff,13,0,20,7
1713518736282,MCWP 40R,B00,518781,Staff,11,0,20,9
1713518736282,MCWP 40R,C00,518783,Staff,8,0,20,12
1713518737313,MCWP 50R,A00,518791,Staff,7,0,20,13
1713518737313,MCWP 50R,B00,518792,Staff,3,0,20,17
1713518737313,MCWP 50R,C00,518793,Staff,5,0,20,15
1713518737313,MCWP 50R,D00,518794,Staff,0,0,20,20
1713518737313,MCWP 50R,E00,518795,Staff,0,0,20,20
1713518737313,MCWP 50R,F00,518796,Staff,10,0,20,10
1713518737313,MCWP 50R,G00,518797,Staff,10,0,20,10
1713518738340,MMW 12R,A01,514034,Herbst; Matthew,1,0,16,15
1713518738340,MMW 12R,A02,514035,Herbst; Matthew,13,0,16,3
1713518739371,MMW 13R,A01,514037,Staff,0,8,16,16
1713518739371,MMW 13R,A02,514039,Staff,0,7,16,16
1713518741422,SIO 295LS,A00,523233,Staff,15,0,30,15
1713518742446,SIO 295S,A00,523232,Staff,15,0,30,15
1713518743473,SOCI 117,A01,494376,Staff,0,2,5,5
1713518744502,WES 237B,A00,494380,Staff,19,0,20,1
1713518746561,AESE 279B,A00,494370,Wade; Jon P,33,0,33,0
1713518747585,AIP 197,001,627712,Vespa; Emanuel Ignacio,9999,0,9999,0
1713518748610,ANAR 135S,A00,494369,Braswell; Geoffrey E.,0,0,0,0
1713518749636,CAT 124RS,A01,519847,Geibel; William,6,0,20,14
1713518750661,CAT 125RS,A01,515971,Geibel; William,6,0,20,14
1713518751690,CLRE 250,A00,511389,Morris; Sheldon,9996,0,9999,3
1713518752721,CLRE 251,A00,507176,Mehta; Ravindra L.,9996,0,9999,3
1713518752721,CLRE 251,B00,511410,Mehta; Ravindra L.,9998,0,9999,1
1713518753746,CLRE 252,A00,507189,Cuomo; Raphael Eduardo,9998,0,9999,1
1713518754777,CLRE 253,A00,507199,Vaida; Florin,9997,0,9999,2
1713518754777,CLRE 253,B00,507202,Vaida; Florin,9999,0,9999,0
1713518755802,CLRE 259,A00,507211,Patel; Hemal,9996,0,9999,3
1713518756828,CLRE 260,A00,507221,Cuomo; Raphael Eduardo,9999,0,9999,0
1713518757855,CLRE 297,001,507242,Cuomo; Raphael Eduardo,9999,0,9999,0
1713518758880,CSE 191,A00,516875,Minnes Kemp; Mor Mia,9999,0,9999,0
1713518759909,CSS 201S,A01,494383,Staff,35,0,35,0
1713518760935,CSS 202S,A01,494387,Staff,35,0,35,0
1713518761964,EAP 100,A00,516065,Staff,9792,0,9999,207
1713518762991,ECE 45,A01,507414,Staff,37,0,60,23
1713518764018,ECE 100,A01,507416,Baghdadchi; Saharnaz,0,0,20,20
1713518764018,ECE 100,A02,507418,Baghdadchi; Saharnaz,19,0,20,1
1713518765043,ECE 111,A01,507420,Staff,27,0,50,23
1713518766068,ECE 197,001,548057,Sievenpiper; Daniel F.,9998,0,9999,1
1713518767096,EDS 115,A00,507243,Choi; Bailey Miyeon,27,0,28,1
1713518768126,EDS 117,A01,494379,Staff,14,0,25,11
1713518769152,EDS 125,A00,507246,Hopkins; Megan Beth,27,0,30,3
1713518770178,EDS 128A,A01,507264,Fargason; Sharon Gayle,26,0,26,0
1713518771203,EDS 128B,A01,507293,Pappas; Elizabeth,30,0,30,0
1713518772232,EDS 139,A00,507294,Fargason; Sharon Gayle,30,0,30,0
1713518772232,EDS 139,B00,507313,Pappas; Elizabeth,30,0,30,0
1713518773257,EDS 201,A00,507315,Staff,18,0,30,12
1713518774283,EDS 203,A01,507317,Halter; Christopher P.,17,0,30,13
1713518775310,EDS 204R,A01,507319,Halter; Christopher P.,0,1,30,30
1713518775310,EDS 204R,B01,507331,Heinzman; Erica M.,22,0,30,8
1713518776333,EDS 206R,A00,507332,Staff,0,2,30,30
1713518776333,EDS 206R,B00,507343,Staff,23,0,30,7
1713518777359,EDS 250,A00,507344,Hemans; Patricia Ann Benitez,27,0,40,13
1713518778385,EDS 281,A00,507345,Daly; Alan J.,18,0,18,0
1713518779409,EDS 284,A00,507350,Daly; Alan J.,16,0,16,0
1713518780435,EDS 286,A00,507359,Fine; Sarah,18,0,18,0
1713518781460,EDS 289C,A01,507361,Daly; Alan J.,18,0,18,0
1713518782489,EDS 290,A00,507366,Hofstetter; Carolyn,15,0,15,0
1713518783516,LIGM 5A,A00,507421,Fischer-Grunski; Eva K,20,0,20,0
1713518784546,LIGM 5B,A00,507423,Fischer-Grunski; Eva K,20,0,20,0
1713518785573,LIGM 5C,A00,507425,Fischer-Grunski; Eva K,20,0,20,0
1713518786655,LIIT 5AS,A00,507427,Carnelos; Chiara,20,0,20,0
1713518787685,LIIT 5BS,A00,507430,Carnelos; Chiara,20,0,20,0
1713518788713,LIIT 5CS,A00,507432,Carnelos; Chiara,20,0,20,0
1713518789737,LISP 5A,A00,507541,Munoz Sanchez; Alicia,14,0,20,6
1713518790760,LISP 5B,A00,507671,Munoz Sanchez; Alicia,12,0,20,8
1713518791786,LISP 5C,A00,507696,Munoz Sanchez; Alicia,11,0,20,9
1713518792809,MAE 197,001,528363,Boechler; Nicholas Sebastia,9998,0,9999,1
1713518793835,MATH 197,001,523477,Kedlaya; Kiran S.,9999,0,9999,0
1713518793835,MATH 197,002,563811,Zhang; Danna,9998,0,9999,1
1713518794859,MCWP 40R,A00,518780,Staff,13,0,20,7
1713518794859,MCWP 40R,B00,518781,Staff,11,0,20,9
1713518794859,MCWP 40R,C00,518783,Staff,8,0,20,12
1713518795884,MCWP 50R,A00,518791,Staff,7,0,20,13
1713518795884,MCWP 50R,B00,518792,Staff,3,0,20,17
1713518795884,MCWP 50R,C00,518793,Staff,5,0,20,15
1713518795884,MCWP 50R,D00,518794,Staff,0,0,20,20
1713518795884,MCWP 50R,E00,518795,Staff,0,0,20,20
1713518795884,MCWP 50R,F00,518796,Staff,10,0,20,10
1713518795884,MCWP 50R,G00,518797,Staff,10,0,20,10
1713518796911,MMW 12R,A01,514034,Herbst; Matthew,1,0,16,15
1713518796911,MMW 12R,A02,514035,Herbst; Matthew,13,0,16,3
1713518797941,MMW 13R,A01,514037,Staff,0,8,16,16
1713518797941,MMW 13R,A02,514039,Staff,0,7,16,16
1713518799992,SIO 295LS,A00,523233,Staff,15,0,30,15
1713518801021,SIO 295S,A00,523232,Staff,15,0,30,15
1713518802051,SOCI 117,A01,494376,Staff,0,2,5,5
1713518803078,WES 237B,A00,494380,Staff,19,0,20,1
1713518805148,AESE 279B,A00,494370,Wade; Jon P,33,0,33,0
1713518806174,AIP 197,001,627712,Vespa; Emanuel Ignacio,9999,0,9999,0
1713518807200,ANAR 135S,A00,494369,Braswell; Geoffrey E.,0,0,0,0
1713518808230,CAT 124RS,A01,519847,Geibel; William,6,0,20,14
1713518809254,CAT 125RS,A01,515971,Geibel; William,6,0,20,14
1713518810282,CLRE 250,A00,511389,Morris; Sheldon,9996,0,9999,3
1713518811318,CLRE 251,A00,507176,Mehta; Ravindra L.,9996,0,9999,3
1713518811318,CLRE 251,B00,511410,Mehta; Ravindra L.,9998,0,9999,1
1713518812344,CLRE 252,A00,507189,Cuomo; Raphael Eduardo,9998,0,9999,1
1713518813369,CLRE 253,A00,507199,Vaida; Florin,9997,0,9999,2
1713518813369,CLRE 253,B00,507202,Vaida; Florin,9999,0,9999,0
1713518814393,CLRE 259,A00,507211,Patel; Hemal,9996,0,9999,3
1713518815418,CLRE 260,A00,507221,Cuomo; Raphael Eduardo,9999,0,9999,0
1713518816444,CLRE 297,001,507242,Cuomo; Raphael Eduardo,9999,0,9999,0
1713518817469,CSE 191,A00,516875,Minnes Kemp; Mor Mia,9999,0,9999,0
1713518818499,CSS 201S,A01,494383,Staff,35,0,35,0
1713518819525,CSS 202S,A01,494387,Staff,35,0,35,0
1713518820552,EAP 100,A00,516065,Staff,9792,0,9999,207
1713518821576,ECE 45,A01,507414,Staff,37,0,60,23
1713518822603,ECE 100,A01,507416,Baghdadchi; Saharnaz,0,0,20,20
1713518822603,ECE 100,A02,507418,Baghdadchi; Saharnaz,19,0,20,1
1713518823628,ECE 111,A01,507420,Staff,27,0,50,23
1713518824654,ECE 197,001,548057,Sievenpiper; Daniel F.,9998,0,9999,1
1713518825680,EDS 115,A00,507243,Choi; Bailey Miyeon,27,0,28,1
1713518826706,EDS 117,A01,494379,Staff,14,0,25,11
1713518827740,EDS 125,A00,507246,Hopkins; Megan Beth,27,0,30,3
1713518828766,EDS 128A,A01,507264,Fargason; Sharon Gayle,26,0,26,0
1713518829798,EDS 128B,A01,507293,Pappas; Elizabeth,30,0,30,0
1713518830824,EDS 139,A00,507294,Fargason; Sharon Gayle,30,0,30,0
1713518830824,EDS 139,B00,507313,Pappas; Elizabeth,30,0,30,0
1713518831850,EDS 201,A00,507315,Staff,18,0,30,12
1713518832880,EDS 203,A01,507317,Halter; Christopher P.,17,0,30,13
1713518833910,EDS 204R,A01,507319,Halter; Christopher P.,0,1,30,30
1713518833910,EDS 204R,B01,507331,Heinzman; Erica M.,22,0,30,8
1713518834935,EDS 206R,A00,507332,Staff,0,2,30,30
1713518834935,EDS 206R,B00,507343,Staff,23,0,30,7
1713518835964,EDS 250,A00,507344,Hemans; Patricia Ann Benitez,27,0,40,13
1713518836994,EDS 281,A00,507345,Daly; Alan J.,18,0,18,0
1713518838019,EDS 284,A00,507350,Daly; Alan J.,16,0,16,0
1713518839052,EDS 286,A00,507359,Fine; Sarah,18,0,18,0
1713518840077,EDS 289C,A01,507361,Daly; Alan J.,18,0,18,0
1713518841103,EDS 290,A00,507366,Hofstetter; Carolyn,15,0,15,0
1713518842130,LIGM 5A,A00,507421,Fischer-Grunski; Eva K,20,0,20,0
1713518843160,LIGM 5B,A00,507423,Fischer-Grunski; Eva K,20,0,20,0
1713518844185,LIGM 5C,A00,507425,Fischer-Grunski; Eva K,20,0,20,0
1713518845211,LIIT 5AS,A00,507427,Carnelos; Chiara,20,0,20,0
1713518846241,LIIT 5BS,A00,507430,Carnelos; Chiara,20,0,20,0
1713518847272,LIIT 5CS,A00,507432,Carnelos; Chiara,20,0,20,0
1713518848301,LISP 5A,A00,507541,Munoz Sanchez; Alicia,14,0,20,6
1713518849325,LISP 5B,A00,507671,Munoz Sanchez; Alicia,12,0,20,8
1713518850354,LISP 5C,A00,507696,Munoz Sanchez; Alicia,11,0,20,9
1713518851380,MAE 197,001,528363,Boechler; Nicholas Sebastia,9998,0,9999,1
1713518852405,MATH 197,001,523477,Kedlaya; Kiran S.,9999,0,9999,0
1713518852405,MATH 197,002,563811,Zhang; Danna,9998,0,9999,1
1713518853436,MCWP 40R,A00,518780,Staff,13,0,20,7
1713518853436,MCWP 40R,B00,518781,Staff,11,0,20,9
1713518853436,MCWP 40R,C00,518783,Staff,8,0,20,12
1713518854461,MCWP 50R,A00,518791,Staff,7,0,20,13
1713518854461,MCWP 50R,B00,518792,Staff,3,0,20,17
1713518854461,MCWP 50R,C00,518793,Staff,5,0,20,15
1713518854461,MCWP 50R,D00,518794,Staff,0,0,20,20
1713518854461,MCWP 50R,E00,518795,Staff,0,0,20,20
1713518854461,MCWP 50R,F00,518796,Staff,10,0,20,10
1713518854461,MCWP 50R,G00,518797,Staff,10,0,20,10
1713518855486,MMW 12R,A01,514034,Herbst; Matthew,1,0,16,15
1713518855486,MMW 12R,A02,514035,Herbst; Matthew,13,0,16,3
1713518856515,MMW 13R,A01,514037,Staff,0,8,16,16
1713518856515,MMW 13R,A02,514039,Staff,0,7,16,16
1713518858568,SIO 295LS,A00,523233,Staff,15,0,30,15
1713518859593,SIO 295S,A00,523232,Staff,15,0,30,15
1713518860619,SOCI 117,A01,494376,Staff,0,2,5,5
1713518861648,WES 237B,A00,494380,Staff,19,0,20,1
1713518863717,AESE 279B,A00,494370,Wade; Jon P,33,0,33,0
1713518864745,AIP 197,001,627712,Vespa; Emanuel Ignacio,9999,0,9999,0
1713518865772,ANAR 135S,A00,494369,Braswell; Geoffrey E.,0,0,0,0
1713518866801,CAT 124RS,A01,519847,Geibel; William,6,0,20,14
1713518867829,CAT 125RS,A01,515971,Geibel; William,6,0,20,14
1713518868856,CLRE 250,A00,511389,Morris; Sheldon,9996,0,9999,3
1713518869888,CLRE 251,A00,507176,Mehta; Ravindra L.,9996,0,9999,3
1713518869888,CLRE 251,B00,511410,Mehta; Ravindra L.,9998,0,9999,1
1713518870917,CLRE 252,A00,507189,Cuomo; Raphael Eduardo,9998,0,9999,1
1713518871943,CLRE 253,A00,507199,Vaida; Florin,9997,0,9999,2
1713518871943,CLRE 253,B00,507202,Vaida; Florin,9999,0,9999,0
1713518872969,CLRE 259,A00,507211,Patel; Hemal,9996,0,9999,3
1713518873995,CLRE 260,A00,507221,Cuomo; Raphael Eduardo,9999,0,9999,0
1713518875020,CLRE 297,001,507242,Cuomo; Raphael Eduardo,9999,0,9999,0
1713518876045,CSE 191,A00,516875,Minnes Kemp; Mor Mia,9999,0,9999,0
1713518877073,CSS 201S,A01,494383,Staff,35,0,35,0
1713518878102,CSS 202S,A01,494387,Staff,35,0,35,0
1713518879127,EAP 100,A00,516065,Staff,9792,0,9999,207
1713518880155,ECE 45,A01,507414,Staff,37,0,60,23
1713518881181,ECE 100,A01,507416,Baghdadchi; Saharnaz,0,0,20,20
1713518881181,ECE 100,A02,507418,Baghdadchi; Saharnaz,19,0,20,1
1713518882206,ECE 111,A01,507420,Staff,27,0,50,23
1713518883234,ECE 197,001,548057,Sievenpiper; Daniel F.,9998,0,9999,1
1713518884259,EDS 115,A00,507243,Choi; Bailey Miyeon,27,0,28,1
1713518885287,EDS 117,A01,494379,Staff,14,0,25,11
1713518886319,EDS 125,A00,507246,Hopkins; Megan Beth,27,0,30,3
1713518887346,EDS 128A,A01,507264,Fargason; Sharon Gayle,26,0,26,0
1713518888376,EDS 128B,A01,507293,Pappas; Elizabeth,30,0,30,0
1713518889403,EDS 139,A00,507294,Fargason; Sharon Gayle,30,0,30,0
1713518889403,EDS 139,B00,507313,Pappas; Elizabeth,30,0,30,0
1713518890485,EDS 201,A00,507315,Staff,18,0,30,12
1713518891512,EDS 203,A01,507317,Halter; Christopher P.,17,0,30,13
1713518892544,EDS 204R,A01,507319,Halter; Christopher P.,0,1,30,30
1713518892544,EDS 204R,B01,507331,Heinzman; Erica M.,22,0,30,8
1713518893568,EDS 206R,A00,507332,Staff,0,2,30,30
1713518893568,EDS 206R,B00,507343,Staff,23,0,30,7
1713518894593,EDS 250,A00,507344,Hemans; Patricia Ann Benitez,27,0,40,13
1713518895618,EDS 281,A00,507345,Daly; Alan J.,18,0,18,0
1713518896642,EDS 284,A00,507350,Daly; Alan J.,16,0,16,0
1713518897672,EDS 286,A00,507359,Fine; Sarah,18,0,18,0
1713518898698,EDS 289C,A01,507361,Daly; Alan J.,18,0,18,0
1713518899726,EDS 290,A00,507366,Hofstetter; Carolyn,15,0,15,0
1713518900758,LIGM 5A,A00,507421,Fischer-Grunski; Eva K,20,0,20,0
1713518901784,LIGM 5B,A00,507423,Fischer-Grunski; Eva K,20,0,20,0
1713518902812,LIGM 5C,A00,507425,Fischer-Grunski; Eva K,20,0,20,0
1713518903838,LIIT 5AS,A00,507427,Carnelos; Chiara,20,0,20,0
1713518904868,LIIT 5BS,A00,507430,Carnelos; Chiara,20,0,20,0
1713518905893,LIIT 5CS,A00,507432,Carnelos; Chiara,20,0,20,0
1713518906918,LISP 5A,A00,507541,Munoz Sanchez; Alicia,14,0,20,6
1713518907943,LISP 5B,A00,507671,Munoz Sanchez; Alicia,12,0,20,8
1713518908969,LISP 5C,A00,507696,Munoz Sanchez; Alicia,11,0,20,9
1713518909996,MAE 197,001,528363,Boechler; Nicholas Sebastia,9998,0,9999,1
1713518911022,MATH 197,001,523477,Kedlaya; Kiran S.,9999,0,9999,0
1713518911022,MATH 197,002,563811,Zhang; Danna,9998,0,9999,1
1713518912051,MCWP 40R,A00,518780,Staff,13,0,20,7
1713518912051,MCWP 40R,B00,518781,Staff,11,0,20,9
1713518912051,MCWP 40R,C00,518783,Staff,8,0,20,12
1713518913079,MCWP 50R,A00,518791,Staff,7,0,20,13
1713518913079,MCWP 50R,B00,518792,Staff,3,0,20,17
1713518913079,MCWP 50R,C00,518793,Staff,5,0,20,15
1713518913079,MCWP 50R,D00,518794,Staff,0,0,20,20
1713518913079,MCWP 50R,E00,518795,Staff,0,0,20,20
1713518913079,MCWP 50R,F00,518796,Staff,10,0,20,10
1713518913079,MCWP 50R,G00,518797,Staff,10,0,20,10
1713518914104,MMW 12R,A01,514034,Herbst; Matthew,1,0,16,15
1713518914104,MMW 12R,A02,514035,Herbst; Matthew,13,0,16,3
1713518915129,MMW 13R,A01,514037,Staff,0,8,16,16
1713518915129,MMW 13R,A02,514039,Staff,0,7,16,16
1713518917180,SIO 295LS,A00,523233,Staff,15,0,30,15
1713518918206,SIO 295S,A00,523232,Staff,15,0,30,15
1713518919232,SOCI 117,A01,494376,Staff,0,2,5,5
1713518920258,WES 237B,A00,494380,Staff,19,0,20,1
1713518922325,AESE 279B,A00,494370,Wade; Jon P,33,0,33,0
1713518923348,AIP 197,001,627712,Vespa; Emanuel Ignacio,9999,0,9999,0
1713518924377,ANAR 135S,A00,494369,Braswell; Geoffrey E.,0,0,0,0
1713518925403,CAT 124RS,A01,519847,Geibel; William,6,0,20,14
1713518926427,CAT 125RS,A01,515971,Geibel; William,6,0,20,14
1713518927456,CLRE 250,A00,511389,Morris; Sheldon,9996,0,9999,3
1713518928483,CLRE 251,A00,507176,Mehta; Ravindra L.,9996,0,9999,3
1713518928483,CLRE 251,B00,511410,Mehta; Ravindra L.,9998,0,9999,1
1713518929513,CLRE 252,A00,507189,Cuomo; Raphael Eduardo,9998,0,9999,1
1713518930538,CLRE 253,A00,507199,Vaida; Florin,9997,0,9999,2
1713518930538,CLRE 253,B00,507202,Vaida; Florin,9999,0,9999,0
1713518931565,CLRE 259,A00,507211,Patel; Hemal,9996,0,9999,3
1713518932595,CLRE 260,A00,507221,Cuomo; Raphael Eduardo,9999,0,9999,0
1713518933623,CLRE 297,001,507242,Cuomo; Raphael Eduardo,9999,0,9999,0
1713518934651,CSE 191,A00,516875,Minnes Kemp; Mor Mia,9999,0,9999,0
1713518935677,CSS 201S,A01,494383,Staff,35,0,35,0
1713518936703,CSS 202S,A01,494387,Staff,35,0,35,0
1713518937732,EAP 100,A00,516065,Staff,9792,0,9999,207
1713518938759,ECE 45,A01,507414,Staff,37,0,60,23
1713518939789,ECE 100,A01,507416,Baghdadchi; Saharnaz,0,0,20,20
1713518939789,ECE 100,A02,507418,Baghdadchi; Saharnaz,19,0,20,1
1713518940819,ECE 111,A01,507420,Staff,27,0,50,23
1713518941844,ECE 197,001,548057,Sievenpiper; Daniel F.,9998,0,9999,1
1713518942874,EDS 115,A00,507243,Choi; Bailey Miyeon,27,0,28,1
1713518943900,EDS 117,A01,494379,Staff,14,0,25,11
1713518944926,EDS 125,A00,507246,Hopkins; Megan Beth,27,0,30,3
1713518945951,EDS 128A,A01,507264,Fargason; Sharon Gayle,26,0,26,0
1713518946978,EDS 128B,A01,507293,Pappas; Elizabeth,30,0,30,0
1713518948007,EDS 139,A00,507294,Fargason; Sharon Gayle,30,0,30,0
1713518948007,EDS 139,B00,507313,Pappas; Elizabeth,30,0,30,0
1713518949034,EDS 201,A00,507315,Staff,18,0,30,12
1713518950060,EDS 203,A01,507317,Halter; Christopher P.,17,0,30,13
1713518951090,EDS 204R,A01,507319,Halter; Christopher P.,0,1,30,30
1713518951090,EDS 204R,B01,507331,Heinzman; Erica M.,22,0,30,8
1713518952119,EDS 206R,A00,507332,Staff,0,2,30,30
1713518952119,EDS 206R,B00,507343,Staff,23,0,30,7
1713518953149,EDS 250,A00,507344,Hemans; Patricia Ann Benitez,27,0,40,13
1713518954175,EDS 281,A00,507345,Daly; Alan J.,18,0,18,0
1713518955203,EDS 284,A00,507350,Daly; Alan J.,16,0,16,0
1713518956229,EDS 286,A00,507359,Fine; Sarah,18,0,18,0
1713518957259,EDS 289C,A01,507361,Daly; Alan J.,18,0,18,0
1713518958287,EDS 290,A00,507366,Hofstetter; Carolyn,15,0,15,0
1713518959317,LIGM 5A,A00,507421,Fischer-Grunski; Eva K,20,0,20,0
1713518960343,LIGM 5B,A00,507423,Fischer-Grunski; Eva K,20,0,20,0
1713518961369,LIGM 5C,A00,507425,Fischer-Grunski; Eva K,20,0,20,0
1713518962397,LIIT 5AS,A00,507427,Carnelos; Chiara,20,0,20,0
1713518963426,LIIT 5BS,A00,507430,Carnelos; Chiara,20,0,20,0
1713518964452,LIIT 5CS,A00,507432,Carnelos; Chiara,20,0,20,0
1713518965478,LISP 5A,A00,507541,Munoz Sanchez; Alicia,14,0,20,6
1713518966511,LISP 5B,A00,507671,Munoz Sanchez; Alicia,12,0,20,8
1713518967544,LISP 5C,A00,507696,Munoz Sanchez; Alicia,11,0,20,9
1713518968570,MAE 197,001,528363,Boechler; Nicholas Sebastia,9998,0,9999,1
1713518969603,MATH 197,001,523477,Kedlaya; Kiran S.,9999,0,9999,0
1713518969603,MATH 197,002,563811,Zhang; Danna,9998,0,9999,1
1713518970628,MCWP 40R,A00,518780,Staff,13,0,20,7
1713518970628,MCWP 40R,B00,518781,Staff,11,0,20,9
1713518970628,MCWP 40R,C00,518783,Staff,8,0,20,12
1713518971659,MCWP 50R,A00,518791,Staff,7,0,20,13
1713518971659,MCWP 50R,B00,518792,Staff,3,0,20,17
1713518971659,MCWP 50R,C00,518793,Staff,5,0,20,15
1713518971659,MCWP 50R,D00,518794,Staff,0,0,20,20
1713518971659,MCWP 50R,E00,518795,Staff,0,0,20,20
1713518971659,MCWP 50R,F00,518796,Staff,10,0,20,10
1713518971659,MCWP 50R,G00,518797,Staff,10,0,20,10
1713518972688,MMW 12R,A01,514034,Herbst; Matthew,1,0,16,15
1713518972688,MMW 12R,A02,514035,Herbst; Matthew,13,0,16,3
1713518973716,MMW 13R,A01,514037,Staff,0,8,16,16
1713518973716,MMW 13R,A02,514039,Staff,0,7,16,16
1713518975774,SIO 295LS,A00,523233,Staff,15,0,30,15
1713518976802,SIO 295S,A00,523232,Staff,15,0,30,15
1713518977832,SOCI 117,A01,494376,Staff,0,2,5,5
1713518978858,WES 237B,A00,494380,Staff,19,0,20,1
1713518980941,AESE 279B,A00,494370,Wade; Jon P,33,0,33,0
1713518981971,AIP 197,001,627712,Vespa; Emanuel Ignacio,9999,0,9999,0
1713518982998,ANAR 135S,A00,494369,Braswell; Geoffrey E.,0,0,0,0
1713518984024,CAT 124RS,A01,519847,Geibel; William,6,0,20,14
1713518985055,CAT 125RS,A01,515971,Geibel; William,6,0,20,14
1713518986080,CLRE 250,A00,511389,Morris; Sheldon,9996,0,9999,3
1713518987108,CLRE 251,A00,507176,Mehta; Ravindra L.,9996,0,9999,3
1713518987108,CLRE 251,B00,511410,Mehta; Ravindra L.,9998,0,9999,1
1713518988136,CLRE 252,A00,507189,Cuomo; Raphael Eduardo,9998,0,9999,1
1713518989167,CLRE 253,A00,507199,Vaida; Florin,9997,0,9999,2
1713518989167,CLRE 253,B00,507202,Vaida; Florin,9999,0,9999,0
1713518990193,CLRE 259,A00,507211,Patel; Hemal,9996,0,9999,3
1713518991220,CLRE 260,A00,507221,Cuomo; Raphael Eduardo,9999,0,9999,0
1713518992247,CLRE 297,001,507242,Cuomo; Raphael Eduardo,9999,0,9999,0
1713518993273,CSE 191,A00,516875,Minnes Kemp; Mor Mia,9999,0,9999,0
1713518994360,CSS 201S,A01,494383,Staff,35,0,35,0
1713518995385,CSS 202S,A01,494387,Staff,35,0,35,0
1713518996412,EAP 100,A00,516065,Staff,9792,0,9999,207
1713518997438,ECE 45,A01,507414,Staff,37,0,60,23
1713518998462,ECE 100,A01,507416,Baghdadchi; Saharnaz,0,0,20,20
1713518998462,ECE 100,A02,507418,Baghdadchi; Saharnaz,19,0,20,1
1713518999491,ECE 111,A01,507420,Staff,27,0,50,23
1713519000525,ECE 197,001,548057,Sievenpiper; Daniel F.,9998,0,9999,1
1713519001551,EDS 115,A00,507243,Choi; Bailey Miyeon,27,0,28,1
1713519002580,EDS 117,A01,494379,Staff,14,0,25,11
1713519003605,EDS 125,A00,507246,Hopkins; Megan Beth,27,0,30,3
1713519004636,EDS 128A,A01,507264,Fargason; Sharon Gayle,26,0,26,0
1713519005667,EDS 128B,A01,507293,Pappas; Elizabeth,30,0,30,0
1713519006695,EDS 139,A00,507294,Fargason; Sharon Gayle,30,0,30,0
1713519006695,EDS 139,B00,507313,Pappas; Elizabeth,30,0,30,0
1713519007718,EDS 201,A00,507315,Staff,18,0,30,12
1713519008743,EDS 203,A01,507317,Halter; Christopher P.,17,0,30,13
1713519009779,EDS 204R,A01,507319,Halter; Christopher P.,0,1,30,30
1713519009779,EDS 204R,B01,507331,Heinzman; Erica M.,22,0,30,8
1713519010805,EDS 206R,A00,507332,Staff,0,2,30,30
1713519010805,EDS 206R,B00,507343,Staff,23,0,30,7
1713519011831,EDS 250,A00,507344,Hemans; Patricia Ann Benitez,27,0,40,13
1713519012856,EDS 281,A00,507345,Daly; Alan J.,18,0,18,0
1713519013883,EDS 284,A00,507350,Daly; Alan J.,16,0,16,0
1713519014911,EDS 286,A00,507359,Fine; Sarah,18,0,18,0
1713519015936,EDS 289C,A01,507361,Daly; Alan J.,18,0,18,0
1713519016963,EDS 290,A00,507366,Hofstetter; Carolyn,15,0,15,0
1713519017988,LIGM 5A,A00,507421,Fischer-Grunski; Eva K,20,0,20,0
1713519019014,LIGM 5B,A00,507423,Fischer-Grunski; Eva K,20,0,20,0
1713519020047,LIGM 5C,A00,507425,Fischer-Grunski; Eva K,20,0,20,0
1713519021071,LIIT 5AS,A00,507427,Carnelos; Chiara,20,0,20,0
1713519022101,LIIT 5BS,A00,507430,Carnelos; Chiara,20,0,20,0
1713519023125,LIIT 5CS,A00,507432,Carnelos; Chiara,20,0,20,0
1713519024155,LISP 5A,A00,507541,Munoz Sanchez; Alicia,14,0,20,6
1713519025180,LISP 5B,A00,507671,Munoz Sanchez; Alicia,12,0,20,8
1713519026206,LISP 5C,A00,507696,Munoz Sanchez; Alicia,11,0,20,9
1713519027231,MAE 197,001,528363,Boechler; Nicholas Sebastia,9998,0,9999,1
1713519028257,MATH 197,001,523477,Kedlaya; Kiran S.,9999,0,9999,0
1713519028257,MATH 197,002,563811,Zhang; Danna,9998,0,9999,1
1713519029284,MCWP 40R,A00,518780,Staff,13,0,20,7
1713519029284,MCWP 40R,B00,518781,Staff,11,0,20,9
1713519029284,MCWP 40R,C00,518783,Staff,8,0,20,12
1713519030311,MCWP 50R,A00,518791,Staff,7,0,20,13
1713519030311,MCWP 50R,B00,518792,Staff,3,0,20,17
1713519030311,MCWP 50R,C00,518793,Staff,5,0,20,15
1713519030311,MCWP 50R,D00,518794,Staff,0,0,20,20
1713519030311,MCWP 50R,E00,518795,Staff,0,0,20,20
1713519030311,MCWP 50R,F00,518796,Staff,10,0,20,10
1713519030311,MCWP 50R,G00,518797,Staff,10,0,20,10
1713519031336,MMW 12R,A01,514034,Herbst; Matthew,1,0,16,15
1713519031336,MMW 12R,A02,514035,Herbst; Matthew,13,0,16,3
1713519032365,MMW 13R,A01,514037,Staff,0,8,16,16
1713519032365,MMW 13R,A02,514039,Staff,0,7,16,16
1713519034422,SIO 295LS,A00,523233,Staff,15,0,30,15
1713519035447,SIO 295S,A00,523232,Staff,15,0,30,15
1713519036473,SOCI 117,A01,494376,Staff,0,2,5,5
1713519037505,WES 237B,A00,494380,Staff,19,0,20,1
1713519039592,AESE 279B,A00,494370,Wade; Jon P,33,0,33,0
1713519040617,AIP 197,001,627712,Vespa; Emanuel Ignacio,9999,0,9999,0
1713519041645,ANAR 135S,A00,494369,Braswell; Geoffrey E.,0,0,0,0
1713519042670,CAT 124RS,A01,519847,Geibel; William,6,0,20,14
1713519043695,CAT 125RS,A01,515971,Geibel; William,6,0,20,14
1713519044722,CLRE 250,A00,511389,Morris; Sheldon,9996,0,9999,3
1713519045753,CLRE 251,A00,507176,Mehta; Ravindra L.,9996,0,9999,3
1713519045753,CLRE 251,B00,511410,Mehta; Ravindra L.,9998,0,9999,1
1713519046782,CLRE 252,A00,507189,Cuomo; Raphael Eduardo,9998,0,9999,1
1713519047812,CLRE 253,A00,507199,Vaida; Florin,9997,0,9999,2
1713519047812,CLRE 253,B00,507202,Vaida; Florin,9999,0,9999,0
1713519048836,CLRE 259,A00,507211,Patel; Hemal,9996,0,9999,3
1713519049865,CLRE 260,A00,507221,Cuomo; Raphael Eduardo,9999,0,9999,0
1713519050891,CLRE 297,001,507242,Cuomo; Raphael Eduardo,9999,0,9999,0
1713519051920,CSE 191,A00,516875,Minnes Kemp; Mor Mia,9999,0,9999,0
1713519052947,CSS 201S,A01,494383,Staff,35,0,35,0
1713519053974,CSS 202S,A01,494387,Staff,35,0,35,0
1713519055002,EAP 100,A00,516065,Staff,9792,0,9999,207
1713519056028,ECE 45,A01,507414,Staff,37,0,60,23
1713519057055,ECE 100,A01,507416,Baghdadchi; Saharnaz,0,0,20,20
1713519057055,ECE 100,A02,507418,Baghdadchi; Saharnaz,19,0,20,1
1713519058080,ECE 111,A01,507420,Staff,27,0,50,23
1713519059105,ECE 197,001,548057,Sievenpiper; Daniel F.,9998,0,9999,1
1713519060160,EDS 115,A00,507243,Choi; Bailey Miyeon,27,0,28,1
1713519061186,EDS 117,A01,494379,Staff,14,0,25,11
1713519062219,EDS 125,A00,507246,Hopkins; Megan Beth,27,0,30,3
1713519063252,EDS 128A,A01,507264,Fargason; Sharon Gayle,26,0,26,0
1713519064278,EDS 128B,A01,507293,Pappas; Elizabeth,30,0,30,0
1713519065303,EDS 139,A00,507294,Fargason; Sharon Gayle,30,0,30,0
1713519065303,EDS 139,B00,507313,Pappas; Elizabeth,30,0,30,0
1713519066328,EDS 201,A00,507315,Staff,18,0,30,12
1713519067357,EDS 203,A01,507317,Halter; Christopher P.,17,0,30,13
1713519068388,EDS 204R,A01,507319,Halter; Christopher P.,0,1,30,30
1713519068388,EDS 204R,B01,507331,Heinzman; Erica M.,22,0,30,8
1713519069416,EDS 206R,A00,507332,Staff,0,2,30,30
1713519069416,EDS 206R,B00,507343,Staff,23,0,30,7
1713519070448,EDS 250,A00,507344,Hemans; Patricia Ann Benitez,27,0,40,13
1713519071478,EDS 281,A00,507345,Daly; Alan J.,18,0,18,0
1713519072507,EDS 284,A00,507350,Daly; Alan J.,16,0,16,0
1713519073533,EDS 286,A00,507359,Fine; Sarah,18,0,18,0
1713519074563,EDS 289C,A01,507361,Daly; Alan J.,18,0,18,0
1713519075593,EDS 290,A00,507366,Hofstetter; Carolyn,15,0,15,0
1713519076618,LIGM 5A,A00,507421,Fischer-Grunski; Eva K,20,0,20,0
1713519077644,LIGM 5B,A00,507423,Fischer-Grunski; Eva K,20,0,20,0
1713519078669,LIGM 5C,A00,507425,Fischer-Grunski; Eva K,20,0,20,0
1713519079695,LIIT 5AS,A00,507427,Carnelos; Chiara,20,0,20,0
1713519080721,LIIT 5BS,A00,507430,Carnelos; Chiara,20,0,20,0
1713519081749,LIIT 5CS,A00,507432,Carnelos; Chiara,20,0,20,0
1713519082775,LISP 5A,A00,507541,Munoz Sanchez; Alicia,14,0,20,6
1713519083801,LISP 5B,A00,507671,Munoz Sanchez; Alicia,12,0,20,8
1713519084829,LISP 5C,A00,507696,Munoz Sanchez; Alicia,11,0,20,9
1713519085857,MAE 197,001,528363,Boechler; Nicholas Sebastia,9998,0,9999,1
1713519086882,MATH 197,001,523477,Kedlaya; Kiran S.,9999,0,9999,0
1713519086882,MATH 197,002,563811,Zhang; Danna,9998,0,9999,1
1713519087907,MCWP 40R,A00,518780,Staff,13,0,20,7
1713519087907,MCWP 40R,B00,518781,Staff,11,0,20,9
1713519087907,MCWP 40R,C00,518783,Staff,8,0,20,12
1713519088936,MCWP 50R,A00,518791,Staff,7,0,20,13
1713519088936,MCWP 50R,B00,518792,Staff,3,0,20,17
1713519088936,MCWP 50R,C00,518793,Staff,5,0,20,15
1713519088936,MCWP 50R,D00,518794,Staff,0,0,20,20
1713519088936,MCWP 50R,E00,518795,Staff,0,0,20,20
1713519088936,MCWP 50R,F00,518796,Staff,10,0,20,10
1713519088936,MCWP 50R,G00,518797,Staff,10,0,20,10
1713519089961,MMW 12R,A01,514034,Herbst; Matthew,1,0,16,15
1713519089961,MMW 12R,A02,514035,Herbst; Matthew,13,0,16,3
1713519090989,MMW 13R,A01,514037,Staff,0,8,16,16
1713519090989,MMW 13R,A02,514039,Staff,0,7,16,16
1713519093046,SIO 295LS,A00,523233,Staff,15,0,30,15
1713519094072,SIO 295S,A00,523232,Staff,15,0,30,15
1713519095097,SOCI 117,A01,494376,Staff,0,2,5,5
1713519096126,WES 237B,A00,494380,Staff,19,0,20,1
1713519098304,AESE 279B,A00,494370,Wade; Jon P,33,0,33,0
1713519099331,AIP 197,001,627712,Vespa; Emanuel Ignacio,9999,0,9999,0
1713519100361,ANAR 135S,A00,494369,Braswell; Geoffrey E.,0,0,0,0
1713519101386,CAT 124RS,A01,519847,Geibel; William,6,0,20,14
1713519102412,CAT 125RS,A01,515971,Geibel; William,6,0,20,14
1713519103439,CLRE 250,A00,511389,Morris; Sheldon,9996,0,9999,3
1713519104466,CLRE 251,A00,507176,Mehta; Ravindra L.,9996,0,9999,3
1713519104466,CLRE 251,B00,511410,Mehta; Ravindra L.,9998,0,9999,1
1713519105494,CLRE 252,A00,507189,Cuomo; Raphael Eduardo,9998,0,9999,1
1713519106518,CLRE 253,A00,507199,Vaida; Florin,9997,0,9999,2
1713519106518,CLRE 253,B00,507202,Vaida; Florin,9999,0,9999,0
1713519107543,CLRE 259,A00,507211,Patel; Hemal,9996,0,9999,3
1713519108569,CLRE 260,A00,507221,Cuomo; Raphael Eduardo,9999,0,9999,0
1713519109598,CLRE 297,001,507242,Cuomo; Raphael Eduardo,9999,0,9999,0
1713519110623,CSE 191,A00,516875,Minnes Kemp; Mor Mia,9999,0,9999,0
1713519111650,CSS 201S,A01,494383,Staff,35,0,35,0
1713519112677,CSS 202S,A01,494387,Staff,35,0,35,0
1713519113702,EAP 100,A00,516065,Staff,9792,0,9999,207
1713519114728,ECE 45,A01,507414,Staff,37,0,60,23
1713519115754,ECE 100,A01,507416,Baghdadchi; Saharnaz,0,0,20,20
1713519115754,ECE 100,A02,507418,Baghdadchi; Saharnaz,19,0,20,1
1713519116783,ECE 111,A01,507420,Staff,27,0,50,23
1713519117809,ECE 197,001,548057,Sievenpiper; Daniel F.,9998,0,9999,1
1713519118835,EDS 115,A00,507243,Choi; Bailey Miyeon,27,0,28,1
1713519119861,EDS 117,A01,494379,Staff,14,0,25,11
1713519120886,EDS 125,A00,507246,Hopkins; Megan Beth,27,0,30,3
1713519121918,EDS 128A,A01,507264,Fargason; Sharon Gayle,26,0,26,0
1713519122944,EDS 128B,A01,507293,Pappas; Elizabeth,30,0,30,0
1713519123971,EDS 139,A00,507294,Fargason; Sharon Gayle,30,0,30,0
1713519123971,EDS 139,B00,507313,Pappas; Elizabeth,30,0,30,0
1713519124996,EDS 201,A00,507315,Staff,18,0,30,12
1713519126026,EDS 203,A01,507317,Halter; Christopher P.,17,0,30,13
1713519127053,EDS 204R,A01,507319,Halter; Christopher P.,0,1,30,30
1713519127053,EDS 204R,B01,507331,Heinzman; Erica M.,22,0,30,8
1713519128079,EDS 206R,A00,507332,Staff,0,2,30,30
1713519128079,EDS 206R,B00,507343,Staff,23,0,30,7
1713519129108,EDS 250,A00,507344,Hemans; Patricia Ann Benitez,27,0,40,13
1713519130135,EDS 281,A00,507345,Daly; Alan J.,18,0,18,0
1713519131161,EDS 284,A00,507350,Daly; Alan J.,16,0,16,0
1713519132187,EDS 286,A00,507359,Fine; Sarah,18,0,18,0
1713519133216,EDS 289C,A01,507361,Daly; Alan J.,18,0,18,0
1713519134246,EDS 290,A00,507366,Hofstetter; Carolyn,15,0,15,0
1713519135275,LIGM 5A,A00,507421,Fischer-Grunski; Eva K,20,0,20,0
1713519136304,LIGM 5B,A00,507423,Fischer-Grunski; Eva K,20,0,20,0
1713519137329,LIGM 5C,A00,507425,Fischer-Grunski; Eva K,20,0,20,0
1713519138359,LIIT 5AS,A00,507427,Carnelos; Chiara,20,0,20,0
1713519139386,LIIT 5BS,A00,507430,Carnelos; Chiara,20,0,20,0
1713519140411,LIIT 5CS,A00,507432,Carnelos; Chiara,20,0,20,0
1713519141439,LISP 5A,A00,507541,Munoz Sanchez; Alicia,14,0,20,6
1713519142464,LISP 5B,A00,507671,Munoz Sanchez; Alicia,12,0,20,8
1713519143493,LISP 5C,A00,507696,Munoz Sanchez; Alicia,11,0,20,9
1713519144523,MAE 197,001,528363,Boechler; Nicholas Sebastia,9998,0,9999,1
1713519145548,MATH 197,001,523477,Kedlaya; Kiran S.,9999,0,9999,0
1713519145548,MATH 197,002,563811,Zhang; Danna,9998,0,9999,1
1713519146574,MCWP 40R,A00,518780,Staff,13,0,20,7
1713519146574,MCWP 40R,B00,518781,Staff,11,0,20,9
1713519146574,MCWP 40R,C00,518783,Staff,8,0,20,12
1713519147602,MCWP 50R,A00,518791,Staff,7,0,20,13
1713519147602,MCWP 50R,B00,518792,Staff,3,0,20,17
1713519147602,MCWP 50R,C00,518793,Staff,5,0,20,15
1713519147602,MCWP 50R,D00,518794,Staff,0,0,20,20
1713519147602,MCWP 50R,E00,518795,Staff,0,0,20,20
1713519147602,MCWP 50R,F00,518796,Staff,10,0,20,10
1713519147602,MCWP 50R,G00,518797,Staff,10,0,20,10
1713519148628,MMW 12R,A01,514034,Herbst; Matthew,1,0,16,15
1713519148628,MMW 12R,A02,514035,Herbst; Matthew,13,0,16,3
1713519149656,MMW 13R,A01,514037,Staff,0,8,16,16
1713519149656,MMW 13R,A02,514039,Staff,0,7,16,16
1713519151707,SIO 295LS,A00,523233,Staff,15,0,30,15
1713519152733,SIO 295S,A00,523232,Staff,15,0,30,15
1713519153758,SOCI 117,A01,494376,Staff,0,2,5,5
1713519154785,WES 237B,A00,494380,Staff,19,0,20,1
1713519156850,AESE 279B,A00,494370,Wade; Jon P,33,0,33,0
1713519157878,AIP 197,001,627712,Vespa; Emanuel Ignacio,9999,0,9999,0
1713519158909,ANAR 135S,A00,494369,Braswell; Geoffrey E.,0,0,0,0
1713519159934,CAT 124RS,A01,519847,Geibel; William,6,0,20,14
1713519160959,CAT 125RS,A01,515971,Geibel; William,6,0,20,14
1713519161984,CLRE 250,A00,511389,Morris; Sheldon,9996,0,9999,3
1713519163019,CLRE 251,A00,507176,Mehta; Ravindra L.,9996,0,9999,3
1713519163019,CLRE 251,B00,511410,Mehta; Ravindra L.,9998,0,9999,1
1713519164049,CLRE 252,A00,507189,Cuomo; Raphael Eduardo,9998,0,9999,1
1713519165079,CLRE 253,A00,507199,Vaida; Florin,9997,0,9999,2
1713519165079,CLRE 253,B00,507202,Vaida; Florin,9999,0,9999,0
1713519166109,CLRE 259,A00,507211,Patel; Hemal,9996,0,9999,3
1713519167137,CLRE 260,A00,507221,Cuomo; Raphael Eduardo,9999,0,9999,0
1713519168163,CLRE 297,001,507242,Cuomo; Raphael Eduardo,9999,0,9999,0
1713519169190,CSE 191,A00,516875,Minnes Kemp; Mor Mia,9999,0,9999,0
1713519170220,CSS 201S,A01,494383,Staff,35,0,35,0
1713519171246,CSS 202S,A01,494387,Staff,35,0,35,0
1713519172271,EAP 100,A00,516065,Staff,9792,0,9999,207
1713519173297,ECE 45,A01,507414,Staff,37,0,60,23
1713519174324,ECE 100,A01,507416,Baghdadchi; Saharnaz,0,0,20,20
1713519174324,ECE 100,A02,507418,Baghdadchi; Saharnaz,19,0,20,1
1713519175349,ECE 111,A01,507420,Staff,27,0,50,23
1713519176374,ECE 197,001,548057,Sievenpiper; Daniel F.,9998,0,9999,1
1713519177406,EDS 115,A00,507243,Choi; Bailey Miyeon,27,0,28,1
1713519178433,EDS 117,A01,494379,Staff,14,0,25,11
1713519179464,EDS 125,A00,507246,Hopkins; Megan Beth,27,0,30,3
1713519180499,EDS 128A,A01,507264,Fargason; Sharon Gayle,26,0,26,0
1713519181524,EDS 128B,A01,507293,Pappas; Elizabeth,30,0,30,0
1713519182551,EDS 139,A00,507294,Fargason; Sharon Gayle,30,0,30,0
1713519182551,EDS 139,B00,507313,Pappas; Elizabeth,30,0,30,0
1713519183579,EDS 201,A00,507315,Staff,18,0,30,12
1713519184610,EDS 203,A01,507317,Halter; Christopher P.,17,0,30,13
1713519185641,EDS 204R,A01,507319,Halter; Christopher P.,0,1,30,30
1713519185641,EDS 204R,B01,507331,Heinzman; Erica M.,22,0,30,8
1713519186673,EDS 206R,A00,507332,Staff,0,2,30,30
1713519186673,EDS 206R,B00,507343,Staff,23,0,30,7
1713519187703,EDS 250,A00,507344,Hemans; Patricia Ann Benitez,27,0,40,13
1713519188732,EDS 281,A00,507345,Daly; Alan J.,18,0,18,0
1713519189760,EDS 284,A00,507350,Daly; Alan J.,16,0,16,0
1713519190786,EDS 286,A00,507359,Fine; Sarah,18,0,18,0
1713519191811,EDS 289C,A01,507361,Daly; Alan J.,18,0,18,0
1713519192840,EDS 290,A00,507366,Hofstetter; Carolyn,15,0,15,0
1713519193865,LIGM 5A,A00,507421,Fischer-Grunski; Eva K,20,0,20,0
1713519194892,LIGM 5B,A00,507423,Fischer-Grunski; Eva K,20,0,20,0
1713519195922,LIGM 5C,A00,507425,Fischer-Grunski; Eva K,20,0,20,0
1713519196953,LIIT 5AS,A00,507427,Carnelos; Chiara,20,0,20,0
1713519197979,LIIT 5BS,A00,507430,Carnelos; Chiara,20,0,20,0
1713519199004,LIIT 5CS,A00,507432,Carnelos; Chiara,20,0,20,0
1713519200035,LISP 5A,A00,507541,Munoz Sanchez; Alicia,14,0,20,6
1713519201062,LISP 5B,A00,507671,Munoz Sanchez; Alicia,12,0,20,8
1713519202143,LISP 5C,A00,507696,Munoz Sanchez; Alicia,11,0,20,9
1713519203173,MAE 197,001,528363,Boechler; Nicholas Sebastia,9998,0,9999,1
1713519204197,MATH 197,001,523477,Kedlaya; Kiran S.,9999,0,9999,0
1713519204197,MATH 197,002,563811,Zhang; Danna,9998,0,9999,1
1713519205228,MCWP 40R,A00,518780,Staff,13,0,20,7
1713519205228,MCWP 40R,B00,518781,Staff,11,0,20,9
1713519205228,MCWP 40R,C00,518783,Staff,8,0,20,12
1713519206254,MCWP 50R,A00,518791,Staff,7,0,20,13
1713519206254,MCWP 50R,B00,518792,Staff,3,0,20,17
1713519206254,MCWP 50R,C00,518793,Staff,5,0,20,15
1713519206254,MCWP 50R,D00,518794,Staff,0,0,20,20
1713519206254,MCWP 50R,E00,518795,Staff,0,0,20,20
1713519206254,MCWP 50R,F00,518796,Staff,10,0,20,10
1713519206254,MCWP 50R,G00,518797,Staff,10,0,20,10
1713519207285,MMW 12R,A01,514034,Herbst; Matthew,1,0,16,15
1713519207285,MMW 12R,A02,514035,Herbst; Matthew,13,0,16,3
1713519208314,MMW 13R,A01,514037,Staff,0,8,16,16
1713519208314,MMW 13R,A02,514039,Staff,0,7,16,16
1713519210364,SIO 295LS,A00,523233,Staff,15,0,30,15
1713519211390,SIO 295S,A00,523232,Staff,15,0,30,15
1713519212416,SOCI 117,A01,494376,Staff,0,2,5,5
1713519213443,WES 237B,A00,494380,Staff,19,0,20,1
1713519215535,AESE 279B,A00,494370,Wade; Jon P,33,0,33,0
1713519216566,AIP 197,001,627712,Vespa; Emanuel Ignacio,9999,0,9999,0
1713519217590,ANAR 135S,A00,494369,Braswell; Geoffrey E.,0,0,0,0
1713519218622,CAT 124RS,A01,519847,Geibel; William,6,0,20,14
1713519219650,CAT 125RS,A01,515971,Geibel; William,6,0,20,14
1713519220675,CLRE 250,A00,511389,Morris; Sheldon,9996,0,9999,3
1713519221702,CLRE 251,A00,507176,Mehta; Ravindra L.,9996,0,9999,3
1713519221702,CLRE 251,B00,511410,Mehta; Ravindra L.,9998,0,9999,1
1713519222728,CLRE 252,A00,507189,Cuomo; Raphael Eduardo,9998,0,9999,1
1713519223763,CLRE 253,A00,507199,Vaida; Florin,9997,0,9999,2
1713519223763,CLRE 253,B00,507202,Vaida; Florin,9999,0,9999,0
1713519224789,CLRE 259,A00,507211,Patel; Hemal,9996,0,9999,3
1713519225818,CLRE 260,A00,507221,Cuomo; Raphael Eduardo,9999,0,9999,0
1713519226846,CLRE 297,001,507242,Cuomo; Raphael Eduardo,9999,0,9999,0
1713519227877,CSE 191,A00,516875,Minnes Kemp; Mor Mia,9999,0,9999,0
1713519228903,CSS 201S,A01,494383,Staff,35,0,35,0
1713519229929,CSS 202S,A01,494387,Staff,35,0,35,0
1713519230955,EAP 100,A00,516065,Staff,9792,0,9999,207
1713519231980,ECE 45,A01,507414,Staff,37,0,60,23
1713519233010,ECE 100,A01,507416,Baghdadchi; Saharnaz,0,0,20,20
1713519233010,ECE 100,A02,507418,Baghdadchi; Saharnaz,19,0,20,1
1713519234038,ECE 111,A01,507420,Staff,27,0,50,23
1713519235066,ECE 197,001,548057,Sievenpiper; Daniel F.,9998,0,9999,1
1713519236098,EDS 115,A00,507243,Choi; Bailey Miyeon,27,0,28,1
1713519237122,EDS 117,A01,494379,Staff,14,0,25,11
1713519238152,EDS 125,A00,507246,Hopkins; Megan Beth,27,0,30,3
1713519239179,EDS 128A,A01,507264,Fargason; Sharon Gayle,26,0,26,0
1713519240208,EDS 128B,A01,507293,Pappas; Elizabeth,30,0,30,0
1713519241239,EDS 139,A00,507294,Fargason; Sharon Gayle,30,0,30,0
1713519241239,EDS 139,B00,507313,Pappas; Elizabeth,30,0,30,0
1713519242274,EDS 201,A00,507315,Staff,18,0,30,12
1713519243309,EDS 203,A01,507317,Halter; Christopher P.,17,0,30,13
1713519244336,EDS 204R,A01,507319,Halter; Christopher P.,0,1,30,30
1713519244336,EDS 204R,B01,507331,Heinzman; Erica M.,22,0,30,8
1713519245360,EDS 206R,A00,507332,Staff,0,2,30,30
1713519245360,EDS 206R,B00,507343,Staff,23,0,30,7
1713519246388,EDS 250,A00,507344,Hemans; Patricia Ann Benitez,27,0,40,13
1713519247412,EDS 281,A00,507345,Daly; Alan J.,18,0,18,0
1713519248436,EDS 284,A00,507350,Daly; Alan J.,16,0,16,0
1713519249465,EDS 286,A00,507359,Fine; Sarah,18,0,18,0
1713519250490,EDS 289C,A01,507361,Daly; Alan J.,18,0,18,0
1713519251521,EDS 290,A00,507366,Hofstetter; Carolyn,15,0,15,0
1713519252545,LIGM 5A,A00,507421,Fischer-Grunski; Eva K,20,0,20,0
1713519253570,LIGM 5B,A00,507423,Fischer-Grunski; Eva K,20,0,20,0
1713519254601,LIGM 5C,A00,507425,Fischer-Grunski; Eva K,20,0,20,0
1713519255631,LIIT 5AS,A00,507427,Carnelos; Chiara,20,0,20,0
1713519256659,LIIT 5BS,A00,507430,Carnelos; Chiara,20,0,20,0
1713519257684,LIIT 5CS,A00,507432,Carnelos; Chiara,20,0,20,0
1713519258714,LISP 5A,A00,507541,Munoz Sanchez; Alicia,14,0,20,6
1713519259745,LISP 5B,A00,507671,Munoz Sanchez; Alicia,12,0,20,8
1713519260770,LISP 5C,A00,507696,Munoz Sanchez; Alicia,11,0,20,9
1713519261797,MAE 197,001,528363,Boechler; Nicholas Sebastia,9998,0,9999,1
1713519262823,MATH 197,001,523477,Kedlaya; Kiran S.,9999,0,9999,0
1713519262823,MATH 197,002,563811,Zhang; Danna,9998,0,9999,1
1713519263863,MCWP 40R,A00,518780,Staff,13,0,20,7
1713519263863,MCWP 40R,B00,518781,Staff,11,0,20,9
1713519263863,MCWP 40R,C00,518783,Staff,8,0,20,12
1713519264888,MCWP 50R,A00,518791,Staff,7,0,20,13
1713519264888,MCWP 50R,B00,518792,Staff,3,0,20,17
1713519264888,MCWP 50R,C00,518793,Staff,5,0,20,15
1713519264888,MCWP 50R,D00,518794,Staff,0,0,20,20
1713519264888,MCWP 50R,E00,518795,Staff,0,0,20,20
1713519264888,MCWP 50R,F00,518796,Staff,10,0,20,10
1713519264888,MCWP 50R,G00,518797,Staff,10,0,20,10
1713519265917,MMW 12R,A01,514034,Herbst; Matthew,1,0,16,15
1713519265917,MMW 12R,A02,514035,Herbst; Matthew,13,0,16,3
1713519266943,MMW 13R,A01,514037,Staff,0,8,16,16
1713519266943,MMW 13R,A02,514039,Staff,0,7,16,16
1713519268991,SIO 295LS,A00,523233,Staff,15,0,30,15
1713519270020,SIO 295S,A00,523232,Staff,15,0,30,15
1713519271046,SOCI 117,A01,494376,Staff,0,2,5,5
1713519272075,WES 237B,A00,494380,Staff,19,0,20,1
1713519274137,AESE 279B,A00,494370,Wade; Jon P,33,0,33,0
1713519275168,AIP 197,001,627712,Vespa; Emanuel Ignacio,9999,0,9999,0
1713519276194,ANAR 135S,A00,494369,Braswell; Geoffrey E.,0,0,0,0
1713519277223,CAT 124RS,A01,519847,Geibel; William,6,0,20,14
1713519278251,CAT 125RS,A01,515971,Geibel; William,6,0,20,14
1713519279277,CLRE 250,A00,511389,Morris; Sheldon,9996,0,9999,3
1713519280304,CLRE 251,A00,507176,Mehta; Ravindra L.,9996,0,9999,3
1713519280304,CLRE 251,B00,511410,Mehta; Ravindra L.,9998,0,9999,1
1713519281334,CLRE 252,A00,507189,Cuomo; Raphael Eduardo,9998,0,9999,1
1713519282360,CLRE 253,A00,507199,Vaida; Florin,9997,0,9999,2
1713519282360,CLRE 253,B00,507202,Vaida; Florin,9999,0,9999,0
1713519283386,CLRE 259,A00,507211,Patel; Hemal,9996,0,9999,3
1713519284410,CLRE 260,A00,507221,Cuomo; Raphael Eduardo,9999,0,9999,0
1713519285435,CLRE 297,001,507242,Cuomo; Raphael Eduardo,9999,0,9999,0
1713519286465,CSE 191,A00,516875,Minnes Kemp; Mor Mia,9999,0,9999,0
1713519287491,CSS 201S,A01,494383,Staff,35,0,35,0
1713519288516,CSS 202S,A01,494387,Staff,35,0,35,0
1713519289542,EAP 100,A00,516065,Staff,9792,0,9999,207
1713519290572,ECE 45,A01,507414,Staff,37,0,60,23
1713519291602,ECE 100,A01,507416,Baghdadchi; Saharnaz,0,0,20,20
1713519291602,ECE 100,A02,507418,Baghdadchi; Saharnaz,19,0,20,1
1713519292633,ECE 111,A01,507420,Staff,27,0,50,23
1713519293662,ECE 197,001,548057,Sievenpiper; Daniel F.,9998,0,9999,1
1713519294690,EDS 115,A00,507243,Choi; Bailey Miyeon,27,0,28,1
1713519295719,EDS 117,A01,494379,Staff,14,0,25,11
1713519296745,EDS 125,A00,507246,Hopkins; Megan Beth,27,0,30,3
1713519297770,EDS 128A,A01,507264,Fargason; Sharon Gayle,26,0,26,0
1713519298802,EDS 128B,A01,507293,Pappas; Elizabeth,30,0,30,0
1713519299828,EDS 139,A00,507294,Fargason; Sharon Gayle,30,0,30,0
1713519299828,EDS 139,B00,507313,Pappas; Elizabeth,30,0,30,0
1713519300855,EDS 201,A00,507315,Staff,18,0,30,12
1713519301880,EDS 203,A01,507317,Halter; Christopher P.,17,0,30,13
1713519302905,EDS 204R,A01,507319,Halter; Christopher P.,0,1,30,30
1713519302905,EDS 204R,B01,507331,Heinzman; Erica M.,22,0,30,8
1713519303931,EDS 206R,A00,507332,Staff,0,2,30,30
1713519303931,EDS 206R,B00,507343,Staff,23,0,30,7
1713519304955,EDS 250,A00,507344,Hemans; Patricia Ann Benitez,27,0,40,13
1713519306034,EDS 281,A00,507345,Daly; Alan J.,18,0,18,0
1713519307060,EDS 284,A00,507350,Daly; Alan J.,16,0,16,0
1713519308088,EDS 286,A00,507359,Fine; Sarah,18,0,18,0
1713519309115,EDS 289C,A01,507361,Daly; Alan J.,18,0,18,0
1713519310139,EDS 290,A00,507366,Hofstetter; Carolyn,15,0,15,0
1713519311170,LIGM 5A,A00,507421,Fischer-Grunski; Eva K,20,0,20,0
1713519312195,LIGM 5B,A00,507423,Fischer-Grunski; Eva K,20,0,20,0
1713519313221,LIGM 5C,A00,507425,Fischer-Grunski; Eva K,20,0,20,0
1713519314255,LIIT 5AS,A00,507427,Carnelos; Chiara,20,0,20,0
1713519315281,LIIT 5BS,A00,507430,Carnelos; Chiara,20,0,20,0
1713519316308,LIIT 5CS,A00,507432,Carnelos; Chiara,20,0,20,0
1713519317340,LISP 5A,A00,507541,Munoz Sanchez; Alicia,14,0,20,6
1713519318366,LISP 5B,A00,507671,Munoz Sanchez; Alicia,12,0,20,8
1713519319395,LISP 5C,A00,507696,Munoz Sanchez; Alicia,11,0,20,9
1713519320419,MAE 197,001,528363,Boechler; Nicholas Sebastia,9998,0,9999,1
1713519321444,MATH 197,001,523477,Kedlaya; Kiran S.,9999,0,9999,0
1713519321444,MATH 197,002,563811,Zhang; Danna,9998,0,9999,1
1713519322468,MCWP 40R,A00,518780,Staff,13,0,20,7
1713519322468,MCWP 40R,B00,518781,Staff,11,0,20,9
1713519322468,MCWP 40R,C00,518783,Staff,8,0,20,12
1713519323495,MCWP 50R,A00,518791,Staff,7,0,20,13
1713519323495,MCWP 50R,B00,518792,Staff,3,0,20,17
1713519323495,MCWP 50R,C00,518793,Staff,5,0,20,15
1713519323495,MCWP 50R,D00,518794,Staff,0,0,20,20
1713519323495,MCWP 50R,E00,518795,Staff,0,0,20,20
1713519323495,MCWP 50R,F00,518796,Staff,10,0,20,10
1713519323495,MCWP 50R,G00,518797,Staff,10,0,20,10
1713519324524,MMW 12R,A01,514034,Herbst; Matthew,1,0,16,15
1713519324524,MMW 12R,A02,514035,Herbst; Matthew,13,0,16,3
1713519325553,MMW 13R,A01,514037,Staff,0,8,16,16
1713519325553,MMW 13R,A02,514039,Staff,0,7,16,16
1713519327611,SIO 295LS,A00,523233,Staff,15,0,30,15
1713519328635,SIO 295S,A00,523232,Staff,15,0,30,15
1713519329661,SOCI 117,A01,494376,Staff,0,2,5,5
1713519330689,WES 237B,A00,494380,Staff,19,0,20,1
1713519332769,AESE 279B,A00,494370,Wade; Jon P,33,0,33,0
1713519333800,AIP 197,001,627712,Vespa; Emanuel Ignacio,9999,0,9999,0
1713519334826,ANAR 135S,A00,494369,Braswell; Geoffrey E.,0,0,0,0
1713519335855,CAT 124RS,A01,519847,Geibel; William,6,0,20,14
1713519336880,CAT 125RS,A01,515971,Geibel; William,6,0,20,14
1713519337915,CLRE 250,A00,511389,Morris; Sheldon,9996,0,9999,3
1713519338941,CLRE 251,A00,507176,Mehta; Ravindra L.,9996,0,9999,3
1713519338941,CLRE 251,B00,511410,Mehta; Ravindra L.,9998,0,9999,1
1713519339972,CLRE 252,A00,507189,Cuomo; Raphael Eduardo,9998,0,9999,1
1713519341001,CLRE 253,A00,507199,Vaida; Florin,9997,0,9999,2
1713519341001,CLRE 253,B00,507202,Vaida; Florin,9999,0,9999,0
1713519342029,CLRE 259,A00,507211,Patel; Hemal,9996,0,9999,3
1713519343052,CLRE 260,A00,507221,Cuomo; Raphael Eduardo,9999,0,9999,0
1713519344078,CLRE 297,001,507242,Cuomo; Raphael Eduardo,9999,0,9999,0
1713519345107,CSE 191,A00,516875,Minnes Kemp; Mor Mia,9999,0,9999,0
1713519346138,CSS 201S,A01,494383,Staff,35,0,35,0
1713519347168,CSS 202S,A01,494387,Staff,35,0,35,0
1713519348193,EAP 100,A00,516065,Staff,9792,0,9999,207
1713519349217,ECE 45,A01,507414,Staff,37,0,60,23
1713519350242,ECE 100,A01,507416,Baghdadchi; Saharnaz,0,0,20,20
1713519350242,ECE 100,A02,507418,Baghdadchi; Saharnaz,19,0,20,1
1713519351271,ECE 111,A01,507420,Staff,27,0,50,23
1713519352296,ECE 197,001,548057,Sievenpiper; Daniel F.,9998,0,9999,1
1713519353320,EDS 115,A00,507243,Choi; Bailey Miyeon,27,0,28,1
1713519354350,EDS 117,A01,494379,Staff,14,0,25,11
1713519355380,EDS 125,A00,507246,Hopkins; Megan Beth,27,0,30,3
1713519356406,EDS 128A,A01,507264,Fargason; Sharon Gayle,26,0,26,0
1713519357436,EDS 128B,A01,507293,Pappas; Elizabeth,30,0,30,0
1713519358462,EDS 139,A00,507294,Fargason; Sharon Gayle,30,0,30,0
1713519358462,EDS 139,B00,507313,Pappas; Elizabeth,30,0,30,0
1713519359488,EDS 201,A00,507315,Staff,18,0,30,12
1713519360514,EDS 203,A01,507317,Halter; Christopher P.,17,0,30,13
1713519361545,EDS 204R,A01,507319,Halter; Christopher P.,0,1,30,30
1713519361545,EDS 204R,B01,507331,Heinzman; Erica M.,22,0,30,8
1713519362574,EDS 206R,A00,507332,Staff,0,2,30,30
1713519362574,EDS 206R,B00,507343,Staff,23,0,30,7
1713519363605,EDS 250,A00,507344,Hemans; Patricia Ann Benitez,27,0,40,13
1713519364632,EDS 281,A00,507345,Daly; Alan J.,18,0,18,0
1713519365658,EDS 284,A00,507350,Daly; Alan J.,16,0,16,0
1713519366684,EDS 286,A00,507359,Fine; Sarah,18,0,18,0
1713519367708,EDS 289C,A01,507361,Daly; Alan J.,18,0,18,0
1713519368739,EDS 290,A00,507366,Hofstetter; Carolyn,15,0,15,0
1713519369769,LIGM 5A,A00,507421,Fischer-Grunski; Eva K,20,0,20,0
1713519370799,LIGM 5B,A00,507423,Fischer-Grunski; Eva K,20,0,20,0
1713519371826,LIGM 5C,A00,507425,Fischer-Grunski; Eva K,20,0,20,0
1713519372851,LIIT 5AS,A00,507427,Carnelos; Chiara,20,0,20,0
1713519373877,LIIT 5BS,A00,507430,Carnelos; Chiara,20,0,20,0
1713519374907,LIIT 5CS,A00,507432,Carnelos; Chiara,20,0,20,0
1713519375938,LISP 5A,A00,507541,Munoz Sanchez; Alicia,14,0,20,6
1713519376964,LISP 5B,A00,507671,Munoz Sanchez; Alicia,12,0,20,8
1713519377988,LISP 5C,A00,507696,Munoz Sanchez; Alicia,11,0,20,9
1713519379013,MAE 197,001,528363,Boechler; Nicholas Sebastia,9998,0,9999,1
1713519380044,MATH 197,001,523477,Kedlaya; Kiran S.,9999,0,9999,0
1713519380044,MATH 197,002,563811,Zhang; Danna,9998,0,9999,1
1713519381070,MCWP 40R,A00,518780,Staff,13,0,20,7
1713519381070,MCWP 40R,B00,518781,Staff,11,0,20,9
1713519381070,MCWP 40R,C00,518783,Staff,8,0,20,12
1713519382102,MCWP 50R,A00,518791,Staff,7,0,20,13
1713519382102,MCWP 50R,B00,518792,Staff,3,0,20,17
1713519382102,MCWP 50R,C00,518793,Staff,5,0,20,15
1713519382102,MCWP 50R,D00,518794,Staff,0,0,20,20
1713519382102,MCWP 50R,E00,518795,Staff,0,0,20,20
1713519382102,MCWP 50R,F00,518796,Staff,10,0,20,10
1713519382102,MCWP 50R,G00,518797,Staff,10,0,20,10
1713519383128,MMW 12R,A01,514034,Herbst; Matthew,1,0,16,15
1713519383128,MMW 12R,A02,514035,Herbst; Matthew,13,0,16,3
1713519384159,MMW 13R,A01,514037,Staff,0,8,16,16
1713519384159,MMW 13R,A02,514039,Staff,0,7,16,16
1713519386209,SIO 295LS,A00,523233,Staff,15,0,30,15
1713519387236,SIO 295S,A00,523232,Staff,15,0,30,15
1713519388261,SOCI 117,A01,494376,Staff,0,2,5,5
1713519389286,WES 237B,A00,494380,Staff,19,0,20,1
1713519391355,AESE 279B,A00,494370,Wade; Jon P,33,0,33,0
1713519392380,AIP 197,001,627712,Vespa; Emanuel Ignacio,9999,0,9999,0
1713519393407,ANAR 135S,A00,494369,Braswell; Geoffrey E.,0,0,0,0
1713519394433,CAT 124RS,A01,519847,Geibel; William,6,0,20,14
1713519395462,CAT 125RS,A01,515971,Geibel; William,6,0,20,14
1713519396489,CLRE 250,A00,511389,Morris; Sheldon,9996,0,9999,3
1713519397518,CLRE 251,A00,507176,Mehta; Ravindra L.,9996,0,9999,3
1713519397518,CLRE 251,B00,511410,Mehta; Ravindra L.,9998,0,9999,1
1713519398547,CLRE 252,A00,507189,Cuomo; Raphael Eduardo,9998,0,9999,1
1713519399578,CLRE 253,A00,507199,Vaida; Florin,9997,0,9999,2
1713519399578,CLRE 253,B00,507202,Vaida; Florin,9999,0,9999,0
1713519400605,CLRE 259,A00,507211,Patel; Hemal,9996,0,9999,3
1713519401633,CLRE 260,A00,507221,Cuomo; Raphael Eduardo,9999,0,9999,0
1713519402662,CLRE 297,001,507242,Cuomo; Raphael Eduardo,9999,0,9999,0
1713519403691,CSE 191,A00,516875,Minnes Kemp; Mor Mia,9999,0,9999,0
1713519404717,CSS 201S,A01,494383,Staff,35,0,35,0
1713519405741,CSS 202S,A01,494387,Staff,35,0,35,0
1713519406768,EAP 100,A00,516065,Staff,9792,0,9999,207
1713519407798,ECE 45,A01,507414,Staff,37,0,60,23
1713519408827,ECE 100,A01,507416,Baghdadchi; Saharnaz,0,0,20,20
1713519408827,ECE 100,A02,507418,Baghdadchi; Saharnaz,19,0,20,1
1713519409906,ECE 111,A01,507420,Staff,27,0,50,23
1713519410937,ECE 197,001,548057,Sievenpiper; Daniel F.,9998,0,9999,1
1713519411967,EDS 115,A00,507243,Choi; Bailey Miyeon,27,0,28,1
1713519412993,EDS 117,A01,494379,Staff,14,0,25,11
1713519414018,EDS 125,A00,507246,Hopkins; Megan Beth,27,0,30,3
1713519415044,EDS 128A,A01,507264,Fargason; Sharon Gayle,26,0,26,0
1713519416077,EDS 128B,A01,507293,Pappas; Elizabeth,30,0,30,0
1713519417104,EDS 139,A00,507294,Fargason; Sharon Gayle,30,0,30,0
1713519417104,EDS 139,B00,507313,Pappas; Elizabeth,30,0,30,0
1713519418130,EDS 201,A00,507315,Staff,18,0,30,12
1713519419157,EDS 203,A01,507317,Halter; Christopher P.,17,0,30,13
1713519420183,EDS 204R,A01,507319,Halter; Christopher P.,0,1,30,30
1713519420183,EDS 204R,B01,507331,Heinzman; Erica M.,22,0,30,8
1713519421209,EDS 206R,A00,507332,Staff,0,2,30,30
1713519421209,EDS 206R,B00,507343,Staff,23,0,30,7
1713519422235,EDS 250,A00,507344,Hemans; Patricia Ann Benitez,27,0,40,13
1713519423266,EDS 281,A00,507345,Daly; Alan J.,18,0,18,0
1713519424292,EDS 284,A00,507350,Daly; Alan J.,16,0,16,0
1713519425321,EDS 286,A00,507359,Fine; Sarah,18,0,18,0
1713519426349,EDS 289C,A01,507361,Daly; Alan J.,18,0,18,0
1713519427378,EDS 290,A00,507366,Hofstetter; Carolyn,15,0,15,0
1713519428407,LIGM 5A,A00,507421,Fischer-Grunski; Eva K,20,0,20,0
1713519429437,LIGM 5B,A00,507423,Fischer-Grunski; Eva K,20,0,20,0
1713519430461,LIGM 5C,A00,507425,Fischer-Grunski; Eva K,20,0,20,0
1713519431492,LIIT 5AS,A00,507427,Carnelos; Chiara,20,0,20,0
1713519432519,LIIT 5BS,A00,507430,Carnelos; Chiara,20,0,20,0
1713519433549,LIIT 5CS,A00,507432,Carnelos; Chiara,20,0,20,0
1713519434579,LISP 5A,A00,507541,Munoz Sanchez; Alicia,14,0,20,6
1713519435605,LISP 5B,A00,507671,Munoz Sanchez; Alicia,12,0,20,8
1713519436638,LISP 5C,A00,507696,Munoz Sanchez; Alicia,11,0,20,9
1713519437663,MAE 197,001,528363,Boechler; Nicholas Sebastia,9998,0,9999,1
1713519438689,MATH 197,001,523477,Kedlaya; Kiran S.,9999,0,9999,0
1713519438689,MATH 197,002,563811,Zhang; Danna,9998,0,9999,1
1713519439714,MCWP 40R,A00,518780,Staff,13,0,20,7
1713519439714,MCWP 40R,B00,518781,Staff,11,0,20,9
1713519439714,MCWP 40R,C00,518783,Staff,8,0,20,12
1713519440741,MCWP 50R,A00,518791,Staff,7,0,20,13
1713519440741,MCWP 50R,B00,518792,Staff,3,0,20,17
1713519440741,MCWP 50R,C00,518793,Staff,5,0,20,15
1713519440741,MCWP 50R,D00,518794,Staff,0,0,20,20
1713519440741,MCWP 50R,E00,518795,Staff,0,0,20,20
1713519440741,MCWP 50R,F00,518796,Staff,10,0,20,10
1713519440741,MCWP 50R,G00,518797,Staff,10,0,20,10
1713519441766,MMW 12R,A01,514034,Herbst; Matthew,1,0,16,15
1713519441766,MMW 12R,A02,514035,Herbst; Matthew,13,0,16,3
1713519442796,MMW 13R,A01,514037,Staff,0,8,16,16
1713519442796,MMW 13R,A02,514039,Staff,0,7,16,16
1713519444854,SIO 295LS,A00,523233,Staff,15,0,30,15
1713519445887,SIO 295S,A00,523232,Staff,15,0,30,15
1713519446912,SOCI 117,A01,494376,Staff,0,2,5,5
1713519447938,WES 237B,A00,494380,Staff,19,0,20,1
1713519450005,AESE 279B,A00,494370,Wade; Jon P,33,0,33,0
1713519451029,AIP 197,001,627712,Vespa; Emanuel Ignacio,9999,0,9999,0
1713519452054,ANAR 135S,A00,494369,Braswell; Geoffrey E.,0,0,0,0
1713519453084,CAT 124RS,A01,519847,Geibel; William,6,0,20,14
1713519454110,CAT 125RS,A01,515971,Geibel; William,6,0,20,14
1713519455135,CLRE 250,A00,511389,Morris; Sheldon,9996,0,9999,3
1713519456167,CLRE 251,A00,507176,Mehta; Ravindra L.,9996,0,9999,3
1713519456167,CLRE 251,B00,511410,Mehta; Ravindra L.,9998,0,9999,1
1713519457198,CLRE 252,A00,507189,Cuomo; Raphael Eduardo,9998,0,9999,1
1713519458224,CLRE 253,A00,507199,Vaida; Florin,9997,0,9999,2
1713519458224,CLRE 253,B00,507202,Vaida; Florin,9999,0,9999,0
1713519459253,CLRE 259,A00,507211,Patel; Hemal,9996,0,9999,3
1713519460283,CLRE 260,A00,507221,Cuomo; Raphael Eduardo,9999,0,9999,0
1713519461308,CLRE 297,001,507242,Cuomo; Raphael Eduardo,9999,0,9999,0
1713519462336,CSE 191,A00,516875,Minnes Kemp; Mor Mia,9999,0,9999,0
1713519463366,CSS 201S,A01,494383,Staff,35,0,35,0
1713519464393,CSS 202S,A01,494387,Staff,35,0,35,0
1713519465420,EAP 100,A00,516065,Staff,9792,0,9999,207
1713519466444,ECE 45,A01,507414,Staff,37,0,60,23
1713519467473,ECE 100,A01,507416,Baghdadchi; Saharnaz,0,0,20,20
1713519467473,ECE 100,A02,507418,Baghdadchi; Saharnaz,19,0,20,1
1713519468502,ECE 111,A01,507420,Staff,27,0,50,23
1713519469532,ECE 197,001,548057,Sievenpiper; Daniel F.,9998,0,9999,1
1713519470562,EDS 115,A00,507243,Choi; Bailey Miyeon,27,0,28,1
1713519471588,EDS 117,A01,494379,Staff,14,0,25,11
1713519472617,EDS 125,A00,507246,Hopkins; Megan Beth,27,0,30,3
1713519473642,EDS 128A,A01,507264,Fargason; Sharon Gayle,26,0,26,0
1713519474668,EDS 128B,A01,507293,Pappas; Elizabeth,30,0,30,0
1713519475693,EDS 139,A00,507294,Fargason; Sharon Gayle,30,0,30,0
1713519475693,EDS 139,B00,507313,Pappas; Elizabeth,30,0,30,0
1713519476720,EDS 201,A00,507315,Staff,18,0,30,12
1713519477745,EDS 203,A01,507317,Halter; Christopher P.,17,0,30,13
1713519478772,EDS 204R,A01,507319,Halter; Christopher P.,0,1,30,30
1713519478772,EDS 204R,B01,507331,Heinzman; Erica M.,22,0,30,8
1713519479798,EDS 206R,A00,507332,Staff,0,2,30,30
1713519479798,EDS 206R,B00,507343,Staff,23,0,30,7
1713519480823,EDS 250,A00,507344,Hemans; Patricia Ann Benitez,27,0,40,13
1713519481851,EDS 281,A00,507345,Daly; Alan J.,18,0,18,0
1713519482880,EDS 284,A00,507350,Daly; Alan J.,16,0,16,0
1713519483909,EDS 286,A00,507359,Fine; Sarah,18,0,18,0
1713519484935,EDS 289C,A01,507361,Daly; Alan J.,18,0,18,0
1713519485960,EDS 290,A00,507366,Hofstetter; Carolyn,15,0,15,0
1713519486992,LIGM 5A,A00,507421,Fischer-Grunski; Eva K,20,0,20,0
1713519488022,LIGM 5B,A00,507423,Fischer-Grunski; Eva K,20,0,20,0
1713519489049,LIGM 5C,A00,507425,Fischer-Grunski; Eva K,20,0,20,0
1713519490075,LIIT 5AS,A00,507427,Carnelos; Chiara,20,0,20,0
1713519491103,LIIT 5BS,A00,507430,Carnelos; Chiara,20,0,20,0
1713519492129,LIIT 5CS,A00,507432,Carnelos; Chiara,20,0,20,0
1713519493160,LISP 5A,A00,507541,Munoz Sanchez; Alicia,14,0,20,6
1713519494188,LISP 5B,A00,507671,Munoz Sanchez; Alicia,12,0,20,8
1713519495212,LISP 5C,A00,507696,Munoz Sanchez; Alicia,11,0,20,9
1713519496237,MAE 197,001,528363,Boechler; Nicholas Sebastia,9998,0,9999,1
1713519497263,MATH 197,001,523477,Kedlaya; Kiran S.,9999,0,9999,0
1713519497263,MATH 197,002,563811,Zhang; Danna,9998,0,9999,1
1713519498294,MCWP 40R,A00,518780,Staff,13,0,20,7
1713519498294,MCWP 40R,B00,518781,Staff,11,0,20,9
1713519498294,MCWP 40R,C00,518783,Staff,8,0,20,12
1713519499322,MCWP 50R,A00,518791,Staff,7,0,20,13
1713519499322,MCWP 50R,B00,518792,Staff,3,0,20,17
1713519499322,MCWP 50R,C00,518793,Staff,5,0,20,15
1713519499322,MCWP 50R,D00,518794,Staff,0,0,20,20
1713519499322,MCWP 50R,E00,518795,Staff,0,0,20,20
1713519499322,MCWP 50R,F00,518796,Staff,10,0,20,10
1713519499322,MCWP 50R,G00,518797,Staff,10,0,20,10
1713519500349,MMW 12R,A01,514034,Herbst; Matthew,1,0,16,15
1713519500349,MMW 12R,A02,514035,Herbst; Matthew,13,0,16,3
1713519501380,MMW 13R,A01,514037,Staff,0,8,16,16
1713519501380,MMW 13R,A02,514039,Staff,0,7,16,16
1713519503435,SIO 295LS,A00,523233,Staff,15,0,30,15
1713519504461,SIO 295S,A00,523232,Staff,15,0,30,15
1713519505486,SOCI 117,A01,494376,Staff,0,2,5,5
1713519506511,WES 237B,A00,494380,Staff,19,0,20,1
1713519508584,AESE 279B,A00,494370,Wade; Jon P,33,0,33,0
1713519509609,AIP 197,001,627712,Vespa; Emanuel Ignacio,9999,0,9999,0
1713519510635,ANAR 135S,A00,494369,Braswell; Geoffrey E.,0,0,0,0
1713519511661,CAT 124RS,A01,519847,Geibel; William,6,0,20,14
1713519512691,CAT 125RS,A01,515971,Geibel; William,6,0,20,14
1713519513775,CLRE 250,A00,511389,Morris; Sheldon,9996,0,9999,3
1713519514802,CLRE 251,A00,507176,Mehta; Ravindra L.,9996,0,9999,3
1713519514802,CLRE 251,B00,511410,Mehta; Ravindra L.,9998,0,9999,1
1713519515828,CLRE 252,A00,507189,Cuomo; Raphael Eduardo,9998,0,9999,1
1713519516854,CLRE 253,A00,507199,Vaida; Florin,9997,0,9999,2
1713519516854,CLRE 253,B00,507202,Vaida; Florin,9999,0,9999,0
1713519517884,CLRE 259,A00,507211,Patel; Hemal,9996,0,9999,3
1713519518909,CLRE 260,A00,507221,Cuomo; Raphael Eduardo,9999,0,9999,0
1713519519938,CLRE 297,001,507242,Cuomo; Raphael Eduardo,9999,0,9999,0
1713519520971,CSE 191,A00,516875,Minnes Kemp; Mor Mia,9999,0,9999,0
1713519521997,CSS 201S,A01,494383,Staff,35,0,35,0
1713519523023,CSS 202S,A01,494387,Staff,35,0,35,0
1713519524051,EAP 100,A00,516065,Staff,9792,0,9999,207
1713519525077,ECE 45,A01,507414,Staff,37,0,60,23
1713519526103,ECE 100,A01,507416,Baghdadchi; Saharnaz,0,0,20,20
1713519526103,ECE 100,A02,507418,Baghdadchi; Saharnaz,19,0,20,1
1713519527128,ECE 111,A01,507420,Staff,27,0,50,23
1713519528154,ECE 197,001,548057,Sievenpiper; Daniel F.,9998,0,9999,1
1713519529179,EDS 115,A00,507243,Choi; Bailey Miyeon,27,0,28,1
1713519530207,EDS 117,A01,494379,Staff,14,0,25,11
1713519531233,EDS 125,A00,507246,Hopkins; Megan Beth,27,0,30,3
1713519532258,EDS 128A,A01,507264,Fargason; Sharon Gayle,26,0,26,0
1713519533284,EDS 128B,A01,507293,Pappas; Elizabeth,30,0,30,0
1713519534313,EDS 139,A00,507294,Fargason; Sharon Gayle,30,0,30,0
1713519534313,EDS 139,B00,507313,Pappas; Elizabeth,30,0,30,0
1713519535339,EDS 201,A00,507315,Staff,18,0,30,12
1713519536366,EDS 203,A01,507317,Halter; Christopher P.,17,0,30,13
1713519537393,EDS 204R,A01,507319,Halter; Christopher P.,0,1,30,30
1713519537393,EDS 204R,B01,507331,Heinzman; Erica M.,22,0,30,8
1713519538418,EDS 206R,A00,507332,Staff,0,2,30,30
1713519538418,EDS 206R,B00,507343,Staff,23,0,30,7
1713519539444,EDS 250,A00,507344,Hemans; Patricia Ann Benitez,27,0,40,13
1713519540469,EDS 281,A00,507345,Daly; Alan J.,18,0,18,0
1713519541495,EDS 284,A00,507350,Daly; Alan J.,16,0,16,0
1713519542521,EDS 286,A00,507359,Fine; Sarah,18,0,18,0
1713519543548,EDS 289C,A01,507361,Daly; Alan J.,18,0,18,0
1713519544573,EDS 290,A00,507366,Hofstetter; Carolyn,15,0,15,0
1713519545604,LIGM 5A,A00,507421,Fischer-Grunski; Eva K,20,0,20,0
1713519546630,LIGM 5B,A00,507423,Fischer-Grunski; Eva K,20,0,20,0
1713519547659,LIGM 5C,A00,507425,Fischer-Grunski; Eva K,20,0,20,0
1713519548685,LIIT 5AS,A00,507427,Carnelos; Chiara,20,0,20,0
1713519549715,LIIT 5BS,A00,507430,Carnelos; Chiara,20,0,20,0
1713519550741,LIIT 5CS,A00,507432,Carnelos; Chiara,20,0,20,0
1713519551771,LISP 5A,A00,507541,Munoz Sanchez; Alicia,14,0,20,6
1713519552797,LISP 5B,A00,507671,Munoz Sanchez; Alicia,12,0,20,8
1713519553824,LISP 5C,A00,507696,Munoz Sanchez; Alicia,11,0,20,9
1713519554850,MAE 197,001,528363,Boechler; Nicholas Sebastia,9998,0,9999,1
1713519555878,MATH 197,001,523477,Kedlaya; Kiran S.,9999,0,9999,0
1713519555878,MATH 197,002,563811,Zhang; Danna,9998,0,9999,1
1713519556909,MCWP 40R,A00,518780,Staff,13,0,20,7
1713519556909,MCWP 40R,B00,518781,Staff,11,0,20,9
1713519556909,MCWP 40R,C00,518783,Staff,8,0,20,12
1713519557938,MCWP 50R,A00,518791,Staff,7,0,20,13
1713519557938,MCWP 50R,B00,518792,Staff,3,0,20,17
1713519557938,MCWP 50R,C00,518793,Staff,5,0,20,15
1713519557938,MCWP 50R,D00,518794,Staff,0,0,20,20
1713519557938,MCWP 50R,E00,518795,Staff,0,0,20,20
1713519557938,MCWP 50R,F00,518796,Staff,10,0,20,10
1713519557938,MCWP 50R,G00,518797,Staff,10,0,20,10
1713519558965,MMW 12R,A01,514034,Herbst; Matthew,1,0,16,15
1713519558965,MMW 12R,A02,514035,Herbst; Matthew,13,0,16,3
1713519559992,MMW 13R,A01,514037,Staff,0,8,16,16
1713519559992,MMW 13R,A02,514039,Staff,0,7,16,16
1713519562045,SIO 295LS,A00,523233,Staff,15,0,30,15
1713519563073,SIO 295S,A00,523232,Staff,15,0,30,15
1713519564097,SOCI 117,A01,494376,Staff,0,2,5,5
1713519565127,WES 237B,A00,494380,Staff,19,0,20,1
1713519567210,AESE 279B,A00,494370,Wade; Jon P,33,0,33,0
1713519568241,AIP 197,001,627712,Vespa; Emanuel Ignacio,9999,0,9999,0
1713519569270,ANAR 135S,A00,494369,Braswell; Geoffrey E.,0,0,0,0
1713519570297,CAT 124RS,A01,519847,Geibel; William,6,0,20,14
1713519571322,CAT 125RS,A01,515971,Geibel; William,6,0,20,14
1713519572354,CLRE 250,A00,511389,Morris; Sheldon,9996,0,9999,3
1713519573383,CLRE 251,A00,507176,Mehta; Ravindra L.,9996,0,9999,3
1713519573383,CLRE 251,B00,511410,Mehta; Ravindra L.,9998,0,9999,1
1713519574410,CLRE 252,A00,507189,Cuomo; Raphael Eduardo,9998,0,9999,1
1713519575436,CLRE 253,A00,507199,Vaida; Florin,9997,0,9999,2
1713519575436,CLRE 253,B00,507202,Vaida; Florin,9999,0,9999,0
1713519576466,CLRE 259,A00,507211,Patel; Hemal,9996,0,9999,3
1713519577489,CLRE 260,A00,507221,Cuomo; Raphael Eduardo,9999,0,9999,0
1713519578519,CLRE 297,001,507242,Cuomo; Raphael Eduardo,9999,0,9999,0
1713519579545,CSE 191,A00,516875,Minnes Kemp; Mor Mia,9999,0,9999,0
1713519580570,CSS 201S,A01,494383,Staff,35,0,35,0
1713519581601,CSS 202S,A01,494387,Staff,35,0,35,0
1713519582626,EAP 100,A00,516065,Staff,9792,0,9999,207
1713519583656,ECE 45,A01,507414,Staff,37,0,60,23
1713519584686,ECE 100,A01,507416,Baghdadchi; Saharnaz,0,0,20,20
1713519584686,ECE 100,A02,507418,Baghdadchi; Saharnaz,19,0,20,1
1713519585720,ECE 111,A01,507420,Staff,27,0,50,23
1713519586745,ECE 197,001,548057,Sievenpiper; Daniel F.,9998,0,9999,1
1713519587771,EDS 115,A00,507243,Choi; Bailey Miyeon,27,0,28,1
1713519588796,EDS 117,A01,494379,Staff,14,0,25,11
1713519589821,EDS 125,A00,507246,Hopkins; Megan Beth,27,0,30,3
1713519590848,EDS 128A,A01,507264,Fargason; Sharon Gayle,26,0,26,0
1713519591879,EDS 128B,A01,507293,Pappas; Elizabeth,30,0,30,0
1713519592908,EDS 139,A00,507294,Fargason; Sharon Gayle,30,0,30,0
1713519592908,EDS 139,B00,507313,Pappas; Elizabeth,30,0,30,0
1713519593932,EDS 201,A00,507315,Staff,18,0,30,12
1713519594964,EDS 203,A01,507317,Halter; Christopher P.,17,0,30,13
1713519595988,EDS 204R,A01,507319,Halter; Christopher P.,0,1,30,30
1713519595988,EDS 204R,B01,507331,Heinzman; Erica M.,22,0,30,8
1713519597014,EDS 206R,A00,507332,Staff,0,2,30,30
1713519597014,EDS 206R,B00,507343,Staff,23,0,30,7
1713519598039,EDS 250,A00,507344,Hemans; Patricia Ann Benitez,27,0,40,13
1713519599064,EDS 281,A00,507345,Daly; Alan J.,18,0,18,0
1713519600090,EDS 284,A00,507350,Daly; Alan J.,16,0,16,0
1713519601117,EDS 286,A00,507359,Fine; Sarah,18,0,18,0
1713519602147,EDS 289C,A01,507361,Daly; Alan J.,18,0,18,0
1713519603173,EDS 290,A00,507366,Hofstetter; Carolyn,15,0,15,0
1713519604200,LIGM 5A,A00,507421,Fischer-Grunski; Eva K,20,0,20,0
1713519605231,LIGM 5B,A00,507423,Fischer-Grunski; Eva K,20,0,20,0
1713519606258,LIGM 5C,A00,507425,Fischer-Grunski; Eva K,20,0,20,0
1713519607284,LIIT 5AS,A00,507427,Carnelos; Chiara,20,0,20,0
1713519608315,LIIT 5BS,A00,507430,Carnelos; Chiara,20,0,20,0
1713519609340,LIIT 5CS,A00,507432,Carnelos; Chiara,20,0,20,0
1713519610366,LISP 5A,A00,507541,Munoz Sanchez; Alicia,14,0,20,6
1713519611394,LISP 5B,A00,507671,Munoz Sanchez; Alicia,12,0,20,8
1713519612420,LISP 5C,A00,507696,Munoz Sanchez; Alicia,11,0,20,9
1713519613447,MAE 197,001,528363,Boechler; Nicholas Sebastia,9998,0,9999,1
1713519614477,MATH 197,001,523477,Kedlaya; Kiran S.,9999,0,9999,0
1713519614477,MATH 197,002,563811,Zhang; Danna,9998,0,9999,1
1713519615506,MCWP 40R,A00,518780,Staff,13,0,20,7
1713519615506,MCWP 40R,B00,518781,Staff,11,0,20,9
1713519615506,MCWP 40R,C00,518783,Staff,8,0,20,12
1713519616538,MCWP 50R,A00,518791,Staff,7,0,20,13
1713519616538,MCWP 50R,B00,518792,Staff,3,0,20,17
1713519616538,MCWP 50R,C00,518793,Staff,5,0,20,15
1713519616538,MCWP 50R,D00,518794,Staff,0,0,20,20
1713519616538,MCWP 50R,E00,518795,Staff,0,0,20,20
1713519616538,MCWP 50R,F00,518796,Staff,10,0,20,10
1713519616538,MCWP 50R,G00,518797,Staff,10,0,20,10
1713519617619,MMW 12R,A01,514034,Herbst; Matthew,1,0,16,15
1713519617619,MMW 12R,A02,514035,Herbst; Matthew,13,0,16,3
1713519618644,MMW 13R,A01,514037,Staff,0,8,16,16
1713519618644,MMW 13R,A02,514039,Staff,0,7,16,16
1713519620696,SIO 295LS,A00,523233,Staff,15,0,30,15
1713519621720,SIO 295S,A00,523232,Staff,15,0,30,15
1713519622745,SOCI 117,A01,494376,Staff,0,2,5,5
1713519623770,WES 237B,A00,494380,Staff,19,0,20,1
1713519625856,AESE 279B,A00,494370,Wade; Jon P,33,0,33,0
1713519626882,AIP 197,001,627712,Vespa; Emanuel Ignacio,9999,0,9999,0
1713519627908,ANAR 135S,A00,494369,Braswell; Geoffrey E.,0,0,0,0
1713519628937,CAT 124RS,A01,519847,Geibel; William,6,0,20,14
1713519629963,CAT 125RS,A01,515971,Geibel; William,6,0,20,14
1713519630989,CLRE 250,A00,511389,Morris; Sheldon,9996,0,9999,3
1713519632016,CLRE 251,A00,507176,Mehta; Ravindra L.,9996,0,9999,3
1713519632016,CLRE 251,B00,511410,Mehta; Ravindra L.,9998,0,9999,1
1713519633042,CLRE 252,A00,507189,Cuomo; Raphael Eduardo,9998,0,9999,1
1713519634067,CLRE 253,A00,507199,Vaida; Florin,9997,0,9999,2
1713519634067,CLRE 253,B00,507202,Vaida; Florin,9999,0,9999,0
1713519635096,CLRE 259,A00,507211,Patel; Hemal,9996,0,9999,3
1713519636126,CLRE 260,A00,507221,Cuomo; Raphael Eduardo,9999,0,9999,0
1713519637154,CLRE 297,001,507242,Cuomo; Raphael Eduardo,9999,0,9999,0
1713519638179,CSE 191,A00,516875,Minnes Kemp; Mor Mia,9999,0,9999,0
1713519639207,CSS 201S,A01,494383,Staff,35,0,35,0
1713519640239,CSS 202S,A01,494387,Staff,35,0,35,0
1713519641268,EAP 100,A00,516065,Staff,9792,0,9999,207
1713519642294,ECE 45,A01,507414,Staff,37,0,60,23
1713519643319,ECE 100,A01,507416,Baghdadchi; Saharnaz,0,0,20,20
1713519643319,ECE 100,A02,507418,Baghdadchi; Saharnaz,19,0,20,1
1713519644344,ECE 111,A01,507420,Staff,27,0,50,23
1713519645369,ECE 197,001,548057,Sievenpiper; Daniel F.,9998,0,9999,1
1713519646396,EDS 115,A00,507243,Choi; Bailey Miyeon,27,0,28,1
1713519647425,EDS 117,A01,494379,Staff,14,0,25,11
1713519648452,EDS 125,A00,507246,Hopkins; Megan Beth,27,0,30,3
1713519649477,EDS 128A,A01,507264,Fargason; Sharon Gayle,26,0,26,0
1713519650502,EDS 128B,A01,507293,Pappas; Elizabeth,30,0,30,0
1713519651532,EDS 139,A00,507294,Fargason; Sharon Gayle,30,0,30,0
1713519651532,EDS 139,B00,507313,Pappas; Elizabeth,30,0,30,0
1713519652558,EDS 201,A00,507315,Staff,18,0,30,12
1713519653587,EDS 203,A01,507317,Halter; Christopher P.,17,0,30,13
1713519654612,EDS 204R,A01,507319,Halter; Christopher P.,0,1,30,30
1713519654612,EDS 204R,B01,507331,Heinzman; Erica M.,22,0,30,8
1713519655638,EDS 206R,A00,507332,Staff,0,2,30,30
1713519655638,EDS 206R,B00,507343,Staff,23,0,30,7
1713519656663,EDS 250,A00,507344,Hemans; Patricia Ann Benitez,27,0,40,13
1713519657688,EDS 281,A00,507345,Daly; Alan J.,18,0,18,0
1713519658713,EDS 284,A00,507350,Daly; Alan J.,16,0,16,0
1713519659740,EDS 286,A00,507359,Fine; Sarah,18,0,18,0
1713519660768,EDS 289C,A01,507361,Daly; Alan J.,18,0,18,0
1713519661802,EDS 290,A00,507366,Hofstetter; Carolyn,15,0,15,0
1713519662828,LIGM 5A,A00,507421,Fischer-Grunski; Eva K,20,0,20,0
1713519663852,LIGM 5B,A00,507423,Fischer-Grunski; Eva K,20,0,20,0
1713519664878,LIGM 5C,A00,507425,Fischer-Grunski; Eva K,20,0,20,0
1713519665912,LIIT 5AS,A00,507427,Carnelos; Chiara,20,0,20,0
1713519666938,LIIT 5BS,A00,507430,Carnelos; Chiara,20,0,20,0
1713519667963,LIIT 5CS,A00,507432,Carnelos; Chiara,20,0,20,0
1713519669009,LISP 5A,A00,507541,Munoz Sanchez; Alicia,14,0,20,6
1713519670042,LISP 5B,A00,507671,Munoz Sanchez; Alicia,12,0,20,8
1713519671096,LISP 5C,A00,507696,Munoz Sanchez; Alicia,11,0,20,9
1713519672126,MAE 197,001,528363,Boechler; Nicholas Sebastia,9998,0,9999,1
1713519673156,MATH 197,001,523477,Kedlaya; Kiran S.,9999,0,9999,0
1713519673156,MATH 197,002,563811,Zhang; Danna,9998,0,9999,1
1713519674184,MCWP 40R,A00,518780,Staff,13,0,20,7
1713519674184,MCWP 40R,B00,518781,Staff,11,0,20,9
1713519674184,MCWP 40R,C00,518783,Staff,8,0,20,12
1713519675209,MCWP 50R,A00,518791,Staff,7,0,20,13
1713519675209,MCWP 50R,B00,518792,Staff,3,0,20,17
1713519675209,MCWP 50R,C00,518793,Staff,5,0,20,15
1713519675209,MCWP 50R,D00,518794,Staff,0,0,20,20
1713519675209,MCWP 50R,E00,518795,Staff,0,0,20,20
1713519675209,MCWP 50R,F00,518796,Staff,10,0,20,10
1713519675209,MCWP 50R,G00,518797,Staff,10,0,20,10
1713519676234,MMW 12R,A01,514034,Herbst; Matthew,1,0,16,15
1713519676234,MMW 12R,A02,514035,Herbst; Matthew,13,0,16,3
1713519677264,MMW 13R,A01,514037,Staff,0,8,16,16
1713519677264,MMW 13R,A02,514039,Staff,0,7,16,16
1713519679324,SIO 295LS,A00,523233,Staff,15,0,30,15
1713519680353,SIO 295S,A00,523232,Staff,15,0,30,15
1713519681381,SOCI 117,A01,494376,Staff,0,2,5,5
1713519682406,WES 237B,A00,494380,Staff,19,0,20,1
1713519684475,AESE 279B,A00,494370,Wade; Jon P,33,0,33,0
1713519685500,AIP 197,001,627712,Vespa; Emanuel Ignacio,9999,0,9999,0
1713519686526,ANAR 135S,A00,494369,Braswell; Geoffrey E.,0,0,0,0
1713519687556,CAT 124RS,A01,519847,Geibel; William,6,0,20,14
1713519688581,CAT 125RS,A01,515971,Geibel; William,6,0,20,14
1713519689610,CLRE 250,A00,511389,Morris; Sheldon,9996,0,9999,3
1713519690638,CLRE 251,A00,507176,Mehta; Ravindra L.,9996,0,9999,3
1713519690638,CLRE 251,B00,511410,Mehta; Ravindra L.,9998,0,9999,1
1713519691664,CLRE 252,A00,507189,Cuomo; Raphael Eduardo,9998,0,9999,1
1713519692691,CLRE 253,A00,507199,Vaida; Florin,9997,0,9999,2
1713519692691,CLRE 253,B00,507202,Vaida; Florin,9999,0,9999,0
1713519693716,CLRE 259,A00,507211,Patel; Hemal,9996,0,9999,3
1713519694742,CLRE 260,A00,507221,Cuomo; Raphael Eduardo,9999,0,9999,0
1713519695768,CLRE 297,001,507242,Cuomo; Raphael Eduardo,9999,0,9999,0
1713519696794,CSE 191,A00,516875,Minnes Kemp; Mor Mia,9999,0,9999,0
1713519697820,CSS 201S,A01,494383,Staff,35,0,35,0
1713519698845,CSS 202S,A01,494387,Staff,35,0,35,0
1713519699871,EAP 100,A00,516065,Staff,9792,0,9999,207
1713519700902,ECE 45,A01,507414,Staff,37,0,60,23
1713519701934,ECE 100,A01,507416,Baghdadchi; Saharnaz,0,0,20,20
1713519701934,ECE 100,A02,507418,Baghdadchi; Saharnaz,19,0,20,1
1713519702963,ECE 111,A01,507420,Staff,27,0,50,23
1713519703989,ECE 197,001,548057,Sievenpiper; Daniel F.,9998,0,9999,1
1713519705019,EDS 115,A00,507243,Choi; Bailey Miyeon,27,0,28,1
1713519706048,EDS 117,A01,494379,Staff,14,0,25,11
1713519707074,EDS 125,A00,507246,Hopkins; Megan Beth,27,0,30,3
1713519708099,EDS 128A,A01,507264,Fargason; Sharon Gayle,26,0,26,0
1713519709125,EDS 128B,A01,507293,Pappas; Elizabeth,30,0,30,0
1713519710151,EDS 139,A00,507294,Fargason; Sharon Gayle,30,0,30,0
1713519710151,EDS 139,B00,507313,Pappas; Elizabeth,30,0,30,0
1713519711177,EDS 201,A00,507315,Staff,18,0,30,12
1713519712203,EDS 203,A01,507317,Halter; Christopher P.,17,0,30,13
1713519713234,EDS 204R,A01,507319,Halter; Christopher P.,0,1,30,30
1713519713234,EDS 204R,B01,507331,Heinzman; Erica M.,22,0,30,8
1713519714265,EDS 206R,A00,507332,Staff,0,2,30,30
1713519714265,EDS 206R,B00,507343,Staff,23,0,30,7
1713519715291,EDS 250,A00,507344,Hemans; Patricia Ann Benitez,27,0,40,13
1713519716316,EDS 281,A00,507345,Daly; Alan J.,18,0,18,0
1713519717342,EDS 284,A00,507350,Daly; Alan J.,16,0,16,0
1713519718367,EDS 286,A00,507359,Fine; Sarah,18,0,18,0
1713519719393,EDS 289C,A01,507361,Daly; Alan J.,18,0,18,0
1713519720423,EDS 290,A00,507366,Hofstetter; Carolyn,15,0,15,0
1713519721500,LIGM 5A,A00,507421,Fischer-Grunski; Eva K,20,0,20,0
1713519722528,LIGM 5B,A00,507423,Fischer-Grunski; Eva K,20,0,20,0
1713519723558,LIGM 5C,A00,507425,Fischer-Grunski; Eva K,20,0,20,0
1713519724583,LIIT 5AS,A00,507427,Carnelos; Chiara,20,0,20,0
1713519725613,LIIT 5BS,A00,507430,Carnelos; Chiara,20,0,20,0
1713519726641,LIIT 5CS,A00,507432,Carnelos; Chiara,20,0,20,0
1713519727666,LISP 5A,A00,507541,Munoz Sanchez; Alicia,14,0,20,6
1713519728696,LISP 5B,A00,507671,Munoz Sanchez; Alicia,12,0,20,8
1713519729722,LISP 5C,A00,507696,Munoz Sanchez; Alicia,11,0,20,9
1713519730750,MAE 197,001,528363,Boechler; Nicholas Sebastia,9998,0,9999,1
1713519731778,MATH 197,001,523477,Kedlaya; Kiran S.,9999,0,9999,0
1713519731778,MATH 197,002,563811,Zhang; Danna,9998,0,9999,1
1713519732808,MCWP 40R,A00,518780,Staff,13,0,20,7
1713519732808,MCWP 40R,B00,518781,Staff,11,0,20,9
1713519732808,MCWP 40R,C00,518783,Staff,8,0,20,12
1713519733834,MCWP 50R,A00,518791,Staff,7,0,20,13
1713519733834,MCWP 50R,B00,518792,Staff,3,0,20,17
1713519733834,MCWP 50R,C00,518793,Staff,5,0,20,15
1713519733834,MCWP 50R,D00,518794,Staff,0,0,20,20
1713519733834,MCWP 50R,E00,518795,Staff,0,0,20,20
1713519733834,MCWP 50R,F00,518796,Staff,10,0,20,10
1713519733834,MCWP 50R,G00,518797,Staff,10,0,20,10
1713519734864,MMW 12R,A01,514034,Herbst; Matthew,1,0,16,15
1713519734864,MMW 12R,A02,514035,Herbst; Matthew,13,0,16,3
1713519735889,MMW 13R,A01,514037,Staff,0,8,16,16
1713519735889,MMW 13R,A02,514039,Staff,0,7,16,16
1713519737944,SIO 295LS,A00,523233,Staff,15,0,30,15
1713519738970,SIO 295S,A00,523232,Staff,15,0,30,15
1713519739994,SOCI 117,A01,494376,Staff,0,2,5,5
1713519741022,WES 237B,A00,494380,Staff,19,0,20,1
1713519743099,AESE 279B,A00,494370,Wade; Jon P,33,0,33,0
1713519744129,AIP 197,001,627712,Vespa; Emanuel Ignacio,9999,0,9999,0
1713519745158,ANAR 135S,A00,494369,Braswell; Geoffrey E.,0,0,0,0
1713519746184,CAT 124RS,A01,519847,Geibel; William,6,0,20,14
1713519747210,CAT 125RS,A01,515971,Geibel; William,6,0,20,14
1713519748235,CLRE 250,A00,511389,Morris; Sheldon,9996,0,9999,3
1713519749265,CLRE 251,A00,507176,Mehta; Ravindra L.,9996,0,9999,3
1713519749265,CLRE 251,B00,511410,Mehta; Ravindra L.,9998,0,9999,1
1713519750293,CLRE 252,A00,507189,Cuomo; Raphael Eduardo,9998,0,9999,1
1713519751323,CLRE 253,A00,507199,Vaida; Florin,9997,0,9999,2
1713519751323,CLRE 253,B00,507202,Vaida; Florin,9999,0,9999,0
1713519752349,CLRE 259,A00,507211,Patel; Hemal,9996,0,9999,3
1713519753374,CLRE 260,A00,507221,Cuomo; Raphael Eduardo,9999,0,9999,0
1713519754400,CLRE 297,001,507242,Cuomo; Raphael Eduardo,9999,0,9999,0
1713519755426,CSE 191,A00,516875,Minnes Kemp; Mor Mia,9999,0,9999,0
1713519756453,CSS 201S,A01,494383,Staff,35,0,35,0
1713519757481,CSS 202S,A01,494387,Staff,35,0,35,0
1713519758506,EAP 100,A00,516065,Staff,9792,0,9999,207
1713519759531,ECE 45,A01,507414,Staff,37,0,60,23
1713519760556,ECE 100,A01,507416,Baghdadchi; Saharnaz,0,0,20,20
1713519760556,ECE 100,A02,507418,Baghdadchi; Saharnaz,19,0,20,1
1713519761582,ECE 111,A01,507420,Staff,27,0,50,23
1713519762606,ECE 197,001,548057,Sievenpiper; Daniel F.,9998,0,9999,1
1713519763632,EDS 115,A00,507243,Choi; Bailey Miyeon,27,0,28,1
1713519764659,EDS 117,A01,494379,Staff,14,0,25,11
1713519765689,EDS 125,A00,507246,Hopkins; Megan Beth,27,0,30,3
1713519766718,EDS 128A,A01,507264,Fargason; Sharon Gayle,26,0,26,0
1713519767747,EDS 128B,A01,507293,Pappas; Elizabeth,30,0,30,0
1713519768774,EDS 139,A00,507294,Fargason; Sharon Gayle,30,0,30,0
1713519768774,EDS 139,B00,507313,Pappas; Elizabeth,30,0,30,0
1713519769799,EDS 201,A00,507315,Staff,18,0,30,12
1713519770830,EDS 203,A01,507317,Halter; Christopher P.,17,0,30,13
1713519771855,EDS 204R,A01,507319,Halter; Christopher P.,0,1,30,30
1713519771855,EDS 204R,B01,507331,Heinzman; Erica M.,22,0,30,8
1713519772882,EDS 206R,A00,507332,Staff,0,2,30,30
1713519772882,EDS 206R,B00,507343,Staff,23,0,30,7
1713519773908,EDS 250,A00,507344,Hemans; Patricia Ann Benitez,27,0,40,13
1713519774936,EDS 281,A00,507345,Daly; Alan J.,18,0,18,0
1713519775964,EDS 284,A00,507350,Daly; Alan J.,16,0,16,0
1713519776994,EDS 286,A00,507359,Fine; Sarah,18,0,18,0
1713519778020,EDS 289C,A01,507361,Daly; Alan J.,18,0,18,0
1713519779045,EDS 290,A00,507366,Hofstetter; Carolyn,15,0,15,0
1713519780075,LIGM 5A,A00,507421,Fischer-Grunski; Eva K,20,0,20,0
1713519781101,LIGM 5B,A00,507423,Fischer-Grunski; Eva K,20,0,20,0
1713519782130,LIGM 5C,A00,507425,Fischer-Grunski; Eva K,20,0,20,0
1713519783159,LIIT 5AS,A00,507427,Carnelos; Chiara,20,0,20,0
1713519784185,LIIT 5BS,A00,507430,Carnelos; Chiara,20,0,20,0
1713519785214,LIIT 5CS,A00,507432,Carnelos; Chiara,20,0,20,0
1713519786240,LISP 5A,A00,507541,Munoz Sanchez; Alicia,14,0,20,6
1713519787270,LISP 5B,A00,507671,Munoz Sanchez; Alicia,12,0,20,8
1713519788295,LISP 5C,A00,507696,Munoz Sanchez; Alicia,11,0,20,9
1713519789324,MAE 197,001,528363,Boechler; Nicholas Sebastia,9998,0,9999,1
1713519790353,MATH 197,001,523477,Kedlaya; Kiran S.,9999,0,9999,0
1713519790353,MATH 197,002,563811,Zhang; Danna,9998,0,9999,1
1713519791380,MCWP 40R,A00,518780,Staff,13,0,20,7
1713519791380,MCWP 40R,B00,518781,Staff,11,0,20,9
1713519791380,MCWP 40R,C00,518783,Staff,8,0,20,12
1713519792410,MCWP 50R,A00,518791,Staff,7,0,20,13
1713519792410,MCWP 50R,B00,518792,Staff,3,0,20,17
1713519792410,MCWP 50R,C00,518793,Staff,5,0,20,15
1713519792410,MCWP 50R,D00,518794,Staff,0,0,20,20
1713519792410,MCWP 50R,E00,518795,Staff,0,0,20,20
1713519792410,MCWP 50R,F00,518796,Staff,10,0,20,10
1713519792410,MCWP 50R,G00,518797,Staff,10,0,20,10
1713519793439,MMW 12R,A01,514034,Herbst; Matthew,1,0,16,15
1713519793439,MMW 12R,A02,514035,Herbst; Matthew,13,0,16,3
1713519794468,MMW 13R,A01,514037,Staff,0,8,16,16
1713519794468,MMW 13R,A02,514039,Staff,0,7,16,16
1713519796521,SIO 295LS,A00,523233,Staff,15,0,30,15
1713519797546,SIO 295S,A00,523232,Staff,15,0,30,15
1713519798573,SOCI 117,A01,494376,Staff,0,2,5,5
1713519799600,WES 237B,A00,494380,Staff,19,0,20,1
1713519801683,AESE 279B,A00,494370,Wade; Jon P,33,0,33,0
1713519802711,AIP 197,001,627712,Vespa; Emanuel Ignacio,9999,0,9999,0
1713519803737,ANAR 135S,A00,494369,Braswell; Geoffrey E.,0,0,0,0
1713519804765,CAT 124RS,A01,519847,Geibel; William,6,0,20,14
1713519805791,CAT 125RS,A01,515971,Geibel; William,6,0,20,14
1713519806823,CLRE 250,A00,511389,Morris; Sheldon,9996,0,9999,3
1713519807850,CLRE 251,A00,507176,Mehta; Ravindra L.,9996,0,9999,3
1713519807850,CLRE 251,B00,511410,Mehta; Ravindra L.,9998,0,9999,1
1713519808880,CLRE 252,A00,507189,Cuomo; Raphael Eduardo,9998,0,9999,1
1713519809910,CLRE 253,A00,507199,Vaida; Florin,9997,0,9999,2
1713519809910,CLRE 253,B00,507202,Vaida; Florin,9999,0,9999,0
1713519810944,CLRE 259,A00,507211,Patel; Hemal,9996,0,9999,3
1713519811968,CLRE 260,A00,507221,Cuomo; Raphael Eduardo,9999,0,9999,0
1713519812993,CLRE 297,001,507242,Cuomo; Raphael Eduardo,9999,0,9999,0
1713519814018,CSE 191,A00,516875,Minnes Kemp; Mor Mia,9999,0,9999,0
1713519815048,CSS 201S,A01,494383,Staff,35,0,35,0
1713519816074,CSS 202S,A01,494387,Staff,35,0,35,0
1713519817100,EAP 100,A00,516065,Staff,9792,0,9999,207
1713519818129,ECE 45,A01,507414,Staff,37,0,60,23
1713519819159,ECE 100,A01,507416,Baghdadchi; Saharnaz,0,0,20,20
1713519819159,ECE 100,A02,507418,Baghdadchi; Saharnaz,19,0,20,1
1713519820189,ECE 111,A01,507420,Staff,27,0,50,23
1713519821216,ECE 197,001,548057,Sievenpiper; Daniel F.,9998,0,9999,1
1713519822246,EDS 115,A00,507243,Choi; Bailey Miyeon,27,0,28,1
1713519823274,EDS 117,A01,494379,Staff,14,0,25,11
1713519824304,EDS 125,A00,507246,Hopkins; Megan Beth,27,0,30,3
1713519825388,EDS 128A,A01,507264,Fargason; Sharon Gayle,26,0,26,0
1713519826413,EDS 128B,A01,507293,Pappas; Elizabeth,30,0,30,0
1713519827439,EDS 139,A00,507294,Fargason; Sharon Gayle,30,0,30,0
1713519827439,EDS 139,B00,507313,Pappas; Elizabeth,30,0,30,0
1713519828469,EDS 201,A00,507315,Staff,18,0,30,12
1713519829496,EDS 203,A01,507317,Halter; Christopher P.,17,0,30,13
1713519830520,EDS 204R,A01,507319,Halter; Christopher P.,0,1,30,30
1713519830520,EDS 204R,B01,507331,Heinzman; Erica M.,22,0,30,8
1713519831545,EDS 206R,A00,507332,Staff,0,2,30,30
1713519831545,EDS 206R,B00,507343,Staff,23,0,30,7
1713519832572,EDS 250,A00,507344,Hemans; Patricia Ann Benitez,27,0,40,13
1713519833596,EDS 281,A00,507345,Daly; Alan J.,18,0,18,0
1713519834657,EDS 284,A00,507350,Daly; Alan J.,16,0,16,0
1713519835685,EDS 286,A00,507359,Fine; Sarah,18,0,18,0
1713519836709,EDS 289C,A01,507361,Daly; Alan J.,18,0,18,0
1713519837740,EDS 290,A00,507366,Hofstetter; Carolyn,15,0,15,0
1713519838767,LIGM 5A,A00,507421,Fischer-Grunski; Eva K,20,0,20,0
1713519839794,LIGM 5B,A00,507423,Fischer-Grunski; Eva K,20,0,20,0
1713519840819,LIGM 5C,A00,507425,Fischer-Grunski; Eva K,20,0,20,0
1713519841847,LIIT 5AS,A00,507427,Carnelos; Chiara,20,0,20,0
1713519842877,LIIT 5BS,A00,507430,Carnelos; Chiara,20,0,20,0
1713519843908,LIIT 5CS,A00,507432,Carnelos; Chiara,20,0,20,0
1713519844939,LISP 5A,A00,507541,Munoz Sanchez; Alicia,14,0,20,6
1713519845965,LISP 5B,A00,507671,Munoz Sanchez; Alicia,12,0,20,8
1713519846989,LISP 5C,A00,507696,Munoz Sanchez; Alicia,11,0,20,9
1713519848015,MAE 197,001,528363,Boechler; Nicholas Sebastia,9998,0,9999,1
1713519849041,MATH 197,001,523477,Kedlaya; Kiran S.,9999,0,9999,0
1713519849041,MATH 197,002,563811,Zhang; Danna,9998,0,9999,1
1713519850071,MCWP 40R,A00,518780,Staff,13,0,20,7
1713519850071,MCWP 40R,B00,518781,Staff,11,0,20,9
1713519850071,MCWP 40R,C00,518783,Staff,8,0,20,12
1713519851101,MCWP 50R,A00,518791,Staff,7,0,20,13
1713519851101,MCWP 50R,B00,518792,Staff,3,0,20,17
1713519851101,MCWP 50R,C00,518793,Staff,5,0,20,15
1713519851101,MCWP 50R,D00,518794,Staff,0,0,20,20
1713519851101,MCWP 50R,E00,518795,Staff,0,0,20,20
1713519851101,MCWP 50R,F00,518796,Staff,10,0,20,10
1713519851101,MCWP 50R,G00,518797,Staff,10,0,20,10
1713519852130,MMW 12R,A01,514034,Herbst; Matthew,1,0,16,15
1713519852130,MMW 12R,A02,514035,Herbst; Matthew,13,0,16,3
1713519853156,MMW 13R,A01,514037,Staff,0,8,16,16
1713519853156,MMW 13R,A02,514039,Staff,0,7,16,16
1713519855214,SIO 295LS,A00,523233,Staff,15,0,30,15
1713519856239,SIO 295S,A00,523232,Staff,15,0,30,15
1713519857266,SOCI 117,A01,494376,Staff,0,2,5,5
1713519858295,WES 237B,A00,494380,Staff,19,0,20,1
1713519860355,AESE 279B,A00,494370,Wade; Jon P,33,0,33,0
1713519861380,AIP 197,001,627712,Vespa; Emanuel Ignacio,9999,0,9999,0
1713519862409,ANAR 135S,A00,494369,Braswell; Geoffrey E.,0,0,0,0
1713519863434,CAT 124RS,A01,519847,Geibel; William,6,0,20,14
1713519864465,CAT 125RS,A01,515971,Geibel; William,6,0,20,14
1713519865491,CLRE 250,A00,511389,Morris; Sheldon,9996,0,9999,3
1713519866521,CLRE 251,A00,507176,Mehta; Ravindra L.,9996,0,9999,3
1713519866521,CLRE 251,B00,511410,Mehta; Ravindra L.,9998,0,9999,1
1713519867553,CLRE 252,A00,507189,Cuomo; Raphael Eduardo,9998,0,9999,1
1713519868584,CLRE 253,A00,507199,Vaida; Florin,9997,0,9999,2
1713519868584,CLRE 253,B00,507202,Vaida; Florin,9999,0,9999,0
1713519869613,CLRE 259,A00,507211,Patel; Hemal,9996,0,9999,3
1713519870639,CLRE 260,A00,507221,Cuomo; Raphael Eduardo,9999,0,9999,0
1713519871664,CLRE 297,001,507242,Cuomo; Raphael Eduardo,9999,0,9999,0
1713519872691,CSE 191,A00,516875,Minnes Kemp; Mor Mia,9999,0,9999,0
1713519873718,CSS 201S,A01,494383,Staff,35,0,35,0
1713519874744,CSS 202S,A01,494387,Staff,35,0,35,0
1713519875770,EAP 100,A00,516065,Staff,9792,0,9999,207
1713519876801,ECE 45,A01,507414,Staff,37,0,60,23
1713519877834,ECE 100,A01,507416,Baghdadchi; Saharnaz,0,0,20,20
1713519877834,ECE 100,A02,507418,Baghdadchi; Saharnaz,19,0,20,1
1713519878860,ECE 111,A01,507420,Staff,27,0,50,23
1713519879889,ECE 197,001,548057,Sievenpiper; Daniel F.,9998,0,9999,1
1713519880916,EDS 115,A00,507243,Choi; Bailey Miyeon,27,0,28,1
1713519881943,EDS 117,A01,494379,Staff,14,0,25,11
1713519882974,EDS 125,A00,507246,Hopkins; Megan Beth,27,0,30,3
1713519884006,EDS 128A,A01,507264,Fargason; Sharon Gayle,26,0,26,0
1713519885037,EDS 128B,A01,507293,Pappas; Elizabeth,30,0,30,0
1713519886062,EDS 139,A00,507294,Fargason; Sharon Gayle,30,0,30,0
1713519886062,EDS 139,B00,507313,Pappas; Elizabeth,30,0,30,0
1713519887096,EDS 201,A00,507315,Staff,18,0,30,12
1713519888121,EDS 203,A01,507317,Halter; Christopher P.,17,0,30,13
1713519889147,EDS 204R,A01,507319,Halter; Christopher P.,0,1,30,30
1713519889147,EDS 204R,B01,507331,Heinzman; Erica M.,22,0,30,8
1713519890177,EDS 206R,A00,507332,Staff,0,2,30,30
1713519890177,EDS 206R,B00,507343,Staff,23,0,30,7
1713519891207,EDS 250,A00,507344,Hemans; Patricia Ann Benitez,27,0,40,13
1713519892233,EDS 281,A00,507345,Daly; Alan J.,18,0,18,0
1713519893258,EDS 284,A00,507350,Daly; Alan J.,16,0,16,0
1713519894285,EDS 286,A00,507359,Fine; Sarah,18,0,18,0
1713519895311,EDS 289C,A01,507361,Daly; Alan J.,18,0,18,0
1713519896337,EDS 290,A00,507366,Hofstetter; Carolyn,15,0,15,0
1713519897370,LIGM 5A,A00,507421,Fischer-Grunski; Eva K,20,0,20,0
1713519898401,LIGM 5B,A00,507423,Fischer-Grunski; Eva K,20,0,20,0
1713519899427,LIGM 5C,A00,507425,Fischer-Grunski; Eva K,20,0,20,0
1713519900468,LIIT 5AS,A00,507427,Carnelos; Chiara,20,0,20,0
1713519901502,LIIT 5BS,A00,507430,Carnelos; Chiara,20,0,20,0
1713519902530,LIIT 5CS,A00,507432,Carnelos; Chiara,20,0,20,0
1713519903555,LISP 5A,A00,507541,Munoz Sanchez; Alicia,14,0,20,6
1713519904579,LISP 5B,A00,507671,Munoz Sanchez; Alicia,12,0,20,8
1713519905604,LISP 5C,A00,507696,Munoz Sanchez; Alicia,11,0,20,9
1713519906628,MAE 197,001,528363,Boechler; Nicholas Sebastia,9998,0,9999,1
1713519907656,MATH 197,001,523477,Kedlaya; Kiran S.,9999,0,9999,0
1713519907656,MATH 197,002,563811,Zhang; Danna,9998,0,9999,1
1713519908683,MCWP 40R,A00,518780,Staff,13,0,20,7
1713519908683,MCWP 40R,B00,518781,Staff,11,0,20,9
1713519908683,MCWP 40R,C00,518783,Staff,8,0,20,12
1713519909713,MCWP 50R,A00,518791,Staff,7,0,20,13
1713519909713,MCWP 50R,B00,518792,Staff,3,0,20,17
1713519909713,MCWP 50R,C00,518793,Staff,5,0,20,15
1713519909713,MCWP 50R,D00,518794,Staff,0,0,20,20
1713519909713,MCWP 50R,E00,518795,Staff,0,0,20,20
1713519909713,MCWP 50R,F00,518796,Staff,10,0,20,10
1713519909713,MCWP 50R,G00,518797,Staff,10,0,20,10
1713519910737,MMW 12R,A01,514034,Herbst; Matthew,1,0,16,15
1713519910737,MMW 12R,A02,514035,Herbst; Matthew,13,0,16,3
1713519911767,MMW 13R,A01,514037,Staff,0,8,16,16
1713519911767,MMW 13R,A02,514039,Staff,0,7,16,16
1713519913824,SIO 295LS,A00,523233,Staff,15,0,30,15
1713519914849,SIO 295S,A00,523232,Staff,15,0,30,15
1713519915888,SOCI 117,A01,494376,Staff,0,2,5,5
1713519916913,WES 237B,A00,494380,Staff,19,0,20,1
1713519918976,AESE 279B,A00,494370,Wade; Jon P,33,0,33,0
1713519920003,AIP 197,001,627712,Vespa; Emanuel Ignacio,9999,0,9999,0
1713519921028,ANAR 135S,A00,494369,Braswell; Geoffrey E.,0,0,0,0
1713519922055,CAT 124RS,A01,519847,Geibel; William,6,0,20,14
1713519923083,CAT 125RS,A01,515971,Geibel; William,6,0,20,14
1713519924109,CLRE 250,A00,511389,Morris; Sheldon,9996,0,9999,3
1713519925135,CLRE 251,A00,507176,Mehta; Ravindra L.,9996,0,9999,3
1713519925135,CLRE 251,B00,511410,Mehta; Ravindra L.,9998,0,9999,1
1713519926161,CLRE 252,A00,507189,Cuomo; Raphael Eduardo,9998,0,9999,1
1713519927185,CLRE 253,A00,507199,Vaida; Florin,9997,0,9999,2
1713519927185,CLRE 253,B00,507202,Vaida; Florin,9999,0,9999,0
1713519928215,CLRE 259,A00,507211,Patel; Hemal,9996,0,9999,3
1713519929299,CLRE 260,A00,507221,Cuomo; Raphael Eduardo,9999,0,9999,0
1713519930327,CLRE 297,001,507242,Cuomo; Raphael Eduardo,9999,0,9999,0
1713519931352,CSE 191,A00,516875,Minnes Kemp; Mor Mia,9999,0,9999,0
1713519932379,CSS 201S,A01,494383,Staff,35,0,35,0
1713519933404,CSS 202S,A01,494387,Staff,35,0,35,0
1713519934429,EAP 100,A00,516065,Staff,9792,0,9999,207
1713519935454,ECE 45,A01,507414,Staff,37,0,60,23
1713519936479,ECE 100,A01,507416,Baghdadchi; Saharnaz,0,0,20,20
1713519936479,ECE 100,A02,507418,Baghdadchi; Saharnaz,19,0,20,1
1713519937502,ECE 111,A01,507420,Staff,27,0,50,23
1713519938533,ECE 197,001,548057,Sievenpiper; Daniel F.,9998,0,9999,1
1713519939557,EDS 115,A00,507243,Choi; Bailey Miyeon,27,0,28,1
1713519940583,EDS 117,A01,494379,Staff,14,0,25,11
1713519941613,EDS 125,A00,507246,Hopkins; Megan Beth,27,0,30,3
1713519942638,EDS 128A,A01,507264,Fargason; Sharon Gayle,26,0,26,0
1713519943668,EDS 128B,A01,507293,Pappas; Elizabeth,30,0,30,0
1713519944692,EDS 139,A00,507294,Fargason; Sharon Gayle,30,0,30,0
1713519944692,EDS 139,B00,507313,Pappas; Elizabeth,30,0,30,0
1713519945718,EDS 201,A00,507315,Staff,18,0,30,12
1713519946749,EDS 203,A01,507317,Halter; Christopher P.,17,0,30,13
1713519947773,EDS 204R,A01,507319,Halter; Christopher P.,0,1,30,30
1713519947773,EDS 204R,B01,507331,Heinzman; Erica M.,22,0,30,8
1713519948799,EDS 206R,A00,507332,Staff,0,2,30,30
1713519948799,EDS 206R,B00,507343,Staff,23,0,30,7
1713519949825,EDS 250,A00,507344,Hemans; Patricia Ann Benitez,27,0,40,13
1713519950851,EDS 281,A00,507345,Daly; Alan J.,18,0,18,0
1713519951879,EDS 284,A00,507350,Daly; Alan J.,16,0,16,0
1713519952904,EDS 286,A00,507359,Fine; Sarah,18,0,18,0
1713519953930,EDS 289C,A01,507361,Daly; Alan J.,18,0,18,0
1713519954955,EDS 290,A00,507366,Hofstetter; Carolyn,15,0,15,0
1713519955986,LIGM 5A,A00,507421,Fischer-Grunski; Eva K,20,0,20,0
1713519957011,LIGM 5B,A00,507423,Fischer-Grunski; Eva K,20,0,20,0
1713519958035,LIGM 5C,A00,507425,Fischer-Grunski; Eva K,20,0,20,0
1713519959061,LIIT 5AS,A00,507427,Carnelos; Chiara,20,0,20,0
1713519960103,LIIT 5BS,A00,507430,Carnelos; Chiara,20,0,20,0
1713519961134,LIIT 5CS,A00,507432,Carnelos; Chiara,20,0,20,0
1713519962159,LISP 5A,A00,507541,Munoz Sanchez; Alicia,14,0,20,6
1713519963185,LISP 5B,A00,507671,Munoz Sanchez; Alicia,12,0,20,8
1713519964211,LISP 5C,A00,507696,Munoz Sanchez; Alicia,11,0,20,9
1713519965239,MAE 197,001,528363,Boechler; Nicholas Sebastia,9998,0,9999,1
1713519966269,MATH 197,001,523477,Kedlaya; Kiran S.,9999,0,9999,0
1713519966269,MATH 197,002,563811,Zhang; Danna,9998,0,9999,1
1713519967294,MCWP 40R,A00,518780,Staff,13,0,20,7
1713519967294,MCWP 40R,B00,518781,Staff,11,0,20,9
1713519967294,MCWP 40R,C00,518783,Staff,8,0,20,12
1713519968323,MCWP 50R,A00,518791,Staff,7,0,20,13
1713519968323,MCWP 50R,B00,518792,Staff,3,0,20,17
1713519968323,MCWP 50R,C00,518793,Staff,5,0,20,15
1713519968323,MCWP 50R,D00,518794,Staff,0,0,20,20
1713519968323,MCWP 50R,E00,518795,Staff,0,0,20,20
1713519968323,MCWP 50R,F00,518796,Staff,10,0,20,10
1713519968323,MCWP 50R,G00,518797,Staff,10,0,20,10
1713519969348,MMW 12R,A01,514034,Herbst; Matthew,1,0,16,15
1713519969348,MMW 12R,A02,514035,Herbst; Matthew,13,0,16,3
1713519970373,MMW 13R,A01,514037,Staff,0,8,16,16
1713519970373,MMW 13R,A02,514039,Staff,0,7,16,16
1713519972427,SIO 295LS,A00,523233,Staff,15,0,30,15
1713519973456,SIO 295S,A00,523232,Staff,15,0,30,15
1713519974481,SOCI 117,A01,494376,Staff,0,2,5,5
1713519975505,WES 237B,A00,494380,Staff,19,0,20,1
1713519977570,AESE 279B,A00,494370,Wade; Jon P,33,0,33,0
1713519978598,AIP 197,001,627712,Vespa; Emanuel Ignacio,9999,0,9999,0
1713519979622,ANAR 135S,A00,494369,Braswell; Geoffrey E.,0,0,0,0
1713519980648,CAT 124RS,A01,519847,Geibel; William,6,0,20,14
1713519981676,CAT 125RS,A01,515971,Geibel; William,6,0,20,14
1713519982700,CLRE 250,A00,511389,Morris; Sheldon,9996,0,9999,3
1713519983726,CLRE 251,A00,507176,Mehta; Ravindra L.,9996,0,9999,3
1713519983726,CLRE 251,B00,511410,Mehta; Ravindra L.,9998,0,9999,1
1713519984750,CLRE 252,A00,507189,Cuomo; Raphael Eduardo,9998,0,9999,1
1713519985780,CLRE 253,A00,507199,Vaida; Florin,9997,0,9999,2
1713519985780,CLRE 253,B00,507202,Vaida; Florin,9999,0,9999,0
1713519986808,CLRE 259,A00,507211,Patel; Hemal,9996,0,9999,3
1713519987837,CLRE 260,A00,507221,Cuomo; Raphael Eduardo,9999,0,9999,0
1713519988867,CLRE 297,001,507242,Cuomo; Raphael Eduardo,9999,0,9999,0
1713519989892,CSE 191,A00,516875,Minnes Kemp; Mor Mia,9999,0,9999,0
1713519990916,CSS 201S,A01,494383,Staff,35,0,35,0
1713519991942,CSS 202S,A01,494387,Staff,35,0,35,0
1713519992966,EAP 100,A00,516065,Staff,9792,0,9999,207
1713519993992,ECE 45,A01,507414,Staff,37,0,60,23
1713519995015,ECE 100,A01,507416,Baghdadchi; Saharnaz,0,0,20,20
1713519995015,ECE 100,A02,507418,Baghdadchi; Saharnaz,19,0,20,1
1713519996046,ECE 111,A01,507420,Staff,27,0,50,23
1713519997074,ECE 197,001,548057,Sievenpiper; Daniel F.,9998,0,9999,1
1713519998100,EDS 115,A00,507243,Choi; Bailey Miyeon,27,0,28,1
1713519999125,EDS 117,A01,494379,Staff,14,0,25,11
1713520000155,EDS 125,A00,507246,Hopkins; Megan Beth,27,0,30,3
1713520001184,EDS 128A,A01,507264,Fargason; Sharon Gayle,26,0,26,0
1713520002211,EDS 128B,A01,507293,Pappas; Elizabeth,30,0,30,0
1713520003237,EDS 139,A00,507294,Fargason; Sharon Gayle,30,0,30,0
1713520003237,EDS 139,B00,507313,Pappas; Elizabeth,30,0,30,0
1713520004263,EDS 201,A00,507315,Staff,18,0,30,12
1713520005289,EDS 203,A01,507317,Halter; Christopher P.,17,0,30,13
1713520006315,EDS 204R,A01,507319,Halter; Christopher P.,0,1,30,30
1713520006315,EDS 204R,B01,507331,Heinzman; Erica M.,22,0,30,8
1713520007344,EDS 206R,A00,507332,Staff,0,2,30,30
1713520007344,EDS 206R,B00,507343,Staff,23,0,30,7
1713520008370,EDS 250,A00,507344,Hemans; Patricia Ann Benitez,27,0,40,13
1713520009395,EDS 281,A00,507345,Daly; Alan J.,18,0,18,0
1713520010422,EDS 284,A00,507350,Daly; Alan J.,16,0,16,0
1713520011450,EDS 286,A00,507359,Fine; Sarah,18,0,18,0
1713520012474,EDS 289C,A01,507361,Daly; Alan J.,18,0,18,0
1713520013501,EDS 290,A00,507366,Hofstetter; Carolyn,15,0,15,0
1713520014528,LIGM 5A,A00,507421,Fischer-Grunski; Eva K,20,0,20,0
1713520015557,LIGM 5B,A00,507423,Fischer-Grunski; Eva K,20,0,20,0
1713520016585,LIGM 5C,A00,507425,Fischer-Grunski; Eva K,20,0,20,0
1713520017610,LIIT 5AS,A00,507427,Carnelos; Chiara,20,0,20,0
1713520018638,LIIT 5BS,A00,507430,Carnelos; Chiara,20,0,20,0
1713520019664,LIIT 5CS,A00,507432,Carnelos; Chiara,20,0,20,0
1713520020690,LISP 5A,A00,507541,Munoz Sanchez; Alicia,14,0,20,6
1713520021719,LISP 5B,A00,507671,Munoz Sanchez; Alicia,12,0,20,8
1713520022745,LISP 5C,A00,507696,Munoz Sanchez; Alicia,11,0,20,9
1713520023770,MAE 197,001,528363,Boechler; Nicholas Sebastia,9998,0,9999,1
1713520024796,MATH 197,001,523477,Kedlaya; Kiran S.,9999,0,9999,0
1713520024796,MATH 197,002,563811,Zhang; Danna,9998,0,9999,1
1713520025822,MCWP 40R,A00,518780,Staff,13,0,20,7
1713520025822,MCWP 40R,B00,518781,Staff,11,0,20,9
1713520025822,MCWP 40R,C00,518783,Staff,8,0,20,12
1713520026851,MCWP 50R,A00,518791,Staff,7,0,20,13
1713520026851,MCWP 50R,B00,518792,Staff,3,0,20,17
1713520026851,MCWP 50R,C00,518793,Staff,5,0,20,15
1713520026851,MCWP 50R,D00,518794,Staff,0,0,20,20
1713520026851,MCWP 50R,E00,518795,Staff,0,0,20,20
1713520026851,MCWP 50R,F00,518796,Staff,10,0,20,10
1713520026851,MCWP 50R,G00,518797,Staff,10,0,20,10
1713520027880,MMW 12R,A01,514034,Herbst; Matthew,1,0,16,15
1713520027880,MMW 12R,A02,514035,Herbst; Matthew,13,0,16,3
1713520028909,MMW 13R,A01,514037,Staff,0,8,16,16
1713520028909,MMW 13R,A02,514039,Staff,0,7,16,16
1713520030961,SIO 295LS,A00,523233,Staff,15,0,30,15
1713520031987,SIO 295S,A00,523232,Staff,15,0,30,15
1713520033069,SOCI 117,A01,494376,Staff,0,2,5,5
1713520034094,WES 237B,A00,494380,Staff,19,0,20,1
1713520036157,AESE 279B,A00,494370,Wade; Jon P,33,0,33,0
1713520037183,AIP 197,001,627712,Vespa; Emanuel Ignacio,9999,0,9999,0
1713520038208,ANAR 135S,A00,494369,Braswell; Geoffrey E.,0,0,0,0
1713520039237,CAT 124RS,A01,519847,Geibel; William,6,0,20,14
1713520040267,CAT 125RS,A01,515971,Geibel; William,6,0,20,14
1713520041295,CLRE 250,A00,511389,Morris; Sheldon,9996,0,9999,3
1713520042325,CLRE 251,A00,507176,Mehta; Ravindra L.,9996,0,9999,3
1713520042325,CLRE 251,B00,511410,Mehta; Ravindra L.,9998,0,9999,1
1713520043355,CLRE 252,A00,507189,Cuomo; Raphael Eduardo,9998,0,9999,1
1713520044380,CLRE 253,A00,507199,Vaida; Florin,9997,0,9999,2
1713520044380,CLRE 253,B00,507202,Vaida; Florin,9999,0,9999,0
1713520045405,CLRE 259,A00,507211,Patel; Hemal,9996,0,9999,3
1713520046430,CLRE 260,A00,507221,Cuomo; Raphael Eduardo,9999,0,9999,0
1713520047458,CLRE 297,001,507242,Cuomo; Raphael Eduardo,9999,0,9999,0
1713520048483,CSE 191,A00,516875,Minnes Kemp; Mor Mia,9999,0,9999,0
1713520049508,CSS 201S,A01,494383,Staff,35,0,35,0
1713520050534,CSS 202S,A01,494387,Staff,35,0,35,0
1713520051559,EAP 100,A00,516065,Staff,9792,0,9999,207
1713520052584,ECE 45,A01,507414,Staff,37,0,60,23
1713520053614,ECE 100,A01,507416,Baghdadchi; Saharnaz,0,0,20,20
1713520053614,ECE 100,A02,507418,Baghdadchi; Saharnaz,19,0,20,1
1713520054639,ECE 111,A01,507420,Staff,27,0,50,23
1713520055669,ECE 197,001,548057,Sievenpiper; Daniel F.,9998,0,9999,1
1713520056698,EDS 115,A00,507243,Choi; Bailey Miyeon,27,0,28,1
1713520057726,EDS 117,A01,494379,Staff,14,0,25,11
1713520058756,EDS 125,A00,507246,Hopkins; Megan Beth,27,0,30,3
1713520059784,EDS 128A,A01,507264,Fargason; Sharon Gayle,26,0,26,0
1713520060813,EDS 128B,A01,507293,Pappas; Elizabeth,30,0,30,0
1713520061838,EDS 139,A00,507294,Fargason; Sharon Gayle,30,0,30,0
1713520061838,EDS 139,B00,507313,Pappas; Elizabeth,30,0,30,0
1713520062868,EDS 201,A00,507315,Staff,18,0,30,12
1713520063911,EDS 203,A01,507317,Halter; Christopher P.,17,0,30,13
1713520064937,EDS 204R,A01,507319,Halter; Christopher P.,0,1,30,30
1713520064937,EDS 204R,B01,507331,Heinzman; Erica M.,22,0,30,8
1713520066007,EDS 206R,A00,507332,Staff,0,2,30,30
1713520066007,EDS 206R,B00,507343,Staff,23,0,30,7
1713520067035,EDS 250,A00,507344,Hemans; Patricia Ann Benitez,27,0,40,13
1713520068063,EDS 281,A00,507345,Daly; Alan J.,18,0,18,0
1713520069089,EDS 284,A00,507350,Daly; Alan J.,16,0,16,0
1713520070115,EDS 286,A00,507359,Fine; Sarah,18,0,18,0
1713520071142,EDS 289C,A01,507361,Daly; Alan J.,18,0,18,0
1713520072168,EDS 290,A00,507366,Hofstetter; Carolyn,15,0,15,0
1713520073198,LIGM 5A,A00,507421,Fischer-Grunski; Eva K,20,0,20,0
1713520074227,LIGM 5B,A00,507423,Fischer-Grunski; Eva K,20,0,20,0
1713520075252,LIGM 5C,A00,507425,Fischer-Grunski; Eva K,20,0,20,0
1713520076277,LIIT 5AS,A00,507427,Carnelos; Chiara,20,0,20,0
1713520077302,LIIT 5BS,A00,507430,Carnelos; Chiara,20,0,20,0
1713520078328,LIIT 5CS,A00,507432,Carnelos; Chiara,20,0,20,0
1713520079358,LISP 5A,A00,507541,Munoz Sanchez; Alicia,14,0,20,6
1713520080384,LISP 5B,A00,507671,Munoz Sanchez; Alicia,12,0,20,8
1713520081410,LISP 5C,A00,507696,Munoz Sanchez; Alicia,11,0,20,9
1713520082438,MAE 197,001,528363,Boechler; Nicholas Sebastia,9998,0,9999,1
1713520083468,MATH 197,001,523477,Kedlaya; Kiran S.,9999,0,9999,0
1713520083468,MATH 197,002,563811,Zhang; Danna,9998,0,9999,1
1713520084496,MCWP 40R,A00,518780,Staff,13,0,20,7
1713520084496,MCWP 40R,B00,518781,Staff,11,0,20,9
1713520084496,MCWP 40R,C00,518783,Staff,8,0,20,12
1713520085522,MCWP 50R,A00,518791,Staff,7,0,20,13
1713520085522,MCWP 50R,B00,518792,Staff,3,0,20,17
1713520085522,MCWP 50R,C00,518793,Staff,5,0,20,15
1713520085522,MCWP 50R,D00,518794,Staff,0,0,20,20
1713520085522,MCWP 50R,E00,518795,Staff,0,0,20,20
1713520085522,MCWP 50R,F00,518796,Staff,10,0,20,10
1713520085522,MCWP 50R,G00,518797,Staff,10,0,20,10
1713520086553,MMW 12R,A01,514034,Herbst; Matthew,1,0,16,15
1713520086553,MMW 12R,A02,514035,Herbst; Matthew,13,0,16,3
1713520087579,MMW 13R,A01,514037,Staff,0,8,16,16
1713520087579,MMW 13R,A02,514039,Staff,0,7,16,16
1713520089637,SIO 295LS,A00,523233,Staff,15,0,30,15
1713520090665,SIO 295S,A00,523232,Staff,15,0,30,15
1713520091691,SOCI 117,A01,494376,Staff,0,2,5,5
1713520092717,WES 237B,A00,494380,Staff,19,0,20,1
1713520094782,AESE 279B,A00,494370,Wade; Jon P,33,0,33,0
1713520095808,AIP 197,001,627712,Vespa; Emanuel Ignacio,9999,0,9999,0
1713520096835,ANAR 135S,A00,494369,Braswell; Geoffrey E.,0,0,0,0
1713520097862,CAT 124RS,A01,519847,Geibel; William,6,0,20,14
1713520098890,CAT 125RS,A01,515971,Geibel; William,6,0,20,14
1713520099919,CLRE 250,A00,511389,Morris; Sheldon,9996,0,9999,3
1713520100947,CLRE 251,A00,507176,Mehta; Ravindra L.,9996,0,9999,3
1713520100947,CLRE 251,B00,511410,Mehta; Ravindra L.,9998,0,9999,1
1713520101972,CLRE 252,A00,507189,Cuomo; Raphael Eduardo,9998,0,9999,1
1713520102999,CLRE 253,A00,507199,Vaida; Florin,9997,0,9999,2
1713520102999,CLRE 253,B00,507202,Vaida; Florin,9999,0,9999,0
1713520104025,CLRE 259,A00,507211,Patel; Hemal,9996,0,9999,3
1713520105055,CLRE 260,A00,507221,Cuomo; Raphael Eduardo,9999,0,9999,0
1713520106081,CLRE 297,001,507242,Cuomo; Raphael Eduardo,9999,0,9999,0
1713520107109,CSE 191,A00,516875,Minnes Kemp; Mor Mia,9999,0,9999,0
1713520108138,CSS 201S,A01,494383,Staff,35,0,35,0
1713520109170,CSS 202S,A01,494387,Staff,35,0,35,0
1713520110196,EAP 100,A00,516065,Staff,9792,0,9999,207
1713520111227,ECE 45,A01,507414,Staff,37,0,60,23
1713520112252,ECE 100,A01,507416,Baghdadchi; Saharnaz,0,0,20,20
1713520112252,ECE 100,A02,507418,Baghdadchi; Saharnaz,19,0,20,1
1713520113282,ECE 111,A01,507420,Staff,27,0,50,23
1713520114308,ECE 197,001,548057,Sievenpiper; Daniel F.,9998,0,9999,1
1713520115338,EDS 115,A00,507243,Choi; Bailey Miyeon,27,0,28,1
1713520116364,EDS 117,A01,494379,Staff,14,0,25,11
1713520117395,EDS 125,A00,507246,Hopkins; Megan Beth,27,0,30,3
1713520118422,EDS 128A,A01,507264,Fargason; Sharon Gayle,26,0,26,0
1713520119451,EDS 128B,A01,507293,Pappas; Elizabeth,30,0,30,0
1713520120477,EDS 139,A00,507294,Fargason; Sharon Gayle,30,0,30,0
1713520120477,EDS 139,B00,507313,Pappas; Elizabeth,30,0,30,0
1713520121503,EDS 201,A00,507315,Staff,18,0,30,12
1713520122529,EDS 203,A01,507317,Halter; Christopher P.,17,0,30,13
1713520123558,EDS 204R,A01,507319,Halter; Christopher P.,0,1,30,30
1713520123558,EDS 204R,B01,507331,Heinzman; Erica M.,22,0,30,8
1713520124584,EDS 206R,A00,507332,Staff,0,2,30,30
1713520124584,EDS 206R,B00,507343,Staff,23,0,30,7
1713520125610,EDS 250,A00,507344,Hemans; Patricia Ann Benitez,27,0,40,13
1713520126639,EDS 281,A00,507345,Daly; Alan J.,18,0,18,0
1713520127668,EDS 284,A00,507350,Daly; Alan J.,16,0,16,0
1713520128698,EDS 286,A00,507359,Fine; Sarah,18,0,18,0
1713520129728,EDS 289C,A01,507361,Daly; Alan J.,18,0,18,0
1713520130754,EDS 290,A00,507366,Hofstetter; Carolyn,15,0,15,0
1713520131781,LIGM 5A,A00,507421,Fischer-Grunski; Eva K,20,0,20,0
1713520132810,LIGM 5B,A00,507423,Fischer-Grunski; Eva K,20,0,20,0
1713520133837,LIGM 5C,A00,507425,Fischer-Grunski; Eva K,20,0,20,0
1713520134865,LIIT 5AS,A00,507427,Carnelos; Chiara,20,0,20,0
1713520135891,LIIT 5BS,A00,507430,Carnelos; Chiara,20,0,20,0
1713520136974,LIIT 5CS,A00,507432,Carnelos; Chiara,20,0,20,0
1713520138005,LISP 5A,A00,507541,Munoz Sanchez; Alicia,14,0,20,6
1713520139033,LISP 5B,A00,507671,Munoz Sanchez; Alicia,12,0,20,8
1713520140067,LISP 5C,A00,507696,Munoz Sanchez; Alicia,11,0,20,9
1713520141092,MAE 197,001,528363,Boechler; Nicholas Sebastia,9998,0,9999,1
1713520142119,MATH 197,001,523477,Kedlaya; Kiran S.,9999,0,9999,0
1713520142119,MATH 197,002,563811,Zhang; Danna,9998,0,9999,1
1713520143144,MCWP 40R,A00,518780,Staff,13,0,20,7
1713520143144,MCWP 40R,B00,518781,Staff,11,0,20,9
1713520143144,MCWP 40R,C00,518783,Staff,8,0,20,12
1713520144170,MCWP 50R,A00,518791,Staff,7,0,20,13
1713520144170,MCWP 50R,B00,518792,Staff,3,0,20,17
1713520144170,MCWP 50R,C00,518793,Staff,5,0,20,15
1713520144170,MCWP 50R,D00,518794,Staff,0,0,20,20
1713520144170,MCWP 50R,E00,518795,Staff,0,0,20,20
1713520144170,MCWP 50R,F00,518796,Staff,10,0,20,10
1713520144170,MCWP 50R,G00,518797,Staff,10,0,20,10
1713520145201,MMW 12R,A01,514034,Herbst; Matthew,1,0,16,15
1713520145201,MMW 12R,A02,514035,Herbst; Matthew,13,0,16,3
1713520146227,MMW 13R,A01,514037,Staff,0,8,16,16
1713520146227,MMW 13R,A02,514039,Staff,0,7,16,16
1713520148282,SIO 295LS,A00,523233,Staff,15,0,30,15
1713520149308,SIO 295S,A00,523232,Staff,15,0,30,15
1713520150334,SOCI 117,A01,494376,Staff,0,2,5,5
1713520151362,WES 237B,A00,494380,Staff,19,0,20,1
1713520153435,AESE 279B,A00,494370,Wade; Jon P,33,0,33,0
1713520154460,AIP 197,001,627712,Vespa; Emanuel Ignacio,9999,0,9999,0
1713520155485,ANAR 135S,A00,494369,Braswell; Geoffrey E.,0,0,0,0
1713520156513,CAT 124RS,A01,519847,Geibel; William,6,0,20,14
1713520157537,CAT 125RS,A01,515971,Geibel; William,6,0,20,14
1713520158561,CLRE 250,A00,511389,Morris; Sheldon,9996,0,9999,3
1713520159592,CLRE 251,A00,507176,Mehta; Ravindra L.,9996,0,9999,3
1713520159592,CLRE 251,B00,511410,Mehta; Ravindra L.,9998,0,9999,1
1713520160617,CLRE 252,A00,507189,Cuomo; Raphael Eduardo,9998,0,9999,1
1713520161647,CLRE 253,A00,507199,Vaida; Florin,9997,0,9999,2
1713520161647,CLRE 253,B00,507202,Vaida; Florin,9999,0,9999,0
1713520162674,CLRE 259,A00,507211,Patel; Hemal,9996,0,9999,3
1713520163698,CLRE 260,A00,507221,Cuomo; Raphael Eduardo,9999,0,9999,0
1713520164723,CLRE 297,001,507242,Cuomo; Raphael Eduardo,9999,0,9999,0
1713520165752,CSE 191,A00,516875,Minnes Kemp; Mor Mia,9999,0,9999,0
1713520166778,CSS 201S,A01,494383,Staff,35,0,35,0
1713520167806,CSS 202S,A01,494387,Staff,35,0,35,0
1713520168835,EAP 100,A00,516065,Staff,9792,0,9999,207
1713520169863,ECE 45,A01,507414,Staff,37,0,60,23
1713520170888,ECE 100,A01,507416,Baghdadchi; Saharnaz,0,0,20,20
1713520170888,ECE 100,A02,507418,Baghdadchi; Saharnaz,19,0,20,1
1713520171913,ECE 111,A01,507420,Staff,27,0,50,23
1713520172939,ECE 197,001,548057,Sievenpiper; Daniel F.,9998,0,9999,1
1713520173965,EDS 115,A00,507243,Choi; Bailey Miyeon,27,0,28,1
1713520174994,EDS 117,A01,494379,Staff,14,0,25,11
1713520176021,EDS 125,A00,507246,Hopkins; Megan Beth,27,0,30,3
1713520177051,EDS 128A,A01,507264,Fargason; Sharon Gayle,26,0,26,0
1713520178079,EDS 128B,A01,507293,Pappas; Elizabeth,30,0,30,0
1713520179108,EDS 139,A00,507294,Fargason; Sharon Gayle,30,0,30,0
1713520179108,EDS 139,B00,507313,Pappas; Elizabeth,30,0,30,0
1713520180135,EDS 201,A00,507315,Staff,18,0,30,12
1713520181165,EDS 203,A01,507317,Halter; Christopher P.,17,0,30,13
1713520182195,EDS 204R,A01,507319,Halter; Christopher P.,0,1,30,30
1713520182195,EDS 204R,B01,507331,Heinzman; Erica M.,22,0,30,8
1713520183221,EDS 206R,A00,507332,Staff,0,2,30,30
1713520183221,EDS 206R,B00,507343,Staff,23,0,30,7
1713520184251,EDS 250,A00,507344,Hemans; Patricia Ann Benitez,27,0,40,13
1713520185277,EDS 281,A00,507345,Daly; Alan J.,18,0,18,0
1713520186301,EDS 284,A00,507350,Daly; Alan J.,16,0,16,0
1713520187327,EDS 286,A00,507359,Fine; Sarah,18,0,18,0
1713520188355,EDS 289C,A01,507361,Daly; Alan J.,18,0,18,0
1713520189380,EDS 290,A00,507366,Hofstetter; Carolyn,15,0,15,0
1713520190406,LIGM 5A,A00,507421,Fischer-Grunski; Eva K,20,0,20,0
1713520191436,LIGM 5B,A00,507423,Fischer-Grunski; Eva K,20,0,20,0
1713520192461,LIGM 5C,A00,507425,Fischer-Grunski; Eva K,20,0,20,0
1713520193487,LIIT 5AS,A00,507427,Carnelos; Chiara,20,0,20,0
1713520194517,LIIT 5BS,A00,507430,Carnelos; Chiara,20,0,20,0
1713520195544,LIIT 5CS,A00,507432,Carnelos; Chiara,20,0,20,0
1713520196575,LISP 5A,A00,507541,Munoz Sanchez; Alicia,14,0,20,6
1713520197600,LISP 5B,A00,507671,Munoz Sanchez; Alicia,12,0,20,8
1713520198626,LISP 5C,A00,507696,Munoz Sanchez; Alicia,11,0,20,9
1713520199652,MAE 197,001,528363,Boechler; Nicholas Sebastia,9998,0,9999,1
1713520200683,MATH 197,001,523477,Kedlaya; Kiran S.,9999,0,9999,0
1713520200683,MATH 197,002,563811,Zhang; Danna,9998,0,9999,1
1713520201714,MCWP 40R,A00,518780,Staff,13,0,20,7
1713520201714,MCWP 40R,B00,518781,Staff,11,0,20,9
1713520201714,MCWP 40R,C00,518783,Staff,8,0,20,12
1713520202741,MCWP 50R,A00,518791,Staff,7,0,20,13
1713520202741,MCWP 50R,B00,518792,Staff,3,0,20,17
1713520202741,MCWP 50R,C00,518793,Staff,5,0,20,15
1713520202741,MCWP 50R,D00,518794,Staff,0,0,20,20
1713520202741,MCWP 50R,E00,518795,Staff,0,0,20,20
1713520202741,MCWP 50R,F00,518796,Staff,10,0,20,10
1713520202741,MCWP 50R,G00,518797,Staff,10,0,20,10
1713520203774,MMW 12R,A01,514034,Herbst; Matthew,1,0,16,15
1713520203774,MMW 12R,A02,514035,Herbst; Matthew,13,0,16,3
1713520204802,MMW 13R,A01,514037,Staff,0,8,16,16
1713520204802,MMW 13R,A02,514039,Staff,0,7,16,16
1713520206855,SIO 295LS,A00,523233,Staff,15,0,30,15
1713520207880,SIO 295S,A00,523232,Staff,15,0,30,15
1713520208905,SOCI 117,A01,494376,Staff,0,2,5,5
1713520209931,WES 237B,A00,494380,Staff,19,0,20,1
1713520212000,AESE 279B,A00,494370,Wade; Jon P,33,0,33,0
1713520213025,AIP 197,001,627712,Vespa; Emanuel Ignacio,9999,0,9999,0
1713520214053,ANAR 135S,A00,494369,Braswell; Geoffrey E.,0,0,0,0
1713520215077,CAT 124RS,A01,519847,Geibel; William,6,0,20,14
1713520216105,CAT 125RS,A01,515971,Geibel; William,6,0,20,14
1713520217132,CLRE 250,A00,511389,Morris; Sheldon,9996,0,9999,3
1713520218159,CLRE 251,A00,507176,Mehta; Ravindra L.,9996,0,9999,3
1713520218159,CLRE 251,B00,511410,Mehta; Ravindra L.,9998,0,9999,1
1713520219189,CLRE 252,A00,507189,Cuomo; Raphael Eduardo,9998,0,9999,1
1713520220217,CLRE 253,A00,507199,Vaida; Florin,9997,0,9999,2
1713520220217,CLRE 253,B00,507202,Vaida; Florin,9999,0,9999,0
1713520221246,CLRE 259,A00,507211,Patel; Hemal,9996,0,9999,3
1713520222272,CLRE 260,A00,507221,Cuomo; Raphael Eduardo,9999,0,9999,0
1713520223297,CLRE 297,001,507242,Cuomo; Raphael Eduardo,9999,0,9999,0
1713520224324,CSE 191,A00,516875,Minnes Kemp; Mor Mia,9999,0,9999,0
1713520225350,CSS 201S,A01,494383,Staff,35,0,35,0
1713520226375,CSS 202S,A01,494387,Staff,35,0,35,0
1713520227399,EAP 100,A00,516065,Staff,9792,0,9999,207
1713520228428,ECE 45,A01,507414,Staff,37,0,60,23
1713520229455,ECE 100,A01,507416,Baghdadchi; Saharnaz,0,0,20,20
1713520229455,ECE 100,A02,507418,Baghdadchi; Saharnaz,19,0,20,1
1713520230480,ECE 111,A01,507420,Staff,27,0,50,23
1713520231506,ECE 197,001,548057,Sievenpiper; Daniel F.,9998,0,9999,1
1713520232535,EDS 115,A00,507243,Choi; Bailey Miyeon,27,0,28,1
1713520233565,EDS 117,A01,494379,Staff,14,0,25,11
1713520234590,EDS 125,A00,507246,Hopkins; Megan Beth,27,0,30,3
1713520235616,EDS 128A,A01,507264,Fargason; Sharon Gayle,26,0,26,0
1713520236641,EDS 128B,A01,507293,Pappas; Elizabeth,30,0,30,0
1713520237669,EDS 139,A00,507294,Fargason; Sharon Gayle,30,0,30,0
1713520237669,EDS 139,B00,507313,Pappas; Elizabeth,30,0,30,0
1713520238694,EDS 201,A00,507315,Staff,18,0,30,12
1713520239720,EDS 203,A01,507317,Halter; Christopher P.,17,0,30,13
1713520240805,EDS 204R,A01,507319,Halter; Christopher P.,0,1,30,30
1713520240805,EDS 204R,B01,507331,Heinzman; Erica M.,22,0,30,8
1713520241831,EDS 206R,A00,507332,Staff,0,2,30,30
1713520241831,EDS 206R,B00,507343,Staff,23,0,30,7
1713520242856,EDS 250,A00,507344,Hemans; Patricia Ann Benitez,27,0,40,13
1713520243896,EDS 281,A00,507345,Daly; Alan J.,18,0,18,0
1713520244922,EDS 284,A00,507350,Daly; Alan J.,16,0,16,0
1713520245953,EDS 286,A00,507359,Fine; Sarah,18,0,18,0
1713520246985,EDS 289C,A01,507361,Daly; Alan J.,18,0,18,0
1713520248011,EDS 290,A00,507366,Hofstetter; Carolyn,15,0,15,0
1713520249038,LIGM 5A,A00,507421,Fischer-Grunski; Eva K,20,0,20,0
1713520250077,LIGM 5B,A00,507423,Fischer-Grunski; Eva K,20,0,20,0
1713520251103,LIGM 5C,A00,507425,Fischer-Grunski; Eva K,20,0,20,0
1713520252133,LIIT 5AS,A00,507427,Carnelos; Chiara,20,0,20,0
1713520253159,LIIT 5BS,A00,507430,Carnelos; Chiara,20,0,20,0
1713520254185,LIIT 5CS,A00,507432,Carnelos; Chiara,20,0,20,0
1713520255211,LISP 5A,A00,507541,Munoz Sanchez; Alicia,14,0,20,6
1713520256238,LISP 5B,A00,507671,Munoz Sanchez; Alicia,12,0,20,8
1713520257264,LISP 5C,A00,507696,Munoz Sanchez; Alicia,11,0,20,9
1713520258292,MAE 197,001,528363,Boechler; Nicholas Sebastia,9998,0,9999,1
1713520259319,MATH 197,001,523477,Kedlaya; Kiran S.,9999,0,9999,0
1713520259319,MATH 197,002,563811,Zhang; Danna,9998,0,9999,1
1713520260345,MCWP 40R,A00,518780,Staff,13,0,20,7
1713520260345,MCWP 40R,B00,518781,Staff,11,0,20,9
1713520260345,MCWP 40R,C00,518783,Staff,8,0,20,12
1713520261376,MCWP 50R,A00,518791,Staff,7,0,20,13
1713520261376,MCWP 50R,B00,518792,Staff,3,0,20,17
1713520261376,MCWP 50R,C00,518793,Staff,5,0,20,15
1713520261376,MCWP 50R,D00,518794,Staff,0,0,20,20
1713520261376,MCWP 50R,E00,518795,Staff,0,0,20,20
1713520261376,MCWP 50R,F00,518796,Staff,10,0,20,10
1713520261376,MCWP 50R,G00,518797,Staff,10,0,20,10
1713520262402,MMW 12R,A01,514034,Herbst; Matthew,1,0,16,15
1713520262402,MMW 12R,A02,514035,Herbst; Matthew,13,0,16,3
1713520263428,MMW 13R,A01,514037,Staff,0,8,16,16
1713520263428,MMW 13R,A02,514039,Staff,0,7,16,16
1713520265484,SIO 295LS,A00,523233,Staff,15,0,30,15
1713520266509,SIO 295S,A00,523232,Staff,15,0,30,15
1713520267537,SOCI 117,A01,494376,Staff,0,2,5,5
1713520268561,WES 237B,A00,494380,Staff,19,0,20,1
1713520270621,AESE 279B,A00,494370,Wade; Jon P,33,0,33,0
1713520271646,AIP 197,001,627712,Vespa; Emanuel Ignacio,9999,0,9999,0
1713520272676,ANAR 135S,A00,494369,Braswell; Geoffrey E.,0,0,0,0
1713520273701,CAT 124RS,A01,519847,Geibel; William,6,0,20,14
1713520274727,CAT 125RS,A01,515971,Geibel; William,6,0,20,14
1713520275754,CLRE 250,A00,511389,Morris; Sheldon,9996,0,9999,3
1713520276781,CLRE 251,A00,507176,Mehta; Ravindra L.,9996,0,9999,3
1713520276781,CLRE 251,B00,511410,Mehta; Ravindra L.,9998,0,9999,1
1713520277810,CLRE 252,A00,507189,Cuomo; Raphael Eduardo,9998,0,9999,1
1713520278835,CLRE 253,A00,507199,Vaida; Florin,9997,0,9999,2
1713520278835,CLRE 253,B00,507202,Vaida; Florin,9999,0,9999,0
1713520279858,CLRE 259,A00,507211,Patel; Hemal,9996,0,9999,3
1713520280883,CLRE 260,A00,507221,Cuomo; Raphael Eduardo,9999,0,9999,0
1713520281912,CLRE 297,001,507242,Cuomo; Raphael Eduardo,9999,0,9999,0
1713520282938,CSE 191,A00,516875,Minnes Kemp; Mor Mia,9999,0,9999,0
1713520283964,CSS 201S,A01,494383,Staff,35,0,35,0
1713520284991,CSS 202S,A01,494387,Staff,35,0,35,0
1713520286018,EAP 100,A00,516065,Staff,9792,0,9999,207
1713520287045,ECE 45,A01,507414,Staff,37,0,60,23
1713520288074,ECE 100,A01,507416,Baghdadchi; Saharnaz,0,0,20,20
1713520288074,ECE 100,A02,507418,Baghdadchi; Saharnaz,19,0,20,1
1713520289104,ECE 111,A01,507420,Staff,27,0,50,23
1713520290131,ECE 197,001,548057,Sievenpiper; Daniel F.,9998,0,9999,1
1713520291156,EDS 115,A00,507243,Choi; Bailey Miyeon,27,0,28,1
1713520292180,EDS 117,A01,494379,Staff,14,0,25,11
1713520293209,EDS 125,A00,507246,Hopkins; Megan Beth,27,0,30,3
1713520294235,EDS 128A,A01,507264,Fargason; Sharon Gayle,26,0,26,0
1713520295259,EDS 128B,A01,507293,Pappas; Elizabeth,30,0,30,0
1713520296288,EDS 139,A00,507294,Fargason; Sharon Gayle,30,0,30,0
1713520296288,EDS 139,B00,507313,Pappas; Elizabeth,30,0,30,0
1713520297313,EDS 201,A00,507315,Staff,18,0,30,12
1713520298338,EDS 203,A01,507317,Halter; Christopher P.,17,0,30,13
1713520299370,EDS 204R,A01,507319,Halter; Christopher P.,0,1,30,30
1713520299370,EDS 204R,B01,507331,Heinzman; Erica M.,22,0,30,8
1713520300400,EDS 206R,A00,507332,Staff,0,2,30,30
1713520300400,EDS 206R,B00,507343,Staff,23,0,30,7
1713520301425,EDS 250,A00,507344,Hemans; Patricia Ann Benitez,27,0,40,13
1713520302450,EDS 281,A00,507345,Daly; Alan J.,18,0,18,0
1713520303479,EDS 284,A00,507350,Daly; Alan J.,16,0,16,0
1713520304508,EDS 286,A00,507359,Fine; Sarah,18,0,18,0
1713520305533,EDS 289C,A01,507361,Daly; Alan J.,18,0,18,0
1713520306560,EDS 290,A00,507366,Hofstetter; Carolyn,15,0,15,0
1713520307586,LIGM 5A,A00,507421,Fischer-Grunski; Eva K,20,0,20,0
1713520308610,LIGM 5B,A00,507423,Fischer-Grunski; Eva K,20,0,20,0
1713520309635,LIGM 5C,A00,507425,Fischer-Grunski; Eva K,20,0,20,0
1713520310665,LIIT 5AS,A00,507427,Carnelos; Chiara,20,0,20,0
1713520311691,LIIT 5BS,A00,507430,Carnelos; Chiara,20,0,20,0
1713520312718,LIIT 5CS,A00,507432,Carnelos; Chiara,20,0,20,0
1713520313743,LISP 5A,A00,507541,Munoz Sanchez; Alicia,14,0,20,6
1713520314769,LISP 5B,A00,507671,Munoz Sanchez; Alicia,12,0,20,8
1713520315796,LISP 5C,A00,507696,Munoz Sanchez; Alicia,11,0,20,9
1713520316821,MAE 197,001,528363,Boechler; Nicholas Sebastia,9998,0,9999,1
1713520317850,MATH 197,001,523477,Kedlaya; Kiran S.,9999,0,9999,0
1713520317850,MATH 197,002,563811,Zhang; Danna,9998,0,9999,1
1713520318879,MCWP 40R,A00,518780,Staff,13,0,20,7
1713520318879,MCWP 40R,B00,518781,Staff,11,0,20,9
1713520318879,MCWP 40R,C00,518783,Staff,8,0,20,12
1713520319904,MCWP 50R,A00,518791,Staff,7,0,20,13
1713520319904,MCWP 50R,B00,518792,Staff,3,0,20,17
1713520319904,MCWP 50R,C00,518793,Staff,5,0,20,15
1713520319904,MCWP 50R,D00,518794,Staff,0,0,20,20
1713520319904,MCWP 50R,E00,518795,Staff,0,0,20,20
1713520319904,MCWP 50R,F00,518796,Staff,10,0,20,10
1713520319904,MCWP 50R,G00,518797,Staff,10,0,20,10
1713520320930,MMW 12R,A01,514034,Herbst; Matthew,1,0,16,15
1713520320930,MMW 12R,A02,514035,Herbst; Matthew,13,0,16,3
1713520321955,MMW 13R,A01,514037,Staff,0,8,16,16
1713520321955,MMW 13R,A02,514039,Staff,0,7,16,16
1713520324009,SIO 295LS,A00,523233,Staff,15,0,30,15
1713520325037,SIO 295S,A00,523232,Staff,15,0,30,15
1713520326063,SOCI 117,A01,494376,Staff,0,2,5,5
1713520327092,WES 237B,A00,494380,Staff,19,0,20,1
1713520329158,AESE 279B,A00,494370,Wade; Jon P,33,0,33,0
1713520330184,AIP 197,001,627712,Vespa; Emanuel Ignacio,9999,0,9999,0
1713520331212,ANAR 135S,A00,494369,Braswell; Geoffrey E.,0,0,0,0
1713520332240,CAT 124RS,A01,519847,Geibel; William,6,0,20,14
1713520333269,CAT 125RS,A01,515971,Geibel; William,6,0,20,14
1713520334295,CLRE 250,A00,511389,Morris; Sheldon,9996,0,9999,3
1713520335321,CLRE 251,A00,507176,Mehta; Ravindra L.,9996,0,9999,3
1713520335321,CLRE 251,B00,511410,Mehta; Ravindra L.,9998,0,9999,1
1713520336348,CLRE 252,A00,507189,Cuomo; Raphael Eduardo,9998,0,9999,1
1713520337375,CLRE 253,A00,507199,Vaida; Florin,9997,0,9999,2
1713520337375,CLRE 253,B00,507202,Vaida; Florin,9999,0,9999,0
1713520338404,CLRE 259,A00,507211,Patel; Hemal,9996,0,9999,3
1713520339430,CLRE 260,A00,507221,Cuomo; Raphael Eduardo,9999,0,9999,0
1713520340457,CLRE 297,001,507242,Cuomo; Raphael Eduardo,9999,0,9999,0
1713520341484,CSE 191,A00,516875,Minnes Kemp; Mor Mia,9999,0,9999,0
1713520342511,CSS 201S,A01,494383,Staff,35,0,35,0
1713520343537,CSS 202S,A01,494387,Staff,35,0,35,0
1713520344617,EAP 100,A00,516065,Staff,9792,0,9999,207
1713520345646,ECE 45,A01,507414,Staff,37,0,60,23
1713520346674,ECE 100,A01,507416,Baghdadchi; Saharnaz,0,0,20,20
1713520346674,ECE 100,A02,507418,Baghdadchi; Saharnaz,19,0,20,1
1713520347698,ECE 111,A01,507420,Staff,27,0,50,23
1713520348724,ECE 197,001,548057,Sievenpiper; Daniel F.,9998,0,9999,1
1713520349750,EDS 115,A00,507243,Choi; Bailey Miyeon,27,0,28,1
1713520350774,EDS 117,A01,494379,Staff,14,0,25,11
1713520351803,EDS 125,A00,507246,Hopkins; Megan Beth,27,0,30,3
1713520352833,EDS 128A,A01,507264,Fargason; Sharon Gayle,26,0,26,0
1713520353874,EDS 128B,A01,507293,Pappas; Elizabeth,30,0,30,0
1713520354898,EDS 139,A00,507294,Fargason; Sharon Gayle,30,0,30,0
1713520354898,EDS 139,B00,507313,Pappas; Elizabeth,30,0,30,0
1713520355926,EDS 201,A00,507315,Staff,18,0,30,12
1713520356954,EDS 203,A01,507317,Halter; Christopher P.,17,0,30,13
1713520357979,EDS 204R,A01,507319,Halter; Christopher P.,0,1,30,30
1713520357979,EDS 204R,B01,507331,Heinzman; Erica M.,22,0,30,8
1713520359008,EDS 206R,A00,507332,Staff,0,2,30,30
1713520359008,EDS 206R,B00,507343,Staff,23,0,30,7
1713520360034,EDS 250,A00,507344,Hemans; Patricia Ann Benitez,27,0,40,13
1713520361059,EDS 281,A00,507345,Daly; Alan J.,18,0,18,0
1713520362086,EDS 284,A00,507350,Daly; Alan J.,16,0,16,0
1713520363112,EDS 286,A00,507359,Fine; Sarah,18,0,18,0
1713520364138,EDS 289C,A01,507361,Daly; Alan J.,18,0,18,0
1713520365168,EDS 290,A00,507366,Hofstetter; Carolyn,15,0,15,0
1713520366197,LIGM 5A,A00,507421,Fischer-Grunski; Eva K,20,0,20,0
1713520367224,LIGM 5B,A00,507423,Fischer-Grunski; Eva K,20,0,20,0
1713520368252,LIGM 5C,A00,507425,Fischer-Grunski; Eva K,20,0,20,0
1713520369277,LIIT 5AS,A00,507427,Carnelos; Chiara,20,0,20,0
1713520370307,LIIT 5BS,A00,507430,Carnelos; Chiara,20,0,20,0
1713520371334,LIIT 5CS,A00,507432,Carnelos; Chiara,20,0,20,0
1713520372359,LISP 5A,A00,507541,Munoz Sanchez; Alicia,14,0,20,6
1713520373390,LISP 5B,A00,507671,Munoz Sanchez; Alicia,12,0,20,8
1713520374417,LISP 5C,A00,507696,Munoz Sanchez; Alicia,11,0,20,9
1713520375442,MAE 197,001,528363,Boechler; Nicholas Sebastia,9998,0,9999,1
1713520376470,MATH 197,001,523477,Kedlaya; Kiran S.,9999,0,9999,0
1713520376470,MATH 197,002,563811,Zhang; Danna,9998,0,9999,1
1713520377499,MCWP 40R,A00,518780,Staff,13,0,20,7
1713520377499,MCWP 40R,B00,518781,Staff,11,0,20,9
1713520377499,MCWP 40R,C00,518783,Staff,8,0,20,12
1713520378523,MCWP 50R,A00,518791,Staff,7,0,20,13
1713520378523,MCWP 50R,B00,518792,Staff,3,0,20,17
1713520378523,MCWP 50R,C00,518793,Staff,5,0,20,15
1713520378523,MCWP 50R,D00,518794,Staff,0,0,20,20
1713520378523,MCWP 50R,E00,518795,Staff,0,0,20,20
1713520378523,MCWP 50R,F00,518796,Staff,10,0,20,10
1713520378523,MCWP 50R,G00,518797,Staff,10,0,20,10
1713520379552,MMW 12R,A01,514034,Herbst; Matthew,1,0,16,15
1713520379552,MMW 12R,A02,514035,Herbst; Matthew,13,0,16,3
1713520380576,MMW 13R,A01,514037,Staff,0,8,16,16
1713520380576,MMW 13R,A02,514039,Staff,0,7,16,16
1713520382630,SIO 295LS,A00,523233,Staff,15,0,30,15
1713520383657,SIO 295S,A00,523232,Staff,15,0,30,15
1713520384684,SOCI 117,A01,494376,Staff,0,2,5,5
1713520385708,WES 237B,A00,494380,Staff,19,0,20,1
1713520387787,AESE 279B,A00,494370,Wade; Jon P,33,0,33,0
1713520388812,AIP 197,001,627712,Vespa; Emanuel Ignacio,9999,0,9999,0
1713520389838,ANAR 135S,A00,494369,Braswell; Geoffrey E.,0,0,0,0
1713520390868,CAT 124RS,A01,519847,Geibel; William,6,0,20,14
1713520391893,CAT 125RS,A01,515971,Geibel; William,6,0,20,14
1713520392919,CLRE 250,A00,511389,Morris; Sheldon,9996,0,9999,3
1713520393947,CLRE 251,A00,507176,Mehta; Ravindra L.,9996,0,9999,3
1713520393947,CLRE 251,B00,511410,Mehta; Ravindra L.,9998,0,9999,1
1713520394976,CLRE 252,A00,507189,Cuomo; Raphael Eduardo,9998,0,9999,1
1713520396001,CLRE 253,A00,507199,Vaida; Florin,9997,0,9999,2
1713520396001,CLRE 253,B00,507202,Vaida; Florin,9999,0,9999,0
1713520397026,CLRE 259,A00,507211,Patel; Hemal,9996,0,9999,3
1713520398056,CLRE 260,A00,507221,Cuomo; Raphael Eduardo,9999,0,9999,0
1713520399084,CLRE 297,001,507242,Cuomo; Raphael Eduardo,9999,0,9999,0
1713520400109,CSE 191,A00,516875,Minnes Kemp; Mor Mia,9999,0,9999,0
1713520401136,CSS 201S,A01,494383,Staff,35,0,35,0
1713520402166,CSS 202S,A01,494387,Staff,35,0,35,0
1713520403192,EAP 100,A00,516065,Staff,9792,0,9999,207
1713520404222,ECE 45,A01,507414,Staff,37,0,60,23
1713520405250,ECE 100,A01,507416,Baghdadchi; Saharnaz,0,0,20,20
1713520405250,ECE 100,A02,507418,Baghdadchi; Saharnaz,19,0,20,1
1713520406276,ECE 111,A01,507420,Staff,27,0,50,23
1713520407301,ECE 197,001,548057,Sievenpiper; Daniel F.,9998,0,9999,1
1713520408330,EDS 115,A00,507243,Choi; Bailey Miyeon,27,0,28,1
1713520409358,EDS 117,A01,494379,Staff,14,0,25,11
1713520410384,EDS 125,A00,507246,Hopkins; Megan Beth,27,0,30,3
1713520411410,EDS 128A,A01,507264,Fargason; Sharon Gayle,26,0,26,0
1713520412436,EDS 128B,A01,507293,Pappas; Elizabeth,30,0,30,0
1713520413462,EDS 139,A00,507294,Fargason; Sharon Gayle,30,0,30,0
1713520413462,EDS 139,B00,507313,Pappas; Elizabeth,30,0,30,0
1713520414485,EDS 201,A00,507315,Staff,18,0,30,12
1713520415511,EDS 203,A01,507317,Halter; Christopher P.,17,0,30,13
1713520416540,EDS 204R,A01,507319,Halter; Christopher P.,0,1,30,30
1713520416540,EDS 204R,B01,507331,Heinzman; Erica M.,22,0,30,8
1713520417564,EDS 206R,A00,507332,Staff,0,2,30,30
1713520417564,EDS 206R,B00,507343,Staff,23,0,30,7
1713520418592,EDS 250,A00,507344,Hemans; Patricia Ann Benitez,27,0,40,13
1713520419619,EDS 281,A00,507345,Daly; Alan J.,18,0,18,0
1713520420644,EDS 284,A00,507350,Daly; Alan J.,16,0,16,0
1713520421670,EDS 286,A00,507359,Fine; Sarah,18,0,18,0
1713520422699,EDS 289C,A01,507361,Daly; Alan J.,18,0,18,0
1713520423725,EDS 290,A00,507366,Hofstetter; Carolyn,15,0,15,0
1713520424751,LIGM 5A,A00,507421,Fischer-Grunski; Eva K,20,0,20,0
1713520425778,LIGM 5B,A00,507423,Fischer-Grunski; Eva K,20,0,20,0
1713520426804,LIGM 5C,A00,507425,Fischer-Grunski; Eva K,20,0,20,0
1713520427829,LIIT 5AS,A00,507427,Carnelos; Chiara,20,0,20,0
1713520428858,LIIT 5BS,A00,507430,Carnelos; Chiara,20,0,20,0
1713520429888,LIIT 5CS,A00,507432,Carnelos; Chiara,20,0,20,0
1713520430917,LISP 5A,A00,507541,Munoz Sanchez; Alicia,14,0,20,6
1713520431943,LISP 5B,A00,507671,Munoz Sanchez; Alicia,12,0,20,8
1713520432973,LISP 5C,A00,507696,Munoz Sanchez; Alicia,11,0,20,9
1713520434000,MAE 197,001,528363,Boechler; Nicholas Sebastia,9998,0,9999,1
1713520435027,MATH 197,001,523477,Kedlaya; Kiran S.,9999,0,9999,0
1713520435027,MATH 197,002,563811,Zhang; Danna,9998,0,9999,1
1713520436057,MCWP 40R,A00,518780,Staff,13,0,20,7
1713520436057,MCWP 40R,B00,518781,Staff,11,0,20,9
1713520436057,MCWP 40R,C00,518783,Staff,8,0,20,12
1713520437084,MCWP 50R,A00,518791,Staff,7,0,20,13
1713520437084,MCWP 50R,B00,518792,Staff,3,0,20,17
1713520437084,MCWP 50R,C00,518793,Staff,5,0,20,15
1713520437084,MCWP 50R,D00,518794,Staff,0,0,20,20
1713520437084,MCWP 50R,E00,518795,Staff,0,0,20,20
1713520437084,MCWP 50R,F00,518796,Staff,10,0,20,10
1713520437084,MCWP 50R,G00,518797,Staff,10,0,20,10
1713520438110,MMW 12R,A01,514034,Herbst; Matthew,1,0,16,15
1713520438110,MMW 12R,A02,514035,Herbst; Matthew,13,0,16,3
1713520439139,MMW 13R,A01,514037,Staff,0,8,16,16
1713520439139,MMW 13R,A02,514039,Staff,0,7,16,16
1713520441196,SIO 295LS,A00,523233,Staff,15,0,30,15
1713520442225,SIO 295S,A00,523232,Staff,15,0,30,15
1713520443252,SOCI 117,A01,494376,Staff,0,2,5,5
1713520444277,WES 237B,A00,494380,Staff,19,0,20,1
1713520446362,AESE 279B,A00,494370,Wade; Jon P,33,0,33,0
1713520447388,AIP 197,001,627712,Vespa; Emanuel Ignacio,9999,0,9999,0
1713520448470,ANAR 135S,A00,494369,Braswell; Geoffrey E.,0,0,0,0
1713520449500,CAT 124RS,A01,519847,Geibel; William,6,0,20,14
1713520450525,CAT 125RS,A01,515971,Geibel; William,6,0,20,14
1713520451556,CLRE 250,A00,511389,Morris; Sheldon,9996,0,9999,3
1713520452581,CLRE 251,A00,507176,Mehta; Ravindra L.,9996,0,9999,3
1713520452581,CLRE 251,B00,511410,Mehta; Ravindra L.,9998,0,9999,1
1713520453606,CLRE 252,A00,507189,Cuomo; Raphael Eduardo,9998,0,9999,1
1713520454633,CLRE 253,A00,507199,Vaida; Florin,9997,0,9999,2
1713520454633,CLRE 253,B00,507202,Vaida; Florin,9999,0,9999,0
1713520455661,CLRE 259,A00,507211,Patel; Hemal,9996,0,9999,3
1713520456687,CLRE 260,A00,507221,Cuomo; Raphael Eduardo,9999,0,9999,0
1713520457716,CLRE 297,001,507242,Cuomo; Raphael Eduardo,9999,0,9999,0
1713520458743,CSE 191,A00,516875,Minnes Kemp; Mor Mia,9999,0,9999,0
1713520459770,CSS 201S,A01,494383,Staff,35,0,35,0
1713520460800,CSS 202S,A01,494387,Staff,35,0,35,0
1713520461825,EAP 100,A00,516065,Staff,9792,0,9999,207
1713520462854,ECE 45,A01,507414,Staff,37,0,60,23
1713520463880,ECE 100,A01,507416,Baghdadchi; Saharnaz,0,0,20,20
1713520463880,ECE 100,A02,507418,Baghdadchi; Saharnaz,19,0,20,1
1713520464908,ECE 111,A01,507420,Staff,27,0,50,23
1713520465935,ECE 197,001,548057,Sievenpiper; Daniel F.,9998,0,9999,1
1713520466961,EDS 115,A00,507243,Choi; Bailey Miyeon,27,0,28,1
1713520467986,EDS 117,A01,494379,Staff,14,0,25,11
1713520469012,EDS 125,A00,507246,Hopkins; Megan Beth,27,0,30,3
1713520470043,EDS 128A,A01,507264,Fargason; Sharon Gayle,26,0,26,0
1713520471070,EDS 128B,A01,507293,Pappas; Elizabeth,30,0,30,0
1713520472099,EDS 139,A00,507294,Fargason; Sharon Gayle,30,0,30,0
1713520472099,EDS 139,B00,507313,Pappas; Elizabeth,30,0,30,0
1713520473128,EDS 201,A00,507315,Staff,18,0,30,12
1713520474159,EDS 203,A01,507317,Halter; Christopher P.,17,0,30,13
1713520475186,EDS 204R,A01,507319,Halter; Christopher P.,0,1,30,30
1713520475186,EDS 204R,B01,507331,Heinzman; Erica M.,22,0,30,8
1713520476223,EDS 206R,A00,507332,Staff,0,2,30,30
1713520476223,EDS 206R,B00,507343,Staff,23,0,30,7
1713520477252,EDS 250,A00,507344,Hemans; Patricia Ann Benitez,27,0,40,13
1713520478276,EDS 281,A00,507345,Daly; Alan J.,18,0,18,0
1713520479302,EDS 284,A00,507350,Daly; Alan J.,16,0,16,0
1713520480327,EDS 286,A00,507359,Fine; Sarah,18,0,18,0
1713520481356,EDS 289C,A01,507361,Daly; Alan J.,18,0,18,0
1713520482385,EDS 290,A00,507366,Hofstetter; Carolyn,15,0,15,0
1713520483416,LIGM 5A,A00,507421,Fischer-Grunski; Eva K,20,0,20,0
1713520484446,LIGM 5B,A00,507423,Fischer-Grunski; Eva K,20,0,20,0
1713520485475,LIGM 5C,A00,507425,Fischer-Grunski; Eva K,20,0,20,0
1713520486499,LIIT 5AS,A00,507427,Carnelos; Chiara,20,0,20,0
1713520487524,LIIT 5BS,A00,507430,Carnelos; Chiara,20,0,20,0
1713520488550,LIIT 5CS,A00,507432,Carnelos; Chiara,20,0,20,0
1713520489576,LISP 5A,A00,507541,Munoz Sanchez; Alicia,14,0,20,6
1713520490600,LISP 5B,A00,507671,Munoz Sanchez; Alicia,12,0,20,8
1713520491627,LISP 5C,A00,507696,Munoz Sanchez; Alicia,11,0,20,9
1713520492651,MAE 197,001,528363,Boechler; Nicholas Sebastia,9998,0,9999,1
1713520493677,MATH 197,001,523477,Kedlaya; Kiran S.,9999,0,9999,0
1713520493677,MATH 197,002,563811,Zhang; Danna,9998,0,9999,1
1713520494703,MCWP 40R,A00,518780,Staff,13,0,20,7
1713520494703,MCWP 40R,B00,518781,Staff,11,0,20,9
1713520494703,MCWP 40R,C00,518783,Staff,8,0,20,12
1713520495735,MCWP 50R,A00,518791,Staff,7,0,20,13
1713520495735,MCWP 50R,B00,518792,Staff,3,0,20,17
1713520495735,MCWP 50R,C00,518793,Staff,5,0,20,15
1713520495735,MCWP 50R,D00,518794,Staff,0,0,20,20
1713520495735,MCWP 50R,E00,518795,Staff,0,0,20,20
1713520495735,MCWP 50R,F00,518796,Staff,10,0,20,10
1713520495735,MCWP 50R,G00,518797,Staff,10,0,20,10
1713520496760,MMW 12R,A01,514034,Herbst; Matthew,1,0,16,15
1713520496760,MMW 12R,A02,514035,Herbst; Matthew,13,0,16,3
1713520497789,MMW 13R,A01,514037,Staff,0,8,16,16
1713520497789,MMW 13R,A02,514039,Staff,0,7,16,16
1713520499840,SIO 295LS,A00,523233,Staff,15,0,30,15
1713520500865,SIO 295S,A00,523232,Staff,15,0,30,15
1713520501894,SOCI 117,A01,494376,Staff,0,2,5,5
1713520502921,WES 237B,A00,494380,Staff,19,0,20,1
1713520504993,AESE 279B,A00,494370,Wade; Jon P,33,0,33,0
1713520506019,AIP 197,001,627712,Vespa; Emanuel Ignacio,9999,0,9999,0
1713520507046,ANAR 135S,A00,494369,Braswell; Geoffrey E.,0,0,0,0
1713520508072,CAT 124RS,A01,519847,Geibel; William,6,0,20,14
1713520509099,CAT 125RS,A01,515971,Geibel; William,6,0,20,14
1713520510126,CLRE 250,A00,511389,Morris; Sheldon,9996,0,9999,3
1713520511158,CLRE 251,A00,507176,Mehta; Ravindra L.,9996,0,9999,3
1713520511158,CLRE 251,B00,511410,Mehta; Ravindra L.,9998,0,9999,1
1713520512188,CLRE 252,A00,507189,Cuomo; Raphael Eduardo,9998,0,9999,1
1713520513218,CLRE 253,A00,507199,Vaida; Florin,9997,0,9999,2
1713520513218,CLRE 253,B00,507202,Vaida; Florin,9999,0,9999,0
1713520514247,CLRE 259,A00,507211,Patel; Hemal,9996,0,9999,3
1713520515273,CLRE 260,A00,507221,Cuomo; Raphael Eduardo,9999,0,9999,0
1713520516298,CLRE 297,001,507242,Cuomo; Raphael Eduardo,9999,0,9999,0
1713520517328,CSE 191,A00,516875,Minnes Kemp; Mor Mia,9999,0,9999,0
1713520518358,CSS 201S,A01,494383,Staff,35,0,35,0
1713520519383,CSS 202S,A01,494387,Staff,35,0,35,0
1713520520412,EAP 100,A00,516065,Staff,9792,0,9999,207
1713520521438,ECE 45,A01,507414,Staff,37,0,60,23
1713520522463,ECE 100,A01,507416,Baghdadchi; Saharnaz,0,0,20,20
1713520522463,ECE 100,A02,507418,Baghdadchi; Saharnaz,19,0,20,1
1713520523488,ECE 111,A01,507420,Staff,27,0,50,23
1713520524515,ECE 197,001,548057,Sievenpiper; Daniel F.,9998,0,9999,1
1713520525543,EDS 115,A00,507243,Choi; Bailey Miyeon,27,0,28,1
1713520526573,EDS 117,A01,494379,Staff,14,0,25,11
1713520527599,EDS 125,A00,507246,Hopkins; Megan Beth,27,0,30,3
1713520528632,EDS 128A,A01,507264,Fargason; Sharon Gayle,26,0,26,0
1713520529658,EDS 128B,A01,507293,Pappas; Elizabeth,30,0,30,0
1713520530683,EDS 139,A00,507294,Fargason; Sharon Gayle,30,0,30,0
1713520530683,EDS 139,B00,507313,Pappas; Elizabeth,30,0,30,0
1713520531711,EDS 201,A00,507315,Staff,18,0,30,12
1713520532739,EDS 203,A01,507317,Halter; Christopher P.,17,0,30,13
1713520533766,EDS 204R,A01,507319,Halter; Christopher P.,0,1,30,30
1713520533766,EDS 204R,B01,507331,Heinzman; Erica M.,22,0,30,8
1713520534793,EDS 206R,A00,507332,Staff,0,2,30,30
1713520534793,EDS 206R,B00,507343,Staff,23,0,30,7
1713520535820,EDS 250,A00,507344,Hemans; Patricia Ann Benitez,27,0,40,13
1713520536849,EDS 281,A00,507345,Daly; Alan J.,18,0,18,0
1713520537875,EDS 284,A00,507350,Daly; Alan J.,16,0,16,0
1713520538901,EDS 286,A00,507359,Fine; Sarah,18,0,18,0
1713520539929,EDS 289C,A01,507361,Daly; Alan J.,18,0,18,0
1713520540955,EDS 290,A00,507366,Hofstetter; Carolyn,15,0,15,0
1713520541988,LIGM 5A,A00,507421,Fischer-Grunski; Eva K,20,0,20,0
1713520543014,LIGM 5B,A00,507423,Fischer-Grunski; Eva K,20,0,20,0
1713520544044,LIGM 5C,A00,507425,Fischer-Grunski; Eva K,20,0,20,0
1713520545076,LIIT 5AS,A00,507427,Carnelos; Chiara,20,0,20,0
1713520546104,LIIT 5BS,A00,507430,Carnelos; Chiara,20,0,20,0
1713520547134,LIIT 5CS,A00,507432,Carnelos; Chiara,20,0,20,0
1713520548160,LISP 5A,A00,507541,Munoz Sanchez; Alicia,14,0,20,6
1713520549186,LISP 5B,A00,507671,Munoz Sanchez; Alicia,12,0,20,8
1713520550217,LISP 5C,A00,507696,Munoz Sanchez; Alicia,11,0,20,9
1713520551250,MAE 197,001,528363,Boechler; Nicholas Sebastia,9998,0,9999,1
1713520552339,MATH 197,001,523477,Kedlaya; Kiran S.,9999,0,9999,0
1713520552339,MATH 197,002,563811,Zhang; Danna,9998,0,9999,1
1713520553366,MCWP 40R,A00,518780,Staff,13,0,20,7
1713520553366,MCWP 40R,B00,518781,Staff,11,0,20,9
1713520553366,MCWP 40R,C00,518783,Staff,8,0,20,12
1713520554397,MCWP 50R,A00,518791,Staff,7,0,20,13
1713520554397,MCWP 50R,B00,518792,Staff,3,0,20,17
1713520554397,MCWP 50R,C00,518793,Staff,5,0,20,15
1713520554397,MCWP 50R,D00,518794,Staff,0,0,20,20
1713520554397,MCWP 50R,E00,518795,Staff,0,0,20,20
1713520554397,MCWP 50R,F00,518796,Staff,10,0,20,10
1713520554397,MCWP 50R,G00,518797,Staff,10,0,20,10
1713520555429,MMW 12R,A01,514034,Herbst; Matthew,1,0,16,15
1713520555429,MMW 12R,A02,514035,Herbst; Matthew,13,0,16,3
1713520556460,MMW 13R,A01,514037,Staff,0,8,16,16
1713520556460,MMW 13R,A02,514039,Staff,0,7,16,16
1713520558519,SIO 295LS,A00,523233,Staff,15,0,30,15
1713520559545,SIO 295S,A00,523232,Staff,15,0,30,15
1713520560573,SOCI 117,A01,494376,Staff,0,2,5,5
1713520561602,WES 237B,A00,494380,Staff,19,0,20,1
1713520563679,AESE 279B,A00,494370,Wade; Jon P,33,0,33,0
1713520564703,AIP 197,001,627712,Vespa; Emanuel Ignacio,9999,0,9999,0
1713520565732,ANAR 135S,A00,494369,Braswell; Geoffrey E.,0,0,0,0
1713520566758,CAT 124RS,A01,519847,Geibel; William,6,0,20,14
1713520567783,CAT 125RS,A01,515971,Geibel; William,6,0,20,14
1713520568812,CLRE 250,A00,511389,Morris; Sheldon,9996,0,9999,3
1713520569847,CLRE 251,A00,507176,Mehta; Ravindra L.,9996,0,9999,3
1713520569847,CLRE 251,B00,511410,Mehta; Ravindra L.,9998,0,9999,1
1713520570877,CLRE 252,A00,507189,Cuomo; Raphael Eduardo,9998,0,9999,1
1713520571904,CLRE 253,A00,507199,Vaida; Florin,9997,0,9999,2
1713520571904,CLRE 253,B00,507202,Vaida; Florin,9999,0,9999,0
1713520572933,CLRE 259,A00,507211,Patel; Hemal,9996,0,9999,3
1713520573963,CLRE 260,A00,507221,Cuomo; Raphael Eduardo,9999,0,9999,0
1713520574988,CLRE 297,001,507242,Cuomo; Raphael Eduardo,9999,0,9999,0
1713520576012,CSE 191,A00,516875,Minnes Kemp; Mor Mia,9999,0,9999,0
1713520577041,CSS 201S,A01,494383,Staff,35,0,35,0
1713520578071,CSS 202S,A01,494387,Staff,35,0,35,0
1713520579099,EAP 100,A00,516065,Staff,9792,0,9999,207
1713520580126,ECE 45,A01,507414,Staff,37,0,60,23
1713520581151,ECE 100,A01,507416,Baghdadchi; Saharnaz,0,0,20,20
1713520581151,ECE 100,A02,507418,Baghdadchi; Saharnaz,19,0,20,1
1713520582176,ECE 111,A01,507420,Staff,27,0,50,23
1713520583202,ECE 197,001,548057,Sievenpiper; Daniel F.,9998,0,9999,1
1713520584228,EDS 115,A00,507243,Choi; Bailey Miyeon,27,0,28,1
1713520585253,EDS 117,A01,494379,Staff,14,0,25,11
1713520586283,EDS 125,A00,507246,Hopkins; Megan Beth,27,0,30,3
1713520587313,EDS 128A,A01,507264,Fargason; Sharon Gayle,26,0,26,0
1713520588339,EDS 128B,A01,507293,Pappas; Elizabeth,30,0,30,0
1713520589368,EDS 139,A00,507294,Fargason; Sharon Gayle,30,0,30,0
1713520589368,EDS 139,B00,507313,Pappas; Elizabeth,30,0,30,0
1713520590396,EDS 201,A00,507315,Staff,18,0,30,12
1713520591426,EDS 203,A01,507317,Halter; Christopher P.,17,0,30,13
1713520592455,EDS 204R,A01,507319,Halter; Christopher P.,0,1,30,30
1713520592455,EDS 204R,B01,507331,Heinzman; Erica M.,22,0,30,8
1713520593483,EDS 206R,A00,507332,Staff,0,2,30,30
1713520593483,EDS 206R,B00,507343,Staff,23,0,30,7
1713520594507,EDS 250,A00,507344,Hemans; Patricia Ann Benitez,27,0,40,13
1713520595532,EDS 281,A00,507345,Daly; Alan J.,18,0,18,0
1713520596557,EDS 284,A00,507350,Daly; Alan J.,16,0,16,0
1713520597582,EDS 286,A00,507359,Fine; Sarah,18,0,18,0
1713520598610,EDS 289C,A01,507361,Daly; Alan J.,18,0,18,0
1713520599636,EDS 290,A00,507366,Hofstetter; Carolyn,15,0,15,0
1713520600670,LIGM 5A,A00,507421,Fischer-Grunski; Eva K,20,0,20,0
1713520601698,LIGM 5B,A00,507423,Fischer-Grunski; Eva K,20,0,20,0
1713520602730,LIGM 5C,A00,507425,Fischer-Grunski; Eva K,20,0,20,0
1713520603756,LIIT 5AS,A00,507427,Carnelos; Chiara,20,0,20,0
1713520604781,LIIT 5BS,A00,507430,Carnelos; Chiara,20,0,20,0
1713520605804,LIIT 5CS,A00,507432,Carnelos; Chiara,20,0,20,0
1713520606837,LISP 5A,A00,507541,Munoz Sanchez; Alicia,14,0,20,6
1713520607862,LISP 5B,A00,507671,Munoz Sanchez; Alicia,12,0,20,8
1713520608891,LISP 5C,A00,507696,Munoz Sanchez; Alicia,11,0,20,9
1713520609918,MAE 197,001,528363,Boechler; Nicholas Sebastia,9998,0,9999,1
1713520610949,MATH 197,001,523477,Kedlaya; Kiran S.,9999,0,9999,0
1713520610949,MATH 197,002,563811,Zhang; Danna,9998,0,9999,1
1713520611979,MCWP 40R,A00,518780,Staff,13,0,20,7
1713520611979,MCWP 40R,B00,518781,Staff,11,0,20,9
1713520611979,MCWP 40R,C00,518783,Staff,8,0,20,12
1713520613005,MCWP 50R,A00,518791,Staff,7,0,20,13
1713520613005,MCWP 50R,B00,518792,Staff,3,0,20,17
1713520613005,MCWP 50R,C00,518793,Staff,5,0,20,15
1713520613005,MCWP 50R,D00,518794,Staff,0,0,20,20
1713520613005,MCWP 50R,E00,518795,Staff,0,0,20,20
1713520613005,MCWP 50R,F00,518796,Staff,10,0,20,10
1713520613005,MCWP 50R,G00,518797,Staff,10,0,20,10
1713520614034,MMW 12R,A01,514034,Herbst; Matthew,1,0,16,15
1713520614034,MMW 12R,A02,514035,Herbst; Matthew,13,0,16,3
1713520615063,MMW 13R,A01,514037,Staff,0,8,16,16
1713520615063,MMW 13R,A02,514039,Staff,0,7,16,16
1713520617118,SIO 295LS,A00,523233,Staff,15,0,30,15
1713520618143,SIO 295S,A00,523232,Staff,15,0,30,15
1713520619174,SOCI 117,A01,494376,Staff,0,2,5,5
1713520620200,WES 237B,A00,494380,Staff,19,0,20,1
1713520622285,AESE 279B,A00,494370,Wade; Jon P,33,0,33,0
1713520623316,AIP 197,001,627712,Vespa; Emanuel Ignacio,9999,0,9999,0
1713520624342,ANAR 135S,A00,494369,Braswell; Geoffrey E.,0,0,0,0
1713520625369,CAT 124RS,A01,519847,Geibel; William,6,0,20,14
1713520626394,CAT 125RS,A01,515971,Geibel; William,6,0,20,14
1713520627420,CLRE 250,A00,511389,Morris; Sheldon,9996,0,9999,3
1713520628445,CLRE 251,A00,507176,Mehta; Ravindra L.,9996,0,9999,3
1713520628445,CLRE 251,B00,511410,Mehta; Ravindra L.,9998,0,9999,1
1713520629468,CLRE 252,A00,507189,Cuomo; Raphael Eduardo,9998,0,9999,1
1713520630498,CLRE 253,A00,507199,Vaida; Florin,9997,0,9999,2
1713520630498,CLRE 253,B00,507202,Vaida; Florin,9999,0,9999,0
1713520631523,CLRE 259,A00,507211,Patel; Hemal,9996,0,9999,3
1713520632549,CLRE 260,A00,507221,Cuomo; Raphael Eduardo,9999,0,9999,0
1713520633577,CLRE 297,001,507242,Cuomo; Raphael Eduardo,9999,0,9999,0
1713520634606,CSE 191,A00,516875,Minnes Kemp; Mor Mia,9999,0,9999,0
1713520635631,CSS 201S,A01,494383,Staff,35,0,35,0
1713520636664,CSS 202S,A01,494387,Staff,35,0,35,0
1713520637689,EAP 100,A00,516065,Staff,9792,0,9999,207
1713520638718,ECE 45,A01,507414,Staff,37,0,60,23
1713520639744,ECE 100,A01,507416,Baghdadchi; Saharnaz,0,0,20,20
1713520639744,ECE 100,A02,507418,Baghdadchi; Saharnaz,19,0,20,1
1713520640770,ECE 111,A01,507420,Staff,27,0,50,23
1713520641796,ECE 197,001,548057,Sievenpiper; Daniel F.,9998,0,9999,1
1713520642823,EDS 115,A00,507243,Choi; Bailey Miyeon,27,0,28,1
1713520643862,EDS 117,A01,494379,Staff,14,0,25,11
1713520644894,EDS 125,A00,507246,Hopkins; Megan Beth,27,0,30,3
1713520645918,EDS 128A,A01,507264,Fargason; Sharon Gayle,26,0,26,0
1713520646943,EDS 128B,A01,507293,Pappas; Elizabeth,30,0,30,0
1713520647973,EDS 139,A00,507294,Fargason; Sharon Gayle,30,0,30,0
1713520647973,EDS 139,B00,507313,Pappas; Elizabeth,30,0,30,0
1713520648999,EDS 201,A00,507315,Staff,18,0,30,12
1713520650029,EDS 203,A01,507317,Halter; Christopher P.,17,0,30,13
1713520651060,EDS 204R,A01,507319,Halter; Christopher P.,0,1,30,30
1713520651060,EDS 204R,B01,507331,Heinzman; Erica M.,22,0,30,8
1713520652088,EDS 206R,A00,507332,Staff,0,2,30,30
1713520652088,EDS 206R,B00,507343,Staff,23,0,30,7
1713520653114,EDS 250,A00,507344,Hemans; Patricia Ann Benitez,27,0,40,13
1713520654142,EDS 281,A00,507345,Daly; Alan J.,18,0,18,0
1713520655169,EDS 284,A00,507350,Daly; Alan J.,16,0,16,0
1713520656254,EDS 286,A00,507359,Fine; Sarah,18,0,18,0
1713520657285,EDS 289C,A01,507361,Daly; Alan J.,18,0,18,0
1713520658314,EDS 290,A00,507366,Hofstetter; Carolyn,15,0,15,0
1713520659345,LIGM 5A,A00,507421,Fischer-Grunski; Eva K,20,0,20,0
1713520660371,LIGM 5B,A00,507423,Fischer-Grunski; Eva K,20,0,20,0
1713520661400,LIGM 5C,A00,507425,Fischer-Grunski; Eva K,20,0,20,0
1713520662426,LIIT 5AS,A00,507427,Carnelos; Chiara,20,0,20,0
1713520663451,LIIT 5BS,A00,507430,Carnelos; Chiara,20,0,20,0
1713520664480,LIIT 5CS,A00,507432,Carnelos; Chiara,20,0,20,0
1713520665504,LISP 5A,A00,507541,Munoz Sanchez; Alicia,14,0,20,6
1713520666530,LISP 5B,A00,507671,Munoz Sanchez; Alicia,12,0,20,8
1713520667554,LISP 5C,A00,507696,Munoz Sanchez; Alicia,11,0,20,9
1713520668579,MAE 197,001,528363,Boechler; Nicholas Sebastia,9998,0,9999,1
1713520669613,MATH 197,001,523477,Kedlaya; Kiran S.,9999,0,9999,0
1713520669613,MATH 197,002,563811,Zhang; Danna,9998,0,9999,1
1713520670640,MCWP 40R,A00,518780,Staff,13,0,20,7
1713520670640,MCWP 40R,B00,518781,Staff,11,0,20,9
1713520670640,MCWP 40R,C00,518783,Staff,8,0,20,12
1713520671672,MCWP 50R,A00,518791,Staff,7,0,20,13
1713520671672,MCWP 50R,B00,518792,Staff,3,0,20,17
1713520671672,MCWP 50R,C00,518793,Staff,5,0,20,15
1713520671672,MCWP 50R,D00,518794,Staff,0,0,20,20
1713520671672,MCWP 50R,E00,518795,Staff,0,0,20,20
1713520671672,MCWP 50R,F00,518796,Staff,10,0,20,10
1713520671672,MCWP 50R,G00,518797,Staff,10,0,20,10
1713520672698,MMW 12R,A01,514034,Herbst; Matthew,1,0,16,15
1713520672698,MMW 12R,A02,514035,Herbst; Matthew,13,0,16,3
1713520673726,MMW 13R,A01,514037,Staff,0,8,16,16
1713520673726,MMW 13R,A02,514039,Staff,0,7,16,16
1713520675782,SIO 295LS,A00,523233,Staff,15,0,30,15
1713520676808,SIO 295S,A00,523232,Staff,15,0,30,15
1713520677834,SOCI 117,A01,494376,Staff,0,2,5,5
1713520678860,WES 237B,A00,494380,Staff,19,0,20,1
1713520680948,AESE 279B,A00,494370,Wade; Jon P,33,0,33,0
1713520681973,AIP 197,001,627712,Vespa; Emanuel Ignacio,9999,0,9999,0
1713520683002,ANAR 135S,A00,494369,Braswell; Geoffrey E.,0,0,0,0
1713520684027,CAT 124RS,A01,519847,Geibel; William,6,0,20,14
1713520685053,CAT 125RS,A01,515971,Geibel; William,6,0,20,14
1713520686079,CLRE 250,A00,511389,Morris; Sheldon,9996,0,9999,3
1713520687106,CLRE 251,A00,507176,Mehta; Ravindra L.,9996,0,9999,3
1713520687106,CLRE 251,B00,511410,Mehta; Ravindra L.,9998,0,9999,1
1713520688133,CLRE 252,A00,507189,Cuomo; Raphael Eduardo,9998,0,9999,1
1713520689165,CLRE 253,A00,507199,Vaida; Florin,9997,0,9999,2
1713520689165,CLRE 253,B00,507202,Vaida; Florin,9999,0,9999,0
1713520690192,CLRE 259,A00,507211,Patel; Hemal,9996,0,9999,3
1713520691218,CLRE 260,A00,507221,Cuomo; Raphael Eduardo,9999,0,9999,0
1713520692246,CLRE 297,001,507242,Cuomo; Raphael Eduardo,9999,0,9999,0
1713520693275,CSE 191,A00,516875,Minnes Kemp; Mor Mia,9999,0,9999,0
1713520694303,CSS 201S,A01,494383,Staff,35,0,35,0
1713520695331,CSS 202S,A01,494387,Staff,35,0,35,0
1713520696357,EAP 100,A00,516065,Staff,9792,0,9999,207
1713520697384,ECE 45,A01,507414,Staff,37,0,60,23
1713520698413,ECE 100,A01,507416,Baghdadchi; Saharnaz,0,0,20,20
1713520698413,ECE 100,A02,507418,Baghdadchi; Saharnaz,19,0,20,1
1713520699439,ECE 111,A01,507420,Staff,27,0,50,23
1713520700470,ECE 197,001,548057,Sievenpiper; Daniel F.,9998,0,9999,1
1713520701497,EDS 115,A00,507243,Choi; Bailey Miyeon,27,0,28,1
1713520702526,EDS 117,A01,494379,Staff,14,0,25,11
1713520703555,EDS 125,A00,507246,Hopkins; Megan Beth,27,0,30,3
1713520704585,EDS 128A,A01,507264,Fargason; Sharon Gayle,26,0,26,0
1713520705611,EDS 128B,A01,507293,Pappas; Elizabeth,30,0,30,0
1713520706635,EDS 139,A00,507294,Fargason; Sharon Gayle,30,0,30,0
1713520706635,EDS 139,B00,507313,Pappas; Elizabeth,30,0,30,0
1713520707664,EDS 201,A00,507315,Staff,18,0,30,12
1713520708693,EDS 203,A01,507317,Halter; Christopher P.,17,0,30,13
1713520709719,EDS 204R,A01,507319,Halter; Christopher P.,0,1,30,30
1713520709719,EDS 204R,B01,507331,Heinzman; Erica M.,22,0,30,8
1713520710745,EDS 206R,A00,507332,Staff,0,2,30,30
1713520710745,EDS 206R,B00,507343,Staff,23,0,30,7
1713520711769,EDS 250,A00,507344,Hemans; Patricia Ann Benitez,27,0,40,13
1713520712796,EDS 281,A00,507345,Daly; Alan J.,18,0,18,0
1713520713824,EDS 284,A00,507350,Daly; Alan J.,16,0,16,0
1713520714851,EDS 286,A00,507359,Fine; Sarah,18,0,18,0
1713520715879,EDS 289C,A01,507361,Daly; Alan J.,18,0,18,0
1713520716905,EDS 290,A00,507366,Hofstetter; Carolyn,15,0,15,0
1713520717937,LIGM 5A,A00,507421,Fischer-Grunski; Eva K,20,0,20,0
1713520718967,LIGM 5B,A00,507423,Fischer-Grunski; Eva K,20,0,20,0
1713520719992,LIGM 5C,A00,507425,Fischer-Grunski; Eva K,20,0,20,0
1713520721018,LIIT 5AS,A00,507427,Carnelos; Chiara,20,0,20,0
1713520722047,LIIT 5BS,A00,507430,Carnelos; Chiara,20,0,20,0
1713520723077,LIIT 5CS,A00,507432,Carnelos; Chiara,20,0,20,0
1713520724107,LISP 5A,A00,507541,Munoz Sanchez; Alicia,14,0,20,6
1713520725137,LISP 5B,A00,507671,Munoz Sanchez; Alicia,12,0,20,8
1713520726167,LISP 5C,A00,507696,Munoz Sanchez; Alicia,11,0,20,9
1713520727193,MAE 197,001,528363,Boechler; Nicholas Sebastia,9998,0,9999,1
1713520728224,MATH 197,001,523477,Kedlaya; Kiran S.,9999,0,9999,0
1713520728224,MATH 197,002,563811,Zhang; Danna,9998,0,9999,1
1713520729254,MCWP 40R,A00,518780,Staff,13,0,20,7
1713520729254,MCWP 40R,B00,518781,Staff,11,0,20,9
1713520729254,MCWP 40R,C00,518783,Staff,8,0,20,12
1713520730281,MCWP 50R,A00,518791,Staff,7,0,20,13
1713520730281,MCWP 50R,B00,518792,Staff,3,0,20,17
1713520730281,MCWP 50R,C00,518793,Staff,5,0,20,15
1713520730281,MCWP 50R,D00,518794,Staff,0,0,20,20
1713520730281,MCWP 50R,E00,518795,Staff,0,0,20,20
1713520730281,MCWP 50R,F00,518796,Staff,10,0,20,10
1713520730281,MCWP 50R,G00,518797,Staff,10,0,20,10
1713520731307,MMW 12R,A01,514034,Herbst; Matthew,1,0,16,15
1713520731307,MMW 12R,A02,514035,Herbst; Matthew,13,0,16,3
1713520732332,MMW 13R,A01,514037,Staff,0,8,16,16
1713520732332,MMW 13R,A02,514039,Staff,0,7,16,16
1713520734386,SIO 295LS,A00,523233,Staff,15,0,30,15
1713520735410,SIO 295S,A00,523232,Staff,15,0,30,15
1713520736439,SOCI 117,A01,494376,Staff,0,2,5,5
1713520737468,WES 237B,A00,494380,Staff,19,0,20,1
1713520739547,AESE 279B,A00,494370,Wade; Jon P,33,0,33,0
1713520740573,AIP 197,001,627712,Vespa; Emanuel Ignacio,9999,0,9999,0
1713520741601,ANAR 135S,A00,494369,Braswell; Geoffrey E.,0,0,0,0
1713520742629,CAT 124RS,A01,519847,Geibel; William,6,0,20,14
1713520743656,CAT 125RS,A01,515971,Geibel; William,6,0,20,14
1713520744682,CLRE 250,A00,511389,Morris; Sheldon,9996,0,9999,3
1713520745714,CLRE 251,A00,507176,Mehta; Ravindra L.,9996,0,9999,3
1713520745714,CLRE 251,B00,511410,Mehta; Ravindra L.,9998,0,9999,1
1713520746741,CLRE 252,A00,507189,Cuomo; Raphael Eduardo,9998,0,9999,1
1713520747771,CLRE 253,A00,507199,Vaida; Florin,9997,0,9999,2
1713520747771,CLRE 253,B00,507202,Vaida; Florin,9999,0,9999,0
1713520748804,CLRE 259,A00,507211,Patel; Hemal,9996,0,9999,3
1713520749831,CLRE 260,A00,507221,Cuomo; Raphael Eduardo,9999,0,9999,0
1713520750859,CLRE 297,001,507242,Cuomo; Raphael Eduardo,9999,0,9999,0
1713520751885,CSE 191,A00,516875,Minnes Kemp; Mor Mia,9999,0,9999,0
1713520752913,CSS 201S,A01,494383,Staff,35,0,35,0
1713520753939,CSS 202S,A01,494387,Staff,35,0,35,0
1713520754967,EAP 100,A00,516065,Staff,9792,0,9999,207
1713520755999,ECE 45,A01,507414,Staff,37,0,60,23
1713520757025,ECE 100,A01,507416,Baghdadchi; Saharnaz,0,0,20,20
1713520757025,ECE 100,A02,507418,Baghdadchi; Saharnaz,19,0,20,1
1713520758055,ECE 111,A01,507420,Staff,27,0,50,23
1713520759081,ECE 197,001,548057,Sievenpiper; Daniel F.,9998,0,9999,1
1713520760164,EDS 115,A00,507243,Choi; Bailey Miyeon,27,0,28,1
1713520761195,EDS 117,A01,494379,Staff,14,0,25,11
1713520762228,EDS 125,A00,507246,Hopkins; Megan Beth,27,0,30,3
1713520763256,EDS 128A,A01,507264,Fargason; Sharon Gayle,26,0,26,0
1713520764283,EDS 128B,A01,507293,Pappas; Elizabeth,30,0,30,0
1713520765307,EDS 139,A00,507294,Fargason; Sharon Gayle,30,0,30,0
1713520765307,EDS 139,B00,507313,Pappas; Elizabeth,30,0,30,0
1713520766335,EDS 201,A00,507315,Staff,18,0,30,12
1713520767360,EDS 203,A01,507317,Halter; Christopher P.,17,0,30,13
1713520768390,EDS 204R,A01,507319,Halter; Christopher P.,0,1,30,30
1713520768390,EDS 204R,B01,507331,Heinzman; Erica M.,22,0,30,8
1713520769418,EDS 206R,A00,507332,Staff,0,2,30,30
1713520769418,EDS 206R,B00,507343,Staff,23,0,30,7
1713520770443,EDS 250,A00,507344,Hemans; Patricia Ann Benitez,27,0,40,13
1713520771471,EDS 281,A00,507345,Daly; Alan J.,18,0,18,0
1713520772499,EDS 284,A00,507350,Daly; Alan J.,16,0,16,0
1713520773525,EDS 286,A00,507359,Fine; Sarah,18,0,18,0
1713520774551,EDS 289C,A01,507361,Daly; Alan J.,18,0,18,0
1713520775580,EDS 290,A00,507366,Hofstetter; Carolyn,15,0,15,0
1713520776606,LIGM 5A,A00,507421,Fischer-Grunski; Eva K,20,0,20,0
1713520777634,LIGM 5B,A00,507423,Fischer-Grunski; Eva K,20,0,20,0
1713520778660,LIGM 5C,A00,507425,Fischer-Grunski; Eva K,20,0,20,0
1713520779687,LIIT 5AS,A00,507427,Carnelos; Chiara,20,0,20,0
1713520780714,LIIT 5BS,A00,507430,Carnelos; Chiara,20,0,20,0
1713520781744,LIIT 5CS,A00,507432,Carnelos; Chiara,20,0,20,0
1713520782771,LISP 5A,A00,507541,Munoz Sanchez; Alicia,14,0,20,6
1713520783804,LISP 5B,A00,507671,Munoz Sanchez; Alicia,12,0,20,8
1713520784831,LISP 5C,A00,507696,Munoz Sanchez; Alicia,11,0,20,9
1713520785858,MAE 197,001,528363,Boechler; Nicholas Sebastia,9998,0,9999,1
1713520786885,MATH 197,001,523477,Kedlaya; Kiran S.,9999,0,9999,0
1713520786885,MATH 197,002,563811,Zhang; Danna,9998,0,9999,1
1713520787915,MCWP 40R,A00,518780,Staff,13,0,20,7
1713520787915,MCWP 40R,B00,518781,Staff,11,0,20,9
1713520787915,MCWP 40R,C00,518783,Staff,8,0,20,12
1713520788946,MCWP 50R,A00,518791,Staff,7,0,20,13
1713520788946,MCWP 50R,B00,518792,Staff,3,0,20,17
1713520788946,MCWP 50R,C00,518793,Staff,5,0,20,15
1713520788946,MCWP 50R,D00,518794,Staff,0,0,20,20
1713520788946,MCWP 50R,E00,518795,Staff,0,0,20,20
1713520788946,MCWP 50R,F00,518796,Staff,10,0,20,10
1713520788946,MCWP 50R,G00,518797,Staff,10,0,20,10
1713520789974,MMW 12R,A01,514034,Herbst; Matthew,1,0,16,15
1713520789974,MMW 12R,A02,514035,Herbst; Matthew,13,0,16,3
1713520791000,MMW 13R,A01,514037,Staff,0,8,16,16
1713520791000,MMW 13R,A02,514039,Staff,0,7,16,16
1713520793057,SIO 295LS,A00,523233,Staff,15,0,30,15
1713520794083,SIO 295S,A00,523232,Staff,15,0,30,15
1713520795110,SOCI 117,A01,494376,Staff,0,2,5,5
1713520796140,WES 237B,A00,494380,Staff,19,0,20,1
1713520798216,AESE 279B,A00,494370,Wade; Jon P,33,0,33,0
1713520799247,AIP 197,001,627712,Vespa; Emanuel Ignacio,9999,0,9999,0
1713520800273,ANAR 135S,A00,494369,Braswell; Geoffrey E.,0,0,0,0
1713520801301,CAT 124RS,A01,519847,Geibel; William,6,0,20,14
1713520802331,CAT 125RS,A01,515971,Geibel; William,6,0,20,14
1713520803356,CLRE 250,A00,511389,Morris; Sheldon,9996,0,9999,3
1713520804382,CLRE 251,A00,507176,Mehta; Ravindra L.,9996,0,9999,3
1713520804382,CLRE 251,B00,511410,Mehta; Ravindra L.,9998,0,9999,1
1713520805407,CLRE 252,A00,507189,Cuomo; Raphael Eduardo,9998,0,9999,1
1713520806437,CLRE 253,A00,507199,Vaida; Florin,9997,0,9999,2
1713520806437,CLRE 253,B00,507202,Vaida; Florin,9999,0,9999,0
1713520807465,CLRE 259,A00,507211,Patel; Hemal,9996,0,9999,3
1713520808490,CLRE 260,A00,507221,Cuomo; Raphael Eduardo,9999,0,9999,0
1713520809518,CLRE 297,001,507242,Cuomo; Raphael Eduardo,9999,0,9999,0
1713520810547,CSE 191,A00,516875,Minnes Kemp; Mor Mia,9999,0,9999,0
1713520811576,CSS 201S,A01,494383,Staff,35,0,35,0
1713520812604,CSS 202S,A01,494387,Staff,35,0,35,0
1713520813629,EAP 100,A00,516065,Staff,9792,0,9999,207
1713520814653,ECE 45,A01,507414,Staff,37,0,60,23
1713520815678,ECE 100,A01,507416,Baghdadchi; Saharnaz,0,0,20,20
1713520815678,ECE 100,A02,507418,Baghdadchi; Saharnaz,19,0,20,1
1713520816703,ECE 111,A01,507420,Staff,27,0,50,23
1713520817729,ECE 197,001,548057,Sievenpiper; Daniel F.,9998,0,9999,1
1713520818754,EDS 115,A00,507243,Choi; Bailey Miyeon,27,0,28,1
1713520819784,EDS 117,A01,494379,Staff,14,0,25,11
1713520820810,EDS 125,A00,507246,Hopkins; Megan Beth,27,0,30,3
1713520821836,EDS 128A,A01,507264,Fargason; Sharon Gayle,26,0,26,0
1713520822866,EDS 128B,A01,507293,Pappas; Elizabeth,30,0,30,0
1713520823911,EDS 139,A00,507294,Fargason; Sharon Gayle,30,0,30,0
1713520823911,EDS 139,B00,507313,Pappas; Elizabeth,30,0,30,0
1713520824935,EDS 201,A00,507315,Staff,18,0,30,12
1713520825966,EDS 203,A01,507317,Halter; Christopher P.,17,0,30,13
1713520826991,EDS 204R,A01,507319,Halter; Christopher P.,0,1,30,30
1713520826991,EDS 204R,B01,507331,Heinzman; Erica M.,22,0,30,8
1713520828017,EDS 206R,A00,507332,Staff,0,2,30,30
1713520828017,EDS 206R,B00,507343,Staff,23,0,30,7
1713520829042,EDS 250,A00,507344,Hemans; Patricia Ann Benitez,27,0,40,13
1713520830071,EDS 281,A00,507345,Daly; Alan J.,18,0,18,0
1713520831099,EDS 284,A00,507350,Daly; Alan J.,16,0,16,0
1713520832124,EDS 286,A00,507359,Fine; Sarah,18,0,18,0
1713520833151,EDS 289C,A01,507361,Daly; Alan J.,18,0,18,0
1713520834181,EDS 290,A00,507366,Hofstetter; Carolyn,15,0,15,0
1713520835214,LIGM 5A,A00,507421,Fischer-Grunski; Eva K,20,0,20,0
1713520836239,LIGM 5B,A00,507423,Fischer-Grunski; Eva K,20,0,20,0
1713520837265,LIGM 5C,A00,507425,Fischer-Grunski; Eva K,20,0,20,0
1713520838291,LIIT 5AS,A00,507427,Carnelos; Chiara,20,0,20,0
1713520839316,LIIT 5BS,A00,507430,Carnelos; Chiara,20,0,20,0
1713520840342,LIIT 5CS,A00,507432,Carnelos; Chiara,20,0,20,0
1713520841368,LISP 5A,A00,507541,Munoz Sanchez; Alicia,14,0,20,6
1713520842399,LISP 5B,A00,507671,Munoz Sanchez; Alicia,12,0,20,8
1713520843423,LISP 5C,A00,507696,Munoz Sanchez; Alicia,11,0,20,9
1713520844449,MAE 197,001,528363,Boechler; Nicholas Sebastia,9998,0,9999,1
1713520845475,MATH 197,001,523477,Kedlaya; Kiran S.,9999,0,9999,0
1713520845475,MATH 197,002,563811,Zhang; Danna,9998,0,9999,1
1713520846500,MCWP 40R,A00,518780,Staff,13,0,20,7
1713520846500,MCWP 40R,B00,518781,Staff,11,0,20,9
1713520846500,MCWP 40R,C00,518783,Staff,8,0,20,12
1713520847528,MCWP 50R,A00,518791,Staff,7,0,20,13
1713520847528,MCWP 50R,B00,518792,Staff,3,0,20,17
1713520847528,MCWP 50R,C00,518793,Staff,5,0,20,15
1713520847528,MCWP 50R,D00,518794,Staff,0,0,20,20
1713520847528,MCWP 50R,E00,518795,Staff,0,0,20,20
1713520847528,MCWP 50R,F00,518796,Staff,10,0,20,10
1713520847528,MCWP 50R,G00,518797,Staff,10,0,20,10
1713520848555,MMW 12R,A01,514034,Herbst; Matthew,1,0,16,15
1713520848555,MMW 12R,A02,514035,Herbst; Matthew,13,0,16,3
1713520849579,MMW 13R,A01,514037,Staff,0,8,16,16
1713520849579,MMW 13R,A02,514039,Staff,0,7,16,16
1713520851635,SIO 295LS,A00,523233,Staff,15,0,30,15
1713520852663,SIO 295S,A00,523232,Staff,15,0,30,15
1713520853689,SOCI 117,A01,494376,Staff,0,2,5,5
1713520854716,WES 237B,A00,494380,Staff,19,0,20,1
1713520856794,AESE 279B,A00,494370,Wade; Jon P,33,0,33,0
1713520857824,AIP 197,001,627712,Vespa; Emanuel Ignacio,9999,0,9999,0
1713520858855,ANAR 135S,A00,494369,Braswell; Geoffrey E.,0,0,0,0
1713520859881,CAT 124RS,A01,519847,Geibel; William,6,0,20,14
1713520860907,CAT 125RS,A01,515971,Geibel; William,6,0,20,14
1713520861937,CLRE 250,A00,511389,Morris; Sheldon,9996,0,9999,3
1713520862971,CLRE 251,A00,507176,Mehta; Ravindra L.,9996,0,9999,3
1713520862971,CLRE 251,B00,511410,Mehta; Ravindra L.,9998,0,9999,1
1713520864054,CLRE 252,A00,507189,Cuomo; Raphael Eduardo,9998,0,9999,1
1713520865081,CLRE 253,A00,507199,Vaida; Florin,9997,0,9999,2
1713520865081,CLRE 253,B00,507202,Vaida; Florin,9999,0,9999,0
1713520866106,CLRE 259,A00,507211,Patel; Hemal,9996,0,9999,3
1713520867133,CLRE 260,A00,507221,Cuomo; Raphael Eduardo,9999,0,9999,0
1713520868159,CLRE 297,001,507242,Cuomo; Raphael Eduardo,9999,0,9999,0
1713520869184,CSE 191,A00,516875,Minnes Kemp; Mor Mia,9999,0,9999,0
1713520870209,CSS 201S,A01,494383,Staff,35,0,35,0
1713520871240,CSS 202S,A01,494387,Staff,35,0,35,0
1713520872265,EAP 100,A00,516065,Staff,9792,0,9999,207
1713520873292,ECE 45,A01,507414,Staff,37,0,60,23
1713520874324,ECE 100,A01,507416,Baghdadchi; Saharnaz,0,0,20,20
1713520874324,ECE 100,A02,507418,Baghdadchi; Saharnaz,19,0,20,1
1713520875354,ECE 111,A01,507420,Staff,27,0,50,23
1713520876381,ECE 197,001,548057,Sievenpiper; Daniel F.,9998,0,9999,1
1713520877408,EDS 115,A00,507243,Choi; Bailey Miyeon,27,0,28,1
1713520878435,EDS 117,A01,494379,Staff,14,0,25,11
1713520879460,EDS 125,A00,507246,Hopkins; Megan Beth,27,0,30,3
1713520880487,EDS 128A,A01,507264,Fargason; Sharon Gayle,26,0,26,0
1713520881513,EDS 128B,A01,507293,Pappas; Elizabeth,30,0,30,0
1713520882538,EDS 139,A00,507294,Fargason; Sharon Gayle,30,0,30,0
1713520882538,EDS 139,B00,507313,Pappas; Elizabeth,30,0,30,0
1713520883563,EDS 201,A00,507315,Staff,18,0,30,12
1713520884589,EDS 203,A01,507317,Halter; Christopher P.,17,0,30,13
1713520885615,EDS 204R,A01,507319,Halter; Christopher P.,0,1,30,30
1713520885615,EDS 204R,B01,507331,Heinzman; Erica M.,22,0,30,8
1713520886639,EDS 206R,A00,507332,Staff,0,2,30,30
1713520886639,EDS 206R,B00,507343,Staff,23,0,30,7
1713520887667,EDS 250,A00,507344,Hemans; Patricia Ann Benitez,27,0,40,13
1713520888696,EDS 281,A00,507345,Daly; Alan J.,18,0,18,0
1713520889722,EDS 284,A00,507350,Daly; Alan J.,16,0,16,0
1713520890748,EDS 286,A00,507359,Fine; Sarah,18,0,18,0
1713520891773,EDS 289C,A01,507361,Daly; Alan J.,18,0,18,0
1713520892803,EDS 290,A00,507366,Hofstetter; Carolyn,15,0,15,0
1713520893835,LIGM 5A,A00,507421,Fischer-Grunski; Eva K,20,0,20,0
1713520894865,LIGM 5B,A00,507423,Fischer-Grunski; Eva K,20,0,20,0
1713520895889,LIGM 5C,A00,507425,Fischer-Grunski; Eva K,20,0,20,0
1713520896915,LIIT 5AS,A00,507427,Carnelos; Chiara,20,0,20,0
1713520897940,LIIT 5BS,A00,507430,Carnelos; Chiara,20,0,20,0
1713520898971,LIIT 5CS,A00,507432,Carnelos; Chiara,20,0,20,0
1713520899997,LISP 5A,A00,507541,Munoz Sanchez; Alicia,14,0,20,6
1713520901020,LISP 5B,A00,507671,Munoz Sanchez; Alicia,12,0,20,8
1713520902052,LISP 5C,A00,507696,Munoz Sanchez; Alicia,11,0,20,9
1713520903082,MAE 197,001,528363,Boechler; Nicholas Sebastia,9998,0,9999,1
1713520904109,MATH 197,001,523477,Kedlaya; Kiran S.,9999,0,9999,0
1713520904109,MATH 197,002,563811,Zhang; Danna,9998,0,9999,1
1713520905134,MCWP 40R,A00,518780,Staff,13,0,20,7
1713520905134,MCWP 40R,B00,518781,Staff,11,0,20,9
1713520905134,MCWP 40R,C00,518783,Staff,8,0,20,12
1713520906162,MCWP 50R,A00,518791,Staff,7,0,20,13
1713520906162,MCWP 50R,B00,518792,Staff,3,0,20,17
1713520906162,MCWP 50R,C00,518793,Staff,5,0,20,15
1713520906162,MCWP 50R,D00,518794,Staff,0,0,20,20
1713520906162,MCWP 50R,E00,518795,Staff,0,0,20,20
1713520906162,MCWP 50R,F00,518796,Staff,10,0,20,10
1713520906162,MCWP 50R,G00,518797,Staff,10,0,20,10
1713520907188,MMW 12R,A01,514034,Herbst; Matthew,1,0,16,15
1713520907188,MMW 12R,A02,514035,Herbst; Matthew,13,0,16,3
1713520908213,MMW 13R,A01,514037,Staff,0,8,16,16
1713520908213,MMW 13R,A02,514039,Staff,0,7,16,16
1713520910274,SIO 295LS,A00,523233,Staff,15,0,30,15
1713520911303,SIO 295S,A00,523232,Staff,15,0,30,15
1713520912328,SOCI 117,A01,494376,Staff,0,2,5,5
1713520913360,WES 237B,A00,494380,Staff,19,0,20,1
1713520915431,AESE 279B,A00,494370,Wade; Jon P,33,0,33,0
1713520916457,AIP 197,001,627712,Vespa; Emanuel Ignacio,9999,0,9999,0
1713520917484,ANAR 135S,A00,494369,Braswell; Geoffrey E.,0,0,0,0
1713520918515,CAT 124RS,A01,519847,Geibel; William,6,0,20,14
1713520919545,CAT 125RS,A01,515971,Geibel; William,6,0,20,14
1713520920581,CLRE 250,A00,511389,Morris; Sheldon,9996,0,9999,3
1713520921613,CLRE 251,A00,507176,Mehta; Ravindra L.,9996,0,9999,3
1713520921613,CLRE 251,B00,511410,Mehta; Ravindra L.,9998,0,9999,1
1713520922644,CLRE 252,A00,507189,Cuomo; Raphael Eduardo,9998,0,9999,1
1713520923671,CLRE 253,A00,507199,Vaida; Florin,9997,0,9999,2
1713520923671,CLRE 253,B00,507202,Vaida; Florin,9999,0,9999,0
1713520924698,CLRE 259,A00,507211,Patel; Hemal,9996,0,9999,3
1713520925724,CLRE 260,A00,507221,Cuomo; Raphael Eduardo,9999,0,9999,0
1713520926753,CLRE 297,001,507242,Cuomo; Raphael Eduardo,9999,0,9999,0
1713520927779,CSE 191,A00,516875,Minnes Kemp; Mor Mia,9999,0,9999,0
1713520928804,CSS 201S,A01,494383,Staff,35,0,35,0
1713520929831,CSS 202S,A01,494387,Staff,35,0,35,0
1713520930862,EAP 100,A00,516065,Staff,9792,0,9999,207
1713520931888,ECE 45,A01,507414,Staff,37,0,60,23
1713520932918,ECE 100,A01,507416,Baghdadchi; Saharnaz,0,0,20,20
1713520932918,ECE 100,A02,507418,Baghdadchi; Saharnaz,19,0,20,1
1713520933948,ECE 111,A01,507420,Staff,27,0,50,23
1713520934975,ECE 197,001,548057,Sievenpiper; Daniel F.,9998,0,9999,1
1713520936002,EDS 115,A00,507243,Choi; Bailey Miyeon,27,0,28,1
1713520937028,EDS 117,A01,494379,Staff,14,0,25,11
1713520938055,EDS 125,A00,507246,Hopkins; Megan Beth,27,0,30,3
1713520939081,EDS 128A,A01,507264,Fargason; Sharon Gayle,26,0,26,0
1713520940111,EDS 128B,A01,507293,Pappas; Elizabeth,30,0,30,0
1713520941136,EDS 139,A00,507294,Fargason; Sharon Gayle,30,0,30,0
1713520941136,EDS 139,B00,507313,Pappas; Elizabeth,30,0,30,0
1713520942164,EDS 201,A00,507315,Staff,18,0,30,12
1713520943195,EDS 203,A01,507317,Halter; Christopher P.,17,0,30,13
1713520944221,EDS 204R,A01,507319,Halter; Christopher P.,0,1,30,30
1713520944221,EDS 204R,B01,507331,Heinzman; Erica M.,22,0,30,8
1713520945249,EDS 206R,A00,507332,Staff,0,2,30,30
1713520945249,EDS 206R,B00,507343,Staff,23,0,30,7
1713520946279,EDS 250,A00,507344,Hemans; Patricia Ann Benitez,27,0,40,13
1713520947304,EDS 281,A00,507345,Daly; Alan J.,18,0,18,0
1713520948333,EDS 284,A00,507350,Daly; Alan J.,16,0,16,0
1713520949363,EDS 286,A00,507359,Fine; Sarah,18,0,18,0
1713520950389,EDS 289C,A01,507361,Daly; Alan J.,18,0,18,0
1713520951415,EDS 290,A00,507366,Hofstetter; Carolyn,15,0,15,0
1713520952445,LIGM 5A,A00,507421,Fischer-Grunski; Eva K,20,0,20,0
1713520953472,LIGM 5B,A00,507423,Fischer-Grunski; Eva K,20,0,20,0
1713520954501,LIGM 5C,A00,507425,Fischer-Grunski; Eva K,20,0,20,0
1713520955532,LIIT 5AS,A00,507427,Carnelos; Chiara,20,0,20,0
1713520956562,LIIT 5BS,A00,507430,Carnelos; Chiara,20,0,20,0
1713520957589,LIIT 5CS,A00,507432,Carnelos; Chiara,20,0,20,0
1713520958618,LISP 5A,A00,507541,Munoz Sanchez; Alicia,14,0,20,6
1713520959644,LISP 5B,A00,507671,Munoz Sanchez; Alicia,12,0,20,8
1713520960669,LISP 5C,A00,507696,Munoz Sanchez; Alicia,11,0,20,9
1713520961694,MAE 197,001,528363,Boechler; Nicholas Sebastia,9998,0,9999,1
1713520962721,MATH 197,001,523477,Kedlaya; Kiran S.,9999,0,9999,0
1713520962721,MATH 197,002,563811,Zhang; Danna,9998,0,9999,1
1713520963748,MCWP 40R,A00,518780,Staff,13,0,20,7
1713520963748,MCWP 40R,B00,518781,Staff,11,0,20,9
1713520963748,MCWP 40R,C00,518783,Staff,8,0,20,12
1713520964774,MCWP 50R,A00,518791,Staff,7,0,20,13
1713520964774,MCWP 50R,B00,518792,Staff,3,0,20,17
1713520964774,MCWP 50R,C00,518793,Staff,5,0,20,15
1713520964774,MCWP 50R,D00,518794,Staff,0,0,20,20
1713520964774,MCWP 50R,E00,518795,Staff,0,0,20,20
1713520964774,MCWP 50R,F00,518796,Staff,10,0,20,10
1713520964774,MCWP 50R,G00,518797,Staff,10,0,20,10
1713520965800,MMW 12R,A01,514034,Herbst; Matthew,1,0,16,15
1713520965800,MMW 12R,A02,514035,Herbst; Matthew,13,0,16,3
1713520966829,MMW 13R,A01,514037,Staff,0,8,16,16
1713520966829,MMW 13R,A02,514039,Staff,0,7,16,16
1713520968939,SIO 295LS,A00,523233,Staff,15,0,30,15
1713520969982,SIO 295S,A00,523232,Staff,15,0,30,15
1713520971012,SOCI 117,A01,494376,Staff,0,2,5,5
1713520972038,WES 237B,A00,494380,Staff,19,0,20,1
1713520974115,AESE 279B,A00,494370,Wade; Jon P,33,0,33,0
1713520975142,AIP 197,001,627712,Vespa; Emanuel Ignacio,9999,0,9999,0
1713520976168,ANAR 135S,A00,494369,Braswell; Geoffrey E.,0,0,0,0
1713520977195,CAT 124RS,A01,519847,Geibel; William,6,0,20,14
1713520978222,CAT 125RS,A01,515971,Geibel; William,6,0,20,14
1713520979247,CLRE 250,A00,511389,Morris; Sheldon,9996,0,9999,3
1713520980276,CLRE 251,A00,507176,Mehta; Ravindra L.,9996,0,9999,3
1713520980276,CLRE 251,B00,511410,Mehta; Ravindra L.,9998,0,9999,1
1713520981302,CLRE 252,A00,507189,Cuomo; Raphael Eduardo,9998,0,9999,1
1713520982334,CLRE 253,A00,507199,Vaida; Florin,9997,0,9999,2
1713520982334,CLRE 253,B00,507202,Vaida; Florin,9999,0,9999,0
1713520983359,CLRE 259,A00,507211,Patel; Hemal,9996,0,9999,3
1713520984385,CLRE 260,A00,507221,Cuomo; Raphael Eduardo,9999,0,9999,0
1713520985414,CLRE 297,001,507242,Cuomo; Raphael Eduardo,9999,0,9999,0
1713520986439,CSE 191,A00,516875,Minnes Kemp; Mor Mia,9999,0,9999,0
1713520987463,CSS 201S,A01,494383,Staff,35,0,35,0
1713520988492,CSS 202S,A01,494387,Staff,35,0,35,0
1713520989520,EAP 100,A00,516065,Staff,9792,0,9999,207
1713520990547,ECE 45,A01,507414,Staff,37,0,60,23
1713520991578,ECE 100,A01,507416,Baghdadchi; Saharnaz,0,0,20,20
1713520991578,ECE 100,A02,507418,Baghdadchi; Saharnaz,19,0,20,1
1713520992607,ECE 111,A01,507420,Staff,27,0,50,23
1713520993637,ECE 197,001,548057,Sievenpiper; Daniel F.,9998,0,9999,1
1713520994663,EDS 115,A00,507243,Choi; Bailey Miyeon,27,0,28,1
1713520995687,EDS 117,A01,494379,Staff,14,0,25,11
1713520996712,EDS 125,A00,507246,Hopkins; Megan Beth,27,0,30,3
1713520997739,EDS 128A,A01,507264,Fargason; Sharon Gayle,26,0,26,0
1713520998771,EDS 128B,A01,507293,Pappas; Elizabeth,30,0,30,0
1713520999797,EDS 139,A00,507294,Fargason; Sharon Gayle,30,0,30,0
1713520999797,EDS 139,B00,507313,Pappas; Elizabeth,30,0,30,0
1713521000823,EDS 201,A00,507315,Staff,18,0,30,12
1713521001849,EDS 203,A01,507317,Halter; Christopher P.,17,0,30,13
1713521002881,EDS 204R,A01,507319,Halter; Christopher P.,0,1,30,30
1713521002881,EDS 204R,B01,507331,Heinzman; Erica M.,22,0,30,8
1713521003907,EDS 206R,A00,507332,Staff,0,2,30,30
1713521003907,EDS 206R,B00,507343,Staff,23,0,30,7
1713521004935,EDS 250,A00,507344,Hemans; Patricia Ann Benitez,27,0,40,13
1713521005960,EDS 281,A00,507345,Daly; Alan J.,18,0,18,0
1713521006986,EDS 284,A00,507350,Daly; Alan J.,16,0,16,0
1713521008012,EDS 286,A00,507359,Fine; Sarah,18,0,18,0
1713521009037,EDS 289C,A01,507361,Daly; Alan J.,18,0,18,0
1713521010065,EDS 290,A00,507366,Hofstetter; Carolyn,15,0,15,0
1713521011093,LIGM 5A,A00,507421,Fischer-Grunski; Eva K,20,0,20,0
1713521012118,LIGM 5B,A00,507423,Fischer-Grunski; Eva K,20,0,20,0
1713521013148,LIGM 5C,A00,507425,Fischer-Grunski; Eva K,20,0,20,0
1713521014174,LIIT 5AS,A00,507427,Carnelos; Chiara,20,0,20,0
1713521015204,LIIT 5BS,A00,507430,Carnelos; Chiara,20,0,20,0
1713521016230,LIIT 5CS,A00,507432,Carnelos; Chiara,20,0,20,0
1713521017257,LISP 5A,A00,507541,Munoz Sanchez; Alicia,14,0,20,6
1713521018288,LISP 5B,A00,507671,Munoz Sanchez; Alicia,12,0,20,8
1713521019317,LISP 5C,A00,507696,Munoz Sanchez; Alicia,11,0,20,9
1713521020342,MAE 197,001,528363,Boechler; Nicholas Sebastia,9998,0,9999,1
1713521021371,MATH 197,001,523477,Kedlaya; Kiran S.,9999,0,9999,0
1713521021371,MATH 197,002,563811,Zhang; Danna,9998,0,9999,1
1713521022402,MCWP 40R,A00,518780,Staff,13,0,20,7
1713521022402,MCWP 40R,B00,518781,Staff,11,0,20,9
1713521022402,MCWP 40R,C00,518783,Staff,8,0,20,12
1713521023431,MCWP 50R,A00,518791,Staff,7,0,20,13
1713521023431,MCWP 50R,B00,518792,Staff,3,0,20,17
1713521023431,MCWP 50R,C00,518793,Staff,5,0,20,15
1713521023431,MCWP 50R,D00,518794,Staff,0,0,20,20
1713521023431,MCWP 50R,E00,518795,Staff,0,0,20,20
1713521023431,MCWP 50R,F00,518796,Staff,10,0,20,10
1713521023431,MCWP 50R,G00,518797,Staff,10,0,20,10
1713521024458,MMW 12R,A01,514034,Herbst; Matthew,1,0,16,15
1713521024458,MMW 12R,A02,514035,Herbst; Matthew,13,0,16,3
1713521025485,MMW 13R,A01,514037,Staff,0,8,16,16
1713521025485,MMW 13R,A02,514039,Staff,0,7,16,16
1713521027545,SIO 295LS,A00,523233,Staff,15,0,30,15
1713521028569,SIO 295S,A00,523232,Staff,15,0,30,15
1713521029595,SOCI 117,A01,494376,Staff,0,2,5,5
1713521030640,WES 237B,A00,494380,Staff,19,0,20,1
1713521032729,AESE 279B,A00,494370,Wade; Jon P,33,0,33,0
1713521033757,AIP 197,001,627712,Vespa; Emanuel Ignacio,9999,0,9999,0
1713521034783,ANAR 135S,A00,494369,Braswell; Geoffrey E.,0,0,0,0
1713521035813,CAT 124RS,A01,519847,Geibel; William,6,0,20,14
1713521036838,CAT 125RS,A01,515971,Geibel; William,6,0,20,14
1713521037865,CLRE 250,A00,511389,Morris; Sheldon,9996,0,9999,3
1713521038897,CLRE 251,A00,507176,Mehta; Ravindra L.,9996,0,9999,3
1713521038897,CLRE 251,B00,511410,Mehta; Ravindra L.,9998,0,9999,1
1713521039924,CLRE 252,A00,507189,Cuomo; Raphael Eduardo,9998,0,9999,1
1713521040951,CLRE 253,A00,507199,Vaida; Florin,9997,0,9999,2
1713521040951,CLRE 253,B00,507202,Vaida; Florin,9999,0,9999,0
1713521041981,CLRE 259,A00,507211,Patel; Hemal,9996,0,9999,3
1713521043006,CLRE 260,A00,507221,Cuomo; Raphael Eduardo,9999,0,9999,0
1713521044030,CLRE 297,001,507242,Cuomo; Raphael Eduardo,9999,0,9999,0
1713521045055,CSE 191,A00,516875,Minnes Kemp; Mor Mia,9999,0,9999,0
1713521046083,CSS 201S,A01,494383,Staff,35,0,35,0
1713521047112,CSS 202S,A01,494387,Staff,35,0,35,0
1713521048138,EAP 100,A00,516065,Staff,9792,0,9999,207
1713521049164,ECE 45,A01,507414,Staff,37,0,60,23
1713521050195,ECE 100,A01,507416,Baghdadchi; Saharnaz,0,0,20,20
1713521050195,ECE 100,A02,507418,Baghdadchi; Saharnaz,19,0,20,1
1713521051223,ECE 111,A01,507420,Staff,27,0,50,23
1713521052252,ECE 197,001,548057,Sievenpiper; Daniel F.,9998,0,9999,1
1713521053281,EDS 115,A00,507243,Choi; Bailey Miyeon,27,0,28,1
1713521054311,EDS 117,A01,494379,Staff,14,0,25,11
1713521055342,EDS 125,A00,507246,Hopkins; Megan Beth,27,0,30,3
1713521056369,EDS 128A,A01,507264,Fargason; Sharon Gayle,26,0,26,0
1713521057399,EDS 128B,A01,507293,Pappas; Elizabeth,30,0,30,0
1713521058423,EDS 139,A00,507294,Fargason; Sharon Gayle,30,0,30,0
1713521058423,EDS 139,B00,507313,Pappas; Elizabeth,30,0,30,0
1713521059447,EDS 201,A00,507315,Staff,18,0,30,12
1713521060479,EDS 203,A01,507317,Halter; Christopher P.,17,0,30,13
1713521061505,EDS 204R,A01,507319,Halter; Christopher P.,0,1,30,30
1713521061505,EDS 204R,B01,507331,Heinzman; Erica M.,22,0,30,8
1713521062531,EDS 206R,A00,507332,Staff,0,2,30,30
1713521062531,EDS 206R,B00,507343,Staff,23,0,30,7
1713521063560,EDS 250,A00,507344,Hemans; Patricia Ann Benitez,27,0,40,13
1713521064585,EDS 281,A00,507345,Daly; Alan J.,18,0,18,0
1713521065614,EDS 284,A00,507350,Daly; Alan J.,16,0,16,0
1713521066639,EDS 286,A00,507359,Fine; Sarah,18,0,18,0
1713521067664,EDS 289C,A01,507361,Daly; Alan J.,18,0,18,0
1713521068693,EDS 290,A00,507366,Hofstetter; Carolyn,15,0,15,0
1713521069727,LIGM 5A,A00,507421,Fischer-Grunski; Eva K,20,0,20,0
1713521070756,LIGM 5B,A00,507423,Fischer-Grunski; Eva K,20,0,20,0
1713521071838,LIGM 5C,A00,507425,Fischer-Grunski; Eva K,20,0,20,0
1713521072864,LIIT 5AS,A00,507427,Carnelos; Chiara,20,0,20,0
1713521073893,LIIT 5BS,A00,507430,Carnelos; Chiara,20,0,20,0
1713521074919,LIIT 5CS,A00,507432,Carnelos; Chiara,20,0,20,0
1713521075946,LISP 5A,A00,507541,Munoz Sanchez; Alicia,14,0,20,6
1713521076974,LISP 5B,A00,507671,Munoz Sanchez; Alicia,12,0,20,8
1713521077999,LISP 5C,A00,507696,Munoz Sanchez; Alicia,11,0,20,9
1713521079029,MAE 197,001,528363,Boechler; Nicholas Sebastia,9998,0,9999,1
1713521080054,MATH 197,001,523477,Kedlaya; Kiran S.,9999,0,9999,0
1713521080054,MATH 197,002,563811,Zhang; Danna,9998,0,9999,1
1713521081079,MCWP 40R,A00,518780,Staff,13,0,20,7
1713521081079,MCWP 40R,B00,518781,Staff,11,0,20,9
1713521081079,MCWP 40R,C00,518783,Staff,8,0,20,12
1713521082104,MCWP 50R,A00,518791,Staff,7,0,20,13
1713521082104,MCWP 50R,B00,518792,Staff,3,0,20,17
1713521082104,MCWP 50R,C00,518793,Staff,5,0,20,15
1713521082104,MCWP 50R,D00,518794,Staff,0,0,20,20
1713521082104,MCWP 50R,E00,518795,Staff,0,0,20,20
1713521082104,MCWP 50R,F00,518796,Staff,10,0,20,10
1713521082104,MCWP 50R,G00,518797,Staff,10,0,20,10
1713521083136,MMW 12R,A01,514034,Herbst; Matthew,1,0,16,15
1713521083136,MMW 12R,A02,514035,Herbst; Matthew,13,0,16,3
1713521084162,MMW 13R,A01,514037,Staff,0,8,16,16
1713521084162,MMW 13R,A02,514039,Staff,0,7,16,16
1713521086231,SIO 295LS,A00,523233,Staff,15,0,30,15
1713521087260,SIO 295S,A00,523232,Staff,15,0,30,15
1713521088285,SOCI 117,A01,494376,Staff,0,2,5,5
1713521089310,WES 237B,A00,494380,Staff,19,0,20,1
1713521091392,AESE 279B,A00,494370,Wade; Jon P,33,0,33,0
1713521092419,AIP 197,001,627712,Vespa; Emanuel Ignacio,9999,0,9999,0
1713521093444,ANAR 135S,A00,494369,Braswell; Geoffrey E.,0,0,0,0
1713521094471,CAT 124RS,A01,519847,Geibel; William,6,0,20,14
1713521095497,CAT 125RS,A01,515971,Geibel; William,6,0,20,14
1713521096527,CLRE 250,A00,511389,Morris; Sheldon,9996,0,9999,3
1713521097556,CLRE 251,A00,507176,Mehta; Ravindra L.,9996,0,9999,3
1713521097556,CLRE 251,B00,511410,Mehta; Ravindra L.,9998,0,9999,1
1713521098583,CLRE 252,A00,507189,Cuomo; Raphael Eduardo,9998,0,9999,1
1713521099609,CLRE 253,A00,507199,Vaida; Florin,9997,0,9999,2
1713521099609,CLRE 253,B00,507202,Vaida; Florin,9999,0,9999,0
1713521100635,CLRE 259,A00,507211,Patel; Hemal,9996,0,9999,3
1713521101660,CLRE 260,A00,507221,Cuomo; Raphael Eduardo,9999,0,9999,0
1713521102686,CLRE 297,001,507242,Cuomo; Raphael Eduardo,9999,0,9999,0
1713521103715,CSE 191,A00,516875,Minnes Kemp; Mor Mia,9999,0,9999,0
1713521104756,CSS 201S,A01,494383,Staff,35,0,35,0
1713521105783,CSS 202S,A01,494387,Staff,35,0,35,0
1713521106809,EAP 100,A00,516065,Staff,9792,0,9999,207
1713521107843,ECE 45,A01,507414,Staff,37,0,60,23
1713521108869,ECE 100,A01,507416,Baghdadchi; Saharnaz,0,0,20,20
1713521108869,ECE 100,A02,507418,Baghdadchi; Saharnaz,19,0,20,1
1713521109898,ECE 111,A01,507420,Staff,27,0,50,23
1713521110924,ECE 197,001,548057,Sievenpiper; Daniel F.,9998,0,9999,1
1713521111951,EDS 115,A00,507243,Choi; Bailey Miyeon,27,0,28,1
1713521112986,EDS 117,A01,494379,Staff,14,0,25,11
1713521114015,EDS 125,A00,507246,Hopkins; Megan Beth,27,0,30,3
1713521115042,EDS 128A,A01,507264,Fargason; Sharon Gayle,26,0,26,0
1713521116071,EDS 128B,A01,507293,Pappas; Elizabeth,30,0,30,0
1713521117097,EDS 139,A00,507294,Fargason; Sharon Gayle,30,0,30,0
1713521117097,EDS 139,B00,507313,Pappas; Elizabeth,30,0,30,0
1713521118123,EDS 201,A00,507315,Staff,18,0,30,12
1713521119148,EDS 203,A01,507317,Halter; Christopher P.,17,0,30,13
1713521120174,EDS 204R,A01,507319,Halter; Christopher P.,0,1,30,30
1713521120174,EDS 204R,B01,507331,Heinzman; Erica M.,22,0,30,8
1713521121200,EDS 206R,A00,507332,Staff,0,2,30,30
1713521121200,EDS 206R,B00,507343,Staff,23,0,30,7
1713521122229,EDS 250,A00,507344,Hemans; Patricia Ann Benitez,27,0,40,13
1713521123255,EDS 281,A00,507345,Daly; Alan J.,18,0,18,0
1713521124279,EDS 284,A00,507350,Daly; Alan J.,16,0,16,0
1713521125315,EDS 286,A00,507359,Fine; Sarah,18,0,18,0
1713521126339,EDS 289C,A01,507361,Daly; Alan J.,18,0,18,0
1713521127364,EDS 290,A00,507366,Hofstetter; Carolyn,15,0,15,0
1713521128388,LIGM 5A,A00,507421,Fischer-Grunski; Eva K,20,0,20,0
1713521129412,LIGM 5B,A00,507423,Fischer-Grunski; Eva K,20,0,20,0
1713521130441,LIGM 5C,A00,507425,Fischer-Grunski; Eva K,20,0,20,0
1713521131467,LIIT 5AS,A00,507427,Carnelos; Chiara,20,0,20,0
1713521132497,LIIT 5BS,A00,507430,Carnelos; Chiara,20,0,20,0
1713521133526,LIIT 5CS,A00,507432,Carnelos; Chiara,20,0,20,0
1713521134554,LISP 5A,A00,507541,Munoz Sanchez; Alicia,14,0,20,6
1713521135580,LISP 5B,A00,507671,Munoz Sanchez; Alicia,12,0,20,8
1713521136610,LISP 5C,A00,507696,Munoz Sanchez; Alicia,11,0,20,9
1713521137638,MAE 197,001,528363,Boechler; Nicholas Sebastia,9998,0,9999,1
1713521138667,MATH 197,001,523477,Kedlaya; Kiran S.,9999,0,9999,0
1713521138667,MATH 197,002,563811,Zhang; Danna,9998,0,9999,1
1713521139692,MCWP 40R,A00,518780,Staff,13,0,20,7
1713521139692,MCWP 40R,B00,518781,Staff,11,0,20,9
1713521139692,MCWP 40R,C00,518783,Staff,8,0,20,12
1713521140719,MCWP 50R,A00,518791,Staff,7,0,20,13
1713521140719,MCWP 50R,B00,518792,Staff,3,0,20,17
1713521140719,MCWP 50R,C00,518793,Staff,5,0,20,15
1713521140719,MCWP 50R,D00,518794,Staff,0,0,20,20
1713521140719,MCWP 50R,E00,518795,Staff,0,0,20,20
1713521140719,MCWP 50R,F00,518796,Staff,10,0,20,10
1713521140719,MCWP 50R,G00,518797,Staff,10,0,20,10
1713521141748,MMW 12R,A01,514034,Herbst; Matthew,1,0,16,15
1713521141748,MMW 12R,A02,514035,Herbst; Matthew,13,0,16,3
1713521142773,MMW 13R,A01,514037,Staff,0,8,16,16
1713521142773,MMW 13R,A02,514039,Staff,0,7,16,16
1713521144837,SIO 295LS,A00,523233,Staff,15,0,30,15
1713521145865,SIO 295S,A00,523232,Staff,15,0,30,15
1713521146892,SOCI 117,A01,494376,Staff,0,2,5,5
1713521147919,WES 237B,A00,494380,Staff,19,0,20,1
1713521150003,AESE 279B,A00,494370,Wade; Jon P,33,0,33,0
1713521151030,AIP 197,001,627712,Vespa; Emanuel Ignacio,9999,0,9999,0
1713521152055,ANAR 135S,A00,494369,Braswell; Geoffrey E.,0,0,0,0
1713521153082,CAT 124RS,A01,519847,Geibel; William,6,0,20,14
1713521154107,CAT 125RS,A01,515971,Geibel; William,6,0,20,14
1713521155136,CLRE 250,A00,511389,Morris; Sheldon,9996,0,9999,3
1713521156164,CLRE 251,A00,507176,Mehta; Ravindra L.,9996,0,9999,3
1713521156164,CLRE 251,B00,511410,Mehta; Ravindra L.,9998,0,9999,1
1713521157194,CLRE 252,A00,507189,Cuomo; Raphael Eduardo,9998,0,9999,1
1713521158226,CLRE 253,A00,507199,Vaida; Florin,9997,0,9999,2
1713521158226,CLRE 253,B00,507202,Vaida; Florin,9999,0,9999,0
1713521159252,CLRE 259,A00,507211,Patel; Hemal,9996,0,9999,3
1713521160281,CLRE 260,A00,507221,Cuomo; Raphael Eduardo,9999,0,9999,0
1713521161306,CLRE 297,001,507242,Cuomo; Raphael Eduardo,9999,0,9999,0
1713521162333,CSE 191,A00,516875,Minnes Kemp; Mor Mia,9999,0,9999,0
1713521163388,CSS 201S,A01,494383,Staff,35,0,35,0
1713521164415,CSS 202S,A01,494387,Staff,35,0,35,0
1713521165444,EAP 100,A00,516065,Staff,9792,0,9999,207
1713521166520,ECE 45,A01,507414,Staff,37,0,60,23
1713521167548,ECE 100,A01,507416,Baghdadchi; Saharnaz,0,0,20,20
1713521167548,ECE 100,A02,507418,Baghdadchi; Saharnaz,19,0,20,1
1713521168576,ECE 111,A01,507420,Staff,27,0,50,23
1713521169603,ECE 197,001,548057,Sievenpiper; Daniel F.,9998,0,9999,1
1713521170632,EDS 115,A00,507243,Choi; Bailey Miyeon,27,0,28,1
1713521171658,EDS 117,A01,494379,Staff,14,0,25,11
1713521172683,EDS 125,A00,507246,Hopkins; Megan Beth,27,0,30,3
1713521173709,EDS 128A,A01,507264,Fargason; Sharon Gayle,26,0,26,0
1713521174738,EDS 128B,A01,507293,Pappas; Elizabeth,30,0,30,0
1713521175817,EDS 139,A00,507294,Fargason; Sharon Gayle,30,0,30,0
1713521175817,EDS 139,B00,507313,Pappas; Elizabeth,30,0,30,0
1713521176847,EDS 201,A00,507315,Staff,18,0,30,12
1713521177874,EDS 203,A01,507317,Halter; Christopher P.,17,0,30,13
1713521178900,EDS 204R,A01,507319,Halter; Christopher P.,0,1,30,30
1713521178900,EDS 204R,B01,507331,Heinzman; Erica M.,22,0,30,8
1713521179929,EDS 206R,A00,507332,Staff,0,2,30,30
1713521179929,EDS 206R,B00,507343,Staff,23,0,30,7
1713521180954,EDS 250,A00,507344,Hemans; Patricia Ann Benitez,27,0,40,13
1713521181979,EDS 281,A00,507345,Daly; Alan J.,18,0,18,0
1713521183003,EDS 284,A00,507350,Daly; Alan J.,16,0,16,0
1713521184030,EDS 286,A00,507359,Fine; Sarah,18,0,18,0
1713521185056,EDS 289C,A01,507361,Daly; Alan J.,18,0,18,0
1713521186085,EDS 290,A00,507366,Hofstetter; Carolyn,15,0,15,0
1713521187116,LIGM 5A,A00,507421,Fischer-Grunski; Eva K,20,0,20,0
1713521188144,LIGM 5B,A00,507423,Fischer-Grunski; Eva K,20,0,20,0
1713521189170,LIGM 5C,A00,507425,Fischer-Grunski; Eva K,20,0,20,0
1713521190200,LIIT 5AS,A00,507427,Carnelos; Chiara,20,0,20,0
1713521191224,LIIT 5BS,A00,507430,Carnelos; Chiara,20,0,20,0
1713521192253,LIIT 5CS,A00,507432,Carnelos; Chiara,20,0,20,0
1713521193287,LISP 5A,A00,507541,Munoz Sanchez; Alicia,14,0,20,6
1713521194311,LISP 5B,A00,507671,Munoz Sanchez; Alicia,12,0,20,8
1713521195335,LISP 5C,A00,507696,Munoz Sanchez; Alicia,11,0,20,9
1713521196366,MAE 197,001,528363,Boechler; Nicholas Sebastia,9998,0,9999,1
1713521197391,MATH 197,001,523477,Kedlaya; Kiran S.,9999,0,9999,0
1713521197391,MATH 197,002,563811,Zhang; Danna,9998,0,9999,1
1713521198447,MCWP 40R,A00,518780,Staff,13,0,20,7
1713521198447,MCWP 40R,B00,518781,Staff,11,0,20,9
1713521198447,MCWP 40R,C00,518783,Staff,8,0,20,12
1713521199474,MCWP 50R,A00,518791,Staff,7,0,20,13
1713521199474,MCWP 50R,B00,518792,Staff,3,0,20,17
1713521199474,MCWP 50R,C00,518793,Staff,5,0,20,15
1713521199474,MCWP 50R,D00,518794,Staff,0,0,20,20
1713521199474,MCWP 50R,E00,518795,Staff,0,0,20,20
1713521199474,MCWP 50R,F00,518796,Staff,10,0,20,10
1713521199474,MCWP 50R,G00,518797,Staff,10,0,20,10
1713521200499,MMW 12R,A01,514034,Herbst; Matthew,1,0,16,15
1713521200499,MMW 12R,A02,514035,Herbst; Matthew,13,0,16,3
1713521201530,MMW 13R,A01,514037,Staff,0,8,16,16
1713521201530,MMW 13R,A02,514039,Staff,0,7,16,16
1713521203580,SIO 295LS,A00,523233,Staff,15,0,30,15
1713521204606,SIO 295S,A00,523232,Staff,15,0,30,15
1713521205639,SOCI 117,A01,494376,Staff,0,2,5,5
1713521206672,WES 237B,A00,494380,Staff,19,0,20,1
1713521208748,AESE 279B,A00,494370,Wade; Jon P,33,0,33,0
1713521209773,AIP 197,001,627712,Vespa; Emanuel Ignacio,9999,0,9999,0
1713521210799,ANAR 135S,A00,494369,Braswell; Geoffrey E.,0,0,0,0
1713521211826,CAT 124RS,A01,519847,Geibel; William,6,0,20,14
1713521212852,CAT 125RS,A01,515971,Geibel; William,6,0,20,14
1713521213893,CLRE 250,A00,511389,Morris; Sheldon,9996,0,9999,3
1713521214922,CLRE 251,A00,507176,Mehta; Ravindra L.,9996,0,9999,3
1713521214922,CLRE 251,B00,511410,Mehta; Ravindra L.,9998,0,9999,1
1713521215952,CLRE 252,A00,507189,Cuomo; Raphael Eduardo,9998,0,9999,1
1713521216982,CLRE 253,A00,507199,Vaida; Florin,9997,0,9999,2
1713521216982,CLRE 253,B00,507202,Vaida; Florin,9999,0,9999,0
1713521218007,CLRE 259,A00,507211,Patel; Hemal,9996,0,9999,3
1713521219032,CLRE 260,A00,507221,Cuomo; Raphael Eduardo,9999,0,9999,0
1713521220060,CLRE 297,001,507242,Cuomo; Raphael Eduardo,9999,0,9999,0
1713521221087,CSE 191,A00,516875,Minnes Kemp; Mor Mia,9999,0,9999,0
1713521222117,CSS 201S,A01,494383,Staff,35,0,35,0
1713521223143,CSS 202S,A01,494387,Staff,35,0,35,0
1713521224171,EAP 100,A00,516065,Staff,9792,0,9999,207
1713521225197,ECE 45,A01,507414,Staff,37,0,60,23
1713521226222,ECE 100,A01,507416,Baghdadchi; Saharnaz,0,0,20,20
1713521226222,ECE 100,A02,507418,Baghdadchi; Saharnaz,19,0,20,1
1713521227252,ECE 111,A01,507420,Staff,27,0,50,23
1713521228277,ECE 197,001,548057,Sievenpiper; Daniel F.,9998,0,9999,1
1713521229302,EDS 115,A00,507243,Choi; Bailey Miyeon,27,0,28,1
1713521230332,EDS 117,A01,494379,Staff,14,0,25,11
1713521231361,EDS 125,A00,507246,Hopkins; Megan Beth,27,0,30,3
1713521232393,EDS 128A,A01,507264,Fargason; Sharon Gayle,26,0,26,0
1713521233419,EDS 128B,A01,507293,Pappas; Elizabeth,30,0,30,0
1713521234445,EDS 139,A00,507294,Fargason; Sharon Gayle,30,0,30,0
1713521234445,EDS 139,B00,507313,Pappas; Elizabeth,30,0,30,0
1713521235470,EDS 201,A00,507315,Staff,18,0,30,12
1713521236496,EDS 203,A01,507317,Halter; Christopher P.,17,0,30,13
1713521237528,EDS 204R,A01,507319,Halter; Christopher P.,0,1,30,30
1713521237528,EDS 204R,B01,507331,Heinzman; Erica M.,22,0,30,8
1713521238557,EDS 206R,A00,507332,Staff,0,2,30,30
1713521238557,EDS 206R,B00,507343,Staff,23,0,30,7
1713521239589,EDS 250,A00,507344,Hemans; Patricia Ann Benitez,27,0,40,13
1713521240613,EDS 281,A00,507345,Daly; Alan J.,18,0,18,0
1713521241638,EDS 284,A00,507350,Daly; Alan J.,16,0,16,0
1713521242664,EDS 286,A00,507359,Fine; Sarah,18,0,18,0
1713521243691,EDS 289C,A01,507361,Daly; Alan J.,18,0,18,0
1713521244719,EDS 290,A00,507366,Hofstetter; Carolyn,15,0,15,0
1713521245751,LIGM 5A,A00,507421,Fischer-Grunski; Eva K,20,0,20,0
1713521246779,LIGM 5B,A00,507423,Fischer-Grunski; Eva K,20,0,20,0
1713521247813,LIGM 5C,A00,507425,Fischer-Grunski; Eva K,20,0,20,0
1713521248845,LIIT 5AS,A00,507427,Carnelos; Chiara,20,0,20,0
1713521249873,LIIT 5BS,A00,507430,Carnelos; Chiara,20,0,20,0
1713521250901,LIIT 5CS,A00,507432,Carnelos; Chiara,20,0,20,0
1713521251931,LISP 5A,A00,507541,Munoz Sanchez; Alicia,14,0,20,6
1713521252957,LISP 5B,A00,507671,Munoz Sanchez; Alicia,12,0,20,8
1713521253984,LISP 5C,A00,507696,Munoz Sanchez; Alicia,11,0,20,9
1713521255010,MAE 197,001,528363,Boechler; Nicholas Sebastia,9998,0,9999,1
1713521256038,MATH 197,001,523477,Kedlaya; Kiran S.,9999,0,9999,0
1713521256038,MATH 197,002,563811,Zhang; Danna,9998,0,9999,1
1713521257085,MCWP 40R,A00,518780,Staff,13,0,20,7
1713521257085,MCWP 40R,B00,518781,Staff,11,0,20,9
1713521257085,MCWP 40R,C00,518783,Staff,8,0,20,12
1713521258120,MCWP 50R,A00,518791,Staff,7,0,20,13
1713521258120,MCWP 50R,B00,518792,Staff,3,0,20,17
1713521258120,MCWP 50R,C00,518793,Staff,5,0,20,15
1713521258120,MCWP 50R,D00,518794,Staff,0,0,20,20
1713521258120,MCWP 50R,E00,518795,Staff,0,0,20,20
1713521258120,MCWP 50R,F00,518796,Staff,10,0,20,10
1713521258120,MCWP 50R,G00,518797,Staff,10,0,20,10
1713521259147,MMW 12R,A01,514034,Herbst; Matthew,1,0,16,15
1713521259147,MMW 12R,A02,514035,Herbst; Matthew,13,0,16,3
1713521260173,MMW 13R,A01,514037,Staff,0,8,16,16
1713521260173,MMW 13R,A02,514039,Staff,0,7,16,16
1713521262227,SIO 295LS,A00,523233,Staff,15,0,30,15
1713521263252,SIO 295S,A00,523232,Staff,15,0,30,15
1713521264278,SOCI 117,A01,494376,Staff,0,2,5,5
1713521265304,WES 237B,A00,494380,Staff,19,0,20,1
1713521267383,AESE 279B,A00,494370,Wade; Jon P,33,0,33,0
1713521268410,AIP 197,001,627712,Vespa; Emanuel Ignacio,9999,0,9999,0
1713521269435,ANAR 135S,A00,494369,Braswell; Geoffrey E.,0,0,0,0
1713521270464,CAT 124RS,A01,519847,Geibel; William,6,0,20,14
1713521271491,CAT 125RS,A01,515971,Geibel; William,6,0,20,14
1713521272517,CLRE 250,A00,511389,Morris; Sheldon,9996,0,9999,3
1713521273549,CLRE 251,A00,507176,Mehta; Ravindra L.,9996,0,9999,3
1713521273549,CLRE 251,B00,511410,Mehta; Ravindra L.,9998,0,9999,1
1713521274579,CLRE 252,A00,507189,Cuomo; Raphael Eduardo,9998,0,9999,1
1713521275617,CLRE 253,A00,507199,Vaida; Florin,9997,0,9999,2
1713521275617,CLRE 253,B00,507202,Vaida; Florin,9999,0,9999,0
1713521276642,CLRE 259,A00,507211,Patel; Hemal,9996,0,9999,3
1713521277668,CLRE 260,A00,507221,Cuomo; Raphael Eduardo,9999,0,9999,0
1713521278691,CLRE 297,001,507242,Cuomo; Raphael Eduardo,9999,0,9999,0
1713521279771,CSE 191,A00,516875,Minnes Kemp; Mor Mia,9999,0,9999,0
1713521280797,CSS 201S,A01,494383,Staff,35,0,35,0
1713521281827,CSS 202S,A01,494387,Staff,35,0,35,0
1713521282852,EAP 100,A00,516065,Staff,9792,0,9999,207
1713521283877,ECE 45,A01,507414,Staff,37,0,60,23
1713521284910,ECE 100,A01,507416,Baghdadchi; Saharnaz,0,0,20,20
1713521284910,ECE 100,A02,507418,Baghdadchi; Saharnaz,19,0,20,1
1713521285939,ECE 111,A01,507420,Staff,27,0,50,23
1713521286966,ECE 197,001,548057,Sievenpiper; Daniel F.,9998,0,9999,1
1713521288000,EDS 115,A00,507243,Choi; Bailey Miyeon,27,0,28,1
1713521289030,EDS 117,A01,494379,Staff,14,0,25,11
1713521290062,EDS 125,A00,507246,Hopkins; Megan Beth,27,0,30,3
1713521291091,EDS 128A,A01,507264,Fargason; Sharon Gayle,26,0,26,0
1713521292118,EDS 128B,A01,507293,Pappas; Elizabeth,30,0,30,0
1713521293147,EDS 139,A00,507294,Fargason; Sharon Gayle,30,0,30,0
1713521293147,EDS 139,B00,507313,Pappas; Elizabeth,30,0,30,0
1713521294172,EDS 201,A00,507315,Staff,18,0,30,12
1713521295202,EDS 203,A01,507317,Halter; Christopher P.,17,0,30,13
1713521296231,EDS 204R,A01,507319,Halter; Christopher P.,0,1,30,30
1713521296231,EDS 204R,B01,507331,Heinzman; Erica M.,22,0,30,8
1713521297256,EDS 206R,A00,507332,Staff,0,2,30,30
1713521297256,EDS 206R,B00,507343,Staff,23,0,30,7
1713521298283,EDS 250,A00,507344,Hemans; Patricia Ann Benitez,27,0,40,13
1713521299309,EDS 281,A00,507345,Daly; Alan J.,18,0,18,0
1713521300333,EDS 284,A00,507350,Daly; Alan J.,16,0,16,0
1713521301366,EDS 286,A00,507359,Fine; Sarah,18,0,18,0
1713521302391,EDS 289C,A01,507361,Daly; Alan J.,18,0,18,0
1713521303418,EDS 290,A00,507366,Hofstetter; Carolyn,15,0,15,0
1713521304444,LIGM 5A,A00,507421,Fischer-Grunski; Eva K,20,0,20,0
1713521305469,LIGM 5B,A00,507423,Fischer-Grunski; Eva K,20,0,20,0
1713521306495,LIGM 5C,A00,507425,Fischer-Grunski; Eva K,20,0,20,0
1713521307551,LIIT 5AS,A00,507427,Carnelos; Chiara,20,0,20,0
1713521308577,LIIT 5BS,A00,507430,Carnelos; Chiara,20,0,20,0
1713521309607,LIIT 5CS,A00,507432,Carnelos; Chiara,20,0,20,0
1713521310634,LISP 5A,A00,507541,Munoz Sanchez; Alicia,14,0,20,6
1713521311660,LISP 5B,A00,507671,Munoz Sanchez; Alicia,12,0,20,8
1713521312690,LISP 5C,A00,507696,Munoz Sanchez; Alicia,11,0,20,9
1713521313717,MAE 197,001,528363,Boechler; Nicholas Sebastia,9998,0,9999,1
1713521314743,MATH 197,001,523477,Kedlaya; Kiran S.,9999,0,9999,0
1713521314743,MATH 197,002,563811,Zhang; Danna,9998,0,9999,1
1713521315774,MCWP 40R,A00,518780,Staff,13,0,20,7
1713521315774,MCWP 40R,B00,518781,Staff,11,0,20,9
1713521315774,MCWP 40R,C00,518783,Staff,8,0,20,12
1713521316823,MCWP 50R,A00,518791,Staff,7,0,20,13
1713521316823,MCWP 50R,B00,518792,Staff,3,0,20,17
1713521316823,MCWP 50R,C00,518793,Staff,5,0,20,15
1713521316823,MCWP 50R,D00,518794,Staff,0,0,20,20
1713521316823,MCWP 50R,E00,518795,Staff,0,0,20,20
1713521316823,MCWP 50R,F00,518796,Staff,10,0,20,10
1713521316823,MCWP 50R,G00,518797,Staff,10,0,20,10
1713521317852,MMW 12R,A01,514034,Herbst; Matthew,1,0,16,15
1713521317852,MMW 12R,A02,514035,Herbst; Matthew,13,0,16,3
1713521318881,MMW 13R,A01,514037,Staff,0,8,16,16
1713521318881,MMW 13R,A02,514039,Staff,0,7,16,16
1713521320932,SIO 295LS,A00,523233,Staff,15,0,30,15
1713521321959,SIO 295S,A00,523232,Staff,15,0,30,15
1713521322985,SOCI 117,A01,494376,Staff,0,2,5,5
1713521324012,WES 237B,A00,494380,Staff,19,0,20,1
1713521326095,AESE 279B,A00,494370,Wade; Jon P,33,0,33,0
1713521327125,AIP 197,001,627712,Vespa; Emanuel Ignacio,9999,0,9999,0
1713521328153,ANAR 135S,A00,494369,Braswell; Geoffrey E.,0,0,0,0
1713521329178,CAT 124RS,A01,519847,Geibel; William,6,0,20,14
1713521330202,CAT 125RS,A01,515971,Geibel; William,6,0,20,14
1713521331228,CLRE 250,A00,511389,Morris; Sheldon,9996,0,9999,3
1713521332274,CLRE 251,A00,507176,Mehta; Ravindra L.,9996,0,9999,3
1713521332274,CLRE 251,B00,511410,Mehta; Ravindra L.,9998,0,9999,1
1713521333301,CLRE 252,A00,507189,Cuomo; Raphael Eduardo,9998,0,9999,1
1713521334327,CLRE 253,A00,507199,Vaida; Florin,9997,0,9999,2
1713521334327,CLRE 253,B00,507202,Vaida; Florin,9999,0,9999,0
1713521335356,CLRE 259,A00,507211,Patel; Hemal,9996,0,9999,3
1713521336380,CLRE 260,A00,507221,Cuomo; Raphael Eduardo,9999,0,9999,0
1713521337405,CLRE 297,001,507242,Cuomo; Raphael Eduardo,9999,0,9999,0
1713521338434,CSE 191,A00,516875,Minnes Kemp; Mor Mia,9999,0,9999,0
1713521339466,CSS 201S,A01,494383,Staff,35,0,35,0
1713521340491,CSS 202S,A01,494387,Staff,35,0,35,0
1713521341515,EAP 100,A00,516065,Staff,9792,0,9999,207
1713521342565,ECE 45,A01,507414,Staff,37,0,60,23
1713521343591,ECE 100,A01,507416,Baghdadchi; Saharnaz,0,0,20,20
1713521343591,ECE 100,A02,507418,Baghdadchi; Saharnaz,19,0,20,1
1713521344616,ECE 111,A01,507420,Staff,27,0,50,23
1713521345643,ECE 197,001,548057,Sievenpiper; Daniel F.,9998,0,9999,1
1713521346670,EDS 115,A00,507243,Choi; Bailey Miyeon,27,0,28,1
1713521347698,EDS 117,A01,494379,Staff,14,0,25,11
1713521348725,EDS 125,A00,507246,Hopkins; Megan Beth,27,0,30,3
1713521349752,EDS 128A,A01,507264,Fargason; Sharon Gayle,26,0,26,0
1713521350778,EDS 128B,A01,507293,Pappas; Elizabeth,30,0,30,0
1713521351804,EDS 139,A00,507294,Fargason; Sharon Gayle,30,0,30,0
1713521351804,EDS 139,B00,507313,Pappas; Elizabeth,30,0,30,0
1713521352833,EDS 201,A00,507315,Staff,18,0,30,12
1713521353862,EDS 203,A01,507317,Halter; Christopher P.,17,0,30,13
1713521354892,EDS 204R,A01,507319,Halter; Christopher P.,0,1,30,30
1713521354892,EDS 204R,B01,507331,Heinzman; Erica M.,22,0,30,8
1713521355921,EDS 206R,A00,507332,Staff,0,2,30,30
1713521355921,EDS 206R,B00,507343,Staff,23,0,30,7
1713521356946,EDS 250,A00,507344,Hemans; Patricia Ann Benitez,27,0,40,13
1713521357975,EDS 281,A00,507345,Daly; Alan J.,18,0,18,0
1713521359001,EDS 284,A00,507350,Daly; Alan J.,16,0,16,0
1713521360027,EDS 286,A00,507359,Fine; Sarah,18,0,18,0
1713521361052,EDS 289C,A01,507361,Daly; Alan J.,18,0,18,0
1713521362077,EDS 290,A00,507366,Hofstetter; Carolyn,15,0,15,0
1713521363108,LIGM 5A,A00,507421,Fischer-Grunski; Eva K,20,0,20,0
1713521364134,LIGM 5B,A00,507423,Fischer-Grunski; Eva K,20,0,20,0
1713521365161,LIGM 5C,A00,507425,Fischer-Grunski; Eva K,20,0,20,0
1713521366188,LIIT 5AS,A00,507427,Carnelos; Chiara,20,0,20,0
1713521367215,LIIT 5BS,A00,507430,Carnelos; Chiara,20,0,20,0
1713521368241,LIIT 5CS,A00,507432,Carnelos; Chiara,20,0,20,0
1713521369284,LISP 5A,A00,507541,Munoz Sanchez; Alicia,14,0,20,6
1713521370311,LISP 5B,A00,507671,Munoz Sanchez; Alicia,12,0,20,8
1713521371342,LISP 5C,A00,507696,Munoz Sanchez; Alicia,11,0,20,9
1713521372368,MAE 197,001,528363,Boechler; Nicholas Sebastia,9998,0,9999,1
1713521373397,MATH 197,001,523477,Kedlaya; Kiran S.,9999,0,9999,0
1713521373397,MATH 197,002,563811,Zhang; Danna,9998,0,9999,1
1713521374428,MCWP 40R,A00,518780,Staff,13,0,20,7
1713521374428,MCWP 40R,B00,518781,Staff,11,0,20,9
1713521374428,MCWP 40R,C00,518783,Staff,8,0,20,12
1713521375458,MCWP 50R,A00,518791,Staff,7,0,20,13
1713521375458,MCWP 50R,B00,518792,Staff,3,0,20,17
1713521375458,MCWP 50R,C00,518793,Staff,5,0,20,15
1713521375458,MCWP 50R,D00,518794,Staff,0,0,20,20
1713521375458,MCWP 50R,E00,518795,Staff,0,0,20,20
1713521375458,MCWP 50R,F00,518796,Staff,10,0,20,10
1713521375458,MCWP 50R,G00,518797,Staff,10,0,20,10
1713521376484,MMW 12R,A01,514034,Herbst; Matthew,1,0,16,15
1713521376484,MMW 12R,A02,514035,Herbst; Matthew,13,0,16,3
1713521377508,MMW 13R,A01,514037,Staff,0,8,16,16
1713521377508,MMW 13R,A02,514039,Staff,0,7,16,16
1713521379566,SIO 295LS,A00,523233,Staff,15,0,30,15
1713521380592,SIO 295S,A00,523232,Staff,15,0,30,15
1713521381619,SOCI 117,A01,494376,Staff,0,2,5,5
1713521382649,WES 237B,A00,494380,Staff,19,0,20,1
1713521384764,AESE 279B,A00,494370,Wade; Jon P,33,0,33,0
1713521385787,AIP 197,001,627712,Vespa; Emanuel Ignacio,9999,0,9999,0
1713521386811,ANAR 135S,A00,494369,Braswell; Geoffrey E.,0,0,0,0
1713521387837,CAT 124RS,A01,519847,Geibel; William,6,0,20,14
1713521388863,CAT 125RS,A01,515971,Geibel; William,6,0,20,14
1713521389888,CLRE 250,A00,511389,Morris; Sheldon,9996,0,9999,3
1713521390913,CLRE 251,A00,507176,Mehta; Ravindra L.,9996,0,9999,3
1713521390913,CLRE 251,B00,511410,Mehta; Ravindra L.,9998,0,9999,1
1713521391941,CLRE 252,A00,507189,Cuomo; Raphael Eduardo,9998,0,9999,1
1713521392966,CLRE 253,A00,507199,Vaida; Florin,9997,0,9999,2
1713521392966,CLRE 253,B00,507202,Vaida; Florin,9999,0,9999,0
1713521393993,CLRE 259,A00,507211,Patel; Hemal,9996,0,9999,3
1713521395018,CLRE 260,A00,507221,Cuomo; Raphael Eduardo,9999,0,9999,0
1713521396044,CLRE 297,001,507242,Cuomo; Raphael Eduardo,9999,0,9999,0
1713521397069,CSE 191,A00,516875,Minnes Kemp; Mor Mia,9999,0,9999,0
1713521398109,CSS 201S,A01,494383,Staff,35,0,35,0
1713521399135,CSS 202S,A01,494387,Staff,35,0,35,0
1713521400160,EAP 100,A00,516065,Staff,9792,0,9999,207
1713521401190,ECE 45,A01,507414,Staff,37,0,60,23
1713521402220,ECE 100,A01,507416,Baghdadchi; Saharnaz,0,0,20,20
1713521402220,ECE 100,A02,507418,Baghdadchi; Saharnaz,19,0,20,1
1713521403245,ECE 111,A01,507420,Staff,27,0,50,23
1713521404270,ECE 197,001,548057,Sievenpiper; Daniel F.,9998,0,9999,1
1713521405299,EDS 115,A00,507243,Choi; Bailey Miyeon,27,0,28,1
1713521406328,EDS 117,A01,494379,Staff,14,0,25,11
1713521407358,EDS 125,A00,507246,Hopkins; Megan Beth,27,0,30,3
1713521408389,EDS 128A,A01,507264,Fargason; Sharon Gayle,26,0,26,0
1713521409419,EDS 128B,A01,507293,Pappas; Elizabeth,30,0,30,0
1713521410443,EDS 139,A00,507294,Fargason; Sharon Gayle,30,0,30,0
1713521410443,EDS 139,B00,507313,Pappas; Elizabeth,30,0,30,0
1713521411473,EDS 201,A00,507315,Staff,18,0,30,12
1713521412501,EDS 203,A01,507317,Halter; Christopher P.,17,0,30,13
1713521413525,EDS 204R,A01,507319,Halter; Christopher P.,0,1,30,30
1713521413525,EDS 204R,B01,507331,Heinzman; Erica M.,22,0,30,8
1713521414550,EDS 206R,A00,507332,Staff,0,2,30,30
1713521414550,EDS 206R,B00,507343,Staff,23,0,30,7
1713521415574,EDS 250,A00,507344,Hemans; Patricia Ann Benitez,27,0,40,13
1713521416603,EDS 281,A00,507345,Daly; Alan J.,18,0,18,0
1713521417627,EDS 284,A00,507350,Daly; Alan J.,16,0,16,0
1713521418664,EDS 286,A00,507359,Fine; Sarah,18,0,18,0
1713521419686,EDS 289C,A01,507361,Daly; Alan J.,18,0,18,0
1713521420713,EDS 290,A00,507366,Hofstetter; Carolyn,15,0,15,0
1713521421740,LIGM 5A,A00,507421,Fischer-Grunski; Eva K,20,0,20,0
1713521422765,LIGM 5B,A00,507423,Fischer-Grunski; Eva K,20,0,20,0
1713521423790,LIGM 5C,A00,507425,Fischer-Grunski; Eva K,20,0,20,0
1713521424820,LIIT 5AS,A00,507427,Carnelos; Chiara,20,0,20,0
1713521425847,LIIT 5BS,A00,507430,Carnelos; Chiara,20,0,20,0
1713521426873,LIIT 5CS,A00,507432,Carnelos; Chiara,20,0,20,0
1713521427904,LISP 5A,A00,507541,Munoz Sanchez; Alicia,14,0,20,6
1713521428930,LISP 5B,A00,507671,Munoz Sanchez; Alicia,12,0,20,8
1713521429955,LISP 5C,A00,507696,Munoz Sanchez; Alicia,11,0,20,9
1713521430979,MAE 197,001,528363,Boechler; Nicholas Sebastia,9998,0,9999,1
1713521432010,MATH 197,001,523477,Kedlaya; Kiran S.,9999,0,9999,0
1713521432010,MATH 197,002,563811,Zhang; Danna,9998,0,9999,1
1713521433037,MCWP 40R,A00,518780,Staff,13,0,20,7
1713521433037,MCWP 40R,B00,518781,Staff,11,0,20,9
1713521433037,MCWP 40R,C00,518783,Staff,8,0,20,12
1713521434116,MCWP 50R,A00,518791,Staff,7,0,20,13
1713521434116,MCWP 50R,B00,518792,Staff,3,0,20,17
1713521434116,MCWP 50R,C00,518793,Staff,5,0,20,15
1713521434116,MCWP 50R,D00,518794,Staff,0,0,20,20
1713521434116,MCWP 50R,E00,518795,Staff,0,0,20,20
1713521434116,MCWP 50R,F00,518796,Staff,10,0,20,10
1713521434116,MCWP 50R,G00,518797,Staff,10,0,20,10
1713521435141,MMW 12R,A01,514034,Herbst; Matthew,1,0,16,15
1713521435141,MMW 12R,A02,514035,Herbst; Matthew,13,0,16,3
1713521436165,MMW 13R,A01,514037,Staff,0,8,16,16
1713521436165,MMW 13R,A02,514039,Staff,0,7,16,16
1713521438236,SIO 295LS,A00,523233,Staff,15,0,30,15
1713521439261,SIO 295S,A00,523232,Staff,15,0,30,15
1713521440292,SOCI 117,A01,494376,Staff,0,2,5,5
1713521441318,WES 237B,A00,494380,Staff,19,0,20,1
1713521443389,AESE 279B,A00,494370,Wade; Jon P,33,0,33,0
1713521444419,AIP 197,001,627712,Vespa; Emanuel Ignacio,9999,0,9999,0
1713521445447,ANAR 135S,A00,494369,Braswell; Geoffrey E.,0,0,0,0
1713521446476,CAT 124RS,A01,519847,Geibel; William,6,0,20,14
1713521447501,CAT 125RS,A01,515971,Geibel; William,6,0,20,14
1713521448541,CLRE 250,A00,511389,Morris; Sheldon,9996,0,9999,3
1713521449566,CLRE 251,A00,507176,Mehta; Ravindra L.,9996,0,9999,3
1713521449566,CLRE 251,B00,511410,Mehta; Ravindra L.,9998,0,9999,1
1713521450592,CLRE 252,A00,507189,Cuomo; Raphael Eduardo,9998,0,9999,1
1713521451619,CLRE 253,A00,507199,Vaida; Florin,9997,0,9999,2
1713521451619,CLRE 253,B00,507202,Vaida; Florin,9999,0,9999,0
1713521452651,CLRE 259,A00,507211,Patel; Hemal,9996,0,9999,3
1713521453681,CLRE 260,A00,507221,Cuomo; Raphael Eduardo,9999,0,9999,0
1713521454711,CLRE 297,001,507242,Cuomo; Raphael Eduardo,9999,0,9999,0
1713521455739,CSE 191,A00,516875,Minnes Kemp; Mor Mia,9999,0,9999,0
1713521456765,CSS 201S,A01,494383,Staff,35,0,35,0
1713521457790,CSS 202S,A01,494387,Staff,35,0,35,0
1713521458824,EAP 100,A00,516065,Staff,9792,0,9999,207
1713521459857,ECE 45,A01,507414,Staff,37,0,60,23
1713521460887,ECE 100,A01,507416,Baghdadchi; Saharnaz,0,0,20,20
1713521460887,ECE 100,A02,507418,Baghdadchi; Saharnaz,19,0,20,1
1713521461912,ECE 111,A01,507420,Staff,27,0,50,23
1713521462945,ECE 197,001,548057,Sievenpiper; Daniel F.,9998,0,9999,1
1713521463971,EDS 115,A00,507243,Choi; Bailey Miyeon,27,0,28,1
1713521464997,EDS 117,A01,494379,Staff,14,0,25,11
1713521466026,EDS 125,A00,507246,Hopkins; Megan Beth,27,0,30,3
1713521467056,EDS 128A,A01,507264,Fargason; Sharon Gayle,26,0,26,0
1713521468084,EDS 128B,A01,507293,Pappas; Elizabeth,30,0,30,0
1713521469111,EDS 139,A00,507294,Fargason; Sharon Gayle,30,0,30,0
1713521469111,EDS 139,B00,507313,Pappas; Elizabeth,30,0,30,0
1713521470140,EDS 201,A00,507315,Staff,18,0,30,12
1713521471171,EDS 203,A01,507317,Halter; Christopher P.,17,0,30,13
1713521472196,EDS 204R,A01,507319,Halter; Christopher P.,0,1,30,30
1713521472196,EDS 204R,B01,507331,Heinzman; Erica M.,22,0,30,8
1713521473222,EDS 206R,A00,507332,Staff,0,2,30,30
1713521473222,EDS 206R,B00,507343,Staff,23,0,30,7
1713521474251,EDS 250,A00,507344,Hemans; Patricia Ann Benitez,27,0,40,13
1713521475276,EDS 281,A00,507345,Daly; Alan J.,18,0,18,0
1713521476300,EDS 284,A00,507350,Daly; Alan J.,16,0,16,0
1713521477325,EDS 286,A00,507359,Fine; Sarah,18,0,18,0
1713521478354,EDS 289C,A01,507361,Daly; Alan J.,18,0,18,0
1713521479380,EDS 290,A00,507366,Hofstetter; Carolyn,15,0,15,0
1713521480407,LIGM 5A,A00,507421,Fischer-Grunski; Eva K,20,0,20,0
1713521481432,LIGM 5B,A00,507423,Fischer-Grunski; Eva K,20,0,20,0
1713521482462,LIGM 5C,A00,507425,Fischer-Grunski; Eva K,20,0,20,0
1713521483486,LIIT 5AS,A00,507427,Carnelos; Chiara,20,0,20,0
1713521484510,LIIT 5BS,A00,507430,Carnelos; Chiara,20,0,20,0
1713521485539,LIIT 5CS,A00,507432,Carnelos; Chiara,20,0,20,0
1713521486563,LISP 5A,A00,507541,Munoz Sanchez; Alicia,14,0,20,6
1713521487641,LISP 5B,A00,507671,Munoz Sanchez; Alicia,12,0,20,8
1713521488667,LISP 5C,A00,507696,Munoz Sanchez; Alicia,11,0,20,9
1713521489692,MAE 197,001,528363,Boechler; Nicholas Sebastia,9998,0,9999,1
1713521490716,MATH 197,001,523477,Kedlaya; Kiran S.,9999,0,9999,0
1713521490716,MATH 197,002,563811,Zhang; Danna,9998,0,9999,1
1713521491742,MCWP 40R,A00,518780,Staff,13,0,20,7
1713521491742,MCWP 40R,B00,518781,Staff,11,0,20,9
1713521491742,MCWP 40R,C00,518783,Staff,8,0,20,12
1713521492766,MCWP 50R,A00,518791,Staff,7,0,20,13
1713521492766,MCWP 50R,B00,518792,Staff,3,0,20,17
1713521492766,MCWP 50R,C00,518793,Staff,5,0,20,15
1713521492766,MCWP 50R,D00,518794,Staff,0,0,20,20
1713521492766,MCWP 50R,E00,518795,Staff,0,0,20,20
1713521492766,MCWP 50R,F00,518796,Staff,10,0,20,10
1713521492766,MCWP 50R,G00,518797,Staff,10,0,20,10
1713521493796,MMW 12R,A01,514034,Herbst; Matthew,1,0,16,15
1713521493796,MMW 12R,A02,514035,Herbst; Matthew,13,0,16,3
1713521494822,MMW 13R,A01,514037,Staff,0,8,16,16
1713521494822,MMW 13R,A02,514039,Staff,0,7,16,16
1713521496882,SIO 295LS,A00,523233,Staff,15,0,30,15
1713521497910,SIO 295S,A00,523232,Staff,15,0,30,15
1713521498942,SOCI 117,A01,494376,Staff,0,2,5,5
1713521499970,WES 237B,A00,494380,Staff,19,0,20,1
1713521502039,AESE 279B,A00,494370,Wade; Jon P,33,0,33,0
1713521503066,AIP 197,001,627712,Vespa; Emanuel Ignacio,9999,0,9999,0
1713521504091,ANAR 135S,A00,494369,Braswell; Geoffrey E.,0,0,0,0
1713521505120,CAT 124RS,A01,519847,Geibel; William,6,0,20,14
1713521506145,CAT 125RS,A01,515971,Geibel; William,6,0,20,14
1713521507172,CLRE 250,A00,511389,Morris; Sheldon,9996,0,9999,3
1713521508201,CLRE 251,A00,507176,Mehta; Ravindra L.,9996,0,9999,3
1713521508201,CLRE 251,B00,511410,Mehta; Ravindra L.,9998,0,9999,1
1713521509228,CLRE 252,A00,507189,Cuomo; Raphael Eduardo,9998,0,9999,1
1713521510255,CLRE 253,A00,507199,Vaida; Florin,9997,0,9999,2
1713521510255,CLRE 253,B00,507202,Vaida; Florin,9999,0,9999,0
1713521511282,CLRE 259,A00,507211,Patel; Hemal,9996,0,9999,3
1713521512310,CLRE 260,A00,507221,Cuomo; Raphael Eduardo,9999,0,9999,0
1713521513338,CLRE 297,001,507242,Cuomo; Raphael Eduardo,9999,0,9999,0
1713521514362,CSE 191,A00,516875,Minnes Kemp; Mor Mia,9999,0,9999,0
1713521515391,CSS 201S,A01,494383,Staff,35,0,35,0
1713521516417,CSS 202S,A01,494387,Staff,35,0,35,0
1713521517445,EAP 100,A00,516065,Staff,9792,0,9999,207
1713521518479,ECE 45,A01,507414,Staff,37,0,60,23
1713521519505,ECE 100,A01,507416,Baghdadchi; Saharnaz,0,0,20,20
1713521519505,ECE 100,A02,507418,Baghdadchi; Saharnaz,19,0,20,1
1713521520535,ECE 111,A01,507420,Staff,27,0,50,23
1713521521561,ECE 197,001,548057,Sievenpiper; Daniel F.,9998,0,9999,1
1713521522591,EDS 115,A00,507243,Choi; Bailey Miyeon,27,0,28,1
1713521523619,EDS 117,A01,494379,Staff,14,0,25,11
1713521524645,EDS 125,A00,507246,Hopkins; Megan Beth,27,0,30,3
1713521525672,EDS 128A,A01,507264,Fargason; Sharon Gayle,26,0,26,0
1713521526697,EDS 128B,A01,507293,Pappas; Elizabeth,30,0,30,0
1713521527725,EDS 139,A00,507294,Fargason; Sharon Gayle,30,0,30,0
1713521527725,EDS 139,B00,507313,Pappas; Elizabeth,30,0,30,0
1713521528751,EDS 201,A00,507315,Staff,18,0,30,12
1713521529783,EDS 203,A01,507317,Halter; Christopher P.,17,0,30,13
1713521530813,EDS 204R,A01,507319,Halter; Christopher P.,0,1,30,30
1713521530813,EDS 204R,B01,507331,Heinzman; Erica M.,22,0,30,8
1713521531838,EDS 206R,A00,507332,Staff,0,2,30,30
1713521531838,EDS 206R,B00,507343,Staff,23,0,30,7
1713521532865,EDS 250,A00,507344,Hemans; Patricia Ann Benitez,27,0,40,13
1713521533891,EDS 281,A00,507345,Daly; Alan J.,18,0,18,0
1713521534919,EDS 284,A00,507350,Daly; Alan J.,16,0,16,0
1713521535948,EDS 286,A00,507359,Fine; Sarah,18,0,18,0
1713521536973,EDS 289C,A01,507361,Daly; Alan J.,18,0,18,0
1713521537998,EDS 290,A00,507366,Hofstetter; Carolyn,15,0,15,0
1713521539029,LIGM 5A,A00,507421,Fischer-Grunski; Eva K,20,0,20,0
1713521540057,LIGM 5B,A00,507423,Fischer-Grunski; Eva K,20,0,20,0
1713521541083,LIGM 5C,A00,507425,Fischer-Grunski; Eva K,20,0,20,0
1713521542110,LIIT 5AS,A00,507427,Carnelos; Chiara,20,0,20,0
1713521543137,LIIT 5BS,A00,507430,Carnelos; Chiara,20,0,20,0
1713521544162,LIIT 5CS,A00,507432,Carnelos; Chiara,20,0,20,0
1713521545189,LISP 5A,A00,507541,Munoz Sanchez; Alicia,14,0,20,6
1713521546216,LISP 5B,A00,507671,Munoz Sanchez; Alicia,12,0,20,8
1713521547246,LISP 5C,A00,507696,Munoz Sanchez; Alicia,11,0,20,9
1713521548272,MAE 197,001,528363,Boechler; Nicholas Sebastia,9998,0,9999,1
1713521549299,MATH 197,001,523477,Kedlaya; Kiran S.,9999,0,9999,0
1713521549299,MATH 197,002,563811,Zhang; Danna,9998,0,9999,1
1713521550330,MCWP 40R,A00,518780,Staff,13,0,20,7
1713521550330,MCWP 40R,B00,518781,Staff,11,0,20,9
1713521550330,MCWP 40R,C00,518783,Staff,8,0,20,12
1713521551357,MCWP 50R,A00,518791,Staff,7,0,20,13
1713521551357,MCWP 50R,B00,518792,Staff,3,0,20,17
1713521551357,MCWP 50R,C00,518793,Staff,5,0,20,15
1713521551357,MCWP 50R,D00,518794,Staff,0,0,20,20
1713521551357,MCWP 50R,E00,518795,Staff,0,0,20,20
1713521551357,MCWP 50R,F00,518796,Staff,10,0,20,10
1713521551357,MCWP 50R,G00,518797,Staff,10,0,20,10
1713521552383,MMW 12R,A01,514034,Herbst; Matthew,1,0,16,15
1713521552383,MMW 12R,A02,514035,Herbst; Matthew,13,0,16,3
1713521553411,MMW 13R,A01,514037,Staff,0,8,16,16
1713521553411,MMW 13R,A02,514039,Staff,0,7,16,16
1713521555469,SIO 295LS,A00,523233,Staff,15,0,30,15
1713521556494,SIO 295S,A00,523232,Staff,15,0,30,15
1713521557522,SOCI 117,A01,494376,Staff,0,2,5,5
1713521558549,WES 237B,A00,494380,Staff,19,0,20,1
1713521560617,AESE 279B,A00,494370,Wade; Jon P,33,0,33,0
1713521561647,AIP 197,001,627712,Vespa; Emanuel Ignacio,9999,0,9999,0
1713521562673,ANAR 135S,A00,494369,Braswell; Geoffrey E.,0,0,0,0
1713521563702,CAT 124RS,A01,519847,Geibel; William,6,0,20,14
1713521564727,CAT 125RS,A01,515971,Geibel; William,6,0,20,14
1713521565755,CLRE 250,A00,511389,Morris; Sheldon,9996,0,9999,3
1713521566786,CLRE 251,A00,507176,Mehta; Ravindra L.,9996,0,9999,3
1713521566786,CLRE 251,B00,511410,Mehta; Ravindra L.,9998,0,9999,1
1713521567815,CLRE 252,A00,507189,Cuomo; Raphael Eduardo,9998,0,9999,1
1713521568843,CLRE 253,A00,507199,Vaida; Florin,9997,0,9999,2
1713521568843,CLRE 253,B00,507202,Vaida; Florin,9999,0,9999,0
1713521569874,CLRE 259,A00,507211,Patel; Hemal,9996,0,9999,3
1713521570900,CLRE 260,A00,507221,Cuomo; Raphael Eduardo,9999,0,9999,0
1713521571924,CLRE 297,001,507242,Cuomo; Raphael Eduardo,9999,0,9999,0
1713521572950,CSE 191,A00,516875,Minnes Kemp; Mor Mia,9999,0,9999,0
1713521573977,CSS 201S,A01,494383,Staff,35,0,35,0
1713521575016,CSS 202S,A01,494387,Staff,35,0,35,0
1713521576040,EAP 100,A00,516065,Staff,9792,0,9999,207
1713521577075,ECE 45,A01,507414,Staff,37,0,60,23
1713521578105,ECE 100,A01,507416,Baghdadchi; Saharnaz,0,0,20,20
1713521578105,ECE 100,A02,507418,Baghdadchi; Saharnaz,19,0,20,1
1713521579131,ECE 111,A01,507420,Staff,27,0,50,23
1713521580165,ECE 197,001,548057,Sievenpiper; Daniel F.,9998,0,9999,1
1713521581195,EDS 115,A00,507243,Choi; Bailey Miyeon,27,0,28,1
1713521582223,EDS 117,A01,494379,Staff,14,0,25,11
1713521583248,EDS 125,A00,507246,Hopkins; Megan Beth,27,0,30,3
1713521584275,EDS 128A,A01,507264,Fargason; Sharon Gayle,26,0,26,0
1713521585301,EDS 128B,A01,507293,Pappas; Elizabeth,30,0,30,0
1713521586326,EDS 139,A00,507294,Fargason; Sharon Gayle,30,0,30,0
1713521586326,EDS 139,B00,507313,Pappas; Elizabeth,30,0,30,0
1713521587354,EDS 201,A00,507315,Staff,18,0,30,12
1713521588384,EDS 203,A01,507317,Halter; Christopher P.,17,0,30,13
1713521589410,EDS 204R,A01,507319,Halter; Christopher P.,0,1,30,30
1713521589410,EDS 204R,B01,507331,Heinzman; Erica M.,22,0,30,8
1713521590437,EDS 206R,A00,507332,Staff,0,2,30,30
1713521590437,EDS 206R,B00,507343,Staff,23,0,30,7
1713521591520,EDS 250,A00,507344,Hemans; Patricia Ann Benitez,27,0,40,13
1713521592545,EDS 281,A00,507345,Daly; Alan J.,18,0,18,0
1713521593570,EDS 284,A00,507350,Daly; Alan J.,16,0,16,0
1713521594597,EDS 286,A00,507359,Fine; Sarah,18,0,18,0
1713521595623,EDS 289C,A01,507361,Daly; Alan J.,18,0,18,0
1713521596650,EDS 290,A00,507366,Hofstetter; Carolyn,15,0,15,0
1713521597676,LIGM 5A,A00,507421,Fischer-Grunski; Eva K,20,0,20,0
1713521598706,LIGM 5B,A00,507423,Fischer-Grunski; Eva K,20,0,20,0
1713521599735,LIGM 5C,A00,507425,Fischer-Grunski; Eva K,20,0,20,0
1713521600760,LIIT 5AS,A00,507427,Carnelos; Chiara,20,0,20,0
1713521601791,LIIT 5BS,A00,507430,Carnelos; Chiara,20,0,20,0
1713521602822,LIIT 5CS,A00,507432,Carnelos; Chiara,20,0,20,0
1713521603851,LISP 5A,A00,507541,Munoz Sanchez; Alicia,14,0,20,6
1713521604881,LISP 5B,A00,507671,Munoz Sanchez; Alicia,12,0,20,8
1713521605909,LISP 5C,A00,507696,Munoz Sanchez; Alicia,11,0,20,9
1713521606935,MAE 197,001,528363,Boechler; Nicholas Sebastia,9998,0,9999,1
1713521607964,MATH 197,001,523477,Kedlaya; Kiran S.,9999,0,9999,0
1713521607964,MATH 197,002,563811,Zhang; Danna,9998,0,9999,1
1713521608990,MCWP 40R,A00,518780,Staff,13,0,20,7
1713521608990,MCWP 40R,B00,518781,Staff,11,0,20,9
1713521608990,MCWP 40R,C00,518783,Staff,8,0,20,12
1713521610019,MCWP 50R,A00,518791,Staff,7,0,20,13
1713521610019,MCWP 50R,B00,518792,Staff,3,0,20,17
1713521610019,MCWP 50R,C00,518793,Staff,5,0,20,15
1713521610019,MCWP 50R,D00,518794,Staff,0,0,20,20
1713521610019,MCWP 50R,E00,518795,Staff,0,0,20,20
1713521610019,MCWP 50R,F00,518796,Staff,10,0,20,10
1713521610019,MCWP 50R,G00,518797,Staff,10,0,20,10
1713521611044,MMW 12R,A01,514034,Herbst; Matthew,1,0,16,15
1713521611044,MMW 12R,A02,514035,Herbst; Matthew,13,0,16,3
1713521612073,MMW 13R,A01,514037,Staff,0,8,16,16
1713521612073,MMW 13R,A02,514039,Staff,0,7,16,16
1713521614124,SIO 295LS,A00,523233,Staff,15,0,30,15
1713521615152,SIO 295S,A00,523232,Staff,15,0,30,15
1713521616178,SOCI 117,A01,494376,Staff,0,2,5,5
1713521617205,WES 237B,A00,494380,Staff,19,0,20,1
1713521619273,AESE 279B,A00,494370,Wade; Jon P,33,0,33,0
1713521620298,AIP 197,001,627712,Vespa; Emanuel Ignacio,9999,0,9999,0
1713521621322,ANAR 135S,A00,494369,Braswell; Geoffrey E.,0,0,0,0
1713521622349,CAT 124RS,A01,519847,Geibel; William,6,0,20,14
1713521623375,CAT 125RS,A01,515971,Geibel; William,6,0,20,14
1713521624403,CLRE 250,A00,511389,Morris; Sheldon,9996,0,9999,3
1713521625434,CLRE 251,A00,507176,Mehta; Ravindra L.,9996,0,9999,3
1713521625434,CLRE 251,B00,511410,Mehta; Ravindra L.,9998,0,9999,1
1713521626460,CLRE 252,A00,507189,Cuomo; Raphael Eduardo,9998,0,9999,1
1713521627489,CLRE 253,A00,507199,Vaida; Florin,9997,0,9999,2
1713521627489,CLRE 253,B00,507202,Vaida; Florin,9999,0,9999,0
1713521628515,CLRE 259,A00,507211,Patel; Hemal,9996,0,9999,3
1713521629543,CLRE 260,A00,507221,Cuomo; Raphael Eduardo,9999,0,9999,0
1713521630571,CLRE 297,001,507242,Cuomo; Raphael Eduardo,9999,0,9999,0
1713521631599,CSE 191,A00,516875,Minnes Kemp; Mor Mia,9999,0,9999,0
1713521632642,CSS 201S,A01,494383,Staff,35,0,35,0
1713521633674,CSS 202S,A01,494387,Staff,35,0,35,0
1713521634707,EAP 100,A00,516065,Staff,9792,0,9999,207
1713521635732,ECE 45,A01,507414,Staff,37,0,60,23
1713521636757,ECE 100,A01,507416,Baghdadchi; Saharnaz,0,0,20,20
1713521636757,ECE 100,A02,507418,Baghdadchi; Saharnaz,19,0,20,1
1713521637787,ECE 111,A01,507420,Staff,27,0,50,23
1713521638826,ECE 197,001,548057,Sievenpiper; Daniel F.,9998,0,9999,1
1713521639853,EDS 115,A00,507243,Choi; Bailey Miyeon,27,0,28,1
1713521640884,EDS 117,A01,494379,Staff,14,0,25,11
1713521641910,EDS 125,A00,507246,Hopkins; Megan Beth,27,0,30,3
1713521642940,EDS 128A,A01,507264,Fargason; Sharon Gayle,26,0,26,0
1713521643969,EDS 128B,A01,507293,Pappas; Elizabeth,30,0,30,0
1713521644994,EDS 139,A00,507294,Fargason; Sharon Gayle,30,0,30,0
1713521644994,EDS 139,B00,507313,Pappas; Elizabeth,30,0,30,0
1713521646019,EDS 201,A00,507315,Staff,18,0,30,12
1713521647046,EDS 203,A01,507317,Halter; Christopher P.,17,0,30,13
1713521648072,EDS 204R,A01,507319,Halter; Christopher P.,0,1,30,30
1713521648072,EDS 204R,B01,507331,Heinzman; Erica M.,22,0,30,8
1713521649097,EDS 206R,A00,507332,Staff,0,2,30,30
1713521649097,EDS 206R,B00,507343,Staff,23,0,30,7
1713521650127,EDS 250,A00,507344,Hemans; Patricia Ann Benitez,27,0,40,13
1713521651151,EDS 281,A00,507345,Daly; Alan J.,18,0,18,0
1713521652177,EDS 284,A00,507350,Daly; Alan J.,16,0,16,0
1713521653206,EDS 286,A00,507359,Fine; Sarah,18,0,18,0
1713521654236,EDS 289C,A01,507361,Daly; Alan J.,18,0,18,0
1713521655260,EDS 290,A00,507366,Hofstetter; Carolyn,15,0,15,0
1713521656293,LIGM 5A,A00,507421,Fischer-Grunski; Eva K,20,0,20,0
1713521657319,LIGM 5B,A00,507423,Fischer-Grunski; Eva K,20,0,20,0
1713521658345,LIGM 5C,A00,507425,Fischer-Grunski; Eva K,20,0,20,0
1713521659371,LIIT 5AS,A00,507427,Carnelos; Chiara,20,0,20,0
1713521660399,LIIT 5BS,A00,507430,Carnelos; Chiara,20,0,20,0
1713521661430,LIIT 5CS,A00,507432,Carnelos; Chiara,20,0,20,0
1713521662457,LISP 5A,A00,507541,Munoz Sanchez; Alicia,14,0,20,6
1713521663482,LISP 5B,A00,507671,Munoz Sanchez; Alicia,12,0,20,8
1713521664512,LISP 5C,A00,507696,Munoz Sanchez; Alicia,11,0,20,9
1713521665540,MAE 197,001,528363,Boechler; Nicholas Sebastia,9998,0,9999,1
1713521666567,MATH 197,001,523477,Kedlaya; Kiran S.,9999,0,9999,0
1713521666567,MATH 197,002,563811,Zhang; Danna,9998,0,9999,1
1713521667593,MCWP 40R,A00,518780,Staff,13,0,20,7
1713521667593,MCWP 40R,B00,518781,Staff,11,0,20,9
1713521667593,MCWP 40R,C00,518783,Staff,8,0,20,12
1713521668619,MCWP 50R,A00,518791,Staff,7,0,20,13
1713521668619,MCWP 50R,B00,518792,Staff,3,0,20,17
1713521668619,MCWP 50R,C00,518793,Staff,5,0,20,15
1713521668619,MCWP 50R,D00,518794,Staff,0,0,20,20
1713521668619,MCWP 50R,E00,518795,Staff,0,0,20,20
1713521668619,MCWP 50R,F00,518796,Staff,10,0,20,10
1713521668619,MCWP 50R,G00,518797,Staff,10,0,20,10
1713521669646,MMW 12R,A01,514034,Herbst; Matthew,1,0,16,15
1713521669646,MMW 12R,A02,514035,Herbst; Matthew,13,0,16,3
1713521670670,MMW 13R,A01,514037,Staff,0,8,16,16
1713521670670,MMW 13R,A02,514039,Staff,0,7,16,16
1713521672731,SIO 295LS,A00,523233,Staff,15,0,30,15
1713521673755,SIO 295S,A00,523232,Staff,15,0,30,15
1713521674780,SOCI 117,A01,494376,Staff,0,2,5,5
1713521675806,WES 237B,A00,494380,Staff,19,0,20,1
1713521677900,AESE 279B,A00,494370,Wade; Jon P,33,0,33,0
1713521678930,AIP 197,001,627712,Vespa; Emanuel Ignacio,9999,0,9999,0
1713521679955,ANAR 135S,A00,494369,Braswell; Geoffrey E.,0,0,0,0
1713521680985,CAT 124RS,A01,519847,Geibel; William,6,0,20,14
1713521682009,CAT 125RS,A01,515971,Geibel; William,6,0,20,14
1713521683035,CLRE 250,A00,511389,Morris; Sheldon,9996,0,9999,3
1713521684066,CLRE 251,A00,507176,Mehta; Ravindra L.,9996,0,9999,3
1713521684066,CLRE 251,B00,511410,Mehta; Ravindra L.,9998,0,9999,1
1713521685092,CLRE 252,A00,507189,Cuomo; Raphael Eduardo,9998,0,9999,1
1713521686125,CLRE 253,A00,507199,Vaida; Florin,9997,0,9999,2
1713521686125,CLRE 253,B00,507202,Vaida; Florin,9999,0,9999,0
1713521687149,CLRE 259,A00,507211,Patel; Hemal,9996,0,9999,3
1713521688176,CLRE 260,A00,507221,Cuomo; Raphael Eduardo,9999,0,9999,0
1713521689204,CLRE 297,001,507242,Cuomo; Raphael Eduardo,9999,0,9999,0
1713521690230,CSE 191,A00,516875,Minnes Kemp; Mor Mia,9999,0,9999,0
1713521691258,CSS 201S,A01,494383,Staff,35,0,35,0
1713521692284,CSS 202S,A01,494387,Staff,35,0,35,0
1713521693309,EAP 100,A00,516065,Staff,9792,0,9999,207
1713521694343,ECE 45,A01,507414,Staff,37,0,60,23
1713521695423,ECE 100,A01,507416,Baghdadchi; Saharnaz,0,0,20,20
1713521695423,ECE 100,A02,507418,Baghdadchi; Saharnaz,19,0,20,1
1713521696448,ECE 111,A01,507420,Staff,27,0,50,23
1713521697473,ECE 197,001,548057,Sievenpiper; Daniel F.,9998,0,9999,1
1713521698499,EDS 115,A00,507243,Choi; Bailey Miyeon,27,0,28,1
1713521699525,EDS 117,A01,494379,Staff,14,0,25,11
1713521700551,EDS 125,A00,507246,Hopkins; Megan Beth,27,0,30,3
1713521701575,EDS 128A,A01,507264,Fargason; Sharon Gayle,26,0,26,0
1713521702601,EDS 128B,A01,507293,Pappas; Elizabeth,30,0,30,0
1713521703630,EDS 139,A00,507294,Fargason; Sharon Gayle,30,0,30,0
1713521703630,EDS 139,B00,507313,Pappas; Elizabeth,30,0,30,0
1713521704654,EDS 201,A00,507315,Staff,18,0,30,12
1713521705683,EDS 203,A01,507317,Halter; Christopher P.,17,0,30,13
1713521706708,EDS 204R,A01,507319,Halter; Christopher P.,0,1,30,30
1713521706708,EDS 204R,B01,507331,Heinzman; Erica M.,22,0,30,8
1713521707735,EDS 206R,A00,507332,Staff,0,2,30,30
1713521707735,EDS 206R,B00,507343,Staff,23,0,30,7
1713521708759,EDS 250,A00,507344,Hemans; Patricia Ann Benitez,27,0,40,13
1713521709786,EDS 281,A00,507345,Daly; Alan J.,18,0,18,0
1713521710813,EDS 284,A00,507350,Daly; Alan J.,16,0,16,0
1713521711841,EDS 286,A00,507359,Fine; Sarah,18,0,18,0
1713521712868,EDS 289C,A01,507361,Daly; Alan J.,18,0,18,0
1713521713896,EDS 290,A00,507366,Hofstetter; Carolyn,15,0,15,0
1713521714921,LIGM 5A,A00,507421,Fischer-Grunski; Eva K,20,0,20,0
1713521715948,LIGM 5B,A00,507423,Fischer-Grunski; Eva K,20,0,20,0
1713521716983,LIGM 5C,A00,507425,Fischer-Grunski; Eva K,20,0,20,0
1713521718009,LIIT 5AS,A00,507427,Carnelos; Chiara,20,0,20,0
1713521719034,LIIT 5BS,A00,507430,Carnelos; Chiara,20,0,20,0
1713521720059,LIIT 5CS,A00,507432,Carnelos; Chiara,20,0,20,0
1713521721085,LISP 5A,A00,507541,Munoz Sanchez; Alicia,14,0,20,6
1713521722114,LISP 5B,A00,507671,Munoz Sanchez; Alicia,12,0,20,8
1713521723142,LISP 5C,A00,507696,Munoz Sanchez; Alicia,11,0,20,9
1713521724168,MAE 197,001,528363,Boechler; Nicholas Sebastia,9998,0,9999,1
1713521725196,MATH 197,001,523477,Kedlaya; Kiran S.,9999,0,9999,0
1713521725196,MATH 197,002,563811,Zhang; Danna,9998,0,9999,1
1713521726221,MCWP 40R,A00,518780,Staff,13,0,20,7
1713521726221,MCWP 40R,B00,518781,Staff,11,0,20,9
1713521726221,MCWP 40R,C00,518783,Staff,8,0,20,12
1713521727251,MCWP 50R,A00,518791,Staff,7,0,20,13
1713521727251,MCWP 50R,B00,518792,Staff,3,0,20,17
1713521727251,MCWP 50R,C00,518793,Staff,5,0,20,15
1713521727251,MCWP 50R,D00,518794,Staff,0,0,20,20
1713521727251,MCWP 50R,E00,518795,Staff,0,0,20,20
1713521727251,MCWP 50R,F00,518796,Staff,10,0,20,10
1713521727251,MCWP 50R,G00,518797,Staff,10,0,20,10
1713521728279,MMW 12R,A01,514034,Herbst; Matthew,1,0,16,15
1713521728279,MMW 12R,A02,514035,Herbst; Matthew,13,0,16,3
1713521729303,MMW 13R,A01,514037,Staff,0,8,16,16
1713521729303,MMW 13R,A02,514039,Staff,0,7,16,16
1713521731358,SIO 295LS,A00,523233,Staff,15,0,30,15
1713521732386,SIO 295S,A00,523232,Staff,15,0,30,15
1713521733412,SOCI 117,A01,494376,Staff,0,2,5,5
1713521734436,WES 237B,A00,494380,Staff,19,0,20,1
1713521736496,AESE 279B,A00,494370,Wade; Jon P,33,0,33,0
1713521737525,AIP 197,001,627712,Vespa; Emanuel Ignacio,9999,0,9999,0
1713521738549,ANAR 135S,A00,494369,Braswell; Geoffrey E.,0,0,0,0
1713521739577,CAT 124RS,A01,519847,Geibel; William,6,0,20,14
1713521740602,CAT 125RS,A01,515971,Geibel; William,6,0,20,14
1713521741627,CLRE 250,A00,511389,Morris; Sheldon,9996,0,9999,3
1713521742652,CLRE 251,A00,507176,Mehta; Ravindra L.,9996,0,9999,3
1713521742652,CLRE 251,B00,511410,Mehta; Ravindra L.,9998,0,9999,1
1713521743682,CLRE 252,A00,507189,Cuomo; Raphael Eduardo,9998,0,9999,1
1713521744710,CLRE 253,A00,507199,Vaida; Florin,9997,0,9999,2
1713521744710,CLRE 253,B00,507202,Vaida; Florin,9999,0,9999,0
1713521745739,CLRE 259,A00,507211,Patel; Hemal,9996,0,9999,3
1713521746764,CLRE 260,A00,507221,Cuomo; Raphael Eduardo,9999,0,9999,0
1713521747791,CLRE 297,001,507242,Cuomo; Raphael Eduardo,9999,0,9999,0
1713521748817,CSE 191,A00,516875,Minnes Kemp; Mor Mia,9999,0,9999,0
1713521749843,CSS 201S,A01,494383,Staff,35,0,35,0
1713521750873,CSS 202S,A01,494387,Staff,35,0,35,0
1713521751898,EAP 100,A00,516065,Staff,9792,0,9999,207
1713521752928,ECE 45,A01,507414,Staff,37,0,60,23
1713521753953,ECE 100,A01,507416,Baghdadchi; Saharnaz,0,0,20,20
1713521753953,ECE 100,A02,507418,Baghdadchi; Saharnaz,19,0,20,1
1713521754982,ECE 111,A01,507420,Staff,27,0,50,23
1713521756007,ECE 197,001,548057,Sievenpiper; Daniel F.,9998,0,9999,1
1713521757039,EDS 115,A00,507243,Choi; Bailey Miyeon,27,0,28,1
1713521758064,EDS 117,A01,494379,Staff,14,0,25,11
1713521759094,EDS 125,A00,507246,Hopkins; Megan Beth,27,0,30,3
1713521760126,EDS 128A,A01,507264,Fargason; Sharon Gayle,26,0,26,0
1713521761151,EDS 128B,A01,507293,Pappas; Elizabeth,30,0,30,0
1713521762176,EDS 139,A00,507294,Fargason; Sharon Gayle,30,0,30,0
1713521762176,EDS 139,B00,507313,Pappas; Elizabeth,30,0,30,0
1713521763201,EDS 201,A00,507315,Staff,18,0,30,12
1713521764228,EDS 203,A01,507317,Halter; Christopher P.,17,0,30,13
1713521765252,EDS 204R,A01,507319,Halter; Christopher P.,0,1,30,30
1713521765252,EDS 204R,B01,507331,Heinzman; Erica M.,22,0,30,8
1713521766277,EDS 206R,A00,507332,Staff,0,2,30,30
1713521766277,EDS 206R,B00,507343,Staff,23,0,30,7
1713521767303,EDS 250,A00,507344,Hemans; Patricia Ann Benitez,27,0,40,13
1713521768329,EDS 281,A00,507345,Daly; Alan J.,18,0,18,0
1713521769355,EDS 284,A00,507350,Daly; Alan J.,16,0,16,0
1713521770385,EDS 286,A00,507359,Fine; Sarah,18,0,18,0
1713521771410,EDS 289C,A01,507361,Daly; Alan J.,18,0,18,0
1713521772436,EDS 290,A00,507366,Hofstetter; Carolyn,15,0,15,0
1713521773464,LIGM 5A,A00,507421,Fischer-Grunski; Eva K,20,0,20,0
1713521774490,LIGM 5B,A00,507423,Fischer-Grunski; Eva K,20,0,20,0
1713521775515,LIGM 5C,A00,507425,Fischer-Grunski; Eva K,20,0,20,0
1713521776544,LIIT 5AS,A00,507427,Carnelos; Chiara,20,0,20,0
1713521777573,LIIT 5BS,A00,507430,Carnelos; Chiara,20,0,20,0
1713521778602,LIIT 5CS,A00,507432,Carnelos; Chiara,20,0,20,0
1713521779629,LISP 5A,A00,507541,Munoz Sanchez; Alicia,14,0,20,6
1713521780654,LISP 5B,A00,507671,Munoz Sanchez; Alicia,12,0,20,8
1713521781686,LISP 5C,A00,507696,Munoz Sanchez; Alicia,11,0,20,9
1713521782717,MAE 197,001,528363,Boechler; Nicholas Sebastia,9998,0,9999,1
1713521783748,MATH 197,001,523477,Kedlaya; Kiran S.,9999,0,9999,0
1713521783748,MATH 197,002,563811,Zhang; Danna,9998,0,9999,1
1713521784774,MCWP 40R,A00,518780,Staff,13,0,20,7
1713521784774,MCWP 40R,B00,518781,Staff,11,0,20,9
1713521784774,MCWP 40R,C00,518783,Staff,8,0,20,12
1713521785804,MCWP 50R,A00,518791,Staff,7,0,20,13
1713521785804,MCWP 50R,B00,518792,Staff,3,0,20,17
1713521785804,MCWP 50R,C00,518793,Staff,5,0,20,15
1713521785804,MCWP 50R,D00,518794,Staff,0,0,20,20
1713521785804,MCWP 50R,E00,518795,Staff,0,0,20,20
1713521785804,MCWP 50R,F00,518796,Staff,10,0,20,10
1713521785804,MCWP 50R,G00,518797,Staff,10,0,20,10
1713521786829,MMW 12R,A01,514034,Herbst; Matthew,1,0,16,15
1713521786829,MMW 12R,A02,514035,Herbst; Matthew,13,0,16,3
1713521787859,MMW 13R,A01,514037,Staff,0,8,16,16
1713521787859,MMW 13R,A02,514039,Staff,0,7,16,16
1713521789912,SIO 295LS,A00,523233,Staff,15,0,30,15
1713521790936,SIO 295S,A00,523232,Staff,15,0,30,15
1713521791962,SOCI 117,A01,494376,Staff,0,2,5,5
1713521792988,WES 237B,A00,494380,Staff,19,0,20,1
1713521795068,AESE 279B,A00,494370,Wade; Jon P,33,0,33,0
1713521796093,AIP 197,001,627712,Vespa; Emanuel Ignacio,9999,0,9999,0
1713521797122,ANAR 135S,A00,494369,Braswell; Geoffrey E.,0,0,0,0
1713521798147,CAT 124RS,A01,519847,Geibel; William,6,0,20,14
1713521799249,CAT 125RS,A01,515971,Geibel; William,6,0,20,14
1713521800274,CLRE 250,A00,511389,Morris; Sheldon,9996,0,9999,3
1713521801299,CLRE 251,A00,507176,Mehta; Ravindra L.,9996,0,9999,3
1713521801299,CLRE 251,B00,511410,Mehta; Ravindra L.,9998,0,9999,1
1713521802328,CLRE 252,A00,507189,Cuomo; Raphael Eduardo,9998,0,9999,1
1713521803352,CLRE 253,A00,507199,Vaida; Florin,9997,0,9999,2
1713521803352,CLRE 253,B00,507202,Vaida; Florin,9999,0,9999,0
1713521804376,CLRE 259,A00,507211,Patel; Hemal,9996,0,9999,3
1713521805405,CLRE 260,A00,507221,Cuomo; Raphael Eduardo,9999,0,9999,0
1713521806433,CLRE 297,001,507242,Cuomo; Raphael Eduardo,9999,0,9999,0
1713521807459,CSE 191,A00,516875,Minnes Kemp; Mor Mia,9999,0,9999,0
1713521808484,CSS 201S,A01,494383,Staff,35,0,35,0
1713521809515,CSS 202S,A01,494387,Staff,35,0,35,0
1713521810540,EAP 100,A00,516065,Staff,9792,0,9999,207
1713521811564,ECE 45,A01,507414,Staff,37,0,60,23
1713521812589,ECE 100,A01,507416,Baghdadchi; Saharnaz,0,0,20,20
1713521812589,ECE 100,A02,507418,Baghdadchi; Saharnaz,19,0,20,1
1713521813614,ECE 111,A01,507420,Staff,27,0,50,23
1713521814641,ECE 197,001,548057,Sievenpiper; Daniel F.,9998,0,9999,1
1713521815667,EDS 115,A00,507243,Choi; Bailey Miyeon,27,0,28,1
1713521816695,EDS 117,A01,494379,Staff,14,0,25,11
1713521817723,EDS 125,A00,507246,Hopkins; Megan Beth,27,0,30,3
1713521818750,EDS 128A,A01,507264,Fargason; Sharon Gayle,26,0,26,0
1713521819775,EDS 128B,A01,507293,Pappas; Elizabeth,30,0,30,0
1713521820804,EDS 139,A00,507294,Fargason; Sharon Gayle,30,0,30,0
1713521820804,EDS 139,B00,507313,Pappas; Elizabeth,30,0,30,0
1713521821829,EDS 201,A00,507315,Staff,18,0,30,12
1713521822859,EDS 203,A01,507317,Halter; Christopher P.,17,0,30,13
1713521823893,EDS 204R,A01,507319,Halter; Christopher P.,0,1,30,30
1713521823893,EDS 204R,B01,507331,Heinzman; Erica M.,22,0,30,8
1713521824922,EDS 206R,A00,507332,Staff,0,2,30,30
1713521824922,EDS 206R,B00,507343,Staff,23,0,30,7
1713521825948,EDS 250,A00,507344,Hemans; Patricia Ann Benitez,27,0,40,13
1713521826977,EDS 281,A00,507345,Daly; Alan J.,18,0,18,0
1713521828001,EDS 284,A00,507350,Daly; Alan J.,16,0,16,0
1713521829033,EDS 286,A00,507359,Fine; Sarah,18,0,18,0
1713521830060,EDS 289C,A01,507361,Daly; Alan J.,18,0,18,0
1713521831088,EDS 290,A00,507366,Hofstetter; Carolyn,15,0,15,0
1713521832117,LIGM 5A,A00,507421,Fischer-Grunski; Eva K,20,0,20,0
1713521833146,LIGM 5B,A00,507423,Fischer-Grunski; Eva K,20,0,20,0
1713521834175,LIGM 5C,A00,507425,Fischer-Grunski; Eva K,20,0,20,0
1713521835201,LIIT 5AS,A00,507427,Carnelos; Chiara,20,0,20,0
1713521836226,LIIT 5BS,A00,507430,Carnelos; Chiara,20,0,20,0
1713521837251,LIIT 5CS,A00,507432,Carnelos; Chiara,20,0,20,0
1713521838277,LISP 5A,A00,507541,Munoz Sanchez; Alicia,14,0,20,6
1713521839306,LISP 5B,A00,507671,Munoz Sanchez; Alicia,12,0,20,8
1713521840330,LISP 5C,A00,507696,Munoz Sanchez; Alicia,11,0,20,9
1713521841356,MAE 197,001,528363,Boechler; Nicholas Sebastia,9998,0,9999,1
1713521842383,MATH 197,001,523477,Kedlaya; Kiran S.,9999,0,9999,0
1713521842383,MATH 197,002,563811,Zhang; Danna,9998,0,9999,1
1713521843408,MCWP 40R,A00,518780,Staff,13,0,20,7
1713521843408,MCWP 40R,B00,518781,Staff,11,0,20,9
1713521843408,MCWP 40R,C00,518783,Staff,8,0,20,12
1713521844435,MCWP 50R,A00,518791,Staff,7,0,20,13
1713521844435,MCWP 50R,B00,518792,Staff,3,0,20,17
1713521844435,MCWP 50R,C00,518793,Staff,5,0,20,15
1713521844435,MCWP 50R,D00,518794,Staff,0,0,20,20
1713521844435,MCWP 50R,E00,518795,Staff,0,0,20,20
1713521844435,MCWP 50R,F00,518796,Staff,10,0,20,10
1713521844435,MCWP 50R,G00,518797,Staff,10,0,20,10
1713521845460,MMW 12R,A01,514034,Herbst; Matthew,1,0,16,15
1713521845460,MMW 12R,A02,514035,Herbst; Matthew,13,0,16,3
1713521846485,MMW 13R,A01,514037,Staff,0,8,16,16
1713521846485,MMW 13R,A02,514039,Staff,0,7,16,16
1713521848538,SIO 295LS,A00,523233,Staff,15,0,30,15
1713521849564,SIO 295S,A00,523232,Staff,15,0,30,15
1713521850591,SOCI 117,A01,494376,Staff,0,2,5,5
1713521851616,WES 237B,A00,494380,Staff,19,0,20,1
1713521853682,AESE 279B,A00,494370,Wade; Jon P,33,0,33,0
1713521854710,AIP 197,001,627712,Vespa; Emanuel Ignacio,9999,0,9999,0
1713521855735,ANAR 135S,A00,494369,Braswell; Geoffrey E.,0,0,0,0
1713521856765,CAT 124RS,A01,519847,Geibel; William,6,0,20,14
1713521857793,CAT 125RS,A01,515971,Geibel; William,6,0,20,14
1713521858820,CLRE 250,A00,511389,Morris; Sheldon,9996,0,9999,3
1713521859849,CLRE 251,A00,507176,Mehta; Ravindra L.,9996,0,9999,3
1713521859849,CLRE 251,B00,511410,Mehta; Ravindra L.,9998,0,9999,1
1713521860874,CLRE 252,A00,507189,Cuomo; Raphael Eduardo,9998,0,9999,1
1713521861900,CLRE 253,A00,507199,Vaida; Florin,9997,0,9999,2
1713521861900,CLRE 253,B00,507202,Vaida; Florin,9999,0,9999,0
1713521862926,CLRE 259,A00,507211,Patel; Hemal,9996,0,9999,3
1713521863955,CLRE 260,A00,507221,Cuomo; Raphael Eduardo,9999,0,9999,0
1713521864984,CLRE 297,001,507242,Cuomo; Raphael Eduardo,9999,0,9999,0
1713521866009,CSE 191,A00,516875,Minnes Kemp; Mor Mia,9999,0,9999,0
1713521867055,CSS 201S,A01,494383,Staff,35,0,35,0
1713521868082,CSS 202S,A01,494387,Staff,35,0,35,0
1713521869107,EAP 100,A00,516065,Staff,9792,0,9999,207
1713521870133,ECE 45,A01,507414,Staff,37,0,60,23
1713521871163,ECE 100,A01,507416,Baghdadchi; Saharnaz,0,0,20,20
1713521871163,ECE 100,A02,507418,Baghdadchi; Saharnaz,19,0,20,1
1713521872188,ECE 111,A01,507420,Staff,27,0,50,23
1713521873216,ECE 197,001,548057,Sievenpiper; Daniel F.,9998,0,9999,1
1713521874243,EDS 115,A00,507243,Choi; Bailey Miyeon,27,0,28,1
1713521875273,EDS 117,A01,494379,Staff,14,0,25,11
1713521876309,EDS 125,A00,507246,Hopkins; Megan Beth,27,0,30,3
1713521877339,EDS 128A,A01,507264,Fargason; Sharon Gayle,26,0,26,0
1713521878368,EDS 128B,A01,507293,Pappas; Elizabeth,30,0,30,0
1713521879397,EDS 139,A00,507294,Fargason; Sharon Gayle,30,0,30,0
1713521879397,EDS 139,B00,507313,Pappas; Elizabeth,30,0,30,0
1713521880421,EDS 201,A00,507315,Staff,18,0,30,12
1713521881452,EDS 203,A01,507317,Halter; Christopher P.,17,0,30,13
1713521882483,EDS 204R,A01,507319,Halter; Christopher P.,0,1,30,30
1713521882483,EDS 204R,B01,507331,Heinzman; Erica M.,22,0,30,8
1713521883510,EDS 206R,A00,507332,Staff,0,2,30,30
1713521883510,EDS 206R,B00,507343,Staff,23,0,30,7
1713521884539,EDS 250,A00,507344,Hemans; Patricia Ann Benitez,27,0,40,13
1713521885564,EDS 281,A00,507345,Daly; Alan J.,18,0,18,0
1713521886590,EDS 284,A00,507350,Daly; Alan J.,16,0,16,0
1713521887625,EDS 286,A00,507359,Fine; Sarah,18,0,18,0
1713521888649,EDS 289C,A01,507361,Daly; Alan J.,18,0,18,0
1713521889680,EDS 290,A00,507366,Hofstetter; Carolyn,15,0,15,0
1713521890714,LIGM 5A,A00,507421,Fischer-Grunski; Eva K,20,0,20,0
1713521891742,LIGM 5B,A00,507423,Fischer-Grunski; Eva K,20,0,20,0
1713521892768,LIGM 5C,A00,507425,Fischer-Grunski; Eva K,20,0,20,0
1713521893794,LIIT 5AS,A00,507427,Carnelos; Chiara,20,0,20,0
1713521894821,LIIT 5BS,A00,507430,Carnelos; Chiara,20,0,20,0
1713521895848,LIIT 5CS,A00,507432,Carnelos; Chiara,20,0,20,0
1713521896875,LISP 5A,A00,507541,Munoz Sanchez; Alicia,14,0,20,6
1713521897900,LISP 5B,A00,507671,Munoz Sanchez; Alicia,12,0,20,8
1713521898931,LISP 5C,A00,507696,Munoz Sanchez; Alicia,11,0,20,9
1713521899957,MAE 197,001,528363,Boechler; Nicholas Sebastia,9998,0,9999,1
1713521900985,MATH 197,001,523477,Kedlaya; Kiran S.,9999,0,9999,0
1713521900985,MATH 197,002,563811,Zhang; Danna,9998,0,9999,1
1713521902011,MCWP 40R,A00,518780,Staff,13,0,20,7
1713521902011,MCWP 40R,B00,518781,Staff,11,0,20,9
1713521902011,MCWP 40R,C00,518783,Staff,8,0,20,12
1713521903098,MCWP 50R,A00,518791,Staff,7,0,20,13
1713521903098,MCWP 50R,B00,518792,Staff,3,0,20,17
1713521903098,MCWP 50R,C00,518793,Staff,5,0,20,15
1713521903098,MCWP 50R,D00,518794,Staff,0,0,20,20
1713521903098,MCWP 50R,E00,518795,Staff,0,0,20,20
1713521903098,MCWP 50R,F00,518796,Staff,10,0,20,10
1713521903098,MCWP 50R,G00,518797,Staff,10,0,20,10
1713521904124,MMW 12R,A01,514034,Herbst; Matthew,1,0,16,15
1713521904124,MMW 12R,A02,514035,Herbst; Matthew,13,0,16,3
1713521905151,MMW 13R,A01,514037,Staff,0,8,16,16
1713521905151,MMW 13R,A02,514039,Staff,0,7,16,16
1713521907203,SIO 295LS,A00,523233,Staff,15,0,30,15
1713521908228,SIO 295S,A00,523232,Staff,15,0,30,15
1713521909253,SOCI 117,A01,494376,Staff,0,2,5,5
1713521910278,WES 237B,A00,494380,Staff,19,0,20,1
1713521912345,AESE 279B,A00,494370,Wade; Jon P,33,0,33,0
1713521913372,AIP 197,001,627712,Vespa; Emanuel Ignacio,9999,0,9999,0
1713521914395,ANAR 135S,A00,494369,Braswell; Geoffrey E.,0,0,0,0
1713521915423,CAT 124RS,A01,519847,Geibel; William,6,0,20,14
1713521916452,CAT 125RS,A01,515971,Geibel; William,6,0,20,14
1713521917480,CLRE 250,A00,511389,Morris; Sheldon,9996,0,9999,3
1713521918509,CLRE 251,A00,507176,Mehta; Ravindra L.,9996,0,9999,3
1713521918509,CLRE 251,B00,511410,Mehta; Ravindra L.,9998,0,9999,1
1713521919534,CLRE 252,A00,507189,Cuomo; Raphael Eduardo,9998,0,9999,1
1713521920561,CLRE 253,A00,507199,Vaida; Florin,9997,0,9999,2
1713521920561,CLRE 253,B00,507202,Vaida; Florin,9999,0,9999,0
1713521921587,CLRE 259,A00,507211,Patel; Hemal,9996,0,9999,3
1713521922613,CLRE 260,A00,507221,Cuomo; Raphael Eduardo,9999,0,9999,0
1713521923638,CLRE 297,001,507242,Cuomo; Raphael Eduardo,9999,0,9999,0
1713521924665,CSE 191,A00,516875,Minnes Kemp; Mor Mia,9999,0,9999,0
1713521925693,CSS 201S,A01,494383,Staff,35,0,35,0
1713521926722,CSS 202S,A01,494387,Staff,35,0,35,0
1713521927745,EAP 100,A00,516065,Staff,9792,0,9999,207
1713521928775,ECE 45,A01,507414,Staff,37,0,60,23
1713521929801,ECE 100,A01,507416,Baghdadchi; Saharnaz,0,0,20,20
1713521929801,ECE 100,A02,507418,Baghdadchi; Saharnaz,19,0,20,1
1713521930831,ECE 111,A01,507420,Staff,27,0,50,23
1713521931856,ECE 197,001,548057,Sievenpiper; Daniel F.,9998,0,9999,1
1713521932893,EDS 115,A00,507243,Choi; Bailey Miyeon,27,0,28,1
1713521933919,EDS 117,A01,494379,Staff,14,0,25,11
1713521934944,EDS 125,A00,507246,Hopkins; Megan Beth,27,0,30,3
1713521935974,EDS 128A,A01,507264,Fargason; Sharon Gayle,26,0,26,0
1713521937004,EDS 128B,A01,507293,Pappas; Elizabeth,30,0,30,0
1713521938029,EDS 139,A00,507294,Fargason; Sharon Gayle,30,0,30,0
1713521938029,EDS 139,B00,507313,Pappas; Elizabeth,30,0,30,0
1713521939057,EDS 201,A00,507315,Staff,18,0,30,12
1713521940099,EDS 203,A01,507317,Halter; Christopher P.,17,0,30,13
1713521941124,EDS 204R,A01,507319,Halter; Christopher P.,0,1,30,30
1713521941124,EDS 204R,B01,507331,Heinzman; Erica M.,22,0,30,8
1713521942148,EDS 206R,A00,507332,Staff,0,2,30,30
1713521942148,EDS 206R,B00,507343,Staff,23,0,30,7
1713521943184,EDS 250,A00,507344,Hemans; Patricia Ann Benitez,27,0,40,13
1713521944209,EDS 281,A00,507345,Daly; Alan J.,18,0,18,0
1713521945240,EDS 284,A00,507350,Daly; Alan J.,16,0,16,0
1713521946265,EDS 286,A00,507359,Fine; Sarah,18,0,18,0
1713521947295,EDS 289C,A01,507361,Daly; Alan J.,18,0,18,0
1713521948323,EDS 290,A00,507366,Hofstetter; Carolyn,15,0,15,0
1713521949349,LIGM 5A,A00,507421,Fischer-Grunski; Eva K,20,0,20,0
1713521950374,LIGM 5B,A00,507423,Fischer-Grunski; Eva K,20,0,20,0
1713521951405,LIGM 5C,A00,507425,Fischer-Grunski; Eva K,20,0,20,0
1713521952434,LIIT 5AS,A00,507427,Carnelos; Chiara,20,0,20,0
1713521953457,LIIT 5BS,A00,507430,Carnelos; Chiara,20,0,20,0
1713521954482,LIIT 5CS,A00,507432,Carnelos; Chiara,20,0,20,0
1713521955506,LISP 5A,A00,507541,Munoz Sanchez; Alicia,14,0,20,6
1713521956530,LISP 5B,A00,507671,Munoz Sanchez; Alicia,12,0,20,8
1713521957560,LISP 5C,A00,507696,Munoz Sanchez; Alicia,11,0,20,9
1713521958586,MAE 197,001,528363,Boechler; Nicholas Sebastia,9998,0,9999,1
1713521959614,MATH 197,001,523477,Kedlaya; Kiran S.,9999,0,9999,0
1713521959614,MATH 197,002,563811,Zhang; Danna,9998,0,9999,1
1713521960640,MCWP 40R,A00,518780,Staff,13,0,20,7
1713521960640,MCWP 40R,B00,518781,Staff,11,0,20,9
1713521960640,MCWP 40R,C00,518783,Staff,8,0,20,12
1713521961670,MCWP 50R,A00,518791,Staff,7,0,20,13
1713521961670,MCWP 50R,B00,518792,Staff,3,0,20,17
1713521961670,MCWP 50R,C00,518793,Staff,5,0,20,15
1713521961670,MCWP 50R,D00,518794,Staff,0,0,20,20
1713521961670,MCWP 50R,E00,518795,Staff,0,0,20,20
1713521961670,MCWP 50R,F00,518796,Staff,10,0,20,10
1713521961670,MCWP 50R,G00,518797,Staff,10,0,20,10
1713521962702,MMW 12R,A01,514034,Herbst; Matthew,1,0,16,15
1713521962702,MMW 12R,A02,514035,Herbst; Matthew,13,0,16,3
1713521963728,MMW 13R,A01,514037,Staff,0,8,16,16
1713521963728,MMW 13R,A02,514039,Staff,0,7,16,16
1713521965780,SIO 295LS,A00,523233,Staff,15,0,30,15
1713521966809,SIO 295S,A00,523232,Staff,15,0,30,15
1713521967837,SOCI 117,A01,494376,Staff,0,2,5,5
1713521968862,WES 237B,A00,494380,Staff,19,0,20,1
1713521970951,AESE 279B,A00,494370,Wade; Jon P,33,0,33,0
1713521971983,AIP 197,001,627712,Vespa; Emanuel Ignacio,9999,0,9999,0
1713521973009,ANAR 135S,A00,494369,Braswell; Geoffrey E.,0,0,0,0
1713521974037,CAT 124RS,A01,519847,Geibel; William,6,0,20,14
1713521975064,CAT 125RS,A01,515971,Geibel; William,6,0,20,14
1713521976091,CLRE 250,A00,511389,Morris; Sheldon,9996,0,9999,3
1713521977124,CLRE 251,A00,507176,Mehta; Ravindra L.,9996,0,9999,3
1713521977124,CLRE 251,B00,511410,Mehta; Ravindra L.,9998,0,9999,1
1713521978151,CLRE 252,A00,507189,Cuomo; Raphael Eduardo,9998,0,9999,1
1713521979178,CLRE 253,A00,507199,Vaida; Florin,9997,0,9999,2
1713521979178,CLRE 253,B00,507202,Vaida; Florin,9999,0,9999,0
1713521980204,CLRE 259,A00,507211,Patel; Hemal,9996,0,9999,3
1713521981232,CLRE 260,A00,507221,Cuomo; Raphael Eduardo,9999,0,9999,0
1713521982255,CLRE 297,001,507242,Cuomo; Raphael Eduardo,9999,0,9999,0
1713521983279,CSE 191,A00,516875,Minnes Kemp; Mor Mia,9999,0,9999,0
1713521984307,CSS 201S,A01,494383,Staff,35,0,35,0
1713521985333,CSS 202S,A01,494387,Staff,35,0,35,0
1713521986357,EAP 100,A00,516065,Staff,9792,0,9999,207
1713521987384,ECE 45,A01,507414,Staff,37,0,60,23
1713521988415,ECE 100,A01,507416,Baghdadchi; Saharnaz,0,0,20,20
1713521988415,ECE 100,A02,507418,Baghdadchi; Saharnaz,19,0,20,1
1713521989441,ECE 111,A01,507420,Staff,27,0,50,23
1713521990472,ECE 197,001,548057,Sievenpiper; Daniel F.,9998,0,9999,1
1713521991503,EDS 115,A00,507243,Choi; Bailey Miyeon,27,0,28,1
1713521992530,EDS 117,A01,494379,Staff,14,0,25,11
1713521993556,EDS 125,A00,507246,Hopkins; Megan Beth,27,0,30,3
1713521994583,EDS 128A,A01,507264,Fargason; Sharon Gayle,26,0,26,0
1713521995616,EDS 128B,A01,507293,Pappas; Elizabeth,30,0,30,0
1713521996644,EDS 139,A00,507294,Fargason; Sharon Gayle,30,0,30,0
1713521996644,EDS 139,B00,507313,Pappas; Elizabeth,30,0,30,0
1713521997670,EDS 201,A00,507315,Staff,18,0,30,12
1713521998697,EDS 203,A01,507317,Halter; Christopher P.,17,0,30,13
1713521999727,EDS 204R,A01,507319,Halter; Christopher P.,0,1,30,30
1713521999727,EDS 204R,B01,507331,Heinzman; Erica M.,22,0,30,8
1713522000758,EDS 206R,A00,507332,Staff,0,2,30,30
1713522000758,EDS 206R,B00,507343,Staff,23,0,30,7
1713522001792,EDS 250,A00,507344,Hemans; Patricia Ann Benitez,27,0,40,13
1713522002821,EDS 281,A00,507345,Daly; Alan J.,18,0,18,0
1713522003848,EDS 284,A00,507350,Daly; Alan J.,16,0,16,0
1713522004879,EDS 286,A00,507359,Fine; Sarah,18,0,18,0
1713522005906,EDS 289C,A01,507361,Daly; Alan J.,18,0,18,0
1713522006987,EDS 290,A00,507366,Hofstetter; Carolyn,15,0,15,0
1713522008015,LIGM 5A,A00,507421,Fischer-Grunski; Eva K,20,0,20,0
1713522009046,LIGM 5B,A00,507423,Fischer-Grunski; Eva K,20,0,20,0
1713522010076,LIGM 5C,A00,507425,Fischer-Grunski; Eva K,20,0,20,0
1713522011105,LIIT 5AS,A00,507427,Carnelos; Chiara,20,0,20,0
1713522012134,LIIT 5BS,A00,507430,Carnelos; Chiara,20,0,20,0
1713522013160,LIIT 5CS,A00,507432,Carnelos; Chiara,20,0,20,0
1713522014190,LISP 5A,A00,507541,Munoz Sanchez; Alicia,14,0,20,6
1713522015219,LISP 5B,A00,507671,Munoz Sanchez; Alicia,12,0,20,8
1713522016244,LISP 5C,A00,507696,Munoz Sanchez; Alicia,11,0,20,9
1713522017269,MAE 197,001,528363,Boechler; Nicholas Sebastia,9998,0,9999,1
1713522018296,MATH 197,001,523477,Kedlaya; Kiran S.,9999,0,9999,0
1713522018296,MATH 197,002,563811,Zhang; Danna,9998,0,9999,1
1713522019327,MCWP 40R,A00,518780,Staff,13,0,20,7
1713522019327,MCWP 40R,B00,518781,Staff,11,0,20,9
1713522019327,MCWP 40R,C00,518783,Staff,8,0,20,12
1713522020358,MCWP 50R,A00,518791,Staff,7,0,20,13
1713522020358,MCWP 50R,B00,518792,Staff,3,0,20,17
1713522020358,MCWP 50R,C00,518793,Staff,5,0,20,15
1713522020358,MCWP 50R,D00,518794,Staff,0,0,20,20
1713522020358,MCWP 50R,E00,518795,Staff,0,0,20,20
1713522020358,MCWP 50R,F00,518796,Staff,10,0,20,10
1713522020358,MCWP 50R,G00,518797,Staff,10,0,20,10
1713522021384,MMW 12R,A01,514034,Herbst; Matthew,1,0,16,15
1713522021384,MMW 12R,A02,514035,Herbst; Matthew,13,0,16,3
1713522022413,MMW 13R,A01,514037,Staff,0,8,16,16
1713522022413,MMW 13R,A02,514039,Staff,0,7,16,16
1713522024473,SIO 295LS,A00,523233,Staff,15,0,30,15
1713522025498,SIO 295S,A00,523232,Staff,15,0,30,15
1713522026527,SOCI 117,A01,494376,Staff,0,2,5,5
1713522027554,WES 237B,A00,494380,Staff,19,0,20,1
1713522029637,AESE 279B,A00,494370,Wade; Jon P,33,0,33,0
1713522030667,AIP 197,001,627712,Vespa; Emanuel Ignacio,9999,0,9999,0
1713522031692,ANAR 135S,A00,494369,Braswell; Geoffrey E.,0,0,0,0
1713522032718,CAT 124RS,A01,519847,Geibel; William,6,0,20,14
1713522033747,CAT 125RS,A01,515971,Geibel; William,6,0,20,14
1713522034774,CLRE 250,A00,511389,Morris; Sheldon,9996,0,9999,3
1713522035811,CLRE 251,A00,507176,Mehta; Ravindra L.,9996,0,9999,3
1713522035811,CLRE 251,B00,511410,Mehta; Ravindra L.,9998,0,9999,1
1713522036837,CLRE 252,A00,507189,Cuomo; Raphael Eduardo,9998,0,9999,1
1713522037867,CLRE 253,A00,507199,Vaida; Florin,9997,0,9999,2
1713522037867,CLRE 253,B00,507202,Vaida; Florin,9999,0,9999,0
1713522038896,CLRE 259,A00,507211,Patel; Hemal,9996,0,9999,3
1713522039925,CLRE 260,A00,507221,Cuomo; Raphael Eduardo,9999,0,9999,0
1713522040951,CLRE 297,001,507242,Cuomo; Raphael Eduardo,9999,0,9999,0
1713522041976,CSE 191,A00,516875,Minnes Kemp; Mor Mia,9999,0,9999,0
1713522043004,CSS 201S,A01,494383,Staff,35,0,35,0
1713522044030,CSS 202S,A01,494387,Staff,35,0,35,0
1713522045056,EAP 100,A00,516065,Staff,9792,0,9999,207
1713522046086,ECE 45,A01,507414,Staff,37,0,60,23
1713522047112,ECE 100,A01,507416,Baghdadchi; Saharnaz,0,0,20,20
1713522047112,ECE 100,A02,507418,Baghdadchi; Saharnaz,19,0,20,1
1713522048143,ECE 111,A01,507420,Staff,27,0,50,23
1713522049172,ECE 197,001,548057,Sievenpiper; Daniel F.,9998,0,9999,1
1713522050199,EDS 115,A00,507243,Choi; Bailey Miyeon,27,0,28,1
1713522051228,EDS 117,A01,494379,Staff,14,0,25,11
1713522052257,EDS 125,A00,507246,Hopkins; Megan Beth,27,0,30,3
1713522053289,EDS 128A,A01,507264,Fargason; Sharon Gayle,26,0,26,0
1713522054315,EDS 128B,A01,507293,Pappas; Elizabeth,30,0,30,0
1713522055341,EDS 139,A00,507294,Fargason; Sharon Gayle,30,0,30,0
1713522055341,EDS 139,B00,507313,Pappas; Elizabeth,30,0,30,0
1713522056370,EDS 201,A00,507315,Staff,18,0,30,12
1713522057397,EDS 203,A01,507317,Halter; Christopher P.,17,0,30,13
1713522058423,EDS 204R,A01,507319,Halter; Christopher P.,0,1,30,30
1713522058423,EDS 204R,B01,507331,Heinzman; Erica M.,22,0,30,8
1713522059448,EDS 206R,A00,507332,Staff,0,2,30,30
1713522059448,EDS 206R,B00,507343,Staff,23,0,30,7
1713522060482,EDS 250,A00,507344,Hemans; Patricia Ann Benitez,27,0,40,13
1713522061508,EDS 281,A00,507345,Daly; Alan J.,18,0,18,0
1713522062534,EDS 284,A00,507350,Daly; Alan J.,16,0,16,0
1713522063565,EDS 286,A00,507359,Fine; Sarah,18,0,18,0
1713522064592,EDS 289C,A01,507361,Daly; Alan J.,18,0,18,0
1713522065621,EDS 290,A00,507366,Hofstetter; Carolyn,15,0,15,0
1713522066651,LIGM 5A,A00,507421,Fischer-Grunski; Eva K,20,0,20,0
1713522067677,LIGM 5B,A00,507423,Fischer-Grunski; Eva K,20,0,20,0
1713522068703,LIGM 5C,A00,507425,Fischer-Grunski; Eva K,20,0,20,0
1713522069732,LIIT 5AS,A00,507427,Carnelos; Chiara,20,0,20,0
1713522070763,LIIT 5BS,A00,507430,Carnelos; Chiara,20,0,20,0
1713522071791,LIIT 5CS,A00,507432,Carnelos; Chiara,20,0,20,0
1713522072819,LISP 5A,A00,507541,Munoz Sanchez; Alicia,14,0,20,6
1713522073849,LISP 5B,A00,507671,Munoz Sanchez; Alicia,12,0,20,8
1713522074873,LISP 5C,A00,507696,Munoz Sanchez; Alicia,11,0,20,9
1713522075900,MAE 197,001,528363,Boechler; Nicholas Sebastia,9998,0,9999,1
1713522076927,MATH 197,001,523477,Kedlaya; Kiran S.,9999,0,9999,0
1713522076927,MATH 197,002,563811,Zhang; Danna,9998,0,9999,1
1713522077958,MCWP 40R,A00,518780,Staff,13,0,20,7
1713522077958,MCWP 40R,B00,518781,Staff,11,0,20,9
1713522077958,MCWP 40R,C00,518783,Staff,8,0,20,12
1713522078990,MCWP 50R,A00,518791,Staff,7,0,20,13
1713522078990,MCWP 50R,B00,518792,Staff,3,0,20,17
1713522078990,MCWP 50R,C00,518793,Staff,5,0,20,15
1713522078990,MCWP 50R,D00,518794,Staff,0,0,20,20
1713522078990,MCWP 50R,E00,518795,Staff,0,0,20,20
1713522078990,MCWP 50R,F00,518796,Staff,10,0,20,10
1713522078990,MCWP 50R,G00,518797,Staff,10,0,20,10
1713522080017,MMW 12R,A01,514034,Herbst; Matthew,1,0,16,15
1713522080017,MMW 12R,A02,514035,Herbst; Matthew,13,0,16,3
1713522081042,MMW 13R,A01,514037,Staff,0,8,16,16
1713522081042,MMW 13R,A02,514039,Staff,0,7,16,16
1713522083097,SIO 295LS,A00,523233,Staff,15,0,30,15
1713522084127,SIO 295S,A00,523232,Staff,15,0,30,15
1713522085158,SOCI 117,A01,494376,Staff,0,2,5,5
1713522086191,WES 237B,A00,494380,Staff,19,0,20,1
1713522088266,AESE 279B,A00,494370,Wade; Jon P,33,0,33,0
1713522089293,AIP 197,001,627712,Vespa; Emanuel Ignacio,9999,0,9999,0
1713522090323,ANAR 135S,A00,494369,Braswell; Geoffrey E.,0,0,0,0
1713522091350,CAT 124RS,A01,519847,Geibel; William,6,0,20,14
1713522092380,CAT 125RS,A01,515971,Geibel; William,6,0,20,14
1713522093409,CLRE 250,A00,511389,Morris; Sheldon,9996,0,9999,3
1713522094444,CLRE 251,A00,507176,Mehta; Ravindra L.,9996,0,9999,3
1713522094444,CLRE 251,B00,511410,Mehta; Ravindra L.,9998,0,9999,1
1713522095470,CLRE 252,A00,507189,Cuomo; Raphael Eduardo,9998,0,9999,1
1713522096503,CLRE 253,A00,507199,Vaida; Florin,9997,0,9999,2
1713522096503,CLRE 253,B00,507202,Vaida; Florin,9999,0,9999,0
1713522097528,CLRE 259,A00,507211,Patel; Hemal,9996,0,9999,3
1713522098552,CLRE 260,A00,507221,Cuomo; Raphael Eduardo,9999,0,9999,0
1713522099580,CLRE 297,001,507242,Cuomo; Raphael Eduardo,9999,0,9999,0
1713522100606,CSE 191,A00,516875,Minnes Kemp; Mor Mia,9999,0,9999,0
1713522101632,CSS 201S,A01,494383,Staff,35,0,35,0
1713522102659,CSS 202S,A01,494387,Staff,35,0,35,0
1713522103686,EAP 100,A00,516065,Staff,9792,0,9999,207
1713522104714,ECE 45,A01,507414,Staff,37,0,60,23
1713522105743,ECE 100,A01,507416,Baghdadchi; Saharnaz,0,0,20,20
1713522105743,ECE 100,A02,507418,Baghdadchi; Saharnaz,19,0,20,1
1713522106769,ECE 111,A01,507420,Staff,27,0,50,23
1713522107795,ECE 197,001,548057,Sievenpiper; Daniel F.,9998,0,9999,1
1713522108826,EDS 115,A00,507243,Choi; Bailey Miyeon,27,0,28,1
1713522109853,EDS 117,A01,494379,Staff,14,0,25,11
1713522110942,EDS 125,A00,507246,Hopkins; Megan Beth,27,0,30,3
1713522111971,EDS 128A,A01,507264,Fargason; Sharon Gayle,26,0,26,0
1713522112999,EDS 128B,A01,507293,Pappas; Elizabeth,30,0,30,0
1713522114027,EDS 139,A00,507294,Fargason; Sharon Gayle,30,0,30,0
1713522114027,EDS 139,B00,507313,Pappas; Elizabeth,30,0,30,0
1713522115051,EDS 201,A00,507315,Staff,18,0,30,12
1713522116076,EDS 203,A01,507317,Halter; Christopher P.,17,0,30,13
1713522117101,EDS 204R,A01,507319,Halter; Christopher P.,0,1,30,30
1713522117101,EDS 204R,B01,507331,Heinzman; Erica M.,22,0,30,8
1713522118127,EDS 206R,A00,507332,Staff,0,2,30,30
1713522118127,EDS 206R,B00,507343,Staff,23,0,30,7
1713522119153,EDS 250,A00,507344,Hemans; Patricia Ann Benitez,27,0,40,13
1713522120178,EDS 281,A00,507345,Daly; Alan J.,18,0,18,0
1713522121205,EDS 284,A00,507350,Daly; Alan J.,16,0,16,0
1713522122232,EDS 286,A00,507359,Fine; Sarah,18,0,18,0
1713522123257,EDS 289C,A01,507361,Daly; Alan J.,18,0,18,0
1713522124285,EDS 290,A00,507366,Hofstetter; Carolyn,15,0,15,0
1713522125310,LIGM 5A,A00,507421,Fischer-Grunski; Eva K,20,0,20,0
1713522126336,LIGM 5B,A00,507423,Fischer-Grunski; Eva K,20,0,20,0
1713522127361,LIGM 5C,A00,507425,Fischer-Grunski; Eva K,20,0,20,0
1713522128386,LIIT 5AS,A00,507427,Carnelos; Chiara,20,0,20,0
1713522129415,LIIT 5BS,A00,507430,Carnelos; Chiara,20,0,20,0
1713522130441,LIIT 5CS,A00,507432,Carnelos; Chiara,20,0,20,0
1713522131466,LISP 5A,A00,507541,Munoz Sanchez; Alicia,14,0,20,6
1713522132492,LISP 5B,A00,507671,Munoz Sanchez; Alicia,12,0,20,8
1713522133522,LISP 5C,A00,507696,Munoz Sanchez; Alicia,11,0,20,9
1713522134552,MAE 197,001,528363,Boechler; Nicholas Sebastia,9998,0,9999,1
1713522135583,MATH 197,001,523477,Kedlaya; Kiran S.,9999,0,9999,0
1713522135583,MATH 197,002,563811,Zhang; Danna,9998,0,9999,1
1713522136613,MCWP 40R,A00,518780,Staff,13,0,20,7
1713522136613,MCWP 40R,B00,518781,Staff,11,0,20,9
1713522136613,MCWP 40R,C00,518783,Staff,8,0,20,12
1713522137639,MCWP 50R,A00,518791,Staff,7,0,20,13
1713522137639,MCWP 50R,B00,518792,Staff,3,0,20,17
1713522137639,MCWP 50R,C00,518793,Staff,5,0,20,15
1713522137639,MCWP 50R,D00,518794,Staff,0,0,20,20
1713522137639,MCWP 50R,E00,518795,Staff,0,0,20,20
1713522137639,MCWP 50R,F00,518796,Staff,10,0,20,10
1713522137639,MCWP 50R,G00,518797,Staff,10,0,20,10
1713522138665,MMW 12R,A01,514034,Herbst; Matthew,1,0,16,15
1713522138665,MMW 12R,A02,514035,Herbst; Matthew,13,0,16,3
1713522139690,MMW 13R,A01,514037,Staff,0,8,16,16
1713522139690,MMW 13R,A02,514039,Staff,0,7,16,16
1713522141744,SIO 295LS,A00,523233,Staff,15,0,30,15
1713522142769,SIO 295S,A00,523232,Staff,15,0,30,15
1713522143795,SOCI 117,A01,494376,Staff,0,2,5,5
1713522144819,WES 237B,A00,494380,Staff,19,0,20,1
1713522146890,AESE 279B,A00,494370,Wade; Jon P,33,0,33,0
1713522147920,AIP 197,001,627712,Vespa; Emanuel Ignacio,9999,0,9999,0
1713522148950,ANAR 135S,A00,494369,Braswell; Geoffrey E.,0,0,0,0
1713522149975,CAT 124RS,A01,519847,Geibel; William,6,0,20,14
1713522151005,CAT 125RS,A01,515971,Geibel; William,6,0,20,14
1713522152037,CLRE 250,A00,511389,Morris; Sheldon,9996,0,9999,3
1713522153066,CLRE 251,A00,507176,Mehta; Ravindra L.,9996,0,9999,3
1713522153066,CLRE 251,B00,511410,Mehta; Ravindra L.,9998,0,9999,1
1713522154099,CLRE 252,A00,507189,Cuomo; Raphael Eduardo,9998,0,9999,1
1713522155129,CLRE 253,A00,507199,Vaida; Florin,9997,0,9999,2
1713522155129,CLRE 253,B00,507202,Vaida; Florin,9999,0,9999,0
1713522156159,CLRE 259,A00,507211,Patel; Hemal,9996,0,9999,3
1713522157187,CLRE 260,A00,507221,Cuomo; Raphael Eduardo,9999,0,9999,0
1713522158211,CLRE 297,001,507242,Cuomo; Raphael Eduardo,9999,0,9999,0
1713522159237,CSE 191,A00,516875,Minnes Kemp; Mor Mia,9999,0,9999,0
1713522160265,CSS 201S,A01,494383,Staff,35,0,35,0
1713522161296,CSS 202S,A01,494387,Staff,35,0,35,0
1713522162325,EAP 100,A00,516065,Staff,9792,0,9999,207
1713522163351,ECE 45,A01,507414,Staff,37,0,60,23
1713522164376,ECE 100,A01,507416,Baghdadchi; Saharnaz,0,0,20,20
1713522164376,ECE 100,A02,507418,Baghdadchi; Saharnaz,19,0,20,1
1713522165401,ECE 111,A01,507420,Staff,27,0,50,23
1713522166427,ECE 197,001,548057,Sievenpiper; Daniel F.,9998,0,9999,1
1713522167456,EDS 115,A00,507243,Choi; Bailey Miyeon,27,0,28,1
1713522168486,EDS 117,A01,494379,Staff,14,0,25,11
1713522169511,EDS 125,A00,507246,Hopkins; Megan Beth,27,0,30,3
1713522170541,EDS 128A,A01,507264,Fargason; Sharon Gayle,26,0,26,0
1713522171565,EDS 128B,A01,507293,Pappas; Elizabeth,30,0,30,0
1713522172590,EDS 139,A00,507294,Fargason; Sharon Gayle,30,0,30,0
1713522172590,EDS 139,B00,507313,Pappas; Elizabeth,30,0,30,0
1713522173618,EDS 201,A00,507315,Staff,18,0,30,12
1713522174647,EDS 203,A01,507317,Halter; Christopher P.,17,0,30,13
1713522175672,EDS 204R,A01,507319,Halter; Christopher P.,0,1,30,30
1713522175672,EDS 204R,B01,507331,Heinzman; Erica M.,22,0,30,8
1713522176700,EDS 206R,A00,507332,Staff,0,2,30,30
1713522176700,EDS 206R,B00,507343,Staff,23,0,30,7
1713522177727,EDS 250,A00,507344,Hemans; Patricia Ann Benitez,27,0,40,13
1713522178757,EDS 281,A00,507345,Daly; Alan J.,18,0,18,0
1713522179785,EDS 284,A00,507350,Daly; Alan J.,16,0,16,0
1713522180810,EDS 286,A00,507359,Fine; Sarah,18,0,18,0
1713522181838,EDS 289C,A01,507361,Daly; Alan J.,18,0,18,0
1713522182864,EDS 290,A00,507366,Hofstetter; Carolyn,15,0,15,0
1713522183895,LIGM 5A,A00,507421,Fischer-Grunski; Eva K,20,0,20,0
1713522184926,LIGM 5B,A00,507423,Fischer-Grunski; Eva K,20,0,20,0
1713522185951,LIGM 5C,A00,507425,Fischer-Grunski; Eva K,20,0,20,0
1713522186977,LIIT 5AS,A00,507427,Carnelos; Chiara,20,0,20,0
1713522188001,LIIT 5BS,A00,507430,Carnelos; Chiara,20,0,20,0
1713522189027,LIIT 5CS,A00,507432,Carnelos; Chiara,20,0,20,0
1713522190053,LISP 5A,A00,507541,Munoz Sanchez; Alicia,14,0,20,6
1713522191079,LISP 5B,A00,507671,Munoz Sanchez; Alicia,12,0,20,8
1713522192108,LISP 5C,A00,507696,Munoz Sanchez; Alicia,11,0,20,9
1713522193135,MAE 197,001,528363,Boechler; Nicholas Sebastia,9998,0,9999,1
1713522194166,MATH 197,001,523477,Kedlaya; Kiran S.,9999,0,9999,0
1713522194166,MATH 197,002,563811,Zhang; Danna,9998,0,9999,1
1713522195194,MCWP 40R,A00,518780,Staff,13,0,20,7
1713522195194,MCWP 40R,B00,518781,Staff,11,0,20,9
1713522195194,MCWP 40R,C00,518783,Staff,8,0,20,12
1713522196220,MCWP 50R,A00,518791,Staff,7,0,20,13
1713522196220,MCWP 50R,B00,518792,Staff,3,0,20,17
1713522196220,MCWP 50R,C00,518793,Staff,5,0,20,15
1713522196220,MCWP 50R,D00,518794,Staff,0,0,20,20
1713522196220,MCWP 50R,E00,518795,Staff,0,0,20,20
1713522196220,MCWP 50R,F00,518796,Staff,10,0,20,10
1713522196220,MCWP 50R,G00,518797,Staff,10,0,20,10
1713522197244,MMW 12R,A01,514034,Herbst; Matthew,1,0,16,15
1713522197244,MMW 12R,A02,514035,Herbst; Matthew,13,0,16,3
1713522198269,MMW 13R,A01,514037,Staff,0,8,16,16
1713522198269,MMW 13R,A02,514039,Staff,0,7,16,16
1713522200320,SIO 295LS,A00,523233,Staff,15,0,30,15
1713522201345,SIO 295S,A00,523232,Staff,15,0,30,15
1713522202372,SOCI 117,A01,494376,Staff,0,2,5,5
1713522203400,WES 237B,A00,494380,Staff,19,0,20,1
1713522205481,AESE 279B,A00,494370,Wade; Jon P,33,0,33,0
1713522206507,AIP 197,001,627712,Vespa; Emanuel Ignacio,9999,0,9999,0
1713522207536,ANAR 135S,A00,494369,Braswell; Geoffrey E.,0,0,0,0
1713522208567,CAT 124RS,A01,519847,Geibel; William,6,0,20,14
1713522209595,CAT 125RS,A01,515971,Geibel; William,6,0,20,14
1713522210623,CLRE 250,A00,511389,Morris; Sheldon,9996,0,9999,3
1713522211656,CLRE 251,A00,507176,Mehta; Ravindra L.,9996,0,9999,3
1713522211656,CLRE 251,B00,511410,Mehta; Ravindra L.,9998,0,9999,1
1713522212686,CLRE 252,A00,507189,Cuomo; Raphael Eduardo,9998,0,9999,1
1713522213713,CLRE 253,A00,507199,Vaida; Florin,9997,0,9999,2
1713522213713,CLRE 253,B00,507202,Vaida; Florin,9999,0,9999,0
1713522214823,CLRE 259,A00,507211,Patel; Hemal,9996,0,9999,3
1713522215853,CLRE 260,A00,507221,Cuomo; Raphael Eduardo,9999,0,9999,0
1713522216879,CLRE 297,001,507242,Cuomo; Raphael Eduardo,9999,0,9999,0
1713522217910,CSE 191,A00,516875,Minnes Kemp; Mor Mia,9999,0,9999,0
1713522218941,CSS 201S,A01,494383,Staff,35,0,35,0
1713522219970,CSS 202S,A01,494387,Staff,35,0,35,0
1713522220997,EAP 100,A00,516065,Staff,9792,0,9999,207
1713522222033,ECE 45,A01,507414,Staff,37,0,60,23
1713522223058,ECE 100,A01,507416,Baghdadchi; Saharnaz,0,0,20,20
1713522223058,ECE 100,A02,507418,Baghdadchi; Saharnaz,19,0,20,1
1713522224084,ECE 111,A01,507420,Staff,27,0,50,23
1713522225111,ECE 197,001,548057,Sievenpiper; Daniel F.,9998,0,9999,1
1713522226140,EDS 115,A00,507243,Choi; Bailey Miyeon,27,0,28,1
1713522227166,EDS 117,A01,494379,Staff,14,0,25,11
1713522228193,EDS 125,A00,507246,Hopkins; Megan Beth,27,0,30,3
1713522229224,EDS 128A,A01,507264,Fargason; Sharon Gayle,26,0,26,0
1713522230250,EDS 128B,A01,507293,Pappas; Elizabeth,30,0,30,0
1713522231274,EDS 139,A00,507294,Fargason; Sharon Gayle,30,0,30,0
1713522231274,EDS 139,B00,507313,Pappas; Elizabeth,30,0,30,0
1713522232302,EDS 201,A00,507315,Staff,18,0,30,12
1713522233329,EDS 203,A01,507317,Halter; Christopher P.,17,0,30,13
1713522234358,EDS 204R,A01,507319,Halter; Christopher P.,0,1,30,30
1713522234358,EDS 204R,B01,507331,Heinzman; Erica M.,22,0,30,8
1713522235387,EDS 206R,A00,507332,Staff,0,2,30,30
1713522235387,EDS 206R,B00,507343,Staff,23,0,30,7
1713522236416,EDS 250,A00,507344,Hemans; Patricia Ann Benitez,27,0,40,13
1713522237443,EDS 281,A00,507345,Daly; Alan J.,18,0,18,0
1713522238471,EDS 284,A00,507350,Daly; Alan J.,16,0,16,0
1713522239502,EDS 286,A00,507359,Fine; Sarah,18,0,18,0
1713522240526,EDS 289C,A01,507361,Daly; Alan J.,18,0,18,0
1713522241561,EDS 290,A00,507366,Hofstetter; Carolyn,15,0,15,0
1713522242594,LIGM 5A,A00,507421,Fischer-Grunski; Eva K,20,0,20,0
1713522243621,LIGM 5B,A00,507423,Fischer-Grunski; Eva K,20,0,20,0
1713522244648,LIGM 5C,A00,507425,Fischer-Grunski; Eva K,20,0,20,0
1713522245679,LIIT 5AS,A00,507427,Carnelos; Chiara,20,0,20,0
1713522246707,LIIT 5BS,A00,507430,Carnelos; Chiara,20,0,20,0
1713522247732,LIIT 5CS,A00,507432,Carnelos; Chiara,20,0,20,0
1713522248760,LISP 5A,A00,507541,Munoz Sanchez; Alicia,14,0,20,6
1713522249785,LISP 5B,A00,507671,Munoz Sanchez; Alicia,12,0,20,8
1713522250814,LISP 5C,A00,507696,Munoz Sanchez; Alicia,11,0,20,9
1713522251842,MAE 197,001,528363,Boechler; Nicholas Sebastia,9998,0,9999,1
1713522252875,MATH 197,001,523477,Kedlaya; Kiran S.,9999,0,9999,0
1713522252875,MATH 197,002,563811,Zhang; Danna,9998,0,9999,1
1713522253904,MCWP 40R,A00,518780,Staff,13,0,20,7
1713522253904,MCWP 40R,B00,518781,Staff,11,0,20,9
1713522253904,MCWP 40R,C00,518783,Staff,8,0,20,12
1713522254934,MCWP 50R,A00,518791,Staff,7,0,20,13
1713522254934,MCWP 50R,B00,518792,Staff,3,0,20,17
1713522254934,MCWP 50R,C00,518793,Staff,5,0,20,15
1713522254934,MCWP 50R,D00,518794,Staff,0,0,20,20
1713522254934,MCWP 50R,E00,518795,Staff,0,0,20,20
1713522254934,MCWP 50R,F00,518796,Staff,10,0,20,10
1713522254934,MCWP 50R,G00,518797,Staff,10,0,20,10
1713522255961,MMW 12R,A01,514034,Herbst; Matthew,1,0,16,15
1713522255961,MMW 12R,A02,514035,Herbst; Matthew,13,0,16,3
1713522256990,MMW 13R,A01,514037,Staff,0,8,16,16
1713522256990,MMW 13R,A02,514039,Staff,0,7,16,16
1713522259043,SIO 295LS,A00,523233,Staff,15,0,30,15
1713522260067,SIO 295S,A00,523232,Staff,15,0,30,15
1713522261098,SOCI 117,A01,494376,Staff,0,2,5,5
1713522262124,WES 237B,A00,494380,Staff,19,0,20,1
1713522264210,AESE 279B,A00,494370,Wade; Jon P,33,0,33,0
1713522265237,AIP 197,001,627712,Vespa; Emanuel Ignacio,9999,0,9999,0
1713522266263,ANAR 135S,A00,494369,Braswell; Geoffrey E.,0,0,0,0
1713522267288,CAT 124RS,A01,519847,Geibel; William,6,0,20,14
1713522268316,CAT 125RS,A01,515971,Geibel; William,6,0,20,14
1713522269346,CLRE 250,A00,511389,Morris; Sheldon,9996,0,9999,3
1713522270379,CLRE 251,A00,507176,Mehta; Ravindra L.,9996,0,9999,3
1713522270379,CLRE 251,B00,511410,Mehta; Ravindra L.,9998,0,9999,1
1713522271407,CLRE 252,A00,507189,Cuomo; Raphael Eduardo,9998,0,9999,1
1713522272436,CLRE 253,A00,507199,Vaida; Florin,9997,0,9999,2
1713522272436,CLRE 253,B00,507202,Vaida; Florin,9999,0,9999,0
1713522273460,CLRE 259,A00,507211,Patel; Hemal,9996,0,9999,3
1713522274487,CLRE 260,A00,507221,Cuomo; Raphael Eduardo,9999,0,9999,0
1713522275516,CLRE 297,001,507242,Cuomo; Raphael Eduardo,9999,0,9999,0
1713522276549,CSE 191,A00,516875,Minnes Kemp; Mor Mia,9999,0,9999,0
1713522277576,CSS 201S,A01,494383,Staff,35,0,35,0
1713522278604,CSS 202S,A01,494387,Staff,35,0,35,0
1713522279629,EAP 100,A00,516065,Staff,9792,0,9999,207
1713522280654,ECE 45,A01,507414,Staff,37,0,60,23
1713522281685,ECE 100,A01,507416,Baghdadchi; Saharnaz,0,0,20,20
1713522281685,ECE 100,A02,507418,Baghdadchi; Saharnaz,19,0,20,1
1713522282712,ECE 111,A01,507420,Staff,27,0,50,23
1713522283739,ECE 197,001,548057,Sievenpiper; Daniel F.,9998,0,9999,1
1713522284764,EDS 115,A00,507243,Choi; Bailey Miyeon,27,0,28,1
1713522285794,EDS 117,A01,494379,Staff,14,0,25,11
1713522286821,EDS 125,A00,507246,Hopkins; Megan Beth,27,0,30,3
1713522287847,EDS 128A,A01,507264,Fargason; Sharon Gayle,26,0,26,0
1713522288877,EDS 128B,A01,507293,Pappas; Elizabeth,30,0,30,0
1713522289905,EDS 139,A00,507294,Fargason; Sharon Gayle,30,0,30,0
1713522289905,EDS 139,B00,507313,Pappas; Elizabeth,30,0,30,0
1713522290931,EDS 201,A00,507315,Staff,18,0,30,12
1713522291958,EDS 203,A01,507317,Halter; Christopher P.,17,0,30,13
1713522292985,EDS 204R,A01,507319,Halter; Christopher P.,0,1,30,30
1713522292985,EDS 204R,B01,507331,Heinzman; Erica M.,22,0,30,8
1713522294013,EDS 206R,A00,507332,Staff,0,2,30,30
1713522294013,EDS 206R,B00,507343,Staff,23,0,30,7
1713522295047,EDS 250,A00,507344,Hemans; Patricia Ann Benitez,27,0,40,13
1713522296072,EDS 281,A00,507345,Daly; Alan J.,18,0,18,0
1713522297099,EDS 284,A00,507350,Daly; Alan J.,16,0,16,0
1713522298131,EDS 286,A00,507359,Fine; Sarah,18,0,18,0
1713522299160,EDS 289C,A01,507361,Daly; Alan J.,18,0,18,0
1713522300194,EDS 290,A00,507366,Hofstetter; Carolyn,15,0,15,0
1713522301222,LIGM 5A,A00,507421,Fischer-Grunski; Eva K,20,0,20,0
1713522302252,LIGM 5B,A00,507423,Fischer-Grunski; Eva K,20,0,20,0
1713522303278,LIGM 5C,A00,507425,Fischer-Grunski; Eva K,20,0,20,0
1713522304305,LIIT 5AS,A00,507427,Carnelos; Chiara,20,0,20,0
1713522305331,LIIT 5BS,A00,507430,Carnelos; Chiara,20,0,20,0
1713522306357,LIIT 5CS,A00,507432,Carnelos; Chiara,20,0,20,0
1713522307387,LISP 5A,A00,507541,Munoz Sanchez; Alicia,14,0,20,6
1713522308416,LISP 5B,A00,507671,Munoz Sanchez; Alicia,12,0,20,8
1713522309445,LISP 5C,A00,507696,Munoz Sanchez; Alicia,11,0,20,9
1713522310475,MAE 197,001,528363,Boechler; Nicholas Sebastia,9998,0,9999,1
1713522311505,MATH 197,001,523477,Kedlaya; Kiran S.,9999,0,9999,0
1713522311505,MATH 197,002,563811,Zhang; Danna,9998,0,9999,1
1713522312531,MCWP 40R,A00,518780,Staff,13,0,20,7
1713522312531,MCWP 40R,B00,518781,Staff,11,0,20,9
1713522312531,MCWP 40R,C00,518783,Staff,8,0,20,12
1713522313563,MCWP 50R,A00,518791,Staff,7,0,20,13
1713522313563,MCWP 50R,B00,518792,Staff,3,0,20,17
1713522313563,MCWP 50R,C00,518793,Staff,5,0,20,15
1713522313563,MCWP 50R,D00,518794,Staff,0,0,20,20
1713522313563,MCWP 50R,E00,518795,Staff,0,0,20,20
1713522313563,MCWP 50R,F00,518796,Staff,10,0,20,10
1713522313563,MCWP 50R,G00,518797,Staff,10,0,20,10
1713522314594,MMW 12R,A01,514034,Herbst; Matthew,1,0,16,15
1713522314594,MMW 12R,A02,514035,Herbst; Matthew,13,0,16,3
1713522315620,MMW 13R,A01,514037,Staff,0,8,16,16
1713522315620,MMW 13R,A02,514039,Staff,0,7,16,16
1713522317677,SIO 295LS,A00,523233,Staff,15,0,30,15
1713522318762,SIO 295S,A00,523232,Staff,15,0,30,15
1713522319793,SOCI 117,A01,494376,Staff,0,2,5,5
1713522320819,WES 237B,A00,494380,Staff,19,0,20,1
1713522322895,AESE 279B,A00,494370,Wade; Jon P,33,0,33,0
1713522323922,AIP 197,001,627712,Vespa; Emanuel Ignacio,9999,0,9999,0
1713522324951,ANAR 135S,A00,494369,Braswell; Geoffrey E.,0,0,0,0
1713522325977,CAT 124RS,A01,519847,Geibel; William,6,0,20,14
1713522327003,CAT 125RS,A01,515971,Geibel; William,6,0,20,14
1713522328029,CLRE 250,A00,511389,Morris; Sheldon,9996,0,9999,3
1713522329062,CLRE 251,A00,507176,Mehta; Ravindra L.,9996,0,9999,3
1713522329062,CLRE 251,B00,511410,Mehta; Ravindra L.,9998,0,9999,1
1713522330092,CLRE 252,A00,507189,Cuomo; Raphael Eduardo,9998,0,9999,1
1713522331118,CLRE 253,A00,507199,Vaida; Florin,9997,0,9999,2
1713522331118,CLRE 253,B00,507202,Vaida; Florin,9999,0,9999,0
1713522332144,CLRE 259,A00,507211,Patel; Hemal,9996,0,9999,3
1713522333172,CLRE 260,A00,507221,Cuomo; Raphael Eduardo,9999,0,9999,0
1713522334198,CLRE 297,001,507242,Cuomo; Raphael Eduardo,9999,0,9999,0
1713522335228,CSE 191,A00,516875,Minnes Kemp; Mor Mia,9999,0,9999,0
1713522336260,CSS 201S,A01,494383,Staff,35,0,35,0
1713522337292,CSS 202S,A01,494387,Staff,35,0,35,0
1713522338317,EAP 100,A00,516065,Staff,9792,0,9999,207
1713522339346,ECE 45,A01,507414,Staff,37,0,60,23
1713522340375,ECE 100,A01,507416,Baghdadchi; Saharnaz,0,0,20,20
1713522340375,ECE 100,A02,507418,Baghdadchi; Saharnaz,19,0,20,1
1713522341401,ECE 111,A01,507420,Staff,27,0,50,23
1713522342431,ECE 197,001,548057,Sievenpiper; Daniel F.,9998,0,9999,1
1713522343461,EDS 115,A00,507243,Choi; Bailey Miyeon,27,0,28,1
1713522344486,EDS 117,A01,494379,Staff,14,0,25,11
1713522345511,EDS 125,A00,507246,Hopkins; Megan Beth,27,0,30,3
1713522346539,EDS 128A,A01,507264,Fargason; Sharon Gayle,26,0,26,0
1713522347568,EDS 128B,A01,507293,Pappas; Elizabeth,30,0,30,0
1713522348594,EDS 139,A00,507294,Fargason; Sharon Gayle,30,0,30,0
1713522348594,EDS 139,B00,507313,Pappas; Elizabeth,30,0,30,0
1713522349622,EDS 201,A00,507315,Staff,18,0,30,12
1713522350648,EDS 203,A01,507317,Halter; Christopher P.,17,0,30,13
1713522351675,EDS 204R,A01,507319,Halter; Christopher P.,0,1,30,30
1713522351675,EDS 204R,B01,507331,Heinzman; Erica M.,22,0,30,8
1713522352701,EDS 206R,A00,507332,Staff,0,2,30,30
1713522352701,EDS 206R,B00,507343,Staff,23,0,30,7
1713522353727,EDS 250,A00,507344,Hemans; Patricia Ann Benitez,27,0,40,13
1713522354803,EDS 281,A00,507345,Daly; Alan J.,18,0,18,0
1713522355827,EDS 284,A00,507350,Daly; Alan J.,16,0,16,0
1713522356854,EDS 286,A00,507359,Fine; Sarah,18,0,18,0
1713522357881,EDS 289C,A01,507361,Daly; Alan J.,18,0,18,0
1713522358911,EDS 290,A00,507366,Hofstetter; Carolyn,15,0,15,0
1713522359938,LIGM 5A,A00,507421,Fischer-Grunski; Eva K,20,0,20,0
1713522360963,LIGM 5B,A00,507423,Fischer-Grunski; Eva K,20,0,20,0
1713522361990,LIGM 5C,A00,507425,Fischer-Grunski; Eva K,20,0,20,0
1713522363023,LIIT 5AS,A00,507427,Carnelos; Chiara,20,0,20,0
1713522364047,LIIT 5BS,A00,507430,Carnelos; Chiara,20,0,20,0
1713522365076,LIIT 5CS,A00,507432,Carnelos; Chiara,20,0,20,0
1713522366101,LISP 5A,A00,507541,Munoz Sanchez; Alicia,14,0,20,6
1713522367128,LISP 5B,A00,507671,Munoz Sanchez; Alicia,12,0,20,8
1713522368157,LISP 5C,A00,507696,Munoz Sanchez; Alicia,11,0,20,9
1713522369186,MAE 197,001,528363,Boechler; Nicholas Sebastia,9998,0,9999,1
1713522370212,MATH 197,001,523477,Kedlaya; Kiran S.,9999,0,9999,0
1713522370212,MATH 197,002,563811,Zhang; Danna,9998,0,9999,1
1713522371239,MCWP 40R,A00,518780,Staff,13,0,20,7
1713522371239,MCWP 40R,B00,518781,Staff,11,0,20,9
1713522371239,MCWP 40R,C00,518783,Staff,8,0,20,12
1713522372270,MCWP 50R,A00,518791,Staff,7,0,20,13
1713522372270,MCWP 50R,B00,518792,Staff,3,0,20,17
1713522372270,MCWP 50R,C00,518793,Staff,5,0,20,15
1713522372270,MCWP 50R,D00,518794,Staff,0,0,20,20
1713522372270,MCWP 50R,E00,518795,Staff,0,0,20,20
1713522372270,MCWP 50R,F00,518796,Staff,10,0,20,10
1713522372270,MCWP 50R,G00,518797,Staff,10,0,20,10
1713522373296,MMW 12R,A01,514034,Herbst; Matthew,1,0,16,15
1713522373296,MMW 12R,A02,514035,Herbst; Matthew,13,0,16,3
1713522374322,MMW 13R,A01,514037,Staff,0,8,16,16
1713522374322,MMW 13R,A02,514039,Staff,0,7,16,16
1713522376381,SIO 295LS,A00,523233,Staff,15,0,30,15
1713522377408,SIO 295S,A00,523232,Staff,15,0,30,15
1713522378439,SOCI 117,A01,494376,Staff,0,2,5,5
1713522379468,WES 237B,A00,494380,Staff,19,0,20,1
1713522381563,AESE 279B,A00,494370,Wade; Jon P,33,0,33,0
1713522382588,AIP 197,001,627712,Vespa; Emanuel Ignacio,9999,0,9999,0
1713522383620,ANAR 135S,A00,494369,Braswell; Geoffrey E.,0,0,0,0
1713522384645,CAT 124RS,A01,519847,Geibel; William,6,0,20,14
1713522385671,CAT 125RS,A01,515971,Geibel; William,6,0,20,14
1713522386702,CLRE 250,A00,511389,Morris; Sheldon,9996,0,9999,3
1713522387730,CLRE 251,A00,507176,Mehta; Ravindra L.,9996,0,9999,3
1713522387730,CLRE 251,B00,511410,Mehta; Ravindra L.,9998,0,9999,1
1713522388759,CLRE 252,A00,507189,Cuomo; Raphael Eduardo,9998,0,9999,1
1713522389792,CLRE 253,A00,507199,Vaida; Florin,9997,0,9999,2
1713522389792,CLRE 253,B00,507202,Vaida; Florin,9999,0,9999,0
1713522390817,CLRE 259,A00,507211,Patel; Hemal,9996,0,9999,3
1713522391846,CLRE 260,A00,507221,Cuomo; Raphael Eduardo,9999,0,9999,0
1713522392872,CLRE 297,001,507242,Cuomo; Raphael Eduardo,9999,0,9999,0
1713522393903,CSE 191,A00,516875,Minnes Kemp; Mor Mia,9999,0,9999,0
1713522394931,CSS 201S,A01,494383,Staff,35,0,35,0
1713522395957,CSS 202S,A01,494387,Staff,35,0,35,0
1713522396982,EAP 100,A00,516065,Staff,9792,0,9999,207
1713522398009,ECE 45,A01,507414,Staff,37,0,60,23
1713522399039,ECE 100,A01,507416,Baghdadchi; Saharnaz,0,0,20,20
1713522399039,ECE 100,A02,507418,Baghdadchi; Saharnaz,19,0,20,1
1713522400064,ECE 111,A01,507420,Staff,27,0,50,23
1713522401093,ECE 197,001,548057,Sievenpiper; Daniel F.,9998,0,9999,1
1713522402125,EDS 115,A00,507243,Choi; Bailey Miyeon,27,0,28,1
1713522403150,EDS 117,A01,494379,Staff,14,0,25,11
1713522404179,EDS 125,A00,507246,Hopkins; Megan Beth,27,0,30,3
1713522405207,EDS 128A,A01,507264,Fargason; Sharon Gayle,26,0,26,0
1713522406236,EDS 128B,A01,507293,Pappas; Elizabeth,30,0,30,0
1713522407279,EDS 139,A00,507294,Fargason; Sharon Gayle,30,0,30,0
1713522407279,EDS 139,B00,507313,Pappas; Elizabeth,30,0,30,0
1713522408305,EDS 201,A00,507315,Staff,18,0,30,12
1713522409335,EDS 203,A01,507317,Halter; Christopher P.,17,0,30,13
1713522410361,EDS 204R,A01,507319,Halter; Christopher P.,0,1,30,30
1713522410361,EDS 204R,B01,507331,Heinzman; Erica M.,22,0,30,8
1713522411387,EDS 206R,A00,507332,Staff,0,2,30,30
1713522411387,EDS 206R,B00,507343,Staff,23,0,30,7
1713522412412,EDS 250,A00,507344,Hemans; Patricia Ann Benitez,27,0,40,13
1713522413439,EDS 281,A00,507345,Daly; Alan J.,18,0,18,0
1713522414464,EDS 284,A00,507350,Daly; Alan J.,16,0,16,0
1713522415495,EDS 286,A00,507359,Fine; Sarah,18,0,18,0
1713522416525,EDS 289C,A01,507361,Daly; Alan J.,18,0,18,0
1713522417552,EDS 290,A00,507366,Hofstetter; Carolyn,15,0,15,0
1713522418579,LIGM 5A,A00,507421,Fischer-Grunski; Eva K,20,0,20,0
1713522419606,LIGM 5B,A00,507423,Fischer-Grunski; Eva K,20,0,20,0
1713522420632,LIGM 5C,A00,507425,Fischer-Grunski; Eva K,20,0,20,0
1713522421664,LIIT 5AS,A00,507427,Carnelos; Chiara,20,0,20,0
1713522422748,LIIT 5BS,A00,507430,Carnelos; Chiara,20,0,20,0
1713522423773,LIIT 5CS,A00,507432,Carnelos; Chiara,20,0,20,0
1713522424800,LISP 5A,A00,507541,Munoz Sanchez; Alicia,14,0,20,6
1713522425826,LISP 5B,A00,507671,Munoz Sanchez; Alicia,12,0,20,8
1713522426851,LISP 5C,A00,507696,Munoz Sanchez; Alicia,11,0,20,9
1713522427883,MAE 197,001,528363,Boechler; Nicholas Sebastia,9998,0,9999,1
1713522428910,MATH 197,001,523477,Kedlaya; Kiran S.,9999,0,9999,0
1713522428910,MATH 197,002,563811,Zhang; Danna,9998,0,9999,1
1713522429937,MCWP 40R,A00,518780,Staff,13,0,20,7
1713522429937,MCWP 40R,B00,518781,Staff,11,0,20,9
1713522429937,MCWP 40R,C00,518783,Staff,8,0,20,12
1713522430964,MCWP 50R,A00,518791,Staff,7,0,20,13
1713522430964,MCWP 50R,B00,518792,Staff,3,0,20,17
1713522430964,MCWP 50R,C00,518793,Staff,5,0,20,15
1713522430964,MCWP 50R,D00,518794,Staff,0,0,20,20
1713522430964,MCWP 50R,E00,518795,Staff,0,0,20,20
1713522430964,MCWP 50R,F00,518796,Staff,10,0,20,10
1713522430964,MCWP 50R,G00,518797,Staff,10,0,20,10
1713522431998,MMW 12R,A01,514034,Herbst; Matthew,1,0,16,15
1713522431998,MMW 12R,A02,514035,Herbst; Matthew,13,0,16,3
1713522433023,MMW 13R,A01,514037,Staff,0,8,16,16
1713522433023,MMW 13R,A02,514039,Staff,0,7,16,16
1713522435075,SIO 295LS,A00,523233,Staff,15,0,30,15
1713522436105,SIO 295S,A00,523232,Staff,15,0,30,15
1713522437137,SOCI 117,A01,494376,Staff,0,2,5,5
1713522438163,WES 237B,A00,494380,Staff,19,0,20,1
1713522440246,AESE 279B,A00,494370,Wade; Jon P,33,0,33,0
1713522441271,AIP 197,001,627712,Vespa; Emanuel Ignacio,9999,0,9999,0
1713522442296,ANAR 135S,A00,494369,Braswell; Geoffrey E.,0,0,0,0
1713522443328,CAT 124RS,A01,519847,Geibel; William,6,0,20,14
1713522444354,CAT 125RS,A01,515971,Geibel; William,6,0,20,14
1713522445380,CLRE 250,A00,511389,Morris; Sheldon,9996,0,9999,3
1713522446414,CLRE 251,A00,507176,Mehta; Ravindra L.,9996,0,9999,3
1713522446414,CLRE 251,B00,511410,Mehta; Ravindra L.,9998,0,9999,1
1713522447440,CLRE 252,A00,507189,Cuomo; Raphael Eduardo,9998,0,9999,1
1713522448466,CLRE 253,A00,507199,Vaida; Florin,9997,0,9999,2
1713522448466,CLRE 253,B00,507202,Vaida; Florin,9999,0,9999,0
1713522449492,CLRE 259,A00,507211,Patel; Hemal,9996,0,9999,3
1713522450517,CLRE 260,A00,507221,Cuomo; Raphael Eduardo,9999,0,9999,0
1713522451544,CLRE 297,001,507242,Cuomo; Raphael Eduardo,9999,0,9999,0
1713522452570,CSE 191,A00,516875,Minnes Kemp; Mor Mia,9999,0,9999,0
1713522453596,CSS 201S,A01,494383,Staff,35,0,35,0
1713522454621,CSS 202S,A01,494387,Staff,35,0,35,0
1713522455650,EAP 100,A00,516065,Staff,9792,0,9999,207
1713522456681,ECE 45,A01,507414,Staff,37,0,60,23
1713522457710,ECE 100,A01,507416,Baghdadchi; Saharnaz,0,0,20,20
1713522457710,ECE 100,A02,507418,Baghdadchi; Saharnaz,19,0,20,1
1713522458736,ECE 111,A01,507420,Staff,27,0,50,23
1713522459762,ECE 197,001,548057,Sievenpiper; Daniel F.,9998,0,9999,1
1713522460789,EDS 115,A00,507243,Choi; Bailey Miyeon,27,0,28,1
1713522461822,EDS 117,A01,494379,Staff,14,0,25,11
1713522462852,EDS 125,A00,507246,Hopkins; Megan Beth,27,0,30,3
1713522463893,EDS 128A,A01,507264,Fargason; Sharon Gayle,26,0,26,0
1713522464918,EDS 128B,A01,507293,Pappas; Elizabeth,30,0,30,0
1713522465946,EDS 139,A00,507294,Fargason; Sharon Gayle,30,0,30,0
1713522465946,EDS 139,B00,507313,Pappas; Elizabeth,30,0,30,0
1713522466970,EDS 201,A00,507315,Staff,18,0,30,12
1713522467999,EDS 203,A01,507317,Halter; Christopher P.,17,0,30,13
1713522469025,EDS 204R,A01,507319,Halter; Christopher P.,0,1,30,30
1713522469025,EDS 204R,B01,507331,Heinzman; Erica M.,22,0,30,8
1713522470054,EDS 206R,A00,507332,Staff,0,2,30,30
1713522470054,EDS 206R,B00,507343,Staff,23,0,30,7
1713522471084,EDS 250,A00,507344,Hemans; Patricia Ann Benitez,27,0,40,13
1713522472114,EDS 281,A00,507345,Daly; Alan J.,18,0,18,0
1713522473141,EDS 284,A00,507350,Daly; Alan J.,16,0,16,0
1713522474167,EDS 286,A00,507359,Fine; Sarah,18,0,18,0
1713522475192,EDS 289C,A01,507361,Daly; Alan J.,18,0,18,0
1713522476224,EDS 290,A00,507366,Hofstetter; Carolyn,15,0,15,0
1713522477255,LIGM 5A,A00,507421,Fischer-Grunski; Eva K,20,0,20,0
1713522478287,LIGM 5B,A00,507423,Fischer-Grunski; Eva K,20,0,20,0
1713522479316,LIGM 5C,A00,507425,Fischer-Grunski; Eva K,20,0,20,0
1713522480347,LIIT 5AS,A00,507427,Carnelos; Chiara,20,0,20,0
1713522481374,LIIT 5BS,A00,507430,Carnelos; Chiara,20,0,20,0
1713522482407,LIIT 5CS,A00,507432,Carnelos; Chiara,20,0,20,0
1713522483433,LISP 5A,A00,507541,Munoz Sanchez; Alicia,14,0,20,6
1713522484460,LISP 5B,A00,507671,Munoz Sanchez; Alicia,12,0,20,8
1713522485486,LISP 5C,A00,507696,Munoz Sanchez; Alicia,11,0,20,9
1713522486512,MAE 197,001,528363,Boechler; Nicholas Sebastia,9998,0,9999,1
1713522487539,MATH 197,001,523477,Kedlaya; Kiran S.,9999,0,9999,0
1713522487539,MATH 197,002,563811,Zhang; Danna,9998,0,9999,1
1713522488565,MCWP 40R,A00,518780,Staff,13,0,20,7
1713522488565,MCWP 40R,B00,518781,Staff,11,0,20,9
1713522488565,MCWP 40R,C00,518783,Staff,8,0,20,12
1713522489598,MCWP 50R,A00,518791,Staff,7,0,20,13
1713522489598,MCWP 50R,B00,518792,Staff,3,0,20,17
1713522489598,MCWP 50R,C00,518793,Staff,5,0,20,15
1713522489598,MCWP 50R,D00,518794,Staff,0,0,20,20
1713522489598,MCWP 50R,E00,518795,Staff,0,0,20,20
1713522489598,MCWP 50R,F00,518796,Staff,10,0,20,10
1713522489598,MCWP 50R,G00,518797,Staff,10,0,20,10
1713522490624,MMW 12R,A01,514034,Herbst; Matthew,1,0,16,15
1713522490624,MMW 12R,A02,514035,Herbst; Matthew,13,0,16,3
1713522491653,MMW 13R,A01,514037,Staff,0,8,16,16
1713522491653,MMW 13R,A02,514039,Staff,0,7,16,16
1713522493711,SIO 295LS,A00,523233,Staff,15,0,30,15
1713522494736,SIO 295S,A00,523232,Staff,15,0,30,15
1713522495765,SOCI 117,A01,494376,Staff,0,2,5,5
1713522496795,WES 237B,A00,494380,Staff,19,0,20,1
1713522498876,AESE 279B,A00,494370,Wade; Jon P,33,0,33,0
1713522499905,AIP 197,001,627712,Vespa; Emanuel Ignacio,9999,0,9999,0
1713522500934,ANAR 135S,A00,494369,Braswell; Geoffrey E.,0,0,0,0
1713522501964,CAT 124RS,A01,519847,Geibel; William,6,0,20,14
1713522502995,CAT 125RS,A01,515971,Geibel; William,6,0,20,14
1713522504029,CLRE 250,A00,511389,Morris; Sheldon,9996,0,9999,3
1713522505065,CLRE 251,A00,507176,Mehta; Ravindra L.,9996,0,9999,3
1713522505065,CLRE 251,B00,511410,Mehta; Ravindra L.,9998,0,9999,1
1713522506099,CLRE 252,A00,507189,Cuomo; Raphael Eduardo,9998,0,9999,1
1713522507126,CLRE 253,A00,507199,Vaida; Florin,9997,0,9999,2
1713522507126,CLRE 253,B00,507202,Vaida; Florin,9999,0,9999,0
1713522508154,CLRE 259,A00,507211,Patel; Hemal,9996,0,9999,3
1713522509180,CLRE 260,A00,507221,Cuomo; Raphael Eduardo,9999,0,9999,0
1713522510208,CLRE 297,001,507242,Cuomo; Raphael Eduardo,9999,0,9999,0
1713522511235,CSE 191,A00,516875,Minnes Kemp; Mor Mia,9999,0,9999,0
1713522512261,CSS 201S,A01,494383,Staff,35,0,35,0
1713522513288,CSS 202S,A01,494387,Staff,35,0,35,0
1713522514317,EAP 100,A00,516065,Staff,9792,0,9999,207
1713522515347,ECE 45,A01,507414,Staff,37,0,60,23
1713522516374,ECE 100,A01,507416,Baghdadchi; Saharnaz,0,0,20,20
1713522516374,ECE 100,A02,507418,Baghdadchi; Saharnaz,19,0,20,1
1713522517401,ECE 111,A01,507420,Staff,27,0,50,23
1713522518428,ECE 197,001,548057,Sievenpiper; Daniel F.,9998,0,9999,1
1713522519454,EDS 115,A00,507243,Choi; Bailey Miyeon,27,0,28,1
1713522520478,EDS 117,A01,494379,Staff,14,0,25,11
1713522521509,EDS 125,A00,507246,Hopkins; Megan Beth,27,0,30,3
1713522522537,EDS 128A,A01,507264,Fargason; Sharon Gayle,26,0,26,0
1713522523568,EDS 128B,A01,507293,Pappas; Elizabeth,30,0,30,0
1713522524591,EDS 139,A00,507294,Fargason; Sharon Gayle,30,0,30,0
1713522524591,EDS 139,B00,507313,Pappas; Elizabeth,30,0,30,0
1713522525618,EDS 201,A00,507315,Staff,18,0,30,12
1713522526705,EDS 203,A01,507317,Halter; Christopher P.,17,0,30,13
1713522527731,EDS 204R,A01,507319,Halter; Christopher P.,0,1,30,30
1713522527731,EDS 204R,B01,507331,Heinzman; Erica M.,22,0,30,8
1713522528761,EDS 206R,A00,507332,Staff,0,2,30,30
1713522528761,EDS 206R,B00,507343,Staff,23,0,30,7
1713522529789,EDS 250,A00,507344,Hemans; Patricia Ann Benitez,27,0,40,13
1713522530820,EDS 281,A00,507345,Daly; Alan J.,18,0,18,0
1713522531846,EDS 284,A00,507350,Daly; Alan J.,16,0,16,0
1713522532878,EDS 286,A00,507359,Fine; Sarah,18,0,18,0
1713522533902,EDS 289C,A01,507361,Daly; Alan J.,18,0,18,0
1713522534931,EDS 290,A00,507366,Hofstetter; Carolyn,15,0,15,0
1713522535958,LIGM 5A,A00,507421,Fischer-Grunski; Eva K,20,0,20,0
1713522536984,LIGM 5B,A00,507423,Fischer-Grunski; Eva K,20,0,20,0
1713522538010,LIGM 5C,A00,507425,Fischer-Grunski; Eva K,20,0,20,0
1713522539041,LIIT 5AS,A00,507427,Carnelos; Chiara,20,0,20,0
1713522540076,LIIT 5BS,A00,507430,Carnelos; Chiara,20,0,20,0
1713522541103,LIIT 5CS,A00,507432,Carnelos; Chiara,20,0,20,0
1713522542129,LISP 5A,A00,507541,Munoz Sanchez; Alicia,14,0,20,6
1713522543155,LISP 5B,A00,507671,Munoz Sanchez; Alicia,12,0,20,8
1713522544187,LISP 5C,A00,507696,Munoz Sanchez; Alicia,11,0,20,9
1713522545214,MAE 197,001,528363,Boechler; Nicholas Sebastia,9998,0,9999,1
1713522546242,MATH 197,001,523477,Kedlaya; Kiran S.,9999,0,9999,0
1713522546242,MATH 197,002,563811,Zhang; Danna,9998,0,9999,1
1713522547268,MCWP 40R,A00,518780,Staff,13,0,20,7
1713522547268,MCWP 40R,B00,518781,Staff,11,0,20,9
1713522547268,MCWP 40R,C00,518783,Staff,8,0,20,12
1713522548296,MCWP 50R,A00,518791,Staff,7,0,20,13
1713522548296,MCWP 50R,B00,518792,Staff,3,0,20,17
1713522548296,MCWP 50R,C00,518793,Staff,5,0,20,15
1713522548296,MCWP 50R,D00,518794,Staff,0,0,20,20
1713522548296,MCWP 50R,E00,518795,Staff,0,0,20,20
1713522548296,MCWP 50R,F00,518796,Staff,10,0,20,10
1713522548296,MCWP 50R,G00,518797,Staff,10,0,20,10
1713522549325,MMW 12R,A01,514034,Herbst; Matthew,1,0,16,15
1713522549325,MMW 12R,A02,514035,Herbst; Matthew,13,0,16,3
1713522550354,MMW 13R,A01,514037,Staff,0,8,16,16
1713522550354,MMW 13R,A02,514039,Staff,0,7,16,16
1713522552415,SIO 295LS,A00,523233,Staff,15,0,30,15
1713522553444,SIO 295S,A00,523232,Staff,15,0,30,15
1713522554472,SOCI 117,A01,494376,Staff,0,2,5,5
1713522555496,WES 237B,A00,494380,Staff,19,0,20,1
1713522557581,AESE 279B,A00,494370,Wade; Jon P,33,0,33,0
1713522558607,AIP 197,001,627712,Vespa; Emanuel Ignacio,9999,0,9999,0
1713522559633,ANAR 135S,A00,494369,Braswell; Geoffrey E.,0,0,0,0
1713522560664,CAT 124RS,A01,519847,Geibel; William,6,0,20,14
1713522561692,CAT 125RS,A01,515971,Geibel; William,6,0,20,14
1713522562720,CLRE 250,A00,511389,Morris; Sheldon,9996,0,9999,3
1713522563748,CLRE 251,A00,507176,Mehta; Ravindra L.,9996,0,9999,3
1713522563748,CLRE 251,B00,511410,Mehta; Ravindra L.,9998,0,9999,1
1713522564779,CLRE 252,A00,507189,Cuomo; Raphael Eduardo,9998,0,9999,1
1713522565806,CLRE 253,A00,507199,Vaida; Florin,9997,0,9999,2
1713522565806,CLRE 253,B00,507202,Vaida; Florin,9999,0,9999,0
1713522566832,CLRE 259,A00,507211,Patel; Hemal,9996,0,9999,3
1713522567860,CLRE 260,A00,507221,Cuomo; Raphael Eduardo,9999,0,9999,0
1713522568886,CLRE 297,001,507242,Cuomo; Raphael Eduardo,9999,0,9999,0
1713522569912,CSE 191,A00,516875,Minnes Kemp; Mor Mia,9999,0,9999,0
1713522570939,CSS 201S,A01,494383,Staff,35,0,35,0
1713522571968,CSS 202S,A01,494387,Staff,35,0,35,0
1713522572993,EAP 100,A00,516065,Staff,9792,0,9999,207
1713522574027,ECE 45,A01,507414,Staff,37,0,60,23
1713522575053,ECE 100,A01,507416,Baghdadchi; Saharnaz,0,0,20,20
1713522575053,ECE 100,A02,507418,Baghdadchi; Saharnaz,19,0,20,1
1713522576083,ECE 111,A01,507420,Staff,27,0,50,23
1713522577109,ECE 197,001,548057,Sievenpiper; Daniel F.,9998,0,9999,1
1713522578136,EDS 115,A00,507243,Choi; Bailey Miyeon,27,0,28,1
1713522579165,EDS 117,A01,494379,Staff,14,0,25,11
1713522580192,EDS 125,A00,507246,Hopkins; Megan Beth,27,0,30,3
1713522581219,EDS 128A,A01,507264,Fargason; Sharon Gayle,26,0,26,0
1713522582246,EDS 128B,A01,507293,Pappas; Elizabeth,30,0,30,0
1713522583271,EDS 139,A00,507294,Fargason; Sharon Gayle,30,0,30,0
1713522583271,EDS 139,B00,507313,Pappas; Elizabeth,30,0,30,0
1713522584299,EDS 201,A00,507315,Staff,18,0,30,12
1713522585329,EDS 203,A01,507317,Halter; Christopher P.,17,0,30,13
1713522586361,EDS 204R,A01,507319,Halter; Christopher P.,0,1,30,30
1713522586361,EDS 204R,B01,507331,Heinzman; Erica M.,22,0,30,8
1713522587387,EDS 206R,A00,507332,Staff,0,2,30,30
1713522587387,EDS 206R,B00,507343,Staff,23,0,30,7
1713522588415,EDS 250,A00,507344,Hemans; Patricia Ann Benitez,27,0,40,13
1713522589440,EDS 281,A00,507345,Daly; Alan J.,18,0,18,0
1713522590466,EDS 284,A00,507350,Daly; Alan J.,16,0,16,0
1713522591496,EDS 286,A00,507359,Fine; Sarah,18,0,18,0
1713522592522,EDS 289C,A01,507361,Daly; Alan J.,18,0,18,0
1713522593548,EDS 290,A00,507366,Hofstetter; Carolyn,15,0,15,0
1713522594579,LIGM 5A,A00,507421,Fischer-Grunski; Eva K,20,0,20,0
1713522595606,LIGM 5B,A00,507423,Fischer-Grunski; Eva K,20,0,20,0
1713522596631,LIGM 5C,A00,507425,Fischer-Grunski; Eva K,20,0,20,0
1713522597661,LIIT 5AS,A00,507427,Carnelos; Chiara,20,0,20,0
1713522598688,LIIT 5BS,A00,507430,Carnelos; Chiara,20,0,20,0
1713522599712,LIIT 5CS,A00,507432,Carnelos; Chiara,20,0,20,0
1713522600739,LISP 5A,A00,507541,Munoz Sanchez; Alicia,14,0,20,6
1713522601767,LISP 5B,A00,507671,Munoz Sanchez; Alicia,12,0,20,8
1713522602792,LISP 5C,A00,507696,Munoz Sanchez; Alicia,11,0,20,9
1713522603823,MAE 197,001,528363,Boechler; Nicholas Sebastia,9998,0,9999,1
1713522604858,MATH 197,001,523477,Kedlaya; Kiran S.,9999,0,9999,0
1713522604858,MATH 197,002,563811,Zhang; Danna,9998,0,9999,1
1713522605888,MCWP 40R,A00,518780,Staff,13,0,20,7
1713522605888,MCWP 40R,B00,518781,Staff,11,0,20,9
1713522605888,MCWP 40R,C00,518783,Staff,8,0,20,12
1713522606914,MCWP 50R,A00,518791,Staff,7,0,20,13
1713522606914,MCWP 50R,B00,518792,Staff,3,0,20,17
1713522606914,MCWP 50R,C00,518793,Staff,5,0,20,15
1713522606914,MCWP 50R,D00,518794,Staff,0,0,20,20
1713522606914,MCWP 50R,E00,518795,Staff,0,0,20,20
1713522606914,MCWP 50R,F00,518796,Staff,10,0,20,10
1713522606914,MCWP 50R,G00,518797,Staff,10,0,20,10
1713522607940,MMW 12R,A01,514034,Herbst; Matthew,1,0,16,15
1713522607940,MMW 12R,A02,514035,Herbst; Matthew,13,0,16,3
1713522608966,MMW 13R,A01,514037,Staff,0,8,16,16
1713522608966,MMW 13R,A02,514039,Staff,0,7,16,16
1713522611019,SIO 295LS,A00,523233,Staff,15,0,30,15
1713522612060,SIO 295S,A00,523232,Staff,15,0,30,15
1713522613086,SOCI 117,A01,494376,Staff,0,2,5,5
1713522614115,WES 237B,A00,494380,Staff,19,0,20,1
1713522616195,AESE 279B,A00,494370,Wade; Jon P,33,0,33,0
1713522617223,AIP 197,001,627712,Vespa; Emanuel Ignacio,9999,0,9999,0
1713522618250,ANAR 135S,A00,494369,Braswell; Geoffrey E.,0,0,0,0
1713522619284,CAT 124RS,A01,519847,Geibel; William,6,0,20,14
1713522620310,CAT 125RS,A01,515971,Geibel; William,6,0,20,14
1713522621340,CLRE 250,A00,511389,Morris; Sheldon,9996,0,9999,3
1713522622367,CLRE 251,A00,507176,Mehta; Ravindra L.,9996,0,9999,3
1713522622367,CLRE 251,B00,511410,Mehta; Ravindra L.,9998,0,9999,1
1713522623393,CLRE 252,A00,507189,Cuomo; Raphael Eduardo,9998,0,9999,1
1713522624421,CLRE 253,A00,507199,Vaida; Florin,9997,0,9999,2
1713522624421,CLRE 253,B00,507202,Vaida; Florin,9999,0,9999,0
1713522625452,CLRE 259,A00,507211,Patel; Hemal,9996,0,9999,3
1713522626476,CLRE 260,A00,507221,Cuomo; Raphael Eduardo,9999,0,9999,0
1713522627502,CLRE 297,001,507242,Cuomo; Raphael Eduardo,9999,0,9999,0
1713522628531,CSE 191,A00,516875,Minnes Kemp; Mor Mia,9999,0,9999,0
1713522629559,CSS 201S,A01,494383,Staff,35,0,35,0
1713522630639,CSS 202S,A01,494387,Staff,35,0,35,0
1713522631664,EAP 100,A00,516065,Staff,9792,0,9999,207
1713522632691,ECE 45,A01,507414,Staff,37,0,60,23
1713522633718,ECE 100,A01,507416,Baghdadchi; Saharnaz,0,0,20,20
1713522633718,ECE 100,A02,507418,Baghdadchi; Saharnaz,19,0,20,1
1713522634747,ECE 111,A01,507420,Staff,27,0,50,23
1713522635773,ECE 197,001,548057,Sievenpiper; Daniel F.,9998,0,9999,1
1713522636805,EDS 115,A00,507243,Choi; Bailey Miyeon,27,0,28,1
1713522637832,EDS 117,A01,494379,Staff,14,0,25,11
1713522638858,EDS 125,A00,507246,Hopkins; Megan Beth,27,0,30,3
1713522639884,EDS 128A,A01,507264,Fargason; Sharon Gayle,26,0,26,0
1713522640911,EDS 128B,A01,507293,Pappas; Elizabeth,30,0,30,0
1713522641940,EDS 139,A00,507294,Fargason; Sharon Gayle,30,0,30,0
1713522641940,EDS 139,B00,507313,Pappas; Elizabeth,30,0,30,0
1713522642966,EDS 201,A00,507315,Staff,18,0,30,12
1713522643997,EDS 203,A01,507317,Halter; Christopher P.,17,0,30,13
1713522645029,EDS 204R,A01,507319,Halter; Christopher P.,0,1,30,30
1713522645029,EDS 204R,B01,507331,Heinzman; Erica M.,22,0,30,8
1713522646060,EDS 206R,A00,507332,Staff,0,2,30,30
1713522646060,EDS 206R,B00,507343,Staff,23,0,30,7
1713522647087,EDS 250,A00,507344,Hemans; Patricia Ann Benitez,27,0,40,13
1713522648118,EDS 281,A00,507345,Daly; Alan J.,18,0,18,0
1713522649144,EDS 284,A00,507350,Daly; Alan J.,16,0,16,0
1713522650175,EDS 286,A00,507359,Fine; Sarah,18,0,18,0
1713522651204,EDS 289C,A01,507361,Daly; Alan J.,18,0,18,0
1713522652232,EDS 290,A00,507366,Hofstetter; Carolyn,15,0,15,0
1713522653263,LIGM 5A,A00,507421,Fischer-Grunski; Eva K,20,0,20,0
1713522654294,LIGM 5B,A00,507423,Fischer-Grunski; Eva K,20,0,20,0
1713522655325,LIGM 5C,A00,507425,Fischer-Grunski; Eva K,20,0,20,0
1713522656351,LIIT 5AS,A00,507427,Carnelos; Chiara,20,0,20,0
1713522657378,LIIT 5BS,A00,507430,Carnelos; Chiara,20,0,20,0
1713522658403,LIIT 5CS,A00,507432,Carnelos; Chiara,20,0,20,0
1713522659435,LISP 5A,A00,507541,Munoz Sanchez; Alicia,14,0,20,6
1713522660466,LISP 5B,A00,507671,Munoz Sanchez; Alicia,12,0,20,8
1713522661492,LISP 5C,A00,507696,Munoz Sanchez; Alicia,11,0,20,9
1713522662518,MAE 197,001,528363,Boechler; Nicholas Sebastia,9998,0,9999,1
1713522663547,MATH 197,001,523477,Kedlaya; Kiran S.,9999,0,9999,0
1713522663547,MATH 197,002,563811,Zhang; Danna,9998,0,9999,1
1713522664573,MCWP 40R,A00,518780,Staff,13,0,20,7
1713522664573,MCWP 40R,B00,518781,Staff,11,0,20,9
1713522664573,MCWP 40R,C00,518783,Staff,8,0,20,12
1713522665600,MCWP 50R,A00,518791,Staff,7,0,20,13
1713522665600,MCWP 50R,B00,518792,Staff,3,0,20,17
1713522665600,MCWP 50R,C00,518793,Staff,5,0,20,15
1713522665600,MCWP 50R,D00,518794,Staff,0,0,20,20
1713522665600,MCWP 50R,E00,518795,Staff,0,0,20,20
1713522665600,MCWP 50R,F00,518796,Staff,10,0,20,10
1713522665600,MCWP 50R,G00,518797,Staff,10,0,20,10
1713522666627,MMW 12R,A01,514034,Herbst; Matthew,1,0,16,15
1713522666627,MMW 12R,A02,514035,Herbst; Matthew,13,0,16,3
1713522667653,MMW 13R,A01,514037,Staff,0,8,16,16
1713522667653,MMW 13R,A02,514039,Staff,0,7,16,16
1713522669713,SIO 295LS,A00,523233,Staff,15,0,30,15
1713522670740,SIO 295S,A00,523232,Staff,15,0,30,15
1713522671766,SOCI 117,A01,494376,Staff,0,2,5,5
1713522672793,WES 237B,A00,494380,Staff,19,0,20,1
1713522674889,AESE 279B,A00,494370,Wade; Jon P,33,0,33,0
1713522675918,AIP 197,001,627712,Vespa; Emanuel Ignacio,9999,0,9999,0
1713522676944,ANAR 135S,A00,494369,Braswell; Geoffrey E.,0,0,0,0
1713522677974,CAT 124RS,A01,519847,Geibel; William,6,0,20,14
1713522679000,CAT 125RS,A01,515971,Geibel; William,6,0,20,14
1713522680026,CLRE 250,A00,511389,Morris; Sheldon,9996,0,9999,3
1713522681057,CLRE 251,A00,507176,Mehta; Ravindra L.,9996,0,9999,3
1713522681057,CLRE 251,B00,511410,Mehta; Ravindra L.,9998,0,9999,1
1713522682088,CLRE 252,A00,507189,Cuomo; Raphael Eduardo,9998,0,9999,1
1713522683119,CLRE 253,A00,507199,Vaida; Florin,9997,0,9999,2
1713522683119,CLRE 253,B00,507202,Vaida; Florin,9999,0,9999,0
1713522684146,CLRE 259,A00,507211,Patel; Hemal,9996,0,9999,3
1713522685175,CLRE 260,A00,507221,Cuomo; Raphael Eduardo,9999,0,9999,0
1713522686200,CLRE 297,001,507242,Cuomo; Raphael Eduardo,9999,0,9999,0
1713522687229,CSE 191,A00,516875,Minnes Kemp; Mor Mia,9999,0,9999,0
1713522688263,CSS 201S,A01,494383,Staff,35,0,35,0
1713522689289,CSS 202S,A01,494387,Staff,35,0,35,0
1713522690319,EAP 100,A00,516065,Staff,9792,0,9999,207
1713522691346,ECE 45,A01,507414,Staff,37,0,60,23
1713522692374,ECE 100,A01,507416,Baghdadchi; Saharnaz,0,0,20,20
1713522692374,ECE 100,A02,507418,Baghdadchi; Saharnaz,19,0,20,1
1713522693400,ECE 111,A01,507420,Staff,27,0,50,23
1713522694427,ECE 197,001,548057,Sievenpiper; Daniel F.,9998,0,9999,1
1713522695459,EDS 115,A00,507243,Choi; Bailey Miyeon,27,0,28,1
1713522696490,EDS 117,A01,494379,Staff,14,0,25,11
1713522697515,EDS 125,A00,507246,Hopkins; Megan Beth,27,0,30,3
1713522698541,EDS 128A,A01,507264,Fargason; Sharon Gayle,26,0,26,0
1713522699566,EDS 128B,A01,507293,Pappas; Elizabeth,30,0,30,0
1713522700594,EDS 139,A00,507294,Fargason; Sharon Gayle,30,0,30,0
1713522700594,EDS 139,B00,507313,Pappas; Elizabeth,30,0,30,0
1713522701624,EDS 201,A00,507315,Staff,18,0,30,12
1713522702650,EDS 203,A01,507317,Halter; Christopher P.,17,0,30,13
1713522703683,EDS 204R,A01,507319,Halter; Christopher P.,0,1,30,30
1713522703683,EDS 204R,B01,507331,Heinzman; Erica M.,22,0,30,8
1713522704710,EDS 206R,A00,507332,Staff,0,2,30,30
1713522704710,EDS 206R,B00,507343,Staff,23,0,30,7
1713522705739,EDS 250,A00,507344,Hemans; Patricia Ann Benitez,27,0,40,13
1713522706765,EDS 281,A00,507345,Daly; Alan J.,18,0,18,0
1713522707793,EDS 284,A00,507350,Daly; Alan J.,16,0,16,0
1713522708819,EDS 286,A00,507359,Fine; Sarah,18,0,18,0
1713522709847,EDS 289C,A01,507361,Daly; Alan J.,18,0,18,0
1713522710873,EDS 290,A00,507366,Hofstetter; Carolyn,15,0,15,0
1713522711900,LIGM 5A,A00,507421,Fischer-Grunski; Eva K,20,0,20,0
1713522712926,LIGM 5B,A00,507423,Fischer-Grunski; Eva K,20,0,20,0
1713522713952,LIGM 5C,A00,507425,Fischer-Grunski; Eva K,20,0,20,0
1713522714978,LIIT 5AS,A00,507427,Carnelos; Chiara,20,0,20,0
1713522716008,LIIT 5BS,A00,507430,Carnelos; Chiara,20,0,20,0
1713522717033,LIIT 5CS,A00,507432,Carnelos; Chiara,20,0,20,0
1713522718060,LISP 5A,A00,507541,Munoz Sanchez; Alicia,14,0,20,6
1713522719090,LISP 5B,A00,507671,Munoz Sanchez; Alicia,12,0,20,8
1713522720116,LISP 5C,A00,507696,Munoz Sanchez; Alicia,11,0,20,9
1713522721142,MAE 197,001,528363,Boechler; Nicholas Sebastia,9998,0,9999,1
1713522722188,MATH 197,001,523477,Kedlaya; Kiran S.,9999,0,9999,0
1713522722188,MATH 197,002,563811,Zhang; Danna,9998,0,9999,1
1713522723215,MCWP 40R,A00,518780,Staff,13,0,20,7
1713522723215,MCWP 40R,B00,518781,Staff,11,0,20,9
1713522723215,MCWP 40R,C00,518783,Staff,8,0,20,12
1713522724242,MCWP 50R,A00,518791,Staff,7,0,20,13
1713522724242,MCWP 50R,B00,518792,Staff,3,0,20,17
1713522724242,MCWP 50R,C00,518793,Staff,5,0,20,15
1713522724242,MCWP 50R,D00,518794,Staff,0,0,20,20
1713522724242,MCWP 50R,E00,518795,Staff,0,0,20,20
1713522724242,MCWP 50R,F00,518796,Staff,10,0,20,10
1713522724242,MCWP 50R,G00,518797,Staff,10,0,20,10
1713522725272,MMW 12R,A01,514034,Herbst; Matthew,1,0,16,15
1713522725272,MMW 12R,A02,514035,Herbst; Matthew,13,0,16,3
1713522726297,MMW 13R,A01,514037,Staff,0,8,16,16
1713522726297,MMW 13R,A02,514039,Staff,0,7,16,16
1713522728353,SIO 295LS,A00,523233,Staff,15,0,30,15
1713522729382,SIO 295S,A00,523232,Staff,15,0,30,15
1713522730408,SOCI 117,A01,494376,Staff,0,2,5,5
1713522731435,WES 237B,A00,494380,Staff,19,0,20,1
1713522733537,AESE 279B,A00,494370,Wade; Jon P,33,0,33,0
1713522734617,AIP 197,001,627712,Vespa; Emanuel Ignacio,9999,0,9999,0
1713522735643,ANAR 135S,A00,494369,Braswell; Geoffrey E.,0,0,0,0
1713522736671,CAT 124RS,A01,519847,Geibel; William,6,0,20,14
1713522737700,CAT 125RS,A01,515971,Geibel; William,6,0,20,14
1713522738725,CLRE 250,A00,511389,Morris; Sheldon,9996,0,9999,3
1713522739753,CLRE 251,A00,507176,Mehta; Ravindra L.,9996,0,9999,3
1713522739753,CLRE 251,B00,511410,Mehta; Ravindra L.,9998,0,9999,1
1713522740779,CLRE 252,A00,507189,Cuomo; Raphael Eduardo,9998,0,9999,1
1713522741810,CLRE 253,A00,507199,Vaida; Florin,9997,0,9999,2
1713522741810,CLRE 253,B00,507202,Vaida; Florin,9999,0,9999,0
1713522742836,CLRE 259,A00,507211,Patel; Hemal,9996,0,9999,3
1713522743865,CLRE 260,A00,507221,Cuomo; Raphael Eduardo,9999,0,9999,0
1713522744893,CLRE 297,001,507242,Cuomo; Raphael Eduardo,9999,0,9999,0
1713522745920,CSE 191,A00,516875,Minnes Kemp; Mor Mia,9999,0,9999,0
1713522746950,CSS 201S,A01,494383,Staff,35,0,35,0
1713522747976,CSS 202S,A01,494387,Staff,35,0,35,0
1713522749002,EAP 100,A00,516065,Staff,9792,0,9999,207
1713522750031,ECE 45,A01,507414,Staff,37,0,60,23
1713522751062,ECE 100,A01,507416,Baghdadchi; Saharnaz,0,0,20,20
1713522751062,ECE 100,A02,507418,Baghdadchi; Saharnaz,19,0,20,1
1713522752092,ECE 111,A01,507420,Staff,27,0,50,23
1713522753123,ECE 197,001,548057,Sievenpiper; Daniel F.,9998,0,9999,1
1713522754154,EDS 115,A00,507243,Choi; Bailey Miyeon,27,0,28,1
1713522755184,EDS 117,A01,494379,Staff,14,0,25,11
1713522756214,EDS 125,A00,507246,Hopkins; Megan Beth,27,0,30,3
1713522757241,EDS 128A,A01,507264,Fargason; Sharon Gayle,26,0,26,0
1713522758266,EDS 128B,A01,507293,Pappas; Elizabeth,30,0,30,0
1713522759294,EDS 139,A00,507294,Fargason; Sharon Gayle,30,0,30,0
1713522759294,EDS 139,B00,507313,Pappas; Elizabeth,30,0,30,0
1713522760319,EDS 201,A00,507315,Staff,18,0,30,12
1713522761350,EDS 203,A01,507317,Halter; Christopher P.,17,0,30,13
1713522762376,EDS 204R,A01,507319,Halter; Christopher P.,0,1,30,30
1713522762376,EDS 204R,B01,507331,Heinzman; Erica M.,22,0,30,8
1713522763400,EDS 206R,A00,507332,Staff,0,2,30,30
1713522763400,EDS 206R,B00,507343,Staff,23,0,30,7
1713522764426,EDS 250,A00,507344,Hemans; Patricia Ann Benitez,27,0,40,13
1713522765450,EDS 281,A00,507345,Daly; Alan J.,18,0,18,0
1713522766476,EDS 284,A00,507350,Daly; Alan J.,16,0,16,0
1713522767501,EDS 286,A00,507359,Fine; Sarah,18,0,18,0
1713522768528,EDS 289C,A01,507361,Daly; Alan J.,18,0,18,0
1713522769556,EDS 290,A00,507366,Hofstetter; Carolyn,15,0,15,0
1713522770591,LIGM 5A,A00,507421,Fischer-Grunski; Eva K,20,0,20,0
1713522771617,LIGM 5B,A00,507423,Fischer-Grunski; Eva K,20,0,20,0
1713522772642,LIGM 5C,A00,507425,Fischer-Grunski; Eva K,20,0,20,0
1713522773673,LIIT 5AS,A00,507427,Carnelos; Chiara,20,0,20,0
1713522774698,LIIT 5BS,A00,507430,Carnelos; Chiara,20,0,20,0
1713522775728,LIIT 5CS,A00,507432,Carnelos; Chiara,20,0,20,0
1713522776759,LISP 5A,A00,507541,Munoz Sanchez; Alicia,14,0,20,6
1713522777785,LISP 5B,A00,507671,Munoz Sanchez; Alicia,12,0,20,8
1713522778823,LISP 5C,A00,507696,Munoz Sanchez; Alicia,11,0,20,9
1713522779851,MAE 197,001,528363,Boechler; Nicholas Sebastia,9998,0,9999,1
1713522780878,MATH 197,001,523477,Kedlaya; Kiran S.,9999,0,9999,0
1713522780878,MATH 197,002,563811,Zhang; Danna,9998,0,9999,1
1713522781905,MCWP 40R,A00,518780,Staff,13,0,20,7
1713522781905,MCWP 40R,B00,518781,Staff,11,0,20,9
1713522781905,MCWP 40R,C00,518783,Staff,8,0,20,12
1713522782938,MCWP 50R,A00,518791,Staff,7,0,20,13
1713522782938,MCWP 50R,B00,518792,Staff,3,0,20,17
1713522782938,MCWP 50R,C00,518793,Staff,5,0,20,15
1713522782938,MCWP 50R,D00,518794,Staff,0,0,20,20
1713522782938,MCWP 50R,E00,518795,Staff,0,0,20,20
1713522782938,MCWP 50R,F00,518796,Staff,10,0,20,10
1713522782938,MCWP 50R,G00,518797,Staff,10,0,20,10
1713522783965,MMW 12R,A01,514034,Herbst; Matthew,1,0,16,15
1713522783965,MMW 12R,A02,514035,Herbst; Matthew,13,0,16,3
1713522784991,MMW 13R,A01,514037,Staff,0,8,16,16
1713522784991,MMW 13R,A02,514039,Staff,0,7,16,16
1713522787047,SIO 295LS,A00,523233,Staff,15,0,30,15
1713522788073,SIO 295S,A00,523232,Staff,15,0,30,15
1713522789100,SOCI 117,A01,494376,Staff,0,2,5,5
1713522790130,WES 237B,A00,494380,Staff,19,0,20,1
1713522792207,AESE 279B,A00,494370,Wade; Jon P,33,0,33,0
1713522793238,AIP 197,001,627712,Vespa; Emanuel Ignacio,9999,0,9999,0
1713522794268,ANAR 135S,A00,494369,Braswell; Geoffrey E.,0,0,0,0
1713522795294,CAT 124RS,A01,519847,Geibel; William,6,0,20,14
1713522796324,CAT 125RS,A01,515971,Geibel; William,6,0,20,14
1713522797352,CLRE 250,A00,511389,Morris; Sheldon,9996,0,9999,3
1713522798389,CLRE 251,A00,507176,Mehta; Ravindra L.,9996,0,9999,3
1713522798389,CLRE 251,B00,511410,Mehta; Ravindra L.,9998,0,9999,1
1713522799415,CLRE 252,A00,507189,Cuomo; Raphael Eduardo,9998,0,9999,1
1713522800442,CLRE 253,A00,507199,Vaida; Florin,9997,0,9999,2
1713522800442,CLRE 253,B00,507202,Vaida; Florin,9999,0,9999,0
1713522801470,CLRE 259,A00,507211,Patel; Hemal,9996,0,9999,3
1713522802495,CLRE 260,A00,507221,Cuomo; Raphael Eduardo,9999,0,9999,0
1713522803520,CLRE 297,001,507242,Cuomo; Raphael Eduardo,9999,0,9999,0
1713522804550,CSE 191,A00,516875,Minnes Kemp; Mor Mia,9999,0,9999,0
1713522805577,CSS 201S,A01,494383,Staff,35,0,35,0
1713522806605,CSS 202S,A01,494387,Staff,35,0,35,0
1713522807630,EAP 100,A00,516065,Staff,9792,0,9999,207
1713522808659,ECE 45,A01,507414,Staff,37,0,60,23
1713522809685,ECE 100,A01,507416,Baghdadchi; Saharnaz,0,0,20,20
1713522809685,ECE 100,A02,507418,Baghdadchi; Saharnaz,19,0,20,1
1713522810712,ECE 111,A01,507420,Staff,27,0,50,23
1713522811742,ECE 197,001,548057,Sievenpiper; Daniel F.,9998,0,9999,1
1713522812774,EDS 115,A00,507243,Choi; Bailey Miyeon,27,0,28,1
1713522813804,EDS 117,A01,494379,Staff,14,0,25,11
1713522814830,EDS 125,A00,507246,Hopkins; Megan Beth,27,0,30,3
1713522815860,EDS 128A,A01,507264,Fargason; Sharon Gayle,26,0,26,0
1713522816891,EDS 128B,A01,507293,Pappas; Elizabeth,30,0,30,0
1713522817919,EDS 139,A00,507294,Fargason; Sharon Gayle,30,0,30,0
1713522817919,EDS 139,B00,507313,Pappas; Elizabeth,30,0,30,0
1713522818945,EDS 201,A00,507315,Staff,18,0,30,12
1713522819972,EDS 203,A01,507317,Halter; Christopher P.,17,0,30,13
1713522821004,EDS 204R,A01,507319,Halter; Christopher P.,0,1,30,30
1713522821004,EDS 204R,B01,507331,Heinzman; Erica M.,22,0,30,8
1713522822028,EDS 206R,A00,507332,Staff,0,2,30,30
1713522822028,EDS 206R,B00,507343,Staff,23,0,30,7
1713522823054,EDS 250,A00,507344,Hemans; Patricia Ann Benitez,27,0,40,13
1713522824080,EDS 281,A00,507345,Daly; Alan J.,18,0,18,0
1713522825106,EDS 284,A00,507350,Daly; Alan J.,16,0,16,0
1713522826132,EDS 286,A00,507359,Fine; Sarah,18,0,18,0
1713522827158,EDS 289C,A01,507361,Daly; Alan J.,18,0,18,0
1713522828183,EDS 290,A00,507366,Hofstetter; Carolyn,15,0,15,0
1713522829216,LIGM 5A,A00,507421,Fischer-Grunski; Eva K,20,0,20,0
1713522830242,LIGM 5B,A00,507423,Fischer-Grunski; Eva K,20,0,20,0
1713522831270,LIGM 5C,A00,507425,Fischer-Grunski; Eva K,20,0,20,0
1713522832297,LIIT 5AS,A00,507427,Carnelos; Chiara,20,0,20,0
1713522833323,LIIT 5BS,A00,507430,Carnelos; Chiara,20,0,20,0
1713522834349,LIIT 5CS,A00,507432,Carnelos; Chiara,20,0,20,0
1713522835376,LISP 5A,A00,507541,Munoz Sanchez; Alicia,14,0,20,6
1713522836407,LISP 5B,A00,507671,Munoz Sanchez; Alicia,12,0,20,8
1713522837433,LISP 5C,A00,507696,Munoz Sanchez; Alicia,11,0,20,9
1713522838521,MAE 197,001,528363,Boechler; Nicholas Sebastia,9998,0,9999,1
1713522839549,MATH 197,001,523477,Kedlaya; Kiran S.,9999,0,9999,0
1713522839549,MATH 197,002,563811,Zhang; Danna,9998,0,9999,1
1713522840576,MCWP 40R,A00,518780,Staff,13,0,20,7
1713522840576,MCWP 40R,B00,518781,Staff,11,0,20,9
1713522840576,MCWP 40R,C00,518783,Staff,8,0,20,12
1713522841603,MCWP 50R,A00,518791,Staff,7,0,20,13
1713522841603,MCWP 50R,B00,518792,Staff,3,0,20,17
1713522841603,MCWP 50R,C00,518793,Staff,5,0,20,15
1713522841603,MCWP 50R,D00,518794,Staff,0,0,20,20
1713522841603,MCWP 50R,E00,518795,Staff,0,0,20,20
1713522841603,MCWP 50R,F00,518796,Staff,10,0,20,10
1713522841603,MCWP 50R,G00,518797,Staff,10,0,20,10
1713522842631,MMW 12R,A01,514034,Herbst; Matthew,1,0,16,15
1713522842631,MMW 12R,A02,514035,Herbst; Matthew,13,0,16,3
1713522843659,MMW 13R,A01,514037,Staff,0,8,16,16
1713522843659,MMW 13R,A02,514039,Staff,0,7,16,16
1713522845712,SIO 295LS,A00,523233,Staff,15,0,30,15
1713522846737,SIO 295S,A00,523232,Staff,15,0,30,15
1713522847764,SOCI 117,A01,494376,Staff,0,2,5,5
1713522848796,WES 237B,A00,494380,Staff,19,0,20,1
1713522850881,AESE 279B,A00,494370,Wade; Jon P,33,0,33,0
1713522851908,AIP 197,001,627712,Vespa; Emanuel Ignacio,9999,0,9999,0
1713522852944,ANAR 135S,A00,494369,Braswell; Geoffrey E.,0,0,0,0
1713522853974,CAT 124RS,A01,519847,Geibel; William,6,0,20,14
1713522855000,CAT 125RS,A01,515971,Geibel; William,6,0,20,14
1713522856028,CLRE 250,A00,511389,Morris; Sheldon,9996,0,9999,3
1713522857062,CLRE 251,A00,507176,Mehta; Ravindra L.,9996,0,9999,3
1713522857062,CLRE 251,B00,511410,Mehta; Ravindra L.,9998,0,9999,1
1713522858092,CLRE 252,A00,507189,Cuomo; Raphael Eduardo,9998,0,9999,1
1713522859119,CLRE 253,A00,507199,Vaida; Florin,9997,0,9999,2
1713522859119,CLRE 253,B00,507202,Vaida; Florin,9999,0,9999,0
1713522860156,CLRE 259,A00,507211,Patel; Hemal,9996,0,9999,3
1713522861182,CLRE 260,A00,507221,Cuomo; Raphael Eduardo,9999,0,9999,0
1713522862207,CLRE 297,001,507242,Cuomo; Raphael Eduardo,9999,0,9999,0
1713522863234,CSE 191,A00,516875,Minnes Kemp; Mor Mia,9999,0,9999,0
1713522864261,CSS 201S,A01,494383,Staff,35,0,35,0
1713522865291,CSS 202S,A01,494387,Staff,35,0,35,0
1713522866316,EAP 100,A00,516065,Staff,9792,0,9999,207
1713522867347,ECE 45,A01,507414,Staff,37,0,60,23
1713522868371,ECE 100,A01,507416,Baghdadchi; Saharnaz,0,0,20,20
1713522868371,ECE 100,A02,507418,Baghdadchi; Saharnaz,19,0,20,1
1713522869402,ECE 111,A01,507420,Staff,27,0,50,23
1713522870428,ECE 197,001,548057,Sievenpiper; Daniel F.,9998,0,9999,1
1713522871454,EDS 115,A00,507243,Choi; Bailey Miyeon,27,0,28,1
1713522872481,EDS 117,A01,494379,Staff,14,0,25,11
1713522873507,EDS 125,A00,507246,Hopkins; Megan Beth,27,0,30,3
1713522874537,EDS 128A,A01,507264,Fargason; Sharon Gayle,26,0,26,0
1713522875564,EDS 128B,A01,507293,Pappas; Elizabeth,30,0,30,0
1713522876589,EDS 139,A00,507294,Fargason; Sharon Gayle,30,0,30,0
1713522876589,EDS 139,B00,507313,Pappas; Elizabeth,30,0,30,0
1713522877611,EDS 201,A00,507315,Staff,18,0,30,12
1713522878644,EDS 203,A01,507317,Halter; Christopher P.,17,0,30,13
1713522879672,EDS 204R,A01,507319,Halter; Christopher P.,0,1,30,30
1713522879672,EDS 204R,B01,507331,Heinzman; Erica M.,22,0,30,8
1713522880699,EDS 206R,A00,507332,Staff,0,2,30,30
1713522880699,EDS 206R,B00,507343,Staff,23,0,30,7
1713522881729,EDS 250,A00,507344,Hemans; Patricia Ann Benitez,27,0,40,13
1713522882758,EDS 281,A00,507345,Daly; Alan J.,18,0,18,0
1713522883784,EDS 284,A00,507350,Daly; Alan J.,16,0,16,0
1713522884810,EDS 286,A00,507359,Fine; Sarah,18,0,18,0
1713522885836,EDS 289C,A01,507361,Daly; Alan J.,18,0,18,0
1713522886863,EDS 290,A00,507366,Hofstetter; Carolyn,15,0,15,0
1713522887894,LIGM 5A,A00,507421,Fischer-Grunski; Eva K,20,0,20,0
1713522888926,LIGM 5B,A00,507423,Fischer-Grunski; Eva K,20,0,20,0
1713522889956,LIGM 5C,A00,507425,Fischer-Grunski; Eva K,20,0,20,0
1713522890982,LIIT 5AS,A00,507427,Carnelos; Chiara,20,0,20,0
1713522892012,LIIT 5BS,A00,507430,Carnelos; Chiara,20,0,20,0
1713522893038,LIIT 5CS,A00,507432,Carnelos; Chiara,20,0,20,0
1713522894065,LISP 5A,A00,507541,Munoz Sanchez; Alicia,14,0,20,6
1713522895094,LISP 5B,A00,507671,Munoz Sanchez; Alicia,12,0,20,8
1713522896131,LISP 5C,A00,507696,Munoz Sanchez; Alicia,11,0,20,9
1713522897161,MAE 197,001,528363,Boechler; Nicholas Sebastia,9998,0,9999,1
1713522898195,MATH 197,001,523477,Kedlaya; Kiran S.,9999,0,9999,0
1713522898195,MATH 197,002,563811,Zhang; Danna,9998,0,9999,1
1713522899226,MCWP 40R,A00,518780,Staff,13,0,20,7
1713522899226,MCWP 40R,B00,518781,Staff,11,0,20,9
1713522899226,MCWP 40R,C00,518783,Staff,8,0,20,12
1713522900252,MCWP 50R,A00,518791,Staff,7,0,20,13
1713522900252,MCWP 50R,B00,518792,Staff,3,0,20,17
1713522900252,MCWP 50R,C00,518793,Staff,5,0,20,15
1713522900252,MCWP 50R,D00,518794,Staff,0,0,20,20
1713522900252,MCWP 50R,E00,518795,Staff,0,0,20,20
1713522900252,MCWP 50R,F00,518796,Staff,10,0,20,10
1713522900252,MCWP 50R,G00,518797,Staff,10,0,20,10
1713522901279,MMW 12R,A01,514034,Herbst; Matthew,1,0,16,15
1713522901279,MMW 12R,A02,514035,Herbst; Matthew,13,0,16,3
1713522902304,MMW 13R,A01,514037,Staff,0,8,16,16
1713522902304,MMW 13R,A02,514039,Staff,0,7,16,16
1713522904360,SIO 295LS,A00,523233,Staff,15,0,30,15
1713522905392,SIO 295S,A00,523232,Staff,15,0,30,15
1713522906419,SOCI 117,A01,494376,Staff,0,2,5,5
1713522907444,WES 237B,A00,494380,Staff,19,0,20,1
1713522909522,AESE 279B,A00,494370,Wade; Jon P,33,0,33,0
1713522910553,AIP 197,001,627712,Vespa; Emanuel Ignacio,9999,0,9999,0
1713522911582,ANAR 135S,A00,494369,Braswell; Geoffrey E.,0,0,0,0
1713522912613,CAT 124RS,A01,519847,Geibel; William,6,0,20,14
1713522913637,CAT 125RS,A01,515971,Geibel; William,6,0,20,14
1713522914664,CLRE 250,A00,511389,Morris; Sheldon,9996,0,9999,3
1713522915690,CLRE 251,A00,507176,Mehta; Ravindra L.,9996,0,9999,3
1713522915690,CLRE 251,B00,511410,Mehta; Ravindra L.,9998,0,9999,1
1713522916720,CLRE 252,A00,507189,Cuomo; Raphael Eduardo,9998,0,9999,1
1713522917749,CLRE 253,A00,507199,Vaida; Florin,9997,0,9999,2
1713522917749,CLRE 253,B00,507202,Vaida; Florin,9999,0,9999,0
1713522918780,CLRE 259,A00,507211,Patel; Hemal,9996,0,9999,3
1713522919808,CLRE 260,A00,507221,Cuomo; Raphael Eduardo,9999,0,9999,0
1713522920833,CLRE 297,001,507242,Cuomo; Raphael Eduardo,9999,0,9999,0
1713522921865,CSE 191,A00,516875,Minnes Kemp; Mor Mia,9999,0,9999,0
1713522922889,CSS 201S,A01,494383,Staff,35,0,35,0
1713522923913,CSS 202S,A01,494387,Staff,35,0,35,0
1713522924944,EAP 100,A00,516065,Staff,9792,0,9999,207
1713522925972,ECE 45,A01,507414,Staff,37,0,60,23
1713522927003,ECE 100,A01,507416,Baghdadchi; Saharnaz,0,0,20,20
1713522927003,ECE 100,A02,507418,Baghdadchi; Saharnaz,19,0,20,1
1713522928029,ECE 111,A01,507420,Staff,27,0,50,23
1713522929059,ECE 197,001,548057,Sievenpiper; Daniel F.,9998,0,9999,1
1713522930085,EDS 115,A00,507243,Choi; Bailey Miyeon,27,0,28,1
1713522931111,EDS 117,A01,494379,Staff,14,0,25,11
1713522932136,EDS 125,A00,507246,Hopkins; Megan Beth,27,0,30,3
1713522933162,EDS 128A,A01,507264,Fargason; Sharon Gayle,26,0,26,0
1713522934188,EDS 128B,A01,507293,Pappas; Elizabeth,30,0,30,0
1713522935213,EDS 139,A00,507294,Fargason; Sharon Gayle,30,0,30,0
1713522935213,EDS 139,B00,507313,Pappas; Elizabeth,30,0,30,0
1713522936238,EDS 201,A00,507315,Staff,18,0,30,12
1713522937264,EDS 203,A01,507317,Halter; Christopher P.,17,0,30,13
1713522938291,EDS 204R,A01,507319,Halter; Christopher P.,0,1,30,30
1713522938291,EDS 204R,B01,507331,Heinzman; Erica M.,22,0,30,8
1713522939316,EDS 206R,A00,507332,Staff,0,2,30,30
1713522939316,EDS 206R,B00,507343,Staff,23,0,30,7
1713522940346,EDS 250,A00,507344,Hemans; Patricia Ann Benitez,27,0,40,13
1713522941371,EDS 281,A00,507345,Daly; Alan J.,18,0,18,0
1713522942454,EDS 284,A00,507350,Daly; Alan J.,16,0,16,0
1713522943484,EDS 286,A00,507359,Fine; Sarah,18,0,18,0
1713522944512,EDS 289C,A01,507361,Daly; Alan J.,18,0,18,0
1713522945539,EDS 290,A00,507366,Hofstetter; Carolyn,15,0,15,0
1713522946565,LIGM 5A,A00,507421,Fischer-Grunski; Eva K,20,0,20,0
1713522947594,LIGM 5B,A00,507423,Fischer-Grunski; Eva K,20,0,20,0
1713522948620,LIGM 5C,A00,507425,Fischer-Grunski; Eva K,20,0,20,0
1713522949650,LIIT 5AS,A00,507427,Carnelos; Chiara,20,0,20,0
1713522950677,LIIT 5BS,A00,507430,Carnelos; Chiara,20,0,20,0
1713522951708,LIIT 5CS,A00,507432,Carnelos; Chiara,20,0,20,0
1713522952740,LISP 5A,A00,507541,Munoz Sanchez; Alicia,14,0,20,6
1713522953771,LISP 5B,A00,507671,Munoz Sanchez; Alicia,12,0,20,8
1713522954802,LISP 5C,A00,507696,Munoz Sanchez; Alicia,11,0,20,9
1713522955829,MAE 197,001,528363,Boechler; Nicholas Sebastia,9998,0,9999,1
1713522956858,MATH 197,001,523477,Kedlaya; Kiran S.,9999,0,9999,0
1713522956858,MATH 197,002,563811,Zhang; Danna,9998,0,9999,1
1713522957884,MCWP 40R,A00,518780,Staff,13,0,20,7
1713522957884,MCWP 40R,B00,518781,Staff,11,0,20,9
1713522957884,MCWP 40R,C00,518783,Staff,8,0,20,12
1713522958911,MCWP 50R,A00,518791,Staff,7,0,20,13
1713522958911,MCWP 50R,B00,518792,Staff,3,0,20,17
1713522958911,MCWP 50R,C00,518793,Staff,5,0,20,15
1713522958911,MCWP 50R,D00,518794,Staff,0,0,20,20
1713522958911,MCWP 50R,E00,518795,Staff,0,0,20,20
1713522958911,MCWP 50R,F00,518796,Staff,10,0,20,10
1713522958911,MCWP 50R,G00,518797,Staff,10,0,20,10
1713522959937,MMW 12R,A01,514034,Herbst; Matthew,1,0,16,15
1713522959937,MMW 12R,A02,514035,Herbst; Matthew,13,0,16,3
1713522960964,MMW 13R,A01,514037,Staff,0,8,16,16
1713522960964,MMW 13R,A02,514039,Staff,0,7,16,16
1713522963016,SIO 295LS,A00,523233,Staff,15,0,30,15
1713522964040,SIO 295S,A00,523232,Staff,15,0,30,15
1713522965072,SOCI 117,A01,494376,Staff,0,2,5,5
1713522966102,WES 237B,A00,494380,Staff,19,0,20,1
1713522968193,AESE 279B,A00,494370,Wade; Jon P,33,0,33,0
1713522969220,AIP 197,001,627712,Vespa; Emanuel Ignacio,9999,0,9999,0
1713522970246,ANAR 135S,A00,494369,Braswell; Geoffrey E.,0,0,0,0
1713522971273,CAT 124RS,A01,519847,Geibel; William,6,0,20,14
1713522972303,CAT 125RS,A01,515971,Geibel; William,6,0,20,14
1713522973334,CLRE 250,A00,511389,Morris; Sheldon,9996,0,9999,3
1713522974361,CLRE 251,A00,507176,Mehta; Ravindra L.,9996,0,9999,3
1713522974361,CLRE 251,B00,511410,Mehta; Ravindra L.,9998,0,9999,1
1713522975387,CLRE 252,A00,507189,Cuomo; Raphael Eduardo,9998,0,9999,1
1713522976413,CLRE 253,A00,507199,Vaida; Florin,9997,0,9999,2
1713522976413,CLRE 253,B00,507202,Vaida; Florin,9999,0,9999,0
1713522977439,CLRE 259,A00,507211,Patel; Hemal,9996,0,9999,3
1713522978465,CLRE 260,A00,507221,Cuomo; Raphael Eduardo,9999,0,9999,0
1713522979490,CLRE 297,001,507242,Cuomo; Raphael Eduardo,9999,0,9999,0
1713522980516,CSE 191,A00,516875,Minnes Kemp; Mor Mia,9999,0,9999,0
1713522981543,CSS 201S,A01,494383,Staff,35,0,35,0
1713522982567,CSS 202S,A01,494387,Staff,35,0,35,0
1713522983592,EAP 100,A00,516065,Staff,9792,0,9999,207
1713522984618,ECE 45,A01,507414,Staff,37,0,60,23
1713522985643,ECE 100,A01,507416,Baghdadchi; Saharnaz,0,0,20,20
1713522985643,ECE 100,A02,507418,Baghdadchi; Saharnaz,19,0,20,1
1713522986673,ECE 111,A01,507420,Staff,27,0,50,23
1713522987700,ECE 197,001,548057,Sievenpiper; Daniel F.,9998,0,9999,1
1713522988728,EDS 115,A00,507243,Choi; Bailey Miyeon,27,0,28,1
1713522989754,EDS 117,A01,494379,Staff,14,0,25,11
1713522990780,EDS 125,A00,507246,Hopkins; Megan Beth,27,0,30,3
1713522991804,EDS 128A,A01,507264,Fargason; Sharon Gayle,26,0,26,0
1713522992835,EDS 128B,A01,507293,Pappas; Elizabeth,30,0,30,0
1713522993870,EDS 139,A00,507294,Fargason; Sharon Gayle,30,0,30,0
1713522993870,EDS 139,B00,507313,Pappas; Elizabeth,30,0,30,0
1713522994895,EDS 201,A00,507315,Staff,18,0,30,12
1713522995922,EDS 203,A01,507317,Halter; Christopher P.,17,0,30,13
1713522996953,EDS 204R,A01,507319,Halter; Christopher P.,0,1,30,30
1713522996953,EDS 204R,B01,507331,Heinzman; Erica M.,22,0,30,8
1713522997984,EDS 206R,A00,507332,Staff,0,2,30,30
1713522997984,EDS 206R,B00,507343,Staff,23,0,30,7
1713522999011,EDS 250,A00,507344,Hemans; Patricia Ann Benitez,27,0,40,13
1713523000038,EDS 281,A00,507345,Daly; Alan J.,18,0,18,0
1713523001068,EDS 284,A00,507350,Daly; Alan J.,16,0,16,0
1713523002098,EDS 286,A00,507359,Fine; Sarah,18,0,18,0
1713523003123,EDS 289C,A01,507361,Daly; Alan J.,18,0,18,0
1713523004154,EDS 290,A00,507366,Hofstetter; Carolyn,15,0,15,0
1713523005181,LIGM 5A,A00,507421,Fischer-Grunski; Eva K,20,0,20,0
1713523006207,LIGM 5B,A00,507423,Fischer-Grunski; Eva K,20,0,20,0
1713523007235,LIGM 5C,A00,507425,Fischer-Grunski; Eva K,20,0,20,0
1713523008262,LIIT 5AS,A00,507427,Carnelos; Chiara,20,0,20,0
1713523009291,LIIT 5BS,A00,507430,Carnelos; Chiara,20,0,20,0
1713523010317,LIIT 5CS,A00,507432,Carnelos; Chiara,20,0,20,0
1713523011344,LISP 5A,A00,507541,Munoz Sanchez; Alicia,14,0,20,6
1713523012373,LISP 5B,A00,507671,Munoz Sanchez; Alicia,12,0,20,8
1713523013399,LISP 5C,A00,507696,Munoz Sanchez; Alicia,11,0,20,9
1713523014423,MAE 197,001,528363,Boechler; Nicholas Sebastia,9998,0,9999,1
1713523015452,MATH 197,001,523477,Kedlaya; Kiran S.,9999,0,9999,0
1713523015452,MATH 197,002,563811,Zhang; Danna,9998,0,9999,1
1713523016478,MCWP 40R,A00,518780,Staff,13,0,20,7
1713523016478,MCWP 40R,B00,518781,Staff,11,0,20,9
1713523016478,MCWP 40R,C00,518783,Staff,8,0,20,12
1713523017504,MCWP 50R,A00,518791,Staff,7,0,20,13
1713523017504,MCWP 50R,B00,518792,Staff,3,0,20,17
1713523017504,MCWP 50R,C00,518793,Staff,5,0,20,15
1713523017504,MCWP 50R,D00,518794,Staff,0,0,20,20
1713523017504,MCWP 50R,E00,518795,Staff,0,0,20,20
1713523017504,MCWP 50R,F00,518796,Staff,10,0,20,10
1713523017504,MCWP 50R,G00,518797,Staff,10,0,20,10
1713523018534,MMW 12R,A01,514034,Herbst; Matthew,1,0,16,15
1713523018534,MMW 12R,A02,514035,Herbst; Matthew,13,0,16,3
1713523019563,MMW 13R,A01,514037,Staff,0,8,16,16
1713523019563,MMW 13R,A02,514039,Staff,0,7,16,16
1713523021619,SIO 295LS,A00,523233,Staff,15,0,30,15
1713523022645,SIO 295S,A00,523232,Staff,15,0,30,15
1713523023688,SOCI 117,A01,494376,Staff,0,2,5,5
1713523024717,WES 237B,A00,494380,Staff,19,0,20,1
1713523026798,AESE 279B,A00,494370,Wade; Jon P,33,0,33,0
1713523027823,AIP 197,001,627712,Vespa; Emanuel Ignacio,9999,0,9999,0
1713523028851,ANAR 135S,A00,494369,Braswell; Geoffrey E.,0,0,0,0
1713523029877,CAT 124RS,A01,519847,Geibel; William,6,0,20,14
1713523030903,CAT 125RS,A01,515971,Geibel; William,6,0,20,14
1713523031930,CLRE 250,A00,511389,Morris; Sheldon,9996,0,9999,3
1713523032958,CLRE 251,A00,507176,Mehta; Ravindra L.,9996,0,9999,3
1713523032958,CLRE 251,B00,511410,Mehta; Ravindra L.,9998,0,9999,1
1713523033987,CLRE 252,A00,507189,Cuomo; Raphael Eduardo,9998,0,9999,1
1713523035012,CLRE 253,A00,507199,Vaida; Florin,9997,0,9999,2
1713523035012,CLRE 253,B00,507202,Vaida; Florin,9999,0,9999,0
1713523036044,CLRE 259,A00,507211,Patel; Hemal,9996,0,9999,3
1713523037070,CLRE 260,A00,507221,Cuomo; Raphael Eduardo,9999,0,9999,0
1713523038096,CLRE 297,001,507242,Cuomo; Raphael Eduardo,9999,0,9999,0
1713523039121,CSE 191,A00,516875,Minnes Kemp; Mor Mia,9999,0,9999,0
1713523040153,CSS 201S,A01,494383,Staff,35,0,35,0
1713523041183,CSS 202S,A01,494387,Staff,35,0,35,0
1713523042210,EAP 100,A00,516065,Staff,9792,0,9999,207
1713523043235,ECE 45,A01,507414,Staff,37,0,60,23
1713523044262,ECE 100,A01,507416,Baghdadchi; Saharnaz,0,0,20,20
1713523044262,ECE 100,A02,507418,Baghdadchi; Saharnaz,19,0,20,1
1713523045287,ECE 111,A01,507420,Staff,27,0,50,23
1713523046368,ECE 197,001,548057,Sievenpiper; Daniel F.,9998,0,9999,1
1713523047394,EDS 115,A00,507243,Choi; Bailey Miyeon,27,0,28,1
1713523048421,EDS 117,A01,494379,Staff,14,0,25,11
1713523049451,EDS 125,A00,507246,Hopkins; Megan Beth,27,0,30,3
1713523050480,EDS 128A,A01,507264,Fargason; Sharon Gayle,26,0,26,0
1713523051506,EDS 128B,A01,507293,Pappas; Elizabeth,30,0,30,0
1713523052533,EDS 139,A00,507294,Fargason; Sharon Gayle,30,0,30,0
1713523052533,EDS 139,B00,507313,Pappas; Elizabeth,30,0,30,0
1713523053563,EDS 201,A00,507315,Staff,18,0,30,12
1713523054588,EDS 203,A01,507317,Halter; Christopher P.,17,0,30,13
1713523055614,EDS 204R,A01,507319,Halter; Christopher P.,0,1,30,30
1713523055614,EDS 204R,B01,507331,Heinzman; Erica M.,22,0,30,8
1713523056639,EDS 206R,A00,507332,Staff,0,2,30,30
1713523056639,EDS 206R,B00,507343,Staff,23,0,30,7
1713523057664,EDS 250,A00,507344,Hemans; Patricia Ann Benitez,27,0,40,13
1713523058690,EDS 281,A00,507345,Daly; Alan J.,18,0,18,0
1713523059715,EDS 284,A00,507350,Daly; Alan J.,16,0,16,0
1713523060745,EDS 286,A00,507359,Fine; Sarah,18,0,18,0
1713523061771,EDS 289C,A01,507361,Daly; Alan J.,18,0,18,0
1713523062800,EDS 290,A00,507366,Hofstetter; Carolyn,15,0,15,0
1713523063827,LIGM 5A,A00,507421,Fischer-Grunski; Eva K,20,0,20,0
1713523064857,LIGM 5B,A00,507423,Fischer-Grunski; Eva K,20,0,20,0
1713523065883,LIGM 5C,A00,507425,Fischer-Grunski; Eva K,20,0,20,0
1713523066910,LIIT 5AS,A00,507427,Carnelos; Chiara,20,0,20,0
1713523067940,LIIT 5BS,A00,507430,Carnelos; Chiara,20,0,20,0
1713523068966,LIIT 5CS,A00,507432,Carnelos; Chiara,20,0,20,0
1713523069993,LISP 5A,A00,507541,Munoz Sanchez; Alicia,14,0,20,6
1713523071020,LISP 5B,A00,507671,Munoz Sanchez; Alicia,12,0,20,8
1713523072046,LISP 5C,A00,507696,Munoz Sanchez; Alicia,11,0,20,9
1713523073072,MAE 197,001,528363,Boechler; Nicholas Sebastia,9998,0,9999,1
1713523074101,MATH 197,001,523477,Kedlaya; Kiran S.,9999,0,9999,0
1713523074101,MATH 197,002,563811,Zhang; Danna,9998,0,9999,1
1713523075127,MCWP 40R,A00,518780,Staff,13,0,20,7
1713523075127,MCWP 40R,B00,518781,Staff,11,0,20,9
1713523075127,MCWP 40R,C00,518783,Staff,8,0,20,12
1713523076153,MCWP 50R,A00,518791,Staff,7,0,20,13
1713523076153,MCWP 50R,B00,518792,Staff,3,0,20,17
1713523076153,MCWP 50R,C00,518793,Staff,5,0,20,15
1713523076153,MCWP 50R,D00,518794,Staff,0,0,20,20
1713523076153,MCWP 50R,E00,518795,Staff,0,0,20,20
1713523076153,MCWP 50R,F00,518796,Staff,10,0,20,10
1713523076153,MCWP 50R,G00,518797,Staff,10,0,20,10
1713523077179,MMW 12R,A01,514034,Herbst; Matthew,1,0,16,15
1713523077179,MMW 12R,A02,514035,Herbst; Matthew,13,0,16,3
1713523078209,MMW 13R,A01,514037,Staff,0,8,16,16
1713523078209,MMW 13R,A02,514039,Staff,0,7,16,16
1713523080261,SIO 295LS,A00,523233,Staff,15,0,30,15
1713523081286,SIO 295S,A00,523232,Staff,15,0,30,15
1713523082317,SOCI 117,A01,494376,Staff,0,2,5,5
1713523083352,WES 237B,A00,494380,Staff,19,0,20,1
1713523085443,AESE 279B,A00,494370,Wade; Jon P,33,0,33,0
1713523086473,AIP 197,001,627712,Vespa; Emanuel Ignacio,9999,0,9999,0
1713523087500,ANAR 135S,A00,494369,Braswell; Geoffrey E.,0,0,0,0
1713523088525,CAT 124RS,A01,519847,Geibel; William,6,0,20,14
1713523089552,CAT 125RS,A01,515971,Geibel; William,6,0,20,14
1713523090579,CLRE 250,A00,511389,Morris; Sheldon,9996,0,9999,3
1713523091608,CLRE 251,A00,507176,Mehta; Ravindra L.,9996,0,9999,3
1713523091608,CLRE 251,B00,511410,Mehta; Ravindra L.,9998,0,9999,1
1713523092633,CLRE 252,A00,507189,Cuomo; Raphael Eduardo,9998,0,9999,1
1713523093664,CLRE 253,A00,507199,Vaida; Florin,9997,0,9999,2
1713523093664,CLRE 253,B00,507202,Vaida; Florin,9999,0,9999,0
1713523094689,CLRE 259,A00,507211,Patel; Hemal,9996,0,9999,3
1713523095718,CLRE 260,A00,507221,Cuomo; Raphael Eduardo,9999,0,9999,0
1713523096748,CLRE 297,001,507242,Cuomo; Raphael Eduardo,9999,0,9999,0
1713523097778,CSE 191,A00,516875,Minnes Kemp; Mor Mia,9999,0,9999,0
1713523098813,CSS 201S,A01,494383,Staff,35,0,35,0
1713523099839,CSS 202S,A01,494387,Staff,35,0,35,0
1713523100868,EAP 100,A00,516065,Staff,9792,0,9999,207
1713523101895,ECE 45,A01,507414,Staff,37,0,60,23
1713523102923,ECE 100,A01,507416,Baghdadchi; Saharnaz,0,0,20,20
1713523102923,ECE 100,A02,507418,Baghdadchi; Saharnaz,19,0,20,1
1713523103949,ECE 111,A01,507420,Staff,27,0,50,23
1713523104979,ECE 197,001,548057,Sievenpiper; Daniel F.,9998,0,9999,1
1713523106007,EDS 115,A00,507243,Choi; Bailey Miyeon,27,0,28,1
1713523107036,EDS 117,A01,494379,Staff,14,0,25,11
1713523108066,EDS 125,A00,507246,Hopkins; Megan Beth,27,0,30,3
1713523109092,EDS 128A,A01,507264,Fargason; Sharon Gayle,26,0,26,0
1713523110138,EDS 128B,A01,507293,Pappas; Elizabeth,30,0,30,0
1713523111164,EDS 139,A00,507294,Fargason; Sharon Gayle,30,0,30,0
1713523111164,EDS 139,B00,507313,Pappas; Elizabeth,30,0,30,0
1713523112189,EDS 201,A00,507315,Staff,18,0,30,12
1713523113216,EDS 203,A01,507317,Halter; Christopher P.,17,0,30,13
1713523114243,EDS 204R,A01,507319,Halter; Christopher P.,0,1,30,30
1713523114243,EDS 204R,B01,507331,Heinzman; Erica M.,22,0,30,8
1713523115273,EDS 206R,A00,507332,Staff,0,2,30,30
1713523115273,EDS 206R,B00,507343,Staff,23,0,30,7
1713523116303,EDS 250,A00,507344,Hemans; Patricia Ann Benitez,27,0,40,13
1713523117331,EDS 281,A00,507345,Daly; Alan J.,18,0,18,0
1713523118358,EDS 284,A00,507350,Daly; Alan J.,16,0,16,0
1713523119384,EDS 286,A00,507359,Fine; Sarah,18,0,18,0
1713523120411,EDS 289C,A01,507361,Daly; Alan J.,18,0,18,0
1713523121440,EDS 290,A00,507366,Hofstetter; Carolyn,15,0,15,0
1713523122472,LIGM 5A,A00,507421,Fischer-Grunski; Eva K,20,0,20,0
1713523123498,LIGM 5B,A00,507423,Fischer-Grunski; Eva K,20,0,20,0
1713523124523,LIGM 5C,A00,507425,Fischer-Grunski; Eva K,20,0,20,0
1713523125551,LIIT 5AS,A00,507427,Carnelos; Chiara,20,0,20,0
1713523126577,LIIT 5BS,A00,507430,Carnelos; Chiara,20,0,20,0
1713523127601,LIIT 5CS,A00,507432,Carnelos; Chiara,20,0,20,0
1713523128627,LISP 5A,A00,507541,Munoz Sanchez; Alicia,14,0,20,6
1713523129657,LISP 5B,A00,507671,Munoz Sanchez; Alicia,12,0,20,8
1713523130682,LISP 5C,A00,507696,Munoz Sanchez; Alicia,11,0,20,9
1713523131712,MAE 197,001,528363,Boechler; Nicholas Sebastia,9998,0,9999,1
1713523132739,MATH 197,001,523477,Kedlaya; Kiran S.,9999,0,9999,0
1713523132739,MATH 197,002,563811,Zhang; Danna,9998,0,9999,1
1713523133765,MCWP 40R,A00,518780,Staff,13,0,20,7
1713523133765,MCWP 40R,B00,518781,Staff,11,0,20,9
1713523133765,MCWP 40R,C00,518783,Staff,8,0,20,12
1713523134791,MCWP 50R,A00,518791,Staff,7,0,20,13
1713523134791,MCWP 50R,B00,518792,Staff,3,0,20,17
1713523134791,MCWP 50R,C00,518793,Staff,5,0,20,15
1713523134791,MCWP 50R,D00,518794,Staff,0,0,20,20
1713523134791,MCWP 50R,E00,518795,Staff,0,0,20,20
1713523134791,MCWP 50R,F00,518796,Staff,10,0,20,10
1713523134791,MCWP 50R,G00,518797,Staff,10,0,20,10
1713523135821,MMW 12R,A01,514034,Herbst; Matthew,1,0,16,15
1713523135821,MMW 12R,A02,514035,Herbst; Matthew,13,0,16,3
1713523136850,MMW 13R,A01,514037,Staff,0,8,16,16
1713523136850,MMW 13R,A02,514039,Staff,0,7,16,16
1713523138914,SIO 295LS,A00,523233,Staff,15,0,30,15
1713523139941,SIO 295S,A00,523232,Staff,15,0,30,15
1713523140968,SOCI 117,A01,494376,Staff,0,2,5,5
1713523141999,WES 237B,A00,494380,Staff,19,0,20,1
1713523144071,AESE 279B,A00,494370,Wade; Jon P,33,0,33,0
1713523145096,AIP 197,001,627712,Vespa; Emanuel Ignacio,9999,0,9999,0
1713523146124,ANAR 135S,A00,494369,Braswell; Geoffrey E.,0,0,0,0
1713523147155,CAT 124RS,A01,519847,Geibel; William,6,0,20,14
1713523148181,CAT 125RS,A01,515971,Geibel; William,6,0,20,14
1713523149209,CLRE 250,A00,511389,Morris; Sheldon,9996,0,9999,3
1713523150320,CLRE 251,A00,507176,Mehta; Ravindra L.,9996,0,9999,3
1713523150320,CLRE 251,B00,511410,Mehta; Ravindra L.,9998,0,9999,1
1713523151351,CLRE 252,A00,507189,Cuomo; Raphael Eduardo,9998,0,9999,1
1713523152378,CLRE 253,A00,507199,Vaida; Florin,9997,0,9999,2
1713523152378,CLRE 253,B00,507202,Vaida; Florin,9999,0,9999,0
1713523153404,CLRE 259,A00,507211,Patel; Hemal,9996,0,9999,3
1713523154432,CLRE 260,A00,507221,Cuomo; Raphael Eduardo,9999,0,9999,0
1713523155463,CLRE 297,001,507242,Cuomo; Raphael Eduardo,9999,0,9999,0
1713523156489,CSE 191,A00,516875,Minnes Kemp; Mor Mia,9999,0,9999,0
1713523157518,CSS 201S,A01,494383,Staff,35,0,35,0
1713523158545,CSS 202S,A01,494387,Staff,35,0,35,0
1713523159573,EAP 100,A00,516065,Staff,9792,0,9999,207
1713523160600,ECE 45,A01,507414,Staff,37,0,60,23
1713523161630,ECE 100,A01,507416,Baghdadchi; Saharnaz,0,0,20,20
1713523161630,ECE 100,A02,507418,Baghdadchi; Saharnaz,19,0,20,1
1713523162658,ECE 111,A01,507420,Staff,27,0,50,23
1713523163693,ECE 197,001,548057,Sievenpiper; Daniel F.,9998,0,9999,1
1713523164721,EDS 115,A00,507243,Choi; Bailey Miyeon,27,0,28,1
1713523165748,EDS 117,A01,494379,Staff,14,0,25,11
1713523166774,EDS 125,A00,507246,Hopkins; Megan Beth,27,0,30,3
1713523167814,EDS 128A,A01,507264,Fargason; Sharon Gayle,26,0,26,0
1713523168845,EDS 128B,A01,507293,Pappas; Elizabeth,30,0,30,0
1713523169877,EDS 139,A00,507294,Fargason; Sharon Gayle,30,0,30,0
1713523169877,EDS 139,B00,507313,Pappas; Elizabeth,30,0,30,0
1713523170903,EDS 201,A00,507315,Staff,18,0,30,12
1713523171933,EDS 203,A01,507317,Halter; Christopher P.,17,0,30,13
1713523172960,EDS 204R,A01,507319,Halter; Christopher P.,0,1,30,30
1713523172960,EDS 204R,B01,507331,Heinzman; Erica M.,22,0,30,8
1713523173988,EDS 206R,A00,507332,Staff,0,2,30,30
1713523173988,EDS 206R,B00,507343,Staff,23,0,30,7
1713523175018,EDS 250,A00,507344,Hemans; Patricia Ann Benitez,27,0,40,13
1713523176047,EDS 281,A00,507345,Daly; Alan J.,18,0,18,0
1713523177077,EDS 284,A00,507350,Daly; Alan J.,16,0,16,0
1713523178112,EDS 286,A00,507359,Fine; Sarah,18,0,18,0
1713523179139,EDS 289C,A01,507361,Daly; Alan J.,18,0,18,0
1713523180165,EDS 290,A00,507366,Hofstetter; Carolyn,15,0,15,0
1713523181193,LIGM 5A,A00,507421,Fischer-Grunski; Eva K,20,0,20,0
1713523182218,LIGM 5B,A00,507423,Fischer-Grunski; Eva K,20,0,20,0
1713523183245,LIGM 5C,A00,507425,Fischer-Grunski; Eva K,20,0,20,0
1713523184277,LIIT 5AS,A00,507427,Carnelos; Chiara,20,0,20,0
1713523185304,LIIT 5BS,A00,507430,Carnelos; Chiara,20,0,20,0
1713523186333,LIIT 5CS,A00,507432,Carnelos; Chiara,20,0,20,0
1713523187365,LISP 5A,A00,507541,Munoz Sanchez; Alicia,14,0,20,6
1713523188391,LISP 5B,A00,507671,Munoz Sanchez; Alicia,12,0,20,8
1713523189416,LISP 5C,A00,507696,Munoz Sanchez; Alicia,11,0,20,9
1713523190443,MAE 197,001,528363,Boechler; Nicholas Sebastia,9998,0,9999,1
1713523191478,MATH 197,001,523477,Kedlaya; Kiran S.,9999,0,9999,0
1713523191478,MATH 197,002,563811,Zhang; Danna,9998,0,9999,1
1713523192505,MCWP 40R,A00,518780,Staff,13,0,20,7
1713523192505,MCWP 40R,B00,518781,Staff,11,0,20,9
1713523192505,MCWP 40R,C00,518783,Staff,8,0,20,12
1713523193536,MCWP 50R,A00,518791,Staff,7,0,20,13
1713523193536,MCWP 50R,B00,518792,Staff,3,0,20,17
1713523193536,MCWP 50R,C00,518793,Staff,5,0,20,15
1713523193536,MCWP 50R,D00,518794,Staff,0,0,20,20
1713523193536,MCWP 50R,E00,518795,Staff,0,0,20,20
1713523193536,MCWP 50R,F00,518796,Staff,10,0,20,10
1713523193536,MCWP 50R,G00,518797,Staff,10,0,20,10
1713523194563,MMW 12R,A01,514034,Herbst; Matthew,1,0,16,15
1713523194563,MMW 12R,A02,514035,Herbst; Matthew,13,0,16,3
1713523195592,MMW 13R,A01,514037,Staff,0,8,16,16
1713523195592,MMW 13R,A02,514039,Staff,0,7,16,16
1713523197658,SIO 295LS,A00,523233,Staff,15,0,30,15
1713523198682,SIO 295S,A00,523232,Staff,15,0,30,15
1713523199709,SOCI 117,A01,494376,Staff,0,2,5,5
1713523200738,WES 237B,A00,494380,Staff,19,0,20,1
1713523202826,AESE 279B,A00,494370,Wade; Jon P,33,0,33,0
1713523203851,AIP 197,001,627712,Vespa; Emanuel Ignacio,9999,0,9999,0
1713523204880,ANAR 135S,A00,494369,Braswell; Geoffrey E.,0,0,0,0
1713523205910,CAT 124RS,A01,519847,Geibel; William,6,0,20,14
1713523206941,CAT 125RS,A01,515971,Geibel; William,6,0,20,14
1713523207967,CLRE 250,A00,511389,Morris; Sheldon,9996,0,9999,3
1713523208998,CLRE 251,A00,507176,Mehta; Ravindra L.,9996,0,9999,3
1713523208998,CLRE 251,B00,511410,Mehta; Ravindra L.,9998,0,9999,1
1713523210024,CLRE 252,A00,507189,Cuomo; Raphael Eduardo,9998,0,9999,1
1713523211055,CLRE 253,A00,507199,Vaida; Florin,9997,0,9999,2
1713523211055,CLRE 253,B00,507202,Vaida; Florin,9999,0,9999,0
1713523212082,CLRE 259,A00,507211,Patel; Hemal,9996,0,9999,3
1713523213110,CLRE 260,A00,507221,Cuomo; Raphael Eduardo,9999,0,9999,0
1713523214139,CLRE 297,001,507242,Cuomo; Raphael Eduardo,9999,0,9999,0
1713523215168,CSE 191,A00,516875,Minnes Kemp; Mor Mia,9999,0,9999,0
1713523216194,CSS 201S,A01,494383,Staff,35,0,35,0
1713523217224,CSS 202S,A01,494387,Staff,35,0,35,0
1713523218249,EAP 100,A00,516065,Staff,9792,0,9999,207
1713523219275,ECE 45,A01,507414,Staff,37,0,60,23
1713523220304,ECE 100,A01,507416,Baghdadchi; Saharnaz,0,0,20,20
1713523220304,ECE 100,A02,507418,Baghdadchi; Saharnaz,19,0,20,1
1713523221334,ECE 111,A01,507420,Staff,27,0,50,23
1713523222359,ECE 197,001,548057,Sievenpiper; Daniel F.,9998,0,9999,1
1713523223385,EDS 115,A00,507243,Choi; Bailey Miyeon,27,0,28,1
1713523224412,EDS 117,A01,494379,Staff,14,0,25,11
1713523225437,EDS 125,A00,507246,Hopkins; Megan Beth,27,0,30,3
1713523226464,EDS 128A,A01,507264,Fargason; Sharon Gayle,26,0,26,0
1713523227490,EDS 128B,A01,507293,Pappas; Elizabeth,30,0,30,0
1713523228515,EDS 139,A00,507294,Fargason; Sharon Gayle,30,0,30,0
1713523228515,EDS 139,B00,507313,Pappas; Elizabeth,30,0,30,0
1713523229540,EDS 201,A00,507315,Staff,18,0,30,12
1713523230567,EDS 203,A01,507317,Halter; Christopher P.,17,0,30,13
1713523231596,EDS 204R,A01,507319,Halter; Christopher P.,0,1,30,30
1713523231596,EDS 204R,B01,507331,Heinzman; Erica M.,22,0,30,8
1713523232622,EDS 206R,A00,507332,Staff,0,2,30,30
1713523232622,EDS 206R,B00,507343,Staff,23,0,30,7
1713523233652,EDS 250,A00,507344,Hemans; Patricia Ann Benitez,27,0,40,13
1713523234679,EDS 281,A00,507345,Daly; Alan J.,18,0,18,0
1713523235703,EDS 284,A00,507350,Daly; Alan J.,16,0,16,0
1713523236728,EDS 286,A00,507359,Fine; Sarah,18,0,18,0
1713523237753,EDS 289C,A01,507361,Daly; Alan J.,18,0,18,0
1713523238782,EDS 290,A00,507366,Hofstetter; Carolyn,15,0,15,0
1713523239809,LIGM 5A,A00,507421,Fischer-Grunski; Eva K,20,0,20,0
1713523240838,LIGM 5B,A00,507423,Fischer-Grunski; Eva K,20,0,20,0
1713523241863,LIGM 5C,A00,507425,Fischer-Grunski; Eva K,20,0,20,0
1713523242895,LIIT 5AS,A00,507427,Carnelos; Chiara,20,0,20,0
1713523243921,LIIT 5BS,A00,507430,Carnelos; Chiara,20,0,20,0
1713523244951,LIIT 5CS,A00,507432,Carnelos; Chiara,20,0,20,0
1713523245979,LISP 5A,A00,507541,Munoz Sanchez; Alicia,14,0,20,6
1713523247005,LISP 5B,A00,507671,Munoz Sanchez; Alicia,12,0,20,8
1713523248038,LISP 5C,A00,507696,Munoz Sanchez; Alicia,11,0,20,9
1713523249072,MAE 197,001,528363,Boechler; Nicholas Sebastia,9998,0,9999,1
1713523250099,MATH 197,001,523477,Kedlaya; Kiran S.,9999,0,9999,0
1713523250099,MATH 197,002,563811,Zhang; Danna,9998,0,9999,1
1713523251126,MCWP 40R,A00,518780,Staff,13,0,20,7
1713523251126,MCWP 40R,B00,518781,Staff,11,0,20,9
1713523251126,MCWP 40R,C00,518783,Staff,8,0,20,12
1713523252158,MCWP 50R,A00,518791,Staff,7,0,20,13
1713523252158,MCWP 50R,B00,518792,Staff,3,0,20,17
1713523252158,MCWP 50R,C00,518793,Staff,5,0,20,15
1713523252158,MCWP 50R,D00,518794,Staff,0,0,20,20
1713523252158,MCWP 50R,E00,518795,Staff,0,0,20,20
1713523252158,MCWP 50R,F00,518796,Staff,10,0,20,10
1713523252158,MCWP 50R,G00,518797,Staff,10,0,20,10
1713523253190,MMW 12R,A01,514034,Herbst; Matthew,1,0,16,15
1713523253190,MMW 12R,A02,514035,Herbst; Matthew,13,0,16,3
1713523254273,MMW 13R,A01,514037,Staff,0,8,16,16
1713523254273,MMW 13R,A02,514039,Staff,0,7,16,16
1713523256329,SIO 295LS,A00,523233,Staff,15,0,30,15
1713523257355,SIO 295S,A00,523232,Staff,15,0,30,15
1713523258385,SOCI 117,A01,494376,Staff,0,2,5,5
1713523259411,WES 237B,A00,494380,Staff,19,0,20,1
1713523261494,AESE 279B,A00,494370,Wade; Jon P,33,0,33,0
1713523262522,AIP 197,001,627712,Vespa; Emanuel Ignacio,9999,0,9999,0
1713523263548,ANAR 135S,A00,494369,Braswell; Geoffrey E.,0,0,0,0
1713523264576,CAT 124RS,A01,519847,Geibel; William,6,0,20,14
1713523265602,CAT 125RS,A01,515971,Geibel; William,6,0,20,14
1713523266634,CLRE 250,A00,511389,Morris; Sheldon,9996,0,9999,3
1713523267662,CLRE 251,A00,507176,Mehta; Ravindra L.,9996,0,9999,3
1713523267662,CLRE 251,B00,511410,Mehta; Ravindra L.,9998,0,9999,1
1713523268693,CLRE 252,A00,507189,Cuomo; Raphael Eduardo,9998,0,9999,1
1713523269719,CLRE 253,A00,507199,Vaida; Florin,9997,0,9999,2
1713523269719,CLRE 253,B00,507202,Vaida; Florin,9999,0,9999,0
1713523270745,CLRE 259,A00,507211,Patel; Hemal,9996,0,9999,3
1713523271774,CLRE 260,A00,507221,Cuomo; Raphael Eduardo,9999,0,9999,0
1713523272799,CLRE 297,001,507242,Cuomo; Raphael Eduardo,9999,0,9999,0
1713523273825,CSE 191,A00,516875,Minnes Kemp; Mor Mia,9999,0,9999,0
1713523274852,CSS 201S,A01,494383,Staff,35,0,35,0
1713523275878,CSS 202S,A01,494387,Staff,35,0,35,0
1713523276906,EAP 100,A00,516065,Staff,9792,0,9999,207
1713523277933,ECE 45,A01,507414,Staff,37,0,60,23
1713523278965,ECE 100,A01,507416,Baghdadchi; Saharnaz,0,0,20,20
1713523278965,ECE 100,A02,507418,Baghdadchi; Saharnaz,19,0,20,1
1713523279994,ECE 111,A01,507420,Staff,27,0,50,23
1713523281024,ECE 197,001,548057,Sievenpiper; Daniel F.,9998,0,9999,1
1713523282051,EDS 115,A00,507243,Choi; Bailey Miyeon,27,0,28,1
1713523283078,EDS 117,A01,494379,Staff,14,0,25,11
1713523284105,EDS 125,A00,507246,Hopkins; Megan Beth,27,0,30,3
1713523285131,EDS 128A,A01,507264,Fargason; Sharon Gayle,26,0,26,0
1713523286162,EDS 128B,A01,507293,Pappas; Elizabeth,30,0,30,0
1713523287192,EDS 139,A00,507294,Fargason; Sharon Gayle,30,0,30,0
1713523287192,EDS 139,B00,507313,Pappas; Elizabeth,30,0,30,0
1713523288220,EDS 201,A00,507315,Staff,18,0,30,12
1713523289252,EDS 203,A01,507317,Halter; Christopher P.,17,0,30,13
1713523290285,EDS 204R,A01,507319,Halter; Christopher P.,0,1,30,30
1713523290285,EDS 204R,B01,507331,Heinzman; Erica M.,22,0,30,8
1713523291312,EDS 206R,A00,507332,Staff,0,2,30,30
1713523291312,EDS 206R,B00,507343,Staff,23,0,30,7
1713523292340,EDS 250,A00,507344,Hemans; Patricia Ann Benitez,27,0,40,13
1713523293370,EDS 281,A00,507345,Daly; Alan J.,18,0,18,0
1713523294394,EDS 284,A00,507350,Daly; Alan J.,16,0,16,0
1713523295421,EDS 286,A00,507359,Fine; Sarah,18,0,18,0
1713523296446,EDS 289C,A01,507361,Daly; Alan J.,18,0,18,0
1713523297470,EDS 290,A00,507366,Hofstetter; Carolyn,15,0,15,0
1713523298497,LIGM 5A,A00,507421,Fischer-Grunski; Eva K,20,0,20,0
1713523299522,LIGM 5B,A00,507423,Fischer-Grunski; Eva K,20,0,20,0
1713523300549,LIGM 5C,A00,507425,Fischer-Grunski; Eva K,20,0,20,0
1713523301574,LIIT 5AS,A00,507427,Carnelos; Chiara,20,0,20,0
1713523302602,LIIT 5BS,A00,507430,Carnelos; Chiara,20,0,20,0
1713523303631,LIIT 5CS,A00,507432,Carnelos; Chiara,20,0,20,0
1713523304664,LISP 5A,A00,507541,Munoz Sanchez; Alicia,14,0,20,6
1713523305694,LISP 5B,A00,507671,Munoz Sanchez; Alicia,12,0,20,8
1713523306720,LISP 5C,A00,507696,Munoz Sanchez; Alicia,11,0,20,9
1713523307753,MAE 197,001,528363,Boechler; Nicholas Sebastia,9998,0,9999,1
1713523308785,MATH 197,001,523477,Kedlaya; Kiran S.,9999,0,9999,0
1713523308785,MATH 197,002,563811,Zhang; Danna,9998,0,9999,1
1713523309815,MCWP 40R,A00,518780,Staff,13,0,20,7
1713523309815,MCWP 40R,B00,518781,Staff,11,0,20,9
1713523309815,MCWP 40R,C00,518783,Staff,8,0,20,12
1713523310840,MCWP 50R,A00,518791,Staff,7,0,20,13
1713523310840,MCWP 50R,B00,518792,Staff,3,0,20,17
1713523310840,MCWP 50R,C00,518793,Staff,5,0,20,15
1713523310840,MCWP 50R,D00,518794,Staff,0,0,20,20
1713523310840,MCWP 50R,E00,518795,Staff,0,0,20,20
1713523310840,MCWP 50R,F00,518796,Staff,10,0,20,10
1713523310840,MCWP 50R,G00,518797,Staff,10,0,20,10
1713523311870,MMW 12R,A01,514034,Herbst; Matthew,1,0,16,15
1713523311870,MMW 12R,A02,514035,Herbst; Matthew,13,0,16,3
1713523312895,MMW 13R,A01,514037,Staff,0,8,16,16
1713523312895,MMW 13R,A02,514039,Staff,0,7,16,16
1713523314949,SIO 295LS,A00,523233,Staff,15,0,30,15
1713523315977,SIO 295S,A00,523232,Staff,15,0,30,15
1713523317007,SOCI 117,A01,494376,Staff,0,2,5,5
1713523318038,WES 237B,A00,494380,Staff,19,0,20,1
1713523320110,AESE 279B,A00,494370,Wade; Jon P,33,0,33,0
1713523321135,AIP 197,001,627712,Vespa; Emanuel Ignacio,9999,0,9999,0
1713523322167,ANAR 135S,A00,494369,Braswell; Geoffrey E.,0,0,0,0
1713523323195,CAT 124RS,A01,519847,Geibel; William,6,0,20,14
1713523324221,CAT 125RS,A01,515971,Geibel; William,6,0,20,14
1713523325247,CLRE 250,A00,511389,Morris; Sheldon,9996,0,9999,3
1713523326285,CLRE 251,A00,507176,Mehta; Ravindra L.,9996,0,9999,3
1713523326285,CLRE 251,B00,511410,Mehta; Ravindra L.,9998,0,9999,1
1713523327311,CLRE 252,A00,507189,Cuomo; Raphael Eduardo,9998,0,9999,1
1713523328339,CLRE 253,A00,507199,Vaida; Florin,9997,0,9999,2
1713523328339,CLRE 253,B00,507202,Vaida; Florin,9999,0,9999,0
1713523329368,CLRE 259,A00,507211,Patel; Hemal,9996,0,9999,3
1713523330395,CLRE 260,A00,507221,Cuomo; Raphael Eduardo,9999,0,9999,0
1713523331425,CLRE 297,001,507242,Cuomo; Raphael Eduardo,9999,0,9999,0
1713523332454,CSE 191,A00,516875,Minnes Kemp; Mor Mia,9999,0,9999,0
1713523333481,CSS 201S,A01,494383,Staff,35,0,35,0
1713523334508,CSS 202S,A01,494387,Staff,35,0,35,0
1713523335537,EAP 100,A00,516065,Staff,9792,0,9999,207
1713523336563,ECE 45,A01,507414,Staff,37,0,60,23
1713523337594,ECE 100,A01,507416,Baghdadchi; Saharnaz,0,0,20,20
1713523337594,ECE 100,A02,507418,Baghdadchi; Saharnaz,19,0,20,1
1713523338623,ECE 111,A01,507420,Staff,27,0,50,23
1713523339653,ECE 197,001,548057,Sievenpiper; Daniel F.,9998,0,9999,1
1713523340678,EDS 115,A00,507243,Choi; Bailey Miyeon,27,0,28,1
1713523341706,EDS 117,A01,494379,Staff,14,0,25,11
1713523342733,EDS 125,A00,507246,Hopkins; Megan Beth,27,0,30,3
1713523343760,EDS 128A,A01,507264,Fargason; Sharon Gayle,26,0,26,0
1713523344790,EDS 128B,A01,507293,Pappas; Elizabeth,30,0,30,0
1713523345820,EDS 139,A00,507294,Fargason; Sharon Gayle,30,0,30,0
1713523345820,EDS 139,B00,507313,Pappas; Elizabeth,30,0,30,0
1713523346847,EDS 201,A00,507315,Staff,18,0,30,12
1713523347876,EDS 203,A01,507317,Halter; Christopher P.,17,0,30,13
1713523348902,EDS 204R,A01,507319,Halter; Christopher P.,0,1,30,30
1713523348902,EDS 204R,B01,507331,Heinzman; Erica M.,22,0,30,8
1713523349931,EDS 206R,A00,507332,Staff,0,2,30,30
1713523349931,EDS 206R,B00,507343,Staff,23,0,30,7
1713523350959,EDS 250,A00,507344,Hemans; Patricia Ann Benitez,27,0,40,13
1713523351987,EDS 281,A00,507345,Daly; Alan J.,18,0,18,0
1713523353012,EDS 284,A00,507350,Daly; Alan J.,16,0,16,0
1713523354038,EDS 286,A00,507359,Fine; Sarah,18,0,18,0
1713523355065,EDS 289C,A01,507361,Daly; Alan J.,18,0,18,0
1713523356091,EDS 290,A00,507366,Hofstetter; Carolyn,15,0,15,0
1713523357118,LIGM 5A,A00,507421,Fischer-Grunski; Eva K,20,0,20,0
1713523358201,LIGM 5B,A00,507423,Fischer-Grunski; Eva K,20,0,20,0
1713523359231,LIGM 5C,A00,507425,Fischer-Grunski; Eva K,20,0,20,0
1713523360258,LIIT 5AS,A00,507427,Carnelos; Chiara,20,0,20,0
1713523361287,LIIT 5BS,A00,507430,Carnelos; Chiara,20,0,20,0
1713523362314,LIIT 5CS,A00,507432,Carnelos; Chiara,20,0,20,0
1713523363345,LISP 5A,A00,507541,Munoz Sanchez; Alicia,14,0,20,6
1713523364371,LISP 5B,A00,507671,Munoz Sanchez; Alicia,12,0,20,8
1713523365397,LISP 5C,A00,507696,Munoz Sanchez; Alicia,11,0,20,9
1713523366426,MAE 197,001,528363,Boechler; Nicholas Sebastia,9998,0,9999,1
1713523367451,MATH 197,001,523477,Kedlaya; Kiran S.,9999,0,9999,0
1713523367451,MATH 197,002,563811,Zhang; Danna,9998,0,9999,1
1713523368480,MCWP 40R,A00,518780,Staff,13,0,20,7
1713523368480,MCWP 40R,B00,518781,Staff,11,0,20,9
1713523368480,MCWP 40R,C00,518783,Staff,8,0,20,12
1713523369510,MCWP 50R,A00,518791,Staff,7,0,20,13
1713523369510,MCWP 50R,B00,518792,Staff,3,0,20,17
1713523369510,MCWP 50R,C00,518793,Staff,5,0,20,15
1713523369510,MCWP 50R,D00,518794,Staff,0,0,20,20
1713523369510,MCWP 50R,E00,518795,Staff,0,0,20,20
1713523369510,MCWP 50R,F00,518796,Staff,10,0,20,10
1713523369510,MCWP 50R,G00,518797,Staff,10,0,20,10
1713523370540,MMW 12R,A01,514034,Herbst; Matthew,1,0,16,15
1713523370540,MMW 12R,A02,514035,Herbst; Matthew,13,0,16,3
1713523371566,MMW 13R,A01,514037,Staff,0,8,16,16
1713523371566,MMW 13R,A02,514039,Staff,0,7,16,16
1713523373619,SIO 295LS,A00,523233,Staff,15,0,30,15
1713523374644,SIO 295S,A00,523232,Staff,15,0,30,15
1713523375673,SOCI 117,A01,494376,Staff,0,2,5,5
1713523376701,WES 237B,A00,494380,Staff,19,0,20,1
1713523378773,AESE 279B,A00,494370,Wade; Jon P,33,0,33,0
1713523379802,AIP 197,001,627712,Vespa; Emanuel Ignacio,9999,0,9999,0
1713523380831,ANAR 135S,A00,494369,Braswell; Geoffrey E.,0,0,0,0
1713523381856,CAT 124RS,A01,519847,Geibel; William,6,0,20,14
1713523382884,CAT 125RS,A01,515971,Geibel; William,6,0,20,14
1713523383910,CLRE 250,A00,511389,Morris; Sheldon,9996,0,9999,3
1713523384937,CLRE 251,A00,507176,Mehta; Ravindra L.,9996,0,9999,3
1713523384937,CLRE 251,B00,511410,Mehta; Ravindra L.,9998,0,9999,1
1713523385966,CLRE 252,A00,507189,Cuomo; Raphael Eduardo,9998,0,9999,1
1713523386996,CLRE 253,A00,507199,Vaida; Florin,9997,0,9999,2
1713523386996,CLRE 253,B00,507202,Vaida; Florin,9999,0,9999,0
1713523388028,CLRE 259,A00,507211,Patel; Hemal,9996,0,9999,3
1713523389056,CLRE 260,A00,507221,Cuomo; Raphael Eduardo,9999,0,9999,0
1713523390081,CLRE 297,001,507242,Cuomo; Raphael Eduardo,9999,0,9999,0
1713523391107,CSE 191,A00,516875,Minnes Kemp; Mor Mia,9999,0,9999,0
1713523392138,CSS 201S,A01,494383,Staff,35,0,35,0
1713523393169,CSS 202S,A01,494387,Staff,35,0,35,0
1713523394195,EAP 100,A00,516065,Staff,9792,0,9999,207
1713523395221,ECE 45,A01,507414,Staff,37,0,60,23
1713523396247,ECE 100,A01,507416,Baghdadchi; Saharnaz,0,0,20,20
1713523396247,ECE 100,A02,507418,Baghdadchi; Saharnaz,19,0,20,1
1713523397273,ECE 111,A01,507420,Staff,27,0,50,23
1713523398299,ECE 197,001,548057,Sievenpiper; Daniel F.,9998,0,9999,1
1713523399324,EDS 115,A00,507243,Choi; Bailey Miyeon,27,0,28,1
1713523400353,EDS 117,A01,494379,Staff,14,0,25,11
1713523401384,EDS 125,A00,507246,Hopkins; Megan Beth,27,0,30,3
1713523402413,EDS 128A,A01,507264,Fargason; Sharon Gayle,26,0,26,0
1713523403439,EDS 128B,A01,507293,Pappas; Elizabeth,30,0,30,0
1713523404469,EDS 139,A00,507294,Fargason; Sharon Gayle,30,0,30,0
1713523404469,EDS 139,B00,507313,Pappas; Elizabeth,30,0,30,0
1713523405494,EDS 201,A00,507315,Staff,18,0,30,12
1713523406520,EDS 203,A01,507317,Halter; Christopher P.,17,0,30,13
1713523407547,EDS 204R,A01,507319,Halter; Christopher P.,0,1,30,30
1713523407547,EDS 204R,B01,507331,Heinzman; Erica M.,22,0,30,8
1713523408574,EDS 206R,A00,507332,Staff,0,2,30,30
1713523408574,EDS 206R,B00,507343,Staff,23,0,30,7
1713523409601,EDS 250,A00,507344,Hemans; Patricia Ann Benitez,27,0,40,13
1713523410627,EDS 281,A00,507345,Daly; Alan J.,18,0,18,0
1713523411653,EDS 284,A00,507350,Daly; Alan J.,16,0,16,0
1713523412683,EDS 286,A00,507359,Fine; Sarah,18,0,18,0
1713523413709,EDS 289C,A01,507361,Daly; Alan J.,18,0,18,0
1713523414736,EDS 290,A00,507366,Hofstetter; Carolyn,15,0,15,0
1713523415766,LIGM 5A,A00,507421,Fischer-Grunski; Eva K,20,0,20,0
1713523416796,LIGM 5B,A00,507423,Fischer-Grunski; Eva K,20,0,20,0
1713523417827,LIGM 5C,A00,507425,Fischer-Grunski; Eva K,20,0,20,0
1713523418853,LIIT 5AS,A00,507427,Carnelos; Chiara,20,0,20,0
1713523419878,LIIT 5BS,A00,507430,Carnelos; Chiara,20,0,20,0
1713523420904,LIIT 5CS,A00,507432,Carnelos; Chiara,20,0,20,0
1713523421931,LISP 5A,A00,507541,Munoz Sanchez; Alicia,14,0,20,6
1713523422962,LISP 5B,A00,507671,Munoz Sanchez; Alicia,12,0,20,8
1713523423993,LISP 5C,A00,507696,Munoz Sanchez; Alicia,11,0,20,9
1713523425021,MAE 197,001,528363,Boechler; Nicholas Sebastia,9998,0,9999,1
1713523426046,MATH 197,001,523477,Kedlaya; Kiran S.,9999,0,9999,0
1713523426046,MATH 197,002,563811,Zhang; Danna,9998,0,9999,1
1713523427074,MCWP 40R,A00,518780,Staff,13,0,20,7
1713523427074,MCWP 40R,B00,518781,Staff,11,0,20,9
1713523427074,MCWP 40R,C00,518783,Staff,8,0,20,12
1713523428104,MCWP 50R,A00,518791,Staff,7,0,20,13
1713523428104,MCWP 50R,B00,518792,Staff,3,0,20,17
1713523428104,MCWP 50R,C00,518793,Staff,5,0,20,15
1713523428104,MCWP 50R,D00,518794,Staff,0,0,20,20
1713523428104,MCWP 50R,E00,518795,Staff,0,0,20,20
1713523428104,MCWP 50R,F00,518796,Staff,10,0,20,10
1713523428104,MCWP 50R,G00,518797,Staff,10,0,20,10
1713523429129,MMW 12R,A01,514034,Herbst; Matthew,1,0,16,15
1713523429129,MMW 12R,A02,514035,Herbst; Matthew,13,0,16,3
1713523430155,MMW 13R,A01,514037,Staff,0,8,16,16
1713523430155,MMW 13R,A02,514039,Staff,0,7,16,16
1713523432207,SIO 295LS,A00,523233,Staff,15,0,30,15
1713523433232,SIO 295S,A00,523232,Staff,15,0,30,15
1713523434262,SOCI 117,A01,494376,Staff,0,2,5,5
1713523435292,WES 237B,A00,494380,Staff,19,0,20,1
1713523437379,AESE 279B,A00,494370,Wade; Jon P,33,0,33,0
1713523438409,AIP 197,001,627712,Vespa; Emanuel Ignacio,9999,0,9999,0
1713523439436,ANAR 135S,A00,494369,Braswell; Geoffrey E.,0,0,0,0
1713523440478,CAT 124RS,A01,519847,Geibel; William,6,0,20,14
1713523441507,CAT 125RS,A01,515971,Geibel; William,6,0,20,14
1713523442533,CLRE 250,A00,511389,Morris; Sheldon,9996,0,9999,3
1713523443573,CLRE 251,A00,507176,Mehta; Ravindra L.,9996,0,9999,3
1713523443573,CLRE 251,B00,511410,Mehta; Ravindra L.,9998,0,9999,1
1713523444598,CLRE 252,A00,507189,Cuomo; Raphael Eduardo,9998,0,9999,1
1713523445625,CLRE 253,A00,507199,Vaida; Florin,9997,0,9999,2
1713523445625,CLRE 253,B00,507202,Vaida; Florin,9999,0,9999,0
1713523446651,CLRE 259,A00,507211,Patel; Hemal,9996,0,9999,3
1713523447678,CLRE 260,A00,507221,Cuomo; Raphael Eduardo,9999,0,9999,0
1713523448704,CLRE 297,001,507242,Cuomo; Raphael Eduardo,9999,0,9999,0
1713523449735,CSE 191,A00,516875,Minnes Kemp; Mor Mia,9999,0,9999,0
1713523450763,CSS 201S,A01,494383,Staff,35,0,35,0
1713523451789,CSS 202S,A01,494387,Staff,35,0,35,0
1713523452815,EAP 100,A00,516065,Staff,9792,0,9999,207
1713523453846,ECE 45,A01,507414,Staff,37,0,60,23
1713523454879,ECE 100,A01,507416,Baghdadchi; Saharnaz,0,0,20,20
1713523454879,ECE 100,A02,507418,Baghdadchi; Saharnaz,19,0,20,1
1713523455909,ECE 111,A01,507420,Staff,27,0,50,23
1713523456936,ECE 197,001,548057,Sievenpiper; Daniel F.,9998,0,9999,1
1713523457967,EDS 115,A00,507243,Choi; Bailey Miyeon,27,0,28,1
1713523458999,EDS 117,A01,494379,Staff,14,0,25,11
1713523460026,EDS 125,A00,507246,Hopkins; Megan Beth,27,0,30,3
1713523461053,EDS 128A,A01,507264,Fargason; Sharon Gayle,26,0,26,0
1713523462139,EDS 128B,A01,507293,Pappas; Elizabeth,30,0,30,0
1713523463166,EDS 139,A00,507294,Fargason; Sharon Gayle,30,0,30,0
1713523463166,EDS 139,B00,507313,Pappas; Elizabeth,30,0,30,0
1713523464195,EDS 201,A00,507315,Staff,18,0,30,12
1713523465222,EDS 203,A01,507317,Halter; Christopher P.,17,0,30,13
1713523466248,EDS 204R,A01,507319,Halter; Christopher P.,0,1,30,30
1713523466248,EDS 204R,B01,507331,Heinzman; Erica M.,22,0,30,8
1713523467275,EDS 206R,A00,507332,Staff,0,2,30,30
1713523467275,EDS 206R,B00,507343,Staff,23,0,30,7
1713523468299,EDS 250,A00,507344,Hemans; Patricia Ann Benitez,27,0,40,13
1713523469323,EDS 281,A00,507345,Daly; Alan J.,18,0,18,0
1713523470350,EDS 284,A00,507350,Daly; Alan J.,16,0,16,0
1713523471377,EDS 286,A00,507359,Fine; Sarah,18,0,18,0
1713523472402,EDS 289C,A01,507361,Daly; Alan J.,18,0,18,0
1713523473429,EDS 290,A00,507366,Hofstetter; Carolyn,15,0,15,0
1713523474454,LIGM 5A,A00,507421,Fischer-Grunski; Eva K,20,0,20,0
1713523475480,LIGM 5B,A00,507423,Fischer-Grunski; Eva K,20,0,20,0
1713523476506,LIGM 5C,A00,507425,Fischer-Grunski; Eva K,20,0,20,0
1713523477533,LIIT 5AS,A00,507427,Carnelos; Chiara,20,0,20,0
1713523478559,LIIT 5BS,A00,507430,Carnelos; Chiara,20,0,20,0
1713523479585,LIIT 5CS,A00,507432,Carnelos; Chiara,20,0,20,0
1713523480611,LISP 5A,A00,507541,Munoz Sanchez; Alicia,14,0,20,6
1713523481640,LISP 5B,A00,507671,Munoz Sanchez; Alicia,12,0,20,8
1713523482665,LISP 5C,A00,507696,Munoz Sanchez; Alicia,11,0,20,9
1713523483692,MAE 197,001,528363,Boechler; Nicholas Sebastia,9998,0,9999,1
1713523484721,MATH 197,001,523477,Kedlaya; Kiran S.,9999,0,9999,0
1713523484721,MATH 197,002,563811,Zhang; Danna,9998,0,9999,1
1713523485754,MCWP 40R,A00,518780,Staff,13,0,20,7
1713523485754,MCWP 40R,B00,518781,Staff,11,0,20,9
1713523485754,MCWP 40R,C00,518783,Staff,8,0,20,12
1713523486780,MCWP 50R,A00,518791,Staff,7,0,20,13
1713523486780,MCWP 50R,B00,518792,Staff,3,0,20,17
1713523486780,MCWP 50R,C00,518793,Staff,5,0,20,15
1713523486780,MCWP 50R,D00,518794,Staff,0,0,20,20
1713523486780,MCWP 50R,E00,518795,Staff,0,0,20,20
1713523486780,MCWP 50R,F00,518796,Staff,10,0,20,10
1713523486780,MCWP 50R,G00,518797,Staff,10,0,20,10
1713523487810,MMW 12R,A01,514034,Herbst; Matthew,1,0,16,15
1713523487810,MMW 12R,A02,514035,Herbst; Matthew,13,0,16,3
1713523488840,MMW 13R,A01,514037,Staff,0,8,16,16
1713523488840,MMW 13R,A02,514039,Staff,0,7,16,16
1713523490894,SIO 295LS,A00,523233,Staff,15,0,30,15
1713523491917,SIO 295S,A00,523232,Staff,15,0,30,15
1713523492948,SOCI 117,A01,494376,Staff,0,2,5,5
1713523493981,WES 237B,A00,494380,Staff,19,0,20,1
1713523496057,AESE 279B,A00,494370,Wade; Jon P,33,0,33,0
1713523497083,AIP 197,001,627712,Vespa; Emanuel Ignacio,9999,0,9999,0
1713523498117,ANAR 135S,A00,494369,Braswell; Geoffrey E.,0,0,0,0
1713523499144,CAT 124RS,A01,519847,Geibel; William,6,0,20,14
1713523500200,CAT 125RS,A01,515971,Geibel; William,6,0,20,14
1713523501227,CLRE 250,A00,511389,Morris; Sheldon,9996,0,9999,3
1713523502256,CLRE 251,A00,507176,Mehta; Ravindra L.,9996,0,9999,3
1713523502256,CLRE 251,B00,511410,Mehta; Ravindra L.,9998,0,9999,1
1713523503281,CLRE 252,A00,507189,Cuomo; Raphael Eduardo,9998,0,9999,1
1713523504308,CLRE 253,A00,507199,Vaida; Florin,9997,0,9999,2
1713523504308,CLRE 253,B00,507202,Vaida; Florin,9999,0,9999,0
1713523505334,CLRE 259,A00,507211,Patel; Hemal,9996,0,9999,3
1713523506364,CLRE 260,A00,507221,Cuomo; Raphael Eduardo,9999,0,9999,0
1713523507388,CLRE 297,001,507242,Cuomo; Raphael Eduardo,9999,0,9999,0
1713523508414,CSE 191,A00,516875,Minnes Kemp; Mor Mia,9999,0,9999,0
1713523509445,CSS 201S,A01,494383,Staff,35,0,35,0
1713523510470,CSS 202S,A01,494387,Staff,35,0,35,0
1713523511495,EAP 100,A00,516065,Staff,9792,0,9999,207
1713523512521,ECE 45,A01,507414,Staff,37,0,60,23
1713523513546,ECE 100,A01,507416,Baghdadchi; Saharnaz,0,0,20,20
1713523513546,ECE 100,A02,507418,Baghdadchi; Saharnaz,19,0,20,1
1713523514570,ECE 111,A01,507420,Staff,27,0,50,23
1713523515612,ECE 197,001,548057,Sievenpiper; Daniel F.,9998,0,9999,1
1713523516637,EDS 115,A00,507243,Choi; Bailey Miyeon,27,0,28,1
1713523517666,EDS 117,A01,494379,Staff,14,0,25,11
1713523518691,EDS 125,A00,507246,Hopkins; Megan Beth,27,0,30,3
1713523519717,EDS 128A,A01,507264,Fargason; Sharon Gayle,26,0,26,0
1713523520747,EDS 128B,A01,507293,Pappas; Elizabeth,30,0,30,0
1713523521772,EDS 139,A00,507294,Fargason; Sharon Gayle,30,0,30,0
1713523521772,EDS 139,B00,507313,Pappas; Elizabeth,30,0,30,0
1713523522801,EDS 201,A00,507315,Staff,18,0,30,12
1713523523825,EDS 203,A01,507317,Halter; Christopher P.,17,0,30,13
1713523524852,EDS 204R,A01,507319,Halter; Christopher P.,0,1,30,30
1713523524852,EDS 204R,B01,507331,Heinzman; Erica M.,22,0,30,8
1713523525877,EDS 206R,A00,507332,Staff,0,2,30,30
1713523525877,EDS 206R,B00,507343,Staff,23,0,30,7
1713523526904,EDS 250,A00,507344,Hemans; Patricia Ann Benitez,27,0,40,13
1713523527933,EDS 281,A00,507345,Daly; Alan J.,18,0,18,0
1713523528959,EDS 284,A00,507350,Daly; Alan J.,16,0,16,0
1713523529987,EDS 286,A00,507359,Fine; Sarah,18,0,18,0
1713523531019,EDS 289C,A01,507361,Daly; Alan J.,18,0,18,0
1713523532046,EDS 290,A00,507366,Hofstetter; Carolyn,15,0,15,0
1713523533080,LIGM 5A,A00,507421,Fischer-Grunski; Eva K,20,0,20,0
1713523534105,LIGM 5B,A00,507423,Fischer-Grunski; Eva K,20,0,20,0
1713523535136,LIGM 5C,A00,507425,Fischer-Grunski; Eva K,20,0,20,0
1713523536163,LIIT 5AS,A00,507427,Carnelos; Chiara,20,0,20,0
1713523537189,LIIT 5BS,A00,507430,Carnelos; Chiara,20,0,20,0
1713523538220,LIIT 5CS,A00,507432,Carnelos; Chiara,20,0,20,0
1713523539247,LISP 5A,A00,507541,Munoz Sanchez; Alicia,14,0,20,6
1713523540278,LISP 5B,A00,507671,Munoz Sanchez; Alicia,12,0,20,8
1713523541302,LISP 5C,A00,507696,Munoz Sanchez; Alicia,11,0,20,9
1713523542331,MAE 197,001,528363,Boechler; Nicholas Sebastia,9998,0,9999,1
1713523543356,MATH 197,001,523477,Kedlaya; Kiran S.,9999,0,9999,0
1713523543356,MATH 197,002,563811,Zhang; Danna,9998,0,9999,1
1713523544383,MCWP 40R,A00,518780,Staff,13,0,20,7
1713523544383,MCWP 40R,B00,518781,Staff,11,0,20,9
1713523544383,MCWP 40R,C00,518783,Staff,8,0,20,12
1713523545411,MCWP 50R,A00,518791,Staff,7,0,20,13
1713523545411,MCWP 50R,B00,518792,Staff,3,0,20,17
1713523545411,MCWP 50R,C00,518793,Staff,5,0,20,15
1713523545411,MCWP 50R,D00,518794,Staff,0,0,20,20
1713523545411,MCWP 50R,E00,518795,Staff,0,0,20,20
1713523545411,MCWP 50R,F00,518796,Staff,10,0,20,10
1713523545411,MCWP 50R,G00,518797,Staff,10,0,20,10
1713523546438,MMW 12R,A01,514034,Herbst; Matthew,1,0,16,15
1713523546438,MMW 12R,A02,514035,Herbst; Matthew,13,0,16,3
1713523547464,MMW 13R,A01,514037,Staff,0,8,16,16
1713523547464,MMW 13R,A02,514039,Staff,0,7,16,16
1713523549522,SIO 295LS,A00,523233,Staff,15,0,30,15
1713523550552,SIO 295S,A00,523232,Staff,15,0,30,15
1713523551582,SOCI 117,A01,494376,Staff,0,2,5,5
1713523552613,WES 237B,A00,494380,Staff,19,0,20,1
1713523554686,AESE 279B,A00,494370,Wade; Jon P,33,0,33,0
1713523555712,AIP 197,001,627712,Vespa; Emanuel Ignacio,9999,0,9999,0
1713523556739,ANAR 135S,A00,494369,Braswell; Geoffrey E.,0,0,0,0
1713523557765,CAT 124RS,A01,519847,Geibel; William,6,0,20,14
1713523558795,CAT 125RS,A01,515971,Geibel; William,6,0,20,14
1713523559821,CLRE 250,A00,511389,Morris; Sheldon,9996,0,9999,3
1713523560855,CLRE 251,A00,507176,Mehta; Ravindra L.,9996,0,9999,3
1713523560855,CLRE 251,B00,511410,Mehta; Ravindra L.,9998,0,9999,1
1713523561882,CLRE 252,A00,507189,Cuomo; Raphael Eduardo,9998,0,9999,1
1713523562913,CLRE 253,A00,507199,Vaida; Florin,9997,0,9999,2
1713523562913,CLRE 253,B00,507202,Vaida; Florin,9999,0,9999,0
1713523563942,CLRE 259,A00,507211,Patel; Hemal,9996,0,9999,3
1713523564968,CLRE 260,A00,507221,Cuomo; Raphael Eduardo,9999,0,9999,0
1713523566048,CLRE 297,001,507242,Cuomo; Raphael Eduardo,9999,0,9999,0
1713523567078,CSE 191,A00,516875,Minnes Kemp; Mor Mia,9999,0,9999,0
1713523568106,CSS 201S,A01,494383,Staff,35,0,35,0
1713523569133,CSS 202S,A01,494387,Staff,35,0,35,0
1713523570158,EAP 100,A00,516065,Staff,9792,0,9999,207
1713523571190,ECE 45,A01,507414,Staff,37,0,60,23
1713523572217,ECE 100,A01,507416,Baghdadchi; Saharnaz,0,0,20,20
1713523572217,ECE 100,A02,507418,Baghdadchi; Saharnaz,19,0,20,1
1713523573243,ECE 111,A01,507420,Staff,27,0,50,23
1713523574269,ECE 197,001,548057,Sievenpiper; Daniel F.,9998,0,9999,1
1713523575296,EDS 115,A00,507243,Choi; Bailey Miyeon,27,0,28,1
1713523576323,EDS 117,A01,494379,Staff,14,0,25,11
1713523577354,EDS 125,A00,507246,Hopkins; Megan Beth,27,0,30,3
1713523578381,EDS 128A,A01,507264,Fargason; Sharon Gayle,26,0,26,0
1713523579409,EDS 128B,A01,507293,Pappas; Elizabeth,30,0,30,0
1713523580436,EDS 139,A00,507294,Fargason; Sharon Gayle,30,0,30,0
1713523580436,EDS 139,B00,507313,Pappas; Elizabeth,30,0,30,0
1713523581463,EDS 201,A00,507315,Staff,18,0,30,12
1713523582494,EDS 203,A01,507317,Halter; Christopher P.,17,0,30,13
1713523583520,EDS 204R,A01,507319,Halter; Christopher P.,0,1,30,30
1713523583520,EDS 204R,B01,507331,Heinzman; Erica M.,22,0,30,8
1713523584546,EDS 206R,A00,507332,Staff,0,2,30,30
1713523584546,EDS 206R,B00,507343,Staff,23,0,30,7
1713523585573,EDS 250,A00,507344,Hemans; Patricia Ann Benitez,27,0,40,13
1713523586600,EDS 281,A00,507345,Daly; Alan J.,18,0,18,0
1713523587626,EDS 284,A00,507350,Daly; Alan J.,16,0,16,0
1713523588652,EDS 286,A00,507359,Fine; Sarah,18,0,18,0
1713523589682,EDS 289C,A01,507361,Daly; Alan J.,18,0,18,0
1713523590708,EDS 290,A00,507366,Hofstetter; Carolyn,15,0,15,0
1713523591734,LIGM 5A,A00,507421,Fischer-Grunski; Eva K,20,0,20,0
1713523592762,LIGM 5B,A00,507423,Fischer-Grunski; Eva K,20,0,20,0
1713523593789,LIGM 5C,A00,507425,Fischer-Grunski; Eva K,20,0,20,0
1713523594815,LIIT 5AS,A00,507427,Carnelos; Chiara,20,0,20,0
1713523595840,LIIT 5BS,A00,507430,Carnelos; Chiara,20,0,20,0
1713523596869,LIIT 5CS,A00,507432,Carnelos; Chiara,20,0,20,0
1713523597895,LISP 5A,A00,507541,Munoz Sanchez; Alicia,14,0,20,6
1713523598926,LISP 5B,A00,507671,Munoz Sanchez; Alicia,12,0,20,8
1713523599959,LISP 5C,A00,507696,Munoz Sanchez; Alicia,11,0,20,9
1713523600985,MAE 197,001,528363,Boechler; Nicholas Sebastia,9998,0,9999,1
1713523602012,MATH 197,001,523477,Kedlaya; Kiran S.,9999,0,9999,0
1713523602012,MATH 197,002,563811,Zhang; Danna,9998,0,9999,1
1713523603043,MCWP 40R,A00,518780,Staff,13,0,20,7
1713523603043,MCWP 40R,B00,518781,Staff,11,0,20,9
1713523603043,MCWP 40R,C00,518783,Staff,8,0,20,12
1713523604070,MCWP 50R,A00,518791,Staff,7,0,20,13
1713523604070,MCWP 50R,B00,518792,Staff,3,0,20,17
1713523604070,MCWP 50R,C00,518793,Staff,5,0,20,15
1713523604070,MCWP 50R,D00,518794,Staff,0,0,20,20
1713523604070,MCWP 50R,E00,518795,Staff,0,0,20,20
1713523604070,MCWP 50R,F00,518796,Staff,10,0,20,10
1713523604070,MCWP 50R,G00,518797,Staff,10,0,20,10
1713523605096,MMW 12R,A01,514034,Herbst; Matthew,1,0,16,15
1713523605096,MMW 12R,A02,514035,Herbst; Matthew,13,0,16,3
1713523606122,MMW 13R,A01,514037,Staff,0,8,16,16
1713523606122,MMW 13R,A02,514039,Staff,0,7,16,16
1713523608178,SIO 295LS,A00,523233,Staff,15,0,30,15
1713523609204,SIO 295S,A00,523232,Staff,15,0,30,15
1713523610236,SOCI 117,A01,494376,Staff,0,2,5,5
1713523611267,WES 237B,A00,494380,Staff,19,0,20,1
1713523613349,AESE 279B,A00,494370,Wade; Jon P,33,0,33,0
1713523614377,AIP 197,001,627712,Vespa; Emanuel Ignacio,9999,0,9999,0
1713523615404,ANAR 135S,A00,494369,Braswell; Geoffrey E.,0,0,0,0
1713523616430,CAT 124RS,A01,519847,Geibel; William,6,0,20,14
1713523617456,CAT 125RS,A01,515971,Geibel; William,6,0,20,14
1713523618482,CLRE 250,A00,511389,Morris; Sheldon,9996,0,9999,3
1713523619510,CLRE 251,A00,507176,Mehta; Ravindra L.,9996,0,9999,3
1713523619510,CLRE 251,B00,511410,Mehta; Ravindra L.,9998,0,9999,1
1713523620537,CLRE 252,A00,507189,Cuomo; Raphael Eduardo,9998,0,9999,1
1713523621562,CLRE 253,A00,507199,Vaida; Florin,9997,0,9999,2
1713523621562,CLRE 253,B00,507202,Vaida; Florin,9999,0,9999,0
1713523622590,CLRE 259,A00,507211,Patel; Hemal,9996,0,9999,3
1713523623619,CLRE 260,A00,507221,Cuomo; Raphael Eduardo,9999,0,9999,0
1713523624644,CLRE 297,001,507242,Cuomo; Raphael Eduardo,9999,0,9999,0
1713523625674,CSE 191,A00,516875,Minnes Kemp; Mor Mia,9999,0,9999,0
1713523626702,CSS 201S,A01,494383,Staff,35,0,35,0
1713523627727,CSS 202S,A01,494387,Staff,35,0,35,0
1713523628751,EAP 100,A00,516065,Staff,9792,0,9999,207
1713523629783,ECE 45,A01,507414,Staff,37,0,60,23
1713523630812,ECE 100,A01,507416,Baghdadchi; Saharnaz,0,0,20,20
1713523630812,ECE 100,A02,507418,Baghdadchi; Saharnaz,19,0,20,1
1713523631836,ECE 111,A01,507420,Staff,27,0,50,23
1713523632861,ECE 197,001,548057,Sievenpiper; Daniel F.,9998,0,9999,1
1713523633887,EDS 115,A00,507243,Choi; Bailey Miyeon,27,0,28,1
1713523634914,EDS 117,A01,494379,Staff,14,0,25,11
1713523635948,EDS 125,A00,507246,Hopkins; Megan Beth,27,0,30,3
1713523636974,EDS 128A,A01,507264,Fargason; Sharon Gayle,26,0,26,0
1713523638004,EDS 128B,A01,507293,Pappas; Elizabeth,30,0,30,0
1713523639031,EDS 139,A00,507294,Fargason; Sharon Gayle,30,0,30,0
1713523639031,EDS 139,B00,507313,Pappas; Elizabeth,30,0,30,0
1713523640056,EDS 201,A00,507315,Staff,18,0,30,12
1713523641082,EDS 203,A01,507317,Halter; Christopher P.,17,0,30,13
1713523642113,EDS 204R,A01,507319,Halter; Christopher P.,0,1,30,30
1713523642113,EDS 204R,B01,507331,Heinzman; Erica M.,22,0,30,8
1713523643137,EDS 206R,A00,507332,Staff,0,2,30,30
1713523643137,EDS 206R,B00,507343,Staff,23,0,30,7
1713523644162,EDS 250,A00,507344,Hemans; Patricia Ann Benitez,27,0,40,13
1713523645191,EDS 281,A00,507345,Daly; Alan J.,18,0,18,0
1713523646219,EDS 284,A00,507350,Daly; Alan J.,16,0,16,0
1713523647245,EDS 286,A00,507359,Fine; Sarah,18,0,18,0
1713523648271,EDS 289C,A01,507361,Daly; Alan J.,18,0,18,0
1713523649300,EDS 290,A00,507366,Hofstetter; Carolyn,15,0,15,0
1713523650334,LIGM 5A,A00,507421,Fischer-Grunski; Eva K,20,0,20,0
1713523651364,LIGM 5B,A00,507423,Fischer-Grunski; Eva K,20,0,20,0
1713523652390,LIGM 5C,A00,507425,Fischer-Grunski; Eva K,20,0,20,0
1713523653421,LIIT 5AS,A00,507427,Carnelos; Chiara,20,0,20,0
1713523654447,LIIT 5BS,A00,507430,Carnelos; Chiara,20,0,20,0
1713523655473,LIIT 5CS,A00,507432,Carnelos; Chiara,20,0,20,0
1713523656499,LISP 5A,A00,507541,Munoz Sanchez; Alicia,14,0,20,6
1713523657524,LISP 5B,A00,507671,Munoz Sanchez; Alicia,12,0,20,8
1713523658555,LISP 5C,A00,507696,Munoz Sanchez; Alicia,11,0,20,9
1713523659581,MAE 197,001,528363,Boechler; Nicholas Sebastia,9998,0,9999,1
1713523660609,MATH 197,001,523477,Kedlaya; Kiran S.,9999,0,9999,0
1713523660609,MATH 197,002,563811,Zhang; Danna,9998,0,9999,1
1713523661643,MCWP 40R,A00,518780,Staff,13,0,20,7
1713523661643,MCWP 40R,B00,518781,Staff,11,0,20,9
1713523661643,MCWP 40R,C00,518783,Staff,8,0,20,12
1713523662670,MCWP 50R,A00,518791,Staff,7,0,20,13
1713523662670,MCWP 50R,B00,518792,Staff,3,0,20,17
1713523662670,MCWP 50R,C00,518793,Staff,5,0,20,15
1713523662670,MCWP 50R,D00,518794,Staff,0,0,20,20
1713523662670,MCWP 50R,E00,518795,Staff,0,0,20,20
1713523662670,MCWP 50R,F00,518796,Staff,10,0,20,10
1713523662670,MCWP 50R,G00,518797,Staff,10,0,20,10
1713523663699,MMW 12R,A01,514034,Herbst; Matthew,1,0,16,15
1713523663699,MMW 12R,A02,514035,Herbst; Matthew,13,0,16,3
1713523664726,MMW 13R,A01,514037,Staff,0,8,16,16
1713523664726,MMW 13R,A02,514039,Staff,0,7,16,16
1713523666782,SIO 295LS,A00,523233,Staff,15,0,30,15
1713523667809,SIO 295S,A00,523232,Staff,15,0,30,15
1713523668837,SOCI 117,A01,494376,Staff,0,2,5,5
1713523669916,WES 237B,A00,494380,Staff,19,0,20,1
1713523671995,AESE 279B,A00,494370,Wade; Jon P,33,0,33,0
1713523673021,AIP 197,001,627712,Vespa; Emanuel Ignacio,9999,0,9999,0
1713523674049,ANAR 135S,A00,494369,Braswell; Geoffrey E.,0,0,0,0
1713523675080,CAT 124RS,A01,519847,Geibel; William,6,0,20,14
1713523676106,CAT 125RS,A01,515971,Geibel; William,6,0,20,14
1713523677131,CLRE 250,A00,511389,Morris; Sheldon,9996,0,9999,3
1713523678158,CLRE 251,A00,507176,Mehta; Ravindra L.,9996,0,9999,3
1713523678158,CLRE 251,B00,511410,Mehta; Ravindra L.,9998,0,9999,1
1713523679187,CLRE 252,A00,507189,Cuomo; Raphael Eduardo,9998,0,9999,1
1713523680213,CLRE 253,A00,507199,Vaida; Florin,9997,0,9999,2
1713523680213,CLRE 253,B00,507202,Vaida; Florin,9999,0,9999,0
1713523681238,CLRE 259,A00,507211,Patel; Hemal,9996,0,9999,3
1713523682267,CLRE 260,A00,507221,Cuomo; Raphael Eduardo,9999,0,9999,0
1713523683294,CLRE 297,001,507242,Cuomo; Raphael Eduardo,9999,0,9999,0
1713523684323,CSE 191,A00,516875,Minnes Kemp; Mor Mia,9999,0,9999,0
1713523685366,CSS 201S,A01,494383,Staff,35,0,35,0
1713523686398,CSS 202S,A01,494387,Staff,35,0,35,0
1713523687424,EAP 100,A00,516065,Staff,9792,0,9999,207
1713523688451,ECE 45,A01,507414,Staff,37,0,60,23
1713523689483,ECE 100,A01,507416,Baghdadchi; Saharnaz,0,0,20,20
1713523689483,ECE 100,A02,507418,Baghdadchi; Saharnaz,19,0,20,1
1713523690510,ECE 111,A01,507420,Staff,27,0,50,23
1713523691541,ECE 197,001,548057,Sievenpiper; Daniel F.,9998,0,9999,1
1713523692572,EDS 115,A00,507243,Choi; Bailey Miyeon,27,0,28,1
1713523693596,EDS 117,A01,494379,Staff,14,0,25,11
1713523694628,EDS 125,A00,507246,Hopkins; Megan Beth,27,0,30,3
1713523695657,EDS 128A,A01,507264,Fargason; Sharon Gayle,26,0,26,0
1713523696681,EDS 128B,A01,507293,Pappas; Elizabeth,30,0,30,0
1713523697710,EDS 139,A00,507294,Fargason; Sharon Gayle,30,0,30,0
1713523697710,EDS 139,B00,507313,Pappas; Elizabeth,30,0,30,0
1713523698736,EDS 201,A00,507315,Staff,18,0,30,12
1713523699762,EDS 203,A01,507317,Halter; Christopher P.,17,0,30,13
1713523700788,EDS 204R,A01,507319,Halter; Christopher P.,0,1,30,30
1713523700788,EDS 204R,B01,507331,Heinzman; Erica M.,22,0,30,8
1713523701814,EDS 206R,A00,507332,Staff,0,2,30,30
1713523701814,EDS 206R,B00,507343,Staff,23,0,30,7
1713523702839,EDS 250,A00,507344,Hemans; Patricia Ann Benitez,27,0,40,13
1713523703869,EDS 281,A00,507345,Daly; Alan J.,18,0,18,0
1713523704895,EDS 284,A00,507350,Daly; Alan J.,16,0,16,0
1713523705921,EDS 286,A00,507359,Fine; Sarah,18,0,18,0
1713523706949,EDS 289C,A01,507361,Daly; Alan J.,18,0,18,0
1713523707975,EDS 290,A00,507366,Hofstetter; Carolyn,15,0,15,0
1713523709003,LIGM 5A,A00,507421,Fischer-Grunski; Eva K,20,0,20,0
1713523710029,LIGM 5B,A00,507423,Fischer-Grunski; Eva K,20,0,20,0
1713523711060,LIGM 5C,A00,507425,Fischer-Grunski; Eva K,20,0,20,0
1713523712089,LIIT 5AS,A00,507427,Carnelos; Chiara,20,0,20,0
1713523713116,LIIT 5BS,A00,507430,Carnelos; Chiara,20,0,20,0
1713523714144,LIIT 5CS,A00,507432,Carnelos; Chiara,20,0,20,0
1713523715171,LISP 5A,A00,507541,Munoz Sanchez; Alicia,14,0,20,6
1713523716197,LISP 5B,A00,507671,Munoz Sanchez; Alicia,12,0,20,8
1713523717226,LISP 5C,A00,507696,Munoz Sanchez; Alicia,11,0,20,9
1713523718253,MAE 197,001,528363,Boechler; Nicholas Sebastia,9998,0,9999,1
1713523719279,MATH 197,001,523477,Kedlaya; Kiran S.,9999,0,9999,0
1713523719279,MATH 197,002,563811,Zhang; Danna,9998,0,9999,1
1713523720309,MCWP 40R,A00,518780,Staff,13,0,20,7
1713523720309,MCWP 40R,B00,518781,Staff,11,0,20,9
1713523720309,MCWP 40R,C00,518783,Staff,8,0,20,12
1713523721335,MCWP 50R,A00,518791,Staff,7,0,20,13
1713523721335,MCWP 50R,B00,518792,Staff,3,0,20,17
1713523721335,MCWP 50R,C00,518793,Staff,5,0,20,15
1713523721335,MCWP 50R,D00,518794,Staff,0,0,20,20
1713523721335,MCWP 50R,E00,518795,Staff,0,0,20,20
1713523721335,MCWP 50R,F00,518796,Staff,10,0,20,10
1713523721335,MCWP 50R,G00,518797,Staff,10,0,20,10
1713523722371,MMW 12R,A01,514034,Herbst; Matthew,1,0,16,15
1713523722371,MMW 12R,A02,514035,Herbst; Matthew,13,0,16,3
1713523723403,MMW 13R,A01,514037,Staff,0,8,16,16
1713523723403,MMW 13R,A02,514039,Staff,0,7,16,16
1713523725459,SIO 295LS,A00,523233,Staff,15,0,30,15
1713523726484,SIO 295S,A00,523232,Staff,15,0,30,15
1713523727514,SOCI 117,A01,494376,Staff,0,2,5,5
1713523728542,WES 237B,A00,494380,Staff,19,0,20,1
1713523730600,AESE 279B,A00,494370,Wade; Jon P,33,0,33,0
1713523731628,AIP 197,001,627712,Vespa; Emanuel Ignacio,9999,0,9999,0
1713523732653,ANAR 135S,A00,494369,Braswell; Geoffrey E.,0,0,0,0
1713523733679,CAT 124RS,A01,519847,Geibel; William,6,0,20,14
1713523734711,CAT 125RS,A01,515971,Geibel; William,6,0,20,14
1713523735742,CLRE 250,A00,511389,Morris; Sheldon,9996,0,9999,3
1713523736769,CLRE 251,A00,507176,Mehta; Ravindra L.,9996,0,9999,3
1713523736769,CLRE 251,B00,511410,Mehta; Ravindra L.,9998,0,9999,1
1713523737797,CLRE 252,A00,507189,Cuomo; Raphael Eduardo,9998,0,9999,1
1713523738825,CLRE 253,A00,507199,Vaida; Florin,9997,0,9999,2
1713523738825,CLRE 253,B00,507202,Vaida; Florin,9999,0,9999,0
1713523739850,CLRE 259,A00,507211,Patel; Hemal,9996,0,9999,3
1713523740875,CLRE 260,A00,507221,Cuomo; Raphael Eduardo,9999,0,9999,0
1713523741904,CLRE 297,001,507242,Cuomo; Raphael Eduardo,9999,0,9999,0
1713523742934,CSE 191,A00,516875,Minnes Kemp; Mor Mia,9999,0,9999,0
1713523743971,CSS 201S,A01,494383,Staff,35,0,35,0
1713523745003,CSS 202S,A01,494387,Staff,35,0,35,0
1713523746031,EAP 100,A00,516065,Staff,9792,0,9999,207
1713523747061,ECE 45,A01,507414,Staff,37,0,60,23
1713523748086,ECE 100,A01,507416,Baghdadchi; Saharnaz,0,0,20,20
1713523748086,ECE 100,A02,507418,Baghdadchi; Saharnaz,19,0,20,1
1713523749118,ECE 111,A01,507420,Staff,27,0,50,23
1713523750144,ECE 197,001,548057,Sievenpiper; Daniel F.,9998,0,9999,1
1713523751169,EDS 115,A00,507243,Choi; Bailey Miyeon,27,0,28,1
1713523752196,EDS 117,A01,494379,Staff,14,0,25,11
1713523753227,EDS 125,A00,507246,Hopkins; Megan Beth,27,0,30,3
1713523754254,EDS 128A,A01,507264,Fargason; Sharon Gayle,26,0,26,0
1713523755280,EDS 128B,A01,507293,Pappas; Elizabeth,30,0,30,0
1713523756303,EDS 139,A00,507294,Fargason; Sharon Gayle,30,0,30,0
1713523756303,EDS 139,B00,507313,Pappas; Elizabeth,30,0,30,0
1713523757331,EDS 201,A00,507315,Staff,18,0,30,12
1713523758356,EDS 203,A01,507317,Halter; Christopher P.,17,0,30,13
1713523759386,EDS 204R,A01,507319,Halter; Christopher P.,0,1,30,30
1713523759386,EDS 204R,B01,507331,Heinzman; Erica M.,22,0,30,8
1713523760416,EDS 206R,A00,507332,Staff,0,2,30,30
1713523760416,EDS 206R,B00,507343,Staff,23,0,30,7
1713523761442,EDS 250,A00,507344,Hemans; Patricia Ann Benitez,27,0,40,13
1713523762476,EDS 281,A00,507345,Daly; Alan J.,18,0,18,0
1713523763504,EDS 284,A00,507350,Daly; Alan J.,16,0,16,0
1713523764532,EDS 286,A00,507359,Fine; Sarah,18,0,18,0
1713523765566,EDS 289C,A01,507361,Daly; Alan J.,18,0,18,0
1713523766590,EDS 290,A00,507366,Hofstetter; Carolyn,15,0,15,0
1713523767617,LIGM 5A,A00,507421,Fischer-Grunski; Eva K,20,0,20,0
1713523768642,LIGM 5B,A00,507423,Fischer-Grunski; Eva K,20,0,20,0
1713523769667,LIGM 5C,A00,507425,Fischer-Grunski; Eva K,20,0,20,0
1713523770693,LIIT 5AS,A00,507427,Carnelos; Chiara,20,0,20,0
1713523771718,LIIT 5BS,A00,507430,Carnelos; Chiara,20,0,20,0
1713523772743,LIIT 5CS,A00,507432,Carnelos; Chiara,20,0,20,0
1713523773822,LISP 5A,A00,507541,Munoz Sanchez; Alicia,14,0,20,6
1713523774849,LISP 5B,A00,507671,Munoz Sanchez; Alicia,12,0,20,8
1713523775875,LISP 5C,A00,507696,Munoz Sanchez; Alicia,11,0,20,9
1713523776901,MAE 197,001,528363,Boechler; Nicholas Sebastia,9998,0,9999,1
1713523777927,MATH 197,001,523477,Kedlaya; Kiran S.,9999,0,9999,0
1713523777927,MATH 197,002,563811,Zhang; Danna,9998,0,9999,1
1713523778958,MCWP 40R,A00,518780,Staff,13,0,20,7
1713523778958,MCWP 40R,B00,518781,Staff,11,0,20,9
1713523778958,MCWP 40R,C00,518783,Staff,8,0,20,12
1713523779985,MCWP 50R,A00,518791,Staff,7,0,20,13
1713523779985,MCWP 50R,B00,518792,Staff,3,0,20,17
1713523779985,MCWP 50R,C00,518793,Staff,5,0,20,15
1713523779985,MCWP 50R,D00,518794,Staff,0,0,20,20
1713523779985,MCWP 50R,E00,518795,Staff,0,0,20,20
1713523779985,MCWP 50R,F00,518796,Staff,10,0,20,10
1713523779985,MCWP 50R,G00,518797,Staff,10,0,20,10
1713523781013,MMW 12R,A01,514034,Herbst; Matthew,1,0,16,15
1713523781013,MMW 12R,A02,514035,Herbst; Matthew,13,0,16,3
1713523782040,MMW 13R,A01,514037,Staff,0,8,16,16
1713523782040,MMW 13R,A02,514039,Staff,0,7,16,16
1713523784093,SIO 295LS,A00,523233,Staff,15,0,30,15
1713523785122,SIO 295S,A00,523232,Staff,15,0,30,15
1713523786148,SOCI 117,A01,494376,Staff,0,2,5,5
1713523787174,WES 237B,A00,494380,Staff,19,0,20,1
1713523789253,AESE 279B,A00,494370,Wade; Jon P,33,0,33,0
1713523790283,AIP 197,001,627712,Vespa; Emanuel Ignacio,9999,0,9999,0
1713523791309,ANAR 135S,A00,494369,Braswell; Geoffrey E.,0,0,0,0
1713523792334,CAT 124RS,A01,519847,Geibel; William,6,0,20,14
1713523793360,CAT 125RS,A01,515971,Geibel; William,6,0,20,14
1713523794388,CLRE 250,A00,511389,Morris; Sheldon,9996,0,9999,3
1713523795416,CLRE 251,A00,507176,Mehta; Ravindra L.,9996,0,9999,3
1713523795416,CLRE 251,B00,511410,Mehta; Ravindra L.,9998,0,9999,1
1713523796454,CLRE 252,A00,507189,Cuomo; Raphael Eduardo,9998,0,9999,1
1713523797485,CLRE 253,A00,507199,Vaida; Florin,9997,0,9999,2
1713523797485,CLRE 253,B00,507202,Vaida; Florin,9999,0,9999,0
1713523798515,CLRE 259,A00,507211,Patel; Hemal,9996,0,9999,3
1713523799540,CLRE 260,A00,507221,Cuomo; Raphael Eduardo,9999,0,9999,0
1713523800565,CLRE 297,001,507242,Cuomo; Raphael Eduardo,9999,0,9999,0
1713523801595,CSE 191,A00,516875,Minnes Kemp; Mor Mia,9999,0,9999,0
1713523802631,CSS 201S,A01,494383,Staff,35,0,35,0
1713523803657,CSS 202S,A01,494387,Staff,35,0,35,0
1713523804684,EAP 100,A00,516065,Staff,9792,0,9999,207
1713523805712,ECE 45,A01,507414,Staff,37,0,60,23
1713523806738,ECE 100,A01,507416,Baghdadchi; Saharnaz,0,0,20,20
1713523806738,ECE 100,A02,507418,Baghdadchi; Saharnaz,19,0,20,1
1713523807763,ECE 111,A01,507420,Staff,27,0,50,23
1713523808799,ECE 197,001,548057,Sievenpiper; Daniel F.,9998,0,9999,1
1713523809823,EDS 115,A00,507243,Choi; Bailey Miyeon,27,0,28,1
1713523810849,EDS 117,A01,494379,Staff,14,0,25,11
1713523811874,EDS 125,A00,507246,Hopkins; Megan Beth,27,0,30,3
1713523812900,EDS 128A,A01,507264,Fargason; Sharon Gayle,26,0,26,0
1713523813929,EDS 128B,A01,507293,Pappas; Elizabeth,30,0,30,0
1713523814959,EDS 139,A00,507294,Fargason; Sharon Gayle,30,0,30,0
1713523814959,EDS 139,B00,507313,Pappas; Elizabeth,30,0,30,0
1713523815985,EDS 201,A00,507315,Staff,18,0,30,12
1713523817010,EDS 203,A01,507317,Halter; Christopher P.,17,0,30,13
1713523818040,EDS 204R,A01,507319,Halter; Christopher P.,0,1,30,30
1713523818040,EDS 204R,B01,507331,Heinzman; Erica M.,22,0,30,8
1713523819064,EDS 206R,A00,507332,Staff,0,2,30,30
1713523819064,EDS 206R,B00,507343,Staff,23,0,30,7
1713523820087,EDS 250,A00,507344,Hemans; Patricia Ann Benitez,27,0,40,13
1713523821115,EDS 281,A00,507345,Daly; Alan J.,18,0,18,0
1713523822140,EDS 284,A00,507350,Daly; Alan J.,16,0,16,0
1713523823164,EDS 286,A00,507359,Fine; Sarah,18,0,18,0
1713523824188,EDS 289C,A01,507361,Daly; Alan J.,18,0,18,0
1713523825214,EDS 290,A00,507366,Hofstetter; Carolyn,15,0,15,0
1713523826239,LIGM 5A,A00,507421,Fischer-Grunski; Eva K,20,0,20,0
1713523827265,LIGM 5B,A00,507423,Fischer-Grunski; Eva K,20,0,20,0
1713523828294,LIGM 5C,A00,507425,Fischer-Grunski; Eva K,20,0,20,0
1713523829321,LIIT 5AS,A00,507427,Carnelos; Chiara,20,0,20,0
1713523830346,LIIT 5BS,A00,507430,Carnelos; Chiara,20,0,20,0
1713523831371,LIIT 5CS,A00,507432,Carnelos; Chiara,20,0,20,0
1713523832396,LISP 5A,A00,507541,Munoz Sanchez; Alicia,14,0,20,6
1713523833425,LISP 5B,A00,507671,Munoz Sanchez; Alicia,12,0,20,8
1713523834453,LISP 5C,A00,507696,Munoz Sanchez; Alicia,11,0,20,9
1713523835482,MAE 197,001,528363,Boechler; Nicholas Sebastia,9998,0,9999,1
1713523836506,MATH 197,001,523477,Kedlaya; Kiran S.,9999,0,9999,0
1713523836506,MATH 197,002,563811,Zhang; Danna,9998,0,9999,1
1713523837535,MCWP 40R,A00,518780,Staff,13,0,20,7
1713523837535,MCWP 40R,B00,518781,Staff,11,0,20,9
1713523837535,MCWP 40R,C00,518783,Staff,8,0,20,12
1713523838559,MCWP 50R,A00,518791,Staff,7,0,20,13
1713523838559,MCWP 50R,B00,518792,Staff,3,0,20,17
1713523838559,MCWP 50R,C00,518793,Staff,5,0,20,15
1713523838559,MCWP 50R,D00,518794,Staff,0,0,20,20
1713523838559,MCWP 50R,E00,518795,Staff,0,0,20,20
1713523838559,MCWP 50R,F00,518796,Staff,10,0,20,10
1713523838559,MCWP 50R,G00,518797,Staff,10,0,20,10
1713523839584,MMW 12R,A01,514034,Herbst; Matthew,1,0,16,15
1713523839584,MMW 12R,A02,514035,Herbst; Matthew,13,0,16,3
1713523840609,MMW 13R,A01,514037,Staff,0,8,16,16
1713523840609,MMW 13R,A02,514039,Staff,0,7,16,16
1713523842665,SIO 295LS,A00,523233,Staff,15,0,30,15
1713523843690,SIO 295S,A00,523232,Staff,15,0,30,15
1713523844714,SOCI 117,A01,494376,Staff,0,2,5,5
1713523845745,WES 237B,A00,494380,Staff,19,0,20,1
1713523847831,AESE 279B,A00,494370,Wade; Jon P,33,0,33,0
1713523848857,AIP 197,001,627712,Vespa; Emanuel Ignacio,9999,0,9999,0
1713523849913,ANAR 135S,A00,494369,Braswell; Geoffrey E.,0,0,0,0
1713523850940,CAT 124RS,A01,519847,Geibel; William,6,0,20,14
1713523851966,CAT 125RS,A01,515971,Geibel; William,6,0,20,14
1713523852992,CLRE 250,A00,511389,Morris; Sheldon,9996,0,9999,3
1713523854021,CLRE 251,A00,507176,Mehta; Ravindra L.,9996,0,9999,3
1713523854021,CLRE 251,B00,511410,Mehta; Ravindra L.,9998,0,9999,1
1713523855050,CLRE 252,A00,507189,Cuomo; Raphael Eduardo,9998,0,9999,1
1713523856079,CLRE 253,A00,507199,Vaida; Florin,9997,0,9999,2
1713523856079,CLRE 253,B00,507202,Vaida; Florin,9999,0,9999,0
1713523857105,CLRE 259,A00,507211,Patel; Hemal,9996,0,9999,3
1713523858131,CLRE 260,A00,507221,Cuomo; Raphael Eduardo,9999,0,9999,0
1713523859158,CLRE 297,001,507242,Cuomo; Raphael Eduardo,9999,0,9999,0
1713523860184,CSE 191,A00,516875,Minnes Kemp; Mor Mia,9999,0,9999,0
1713523861214,CSS 201S,A01,494383,Staff,35,0,35,0
1713523862244,CSS 202S,A01,494387,Staff,35,0,35,0
1713523863273,EAP 100,A00,516065,Staff,9792,0,9999,207
1713523864298,ECE 45,A01,507414,Staff,37,0,60,23
1713523865330,ECE 100,A01,507416,Baghdadchi; Saharnaz,0,0,20,20
1713523865330,ECE 100,A02,507418,Baghdadchi; Saharnaz,19,0,20,1
1713523866357,ECE 111,A01,507420,Staff,27,0,50,23
1713523867386,ECE 197,001,548057,Sievenpiper; Daniel F.,9998,0,9999,1
1713523868412,EDS 115,A00,507243,Choi; Bailey Miyeon,27,0,28,1
1713523869442,EDS 117,A01,494379,Staff,14,0,25,11
1713523870472,EDS 125,A00,507246,Hopkins; Megan Beth,27,0,30,3
1713523871501,EDS 128A,A01,507264,Fargason; Sharon Gayle,26,0,26,0
1713523872526,EDS 128B,A01,507293,Pappas; Elizabeth,30,0,30,0
1713523873555,EDS 139,A00,507294,Fargason; Sharon Gayle,30,0,30,0
1713523873555,EDS 139,B00,507313,Pappas; Elizabeth,30,0,30,0
1713523874581,EDS 201,A00,507315,Staff,18,0,30,12
1713523875613,EDS 203,A01,507317,Halter; Christopher P.,17,0,30,13
1713523876640,EDS 204R,A01,507319,Halter; Christopher P.,0,1,30,30
1713523876640,EDS 204R,B01,507331,Heinzman; Erica M.,22,0,30,8
1713523877721,EDS 206R,A00,507332,Staff,0,2,30,30
1713523877721,EDS 206R,B00,507343,Staff,23,0,30,7
1713523878747,EDS 250,A00,507344,Hemans; Patricia Ann Benitez,27,0,40,13
1713523879776,EDS 281,A00,507345,Daly; Alan J.,18,0,18,0
1713523880800,EDS 284,A00,507350,Daly; Alan J.,16,0,16,0
1713523881829,EDS 286,A00,507359,Fine; Sarah,18,0,18,0
1713523882855,EDS 289C,A01,507361,Daly; Alan J.,18,0,18,0
1713523883881,EDS 290,A00,507366,Hofstetter; Carolyn,15,0,15,0
1713523884918,LIGM 5A,A00,507421,Fischer-Grunski; Eva K,20,0,20,0
1713523885942,LIGM 5B,A00,507423,Fischer-Grunski; Eva K,20,0,20,0
1713523886971,LIGM 5C,A00,507425,Fischer-Grunski; Eva K,20,0,20,0
1713523888011,LIIT 5AS,A00,507427,Carnelos; Chiara,20,0,20,0
1713523889036,LIIT 5BS,A00,507430,Carnelos; Chiara,20,0,20,0
1713523890066,LIIT 5CS,A00,507432,Carnelos; Chiara,20,0,20,0
1713523891093,LISP 5A,A00,507541,Munoz Sanchez; Alicia,14,0,20,6
1713523892118,LISP 5B,A00,507671,Munoz Sanchez; Alicia,12,0,20,8
1713523893144,LISP 5C,A00,507696,Munoz Sanchez; Alicia,11,0,20,9
1713523894186,MAE 197,001,528363,Boechler; Nicholas Sebastia,9998,0,9999,1
1713523895212,MATH 197,001,523477,Kedlaya; Kiran S.,9999,0,9999,0
1713523895212,MATH 197,002,563811,Zhang; Danna,9998,0,9999,1
1713523896241,MCWP 40R,A00,518780,Staff,13,0,20,7
1713523896241,MCWP 40R,B00,518781,Staff,11,0,20,9
1713523896241,MCWP 40R,C00,518783,Staff,8,0,20,12
1713523897266,MCWP 50R,A00,518791,Staff,7,0,20,13
1713523897266,MCWP 50R,B00,518792,Staff,3,0,20,17
1713523897266,MCWP 50R,C00,518793,Staff,5,0,20,15
1713523897266,MCWP 50R,D00,518794,Staff,0,0,20,20
1713523897266,MCWP 50R,E00,518795,Staff,0,0,20,20
1713523897266,MCWP 50R,F00,518796,Staff,10,0,20,10
1713523897266,MCWP 50R,G00,518797,Staff,10,0,20,10
1713523898293,MMW 12R,A01,514034,Herbst; Matthew,1,0,16,15
1713523898293,MMW 12R,A02,514035,Herbst; Matthew,13,0,16,3
1713523899321,MMW 13R,A01,514037,Staff,0,8,16,16
1713523899321,MMW 13R,A02,514039,Staff,0,7,16,16
1713523901377,SIO 295LS,A00,523233,Staff,15,0,30,15
1713523902405,SIO 295S,A00,523232,Staff,15,0,30,15
1713523903435,SOCI 117,A01,494376,Staff,0,2,5,5
1713523904464,WES 237B,A00,494380,Staff,19,0,20,1
1713523906542,AESE 279B,A00,494370,Wade; Jon P,33,0,33,0
1713523907569,AIP 197,001,627712,Vespa; Emanuel Ignacio,9999,0,9999,0
1713523908597,ANAR 135S,A00,494369,Braswell; Geoffrey E.,0,0,0,0
1713523909635,CAT 124RS,A01,519847,Geibel; William,6,0,20,14
1713523910660,CAT 125RS,A01,515971,Geibel; William,6,0,20,14
1713523911685,CLRE 250,A00,511389,Morris; Sheldon,9996,0,9999,3
1713523912716,CLRE 251,A00,507176,Mehta; Ravindra L.,9996,0,9999,3
1713523912716,CLRE 251,B00,511410,Mehta; Ravindra L.,9998,0,9999,1
1713523913741,CLRE 252,A00,507189,Cuomo; Raphael Eduardo,9998,0,9999,1
1713523914772,CLRE 253,A00,507199,Vaida; Florin,9997,0,9999,2
1713523914772,CLRE 253,B00,507202,Vaida; Florin,9999,0,9999,0
1713523915799,CLRE 259,A00,507211,Patel; Hemal,9996,0,9999,3
1713523916825,CLRE 260,A00,507221,Cuomo; Raphael Eduardo,9999,0,9999,0
1713523917854,CLRE 297,001,507242,Cuomo; Raphael Eduardo,9999,0,9999,0
1713523918881,CSE 191,A00,516875,Minnes Kemp; Mor Mia,9999,0,9999,0
1713523919908,CSS 201S,A01,494383,Staff,35,0,35,0
1713523920941,CSS 202S,A01,494387,Staff,35,0,35,0
1713523921969,EAP 100,A00,516065,Staff,9792,0,9999,207
1713523922994,ECE 45,A01,507414,Staff,37,0,60,23
1713523924019,ECE 100,A01,507416,Baghdadchi; Saharnaz,0,0,20,20
1713523924019,ECE 100,A02,507418,Baghdadchi; Saharnaz,19,0,20,1
1713523925046,ECE 111,A01,507420,Staff,27,0,50,23
1713523926073,ECE 197,001,548057,Sievenpiper; Daniel F.,9998,0,9999,1
1713523927109,EDS 115,A00,507243,Choi; Bailey Miyeon,27,0,28,1
1713523928136,EDS 117,A01,494379,Staff,14,0,25,11
1713523929166,EDS 125,A00,507246,Hopkins; Megan Beth,27,0,30,3
1713523930192,EDS 128A,A01,507264,Fargason; Sharon Gayle,26,0,26,0
1713523931219,EDS 128B,A01,507293,Pappas; Elizabeth,30,0,30,0
1713523932245,EDS 139,A00,507294,Fargason; Sharon Gayle,30,0,30,0
1713523932245,EDS 139,B00,507313,Pappas; Elizabeth,30,0,30,0
1713523933270,EDS 201,A00,507315,Staff,18,0,30,12
1713523934303,EDS 203,A01,507317,Halter; Christopher P.,17,0,30,13
1713523935330,EDS 204R,A01,507319,Halter; Christopher P.,0,1,30,30
1713523935330,EDS 204R,B01,507331,Heinzman; Erica M.,22,0,30,8
1713523936355,EDS 206R,A00,507332,Staff,0,2,30,30
1713523936355,EDS 206R,B00,507343,Staff,23,0,30,7
1713523937379,EDS 250,A00,507344,Hemans; Patricia Ann Benitez,27,0,40,13
1713523938409,EDS 281,A00,507345,Daly; Alan J.,18,0,18,0
1713523939434,EDS 284,A00,507350,Daly; Alan J.,16,0,16,0
1713523940464,EDS 286,A00,507359,Fine; Sarah,18,0,18,0
1713523941490,EDS 289C,A01,507361,Daly; Alan J.,18,0,18,0
1713523942516,EDS 290,A00,507366,Hofstetter; Carolyn,15,0,15,0
1713523943542,LIGM 5A,A00,507421,Fischer-Grunski; Eva K,20,0,20,0
1713523944566,LIGM 5B,A00,507423,Fischer-Grunski; Eva K,20,0,20,0
1713523945595,LIGM 5C,A00,507425,Fischer-Grunski; Eva K,20,0,20,0
1713523946621,LIIT 5AS,A00,507427,Carnelos; Chiara,20,0,20,0
1713523947645,LIIT 5BS,A00,507430,Carnelos; Chiara,20,0,20,0
1713523948671,LIIT 5CS,A00,507432,Carnelos; Chiara,20,0,20,0
1713523949702,LISP 5A,A00,507541,Munoz Sanchez; Alicia,14,0,20,6
1713523950727,LISP 5B,A00,507671,Munoz Sanchez; Alicia,12,0,20,8
1713523951758,LISP 5C,A00,507696,Munoz Sanchez; Alicia,11,0,20,9
1713523952785,MAE 197,001,528363,Boechler; Nicholas Sebastia,9998,0,9999,1
1713523953827,MATH 197,001,523477,Kedlaya; Kiran S.,9999,0,9999,0
1713523953827,MATH 197,002,563811,Zhang; Danna,9998,0,9999,1
1713523954854,MCWP 40R,A00,518780,Staff,13,0,20,7
1713523954854,MCWP 40R,B00,518781,Staff,11,0,20,9
1713523954854,MCWP 40R,C00,518783,Staff,8,0,20,12
1713523955881,MCWP 50R,A00,518791,Staff,7,0,20,13
1713523955881,MCWP 50R,B00,518792,Staff,3,0,20,17
1713523955881,MCWP 50R,C00,518793,Staff,5,0,20,15
1713523955881,MCWP 50R,D00,518794,Staff,0,0,20,20
1713523955881,MCWP 50R,E00,518795,Staff,0,0,20,20
1713523955881,MCWP 50R,F00,518796,Staff,10,0,20,10
1713523955881,MCWP 50R,G00,518797,Staff,10,0,20,10
1713523956914,MMW 12R,A01,514034,Herbst; Matthew,1,0,16,15
1713523956914,MMW 12R,A02,514035,Herbst; Matthew,13,0,16,3
1713523957943,MMW 13R,A01,514037,Staff,0,8,16,16
1713523957943,MMW 13R,A02,514039,Staff,0,7,16,16
1713523959992,SIO 295LS,A00,523233,Staff,15,0,30,15
1713523961016,SIO 295S,A00,523232,Staff,15,0,30,15
1713523962047,SOCI 117,A01,494376,Staff,0,2,5,5
1713523963074,WES 237B,A00,494380,Staff,19,0,20,1
1713523965149,AESE 279B,A00,494370,Wade; Jon P,33,0,33,0
1713523966181,AIP 197,001,627712,Vespa; Emanuel Ignacio,9999,0,9999,0
1713523967206,ANAR 135S,A00,494369,Braswell; Geoffrey E.,0,0,0,0
1713523968231,CAT 124RS,A01,519847,Geibel; William,6,0,20,14
1713523969262,CAT 125RS,A01,515971,Geibel; William,6,0,20,14
1713523970295,CLRE 250,A00,511389,Morris; Sheldon,9996,0,9999,3
1713523971323,CLRE 251,A00,507176,Mehta; Ravindra L.,9996,0,9999,3
1713523971323,CLRE 251,B00,511410,Mehta; Ravindra L.,9998,0,9999,1
1713523972350,CLRE 252,A00,507189,Cuomo; Raphael Eduardo,9998,0,9999,1
1713523973375,CLRE 253,A00,507199,Vaida; Florin,9997,0,9999,2
1713523973375,CLRE 253,B00,507202,Vaida; Florin,9999,0,9999,0
1713523974406,CLRE 259,A00,507211,Patel; Hemal,9996,0,9999,3
1713523975434,CLRE 260,A00,507221,Cuomo; Raphael Eduardo,9999,0,9999,0
1713523976459,CLRE 297,001,507242,Cuomo; Raphael Eduardo,9999,0,9999,0
1713523977485,CSE 191,A00,516875,Minnes Kemp; Mor Mia,9999,0,9999,0
1713523978512,CSS 201S,A01,494383,Staff,35,0,35,0
1713523979542,CSS 202S,A01,494387,Staff,35,0,35,0
1713523980569,EAP 100,A00,516065,Staff,9792,0,9999,207
1713523981666,ECE 45,A01,507414,Staff,37,0,60,23
1713523982693,ECE 100,A01,507416,Baghdadchi; Saharnaz,0,0,20,20
1713523982693,ECE 100,A02,507418,Baghdadchi; Saharnaz,19,0,20,1
1713523983717,ECE 111,A01,507420,Staff,27,0,50,23
1713523984749,ECE 197,001,548057,Sievenpiper; Daniel F.,9998,0,9999,1
1713523985782,EDS 115,A00,507243,Choi; Bailey Miyeon,27,0,28,1
1713523986809,EDS 117,A01,494379,Staff,14,0,25,11
1713523987842,EDS 125,A00,507246,Hopkins; Megan Beth,27,0,30,3
1713523988868,EDS 128A,A01,507264,Fargason; Sharon Gayle,26,0,26,0
1713523989895,EDS 128B,A01,507293,Pappas; Elizabeth,30,0,30,0
1713523990925,EDS 139,A00,507294,Fargason; Sharon Gayle,30,0,30,0
1713523990925,EDS 139,B00,507313,Pappas; Elizabeth,30,0,30,0
1713523991950,EDS 201,A00,507315,Staff,18,0,30,12
1713523992977,EDS 203,A01,507317,Halter; Christopher P.,17,0,30,13
1713523994006,EDS 204R,A01,507319,Halter; Christopher P.,0,1,30,30
1713523994006,EDS 204R,B01,507331,Heinzman; Erica M.,22,0,30,8
1713523995030,EDS 206R,A00,507332,Staff,0,2,30,30
1713523995030,EDS 206R,B00,507343,Staff,23,0,30,7
1713523996062,EDS 250,A00,507344,Hemans; Patricia Ann Benitez,27,0,40,13
1713523997095,EDS 281,A00,507345,Daly; Alan J.,18,0,18,0
1713523998119,EDS 284,A00,507350,Daly; Alan J.,16,0,16,0
1713523999145,EDS 286,A00,507359,Fine; Sarah,18,0,18,0
1713524000171,EDS 289C,A01,507361,Daly; Alan J.,18,0,18,0
1713524001197,EDS 290,A00,507366,Hofstetter; Carolyn,15,0,15,0
1713524002223,LIGM 5A,A00,507421,Fischer-Grunski; Eva K,20,0,20,0
1713524003251,LIGM 5B,A00,507423,Fischer-Grunski; Eva K,20,0,20,0
1713524004286,LIGM 5C,A00,507425,Fischer-Grunski; Eva K,20,0,20,0
1713524005310,LIIT 5AS,A00,507427,Carnelos; Chiara,20,0,20,0
1713524006336,LIIT 5BS,A00,507430,Carnelos; Chiara,20,0,20,0
1713524007362,LIIT 5CS,A00,507432,Carnelos; Chiara,20,0,20,0
1713524008390,LISP 5A,A00,507541,Munoz Sanchez; Alicia,14,0,20,6
1713524009418,LISP 5B,A00,507671,Munoz Sanchez; Alicia,12,0,20,8
1713524010443,LISP 5C,A00,507696,Munoz Sanchez; Alicia,11,0,20,9
1713524011475,MAE 197,001,528363,Boechler; Nicholas Sebastia,9998,0,9999,1
1713524012504,MATH 197,001,523477,Kedlaya; Kiran S.,9999,0,9999,0
1713524012504,MATH 197,002,563811,Zhang; Danna,9998,0,9999,1
1713524013531,MCWP 40R,A00,518780,Staff,13,0,20,7
1713524013531,MCWP 40R,B00,518781,Staff,11,0,20,9
1713524013531,MCWP 40R,C00,518783,Staff,8,0,20,12
1713524014558,MCWP 50R,A00,518791,Staff,7,0,20,13
1713524014558,MCWP 50R,B00,518792,Staff,3,0,20,17
1713524014558,MCWP 50R,C00,518793,Staff,5,0,20,15
1713524014558,MCWP 50R,D00,518794,Staff,0,0,20,20
1713524014558,MCWP 50R,E00,518795,Staff,0,0,20,20
1713524014558,MCWP 50R,F00,518796,Staff,10,0,20,10
1713524014558,MCWP 50R,G00,518797,Staff,10,0,20,10
1713524015586,MMW 12R,A01,514034,Herbst; Matthew,1,0,16,15
1713524015586,MMW 12R,A02,514035,Herbst; Matthew,13,0,16,3
1713524016613,MMW 13R,A01,514037,Staff,0,8,16,16
1713524016613,MMW 13R,A02,514039,Staff,0,7,16,16
1713524018666,SIO 295LS,A00,523233,Staff,15,0,30,15
1713524019692,SIO 295S,A00,523232,Staff,15,0,30,15
1713524020719,SOCI 117,A01,494376,Staff,0,2,5,5
1713524021751,WES 237B,A00,494380,Staff,19,0,20,1
1713524023847,AESE 279B,A00,494370,Wade; Jon P,33,0,33,0
1713524024874,AIP 197,001,627712,Vespa; Emanuel Ignacio,9999,0,9999,0
1713524025900,ANAR 135S,A00,494369,Braswell; Geoffrey E.,0,0,0,0
1713524026927,CAT 124RS,A01,519847,Geibel; William,6,0,20,14
1713524027955,CAT 125RS,A01,515971,Geibel; William,6,0,20,14
1713524028983,CLRE 250,A00,511389,Morris; Sheldon,9996,0,9999,3
1713524030021,CLRE 251,A00,507176,Mehta; Ravindra L.,9996,0,9999,3
1713524030021,CLRE 251,B00,511410,Mehta; Ravindra L.,9998,0,9999,1
1713524031048,CLRE 252,A00,507189,Cuomo; Raphael Eduardo,9998,0,9999,1
1713524032076,CLRE 253,A00,507199,Vaida; Florin,9997,0,9999,2
1713524032076,CLRE 253,B00,507202,Vaida; Florin,9999,0,9999,0
1713524033102,CLRE 259,A00,507211,Patel; Hemal,9996,0,9999,3
1713524034128,CLRE 260,A00,507221,Cuomo; Raphael Eduardo,9999,0,9999,0
1713524035159,CLRE 297,001,507242,Cuomo; Raphael Eduardo,9999,0,9999,0
1713524036193,CSE 191,A00,516875,Minnes Kemp; Mor Mia,9999,0,9999,0
1713524037225,CSS 201S,A01,494383,Staff,35,0,35,0
1713524038250,CSS 202S,A01,494387,Staff,35,0,35,0
1713524039277,EAP 100,A00,516065,Staff,9792,0,9999,207
1713524040306,ECE 45,A01,507414,Staff,37,0,60,23
1713524041332,ECE 100,A01,507416,Baghdadchi; Saharnaz,0,0,20,20
1713524041332,ECE 100,A02,507418,Baghdadchi; Saharnaz,19,0,20,1
1713524042364,ECE 111,A01,507420,Staff,27,0,50,23
1713524043391,ECE 197,001,548057,Sievenpiper; Daniel F.,9998,0,9999,1
1713524044418,EDS 115,A00,507243,Choi; Bailey Miyeon,27,0,28,1
1713524045448,EDS 117,A01,494379,Staff,14,0,25,11
1713524046488,EDS 125,A00,507246,Hopkins; Megan Beth,27,0,30,3
1713524047514,EDS 128A,A01,507264,Fargason; Sharon Gayle,26,0,26,0
1713524048539,EDS 128B,A01,507293,Pappas; Elizabeth,30,0,30,0
1713524049571,EDS 139,A00,507294,Fargason; Sharon Gayle,30,0,30,0
1713524049571,EDS 139,B00,507313,Pappas; Elizabeth,30,0,30,0
1713524050597,EDS 201,A00,507315,Staff,18,0,30,12
1713524051630,EDS 203,A01,507317,Halter; Christopher P.,17,0,30,13
1713524052656,EDS 204R,A01,507319,Halter; Christopher P.,0,1,30,30
1713524052656,EDS 204R,B01,507331,Heinzman; Erica M.,22,0,30,8
1713524053682,EDS 206R,A00,507332,Staff,0,2,30,30
1713524053682,EDS 206R,B00,507343,Staff,23,0,30,7
1713524054714,EDS 250,A00,507344,Hemans; Patricia Ann Benitez,27,0,40,13
1713524055740,EDS 281,A00,507345,Daly; Alan J.,18,0,18,0
1713524056766,EDS 284,A00,507350,Daly; Alan J.,16,0,16,0
1713524057798,EDS 286,A00,507359,Fine; Sarah,18,0,18,0
1713524058824,EDS 289C,A01,507361,Daly; Alan J.,18,0,18,0
1713524059858,EDS 290,A00,507366,Hofstetter; Carolyn,15,0,15,0
1713524060885,LIGM 5A,A00,507421,Fischer-Grunski; Eva K,20,0,20,0
1713524061915,LIGM 5B,A00,507423,Fischer-Grunski; Eva K,20,0,20,0
1713524062941,LIGM 5C,A00,507425,Fischer-Grunski; Eva K,20,0,20,0
1713524063995,LIIT 5AS,A00,507427,Carnelos; Chiara,20,0,20,0
1713524065023,LIIT 5BS,A00,507430,Carnelos; Chiara,20,0,20,0
1713524066049,LIIT 5CS,A00,507432,Carnelos; Chiara,20,0,20,0
1713524067077,LISP 5A,A00,507541,Munoz Sanchez; Alicia,14,0,20,6
1713524068109,LISP 5B,A00,507671,Munoz Sanchez; Alicia,12,0,20,8
1713524069140,LISP 5C,A00,507696,Munoz Sanchez; Alicia,11,0,20,9
1713524070175,MAE 197,001,528363,Boechler; Nicholas Sebastia,9998,0,9999,1
1713524071203,MATH 197,001,523477,Kedlaya; Kiran S.,9999,0,9999,0
1713524071203,MATH 197,002,563811,Zhang; Danna,9998,0,9999,1
1713524072236,MCWP 40R,A00,518780,Staff,13,0,20,7
1713524072236,MCWP 40R,B00,518781,Staff,11,0,20,9
1713524072236,MCWP 40R,C00,518783,Staff,8,0,20,12
1713524073267,MCWP 50R,A00,518791,Staff,7,0,20,13
1713524073267,MCWP 50R,B00,518792,Staff,3,0,20,17
1713524073267,MCWP 50R,C00,518793,Staff,5,0,20,15
1713524073267,MCWP 50R,D00,518794,Staff,0,0,20,20
1713524073267,MCWP 50R,E00,518795,Staff,0,0,20,20
1713524073267,MCWP 50R,F00,518796,Staff,10,0,20,10
1713524073267,MCWP 50R,G00,518797,Staff,10,0,20,10
1713524074304,MMW 12R,A01,514034,Herbst; Matthew,1,0,16,15
1713524074304,MMW 12R,A02,514035,Herbst; Matthew,13,0,16,3
1713524075334,MMW 13R,A01,514037,Staff,0,8,16,16
1713524075334,MMW 13R,A02,514039,Staff,0,7,16,16
1713524077396,SIO 295LS,A00,523233,Staff,15,0,30,15
1713524078420,SIO 295S,A00,523232,Staff,15,0,30,15
1713524079457,SOCI 117,A01,494376,Staff,0,2,5,5
1713524080484,WES 237B,A00,494380,Staff,19,0,20,1
1713524082558,AESE 279B,A00,494370,Wade; Jon P,33,0,33,0
1713524083583,AIP 197,001,627712,Vespa; Emanuel Ignacio,9999,0,9999,0
1713524084618,ANAR 135S,A00,494369,Braswell; Geoffrey E.,0,0,0,0
1713524085705,CAT 124RS,A01,519847,Geibel; William,6,0,20,14
1713524086735,CAT 125RS,A01,515971,Geibel; William,6,0,20,14
1713524087767,CLRE 250,A00,511389,Morris; Sheldon,9996,0,9999,3
1713524088803,CLRE 251,A00,507176,Mehta; Ravindra L.,9996,0,9999,3
1713524088803,CLRE 251,B00,511410,Mehta; Ravindra L.,9998,0,9999,1
1713524089828,CLRE 252,A00,507189,Cuomo; Raphael Eduardo,9998,0,9999,1
1713524090855,CLRE 253,A00,507199,Vaida; Florin,9997,0,9999,2
1713524090855,CLRE 253,B00,507202,Vaida; Florin,9999,0,9999,0
1713524091887,CLRE 259,A00,507211,Patel; Hemal,9996,0,9999,3
1713524092913,CLRE 260,A00,507221,Cuomo; Raphael Eduardo,9999,0,9999,0
1713524093942,CLRE 297,001,507242,Cuomo; Raphael Eduardo,9999,0,9999,0
1713524094976,CSE 191,A00,516875,Minnes Kemp; Mor Mia,9999,0,9999,0
1713524096004,CSS 201S,A01,494383,Staff,35,0,35,0
1713524097035,CSS 202S,A01,494387,Staff,35,0,35,0
1713524098074,EAP 100,A00,516065,Staff,9792,0,9999,207
1713524099101,ECE 45,A01,507414,Staff,37,0,60,23
1713524100198,ECE 100,A01,507416,Baghdadchi; Saharnaz,0,0,20,20
1713524100198,ECE 100,A02,507418,Baghdadchi; Saharnaz,19,0,20,1
1713524101231,ECE 111,A01,507420,Staff,27,0,50,23
1713524102260,ECE 197,001,548057,Sievenpiper; Daniel F.,9998,0,9999,1
1713524103288,EDS 115,A00,507243,Choi; Bailey Miyeon,27,0,28,1
1713524104314,EDS 117,A01,494379,Staff,14,0,25,11
1713524105341,EDS 125,A00,507246,Hopkins; Megan Beth,27,0,30,3
1713524106368,EDS 128A,A01,507264,Fargason; Sharon Gayle,26,0,26,0
1713524107406,EDS 128B,A01,507293,Pappas; Elizabeth,30,0,30,0
1713524108433,EDS 139,A00,507294,Fargason; Sharon Gayle,30,0,30,0
1713524108433,EDS 139,B00,507313,Pappas; Elizabeth,30,0,30,0
1713524109459,EDS 201,A00,507315,Staff,18,0,30,12
1713524110495,EDS 203,A01,507317,Halter; Christopher P.,17,0,30,13
1713524111558,EDS 204R,A01,507319,Halter; Christopher P.,0,1,30,30
1713524111558,EDS 204R,B01,507331,Heinzman; Erica M.,22,0,30,8
1713524112584,EDS 206R,A00,507332,Staff,0,2,30,30
1713524112584,EDS 206R,B00,507343,Staff,23,0,30,7
1713524113609,EDS 250,A00,507344,Hemans; Patricia Ann Benitez,27,0,40,13
1713524114636,EDS 281,A00,507345,Daly; Alan J.,18,0,18,0
1713524115661,EDS 284,A00,507350,Daly; Alan J.,16,0,16,0
1713524116687,EDS 286,A00,507359,Fine; Sarah,18,0,18,0
1713524117711,EDS 289C,A01,507361,Daly; Alan J.,18,0,18,0
1713524118793,EDS 290,A00,507366,Hofstetter; Carolyn,15,0,15,0
1713524119820,LIGM 5A,A00,507421,Fischer-Grunski; Eva K,20,0,20,0
1713524120847,LIGM 5B,A00,507423,Fischer-Grunski; Eva K,20,0,20,0
1713524121872,LIGM 5C,A00,507425,Fischer-Grunski; Eva K,20,0,20,0
1713524122898,LIIT 5AS,A00,507427,Carnelos; Chiara,20,0,20,0
1713524123924,LIIT 5BS,A00,507430,Carnelos; Chiara,20,0,20,0
1713524124950,LIIT 5CS,A00,507432,Carnelos; Chiara,20,0,20,0
1713524125976,LISP 5A,A00,507541,Munoz Sanchez; Alicia,14,0,20,6
1713524127002,LISP 5B,A00,507671,Munoz Sanchez; Alicia,12,0,20,8
1713524128026,LISP 5C,A00,507696,Munoz Sanchez; Alicia,11,0,20,9
1713524129052,MAE 197,001,528363,Boechler; Nicholas Sebastia,9998,0,9999,1
1713524130079,MATH 197,001,523477,Kedlaya; Kiran S.,9999,0,9999,0
1713524130079,MATH 197,002,563811,Zhang; Danna,9998,0,9999,1
1713524131106,MCWP 40R,A00,518780,Staff,13,0,20,7
1713524131106,MCWP 40R,B00,518781,Staff,11,0,20,9
1713524131106,MCWP 40R,C00,518783,Staff,8,0,20,12
1713524132138,MCWP 50R,A00,518791,Staff,7,0,20,13
1713524132138,MCWP 50R,B00,518792,Staff,3,0,20,17
1713524132138,MCWP 50R,C00,518793,Staff,5,0,20,15
1713524132138,MCWP 50R,D00,518794,Staff,0,0,20,20
1713524132138,MCWP 50R,E00,518795,Staff,0,0,20,20
1713524132138,MCWP 50R,F00,518796,Staff,10,0,20,10
1713524132138,MCWP 50R,G00,518797,Staff,10,0,20,10
1713524133163,MMW 12R,A01,514034,Herbst; Matthew,1,0,16,15
1713524133163,MMW 12R,A02,514035,Herbst; Matthew,13,0,16,3
1713524134189,MMW 13R,A01,514037,Staff,0,8,16,16
1713524134189,MMW 13R,A02,514039,Staff,0,7,16,16
1713524136245,SIO 295LS,A00,523233,Staff,15,0,30,15
1713524137273,SIO 295S,A00,523232,Staff,15,0,30,15
1713524138299,SOCI 117,A01,494376,Staff,0,2,5,5
1713524139324,WES 237B,A00,494380,Staff,19,0,20,1
1713524141461,AESE 279B,A00,494370,Wade; Jon P,33,0,33,0
1713524142495,AIP 197,001,627712,Vespa; Emanuel Ignacio,9999,0,9999,0
1713524143521,ANAR 135S,A00,494369,Braswell; Geoffrey E.,0,0,0,0
1713524144548,CAT 124RS,A01,519847,Geibel; William,6,0,20,14
1713524145574,CAT 125RS,A01,515971,Geibel; William,6,0,20,14
1713524146606,CLRE 250,A00,511389,Morris; Sheldon,9996,0,9999,3
1713524147632,CLRE 251,A00,507176,Mehta; Ravindra L.,9996,0,9999,3
1713524147632,CLRE 251,B00,511410,Mehta; Ravindra L.,9998,0,9999,1
1713524148658,CLRE 252,A00,507189,Cuomo; Raphael Eduardo,9998,0,9999,1
1713524149682,CLRE 253,A00,507199,Vaida; Florin,9997,0,9999,2
1713524149682,CLRE 253,B00,507202,Vaida; Florin,9999,0,9999,0
1713524150718,CLRE 259,A00,507211,Patel; Hemal,9996,0,9999,3
1713524151747,CLRE 260,A00,507221,Cuomo; Raphael Eduardo,9999,0,9999,0
1713524152773,CLRE 297,001,507242,Cuomo; Raphael Eduardo,9999,0,9999,0
1713524153799,CSE 191,A00,516875,Minnes Kemp; Mor Mia,9999,0,9999,0
1713524154830,CSS 201S,A01,494383,Staff,35,0,35,0
1713524155856,CSS 202S,A01,494387,Staff,35,0,35,0
1713524156885,EAP 100,A00,516065,Staff,9792,0,9999,207
1713524157910,ECE 45,A01,507414,Staff,37,0,60,23
1713524158941,ECE 100,A01,507416,Baghdadchi; Saharnaz,0,0,20,20
1713524158941,ECE 100,A02,507418,Baghdadchi; Saharnaz,19,0,20,1
1713524159970,ECE 111,A01,507420,Staff,27,0,50,23
1713524160997,ECE 197,001,548057,Sievenpiper; Daniel F.,9998,0,9999,1
1713524162080,EDS 115,A00,507243,Choi; Bailey Miyeon,27,0,28,1
1713524163107,EDS 117,A01,494379,Staff,14,0,25,11
1713524164136,EDS 125,A00,507246,Hopkins; Megan Beth,27,0,30,3
1713524165161,EDS 128A,A01,507264,Fargason; Sharon Gayle,26,0,26,0
1713524166187,EDS 128B,A01,507293,Pappas; Elizabeth,30,0,30,0
1713524167213,EDS 139,A00,507294,Fargason; Sharon Gayle,30,0,30,0
1713524167213,EDS 139,B00,507313,Pappas; Elizabeth,30,0,30,0
1713524168244,EDS 201,A00,507315,Staff,18,0,30,12
1713524169273,EDS 203,A01,507317,Halter; Christopher P.,17,0,30,13
1713524170302,EDS 204R,A01,507319,Halter; Christopher P.,0,1,30,30
1713524170302,EDS 204R,B01,507331,Heinzman; Erica M.,22,0,30,8
1713524171331,EDS 206R,A00,507332,Staff,0,2,30,30
1713524171331,EDS 206R,B00,507343,Staff,23,0,30,7
1713524172360,EDS 250,A00,507344,Hemans; Patricia Ann Benitez,27,0,40,13
1713524173389,EDS 281,A00,507345,Daly; Alan J.,18,0,18,0
1713524174414,EDS 284,A00,507350,Daly; Alan J.,16,0,16,0
1713524175440,EDS 286,A00,507359,Fine; Sarah,18,0,18,0
1713524176468,EDS 289C,A01,507361,Daly; Alan J.,18,0,18,0
1713524177492,EDS 290,A00,507366,Hofstetter; Carolyn,15,0,15,0
1713524178518,LIGM 5A,A00,507421,Fischer-Grunski; Eva K,20,0,20,0
1713524179543,LIGM 5B,A00,507423,Fischer-Grunski; Eva K,20,0,20,0
1713524180577,LIGM 5C,A00,507425,Fischer-Grunski; Eva K,20,0,20,0
1713524181603,LIIT 5AS,A00,507427,Carnelos; Chiara,20,0,20,0
1713524182628,LIIT 5BS,A00,507430,Carnelos; Chiara,20,0,20,0
1713524183654,LIIT 5CS,A00,507432,Carnelos; Chiara,20,0,20,0
1713524184678,LISP 5A,A00,507541,Munoz Sanchez; Alicia,14,0,20,6
1713524185703,LISP 5B,A00,507671,Munoz Sanchez; Alicia,12,0,20,8
1713524186737,LISP 5C,A00,507696,Munoz Sanchez; Alicia,11,0,20,9
1713524187763,MAE 197,001,528363,Boechler; Nicholas Sebastia,9998,0,9999,1
1713524188799,MATH 197,001,523477,Kedlaya; Kiran S.,9999,0,9999,0
1713524188799,MATH 197,002,563811,Zhang; Danna,9998,0,9999,1
1713524189883,MCWP 40R,A00,518780,Staff,13,0,20,7
1713524189883,MCWP 40R,B00,518781,Staff,11,0,20,9
1713524189883,MCWP 40R,C00,518783,Staff,8,0,20,12
1713524190909,MCWP 50R,A00,518791,Staff,7,0,20,13
1713524190909,MCWP 50R,B00,518792,Staff,3,0,20,17
1713524190909,MCWP 50R,C00,518793,Staff,5,0,20,15
1713524190909,MCWP 50R,D00,518794,Staff,0,0,20,20
1713524190909,MCWP 50R,E00,518795,Staff,0,0,20,20
1713524190909,MCWP 50R,F00,518796,Staff,10,0,20,10
1713524190909,MCWP 50R,G00,518797,Staff,10,0,20,10
1713524191936,MMW 12R,A01,514034,Herbst; Matthew,1,0,16,15
1713524191936,MMW 12R,A02,514035,Herbst; Matthew,13,0,16,3
1713524192966,MMW 13R,A01,514037,Staff,0,8,16,16
1713524192966,MMW 13R,A02,514039,Staff,0,7,16,16
1713524195020,SIO 295LS,A00,523233,Staff,15,0,30,15
1713524196049,SIO 295S,A00,523232,Staff,15,0,30,15
1713524197076,SOCI 117,A01,494376,Staff,0,2,5,5
1713524198109,WES 237B,A00,494380,Staff,19,0,20,1
1713524200202,AESE 279B,A00,494370,Wade; Jon P,33,0,33,0
1713524201227,AIP 197,001,627712,Vespa; Emanuel Ignacio,9999,0,9999,0
1713524202259,ANAR 135S,A00,494369,Braswell; Geoffrey E.,0,0,0,0
1713524203304,CAT 124RS,A01,519847,Geibel; William,6,0,20,14
1713524204330,CAT 125RS,A01,515971,Geibel; William,6,0,20,14
1713524205356,CLRE 250,A00,511389,Morris; Sheldon,9996,0,9999,3
1713524206384,CLRE 251,A00,507176,Mehta; Ravindra L.,9996,0,9999,3
1713524206384,CLRE 251,B00,511410,Mehta; Ravindra L.,9998,0,9999,1
1713524207415,CLRE 252,A00,507189,Cuomo; Raphael Eduardo,9998,0,9999,1
1713524208441,CLRE 253,A00,507199,Vaida; Florin,9997,0,9999,2
1713524208441,CLRE 253,B00,507202,Vaida; Florin,9999,0,9999,0
1713524209468,CLRE 259,A00,507211,Patel; Hemal,9996,0,9999,3
1713524210492,CLRE 260,A00,507221,Cuomo; Raphael Eduardo,9999,0,9999,0
1713524211518,CLRE 297,001,507242,Cuomo; Raphael Eduardo,9999,0,9999,0
1713524212555,CSE 191,A00,516875,Minnes Kemp; Mor Mia,9999,0,9999,0
1713524213586,CSS 201S,A01,494383,Staff,35,0,35,0
1713524214611,CSS 202S,A01,494387,Staff,35,0,35,0
1713524215641,EAP 100,A00,516065,Staff,9792,0,9999,207
1713524216668,ECE 45,A01,507414,Staff,37,0,60,23
1713524217701,ECE 100,A01,507416,Baghdadchi; Saharnaz,0,0,20,20
1713524217701,ECE 100,A02,507418,Baghdadchi; Saharnaz,19,0,20,1
1713524218730,ECE 111,A01,507420,Staff,27,0,50,23
1713524219757,ECE 197,001,548057,Sievenpiper; Daniel F.,9998,0,9999,1
1713524220788,EDS 115,A00,507243,Choi; Bailey Miyeon,27,0,28,1
1713524221860,EDS 117,A01,494379,Staff,14,0,25,11
1713524222892,EDS 125,A00,507246,Hopkins; Megan Beth,27,0,30,3
1713524223923,EDS 128A,A01,507264,Fargason; Sharon Gayle,26,0,26,0
1713524224949,EDS 128B,A01,507293,Pappas; Elizabeth,30,0,30,0
1713524225975,EDS 139,A00,507294,Fargason; Sharon Gayle,30,0,30,0
1713524225975,EDS 139,B00,507313,Pappas; Elizabeth,30,0,30,0
1713524227004,EDS 201,A00,507315,Staff,18,0,30,12
1713524228032,EDS 203,A01,507317,Halter; Christopher P.,17,0,30,13
1713524229064,EDS 204R,A01,507319,Halter; Christopher P.,0,1,30,30
1713524229064,EDS 204R,B01,507331,Heinzman; Erica M.,22,0,30,8
1713524230093,EDS 206R,A00,507332,Staff,0,2,30,30
1713524230093,EDS 206R,B00,507343,Staff,23,0,30,7
1713524231119,EDS 250,A00,507344,Hemans; Patricia Ann Benitez,27,0,40,13
1713524232149,EDS 281,A00,507345,Daly; Alan J.,18,0,18,0
1713524233179,EDS 284,A00,507350,Daly; Alan J.,16,0,16,0
1713524234203,EDS 286,A00,507359,Fine; Sarah,18,0,18,0
1713524235234,EDS 289C,A01,507361,Daly; Alan J.,18,0,18,0
1713524236263,EDS 290,A00,507366,Hofstetter; Carolyn,15,0,15,0
1713524237290,LIGM 5A,A00,507421,Fischer-Grunski; Eva K,20,0,20,0
1713524238317,LIGM 5B,A00,507423,Fischer-Grunski; Eva K,20,0,20,0
1713524239342,LIGM 5C,A00,507425,Fischer-Grunski; Eva K,20,0,20,0
1713524240368,LIIT 5AS,A00,507427,Carnelos; Chiara,20,0,20,0
1713524241399,LIIT 5BS,A00,507430,Carnelos; Chiara,20,0,20,0
1713524242424,LIIT 5CS,A00,507432,Carnelos; Chiara,20,0,20,0
1713524243450,LISP 5A,A00,507541,Munoz Sanchez; Alicia,14,0,20,6
1713524244478,LISP 5B,A00,507671,Munoz Sanchez; Alicia,12,0,20,8
1713524245505,LISP 5C,A00,507696,Munoz Sanchez; Alicia,11,0,20,9
1713524246531,MAE 197,001,528363,Boechler; Nicholas Sebastia,9998,0,9999,1
1713524247558,MATH 197,001,523477,Kedlaya; Kiran S.,9999,0,9999,0
1713524247558,MATH 197,002,563811,Zhang; Danna,9998,0,9999,1
1713524248586,MCWP 40R,A00,518780,Staff,13,0,20,7
1713524248586,MCWP 40R,B00,518781,Staff,11,0,20,9
1713524248586,MCWP 40R,C00,518783,Staff,8,0,20,12
1713524249613,MCWP 50R,A00,518791,Staff,7,0,20,13
1713524249613,MCWP 50R,B00,518792,Staff,3,0,20,17
1713524249613,MCWP 50R,C00,518793,Staff,5,0,20,15
1713524249613,MCWP 50R,D00,518794,Staff,0,0,20,20
1713524249613,MCWP 50R,E00,518795,Staff,0,0,20,20
1713524249613,MCWP 50R,F00,518796,Staff,10,0,20,10
1713524249613,MCWP 50R,G00,518797,Staff,10,0,20,10
1713524250642,MMW 12R,A01,514034,Herbst; Matthew,1,0,16,15
1713524250642,MMW 12R,A02,514035,Herbst; Matthew,13,0,16,3
1713524251668,MMW 13R,A01,514037,Staff,0,8,16,16
1713524251668,MMW 13R,A02,514039,Staff,0,7,16,16
1713524253726,SIO 295LS,A00,523233,Staff,15,0,30,15
1713524254751,SIO 295S,A00,523232,Staff,15,0,30,15
1713524255778,SOCI 117,A01,494376,Staff,0,2,5,5
1713524256808,WES 237B,A00,494380,Staff,19,0,20,1
1713524258891,AESE 279B,A00,494370,Wade; Jon P,33,0,33,0
1713524259917,AIP 197,001,627712,Vespa; Emanuel Ignacio,9999,0,9999,0
1713524260944,ANAR 135S,A00,494369,Braswell; Geoffrey E.,0,0,0,0
1713524261974,CAT 124RS,A01,519847,Geibel; William,6,0,20,14
1713524263002,CAT 125RS,A01,515971,Geibel; William,6,0,20,14
1713524264027,CLRE 250,A00,511389,Morris; Sheldon,9996,0,9999,3
1713524265055,CLRE 251,A00,507176,Mehta; Ravindra L.,9996,0,9999,3
1713524265055,CLRE 251,B00,511410,Mehta; Ravindra L.,9998,0,9999,1
1713524266086,CLRE 252,A00,507189,Cuomo; Raphael Eduardo,9998,0,9999,1
1713524267113,CLRE 253,A00,507199,Vaida; Florin,9997,0,9999,2
1713524267113,CLRE 253,B00,507202,Vaida; Florin,9999,0,9999,0
1713524268143,CLRE 259,A00,507211,Patel; Hemal,9996,0,9999,3
1713524269174,CLRE 260,A00,507221,Cuomo; Raphael Eduardo,9999,0,9999,0
1713524270200,CLRE 297,001,507242,Cuomo; Raphael Eduardo,9999,0,9999,0
1713524271227,CSE 191,A00,516875,Minnes Kemp; Mor Mia,9999,0,9999,0
1713524272254,CSS 201S,A01,494383,Staff,35,0,35,0
1713524273279,CSS 202S,A01,494387,Staff,35,0,35,0
1713524274305,EAP 100,A00,516065,Staff,9792,0,9999,207
1713524275335,ECE 45,A01,507414,Staff,37,0,60,23
1713524276376,ECE 100,A01,507416,Baghdadchi; Saharnaz,0,0,20,20
1713524276376,ECE 100,A02,507418,Baghdadchi; Saharnaz,19,0,20,1
1713524277404,ECE 111,A01,507420,Staff,27,0,50,23
1713524278436,ECE 197,001,548057,Sievenpiper; Daniel F.,9998,0,9999,1
1713524279469,EDS 115,A00,507243,Choi; Bailey Miyeon,27,0,28,1
1713524280501,EDS 117,A01,494379,Staff,14,0,25,11
1713524281531,EDS 125,A00,507246,Hopkins; Megan Beth,27,0,30,3
1713524282562,EDS 128A,A01,507264,Fargason; Sharon Gayle,26,0,26,0
1713524283593,EDS 128B,A01,507293,Pappas; Elizabeth,30,0,30,0
1713524284618,EDS 139,A00,507294,Fargason; Sharon Gayle,30,0,30,0
1713524284618,EDS 139,B00,507313,Pappas; Elizabeth,30,0,30,0
1713524285644,EDS 201,A00,507315,Staff,18,0,30,12
1713524286685,EDS 203,A01,507317,Halter; Christopher P.,17,0,30,13
1713524287715,EDS 204R,A01,507319,Halter; Christopher P.,0,1,30,30
1713524287715,EDS 204R,B01,507331,Heinzman; Erica M.,22,0,30,8
1713524288745,EDS 206R,A00,507332,Staff,0,2,30,30
1713524288745,EDS 206R,B00,507343,Staff,23,0,30,7
1713524289775,EDS 250,A00,507344,Hemans; Patricia Ann Benitez,27,0,40,13
1713524290803,EDS 281,A00,507345,Daly; Alan J.,18,0,18,0
1713524291833,EDS 284,A00,507350,Daly; Alan J.,16,0,16,0
1713524292859,EDS 286,A00,507359,Fine; Sarah,18,0,18,0
1713524293961,EDS 289C,A01,507361,Daly; Alan J.,18,0,18,0
1713524294988,EDS 290,A00,507366,Hofstetter; Carolyn,15,0,15,0
1713524296018,LIGM 5A,A00,507421,Fischer-Grunski; Eva K,20,0,20,0
1713524297045,LIGM 5B,A00,507423,Fischer-Grunski; Eva K,20,0,20,0
1713524298075,LIGM 5C,A00,507425,Fischer-Grunski; Eva K,20,0,20,0
1713524299105,LIIT 5AS,A00,507427,Carnelos; Chiara,20,0,20,0
1713524300130,LIIT 5BS,A00,507430,Carnelos; Chiara,20,0,20,0
1713524301156,LIIT 5CS,A00,507432,Carnelos; Chiara,20,0,20,0
1713524302186,LISP 5A,A00,507541,Munoz Sanchez; Alicia,14,0,20,6
1713524303213,LISP 5B,A00,507671,Munoz Sanchez; Alicia,12,0,20,8
1713524304239,LISP 5C,A00,507696,Munoz Sanchez; Alicia,11,0,20,9
1713524305267,MAE 197,001,528363,Boechler; Nicholas Sebastia,9998,0,9999,1
1713524306297,MATH 197,001,523477,Kedlaya; Kiran S.,9999,0,9999,0
1713524306297,MATH 197,002,563811,Zhang; Danna,9998,0,9999,1
1713524307325,MCWP 40R,A00,518780,Staff,13,0,20,7
1713524307325,MCWP 40R,B00,518781,Staff,11,0,20,9
1713524307325,MCWP 40R,C00,518783,Staff,8,0,20,12
1713524308356,MCWP 50R,A00,518791,Staff,7,0,20,13
1713524308356,MCWP 50R,B00,518792,Staff,3,0,20,17
1713524308356,MCWP 50R,C00,518793,Staff,5,0,20,15
1713524308356,MCWP 50R,D00,518794,Staff,0,0,20,20
1713524308356,MCWP 50R,E00,518795,Staff,0,0,20,20
1713524308356,MCWP 50R,F00,518796,Staff,10,0,20,10
1713524308356,MCWP 50R,G00,518797,Staff,10,0,20,10
1713524309385,MMW 12R,A01,514034,Herbst; Matthew,1,0,16,15
1713524309385,MMW 12R,A02,514035,Herbst; Matthew,13,0,16,3
1713524310411,MMW 13R,A01,514037,Staff,0,8,16,16
1713524310411,MMW 13R,A02,514039,Staff,0,7,16,16
1713524312467,SIO 295LS,A00,523233,Staff,15,0,30,15
1713524313492,SIO 295S,A00,523232,Staff,15,0,30,15
1713524314518,SOCI 117,A01,494376,Staff,0,2,5,5
1713524315547,WES 237B,A00,494380,Staff,19,0,20,1
1713524317605,AESE 279B,A00,494370,Wade; Jon P,33,0,33,0
1713524318634,AIP 197,001,627712,Vespa; Emanuel Ignacio,9999,0,9999,0
1713524319666,ANAR 135S,A00,494369,Braswell; Geoffrey E.,0,0,0,0
1713524320691,CAT 124RS,A01,519847,Geibel; William,6,0,20,14
1713524321721,CAT 125RS,A01,515971,Geibel; William,6,0,20,14
1713524322748,CLRE 250,A00,511389,Morris; Sheldon,9996,0,9999,3
1713524323774,CLRE 251,A00,507176,Mehta; Ravindra L.,9996,0,9999,3
1713524323774,CLRE 251,B00,511410,Mehta; Ravindra L.,9998,0,9999,1
1713524324800,CLRE 252,A00,507189,Cuomo; Raphael Eduardo,9998,0,9999,1
1713524325826,CLRE 253,A00,507199,Vaida; Florin,9997,0,9999,2
1713524325826,CLRE 253,B00,507202,Vaida; Florin,9999,0,9999,0
1713524326852,CLRE 259,A00,507211,Patel; Hemal,9996,0,9999,3
1713524327881,CLRE 260,A00,507221,Cuomo; Raphael Eduardo,9999,0,9999,0
1713524328911,CLRE 297,001,507242,Cuomo; Raphael Eduardo,9999,0,9999,0
1713524329936,CSE 191,A00,516875,Minnes Kemp; Mor Mia,9999,0,9999,0
1713524330966,CSS 201S,A01,494383,Staff,35,0,35,0
1713524331991,CSS 202S,A01,494387,Staff,35,0,35,0
1713524333020,EAP 100,A00,516065,Staff,9792,0,9999,207
1713524334049,ECE 45,A01,507414,Staff,37,0,60,23
1713524335081,ECE 100,A01,507416,Baghdadchi; Saharnaz,0,0,20,20
1713524335081,ECE 100,A02,507418,Baghdadchi; Saharnaz,19,0,20,1
1713524336113,ECE 111,A01,507420,Staff,27,0,50,23
1713524337139,ECE 197,001,548057,Sievenpiper; Daniel F.,9998,0,9999,1
1713524338165,EDS 115,A00,507243,Choi; Bailey Miyeon,27,0,28,1
1713524339194,EDS 117,A01,494379,Staff,14,0,25,11
1713524340224,EDS 125,A00,507246,Hopkins; Megan Beth,27,0,30,3
1713524341253,EDS 128A,A01,507264,Fargason; Sharon Gayle,26,0,26,0
1713524342279,EDS 128B,A01,507293,Pappas; Elizabeth,30,0,30,0
1713524343305,EDS 139,A00,507294,Fargason; Sharon Gayle,30,0,30,0
1713524343305,EDS 139,B00,507313,Pappas; Elizabeth,30,0,30,0
1713524344334,EDS 201,A00,507315,Staff,18,0,30,12
1713524345362,EDS 203,A01,507317,Halter; Christopher P.,17,0,30,13
1713524346392,EDS 204R,A01,507319,Halter; Christopher P.,0,1,30,30
1713524346392,EDS 204R,B01,507331,Heinzman; Erica M.,22,0,30,8
1713524347419,EDS 206R,A00,507332,Staff,0,2,30,30
1713524347419,EDS 206R,B00,507343,Staff,23,0,30,7
1713524348445,EDS 250,A00,507344,Hemans; Patricia Ann Benitez,27,0,40,13
1713524349470,EDS 281,A00,507345,Daly; Alan J.,18,0,18,0
1713524350495,EDS 284,A00,507350,Daly; Alan J.,16,0,16,0
1713524351521,EDS 286,A00,507359,Fine; Sarah,18,0,18,0
1713524352547,EDS 289C,A01,507361,Daly; Alan J.,18,0,18,0
1713524353580,EDS 290,A00,507366,Hofstetter; Carolyn,15,0,15,0
1713524354613,LIGM 5A,A00,507421,Fischer-Grunski; Eva K,20,0,20,0
1713524355644,LIGM 5B,A00,507423,Fischer-Grunski; Eva K,20,0,20,0
1713524356672,LIGM 5C,A00,507425,Fischer-Grunski; Eva K,20,0,20,0
1713524357699,LIIT 5AS,A00,507427,Carnelos; Chiara,20,0,20,0
1713524358725,LIIT 5BS,A00,507430,Carnelos; Chiara,20,0,20,0
1713524359750,LIIT 5CS,A00,507432,Carnelos; Chiara,20,0,20,0
1713524360784,LISP 5A,A00,507541,Munoz Sanchez; Alicia,14,0,20,6
1713524361810,LISP 5B,A00,507671,Munoz Sanchez; Alicia,12,0,20,8
1713524362837,LISP 5C,A00,507696,Munoz Sanchez; Alicia,11,0,20,9
1713524363875,MAE 197,001,528363,Boechler; Nicholas Sebastia,9998,0,9999,1
1713524364912,MATH 197,001,523477,Kedlaya; Kiran S.,9999,0,9999,0
1713524364912,MATH 197,002,563811,Zhang; Danna,9998,0,9999,1
1713524365939,MCWP 40R,A00,518780,Staff,13,0,20,7
1713524365939,MCWP 40R,B00,518781,Staff,11,0,20,9
1713524365939,MCWP 40R,C00,518783,Staff,8,0,20,12
1713524366966,MCWP 50R,A00,518791,Staff,7,0,20,13
1713524366966,MCWP 50R,B00,518792,Staff,3,0,20,17
1713524366966,MCWP 50R,C00,518793,Staff,5,0,20,15
1713524366966,MCWP 50R,D00,518794,Staff,0,0,20,20
1713524366966,MCWP 50R,E00,518795,Staff,0,0,20,20
1713524366966,MCWP 50R,F00,518796,Staff,10,0,20,10
1713524366966,MCWP 50R,G00,518797,Staff,10,0,20,10
1713524367997,MMW 12R,A01,514034,Herbst; Matthew,1,0,16,15
1713524367997,MMW 12R,A02,514035,Herbst; Matthew,13,0,16,3
1713524369022,MMW 13R,A01,514037,Staff,0,8,16,16
1713524369022,MMW 13R,A02,514039,Staff,0,7,16,16
1713524371080,SIO 295LS,A00,523233,Staff,15,0,30,15
1713524372105,SIO 295S,A00,523232,Staff,15,0,30,15
1713524373134,SOCI 117,A01,494376,Staff,0,2,5,5
1713524374161,WES 237B,A00,494380,Staff,19,0,20,1
1713524376237,AESE 279B,A00,494370,Wade; Jon P,33,0,33,0
1713524377266,AIP 197,001,627712,Vespa; Emanuel Ignacio,9999,0,9999,0
1713524378294,ANAR 135S,A00,494369,Braswell; Geoffrey E.,0,0,0,0
1713524379320,CAT 124RS,A01,519847,Geibel; William,6,0,20,14
1713524380349,CAT 125RS,A01,515971,Geibel; William,6,0,20,14
1713524381383,CLRE 250,A00,511389,Morris; Sheldon,9996,0,9999,3
1713524382411,CLRE 251,A00,507176,Mehta; Ravindra L.,9996,0,9999,3
1713524382411,CLRE 251,B00,511410,Mehta; Ravindra L.,9998,0,9999,1
1713524383439,CLRE 252,A00,507189,Cuomo; Raphael Eduardo,9998,0,9999,1
1713524384477,CLRE 253,A00,507199,Vaida; Florin,9997,0,9999,2
1713524384477,CLRE 253,B00,507202,Vaida; Florin,9999,0,9999,0
1713524385506,CLRE 259,A00,507211,Patel; Hemal,9996,0,9999,3
1713524386532,CLRE 260,A00,507221,Cuomo; Raphael Eduardo,9999,0,9999,0
1713524387558,CLRE 297,001,507242,Cuomo; Raphael Eduardo,9999,0,9999,0
1713524388587,CSE 191,A00,516875,Minnes Kemp; Mor Mia,9999,0,9999,0
1713524389617,CSS 201S,A01,494383,Staff,35,0,35,0
1713524390649,CSS 202S,A01,494387,Staff,35,0,35,0
1713524391675,EAP 100,A00,516065,Staff,9792,0,9999,207
1713524392700,ECE 45,A01,507414,Staff,37,0,60,23
1713524393733,ECE 100,A01,507416,Baghdadchi; Saharnaz,0,0,20,20
1713524393733,ECE 100,A02,507418,Baghdadchi; Saharnaz,19,0,20,1
1713524394759,ECE 111,A01,507420,Staff,27,0,50,23
1713524395792,ECE 197,001,548057,Sievenpiper; Daniel F.,9998,0,9999,1
1713524396818,EDS 115,A00,507243,Choi; Bailey Miyeon,27,0,28,1
1713524397902,EDS 117,A01,494379,Staff,14,0,25,11
1713524398930,EDS 125,A00,507246,Hopkins; Megan Beth,27,0,30,3
1713524399955,EDS 128A,A01,507264,Fargason; Sharon Gayle,26,0,26,0
1713524400981,EDS 128B,A01,507293,Pappas; Elizabeth,30,0,30,0
1713524402009,EDS 139,A00,507294,Fargason; Sharon Gayle,30,0,30,0
1713524402009,EDS 139,B00,507313,Pappas; Elizabeth,30,0,30,0
1713524403035,EDS 201,A00,507315,Staff,18,0,30,12
1713524404066,EDS 203,A01,507317,Halter; Christopher P.,17,0,30,13
1713524405095,EDS 204R,A01,507319,Halter; Christopher P.,0,1,30,30
1713524405095,EDS 204R,B01,507331,Heinzman; Erica M.,22,0,30,8
1713524406121,EDS 206R,A00,507332,Staff,0,2,30,30
1713524406121,EDS 206R,B00,507343,Staff,23,0,30,7
1713524407152,EDS 250,A00,507344,Hemans; Patricia Ann Benitez,27,0,40,13
1713524408179,EDS 281,A00,507345,Daly; Alan J.,18,0,18,0
1713524409207,EDS 284,A00,507350,Daly; Alan J.,16,0,16,0
1713524410236,EDS 286,A00,507359,Fine; Sarah,18,0,18,0
1713524411263,EDS 289C,A01,507361,Daly; Alan J.,18,0,18,0
1713524412287,EDS 290,A00,507366,Hofstetter; Carolyn,15,0,15,0
1713524413315,LIGM 5A,A00,507421,Fischer-Grunski; Eva K,20,0,20,0
1713524414341,LIGM 5B,A00,507423,Fischer-Grunski; Eva K,20,0,20,0
1713524415374,LIGM 5C,A00,507425,Fischer-Grunski; Eva K,20,0,20,0
1713524416401,LIIT 5AS,A00,507427,Carnelos; Chiara,20,0,20,0
1713524417434,LIIT 5BS,A00,507430,Carnelos; Chiara,20,0,20,0
1713524418460,LIIT 5CS,A00,507432,Carnelos; Chiara,20,0,20,0
1713524419490,LISP 5A,A00,507541,Munoz Sanchez; Alicia,14,0,20,6
1713524420518,LISP 5B,A00,507671,Munoz Sanchez; Alicia,12,0,20,8
1713524421544,LISP 5C,A00,507696,Munoz Sanchez; Alicia,11,0,20,9
1713524422571,MAE 197,001,528363,Boechler; Nicholas Sebastia,9998,0,9999,1
1713524423605,MATH 197,001,523477,Kedlaya; Kiran S.,9999,0,9999,0
1713524423605,MATH 197,002,563811,Zhang; Danna,9998,0,9999,1
1713524424638,MCWP 40R,A00,518780,Staff,13,0,20,7
1713524424638,MCWP 40R,B00,518781,Staff,11,0,20,9
1713524424638,MCWP 40R,C00,518783,Staff,8,0,20,12
1713524425669,MCWP 50R,A00,518791,Staff,7,0,20,13
1713524425669,MCWP 50R,B00,518792,Staff,3,0,20,17
1713524425669,MCWP 50R,C00,518793,Staff,5,0,20,15
1713524425669,MCWP 50R,D00,518794,Staff,0,0,20,20
1713524425669,MCWP 50R,E00,518795,Staff,0,0,20,20
1713524425669,MCWP 50R,F00,518796,Staff,10,0,20,10
1713524425669,MCWP 50R,G00,518797,Staff,10,0,20,10
1713524426695,MMW 12R,A01,514034,Herbst; Matthew,1,0,16,15
1713524426695,MMW 12R,A02,514035,Herbst; Matthew,13,0,16,3
1713524427725,MMW 13R,A01,514037,Staff,0,8,16,16
1713524427725,MMW 13R,A02,514039,Staff,0,7,16,16
1713524429782,SIO 295LS,A00,523233,Staff,15,0,30,15
1713524430806,SIO 295S,A00,523232,Staff,15,0,30,15
1713524431838,SOCI 117,A01,494376,Staff,0,2,5,5
1713524432864,WES 237B,A00,494380,Staff,19,0,20,1
1713524434941,AESE 279B,A00,494370,Wade; Jon P,33,0,33,0
1713524435970,AIP 197,001,627712,Vespa; Emanuel Ignacio,9999,0,9999,0
1713524437000,ANAR 135S,A00,494369,Braswell; Geoffrey E.,0,0,0,0
1713524438028,CAT 124RS,A01,519847,Geibel; William,6,0,20,14
1713524439053,CAT 125RS,A01,515971,Geibel; William,6,0,20,14
1713524440080,CLRE 250,A00,511389,Morris; Sheldon,9996,0,9999,3
1713524441117,CLRE 251,A00,507176,Mehta; Ravindra L.,9996,0,9999,3
1713524441117,CLRE 251,B00,511410,Mehta; Ravindra L.,9998,0,9999,1
1713524442144,CLRE 252,A00,507189,Cuomo; Raphael Eduardo,9998,0,9999,1
1713524443170,CLRE 253,A00,507199,Vaida; Florin,9997,0,9999,2
1713524443170,CLRE 253,B00,507202,Vaida; Florin,9999,0,9999,0
1713524444198,CLRE 259,A00,507211,Patel; Hemal,9996,0,9999,3
1713524445227,CLRE 260,A00,507221,Cuomo; Raphael Eduardo,9999,0,9999,0
1713524446255,CLRE 297,001,507242,Cuomo; Raphael Eduardo,9999,0,9999,0
1713524447282,CSE 191,A00,516875,Minnes Kemp; Mor Mia,9999,0,9999,0
1713524448310,CSS 201S,A01,494383,Staff,35,0,35,0
1713524449339,CSS 202S,A01,494387,Staff,35,0,35,0
1713524450365,EAP 100,A00,516065,Staff,9792,0,9999,207
1713524451393,ECE 45,A01,507414,Staff,37,0,60,23
1713524452419,ECE 100,A01,507416,Baghdadchi; Saharnaz,0,0,20,20
1713524452419,ECE 100,A02,507418,Baghdadchi; Saharnaz,19,0,20,1
1713524453445,ECE 111,A01,507420,Staff,27,0,50,23
1713524454477,ECE 197,001,548057,Sievenpiper; Daniel F.,9998,0,9999,1
1713524455504,EDS 115,A00,507243,Choi; Bailey Miyeon,27,0,28,1
1713524456531,EDS 117,A01,494379,Staff,14,0,25,11
1713524457562,EDS 125,A00,507246,Hopkins; Megan Beth,27,0,30,3
1713524458594,EDS 128A,A01,507264,Fargason; Sharon Gayle,26,0,26,0
1713524459624,EDS 128B,A01,507293,Pappas; Elizabeth,30,0,30,0
1713524460663,EDS 139,A00,507294,Fargason; Sharon Gayle,30,0,30,0
1713524460663,EDS 139,B00,507313,Pappas; Elizabeth,30,0,30,0
1713524461691,EDS 201,A00,507315,Staff,18,0,30,12
1713524462716,EDS 203,A01,507317,Halter; Christopher P.,17,0,30,13
1713524463742,EDS 204R,A01,507319,Halter; Christopher P.,0,1,30,30
1713524463742,EDS 204R,B01,507331,Heinzman; Erica M.,22,0,30,8
1713524464766,EDS 206R,A00,507332,Staff,0,2,30,30
1713524464766,EDS 206R,B00,507343,Staff,23,0,30,7
1713524465792,EDS 250,A00,507344,Hemans; Patricia Ann Benitez,27,0,40,13
1713524466823,EDS 281,A00,507345,Daly; Alan J.,18,0,18,0
1713524467852,EDS 284,A00,507350,Daly; Alan J.,16,0,16,0
1713524468877,EDS 286,A00,507359,Fine; Sarah,18,0,18,0
1713524469902,EDS 289C,A01,507361,Daly; Alan J.,18,0,18,0
1713524470926,EDS 290,A00,507366,Hofstetter; Carolyn,15,0,15,0
1713524471958,LIGM 5A,A00,507421,Fischer-Grunski; Eva K,20,0,20,0
1713524472984,LIGM 5B,A00,507423,Fischer-Grunski; Eva K,20,0,20,0
1713524474011,LIGM 5C,A00,507425,Fischer-Grunski; Eva K,20,0,20,0
1713524475040,LIIT 5AS,A00,507427,Carnelos; Chiara,20,0,20,0
1713524476065,LIIT 5BS,A00,507430,Carnelos; Chiara,20,0,20,0
1713524477091,LIIT 5CS,A00,507432,Carnelos; Chiara,20,0,20,0
1713524478123,LISP 5A,A00,507541,Munoz Sanchez; Alicia,14,0,20,6
1713524479152,LISP 5B,A00,507671,Munoz Sanchez; Alicia,12,0,20,8
1713524480185,LISP 5C,A00,507696,Munoz Sanchez; Alicia,11,0,20,9
1713524481210,MAE 197,001,528363,Boechler; Nicholas Sebastia,9998,0,9999,1
1713524482236,MATH 197,001,523477,Kedlaya; Kiran S.,9999,0,9999,0
1713524482236,MATH 197,002,563811,Zhang; Danna,9998,0,9999,1
1713524483263,MCWP 40R,A00,518780,Staff,13,0,20,7
1713524483263,MCWP 40R,B00,518781,Staff,11,0,20,9
1713524483263,MCWP 40R,C00,518783,Staff,8,0,20,12
1713524484290,MCWP 50R,A00,518791,Staff,7,0,20,13
1713524484290,MCWP 50R,B00,518792,Staff,3,0,20,17
1713524484290,MCWP 50R,C00,518793,Staff,5,0,20,15
1713524484290,MCWP 50R,D00,518794,Staff,0,0,20,20
1713524484290,MCWP 50R,E00,518795,Staff,0,0,20,20
1713524484290,MCWP 50R,F00,518796,Staff,10,0,20,10
1713524484290,MCWP 50R,G00,518797,Staff,10,0,20,10
1713524485316,MMW 12R,A01,514034,Herbst; Matthew,1,0,16,15
1713524485316,MMW 12R,A02,514035,Herbst; Matthew,13,0,16,3
1713524486341,MMW 13R,A01,514037,Staff,0,8,16,16
1713524486341,MMW 13R,A02,514039,Staff,0,7,16,16
1713524488401,SIO 295LS,A00,523233,Staff,15,0,30,15
1713524489427,SIO 295S,A00,523232,Staff,15,0,30,15
1713524490456,SOCI 117,A01,494376,Staff,0,2,5,5
1713524491481,WES 237B,A00,494380,Staff,19,0,20,1
1713524493556,AESE 279B,A00,494370,Wade; Jon P,33,0,33,0
1713524494586,AIP 197,001,627712,Vespa; Emanuel Ignacio,9999,0,9999,0
1713524495613,ANAR 135S,A00,494369,Braswell; Geoffrey E.,0,0,0,0
1713524496639,CAT 124RS,A01,519847,Geibel; William,6,0,20,14
1713524497663,CAT 125RS,A01,515971,Geibel; William,6,0,20,14
1713524498689,CLRE 250,A00,511389,Morris; Sheldon,9996,0,9999,3
1713524499718,CLRE 251,A00,507176,Mehta; Ravindra L.,9996,0,9999,3
1713524499718,CLRE 251,B00,511410,Mehta; Ravindra L.,9998,0,9999,1
1713524500750,CLRE 252,A00,507189,Cuomo; Raphael Eduardo,9998,0,9999,1
1713524501852,CLRE 253,A00,507199,Vaida; Florin,9997,0,9999,2
1713524501852,CLRE 253,B00,507202,Vaida; Florin,9999,0,9999,0
1713524502881,CLRE 259,A00,507211,Patel; Hemal,9996,0,9999,3
1713524503905,CLRE 260,A00,507221,Cuomo; Raphael Eduardo,9999,0,9999,0
1713524504931,CLRE 297,001,507242,Cuomo; Raphael Eduardo,9999,0,9999,0
1713524505964,CSE 191,A00,516875,Minnes Kemp; Mor Mia,9999,0,9999,0
1713524506997,CSS 201S,A01,494383,Staff,35,0,35,0
1713524508025,CSS 202S,A01,494387,Staff,35,0,35,0
1713524509050,EAP 100,A00,516065,Staff,9792,0,9999,207
1713524510083,ECE 45,A01,507414,Staff,37,0,60,23
1713524511113,ECE 100,A01,507416,Baghdadchi; Saharnaz,0,0,20,20
1713524511113,ECE 100,A02,507418,Baghdadchi; Saharnaz,19,0,20,1
1713524512139,ECE 111,A01,507420,Staff,27,0,50,23
1713524513165,ECE 197,001,548057,Sievenpiper; Daniel F.,9998,0,9999,1
1713524514195,EDS 115,A00,507243,Choi; Bailey Miyeon,27,0,28,1
1713524515221,EDS 117,A01,494379,Staff,14,0,25,11
1713524516252,EDS 125,A00,507246,Hopkins; Megan Beth,27,0,30,3
1713524517281,EDS 128A,A01,507264,Fargason; Sharon Gayle,26,0,26,0
1713524518307,EDS 128B,A01,507293,Pappas; Elizabeth,30,0,30,0
1713524519333,EDS 139,A00,507294,Fargason; Sharon Gayle,30,0,30,0
1713524519333,EDS 139,B00,507313,Pappas; Elizabeth,30,0,30,0
1713524520358,EDS 201,A00,507315,Staff,18,0,30,12
1713524521390,EDS 203,A01,507317,Halter; Christopher P.,17,0,30,13
1713524522419,EDS 204R,A01,507319,Halter; Christopher P.,0,1,30,30
1713524522419,EDS 204R,B01,507331,Heinzman; Erica M.,22,0,30,8
1713524523446,EDS 206R,A00,507332,Staff,0,2,30,30
1713524523446,EDS 206R,B00,507343,Staff,23,0,30,7
1713524524475,EDS 250,A00,507344,Hemans; Patricia Ann Benitez,27,0,40,13
1713524525503,EDS 281,A00,507345,Daly; Alan J.,18,0,18,0
1713524526530,EDS 284,A00,507350,Daly; Alan J.,16,0,16,0
1713524527558,EDS 286,A00,507359,Fine; Sarah,18,0,18,0
1713524528586,EDS 289C,A01,507361,Daly; Alan J.,18,0,18,0
1713524529617,EDS 290,A00,507366,Hofstetter; Carolyn,15,0,15,0
1713524530645,LIGM 5A,A00,507421,Fischer-Grunski; Eva K,20,0,20,0
1713524531675,LIGM 5B,A00,507423,Fischer-Grunski; Eva K,20,0,20,0
1713524532705,LIGM 5C,A00,507425,Fischer-Grunski; Eva K,20,0,20,0
1713524533732,LIIT 5AS,A00,507427,Carnelos; Chiara,20,0,20,0
1713524534762,LIIT 5BS,A00,507430,Carnelos; Chiara,20,0,20,0
1713524535792,LIIT 5CS,A00,507432,Carnelos; Chiara,20,0,20,0
1713524536823,LISP 5A,A00,507541,Munoz Sanchez; Alicia,14,0,20,6
1713524537848,LISP 5B,A00,507671,Munoz Sanchez; Alicia,12,0,20,8
1713524538875,LISP 5C,A00,507696,Munoz Sanchez; Alicia,11,0,20,9
1713524539901,MAE 197,001,528363,Boechler; Nicholas Sebastia,9998,0,9999,1
1713524540930,MATH 197,001,523477,Kedlaya; Kiran S.,9999,0,9999,0
1713524540930,MATH 197,002,563811,Zhang; Danna,9998,0,9999,1
1713524541957,MCWP 40R,A00,518780,Staff,13,0,20,7
1713524541957,MCWP 40R,B00,518781,Staff,11,0,20,9
1713524541957,MCWP 40R,C00,518783,Staff,8,0,20,12
1713524542991,MCWP 50R,A00,518791,Staff,7,0,20,13
1713524542991,MCWP 50R,B00,518792,Staff,3,0,20,17
1713524542991,MCWP 50R,C00,518793,Staff,5,0,20,15
1713524542991,MCWP 50R,D00,518794,Staff,0,0,20,20
1713524542991,MCWP 50R,E00,518795,Staff,0,0,20,20
1713524542991,MCWP 50R,F00,518796,Staff,10,0,20,10
1713524542991,MCWP 50R,G00,518797,Staff,10,0,20,10
1713524544019,MMW 12R,A01,514034,Herbst; Matthew,1,0,16,15
1713524544019,MMW 12R,A02,514035,Herbst; Matthew,13,0,16,3
1713524545049,MMW 13R,A01,514037,Staff,0,8,16,16
1713524545049,MMW 13R,A02,514039,Staff,0,7,16,16
1713524547104,SIO 295LS,A00,523233,Staff,15,0,30,15
1713524548132,SIO 295S,A00,523232,Staff,15,0,30,15
1713524549161,SOCI 117,A01,494376,Staff,0,2,5,5
1713524550190,WES 237B,A00,494380,Staff,19,0,20,1
1713524552270,AESE 279B,A00,494370,Wade; Jon P,33,0,33,0
1713524553301,AIP 197,001,627712,Vespa; Emanuel Ignacio,9999,0,9999,0
1713524554331,ANAR 135S,A00,494369,Braswell; Geoffrey E.,0,0,0,0
1713524555356,CAT 124RS,A01,519847,Geibel; William,6,0,20,14
1713524556381,CAT 125RS,A01,515971,Geibel; William,6,0,20,14
1713524557410,CLRE 250,A00,511389,Morris; Sheldon,9996,0,9999,3
1713524558439,CLRE 251,A00,507176,Mehta; Ravindra L.,9996,0,9999,3
1713524558439,CLRE 251,B00,511410,Mehta; Ravindra L.,9998,0,9999,1
1713524559469,CLRE 252,A00,507189,Cuomo; Raphael Eduardo,9998,0,9999,1
1713524560493,CLRE 253,A00,507199,Vaida; Florin,9997,0,9999,2
1713524560493,CLRE 253,B00,507202,Vaida; Florin,9999,0,9999,0
1713524561522,CLRE 259,A00,507211,Patel; Hemal,9996,0,9999,3
1713524562548,CLRE 260,A00,507221,Cuomo; Raphael Eduardo,9999,0,9999,0
1713524563573,CLRE 297,001,507242,Cuomo; Raphael Eduardo,9999,0,9999,0
1713524564601,CSE 191,A00,516875,Minnes Kemp; Mor Mia,9999,0,9999,0
1713524565631,CSS 201S,A01,494383,Staff,35,0,35,0
1713524566659,CSS 202S,A01,494387,Staff,35,0,35,0
1713524567684,EAP 100,A00,516065,Staff,9792,0,9999,207
1713524568711,ECE 45,A01,507414,Staff,37,0,60,23
1713524569738,ECE 100,A01,507416,Baghdadchi; Saharnaz,0,0,20,20
1713524569738,ECE 100,A02,507418,Baghdadchi; Saharnaz,19,0,20,1
1713524570766,ECE 111,A01,507420,Staff,27,0,50,23
1713524571794,ECE 197,001,548057,Sievenpiper; Daniel F.,9998,0,9999,1
1713524572825,EDS 115,A00,507243,Choi; Bailey Miyeon,27,0,28,1
1713524573854,EDS 117,A01,494379,Staff,14,0,25,11
1713524574888,EDS 125,A00,507246,Hopkins; Megan Beth,27,0,30,3
1713524575915,EDS 128A,A01,507264,Fargason; Sharon Gayle,26,0,26,0
1713524576941,EDS 128B,A01,507293,Pappas; Elizabeth,30,0,30,0
1713524577968,EDS 139,A00,507294,Fargason; Sharon Gayle,30,0,30,0
1713524577968,EDS 139,B00,507313,Pappas; Elizabeth,30,0,30,0
1713524578998,EDS 201,A00,507315,Staff,18,0,30,12
1713524580028,EDS 203,A01,507317,Halter; Christopher P.,17,0,30,13
1713524581053,EDS 204R,A01,507319,Halter; Christopher P.,0,1,30,30
1713524581053,EDS 204R,B01,507331,Heinzman; Erica M.,22,0,30,8
1713524582082,EDS 206R,A00,507332,Staff,0,2,30,30
1713524582082,EDS 206R,B00,507343,Staff,23,0,30,7
1713524583113,EDS 250,A00,507344,Hemans; Patricia Ann Benitez,27,0,40,13
1713524584139,EDS 281,A00,507345,Daly; Alan J.,18,0,18,0
1713524585163,EDS 284,A00,507350,Daly; Alan J.,16,0,16,0
1713524586191,EDS 286,A00,507359,Fine; Sarah,18,0,18,0
1713524587215,EDS 289C,A01,507361,Daly; Alan J.,18,0,18,0
1713524588241,EDS 290,A00,507366,Hofstetter; Carolyn,15,0,15,0
1713524589269,LIGM 5A,A00,507421,Fischer-Grunski; Eva K,20,0,20,0
1713524590294,LIGM 5B,A00,507423,Fischer-Grunski; Eva K,20,0,20,0
1713524591321,LIGM 5C,A00,507425,Fischer-Grunski; Eva K,20,0,20,0
1713524592346,LIIT 5AS,A00,507427,Carnelos; Chiara,20,0,20,0
1713524593375,LIIT 5BS,A00,507430,Carnelos; Chiara,20,0,20,0
1713524594402,LIIT 5CS,A00,507432,Carnelos; Chiara,20,0,20,0
1713524595431,LISP 5A,A00,507541,Munoz Sanchez; Alicia,14,0,20,6
1713524596461,LISP 5B,A00,507671,Munoz Sanchez; Alicia,12,0,20,8
1713524597487,LISP 5C,A00,507696,Munoz Sanchez; Alicia,11,0,20,9
1713524598513,MAE 197,001,528363,Boechler; Nicholas Sebastia,9998,0,9999,1
1713524599541,MATH 197,001,523477,Kedlaya; Kiran S.,9999,0,9999,0
1713524599541,MATH 197,002,563811,Zhang; Danna,9998,0,9999,1
1713524600566,MCWP 40R,A00,518780,Staff,13,0,20,7
1713524600566,MCWP 40R,B00,518781,Staff,11,0,20,9
1713524600566,MCWP 40R,C00,518783,Staff,8,0,20,12
1713524601595,MCWP 50R,A00,518791,Staff,7,0,20,13
1713524601595,MCWP 50R,B00,518792,Staff,3,0,20,17
1713524601595,MCWP 50R,C00,518793,Staff,5,0,20,15
1713524601595,MCWP 50R,D00,518794,Staff,0,0,20,20
1713524601595,MCWP 50R,E00,518795,Staff,0,0,20,20
1713524601595,MCWP 50R,F00,518796,Staff,10,0,20,10
1713524601595,MCWP 50R,G00,518797,Staff,10,0,20,10
1713524602618,MMW 12R,A01,514034,Herbst; Matthew,1,0,16,15
1713524602618,MMW 12R,A02,514035,Herbst; Matthew,13,0,16,3
1713524603645,MMW 13R,A01,514037,Staff,0,8,16,16
1713524603645,MMW 13R,A02,514039,Staff,0,7,16,16
1713524605753,SIO 295LS,A00,523233,Staff,15,0,30,15
1713524606780,SIO 295S,A00,523232,Staff,15,0,30,15
1713524607815,SOCI 117,A01,494376,Staff,0,2,5,5
1713524608841,WES 237B,A00,494380,Staff,19,0,20,1
1713524610899,AESE 279B,A00,494370,Wade; Jon P,33,0,33,0
1713524611927,AIP 197,001,627712,Vespa; Emanuel Ignacio,9999,0,9999,0
1713524612952,ANAR 135S,A00,494369,Braswell; Geoffrey E.,0,0,0,0
1713524613978,CAT 124RS,A01,519847,Geibel; William,6,0,20,14
1713524615003,CAT 125RS,A01,515971,Geibel; William,6,0,20,14
1713524616031,CLRE 250,A00,511389,Morris; Sheldon,9996,0,9999,3
1713524617060,CLRE 251,A00,507176,Mehta; Ravindra L.,9996,0,9999,3
1713524617060,CLRE 251,B00,511410,Mehta; Ravindra L.,9998,0,9999,1
1713524618087,CLRE 252,A00,507189,Cuomo; Raphael Eduardo,9998,0,9999,1
1713524619114,CLRE 253,A00,507199,Vaida; Florin,9997,0,9999,2
1713524619114,CLRE 253,B00,507202,Vaida; Florin,9999,0,9999,0
1713524620144,CLRE 259,A00,507211,Patel; Hemal,9996,0,9999,3
1713524621172,CLRE 260,A00,507221,Cuomo; Raphael Eduardo,9999,0,9999,0
1713524622195,CLRE 297,001,507242,Cuomo; Raphael Eduardo,9999,0,9999,0
1713524623220,CSE 191,A00,516875,Minnes Kemp; Mor Mia,9999,0,9999,0
1713524624251,CSS 201S,A01,494383,Staff,35,0,35,0
1713524625280,CSS 202S,A01,494387,Staff,35,0,35,0
1713524626306,EAP 100,A00,516065,Staff,9792,0,9999,207
1713524627333,ECE 45,A01,507414,Staff,37,0,60,23
1713524628359,ECE 100,A01,507416,Baghdadchi; Saharnaz,0,0,20,20
1713524628359,ECE 100,A02,507418,Baghdadchi; Saharnaz,19,0,20,1
1713524629391,ECE 111,A01,507420,Staff,27,0,50,23
1713524630419,ECE 197,001,548057,Sievenpiper; Daniel F.,9998,0,9999,1
1713524631447,EDS 115,A00,507243,Choi; Bailey Miyeon,27,0,28,1
1713524632473,EDS 117,A01,494379,Staff,14,0,25,11
1713524633497,EDS 125,A00,507246,Hopkins; Megan Beth,27,0,30,3
1713524634525,EDS 128A,A01,507264,Fargason; Sharon Gayle,26,0,26,0
1713524635551,EDS 128B,A01,507293,Pappas; Elizabeth,30,0,30,0
1713524636579,EDS 139,A00,507294,Fargason; Sharon Gayle,30,0,30,0
1713524636579,EDS 139,B00,507313,Pappas; Elizabeth,30,0,30,0
1713524637605,EDS 201,A00,507315,Staff,18,0,30,12
1713524638631,EDS 203,A01,507317,Halter; Christopher P.,17,0,30,13
1713524639661,EDS 204R,A01,507319,Halter; Christopher P.,0,1,30,30
1713524639661,EDS 204R,B01,507331,Heinzman; Erica M.,22,0,30,8
1713524640690,EDS 206R,A00,507332,Staff,0,2,30,30
1713524640690,EDS 206R,B00,507343,Staff,23,0,30,7
1713524641721,EDS 250,A00,507344,Hemans; Patricia Ann Benitez,27,0,40,13
1713524642746,EDS 281,A00,507345,Daly; Alan J.,18,0,18,0
1713524643772,EDS 284,A00,507350,Daly; Alan J.,16,0,16,0
1713524644798,EDS 286,A00,507359,Fine; Sarah,18,0,18,0
1713524645823,EDS 289C,A01,507361,Daly; Alan J.,18,0,18,0
1713524646860,EDS 290,A00,507366,Hofstetter; Carolyn,15,0,15,0
1713524647894,LIGM 5A,A00,507421,Fischer-Grunski; Eva K,20,0,20,0
1713524648923,LIGM 5B,A00,507423,Fischer-Grunski; Eva K,20,0,20,0
1713524649951,LIGM 5C,A00,507425,Fischer-Grunski; Eva K,20,0,20,0
1713524650982,LIIT 5AS,A00,507427,Carnelos; Chiara,20,0,20,0
1713524652008,LIIT 5BS,A00,507430,Carnelos; Chiara,20,0,20,0
1713524653034,LIIT 5CS,A00,507432,Carnelos; Chiara,20,0,20,0
1713524654061,LISP 5A,A00,507541,Munoz Sanchez; Alicia,14,0,20,6
1713524655088,LISP 5B,A00,507671,Munoz Sanchez; Alicia,12,0,20,8
1713524656117,LISP 5C,A00,507696,Munoz Sanchez; Alicia,11,0,20,9
1713524657146,MAE 197,001,528363,Boechler; Nicholas Sebastia,9998,0,9999,1
1713524658173,MATH 197,001,523477,Kedlaya; Kiran S.,9999,0,9999,0
1713524658173,MATH 197,002,563811,Zhang; Danna,9998,0,9999,1
1713524659200,MCWP 40R,A00,518780,Staff,13,0,20,7
1713524659200,MCWP 40R,B00,518781,Staff,11,0,20,9
1713524659200,MCWP 40R,C00,518783,Staff,8,0,20,12
1713524660226,MCWP 50R,A00,518791,Staff,7,0,20,13
1713524660226,MCWP 50R,B00,518792,Staff,3,0,20,17
1713524660226,MCWP 50R,C00,518793,Staff,5,0,20,15
1713524660226,MCWP 50R,D00,518794,Staff,0,0,20,20
1713524660226,MCWP 50R,E00,518795,Staff,0,0,20,20
1713524660226,MCWP 50R,F00,518796,Staff,10,0,20,10
1713524660226,MCWP 50R,G00,518797,Staff,10,0,20,10
1713524661253,MMW 12R,A01,514034,Herbst; Matthew,1,0,16,15
1713524661253,MMW 12R,A02,514035,Herbst; Matthew,13,0,16,3
1713524662282,MMW 13R,A01,514037,Staff,0,8,16,16
1713524662282,MMW 13R,A02,514039,Staff,0,7,16,16
1713524664338,SIO 295LS,A00,523233,Staff,15,0,30,15
1713524665366,SIO 295S,A00,523232,Staff,15,0,30,15
1713524666394,SOCI 117,A01,494376,Staff,0,2,5,5
1713524667423,WES 237B,A00,494380,Staff,19,0,20,1
1713524669503,AESE 279B,A00,494370,Wade; Jon P,33,0,33,0
1713524670528,AIP 197,001,627712,Vespa; Emanuel Ignacio,9999,0,9999,0
1713524671555,ANAR 135S,A00,494369,Braswell; Geoffrey E.,0,0,0,0
1713524672587,CAT 124RS,A01,519847,Geibel; William,6,0,20,14
1713524673612,CAT 125RS,A01,515971,Geibel; William,6,0,20,14
1713524674645,CLRE 250,A00,511389,Morris; Sheldon,9996,0,9999,3
1713524675674,CLRE 251,A00,507176,Mehta; Ravindra L.,9996,0,9999,3
1713524675674,CLRE 251,B00,511410,Mehta; Ravindra L.,9998,0,9999,1
1713524676707,CLRE 252,A00,507189,Cuomo; Raphael Eduardo,9998,0,9999,1
1713524677734,CLRE 253,A00,507199,Vaida; Florin,9997,0,9999,2
1713524677734,CLRE 253,B00,507202,Vaida; Florin,9999,0,9999,0
1713524678765,CLRE 259,A00,507211,Patel; Hemal,9996,0,9999,3
1713524679792,CLRE 260,A00,507221,Cuomo; Raphael Eduardo,9999,0,9999,0
1713524680821,CLRE 297,001,507242,Cuomo; Raphael Eduardo,9999,0,9999,0
1713524681851,CSE 191,A00,516875,Minnes Kemp; Mor Mia,9999,0,9999,0
1713524682878,CSS 201S,A01,494383,Staff,35,0,35,0
1713524683910,CSS 202S,A01,494387,Staff,35,0,35,0
1713524684939,EAP 100,A00,516065,Staff,9792,0,9999,207
1713524685967,ECE 45,A01,507414,Staff,37,0,60,23
1713524686992,ECE 100,A01,507416,Baghdadchi; Saharnaz,0,0,20,20
1713524686992,ECE 100,A02,507418,Baghdadchi; Saharnaz,19,0,20,1
1713524688017,ECE 111,A01,507420,Staff,27,0,50,23
1713524689042,ECE 197,001,548057,Sievenpiper; Daniel F.,9998,0,9999,1
1713524690069,EDS 115,A00,507243,Choi; Bailey Miyeon,27,0,28,1
1713524691095,EDS 117,A01,494379,Staff,14,0,25,11
1713524692119,EDS 125,A00,507246,Hopkins; Megan Beth,27,0,30,3
1713524693145,EDS 128A,A01,507264,Fargason; Sharon Gayle,26,0,26,0
1713524694169,EDS 128B,A01,507293,Pappas; Elizabeth,30,0,30,0
1713524695195,EDS 139,A00,507294,Fargason; Sharon Gayle,30,0,30,0
1713524695195,EDS 139,B00,507313,Pappas; Elizabeth,30,0,30,0
1713524696221,EDS 201,A00,507315,Staff,18,0,30,12
1713524697247,EDS 203,A01,507317,Halter; Christopher P.,17,0,30,13
1713524698273,EDS 204R,A01,507319,Halter; Christopher P.,0,1,30,30
1713524698273,EDS 204R,B01,507331,Heinzman; Erica M.,22,0,30,8
1713524699299,EDS 206R,A00,507332,Staff,0,2,30,30
1713524699299,EDS 206R,B00,507343,Staff,23,0,30,7
1713524700326,EDS 250,A00,507344,Hemans; Patricia Ann Benitez,27,0,40,13
1713524701353,EDS 281,A00,507345,Daly; Alan J.,18,0,18,0
1713524702836,EDS 284,A00,507350,Daly; Alan J.,16,0,16,0
1713524703866,EDS 286,A00,507359,Fine; Sarah,18,0,18,0
1713524704891,EDS 289C,A01,507361,Daly; Alan J.,18,0,18,0
1713524705916,EDS 290,A00,507366,Hofstetter; Carolyn,15,0,15,0
1713524706951,LIGM 5A,A00,507421,Fischer-Grunski; Eva K,20,0,20,0
1713524707976,LIGM 5B,A00,507423,Fischer-Grunski; Eva K,20,0,20,0
1713524709002,LIGM 5C,A00,507425,Fischer-Grunski; Eva K,20,0,20,0
1713524710027,LIIT 5AS,A00,507427,Carnelos; Chiara,20,0,20,0
1713524711052,LIIT 5BS,A00,507430,Carnelos; Chiara,20,0,20,0
1713524712076,LIIT 5CS,A00,507432,Carnelos; Chiara,20,0,20,0
1713524713107,LISP 5A,A00,507541,Munoz Sanchez; Alicia,14,0,20,6
1713524714134,LISP 5B,A00,507671,Munoz Sanchez; Alicia,12,0,20,8
1713524715167,LISP 5C,A00,507696,Munoz Sanchez; Alicia,11,0,20,9
1713524716190,MAE 197,001,528363,Boechler; Nicholas Sebastia,9998,0,9999,1
1713524717216,MATH 197,001,523477,Kedlaya; Kiran S.,9999,0,9999,0
1713524717216,MATH 197,002,563811,Zhang; Danna,9998,0,9999,1
1713524718242,MCWP 40R,A00,518780,Staff,13,0,20,7
1713524718242,MCWP 40R,B00,518781,Staff,11,0,20,9
1713524718242,MCWP 40R,C00,518783,Staff,8,0,20,12
1713524719272,MCWP 50R,A00,518791,Staff,7,0,20,13
1713524719272,MCWP 50R,B00,518792,Staff,3,0,20,17
1713524719272,MCWP 50R,C00,518793,Staff,5,0,20,15
1713524719272,MCWP 50R,D00,518794,Staff,0,0,20,20
1713524719272,MCWP 50R,E00,518795,Staff,0,0,20,20
1713524719272,MCWP 50R,F00,518796,Staff,10,0,20,10
1713524719272,MCWP 50R,G00,518797,Staff,10,0,20,10
1713524720303,MMW 12R,A01,514034,Herbst; Matthew,1,0,16,15
1713524720303,MMW 12R,A02,514035,Herbst; Matthew,13,0,16,3
1713524721327,MMW 13R,A01,514037,Staff,0,8,16,16
1713524721327,MMW 13R,A02,514039,Staff,0,7,16,16
1713524723377,SIO 295LS,A00,523233,Staff,15,0,30,15
1713524724402,SIO 295S,A00,523232,Staff,15,0,30,15
1713524725427,SOCI 117,A01,494376,Staff,0,2,5,5
1713524726456,WES 237B,A00,494380,Staff,19,0,20,1
1713524728528,AESE 279B,A00,494370,Wade; Jon P,33,0,33,0
1713524729559,AIP 197,001,627712,Vespa; Emanuel Ignacio,9999,0,9999,0
1713524730588,ANAR 135S,A00,494369,Braswell; Geoffrey E.,0,0,0,0
1713524731614,CAT 124RS,A01,519847,Geibel; William,6,0,20,14
1713524732640,CAT 125RS,A01,515971,Geibel; William,6,0,20,14
1713524733664,CLRE 250,A00,511389,Morris; Sheldon,9996,0,9999,3
1713524734696,CLRE 251,A00,507176,Mehta; Ravindra L.,9996,0,9999,3
1713524734696,CLRE 251,B00,511410,Mehta; Ravindra L.,9998,0,9999,1
1713524735725,CLRE 252,A00,507189,Cuomo; Raphael Eduardo,9998,0,9999,1
1713524736752,CLRE 253,A00,507199,Vaida; Florin,9997,0,9999,2
1713524736752,CLRE 253,B00,507202,Vaida; Florin,9999,0,9999,0
1713524737776,CLRE 259,A00,507211,Patel; Hemal,9996,0,9999,3
1713524738801,CLRE 260,A00,507221,Cuomo; Raphael Eduardo,9999,0,9999,0
1713524739830,CLRE 297,001,507242,Cuomo; Raphael Eduardo,9999,0,9999,0
1713524740862,CSE 191,A00,516875,Minnes Kemp; Mor Mia,9999,0,9999,0
1713524741889,CSS 201S,A01,494383,Staff,35,0,35,0
1713524742918,CSS 202S,A01,494387,Staff,35,0,35,0
1713524743942,EAP 100,A00,516065,Staff,9792,0,9999,207
1713524744971,ECE 45,A01,507414,Staff,37,0,60,23
1713524745995,ECE 100,A01,507416,Baghdadchi; Saharnaz,0,0,20,20
1713524745995,ECE 100,A02,507418,Baghdadchi; Saharnaz,19,0,20,1
1713524747023,ECE 111,A01,507420,Staff,27,0,50,23
1713524748049,ECE 197,001,548057,Sievenpiper; Daniel F.,9998,0,9999,1
1713524749075,EDS 115,A00,507243,Choi; Bailey Miyeon,27,0,28,1
1713524750101,EDS 117,A01,494379,Staff,14,0,25,11
1713524751127,EDS 125,A00,507246,Hopkins; Megan Beth,27,0,30,3
1713524752153,EDS 128A,A01,507264,Fargason; Sharon Gayle,26,0,26,0
1713524753178,EDS 128B,A01,507293,Pappas; Elizabeth,30,0,30,0
1713524754204,EDS 139,A00,507294,Fargason; Sharon Gayle,30,0,30,0
1713524754204,EDS 139,B00,507313,Pappas; Elizabeth,30,0,30,0
1713524755230,EDS 201,A00,507315,Staff,18,0,30,12
1713524756260,EDS 203,A01,507317,Halter; Christopher P.,17,0,30,13
1713524757286,EDS 204R,A01,507319,Halter; Christopher P.,0,1,30,30
1713524757286,EDS 204R,B01,507331,Heinzman; Erica M.,22,0,30,8
1713524758314,EDS 206R,A00,507332,Staff,0,2,30,30
1713524758314,EDS 206R,B00,507343,Staff,23,0,30,7
1713524759338,EDS 250,A00,507344,Hemans; Patricia Ann Benitez,27,0,40,13
1713524760364,EDS 281,A00,507345,Daly; Alan J.,18,0,18,0
1713524761388,EDS 284,A00,507350,Daly; Alan J.,16,0,16,0
1713524762413,EDS 286,A00,507359,Fine; Sarah,18,0,18,0
1713524763439,EDS 289C,A01,507361,Daly; Alan J.,18,0,18,0
1713524764464,EDS 290,A00,507366,Hofstetter; Carolyn,15,0,15,0
1713524765496,LIGM 5A,A00,507421,Fischer-Grunski; Eva K,20,0,20,0
1713524766523,LIGM 5B,A00,507423,Fischer-Grunski; Eva K,20,0,20,0
1713524767548,LIGM 5C,A00,507425,Fischer-Grunski; Eva K,20,0,20,0
1713524768574,LIIT 5AS,A00,507427,Carnelos; Chiara,20,0,20,0
1713524769603,LIIT 5BS,A00,507430,Carnelos; Chiara,20,0,20,0
1713524770629,LIIT 5CS,A00,507432,Carnelos; Chiara,20,0,20,0
1713524771654,LISP 5A,A00,507541,Munoz Sanchez; Alicia,14,0,20,6
1713524772679,LISP 5B,A00,507671,Munoz Sanchez; Alicia,12,0,20,8
1713524773704,LISP 5C,A00,507696,Munoz Sanchez; Alicia,11,0,20,9
1713524774732,MAE 197,001,528363,Boechler; Nicholas Sebastia,9998,0,9999,1
1713524775758,MATH 197,001,523477,Kedlaya; Kiran S.,9999,0,9999,0
1713524775758,MATH 197,002,563811,Zhang; Danna,9998,0,9999,1
1713524776782,MCWP 40R,A00,518780,Staff,13,0,20,7
1713524776782,MCWP 40R,B00,518781,Staff,11,0,20,9
1713524776782,MCWP 40R,C00,518783,Staff,8,0,20,12
1713524795035,MCWP 50R,A00,518791,Staff,7,0,20,13
1713524795035,MCWP 50R,B00,518792,Staff,3,0,20,17
1713524795035,MCWP 50R,C00,518793,Staff,5,0,20,15
1713524795035,MCWP 50R,D00,518794,Staff,0,0,20,20
1713524795035,MCWP 50R,E00,518795,Staff,0,0,20,20
1713524795035,MCWP 50R,F00,518796,Staff,10,0,20,10
1713524795035,MCWP 50R,G00,518797,Staff,10,0,20,10
1713524796060,MMW 12R,A01,514034,Herbst; Matthew,1,0,16,15
1713524796060,MMW 12R,A02,514035,Herbst; Matthew,13,0,16,3
1713524797087,MMW 13R,A01,514037,Staff,0,8,16,16
1713524797087,MMW 13R,A02,514039,Staff,0,7,16,16
1713524799142,SIO 295LS,A00,523233,Staff,15,0,30,15
1713524800169,SIO 295S,A00,523232,Staff,15,0,30,15
1713524801206,SOCI 117,A01,494376,Staff,0,2,5,5
1713524802232,WES 237B,A00,494380,Staff,19,0,20,1
1713524804322,AESE 279B,A00,494370,Wade; Jon P,33,0,33,0
1713524805351,AIP 197,001,627712,Vespa; Emanuel Ignacio,9999,0,9999,0
1713524806377,ANAR 135S,A00,494369,Braswell; Geoffrey E.,0,0,0,0
1713524807404,CAT 124RS,A01,519847,Geibel; William,6,0,20,14
1713524808430,CAT 125RS,A01,515971,Geibel; William,6,0,20,14
1713524809456,CLRE 250,A00,511389,Morris; Sheldon,9996,0,9999,3
1713524810490,CLRE 251,A00,507176,Mehta; Ravindra L.,9996,0,9999,3
1713524810490,CLRE 251,B00,511410,Mehta; Ravindra L.,9998,0,9999,1
1713524811517,CLRE 252,A00,507189,Cuomo; Raphael Eduardo,9998,0,9999,1
1713524812543,CLRE 253,A00,507199,Vaida; Florin,9997,0,9999,2
1713524812543,CLRE 253,B00,507202,Vaida; Florin,9999,0,9999,0
1713524813567,CLRE 259,A00,507211,Patel; Hemal,9996,0,9999,3
1713524814597,CLRE 260,A00,507221,Cuomo; Raphael Eduardo,9999,0,9999,0
1713524815625,CLRE 297,001,507242,Cuomo; Raphael Eduardo,9999,0,9999,0
1713524816655,CSE 191,A00,516875,Minnes Kemp; Mor Mia,9999,0,9999,0
1713524817690,CSS 201S,A01,494383,Staff,35,0,35,0
1713524818715,CSS 202S,A01,494387,Staff,35,0,35,0
1713524819744,EAP 100,A00,516065,Staff,9792,0,9999,207
1713524820771,ECE 45,A01,507414,Staff,37,0,60,23
1713524821801,ECE 100,A01,507416,Baghdadchi; Saharnaz,0,0,20,20
1713524821801,ECE 100,A02,507418,Baghdadchi; Saharnaz,19,0,20,1
1713524822827,ECE 111,A01,507420,Staff,27,0,50,23
1713524823914,ECE 197,001,548057,Sievenpiper; Daniel F.,9998,0,9999,1
1713524824940,EDS 115,A00,507243,Choi; Bailey Miyeon,27,0,28,1
1713524825966,EDS 117,A01,494379,Staff,14,0,25,11
1713524826992,EDS 125,A00,507246,Hopkins; Megan Beth,27,0,30,3
1713524828025,EDS 128A,A01,507264,Fargason; Sharon Gayle,26,0,26,0
1713524829058,EDS 128B,A01,507293,Pappas; Elizabeth,30,0,30,0
1713524830087,EDS 139,A00,507294,Fargason; Sharon Gayle,30,0,30,0
1713524830087,EDS 139,B00,507313,Pappas; Elizabeth,30,0,30,0
1713524831116,EDS 201,A00,507315,Staff,18,0,30,12
1713524832142,EDS 203,A01,507317,Halter; Christopher P.,17,0,30,13
1713524833173,EDS 204R,A01,507319,Halter; Christopher P.,0,1,30,30
1713524833173,EDS 204R,B01,507331,Heinzman; Erica M.,22,0,30,8
1713524834202,EDS 206R,A00,507332,Staff,0,2,30,30
1713524834202,EDS 206R,B00,507343,Staff,23,0,30,7
1713524835231,EDS 250,A00,507344,Hemans; Patricia Ann Benitez,27,0,40,13
1713524836257,EDS 281,A00,507345,Daly; Alan J.,18,0,18,0
1713524837282,EDS 284,A00,507350,Daly; Alan J.,16,0,16,0
1713524838313,EDS 286,A00,507359,Fine; Sarah,18,0,18,0
1713524839346,EDS 289C,A01,507361,Daly; Alan J.,18,0,18,0
1713524840378,EDS 290,A00,507366,Hofstetter; Carolyn,15,0,15,0
1713524841410,LIGM 5A,A00,507421,Fischer-Grunski; Eva K,20,0,20,0
1713524842436,LIGM 5B,A00,507423,Fischer-Grunski; Eva K,20,0,20,0
1713524843462,LIGM 5C,A00,507425,Fischer-Grunski; Eva K,20,0,20,0
1713524844489,LIIT 5AS,A00,507427,Carnelos; Chiara,20,0,20,0
1713524845513,LIIT 5BS,A00,507430,Carnelos; Chiara,20,0,20,0
1713524846546,LIIT 5CS,A00,507432,Carnelos; Chiara,20,0,20,0
1713524847572,LISP 5A,A00,507541,Munoz Sanchez; Alicia,14,0,20,6
1713524848597,LISP 5B,A00,507671,Munoz Sanchez; Alicia,12,0,20,8
1713524849624,LISP 5C,A00,507696,Munoz Sanchez; Alicia,11,0,20,9
1713524850654,MAE 197,001,528363,Boechler; Nicholas Sebastia,9998,0,9999,1
1713524851682,MATH 197,001,523477,Kedlaya; Kiran S.,9999,0,9999,0
1713524851682,MATH 197,002,563811,Zhang; Danna,9998,0,9999,1
1713524852709,MCWP 40R,A00,518780,Staff,13,0,20,7
1713524852709,MCWP 40R,B00,518781,Staff,11,0,20,9
1713524852709,MCWP 40R,C00,518783,Staff,8,0,20,12
1713524853740,MCWP 50R,A00,518791,Staff,7,0,20,13
1713524853740,MCWP 50R,B00,518792,Staff,3,0,20,17
1713524853740,MCWP 50R,C00,518793,Staff,5,0,20,15
1713524853740,MCWP 50R,D00,518794,Staff,0,0,20,20
1713524853740,MCWP 50R,E00,518795,Staff,0,0,20,20
1713524853740,MCWP 50R,F00,518796,Staff,10,0,20,10
1713524853740,MCWP 50R,G00,518797,Staff,10,0,20,10
1713524854767,MMW 12R,A01,514034,Herbst; Matthew,1,0,16,15
1713524854767,MMW 12R,A02,514035,Herbst; Matthew,13,0,16,3
1713524855794,MMW 13R,A01,514037,Staff,0,8,16,16
1713524855794,MMW 13R,A02,514039,Staff,0,7,16,16
1713524857845,SIO 295LS,A00,523233,Staff,15,0,30,15
