time,subj_course_id,sec_code,sec_id,prof,available,waitlist,total,enrolled_ct
1715599331985,AESE 279B,A00,494370,Wade; Jon P,0,0,33,33
1715599333016,AIP 97,001,660915,Van Den Einde; Yael Dahlia,9999,0,9999,0
1715599334058,AIP 197,001,627712,Vespa; Emanuel Ignacio,9995,0,9999,4
1715599334058,AIP 197,002,650778,Amir; On,9998,0,9999,1
1715599334058,AIP 197,003,650933,Avenancio-Leon; Carlos,9998,0,9999,1
1715599334058,AIP 197,004,658530,Heyman; Gail D.,9998,0,9999,1
1715599334058,AIP 197,005,658631,Neal; Sonya E,9998,0,9999,1
1715599334058,AIP 197,006,658671,Du; Songzi,9998,0,9999,1
1715599335092,ANAR 135S,A00,494369,Braswell; Geoffrey E.,0,0,0,0
1715599336131,BENG 196,001,628496,Engler; Adam J.,9998,0,9999,1
1715599336131,BENG 196,002,660916,Watson; John Thomas,9999,0,9999,0
1715599337169,BISP 197,001,650773,Wilhelm; James E.,9994,0,9999,5
1715599337169,BISP 197,002,658904,Coleman; Aaron B.,9998,0,9999,1
1715599338203,CAT 124RS,A01,519847,Geibel; William,0,0,20,20
1715599339237,CAT 125RS,A01,515971,Geibel; William,0,0,20,20
1715599340270,CLRE 250,A00,511389,Morris; Sheldon,9992,0,9999,7
1715599341307,CLRE 251,A00,507176,Mehta; Ravindra L.,9992,0,9999,7
1715599341307,CLRE 251,B00,511410,Mehta; Ravindra L.,9998,0,9999,1
1715599342339,CLRE 252,A00,507189,Cuomo; Raphael Eduardo,9994,0,9999,5
1715599343370,CLRE 253,A00,507199,Vaida; Florin,9994,0,9999,5
1715599343370,CLRE 253,B00,507202,Vaida; Florin,9999,0,9999,0
1715599344400,CLRE 259,A00,507211,Patel; Hemal,9996,0,9999,3
1715599345431,CLRE 260,A00,507221,Cuomo; Raphael Eduardo,9999,0,9999,0
1715599346464,CLRE 297,001,507242,Cuomo; Raphael Eduardo,9999,0,9999,0
1715599347496,COGS 197,001,638244,Voytek; Bradley Thomas,9997,0,9999,2
1715599348531,CSE 191,A00,516875,Minnes Kemp; Mor Mia,9991,0,9999,8
1715599349562,CSE 197,001,637388,Minnes Kemp; Mor Mia,9992,0,9999,7
1715599350597,CSS 201S,A01,494383,Mignozzetti; Umberto,35,0,35,0
1715599351629,CSS 202S,A01,494387,Mignozzetti; Umberto,35,0,35,0
1715599352658,DSC 197,001,628532,Eldridge; Justin Matthew,9995,0,9999,4
1715599353690,EAP 100,A00,516065,Staff,9799,0,9999,200
1715599354724,ECE 45,A01,507414,Staff,31,0,60,29
1715599356785,ECE 111,A01,507420,Staff,11,0,50,39
1715599357814,ECE 197,001,548057,Sievenpiper; Daniel F.,9991,0,9999,8
1715599358843,EDS 115,A00,507243,Choi; Bailey Miyeon,7,0,28,21
1715599359879,EDS 117,A01,494379,Staff,0,6,34,34
1715599360908,EDS 125,A00,507246,Hopkins; Megan Beth,8,0,30,22
1715599361942,EDS 128A,A01,507264,Fargason; Sharon Gayle,6,0,26,20
1715599362972,EDS 128B,A01,507293,Pappas; Elizabeth,10,0,30,20
1715599364000,EDS 139,A00,507294,Fargason; Sharon Gayle,10,0,30,20
1715599364000,EDS 139,B00,507313,Pappas; Elizabeth,11,0,30,19
1715599365031,EDS 201,A00,507315,Staff,10,0,30,20
1715599366066,EDS 203,A01,507317,Halter; Christopher P.,10,0,30,20
1715599367097,EDS 204R,A01,507319,Halter; Christopher P.,0,3,30,30
1715599367097,EDS 204R,B01,507331,Heinzman; Erica M.,14,0,30,16
1715599368130,EDS 206R,A00,507332,Staff,0,4,30,30
1715599368130,EDS 206R,B00,507343,Staff,15,0,30,15
1715599369160,EDS 250,A00,507344,Hemans; Patricia Ann Benitez,20,0,40,20
1715599370192,EDS 281,A00,507345,Daly; Alan J.,18,0,18,0
1715599371223,EDS 284,A00,507350,Daly; Alan J.,16,0,16,0
1715599372255,EDS 286,A00,507359,Fine; Sarah,18,0,18,0
1715599373283,EDS 289C,A01,507361,Daly; Alan J.,18,0,18,0
1715599374317,EDS 290,A00,507366,Hofstetter; Carolyn,15,0,15,0
1715599375356,LIGM 5A,A00,507421,Fischer-Grunski; Eva K,17,0,20,3
1715599376386,LIGM 5B,A00,507423,Fischer-Grunski; Eva K,19,0,20,1
1715599377417,LIGM 5C,A00,507425,Fischer-Grunski; Eva K,19,0,20,1
1715599378447,LIIT 5AS,A00,507427,Carnelos; Chiara,20,0,20,0
1715599379477,LIIT 5BS,A00,507430,Carnelos; Chiara,20,0,20,0
1715599380509,LIIT 5CS,A00,507432,Carnelos; Chiara,20,0,20,0
1715599381537,LISP 5A,A00,507541,Munoz Sanchez; Alicia,11,0,20,9
1715599382567,LISP 5B,A00,507671,Munoz Sanchez; Alicia,9,0,20,11
1715599383598,LISP 5C,A00,507696,Munoz Sanchez; Alicia,9,0,20,11
1715599384631,MAE 197,001,528363,Boechler; Nicholas Sebastia,9998,0,9999,1
1715599385664,MATH 197,001,523477,Kedlaya; Kiran S.,9994,0,9999,5
1715599385664,MATH 197,002,563811,Zhang; Danna,9994,0,9999,5
1715599385664,MATH 197,003,628552,Dumitriu; Ioana,9998,0,9999,1
1715599385664,MATH 197,004,660885,Floyd; Eric,9999,0,9999,0
1715599386695,MCWP 40R,A00,518780,Staff,2,0,20,18
1715599386695,MCWP 40R,B00,518781,Staff,11,0,20,9
1715599386695,MCWP 40R,C00,518783,Staff,5,0,20,15
1715599387721,MCWP 50R,A00,518791,Staff,0,1,20,20
1715599387721,MCWP 50R,B00,518792,Staff,0,2,20,20
1715599387721,MCWP 50R,C00,518793,Staff,0,4,20,20
1715599387721,MCWP 50R,D00,518794,Staff,0,1,20,20
1715599387721,MCWP 50R,E00,518795,Staff,0,2,20,20
1715599387721,MCWP 50R,F00,518796,Staff,0,1,20,20
1715599387721,MCWP 50R,G00,518797,Staff,0,1,20,20
1715599388750,MMW 12R,A01,514034,Herbst; Matthew,0,2,16,16
1715599388750,MMW 12R,A02,514035,Herbst; Matthew,0,0,16,16
1715599389780,MMW 13R,A01,514037,Staff,0,5,16,16
1715599389780,MMW 13R,A02,514039,Staff,0,5,16,16
1715599389780,MMW 13R,A03,628519,Staff,0,4,16,16
1715599391837,SIO 295LS,A00,523233,Staff,10,0,30,20
1715599392866,SIO 295S,A00,523232,Staff,10,0,30,20
1715599393901,SIOC 290S,A01,637330,Merrifield; Mark A,23,0,30,7
1715599394936,SIOC 291S,A01,637333,Gabriel; Corey John,23,0,30,7
1715599395966,SOCI 117,A01,494376,Staff,0,5,5,5
1715599396994,WES 237B,A00,494380,Staff,10,0,20,10
1715599399077,AESE 279B,A00,494370,Wade; Jon P,0,0,33,33
1715599400109,AIP 97,001,660915,Van Den Einde; Yael Dahlia,9999,0,9999,0
1715599401140,AIP 197,001,627712,Vespa; Emanuel Ignacio,9995,0,9999,4
1715599401140,AIP 197,002,650778,Amir; On,9998,0,9999,1
1715599401140,AIP 197,003,650933,Avenancio-Leon; Carlos,9998,0,9999,1
1715599401140,AIP 197,004,658530,Heyman; Gail D.,9998,0,9999,1
1715599401140,AIP 197,005,658631,Neal; Sonya E,9998,0,9999,1
1715599401140,AIP 197,006,658671,Du; Songzi,9998,0,9999,1
1715599402175,ANAR 135S,A00,494369,Braswell; Geoffrey E.,0,0,0,0
1715599403211,BENG 196,001,628496,Engler; Adam J.,9998,0,9999,1
1715599403211,BENG 196,002,660916,Watson; John Thomas,9999,0,9999,0
1715599404240,BISP 197,001,650773,Wilhelm; James E.,9994,0,9999,5
1715599404240,BISP 197,002,658904,Coleman; Aaron B.,9998,0,9999,1
1715599405274,CAT 124RS,A01,519847,Geibel; William,0,0,20,20
1715599406307,CAT 125RS,A01,515971,Geibel; William,0,0,20,20
1715599407336,CLRE 250,A00,511389,Morris; Sheldon,9992,0,9999,7
1715599408367,CLRE 251,A00,507176,Mehta; Ravindra L.,9992,0,9999,7
1715599408367,CLRE 251,B00,511410,Mehta; Ravindra L.,9998,0,9999,1
1715599409395,CLRE 252,A00,507189,Cuomo; Raphael Eduardo,9994,0,9999,5
1715599410434,CLRE 253,A00,507199,Vaida; Florin,9994,0,9999,5
1715599410434,CLRE 253,B00,507202,Vaida; Florin,9999,0,9999,0
1715599411466,CLRE 259,A00,507211,Patel; Hemal,9996,0,9999,3
1715599412497,CLRE 260,A00,507221,Cuomo; Raphael Eduardo,9999,0,9999,0
1715599413531,CLRE 297,001,507242,Cuomo; Raphael Eduardo,9999,0,9999,0
1715599414561,COGS 197,001,638244,Voytek; Bradley Thomas,9997,0,9999,2
1715599415590,CSE 191,A00,516875,Minnes Kemp; Mor Mia,9991,0,9999,8
1715599416616,CSE 197,001,637388,Minnes Kemp; Mor Mia,9992,0,9999,7
1715599417647,CSS 201S,A01,494383,Mignozzetti; Umberto,35,0,35,0
1715599418679,CSS 202S,A01,494387,Mignozzetti; Umberto,35,0,35,0
1715599419712,DSC 197,001,628532,Eldridge; Justin Matthew,9995,0,9999,4
1715599420740,EAP 100,A00,516065,Staff,9799,0,9999,200
1715599421777,ECE 45,A01,507414,Staff,31,0,60,29
1715599423835,ECE 111,A01,507420,Staff,11,0,50,39
1715599424867,ECE 197,001,548057,Sievenpiper; Daniel F.,9991,0,9999,8
1715599425906,EDS 115,A00,507243,Choi; Bailey Miyeon,7,0,28,21
1715599426938,EDS 117,A01,494379,Staff,0,6,34,34
1715599427971,EDS 125,A00,507246,Hopkins; Megan Beth,8,0,30,22
1715599429004,EDS 128A,A01,507264,Fargason; Sharon Gayle,6,0,26,20
1715599430034,EDS 128B,A01,507293,Pappas; Elizabeth,10,0,30,20
1715599431066,EDS 139,A00,507294,Fargason; Sharon Gayle,10,0,30,20
1715599431066,EDS 139,B00,507313,Pappas; Elizabeth,11,0,30,19
1715599432098,EDS 201,A00,507315,Staff,10,0,30,20
1715599433127,EDS 203,A01,507317,Halter; Christopher P.,10,0,30,20
1715599434159,EDS 204R,A01,507319,Halter; Christopher P.,0,3,30,30
1715599434159,EDS 204R,B01,507331,Heinzman; Erica M.,14,0,30,16
1715599435191,EDS 206R,A00,507332,Staff,0,4,30,30
1715599435191,EDS 206R,B00,507343,Staff,15,0,30,15
1715599436223,EDS 250,A00,507344,Hemans; Patricia Ann Benitez,20,0,40,20
1715599437253,EDS 281,A00,507345,Daly; Alan J.,18,0,18,0
1715599438284,EDS 284,A00,507350,Daly; Alan J.,16,0,16,0
1715599439315,EDS 286,A00,507359,Fine; Sarah,18,0,18,0
1715599440344,EDS 289C,A01,507361,Daly; Alan J.,18,0,18,0
1715599441373,EDS 290,A00,507366,Hofstetter; Carolyn,15,0,15,0
1715599442408,LIGM 5A,A00,507421,Fischer-Grunski; Eva K,17,0,20,3
1715599443439,LIGM 5B,A00,507423,Fischer-Grunski; Eva K,19,0,20,1
1715599444472,LIGM 5C,A00,507425,Fischer-Grunski; Eva K,19,0,20,1
1715599445507,LIIT 5AS,A00,507427,Carnelos; Chiara,20,0,20,0
1715599446537,LIIT 5BS,A00,507430,Carnelos; Chiara,20,0,20,0
1715599447571,LIIT 5CS,A00,507432,Carnelos; Chiara,20,0,20,0
1715599448600,LISP 5A,A00,507541,Munoz Sanchez; Alicia,11,0,20,9
1715599449630,LISP 5B,A00,507671,Munoz Sanchez; Alicia,9,0,20,11
1715599450656,LISP 5C,A00,507696,Munoz Sanchez; Alicia,9,0,20,11
1715599451686,MAE 197,001,528363,Boechler; Nicholas Sebastia,9998,0,9999,1
1715599452717,MATH 197,001,523477,Kedlaya; Kiran S.,9994,0,9999,5
1715599452717,MATH 197,002,563811,Zhang; Danna,9994,0,9999,5
1715599452717,MATH 197,003,628552,Dumitriu; Ioana,9998,0,9999,1
1715599452717,MATH 197,004,660885,Floyd; Eric,9999,0,9999,0
1715599453749,MCWP 40R,A00,518780,Staff,2,0,20,18
1715599453749,MCWP 40R,B00,518781,Staff,11,0,20,9
1715599453749,MCWP 40R,C00,518783,Staff,5,0,20,15
1715599454779,MCWP 50R,A00,518791,Staff,0,1,20,20
1715599454779,MCWP 50R,B00,518792,Staff,0,2,20,20
1715599454779,MCWP 50R,C00,518793,Staff,0,4,20,20
1715599454779,MCWP 50R,D00,518794,Staff,0,1,20,20
1715599454779,MCWP 50R,E00,518795,Staff,0,2,20,20
1715599454779,MCWP 50R,F00,518796,Staff,0,1,20,20
1715599454779,MCWP 50R,G00,518797,Staff,0,1,20,20
1715599455814,MMW 12R,A01,514034,Herbst; Matthew,0,2,16,16
1715599455814,MMW 12R,A02,514035,Herbst; Matthew,0,0,16,16
1715599456840,MMW 13R,A01,514037,Staff,0,5,16,16
1715599456840,MMW 13R,A02,514039,Staff,0,5,16,16
1715599456840,MMW 13R,A03,628519,Staff,0,4,16,16
1715599458906,SIO 295LS,A00,523233,Staff,10,0,30,20
1715599459935,SIO 295S,A00,523232,Staff,10,0,30,20
1715599460970,SIOC 290S,A01,637330,Merrifield; Mark A,23,0,30,7
1715599462001,SIOC 291S,A01,637333,Gabriel; Corey John,23,0,30,7
1715599463033,SOCI 117,A01,494376,Staff,0,5,5,5
1715599464065,WES 237B,A00,494380,Staff,10,0,20,10
1715599466146,AESE 279B,A00,494370,Wade; Jon P,0,0,33,33
1715599467178,AIP 97,001,660915,Van Den Einde; Yael Dahlia,9999,0,9999,0
1715599468211,AIP 197,001,627712,Vespa; Emanuel Ignacio,9995,0,9999,4
1715599468211,AIP 197,002,650778,Amir; On,9998,0,9999,1
1715599468211,AIP 197,003,650933,Avenancio-Leon; Carlos,9998,0,9999,1
1715599468211,AIP 197,004,658530,Heyman; Gail D.,9998,0,9999,1
1715599468211,AIP 197,005,658631,Neal; Sonya E,9998,0,9999,1
1715599468211,AIP 197,006,658671,Du; Songzi,9998,0,9999,1
1715599469241,ANAR 135S,A00,494369,Braswell; Geoffrey E.,0,0,0,0
1715599470267,BENG 196,001,628496,Engler; Adam J.,9998,0,9999,1
1715599470267,BENG 196,002,660916,Watson; John Thomas,9999,0,9999,0
1715599471298,BISP 197,001,650773,Wilhelm; James E.,9994,0,9999,5
1715599471298,BISP 197,002,658904,Coleman; Aaron B.,9998,0,9999,1
1715599472327,CAT 124RS,A01,519847,Geibel; William,0,0,20,20
1715599473354,CAT 125RS,A01,515971,Geibel; William,0,0,20,20
1715599474387,CLRE 250,A00,511389,Morris; Sheldon,9992,0,9999,7
1715599475414,CLRE 251,A00,507176,Mehta; Ravindra L.,9992,0,9999,7
1715599475414,CLRE 251,B00,511410,Mehta; Ravindra L.,9998,0,9999,1
1715599476441,CLRE 252,A00,507189,Cuomo; Raphael Eduardo,9994,0,9999,5
1715599477469,CLRE 253,A00,507199,Vaida; Florin,9994,0,9999,5
1715599477469,CLRE 253,B00,507202,Vaida; Florin,9999,0,9999,0
1715599478496,CLRE 259,A00,507211,Patel; Hemal,9996,0,9999,3
1715599479521,CLRE 260,A00,507221,Cuomo; Raphael Eduardo,9999,0,9999,0
1715599480547,CLRE 297,001,507242,Cuomo; Raphael Eduardo,9999,0,9999,0
1715599481574,COGS 197,001,638244,Voytek; Bradley Thomas,9997,0,9999,2
1715599482601,CSE 191,A00,516875,Minnes Kemp; Mor Mia,9991,0,9999,8
1715599483648,CSE 197,001,637388,Minnes Kemp; Mor Mia,9992,0,9999,7
1715599484676,CSS 201S,A01,494383,Mignozzetti; Umberto,35,0,35,0
1715599485707,CSS 202S,A01,494387,Mignozzetti; Umberto,35,0,35,0
1715599486734,DSC 197,001,628532,Eldridge; Justin Matthew,9995,0,9999,4
1715599487759,EAP 100,A00,516065,Staff,9799,0,9999,200
1715599488790,ECE 45,A01,507414,Staff,31,0,60,29
1715599490844,ECE 111,A01,507420,Staff,11,0,50,39
1715599491875,ECE 197,001,548057,Sievenpiper; Daniel F.,9991,0,9999,8
1715599492902,EDS 115,A00,507243,Choi; Bailey Miyeon,7,0,28,21
1715599493935,EDS 117,A01,494379,Staff,0,6,34,34
1715599494963,EDS 125,A00,507246,Hopkins; Megan Beth,8,0,30,22
1715599495992,EDS 128A,A01,507264,Fargason; Sharon Gayle,6,0,26,20
1715599497021,EDS 128B,A01,507293,Pappas; Elizabeth,10,0,30,20
1715599498053,EDS 139,A00,507294,Fargason; Sharon Gayle,10,0,30,20
1715599498053,EDS 139,B00,507313,Pappas; Elizabeth,11,0,30,19
1715599499082,EDS 201,A00,507315,Staff,10,0,30,20
1715599500111,EDS 203,A01,507317,Halter; Christopher P.,10,0,30,20
1715599501141,EDS 204R,A01,507319,Halter; Christopher P.,0,3,30,30
1715599501141,EDS 204R,B01,507331,Heinzman; Erica M.,14,0,30,16
1715599502170,EDS 206R,A00,507332,Staff,0,4,30,30
1715599502170,EDS 206R,B00,507343,Staff,15,0,30,15
1715599503197,EDS 250,A00,507344,Hemans; Patricia Ann Benitez,20,0,40,20
1715599504229,EDS 281,A00,507345,Daly; Alan J.,18,0,18,0
1715599505261,EDS 284,A00,507350,Daly; Alan J.,16,0,16,0
1715599506288,EDS 286,A00,507359,Fine; Sarah,18,0,18,0
1715599507325,EDS 289C,A01,507361,Daly; Alan J.,18,0,18,0
1715599508353,EDS 290,A00,507366,Hofstetter; Carolyn,15,0,15,0
1715599509386,LIGM 5A,A00,507421,Fischer-Grunski; Eva K,17,0,20,3
1715599510415,LIGM 5B,A00,507423,Fischer-Grunski; Eva K,19,0,20,1
1715599511449,LIGM 5C,A00,507425,Fischer-Grunski; Eva K,19,0,20,1
1715599512480,LIIT 5AS,A00,507427,Carnelos; Chiara,20,0,20,0
1715599513512,LIIT 5BS,A00,507430,Carnelos; Chiara,20,0,20,0
1715599514538,LIIT 5CS,A00,507432,Carnelos; Chiara,20,0,20,0
1715599515565,LISP 5A,A00,507541,Munoz Sanchez; Alicia,11,0,20,9
1715599516593,LISP 5B,A00,507671,Munoz Sanchez; Alicia,9,0,20,11
1715599517623,LISP 5C,A00,507696,Munoz Sanchez; Alicia,9,0,20,11
1715599518652,MAE 197,001,528363,Boechler; Nicholas Sebastia,9998,0,9999,1
1715599519692,MATH 197,001,523477,Kedlaya; Kiran S.,9994,0,9999,5
1715599519692,MATH 197,002,563811,Zhang; Danna,9994,0,9999,5
1715599519692,MATH 197,003,628552,Dumitriu; Ioana,9998,0,9999,1
1715599519692,MATH 197,004,660885,Floyd; Eric,9999,0,9999,0
1715599520720,MCWP 40R,A00,518780,Staff,2,0,20,18
1715599520720,MCWP 40R,B00,518781,Staff,11,0,20,9
1715599520720,MCWP 40R,C00,518783,Staff,5,0,20,15
1715599521750,MCWP 50R,A00,518791,Staff,0,1,20,20
1715599521750,MCWP 50R,B00,518792,Staff,0,2,20,20
1715599521750,MCWP 50R,C00,518793,Staff,0,4,20,20
1715599521750,MCWP 50R,D00,518794,Staff,0,1,20,20
1715599521750,MCWP 50R,E00,518795,Staff,0,2,20,20
1715599521750,MCWP 50R,F00,518796,Staff,0,1,20,20
1715599521750,MCWP 50R,G00,518797,Staff,0,1,20,20
1715599522778,MMW 12R,A01,514034,Herbst; Matthew,0,2,16,16
1715599522778,MMW 12R,A02,514035,Herbst; Matthew,0,0,16,16
1715599523804,MMW 13R,A01,514037,Staff,0,5,16,16
1715599523804,MMW 13R,A02,514039,Staff,0,5,16,16
1715599523804,MMW 13R,A03,628519,Staff,0,4,16,16
1715599525864,SIO 295LS,A00,523233,Staff,10,0,30,20
1715599526892,SIO 295S,A00,523232,Staff,10,0,30,20
1715599527928,SIOC 290S,A01,637330,Merrifield; Mark A,23,0,30,7
1715599528959,SIOC 291S,A01,637333,Gabriel; Corey John,23,0,30,7
1715599529986,SOCI 117,A01,494376,Staff,0,5,5,5
1715599531010,WES 237B,A00,494380,Staff,10,0,20,10
1715599533103,AESE 279B,A00,494370,Wade; Jon P,0,0,33,33
1715599534130,AIP 97,001,660915,Van Den Einde; Yael Dahlia,9999,0,9999,0
1715599535160,AIP 197,001,627712,Vespa; Emanuel Ignacio,9995,0,9999,4
1715599535160,AIP 197,002,650778,Amir; On,9998,0,9999,1
1715599535160,AIP 197,003,650933,Avenancio-Leon; Carlos,9998,0,9999,1
1715599535160,AIP 197,004,658530,Heyman; Gail D.,9998,0,9999,1
1715599535160,AIP 197,005,658631,Neal; Sonya E,9998,0,9999,1
1715599535160,AIP 197,006,658671,Du; Songzi,9998,0,9999,1
1715599536188,ANAR 135S,A00,494369,Braswell; Geoffrey E.,0,0,0,0
1715599537217,BENG 196,001,628496,Engler; Adam J.,9998,0,9999,1
1715599537217,BENG 196,002,660916,Watson; John Thomas,9999,0,9999,0
1715599538245,BISP 197,001,650773,Wilhelm; James E.,9994,0,9999,5
1715599538245,BISP 197,002,658904,Coleman; Aaron B.,9998,0,9999,1
1715599539273,CAT 124RS,A01,519847,Geibel; William,0,0,20,20
1715599540300,CAT 125RS,A01,515971,Geibel; William,0,0,20,20
1715599541330,CLRE 250,A00,511389,Morris; Sheldon,9992,0,9999,7
1715599542359,CLRE 251,A00,507176,Mehta; Ravindra L.,9992,0,9999,7
1715599542359,CLRE 251,B00,511410,Mehta; Ravindra L.,9998,0,9999,1
1715599543399,CLRE 252,A00,507189,Cuomo; Raphael Eduardo,9994,0,9999,5
1715599544427,CLRE 253,A00,507199,Vaida; Florin,9994,0,9999,5
1715599544427,CLRE 253,B00,507202,Vaida; Florin,9999,0,9999,0
1715599545453,CLRE 259,A00,507211,Patel; Hemal,9996,0,9999,3
1715599546480,CLRE 260,A00,507221,Cuomo; Raphael Eduardo,9999,0,9999,0
1715599547505,CLRE 297,001,507242,Cuomo; Raphael Eduardo,9999,0,9999,0
1715599548530,COGS 197,001,638244,Voytek; Bradley Thomas,9997,0,9999,2
1715599549557,CSE 191,A00,516875,Minnes Kemp; Mor Mia,9991,0,9999,8
1715599550586,CSE 197,001,637388,Minnes Kemp; Mor Mia,9992,0,9999,7
1715599551619,CSS 201S,A01,494383,Mignozzetti; Umberto,35,0,35,0
1715599552650,CSS 202S,A01,494387,Mignozzetti; Umberto,35,0,35,0
1715599553677,DSC 197,001,628532,Eldridge; Justin Matthew,9995,0,9999,4
1715599554706,EAP 100,A00,516065,Staff,9799,0,9999,200
1715599555731,ECE 45,A01,507414,Staff,31,0,60,29
1715599557785,ECE 111,A01,507420,Staff,11,0,50,39
1715599558817,ECE 197,001,548057,Sievenpiper; Daniel F.,9991,0,9999,8
1715599559848,EDS 115,A00,507243,Choi; Bailey Miyeon,7,0,28,21
1715599560877,EDS 117,A01,494379,Staff,0,6,34,34
1715599561904,EDS 125,A00,507246,Hopkins; Megan Beth,8,0,30,22
1715599562936,EDS 128A,A01,507264,Fargason; Sharon Gayle,6,0,26,20
1715599563966,EDS 128B,A01,507293,Pappas; Elizabeth,10,0,30,20
1715599564994,EDS 139,A00,507294,Fargason; Sharon Gayle,10,0,30,20
1715599564994,EDS 139,B00,507313,Pappas; Elizabeth,11,0,30,19
1715599566021,EDS 201,A00,507315,Staff,10,0,30,20
1715599567051,EDS 203,A01,507317,Halter; Christopher P.,10,0,30,20
1715599568081,EDS 204R,A01,507319,Halter; Christopher P.,0,3,30,30
1715599568081,EDS 204R,B01,507331,Heinzman; Erica M.,14,0,30,16
1715599569110,EDS 206R,A00,507332,Staff,0,4,30,30
1715599569110,EDS 206R,B00,507343,Staff,15,0,30,15
1715599570138,EDS 250,A00,507344,Hemans; Patricia Ann Benitez,20,0,40,20
1715599571166,EDS 281,A00,507345,Daly; Alan J.,18,0,18,0
1715599572195,EDS 284,A00,507350,Daly; Alan J.,16,0,16,0
1715599573222,EDS 286,A00,507359,Fine; Sarah,18,0,18,0
1715599574249,EDS 289C,A01,507361,Daly; Alan J.,18,0,18,0
1715599575281,EDS 290,A00,507366,Hofstetter; Carolyn,15,0,15,0
1715599576313,LIGM 5A,A00,507421,Fischer-Grunski; Eva K,17,0,20,3
1715599577342,LIGM 5B,A00,507423,Fischer-Grunski; Eva K,19,0,20,1
1715599578373,LIGM 5C,A00,507425,Fischer-Grunski; Eva K,19,0,20,1
1715599579401,LIIT 5AS,A00,507427,Carnelos; Chiara,20,0,20,0
1715599580434,LIIT 5BS,A00,507430,Carnelos; Chiara,20,0,20,0
1715599581464,LIIT 5CS,A00,507432,Carnelos; Chiara,20,0,20,0
1715599582493,LISP 5A,A00,507541,Munoz Sanchez; Alicia,11,0,20,9
1715599583520,LISP 5B,A00,507671,Munoz Sanchez; Alicia,9,0,20,11
1715599584552,LISP 5C,A00,507696,Munoz Sanchez; Alicia,9,0,20,11
1715599585584,MAE 197,001,528363,Boechler; Nicholas Sebastia,9998,0,9999,1
1715599586620,MATH 197,001,523477,Kedlaya; Kiran S.,9994,0,9999,5
1715599586620,MATH 197,002,563811,Zhang; Danna,9994,0,9999,5
1715599586620,MATH 197,003,628552,Dumitriu; Ioana,9998,0,9999,1
1715599586620,MATH 197,004,660885,Floyd; Eric,9999,0,9999,0
1715599587650,MCWP 40R,A00,518780,Staff,2,0,20,18
1715599587650,MCWP 40R,B00,518781,Staff,11,0,20,9
1715599587650,MCWP 40R,C00,518783,Staff,5,0,20,15
1715599588704,MCWP 50R,A00,518791,Staff,0,1,20,20
1715599588704,MCWP 50R,B00,518792,Staff,0,2,20,20
1715599588704,MCWP 50R,C00,518793,Staff,0,4,20,20
1715599588704,MCWP 50R,D00,518794,Staff,0,1,20,20
1715599588704,MCWP 50R,E00,518795,Staff,0,2,20,20
1715599588704,MCWP 50R,F00,518796,Staff,0,1,20,20
1715599588704,MCWP 50R,G00,518797,Staff,0,1,20,20
1715599589733,MMW 12R,A01,514034,Herbst; Matthew,0,2,16,16
1715599589733,MMW 12R,A02,514035,Herbst; Matthew,0,0,16,16
1715599590759,MMW 13R,A01,514037,Staff,0,5,16,16
1715599590759,MMW 13R,A02,514039,Staff,0,5,16,16
1715599590759,MMW 13R,A03,628519,Staff,0,4,16,16
1715599592816,SIO 295LS,A00,523233,Staff,10,0,30,20
1715599593843,SIO 295S,A00,523232,Staff,10,0,30,20
1715599594877,SIOC 290S,A01,637330,Merrifield; Mark A,23,0,30,7
1715599595909,SIOC 291S,A01,637333,Gabriel; Corey John,23,0,30,7
1715599596935,SOCI 117,A01,494376,Staff,0,5,5,5
1715599597962,WES 237B,A00,494380,Staff,10,0,20,10
1715599600040,AESE 279B,A00,494370,Wade; Jon P,0,0,33,33
1715599601068,AIP 97,001,660915,Van Den Einde; Yael Dahlia,9999,0,9999,0
1715599602099,AIP 197,001,627712,Vespa; Emanuel Ignacio,9995,0,9999,4
1715599602099,AIP 197,002,650778,Amir; On,9998,0,9999,1
1715599602099,AIP 197,003,650933,Avenancio-Leon; Carlos,9998,0,9999,1
1715599602099,AIP 197,004,658530,Heyman; Gail D.,9998,0,9999,1
1715599602099,AIP 197,005,658631,Neal; Sonya E,9998,0,9999,1
1715599602099,AIP 197,006,658671,Du; Songzi,9998,0,9999,1
1715599603127,ANAR 135S,A00,494369,Braswell; Geoffrey E.,0,0,0,0
1715599604153,BENG 196,001,628496,Engler; Adam J.,9998,0,9999,1
1715599604153,BENG 196,002,660916,Watson; John Thomas,9999,0,9999,0
1715599605184,BISP 197,001,650773,Wilhelm; James E.,9994,0,9999,5
1715599605184,BISP 197,002,658904,Coleman; Aaron B.,9998,0,9999,1
1715599606211,CAT 124RS,A01,519847,Geibel; William,0,0,20,20
1715599607239,CAT 125RS,A01,515971,Geibel; William,0,0,20,20
1715599608266,CLRE 250,A00,511389,Morris; Sheldon,9992,0,9999,7
1715599609294,CLRE 251,A00,507176,Mehta; Ravindra L.,9992,0,9999,7
1715599609294,CLRE 251,B00,511410,Mehta; Ravindra L.,9998,0,9999,1
1715599610321,CLRE 252,A00,507189,Cuomo; Raphael Eduardo,9994,0,9999,5
1715599611350,CLRE 253,A00,507199,Vaida; Florin,9994,0,9999,5
1715599611350,CLRE 253,B00,507202,Vaida; Florin,9999,0,9999,0
1715599612381,CLRE 259,A00,507211,Patel; Hemal,9996,0,9999,3
1715599613407,CLRE 260,A00,507221,Cuomo; Raphael Eduardo,9999,0,9999,0
1715599614435,CLRE 297,001,507242,Cuomo; Raphael Eduardo,9999,0,9999,0
1715599615466,COGS 197,001,638244,Voytek; Bradley Thomas,9997,0,9999,2
1715599616493,CSE 191,A00,516875,Minnes Kemp; Mor Mia,9991,0,9999,8
1715599617522,CSE 197,001,637388,Minnes Kemp; Mor Mia,9992,0,9999,7
1715599618554,CSS 201S,A01,494383,Mignozzetti; Umberto,35,0,35,0
1715599619580,CSS 202S,A01,494387,Mignozzetti; Umberto,35,0,35,0
1715599620608,DSC 197,001,628532,Eldridge; Justin Matthew,9995,0,9999,4
1715599621636,EAP 100,A00,516065,Staff,9799,0,9999,200
1715599622672,ECE 45,A01,507414,Staff,31,0,60,29
1715599624730,ECE 111,A01,507420,Staff,11,0,50,39
1715599625761,ECE 197,001,548057,Sievenpiper; Daniel F.,9991,0,9999,8
1715599626792,EDS 115,A00,507243,Choi; Bailey Miyeon,7,0,28,21
1715599627822,EDS 117,A01,494379,Staff,0,6,34,34
1715599628849,EDS 125,A00,507246,Hopkins; Megan Beth,8,0,30,22
1715599629880,EDS 128A,A01,507264,Fargason; Sharon Gayle,6,0,26,20
1715599630905,EDS 128B,A01,507293,Pappas; Elizabeth,10,0,30,20
1715599631932,EDS 139,A00,507294,Fargason; Sharon Gayle,10,0,30,20
1715599631932,EDS 139,B00,507313,Pappas; Elizabeth,11,0,30,19
1715599632958,EDS 201,A00,507315,Staff,10,0,30,20
1715599633989,EDS 203,A01,507317,Halter; Christopher P.,10,0,30,20
1715599635016,EDS 204R,A01,507319,Halter; Christopher P.,0,3,30,30
1715599635016,EDS 204R,B01,507331,Heinzman; Erica M.,14,0,30,16
1715599636044,EDS 206R,A00,507332,Staff,0,4,30,30
1715599636044,EDS 206R,B00,507343,Staff,15,0,30,15
1715599637076,EDS 250,A00,507344,Hemans; Patricia Ann Benitez,20,0,40,20
1715599638102,EDS 281,A00,507345,Daly; Alan J.,18,0,18,0
1715599639129,EDS 284,A00,507350,Daly; Alan J.,16,0,16,0
1715599640158,EDS 286,A00,507359,Fine; Sarah,18,0,18,0
1715599641182,EDS 289C,A01,507361,Daly; Alan J.,18,0,18,0
1715599642209,EDS 290,A00,507366,Hofstetter; Carolyn,15,0,15,0
1715599643235,LIGM 5A,A00,507421,Fischer-Grunski; Eva K,17,0,20,3
1715599644260,LIGM 5B,A00,507423,Fischer-Grunski; Eva K,19,0,20,1
1715599645292,LIGM 5C,A00,507425,Fischer-Grunski; Eva K,19,0,20,1
1715599646318,LIIT 5AS,A00,507427,Carnelos; Chiara,20,0,20,0
1715599647347,LIIT 5BS,A00,507430,Carnelos; Chiara,20,0,20,0
1715599648374,LIIT 5CS,A00,507432,Carnelos; Chiara,20,0,20,0
1715599649405,LISP 5A,A00,507541,Munoz Sanchez; Alicia,11,0,20,9
1715599650432,LISP 5B,A00,507671,Munoz Sanchez; Alicia,9,0,20,11
1715599651460,LISP 5C,A00,507696,Munoz Sanchez; Alicia,9,0,20,11
1715599652489,MAE 197,001,528363,Boechler; Nicholas Sebastia,9998,0,9999,1
1715599653522,MATH 197,001,523477,Kedlaya; Kiran S.,9994,0,9999,5
1715599653522,MATH 197,002,563811,Zhang; Danna,9994,0,9999,5
1715599653522,MATH 197,003,628552,Dumitriu; Ioana,9998,0,9999,1
1715599653522,MATH 197,004,660885,Floyd; Eric,9999,0,9999,0
1715599654553,MCWP 40R,A00,518780,Staff,2,0,20,18
1715599654553,MCWP 40R,B00,518781,Staff,11,0,20,9
1715599654553,MCWP 40R,C00,518783,Staff,5,0,20,15
1715599655588,MCWP 50R,A00,518791,Staff,0,1,20,20
1715599655588,MCWP 50R,B00,518792,Staff,0,2,20,20
1715599655588,MCWP 50R,C00,518793,Staff,0,4,20,20
1715599655588,MCWP 50R,D00,518794,Staff,0,1,20,20
1715599655588,MCWP 50R,E00,518795,Staff,0,2,20,20
1715599655588,MCWP 50R,F00,518796,Staff,0,1,20,20
1715599655588,MCWP 50R,G00,518797,Staff,0,1,20,20
1715599656615,MMW 12R,A01,514034,Herbst; Matthew,0,2,16,16
1715599656615,MMW 12R,A02,514035,Herbst; Matthew,0,0,16,16
1715599657640,MMW 13R,A01,514037,Staff,0,5,16,16
1715599657640,MMW 13R,A02,514039,Staff,0,5,16,16
1715599657640,MMW 13R,A03,628519,Staff,0,4,16,16
1715599659704,SIO 295LS,A00,523233,Staff,10,0,30,20
1715599660733,SIO 295S,A00,523232,Staff,10,0,30,20
1715599661766,SIOC 290S,A01,637330,Merrifield; Mark A,23,0,30,7
1715599662801,SIOC 291S,A01,637333,Gabriel; Corey John,23,0,30,7
1715599663830,SOCI 117,A01,494376,Staff,0,5,5,5
1715599664858,WES 237B,A00,494380,Staff,10,0,20,10
1715599666936,AESE 279B,A00,494370,Wade; Jon P,0,0,33,33
1715599667966,AIP 97,001,660915,Van Den Einde; Yael Dahlia,9999,0,9999,0
1715599668997,AIP 197,001,627712,Vespa; Emanuel Ignacio,9995,0,9999,4
1715599668997,AIP 197,002,650778,Amir; On,9998,0,9999,1
1715599668997,AIP 197,003,650933,Avenancio-Leon; Carlos,9998,0,9999,1
1715599668997,AIP 197,004,658530,Heyman; Gail D.,9998,0,9999,1
1715599668997,AIP 197,005,658631,Neal; Sonya E,9998,0,9999,1
1715599668997,AIP 197,006,658671,Du; Songzi,9998,0,9999,1
1715599670025,ANAR 135S,A00,494369,Braswell; Geoffrey E.,0,0,0,0
1715599671057,BENG 196,001,628496,Engler; Adam J.,9998,0,9999,1
1715599671057,BENG 196,002,660916,Watson; John Thomas,9999,0,9999,0
1715599672088,BISP 197,001,650773,Wilhelm; James E.,9994,0,9999,5
1715599672088,BISP 197,002,658904,Coleman; Aaron B.,9998,0,9999,1
1715599673114,CAT 124RS,A01,519847,Geibel; William,0,0,20,20
1715599674144,CAT 125RS,A01,515971,Geibel; William,0,0,20,20
1715599675174,CLRE 250,A00,511389,Morris; Sheldon,9992,0,9999,7
1715599676209,CLRE 251,A00,507176,Mehta; Ravindra L.,9992,0,9999,7
1715599676209,CLRE 251,B00,511410,Mehta; Ravindra L.,9998,0,9999,1
1715599677261,CLRE 252,A00,507189,Cuomo; Raphael Eduardo,9994,0,9999,5
1715599678287,CLRE 253,A00,507199,Vaida; Florin,9994,0,9999,5
1715599678287,CLRE 253,B00,507202,Vaida; Florin,9999,0,9999,0
1715599679314,CLRE 259,A00,507211,Patel; Hemal,9996,0,9999,3
1715599680340,CLRE 260,A00,507221,Cuomo; Raphael Eduardo,9999,0,9999,0
1715599681368,CLRE 297,001,507242,Cuomo; Raphael Eduardo,9999,0,9999,0
1715599682395,COGS 197,001,638244,Voytek; Bradley Thomas,9997,0,9999,2
1715599683421,CSE 191,A00,516875,Minnes Kemp; Mor Mia,9991,0,9999,8
1715599684449,CSE 197,001,637388,Minnes Kemp; Mor Mia,9992,0,9999,7
1715599685475,CSS 201S,A01,494383,Mignozzetti; Umberto,35,0,35,0
1715599686501,CSS 202S,A01,494387,Mignozzetti; Umberto,35,0,35,0
1715599687527,DSC 197,001,628532,Eldridge; Justin Matthew,9995,0,9999,4
1715599688555,EAP 100,A00,516065,Staff,9799,0,9999,200
1715599689584,ECE 45,A01,507414,Staff,31,0,60,29
1715599691637,ECE 111,A01,507420,Staff,11,0,50,39
1715599692664,ECE 197,001,548057,Sievenpiper; Daniel F.,9991,0,9999,8
1715599693691,EDS 115,A00,507243,Choi; Bailey Miyeon,7,0,28,21
1715599694721,EDS 117,A01,494379,Staff,0,6,34,34
1715599695751,EDS 125,A00,507246,Hopkins; Megan Beth,8,0,30,22
1715599696777,EDS 128A,A01,507264,Fargason; Sharon Gayle,6,0,26,20
1715599697804,EDS 128B,A01,507293,Pappas; Elizabeth,10,0,30,20
1715599698831,EDS 139,A00,507294,Fargason; Sharon Gayle,10,0,30,20
1715599698831,EDS 139,B00,507313,Pappas; Elizabeth,11,0,30,19
1715599699860,EDS 201,A00,507315,Staff,10,0,30,20
1715599700888,EDS 203,A01,507317,Halter; Christopher P.,10,0,30,20
1715599701919,EDS 204R,A01,507319,Halter; Christopher P.,0,3,30,30
1715599701919,EDS 204R,B01,507331,Heinzman; Erica M.,14,0,30,16
1715599702948,EDS 206R,A00,507332,Staff,0,4,30,30
1715599702948,EDS 206R,B00,507343,Staff,15,0,30,15
1715599703975,EDS 250,A00,507344,Hemans; Patricia Ann Benitez,20,0,40,20
1715599705002,EDS 281,A00,507345,Daly; Alan J.,18,0,18,0
1715599706057,EDS 284,A00,507350,Daly; Alan J.,16,0,16,0
1715599707116,EDS 286,A00,507359,Fine; Sarah,18,0,18,0
1715599708148,EDS 289C,A01,507361,Daly; Alan J.,18,0,18,0
1715599709176,EDS 290,A00,507366,Hofstetter; Carolyn,15,0,15,0
1715599710204,LIGM 5A,A00,507421,Fischer-Grunski; Eva K,17,0,20,3
1715599711235,LIGM 5B,A00,507423,Fischer-Grunski; Eva K,19,0,20,1
1715599712265,LIGM 5C,A00,507425,Fischer-Grunski; Eva K,19,0,20,1
1715599713293,LIIT 5AS,A00,507427,Carnelos; Chiara,20,0,20,0
1715599714319,LIIT 5BS,A00,507430,Carnelos; Chiara,20,0,20,0
1715599715349,LIIT 5CS,A00,507432,Carnelos; Chiara,20,0,20,0
1715599716381,LISP 5A,A00,507541,Munoz Sanchez; Alicia,11,0,20,9
1715599717417,LISP 5B,A00,507671,Munoz Sanchez; Alicia,9,0,20,11
1715599718468,LISP 5C,A00,507696,Munoz Sanchez; Alicia,9,0,20,11
1715599719522,MAE 197,001,528363,Boechler; Nicholas Sebastia,9998,0,9999,1
1715599720589,MATH 197,001,523477,Kedlaya; Kiran S.,9994,0,9999,5
1715599720589,MATH 197,002,563811,Zhang; Danna,9994,0,9999,5
1715599720589,MATH 197,003,628552,Dumitriu; Ioana,9998,0,9999,1
1715599720589,MATH 197,004,660885,Floyd; Eric,9999,0,9999,0
1715599721678,MCWP 40R,A00,518780,Staff,2,0,20,18
1715599721678,MCWP 40R,B00,518781,Staff,11,0,20,9
1715599721678,MCWP 40R,C00,518783,Staff,5,0,20,15
1715599722741,MCWP 50R,A00,518791,Staff,0,1,20,20
1715599722741,MCWP 50R,B00,518792,Staff,0,2,20,20
1715599722741,MCWP 50R,C00,518793,Staff,0,4,20,20
1715599722741,MCWP 50R,D00,518794,Staff,0,1,20,20
1715599722741,MCWP 50R,E00,518795,Staff,0,2,20,20
1715599722741,MCWP 50R,F00,518796,Staff,0,1,20,20
1715599722741,MCWP 50R,G00,518797,Staff,0,1,20,20
1715599723808,MMW 12R,A01,514034,Herbst; Matthew,0,2,16,16
1715599723808,MMW 12R,A02,514035,Herbst; Matthew,0,0,16,16
1715599724867,MMW 13R,A01,514037,Staff,0,5,16,16
1715599724867,MMW 13R,A02,514039,Staff,0,5,16,16
1715599724867,MMW 13R,A03,628519,Staff,0,4,16,16
1715599726949,SIO 295LS,A00,523233,Staff,10,0,30,20
1715599728119,SIO 295S,A00,523232,Staff,10,0,30,20
1715599729162,SIOC 290S,A01,637330,Merrifield; Mark A,23,0,30,7
1715599730246,SIOC 291S,A01,637333,Gabriel; Corey John,23,0,30,7
1715599731285,SOCI 117,A01,494376,Staff,0,5,5,5
1715599732321,WES 237B,A00,494380,Staff,10,0,20,10
1715599734430,AESE 279B,A00,494370,Wade; Jon P,0,0,33,33
1715599735458,AIP 97,001,660915,Van Den Einde; Yael Dahlia,9999,0,9999,0
1715599736486,AIP 197,001,627712,Vespa; Emanuel Ignacio,9995,0,9999,4
1715599736486,AIP 197,002,650778,Amir; On,9998,0,9999,1
1715599736486,AIP 197,003,650933,Avenancio-Leon; Carlos,9998,0,9999,1
1715599736486,AIP 197,004,658530,Heyman; Gail D.,9998,0,9999,1
1715599736486,AIP 197,005,658631,Neal; Sonya E,9998,0,9999,1
1715599736486,AIP 197,006,658671,Du; Songzi,9998,0,9999,1
1715599737517,ANAR 135S,A00,494369,Braswell; Geoffrey E.,0,0,0,0
1715599738542,BENG 196,001,628496,Engler; Adam J.,9998,0,9999,1
1715599738542,BENG 196,002,660916,Watson; John Thomas,9999,0,9999,0
1715599739567,BISP 197,001,650773,Wilhelm; James E.,9994,0,9999,5
1715599739567,BISP 197,002,658904,Coleman; Aaron B.,9998,0,9999,1
1715599740600,CAT 124RS,A01,519847,Geibel; William,0,0,20,20
1715599741629,CAT 125RS,A01,515971,Geibel; William,0,0,20,20
1715599742655,CLRE 250,A00,511389,Morris; Sheldon,9992,0,9999,7
1715599743683,CLRE 251,A00,507176,Mehta; Ravindra L.,9992,0,9999,7
1715599743683,CLRE 251,B00,511410,Mehta; Ravindra L.,9998,0,9999,1
1715599744710,CLRE 252,A00,507189,Cuomo; Raphael Eduardo,9994,0,9999,5
1715599745737,CLRE 253,A00,507199,Vaida; Florin,9994,0,9999,5
1715599745737,CLRE 253,B00,507202,Vaida; Florin,9999,0,9999,0
1715599746765,CLRE 259,A00,507211,Patel; Hemal,9996,0,9999,3
1715599747791,CLRE 260,A00,507221,Cuomo; Raphael Eduardo,9999,0,9999,0
1715599748821,CLRE 297,001,507242,Cuomo; Raphael Eduardo,9999,0,9999,0
1715599749848,COGS 197,001,638244,Voytek; Bradley Thomas,9997,0,9999,2
1715599750876,CSE 191,A00,516875,Minnes Kemp; Mor Mia,9991,0,9999,8
1715599751904,CSE 197,001,637388,Minnes Kemp; Mor Mia,9992,0,9999,7
1715599752937,CSS 201S,A01,494383,Mignozzetti; Umberto,35,0,35,0
1715599753964,CSS 202S,A01,494387,Mignozzetti; Umberto,35,0,35,0
1715599754994,DSC 197,001,628532,Eldridge; Justin Matthew,9995,0,9999,4
1715599756023,EAP 100,A00,516065,Staff,9799,0,9999,200
1715599757053,ECE 45,A01,507414,Staff,31,0,60,29
1715599759111,ECE 111,A01,507420,Staff,11,0,50,39
1715599760142,ECE 197,001,548057,Sievenpiper; Daniel F.,9991,0,9999,8
1715599761171,EDS 115,A00,507243,Choi; Bailey Miyeon,7,0,28,21
1715599762200,EDS 117,A01,494379,Staff,0,6,34,34
1715599763230,EDS 125,A00,507246,Hopkins; Megan Beth,8,0,30,22
1715599764262,EDS 128A,A01,507264,Fargason; Sharon Gayle,6,0,26,20
1715599765297,EDS 128B,A01,507293,Pappas; Elizabeth,10,0,30,20
1715599766325,EDS 139,A00,507294,Fargason; Sharon Gayle,10,0,30,20
1715599766325,EDS 139,B00,507313,Pappas; Elizabeth,11,0,30,19
1715599767358,EDS 201,A00,507315,Staff,10,0,30,20
1715599768389,EDS 203,A01,507317,Halter; Christopher P.,10,0,30,20
1715599769421,EDS 204R,A01,507319,Halter; Christopher P.,0,3,30,30
1715599769421,EDS 204R,B01,507331,Heinzman; Erica M.,14,0,30,16
1715599770452,EDS 206R,A00,507332,Staff,0,4,30,30
1715599770452,EDS 206R,B00,507343,Staff,15,0,30,15
1715599771487,EDS 250,A00,507344,Hemans; Patricia Ann Benitez,20,0,40,20
1715599772517,EDS 281,A00,507345,Daly; Alan J.,18,0,18,0
1715599773546,EDS 284,A00,507350,Daly; Alan J.,16,0,16,0
1715599774574,EDS 286,A00,507359,Fine; Sarah,18,0,18,0
1715599775605,EDS 289C,A01,507361,Daly; Alan J.,18,0,18,0
1715599776634,EDS 290,A00,507366,Hofstetter; Carolyn,15,0,15,0
1715599777663,LIGM 5A,A00,507421,Fischer-Grunski; Eva K,17,0,20,3
1715599778693,LIGM 5B,A00,507423,Fischer-Grunski; Eva K,19,0,20,1
1715599779723,LIGM 5C,A00,507425,Fischer-Grunski; Eva K,19,0,20,1
1715599780754,LIIT 5AS,A00,507427,Carnelos; Chiara,20,0,20,0
1715599781780,LIIT 5BS,A00,507430,Carnelos; Chiara,20,0,20,0
1715599782808,LIIT 5CS,A00,507432,Carnelos; Chiara,20,0,20,0
1715599783842,LISP 5A,A00,507541,Munoz Sanchez; Alicia,11,0,20,9
1715599784870,LISP 5B,A00,507671,Munoz Sanchez; Alicia,9,0,20,11
1715599785900,LISP 5C,A00,507696,Munoz Sanchez; Alicia,9,0,20,11
1715599786931,MAE 197,001,528363,Boechler; Nicholas Sebastia,9998,0,9999,1
1715599787966,MATH 197,001,523477,Kedlaya; Kiran S.,9994,0,9999,5
1715599787966,MATH 197,002,563811,Zhang; Danna,9994,0,9999,5
1715599787966,MATH 197,003,628552,Dumitriu; Ioana,9998,0,9999,1
1715599787966,MATH 197,004,660885,Floyd; Eric,9999,0,9999,0
1715599788997,MCWP 40R,A00,518780,Staff,2,0,20,18
1715599788997,MCWP 40R,B00,518781,Staff,11,0,20,9
1715599788997,MCWP 40R,C00,518783,Staff,5,0,20,15
1715599790028,MCWP 50R,A00,518791,Staff,0,1,20,20
1715599790028,MCWP 50R,B00,518792,Staff,0,2,20,20
1715599790028,MCWP 50R,C00,518793,Staff,0,4,20,20
1715599790028,MCWP 50R,D00,518794,Staff,0,1,20,20
1715599790028,MCWP 50R,E00,518795,Staff,0,2,20,20
1715599790028,MCWP 50R,F00,518796,Staff,0,1,20,20
1715599790028,MCWP 50R,G00,518797,Staff,0,1,20,20
1715599791061,MMW 12R,A01,514034,Herbst; Matthew,0,2,16,16
1715599791061,MMW 12R,A02,514035,Herbst; Matthew,0,0,16,16
1715599792090,MMW 13R,A01,514037,Staff,0,5,16,16
1715599792090,MMW 13R,A02,514039,Staff,0,5,16,16
1715599792090,MMW 13R,A03,628519,Staff,0,4,16,16
1715599794144,SIO 295LS,A00,523233,Staff,10,0,30,20
1715599795174,SIO 295S,A00,523232,Staff,10,0,30,20
1715599796203,SIOC 290S,A01,637330,Merrifield; Mark A,23,0,30,7
1715599797230,SIOC 291S,A01,637333,Gabriel; Corey John,23,0,30,7
1715599798262,SOCI 117,A01,494376,Staff,0,5,5,5
1715599799290,WES 237B,A00,494380,Staff,10,0,20,10
1715599801381,AESE 279B,A00,494370,Wade; Jon P,0,0,33,33
1715599802407,AIP 97,001,660915,Van Den Einde; Yael Dahlia,9999,0,9999,0
1715599803437,AIP 197,001,627712,Vespa; Emanuel Ignacio,9995,0,9999,4
1715599803437,AIP 197,002,650778,Amir; On,9998,0,9999,1
1715599803437,AIP 197,003,650933,Avenancio-Leon; Carlos,9998,0,9999,1
1715599803437,AIP 197,004,658530,Heyman; Gail D.,9998,0,9999,1
1715599803437,AIP 197,005,658631,Neal; Sonya E,9998,0,9999,1
1715599803437,AIP 197,006,658671,Du; Songzi,9998,0,9999,1
1715599804469,ANAR 135S,A00,494369,Braswell; Geoffrey E.,0,0,0,0
1715599805498,BENG 196,001,628496,Engler; Adam J.,9998,0,9999,1
1715599805498,BENG 196,002,660916,Watson; John Thomas,9999,0,9999,0
1715599806524,BISP 197,001,650773,Wilhelm; James E.,9994,0,9999,5
1715599806524,BISP 197,002,658904,Coleman; Aaron B.,9998,0,9999,1
1715599807549,CAT 124RS,A01,519847,Geibel; William,0,0,20,20
1715599808576,CAT 125RS,A01,515971,Geibel; William,0,0,20,20
1715599809608,CLRE 250,A00,511389,Morris; Sheldon,9992,0,9999,7
1715599810639,CLRE 251,A00,507176,Mehta; Ravindra L.,9992,0,9999,7
1715599810639,CLRE 251,B00,511410,Mehta; Ravindra L.,9998,0,9999,1
1715599811668,CLRE 252,A00,507189,Cuomo; Raphael Eduardo,9994,0,9999,5
1715599812696,CLRE 253,A00,507199,Vaida; Florin,9994,0,9999,5
1715599812696,CLRE 253,B00,507202,Vaida; Florin,9999,0,9999,0
1715599813721,CLRE 259,A00,507211,Patel; Hemal,9996,0,9999,3
1715599814746,CLRE 260,A00,507221,Cuomo; Raphael Eduardo,9999,0,9999,0
1715599815778,CLRE 297,001,507242,Cuomo; Raphael Eduardo,9999,0,9999,0
1715599816804,COGS 197,001,638244,Voytek; Bradley Thomas,9997,0,9999,2
1715599817828,CSE 191,A00,516875,Minnes Kemp; Mor Mia,9991,0,9999,8
1715599818852,CSE 197,001,637388,Minnes Kemp; Mor Mia,9992,0,9999,7
1715599819882,CSS 201S,A01,494383,Mignozzetti; Umberto,35,0,35,0
1715599820911,CSS 202S,A01,494387,Mignozzetti; Umberto,35,0,35,0
1715599821936,DSC 197,001,628532,Eldridge; Justin Matthew,9995,0,9999,4
1715599822960,EAP 100,A00,516065,Staff,9799,0,9999,200
1715599823986,ECE 45,A01,507414,Staff,31,0,60,29
1715599826044,ECE 111,A01,507420,Staff,11,0,50,39
1715599827073,ECE 197,001,548057,Sievenpiper; Daniel F.,9991,0,9999,8
1715599828098,EDS 115,A00,507243,Choi; Bailey Miyeon,7,0,28,21
1715599829126,EDS 117,A01,494379,Staff,0,6,34,34
1715599830154,EDS 125,A00,507246,Hopkins; Megan Beth,8,0,30,22
1715599831185,EDS 128A,A01,507264,Fargason; Sharon Gayle,6,0,26,20
1715599832213,EDS 128B,A01,507293,Pappas; Elizabeth,10,0,30,20
1715599833240,EDS 139,A00,507294,Fargason; Sharon Gayle,10,0,30,20
1715599833240,EDS 139,B00,507313,Pappas; Elizabeth,11,0,30,19
1715599834269,EDS 201,A00,507315,Staff,10,0,30,20
1715599835301,EDS 203,A01,507317,Halter; Christopher P.,10,0,30,20
1715599836328,EDS 204R,A01,507319,Halter; Christopher P.,0,3,30,30
1715599836328,EDS 204R,B01,507331,Heinzman; Erica M.,14,0,30,16
1715599837355,EDS 206R,A00,507332,Staff,0,4,30,30
1715599837355,EDS 206R,B00,507343,Staff,15,0,30,15
1715599838384,EDS 250,A00,507344,Hemans; Patricia Ann Benitez,20,0,40,20
1715599839414,EDS 281,A00,507345,Daly; Alan J.,18,0,18,0
1715599840443,EDS 284,A00,507350,Daly; Alan J.,16,0,16,0
1715599841475,EDS 286,A00,507359,Fine; Sarah,18,0,18,0
1715599842503,EDS 289C,A01,507361,Daly; Alan J.,18,0,18,0
1715599843529,EDS 290,A00,507366,Hofstetter; Carolyn,15,0,15,0
1715599844557,LIGM 5A,A00,507421,Fischer-Grunski; Eva K,17,0,20,3
1715599845585,LIGM 5B,A00,507423,Fischer-Grunski; Eva K,19,0,20,1
1715599846609,LIGM 5C,A00,507425,Fischer-Grunski; Eva K,19,0,20,1
1715599847639,LIIT 5AS,A00,507427,Carnelos; Chiara,20,0,20,0
1715599848666,LIIT 5BS,A00,507430,Carnelos; Chiara,20,0,20,0
1715599849694,LIIT 5CS,A00,507432,Carnelos; Chiara,20,0,20,0
1715599850727,LISP 5A,A00,507541,Munoz Sanchez; Alicia,11,0,20,9
1715599851757,LISP 5B,A00,507671,Munoz Sanchez; Alicia,9,0,20,11
1715599852785,LISP 5C,A00,507696,Munoz Sanchez; Alicia,9,0,20,11
1715599853815,MAE 197,001,528363,Boechler; Nicholas Sebastia,9998,0,9999,1
1715599854844,MATH 197,001,523477,Kedlaya; Kiran S.,9994,0,9999,5
1715599854844,MATH 197,002,563811,Zhang; Danna,9994,0,9999,5
1715599854844,MATH 197,003,628552,Dumitriu; Ioana,9998,0,9999,1
1715599854844,MATH 197,004,660885,Floyd; Eric,9999,0,9999,0
1715599855876,MCWP 40R,A00,518780,Staff,2,0,20,18
1715599855876,MCWP 40R,B00,518781,Staff,11,0,20,9
1715599855876,MCWP 40R,C00,518783,Staff,5,0,20,15
1715599856902,MCWP 50R,A00,518791,Staff,0,1,20,20
1715599856902,MCWP 50R,B00,518792,Staff,0,2,20,20
1715599856902,MCWP 50R,C00,518793,Staff,0,4,20,20
1715599856902,MCWP 50R,D00,518794,Staff,0,1,20,20
1715599856902,MCWP 50R,E00,518795,Staff,0,2,20,20
1715599856902,MCWP 50R,F00,518796,Staff,0,1,20,20
1715599856902,MCWP 50R,G00,518797,Staff,0,1,20,20
1715599857933,MMW 12R,A01,514034,Herbst; Matthew,0,2,16,16
1715599857933,MMW 12R,A02,514035,Herbst; Matthew,0,0,16,16
1715599858959,MMW 13R,A01,514037,Staff,0,5,16,16
1715599858959,MMW 13R,A02,514039,Staff,0,5,16,16
1715599858959,MMW 13R,A03,628519,Staff,0,4,16,16
1715599861122,SIO 295LS,A00,523233,Staff,10,0,30,20
1715599862150,SIO 295S,A00,523232,Staff,10,0,30,20
1715599863179,SIOC 290S,A01,637330,Merrifield; Mark A,23,0,30,7
1715599864206,SIOC 291S,A01,637333,Gabriel; Corey John,23,0,30,7
1715599865234,SOCI 117,A01,494376,Staff,0,5,5,5
1715599866266,WES 237B,A00,494380,Staff,10,0,20,10
1715599868339,AESE 279B,A00,494370,Wade; Jon P,0,0,33,33
1715599869365,AIP 97,001,660915,Van Den Einde; Yael Dahlia,9999,0,9999,0
1715599870394,AIP 197,001,627712,Vespa; Emanuel Ignacio,9995,0,9999,4
1715599870394,AIP 197,002,650778,Amir; On,9998,0,9999,1
1715599870394,AIP 197,003,650933,Avenancio-Leon; Carlos,9998,0,9999,1
1715599870394,AIP 197,004,658530,Heyman; Gail D.,9998,0,9999,1
1715599870394,AIP 197,005,658631,Neal; Sonya E,9998,0,9999,1
1715599870394,AIP 197,006,658671,Du; Songzi,9998,0,9999,1
1715599871419,ANAR 135S,A00,494369,Braswell; Geoffrey E.,0,0,0,0
1715599872449,BENG 196,001,628496,Engler; Adam J.,9998,0,9999,1
1715599872449,BENG 196,002,660916,Watson; John Thomas,9999,0,9999,0
1715599873476,BISP 197,001,650773,Wilhelm; James E.,9994,0,9999,5
1715599873476,BISP 197,002,658904,Coleman; Aaron B.,9998,0,9999,1
1715599874509,CAT 124RS,A01,519847,Geibel; William,0,0,20,20
1715599875536,CAT 125RS,A01,515971,Geibel; William,0,0,20,20
1715599876566,CLRE 250,A00,511389,Morris; Sheldon,9992,0,9999,7
1715599877599,CLRE 251,A00,507176,Mehta; Ravindra L.,9992,0,9999,7
1715599877599,CLRE 251,B00,511410,Mehta; Ravindra L.,9998,0,9999,1
1715599878627,CLRE 252,A00,507189,Cuomo; Raphael Eduardo,9994,0,9999,5
1715599879656,CLRE 253,A00,507199,Vaida; Florin,9994,0,9999,5
1715599879656,CLRE 253,B00,507202,Vaida; Florin,9999,0,9999,0
1715599880684,CLRE 259,A00,507211,Patel; Hemal,9996,0,9999,3
1715599881709,CLRE 260,A00,507221,Cuomo; Raphael Eduardo,9999,0,9999,0
1715599882737,CLRE 297,001,507242,Cuomo; Raphael Eduardo,9999,0,9999,0
1715599883763,COGS 197,001,638244,Voytek; Bradley Thomas,9997,0,9999,2
1715599884792,CSE 191,A00,516875,Minnes Kemp; Mor Mia,9991,0,9999,8
1715599885818,CSE 197,001,637388,Minnes Kemp; Mor Mia,9992,0,9999,7
1715599886850,CSS 201S,A01,494383,Mignozzetti; Umberto,35,0,35,0
1715599887880,CSS 202S,A01,494387,Mignozzetti; Umberto,35,0,35,0
1715599888906,DSC 197,001,628532,Eldridge; Justin Matthew,9995,0,9999,4
1715599889933,EAP 100,A00,516065,Staff,9799,0,9999,200
1715599890959,ECE 45,A01,507414,Staff,31,0,60,29
1715599893017,ECE 111,A01,507420,Staff,11,0,50,39
1715599894048,ECE 197,001,548057,Sievenpiper; Daniel F.,9991,0,9999,8
1715599895077,EDS 115,A00,507243,Choi; Bailey Miyeon,7,0,28,21
1715599896103,EDS 117,A01,494379,Staff,0,6,34,34
1715599897131,EDS 125,A00,507246,Hopkins; Megan Beth,8,0,30,22
1715599898160,EDS 128A,A01,507264,Fargason; Sharon Gayle,6,0,26,20
1715599899187,EDS 128B,A01,507293,Pappas; Elizabeth,10,0,30,20
1715599900216,EDS 139,A00,507294,Fargason; Sharon Gayle,10,0,30,20
1715599900216,EDS 139,B00,507313,Pappas; Elizabeth,11,0,30,19
1715599901242,EDS 201,A00,507315,Staff,10,0,30,20
1715599902272,EDS 203,A01,507317,Halter; Christopher P.,10,0,30,20
1715599903300,EDS 204R,A01,507319,Halter; Christopher P.,0,3,30,30
1715599903300,EDS 204R,B01,507331,Heinzman; Erica M.,14,0,30,16
1715599904331,EDS 206R,A00,507332,Staff,0,4,30,30
1715599904331,EDS 206R,B00,507343,Staff,15,0,30,15
1715599905359,EDS 250,A00,507344,Hemans; Patricia Ann Benitez,20,0,40,20
1715599906386,EDS 281,A00,507345,Daly; Alan J.,18,0,18,0
1715599907416,EDS 284,A00,507350,Daly; Alan J.,16,0,16,0
1715599908445,EDS 286,A00,507359,Fine; Sarah,18,0,18,0
1715599909471,EDS 289C,A01,507361,Daly; Alan J.,18,0,18,0
1715599910500,EDS 290,A00,507366,Hofstetter; Carolyn,15,0,15,0
1715599911528,LIGM 5A,A00,507421,Fischer-Grunski; Eva K,17,0,20,3
1715599912562,LIGM 5B,A00,507423,Fischer-Grunski; Eva K,19,0,20,1
1715599913588,LIGM 5C,A00,507425,Fischer-Grunski; Eva K,19,0,20,1
1715599914617,LIIT 5AS,A00,507427,Carnelos; Chiara,20,0,20,0
1715599915644,LIIT 5BS,A00,507430,Carnelos; Chiara,20,0,20,0
1715599916675,LIIT 5CS,A00,507432,Carnelos; Chiara,20,0,20,0
1715599917704,LISP 5A,A00,507541,Munoz Sanchez; Alicia,11,0,20,9
1715599918732,LISP 5B,A00,507671,Munoz Sanchez; Alicia,9,0,20,11
1715599919762,LISP 5C,A00,507696,Munoz Sanchez; Alicia,9,0,20,11
1715599920789,MAE 197,001,528363,Boechler; Nicholas Sebastia,9998,0,9999,1
1715599921821,MATH 197,001,523477,Kedlaya; Kiran S.,9994,0,9999,5
1715599921821,MATH 197,002,563811,Zhang; Danna,9994,0,9999,5
1715599921821,MATH 197,003,628552,Dumitriu; Ioana,9998,0,9999,1
1715599921821,MATH 197,004,660885,Floyd; Eric,9999,0,9999,0
1715599922848,MCWP 40R,A00,518780,Staff,2,0,20,18
1715599922848,MCWP 40R,B00,518781,Staff,11,0,20,9
1715599922848,MCWP 40R,C00,518783,Staff,5,0,20,15
1715599923878,MCWP 50R,A00,518791,Staff,0,1,20,20
1715599923878,MCWP 50R,B00,518792,Staff,0,2,20,20
1715599923878,MCWP 50R,C00,518793,Staff,0,4,20,20
1715599923878,MCWP 50R,D00,518794,Staff,0,1,20,20
1715599923878,MCWP 50R,E00,518795,Staff,0,2,20,20
1715599923878,MCWP 50R,F00,518796,Staff,0,1,20,20
1715599923878,MCWP 50R,G00,518797,Staff,0,1,20,20
1715599924904,MMW 12R,A01,514034,Herbst; Matthew,0,2,16,16
1715599924904,MMW 12R,A02,514035,Herbst; Matthew,0,0,16,16
1715599925930,MMW 13R,A01,514037,Staff,0,5,16,16
1715599925930,MMW 13R,A02,514039,Staff,0,5,16,16
1715599925930,MMW 13R,A03,628519,Staff,0,4,16,16
1715599927985,SIO 295LS,A00,523233,Staff,10,0,30,20
1715599929011,SIO 295S,A00,523232,Staff,10,0,30,20
1715599930043,SIOC 290S,A01,637330,Merrifield; Mark A,23,0,30,7
1715599931072,SIOC 291S,A01,637333,Gabriel; Corey John,23,0,30,7
1715599932103,SOCI 117,A01,494376,Staff,0,5,5,5
1715599933131,WES 237B,A00,494380,Staff,10,0,20,10
1715599935209,AESE 279B,A00,494370,Wade; Jon P,0,0,33,33
1715599936240,AIP 97,001,660915,Van Den Einde; Yael Dahlia,9999,0,9999,0
1715599937271,AIP 197,001,627712,Vespa; Emanuel Ignacio,9995,0,9999,4
1715599937271,AIP 197,002,650778,Amir; On,9998,0,9999,1
1715599937271,AIP 197,003,650933,Avenancio-Leon; Carlos,9998,0,9999,1
1715599937271,AIP 197,004,658530,Heyman; Gail D.,9998,0,9999,1
1715599937271,AIP 197,005,658631,Neal; Sonya E,9998,0,9999,1
1715599937271,AIP 197,006,658671,Du; Songzi,9998,0,9999,1
1715599938298,ANAR 135S,A00,494369,Braswell; Geoffrey E.,0,0,0,0
1715599939329,BENG 196,001,628496,Engler; Adam J.,9998,0,9999,1
1715599939329,BENG 196,002,660916,Watson; John Thomas,9999,0,9999,0
1715599940355,BISP 197,001,650773,Wilhelm; James E.,9994,0,9999,5
1715599940355,BISP 197,002,658904,Coleman; Aaron B.,9998,0,9999,1
1715599941385,CAT 124RS,A01,519847,Geibel; William,0,0,20,20
1715599942415,CAT 125RS,A01,515971,Geibel; William,0,0,20,20
1715599943443,CLRE 250,A00,511389,Morris; Sheldon,9992,0,9999,7
1715599944473,CLRE 251,A00,507176,Mehta; Ravindra L.,9992,0,9999,7
1715599944473,CLRE 251,B00,511410,Mehta; Ravindra L.,9998,0,9999,1
1715599945499,CLRE 252,A00,507189,Cuomo; Raphael Eduardo,9994,0,9999,5
1715599946526,CLRE 253,A00,507199,Vaida; Florin,9994,0,9999,5
1715599946526,CLRE 253,B00,507202,Vaida; Florin,9999,0,9999,0
1715599947551,CLRE 259,A00,507211,Patel; Hemal,9996,0,9999,3
1715599948581,CLRE 260,A00,507221,Cuomo; Raphael Eduardo,9999,0,9999,0
1715599949607,CLRE 297,001,507242,Cuomo; Raphael Eduardo,9999,0,9999,0
1715599950635,COGS 197,001,638244,Voytek; Bradley Thomas,9997,0,9999,2
1715599951662,CSE 191,A00,516875,Minnes Kemp; Mor Mia,9991,0,9999,8
1715599952695,CSE 197,001,637388,Minnes Kemp; Mor Mia,9992,0,9999,7
1715599953729,CSS 201S,A01,494383,Mignozzetti; Umberto,35,0,35,0
1715599954756,CSS 202S,A01,494387,Mignozzetti; Umberto,35,0,35,0
1715599955785,DSC 197,001,628532,Eldridge; Justin Matthew,9995,0,9999,4
1715599956812,EAP 100,A00,516065,Staff,9799,0,9999,200
1715599957842,ECE 45,A01,507414,Staff,31,0,60,29
1715599959897,ECE 111,A01,507420,Staff,11,0,50,39
1715599960924,ECE 197,001,548057,Sievenpiper; Daniel F.,9991,0,9999,8
1715599961955,EDS 115,A00,507243,Choi; Bailey Miyeon,7,0,28,21
1715599962981,EDS 117,A01,494379,Staff,0,6,34,34
1715599964008,EDS 125,A00,507246,Hopkins; Megan Beth,8,0,30,22
1715599965038,EDS 128A,A01,507264,Fargason; Sharon Gayle,6,0,26,20
1715599966065,EDS 128B,A01,507293,Pappas; Elizabeth,10,0,30,20
1715599967090,EDS 139,A00,507294,Fargason; Sharon Gayle,10,0,30,20
1715599967090,EDS 139,B00,507313,Pappas; Elizabeth,11,0,30,19
1715599968117,EDS 201,A00,507315,Staff,10,0,30,20
1715599969147,EDS 203,A01,507317,Halter; Christopher P.,10,0,30,20
1715599970178,EDS 204R,A01,507319,Halter; Christopher P.,0,3,30,30
1715599970178,EDS 204R,B01,507331,Heinzman; Erica M.,14,0,30,16
1715599971206,EDS 206R,A00,507332,Staff,0,4,30,30
1715599971206,EDS 206R,B00,507343,Staff,15,0,30,15
1715599972233,EDS 250,A00,507344,Hemans; Patricia Ann Benitez,20,0,40,20
1715599973263,EDS 281,A00,507345,Daly; Alan J.,18,0,18,0
1715599974289,EDS 284,A00,507350,Daly; Alan J.,16,0,16,0
1715599975315,EDS 286,A00,507359,Fine; Sarah,18,0,18,0
1715599976346,EDS 289C,A01,507361,Daly; Alan J.,18,0,18,0
1715599977374,EDS 290,A00,507366,Hofstetter; Carolyn,15,0,15,0
1715599978401,LIGM 5A,A00,507421,Fischer-Grunski; Eva K,17,0,20,3
1715599979428,LIGM 5B,A00,507423,Fischer-Grunski; Eva K,19,0,20,1
1715599980457,LIGM 5C,A00,507425,Fischer-Grunski; Eva K,19,0,20,1
1715599981490,LIIT 5AS,A00,507427,Carnelos; Chiara,20,0,20,0
1715599982516,LIIT 5BS,A00,507430,Carnelos; Chiara,20,0,20,0
1715599983543,LIIT 5CS,A00,507432,Carnelos; Chiara,20,0,20,0
1715599984570,LISP 5A,A00,507541,Munoz Sanchez; Alicia,11,0,20,9
1715599985598,LISP 5B,A00,507671,Munoz Sanchez; Alicia,9,0,20,11
1715599986627,LISP 5C,A00,507696,Munoz Sanchez; Alicia,9,0,20,11
1715599987654,MAE 197,001,528363,Boechler; Nicholas Sebastia,9998,0,9999,1
1715599988683,MATH 197,001,523477,Kedlaya; Kiran S.,9994,0,9999,5
1715599988683,MATH 197,002,563811,Zhang; Danna,9994,0,9999,5
1715599988683,MATH 197,003,628552,Dumitriu; Ioana,9998,0,9999,1
1715599988683,MATH 197,004,660885,Floyd; Eric,9999,0,9999,0
1715599989715,MCWP 40R,A00,518780,Staff,2,0,20,18
1715599989715,MCWP 40R,B00,518781,Staff,11,0,20,9
1715599989715,MCWP 40R,C00,518783,Staff,5,0,20,15
1715599990744,MCWP 50R,A00,518791,Staff,0,1,20,20
1715599990744,MCWP 50R,B00,518792,Staff,0,2,20,20
1715599990744,MCWP 50R,C00,518793,Staff,0,4,20,20
1715599990744,MCWP 50R,D00,518794,Staff,0,1,20,20
1715599990744,MCWP 50R,E00,518795,Staff,0,2,20,20
1715599990744,MCWP 50R,F00,518796,Staff,0,1,20,20
1715599990744,MCWP 50R,G00,518797,Staff,0,1,20,20
1715599991772,MMW 12R,A01,514034,Herbst; Matthew,0,2,16,16
1715599991772,MMW 12R,A02,514035,Herbst; Matthew,0,0,16,16
1715599992803,MMW 13R,A01,514037,Staff,0,5,16,16
1715599992803,MMW 13R,A02,514039,Staff,0,5,16,16
1715599992803,MMW 13R,A03,628519,Staff,0,4,16,16
1715599994858,SIO 295LS,A00,523233,Staff,10,0,30,20
1715599995885,SIO 295S,A00,523232,Staff,10,0,30,20
1715599996911,SIOC 290S,A01,637330,Merrifield; Mark A,23,0,30,7
1715599997939,SIOC 291S,A01,637333,Gabriel; Corey John,23,0,30,7
1715599998968,SOCI 117,A01,494376,Staff,0,5,5,5
1715599999992,WES 237B,A00,494380,Staff,10,0,20,10
1715600002076,AESE 279B,A00,494370,Wade; Jon P,0,0,33,33
1715600003105,AIP 97,001,660915,Van Den Einde; Yael Dahlia,9999,0,9999,0
1715600004133,AIP 197,001,627712,Vespa; Emanuel Ignacio,9995,0,9999,4
1715600004133,AIP 197,002,650778,Amir; On,9998,0,9999,1
1715600004133,AIP 197,003,650933,Avenancio-Leon; Carlos,9998,0,9999,1
1715600004133,AIP 197,004,658530,Heyman; Gail D.,9998,0,9999,1
1715600004133,AIP 197,005,658631,Neal; Sonya E,9998,0,9999,1
1715600004133,AIP 197,006,658671,Du; Songzi,9998,0,9999,1
1715600005164,ANAR 135S,A00,494369,Braswell; Geoffrey E.,0,0,0,0
1715600006192,BENG 196,001,628496,Engler; Adam J.,9998,0,9999,1
1715600006192,BENG 196,002,660916,Watson; John Thomas,9999,0,9999,0
1715600007222,BISP 197,001,650773,Wilhelm; James E.,9994,0,9999,5
1715600007222,BISP 197,002,658904,Coleman; Aaron B.,9998,0,9999,1
1715600008251,CAT 124RS,A01,519847,Geibel; William,0,0,20,20
1715600009281,CAT 125RS,A01,515971,Geibel; William,0,0,20,20
1715600010324,CLRE 250,A00,511389,Morris; Sheldon,9992,0,9999,7
1715600011354,CLRE 251,A00,507176,Mehta; Ravindra L.,9992,0,9999,7
1715600011354,CLRE 251,B00,511410,Mehta; Ravindra L.,9998,0,9999,1
1715600012383,CLRE 252,A00,507189,Cuomo; Raphael Eduardo,9994,0,9999,5
1715600013414,CLRE 253,A00,507199,Vaida; Florin,9994,0,9999,5
1715600013414,CLRE 253,B00,507202,Vaida; Florin,9999,0,9999,0
1715600014447,CLRE 259,A00,507211,Patel; Hemal,9996,0,9999,3
1715600015472,CLRE 260,A00,507221,Cuomo; Raphael Eduardo,9999,0,9999,0
1715600016498,CLRE 297,001,507242,Cuomo; Raphael Eduardo,9999,0,9999,0
1715600017529,COGS 197,001,638244,Voytek; Bradley Thomas,9997,0,9999,2
1715600018557,CSE 191,A00,516875,Minnes Kemp; Mor Mia,9991,0,9999,8
1715600019583,CSE 197,001,637388,Minnes Kemp; Mor Mia,9992,0,9999,7
1715600020611,CSS 201S,A01,494383,Mignozzetti; Umberto,35,0,35,0
1715600021640,CSS 202S,A01,494387,Mignozzetti; Umberto,35,0,35,0
1715600022669,DSC 197,001,628532,Eldridge; Justin Matthew,9995,0,9999,4
1715600023698,EAP 100,A00,516065,Staff,9799,0,9999,200
1715600024932,ECE 45,A01,507414,Staff,31,0,60,29
1715600026991,ECE 111,A01,507420,Staff,11,0,50,39
1715600028018,ECE 197,001,548057,Sievenpiper; Daniel F.,9991,0,9999,8
1715600029048,EDS 115,A00,507243,Choi; Bailey Miyeon,7,0,28,21
1715600030079,EDS 117,A01,494379,Staff,0,6,34,34
1715600031105,EDS 125,A00,507246,Hopkins; Megan Beth,8,0,30,22
1715600032137,EDS 128A,A01,507264,Fargason; Sharon Gayle,6,0,26,20
1715600033169,EDS 128B,A01,507293,Pappas; Elizabeth,10,0,30,20
1715600034194,EDS 139,A00,507294,Fargason; Sharon Gayle,10,0,30,20
1715600034194,EDS 139,B00,507313,Pappas; Elizabeth,11,0,30,19
1715600035220,EDS 201,A00,507315,Staff,10,0,30,20
1715600036251,EDS 203,A01,507317,Halter; Christopher P.,10,0,30,20
1715600037278,EDS 204R,A01,507319,Halter; Christopher P.,0,3,30,30
1715600037278,EDS 204R,B01,507331,Heinzman; Erica M.,14,0,30,16
1715600038305,EDS 206R,A00,507332,Staff,0,4,30,30
1715600038305,EDS 206R,B00,507343,Staff,15,0,30,15
1715600039337,EDS 250,A00,507344,Hemans; Patricia Ann Benitez,20,0,40,20
1715600040367,EDS 281,A00,507345,Daly; Alan J.,18,0,18,0
1715600041395,EDS 284,A00,507350,Daly; Alan J.,16,0,16,0
1715600042423,EDS 286,A00,507359,Fine; Sarah,18,0,18,0
1715600043460,EDS 289C,A01,507361,Daly; Alan J.,18,0,18,0
1715600044489,EDS 290,A00,507366,Hofstetter; Carolyn,15,0,15,0
1715600045517,LIGM 5A,A00,507421,Fischer-Grunski; Eva K,17,0,20,3
1715600046549,LIGM 5B,A00,507423,Fischer-Grunski; Eva K,19,0,20,1
1715600047577,LIGM 5C,A00,507425,Fischer-Grunski; Eva K,19,0,20,1
1715600048609,LIIT 5AS,A00,507427,Carnelos; Chiara,20,0,20,0
1715600049636,LIIT 5BS,A00,507430,Carnelos; Chiara,20,0,20,0
1715600050662,LIIT 5CS,A00,507432,Carnelos; Chiara,20,0,20,0
1715600051692,LISP 5A,A00,507541,Munoz Sanchez; Alicia,11,0,20,9
1715600052717,LISP 5B,A00,507671,Munoz Sanchez; Alicia,9,0,20,11
1715600053744,LISP 5C,A00,507696,Munoz Sanchez; Alicia,9,0,20,11
1715600054772,MAE 197,001,528363,Boechler; Nicholas Sebastia,9998,0,9999,1
1715600055801,MATH 197,001,523477,Kedlaya; Kiran S.,9994,0,9999,5
1715600055801,MATH 197,002,563811,Zhang; Danna,9994,0,9999,5
1715600055801,MATH 197,003,628552,Dumitriu; Ioana,9998,0,9999,1
1715600055801,MATH 197,004,660885,Floyd; Eric,9999,0,9999,0
1715600056831,MCWP 40R,A00,518780,Staff,2,0,20,18
1715600056831,MCWP 40R,B00,518781,Staff,11,0,20,9
1715600056831,MCWP 40R,C00,518783,Staff,5,0,20,15
1715600057862,MCWP 50R,A00,518791,Staff,0,1,20,20
1715600057862,MCWP 50R,B00,518792,Staff,0,2,20,20
1715600057862,MCWP 50R,C00,518793,Staff,0,4,20,20
1715600057862,MCWP 50R,D00,518794,Staff,0,1,20,20
1715600057862,MCWP 50R,E00,518795,Staff,0,2,20,20
1715600057862,MCWP 50R,F00,518796,Staff,0,1,20,20
1715600057862,MCWP 50R,G00,518797,Staff,0,1,20,20
1715600058888,MMW 12R,A01,514034,Herbst; Matthew,0,2,16,16
1715600058888,MMW 12R,A02,514035,Herbst; Matthew,0,0,16,16
1715600059912,MMW 13R,A01,514037,Staff,0,5,16,16
1715600059912,MMW 13R,A02,514039,Staff,0,5,16,16
1715600059912,MMW 13R,A03,628519,Staff,0,4,16,16
1715600061966,SIO 295LS,A00,523233,Staff,10,0,30,20
1715600062992,SIO 295S,A00,523232,Staff,10,0,30,20
1715600064025,SIOC 290S,A01,637330,Merrifield; Mark A,23,0,30,7
1715600065056,SIOC 291S,A01,637333,Gabriel; Corey John,23,0,30,7
1715600066085,SOCI 117,A01,494376,Staff,0,5,5,5
1715600067117,WES 237B,A00,494380,Staff,10,0,20,10
1715600069193,AESE 279B,A00,494370,Wade; Jon P,0,0,33,33
1715600070219,AIP 97,001,660915,Van Den Einde; Yael Dahlia,9999,0,9999,0
1715600071248,AIP 197,001,627712,Vespa; Emanuel Ignacio,9995,0,9999,4
1715600071248,AIP 197,002,650778,Amir; On,9998,0,9999,1
1715600071248,AIP 197,003,650933,Avenancio-Leon; Carlos,9998,0,9999,1
1715600071248,AIP 197,004,658530,Heyman; Gail D.,9998,0,9999,1
1715600071248,AIP 197,005,658631,Neal; Sonya E,9998,0,9999,1
1715600071248,AIP 197,006,658671,Du; Songzi,9998,0,9999,1
1715600072275,ANAR 135S,A00,494369,Braswell; Geoffrey E.,0,0,0,0
1715600073303,BENG 196,001,628496,Engler; Adam J.,9998,0,9999,1
1715600073303,BENG 196,002,660916,Watson; John Thomas,9999,0,9999,0
1715600074334,BISP 197,001,650773,Wilhelm; James E.,9994,0,9999,5
1715600074334,BISP 197,002,658904,Coleman; Aaron B.,9998,0,9999,1
1715600075361,CAT 124RS,A01,519847,Geibel; William,0,0,20,20
1715600076387,CAT 125RS,A01,515971,Geibel; William,0,0,20,20
1715600077416,CLRE 250,A00,511389,Morris; Sheldon,9992,0,9999,7
1715600078450,CLRE 251,A00,507176,Mehta; Ravindra L.,9992,0,9999,7
1715600078450,CLRE 251,B00,511410,Mehta; Ravindra L.,9998,0,9999,1
1715600079479,CLRE 252,A00,507189,Cuomo; Raphael Eduardo,9994,0,9999,5
1715600080507,CLRE 253,A00,507199,Vaida; Florin,9994,0,9999,5
1715600080507,CLRE 253,B00,507202,Vaida; Florin,9999,0,9999,0
1715600081533,CLRE 259,A00,507211,Patel; Hemal,9996,0,9999,3
1715600082560,CLRE 260,A00,507221,Cuomo; Raphael Eduardo,9999,0,9999,0
1715600083585,CLRE 297,001,507242,Cuomo; Raphael Eduardo,9999,0,9999,0
1715600084615,COGS 197,001,638244,Voytek; Bradley Thomas,9997,0,9999,2
1715600085648,CSE 191,A00,516875,Minnes Kemp; Mor Mia,9991,0,9999,8
1715600086676,CSE 197,001,637388,Minnes Kemp; Mor Mia,9992,0,9999,7
1715600087707,CSS 201S,A01,494383,Mignozzetti; Umberto,35,0,35,0
1715600088738,CSS 202S,A01,494387,Mignozzetti; Umberto,35,0,35,0
1715600089765,DSC 197,001,628532,Eldridge; Justin Matthew,9995,0,9999,4
1715600090794,EAP 100,A00,516065,Staff,9799,0,9999,200
1715600091825,ECE 45,A01,507414,Staff,31,0,60,29
1715600093882,ECE 111,A01,507420,Staff,11,0,50,39
1715600094910,ECE 197,001,548057,Sievenpiper; Daniel F.,9991,0,9999,8
1715600095938,EDS 115,A00,507243,Choi; Bailey Miyeon,7,0,28,21
1715600096969,EDS 117,A01,494379,Staff,0,6,34,34
1715600097996,EDS 125,A00,507246,Hopkins; Megan Beth,8,0,30,22
1715600099023,EDS 128A,A01,507264,Fargason; Sharon Gayle,6,0,26,20
1715600100054,EDS 128B,A01,507293,Pappas; Elizabeth,10,0,30,20
1715600101085,EDS 139,A00,507294,Fargason; Sharon Gayle,10,0,30,20
1715600101085,EDS 139,B00,507313,Pappas; Elizabeth,11,0,30,19
1715600102117,EDS 201,A00,507315,Staff,10,0,30,20
1715600103151,EDS 203,A01,507317,Halter; Christopher P.,10,0,30,20
1715600104178,EDS 204R,A01,507319,Halter; Christopher P.,0,3,30,30
1715600104178,EDS 204R,B01,507331,Heinzman; Erica M.,14,0,30,16
1715600105205,EDS 206R,A00,507332,Staff,0,4,30,30
1715600105205,EDS 206R,B00,507343,Staff,15,0,30,15
1715600106236,EDS 250,A00,507344,Hemans; Patricia Ann Benitez,20,0,40,20
1715600107262,EDS 281,A00,507345,Daly; Alan J.,18,0,18,0
1715600108292,EDS 284,A00,507350,Daly; Alan J.,16,0,16,0
1715600109322,EDS 286,A00,507359,Fine; Sarah,18,0,18,0
1715600110348,EDS 289C,A01,507361,Daly; Alan J.,18,0,18,0
1715600111376,EDS 290,A00,507366,Hofstetter; Carolyn,15,0,15,0
1715600112403,LIGM 5A,A00,507421,Fischer-Grunski; Eva K,17,0,20,3
1715600113434,LIGM 5B,A00,507423,Fischer-Grunski; Eva K,19,0,20,1
1715600114464,LIGM 5C,A00,507425,Fischer-Grunski; Eva K,19,0,20,1
1715600115489,LIIT 5AS,A00,507427,Carnelos; Chiara,20,0,20,0
1715600116518,LIIT 5BS,A00,507430,Carnelos; Chiara,20,0,20,0
1715600117548,LIIT 5CS,A00,507432,Carnelos; Chiara,20,0,20,0
1715600118577,LISP 5A,A00,507541,Munoz Sanchez; Alicia,11,0,20,9
1715600119603,LISP 5B,A00,507671,Munoz Sanchez; Alicia,9,0,20,11
1715600120631,LISP 5C,A00,507696,Munoz Sanchez; Alicia,9,0,20,11
1715600121660,MAE 197,001,528363,Boechler; Nicholas Sebastia,9998,0,9999,1
1715600122693,MATH 197,001,523477,Kedlaya; Kiran S.,9994,0,9999,5
1715600122693,MATH 197,002,563811,Zhang; Danna,9994,0,9999,5
1715600122693,MATH 197,003,628552,Dumitriu; Ioana,9998,0,9999,1
1715600122693,MATH 197,004,660885,Floyd; Eric,9999,0,9999,0
1715600123725,MCWP 40R,A00,518780,Staff,2,0,20,18
1715600123725,MCWP 40R,B00,518781,Staff,11,0,20,9
1715600123725,MCWP 40R,C00,518783,Staff,5,0,20,15
1715600124754,MCWP 50R,A00,518791,Staff,0,1,20,20
1715600124754,MCWP 50R,B00,518792,Staff,0,2,20,20
1715600124754,MCWP 50R,C00,518793,Staff,0,4,20,20
1715600124754,MCWP 50R,D00,518794,Staff,0,1,20,20
1715600124754,MCWP 50R,E00,518795,Staff,0,2,20,20
1715600124754,MCWP 50R,F00,518796,Staff,0,1,20,20
1715600124754,MCWP 50R,G00,518797,Staff,0,1,20,20
1715600125780,MMW 12R,A01,514034,Herbst; Matthew,0,2,16,16
1715600125780,MMW 12R,A02,514035,Herbst; Matthew,0,0,16,16
1715600126806,MMW 13R,A01,514037,Staff,0,5,16,16
1715600126806,MMW 13R,A02,514039,Staff,0,5,16,16
1715600126806,MMW 13R,A03,628519,Staff,0,4,16,16
1715600128858,SIO 295LS,A00,523233,Staff,10,0,30,20
1715600129888,SIO 295S,A00,523232,Staff,10,0,30,20
1715600130918,SIOC 290S,A01,637330,Merrifield; Mark A,23,0,30,7
1715600131943,SIOC 291S,A01,637333,Gabriel; Corey John,23,0,30,7
1715600132970,SOCI 117,A01,494376,Staff,0,5,5,5
1715600133997,WES 237B,A00,494380,Staff,10,0,20,10
1715600136067,AESE 279B,A00,494370,Wade; Jon P,0,0,33,33
1715600137097,AIP 97,001,660915,Van Den Einde; Yael Dahlia,9999,0,9999,0
1715600138133,AIP 197,001,627712,Vespa; Emanuel Ignacio,9995,0,9999,4
1715600138133,AIP 197,002,650778,Amir; On,9998,0,9999,1
1715600138133,AIP 197,003,650933,Avenancio-Leon; Carlos,9998,0,9999,1
1715600138133,AIP 197,004,658530,Heyman; Gail D.,9998,0,9999,1
1715600138133,AIP 197,005,658631,Neal; Sonya E,9998,0,9999,1
1715600138133,AIP 197,006,658671,Du; Songzi,9998,0,9999,1
1715600139158,ANAR 135S,A00,494369,Braswell; Geoffrey E.,0,0,0,0
1715600140190,BENG 196,001,628496,Engler; Adam J.,9998,0,9999,1
1715600140190,BENG 196,002,660916,Watson; John Thomas,9999,0,9999,0
1715600141218,BISP 197,001,650773,Wilhelm; James E.,9994,0,9999,5
1715600141218,BISP 197,002,658904,Coleman; Aaron B.,9998,0,9999,1
1715600142244,CAT 124RS,A01,519847,Geibel; William,0,0,20,20
1715600143270,CAT 125RS,A01,515971,Geibel; William,0,0,20,20
1715600144302,CLRE 250,A00,511389,Morris; Sheldon,9992,0,9999,7
1715600145394,CLRE 251,A00,507176,Mehta; Ravindra L.,9992,0,9999,7
1715600145394,CLRE 251,B00,511410,Mehta; Ravindra L.,9998,0,9999,1
1715600146422,CLRE 252,A00,507189,Cuomo; Raphael Eduardo,9994,0,9999,5
1715600147451,CLRE 253,A00,507199,Vaida; Florin,9994,0,9999,5
1715600147451,CLRE 253,B00,507202,Vaida; Florin,9999,0,9999,0
1715600148482,CLRE 259,A00,507211,Patel; Hemal,9996,0,9999,3
1715600149507,CLRE 260,A00,507221,Cuomo; Raphael Eduardo,9999,0,9999,0
1715600150534,CLRE 297,001,507242,Cuomo; Raphael Eduardo,9999,0,9999,0
1715600151560,COGS 197,001,638244,Voytek; Bradley Thomas,9997,0,9999,2
1715600152591,CSE 191,A00,516875,Minnes Kemp; Mor Mia,9991,0,9999,8
1715600153617,CSE 197,001,637388,Minnes Kemp; Mor Mia,9992,0,9999,7
1715600154645,CSS 201S,A01,494383,Mignozzetti; Umberto,35,0,35,0
1715600155674,CSS 202S,A01,494387,Mignozzetti; Umberto,35,0,35,0
1715600156700,DSC 197,001,628532,Eldridge; Justin Matthew,9995,0,9999,4
1715600157726,EAP 100,A00,516065,Staff,9799,0,9999,200
1715600158752,ECE 45,A01,507414,Staff,31,0,60,29
1715600160809,ECE 111,A01,507420,Staff,11,0,50,39
1715600161835,ECE 197,001,548057,Sievenpiper; Daniel F.,9991,0,9999,8
1715600162865,EDS 115,A00,507243,Choi; Bailey Miyeon,7,0,28,21
1715600163897,EDS 117,A01,494379,Staff,0,6,34,34
1715600164921,EDS 125,A00,507246,Hopkins; Megan Beth,8,0,30,22
1715600165949,EDS 128A,A01,507264,Fargason; Sharon Gayle,6,0,26,20
1715600166980,EDS 128B,A01,507293,Pappas; Elizabeth,10,0,30,20
1715600168004,EDS 139,A00,507294,Fargason; Sharon Gayle,10,0,30,20
1715600168004,EDS 139,B00,507313,Pappas; Elizabeth,11,0,30,19
1715600169031,EDS 201,A00,507315,Staff,10,0,30,20
1715600170064,EDS 203,A01,507317,Halter; Christopher P.,10,0,30,20
1715600171091,EDS 204R,A01,507319,Halter; Christopher P.,0,3,30,30
1715600171091,EDS 204R,B01,507331,Heinzman; Erica M.,14,0,30,16
1715600172117,EDS 206R,A00,507332,Staff,0,4,30,30
1715600172117,EDS 206R,B00,507343,Staff,15,0,30,15
1715600173146,EDS 250,A00,507344,Hemans; Patricia Ann Benitez,20,0,40,20
1715600174175,EDS 281,A00,507345,Daly; Alan J.,18,0,18,0
1715600175202,EDS 284,A00,507350,Daly; Alan J.,16,0,16,0
1715600176227,EDS 286,A00,507359,Fine; Sarah,18,0,18,0
1715600177253,EDS 289C,A01,507361,Daly; Alan J.,18,0,18,0
1715600178279,EDS 290,A00,507366,Hofstetter; Carolyn,15,0,15,0
1715600179312,LIGM 5A,A00,507421,Fischer-Grunski; Eva K,17,0,20,3
1715600180339,LIGM 5B,A00,507423,Fischer-Grunski; Eva K,19,0,20,1
1715600181368,LIGM 5C,A00,507425,Fischer-Grunski; Eva K,19,0,20,1
1715600182398,LIIT 5AS,A00,507427,Carnelos; Chiara,20,0,20,0
1715600183423,LIIT 5BS,A00,507430,Carnelos; Chiara,20,0,20,0
1715600184453,LIIT 5CS,A00,507432,Carnelos; Chiara,20,0,20,0
1715600185480,LISP 5A,A00,507541,Munoz Sanchez; Alicia,11,0,20,9
1715600186505,LISP 5B,A00,507671,Munoz Sanchez; Alicia,9,0,20,11
1715600187533,LISP 5C,A00,507696,Munoz Sanchez; Alicia,9,0,20,11
1715600188558,MAE 197,001,528363,Boechler; Nicholas Sebastia,9998,0,9999,1
1715600189588,MATH 197,001,523477,Kedlaya; Kiran S.,9994,0,9999,5
1715600189588,MATH 197,002,563811,Zhang; Danna,9994,0,9999,5
1715600189588,MATH 197,003,628552,Dumitriu; Ioana,9998,0,9999,1
1715600189588,MATH 197,004,660885,Floyd; Eric,9999,0,9999,0
1715600190614,MCWP 40R,A00,518780,Staff,2,0,20,18
1715600190614,MCWP 40R,B00,518781,Staff,11,0,20,9
1715600190614,MCWP 40R,C00,518783,Staff,5,0,20,15
1715600191641,MCWP 50R,A00,518791,Staff,0,1,20,20
1715600191641,MCWP 50R,B00,518792,Staff,0,2,20,20
1715600191641,MCWP 50R,C00,518793,Staff,0,4,20,20
1715600191641,MCWP 50R,D00,518794,Staff,0,1,20,20
1715600191641,MCWP 50R,E00,518795,Staff,0,2,20,20
1715600191641,MCWP 50R,F00,518796,Staff,0,1,20,20
1715600191641,MCWP 50R,G00,518797,Staff,0,1,20,20
1715600192670,MMW 12R,A01,514034,Herbst; Matthew,0,2,16,16
1715600192670,MMW 12R,A02,514035,Herbst; Matthew,0,0,16,16
1715600193700,MMW 13R,A01,514037,Staff,0,5,16,16
1715600193700,MMW 13R,A02,514039,Staff,0,5,16,16
1715600193700,MMW 13R,A03,628519,Staff,0,4,16,16
1715600195757,SIO 295LS,A00,523233,Staff,10,0,30,20
1715600196786,SIO 295S,A00,523232,Staff,10,0,30,20
1715600197813,SIOC 290S,A01,637330,Merrifield; Mark A,23,0,30,7
1715600198842,SIOC 291S,A01,637333,Gabriel; Corey John,23,0,30,7
1715600199870,SOCI 117,A01,494376,Staff,0,5,5,5
1715600200900,WES 237B,A00,494380,Staff,10,0,20,10
1715600202965,AESE 279B,A00,494370,Wade; Jon P,0,0,33,33
1715600203994,AIP 97,001,660915,Van Den Einde; Yael Dahlia,9999,0,9999,0
1715600205023,AIP 197,001,627712,Vespa; Emanuel Ignacio,9995,0,9999,4
1715600205023,AIP 197,002,650778,Amir; On,9998,0,9999,1
1715600205023,AIP 197,003,650933,Avenancio-Leon; Carlos,9998,0,9999,1
1715600205023,AIP 197,004,658530,Heyman; Gail D.,9998,0,9999,1
1715600205023,AIP 197,005,658631,Neal; Sonya E,9998,0,9999,1
1715600205023,AIP 197,006,658671,Du; Songzi,9998,0,9999,1
1715600206055,ANAR 135S,A00,494369,Braswell; Geoffrey E.,0,0,0,0
1715600207086,BENG 196,001,628496,Engler; Adam J.,9998,0,9999,1
1715600207086,BENG 196,002,660916,Watson; John Thomas,9999,0,9999,0
1715600208114,BISP 197,001,650773,Wilhelm; James E.,9994,0,9999,5
1715600208114,BISP 197,002,658904,Coleman; Aaron B.,9998,0,9999,1
1715600209140,CAT 124RS,A01,519847,Geibel; William,0,0,20,20
1715600210167,CAT 125RS,A01,515971,Geibel; William,0,0,20,20
1715600211195,CLRE 250,A00,511389,Morris; Sheldon,9992,0,9999,7
1715600212227,CLRE 251,A00,507176,Mehta; Ravindra L.,9992,0,9999,7
1715600212227,CLRE 251,B00,511410,Mehta; Ravindra L.,9998,0,9999,1
1715600213260,CLRE 252,A00,507189,Cuomo; Raphael Eduardo,9994,0,9999,5
1715600214288,CLRE 253,A00,507199,Vaida; Florin,9994,0,9999,5
1715600214288,CLRE 253,B00,507202,Vaida; Florin,9999,0,9999,0
1715600215315,CLRE 259,A00,507211,Patel; Hemal,9996,0,9999,3
1715600216344,CLRE 260,A00,507221,Cuomo; Raphael Eduardo,9999,0,9999,0
1715600217373,CLRE 297,001,507242,Cuomo; Raphael Eduardo,9999,0,9999,0
1715600218401,COGS 197,001,638244,Voytek; Bradley Thomas,9997,0,9999,2
1715600219429,CSE 191,A00,516875,Minnes Kemp; Mor Mia,9991,0,9999,8
1715600220455,CSE 197,001,637388,Minnes Kemp; Mor Mia,9992,0,9999,7
1715600221484,CSS 201S,A01,494383,Mignozzetti; Umberto,35,0,35,0
1715600222511,CSS 202S,A01,494387,Mignozzetti; Umberto,35,0,35,0
1715600223542,DSC 197,001,628532,Eldridge; Justin Matthew,9995,0,9999,4
1715600224570,EAP 100,A00,516065,Staff,9799,0,9999,200
1715600225603,ECE 45,A01,507414,Staff,31,0,60,29
1715600227659,ECE 111,A01,507420,Staff,11,0,50,39
1715600228689,ECE 197,001,548057,Sievenpiper; Daniel F.,9991,0,9999,8
1715600229716,EDS 115,A00,507243,Choi; Bailey Miyeon,7,0,28,21
1715600230747,EDS 117,A01,494379,Staff,0,6,34,34
1715600231774,EDS 125,A00,507246,Hopkins; Megan Beth,8,0,30,22
1715600232802,EDS 128A,A01,507264,Fargason; Sharon Gayle,6,0,26,20
1715600233831,EDS 128B,A01,507293,Pappas; Elizabeth,10,0,30,20
1715600234861,EDS 139,A00,507294,Fargason; Sharon Gayle,10,0,30,20
1715600234861,EDS 139,B00,507313,Pappas; Elizabeth,11,0,30,19
1715600235890,EDS 201,A00,507315,Staff,10,0,30,20
1715600236919,EDS 203,A01,507317,Halter; Christopher P.,10,0,30,20
1715600237947,EDS 204R,A01,507319,Halter; Christopher P.,0,3,30,30
1715600237947,EDS 204R,B01,507331,Heinzman; Erica M.,14,0,30,16
1715600238974,EDS 206R,A00,507332,Staff,0,4,30,30
1715600238974,EDS 206R,B00,507343,Staff,15,0,30,15
1715600240001,EDS 250,A00,507344,Hemans; Patricia Ann Benitez,20,0,40,20
1715600241030,EDS 281,A00,507345,Daly; Alan J.,18,0,18,0
1715600242057,EDS 284,A00,507350,Daly; Alan J.,16,0,16,0
1715600243086,EDS 286,A00,507359,Fine; Sarah,18,0,18,0
1715600244112,EDS 289C,A01,507361,Daly; Alan J.,18,0,18,0
1715600245139,EDS 290,A00,507366,Hofstetter; Carolyn,15,0,15,0
1715600246166,LIGM 5A,A00,507421,Fischer-Grunski; Eva K,17,0,20,3
1715600247196,LIGM 5B,A00,507423,Fischer-Grunski; Eva K,19,0,20,1
1715600248226,LIGM 5C,A00,507425,Fischer-Grunski; Eva K,19,0,20,1
1715600249254,LIIT 5AS,A00,507427,Carnelos; Chiara,20,0,20,0
1715600250284,LIIT 5BS,A00,507430,Carnelos; Chiara,20,0,20,0
1715600251312,LIIT 5CS,A00,507432,Carnelos; Chiara,20,0,20,0
1715600252344,LISP 5A,A00,507541,Munoz Sanchez; Alicia,11,0,20,9
1715600253370,LISP 5B,A00,507671,Munoz Sanchez; Alicia,9,0,20,11
1715600254396,LISP 5C,A00,507696,Munoz Sanchez; Alicia,9,0,20,11
1715600255421,MAE 197,001,528363,Boechler; Nicholas Sebastia,9998,0,9999,1
1715600256450,MATH 197,001,523477,Kedlaya; Kiran S.,9994,0,9999,5
1715600256450,MATH 197,002,563811,Zhang; Danna,9994,0,9999,5
1715600256450,MATH 197,003,628552,Dumitriu; Ioana,9998,0,9999,1
1715600256450,MATH 197,004,660885,Floyd; Eric,9999,0,9999,0
1715600257476,MCWP 40R,A00,518780,Staff,2,0,20,18
1715600257476,MCWP 40R,B00,518781,Staff,11,0,20,9
1715600257476,MCWP 40R,C00,518783,Staff,5,0,20,15
1715600258505,MCWP 50R,A00,518791,Staff,0,1,20,20
1715600258505,MCWP 50R,B00,518792,Staff,0,2,20,20
1715600258505,MCWP 50R,C00,518793,Staff,0,4,20,20
1715600258505,MCWP 50R,D00,518794,Staff,0,1,20,20
1715600258505,MCWP 50R,E00,518795,Staff,0,2,20,20
1715600258505,MCWP 50R,F00,518796,Staff,0,1,20,20
1715600258505,MCWP 50R,G00,518797,Staff,0,1,20,20
1715600259536,MMW 12R,A01,514034,Herbst; Matthew,0,2,16,16
1715600259536,MMW 12R,A02,514035,Herbst; Matthew,0,0,16,16
1715600260564,MMW 13R,A01,514037,Staff,0,5,16,16
1715600260564,MMW 13R,A02,514039,Staff,0,5,16,16
1715600260564,MMW 13R,A03,628519,Staff,0,4,16,16
1715600262624,SIO 295LS,A00,523233,Staff,10,0,30,20
1715600263651,SIO 295S,A00,523232,Staff,10,0,30,20
1715600264678,SIOC 290S,A01,637330,Merrifield; Mark A,23,0,30,7
1715600265705,SIOC 291S,A01,637333,Gabriel; Corey John,23,0,30,7
1715600266735,SOCI 117,A01,494376,Staff,0,5,5,5
1715600267762,WES 237B,A00,494380,Staff,10,0,20,10
1715600269829,AESE 279B,A00,494370,Wade; Jon P,0,0,33,33
1715600270855,AIP 97,001,660915,Van Den Einde; Yael Dahlia,9999,0,9999,0
1715600271885,AIP 197,001,627712,Vespa; Emanuel Ignacio,9995,0,9999,4
1715600271885,AIP 197,002,650778,Amir; On,9998,0,9999,1
1715600271885,AIP 197,003,650933,Avenancio-Leon; Carlos,9998,0,9999,1
1715600271885,AIP 197,004,658530,Heyman; Gail D.,9998,0,9999,1
1715600271885,AIP 197,005,658631,Neal; Sonya E,9998,0,9999,1
1715600271885,AIP 197,006,658671,Du; Songzi,9998,0,9999,1
1715600272916,ANAR 135S,A00,494369,Braswell; Geoffrey E.,0,0,0,0
1715600273944,BENG 196,001,628496,Engler; Adam J.,9998,0,9999,1
1715600273944,BENG 196,002,660916,Watson; John Thomas,9999,0,9999,0
1715600274970,BISP 197,001,650773,Wilhelm; James E.,9994,0,9999,5
1715600274970,BISP 197,002,658904,Coleman; Aaron B.,9998,0,9999,1
1715600275998,CAT 124RS,A01,519847,Geibel; William,0,0,20,20
1715600277028,CAT 125RS,A01,515971,Geibel; William,0,0,20,20
1715600278059,CLRE 250,A00,511389,Morris; Sheldon,9992,0,9999,7
1715600279091,CLRE 251,A00,507176,Mehta; Ravindra L.,9992,0,9999,7
1715600279091,CLRE 251,B00,511410,Mehta; Ravindra L.,9998,0,9999,1
1715600280120,CLRE 252,A00,507189,Cuomo; Raphael Eduardo,9994,0,9999,5
1715600281150,CLRE 253,A00,507199,Vaida; Florin,9994,0,9999,5
1715600281150,CLRE 253,B00,507202,Vaida; Florin,9999,0,9999,0
1715600282176,CLRE 259,A00,507211,Patel; Hemal,9996,0,9999,3
1715600283205,CLRE 260,A00,507221,Cuomo; Raphael Eduardo,9999,0,9999,0
1715600284233,CLRE 297,001,507242,Cuomo; Raphael Eduardo,9999,0,9999,0
1715600285262,COGS 197,001,638244,Voytek; Bradley Thomas,9997,0,9999,2
1715600286292,CSE 191,A00,516875,Minnes Kemp; Mor Mia,9991,0,9999,8
1715600287317,CSE 197,001,637388,Minnes Kemp; Mor Mia,9992,0,9999,7
1715600288345,CSS 201S,A01,494383,Mignozzetti; Umberto,35,0,35,0
1715600289375,CSS 202S,A01,494387,Mignozzetti; Umberto,35,0,35,0
1715600290401,DSC 197,001,628532,Eldridge; Justin Matthew,9995,0,9999,4
1715600291428,EAP 100,A00,516065,Staff,9799,0,9999,200
1715600292459,ECE 45,A01,507414,Staff,31,0,60,29
1715600294517,ECE 111,A01,507420,Staff,11,0,50,39
1715600295545,ECE 197,001,548057,Sievenpiper; Daniel F.,9991,0,9999,8
1715600296577,EDS 115,A00,507243,Choi; Bailey Miyeon,7,0,28,21
1715600297605,EDS 117,A01,494379,Staff,0,6,34,34
1715600298632,EDS 125,A00,507246,Hopkins; Megan Beth,8,0,30,22
1715600299657,EDS 128A,A01,507264,Fargason; Sharon Gayle,6,0,26,20
1715600300686,EDS 128B,A01,507293,Pappas; Elizabeth,10,0,30,20
1715600301713,EDS 139,A00,507294,Fargason; Sharon Gayle,10,0,30,20
1715600301713,EDS 139,B00,507313,Pappas; Elizabeth,11,0,30,19
1715600302739,EDS 201,A00,507315,Staff,10,0,30,20
1715600303766,EDS 203,A01,507317,Halter; Christopher P.,10,0,30,20
1715600304797,EDS 204R,A01,507319,Halter; Christopher P.,0,3,30,30
1715600304797,EDS 204R,B01,507331,Heinzman; Erica M.,14,0,30,16
1715600305829,EDS 206R,A00,507332,Staff,0,4,30,30
1715600305829,EDS 206R,B00,507343,Staff,15,0,30,15
1715600306860,EDS 250,A00,507344,Hemans; Patricia Ann Benitez,20,0,40,20
1715600307890,EDS 281,A00,507345,Daly; Alan J.,18,0,18,0
1715600308916,EDS 284,A00,507350,Daly; Alan J.,16,0,16,0
1715600309943,EDS 286,A00,507359,Fine; Sarah,18,0,18,0
1715600310968,EDS 289C,A01,507361,Daly; Alan J.,18,0,18,0
1715600311993,EDS 290,A00,507366,Hofstetter; Carolyn,15,0,15,0
1715600313025,LIGM 5A,A00,507421,Fischer-Grunski; Eva K,17,0,20,3
1715600314050,LIGM 5B,A00,507423,Fischer-Grunski; Eva K,19,0,20,1
1715600315076,LIGM 5C,A00,507425,Fischer-Grunski; Eva K,19,0,20,1
1715600316102,LIIT 5AS,A00,507427,Carnelos; Chiara,20,0,20,0
1715600317132,LIIT 5BS,A00,507430,Carnelos; Chiara,20,0,20,0
1715600318160,LIIT 5CS,A00,507432,Carnelos; Chiara,20,0,20,0
1715600319188,LISP 5A,A00,507541,Munoz Sanchez; Alicia,11,0,20,9
1715600320215,LISP 5B,A00,507671,Munoz Sanchez; Alicia,9,0,20,11
1715600321242,LISP 5C,A00,507696,Munoz Sanchez; Alicia,9,0,20,11
1715600322268,MAE 197,001,528363,Boechler; Nicholas Sebastia,9998,0,9999,1
1715600323296,MATH 197,001,523477,Kedlaya; Kiran S.,9994,0,9999,5
1715600323296,MATH 197,002,563811,Zhang; Danna,9994,0,9999,5
1715600323296,MATH 197,003,628552,Dumitriu; Ioana,9998,0,9999,1
1715600323296,MATH 197,004,660885,Floyd; Eric,9999,0,9999,0
1715600324323,MCWP 40R,A00,518780,Staff,2,0,20,18
1715600324323,MCWP 40R,B00,518781,Staff,11,0,20,9
1715600324323,MCWP 40R,C00,518783,Staff,5,0,20,15
1715600325355,MCWP 50R,A00,518791,Staff,0,1,20,20
1715600325355,MCWP 50R,B00,518792,Staff,0,2,20,20
1715600325355,MCWP 50R,C00,518793,Staff,0,4,20,20
1715600325355,MCWP 50R,D00,518794,Staff,0,1,20,20
1715600325355,MCWP 50R,E00,518795,Staff,0,2,20,20
1715600325355,MCWP 50R,F00,518796,Staff,0,1,20,20
1715600325355,MCWP 50R,G00,518797,Staff,0,1,20,20
1715600326385,MMW 12R,A01,514034,Herbst; Matthew,0,2,16,16
1715600326385,MMW 12R,A02,514035,Herbst; Matthew,0,0,16,16
1715600327416,MMW 13R,A01,514037,Staff,0,5,16,16
1715600327416,MMW 13R,A02,514039,Staff,0,5,16,16
1715600327416,MMW 13R,A03,628519,Staff,0,4,16,16
1715600329468,SIO 295LS,A00,523233,Staff,10,0,30,20
1715600330495,SIO 295S,A00,523232,Staff,10,0,30,20
1715600331521,SIOC 290S,A01,637330,Merrifield; Mark A,23,0,30,7
1715600332548,SIOC 291S,A01,637333,Gabriel; Corey John,23,0,30,7
1715600333579,SOCI 117,A01,494376,Staff,0,5,5,5
1715600334606,WES 237B,A00,494380,Staff,10,0,20,10
1715600336707,AESE 279B,A00,494370,Wade; Jon P,0,0,33,33
1715600337737,AIP 97,001,660915,Van Den Einde; Yael Dahlia,9999,0,9999,0
1715600338766,AIP 197,001,627712,Vespa; Emanuel Ignacio,9995,0,9999,4
1715600338766,AIP 197,002,650778,Amir; On,9998,0,9999,1
1715600338766,AIP 197,003,650933,Avenancio-Leon; Carlos,9998,0,9999,1
1715600338766,AIP 197,004,658530,Heyman; Gail D.,9998,0,9999,1
1715600338766,AIP 197,005,658631,Neal; Sonya E,9998,0,9999,1
1715600338766,AIP 197,006,658671,Du; Songzi,9998,0,9999,1
1715600339793,ANAR 135S,A00,494369,Braswell; Geoffrey E.,0,0,0,0
1715600340821,BENG 196,001,628496,Engler; Adam J.,9998,0,9999,1
1715600340821,BENG 196,002,660916,Watson; John Thomas,9999,0,9999,0
1715600341849,BISP 197,001,650773,Wilhelm; James E.,9994,0,9999,5
1715600341849,BISP 197,002,658904,Coleman; Aaron B.,9998,0,9999,1
1715600342874,CAT 124RS,A01,519847,Geibel; William,0,0,20,20
1715600343905,CAT 125RS,A01,515971,Geibel; William,0,0,20,20
1715600344932,CLRE 250,A00,511389,Morris; Sheldon,9992,0,9999,7
1715600345966,CLRE 251,A00,507176,Mehta; Ravindra L.,9992,0,9999,7
1715600345966,CLRE 251,B00,511410,Mehta; Ravindra L.,9998,0,9999,1
1715600346994,CLRE 252,A00,507189,Cuomo; Raphael Eduardo,9994,0,9999,5
1715600348019,CLRE 253,A00,507199,Vaida; Florin,9994,0,9999,5
1715600348019,CLRE 253,B00,507202,Vaida; Florin,9999,0,9999,0
1715600349049,CLRE 259,A00,507211,Patel; Hemal,9996,0,9999,3
1715600350075,CLRE 260,A00,507221,Cuomo; Raphael Eduardo,9999,0,9999,0
1715600351102,CLRE 297,001,507242,Cuomo; Raphael Eduardo,9999,0,9999,0
1715600352131,COGS 197,001,638244,Voytek; Bradley Thomas,9997,0,9999,2
1715600353157,CSE 191,A00,516875,Minnes Kemp; Mor Mia,9991,0,9999,8
1715600354183,CSE 197,001,637388,Minnes Kemp; Mor Mia,9992,0,9999,7
1715600355211,CSS 201S,A01,494383,Mignozzetti; Umberto,35,0,35,0
1715600356237,CSS 202S,A01,494387,Mignozzetti; Umberto,35,0,35,0
1715600357263,DSC 197,001,628532,Eldridge; Justin Matthew,9995,0,9999,4
1715600358289,EAP 100,A00,516065,Staff,9799,0,9999,200
1715600359320,ECE 45,A01,507414,Staff,31,0,60,29
1715600361373,ECE 111,A01,507420,Staff,11,0,50,39
1715600362399,ECE 197,001,548057,Sievenpiper; Daniel F.,9991,0,9999,8
1715600363427,EDS 115,A00,507243,Choi; Bailey Miyeon,7,0,28,21
1715600364456,EDS 117,A01,494379,Staff,0,6,34,34
1715600365481,EDS 125,A00,507246,Hopkins; Megan Beth,8,0,30,22
1715600366510,EDS 128A,A01,507264,Fargason; Sharon Gayle,6,0,26,20
1715600367540,EDS 128B,A01,507293,Pappas; Elizabeth,10,0,30,20
1715600368568,EDS 139,A00,507294,Fargason; Sharon Gayle,10,0,30,20
1715600368568,EDS 139,B00,507313,Pappas; Elizabeth,11,0,30,19
1715600369596,EDS 201,A00,507315,Staff,10,0,30,20
1715600370626,EDS 203,A01,507317,Halter; Christopher P.,10,0,30,20
1715600371655,EDS 204R,A01,507319,Halter; Christopher P.,0,3,30,30
1715600371655,EDS 204R,B01,507331,Heinzman; Erica M.,14,0,30,16
1715600372682,EDS 206R,A00,507332,Staff,0,4,30,30
1715600372682,EDS 206R,B00,507343,Staff,15,0,30,15
1715600373706,EDS 250,A00,507344,Hemans; Patricia Ann Benitez,20,0,40,20
1715600374732,EDS 281,A00,507345,Daly; Alan J.,18,0,18,0
1715600375757,EDS 284,A00,507350,Daly; Alan J.,16,0,16,0
1715600376782,EDS 286,A00,507359,Fine; Sarah,18,0,18,0
1715600377812,EDS 289C,A01,507361,Daly; Alan J.,18,0,18,0
1715600378838,EDS 290,A00,507366,Hofstetter; Carolyn,15,0,15,0
1715600379872,LIGM 5A,A00,507421,Fischer-Grunski; Eva K,17,0,20,3
1715600380901,LIGM 5B,A00,507423,Fischer-Grunski; Eva K,19,0,20,1
1715600381928,LIGM 5C,A00,507425,Fischer-Grunski; Eva K,19,0,20,1
1715600382956,LIIT 5AS,A00,507427,Carnelos; Chiara,20,0,20,0
1715600383982,LIIT 5BS,A00,507430,Carnelos; Chiara,20,0,20,0
1715600385011,LIIT 5CS,A00,507432,Carnelos; Chiara,20,0,20,0
1715600386037,LISP 5A,A00,507541,Munoz Sanchez; Alicia,11,0,20,9
1715600387067,LISP 5B,A00,507671,Munoz Sanchez; Alicia,9,0,20,11
1715600388093,LISP 5C,A00,507696,Munoz Sanchez; Alicia,9,0,20,11
1715600389122,MAE 197,001,528363,Boechler; Nicholas Sebastia,9998,0,9999,1
1715600390150,MATH 197,001,523477,Kedlaya; Kiran S.,9994,0,9999,5
1715600390150,MATH 197,002,563811,Zhang; Danna,9994,0,9999,5
1715600390150,MATH 197,003,628552,Dumitriu; Ioana,9998,0,9999,1
1715600390150,MATH 197,004,660885,Floyd; Eric,9999,0,9999,0
1715600391176,MCWP 40R,A00,518780,Staff,2,0,20,18
1715600391176,MCWP 40R,B00,518781,Staff,11,0,20,9
1715600391176,MCWP 40R,C00,518783,Staff,5,0,20,15
1715600392202,MCWP 50R,A00,518791,Staff,0,1,20,20
1715600392202,MCWP 50R,B00,518792,Staff,0,2,20,20
1715600392202,MCWP 50R,C00,518793,Staff,0,4,20,20
1715600392202,MCWP 50R,D00,518794,Staff,0,1,20,20
1715600392202,MCWP 50R,E00,518795,Staff,0,2,20,20
1715600392202,MCWP 50R,F00,518796,Staff,0,1,20,20
1715600392202,MCWP 50R,G00,518797,Staff,0,1,20,20
1715600393228,MMW 12R,A01,514034,Herbst; Matthew,0,2,16,16
1715600393228,MMW 12R,A02,514035,Herbst; Matthew,0,0,16,16
1715600394256,MMW 13R,A01,514037,Staff,0,5,16,16
1715600394256,MMW 13R,A02,514039,Staff,0,5,16,16
1715600394256,MMW 13R,A03,628519,Staff,0,4,16,16
1715600396312,SIO 295LS,A00,523233,Staff,10,0,30,20
1715600397339,SIO 295S,A00,523232,Staff,10,0,30,20
1715600398370,SIOC 290S,A01,637330,Merrifield; Mark A,23,0,30,7
1715600399401,SIOC 291S,A01,637333,Gabriel; Corey John,23,0,30,7
1715600400428,SOCI 117,A01,494376,Staff,0,5,5,5
1715600401456,WES 237B,A00,494380,Staff,10,0,20,10
1715600403535,AESE 279B,A00,494370,Wade; Jon P,0,0,33,33
1715600404562,AIP 97,001,660915,Van Den Einde; Yael Dahlia,9999,0,9999,0
1715600405600,AIP 197,001,627712,Vespa; Emanuel Ignacio,9995,0,9999,4
1715600405600,AIP 197,002,650778,Amir; On,9998,0,9999,1
1715600405600,AIP 197,003,650933,Avenancio-Leon; Carlos,9998,0,9999,1
1715600405600,AIP 197,004,658530,Heyman; Gail D.,9998,0,9999,1
1715600405600,AIP 197,005,658631,Neal; Sonya E,9998,0,9999,1
1715600405600,AIP 197,006,658671,Du; Songzi,9998,0,9999,1
1715600406628,ANAR 135S,A00,494369,Braswell; Geoffrey E.,0,0,0,0
1715600407658,BENG 196,001,628496,Engler; Adam J.,9998,0,9999,1
1715600407658,BENG 196,002,660916,Watson; John Thomas,9999,0,9999,0
1715600408684,BISP 197,001,650773,Wilhelm; James E.,9994,0,9999,5
1715600408684,BISP 197,002,658904,Coleman; Aaron B.,9998,0,9999,1
1715600409726,CAT 124RS,A01,519847,Geibel; William,0,0,20,20
1715600410751,CAT 125RS,A01,515971,Geibel; William,0,0,20,20
1715600411778,CLRE 250,A00,511389,Morris; Sheldon,9992,0,9999,7
1715600412807,CLRE 251,A00,507176,Mehta; Ravindra L.,9992,0,9999,7
1715600412807,CLRE 251,B00,511410,Mehta; Ravindra L.,9998,0,9999,1
1715600413833,CLRE 252,A00,507189,Cuomo; Raphael Eduardo,9994,0,9999,5
1715600414859,CLRE 253,A00,507199,Vaida; Florin,9994,0,9999,5
1715600414859,CLRE 253,B00,507202,Vaida; Florin,9999,0,9999,0
1715600415885,CLRE 259,A00,507211,Patel; Hemal,9996,0,9999,3
1715600416909,CLRE 260,A00,507221,Cuomo; Raphael Eduardo,9999,0,9999,0
1715600417933,CLRE 297,001,507242,Cuomo; Raphael Eduardo,9999,0,9999,0
1715600418965,COGS 197,001,638244,Voytek; Bradley Thomas,9997,0,9999,2
1715600419991,CSE 191,A00,516875,Minnes Kemp; Mor Mia,9991,0,9999,8
1715600421016,CSE 197,001,637388,Minnes Kemp; Mor Mia,9992,0,9999,7
1715600422044,CSS 201S,A01,494383,Mignozzetti; Umberto,35,0,35,0
1715600423068,CSS 202S,A01,494387,Mignozzetti; Umberto,35,0,35,0
1715600424096,DSC 197,001,628532,Eldridge; Justin Matthew,9995,0,9999,4
1715600425123,EAP 100,A00,516065,Staff,9799,0,9999,200
1715600426154,ECE 45,A01,507414,Staff,31,0,60,29
1715600428209,ECE 111,A01,507420,Staff,11,0,50,39
1715600429237,ECE 197,001,548057,Sievenpiper; Daniel F.,9991,0,9999,8
1715600430270,EDS 115,A00,507243,Choi; Bailey Miyeon,7,0,28,21
1715600431298,EDS 117,A01,494379,Staff,0,6,34,34
1715600432331,EDS 125,A00,507246,Hopkins; Megan Beth,8,0,30,22
1715600433359,EDS 128A,A01,507264,Fargason; Sharon Gayle,6,0,26,20
1715600434390,EDS 128B,A01,507293,Pappas; Elizabeth,10,0,30,20
1715600435417,EDS 139,A00,507294,Fargason; Sharon Gayle,10,0,30,20
1715600435417,EDS 139,B00,507313,Pappas; Elizabeth,11,0,30,19
1715600436443,EDS 201,A00,507315,Staff,10,0,30,20
1715600437473,EDS 203,A01,507317,Halter; Christopher P.,10,0,30,20
1715600438502,EDS 204R,A01,507319,Halter; Christopher P.,0,3,30,30
1715600438502,EDS 204R,B01,507331,Heinzman; Erica M.,14,0,30,16
1715600439530,EDS 206R,A00,507332,Staff,0,4,30,30
1715600439530,EDS 206R,B00,507343,Staff,15,0,30,15
1715600440557,EDS 250,A00,507344,Hemans; Patricia Ann Benitez,20,0,40,20
1715600441584,EDS 281,A00,507345,Daly; Alan J.,18,0,18,0
1715600442610,EDS 284,A00,507350,Daly; Alan J.,16,0,16,0
1715600443635,EDS 286,A00,507359,Fine; Sarah,18,0,18,0
1715600444664,EDS 289C,A01,507361,Daly; Alan J.,18,0,18,0
1715600445693,EDS 290,A00,507366,Hofstetter; Carolyn,15,0,15,0
1715600446723,LIGM 5A,A00,507421,Fischer-Grunski; Eva K,17,0,20,3
1715600447750,LIGM 5B,A00,507423,Fischer-Grunski; Eva K,19,0,20,1
1715600448774,LIGM 5C,A00,507425,Fischer-Grunski; Eva K,19,0,20,1
1715600449803,LIIT 5AS,A00,507427,Carnelos; Chiara,20,0,20,0
1715600450831,LIIT 5BS,A00,507430,Carnelos; Chiara,20,0,20,0
1715600451860,LIIT 5CS,A00,507432,Carnelos; Chiara,20,0,20,0
1715600452887,LISP 5A,A00,507541,Munoz Sanchez; Alicia,11,0,20,9
1715600453917,LISP 5B,A00,507671,Munoz Sanchez; Alicia,9,0,20,11
1715600454942,LISP 5C,A00,507696,Munoz Sanchez; Alicia,9,0,20,11
1715600455968,MAE 197,001,528363,Boechler; Nicholas Sebastia,9998,0,9999,1
1715600457000,MATH 197,001,523477,Kedlaya; Kiran S.,9994,0,9999,5
1715600457000,MATH 197,002,563811,Zhang; Danna,9994,0,9999,5
1715600457000,MATH 197,003,628552,Dumitriu; Ioana,9998,0,9999,1
1715600457000,MATH 197,004,660885,Floyd; Eric,9999,0,9999,0
1715600458026,MCWP 40R,A00,518780,Staff,2,0,20,18
1715600458026,MCWP 40R,B00,518781,Staff,11,0,20,9
1715600458026,MCWP 40R,C00,518783,Staff,5,0,20,15
1715600459052,MCWP 50R,A00,518791,Staff,0,1,20,20
1715600459052,MCWP 50R,B00,518792,Staff,0,2,20,20
1715600459052,MCWP 50R,C00,518793,Staff,0,4,20,20
1715600459052,MCWP 50R,D00,518794,Staff,0,1,20,20
1715600459052,MCWP 50R,E00,518795,Staff,0,2,20,20
1715600459052,MCWP 50R,F00,518796,Staff,0,1,20,20
1715600459052,MCWP 50R,G00,518797,Staff,0,1,20,20
1715600460078,MMW 12R,A01,514034,Herbst; Matthew,0,2,16,16
1715600460078,MMW 12R,A02,514035,Herbst; Matthew,0,0,16,16
1715600461108,MMW 13R,A01,514037,Staff,0,5,16,16
1715600461108,MMW 13R,A02,514039,Staff,0,5,16,16
1715600461108,MMW 13R,A03,628519,Staff,0,4,16,16
1715600463163,SIO 295LS,A00,523233,Staff,10,0,30,20
1715600464192,SIO 295S,A00,523232,Staff,10,0,30,20
1715600465217,SIOC 290S,A01,637330,Merrifield; Mark A,23,0,30,7
1715600466241,SIOC 291S,A01,637333,Gabriel; Corey John,23,0,30,7
1715600467271,SOCI 117,A01,494376,Staff,0,5,5,5
1715600468299,WES 237B,A00,494380,Staff,10,0,20,10
1715600470375,AESE 279B,A00,494370,Wade; Jon P,0,0,33,33
1715600471402,AIP 97,001,660915,Van Den Einde; Yael Dahlia,9999,0,9999,0
1715600472430,AIP 197,001,627712,Vespa; Emanuel Ignacio,9995,0,9999,4
1715600472430,AIP 197,002,650778,Amir; On,9998,0,9999,1
1715600472430,AIP 197,003,650933,Avenancio-Leon; Carlos,9998,0,9999,1
1715600472430,AIP 197,004,658530,Heyman; Gail D.,9998,0,9999,1
1715600472430,AIP 197,005,658631,Neal; Sonya E,9998,0,9999,1
1715600472430,AIP 197,006,658671,Du; Songzi,9998,0,9999,1
1715600473460,ANAR 135S,A00,494369,Braswell; Geoffrey E.,0,0,0,0
1715600474486,BENG 196,001,628496,Engler; Adam J.,9998,0,9999,1
1715600474486,BENG 196,002,660916,Watson; John Thomas,9999,0,9999,0
1715600475517,BISP 197,001,650773,Wilhelm; James E.,9994,0,9999,5
1715600475517,BISP 197,002,658904,Coleman; Aaron B.,9998,0,9999,1
1715600476544,CAT 124RS,A01,519847,Geibel; William,0,0,20,20
1715600477570,CAT 125RS,A01,515971,Geibel; William,0,0,20,20
1715600478600,CLRE 250,A00,511389,Morris; Sheldon,9992,0,9999,7
1715600479629,CLRE 251,A00,507176,Mehta; Ravindra L.,9992,0,9999,7
1715600479629,CLRE 251,B00,511410,Mehta; Ravindra L.,9998,0,9999,1
1715600480659,CLRE 252,A00,507189,Cuomo; Raphael Eduardo,9994,0,9999,5
1715600481690,CLRE 253,A00,507199,Vaida; Florin,9994,0,9999,5
1715600481690,CLRE 253,B00,507202,Vaida; Florin,9999,0,9999,0
1715600482714,CLRE 259,A00,507211,Patel; Hemal,9996,0,9999,3
1715600483740,CLRE 260,A00,507221,Cuomo; Raphael Eduardo,9999,0,9999,0
1715600484764,CLRE 297,001,507242,Cuomo; Raphael Eduardo,9999,0,9999,0
1715600485791,COGS 197,001,638244,Voytek; Bradley Thomas,9997,0,9999,2
1715600486819,CSE 191,A00,516875,Minnes Kemp; Mor Mia,9991,0,9999,8
1715600487847,CSE 197,001,637388,Minnes Kemp; Mor Mia,9992,0,9999,7
1715600488879,CSS 201S,A01,494383,Mignozzetti; Umberto,35,0,35,0
1715600489909,CSS 202S,A01,494387,Mignozzetti; Umberto,35,0,35,0
1715600490937,DSC 197,001,628532,Eldridge; Justin Matthew,9995,0,9999,4
1715600491960,EAP 100,A00,516065,Staff,9799,0,9999,200
1715600492989,ECE 45,A01,507414,Staff,31,0,60,29
1715600495078,ECE 111,A01,507420,Staff,11,0,50,39
1715600496106,ECE 197,001,548057,Sievenpiper; Daniel F.,9991,0,9999,8
1715600497133,EDS 115,A00,507243,Choi; Bailey Miyeon,7,0,28,21
1715600498164,EDS 117,A01,494379,Staff,0,6,34,34
1715600499191,EDS 125,A00,507246,Hopkins; Megan Beth,8,0,30,22
1715600500217,EDS 128A,A01,507264,Fargason; Sharon Gayle,6,0,26,20
1715600501244,EDS 128B,A01,507293,Pappas; Elizabeth,10,0,30,20
1715600502269,EDS 139,A00,507294,Fargason; Sharon Gayle,10,0,30,20
1715600502269,EDS 139,B00,507313,Pappas; Elizabeth,11,0,30,19
1715600503295,EDS 201,A00,507315,Staff,10,0,30,20
1715600504321,EDS 203,A01,507317,Halter; Christopher P.,10,0,30,20
1715600505348,EDS 204R,A01,507319,Halter; Christopher P.,0,3,30,30
1715600505348,EDS 204R,B01,507331,Heinzman; Erica M.,14,0,30,16
1715600506373,EDS 206R,A00,507332,Staff,0,4,30,30
1715600506373,EDS 206R,B00,507343,Staff,15,0,30,15
1715600507403,EDS 250,A00,507344,Hemans; Patricia Ann Benitez,20,0,40,20
1715600508430,EDS 281,A00,507345,Daly; Alan J.,18,0,18,0
1715600509456,EDS 284,A00,507350,Daly; Alan J.,16,0,16,0
1715600510484,EDS 286,A00,507359,Fine; Sarah,18,0,18,0
1715600511512,EDS 289C,A01,507361,Daly; Alan J.,18,0,18,0
1715600512542,EDS 290,A00,507366,Hofstetter; Carolyn,15,0,15,0
1715600513569,LIGM 5A,A00,507421,Fischer-Grunski; Eva K,17,0,20,3
1715600514599,LIGM 5B,A00,507423,Fischer-Grunski; Eva K,19,0,20,1
1715600515624,LIGM 5C,A00,507425,Fischer-Grunski; Eva K,19,0,20,1
1715600516654,LIIT 5AS,A00,507427,Carnelos; Chiara,20,0,20,0
1715600517680,LIIT 5BS,A00,507430,Carnelos; Chiara,20,0,20,0
1715600518708,LIIT 5CS,A00,507432,Carnelos; Chiara,20,0,20,0
1715600519734,LISP 5A,A00,507541,Munoz Sanchez; Alicia,11,0,20,9
1715600520761,LISP 5B,A00,507671,Munoz Sanchez; Alicia,9,0,20,11
1715600521791,LISP 5C,A00,507696,Munoz Sanchez; Alicia,9,0,20,11
1715600522818,MAE 197,001,528363,Boechler; Nicholas Sebastia,9998,0,9999,1
1715600523854,MATH 197,001,523477,Kedlaya; Kiran S.,9994,0,9999,5
1715600523854,MATH 197,002,563811,Zhang; Danna,9994,0,9999,5
1715600523854,MATH 197,003,628552,Dumitriu; Ioana,9998,0,9999,1
1715600523854,MATH 197,004,660885,Floyd; Eric,9999,0,9999,0
1715600524880,MCWP 40R,A00,518780,Staff,2,0,20,18
1715600524880,MCWP 40R,B00,518781,Staff,11,0,20,9
1715600524880,MCWP 40R,C00,518783,Staff,5,0,20,15
1715600525912,MCWP 50R,A00,518791,Staff,0,1,20,20
1715600525912,MCWP 50R,B00,518792,Staff,0,2,20,20
1715600525912,MCWP 50R,C00,518793,Staff,0,4,20,20
1715600525912,MCWP 50R,D00,518794,Staff,0,1,20,20
1715600525912,MCWP 50R,E00,518795,Staff,0,2,20,20
1715600525912,MCWP 50R,F00,518796,Staff,0,1,20,20
1715600525912,MCWP 50R,G00,518797,Staff,0,1,20,20
1715600526942,MMW 12R,A01,514034,Herbst; Matthew,0,2,16,16
1715600526942,MMW 12R,A02,514035,Herbst; Matthew,0,0,16,16
1715600527968,MMW 13R,A01,514037,Staff,0,5,16,16
1715600527968,MMW 13R,A02,514039,Staff,0,5,16,16
1715600527968,MMW 13R,A03,628519,Staff,0,4,16,16
1715600530026,SIO 295LS,A00,523233,Staff,10,0,30,20
1715600531057,SIO 295S,A00,523232,Staff,10,0,30,20
1715600532084,SIOC 290S,A01,637330,Merrifield; Mark A,23,0,30,7
1715600533112,SIOC 291S,A01,637333,Gabriel; Corey John,23,0,30,7
1715600534138,SOCI 117,A01,494376,Staff,0,5,5,5
1715600535165,WES 237B,A00,494380,Staff,10,0,20,10
1715600537242,AESE 279B,A00,494370,Wade; Jon P,0,0,33,33
1715600538272,AIP 97,001,660915,Van Den Einde; Yael Dahlia,9999,0,9999,0
1715600539309,AIP 197,001,627712,Vespa; Emanuel Ignacio,9995,0,9999,4
1715600539309,AIP 197,002,650778,Amir; On,9998,0,9999,1
1715600539309,AIP 197,003,650933,Avenancio-Leon; Carlos,9998,0,9999,1
1715600539309,AIP 197,004,658530,Heyman; Gail D.,9998,0,9999,1
1715600539309,AIP 197,005,658631,Neal; Sonya E,9998,0,9999,1
1715600539309,AIP 197,006,658671,Du; Songzi,9998,0,9999,1
1715600540341,ANAR 135S,A00,494369,Braswell; Geoffrey E.,0,0,0,0
1715600541372,BENG 196,001,628496,Engler; Adam J.,9998,0,9999,1
1715600541372,BENG 196,002,660916,Watson; John Thomas,9999,0,9999,0
1715600542402,BISP 197,001,650773,Wilhelm; James E.,9994,0,9999,5
1715600542402,BISP 197,002,658904,Coleman; Aaron B.,9998,0,9999,1
1715600543430,CAT 124RS,A01,519847,Geibel; William,0,0,20,20
1715600544457,CAT 125RS,A01,515971,Geibel; William,0,0,20,20
1715600545484,CLRE 250,A00,511389,Morris; Sheldon,9992,0,9999,7
1715600546518,CLRE 251,A00,507176,Mehta; Ravindra L.,9992,0,9999,7
1715600546518,CLRE 251,B00,511410,Mehta; Ravindra L.,9998,0,9999,1
1715600547551,CLRE 252,A00,507189,Cuomo; Raphael Eduardo,9994,0,9999,5
1715600548582,CLRE 253,A00,507199,Vaida; Florin,9994,0,9999,5
1715600548582,CLRE 253,B00,507202,Vaida; Florin,9999,0,9999,0
1715600549611,CLRE 259,A00,507211,Patel; Hemal,9996,0,9999,3
1715600550638,CLRE 260,A00,507221,Cuomo; Raphael Eduardo,9999,0,9999,0
1715600551666,CLRE 297,001,507242,Cuomo; Raphael Eduardo,9999,0,9999,0
1715600552697,COGS 197,001,638244,Voytek; Bradley Thomas,9997,0,9999,2
1715600553729,CSE 191,A00,516875,Minnes Kemp; Mor Mia,9991,0,9999,8
1715600554755,CSE 197,001,637388,Minnes Kemp; Mor Mia,9992,0,9999,7
1715600555785,CSS 201S,A01,494383,Mignozzetti; Umberto,35,0,35,0
1715600556814,CSS 202S,A01,494387,Mignozzetti; Umberto,35,0,35,0
1715600557840,DSC 197,001,628532,Eldridge; Justin Matthew,9995,0,9999,4
1715600558866,EAP 100,A00,516065,Staff,9799,0,9999,200
1715600559894,ECE 45,A01,507414,Staff,31,0,60,29
1715600561948,ECE 111,A01,507420,Staff,11,0,50,39
1715600562976,ECE 197,001,548057,Sievenpiper; Daniel F.,9991,0,9999,8
1715600564004,EDS 115,A00,507243,Choi; Bailey Miyeon,7,0,28,21
1715600565031,EDS 117,A01,494379,Staff,0,6,34,34
1715600566061,EDS 125,A00,507246,Hopkins; Megan Beth,8,0,30,22
1715600567089,EDS 128A,A01,507264,Fargason; Sharon Gayle,6,0,26,20
1715600568119,EDS 128B,A01,507293,Pappas; Elizabeth,10,0,30,20
1715600569144,EDS 139,A00,507294,Fargason; Sharon Gayle,10,0,30,20
1715600569144,EDS 139,B00,507313,Pappas; Elizabeth,11,0,30,19
1715600570174,EDS 201,A00,507315,Staff,10,0,30,20
1715600571201,EDS 203,A01,507317,Halter; Christopher P.,10,0,30,20
1715600572238,EDS 204R,A01,507319,Halter; Christopher P.,0,3,30,30
1715600572238,EDS 204R,B01,507331,Heinzman; Erica M.,14,0,30,16
1715600573265,EDS 206R,A00,507332,Staff,0,4,30,30
1715600573265,EDS 206R,B00,507343,Staff,15,0,30,15
1715600574293,EDS 250,A00,507344,Hemans; Patricia Ann Benitez,20,0,40,20
1715600575321,EDS 281,A00,507345,Daly; Alan J.,18,0,18,0
1715600576348,EDS 284,A00,507350,Daly; Alan J.,16,0,16,0
1715600577373,EDS 286,A00,507359,Fine; Sarah,18,0,18,0
1715600578401,EDS 289C,A01,507361,Daly; Alan J.,18,0,18,0
1715600579428,EDS 290,A00,507366,Hofstetter; Carolyn,15,0,15,0
1715600580455,LIGM 5A,A00,507421,Fischer-Grunski; Eva K,17,0,20,3
1715600581480,LIGM 5B,A00,507423,Fischer-Grunski; Eva K,19,0,20,1
1715600582508,LIGM 5C,A00,507425,Fischer-Grunski; Eva K,19,0,20,1
1715600583536,LIIT 5AS,A00,507427,Carnelos; Chiara,20,0,20,0
1715600584564,LIIT 5BS,A00,507430,Carnelos; Chiara,20,0,20,0
1715600585590,LIIT 5CS,A00,507432,Carnelos; Chiara,20,0,20,0
1715600586624,LISP 5A,A00,507541,Munoz Sanchez; Alicia,11,0,20,9
1715600587658,LISP 5B,A00,507671,Munoz Sanchez; Alicia,9,0,20,11
1715600588687,LISP 5C,A00,507696,Munoz Sanchez; Alicia,9,0,20,11
1715600589719,MAE 197,001,528363,Boechler; Nicholas Sebastia,9998,0,9999,1
1715600590749,MATH 197,001,523477,Kedlaya; Kiran S.,9994,0,9999,5
1715600590749,MATH 197,002,563811,Zhang; Danna,9994,0,9999,5
1715600590749,MATH 197,003,628552,Dumitriu; Ioana,9998,0,9999,1
1715600590749,MATH 197,004,660885,Floyd; Eric,9999,0,9999,0
1715600591780,MCWP 40R,A00,518780,Staff,2,0,20,18
1715600591780,MCWP 40R,B00,518781,Staff,11,0,20,9
1715600591780,MCWP 40R,C00,518783,Staff,5,0,20,15
1715600592809,MCWP 50R,A00,518791,Staff,0,1,20,20
1715600592809,MCWP 50R,B00,518792,Staff,0,2,20,20
1715600592809,MCWP 50R,C00,518793,Staff,0,4,20,20
1715600592809,MCWP 50R,D00,518794,Staff,0,1,20,20
1715600592809,MCWP 50R,E00,518795,Staff,0,2,20,20
1715600592809,MCWP 50R,F00,518796,Staff,0,1,20,20
1715600592809,MCWP 50R,G00,518797,Staff,0,1,20,20
1715600593840,MMW 12R,A01,514034,Herbst; Matthew,0,2,16,16
1715600593840,MMW 12R,A02,514035,Herbst; Matthew,0,0,16,16
1715600594867,MMW 13R,A01,514037,Staff,0,5,16,16
1715600594867,MMW 13R,A02,514039,Staff,0,5,16,16
1715600594867,MMW 13R,A03,628519,Staff,0,4,16,16
1715600596922,SIO 295LS,A00,523233,Staff,10,0,30,20
1715600597948,SIO 295S,A00,523232,Staff,10,0,30,20
1715600598980,SIOC 290S,A01,637330,Merrifield; Mark A,23,0,30,7
1715600600008,SIOC 291S,A01,637333,Gabriel; Corey John,23,0,30,7
1715600601035,SOCI 117,A01,494376,Staff,0,5,5,5
1715600602061,WES 237B,A00,494380,Staff,10,0,20,10
1715600604169,AESE 279B,A00,494370,Wade; Jon P,0,0,33,33
1715600605198,AIP 97,001,660915,Van Den Einde; Yael Dahlia,9999,0,9999,0
1715600606228,AIP 197,001,627712,Vespa; Emanuel Ignacio,9995,0,9999,4
1715600606228,AIP 197,002,650778,Amir; On,9998,0,9999,1
1715600606228,AIP 197,003,650933,Avenancio-Leon; Carlos,9998,0,9999,1
1715600606228,AIP 197,004,658530,Heyman; Gail D.,9998,0,9999,1
1715600606228,AIP 197,005,658631,Neal; Sonya E,9998,0,9999,1
1715600606228,AIP 197,006,658671,Du; Songzi,9998,0,9999,1
1715600607257,ANAR 135S,A00,494369,Braswell; Geoffrey E.,0,0,0,0
1715600608285,BENG 196,001,628496,Engler; Adam J.,9998,0,9999,1
1715600608285,BENG 196,002,660916,Watson; John Thomas,9999,0,9999,0
1715600609316,BISP 197,001,650773,Wilhelm; James E.,9994,0,9999,5
1715600609316,BISP 197,002,658904,Coleman; Aaron B.,9998,0,9999,1
1715600610343,CAT 124RS,A01,519847,Geibel; William,0,0,20,20
1715600611371,CAT 125RS,A01,515971,Geibel; William,0,0,20,20
1715600612399,CLRE 250,A00,511389,Morris; Sheldon,9992,0,9999,7
1715600613428,CLRE 251,A00,507176,Mehta; Ravindra L.,9992,0,9999,7
1715600613428,CLRE 251,B00,511410,Mehta; Ravindra L.,9998,0,9999,1
1715600614455,CLRE 252,A00,507189,Cuomo; Raphael Eduardo,9994,0,9999,5
1715600615481,CLRE 253,A00,507199,Vaida; Florin,9994,0,9999,5
1715600615481,CLRE 253,B00,507202,Vaida; Florin,9999,0,9999,0
1715600616512,CLRE 259,A00,507211,Patel; Hemal,9996,0,9999,3
1715600617536,CLRE 260,A00,507221,Cuomo; Raphael Eduardo,9999,0,9999,0
1715600618566,CLRE 297,001,507242,Cuomo; Raphael Eduardo,9999,0,9999,0
1715600619592,COGS 197,001,638244,Voytek; Bradley Thomas,9997,0,9999,2
1715600620618,CSE 191,A00,516875,Minnes Kemp; Mor Mia,9991,0,9999,8
1715600621643,CSE 197,001,637388,Minnes Kemp; Mor Mia,9992,0,9999,7
1715600622671,CSS 201S,A01,494383,Mignozzetti; Umberto,35,0,35,0
1715600623699,CSS 202S,A01,494387,Mignozzetti; Umberto,35,0,35,0
1715600624725,DSC 197,001,628532,Eldridge; Justin Matthew,9995,0,9999,4
1715600625750,EAP 100,A00,516065,Staff,9799,0,9999,200
1715600626783,ECE 45,A01,507414,Staff,31,0,60,29
1715600628836,ECE 111,A01,507420,Staff,11,0,50,39
1715600629861,ECE 197,001,548057,Sievenpiper; Daniel F.,9991,0,9999,8
1715600630888,EDS 115,A00,507243,Choi; Bailey Miyeon,7,0,28,21
1715600631916,EDS 117,A01,494379,Staff,0,6,34,34
1715600632941,EDS 125,A00,507246,Hopkins; Megan Beth,8,0,30,22
1715600633967,EDS 128A,A01,507264,Fargason; Sharon Gayle,6,0,26,20
1715600634995,EDS 128B,A01,507293,Pappas; Elizabeth,10,0,30,20
1715600636024,EDS 139,A00,507294,Fargason; Sharon Gayle,10,0,30,20
1715600636024,EDS 139,B00,507313,Pappas; Elizabeth,11,0,30,19
1715600637051,EDS 201,A00,507315,Staff,10,0,30,20
1715600638105,EDS 203,A01,507317,Halter; Christopher P.,10,0,30,20
1715600639133,EDS 204R,A01,507319,Halter; Christopher P.,0,3,30,30
1715600639133,EDS 204R,B01,507331,Heinzman; Erica M.,14,0,30,16
1715600640162,EDS 206R,A00,507332,Staff,0,4,30,30
1715600640162,EDS 206R,B00,507343,Staff,15,0,30,15
1715600641187,EDS 250,A00,507344,Hemans; Patricia Ann Benitez,20,0,40,20
1715600642216,EDS 281,A00,507345,Daly; Alan J.,18,0,18,0
1715600643243,EDS 284,A00,507350,Daly; Alan J.,16,0,16,0
1715600644274,EDS 286,A00,507359,Fine; Sarah,18,0,18,0
1715600645300,EDS 289C,A01,507361,Daly; Alan J.,18,0,18,0
1715600646327,EDS 290,A00,507366,Hofstetter; Carolyn,15,0,15,0
1715600647354,LIGM 5A,A00,507421,Fischer-Grunski; Eva K,17,0,20,3
1715600648383,LIGM 5B,A00,507423,Fischer-Grunski; Eva K,19,0,20,1
1715600649411,LIGM 5C,A00,507425,Fischer-Grunski; Eva K,19,0,20,1
1715600650436,LIIT 5AS,A00,507427,Carnelos; Chiara,20,0,20,0
1715600651466,LIIT 5BS,A00,507430,Carnelos; Chiara,20,0,20,0
1715600652499,LIIT 5CS,A00,507432,Carnelos; Chiara,20,0,20,0
1715600653527,LISP 5A,A00,507541,Munoz Sanchez; Alicia,11,0,20,9
1715600654551,LISP 5B,A00,507671,Munoz Sanchez; Alicia,9,0,20,11
1715600655579,LISP 5C,A00,507696,Munoz Sanchez; Alicia,9,0,20,11
1715600656611,MAE 197,001,528363,Boechler; Nicholas Sebastia,9998,0,9999,1
1715600657647,MATH 197,001,523477,Kedlaya; Kiran S.,9994,0,9999,5
1715600657647,MATH 197,002,563811,Zhang; Danna,9994,0,9999,5
1715600657647,MATH 197,003,628552,Dumitriu; Ioana,9998,0,9999,1
1715600657647,MATH 197,004,660885,Floyd; Eric,9999,0,9999,0
1715600658674,MCWP 40R,A00,518780,Staff,2,0,20,18
1715600658674,MCWP 40R,B00,518781,Staff,11,0,20,9
1715600658674,MCWP 40R,C00,518783,Staff,5,0,20,15
1715600659701,MCWP 50R,A00,518791,Staff,0,1,20,20
1715600659701,MCWP 50R,B00,518792,Staff,0,2,20,20
1715600659701,MCWP 50R,C00,518793,Staff,0,4,20,20
1715600659701,MCWP 50R,D00,518794,Staff,0,1,20,20
1715600659701,MCWP 50R,E00,518795,Staff,0,2,20,20
1715600659701,MCWP 50R,F00,518796,Staff,0,1,20,20
1715600659701,MCWP 50R,G00,518797,Staff,0,1,20,20
1715600660730,MMW 12R,A01,514034,Herbst; Matthew,0,2,16,16
1715600660730,MMW 12R,A02,514035,Herbst; Matthew,0,0,16,16
1715600661758,MMW 13R,A01,514037,Staff,0,5,16,16
1715600661758,MMW 13R,A02,514039,Staff,0,5,16,16
1715600661758,MMW 13R,A03,628519,Staff,0,4,16,16
1715600663809,SIO 295LS,A00,523233,Staff,10,0,30,20
1715600664838,SIO 295S,A00,523232,Staff,10,0,30,20
1715600665865,SIOC 290S,A01,637330,Merrifield; Mark A,23,0,30,7
1715600666895,SIOC 291S,A01,637333,Gabriel; Corey John,23,0,30,7
1715600667924,SOCI 117,A01,494376,Staff,0,5,5,5
1715600668953,WES 237B,A00,494380,Staff,10,0,20,10
1715600671029,AESE 279B,A00,494370,Wade; Jon P,0,0,33,33
1715600672056,AIP 97,001,660915,Van Den Einde; Yael Dahlia,9999,0,9999,0
1715600673091,AIP 197,001,627712,Vespa; Emanuel Ignacio,9995,0,9999,4
1715600673091,AIP 197,002,650778,Amir; On,9998,0,9999,1
1715600673091,AIP 197,003,650933,Avenancio-Leon; Carlos,9998,0,9999,1
1715600673091,AIP 197,004,658530,Heyman; Gail D.,9998,0,9999,1
1715600673091,AIP 197,005,658631,Neal; Sonya E,9998,0,9999,1
1715600673091,AIP 197,006,658671,Du; Songzi,9998,0,9999,1
1715600674245,ANAR 135S,A00,494369,Braswell; Geoffrey E.,0,0,0,0
1715600675274,BENG 196,001,628496,Engler; Adam J.,9998,0,9999,1
1715600675274,BENG 196,002,660916,Watson; John Thomas,9999,0,9999,0
1715600676303,BISP 197,001,650773,Wilhelm; James E.,9994,0,9999,5
1715600676303,BISP 197,002,658904,Coleman; Aaron B.,9998,0,9999,1
1715600677329,CAT 124RS,A01,519847,Geibel; William,0,0,20,20
1715600678354,CAT 125RS,A01,515971,Geibel; William,0,0,20,20
1715600679383,CLRE 250,A00,511389,Morris; Sheldon,9992,0,9999,7
1715600680409,CLRE 251,A00,507176,Mehta; Ravindra L.,9992,0,9999,7
1715600680409,CLRE 251,B00,511410,Mehta; Ravindra L.,9998,0,9999,1
1715600681435,CLRE 252,A00,507189,Cuomo; Raphael Eduardo,9994,0,9999,5
1715600682465,CLRE 253,A00,507199,Vaida; Florin,9994,0,9999,5
1715600682465,CLRE 253,B00,507202,Vaida; Florin,9999,0,9999,0
1715600683509,CLRE 259,A00,507211,Patel; Hemal,9996,0,9999,3
1715600684534,CLRE 260,A00,507221,Cuomo; Raphael Eduardo,9999,0,9999,0
1715600685562,CLRE 297,001,507242,Cuomo; Raphael Eduardo,9999,0,9999,0
1715600686587,COGS 197,001,638244,Voytek; Bradley Thomas,9997,0,9999,2
1715600687614,CSE 191,A00,516875,Minnes Kemp; Mor Mia,9991,0,9999,8
1715600688639,CSE 197,001,637388,Minnes Kemp; Mor Mia,9992,0,9999,7
1715600689665,CSS 201S,A01,494383,Mignozzetti; Umberto,35,0,35,0
1715600690690,CSS 202S,A01,494387,Mignozzetti; Umberto,35,0,35,0
1715600691716,DSC 197,001,628532,Eldridge; Justin Matthew,9995,0,9999,4
1715600692742,EAP 100,A00,516065,Staff,9799,0,9999,200
1715600693773,ECE 45,A01,507414,Staff,31,0,60,29
1715600695827,ECE 111,A01,507420,Staff,11,0,50,39
1715600696855,ECE 197,001,548057,Sievenpiper; Daniel F.,9991,0,9999,8
1715600697882,EDS 115,A00,507243,Choi; Bailey Miyeon,7,0,28,21
1715600698910,EDS 117,A01,494379,Staff,0,6,34,34
1715600699937,EDS 125,A00,507246,Hopkins; Megan Beth,8,0,30,22
1715600700964,EDS 128A,A01,507264,Fargason; Sharon Gayle,6,0,26,20
1715600701989,EDS 128B,A01,507293,Pappas; Elizabeth,10,0,30,20
1715600703018,EDS 139,A00,507294,Fargason; Sharon Gayle,10,0,30,20
1715600703018,EDS 139,B00,507313,Pappas; Elizabeth,11,0,30,19
1715600704044,EDS 201,A00,507315,Staff,10,0,30,20
1715600705073,EDS 203,A01,507317,Halter; Christopher P.,10,0,30,20
1715600706103,EDS 204R,A01,507319,Halter; Christopher P.,0,3,30,30
1715600706103,EDS 204R,B01,507331,Heinzman; Erica M.,14,0,30,16
1715600707129,EDS 206R,A00,507332,Staff,0,4,30,30
1715600707129,EDS 206R,B00,507343,Staff,15,0,30,15
1715600708155,EDS 250,A00,507344,Hemans; Patricia Ann Benitez,20,0,40,20
1715600709183,EDS 281,A00,507345,Daly; Alan J.,18,0,18,0
1715600710208,EDS 284,A00,507350,Daly; Alan J.,16,0,16,0
1715600711237,EDS 286,A00,507359,Fine; Sarah,18,0,18,0
1715600712266,EDS 289C,A01,507361,Daly; Alan J.,18,0,18,0
1715600713293,EDS 290,A00,507366,Hofstetter; Carolyn,15,0,15,0
1715600714321,LIGM 5A,A00,507421,Fischer-Grunski; Eva K,17,0,20,3
1715600715350,LIGM 5B,A00,507423,Fischer-Grunski; Eva K,19,0,20,1
1715600716378,LIGM 5C,A00,507425,Fischer-Grunski; Eva K,19,0,20,1
1715600717405,LIIT 5AS,A00,507427,Carnelos; Chiara,20,0,20,0
1715600718430,LIIT 5BS,A00,507430,Carnelos; Chiara,20,0,20,0
1715600719457,LIIT 5CS,A00,507432,Carnelos; Chiara,20,0,20,0
1715600720488,LISP 5A,A00,507541,Munoz Sanchez; Alicia,11,0,20,9
1715600721517,LISP 5B,A00,507671,Munoz Sanchez; Alicia,9,0,20,11
1715600722542,LISP 5C,A00,507696,Munoz Sanchez; Alicia,9,0,20,11
1715600723570,MAE 197,001,528363,Boechler; Nicholas Sebastia,9998,0,9999,1
1715600734901,MATH 197,001,523477,Kedlaya; Kiran S.,9994,0,9999,5
1715600734901,MATH 197,002,563811,Zhang; Danna,9994,0,9999,5
1715600734901,MATH 197,003,628552,Dumitriu; Ioana,9998,0,9999,1
1715600734901,MATH 197,004,660885,Floyd; Eric,9999,0,9999,0
1715600735931,MCWP 40R,A00,518780,Staff,2,0,20,18
1715600735931,MCWP 40R,B00,518781,Staff,11,0,20,9
1715600735931,MCWP 40R,C00,518783,Staff,5,0,20,15
1715600737050,MCWP 50R,A00,518791,Staff,0,1,20,20
1715600737050,MCWP 50R,B00,518792,Staff,0,2,20,20
1715600737050,MCWP 50R,C00,518793,Staff,0,4,20,20
1715600737050,MCWP 50R,D00,518794,Staff,0,1,20,20
1715600737050,MCWP 50R,E00,518795,Staff,0,2,20,20
1715600737050,MCWP 50R,F00,518796,Staff,0,1,20,20
1715600737050,MCWP 50R,G00,518797,Staff,0,1,20,20
1715600738081,MMW 12R,A01,514034,Herbst; Matthew,0,2,16,16
1715600738081,MMW 12R,A02,514035,Herbst; Matthew,0,0,16,16
1715600739117,MMW 13R,A01,514037,Staff,0,5,16,16
1715600739117,MMW 13R,A02,514039,Staff,0,5,16,16
1715600739117,MMW 13R,A03,628519,Staff,0,4,16,16
1715600741178,SIO 295LS,A00,523233,Staff,10,0,30,20
1715600742206,SIO 295S,A00,523232,Staff,10,0,30,20
1715600743236,SIOC 290S,A01,637330,Merrifield; Mark A,23,0,30,7
1715600744270,SIOC 291S,A01,637333,Gabriel; Corey John,23,0,30,7
1715600756274,SOCI 117,A01,494376,Staff,0,5,5,5
1715600757304,WES 237B,A00,494380,Staff,10,0,20,10
1715600759415,AESE 279B,A00,494370,Wade; Jon P,0,0,33,33
1715600760448,AIP 97,001,660915,Van Den Einde; Yael Dahlia,9999,0,9999,0
1715600761480,AIP 197,001,627712,Vespa; Emanuel Ignacio,9995,0,9999,4
1715600761480,AIP 197,002,650778,Amir; On,9998,0,9999,1
1715600761480,AIP 197,003,650933,Avenancio-Leon; Carlos,9998,0,9999,1
1715600761480,AIP 197,004,658530,Heyman; Gail D.,9998,0,9999,1
1715600761480,AIP 197,005,658631,Neal; Sonya E,9998,0,9999,1
1715600761480,AIP 197,006,658671,Du; Songzi,9998,0,9999,1
1715600762514,ANAR 135S,A00,494369,Braswell; Geoffrey E.,0,0,0,0
1715600763543,BENG 196,001,628496,Engler; Adam J.,9998,0,9999,1
1715600763543,BENG 196,002,660916,Watson; John Thomas,9999,0,9999,0
1715600764573,BISP 197,001,650773,Wilhelm; James E.,9994,0,9999,5
1715600764573,BISP 197,002,658904,Coleman; Aaron B.,9998,0,9999,1
1715600765602,CAT 124RS,A01,519847,Geibel; William,0,0,20,20
1715600777407,CAT 125RS,A01,515971,Geibel; William,0,0,20,20
1715600778442,CLRE 250,A00,511389,Morris; Sheldon,9992,0,9999,7
1715600779481,CLRE 251,A00,507176,Mehta; Ravindra L.,9992,0,9999,7
1715600779481,CLRE 251,B00,511410,Mehta; Ravindra L.,9998,0,9999,1
1715600780513,CLRE 252,A00,507189,Cuomo; Raphael Eduardo,9994,0,9999,5
1715600781539,CLRE 253,A00,507199,Vaida; Florin,9994,0,9999,5
1715600781539,CLRE 253,B00,507202,Vaida; Florin,9999,0,9999,0
1715600782565,CLRE 259,A00,507211,Patel; Hemal,9996,0,9999,3
1715600783593,CLRE 260,A00,507221,Cuomo; Raphael Eduardo,9999,0,9999,0
1715600784628,CLRE 297,001,507242,Cuomo; Raphael Eduardo,9999,0,9999,0
1715600785658,COGS 197,001,638244,Voytek; Bradley Thomas,9997,0,9999,2
1715600786686,CSE 191,A00,516875,Minnes Kemp; Mor Mia,9991,0,9999,8
1715600787791,CSE 197,001,637388,Minnes Kemp; Mor Mia,9992,0,9999,7
1715600799180,CSS 201S,A01,494383,Mignozzetti; Umberto,35,0,35,0
1715600800208,CSS 202S,A01,494387,Mignozzetti; Umberto,35,0,35,0
1715600801241,DSC 197,001,628532,Eldridge; Justin Matthew,9995,0,9999,4
1715600802270,EAP 100,A00,516065,Staff,9799,0,9999,200
1715600803307,ECE 45,A01,507414,Staff,31,0,60,29
1715600805364,ECE 111,A01,507420,Staff,11,0,50,39
1715600806394,ECE 197,001,548057,Sievenpiper; Daniel F.,9991,0,9999,8
1715600807428,EDS 115,A00,507243,Choi; Bailey Miyeon,7,0,28,21
1715600808457,EDS 117,A01,494379,Staff,0,6,34,34
1715600809529,EDS 125,A00,507246,Hopkins; Megan Beth,8,0,30,22
1715600821095,EDS 128A,A01,507264,Fargason; Sharon Gayle,6,0,26,20
1715600822131,EDS 128B,A01,507293,Pappas; Elizabeth,10,0,30,20
1715600823160,EDS 139,A00,507294,Fargason; Sharon Gayle,10,0,30,20
1715600823160,EDS 139,B00,507313,Pappas; Elizabeth,11,0,30,19
1715600824186,EDS 201,A00,507315,Staff,10,0,30,20
1715600825215,EDS 203,A01,507317,Halter; Christopher P.,10,0,30,20
1715600826243,EDS 204R,A01,507319,Halter; Christopher P.,0,3,30,30
1715600826243,EDS 204R,B01,507331,Heinzman; Erica M.,14,0,30,16
1715600827271,EDS 206R,A00,507332,Staff,0,4,30,30
1715600827271,EDS 206R,B00,507343,Staff,15,0,30,15
1715600828302,EDS 250,A00,507344,Hemans; Patricia Ann Benitez,20,0,40,20
1715600829332,EDS 281,A00,507345,Daly; Alan J.,18,0,18,0
1715600830359,EDS 284,A00,507350,Daly; Alan J.,16,0,16,0
1715600842290,EDS 286,A00,507359,Fine; Sarah,18,0,18,0
1715600843321,EDS 289C,A01,507361,Daly; Alan J.,18,0,18,0
1715600844353,EDS 290,A00,507366,Hofstetter; Carolyn,15,0,15,0
1715600845383,LIGM 5A,A00,507421,Fischer-Grunski; Eva K,17,0,20,3
1715600846415,LIGM 5B,A00,507423,Fischer-Grunski; Eva K,19,0,20,1
1715600847442,LIGM 5C,A00,507425,Fischer-Grunski; Eva K,19,0,20,1
1715600848472,LIIT 5AS,A00,507427,Carnelos; Chiara,20,0,20,0
1715600849503,LIIT 5BS,A00,507430,Carnelos; Chiara,20,0,20,0
1715600850558,LIIT 5CS,A00,507432,Carnelos; Chiara,20,0,20,0
1715600851585,LISP 5A,A00,507541,Munoz Sanchez; Alicia,11,0,20,9
1715600863724,LISP 5B,A00,507671,Munoz Sanchez; Alicia,9,0,20,11
1715600864754,LISP 5C,A00,507696,Munoz Sanchez; Alicia,9,0,20,11
1715600865784,MAE 197,001,528363,Boechler; Nicholas Sebastia,9998,0,9999,1
1715600866823,MATH 197,001,523477,Kedlaya; Kiran S.,9994,0,9999,5
1715600866823,MATH 197,002,563811,Zhang; Danna,9994,0,9999,5
1715600866823,MATH 197,003,628552,Dumitriu; Ioana,9998,0,9999,1
1715600866823,MATH 197,004,660885,Floyd; Eric,9999,0,9999,0
1715600867858,MCWP 40R,A00,518780,Staff,2,0,20,18
1715600867858,MCWP 40R,B00,518781,Staff,11,0,20,9
1715600867858,MCWP 40R,C00,518783,Staff,5,0,20,15
1715600868885,MCWP 50R,A00,518791,Staff,0,1,20,20
1715600868885,MCWP 50R,B00,518792,Staff,0,2,20,20
1715600868885,MCWP 50R,C00,518793,Staff,0,4,20,20
1715600868885,MCWP 50R,D00,518794,Staff,0,1,20,20
1715600868885,MCWP 50R,E00,518795,Staff,0,2,20,20
1715600868885,MCWP 50R,F00,518796,Staff,0,1,20,20
1715600868885,MCWP 50R,G00,518797,Staff,0,1,20,20
1715600869912,MMW 12R,A01,514034,Herbst; Matthew,0,2,16,16
1715600869912,MMW 12R,A02,514035,Herbst; Matthew,0,0,16,16
1715600870947,MMW 13R,A01,514037,Staff,0,5,16,16
1715600870947,MMW 13R,A02,514039,Staff,0,5,16,16
1715600870947,MMW 13R,A03,628519,Staff,0,4,16,16
1715600873006,SIO 295LS,A00,523233,Staff,10,0,30,20
1715600877303,SIO 295S,A00,523232,Staff,10,0,30,20
1715600878334,SIOC 290S,A01,637330,Merrifield; Mark A,23,0,30,7
1715600879361,SIOC 291S,A01,637333,Gabriel; Corey John,23,0,30,7
1715600880396,SOCI 117,A01,494376,Staff,0,5,5,5
1715600881426,WES 237B,A00,494380,Staff,10,0,20,10
1715600883508,AESE 279B,A00,494370,Wade; Jon P,0,0,33,33
1715600884535,AIP 97,001,660915,Van Den Einde; Yael Dahlia,9999,0,9999,0
1715600885564,AIP 197,001,627712,Vespa; Emanuel Ignacio,9995,0,9999,4
1715600885564,AIP 197,002,650778,Amir; On,9998,0,9999,1
1715600885564,AIP 197,003,650933,Avenancio-Leon; Carlos,9998,0,9999,1
1715600885564,AIP 197,004,658530,Heyman; Gail D.,9998,0,9999,1
1715600885564,AIP 197,005,658631,Neal; Sonya E,9998,0,9999,1
1715600885564,AIP 197,006,658671,Du; Songzi,9998,0,9999,1
1715600886594,ANAR 135S,A00,494369,Braswell; Geoffrey E.,0,0,0,0
1715600887623,BENG 196,001,628496,Engler; Adam J.,9998,0,9999,1
1715600887623,BENG 196,002,660916,Watson; John Thomas,9999,0,9999,0
1715600888650,BISP 197,001,650773,Wilhelm; James E.,9994,0,9999,5
1715600888650,BISP 197,002,658904,Coleman; Aaron B.,9998,0,9999,1
1715600889679,CAT 124RS,A01,519847,Geibel; William,0,0,20,20
1715600890706,CAT 125RS,A01,515971,Geibel; William,0,0,20,20
1715600891735,CLRE 250,A00,511389,Morris; Sheldon,9992,0,9999,7
1715600892769,CLRE 251,A00,507176,Mehta; Ravindra L.,9992,0,9999,7
1715600892769,CLRE 251,B00,511410,Mehta; Ravindra L.,9998,0,9999,1
1715600893797,CLRE 252,A00,507189,Cuomo; Raphael Eduardo,9994,0,9999,5
1715600894829,CLRE 253,A00,507199,Vaida; Florin,9994,0,9999,5
1715600894829,CLRE 253,B00,507202,Vaida; Florin,9999,0,9999,0
1715600895855,CLRE 259,A00,507211,Patel; Hemal,9996,0,9999,3
1715600896885,CLRE 260,A00,507221,Cuomo; Raphael Eduardo,9999,0,9999,0
1715600897914,CLRE 297,001,507242,Cuomo; Raphael Eduardo,9999,0,9999,0
1715600898963,COGS 197,001,638244,Voytek; Bradley Thomas,9997,0,9999,2
1715600899989,CSE 191,A00,516875,Minnes Kemp; Mor Mia,9991,0,9999,8
1715600901015,CSE 197,001,637388,Minnes Kemp; Mor Mia,9992,0,9999,7
1715600902041,CSS 201S,A01,494383,Mignozzetti; Umberto,35,0,35,0
1715600903073,CSS 202S,A01,494387,Mignozzetti; Umberto,35,0,35,0
1715600904101,DSC 197,001,628532,Eldridge; Justin Matthew,9995,0,9999,4
1715600905129,EAP 100,A00,516065,Staff,9799,0,9999,200
1715600906159,ECE 45,A01,507414,Staff,31,0,60,29
1715600908217,ECE 111,A01,507420,Staff,11,0,50,39
1715600909245,ECE 197,001,548057,Sievenpiper; Daniel F.,9991,0,9999,8
1715600910277,EDS 115,A00,507243,Choi; Bailey Miyeon,7,0,28,21
1715600911308,EDS 117,A01,494379,Staff,0,6,34,34
1715600912334,EDS 125,A00,507246,Hopkins; Megan Beth,8,0,30,22
1715600913364,EDS 128A,A01,507264,Fargason; Sharon Gayle,6,0,26,20
1715600914393,EDS 128B,A01,507293,Pappas; Elizabeth,10,0,30,20
1715600915420,EDS 139,A00,507294,Fargason; Sharon Gayle,10,0,30,20
1715600915420,EDS 139,B00,507313,Pappas; Elizabeth,11,0,30,19
1715600916446,EDS 201,A00,507315,Staff,10,0,30,20
1715600917477,EDS 203,A01,507317,Halter; Christopher P.,10,0,30,20
1715600918503,EDS 204R,A01,507319,Halter; Christopher P.,0,3,30,30
1715600918503,EDS 204R,B01,507331,Heinzman; Erica M.,14,0,30,16
1715600919534,EDS 206R,A00,507332,Staff,0,4,30,30
1715600919534,EDS 206R,B00,507343,Staff,15,0,30,15
1715600920560,EDS 250,A00,507344,Hemans; Patricia Ann Benitez,20,0,40,20
1715600921587,EDS 281,A00,507345,Daly; Alan J.,18,0,18,0
1715600922612,EDS 284,A00,507350,Daly; Alan J.,16,0,16,0
1715600923639,EDS 286,A00,507359,Fine; Sarah,18,0,18,0
1715600924667,EDS 289C,A01,507361,Daly; Alan J.,18,0,18,0
1715600925692,EDS 290,A00,507366,Hofstetter; Carolyn,15,0,15,0
1715600926719,LIGM 5A,A00,507421,Fischer-Grunski; Eva K,17,0,20,3
1715600927750,LIGM 5B,A00,507423,Fischer-Grunski; Eva K,19,0,20,1
1715600928778,LIGM 5C,A00,507425,Fischer-Grunski; Eva K,19,0,20,1
1715600929804,LIIT 5AS,A00,507427,Carnelos; Chiara,20,0,20,0
1715600930834,LIIT 5BS,A00,507430,Carnelos; Chiara,20,0,20,0
1715600931879,LIIT 5CS,A00,507432,Carnelos; Chiara,20,0,20,0
1715600932908,LISP 5A,A00,507541,Munoz Sanchez; Alicia,11,0,20,9
1715600933941,LISP 5B,A00,507671,Munoz Sanchez; Alicia,9,0,20,11
1715600934976,LISP 5C,A00,507696,Munoz Sanchez; Alicia,9,0,20,11
1715600936007,MAE 197,001,528363,Boechler; Nicholas Sebastia,9998,0,9999,1
1715600937036,MATH 197,001,523477,Kedlaya; Kiran S.,9994,0,9999,5
1715600937036,MATH 197,002,563811,Zhang; Danna,9994,0,9999,5
1715600937036,MATH 197,003,628552,Dumitriu; Ioana,9998,0,9999,1
1715600937036,MATH 197,004,660885,Floyd; Eric,9999,0,9999,0
1715600938065,MCWP 40R,A00,518780,Staff,2,0,20,18
1715600938065,MCWP 40R,B00,518781,Staff,11,0,20,9
1715600938065,MCWP 40R,C00,518783,Staff,5,0,20,15
1715600939092,MCWP 50R,A00,518791,Staff,0,1,20,20
1715600939092,MCWP 50R,B00,518792,Staff,0,2,20,20
1715600939092,MCWP 50R,C00,518793,Staff,0,4,20,20
1715600939092,MCWP 50R,D00,518794,Staff,0,1,20,20
1715600939092,MCWP 50R,E00,518795,Staff,0,2,20,20
1715600939092,MCWP 50R,F00,518796,Staff,0,1,20,20
1715600939092,MCWP 50R,G00,518797,Staff,0,1,20,20
1715600940126,MMW 12R,A01,514034,Herbst; Matthew,0,2,16,16
1715600940126,MMW 12R,A02,514035,Herbst; Matthew,0,0,16,16
1715600941156,MMW 13R,A01,514037,Staff,0,5,16,16
1715600941156,MMW 13R,A02,514039,Staff,0,5,16,16
1715600941156,MMW 13R,A03,628519,Staff,0,4,16,16
1715600943218,SIO 295LS,A00,523233,Staff,10,0,30,20
1715600944245,SIO 295S,A00,523232,Staff,10,0,30,20
1715600945274,SIOC 290S,A01,637330,Merrifield; Mark A,23,0,30,7
1715600946305,SIOC 291S,A01,637333,Gabriel; Corey John,23,0,30,7
1715600947333,SOCI 117,A01,494376,Staff,0,5,5,5
1715600948360,WES 237B,A00,494380,Staff,10,0,20,10
1715600950435,AESE 279B,A00,494370,Wade; Jon P,0,0,33,33
1715600951464,AIP 97,001,660915,Van Den Einde; Yael Dahlia,9999,0,9999,0
1715600952494,AIP 197,001,627712,Vespa; Emanuel Ignacio,9995,0,9999,4
1715600952494,AIP 197,002,650778,Amir; On,9998,0,9999,1
1715600952494,AIP 197,003,650933,Avenancio-Leon; Carlos,9998,0,9999,1
1715600952494,AIP 197,004,658530,Heyman; Gail D.,9998,0,9999,1
1715600952494,AIP 197,005,658631,Neal; Sonya E,9998,0,9999,1
1715600952494,AIP 197,006,658671,Du; Songzi,9998,0,9999,1
1715600953524,ANAR 135S,A00,494369,Braswell; Geoffrey E.,0,0,0,0
1715600954557,BENG 196,001,628496,Engler; Adam J.,9998,0,9999,1
1715600954557,BENG 196,002,660916,Watson; John Thomas,9999,0,9999,0
1715600955584,BISP 197,001,650773,Wilhelm; James E.,9994,0,9999,5
1715600955584,BISP 197,002,658904,Coleman; Aaron B.,9998,0,9999,1
1715600956615,CAT 124RS,A01,519847,Geibel; William,0,0,20,20
1715600957642,CAT 125RS,A01,515971,Geibel; William,0,0,20,20
1715600958668,CLRE 250,A00,511389,Morris; Sheldon,9992,0,9999,7
1715600959699,CLRE 251,A00,507176,Mehta; Ravindra L.,9992,0,9999,7
1715600959699,CLRE 251,B00,511410,Mehta; Ravindra L.,9998,0,9999,1
1715600960729,CLRE 252,A00,507189,Cuomo; Raphael Eduardo,9994,0,9999,5
1715600961755,CLRE 253,A00,507199,Vaida; Florin,9994,0,9999,5
1715600961755,CLRE 253,B00,507202,Vaida; Florin,9999,0,9999,0
1715600962782,CLRE 259,A00,507211,Patel; Hemal,9996,0,9999,3
1715600963812,CLRE 260,A00,507221,Cuomo; Raphael Eduardo,9999,0,9999,0
1715600964841,CLRE 297,001,507242,Cuomo; Raphael Eduardo,9999,0,9999,0
1715600965869,COGS 197,001,638244,Voytek; Bradley Thomas,9997,0,9999,2
1715600966896,CSE 191,A00,516875,Minnes Kemp; Mor Mia,9991,0,9999,8
1715600967924,CSE 197,001,637388,Minnes Kemp; Mor Mia,9992,0,9999,7
1715600968953,CSS 201S,A01,494383,Mignozzetti; Umberto,35,0,35,0
1715600969980,CSS 202S,A01,494387,Mignozzetti; Umberto,35,0,35,0
1715600971010,DSC 197,001,628532,Eldridge; Justin Matthew,9995,0,9999,4
1715600972037,EAP 100,A00,516065,Staff,9799,0,9999,200
1715600973069,ECE 45,A01,507414,Staff,31,0,60,29
1715600975127,ECE 111,A01,507420,Staff,11,0,50,39
1715600976160,ECE 197,001,548057,Sievenpiper; Daniel F.,9991,0,9999,8
1715600977189,EDS 115,A00,507243,Choi; Bailey Miyeon,7,0,28,21
1715600978218,EDS 117,A01,494379,Staff,0,6,34,34
1715600979250,EDS 125,A00,507246,Hopkins; Megan Beth,8,0,30,22
1715600980281,EDS 128A,A01,507264,Fargason; Sharon Gayle,6,0,26,20
1715600981312,EDS 128B,A01,507293,Pappas; Elizabeth,10,0,30,20
1715600982342,EDS 139,A00,507294,Fargason; Sharon Gayle,10,0,30,20
1715600982342,EDS 139,B00,507313,Pappas; Elizabeth,11,0,30,19
1715600983367,EDS 201,A00,507315,Staff,10,0,30,20
1715600984396,EDS 203,A01,507317,Halter; Christopher P.,10,0,30,20
1715600985423,EDS 204R,A01,507319,Halter; Christopher P.,0,3,30,30
1715600985423,EDS 204R,B01,507331,Heinzman; Erica M.,14,0,30,16
1715600986450,EDS 206R,A00,507332,Staff,0,4,30,30
1715600986450,EDS 206R,B00,507343,Staff,15,0,30,15
1715600987480,EDS 250,A00,507344,Hemans; Patricia Ann Benitez,20,0,40,20
1715600988508,EDS 281,A00,507345,Daly; Alan J.,18,0,18,0
1715600989537,EDS 284,A00,507350,Daly; Alan J.,16,0,16,0
1715600990569,EDS 286,A00,507359,Fine; Sarah,18,0,18,0
1715600991597,EDS 289C,A01,507361,Daly; Alan J.,18,0,18,0
1715600992627,EDS 290,A00,507366,Hofstetter; Carolyn,15,0,15,0
1715600993657,LIGM 5A,A00,507421,Fischer-Grunski; Eva K,17,0,20,3
1715600994688,LIGM 5B,A00,507423,Fischer-Grunski; Eva K,19,0,20,1
1715600995714,LIGM 5C,A00,507425,Fischer-Grunski; Eva K,19,0,20,1
1715600996748,LIIT 5AS,A00,507427,Carnelos; Chiara,20,0,20,0
1715600997778,LIIT 5BS,A00,507430,Carnelos; Chiara,20,0,20,0
1715600998804,LIIT 5CS,A00,507432,Carnelos; Chiara,20,0,20,0
1715600999833,LISP 5A,A00,507541,Munoz Sanchez; Alicia,11,0,20,9
1715601000860,LISP 5B,A00,507671,Munoz Sanchez; Alicia,9,0,20,11
1715601001892,LISP 5C,A00,507696,Munoz Sanchez; Alicia,9,0,20,11
1715601002920,MAE 197,001,528363,Boechler; Nicholas Sebastia,9998,0,9999,1
1715601003956,MATH 197,001,523477,Kedlaya; Kiran S.,9994,0,9999,5
1715601003956,MATH 197,002,563811,Zhang; Danna,9994,0,9999,5
1715601003956,MATH 197,003,628552,Dumitriu; Ioana,9998,0,9999,1
1715601003956,MATH 197,004,660885,Floyd; Eric,9999,0,9999,0
1715601004987,MCWP 40R,A00,518780,Staff,2,0,20,18
1715601004987,MCWP 40R,B00,518781,Staff,11,0,20,9
1715601004987,MCWP 40R,C00,518783,Staff,5,0,20,15
1715601006014,MCWP 50R,A00,518791,Staff,0,1,20,20
1715601006014,MCWP 50R,B00,518792,Staff,0,2,20,20
1715601006014,MCWP 50R,C00,518793,Staff,0,4,20,20
1715601006014,MCWP 50R,D00,518794,Staff,0,1,20,20
1715601006014,MCWP 50R,E00,518795,Staff,0,2,20,20
1715601006014,MCWP 50R,F00,518796,Staff,0,1,20,20
1715601006014,MCWP 50R,G00,518797,Staff,0,1,20,20
1715601007038,MMW 12R,A01,514034,Herbst; Matthew,0,2,16,16
1715601007038,MMW 12R,A02,514035,Herbst; Matthew,0,0,16,16
1715601008068,MMW 13R,A01,514037,Staff,0,5,16,16
1715601008068,MMW 13R,A02,514039,Staff,0,5,16,16
1715601008068,MMW 13R,A03,628519,Staff,0,4,16,16
1715601010125,SIO 295LS,A00,523233,Staff,10,0,30,20
1715601011151,SIO 295S,A00,523232,Staff,10,0,30,20
1715601012184,SIOC 290S,A01,637330,Merrifield; Mark A,23,0,30,7
1715601013213,SIOC 291S,A01,637333,Gabriel; Corey John,23,0,30,7
1715601014240,SOCI 117,A01,494376,Staff,0,5,5,5
1715601015267,WES 237B,A00,494380,Staff,10,0,20,10
1715601017393,AESE 279B,A00,494370,Wade; Jon P,0,0,33,33
1715601018423,AIP 97,001,660915,Van Den Einde; Yael Dahlia,9999,0,9999,0
1715601019452,AIP 197,001,627712,Vespa; Emanuel Ignacio,9995,0,9999,4
1715601019452,AIP 197,002,650778,Amir; On,9998,0,9999,1
1715601019452,AIP 197,003,650933,Avenancio-Leon; Carlos,9998,0,9999,1
1715601019452,AIP 197,004,658530,Heyman; Gail D.,9998,0,9999,1
1715601019452,AIP 197,005,658631,Neal; Sonya E,9998,0,9999,1
1715601019452,AIP 197,006,658671,Du; Songzi,9998,0,9999,1
1715601020481,ANAR 135S,A00,494369,Braswell; Geoffrey E.,0,0,0,0
1715601021512,BENG 196,001,628496,Engler; Adam J.,9998,0,9999,1
1715601021512,BENG 196,002,660916,Watson; John Thomas,9999,0,9999,0
1715601022543,BISP 197,001,650773,Wilhelm; James E.,9994,0,9999,5
1715601022543,BISP 197,002,658904,Coleman; Aaron B.,9998,0,9999,1
1715601023569,CAT 124RS,A01,519847,Geibel; William,0,0,20,20
1715601024600,CAT 125RS,A01,515971,Geibel; William,0,0,20,20
1715601025627,CLRE 250,A00,511389,Morris; Sheldon,9992,0,9999,7
1715601026656,CLRE 251,A00,507176,Mehta; Ravindra L.,9992,0,9999,7
1715601026656,CLRE 251,B00,511410,Mehta; Ravindra L.,9998,0,9999,1
1715601027688,CLRE 252,A00,507189,Cuomo; Raphael Eduardo,9994,0,9999,5
1715601028715,CLRE 253,A00,507199,Vaida; Florin,9994,0,9999,5
1715601028715,CLRE 253,B00,507202,Vaida; Florin,9999,0,9999,0
1715601029744,CLRE 259,A00,507211,Patel; Hemal,9996,0,9999,3
1715601030769,CLRE 260,A00,507221,Cuomo; Raphael Eduardo,9999,0,9999,0
1715601031796,CLRE 297,001,507242,Cuomo; Raphael Eduardo,9999,0,9999,0
1715601032824,COGS 197,001,638244,Voytek; Bradley Thomas,9997,0,9999,2
1715601033851,CSE 191,A00,516875,Minnes Kemp; Mor Mia,9991,0,9999,8
1715601034877,CSE 197,001,637388,Minnes Kemp; Mor Mia,9992,0,9999,7
1715601035913,CSS 201S,A01,494383,Mignozzetti; Umberto,35,0,35,0
1715601036944,CSS 202S,A01,494387,Mignozzetti; Umberto,35,0,35,0
1715601037974,DSC 197,001,628532,Eldridge; Justin Matthew,9995,0,9999,4
1715601039004,EAP 100,A00,516065,Staff,9799,0,9999,200
1715601040031,ECE 45,A01,507414,Staff,31,0,60,29
1715601042139,ECE 111,A01,507420,Staff,11,0,50,39
1715601043166,ECE 197,001,548057,Sievenpiper; Daniel F.,9991,0,9999,8
1715601044198,EDS 115,A00,507243,Choi; Bailey Miyeon,7,0,28,21
1715601045224,EDS 117,A01,494379,Staff,0,6,34,34
1715601046253,EDS 125,A00,507246,Hopkins; Megan Beth,8,0,30,22
1715601047279,EDS 128A,A01,507264,Fargason; Sharon Gayle,6,0,26,20
1715601048306,EDS 128B,A01,507293,Pappas; Elizabeth,10,0,30,20
1715601049333,EDS 139,A00,507294,Fargason; Sharon Gayle,10,0,30,20
1715601049333,EDS 139,B00,507313,Pappas; Elizabeth,11,0,30,19
1715601050360,EDS 201,A00,507315,Staff,10,0,30,20
1715601051388,EDS 203,A01,507317,Halter; Christopher P.,10,0,30,20
1715601052420,EDS 204R,A01,507319,Halter; Christopher P.,0,3,30,30
1715601052420,EDS 204R,B01,507331,Heinzman; Erica M.,14,0,30,16
1715601053449,EDS 206R,A00,507332,Staff,0,4,30,30
1715601053449,EDS 206R,B00,507343,Staff,15,0,30,15
1715601054475,EDS 250,A00,507344,Hemans; Patricia Ann Benitez,20,0,40,20
1715601055502,EDS 281,A00,507345,Daly; Alan J.,18,0,18,0
1715601056531,EDS 284,A00,507350,Daly; Alan J.,16,0,16,0
1715601057561,EDS 286,A00,507359,Fine; Sarah,18,0,18,0
1715601058588,EDS 289C,A01,507361,Daly; Alan J.,18,0,18,0
1715601059614,EDS 290,A00,507366,Hofstetter; Carolyn,15,0,15,0
1715601060641,LIGM 5A,A00,507421,Fischer-Grunski; Eva K,17,0,20,3
1715601061667,LIGM 5B,A00,507423,Fischer-Grunski; Eva K,19,0,20,1
1715601062693,LIGM 5C,A00,507425,Fischer-Grunski; Eva K,19,0,20,1
1715601063720,LIIT 5AS,A00,507427,Carnelos; Chiara,20,0,20,0
1715601064748,LIIT 5BS,A00,507430,Carnelos; Chiara,20,0,20,0
1715601065775,LIIT 5CS,A00,507432,Carnelos; Chiara,20,0,20,0
1715601066807,LISP 5A,A00,507541,Munoz Sanchez; Alicia,11,0,20,9
1715601067836,LISP 5B,A00,507671,Munoz Sanchez; Alicia,9,0,20,11
1715601068868,LISP 5C,A00,507696,Munoz Sanchez; Alicia,9,0,20,11
1715601069895,MAE 197,001,528363,Boechler; Nicholas Sebastia,9998,0,9999,1
1715601070924,MATH 197,001,523477,Kedlaya; Kiran S.,9994,0,9999,5
1715601070924,MATH 197,002,563811,Zhang; Danna,9994,0,9999,5
1715601070924,MATH 197,003,628552,Dumitriu; Ioana,9998,0,9999,1
1715601070924,MATH 197,004,660885,Floyd; Eric,9999,0,9999,0
1715601071950,MCWP 40R,A00,518780,Staff,2,0,20,18
1715601071950,MCWP 40R,B00,518781,Staff,11,0,20,9
1715601071950,MCWP 40R,C00,518783,Staff,5,0,20,15
1715601072982,MCWP 50R,A00,518791,Staff,0,1,20,20
1715601072982,MCWP 50R,B00,518792,Staff,0,2,20,20
1715601072982,MCWP 50R,C00,518793,Staff,0,4,20,20
1715601072982,MCWP 50R,D00,518794,Staff,0,1,20,20
1715601072982,MCWP 50R,E00,518795,Staff,0,2,20,20
1715601072982,MCWP 50R,F00,518796,Staff,0,1,20,20
1715601072982,MCWP 50R,G00,518797,Staff,0,1,20,20
1715601074008,MMW 12R,A01,514034,Herbst; Matthew,0,2,16,16
1715601074008,MMW 12R,A02,514035,Herbst; Matthew,0,0,16,16
1715601075036,MMW 13R,A01,514037,Staff,0,5,16,16
1715601075036,MMW 13R,A02,514039,Staff,0,5,16,16
1715601075036,MMW 13R,A03,628519,Staff,0,4,16,16
1715601077105,SIO 295LS,A00,523233,Staff,10,0,30,20
1715601078130,SIO 295S,A00,523232,Staff,10,0,30,20
1715601079158,SIOC 290S,A01,637330,Merrifield; Mark A,23,0,30,7
1715601080188,SIOC 291S,A01,637333,Gabriel; Corey John,23,0,30,7
1715601081217,SOCI 117,A01,494376,Staff,0,5,5,5
1715601082244,WES 237B,A00,494380,Staff,10,0,20,10
1715601084314,AESE 279B,A00,494370,Wade; Jon P,0,0,33,33
1715601085346,AIP 97,001,660915,Van Den Einde; Yael Dahlia,9999,0,9999,0
1715601086374,AIP 197,001,627712,Vespa; Emanuel Ignacio,9995,0,9999,4
1715601086374,AIP 197,002,650778,Amir; On,9998,0,9999,1
1715601086374,AIP 197,003,650933,Avenancio-Leon; Carlos,9998,0,9999,1
1715601086374,AIP 197,004,658530,Heyman; Gail D.,9998,0,9999,1
1715601086374,AIP 197,005,658631,Neal; Sonya E,9998,0,9999,1
1715601086374,AIP 197,006,658671,Du; Songzi,9998,0,9999,1
1715601087402,ANAR 135S,A00,494369,Braswell; Geoffrey E.,0,0,0,0
1715601088428,BENG 196,001,628496,Engler; Adam J.,9998,0,9999,1
1715601088428,BENG 196,002,660916,Watson; John Thomas,9999,0,9999,0
1715601089459,BISP 197,001,650773,Wilhelm; James E.,9994,0,9999,5
1715601089459,BISP 197,002,658904,Coleman; Aaron B.,9998,0,9999,1
1715601090486,CAT 124RS,A01,519847,Geibel; William,0,0,20,20
1715601091513,CAT 125RS,A01,515971,Geibel; William,0,0,20,20
1715601092539,CLRE 250,A00,511389,Morris; Sheldon,9992,0,9999,7
1715601093565,CLRE 251,A00,507176,Mehta; Ravindra L.,9992,0,9999,7
1715601093565,CLRE 251,B00,511410,Mehta; Ravindra L.,9998,0,9999,1
1715601094593,CLRE 252,A00,507189,Cuomo; Raphael Eduardo,9994,0,9999,5
1715601095625,CLRE 253,A00,507199,Vaida; Florin,9994,0,9999,5
1715601095625,CLRE 253,B00,507202,Vaida; Florin,9999,0,9999,0
1715601096651,CLRE 259,A00,507211,Patel; Hemal,9996,0,9999,3
1715601097684,CLRE 260,A00,507221,Cuomo; Raphael Eduardo,9999,0,9999,0
1715601109344,CLRE 297,001,507242,Cuomo; Raphael Eduardo,9999,0,9999,0
1715601110375,COGS 197,001,638244,Voytek; Bradley Thomas,9997,0,9999,2
1715601111401,CSE 191,A00,516875,Minnes Kemp; Mor Mia,9991,0,9999,8
1715601112428,CSE 197,001,637388,Minnes Kemp; Mor Mia,9992,0,9999,7
1715601113456,CSS 201S,A01,494383,Mignozzetti; Umberto,35,0,35,0
1715601114487,CSS 202S,A01,494387,Mignozzetti; Umberto,35,0,35,0
1715601115518,DSC 197,001,628532,Eldridge; Justin Matthew,9995,0,9999,4
1715601116546,EAP 100,A00,516065,Staff,9799,0,9999,200
1715601117582,ECE 45,A01,507414,Staff,31,0,60,29
1715601125859,ECE 111,A01,507420,Staff,11,0,50,39
1715601126888,ECE 197,001,548057,Sievenpiper; Daniel F.,9991,0,9999,8
1715601127915,EDS 115,A00,507243,Choi; Bailey Miyeon,7,0,28,21
1715601128946,EDS 117,A01,494379,Staff,0,6,34,34
1715601129972,EDS 125,A00,507246,Hopkins; Megan Beth,8,0,30,22
1715601131000,EDS 128A,A01,507264,Fargason; Sharon Gayle,6,0,26,20
1715601132028,EDS 128B,A01,507293,Pappas; Elizabeth,10,0,30,20
1715601133056,EDS 139,A00,507294,Fargason; Sharon Gayle,10,0,30,20
1715601133056,EDS 139,B00,507313,Pappas; Elizabeth,11,0,30,19
1715601134083,EDS 201,A00,507315,Staff,10,0,30,20
1715601135115,EDS 203,A01,507317,Halter; Christopher P.,10,0,30,20
1715601136140,EDS 204R,A01,507319,Halter; Christopher P.,0,3,30,30
1715601136140,EDS 204R,B01,507331,Heinzman; Erica M.,14,0,30,16
1715601137170,EDS 206R,A00,507332,Staff,0,4,30,30
1715601137170,EDS 206R,B00,507343,Staff,15,0,30,15
1715601138201,EDS 250,A00,507344,Hemans; Patricia Ann Benitez,20,0,40,20
1715601139231,EDS 281,A00,507345,Daly; Alan J.,18,0,18,0
1715601140259,EDS 284,A00,507350,Daly; Alan J.,16,0,16,0
1715601141287,EDS 286,A00,507359,Fine; Sarah,18,0,18,0
1715601142317,EDS 289C,A01,507361,Daly; Alan J.,18,0,18,0
1715601143343,EDS 290,A00,507366,Hofstetter; Carolyn,15,0,15,0
1715601144377,LIGM 5A,A00,507421,Fischer-Grunski; Eva K,17,0,20,3
1715601145404,LIGM 5B,A00,507423,Fischer-Grunski; Eva K,19,0,20,1
1715601146433,LIGM 5C,A00,507425,Fischer-Grunski; Eva K,19,0,20,1
1715601147461,LIIT 5AS,A00,507427,Carnelos; Chiara,20,0,20,0
1715601148489,LIIT 5BS,A00,507430,Carnelos; Chiara,20,0,20,0
1715601149520,LIIT 5CS,A00,507432,Carnelos; Chiara,20,0,20,0
1715601150551,LISP 5A,A00,507541,Munoz Sanchez; Alicia,11,0,20,9
1715601151578,LISP 5B,A00,507671,Munoz Sanchez; Alicia,9,0,20,11
1715601152608,LISP 5C,A00,507696,Munoz Sanchez; Alicia,9,0,20,11
1715601153639,MAE 197,001,528363,Boechler; Nicholas Sebastia,9998,0,9999,1
1715601154669,MATH 197,001,523477,Kedlaya; Kiran S.,9994,0,9999,5
1715601154669,MATH 197,002,563811,Zhang; Danna,9994,0,9999,5
1715601154669,MATH 197,003,628552,Dumitriu; Ioana,9998,0,9999,1
1715601154669,MATH 197,004,660885,Floyd; Eric,9999,0,9999,0
1715601155698,MCWP 40R,A00,518780,Staff,2,0,20,18
1715601155698,MCWP 40R,B00,518781,Staff,11,0,20,9
1715601155698,MCWP 40R,C00,518783,Staff,5,0,20,15
1715601156729,MCWP 50R,A00,518791,Staff,0,1,20,20
1715601156729,MCWP 50R,B00,518792,Staff,0,2,20,20
1715601156729,MCWP 50R,C00,518793,Staff,0,4,20,20
1715601156729,MCWP 50R,D00,518794,Staff,0,1,20,20
1715601156729,MCWP 50R,E00,518795,Staff,0,2,20,20
1715601156729,MCWP 50R,F00,518796,Staff,0,1,20,20
1715601156729,MCWP 50R,G00,518797,Staff,0,1,20,20
1715601157754,MMW 12R,A01,514034,Herbst; Matthew,0,2,16,16
1715601157754,MMW 12R,A02,514035,Herbst; Matthew,0,0,16,16
1715601158781,MMW 13R,A01,514037,Staff,0,5,16,16
1715601158781,MMW 13R,A02,514039,Staff,0,5,16,16
1715601158781,MMW 13R,A03,628519,Staff,0,4,16,16
1715601160835,SIO 295LS,A00,523233,Staff,10,0,30,20
1715601161866,SIO 295S,A00,523232,Staff,10,0,30,20
1715601162895,SIOC 290S,A01,637330,Merrifield; Mark A,23,0,30,7
1715601163922,SIOC 291S,A01,637333,Gabriel; Corey John,23,0,30,7
1715601164951,SOCI 117,A01,494376,Staff,0,5,5,5
1715601165977,WES 237B,A00,494380,Staff,10,0,20,10
1715601168052,AESE 279B,A00,494370,Wade; Jon P,0,0,33,33
1715601169080,AIP 97,001,660915,Van Den Einde; Yael Dahlia,9999,0,9999,0
1715601170109,AIP 197,001,627712,Vespa; Emanuel Ignacio,9995,0,9999,4
1715601170109,AIP 197,002,650778,Amir; On,9998,0,9999,1
1715601170109,AIP 197,003,650933,Avenancio-Leon; Carlos,9998,0,9999,1
1715601170109,AIP 197,004,658530,Heyman; Gail D.,9998,0,9999,1
1715601170109,AIP 197,005,658631,Neal; Sonya E,9998,0,9999,1
1715601170109,AIP 197,006,658671,Du; Songzi,9998,0,9999,1
1715601171136,ANAR 135S,A00,494369,Braswell; Geoffrey E.,0,0,0,0
1715601172165,BENG 196,001,628496,Engler; Adam J.,9998,0,9999,1
1715601172165,BENG 196,002,660916,Watson; John Thomas,9999,0,9999,0
1715601173194,BISP 197,001,650773,Wilhelm; James E.,9994,0,9999,5
1715601173194,BISP 197,002,658904,Coleman; Aaron B.,9998,0,9999,1
1715601174224,CAT 124RS,A01,519847,Geibel; William,0,0,20,20
1715601175253,CAT 125RS,A01,515971,Geibel; William,0,0,20,20
1715601176281,CLRE 250,A00,511389,Morris; Sheldon,9992,0,9999,7
1715601177308,CLRE 251,A00,507176,Mehta; Ravindra L.,9992,0,9999,7
1715601177308,CLRE 251,B00,511410,Mehta; Ravindra L.,9998,0,9999,1
1715601178334,CLRE 252,A00,507189,Cuomo; Raphael Eduardo,9994,0,9999,5
1715601179363,CLRE 253,A00,507199,Vaida; Florin,9994,0,9999,5
1715601179363,CLRE 253,B00,507202,Vaida; Florin,9999,0,9999,0
1715601180394,CLRE 259,A00,507211,Patel; Hemal,9996,0,9999,3
1715601181423,CLRE 260,A00,507221,Cuomo; Raphael Eduardo,9999,0,9999,0
1715601182448,CLRE 297,001,507242,Cuomo; Raphael Eduardo,9999,0,9999,0
1715601183477,COGS 197,001,638244,Voytek; Bradley Thomas,9997,0,9999,2
1715601184504,CSE 191,A00,516875,Minnes Kemp; Mor Mia,9991,0,9999,8
1715601185531,CSE 197,001,637388,Minnes Kemp; Mor Mia,9992,0,9999,7
1715601186561,CSS 201S,A01,494383,Mignozzetti; Umberto,35,0,35,0
1715601187589,CSS 202S,A01,494387,Mignozzetti; Umberto,35,0,35,0
1715601188617,DSC 197,001,628532,Eldridge; Justin Matthew,9995,0,9999,4
1715601189645,EAP 100,A00,516065,Staff,9799,0,9999,200
1715601190681,ECE 45,A01,507414,Staff,31,0,60,29
1715601192734,ECE 111,A01,507420,Staff,11,0,50,39
1715601193763,ECE 197,001,548057,Sievenpiper; Daniel F.,9991,0,9999,8
1715601194790,EDS 115,A00,507243,Choi; Bailey Miyeon,7,0,28,21
1715601195820,EDS 117,A01,494379,Staff,0,6,34,34
1715601196850,EDS 125,A00,507246,Hopkins; Megan Beth,8,0,30,22
1715601197874,EDS 128A,A01,507264,Fargason; Sharon Gayle,6,0,26,20
1715601198902,EDS 128B,A01,507293,Pappas; Elizabeth,10,0,30,20
1715601199927,EDS 139,A00,507294,Fargason; Sharon Gayle,10,0,30,20
1715601199927,EDS 139,B00,507313,Pappas; Elizabeth,11,0,30,19
1715601200957,EDS 201,A00,507315,Staff,10,0,30,20
1715601201988,EDS 203,A01,507317,Halter; Christopher P.,10,0,30,20
1715601203015,EDS 204R,A01,507319,Halter; Christopher P.,0,3,30,30
1715601203015,EDS 204R,B01,507331,Heinzman; Erica M.,14,0,30,16
1715601204045,EDS 206R,A00,507332,Staff,0,4,30,30
1715601204045,EDS 206R,B00,507343,Staff,15,0,30,15
1715601205074,EDS 250,A00,507344,Hemans; Patricia Ann Benitez,20,0,40,20
1715601206105,EDS 281,A00,507345,Daly; Alan J.,18,0,18,0
1715601207132,EDS 284,A00,507350,Daly; Alan J.,16,0,16,0
1715601208162,EDS 286,A00,507359,Fine; Sarah,18,0,18,0
1715601209191,EDS 289C,A01,507361,Daly; Alan J.,18,0,18,0
1715601210219,EDS 290,A00,507366,Hofstetter; Carolyn,15,0,15,0
1715601211247,LIGM 5A,A00,507421,Fischer-Grunski; Eva K,17,0,20,3
1715601212275,LIGM 5B,A00,507423,Fischer-Grunski; Eva K,19,0,20,1
1715601213305,LIGM 5C,A00,507425,Fischer-Grunski; Eva K,19,0,20,1
1715601214331,LIIT 5AS,A00,507427,Carnelos; Chiara,20,0,20,0
1715601215358,LIIT 5BS,A00,507430,Carnelos; Chiara,20,0,20,0
1715601216388,LIIT 5CS,A00,507432,Carnelos; Chiara,20,0,20,0
1715601217420,LISP 5A,A00,507541,Munoz Sanchez; Alicia,11,0,20,9
1715601218447,LISP 5B,A00,507671,Munoz Sanchez; Alicia,9,0,20,11
1715601219476,LISP 5C,A00,507696,Munoz Sanchez; Alicia,9,0,20,11
1715601220502,MAE 197,001,528363,Boechler; Nicholas Sebastia,9998,0,9999,1
1715601221533,MATH 197,001,523477,Kedlaya; Kiran S.,9994,0,9999,5
1715601221533,MATH 197,002,563811,Zhang; Danna,9994,0,9999,5
1715601221533,MATH 197,003,628552,Dumitriu; Ioana,9998,0,9999,1
1715601221533,MATH 197,004,660885,Floyd; Eric,9999,0,9999,0
1715601222561,MCWP 40R,A00,518780,Staff,2,0,20,18
1715601222561,MCWP 40R,B00,518781,Staff,11,0,20,9
1715601222561,MCWP 40R,C00,518783,Staff,5,0,20,15
1715601223590,MCWP 50R,A00,518791,Staff,0,1,20,20
1715601223590,MCWP 50R,B00,518792,Staff,0,2,20,20
1715601223590,MCWP 50R,C00,518793,Staff,0,4,20,20
1715601223590,MCWP 50R,D00,518794,Staff,0,1,20,20
1715601223590,MCWP 50R,E00,518795,Staff,0,2,20,20
1715601223590,MCWP 50R,F00,518796,Staff,0,1,20,20
1715601223590,MCWP 50R,G00,518797,Staff,0,1,20,20
1715601224618,MMW 12R,A01,514034,Herbst; Matthew,0,2,16,16
1715601224618,MMW 12R,A02,514035,Herbst; Matthew,0,0,16,16
1715601225646,MMW 13R,A01,514037,Staff,0,5,16,16
1715601225646,MMW 13R,A02,514039,Staff,0,5,16,16
1715601225646,MMW 13R,A03,628519,Staff,0,4,16,16
1715601227703,SIO 295LS,A00,523233,Staff,10,0,30,20
1715601228731,SIO 295S,A00,523232,Staff,10,0,30,20
1715601229759,SIOC 290S,A01,637330,Merrifield; Mark A,23,0,30,7
1715601230788,SIOC 291S,A01,637333,Gabriel; Corey John,23,0,30,7
1715601231814,SOCI 117,A01,494376,Staff,0,5,5,5
1715601232840,WES 237B,A00,494380,Staff,10,0,20,10
1715601234922,AESE 279B,A00,494370,Wade; Jon P,0,0,33,33
1715601235949,AIP 97,001,660915,Van Den Einde; Yael Dahlia,9999,0,9999,0
1715601236982,AIP 197,001,627712,Vespa; Emanuel Ignacio,9995,0,9999,4
1715601236982,AIP 197,002,650778,Amir; On,9998,0,9999,1
1715601236982,AIP 197,003,650933,Avenancio-Leon; Carlos,9998,0,9999,1
1715601236982,AIP 197,004,658530,Heyman; Gail D.,9998,0,9999,1
1715601236982,AIP 197,005,658631,Neal; Sonya E,9998,0,9999,1
1715601236982,AIP 197,006,658671,Du; Songzi,9998,0,9999,1
1715601238016,ANAR 135S,A00,494369,Braswell; Geoffrey E.,0,0,0,0
1715601239043,BENG 196,001,628496,Engler; Adam J.,9998,0,9999,1
1715601239043,BENG 196,002,660916,Watson; John Thomas,9999,0,9999,0
1715601240068,BISP 197,001,650773,Wilhelm; James E.,9994,0,9999,5
1715601240068,BISP 197,002,658904,Coleman; Aaron B.,9998,0,9999,1
1715601241096,CAT 124RS,A01,519847,Geibel; William,0,0,20,20
1715601242121,CAT 125RS,A01,515971,Geibel; William,0,0,20,20
1715601243152,CLRE 250,A00,511389,Morris; Sheldon,9992,0,9999,7
1715601244179,CLRE 251,A00,507176,Mehta; Ravindra L.,9992,0,9999,7
1715601244179,CLRE 251,B00,511410,Mehta; Ravindra L.,9998,0,9999,1
1715601245207,CLRE 252,A00,507189,Cuomo; Raphael Eduardo,9994,0,9999,5
1715601246236,CLRE 253,A00,507199,Vaida; Florin,9994,0,9999,5
1715601246236,CLRE 253,B00,507202,Vaida; Florin,9999,0,9999,0
1715601247265,CLRE 259,A00,507211,Patel; Hemal,9996,0,9999,3
1715601248296,CLRE 260,A00,507221,Cuomo; Raphael Eduardo,9999,0,9999,0
1715601249321,CLRE 297,001,507242,Cuomo; Raphael Eduardo,9999,0,9999,0
1715601250351,COGS 197,001,638244,Voytek; Bradley Thomas,9997,0,9999,2
1715601251383,CSE 191,A00,516875,Minnes Kemp; Mor Mia,9991,0,9999,8
1715601252408,CSE 197,001,637388,Minnes Kemp; Mor Mia,9992,0,9999,7
1715601253441,CSS 201S,A01,494383,Mignozzetti; Umberto,35,0,35,0
1715601254468,CSS 202S,A01,494387,Mignozzetti; Umberto,35,0,35,0
1715601255495,DSC 197,001,628532,Eldridge; Justin Matthew,9995,0,9999,4
1715601256524,EAP 100,A00,516065,Staff,9799,0,9999,200
1715601257559,ECE 45,A01,507414,Staff,31,0,60,29
1715601259619,ECE 111,A01,507420,Staff,11,0,50,39
1715601260650,ECE 197,001,548057,Sievenpiper; Daniel F.,9991,0,9999,8
1715601261678,EDS 115,A00,507243,Choi; Bailey Miyeon,7,0,28,21
1715601262712,EDS 117,A01,494379,Staff,0,6,34,34
1715601263742,EDS 125,A00,507246,Hopkins; Megan Beth,8,0,30,22
1715601264769,EDS 128A,A01,507264,Fargason; Sharon Gayle,6,0,26,20
1715601265797,EDS 128B,A01,507293,Pappas; Elizabeth,10,0,30,20
1715601266823,EDS 139,A00,507294,Fargason; Sharon Gayle,10,0,30,20
1715601266823,EDS 139,B00,507313,Pappas; Elizabeth,11,0,30,19
1715601267852,EDS 201,A00,507315,Staff,10,0,30,20
1715601268884,EDS 203,A01,507317,Halter; Christopher P.,10,0,30,20
1715601269914,EDS 204R,A01,507319,Halter; Christopher P.,0,3,30,30
1715601269914,EDS 204R,B01,507331,Heinzman; Erica M.,14,0,30,16
1715601270944,EDS 206R,A00,507332,Staff,0,4,30,30
1715601270944,EDS 206R,B00,507343,Staff,15,0,30,15
1715601271973,EDS 250,A00,507344,Hemans; Patricia Ann Benitez,20,0,40,20
1715601273003,EDS 281,A00,507345,Daly; Alan J.,18,0,18,0
1715601274026,EDS 284,A00,507350,Daly; Alan J.,16,0,16,0
1715601275053,EDS 286,A00,507359,Fine; Sarah,18,0,18,0
1715601276079,EDS 289C,A01,507361,Daly; Alan J.,18,0,18,0
1715601277111,EDS 290,A00,507366,Hofstetter; Carolyn,15,0,15,0
1715601278142,LIGM 5A,A00,507421,Fischer-Grunski; Eva K,17,0,20,3
1715601279168,LIGM 5B,A00,507423,Fischer-Grunski; Eva K,19,0,20,1
1715601280227,LIGM 5C,A00,507425,Fischer-Grunski; Eva K,19,0,20,1
1715601281260,LIIT 5AS,A00,507427,Carnelos; Chiara,20,0,20,0
1715601282288,LIIT 5BS,A00,507430,Carnelos; Chiara,20,0,20,0
1715601283312,LIIT 5CS,A00,507432,Carnelos; Chiara,20,0,20,0
1715601284340,LISP 5A,A00,507541,Munoz Sanchez; Alicia,11,0,20,9
1715601285367,LISP 5B,A00,507671,Munoz Sanchez; Alicia,9,0,20,11
1715601286394,LISP 5C,A00,507696,Munoz Sanchez; Alicia,9,0,20,11
1715601287421,MAE 197,001,528363,Boechler; Nicholas Sebastia,9998,0,9999,1
1715601288450,MATH 197,001,523477,Kedlaya; Kiran S.,9994,0,9999,5
1715601288450,MATH 197,002,563811,Zhang; Danna,9994,0,9999,5
1715601288450,MATH 197,003,628552,Dumitriu; Ioana,9998,0,9999,1
1715601288450,MATH 197,004,660885,Floyd; Eric,9999,0,9999,0
1715601289476,MCWP 40R,A00,518780,Staff,2,0,20,18
1715601289476,MCWP 40R,B00,518781,Staff,11,0,20,9
1715601289476,MCWP 40R,C00,518783,Staff,5,0,20,15
1715601290502,MCWP 50R,A00,518791,Staff,0,1,20,20
1715601290502,MCWP 50R,B00,518792,Staff,0,2,20,20
1715601290502,MCWP 50R,C00,518793,Staff,0,4,20,20
1715601290502,MCWP 50R,D00,518794,Staff,0,1,20,20
1715601290502,MCWP 50R,E00,518795,Staff,0,2,20,20
1715601290502,MCWP 50R,F00,518796,Staff,0,1,20,20
1715601290502,MCWP 50R,G00,518797,Staff,0,1,20,20
1715601291529,MMW 12R,A01,514034,Herbst; Matthew,0,2,16,16
1715601291529,MMW 12R,A02,514035,Herbst; Matthew,0,0,16,16
1715601292555,MMW 13R,A01,514037,Staff,0,5,16,16
1715601292555,MMW 13R,A02,514039,Staff,0,5,16,16
1715601292555,MMW 13R,A03,628519,Staff,0,4,16,16
1715601294611,SIO 295LS,A00,523233,Staff,10,0,30,20
1715601295640,SIO 295S,A00,523232,Staff,10,0,30,20
1715601296668,SIOC 290S,A01,637330,Merrifield; Mark A,23,0,30,7
1715601297695,SIOC 291S,A01,637333,Gabriel; Corey John,23,0,30,7
1715601298726,SOCI 117,A01,494376,Staff,0,5,5,5
1715601299754,WES 237B,A00,494380,Staff,10,0,20,10
1715601301818,AESE 279B,A00,494370,Wade; Jon P,0,0,33,33
1715601302843,AIP 97,001,660915,Van Den Einde; Yael Dahlia,9999,0,9999,0
1715601303883,AIP 197,001,627712,Vespa; Emanuel Ignacio,9995,0,9999,4
1715601303883,AIP 197,002,650778,Amir; On,9998,0,9999,1
1715601303883,AIP 197,003,650933,Avenancio-Leon; Carlos,9998,0,9999,1
1715601303883,AIP 197,004,658530,Heyman; Gail D.,9998,0,9999,1
1715601303883,AIP 197,005,658631,Neal; Sonya E,9998,0,9999,1
1715601303883,AIP 197,006,658671,Du; Songzi,9998,0,9999,1
1715601304911,ANAR 135S,A00,494369,Braswell; Geoffrey E.,0,0,0,0
1715601305938,BENG 196,001,628496,Engler; Adam J.,9998,0,9999,1
1715601305938,BENG 196,002,660916,Watson; John Thomas,9999,0,9999,0
1715601306966,BISP 197,001,650773,Wilhelm; James E.,9994,0,9999,5
1715601306966,BISP 197,002,658904,Coleman; Aaron B.,9998,0,9999,1
1715601307994,CAT 124RS,A01,519847,Geibel; William,0,0,20,20
1715601309023,CAT 125RS,A01,515971,Geibel; William,0,0,20,20
1715601310053,CLRE 250,A00,511389,Morris; Sheldon,9992,0,9999,7
1715601311087,CLRE 251,A00,507176,Mehta; Ravindra L.,9992,0,9999,7
1715601311087,CLRE 251,B00,511410,Mehta; Ravindra L.,9998,0,9999,1
1715601312114,CLRE 252,A00,507189,Cuomo; Raphael Eduardo,9994,0,9999,5
1715601313144,CLRE 253,A00,507199,Vaida; Florin,9994,0,9999,5
1715601313144,CLRE 253,B00,507202,Vaida; Florin,9999,0,9999,0
1715601314170,CLRE 259,A00,507211,Patel; Hemal,9996,0,9999,3
1715601315196,CLRE 260,A00,507221,Cuomo; Raphael Eduardo,9999,0,9999,0
1715601316223,CLRE 297,001,507242,Cuomo; Raphael Eduardo,9999,0,9999,0
1715601317250,COGS 197,001,638244,Voytek; Bradley Thomas,9997,0,9999,2
1715601318278,CSE 191,A00,516875,Minnes Kemp; Mor Mia,9991,0,9999,8
1715601319304,CSE 197,001,637388,Minnes Kemp; Mor Mia,9992,0,9999,7
1715601320334,CSS 201S,A01,494383,Mignozzetti; Umberto,35,0,35,0
1715601321388,CSS 202S,A01,494387,Mignozzetti; Umberto,35,0,35,0
1715601322416,DSC 197,001,628532,Eldridge; Justin Matthew,9995,0,9999,4
1715601323443,EAP 100,A00,516065,Staff,9799,0,9999,200
1715601324476,ECE 45,A01,507414,Staff,31,0,60,29
1715601326530,ECE 111,A01,507420,Staff,11,0,50,39
1715601327556,ECE 197,001,548057,Sievenpiper; Daniel F.,9991,0,9999,8
1715601328583,EDS 115,A00,507243,Choi; Bailey Miyeon,7,0,28,21
1715601329610,EDS 117,A01,494379,Staff,0,6,34,34
1715601330638,EDS 125,A00,507246,Hopkins; Megan Beth,8,0,30,22
1715601331663,EDS 128A,A01,507264,Fargason; Sharon Gayle,6,0,26,20
1715601332689,EDS 128B,A01,507293,Pappas; Elizabeth,10,0,30,20
1715601333714,EDS 139,A00,507294,Fargason; Sharon Gayle,10,0,30,20
1715601333714,EDS 139,B00,507313,Pappas; Elizabeth,11,0,30,19
1715601334742,EDS 201,A00,507315,Staff,10,0,30,20
1715601335767,EDS 203,A01,507317,Halter; Christopher P.,10,0,30,20
1715601336799,EDS 204R,A01,507319,Halter; Christopher P.,0,3,30,30
1715601336799,EDS 204R,B01,507331,Heinzman; Erica M.,14,0,30,16
1715601337823,EDS 206R,A00,507332,Staff,0,4,30,30
1715601337823,EDS 206R,B00,507343,Staff,15,0,30,15
1715601338854,EDS 250,A00,507344,Hemans; Patricia Ann Benitez,20,0,40,20
1715601339880,EDS 281,A00,507345,Daly; Alan J.,18,0,18,0
1715601340906,EDS 284,A00,507350,Daly; Alan J.,16,0,16,0
1715601341932,EDS 286,A00,507359,Fine; Sarah,18,0,18,0
1715601342959,EDS 289C,A01,507361,Daly; Alan J.,18,0,18,0
1715601343988,EDS 290,A00,507366,Hofstetter; Carolyn,15,0,15,0
1715601345015,LIGM 5A,A00,507421,Fischer-Grunski; Eva K,17,0,20,3
1715601346041,LIGM 5B,A00,507423,Fischer-Grunski; Eva K,19,0,20,1
1715601347068,LIGM 5C,A00,507425,Fischer-Grunski; Eva K,19,0,20,1
1715601348094,LIIT 5AS,A00,507427,Carnelos; Chiara,20,0,20,0
1715601349126,LIIT 5BS,A00,507430,Carnelos; Chiara,20,0,20,0
1715601350153,LIIT 5CS,A00,507432,Carnelos; Chiara,20,0,20,0
1715601351185,LISP 5A,A00,507541,Munoz Sanchez; Alicia,11,0,20,9
1715601352214,LISP 5B,A00,507671,Munoz Sanchez; Alicia,9,0,20,11
1715601353245,LISP 5C,A00,507696,Munoz Sanchez; Alicia,9,0,20,11
1715601354274,MAE 197,001,528363,Boechler; Nicholas Sebastia,9998,0,9999,1
1715601355304,MATH 197,001,523477,Kedlaya; Kiran S.,9994,0,9999,5
1715601355304,MATH 197,002,563811,Zhang; Danna,9994,0,9999,5
1715601355304,MATH 197,003,628552,Dumitriu; Ioana,9998,0,9999,1
1715601355304,MATH 197,004,660885,Floyd; Eric,9999,0,9999,0
1715601356332,MCWP 40R,A00,518780,Staff,2,0,20,18
1715601356332,MCWP 40R,B00,518781,Staff,11,0,20,9
1715601356332,MCWP 40R,C00,518783,Staff,5,0,20,15
1715601357359,MCWP 50R,A00,518791,Staff,0,1,20,20
1715601357359,MCWP 50R,B00,518792,Staff,0,2,20,20
1715601357359,MCWP 50R,C00,518793,Staff,0,4,20,20
1715601357359,MCWP 50R,D00,518794,Staff,0,1,20,20
1715601357359,MCWP 50R,E00,518795,Staff,0,2,20,20
1715601357359,MCWP 50R,F00,518796,Staff,0,1,20,20
1715601357359,MCWP 50R,G00,518797,Staff,0,1,20,20
1715601358392,MMW 12R,A01,514034,Herbst; Matthew,0,2,16,16
1715601358392,MMW 12R,A02,514035,Herbst; Matthew,0,0,16,16
1715601359421,MMW 13R,A01,514037,Staff,0,5,16,16
1715601359421,MMW 13R,A02,514039,Staff,0,5,16,16
1715601359421,MMW 13R,A03,628519,Staff,0,4,16,16
1715601361479,SIO 295LS,A00,523233,Staff,10,0,30,20
1715601362507,SIO 295S,A00,523232,Staff,10,0,30,20
1715601363536,SIOC 290S,A01,637330,Merrifield; Mark A,23,0,30,7
1715601364562,SIOC 291S,A01,637333,Gabriel; Corey John,23,0,30,7
1715601365586,SOCI 117,A01,494376,Staff,0,5,5,5
1715601366613,WES 237B,A00,494380,Staff,10,0,20,10
1715601368687,AESE 279B,A00,494370,Wade; Jon P,0,0,33,33
1715601369714,AIP 97,001,660915,Van Den Einde; Yael Dahlia,9999,0,9999,0
1715601370741,AIP 197,001,627712,Vespa; Emanuel Ignacio,9995,0,9999,4
1715601370741,AIP 197,002,650778,Amir; On,9998,0,9999,1
1715601370741,AIP 197,003,650933,Avenancio-Leon; Carlos,9998,0,9999,1
1715601370741,AIP 197,004,658530,Heyman; Gail D.,9998,0,9999,1
1715601370741,AIP 197,005,658631,Neal; Sonya E,9998,0,9999,1
1715601370741,AIP 197,006,658671,Du; Songzi,9998,0,9999,1
1715601371766,ANAR 135S,A00,494369,Braswell; Geoffrey E.,0,0,0,0
1715601372796,BENG 196,001,628496,Engler; Adam J.,9998,0,9999,1
1715601372796,BENG 196,002,660916,Watson; John Thomas,9999,0,9999,0
1715601373827,BISP 197,001,650773,Wilhelm; James E.,9994,0,9999,5
1715601373827,BISP 197,002,658904,Coleman; Aaron B.,9998,0,9999,1
1715601374852,CAT 124RS,A01,519847,Geibel; William,0,0,20,20
1715601375879,CAT 125RS,A01,515971,Geibel; William,0,0,20,20
1715601376905,CLRE 250,A00,511389,Morris; Sheldon,9992,0,9999,7
1715601377931,CLRE 251,A00,507176,Mehta; Ravindra L.,9992,0,9999,7
1715601377931,CLRE 251,B00,511410,Mehta; Ravindra L.,9998,0,9999,1
1715601378958,CLRE 252,A00,507189,Cuomo; Raphael Eduardo,9994,0,9999,5
1715601379988,CLRE 253,A00,507199,Vaida; Florin,9994,0,9999,5
1715601379988,CLRE 253,B00,507202,Vaida; Florin,9999,0,9999,0
1715601381014,CLRE 259,A00,507211,Patel; Hemal,9996,0,9999,3
1715601382040,CLRE 260,A00,507221,Cuomo; Raphael Eduardo,9999,0,9999,0
1715601383067,CLRE 297,001,507242,Cuomo; Raphael Eduardo,9999,0,9999,0
1715601384094,COGS 197,001,638244,Voytek; Bradley Thomas,9997,0,9999,2
1715601385121,CSE 191,A00,516875,Minnes Kemp; Mor Mia,9991,0,9999,8
1715601386146,CSE 197,001,637388,Minnes Kemp; Mor Mia,9992,0,9999,7
1715601387178,CSS 201S,A01,494383,Mignozzetti; Umberto,35,0,35,0
1715601388208,CSS 202S,A01,494387,Mignozzetti; Umberto,35,0,35,0
1715601389239,DSC 197,001,628532,Eldridge; Justin Matthew,9995,0,9999,4
1715601390267,EAP 100,A00,516065,Staff,9799,0,9999,200
1715601391294,ECE 45,A01,507414,Staff,31,0,60,29
1715601393352,ECE 111,A01,507420,Staff,11,0,50,39
1715601394378,ECE 197,001,548057,Sievenpiper; Daniel F.,9991,0,9999,8
1715601395410,EDS 115,A00,507243,Choi; Bailey Miyeon,7,0,28,21
1715601396439,EDS 117,A01,494379,Staff,0,6,34,34
1715601397470,EDS 125,A00,507246,Hopkins; Megan Beth,8,0,30,22
1715601398496,EDS 128A,A01,507264,Fargason; Sharon Gayle,6,0,26,20
1715601399549,EDS 128B,A01,507293,Pappas; Elizabeth,10,0,30,20
1715601400576,EDS 139,A00,507294,Fargason; Sharon Gayle,10,0,30,20
1715601400576,EDS 139,B00,507313,Pappas; Elizabeth,11,0,30,19
1715601401601,EDS 201,A00,507315,Staff,10,0,30,20
1715601402632,EDS 203,A01,507317,Halter; Christopher P.,10,0,30,20
1715601403656,EDS 204R,A01,507319,Halter; Christopher P.,0,3,30,30
1715601403656,EDS 204R,B01,507331,Heinzman; Erica M.,14,0,30,16
1715601404684,EDS 206R,A00,507332,Staff,0,4,30,30
1715601404684,EDS 206R,B00,507343,Staff,15,0,30,15
1715601405713,EDS 250,A00,507344,Hemans; Patricia Ann Benitez,20,0,40,20
1715601406737,EDS 281,A00,507345,Daly; Alan J.,18,0,18,0
1715601407763,EDS 284,A00,507350,Daly; Alan J.,16,0,16,0
1715601408788,EDS 286,A00,507359,Fine; Sarah,18,0,18,0
1715601409814,EDS 289C,A01,507361,Daly; Alan J.,18,0,18,0
1715601410841,EDS 290,A00,507366,Hofstetter; Carolyn,15,0,15,0
1715601411868,LIGM 5A,A00,507421,Fischer-Grunski; Eva K,17,0,20,3
1715601412895,LIGM 5B,A00,507423,Fischer-Grunski; Eva K,19,0,20,1
1715601413922,LIGM 5C,A00,507425,Fischer-Grunski; Eva K,19,0,20,1
1715601414948,LIIT 5AS,A00,507427,Carnelos; Chiara,20,0,20,0
1715601415976,LIIT 5BS,A00,507430,Carnelos; Chiara,20,0,20,0
1715601417002,LIIT 5CS,A00,507432,Carnelos; Chiara,20,0,20,0
1715601418028,LISP 5A,A00,507541,Munoz Sanchez; Alicia,11,0,20,9
1715601419057,LISP 5B,A00,507671,Munoz Sanchez; Alicia,9,0,20,11
1715601420084,LISP 5C,A00,507696,Munoz Sanchez; Alicia,9,0,20,11
1715601421113,MAE 197,001,528363,Boechler; Nicholas Sebastia,9998,0,9999,1
1715601422146,MATH 197,001,523477,Kedlaya; Kiran S.,9994,0,9999,5
1715601422146,MATH 197,002,563811,Zhang; Danna,9994,0,9999,5
1715601422146,MATH 197,003,628552,Dumitriu; Ioana,9998,0,9999,1
1715601422146,MATH 197,004,660885,Floyd; Eric,9999,0,9999,0
1715601423176,MCWP 40R,A00,518780,Staff,2,0,20,18
1715601423176,MCWP 40R,B00,518781,Staff,11,0,20,9
1715601423176,MCWP 40R,C00,518783,Staff,5,0,20,15
1715601424204,MCWP 50R,A00,518791,Staff,0,1,20,20
1715601424204,MCWP 50R,B00,518792,Staff,0,2,20,20
1715601424204,MCWP 50R,C00,518793,Staff,0,4,20,20
1715601424204,MCWP 50R,D00,518794,Staff,0,1,20,20
1715601424204,MCWP 50R,E00,518795,Staff,0,2,20,20
1715601424204,MCWP 50R,F00,518796,Staff,0,1,20,20
1715601424204,MCWP 50R,G00,518797,Staff,0,1,20,20
1715601425232,MMW 12R,A01,514034,Herbst; Matthew,0,2,16,16
1715601425232,MMW 12R,A02,514035,Herbst; Matthew,0,0,16,16
1715601426260,MMW 13R,A01,514037,Staff,0,5,16,16
1715601426260,MMW 13R,A02,514039,Staff,0,5,16,16
1715601426260,MMW 13R,A03,628519,Staff,0,4,16,16
1715601428317,SIO 295LS,A00,523233,Staff,10,0,30,20
1715601429345,SIO 295S,A00,523232,Staff,10,0,30,20
1715601430373,SIOC 290S,A01,637330,Merrifield; Mark A,23,0,30,7
1715601431400,SIOC 291S,A01,637333,Gabriel; Corey John,23,0,30,7
1715601432428,SOCI 117,A01,494376,Staff,0,5,5,5
1715601433455,WES 237B,A00,494380,Staff,10,0,20,10
1715601435537,AESE 279B,A00,494370,Wade; Jon P,0,0,33,33
1715601436562,AIP 97,001,660915,Van Den Einde; Yael Dahlia,9999,0,9999,0
1715601437591,AIP 197,001,627712,Vespa; Emanuel Ignacio,9995,0,9999,4
1715601437591,AIP 197,002,650778,Amir; On,9998,0,9999,1
1715601437591,AIP 197,003,650933,Avenancio-Leon; Carlos,9998,0,9999,1
1715601437591,AIP 197,004,658530,Heyman; Gail D.,9998,0,9999,1
1715601437591,AIP 197,005,658631,Neal; Sonya E,9998,0,9999,1
1715601437591,AIP 197,006,658671,Du; Songzi,9998,0,9999,1
1715601438620,ANAR 135S,A00,494369,Braswell; Geoffrey E.,0,0,0,0
1715601439648,BENG 196,001,628496,Engler; Adam J.,9998,0,9999,1
1715601439648,BENG 196,002,660916,Watson; John Thomas,9999,0,9999,0
1715601440675,BISP 197,001,650773,Wilhelm; James E.,9994,0,9999,5
1715601440675,BISP 197,002,658904,Coleman; Aaron B.,9998,0,9999,1
1715601441701,CAT 124RS,A01,519847,Geibel; William,0,0,20,20
1715601442730,CAT 125RS,A01,515971,Geibel; William,0,0,20,20
1715601443755,CLRE 250,A00,511389,Morris; Sheldon,9992,0,9999,7
1715601444782,CLRE 251,A00,507176,Mehta; Ravindra L.,9992,0,9999,7
1715601444782,CLRE 251,B00,511410,Mehta; Ravindra L.,9998,0,9999,1
1715601445806,CLRE 252,A00,507189,Cuomo; Raphael Eduardo,9994,0,9999,5
1715601446831,CLRE 253,A00,507199,Vaida; Florin,9994,0,9999,5
1715601446831,CLRE 253,B00,507202,Vaida; Florin,9999,0,9999,0
1715601447856,CLRE 259,A00,507211,Patel; Hemal,9996,0,9999,3
1715601448882,CLRE 260,A00,507221,Cuomo; Raphael Eduardo,9999,0,9999,0
1715601449907,CLRE 297,001,507242,Cuomo; Raphael Eduardo,9999,0,9999,0
1715601450935,COGS 197,001,638244,Voytek; Bradley Thomas,9997,0,9999,2
1715601451962,CSE 191,A00,516875,Minnes Kemp; Mor Mia,9991,0,9999,8
1715601452993,CSE 197,001,637388,Minnes Kemp; Mor Mia,9992,0,9999,7
1715601454020,CSS 201S,A01,494383,Mignozzetti; Umberto,35,0,35,0
1715601455050,CSS 202S,A01,494387,Mignozzetti; Umberto,35,0,35,0
1715601456077,DSC 197,001,628532,Eldridge; Justin Matthew,9995,0,9999,4
1715601457104,EAP 100,A00,516065,Staff,9799,0,9999,200
1715601458147,ECE 45,A01,507414,Staff,31,0,60,29
1715601460200,ECE 111,A01,507420,Staff,11,0,50,39
1715601461226,ECE 197,001,548057,Sievenpiper; Daniel F.,9991,0,9999,8
1715601462259,EDS 115,A00,507243,Choi; Bailey Miyeon,7,0,28,21
1715601463287,EDS 117,A01,494379,Staff,0,6,34,34
1715601464318,EDS 125,A00,507246,Hopkins; Megan Beth,8,0,30,22
1715601465348,EDS 128A,A01,507264,Fargason; Sharon Gayle,6,0,26,20
1715601466378,EDS 128B,A01,507293,Pappas; Elizabeth,10,0,30,20
1715601467407,EDS 139,A00,507294,Fargason; Sharon Gayle,10,0,30,20
1715601467407,EDS 139,B00,507313,Pappas; Elizabeth,11,0,30,19
1715601468432,EDS 201,A00,507315,Staff,10,0,30,20
1715601469459,EDS 203,A01,507317,Halter; Christopher P.,10,0,30,20
1715601470489,EDS 204R,A01,507319,Halter; Christopher P.,0,3,30,30
1715601470489,EDS 204R,B01,507331,Heinzman; Erica M.,14,0,30,16
1715601471519,EDS 206R,A00,507332,Staff,0,4,30,30
1715601471519,EDS 206R,B00,507343,Staff,15,0,30,15
1715601472545,EDS 250,A00,507344,Hemans; Patricia Ann Benitez,20,0,40,20
1715601473572,EDS 281,A00,507345,Daly; Alan J.,18,0,18,0
1715601474600,EDS 284,A00,507350,Daly; Alan J.,16,0,16,0
1715601475627,EDS 286,A00,507359,Fine; Sarah,18,0,18,0
1715601476655,EDS 289C,A01,507361,Daly; Alan J.,18,0,18,0
1715601477685,EDS 290,A00,507366,Hofstetter; Carolyn,15,0,15,0
1715601478715,LIGM 5A,A00,507421,Fischer-Grunski; Eva K,17,0,20,3
1715601479742,LIGM 5B,A00,507423,Fischer-Grunski; Eva K,19,0,20,1
1715601480773,LIGM 5C,A00,507425,Fischer-Grunski; Eva K,19,0,20,1
1715601481800,LIIT 5AS,A00,507427,Carnelos; Chiara,20,0,20,0
1715601482831,LIIT 5BS,A00,507430,Carnelos; Chiara,20,0,20,0
1715601483870,LIIT 5CS,A00,507432,Carnelos; Chiara,20,0,20,0
1715601484900,LISP 5A,A00,507541,Munoz Sanchez; Alicia,11,0,20,9
1715601485925,LISP 5B,A00,507671,Munoz Sanchez; Alicia,9,0,20,11
1715601486974,LISP 5C,A00,507696,Munoz Sanchez; Alicia,9,0,20,11
1715601488000,MAE 197,001,528363,Boechler; Nicholas Sebastia,9998,0,9999,1
1715601489029,MATH 197,001,523477,Kedlaya; Kiran S.,9994,0,9999,5
1715601489029,MATH 197,002,563811,Zhang; Danna,9994,0,9999,5
1715601489029,MATH 197,003,628552,Dumitriu; Ioana,9998,0,9999,1
1715601489029,MATH 197,004,660885,Floyd; Eric,9999,0,9999,0
1715601490054,MCWP 40R,A00,518780,Staff,2,0,20,18
1715601490054,MCWP 40R,B00,518781,Staff,11,0,20,9
1715601490054,MCWP 40R,C00,518783,Staff,5,0,20,15
1715601491081,MCWP 50R,A00,518791,Staff,0,1,20,20
1715601491081,MCWP 50R,B00,518792,Staff,0,2,20,20
1715601491081,MCWP 50R,C00,518793,Staff,0,4,20,20
1715601491081,MCWP 50R,D00,518794,Staff,0,1,20,20
1715601491081,MCWP 50R,E00,518795,Staff,0,2,20,20
1715601491081,MCWP 50R,F00,518796,Staff,0,1,20,20
1715601491081,MCWP 50R,G00,518797,Staff,0,1,20,20
1715601492107,MMW 12R,A01,514034,Herbst; Matthew,0,2,16,16
1715601492107,MMW 12R,A02,514035,Herbst; Matthew,0,0,16,16
1715601493132,MMW 13R,A01,514037,Staff,0,5,16,16
1715601493132,MMW 13R,A02,514039,Staff,0,5,16,16
1715601493132,MMW 13R,A03,628519,Staff,0,4,16,16
1715601495183,SIO 295LS,A00,523233,Staff,10,0,30,20
1715601496211,SIO 295S,A00,523232,Staff,10,0,30,20
1715601497237,SIOC 290S,A01,637330,Merrifield; Mark A,23,0,30,7
1715601498263,SIOC 291S,A01,637333,Gabriel; Corey John,23,0,30,7
1715601499296,SOCI 117,A01,494376,Staff,0,5,5,5
1715601500324,WES 237B,A00,494380,Staff,10,0,20,10
1715601502390,AESE 279B,A00,494370,Wade; Jon P,0,0,33,33
1715601503416,AIP 97,001,660915,Van Den Einde; Yael Dahlia,9999,0,9999,0
1715601504444,AIP 197,001,627712,Vespa; Emanuel Ignacio,9995,0,9999,4
1715601504444,AIP 197,002,650778,Amir; On,9998,0,9999,1
1715601504444,AIP 197,003,650933,Avenancio-Leon; Carlos,9998,0,9999,1
1715601504444,AIP 197,004,658530,Heyman; Gail D.,9998,0,9999,1
1715601504444,AIP 197,005,658631,Neal; Sonya E,9998,0,9999,1
1715601504444,AIP 197,006,658671,Du; Songzi,9998,0,9999,1
1715601505472,ANAR 135S,A00,494369,Braswell; Geoffrey E.,0,0,0,0
1715601506501,BENG 196,001,628496,Engler; Adam J.,9998,0,9999,1
1715601506501,BENG 196,002,660916,Watson; John Thomas,9999,0,9999,0
1715601507531,BISP 197,001,650773,Wilhelm; James E.,9994,0,9999,5
1715601507531,BISP 197,002,658904,Coleman; Aaron B.,9998,0,9999,1
1715601508556,CAT 124RS,A01,519847,Geibel; William,0,0,20,20
1715601509581,CAT 125RS,A01,515971,Geibel; William,0,0,20,20
1715601510612,CLRE 250,A00,511389,Morris; Sheldon,9992,0,9999,7
1715601511644,CLRE 251,A00,507176,Mehta; Ravindra L.,9992,0,9999,7
1715601511644,CLRE 251,B00,511410,Mehta; Ravindra L.,9998,0,9999,1
1715601512673,CLRE 252,A00,507189,Cuomo; Raphael Eduardo,9994,0,9999,5
1715601513703,CLRE 253,A00,507199,Vaida; Florin,9994,0,9999,5
1715601513703,CLRE 253,B00,507202,Vaida; Florin,9999,0,9999,0
1715601514733,CLRE 259,A00,507211,Patel; Hemal,9996,0,9999,3
1715601515761,CLRE 260,A00,507221,Cuomo; Raphael Eduardo,9999,0,9999,0
1715601516787,CLRE 297,001,507242,Cuomo; Raphael Eduardo,9999,0,9999,0
1715601517812,COGS 197,001,638244,Voytek; Bradley Thomas,9997,0,9999,2
1715601518837,CSE 191,A00,516875,Minnes Kemp; Mor Mia,9991,0,9999,8
1715601519862,CSE 197,001,637388,Minnes Kemp; Mor Mia,9992,0,9999,7
1715601520892,CSS 201S,A01,494383,Mignozzetti; Umberto,35,0,35,0
1715601521922,CSS 202S,A01,494387,Mignozzetti; Umberto,35,0,35,0
1715601522948,DSC 197,001,628532,Eldridge; Justin Matthew,9995,0,9999,4
1715601523974,EAP 100,A00,516065,Staff,9799,0,9999,200
1715601525002,ECE 45,A01,507414,Staff,31,0,60,29
1715601527059,ECE 111,A01,507420,Staff,11,0,50,39
1715601528088,ECE 197,001,548057,Sievenpiper; Daniel F.,9991,0,9999,8
1715601529115,EDS 115,A00,507243,Choi; Bailey Miyeon,7,0,28,21
1715601530141,EDS 117,A01,494379,Staff,0,6,34,34
1715601531185,EDS 125,A00,507246,Hopkins; Megan Beth,8,0,30,22
1715601532213,EDS 128A,A01,507264,Fargason; Sharon Gayle,6,0,26,20
1715601533239,EDS 128B,A01,507293,Pappas; Elizabeth,10,0,30,20
1715601534266,EDS 139,A00,507294,Fargason; Sharon Gayle,10,0,30,20
1715601534266,EDS 139,B00,507313,Pappas; Elizabeth,11,0,30,19
1715601535292,EDS 201,A00,507315,Staff,10,0,30,20
1715601536321,EDS 203,A01,507317,Halter; Christopher P.,10,0,30,20
1715601537349,EDS 204R,A01,507319,Halter; Christopher P.,0,3,30,30
1715601537349,EDS 204R,B01,507331,Heinzman; Erica M.,14,0,30,16
1715601538377,EDS 206R,A00,507332,Staff,0,4,30,30
1715601538377,EDS 206R,B00,507343,Staff,15,0,30,15
1715601539404,EDS 250,A00,507344,Hemans; Patricia Ann Benitez,20,0,40,20
1715601540430,EDS 281,A00,507345,Daly; Alan J.,18,0,18,0
1715601541457,EDS 284,A00,507350,Daly; Alan J.,16,0,16,0
1715601542483,EDS 286,A00,507359,Fine; Sarah,18,0,18,0
1715601543509,EDS 289C,A01,507361,Daly; Alan J.,18,0,18,0
1715601544536,EDS 290,A00,507366,Hofstetter; Carolyn,15,0,15,0
1715601545567,LIGM 5A,A00,507421,Fischer-Grunski; Eva K,17,0,20,3
1715601546596,LIGM 5B,A00,507423,Fischer-Grunski; Eva K,19,0,20,1
1715601547623,LIGM 5C,A00,507425,Fischer-Grunski; Eva K,19,0,20,1
1715601548650,LIIT 5AS,A00,507427,Carnelos; Chiara,20,0,20,0
1715601549678,LIIT 5BS,A00,507430,Carnelos; Chiara,20,0,20,0
1715601550704,LIIT 5CS,A00,507432,Carnelos; Chiara,20,0,20,0
1715601551731,LISP 5A,A00,507541,Munoz Sanchez; Alicia,11,0,20,9
1715601552758,LISP 5B,A00,507671,Munoz Sanchez; Alicia,9,0,20,11
1715601553786,LISP 5C,A00,507696,Munoz Sanchez; Alicia,9,0,20,11
1715601554813,MAE 197,001,528363,Boechler; Nicholas Sebastia,9998,0,9999,1
1715601555849,MATH 197,001,523477,Kedlaya; Kiran S.,9994,0,9999,5
1715601555849,MATH 197,002,563811,Zhang; Danna,9994,0,9999,5
1715601555849,MATH 197,003,628552,Dumitriu; Ioana,9998,0,9999,1
1715601555849,MATH 197,004,660885,Floyd; Eric,9999,0,9999,0
1715601556878,MCWP 40R,A00,518780,Staff,2,0,20,18
1715601556878,MCWP 40R,B00,518781,Staff,11,0,20,9
1715601556878,MCWP 40R,C00,518783,Staff,5,0,20,15
1715601557909,MCWP 50R,A00,518791,Staff,0,1,20,20
1715601557909,MCWP 50R,B00,518792,Staff,0,2,20,20
1715601557909,MCWP 50R,C00,518793,Staff,0,4,20,20
1715601557909,MCWP 50R,D00,518794,Staff,0,1,20,20
1715601557909,MCWP 50R,E00,518795,Staff,0,2,20,20
1715601557909,MCWP 50R,F00,518796,Staff,0,1,20,20
1715601557909,MCWP 50R,G00,518797,Staff,0,1,20,20
1715601558940,MMW 12R,A01,514034,Herbst; Matthew,0,2,16,16
1715601558940,MMW 12R,A02,514035,Herbst; Matthew,0,0,16,16
1715601559967,MMW 13R,A01,514037,Staff,0,5,16,16
1715601559967,MMW 13R,A02,514039,Staff,0,5,16,16
1715601559967,MMW 13R,A03,628519,Staff,0,4,16,16
1715601562025,SIO 295LS,A00,523233,Staff,10,0,30,20
1715601563050,SIO 295S,A00,523232,Staff,10,0,30,20
1715601564083,SIOC 290S,A01,637330,Merrifield; Mark A,23,0,30,7
1715601565110,SIOC 291S,A01,637333,Gabriel; Corey John,23,0,30,7
1715601566140,SOCI 117,A01,494376,Staff,0,5,5,5
1715601567166,WES 237B,A00,494380,Staff,10,0,20,10
1715601569239,AESE 279B,A00,494370,Wade; Jon P,0,0,33,33
1715601570269,AIP 97,001,660915,Van Den Einde; Yael Dahlia,9999,0,9999,0
1715601571299,AIP 197,001,627712,Vespa; Emanuel Ignacio,9995,0,9999,4
1715601571299,AIP 197,002,650778,Amir; On,9998,0,9999,1
1715601571299,AIP 197,003,650933,Avenancio-Leon; Carlos,9998,0,9999,1
1715601571299,AIP 197,004,658530,Heyman; Gail D.,9998,0,9999,1
1715601571299,AIP 197,005,658631,Neal; Sonya E,9998,0,9999,1
1715601571299,AIP 197,006,658671,Du; Songzi,9998,0,9999,1
1715601572326,ANAR 135S,A00,494369,Braswell; Geoffrey E.,0,0,0,0
1715601573354,BENG 196,001,628496,Engler; Adam J.,9998,0,9999,1
1715601573354,BENG 196,002,660916,Watson; John Thomas,9999,0,9999,0
1715601574382,BISP 197,001,650773,Wilhelm; James E.,9994,0,9999,5
1715601574382,BISP 197,002,658904,Coleman; Aaron B.,9998,0,9999,1
1715601575413,CAT 124RS,A01,519847,Geibel; William,0,0,20,20
1715601576438,CAT 125RS,A01,515971,Geibel; William,0,0,20,20
1715601577465,CLRE 250,A00,511389,Morris; Sheldon,9992,0,9999,7
1715601578493,CLRE 251,A00,507176,Mehta; Ravindra L.,9992,0,9999,7
1715601578493,CLRE 251,B00,511410,Mehta; Ravindra L.,9998,0,9999,1
1715601579526,CLRE 252,A00,507189,Cuomo; Raphael Eduardo,9994,0,9999,5
1715601580552,CLRE 253,A00,507199,Vaida; Florin,9994,0,9999,5
1715601580552,CLRE 253,B00,507202,Vaida; Florin,9999,0,9999,0
1715601581579,CLRE 259,A00,507211,Patel; Hemal,9996,0,9999,3
1715601582606,CLRE 260,A00,507221,Cuomo; Raphael Eduardo,9999,0,9999,0
1715601583631,CLRE 297,001,507242,Cuomo; Raphael Eduardo,9999,0,9999,0
1715601584658,COGS 197,001,638244,Voytek; Bradley Thomas,9997,0,9999,2
1715601585688,CSE 191,A00,516875,Minnes Kemp; Mor Mia,9991,0,9999,8
1715601586713,CSE 197,001,637388,Minnes Kemp; Mor Mia,9992,0,9999,7
1715601587741,CSS 201S,A01,494383,Mignozzetti; Umberto,35,0,35,0
1715601588769,CSS 202S,A01,494387,Mignozzetti; Umberto,35,0,35,0
1715601589793,DSC 197,001,628532,Eldridge; Justin Matthew,9995,0,9999,4
1715601590819,EAP 100,A00,516065,Staff,9799,0,9999,200
1715601591853,ECE 45,A01,507414,Staff,31,0,60,29
1715601593907,ECE 111,A01,507420,Staff,11,0,50,39
1715601594937,ECE 197,001,548057,Sievenpiper; Daniel F.,9991,0,9999,8
1715601595967,EDS 115,A00,507243,Choi; Bailey Miyeon,7,0,28,21
1715601596999,EDS 117,A01,494379,Staff,0,6,34,34
1715601598026,EDS 125,A00,507246,Hopkins; Megan Beth,8,0,30,22
1715601599053,EDS 128A,A01,507264,Fargason; Sharon Gayle,6,0,26,20
1715601600081,EDS 128B,A01,507293,Pappas; Elizabeth,10,0,30,20
1715601601107,EDS 139,A00,507294,Fargason; Sharon Gayle,10,0,30,20
1715601601107,EDS 139,B00,507313,Pappas; Elizabeth,11,0,30,19
1715601602133,EDS 201,A00,507315,Staff,10,0,30,20
1715601603165,EDS 203,A01,507317,Halter; Christopher P.,10,0,30,20
1715601604194,EDS 204R,A01,507319,Halter; Christopher P.,0,3,30,30
1715601604194,EDS 204R,B01,507331,Heinzman; Erica M.,14,0,30,16
1715601605222,EDS 206R,A00,507332,Staff,0,4,30,30
1715601605222,EDS 206R,B00,507343,Staff,15,0,30,15
1715601606251,EDS 250,A00,507344,Hemans; Patricia Ann Benitez,20,0,40,20
1715601607282,EDS 281,A00,507345,Daly; Alan J.,18,0,18,0
1715601608307,EDS 284,A00,507350,Daly; Alan J.,16,0,16,0
1715601609335,EDS 286,A00,507359,Fine; Sarah,18,0,18,0
1715601610359,EDS 289C,A01,507361,Daly; Alan J.,18,0,18,0
1715601611442,EDS 290,A00,507366,Hofstetter; Carolyn,15,0,15,0
1715601612471,LIGM 5A,A00,507421,Fischer-Grunski; Eva K,17,0,20,3
1715601613497,LIGM 5B,A00,507423,Fischer-Grunski; Eva K,19,0,20,1
1715601614527,LIGM 5C,A00,507425,Fischer-Grunski; Eva K,19,0,20,1
1715601615555,LIIT 5AS,A00,507427,Carnelos; Chiara,20,0,20,0
1715601616583,LIIT 5BS,A00,507430,Carnelos; Chiara,20,0,20,0
1715601617611,LIIT 5CS,A00,507432,Carnelos; Chiara,20,0,20,0
1715601618642,LISP 5A,A00,507541,Munoz Sanchez; Alicia,11,0,20,9
1715601619667,LISP 5B,A00,507671,Munoz Sanchez; Alicia,9,0,20,11
1715601620695,LISP 5C,A00,507696,Munoz Sanchez; Alicia,9,0,20,11
1715601621724,MAE 197,001,528363,Boechler; Nicholas Sebastia,9998,0,9999,1
1715601622752,MATH 197,001,523477,Kedlaya; Kiran S.,9994,0,9999,5
1715601622752,MATH 197,002,563811,Zhang; Danna,9994,0,9999,5
1715601622752,MATH 197,003,628552,Dumitriu; Ioana,9998,0,9999,1
1715601622752,MATH 197,004,660885,Floyd; Eric,9999,0,9999,0
1715601623779,MCWP 40R,A00,518780,Staff,2,0,20,18
1715601623779,MCWP 40R,B00,518781,Staff,11,0,20,9
1715601623779,MCWP 40R,C00,518783,Staff,5,0,20,15
1715601624809,MCWP 50R,A00,518791,Staff,0,1,20,20
1715601624809,MCWP 50R,B00,518792,Staff,0,2,20,20
1715601624809,MCWP 50R,C00,518793,Staff,0,4,20,20
1715601624809,MCWP 50R,D00,518794,Staff,0,1,20,20
1715601624809,MCWP 50R,E00,518795,Staff,0,2,20,20
1715601624809,MCWP 50R,F00,518796,Staff,0,1,20,20
1715601624809,MCWP 50R,G00,518797,Staff,0,1,20,20
1715601625835,MMW 12R,A01,514034,Herbst; Matthew,0,2,16,16
1715601625835,MMW 12R,A02,514035,Herbst; Matthew,0,0,16,16
1715601626864,MMW 13R,A01,514037,Staff,0,5,16,16
1715601626864,MMW 13R,A02,514039,Staff,0,5,16,16
1715601626864,MMW 13R,A03,628519,Staff,0,4,16,16
1715601628916,SIO 295LS,A00,523233,Staff,10,0,30,20
1715601629943,SIO 295S,A00,523232,Staff,10,0,30,20
1715601630970,SIOC 290S,A01,637330,Merrifield; Mark A,23,0,30,7
1715601632002,SIOC 291S,A01,637333,Gabriel; Corey John,23,0,30,7
1715601633029,SOCI 117,A01,494376,Staff,0,5,5,5
1715601634056,WES 237B,A00,494380,Staff,10,0,20,10
1715601636130,AESE 279B,A00,494370,Wade; Jon P,0,0,33,33
1715601637158,AIP 97,001,660915,Van Den Einde; Yael Dahlia,9999,0,9999,0
1715601638191,AIP 197,001,627712,Vespa; Emanuel Ignacio,9995,0,9999,4
1715601638191,AIP 197,002,650778,Amir; On,9998,0,9999,1
1715601638191,AIP 197,003,650933,Avenancio-Leon; Carlos,9998,0,9999,1
1715601638191,AIP 197,004,658530,Heyman; Gail D.,9998,0,9999,1
1715601638191,AIP 197,005,658631,Neal; Sonya E,9998,0,9999,1
1715601638191,AIP 197,006,658671,Du; Songzi,9998,0,9999,1
1715601639220,ANAR 135S,A00,494369,Braswell; Geoffrey E.,0,0,0,0
1715601640252,BENG 196,001,628496,Engler; Adam J.,9998,0,9999,1
1715601640252,BENG 196,002,660916,Watson; John Thomas,9999,0,9999,0
1715601641281,BISP 197,001,650773,Wilhelm; James E.,9994,0,9999,5
1715601641281,BISP 197,002,658904,Coleman; Aaron B.,9998,0,9999,1
1715601642306,CAT 124RS,A01,519847,Geibel; William,0,0,20,20
1715601643333,CAT 125RS,A01,515971,Geibel; William,0,0,20,20
1715601644363,CLRE 250,A00,511389,Morris; Sheldon,9992,0,9999,7
1715601645388,CLRE 251,A00,507176,Mehta; Ravindra L.,9992,0,9999,7
1715601645388,CLRE 251,B00,511410,Mehta; Ravindra L.,9998,0,9999,1
1715601646414,CLRE 252,A00,507189,Cuomo; Raphael Eduardo,9994,0,9999,5
1715601647440,CLRE 253,A00,507199,Vaida; Florin,9994,0,9999,5
1715601647440,CLRE 253,B00,507202,Vaida; Florin,9999,0,9999,0
1715601648468,CLRE 259,A00,507211,Patel; Hemal,9996,0,9999,3
1715601649493,CLRE 260,A00,507221,Cuomo; Raphael Eduardo,9999,0,9999,0
1715601650520,CLRE 297,001,507242,Cuomo; Raphael Eduardo,9999,0,9999,0
1715601651549,COGS 197,001,638244,Voytek; Bradley Thomas,9997,0,9999,2
1715601652575,CSE 191,A00,516875,Minnes Kemp; Mor Mia,9991,0,9999,8
1715601653604,CSE 197,001,637388,Minnes Kemp; Mor Mia,9992,0,9999,7
1715601654636,CSS 201S,A01,494383,Mignozzetti; Umberto,35,0,35,0
1715601655666,CSS 202S,A01,494387,Mignozzetti; Umberto,35,0,35,0
1715601656694,DSC 197,001,628532,Eldridge; Justin Matthew,9995,0,9999,4
1715601657722,EAP 100,A00,516065,Staff,9799,0,9999,200
1715601658750,ECE 45,A01,507414,Staff,31,0,60,29
1715601660802,ECE 111,A01,507420,Staff,11,0,50,39
1715601661828,ECE 197,001,548057,Sievenpiper; Daniel F.,9991,0,9999,8
1715601662857,EDS 115,A00,507243,Choi; Bailey Miyeon,7,0,28,21
1715601663883,EDS 117,A01,494379,Staff,0,6,34,34
1715601664908,EDS 125,A00,507246,Hopkins; Megan Beth,8,0,30,22
1715601665939,EDS 128A,A01,507264,Fargason; Sharon Gayle,6,0,26,20
1715601666966,EDS 128B,A01,507293,Pappas; Elizabeth,10,0,30,20
1715601667992,EDS 139,A00,507294,Fargason; Sharon Gayle,10,0,30,20
1715601667992,EDS 139,B00,507313,Pappas; Elizabeth,11,0,30,19
1715601669022,EDS 201,A00,507315,Staff,10,0,30,20
1715601670049,EDS 203,A01,507317,Halter; Christopher P.,10,0,30,20
1715601671076,EDS 204R,A01,507319,Halter; Christopher P.,0,3,30,30
1715601671076,EDS 204R,B01,507331,Heinzman; Erica M.,14,0,30,16
1715601672102,EDS 206R,A00,507332,Staff,0,4,30,30
1715601672102,EDS 206R,B00,507343,Staff,15,0,30,15
1715601673132,EDS 250,A00,507344,Hemans; Patricia Ann Benitez,20,0,40,20
1715601674159,EDS 281,A00,507345,Daly; Alan J.,18,0,18,0
1715601675185,EDS 284,A00,507350,Daly; Alan J.,16,0,16,0
1715601676209,EDS 286,A00,507359,Fine; Sarah,18,0,18,0
1715601677237,EDS 289C,A01,507361,Daly; Alan J.,18,0,18,0
1715601678303,EDS 290,A00,507366,Hofstetter; Carolyn,15,0,15,0
1715601679330,LIGM 5A,A00,507421,Fischer-Grunski; Eva K,17,0,20,3
1715601680363,LIGM 5B,A00,507423,Fischer-Grunski; Eva K,19,0,20,1
1715601681390,LIGM 5C,A00,507425,Fischer-Grunski; Eva K,19,0,20,1
1715601682422,LIIT 5AS,A00,507427,Carnelos; Chiara,20,0,20,0
1715601683452,LIIT 5BS,A00,507430,Carnelos; Chiara,20,0,20,0
1715601684479,LIIT 5CS,A00,507432,Carnelos; Chiara,20,0,20,0
1715601685505,LISP 5A,A00,507541,Munoz Sanchez; Alicia,11,0,20,9
1715601686535,LISP 5B,A00,507671,Munoz Sanchez; Alicia,9,0,20,11
1715601687565,LISP 5C,A00,507696,Munoz Sanchez; Alicia,9,0,20,11
1715601688591,MAE 197,001,528363,Boechler; Nicholas Sebastia,9998,0,9999,1
1715601689619,MATH 197,001,523477,Kedlaya; Kiran S.,9994,0,9999,5
1715601689619,MATH 197,002,563811,Zhang; Danna,9994,0,9999,5
1715601689619,MATH 197,003,628552,Dumitriu; Ioana,9998,0,9999,1
1715601689619,MATH 197,004,660885,Floyd; Eric,9999,0,9999,0
1715601690694,MCWP 40R,A00,518780,Staff,2,0,20,18
1715601690694,MCWP 40R,B00,518781,Staff,11,0,20,9
1715601690694,MCWP 40R,C00,518783,Staff,5,0,20,15
1715601691740,MCWP 50R,A00,518791,Staff,0,1,20,20
1715601691740,MCWP 50R,B00,518792,Staff,0,2,20,20
1715601691740,MCWP 50R,C00,518793,Staff,0,4,20,20
1715601691740,MCWP 50R,D00,518794,Staff,0,1,20,20
1715601691740,MCWP 50R,E00,518795,Staff,0,2,20,20
1715601691740,MCWP 50R,F00,518796,Staff,0,1,20,20
1715601691740,MCWP 50R,G00,518797,Staff,0,1,20,20
1715601692766,MMW 12R,A01,514034,Herbst; Matthew,0,2,16,16
1715601692766,MMW 12R,A02,514035,Herbst; Matthew,0,0,16,16
1715601693793,MMW 13R,A01,514037,Staff,0,5,16,16
1715601693793,MMW 13R,A02,514039,Staff,0,5,16,16
1715601693793,MMW 13R,A03,628519,Staff,0,4,16,16
1715601695881,SIO 295LS,A00,523233,Staff,10,0,30,20
1715601696909,SIO 295S,A00,523232,Staff,10,0,30,20
1715601698029,SIOC 290S,A01,637330,Merrifield; Mark A,23,0,30,7
1715601699061,SIOC 291S,A01,637333,Gabriel; Corey John,23,0,30,7
1715601700159,SOCI 117,A01,494376,Staff,0,5,5,5
1715601701274,WES 237B,A00,494380,Staff,10,0,20,10
1715601703372,AESE 279B,A00,494370,Wade; Jon P,0,0,33,33
1715601704397,AIP 97,001,660915,Van Den Einde; Yael Dahlia,9999,0,9999,0
1715601705433,AIP 197,001,627712,Vespa; Emanuel Ignacio,9995,0,9999,4
1715601705433,AIP 197,002,650778,Amir; On,9998,0,9999,1
1715601705433,AIP 197,003,650933,Avenancio-Leon; Carlos,9998,0,9999,1
1715601705433,AIP 197,004,658530,Heyman; Gail D.,9998,0,9999,1
1715601705433,AIP 197,005,658631,Neal; Sonya E,9998,0,9999,1
1715601705433,AIP 197,006,658671,Du; Songzi,9998,0,9999,1
1715601706460,ANAR 135S,A00,494369,Braswell; Geoffrey E.,0,0,0,0
1715601707488,BENG 196,001,628496,Engler; Adam J.,9998,0,9999,1
1715601707488,BENG 196,002,660916,Watson; John Thomas,9999,0,9999,0
1715601708515,BISP 197,001,650773,Wilhelm; James E.,9994,0,9999,5
1715601708515,BISP 197,002,658904,Coleman; Aaron B.,9998,0,9999,1
1715601709542,CAT 124RS,A01,519847,Geibel; William,0,0,20,20
1715601710567,CAT 125RS,A01,515971,Geibel; William,0,0,20,20
1715601711620,CLRE 250,A00,511389,Morris; Sheldon,9992,0,9999,7
1715601712701,CLRE 251,A00,507176,Mehta; Ravindra L.,9992,0,9999,7
1715601712701,CLRE 251,B00,511410,Mehta; Ravindra L.,9998,0,9999,1
1715601713731,CLRE 252,A00,507189,Cuomo; Raphael Eduardo,9994,0,9999,5
1715601714758,CLRE 253,A00,507199,Vaida; Florin,9994,0,9999,5
1715601714758,CLRE 253,B00,507202,Vaida; Florin,9999,0,9999,0
1715601715785,CLRE 259,A00,507211,Patel; Hemal,9996,0,9999,3
1715601716814,CLRE 260,A00,507221,Cuomo; Raphael Eduardo,9999,0,9999,0
1715601717845,CLRE 297,001,507242,Cuomo; Raphael Eduardo,9999,0,9999,0
1715601718873,COGS 197,001,638244,Voytek; Bradley Thomas,9997,0,9999,2
1715601719901,CSE 191,A00,516875,Minnes Kemp; Mor Mia,9991,0,9999,8
1715601720932,CSE 197,001,637388,Minnes Kemp; Mor Mia,9992,0,9999,7
1715601722186,CSS 201S,A01,494383,Mignozzetti; Umberto,35,0,35,0
1715601723217,CSS 202S,A01,494387,Mignozzetti; Umberto,35,0,35,0
1715601724244,DSC 197,001,628532,Eldridge; Justin Matthew,9995,0,9999,4
1715601725273,EAP 100,A00,516065,Staff,9799,0,9999,200
1715601726377,ECE 45,A01,507414,Staff,31,0,60,29
1715601728433,ECE 111,A01,507420,Staff,11,0,50,39
1715601729459,ECE 197,001,548057,Sievenpiper; Daniel F.,9991,0,9999,8
1715601730489,EDS 115,A00,507243,Choi; Bailey Miyeon,7,0,28,21
1715601731517,EDS 117,A01,494379,Staff,0,6,34,34
1715601732544,EDS 125,A00,507246,Hopkins; Megan Beth,8,0,30,22
1715601733574,EDS 128A,A01,507264,Fargason; Sharon Gayle,6,0,26,20
1715601734612,EDS 128B,A01,507293,Pappas; Elizabeth,10,0,30,20
1715601735640,EDS 139,A00,507294,Fargason; Sharon Gayle,10,0,30,20
1715601735640,EDS 139,B00,507313,Pappas; Elizabeth,11,0,30,19
1715601736666,EDS 201,A00,507315,Staff,10,0,30,20
1715601737812,EDS 203,A01,507317,Halter; Christopher P.,10,0,30,20
1715601738839,EDS 204R,A01,507319,Halter; Christopher P.,0,3,30,30
1715601738839,EDS 204R,B01,507331,Heinzman; Erica M.,14,0,30,16
1715601739867,EDS 206R,A00,507332,Staff,0,4,30,30
1715601739867,EDS 206R,B00,507343,Staff,15,0,30,15
1715601740893,EDS 250,A00,507344,Hemans; Patricia Ann Benitez,20,0,40,20
1715601741975,EDS 281,A00,507345,Daly; Alan J.,18,0,18,0
1715601743002,EDS 284,A00,507350,Daly; Alan J.,16,0,16,0
1715601744097,EDS 286,A00,507359,Fine; Sarah,18,0,18,0
1715601745124,EDS 289C,A01,507361,Daly; Alan J.,18,0,18,0
1715601746210,EDS 290,A00,507366,Hofstetter; Carolyn,15,0,15,0
1715601747378,LIGM 5A,A00,507421,Fischer-Grunski; Eva K,17,0,20,3
1715601748422,LIGM 5B,A00,507423,Fischer-Grunski; Eva K,19,0,20,1
1715601749452,LIGM 5C,A00,507425,Fischer-Grunski; Eva K,19,0,20,1
1715601750483,LIIT 5AS,A00,507427,Carnelos; Chiara,20,0,20,0
1715601751509,LIIT 5BS,A00,507430,Carnelos; Chiara,20,0,20,0
1715601752537,LIIT 5CS,A00,507432,Carnelos; Chiara,20,0,20,0
1715601753562,LISP 5A,A00,507541,Munoz Sanchez; Alicia,11,0,20,9
1715601754640,LISP 5B,A00,507671,Munoz Sanchez; Alicia,9,0,20,11
1715601755670,LISP 5C,A00,507696,Munoz Sanchez; Alicia,9,0,20,11
1715601756700,MAE 197,001,528363,Boechler; Nicholas Sebastia,9998,0,9999,1
1715601757729,MATH 197,001,523477,Kedlaya; Kiran S.,9994,0,9999,5
1715601757729,MATH 197,002,563811,Zhang; Danna,9994,0,9999,5
1715601757729,MATH 197,003,628552,Dumitriu; Ioana,9998,0,9999,1
1715601757729,MATH 197,004,660885,Floyd; Eric,9999,0,9999,0
1715601758759,MCWP 40R,A00,518780,Staff,2,0,20,18
1715601758759,MCWP 40R,B00,518781,Staff,11,0,20,9
1715601758759,MCWP 40R,C00,518783,Staff,5,0,20,15
1715601759812,MCWP 50R,A00,518791,Staff,0,1,20,20
1715601759812,MCWP 50R,B00,518792,Staff,0,2,20,20
1715601759812,MCWP 50R,C00,518793,Staff,0,4,20,20
1715601759812,MCWP 50R,D00,518794,Staff,0,1,20,20
1715601759812,MCWP 50R,E00,518795,Staff,0,2,20,20
1715601759812,MCWP 50R,F00,518796,Staff,0,1,20,20
1715601759812,MCWP 50R,G00,518797,Staff,0,1,20,20
1715601760842,MMW 12R,A01,514034,Herbst; Matthew,0,2,16,16
1715601760842,MMW 12R,A02,514035,Herbst; Matthew,0,0,16,16
1715601761868,MMW 13R,A01,514037,Staff,0,5,16,16
1715601761868,MMW 13R,A02,514039,Staff,0,5,16,16
1715601761868,MMW 13R,A03,628519,Staff,0,4,16,16
1715601763925,SIO 295LS,A00,523233,Staff,10,0,30,20
1715601764953,SIO 295S,A00,523232,Staff,10,0,30,20
1715601765981,SIOC 290S,A01,637330,Merrifield; Mark A,23,0,30,7
1715601767012,SIOC 291S,A01,637333,Gabriel; Corey John,23,0,30,7
1715601768112,SOCI 117,A01,494376,Staff,0,5,5,5
1715601769211,WES 237B,A00,494380,Staff,10,0,20,10
1715601771277,AESE 279B,A00,494370,Wade; Jon P,0,0,33,33
1715601772302,AIP 97,001,660915,Van Den Einde; Yael Dahlia,9999,0,9999,0
1715601773337,AIP 197,001,627712,Vespa; Emanuel Ignacio,9995,0,9999,4
1715601773337,AIP 197,002,650778,Amir; On,9998,0,9999,1
1715601773337,AIP 197,003,650933,Avenancio-Leon; Carlos,9998,0,9999,1
1715601773337,AIP 197,004,658530,Heyman; Gail D.,9998,0,9999,1
1715601773337,AIP 197,005,658631,Neal; Sonya E,9998,0,9999,1
1715601773337,AIP 197,006,658671,Du; Songzi,9998,0,9999,1
1715601774361,ANAR 135S,A00,494369,Braswell; Geoffrey E.,0,0,0,0
1715601775392,BENG 196,001,628496,Engler; Adam J.,9998,0,9999,1
1715601775392,BENG 196,002,660916,Watson; John Thomas,9999,0,9999,0
1715601776423,BISP 197,001,650773,Wilhelm; James E.,9994,0,9999,5
1715601776423,BISP 197,002,658904,Coleman; Aaron B.,9998,0,9999,1
1715601777449,CAT 124RS,A01,519847,Geibel; William,0,0,20,20
1715601778481,CAT 125RS,A01,515971,Geibel; William,0,0,20,20
1715601779525,CLRE 250,A00,511389,Morris; Sheldon,9992,0,9999,7
1715601780607,CLRE 251,A00,507176,Mehta; Ravindra L.,9992,0,9999,7
1715601780607,CLRE 251,B00,511410,Mehta; Ravindra L.,9998,0,9999,1
1715601781638,CLRE 252,A00,507189,Cuomo; Raphael Eduardo,9994,0,9999,5
1715601782666,CLRE 253,A00,507199,Vaida; Florin,9994,0,9999,5
1715601782666,CLRE 253,B00,507202,Vaida; Florin,9999,0,9999,0
1715601783694,CLRE 259,A00,507211,Patel; Hemal,9996,0,9999,3
1715601784721,CLRE 260,A00,507221,Cuomo; Raphael Eduardo,9999,0,9999,0
1715601785749,CLRE 297,001,507242,Cuomo; Raphael Eduardo,9999,0,9999,0
1715601786778,COGS 197,001,638244,Voytek; Bradley Thomas,9997,0,9999,2
1715601787808,CSE 191,A00,516875,Minnes Kemp; Mor Mia,9991,0,9999,8
1715601788890,CSE 197,001,637388,Minnes Kemp; Mor Mia,9992,0,9999,7
1715601789929,CSS 201S,A01,494383,Mignozzetti; Umberto,35,0,35,0
1715601790955,CSS 202S,A01,494387,Mignozzetti; Umberto,35,0,35,0
1715601791985,DSC 197,001,628532,Eldridge; Justin Matthew,9995,0,9999,4
1715601793011,EAP 100,A00,516065,Staff,9799,0,9999,200
1715601794085,ECE 45,A01,507414,Staff,31,0,60,29
1715601796143,ECE 111,A01,507420,Staff,11,0,50,39
1715601797170,ECE 197,001,548057,Sievenpiper; Daniel F.,9991,0,9999,8
1715601798198,EDS 115,A00,507243,Choi; Bailey Miyeon,7,0,28,21
1715601799263,EDS 117,A01,494379,Staff,0,6,34,34
1715601800293,EDS 125,A00,507246,Hopkins; Megan Beth,8,0,30,22
1715601801323,EDS 128A,A01,507264,Fargason; Sharon Gayle,6,0,26,20
1715601802351,EDS 128B,A01,507293,Pappas; Elizabeth,10,0,30,20
1715601803380,EDS 139,A00,507294,Fargason; Sharon Gayle,10,0,30,20
1715601803380,EDS 139,B00,507313,Pappas; Elizabeth,11,0,30,19
1715601804408,EDS 201,A00,507315,Staff,10,0,30,20
1715601805438,EDS 203,A01,507317,Halter; Christopher P.,10,0,30,20
1715601806465,EDS 204R,A01,507319,Halter; Christopher P.,0,3,30,30
1715601806465,EDS 204R,B01,507331,Heinzman; Erica M.,14,0,30,16
1715601807490,EDS 206R,A00,507332,Staff,0,4,30,30
1715601807490,EDS 206R,B00,507343,Staff,15,0,30,15
1715601808517,EDS 250,A00,507344,Hemans; Patricia Ann Benitez,20,0,40,20
1715601809545,EDS 281,A00,507345,Daly; Alan J.,18,0,18,0
1715601810572,EDS 284,A00,507350,Daly; Alan J.,16,0,16,0
1715601811603,EDS 286,A00,507359,Fine; Sarah,18,0,18,0
1715601812629,EDS 289C,A01,507361,Daly; Alan J.,18,0,18,0
1715601813655,EDS 290,A00,507366,Hofstetter; Carolyn,15,0,15,0
1715601814686,LIGM 5A,A00,507421,Fischer-Grunski; Eva K,17,0,20,3
1715601815713,LIGM 5B,A00,507423,Fischer-Grunski; Eva K,19,0,20,1
1715601816739,LIGM 5C,A00,507425,Fischer-Grunski; Eva K,19,0,20,1
1715601817764,LIIT 5AS,A00,507427,Carnelos; Chiara,20,0,20,0
1715601818794,LIIT 5BS,A00,507430,Carnelos; Chiara,20,0,20,0
1715601819821,LIIT 5CS,A00,507432,Carnelos; Chiara,20,0,20,0
1715601820854,LISP 5A,A00,507541,Munoz Sanchez; Alicia,11,0,20,9
1715601821884,LISP 5B,A00,507671,Munoz Sanchez; Alicia,9,0,20,11
1715601822915,LISP 5C,A00,507696,Munoz Sanchez; Alicia,9,0,20,11
1715601823955,MAE 197,001,528363,Boechler; Nicholas Sebastia,9998,0,9999,1
1715601824985,MATH 197,001,523477,Kedlaya; Kiran S.,9994,0,9999,5
1715601824985,MATH 197,002,563811,Zhang; Danna,9994,0,9999,5
1715601824985,MATH 197,003,628552,Dumitriu; Ioana,9998,0,9999,1
1715601824985,MATH 197,004,660885,Floyd; Eric,9999,0,9999,0
1715601826014,MCWP 40R,A00,518780,Staff,2,0,20,18
1715601826014,MCWP 40R,B00,518781,Staff,11,0,20,9
1715601826014,MCWP 40R,C00,518783,Staff,5,0,20,15
1715601827040,MCWP 50R,A00,518791,Staff,0,1,20,20
1715601827040,MCWP 50R,B00,518792,Staff,0,2,20,20
1715601827040,MCWP 50R,C00,518793,Staff,0,4,20,20
1715601827040,MCWP 50R,D00,518794,Staff,0,1,20,20
1715601827040,MCWP 50R,E00,518795,Staff,0,2,20,20
1715601827040,MCWP 50R,F00,518796,Staff,0,1,20,20
1715601827040,MCWP 50R,G00,518797,Staff,0,1,20,20
1715601828066,MMW 12R,A01,514034,Herbst; Matthew,0,2,16,16
1715601828066,MMW 12R,A02,514035,Herbst; Matthew,0,0,16,16
1715601829096,MMW 13R,A01,514037,Staff,0,5,16,16
1715601829096,MMW 13R,A02,514039,Staff,0,5,16,16
1715601829096,MMW 13R,A03,628519,Staff,0,4,16,16
1715601831151,SIO 295LS,A00,523233,Staff,10,0,30,20
1715601832177,SIO 295S,A00,523232,Staff,10,0,30,20
1715601833205,SIOC 290S,A01,637330,Merrifield; Mark A,23,0,30,7
1715601834238,SIOC 291S,A01,637333,Gabriel; Corey John,23,0,30,7
1715601835275,SOCI 117,A01,494376,Staff,0,5,5,5
1715601836302,WES 237B,A00,494380,Staff,10,0,20,10
1715601838392,AESE 279B,A00,494370,Wade; Jon P,0,0,33,33
1715601839417,AIP 97,001,660915,Van Den Einde; Yael Dahlia,9999,0,9999,0
1715601840448,AIP 197,001,627712,Vespa; Emanuel Ignacio,9995,0,9999,4
1715601840448,AIP 197,002,650778,Amir; On,9998,0,9999,1
1715601840448,AIP 197,003,650933,Avenancio-Leon; Carlos,9998,0,9999,1
1715601840448,AIP 197,004,658530,Heyman; Gail D.,9998,0,9999,1
1715601840448,AIP 197,005,658631,Neal; Sonya E,9998,0,9999,1
1715601840448,AIP 197,006,658671,Du; Songzi,9998,0,9999,1
1715601841478,ANAR 135S,A00,494369,Braswell; Geoffrey E.,0,0,0,0
1715601842505,BENG 196,001,628496,Engler; Adam J.,9998,0,9999,1
1715601842505,BENG 196,002,660916,Watson; John Thomas,9999,0,9999,0
1715601843533,BISP 197,001,650773,Wilhelm; James E.,9994,0,9999,5
1715601843533,BISP 197,002,658904,Coleman; Aaron B.,9998,0,9999,1
1715601844560,CAT 124RS,A01,519847,Geibel; William,0,0,20,20
1715601845587,CAT 125RS,A01,515971,Geibel; William,0,0,20,20
1715601846613,CLRE 250,A00,511389,Morris; Sheldon,9992,0,9999,7
1715601847647,CLRE 251,A00,507176,Mehta; Ravindra L.,9992,0,9999,7
1715601847647,CLRE 251,B00,511410,Mehta; Ravindra L.,9998,0,9999,1
1715601848677,CLRE 252,A00,507189,Cuomo; Raphael Eduardo,9994,0,9999,5
1715601849708,CLRE 253,A00,507199,Vaida; Florin,9994,0,9999,5
1715601849708,CLRE 253,B00,507202,Vaida; Florin,9999,0,9999,0
1715601850738,CLRE 259,A00,507211,Patel; Hemal,9996,0,9999,3
1715601851764,CLRE 260,A00,507221,Cuomo; Raphael Eduardo,9999,0,9999,0
1715601852790,CLRE 297,001,507242,Cuomo; Raphael Eduardo,9999,0,9999,0
1715601853816,COGS 197,001,638244,Voytek; Bradley Thomas,9997,0,9999,2
1715601854848,CSE 191,A00,516875,Minnes Kemp; Mor Mia,9991,0,9999,8
1715601855873,CSE 197,001,637388,Minnes Kemp; Mor Mia,9992,0,9999,7
1715601856902,CSS 201S,A01,494383,Mignozzetti; Umberto,35,0,35,0
1715601857930,CSS 202S,A01,494387,Mignozzetti; Umberto,35,0,35,0
1715601858956,DSC 197,001,628532,Eldridge; Justin Matthew,9995,0,9999,4
1715601859982,EAP 100,A00,516065,Staff,9799,0,9999,200
1715601861012,ECE 45,A01,507414,Staff,31,0,60,29
1715601863067,ECE 111,A01,507420,Staff,11,0,50,39
1715601864092,ECE 197,001,548057,Sievenpiper; Daniel F.,9991,0,9999,8
1715601865125,EDS 115,A00,507243,Choi; Bailey Miyeon,7,0,28,21
1715601866154,EDS 117,A01,494379,Staff,0,6,34,34
1715601867185,EDS 125,A00,507246,Hopkins; Megan Beth,8,0,30,22
1715601868216,EDS 128A,A01,507264,Fargason; Sharon Gayle,6,0,26,20
1715601869248,EDS 128B,A01,507293,Pappas; Elizabeth,10,0,30,20
1715601870277,EDS 139,A00,507294,Fargason; Sharon Gayle,10,0,30,20
1715601870277,EDS 139,B00,507313,Pappas; Elizabeth,11,0,30,19
1715601871306,EDS 201,A00,507315,Staff,10,0,30,20
1715601872333,EDS 203,A01,507317,Halter; Christopher P.,10,0,30,20
1715601873372,EDS 204R,A01,507319,Halter; Christopher P.,0,3,30,30
1715601873372,EDS 204R,B01,507331,Heinzman; Erica M.,14,0,30,16
1715601874399,EDS 206R,A00,507332,Staff,0,4,30,30
1715601874399,EDS 206R,B00,507343,Staff,15,0,30,15
1715601875429,EDS 250,A00,507344,Hemans; Patricia Ann Benitez,20,0,40,20
1715601876454,EDS 281,A00,507345,Daly; Alan J.,18,0,18,0
1715601877483,EDS 284,A00,507350,Daly; Alan J.,16,0,16,0
1715601878521,EDS 286,A00,507359,Fine; Sarah,18,0,18,0
1715601879544,EDS 289C,A01,507361,Daly; Alan J.,18,0,18,0
1715601880575,EDS 290,A00,507366,Hofstetter; Carolyn,15,0,15,0
1715601881603,LIGM 5A,A00,507421,Fischer-Grunski; Eva K,17,0,20,3
1715601882628,LIGM 5B,A00,507423,Fischer-Grunski; Eva K,19,0,20,1
1715601883657,LIGM 5C,A00,507425,Fischer-Grunski; Eva K,19,0,20,1
1715601884691,LIIT 5AS,A00,507427,Carnelos; Chiara,20,0,20,0
1715601885722,LIIT 5BS,A00,507430,Carnelos; Chiara,20,0,20,0
1715601886749,LIIT 5CS,A00,507432,Carnelos; Chiara,20,0,20,0
1715601887776,LISP 5A,A00,507541,Munoz Sanchez; Alicia,11,0,20,9
1715601888808,LISP 5B,A00,507671,Munoz Sanchez; Alicia,9,0,20,11
1715601889838,LISP 5C,A00,507696,Munoz Sanchez; Alicia,9,0,20,11
1715601890864,MAE 197,001,528363,Boechler; Nicholas Sebastia,9998,0,9999,1
1715601891919,MATH 197,001,523477,Kedlaya; Kiran S.,9994,0,9999,5
1715601891919,MATH 197,002,563811,Zhang; Danna,9994,0,9999,5
1715601891919,MATH 197,003,628552,Dumitriu; Ioana,9998,0,9999,1
1715601891919,MATH 197,004,660885,Floyd; Eric,9999,0,9999,0
1715601892947,MCWP 40R,A00,518780,Staff,2,0,20,18
1715601892947,MCWP 40R,B00,518781,Staff,11,0,20,9
1715601892947,MCWP 40R,C00,518783,Staff,5,0,20,15
1715601893989,MCWP 50R,A00,518791,Staff,0,1,20,20
1715601893989,MCWP 50R,B00,518792,Staff,0,2,20,20
1715601893989,MCWP 50R,C00,518793,Staff,0,4,20,20
1715601893989,MCWP 50R,D00,518794,Staff,0,1,20,20
1715601893989,MCWP 50R,E00,518795,Staff,0,2,20,20
1715601893989,MCWP 50R,F00,518796,Staff,0,1,20,20
1715601893989,MCWP 50R,G00,518797,Staff,0,1,20,20
1715601895016,MMW 12R,A01,514034,Herbst; Matthew,0,2,16,16
1715601895016,MMW 12R,A02,514035,Herbst; Matthew,0,0,16,16
1715601896043,MMW 13R,A01,514037,Staff,0,5,16,16
1715601896043,MMW 13R,A02,514039,Staff,0,5,16,16
1715601896043,MMW 13R,A03,628519,Staff,0,4,16,16
1715601898095,SIO 295LS,A00,523233,Staff,10,0,30,20
1715601899124,SIO 295S,A00,523232,Staff,10,0,30,20
1715601900163,SIOC 290S,A01,637330,Merrifield; Mark A,23,0,30,7
1715601901190,SIOC 291S,A01,637333,Gabriel; Corey John,23,0,30,7
1715601902217,SOCI 117,A01,494376,Staff,0,5,5,5
1715601903245,WES 237B,A00,494380,Staff,10,0,20,10
1715601905325,AESE 279B,A00,494370,Wade; Jon P,0,0,33,33
1715601906359,AIP 97,001,660915,Van Den Einde; Yael Dahlia,9999,0,9999,0
1715601907397,AIP 197,001,627712,Vespa; Emanuel Ignacio,9995,0,9999,4
1715601907397,AIP 197,002,650778,Amir; On,9998,0,9999,1
1715601907397,AIP 197,003,650933,Avenancio-Leon; Carlos,9998,0,9999,1
1715601907397,AIP 197,004,658530,Heyman; Gail D.,9998,0,9999,1
1715601907397,AIP 197,005,658631,Neal; Sonya E,9998,0,9999,1
1715601907397,AIP 197,006,658671,Du; Songzi,9998,0,9999,1
1715601908424,ANAR 135S,A00,494369,Braswell; Geoffrey E.,0,0,0,0
1715601909451,BENG 196,001,628496,Engler; Adam J.,9998,0,9999,1
1715601909451,BENG 196,002,660916,Watson; John Thomas,9999,0,9999,0
1715601910480,BISP 197,001,650773,Wilhelm; James E.,9994,0,9999,5
1715601910480,BISP 197,002,658904,Coleman; Aaron B.,9998,0,9999,1
1715601911509,CAT 124RS,A01,519847,Geibel; William,0,0,20,20
1715601912537,CAT 125RS,A01,515971,Geibel; William,0,0,20,20
1715601913565,CLRE 250,A00,511389,Morris; Sheldon,9992,0,9999,7
1715601914593,CLRE 251,A00,507176,Mehta; Ravindra L.,9992,0,9999,7
1715601914593,CLRE 251,B00,511410,Mehta; Ravindra L.,9998,0,9999,1
1715601915632,CLRE 252,A00,507189,Cuomo; Raphael Eduardo,9994,0,9999,5
1715601916660,CLRE 253,A00,507199,Vaida; Florin,9994,0,9999,5
1715601916660,CLRE 253,B00,507202,Vaida; Florin,9999,0,9999,0
1715601917688,CLRE 259,A00,507211,Patel; Hemal,9996,0,9999,3
1715601918718,CLRE 260,A00,507221,Cuomo; Raphael Eduardo,9999,0,9999,0
1715601919746,CLRE 297,001,507242,Cuomo; Raphael Eduardo,9999,0,9999,0
1715601920773,COGS 197,001,638244,Voytek; Bradley Thomas,9997,0,9999,2
1715601921800,CSE 191,A00,516875,Minnes Kemp; Mor Mia,9991,0,9999,8
1715601922826,CSE 197,001,637388,Minnes Kemp; Mor Mia,9992,0,9999,7
1715601923855,CSS 201S,A01,494383,Mignozzetti; Umberto,35,0,35,0
1715601924880,CSS 202S,A01,494387,Mignozzetti; Umberto,35,0,35,0
1715601925906,DSC 197,001,628532,Eldridge; Justin Matthew,9995,0,9999,4
1715601926935,EAP 100,A00,516065,Staff,9799,0,9999,200
1715601927973,ECE 45,A01,507414,Staff,31,0,60,29
1715601930029,ECE 111,A01,507420,Staff,11,0,50,39
1715601931062,ECE 197,001,548057,Sievenpiper; Daniel F.,9991,0,9999,8
1715601932091,EDS 115,A00,507243,Choi; Bailey Miyeon,7,0,28,21
1715601933126,EDS 117,A01,494379,Staff,0,6,34,34
1715601934159,EDS 125,A00,507246,Hopkins; Megan Beth,8,0,30,22
1715601935186,EDS 128A,A01,507264,Fargason; Sharon Gayle,6,0,26,20
1715601936211,EDS 128B,A01,507293,Pappas; Elizabeth,10,0,30,20
1715601937240,EDS 139,A00,507294,Fargason; Sharon Gayle,10,0,30,20
1715601937240,EDS 139,B00,507313,Pappas; Elizabeth,11,0,30,19
1715601938266,EDS 201,A00,507315,Staff,10,0,30,20
1715601939293,EDS 203,A01,507317,Halter; Christopher P.,10,0,30,20
1715601940332,EDS 204R,A01,507319,Halter; Christopher P.,0,3,30,30
1715601940332,EDS 204R,B01,507331,Heinzman; Erica M.,14,0,30,16
1715601941362,EDS 206R,A00,507332,Staff,0,4,30,30
1715601941362,EDS 206R,B00,507343,Staff,15,0,30,15
1715601942390,EDS 250,A00,507344,Hemans; Patricia Ann Benitez,20,0,40,20
1715601943417,EDS 281,A00,507345,Daly; Alan J.,18,0,18,0
1715601944449,EDS 284,A00,507350,Daly; Alan J.,16,0,16,0
1715601945477,EDS 286,A00,507359,Fine; Sarah,18,0,18,0
1715601946505,EDS 289C,A01,507361,Daly; Alan J.,18,0,18,0
1715601947532,EDS 290,A00,507366,Hofstetter; Carolyn,15,0,15,0
1715601948568,LIGM 5A,A00,507421,Fischer-Grunski; Eva K,17,0,20,3
1715601949596,LIGM 5B,A00,507423,Fischer-Grunski; Eva K,19,0,20,1
1715601950638,LIGM 5C,A00,507425,Fischer-Grunski; Eva K,19,0,20,1
1715601951693,LIIT 5AS,A00,507427,Carnelos; Chiara,20,0,20,0
1715601952720,LIIT 5BS,A00,507430,Carnelos; Chiara,20,0,20,0
1715601953757,LIIT 5CS,A00,507432,Carnelos; Chiara,20,0,20,0
1715601954785,LISP 5A,A00,507541,Munoz Sanchez; Alicia,11,0,20,9
1715601955815,LISP 5B,A00,507671,Munoz Sanchez; Alicia,9,0,20,11
1715601956840,LISP 5C,A00,507696,Munoz Sanchez; Alicia,9,0,20,11
1715601957868,MAE 197,001,528363,Boechler; Nicholas Sebastia,9998,0,9999,1
1715601958912,MATH 197,001,523477,Kedlaya; Kiran S.,9994,0,9999,5
1715601958912,MATH 197,002,563811,Zhang; Danna,9994,0,9999,5
1715601958912,MATH 197,003,628552,Dumitriu; Ioana,9998,0,9999,1
1715601958912,MATH 197,004,660885,Floyd; Eric,9999,0,9999,0
1715601959940,MCWP 40R,A00,518780,Staff,2,0,20,18
1715601959940,MCWP 40R,B00,518781,Staff,11,0,20,9
1715601959940,MCWP 40R,C00,518783,Staff,5,0,20,15
1715601960968,MCWP 50R,A00,518791,Staff,0,1,20,20
1715601960968,MCWP 50R,B00,518792,Staff,0,2,20,20
1715601960968,MCWP 50R,C00,518793,Staff,0,4,20,20
1715601960968,MCWP 50R,D00,518794,Staff,0,1,20,20
1715601960968,MCWP 50R,E00,518795,Staff,0,2,20,20
1715601960968,MCWP 50R,F00,518796,Staff,0,1,20,20
1715601960968,MCWP 50R,G00,518797,Staff,0,1,20,20
1715601962003,MMW 12R,A01,514034,Herbst; Matthew,0,2,16,16
1715601962003,MMW 12R,A02,514035,Herbst; Matthew,0,0,16,16
1715601963041,MMW 13R,A01,514037,Staff,0,5,16,16
1715601963041,MMW 13R,A02,514039,Staff,0,5,16,16
1715601963041,MMW 13R,A03,628519,Staff,0,4,16,16
1715601965098,SIO 295LS,A00,523233,Staff,10,0,30,20
1715601966128,SIO 295S,A00,523232,Staff,10,0,30,20
1715601967162,SIOC 290S,A01,637330,Merrifield; Mark A,23,0,30,7
1715601968194,SIOC 291S,A01,637333,Gabriel; Corey John,23,0,30,7
1715601969224,SOCI 117,A01,494376,Staff,0,5,5,5
1715601970255,WES 237B,A00,494380,Staff,10,0,20,10
1715601972335,AESE 279B,A00,494370,Wade; Jon P,0,0,33,33
1715601973366,AIP 97,001,660915,Van Den Einde; Yael Dahlia,9999,0,9999,0
1715601974403,AIP 197,001,627712,Vespa; Emanuel Ignacio,9995,0,9999,4
1715601974403,AIP 197,002,650778,Amir; On,9998,0,9999,1
1715601974403,AIP 197,003,650933,Avenancio-Leon; Carlos,9998,0,9999,1
1715601974403,AIP 197,004,658530,Heyman; Gail D.,9998,0,9999,1
1715601974403,AIP 197,005,658631,Neal; Sonya E,9998,0,9999,1
1715601974403,AIP 197,006,658671,Du; Songzi,9998,0,9999,1
1715601975433,ANAR 135S,A00,494369,Braswell; Geoffrey E.,0,0,0,0
1715601976468,BENG 196,001,628496,Engler; Adam J.,9998,0,9999,1
1715601976468,BENG 196,002,660916,Watson; John Thomas,9999,0,9999,0
1715601977496,BISP 197,001,650773,Wilhelm; James E.,9994,0,9999,5
1715601977496,BISP 197,002,658904,Coleman; Aaron B.,9998,0,9999,1
1715601978528,CAT 124RS,A01,519847,Geibel; William,0,0,20,20
1715601979556,CAT 125RS,A01,515971,Geibel; William,0,0,20,20
1715601980587,CLRE 250,A00,511389,Morris; Sheldon,9992,0,9999,7
1715601981623,CLRE 251,A00,507176,Mehta; Ravindra L.,9992,0,9999,7
1715601981623,CLRE 251,B00,511410,Mehta; Ravindra L.,9998,0,9999,1
1715601982655,CLRE 252,A00,507189,Cuomo; Raphael Eduardo,9994,0,9999,5
1715601983690,CLRE 253,A00,507199,Vaida; Florin,9994,0,9999,5
1715601983690,CLRE 253,B00,507202,Vaida; Florin,9999,0,9999,0
1715601984721,CLRE 259,A00,507211,Patel; Hemal,9996,0,9999,3
1715601985753,CLRE 260,A00,507221,Cuomo; Raphael Eduardo,9999,0,9999,0
1715601986783,CLRE 297,001,507242,Cuomo; Raphael Eduardo,9999,0,9999,0
1715601987817,COGS 197,001,638244,Voytek; Bradley Thomas,9997,0,9999,2
1715601988843,CSE 191,A00,516875,Minnes Kemp; Mor Mia,9991,0,9999,8
1715601989874,CSE 197,001,637388,Minnes Kemp; Mor Mia,9992,0,9999,7
1715601990907,CSS 201S,A01,494383,Mignozzetti; Umberto,35,0,35,0
1715601991935,CSS 202S,A01,494387,Mignozzetti; Umberto,35,0,35,0
1715601992963,DSC 197,001,628532,Eldridge; Justin Matthew,9995,0,9999,4
1715601993993,EAP 100,A00,516065,Staff,9799,0,9999,200
1715601995032,ECE 45,A01,507414,Staff,31,0,60,29
1715601997085,ECE 111,A01,507420,Staff,11,0,50,39
1715601998114,ECE 197,001,548057,Sievenpiper; Daniel F.,9991,0,9999,8
1715601999144,EDS 115,A00,507243,Choi; Bailey Miyeon,7,0,28,21
1715602000178,EDS 117,A01,494379,Staff,0,6,34,34
1715602001208,EDS 125,A00,507246,Hopkins; Megan Beth,8,0,30,22
1715602002236,EDS 128A,A01,507264,Fargason; Sharon Gayle,6,0,26,20
1715602003269,EDS 128B,A01,507293,Pappas; Elizabeth,10,0,30,20
1715602004298,EDS 139,A00,507294,Fargason; Sharon Gayle,10,0,30,20
1715602004298,EDS 139,B00,507313,Pappas; Elizabeth,11,0,30,19
1715602005328,EDS 201,A00,507315,Staff,10,0,30,20
1715602006362,EDS 203,A01,507317,Halter; Christopher P.,10,0,30,20
1715602007393,EDS 204R,A01,507319,Halter; Christopher P.,0,3,30,30
1715602007393,EDS 204R,B01,507331,Heinzman; Erica M.,14,0,30,16
1715602008425,EDS 206R,A00,507332,Staff,0,4,30,30
1715602008425,EDS 206R,B00,507343,Staff,15,0,30,15
1715602009456,EDS 250,A00,507344,Hemans; Patricia Ann Benitez,20,0,40,20
1715602010489,EDS 281,A00,507345,Daly; Alan J.,18,0,18,0
1715602011517,EDS 284,A00,507350,Daly; Alan J.,16,0,16,0
1715602012542,EDS 286,A00,507359,Fine; Sarah,18,0,18,0
1715602013572,EDS 289C,A01,507361,Daly; Alan J.,18,0,18,0
1715602014603,EDS 290,A00,507366,Hofstetter; Carolyn,15,0,15,0
1715602015632,LIGM 5A,A00,507421,Fischer-Grunski; Eva K,17,0,20,3
1715602016663,LIGM 5B,A00,507423,Fischer-Grunski; Eva K,19,0,20,1
1715602017691,LIGM 5C,A00,507425,Fischer-Grunski; Eva K,19,0,20,1
1715602018723,LIIT 5AS,A00,507427,Carnelos; Chiara,20,0,20,0
1715602019752,LIIT 5BS,A00,507430,Carnelos; Chiara,20,0,20,0
1715602020785,LIIT 5CS,A00,507432,Carnelos; Chiara,20,0,20,0
1715602021812,LISP 5A,A00,507541,Munoz Sanchez; Alicia,11,0,20,9
1715602022839,LISP 5B,A00,507671,Munoz Sanchez; Alicia,9,0,20,11
1715602023864,LISP 5C,A00,507696,Munoz Sanchez; Alicia,9,0,20,11
1715602024894,MAE 197,001,528363,Boechler; Nicholas Sebastia,9998,0,9999,1
1715602025932,MATH 197,001,523477,Kedlaya; Kiran S.,9994,0,9999,5
1715602025932,MATH 197,002,563811,Zhang; Danna,9994,0,9999,5
1715602025932,MATH 197,003,628552,Dumitriu; Ioana,9998,0,9999,1
1715602025932,MATH 197,004,660885,Floyd; Eric,9999,0,9999,0
1715602026961,MCWP 40R,A00,518780,Staff,2,0,20,18
1715602026961,MCWP 40R,B00,518781,Staff,11,0,20,9
1715602026961,MCWP 40R,C00,518783,Staff,5,0,20,15
1715602027989,MCWP 50R,A00,518791,Staff,0,1,20,20
1715602027989,MCWP 50R,B00,518792,Staff,0,2,20,20
1715602027989,MCWP 50R,C00,518793,Staff,0,4,20,20
1715602027989,MCWP 50R,D00,518794,Staff,0,1,20,20
1715602027989,MCWP 50R,E00,518795,Staff,0,2,20,20
1715602027989,MCWP 50R,F00,518796,Staff,0,1,20,20
1715602027989,MCWP 50R,G00,518797,Staff,0,1,20,20
1715602029017,MMW 12R,A01,514034,Herbst; Matthew,0,2,16,16
1715602029017,MMW 12R,A02,514035,Herbst; Matthew,0,0,16,16
1715602030044,MMW 13R,A01,514037,Staff,0,5,16,16
1715602030044,MMW 13R,A02,514039,Staff,0,5,16,16
1715602030044,MMW 13R,A03,628519,Staff,0,4,16,16
1715602032100,SIO 295LS,A00,523233,Staff,10,0,30,20
1715602033127,SIO 295S,A00,523232,Staff,10,0,30,20
1715602034156,SIOC 290S,A01,637330,Merrifield; Mark A,23,0,30,7
1715602035183,SIOC 291S,A01,637333,Gabriel; Corey John,23,0,30,7
1715602036214,SOCI 117,A01,494376,Staff,0,5,5,5
1715602037241,WES 237B,A00,494380,Staff,10,0,20,10
1715602039324,AESE 279B,A00,494370,Wade; Jon P,0,0,33,33
1715602040351,AIP 97,001,660915,Van Den Einde; Yael Dahlia,9999,0,9999,0
1715602041381,AIP 197,001,627712,Vespa; Emanuel Ignacio,9995,0,9999,4
1715602041381,AIP 197,002,650778,Amir; On,9998,0,9999,1
1715602041381,AIP 197,003,650933,Avenancio-Leon; Carlos,9998,0,9999,1
1715602041381,AIP 197,004,658530,Heyman; Gail D.,9998,0,9999,1
1715602041381,AIP 197,005,658631,Neal; Sonya E,9998,0,9999,1
1715602041381,AIP 197,006,658671,Du; Songzi,9998,0,9999,1
1715602042411,ANAR 135S,A00,494369,Braswell; Geoffrey E.,0,0,0,0
1715602043442,BENG 196,001,628496,Engler; Adam J.,9998,0,9999,1
1715602043442,BENG 196,002,660916,Watson; John Thomas,9999,0,9999,0
1715602044474,BISP 197,001,650773,Wilhelm; James E.,9994,0,9999,5
1715602044474,BISP 197,002,658904,Coleman; Aaron B.,9998,0,9999,1
1715602045503,CAT 124RS,A01,519847,Geibel; William,0,0,20,20
1715602046529,CAT 125RS,A01,515971,Geibel; William,0,0,20,20
1715602047558,CLRE 250,A00,511389,Morris; Sheldon,9992,0,9999,7
1715602048588,CLRE 251,A00,507176,Mehta; Ravindra L.,9992,0,9999,7
1715602048588,CLRE 251,B00,511410,Mehta; Ravindra L.,9998,0,9999,1
1715602049619,CLRE 252,A00,507189,Cuomo; Raphael Eduardo,9994,0,9999,5
1715602050646,CLRE 253,A00,507199,Vaida; Florin,9994,0,9999,5
1715602050646,CLRE 253,B00,507202,Vaida; Florin,9999,0,9999,0
1715602051672,CLRE 259,A00,507211,Patel; Hemal,9996,0,9999,3
1715602052699,CLRE 260,A00,507221,Cuomo; Raphael Eduardo,9999,0,9999,0
1715602053726,CLRE 297,001,507242,Cuomo; Raphael Eduardo,9999,0,9999,0
1715602054757,COGS 197,001,638244,Voytek; Bradley Thomas,9997,0,9999,2
1715602055786,CSE 191,A00,516875,Minnes Kemp; Mor Mia,9991,0,9999,8
1715602056812,CSE 197,001,637388,Minnes Kemp; Mor Mia,9992,0,9999,7
1715602057849,CSS 201S,A01,494383,Mignozzetti; Umberto,35,0,35,0
1715602058877,CSS 202S,A01,494387,Mignozzetti; Umberto,35,0,35,0
1715602059904,DSC 197,001,628532,Eldridge; Justin Matthew,9995,0,9999,4
1715602060989,EAP 100,A00,516065,Staff,9799,0,9999,200
1715602062017,ECE 45,A01,507414,Staff,31,0,60,29
1715602064074,ECE 111,A01,507420,Staff,11,0,50,39
1715602065108,ECE 197,001,548057,Sievenpiper; Daniel F.,9991,0,9999,8
1715602066139,EDS 115,A00,507243,Choi; Bailey Miyeon,7,0,28,21
1715602067168,EDS 117,A01,494379,Staff,0,6,34,34
1715602068196,EDS 125,A00,507246,Hopkins; Megan Beth,8,0,30,22
1715602069224,EDS 128A,A01,507264,Fargason; Sharon Gayle,6,0,26,20
1715602070251,EDS 128B,A01,507293,Pappas; Elizabeth,10,0,30,20
1715602071277,EDS 139,A00,507294,Fargason; Sharon Gayle,10,0,30,20
1715602071277,EDS 139,B00,507313,Pappas; Elizabeth,11,0,30,19
1715602072308,EDS 201,A00,507315,Staff,10,0,30,20
1715602073340,EDS 203,A01,507317,Halter; Christopher P.,10,0,30,20
1715602074368,EDS 204R,A01,507319,Halter; Christopher P.,0,3,30,30
1715602074368,EDS 204R,B01,507331,Heinzman; Erica M.,14,0,30,16
1715602075393,EDS 206R,A00,507332,Staff,0,4,30,30
1715602075393,EDS 206R,B00,507343,Staff,15,0,30,15
1715602076426,EDS 250,A00,507344,Hemans; Patricia Ann Benitez,20,0,40,20
1715602077457,EDS 281,A00,507345,Daly; Alan J.,18,0,18,0
1715602078483,EDS 284,A00,507350,Daly; Alan J.,16,0,16,0
1715602079510,EDS 286,A00,507359,Fine; Sarah,18,0,18,0
1715602080542,EDS 289C,A01,507361,Daly; Alan J.,18,0,18,0
1715602081575,EDS 290,A00,507366,Hofstetter; Carolyn,15,0,15,0
1715602082609,LIGM 5A,A00,507421,Fischer-Grunski; Eva K,17,0,20,3
1715602083636,LIGM 5B,A00,507423,Fischer-Grunski; Eva K,19,0,20,1
1715602084661,LIGM 5C,A00,507425,Fischer-Grunski; Eva K,19,0,20,1
1715602085689,LIIT 5AS,A00,507427,Carnelos; Chiara,20,0,20,0
1715602086715,LIIT 5BS,A00,507430,Carnelos; Chiara,20,0,20,0
1715602087745,LIIT 5CS,A00,507432,Carnelos; Chiara,20,0,20,0
1715602088774,LISP 5A,A00,507541,Munoz Sanchez; Alicia,11,0,20,9
1715602089804,LISP 5B,A00,507671,Munoz Sanchez; Alicia,9,0,20,11
1715602090831,LISP 5C,A00,507696,Munoz Sanchez; Alicia,9,0,20,11
1715602091858,MAE 197,001,528363,Boechler; Nicholas Sebastia,9998,0,9999,1
1715602092887,MATH 197,001,523477,Kedlaya; Kiran S.,9994,0,9999,5
1715602092887,MATH 197,002,563811,Zhang; Danna,9994,0,9999,5
1715602092887,MATH 197,003,628552,Dumitriu; Ioana,9998,0,9999,1
1715602092887,MATH 197,004,660885,Floyd; Eric,9999,0,9999,0
1715602093916,MCWP 40R,A00,518780,Staff,2,0,20,18
1715602093916,MCWP 40R,B00,518781,Staff,11,0,20,9
1715602093916,MCWP 40R,C00,518783,Staff,5,0,20,15
1715602094947,MCWP 50R,A00,518791,Staff,0,1,20,20
1715602094947,MCWP 50R,B00,518792,Staff,0,2,20,20
1715602094947,MCWP 50R,C00,518793,Staff,0,4,20,20
1715602094947,MCWP 50R,D00,518794,Staff,0,1,20,20
1715602094947,MCWP 50R,E00,518795,Staff,0,2,20,20
1715602094947,MCWP 50R,F00,518796,Staff,0,1,20,20
1715602094947,MCWP 50R,G00,518797,Staff,0,1,20,20
1715602095978,MMW 12R,A01,514034,Herbst; Matthew,0,2,16,16
1715602095978,MMW 12R,A02,514035,Herbst; Matthew,0,0,16,16
1715602097005,MMW 13R,A01,514037,Staff,0,5,16,16
1715602097005,MMW 13R,A02,514039,Staff,0,5,16,16
1715602097005,MMW 13R,A03,628519,Staff,0,4,16,16
1715602099055,SIO 295LS,A00,523233,Staff,10,0,30,20
1715602100081,SIO 295S,A00,523232,Staff,10,0,30,20
1715602101112,SIOC 290S,A01,637330,Merrifield; Mark A,23,0,30,7
1715602102141,SIOC 291S,A01,637333,Gabriel; Corey John,23,0,30,7
1715602103168,SOCI 117,A01,494376,Staff,0,5,5,5
1715602104192,WES 237B,A00,494380,Staff,10,0,20,10
1715602106275,AESE 279B,A00,494370,Wade; Jon P,0,0,33,33
1715602107301,AIP 97,001,660915,Van Den Einde; Yael Dahlia,9999,0,9999,0
1715602108330,AIP 197,001,627712,Vespa; Emanuel Ignacio,9995,0,9999,4
1715602108330,AIP 197,002,650778,Amir; On,9998,0,9999,1
1715602108330,AIP 197,003,650933,Avenancio-Leon; Carlos,9998,0,9999,1
1715602108330,AIP 197,004,658530,Heyman; Gail D.,9998,0,9999,1
1715602108330,AIP 197,005,658631,Neal; Sonya E,9998,0,9999,1
1715602108330,AIP 197,006,658671,Du; Songzi,9998,0,9999,1
1715602109357,ANAR 135S,A00,494369,Braswell; Geoffrey E.,0,0,0,0
1715602110384,BENG 196,001,628496,Engler; Adam J.,9998,0,9999,1
1715602110384,BENG 196,002,660916,Watson; John Thomas,9999,0,9999,0
1715602111415,BISP 197,001,650773,Wilhelm; James E.,9994,0,9999,5
1715602111415,BISP 197,002,658904,Coleman; Aaron B.,9998,0,9999,1
1715602112440,CAT 124RS,A01,519847,Geibel; William,0,0,20,20
1715602113470,CAT 125RS,A01,515971,Geibel; William,0,0,20,20
1715602114499,CLRE 250,A00,511389,Morris; Sheldon,9992,0,9999,7
1715602115533,CLRE 251,A00,507176,Mehta; Ravindra L.,9992,0,9999,7
1715602115533,CLRE 251,B00,511410,Mehta; Ravindra L.,9998,0,9999,1
1715602116559,CLRE 252,A00,507189,Cuomo; Raphael Eduardo,9994,0,9999,5
1715602117593,CLRE 253,A00,507199,Vaida; Florin,9994,0,9999,5
1715602117593,CLRE 253,B00,507202,Vaida; Florin,9999,0,9999,0
1715602118623,CLRE 259,A00,507211,Patel; Hemal,9996,0,9999,3
1715602119663,CLRE 260,A00,507221,Cuomo; Raphael Eduardo,9999,0,9999,0
1715602120687,CLRE 297,001,507242,Cuomo; Raphael Eduardo,9999,0,9999,0
1715602121720,COGS 197,001,638244,Voytek; Bradley Thomas,9997,0,9999,2
1715602122749,CSE 191,A00,516875,Minnes Kemp; Mor Mia,9991,0,9999,8
1715602123779,CSE 197,001,637388,Minnes Kemp; Mor Mia,9992,0,9999,7
1715602124813,CSS 201S,A01,494383,Mignozzetti; Umberto,35,0,35,0
1715602125840,CSS 202S,A01,494387,Mignozzetti; Umberto,35,0,35,0
1715602126875,DSC 197,001,628532,Eldridge; Justin Matthew,9995,0,9999,4
1715602127902,EAP 100,A00,516065,Staff,9799,0,9999,200
1715602128933,ECE 45,A01,507414,Staff,31,0,60,29
1715602130989,ECE 111,A01,507420,Staff,11,0,50,39
1715602132018,ECE 197,001,548057,Sievenpiper; Daniel F.,9991,0,9999,8
1715602133051,EDS 115,A00,507243,Choi; Bailey Miyeon,7,0,28,21
1715602134083,EDS 117,A01,494379,Staff,0,6,34,34
1715602135111,EDS 125,A00,507246,Hopkins; Megan Beth,8,0,30,22
1715602136137,EDS 128A,A01,507264,Fargason; Sharon Gayle,6,0,26,20
1715602137168,EDS 128B,A01,507293,Pappas; Elizabeth,10,0,30,20
1715602138196,EDS 139,A00,507294,Fargason; Sharon Gayle,10,0,30,20
1715602138196,EDS 139,B00,507313,Pappas; Elizabeth,11,0,30,19
1715602139222,EDS 201,A00,507315,Staff,10,0,30,20
1715602140254,EDS 203,A01,507317,Halter; Christopher P.,10,0,30,20
1715602141287,EDS 204R,A01,507319,Halter; Christopher P.,0,3,30,30
1715602141287,EDS 204R,B01,507331,Heinzman; Erica M.,14,0,30,16
1715602142317,EDS 206R,A00,507332,Staff,0,4,30,30
1715602142317,EDS 206R,B00,507343,Staff,15,0,30,15
1715602143347,EDS 250,A00,507344,Hemans; Patricia Ann Benitez,20,0,40,20
1715602144375,EDS 281,A00,507345,Daly; Alan J.,18,0,18,0
1715602145407,EDS 284,A00,507350,Daly; Alan J.,16,0,16,0
1715602146436,EDS 286,A00,507359,Fine; Sarah,18,0,18,0
1715602147469,EDS 289C,A01,507361,Daly; Alan J.,18,0,18,0
1715602148495,EDS 290,A00,507366,Hofstetter; Carolyn,15,0,15,0
1715602149552,LIGM 5A,A00,507421,Fischer-Grunski; Eva K,17,0,20,3
1715602150582,LIGM 5B,A00,507423,Fischer-Grunski; Eva K,19,0,20,1
1715602151615,LIGM 5C,A00,507425,Fischer-Grunski; Eva K,19,0,20,1
1715602152642,LIIT 5AS,A00,507427,Carnelos; Chiara,20,0,20,0
1715602153669,LIIT 5BS,A00,507430,Carnelos; Chiara,20,0,20,0
1715602154699,LIIT 5CS,A00,507432,Carnelos; Chiara,20,0,20,0
1715602155728,LISP 5A,A00,507541,Munoz Sanchez; Alicia,11,0,20,9
1715602156758,LISP 5B,A00,507671,Munoz Sanchez; Alicia,9,0,20,11
1715602157793,LISP 5C,A00,507696,Munoz Sanchez; Alicia,9,0,20,11
1715602158820,MAE 197,001,528363,Boechler; Nicholas Sebastia,9998,0,9999,1
1715602159848,MATH 197,001,523477,Kedlaya; Kiran S.,9994,0,9999,5
1715602159848,MATH 197,002,563811,Zhang; Danna,9994,0,9999,5
1715602159848,MATH 197,003,628552,Dumitriu; Ioana,9998,0,9999,1
1715602159848,MATH 197,004,660885,Floyd; Eric,9999,0,9999,0
1715602160877,MCWP 40R,A00,518780,Staff,2,0,20,18
1715602160877,MCWP 40R,B00,518781,Staff,11,0,20,9
1715602160877,MCWP 40R,C00,518783,Staff,5,0,20,15
1715602161905,MCWP 50R,A00,518791,Staff,0,1,20,20
1715602161905,MCWP 50R,B00,518792,Staff,0,2,20,20
1715602161905,MCWP 50R,C00,518793,Staff,0,4,20,20
1715602161905,MCWP 50R,D00,518794,Staff,0,1,20,20
1715602161905,MCWP 50R,E00,518795,Staff,0,2,20,20
1715602161905,MCWP 50R,F00,518796,Staff,0,1,20,20
1715602161905,MCWP 50R,G00,518797,Staff,0,1,20,20
1715602162930,MMW 12R,A01,514034,Herbst; Matthew,0,2,16,16
1715602162930,MMW 12R,A02,514035,Herbst; Matthew,0,0,16,16
1715602163961,MMW 13R,A01,514037,Staff,0,5,16,16
1715602163961,MMW 13R,A02,514039,Staff,0,5,16,16
1715602163961,MMW 13R,A03,628519,Staff,0,4,16,16
1715602166018,SIO 295LS,A00,523233,Staff,10,0,30,20
1715602167044,SIO 295S,A00,523232,Staff,10,0,30,20
1715602168071,SIOC 290S,A01,637330,Merrifield; Mark A,23,0,30,7
1715602169101,SIOC 291S,A01,637333,Gabriel; Corey John,23,0,30,7
1715602170129,SOCI 117,A01,494376,Staff,0,5,5,5
1715602171158,WES 237B,A00,494380,Staff,10,0,20,10
1715602173241,AESE 279B,A00,494370,Wade; Jon P,0,0,33,33
1715602174269,AIP 97,001,660915,Van Den Einde; Yael Dahlia,9999,0,9999,0
1715602175307,AIP 197,001,627712,Vespa; Emanuel Ignacio,9995,0,9999,4
1715602175307,AIP 197,002,650778,Amir; On,9998,0,9999,1
1715602175307,AIP 197,003,650933,Avenancio-Leon; Carlos,9998,0,9999,1
1715602175307,AIP 197,004,658530,Heyman; Gail D.,9998,0,9999,1
1715602175307,AIP 197,005,658631,Neal; Sonya E,9998,0,9999,1
1715602175307,AIP 197,006,658671,Du; Songzi,9998,0,9999,1
1715602176334,ANAR 135S,A00,494369,Braswell; Geoffrey E.,0,0,0,0
1715602177363,BENG 196,001,628496,Engler; Adam J.,9998,0,9999,1
1715602177363,BENG 196,002,660916,Watson; John Thomas,9999,0,9999,0
1715602178390,BISP 197,001,650773,Wilhelm; James E.,9994,0,9999,5
1715602178390,BISP 197,002,658904,Coleman; Aaron B.,9998,0,9999,1
1715602179418,CAT 124RS,A01,519847,Geibel; William,0,0,20,20
1715602180449,CAT 125RS,A01,515971,Geibel; William,0,0,20,20
1715602181476,CLRE 250,A00,511389,Morris; Sheldon,9992,0,9999,7
1715602182507,CLRE 251,A00,507176,Mehta; Ravindra L.,9992,0,9999,7
1715602182507,CLRE 251,B00,511410,Mehta; Ravindra L.,9998,0,9999,1
1715602183533,CLRE 252,A00,507189,Cuomo; Raphael Eduardo,9994,0,9999,5
1715602184561,CLRE 253,A00,507199,Vaida; Florin,9994,0,9999,5
1715602184561,CLRE 253,B00,507202,Vaida; Florin,9999,0,9999,0
1715602185592,CLRE 259,A00,507211,Patel; Hemal,9996,0,9999,3
1715602186618,CLRE 260,A00,507221,Cuomo; Raphael Eduardo,9999,0,9999,0
1715602187643,CLRE 297,001,507242,Cuomo; Raphael Eduardo,9999,0,9999,0
1715602188677,COGS 197,001,638244,Voytek; Bradley Thomas,9997,0,9999,2
1715602189704,CSE 191,A00,516875,Minnes Kemp; Mor Mia,9991,0,9999,8
1715602190729,CSE 197,001,637388,Minnes Kemp; Mor Mia,9992,0,9999,7
1715602191763,CSS 201S,A01,494383,Mignozzetti; Umberto,35,0,35,0
1715602192788,CSS 202S,A01,494387,Mignozzetti; Umberto,35,0,35,0
1715602193815,DSC 197,001,628532,Eldridge; Justin Matthew,9995,0,9999,4
1715602194842,EAP 100,A00,516065,Staff,9799,0,9999,200
1715602195878,ECE 45,A01,507414,Staff,31,0,60,29
1715602197933,ECE 111,A01,507420,Staff,11,0,50,39
1715602198958,ECE 197,001,548057,Sievenpiper; Daniel F.,9991,0,9999,8
1715602200049,EDS 115,A00,507243,Choi; Bailey Miyeon,7,0,28,21
1715602201076,EDS 117,A01,494379,Staff,0,6,34,34
1715602202113,EDS 125,A00,507246,Hopkins; Megan Beth,8,0,30,22
1715602203150,EDS 128A,A01,507264,Fargason; Sharon Gayle,6,0,26,20
1715602204176,EDS 128B,A01,507293,Pappas; Elizabeth,10,0,30,20
1715602205204,EDS 139,A00,507294,Fargason; Sharon Gayle,10,0,30,20
1715602205204,EDS 139,B00,507313,Pappas; Elizabeth,11,0,30,19
1715602206232,EDS 201,A00,507315,Staff,10,0,30,20
1715602207259,EDS 203,A01,507317,Halter; Christopher P.,10,0,30,20
1715602208290,EDS 204R,A01,507319,Halter; Christopher P.,0,3,30,30
1715602208290,EDS 204R,B01,507331,Heinzman; Erica M.,14,0,30,16
1715602209321,EDS 206R,A00,507332,Staff,0,4,30,30
1715602209321,EDS 206R,B00,507343,Staff,15,0,30,15
1715602210348,EDS 250,A00,507344,Hemans; Patricia Ann Benitez,20,0,40,20
1715602211381,EDS 281,A00,507345,Daly; Alan J.,18,0,18,0
1715602212408,EDS 284,A00,507350,Daly; Alan J.,16,0,16,0
1715602213436,EDS 286,A00,507359,Fine; Sarah,18,0,18,0
1715602214461,EDS 289C,A01,507361,Daly; Alan J.,18,0,18,0
1715602215490,EDS 290,A00,507366,Hofstetter; Carolyn,15,0,15,0
1715602216518,LIGM 5A,A00,507421,Fischer-Grunski; Eva K,17,0,20,3
1715602217543,LIGM 5B,A00,507423,Fischer-Grunski; Eva K,19,0,20,1
1715602218569,LIGM 5C,A00,507425,Fischer-Grunski; Eva K,19,0,20,1
1715602219600,LIIT 5AS,A00,507427,Carnelos; Chiara,20,0,20,0
1715602220633,LIIT 5BS,A00,507430,Carnelos; Chiara,20,0,20,0
1715602221665,LIIT 5CS,A00,507432,Carnelos; Chiara,20,0,20,0
1715602222692,LISP 5A,A00,507541,Munoz Sanchez; Alicia,11,0,20,9
1715602223718,LISP 5B,A00,507671,Munoz Sanchez; Alicia,9,0,20,11
1715602224746,LISP 5C,A00,507696,Munoz Sanchez; Alicia,9,0,20,11
1715602225772,MAE 197,001,528363,Boechler; Nicholas Sebastia,9998,0,9999,1
1715602226802,MATH 197,001,523477,Kedlaya; Kiran S.,9994,0,9999,5
1715602226802,MATH 197,002,563811,Zhang; Danna,9994,0,9999,5
1715602226802,MATH 197,003,628552,Dumitriu; Ioana,9998,0,9999,1
1715602226802,MATH 197,004,660885,Floyd; Eric,9999,0,9999,0
1715602227828,MCWP 40R,A00,518780,Staff,2,0,20,18
1715602227828,MCWP 40R,B00,518781,Staff,11,0,20,9
1715602227828,MCWP 40R,C00,518783,Staff,5,0,20,15
1715602228855,MCWP 50R,A00,518791,Staff,0,1,20,20
1715602228855,MCWP 50R,B00,518792,Staff,0,2,20,20
1715602228855,MCWP 50R,C00,518793,Staff,0,4,20,20
1715602228855,MCWP 50R,D00,518794,Staff,0,1,20,20
1715602228855,MCWP 50R,E00,518795,Staff,0,2,20,20
1715602228855,MCWP 50R,F00,518796,Staff,0,1,20,20
1715602228855,MCWP 50R,G00,518797,Staff,0,1,20,20
1715602229882,MMW 12R,A01,514034,Herbst; Matthew,0,2,16,16
1715602229882,MMW 12R,A02,514035,Herbst; Matthew,0,0,16,16
1715602230921,MMW 13R,A01,514037,Staff,0,5,16,16
1715602230921,MMW 13R,A02,514039,Staff,0,5,16,16
1715602230921,MMW 13R,A03,628519,Staff,0,4,16,16
1715602232980,SIO 295LS,A00,523233,Staff,10,0,30,20
1715602234005,SIO 295S,A00,523232,Staff,10,0,30,20
1715602235032,SIOC 290S,A01,637330,Merrifield; Mark A,23,0,30,7
1715602236067,SIOC 291S,A01,637333,Gabriel; Corey John,23,0,30,7
1715602237098,SOCI 117,A01,494376,Staff,0,5,5,5
1715602238127,WES 237B,A00,494380,Staff,10,0,20,10
1715602240231,AESE 279B,A00,494370,Wade; Jon P,0,0,33,33
1715602241258,AIP 97,001,660915,Van Den Einde; Yael Dahlia,9999,0,9999,0
1715602242311,AIP 197,001,627712,Vespa; Emanuel Ignacio,9995,0,9999,4
1715602242311,AIP 197,002,650778,Amir; On,9998,0,9999,1
1715602242311,AIP 197,003,650933,Avenancio-Leon; Carlos,9998,0,9999,1
1715602242311,AIP 197,004,658530,Heyman; Gail D.,9998,0,9999,1
1715602242311,AIP 197,005,658631,Neal; Sonya E,9998,0,9999,1
1715602242311,AIP 197,006,658671,Du; Songzi,9998,0,9999,1
1715602243342,ANAR 135S,A00,494369,Braswell; Geoffrey E.,0,0,0,0
1715602244374,BENG 196,001,628496,Engler; Adam J.,9998,0,9999,1
1715602244374,BENG 196,002,660916,Watson; John Thomas,9999,0,9999,0
1715602245400,BISP 197,001,650773,Wilhelm; James E.,9994,0,9999,5
1715602245400,BISP 197,002,658904,Coleman; Aaron B.,9998,0,9999,1
1715602246429,CAT 124RS,A01,519847,Geibel; William,0,0,20,20
1715602247460,CAT 125RS,A01,515971,Geibel; William,0,0,20,20
1715602248492,CLRE 250,A00,511389,Morris; Sheldon,9992,0,9999,7
1715602249522,CLRE 251,A00,507176,Mehta; Ravindra L.,9992,0,9999,7
1715602249522,CLRE 251,B00,511410,Mehta; Ravindra L.,9998,0,9999,1
1715602250548,CLRE 252,A00,507189,Cuomo; Raphael Eduardo,9994,0,9999,5
1715602251576,CLRE 253,A00,507199,Vaida; Florin,9994,0,9999,5
1715602251576,CLRE 253,B00,507202,Vaida; Florin,9999,0,9999,0
1715602252602,CLRE 259,A00,507211,Patel; Hemal,9996,0,9999,3
1715602253632,CLRE 260,A00,507221,Cuomo; Raphael Eduardo,9999,0,9999,0
1715602254660,CLRE 297,001,507242,Cuomo; Raphael Eduardo,9999,0,9999,0
1715602255688,COGS 197,001,638244,Voytek; Bradley Thomas,9997,0,9999,2
1715602256716,CSE 191,A00,516875,Minnes Kemp; Mor Mia,9991,0,9999,8
1715602257748,CSE 197,001,637388,Minnes Kemp; Mor Mia,9992,0,9999,7
1715602258777,CSS 201S,A01,494383,Mignozzetti; Umberto,35,0,35,0
1715602259803,CSS 202S,A01,494387,Mignozzetti; Umberto,35,0,35,0
1715602260833,DSC 197,001,628532,Eldridge; Justin Matthew,9995,0,9999,4
1715602261860,EAP 100,A00,516065,Staff,9799,0,9999,200
1715602262909,ECE 45,A01,507414,Staff,31,0,60,29
1715602264963,ECE 111,A01,507420,Staff,11,0,50,39
1715602265989,ECE 197,001,548057,Sievenpiper; Daniel F.,9991,0,9999,8
1715602267022,EDS 115,A00,507243,Choi; Bailey Miyeon,7,0,28,21
1715602268049,EDS 117,A01,494379,Staff,0,6,34,34
1715602269076,EDS 125,A00,507246,Hopkins; Megan Beth,8,0,30,22
1715602270105,EDS 128A,A01,507264,Fargason; Sharon Gayle,6,0,26,20
1715602271136,EDS 128B,A01,507293,Pappas; Elizabeth,10,0,30,20
1715602272167,EDS 139,A00,507294,Fargason; Sharon Gayle,10,0,30,20
1715602272167,EDS 139,B00,507313,Pappas; Elizabeth,11,0,30,19
1715602273198,EDS 201,A00,507315,Staff,10,0,30,20
1715602274227,EDS 203,A01,507317,Halter; Christopher P.,10,0,30,20
1715602275261,EDS 204R,A01,507319,Halter; Christopher P.,0,3,30,30
1715602275261,EDS 204R,B01,507331,Heinzman; Erica M.,14,0,30,16
1715602276291,EDS 206R,A00,507332,Staff,0,4,30,30
1715602276291,EDS 206R,B00,507343,Staff,15,0,30,15
1715602277319,EDS 250,A00,507344,Hemans; Patricia Ann Benitez,20,0,40,20
1715602278345,EDS 281,A00,507345,Daly; Alan J.,18,0,18,0
1715602279373,EDS 284,A00,507350,Daly; Alan J.,16,0,16,0
1715602280403,EDS 286,A00,507359,Fine; Sarah,18,0,18,0
1715602281434,EDS 289C,A01,507361,Daly; Alan J.,18,0,18,0
1715602282463,EDS 290,A00,507366,Hofstetter; Carolyn,15,0,15,0
1715602283492,LIGM 5A,A00,507421,Fischer-Grunski; Eva K,17,0,20,3
1715602284519,LIGM 5B,A00,507423,Fischer-Grunski; Eva K,19,0,20,1
1715602285546,LIGM 5C,A00,507425,Fischer-Grunski; Eva K,19,0,20,1
1715602286573,LIIT 5AS,A00,507427,Carnelos; Chiara,20,0,20,0
1715602287601,LIIT 5BS,A00,507430,Carnelos; Chiara,20,0,20,0
1715602288628,LIIT 5CS,A00,507432,Carnelos; Chiara,20,0,20,0
1715602289656,LISP 5A,A00,507541,Munoz Sanchez; Alicia,11,0,20,9
1715602290683,LISP 5B,A00,507671,Munoz Sanchez; Alicia,9,0,20,11
1715602291714,LISP 5C,A00,507696,Munoz Sanchez; Alicia,9,0,20,11
1715602292740,MAE 197,001,528363,Boechler; Nicholas Sebastia,9998,0,9999,1
1715602293782,MATH 197,001,523477,Kedlaya; Kiran S.,9994,0,9999,5
1715602293782,MATH 197,002,563811,Zhang; Danna,9994,0,9999,5
1715602293782,MATH 197,003,628552,Dumitriu; Ioana,9998,0,9999,1
1715602293782,MATH 197,004,660885,Floyd; Eric,9999,0,9999,0
1715602294814,MCWP 40R,A00,518780,Staff,2,0,20,18
1715602294814,MCWP 40R,B00,518781,Staff,11,0,20,9
1715602294814,MCWP 40R,C00,518783,Staff,5,0,20,15
1715602295840,MCWP 50R,A00,518791,Staff,0,1,20,20
1715602295840,MCWP 50R,B00,518792,Staff,0,2,20,20
1715602295840,MCWP 50R,C00,518793,Staff,0,4,20,20
1715602295840,MCWP 50R,D00,518794,Staff,0,1,20,20
1715602295840,MCWP 50R,E00,518795,Staff,0,2,20,20
1715602295840,MCWP 50R,F00,518796,Staff,0,1,20,20
1715602295840,MCWP 50R,G00,518797,Staff,0,1,20,20
1715602296867,MMW 12R,A01,514034,Herbst; Matthew,0,2,16,16
1715602296867,MMW 12R,A02,514035,Herbst; Matthew,0,0,16,16
1715602297896,MMW 13R,A01,514037,Staff,0,5,16,16
1715602297896,MMW 13R,A02,514039,Staff,0,5,16,16
1715602297896,MMW 13R,A03,628519,Staff,0,4,16,16
1715602299954,SIO 295LS,A00,523233,Staff,10,0,30,20
1715602300980,SIO 295S,A00,523232,Staff,10,0,30,20
1715602302013,SIOC 290S,A01,637330,Merrifield; Mark A,23,0,30,7
1715602303041,SIOC 291S,A01,637333,Gabriel; Corey John,23,0,30,7
1715602304067,SOCI 117,A01,494376,Staff,0,5,5,5
1715602305096,WES 237B,A00,494380,Staff,10,0,20,10
1715602307186,AESE 279B,A00,494370,Wade; Jon P,0,0,33,33
1715602308219,AIP 97,001,660915,Van Den Einde; Yael Dahlia,9999,0,9999,0
1715602309253,AIP 197,001,627712,Vespa; Emanuel Ignacio,9995,0,9999,4
1715602309253,AIP 197,002,650778,Amir; On,9998,0,9999,1
1715602309253,AIP 197,003,650933,Avenancio-Leon; Carlos,9998,0,9999,1
1715602309253,AIP 197,004,658530,Heyman; Gail D.,9998,0,9999,1
1715602309253,AIP 197,005,658631,Neal; Sonya E,9998,0,9999,1
1715602309253,AIP 197,006,658671,Du; Songzi,9998,0,9999,1
1715602310280,ANAR 135S,A00,494369,Braswell; Geoffrey E.,0,0,0,0
1715602311311,BENG 196,001,628496,Engler; Adam J.,9998,0,9999,1
1715602311311,BENG 196,002,660916,Watson; John Thomas,9999,0,9999,0
1715602312346,BISP 197,001,650773,Wilhelm; James E.,9994,0,9999,5
1715602312346,BISP 197,002,658904,Coleman; Aaron B.,9998,0,9999,1
1715602313374,CAT 124RS,A01,519847,Geibel; William,0,0,20,20
1715602314401,CAT 125RS,A01,515971,Geibel; William,0,0,20,20
1715602315432,CLRE 250,A00,511389,Morris; Sheldon,9992,0,9999,7
1715602316466,CLRE 251,A00,507176,Mehta; Ravindra L.,9992,0,9999,7
1715602316466,CLRE 251,B00,511410,Mehta; Ravindra L.,9998,0,9999,1
1715602317497,CLRE 252,A00,507189,Cuomo; Raphael Eduardo,9994,0,9999,5
1715602318528,CLRE 253,A00,507199,Vaida; Florin,9994,0,9999,5
1715602318528,CLRE 253,B00,507202,Vaida; Florin,9999,0,9999,0
1715602319555,CLRE 259,A00,507211,Patel; Hemal,9996,0,9999,3
1715602320581,CLRE 260,A00,507221,Cuomo; Raphael Eduardo,9999,0,9999,0
1715602321611,CLRE 297,001,507242,Cuomo; Raphael Eduardo,9999,0,9999,0
1715602322643,COGS 197,001,638244,Voytek; Bradley Thomas,9997,0,9999,2
1715602323671,CSE 191,A00,516875,Minnes Kemp; Mor Mia,9991,0,9999,8
1715602324703,CSE 197,001,637388,Minnes Kemp; Mor Mia,9992,0,9999,7
1715602325736,CSS 201S,A01,494383,Mignozzetti; Umberto,35,0,35,0
1715602326767,CSS 202S,A01,494387,Mignozzetti; Umberto,35,0,35,0
1715602327801,DSC 197,001,628532,Eldridge; Justin Matthew,9995,0,9999,4
1715602328829,EAP 100,A00,516065,Staff,9799,0,9999,200
1715602329858,ECE 45,A01,507414,Staff,31,0,60,29
1715602331929,ECE 111,A01,507420,Staff,11,0,50,39
1715602332956,ECE 197,001,548057,Sievenpiper; Daniel F.,9991,0,9999,8
1715602333984,EDS 115,A00,507243,Choi; Bailey Miyeon,7,0,28,21
1715602335014,EDS 117,A01,494379,Staff,0,6,34,34
1715602336043,EDS 125,A00,507246,Hopkins; Megan Beth,8,0,30,22
1715602337074,EDS 128A,A01,507264,Fargason; Sharon Gayle,6,0,26,20
1715602338102,EDS 128B,A01,507293,Pappas; Elizabeth,10,0,30,20
1715602339131,EDS 139,A00,507294,Fargason; Sharon Gayle,10,0,30,20
1715602339131,EDS 139,B00,507313,Pappas; Elizabeth,11,0,30,19
1715602340159,EDS 201,A00,507315,Staff,10,0,30,20
1715602341189,EDS 203,A01,507317,Halter; Christopher P.,10,0,30,20
1715602342218,EDS 204R,A01,507319,Halter; Christopher P.,0,3,30,30
1715602342218,EDS 204R,B01,507331,Heinzman; Erica M.,14,0,30,16
1715602343245,EDS 206R,A00,507332,Staff,0,4,30,30
1715602343245,EDS 206R,B00,507343,Staff,15,0,30,15
1715602344272,EDS 250,A00,507344,Hemans; Patricia Ann Benitez,20,0,40,20
1715602345306,EDS 281,A00,507345,Daly; Alan J.,18,0,18,0
1715602346332,EDS 284,A00,507350,Daly; Alan J.,16,0,16,0
1715602347364,EDS 286,A00,507359,Fine; Sarah,18,0,18,0
1715602348393,EDS 289C,A01,507361,Daly; Alan J.,18,0,18,0
1715602349418,EDS 290,A00,507366,Hofstetter; Carolyn,15,0,15,0
1715602350446,LIGM 5A,A00,507421,Fischer-Grunski; Eva K,17,0,20,3
1715602351472,LIGM 5B,A00,507423,Fischer-Grunski; Eva K,19,0,20,1
1715602352501,LIGM 5C,A00,507425,Fischer-Grunski; Eva K,19,0,20,1
1715602353527,LIIT 5AS,A00,507427,Carnelos; Chiara,20,0,20,0
1715602354555,LIIT 5BS,A00,507430,Carnelos; Chiara,20,0,20,0
1715602355582,LIIT 5CS,A00,507432,Carnelos; Chiara,20,0,20,0
1715602356608,LISP 5A,A00,507541,Munoz Sanchez; Alicia,11,0,20,9
1715602357634,LISP 5B,A00,507671,Munoz Sanchez; Alicia,9,0,20,11
1715602358664,LISP 5C,A00,507696,Munoz Sanchez; Alicia,9,0,20,11
1715602359694,MAE 197,001,528363,Boechler; Nicholas Sebastia,9998,0,9999,1
1715602360728,MATH 197,001,523477,Kedlaya; Kiran S.,9994,0,9999,5
1715602360728,MATH 197,002,563811,Zhang; Danna,9994,0,9999,5
1715602360728,MATH 197,003,628552,Dumitriu; Ioana,9998,0,9999,1
1715602360728,MATH 197,004,660885,Floyd; Eric,9999,0,9999,0
1715602361757,MCWP 40R,A00,518780,Staff,2,0,20,18
1715602361757,MCWP 40R,B00,518781,Staff,11,0,20,9
1715602361757,MCWP 40R,C00,518783,Staff,5,0,20,15
1715602362789,MCWP 50R,A00,518791,Staff,0,1,20,20
1715602362789,MCWP 50R,B00,518792,Staff,0,2,20,20
1715602362789,MCWP 50R,C00,518793,Staff,0,4,20,20
1715602362789,MCWP 50R,D00,518794,Staff,0,1,20,20
1715602362789,MCWP 50R,E00,518795,Staff,0,2,20,20
1715602362789,MCWP 50R,F00,518796,Staff,0,1,20,20
1715602362789,MCWP 50R,G00,518797,Staff,0,1,20,20
1715602363819,MMW 12R,A01,514034,Herbst; Matthew,0,2,16,16
1715602363819,MMW 12R,A02,514035,Herbst; Matthew,0,0,16,16
1715602364850,MMW 13R,A01,514037,Staff,0,5,16,16
1715602364850,MMW 13R,A02,514039,Staff,0,5,16,16
1715602364850,MMW 13R,A03,628519,Staff,0,4,16,16
1715602366906,SIO 295LS,A00,523233,Staff,10,0,30,20
1715602367931,SIO 295S,A00,523232,Staff,10,0,30,20
1715602368962,SIOC 290S,A01,637330,Merrifield; Mark A,23,0,30,7
1715602369987,SIOC 291S,A01,637333,Gabriel; Corey John,23,0,30,7
1715602371013,SOCI 117,A01,494376,Staff,0,5,5,5
1715602372040,WES 237B,A00,494380,Staff,10,0,20,10
1715602374131,AESE 279B,A00,494370,Wade; Jon P,0,0,33,33
1715602375157,AIP 97,001,660915,Van Den Einde; Yael Dahlia,9999,0,9999,0
1715602376196,AIP 197,001,627712,Vespa; Emanuel Ignacio,9995,0,9999,4
1715602376196,AIP 197,002,650778,Amir; On,9998,0,9999,1
1715602376196,AIP 197,003,650933,Avenancio-Leon; Carlos,9998,0,9999,1
1715602376196,AIP 197,004,658530,Heyman; Gail D.,9998,0,9999,1
1715602376196,AIP 197,005,658631,Neal; Sonya E,9998,0,9999,1
1715602376196,AIP 197,006,658671,Du; Songzi,9998,0,9999,1
1715602377222,ANAR 135S,A00,494369,Braswell; Geoffrey E.,0,0,0,0
1715602378250,BENG 196,001,628496,Engler; Adam J.,9998,0,9999,1
1715602378250,BENG 196,002,660916,Watson; John Thomas,9999,0,9999,0
1715602379281,BISP 197,001,650773,Wilhelm; James E.,9994,0,9999,5
1715602379281,BISP 197,002,658904,Coleman; Aaron B.,9998,0,9999,1
1715602380314,CAT 124RS,A01,519847,Geibel; William,0,0,20,20
1715602381340,CAT 125RS,A01,515971,Geibel; William,0,0,20,20
1715602382368,CLRE 250,A00,511389,Morris; Sheldon,9992,0,9999,7
1715602383404,CLRE 251,A00,507176,Mehta; Ravindra L.,9992,0,9999,7
1715602383404,CLRE 251,B00,511410,Mehta; Ravindra L.,9998,0,9999,1
1715602384431,CLRE 252,A00,507189,Cuomo; Raphael Eduardo,9994,0,9999,5
1715602385460,CLRE 253,A00,507199,Vaida; Florin,9994,0,9999,5
1715602385460,CLRE 253,B00,507202,Vaida; Florin,9999,0,9999,0
1715602386487,CLRE 259,A00,507211,Patel; Hemal,9996,0,9999,3
1715602387513,CLRE 260,A00,507221,Cuomo; Raphael Eduardo,9999,0,9999,0
1715602388539,CLRE 297,001,507242,Cuomo; Raphael Eduardo,9999,0,9999,0
1715602389584,COGS 197,001,638244,Voytek; Bradley Thomas,9997,0,9999,2
1715602390611,CSE 191,A00,516875,Minnes Kemp; Mor Mia,9991,0,9999,8
1715602391639,CSE 197,001,637388,Minnes Kemp; Mor Mia,9992,0,9999,7
1715602392676,CSS 201S,A01,494383,Mignozzetti; Umberto,35,0,35,0
1715602393704,CSS 202S,A01,494387,Mignozzetti; Umberto,35,0,35,0
1715602394736,DSC 197,001,628532,Eldridge; Justin Matthew,9995,0,9999,4
1715602395761,EAP 100,A00,516065,Staff,9799,0,9999,200
1715602396799,ECE 45,A01,507414,Staff,31,0,60,29
1715602398855,ECE 111,A01,507420,Staff,11,0,50,39
1715602399881,ECE 197,001,548057,Sievenpiper; Daniel F.,9991,0,9999,8
1715602400911,EDS 115,A00,507243,Choi; Bailey Miyeon,7,0,28,21
1715602401946,EDS 117,A01,494379,Staff,0,6,34,34
1715602402972,EDS 125,A00,507246,Hopkins; Megan Beth,8,0,30,22
1715602404005,EDS 128A,A01,507264,Fargason; Sharon Gayle,6,0,26,20
1715602405031,EDS 128B,A01,507293,Pappas; Elizabeth,10,0,30,20
1715602406062,EDS 139,A00,507294,Fargason; Sharon Gayle,10,0,30,20
1715602406062,EDS 139,B00,507313,Pappas; Elizabeth,11,0,30,19
1715602407097,EDS 201,A00,507315,Staff,10,0,30,20
1715602408128,EDS 203,A01,507317,Halter; Christopher P.,10,0,30,20
1715602409156,EDS 204R,A01,507319,Halter; Christopher P.,0,3,30,30
1715602409156,EDS 204R,B01,507331,Heinzman; Erica M.,14,0,30,16
1715602410187,EDS 206R,A00,507332,Staff,0,4,30,30
1715602410187,EDS 206R,B00,507343,Staff,15,0,30,15
1715602411217,EDS 250,A00,507344,Hemans; Patricia Ann Benitez,20,0,40,20
1715602412248,EDS 281,A00,507345,Daly; Alan J.,18,0,18,0
1715602413274,EDS 284,A00,507350,Daly; Alan J.,16,0,16,0
1715602414300,EDS 286,A00,507359,Fine; Sarah,18,0,18,0
1715602415331,EDS 289C,A01,507361,Daly; Alan J.,18,0,18,0
1715602416358,EDS 290,A00,507366,Hofstetter; Carolyn,15,0,15,0
1715602417392,LIGM 5A,A00,507421,Fischer-Grunski; Eva K,17,0,20,3
1715602418419,LIGM 5B,A00,507423,Fischer-Grunski; Eva K,19,0,20,1
1715602419445,LIGM 5C,A00,507425,Fischer-Grunski; Eva K,19,0,20,1
1715602420472,LIIT 5AS,A00,507427,Carnelos; Chiara,20,0,20,0
1715602421499,LIIT 5BS,A00,507430,Carnelos; Chiara,20,0,20,0
1715602422530,LIIT 5CS,A00,507432,Carnelos; Chiara,20,0,20,0
1715602423564,LISP 5A,A00,507541,Munoz Sanchez; Alicia,11,0,20,9
1715602424594,LISP 5B,A00,507671,Munoz Sanchez; Alicia,9,0,20,11
1715602425620,LISP 5C,A00,507696,Munoz Sanchez; Alicia,9,0,20,11
1715602426650,MAE 197,001,528363,Boechler; Nicholas Sebastia,9998,0,9999,1
1715602427685,MATH 197,001,523477,Kedlaya; Kiran S.,9994,0,9999,5
1715602427685,MATH 197,002,563811,Zhang; Danna,9994,0,9999,5
1715602427685,MATH 197,003,628552,Dumitriu; Ioana,9998,0,9999,1
1715602427685,MATH 197,004,660885,Floyd; Eric,9999,0,9999,0
1715602428715,MCWP 40R,A00,518780,Staff,2,0,20,18
1715602428715,MCWP 40R,B00,518781,Staff,11,0,20,9
1715602428715,MCWP 40R,C00,518783,Staff,5,0,20,15
1715602429746,MCWP 50R,A00,518791,Staff,0,1,20,20
1715602429746,MCWP 50R,B00,518792,Staff,0,2,20,20
1715602429746,MCWP 50R,C00,518793,Staff,0,4,20,20
1715602429746,MCWP 50R,D00,518794,Staff,0,1,20,20
1715602429746,MCWP 50R,E00,518795,Staff,0,2,20,20
1715602429746,MCWP 50R,F00,518796,Staff,0,1,20,20
1715602429746,MCWP 50R,G00,518797,Staff,0,1,20,20
1715602430776,MMW 12R,A01,514034,Herbst; Matthew,0,2,16,16
1715602430776,MMW 12R,A02,514035,Herbst; Matthew,0,0,16,16
1715602431800,MMW 13R,A01,514037,Staff,0,5,16,16
1715602431800,MMW 13R,A02,514039,Staff,0,5,16,16
1715602431800,MMW 13R,A03,628519,Staff,0,4,16,16
1715602433852,SIO 295LS,A00,523233,Staff,10,0,30,20
1715602434879,SIO 295S,A00,523232,Staff,10,0,30,20
1715602435913,SIOC 290S,A01,637330,Merrifield; Mark A,23,0,30,7
1715602436943,SIOC 291S,A01,637333,Gabriel; Corey John,23,0,30,7
1715602437970,SOCI 117,A01,494376,Staff,0,5,5,5
1715602439000,WES 237B,A00,494380,Staff,10,0,20,10
1715602441083,AESE 279B,A00,494370,Wade; Jon P,0,0,33,33
1715602442113,AIP 97,001,660915,Van Den Einde; Yael Dahlia,9999,0,9999,0
1715602443141,AIP 197,001,627712,Vespa; Emanuel Ignacio,9995,0,9999,4
1715602443141,AIP 197,002,650778,Amir; On,9998,0,9999,1
1715602443141,AIP 197,003,650933,Avenancio-Leon; Carlos,9998,0,9999,1
1715602443141,AIP 197,004,658530,Heyman; Gail D.,9998,0,9999,1
1715602443141,AIP 197,005,658631,Neal; Sonya E,9998,0,9999,1
1715602443141,AIP 197,006,658671,Du; Songzi,9998,0,9999,1
1715602444168,ANAR 135S,A00,494369,Braswell; Geoffrey E.,0,0,0,0
1715602445197,BENG 196,001,628496,Engler; Adam J.,9998,0,9999,1
1715602445197,BENG 196,002,660916,Watson; John Thomas,9999,0,9999,0
1715602446226,BISP 197,001,650773,Wilhelm; James E.,9994,0,9999,5
1715602446226,BISP 197,002,658904,Coleman; Aaron B.,9998,0,9999,1
1715602447257,CAT 124RS,A01,519847,Geibel; William,0,0,20,20
1715602448288,CAT 125RS,A01,515971,Geibel; William,0,0,20,20
1715602449315,CLRE 250,A00,511389,Morris; Sheldon,9992,0,9999,7
1715602450345,CLRE 251,A00,507176,Mehta; Ravindra L.,9992,0,9999,7
1715602450345,CLRE 251,B00,511410,Mehta; Ravindra L.,9998,0,9999,1
1715602451373,CLRE 252,A00,507189,Cuomo; Raphael Eduardo,9994,0,9999,5
1715602452400,CLRE 253,A00,507199,Vaida; Florin,9994,0,9999,5
1715602452400,CLRE 253,B00,507202,Vaida; Florin,9999,0,9999,0
1715602453430,CLRE 259,A00,507211,Patel; Hemal,9996,0,9999,3
1715602454458,CLRE 260,A00,507221,Cuomo; Raphael Eduardo,9999,0,9999,0
1715602455484,CLRE 297,001,507242,Cuomo; Raphael Eduardo,9999,0,9999,0
1715602456513,COGS 197,001,638244,Voytek; Bradley Thomas,9997,0,9999,2
1715602457543,CSE 191,A00,516875,Minnes Kemp; Mor Mia,9991,0,9999,8
1715602458569,CSE 197,001,637388,Minnes Kemp; Mor Mia,9992,0,9999,7
1715602459605,CSS 201S,A01,494383,Mignozzetti; Umberto,35,0,35,0
1715602460631,CSS 202S,A01,494387,Mignozzetti; Umberto,35,0,35,0
1715602461661,DSC 197,001,628532,Eldridge; Justin Matthew,9995,0,9999,4
1715602462689,EAP 100,A00,516065,Staff,9799,0,9999,200
1715602463719,ECE 45,A01,507414,Staff,31,0,60,29
1715602465778,ECE 111,A01,507420,Staff,11,0,50,39
1715602466805,ECE 197,001,548057,Sievenpiper; Daniel F.,9991,0,9999,8
1715602467835,EDS 115,A00,507243,Choi; Bailey Miyeon,7,0,28,21
1715602468862,EDS 117,A01,494379,Staff,0,6,34,34
1715602469891,EDS 125,A00,507246,Hopkins; Megan Beth,8,0,30,22
1715602470920,EDS 128A,A01,507264,Fargason; Sharon Gayle,6,0,26,20
1715602471950,EDS 128B,A01,507293,Pappas; Elizabeth,10,0,30,20
1715602472980,EDS 139,A00,507294,Fargason; Sharon Gayle,10,0,30,20
1715602472980,EDS 139,B00,507313,Pappas; Elizabeth,11,0,30,19
1715602474007,EDS 201,A00,507315,Staff,10,0,30,20
1715602475034,EDS 203,A01,507317,Halter; Christopher P.,10,0,30,20
1715602476062,EDS 204R,A01,507319,Halter; Christopher P.,0,3,30,30
1715602476062,EDS 204R,B01,507331,Heinzman; Erica M.,14,0,30,16
1715602477090,EDS 206R,A00,507332,Staff,0,4,30,30
1715602477090,EDS 206R,B00,507343,Staff,15,0,30,15
1715602478120,EDS 250,A00,507344,Hemans; Patricia Ann Benitez,20,0,40,20
1715602479147,EDS 281,A00,507345,Daly; Alan J.,18,0,18,0
1715602480173,EDS 284,A00,507350,Daly; Alan J.,16,0,16,0
1715602481198,EDS 286,A00,507359,Fine; Sarah,18,0,18,0
1715602482225,EDS 289C,A01,507361,Daly; Alan J.,18,0,18,0
1715602483251,EDS 290,A00,507366,Hofstetter; Carolyn,15,0,15,0
1715602484279,LIGM 5A,A00,507421,Fischer-Grunski; Eva K,17,0,20,3
1715602485309,LIGM 5B,A00,507423,Fischer-Grunski; Eva K,19,0,20,1
1715602486336,LIGM 5C,A00,507425,Fischer-Grunski; Eva K,19,0,20,1
1715602487364,LIIT 5AS,A00,507427,Carnelos; Chiara,20,0,20,0
1715602488395,LIIT 5BS,A00,507430,Carnelos; Chiara,20,0,20,0
1715602489422,LIIT 5CS,A00,507432,Carnelos; Chiara,20,0,20,0
1715602490450,LISP 5A,A00,507541,Munoz Sanchez; Alicia,11,0,20,9
1715602491476,LISP 5B,A00,507671,Munoz Sanchez; Alicia,9,0,20,11
1715602492506,LISP 5C,A00,507696,Munoz Sanchez; Alicia,9,0,20,11
1715602493535,MAE 197,001,528363,Boechler; Nicholas Sebastia,9998,0,9999,1
1715602494575,MATH 197,001,523477,Kedlaya; Kiran S.,9994,0,9999,5
1715602494575,MATH 197,002,563811,Zhang; Danna,9994,0,9999,5
1715602494575,MATH 197,003,628552,Dumitriu; Ioana,9998,0,9999,1
1715602494575,MATH 197,004,660885,Floyd; Eric,9999,0,9999,0
1715602495607,MCWP 40R,A00,518780,Staff,2,0,20,18
1715602495607,MCWP 40R,B00,518781,Staff,11,0,20,9
1715602495607,MCWP 40R,C00,518783,Staff,5,0,20,15
1715602496691,MCWP 50R,A00,518791,Staff,0,1,20,20
1715602496691,MCWP 50R,B00,518792,Staff,0,2,20,20
1715602496691,MCWP 50R,C00,518793,Staff,0,4,20,20
1715602496691,MCWP 50R,D00,518794,Staff,0,1,20,20
1715602496691,MCWP 50R,E00,518795,Staff,0,2,20,20
1715602496691,MCWP 50R,F00,518796,Staff,0,1,20,20
1715602496691,MCWP 50R,G00,518797,Staff,0,1,20,20
1715602497717,MMW 12R,A01,514034,Herbst; Matthew,0,2,16,16
1715602497717,MMW 12R,A02,514035,Herbst; Matthew,0,0,16,16
1715602498745,MMW 13R,A01,514037,Staff,0,5,16,16
1715602498745,MMW 13R,A02,514039,Staff,0,5,16,16
1715602498745,MMW 13R,A03,628519,Staff,0,4,16,16
1715602500800,SIO 295LS,A00,523233,Staff,10,0,30,20
1715602501826,SIO 295S,A00,523232,Staff,10,0,30,20
1715602502855,SIOC 290S,A01,637330,Merrifield; Mark A,23,0,30,7
1715602503901,SIOC 291S,A01,637333,Gabriel; Corey John,23,0,30,7
1715602504926,SOCI 117,A01,494376,Staff,0,5,5,5
1715602505958,WES 237B,A00,494380,Staff,10,0,20,10
1715602508058,AESE 279B,A00,494370,Wade; Jon P,0,0,33,33
1715602509085,AIP 97,001,660915,Van Den Einde; Yael Dahlia,9999,0,9999,0
1715602510116,AIP 197,001,627712,Vespa; Emanuel Ignacio,9995,0,9999,4
1715602510116,AIP 197,002,650778,Amir; On,9998,0,9999,1
1715602510116,AIP 197,003,650933,Avenancio-Leon; Carlos,9998,0,9999,1
1715602510116,AIP 197,004,658530,Heyman; Gail D.,9998,0,9999,1
1715602510116,AIP 197,005,658631,Neal; Sonya E,9998,0,9999,1
1715602510116,AIP 197,006,658671,Du; Songzi,9998,0,9999,1
1715602511145,ANAR 135S,A00,494369,Braswell; Geoffrey E.,0,0,0,0
1715602512174,BENG 196,001,628496,Engler; Adam J.,9998,0,9999,1
1715602512174,BENG 196,002,660916,Watson; John Thomas,9999,0,9999,0
1715602513205,BISP 197,001,650773,Wilhelm; James E.,9994,0,9999,5
1715602513205,BISP 197,002,658904,Coleman; Aaron B.,9998,0,9999,1
1715602514232,CAT 124RS,A01,519847,Geibel; William,0,0,20,20
1715602515260,CAT 125RS,A01,515971,Geibel; William,0,0,20,20
1715602516288,CLRE 250,A00,511389,Morris; Sheldon,9992,0,9999,7
1715602517318,CLRE 251,A00,507176,Mehta; Ravindra L.,9992,0,9999,7
1715602517318,CLRE 251,B00,511410,Mehta; Ravindra L.,9998,0,9999,1
1715602518353,CLRE 252,A00,507189,Cuomo; Raphael Eduardo,9994,0,9999,5
1715602519381,CLRE 253,A00,507199,Vaida; Florin,9994,0,9999,5
1715602519381,CLRE 253,B00,507202,Vaida; Florin,9999,0,9999,0
1715602520409,CLRE 259,A00,507211,Patel; Hemal,9996,0,9999,3
1715602521434,CLRE 260,A00,507221,Cuomo; Raphael Eduardo,9999,0,9999,0
1715602522462,CLRE 297,001,507242,Cuomo; Raphael Eduardo,9999,0,9999,0
1715602523489,COGS 197,001,638244,Voytek; Bradley Thomas,9997,0,9999,2
1715602524518,CSE 191,A00,516875,Minnes Kemp; Mor Mia,9991,0,9999,8
1715602525546,CSE 197,001,637388,Minnes Kemp; Mor Mia,9992,0,9999,7
1715602526574,CSS 201S,A01,494383,Mignozzetti; Umberto,35,0,35,0
1715602527601,CSS 202S,A01,494387,Mignozzetti; Umberto,35,0,35,0
1715602528633,DSC 197,001,628532,Eldridge; Justin Matthew,9995,0,9999,4
1715602529661,EAP 100,A00,516065,Staff,9799,0,9999,200
1715602530692,ECE 45,A01,507414,Staff,31,0,60,29
1715602532748,ECE 111,A01,507420,Staff,11,0,50,39
1715602533780,ECE 197,001,548057,Sievenpiper; Daniel F.,9991,0,9999,8
1715602534805,EDS 115,A00,507243,Choi; Bailey Miyeon,7,0,28,21
1715602535833,EDS 117,A01,494379,Staff,0,6,34,34
1715602536865,EDS 125,A00,507246,Hopkins; Megan Beth,8,0,30,22
1715602537891,EDS 128A,A01,507264,Fargason; Sharon Gayle,6,0,26,20
1715602538920,EDS 128B,A01,507293,Pappas; Elizabeth,10,0,30,20
1715602539946,EDS 139,A00,507294,Fargason; Sharon Gayle,10,0,30,20
1715602539946,EDS 139,B00,507313,Pappas; Elizabeth,11,0,30,19
1715602540971,EDS 201,A00,507315,Staff,10,0,30,20
1715602542003,EDS 203,A01,507317,Halter; Christopher P.,10,0,30,20
1715602543030,EDS 204R,A01,507319,Halter; Christopher P.,0,3,30,30
1715602543030,EDS 204R,B01,507331,Heinzman; Erica M.,14,0,30,16
1715602544061,EDS 206R,A00,507332,Staff,0,4,30,30
1715602544061,EDS 206R,B00,507343,Staff,15,0,30,15
1715602545087,EDS 250,A00,507344,Hemans; Patricia Ann Benitez,20,0,40,20
1715602546114,EDS 281,A00,507345,Daly; Alan J.,18,0,18,0
1715602547139,EDS 284,A00,507350,Daly; Alan J.,16,0,16,0
1715602548166,EDS 286,A00,507359,Fine; Sarah,18,0,18,0
1715602549192,EDS 289C,A01,507361,Daly; Alan J.,18,0,18,0
1715602550221,EDS 290,A00,507366,Hofstetter; Carolyn,15,0,15,0
1715602551248,LIGM 5A,A00,507421,Fischer-Grunski; Eva K,17,0,20,3
1715602552282,LIGM 5B,A00,507423,Fischer-Grunski; Eva K,19,0,20,1
1715602553309,LIGM 5C,A00,507425,Fischer-Grunski; Eva K,19,0,20,1
1715602554338,LIIT 5AS,A00,507427,Carnelos; Chiara,20,0,20,0
1715602555368,LIIT 5BS,A00,507430,Carnelos; Chiara,20,0,20,0
1715602556394,LIIT 5CS,A00,507432,Carnelos; Chiara,20,0,20,0
1715602557422,LISP 5A,A00,507541,Munoz Sanchez; Alicia,11,0,20,9
1715602558453,LISP 5B,A00,507671,Munoz Sanchez; Alicia,9,0,20,11
1715602559480,LISP 5C,A00,507696,Munoz Sanchez; Alicia,9,0,20,11
1715602560539,MAE 197,001,528363,Boechler; Nicholas Sebastia,9998,0,9999,1
1715602561569,MATH 197,001,523477,Kedlaya; Kiran S.,9994,0,9999,5
1715602561569,MATH 197,002,563811,Zhang; Danna,9994,0,9999,5
1715602561569,MATH 197,003,628552,Dumitriu; Ioana,9998,0,9999,1
1715602561569,MATH 197,004,660885,Floyd; Eric,9999,0,9999,0
1715602562603,MCWP 40R,A00,518780,Staff,2,0,20,18
1715602562603,MCWP 40R,B00,518781,Staff,11,0,20,9
1715602562603,MCWP 40R,C00,518783,Staff,5,0,20,15
1715602563633,MCWP 50R,A00,518791,Staff,0,1,20,20
1715602563633,MCWP 50R,B00,518792,Staff,0,2,20,20
1715602563633,MCWP 50R,C00,518793,Staff,0,4,20,20
1715602563633,MCWP 50R,D00,518794,Staff,0,1,20,20
1715602563633,MCWP 50R,E00,518795,Staff,0,2,20,20
1715602563633,MCWP 50R,F00,518796,Staff,0,1,20,20
1715602563633,MCWP 50R,G00,518797,Staff,0,1,20,20
1715602564660,MMW 12R,A01,514034,Herbst; Matthew,0,2,16,16
1715602564660,MMW 12R,A02,514035,Herbst; Matthew,0,0,16,16
1715602565687,MMW 13R,A01,514037,Staff,0,5,16,16
1715602565687,MMW 13R,A02,514039,Staff,0,5,16,16
1715602565687,MMW 13R,A03,628519,Staff,0,4,16,16
1715602567747,SIO 295LS,A00,523233,Staff,10,0,30,20
1715602568776,SIO 295S,A00,523232,Staff,10,0,30,20
1715602569809,SIOC 290S,A01,637330,Merrifield; Mark A,23,0,30,7
1715602570836,SIOC 291S,A01,637333,Gabriel; Corey John,23,0,30,7
1715602571862,SOCI 117,A01,494376,Staff,0,5,5,5
1715602572889,WES 237B,A00,494380,Staff,10,0,20,10
1715602574974,AESE 279B,A00,494370,Wade; Jon P,0,0,33,33
1715602576004,AIP 97,001,660915,Van Den Einde; Yael Dahlia,9999,0,9999,0
1715602577034,AIP 197,001,627712,Vespa; Emanuel Ignacio,9995,0,9999,4
1715602577034,AIP 197,002,650778,Amir; On,9998,0,9999,1
1715602577034,AIP 197,003,650933,Avenancio-Leon; Carlos,9998,0,9999,1
1715602577034,AIP 197,004,658530,Heyman; Gail D.,9998,0,9999,1
1715602577034,AIP 197,005,658631,Neal; Sonya E,9998,0,9999,1
1715602577034,AIP 197,006,658671,Du; Songzi,9998,0,9999,1
1715602578060,ANAR 135S,A00,494369,Braswell; Geoffrey E.,0,0,0,0
1715602579091,BENG 196,001,628496,Engler; Adam J.,9998,0,9999,1
1715602579091,BENG 196,002,660916,Watson; John Thomas,9999,0,9999,0
1715602580120,BISP 197,001,650773,Wilhelm; James E.,9994,0,9999,5
1715602580120,BISP 197,002,658904,Coleman; Aaron B.,9998,0,9999,1
1715602581149,CAT 124RS,A01,519847,Geibel; William,0,0,20,20
1715602582182,CAT 125RS,A01,515971,Geibel; William,0,0,20,20
1715602583215,CLRE 250,A00,511389,Morris; Sheldon,9992,0,9999,7
1715602584245,CLRE 251,A00,507176,Mehta; Ravindra L.,9992,0,9999,7
1715602584245,CLRE 251,B00,511410,Mehta; Ravindra L.,9998,0,9999,1
1715602585273,CLRE 252,A00,507189,Cuomo; Raphael Eduardo,9994,0,9999,5
1715602586299,CLRE 253,A00,507199,Vaida; Florin,9994,0,9999,5
1715602586299,CLRE 253,B00,507202,Vaida; Florin,9999,0,9999,0
1715602587325,CLRE 259,A00,507211,Patel; Hemal,9996,0,9999,3
1715602588357,CLRE 260,A00,507221,Cuomo; Raphael Eduardo,9999,0,9999,0
1715602589388,CLRE 297,001,507242,Cuomo; Raphael Eduardo,9999,0,9999,0
1715602590416,COGS 197,001,638244,Voytek; Bradley Thomas,9997,0,9999,2
1715602591445,CSE 191,A00,516875,Minnes Kemp; Mor Mia,9991,0,9999,8
1715602592471,CSE 197,001,637388,Minnes Kemp; Mor Mia,9992,0,9999,7
1715602593503,CSS 201S,A01,494383,Mignozzetti; Umberto,35,0,35,0
1715602594529,CSS 202S,A01,494387,Mignozzetti; Umberto,35,0,35,0
1715602595557,DSC 197,001,628532,Eldridge; Justin Matthew,9995,0,9999,4
1715602596583,EAP 100,A00,516065,Staff,9799,0,9999,200
1715602597618,ECE 45,A01,507414,Staff,31,0,60,29
1715602599670,ECE 111,A01,507420,Staff,11,0,50,39
1715602600698,ECE 197,001,548057,Sievenpiper; Daniel F.,9991,0,9999,8
1715602601726,EDS 115,A00,507243,Choi; Bailey Miyeon,7,0,28,21
1715602602753,EDS 117,A01,494379,Staff,0,6,34,34
1715602603778,EDS 125,A00,507246,Hopkins; Megan Beth,8,0,30,22
1715602604809,EDS 128A,A01,507264,Fargason; Sharon Gayle,6,0,26,20
1715602605834,EDS 128B,A01,507293,Pappas; Elizabeth,10,0,30,20
1715602606858,EDS 139,A00,507294,Fargason; Sharon Gayle,10,0,30,20
1715602606858,EDS 139,B00,507313,Pappas; Elizabeth,11,0,30,19
1715602607888,EDS 201,A00,507315,Staff,10,0,30,20
1715602608914,EDS 203,A01,507317,Halter; Christopher P.,10,0,30,20
1715602609942,EDS 204R,A01,507319,Halter; Christopher P.,0,3,30,30
1715602609942,EDS 204R,B01,507331,Heinzman; Erica M.,14,0,30,16
1715602610972,EDS 206R,A00,507332,Staff,0,4,30,30
1715602610972,EDS 206R,B00,507343,Staff,15,0,30,15
1715602612005,EDS 250,A00,507344,Hemans; Patricia Ann Benitez,20,0,40,20
1715602613036,EDS 281,A00,507345,Daly; Alan J.,18,0,18,0
1715602614065,EDS 284,A00,507350,Daly; Alan J.,16,0,16,0
1715602615096,EDS 286,A00,507359,Fine; Sarah,18,0,18,0
1715602616126,EDS 289C,A01,507361,Daly; Alan J.,18,0,18,0
1715602617154,EDS 290,A00,507366,Hofstetter; Carolyn,15,0,15,0
1715602618186,LIGM 5A,A00,507421,Fischer-Grunski; Eva K,17,0,20,3
1715602619215,LIGM 5B,A00,507423,Fischer-Grunski; Eva K,19,0,20,1
1715602620246,LIGM 5C,A00,507425,Fischer-Grunski; Eva K,19,0,20,1
1715602621273,LIIT 5AS,A00,507427,Carnelos; Chiara,20,0,20,0
1715602622303,LIIT 5BS,A00,507430,Carnelos; Chiara,20,0,20,0
1715602623334,LIIT 5CS,A00,507432,Carnelos; Chiara,20,0,20,0
1715602624365,LISP 5A,A00,507541,Munoz Sanchez; Alicia,11,0,20,9
1715602625394,LISP 5B,A00,507671,Munoz Sanchez; Alicia,9,0,20,11
1715602626425,LISP 5C,A00,507696,Munoz Sanchez; Alicia,9,0,20,11
1715602627452,MAE 197,001,528363,Boechler; Nicholas Sebastia,9998,0,9999,1
1715602628487,MATH 197,001,523477,Kedlaya; Kiran S.,9994,0,9999,5
1715602628487,MATH 197,002,563811,Zhang; Danna,9994,0,9999,5
1715602628487,MATH 197,003,628552,Dumitriu; Ioana,9998,0,9999,1
1715602628487,MATH 197,004,660885,Floyd; Eric,9999,0,9999,0
1715602629517,MCWP 40R,A00,518780,Staff,2,0,20,18
1715602629517,MCWP 40R,B00,518781,Staff,11,0,20,9
1715602629517,MCWP 40R,C00,518783,Staff,5,0,20,15
1715602630548,MCWP 50R,A00,518791,Staff,0,1,20,20
1715602630548,MCWP 50R,B00,518792,Staff,0,2,20,20
1715602630548,MCWP 50R,C00,518793,Staff,0,4,20,20
1715602630548,MCWP 50R,D00,518794,Staff,0,1,20,20
1715602630548,MCWP 50R,E00,518795,Staff,0,2,20,20
1715602630548,MCWP 50R,F00,518796,Staff,0,1,20,20
1715602630548,MCWP 50R,G00,518797,Staff,0,1,20,20
1715602631576,MMW 12R,A01,514034,Herbst; Matthew,0,2,16,16
1715602631576,MMW 12R,A02,514035,Herbst; Matthew,0,0,16,16
1715602632605,MMW 13R,A01,514037,Staff,0,5,16,16
1715602632605,MMW 13R,A02,514039,Staff,0,5,16,16
1715602632605,MMW 13R,A03,628519,Staff,0,4,16,16
1715602634658,SIO 295LS,A00,523233,Staff,10,0,30,20
1715602635690,SIO 295S,A00,523232,Staff,10,0,30,20
1715602636722,SIOC 290S,A01,637330,Merrifield; Mark A,23,0,30,7
1715602637745,SIOC 291S,A01,637333,Gabriel; Corey John,23,0,30,7
1715602638777,SOCI 117,A01,494376,Staff,0,5,5,5
1715602639805,WES 237B,A00,494380,Staff,10,0,20,10
1715602641893,AESE 279B,A00,494370,Wade; Jon P,0,0,33,33
1715602642923,AIP 97,001,660915,Van Den Einde; Yael Dahlia,9999,0,9999,0
1715602643954,AIP 197,001,627712,Vespa; Emanuel Ignacio,9995,0,9999,4
1715602643954,AIP 197,002,650778,Amir; On,9998,0,9999,1
1715602643954,AIP 197,003,650933,Avenancio-Leon; Carlos,9998,0,9999,1
1715602643954,AIP 197,004,658530,Heyman; Gail D.,9998,0,9999,1
1715602643954,AIP 197,005,658631,Neal; Sonya E,9998,0,9999,1
1715602643954,AIP 197,006,658671,Du; Songzi,9998,0,9999,1
1715602644984,ANAR 135S,A00,494369,Braswell; Geoffrey E.,0,0,0,0
1715602646009,BENG 196,001,628496,Engler; Adam J.,9998,0,9999,1
1715602646009,BENG 196,002,660916,Watson; John Thomas,9999,0,9999,0
1715602647037,BISP 197,001,650773,Wilhelm; James E.,9994,0,9999,5
1715602647037,BISP 197,002,658904,Coleman; Aaron B.,9998,0,9999,1
1715602648064,CAT 124RS,A01,519847,Geibel; William,0,0,20,20
1715602649093,CAT 125RS,A01,515971,Geibel; William,0,0,20,20
1715602650125,CLRE 250,A00,511389,Morris; Sheldon,9992,0,9999,7
1715602651157,CLRE 251,A00,507176,Mehta; Ravindra L.,9992,0,9999,7
1715602651157,CLRE 251,B00,511410,Mehta; Ravindra L.,9998,0,9999,1
1715602652194,CLRE 252,A00,507189,Cuomo; Raphael Eduardo,9994,0,9999,5
1715602653222,CLRE 253,A00,507199,Vaida; Florin,9994,0,9999,5
1715602653222,CLRE 253,B00,507202,Vaida; Florin,9999,0,9999,0
1715602654246,CLRE 259,A00,507211,Patel; Hemal,9996,0,9999,3
1715602655272,CLRE 260,A00,507221,Cuomo; Raphael Eduardo,9999,0,9999,0
1715602656298,CLRE 297,001,507242,Cuomo; Raphael Eduardo,9999,0,9999,0
1715602657325,COGS 197,001,638244,Voytek; Bradley Thomas,9997,0,9999,2
1715602658357,CSE 191,A00,516875,Minnes Kemp; Mor Mia,9991,0,9999,8
1715602659388,CSE 197,001,637388,Minnes Kemp; Mor Mia,9992,0,9999,7
1715602660419,CSS 201S,A01,494383,Mignozzetti; Umberto,35,0,35,0
1715602661445,CSS 202S,A01,494387,Mignozzetti; Umberto,35,0,35,0
1715602662472,DSC 197,001,628532,Eldridge; Justin Matthew,9995,0,9999,4
1715602663499,EAP 100,A00,516065,Staff,9799,0,9999,200
1715602664536,ECE 45,A01,507414,Staff,31,0,60,29
1715602666590,ECE 111,A01,507420,Staff,11,0,50,39
1715602667620,ECE 197,001,548057,Sievenpiper; Daniel F.,9991,0,9999,8
1715602668647,EDS 115,A00,507243,Choi; Bailey Miyeon,7,0,28,21
1715602669678,EDS 117,A01,494379,Staff,0,6,34,34
1715602670710,EDS 125,A00,507246,Hopkins; Megan Beth,8,0,30,22
1715602671737,EDS 128A,A01,507264,Fargason; Sharon Gayle,6,0,26,20
1715602672768,EDS 128B,A01,507293,Pappas; Elizabeth,10,0,30,20
1715602673794,EDS 139,A00,507294,Fargason; Sharon Gayle,10,0,30,20
1715602673794,EDS 139,B00,507313,Pappas; Elizabeth,11,0,30,19
1715602674825,EDS 201,A00,507315,Staff,10,0,30,20
1715602675852,EDS 203,A01,507317,Halter; Christopher P.,10,0,30,20
1715602676881,EDS 204R,A01,507319,Halter; Christopher P.,0,3,30,30
1715602676881,EDS 204R,B01,507331,Heinzman; Erica M.,14,0,30,16
1715602677911,EDS 206R,A00,507332,Staff,0,4,30,30
1715602677911,EDS 206R,B00,507343,Staff,15,0,30,15
1715602678936,EDS 250,A00,507344,Hemans; Patricia Ann Benitez,20,0,40,20
1715602679964,EDS 281,A00,507345,Daly; Alan J.,18,0,18,0
1715602680991,EDS 284,A00,507350,Daly; Alan J.,16,0,16,0
1715602682018,EDS 286,A00,507359,Fine; Sarah,18,0,18,0
1715602683043,EDS 289C,A01,507361,Daly; Alan J.,18,0,18,0
1715602684072,EDS 290,A00,507366,Hofstetter; Carolyn,15,0,15,0
1715602685104,LIGM 5A,A00,507421,Fischer-Grunski; Eva K,17,0,20,3
1715602686134,LIGM 5B,A00,507423,Fischer-Grunski; Eva K,19,0,20,1
1715602687160,LIGM 5C,A00,507425,Fischer-Grunski; Eva K,19,0,20,1
1715602688190,LIIT 5AS,A00,507427,Carnelos; Chiara,20,0,20,0
1715602689216,LIIT 5BS,A00,507430,Carnelos; Chiara,20,0,20,0
1715602690245,LIIT 5CS,A00,507432,Carnelos; Chiara,20,0,20,0
1715602691275,LISP 5A,A00,507541,Munoz Sanchez; Alicia,11,0,20,9
1715602692306,LISP 5B,A00,507671,Munoz Sanchez; Alicia,9,0,20,11
1715602693335,LISP 5C,A00,507696,Munoz Sanchez; Alicia,9,0,20,11
1715602694366,MAE 197,001,528363,Boechler; Nicholas Sebastia,9998,0,9999,1
1715602695405,MATH 197,001,523477,Kedlaya; Kiran S.,9994,0,9999,5
1715602695405,MATH 197,002,563811,Zhang; Danna,9994,0,9999,5
1715602695405,MATH 197,003,628552,Dumitriu; Ioana,9998,0,9999,1
1715602695405,MATH 197,004,660885,Floyd; Eric,9999,0,9999,0
1715602696431,MCWP 40R,A00,518780,Staff,2,0,20,18
1715602696431,MCWP 40R,B00,518781,Staff,11,0,20,9
1715602696431,MCWP 40R,C00,518783,Staff,5,0,20,15
1715602697459,MCWP 50R,A00,518791,Staff,0,1,20,20
1715602697459,MCWP 50R,B00,518792,Staff,0,2,20,20
1715602697459,MCWP 50R,C00,518793,Staff,0,4,20,20
1715602697459,MCWP 50R,D00,518794,Staff,0,1,20,20
1715602697459,MCWP 50R,E00,518795,Staff,0,2,20,20
1715602697459,MCWP 50R,F00,518796,Staff,0,1,20,20
1715602697459,MCWP 50R,G00,518797,Staff,0,1,20,20
1715602698486,MMW 12R,A01,514034,Herbst; Matthew,0,2,16,16
1715602698486,MMW 12R,A02,514035,Herbst; Matthew,0,0,16,16
1715602699515,MMW 13R,A01,514037,Staff,0,5,16,16
1715602699515,MMW 13R,A02,514039,Staff,0,5,16,16
1715602699515,MMW 13R,A03,628519,Staff,0,4,16,16
1715602701569,SIO 295LS,A00,523233,Staff,10,0,30,20
1715602702597,SIO 295S,A00,523232,Staff,10,0,30,20
1715602703625,SIOC 290S,A01,637330,Merrifield; Mark A,23,0,30,7
1715602704650,SIOC 291S,A01,637333,Gabriel; Corey John,23,0,30,7
1715602705676,SOCI 117,A01,494376,Staff,0,5,5,5
1715602706702,WES 237B,A00,494380,Staff,10,0,20,10
1715602708794,AESE 279B,A00,494370,Wade; Jon P,0,0,33,33
1715602709823,AIP 97,001,660915,Van Den Einde; Yael Dahlia,9999,0,9999,0
1715602710853,AIP 197,001,627712,Vespa; Emanuel Ignacio,9995,0,9999,4
1715602710853,AIP 197,002,650778,Amir; On,9998,0,9999,1
1715602710853,AIP 197,003,650933,Avenancio-Leon; Carlos,9998,0,9999,1
1715602710853,AIP 197,004,658530,Heyman; Gail D.,9998,0,9999,1
1715602710853,AIP 197,005,658631,Neal; Sonya E,9998,0,9999,1
1715602710853,AIP 197,006,658671,Du; Songzi,9998,0,9999,1
1715602711883,ANAR 135S,A00,494369,Braswell; Geoffrey E.,0,0,0,0
1715602712913,BENG 196,001,628496,Engler; Adam J.,9998,0,9999,1
1715602712913,BENG 196,002,660916,Watson; John Thomas,9999,0,9999,0
1715602713943,BISP 197,001,650773,Wilhelm; James E.,9994,0,9999,5
1715602713943,BISP 197,002,658904,Coleman; Aaron B.,9998,0,9999,1
1715602714973,CAT 124RS,A01,519847,Geibel; William,0,0,20,20
1715602716001,CAT 125RS,A01,515971,Geibel; William,0,0,20,20
1715602717031,CLRE 250,A00,511389,Morris; Sheldon,9992,0,9999,7
1715602718064,CLRE 251,A00,507176,Mehta; Ravindra L.,9992,0,9999,7
1715602718064,CLRE 251,B00,511410,Mehta; Ravindra L.,9998,0,9999,1
1715602719092,CLRE 252,A00,507189,Cuomo; Raphael Eduardo,9994,0,9999,5
1715602720119,CLRE 253,A00,507199,Vaida; Florin,9994,0,9999,5
1715602720119,CLRE 253,B00,507202,Vaida; Florin,9999,0,9999,0
1715602721149,CLRE 259,A00,507211,Patel; Hemal,9996,0,9999,3
1715602722175,CLRE 260,A00,507221,Cuomo; Raphael Eduardo,9999,0,9999,0
1715602723204,CLRE 297,001,507242,Cuomo; Raphael Eduardo,9999,0,9999,0
1715602724232,COGS 197,001,638244,Voytek; Bradley Thomas,9997,0,9999,2
1715602725263,CSE 191,A00,516875,Minnes Kemp; Mor Mia,9991,0,9999,8
1715602726290,CSE 197,001,637388,Minnes Kemp; Mor Mia,9992,0,9999,7
1715602727319,CSS 201S,A01,494383,Mignozzetti; Umberto,35,0,35,0
1715602728345,CSS 202S,A01,494387,Mignozzetti; Umberto,35,0,35,0
1715602729379,DSC 197,001,628532,Eldridge; Justin Matthew,9995,0,9999,4
1715602730405,EAP 100,A00,516065,Staff,9799,0,9999,200
1715602731433,ECE 45,A01,507414,Staff,31,0,60,29
1715602733487,ECE 111,A01,507420,Staff,11,0,50,39
1715602734517,ECE 197,001,548057,Sievenpiper; Daniel F.,9991,0,9999,8
1715602735547,EDS 115,A00,507243,Choi; Bailey Miyeon,7,0,28,21
1715602736579,EDS 117,A01,494379,Staff,0,6,34,34
1715602737608,EDS 125,A00,507246,Hopkins; Megan Beth,8,0,30,22
1715602738638,EDS 128A,A01,507264,Fargason; Sharon Gayle,6,0,26,20
1715602739672,EDS 128B,A01,507293,Pappas; Elizabeth,10,0,30,20
1715602740699,EDS 139,A00,507294,Fargason; Sharon Gayle,10,0,30,20
1715602740699,EDS 139,B00,507313,Pappas; Elizabeth,11,0,30,19
1715602741728,EDS 201,A00,507315,Staff,10,0,30,20
1715602742753,EDS 203,A01,507317,Halter; Christopher P.,10,0,30,20
1715602743786,EDS 204R,A01,507319,Halter; Christopher P.,0,3,30,30
1715602743786,EDS 204R,B01,507331,Heinzman; Erica M.,14,0,30,16
1715602744812,EDS 206R,A00,507332,Staff,0,4,30,30
1715602744812,EDS 206R,B00,507343,Staff,15,0,30,15
1715602745840,EDS 250,A00,507344,Hemans; Patricia Ann Benitez,20,0,40,20
1715602746875,EDS 281,A00,507345,Daly; Alan J.,18,0,18,0
1715602747904,EDS 284,A00,507350,Daly; Alan J.,16,0,16,0
1715602748932,EDS 286,A00,507359,Fine; Sarah,18,0,18,0
1715602749963,EDS 289C,A01,507361,Daly; Alan J.,18,0,18,0
1715602750992,EDS 290,A00,507366,Hofstetter; Carolyn,15,0,15,0
1715602752020,LIGM 5A,A00,507421,Fischer-Grunski; Eva K,17,0,20,3
1715602753052,LIGM 5B,A00,507423,Fischer-Grunski; Eva K,19,0,20,1
1715602754078,LIGM 5C,A00,507425,Fischer-Grunski; Eva K,19,0,20,1
1715602755105,LIIT 5AS,A00,507427,Carnelos; Chiara,20,0,20,0
1715602756131,LIIT 5BS,A00,507430,Carnelos; Chiara,20,0,20,0
1715602757158,LIIT 5CS,A00,507432,Carnelos; Chiara,20,0,20,0
1715602758186,LISP 5A,A00,507541,Munoz Sanchez; Alicia,11,0,20,9
1715602759217,LISP 5B,A00,507671,Munoz Sanchez; Alicia,9,0,20,11
1715602760246,LISP 5C,A00,507696,Munoz Sanchez; Alicia,9,0,20,11
1715602761276,MAE 197,001,528363,Boechler; Nicholas Sebastia,9998,0,9999,1
1715602762312,MATH 197,001,523477,Kedlaya; Kiran S.,9994,0,9999,5
1715602762312,MATH 197,002,563811,Zhang; Danna,9994,0,9999,5
1715602762312,MATH 197,003,628552,Dumitriu; Ioana,9998,0,9999,1
1715602762312,MATH 197,004,660885,Floyd; Eric,9999,0,9999,0
1715602763343,MCWP 40R,A00,518780,Staff,2,0,20,18
1715602763343,MCWP 40R,B00,518781,Staff,11,0,20,9
1715602763343,MCWP 40R,C00,518783,Staff,5,0,20,15
1715602764374,MCWP 50R,A00,518791,Staff,0,1,20,20
1715602764374,MCWP 50R,B00,518792,Staff,0,2,20,20
1715602764374,MCWP 50R,C00,518793,Staff,0,4,20,20
1715602764374,MCWP 50R,D00,518794,Staff,0,1,20,20
1715602764374,MCWP 50R,E00,518795,Staff,0,2,20,20
1715602764374,MCWP 50R,F00,518796,Staff,0,1,20,20
1715602764374,MCWP 50R,G00,518797,Staff,0,1,20,20
1715602765402,MMW 12R,A01,514034,Herbst; Matthew,0,2,16,16
1715602765402,MMW 12R,A02,514035,Herbst; Matthew,0,0,16,16
1715602766429,MMW 13R,A01,514037,Staff,0,5,16,16
1715602766429,MMW 13R,A02,514039,Staff,0,5,16,16
1715602766429,MMW 13R,A03,628519,Staff,0,4,16,16
1715602768488,SIO 295LS,A00,523233,Staff,10,0,30,20
1715602769514,SIO 295S,A00,523232,Staff,10,0,30,20
1715602770542,SIOC 290S,A01,637330,Merrifield; Mark A,23,0,30,7
1715602771624,SIOC 291S,A01,637333,Gabriel; Corey John,23,0,30,7
1715602772655,SOCI 117,A01,494376,Staff,0,5,5,5
1715602773681,WES 237B,A00,494380,Staff,10,0,20,10
1715602775758,AESE 279B,A00,494370,Wade; Jon P,0,0,33,33
1715602776783,AIP 97,001,660915,Van Den Einde; Yael Dahlia,9999,0,9999,0
1715602777812,AIP 197,001,627712,Vespa; Emanuel Ignacio,9995,0,9999,4
1715602777812,AIP 197,002,650778,Amir; On,9998,0,9999,1
1715602777812,AIP 197,003,650933,Avenancio-Leon; Carlos,9998,0,9999,1
1715602777812,AIP 197,004,658530,Heyman; Gail D.,9998,0,9999,1
1715602777812,AIP 197,005,658631,Neal; Sonya E,9998,0,9999,1
1715602777812,AIP 197,006,658671,Du; Songzi,9998,0,9999,1
1715602778838,ANAR 135S,A00,494369,Braswell; Geoffrey E.,0,0,0,0
1715602779869,BENG 196,001,628496,Engler; Adam J.,9998,0,9999,1
1715602779869,BENG 196,002,660916,Watson; John Thomas,9999,0,9999,0
1715602780896,BISP 197,001,650773,Wilhelm; James E.,9994,0,9999,5
1715602780896,BISP 197,002,658904,Coleman; Aaron B.,9998,0,9999,1
1715602781929,CAT 124RS,A01,519847,Geibel; William,0,0,20,20
1715602782956,CAT 125RS,A01,515971,Geibel; William,0,0,20,20
1715602783983,CLRE 250,A00,511389,Morris; Sheldon,9992,0,9999,7
1715602785012,CLRE 251,A00,507176,Mehta; Ravindra L.,9992,0,9999,7
1715602785012,CLRE 251,B00,511410,Mehta; Ravindra L.,9998,0,9999,1
1715602786043,CLRE 252,A00,507189,Cuomo; Raphael Eduardo,9994,0,9999,5
1715602787076,CLRE 253,A00,507199,Vaida; Florin,9994,0,9999,5
1715602787076,CLRE 253,B00,507202,Vaida; Florin,9999,0,9999,0
1715602788108,CLRE 259,A00,507211,Patel; Hemal,9996,0,9999,3
1715602789133,CLRE 260,A00,507221,Cuomo; Raphael Eduardo,9999,0,9999,0
1715602790160,CLRE 297,001,507242,Cuomo; Raphael Eduardo,9999,0,9999,0
1715602791191,COGS 197,001,638244,Voytek; Bradley Thomas,9997,0,9999,2
1715602792222,CSE 191,A00,516875,Minnes Kemp; Mor Mia,9991,0,9999,8
1715602793248,CSE 197,001,637388,Minnes Kemp; Mor Mia,9992,0,9999,7
1715602794280,CSS 201S,A01,494383,Mignozzetti; Umberto,35,0,35,0
1715602795311,CSS 202S,A01,494387,Mignozzetti; Umberto,35,0,35,0
1715602796341,DSC 197,001,628532,Eldridge; Justin Matthew,9995,0,9999,4
1715602797369,EAP 100,A00,516065,Staff,9799,0,9999,200
1715602798395,ECE 45,A01,507414,Staff,31,0,60,29
1715602800448,ECE 111,A01,507420,Staff,11,0,50,39
1715602801485,ECE 197,001,548057,Sievenpiper; Daniel F.,9991,0,9999,8
1715602802518,EDS 115,A00,507243,Choi; Bailey Miyeon,7,0,28,21
1715602803550,EDS 117,A01,494379,Staff,0,6,34,34
1715602804579,EDS 125,A00,507246,Hopkins; Megan Beth,8,0,30,22
1715602805611,EDS 128A,A01,507264,Fargason; Sharon Gayle,6,0,26,20
1715602806644,EDS 128B,A01,507293,Pappas; Elizabeth,10,0,30,20
1715602807669,EDS 139,A00,507294,Fargason; Sharon Gayle,10,0,30,20
1715602807669,EDS 139,B00,507313,Pappas; Elizabeth,11,0,30,19
1715602808698,EDS 201,A00,507315,Staff,10,0,30,20
1715602809725,EDS 203,A01,507317,Halter; Christopher P.,10,0,30,20
1715602810752,EDS 204R,A01,507319,Halter; Christopher P.,0,3,30,30
1715602810752,EDS 204R,B01,507331,Heinzman; Erica M.,14,0,30,16
1715602811777,EDS 206R,A00,507332,Staff,0,4,30,30
1715602811777,EDS 206R,B00,507343,Staff,15,0,30,15
1715602812802,EDS 250,A00,507344,Hemans; Patricia Ann Benitez,20,0,40,20
1715602813831,EDS 281,A00,507345,Daly; Alan J.,18,0,18,0
1715602814857,EDS 284,A00,507350,Daly; Alan J.,16,0,16,0
1715602815883,EDS 286,A00,507359,Fine; Sarah,18,0,18,0
1715602816912,EDS 289C,A01,507361,Daly; Alan J.,18,0,18,0
1715602817942,EDS 290,A00,507366,Hofstetter; Carolyn,15,0,15,0
1715602818972,LIGM 5A,A00,507421,Fischer-Grunski; Eva K,17,0,20,3
1715602819998,LIGM 5B,A00,507423,Fischer-Grunski; Eva K,19,0,20,1
1715602821024,LIGM 5C,A00,507425,Fischer-Grunski; Eva K,19,0,20,1
1715602822051,LIIT 5AS,A00,507427,Carnelos; Chiara,20,0,20,0
1715602823076,LIIT 5BS,A00,507430,Carnelos; Chiara,20,0,20,0
1715602824107,LIIT 5CS,A00,507432,Carnelos; Chiara,20,0,20,0
1715602825133,LISP 5A,A00,507541,Munoz Sanchez; Alicia,11,0,20,9
1715602826166,LISP 5B,A00,507671,Munoz Sanchez; Alicia,9,0,20,11
1715602827192,LISP 5C,A00,507696,Munoz Sanchez; Alicia,9,0,20,11
1715602828222,MAE 197,001,528363,Boechler; Nicholas Sebastia,9998,0,9999,1
1715602829254,MATH 197,001,523477,Kedlaya; Kiran S.,9994,0,9999,5
1715602829254,MATH 197,002,563811,Zhang; Danna,9994,0,9999,5
1715602829254,MATH 197,003,628552,Dumitriu; Ioana,9998,0,9999,1
1715602829254,MATH 197,004,660885,Floyd; Eric,9999,0,9999,0
1715602830282,MCWP 40R,A00,518780,Staff,2,0,20,18
1715602830282,MCWP 40R,B00,518781,Staff,11,0,20,9
1715602830282,MCWP 40R,C00,518783,Staff,5,0,20,15
1715602831309,MCWP 50R,A00,518791,Staff,0,1,20,20
1715602831309,MCWP 50R,B00,518792,Staff,0,2,20,20
1715602831309,MCWP 50R,C00,518793,Staff,0,4,20,20
1715602831309,MCWP 50R,D00,518794,Staff,0,1,20,20
1715602831309,MCWP 50R,E00,518795,Staff,0,2,20,20
1715602831309,MCWP 50R,F00,518796,Staff,0,1,20,20
1715602831309,MCWP 50R,G00,518797,Staff,0,1,20,20
1715602832337,MMW 12R,A01,514034,Herbst; Matthew,0,2,16,16
1715602832337,MMW 12R,A02,514035,Herbst; Matthew,0,0,16,16
1715602833371,MMW 13R,A01,514037,Staff,0,5,16,16
1715602833371,MMW 13R,A02,514039,Staff,0,5,16,16
1715602833371,MMW 13R,A03,628519,Staff,0,4,16,16
1715602835425,SIO 295LS,A00,523233,Staff,10,0,30,20
1715602836452,SIO 295S,A00,523232,Staff,10,0,30,20
1715602837480,SIOC 290S,A01,637330,Merrifield; Mark A,23,0,30,7
1715602838510,SIOC 291S,A01,637333,Gabriel; Corey John,23,0,30,7
1715602839538,SOCI 117,A01,494376,Staff,0,5,5,5
1715602840563,WES 237B,A00,494380,Staff,10,0,20,10
1715602842648,AESE 279B,A00,494370,Wade; Jon P,0,0,33,33
1715602843675,AIP 97,001,660915,Van Den Einde; Yael Dahlia,9999,0,9999,0
1715602844706,AIP 197,001,627712,Vespa; Emanuel Ignacio,9995,0,9999,4
1715602844706,AIP 197,002,650778,Amir; On,9998,0,9999,1
1715602844706,AIP 197,003,650933,Avenancio-Leon; Carlos,9998,0,9999,1
1715602844706,AIP 197,004,658530,Heyman; Gail D.,9998,0,9999,1
1715602844706,AIP 197,005,658631,Neal; Sonya E,9998,0,9999,1
1715602844706,AIP 197,006,658671,Du; Songzi,9998,0,9999,1
1715602845731,ANAR 135S,A00,494369,Braswell; Geoffrey E.,0,0,0,0
1715602846762,BENG 196,001,628496,Engler; Adam J.,9998,0,9999,1
1715602846762,BENG 196,002,660916,Watson; John Thomas,9999,0,9999,0
1715602847792,BISP 197,001,650773,Wilhelm; James E.,9994,0,9999,5
1715602847792,BISP 197,002,658904,Coleman; Aaron B.,9998,0,9999,1
1715602848820,CAT 124RS,A01,519847,Geibel; William,0,0,20,20
1715602849844,CAT 125RS,A01,515971,Geibel; William,0,0,20,20
1715602850873,CLRE 250,A00,511389,Morris; Sheldon,9992,0,9999,7
1715602851906,CLRE 251,A00,507176,Mehta; Ravindra L.,9992,0,9999,7
1715602851906,CLRE 251,B00,511410,Mehta; Ravindra L.,9998,0,9999,1
1715602852936,CLRE 252,A00,507189,Cuomo; Raphael Eduardo,9994,0,9999,5
1715602853963,CLRE 253,A00,507199,Vaida; Florin,9994,0,9999,5
1715602853963,CLRE 253,B00,507202,Vaida; Florin,9999,0,9999,0
1715602854994,CLRE 259,A00,507211,Patel; Hemal,9996,0,9999,3
1715602856025,CLRE 260,A00,507221,Cuomo; Raphael Eduardo,9999,0,9999,0
1715602857052,CLRE 297,001,507242,Cuomo; Raphael Eduardo,9999,0,9999,0
1715602858083,COGS 197,001,638244,Voytek; Bradley Thomas,9997,0,9999,2
1715602859109,CSE 191,A00,516875,Minnes Kemp; Mor Mia,9991,0,9999,8
1715602860137,CSE 197,001,637388,Minnes Kemp; Mor Mia,9992,0,9999,7
1715602861166,CSS 201S,A01,494383,Mignozzetti; Umberto,35,0,35,0
1715602862197,CSS 202S,A01,494387,Mignozzetti; Umberto,35,0,35,0
1715602863225,DSC 197,001,628532,Eldridge; Justin Matthew,9995,0,9999,4
1715602864250,EAP 100,A00,516065,Staff,9799,0,9999,200
1715602865279,ECE 45,A01,507414,Staff,31,0,60,29
1715602867334,ECE 111,A01,507420,Staff,11,0,50,39
1715602868358,ECE 197,001,548057,Sievenpiper; Daniel F.,9991,0,9999,8
1715602869389,EDS 115,A00,507243,Choi; Bailey Miyeon,7,0,28,21
1715602870416,EDS 117,A01,494379,Staff,0,6,34,34
1715602871446,EDS 125,A00,507246,Hopkins; Megan Beth,8,0,30,22
1715602872473,EDS 128A,A01,507264,Fargason; Sharon Gayle,6,0,26,20
1715602873499,EDS 128B,A01,507293,Pappas; Elizabeth,10,0,30,20
1715602874525,EDS 139,A00,507294,Fargason; Sharon Gayle,10,0,30,20
1715602874525,EDS 139,B00,507313,Pappas; Elizabeth,11,0,30,19
1715602875608,EDS 201,A00,507315,Staff,10,0,30,20
1715602876634,EDS 203,A01,507317,Halter; Christopher P.,10,0,30,20
1715602877665,EDS 204R,A01,507319,Halter; Christopher P.,0,3,30,30
1715602877665,EDS 204R,B01,507331,Heinzman; Erica M.,14,0,30,16
1715602878694,EDS 206R,A00,507332,Staff,0,4,30,30
1715602878694,EDS 206R,B00,507343,Staff,15,0,30,15
1715602879719,EDS 250,A00,507344,Hemans; Patricia Ann Benitez,20,0,40,20
1715602880746,EDS 281,A00,507345,Daly; Alan J.,18,0,18,0
1715602881776,EDS 284,A00,507350,Daly; Alan J.,16,0,16,0
1715602882802,EDS 286,A00,507359,Fine; Sarah,18,0,18,0
1715602883830,EDS 289C,A01,507361,Daly; Alan J.,18,0,18,0
1715602884857,EDS 290,A00,507366,Hofstetter; Carolyn,15,0,15,0
1715602885884,LIGM 5A,A00,507421,Fischer-Grunski; Eva K,17,0,20,3
1715602886910,LIGM 5B,A00,507423,Fischer-Grunski; Eva K,19,0,20,1
1715602887939,LIGM 5C,A00,507425,Fischer-Grunski; Eva K,19,0,20,1
1715602888968,LIIT 5AS,A00,507427,Carnelos; Chiara,20,0,20,0
1715602889997,LIIT 5BS,A00,507430,Carnelos; Chiara,20,0,20,0
1715602891026,LIIT 5CS,A00,507432,Carnelos; Chiara,20,0,20,0
1715602892052,LISP 5A,A00,507541,Munoz Sanchez; Alicia,11,0,20,9
1715602893078,LISP 5B,A00,507671,Munoz Sanchez; Alicia,9,0,20,11
1715602894108,LISP 5C,A00,507696,Munoz Sanchez; Alicia,9,0,20,11
1715602895139,MAE 197,001,528363,Boechler; Nicholas Sebastia,9998,0,9999,1
1715602896175,MATH 197,001,523477,Kedlaya; Kiran S.,9994,0,9999,5
1715602896175,MATH 197,002,563811,Zhang; Danna,9994,0,9999,5
1715602896175,MATH 197,003,628552,Dumitriu; Ioana,9998,0,9999,1
1715602896175,MATH 197,004,660885,Floyd; Eric,9999,0,9999,0
1715602897204,MCWP 40R,A00,518780,Staff,2,0,20,18
1715602897204,MCWP 40R,B00,518781,Staff,11,0,20,9
1715602897204,MCWP 40R,C00,518783,Staff,5,0,20,15
1715602898231,MCWP 50R,A00,518791,Staff,0,1,20,20
1715602898231,MCWP 50R,B00,518792,Staff,0,2,20,20
1715602898231,MCWP 50R,C00,518793,Staff,0,4,20,20
1715602898231,MCWP 50R,D00,518794,Staff,0,1,20,20
1715602898231,MCWP 50R,E00,518795,Staff,0,2,20,20
1715602898231,MCWP 50R,F00,518796,Staff,0,1,20,20
1715602898231,MCWP 50R,G00,518797,Staff,0,1,20,20
1715602899258,MMW 12R,A01,514034,Herbst; Matthew,0,2,16,16
1715602899258,MMW 12R,A02,514035,Herbst; Matthew,0,0,16,16
1715602900284,MMW 13R,A01,514037,Staff,0,5,16,16
1715602900284,MMW 13R,A02,514039,Staff,0,5,16,16
1715602900284,MMW 13R,A03,628519,Staff,0,4,16,16
1715602902342,SIO 295LS,A00,523233,Staff,10,0,30,20
1715602903371,SIO 295S,A00,523232,Staff,10,0,30,20
1715602904400,SIOC 290S,A01,637330,Merrifield; Mark A,23,0,30,7
1715602905427,SIOC 291S,A01,637333,Gabriel; Corey John,23,0,30,7
1715602906458,SOCI 117,A01,494376,Staff,0,5,5,5
1715602907485,WES 237B,A00,494380,Staff,10,0,20,10
1715602909564,AESE 279B,A00,494370,Wade; Jon P,0,0,33,33
1715602910608,AIP 97,001,660915,Van Den Einde; Yael Dahlia,9999,0,9999,0
1715602911647,AIP 197,001,627712,Vespa; Emanuel Ignacio,9995,0,9999,4
1715602911647,AIP 197,002,650778,Amir; On,9998,0,9999,1
1715602911647,AIP 197,003,650933,Avenancio-Leon; Carlos,9998,0,9999,1
1715602911647,AIP 197,004,658530,Heyman; Gail D.,9998,0,9999,1
1715602911647,AIP 197,005,658631,Neal; Sonya E,9998,0,9999,1
1715602911647,AIP 197,006,658671,Du; Songzi,9998,0,9999,1
1715602912673,ANAR 135S,A00,494369,Braswell; Geoffrey E.,0,0,0,0
1715602913703,BENG 196,001,628496,Engler; Adam J.,9998,0,9999,1
1715602913703,BENG 196,002,660916,Watson; John Thomas,9999,0,9999,0
1715602914731,BISP 197,001,650773,Wilhelm; James E.,9994,0,9999,5
1715602914731,BISP 197,002,658904,Coleman; Aaron B.,9998,0,9999,1
1715602915757,CAT 124RS,A01,519847,Geibel; William,0,0,20,20
1715602916788,CAT 125RS,A01,515971,Geibel; William,0,0,20,20
1715602917816,CLRE 250,A00,511389,Morris; Sheldon,9992,0,9999,7
1715602918851,CLRE 251,A00,507176,Mehta; Ravindra L.,9992,0,9999,7
1715602918851,CLRE 251,B00,511410,Mehta; Ravindra L.,9998,0,9999,1
1715602919878,CLRE 252,A00,507189,Cuomo; Raphael Eduardo,9994,0,9999,5
1715602920905,CLRE 253,A00,507199,Vaida; Florin,9994,0,9999,5
1715602920905,CLRE 253,B00,507202,Vaida; Florin,9999,0,9999,0
1715602921931,CLRE 259,A00,507211,Patel; Hemal,9996,0,9999,3
1715602922961,CLRE 260,A00,507221,Cuomo; Raphael Eduardo,9999,0,9999,0
1715602923987,CLRE 297,001,507242,Cuomo; Raphael Eduardo,9999,0,9999,0
1715602925016,COGS 197,001,638244,Voytek; Bradley Thomas,9997,0,9999,2
1715602926046,CSE 191,A00,516875,Minnes Kemp; Mor Mia,9991,0,9999,8
1715602927076,CSE 197,001,637388,Minnes Kemp; Mor Mia,9992,0,9999,7
1715602928109,CSS 201S,A01,494383,Mignozzetti; Umberto,35,0,35,0
1715602929141,CSS 202S,A01,494387,Mignozzetti; Umberto,35,0,35,0
1715602930172,DSC 197,001,628532,Eldridge; Justin Matthew,9995,0,9999,4
1715602931197,EAP 100,A00,516065,Staff,9799,0,9999,200
1715602932237,ECE 45,A01,507414,Staff,31,0,60,29
1715602934290,ECE 111,A01,507420,Staff,11,0,50,39
1715602935319,ECE 197,001,548057,Sievenpiper; Daniel F.,9991,0,9999,8
1715602936346,EDS 115,A00,507243,Choi; Bailey Miyeon,7,0,28,21
1715602937372,EDS 117,A01,494379,Staff,0,6,34,34
1715602938401,EDS 125,A00,507246,Hopkins; Megan Beth,8,0,30,22
1715602939427,EDS 128A,A01,507264,Fargason; Sharon Gayle,6,0,26,20
1715602940457,EDS 128B,A01,507293,Pappas; Elizabeth,10,0,30,20
1715602941488,EDS 139,A00,507294,Fargason; Sharon Gayle,10,0,30,20
1715602941488,EDS 139,B00,507313,Pappas; Elizabeth,11,0,30,19
1715602942517,EDS 201,A00,507315,Staff,10,0,30,20
1715602943545,EDS 203,A01,507317,Halter; Christopher P.,10,0,30,20
1715602944573,EDS 204R,A01,507319,Halter; Christopher P.,0,3,30,30
1715602944573,EDS 204R,B01,507331,Heinzman; Erica M.,14,0,30,16
1715602945603,EDS 206R,A00,507332,Staff,0,4,30,30
1715602945603,EDS 206R,B00,507343,Staff,15,0,30,15
1715602946634,EDS 250,A00,507344,Hemans; Patricia Ann Benitez,20,0,40,20
1715602947659,EDS 281,A00,507345,Daly; Alan J.,18,0,18,0
1715602948685,EDS 284,A00,507350,Daly; Alan J.,16,0,16,0
1715602949713,EDS 286,A00,507359,Fine; Sarah,18,0,18,0
1715602950739,EDS 289C,A01,507361,Daly; Alan J.,18,0,18,0
1715602951767,EDS 290,A00,507366,Hofstetter; Carolyn,15,0,15,0
1715602952814,LIGM 5A,A00,507421,Fischer-Grunski; Eva K,17,0,20,3
1715602953840,LIGM 5B,A00,507423,Fischer-Grunski; Eva K,19,0,20,1
1715602954866,LIGM 5C,A00,507425,Fischer-Grunski; Eva K,19,0,20,1
1715602955896,LIIT 5AS,A00,507427,Carnelos; Chiara,20,0,20,0
1715602956925,LIIT 5BS,A00,507430,Carnelos; Chiara,20,0,20,0
1715602957949,LIIT 5CS,A00,507432,Carnelos; Chiara,20,0,20,0
1715602958974,LISP 5A,A00,507541,Munoz Sanchez; Alicia,11,0,20,9
1715602960000,LISP 5B,A00,507671,Munoz Sanchez; Alicia,9,0,20,11
1715602961031,LISP 5C,A00,507696,Munoz Sanchez; Alicia,9,0,20,11
1715602962058,MAE 197,001,528363,Boechler; Nicholas Sebastia,9998,0,9999,1
1715602963092,MATH 197,001,523477,Kedlaya; Kiran S.,9994,0,9999,5
1715602963092,MATH 197,002,563811,Zhang; Danna,9994,0,9999,5
1715602963092,MATH 197,003,628552,Dumitriu; Ioana,9998,0,9999,1
1715602963092,MATH 197,004,660885,Floyd; Eric,9999,0,9999,0
1715602964117,MCWP 40R,A00,518780,Staff,2,0,20,18
1715602964117,MCWP 40R,B00,518781,Staff,11,0,20,9
1715602964117,MCWP 40R,C00,518783,Staff,5,0,20,15
1715602965142,MCWP 50R,A00,518791,Staff,0,1,20,20
1715602965142,MCWP 50R,B00,518792,Staff,0,2,20,20
1715602965142,MCWP 50R,C00,518793,Staff,0,4,20,20
1715602965142,MCWP 50R,D00,518794,Staff,0,1,20,20
1715602965142,MCWP 50R,E00,518795,Staff,0,2,20,20
1715602965142,MCWP 50R,F00,518796,Staff,0,1,20,20
1715602965142,MCWP 50R,G00,518797,Staff,0,1,20,20
1715602966172,MMW 12R,A01,514034,Herbst; Matthew,0,2,16,16
1715602966172,MMW 12R,A02,514035,Herbst; Matthew,0,0,16,16
1715602967197,MMW 13R,A01,514037,Staff,0,5,16,16
1715602967197,MMW 13R,A02,514039,Staff,0,5,16,16
1715602967197,MMW 13R,A03,628519,Staff,0,4,16,16
1715602969252,SIO 295LS,A00,523233,Staff,10,0,30,20
1715602970278,SIO 295S,A00,523232,Staff,10,0,30,20
1715602971308,SIOC 290S,A01,637330,Merrifield; Mark A,23,0,30,7
1715602972340,SIOC 291S,A01,637333,Gabriel; Corey John,23,0,30,7
1715602973368,SOCI 117,A01,494376,Staff,0,5,5,5
1715602974394,WES 237B,A00,494380,Staff,10,0,20,10
1715602976469,AESE 279B,A00,494370,Wade; Jon P,0,0,33,33
1715602977496,AIP 97,001,660915,Van Den Einde; Yael Dahlia,9999,0,9999,0
1715602978525,AIP 197,001,627712,Vespa; Emanuel Ignacio,9995,0,9999,4
1715602978525,AIP 197,002,650778,Amir; On,9998,0,9999,1
1715602978525,AIP 197,003,650933,Avenancio-Leon; Carlos,9998,0,9999,1
1715602978525,AIP 197,004,658530,Heyman; Gail D.,9998,0,9999,1
1715602978525,AIP 197,005,658631,Neal; Sonya E,9998,0,9999,1
1715602978525,AIP 197,006,658671,Du; Songzi,9998,0,9999,1
1715602979555,ANAR 135S,A00,494369,Braswell; Geoffrey E.,0,0,0,0
1715602980587,BENG 196,001,628496,Engler; Adam J.,9998,0,9999,1
1715602980587,BENG 196,002,660916,Watson; John Thomas,9999,0,9999,0
1715602981614,BISP 197,001,650773,Wilhelm; James E.,9994,0,9999,5
1715602981614,BISP 197,002,658904,Coleman; Aaron B.,9998,0,9999,1
1715602982643,CAT 124RS,A01,519847,Geibel; William,0,0,20,20
1715602983673,CAT 125RS,A01,515971,Geibel; William,0,0,20,20
1715602984703,CLRE 250,A00,511389,Morris; Sheldon,9992,0,9999,7
1715602985732,CLRE 251,A00,507176,Mehta; Ravindra L.,9992,0,9999,7
1715602985732,CLRE 251,B00,511410,Mehta; Ravindra L.,9998,0,9999,1
1715602986759,CLRE 252,A00,507189,Cuomo; Raphael Eduardo,9994,0,9999,5
1715602987786,CLRE 253,A00,507199,Vaida; Florin,9994,0,9999,5
1715602987786,CLRE 253,B00,507202,Vaida; Florin,9999,0,9999,0
1715602988812,CLRE 259,A00,507211,Patel; Hemal,9996,0,9999,3
1715602989841,CLRE 260,A00,507221,Cuomo; Raphael Eduardo,9999,0,9999,0
1715602990869,CLRE 297,001,507242,Cuomo; Raphael Eduardo,9999,0,9999,0
1715602991894,COGS 197,001,638244,Voytek; Bradley Thomas,9997,0,9999,2
1715602992924,CSE 191,A00,516875,Minnes Kemp; Mor Mia,9991,0,9999,8
1715602993949,CSE 197,001,637388,Minnes Kemp; Mor Mia,9992,0,9999,7
1715602994977,CSS 201S,A01,494383,Mignozzetti; Umberto,35,0,35,0
1715602996002,CSS 202S,A01,494387,Mignozzetti; Umberto,35,0,35,0
1715602997028,DSC 197,001,628532,Eldridge; Justin Matthew,9995,0,9999,4
1715602998053,EAP 100,A00,516065,Staff,9799,0,9999,200
1715602999083,ECE 45,A01,507414,Staff,31,0,60,29
1715603001144,ECE 111,A01,507420,Staff,11,0,50,39
1715603002175,ECE 197,001,548057,Sievenpiper; Daniel F.,9991,0,9999,8
1715603003204,EDS 115,A00,507243,Choi; Bailey Miyeon,7,0,28,21
1715603004236,EDS 117,A01,494379,Staff,0,6,34,34
1715603005268,EDS 125,A00,507246,Hopkins; Megan Beth,8,0,30,22
1715603006295,EDS 128A,A01,507264,Fargason; Sharon Gayle,6,0,26,20
1715603007328,EDS 128B,A01,507293,Pappas; Elizabeth,10,0,30,20
1715603008358,EDS 139,A00,507294,Fargason; Sharon Gayle,10,0,30,20
1715603008358,EDS 139,B00,507313,Pappas; Elizabeth,11,0,30,19
1715603009384,EDS 201,A00,507315,Staff,10,0,30,20
1715603010416,EDS 203,A01,507317,Halter; Christopher P.,10,0,30,20
1715603011445,EDS 204R,A01,507319,Halter; Christopher P.,0,3,30,30
1715603011445,EDS 204R,B01,507331,Heinzman; Erica M.,14,0,30,16
1715603012473,EDS 206R,A00,507332,Staff,0,4,30,30
1715603012473,EDS 206R,B00,507343,Staff,15,0,30,15
1715603013500,EDS 250,A00,507344,Hemans; Patricia Ann Benitez,20,0,40,20
1715603014529,EDS 281,A00,507345,Daly; Alan J.,18,0,18,0
1715603015558,EDS 284,A00,507350,Daly; Alan J.,16,0,16,0
1715603016644,EDS 286,A00,507359,Fine; Sarah,18,0,18,0
1715603017672,EDS 289C,A01,507361,Daly; Alan J.,18,0,18,0
1715603018700,EDS 290,A00,507366,Hofstetter; Carolyn,15,0,15,0
1715603019728,LIGM 5A,A00,507421,Fischer-Grunski; Eva K,17,0,20,3
1715603020755,LIGM 5B,A00,507423,Fischer-Grunski; Eva K,19,0,20,1
1715603021786,LIGM 5C,A00,507425,Fischer-Grunski; Eva K,19,0,20,1
1715603022813,LIIT 5AS,A00,507427,Carnelos; Chiara,20,0,20,0
1715603023839,LIIT 5BS,A00,507430,Carnelos; Chiara,20,0,20,0
1715603024867,LIIT 5CS,A00,507432,Carnelos; Chiara,20,0,20,0
1715603025899,LISP 5A,A00,507541,Munoz Sanchez; Alicia,11,0,20,9
1715603026924,LISP 5B,A00,507671,Munoz Sanchez; Alicia,9,0,20,11
1715603027952,LISP 5C,A00,507696,Munoz Sanchez; Alicia,9,0,20,11
1715603028982,MAE 197,001,528363,Boechler; Nicholas Sebastia,9998,0,9999,1
1715603030011,MATH 197,001,523477,Kedlaya; Kiran S.,9994,0,9999,5
1715603030011,MATH 197,002,563811,Zhang; Danna,9994,0,9999,5
1715603030011,MATH 197,003,628552,Dumitriu; Ioana,9998,0,9999,1
1715603030011,MATH 197,004,660885,Floyd; Eric,9999,0,9999,0
1715603031040,MCWP 40R,A00,518780,Staff,2,0,20,18
1715603031040,MCWP 40R,B00,518781,Staff,11,0,20,9
1715603031040,MCWP 40R,C00,518783,Staff,5,0,20,15
1715603032072,MCWP 50R,A00,518791,Staff,0,1,20,20
1715603032072,MCWP 50R,B00,518792,Staff,0,2,20,20
1715603032072,MCWP 50R,C00,518793,Staff,0,4,20,20
1715603032072,MCWP 50R,D00,518794,Staff,0,1,20,20
1715603032072,MCWP 50R,E00,518795,Staff,0,2,20,20
1715603032072,MCWP 50R,F00,518796,Staff,0,1,20,20
1715603032072,MCWP 50R,G00,518797,Staff,0,1,20,20
1715603033100,MMW 12R,A01,514034,Herbst; Matthew,0,2,16,16
1715603033100,MMW 12R,A02,514035,Herbst; Matthew,0,0,16,16
1715603034131,MMW 13R,A01,514037,Staff,0,5,16,16
1715603034131,MMW 13R,A02,514039,Staff,0,5,16,16
1715603034131,MMW 13R,A03,628519,Staff,0,4,16,16
1715603036185,SIO 295LS,A00,523233,Staff,10,0,30,20
1715603037210,SIO 295S,A00,523232,Staff,10,0,30,20
1715603038240,SIOC 290S,A01,637330,Merrifield; Mark A,23,0,30,7
1715603039267,SIOC 291S,A01,637333,Gabriel; Corey John,23,0,30,7
1715603040296,SOCI 117,A01,494376,Staff,0,5,5,5
1715603041325,WES 237B,A00,494380,Staff,10,0,20,10
1715603043411,AESE 279B,A00,494370,Wade; Jon P,0,0,33,33
1715603044439,AIP 97,001,660915,Van Den Einde; Yael Dahlia,9999,0,9999,0
1715603045478,AIP 197,001,627712,Vespa; Emanuel Ignacio,9995,0,9999,4
1715603045478,AIP 197,002,650778,Amir; On,9998,0,9999,1
1715603045478,AIP 197,003,650933,Avenancio-Leon; Carlos,9998,0,9999,1
1715603045478,AIP 197,004,658530,Heyman; Gail D.,9998,0,9999,1
1715603045478,AIP 197,005,658631,Neal; Sonya E,9998,0,9999,1
1715603045478,AIP 197,006,658671,Du; Songzi,9998,0,9999,1
1715603046510,ANAR 135S,A00,494369,Braswell; Geoffrey E.,0,0,0,0
1715603047537,BENG 196,001,628496,Engler; Adam J.,9998,0,9999,1
1715603047537,BENG 196,002,660916,Watson; John Thomas,9999,0,9999,0
1715603048564,BISP 197,001,650773,Wilhelm; James E.,9994,0,9999,5
1715603048564,BISP 197,002,658904,Coleman; Aaron B.,9998,0,9999,1
1715603049592,CAT 124RS,A01,519847,Geibel; William,0,0,20,20
1715603050623,CAT 125RS,A01,515971,Geibel; William,0,0,20,20
1715603051655,CLRE 250,A00,511389,Morris; Sheldon,9992,0,9999,7
1715603052685,CLRE 251,A00,507176,Mehta; Ravindra L.,9992,0,9999,7
1715603052685,CLRE 251,B00,511410,Mehta; Ravindra L.,9998,0,9999,1
1715603053717,CLRE 252,A00,507189,Cuomo; Raphael Eduardo,9994,0,9999,5
1715603054749,CLRE 253,A00,507199,Vaida; Florin,9994,0,9999,5
1715603054749,CLRE 253,B00,507202,Vaida; Florin,9999,0,9999,0
1715603055775,CLRE 259,A00,507211,Patel; Hemal,9996,0,9999,3
1715603056801,CLRE 260,A00,507221,Cuomo; Raphael Eduardo,9999,0,9999,0
1715603057829,CLRE 297,001,507242,Cuomo; Raphael Eduardo,9999,0,9999,0
1715603058860,COGS 197,001,638244,Voytek; Bradley Thomas,9997,0,9999,2
1715603059884,CSE 191,A00,516875,Minnes Kemp; Mor Mia,9991,0,9999,8
1715603060910,CSE 197,001,637388,Minnes Kemp; Mor Mia,9992,0,9999,7
1715603061940,CSS 201S,A01,494383,Mignozzetti; Umberto,35,0,35,0
1715603062972,CSS 202S,A01,494387,Mignozzetti; Umberto,35,0,35,0
1715603064002,DSC 197,001,628532,Eldridge; Justin Matthew,9995,0,9999,4
1715603065030,EAP 100,A00,516065,Staff,9799,0,9999,200
1715603066066,ECE 45,A01,507414,Staff,31,0,60,29
1715603068120,ECE 111,A01,507420,Staff,11,0,50,39
1715603069149,ECE 197,001,548057,Sievenpiper; Daniel F.,9991,0,9999,8
1715603070182,EDS 115,A00,507243,Choi; Bailey Miyeon,7,0,28,21
1715603071209,EDS 117,A01,494379,Staff,0,6,34,34
1715603072237,EDS 125,A00,507246,Hopkins; Megan Beth,8,0,30,22
1715603073263,EDS 128A,A01,507264,Fargason; Sharon Gayle,6,0,26,20
1715603074295,EDS 128B,A01,507293,Pappas; Elizabeth,10,0,30,20
1715603075325,EDS 139,A00,507294,Fargason; Sharon Gayle,10,0,30,20
1715603075325,EDS 139,B00,507313,Pappas; Elizabeth,11,0,30,19
1715603076353,EDS 201,A00,507315,Staff,10,0,30,20
1715603077383,EDS 203,A01,507317,Halter; Christopher P.,10,0,30,20
1715603078411,EDS 204R,A01,507319,Halter; Christopher P.,0,3,30,30
1715603078411,EDS 204R,B01,507331,Heinzman; Erica M.,14,0,30,16
1715603079440,EDS 206R,A00,507332,Staff,0,4,30,30
1715603079440,EDS 206R,B00,507343,Staff,15,0,30,15
1715603080469,EDS 250,A00,507344,Hemans; Patricia Ann Benitez,20,0,40,20
1715603081497,EDS 281,A00,507345,Daly; Alan J.,18,0,18,0
1715603082524,EDS 284,A00,507350,Daly; Alan J.,16,0,16,0
1715603083557,EDS 286,A00,507359,Fine; Sarah,18,0,18,0
1715603084590,EDS 289C,A01,507361,Daly; Alan J.,18,0,18,0
1715603085620,EDS 290,A00,507366,Hofstetter; Carolyn,15,0,15,0
1715603086650,LIGM 5A,A00,507421,Fischer-Grunski; Eva K,17,0,20,3
1715603087676,LIGM 5B,A00,507423,Fischer-Grunski; Eva K,19,0,20,1
1715603088703,LIGM 5C,A00,507425,Fischer-Grunski; Eva K,19,0,20,1
1715603089733,LIIT 5AS,A00,507427,Carnelos; Chiara,20,0,20,0
1715603090761,LIIT 5BS,A00,507430,Carnelos; Chiara,20,0,20,0
1715603091788,LIIT 5CS,A00,507432,Carnelos; Chiara,20,0,20,0
1715603092820,LISP 5A,A00,507541,Munoz Sanchez; Alicia,11,0,20,9
1715603093850,LISP 5B,A00,507671,Munoz Sanchez; Alicia,9,0,20,11
1715603094879,LISP 5C,A00,507696,Munoz Sanchez; Alicia,9,0,20,11
1715603095908,MAE 197,001,528363,Boechler; Nicholas Sebastia,9998,0,9999,1
1715603096942,MATH 197,001,523477,Kedlaya; Kiran S.,9994,0,9999,5
1715603096942,MATH 197,002,563811,Zhang; Danna,9994,0,9999,5
1715603096942,MATH 197,003,628552,Dumitriu; Ioana,9998,0,9999,1
1715603096942,MATH 197,004,660885,Floyd; Eric,9999,0,9999,0
1715603097971,MCWP 40R,A00,518780,Staff,2,0,20,18
1715603097971,MCWP 40R,B00,518781,Staff,11,0,20,9
1715603097971,MCWP 40R,C00,518783,Staff,5,0,20,15
1715603098998,MCWP 50R,A00,518791,Staff,0,1,20,20
1715603098998,MCWP 50R,B00,518792,Staff,0,2,20,20
1715603098998,MCWP 50R,C00,518793,Staff,0,4,20,20
1715603098998,MCWP 50R,D00,518794,Staff,0,1,20,20
1715603098998,MCWP 50R,E00,518795,Staff,0,2,20,20
1715603098998,MCWP 50R,F00,518796,Staff,0,1,20,20
1715603098998,MCWP 50R,G00,518797,Staff,0,1,20,20
1715603100030,MMW 12R,A01,514034,Herbst; Matthew,0,2,16,16
1715603100030,MMW 12R,A02,514035,Herbst; Matthew,0,0,16,16
1715603101058,MMW 13R,A01,514037,Staff,0,5,16,16
1715603101058,MMW 13R,A02,514039,Staff,0,5,16,16
1715603101058,MMW 13R,A03,628519,Staff,0,4,16,16
1715603103112,SIO 295LS,A00,523233,Staff,10,0,30,20
1715603104138,SIO 295S,A00,523232,Staff,10,0,30,20
1715603105167,SIOC 290S,A01,637330,Merrifield; Mark A,23,0,30,7
1715603106194,SIOC 291S,A01,637333,Gabriel; Corey John,23,0,30,7
1715603107227,SOCI 117,A01,494376,Staff,0,5,5,5
1715603108256,WES 237B,A00,494380,Staff,10,0,20,10
1715603110371,AESE 279B,A00,494370,Wade; Jon P,0,0,33,33
1715603111400,AIP 97,001,660915,Van Den Einde; Yael Dahlia,9999,0,9999,0
1715603112429,AIP 197,001,627712,Vespa; Emanuel Ignacio,9995,0,9999,4
1715603112429,AIP 197,002,650778,Amir; On,9998,0,9999,1
1715603112429,AIP 197,003,650933,Avenancio-Leon; Carlos,9998,0,9999,1
1715603112429,AIP 197,004,658530,Heyman; Gail D.,9998,0,9999,1
1715603112429,AIP 197,005,658631,Neal; Sonya E,9998,0,9999,1
1715603112429,AIP 197,006,658671,Du; Songzi,9998,0,9999,1
1715603113455,ANAR 135S,A00,494369,Braswell; Geoffrey E.,0,0,0,0
1715603114481,BENG 196,001,628496,Engler; Adam J.,9998,0,9999,1
1715603114481,BENG 196,002,660916,Watson; John Thomas,9999,0,9999,0
1715603115511,BISP 197,001,650773,Wilhelm; James E.,9994,0,9999,5
1715603115511,BISP 197,002,658904,Coleman; Aaron B.,9998,0,9999,1
1715603116541,CAT 124RS,A01,519847,Geibel; William,0,0,20,20
1715603117567,CAT 125RS,A01,515971,Geibel; William,0,0,20,20
1715603118593,CLRE 250,A00,511389,Morris; Sheldon,9992,0,9999,7
1715603119621,CLRE 251,A00,507176,Mehta; Ravindra L.,9992,0,9999,7
1715603119621,CLRE 251,B00,511410,Mehta; Ravindra L.,9998,0,9999,1
1715603120646,CLRE 252,A00,507189,Cuomo; Raphael Eduardo,9994,0,9999,5
1715603121677,CLRE 253,A00,507199,Vaida; Florin,9994,0,9999,5
1715603121677,CLRE 253,B00,507202,Vaida; Florin,9999,0,9999,0
1715603122704,CLRE 259,A00,507211,Patel; Hemal,9996,0,9999,3
1715603123731,CLRE 260,A00,507221,Cuomo; Raphael Eduardo,9999,0,9999,0
1715603124758,CLRE 297,001,507242,Cuomo; Raphael Eduardo,9999,0,9999,0
1715603125785,COGS 197,001,638244,Voytek; Bradley Thomas,9997,0,9999,2
1715603126814,CSE 191,A00,516875,Minnes Kemp; Mor Mia,9991,0,9999,8
1715603127841,CSE 197,001,637388,Minnes Kemp; Mor Mia,9992,0,9999,7
1715603128867,CSS 201S,A01,494383,Mignozzetti; Umberto,35,0,35,0
1715603129897,CSS 202S,A01,494387,Mignozzetti; Umberto,35,0,35,0
1715603130926,DSC 197,001,628532,Eldridge; Justin Matthew,9995,0,9999,4
1715603131969,EAP 100,A00,516065,Staff,9799,0,9999,200
1715603133003,ECE 45,A01,507414,Staff,31,0,60,29
1715603135065,ECE 111,A01,507420,Staff,11,0,50,39
1715603136089,ECE 197,001,548057,Sievenpiper; Daniel F.,9991,0,9999,8
1715603137116,EDS 115,A00,507243,Choi; Bailey Miyeon,7,0,28,21
1715603138148,EDS 117,A01,494379,Staff,0,6,34,34
1715603139175,EDS 125,A00,507246,Hopkins; Megan Beth,8,0,30,22
1715603140201,EDS 128A,A01,507264,Fargason; Sharon Gayle,6,0,26,20
1715603141229,EDS 128B,A01,507293,Pappas; Elizabeth,10,0,30,20
1715603142255,EDS 139,A00,507294,Fargason; Sharon Gayle,10,0,30,20
1715603142255,EDS 139,B00,507313,Pappas; Elizabeth,11,0,30,19
1715603143282,EDS 201,A00,507315,Staff,10,0,30,20
1715603144308,EDS 203,A01,507317,Halter; Christopher P.,10,0,30,20
1715603145341,EDS 204R,A01,507319,Halter; Christopher P.,0,3,30,30
1715603145341,EDS 204R,B01,507331,Heinzman; Erica M.,14,0,30,16
1715603146367,EDS 206R,A00,507332,Staff,0,4,30,30
1715603146367,EDS 206R,B00,507343,Staff,15,0,30,15
1715603147393,EDS 250,A00,507344,Hemans; Patricia Ann Benitez,20,0,40,20
1715603148421,EDS 281,A00,507345,Daly; Alan J.,18,0,18,0
1715603149450,EDS 284,A00,507350,Daly; Alan J.,16,0,16,0
1715603150481,EDS 286,A00,507359,Fine; Sarah,18,0,18,0
1715603151511,EDS 289C,A01,507361,Daly; Alan J.,18,0,18,0
1715603152538,EDS 290,A00,507366,Hofstetter; Carolyn,15,0,15,0
1715603153565,LIGM 5A,A00,507421,Fischer-Grunski; Eva K,17,0,20,3
1715603154591,LIGM 5B,A00,507423,Fischer-Grunski; Eva K,19,0,20,1
1715603155616,LIGM 5C,A00,507425,Fischer-Grunski; Eva K,19,0,20,1
1715603156647,LIIT 5AS,A00,507427,Carnelos; Chiara,20,0,20,0
1715603157674,LIIT 5BS,A00,507430,Carnelos; Chiara,20,0,20,0
1715603158699,LIIT 5CS,A00,507432,Carnelos; Chiara,20,0,20,0
1715603159732,LISP 5A,A00,507541,Munoz Sanchez; Alicia,11,0,20,9
1715603160767,LISP 5B,A00,507671,Munoz Sanchez; Alicia,9,0,20,11
1715603161796,LISP 5C,A00,507696,Munoz Sanchez; Alicia,9,0,20,11
1715603162827,MAE 197,001,528363,Boechler; Nicholas Sebastia,9998,0,9999,1
1715603163855,MATH 197,001,523477,Kedlaya; Kiran S.,9994,0,9999,5
1715603163855,MATH 197,002,563811,Zhang; Danna,9994,0,9999,5
1715603163855,MATH 197,003,628552,Dumitriu; Ioana,9998,0,9999,1
1715603163855,MATH 197,004,660885,Floyd; Eric,9999,0,9999,0
1715603164885,MCWP 40R,A00,518780,Staff,2,0,20,18
1715603164885,MCWP 40R,B00,518781,Staff,11,0,20,9
1715603164885,MCWP 40R,C00,518783,Staff,5,0,20,15
1715603165917,MCWP 50R,A00,518791,Staff,0,1,20,20
1715603165917,MCWP 50R,B00,518792,Staff,0,2,20,20
1715603165917,MCWP 50R,C00,518793,Staff,0,4,20,20
1715603165917,MCWP 50R,D00,518794,Staff,0,1,20,20
1715603165917,MCWP 50R,E00,518795,Staff,0,2,20,20
1715603165917,MCWP 50R,F00,518796,Staff,0,1,20,20
1715603165917,MCWP 50R,G00,518797,Staff,0,1,20,20
1715603166948,MMW 12R,A01,514034,Herbst; Matthew,0,2,16,16
1715603166948,MMW 12R,A02,514035,Herbst; Matthew,0,0,16,16
1715603167981,MMW 13R,A01,514037,Staff,0,5,16,16
1715603167981,MMW 13R,A02,514039,Staff,0,5,16,16
1715603167981,MMW 13R,A03,628519,Staff,0,4,16,16
1715603170034,SIO 295LS,A00,523233,Staff,10,0,30,20
1715603171063,SIO 295S,A00,523232,Staff,10,0,30,20
1715603172090,SIOC 290S,A01,637330,Merrifield; Mark A,23,0,30,7
1715603173118,SIOC 291S,A01,637333,Gabriel; Corey John,23,0,30,7
1715603174143,SOCI 117,A01,494376,Staff,0,5,5,5
1715603175171,WES 237B,A00,494380,Staff,10,0,20,10
1715603177245,AESE 279B,A00,494370,Wade; Jon P,0,0,33,33
1715603178275,AIP 97,001,660915,Van Den Einde; Yael Dahlia,9999,0,9999,0
1715603179306,AIP 197,001,627712,Vespa; Emanuel Ignacio,9995,0,9999,4
1715603179306,AIP 197,002,650778,Amir; On,9998,0,9999,1
1715603179306,AIP 197,003,650933,Avenancio-Leon; Carlos,9998,0,9999,1
1715603179306,AIP 197,004,658530,Heyman; Gail D.,9998,0,9999,1
1715603179306,AIP 197,005,658631,Neal; Sonya E,9998,0,9999,1
1715603179306,AIP 197,006,658671,Du; Songzi,9998,0,9999,1
1715603180333,ANAR 135S,A00,494369,Braswell; Geoffrey E.,0,0,0,0
1715603181359,BENG 196,001,628496,Engler; Adam J.,9998,0,9999,1
1715603181359,BENG 196,002,660916,Watson; John Thomas,9999,0,9999,0
1715603182403,BISP 197,001,650773,Wilhelm; James E.,9994,0,9999,5
1715603182403,BISP 197,002,658904,Coleman; Aaron B.,9998,0,9999,1
1715603183428,CAT 124RS,A01,519847,Geibel; William,0,0,20,20
1715603184458,CAT 125RS,A01,515971,Geibel; William,0,0,20,20
1715603185485,CLRE 250,A00,511389,Morris; Sheldon,9992,0,9999,7
1715603186519,CLRE 251,A00,507176,Mehta; Ravindra L.,9992,0,9999,7
1715603186519,CLRE 251,B00,511410,Mehta; Ravindra L.,9998,0,9999,1
1715603187547,CLRE 252,A00,507189,Cuomo; Raphael Eduardo,9994,0,9999,5
1715603188575,CLRE 253,A00,507199,Vaida; Florin,9994,0,9999,5
1715603188575,CLRE 253,B00,507202,Vaida; Florin,9999,0,9999,0
1715603189606,CLRE 259,A00,507211,Patel; Hemal,9996,0,9999,3
1715603190632,CLRE 260,A00,507221,Cuomo; Raphael Eduardo,9999,0,9999,0
1715603191662,CLRE 297,001,507242,Cuomo; Raphael Eduardo,9999,0,9999,0
1715603192687,COGS 197,001,638244,Voytek; Bradley Thomas,9997,0,9999,2
1715603193715,CSE 191,A00,516875,Minnes Kemp; Mor Mia,9991,0,9999,8
1715603194740,CSE 197,001,637388,Minnes Kemp; Mor Mia,9992,0,9999,7
1715603195766,CSS 201S,A01,494383,Mignozzetti; Umberto,35,0,35,0
1715603196797,CSS 202S,A01,494387,Mignozzetti; Umberto,35,0,35,0
1715603197822,DSC 197,001,628532,Eldridge; Justin Matthew,9995,0,9999,4
1715603198850,EAP 100,A00,516065,Staff,9799,0,9999,200
1715603199880,ECE 45,A01,507414,Staff,31,0,60,29
1715603201946,ECE 111,A01,507420,Staff,11,0,50,39
1715603202972,ECE 197,001,548057,Sievenpiper; Daniel F.,9991,0,9999,8
1715603203999,EDS 115,A00,507243,Choi; Bailey Miyeon,7,0,28,21
1715603205031,EDS 117,A01,494379,Staff,0,6,34,34
1715603206057,EDS 125,A00,507246,Hopkins; Megan Beth,8,0,30,22
1715603207083,EDS 128A,A01,507264,Fargason; Sharon Gayle,6,0,26,20
1715603208109,EDS 128B,A01,507293,Pappas; Elizabeth,10,0,30,20
1715603209137,EDS 139,A00,507294,Fargason; Sharon Gayle,10,0,30,20
1715603209137,EDS 139,B00,507313,Pappas; Elizabeth,11,0,30,19
1715603210166,EDS 201,A00,507315,Staff,10,0,30,20
1715603211197,EDS 203,A01,507317,Halter; Christopher P.,10,0,30,20
1715603212225,EDS 204R,A01,507319,Halter; Christopher P.,0,3,30,30
1715603212225,EDS 204R,B01,507331,Heinzman; Erica M.,14,0,30,16
1715603213334,EDS 206R,A00,507332,Staff,0,4,30,30
1715603213334,EDS 206R,B00,507343,Staff,15,0,30,15
1715603214363,EDS 250,A00,507344,Hemans; Patricia Ann Benitez,20,0,40,20
1715603215389,EDS 281,A00,507345,Daly; Alan J.,18,0,18,0
1715603216415,EDS 284,A00,507350,Daly; Alan J.,16,0,16,0
1715603217445,EDS 286,A00,507359,Fine; Sarah,18,0,18,0
1715603218470,EDS 289C,A01,507361,Daly; Alan J.,18,0,18,0
1715603219496,EDS 290,A00,507366,Hofstetter; Carolyn,15,0,15,0
1715603220528,LIGM 5A,A00,507421,Fischer-Grunski; Eva K,17,0,20,3
1715603221556,LIGM 5B,A00,507423,Fischer-Grunski; Eva K,19,0,20,1
1715603222583,LIGM 5C,A00,507425,Fischer-Grunski; Eva K,19,0,20,1
1715603223611,LIIT 5AS,A00,507427,Carnelos; Chiara,20,0,20,0
1715603224640,LIIT 5BS,A00,507430,Carnelos; Chiara,20,0,20,0
1715603225667,LIIT 5CS,A00,507432,Carnelos; Chiara,20,0,20,0
1715603226695,LISP 5A,A00,507541,Munoz Sanchez; Alicia,11,0,20,9
1715603227719,LISP 5B,A00,507671,Munoz Sanchez; Alicia,9,0,20,11
1715603228746,LISP 5C,A00,507696,Munoz Sanchez; Alicia,9,0,20,11
1715603229773,MAE 197,001,528363,Boechler; Nicholas Sebastia,9998,0,9999,1
1715603230811,MATH 197,001,523477,Kedlaya; Kiran S.,9994,0,9999,5
1715603230811,MATH 197,002,563811,Zhang; Danna,9994,0,9999,5
1715603230811,MATH 197,003,628552,Dumitriu; Ioana,9998,0,9999,1
1715603230811,MATH 197,004,660885,Floyd; Eric,9999,0,9999,0
1715603231838,MCWP 40R,A00,518780,Staff,2,0,20,18
1715603231838,MCWP 40R,B00,518781,Staff,11,0,20,9
1715603231838,MCWP 40R,C00,518783,Staff,5,0,20,15
1715603232864,MCWP 50R,A00,518791,Staff,0,1,20,20
1715603232864,MCWP 50R,B00,518792,Staff,0,2,20,20
1715603232864,MCWP 50R,C00,518793,Staff,0,4,20,20
1715603232864,MCWP 50R,D00,518794,Staff,0,1,20,20
1715603232864,MCWP 50R,E00,518795,Staff,0,2,20,20
1715603232864,MCWP 50R,F00,518796,Staff,0,1,20,20
1715603232864,MCWP 50R,G00,518797,Staff,0,1,20,20
1715603233898,MMW 12R,A01,514034,Herbst; Matthew,0,2,16,16
1715603233898,MMW 12R,A02,514035,Herbst; Matthew,0,0,16,16
1715603234930,MMW 13R,A01,514037,Staff,0,5,16,16
1715603234930,MMW 13R,A02,514039,Staff,0,5,16,16
1715603234930,MMW 13R,A03,628519,Staff,0,4,16,16
1715603236990,SIO 295LS,A00,523233,Staff,10,0,30,20
1715603238017,SIO 295S,A00,523232,Staff,10,0,30,20
1715603239046,SIOC 290S,A01,637330,Merrifield; Mark A,23,0,30,7
1715603240072,SIOC 291S,A01,637333,Gabriel; Corey John,23,0,30,7
1715603241098,SOCI 117,A01,494376,Staff,0,5,5,5
1715603242125,WES 237B,A00,494380,Staff,10,0,20,10
1715603244201,AESE 279B,A00,494370,Wade; Jon P,0,0,33,33
1715603245229,AIP 97,001,660915,Van Den Einde; Yael Dahlia,9999,0,9999,0
1715603246269,AIP 197,001,627712,Vespa; Emanuel Ignacio,9995,0,9999,4
1715603246269,AIP 197,002,650778,Amir; On,9998,0,9999,1
1715603246269,AIP 197,003,650933,Avenancio-Leon; Carlos,9998,0,9999,1
1715603246269,AIP 197,004,658530,Heyman; Gail D.,9998,0,9999,1
1715603246269,AIP 197,005,658631,Neal; Sonya E,9998,0,9999,1
1715603246269,AIP 197,006,658671,Du; Songzi,9998,0,9999,1
1715603247297,ANAR 135S,A00,494369,Braswell; Geoffrey E.,0,0,0,0
1715603248325,BENG 196,001,628496,Engler; Adam J.,9998,0,9999,1
1715603248325,BENG 196,002,660916,Watson; John Thomas,9999,0,9999,0
1715603249353,BISP 197,001,650773,Wilhelm; James E.,9994,0,9999,5
1715603249353,BISP 197,002,658904,Coleman; Aaron B.,9998,0,9999,1
1715603250381,CAT 124RS,A01,519847,Geibel; William,0,0,20,20
1715603251406,CAT 125RS,A01,515971,Geibel; William,0,0,20,20
1715603252437,CLRE 250,A00,511389,Morris; Sheldon,9992,0,9999,7
1715603253464,CLRE 251,A00,507176,Mehta; Ravindra L.,9992,0,9999,7
1715603253464,CLRE 251,B00,511410,Mehta; Ravindra L.,9998,0,9999,1
1715603254498,CLRE 252,A00,507189,Cuomo; Raphael Eduardo,9994,0,9999,5
1715603255524,CLRE 253,A00,507199,Vaida; Florin,9994,0,9999,5
1715603255524,CLRE 253,B00,507202,Vaida; Florin,9999,0,9999,0
1715603256555,CLRE 259,A00,507211,Patel; Hemal,9996,0,9999,3
1715603257580,CLRE 260,A00,507221,Cuomo; Raphael Eduardo,9999,0,9999,0
1715603258605,CLRE 297,001,507242,Cuomo; Raphael Eduardo,9999,0,9999,0
1715603259632,COGS 197,001,638244,Voytek; Bradley Thomas,9997,0,9999,2
1715603260661,CSE 191,A00,516875,Minnes Kemp; Mor Mia,9991,0,9999,8
1715603261687,CSE 197,001,637388,Minnes Kemp; Mor Mia,9992,0,9999,7
1715603262715,CSS 201S,A01,494383,Mignozzetti; Umberto,35,0,35,0
1715603263743,CSS 202S,A01,494387,Mignozzetti; Umberto,35,0,35,0
1715603264771,DSC 197,001,628532,Eldridge; Justin Matthew,9995,0,9999,4
1715603265796,EAP 100,A00,516065,Staff,9799,0,9999,200
1715603266830,ECE 45,A01,507414,Staff,31,0,60,29
1715603268886,ECE 111,A01,507420,Staff,11,0,50,39
1715603269915,ECE 197,001,548057,Sievenpiper; Daniel F.,9991,0,9999,8
1715603270941,EDS 115,A00,507243,Choi; Bailey Miyeon,7,0,28,21
1715603271967,EDS 117,A01,494379,Staff,0,6,34,34
1715603272995,EDS 125,A00,507246,Hopkins; Megan Beth,8,0,30,22
1715603274022,EDS 128A,A01,507264,Fargason; Sharon Gayle,6,0,26,20
1715603275049,EDS 128B,A01,507293,Pappas; Elizabeth,10,0,30,20
1715603276074,EDS 139,A00,507294,Fargason; Sharon Gayle,10,0,30,20
1715603276074,EDS 139,B00,507313,Pappas; Elizabeth,11,0,30,19
1715603277104,EDS 201,A00,507315,Staff,10,0,30,20
1715603278130,EDS 203,A01,507317,Halter; Christopher P.,10,0,30,20
1715603279162,EDS 204R,A01,507319,Halter; Christopher P.,0,3,30,30
1715603279162,EDS 204R,B01,507331,Heinzman; Erica M.,14,0,30,16
1715603280194,EDS 206R,A00,507332,Staff,0,4,30,30
1715603280194,EDS 206R,B00,507343,Staff,15,0,30,15
1715603281222,EDS 250,A00,507344,Hemans; Patricia Ann Benitez,20,0,40,20
1715603282252,EDS 281,A00,507345,Daly; Alan J.,18,0,18,0
1715603283278,EDS 284,A00,507350,Daly; Alan J.,16,0,16,0
1715603284312,EDS 286,A00,507359,Fine; Sarah,18,0,18,0
1715603285337,EDS 289C,A01,507361,Daly; Alan J.,18,0,18,0
1715603286362,EDS 290,A00,507366,Hofstetter; Carolyn,15,0,15,0
1715603287390,LIGM 5A,A00,507421,Fischer-Grunski; Eva K,17,0,20,3
1715603288421,LIGM 5B,A00,507423,Fischer-Grunski; Eva K,19,0,20,1
1715603289483,LIGM 5C,A00,507425,Fischer-Grunski; Eva K,19,0,20,1
1715603290754,LIIT 5AS,A00,507427,Carnelos; Chiara,20,0,20,0
1715603291783,LIIT 5BS,A00,507430,Carnelos; Chiara,20,0,20,0
1715603292809,LIIT 5CS,A00,507432,Carnelos; Chiara,20,0,20,0
1715603293835,LISP 5A,A00,507541,Munoz Sanchez; Alicia,11,0,20,9
1715603294866,LISP 5B,A00,507671,Munoz Sanchez; Alicia,9,0,20,11
1715603295894,LISP 5C,A00,507696,Munoz Sanchez; Alicia,9,0,20,11
1715603296919,MAE 197,001,528363,Boechler; Nicholas Sebastia,9998,0,9999,1
1715603297958,MATH 197,001,523477,Kedlaya; Kiran S.,9994,0,9999,5
1715603297958,MATH 197,002,563811,Zhang; Danna,9994,0,9999,5
1715603297958,MATH 197,003,628552,Dumitriu; Ioana,9998,0,9999,1
1715603297958,MATH 197,004,660885,Floyd; Eric,9999,0,9999,0
1715603298988,MCWP 40R,A00,518780,Staff,2,0,20,18
1715603298988,MCWP 40R,B00,518781,Staff,11,0,20,9
1715603298988,MCWP 40R,C00,518783,Staff,5,0,20,15
1715603300017,MCWP 50R,A00,518791,Staff,0,1,20,20
1715603300017,MCWP 50R,B00,518792,Staff,0,2,20,20
1715603300017,MCWP 50R,C00,518793,Staff,0,4,20,20
1715603300017,MCWP 50R,D00,518794,Staff,0,1,20,20
1715603300017,MCWP 50R,E00,518795,Staff,0,2,20,20
1715603300017,MCWP 50R,F00,518796,Staff,0,1,20,20
1715603300017,MCWP 50R,G00,518797,Staff,0,1,20,20
1715603301045,MMW 12R,A01,514034,Herbst; Matthew,0,2,16,16
1715603301045,MMW 12R,A02,514035,Herbst; Matthew,0,0,16,16
1715603302075,MMW 13R,A01,514037,Staff,0,5,16,16
1715603302075,MMW 13R,A02,514039,Staff,0,5,16,16
1715603302075,MMW 13R,A03,628519,Staff,0,4,16,16
1715603304131,SIO 295LS,A00,523233,Staff,10,0,30,20
1715603305162,SIO 295S,A00,523232,Staff,10,0,30,20
1715603306189,SIOC 290S,A01,637330,Merrifield; Mark A,23,0,30,7
1715603307221,SIOC 291S,A01,637333,Gabriel; Corey John,23,0,30,7
1715603308248,SOCI 117,A01,494376,Staff,0,5,5,5
1715603309279,WES 237B,A00,494380,Staff,10,0,20,10
1715603311354,AESE 279B,A00,494370,Wade; Jon P,0,0,33,33
1715603312382,AIP 97,001,660915,Van Den Einde; Yael Dahlia,9999,0,9999,0
1715603313421,AIP 197,001,627712,Vespa; Emanuel Ignacio,9995,0,9999,4
1715603313421,AIP 197,002,650778,Amir; On,9998,0,9999,1
1715603313421,AIP 197,003,650933,Avenancio-Leon; Carlos,9998,0,9999,1
1715603313421,AIP 197,004,658530,Heyman; Gail D.,9998,0,9999,1
1715603313421,AIP 197,005,658631,Neal; Sonya E,9998,0,9999,1
1715603313421,AIP 197,006,658671,Du; Songzi,9998,0,9999,1
1715603314451,ANAR 135S,A00,494369,Braswell; Geoffrey E.,0,0,0,0
1715603315482,BENG 196,001,628496,Engler; Adam J.,9998,0,9999,1
1715603315482,BENG 196,002,660916,Watson; John Thomas,9999,0,9999,0
1715603316513,BISP 197,001,650773,Wilhelm; James E.,9994,0,9999,5
1715603316513,BISP 197,002,658904,Coleman; Aaron B.,9998,0,9999,1
1715603317541,CAT 124RS,A01,519847,Geibel; William,0,0,20,20
1715603318574,CAT 125RS,A01,515971,Geibel; William,0,0,20,20
1715603319606,CLRE 250,A00,511389,Morris; Sheldon,9992,0,9999,7
1715603320641,CLRE 251,A00,507176,Mehta; Ravindra L.,9992,0,9999,7
1715603320641,CLRE 251,B00,511410,Mehta; Ravindra L.,9998,0,9999,1
1715603321677,CLRE 252,A00,507189,Cuomo; Raphael Eduardo,9994,0,9999,5
1715603322705,CLRE 253,A00,507199,Vaida; Florin,9994,0,9999,5
1715603322705,CLRE 253,B00,507202,Vaida; Florin,9999,0,9999,0
1715603323735,CLRE 259,A00,507211,Patel; Hemal,9996,0,9999,3
1715603324761,CLRE 260,A00,507221,Cuomo; Raphael Eduardo,9999,0,9999,0
1715603325788,CLRE 297,001,507242,Cuomo; Raphael Eduardo,9999,0,9999,0
1715603326819,COGS 197,001,638244,Voytek; Bradley Thomas,9997,0,9999,2
1715603327846,CSE 191,A00,516875,Minnes Kemp; Mor Mia,9991,0,9999,8
1715603328872,CSE 197,001,637388,Minnes Kemp; Mor Mia,9992,0,9999,7
1715603329899,CSS 201S,A01,494383,Mignozzetti; Umberto,35,0,35,0
1715603330931,CSS 202S,A01,494387,Mignozzetti; Umberto,35,0,35,0
1715603331958,DSC 197,001,628532,Eldridge; Justin Matthew,9995,0,9999,4
1715603332985,EAP 100,A00,516065,Staff,9799,0,9999,200
1715603334021,ECE 45,A01,507414,Staff,31,0,60,29
1715603336075,ECE 111,A01,507420,Staff,11,0,50,39
1715603337102,ECE 197,001,548057,Sievenpiper; Daniel F.,9991,0,9999,8
1715603338128,EDS 115,A00,507243,Choi; Bailey Miyeon,7,0,28,21
1715603339158,EDS 117,A01,494379,Staff,0,6,34,34
1715603340189,EDS 125,A00,507246,Hopkins; Megan Beth,8,0,30,22
1715603341218,EDS 128A,A01,507264,Fargason; Sharon Gayle,6,0,26,20
1715603342249,EDS 128B,A01,507293,Pappas; Elizabeth,10,0,30,20
1715603343278,EDS 139,A00,507294,Fargason; Sharon Gayle,10,0,30,20
1715603343278,EDS 139,B00,507313,Pappas; Elizabeth,11,0,30,19
1715603344305,EDS 201,A00,507315,Staff,10,0,30,20
1715603345333,EDS 203,A01,507317,Halter; Christopher P.,10,0,30,20
1715603346365,EDS 204R,A01,507319,Halter; Christopher P.,0,3,30,30
1715603346365,EDS 204R,B01,507331,Heinzman; Erica M.,14,0,30,16
1715603347391,EDS 206R,A00,507332,Staff,0,4,30,30
1715603347391,EDS 206R,B00,507343,Staff,15,0,30,15
1715603348422,EDS 250,A00,507344,Hemans; Patricia Ann Benitez,20,0,40,20
1715603349451,EDS 281,A00,507345,Daly; Alan J.,18,0,18,0
1715603350476,EDS 284,A00,507350,Daly; Alan J.,16,0,16,0
1715603351502,EDS 286,A00,507359,Fine; Sarah,18,0,18,0
1715603352528,EDS 289C,A01,507361,Daly; Alan J.,18,0,18,0
1715603353556,EDS 290,A00,507366,Hofstetter; Carolyn,15,0,15,0
1715603354585,LIGM 5A,A00,507421,Fischer-Grunski; Eva K,17,0,20,3
1715603355614,LIGM 5B,A00,507423,Fischer-Grunski; Eva K,19,0,20,1
1715603356645,LIGM 5C,A00,507425,Fischer-Grunski; Eva K,19,0,20,1
1715603357673,LIIT 5AS,A00,507427,Carnelos; Chiara,20,0,20,0
1715603358698,LIIT 5BS,A00,507430,Carnelos; Chiara,20,0,20,0
1715603359724,LIIT 5CS,A00,507432,Carnelos; Chiara,20,0,20,0
1715603360757,LISP 5A,A00,507541,Munoz Sanchez; Alicia,11,0,20,9
1715603361783,LISP 5B,A00,507671,Munoz Sanchez; Alicia,9,0,20,11
1715603362816,LISP 5C,A00,507696,Munoz Sanchez; Alicia,9,0,20,11
1715603363845,MAE 197,001,528363,Boechler; Nicholas Sebastia,9998,0,9999,1
1715603364875,MATH 197,001,523477,Kedlaya; Kiran S.,9994,0,9999,5
1715603364875,MATH 197,002,563811,Zhang; Danna,9994,0,9999,5
1715603364875,MATH 197,003,628552,Dumitriu; Ioana,9998,0,9999,1
1715603364875,MATH 197,004,660885,Floyd; Eric,9999,0,9999,0
1715603365903,MCWP 40R,A00,518780,Staff,2,0,20,18
1715603365903,MCWP 40R,B00,518781,Staff,11,0,20,9
1715603365903,MCWP 40R,C00,518783,Staff,5,0,20,15
1715603366931,MCWP 50R,A00,518791,Staff,0,1,20,20
1715603366931,MCWP 50R,B00,518792,Staff,0,2,20,20
1715603366931,MCWP 50R,C00,518793,Staff,0,4,20,20
1715603366931,MCWP 50R,D00,518794,Staff,0,1,20,20
1715603366931,MCWP 50R,E00,518795,Staff,0,2,20,20
1715603366931,MCWP 50R,F00,518796,Staff,0,1,20,20
1715603366931,MCWP 50R,G00,518797,Staff,0,1,20,20
1715603367963,MMW 12R,A01,514034,Herbst; Matthew,0,2,16,16
1715603367963,MMW 12R,A02,514035,Herbst; Matthew,0,0,16,16
1715603368989,MMW 13R,A01,514037,Staff,0,5,16,16
1715603368989,MMW 13R,A02,514039,Staff,0,5,16,16
1715603368989,MMW 13R,A03,628519,Staff,0,4,16,16
1715603371048,SIO 295LS,A00,523233,Staff,10,0,30,20
1715603372079,SIO 295S,A00,523232,Staff,10,0,30,20
1715603373111,SIOC 290S,A01,637330,Merrifield; Mark A,23,0,30,7
1715603374137,SIOC 291S,A01,637333,Gabriel; Corey John,23,0,30,7
1715603375167,SOCI 117,A01,494376,Staff,0,5,5,5
1715603376197,WES 237B,A00,494380,Staff,10,0,20,10
1715603378287,AESE 279B,A00,494370,Wade; Jon P,0,0,33,33
1715603379318,AIP 97,001,660915,Van Den Einde; Yael Dahlia,9999,0,9999,0
1715603380346,AIP 197,001,627712,Vespa; Emanuel Ignacio,9995,0,9999,4
1715603380346,AIP 197,002,650778,Amir; On,9998,0,9999,1
1715603380346,AIP 197,003,650933,Avenancio-Leon; Carlos,9998,0,9999,1
1715603380346,AIP 197,004,658530,Heyman; Gail D.,9998,0,9999,1
1715603380346,AIP 197,005,658631,Neal; Sonya E,9998,0,9999,1
1715603380346,AIP 197,006,658671,Du; Songzi,9998,0,9999,1
1715603381374,ANAR 135S,A00,494369,Braswell; Geoffrey E.,0,0,0,0
1715603382407,BENG 196,001,628496,Engler; Adam J.,9998,0,9999,1
1715603382407,BENG 196,002,660916,Watson; John Thomas,9999,0,9999,0
1715603383439,BISP 197,001,650773,Wilhelm; James E.,9994,0,9999,5
1715603383439,BISP 197,002,658904,Coleman; Aaron B.,9998,0,9999,1
1715603384468,CAT 124RS,A01,519847,Geibel; William,0,0,20,20
1715603385496,CAT 125RS,A01,515971,Geibel; William,0,0,20,20
1715603386524,CLRE 250,A00,511389,Morris; Sheldon,9992,0,9999,7
1715603387550,CLRE 251,A00,507176,Mehta; Ravindra L.,9992,0,9999,7
1715603387550,CLRE 251,B00,511410,Mehta; Ravindra L.,9998,0,9999,1
1715603388579,CLRE 252,A00,507189,Cuomo; Raphael Eduardo,9994,0,9999,5
1715603389606,CLRE 253,A00,507199,Vaida; Florin,9994,0,9999,5
1715603389606,CLRE 253,B00,507202,Vaida; Florin,9999,0,9999,0
1715603390635,CLRE 259,A00,507211,Patel; Hemal,9996,0,9999,3
1715603391664,CLRE 260,A00,507221,Cuomo; Raphael Eduardo,9999,0,9999,0
1715603392689,CLRE 297,001,507242,Cuomo; Raphael Eduardo,9999,0,9999,0
1715603393718,COGS 197,001,638244,Voytek; Bradley Thomas,9997,0,9999,2
1715603394746,CSE 191,A00,516875,Minnes Kemp; Mor Mia,9991,0,9999,8
1715603395773,CSE 197,001,637388,Minnes Kemp; Mor Mia,9992,0,9999,7
1715603396800,CSS 201S,A01,494383,Mignozzetti; Umberto,35,0,35,0
1715603397829,CSS 202S,A01,494387,Mignozzetti; Umberto,35,0,35,0
1715603398857,DSC 197,001,628532,Eldridge; Justin Matthew,9995,0,9999,4
1715603399886,EAP 100,A00,516065,Staff,9799,0,9999,200
1715603400915,ECE 45,A01,507414,Staff,31,0,60,29
1715603402966,ECE 111,A01,507420,Staff,11,0,50,39
1715603403997,ECE 197,001,548057,Sievenpiper; Daniel F.,9991,0,9999,8
1715603405032,EDS 115,A00,507243,Choi; Bailey Miyeon,7,0,28,21
1715603406065,EDS 117,A01,494379,Staff,0,6,34,34
1715603407095,EDS 125,A00,507246,Hopkins; Megan Beth,8,0,30,22
1715603408121,EDS 128A,A01,507264,Fargason; Sharon Gayle,6,0,26,20
1715603409151,EDS 128B,A01,507293,Pappas; Elizabeth,10,0,30,20
1715603410178,EDS 139,A00,507294,Fargason; Sharon Gayle,10,0,30,20
1715603410178,EDS 139,B00,507313,Pappas; Elizabeth,11,0,30,19
1715603411206,EDS 201,A00,507315,Staff,10,0,30,20
1715603412233,EDS 203,A01,507317,Halter; Christopher P.,10,0,30,20
1715603413260,EDS 204R,A01,507319,Halter; Christopher P.,0,3,30,30
1715603413260,EDS 204R,B01,507331,Heinzman; Erica M.,14,0,30,16
1715603414292,EDS 206R,A00,507332,Staff,0,4,30,30
1715603414292,EDS 206R,B00,507343,Staff,15,0,30,15
1715603415317,EDS 250,A00,507344,Hemans; Patricia Ann Benitez,20,0,40,20
1715603416345,EDS 281,A00,507345,Daly; Alan J.,18,0,18,0
1715603417371,EDS 284,A00,507350,Daly; Alan J.,16,0,16,0
1715603418403,EDS 286,A00,507359,Fine; Sarah,18,0,18,0
1715603419428,EDS 289C,A01,507361,Daly; Alan J.,18,0,18,0
1715603420457,EDS 290,A00,507366,Hofstetter; Carolyn,15,0,15,0
1715603421489,LIGM 5A,A00,507421,Fischer-Grunski; Eva K,17,0,20,3
1715603422519,LIGM 5B,A00,507423,Fischer-Grunski; Eva K,19,0,20,1
1715603423548,LIGM 5C,A00,507425,Fischer-Grunski; Eva K,19,0,20,1
1715603424574,LIIT 5AS,A00,507427,Carnelos; Chiara,20,0,20,0
1715603425605,LIIT 5BS,A00,507430,Carnelos; Chiara,20,0,20,0
1715603426635,LIIT 5CS,A00,507432,Carnelos; Chiara,20,0,20,0
1715603427662,LISP 5A,A00,507541,Munoz Sanchez; Alicia,11,0,20,9
1715603428687,LISP 5B,A00,507671,Munoz Sanchez; Alicia,9,0,20,11
1715603429715,LISP 5C,A00,507696,Munoz Sanchez; Alicia,9,0,20,11
1715603430745,MAE 197,001,528363,Boechler; Nicholas Sebastia,9998,0,9999,1
1715603431779,MATH 197,001,523477,Kedlaya; Kiran S.,9994,0,9999,5
1715603431779,MATH 197,002,563811,Zhang; Danna,9994,0,9999,5
1715603431779,MATH 197,003,628552,Dumitriu; Ioana,9998,0,9999,1
1715603431779,MATH 197,004,660885,Floyd; Eric,9999,0,9999,0
1715603432807,MCWP 40R,A00,518780,Staff,2,0,20,18
1715603432807,MCWP 40R,B00,518781,Staff,11,0,20,9
1715603432807,MCWP 40R,C00,518783,Staff,5,0,20,15
1715603433842,MCWP 50R,A00,518791,Staff,0,1,20,20
1715603433842,MCWP 50R,B00,518792,Staff,0,2,20,20
1715603433842,MCWP 50R,C00,518793,Staff,0,4,20,20
1715603433842,MCWP 50R,D00,518794,Staff,0,1,20,20
1715603433842,MCWP 50R,E00,518795,Staff,0,2,20,20
1715603433842,MCWP 50R,F00,518796,Staff,0,1,20,20
1715603433842,MCWP 50R,G00,518797,Staff,0,1,20,20
1715603434869,MMW 12R,A01,514034,Herbst; Matthew,0,2,16,16
1715603434869,MMW 12R,A02,514035,Herbst; Matthew,0,0,16,16
1715603435899,MMW 13R,A01,514037,Staff,0,5,16,16
1715603435899,MMW 13R,A02,514039,Staff,0,5,16,16
1715603435899,MMW 13R,A03,628519,Staff,0,4,16,16
1715603437953,SIO 295LS,A00,523233,Staff,10,0,30,20
1715603438984,SIO 295S,A00,523232,Staff,10,0,30,20
1715603440012,SIOC 290S,A01,637330,Merrifield; Mark A,23,0,30,7
1715603441044,SIOC 291S,A01,637333,Gabriel; Corey John,23,0,30,7
1715603442075,SOCI 117,A01,494376,Staff,0,5,5,5
1715603443101,WES 237B,A00,494380,Staff,10,0,20,10
1715603445182,AESE 279B,A00,494370,Wade; Jon P,0,0,33,33
1715603446212,AIP 97,001,660915,Van Den Einde; Yael Dahlia,9999,0,9999,0
1715603447246,AIP 197,001,627712,Vespa; Emanuel Ignacio,9995,0,9999,4
1715603447246,AIP 197,002,650778,Amir; On,9998,0,9999,1
1715603447246,AIP 197,003,650933,Avenancio-Leon; Carlos,9998,0,9999,1
1715603447246,AIP 197,004,658530,Heyman; Gail D.,9998,0,9999,1
1715603447246,AIP 197,005,658631,Neal; Sonya E,9998,0,9999,1
1715603447246,AIP 197,006,658671,Du; Songzi,9998,0,9999,1
1715603448271,ANAR 135S,A00,494369,Braswell; Geoffrey E.,0,0,0,0
1715603449304,BENG 196,001,628496,Engler; Adam J.,9998,0,9999,1
1715603449304,BENG 196,002,660916,Watson; John Thomas,9999,0,9999,0
1715603450331,BISP 197,001,650773,Wilhelm; James E.,9994,0,9999,5
1715603450331,BISP 197,002,658904,Coleman; Aaron B.,9998,0,9999,1
1715603451358,CAT 124RS,A01,519847,Geibel; William,0,0,20,20
1715603452386,CAT 125RS,A01,515971,Geibel; William,0,0,20,20
1715603453411,CLRE 250,A00,511389,Morris; Sheldon,9992,0,9999,7
1715603454440,CLRE 251,A00,507176,Mehta; Ravindra L.,9992,0,9999,7
1715603454440,CLRE 251,B00,511410,Mehta; Ravindra L.,9998,0,9999,1
1715603455469,CLRE 252,A00,507189,Cuomo; Raphael Eduardo,9994,0,9999,5
1715603456496,CLRE 253,A00,507199,Vaida; Florin,9994,0,9999,5
1715603456496,CLRE 253,B00,507202,Vaida; Florin,9999,0,9999,0
1715603457524,CLRE 259,A00,507211,Patel; Hemal,9996,0,9999,3
1715603458555,CLRE 260,A00,507221,Cuomo; Raphael Eduardo,9999,0,9999,0
1715603459581,CLRE 297,001,507242,Cuomo; Raphael Eduardo,9999,0,9999,0
1715603460610,COGS 197,001,638244,Voytek; Bradley Thomas,9997,0,9999,2
1715603461641,CSE 191,A00,516875,Minnes Kemp; Mor Mia,9991,0,9999,8
1715603462671,CSE 197,001,637388,Minnes Kemp; Mor Mia,9992,0,9999,7
1715603463698,CSS 201S,A01,494383,Mignozzetti; Umberto,35,0,35,0
1715603464731,CSS 202S,A01,494387,Mignozzetti; Umberto,35,0,35,0
1715603465761,DSC 197,001,628532,Eldridge; Justin Matthew,9995,0,9999,4
1715603466791,EAP 100,A00,516065,Staff,9799,0,9999,200
1715603467822,ECE 45,A01,507414,Staff,31,0,60,29
1715603469877,ECE 111,A01,507420,Staff,11,0,50,39
1715603470909,ECE 197,001,548057,Sievenpiper; Daniel F.,9991,0,9999,8
1715603471939,EDS 115,A00,507243,Choi; Bailey Miyeon,7,0,28,21
1715603472967,EDS 117,A01,494379,Staff,0,6,34,34
1715603473994,EDS 125,A00,507246,Hopkins; Megan Beth,8,0,30,22
1715603475022,EDS 128A,A01,507264,Fargason; Sharon Gayle,6,0,26,20
1715603476051,EDS 128B,A01,507293,Pappas; Elizabeth,10,0,30,20
1715603477078,EDS 139,A00,507294,Fargason; Sharon Gayle,10,0,30,20
1715603477078,EDS 139,B00,507313,Pappas; Elizabeth,11,0,30,19
1715603478105,EDS 201,A00,507315,Staff,10,0,30,20
1715603479131,EDS 203,A01,507317,Halter; Christopher P.,10,0,30,20
1715603480158,EDS 204R,A01,507319,Halter; Christopher P.,0,3,30,30
1715603480158,EDS 204R,B01,507331,Heinzman; Erica M.,14,0,30,16
1715603481183,EDS 206R,A00,507332,Staff,0,4,30,30
1715603481183,EDS 206R,B00,507343,Staff,15,0,30,15
1715603482211,EDS 250,A00,507344,Hemans; Patricia Ann Benitez,20,0,40,20
1715603483241,EDS 281,A00,507345,Daly; Alan J.,18,0,18,0
1715603484268,EDS 284,A00,507350,Daly; Alan J.,16,0,16,0
1715603485293,EDS 286,A00,507359,Fine; Sarah,18,0,18,0
1715603486316,EDS 289C,A01,507361,Daly; Alan J.,18,0,18,0
1715603487345,EDS 290,A00,507366,Hofstetter; Carolyn,15,0,15,0
1715603488372,LIGM 5A,A00,507421,Fischer-Grunski; Eva K,17,0,20,3
1715603489400,LIGM 5B,A00,507423,Fischer-Grunski; Eva K,19,0,20,1
1715603490429,LIGM 5C,A00,507425,Fischer-Grunski; Eva K,19,0,20,1
1715603491457,LIIT 5AS,A00,507427,Carnelos; Chiara,20,0,20,0
1715603492483,LIIT 5BS,A00,507430,Carnelos; Chiara,20,0,20,0
1715603493512,LIIT 5CS,A00,507432,Carnelos; Chiara,20,0,20,0
1715603494541,LISP 5A,A00,507541,Munoz Sanchez; Alicia,11,0,20,9
1715603495570,LISP 5B,A00,507671,Munoz Sanchez; Alicia,9,0,20,11
1715603496597,LISP 5C,A00,507696,Munoz Sanchez; Alicia,9,0,20,11
1715603497624,MAE 197,001,528363,Boechler; Nicholas Sebastia,9998,0,9999,1
1715603498653,MATH 197,001,523477,Kedlaya; Kiran S.,9994,0,9999,5
1715603498653,MATH 197,002,563811,Zhang; Danna,9994,0,9999,5
1715603498653,MATH 197,003,628552,Dumitriu; Ioana,9998,0,9999,1
1715603498653,MATH 197,004,660885,Floyd; Eric,9999,0,9999,0
1715603499683,MCWP 40R,A00,518780,Staff,2,0,20,18
1715603499683,MCWP 40R,B00,518781,Staff,11,0,20,9
1715603499683,MCWP 40R,C00,518783,Staff,5,0,20,15
1715603500710,MCWP 50R,A00,518791,Staff,0,1,20,20
1715603500710,MCWP 50R,B00,518792,Staff,0,2,20,20
1715603500710,MCWP 50R,C00,518793,Staff,0,4,20,20
1715603500710,MCWP 50R,D00,518794,Staff,0,1,20,20
1715603500710,MCWP 50R,E00,518795,Staff,0,2,20,20
1715603500710,MCWP 50R,F00,518796,Staff,0,1,20,20
1715603500710,MCWP 50R,G00,518797,Staff,0,1,20,20
1715603501735,MMW 12R,A01,514034,Herbst; Matthew,0,2,16,16
1715603501735,MMW 12R,A02,514035,Herbst; Matthew,0,0,16,16
1715603502762,MMW 13R,A01,514037,Staff,0,5,16,16
1715603502762,MMW 13R,A02,514039,Staff,0,5,16,16
1715603502762,MMW 13R,A03,628519,Staff,0,4,16,16
1715603504816,SIO 295LS,A00,523233,Staff,10,0,30,20
1715603505845,SIO 295S,A00,523232,Staff,10,0,30,20
1715603506874,SIOC 290S,A01,637330,Merrifield; Mark A,23,0,30,7
1715603507900,SIOC 291S,A01,637333,Gabriel; Corey John,23,0,30,7
1715603508929,SOCI 117,A01,494376,Staff,0,5,5,5
1715603509958,WES 237B,A00,494380,Staff,10,0,20,10
1715603512045,AESE 279B,A00,494370,Wade; Jon P,0,0,33,33
1715603513072,AIP 97,001,660915,Van Den Einde; Yael Dahlia,9999,0,9999,0
1715603514109,AIP 197,001,627712,Vespa; Emanuel Ignacio,9995,0,9999,4
1715603514109,AIP 197,002,650778,Amir; On,9998,0,9999,1
1715603514109,AIP 197,003,650933,Avenancio-Leon; Carlos,9998,0,9999,1
1715603514109,AIP 197,004,658530,Heyman; Gail D.,9998,0,9999,1
1715603514109,AIP 197,005,658631,Neal; Sonya E,9998,0,9999,1
1715603514109,AIP 197,006,658671,Du; Songzi,9998,0,9999,1
1715603515137,ANAR 135S,A00,494369,Braswell; Geoffrey E.,0,0,0,0
1715603516168,BENG 196,001,628496,Engler; Adam J.,9998,0,9999,1
1715603516168,BENG 196,002,660916,Watson; John Thomas,9999,0,9999,0
1715603517201,BISP 197,001,650773,Wilhelm; James E.,9994,0,9999,5
1715603517201,BISP 197,002,658904,Coleman; Aaron B.,9998,0,9999,1
1715603518228,CAT 124RS,A01,519847,Geibel; William,0,0,20,20
1715603519255,CAT 125RS,A01,515971,Geibel; William,0,0,20,20
1715603520289,CLRE 250,A00,511389,Morris; Sheldon,9992,0,9999,7
1715603521325,CLRE 251,A00,507176,Mehta; Ravindra L.,9992,0,9999,7
1715603521325,CLRE 251,B00,511410,Mehta; Ravindra L.,9998,0,9999,1
1715603522349,CLRE 252,A00,507189,Cuomo; Raphael Eduardo,9994,0,9999,5
1715603523377,CLRE 253,A00,507199,Vaida; Florin,9994,0,9999,5
1715603523377,CLRE 253,B00,507202,Vaida; Florin,9999,0,9999,0
1715603524403,CLRE 259,A00,507211,Patel; Hemal,9996,0,9999,3
1715603525429,CLRE 260,A00,507221,Cuomo; Raphael Eduardo,9999,0,9999,0
1715603526455,CLRE 297,001,507242,Cuomo; Raphael Eduardo,9999,0,9999,0
1715603527481,COGS 197,001,638244,Voytek; Bradley Thomas,9997,0,9999,2
1715603528506,CSE 191,A00,516875,Minnes Kemp; Mor Mia,9991,0,9999,8
1715603529535,CSE 197,001,637388,Minnes Kemp; Mor Mia,9992,0,9999,7
1715603530564,CSS 201S,A01,494383,Mignozzetti; Umberto,35,0,35,0
1715603531594,CSS 202S,A01,494387,Mignozzetti; Umberto,35,0,35,0
1715603532621,DSC 197,001,628532,Eldridge; Justin Matthew,9995,0,9999,4
1715603533650,EAP 100,A00,516065,Staff,9799,0,9999,200
1715603534678,ECE 45,A01,507414,Staff,31,0,60,29
1715603536729,ECE 111,A01,507420,Staff,11,0,50,39
1715603537755,ECE 197,001,548057,Sievenpiper; Daniel F.,9991,0,9999,8
1715603538783,EDS 115,A00,507243,Choi; Bailey Miyeon,7,0,28,21
1715603539810,EDS 117,A01,494379,Staff,0,6,34,34
1715603540836,EDS 125,A00,507246,Hopkins; Megan Beth,8,0,30,22
1715603541863,EDS 128A,A01,507264,Fargason; Sharon Gayle,6,0,26,20
1715603542889,EDS 128B,A01,507293,Pappas; Elizabeth,10,0,30,20
1715603543915,EDS 139,A00,507294,Fargason; Sharon Gayle,10,0,30,20
1715603543915,EDS 139,B00,507313,Pappas; Elizabeth,11,0,30,19
1715603544942,EDS 201,A00,507315,Staff,10,0,30,20
1715603545974,EDS 203,A01,507317,Halter; Christopher P.,10,0,30,20
1715603547005,EDS 204R,A01,507319,Halter; Christopher P.,0,3,30,30
1715603547005,EDS 204R,B01,507331,Heinzman; Erica M.,14,0,30,16
1715603548030,EDS 206R,A00,507332,Staff,0,4,30,30
1715603548030,EDS 206R,B00,507343,Staff,15,0,30,15
1715603549056,EDS 250,A00,507344,Hemans; Patricia Ann Benitez,20,0,40,20
1715603550085,EDS 281,A00,507345,Daly; Alan J.,18,0,18,0
1715603551112,EDS 284,A00,507350,Daly; Alan J.,16,0,16,0
1715603552139,EDS 286,A00,507359,Fine; Sarah,18,0,18,0
1715603553165,EDS 289C,A01,507361,Daly; Alan J.,18,0,18,0
1715603554205,EDS 290,A00,507366,Hofstetter; Carolyn,15,0,15,0
1715603555231,LIGM 5A,A00,507421,Fischer-Grunski; Eva K,17,0,20,3
1715603556257,LIGM 5B,A00,507423,Fischer-Grunski; Eva K,19,0,20,1
1715603557283,LIGM 5C,A00,507425,Fischer-Grunski; Eva K,19,0,20,1
1715603558313,LIIT 5AS,A00,507427,Carnelos; Chiara,20,0,20,0
1715603559342,LIIT 5BS,A00,507430,Carnelos; Chiara,20,0,20,0
1715603560370,LIIT 5CS,A00,507432,Carnelos; Chiara,20,0,20,0
1715603561400,LISP 5A,A00,507541,Munoz Sanchez; Alicia,11,0,20,9
1715603562430,LISP 5B,A00,507671,Munoz Sanchez; Alicia,9,0,20,11
1715603563455,LISP 5C,A00,507696,Munoz Sanchez; Alicia,9,0,20,11
1715603564483,MAE 197,001,528363,Boechler; Nicholas Sebastia,9998,0,9999,1
1715603565516,MATH 197,001,523477,Kedlaya; Kiran S.,9994,0,9999,5
1715603565516,MATH 197,002,563811,Zhang; Danna,9994,0,9999,5
1715603565516,MATH 197,003,628552,Dumitriu; Ioana,9998,0,9999,1
1715603565516,MATH 197,004,660885,Floyd; Eric,9999,0,9999,0
1715603566542,MCWP 40R,A00,518780,Staff,2,0,20,18
1715603566542,MCWP 40R,B00,518781,Staff,11,0,20,9
1715603566542,MCWP 40R,C00,518783,Staff,5,0,20,15
1715603567569,MCWP 50R,A00,518791,Staff,0,1,20,20
1715603567569,MCWP 50R,B00,518792,Staff,0,2,20,20
1715603567569,MCWP 50R,C00,518793,Staff,0,4,20,20
1715603567569,MCWP 50R,D00,518794,Staff,0,1,20,20
1715603567569,MCWP 50R,E00,518795,Staff,0,2,20,20
1715603567569,MCWP 50R,F00,518796,Staff,0,1,20,20
1715603567569,MCWP 50R,G00,518797,Staff,0,1,20,20
1715603568596,MMW 12R,A01,514034,Herbst; Matthew,0,2,16,16
1715603568596,MMW 12R,A02,514035,Herbst; Matthew,0,0,16,16
1715603569621,MMW 13R,A01,514037,Staff,0,5,16,16
1715603569621,MMW 13R,A02,514039,Staff,0,5,16,16
1715603569621,MMW 13R,A03,628519,Staff,0,4,16,16
1715603571674,SIO 295LS,A00,523233,Staff,10,0,30,20
1715603572699,SIO 295S,A00,523232,Staff,10,0,30,20
1715603573727,SIOC 290S,A01,637330,Merrifield; Mark A,23,0,30,7
1715603574754,SIOC 291S,A01,637333,Gabriel; Corey John,23,0,30,7
1715603575779,SOCI 117,A01,494376,Staff,0,5,5,5
1715603576810,WES 237B,A00,494380,Staff,10,0,20,10
1715603578897,AESE 279B,A00,494370,Wade; Jon P,0,0,33,33
1715603579924,AIP 97,001,660915,Van Den Einde; Yael Dahlia,9999,0,9999,0
1715603580954,AIP 197,001,627712,Vespa; Emanuel Ignacio,9995,0,9999,4
1715603580954,AIP 197,002,650778,Amir; On,9998,0,9999,1
1715603580954,AIP 197,003,650933,Avenancio-Leon; Carlos,9998,0,9999,1
1715603580954,AIP 197,004,658530,Heyman; Gail D.,9998,0,9999,1
1715603580954,AIP 197,005,658631,Neal; Sonya E,9998,0,9999,1
1715603580954,AIP 197,006,658671,Du; Songzi,9998,0,9999,1
1715603581984,ANAR 135S,A00,494369,Braswell; Geoffrey E.,0,0,0,0
1715603583035,BENG 196,001,628496,Engler; Adam J.,9998,0,9999,1
1715603583035,BENG 196,002,660916,Watson; John Thomas,9999,0,9999,0
1715603584062,BISP 197,001,650773,Wilhelm; James E.,9994,0,9999,5
1715603584062,BISP 197,002,658904,Coleman; Aaron B.,9998,0,9999,1
1715603585093,CAT 124RS,A01,519847,Geibel; William,0,0,20,20
1715603586119,CAT 125RS,A01,515971,Geibel; William,0,0,20,20
1715603587149,CLRE 250,A00,511389,Morris; Sheldon,9992,0,9999,7
1715603588177,CLRE 251,A00,507176,Mehta; Ravindra L.,9992,0,9999,7
1715603588177,CLRE 251,B00,511410,Mehta; Ravindra L.,9998,0,9999,1
1715603589209,CLRE 252,A00,507189,Cuomo; Raphael Eduardo,9994,0,9999,5
1715603590236,CLRE 253,A00,507199,Vaida; Florin,9994,0,9999,5
1715603590236,CLRE 253,B00,507202,Vaida; Florin,9999,0,9999,0
1715603591267,CLRE 259,A00,507211,Patel; Hemal,9996,0,9999,3
1715603592293,CLRE 260,A00,507221,Cuomo; Raphael Eduardo,9999,0,9999,0
1715603593319,CLRE 297,001,507242,Cuomo; Raphael Eduardo,9999,0,9999,0
1715603594349,COGS 197,001,638244,Voytek; Bradley Thomas,9997,0,9999,2
1715603595379,CSE 191,A00,516875,Minnes Kemp; Mor Mia,9991,0,9999,8
1715603596405,CSE 197,001,637388,Minnes Kemp; Mor Mia,9992,0,9999,7
1715603597434,CSS 201S,A01,494383,Mignozzetti; Umberto,35,0,35,0
1715603598461,CSS 202S,A01,494387,Mignozzetti; Umberto,35,0,35,0
1715603599490,DSC 197,001,628532,Eldridge; Justin Matthew,9995,0,9999,4
1715603600518,EAP 100,A00,516065,Staff,9799,0,9999,200
1715603601548,ECE 45,A01,507414,Staff,31,0,60,29
1715603603601,ECE 111,A01,507420,Staff,11,0,50,39
1715603604627,ECE 197,001,548057,Sievenpiper; Daniel F.,9991,0,9999,8
1715603605654,EDS 115,A00,507243,Choi; Bailey Miyeon,7,0,28,21
1715603606682,EDS 117,A01,494379,Staff,0,6,34,34
1715603607712,EDS 125,A00,507246,Hopkins; Megan Beth,8,0,30,22
1715603608737,EDS 128A,A01,507264,Fargason; Sharon Gayle,6,0,26,20
1715603609763,EDS 128B,A01,507293,Pappas; Elizabeth,10,0,30,20
1715603610841,EDS 139,A00,507294,Fargason; Sharon Gayle,10,0,30,20
1715603610841,EDS 139,B00,507313,Pappas; Elizabeth,11,0,30,19
1715603611870,EDS 201,A00,507315,Staff,10,0,30,20
1715603612900,EDS 203,A01,507317,Halter; Christopher P.,10,0,30,20
1715603613925,EDS 204R,A01,507319,Halter; Christopher P.,0,3,30,30
1715603613925,EDS 204R,B01,507331,Heinzman; Erica M.,14,0,30,16
1715603614951,EDS 206R,A00,507332,Staff,0,4,30,30
1715603614951,EDS 206R,B00,507343,Staff,15,0,30,15
1715603615981,EDS 250,A00,507344,Hemans; Patricia Ann Benitez,20,0,40,20
1715603617009,EDS 281,A00,507345,Daly; Alan J.,18,0,18,0
1715603618037,EDS 284,A00,507350,Daly; Alan J.,16,0,16,0
1715603619065,EDS 286,A00,507359,Fine; Sarah,18,0,18,0
1715603620091,EDS 289C,A01,507361,Daly; Alan J.,18,0,18,0
1715603621118,EDS 290,A00,507366,Hofstetter; Carolyn,15,0,15,0
1715603622145,LIGM 5A,A00,507421,Fischer-Grunski; Eva K,17,0,20,3
1715603623171,LIGM 5B,A00,507423,Fischer-Grunski; Eva K,19,0,20,1
1715603624199,LIGM 5C,A00,507425,Fischer-Grunski; Eva K,19,0,20,1
1715603625230,LIIT 5AS,A00,507427,Carnelos; Chiara,20,0,20,0
1715603626261,LIIT 5BS,A00,507430,Carnelos; Chiara,20,0,20,0
1715603627292,LIIT 5CS,A00,507432,Carnelos; Chiara,20,0,20,0
1715603628324,LISP 5A,A00,507541,Munoz Sanchez; Alicia,11,0,20,9
1715603629353,LISP 5B,A00,507671,Munoz Sanchez; Alicia,9,0,20,11
1715603630383,LISP 5C,A00,507696,Munoz Sanchez; Alicia,9,0,20,11
1715603631410,MAE 197,001,528363,Boechler; Nicholas Sebastia,9998,0,9999,1
1715603632439,MATH 197,001,523477,Kedlaya; Kiran S.,9994,0,9999,5
1715603632439,MATH 197,002,563811,Zhang; Danna,9994,0,9999,5
1715603632439,MATH 197,003,628552,Dumitriu; Ioana,9998,0,9999,1
1715603632439,MATH 197,004,660885,Floyd; Eric,9999,0,9999,0
1715603633470,MCWP 40R,A00,518780,Staff,2,0,20,18
1715603633470,MCWP 40R,B00,518781,Staff,11,0,20,9
1715603633470,MCWP 40R,C00,518783,Staff,5,0,20,15
1715603634497,MCWP 50R,A00,518791,Staff,0,1,20,20
1715603634497,MCWP 50R,B00,518792,Staff,0,2,20,20
1715603634497,MCWP 50R,C00,518793,Staff,0,4,20,20
1715603634497,MCWP 50R,D00,518794,Staff,0,1,20,20
1715603634497,MCWP 50R,E00,518795,Staff,0,2,20,20
1715603634497,MCWP 50R,F00,518796,Staff,0,1,20,20
1715603634497,MCWP 50R,G00,518797,Staff,0,1,20,20
1715603635528,MMW 12R,A01,514034,Herbst; Matthew,0,2,16,16
1715603635528,MMW 12R,A02,514035,Herbst; Matthew,0,0,16,16
1715603636560,MMW 13R,A01,514037,Staff,0,5,16,16
1715603636560,MMW 13R,A02,514039,Staff,0,5,16,16
1715603636560,MMW 13R,A03,628519,Staff,0,4,16,16
1715603638623,SIO 295LS,A00,523233,Staff,10,0,30,20
1715603639650,SIO 295S,A00,523232,Staff,10,0,30,20
1715603640678,SIOC 290S,A01,637330,Merrifield; Mark A,23,0,30,7
1715603641704,SIOC 291S,A01,637333,Gabriel; Corey John,23,0,30,7
1715603642731,SOCI 117,A01,494376,Staff,0,5,5,5
1715603643764,WES 237B,A00,494380,Staff,10,0,20,10
1715603645840,AESE 279B,A00,494370,Wade; Jon P,0,0,33,33
1715603646869,AIP 97,001,660915,Van Den Einde; Yael Dahlia,9999,0,9999,0
1715603647907,AIP 197,001,627712,Vespa; Emanuel Ignacio,9995,0,9999,4
1715603647907,AIP 197,002,650778,Amir; On,9998,0,9999,1
1715603647907,AIP 197,003,650933,Avenancio-Leon; Carlos,9998,0,9999,1
1715603647907,AIP 197,004,658530,Heyman; Gail D.,9998,0,9999,1
1715603647907,AIP 197,005,658631,Neal; Sonya E,9998,0,9999,1
1715603647907,AIP 197,006,658671,Du; Songzi,9998,0,9999,1
1715603648937,ANAR 135S,A00,494369,Braswell; Geoffrey E.,0,0,0,0
1715603649965,BENG 196,001,628496,Engler; Adam J.,9998,0,9999,1
1715603649965,BENG 196,002,660916,Watson; John Thomas,9999,0,9999,0
1715603650992,BISP 197,001,650773,Wilhelm; James E.,9994,0,9999,5
1715603650992,BISP 197,002,658904,Coleman; Aaron B.,9998,0,9999,1
1715603652019,CAT 124RS,A01,519847,Geibel; William,0,0,20,20
1715603653045,CAT 125RS,A01,515971,Geibel; William,0,0,20,20
1715603654074,CLRE 250,A00,511389,Morris; Sheldon,9992,0,9999,7
1715603655106,CLRE 251,A00,507176,Mehta; Ravindra L.,9992,0,9999,7
1715603655106,CLRE 251,B00,511410,Mehta; Ravindra L.,9998,0,9999,1
1715603656135,CLRE 252,A00,507189,Cuomo; Raphael Eduardo,9994,0,9999,5
1715603657162,CLRE 253,A00,507199,Vaida; Florin,9994,0,9999,5
1715603657162,CLRE 253,B00,507202,Vaida; Florin,9999,0,9999,0
1715603658190,CLRE 259,A00,507211,Patel; Hemal,9996,0,9999,3
1715603659215,CLRE 260,A00,507221,Cuomo; Raphael Eduardo,9999,0,9999,0
1715603660242,CLRE 297,001,507242,Cuomo; Raphael Eduardo,9999,0,9999,0
1715603661270,COGS 197,001,638244,Voytek; Bradley Thomas,9997,0,9999,2
1715603662295,CSE 191,A00,516875,Minnes Kemp; Mor Mia,9991,0,9999,8
1715603663322,CSE 197,001,637388,Minnes Kemp; Mor Mia,9992,0,9999,7
1715603664348,CSS 201S,A01,494383,Mignozzetti; Umberto,35,0,35,0
1715603665381,CSS 202S,A01,494387,Mignozzetti; Umberto,35,0,35,0
1715603666408,DSC 197,001,628532,Eldridge; Justin Matthew,9995,0,9999,4
1715603667436,EAP 100,A00,516065,Staff,9799,0,9999,200
1715603668465,ECE 45,A01,507414,Staff,31,0,60,29
1715603670516,ECE 111,A01,507420,Staff,11,0,50,39
1715603671544,ECE 197,001,548057,Sievenpiper; Daniel F.,9991,0,9999,8
1715603672573,EDS 115,A00,507243,Choi; Bailey Miyeon,7,0,28,21
1715603673599,EDS 117,A01,494379,Staff,0,6,34,34
1715603674625,EDS 125,A00,507246,Hopkins; Megan Beth,8,0,30,22
1715603675654,EDS 128A,A01,507264,Fargason; Sharon Gayle,6,0,26,20
1715603676681,EDS 128B,A01,507293,Pappas; Elizabeth,10,0,30,20
1715603677707,EDS 139,A00,507294,Fargason; Sharon Gayle,10,0,30,20
1715603677707,EDS 139,B00,507313,Pappas; Elizabeth,11,0,30,19
1715603678736,EDS 201,A00,507315,Staff,10,0,30,20
1715603679767,EDS 203,A01,507317,Halter; Christopher P.,10,0,30,20
1715603680794,EDS 204R,A01,507319,Halter; Christopher P.,0,3,30,30
1715603680794,EDS 204R,B01,507331,Heinzman; Erica M.,14,0,30,16
1715603681824,EDS 206R,A00,507332,Staff,0,4,30,30
1715603681824,EDS 206R,B00,507343,Staff,15,0,30,15
1715603682853,EDS 250,A00,507344,Hemans; Patricia Ann Benitez,20,0,40,20
1715603683883,EDS 281,A00,507345,Daly; Alan J.,18,0,18,0
1715603684912,EDS 284,A00,507350,Daly; Alan J.,16,0,16,0
1715603685944,EDS 286,A00,507359,Fine; Sarah,18,0,18,0
1715603686971,EDS 289C,A01,507361,Daly; Alan J.,18,0,18,0
1715603687999,EDS 290,A00,507366,Hofstetter; Carolyn,15,0,15,0
1715603689032,LIGM 5A,A00,507421,Fischer-Grunski; Eva K,17,0,20,3
1715603690058,LIGM 5B,A00,507423,Fischer-Grunski; Eva K,19,0,20,1
1715603691082,LIGM 5C,A00,507425,Fischer-Grunski; Eva K,19,0,20,1
1715603692108,LIIT 5AS,A00,507427,Carnelos; Chiara,20,0,20,0
1715603693136,LIIT 5BS,A00,507430,Carnelos; Chiara,20,0,20,0
1715603694169,LIIT 5CS,A00,507432,Carnelos; Chiara,20,0,20,0
1715603695196,LISP 5A,A00,507541,Munoz Sanchez; Alicia,11,0,20,9
1715603696223,LISP 5B,A00,507671,Munoz Sanchez; Alicia,9,0,20,11
1715603697253,LISP 5C,A00,507696,Munoz Sanchez; Alicia,9,0,20,11
1715603698280,MAE 197,001,528363,Boechler; Nicholas Sebastia,9998,0,9999,1
1715603699318,MATH 197,001,523477,Kedlaya; Kiran S.,9994,0,9999,5
1715603699318,MATH 197,002,563811,Zhang; Danna,9994,0,9999,5
1715603699318,MATH 197,003,628552,Dumitriu; Ioana,9998,0,9999,1
1715603699318,MATH 197,004,660885,Floyd; Eric,9999,0,9999,0
1715603700348,MCWP 40R,A00,518780,Staff,2,0,20,18
1715603700348,MCWP 40R,B00,518781,Staff,11,0,20,9
1715603700348,MCWP 40R,C00,518783,Staff,5,0,20,15
1715603701375,MCWP 50R,A00,518791,Staff,0,1,20,20
1715603701375,MCWP 50R,B00,518792,Staff,0,2,20,20
1715603701375,MCWP 50R,C00,518793,Staff,0,4,20,20
1715603701375,MCWP 50R,D00,518794,Staff,0,1,20,20
1715603701375,MCWP 50R,E00,518795,Staff,0,2,20,20
1715603701375,MCWP 50R,F00,518796,Staff,0,1,20,20
1715603701375,MCWP 50R,G00,518797,Staff,0,1,20,20
1715603702400,MMW 12R,A01,514034,Herbst; Matthew,0,2,16,16
1715603702400,MMW 12R,A02,514035,Herbst; Matthew,0,0,16,16
1715603703429,MMW 13R,A01,514037,Staff,0,5,16,16
1715603703429,MMW 13R,A02,514039,Staff,0,5,16,16
1715603703429,MMW 13R,A03,628519,Staff,0,4,16,16
1715603705480,SIO 295LS,A00,523233,Staff,10,0,30,20
1715603706506,SIO 295S,A00,523232,Staff,10,0,30,20
1715603707534,SIOC 290S,A01,637330,Merrifield; Mark A,23,0,30,7
1715603708564,SIOC 291S,A01,637333,Gabriel; Corey John,23,0,30,7
1715603709595,SOCI 117,A01,494376,Staff,0,5,5,5
1715603710622,WES 237B,A00,494380,Staff,10,0,20,10
1715603712708,AESE 279B,A00,494370,Wade; Jon P,0,0,33,33
1715603713739,AIP 97,001,660915,Van Den Einde; Yael Dahlia,9999,0,9999,0
1715603714825,AIP 197,001,627712,Vespa; Emanuel Ignacio,9995,0,9999,4
1715603714825,AIP 197,002,650778,Amir; On,9998,0,9999,1
1715603714825,AIP 197,003,650933,Avenancio-Leon; Carlos,9998,0,9999,1
1715603714825,AIP 197,004,658530,Heyman; Gail D.,9998,0,9999,1
1715603714825,AIP 197,005,658631,Neal; Sonya E,9998,0,9999,1
1715603714825,AIP 197,006,658671,Du; Songzi,9998,0,9999,1
1715603715856,ANAR 135S,A00,494369,Braswell; Geoffrey E.,0,0,0,0
1715603716885,BENG 196,001,628496,Engler; Adam J.,9998,0,9999,1
1715603716885,BENG 196,002,660916,Watson; John Thomas,9999,0,9999,0
1715603717912,BISP 197,001,650773,Wilhelm; James E.,9994,0,9999,5
1715603717912,BISP 197,002,658904,Coleman; Aaron B.,9998,0,9999,1
1715603718940,CAT 124RS,A01,519847,Geibel; William,0,0,20,20
1715603719965,CAT 125RS,A01,515971,Geibel; William,0,0,20,20
1715603720995,CLRE 250,A00,511389,Morris; Sheldon,9992,0,9999,7
1715603722022,CLRE 251,A00,507176,Mehta; Ravindra L.,9992,0,9999,7
1715603722022,CLRE 251,B00,511410,Mehta; Ravindra L.,9998,0,9999,1
1715603723053,CLRE 252,A00,507189,Cuomo; Raphael Eduardo,9994,0,9999,5
1715603724083,CLRE 253,A00,507199,Vaida; Florin,9994,0,9999,5
1715603724083,CLRE 253,B00,507202,Vaida; Florin,9999,0,9999,0
1715603725112,CLRE 259,A00,507211,Patel; Hemal,9996,0,9999,3
1715603726137,CLRE 260,A00,507221,Cuomo; Raphael Eduardo,9999,0,9999,0
1715603727163,CLRE 297,001,507242,Cuomo; Raphael Eduardo,9999,0,9999,0
1715603728191,COGS 197,001,638244,Voytek; Bradley Thomas,9997,0,9999,2
1715603729224,CSE 191,A00,516875,Minnes Kemp; Mor Mia,9991,0,9999,8
1715603730254,CSE 197,001,637388,Minnes Kemp; Mor Mia,9992,0,9999,7
1715603731281,CSS 201S,A01,494383,Mignozzetti; Umberto,35,0,35,0
1715603732313,CSS 202S,A01,494387,Mignozzetti; Umberto,35,0,35,0
1715603733342,DSC 197,001,628532,Eldridge; Justin Matthew,9995,0,9999,4
1715603734367,EAP 100,A00,516065,Staff,9799,0,9999,200
1715603735394,ECE 45,A01,507414,Staff,31,0,60,29
1715603737447,ECE 111,A01,507420,Staff,11,0,50,39
1715603738475,ECE 197,001,548057,Sievenpiper; Daniel F.,9991,0,9999,8
1715603739503,EDS 115,A00,507243,Choi; Bailey Miyeon,7,0,28,21
1715603740534,EDS 117,A01,494379,Staff,0,6,34,34
1715603741561,EDS 125,A00,507246,Hopkins; Megan Beth,8,0,30,22
1715603742588,EDS 128A,A01,507264,Fargason; Sharon Gayle,6,0,26,20
1715603743613,EDS 128B,A01,507293,Pappas; Elizabeth,10,0,30,20
1715603744643,EDS 139,A00,507294,Fargason; Sharon Gayle,10,0,30,20
1715603744643,EDS 139,B00,507313,Pappas; Elizabeth,11,0,30,19
1715603745667,EDS 201,A00,507315,Staff,10,0,30,20
1715603746695,EDS 203,A01,507317,Halter; Christopher P.,10,0,30,20
1715603747722,EDS 204R,A01,507319,Halter; Christopher P.,0,3,30,30
1715603747722,EDS 204R,B01,507331,Heinzman; Erica M.,14,0,30,16
1715603748751,EDS 206R,A00,507332,Staff,0,4,30,30
1715603748751,EDS 206R,B00,507343,Staff,15,0,30,15
1715603749777,EDS 250,A00,507344,Hemans; Patricia Ann Benitez,20,0,40,20
1715603750803,EDS 281,A00,507345,Daly; Alan J.,18,0,18,0
1715603751828,EDS 284,A00,507350,Daly; Alan J.,16,0,16,0
1715603752859,EDS 286,A00,507359,Fine; Sarah,18,0,18,0
1715603753898,EDS 289C,A01,507361,Daly; Alan J.,18,0,18,0
1715603754926,EDS 290,A00,507366,Hofstetter; Carolyn,15,0,15,0
1715603755956,LIGM 5A,A00,507421,Fischer-Grunski; Eva K,17,0,20,3
1715603756983,LIGM 5B,A00,507423,Fischer-Grunski; Eva K,19,0,20,1
1715603758010,LIGM 5C,A00,507425,Fischer-Grunski; Eva K,19,0,20,1
1715603759041,LIIT 5AS,A00,507427,Carnelos; Chiara,20,0,20,0
1715603760067,LIIT 5BS,A00,507430,Carnelos; Chiara,20,0,20,0
1715603761094,LIIT 5CS,A00,507432,Carnelos; Chiara,20,0,20,0
1715603762130,LISP 5A,A00,507541,Munoz Sanchez; Alicia,11,0,20,9
1715603763157,LISP 5B,A00,507671,Munoz Sanchez; Alicia,9,0,20,11
1715603764188,LISP 5C,A00,507696,Munoz Sanchez; Alicia,9,0,20,11
1715603765214,MAE 197,001,528363,Boechler; Nicholas Sebastia,9998,0,9999,1
1715603766243,MATH 197,001,523477,Kedlaya; Kiran S.,9994,0,9999,5
1715603766243,MATH 197,002,563811,Zhang; Danna,9994,0,9999,5
1715603766243,MATH 197,003,628552,Dumitriu; Ioana,9998,0,9999,1
1715603766243,MATH 197,004,660885,Floyd; Eric,9999,0,9999,0
1715603767274,MCWP 40R,A00,518780,Staff,2,0,20,18
1715603767274,MCWP 40R,B00,518781,Staff,11,0,20,9
1715603767274,MCWP 40R,C00,518783,Staff,5,0,20,15
1715603768303,MCWP 50R,A00,518791,Staff,0,1,20,20
1715603768303,MCWP 50R,B00,518792,Staff,0,2,20,20
1715603768303,MCWP 50R,C00,518793,Staff,0,4,20,20
1715603768303,MCWP 50R,D00,518794,Staff,0,1,20,20
1715603768303,MCWP 50R,E00,518795,Staff,0,2,20,20
1715603768303,MCWP 50R,F00,518796,Staff,0,1,20,20
1715603768303,MCWP 50R,G00,518797,Staff,0,1,20,20
1715603769329,MMW 12R,A01,514034,Herbst; Matthew,0,2,16,16
1715603769329,MMW 12R,A02,514035,Herbst; Matthew,0,0,16,16
1715603770355,MMW 13R,A01,514037,Staff,0,5,16,16
1715603770355,MMW 13R,A02,514039,Staff,0,5,16,16
1715603770355,MMW 13R,A03,628519,Staff,0,4,16,16
1715603772408,SIO 295LS,A00,523233,Staff,10,0,30,20
1715603773434,SIO 295S,A00,523232,Staff,10,0,30,20
1715603774469,SIOC 290S,A01,637330,Merrifield; Mark A,23,0,30,7
1715603775497,SIOC 291S,A01,637333,Gabriel; Corey John,23,0,30,7
1715603776523,SOCI 117,A01,494376,Staff,0,5,5,5
1715603777553,WES 237B,A00,494380,Staff,10,0,20,10
1715603779619,AESE 279B,A00,494370,Wade; Jon P,0,0,33,33
1715603780648,AIP 97,001,660915,Van Den Einde; Yael Dahlia,9999,0,9999,0
1715603781678,AIP 197,001,627712,Vespa; Emanuel Ignacio,9995,0,9999,4
1715603781678,AIP 197,002,650778,Amir; On,9998,0,9999,1
1715603781678,AIP 197,003,650933,Avenancio-Leon; Carlos,9998,0,9999,1
1715603781678,AIP 197,004,658530,Heyman; Gail D.,9998,0,9999,1
1715603781678,AIP 197,005,658631,Neal; Sonya E,9998,0,9999,1
1715603781678,AIP 197,006,658671,Du; Songzi,9998,0,9999,1
1715603782702,ANAR 135S,A00,494369,Braswell; Geoffrey E.,0,0,0,0
1715603783729,BENG 196,001,628496,Engler; Adam J.,9998,0,9999,1
1715603783729,BENG 196,002,660916,Watson; John Thomas,9999,0,9999,0
1715603784758,BISP 197,001,650773,Wilhelm; James E.,9994,0,9999,5
1715603784758,BISP 197,002,658904,Coleman; Aaron B.,9998,0,9999,1
1715603785790,CAT 124RS,A01,519847,Geibel; William,0,0,20,20
1715603786816,CAT 125RS,A01,515971,Geibel; William,0,0,20,20
1715603787848,CLRE 250,A00,511389,Morris; Sheldon,9992,0,9999,7
1715603788882,CLRE 251,A00,507176,Mehta; Ravindra L.,9992,0,9999,7
1715603788882,CLRE 251,B00,511410,Mehta; Ravindra L.,9998,0,9999,1
1715603789914,CLRE 252,A00,507189,Cuomo; Raphael Eduardo,9994,0,9999,5
1715603790945,CLRE 253,A00,507199,Vaida; Florin,9994,0,9999,5
1715603790945,CLRE 253,B00,507202,Vaida; Florin,9999,0,9999,0
1715603791970,CLRE 259,A00,507211,Patel; Hemal,9996,0,9999,3
1715603792996,CLRE 260,A00,507221,Cuomo; Raphael Eduardo,9999,0,9999,0
1715603794024,CLRE 297,001,507242,Cuomo; Raphael Eduardo,9999,0,9999,0
1715603795050,COGS 197,001,638244,Voytek; Bradley Thomas,9997,0,9999,2
1715603796077,CSE 191,A00,516875,Minnes Kemp; Mor Mia,9991,0,9999,8
1715603797105,CSE 197,001,637388,Minnes Kemp; Mor Mia,9992,0,9999,7
1715603798133,CSS 201S,A01,494383,Mignozzetti; Umberto,35,0,35,0
1715603799164,CSS 202S,A01,494387,Mignozzetti; Umberto,35,0,35,0
1715603800195,DSC 197,001,628532,Eldridge; Justin Matthew,9995,0,9999,4
1715603801224,EAP 100,A00,516065,Staff,9799,0,9999,200
1715603802252,ECE 45,A01,507414,Staff,31,0,60,29
1715603804309,ECE 111,A01,507420,Staff,11,0,50,39
1715603805341,ECE 197,001,548057,Sievenpiper; Daniel F.,9991,0,9999,8
1715603806368,EDS 115,A00,507243,Choi; Bailey Miyeon,7,0,28,21
1715603807399,EDS 117,A01,494379,Staff,0,6,34,34
1715603808431,EDS 125,A00,507246,Hopkins; Megan Beth,8,0,30,22
1715603809459,EDS 128A,A01,507264,Fargason; Sharon Gayle,6,0,26,20
1715603810491,EDS 128B,A01,507293,Pappas; Elizabeth,10,0,30,20
1715603811518,EDS 139,A00,507294,Fargason; Sharon Gayle,10,0,30,20
1715603811518,EDS 139,B00,507313,Pappas; Elizabeth,11,0,30,19
1715603812547,EDS 201,A00,507315,Staff,10,0,30,20
1715603813574,EDS 203,A01,507317,Halter; Christopher P.,10,0,30,20
1715603814601,EDS 204R,A01,507319,Halter; Christopher P.,0,3,30,30
1715603814601,EDS 204R,B01,507331,Heinzman; Erica M.,14,0,30,16
1715603815626,EDS 206R,A00,507332,Staff,0,4,30,30
1715603815626,EDS 206R,B00,507343,Staff,15,0,30,15
1715603816654,EDS 250,A00,507344,Hemans; Patricia Ann Benitez,20,0,40,20
1715603817680,EDS 281,A00,507345,Daly; Alan J.,18,0,18,0
1715603818759,EDS 284,A00,507350,Daly; Alan J.,16,0,16,0
1715603819784,EDS 286,A00,507359,Fine; Sarah,18,0,18,0
1715603820810,EDS 289C,A01,507361,Daly; Alan J.,18,0,18,0
1715603821836,EDS 290,A00,507366,Hofstetter; Carolyn,15,0,15,0
1715603822862,LIGM 5A,A00,507421,Fischer-Grunski; Eva K,17,0,20,3
1715603823888,LIGM 5B,A00,507423,Fischer-Grunski; Eva K,19,0,20,1
1715603824912,LIGM 5C,A00,507425,Fischer-Grunski; Eva K,19,0,20,1
1715603825941,LIIT 5AS,A00,507427,Carnelos; Chiara,20,0,20,0
1715603826967,LIIT 5BS,A00,507430,Carnelos; Chiara,20,0,20,0
1715603827993,LIIT 5CS,A00,507432,Carnelos; Chiara,20,0,20,0
1715603829022,LISP 5A,A00,507541,Munoz Sanchez; Alicia,11,0,20,9
1715603830052,LISP 5B,A00,507671,Munoz Sanchez; Alicia,9,0,20,11
1715603831079,LISP 5C,A00,507696,Munoz Sanchez; Alicia,9,0,20,11
1715603832106,MAE 197,001,528363,Boechler; Nicholas Sebastia,9998,0,9999,1
1715603833135,MATH 197,001,523477,Kedlaya; Kiran S.,9994,0,9999,5
1715603833135,MATH 197,002,563811,Zhang; Danna,9994,0,9999,5
1715603833135,MATH 197,003,628552,Dumitriu; Ioana,9998,0,9999,1
1715603833135,MATH 197,004,660885,Floyd; Eric,9999,0,9999,0
1715603834160,MCWP 40R,A00,518780,Staff,2,0,20,18
1715603834160,MCWP 40R,B00,518781,Staff,11,0,20,9
1715603834160,MCWP 40R,C00,518783,Staff,5,0,20,15
1715603835186,MCWP 50R,A00,518791,Staff,0,1,20,20
1715603835186,MCWP 50R,B00,518792,Staff,0,2,20,20
1715603835186,MCWP 50R,C00,518793,Staff,0,4,20,20
1715603835186,MCWP 50R,D00,518794,Staff,0,1,20,20
1715603835186,MCWP 50R,E00,518795,Staff,0,2,20,20
1715603835186,MCWP 50R,F00,518796,Staff,0,1,20,20
1715603835186,MCWP 50R,G00,518797,Staff,0,1,20,20
1715603836217,MMW 12R,A01,514034,Herbst; Matthew,0,2,16,16
1715603836217,MMW 12R,A02,514035,Herbst; Matthew,0,0,16,16
1715603837247,MMW 13R,A01,514037,Staff,0,5,16,16
1715603837247,MMW 13R,A02,514039,Staff,0,5,16,16
1715603837247,MMW 13R,A03,628519,Staff,0,4,16,16
1715603839306,SIO 295LS,A00,523233,Staff,10,0,30,20
1715603840331,SIO 295S,A00,523232,Staff,10,0,30,20
1715603841362,SIOC 290S,A01,637330,Merrifield; Mark A,23,0,30,7
1715603842389,SIOC 291S,A01,637333,Gabriel; Corey John,23,0,30,7
1715603843415,SOCI 117,A01,494376,Staff,0,5,5,5
1715603844442,WES 237B,A00,494380,Staff,10,0,20,10
1715603846516,AESE 279B,A00,494370,Wade; Jon P,0,0,33,33
1715603847546,AIP 97,001,660915,Van Den Einde; Yael Dahlia,9999,0,9999,0
1715603848583,AIP 197,001,627712,Vespa; Emanuel Ignacio,9995,0,9999,4
1715603848583,AIP 197,002,650778,Amir; On,9998,0,9999,1
1715603848583,AIP 197,003,650933,Avenancio-Leon; Carlos,9998,0,9999,1
1715603848583,AIP 197,004,658530,Heyman; Gail D.,9998,0,9999,1
1715603848583,AIP 197,005,658631,Neal; Sonya E,9998,0,9999,1
1715603848583,AIP 197,006,658671,Du; Songzi,9998,0,9999,1
1715603849612,ANAR 135S,A00,494369,Braswell; Geoffrey E.,0,0,0,0
1715603850641,BENG 196,001,628496,Engler; Adam J.,9998,0,9999,1
1715603850641,BENG 196,002,660916,Watson; John Thomas,9999,0,9999,0
1715603851671,BISP 197,001,650773,Wilhelm; James E.,9994,0,9999,5
1715603851671,BISP 197,002,658904,Coleman; Aaron B.,9998,0,9999,1
1715603852701,CAT 124RS,A01,519847,Geibel; William,0,0,20,20
1715603853730,CAT 125RS,A01,515971,Geibel; William,0,0,20,20
1715603854760,CLRE 250,A00,511389,Morris; Sheldon,9992,0,9999,7
1715603855790,CLRE 251,A00,507176,Mehta; Ravindra L.,9992,0,9999,7
1715603855790,CLRE 251,B00,511410,Mehta; Ravindra L.,9998,0,9999,1
1715603856822,CLRE 252,A00,507189,Cuomo; Raphael Eduardo,9994,0,9999,5
1715603857853,CLRE 253,A00,507199,Vaida; Florin,9994,0,9999,5
1715603857853,CLRE 253,B00,507202,Vaida; Florin,9999,0,9999,0
1715603858884,CLRE 259,A00,507211,Patel; Hemal,9996,0,9999,3
1715603859909,CLRE 260,A00,507221,Cuomo; Raphael Eduardo,9999,0,9999,0
1715603860934,CLRE 297,001,507242,Cuomo; Raphael Eduardo,9999,0,9999,0
1715603861961,COGS 197,001,638244,Voytek; Bradley Thomas,9997,0,9999,2
1715603862990,CSE 191,A00,516875,Minnes Kemp; Mor Mia,9991,0,9999,8
1715603864015,CSE 197,001,637388,Minnes Kemp; Mor Mia,9992,0,9999,7
1715603865043,CSS 201S,A01,494383,Mignozzetti; Umberto,35,0,35,0
1715603866070,CSS 202S,A01,494387,Mignozzetti; Umberto,35,0,35,0
1715603867096,DSC 197,001,628532,Eldridge; Justin Matthew,9995,0,9999,4
1715603868124,EAP 100,A00,516065,Staff,9799,0,9999,200
1715603869156,ECE 45,A01,507414,Staff,31,0,60,29
1715603871207,ECE 111,A01,507420,Staff,11,0,50,39
1715603872233,ECE 197,001,548057,Sievenpiper; Daniel F.,9991,0,9999,8
1715603873261,EDS 115,A00,507243,Choi; Bailey Miyeon,7,0,28,21
1715603874288,EDS 117,A01,494379,Staff,0,6,34,34
1715603875319,EDS 125,A00,507246,Hopkins; Megan Beth,8,0,30,22
1715603876350,EDS 128A,A01,507264,Fargason; Sharon Gayle,6,0,26,20
1715603877379,EDS 128B,A01,507293,Pappas; Elizabeth,10,0,30,20
1715603878406,EDS 139,A00,507294,Fargason; Sharon Gayle,10,0,30,20
1715603878406,EDS 139,B00,507313,Pappas; Elizabeth,11,0,30,19
1715603879435,EDS 201,A00,507315,Staff,10,0,30,20
1715603880463,EDS 203,A01,507317,Halter; Christopher P.,10,0,30,20
1715603881490,EDS 204R,A01,507319,Halter; Christopher P.,0,3,30,30
1715603881490,EDS 204R,B01,507331,Heinzman; Erica M.,14,0,30,16
1715603882519,EDS 206R,A00,507332,Staff,0,4,30,30
1715603882519,EDS 206R,B00,507343,Staff,15,0,30,15
1715603883545,EDS 250,A00,507344,Hemans; Patricia Ann Benitez,20,0,40,20
1715603884576,EDS 281,A00,507345,Daly; Alan J.,18,0,18,0
1715603885604,EDS 284,A00,507350,Daly; Alan J.,16,0,16,0
1715603886630,EDS 286,A00,507359,Fine; Sarah,18,0,18,0
1715603887657,EDS 289C,A01,507361,Daly; Alan J.,18,0,18,0
1715603888683,EDS 290,A00,507366,Hofstetter; Carolyn,15,0,15,0
1715603889710,LIGM 5A,A00,507421,Fischer-Grunski; Eva K,17,0,20,3
1715603890737,LIGM 5B,A00,507423,Fischer-Grunski; Eva K,19,0,20,1
1715603891766,LIGM 5C,A00,507425,Fischer-Grunski; Eva K,19,0,20,1
1715603892796,LIIT 5AS,A00,507427,Carnelos; Chiara,20,0,20,0
1715603893822,LIIT 5BS,A00,507430,Carnelos; Chiara,20,0,20,0
1715603894850,LIIT 5CS,A00,507432,Carnelos; Chiara,20,0,20,0
1715603895878,LISP 5A,A00,507541,Munoz Sanchez; Alicia,11,0,20,9
1715603896905,LISP 5B,A00,507671,Munoz Sanchez; Alicia,9,0,20,11
1715603897935,LISP 5C,A00,507696,Munoz Sanchez; Alicia,9,0,20,11
1715603898962,MAE 197,001,528363,Boechler; Nicholas Sebastia,9998,0,9999,1
1715603899991,MATH 197,001,523477,Kedlaya; Kiran S.,9994,0,9999,5
1715603899991,MATH 197,002,563811,Zhang; Danna,9994,0,9999,5
1715603899991,MATH 197,003,628552,Dumitriu; Ioana,9998,0,9999,1
1715603899991,MATH 197,004,660885,Floyd; Eric,9999,0,9999,0
1715603901019,MCWP 40R,A00,518780,Staff,2,0,20,18
1715603901019,MCWP 40R,B00,518781,Staff,11,0,20,9
1715603901019,MCWP 40R,C00,518783,Staff,5,0,20,15
1715603902046,MCWP 50R,A00,518791,Staff,0,1,20,20
1715603902046,MCWP 50R,B00,518792,Staff,0,2,20,20
1715603902046,MCWP 50R,C00,518793,Staff,0,4,20,20
1715603902046,MCWP 50R,D00,518794,Staff,0,1,20,20
1715603902046,MCWP 50R,E00,518795,Staff,0,2,20,20
1715603902046,MCWP 50R,F00,518796,Staff,0,1,20,20
1715603902046,MCWP 50R,G00,518797,Staff,0,1,20,20
1715603903073,MMW 12R,A01,514034,Herbst; Matthew,0,2,16,16
1715603903073,MMW 12R,A02,514035,Herbst; Matthew,0,0,16,16
1715603904099,MMW 13R,A01,514037,Staff,0,5,16,16
1715603904099,MMW 13R,A02,514039,Staff,0,5,16,16
1715603904099,MMW 13R,A03,628519,Staff,0,4,16,16
1715603906151,SIO 295LS,A00,523233,Staff,10,0,30,20
1715603907176,SIO 295S,A00,523232,Staff,10,0,30,20
1715603908205,SIOC 290S,A01,637330,Merrifield; Mark A,23,0,30,7
1715603909233,SIOC 291S,A01,637333,Gabriel; Corey John,23,0,30,7
1715603910262,SOCI 117,A01,494376,Staff,0,5,5,5
1715603911287,WES 237B,A00,494380,Staff,10,0,20,10
1715603913360,AESE 279B,A00,494370,Wade; Jon P,0,0,33,33
1715603914392,AIP 97,001,660915,Van Den Einde; Yael Dahlia,9999,0,9999,0
1715603915421,AIP 197,001,627712,Vespa; Emanuel Ignacio,9995,0,9999,4
1715603915421,AIP 197,002,650778,Amir; On,9998,0,9999,1
1715603915421,AIP 197,003,650933,Avenancio-Leon; Carlos,9998,0,9999,1
1715603915421,AIP 197,004,658530,Heyman; Gail D.,9998,0,9999,1
1715603915421,AIP 197,005,658631,Neal; Sonya E,9998,0,9999,1
1715603915421,AIP 197,006,658671,Du; Songzi,9998,0,9999,1
1715603916447,ANAR 135S,A00,494369,Braswell; Geoffrey E.,0,0,0,0
1715603917472,BENG 196,001,628496,Engler; Adam J.,9998,0,9999,1
1715603917472,BENG 196,002,660916,Watson; John Thomas,9999,0,9999,0
1715603918505,BISP 197,001,650773,Wilhelm; James E.,9994,0,9999,5
1715603918505,BISP 197,002,658904,Coleman; Aaron B.,9998,0,9999,1
1715603919531,CAT 124RS,A01,519847,Geibel; William,0,0,20,20
1715603920557,CAT 125RS,A01,515971,Geibel; William,0,0,20,20
1715603921585,CLRE 250,A00,511389,Morris; Sheldon,9992,0,9999,7
1715603922676,CLRE 251,A00,507176,Mehta; Ravindra L.,9992,0,9999,7
1715603922676,CLRE 251,B00,511410,Mehta; Ravindra L.,9998,0,9999,1
1715603923703,CLRE 252,A00,507189,Cuomo; Raphael Eduardo,9994,0,9999,5
1715603924731,CLRE 253,A00,507199,Vaida; Florin,9994,0,9999,5
1715603924731,CLRE 253,B00,507202,Vaida; Florin,9999,0,9999,0
1715603925758,CLRE 259,A00,507211,Patel; Hemal,9996,0,9999,3
1715603926786,CLRE 260,A00,507221,Cuomo; Raphael Eduardo,9999,0,9999,0
1715603927817,CLRE 297,001,507242,Cuomo; Raphael Eduardo,9999,0,9999,0
1715603928853,COGS 197,001,638244,Voytek; Bradley Thomas,9997,0,9999,2
1715603929878,CSE 191,A00,516875,Minnes Kemp; Mor Mia,9991,0,9999,8
1715603930907,CSE 197,001,637388,Minnes Kemp; Mor Mia,9992,0,9999,7
1715603931937,CSS 201S,A01,494383,Mignozzetti; Umberto,35,0,35,0
1715603932967,CSS 202S,A01,494387,Mignozzetti; Umberto,35,0,35,0
1715603933996,DSC 197,001,628532,Eldridge; Justin Matthew,9995,0,9999,4
1715603935024,EAP 100,A00,516065,Staff,9799,0,9999,200
1715603937120,ECE 45,A01,507414,Staff,31,0,60,29
1715603939172,ECE 111,A01,507420,Staff,11,0,50,39
1715603940208,ECE 197,001,548057,Sievenpiper; Daniel F.,9991,0,9999,8
1715603941248,EDS 115,A00,507243,Choi; Bailey Miyeon,7,0,28,21
1715603942276,EDS 117,A01,494379,Staff,0,6,34,34
1715603943312,EDS 125,A00,507246,Hopkins; Megan Beth,8,0,30,22
1715603944343,EDS 128A,A01,507264,Fargason; Sharon Gayle,6,0,26,20
1715603945369,EDS 128B,A01,507293,Pappas; Elizabeth,10,0,30,20
1715603946396,EDS 139,A00,507294,Fargason; Sharon Gayle,10,0,30,20
1715603946396,EDS 139,B00,507313,Pappas; Elizabeth,11,0,30,19
1715603947421,EDS 201,A00,507315,Staff,10,0,30,20
1715603948448,EDS 203,A01,507317,Halter; Christopher P.,10,0,30,20
1715603949477,EDS 204R,A01,507319,Halter; Christopher P.,0,3,30,30
1715603949477,EDS 204R,B01,507331,Heinzman; Erica M.,14,0,30,16
1715603950503,EDS 206R,A00,507332,Staff,0,4,30,30
1715603950503,EDS 206R,B00,507343,Staff,15,0,30,15
1715603951535,EDS 250,A00,507344,Hemans; Patricia Ann Benitez,20,0,40,20
1715603952560,EDS 281,A00,507345,Daly; Alan J.,18,0,18,0
1715603953588,EDS 284,A00,507350,Daly; Alan J.,16,0,16,0
1715603954618,EDS 286,A00,507359,Fine; Sarah,18,0,18,0
1715603955647,EDS 289C,A01,507361,Daly; Alan J.,18,0,18,0
1715603956674,EDS 290,A00,507366,Hofstetter; Carolyn,15,0,15,0
1715603957705,LIGM 5A,A00,507421,Fischer-Grunski; Eva K,17,0,20,3
1715603958736,LIGM 5B,A00,507423,Fischer-Grunski; Eva K,19,0,20,1
1715603959761,LIGM 5C,A00,507425,Fischer-Grunski; Eva K,19,0,20,1
1715603960790,LIIT 5AS,A00,507427,Carnelos; Chiara,20,0,20,0
1715603961816,LIIT 5BS,A00,507430,Carnelos; Chiara,20,0,20,0
1715603962841,LIIT 5CS,A00,507432,Carnelos; Chiara,20,0,20,0
1715603963867,LISP 5A,A00,507541,Munoz Sanchez; Alicia,11,0,20,9
1715603964898,LISP 5B,A00,507671,Munoz Sanchez; Alicia,9,0,20,11
1715603965928,LISP 5C,A00,507696,Munoz Sanchez; Alicia,9,0,20,11
1715603966954,MAE 197,001,528363,Boechler; Nicholas Sebastia,9998,0,9999,1
1715603967990,MATH 197,001,523477,Kedlaya; Kiran S.,9994,0,9999,5
1715603967990,MATH 197,002,563811,Zhang; Danna,9994,0,9999,5
1715603967990,MATH 197,003,628552,Dumitriu; Ioana,9998,0,9999,1
1715603967990,MATH 197,004,660885,Floyd; Eric,9999,0,9999,0
1715603969018,MCWP 40R,A00,518780,Staff,2,0,20,18
1715603969018,MCWP 40R,B00,518781,Staff,11,0,20,9
1715603969018,MCWP 40R,C00,518783,Staff,5,0,20,15
1715603970047,MCWP 50R,A00,518791,Staff,0,1,20,20
1715603970047,MCWP 50R,B00,518792,Staff,0,2,20,20
1715603970047,MCWP 50R,C00,518793,Staff,0,4,20,20
1715603970047,MCWP 50R,D00,518794,Staff,0,1,20,20
1715603970047,MCWP 50R,E00,518795,Staff,0,2,20,20
1715603970047,MCWP 50R,F00,518796,Staff,0,1,20,20
1715603970047,MCWP 50R,G00,518797,Staff,0,1,20,20
1715603971077,MMW 12R,A01,514034,Herbst; Matthew,0,2,16,16
1715603971077,MMW 12R,A02,514035,Herbst; Matthew,0,0,16,16
1715603972104,MMW 13R,A01,514037,Staff,0,5,16,16
1715603972104,MMW 13R,A02,514039,Staff,0,5,16,16
1715603972104,MMW 13R,A03,628519,Staff,0,4,16,16
1715603974157,SIO 295LS,A00,523233,Staff,10,0,30,20
1715603975182,SIO 295S,A00,523232,Staff,10,0,30,20
1715603976214,SIOC 290S,A01,637330,Merrifield; Mark A,23,0,30,7
1715603977246,SIOC 291S,A01,637333,Gabriel; Corey John,23,0,30,7
1715603978273,SOCI 117,A01,494376,Staff,0,5,5,5
1715603979303,WES 237B,A00,494380,Staff,10,0,20,10
1715603981384,AESE 279B,A00,494370,Wade; Jon P,0,0,33,33
1715603982416,AIP 97,001,660915,Van Den Einde; Yael Dahlia,9999,0,9999,0
1715603983446,AIP 197,001,627712,Vespa; Emanuel Ignacio,9995,0,9999,4
1715603983446,AIP 197,002,650778,Amir; On,9998,0,9999,1
1715603983446,AIP 197,003,650933,Avenancio-Leon; Carlos,9998,0,9999,1
1715603983446,AIP 197,004,658530,Heyman; Gail D.,9998,0,9999,1
1715603983446,AIP 197,005,658631,Neal; Sonya E,9998,0,9999,1
1715603983446,AIP 197,006,658671,Du; Songzi,9998,0,9999,1
1715603984478,ANAR 135S,A00,494369,Braswell; Geoffrey E.,0,0,0,0
1715603985504,BENG 196,001,628496,Engler; Adam J.,9998,0,9999,1
1715603985504,BENG 196,002,660916,Watson; John Thomas,9999,0,9999,0
1715603986535,BISP 197,001,650773,Wilhelm; James E.,9994,0,9999,5
1715603986535,BISP 197,002,658904,Coleman; Aaron B.,9998,0,9999,1
1715603987561,CAT 124RS,A01,519847,Geibel; William,0,0,20,20
1715603988591,CAT 125RS,A01,515971,Geibel; William,0,0,20,20
1715603989622,CLRE 250,A00,511389,Morris; Sheldon,9992,0,9999,7
1715603990651,CLRE 251,A00,507176,Mehta; Ravindra L.,9992,0,9999,7
1715603990651,CLRE 251,B00,511410,Mehta; Ravindra L.,9998,0,9999,1
1715603991683,CLRE 252,A00,507189,Cuomo; Raphael Eduardo,9994,0,9999,5
1715603992712,CLRE 253,A00,507199,Vaida; Florin,9994,0,9999,5
1715603992712,CLRE 253,B00,507202,Vaida; Florin,9999,0,9999,0
1715603993738,CLRE 259,A00,507211,Patel; Hemal,9996,0,9999,3
1715603994766,CLRE 260,A00,507221,Cuomo; Raphael Eduardo,9999,0,9999,0
1715603995790,CLRE 297,001,507242,Cuomo; Raphael Eduardo,9999,0,9999,0
1715603996817,COGS 197,001,638244,Voytek; Bradley Thomas,9997,0,9999,2
1715603997846,CSE 191,A00,516875,Minnes Kemp; Mor Mia,9991,0,9999,8
1715603998872,CSE 197,001,637388,Minnes Kemp; Mor Mia,9992,0,9999,7
1715603999907,CSS 201S,A01,494383,Mignozzetti; Umberto,35,0,35,0
1715604000937,CSS 202S,A01,494387,Mignozzetti; Umberto,35,0,35,0
1715604001963,DSC 197,001,628532,Eldridge; Justin Matthew,9995,0,9999,4
1715604002990,EAP 100,A00,516065,Staff,9799,0,9999,200
1715604004017,ECE 45,A01,507414,Staff,31,0,60,29
1715604006072,ECE 111,A01,507420,Staff,11,0,50,39
1715604007102,ECE 197,001,548057,Sievenpiper; Daniel F.,9991,0,9999,8
1715604008128,EDS 115,A00,507243,Choi; Bailey Miyeon,7,0,28,21
1715604009161,EDS 117,A01,494379,Staff,0,6,34,34
1715604010191,EDS 125,A00,507246,Hopkins; Megan Beth,8,0,30,22
1715604011222,EDS 128A,A01,507264,Fargason; Sharon Gayle,6,0,26,20
1715604012254,EDS 128B,A01,507293,Pappas; Elizabeth,10,0,30,20
1715604013282,EDS 139,A00,507294,Fargason; Sharon Gayle,10,0,30,20
1715604013282,EDS 139,B00,507313,Pappas; Elizabeth,11,0,30,19
1715604014314,EDS 201,A00,507315,Staff,10,0,30,20
1715604015344,EDS 203,A01,507317,Halter; Christopher P.,10,0,30,20
1715604016376,EDS 204R,A01,507319,Halter; Christopher P.,0,3,30,30
1715604016376,EDS 204R,B01,507331,Heinzman; Erica M.,14,0,30,16
1715604017403,EDS 206R,A00,507332,Staff,0,4,30,30
1715604017403,EDS 206R,B00,507343,Staff,15,0,30,15
1715604018437,EDS 250,A00,507344,Hemans; Patricia Ann Benitez,20,0,40,20
1715604019468,EDS 281,A00,507345,Daly; Alan J.,18,0,18,0
1715604020494,EDS 284,A00,507350,Daly; Alan J.,16,0,16,0
1715604021522,EDS 286,A00,507359,Fine; Sarah,18,0,18,0
1715604022548,EDS 289C,A01,507361,Daly; Alan J.,18,0,18,0
1715604023574,EDS 290,A00,507366,Hofstetter; Carolyn,15,0,15,0
1715604024600,LIGM 5A,A00,507421,Fischer-Grunski; Eva K,17,0,20,3
1715604025625,LIGM 5B,A00,507423,Fischer-Grunski; Eva K,19,0,20,1
1715604026651,LIGM 5C,A00,507425,Fischer-Grunski; Eva K,19,0,20,1
1715604027734,LIIT 5AS,A00,507427,Carnelos; Chiara,20,0,20,0
1715604028765,LIIT 5BS,A00,507430,Carnelos; Chiara,20,0,20,0
1715604029795,LIIT 5CS,A00,507432,Carnelos; Chiara,20,0,20,0
1715604030821,LISP 5A,A00,507541,Munoz Sanchez; Alicia,11,0,20,9
1715604031846,LISP 5B,A00,507671,Munoz Sanchez; Alicia,9,0,20,11
1715604032876,LISP 5C,A00,507696,Munoz Sanchez; Alicia,9,0,20,11
1715604033909,MAE 197,001,528363,Boechler; Nicholas Sebastia,9998,0,9999,1
1715604034937,MATH 197,001,523477,Kedlaya; Kiran S.,9994,0,9999,5
1715604034937,MATH 197,002,563811,Zhang; Danna,9994,0,9999,5
1715604034937,MATH 197,003,628552,Dumitriu; Ioana,9998,0,9999,1
1715604034937,MATH 197,004,660885,Floyd; Eric,9999,0,9999,0
1715604035964,MCWP 40R,A00,518780,Staff,2,0,20,18
1715604035964,MCWP 40R,B00,518781,Staff,11,0,20,9
1715604035964,MCWP 40R,C00,518783,Staff,5,0,20,15
1715604036991,MCWP 50R,A00,518791,Staff,0,1,20,20
1715604036991,MCWP 50R,B00,518792,Staff,0,2,20,20
1715604036991,MCWP 50R,C00,518793,Staff,0,4,20,20
1715604036991,MCWP 50R,D00,518794,Staff,0,1,20,20
1715604036991,MCWP 50R,E00,518795,Staff,0,2,20,20
1715604036991,MCWP 50R,F00,518796,Staff,0,1,20,20
1715604036991,MCWP 50R,G00,518797,Staff,0,1,20,20
1715604038016,MMW 12R,A01,514034,Herbst; Matthew,0,2,16,16
1715604038016,MMW 12R,A02,514035,Herbst; Matthew,0,0,16,16
1715604039043,MMW 13R,A01,514037,Staff,0,5,16,16
1715604039043,MMW 13R,A02,514039,Staff,0,5,16,16
1715604039043,MMW 13R,A03,628519,Staff,0,4,16,16
1715604041094,SIO 295LS,A00,523233,Staff,10,0,30,20
1715604042122,SIO 295S,A00,523232,Staff,10,0,30,20
1715604043154,SIOC 290S,A01,637330,Merrifield; Mark A,23,0,30,7
1715604044181,SIOC 291S,A01,637333,Gabriel; Corey John,23,0,30,7
1715604045208,SOCI 117,A01,494376,Staff,0,5,5,5
1715604046235,WES 237B,A00,494380,Staff,10,0,20,10
1715604048338,AESE 279B,A00,494370,Wade; Jon P,0,0,33,33
1715604049368,AIP 97,001,660915,Van Den Einde; Yael Dahlia,9999,0,9999,0
1715604050397,AIP 197,001,627712,Vespa; Emanuel Ignacio,9995,0,9999,4
1715604050397,AIP 197,002,650778,Amir; On,9998,0,9999,1
1715604050397,AIP 197,003,650933,Avenancio-Leon; Carlos,9998,0,9999,1
1715604050397,AIP 197,004,658530,Heyman; Gail D.,9998,0,9999,1
1715604050397,AIP 197,005,658631,Neal; Sonya E,9998,0,9999,1
1715604050397,AIP 197,006,658671,Du; Songzi,9998,0,9999,1
1715604051428,ANAR 135S,A00,494369,Braswell; Geoffrey E.,0,0,0,0
1715604052454,BENG 196,001,628496,Engler; Adam J.,9998,0,9999,1
1715604052454,BENG 196,002,660916,Watson; John Thomas,9999,0,9999,0
1715604053481,BISP 197,001,650773,Wilhelm; James E.,9994,0,9999,5
1715604053481,BISP 197,002,658904,Coleman; Aaron B.,9998,0,9999,1
1715604054507,CAT 124RS,A01,519847,Geibel; William,0,0,20,20
1715604055532,CAT 125RS,A01,515971,Geibel; William,0,0,20,20
1715604056561,CLRE 250,A00,511389,Morris; Sheldon,9992,0,9999,7
1715604057588,CLRE 251,A00,507176,Mehta; Ravindra L.,9992,0,9999,7
1715604057588,CLRE 251,B00,511410,Mehta; Ravindra L.,9998,0,9999,1
1715604058615,CLRE 252,A00,507189,Cuomo; Raphael Eduardo,9994,0,9999,5
1715604059646,CLRE 253,A00,507199,Vaida; Florin,9994,0,9999,5
1715604059646,CLRE 253,B00,507202,Vaida; Florin,9999,0,9999,0
1715604060672,CLRE 259,A00,507211,Patel; Hemal,9996,0,9999,3
1715604061706,CLRE 260,A00,507221,Cuomo; Raphael Eduardo,9999,0,9999,0
1715604062733,CLRE 297,001,507242,Cuomo; Raphael Eduardo,9999,0,9999,0
1715604063760,COGS 197,001,638244,Voytek; Bradley Thomas,9997,0,9999,2
1715604064786,CSE 191,A00,516875,Minnes Kemp; Mor Mia,9991,0,9999,8
1715604065812,CSE 197,001,637388,Minnes Kemp; Mor Mia,9992,0,9999,7
1715604066848,CSS 201S,A01,494383,Mignozzetti; Umberto,35,0,35,0
1715604067879,CSS 202S,A01,494387,Mignozzetti; Umberto,35,0,35,0
1715604068904,DSC 197,001,628532,Eldridge; Justin Matthew,9995,0,9999,4
1715604069930,EAP 100,A00,516065,Staff,9799,0,9999,200
1715604070957,ECE 45,A01,507414,Staff,31,0,60,29
1715604073013,ECE 111,A01,507420,Staff,11,0,50,39
1715604074039,ECE 197,001,548057,Sievenpiper; Daniel F.,9991,0,9999,8
1715604075070,EDS 115,A00,507243,Choi; Bailey Miyeon,7,0,28,21
1715604076096,EDS 117,A01,494379,Staff,0,6,34,34
1715604077127,EDS 125,A00,507246,Hopkins; Megan Beth,8,0,30,22
1715604078154,EDS 128A,A01,507264,Fargason; Sharon Gayle,6,0,26,20
1715604079184,EDS 128B,A01,507293,Pappas; Elizabeth,10,0,30,20
1715604080209,EDS 139,A00,507294,Fargason; Sharon Gayle,10,0,30,20
1715604080209,EDS 139,B00,507313,Pappas; Elizabeth,11,0,30,19
1715604081234,EDS 201,A00,507315,Staff,10,0,30,20
1715604082265,EDS 203,A01,507317,Halter; Christopher P.,10,0,30,20
1715604083296,EDS 204R,A01,507319,Halter; Christopher P.,0,3,30,30
1715604083296,EDS 204R,B01,507331,Heinzman; Erica M.,14,0,30,16
1715604084326,EDS 206R,A00,507332,Staff,0,4,30,30
1715604084326,EDS 206R,B00,507343,Staff,15,0,30,15
1715604085353,EDS 250,A00,507344,Hemans; Patricia Ann Benitez,20,0,40,20
1715604086381,EDS 281,A00,507345,Daly; Alan J.,18,0,18,0
1715604087409,EDS 284,A00,507350,Daly; Alan J.,16,0,16,0
1715604088441,EDS 286,A00,507359,Fine; Sarah,18,0,18,0
1715604089470,EDS 289C,A01,507361,Daly; Alan J.,18,0,18,0
1715604090501,EDS 290,A00,507366,Hofstetter; Carolyn,15,0,15,0
1715604091527,LIGM 5A,A00,507421,Fischer-Grunski; Eva K,17,0,20,3
1715604092557,LIGM 5B,A00,507423,Fischer-Grunski; Eva K,19,0,20,1
1715604093586,LIGM 5C,A00,507425,Fischer-Grunski; Eva K,19,0,20,1
1715604094616,LIIT 5AS,A00,507427,Carnelos; Chiara,20,0,20,0
1715604095643,LIIT 5BS,A00,507430,Carnelos; Chiara,20,0,20,0
1715604096674,LIIT 5CS,A00,507432,Carnelos; Chiara,20,0,20,0
1715604097705,LISP 5A,A00,507541,Munoz Sanchez; Alicia,11,0,20,9
1715604098732,LISP 5B,A00,507671,Munoz Sanchez; Alicia,9,0,20,11
1715604099762,LISP 5C,A00,507696,Munoz Sanchez; Alicia,9,0,20,11
1715604100791,MAE 197,001,528363,Boechler; Nicholas Sebastia,9998,0,9999,1
1715604101826,MATH 197,001,523477,Kedlaya; Kiran S.,9994,0,9999,5
1715604101826,MATH 197,002,563811,Zhang; Danna,9994,0,9999,5
1715604101826,MATH 197,003,628552,Dumitriu; Ioana,9998,0,9999,1
1715604101826,MATH 197,004,660885,Floyd; Eric,9999,0,9999,0
1715604102852,MCWP 40R,A00,518780,Staff,2,0,20,18
1715604102852,MCWP 40R,B00,518781,Staff,11,0,20,9
1715604102852,MCWP 40R,C00,518783,Staff,5,0,20,15
1715604103880,MCWP 50R,A00,518791,Staff,0,1,20,20
1715604103880,MCWP 50R,B00,518792,Staff,0,2,20,20
1715604103880,MCWP 50R,C00,518793,Staff,0,4,20,20
1715604103880,MCWP 50R,D00,518794,Staff,0,1,20,20
1715604103880,MCWP 50R,E00,518795,Staff,0,2,20,20
1715604103880,MCWP 50R,F00,518796,Staff,0,1,20,20
1715604103880,MCWP 50R,G00,518797,Staff,0,1,20,20
1715604104906,MMW 12R,A01,514034,Herbst; Matthew,0,2,16,16
1715604104906,MMW 12R,A02,514035,Herbst; Matthew,0,0,16,16
1715604105931,MMW 13R,A01,514037,Staff,0,5,16,16
1715604105931,MMW 13R,A02,514039,Staff,0,5,16,16
1715604105931,MMW 13R,A03,628519,Staff,0,4,16,16
1715604107985,SIO 295LS,A00,523233,Staff,10,0,30,20
1715604109015,SIO 295S,A00,523232,Staff,10,0,30,20
1715604110046,SIOC 290S,A01,637330,Merrifield; Mark A,23,0,30,7
1715604111074,SIOC 291S,A01,637333,Gabriel; Corey John,23,0,30,7
1715604112099,SOCI 117,A01,494376,Staff,0,5,5,5
1715604113124,WES 237B,A00,494380,Staff,10,0,20,10
1715604115213,AESE 279B,A00,494370,Wade; Jon P,0,0,33,33
1715604116239,AIP 97,001,660915,Van Den Einde; Yael Dahlia,9999,0,9999,0
1715604117269,AIP 197,001,627712,Vespa; Emanuel Ignacio,9995,0,9999,4
1715604117269,AIP 197,002,650778,Amir; On,9998,0,9999,1
1715604117269,AIP 197,003,650933,Avenancio-Leon; Carlos,9998,0,9999,1
1715604117269,AIP 197,004,658530,Heyman; Gail D.,9998,0,9999,1
1715604117269,AIP 197,005,658631,Neal; Sonya E,9998,0,9999,1
1715604117269,AIP 197,006,658671,Du; Songzi,9998,0,9999,1
1715604118297,ANAR 135S,A00,494369,Braswell; Geoffrey E.,0,0,0,0
1715604119331,BENG 196,001,628496,Engler; Adam J.,9998,0,9999,1
1715604119331,BENG 196,002,660916,Watson; John Thomas,9999,0,9999,0
1715604120358,BISP 197,001,650773,Wilhelm; James E.,9994,0,9999,5
1715604120358,BISP 197,002,658904,Coleman; Aaron B.,9998,0,9999,1
1715604121384,CAT 124RS,A01,519847,Geibel; William,0,0,20,20
1715604122414,CAT 125RS,A01,515971,Geibel; William,0,0,20,20
1715604123446,CLRE 250,A00,511389,Morris; Sheldon,9992,0,9999,7
1715604124481,CLRE 251,A00,507176,Mehta; Ravindra L.,9992,0,9999,7
1715604124481,CLRE 251,B00,511410,Mehta; Ravindra L.,9998,0,9999,1
1715604125512,CLRE 252,A00,507189,Cuomo; Raphael Eduardo,9994,0,9999,5
1715604126540,CLRE 253,A00,507199,Vaida; Florin,9994,0,9999,5
1715604126540,CLRE 253,B00,507202,Vaida; Florin,9999,0,9999,0
1715604127571,CLRE 259,A00,507211,Patel; Hemal,9996,0,9999,3
1715604128600,CLRE 260,A00,507221,Cuomo; Raphael Eduardo,9999,0,9999,0
1715604129627,CLRE 297,001,507242,Cuomo; Raphael Eduardo,9999,0,9999,0
1715604130653,COGS 197,001,638244,Voytek; Bradley Thomas,9997,0,9999,2
1715604131679,CSE 191,A00,516875,Minnes Kemp; Mor Mia,9991,0,9999,8
1715604132704,CSE 197,001,637388,Minnes Kemp; Mor Mia,9992,0,9999,7
1715604133732,CSS 201S,A01,494383,Mignozzetti; Umberto,35,0,35,0
1715604134762,CSS 202S,A01,494387,Mignozzetti; Umberto,35,0,35,0
1715604135792,DSC 197,001,628532,Eldridge; Justin Matthew,9995,0,9999,4
1715604136818,EAP 100,A00,516065,Staff,9799,0,9999,200
1715604137851,ECE 45,A01,507414,Staff,31,0,60,29
1715604139900,ECE 111,A01,507420,Staff,11,0,50,39
1715604140933,ECE 197,001,548057,Sievenpiper; Daniel F.,9991,0,9999,8
1715604141959,EDS 115,A00,507243,Choi; Bailey Miyeon,7,0,28,21
1715604142986,EDS 117,A01,494379,Staff,0,6,34,34
1715604144011,EDS 125,A00,507246,Hopkins; Megan Beth,8,0,30,22
1715604145038,EDS 128A,A01,507264,Fargason; Sharon Gayle,6,0,26,20
1715604146068,EDS 128B,A01,507293,Pappas; Elizabeth,10,0,30,20
1715604147096,EDS 139,A00,507294,Fargason; Sharon Gayle,10,0,30,20
1715604147096,EDS 139,B00,507313,Pappas; Elizabeth,11,0,30,19
1715604148123,EDS 201,A00,507315,Staff,10,0,30,20
1715604149153,EDS 203,A01,507317,Halter; Christopher P.,10,0,30,20
1715604150179,EDS 204R,A01,507319,Halter; Christopher P.,0,3,30,30
1715604150179,EDS 204R,B01,507331,Heinzman; Erica M.,14,0,30,16
1715604151206,EDS 206R,A00,507332,Staff,0,4,30,30
1715604151206,EDS 206R,B00,507343,Staff,15,0,30,15
1715604152236,EDS 250,A00,507344,Hemans; Patricia Ann Benitez,20,0,40,20
1715604153266,EDS 281,A00,507345,Daly; Alan J.,18,0,18,0
1715604154292,EDS 284,A00,507350,Daly; Alan J.,16,0,16,0
1715604155319,EDS 286,A00,507359,Fine; Sarah,18,0,18,0
1715604156348,EDS 289C,A01,507361,Daly; Alan J.,18,0,18,0
1715604157373,EDS 290,A00,507366,Hofstetter; Carolyn,15,0,15,0
1715604158401,LIGM 5A,A00,507421,Fischer-Grunski; Eva K,17,0,20,3
1715604159427,LIGM 5B,A00,507423,Fischer-Grunski; Eva K,19,0,20,1
1715604160454,LIGM 5C,A00,507425,Fischer-Grunski; Eva K,19,0,20,1
1715604161479,LIIT 5AS,A00,507427,Carnelos; Chiara,20,0,20,0
1715604162506,LIIT 5BS,A00,507430,Carnelos; Chiara,20,0,20,0
1715604163533,LIIT 5CS,A00,507432,Carnelos; Chiara,20,0,20,0
1715604164559,LISP 5A,A00,507541,Munoz Sanchez; Alicia,11,0,20,9
1715604165589,LISP 5B,A00,507671,Munoz Sanchez; Alicia,9,0,20,11
1715604166616,LISP 5C,A00,507696,Munoz Sanchez; Alicia,9,0,20,11
1715604167641,MAE 197,001,528363,Boechler; Nicholas Sebastia,9998,0,9999,1
1715604168669,MATH 197,001,523477,Kedlaya; Kiran S.,9994,0,9999,5
1715604168669,MATH 197,002,563811,Zhang; Danna,9994,0,9999,5
1715604168669,MATH 197,003,628552,Dumitriu; Ioana,9998,0,9999,1
1715604168669,MATH 197,004,660885,Floyd; Eric,9999,0,9999,0
1715604169698,MCWP 40R,A00,518780,Staff,2,0,20,18
1715604169698,MCWP 40R,B00,518781,Staff,11,0,20,9
1715604169698,MCWP 40R,C00,518783,Staff,5,0,20,15
1715604170724,MCWP 50R,A00,518791,Staff,0,1,20,20
1715604170724,MCWP 50R,B00,518792,Staff,0,2,20,20
1715604170724,MCWP 50R,C00,518793,Staff,0,4,20,20
1715604170724,MCWP 50R,D00,518794,Staff,0,1,20,20
1715604170724,MCWP 50R,E00,518795,Staff,0,2,20,20
1715604170724,MCWP 50R,F00,518796,Staff,0,1,20,20
1715604170724,MCWP 50R,G00,518797,Staff,0,1,20,20
1715604171755,MMW 12R,A01,514034,Herbst; Matthew,0,2,16,16
1715604171755,MMW 12R,A02,514035,Herbst; Matthew,0,0,16,16
1715604172781,MMW 13R,A01,514037,Staff,0,5,16,16
1715604172781,MMW 13R,A02,514039,Staff,0,5,16,16
1715604172781,MMW 13R,A03,628519,Staff,0,4,16,16
1715604174837,SIO 295LS,A00,523233,Staff,10,0,30,20
1715604175870,SIO 295S,A00,523232,Staff,10,0,30,20
1715604176898,SIOC 290S,A01,637330,Merrifield; Mark A,23,0,30,7
1715604177930,SIOC 291S,A01,637333,Gabriel; Corey John,23,0,30,7
1715604178955,SOCI 117,A01,494376,Staff,0,5,5,5
1715604179983,WES 237B,A00,494380,Staff,10,0,20,10
1715604182066,AESE 279B,A00,494370,Wade; Jon P,0,0,33,33
1715604183095,AIP 97,001,660915,Van Den Einde; Yael Dahlia,9999,0,9999,0
1715604184132,AIP 197,001,627712,Vespa; Emanuel Ignacio,9995,0,9999,4
1715604184132,AIP 197,002,650778,Amir; On,9998,0,9999,1
1715604184132,AIP 197,003,650933,Avenancio-Leon; Carlos,9998,0,9999,1
1715604184132,AIP 197,004,658530,Heyman; Gail D.,9998,0,9999,1
1715604184132,AIP 197,005,658631,Neal; Sonya E,9998,0,9999,1
1715604184132,AIP 197,006,658671,Du; Songzi,9998,0,9999,1
1715604185158,ANAR 135S,A00,494369,Braswell; Geoffrey E.,0,0,0,0
1715604186191,BENG 196,001,628496,Engler; Adam J.,9998,0,9999,1
1715604186191,BENG 196,002,660916,Watson; John Thomas,9999,0,9999,0
1715604187218,BISP 197,001,650773,Wilhelm; James E.,9994,0,9999,5
1715604187218,BISP 197,002,658904,Coleman; Aaron B.,9998,0,9999,1
1715604188246,CAT 124RS,A01,519847,Geibel; William,0,0,20,20
1715604189273,CAT 125RS,A01,515971,Geibel; William,0,0,20,20
1715604190300,CLRE 250,A00,511389,Morris; Sheldon,9992,0,9999,7
1715604191331,CLRE 251,A00,507176,Mehta; Ravindra L.,9992,0,9999,7
1715604191331,CLRE 251,B00,511410,Mehta; Ravindra L.,9998,0,9999,1
1715604192361,CLRE 252,A00,507189,Cuomo; Raphael Eduardo,9994,0,9999,5
1715604193391,CLRE 253,A00,507199,Vaida; Florin,9994,0,9999,5
1715604193391,CLRE 253,B00,507202,Vaida; Florin,9999,0,9999,0
1715604194418,CLRE 259,A00,507211,Patel; Hemal,9996,0,9999,3
1715604195445,CLRE 260,A00,507221,Cuomo; Raphael Eduardo,9999,0,9999,0
1715604196471,CLRE 297,001,507242,Cuomo; Raphael Eduardo,9999,0,9999,0
1715604197498,COGS 197,001,638244,Voytek; Bradley Thomas,9997,0,9999,2
1715604198525,CSE 191,A00,516875,Minnes Kemp; Mor Mia,9991,0,9999,8
1715604199551,CSE 197,001,637388,Minnes Kemp; Mor Mia,9992,0,9999,7
1715604200583,CSS 201S,A01,494383,Mignozzetti; Umberto,35,0,35,0
1715604201614,CSS 202S,A01,494387,Mignozzetti; Umberto,35,0,35,0
1715604202640,DSC 197,001,628532,Eldridge; Justin Matthew,9995,0,9999,4
1715604203665,EAP 100,A00,516065,Staff,9799,0,9999,200
1715604204697,ECE 45,A01,507414,Staff,31,0,60,29
1715604206749,ECE 111,A01,507420,Staff,11,0,50,39
1715604207779,ECE 197,001,548057,Sievenpiper; Daniel F.,9991,0,9999,8
1715604208810,EDS 115,A00,507243,Choi; Bailey Miyeon,7,0,28,21
1715604209843,EDS 117,A01,494379,Staff,0,6,34,34
1715604210873,EDS 125,A00,507246,Hopkins; Megan Beth,8,0,30,22
1715604211901,EDS 128A,A01,507264,Fargason; Sharon Gayle,6,0,26,20
1715604212929,EDS 128B,A01,507293,Pappas; Elizabeth,10,0,30,20
1715604213955,EDS 139,A00,507294,Fargason; Sharon Gayle,10,0,30,20
1715604213955,EDS 139,B00,507313,Pappas; Elizabeth,11,0,30,19
1715604214980,EDS 201,A00,507315,Staff,10,0,30,20
1715604216012,EDS 203,A01,507317,Halter; Christopher P.,10,0,30,20
1715604217039,EDS 204R,A01,507319,Halter; Christopher P.,0,3,30,30
1715604217039,EDS 204R,B01,507331,Heinzman; Erica M.,14,0,30,16
1715604218067,EDS 206R,A00,507332,Staff,0,4,30,30
1715604218067,EDS 206R,B00,507343,Staff,15,0,30,15
1715604219093,EDS 250,A00,507344,Hemans; Patricia Ann Benitez,20,0,40,20
1715604220121,EDS 281,A00,507345,Daly; Alan J.,18,0,18,0
1715604221150,EDS 284,A00,507350,Daly; Alan J.,16,0,16,0
1715604222176,EDS 286,A00,507359,Fine; Sarah,18,0,18,0
1715604223201,EDS 289C,A01,507361,Daly; Alan J.,18,0,18,0
1715604224227,EDS 290,A00,507366,Hofstetter; Carolyn,15,0,15,0
1715604225258,LIGM 5A,A00,507421,Fischer-Grunski; Eva K,17,0,20,3
1715604226288,LIGM 5B,A00,507423,Fischer-Grunski; Eva K,19,0,20,1
1715604227317,LIGM 5C,A00,507425,Fischer-Grunski; Eva K,19,0,20,1
1715604228346,LIIT 5AS,A00,507427,Carnelos; Chiara,20,0,20,0
1715604229371,LIIT 5BS,A00,507430,Carnelos; Chiara,20,0,20,0
1715604230406,LIIT 5CS,A00,507432,Carnelos; Chiara,20,0,20,0
1715604231437,LISP 5A,A00,507541,Munoz Sanchez; Alicia,11,0,20,9
1715604232466,LISP 5B,A00,507671,Munoz Sanchez; Alicia,9,0,20,11
1715604233492,LISP 5C,A00,507696,Munoz Sanchez; Alicia,9,0,20,11
1715604234518,MAE 197,001,528363,Boechler; Nicholas Sebastia,9998,0,9999,1
1715604235554,MATH 197,001,523477,Kedlaya; Kiran S.,9994,0,9999,5
1715604235554,MATH 197,002,563811,Zhang; Danna,9994,0,9999,5
1715604235554,MATH 197,003,628552,Dumitriu; Ioana,9998,0,9999,1
1715604235554,MATH 197,004,660885,Floyd; Eric,9999,0,9999,0
1715604236588,MCWP 40R,A00,518780,Staff,2,0,20,18
1715604236588,MCWP 40R,B00,518781,Staff,11,0,20,9
1715604236588,MCWP 40R,C00,518783,Staff,5,0,20,15
1715604237614,MCWP 50R,A00,518791,Staff,0,1,20,20
1715604237614,MCWP 50R,B00,518792,Staff,0,2,20,20
1715604237614,MCWP 50R,C00,518793,Staff,0,4,20,20
1715604237614,MCWP 50R,D00,518794,Staff,0,1,20,20
1715604237614,MCWP 50R,E00,518795,Staff,0,2,20,20
1715604237614,MCWP 50R,F00,518796,Staff,0,1,20,20
1715604237614,MCWP 50R,G00,518797,Staff,0,1,20,20
1715604238645,MMW 12R,A01,514034,Herbst; Matthew,0,2,16,16
1715604238645,MMW 12R,A02,514035,Herbst; Matthew,0,0,16,16
1715604239675,MMW 13R,A01,514037,Staff,0,5,16,16
1715604239675,MMW 13R,A02,514039,Staff,0,5,16,16
1715604239675,MMW 13R,A03,628519,Staff,0,4,16,16
1715604241727,SIO 295LS,A00,523233,Staff,10,0,30,20
1715604242754,SIO 295S,A00,523232,Staff,10,0,30,20
1715604243782,SIOC 290S,A01,637330,Merrifield; Mark A,23,0,30,7
1715604244808,SIOC 291S,A01,637333,Gabriel; Corey John,23,0,30,7
1715604245837,SOCI 117,A01,494376,Staff,0,5,5,5
1715604246863,WES 237B,A00,494380,Staff,10,0,20,10
1715604248934,AESE 279B,A00,494370,Wade; Jon P,0,0,33,33
1715604249960,AIP 97,001,660915,Van Den Einde; Yael Dahlia,9999,0,9999,0
1715604250989,AIP 197,001,627712,Vespa; Emanuel Ignacio,9995,0,9999,4
1715604250989,AIP 197,002,650778,Amir; On,9998,0,9999,1
1715604250989,AIP 197,003,650933,Avenancio-Leon; Carlos,9998,0,9999,1
1715604250989,AIP 197,004,658530,Heyman; Gail D.,9998,0,9999,1
1715604250989,AIP 197,005,658631,Neal; Sonya E,9998,0,9999,1
1715604250989,AIP 197,006,658671,Du; Songzi,9998,0,9999,1
1715604252018,ANAR 135S,A00,494369,Braswell; Geoffrey E.,0,0,0,0
1715604253046,BENG 196,001,628496,Engler; Adam J.,9998,0,9999,1
1715604253046,BENG 196,002,660916,Watson; John Thomas,9999,0,9999,0
1715604254076,BISP 197,001,650773,Wilhelm; James E.,9994,0,9999,5
1715604254076,BISP 197,002,658904,Coleman; Aaron B.,9998,0,9999,1
1715604255104,CAT 124RS,A01,519847,Geibel; William,0,0,20,20
1715604256132,CAT 125RS,A01,515971,Geibel; William,0,0,20,20
1715604257160,CLRE 250,A00,511389,Morris; Sheldon,9992,0,9999,7
1715604258193,CLRE 251,A00,507176,Mehta; Ravindra L.,9992,0,9999,7
1715604258193,CLRE 251,B00,511410,Mehta; Ravindra L.,9998,0,9999,1
1715604259219,CLRE 252,A00,507189,Cuomo; Raphael Eduardo,9994,0,9999,5
1715604260246,CLRE 253,A00,507199,Vaida; Florin,9994,0,9999,5
1715604260246,CLRE 253,B00,507202,Vaida; Florin,9999,0,9999,0
1715604261271,CLRE 259,A00,507211,Patel; Hemal,9996,0,9999,3
1715604262297,CLRE 260,A00,507221,Cuomo; Raphael Eduardo,9999,0,9999,0
1715604263322,CLRE 297,001,507242,Cuomo; Raphael Eduardo,9999,0,9999,0
1715604264349,COGS 197,001,638244,Voytek; Bradley Thomas,9997,0,9999,2
1715604265375,CSE 191,A00,516875,Minnes Kemp; Mor Mia,9991,0,9999,8
1715604266401,CSE 197,001,637388,Minnes Kemp; Mor Mia,9992,0,9999,7
1715604267430,CSS 201S,A01,494383,Mignozzetti; Umberto,35,0,35,0
1715604268460,CSS 202S,A01,494387,Mignozzetti; Umberto,35,0,35,0
1715604269485,DSC 197,001,628532,Eldridge; Justin Matthew,9995,0,9999,4
1715604270511,EAP 100,A00,516065,Staff,9799,0,9999,200
1715604271539,ECE 45,A01,507414,Staff,31,0,60,29
1715604273597,ECE 111,A01,507420,Staff,11,0,50,39
1715604274627,ECE 197,001,548057,Sievenpiper; Daniel F.,9991,0,9999,8
1715604275653,EDS 115,A00,507243,Choi; Bailey Miyeon,7,0,28,21
1715604276681,EDS 117,A01,494379,Staff,0,6,34,34
1715604277712,EDS 125,A00,507246,Hopkins; Megan Beth,8,0,30,22
1715604278741,EDS 128A,A01,507264,Fargason; Sharon Gayle,6,0,26,20
1715604279772,EDS 128B,A01,507293,Pappas; Elizabeth,10,0,30,20
1715604280802,EDS 139,A00,507294,Fargason; Sharon Gayle,10,0,30,20
1715604280802,EDS 139,B00,507313,Pappas; Elizabeth,11,0,30,19
1715604281828,EDS 201,A00,507315,Staff,10,0,30,20
1715604282854,EDS 203,A01,507317,Halter; Christopher P.,10,0,30,20
1715604283882,EDS 204R,A01,507319,Halter; Christopher P.,0,3,30,30
1715604283882,EDS 204R,B01,507331,Heinzman; Erica M.,14,0,30,16
1715604284910,EDS 206R,A00,507332,Staff,0,4,30,30
1715604284910,EDS 206R,B00,507343,Staff,15,0,30,15
1715604285941,EDS 250,A00,507344,Hemans; Patricia Ann Benitez,20,0,40,20
1715604286969,EDS 281,A00,507345,Daly; Alan J.,18,0,18,0
1715604287998,EDS 284,A00,507350,Daly; Alan J.,16,0,16,0
1715604289025,EDS 286,A00,507359,Fine; Sarah,18,0,18,0
1715604290050,EDS 289C,A01,507361,Daly; Alan J.,18,0,18,0
1715604291077,EDS 290,A00,507366,Hofstetter; Carolyn,15,0,15,0
1715604292110,LIGM 5A,A00,507421,Fischer-Grunski; Eva K,17,0,20,3
1715604293136,LIGM 5B,A00,507423,Fischer-Grunski; Eva K,19,0,20,1
1715604294163,LIGM 5C,A00,507425,Fischer-Grunski; Eva K,19,0,20,1
1715604295189,LIIT 5AS,A00,507427,Carnelos; Chiara,20,0,20,0
1715604296215,LIIT 5BS,A00,507430,Carnelos; Chiara,20,0,20,0
1715604297242,LIIT 5CS,A00,507432,Carnelos; Chiara,20,0,20,0
1715604298273,LISP 5A,A00,507541,Munoz Sanchez; Alicia,11,0,20,9
1715604299302,LISP 5B,A00,507671,Munoz Sanchez; Alicia,9,0,20,11
1715604300333,LISP 5C,A00,507696,Munoz Sanchez; Alicia,9,0,20,11
1715604301359,MAE 197,001,528363,Boechler; Nicholas Sebastia,9998,0,9999,1
1715604302395,MATH 197,001,523477,Kedlaya; Kiran S.,9994,0,9999,5
1715604302395,MATH 197,002,563811,Zhang; Danna,9994,0,9999,5
1715604302395,MATH 197,003,628552,Dumitriu; Ioana,9998,0,9999,1
1715604302395,MATH 197,004,660885,Floyd; Eric,9999,0,9999,0
1715604303422,MCWP 40R,A00,518780,Staff,2,0,20,18
1715604303422,MCWP 40R,B00,518781,Staff,11,0,20,9
1715604303422,MCWP 40R,C00,518783,Staff,5,0,20,15
1715604304448,MCWP 50R,A00,518791,Staff,0,1,20,20
1715604304448,MCWP 50R,B00,518792,Staff,0,2,20,20
1715604304448,MCWP 50R,C00,518793,Staff,0,4,20,20
1715604304448,MCWP 50R,D00,518794,Staff,0,1,20,20
1715604304448,MCWP 50R,E00,518795,Staff,0,2,20,20
1715604304448,MCWP 50R,F00,518796,Staff,0,1,20,20
1715604304448,MCWP 50R,G00,518797,Staff,0,1,20,20
1715604305475,MMW 12R,A01,514034,Herbst; Matthew,0,2,16,16
1715604305475,MMW 12R,A02,514035,Herbst; Matthew,0,0,16,16
1715604306503,MMW 13R,A01,514037,Staff,0,5,16,16
1715604306503,MMW 13R,A02,514039,Staff,0,5,16,16
1715604306503,MMW 13R,A03,628519,Staff,0,4,16,16
1715604308559,SIO 295LS,A00,523233,Staff,10,0,30,20
1715604309584,SIO 295S,A00,523232,Staff,10,0,30,20
1715604310612,SIOC 290S,A01,637330,Merrifield; Mark A,23,0,30,7
1715604311648,SIOC 291S,A01,637333,Gabriel; Corey John,23,0,30,7
1715604312674,SOCI 117,A01,494376,Staff,0,5,5,5
1715604313701,WES 237B,A00,494380,Staff,10,0,20,10
1715604315787,AESE 279B,A00,494370,Wade; Jon P,0,0,33,33
1715604316813,AIP 97,001,660915,Van Den Einde; Yael Dahlia,9999,0,9999,0
1715604317841,AIP 197,001,627712,Vespa; Emanuel Ignacio,9995,0,9999,4
1715604317841,AIP 197,002,650778,Amir; On,9998,0,9999,1
1715604317841,AIP 197,003,650933,Avenancio-Leon; Carlos,9998,0,9999,1
1715604317841,AIP 197,004,658530,Heyman; Gail D.,9998,0,9999,1
1715604317841,AIP 197,005,658631,Neal; Sonya E,9998,0,9999,1
1715604317841,AIP 197,006,658671,Du; Songzi,9998,0,9999,1
1715604318867,ANAR 135S,A00,494369,Braswell; Geoffrey E.,0,0,0,0
1715604319895,BENG 196,001,628496,Engler; Adam J.,9998,0,9999,1
1715604319895,BENG 196,002,660916,Watson; John Thomas,9999,0,9999,0
1715604320921,BISP 197,001,650773,Wilhelm; James E.,9994,0,9999,5
1715604320921,BISP 197,002,658904,Coleman; Aaron B.,9998,0,9999,1
1715604321949,CAT 124RS,A01,519847,Geibel; William,0,0,20,20
1715604322977,CAT 125RS,A01,515971,Geibel; William,0,0,20,20
1715604324009,CLRE 250,A00,511389,Morris; Sheldon,9992,0,9999,7
1715604325035,CLRE 251,A00,507176,Mehta; Ravindra L.,9992,0,9999,7
1715604325035,CLRE 251,B00,511410,Mehta; Ravindra L.,9998,0,9999,1
1715604326069,CLRE 252,A00,507189,Cuomo; Raphael Eduardo,9994,0,9999,5
1715604327095,CLRE 253,A00,507199,Vaida; Florin,9994,0,9999,5
1715604327095,CLRE 253,B00,507202,Vaida; Florin,9999,0,9999,0
1715604328123,CLRE 259,A00,507211,Patel; Hemal,9996,0,9999,3
1715604329150,CLRE 260,A00,507221,Cuomo; Raphael Eduardo,9999,0,9999,0
1715604330174,CLRE 297,001,507242,Cuomo; Raphael Eduardo,9999,0,9999,0
1715604331203,COGS 197,001,638244,Voytek; Bradley Thomas,9997,0,9999,2
1715604332232,CSE 191,A00,516875,Minnes Kemp; Mor Mia,9991,0,9999,8
1715604333258,CSE 197,001,637388,Minnes Kemp; Mor Mia,9992,0,9999,7
1715604334291,CSS 201S,A01,494383,Mignozzetti; Umberto,35,0,35,0
1715604335319,CSS 202S,A01,494387,Mignozzetti; Umberto,35,0,35,0
1715604336344,DSC 197,001,628532,Eldridge; Justin Matthew,9995,0,9999,4
1715604337371,EAP 100,A00,516065,Staff,9799,0,9999,200
1715604338398,ECE 45,A01,507414,Staff,31,0,60,29
1715604340454,ECE 111,A01,507420,Staff,11,0,50,39
1715604341482,ECE 197,001,548057,Sievenpiper; Daniel F.,9991,0,9999,8
1715604342509,EDS 115,A00,507243,Choi; Bailey Miyeon,7,0,28,21
1715604343536,EDS 117,A01,494379,Staff,0,6,34,34
1715604344562,EDS 125,A00,507246,Hopkins; Megan Beth,8,0,30,22
1715604345596,EDS 128A,A01,507264,Fargason; Sharon Gayle,6,0,26,20
1715604346626,EDS 128B,A01,507293,Pappas; Elizabeth,10,0,30,20
1715604347650,EDS 139,A00,507294,Fargason; Sharon Gayle,10,0,30,20
1715604347650,EDS 139,B00,507313,Pappas; Elizabeth,11,0,30,19
1715604348675,EDS 201,A00,507315,Staff,10,0,30,20
1715604349703,EDS 203,A01,507317,Halter; Christopher P.,10,0,30,20
1715604350730,EDS 204R,A01,507319,Halter; Christopher P.,0,3,30,30
1715604350730,EDS 204R,B01,507331,Heinzman; Erica M.,14,0,30,16
1715604351761,EDS 206R,A00,507332,Staff,0,4,30,30
1715604351761,EDS 206R,B00,507343,Staff,15,0,30,15
1715604352791,EDS 250,A00,507344,Hemans; Patricia Ann Benitez,20,0,40,20
1715604353815,EDS 281,A00,507345,Daly; Alan J.,18,0,18,0
1715604354840,EDS 284,A00,507350,Daly; Alan J.,16,0,16,0
1715604355886,EDS 286,A00,507359,Fine; Sarah,18,0,18,0
1715604356914,EDS 289C,A01,507361,Daly; Alan J.,18,0,18,0
1715604357944,EDS 290,A00,507366,Hofstetter; Carolyn,15,0,15,0
1715604358976,LIGM 5A,A00,507421,Fischer-Grunski; Eva K,17,0,20,3
1715604360234,LIGM 5B,A00,507423,Fischer-Grunski; Eva K,19,0,20,1
1715604361260,LIGM 5C,A00,507425,Fischer-Grunski; Eva K,19,0,20,1
1715604362288,LIIT 5AS,A00,507427,Carnelos; Chiara,20,0,20,0
1715604363315,LIIT 5BS,A00,507430,Carnelos; Chiara,20,0,20,0
1715604364342,LIIT 5CS,A00,507432,Carnelos; Chiara,20,0,20,0
1715604365369,LISP 5A,A00,507541,Munoz Sanchez; Alicia,11,0,20,9
1715604366399,LISP 5B,A00,507671,Munoz Sanchez; Alicia,9,0,20,11
1715604367429,LISP 5C,A00,507696,Munoz Sanchez; Alicia,9,0,20,11
1715604368462,MAE 197,001,528363,Boechler; Nicholas Sebastia,9998,0,9999,1
1715604369488,MATH 197,001,523477,Kedlaya; Kiran S.,9994,0,9999,5
1715604369488,MATH 197,002,563811,Zhang; Danna,9994,0,9999,5
1715604369488,MATH 197,003,628552,Dumitriu; Ioana,9998,0,9999,1
1715604369488,MATH 197,004,660885,Floyd; Eric,9999,0,9999,0
1715604370520,MCWP 40R,A00,518780,Staff,2,0,20,18
1715604370520,MCWP 40R,B00,518781,Staff,11,0,20,9
1715604370520,MCWP 40R,C00,518783,Staff,5,0,20,15
1715604371551,MCWP 50R,A00,518791,Staff,0,1,20,20
1715604371551,MCWP 50R,B00,518792,Staff,0,2,20,20
1715604371551,MCWP 50R,C00,518793,Staff,0,4,20,20
1715604371551,MCWP 50R,D00,518794,Staff,0,1,20,20
1715604371551,MCWP 50R,E00,518795,Staff,0,2,20,20
1715604371551,MCWP 50R,F00,518796,Staff,0,1,20,20
1715604371551,MCWP 50R,G00,518797,Staff,0,1,20,20
1715604372580,MMW 12R,A01,514034,Herbst; Matthew,0,2,16,16
1715604372580,MMW 12R,A02,514035,Herbst; Matthew,0,0,16,16
1715604373605,MMW 13R,A01,514037,Staff,0,5,16,16
1715604373605,MMW 13R,A02,514039,Staff,0,5,16,16
1715604373605,MMW 13R,A03,628519,Staff,0,4,16,16
1715604375662,SIO 295LS,A00,523233,Staff,10,0,30,20
1715604376691,SIO 295S,A00,523232,Staff,10,0,30,20
1715604377718,SIOC 290S,A01,637330,Merrifield; Mark A,23,0,30,7
1715604378745,SIOC 291S,A01,637333,Gabriel; Corey John,23,0,30,7
1715604379775,SOCI 117,A01,494376,Staff,0,5,5,5
1715604380803,WES 237B,A00,494380,Staff,10,0,20,10
1715604382874,AESE 279B,A00,494370,Wade; Jon P,0,0,33,33
1715604383901,AIP 97,001,660915,Van Den Einde; Yael Dahlia,9999,0,9999,0
1715604384929,AIP 197,001,627712,Vespa; Emanuel Ignacio,9995,0,9999,4
1715604384929,AIP 197,002,650778,Amir; On,9998,0,9999,1
1715604384929,AIP 197,003,650933,Avenancio-Leon; Carlos,9998,0,9999,1
1715604384929,AIP 197,004,658530,Heyman; Gail D.,9998,0,9999,1
1715604384929,AIP 197,005,658631,Neal; Sonya E,9998,0,9999,1
1715604384929,AIP 197,006,658671,Du; Songzi,9998,0,9999,1
1715604385957,ANAR 135S,A00,494369,Braswell; Geoffrey E.,0,0,0,0
1715604386985,BENG 196,001,628496,Engler; Adam J.,9998,0,9999,1
1715604386985,BENG 196,002,660916,Watson; John Thomas,9999,0,9999,0
1715604388016,BISP 197,001,650773,Wilhelm; James E.,9994,0,9999,5
1715604388016,BISP 197,002,658904,Coleman; Aaron B.,9998,0,9999,1
1715604389046,CAT 124RS,A01,519847,Geibel; William,0,0,20,20
1715604390076,CAT 125RS,A01,515971,Geibel; William,0,0,20,20
1715604391103,CLRE 250,A00,511389,Morris; Sheldon,9992,0,9999,7
1715604392132,CLRE 251,A00,507176,Mehta; Ravindra L.,9992,0,9999,7
1715604392132,CLRE 251,B00,511410,Mehta; Ravindra L.,9998,0,9999,1
1715604393163,CLRE 252,A00,507189,Cuomo; Raphael Eduardo,9994,0,9999,5
1715604394189,CLRE 253,A00,507199,Vaida; Florin,9994,0,9999,5
1715604394189,CLRE 253,B00,507202,Vaida; Florin,9999,0,9999,0
1715604395215,CLRE 259,A00,507211,Patel; Hemal,9996,0,9999,3
1715604396241,CLRE 260,A00,507221,Cuomo; Raphael Eduardo,9999,0,9999,0
1715604397269,CLRE 297,001,507242,Cuomo; Raphael Eduardo,9999,0,9999,0
1715604398295,COGS 197,001,638244,Voytek; Bradley Thomas,9997,0,9999,2
1715604399322,CSE 191,A00,516875,Minnes Kemp; Mor Mia,9991,0,9999,8
1715604400347,CSE 197,001,637388,Minnes Kemp; Mor Mia,9992,0,9999,7
1715604401374,CSS 201S,A01,494383,Mignozzetti; Umberto,35,0,35,0
1715604402406,CSS 202S,A01,494387,Mignozzetti; Umberto,35,0,35,0
1715604403432,DSC 197,001,628532,Eldridge; Justin Matthew,9995,0,9999,4
1715604404459,EAP 100,A00,516065,Staff,9799,0,9999,200
1715604405486,ECE 45,A01,507414,Staff,31,0,60,29
1715604407542,ECE 111,A01,507420,Staff,11,0,50,39
1715604408572,ECE 197,001,548057,Sievenpiper; Daniel F.,9991,0,9999,8
1715604409602,EDS 115,A00,507243,Choi; Bailey Miyeon,7,0,28,21
1715604410630,EDS 117,A01,494379,Staff,0,6,34,34
1715604411662,EDS 125,A00,507246,Hopkins; Megan Beth,8,0,30,22
1715604412692,EDS 128A,A01,507264,Fargason; Sharon Gayle,6,0,26,20
1715604413721,EDS 128B,A01,507293,Pappas; Elizabeth,10,0,30,20
1715604414747,EDS 139,A00,507294,Fargason; Sharon Gayle,10,0,30,20
1715604414747,EDS 139,B00,507313,Pappas; Elizabeth,11,0,30,19
1715604415773,EDS 201,A00,507315,Staff,10,0,30,20
1715604416799,EDS 203,A01,507317,Halter; Christopher P.,10,0,30,20
1715604417826,EDS 204R,A01,507319,Halter; Christopher P.,0,3,30,30
1715604417826,EDS 204R,B01,507331,Heinzman; Erica M.,14,0,30,16
1715604418852,EDS 206R,A00,507332,Staff,0,4,30,30
1715604418852,EDS 206R,B00,507343,Staff,15,0,30,15
1715604419882,EDS 250,A00,507344,Hemans; Patricia Ann Benitez,20,0,40,20
1715604420910,EDS 281,A00,507345,Daly; Alan J.,18,0,18,0
1715604421934,EDS 284,A00,507350,Daly; Alan J.,16,0,16,0
1715604422965,EDS 286,A00,507359,Fine; Sarah,18,0,18,0
1715604423995,EDS 289C,A01,507361,Daly; Alan J.,18,0,18,0
1715604425022,EDS 290,A00,507366,Hofstetter; Carolyn,15,0,15,0
1715604426049,LIGM 5A,A00,507421,Fischer-Grunski; Eva K,17,0,20,3
1715604427080,LIGM 5B,A00,507423,Fischer-Grunski; Eva K,19,0,20,1
1715604428108,LIGM 5C,A00,507425,Fischer-Grunski; Eva K,19,0,20,1
1715604429135,LIIT 5AS,A00,507427,Carnelos; Chiara,20,0,20,0
1715604430165,LIIT 5BS,A00,507430,Carnelos; Chiara,20,0,20,0
1715604431196,LIIT 5CS,A00,507432,Carnelos; Chiara,20,0,20,0
1715604432225,LISP 5A,A00,507541,Munoz Sanchez; Alicia,11,0,20,9
1715604433251,LISP 5B,A00,507671,Munoz Sanchez; Alicia,9,0,20,11
1715604434277,LISP 5C,A00,507696,Munoz Sanchez; Alicia,9,0,20,11
1715604435303,MAE 197,001,528363,Boechler; Nicholas Sebastia,9998,0,9999,1
1715604436332,MATH 197,001,523477,Kedlaya; Kiran S.,9994,0,9999,5
1715604436332,MATH 197,002,563811,Zhang; Danna,9994,0,9999,5
1715604436332,MATH 197,003,628552,Dumitriu; Ioana,9998,0,9999,1
1715604436332,MATH 197,004,660885,Floyd; Eric,9999,0,9999,0
1715604437362,MCWP 40R,A00,518780,Staff,2,0,20,18
1715604437362,MCWP 40R,B00,518781,Staff,11,0,20,9
1715604437362,MCWP 40R,C00,518783,Staff,5,0,20,15
1715604438390,MCWP 50R,A00,518791,Staff,0,1,20,20
1715604438390,MCWP 50R,B00,518792,Staff,0,2,20,20
1715604438390,MCWP 50R,C00,518793,Staff,0,4,20,20
1715604438390,MCWP 50R,D00,518794,Staff,0,1,20,20
1715604438390,MCWP 50R,E00,518795,Staff,0,2,20,20
1715604438390,MCWP 50R,F00,518796,Staff,0,1,20,20
1715604438390,MCWP 50R,G00,518797,Staff,0,1,20,20
1715604439415,MMW 12R,A01,514034,Herbst; Matthew,0,2,16,16
1715604439415,MMW 12R,A02,514035,Herbst; Matthew,0,0,16,16
1715604440445,MMW 13R,A01,514037,Staff,0,5,16,16
1715604440445,MMW 13R,A02,514039,Staff,0,5,16,16
1715604440445,MMW 13R,A03,628519,Staff,0,4,16,16
1715604442498,SIO 295LS,A00,523233,Staff,10,0,30,20
1715604443528,SIO 295S,A00,523232,Staff,10,0,30,20
1715604444556,SIOC 290S,A01,637330,Merrifield; Mark A,23,0,30,7
1715604445582,SIOC 291S,A01,637333,Gabriel; Corey John,23,0,30,7
1715604446613,SOCI 117,A01,494376,Staff,0,5,5,5
1715604447639,WES 237B,A00,494380,Staff,10,0,20,10
1715604449721,AESE 279B,A00,494370,Wade; Jon P,0,0,33,33
1715604450748,AIP 97,001,660915,Van Den Einde; Yael Dahlia,9999,0,9999,0
1715604451778,AIP 197,001,627712,Vespa; Emanuel Ignacio,9995,0,9999,4
1715604451778,AIP 197,002,650778,Amir; On,9998,0,9999,1
1715604451778,AIP 197,003,650933,Avenancio-Leon; Carlos,9998,0,9999,1
1715604451778,AIP 197,004,658530,Heyman; Gail D.,9998,0,9999,1
1715604451778,AIP 197,005,658631,Neal; Sonya E,9998,0,9999,1
1715604451778,AIP 197,006,658671,Du; Songzi,9998,0,9999,1
1715604452804,ANAR 135S,A00,494369,Braswell; Geoffrey E.,0,0,0,0
1715604453831,BENG 196,001,628496,Engler; Adam J.,9998,0,9999,1
1715604453831,BENG 196,002,660916,Watson; John Thomas,9999,0,9999,0
1715604454859,BISP 197,001,650773,Wilhelm; James E.,9994,0,9999,5
1715604454859,BISP 197,002,658904,Coleman; Aaron B.,9998,0,9999,1
1715604455887,CAT 124RS,A01,519847,Geibel; William,0,0,20,20
1715604456912,CAT 125RS,A01,515971,Geibel; William,0,0,20,20
1715604457941,CLRE 250,A00,511389,Morris; Sheldon,9992,0,9999,7
1715604458968,CLRE 251,A00,507176,Mehta; Ravindra L.,9992,0,9999,7
1715604458968,CLRE 251,B00,511410,Mehta; Ravindra L.,9998,0,9999,1
1715604459996,CLRE 252,A00,507189,Cuomo; Raphael Eduardo,9994,0,9999,5
1715604461023,CLRE 253,A00,507199,Vaida; Florin,9994,0,9999,5
1715604461023,CLRE 253,B00,507202,Vaida; Florin,9999,0,9999,0
1715604462050,CLRE 259,A00,507211,Patel; Hemal,9996,0,9999,3
1715604463079,CLRE 260,A00,507221,Cuomo; Raphael Eduardo,9999,0,9999,0
1715604464106,CLRE 297,001,507242,Cuomo; Raphael Eduardo,9999,0,9999,0
1715604465137,COGS 197,001,638244,Voytek; Bradley Thomas,9997,0,9999,2
1715604466170,CSE 191,A00,516875,Minnes Kemp; Mor Mia,9991,0,9999,8
1715604467198,CSE 197,001,637388,Minnes Kemp; Mor Mia,9992,0,9999,7
1715604468227,CSS 201S,A01,494383,Mignozzetti; Umberto,35,0,35,0
1715604469253,CSS 202S,A01,494387,Mignozzetti; Umberto,35,0,35,0
1715604470279,DSC 197,001,628532,Eldridge; Justin Matthew,9995,0,9999,4
1715604471304,EAP 100,A00,516065,Staff,9799,0,9999,200
1715604472334,ECE 45,A01,507414,Staff,31,0,60,29
1715604474388,ECE 111,A01,507420,Staff,11,0,50,39
1715604475418,ECE 197,001,548057,Sievenpiper; Daniel F.,9991,0,9999,8
1715604476447,EDS 115,A00,507243,Choi; Bailey Miyeon,7,0,28,21
1715604477474,EDS 117,A01,494379,Staff,0,6,34,34
1715604478503,EDS 125,A00,507246,Hopkins; Megan Beth,8,0,30,22
1715604479530,EDS 128A,A01,507264,Fargason; Sharon Gayle,6,0,26,20
1715604480560,EDS 128B,A01,507293,Pappas; Elizabeth,10,0,30,20
1715604481586,EDS 139,A00,507294,Fargason; Sharon Gayle,10,0,30,20
1715604481586,EDS 139,B00,507313,Pappas; Elizabeth,11,0,30,19
1715604482614,EDS 201,A00,507315,Staff,10,0,30,20
1715604483646,EDS 203,A01,507317,Halter; Christopher P.,10,0,30,20
1715604484674,EDS 204R,A01,507319,Halter; Christopher P.,0,3,30,30
1715604484674,EDS 204R,B01,507331,Heinzman; Erica M.,14,0,30,16
1715604485701,EDS 206R,A00,507332,Staff,0,4,30,30
1715604485701,EDS 206R,B00,507343,Staff,15,0,30,15
1715604486729,EDS 250,A00,507344,Hemans; Patricia Ann Benitez,20,0,40,20
1715604487755,EDS 281,A00,507345,Daly; Alan J.,18,0,18,0
1715604488781,EDS 284,A00,507350,Daly; Alan J.,16,0,16,0
1715604489808,EDS 286,A00,507359,Fine; Sarah,18,0,18,0
1715604490837,EDS 289C,A01,507361,Daly; Alan J.,18,0,18,0
1715604491869,EDS 290,A00,507366,Hofstetter; Carolyn,15,0,15,0
1715604492899,LIGM 5A,A00,507421,Fischer-Grunski; Eva K,17,0,20,3
1715604493925,LIGM 5B,A00,507423,Fischer-Grunski; Eva K,19,0,20,1
1715604494952,LIGM 5C,A00,507425,Fischer-Grunski; Eva K,19,0,20,1
1715604495980,LIIT 5AS,A00,507427,Carnelos; Chiara,20,0,20,0
1715604497007,LIIT 5BS,A00,507430,Carnelos; Chiara,20,0,20,0
1715604498038,LIIT 5CS,A00,507432,Carnelos; Chiara,20,0,20,0
1715604499064,LISP 5A,A00,507541,Munoz Sanchez; Alicia,11,0,20,9
1715604500093,LISP 5B,A00,507671,Munoz Sanchez; Alicia,9,0,20,11
1715604501123,LISP 5C,A00,507696,Munoz Sanchez; Alicia,9,0,20,11
1715604502156,MAE 197,001,528363,Boechler; Nicholas Sebastia,9998,0,9999,1
1715604503185,MATH 197,001,523477,Kedlaya; Kiran S.,9994,0,9999,5
1715604503185,MATH 197,002,563811,Zhang; Danna,9994,0,9999,5
1715604503185,MATH 197,003,628552,Dumitriu; Ioana,9998,0,9999,1
1715604503185,MATH 197,004,660885,Floyd; Eric,9999,0,9999,0
1715604504211,MCWP 40R,A00,518780,Staff,2,0,20,18
1715604504211,MCWP 40R,B00,518781,Staff,11,0,20,9
1715604504211,MCWP 40R,C00,518783,Staff,5,0,20,15
1715604505244,MCWP 50R,A00,518791,Staff,0,1,20,20
1715604505244,MCWP 50R,B00,518792,Staff,0,2,20,20
1715604505244,MCWP 50R,C00,518793,Staff,0,4,20,20
1715604505244,MCWP 50R,D00,518794,Staff,0,1,20,20
1715604505244,MCWP 50R,E00,518795,Staff,0,2,20,20
1715604505244,MCWP 50R,F00,518796,Staff,0,1,20,20
1715604505244,MCWP 50R,G00,518797,Staff,0,1,20,20
1715604506271,MMW 12R,A01,514034,Herbst; Matthew,0,2,16,16
1715604506271,MMW 12R,A02,514035,Herbst; Matthew,0,0,16,16
1715604507301,MMW 13R,A01,514037,Staff,0,5,16,16
1715604507301,MMW 13R,A02,514039,Staff,0,5,16,16
1715604507301,MMW 13R,A03,628519,Staff,0,4,16,16
1715604509356,SIO 295LS,A00,523233,Staff,10,0,30,20
1715604510384,SIO 295S,A00,523232,Staff,10,0,30,20
1715604511413,SIOC 290S,A01,637330,Merrifield; Mark A,23,0,30,7
1715604512440,SIOC 291S,A01,637333,Gabriel; Corey John,23,0,30,7
1715604513472,SOCI 117,A01,494376,Staff,0,5,5,5
1715604514500,WES 237B,A00,494380,Staff,10,0,20,10
1715604516589,AESE 279B,A00,494370,Wade; Jon P,0,0,33,33
1715604517617,AIP 97,001,660915,Van Den Einde; Yael Dahlia,9999,0,9999,0
1715604518645,AIP 197,001,627712,Vespa; Emanuel Ignacio,9995,0,9999,4
1715604518645,AIP 197,002,650778,Amir; On,9998,0,9999,1
1715604518645,AIP 197,003,650933,Avenancio-Leon; Carlos,9998,0,9999,1
1715604518645,AIP 197,004,658530,Heyman; Gail D.,9998,0,9999,1
1715604518645,AIP 197,005,658631,Neal; Sonya E,9998,0,9999,1
1715604518645,AIP 197,006,658671,Du; Songzi,9998,0,9999,1
1715604519675,ANAR 135S,A00,494369,Braswell; Geoffrey E.,0,0,0,0
1715604520702,BENG 196,001,628496,Engler; Adam J.,9998,0,9999,1
1715604520702,BENG 196,002,660916,Watson; John Thomas,9999,0,9999,0
1715604521736,BISP 197,001,650773,Wilhelm; James E.,9994,0,9999,5
1715604521736,BISP 197,002,658904,Coleman; Aaron B.,9998,0,9999,1
1715604522763,CAT 124RS,A01,519847,Geibel; William,0,0,20,20
1715604523788,CAT 125RS,A01,515971,Geibel; William,0,0,20,20
1715604524820,CLRE 250,A00,511389,Morris; Sheldon,9992,0,9999,7
1715604525847,CLRE 251,A00,507176,Mehta; Ravindra L.,9992,0,9999,7
1715604525847,CLRE 251,B00,511410,Mehta; Ravindra L.,9998,0,9999,1
1715604526874,CLRE 252,A00,507189,Cuomo; Raphael Eduardo,9994,0,9999,5
1715604527900,CLRE 253,A00,507199,Vaida; Florin,9994,0,9999,5
1715604527900,CLRE 253,B00,507202,Vaida; Florin,9999,0,9999,0
1715604528930,CLRE 259,A00,507211,Patel; Hemal,9996,0,9999,3
1715604529956,CLRE 260,A00,507221,Cuomo; Raphael Eduardo,9999,0,9999,0
1715604530984,CLRE 297,001,507242,Cuomo; Raphael Eduardo,9999,0,9999,0
1715604532013,COGS 197,001,638244,Voytek; Bradley Thomas,9997,0,9999,2
1715604533045,CSE 191,A00,516875,Minnes Kemp; Mor Mia,9991,0,9999,8
1715604534071,CSE 197,001,637388,Minnes Kemp; Mor Mia,9992,0,9999,7
1715604535103,CSS 201S,A01,494383,Mignozzetti; Umberto,35,0,35,0
1715604536130,CSS 202S,A01,494387,Mignozzetti; Umberto,35,0,35,0
1715604537155,DSC 197,001,628532,Eldridge; Justin Matthew,9995,0,9999,4
1715604538185,EAP 100,A00,516065,Staff,9799,0,9999,200
1715604539213,ECE 45,A01,507414,Staff,31,0,60,29
1715604541271,ECE 111,A01,507420,Staff,11,0,50,39
1715604542299,ECE 197,001,548057,Sievenpiper; Daniel F.,9991,0,9999,8
1715604543327,EDS 115,A00,507243,Choi; Bailey Miyeon,7,0,28,21
1715604544357,EDS 117,A01,494379,Staff,0,6,34,34
1715604545383,EDS 125,A00,507246,Hopkins; Megan Beth,8,0,30,22
1715604546409,EDS 128A,A01,507264,Fargason; Sharon Gayle,6,0,26,20
1715604547440,EDS 128B,A01,507293,Pappas; Elizabeth,10,0,30,20
1715604548474,EDS 139,A00,507294,Fargason; Sharon Gayle,10,0,30,20
1715604548474,EDS 139,B00,507313,Pappas; Elizabeth,11,0,30,19
1715604549500,EDS 201,A00,507315,Staff,10,0,30,20
1715604550532,EDS 203,A01,507317,Halter; Christopher P.,10,0,30,20
1715604551558,EDS 204R,A01,507319,Halter; Christopher P.,0,3,30,30
1715604551558,EDS 204R,B01,507331,Heinzman; Erica M.,14,0,30,16
1715604552588,EDS 206R,A00,507332,Staff,0,4,30,30
1715604552588,EDS 206R,B00,507343,Staff,15,0,30,15
1715604553618,EDS 250,A00,507344,Hemans; Patricia Ann Benitez,20,0,40,20
1715604554649,EDS 281,A00,507345,Daly; Alan J.,18,0,18,0
1715604555676,EDS 284,A00,507350,Daly; Alan J.,16,0,16,0
1715604556704,EDS 286,A00,507359,Fine; Sarah,18,0,18,0
1715604557733,EDS 289C,A01,507361,Daly; Alan J.,18,0,18,0
1715604558762,EDS 290,A00,507366,Hofstetter; Carolyn,15,0,15,0
1715604559790,LIGM 5A,A00,507421,Fischer-Grunski; Eva K,17,0,20,3
1715604560818,LIGM 5B,A00,507423,Fischer-Grunski; Eva K,19,0,20,1
1715604561847,LIGM 5C,A00,507425,Fischer-Grunski; Eva K,19,0,20,1
1715604562875,LIIT 5AS,A00,507427,Carnelos; Chiara,20,0,20,0
1715604563959,LIIT 5BS,A00,507430,Carnelos; Chiara,20,0,20,0
1715604564988,LIIT 5CS,A00,507432,Carnelos; Chiara,20,0,20,0
1715604566014,LISP 5A,A00,507541,Munoz Sanchez; Alicia,11,0,20,9
1715604567046,LISP 5B,A00,507671,Munoz Sanchez; Alicia,9,0,20,11
1715604568071,LISP 5C,A00,507696,Munoz Sanchez; Alicia,9,0,20,11
1715604569098,MAE 197,001,528363,Boechler; Nicholas Sebastia,9998,0,9999,1
1715604570136,MATH 197,001,523477,Kedlaya; Kiran S.,9994,0,9999,5
1715604570136,MATH 197,002,563811,Zhang; Danna,9994,0,9999,5
1715604570136,MATH 197,003,628552,Dumitriu; Ioana,9998,0,9999,1
1715604570136,MATH 197,004,660885,Floyd; Eric,9999,0,9999,0
1715604571163,MCWP 40R,A00,518780,Staff,2,0,20,18
1715604571163,MCWP 40R,B00,518781,Staff,11,0,20,9
1715604571163,MCWP 40R,C00,518783,Staff,5,0,20,15
1715604572190,MCWP 50R,A00,518791,Staff,0,1,20,20
1715604572190,MCWP 50R,B00,518792,Staff,0,2,20,20
1715604572190,MCWP 50R,C00,518793,Staff,0,4,20,20
1715604572190,MCWP 50R,D00,518794,Staff,0,1,20,20
1715604572190,MCWP 50R,E00,518795,Staff,0,2,20,20
1715604572190,MCWP 50R,F00,518796,Staff,0,1,20,20
1715604572190,MCWP 50R,G00,518797,Staff,0,1,20,20
1715604573218,MMW 12R,A01,514034,Herbst; Matthew,0,2,16,16
1715604573218,MMW 12R,A02,514035,Herbst; Matthew,0,0,16,16
1715604574243,MMW 13R,A01,514037,Staff,0,5,16,16
1715604574243,MMW 13R,A02,514039,Staff,0,5,16,16
1715604574243,MMW 13R,A03,628519,Staff,0,4,16,16
1715604576294,SIO 295LS,A00,523233,Staff,10,0,30,20
1715604577319,SIO 295S,A00,523232,Staff,10,0,30,20
1715604578348,SIOC 290S,A01,637330,Merrifield; Mark A,23,0,30,7
1715604579375,SIOC 291S,A01,637333,Gabriel; Corey John,23,0,30,7
1715604580407,SOCI 117,A01,494376,Staff,0,5,5,5
1715604581490,WES 237B,A00,494380,Staff,10,0,20,10
1715604583577,AESE 279B,A00,494370,Wade; Jon P,0,0,33,33
1715604584604,AIP 97,001,660915,Van Den Einde; Yael Dahlia,9999,0,9999,0
1715604585635,AIP 197,001,627712,Vespa; Emanuel Ignacio,9995,0,9999,4
1715604585635,AIP 197,002,650778,Amir; On,9998,0,9999,1
1715604585635,AIP 197,003,650933,Avenancio-Leon; Carlos,9998,0,9999,1
1715604585635,AIP 197,004,658530,Heyman; Gail D.,9998,0,9999,1
1715604585635,AIP 197,005,658631,Neal; Sonya E,9998,0,9999,1
1715604585635,AIP 197,006,658671,Du; Songzi,9998,0,9999,1
1715604586666,ANAR 135S,A00,494369,Braswell; Geoffrey E.,0,0,0,0
1715604587693,BENG 196,001,628496,Engler; Adam J.,9998,0,9999,1
1715604587693,BENG 196,002,660916,Watson; John Thomas,9999,0,9999,0
1715604588729,BISP 197,001,650773,Wilhelm; James E.,9994,0,9999,5
1715604588729,BISP 197,002,658904,Coleman; Aaron B.,9998,0,9999,1
1715604589761,CAT 124RS,A01,519847,Geibel; William,0,0,20,20
1715604590792,CAT 125RS,A01,515971,Geibel; William,0,0,20,20
1715604591820,CLRE 250,A00,511389,Morris; Sheldon,9992,0,9999,7
1715604592857,CLRE 251,A00,507176,Mehta; Ravindra L.,9992,0,9999,7
1715604592857,CLRE 251,B00,511410,Mehta; Ravindra L.,9998,0,9999,1
1715604593898,CLRE 252,A00,507189,Cuomo; Raphael Eduardo,9994,0,9999,5
1715604594924,CLRE 253,A00,507199,Vaida; Florin,9994,0,9999,5
1715604594924,CLRE 253,B00,507202,Vaida; Florin,9999,0,9999,0
1715604595957,CLRE 259,A00,507211,Patel; Hemal,9996,0,9999,3
1715604596983,CLRE 260,A00,507221,Cuomo; Raphael Eduardo,9999,0,9999,0
1715604598011,CLRE 297,001,507242,Cuomo; Raphael Eduardo,9999,0,9999,0
1715604599042,COGS 197,001,638244,Voytek; Bradley Thomas,9997,0,9999,2
1715604600069,CSE 191,A00,516875,Minnes Kemp; Mor Mia,9991,0,9999,8
1715604601098,CSE 197,001,637388,Minnes Kemp; Mor Mia,9992,0,9999,7
1715604602129,CSS 201S,A01,494383,Mignozzetti; Umberto,35,0,35,0
1715604603156,CSS 202S,A01,494387,Mignozzetti; Umberto,35,0,35,0
1715604604187,DSC 197,001,628532,Eldridge; Justin Matthew,9995,0,9999,4
1715604605214,EAP 100,A00,516065,Staff,9799,0,9999,200
1715604606251,ECE 45,A01,507414,Staff,31,0,60,29
1715604608309,ECE 111,A01,507420,Staff,11,0,50,39
1715604609340,ECE 197,001,548057,Sievenpiper; Daniel F.,9991,0,9999,8
1715604610368,EDS 115,A00,507243,Choi; Bailey Miyeon,7,0,28,21
1715604611398,EDS 117,A01,494379,Staff,0,6,34,34
1715604612428,EDS 125,A00,507246,Hopkins; Megan Beth,8,0,30,22
1715604613460,EDS 128A,A01,507264,Fargason; Sharon Gayle,6,0,26,20
1715604614490,EDS 128B,A01,507293,Pappas; Elizabeth,10,0,30,20
1715604615516,EDS 139,A00,507294,Fargason; Sharon Gayle,10,0,30,20
1715604615516,EDS 139,B00,507313,Pappas; Elizabeth,11,0,30,19
1715604616547,EDS 201,A00,507315,Staff,10,0,30,20
1715604617574,EDS 203,A01,507317,Halter; Christopher P.,10,0,30,20
1715604618600,EDS 204R,A01,507319,Halter; Christopher P.,0,3,30,30
1715604618600,EDS 204R,B01,507331,Heinzman; Erica M.,14,0,30,16
1715604619625,EDS 206R,A00,507332,Staff,0,4,30,30
1715604619625,EDS 206R,B00,507343,Staff,15,0,30,15
1715604620654,EDS 250,A00,507344,Hemans; Patricia Ann Benitez,20,0,40,20
1715604621680,EDS 281,A00,507345,Daly; Alan J.,18,0,18,0
1715604622707,EDS 284,A00,507350,Daly; Alan J.,16,0,16,0
1715604623734,EDS 286,A00,507359,Fine; Sarah,18,0,18,0
1715604624764,EDS 289C,A01,507361,Daly; Alan J.,18,0,18,0
1715604625790,EDS 290,A00,507366,Hofstetter; Carolyn,15,0,15,0
1715604626821,LIGM 5A,A00,507421,Fischer-Grunski; Eva K,17,0,20,3
1715604627850,LIGM 5B,A00,507423,Fischer-Grunski; Eva K,19,0,20,1
1715604628875,LIGM 5C,A00,507425,Fischer-Grunski; Eva K,19,0,20,1
1715604629902,LIIT 5AS,A00,507427,Carnelos; Chiara,20,0,20,0
1715604630929,LIIT 5BS,A00,507430,Carnelos; Chiara,20,0,20,0
1715604631956,LIIT 5CS,A00,507432,Carnelos; Chiara,20,0,20,0
1715604632985,LISP 5A,A00,507541,Munoz Sanchez; Alicia,11,0,20,9
1715604634012,LISP 5B,A00,507671,Munoz Sanchez; Alicia,9,0,20,11
1715604635043,LISP 5C,A00,507696,Munoz Sanchez; Alicia,9,0,20,11
1715604636070,MAE 197,001,528363,Boechler; Nicholas Sebastia,9998,0,9999,1
1715604637100,MATH 197,001,523477,Kedlaya; Kiran S.,9994,0,9999,5
1715604637100,MATH 197,002,563811,Zhang; Danna,9994,0,9999,5
1715604637100,MATH 197,003,628552,Dumitriu; Ioana,9998,0,9999,1
1715604637100,MATH 197,004,660885,Floyd; Eric,9999,0,9999,0
1715604638130,MCWP 40R,A00,518780,Staff,2,0,20,18
1715604638130,MCWP 40R,B00,518781,Staff,11,0,20,9
1715604638130,MCWP 40R,C00,518783,Staff,5,0,20,15
1715604639161,MCWP 50R,A00,518791,Staff,0,1,20,20
1715604639161,MCWP 50R,B00,518792,Staff,0,2,20,20
1715604639161,MCWP 50R,C00,518793,Staff,0,4,20,20
1715604639161,MCWP 50R,D00,518794,Staff,0,1,20,20
1715604639161,MCWP 50R,E00,518795,Staff,0,2,20,20
1715604639161,MCWP 50R,F00,518796,Staff,0,1,20,20
1715604639161,MCWP 50R,G00,518797,Staff,0,1,20,20
1715604640187,MMW 12R,A01,514034,Herbst; Matthew,0,2,16,16
1715604640187,MMW 12R,A02,514035,Herbst; Matthew,0,0,16,16
1715604641216,MMW 13R,A01,514037,Staff,0,5,16,16
1715604641216,MMW 13R,A02,514039,Staff,0,5,16,16
1715604641216,MMW 13R,A03,628519,Staff,0,4,16,16
1715604643271,SIO 295LS,A00,523233,Staff,10,0,30,20
1715604644297,SIO 295S,A00,523232,Staff,10,0,30,20
1715604645322,SIOC 290S,A01,637330,Merrifield; Mark A,23,0,30,7
1715604646349,SIOC 291S,A01,637333,Gabriel; Corey John,23,0,30,7
1715604647381,SOCI 117,A01,494376,Staff,0,5,5,5
1715604648410,WES 237B,A00,494380,Staff,10,0,20,10
1715604650512,AESE 279B,A00,494370,Wade; Jon P,0,0,33,33
1715604651538,AIP 97,001,660915,Van Den Einde; Yael Dahlia,9999,0,9999,0
1715604652574,AIP 197,001,627712,Vespa; Emanuel Ignacio,9995,0,9999,4
1715604652574,AIP 197,002,650778,Amir; On,9998,0,9999,1
1715604652574,AIP 197,003,650933,Avenancio-Leon; Carlos,9998,0,9999,1
1715604652574,AIP 197,004,658530,Heyman; Gail D.,9998,0,9999,1
1715604652574,AIP 197,005,658631,Neal; Sonya E,9998,0,9999,1
1715604652574,AIP 197,006,658671,Du; Songzi,9998,0,9999,1
1715604653604,ANAR 135S,A00,494369,Braswell; Geoffrey E.,0,0,0,0
1715604654630,BENG 196,001,628496,Engler; Adam J.,9998,0,9999,1
1715604654630,BENG 196,002,660916,Watson; John Thomas,9999,0,9999,0
1715604655662,BISP 197,001,650773,Wilhelm; James E.,9994,0,9999,5
1715604655662,BISP 197,002,658904,Coleman; Aaron B.,9998,0,9999,1
1715604656690,CAT 124RS,A01,519847,Geibel; William,0,0,20,20
1715604657716,CAT 125RS,A01,515971,Geibel; William,0,0,20,20
1715604658747,CLRE 250,A00,511389,Morris; Sheldon,9992,0,9999,7
1715604659775,CLRE 251,A00,507176,Mehta; Ravindra L.,9992,0,9999,7
1715604659775,CLRE 251,B00,511410,Mehta; Ravindra L.,9998,0,9999,1
1715604660802,CLRE 252,A00,507189,Cuomo; Raphael Eduardo,9994,0,9999,5
1715604661834,CLRE 253,A00,507199,Vaida; Florin,9994,0,9999,5
1715604661834,CLRE 253,B00,507202,Vaida; Florin,9999,0,9999,0
1715604662861,CLRE 259,A00,507211,Patel; Hemal,9996,0,9999,3
1715604663898,CLRE 260,A00,507221,Cuomo; Raphael Eduardo,9999,0,9999,0
1715604664923,CLRE 297,001,507242,Cuomo; Raphael Eduardo,9999,0,9999,0
1715604665953,COGS 197,001,638244,Voytek; Bradley Thomas,9997,0,9999,2
1715604666981,CSE 191,A00,516875,Minnes Kemp; Mor Mia,9991,0,9999,8
1715604668005,CSE 197,001,637388,Minnes Kemp; Mor Mia,9992,0,9999,7
1715604669037,CSS 201S,A01,494383,Mignozzetti; Umberto,35,0,35,0
1715604670067,CSS 202S,A01,494387,Mignozzetti; Umberto,35,0,35,0
1715604671092,DSC 197,001,628532,Eldridge; Justin Matthew,9995,0,9999,4
1715604672117,EAP 100,A00,516065,Staff,9799,0,9999,200
1715604673146,ECE 45,A01,507414,Staff,31,0,60,29
1715604675198,ECE 111,A01,507420,Staff,11,0,50,39
1715604676224,ECE 197,001,548057,Sievenpiper; Daniel F.,9991,0,9999,8
1715604677251,EDS 115,A00,507243,Choi; Bailey Miyeon,7,0,28,21
1715604678289,EDS 117,A01,494379,Staff,0,6,34,34
1715604679314,EDS 125,A00,507246,Hopkins; Megan Beth,8,0,30,22
1715604680342,EDS 128A,A01,507264,Fargason; Sharon Gayle,6,0,26,20
1715604681368,EDS 128B,A01,507293,Pappas; Elizabeth,10,0,30,20
1715604682396,EDS 139,A00,507294,Fargason; Sharon Gayle,10,0,30,20
1715604682396,EDS 139,B00,507313,Pappas; Elizabeth,11,0,30,19
1715604683423,EDS 201,A00,507315,Staff,10,0,30,20
1715604684450,EDS 203,A01,507317,Halter; Christopher P.,10,0,30,20
1715604685530,EDS 204R,A01,507319,Halter; Christopher P.,0,3,30,30
1715604685530,EDS 204R,B01,507331,Heinzman; Erica M.,14,0,30,16
1715604686559,EDS 206R,A00,507332,Staff,0,4,30,30
1715604686559,EDS 206R,B00,507343,Staff,15,0,30,15
1715604687585,EDS 250,A00,507344,Hemans; Patricia Ann Benitez,20,0,40,20
1715604688613,EDS 281,A00,507345,Daly; Alan J.,18,0,18,0
1715604689643,EDS 284,A00,507350,Daly; Alan J.,16,0,16,0
1715604690669,EDS 286,A00,507359,Fine; Sarah,18,0,18,0
1715604691694,EDS 289C,A01,507361,Daly; Alan J.,18,0,18,0
1715604692722,EDS 290,A00,507366,Hofstetter; Carolyn,15,0,15,0
1715604693753,LIGM 5A,A00,507421,Fischer-Grunski; Eva K,17,0,20,3
1715604694782,LIGM 5B,A00,507423,Fischer-Grunski; Eva K,19,0,20,1
1715604695809,LIGM 5C,A00,507425,Fischer-Grunski; Eva K,19,0,20,1
1715604696834,LIIT 5AS,A00,507427,Carnelos; Chiara,20,0,20,0
1715604697859,LIIT 5BS,A00,507430,Carnelos; Chiara,20,0,20,0
1715604698885,LIIT 5CS,A00,507432,Carnelos; Chiara,20,0,20,0
1715604699919,LISP 5A,A00,507541,Munoz Sanchez; Alicia,11,0,20,9
1715604700948,LISP 5B,A00,507671,Munoz Sanchez; Alicia,9,0,20,11
1715604701974,LISP 5C,A00,507696,Munoz Sanchez; Alicia,9,0,20,11
1715604703003,MAE 197,001,528363,Boechler; Nicholas Sebastia,9998,0,9999,1
1715604704032,MATH 197,001,523477,Kedlaya; Kiran S.,9994,0,9999,5
1715604704032,MATH 197,002,563811,Zhang; Danna,9994,0,9999,5
1715604704032,MATH 197,003,628552,Dumitriu; Ioana,9998,0,9999,1
1715604704032,MATH 197,004,660885,Floyd; Eric,9999,0,9999,0
1715604705062,MCWP 40R,A00,518780,Staff,2,0,20,18
1715604705062,MCWP 40R,B00,518781,Staff,11,0,20,9
1715604705062,MCWP 40R,C00,518783,Staff,5,0,20,15
1715604706089,MCWP 50R,A00,518791,Staff,0,1,20,20
1715604706089,MCWP 50R,B00,518792,Staff,0,2,20,20
1715604706089,MCWP 50R,C00,518793,Staff,0,4,20,20
1715604706089,MCWP 50R,D00,518794,Staff,0,1,20,20
1715604706089,MCWP 50R,E00,518795,Staff,0,2,20,20
1715604706089,MCWP 50R,F00,518796,Staff,0,1,20,20
1715604706089,MCWP 50R,G00,518797,Staff,0,1,20,20
1715604707119,MMW 12R,A01,514034,Herbst; Matthew,0,2,16,16
1715604707119,MMW 12R,A02,514035,Herbst; Matthew,0,0,16,16
1715604708151,MMW 13R,A01,514037,Staff,0,5,16,16
1715604708151,MMW 13R,A02,514039,Staff,0,5,16,16
1715604708151,MMW 13R,A03,628519,Staff,0,4,16,16
1715604710206,SIO 295LS,A00,523233,Staff,10,0,30,20
1715604711235,SIO 295S,A00,523232,Staff,10,0,30,20
1715604712267,SIOC 290S,A01,637330,Merrifield; Mark A,23,0,30,7
1715604713293,SIOC 291S,A01,637333,Gabriel; Corey John,23,0,30,7
1715604714320,SOCI 117,A01,494376,Staff,0,5,5,5
1715604715347,WES 237B,A00,494380,Staff,10,0,20,10
1715604717443,AESE 279B,A00,494370,Wade; Jon P,0,0,33,33
1715604718473,AIP 97,001,660915,Van Den Einde; Yael Dahlia,9999,0,9999,0
1715604719503,AIP 197,001,627712,Vespa; Emanuel Ignacio,9995,0,9999,4
1715604719503,AIP 197,002,650778,Amir; On,9998,0,9999,1
1715604719503,AIP 197,003,650933,Avenancio-Leon; Carlos,9998,0,9999,1
1715604719503,AIP 197,004,658530,Heyman; Gail D.,9998,0,9999,1
1715604719503,AIP 197,005,658631,Neal; Sonya E,9998,0,9999,1
1715604719503,AIP 197,006,658671,Du; Songzi,9998,0,9999,1
1715604720531,ANAR 135S,A00,494369,Braswell; Geoffrey E.,0,0,0,0
1715604721558,BENG 196,001,628496,Engler; Adam J.,9998,0,9999,1
1715604721558,BENG 196,002,660916,Watson; John Thomas,9999,0,9999,0
1715604722590,BISP 197,001,650773,Wilhelm; James E.,9994,0,9999,5
1715604722590,BISP 197,002,658904,Coleman; Aaron B.,9998,0,9999,1
1715604723619,CAT 124RS,A01,519847,Geibel; William,0,0,20,20
1715604724644,CAT 125RS,A01,515971,Geibel; William,0,0,20,20
1715604725675,CLRE 250,A00,511389,Morris; Sheldon,9992,0,9999,7
1715604726705,CLRE 251,A00,507176,Mehta; Ravindra L.,9992,0,9999,7
1715604726705,CLRE 251,B00,511410,Mehta; Ravindra L.,9998,0,9999,1
1715604727732,CLRE 252,A00,507189,Cuomo; Raphael Eduardo,9994,0,9999,5
1715604728759,CLRE 253,A00,507199,Vaida; Florin,9994,0,9999,5
1715604728759,CLRE 253,B00,507202,Vaida; Florin,9999,0,9999,0
1715604729788,CLRE 259,A00,507211,Patel; Hemal,9996,0,9999,3
1715604730815,CLRE 260,A00,507221,Cuomo; Raphael Eduardo,9999,0,9999,0
1715604731841,CLRE 297,001,507242,Cuomo; Raphael Eduardo,9999,0,9999,0
1715604732866,COGS 197,001,638244,Voytek; Bradley Thomas,9997,0,9999,2
1715604733908,CSE 191,A00,516875,Minnes Kemp; Mor Mia,9991,0,9999,8
1715604734938,CSE 197,001,637388,Minnes Kemp; Mor Mia,9992,0,9999,7
1715604735966,CSS 201S,A01,494383,Mignozzetti; Umberto,35,0,35,0
1715604736996,CSS 202S,A01,494387,Mignozzetti; Umberto,35,0,35,0
1715604738021,DSC 197,001,628532,Eldridge; Justin Matthew,9995,0,9999,4
1715604739048,EAP 100,A00,516065,Staff,9799,0,9999,200
1715604740077,ECE 45,A01,507414,Staff,31,0,60,29
1715604742135,ECE 111,A01,507420,Staff,11,0,50,39
1715604743163,ECE 197,001,548057,Sievenpiper; Daniel F.,9991,0,9999,8
1715604744193,EDS 115,A00,507243,Choi; Bailey Miyeon,7,0,28,21
1715604745225,EDS 117,A01,494379,Staff,0,6,34,34
1715604746251,EDS 125,A00,507246,Hopkins; Megan Beth,8,0,30,22
1715604747284,EDS 128A,A01,507264,Fargason; Sharon Gayle,6,0,26,20
1715604748315,EDS 128B,A01,507293,Pappas; Elizabeth,10,0,30,20
1715604749343,EDS 139,A00,507294,Fargason; Sharon Gayle,10,0,30,20
1715604749343,EDS 139,B00,507313,Pappas; Elizabeth,11,0,30,19
1715604750369,EDS 201,A00,507315,Staff,10,0,30,20
1715604751400,EDS 203,A01,507317,Halter; Christopher P.,10,0,30,20
1715604752429,EDS 204R,A01,507319,Halter; Christopher P.,0,3,30,30
1715604752429,EDS 204R,B01,507331,Heinzman; Erica M.,14,0,30,16
1715604753460,EDS 206R,A00,507332,Staff,0,4,30,30
1715604753460,EDS 206R,B00,507343,Staff,15,0,30,15
1715604754490,EDS 250,A00,507344,Hemans; Patricia Ann Benitez,20,0,40,20
1715604755522,EDS 281,A00,507345,Daly; Alan J.,18,0,18,0
1715604756551,EDS 284,A00,507350,Daly; Alan J.,16,0,16,0
1715604757577,EDS 286,A00,507359,Fine; Sarah,18,0,18,0
1715604758604,EDS 289C,A01,507361,Daly; Alan J.,18,0,18,0
1715604759633,EDS 290,A00,507366,Hofstetter; Carolyn,15,0,15,0
1715604760667,LIGM 5A,A00,507421,Fischer-Grunski; Eva K,17,0,20,3
1715604761697,LIGM 5B,A00,507423,Fischer-Grunski; Eva K,19,0,20,1
1715604762723,LIGM 5C,A00,507425,Fischer-Grunski; Eva K,19,0,20,1
1715604763750,LIIT 5AS,A00,507427,Carnelos; Chiara,20,0,20,0
1715604764779,LIIT 5BS,A00,507430,Carnelos; Chiara,20,0,20,0
1715604765805,LIIT 5CS,A00,507432,Carnelos; Chiara,20,0,20,0
1715604766832,LISP 5A,A00,507541,Munoz Sanchez; Alicia,11,0,20,9
1715604767857,LISP 5B,A00,507671,Munoz Sanchez; Alicia,9,0,20,11
1715604768883,LISP 5C,A00,507696,Munoz Sanchez; Alicia,9,0,20,11
1715604769908,MAE 197,001,528363,Boechler; Nicholas Sebastia,9998,0,9999,1
1715604770938,MATH 197,001,523477,Kedlaya; Kiran S.,9994,0,9999,5
1715604770938,MATH 197,002,563811,Zhang; Danna,9994,0,9999,5
1715604770938,MATH 197,003,628552,Dumitriu; Ioana,9998,0,9999,1
1715604770938,MATH 197,004,660885,Floyd; Eric,9999,0,9999,0
1715604771963,MCWP 40R,A00,518780,Staff,2,0,20,18
1715604771963,MCWP 40R,B00,518781,Staff,11,0,20,9
1715604771963,MCWP 40R,C00,518783,Staff,5,0,20,15
1715604772990,MCWP 50R,A00,518791,Staff,0,1,20,20
1715604772990,MCWP 50R,B00,518792,Staff,0,2,20,20
1715604772990,MCWP 50R,C00,518793,Staff,0,4,20,20
1715604772990,MCWP 50R,D00,518794,Staff,0,1,20,20
1715604772990,MCWP 50R,E00,518795,Staff,0,2,20,20
1715604772990,MCWP 50R,F00,518796,Staff,0,1,20,20
1715604772990,MCWP 50R,G00,518797,Staff,0,1,20,20
1715604774022,MMW 12R,A01,514034,Herbst; Matthew,0,2,16,16
1715604774022,MMW 12R,A02,514035,Herbst; Matthew,0,0,16,16
1715604775049,MMW 13R,A01,514037,Staff,0,5,16,16
1715604775049,MMW 13R,A02,514039,Staff,0,5,16,16
1715604775049,MMW 13R,A03,628519,Staff,0,4,16,16
1715604777105,SIO 295LS,A00,523233,Staff,10,0,30,20
1715604778130,SIO 295S,A00,523232,Staff,10,0,30,20
1715604779157,SIOC 290S,A01,637330,Merrifield; Mark A,23,0,30,7
1715604780188,SIOC 291S,A01,637333,Gabriel; Corey John,23,0,30,7
1715604781214,SOCI 117,A01,494376,Staff,0,5,5,5
1715604782241,WES 237B,A00,494380,Staff,10,0,20,10
1715604784332,AESE 279B,A00,494370,Wade; Jon P,0,0,33,33
1715604785359,AIP 97,001,660915,Van Den Einde; Yael Dahlia,9999,0,9999,0
1715604786388,AIP 197,001,627712,Vespa; Emanuel Ignacio,9995,0,9999,4
1715604786388,AIP 197,002,650778,Amir; On,9998,0,9999,1
1715604786388,AIP 197,003,650933,Avenancio-Leon; Carlos,9998,0,9999,1
1715604786388,AIP 197,004,658530,Heyman; Gail D.,9998,0,9999,1
1715604786388,AIP 197,005,658631,Neal; Sonya E,9998,0,9999,1
1715604786388,AIP 197,006,658671,Du; Songzi,9998,0,9999,1
1715604787414,ANAR 135S,A00,494369,Braswell; Geoffrey E.,0,0,0,0
1715604788441,BENG 196,001,628496,Engler; Adam J.,9998,0,9999,1
1715604788441,BENG 196,002,660916,Watson; John Thomas,9999,0,9999,0
1715604789529,BISP 197,001,650773,Wilhelm; James E.,9994,0,9999,5
1715604789529,BISP 197,002,658904,Coleman; Aaron B.,9998,0,9999,1
1715604790554,CAT 124RS,A01,519847,Geibel; William,0,0,20,20
1715604791580,CAT 125RS,A01,515971,Geibel; William,0,0,20,20
1715604792608,CLRE 250,A00,511389,Morris; Sheldon,9992,0,9999,7
1715604793640,CLRE 251,A00,507176,Mehta; Ravindra L.,9992,0,9999,7
1715604793640,CLRE 251,B00,511410,Mehta; Ravindra L.,9998,0,9999,1
1715604794667,CLRE 252,A00,507189,Cuomo; Raphael Eduardo,9994,0,9999,5
1715604795692,CLRE 253,A00,507199,Vaida; Florin,9994,0,9999,5
1715604795692,CLRE 253,B00,507202,Vaida; Florin,9999,0,9999,0
1715604796720,CLRE 259,A00,507211,Patel; Hemal,9996,0,9999,3
1715604797748,CLRE 260,A00,507221,Cuomo; Raphael Eduardo,9999,0,9999,0
1715604798777,CLRE 297,001,507242,Cuomo; Raphael Eduardo,9999,0,9999,0
1715604799806,COGS 197,001,638244,Voytek; Bradley Thomas,9997,0,9999,2
1715604800834,CSE 191,A00,516875,Minnes Kemp; Mor Mia,9991,0,9999,8
1715604801859,CSE 197,001,637388,Minnes Kemp; Mor Mia,9992,0,9999,7
1715604802887,CSS 201S,A01,494383,Mignozzetti; Umberto,35,0,35,0
1715604803919,CSS 202S,A01,494387,Mignozzetti; Umberto,35,0,35,0
1715604804944,DSC 197,001,628532,Eldridge; Justin Matthew,9995,0,9999,4
1715604805968,EAP 100,A00,516065,Staff,9799,0,9999,200
1715604807000,ECE 45,A01,507414,Staff,31,0,60,29
1715604809052,ECE 111,A01,507420,Staff,11,0,50,39
1715604810082,ECE 197,001,548057,Sievenpiper; Daniel F.,9991,0,9999,8
1715604811110,EDS 115,A00,507243,Choi; Bailey Miyeon,7,0,28,21
1715604812137,EDS 117,A01,494379,Staff,0,6,34,34
1715604813163,EDS 125,A00,507246,Hopkins; Megan Beth,8,0,30,22
1715604814194,EDS 128A,A01,507264,Fargason; Sharon Gayle,6,0,26,20
1715604815223,EDS 128B,A01,507293,Pappas; Elizabeth,10,0,30,20
1715604816254,EDS 139,A00,507294,Fargason; Sharon Gayle,10,0,30,20
1715604816254,EDS 139,B00,507313,Pappas; Elizabeth,11,0,30,19
1715604817280,EDS 201,A00,507315,Staff,10,0,30,20
1715604818310,EDS 203,A01,507317,Halter; Christopher P.,10,0,30,20
1715604819343,EDS 204R,A01,507319,Halter; Christopher P.,0,3,30,30
1715604819343,EDS 204R,B01,507331,Heinzman; Erica M.,14,0,30,16
1715604820370,EDS 206R,A00,507332,Staff,0,4,30,30
1715604820370,EDS 206R,B00,507343,Staff,15,0,30,15
1715604821397,EDS 250,A00,507344,Hemans; Patricia Ann Benitez,20,0,40,20
1715604822423,EDS 281,A00,507345,Daly; Alan J.,18,0,18,0
1715604823450,EDS 284,A00,507350,Daly; Alan J.,16,0,16,0
1715604824477,EDS 286,A00,507359,Fine; Sarah,18,0,18,0
1715604825503,EDS 289C,A01,507361,Daly; Alan J.,18,0,18,0
1715604826531,EDS 290,A00,507366,Hofstetter; Carolyn,15,0,15,0
1715604827557,LIGM 5A,A00,507421,Fischer-Grunski; Eva K,17,0,20,3
1715604828585,LIGM 5B,A00,507423,Fischer-Grunski; Eva K,19,0,20,1
1715604829612,LIGM 5C,A00,507425,Fischer-Grunski; Eva K,19,0,20,1
1715604830640,LIIT 5AS,A00,507427,Carnelos; Chiara,20,0,20,0
1715604831671,LIIT 5BS,A00,507430,Carnelos; Chiara,20,0,20,0
1715604832705,LIIT 5CS,A00,507432,Carnelos; Chiara,20,0,20,0
1715604833735,LISP 5A,A00,507541,Munoz Sanchez; Alicia,11,0,20,9
1715604834763,LISP 5B,A00,507671,Munoz Sanchez; Alicia,9,0,20,11
1715604835789,LISP 5C,A00,507696,Munoz Sanchez; Alicia,9,0,20,11
1715604836818,MAE 197,001,528363,Boechler; Nicholas Sebastia,9998,0,9999,1
1715604837849,MATH 197,001,523477,Kedlaya; Kiran S.,9994,0,9999,5
1715604837849,MATH 197,002,563811,Zhang; Danna,9994,0,9999,5
1715604837849,MATH 197,003,628552,Dumitriu; Ioana,9998,0,9999,1
1715604837849,MATH 197,004,660885,Floyd; Eric,9999,0,9999,0
1715604838877,MCWP 40R,A00,518780,Staff,2,0,20,18
1715604838877,MCWP 40R,B00,518781,Staff,11,0,20,9
1715604838877,MCWP 40R,C00,518783,Staff,5,0,20,15
1715604839904,MCWP 50R,A00,518791,Staff,0,1,20,20
1715604839904,MCWP 50R,B00,518792,Staff,0,2,20,20
1715604839904,MCWP 50R,C00,518793,Staff,0,4,20,20
1715604839904,MCWP 50R,D00,518794,Staff,0,1,20,20
1715604839904,MCWP 50R,E00,518795,Staff,0,2,20,20
1715604839904,MCWP 50R,F00,518796,Staff,0,1,20,20
1715604839904,MCWP 50R,G00,518797,Staff,0,1,20,20
1715604840934,MMW 12R,A01,514034,Herbst; Matthew,0,2,16,16
1715604840934,MMW 12R,A02,514035,Herbst; Matthew,0,0,16,16
1715604841963,MMW 13R,A01,514037,Staff,0,5,16,16
1715604841963,MMW 13R,A02,514039,Staff,0,5,16,16
1715604841963,MMW 13R,A03,628519,Staff,0,4,16,16
1715604844020,SIO 295LS,A00,523233,Staff,10,0,30,20
1715604845050,SIO 295S,A00,523232,Staff,10,0,30,20
1715604846077,SIOC 290S,A01,637330,Merrifield; Mark A,23,0,30,7
1715604847111,SIOC 291S,A01,637333,Gabriel; Corey John,23,0,30,7
1715604848140,SOCI 117,A01,494376,Staff,0,5,5,5
1715604849168,WES 237B,A00,494380,Staff,10,0,20,10
1715604851264,AESE 279B,A00,494370,Wade; Jon P,0,0,33,33
1715604852289,AIP 97,001,660915,Van Den Einde; Yael Dahlia,9999,0,9999,0
1715604853319,AIP 197,001,627712,Vespa; Emanuel Ignacio,9995,0,9999,4
1715604853319,AIP 197,002,650778,Amir; On,9998,0,9999,1
1715604853319,AIP 197,003,650933,Avenancio-Leon; Carlos,9998,0,9999,1
1715604853319,AIP 197,004,658530,Heyman; Gail D.,9998,0,9999,1
1715604853319,AIP 197,005,658631,Neal; Sonya E,9998,0,9999,1
1715604853319,AIP 197,006,658671,Du; Songzi,9998,0,9999,1
1715604854349,ANAR 135S,A00,494369,Braswell; Geoffrey E.,0,0,0,0
1715604855379,BENG 196,001,628496,Engler; Adam J.,9998,0,9999,1
1715604855379,BENG 196,002,660916,Watson; John Thomas,9999,0,9999,0
1715604856404,BISP 197,001,650773,Wilhelm; James E.,9994,0,9999,5
1715604856404,BISP 197,002,658904,Coleman; Aaron B.,9998,0,9999,1
1715604857434,CAT 124RS,A01,519847,Geibel; William,0,0,20,20
1715604858461,CAT 125RS,A01,515971,Geibel; William,0,0,20,20
1715604859487,CLRE 250,A00,511389,Morris; Sheldon,9992,0,9999,7
1715604860514,CLRE 251,A00,507176,Mehta; Ravindra L.,9992,0,9999,7
1715604860514,CLRE 251,B00,511410,Mehta; Ravindra L.,9998,0,9999,1
1715604861543,CLRE 252,A00,507189,Cuomo; Raphael Eduardo,9994,0,9999,5
1715604862569,CLRE 253,A00,507199,Vaida; Florin,9994,0,9999,5
1715604862569,CLRE 253,B00,507202,Vaida; Florin,9999,0,9999,0
1715604863596,CLRE 259,A00,507211,Patel; Hemal,9996,0,9999,3
1715604864621,CLRE 260,A00,507221,Cuomo; Raphael Eduardo,9999,0,9999,0
1715604865646,CLRE 297,001,507242,Cuomo; Raphael Eduardo,9999,0,9999,0
1715604866676,COGS 197,001,638244,Voytek; Bradley Thomas,9997,0,9999,2
1715604867706,CSE 191,A00,516875,Minnes Kemp; Mor Mia,9991,0,9999,8
1715604868735,CSE 197,001,637388,Minnes Kemp; Mor Mia,9992,0,9999,7
1715604869768,CSS 201S,A01,494383,Mignozzetti; Umberto,35,0,35,0
1715604870795,CSS 202S,A01,494387,Mignozzetti; Umberto,35,0,35,0
1715604871821,DSC 197,001,628532,Eldridge; Justin Matthew,9995,0,9999,4
1715604872847,EAP 100,A00,516065,Staff,9799,0,9999,200
1715604873874,ECE 45,A01,507414,Staff,31,0,60,29
1715604875933,ECE 111,A01,507420,Staff,11,0,50,39
1715604876961,ECE 197,001,548057,Sievenpiper; Daniel F.,9991,0,9999,8
1715604877988,EDS 115,A00,507243,Choi; Bailey Miyeon,7,0,28,21
1715604879015,EDS 117,A01,494379,Staff,0,6,34,34
1715604880041,EDS 125,A00,507246,Hopkins; Megan Beth,8,0,30,22
1715604881067,EDS 128A,A01,507264,Fargason; Sharon Gayle,6,0,26,20
1715604882095,EDS 128B,A01,507293,Pappas; Elizabeth,10,0,30,20
1715604883122,EDS 139,A00,507294,Fargason; Sharon Gayle,10,0,30,20
1715604883122,EDS 139,B00,507313,Pappas; Elizabeth,11,0,30,19
1715604884148,EDS 201,A00,507315,Staff,10,0,30,20
1715604885176,EDS 203,A01,507317,Halter; Christopher P.,10,0,30,20
1715604886204,EDS 204R,A01,507319,Halter; Christopher P.,0,3,30,30
1715604886204,EDS 204R,B01,507331,Heinzman; Erica M.,14,0,30,16
1715604887231,EDS 206R,A00,507332,Staff,0,4,30,30
1715604887231,EDS 206R,B00,507343,Staff,15,0,30,15
1715604888259,EDS 250,A00,507344,Hemans; Patricia Ann Benitez,20,0,40,20
1715604889288,EDS 281,A00,507345,Daly; Alan J.,18,0,18,0
1715604890312,EDS 284,A00,507350,Daly; Alan J.,16,0,16,0
1715604891340,EDS 286,A00,507359,Fine; Sarah,18,0,18,0
1715604892366,EDS 289C,A01,507361,Daly; Alan J.,18,0,18,0
1715604893391,EDS 290,A00,507366,Hofstetter; Carolyn,15,0,15,0
1715604894418,LIGM 5A,A00,507421,Fischer-Grunski; Eva K,17,0,20,3
1715604895444,LIGM 5B,A00,507423,Fischer-Grunski; Eva K,19,0,20,1
1715604896473,LIGM 5C,A00,507425,Fischer-Grunski; Eva K,19,0,20,1
1715604897501,LIIT 5AS,A00,507427,Carnelos; Chiara,20,0,20,0
1715604898526,LIIT 5BS,A00,507430,Carnelos; Chiara,20,0,20,0
1715604899555,LIIT 5CS,A00,507432,Carnelos; Chiara,20,0,20,0
1715604900582,LISP 5A,A00,507541,Munoz Sanchez; Alicia,11,0,20,9
1715604901609,LISP 5B,A00,507671,Munoz Sanchez; Alicia,9,0,20,11
1715604902638,LISP 5C,A00,507696,Munoz Sanchez; Alicia,9,0,20,11
1715604903664,MAE 197,001,528363,Boechler; Nicholas Sebastia,9998,0,9999,1
1715604904694,MATH 197,001,523477,Kedlaya; Kiran S.,9994,0,9999,5
1715604904694,MATH 197,002,563811,Zhang; Danna,9994,0,9999,5
1715604904694,MATH 197,003,628552,Dumitriu; Ioana,9998,0,9999,1
1715604904694,MATH 197,004,660885,Floyd; Eric,9999,0,9999,0
1715604905720,MCWP 40R,A00,518780,Staff,2,0,20,18
1715604905720,MCWP 40R,B00,518781,Staff,11,0,20,9
1715604905720,MCWP 40R,C00,518783,Staff,5,0,20,15
1715604906749,MCWP 50R,A00,518791,Staff,0,1,20,20
1715604906749,MCWP 50R,B00,518792,Staff,0,2,20,20
1715604906749,MCWP 50R,C00,518793,Staff,0,4,20,20
1715604906749,MCWP 50R,D00,518794,Staff,0,1,20,20
1715604906749,MCWP 50R,E00,518795,Staff,0,2,20,20
1715604906749,MCWP 50R,F00,518796,Staff,0,1,20,20
1715604906749,MCWP 50R,G00,518797,Staff,0,1,20,20
1715604907777,MMW 12R,A01,514034,Herbst; Matthew,0,2,16,16
1715604907777,MMW 12R,A02,514035,Herbst; Matthew,0,0,16,16
1715604908805,MMW 13R,A01,514037,Staff,0,5,16,16
1715604908805,MMW 13R,A02,514039,Staff,0,5,16,16
1715604908805,MMW 13R,A03,628519,Staff,0,4,16,16
1715604910858,SIO 295LS,A00,523233,Staff,10,0,30,20
1715604911886,SIO 295S,A00,523232,Staff,10,0,30,20
1715604912919,SIOC 290S,A01,637330,Merrifield; Mark A,23,0,30,7
1715604913946,SIOC 291S,A01,637333,Gabriel; Corey John,23,0,30,7
1715604914972,SOCI 117,A01,494376,Staff,0,5,5,5
1715604915999,WES 237B,A00,494380,Staff,10,0,20,10
1715604918087,AESE 279B,A00,494370,Wade; Jon P,0,0,33,33
1715604919113,AIP 97,001,660915,Van Den Einde; Yael Dahlia,9999,0,9999,0
1715604920143,AIP 197,001,627712,Vespa; Emanuel Ignacio,9995,0,9999,4
1715604920143,AIP 197,002,650778,Amir; On,9998,0,9999,1
1715604920143,AIP 197,003,650933,Avenancio-Leon; Carlos,9998,0,9999,1
1715604920143,AIP 197,004,658530,Heyman; Gail D.,9998,0,9999,1
1715604920143,AIP 197,005,658631,Neal; Sonya E,9998,0,9999,1
1715604920143,AIP 197,006,658671,Du; Songzi,9998,0,9999,1
1715604921170,ANAR 135S,A00,494369,Braswell; Geoffrey E.,0,0,0,0
1715604922198,BENG 196,001,628496,Engler; Adam J.,9998,0,9999,1
1715604922198,BENG 196,002,660916,Watson; John Thomas,9999,0,9999,0
1715604923229,BISP 197,001,650773,Wilhelm; James E.,9994,0,9999,5
1715604923229,BISP 197,002,658904,Coleman; Aaron B.,9998,0,9999,1
1715604924259,CAT 124RS,A01,519847,Geibel; William,0,0,20,20
1715604925285,CAT 125RS,A01,515971,Geibel; William,0,0,20,20
1715604926314,CLRE 250,A00,511389,Morris; Sheldon,9992,0,9999,7
1715604927341,CLRE 251,A00,507176,Mehta; Ravindra L.,9992,0,9999,7
1715604927341,CLRE 251,B00,511410,Mehta; Ravindra L.,9998,0,9999,1
1715604928366,CLRE 252,A00,507189,Cuomo; Raphael Eduardo,9994,0,9999,5
1715604929391,CLRE 253,A00,507199,Vaida; Florin,9994,0,9999,5
1715604929391,CLRE 253,B00,507202,Vaida; Florin,9999,0,9999,0
1715604930417,CLRE 259,A00,507211,Patel; Hemal,9996,0,9999,3
1715604931446,CLRE 260,A00,507221,Cuomo; Raphael Eduardo,9999,0,9999,0
1715604932472,CLRE 297,001,507242,Cuomo; Raphael Eduardo,9999,0,9999,0
1715604933500,COGS 197,001,638244,Voytek; Bradley Thomas,9997,0,9999,2
1715604934524,CSE 191,A00,516875,Minnes Kemp; Mor Mia,9991,0,9999,8
1715604935551,CSE 197,001,637388,Minnes Kemp; Mor Mia,9992,0,9999,7
1715604936582,CSS 201S,A01,494383,Mignozzetti; Umberto,35,0,35,0
1715604937612,CSS 202S,A01,494387,Mignozzetti; Umberto,35,0,35,0
1715604938637,DSC 197,001,628532,Eldridge; Justin Matthew,9995,0,9999,4
1715604939663,EAP 100,A00,516065,Staff,9799,0,9999,200
1715604940696,ECE 45,A01,507414,Staff,31,0,60,29
1715604942753,ECE 111,A01,507420,Staff,11,0,50,39
1715604943781,ECE 197,001,548057,Sievenpiper; Daniel F.,9991,0,9999,8
1715604944807,EDS 115,A00,507243,Choi; Bailey Miyeon,7,0,28,21
1715604945839,EDS 117,A01,494379,Staff,0,6,34,34
1715604946866,EDS 125,A00,507246,Hopkins; Megan Beth,8,0,30,22
1715604947893,EDS 128A,A01,507264,Fargason; Sharon Gayle,6,0,26,20
1715604948919,EDS 128B,A01,507293,Pappas; Elizabeth,10,0,30,20
1715604949947,EDS 139,A00,507294,Fargason; Sharon Gayle,10,0,30,20
1715604949947,EDS 139,B00,507313,Pappas; Elizabeth,11,0,30,19
1715604950973,EDS 201,A00,507315,Staff,10,0,30,20
1715604952004,EDS 203,A01,507317,Halter; Christopher P.,10,0,30,20
1715604953034,EDS 204R,A01,507319,Halter; Christopher P.,0,3,30,30
1715604953034,EDS 204R,B01,507331,Heinzman; Erica M.,14,0,30,16
1715604954059,EDS 206R,A00,507332,Staff,0,4,30,30
1715604954059,EDS 206R,B00,507343,Staff,15,0,30,15
1715604955085,EDS 250,A00,507344,Hemans; Patricia Ann Benitez,20,0,40,20
1715604956111,EDS 281,A00,507345,Daly; Alan J.,18,0,18,0
1715604957135,EDS 284,A00,507350,Daly; Alan J.,16,0,16,0
1715604958161,EDS 286,A00,507359,Fine; Sarah,18,0,18,0
1715604959187,EDS 289C,A01,507361,Daly; Alan J.,18,0,18,0
1715604960213,EDS 290,A00,507366,Hofstetter; Carolyn,15,0,15,0
1715604961241,LIGM 5A,A00,507421,Fischer-Grunski; Eva K,17,0,20,3
1715604962271,LIGM 5B,A00,507423,Fischer-Grunski; Eva K,19,0,20,1
1715604963302,LIGM 5C,A00,507425,Fischer-Grunski; Eva K,19,0,20,1
1715604964329,LIIT 5AS,A00,507427,Carnelos; Chiara,20,0,20,0
1715604965358,LIIT 5BS,A00,507430,Carnelos; Chiara,20,0,20,0
1715604966385,LIIT 5CS,A00,507432,Carnelos; Chiara,20,0,20,0
1715604967411,LISP 5A,A00,507541,Munoz Sanchez; Alicia,11,0,20,9
1715604968437,LISP 5B,A00,507671,Munoz Sanchez; Alicia,9,0,20,11
1715604969463,LISP 5C,A00,507696,Munoz Sanchez; Alicia,9,0,20,11
1715604970492,MAE 197,001,528363,Boechler; Nicholas Sebastia,9998,0,9999,1
1715604971527,MATH 197,001,523477,Kedlaya; Kiran S.,9994,0,9999,5
1715604971527,MATH 197,002,563811,Zhang; Danna,9994,0,9999,5
1715604971527,MATH 197,003,628552,Dumitriu; Ioana,9998,0,9999,1
1715604971527,MATH 197,004,660885,Floyd; Eric,9999,0,9999,0
1715604972553,MCWP 40R,A00,518780,Staff,2,0,20,18
1715604972553,MCWP 40R,B00,518781,Staff,11,0,20,9
1715604972553,MCWP 40R,C00,518783,Staff,5,0,20,15
1715604973581,MCWP 50R,A00,518791,Staff,0,1,20,20
1715604973581,MCWP 50R,B00,518792,Staff,0,2,20,20
1715604973581,MCWP 50R,C00,518793,Staff,0,4,20,20
1715604973581,MCWP 50R,D00,518794,Staff,0,1,20,20
1715604973581,MCWP 50R,E00,518795,Staff,0,2,20,20
1715604973581,MCWP 50R,F00,518796,Staff,0,1,20,20
1715604973581,MCWP 50R,G00,518797,Staff,0,1,20,20
1715604974607,MMW 12R,A01,514034,Herbst; Matthew,0,2,16,16
1715604974607,MMW 12R,A02,514035,Herbst; Matthew,0,0,16,16
1715604975635,MMW 13R,A01,514037,Staff,0,5,16,16
1715604975635,MMW 13R,A02,514039,Staff,0,5,16,16
1715604975635,MMW 13R,A03,628519,Staff,0,4,16,16
1715604977687,SIO 295LS,A00,523233,Staff,10,0,30,20
1715604978715,SIO 295S,A00,523232,Staff,10,0,30,20
1715604979746,SIOC 290S,A01,637330,Merrifield; Mark A,23,0,30,7
1715604980773,SIOC 291S,A01,637333,Gabriel; Corey John,23,0,30,7
1715604981800,SOCI 117,A01,494376,Staff,0,5,5,5
1715604982831,WES 237B,A00,494380,Staff,10,0,20,10
1715604984904,AESE 279B,A00,494370,Wade; Jon P,0,0,33,33
1715604985931,AIP 97,001,660915,Van Den Einde; Yael Dahlia,9999,0,9999,0
1715604986960,AIP 197,001,627712,Vespa; Emanuel Ignacio,9995,0,9999,4
1715604986960,AIP 197,002,650778,Amir; On,9998,0,9999,1
1715604986960,AIP 197,003,650933,Avenancio-Leon; Carlos,9998,0,9999,1
1715604986960,AIP 197,004,658530,Heyman; Gail D.,9998,0,9999,1
1715604986960,AIP 197,005,658631,Neal; Sonya E,9998,0,9999,1
1715604986960,AIP 197,006,658671,Du; Songzi,9998,0,9999,1
1715604987987,ANAR 135S,A00,494369,Braswell; Geoffrey E.,0,0,0,0
1715604989013,BENG 196,001,628496,Engler; Adam J.,9998,0,9999,1
1715604989013,BENG 196,002,660916,Watson; John Thomas,9999,0,9999,0
1715604990041,BISP 197,001,650773,Wilhelm; James E.,9994,0,9999,5
1715604990041,BISP 197,002,658904,Coleman; Aaron B.,9998,0,9999,1
1715604991068,CAT 124RS,A01,519847,Geibel; William,0,0,20,20
1715604992093,CAT 125RS,A01,515971,Geibel; William,0,0,20,20
1715604993125,CLRE 250,A00,511389,Morris; Sheldon,9992,0,9999,7
1715604994153,CLRE 251,A00,507176,Mehta; Ravindra L.,9992,0,9999,7
1715604994153,CLRE 251,B00,511410,Mehta; Ravindra L.,9998,0,9999,1
1715604995183,CLRE 252,A00,507189,Cuomo; Raphael Eduardo,9994,0,9999,5
1715604996213,CLRE 253,A00,507199,Vaida; Florin,9994,0,9999,5
1715604996213,CLRE 253,B00,507202,Vaida; Florin,9999,0,9999,0
1715604997238,CLRE 259,A00,507211,Patel; Hemal,9996,0,9999,3
1715604998266,CLRE 260,A00,507221,Cuomo; Raphael Eduardo,9999,0,9999,0
1715604999295,CLRE 297,001,507242,Cuomo; Raphael Eduardo,9999,0,9999,0
1715605000322,COGS 197,001,638244,Voytek; Bradley Thomas,9997,0,9999,2
1715605001347,CSE 191,A00,516875,Minnes Kemp; Mor Mia,9991,0,9999,8
1715605002376,CSE 197,001,637388,Minnes Kemp; Mor Mia,9992,0,9999,7
1715605003406,CSS 201S,A01,494383,Mignozzetti; Umberto,35,0,35,0
1715605004432,CSS 202S,A01,494387,Mignozzetti; Umberto,35,0,35,0
1715605005458,DSC 197,001,628532,Eldridge; Justin Matthew,9995,0,9999,4
1715605006489,EAP 100,A00,516065,Staff,9799,0,9999,200
1715605007521,ECE 45,A01,507414,Staff,31,0,60,29
1715605009577,ECE 111,A01,507420,Staff,11,0,50,39
1715605010607,ECE 197,001,548057,Sievenpiper; Daniel F.,9991,0,9999,8
1715605011638,EDS 115,A00,507243,Choi; Bailey Miyeon,7,0,28,21
1715605012667,EDS 117,A01,494379,Staff,0,6,34,34
1715605013696,EDS 125,A00,507246,Hopkins; Megan Beth,8,0,30,22
1715605014722,EDS 128A,A01,507264,Fargason; Sharon Gayle,6,0,26,20
1715605015752,EDS 128B,A01,507293,Pappas; Elizabeth,10,0,30,20
1715605016781,EDS 139,A00,507294,Fargason; Sharon Gayle,10,0,30,20
1715605016781,EDS 139,B00,507313,Pappas; Elizabeth,11,0,30,19
1715605017806,EDS 201,A00,507315,Staff,10,0,30,20
1715605018832,EDS 203,A01,507317,Halter; Christopher P.,10,0,30,20
1715605019859,EDS 204R,A01,507319,Halter; Christopher P.,0,3,30,30
1715605019859,EDS 204R,B01,507331,Heinzman; Erica M.,14,0,30,16
1715605020886,EDS 206R,A00,507332,Staff,0,4,30,30
1715605020886,EDS 206R,B00,507343,Staff,15,0,30,15
1715605021913,EDS 250,A00,507344,Hemans; Patricia Ann Benitez,20,0,40,20
1715605022944,EDS 281,A00,507345,Daly; Alan J.,18,0,18,0
1715605023970,EDS 284,A00,507350,Daly; Alan J.,16,0,16,0
1715605024998,EDS 286,A00,507359,Fine; Sarah,18,0,18,0
1715605026023,EDS 289C,A01,507361,Daly; Alan J.,18,0,18,0
1715605027049,EDS 290,A00,507366,Hofstetter; Carolyn,15,0,15,0
1715605028077,LIGM 5A,A00,507421,Fischer-Grunski; Eva K,17,0,20,3
1715605029102,LIGM 5B,A00,507423,Fischer-Grunski; Eva K,19,0,20,1
1715605030132,LIGM 5C,A00,507425,Fischer-Grunski; Eva K,19,0,20,1
1715605031161,LIIT 5AS,A00,507427,Carnelos; Chiara,20,0,20,0
1715605032189,LIIT 5BS,A00,507430,Carnelos; Chiara,20,0,20,0
1715605033220,LIIT 5CS,A00,507432,Carnelos; Chiara,20,0,20,0
1715605034251,LISP 5A,A00,507541,Munoz Sanchez; Alicia,11,0,20,9
1715605035275,LISP 5B,A00,507671,Munoz Sanchez; Alicia,9,0,20,11
1715605036304,LISP 5C,A00,507696,Munoz Sanchez; Alicia,9,0,20,11
1715605037330,MAE 197,001,528363,Boechler; Nicholas Sebastia,9998,0,9999,1
1715605038358,MATH 197,001,523477,Kedlaya; Kiran S.,9994,0,9999,5
1715605038358,MATH 197,002,563811,Zhang; Danna,9994,0,9999,5
1715605038358,MATH 197,003,628552,Dumitriu; Ioana,9998,0,9999,1
1715605038358,MATH 197,004,660885,Floyd; Eric,9999,0,9999,0
1715605039387,MCWP 40R,A00,518780,Staff,2,0,20,18
1715605039387,MCWP 40R,B00,518781,Staff,11,0,20,9
1715605039387,MCWP 40R,C00,518783,Staff,5,0,20,15
1715605040415,MCWP 50R,A00,518791,Staff,0,1,20,20
1715605040415,MCWP 50R,B00,518792,Staff,0,2,20,20
1715605040415,MCWP 50R,C00,518793,Staff,0,4,20,20
1715605040415,MCWP 50R,D00,518794,Staff,0,1,20,20
1715605040415,MCWP 50R,E00,518795,Staff,0,2,20,20
1715605040415,MCWP 50R,F00,518796,Staff,0,1,20,20
1715605040415,MCWP 50R,G00,518797,Staff,0,1,20,20
1715605041444,MMW 12R,A01,514034,Herbst; Matthew,0,2,16,16
1715605041444,MMW 12R,A02,514035,Herbst; Matthew,0,0,16,16
1715605042470,MMW 13R,A01,514037,Staff,0,5,16,16
1715605042470,MMW 13R,A02,514039,Staff,0,5,16,16
1715605042470,MMW 13R,A03,628519,Staff,0,4,16,16
1715605044520,SIO 295LS,A00,523233,Staff,10,0,30,20
1715605045548,SIO 295S,A00,523232,Staff,10,0,30,20
1715605046576,SIOC 290S,A01,637330,Merrifield; Mark A,23,0,30,7
1715605047607,SIOC 291S,A01,637333,Gabriel; Corey John,23,0,30,7
1715605048632,SOCI 117,A01,494376,Staff,0,5,5,5
1715605049660,WES 237B,A00,494380,Staff,10,0,20,10
1715605051737,AESE 279B,A00,494370,Wade; Jon P,0,0,33,33
1715605052766,AIP 97,001,660915,Van Den Einde; Yael Dahlia,9999,0,9999,0
1715605053798,AIP 197,001,627712,Vespa; Emanuel Ignacio,9995,0,9999,4
1715605053798,AIP 197,002,650778,Amir; On,9998,0,9999,1
1715605053798,AIP 197,003,650933,Avenancio-Leon; Carlos,9998,0,9999,1
1715605053798,AIP 197,004,658530,Heyman; Gail D.,9998,0,9999,1
1715605053798,AIP 197,005,658631,Neal; Sonya E,9998,0,9999,1
1715605053798,AIP 197,006,658671,Du; Songzi,9998,0,9999,1
1715605054824,ANAR 135S,A00,494369,Braswell; Geoffrey E.,0,0,0,0
1715605055852,BENG 196,001,628496,Engler; Adam J.,9998,0,9999,1
1715605055852,BENG 196,002,660916,Watson; John Thomas,9999,0,9999,0
1715605056883,BISP 197,001,650773,Wilhelm; James E.,9994,0,9999,5
1715605056883,BISP 197,002,658904,Coleman; Aaron B.,9998,0,9999,1
1715605057909,CAT 124RS,A01,519847,Geibel; William,0,0,20,20
1715605058938,CAT 125RS,A01,515971,Geibel; William,0,0,20,20
1715605059966,CLRE 250,A00,511389,Morris; Sheldon,9992,0,9999,7
1715605060995,CLRE 251,A00,507176,Mehta; Ravindra L.,9992,0,9999,7
1715605060995,CLRE 251,B00,511410,Mehta; Ravindra L.,9998,0,9999,1
1715605062023,CLRE 252,A00,507189,Cuomo; Raphael Eduardo,9994,0,9999,5
1715605063050,CLRE 253,A00,507199,Vaida; Florin,9994,0,9999,5
1715605063050,CLRE 253,B00,507202,Vaida; Florin,9999,0,9999,0
1715605064081,CLRE 259,A00,507211,Patel; Hemal,9996,0,9999,3
1715605065108,CLRE 260,A00,507221,Cuomo; Raphael Eduardo,9999,0,9999,0
1715605066136,CLRE 297,001,507242,Cuomo; Raphael Eduardo,9999,0,9999,0
1715605067163,COGS 197,001,638244,Voytek; Bradley Thomas,9997,0,9999,2
1715605068190,CSE 191,A00,516875,Minnes Kemp; Mor Mia,9991,0,9999,8
1715605069218,CSE 197,001,637388,Minnes Kemp; Mor Mia,9992,0,9999,7
1715605070244,CSS 201S,A01,494383,Mignozzetti; Umberto,35,0,35,0
1715605071271,CSS 202S,A01,494387,Mignozzetti; Umberto,35,0,35,0
1715605072299,DSC 197,001,628532,Eldridge; Justin Matthew,9995,0,9999,4
1715605073323,EAP 100,A00,516065,Staff,9799,0,9999,200
1715605074352,ECE 45,A01,507414,Staff,31,0,60,29
1715605076404,ECE 111,A01,507420,Staff,11,0,50,39
1715605077431,ECE 197,001,548057,Sievenpiper; Daniel F.,9991,0,9999,8
1715605078460,EDS 115,A00,507243,Choi; Bailey Miyeon,7,0,28,21
1715605079488,EDS 117,A01,494379,Staff,0,6,34,34
1715605080513,EDS 125,A00,507246,Hopkins; Megan Beth,8,0,30,22
1715605081540,EDS 128A,A01,507264,Fargason; Sharon Gayle,6,0,26,20
1715605082566,EDS 128B,A01,507293,Pappas; Elizabeth,10,0,30,20
1715605083594,EDS 139,A00,507294,Fargason; Sharon Gayle,10,0,30,20
1715605083594,EDS 139,B00,507313,Pappas; Elizabeth,11,0,30,19
1715605084621,EDS 201,A00,507315,Staff,10,0,30,20
1715605085649,EDS 203,A01,507317,Halter; Christopher P.,10,0,30,20
1715605086677,EDS 204R,A01,507319,Halter; Christopher P.,0,3,30,30
1715605086677,EDS 204R,B01,507331,Heinzman; Erica M.,14,0,30,16
1715605087706,EDS 206R,A00,507332,Staff,0,4,30,30
1715605087706,EDS 206R,B00,507343,Staff,15,0,30,15
1715605088730,EDS 250,A00,507344,Hemans; Patricia Ann Benitez,20,0,40,20
1715605089757,EDS 281,A00,507345,Daly; Alan J.,18,0,18,0
1715605090782,EDS 284,A00,507350,Daly; Alan J.,16,0,16,0
1715605091810,EDS 286,A00,507359,Fine; Sarah,18,0,18,0
1715605092837,EDS 289C,A01,507361,Daly; Alan J.,18,0,18,0
1715605093866,EDS 290,A00,507366,Hofstetter; Carolyn,15,0,15,0
1715605094891,LIGM 5A,A00,507421,Fischer-Grunski; Eva K,17,0,20,3
1715605095917,LIGM 5B,A00,507423,Fischer-Grunski; Eva K,19,0,20,1
1715605096945,LIGM 5C,A00,507425,Fischer-Grunski; Eva K,19,0,20,1
1715605097972,LIIT 5AS,A00,507427,Carnelos; Chiara,20,0,20,0
1715605099000,LIIT 5BS,A00,507430,Carnelos; Chiara,20,0,20,0
1715605100030,LIIT 5CS,A00,507432,Carnelos; Chiara,20,0,20,0
1715605101055,LISP 5A,A00,507541,Munoz Sanchez; Alicia,11,0,20,9
1715605102082,LISP 5B,A00,507671,Munoz Sanchez; Alicia,9,0,20,11
1715605103113,LISP 5C,A00,507696,Munoz Sanchez; Alicia,9,0,20,11
1715605104141,MAE 197,001,528363,Boechler; Nicholas Sebastia,9998,0,9999,1
1715605105177,MATH 197,001,523477,Kedlaya; Kiran S.,9994,0,9999,5
1715605105177,MATH 197,002,563811,Zhang; Danna,9994,0,9999,5
1715605105177,MATH 197,003,628552,Dumitriu; Ioana,9998,0,9999,1
1715605105177,MATH 197,004,660885,Floyd; Eric,9999,0,9999,0
1715605106204,MCWP 40R,A00,518780,Staff,2,0,20,18
1715605106204,MCWP 40R,B00,518781,Staff,11,0,20,9
1715605106204,MCWP 40R,C00,518783,Staff,5,0,20,15
1715605107230,MCWP 50R,A00,518791,Staff,0,1,20,20
1715605107230,MCWP 50R,B00,518792,Staff,0,2,20,20
1715605107230,MCWP 50R,C00,518793,Staff,0,4,20,20
1715605107230,MCWP 50R,D00,518794,Staff,0,1,20,20
1715605107230,MCWP 50R,E00,518795,Staff,0,2,20,20
1715605107230,MCWP 50R,F00,518796,Staff,0,1,20,20
1715605107230,MCWP 50R,G00,518797,Staff,0,1,20,20
1715605108255,MMW 12R,A01,514034,Herbst; Matthew,0,2,16,16
1715605108255,MMW 12R,A02,514035,Herbst; Matthew,0,0,16,16
1715605109283,MMW 13R,A01,514037,Staff,0,5,16,16
1715605109283,MMW 13R,A02,514039,Staff,0,5,16,16
1715605109283,MMW 13R,A03,628519,Staff,0,4,16,16
1715605111344,SIO 295LS,A00,523233,Staff,10,0,30,20
1715605112374,SIO 295S,A00,523232,Staff,10,0,30,20
1715605113403,SIOC 290S,A01,637330,Merrifield; Mark A,23,0,30,7
1715605114433,SIOC 291S,A01,637333,Gabriel; Corey John,23,0,30,7
1715605115460,SOCI 117,A01,494376,Staff,0,5,5,5
1715605116489,WES 237B,A00,494380,Staff,10,0,20,10
1715605118578,AESE 279B,A00,494370,Wade; Jon P,0,0,33,33
1715605119604,AIP 97,001,660915,Van Den Einde; Yael Dahlia,9999,0,9999,0
1715605120634,AIP 197,001,627712,Vespa; Emanuel Ignacio,9995,0,9999,4
1715605120634,AIP 197,002,650778,Amir; On,9998,0,9999,1
1715605120634,AIP 197,003,650933,Avenancio-Leon; Carlos,9998,0,9999,1
1715605120634,AIP 197,004,658530,Heyman; Gail D.,9998,0,9999,1
1715605120634,AIP 197,005,658631,Neal; Sonya E,9998,0,9999,1
1715605120634,AIP 197,006,658671,Du; Songzi,9998,0,9999,1
1715605121661,ANAR 135S,A00,494369,Braswell; Geoffrey E.,0,0,0,0
1715605122691,BENG 196,001,628496,Engler; Adam J.,9998,0,9999,1
1715605122691,BENG 196,002,660916,Watson; John Thomas,9999,0,9999,0
1715605123722,BISP 197,001,650773,Wilhelm; James E.,9994,0,9999,5
1715605123722,BISP 197,002,658904,Coleman; Aaron B.,9998,0,9999,1
1715605124747,CAT 124RS,A01,519847,Geibel; William,0,0,20,20
1715605125773,CAT 125RS,A01,515971,Geibel; William,0,0,20,20
1715605126801,CLRE 250,A00,511389,Morris; Sheldon,9992,0,9999,7
1715605127832,CLRE 251,A00,507176,Mehta; Ravindra L.,9992,0,9999,7
1715605127832,CLRE 251,B00,511410,Mehta; Ravindra L.,9998,0,9999,1
1715605128860,CLRE 252,A00,507189,Cuomo; Raphael Eduardo,9994,0,9999,5
1715605129891,CLRE 253,A00,507199,Vaida; Florin,9994,0,9999,5
1715605129891,CLRE 253,B00,507202,Vaida; Florin,9999,0,9999,0
1715605130918,CLRE 259,A00,507211,Patel; Hemal,9996,0,9999,3
1715605131952,CLRE 260,A00,507221,Cuomo; Raphael Eduardo,9999,0,9999,0
1715605132977,CLRE 297,001,507242,Cuomo; Raphael Eduardo,9999,0,9999,0
1715605134003,COGS 197,001,638244,Voytek; Bradley Thomas,9997,0,9999,2
1715605135030,CSE 191,A00,516875,Minnes Kemp; Mor Mia,9991,0,9999,8
1715605136056,CSE 197,001,637388,Minnes Kemp; Mor Mia,9992,0,9999,7
1715605137084,CSS 201S,A01,494383,Mignozzetti; Umberto,35,0,35,0
1715605138118,CSS 202S,A01,494387,Mignozzetti; Umberto,35,0,35,0
1715605139144,DSC 197,001,628532,Eldridge; Justin Matthew,9995,0,9999,4
1715605140170,EAP 100,A00,516065,Staff,9799,0,9999,200
1715605141198,ECE 45,A01,507414,Staff,31,0,60,29
1715605143253,ECE 111,A01,507420,Staff,11,0,50,39
1715605144280,ECE 197,001,548057,Sievenpiper; Daniel F.,9991,0,9999,8
1715605145313,EDS 115,A00,507243,Choi; Bailey Miyeon,7,0,28,21
1715605146340,EDS 117,A01,494379,Staff,0,6,34,34
1715605147368,EDS 125,A00,507246,Hopkins; Megan Beth,8,0,30,22
1715605148396,EDS 128A,A01,507264,Fargason; Sharon Gayle,6,0,26,20
1715605149421,EDS 128B,A01,507293,Pappas; Elizabeth,10,0,30,20
1715605150448,EDS 139,A00,507294,Fargason; Sharon Gayle,10,0,30,20
1715605150448,EDS 139,B00,507313,Pappas; Elizabeth,11,0,30,19
1715605151478,EDS 201,A00,507315,Staff,10,0,30,20
1715605152506,EDS 203,A01,507317,Halter; Christopher P.,10,0,30,20
1715605153532,EDS 204R,A01,507319,Halter; Christopher P.,0,3,30,30
1715605153532,EDS 204R,B01,507331,Heinzman; Erica M.,14,0,30,16
1715605154557,EDS 206R,A00,507332,Staff,0,4,30,30
1715605154557,EDS 206R,B00,507343,Staff,15,0,30,15
1715605155583,EDS 250,A00,507344,Hemans; Patricia Ann Benitez,20,0,40,20
1715605156613,EDS 281,A00,507345,Daly; Alan J.,18,0,18,0
1715605157641,EDS 284,A00,507350,Daly; Alan J.,16,0,16,0
1715605158671,EDS 286,A00,507359,Fine; Sarah,18,0,18,0
1715605159698,EDS 289C,A01,507361,Daly; Alan J.,18,0,18,0
1715605160725,EDS 290,A00,507366,Hofstetter; Carolyn,15,0,15,0
1715605161757,LIGM 5A,A00,507421,Fischer-Grunski; Eva K,17,0,20,3
1715605162785,LIGM 5B,A00,507423,Fischer-Grunski; Eva K,19,0,20,1
1715605163811,LIGM 5C,A00,507425,Fischer-Grunski; Eva K,19,0,20,1
1715605164840,LIIT 5AS,A00,507427,Carnelos; Chiara,20,0,20,0
1715605165867,LIIT 5BS,A00,507430,Carnelos; Chiara,20,0,20,0
1715605166896,LIIT 5CS,A00,507432,Carnelos; Chiara,20,0,20,0
1715605167922,LISP 5A,A00,507541,Munoz Sanchez; Alicia,11,0,20,9
1715605168948,LISP 5B,A00,507671,Munoz Sanchez; Alicia,9,0,20,11
1715605169978,LISP 5C,A00,507696,Munoz Sanchez; Alicia,9,0,20,11
1715605171007,MAE 197,001,528363,Boechler; Nicholas Sebastia,9998,0,9999,1
1715605172041,MATH 197,001,523477,Kedlaya; Kiran S.,9994,0,9999,5
1715605172041,MATH 197,002,563811,Zhang; Danna,9994,0,9999,5
1715605172041,MATH 197,003,628552,Dumitriu; Ioana,9998,0,9999,1
1715605172041,MATH 197,004,660885,Floyd; Eric,9999,0,9999,0
1715605173072,MCWP 40R,A00,518780,Staff,2,0,20,18
1715605173072,MCWP 40R,B00,518781,Staff,11,0,20,9
1715605173072,MCWP 40R,C00,518783,Staff,5,0,20,15
1715605174099,MCWP 50R,A00,518791,Staff,0,1,20,20
1715605174099,MCWP 50R,B00,518792,Staff,0,2,20,20
1715605174099,MCWP 50R,C00,518793,Staff,0,4,20,20
1715605174099,MCWP 50R,D00,518794,Staff,0,1,20,20
1715605174099,MCWP 50R,E00,518795,Staff,0,2,20,20
1715605174099,MCWP 50R,F00,518796,Staff,0,1,20,20
1715605174099,MCWP 50R,G00,518797,Staff,0,1,20,20
1715605175129,MMW 12R,A01,514034,Herbst; Matthew,0,2,16,16
1715605175129,MMW 12R,A02,514035,Herbst; Matthew,0,0,16,16
1715605176155,MMW 13R,A01,514037,Staff,0,5,16,16
1715605176155,MMW 13R,A02,514039,Staff,0,5,16,16
1715605176155,MMW 13R,A03,628519,Staff,0,4,16,16
1715605178209,SIO 295LS,A00,523233,Staff,10,0,30,20
1715605179235,SIO 295S,A00,523232,Staff,10,0,30,20
1715605180267,SIOC 290S,A01,637330,Merrifield; Mark A,23,0,30,7
1715605181294,SIOC 291S,A01,637333,Gabriel; Corey John,23,0,30,7
1715605182320,SOCI 117,A01,494376,Staff,0,5,5,5
1715605183349,WES 237B,A00,494380,Staff,10,0,20,10
1715605185449,AESE 279B,A00,494370,Wade; Jon P,0,0,33,33
1715605186483,AIP 97,001,660915,Van Den Einde; Yael Dahlia,9999,0,9999,0
1715605187518,AIP 197,001,627712,Vespa; Emanuel Ignacio,9995,0,9999,4
1715605187518,AIP 197,002,650778,Amir; On,9998,0,9999,1
1715605187518,AIP 197,003,650933,Avenancio-Leon; Carlos,9998,0,9999,1
1715605187518,AIP 197,004,658530,Heyman; Gail D.,9998,0,9999,1
1715605187518,AIP 197,005,658631,Neal; Sonya E,9998,0,9999,1
1715605187518,AIP 197,006,658671,Du; Songzi,9998,0,9999,1
1715605188546,ANAR 135S,A00,494369,Braswell; Geoffrey E.,0,0,0,0
1715605189574,BENG 196,001,628496,Engler; Adam J.,9998,0,9999,1
1715605189574,BENG 196,002,660916,Watson; John Thomas,9999,0,9999,0
1715605190605,BISP 197,001,650773,Wilhelm; James E.,9994,0,9999,5
1715605190605,BISP 197,002,658904,Coleman; Aaron B.,9998,0,9999,1
1715605191636,CAT 124RS,A01,519847,Geibel; William,0,0,20,20
1715605192662,CAT 125RS,A01,515971,Geibel; William,0,0,20,20
1715605193688,CLRE 250,A00,511389,Morris; Sheldon,9992,0,9999,7
1715605194715,CLRE 251,A00,507176,Mehta; Ravindra L.,9992,0,9999,7
1715605194715,CLRE 251,B00,511410,Mehta; Ravindra L.,9998,0,9999,1
1715605195747,CLRE 252,A00,507189,Cuomo; Raphael Eduardo,9994,0,9999,5
1715605196774,CLRE 253,A00,507199,Vaida; Florin,9994,0,9999,5
1715605196774,CLRE 253,B00,507202,Vaida; Florin,9999,0,9999,0
1715605197800,CLRE 259,A00,507211,Patel; Hemal,9996,0,9999,3
1715605198825,CLRE 260,A00,507221,Cuomo; Raphael Eduardo,9999,0,9999,0
1715605199850,CLRE 297,001,507242,Cuomo; Raphael Eduardo,9999,0,9999,0
1715605200878,COGS 197,001,638244,Voytek; Bradley Thomas,9997,0,9999,2
1715605201904,CSE 191,A00,516875,Minnes Kemp; Mor Mia,9991,0,9999,8
1715605202933,CSE 197,001,637388,Minnes Kemp; Mor Mia,9992,0,9999,7
1715605203961,CSS 201S,A01,494383,Mignozzetti; Umberto,35,0,35,0
1715605204990,CSS 202S,A01,494387,Mignozzetti; Umberto,35,0,35,0
1715605206018,DSC 197,001,628532,Eldridge; Justin Matthew,9995,0,9999,4
1715605207045,EAP 100,A00,516065,Staff,9799,0,9999,200
1715605208084,ECE 45,A01,507414,Staff,31,0,60,29
1715605210138,ECE 111,A01,507420,Staff,11,0,50,39
1715605211166,ECE 197,001,548057,Sievenpiper; Daniel F.,9991,0,9999,8
1715605212194,EDS 115,A00,507243,Choi; Bailey Miyeon,7,0,28,21
1715605213221,EDS 117,A01,494379,Staff,0,6,34,34
1715605214260,EDS 125,A00,507246,Hopkins; Megan Beth,8,0,30,22
1715605215287,EDS 128A,A01,507264,Fargason; Sharon Gayle,6,0,26,20
1715605216313,EDS 128B,A01,507293,Pappas; Elizabeth,10,0,30,20
1715605217342,EDS 139,A00,507294,Fargason; Sharon Gayle,10,0,30,20
1715605217342,EDS 139,B00,507313,Pappas; Elizabeth,11,0,30,19
1715605218367,EDS 201,A00,507315,Staff,10,0,30,20
1715605219392,EDS 203,A01,507317,Halter; Christopher P.,10,0,30,20
1715605220417,EDS 204R,A01,507319,Halter; Christopher P.,0,3,30,30
1715605220417,EDS 204R,B01,507331,Heinzman; Erica M.,14,0,30,16
1715605221447,EDS 206R,A00,507332,Staff,0,4,30,30
1715605221447,EDS 206R,B00,507343,Staff,15,0,30,15
1715605222472,EDS 250,A00,507344,Hemans; Patricia Ann Benitez,20,0,40,20
1715605223497,EDS 281,A00,507345,Daly; Alan J.,18,0,18,0
1715605224522,EDS 284,A00,507350,Daly; Alan J.,16,0,16,0
1715605225547,EDS 286,A00,507359,Fine; Sarah,18,0,18,0
1715605226573,EDS 289C,A01,507361,Daly; Alan J.,18,0,18,0
1715605227600,EDS 290,A00,507366,Hofstetter; Carolyn,15,0,15,0
1715605228626,LIGM 5A,A00,507421,Fischer-Grunski; Eva K,17,0,20,3
1715605229652,LIGM 5B,A00,507423,Fischer-Grunski; Eva K,19,0,20,1
1715605230678,LIGM 5C,A00,507425,Fischer-Grunski; Eva K,19,0,20,1
1715605231709,LIIT 5AS,A00,507427,Carnelos; Chiara,20,0,20,0
1715605232740,LIIT 5BS,A00,507430,Carnelos; Chiara,20,0,20,0
1715605233769,LIIT 5CS,A00,507432,Carnelos; Chiara,20,0,20,0
1715605234796,LISP 5A,A00,507541,Munoz Sanchez; Alicia,11,0,20,9
1715605235821,LISP 5B,A00,507671,Munoz Sanchez; Alicia,9,0,20,11
1715605236847,LISP 5C,A00,507696,Munoz Sanchez; Alicia,9,0,20,11
1715605237875,MAE 197,001,528363,Boechler; Nicholas Sebastia,9998,0,9999,1
1715605238904,MATH 197,001,523477,Kedlaya; Kiran S.,9994,0,9999,5
1715605238904,MATH 197,002,563811,Zhang; Danna,9994,0,9999,5
1715605238904,MATH 197,003,628552,Dumitriu; Ioana,9998,0,9999,1
1715605238904,MATH 197,004,660885,Floyd; Eric,9999,0,9999,0
1715605239930,MCWP 40R,A00,518780,Staff,2,0,20,18
1715605239930,MCWP 40R,B00,518781,Staff,11,0,20,9
1715605239930,MCWP 40R,C00,518783,Staff,5,0,20,15
1715605240956,MCWP 50R,A00,518791,Staff,0,1,20,20
1715605240956,MCWP 50R,B00,518792,Staff,0,2,20,20
1715605240956,MCWP 50R,C00,518793,Staff,0,4,20,20
1715605240956,MCWP 50R,D00,518794,Staff,0,1,20,20
1715605240956,MCWP 50R,E00,518795,Staff,0,2,20,20
1715605240956,MCWP 50R,F00,518796,Staff,0,1,20,20
1715605240956,MCWP 50R,G00,518797,Staff,0,1,20,20
1715605241983,MMW 12R,A01,514034,Herbst; Matthew,0,2,16,16
1715605241983,MMW 12R,A02,514035,Herbst; Matthew,0,0,16,16
1715605243008,MMW 13R,A01,514037,Staff,0,5,16,16
1715605243008,MMW 13R,A02,514039,Staff,0,5,16,16
1715605243008,MMW 13R,A03,628519,Staff,0,4,16,16
1715605245062,SIO 295LS,A00,523233,Staff,10,0,30,20
1715605246089,SIO 295S,A00,523232,Staff,10,0,30,20
1715605247117,SIOC 290S,A01,637330,Merrifield; Mark A,23,0,30,7
1715605248144,SIOC 291S,A01,637333,Gabriel; Corey John,23,0,30,7
1715605249171,SOCI 117,A01,494376,Staff,0,5,5,5
1715605250197,WES 237B,A00,494380,Staff,10,0,20,10
1715605252292,AESE 279B,A00,494370,Wade; Jon P,0,0,33,33
1715605253319,AIP 97,001,660915,Van Den Einde; Yael Dahlia,9999,0,9999,0
1715605254348,AIP 197,001,627712,Vespa; Emanuel Ignacio,9995,0,9999,4
1715605254348,AIP 197,002,650778,Amir; On,9998,0,9999,1
1715605254348,AIP 197,003,650933,Avenancio-Leon; Carlos,9998,0,9999,1
1715605254348,AIP 197,004,658530,Heyman; Gail D.,9998,0,9999,1
1715605254348,AIP 197,005,658631,Neal; Sonya E,9998,0,9999,1
1715605254348,AIP 197,006,658671,Du; Songzi,9998,0,9999,1
1715605255378,ANAR 135S,A00,494369,Braswell; Geoffrey E.,0,0,0,0
1715605256406,BENG 196,001,628496,Engler; Adam J.,9998,0,9999,1
1715605256406,BENG 196,002,660916,Watson; John Thomas,9999,0,9999,0
1715605257433,BISP 197,001,650773,Wilhelm; James E.,9994,0,9999,5
1715605257433,BISP 197,002,658904,Coleman; Aaron B.,9998,0,9999,1
1715605258460,CAT 124RS,A01,519847,Geibel; William,0,0,20,20
1715605259486,CAT 125RS,A01,515971,Geibel; William,0,0,20,20
1715605260516,CLRE 250,A00,511389,Morris; Sheldon,9992,0,9999,7
1715605261544,CLRE 251,A00,507176,Mehta; Ravindra L.,9992,0,9999,7
1715605261544,CLRE 251,B00,511410,Mehta; Ravindra L.,9998,0,9999,1
1715605262570,CLRE 252,A00,507189,Cuomo; Raphael Eduardo,9994,0,9999,5
1715605263597,CLRE 253,A00,507199,Vaida; Florin,9994,0,9999,5
1715605263597,CLRE 253,B00,507202,Vaida; Florin,9999,0,9999,0
1715605264624,CLRE 259,A00,507211,Patel; Hemal,9996,0,9999,3
1715605265650,CLRE 260,A00,507221,Cuomo; Raphael Eduardo,9999,0,9999,0
1715605266679,CLRE 297,001,507242,Cuomo; Raphael Eduardo,9999,0,9999,0
1715605267708,COGS 197,001,638244,Voytek; Bradley Thomas,9997,0,9999,2
1715605268734,CSE 191,A00,516875,Minnes Kemp; Mor Mia,9991,0,9999,8
1715605269761,CSE 197,001,637388,Minnes Kemp; Mor Mia,9992,0,9999,7
1715605270790,CSS 201S,A01,494383,Mignozzetti; Umberto,35,0,35,0
1715605271816,CSS 202S,A01,494387,Mignozzetti; Umberto,35,0,35,0
1715605272844,DSC 197,001,628532,Eldridge; Justin Matthew,9995,0,9999,4
1715605273877,EAP 100,A00,516065,Staff,9799,0,9999,200
1715605274910,ECE 45,A01,507414,Staff,31,0,60,29
1715605276962,ECE 111,A01,507420,Staff,11,0,50,39
1715605277992,ECE 197,001,548057,Sievenpiper; Daniel F.,9991,0,9999,8
1715605279019,EDS 115,A00,507243,Choi; Bailey Miyeon,7,0,28,21
1715605280046,EDS 117,A01,494379,Staff,0,6,34,34
1715605281072,EDS 125,A00,507246,Hopkins; Megan Beth,8,0,30,22
1715605282103,EDS 128A,A01,507264,Fargason; Sharon Gayle,6,0,26,20
1715605283130,EDS 128B,A01,507293,Pappas; Elizabeth,10,0,30,20
1715605284157,EDS 139,A00,507294,Fargason; Sharon Gayle,10,0,30,20
1715605284157,EDS 139,B00,507313,Pappas; Elizabeth,11,0,30,19
1715605285182,EDS 201,A00,507315,Staff,10,0,30,20
1715605286212,EDS 203,A01,507317,Halter; Christopher P.,10,0,30,20
1715605287239,EDS 204R,A01,507319,Halter; Christopher P.,0,3,30,30
1715605287239,EDS 204R,B01,507331,Heinzman; Erica M.,14,0,30,16
1715605288269,EDS 206R,A00,507332,Staff,0,4,30,30
1715605288269,EDS 206R,B00,507343,Staff,15,0,30,15
1715605289296,EDS 250,A00,507344,Hemans; Patricia Ann Benitez,20,0,40,20
1715605290320,EDS 281,A00,507345,Daly; Alan J.,18,0,18,0
1715605291348,EDS 284,A00,507350,Daly; Alan J.,16,0,16,0
1715605292378,EDS 286,A00,507359,Fine; Sarah,18,0,18,0
1715605293403,EDS 289C,A01,507361,Daly; Alan J.,18,0,18,0
1715605294429,EDS 290,A00,507366,Hofstetter; Carolyn,15,0,15,0
1715605295456,LIGM 5A,A00,507421,Fischer-Grunski; Eva K,17,0,20,3
1715605296481,LIGM 5B,A00,507423,Fischer-Grunski; Eva K,19,0,20,1
1715605297510,LIGM 5C,A00,507425,Fischer-Grunski; Eva K,19,0,20,1
1715605298537,LIIT 5AS,A00,507427,Carnelos; Chiara,20,0,20,0
1715605299568,LIIT 5BS,A00,507430,Carnelos; Chiara,20,0,20,0
1715605300595,LIIT 5CS,A00,507432,Carnelos; Chiara,20,0,20,0
1715605301623,LISP 5A,A00,507541,Munoz Sanchez; Alicia,11,0,20,9
1715605302650,LISP 5B,A00,507671,Munoz Sanchez; Alicia,9,0,20,11
1715605303677,LISP 5C,A00,507696,Munoz Sanchez; Alicia,9,0,20,11
1715605304706,MAE 197,001,528363,Boechler; Nicholas Sebastia,9998,0,9999,1
1715605305735,MATH 197,001,523477,Kedlaya; Kiran S.,9994,0,9999,5
1715605305735,MATH 197,002,563811,Zhang; Danna,9994,0,9999,5
1715605305735,MATH 197,003,628552,Dumitriu; Ioana,9998,0,9999,1
1715605305735,MATH 197,004,660885,Floyd; Eric,9999,0,9999,0
1715605306761,MCWP 40R,A00,518780,Staff,2,0,20,18
1715605306761,MCWP 40R,B00,518781,Staff,11,0,20,9
1715605306761,MCWP 40R,C00,518783,Staff,5,0,20,15
1715605307792,MCWP 50R,A00,518791,Staff,0,1,20,20
1715605307792,MCWP 50R,B00,518792,Staff,0,2,20,20
1715605307792,MCWP 50R,C00,518793,Staff,0,4,20,20
1715605307792,MCWP 50R,D00,518794,Staff,0,1,20,20
1715605307792,MCWP 50R,E00,518795,Staff,0,2,20,20
1715605307792,MCWP 50R,F00,518796,Staff,0,1,20,20
1715605307792,MCWP 50R,G00,518797,Staff,0,1,20,20
1715605308871,MMW 12R,A01,514034,Herbst; Matthew,0,2,16,16
1715605308871,MMW 12R,A02,514035,Herbst; Matthew,0,0,16,16
1715605309896,MMW 13R,A01,514037,Staff,0,5,16,16
1715605309896,MMW 13R,A02,514039,Staff,0,5,16,16
1715605309896,MMW 13R,A03,628519,Staff,0,4,16,16
1715605311949,SIO 295LS,A00,523233,Staff,10,0,30,20
1715605312976,SIO 295S,A00,523232,Staff,10,0,30,20
1715605314003,SIOC 290S,A01,637330,Merrifield; Mark A,23,0,30,7
1715605315035,SIOC 291S,A01,637333,Gabriel; Corey John,23,0,30,7
1715605316062,SOCI 117,A01,494376,Staff,0,5,5,5
1715605317090,WES 237B,A00,494380,Staff,10,0,20,10
1715605319178,AESE 279B,A00,494370,Wade; Jon P,0,0,33,33
1715605320204,AIP 97,001,660915,Van Den Einde; Yael Dahlia,9999,0,9999,0
1715605321236,AIP 197,001,627712,Vespa; Emanuel Ignacio,9995,0,9999,4
1715605321236,AIP 197,002,650778,Amir; On,9998,0,9999,1
1715605321236,AIP 197,003,650933,Avenancio-Leon; Carlos,9998,0,9999,1
1715605321236,AIP 197,004,658530,Heyman; Gail D.,9998,0,9999,1
1715605321236,AIP 197,005,658631,Neal; Sonya E,9998,0,9999,1
1715605321236,AIP 197,006,658671,Du; Songzi,9998,0,9999,1
1715605322264,ANAR 135S,A00,494369,Braswell; Geoffrey E.,0,0,0,0
1715605323297,BENG 196,001,628496,Engler; Adam J.,9998,0,9999,1
1715605323297,BENG 196,002,660916,Watson; John Thomas,9999,0,9999,0
1715605324326,BISP 197,001,650773,Wilhelm; James E.,9994,0,9999,5
1715605324326,BISP 197,002,658904,Coleman; Aaron B.,9998,0,9999,1
1715605325353,CAT 124RS,A01,519847,Geibel; William,0,0,20,20
1715605326381,CAT 125RS,A01,515971,Geibel; William,0,0,20,20
1715605327408,CLRE 250,A00,511389,Morris; Sheldon,9992,0,9999,7
1715605328443,CLRE 251,A00,507176,Mehta; Ravindra L.,9992,0,9999,7
1715605328443,CLRE 251,B00,511410,Mehta; Ravindra L.,9998,0,9999,1
1715605329472,CLRE 252,A00,507189,Cuomo; Raphael Eduardo,9994,0,9999,5
1715605330502,CLRE 253,A00,507199,Vaida; Florin,9994,0,9999,5
1715605330502,CLRE 253,B00,507202,Vaida; Florin,9999,0,9999,0
1715605331531,CLRE 259,A00,507211,Patel; Hemal,9996,0,9999,3
1715605332557,CLRE 260,A00,507221,Cuomo; Raphael Eduardo,9999,0,9999,0
1715605333586,CLRE 297,001,507242,Cuomo; Raphael Eduardo,9999,0,9999,0
1715605334613,COGS 197,001,638244,Voytek; Bradley Thomas,9997,0,9999,2
1715605335639,CSE 191,A00,516875,Minnes Kemp; Mor Mia,9991,0,9999,8
1715605336666,CSE 197,001,637388,Minnes Kemp; Mor Mia,9992,0,9999,7
1715605337693,CSS 201S,A01,494383,Mignozzetti; Umberto,35,0,35,0
1715605338720,CSS 202S,A01,494387,Mignozzetti; Umberto,35,0,35,0
1715605339745,DSC 197,001,628532,Eldridge; Justin Matthew,9995,0,9999,4
1715605340771,EAP 100,A00,516065,Staff,9799,0,9999,200
1715605341805,ECE 45,A01,507414,Staff,31,0,60,29
1715605343870,ECE 111,A01,507420,Staff,11,0,50,39
1715605344901,ECE 197,001,548057,Sievenpiper; Daniel F.,9991,0,9999,8
1715605345932,EDS 115,A00,507243,Choi; Bailey Miyeon,7,0,28,21
1715605346960,EDS 117,A01,494379,Staff,0,6,34,34
1715605347990,EDS 125,A00,507246,Hopkins; Megan Beth,8,0,30,22
1715605349021,EDS 128A,A01,507264,Fargason; Sharon Gayle,6,0,26,20
1715605350050,EDS 128B,A01,507293,Pappas; Elizabeth,10,0,30,20
1715605351076,EDS 139,A00,507294,Fargason; Sharon Gayle,10,0,30,20
1715605351076,EDS 139,B00,507313,Pappas; Elizabeth,11,0,30,19
1715605352102,EDS 201,A00,507315,Staff,10,0,30,20
1715605353129,EDS 203,A01,507317,Halter; Christopher P.,10,0,30,20
1715605354155,EDS 204R,A01,507319,Halter; Christopher P.,0,3,30,30
1715605354155,EDS 204R,B01,507331,Heinzman; Erica M.,14,0,30,16
1715605355181,EDS 206R,A00,507332,Staff,0,4,30,30
1715605355181,EDS 206R,B00,507343,Staff,15,0,30,15
1715605356209,EDS 250,A00,507344,Hemans; Patricia Ann Benitez,20,0,40,20
1715605357240,EDS 281,A00,507345,Daly; Alan J.,18,0,18,0
1715605358267,EDS 284,A00,507350,Daly; Alan J.,16,0,16,0
1715605359297,EDS 286,A00,507359,Fine; Sarah,18,0,18,0
1715605360327,EDS 289C,A01,507361,Daly; Alan J.,18,0,18,0
1715605361356,EDS 290,A00,507366,Hofstetter; Carolyn,15,0,15,0
1715605362383,LIGM 5A,A00,507421,Fischer-Grunski; Eva K,17,0,20,3
1715605363408,LIGM 5B,A00,507423,Fischer-Grunski; Eva K,19,0,20,1
1715605364434,LIGM 5C,A00,507425,Fischer-Grunski; Eva K,19,0,20,1
1715605365460,LIIT 5AS,A00,507427,Carnelos; Chiara,20,0,20,0
1715605366489,LIIT 5BS,A00,507430,Carnelos; Chiara,20,0,20,0
1715605367515,LIIT 5CS,A00,507432,Carnelos; Chiara,20,0,20,0
1715605368542,LISP 5A,A00,507541,Munoz Sanchez; Alicia,11,0,20,9
1715605369576,LISP 5B,A00,507671,Munoz Sanchez; Alicia,9,0,20,11
1715605370604,LISP 5C,A00,507696,Munoz Sanchez; Alicia,9,0,20,11
1715605371630,MAE 197,001,528363,Boechler; Nicholas Sebastia,9998,0,9999,1
1715605372658,MATH 197,001,523477,Kedlaya; Kiran S.,9994,0,9999,5
1715605372658,MATH 197,002,563811,Zhang; Danna,9994,0,9999,5
1715605372658,MATH 197,003,628552,Dumitriu; Ioana,9998,0,9999,1
1715605372658,MATH 197,004,660885,Floyd; Eric,9999,0,9999,0
1715605373684,MCWP 40R,A00,518780,Staff,2,0,20,18
1715605373684,MCWP 40R,B00,518781,Staff,11,0,20,9
1715605373684,MCWP 40R,C00,518783,Staff,5,0,20,15
1715605374716,MCWP 50R,A00,518791,Staff,0,1,20,20
1715605374716,MCWP 50R,B00,518792,Staff,0,2,20,20
1715605374716,MCWP 50R,C00,518793,Staff,0,4,20,20
1715605374716,MCWP 50R,D00,518794,Staff,0,1,20,20
1715605374716,MCWP 50R,E00,518795,Staff,0,2,20,20
1715605374716,MCWP 50R,F00,518796,Staff,0,1,20,20
1715605374716,MCWP 50R,G00,518797,Staff,0,1,20,20
1715605375741,MMW 12R,A01,514034,Herbst; Matthew,0,2,16,16
1715605375741,MMW 12R,A02,514035,Herbst; Matthew,0,0,16,16
1715605376768,MMW 13R,A01,514037,Staff,0,5,16,16
1715605376768,MMW 13R,A02,514039,Staff,0,5,16,16
1715605376768,MMW 13R,A03,628519,Staff,0,4,16,16
1715605378822,SIO 295LS,A00,523233,Staff,10,0,30,20
1715605379850,SIO 295S,A00,523232,Staff,10,0,30,20
1715605380877,SIOC 290S,A01,637330,Merrifield; Mark A,23,0,30,7
1715605381907,SIOC 291S,A01,637333,Gabriel; Corey John,23,0,30,7
1715605382937,SOCI 117,A01,494376,Staff,0,5,5,5
1715605383964,WES 237B,A00,494380,Staff,10,0,20,10
1715605386045,AESE 279B,A00,494370,Wade; Jon P,0,0,33,33
1715605387074,AIP 97,001,660915,Van Den Einde; Yael Dahlia,9999,0,9999,0
1715605388109,AIP 197,001,627712,Vespa; Emanuel Ignacio,9995,0,9999,4
1715605388109,AIP 197,002,650778,Amir; On,9998,0,9999,1
1715605388109,AIP 197,003,650933,Avenancio-Leon; Carlos,9998,0,9999,1
1715605388109,AIP 197,004,658530,Heyman; Gail D.,9998,0,9999,1
1715605388109,AIP 197,005,658631,Neal; Sonya E,9998,0,9999,1
1715605388109,AIP 197,006,658671,Du; Songzi,9998,0,9999,1
1715605389136,ANAR 135S,A00,494369,Braswell; Geoffrey E.,0,0,0,0
1715605390170,BENG 196,001,628496,Engler; Adam J.,9998,0,9999,1
1715605390170,BENG 196,002,660916,Watson; John Thomas,9999,0,9999,0
1715605391201,BISP 197,001,650773,Wilhelm; James E.,9994,0,9999,5
1715605391201,BISP 197,002,658904,Coleman; Aaron B.,9998,0,9999,1
1715605392227,CAT 124RS,A01,519847,Geibel; William,0,0,20,20
1715605393253,CAT 125RS,A01,515971,Geibel; William,0,0,20,20
1715605394279,CLRE 250,A00,511389,Morris; Sheldon,9992,0,9999,7
1715605395311,CLRE 251,A00,507176,Mehta; Ravindra L.,9992,0,9999,7
1715605395311,CLRE 251,B00,511410,Mehta; Ravindra L.,9998,0,9999,1
1715605396337,CLRE 252,A00,507189,Cuomo; Raphael Eduardo,9994,0,9999,5
1715605397368,CLRE 253,A00,507199,Vaida; Florin,9994,0,9999,5
1715605397368,CLRE 253,B00,507202,Vaida; Florin,9999,0,9999,0
1715605398396,CLRE 259,A00,507211,Patel; Hemal,9996,0,9999,3
1715605399422,CLRE 260,A00,507221,Cuomo; Raphael Eduardo,9999,0,9999,0
1715605400450,CLRE 297,001,507242,Cuomo; Raphael Eduardo,9999,0,9999,0
1715605401481,COGS 197,001,638244,Voytek; Bradley Thomas,9997,0,9999,2
1715605402507,CSE 191,A00,516875,Minnes Kemp; Mor Mia,9991,0,9999,8
1715605403534,CSE 197,001,637388,Minnes Kemp; Mor Mia,9992,0,9999,7
1715605404562,CSS 201S,A01,494383,Mignozzetti; Umberto,35,0,35,0
1715605405588,CSS 202S,A01,494387,Mignozzetti; Umberto,35,0,35,0
1715605406617,DSC 197,001,628532,Eldridge; Justin Matthew,9995,0,9999,4
1715605407646,EAP 100,A00,516065,Staff,9799,0,9999,200
1715605408677,ECE 45,A01,507414,Staff,31,0,60,29
1715605410732,ECE 111,A01,507420,Staff,11,0,50,39
1715605411759,ECE 197,001,548057,Sievenpiper; Daniel F.,9991,0,9999,8
1715605412865,EDS 115,A00,507243,Choi; Bailey Miyeon,7,0,28,21
1715605413910,EDS 117,A01,494379,Staff,0,6,34,34
1715605414936,EDS 125,A00,507246,Hopkins; Megan Beth,8,0,30,22
1715605415962,EDS 128A,A01,507264,Fargason; Sharon Gayle,6,0,26,20
1715605416990,EDS 128B,A01,507293,Pappas; Elizabeth,10,0,30,20
1715605418018,EDS 139,A00,507294,Fargason; Sharon Gayle,10,0,30,20
1715605418018,EDS 139,B00,507313,Pappas; Elizabeth,11,0,30,19
1715605419045,EDS 201,A00,507315,Staff,10,0,30,20
1715605420072,EDS 203,A01,507317,Halter; Christopher P.,10,0,30,20
1715605421100,EDS 204R,A01,507319,Halter; Christopher P.,0,3,30,30
1715605421100,EDS 204R,B01,507331,Heinzman; Erica M.,14,0,30,16
1715605422129,EDS 206R,A00,507332,Staff,0,4,30,30
1715605422129,EDS 206R,B00,507343,Staff,15,0,30,15
1715605423154,EDS 250,A00,507344,Hemans; Patricia Ann Benitez,20,0,40,20
1715605424179,EDS 281,A00,507345,Daly; Alan J.,18,0,18,0
1715605425208,EDS 284,A00,507350,Daly; Alan J.,16,0,16,0
1715605426235,EDS 286,A00,507359,Fine; Sarah,18,0,18,0
1715605427262,EDS 289C,A01,507361,Daly; Alan J.,18,0,18,0
1715605428289,EDS 290,A00,507366,Hofstetter; Carolyn,15,0,15,0
1715605429316,LIGM 5A,A00,507421,Fischer-Grunski; Eva K,17,0,20,3
1715605430342,LIGM 5B,A00,507423,Fischer-Grunski; Eva K,19,0,20,1
1715605431368,LIGM 5C,A00,507425,Fischer-Grunski; Eva K,19,0,20,1
1715605432396,LIIT 5AS,A00,507427,Carnelos; Chiara,20,0,20,0
1715605433424,LIIT 5BS,A00,507430,Carnelos; Chiara,20,0,20,0
1715605434452,LIIT 5CS,A00,507432,Carnelos; Chiara,20,0,20,0
1715605435480,LISP 5A,A00,507541,Munoz Sanchez; Alicia,11,0,20,9
1715605436507,LISP 5B,A00,507671,Munoz Sanchez; Alicia,9,0,20,11
1715605437534,LISP 5C,A00,507696,Munoz Sanchez; Alicia,9,0,20,11
1715605438563,MAE 197,001,528363,Boechler; Nicholas Sebastia,9998,0,9999,1
1715605439599,MATH 197,001,523477,Kedlaya; Kiran S.,9994,0,9999,5
1715605439599,MATH 197,002,563811,Zhang; Danna,9994,0,9999,5
1715605439599,MATH 197,003,628552,Dumitriu; Ioana,9998,0,9999,1
1715605439599,MATH 197,004,660885,Floyd; Eric,9999,0,9999,0
1715605440630,MCWP 40R,A00,518780,Staff,2,0,20,18
1715605440630,MCWP 40R,B00,518781,Staff,11,0,20,9
1715605440630,MCWP 40R,C00,518783,Staff,5,0,20,15
1715605441658,MCWP 50R,A00,518791,Staff,0,1,20,20
1715605441658,MCWP 50R,B00,518792,Staff,0,2,20,20
1715605441658,MCWP 50R,C00,518793,Staff,0,4,20,20
1715605441658,MCWP 50R,D00,518794,Staff,0,1,20,20
1715605441658,MCWP 50R,E00,518795,Staff,0,2,20,20
1715605441658,MCWP 50R,F00,518796,Staff,0,1,20,20
1715605441658,MCWP 50R,G00,518797,Staff,0,1,20,20
1715605442687,MMW 12R,A01,514034,Herbst; Matthew,0,2,16,16
1715605442687,MMW 12R,A02,514035,Herbst; Matthew,0,0,16,16
1715605443715,MMW 13R,A01,514037,Staff,0,5,16,16
1715605443715,MMW 13R,A02,514039,Staff,0,5,16,16
1715605443715,MMW 13R,A03,628519,Staff,0,4,16,16
1715605445766,SIO 295LS,A00,523233,Staff,10,0,30,20
1715605446796,SIO 295S,A00,523232,Staff,10,0,30,20
1715605447828,SIOC 290S,A01,637330,Merrifield; Mark A,23,0,30,7
1715605448856,SIOC 291S,A01,637333,Gabriel; Corey John,23,0,30,7
1715605449882,SOCI 117,A01,494376,Staff,0,5,5,5
1715605450910,WES 237B,A00,494380,Staff,10,0,20,10
1715605453008,AESE 279B,A00,494370,Wade; Jon P,0,0,33,33
1715605454034,AIP 97,001,660915,Van Den Einde; Yael Dahlia,9999,0,9999,0
1715605455063,AIP 197,001,627712,Vespa; Emanuel Ignacio,9995,0,9999,4
1715605455063,AIP 197,002,650778,Amir; On,9998,0,9999,1
1715605455063,AIP 197,003,650933,Avenancio-Leon; Carlos,9998,0,9999,1
1715605455063,AIP 197,004,658530,Heyman; Gail D.,9998,0,9999,1
1715605455063,AIP 197,005,658631,Neal; Sonya E,9998,0,9999,1
1715605455063,AIP 197,006,658671,Du; Songzi,9998,0,9999,1
1715605456093,ANAR 135S,A00,494369,Braswell; Geoffrey E.,0,0,0,0
1715605457124,BENG 196,001,628496,Engler; Adam J.,9998,0,9999,1
1715605457124,BENG 196,002,660916,Watson; John Thomas,9999,0,9999,0
1715605458155,BISP 197,001,650773,Wilhelm; James E.,9994,0,9999,5
1715605458155,BISP 197,002,658904,Coleman; Aaron B.,9998,0,9999,1
1715605459183,CAT 124RS,A01,519847,Geibel; William,0,0,20,20
1715605460209,CAT 125RS,A01,515971,Geibel; William,0,0,20,20
1715605461235,CLRE 250,A00,511389,Morris; Sheldon,9992,0,9999,7
1715605462267,CLRE 251,A00,507176,Mehta; Ravindra L.,9992,0,9999,7
1715605462267,CLRE 251,B00,511410,Mehta; Ravindra L.,9998,0,9999,1
1715605463296,CLRE 252,A00,507189,Cuomo; Raphael Eduardo,9994,0,9999,5
1715605464323,CLRE 253,A00,507199,Vaida; Florin,9994,0,9999,5
1715605464323,CLRE 253,B00,507202,Vaida; Florin,9999,0,9999,0
1715605465347,CLRE 259,A00,507211,Patel; Hemal,9996,0,9999,3
1715605466373,CLRE 260,A00,507221,Cuomo; Raphael Eduardo,9999,0,9999,0
1715605467399,CLRE 297,001,507242,Cuomo; Raphael Eduardo,9999,0,9999,0
1715605468430,COGS 197,001,638244,Voytek; Bradley Thomas,9997,0,9999,2
1715605469461,CSE 191,A00,516875,Minnes Kemp; Mor Mia,9991,0,9999,8
1715605470486,CSE 197,001,637388,Minnes Kemp; Mor Mia,9992,0,9999,7
1715605471513,CSS 201S,A01,494383,Mignozzetti; Umberto,35,0,35,0
1715605472539,CSS 202S,A01,494387,Mignozzetti; Umberto,35,0,35,0
1715605473567,DSC 197,001,628532,Eldridge; Justin Matthew,9995,0,9999,4
1715605474595,EAP 100,A00,516065,Staff,9799,0,9999,200
1715605475631,ECE 45,A01,507414,Staff,31,0,60,29
1715605477689,ECE 111,A01,507420,Staff,11,0,50,39
1715605478715,ECE 197,001,548057,Sievenpiper; Daniel F.,9991,0,9999,8
1715605479740,EDS 115,A00,507243,Choi; Bailey Miyeon,7,0,28,21
1715605480765,EDS 117,A01,494379,Staff,0,6,34,34
1715605481792,EDS 125,A00,507246,Hopkins; Megan Beth,8,0,30,22
1715605482817,EDS 128A,A01,507264,Fargason; Sharon Gayle,6,0,26,20
1715605483843,EDS 128B,A01,507293,Pappas; Elizabeth,10,0,30,20
1715605484869,EDS 139,A00,507294,Fargason; Sharon Gayle,10,0,30,20
1715605484869,EDS 139,B00,507313,Pappas; Elizabeth,11,0,30,19
1715605485895,EDS 201,A00,507315,Staff,10,0,30,20
1715605486921,EDS 203,A01,507317,Halter; Christopher P.,10,0,30,20
1715605487950,EDS 204R,A01,507319,Halter; Christopher P.,0,3,30,30
1715605487950,EDS 204R,B01,507331,Heinzman; Erica M.,14,0,30,16
1715605488976,EDS 206R,A00,507332,Staff,0,4,30,30
1715605488976,EDS 206R,B00,507343,Staff,15,0,30,15
1715605490002,EDS 250,A00,507344,Hemans; Patricia Ann Benitez,20,0,40,20
1715605491038,EDS 281,A00,507345,Daly; Alan J.,18,0,18,0
1715605492066,EDS 284,A00,507350,Daly; Alan J.,16,0,16,0
1715605493091,EDS 286,A00,507359,Fine; Sarah,18,0,18,0
1715605494118,EDS 289C,A01,507361,Daly; Alan J.,18,0,18,0
1715605495148,EDS 290,A00,507366,Hofstetter; Carolyn,15,0,15,0
1715605496180,LIGM 5A,A00,507421,Fischer-Grunski; Eva K,17,0,20,3
1715605497206,LIGM 5B,A00,507423,Fischer-Grunski; Eva K,19,0,20,1
1715605498237,LIGM 5C,A00,507425,Fischer-Grunski; Eva K,19,0,20,1
1715605499263,LIIT 5AS,A00,507427,Carnelos; Chiara,20,0,20,0
1715605500293,LIIT 5BS,A00,507430,Carnelos; Chiara,20,0,20,0
1715605501322,LIIT 5CS,A00,507432,Carnelos; Chiara,20,0,20,0
1715605502349,LISP 5A,A00,507541,Munoz Sanchez; Alicia,11,0,20,9
1715605503376,LISP 5B,A00,507671,Munoz Sanchez; Alicia,9,0,20,11
1715605504402,LISP 5C,A00,507696,Munoz Sanchez; Alicia,9,0,20,11
1715605505430,MAE 197,001,528363,Boechler; Nicholas Sebastia,9998,0,9999,1
1715605506458,MATH 197,001,523477,Kedlaya; Kiran S.,9994,0,9999,5
1715605506458,MATH 197,002,563811,Zhang; Danna,9994,0,9999,5
1715605506458,MATH 197,003,628552,Dumitriu; Ioana,9998,0,9999,1
1715605506458,MATH 197,004,660885,Floyd; Eric,9999,0,9999,0
1715605507485,MCWP 40R,A00,518780,Staff,2,0,20,18
1715605507485,MCWP 40R,B00,518781,Staff,11,0,20,9
1715605507485,MCWP 40R,C00,518783,Staff,5,0,20,15
1715605508512,MCWP 50R,A00,518791,Staff,0,1,20,20
1715605508512,MCWP 50R,B00,518792,Staff,0,2,20,20
1715605508512,MCWP 50R,C00,518793,Staff,0,4,20,20
1715605508512,MCWP 50R,D00,518794,Staff,0,1,20,20
1715605508512,MCWP 50R,E00,518795,Staff,0,2,20,20
1715605508512,MCWP 50R,F00,518796,Staff,0,1,20,20
1715605508512,MCWP 50R,G00,518797,Staff,0,1,20,20
1715605509539,MMW 12R,A01,514034,Herbst; Matthew,0,2,16,16
1715605509539,MMW 12R,A02,514035,Herbst; Matthew,0,0,16,16
1715605510570,MMW 13R,A01,514037,Staff,0,5,16,16
1715605510570,MMW 13R,A02,514039,Staff,0,5,16,16
1715605510570,MMW 13R,A03,628519,Staff,0,4,16,16
1715605512627,SIO 295LS,A00,523233,Staff,10,0,30,20
1715605513652,SIO 295S,A00,523232,Staff,10,0,30,20
1715605514686,SIOC 290S,A01,637330,Merrifield; Mark A,23,0,30,7
1715605515713,SIOC 291S,A01,637333,Gabriel; Corey John,23,0,30,7
1715605516795,SOCI 117,A01,494376,Staff,0,5,5,5
1715605517821,WES 237B,A00,494380,Staff,10,0,20,10
1715605519902,AESE 279B,A00,494370,Wade; Jon P,0,0,33,33
1715605520931,AIP 97,001,660915,Van Den Einde; Yael Dahlia,9999,0,9999,0
1715605521963,AIP 197,001,627712,Vespa; Emanuel Ignacio,9995,0,9999,4
1715605521963,AIP 197,002,650778,Amir; On,9998,0,9999,1
1715605521963,AIP 197,003,650933,Avenancio-Leon; Carlos,9998,0,9999,1
1715605521963,AIP 197,004,658530,Heyman; Gail D.,9998,0,9999,1
1715605521963,AIP 197,005,658631,Neal; Sonya E,9998,0,9999,1
1715605521963,AIP 197,006,658671,Du; Songzi,9998,0,9999,1
1715605522992,ANAR 135S,A00,494369,Braswell; Geoffrey E.,0,0,0,0
1715605524022,BENG 196,001,628496,Engler; Adam J.,9998,0,9999,1
1715605524022,BENG 196,002,660916,Watson; John Thomas,9999,0,9999,0
1715605525049,BISP 197,001,650773,Wilhelm; James E.,9994,0,9999,5
1715605525049,BISP 197,002,658904,Coleman; Aaron B.,9998,0,9999,1
1715605526077,CAT 124RS,A01,519847,Geibel; William,0,0,20,20
1715605527103,CAT 125RS,A01,515971,Geibel; William,0,0,20,20
1715605528135,CLRE 250,A00,511389,Morris; Sheldon,9992,0,9999,7
1715605529167,CLRE 251,A00,507176,Mehta; Ravindra L.,9992,0,9999,7
1715605529167,CLRE 251,B00,511410,Mehta; Ravindra L.,9998,0,9999,1
1715605530192,CLRE 252,A00,507189,Cuomo; Raphael Eduardo,9994,0,9999,5
1715605531222,CLRE 253,A00,507199,Vaida; Florin,9994,0,9999,5
1715605531222,CLRE 253,B00,507202,Vaida; Florin,9999,0,9999,0
1715605532248,CLRE 259,A00,507211,Patel; Hemal,9996,0,9999,3
1715605533273,CLRE 260,A00,507221,Cuomo; Raphael Eduardo,9999,0,9999,0
1715605534299,CLRE 297,001,507242,Cuomo; Raphael Eduardo,9999,0,9999,0
1715605535327,COGS 197,001,638244,Voytek; Bradley Thomas,9997,0,9999,2
1715605536352,CSE 191,A00,516875,Minnes Kemp; Mor Mia,9991,0,9999,8
1715605537377,CSE 197,001,637388,Minnes Kemp; Mor Mia,9992,0,9999,7
1715605538405,CSS 201S,A01,494383,Mignozzetti; Umberto,35,0,35,0
1715605539432,CSS 202S,A01,494387,Mignozzetti; Umberto,35,0,35,0
1715605540459,DSC 197,001,628532,Eldridge; Justin Matthew,9995,0,9999,4
1715605541484,EAP 100,A00,516065,Staff,9799,0,9999,200
1715605542511,ECE 45,A01,507414,Staff,31,0,60,29
1715605544567,ECE 111,A01,507420,Staff,11,0,50,39
1715605545593,ECE 197,001,548057,Sievenpiper; Daniel F.,9991,0,9999,8
1715605546625,EDS 115,A00,507243,Choi; Bailey Miyeon,7,0,28,21
1715605547655,EDS 117,A01,494379,Staff,0,6,34,34
1715605548681,EDS 125,A00,507246,Hopkins; Megan Beth,8,0,30,22
1715605549712,EDS 128A,A01,507264,Fargason; Sharon Gayle,6,0,26,20
1715605550738,EDS 128B,A01,507293,Pappas; Elizabeth,10,0,30,20
1715605551764,EDS 139,A00,507294,Fargason; Sharon Gayle,10,0,30,20
1715605551764,EDS 139,B00,507313,Pappas; Elizabeth,11,0,30,19
1715605552789,EDS 201,A00,507315,Staff,10,0,30,20
1715605553818,EDS 203,A01,507317,Halter; Christopher P.,10,0,30,20
1715605554846,EDS 204R,A01,507319,Halter; Christopher P.,0,3,30,30
1715605554846,EDS 204R,B01,507331,Heinzman; Erica M.,14,0,30,16
1715605555870,EDS 206R,A00,507332,Staff,0,4,30,30
1715605555870,EDS 206R,B00,507343,Staff,15,0,30,15
1715605556895,EDS 250,A00,507344,Hemans; Patricia Ann Benitez,20,0,40,20
1715605557921,EDS 281,A00,507345,Daly; Alan J.,18,0,18,0
1715605558946,EDS 284,A00,507350,Daly; Alan J.,16,0,16,0
1715605559978,EDS 286,A00,507359,Fine; Sarah,18,0,18,0
1715605561003,EDS 289C,A01,507361,Daly; Alan J.,18,0,18,0
1715605562031,EDS 290,A00,507366,Hofstetter; Carolyn,15,0,15,0
1715605563064,LIGM 5A,A00,507421,Fischer-Grunski; Eva K,17,0,20,3
1715605564094,LIGM 5B,A00,507423,Fischer-Grunski; Eva K,19,0,20,1
1715605565120,LIGM 5C,A00,507425,Fischer-Grunski; Eva K,19,0,20,1
1715605566146,LIIT 5AS,A00,507427,Carnelos; Chiara,20,0,20,0
1715605567172,LIIT 5BS,A00,507430,Carnelos; Chiara,20,0,20,0
1715605568198,LIIT 5CS,A00,507432,Carnelos; Chiara,20,0,20,0
1715605569225,LISP 5A,A00,507541,Munoz Sanchez; Alicia,11,0,20,9
1715605570254,LISP 5B,A00,507671,Munoz Sanchez; Alicia,9,0,20,11
1715605571279,LISP 5C,A00,507696,Munoz Sanchez; Alicia,9,0,20,11
1715605572309,MAE 197,001,528363,Boechler; Nicholas Sebastia,9998,0,9999,1
1715605573340,MATH 197,001,523477,Kedlaya; Kiran S.,9994,0,9999,5
1715605573340,MATH 197,002,563811,Zhang; Danna,9994,0,9999,5
1715605573340,MATH 197,003,628552,Dumitriu; Ioana,9998,0,9999,1
1715605573340,MATH 197,004,660885,Floyd; Eric,9999,0,9999,0
1715605574365,MCWP 40R,A00,518780,Staff,2,0,20,18
1715605574365,MCWP 40R,B00,518781,Staff,11,0,20,9
1715605574365,MCWP 40R,C00,518783,Staff,5,0,20,15
1715605575397,MCWP 50R,A00,518791,Staff,0,1,20,20
1715605575397,MCWP 50R,B00,518792,Staff,0,2,20,20
1715605575397,MCWP 50R,C00,518793,Staff,0,4,20,20
1715605575397,MCWP 50R,D00,518794,Staff,0,1,20,20
1715605575397,MCWP 50R,E00,518795,Staff,0,2,20,20
1715605575397,MCWP 50R,F00,518796,Staff,0,1,20,20
1715605575397,MCWP 50R,G00,518797,Staff,0,1,20,20
1715605576427,MMW 12R,A01,514034,Herbst; Matthew,0,2,16,16
1715605576427,MMW 12R,A02,514035,Herbst; Matthew,0,0,16,16
1715605577455,MMW 13R,A01,514037,Staff,0,5,16,16
1715605577455,MMW 13R,A02,514039,Staff,0,5,16,16
1715605577455,MMW 13R,A03,628519,Staff,0,4,16,16
1715605579512,SIO 295LS,A00,523233,Staff,10,0,30,20
1715605580541,SIO 295S,A00,523232,Staff,10,0,30,20
1715605581570,SIOC 290S,A01,637330,Merrifield; Mark A,23,0,30,7
1715605582597,SIOC 291S,A01,637333,Gabriel; Corey John,23,0,30,7
1715605583624,SOCI 117,A01,494376,Staff,0,5,5,5
1715605584650,WES 237B,A00,494380,Staff,10,0,20,10
1715605586736,AESE 279B,A00,494370,Wade; Jon P,0,0,33,33
1715605587762,AIP 97,001,660915,Van Den Einde; Yael Dahlia,9999,0,9999,0
1715605588796,AIP 197,001,627712,Vespa; Emanuel Ignacio,9995,0,9999,4
1715605588796,AIP 197,002,650778,Amir; On,9998,0,9999,1
1715605588796,AIP 197,003,650933,Avenancio-Leon; Carlos,9998,0,9999,1
1715605588796,AIP 197,004,658530,Heyman; Gail D.,9998,0,9999,1
1715605588796,AIP 197,005,658631,Neal; Sonya E,9998,0,9999,1
1715605588796,AIP 197,006,658671,Du; Songzi,9998,0,9999,1
1715605589823,ANAR 135S,A00,494369,Braswell; Geoffrey E.,0,0,0,0
1715605590851,BENG 196,001,628496,Engler; Adam J.,9998,0,9999,1
1715605590851,BENG 196,002,660916,Watson; John Thomas,9999,0,9999,0
1715605591877,BISP 197,001,650773,Wilhelm; James E.,9994,0,9999,5
1715605591877,BISP 197,002,658904,Coleman; Aaron B.,9998,0,9999,1
1715605592905,CAT 124RS,A01,519847,Geibel; William,0,0,20,20
1715605593930,CAT 125RS,A01,515971,Geibel; William,0,0,20,20
1715605594956,CLRE 250,A00,511389,Morris; Sheldon,9992,0,9999,7
1715605595989,CLRE 251,A00,507176,Mehta; Ravindra L.,9992,0,9999,7
1715605595989,CLRE 251,B00,511410,Mehta; Ravindra L.,9998,0,9999,1
1715605597018,CLRE 252,A00,507189,Cuomo; Raphael Eduardo,9994,0,9999,5
1715605598045,CLRE 253,A00,507199,Vaida; Florin,9994,0,9999,5
1715605598045,CLRE 253,B00,507202,Vaida; Florin,9999,0,9999,0
1715605599070,CLRE 259,A00,507211,Patel; Hemal,9996,0,9999,3
1715605600095,CLRE 260,A00,507221,Cuomo; Raphael Eduardo,9999,0,9999,0
1715605601121,CLRE 297,001,507242,Cuomo; Raphael Eduardo,9999,0,9999,0
1715605602149,COGS 197,001,638244,Voytek; Bradley Thomas,9997,0,9999,2
1715605603175,CSE 191,A00,516875,Minnes Kemp; Mor Mia,9991,0,9999,8
1715605604201,CSE 197,001,637388,Minnes Kemp; Mor Mia,9992,0,9999,7
1715605605231,CSS 201S,A01,494383,Mignozzetti; Umberto,35,0,35,0
1715605606260,CSS 202S,A01,494387,Mignozzetti; Umberto,35,0,35,0
1715605607286,DSC 197,001,628532,Eldridge; Justin Matthew,9995,0,9999,4
1715605608313,EAP 100,A00,516065,Staff,9799,0,9999,200
1715605609349,ECE 45,A01,507414,Staff,31,0,60,29
1715605611400,ECE 111,A01,507420,Staff,11,0,50,39
1715605612426,ECE 197,001,548057,Sievenpiper; Daniel F.,9991,0,9999,8
1715605613453,EDS 115,A00,507243,Choi; Bailey Miyeon,7,0,28,21
1715605614483,EDS 117,A01,494379,Staff,0,6,34,34
1715605615512,EDS 125,A00,507246,Hopkins; Megan Beth,8,0,30,22
1715605616543,EDS 128A,A01,507264,Fargason; Sharon Gayle,6,0,26,20
1715605617570,EDS 128B,A01,507293,Pappas; Elizabeth,10,0,30,20
1715605618596,EDS 139,A00,507294,Fargason; Sharon Gayle,10,0,30,20
1715605618596,EDS 139,B00,507313,Pappas; Elizabeth,11,0,30,19
1715605619625,EDS 201,A00,507315,Staff,10,0,30,20
1715605620655,EDS 203,A01,507317,Halter; Christopher P.,10,0,30,20
1715605621684,EDS 204R,A01,507319,Halter; Christopher P.,0,3,30,30
1715605621684,EDS 204R,B01,507331,Heinzman; Erica M.,14,0,30,16
1715605622717,EDS 206R,A00,507332,Staff,0,4,30,30
1715605622717,EDS 206R,B00,507343,Staff,15,0,30,15
1715605623744,EDS 250,A00,507344,Hemans; Patricia Ann Benitez,20,0,40,20
1715605624768,EDS 281,A00,507345,Daly; Alan J.,18,0,18,0
1715605625793,EDS 284,A00,507350,Daly; Alan J.,16,0,16,0
1715605626821,EDS 286,A00,507359,Fine; Sarah,18,0,18,0
1715605627849,EDS 289C,A01,507361,Daly; Alan J.,18,0,18,0
1715605628879,EDS 290,A00,507366,Hofstetter; Carolyn,15,0,15,0
1715605629911,LIGM 5A,A00,507421,Fischer-Grunski; Eva K,17,0,20,3
1715605630940,LIGM 5B,A00,507423,Fischer-Grunski; Eva K,19,0,20,1
1715605631971,LIGM 5C,A00,507425,Fischer-Grunski; Eva K,19,0,20,1
1715605632998,LIIT 5AS,A00,507427,Carnelos; Chiara,20,0,20,0
1715605634023,LIIT 5BS,A00,507430,Carnelos; Chiara,20,0,20,0
1715605635050,LIIT 5CS,A00,507432,Carnelos; Chiara,20,0,20,0
1715605636082,LISP 5A,A00,507541,Munoz Sanchez; Alicia,11,0,20,9
1715605637108,LISP 5B,A00,507671,Munoz Sanchez; Alicia,9,0,20,11
1715605638134,LISP 5C,A00,507696,Munoz Sanchez; Alicia,9,0,20,11
1715605639161,MAE 197,001,528363,Boechler; Nicholas Sebastia,9998,0,9999,1
1715605640188,MATH 197,001,523477,Kedlaya; Kiran S.,9994,0,9999,5
1715605640188,MATH 197,002,563811,Zhang; Danna,9994,0,9999,5
1715605640188,MATH 197,003,628552,Dumitriu; Ioana,9998,0,9999,1
1715605640188,MATH 197,004,660885,Floyd; Eric,9999,0,9999,0
1715605641219,MCWP 40R,A00,518780,Staff,2,0,20,18
1715605641219,MCWP 40R,B00,518781,Staff,11,0,20,9
1715605641219,MCWP 40R,C00,518783,Staff,5,0,20,15
1715605642246,MCWP 50R,A00,518791,Staff,0,1,20,20
1715605642246,MCWP 50R,B00,518792,Staff,0,2,20,20
1715605642246,MCWP 50R,C00,518793,Staff,0,4,20,20
1715605642246,MCWP 50R,D00,518794,Staff,0,1,20,20
1715605642246,MCWP 50R,E00,518795,Staff,0,2,20,20
1715605642246,MCWP 50R,F00,518796,Staff,0,1,20,20
1715605642246,MCWP 50R,G00,518797,Staff,0,1,20,20
1715605643277,MMW 12R,A01,514034,Herbst; Matthew,0,2,16,16
1715605643277,MMW 12R,A02,514035,Herbst; Matthew,0,0,16,16
1715605644307,MMW 13R,A01,514037,Staff,0,5,16,16
1715605644307,MMW 13R,A02,514039,Staff,0,5,16,16
1715605644307,MMW 13R,A03,628519,Staff,0,4,16,16
1715605646359,SIO 295LS,A00,523233,Staff,10,0,30,20
1715605647387,SIO 295S,A00,523232,Staff,10,0,30,20
1715605648415,SIOC 290S,A01,637330,Merrifield; Mark A,23,0,30,7
1715605649442,SIOC 291S,A01,637333,Gabriel; Corey John,23,0,30,7
1715605650469,SOCI 117,A01,494376,Staff,0,5,5,5
1715605651497,WES 237B,A00,494380,Staff,10,0,20,10
1715605653589,AESE 279B,A00,494370,Wade; Jon P,0,0,33,33
1715605654614,AIP 97,001,660915,Van Den Einde; Yael Dahlia,9999,0,9999,0
1715605655643,AIP 197,001,627712,Vespa; Emanuel Ignacio,9995,0,9999,4
1715605655643,AIP 197,002,650778,Amir; On,9998,0,9999,1
1715605655643,AIP 197,003,650933,Avenancio-Leon; Carlos,9998,0,9999,1
1715605655643,AIP 197,004,658530,Heyman; Gail D.,9998,0,9999,1
1715605655643,AIP 197,005,658631,Neal; Sonya E,9998,0,9999,1
1715605655643,AIP 197,006,658671,Du; Songzi,9998,0,9999,1
1715605656669,ANAR 135S,A00,494369,Braswell; Geoffrey E.,0,0,0,0
1715605657695,BENG 196,001,628496,Engler; Adam J.,9998,0,9999,1
1715605657695,BENG 196,002,660916,Watson; John Thomas,9999,0,9999,0
1715605658725,BISP 197,001,650773,Wilhelm; James E.,9994,0,9999,5
1715605658725,BISP 197,002,658904,Coleman; Aaron B.,9998,0,9999,1
1715605659754,CAT 124RS,A01,519847,Geibel; William,0,0,20,20
1715605660781,CAT 125RS,A01,515971,Geibel; William,0,0,20,20
1715605661807,CLRE 250,A00,511389,Morris; Sheldon,9992,0,9999,7
1715605662839,CLRE 251,A00,507176,Mehta; Ravindra L.,9992,0,9999,7
1715605662839,CLRE 251,B00,511410,Mehta; Ravindra L.,9998,0,9999,1
1715605663878,CLRE 252,A00,507189,Cuomo; Raphael Eduardo,9994,0,9999,5
1715605664904,CLRE 253,A00,507199,Vaida; Florin,9994,0,9999,5
1715605664904,CLRE 253,B00,507202,Vaida; Florin,9999,0,9999,0
1715605665934,CLRE 259,A00,507211,Patel; Hemal,9996,0,9999,3
1715605666959,CLRE 260,A00,507221,Cuomo; Raphael Eduardo,9999,0,9999,0
1715605667985,CLRE 297,001,507242,Cuomo; Raphael Eduardo,9999,0,9999,0
1715605669017,COGS 197,001,638244,Voytek; Bradley Thomas,9997,0,9999,2
1715605670042,CSE 191,A00,516875,Minnes Kemp; Mor Mia,9991,0,9999,8
1715605671071,CSE 197,001,637388,Minnes Kemp; Mor Mia,9992,0,9999,7
1715605672103,CSS 201S,A01,494383,Mignozzetti; Umberto,35,0,35,0
1715605673132,CSS 202S,A01,494387,Mignozzetti; Umberto,35,0,35,0
1715605674157,DSC 197,001,628532,Eldridge; Justin Matthew,9995,0,9999,4
1715605675185,EAP 100,A00,516065,Staff,9799,0,9999,200
1715605676219,ECE 45,A01,507414,Staff,31,0,60,29
1715605678274,ECE 111,A01,507420,Staff,11,0,50,39
1715605679302,ECE 197,001,548057,Sievenpiper; Daniel F.,9991,0,9999,8
1715605680330,EDS 115,A00,507243,Choi; Bailey Miyeon,7,0,28,21
1715605681357,EDS 117,A01,494379,Staff,0,6,34,34
1715605682388,EDS 125,A00,507246,Hopkins; Megan Beth,8,0,30,22
1715605683415,EDS 128A,A01,507264,Fargason; Sharon Gayle,6,0,26,20
1715605684441,EDS 128B,A01,507293,Pappas; Elizabeth,10,0,30,20
1715605685468,EDS 139,A00,507294,Fargason; Sharon Gayle,10,0,30,20
1715605685468,EDS 139,B00,507313,Pappas; Elizabeth,11,0,30,19
1715605686494,EDS 201,A00,507315,Staff,10,0,30,20
1715605687524,EDS 203,A01,507317,Halter; Christopher P.,10,0,30,20
1715605688551,EDS 204R,A01,507319,Halter; Christopher P.,0,3,30,30
1715605688551,EDS 204R,B01,507331,Heinzman; Erica M.,14,0,30,16
1715605689578,EDS 206R,A00,507332,Staff,0,4,30,30
1715605689578,EDS 206R,B00,507343,Staff,15,0,30,15
1715605690609,EDS 250,A00,507344,Hemans; Patricia Ann Benitez,20,0,40,20
1715605691635,EDS 281,A00,507345,Daly; Alan J.,18,0,18,0
1715605692664,EDS 284,A00,507350,Daly; Alan J.,16,0,16,0
1715605693691,EDS 286,A00,507359,Fine; Sarah,18,0,18,0
1715605694718,EDS 289C,A01,507361,Daly; Alan J.,18,0,18,0
1715605695744,EDS 290,A00,507366,Hofstetter; Carolyn,15,0,15,0
1715605696769,LIGM 5A,A00,507421,Fischer-Grunski; Eva K,17,0,20,3
1715605697796,LIGM 5B,A00,507423,Fischer-Grunski; Eva K,19,0,20,1
1715605698823,LIGM 5C,A00,507425,Fischer-Grunski; Eva K,19,0,20,1
1715605699849,LIIT 5AS,A00,507427,Carnelos; Chiara,20,0,20,0
1715605700877,LIIT 5BS,A00,507430,Carnelos; Chiara,20,0,20,0
1715605701903,LIIT 5CS,A00,507432,Carnelos; Chiara,20,0,20,0
1715605702929,LISP 5A,A00,507541,Munoz Sanchez; Alicia,11,0,20,9
1715605703958,LISP 5B,A00,507671,Munoz Sanchez; Alicia,9,0,20,11
1715605704984,LISP 5C,A00,507696,Munoz Sanchez; Alicia,9,0,20,11
1715605706012,MAE 197,001,528363,Boechler; Nicholas Sebastia,9998,0,9999,1
1715605707042,MATH 197,001,523477,Kedlaya; Kiran S.,9994,0,9999,5
1715605707042,MATH 197,002,563811,Zhang; Danna,9994,0,9999,5
1715605707042,MATH 197,003,628552,Dumitriu; Ioana,9998,0,9999,1
1715605707042,MATH 197,004,660885,Floyd; Eric,9999,0,9999,0
1715605708068,MCWP 40R,A00,518780,Staff,2,0,20,18
1715605708068,MCWP 40R,B00,518781,Staff,11,0,20,9
1715605708068,MCWP 40R,C00,518783,Staff,5,0,20,15
1715605709095,MCWP 50R,A00,518791,Staff,0,1,20,20
1715605709095,MCWP 50R,B00,518792,Staff,0,2,20,20
1715605709095,MCWP 50R,C00,518793,Staff,0,4,20,20
1715605709095,MCWP 50R,D00,518794,Staff,0,1,20,20
1715605709095,MCWP 50R,E00,518795,Staff,0,2,20,20
1715605709095,MCWP 50R,F00,518796,Staff,0,1,20,20
1715605709095,MCWP 50R,G00,518797,Staff,0,1,20,20
1715605710121,MMW 12R,A01,514034,Herbst; Matthew,0,2,16,16
1715605710121,MMW 12R,A02,514035,Herbst; Matthew,0,0,16,16
1715605711148,MMW 13R,A01,514037,Staff,0,5,16,16
1715605711148,MMW 13R,A02,514039,Staff,0,5,16,16
1715605711148,MMW 13R,A03,628519,Staff,0,4,16,16
1715605713201,SIO 295LS,A00,523233,Staff,10,0,30,20
1715605714228,SIO 295S,A00,523232,Staff,10,0,30,20
1715605715256,SIOC 290S,A01,637330,Merrifield; Mark A,23,0,30,7
1715605716289,SIOC 291S,A01,637333,Gabriel; Corey John,23,0,30,7
1715605717316,SOCI 117,A01,494376,Staff,0,5,5,5
1715605718342,WES 237B,A00,494380,Staff,10,0,20,10
1715605720419,AESE 279B,A00,494370,Wade; Jon P,0,0,33,33
1715605721449,AIP 97,001,660915,Van Den Einde; Yael Dahlia,9999,0,9999,0
1715605722485,AIP 197,001,627712,Vespa; Emanuel Ignacio,9995,0,9999,4
1715605722485,AIP 197,002,650778,Amir; On,9998,0,9999,1
1715605722485,AIP 197,003,650933,Avenancio-Leon; Carlos,9998,0,9999,1
1715605722485,AIP 197,004,658530,Heyman; Gail D.,9998,0,9999,1
1715605722485,AIP 197,005,658631,Neal; Sonya E,9998,0,9999,1
1715605722485,AIP 197,006,658671,Du; Songzi,9998,0,9999,1
1715605723515,ANAR 135S,A00,494369,Braswell; Geoffrey E.,0,0,0,0
1715605724543,BENG 196,001,628496,Engler; Adam J.,9998,0,9999,1
1715605724543,BENG 196,002,660916,Watson; John Thomas,9999,0,9999,0
1715605725573,BISP 197,001,650773,Wilhelm; James E.,9994,0,9999,5
1715605725573,BISP 197,002,658904,Coleman; Aaron B.,9998,0,9999,1
1715605726603,CAT 124RS,A01,519847,Geibel; William,0,0,20,20
1715605727631,CAT 125RS,A01,515971,Geibel; William,0,0,20,20
1715605728659,CLRE 250,A00,511389,Morris; Sheldon,9992,0,9999,7
1715605729692,CLRE 251,A00,507176,Mehta; Ravindra L.,9992,0,9999,7
1715605729692,CLRE 251,B00,511410,Mehta; Ravindra L.,9998,0,9999,1
1715605730720,CLRE 252,A00,507189,Cuomo; Raphael Eduardo,9994,0,9999,5
1715605731752,CLRE 253,A00,507199,Vaida; Florin,9994,0,9999,5
1715605731752,CLRE 253,B00,507202,Vaida; Florin,9999,0,9999,0
1715605732783,CLRE 259,A00,507211,Patel; Hemal,9996,0,9999,3
1715605733809,CLRE 260,A00,507221,Cuomo; Raphael Eduardo,9999,0,9999,0
1715605734836,CLRE 297,001,507242,Cuomo; Raphael Eduardo,9999,0,9999,0
1715605735865,COGS 197,001,638244,Voytek; Bradley Thomas,9997,0,9999,2
1715605736892,CSE 191,A00,516875,Minnes Kemp; Mor Mia,9991,0,9999,8
1715605737921,CSE 197,001,637388,Minnes Kemp; Mor Mia,9992,0,9999,7
1715605738947,CSS 201S,A01,494383,Mignozzetti; Umberto,35,0,35,0
1715605739975,CSS 202S,A01,494387,Mignozzetti; Umberto,35,0,35,0
1715605741001,DSC 197,001,628532,Eldridge; Justin Matthew,9995,0,9999,4
1715605742033,EAP 100,A00,516065,Staff,9799,0,9999,200
1715605743063,ECE 45,A01,507414,Staff,31,0,60,29
1715605745119,ECE 111,A01,507420,Staff,11,0,50,39
1715605746151,ECE 197,001,548057,Sievenpiper; Daniel F.,9991,0,9999,8
1715605747182,EDS 115,A00,507243,Choi; Bailey Miyeon,7,0,28,21
1715605748214,EDS 117,A01,494379,Staff,0,6,34,34
1715605749241,EDS 125,A00,507246,Hopkins; Megan Beth,8,0,30,22
1715605750268,EDS 128A,A01,507264,Fargason; Sharon Gayle,6,0,26,20
1715605751294,EDS 128B,A01,507293,Pappas; Elizabeth,10,0,30,20
1715605752320,EDS 139,A00,507294,Fargason; Sharon Gayle,10,0,30,20
1715605752320,EDS 139,B00,507313,Pappas; Elizabeth,11,0,30,19
1715605753348,EDS 201,A00,507315,Staff,10,0,30,20
1715605754377,EDS 203,A01,507317,Halter; Christopher P.,10,0,30,20
1715605755404,EDS 204R,A01,507319,Halter; Christopher P.,0,3,30,30
1715605755404,EDS 204R,B01,507331,Heinzman; Erica M.,14,0,30,16
1715605756433,EDS 206R,A00,507332,Staff,0,4,30,30
1715605756433,EDS 206R,B00,507343,Staff,15,0,30,15
1715605757459,EDS 250,A00,507344,Hemans; Patricia Ann Benitez,20,0,40,20
1715605758485,EDS 281,A00,507345,Daly; Alan J.,18,0,18,0
1715605759511,EDS 284,A00,507350,Daly; Alan J.,16,0,16,0
1715605760540,EDS 286,A00,507359,Fine; Sarah,18,0,18,0
1715605761566,EDS 289C,A01,507361,Daly; Alan J.,18,0,18,0
1715605762591,EDS 290,A00,507366,Hofstetter; Carolyn,15,0,15,0
1715605763617,LIGM 5A,A00,507421,Fischer-Grunski; Eva K,17,0,20,3
1715605764648,LIGM 5B,A00,507423,Fischer-Grunski; Eva K,19,0,20,1
1715605765677,LIGM 5C,A00,507425,Fischer-Grunski; Eva K,19,0,20,1
1715605766705,LIIT 5AS,A00,507427,Carnelos; Chiara,20,0,20,0
1715605767731,LIIT 5BS,A00,507430,Carnelos; Chiara,20,0,20,0
1715605768757,LIIT 5CS,A00,507432,Carnelos; Chiara,20,0,20,0
1715605769790,LISP 5A,A00,507541,Munoz Sanchez; Alicia,11,0,20,9
1715605770816,LISP 5B,A00,507671,Munoz Sanchez; Alicia,9,0,20,11
1715605771842,LISP 5C,A00,507696,Munoz Sanchez; Alicia,9,0,20,11
1715605772874,MAE 197,001,528363,Boechler; Nicholas Sebastia,9998,0,9999,1
1715605773905,MATH 197,001,523477,Kedlaya; Kiran S.,9994,0,9999,5
1715605773905,MATH 197,002,563811,Zhang; Danna,9994,0,9999,5
1715605773905,MATH 197,003,628552,Dumitriu; Ioana,9998,0,9999,1
1715605773905,MATH 197,004,660885,Floyd; Eric,9999,0,9999,0
1715605774931,MCWP 40R,A00,518780,Staff,2,0,20,18
1715605774931,MCWP 40R,B00,518781,Staff,11,0,20,9
1715605774931,MCWP 40R,C00,518783,Staff,5,0,20,15
1715605775962,MCWP 50R,A00,518791,Staff,0,1,20,20
1715605775962,MCWP 50R,B00,518792,Staff,0,2,20,20
1715605775962,MCWP 50R,C00,518793,Staff,0,4,20,20
1715605775962,MCWP 50R,D00,518794,Staff,0,1,20,20
1715605775962,MCWP 50R,E00,518795,Staff,0,2,20,20
1715605775962,MCWP 50R,F00,518796,Staff,0,1,20,20
1715605775962,MCWP 50R,G00,518797,Staff,0,1,20,20
1715605776989,MMW 12R,A01,514034,Herbst; Matthew,0,2,16,16
1715605776989,MMW 12R,A02,514035,Herbst; Matthew,0,0,16,16
1715605778016,MMW 13R,A01,514037,Staff,0,5,16,16
1715605778016,MMW 13R,A02,514039,Staff,0,5,16,16
1715605778016,MMW 13R,A03,628519,Staff,0,4,16,16
1715605780068,SIO 295LS,A00,523233,Staff,10,0,30,20
1715605781097,SIO 295S,A00,523232,Staff,10,0,30,20
1715605782126,SIOC 290S,A01,637330,Merrifield; Mark A,23,0,30,7
1715605783157,SIOC 291S,A01,637333,Gabriel; Corey John,23,0,30,7
1715605784184,SOCI 117,A01,494376,Staff,0,5,5,5
1715605785209,WES 237B,A00,494380,Staff,10,0,20,10
1715605787299,AESE 279B,A00,494370,Wade; Jon P,0,0,33,33
1715605788332,AIP 97,001,660915,Van Den Einde; Yael Dahlia,9999,0,9999,0
1715605789367,AIP 197,001,627712,Vespa; Emanuel Ignacio,9995,0,9999,4
1715605789367,AIP 197,002,650778,Amir; On,9998,0,9999,1
1715605789367,AIP 197,003,650933,Avenancio-Leon; Carlos,9998,0,9999,1
1715605789367,AIP 197,004,658530,Heyman; Gail D.,9998,0,9999,1
1715605789367,AIP 197,005,658631,Neal; Sonya E,9998,0,9999,1
1715605789367,AIP 197,006,658671,Du; Songzi,9998,0,9999,1
1715605790393,ANAR 135S,A00,494369,Braswell; Geoffrey E.,0,0,0,0
1715605791420,BENG 196,001,628496,Engler; Adam J.,9998,0,9999,1
1715605791420,BENG 196,002,660916,Watson; John Thomas,9999,0,9999,0
1715605792451,BISP 197,001,650773,Wilhelm; James E.,9994,0,9999,5
1715605792451,BISP 197,002,658904,Coleman; Aaron B.,9998,0,9999,1
1715605793478,CAT 124RS,A01,519847,Geibel; William,0,0,20,20
1715605794504,CAT 125RS,A01,515971,Geibel; William,0,0,20,20
1715605795536,CLRE 250,A00,511389,Morris; Sheldon,9992,0,9999,7
1715605796564,CLRE 251,A00,507176,Mehta; Ravindra L.,9992,0,9999,7
1715605796564,CLRE 251,B00,511410,Mehta; Ravindra L.,9998,0,9999,1
1715605797593,CLRE 252,A00,507189,Cuomo; Raphael Eduardo,9994,0,9999,5
1715605798623,CLRE 253,A00,507199,Vaida; Florin,9994,0,9999,5
1715605798623,CLRE 253,B00,507202,Vaida; Florin,9999,0,9999,0
1715605799649,CLRE 259,A00,507211,Patel; Hemal,9996,0,9999,3
1715605800677,CLRE 260,A00,507221,Cuomo; Raphael Eduardo,9999,0,9999,0
1715605801705,CLRE 297,001,507242,Cuomo; Raphael Eduardo,9999,0,9999,0
1715605802732,COGS 197,001,638244,Voytek; Bradley Thomas,9997,0,9999,2
1715605803757,CSE 191,A00,516875,Minnes Kemp; Mor Mia,9991,0,9999,8
1715605804784,CSE 197,001,637388,Minnes Kemp; Mor Mia,9992,0,9999,7
1715605805817,CSS 201S,A01,494383,Mignozzetti; Umberto,35,0,35,0
1715605806847,CSS 202S,A01,494387,Mignozzetti; Umberto,35,0,35,0
1715605807877,DSC 197,001,628532,Eldridge; Justin Matthew,9995,0,9999,4
1715605808903,EAP 100,A00,516065,Staff,9799,0,9999,200
1715605809939,ECE 45,A01,507414,Staff,31,0,60,29
1715605811993,ECE 111,A01,507420,Staff,11,0,50,39
1715605813019,ECE 197,001,548057,Sievenpiper; Daniel F.,9991,0,9999,8
1715605814046,EDS 115,A00,507243,Choi; Bailey Miyeon,7,0,28,21
1715605815073,EDS 117,A01,494379,Staff,0,6,34,34
1715605816101,EDS 125,A00,507246,Hopkins; Megan Beth,8,0,30,22
1715605817128,EDS 128A,A01,507264,Fargason; Sharon Gayle,6,0,26,20
1715605818153,EDS 128B,A01,507293,Pappas; Elizabeth,10,0,30,20
1715605819180,EDS 139,A00,507294,Fargason; Sharon Gayle,10,0,30,20
1715605819180,EDS 139,B00,507313,Pappas; Elizabeth,11,0,30,19
1715605820208,EDS 201,A00,507315,Staff,10,0,30,20
1715605821235,EDS 203,A01,507317,Halter; Christopher P.,10,0,30,20
1715605822262,EDS 204R,A01,507319,Halter; Christopher P.,0,3,30,30
1715605822262,EDS 204R,B01,507331,Heinzman; Erica M.,14,0,30,16
1715605823291,EDS 206R,A00,507332,Staff,0,4,30,30
1715605823291,EDS 206R,B00,507343,Staff,15,0,30,15
1715605824316,EDS 250,A00,507344,Hemans; Patricia Ann Benitez,20,0,40,20
1715605825346,EDS 281,A00,507345,Daly; Alan J.,18,0,18,0
1715605826374,EDS 284,A00,507350,Daly; Alan J.,16,0,16,0
1715605827403,EDS 286,A00,507359,Fine; Sarah,18,0,18,0
1715605828431,EDS 289C,A01,507361,Daly; Alan J.,18,0,18,0
1715605829455,EDS 290,A00,507366,Hofstetter; Carolyn,15,0,15,0
1715605830481,LIGM 5A,A00,507421,Fischer-Grunski; Eva K,17,0,20,3
1715605831510,LIGM 5B,A00,507423,Fischer-Grunski; Eva K,19,0,20,1
1715605832537,LIGM 5C,A00,507425,Fischer-Grunski; Eva K,19,0,20,1
1715605833568,LIIT 5AS,A00,507427,Carnelos; Chiara,20,0,20,0
1715605834598,LIIT 5BS,A00,507430,Carnelos; Chiara,20,0,20,0
1715605835627,LIIT 5CS,A00,507432,Carnelos; Chiara,20,0,20,0
1715605836655,LISP 5A,A00,507541,Munoz Sanchez; Alicia,11,0,20,9
1715605837693,LISP 5B,A00,507671,Munoz Sanchez; Alicia,9,0,20,11
1715605838719,LISP 5C,A00,507696,Munoz Sanchez; Alicia,9,0,20,11
1715605839750,MAE 197,001,528363,Boechler; Nicholas Sebastia,9998,0,9999,1
1715605840778,MATH 197,001,523477,Kedlaya; Kiran S.,9994,0,9999,5
1715605840778,MATH 197,002,563811,Zhang; Danna,9994,0,9999,5
1715605840778,MATH 197,003,628552,Dumitriu; Ioana,9998,0,9999,1
1715605840778,MATH 197,004,660885,Floyd; Eric,9999,0,9999,0
1715605841807,MCWP 40R,A00,518780,Staff,2,0,20,18
1715605841807,MCWP 40R,B00,518781,Staff,11,0,20,9
1715605841807,MCWP 40R,C00,518783,Staff,5,0,20,15
1715605842835,MCWP 50R,A00,518791,Staff,0,1,20,20
1715605842835,MCWP 50R,B00,518792,Staff,0,2,20,20
1715605842835,MCWP 50R,C00,518793,Staff,0,4,20,20
1715605842835,MCWP 50R,D00,518794,Staff,0,1,20,20
1715605842835,MCWP 50R,E00,518795,Staff,0,2,20,20
1715605842835,MCWP 50R,F00,518796,Staff,0,1,20,20
1715605842835,MCWP 50R,G00,518797,Staff,0,1,20,20
1715605843866,MMW 12R,A01,514034,Herbst; Matthew,0,2,16,16
1715605843866,MMW 12R,A02,514035,Herbst; Matthew,0,0,16,16
1715605844893,MMW 13R,A01,514037,Staff,0,5,16,16
1715605844893,MMW 13R,A02,514039,Staff,0,5,16,16
1715605844893,MMW 13R,A03,628519,Staff,0,4,16,16
1715605846947,SIO 295LS,A00,523233,Staff,10,0,30,20
1715605847975,SIO 295S,A00,523232,Staff,10,0,30,20
1715605849009,SIOC 290S,A01,637330,Merrifield; Mark A,23,0,30,7
1715605850033,SIOC 291S,A01,637333,Gabriel; Corey John,23,0,30,7
1715605851058,SOCI 117,A01,494376,Staff,0,5,5,5
1715605852084,WES 237B,A00,494380,Staff,10,0,20,10
1715605854167,AESE 279B,A00,494370,Wade; Jon P,0,0,33,33
1715605855196,AIP 97,001,660915,Van Den Einde; Yael Dahlia,9999,0,9999,0
1715605856232,AIP 197,001,627712,Vespa; Emanuel Ignacio,9995,0,9999,4
1715605856232,AIP 197,002,650778,Amir; On,9998,0,9999,1
1715605856232,AIP 197,003,650933,Avenancio-Leon; Carlos,9998,0,9999,1
1715605856232,AIP 197,004,658530,Heyman; Gail D.,9998,0,9999,1
1715605856232,AIP 197,005,658631,Neal; Sonya E,9998,0,9999,1
1715605856232,AIP 197,006,658671,Du; Songzi,9998,0,9999,1
1715605857258,ANAR 135S,A00,494369,Braswell; Geoffrey E.,0,0,0,0
1715605858285,BENG 196,001,628496,Engler; Adam J.,9998,0,9999,1
1715605858285,BENG 196,002,660916,Watson; John Thomas,9999,0,9999,0
1715605859315,BISP 197,001,650773,Wilhelm; James E.,9994,0,9999,5
1715605859315,BISP 197,002,658904,Coleman; Aaron B.,9998,0,9999,1
1715605860340,CAT 124RS,A01,519847,Geibel; William,0,0,20,20
1715605861368,CAT 125RS,A01,515971,Geibel; William,0,0,20,20
1715605862399,CLRE 250,A00,511389,Morris; Sheldon,9992,0,9999,7
1715605863428,CLRE 251,A00,507176,Mehta; Ravindra L.,9992,0,9999,7
1715605863428,CLRE 251,B00,511410,Mehta; Ravindra L.,9998,0,9999,1
1715605864454,CLRE 252,A00,507189,Cuomo; Raphael Eduardo,9994,0,9999,5
1715605865481,CLRE 253,A00,507199,Vaida; Florin,9994,0,9999,5
1715605865481,CLRE 253,B00,507202,Vaida; Florin,9999,0,9999,0
1715605866507,CLRE 259,A00,507211,Patel; Hemal,9996,0,9999,3
1715605867534,CLRE 260,A00,507221,Cuomo; Raphael Eduardo,9999,0,9999,0
1715605868560,CLRE 297,001,507242,Cuomo; Raphael Eduardo,9999,0,9999,0
1715605869586,COGS 197,001,638244,Voytek; Bradley Thomas,9997,0,9999,2
1715605870611,CSE 191,A00,516875,Minnes Kemp; Mor Mia,9991,0,9999,8
1715605871636,CSE 197,001,637388,Minnes Kemp; Mor Mia,9992,0,9999,7
1715605872664,CSS 201S,A01,494383,Mignozzetti; Umberto,35,0,35,0
1715605873690,CSS 202S,A01,494387,Mignozzetti; Umberto,35,0,35,0
1715605874719,DSC 197,001,628532,Eldridge; Justin Matthew,9995,0,9999,4
1715605875746,EAP 100,A00,516065,Staff,9799,0,9999,200
1715605876775,ECE 45,A01,507414,Staff,31,0,60,29
1715605878828,ECE 111,A01,507420,Staff,11,0,50,39
1715605879853,ECE 197,001,548057,Sievenpiper; Daniel F.,9991,0,9999,8
1715605880885,EDS 115,A00,507243,Choi; Bailey Miyeon,7,0,28,21
1715605881916,EDS 117,A01,494379,Staff,0,6,34,34
1715605882943,EDS 125,A00,507246,Hopkins; Megan Beth,8,0,30,22
1715605883978,EDS 128A,A01,507264,Fargason; Sharon Gayle,6,0,26,20
1715605885008,EDS 128B,A01,507293,Pappas; Elizabeth,10,0,30,20
1715605886035,EDS 139,A00,507294,Fargason; Sharon Gayle,10,0,30,20
1715605886035,EDS 139,B00,507313,Pappas; Elizabeth,11,0,30,19
1715605887060,EDS 201,A00,507315,Staff,10,0,30,20
1715605888092,EDS 203,A01,507317,Halter; Christopher P.,10,0,30,20
1715605889119,EDS 204R,A01,507319,Halter; Christopher P.,0,3,30,30
1715605889119,EDS 204R,B01,507331,Heinzman; Erica M.,14,0,30,16
1715605890149,EDS 206R,A00,507332,Staff,0,4,30,30
1715605890149,EDS 206R,B00,507343,Staff,15,0,30,15
1715605891179,EDS 250,A00,507344,Hemans; Patricia Ann Benitez,20,0,40,20
1715605892208,EDS 281,A00,507345,Daly; Alan J.,18,0,18,0
1715605893233,EDS 284,A00,507350,Daly; Alan J.,16,0,16,0
1715605894261,EDS 286,A00,507359,Fine; Sarah,18,0,18,0
1715605895286,EDS 289C,A01,507361,Daly; Alan J.,18,0,18,0
1715605896314,EDS 290,A00,507366,Hofstetter; Carolyn,15,0,15,0
1715605897347,LIGM 5A,A00,507421,Fischer-Grunski; Eva K,17,0,20,3
1715605898373,LIGM 5B,A00,507423,Fischer-Grunski; Eva K,19,0,20,1
1715605899401,LIGM 5C,A00,507425,Fischer-Grunski; Eva K,19,0,20,1
1715605900427,LIIT 5AS,A00,507427,Carnelos; Chiara,20,0,20,0
1715605901457,LIIT 5BS,A00,507430,Carnelos; Chiara,20,0,20,0
1715605902483,LIIT 5CS,A00,507432,Carnelos; Chiara,20,0,20,0
1715605903509,LISP 5A,A00,507541,Munoz Sanchez; Alicia,11,0,20,9
1715605904535,LISP 5B,A00,507671,Munoz Sanchez; Alicia,9,0,20,11
1715605905561,LISP 5C,A00,507696,Munoz Sanchez; Alicia,9,0,20,11
1715605906590,MAE 197,001,528363,Boechler; Nicholas Sebastia,9998,0,9999,1
1715605907618,MATH 197,001,523477,Kedlaya; Kiran S.,9994,0,9999,5
1715605907618,MATH 197,002,563811,Zhang; Danna,9994,0,9999,5
1715605907618,MATH 197,003,628552,Dumitriu; Ioana,9998,0,9999,1
1715605907618,MATH 197,004,660885,Floyd; Eric,9999,0,9999,0
1715605908648,MCWP 40R,A00,518780,Staff,2,0,20,18
1715605908648,MCWP 40R,B00,518781,Staff,11,0,20,9
1715605908648,MCWP 40R,C00,518783,Staff,5,0,20,15
1715605909680,MCWP 50R,A00,518791,Staff,0,1,20,20
1715605909680,MCWP 50R,B00,518792,Staff,0,2,20,20
1715605909680,MCWP 50R,C00,518793,Staff,0,4,20,20
1715605909680,MCWP 50R,D00,518794,Staff,0,1,20,20
1715605909680,MCWP 50R,E00,518795,Staff,0,2,20,20
1715605909680,MCWP 50R,F00,518796,Staff,0,1,20,20
1715605909680,MCWP 50R,G00,518797,Staff,0,1,20,20
1715605910708,MMW 12R,A01,514034,Herbst; Matthew,0,2,16,16
1715605910708,MMW 12R,A02,514035,Herbst; Matthew,0,0,16,16
1715605911734,MMW 13R,A01,514037,Staff,0,5,16,16
1715605911734,MMW 13R,A02,514039,Staff,0,5,16,16
1715605911734,MMW 13R,A03,628519,Staff,0,4,16,16
1715605913792,SIO 295LS,A00,523233,Staff,10,0,30,20
1715605914822,SIO 295S,A00,523232,Staff,10,0,30,20
1715605915849,SIOC 290S,A01,637330,Merrifield; Mark A,23,0,30,7
1715605916880,SIOC 291S,A01,637333,Gabriel; Corey John,23,0,30,7
1715605917905,SOCI 117,A01,494376,Staff,0,5,5,5
1715605918934,WES 237B,A00,494380,Staff,10,0,20,10
1715605921016,AESE 279B,A00,494370,Wade; Jon P,0,0,33,33
1715605922042,AIP 97,001,660915,Van Den Einde; Yael Dahlia,9999,0,9999,0
1715605923070,AIP 197,001,627712,Vespa; Emanuel Ignacio,9995,0,9999,4
1715605923070,AIP 197,002,650778,Amir; On,9998,0,9999,1
1715605923070,AIP 197,003,650933,Avenancio-Leon; Carlos,9998,0,9999,1
1715605923070,AIP 197,004,658530,Heyman; Gail D.,9998,0,9999,1
1715605923070,AIP 197,005,658631,Neal; Sonya E,9998,0,9999,1
1715605923070,AIP 197,006,658671,Du; Songzi,9998,0,9999,1
1715605924103,ANAR 135S,A00,494369,Braswell; Geoffrey E.,0,0,0,0
1715605925133,BENG 196,001,628496,Engler; Adam J.,9998,0,9999,1
1715605925133,BENG 196,002,660916,Watson; John Thomas,9999,0,9999,0
1715605926164,BISP 197,001,650773,Wilhelm; James E.,9994,0,9999,5
1715605926164,BISP 197,002,658904,Coleman; Aaron B.,9998,0,9999,1
1715605927194,CAT 124RS,A01,519847,Geibel; William,0,0,20,20
1715605928224,CAT 125RS,A01,515971,Geibel; William,0,0,20,20
1715605929252,CLRE 250,A00,511389,Morris; Sheldon,9992,0,9999,7
1715605930279,CLRE 251,A00,507176,Mehta; Ravindra L.,9992,0,9999,7
1715605930279,CLRE 251,B00,511410,Mehta; Ravindra L.,9998,0,9999,1
1715605931306,CLRE 252,A00,507189,Cuomo; Raphael Eduardo,9994,0,9999,5
1715605932334,CLRE 253,A00,507199,Vaida; Florin,9994,0,9999,5
1715605932334,CLRE 253,B00,507202,Vaida; Florin,9999,0,9999,0
1715605933364,CLRE 259,A00,507211,Patel; Hemal,9996,0,9999,3
1715605934390,CLRE 260,A00,507221,Cuomo; Raphael Eduardo,9999,0,9999,0
1715605935419,CLRE 297,001,507242,Cuomo; Raphael Eduardo,9999,0,9999,0
1715605936444,COGS 197,001,638244,Voytek; Bradley Thomas,9997,0,9999,2
1715605937472,CSE 191,A00,516875,Minnes Kemp; Mor Mia,9991,0,9999,8
1715605938496,CSE 197,001,637388,Minnes Kemp; Mor Mia,9992,0,9999,7
1715605939523,CSS 201S,A01,494383,Mignozzetti; Umberto,35,0,35,0
1715605940553,CSS 202S,A01,494387,Mignozzetti; Umberto,35,0,35,0
1715605941579,DSC 197,001,628532,Eldridge; Justin Matthew,9995,0,9999,4
1715605942607,EAP 100,A00,516065,Staff,9799,0,9999,200
1715605943634,ECE 45,A01,507414,Staff,31,0,60,29
1715605945688,ECE 111,A01,507420,Staff,11,0,50,39
1715605946717,ECE 197,001,548057,Sievenpiper; Daniel F.,9991,0,9999,8
1715605947749,EDS 115,A00,507243,Choi; Bailey Miyeon,7,0,28,21
1715605948775,EDS 117,A01,494379,Staff,0,6,34,34
1715605949800,EDS 125,A00,507246,Hopkins; Megan Beth,8,0,30,22
1715605950825,EDS 128A,A01,507264,Fargason; Sharon Gayle,6,0,26,20
1715605951851,EDS 128B,A01,507293,Pappas; Elizabeth,10,0,30,20
1715605952880,EDS 139,A00,507294,Fargason; Sharon Gayle,10,0,30,20
1715605952880,EDS 139,B00,507313,Pappas; Elizabeth,11,0,30,19
1715605953907,EDS 201,A00,507315,Staff,10,0,30,20
1715605954933,EDS 203,A01,507317,Halter; Christopher P.,10,0,30,20
1715605955959,EDS 204R,A01,507319,Halter; Christopher P.,0,3,30,30
1715605955959,EDS 204R,B01,507331,Heinzman; Erica M.,14,0,30,16
1715605956984,EDS 206R,A00,507332,Staff,0,4,30,30
1715605956984,EDS 206R,B00,507343,Staff,15,0,30,15
1715605958011,EDS 250,A00,507344,Hemans; Patricia Ann Benitez,20,0,40,20
1715605959040,EDS 281,A00,507345,Daly; Alan J.,18,0,18,0
1715605960065,EDS 284,A00,507350,Daly; Alan J.,16,0,16,0
1715605961092,EDS 286,A00,507359,Fine; Sarah,18,0,18,0
1715605962119,EDS 289C,A01,507361,Daly; Alan J.,18,0,18,0
1715605963149,EDS 290,A00,507366,Hofstetter; Carolyn,15,0,15,0
1715605964177,LIGM 5A,A00,507421,Fischer-Grunski; Eva K,17,0,20,3
1715605965203,LIGM 5B,A00,507423,Fischer-Grunski; Eva K,19,0,20,1
1715605966229,LIGM 5C,A00,507425,Fischer-Grunski; Eva K,19,0,20,1
1715605967256,LIIT 5AS,A00,507427,Carnelos; Chiara,20,0,20,0
1715605968281,LIIT 5BS,A00,507430,Carnelos; Chiara,20,0,20,0
1715605969309,LIIT 5CS,A00,507432,Carnelos; Chiara,20,0,20,0
1715605970341,LISP 5A,A00,507541,Munoz Sanchez; Alicia,11,0,20,9
1715605971368,LISP 5B,A00,507671,Munoz Sanchez; Alicia,9,0,20,11
1715605972394,LISP 5C,A00,507696,Munoz Sanchez; Alicia,9,0,20,11
1715605973420,MAE 197,001,528363,Boechler; Nicholas Sebastia,9998,0,9999,1
1715605974449,MATH 197,001,523477,Kedlaya; Kiran S.,9994,0,9999,5
1715605974449,MATH 197,002,563811,Zhang; Danna,9994,0,9999,5
1715605974449,MATH 197,003,628552,Dumitriu; Ioana,9998,0,9999,1
1715605974449,MATH 197,004,660885,Floyd; Eric,9999,0,9999,0
1715605975476,MCWP 40R,A00,518780,Staff,2,0,20,18
1715605975476,MCWP 40R,B00,518781,Staff,11,0,20,9
1715605975476,MCWP 40R,C00,518783,Staff,5,0,20,15
1715605976508,MCWP 50R,A00,518791,Staff,0,1,20,20
1715605976508,MCWP 50R,B00,518792,Staff,0,2,20,20
1715605976508,MCWP 50R,C00,518793,Staff,0,4,20,20
1715605976508,MCWP 50R,D00,518794,Staff,0,1,20,20
1715605976508,MCWP 50R,E00,518795,Staff,0,2,20,20
1715605976508,MCWP 50R,F00,518796,Staff,0,1,20,20
1715605976508,MCWP 50R,G00,518797,Staff,0,1,20,20
1715605977535,MMW 12R,A01,514034,Herbst; Matthew,0,2,16,16
1715605977535,MMW 12R,A02,514035,Herbst; Matthew,0,0,16,16
1715605978561,MMW 13R,A01,514037,Staff,0,5,16,16
1715605978561,MMW 13R,A02,514039,Staff,0,5,16,16
1715605978561,MMW 13R,A03,628519,Staff,0,4,16,16
1715605980617,SIO 295LS,A00,523233,Staff,10,0,30,20
1715605981644,SIO 295S,A00,523232,Staff,10,0,30,20
1715605982672,SIOC 290S,A01,637330,Merrifield; Mark A,23,0,30,7
1715605983699,SIOC 291S,A01,637333,Gabriel; Corey John,23,0,30,7
1715605984727,SOCI 117,A01,494376,Staff,0,5,5,5
1715605985753,WES 237B,A00,494380,Staff,10,0,20,10
1715605987856,AESE 279B,A00,494370,Wade; Jon P,0,0,33,33
1715605988883,AIP 97,001,660915,Van Den Einde; Yael Dahlia,9999,0,9999,0
1715605989912,AIP 197,001,627712,Vespa; Emanuel Ignacio,9995,0,9999,4
1715605989912,AIP 197,002,650778,Amir; On,9998,0,9999,1
1715605989912,AIP 197,003,650933,Avenancio-Leon; Carlos,9998,0,9999,1
1715605989912,AIP 197,004,658530,Heyman; Gail D.,9998,0,9999,1
1715605989912,AIP 197,005,658631,Neal; Sonya E,9998,0,9999,1
1715605989912,AIP 197,006,658671,Du; Songzi,9998,0,9999,1
1715605990938,ANAR 135S,A00,494369,Braswell; Geoffrey E.,0,0,0,0
1715605991973,BENG 196,001,628496,Engler; Adam J.,9998,0,9999,1
1715605991973,BENG 196,002,660916,Watson; John Thomas,9999,0,9999,0
1715605993002,BISP 197,001,650773,Wilhelm; James E.,9994,0,9999,5
1715605993002,BISP 197,002,658904,Coleman; Aaron B.,9998,0,9999,1
1715605994029,CAT 124RS,A01,519847,Geibel; William,0,0,20,20
1715605995059,CAT 125RS,A01,515971,Geibel; William,0,0,20,20
1715605996090,CLRE 250,A00,511389,Morris; Sheldon,9992,0,9999,7
1715605997125,CLRE 251,A00,507176,Mehta; Ravindra L.,9992,0,9999,7
1715605997125,CLRE 251,B00,511410,Mehta; Ravindra L.,9998,0,9999,1
1715605998152,CLRE 252,A00,507189,Cuomo; Raphael Eduardo,9994,0,9999,5
1715605999182,CLRE 253,A00,507199,Vaida; Florin,9994,0,9999,5
1715605999182,CLRE 253,B00,507202,Vaida; Florin,9999,0,9999,0
1715606000208,CLRE 259,A00,507211,Patel; Hemal,9996,0,9999,3
1715606001234,CLRE 260,A00,507221,Cuomo; Raphael Eduardo,9999,0,9999,0
1715606002259,CLRE 297,001,507242,Cuomo; Raphael Eduardo,9999,0,9999,0
1715606003285,COGS 197,001,638244,Voytek; Bradley Thomas,9997,0,9999,2
1715606004311,CSE 191,A00,516875,Minnes Kemp; Mor Mia,9991,0,9999,8
1715606005337,CSE 197,001,637388,Minnes Kemp; Mor Mia,9992,0,9999,7
1715606006365,CSS 201S,A01,494383,Mignozzetti; Umberto,35,0,35,0
1715606007392,CSS 202S,A01,494387,Mignozzetti; Umberto,35,0,35,0
1715606008417,DSC 197,001,628532,Eldridge; Justin Matthew,9995,0,9999,4
1715606009445,EAP 100,A00,516065,Staff,9799,0,9999,200
1715606010476,ECE 45,A01,507414,Staff,31,0,60,29
1715606012530,ECE 111,A01,507420,Staff,11,0,50,39
1715606013557,ECE 197,001,548057,Sievenpiper; Daniel F.,9991,0,9999,8
1715606014587,EDS 115,A00,507243,Choi; Bailey Miyeon,7,0,28,21
1715606015618,EDS 117,A01,494379,Staff,0,6,34,34
1715606016651,EDS 125,A00,507246,Hopkins; Megan Beth,8,0,30,22
1715606017679,EDS 128A,A01,507264,Fargason; Sharon Gayle,6,0,26,20
1715606018709,EDS 128B,A01,507293,Pappas; Elizabeth,10,0,30,20
1715606019739,EDS 139,A00,507294,Fargason; Sharon Gayle,10,0,30,20
1715606019739,EDS 139,B00,507313,Pappas; Elizabeth,11,0,30,19
1715606020767,EDS 201,A00,507315,Staff,10,0,30,20
1715606021794,EDS 203,A01,507317,Halter; Christopher P.,10,0,30,20
1715606022826,EDS 204R,A01,507319,Halter; Christopher P.,0,3,30,30
1715606022826,EDS 204R,B01,507331,Heinzman; Erica M.,14,0,30,16
1715606023852,EDS 206R,A00,507332,Staff,0,4,30,30
1715606023852,EDS 206R,B00,507343,Staff,15,0,30,15
1715606024877,EDS 250,A00,507344,Hemans; Patricia Ann Benitez,20,0,40,20
1715606025908,EDS 281,A00,507345,Daly; Alan J.,18,0,18,0
1715606026950,EDS 284,A00,507350,Daly; Alan J.,16,0,16,0
1715606027976,EDS 286,A00,507359,Fine; Sarah,18,0,18,0
1715606029004,EDS 289C,A01,507361,Daly; Alan J.,18,0,18,0
1715606030033,EDS 290,A00,507366,Hofstetter; Carolyn,15,0,15,0
1715606031062,LIGM 5A,A00,507421,Fischer-Grunski; Eva K,17,0,20,3
1715606032088,LIGM 5B,A00,507423,Fischer-Grunski; Eva K,19,0,20,1
1715606033113,LIGM 5C,A00,507425,Fischer-Grunski; Eva K,19,0,20,1
1715606034139,LIIT 5AS,A00,507427,Carnelos; Chiara,20,0,20,0
1715606035163,LIIT 5BS,A00,507430,Carnelos; Chiara,20,0,20,0
1715606036188,LIIT 5CS,A00,507432,Carnelos; Chiara,20,0,20,0
1715606037218,LISP 5A,A00,507541,Munoz Sanchez; Alicia,11,0,20,9
1715606038243,LISP 5B,A00,507671,Munoz Sanchez; Alicia,9,0,20,11
1715606039273,LISP 5C,A00,507696,Munoz Sanchez; Alicia,9,0,20,11
1715606040303,MAE 197,001,528363,Boechler; Nicholas Sebastia,9998,0,9999,1
1715606041329,MATH 197,001,523477,Kedlaya; Kiran S.,9994,0,9999,5
1715606041329,MATH 197,002,563811,Zhang; Danna,9994,0,9999,5
1715606041329,MATH 197,003,628552,Dumitriu; Ioana,9998,0,9999,1
1715606041329,MATH 197,004,660885,Floyd; Eric,9999,0,9999,0
1715606042359,MCWP 40R,A00,518780,Staff,2,0,20,18
1715606042359,MCWP 40R,B00,518781,Staff,11,0,20,9
1715606042359,MCWP 40R,C00,518783,Staff,5,0,20,15
1715606043389,MCWP 50R,A00,518791,Staff,0,1,20,20
1715606043389,MCWP 50R,B00,518792,Staff,0,2,20,20
1715606043389,MCWP 50R,C00,518793,Staff,0,4,20,20
1715606043389,MCWP 50R,D00,518794,Staff,0,1,20,20
1715606043389,MCWP 50R,E00,518795,Staff,0,2,20,20
1715606043389,MCWP 50R,F00,518796,Staff,0,1,20,20
1715606043389,MCWP 50R,G00,518797,Staff,0,1,20,20
1715606044414,MMW 12R,A01,514034,Herbst; Matthew,0,2,16,16
1715606044414,MMW 12R,A02,514035,Herbst; Matthew,0,0,16,16
1715606045440,MMW 13R,A01,514037,Staff,0,5,16,16
1715606045440,MMW 13R,A02,514039,Staff,0,5,16,16
1715606045440,MMW 13R,A03,628519,Staff,0,4,16,16
1715606047499,SIO 295LS,A00,523233,Staff,10,0,30,20
1715606048524,SIO 295S,A00,523232,Staff,10,0,30,20
1715606049549,SIOC 290S,A01,637330,Merrifield; Mark A,23,0,30,7
1715606050577,SIOC 291S,A01,637333,Gabriel; Corey John,23,0,30,7
1715606051606,SOCI 117,A01,494376,Staff,0,5,5,5
1715606052631,WES 237B,A00,494380,Staff,10,0,20,10
1715606054721,AESE 279B,A00,494370,Wade; Jon P,0,0,33,33
1715606055750,AIP 97,001,660915,Van Den Einde; Yael Dahlia,9999,0,9999,0
1715606056779,AIP 197,001,627712,Vespa; Emanuel Ignacio,9995,0,9999,4
1715606056779,AIP 197,002,650778,Amir; On,9998,0,9999,1
1715606056779,AIP 197,003,650933,Avenancio-Leon; Carlos,9998,0,9999,1
1715606056779,AIP 197,004,658530,Heyman; Gail D.,9998,0,9999,1
1715606056779,AIP 197,005,658631,Neal; Sonya E,9998,0,9999,1
1715606056779,AIP 197,006,658671,Du; Songzi,9998,0,9999,1
1715606057810,ANAR 135S,A00,494369,Braswell; Geoffrey E.,0,0,0,0
1715606058842,BENG 196,001,628496,Engler; Adam J.,9998,0,9999,1
1715606058842,BENG 196,002,660916,Watson; John Thomas,9999,0,9999,0
1715606059872,BISP 197,001,650773,Wilhelm; James E.,9994,0,9999,5
1715606059872,BISP 197,002,658904,Coleman; Aaron B.,9998,0,9999,1
1715606060900,CAT 124RS,A01,519847,Geibel; William,0,0,20,20
1715606061927,CAT 125RS,A01,515971,Geibel; William,0,0,20,20
1715606062955,CLRE 250,A00,511389,Morris; Sheldon,9992,0,9999,7
1715606063989,CLRE 251,A00,507176,Mehta; Ravindra L.,9992,0,9999,7
1715606063989,CLRE 251,B00,511410,Mehta; Ravindra L.,9998,0,9999,1
1715606065020,CLRE 252,A00,507189,Cuomo; Raphael Eduardo,9994,0,9999,5
1715606066047,CLRE 253,A00,507199,Vaida; Florin,9994,0,9999,5
1715606066047,CLRE 253,B00,507202,Vaida; Florin,9999,0,9999,0
1715606067076,CLRE 259,A00,507211,Patel; Hemal,9996,0,9999,3
1715606068105,CLRE 260,A00,507221,Cuomo; Raphael Eduardo,9999,0,9999,0
1715606069131,CLRE 297,001,507242,Cuomo; Raphael Eduardo,9999,0,9999,0
1715606070157,COGS 197,001,638244,Voytek; Bradley Thomas,9997,0,9999,2
1715606071186,CSE 191,A00,516875,Minnes Kemp; Mor Mia,9991,0,9999,8
1715606072223,CSE 197,001,637388,Minnes Kemp; Mor Mia,9992,0,9999,7
1715606073250,CSS 201S,A01,494383,Mignozzetti; Umberto,35,0,35,0
1715606074277,CSS 202S,A01,494387,Mignozzetti; Umberto,35,0,35,0
1715606075303,DSC 197,001,628532,Eldridge; Justin Matthew,9995,0,9999,4
1715606076333,EAP 100,A00,516065,Staff,9799,0,9999,200
1715606077365,ECE 45,A01,507414,Staff,31,0,60,29
1715606079418,ECE 111,A01,507420,Staff,11,0,50,39
1715606080445,ECE 197,001,548057,Sievenpiper; Daniel F.,9991,0,9999,8
1715606081472,EDS 115,A00,507243,Choi; Bailey Miyeon,7,0,28,21
1715606082502,EDS 117,A01,494379,Staff,0,6,34,34
1715606083528,EDS 125,A00,507246,Hopkins; Megan Beth,8,0,30,22
1715606084560,EDS 128A,A01,507264,Fargason; Sharon Gayle,6,0,26,20
1715606085587,EDS 128B,A01,507293,Pappas; Elizabeth,10,0,30,20
1715606086615,EDS 139,A00,507294,Fargason; Sharon Gayle,10,0,30,20
1715606086615,EDS 139,B00,507313,Pappas; Elizabeth,11,0,30,19
1715606087641,EDS 201,A00,507315,Staff,10,0,30,20
1715606088673,EDS 203,A01,507317,Halter; Christopher P.,10,0,30,20
1715606089703,EDS 204R,A01,507319,Halter; Christopher P.,0,3,30,30
1715606089703,EDS 204R,B01,507331,Heinzman; Erica M.,14,0,30,16
1715606090730,EDS 206R,A00,507332,Staff,0,4,30,30
1715606090730,EDS 206R,B00,507343,Staff,15,0,30,15
1715606091762,EDS 250,A00,507344,Hemans; Patricia Ann Benitez,20,0,40,20
1715606092792,EDS 281,A00,507345,Daly; Alan J.,18,0,18,0
1715606093869,EDS 284,A00,507350,Daly; Alan J.,16,0,16,0
1715606094894,EDS 286,A00,507359,Fine; Sarah,18,0,18,0
1715606095920,EDS 289C,A01,507361,Daly; Alan J.,18,0,18,0
1715606096945,EDS 290,A00,507366,Hofstetter; Carolyn,15,0,15,0
1715606097971,LIGM 5A,A00,507421,Fischer-Grunski; Eva K,17,0,20,3
1715606098996,LIGM 5B,A00,507423,Fischer-Grunski; Eva K,19,0,20,1
1715606100029,LIGM 5C,A00,507425,Fischer-Grunski; Eva K,19,0,20,1
1715606101059,LIIT 5AS,A00,507427,Carnelos; Chiara,20,0,20,0
1715606102091,LIIT 5BS,A00,507430,Carnelos; Chiara,20,0,20,0
1715606103121,LIIT 5CS,A00,507432,Carnelos; Chiara,20,0,20,0
1715606104151,LISP 5A,A00,507541,Munoz Sanchez; Alicia,11,0,20,9
1715606105179,LISP 5B,A00,507671,Munoz Sanchez; Alicia,9,0,20,11
1715606106208,LISP 5C,A00,507696,Munoz Sanchez; Alicia,9,0,20,11
1715606107272,MAE 197,001,528363,Boechler; Nicholas Sebastia,9998,0,9999,1
1715606108299,MATH 197,001,523477,Kedlaya; Kiran S.,9994,0,9999,5
1715606108299,MATH 197,002,563811,Zhang; Danna,9994,0,9999,5
1715606108299,MATH 197,003,628552,Dumitriu; Ioana,9998,0,9999,1
1715606108299,MATH 197,004,660885,Floyd; Eric,9999,0,9999,0
1715606109326,MCWP 40R,A00,518780,Staff,2,0,20,18
1715606109326,MCWP 40R,B00,518781,Staff,11,0,20,9
1715606109326,MCWP 40R,C00,518783,Staff,5,0,20,15
1715606110353,MCWP 50R,A00,518791,Staff,0,1,20,20
1715606110353,MCWP 50R,B00,518792,Staff,0,2,20,20
1715606110353,MCWP 50R,C00,518793,Staff,0,4,20,20
1715606110353,MCWP 50R,D00,518794,Staff,0,1,20,20
1715606110353,MCWP 50R,E00,518795,Staff,0,2,20,20
1715606110353,MCWP 50R,F00,518796,Staff,0,1,20,20
1715606110353,MCWP 50R,G00,518797,Staff,0,1,20,20
1715606111379,MMW 12R,A01,514034,Herbst; Matthew,0,2,16,16
1715606111379,MMW 12R,A02,514035,Herbst; Matthew,0,0,16,16
1715606112405,MMW 13R,A01,514037,Staff,0,5,16,16
1715606112405,MMW 13R,A02,514039,Staff,0,5,16,16
1715606112405,MMW 13R,A03,628519,Staff,0,4,16,16
1715606114458,SIO 295LS,A00,523233,Staff,10,0,30,20
1715606115488,SIO 295S,A00,523232,Staff,10,0,30,20
1715606116515,SIOC 290S,A01,637330,Merrifield; Mark A,23,0,30,7
1715606117541,SIOC 291S,A01,637333,Gabriel; Corey John,23,0,30,7
1715606118566,SOCI 117,A01,494376,Staff,0,5,5,5
1715606119594,WES 237B,A00,494380,Staff,10,0,20,10
1715606121675,AESE 279B,A00,494370,Wade; Jon P,0,0,33,33
1715606122701,AIP 97,001,660915,Van Den Einde; Yael Dahlia,9999,0,9999,0
1715606123736,AIP 197,001,627712,Vespa; Emanuel Ignacio,9995,0,9999,4
1715606123736,AIP 197,002,650778,Amir; On,9998,0,9999,1
1715606123736,AIP 197,003,650933,Avenancio-Leon; Carlos,9998,0,9999,1
1715606123736,AIP 197,004,658530,Heyman; Gail D.,9998,0,9999,1
1715606123736,AIP 197,005,658631,Neal; Sonya E,9998,0,9999,1
1715606123736,AIP 197,006,658671,Du; Songzi,9998,0,9999,1
1715606124765,ANAR 135S,A00,494369,Braswell; Geoffrey E.,0,0,0,0
1715606125791,BENG 196,001,628496,Engler; Adam J.,9998,0,9999,1
1715606125791,BENG 196,002,660916,Watson; John Thomas,9999,0,9999,0
1715606126820,BISP 197,001,650773,Wilhelm; James E.,9994,0,9999,5
1715606126820,BISP 197,002,658904,Coleman; Aaron B.,9998,0,9999,1
1715606127847,CAT 124RS,A01,519847,Geibel; William,0,0,20,20
1715606128871,CAT 125RS,A01,515971,Geibel; William,0,0,20,20
1715606129901,CLRE 250,A00,511389,Morris; Sheldon,9992,0,9999,7
1715606130933,CLRE 251,A00,507176,Mehta; Ravindra L.,9992,0,9999,7
1715606130933,CLRE 251,B00,511410,Mehta; Ravindra L.,9998,0,9999,1
1715606131962,CLRE 252,A00,507189,Cuomo; Raphael Eduardo,9994,0,9999,5
1715606132991,CLRE 253,A00,507199,Vaida; Florin,9994,0,9999,5
1715606132991,CLRE 253,B00,507202,Vaida; Florin,9999,0,9999,0
1715606134108,CLRE 259,A00,507211,Patel; Hemal,9996,0,9999,3
1715606135140,CLRE 260,A00,507221,Cuomo; Raphael Eduardo,9999,0,9999,0
1715606136167,CLRE 297,001,507242,Cuomo; Raphael Eduardo,9999,0,9999,0
1715606137195,COGS 197,001,638244,Voytek; Bradley Thomas,9997,0,9999,2
1715606138220,CSE 191,A00,516875,Minnes Kemp; Mor Mia,9991,0,9999,8
1715606139244,CSE 197,001,637388,Minnes Kemp; Mor Mia,9992,0,9999,7
1715606140270,CSS 201S,A01,494383,Mignozzetti; Umberto,35,0,35,0
1715606141294,CSS 202S,A01,494387,Mignozzetti; Umberto,35,0,35,0
1715606142319,DSC 197,001,628532,Eldridge; Justin Matthew,9995,0,9999,4
1715606143345,EAP 100,A00,516065,Staff,9799,0,9999,200
1715606144373,ECE 45,A01,507414,Staff,31,0,60,29
1715606146435,ECE 111,A01,507420,Staff,11,0,50,39
1715606147468,ECE 197,001,548057,Sievenpiper; Daniel F.,9991,0,9999,8
1715606148494,EDS 115,A00,507243,Choi; Bailey Miyeon,7,0,28,21
1715606149521,EDS 117,A01,494379,Staff,0,6,34,34
1715606150546,EDS 125,A00,507246,Hopkins; Megan Beth,8,0,30,22
1715606151575,EDS 128A,A01,507264,Fargason; Sharon Gayle,6,0,26,20
1715606152601,EDS 128B,A01,507293,Pappas; Elizabeth,10,0,30,20
1715606153627,EDS 139,A00,507294,Fargason; Sharon Gayle,10,0,30,20
1715606153627,EDS 139,B00,507313,Pappas; Elizabeth,11,0,30,19
1715606154652,EDS 201,A00,507315,Staff,10,0,30,20
1715606155678,EDS 203,A01,507317,Halter; Christopher P.,10,0,30,20
1715606156707,EDS 204R,A01,507319,Halter; Christopher P.,0,3,30,30
1715606156707,EDS 204R,B01,507331,Heinzman; Erica M.,14,0,30,16
1715606157732,EDS 206R,A00,507332,Staff,0,4,30,30
1715606157732,EDS 206R,B00,507343,Staff,15,0,30,15
1715606158757,EDS 250,A00,507344,Hemans; Patricia Ann Benitez,20,0,40,20
1715606159786,EDS 281,A00,507345,Daly; Alan J.,18,0,18,0
1715606160825,EDS 284,A00,507350,Daly; Alan J.,16,0,16,0
1715606161857,EDS 286,A00,507359,Fine; Sarah,18,0,18,0
1715606162886,EDS 289C,A01,507361,Daly; Alan J.,18,0,18,0
1715606163912,EDS 290,A00,507366,Hofstetter; Carolyn,15,0,15,0
1715606164940,LIGM 5A,A00,507421,Fischer-Grunski; Eva K,17,0,20,3
1715606165970,LIGM 5B,A00,507423,Fischer-Grunski; Eva K,19,0,20,1
1715606166995,LIGM 5C,A00,507425,Fischer-Grunski; Eva K,19,0,20,1
1715606168024,LIIT 5AS,A00,507427,Carnelos; Chiara,20,0,20,0
1715606169051,LIIT 5BS,A00,507430,Carnelos; Chiara,20,0,20,0
1715606170077,LIIT 5CS,A00,507432,Carnelos; Chiara,20,0,20,0
1715606171107,LISP 5A,A00,507541,Munoz Sanchez; Alicia,11,0,20,9
1715606172138,LISP 5B,A00,507671,Munoz Sanchez; Alicia,9,0,20,11
1715606173164,LISP 5C,A00,507696,Munoz Sanchez; Alicia,9,0,20,11
1715606174191,MAE 197,001,528363,Boechler; Nicholas Sebastia,9998,0,9999,1
1715606175230,MATH 197,001,523477,Kedlaya; Kiran S.,9994,0,9999,5
1715606175230,MATH 197,002,563811,Zhang; Danna,9994,0,9999,5
1715606175230,MATH 197,003,628552,Dumitriu; Ioana,9998,0,9999,1
1715606175230,MATH 197,004,660885,Floyd; Eric,9999,0,9999,0
1715606176258,MCWP 40R,A00,518780,Staff,2,0,20,18
1715606176258,MCWP 40R,B00,518781,Staff,11,0,20,9
1715606176258,MCWP 40R,C00,518783,Staff,5,0,20,15
1715606177288,MCWP 50R,A00,518791,Staff,0,1,20,20
1715606177288,MCWP 50R,B00,518792,Staff,0,2,20,20
1715606177288,MCWP 50R,C00,518793,Staff,0,4,20,20
1715606177288,MCWP 50R,D00,518794,Staff,0,1,20,20
1715606177288,MCWP 50R,E00,518795,Staff,0,2,20,20
1715606177288,MCWP 50R,F00,518796,Staff,0,1,20,20
1715606177288,MCWP 50R,G00,518797,Staff,0,1,20,20
1715606178313,MMW 12R,A01,514034,Herbst; Matthew,0,2,16,16
1715606178313,MMW 12R,A02,514035,Herbst; Matthew,0,0,16,16
1715606179342,MMW 13R,A01,514037,Staff,0,5,16,16
1715606179342,MMW 13R,A02,514039,Staff,0,5,16,16
1715606179342,MMW 13R,A03,628519,Staff,0,4,16,16
1715606181401,SIO 295LS,A00,523233,Staff,10,0,30,20
1715606182425,SIO 295S,A00,523232,Staff,10,0,30,20
1715606183451,SIOC 290S,A01,637330,Merrifield; Mark A,23,0,30,7
1715606184536,SIOC 291S,A01,637333,Gabriel; Corey John,23,0,30,7
1715606185566,SOCI 117,A01,494376,Staff,0,5,5,5
1715606186647,WES 237B,A00,494380,Staff,10,0,20,10
1715606188723,AESE 279B,A00,494370,Wade; Jon P,0,0,33,33
1715606189759,AIP 97,001,660915,Van Den Einde; Yael Dahlia,9999,0,9999,0
1715606190796,AIP 197,001,627712,Vespa; Emanuel Ignacio,9995,0,9999,4
1715606190796,AIP 197,002,650778,Amir; On,9998,0,9999,1
1715606190796,AIP 197,003,650933,Avenancio-Leon; Carlos,9998,0,9999,1
1715606190796,AIP 197,004,658530,Heyman; Gail D.,9998,0,9999,1
1715606190796,AIP 197,005,658631,Neal; Sonya E,9998,0,9999,1
1715606190796,AIP 197,006,658671,Du; Songzi,9998,0,9999,1
1715606191824,ANAR 135S,A00,494369,Braswell; Geoffrey E.,0,0,0,0
1715606192852,BENG 196,001,628496,Engler; Adam J.,9998,0,9999,1
1715606192852,BENG 196,002,660916,Watson; John Thomas,9999,0,9999,0
1715606193896,BISP 197,001,650773,Wilhelm; James E.,9994,0,9999,5
1715606193896,BISP 197,002,658904,Coleman; Aaron B.,9998,0,9999,1
1715606194921,CAT 124RS,A01,519847,Geibel; William,0,0,20,20
1715606195948,CAT 125RS,A01,515971,Geibel; William,0,0,20,20
1715606196975,CLRE 250,A00,511389,Morris; Sheldon,9992,0,9999,7
1715606198004,CLRE 251,A00,507176,Mehta; Ravindra L.,9992,0,9999,7
1715606198004,CLRE 251,B00,511410,Mehta; Ravindra L.,9998,0,9999,1
1715606199037,CLRE 252,A00,507189,Cuomo; Raphael Eduardo,9994,0,9999,5
1715606200069,CLRE 253,A00,507199,Vaida; Florin,9994,0,9999,5
1715606200069,CLRE 253,B00,507202,Vaida; Florin,9999,0,9999,0
1715606201097,CLRE 259,A00,507211,Patel; Hemal,9996,0,9999,3
1715606202124,CLRE 260,A00,507221,Cuomo; Raphael Eduardo,9999,0,9999,0
1715606203149,CLRE 297,001,507242,Cuomo; Raphael Eduardo,9999,0,9999,0
1715606204180,COGS 197,001,638244,Voytek; Bradley Thomas,9997,0,9999,2
1715606205209,CSE 191,A00,516875,Minnes Kemp; Mor Mia,9991,0,9999,8
1715606206234,CSE 197,001,637388,Minnes Kemp; Mor Mia,9992,0,9999,7
1715606207261,CSS 201S,A01,494383,Mignozzetti; Umberto,35,0,35,0
1715606208287,CSS 202S,A01,494387,Mignozzetti; Umberto,35,0,35,0
1715606209312,DSC 197,001,628532,Eldridge; Justin Matthew,9995,0,9999,4
1715606210337,EAP 100,A00,516065,Staff,9799,0,9999,200
1715606211368,ECE 45,A01,507414,Staff,31,0,60,29
1715606213423,ECE 111,A01,507420,Staff,11,0,50,39
1715606214452,ECE 197,001,548057,Sievenpiper; Daniel F.,9991,0,9999,8
1715606215485,EDS 115,A00,507243,Choi; Bailey Miyeon,7,0,28,21
1715606216511,EDS 117,A01,494379,Staff,0,6,34,34
1715606217539,EDS 125,A00,507246,Hopkins; Megan Beth,8,0,30,22
1715606218570,EDS 128A,A01,507264,Fargason; Sharon Gayle,6,0,26,20
1715606219596,EDS 128B,A01,507293,Pappas; Elizabeth,10,0,30,20
1715606220646,EDS 139,A00,507294,Fargason; Sharon Gayle,10,0,30,20
1715606220646,EDS 139,B00,507313,Pappas; Elizabeth,11,0,30,19
1715606221674,EDS 201,A00,507315,Staff,10,0,30,20
1715606222701,EDS 203,A01,507317,Halter; Christopher P.,10,0,30,20
1715606223731,EDS 204R,A01,507319,Halter; Christopher P.,0,3,30,30
1715606223731,EDS 204R,B01,507331,Heinzman; Erica M.,14,0,30,16
1715606224759,EDS 206R,A00,507332,Staff,0,4,30,30
1715606224759,EDS 206R,B00,507343,Staff,15,0,30,15
1715606225789,EDS 250,A00,507344,Hemans; Patricia Ann Benitez,20,0,40,20
1715606226816,EDS 281,A00,507345,Daly; Alan J.,18,0,18,0
1715606227840,EDS 284,A00,507350,Daly; Alan J.,16,0,16,0
1715606228865,EDS 286,A00,507359,Fine; Sarah,18,0,18,0
1715606229890,EDS 289C,A01,507361,Daly; Alan J.,18,0,18,0
1715606230918,EDS 290,A00,507366,Hofstetter; Carolyn,15,0,15,0
1715606231946,LIGM 5A,A00,507421,Fischer-Grunski; Eva K,17,0,20,3
1715606232971,LIGM 5B,A00,507423,Fischer-Grunski; Eva K,19,0,20,1
1715606233996,LIGM 5C,A00,507425,Fischer-Grunski; Eva K,19,0,20,1
1715606235024,LIIT 5AS,A00,507427,Carnelos; Chiara,20,0,20,0
1715606236049,LIIT 5BS,A00,507430,Carnelos; Chiara,20,0,20,0
1715606237074,LIIT 5CS,A00,507432,Carnelos; Chiara,20,0,20,0
1715606238105,LISP 5A,A00,507541,Munoz Sanchez; Alicia,11,0,20,9
1715606239135,LISP 5B,A00,507671,Munoz Sanchez; Alicia,9,0,20,11
1715606240161,LISP 5C,A00,507696,Munoz Sanchez; Alicia,9,0,20,11
1715606241187,MAE 197,001,528363,Boechler; Nicholas Sebastia,9998,0,9999,1
1715606242218,MATH 197,001,523477,Kedlaya; Kiran S.,9994,0,9999,5
1715606242218,MATH 197,002,563811,Zhang; Danna,9994,0,9999,5
1715606242218,MATH 197,003,628552,Dumitriu; Ioana,9998,0,9999,1
1715606242218,MATH 197,004,660885,Floyd; Eric,9999,0,9999,0
1715606243244,MCWP 40R,A00,518780,Staff,2,0,20,18
1715606243244,MCWP 40R,B00,518781,Staff,11,0,20,9
1715606243244,MCWP 40R,C00,518783,Staff,5,0,20,15
1715606244276,MCWP 50R,A00,518791,Staff,0,1,20,20
1715606244276,MCWP 50R,B00,518792,Staff,0,2,20,20
1715606244276,MCWP 50R,C00,518793,Staff,0,4,20,20
1715606244276,MCWP 50R,D00,518794,Staff,0,1,20,20
1715606244276,MCWP 50R,E00,518795,Staff,0,2,20,20
1715606244276,MCWP 50R,F00,518796,Staff,0,1,20,20
1715606244276,MCWP 50R,G00,518797,Staff,0,1,20,20
1715606245310,MMW 12R,A01,514034,Herbst; Matthew,0,2,16,16
1715606245310,MMW 12R,A02,514035,Herbst; Matthew,0,0,16,16
1715606246334,MMW 13R,A01,514037,Staff,0,5,16,16
1715606246334,MMW 13R,A02,514039,Staff,0,5,16,16
1715606246334,MMW 13R,A03,628519,Staff,0,4,16,16
1715606248386,SIO 295LS,A00,523233,Staff,10,0,30,20
1715606249414,SIO 295S,A00,523232,Staff,10,0,30,20
1715606250442,SIOC 290S,A01,637330,Merrifield; Mark A,23,0,30,7
1715606251472,SIOC 291S,A01,637333,Gabriel; Corey John,23,0,30,7
1715606252499,SOCI 117,A01,494376,Staff,0,5,5,5
1715606253528,WES 237B,A00,494380,Staff,10,0,20,10
1715606255621,AESE 279B,A00,494370,Wade; Jon P,0,0,33,33
1715606256650,AIP 97,001,660915,Van Den Einde; Yael Dahlia,9999,0,9999,0
1715606257686,AIP 197,001,627712,Vespa; Emanuel Ignacio,9995,0,9999,4
1715606257686,AIP 197,002,650778,Amir; On,9998,0,9999,1
1715606257686,AIP 197,003,650933,Avenancio-Leon; Carlos,9998,0,9999,1
1715606257686,AIP 197,004,658530,Heyman; Gail D.,9998,0,9999,1
1715606257686,AIP 197,005,658631,Neal; Sonya E,9998,0,9999,1
1715606257686,AIP 197,006,658671,Du; Songzi,9998,0,9999,1
1715606258716,ANAR 135S,A00,494369,Braswell; Geoffrey E.,0,0,0,0
1715606259743,BENG 196,001,628496,Engler; Adam J.,9998,0,9999,1
1715606259743,BENG 196,002,660916,Watson; John Thomas,9999,0,9999,0
1715606260770,BISP 197,001,650773,Wilhelm; James E.,9994,0,9999,5
1715606260770,BISP 197,002,658904,Coleman; Aaron B.,9998,0,9999,1
1715606261800,CAT 124RS,A01,519847,Geibel; William,0,0,20,20
1715606262826,CAT 125RS,A01,515971,Geibel; William,0,0,20,20
1715606263852,CLRE 250,A00,511389,Morris; Sheldon,9992,0,9999,7
1715606264885,CLRE 251,A00,507176,Mehta; Ravindra L.,9992,0,9999,7
1715606264885,CLRE 251,B00,511410,Mehta; Ravindra L.,9998,0,9999,1
1715606265913,CLRE 252,A00,507189,Cuomo; Raphael Eduardo,9994,0,9999,5
1715606266939,CLRE 253,A00,507199,Vaida; Florin,9994,0,9999,5
1715606266939,CLRE 253,B00,507202,Vaida; Florin,9999,0,9999,0
1715606267964,CLRE 259,A00,507211,Patel; Hemal,9996,0,9999,3
1715606268990,CLRE 260,A00,507221,Cuomo; Raphael Eduardo,9999,0,9999,0
1715606270015,CLRE 297,001,507242,Cuomo; Raphael Eduardo,9999,0,9999,0
1715606271046,COGS 197,001,638244,Voytek; Bradley Thomas,9997,0,9999,2
1715606272080,CSE 191,A00,516875,Minnes Kemp; Mor Mia,9991,0,9999,8
1715606273106,CSE 197,001,637388,Minnes Kemp; Mor Mia,9992,0,9999,7
1715606274138,CSS 201S,A01,494383,Mignozzetti; Umberto,35,0,35,0
1715606275170,CSS 202S,A01,494387,Mignozzetti; Umberto,35,0,35,0
1715606276200,DSC 197,001,628532,Eldridge; Justin Matthew,9995,0,9999,4
1715606277228,EAP 100,A00,516065,Staff,9799,0,9999,200
1715606278263,ECE 45,A01,507414,Staff,31,0,60,29
1715606280316,ECE 111,A01,507420,Staff,11,0,50,39
1715606281345,ECE 197,001,548057,Sievenpiper; Daniel F.,9991,0,9999,8
1715606282373,EDS 115,A00,507243,Choi; Bailey Miyeon,7,0,28,21
1715606283399,EDS 117,A01,494379,Staff,0,6,34,34
1715606284423,EDS 125,A00,507246,Hopkins; Megan Beth,8,0,30,22
1715606285453,EDS 128A,A01,507264,Fargason; Sharon Gayle,6,0,26,20
1715606286481,EDS 128B,A01,507293,Pappas; Elizabeth,10,0,30,20
1715606287506,EDS 139,A00,507294,Fargason; Sharon Gayle,10,0,30,20
1715606287506,EDS 139,B00,507313,Pappas; Elizabeth,11,0,30,19
1715606288532,EDS 201,A00,507315,Staff,10,0,30,20
1715606289557,EDS 203,A01,507317,Halter; Christopher P.,10,0,30,20
1715606290584,EDS 204R,A01,507319,Halter; Christopher P.,0,3,30,30
1715606290584,EDS 204R,B01,507331,Heinzman; Erica M.,14,0,30,16
1715606291609,EDS 206R,A00,507332,Staff,0,4,30,30
1715606291609,EDS 206R,B00,507343,Staff,15,0,30,15
1715606292634,EDS 250,A00,507344,Hemans; Patricia Ann Benitez,20,0,40,20
1715606293662,EDS 281,A00,507345,Daly; Alan J.,18,0,18,0
1715606294686,EDS 284,A00,507350,Daly; Alan J.,16,0,16,0
1715606295712,EDS 286,A00,507359,Fine; Sarah,18,0,18,0
1715606296739,EDS 289C,A01,507361,Daly; Alan J.,18,0,18,0
1715606297764,EDS 290,A00,507366,Hofstetter; Carolyn,15,0,15,0
1715606298793,LIGM 5A,A00,507421,Fischer-Grunski; Eva K,17,0,20,3
1715606299822,LIGM 5B,A00,507423,Fischer-Grunski; Eva K,19,0,20,1
1715606300849,LIGM 5C,A00,507425,Fischer-Grunski; Eva K,19,0,20,1
1715606301878,LIIT 5AS,A00,507427,Carnelos; Chiara,20,0,20,0
1715606302906,LIIT 5BS,A00,507430,Carnelos; Chiara,20,0,20,0
1715606303935,LIIT 5CS,A00,507432,Carnelos; Chiara,20,0,20,0
1715606304966,LISP 5A,A00,507541,Munoz Sanchez; Alicia,11,0,20,9
1715606305993,LISP 5B,A00,507671,Munoz Sanchez; Alicia,9,0,20,11
1715606307020,LISP 5C,A00,507696,Munoz Sanchez; Alicia,9,0,20,11
1715606308046,MAE 197,001,528363,Boechler; Nicholas Sebastia,9998,0,9999,1
1715606309076,MATH 197,001,523477,Kedlaya; Kiran S.,9994,0,9999,5
1715606309076,MATH 197,002,563811,Zhang; Danna,9994,0,9999,5
1715606309076,MATH 197,003,628552,Dumitriu; Ioana,9998,0,9999,1
1715606309076,MATH 197,004,660885,Floyd; Eric,9999,0,9999,0
1715606310106,MCWP 40R,A00,518780,Staff,2,0,20,18
1715606310106,MCWP 40R,B00,518781,Staff,11,0,20,9
1715606310106,MCWP 40R,C00,518783,Staff,5,0,20,15
1715606311132,MCWP 50R,A00,518791,Staff,0,1,20,20
1715606311132,MCWP 50R,B00,518792,Staff,0,2,20,20
1715606311132,MCWP 50R,C00,518793,Staff,0,4,20,20
1715606311132,MCWP 50R,D00,518794,Staff,0,1,20,20
1715606311132,MCWP 50R,E00,518795,Staff,0,2,20,20
1715606311132,MCWP 50R,F00,518796,Staff,0,1,20,20
1715606311132,MCWP 50R,G00,518797,Staff,0,1,20,20
1715606312161,MMW 12R,A01,514034,Herbst; Matthew,0,2,16,16
1715606312161,MMW 12R,A02,514035,Herbst; Matthew,0,0,16,16
1715606313187,MMW 13R,A01,514037,Staff,0,5,16,16
1715606313187,MMW 13R,A02,514039,Staff,0,5,16,16
1715606313187,MMW 13R,A03,628519,Staff,0,4,16,16
1715606315237,SIO 295LS,A00,523233,Staff,10,0,30,20
1715606316261,SIO 295S,A00,523232,Staff,10,0,30,20
1715606317288,SIOC 290S,A01,637330,Merrifield; Mark A,23,0,30,7
1715606318319,SIOC 291S,A01,637333,Gabriel; Corey John,23,0,30,7
1715606319345,SOCI 117,A01,494376,Staff,0,5,5,5
1715606320374,WES 237B,A00,494380,Staff,10,0,20,10
1715606322447,AESE 279B,A00,494370,Wade; Jon P,0,0,33,33
1715606323472,AIP 97,001,660915,Van Den Einde; Yael Dahlia,9999,0,9999,0
1715606324500,AIP 197,001,627712,Vespa; Emanuel Ignacio,9995,0,9999,4
1715606324500,AIP 197,002,650778,Amir; On,9998,0,9999,1
1715606324500,AIP 197,003,650933,Avenancio-Leon; Carlos,9998,0,9999,1
1715606324500,AIP 197,004,658530,Heyman; Gail D.,9998,0,9999,1
1715606324500,AIP 197,005,658631,Neal; Sonya E,9998,0,9999,1
1715606324500,AIP 197,006,658671,Du; Songzi,9998,0,9999,1
1715606325525,ANAR 135S,A00,494369,Braswell; Geoffrey E.,0,0,0,0
1715606326555,BENG 196,001,628496,Engler; Adam J.,9998,0,9999,1
1715606326555,BENG 196,002,660916,Watson; John Thomas,9999,0,9999,0
1715606327581,BISP 197,001,650773,Wilhelm; James E.,9994,0,9999,5
1715606327581,BISP 197,002,658904,Coleman; Aaron B.,9998,0,9999,1
1715606328607,CAT 124RS,A01,519847,Geibel; William,0,0,20,20
1715606329633,CAT 125RS,A01,515971,Geibel; William,0,0,20,20
1715606330660,CLRE 250,A00,511389,Morris; Sheldon,9992,0,9999,7
1715606331687,CLRE 251,A00,507176,Mehta; Ravindra L.,9992,0,9999,7
1715606331687,CLRE 251,B00,511410,Mehta; Ravindra L.,9998,0,9999,1
1715606332713,CLRE 252,A00,507189,Cuomo; Raphael Eduardo,9994,0,9999,5
1715606333742,CLRE 253,A00,507199,Vaida; Florin,9994,0,9999,5
1715606333742,CLRE 253,B00,507202,Vaida; Florin,9999,0,9999,0
1715606334769,CLRE 259,A00,507211,Patel; Hemal,9996,0,9999,3
1715606335796,CLRE 260,A00,507221,Cuomo; Raphael Eduardo,9999,0,9999,0
1715606336822,CLRE 297,001,507242,Cuomo; Raphael Eduardo,9999,0,9999,0
1715606337851,COGS 197,001,638244,Voytek; Bradley Thomas,9997,0,9999,2
1715606338876,CSE 191,A00,516875,Minnes Kemp; Mor Mia,9991,0,9999,8
1715606339905,CSE 197,001,637388,Minnes Kemp; Mor Mia,9992,0,9999,7
1715606340935,CSS 201S,A01,494383,Mignozzetti; Umberto,35,0,35,0
1715606341961,CSS 202S,A01,494387,Mignozzetti; Umberto,35,0,35,0
1715606343056,DSC 197,001,628532,Eldridge; Justin Matthew,9995,0,9999,4
1715606344082,EAP 100,A00,516065,Staff,9799,0,9999,200
1715606345110,ECE 45,A01,507414,Staff,31,0,60,29
1715606347167,ECE 111,A01,507420,Staff,11,0,50,39
1715606348197,ECE 197,001,548057,Sievenpiper; Daniel F.,9991,0,9999,8
1715606349224,EDS 115,A00,507243,Choi; Bailey Miyeon,7,0,28,21
1715606350251,EDS 117,A01,494379,Staff,0,6,34,34
1715606351278,EDS 125,A00,507246,Hopkins; Megan Beth,8,0,30,22
1715606352303,EDS 128A,A01,507264,Fargason; Sharon Gayle,6,0,26,20
1715606353332,EDS 128B,A01,507293,Pappas; Elizabeth,10,0,30,20
1715606354358,EDS 139,A00,507294,Fargason; Sharon Gayle,10,0,30,20
1715606354358,EDS 139,B00,507313,Pappas; Elizabeth,11,0,30,19
1715606355386,EDS 201,A00,507315,Staff,10,0,30,20
1715606356416,EDS 203,A01,507317,Halter; Christopher P.,10,0,30,20
1715606357442,EDS 204R,A01,507319,Halter; Christopher P.,0,3,30,30
1715606357442,EDS 204R,B01,507331,Heinzman; Erica M.,14,0,30,16
1715606358471,EDS 206R,A00,507332,Staff,0,4,30,30
1715606358471,EDS 206R,B00,507343,Staff,15,0,30,15
1715606359496,EDS 250,A00,507344,Hemans; Patricia Ann Benitez,20,0,40,20
1715606360522,EDS 281,A00,507345,Daly; Alan J.,18,0,18,0
1715606361550,EDS 284,A00,507350,Daly; Alan J.,16,0,16,0
1715606362581,EDS 286,A00,507359,Fine; Sarah,18,0,18,0
1715606363607,EDS 289C,A01,507361,Daly; Alan J.,18,0,18,0
1715606364632,EDS 290,A00,507366,Hofstetter; Carolyn,15,0,15,0
1715606365664,LIGM 5A,A00,507421,Fischer-Grunski; Eva K,17,0,20,3
1715606366690,LIGM 5B,A00,507423,Fischer-Grunski; Eva K,19,0,20,1
1715606367718,LIGM 5C,A00,507425,Fischer-Grunski; Eva K,19,0,20,1
1715606368745,LIIT 5AS,A00,507427,Carnelos; Chiara,20,0,20,0
1715606369770,LIIT 5BS,A00,507430,Carnelos; Chiara,20,0,20,0
1715606370801,LIIT 5CS,A00,507432,Carnelos; Chiara,20,0,20,0
1715606371828,LISP 5A,A00,507541,Munoz Sanchez; Alicia,11,0,20,9
1715606372857,LISP 5B,A00,507671,Munoz Sanchez; Alicia,9,0,20,11
1715606373886,LISP 5C,A00,507696,Munoz Sanchez; Alicia,9,0,20,11
1715606374913,MAE 197,001,528363,Boechler; Nicholas Sebastia,9998,0,9999,1
1715606375943,MATH 197,001,523477,Kedlaya; Kiran S.,9994,0,9999,5
1715606375943,MATH 197,002,563811,Zhang; Danna,9994,0,9999,5
1715606375943,MATH 197,003,628552,Dumitriu; Ioana,9998,0,9999,1
1715606375943,MATH 197,004,660885,Floyd; Eric,9999,0,9999,0
1715606376969,MCWP 40R,A00,518780,Staff,2,0,20,18
1715606376969,MCWP 40R,B00,518781,Staff,11,0,20,9
1715606376969,MCWP 40R,C00,518783,Staff,5,0,20,15
1715606377998,MCWP 50R,A00,518791,Staff,0,1,20,20
1715606377998,MCWP 50R,B00,518792,Staff,0,2,20,20
1715606377998,MCWP 50R,C00,518793,Staff,0,4,20,20
1715606377998,MCWP 50R,D00,518794,Staff,0,1,20,20
1715606377998,MCWP 50R,E00,518795,Staff,0,2,20,20
1715606377998,MCWP 50R,F00,518796,Staff,0,1,20,20
1715606377998,MCWP 50R,G00,518797,Staff,0,1,20,20
1715606379024,MMW 12R,A01,514034,Herbst; Matthew,0,2,16,16
1715606379024,MMW 12R,A02,514035,Herbst; Matthew,0,0,16,16
1715606380049,MMW 13R,A01,514037,Staff,0,5,16,16
1715606380049,MMW 13R,A02,514039,Staff,0,5,16,16
1715606380049,MMW 13R,A03,628519,Staff,0,4,16,16
1715606382109,SIO 295LS,A00,523233,Staff,10,0,30,20
1715606383134,SIO 295S,A00,523232,Staff,10,0,30,20
1715606384159,SIOC 290S,A01,637330,Merrifield; Mark A,23,0,30,7
1715606385188,SIOC 291S,A01,637333,Gabriel; Corey John,23,0,30,7
1715606386218,SOCI 117,A01,494376,Staff,0,5,5,5
1715606387245,WES 237B,A00,494380,Staff,10,0,20,10
1715606389317,AESE 279B,A00,494370,Wade; Jon P,0,0,33,33
1715606390346,AIP 97,001,660915,Van Den Einde; Yael Dahlia,9999,0,9999,0
1715606391376,AIP 197,001,627712,Vespa; Emanuel Ignacio,9995,0,9999,4
1715606391376,AIP 197,002,650778,Amir; On,9998,0,9999,1
1715606391376,AIP 197,003,650933,Avenancio-Leon; Carlos,9998,0,9999,1
1715606391376,AIP 197,004,658530,Heyman; Gail D.,9998,0,9999,1
1715606391376,AIP 197,005,658631,Neal; Sonya E,9998,0,9999,1
1715606391376,AIP 197,006,658671,Du; Songzi,9998,0,9999,1
1715606392402,ANAR 135S,A00,494369,Braswell; Geoffrey E.,0,0,0,0
1715606393427,BENG 196,001,628496,Engler; Adam J.,9998,0,9999,1
1715606393427,BENG 196,002,660916,Watson; John Thomas,9999,0,9999,0
1715606394453,BISP 197,001,650773,Wilhelm; James E.,9994,0,9999,5
1715606394453,BISP 197,002,658904,Coleman; Aaron B.,9998,0,9999,1
1715606395481,CAT 124RS,A01,519847,Geibel; William,0,0,20,20
1715606396509,CAT 125RS,A01,515971,Geibel; William,0,0,20,20
1715606397534,CLRE 250,A00,511389,Morris; Sheldon,9992,0,9999,7
1715606398568,CLRE 251,A00,507176,Mehta; Ravindra L.,9992,0,9999,7
1715606398568,CLRE 251,B00,511410,Mehta; Ravindra L.,9998,0,9999,1
1715606399595,CLRE 252,A00,507189,Cuomo; Raphael Eduardo,9994,0,9999,5
1715606400621,CLRE 253,A00,507199,Vaida; Florin,9994,0,9999,5
1715606400621,CLRE 253,B00,507202,Vaida; Florin,9999,0,9999,0
1715606401647,CLRE 259,A00,507211,Patel; Hemal,9996,0,9999,3
1715606402673,CLRE 260,A00,507221,Cuomo; Raphael Eduardo,9999,0,9999,0
1715606403697,CLRE 297,001,507242,Cuomo; Raphael Eduardo,9999,0,9999,0
1715606404723,COGS 197,001,638244,Voytek; Bradley Thomas,9997,0,9999,2
1715606405752,CSE 191,A00,516875,Minnes Kemp; Mor Mia,9991,0,9999,8
1715606406780,CSE 197,001,637388,Minnes Kemp; Mor Mia,9992,0,9999,7
1715606407811,CSS 201S,A01,494383,Mignozzetti; Umberto,35,0,35,0
1715606408836,CSS 202S,A01,494387,Mignozzetti; Umberto,35,0,35,0
1715606409862,DSC 197,001,628532,Eldridge; Justin Matthew,9995,0,9999,4
1715606410885,EAP 100,A00,516065,Staff,9799,0,9999,200
1715606411917,ECE 45,A01,507414,Staff,31,0,60,29
1715606413970,ECE 111,A01,507420,Staff,11,0,50,39
1715606414993,ECE 197,001,548057,Sievenpiper; Daniel F.,9991,0,9999,8
1715606416020,EDS 115,A00,507243,Choi; Bailey Miyeon,7,0,28,21
1715606417046,EDS 117,A01,494379,Staff,0,6,34,34
1715606418072,EDS 125,A00,507246,Hopkins; Megan Beth,8,0,30,22
1715606419098,EDS 128A,A01,507264,Fargason; Sharon Gayle,6,0,26,20
1715606420125,EDS 128B,A01,507293,Pappas; Elizabeth,10,0,30,20
1715606421152,EDS 139,A00,507294,Fargason; Sharon Gayle,10,0,30,20
1715606421152,EDS 139,B00,507313,Pappas; Elizabeth,11,0,30,19
1715606422177,EDS 201,A00,507315,Staff,10,0,30,20
1715606423203,EDS 203,A01,507317,Halter; Christopher P.,10,0,30,20
1715606424230,EDS 204R,A01,507319,Halter; Christopher P.,0,3,30,30
1715606424230,EDS 204R,B01,507331,Heinzman; Erica M.,14,0,30,16
1715606425255,EDS 206R,A00,507332,Staff,0,4,30,30
1715606425255,EDS 206R,B00,507343,Staff,15,0,30,15
1715606426282,EDS 250,A00,507344,Hemans; Patricia Ann Benitez,20,0,40,20
1715606427309,EDS 281,A00,507345,Daly; Alan J.,18,0,18,0
1715606428336,EDS 284,A00,507350,Daly; Alan J.,16,0,16,0
1715606429362,EDS 286,A00,507359,Fine; Sarah,18,0,18,0
1715606430388,EDS 289C,A01,507361,Daly; Alan J.,18,0,18,0
1715606431413,EDS 290,A00,507366,Hofstetter; Carolyn,15,0,15,0
1715606432441,LIGM 5A,A00,507421,Fischer-Grunski; Eva K,17,0,20,3
1715606433467,LIGM 5B,A00,507423,Fischer-Grunski; Eva K,19,0,20,1
1715606434497,LIGM 5C,A00,507425,Fischer-Grunski; Eva K,19,0,20,1
1715606435524,LIIT 5AS,A00,507427,Carnelos; Chiara,20,0,20,0
1715606436553,LIIT 5BS,A00,507430,Carnelos; Chiara,20,0,20,0
1715606437580,LIIT 5CS,A00,507432,Carnelos; Chiara,20,0,20,0
1715606438608,LISP 5A,A00,507541,Munoz Sanchez; Alicia,11,0,20,9
1715606439634,LISP 5B,A00,507671,Munoz Sanchez; Alicia,9,0,20,11
1715606440658,LISP 5C,A00,507696,Munoz Sanchez; Alicia,9,0,20,11
1715606441684,MAE 197,001,528363,Boechler; Nicholas Sebastia,9998,0,9999,1
1715606442713,MATH 197,001,523477,Kedlaya; Kiran S.,9994,0,9999,5
1715606442713,MATH 197,002,563811,Zhang; Danna,9994,0,9999,5
1715606442713,MATH 197,003,628552,Dumitriu; Ioana,9998,0,9999,1
1715606442713,MATH 197,004,660885,Floyd; Eric,9999,0,9999,0
1715606443737,MCWP 40R,A00,518780,Staff,2,0,20,18
1715606443737,MCWP 40R,B00,518781,Staff,11,0,20,9
1715606443737,MCWP 40R,C00,518783,Staff,5,0,20,15
1715606444764,MCWP 50R,A00,518791,Staff,0,1,20,20
1715606444764,MCWP 50R,B00,518792,Staff,0,2,20,20
1715606444764,MCWP 50R,C00,518793,Staff,0,4,20,20
1715606444764,MCWP 50R,D00,518794,Staff,0,1,20,20
1715606444764,MCWP 50R,E00,518795,Staff,0,2,20,20
1715606444764,MCWP 50R,F00,518796,Staff,0,1,20,20
1715606444764,MCWP 50R,G00,518797,Staff,0,1,20,20
1715606445795,MMW 12R,A01,514034,Herbst; Matthew,0,2,16,16
1715606445795,MMW 12R,A02,514035,Herbst; Matthew,0,0,16,16
1715606446824,MMW 13R,A01,514037,Staff,0,5,16,16
1715606446824,MMW 13R,A02,514039,Staff,0,5,16,16
1715606446824,MMW 13R,A03,628519,Staff,0,4,16,16
1715606448880,SIO 295LS,A00,523233,Staff,10,0,30,20
1715606449906,SIO 295S,A00,523232,Staff,10,0,30,20
1715606450933,SIOC 290S,A01,637330,Merrifield; Mark A,23,0,30,7
1715606451959,SIOC 291S,A01,637333,Gabriel; Corey John,23,0,30,7
1715606452986,SOCI 117,A01,494376,Staff,0,5,5,5
1715606454014,WES 237B,A00,494380,Staff,10,0,20,10
1715606456104,AESE 279B,A00,494370,Wade; Jon P,0,0,33,33
1715606457131,AIP 97,001,660915,Van Den Einde; Yael Dahlia,9999,0,9999,0
1715606458159,AIP 197,001,627712,Vespa; Emanuel Ignacio,9995,0,9999,4
1715606458159,AIP 197,002,650778,Amir; On,9998,0,9999,1
1715606458159,AIP 197,003,650933,Avenancio-Leon; Carlos,9998,0,9999,1
1715606458159,AIP 197,004,658530,Heyman; Gail D.,9998,0,9999,1
1715606458159,AIP 197,005,658631,Neal; Sonya E,9998,0,9999,1
1715606458159,AIP 197,006,658671,Du; Songzi,9998,0,9999,1
1715606459189,ANAR 135S,A00,494369,Braswell; Geoffrey E.,0,0,0,0
1715606460215,BENG 196,001,628496,Engler; Adam J.,9998,0,9999,1
1715606460215,BENG 196,002,660916,Watson; John Thomas,9999,0,9999,0
1715606461244,BISP 197,001,650773,Wilhelm; James E.,9994,0,9999,5
1715606461244,BISP 197,002,658904,Coleman; Aaron B.,9998,0,9999,1
1715606462274,CAT 124RS,A01,519847,Geibel; William,0,0,20,20
1715606463301,CAT 125RS,A01,515971,Geibel; William,0,0,20,20
1715606464327,CLRE 250,A00,511389,Morris; Sheldon,9992,0,9999,7
1715606465359,CLRE 251,A00,507176,Mehta; Ravindra L.,9992,0,9999,7
1715606465359,CLRE 251,B00,511410,Mehta; Ravindra L.,9998,0,9999,1
1715606466395,CLRE 252,A00,507189,Cuomo; Raphael Eduardo,9994,0,9999,5
1715606467421,CLRE 253,A00,507199,Vaida; Florin,9994,0,9999,5
1715606467421,CLRE 253,B00,507202,Vaida; Florin,9999,0,9999,0
1715606468450,CLRE 259,A00,507211,Patel; Hemal,9996,0,9999,3
1715606469476,CLRE 260,A00,507221,Cuomo; Raphael Eduardo,9999,0,9999,0
1715606470505,CLRE 297,001,507242,Cuomo; Raphael Eduardo,9999,0,9999,0
1715606471534,COGS 197,001,638244,Voytek; Bradley Thomas,9997,0,9999,2
1715606472560,CSE 191,A00,516875,Minnes Kemp; Mor Mia,9991,0,9999,8
1715606473640,CSE 197,001,637388,Minnes Kemp; Mor Mia,9992,0,9999,7
1715606474669,CSS 201S,A01,494383,Mignozzetti; Umberto,35,0,35,0
1715606475695,CSS 202S,A01,494387,Mignozzetti; Umberto,35,0,35,0
1715606476721,DSC 197,001,628532,Eldridge; Justin Matthew,9995,0,9999,4
1715606477746,EAP 100,A00,516065,Staff,9799,0,9999,200
1715606478778,ECE 45,A01,507414,Staff,31,0,60,29
1715606480834,ECE 111,A01,507420,Staff,11,0,50,39
1715606481860,ECE 197,001,548057,Sievenpiper; Daniel F.,9991,0,9999,8
1715606482887,EDS 115,A00,507243,Choi; Bailey Miyeon,7,0,28,21
1715606483914,EDS 117,A01,494379,Staff,0,6,34,34
1715606484946,EDS 125,A00,507246,Hopkins; Megan Beth,8,0,30,22
1715606485971,EDS 128A,A01,507264,Fargason; Sharon Gayle,6,0,26,20
1715606486997,EDS 128B,A01,507293,Pappas; Elizabeth,10,0,30,20
1715606488022,EDS 139,A00,507294,Fargason; Sharon Gayle,10,0,30,20
1715606488022,EDS 139,B00,507313,Pappas; Elizabeth,11,0,30,19
1715606489046,EDS 201,A00,507315,Staff,10,0,30,20
1715606490074,EDS 203,A01,507317,Halter; Christopher P.,10,0,30,20
1715606491100,EDS 204R,A01,507319,Halter; Christopher P.,0,3,30,30
1715606491100,EDS 204R,B01,507331,Heinzman; Erica M.,14,0,30,16
1715606492129,EDS 206R,A00,507332,Staff,0,4,30,30
1715606492129,EDS 206R,B00,507343,Staff,15,0,30,15
1715606493157,EDS 250,A00,507344,Hemans; Patricia Ann Benitez,20,0,40,20
1715606494183,EDS 281,A00,507345,Daly; Alan J.,18,0,18,0
1715606495207,EDS 284,A00,507350,Daly; Alan J.,16,0,16,0
1715606496232,EDS 286,A00,507359,Fine; Sarah,18,0,18,0
1715606497256,EDS 289C,A01,507361,Daly; Alan J.,18,0,18,0
1715606498283,EDS 290,A00,507366,Hofstetter; Carolyn,15,0,15,0
1715606499309,LIGM 5A,A00,507421,Fischer-Grunski; Eva K,17,0,20,3
1715606500336,LIGM 5B,A00,507423,Fischer-Grunski; Eva K,19,0,20,1
1715606501361,LIGM 5C,A00,507425,Fischer-Grunski; Eva K,19,0,20,1
1715606502387,LIIT 5AS,A00,507427,Carnelos; Chiara,20,0,20,0
1715606503414,LIIT 5BS,A00,507430,Carnelos; Chiara,20,0,20,0
1715606504442,LIIT 5CS,A00,507432,Carnelos; Chiara,20,0,20,0
1715606505470,LISP 5A,A00,507541,Munoz Sanchez; Alicia,11,0,20,9
1715606506496,LISP 5B,A00,507671,Munoz Sanchez; Alicia,9,0,20,11
1715606507521,LISP 5C,A00,507696,Munoz Sanchez; Alicia,9,0,20,11
1715606508547,MAE 197,001,528363,Boechler; Nicholas Sebastia,9998,0,9999,1
1715606509574,MATH 197,001,523477,Kedlaya; Kiran S.,9994,0,9999,5
1715606509574,MATH 197,002,563811,Zhang; Danna,9994,0,9999,5
1715606509574,MATH 197,003,628552,Dumitriu; Ioana,9998,0,9999,1
1715606509574,MATH 197,004,660885,Floyd; Eric,9999,0,9999,0
1715606510602,MCWP 40R,A00,518780,Staff,2,0,20,18
1715606510602,MCWP 40R,B00,518781,Staff,11,0,20,9
1715606510602,MCWP 40R,C00,518783,Staff,5,0,20,15
1715606511647,MCWP 50R,A00,518791,Staff,0,1,20,20
1715606511647,MCWP 50R,B00,518792,Staff,0,2,20,20
1715606511647,MCWP 50R,C00,518793,Staff,0,4,20,20
1715606511647,MCWP 50R,D00,518794,Staff,0,1,20,20
1715606511647,MCWP 50R,E00,518795,Staff,0,2,20,20
1715606511647,MCWP 50R,F00,518796,Staff,0,1,20,20
1715606511647,MCWP 50R,G00,518797,Staff,0,1,20,20
1715606512673,MMW 12R,A01,514034,Herbst; Matthew,0,2,16,16
1715606512673,MMW 12R,A02,514035,Herbst; Matthew,0,0,16,16
1715606513698,MMW 13R,A01,514037,Staff,0,5,16,16
1715606513698,MMW 13R,A02,514039,Staff,0,5,16,16
1715606513698,MMW 13R,A03,628519,Staff,0,4,16,16
1715606515752,SIO 295LS,A00,523233,Staff,10,0,30,20
1715606516782,SIO 295S,A00,523232,Staff,10,0,30,20
1715606517808,SIOC 290S,A01,637330,Merrifield; Mark A,23,0,30,7
1715606518835,SIOC 291S,A01,637333,Gabriel; Corey John,23,0,30,7
1715606519860,SOCI 117,A01,494376,Staff,0,5,5,5
1715606520888,WES 237B,A00,494380,Staff,10,0,20,10
1715606522961,AESE 279B,A00,494370,Wade; Jon P,0,0,33,33
1715606523987,AIP 97,001,660915,Van Den Einde; Yael Dahlia,9999,0,9999,0
1715606525018,AIP 197,001,627712,Vespa; Emanuel Ignacio,9995,0,9999,4
1715606525018,AIP 197,002,650778,Amir; On,9998,0,9999,1
1715606525018,AIP 197,003,650933,Avenancio-Leon; Carlos,9998,0,9999,1
1715606525018,AIP 197,004,658530,Heyman; Gail D.,9998,0,9999,1
1715606525018,AIP 197,005,658631,Neal; Sonya E,9998,0,9999,1
1715606525018,AIP 197,006,658671,Du; Songzi,9998,0,9999,1
1715606526045,ANAR 135S,A00,494369,Braswell; Geoffrey E.,0,0,0,0
1715606527072,BENG 196,001,628496,Engler; Adam J.,9998,0,9999,1
1715606527072,BENG 196,002,660916,Watson; John Thomas,9999,0,9999,0
1715606528098,BISP 197,001,650773,Wilhelm; James E.,9994,0,9999,5
1715606528098,BISP 197,002,658904,Coleman; Aaron B.,9998,0,9999,1
1715606529129,CAT 124RS,A01,519847,Geibel; William,0,0,20,20
1715606530155,CAT 125RS,A01,515971,Geibel; William,0,0,20,20
1715606531180,CLRE 250,A00,511389,Morris; Sheldon,9992,0,9999,7
1715606532211,CLRE 251,A00,507176,Mehta; Ravindra L.,9992,0,9999,7
1715606532211,CLRE 251,B00,511410,Mehta; Ravindra L.,9998,0,9999,1
1715606533239,CLRE 252,A00,507189,Cuomo; Raphael Eduardo,9994,0,9999,5
1715606534269,CLRE 253,A00,507199,Vaida; Florin,9994,0,9999,5
1715606534269,CLRE 253,B00,507202,Vaida; Florin,9999,0,9999,0
1715606535296,CLRE 259,A00,507211,Patel; Hemal,9996,0,9999,3
1715606536322,CLRE 260,A00,507221,Cuomo; Raphael Eduardo,9999,0,9999,0
1715606537347,CLRE 297,001,507242,Cuomo; Raphael Eduardo,9999,0,9999,0
1715606538373,COGS 197,001,638244,Voytek; Bradley Thomas,9997,0,9999,2
1715606539401,CSE 191,A00,516875,Minnes Kemp; Mor Mia,9991,0,9999,8
1715606540430,CSE 197,001,637388,Minnes Kemp; Mor Mia,9992,0,9999,7
1715606541457,CSS 201S,A01,494383,Mignozzetti; Umberto,35,0,35,0
1715606542486,CSS 202S,A01,494387,Mignozzetti; Umberto,35,0,35,0
1715606543515,DSC 197,001,628532,Eldridge; Justin Matthew,9995,0,9999,4
1715606544544,EAP 100,A00,516065,Staff,9799,0,9999,200
1715606545570,ECE 45,A01,507414,Staff,31,0,60,29
1715606547619,ECE 111,A01,507420,Staff,11,0,50,39
1715606548647,ECE 197,001,548057,Sievenpiper; Daniel F.,9991,0,9999,8
1715606549676,EDS 115,A00,507243,Choi; Bailey Miyeon,7,0,28,21
1715606550704,EDS 117,A01,494379,Staff,0,6,34,34
1715606551733,EDS 125,A00,507246,Hopkins; Megan Beth,8,0,30,22
1715606552763,EDS 128A,A01,507264,Fargason; Sharon Gayle,6,0,26,20
1715606553793,EDS 128B,A01,507293,Pappas; Elizabeth,10,0,30,20
1715606554820,EDS 139,A00,507294,Fargason; Sharon Gayle,10,0,30,20
1715606554820,EDS 139,B00,507313,Pappas; Elizabeth,11,0,30,19
1715606555846,EDS 201,A00,507315,Staff,10,0,30,20
1715606556874,EDS 203,A01,507317,Halter; Christopher P.,10,0,30,20
1715606557904,EDS 204R,A01,507319,Halter; Christopher P.,0,3,30,30
1715606557904,EDS 204R,B01,507331,Heinzman; Erica M.,14,0,30,16
1715606558931,EDS 206R,A00,507332,Staff,0,4,30,30
1715606558931,EDS 206R,B00,507343,Staff,15,0,30,15
1715606559959,EDS 250,A00,507344,Hemans; Patricia Ann Benitez,20,0,40,20
1715606560986,EDS 281,A00,507345,Daly; Alan J.,18,0,18,0
1715606562015,EDS 284,A00,507350,Daly; Alan J.,16,0,16,0
1715606563043,EDS 286,A00,507359,Fine; Sarah,18,0,18,0
1715606564071,EDS 289C,A01,507361,Daly; Alan J.,18,0,18,0
1715606565099,EDS 290,A00,507366,Hofstetter; Carolyn,15,0,15,0
1715606566126,LIGM 5A,A00,507421,Fischer-Grunski; Eva K,17,0,20,3
1715606567152,LIGM 5B,A00,507423,Fischer-Grunski; Eva K,19,0,20,1
1715606568180,LIGM 5C,A00,507425,Fischer-Grunski; Eva K,19,0,20,1
1715606569206,LIIT 5AS,A00,507427,Carnelos; Chiara,20,0,20,0
1715606570231,LIIT 5BS,A00,507430,Carnelos; Chiara,20,0,20,0
1715606571261,LIIT 5CS,A00,507432,Carnelos; Chiara,20,0,20,0
1715606572288,LISP 5A,A00,507541,Munoz Sanchez; Alicia,11,0,20,9
1715606573319,LISP 5B,A00,507671,Munoz Sanchez; Alicia,9,0,20,11
1715606574344,LISP 5C,A00,507696,Munoz Sanchez; Alicia,9,0,20,11
1715606575371,MAE 197,001,528363,Boechler; Nicholas Sebastia,9998,0,9999,1
1715606576399,MATH 197,001,523477,Kedlaya; Kiran S.,9994,0,9999,5
1715606576399,MATH 197,002,563811,Zhang; Danna,9994,0,9999,5
1715606576399,MATH 197,003,628552,Dumitriu; Ioana,9998,0,9999,1
1715606576399,MATH 197,004,660885,Floyd; Eric,9999,0,9999,0
1715606577483,MCWP 40R,A00,518780,Staff,2,0,20,18
1715606577483,MCWP 40R,B00,518781,Staff,11,0,20,9
1715606577483,MCWP 40R,C00,518783,Staff,5,0,20,15
1715606578509,MCWP 50R,A00,518791,Staff,0,1,20,20
1715606578509,MCWP 50R,B00,518792,Staff,0,2,20,20
1715606578509,MCWP 50R,C00,518793,Staff,0,4,20,20
1715606578509,MCWP 50R,D00,518794,Staff,0,1,20,20
1715606578509,MCWP 50R,E00,518795,Staff,0,2,20,20
1715606578509,MCWP 50R,F00,518796,Staff,0,1,20,20
1715606578509,MCWP 50R,G00,518797,Staff,0,1,20,20
1715606579535,MMW 12R,A01,514034,Herbst; Matthew,0,2,16,16
1715606579535,MMW 12R,A02,514035,Herbst; Matthew,0,0,16,16
1715606580563,MMW 13R,A01,514037,Staff,0,5,16,16
1715606580563,MMW 13R,A02,514039,Staff,0,5,16,16
1715606580563,MMW 13R,A03,628519,Staff,0,4,16,16
1715606582619,SIO 295LS,A00,523233,Staff,10,0,30,20
1715606583645,SIO 295S,A00,523232,Staff,10,0,30,20
1715606584671,SIOC 290S,A01,637330,Merrifield; Mark A,23,0,30,7
1715606585701,SIOC 291S,A01,637333,Gabriel; Corey John,23,0,30,7
1715606586732,SOCI 117,A01,494376,Staff,0,5,5,5
1715606587757,WES 237B,A00,494380,Staff,10,0,20,10
1715606589844,AESE 279B,A00,494370,Wade; Jon P,0,0,33,33
1715606590874,AIP 97,001,660915,Van Den Einde; Yael Dahlia,9999,0,9999,0
1715606591902,AIP 197,001,627712,Vespa; Emanuel Ignacio,9995,0,9999,4
1715606591902,AIP 197,002,650778,Amir; On,9998,0,9999,1
1715606591902,AIP 197,003,650933,Avenancio-Leon; Carlos,9998,0,9999,1
1715606591902,AIP 197,004,658530,Heyman; Gail D.,9998,0,9999,1
1715606591902,AIP 197,005,658631,Neal; Sonya E,9998,0,9999,1
1715606591902,AIP 197,006,658671,Du; Songzi,9998,0,9999,1
1715606592934,ANAR 135S,A00,494369,Braswell; Geoffrey E.,0,0,0,0
1715606593962,BENG 196,001,628496,Engler; Adam J.,9998,0,9999,1
1715606593962,BENG 196,002,660916,Watson; John Thomas,9999,0,9999,0
1715606594992,BISP 197,001,650773,Wilhelm; James E.,9994,0,9999,5
1715606594992,BISP 197,002,658904,Coleman; Aaron B.,9998,0,9999,1
1715606596016,CAT 124RS,A01,519847,Geibel; William,0,0,20,20
1715606597040,CAT 125RS,A01,515971,Geibel; William,0,0,20,20
1715606598065,CLRE 250,A00,511389,Morris; Sheldon,9992,0,9999,7
1715606599094,CLRE 251,A00,507176,Mehta; Ravindra L.,9992,0,9999,7
1715606599094,CLRE 251,B00,511410,Mehta; Ravindra L.,9998,0,9999,1
1715606600124,CLRE 252,A00,507189,Cuomo; Raphael Eduardo,9994,0,9999,5
1715606601151,CLRE 253,A00,507199,Vaida; Florin,9994,0,9999,5
1715606601151,CLRE 253,B00,507202,Vaida; Florin,9999,0,9999,0
1715606602179,CLRE 259,A00,507211,Patel; Hemal,9996,0,9999,3
1715606603205,CLRE 260,A00,507221,Cuomo; Raphael Eduardo,9999,0,9999,0
1715606604234,CLRE 297,001,507242,Cuomo; Raphael Eduardo,9999,0,9999,0
1715606605260,COGS 197,001,638244,Voytek; Bradley Thomas,9997,0,9999,2
1715606606286,CSE 191,A00,516875,Minnes Kemp; Mor Mia,9991,0,9999,8
1715606607312,CSE 197,001,637388,Minnes Kemp; Mor Mia,9992,0,9999,7
1715606608339,CSS 201S,A01,494383,Mignozzetti; Umberto,35,0,35,0
1715606609367,CSS 202S,A01,494387,Mignozzetti; Umberto,35,0,35,0
1715606610394,DSC 197,001,628532,Eldridge; Justin Matthew,9995,0,9999,4
1715606611422,EAP 100,A00,516065,Staff,9799,0,9999,200
1715606612455,ECE 45,A01,507414,Staff,31,0,60,29
1715606614509,ECE 111,A01,507420,Staff,11,0,50,39
1715606615534,ECE 197,001,548057,Sievenpiper; Daniel F.,9991,0,9999,8
1715606616560,EDS 115,A00,507243,Choi; Bailey Miyeon,7,0,28,21
1715606617590,EDS 117,A01,494379,Staff,0,6,34,34
1715606618615,EDS 125,A00,507246,Hopkins; Megan Beth,8,0,30,22
1715606619644,EDS 128A,A01,507264,Fargason; Sharon Gayle,6,0,26,20
1715606620671,EDS 128B,A01,507293,Pappas; Elizabeth,10,0,30,20
1715606621696,EDS 139,A00,507294,Fargason; Sharon Gayle,10,0,30,20
1715606621696,EDS 139,B00,507313,Pappas; Elizabeth,11,0,30,19
1715606622722,EDS 201,A00,507315,Staff,10,0,30,20
1715606623750,EDS 203,A01,507317,Halter; Christopher P.,10,0,30,20
1715606624780,EDS 204R,A01,507319,Halter; Christopher P.,0,3,30,30
1715606624780,EDS 204R,B01,507331,Heinzman; Erica M.,14,0,30,16
1715606625806,EDS 206R,A00,507332,Staff,0,4,30,30
1715606625806,EDS 206R,B00,507343,Staff,15,0,30,15
1715606626835,EDS 250,A00,507344,Hemans; Patricia Ann Benitez,20,0,40,20
1715606627861,EDS 281,A00,507345,Daly; Alan J.,18,0,18,0
1715606628887,EDS 284,A00,507350,Daly; Alan J.,16,0,16,0
1715606629914,EDS 286,A00,507359,Fine; Sarah,18,0,18,0
1715606630941,EDS 289C,A01,507361,Daly; Alan J.,18,0,18,0
1715606631969,EDS 290,A00,507366,Hofstetter; Carolyn,15,0,15,0
1715606632997,LIGM 5A,A00,507421,Fischer-Grunski; Eva K,17,0,20,3
1715606634026,LIGM 5B,A00,507423,Fischer-Grunski; Eva K,19,0,20,1
1715606635052,LIGM 5C,A00,507425,Fischer-Grunski; Eva K,19,0,20,1
1715606636083,LIIT 5AS,A00,507427,Carnelos; Chiara,20,0,20,0
1715606637112,LIIT 5BS,A00,507430,Carnelos; Chiara,20,0,20,0
1715606638140,LIIT 5CS,A00,507432,Carnelos; Chiara,20,0,20,0
1715606639170,LISP 5A,A00,507541,Munoz Sanchez; Alicia,11,0,20,9
1715606640195,LISP 5B,A00,507671,Munoz Sanchez; Alicia,9,0,20,11
1715606641225,LISP 5C,A00,507696,Munoz Sanchez; Alicia,9,0,20,11
1715606642253,MAE 197,001,528363,Boechler; Nicholas Sebastia,9998,0,9999,1
1715606643283,MATH 197,001,523477,Kedlaya; Kiran S.,9994,0,9999,5
1715606643283,MATH 197,002,563811,Zhang; Danna,9994,0,9999,5
1715606643283,MATH 197,003,628552,Dumitriu; Ioana,9998,0,9999,1
1715606643283,MATH 197,004,660885,Floyd; Eric,9999,0,9999,0
1715606644309,MCWP 40R,A00,518780,Staff,2,0,20,18
1715606644309,MCWP 40R,B00,518781,Staff,11,0,20,9
1715606644309,MCWP 40R,C00,518783,Staff,5,0,20,15
1715606645339,MCWP 50R,A00,518791,Staff,0,1,20,20
1715606645339,MCWP 50R,B00,518792,Staff,0,2,20,20
1715606645339,MCWP 50R,C00,518793,Staff,0,4,20,20
1715606645339,MCWP 50R,D00,518794,Staff,0,1,20,20
1715606645339,MCWP 50R,E00,518795,Staff,0,2,20,20
1715606645339,MCWP 50R,F00,518796,Staff,0,1,20,20
1715606645339,MCWP 50R,G00,518797,Staff,0,1,20,20
1715606646365,MMW 12R,A01,514034,Herbst; Matthew,0,2,16,16
1715606646365,MMW 12R,A02,514035,Herbst; Matthew,0,0,16,16
1715606647390,MMW 13R,A01,514037,Staff,0,5,16,16
1715606647390,MMW 13R,A02,514039,Staff,0,5,16,16
1715606647390,MMW 13R,A03,628519,Staff,0,4,16,16
1715606649448,SIO 295LS,A00,523233,Staff,10,0,30,20
1715606650472,SIO 295S,A00,523232,Staff,10,0,30,20
1715606651499,SIOC 290S,A01,637330,Merrifield; Mark A,23,0,30,7
1715606652525,SIOC 291S,A01,637333,Gabriel; Corey John,23,0,30,7
1715606653550,SOCI 117,A01,494376,Staff,0,5,5,5
1715606654579,WES 237B,A00,494380,Staff,10,0,20,10
1715606656639,AESE 279B,A00,494370,Wade; Jon P,0,0,33,33
1715606657665,AIP 97,001,660915,Van Den Einde; Yael Dahlia,9999,0,9999,0
1715606658690,AIP 197,001,627712,Vespa; Emanuel Ignacio,9995,0,9999,4
1715606658690,AIP 197,002,650778,Amir; On,9998,0,9999,1
1715606658690,AIP 197,003,650933,Avenancio-Leon; Carlos,9998,0,9999,1
1715606658690,AIP 197,004,658530,Heyman; Gail D.,9998,0,9999,1
1715606658690,AIP 197,005,658631,Neal; Sonya E,9998,0,9999,1
1715606658690,AIP 197,006,658671,Du; Songzi,9998,0,9999,1
1715606659717,ANAR 135S,A00,494369,Braswell; Geoffrey E.,0,0,0,0
1715606660746,BENG 196,001,628496,Engler; Adam J.,9998,0,9999,1
1715606660746,BENG 196,002,660916,Watson; John Thomas,9999,0,9999,0
1715606661773,BISP 197,001,650773,Wilhelm; James E.,9994,0,9999,5
1715606661773,BISP 197,002,658904,Coleman; Aaron B.,9998,0,9999,1
1715606662796,CAT 124RS,A01,519847,Geibel; William,0,0,20,20
1715606663822,CAT 125RS,A01,515971,Geibel; William,0,0,20,20
1715606664849,CLRE 250,A00,511389,Morris; Sheldon,9992,0,9999,7
1715606665875,CLRE 251,A00,507176,Mehta; Ravindra L.,9992,0,9999,7
1715606665875,CLRE 251,B00,511410,Mehta; Ravindra L.,9998,0,9999,1
1715606666901,CLRE 252,A00,507189,Cuomo; Raphael Eduardo,9994,0,9999,5
1715606667927,CLRE 253,A00,507199,Vaida; Florin,9994,0,9999,5
1715606667927,CLRE 253,B00,507202,Vaida; Florin,9999,0,9999,0
1715606668953,CLRE 259,A00,507211,Patel; Hemal,9996,0,9999,3
1715606669978,CLRE 260,A00,507221,Cuomo; Raphael Eduardo,9999,0,9999,0
1715606671003,CLRE 297,001,507242,Cuomo; Raphael Eduardo,9999,0,9999,0
1715606672027,COGS 197,001,638244,Voytek; Bradley Thomas,9997,0,9999,2
1715606673054,CSE 191,A00,516875,Minnes Kemp; Mor Mia,9991,0,9999,8
1715606674082,CSE 197,001,637388,Minnes Kemp; Mor Mia,9992,0,9999,7
1715606675112,CSS 201S,A01,494383,Mignozzetti; Umberto,35,0,35,0
1715606676138,CSS 202S,A01,494387,Mignozzetti; Umberto,35,0,35,0
1715606677164,DSC 197,001,628532,Eldridge; Justin Matthew,9995,0,9999,4
1715606678190,EAP 100,A00,516065,Staff,9799,0,9999,200
1715606679218,ECE 45,A01,507414,Staff,31,0,60,29
1715606681325,ECE 111,A01,507420,Staff,11,0,50,39
1715606682350,ECE 197,001,548057,Sievenpiper; Daniel F.,9991,0,9999,8
1715606683378,EDS 115,A00,507243,Choi; Bailey Miyeon,7,0,28,21
1715606684405,EDS 117,A01,494379,Staff,0,6,34,34
1715606685433,EDS 125,A00,507246,Hopkins; Megan Beth,8,0,30,22
1715606686459,EDS 128A,A01,507264,Fargason; Sharon Gayle,6,0,26,20
1715606687485,EDS 128B,A01,507293,Pappas; Elizabeth,10,0,30,20
1715606688510,EDS 139,A00,507294,Fargason; Sharon Gayle,10,0,30,20
1715606688510,EDS 139,B00,507313,Pappas; Elizabeth,11,0,30,19
1715606689538,EDS 201,A00,507315,Staff,10,0,30,20
1715606690567,EDS 203,A01,507317,Halter; Christopher P.,10,0,30,20
1715606691592,EDS 204R,A01,507319,Halter; Christopher P.,0,3,30,30
1715606691592,EDS 204R,B01,507331,Heinzman; Erica M.,14,0,30,16
1715606692620,EDS 206R,A00,507332,Staff,0,4,30,30
1715606692620,EDS 206R,B00,507343,Staff,15,0,30,15
1715606693647,EDS 250,A00,507344,Hemans; Patricia Ann Benitez,20,0,40,20
1715606694673,EDS 281,A00,507345,Daly; Alan J.,18,0,18,0
1715606695701,EDS 284,A00,507350,Daly; Alan J.,16,0,16,0
1715606696730,EDS 286,A00,507359,Fine; Sarah,18,0,18,0
1715606697754,EDS 289C,A01,507361,Daly; Alan J.,18,0,18,0
1715606698782,EDS 290,A00,507366,Hofstetter; Carolyn,15,0,15,0
1715606699807,LIGM 5A,A00,507421,Fischer-Grunski; Eva K,17,0,20,3
1715606700839,LIGM 5B,A00,507423,Fischer-Grunski; Eva K,19,0,20,1
1715606701868,LIGM 5C,A00,507425,Fischer-Grunski; Eva K,19,0,20,1
1715606702897,LIIT 5AS,A00,507427,Carnelos; Chiara,20,0,20,0
1715606703922,LIIT 5BS,A00,507430,Carnelos; Chiara,20,0,20,0
1715606704947,LIIT 5CS,A00,507432,Carnelos; Chiara,20,0,20,0
1715606705978,LISP 5A,A00,507541,Munoz Sanchez; Alicia,11,0,20,9
1715606707005,LISP 5B,A00,507671,Munoz Sanchez; Alicia,9,0,20,11
1715606708032,LISP 5C,A00,507696,Munoz Sanchez; Alicia,9,0,20,11
1715606709059,MAE 197,001,528363,Boechler; Nicholas Sebastia,9998,0,9999,1
1715606710088,MATH 197,001,523477,Kedlaya; Kiran S.,9994,0,9999,5
1715606710088,MATH 197,002,563811,Zhang; Danna,9994,0,9999,5
1715606710088,MATH 197,003,628552,Dumitriu; Ioana,9998,0,9999,1
1715606710088,MATH 197,004,660885,Floyd; Eric,9999,0,9999,0
1715606711115,MCWP 40R,A00,518780,Staff,2,0,20,18
1715606711115,MCWP 40R,B00,518781,Staff,11,0,20,9
1715606711115,MCWP 40R,C00,518783,Staff,5,0,20,15
1715606712141,MCWP 50R,A00,518791,Staff,0,1,20,20
1715606712141,MCWP 50R,B00,518792,Staff,0,2,20,20
1715606712141,MCWP 50R,C00,518793,Staff,0,4,20,20
1715606712141,MCWP 50R,D00,518794,Staff,0,1,20,20
1715606712141,MCWP 50R,E00,518795,Staff,0,2,20,20
1715606712141,MCWP 50R,F00,518796,Staff,0,1,20,20
1715606712141,MCWP 50R,G00,518797,Staff,0,1,20,20
1715606713166,MMW 12R,A01,514034,Herbst; Matthew,0,2,16,16
1715606713166,MMW 12R,A02,514035,Herbst; Matthew,0,0,16,16
1715606714194,MMW 13R,A01,514037,Staff,0,5,16,16
1715606714194,MMW 13R,A02,514039,Staff,0,5,16,16
1715606714194,MMW 13R,A03,628519,Staff,0,4,16,16
1715606716247,SIO 295LS,A00,523233,Staff,10,0,30,20
1715606717272,SIO 295S,A00,523232,Staff,10,0,30,20
1715606718297,SIOC 290S,A01,637330,Merrifield; Mark A,23,0,30,7
1715606719325,SIOC 291S,A01,637333,Gabriel; Corey John,23,0,30,7
1715606720354,SOCI 117,A01,494376,Staff,0,5,5,5
1715606721380,WES 237B,A00,494380,Staff,10,0,20,10
1715606723465,AESE 279B,A00,494370,Wade; Jon P,0,0,33,33
1715606724493,AIP 97,001,660915,Van Den Einde; Yael Dahlia,9999,0,9999,0
1715606725522,AIP 197,001,627712,Vespa; Emanuel Ignacio,9995,0,9999,4
1715606725522,AIP 197,002,650778,Amir; On,9998,0,9999,1
1715606725522,AIP 197,003,650933,Avenancio-Leon; Carlos,9998,0,9999,1
1715606725522,AIP 197,004,658530,Heyman; Gail D.,9998,0,9999,1
1715606725522,AIP 197,005,658631,Neal; Sonya E,9998,0,9999,1
1715606725522,AIP 197,006,658671,Du; Songzi,9998,0,9999,1
1715606726548,ANAR 135S,A00,494369,Braswell; Geoffrey E.,0,0,0,0
1715606727575,BENG 196,001,628496,Engler; Adam J.,9998,0,9999,1
1715606727575,BENG 196,002,660916,Watson; John Thomas,9999,0,9999,0
1715606728601,BISP 197,001,650773,Wilhelm; James E.,9994,0,9999,5
1715606728601,BISP 197,002,658904,Coleman; Aaron B.,9998,0,9999,1
1715606729628,CAT 124RS,A01,519847,Geibel; William,0,0,20,20
1715606730654,CAT 125RS,A01,515971,Geibel; William,0,0,20,20
1715606731680,CLRE 250,A00,511389,Morris; Sheldon,9992,0,9999,7
1715606732707,CLRE 251,A00,507176,Mehta; Ravindra L.,9992,0,9999,7
1715606732707,CLRE 251,B00,511410,Mehta; Ravindra L.,9998,0,9999,1
1715606733736,CLRE 252,A00,507189,Cuomo; Raphael Eduardo,9994,0,9999,5
1715606734762,CLRE 253,A00,507199,Vaida; Florin,9994,0,9999,5
1715606734762,CLRE 253,B00,507202,Vaida; Florin,9999,0,9999,0
1715606735787,CLRE 259,A00,507211,Patel; Hemal,9996,0,9999,3
1715606736812,CLRE 260,A00,507221,Cuomo; Raphael Eduardo,9999,0,9999,0
1715606737835,CLRE 297,001,507242,Cuomo; Raphael Eduardo,9999,0,9999,0
1715606738861,COGS 197,001,638244,Voytek; Bradley Thomas,9997,0,9999,2
1715606739888,CSE 191,A00,516875,Minnes Kemp; Mor Mia,9991,0,9999,8
1715606740912,CSE 197,001,637388,Minnes Kemp; Mor Mia,9992,0,9999,7
1715606741942,CSS 201S,A01,494383,Mignozzetti; Umberto,35,0,35,0
1715606742971,CSS 202S,A01,494387,Mignozzetti; Umberto,35,0,35,0
1715606743995,DSC 197,001,628532,Eldridge; Justin Matthew,9995,0,9999,4
1715606745020,EAP 100,A00,516065,Staff,9799,0,9999,200
1715606746048,ECE 45,A01,507414,Staff,31,0,60,29
1715606748099,ECE 111,A01,507420,Staff,11,0,50,39
1715606749124,ECE 197,001,548057,Sievenpiper; Daniel F.,9991,0,9999,8
1715606750151,EDS 115,A00,507243,Choi; Bailey Miyeon,7,0,28,21
1715606751176,EDS 117,A01,494379,Staff,0,6,34,34
1715606752201,EDS 125,A00,507246,Hopkins; Megan Beth,8,0,30,22
1715606753227,EDS 128A,A01,507264,Fargason; Sharon Gayle,6,0,26,20
1715606754252,EDS 128B,A01,507293,Pappas; Elizabeth,10,0,30,20
1715606755276,EDS 139,A00,507294,Fargason; Sharon Gayle,10,0,30,20
1715606755276,EDS 139,B00,507313,Pappas; Elizabeth,11,0,30,19
1715606756301,EDS 201,A00,507315,Staff,10,0,30,20
1715606757330,EDS 203,A01,507317,Halter; Christopher P.,10,0,30,20
1715606758360,EDS 204R,A01,507319,Halter; Christopher P.,0,3,30,30
1715606758360,EDS 204R,B01,507331,Heinzman; Erica M.,14,0,30,16
1715606759389,EDS 206R,A00,507332,Staff,0,4,30,30
1715606759389,EDS 206R,B00,507343,Staff,15,0,30,15
1715606760417,EDS 250,A00,507344,Hemans; Patricia Ann Benitez,20,0,40,20
1715606761442,EDS 281,A00,507345,Daly; Alan J.,18,0,18,0
1715606762466,EDS 284,A00,507350,Daly; Alan J.,16,0,16,0
1715606763495,EDS 286,A00,507359,Fine; Sarah,18,0,18,0
1715606764519,EDS 289C,A01,507361,Daly; Alan J.,18,0,18,0
1715606765547,EDS 290,A00,507366,Hofstetter; Carolyn,15,0,15,0
1715606766573,LIGM 5A,A00,507421,Fischer-Grunski; Eva K,17,0,20,3
1715606767599,LIGM 5B,A00,507423,Fischer-Grunski; Eva K,19,0,20,1
1715606768625,LIGM 5C,A00,507425,Fischer-Grunski; Eva K,19,0,20,1
1715606769652,LIIT 5AS,A00,507427,Carnelos; Chiara,20,0,20,0
1715606770678,LIIT 5BS,A00,507430,Carnelos; Chiara,20,0,20,0
1715606771704,LIIT 5CS,A00,507432,Carnelos; Chiara,20,0,20,0
1715606772734,LISP 5A,A00,507541,Munoz Sanchez; Alicia,11,0,20,9
1715606773759,LISP 5B,A00,507671,Munoz Sanchez; Alicia,9,0,20,11
1715606774787,LISP 5C,A00,507696,Munoz Sanchez; Alicia,9,0,20,11
1715606775816,MAE 197,001,528363,Boechler; Nicholas Sebastia,9998,0,9999,1
1715606776847,MATH 197,001,523477,Kedlaya; Kiran S.,9994,0,9999,5
1715606776847,MATH 197,002,563811,Zhang; Danna,9994,0,9999,5
1715606776847,MATH 197,003,628552,Dumitriu; Ioana,9998,0,9999,1
1715606776847,MATH 197,004,660885,Floyd; Eric,9999,0,9999,0
1715606777874,MCWP 40R,A00,518780,Staff,2,0,20,18
1715606777874,MCWP 40R,B00,518781,Staff,11,0,20,9
1715606777874,MCWP 40R,C00,518783,Staff,5,0,20,15
1715606778899,MCWP 50R,A00,518791,Staff,0,1,20,20
1715606778899,MCWP 50R,B00,518792,Staff,0,2,20,20
1715606778899,MCWP 50R,C00,518793,Staff,0,4,20,20
1715606778899,MCWP 50R,D00,518794,Staff,0,1,20,20
1715606778899,MCWP 50R,E00,518795,Staff,0,2,20,20
1715606778899,MCWP 50R,F00,518796,Staff,0,1,20,20
1715606778899,MCWP 50R,G00,518797,Staff,0,1,20,20
1715606779925,MMW 12R,A01,514034,Herbst; Matthew,0,2,16,16
1715606779925,MMW 12R,A02,514035,Herbst; Matthew,0,0,16,16
1715606780950,MMW 13R,A01,514037,Staff,0,5,16,16
1715606780950,MMW 13R,A02,514039,Staff,0,5,16,16
1715606780950,MMW 13R,A03,628519,Staff,0,4,16,16
1715606783004,SIO 295LS,A00,523233,Staff,10,0,30,20
1715606784031,SIO 295S,A00,523232,Staff,10,0,30,20
1715606785116,SIOC 290S,A01,637330,Merrifield; Mark A,23,0,30,7
1715606786146,SIOC 291S,A01,637333,Gabriel; Corey John,23,0,30,7
1715606787175,SOCI 117,A01,494376,Staff,0,5,5,5
1715606788201,WES 237B,A00,494380,Staff,10,0,20,10
1715606790280,AESE 279B,A00,494370,Wade; Jon P,0,0,33,33
1715606791308,AIP 97,001,660915,Van Den Einde; Yael Dahlia,9999,0,9999,0
1715606792338,AIP 197,001,627712,Vespa; Emanuel Ignacio,9995,0,9999,4
1715606792338,AIP 197,002,650778,Amir; On,9998,0,9999,1
1715606792338,AIP 197,003,650933,Avenancio-Leon; Carlos,9998,0,9999,1
1715606792338,AIP 197,004,658530,Heyman; Gail D.,9998,0,9999,1
1715606792338,AIP 197,005,658631,Neal; Sonya E,9998,0,9999,1
1715606792338,AIP 197,006,658671,Du; Songzi,9998,0,9999,1
1715606793364,ANAR 135S,A00,494369,Braswell; Geoffrey E.,0,0,0,0
1715606794394,BENG 196,001,628496,Engler; Adam J.,9998,0,9999,1
1715606794394,BENG 196,002,660916,Watson; John Thomas,9999,0,9999,0
1715606795420,BISP 197,001,650773,Wilhelm; James E.,9994,0,9999,5
1715606795420,BISP 197,002,658904,Coleman; Aaron B.,9998,0,9999,1
1715606796446,CAT 124RS,A01,519847,Geibel; William,0,0,20,20
1715606797475,CAT 125RS,A01,515971,Geibel; William,0,0,20,20
1715606798501,CLRE 250,A00,511389,Morris; Sheldon,9992,0,9999,7
1715606799527,CLRE 251,A00,507176,Mehta; Ravindra L.,9992,0,9999,7
1715606799527,CLRE 251,B00,511410,Mehta; Ravindra L.,9998,0,9999,1
1715606800555,CLRE 252,A00,507189,Cuomo; Raphael Eduardo,9994,0,9999,5
1715606801584,CLRE 253,A00,507199,Vaida; Florin,9994,0,9999,5
1715606801584,CLRE 253,B00,507202,Vaida; Florin,9999,0,9999,0
1715606802611,CLRE 259,A00,507211,Patel; Hemal,9996,0,9999,3
1715606803636,CLRE 260,A00,507221,Cuomo; Raphael Eduardo,9999,0,9999,0
1715606804662,CLRE 297,001,507242,Cuomo; Raphael Eduardo,9999,0,9999,0
1715606805691,COGS 197,001,638244,Voytek; Bradley Thomas,9997,0,9999,2
1715606806718,CSE 191,A00,516875,Minnes Kemp; Mor Mia,9991,0,9999,8
1715606807749,CSE 197,001,637388,Minnes Kemp; Mor Mia,9992,0,9999,7
1715606808776,CSS 201S,A01,494383,Mignozzetti; Umberto,35,0,35,0
1715606809800,CSS 202S,A01,494387,Mignozzetti; Umberto,35,0,35,0
1715606810826,DSC 197,001,628532,Eldridge; Justin Matthew,9995,0,9999,4
1715606811854,EAP 100,A00,516065,Staff,9799,0,9999,200
1715606812881,ECE 45,A01,507414,Staff,31,0,60,29
1715606814932,ECE 111,A01,507420,Staff,11,0,50,39
1715606815961,ECE 197,001,548057,Sievenpiper; Daniel F.,9991,0,9999,8
1715606816987,EDS 115,A00,507243,Choi; Bailey Miyeon,7,0,28,21
1715606818013,EDS 117,A01,494379,Staff,0,6,34,34
1715606819037,EDS 125,A00,507246,Hopkins; Megan Beth,8,0,30,22
1715606820067,EDS 128A,A01,507264,Fargason; Sharon Gayle,6,0,26,20
1715606821093,EDS 128B,A01,507293,Pappas; Elizabeth,10,0,30,20
1715606822121,EDS 139,A00,507294,Fargason; Sharon Gayle,10,0,30,20
1715606822121,EDS 139,B00,507313,Pappas; Elizabeth,11,0,30,19
1715606823145,EDS 201,A00,507315,Staff,10,0,30,20
1715606824174,EDS 203,A01,507317,Halter; Christopher P.,10,0,30,20
1715606825204,EDS 204R,A01,507319,Halter; Christopher P.,0,3,30,30
1715606825204,EDS 204R,B01,507331,Heinzman; Erica M.,14,0,30,16
1715606826229,EDS 206R,A00,507332,Staff,0,4,30,30
1715606826229,EDS 206R,B00,507343,Staff,15,0,30,15
1715606827257,EDS 250,A00,507344,Hemans; Patricia Ann Benitez,20,0,40,20
1715606828285,EDS 281,A00,507345,Daly; Alan J.,18,0,18,0
1715606829310,EDS 284,A00,507350,Daly; Alan J.,16,0,16,0
1715606830371,EDS 286,A00,507359,Fine; Sarah,18,0,18,0
1715606831396,EDS 289C,A01,507361,Daly; Alan J.,18,0,18,0
1715606832422,EDS 290,A00,507366,Hofstetter; Carolyn,15,0,15,0
1715606833448,LIGM 5A,A00,507421,Fischer-Grunski; Eva K,17,0,20,3
1715606834477,LIGM 5B,A00,507423,Fischer-Grunski; Eva K,19,0,20,1
1715606835507,LIGM 5C,A00,507425,Fischer-Grunski; Eva K,19,0,20,1
1715606836532,LIIT 5AS,A00,507427,Carnelos; Chiara,20,0,20,0
1715606837561,LIIT 5BS,A00,507430,Carnelos; Chiara,20,0,20,0
1715606838587,LIIT 5CS,A00,507432,Carnelos; Chiara,20,0,20,0
1715606839612,LISP 5A,A00,507541,Munoz Sanchez; Alicia,11,0,20,9
1715606840640,LISP 5B,A00,507671,Munoz Sanchez; Alicia,9,0,20,11
1715606841665,LISP 5C,A00,507696,Munoz Sanchez; Alicia,9,0,20,11
1715606842691,MAE 197,001,528363,Boechler; Nicholas Sebastia,9998,0,9999,1
1715606843723,MATH 197,001,523477,Kedlaya; Kiran S.,9994,0,9999,5
1715606843723,MATH 197,002,563811,Zhang; Danna,9994,0,9999,5
1715606843723,MATH 197,003,628552,Dumitriu; Ioana,9998,0,9999,1
1715606843723,MATH 197,004,660885,Floyd; Eric,9999,0,9999,0
1715606844751,MCWP 40R,A00,518780,Staff,2,0,20,18
1715606844751,MCWP 40R,B00,518781,Staff,11,0,20,9
1715606844751,MCWP 40R,C00,518783,Staff,5,0,20,15
1715606845780,MCWP 50R,A00,518791,Staff,0,1,20,20
1715606845780,MCWP 50R,B00,518792,Staff,0,2,20,20
1715606845780,MCWP 50R,C00,518793,Staff,0,4,20,20
1715606845780,MCWP 50R,D00,518794,Staff,0,1,20,20
1715606845780,MCWP 50R,E00,518795,Staff,0,2,20,20
1715606845780,MCWP 50R,F00,518796,Staff,0,1,20,20
1715606845780,MCWP 50R,G00,518797,Staff,0,1,20,20
1715606846806,MMW 12R,A01,514034,Herbst; Matthew,0,2,16,16
1715606846806,MMW 12R,A02,514035,Herbst; Matthew,0,0,16,16
1715606847835,MMW 13R,A01,514037,Staff,0,5,16,16
1715606847835,MMW 13R,A02,514039,Staff,0,5,16,16
1715606847835,MMW 13R,A03,628519,Staff,0,4,16,16
1715606849893,SIO 295LS,A00,523233,Staff,10,0,30,20
1715606850920,SIO 295S,A00,523232,Staff,10,0,30,20
1715606851949,SIOC 290S,A01,637330,Merrifield; Mark A,23,0,30,7
1715606852978,SIOC 291S,A01,637333,Gabriel; Corey John,23,0,30,7
1715606854005,SOCI 117,A01,494376,Staff,0,5,5,5
1715606855031,WES 237B,A00,494380,Staff,10,0,20,10
1715606857114,AESE 279B,A00,494370,Wade; Jon P,0,0,33,33
1715606858144,AIP 97,001,660915,Van Den Einde; Yael Dahlia,9999,0,9999,0
1715606859174,AIP 197,001,627712,Vespa; Emanuel Ignacio,9995,0,9999,4
1715606859174,AIP 197,002,650778,Amir; On,9998,0,9999,1
1715606859174,AIP 197,003,650933,Avenancio-Leon; Carlos,9998,0,9999,1
1715606859174,AIP 197,004,658530,Heyman; Gail D.,9998,0,9999,1
1715606859174,AIP 197,005,658631,Neal; Sonya E,9998,0,9999,1
1715606859174,AIP 197,006,658671,Du; Songzi,9998,0,9999,1
1715606860204,ANAR 135S,A00,494369,Braswell; Geoffrey E.,0,0,0,0
1715606861230,BENG 196,001,628496,Engler; Adam J.,9998,0,9999,1
1715606861230,BENG 196,002,660916,Watson; John Thomas,9999,0,9999,0
1715606862259,BISP 197,001,650773,Wilhelm; James E.,9994,0,9999,5
1715606862259,BISP 197,002,658904,Coleman; Aaron B.,9998,0,9999,1
1715606863286,CAT 124RS,A01,519847,Geibel; William,0,0,20,20
1715606864310,CAT 125RS,A01,515971,Geibel; William,0,0,20,20
1715606865338,CLRE 250,A00,511389,Morris; Sheldon,9992,0,9999,7
1715606866364,CLRE 251,A00,507176,Mehta; Ravindra L.,9992,0,9999,7
1715606866364,CLRE 251,B00,511410,Mehta; Ravindra L.,9998,0,9999,1
1715606867389,CLRE 252,A00,507189,Cuomo; Raphael Eduardo,9994,0,9999,5
1715606868416,CLRE 253,A00,507199,Vaida; Florin,9994,0,9999,5
1715606868416,CLRE 253,B00,507202,Vaida; Florin,9999,0,9999,0
1715606869443,CLRE 259,A00,507211,Patel; Hemal,9996,0,9999,3
1715606870468,CLRE 260,A00,507221,Cuomo; Raphael Eduardo,9999,0,9999,0
1715606871494,CLRE 297,001,507242,Cuomo; Raphael Eduardo,9999,0,9999,0
1715606872519,COGS 197,001,638244,Voytek; Bradley Thomas,9997,0,9999,2
1715606873544,CSE 191,A00,516875,Minnes Kemp; Mor Mia,9991,0,9999,8
1715606874570,CSE 197,001,637388,Minnes Kemp; Mor Mia,9992,0,9999,7
1715606875600,CSS 201S,A01,494383,Mignozzetti; Umberto,35,0,35,0
1715606876626,CSS 202S,A01,494387,Mignozzetti; Umberto,35,0,35,0
1715606877655,DSC 197,001,628532,Eldridge; Justin Matthew,9995,0,9999,4
1715606878680,EAP 100,A00,516065,Staff,9799,0,9999,200
1715606879709,ECE 45,A01,507414,Staff,31,0,60,29
1715606881759,ECE 111,A01,507420,Staff,11,0,50,39
1715606882787,ECE 197,001,548057,Sievenpiper; Daniel F.,9991,0,9999,8
1715606883813,EDS 115,A00,507243,Choi; Bailey Miyeon,7,0,28,21
1715606884839,EDS 117,A01,494379,Staff,0,6,34,34
1715606885867,EDS 125,A00,507246,Hopkins; Megan Beth,8,0,30,22
1715606886896,EDS 128A,A01,507264,Fargason; Sharon Gayle,6,0,26,20
1715606887921,EDS 128B,A01,507293,Pappas; Elizabeth,10,0,30,20
1715606889003,EDS 139,A00,507294,Fargason; Sharon Gayle,10,0,30,20
1715606889003,EDS 139,B00,507313,Pappas; Elizabeth,11,0,30,19
1715606890032,EDS 201,A00,507315,Staff,10,0,30,20
1715606891062,EDS 203,A01,507317,Halter; Christopher P.,10,0,30,20
1715606892088,EDS 204R,A01,507319,Halter; Christopher P.,0,3,30,30
1715606892088,EDS 204R,B01,507331,Heinzman; Erica M.,14,0,30,16
1715606893113,EDS 206R,A00,507332,Staff,0,4,30,30
1715606893113,EDS 206R,B00,507343,Staff,15,0,30,15
1715606894139,EDS 250,A00,507344,Hemans; Patricia Ann Benitez,20,0,40,20
1715606895165,EDS 281,A00,507345,Daly; Alan J.,18,0,18,0
1715606896192,EDS 284,A00,507350,Daly; Alan J.,16,0,16,0
1715606897219,EDS 286,A00,507359,Fine; Sarah,18,0,18,0
1715606898245,EDS 289C,A01,507361,Daly; Alan J.,18,0,18,0
1715606899271,EDS 290,A00,507366,Hofstetter; Carolyn,15,0,15,0
1715606900298,LIGM 5A,A00,507421,Fischer-Grunski; Eva K,17,0,20,3
1715606901327,LIGM 5B,A00,507423,Fischer-Grunski; Eva K,19,0,20,1
1715606902356,LIGM 5C,A00,507425,Fischer-Grunski; Eva K,19,0,20,1
1715606903383,LIIT 5AS,A00,507427,Carnelos; Chiara,20,0,20,0
1715606904408,LIIT 5BS,A00,507430,Carnelos; Chiara,20,0,20,0
1715606905434,LIIT 5CS,A00,507432,Carnelos; Chiara,20,0,20,0
1715606906463,LISP 5A,A00,507541,Munoz Sanchez; Alicia,11,0,20,9
1715606907491,LISP 5B,A00,507671,Munoz Sanchez; Alicia,9,0,20,11
1715606908521,LISP 5C,A00,507696,Munoz Sanchez; Alicia,9,0,20,11
1715606909546,MAE 197,001,528363,Boechler; Nicholas Sebastia,9998,0,9999,1
1715606910580,MATH 197,001,523477,Kedlaya; Kiran S.,9994,0,9999,5
1715606910580,MATH 197,002,563811,Zhang; Danna,9994,0,9999,5
1715606910580,MATH 197,003,628552,Dumitriu; Ioana,9998,0,9999,1
1715606910580,MATH 197,004,660885,Floyd; Eric,9999,0,9999,0
1715606911606,MCWP 40R,A00,518780,Staff,2,0,20,18
1715606911606,MCWP 40R,B00,518781,Staff,11,0,20,9
1715606911606,MCWP 40R,C00,518783,Staff,5,0,20,15
1715606912636,MCWP 50R,A00,518791,Staff,0,1,20,20
1715606912636,MCWP 50R,B00,518792,Staff,0,2,20,20
1715606912636,MCWP 50R,C00,518793,Staff,0,4,20,20
1715606912636,MCWP 50R,D00,518794,Staff,0,1,20,20
1715606912636,MCWP 50R,E00,518795,Staff,0,2,20,20
1715606912636,MCWP 50R,F00,518796,Staff,0,1,20,20
1715606912636,MCWP 50R,G00,518797,Staff,0,1,20,20
1715606913666,MMW 12R,A01,514034,Herbst; Matthew,0,2,16,16
1715606913666,MMW 12R,A02,514035,Herbst; Matthew,0,0,16,16
1715606914696,MMW 13R,A01,514037,Staff,0,5,16,16
1715606914696,MMW 13R,A02,514039,Staff,0,5,16,16
1715606914696,MMW 13R,A03,628519,Staff,0,4,16,16
1715606916746,SIO 295LS,A00,523233,Staff,10,0,30,20
1715606917773,SIO 295S,A00,523232,Staff,10,0,30,20
1715606918799,SIOC 290S,A01,637330,Merrifield; Mark A,23,0,30,7
1715606919826,SIOC 291S,A01,637333,Gabriel; Corey John,23,0,30,7
1715606920853,SOCI 117,A01,494376,Staff,0,5,5,5
1715606921881,WES 237B,A00,494380,Staff,10,0,20,10
1715606923958,AESE 279B,A00,494370,Wade; Jon P,0,0,33,33
1715606924987,AIP 97,001,660915,Van Den Einde; Yael Dahlia,9999,0,9999,0
1715606926015,AIP 197,001,627712,Vespa; Emanuel Ignacio,9995,0,9999,4
1715606926015,AIP 197,002,650778,Amir; On,9998,0,9999,1
1715606926015,AIP 197,003,650933,Avenancio-Leon; Carlos,9998,0,9999,1
1715606926015,AIP 197,004,658530,Heyman; Gail D.,9998,0,9999,1
1715606926015,AIP 197,005,658631,Neal; Sonya E,9998,0,9999,1
1715606926015,AIP 197,006,658671,Du; Songzi,9998,0,9999,1
1715606927045,ANAR 135S,A00,494369,Braswell; Geoffrey E.,0,0,0,0
1715606928071,BENG 196,001,628496,Engler; Adam J.,9998,0,9999,1
1715606928071,BENG 196,002,660916,Watson; John Thomas,9999,0,9999,0
1715606929097,BISP 197,001,650773,Wilhelm; James E.,9994,0,9999,5
1715606929097,BISP 197,002,658904,Coleman; Aaron B.,9998,0,9999,1
1715606930124,CAT 124RS,A01,519847,Geibel; William,0,0,20,20
1715606931149,CAT 125RS,A01,515971,Geibel; William,0,0,20,20
1715606932176,CLRE 250,A00,511389,Morris; Sheldon,9992,0,9999,7
1715606933216,CLRE 251,A00,507176,Mehta; Ravindra L.,9992,0,9999,7
1715606933216,CLRE 251,B00,511410,Mehta; Ravindra L.,9998,0,9999,1
1715606934243,CLRE 252,A00,507189,Cuomo; Raphael Eduardo,9994,0,9999,5
1715606935269,CLRE 253,A00,507199,Vaida; Florin,9994,0,9999,5
1715606935269,CLRE 253,B00,507202,Vaida; Florin,9999,0,9999,0
1715606936295,CLRE 259,A00,507211,Patel; Hemal,9996,0,9999,3
1715606937322,CLRE 260,A00,507221,Cuomo; Raphael Eduardo,9999,0,9999,0
1715606938346,CLRE 297,001,507242,Cuomo; Raphael Eduardo,9999,0,9999,0
1715606939376,COGS 197,001,638244,Voytek; Bradley Thomas,9997,0,9999,2
1715606940406,CSE 191,A00,516875,Minnes Kemp; Mor Mia,9991,0,9999,8
1715606941430,CSE 197,001,637388,Minnes Kemp; Mor Mia,9992,0,9999,7
1715606942456,CSS 201S,A01,494383,Mignozzetti; Umberto,35,0,35,0
1715606943489,CSS 202S,A01,494387,Mignozzetti; Umberto,35,0,35,0
1715606944518,DSC 197,001,628532,Eldridge; Justin Matthew,9995,0,9999,4
1715606945547,EAP 100,A00,516065,Staff,9799,0,9999,200
1715606946573,ECE 45,A01,507414,Staff,31,0,60,29
1715606948629,ECE 111,A01,507420,Staff,11,0,50,39
1715606949654,ECE 197,001,548057,Sievenpiper; Daniel F.,9991,0,9999,8
1715606950681,EDS 115,A00,507243,Choi; Bailey Miyeon,7,0,28,21
1715606951707,EDS 117,A01,494379,Staff,0,6,34,34
1715606952731,EDS 125,A00,507246,Hopkins; Megan Beth,8,0,30,22
1715606953760,EDS 128A,A01,507264,Fargason; Sharon Gayle,6,0,26,20
1715606954786,EDS 128B,A01,507293,Pappas; Elizabeth,10,0,30,20
1715606955812,EDS 139,A00,507294,Fargason; Sharon Gayle,10,0,30,20
1715606955812,EDS 139,B00,507313,Pappas; Elizabeth,11,0,30,19
1715606956840,EDS 201,A00,507315,Staff,10,0,30,20
1715606957866,EDS 203,A01,507317,Halter; Christopher P.,10,0,30,20
1715606958894,EDS 204R,A01,507319,Halter; Christopher P.,0,3,30,30
1715606958894,EDS 204R,B01,507331,Heinzman; Erica M.,14,0,30,16
1715606959922,EDS 206R,A00,507332,Staff,0,4,30,30
1715606959922,EDS 206R,B00,507343,Staff,15,0,30,15
1715606960948,EDS 250,A00,507344,Hemans; Patricia Ann Benitez,20,0,40,20
1715606961975,EDS 281,A00,507345,Daly; Alan J.,18,0,18,0
1715606962999,EDS 284,A00,507350,Daly; Alan J.,16,0,16,0
1715606964026,EDS 286,A00,507359,Fine; Sarah,18,0,18,0
1715606965051,EDS 289C,A01,507361,Daly; Alan J.,18,0,18,0
1715606966077,EDS 290,A00,507366,Hofstetter; Carolyn,15,0,15,0
1715606967109,LIGM 5A,A00,507421,Fischer-Grunski; Eva K,17,0,20,3
1715606968138,LIGM 5B,A00,507423,Fischer-Grunski; Eva K,19,0,20,1
1715606969163,LIGM 5C,A00,507425,Fischer-Grunski; Eva K,19,0,20,1
1715606970188,LIIT 5AS,A00,507427,Carnelos; Chiara,20,0,20,0
1715606971212,LIIT 5BS,A00,507430,Carnelos; Chiara,20,0,20,0
1715606972243,LIIT 5CS,A00,507432,Carnelos; Chiara,20,0,20,0
1715606973269,LISP 5A,A00,507541,Munoz Sanchez; Alicia,11,0,20,9
1715606974296,LISP 5B,A00,507671,Munoz Sanchez; Alicia,9,0,20,11
1715606975320,LISP 5C,A00,507696,Munoz Sanchez; Alicia,9,0,20,11
1715606976347,MAE 197,001,528363,Boechler; Nicholas Sebastia,9998,0,9999,1
1715606977376,MATH 197,001,523477,Kedlaya; Kiran S.,9994,0,9999,5
1715606977376,MATH 197,002,563811,Zhang; Danna,9994,0,9999,5
1715606977376,MATH 197,003,628552,Dumitriu; Ioana,9998,0,9999,1
1715606977376,MATH 197,004,660885,Floyd; Eric,9999,0,9999,0
1715606978403,MCWP 40R,A00,518780,Staff,2,0,20,18
1715606978403,MCWP 40R,B00,518781,Staff,11,0,20,9
1715606978403,MCWP 40R,C00,518783,Staff,5,0,20,15
1715606979430,MCWP 50R,A00,518791,Staff,0,1,20,20
1715606979430,MCWP 50R,B00,518792,Staff,0,2,20,20
1715606979430,MCWP 50R,C00,518793,Staff,0,4,20,20
1715606979430,MCWP 50R,D00,518794,Staff,0,1,20,20
1715606979430,MCWP 50R,E00,518795,Staff,0,2,20,20
1715606979430,MCWP 50R,F00,518796,Staff,0,1,20,20
1715606979430,MCWP 50R,G00,518797,Staff,0,1,20,20
1715606980456,MMW 12R,A01,514034,Herbst; Matthew,0,2,16,16
1715606980456,MMW 12R,A02,514035,Herbst; Matthew,0,0,16,16
1715606981485,MMW 13R,A01,514037,Staff,0,5,16,16
1715606981485,MMW 13R,A02,514039,Staff,0,5,16,16
1715606981485,MMW 13R,A03,628519,Staff,0,4,16,16
1715606983538,SIO 295LS,A00,523233,Staff,10,0,30,20
1715606984565,SIO 295S,A00,523232,Staff,10,0,30,20
1715606985591,SIOC 290S,A01,637330,Merrifield; Mark A,23,0,30,7
1715606986618,SIOC 291S,A01,637333,Gabriel; Corey John,23,0,30,7
1715606987648,SOCI 117,A01,494376,Staff,0,5,5,5
1715606988672,WES 237B,A00,494380,Staff,10,0,20,10
1715606990743,AESE 279B,A00,494370,Wade; Jon P,0,0,33,33
1715606991770,AIP 97,001,660915,Van Den Einde; Yael Dahlia,9999,0,9999,0
1715606992854,AIP 197,001,627712,Vespa; Emanuel Ignacio,9995,0,9999,4
1715606992854,AIP 197,002,650778,Amir; On,9998,0,9999,1
1715606992854,AIP 197,003,650933,Avenancio-Leon; Carlos,9998,0,9999,1
1715606992854,AIP 197,004,658530,Heyman; Gail D.,9998,0,9999,1
1715606992854,AIP 197,005,658631,Neal; Sonya E,9998,0,9999,1
1715606992854,AIP 197,006,658671,Du; Songzi,9998,0,9999,1
1715606993881,ANAR 135S,A00,494369,Braswell; Geoffrey E.,0,0,0,0
1715606994910,BENG 196,001,628496,Engler; Adam J.,9998,0,9999,1
1715606994910,BENG 196,002,660916,Watson; John Thomas,9999,0,9999,0
1715606995935,BISP 197,001,650773,Wilhelm; James E.,9994,0,9999,5
1715606995935,BISP 197,002,658904,Coleman; Aaron B.,9998,0,9999,1
1715606996962,CAT 124RS,A01,519847,Geibel; William,0,0,20,20
1715606997988,CAT 125RS,A01,515971,Geibel; William,0,0,20,20
1715606999017,CLRE 250,A00,511389,Morris; Sheldon,9992,0,9999,7
1715607000045,CLRE 251,A00,507176,Mehta; Ravindra L.,9992,0,9999,7
1715607000045,CLRE 251,B00,511410,Mehta; Ravindra L.,9998,0,9999,1
1715607001069,CLRE 252,A00,507189,Cuomo; Raphael Eduardo,9994,0,9999,5
1715607002095,CLRE 253,A00,507199,Vaida; Florin,9994,0,9999,5
1715607002095,CLRE 253,B00,507202,Vaida; Florin,9999,0,9999,0
1715607003127,CLRE 259,A00,507211,Patel; Hemal,9996,0,9999,3
1715607004155,CLRE 260,A00,507221,Cuomo; Raphael Eduardo,9999,0,9999,0
1715607005181,CLRE 297,001,507242,Cuomo; Raphael Eduardo,9999,0,9999,0
1715607006206,COGS 197,001,638244,Voytek; Bradley Thomas,9997,0,9999,2
1715607007234,CSE 191,A00,516875,Minnes Kemp; Mor Mia,9991,0,9999,8
1715607008498,CSE 197,001,637388,Minnes Kemp; Mor Mia,9992,0,9999,7
1715607009523,CSS 201S,A01,494383,Mignozzetti; Umberto,35,0,35,0
1715607010551,CSS 202S,A01,494387,Mignozzetti; Umberto,35,0,35,0
1715607011578,DSC 197,001,628532,Eldridge; Justin Matthew,9995,0,9999,4
1715607012604,EAP 100,A00,516065,Staff,9799,0,9999,200
1715607013633,ECE 45,A01,507414,Staff,31,0,60,29
1715607015685,ECE 111,A01,507420,Staff,11,0,50,39
1715607016716,ECE 197,001,548057,Sievenpiper; Daniel F.,9991,0,9999,8
1715607017744,EDS 115,A00,507243,Choi; Bailey Miyeon,7,0,28,21
1715607018770,EDS 117,A01,494379,Staff,0,6,34,34
1715607019797,EDS 125,A00,507246,Hopkins; Megan Beth,8,0,30,22
1715607020823,EDS 128A,A01,507264,Fargason; Sharon Gayle,6,0,26,20
1715607021852,EDS 128B,A01,507293,Pappas; Elizabeth,10,0,30,20
1715607022878,EDS 139,A00,507294,Fargason; Sharon Gayle,10,0,30,20
1715607022878,EDS 139,B00,507313,Pappas; Elizabeth,11,0,30,19
1715607023904,EDS 201,A00,507315,Staff,10,0,30,20
1715607024930,EDS 203,A01,507317,Halter; Christopher P.,10,0,30,20
1715607025956,EDS 204R,A01,507319,Halter; Christopher P.,0,3,30,30
1715607025956,EDS 204R,B01,507331,Heinzman; Erica M.,14,0,30,16
1715607026983,EDS 206R,A00,507332,Staff,0,4,30,30
1715607026983,EDS 206R,B00,507343,Staff,15,0,30,15
1715607028009,EDS 250,A00,507344,Hemans; Patricia Ann Benitez,20,0,40,20
1715607029036,EDS 281,A00,507345,Daly; Alan J.,18,0,18,0
1715607030063,EDS 284,A00,507350,Daly; Alan J.,16,0,16,0
1715607031089,EDS 286,A00,507359,Fine; Sarah,18,0,18,0
1715607032115,EDS 289C,A01,507361,Daly; Alan J.,18,0,18,0
1715607033142,EDS 290,A00,507366,Hofstetter; Carolyn,15,0,15,0
1715607034167,LIGM 5A,A00,507421,Fischer-Grunski; Eva K,17,0,20,3
1715607035196,LIGM 5B,A00,507423,Fischer-Grunski; Eva K,19,0,20,1
1715607036221,LIGM 5C,A00,507425,Fischer-Grunski; Eva K,19,0,20,1
1715607037248,LIIT 5AS,A00,507427,Carnelos; Chiara,20,0,20,0
1715607038272,LIIT 5BS,A00,507430,Carnelos; Chiara,20,0,20,0
1715607039299,LIIT 5CS,A00,507432,Carnelos; Chiara,20,0,20,0
1715607040330,LISP 5A,A00,507541,Munoz Sanchez; Alicia,11,0,20,9
1715607041356,LISP 5B,A00,507671,Munoz Sanchez; Alicia,9,0,20,11
1715607042382,LISP 5C,A00,507696,Munoz Sanchez; Alicia,9,0,20,11
1715607043409,MAE 197,001,528363,Boechler; Nicholas Sebastia,9998,0,9999,1
1715607044437,MATH 197,001,523477,Kedlaya; Kiran S.,9994,0,9999,5
1715607044437,MATH 197,002,563811,Zhang; Danna,9994,0,9999,5
1715607044437,MATH 197,003,628552,Dumitriu; Ioana,9998,0,9999,1
1715607044437,MATH 197,004,660885,Floyd; Eric,9999,0,9999,0
1715607045465,MCWP 40R,A00,518780,Staff,2,0,20,18
1715607045465,MCWP 40R,B00,518781,Staff,11,0,20,9
1715607045465,MCWP 40R,C00,518783,Staff,5,0,20,15
1715607046491,MCWP 50R,A00,518791,Staff,0,1,20,20
1715607046491,MCWP 50R,B00,518792,Staff,0,2,20,20
1715607046491,MCWP 50R,C00,518793,Staff,0,4,20,20
1715607046491,MCWP 50R,D00,518794,Staff,0,1,20,20
1715607046491,MCWP 50R,E00,518795,Staff,0,2,20,20
1715607046491,MCWP 50R,F00,518796,Staff,0,1,20,20
1715607046491,MCWP 50R,G00,518797,Staff,0,1,20,20
1715607047521,MMW 12R,A01,514034,Herbst; Matthew,0,2,16,16
1715607047521,MMW 12R,A02,514035,Herbst; Matthew,0,0,16,16
1715607048549,MMW 13R,A01,514037,Staff,0,5,16,16
1715607048549,MMW 13R,A02,514039,Staff,0,5,16,16
1715607048549,MMW 13R,A03,628519,Staff,0,4,16,16
1715607050605,SIO 295LS,A00,523233,Staff,10,0,30,20
1715607051633,SIO 295S,A00,523232,Staff,10,0,30,20
1715607052660,SIOC 290S,A01,637330,Merrifield; Mark A,23,0,30,7
1715607053685,SIOC 291S,A01,637333,Gabriel; Corey John,23,0,30,7
1715607054711,SOCI 117,A01,494376,Staff,0,5,5,5
1715607055738,WES 237B,A00,494380,Staff,10,0,20,10
1715607057817,AESE 279B,A00,494370,Wade; Jon P,0,0,33,33
1715607058843,AIP 97,001,660915,Van Den Einde; Yael Dahlia,9999,0,9999,0
1715607059871,AIP 197,001,627712,Vespa; Emanuel Ignacio,9995,0,9999,4
1715607059871,AIP 197,002,650778,Amir; On,9998,0,9999,1
1715607059871,AIP 197,003,650933,Avenancio-Leon; Carlos,9998,0,9999,1
1715607059871,AIP 197,004,658530,Heyman; Gail D.,9998,0,9999,1
1715607059871,AIP 197,005,658631,Neal; Sonya E,9998,0,9999,1
1715607059871,AIP 197,006,658671,Du; Songzi,9998,0,9999,1
1715607060901,ANAR 135S,A00,494369,Braswell; Geoffrey E.,0,0,0,0
1715607061927,BENG 196,001,628496,Engler; Adam J.,9998,0,9999,1
1715607061927,BENG 196,002,660916,Watson; John Thomas,9999,0,9999,0
1715607062954,BISP 197,001,650773,Wilhelm; James E.,9994,0,9999,5
1715607062954,BISP 197,002,658904,Coleman; Aaron B.,9998,0,9999,1
1715607063983,CAT 124RS,A01,519847,Geibel; William,0,0,20,20
1715607065009,CAT 125RS,A01,515971,Geibel; William,0,0,20,20
1715607066036,CLRE 250,A00,511389,Morris; Sheldon,9992,0,9999,7
1715607067067,CLRE 251,A00,507176,Mehta; Ravindra L.,9992,0,9999,7
1715607067067,CLRE 251,B00,511410,Mehta; Ravindra L.,9998,0,9999,1
1715607068098,CLRE 252,A00,507189,Cuomo; Raphael Eduardo,9994,0,9999,5
1715607069124,CLRE 253,A00,507199,Vaida; Florin,9994,0,9999,5
1715607069124,CLRE 253,B00,507202,Vaida; Florin,9999,0,9999,0
1715607070150,CLRE 259,A00,507211,Patel; Hemal,9996,0,9999,3
1715607071177,CLRE 260,A00,507221,Cuomo; Raphael Eduardo,9999,0,9999,0
1715607072202,CLRE 297,001,507242,Cuomo; Raphael Eduardo,9999,0,9999,0
1715607073232,COGS 197,001,638244,Voytek; Bradley Thomas,9997,0,9999,2
1715607074259,CSE 191,A00,516875,Minnes Kemp; Mor Mia,9991,0,9999,8
1715607075285,CSE 197,001,637388,Minnes Kemp; Mor Mia,9992,0,9999,7
1715607076317,CSS 201S,A01,494383,Mignozzetti; Umberto,35,0,35,0
1715607077342,CSS 202S,A01,494387,Mignozzetti; Umberto,35,0,35,0
1715607078370,DSC 197,001,628532,Eldridge; Justin Matthew,9995,0,9999,4
1715607079396,EAP 100,A00,516065,Staff,9799,0,9999,200
1715607080423,ECE 45,A01,507414,Staff,31,0,60,29
1715607082475,ECE 111,A01,507420,Staff,11,0,50,39
1715607083505,ECE 197,001,548057,Sievenpiper; Daniel F.,9991,0,9999,8
1715607084535,EDS 115,A00,507243,Choi; Bailey Miyeon,7,0,28,21
1715607085564,EDS 117,A01,494379,Staff,0,6,34,34
1715607086592,EDS 125,A00,507246,Hopkins; Megan Beth,8,0,30,22
1715607087618,EDS 128A,A01,507264,Fargason; Sharon Gayle,6,0,26,20
1715607088647,EDS 128B,A01,507293,Pappas; Elizabeth,10,0,30,20
1715607089672,EDS 139,A00,507294,Fargason; Sharon Gayle,10,0,30,20
1715607089672,EDS 139,B00,507313,Pappas; Elizabeth,11,0,30,19
1715607090697,EDS 201,A00,507315,Staff,10,0,30,20
1715607091724,EDS 203,A01,507317,Halter; Christopher P.,10,0,30,20
1715607092748,EDS 204R,A01,507319,Halter; Christopher P.,0,3,30,30
1715607092748,EDS 204R,B01,507331,Heinzman; Erica M.,14,0,30,16
1715607093774,EDS 206R,A00,507332,Staff,0,4,30,30
1715607093774,EDS 206R,B00,507343,Staff,15,0,30,15
1715607094800,EDS 250,A00,507344,Hemans; Patricia Ann Benitez,20,0,40,20
1715607095828,EDS 281,A00,507345,Daly; Alan J.,18,0,18,0
1715607096907,EDS 284,A00,507350,Daly; Alan J.,16,0,16,0
1715607097933,EDS 286,A00,507359,Fine; Sarah,18,0,18,0
1715607098959,EDS 289C,A01,507361,Daly; Alan J.,18,0,18,0
1715607099984,EDS 290,A00,507366,Hofstetter; Carolyn,15,0,15,0
1715607101011,LIGM 5A,A00,507421,Fischer-Grunski; Eva K,17,0,20,3
1715607102035,LIGM 5B,A00,507423,Fischer-Grunski; Eva K,19,0,20,1
1715607103061,LIGM 5C,A00,507425,Fischer-Grunski; Eva K,19,0,20,1
1715607104088,LIIT 5AS,A00,507427,Carnelos; Chiara,20,0,20,0
1715607105113,LIIT 5BS,A00,507430,Carnelos; Chiara,20,0,20,0
1715607106142,LIIT 5CS,A00,507432,Carnelos; Chiara,20,0,20,0
1715607107167,LISP 5A,A00,507541,Munoz Sanchez; Alicia,11,0,20,9
1715607108193,LISP 5B,A00,507671,Munoz Sanchez; Alicia,9,0,20,11
1715607109219,LISP 5C,A00,507696,Munoz Sanchez; Alicia,9,0,20,11
1715607110244,MAE 197,001,528363,Boechler; Nicholas Sebastia,9998,0,9999,1
1715607111272,MATH 197,001,523477,Kedlaya; Kiran S.,9994,0,9999,5
1715607111272,MATH 197,002,563811,Zhang; Danna,9994,0,9999,5
1715607111272,MATH 197,003,628552,Dumitriu; Ioana,9998,0,9999,1
1715607111272,MATH 197,004,660885,Floyd; Eric,9999,0,9999,0
1715607112296,MCWP 40R,A00,518780,Staff,2,0,20,18
1715607112296,MCWP 40R,B00,518781,Staff,11,0,20,9
1715607112296,MCWP 40R,C00,518783,Staff,5,0,20,15
1715607113323,MCWP 50R,A00,518791,Staff,0,1,20,20
1715607113323,MCWP 50R,B00,518792,Staff,0,2,20,20
1715607113323,MCWP 50R,C00,518793,Staff,0,4,20,20
1715607113323,MCWP 50R,D00,518794,Staff,0,1,20,20
1715607113323,MCWP 50R,E00,518795,Staff,0,2,20,20
1715607113323,MCWP 50R,F00,518796,Staff,0,1,20,20
1715607113323,MCWP 50R,G00,518797,Staff,0,1,20,20
1715607114351,MMW 12R,A01,514034,Herbst; Matthew,0,2,16,16
1715607114351,MMW 12R,A02,514035,Herbst; Matthew,0,0,16,16
1715607115377,MMW 13R,A01,514037,Staff,0,5,16,16
1715607115377,MMW 13R,A02,514039,Staff,0,5,16,16
1715607115377,MMW 13R,A03,628519,Staff,0,4,16,16
1715607117427,SIO 295LS,A00,523233,Staff,10,0,30,20
1715607118455,SIO 295S,A00,523232,Staff,10,0,30,20
1715607119485,SIOC 290S,A01,637330,Merrifield; Mark A,23,0,30,7
1715607120515,SIOC 291S,A01,637333,Gabriel; Corey John,23,0,30,7
1715607121544,SOCI 117,A01,494376,Staff,0,5,5,5
1715607122570,WES 237B,A00,494380,Staff,10,0,20,10
1715607124635,AESE 279B,A00,494370,Wade; Jon P,0,0,33,33
1715607125662,AIP 97,001,660915,Van Den Einde; Yael Dahlia,9999,0,9999,0
1715607126697,AIP 197,001,627712,Vespa; Emanuel Ignacio,9995,0,9999,4
1715607126697,AIP 197,002,650778,Amir; On,9998,0,9999,1
1715607126697,AIP 197,003,650933,Avenancio-Leon; Carlos,9998,0,9999,1
1715607126697,AIP 197,004,658530,Heyman; Gail D.,9998,0,9999,1
1715607126697,AIP 197,005,658631,Neal; Sonya E,9998,0,9999,1
1715607126697,AIP 197,006,658671,Du; Songzi,9998,0,9999,1
1715607127724,ANAR 135S,A00,494369,Braswell; Geoffrey E.,0,0,0,0
1715607128753,BENG 196,001,628496,Engler; Adam J.,9998,0,9999,1
1715607128753,BENG 196,002,660916,Watson; John Thomas,9999,0,9999,0
1715607129782,BISP 197,001,650773,Wilhelm; James E.,9994,0,9999,5
1715607129782,BISP 197,002,658904,Coleman; Aaron B.,9998,0,9999,1
1715607130807,CAT 124RS,A01,519847,Geibel; William,0,0,20,20
1715607131833,CAT 125RS,A01,515971,Geibel; William,0,0,20,20
1715607132861,CLRE 250,A00,511389,Morris; Sheldon,9992,0,9999,7
1715607133892,CLRE 251,A00,507176,Mehta; Ravindra L.,9992,0,9999,7
1715607133892,CLRE 251,B00,511410,Mehta; Ravindra L.,9998,0,9999,1
1715607134923,CLRE 252,A00,507189,Cuomo; Raphael Eduardo,9994,0,9999,5
1715607135954,CLRE 253,A00,507199,Vaida; Florin,9994,0,9999,5
1715607135954,CLRE 253,B00,507202,Vaida; Florin,9999,0,9999,0
1715607136980,CLRE 259,A00,507211,Patel; Hemal,9996,0,9999,3
1715607138005,CLRE 260,A00,507221,Cuomo; Raphael Eduardo,9999,0,9999,0
1715607139034,CLRE 297,001,507242,Cuomo; Raphael Eduardo,9999,0,9999,0
1715607140062,COGS 197,001,638244,Voytek; Bradley Thomas,9997,0,9999,2
1715607141088,CSE 191,A00,516875,Minnes Kemp; Mor Mia,9991,0,9999,8
1715607142114,CSE 197,001,637388,Minnes Kemp; Mor Mia,9992,0,9999,7
1715607143142,CSS 201S,A01,494383,Mignozzetti; Umberto,35,0,35,0
1715607144168,CSS 202S,A01,494387,Mignozzetti; Umberto,35,0,35,0
1715607145193,DSC 197,001,628532,Eldridge; Justin Matthew,9995,0,9999,4
1715607146221,EAP 100,A00,516065,Staff,9799,0,9999,200
1715607147249,ECE 45,A01,507414,Staff,31,0,60,29
1715607149300,ECE 111,A01,507420,Staff,11,0,50,39
1715607150328,ECE 197,001,548057,Sievenpiper; Daniel F.,9991,0,9999,8
1715607151355,EDS 115,A00,507243,Choi; Bailey Miyeon,7,0,28,21
1715607152382,EDS 117,A01,494379,Staff,0,6,34,34
1715607153408,EDS 125,A00,507246,Hopkins; Megan Beth,8,0,30,22
1715607154437,EDS 128A,A01,507264,Fargason; Sharon Gayle,6,0,26,20
1715607155467,EDS 128B,A01,507293,Pappas; Elizabeth,10,0,30,20
1715607156493,EDS 139,A00,507294,Fargason; Sharon Gayle,10,0,30,20
1715607156493,EDS 139,B00,507313,Pappas; Elizabeth,11,0,30,19
1715607157521,EDS 201,A00,507315,Staff,10,0,30,20
1715607158547,EDS 203,A01,507317,Halter; Christopher P.,10,0,30,20
1715607159573,EDS 204R,A01,507319,Halter; Christopher P.,0,3,30,30
1715607159573,EDS 204R,B01,507331,Heinzman; Erica M.,14,0,30,16
1715607160601,EDS 206R,A00,507332,Staff,0,4,30,30
1715607160601,EDS 206R,B00,507343,Staff,15,0,30,15
1715607161627,EDS 250,A00,507344,Hemans; Patricia Ann Benitez,20,0,40,20
1715607162655,EDS 281,A00,507345,Daly; Alan J.,18,0,18,0
1715607163681,EDS 284,A00,507350,Daly; Alan J.,16,0,16,0
1715607164709,EDS 286,A00,507359,Fine; Sarah,18,0,18,0
1715607165738,EDS 289C,A01,507361,Daly; Alan J.,18,0,18,0
1715607166763,EDS 290,A00,507366,Hofstetter; Carolyn,15,0,15,0
1715607167793,LIGM 5A,A00,507421,Fischer-Grunski; Eva K,17,0,20,3
1715607168819,LIGM 5B,A00,507423,Fischer-Grunski; Eva K,19,0,20,1
1715607169843,LIGM 5C,A00,507425,Fischer-Grunski; Eva K,19,0,20,1
1715607170874,LIIT 5AS,A00,507427,Carnelos; Chiara,20,0,20,0
1715607171901,LIIT 5BS,A00,507430,Carnelos; Chiara,20,0,20,0
1715607172929,LIIT 5CS,A00,507432,Carnelos; Chiara,20,0,20,0
1715607173961,LISP 5A,A00,507541,Munoz Sanchez; Alicia,11,0,20,9
1715607174987,LISP 5B,A00,507671,Munoz Sanchez; Alicia,9,0,20,11
1715607176070,LISP 5C,A00,507696,Munoz Sanchez; Alicia,9,0,20,11
1715607177098,MAE 197,001,528363,Boechler; Nicholas Sebastia,9998,0,9999,1
1715607178130,MATH 197,001,523477,Kedlaya; Kiran S.,9994,0,9999,5
1715607178130,MATH 197,002,563811,Zhang; Danna,9994,0,9999,5
1715607178130,MATH 197,003,628552,Dumitriu; Ioana,9998,0,9999,1
1715607178130,MATH 197,004,660885,Floyd; Eric,9999,0,9999,0
1715607179160,MCWP 40R,A00,518780,Staff,2,0,20,18
1715607179160,MCWP 40R,B00,518781,Staff,11,0,20,9
1715607179160,MCWP 40R,C00,518783,Staff,5,0,20,15
1715607180191,MCWP 50R,A00,518791,Staff,0,1,20,20
1715607180191,MCWP 50R,B00,518792,Staff,0,2,20,20
1715607180191,MCWP 50R,C00,518793,Staff,0,4,20,20
1715607180191,MCWP 50R,D00,518794,Staff,0,1,20,20
1715607180191,MCWP 50R,E00,518795,Staff,0,2,20,20
1715607180191,MCWP 50R,F00,518796,Staff,0,1,20,20
1715607180191,MCWP 50R,G00,518797,Staff,0,1,20,20
1715607181220,MMW 12R,A01,514034,Herbst; Matthew,0,2,16,16
1715607181220,MMW 12R,A02,514035,Herbst; Matthew,0,0,16,16
1715607182251,MMW 13R,A01,514037,Staff,0,5,16,16
1715607182251,MMW 13R,A02,514039,Staff,0,5,16,16
1715607182251,MMW 13R,A03,628519,Staff,0,4,16,16
1715607184307,SIO 295LS,A00,523233,Staff,10,0,30,20
1715607185333,SIO 295S,A00,523232,Staff,10,0,30,20
1715607186360,SIOC 290S,A01,637330,Merrifield; Mark A,23,0,30,7
1715607187386,SIOC 291S,A01,637333,Gabriel; Corey John,23,0,30,7
1715607188415,SOCI 117,A01,494376,Staff,0,5,5,5
1715607189443,WES 237B,A00,494380,Staff,10,0,20,10
1715607191522,AESE 279B,A00,494370,Wade; Jon P,0,0,33,33
1715607192548,AIP 97,001,660915,Van Den Einde; Yael Dahlia,9999,0,9999,0
1715607193576,AIP 197,001,627712,Vespa; Emanuel Ignacio,9995,0,9999,4
1715607193576,AIP 197,002,650778,Amir; On,9998,0,9999,1
1715607193576,AIP 197,003,650933,Avenancio-Leon; Carlos,9998,0,9999,1
1715607193576,AIP 197,004,658530,Heyman; Gail D.,9998,0,9999,1
1715607193576,AIP 197,005,658631,Neal; Sonya E,9998,0,9999,1
1715607193576,AIP 197,006,658671,Du; Songzi,9998,0,9999,1
1715607194605,ANAR 135S,A00,494369,Braswell; Geoffrey E.,0,0,0,0
1715607195635,BENG 196,001,628496,Engler; Adam J.,9998,0,9999,1
1715607195635,BENG 196,002,660916,Watson; John Thomas,9999,0,9999,0
1715607196661,BISP 197,001,650773,Wilhelm; James E.,9994,0,9999,5
1715607196661,BISP 197,002,658904,Coleman; Aaron B.,9998,0,9999,1
1715607197686,CAT 124RS,A01,519847,Geibel; William,0,0,20,20
1715607198715,CAT 125RS,A01,515971,Geibel; William,0,0,20,20
1715607199742,CLRE 250,A00,511389,Morris; Sheldon,9992,0,9999,7
1715607200768,CLRE 251,A00,507176,Mehta; Ravindra L.,9992,0,9999,7
1715607200768,CLRE 251,B00,511410,Mehta; Ravindra L.,9998,0,9999,1
1715607201797,CLRE 252,A00,507189,Cuomo; Raphael Eduardo,9994,0,9999,5
1715607202824,CLRE 253,A00,507199,Vaida; Florin,9994,0,9999,5
1715607202824,CLRE 253,B00,507202,Vaida; Florin,9999,0,9999,0
1715607203851,CLRE 259,A00,507211,Patel; Hemal,9996,0,9999,3
1715607204878,CLRE 260,A00,507221,Cuomo; Raphael Eduardo,9999,0,9999,0
1715607205903,CLRE 297,001,507242,Cuomo; Raphael Eduardo,9999,0,9999,0
1715607206929,COGS 197,001,638244,Voytek; Bradley Thomas,9997,0,9999,2
1715607207958,CSE 191,A00,516875,Minnes Kemp; Mor Mia,9991,0,9999,8
1715607208983,CSE 197,001,637388,Minnes Kemp; Mor Mia,9992,0,9999,7
1715607210014,CSS 201S,A01,494383,Mignozzetti; Umberto,35,0,35,0
1715607211041,CSS 202S,A01,494387,Mignozzetti; Umberto,35,0,35,0
1715607212098,DSC 197,001,628532,Eldridge; Justin Matthew,9995,0,9999,4
1715607213127,EAP 100,A00,516065,Staff,9799,0,9999,200
1715607214156,ECE 45,A01,507414,Staff,31,0,60,29
1715607216209,ECE 111,A01,507420,Staff,11,0,50,39
1715607217235,ECE 197,001,548057,Sievenpiper; Daniel F.,9991,0,9999,8
1715607218266,EDS 115,A00,507243,Choi; Bailey Miyeon,7,0,28,21
1715607219295,EDS 117,A01,494379,Staff,0,6,34,34
1715607220320,EDS 125,A00,507246,Hopkins; Megan Beth,8,0,30,22
1715607221348,EDS 128A,A01,507264,Fargason; Sharon Gayle,6,0,26,20
1715607222374,EDS 128B,A01,507293,Pappas; Elizabeth,10,0,30,20
1715607223400,EDS 139,A00,507294,Fargason; Sharon Gayle,10,0,30,20
1715607223400,EDS 139,B00,507313,Pappas; Elizabeth,11,0,30,19
1715607224426,EDS 201,A00,507315,Staff,10,0,30,20
1715607225452,EDS 203,A01,507317,Halter; Christopher P.,10,0,30,20
1715607226483,EDS 204R,A01,507319,Halter; Christopher P.,0,3,30,30
1715607226483,EDS 204R,B01,507331,Heinzman; Erica M.,14,0,30,16
1715607227509,EDS 206R,A00,507332,Staff,0,4,30,30
1715607227509,EDS 206R,B00,507343,Staff,15,0,30,15
1715607228538,EDS 250,A00,507344,Hemans; Patricia Ann Benitez,20,0,40,20
1715607229564,EDS 281,A00,507345,Daly; Alan J.,18,0,18,0
1715607230593,EDS 284,A00,507350,Daly; Alan J.,16,0,16,0
1715607231618,EDS 286,A00,507359,Fine; Sarah,18,0,18,0
1715607232648,EDS 289C,A01,507361,Daly; Alan J.,18,0,18,0
1715607233675,EDS 290,A00,507366,Hofstetter; Carolyn,15,0,15,0
1715607234705,LIGM 5A,A00,507421,Fischer-Grunski; Eva K,17,0,20,3
1715607235733,LIGM 5B,A00,507423,Fischer-Grunski; Eva K,19,0,20,1
1715607236763,LIGM 5C,A00,507425,Fischer-Grunski; Eva K,19,0,20,1
1715607237790,LIIT 5AS,A00,507427,Carnelos; Chiara,20,0,20,0
1715607238820,LIIT 5BS,A00,507430,Carnelos; Chiara,20,0,20,0
1715607239850,LIIT 5CS,A00,507432,Carnelos; Chiara,20,0,20,0
1715607240877,LISP 5A,A00,507541,Munoz Sanchez; Alicia,11,0,20,9
1715607241910,LISP 5B,A00,507671,Munoz Sanchez; Alicia,9,0,20,11
1715607242940,LISP 5C,A00,507696,Munoz Sanchez; Alicia,9,0,20,11
1715607243968,MAE 197,001,528363,Boechler; Nicholas Sebastia,9998,0,9999,1
1715607244996,MATH 197,001,523477,Kedlaya; Kiran S.,9994,0,9999,5
1715607244996,MATH 197,002,563811,Zhang; Danna,9994,0,9999,5
1715607244996,MATH 197,003,628552,Dumitriu; Ioana,9998,0,9999,1
1715607244996,MATH 197,004,660885,Floyd; Eric,9999,0,9999,0
1715607246025,MCWP 40R,A00,518780,Staff,2,0,20,18
1715607246025,MCWP 40R,B00,518781,Staff,11,0,20,9
1715607246025,MCWP 40R,C00,518783,Staff,5,0,20,15
1715607247056,MCWP 50R,A00,518791,Staff,0,1,20,20
1715607247056,MCWP 50R,B00,518792,Staff,0,2,20,20
1715607247056,MCWP 50R,C00,518793,Staff,0,4,20,20
1715607247056,MCWP 50R,D00,518794,Staff,0,1,20,20
1715607247056,MCWP 50R,E00,518795,Staff,0,2,20,20
1715607247056,MCWP 50R,F00,518796,Staff,0,1,20,20
1715607247056,MCWP 50R,G00,518797,Staff,0,1,20,20
1715607248086,MMW 12R,A01,514034,Herbst; Matthew,0,2,16,16
1715607248086,MMW 12R,A02,514035,Herbst; Matthew,0,0,16,16
1715607249111,MMW 13R,A01,514037,Staff,0,5,16,16
1715607249111,MMW 13R,A02,514039,Staff,0,5,16,16
1715607249111,MMW 13R,A03,628519,Staff,0,4,16,16
1715607251166,SIO 295LS,A00,523233,Staff,10,0,30,20
1715607252195,SIO 295S,A00,523232,Staff,10,0,30,20
1715607253223,SIOC 290S,A01,637330,Merrifield; Mark A,23,0,30,7
1715607254249,SIOC 291S,A01,637333,Gabriel; Corey John,23,0,30,7
1715607255277,SOCI 117,A01,494376,Staff,0,5,5,5
1715607256310,WES 237B,A00,494380,Staff,10,0,20,10
1715607258374,AESE 279B,A00,494370,Wade; Jon P,0,0,33,33
1715607259402,AIP 97,001,660915,Van Den Einde; Yael Dahlia,9999,0,9999,0
1715607260426,AIP 197,001,627712,Vespa; Emanuel Ignacio,9995,0,9999,4
1715607260426,AIP 197,002,650778,Amir; On,9998,0,9999,1
1715607260426,AIP 197,003,650933,Avenancio-Leon; Carlos,9998,0,9999,1
1715607260426,AIP 197,004,658530,Heyman; Gail D.,9998,0,9999,1
1715607260426,AIP 197,005,658631,Neal; Sonya E,9998,0,9999,1
1715607260426,AIP 197,006,658671,Du; Songzi,9998,0,9999,1
1715607261452,ANAR 135S,A00,494369,Braswell; Geoffrey E.,0,0,0,0
1715607262477,BENG 196,001,628496,Engler; Adam J.,9998,0,9999,1
1715607262477,BENG 196,002,660916,Watson; John Thomas,9999,0,9999,0
1715607263505,BISP 197,001,650773,Wilhelm; James E.,9994,0,9999,5
1715607263505,BISP 197,002,658904,Coleman; Aaron B.,9998,0,9999,1
1715607264532,CAT 124RS,A01,519847,Geibel; William,0,0,20,20
1715607265559,CAT 125RS,A01,515971,Geibel; William,0,0,20,20
1715607266584,CLRE 250,A00,511389,Morris; Sheldon,9992,0,9999,7
1715607267610,CLRE 251,A00,507176,Mehta; Ravindra L.,9992,0,9999,7
1715607267610,CLRE 251,B00,511410,Mehta; Ravindra L.,9998,0,9999,1
1715607268639,CLRE 252,A00,507189,Cuomo; Raphael Eduardo,9994,0,9999,5
1715607269663,CLRE 253,A00,507199,Vaida; Florin,9994,0,9999,5
1715607269663,CLRE 253,B00,507202,Vaida; Florin,9999,0,9999,0
1715607270689,CLRE 259,A00,507211,Patel; Hemal,9996,0,9999,3
1715607271716,CLRE 260,A00,507221,Cuomo; Raphael Eduardo,9999,0,9999,0
1715607272743,CLRE 297,001,507242,Cuomo; Raphael Eduardo,9999,0,9999,0
1715607273772,COGS 197,001,638244,Voytek; Bradley Thomas,9997,0,9999,2
1715607274798,CSE 191,A00,516875,Minnes Kemp; Mor Mia,9991,0,9999,8
1715607275825,CSE 197,001,637388,Minnes Kemp; Mor Mia,9992,0,9999,7
1715607276851,CSS 201S,A01,494383,Mignozzetti; Umberto,35,0,35,0
1715607277881,CSS 202S,A01,494387,Mignozzetti; Umberto,35,0,35,0
1715607278908,DSC 197,001,628532,Eldridge; Justin Matthew,9995,0,9999,4
1715607279935,EAP 100,A00,516065,Staff,9799,0,9999,200
1715607280970,ECE 45,A01,507414,Staff,31,0,60,29
1715607283024,ECE 111,A01,507420,Staff,11,0,50,39
1715607284052,ECE 197,001,548057,Sievenpiper; Daniel F.,9991,0,9999,8
1715607285077,EDS 115,A00,507243,Choi; Bailey Miyeon,7,0,28,21
1715607286102,EDS 117,A01,494379,Staff,0,6,34,34
1715607287126,EDS 125,A00,507246,Hopkins; Megan Beth,8,0,30,22
1715607288150,EDS 128A,A01,507264,Fargason; Sharon Gayle,6,0,26,20
1715607289177,EDS 128B,A01,507293,Pappas; Elizabeth,10,0,30,20
1715607290206,EDS 139,A00,507294,Fargason; Sharon Gayle,10,0,30,20
1715607290206,EDS 139,B00,507313,Pappas; Elizabeth,11,0,30,19
1715607291235,EDS 201,A00,507315,Staff,10,0,30,20
1715607292261,EDS 203,A01,507317,Halter; Christopher P.,10,0,30,20
1715607293287,EDS 204R,A01,507319,Halter; Christopher P.,0,3,30,30
1715607293287,EDS 204R,B01,507331,Heinzman; Erica M.,14,0,30,16
1715607294313,EDS 206R,A00,507332,Staff,0,4,30,30
1715607294313,EDS 206R,B00,507343,Staff,15,0,30,15
1715607295339,EDS 250,A00,507344,Hemans; Patricia Ann Benitez,20,0,40,20
1715607296368,EDS 281,A00,507345,Daly; Alan J.,18,0,18,0
1715607297395,EDS 284,A00,507350,Daly; Alan J.,16,0,16,0
1715607298425,EDS 286,A00,507359,Fine; Sarah,18,0,18,0
1715607299454,EDS 289C,A01,507361,Daly; Alan J.,18,0,18,0
1715607300479,EDS 290,A00,507366,Hofstetter; Carolyn,15,0,15,0
1715607301508,LIGM 5A,A00,507421,Fischer-Grunski; Eva K,17,0,20,3
1715607302536,LIGM 5B,A00,507423,Fischer-Grunski; Eva K,19,0,20,1
1715607303567,LIGM 5C,A00,507425,Fischer-Grunski; Eva K,19,0,20,1
1715607304592,LIIT 5AS,A00,507427,Carnelos; Chiara,20,0,20,0
1715607305619,LIIT 5BS,A00,507430,Carnelos; Chiara,20,0,20,0
1715607306649,LIIT 5CS,A00,507432,Carnelos; Chiara,20,0,20,0
1715607307676,LISP 5A,A00,507541,Munoz Sanchez; Alicia,11,0,20,9
1715607308704,LISP 5B,A00,507671,Munoz Sanchez; Alicia,9,0,20,11
1715607309730,LISP 5C,A00,507696,Munoz Sanchez; Alicia,9,0,20,11
1715607310756,MAE 197,001,528363,Boechler; Nicholas Sebastia,9998,0,9999,1
1715607311785,MATH 197,001,523477,Kedlaya; Kiran S.,9994,0,9999,5
1715607311785,MATH 197,002,563811,Zhang; Danna,9994,0,9999,5
1715607311785,MATH 197,003,628552,Dumitriu; Ioana,9998,0,9999,1
1715607311785,MATH 197,004,660885,Floyd; Eric,9999,0,9999,0
1715607312813,MCWP 40R,A00,518780,Staff,2,0,20,18
1715607312813,MCWP 40R,B00,518781,Staff,11,0,20,9
1715607312813,MCWP 40R,C00,518783,Staff,5,0,20,15
1715607313845,MCWP 50R,A00,518791,Staff,0,1,20,20
1715607313845,MCWP 50R,B00,518792,Staff,0,2,20,20
1715607313845,MCWP 50R,C00,518793,Staff,0,4,20,20
1715607313845,MCWP 50R,D00,518794,Staff,0,1,20,20
1715607313845,MCWP 50R,E00,518795,Staff,0,2,20,20
1715607313845,MCWP 50R,F00,518796,Staff,0,1,20,20
1715607313845,MCWP 50R,G00,518797,Staff,0,1,20,20
1715607314874,MMW 12R,A01,514034,Herbst; Matthew,0,2,16,16
1715607314874,MMW 12R,A02,514035,Herbst; Matthew,0,0,16,16
1715607315902,MMW 13R,A01,514037,Staff,0,5,16,16
1715607315902,MMW 13R,A02,514039,Staff,0,5,16,16
1715607315902,MMW 13R,A03,628519,Staff,0,4,16,16
1715607317953,SIO 295LS,A00,523233,Staff,10,0,30,20
1715607318982,SIO 295S,A00,523232,Staff,10,0,30,20
1715607320007,SIOC 290S,A01,637330,Merrifield; Mark A,23,0,30,7
1715607321034,SIOC 291S,A01,637333,Gabriel; Corey John,23,0,30,7
1715607322064,SOCI 117,A01,494376,Staff,0,5,5,5
1715607323090,WES 237B,A00,494380,Staff,10,0,20,10
1715607325165,AESE 279B,A00,494370,Wade; Jon P,0,0,33,33
1715607326192,AIP 97,001,660915,Van Den Einde; Yael Dahlia,9999,0,9999,0
1715607327229,AIP 197,001,627712,Vespa; Emanuel Ignacio,9995,0,9999,4
1715607327229,AIP 197,002,650778,Amir; On,9998,0,9999,1
1715607327229,AIP 197,003,650933,Avenancio-Leon; Carlos,9998,0,9999,1
1715607327229,AIP 197,004,658530,Heyman; Gail D.,9998,0,9999,1
1715607327229,AIP 197,005,658631,Neal; Sonya E,9998,0,9999,1
1715607327229,AIP 197,006,658671,Du; Songzi,9998,0,9999,1
1715607328255,ANAR 135S,A00,494369,Braswell; Geoffrey E.,0,0,0,0
1715607329284,BENG 196,001,628496,Engler; Adam J.,9998,0,9999,1
1715607329284,BENG 196,002,660916,Watson; John Thomas,9999,0,9999,0
1715607330310,BISP 197,001,650773,Wilhelm; James E.,9994,0,9999,5
1715607330310,BISP 197,002,658904,Coleman; Aaron B.,9998,0,9999,1
1715607331335,CAT 124RS,A01,519847,Geibel; William,0,0,20,20
1715607332360,CAT 125RS,A01,515971,Geibel; William,0,0,20,20
1715607333387,CLRE 250,A00,511389,Morris; Sheldon,9992,0,9999,7
1715607334417,CLRE 251,A00,507176,Mehta; Ravindra L.,9992,0,9999,7
1715607334417,CLRE 251,B00,511410,Mehta; Ravindra L.,9998,0,9999,1
1715607335447,CLRE 252,A00,507189,Cuomo; Raphael Eduardo,9994,0,9999,5
1715607336474,CLRE 253,A00,507199,Vaida; Florin,9994,0,9999,5
1715607336474,CLRE 253,B00,507202,Vaida; Florin,9999,0,9999,0
1715607337503,CLRE 259,A00,507211,Patel; Hemal,9996,0,9999,3
1715607338532,CLRE 260,A00,507221,Cuomo; Raphael Eduardo,9999,0,9999,0
1715607339558,CLRE 297,001,507242,Cuomo; Raphael Eduardo,9999,0,9999,0
1715607340583,COGS 197,001,638244,Voytek; Bradley Thomas,9997,0,9999,2
1715607341612,CSE 191,A00,516875,Minnes Kemp; Mor Mia,9991,0,9999,8
1715607342640,CSE 197,001,637388,Minnes Kemp; Mor Mia,9992,0,9999,7
1715607343672,CSS 201S,A01,494383,Mignozzetti; Umberto,35,0,35,0
1715607344698,CSS 202S,A01,494387,Mignozzetti; Umberto,35,0,35,0
1715607345726,DSC 197,001,628532,Eldridge; Justin Matthew,9995,0,9999,4
1715607346749,EAP 100,A00,516065,Staff,9799,0,9999,200
1715607347783,ECE 45,A01,507414,Staff,31,0,60,29
1715607349836,ECE 111,A01,507420,Staff,11,0,50,39
1715607350865,ECE 197,001,548057,Sievenpiper; Daniel F.,9991,0,9999,8
1715607351892,EDS 115,A00,507243,Choi; Bailey Miyeon,7,0,28,21
1715607352922,EDS 117,A01,494379,Staff,0,6,34,34
1715607353948,EDS 125,A00,507246,Hopkins; Megan Beth,8,0,30,22
1715607354977,EDS 128A,A01,507264,Fargason; Sharon Gayle,6,0,26,20
1715607356002,EDS 128B,A01,507293,Pappas; Elizabeth,10,0,30,20
1715607357030,EDS 139,A00,507294,Fargason; Sharon Gayle,10,0,30,20
1715607357030,EDS 139,B00,507313,Pappas; Elizabeth,11,0,30,19
1715607358060,EDS 201,A00,507315,Staff,10,0,30,20
1715607359090,EDS 203,A01,507317,Halter; Christopher P.,10,0,30,20
1715607360116,EDS 204R,A01,507319,Halter; Christopher P.,0,3,30,30
1715607360116,EDS 204R,B01,507331,Heinzman; Erica M.,14,0,30,16
1715607361145,EDS 206R,A00,507332,Staff,0,4,30,30
1715607361145,EDS 206R,B00,507343,Staff,15,0,30,15
1715607362174,EDS 250,A00,507344,Hemans; Patricia Ann Benitez,20,0,40,20
1715607363203,EDS 281,A00,507345,Daly; Alan J.,18,0,18,0
1715607364229,EDS 284,A00,507350,Daly; Alan J.,16,0,16,0
1715607365255,EDS 286,A00,507359,Fine; Sarah,18,0,18,0
1715607366283,EDS 289C,A01,507361,Daly; Alan J.,18,0,18,0
1715607367310,EDS 290,A00,507366,Hofstetter; Carolyn,15,0,15,0
1715607368340,LIGM 5A,A00,507421,Fischer-Grunski; Eva K,17,0,20,3
1715607369369,LIGM 5B,A00,507423,Fischer-Grunski; Eva K,19,0,20,1
1715607370397,LIGM 5C,A00,507425,Fischer-Grunski; Eva K,19,0,20,1
1715607371424,LIIT 5AS,A00,507427,Carnelos; Chiara,20,0,20,0
1715607372452,LIIT 5BS,A00,507430,Carnelos; Chiara,20,0,20,0
1715607373480,LIIT 5CS,A00,507432,Carnelos; Chiara,20,0,20,0
1715607374506,LISP 5A,A00,507541,Munoz Sanchez; Alicia,11,0,20,9
1715607375535,LISP 5B,A00,507671,Munoz Sanchez; Alicia,9,0,20,11
1715607376561,LISP 5C,A00,507696,Munoz Sanchez; Alicia,9,0,20,11
1715607377588,MAE 197,001,528363,Boechler; Nicholas Sebastia,9998,0,9999,1
1715607378617,MATH 197,001,523477,Kedlaya; Kiran S.,9994,0,9999,5
1715607378617,MATH 197,002,563811,Zhang; Danna,9994,0,9999,5
1715607378617,MATH 197,003,628552,Dumitriu; Ioana,9998,0,9999,1
1715607378617,MATH 197,004,660885,Floyd; Eric,9999,0,9999,0
1715607379644,MCWP 40R,A00,518780,Staff,2,0,20,18
1715607379644,MCWP 40R,B00,518781,Staff,11,0,20,9
1715607379644,MCWP 40R,C00,518783,Staff,5,0,20,15
1715607380671,MCWP 50R,A00,518791,Staff,0,1,20,20
1715607380671,MCWP 50R,B00,518792,Staff,0,2,20,20
1715607380671,MCWP 50R,C00,518793,Staff,0,4,20,20
1715607380671,MCWP 50R,D00,518794,Staff,0,1,20,20
1715607380671,MCWP 50R,E00,518795,Staff,0,2,20,20
1715607380671,MCWP 50R,F00,518796,Staff,0,1,20,20
1715607380671,MCWP 50R,G00,518797,Staff,0,1,20,20
1715607381697,MMW 12R,A01,514034,Herbst; Matthew,0,2,16,16
1715607381697,MMW 12R,A02,514035,Herbst; Matthew,0,0,16,16
1715607382724,MMW 13R,A01,514037,Staff,0,5,16,16
1715607382724,MMW 13R,A02,514039,Staff,0,5,16,16
1715607382724,MMW 13R,A03,628519,Staff,0,4,16,16
1715607384781,SIO 295LS,A00,523233,Staff,10,0,30,20
1715607385808,SIO 295S,A00,523232,Staff,10,0,30,20
1715607386833,SIOC 290S,A01,637330,Merrifield; Mark A,23,0,30,7
1715607387860,SIOC 291S,A01,637333,Gabriel; Corey John,23,0,30,7
1715607388889,SOCI 117,A01,494376,Staff,0,5,5,5
1715607389915,WES 237B,A00,494380,Staff,10,0,20,10
1715607391983,AESE 279B,A00,494370,Wade; Jon P,0,0,33,33
1715607393009,AIP 97,001,660915,Van Den Einde; Yael Dahlia,9999,0,9999,0
1715607394039,AIP 197,001,627712,Vespa; Emanuel Ignacio,9995,0,9999,4
1715607394039,AIP 197,002,650778,Amir; On,9998,0,9999,1
1715607394039,AIP 197,003,650933,Avenancio-Leon; Carlos,9998,0,9999,1
1715607394039,AIP 197,004,658530,Heyman; Gail D.,9998,0,9999,1
1715607394039,AIP 197,005,658631,Neal; Sonya E,9998,0,9999,1
1715607394039,AIP 197,006,658671,Du; Songzi,9998,0,9999,1
1715607395065,ANAR 135S,A00,494369,Braswell; Geoffrey E.,0,0,0,0
1715607396092,BENG 196,001,628496,Engler; Adam J.,9998,0,9999,1
1715607396092,BENG 196,002,660916,Watson; John Thomas,9999,0,9999,0
1715607397122,BISP 197,001,650773,Wilhelm; James E.,9994,0,9999,5
1715607397122,BISP 197,002,658904,Coleman; Aaron B.,9998,0,9999,1
1715607398149,CAT 124RS,A01,519847,Geibel; William,0,0,20,20
1715607399177,CAT 125RS,A01,515971,Geibel; William,0,0,20,20
1715607400204,CLRE 250,A00,511389,Morris; Sheldon,9992,0,9999,7
1715607401231,CLRE 251,A00,507176,Mehta; Ravindra L.,9992,0,9999,7
1715607401231,CLRE 251,B00,511410,Mehta; Ravindra L.,9998,0,9999,1
1715607402256,CLRE 252,A00,507189,Cuomo; Raphael Eduardo,9994,0,9999,5
1715607403283,CLRE 253,A00,507199,Vaida; Florin,9994,0,9999,5
1715607403283,CLRE 253,B00,507202,Vaida; Florin,9999,0,9999,0
1715607404310,CLRE 259,A00,507211,Patel; Hemal,9996,0,9999,3
1715607405337,CLRE 260,A00,507221,Cuomo; Raphael Eduardo,9999,0,9999,0
1715607406366,CLRE 297,001,507242,Cuomo; Raphael Eduardo,9999,0,9999,0
1715607407391,COGS 197,001,638244,Voytek; Bradley Thomas,9997,0,9999,2
1715607408419,CSE 191,A00,516875,Minnes Kemp; Mor Mia,9991,0,9999,8
1715607409447,CSE 197,001,637388,Minnes Kemp; Mor Mia,9992,0,9999,7
1715607410480,CSS 201S,A01,494383,Mignozzetti; Umberto,35,0,35,0
1715607411511,CSS 202S,A01,494387,Mignozzetti; Umberto,35,0,35,0
1715607412537,DSC 197,001,628532,Eldridge; Justin Matthew,9995,0,9999,4
1715607413562,EAP 100,A00,516065,Staff,9799,0,9999,200
1715607414590,ECE 45,A01,507414,Staff,31,0,60,29
1715607416643,ECE 111,A01,507420,Staff,11,0,50,39
1715607417672,ECE 197,001,548057,Sievenpiper; Daniel F.,9991,0,9999,8
1715607418702,EDS 115,A00,507243,Choi; Bailey Miyeon,7,0,28,21
1715607419732,EDS 117,A01,494379,Staff,0,6,34,34
1715607420762,EDS 125,A00,507246,Hopkins; Megan Beth,8,0,30,22
1715607421787,EDS 128A,A01,507264,Fargason; Sharon Gayle,6,0,26,20
1715607422812,EDS 128B,A01,507293,Pappas; Elizabeth,10,0,30,20
1715607423837,EDS 139,A00,507294,Fargason; Sharon Gayle,10,0,30,20
1715607423837,EDS 139,B00,507313,Pappas; Elizabeth,11,0,30,19
1715607424863,EDS 201,A00,507315,Staff,10,0,30,20
1715607425893,EDS 203,A01,507317,Halter; Christopher P.,10,0,30,20
1715607426922,EDS 204R,A01,507319,Halter; Christopher P.,0,3,30,30
1715607426922,EDS 204R,B01,507331,Heinzman; Erica M.,14,0,30,16
1715607427946,EDS 206R,A00,507332,Staff,0,4,30,30
1715607427946,EDS 206R,B00,507343,Staff,15,0,30,15
1715607428977,EDS 250,A00,507344,Hemans; Patricia Ann Benitez,20,0,40,20
1715607430006,EDS 281,A00,507345,Daly; Alan J.,18,0,18,0
1715607431032,EDS 284,A00,507350,Daly; Alan J.,16,0,16,0
1715607432059,EDS 286,A00,507359,Fine; Sarah,18,0,18,0
1715607433084,EDS 289C,A01,507361,Daly; Alan J.,18,0,18,0
1715607434111,EDS 290,A00,507366,Hofstetter; Carolyn,15,0,15,0
1715607435143,LIGM 5A,A00,507421,Fischer-Grunski; Eva K,17,0,20,3
1715607436172,LIGM 5B,A00,507423,Fischer-Grunski; Eva K,19,0,20,1
1715607437199,LIGM 5C,A00,507425,Fischer-Grunski; Eva K,19,0,20,1
1715607438225,LIIT 5AS,A00,507427,Carnelos; Chiara,20,0,20,0
1715607439259,LIIT 5BS,A00,507430,Carnelos; Chiara,20,0,20,0
1715607440283,LIIT 5CS,A00,507432,Carnelos; Chiara,20,0,20,0
1715607441309,LISP 5A,A00,507541,Munoz Sanchez; Alicia,11,0,20,9
1715607442335,LISP 5B,A00,507671,Munoz Sanchez; Alicia,9,0,20,11
1715607443360,LISP 5C,A00,507696,Munoz Sanchez; Alicia,9,0,20,11
1715607444386,MAE 197,001,528363,Boechler; Nicholas Sebastia,9998,0,9999,1
1715607445418,MATH 197,001,523477,Kedlaya; Kiran S.,9994,0,9999,5
1715607445418,MATH 197,002,563811,Zhang; Danna,9994,0,9999,5
1715607445418,MATH 197,003,628552,Dumitriu; Ioana,9998,0,9999,1
1715607445418,MATH 197,004,660885,Floyd; Eric,9999,0,9999,0
1715607446444,MCWP 40R,A00,518780,Staff,2,0,20,18
1715607446444,MCWP 40R,B00,518781,Staff,11,0,20,9
1715607446444,MCWP 40R,C00,518783,Staff,5,0,20,15
1715607447470,MCWP 50R,A00,518791,Staff,0,1,20,20
1715607447470,MCWP 50R,B00,518792,Staff,0,2,20,20
1715607447470,MCWP 50R,C00,518793,Staff,0,4,20,20
1715607447470,MCWP 50R,D00,518794,Staff,0,1,20,20
1715607447470,MCWP 50R,E00,518795,Staff,0,2,20,20
1715607447470,MCWP 50R,F00,518796,Staff,0,1,20,20
1715607447470,MCWP 50R,G00,518797,Staff,0,1,20,20
1715607448496,MMW 12R,A01,514034,Herbst; Matthew,0,2,16,16
1715607448496,MMW 12R,A02,514035,Herbst; Matthew,0,0,16,16
1715607449522,MMW 13R,A01,514037,Staff,0,5,16,16
1715607449522,MMW 13R,A02,514039,Staff,0,5,16,16
1715607449522,MMW 13R,A03,628519,Staff,0,4,16,16
1715607451575,SIO 295LS,A00,523233,Staff,10,0,30,20
1715607452600,SIO 295S,A00,523232,Staff,10,0,30,20
1715607453627,SIOC 290S,A01,637330,Merrifield; Mark A,23,0,30,7
1715607454653,SIOC 291S,A01,637333,Gabriel; Corey John,23,0,30,7
1715607455684,SOCI 117,A01,494376,Staff,0,5,5,5
1715607456711,WES 237B,A00,494380,Staff,10,0,20,10
1715607458783,AESE 279B,A00,494370,Wade; Jon P,0,0,33,33
1715607459814,AIP 97,001,660915,Van Den Einde; Yael Dahlia,9999,0,9999,0
1715607460843,AIP 197,001,627712,Vespa; Emanuel Ignacio,9995,0,9999,4
1715607460843,AIP 197,002,650778,Amir; On,9998,0,9999,1
1715607460843,AIP 197,003,650933,Avenancio-Leon; Carlos,9998,0,9999,1
1715607460843,AIP 197,004,658530,Heyman; Gail D.,9998,0,9999,1
1715607460843,AIP 197,005,658631,Neal; Sonya E,9998,0,9999,1
1715607460843,AIP 197,006,658671,Du; Songzi,9998,0,9999,1
1715607461875,ANAR 135S,A00,494369,Braswell; Geoffrey E.,0,0,0,0
1715607462905,BENG 196,001,628496,Engler; Adam J.,9998,0,9999,1
1715607462905,BENG 196,002,660916,Watson; John Thomas,9999,0,9999,0
1715607463992,BISP 197,001,650773,Wilhelm; James E.,9994,0,9999,5
1715607463992,BISP 197,002,658904,Coleman; Aaron B.,9998,0,9999,1
1715607465023,CAT 124RS,A01,519847,Geibel; William,0,0,20,20
1715607466051,CAT 125RS,A01,515971,Geibel; William,0,0,20,20
1715607467077,CLRE 250,A00,511389,Morris; Sheldon,9992,0,9999,7
1715607468105,CLRE 251,A00,507176,Mehta; Ravindra L.,9992,0,9999,7
1715607468105,CLRE 251,B00,511410,Mehta; Ravindra L.,9998,0,9999,1
1715607469135,CLRE 252,A00,507189,Cuomo; Raphael Eduardo,9994,0,9999,5
1715607470162,CLRE 253,A00,507199,Vaida; Florin,9994,0,9999,5
1715607470162,CLRE 253,B00,507202,Vaida; Florin,9999,0,9999,0
1715607471189,CLRE 259,A00,507211,Patel; Hemal,9996,0,9999,3
1715607472218,CLRE 260,A00,507221,Cuomo; Raphael Eduardo,9999,0,9999,0
1715607473243,CLRE 297,001,507242,Cuomo; Raphael Eduardo,9999,0,9999,0
1715607474274,COGS 197,001,638244,Voytek; Bradley Thomas,9997,0,9999,2
1715607475300,CSE 191,A00,516875,Minnes Kemp; Mor Mia,9991,0,9999,8
1715607476328,CSE 197,001,637388,Minnes Kemp; Mor Mia,9992,0,9999,7
1715607477356,CSS 201S,A01,494383,Mignozzetti; Umberto,35,0,35,0
1715607478385,CSS 202S,A01,494387,Mignozzetti; Umberto,35,0,35,0
1715607479415,DSC 197,001,628532,Eldridge; Justin Matthew,9995,0,9999,4
1715607480439,EAP 100,A00,516065,Staff,9799,0,9999,200
1715607481466,ECE 45,A01,507414,Staff,31,0,60,29
1715607483524,ECE 111,A01,507420,Staff,11,0,50,39
1715607484550,ECE 197,001,548057,Sievenpiper; Daniel F.,9991,0,9999,8
1715607485577,EDS 115,A00,507243,Choi; Bailey Miyeon,7,0,28,21
1715607486603,EDS 117,A01,494379,Staff,0,6,34,34
1715607487629,EDS 125,A00,507246,Hopkins; Megan Beth,8,0,30,22
1715607488655,EDS 128A,A01,507264,Fargason; Sharon Gayle,6,0,26,20
1715607489685,EDS 128B,A01,507293,Pappas; Elizabeth,10,0,30,20
1715607490712,EDS 139,A00,507294,Fargason; Sharon Gayle,10,0,30,20
1715607490712,EDS 139,B00,507313,Pappas; Elizabeth,11,0,30,19
1715607491740,EDS 201,A00,507315,Staff,10,0,30,20
1715607492772,EDS 203,A01,507317,Halter; Christopher P.,10,0,30,20
1715607493798,EDS 204R,A01,507319,Halter; Christopher P.,0,3,30,30
1715607493798,EDS 204R,B01,507331,Heinzman; Erica M.,14,0,30,16
1715607494824,EDS 206R,A00,507332,Staff,0,4,30,30
1715607494824,EDS 206R,B00,507343,Staff,15,0,30,15
1715607495855,EDS 250,A00,507344,Hemans; Patricia Ann Benitez,20,0,40,20
1715607496883,EDS 281,A00,507345,Daly; Alan J.,18,0,18,0
1715607497913,EDS 284,A00,507350,Daly; Alan J.,16,0,16,0
1715607498938,EDS 286,A00,507359,Fine; Sarah,18,0,18,0
1715607499965,EDS 289C,A01,507361,Daly; Alan J.,18,0,18,0
1715607500994,EDS 290,A00,507366,Hofstetter; Carolyn,15,0,15,0
1715607502026,LIGM 5A,A00,507421,Fischer-Grunski; Eva K,17,0,20,3
1715607503053,LIGM 5B,A00,507423,Fischer-Grunski; Eva K,19,0,20,1
1715607504084,LIGM 5C,A00,507425,Fischer-Grunski; Eva K,19,0,20,1
1715607505113,LIIT 5AS,A00,507427,Carnelos; Chiara,20,0,20,0
1715607506141,LIIT 5BS,A00,507430,Carnelos; Chiara,20,0,20,0
1715607507170,LIIT 5CS,A00,507432,Carnelos; Chiara,20,0,20,0
1715607508198,LISP 5A,A00,507541,Munoz Sanchez; Alicia,11,0,20,9
1715607509225,LISP 5B,A00,507671,Munoz Sanchez; Alicia,9,0,20,11
1715607510255,LISP 5C,A00,507696,Munoz Sanchez; Alicia,9,0,20,11
1715607511284,MAE 197,001,528363,Boechler; Nicholas Sebastia,9998,0,9999,1
1715607512319,MATH 197,001,523477,Kedlaya; Kiran S.,9994,0,9999,5
1715607512319,MATH 197,002,563811,Zhang; Danna,9994,0,9999,5
1715607512319,MATH 197,003,628552,Dumitriu; Ioana,9998,0,9999,1
1715607512319,MATH 197,004,660885,Floyd; Eric,9999,0,9999,0
1715607513347,MCWP 40R,A00,518780,Staff,2,0,20,18
1715607513347,MCWP 40R,B00,518781,Staff,11,0,20,9
1715607513347,MCWP 40R,C00,518783,Staff,5,0,20,15
1715607514371,MCWP 50R,A00,518791,Staff,0,1,20,20
1715607514371,MCWP 50R,B00,518792,Staff,0,2,20,20
1715607514371,MCWP 50R,C00,518793,Staff,0,4,20,20
1715607514371,MCWP 50R,D00,518794,Staff,0,1,20,20
1715607514371,MCWP 50R,E00,518795,Staff,0,2,20,20
1715607514371,MCWP 50R,F00,518796,Staff,0,1,20,20
1715607514371,MCWP 50R,G00,518797,Staff,0,1,20,20
1715607515395,MMW 12R,A01,514034,Herbst; Matthew,0,2,16,16
1715607515395,MMW 12R,A02,514035,Herbst; Matthew,0,0,16,16
1715607516423,MMW 13R,A01,514037,Staff,0,5,16,16
1715607516423,MMW 13R,A02,514039,Staff,0,5,16,16
1715607516423,MMW 13R,A03,628519,Staff,0,4,16,16
1715607518474,SIO 295LS,A00,523233,Staff,10,0,30,20
1715607519503,SIO 295S,A00,523232,Staff,10,0,30,20
1715607520530,SIOC 290S,A01,637330,Merrifield; Mark A,23,0,30,7
1715607521555,SIOC 291S,A01,637333,Gabriel; Corey John,23,0,30,7
1715607522582,SOCI 117,A01,494376,Staff,0,5,5,5
1715607523612,WES 237B,A00,494380,Staff,10,0,20,10
1715607525696,AESE 279B,A00,494370,Wade; Jon P,0,0,33,33
1715607526723,AIP 97,001,660915,Van Den Einde; Yael Dahlia,9999,0,9999,0
1715607527750,AIP 197,001,627712,Vespa; Emanuel Ignacio,9995,0,9999,4
1715607527750,AIP 197,002,650778,Amir; On,9998,0,9999,1
1715607527750,AIP 197,003,650933,Avenancio-Leon; Carlos,9998,0,9999,1
1715607527750,AIP 197,004,658530,Heyman; Gail D.,9998,0,9999,1
1715607527750,AIP 197,005,658631,Neal; Sonya E,9998,0,9999,1
1715607527750,AIP 197,006,658671,Du; Songzi,9998,0,9999,1
1715607528780,ANAR 135S,A00,494369,Braswell; Geoffrey E.,0,0,0,0
1715607529810,BENG 196,001,628496,Engler; Adam J.,9998,0,9999,1
1715607529810,BENG 196,002,660916,Watson; John Thomas,9999,0,9999,0
1715607530840,BISP 197,001,650773,Wilhelm; James E.,9994,0,9999,5
1715607530840,BISP 197,002,658904,Coleman; Aaron B.,9998,0,9999,1
1715607531868,CAT 124RS,A01,519847,Geibel; William,0,0,20,20
1715607532947,CAT 125RS,A01,515971,Geibel; William,0,0,20,20
1715607533975,CLRE 250,A00,511389,Morris; Sheldon,9992,0,9999,7
1715607535001,CLRE 251,A00,507176,Mehta; Ravindra L.,9992,0,9999,7
1715607535001,CLRE 251,B00,511410,Mehta; Ravindra L.,9998,0,9999,1
1715607536029,CLRE 252,A00,507189,Cuomo; Raphael Eduardo,9994,0,9999,5
1715607537056,CLRE 253,A00,507199,Vaida; Florin,9994,0,9999,5
1715607537056,CLRE 253,B00,507202,Vaida; Florin,9999,0,9999,0
1715607538080,CLRE 259,A00,507211,Patel; Hemal,9996,0,9999,3
1715607539107,CLRE 260,A00,507221,Cuomo; Raphael Eduardo,9999,0,9999,0
1715607540133,CLRE 297,001,507242,Cuomo; Raphael Eduardo,9999,0,9999,0
1715607541160,COGS 197,001,638244,Voytek; Bradley Thomas,9997,0,9999,2
1715607542185,CSE 191,A00,516875,Minnes Kemp; Mor Mia,9991,0,9999,8
1715607543214,CSE 197,001,637388,Minnes Kemp; Mor Mia,9992,0,9999,7
1715607544242,CSS 201S,A01,494383,Mignozzetti; Umberto,35,0,35,0
1715607545269,CSS 202S,A01,494387,Mignozzetti; Umberto,35,0,35,0
1715607546298,DSC 197,001,628532,Eldridge; Justin Matthew,9995,0,9999,4
1715607547327,EAP 100,A00,516065,Staff,9799,0,9999,200
1715607548361,ECE 45,A01,507414,Staff,31,0,60,29
1715607550416,ECE 111,A01,507420,Staff,11,0,50,39
1715607551443,ECE 197,001,548057,Sievenpiper; Daniel F.,9991,0,9999,8
1715607552474,EDS 115,A00,507243,Choi; Bailey Miyeon,7,0,28,21
1715607553500,EDS 117,A01,494379,Staff,0,6,34,34
1715607554528,EDS 125,A00,507246,Hopkins; Megan Beth,8,0,30,22
1715607555555,EDS 128A,A01,507264,Fargason; Sharon Gayle,6,0,26,20
1715607556585,EDS 128B,A01,507293,Pappas; Elizabeth,10,0,30,20
1715607557614,EDS 139,A00,507294,Fargason; Sharon Gayle,10,0,30,20
1715607557614,EDS 139,B00,507313,Pappas; Elizabeth,11,0,30,19
1715607558639,EDS 201,A00,507315,Staff,10,0,30,20
1715607559664,EDS 203,A01,507317,Halter; Christopher P.,10,0,30,20
1715607560689,EDS 204R,A01,507319,Halter; Christopher P.,0,3,30,30
1715607560689,EDS 204R,B01,507331,Heinzman; Erica M.,14,0,30,16
1715607561715,EDS 206R,A00,507332,Staff,0,4,30,30
1715607561715,EDS 206R,B00,507343,Staff,15,0,30,15
1715607562739,EDS 250,A00,507344,Hemans; Patricia Ann Benitez,20,0,40,20
1715607563768,EDS 281,A00,507345,Daly; Alan J.,18,0,18,0
1715607564794,EDS 284,A00,507350,Daly; Alan J.,16,0,16,0
1715607565821,EDS 286,A00,507359,Fine; Sarah,18,0,18,0
1715607566846,EDS 289C,A01,507361,Daly; Alan J.,18,0,18,0
1715607567886,EDS 290,A00,507366,Hofstetter; Carolyn,15,0,15,0
1715607568913,LIGM 5A,A00,507421,Fischer-Grunski; Eva K,17,0,20,3
1715607569941,LIGM 5B,A00,507423,Fischer-Grunski; Eva K,19,0,20,1
1715607570973,LIGM 5C,A00,507425,Fischer-Grunski; Eva K,19,0,20,1
1715607572003,LIIT 5AS,A00,507427,Carnelos; Chiara,20,0,20,0
1715607573028,LIIT 5BS,A00,507430,Carnelos; Chiara,20,0,20,0
1715607574054,LIIT 5CS,A00,507432,Carnelos; Chiara,20,0,20,0
1715607575079,LISP 5A,A00,507541,Munoz Sanchez; Alicia,11,0,20,9
1715607576107,LISP 5B,A00,507671,Munoz Sanchez; Alicia,9,0,20,11
1715607577136,LISP 5C,A00,507696,Munoz Sanchez; Alicia,9,0,20,11
1715607578161,MAE 197,001,528363,Boechler; Nicholas Sebastia,9998,0,9999,1
1715607579196,MATH 197,001,523477,Kedlaya; Kiran S.,9994,0,9999,5
1715607579196,MATH 197,002,563811,Zhang; Danna,9994,0,9999,5
1715607579196,MATH 197,003,628552,Dumitriu; Ioana,9998,0,9999,1
1715607579196,MATH 197,004,660885,Floyd; Eric,9999,0,9999,0
1715607580223,MCWP 40R,A00,518780,Staff,2,0,20,18
1715607580223,MCWP 40R,B00,518781,Staff,11,0,20,9
1715607580223,MCWP 40R,C00,518783,Staff,5,0,20,15
1715607581250,MCWP 50R,A00,518791,Staff,0,1,20,20
1715607581250,MCWP 50R,B00,518792,Staff,0,2,20,20
1715607581250,MCWP 50R,C00,518793,Staff,0,4,20,20
1715607581250,MCWP 50R,D00,518794,Staff,0,1,20,20
1715607581250,MCWP 50R,E00,518795,Staff,0,2,20,20
1715607581250,MCWP 50R,F00,518796,Staff,0,1,20,20
1715607581250,MCWP 50R,G00,518797,Staff,0,1,20,20
1715607582277,MMW 12R,A01,514034,Herbst; Matthew,0,2,16,16
1715607582277,MMW 12R,A02,514035,Herbst; Matthew,0,0,16,16
1715607583302,MMW 13R,A01,514037,Staff,0,5,16,16
1715607583302,MMW 13R,A02,514039,Staff,0,5,16,16
1715607583302,MMW 13R,A03,628519,Staff,0,4,16,16
1715607585354,SIO 295LS,A00,523233,Staff,10,0,30,20
1715607586378,SIO 295S,A00,523232,Staff,10,0,30,20
1715607587410,SIOC 290S,A01,637330,Merrifield; Mark A,23,0,30,7
1715607588437,SIOC 291S,A01,637333,Gabriel; Corey John,23,0,30,7
1715607589463,SOCI 117,A01,494376,Staff,0,5,5,5
1715607590490,WES 237B,A00,494380,Staff,10,0,20,10
1715607592565,AESE 279B,A00,494370,Wade; Jon P,0,0,33,33
1715607593590,AIP 97,001,660915,Van Den Einde; Yael Dahlia,9999,0,9999,0
1715607594625,AIP 197,001,627712,Vespa; Emanuel Ignacio,9995,0,9999,4
1715607594625,AIP 197,002,650778,Amir; On,9998,0,9999,1
1715607594625,AIP 197,003,650933,Avenancio-Leon; Carlos,9998,0,9999,1
1715607594625,AIP 197,004,658530,Heyman; Gail D.,9998,0,9999,1
1715607594625,AIP 197,005,658631,Neal; Sonya E,9998,0,9999,1
1715607594625,AIP 197,006,658671,Du; Songzi,9998,0,9999,1
1715607595650,ANAR 135S,A00,494369,Braswell; Geoffrey E.,0,0,0,0
1715607596676,BENG 196,001,628496,Engler; Adam J.,9998,0,9999,1
1715607596676,BENG 196,002,660916,Watson; John Thomas,9999,0,9999,0
1715607597704,BISP 197,001,650773,Wilhelm; James E.,9994,0,9999,5
1715607597704,BISP 197,002,658904,Coleman; Aaron B.,9998,0,9999,1
1715607598733,CAT 124RS,A01,519847,Geibel; William,0,0,20,20
1715607599757,CAT 125RS,A01,515971,Geibel; William,0,0,20,20
1715607600783,CLRE 250,A00,511389,Morris; Sheldon,9992,0,9999,7
1715607601815,CLRE 251,A00,507176,Mehta; Ravindra L.,9992,0,9999,7
1715607601815,CLRE 251,B00,511410,Mehta; Ravindra L.,9998,0,9999,1
1715607602846,CLRE 252,A00,507189,Cuomo; Raphael Eduardo,9994,0,9999,5
1715607603874,CLRE 253,A00,507199,Vaida; Florin,9994,0,9999,5
1715607603874,CLRE 253,B00,507202,Vaida; Florin,9999,0,9999,0
1715607604900,CLRE 259,A00,507211,Patel; Hemal,9996,0,9999,3
1715607605925,CLRE 260,A00,507221,Cuomo; Raphael Eduardo,9999,0,9999,0
1715607606952,CLRE 297,001,507242,Cuomo; Raphael Eduardo,9999,0,9999,0
1715607607981,COGS 197,001,638244,Voytek; Bradley Thomas,9997,0,9999,2
1715607609007,CSE 191,A00,516875,Minnes Kemp; Mor Mia,9991,0,9999,8
1715607610035,CSE 197,001,637388,Minnes Kemp; Mor Mia,9992,0,9999,7
1715607611069,CSS 201S,A01,494383,Mignozzetti; Umberto,35,0,35,0
1715607612095,CSS 202S,A01,494387,Mignozzetti; Umberto,35,0,35,0
1715607613125,DSC 197,001,628532,Eldridge; Justin Matthew,9995,0,9999,4
1715607614152,EAP 100,A00,516065,Staff,9799,0,9999,200
1715607615184,ECE 45,A01,507414,Staff,31,0,60,29
1715607617239,ECE 111,A01,507420,Staff,11,0,50,39
1715607618270,ECE 197,001,548057,Sievenpiper; Daniel F.,9991,0,9999,8
1715607619296,EDS 115,A00,507243,Choi; Bailey Miyeon,7,0,28,21
1715607620322,EDS 117,A01,494379,Staff,0,6,34,34
1715607621349,EDS 125,A00,507246,Hopkins; Megan Beth,8,0,30,22
1715607622377,EDS 128A,A01,507264,Fargason; Sharon Gayle,6,0,26,20
1715607623408,EDS 128B,A01,507293,Pappas; Elizabeth,10,0,30,20
1715607624435,EDS 139,A00,507294,Fargason; Sharon Gayle,10,0,30,20
1715607624435,EDS 139,B00,507313,Pappas; Elizabeth,11,0,30,19
1715607625463,EDS 201,A00,507315,Staff,10,0,30,20
1715607626493,EDS 203,A01,507317,Halter; Christopher P.,10,0,30,20
1715607627520,EDS 204R,A01,507319,Halter; Christopher P.,0,3,30,30
1715607627520,EDS 204R,B01,507331,Heinzman; Erica M.,14,0,30,16
1715607628544,EDS 206R,A00,507332,Staff,0,4,30,30
1715607628544,EDS 206R,B00,507343,Staff,15,0,30,15
1715607629572,EDS 250,A00,507344,Hemans; Patricia Ann Benitez,20,0,40,20
1715607630598,EDS 281,A00,507345,Daly; Alan J.,18,0,18,0
1715607631623,EDS 284,A00,507350,Daly; Alan J.,16,0,16,0
1715607632649,EDS 286,A00,507359,Fine; Sarah,18,0,18,0
1715607633677,EDS 289C,A01,507361,Daly; Alan J.,18,0,18,0
1715607634705,EDS 290,A00,507366,Hofstetter; Carolyn,15,0,15,0
1715607635732,LIGM 5A,A00,507421,Fischer-Grunski; Eva K,17,0,20,3
1715607636826,LIGM 5B,A00,507423,Fischer-Grunski; Eva K,19,0,20,1
1715607637851,LIGM 5C,A00,507425,Fischer-Grunski; Eva K,19,0,20,1
1715607638877,LIIT 5AS,A00,507427,Carnelos; Chiara,20,0,20,0
1715607639901,LIIT 5BS,A00,507430,Carnelos; Chiara,20,0,20,0
1715607640926,LIIT 5CS,A00,507432,Carnelos; Chiara,20,0,20,0
1715607641958,LISP 5A,A00,507541,Munoz Sanchez; Alicia,11,0,20,9
1715607642984,LISP 5B,A00,507671,Munoz Sanchez; Alicia,9,0,20,11
1715607644009,LISP 5C,A00,507696,Munoz Sanchez; Alicia,9,0,20,11
1715607645034,MAE 197,001,528363,Boechler; Nicholas Sebastia,9998,0,9999,1
1715607646063,MATH 197,001,523477,Kedlaya; Kiran S.,9994,0,9999,5
1715607646063,MATH 197,002,563811,Zhang; Danna,9994,0,9999,5
1715607646063,MATH 197,003,628552,Dumitriu; Ioana,9998,0,9999,1
1715607646063,MATH 197,004,660885,Floyd; Eric,9999,0,9999,0
1715607647093,MCWP 40R,A00,518780,Staff,2,0,20,18
1715607647093,MCWP 40R,B00,518781,Staff,11,0,20,9
1715607647093,MCWP 40R,C00,518783,Staff,5,0,20,15
1715607648122,MCWP 50R,A00,518791,Staff,0,1,20,20
1715607648122,MCWP 50R,B00,518792,Staff,0,2,20,20
1715607648122,MCWP 50R,C00,518793,Staff,0,4,20,20
1715607648122,MCWP 50R,D00,518794,Staff,0,1,20,20
1715607648122,MCWP 50R,E00,518795,Staff,0,2,20,20
1715607648122,MCWP 50R,F00,518796,Staff,0,1,20,20
1715607648122,MCWP 50R,G00,518797,Staff,0,1,20,20
1715607649145,MMW 12R,A01,514034,Herbst; Matthew,0,2,16,16
1715607649145,MMW 12R,A02,514035,Herbst; Matthew,0,0,16,16
1715607650176,MMW 13R,A01,514037,Staff,0,5,16,16
1715607650176,MMW 13R,A02,514039,Staff,0,5,16,16
1715607650176,MMW 13R,A03,628519,Staff,0,4,16,16
1715607652228,SIO 295LS,A00,523233,Staff,10,0,30,20
1715607653255,SIO 295S,A00,523232,Staff,10,0,30,20
1715607654281,SIOC 290S,A01,637330,Merrifield; Mark A,23,0,30,7
1715607655311,SIOC 291S,A01,637333,Gabriel; Corey John,23,0,30,7
1715607656336,SOCI 117,A01,494376,Staff,0,5,5,5
1715607657361,WES 237B,A00,494380,Staff,10,0,20,10
1715607659431,AESE 279B,A00,494370,Wade; Jon P,0,0,33,33
1715607660460,AIP 97,001,660915,Van Den Einde; Yael Dahlia,9999,0,9999,0
1715607661485,AIP 197,001,627712,Vespa; Emanuel Ignacio,9995,0,9999,4
1715607661485,AIP 197,002,650778,Amir; On,9998,0,9999,1
1715607661485,AIP 197,003,650933,Avenancio-Leon; Carlos,9998,0,9999,1
1715607661485,AIP 197,004,658530,Heyman; Gail D.,9998,0,9999,1
1715607661485,AIP 197,005,658631,Neal; Sonya E,9998,0,9999,1
1715607661485,AIP 197,006,658671,Du; Songzi,9998,0,9999,1
1715607662511,ANAR 135S,A00,494369,Braswell; Geoffrey E.,0,0,0,0
1715607663543,BENG 196,001,628496,Engler; Adam J.,9998,0,9999,1
1715607663543,BENG 196,002,660916,Watson; John Thomas,9999,0,9999,0
1715607664569,BISP 197,001,650773,Wilhelm; James E.,9994,0,9999,5
1715607664569,BISP 197,002,658904,Coleman; Aaron B.,9998,0,9999,1
1715607665596,CAT 124RS,A01,519847,Geibel; William,0,0,20,20
1715607666621,CAT 125RS,A01,515971,Geibel; William,0,0,20,20
1715607667649,CLRE 250,A00,511389,Morris; Sheldon,9992,0,9999,7
1715607668760,CLRE 251,A00,507176,Mehta; Ravindra L.,9992,0,9999,7
1715607668760,CLRE 251,B00,511410,Mehta; Ravindra L.,9998,0,9999,1
1715607669790,CLRE 252,A00,507189,Cuomo; Raphael Eduardo,9994,0,9999,5
1715607671020,CLRE 253,A00,507199,Vaida; Florin,9994,0,9999,5
1715607671020,CLRE 253,B00,507202,Vaida; Florin,9999,0,9999,0
1715607672050,CLRE 259,A00,507211,Patel; Hemal,9996,0,9999,3
1715607673080,CLRE 260,A00,507221,Cuomo; Raphael Eduardo,9999,0,9999,0
1715607674108,CLRE 297,001,507242,Cuomo; Raphael Eduardo,9999,0,9999,0
1715607675138,COGS 197,001,638244,Voytek; Bradley Thomas,9997,0,9999,2
1715607676166,CSE 191,A00,516875,Minnes Kemp; Mor Mia,9991,0,9999,8
1715607677196,CSE 197,001,637388,Minnes Kemp; Mor Mia,9992,0,9999,7
1715607678225,CSS 201S,A01,494383,Mignozzetti; Umberto,35,0,35,0
1715607679255,CSS 202S,A01,494387,Mignozzetti; Umberto,35,0,35,0
1715607680285,DSC 197,001,628532,Eldridge; Justin Matthew,9995,0,9999,4
1715607681310,EAP 100,A00,516065,Staff,9799,0,9999,200
1715607682339,ECE 45,A01,507414,Staff,31,0,60,29
1715607684396,ECE 111,A01,507420,Staff,11,0,50,39
1715607685423,ECE 197,001,548057,Sievenpiper; Daniel F.,9991,0,9999,8
1715607686453,EDS 115,A00,507243,Choi; Bailey Miyeon,7,0,28,21
1715607687481,EDS 117,A01,494379,Staff,0,6,34,34
1715607688505,EDS 125,A00,507246,Hopkins; Megan Beth,8,0,30,22
1715607689536,EDS 128A,A01,507264,Fargason; Sharon Gayle,6,0,26,20
1715607690562,EDS 128B,A01,507293,Pappas; Elizabeth,10,0,30,20
1715607691591,EDS 139,A00,507294,Fargason; Sharon Gayle,10,0,30,20
1715607691591,EDS 139,B00,507313,Pappas; Elizabeth,11,0,30,19
1715607692675,EDS 201,A00,507315,Staff,10,0,30,20
1715607693702,EDS 203,A01,507317,Halter; Christopher P.,10,0,30,20
1715607694729,EDS 204R,A01,507319,Halter; Christopher P.,0,3,30,30
1715607694729,EDS 204R,B01,507331,Heinzman; Erica M.,14,0,30,16
1715607695757,EDS 206R,A00,507332,Staff,0,4,30,30
1715607695757,EDS 206R,B00,507343,Staff,15,0,30,15
1715607696782,EDS 250,A00,507344,Hemans; Patricia Ann Benitez,20,0,40,20
1715607697810,EDS 281,A00,507345,Daly; Alan J.,18,0,18,0
1715607698838,EDS 284,A00,507350,Daly; Alan J.,16,0,16,0
1715607699863,EDS 286,A00,507359,Fine; Sarah,18,0,18,0
1715607700892,EDS 289C,A01,507361,Daly; Alan J.,18,0,18,0
1715607701918,EDS 290,A00,507366,Hofstetter; Carolyn,15,0,15,0
1715607702946,LIGM 5A,A00,507421,Fischer-Grunski; Eva K,17,0,20,3
1715607703975,LIGM 5B,A00,507423,Fischer-Grunski; Eva K,19,0,20,1
1715607705001,LIGM 5C,A00,507425,Fischer-Grunski; Eva K,19,0,20,1
1715607706033,LIIT 5AS,A00,507427,Carnelos; Chiara,20,0,20,0
1715607707060,LIIT 5BS,A00,507430,Carnelos; Chiara,20,0,20,0
1715607708085,LIIT 5CS,A00,507432,Carnelos; Chiara,20,0,20,0
1715607709110,LISP 5A,A00,507541,Munoz Sanchez; Alicia,11,0,20,9
1715607710140,LISP 5B,A00,507671,Munoz Sanchez; Alicia,9,0,20,11
1715607711164,LISP 5C,A00,507696,Munoz Sanchez; Alicia,9,0,20,11
1715607712193,MAE 197,001,528363,Boechler; Nicholas Sebastia,9998,0,9999,1
1715607713222,MATH 197,001,523477,Kedlaya; Kiran S.,9994,0,9999,5
1715607713222,MATH 197,002,563811,Zhang; Danna,9994,0,9999,5
1715607713222,MATH 197,003,628552,Dumitriu; Ioana,9998,0,9999,1
1715607713222,MATH 197,004,660885,Floyd; Eric,9999,0,9999,0
1715607714248,MCWP 40R,A00,518780,Staff,2,0,20,18
1715607714248,MCWP 40R,B00,518781,Staff,11,0,20,9
1715607714248,MCWP 40R,C00,518783,Staff,5,0,20,15
1715607715280,MCWP 50R,A00,518791,Staff,0,1,20,20
1715607715280,MCWP 50R,B00,518792,Staff,0,2,20,20
1715607715280,MCWP 50R,C00,518793,Staff,0,4,20,20
1715607715280,MCWP 50R,D00,518794,Staff,0,1,20,20
1715607715280,MCWP 50R,E00,518795,Staff,0,2,20,20
1715607715280,MCWP 50R,F00,518796,Staff,0,1,20,20
1715607715280,MCWP 50R,G00,518797,Staff,0,1,20,20
1715607716309,MMW 12R,A01,514034,Herbst; Matthew,0,2,16,16
1715607716309,MMW 12R,A02,514035,Herbst; Matthew,0,0,16,16
1715607717335,MMW 13R,A01,514037,Staff,0,5,16,16
1715607717335,MMW 13R,A02,514039,Staff,0,5,16,16
1715607717335,MMW 13R,A03,628519,Staff,0,4,16,16
1715607719394,SIO 295LS,A00,523233,Staff,10,0,30,20
1715607720420,SIO 295S,A00,523232,Staff,10,0,30,20
1715607721451,SIOC 290S,A01,637330,Merrifield; Mark A,23,0,30,7
1715607722477,SIOC 291S,A01,637333,Gabriel; Corey John,23,0,30,7
1715607723502,SOCI 117,A01,494376,Staff,0,5,5,5
1715607724528,WES 237B,A00,494380,Staff,10,0,20,10
1715607726604,AESE 279B,A00,494370,Wade; Jon P,0,0,33,33
1715607727632,AIP 97,001,660915,Van Den Einde; Yael Dahlia,9999,0,9999,0
1715607728666,AIP 197,001,627712,Vespa; Emanuel Ignacio,9995,0,9999,4
1715607728666,AIP 197,002,650778,Amir; On,9998,0,9999,1
1715607728666,AIP 197,003,650933,Avenancio-Leon; Carlos,9998,0,9999,1
1715607728666,AIP 197,004,658530,Heyman; Gail D.,9998,0,9999,1
1715607728666,AIP 197,005,658631,Neal; Sonya E,9998,0,9999,1
1715607728666,AIP 197,006,658671,Du; Songzi,9998,0,9999,1
1715607729695,ANAR 135S,A00,494369,Braswell; Geoffrey E.,0,0,0,0
1715607730722,BENG 196,001,628496,Engler; Adam J.,9998,0,9999,1
1715607730722,BENG 196,002,660916,Watson; John Thomas,9999,0,9999,0
1715607731748,BISP 197,001,650773,Wilhelm; James E.,9994,0,9999,5
1715607731748,BISP 197,002,658904,Coleman; Aaron B.,9998,0,9999,1
1715607732778,CAT 124RS,A01,519847,Geibel; William,0,0,20,20
1715607733806,CAT 125RS,A01,515971,Geibel; William,0,0,20,20
1715607734836,CLRE 250,A00,511389,Morris; Sheldon,9992,0,9999,7
1715607735865,CLRE 251,A00,507176,Mehta; Ravindra L.,9992,0,9999,7
1715607735865,CLRE 251,B00,511410,Mehta; Ravindra L.,9998,0,9999,1
1715607736893,CLRE 252,A00,507189,Cuomo; Raphael Eduardo,9994,0,9999,5
1715607737926,CLRE 253,A00,507199,Vaida; Florin,9994,0,9999,5
1715607737926,CLRE 253,B00,507202,Vaida; Florin,9999,0,9999,0
1715607738955,CLRE 259,A00,507211,Patel; Hemal,9996,0,9999,3
1715607739981,CLRE 260,A00,507221,Cuomo; Raphael Eduardo,9999,0,9999,0
1715607741010,CLRE 297,001,507242,Cuomo; Raphael Eduardo,9999,0,9999,0
1715607742036,COGS 197,001,638244,Voytek; Bradley Thomas,9997,0,9999,2
1715607743061,CSE 191,A00,516875,Minnes Kemp; Mor Mia,9991,0,9999,8
1715607744088,CSE 197,001,637388,Minnes Kemp; Mor Mia,9992,0,9999,7
1715607745122,CSS 201S,A01,494383,Mignozzetti; Umberto,35,0,35,0
1715607746150,CSS 202S,A01,494387,Mignozzetti; Umberto,35,0,35,0
1715607747176,DSC 197,001,628532,Eldridge; Justin Matthew,9995,0,9999,4
1715607748200,EAP 100,A00,516065,Staff,9799,0,9999,200
1715607749229,ECE 45,A01,507414,Staff,31,0,60,29
1715607751282,ECE 111,A01,507420,Staff,11,0,50,39
1715607752310,ECE 197,001,548057,Sievenpiper; Daniel F.,9991,0,9999,8
1715607753341,EDS 115,A00,507243,Choi; Bailey Miyeon,7,0,28,21
1715607754369,EDS 117,A01,494379,Staff,0,6,34,34
1715607755398,EDS 125,A00,507246,Hopkins; Megan Beth,8,0,30,22
1715607756427,EDS 128A,A01,507264,Fargason; Sharon Gayle,6,0,26,20
1715607757455,EDS 128B,A01,507293,Pappas; Elizabeth,10,0,30,20
1715607758480,EDS 139,A00,507294,Fargason; Sharon Gayle,10,0,30,20
1715607758480,EDS 139,B00,507313,Pappas; Elizabeth,11,0,30,19
1715607759509,EDS 201,A00,507315,Staff,10,0,30,20
1715607760535,EDS 203,A01,507317,Halter; Christopher P.,10,0,30,20
1715607761567,EDS 204R,A01,507319,Halter; Christopher P.,0,3,30,30
1715607761567,EDS 204R,B01,507331,Heinzman; Erica M.,14,0,30,16
1715607762596,EDS 206R,A00,507332,Staff,0,4,30,30
1715607762596,EDS 206R,B00,507343,Staff,15,0,30,15
1715607763623,EDS 250,A00,507344,Hemans; Patricia Ann Benitez,20,0,40,20
1715607764652,EDS 281,A00,507345,Daly; Alan J.,18,0,18,0
1715607765678,EDS 284,A00,507350,Daly; Alan J.,16,0,16,0
1715607766704,EDS 286,A00,507359,Fine; Sarah,18,0,18,0
1715607767731,EDS 289C,A01,507361,Daly; Alan J.,18,0,18,0
1715607768762,EDS 290,A00,507366,Hofstetter; Carolyn,15,0,15,0
1715607769787,LIGM 5A,A00,507421,Fischer-Grunski; Eva K,17,0,20,3
1715607770817,LIGM 5B,A00,507423,Fischer-Grunski; Eva K,19,0,20,1
1715607771842,LIGM 5C,A00,507425,Fischer-Grunski; Eva K,19,0,20,1
1715607772871,LIIT 5AS,A00,507427,Carnelos; Chiara,20,0,20,0
1715607773908,LIIT 5BS,A00,507430,Carnelos; Chiara,20,0,20,0
1715607774937,LIIT 5CS,A00,507432,Carnelos; Chiara,20,0,20,0
1715607775962,LISP 5A,A00,507541,Munoz Sanchez; Alicia,11,0,20,9
1715607776987,LISP 5B,A00,507671,Munoz Sanchez; Alicia,9,0,20,11
1715607778046,LISP 5C,A00,507696,Munoz Sanchez; Alicia,9,0,20,11
1715607779077,MAE 197,001,528363,Boechler; Nicholas Sebastia,9998,0,9999,1
1715607780104,MATH 197,001,523477,Kedlaya; Kiran S.,9994,0,9999,5
1715607780104,MATH 197,002,563811,Zhang; Danna,9994,0,9999,5
1715607780104,MATH 197,003,628552,Dumitriu; Ioana,9998,0,9999,1
1715607780104,MATH 197,004,660885,Floyd; Eric,9999,0,9999,0
1715607781131,MCWP 40R,A00,518780,Staff,2,0,20,18
1715607781131,MCWP 40R,B00,518781,Staff,11,0,20,9
1715607781131,MCWP 40R,C00,518783,Staff,5,0,20,15
1715607782157,MCWP 50R,A00,518791,Staff,0,1,20,20
1715607782157,MCWP 50R,B00,518792,Staff,0,2,20,20
1715607782157,MCWP 50R,C00,518793,Staff,0,4,20,20
1715607782157,MCWP 50R,D00,518794,Staff,0,1,20,20
1715607782157,MCWP 50R,E00,518795,Staff,0,2,20,20
1715607782157,MCWP 50R,F00,518796,Staff,0,1,20,20
1715607782157,MCWP 50R,G00,518797,Staff,0,1,20,20
1715607783184,MMW 12R,A01,514034,Herbst; Matthew,0,2,16,16
1715607783184,MMW 12R,A02,514035,Herbst; Matthew,0,0,16,16
1715607784211,MMW 13R,A01,514037,Staff,0,5,16,16
1715607784211,MMW 13R,A02,514039,Staff,0,5,16,16
1715607784211,MMW 13R,A03,628519,Staff,0,4,16,16
1715607786265,SIO 295LS,A00,523233,Staff,10,0,30,20
1715607787290,SIO 295S,A00,523232,Staff,10,0,30,20
1715607788317,SIOC 290S,A01,637330,Merrifield; Mark A,23,0,30,7
1715607789346,SIOC 291S,A01,637333,Gabriel; Corey John,23,0,30,7
1715607790375,SOCI 117,A01,494376,Staff,0,5,5,5
1715607791400,WES 237B,A00,494380,Staff,10,0,20,10
1715607793469,AESE 279B,A00,494370,Wade; Jon P,0,0,33,33
1715607794493,AIP 97,001,660915,Van Den Einde; Yael Dahlia,9999,0,9999,0
1715607795521,AIP 197,001,627712,Vespa; Emanuel Ignacio,9995,0,9999,4
1715607795521,AIP 197,002,650778,Amir; On,9998,0,9999,1
1715607795521,AIP 197,003,650933,Avenancio-Leon; Carlos,9998,0,9999,1
1715607795521,AIP 197,004,658530,Heyman; Gail D.,9998,0,9999,1
1715607795521,AIP 197,005,658631,Neal; Sonya E,9998,0,9999,1
1715607795521,AIP 197,006,658671,Du; Songzi,9998,0,9999,1
1715607796550,ANAR 135S,A00,494369,Braswell; Geoffrey E.,0,0,0,0
1715607797577,BENG 196,001,628496,Engler; Adam J.,9998,0,9999,1
1715607797577,BENG 196,002,660916,Watson; John Thomas,9999,0,9999,0
1715607798608,BISP 197,001,650773,Wilhelm; James E.,9994,0,9999,5
1715607798608,BISP 197,002,658904,Coleman; Aaron B.,9998,0,9999,1
1715607799641,CAT 124RS,A01,519847,Geibel; William,0,0,20,20
1715607800670,CAT 125RS,A01,515971,Geibel; William,0,0,20,20
1715607801701,CLRE 250,A00,511389,Morris; Sheldon,9992,0,9999,7
1715607802728,CLRE 251,A00,507176,Mehta; Ravindra L.,9992,0,9999,7
1715607802728,CLRE 251,B00,511410,Mehta; Ravindra L.,9998,0,9999,1
1715607803759,CLRE 252,A00,507189,Cuomo; Raphael Eduardo,9994,0,9999,5
1715607804787,CLRE 253,A00,507199,Vaida; Florin,9994,0,9999,5
1715607804787,CLRE 253,B00,507202,Vaida; Florin,9999,0,9999,0
1715607805817,CLRE 259,A00,507211,Patel; Hemal,9996,0,9999,3
1715607806844,CLRE 260,A00,507221,Cuomo; Raphael Eduardo,9999,0,9999,0
1715607807872,CLRE 297,001,507242,Cuomo; Raphael Eduardo,9999,0,9999,0
1715607808898,COGS 197,001,638244,Voytek; Bradley Thomas,9997,0,9999,2
1715607809927,CSE 191,A00,516875,Minnes Kemp; Mor Mia,9991,0,9999,8
1715607810952,CSE 197,001,637388,Minnes Kemp; Mor Mia,9992,0,9999,7
1715607811984,CSS 201S,A01,494383,Mignozzetti; Umberto,35,0,35,0
1715607813015,CSS 202S,A01,494387,Mignozzetti; Umberto,35,0,35,0
1715607814044,DSC 197,001,628532,Eldridge; Justin Matthew,9995,0,9999,4
1715607815073,EAP 100,A00,516065,Staff,9799,0,9999,200
1715607816101,ECE 45,A01,507414,Staff,31,0,60,29
1715607818159,ECE 111,A01,507420,Staff,11,0,50,39
1715607819187,ECE 197,001,548057,Sievenpiper; Daniel F.,9991,0,9999,8
1715607820214,EDS 115,A00,507243,Choi; Bailey Miyeon,7,0,28,21
1715607821243,EDS 117,A01,494379,Staff,0,6,34,34
1715607822273,EDS 125,A00,507246,Hopkins; Megan Beth,8,0,30,22
1715607823885,EDS 128A,A01,507264,Fargason; Sharon Gayle,6,0,26,20
1715607824911,EDS 128B,A01,507293,Pappas; Elizabeth,10,0,30,20
1715607825937,EDS 139,A00,507294,Fargason; Sharon Gayle,10,0,30,20
1715607825937,EDS 139,B00,507313,Pappas; Elizabeth,11,0,30,19
1715607826962,EDS 201,A00,507315,Staff,10,0,30,20
1715607827990,EDS 203,A01,507317,Halter; Christopher P.,10,0,30,20
1715607829020,EDS 204R,A01,507319,Halter; Christopher P.,0,3,30,30
1715607829020,EDS 204R,B01,507331,Heinzman; Erica M.,14,0,30,16
1715607830047,EDS 206R,A00,507332,Staff,0,4,30,30
1715607830047,EDS 206R,B00,507343,Staff,15,0,30,15
1715607831073,EDS 250,A00,507344,Hemans; Patricia Ann Benitez,20,0,40,20
1715607832159,EDS 281,A00,507345,Daly; Alan J.,18,0,18,0
1715607833189,EDS 284,A00,507350,Daly; Alan J.,16,0,16,0
1715607834216,EDS 286,A00,507359,Fine; Sarah,18,0,18,0
1715607835248,EDS 289C,A01,507361,Daly; Alan J.,18,0,18,0
1715607836277,EDS 290,A00,507366,Hofstetter; Carolyn,15,0,15,0
1715607837304,LIGM 5A,A00,507421,Fischer-Grunski; Eva K,17,0,20,3
1715607838330,LIGM 5B,A00,507423,Fischer-Grunski; Eva K,19,0,20,1
1715607839357,LIGM 5C,A00,507425,Fischer-Grunski; Eva K,19,0,20,1
1715607840386,LIIT 5AS,A00,507427,Carnelos; Chiara,20,0,20,0
1715607841412,LIIT 5BS,A00,507430,Carnelos; Chiara,20,0,20,0
1715607842440,LIIT 5CS,A00,507432,Carnelos; Chiara,20,0,20,0
1715607843466,LISP 5A,A00,507541,Munoz Sanchez; Alicia,11,0,20,9
1715607844496,LISP 5B,A00,507671,Munoz Sanchez; Alicia,9,0,20,11
1715607845523,LISP 5C,A00,507696,Munoz Sanchez; Alicia,9,0,20,11
1715607846553,MAE 197,001,528363,Boechler; Nicholas Sebastia,9998,0,9999,1
1715607847585,MATH 197,001,523477,Kedlaya; Kiran S.,9994,0,9999,5
1715607847585,MATH 197,002,563811,Zhang; Danna,9994,0,9999,5
1715607847585,MATH 197,003,628552,Dumitriu; Ioana,9998,0,9999,1
1715607847585,MATH 197,004,660885,Floyd; Eric,9999,0,9999,0
1715607848611,MCWP 40R,A00,518780,Staff,2,0,20,18
1715607848611,MCWP 40R,B00,518781,Staff,11,0,20,9
1715607848611,MCWP 40R,C00,518783,Staff,5,0,20,15
1715607849648,MCWP 50R,A00,518791,Staff,0,1,20,20
1715607849648,MCWP 50R,B00,518792,Staff,0,2,20,20
1715607849648,MCWP 50R,C00,518793,Staff,0,4,20,20
1715607849648,MCWP 50R,D00,518794,Staff,0,1,20,20
1715607849648,MCWP 50R,E00,518795,Staff,0,2,20,20
1715607849648,MCWP 50R,F00,518796,Staff,0,1,20,20
1715607849648,MCWP 50R,G00,518797,Staff,0,1,20,20
1715607850677,MMW 12R,A01,514034,Herbst; Matthew,0,2,16,16
1715607850677,MMW 12R,A02,514035,Herbst; Matthew,0,0,16,16
1715607851703,MMW 13R,A01,514037,Staff,0,5,16,16
1715607851703,MMW 13R,A02,514039,Staff,0,5,16,16
1715607851703,MMW 13R,A03,628519,Staff,0,4,16,16
1715607853761,SIO 295LS,A00,523233,Staff,10,0,30,20
1715607854785,SIO 295S,A00,523232,Staff,10,0,30,20
1715607855812,SIOC 290S,A01,637330,Merrifield; Mark A,23,0,30,7
1715607856842,SIOC 291S,A01,637333,Gabriel; Corey John,23,0,30,7
1715607857872,SOCI 117,A01,494376,Staff,0,5,5,5
1715607858899,WES 237B,A00,494380,Staff,10,0,20,10
1715607860976,AESE 279B,A00,494370,Wade; Jon P,0,0,33,33
1715607862004,AIP 97,001,660915,Van Den Einde; Yael Dahlia,9999,0,9999,0
1715607863032,AIP 197,001,627712,Vespa; Emanuel Ignacio,9995,0,9999,4
1715607863032,AIP 197,002,650778,Amir; On,9998,0,9999,1
1715607863032,AIP 197,003,650933,Avenancio-Leon; Carlos,9998,0,9999,1
1715607863032,AIP 197,004,658530,Heyman; Gail D.,9998,0,9999,1
1715607863032,AIP 197,005,658631,Neal; Sonya E,9998,0,9999,1
1715607863032,AIP 197,006,658671,Du; Songzi,9998,0,9999,1
1715607864061,ANAR 135S,A00,494369,Braswell; Geoffrey E.,0,0,0,0
1715607865088,BENG 196,001,628496,Engler; Adam J.,9998,0,9999,1
1715607865088,BENG 196,002,660916,Watson; John Thomas,9999,0,9999,0
1715607866115,BISP 197,001,650773,Wilhelm; James E.,9994,0,9999,5
1715607866115,BISP 197,002,658904,Coleman; Aaron B.,9998,0,9999,1
1715607867145,CAT 124RS,A01,519847,Geibel; William,0,0,20,20
1715607868170,CAT 125RS,A01,515971,Geibel; William,0,0,20,20
1715607869197,CLRE 250,A00,511389,Morris; Sheldon,9992,0,9999,7
1715607870226,CLRE 251,A00,507176,Mehta; Ravindra L.,9992,0,9999,7
1715607870226,CLRE 251,B00,511410,Mehta; Ravindra L.,9998,0,9999,1
1715607871253,CLRE 252,A00,507189,Cuomo; Raphael Eduardo,9994,0,9999,5
1715607872278,CLRE 253,A00,507199,Vaida; Florin,9994,0,9999,5
1715607872278,CLRE 253,B00,507202,Vaida; Florin,9999,0,9999,0
1715607873305,CLRE 259,A00,507211,Patel; Hemal,9996,0,9999,3
1715607874331,CLRE 260,A00,507221,Cuomo; Raphael Eduardo,9999,0,9999,0
1715607875360,CLRE 297,001,507242,Cuomo; Raphael Eduardo,9999,0,9999,0
1715607876388,COGS 197,001,638244,Voytek; Bradley Thomas,9997,0,9999,2
1715607877416,CSE 191,A00,516875,Minnes Kemp; Mor Mia,9991,0,9999,8
1715607878444,CSE 197,001,637388,Minnes Kemp; Mor Mia,9992,0,9999,7
1715607879482,CSS 201S,A01,494383,Mignozzetti; Umberto,35,0,35,0
1715607880509,CSS 202S,A01,494387,Mignozzetti; Umberto,35,0,35,0
1715607881536,DSC 197,001,628532,Eldridge; Justin Matthew,9995,0,9999,4
1715607882563,EAP 100,A00,516065,Staff,9799,0,9999,200
1715607883590,ECE 45,A01,507414,Staff,31,0,60,29
1715607885641,ECE 111,A01,507420,Staff,11,0,50,39
1715607886669,ECE 197,001,548057,Sievenpiper; Daniel F.,9991,0,9999,8
1715607887699,EDS 115,A00,507243,Choi; Bailey Miyeon,7,0,28,21
1715607888725,EDS 117,A01,494379,Staff,0,6,34,34
1715607889754,EDS 125,A00,507246,Hopkins; Megan Beth,8,0,30,22
1715607890780,EDS 128A,A01,507264,Fargason; Sharon Gayle,6,0,26,20
1715607891807,EDS 128B,A01,507293,Pappas; Elizabeth,10,0,30,20
1715607892834,EDS 139,A00,507294,Fargason; Sharon Gayle,10,0,30,20
1715607892834,EDS 139,B00,507313,Pappas; Elizabeth,11,0,30,19
1715607893860,EDS 201,A00,507315,Staff,10,0,30,20
1715607894888,EDS 203,A01,507317,Halter; Christopher P.,10,0,30,20
1715607895916,EDS 204R,A01,507319,Halter; Christopher P.,0,3,30,30
1715607895916,EDS 204R,B01,507331,Heinzman; Erica M.,14,0,30,16
1715607896945,EDS 206R,A00,507332,Staff,0,4,30,30
1715607896945,EDS 206R,B00,507343,Staff,15,0,30,15
1715607897971,EDS 250,A00,507344,Hemans; Patricia Ann Benitez,20,0,40,20
1715607898996,EDS 281,A00,507345,Daly; Alan J.,18,0,18,0
1715607900022,EDS 284,A00,507350,Daly; Alan J.,16,0,16,0
1715607901050,EDS 286,A00,507359,Fine; Sarah,18,0,18,0
1715607902077,EDS 289C,A01,507361,Daly; Alan J.,18,0,18,0
1715607903108,EDS 290,A00,507366,Hofstetter; Carolyn,15,0,15,0
1715607904136,LIGM 5A,A00,507421,Fischer-Grunski; Eva K,17,0,20,3
1715607905165,LIGM 5B,A00,507423,Fischer-Grunski; Eva K,19,0,20,1
1715607906190,LIGM 5C,A00,507425,Fischer-Grunski; Eva K,19,0,20,1
1715607907220,LIIT 5AS,A00,507427,Carnelos; Chiara,20,0,20,0
1715607908246,LIIT 5BS,A00,507430,Carnelos; Chiara,20,0,20,0
1715607909271,LIIT 5CS,A00,507432,Carnelos; Chiara,20,0,20,0
1715607910299,LISP 5A,A00,507541,Munoz Sanchez; Alicia,11,0,20,9
1715607911325,LISP 5B,A00,507671,Munoz Sanchez; Alicia,9,0,20,11
1715607912352,LISP 5C,A00,507696,Munoz Sanchez; Alicia,9,0,20,11
1715607913381,MAE 197,001,528363,Boechler; Nicholas Sebastia,9998,0,9999,1
1715607914409,MATH 197,001,523477,Kedlaya; Kiran S.,9994,0,9999,5
1715607914409,MATH 197,002,563811,Zhang; Danna,9994,0,9999,5
1715607914409,MATH 197,003,628552,Dumitriu; Ioana,9998,0,9999,1
1715607914409,MATH 197,004,660885,Floyd; Eric,9999,0,9999,0
1715607915435,MCWP 40R,A00,518780,Staff,2,0,20,18
1715607915435,MCWP 40R,B00,518781,Staff,11,0,20,9
1715607915435,MCWP 40R,C00,518783,Staff,5,0,20,15
1715607916463,MCWP 50R,A00,518791,Staff,0,1,20,20
1715607916463,MCWP 50R,B00,518792,Staff,0,2,20,20
1715607916463,MCWP 50R,C00,518793,Staff,0,4,20,20
1715607916463,MCWP 50R,D00,518794,Staff,0,1,20,20
1715607916463,MCWP 50R,E00,518795,Staff,0,2,20,20
1715607916463,MCWP 50R,F00,518796,Staff,0,1,20,20
1715607916463,MCWP 50R,G00,518797,Staff,0,1,20,20
1715607917487,MMW 12R,A01,514034,Herbst; Matthew,0,2,16,16
1715607917487,MMW 12R,A02,514035,Herbst; Matthew,0,0,16,16
1715607918517,MMW 13R,A01,514037,Staff,0,5,16,16
1715607918517,MMW 13R,A02,514039,Staff,0,5,16,16
1715607918517,MMW 13R,A03,628519,Staff,0,4,16,16
1715607920570,SIO 295LS,A00,523233,Staff,10,0,30,20
1715607921598,SIO 295S,A00,523232,Staff,10,0,30,20
1715607922624,SIOC 290S,A01,637330,Merrifield; Mark A,23,0,30,7
1715607923651,SIOC 291S,A01,637333,Gabriel; Corey John,23,0,30,7
1715607924678,SOCI 117,A01,494376,Staff,0,5,5,5
1715607925705,WES 237B,A00,494380,Staff,10,0,20,10
1715607927783,AESE 279B,A00,494370,Wade; Jon P,0,0,33,33
1715607928809,AIP 97,001,660915,Van Den Einde; Yael Dahlia,9999,0,9999,0
1715607929836,AIP 197,001,627712,Vespa; Emanuel Ignacio,9995,0,9999,4
1715607929836,AIP 197,002,650778,Amir; On,9998,0,9999,1
1715607929836,AIP 197,003,650933,Avenancio-Leon; Carlos,9998,0,9999,1
1715607929836,AIP 197,004,658530,Heyman; Gail D.,9998,0,9999,1
1715607929836,AIP 197,005,658631,Neal; Sonya E,9998,0,9999,1
1715607929836,AIP 197,006,658671,Du; Songzi,9998,0,9999,1
1715607930865,ANAR 135S,A00,494369,Braswell; Geoffrey E.,0,0,0,0
1715607931893,BENG 196,001,628496,Engler; Adam J.,9998,0,9999,1
1715607931893,BENG 196,002,660916,Watson; John Thomas,9999,0,9999,0
1715607932923,BISP 197,001,650773,Wilhelm; James E.,9994,0,9999,5
1715607932923,BISP 197,002,658904,Coleman; Aaron B.,9998,0,9999,1
1715607933950,CAT 124RS,A01,519847,Geibel; William,0,0,20,20
1715607934980,CAT 125RS,A01,515971,Geibel; William,0,0,20,20
1715607936010,CLRE 250,A00,511389,Morris; Sheldon,9992,0,9999,7
1715607937042,CLRE 251,A00,507176,Mehta; Ravindra L.,9992,0,9999,7
1715607937042,CLRE 251,B00,511410,Mehta; Ravindra L.,9998,0,9999,1
1715607938068,CLRE 252,A00,507189,Cuomo; Raphael Eduardo,9994,0,9999,5
1715607939097,CLRE 253,A00,507199,Vaida; Florin,9994,0,9999,5
1715607939097,CLRE 253,B00,507202,Vaida; Florin,9999,0,9999,0
1715607940128,CLRE 259,A00,507211,Patel; Hemal,9996,0,9999,3
1715607941157,CLRE 260,A00,507221,Cuomo; Raphael Eduardo,9999,0,9999,0
1715607942182,CLRE 297,001,507242,Cuomo; Raphael Eduardo,9999,0,9999,0
1715607943210,COGS 197,001,638244,Voytek; Bradley Thomas,9997,0,9999,2
1715607944237,CSE 191,A00,516875,Minnes Kemp; Mor Mia,9991,0,9999,8
1715607945264,CSE 197,001,637388,Minnes Kemp; Mor Mia,9992,0,9999,7
1715607946290,CSS 201S,A01,494383,Mignozzetti; Umberto,35,0,35,0
1715607947319,CSS 202S,A01,494387,Mignozzetti; Umberto,35,0,35,0
1715607948346,DSC 197,001,628532,Eldridge; Justin Matthew,9995,0,9999,4
1715607949376,EAP 100,A00,516065,Staff,9799,0,9999,200
1715607950405,ECE 45,A01,507414,Staff,31,0,60,29
1715607952461,ECE 111,A01,507420,Staff,11,0,50,39
1715607953490,ECE 197,001,548057,Sievenpiper; Daniel F.,9991,0,9999,8
1715607954517,EDS 115,A00,507243,Choi; Bailey Miyeon,7,0,28,21
1715607955547,EDS 117,A01,494379,Staff,0,6,34,34
1715607956574,EDS 125,A00,507246,Hopkins; Megan Beth,8,0,30,22
1715607957599,EDS 128A,A01,507264,Fargason; Sharon Gayle,6,0,26,20
1715607958626,EDS 128B,A01,507293,Pappas; Elizabeth,10,0,30,20
1715607959652,EDS 139,A00,507294,Fargason; Sharon Gayle,10,0,30,20
1715607959652,EDS 139,B00,507313,Pappas; Elizabeth,11,0,30,19
1715607960682,EDS 201,A00,507315,Staff,10,0,30,20
1715607961709,EDS 203,A01,507317,Halter; Christopher P.,10,0,30,20
1715607962736,EDS 204R,A01,507319,Halter; Christopher P.,0,3,30,30
1715607962736,EDS 204R,B01,507331,Heinzman; Erica M.,14,0,30,16
1715607963761,EDS 206R,A00,507332,Staff,0,4,30,30
1715607963761,EDS 206R,B00,507343,Staff,15,0,30,15
1715607964785,EDS 250,A00,507344,Hemans; Patricia Ann Benitez,20,0,40,20
1715607965815,EDS 281,A00,507345,Daly; Alan J.,18,0,18,0
1715607966843,EDS 284,A00,507350,Daly; Alan J.,16,0,16,0
1715607967867,EDS 286,A00,507359,Fine; Sarah,18,0,18,0
1715607968893,EDS 289C,A01,507361,Daly; Alan J.,18,0,18,0
1715607969918,EDS 290,A00,507366,Hofstetter; Carolyn,15,0,15,0
1715607970944,LIGM 5A,A00,507421,Fischer-Grunski; Eva K,17,0,20,3
1715607971973,LIGM 5B,A00,507423,Fischer-Grunski; Eva K,19,0,20,1
1715607973000,LIGM 5C,A00,507425,Fischer-Grunski; Eva K,19,0,20,1
1715607974030,LIIT 5AS,A00,507427,Carnelos; Chiara,20,0,20,0
1715607975057,LIIT 5BS,A00,507430,Carnelos; Chiara,20,0,20,0
1715607976084,LIIT 5CS,A00,507432,Carnelos; Chiara,20,0,20,0
1715607977112,LISP 5A,A00,507541,Munoz Sanchez; Alicia,11,0,20,9
1715607978141,LISP 5B,A00,507671,Munoz Sanchez; Alicia,9,0,20,11
1715607979172,LISP 5C,A00,507696,Munoz Sanchez; Alicia,9,0,20,11
1715607980199,MAE 197,001,528363,Boechler; Nicholas Sebastia,9998,0,9999,1
1715607981228,MATH 197,001,523477,Kedlaya; Kiran S.,9994,0,9999,5
1715607981228,MATH 197,002,563811,Zhang; Danna,9994,0,9999,5
1715607981228,MATH 197,003,628552,Dumitriu; Ioana,9998,0,9999,1
1715607981228,MATH 197,004,660885,Floyd; Eric,9999,0,9999,0
1715607982254,MCWP 40R,A00,518780,Staff,2,0,20,18
1715607982254,MCWP 40R,B00,518781,Staff,11,0,20,9
1715607982254,MCWP 40R,C00,518783,Staff,5,0,20,15
1715607983282,MCWP 50R,A00,518791,Staff,0,1,20,20
1715607983282,MCWP 50R,B00,518792,Staff,0,2,20,20
1715607983282,MCWP 50R,C00,518793,Staff,0,4,20,20
1715607983282,MCWP 50R,D00,518794,Staff,0,1,20,20
1715607983282,MCWP 50R,E00,518795,Staff,0,2,20,20
1715607983282,MCWP 50R,F00,518796,Staff,0,1,20,20
1715607983282,MCWP 50R,G00,518797,Staff,0,1,20,20
1715607984307,MMW 12R,A01,514034,Herbst; Matthew,0,2,16,16
1715607984307,MMW 12R,A02,514035,Herbst; Matthew,0,0,16,16
1715607985337,MMW 13R,A01,514037,Staff,0,5,16,16
1715607985337,MMW 13R,A02,514039,Staff,0,5,16,16
1715607985337,MMW 13R,A03,628519,Staff,0,4,16,16
1715607987388,SIO 295LS,A00,523233,Staff,10,0,30,20
1715607988414,SIO 295S,A00,523232,Staff,10,0,30,20
1715607989441,SIOC 290S,A01,637330,Merrifield; Mark A,23,0,30,7
1715607990469,SIOC 291S,A01,637333,Gabriel; Corey John,23,0,30,7
1715607991496,SOCI 117,A01,494376,Staff,0,5,5,5
1715607992529,WES 237B,A00,494380,Staff,10,0,20,10
1715607994611,AESE 279B,A00,494370,Wade; Jon P,0,0,33,33
1715607995640,AIP 97,001,660915,Van Den Einde; Yael Dahlia,9999,0,9999,0
1715607996669,AIP 197,001,627712,Vespa; Emanuel Ignacio,9995,0,9999,4
1715607996669,AIP 197,002,650778,Amir; On,9998,0,9999,1
1715607996669,AIP 197,003,650933,Avenancio-Leon; Carlos,9998,0,9999,1
1715607996669,AIP 197,004,658530,Heyman; Gail D.,9998,0,9999,1
1715607996669,AIP 197,005,658631,Neal; Sonya E,9998,0,9999,1
1715607996669,AIP 197,006,658671,Du; Songzi,9998,0,9999,1
1715607997695,ANAR 135S,A00,494369,Braswell; Geoffrey E.,0,0,0,0
1715607998729,BENG 196,001,628496,Engler; Adam J.,9998,0,9999,1
1715607998729,BENG 196,002,660916,Watson; John Thomas,9999,0,9999,0
1715607999758,BISP 197,001,650773,Wilhelm; James E.,9994,0,9999,5
1715607999758,BISP 197,002,658904,Coleman; Aaron B.,9998,0,9999,1
1715608000787,CAT 124RS,A01,519847,Geibel; William,0,0,20,20
1715608001816,CAT 125RS,A01,515971,Geibel; William,0,0,20,20
1715608002843,CLRE 250,A00,511389,Morris; Sheldon,9992,0,9999,7
1715608003869,CLRE 251,A00,507176,Mehta; Ravindra L.,9992,0,9999,7
1715608003869,CLRE 251,B00,511410,Mehta; Ravindra L.,9998,0,9999,1
1715608004900,CLRE 252,A00,507189,Cuomo; Raphael Eduardo,9994,0,9999,5
1715608005927,CLRE 253,A00,507199,Vaida; Florin,9994,0,9999,5
1715608005927,CLRE 253,B00,507202,Vaida; Florin,9999,0,9999,0
1715608006953,CLRE 259,A00,507211,Patel; Hemal,9996,0,9999,3
1715608007978,CLRE 260,A00,507221,Cuomo; Raphael Eduardo,9999,0,9999,0
1715608009006,CLRE 297,001,507242,Cuomo; Raphael Eduardo,9999,0,9999,0
1715608010037,COGS 197,001,638244,Voytek; Bradley Thomas,9997,0,9999,2
1715608011064,CSE 191,A00,516875,Minnes Kemp; Mor Mia,9991,0,9999,8
1715608012091,CSE 197,001,637388,Minnes Kemp; Mor Mia,9992,0,9999,7
1715608013123,CSS 201S,A01,494383,Mignozzetti; Umberto,35,0,35,0
1715608014148,CSS 202S,A01,494387,Mignozzetti; Umberto,35,0,35,0
1715608015176,DSC 197,001,628532,Eldridge; Justin Matthew,9995,0,9999,4
1715608016203,EAP 100,A00,516065,Staff,9799,0,9999,200
1715608017395,ECE 45,A01,507414,Staff,31,0,60,29
1715608019447,ECE 111,A01,507420,Staff,11,0,50,39
1715608020472,ECE 197,001,548057,Sievenpiper; Daniel F.,9991,0,9999,8
1715608021503,EDS 115,A00,507243,Choi; Bailey Miyeon,7,0,28,21
1715608022537,EDS 117,A01,494379,Staff,0,6,34,34
1715608023565,EDS 125,A00,507246,Hopkins; Megan Beth,8,0,30,22
1715608024592,EDS 128A,A01,507264,Fargason; Sharon Gayle,6,0,26,20
1715608025625,EDS 128B,A01,507293,Pappas; Elizabeth,10,0,30,20
1715608026650,EDS 139,A00,507294,Fargason; Sharon Gayle,10,0,30,20
1715608026650,EDS 139,B00,507313,Pappas; Elizabeth,11,0,30,19
1715608027676,EDS 201,A00,507315,Staff,10,0,30,20
1715608028707,EDS 203,A01,507317,Halter; Christopher P.,10,0,30,20
1715608029732,EDS 204R,A01,507319,Halter; Christopher P.,0,3,30,30
1715608029732,EDS 204R,B01,507331,Heinzman; Erica M.,14,0,30,16
1715608030756,EDS 206R,A00,507332,Staff,0,4,30,30
1715608030756,EDS 206R,B00,507343,Staff,15,0,30,15
1715608031786,EDS 250,A00,507344,Hemans; Patricia Ann Benitez,20,0,40,20
1715608032813,EDS 281,A00,507345,Daly; Alan J.,18,0,18,0
1715608033838,EDS 284,A00,507350,Daly; Alan J.,16,0,16,0
1715608034864,EDS 286,A00,507359,Fine; Sarah,18,0,18,0
1715608035888,EDS 289C,A01,507361,Daly; Alan J.,18,0,18,0
1715608036916,EDS 290,A00,507366,Hofstetter; Carolyn,15,0,15,0
1715608037943,LIGM 5A,A00,507421,Fischer-Grunski; Eva K,17,0,20,3
1715608038970,LIGM 5B,A00,507423,Fischer-Grunski; Eva K,19,0,20,1
1715608040000,LIGM 5C,A00,507425,Fischer-Grunski; Eva K,19,0,20,1
1715608041026,LIIT 5AS,A00,507427,Carnelos; Chiara,20,0,20,0
1715608042056,LIIT 5BS,A00,507430,Carnelos; Chiara,20,0,20,0
1715608043164,LIIT 5CS,A00,507432,Carnelos; Chiara,20,0,20,0
1715608044190,LISP 5A,A00,507541,Munoz Sanchez; Alicia,11,0,20,9
1715608045217,LISP 5B,A00,507671,Munoz Sanchez; Alicia,9,0,20,11
1715608046248,LISP 5C,A00,507696,Munoz Sanchez; Alicia,9,0,20,11
1715608047275,MAE 197,001,528363,Boechler; Nicholas Sebastia,9998,0,9999,1
1715608048305,MATH 197,001,523477,Kedlaya; Kiran S.,9994,0,9999,5
1715608048305,MATH 197,002,563811,Zhang; Danna,9994,0,9999,5
1715608048305,MATH 197,003,628552,Dumitriu; Ioana,9998,0,9999,1
1715608048305,MATH 197,004,660885,Floyd; Eric,9999,0,9999,0
1715608049336,MCWP 40R,A00,518780,Staff,2,0,20,18
1715608049336,MCWP 40R,B00,518781,Staff,11,0,20,9
1715608049336,MCWP 40R,C00,518783,Staff,5,0,20,15
1715608050364,MCWP 50R,A00,518791,Staff,0,1,20,20
1715608050364,MCWP 50R,B00,518792,Staff,0,2,20,20
1715608050364,MCWP 50R,C00,518793,Staff,0,4,20,20
1715608050364,MCWP 50R,D00,518794,Staff,0,1,20,20
1715608050364,MCWP 50R,E00,518795,Staff,0,2,20,20
1715608050364,MCWP 50R,F00,518796,Staff,0,1,20,20
1715608050364,MCWP 50R,G00,518797,Staff,0,1,20,20
1715608051391,MMW 12R,A01,514034,Herbst; Matthew,0,2,16,16
1715608051391,MMW 12R,A02,514035,Herbst; Matthew,0,0,16,16
1715608052417,MMW 13R,A01,514037,Staff,0,5,16,16
1715608052417,MMW 13R,A02,514039,Staff,0,5,16,16
1715608052417,MMW 13R,A03,628519,Staff,0,4,16,16
1715608054470,SIO 295LS,A00,523233,Staff,10,0,30,20
1715608055496,SIO 295S,A00,523232,Staff,10,0,30,20
1715608056523,SIOC 290S,A01,637330,Merrifield; Mark A,23,0,30,7
1715608057559,SIOC 291S,A01,637333,Gabriel; Corey John,23,0,30,7
1715608058590,SOCI 117,A01,494376,Staff,0,5,5,5
1715608059618,WES 237B,A00,494380,Staff,10,0,20,10
1715608061693,AESE 279B,A00,494370,Wade; Jon P,0,0,33,33
1715608062720,AIP 97,001,660915,Van Den Einde; Yael Dahlia,9999,0,9999,0
1715608063756,AIP 197,001,627712,Vespa; Emanuel Ignacio,9995,0,9999,4
1715608063756,AIP 197,002,650778,Amir; On,9998,0,9999,1
1715608063756,AIP 197,003,650933,Avenancio-Leon; Carlos,9998,0,9999,1
1715608063756,AIP 197,004,658530,Heyman; Gail D.,9998,0,9999,1
1715608063756,AIP 197,005,658631,Neal; Sonya E,9998,0,9999,1
1715608063756,AIP 197,006,658671,Du; Songzi,9998,0,9999,1
1715608064781,ANAR 135S,A00,494369,Braswell; Geoffrey E.,0,0,0,0
1715608066397,BENG 196,001,628496,Engler; Adam J.,9998,0,9999,1
1715608066397,BENG 196,002,660916,Watson; John Thomas,9999,0,9999,0
1715608067425,BISP 197,001,650773,Wilhelm; James E.,9994,0,9999,5
1715608067425,BISP 197,002,658904,Coleman; Aaron B.,9998,0,9999,1
1715608068451,CAT 124RS,A01,519847,Geibel; William,0,0,20,20
1715608069477,CAT 125RS,A01,515971,Geibel; William,0,0,20,20
1715608070502,CLRE 250,A00,511389,Morris; Sheldon,9992,0,9999,7
1715608071530,CLRE 251,A00,507176,Mehta; Ravindra L.,9992,0,9999,7
1715608071530,CLRE 251,B00,511410,Mehta; Ravindra L.,9998,0,9999,1
1715608072561,CLRE 252,A00,507189,Cuomo; Raphael Eduardo,9994,0,9999,5
1715608073592,CLRE 253,A00,507199,Vaida; Florin,9994,0,9999,5
1715608073592,CLRE 253,B00,507202,Vaida; Florin,9999,0,9999,0
1715608074619,CLRE 259,A00,507211,Patel; Hemal,9996,0,9999,3
1715608075649,CLRE 260,A00,507221,Cuomo; Raphael Eduardo,9999,0,9999,0
1715608076677,CLRE 297,001,507242,Cuomo; Raphael Eduardo,9999,0,9999,0
1715608077703,COGS 197,001,638244,Voytek; Bradley Thomas,9997,0,9999,2
1715608078733,CSE 191,A00,516875,Minnes Kemp; Mor Mia,9991,0,9999,8
1715608079758,CSE 197,001,637388,Minnes Kemp; Mor Mia,9992,0,9999,7
1715608080785,CSS 201S,A01,494383,Mignozzetti; Umberto,35,0,35,0
1715608081810,CSS 202S,A01,494387,Mignozzetti; Umberto,35,0,35,0
1715608082839,DSC 197,001,628532,Eldridge; Justin Matthew,9995,0,9999,4
1715608083877,EAP 100,A00,516065,Staff,9799,0,9999,200
1715608084960,ECE 45,A01,507414,Staff,31,0,60,29
1715608087016,ECE 111,A01,507420,Staff,11,0,50,39
1715608088042,ECE 197,001,548057,Sievenpiper; Daniel F.,9991,0,9999,8
1715608089068,EDS 115,A00,507243,Choi; Bailey Miyeon,7,0,28,21
1715608090095,EDS 117,A01,494379,Staff,0,6,34,34
1715608091125,EDS 125,A00,507246,Hopkins; Megan Beth,8,0,30,22
1715608092151,EDS 128A,A01,507264,Fargason; Sharon Gayle,6,0,26,20
1715608093182,EDS 128B,A01,507293,Pappas; Elizabeth,10,0,30,20
1715608094207,EDS 139,A00,507294,Fargason; Sharon Gayle,10,0,30,20
1715608094207,EDS 139,B00,507313,Pappas; Elizabeth,11,0,30,19
1715608095234,EDS 201,A00,507315,Staff,10,0,30,20
1715608096259,EDS 203,A01,507317,Halter; Christopher P.,10,0,30,20
1715608097286,EDS 204R,A01,507319,Halter; Christopher P.,0,3,30,30
1715608097286,EDS 204R,B01,507331,Heinzman; Erica M.,14,0,30,16
1715608098310,EDS 206R,A00,507332,Staff,0,4,30,30
1715608098310,EDS 206R,B00,507343,Staff,15,0,30,15
1715608099338,EDS 250,A00,507344,Hemans; Patricia Ann Benitez,20,0,40,20
1715608100366,EDS 281,A00,507345,Daly; Alan J.,18,0,18,0
1715608101393,EDS 284,A00,507350,Daly; Alan J.,16,0,16,0
1715608102420,EDS 286,A00,507359,Fine; Sarah,18,0,18,0
1715608103444,EDS 289C,A01,507361,Daly; Alan J.,18,0,18,0
1715608104469,EDS 290,A00,507366,Hofstetter; Carolyn,15,0,15,0
1715608105494,LIGM 5A,A00,507421,Fischer-Grunski; Eva K,17,0,20,3
1715608106520,LIGM 5B,A00,507423,Fischer-Grunski; Eva K,19,0,20,1
1715608107545,LIGM 5C,A00,507425,Fischer-Grunski; Eva K,19,0,20,1
1715608108574,LIIT 5AS,A00,507427,Carnelos; Chiara,20,0,20,0
1715608109598,LIIT 5BS,A00,507430,Carnelos; Chiara,20,0,20,0
1715608110627,LIIT 5CS,A00,507432,Carnelos; Chiara,20,0,20,0
1715608111658,LISP 5A,A00,507541,Munoz Sanchez; Alicia,11,0,20,9
1715608112687,LISP 5B,A00,507671,Munoz Sanchez; Alicia,9,0,20,11
1715608113715,LISP 5C,A00,507696,Munoz Sanchez; Alicia,9,0,20,11
1715608114745,MAE 197,001,528363,Boechler; Nicholas Sebastia,9998,0,9999,1
1715608115780,MATH 197,001,523477,Kedlaya; Kiran S.,9994,0,9999,5
1715608115780,MATH 197,002,563811,Zhang; Danna,9994,0,9999,5
1715608115780,MATH 197,003,628552,Dumitriu; Ioana,9998,0,9999,1
1715608115780,MATH 197,004,660885,Floyd; Eric,9999,0,9999,0
1715608116809,MCWP 40R,A00,518780,Staff,2,0,20,18
1715608116809,MCWP 40R,B00,518781,Staff,11,0,20,9
1715608116809,MCWP 40R,C00,518783,Staff,5,0,20,15
1715608117836,MCWP 50R,A00,518791,Staff,0,1,20,20
1715608117836,MCWP 50R,B00,518792,Staff,0,2,20,20
1715608117836,MCWP 50R,C00,518793,Staff,0,4,20,20
1715608117836,MCWP 50R,D00,518794,Staff,0,1,20,20
1715608117836,MCWP 50R,E00,518795,Staff,0,2,20,20
1715608117836,MCWP 50R,F00,518796,Staff,0,1,20,20
1715608117836,MCWP 50R,G00,518797,Staff,0,1,20,20
1715608118866,MMW 12R,A01,514034,Herbst; Matthew,0,2,16,16
1715608118866,MMW 12R,A02,514035,Herbst; Matthew,0,0,16,16
1715608119891,MMW 13R,A01,514037,Staff,0,5,16,16
1715608119891,MMW 13R,A02,514039,Staff,0,5,16,16
1715608119891,MMW 13R,A03,628519,Staff,0,4,16,16
1715608121946,SIO 295LS,A00,523233,Staff,10,0,30,20
1715608122969,SIO 295S,A00,523232,Staff,10,0,30,20
1715608123996,SIOC 290S,A01,637330,Merrifield; Mark A,23,0,30,7
1715608125024,SIOC 291S,A01,637333,Gabriel; Corey John,23,0,30,7
1715608126054,SOCI 117,A01,494376,Staff,0,5,5,5
1715608127081,WES 237B,A00,494380,Staff,10,0,20,10
1715608129160,AESE 279B,A00,494370,Wade; Jon P,0,0,33,33
1715608130185,AIP 97,001,660915,Van Den Einde; Yael Dahlia,9999,0,9999,0
1715608131213,AIP 197,001,627712,Vespa; Emanuel Ignacio,9995,0,9999,4
1715608131213,AIP 197,002,650778,Amir; On,9998,0,9999,1
1715608131213,AIP 197,003,650933,Avenancio-Leon; Carlos,9998,0,9999,1
1715608131213,AIP 197,004,658530,Heyman; Gail D.,9998,0,9999,1
1715608131213,AIP 197,005,658631,Neal; Sonya E,9998,0,9999,1
1715608131213,AIP 197,006,658671,Du; Songzi,9998,0,9999,1
1715608132240,ANAR 135S,A00,494369,Braswell; Geoffrey E.,0,0,0,0
1715608133268,BENG 196,001,628496,Engler; Adam J.,9998,0,9999,1
1715608133268,BENG 196,002,660916,Watson; John Thomas,9999,0,9999,0
1715608134296,BISP 197,001,650773,Wilhelm; James E.,9994,0,9999,5
1715608134296,BISP 197,002,658904,Coleman; Aaron B.,9998,0,9999,1
1715608135322,CAT 124RS,A01,519847,Geibel; William,0,0,20,20
1715608136349,CAT 125RS,A01,515971,Geibel; William,0,0,20,20
1715608137377,CLRE 250,A00,511389,Morris; Sheldon,9992,0,9999,7
1715608138404,CLRE 251,A00,507176,Mehta; Ravindra L.,9992,0,9999,7
1715608138404,CLRE 251,B00,511410,Mehta; Ravindra L.,9998,0,9999,1
1715608139437,CLRE 252,A00,507189,Cuomo; Raphael Eduardo,9994,0,9999,5
1715608140472,CLRE 253,A00,507199,Vaida; Florin,9994,0,9999,5
1715608140472,CLRE 253,B00,507202,Vaida; Florin,9999,0,9999,0
1715608141500,CLRE 259,A00,507211,Patel; Hemal,9996,0,9999,3
1715608142527,CLRE 260,A00,507221,Cuomo; Raphael Eduardo,9999,0,9999,0
1715608143558,CLRE 297,001,507242,Cuomo; Raphael Eduardo,9999,0,9999,0
1715608144588,COGS 197,001,638244,Voytek; Bradley Thomas,9997,0,9999,2
1715608145615,CSE 191,A00,516875,Minnes Kemp; Mor Mia,9991,0,9999,8
1715608146640,CSE 197,001,637388,Minnes Kemp; Mor Mia,9992,0,9999,7
1715608147666,CSS 201S,A01,494383,Mignozzetti; Umberto,35,0,35,0
1715608148694,CSS 202S,A01,494387,Mignozzetti; Umberto,35,0,35,0
1715608149720,DSC 197,001,628532,Eldridge; Justin Matthew,9995,0,9999,4
1715608150751,EAP 100,A00,516065,Staff,9799,0,9999,200
1715608151778,ECE 45,A01,507414,Staff,31,0,60,29
1715608153831,ECE 111,A01,507420,Staff,11,0,50,39
1715608154858,ECE 197,001,548057,Sievenpiper; Daniel F.,9991,0,9999,8
1715608155886,EDS 115,A00,507243,Choi; Bailey Miyeon,7,0,28,21
1715608156916,EDS 117,A01,494379,Staff,0,6,34,34
1715608157947,EDS 125,A00,507246,Hopkins; Megan Beth,8,0,30,22
1715608158972,EDS 128A,A01,507264,Fargason; Sharon Gayle,6,0,26,20
1715608159999,EDS 128B,A01,507293,Pappas; Elizabeth,10,0,30,20
1715608161024,EDS 139,A00,507294,Fargason; Sharon Gayle,10,0,30,20
1715608161024,EDS 139,B00,507313,Pappas; Elizabeth,11,0,30,19
1715608162050,EDS 201,A00,507315,Staff,10,0,30,20
1715608163080,EDS 203,A01,507317,Halter; Christopher P.,10,0,30,20
1715608164106,EDS 204R,A01,507319,Halter; Christopher P.,0,3,30,30
1715608164106,EDS 204R,B01,507331,Heinzman; Erica M.,14,0,30,16
1715608165135,EDS 206R,A00,507332,Staff,0,4,30,30
1715608165135,EDS 206R,B00,507343,Staff,15,0,30,15
1715608166160,EDS 250,A00,507344,Hemans; Patricia Ann Benitez,20,0,40,20
1715608167186,EDS 281,A00,507345,Daly; Alan J.,18,0,18,0
1715608168211,EDS 284,A00,507350,Daly; Alan J.,16,0,16,0
1715608169238,EDS 286,A00,507359,Fine; Sarah,18,0,18,0
1715608170264,EDS 289C,A01,507361,Daly; Alan J.,18,0,18,0
1715608171294,EDS 290,A00,507366,Hofstetter; Carolyn,15,0,15,0
1715608172327,LIGM 5A,A00,507421,Fischer-Grunski; Eva K,17,0,20,3
1715608173355,LIGM 5B,A00,507423,Fischer-Grunski; Eva K,19,0,20,1
1715608174384,LIGM 5C,A00,507425,Fischer-Grunski; Eva K,19,0,20,1
1715608175410,LIIT 5AS,A00,507427,Carnelos; Chiara,20,0,20,0
1715608176440,LIIT 5BS,A00,507430,Carnelos; Chiara,20,0,20,0
1715608177470,LIIT 5CS,A00,507432,Carnelos; Chiara,20,0,20,0
1715608178503,LISP 5A,A00,507541,Munoz Sanchez; Alicia,11,0,20,9
1715608179532,LISP 5B,A00,507671,Munoz Sanchez; Alicia,9,0,20,11
1715608180557,LISP 5C,A00,507696,Munoz Sanchez; Alicia,9,0,20,11
1715608181588,MAE 197,001,528363,Boechler; Nicholas Sebastia,9998,0,9999,1
1715608182616,MATH 197,001,523477,Kedlaya; Kiran S.,9994,0,9999,5
1715608182616,MATH 197,002,563811,Zhang; Danna,9994,0,9999,5
1715608182616,MATH 197,003,628552,Dumitriu; Ioana,9998,0,9999,1
1715608182616,MATH 197,004,660885,Floyd; Eric,9999,0,9999,0
1715608183643,MCWP 40R,A00,518780,Staff,2,0,20,18
1715608183643,MCWP 40R,B00,518781,Staff,11,0,20,9
1715608183643,MCWP 40R,C00,518783,Staff,5,0,20,15
1715608184671,MCWP 50R,A00,518791,Staff,0,1,20,20
1715608184671,MCWP 50R,B00,518792,Staff,0,2,20,20
1715608184671,MCWP 50R,C00,518793,Staff,0,4,20,20
1715608184671,MCWP 50R,D00,518794,Staff,0,1,20,20
1715608184671,MCWP 50R,E00,518795,Staff,0,2,20,20
1715608184671,MCWP 50R,F00,518796,Staff,0,1,20,20
1715608184671,MCWP 50R,G00,518797,Staff,0,1,20,20
1715608185697,MMW 12R,A01,514034,Herbst; Matthew,0,2,16,16
1715608185697,MMW 12R,A02,514035,Herbst; Matthew,0,0,16,16
1715608186723,MMW 13R,A01,514037,Staff,0,5,16,16
1715608186723,MMW 13R,A02,514039,Staff,0,5,16,16
1715608186723,MMW 13R,A03,628519,Staff,0,4,16,16
1715608188844,SIO 295LS,A00,523233,Staff,10,0,30,20
1715608189872,SIO 295S,A00,523232,Staff,10,0,30,20
1715608190901,SIOC 290S,A01,637330,Merrifield; Mark A,23,0,30,7
1715608191930,SIOC 291S,A01,637333,Gabriel; Corey John,23,0,30,7
1715608192956,SOCI 117,A01,494376,Staff,0,5,5,5
1715608193983,WES 237B,A00,494380,Staff,10,0,20,10
1715608196054,AESE 279B,A00,494370,Wade; Jon P,0,0,33,33
1715608197081,AIP 97,001,660915,Van Den Einde; Yael Dahlia,9999,0,9999,0
1715608198117,AIP 197,001,627712,Vespa; Emanuel Ignacio,9995,0,9999,4
1715608198117,AIP 197,002,650778,Amir; On,9998,0,9999,1
1715608198117,AIP 197,003,650933,Avenancio-Leon; Carlos,9998,0,9999,1
1715608198117,AIP 197,004,658530,Heyman; Gail D.,9998,0,9999,1
1715608198117,AIP 197,005,658631,Neal; Sonya E,9998,0,9999,1
1715608198117,AIP 197,006,658671,Du; Songzi,9998,0,9999,1
1715608199148,ANAR 135S,A00,494369,Braswell; Geoffrey E.,0,0,0,0
1715608200178,BENG 196,001,628496,Engler; Adam J.,9998,0,9999,1
1715608200178,BENG 196,002,660916,Watson; John Thomas,9999,0,9999,0
1715608201206,BISP 197,001,650773,Wilhelm; James E.,9994,0,9999,5
1715608201206,BISP 197,002,658904,Coleman; Aaron B.,9998,0,9999,1
1715608202238,CAT 124RS,A01,519847,Geibel; William,0,0,20,20
1715608203268,CAT 125RS,A01,515971,Geibel; William,0,0,20,20
1715608204295,CLRE 250,A00,511389,Morris; Sheldon,9992,0,9999,7
1715608205322,CLRE 251,A00,507176,Mehta; Ravindra L.,9992,0,9999,7
1715608205322,CLRE 251,B00,511410,Mehta; Ravindra L.,9998,0,9999,1
1715608206348,CLRE 252,A00,507189,Cuomo; Raphael Eduardo,9994,0,9999,5
1715608207381,CLRE 253,A00,507199,Vaida; Florin,9994,0,9999,5
1715608207381,CLRE 253,B00,507202,Vaida; Florin,9999,0,9999,0
1715608208407,CLRE 259,A00,507211,Patel; Hemal,9996,0,9999,3
1715608209432,CLRE 260,A00,507221,Cuomo; Raphael Eduardo,9999,0,9999,0
1715608210458,CLRE 297,001,507242,Cuomo; Raphael Eduardo,9999,0,9999,0
1715608211484,COGS 197,001,638244,Voytek; Bradley Thomas,9997,0,9999,2
1715608212512,CSE 191,A00,516875,Minnes Kemp; Mor Mia,9991,0,9999,8
1715608213544,CSE 197,001,637388,Minnes Kemp; Mor Mia,9992,0,9999,7
1715608214578,CSS 201S,A01,494383,Mignozzetti; Umberto,35,0,35,0
1715608215605,CSS 202S,A01,494387,Mignozzetti; Umberto,35,0,35,0
1715608216629,DSC 197,001,628532,Eldridge; Justin Matthew,9995,0,9999,4
1715608217654,EAP 100,A00,516065,Staff,9799,0,9999,200
1715608218683,ECE 45,A01,507414,Staff,31,0,60,29
1715608220738,ECE 111,A01,507420,Staff,11,0,50,39
1715608221768,ECE 197,001,548057,Sievenpiper; Daniel F.,9991,0,9999,8
1715608222794,EDS 115,A00,507243,Choi; Bailey Miyeon,7,0,28,21
1715608223819,EDS 117,A01,494379,Staff,0,6,34,34
1715608224846,EDS 125,A00,507246,Hopkins; Megan Beth,8,0,30,22
1715608225873,EDS 128A,A01,507264,Fargason; Sharon Gayle,6,0,26,20
1715608226906,EDS 128B,A01,507293,Pappas; Elizabeth,10,0,30,20
1715608227932,EDS 139,A00,507294,Fargason; Sharon Gayle,10,0,30,20
1715608227932,EDS 139,B00,507313,Pappas; Elizabeth,11,0,30,19
1715608228960,EDS 201,A00,507315,Staff,10,0,30,20
1715608229988,EDS 203,A01,507317,Halter; Christopher P.,10,0,30,20
1715608231016,EDS 204R,A01,507319,Halter; Christopher P.,0,3,30,30
1715608231016,EDS 204R,B01,507331,Heinzman; Erica M.,14,0,30,16
1715608232043,EDS 206R,A00,507332,Staff,0,4,30,30
1715608232043,EDS 206R,B00,507343,Staff,15,0,30,15
1715608233069,EDS 250,A00,507344,Hemans; Patricia Ann Benitez,20,0,40,20
1715608234093,EDS 281,A00,507345,Daly; Alan J.,18,0,18,0
1715608235120,EDS 284,A00,507350,Daly; Alan J.,16,0,16,0
1715608236152,EDS 286,A00,507359,Fine; Sarah,18,0,18,0
1715608237176,EDS 289C,A01,507361,Daly; Alan J.,18,0,18,0
1715608238201,EDS 290,A00,507366,Hofstetter; Carolyn,15,0,15,0
1715608239230,LIGM 5A,A00,507421,Fischer-Grunski; Eva K,17,0,20,3
1715608240256,LIGM 5B,A00,507423,Fischer-Grunski; Eva K,19,0,20,1
1715608241287,LIGM 5C,A00,507425,Fischer-Grunski; Eva K,19,0,20,1
1715608242315,LIIT 5AS,A00,507427,Carnelos; Chiara,20,0,20,0
1715608243342,LIIT 5BS,A00,507430,Carnelos; Chiara,20,0,20,0
1715608244372,LIIT 5CS,A00,507432,Carnelos; Chiara,20,0,20,0
1715608245398,LISP 5A,A00,507541,Munoz Sanchez; Alicia,11,0,20,9
1715608246423,LISP 5B,A00,507671,Munoz Sanchez; Alicia,9,0,20,11
1715608247453,LISP 5C,A00,507696,Munoz Sanchez; Alicia,9,0,20,11
1715608248481,MAE 197,001,528363,Boechler; Nicholas Sebastia,9998,0,9999,1
1715608249510,MATH 197,001,523477,Kedlaya; Kiran S.,9994,0,9999,5
1715608249510,MATH 197,002,563811,Zhang; Danna,9994,0,9999,5
1715608249510,MATH 197,003,628552,Dumitriu; Ioana,9998,0,9999,1
1715608249510,MATH 197,004,660885,Floyd; Eric,9999,0,9999,0
1715608250539,MCWP 40R,A00,518780,Staff,2,0,20,18
1715608250539,MCWP 40R,B00,518781,Staff,11,0,20,9
1715608250539,MCWP 40R,C00,518783,Staff,5,0,20,15
1715608251568,MCWP 50R,A00,518791,Staff,0,1,20,20
1715608251568,MCWP 50R,B00,518792,Staff,0,2,20,20
1715608251568,MCWP 50R,C00,518793,Staff,0,4,20,20
1715608251568,MCWP 50R,D00,518794,Staff,0,1,20,20
1715608251568,MCWP 50R,E00,518795,Staff,0,2,20,20
1715608251568,MCWP 50R,F00,518796,Staff,0,1,20,20
1715608251568,MCWP 50R,G00,518797,Staff,0,1,20,20
1715608252594,MMW 12R,A01,514034,Herbst; Matthew,0,2,16,16
1715608252594,MMW 12R,A02,514035,Herbst; Matthew,0,0,16,16
1715608253619,MMW 13R,A01,514037,Staff,0,5,16,16
1715608253619,MMW 13R,A02,514039,Staff,0,5,16,16
1715608253619,MMW 13R,A03,628519,Staff,0,4,16,16
1715608255675,SIO 295LS,A00,523233,Staff,10,0,30,20
1715608256701,SIO 295S,A00,523232,Staff,10,0,30,20
1715608257729,SIOC 290S,A01,637330,Merrifield; Mark A,23,0,30,7
1715608258757,SIOC 291S,A01,637333,Gabriel; Corey John,23,0,30,7
1715608259784,SOCI 117,A01,494376,Staff,0,5,5,5
1715608260810,WES 237B,A00,494380,Staff,10,0,20,10
1715608262886,AESE 279B,A00,494370,Wade; Jon P,0,0,33,33
1715608263916,AIP 97,001,660915,Van Den Einde; Yael Dahlia,9999,0,9999,0
1715608264944,AIP 197,001,627712,Vespa; Emanuel Ignacio,9995,0,9999,4
1715608264944,AIP 197,002,650778,Amir; On,9998,0,9999,1
1715608264944,AIP 197,003,650933,Avenancio-Leon; Carlos,9998,0,9999,1
1715608264944,AIP 197,004,658530,Heyman; Gail D.,9998,0,9999,1
1715608264944,AIP 197,005,658631,Neal; Sonya E,9998,0,9999,1
1715608264944,AIP 197,006,658671,Du; Songzi,9998,0,9999,1
1715608265972,ANAR 135S,A00,494369,Braswell; Geoffrey E.,0,0,0,0
1715608267000,BENG 196,001,628496,Engler; Adam J.,9998,0,9999,1
1715608267000,BENG 196,002,660916,Watson; John Thomas,9999,0,9999,0
1715608268027,BISP 197,001,650773,Wilhelm; James E.,9994,0,9999,5
1715608268027,BISP 197,002,658904,Coleman; Aaron B.,9998,0,9999,1
1715608269057,CAT 124RS,A01,519847,Geibel; William,0,0,20,20
1715608270083,CAT 125RS,A01,515971,Geibel; William,0,0,20,20
1715608271110,CLRE 250,A00,511389,Morris; Sheldon,9992,0,9999,7
1715608272138,CLRE 251,A00,507176,Mehta; Ravindra L.,9992,0,9999,7
1715608272138,CLRE 251,B00,511410,Mehta; Ravindra L.,9998,0,9999,1
1715608273164,CLRE 252,A00,507189,Cuomo; Raphael Eduardo,9994,0,9999,5
1715608274190,CLRE 253,A00,507199,Vaida; Florin,9994,0,9999,5
1715608274190,CLRE 253,B00,507202,Vaida; Florin,9999,0,9999,0
1715608275222,CLRE 259,A00,507211,Patel; Hemal,9996,0,9999,3
1715608276248,CLRE 260,A00,507221,Cuomo; Raphael Eduardo,9999,0,9999,0
1715608277275,CLRE 297,001,507242,Cuomo; Raphael Eduardo,9999,0,9999,0
1715608278303,COGS 197,001,638244,Voytek; Bradley Thomas,9997,0,9999,2
1715608279329,CSE 191,A00,516875,Minnes Kemp; Mor Mia,9991,0,9999,8
1715608280357,CSE 197,001,637388,Minnes Kemp; Mor Mia,9992,0,9999,7
1715608281394,CSS 201S,A01,494383,Mignozzetti; Umberto,35,0,35,0
1715608282420,CSS 202S,A01,494387,Mignozzetti; Umberto,35,0,35,0
1715608283449,DSC 197,001,628532,Eldridge; Justin Matthew,9995,0,9999,4
1715608284475,EAP 100,A00,516065,Staff,9799,0,9999,200
1715608285504,ECE 45,A01,507414,Staff,31,0,60,29
1715608287556,ECE 111,A01,507420,Staff,11,0,50,39
1715608289047,ECE 197,001,548057,Sievenpiper; Daniel F.,9991,0,9999,8
1715608290076,EDS 115,A00,507243,Choi; Bailey Miyeon,7,0,28,21
1715608291102,EDS 117,A01,494379,Staff,0,6,34,34
1715608292128,EDS 125,A00,507246,Hopkins; Megan Beth,8,0,30,22
1715608293153,EDS 128A,A01,507264,Fargason; Sharon Gayle,6,0,26,20
1715608294182,EDS 128B,A01,507293,Pappas; Elizabeth,10,0,30,20
1715608295209,EDS 139,A00,507294,Fargason; Sharon Gayle,10,0,30,20
1715608295209,EDS 139,B00,507313,Pappas; Elizabeth,11,0,30,19
1715608296234,EDS 201,A00,507315,Staff,10,0,30,20
1715608297265,EDS 203,A01,507317,Halter; Christopher P.,10,0,30,20
1715608298291,EDS 204R,A01,507319,Halter; Christopher P.,0,3,30,30
1715608298291,EDS 204R,B01,507331,Heinzman; Erica M.,14,0,30,16
1715608299318,EDS 206R,A00,507332,Staff,0,4,30,30
1715608299318,EDS 206R,B00,507343,Staff,15,0,30,15
1715608300347,EDS 250,A00,507344,Hemans; Patricia Ann Benitez,20,0,40,20
1715608301376,EDS 281,A00,507345,Daly; Alan J.,18,0,18,0
1715608302402,EDS 284,A00,507350,Daly; Alan J.,16,0,16,0
1715608303428,EDS 286,A00,507359,Fine; Sarah,18,0,18,0
1715608304453,EDS 289C,A01,507361,Daly; Alan J.,18,0,18,0
1715608305480,EDS 290,A00,507366,Hofstetter; Carolyn,15,0,15,0
1715608306508,LIGM 5A,A00,507421,Fischer-Grunski; Eva K,17,0,20,3
1715608307534,LIGM 5B,A00,507423,Fischer-Grunski; Eva K,19,0,20,1
1715608308562,LIGM 5C,A00,507425,Fischer-Grunski; Eva K,19,0,20,1
1715608309593,LIIT 5AS,A00,507427,Carnelos; Chiara,20,0,20,0
1715608310620,LIIT 5BS,A00,507430,Carnelos; Chiara,20,0,20,0
1715608311646,LIIT 5CS,A00,507432,Carnelos; Chiara,20,0,20,0
1715608312697,LISP 5A,A00,507541,Munoz Sanchez; Alicia,11,0,20,9
1715608313723,LISP 5B,A00,507671,Munoz Sanchez; Alicia,9,0,20,11
1715608314751,LISP 5C,A00,507696,Munoz Sanchez; Alicia,9,0,20,11
1715608315776,MAE 197,001,528363,Boechler; Nicholas Sebastia,9998,0,9999,1
1715608316806,MATH 197,001,523477,Kedlaya; Kiran S.,9994,0,9999,5
1715608316806,MATH 197,002,563811,Zhang; Danna,9994,0,9999,5
1715608316806,MATH 197,003,628552,Dumitriu; Ioana,9998,0,9999,1
1715608316806,MATH 197,004,660885,Floyd; Eric,9999,0,9999,0
1715608317833,MCWP 40R,A00,518780,Staff,2,0,20,18
1715608317833,MCWP 40R,B00,518781,Staff,11,0,20,9
1715608317833,MCWP 40R,C00,518783,Staff,5,0,20,15
1715608318859,MCWP 50R,A00,518791,Staff,0,1,20,20
1715608318859,MCWP 50R,B00,518792,Staff,0,2,20,20
1715608318859,MCWP 50R,C00,518793,Staff,0,4,20,20
1715608318859,MCWP 50R,D00,518794,Staff,0,1,20,20
1715608318859,MCWP 50R,E00,518795,Staff,0,2,20,20
1715608318859,MCWP 50R,F00,518796,Staff,0,1,20,20
1715608318859,MCWP 50R,G00,518797,Staff,0,1,20,20
1715608319885,MMW 12R,A01,514034,Herbst; Matthew,0,2,16,16
1715608319885,MMW 12R,A02,514035,Herbst; Matthew,0,0,16,16
1715608320911,MMW 13R,A01,514037,Staff,0,5,16,16
1715608320911,MMW 13R,A02,514039,Staff,0,5,16,16
1715608320911,MMW 13R,A03,628519,Staff,0,4,16,16
1715608322966,SIO 295LS,A00,523233,Staff,10,0,30,20
1715608323993,SIO 295S,A00,523232,Staff,10,0,30,20
1715608325020,SIOC 290S,A01,637330,Merrifield; Mark A,23,0,30,7
1715608326047,SIOC 291S,A01,637333,Gabriel; Corey John,23,0,30,7
1715608327073,SOCI 117,A01,494376,Staff,0,5,5,5
1715608328101,WES 237B,A00,494380,Staff,10,0,20,10
1715608330192,AESE 279B,A00,494370,Wade; Jon P,0,0,33,33
1715608331218,AIP 97,001,660915,Van Den Einde; Yael Dahlia,9999,0,9999,0
1715608332248,AIP 197,001,627712,Vespa; Emanuel Ignacio,9995,0,9999,4
1715608332248,AIP 197,002,650778,Amir; On,9998,0,9999,1
1715608332248,AIP 197,003,650933,Avenancio-Leon; Carlos,9998,0,9999,1
1715608332248,AIP 197,004,658530,Heyman; Gail D.,9998,0,9999,1
1715608332248,AIP 197,005,658631,Neal; Sonya E,9998,0,9999,1
1715608332248,AIP 197,006,658671,Du; Songzi,9998,0,9999,1
1715608333278,ANAR 135S,A00,494369,Braswell; Geoffrey E.,0,0,0,0
1715608334309,BENG 196,001,628496,Engler; Adam J.,9998,0,9999,1
1715608334309,BENG 196,002,660916,Watson; John Thomas,9999,0,9999,0
1715608335340,BISP 197,001,650773,Wilhelm; James E.,9994,0,9999,5
1715608335340,BISP 197,002,658904,Coleman; Aaron B.,9998,0,9999,1
1715608336367,CAT 124RS,A01,519847,Geibel; William,0,0,20,20
1715608337397,CAT 125RS,A01,515971,Geibel; William,0,0,20,20
1715608338426,CLRE 250,A00,511389,Morris; Sheldon,9992,0,9999,7
1715608339456,CLRE 251,A00,507176,Mehta; Ravindra L.,9992,0,9999,7
1715608339456,CLRE 251,B00,511410,Mehta; Ravindra L.,9998,0,9999,1
1715608340483,CLRE 252,A00,507189,Cuomo; Raphael Eduardo,9994,0,9999,5
1715608341516,CLRE 253,A00,507199,Vaida; Florin,9994,0,9999,5
1715608341516,CLRE 253,B00,507202,Vaida; Florin,9999,0,9999,0
1715608342546,CLRE 259,A00,507211,Patel; Hemal,9996,0,9999,3
1715608343573,CLRE 260,A00,507221,Cuomo; Raphael Eduardo,9999,0,9999,0
1715608344601,CLRE 297,001,507242,Cuomo; Raphael Eduardo,9999,0,9999,0
1715608345629,COGS 197,001,638244,Voytek; Bradley Thomas,9997,0,9999,2
1715608346659,CSE 191,A00,516875,Minnes Kemp; Mor Mia,9991,0,9999,8
1715608347686,CSE 197,001,637388,Minnes Kemp; Mor Mia,9992,0,9999,7
1715608348714,CSS 201S,A01,494383,Mignozzetti; Umberto,35,0,35,0
1715608349742,CSS 202S,A01,494387,Mignozzetti; Umberto,35,0,35,0
1715608350769,DSC 197,001,628532,Eldridge; Justin Matthew,9995,0,9999,4
1715608351797,EAP 100,A00,516065,Staff,9799,0,9999,200
1715608352828,ECE 45,A01,507414,Staff,31,0,60,29
1715608354880,ECE 111,A01,507420,Staff,11,0,50,39
1715608355906,ECE 197,001,548057,Sievenpiper; Daniel F.,9991,0,9999,8
1715608356932,EDS 115,A00,507243,Choi; Bailey Miyeon,7,0,28,21
1715608357959,EDS 117,A01,494379,Staff,0,6,34,34
1715608358984,EDS 125,A00,507246,Hopkins; Megan Beth,8,0,30,22
1715608360012,EDS 128A,A01,507264,Fargason; Sharon Gayle,6,0,26,20
1715608361039,EDS 128B,A01,507293,Pappas; Elizabeth,10,0,30,20
1715608362068,EDS 139,A00,507294,Fargason; Sharon Gayle,10,0,30,20
1715608362068,EDS 139,B00,507313,Pappas; Elizabeth,11,0,30,19
1715608363097,EDS 201,A00,507315,Staff,10,0,30,20
1715608364127,EDS 203,A01,507317,Halter; Christopher P.,10,0,30,20
1715608365155,EDS 204R,A01,507319,Halter; Christopher P.,0,3,30,30
1715608365155,EDS 204R,B01,507331,Heinzman; Erica M.,14,0,30,16
1715608366184,EDS 206R,A00,507332,Staff,0,4,30,30
1715608366184,EDS 206R,B00,507343,Staff,15,0,30,15
1715608367211,EDS 250,A00,507344,Hemans; Patricia Ann Benitez,20,0,40,20
1715608368239,EDS 281,A00,507345,Daly; Alan J.,18,0,18,0
1715608369266,EDS 284,A00,507350,Daly; Alan J.,16,0,16,0
1715608370295,EDS 286,A00,507359,Fine; Sarah,18,0,18,0
1715608371322,EDS 289C,A01,507361,Daly; Alan J.,18,0,18,0
1715608372349,EDS 290,A00,507366,Hofstetter; Carolyn,15,0,15,0
1715608373375,LIGM 5A,A00,507421,Fischer-Grunski; Eva K,17,0,20,3
1715608374402,LIGM 5B,A00,507423,Fischer-Grunski; Eva K,19,0,20,1
1715608375432,LIGM 5C,A00,507425,Fischer-Grunski; Eva K,19,0,20,1
1715608376460,LIIT 5AS,A00,507427,Carnelos; Chiara,20,0,20,0
1715608377488,LIIT 5BS,A00,507430,Carnelos; Chiara,20,0,20,0
1715608378512,LIIT 5CS,A00,507432,Carnelos; Chiara,20,0,20,0
1715608379540,LISP 5A,A00,507541,Munoz Sanchez; Alicia,11,0,20,9
1715608380566,LISP 5B,A00,507671,Munoz Sanchez; Alicia,9,0,20,11
1715608381593,LISP 5C,A00,507696,Munoz Sanchez; Alicia,9,0,20,11
1715608382620,MAE 197,001,528363,Boechler; Nicholas Sebastia,9998,0,9999,1
1715608383651,MATH 197,001,523477,Kedlaya; Kiran S.,9994,0,9999,5
1715608383651,MATH 197,002,563811,Zhang; Danna,9994,0,9999,5
1715608383651,MATH 197,003,628552,Dumitriu; Ioana,9998,0,9999,1
1715608383651,MATH 197,004,660885,Floyd; Eric,9999,0,9999,0
1715608384680,MCWP 40R,A00,518780,Staff,2,0,20,18
1715608384680,MCWP 40R,B00,518781,Staff,11,0,20,9
1715608384680,MCWP 40R,C00,518783,Staff,5,0,20,15
1715608385710,MCWP 50R,A00,518791,Staff,0,1,20,20
1715608385710,MCWP 50R,B00,518792,Staff,0,2,20,20
1715608385710,MCWP 50R,C00,518793,Staff,0,4,20,20
1715608385710,MCWP 50R,D00,518794,Staff,0,1,20,20
1715608385710,MCWP 50R,E00,518795,Staff,0,2,20,20
1715608385710,MCWP 50R,F00,518796,Staff,0,1,20,20
1715608385710,MCWP 50R,G00,518797,Staff,0,1,20,20
1715608386738,MMW 12R,A01,514034,Herbst; Matthew,0,2,16,16
1715608386738,MMW 12R,A02,514035,Herbst; Matthew,0,0,16,16
1715608387761,MMW 13R,A01,514037,Staff,0,5,16,16
1715608387761,MMW 13R,A02,514039,Staff,0,5,16,16
1715608387761,MMW 13R,A03,628519,Staff,0,4,16,16
1715608389817,SIO 295LS,A00,523233,Staff,10,0,30,20
1715608390843,SIO 295S,A00,523232,Staff,10,0,30,20
1715608391871,SIOC 290S,A01,637330,Merrifield; Mark A,23,0,30,7
1715608392898,SIOC 291S,A01,637333,Gabriel; Corey John,23,0,30,7
1715608393923,SOCI 117,A01,494376,Staff,0,5,5,5
1715608394949,WES 237B,A00,494380,Staff,10,0,20,10
1715608397025,AESE 279B,A00,494370,Wade; Jon P,0,0,33,33
1715608398054,AIP 97,001,660915,Van Den Einde; Yael Dahlia,9999,0,9999,0
1715608399086,AIP 197,001,627712,Vespa; Emanuel Ignacio,9995,0,9999,4
1715608399086,AIP 197,002,650778,Amir; On,9998,0,9999,1
1715608399086,AIP 197,003,650933,Avenancio-Leon; Carlos,9998,0,9999,1
1715608399086,AIP 197,004,658530,Heyman; Gail D.,9998,0,9999,1
1715608399086,AIP 197,005,658631,Neal; Sonya E,9998,0,9999,1
1715608399086,AIP 197,006,658671,Du; Songzi,9998,0,9999,1
1715608400116,ANAR 135S,A00,494369,Braswell; Geoffrey E.,0,0,0,0
1715608401143,BENG 196,001,628496,Engler; Adam J.,9998,0,9999,1
1715608401143,BENG 196,002,660916,Watson; John Thomas,9999,0,9999,0
1715608402175,BISP 197,001,650773,Wilhelm; James E.,9994,0,9999,5
1715608402175,BISP 197,002,658904,Coleman; Aaron B.,9998,0,9999,1
1715608403204,CAT 124RS,A01,519847,Geibel; William,0,0,20,20
1715608404230,CAT 125RS,A01,515971,Geibel; William,0,0,20,20
1715608405258,CLRE 250,A00,511389,Morris; Sheldon,9992,0,9999,7
1715608406294,CLRE 251,A00,507176,Mehta; Ravindra L.,9992,0,9999,7
1715608406294,CLRE 251,B00,511410,Mehta; Ravindra L.,9998,0,9999,1
1715608407321,CLRE 252,A00,507189,Cuomo; Raphael Eduardo,9994,0,9999,5
1715608408354,CLRE 253,A00,507199,Vaida; Florin,9994,0,9999,5
1715608408354,CLRE 253,B00,507202,Vaida; Florin,9999,0,9999,0
1715608409380,CLRE 259,A00,507211,Patel; Hemal,9996,0,9999,3
1715608410407,CLRE 260,A00,507221,Cuomo; Raphael Eduardo,9999,0,9999,0
1715608411434,CLRE 297,001,507242,Cuomo; Raphael Eduardo,9999,0,9999,0
1715608412462,COGS 197,001,638244,Voytek; Bradley Thomas,9997,0,9999,2
1715608413488,CSE 191,A00,516875,Minnes Kemp; Mor Mia,9991,0,9999,8
1715608414518,CSE 197,001,637388,Minnes Kemp; Mor Mia,9992,0,9999,7
1715608415552,CSS 201S,A01,494383,Mignozzetti; Umberto,35,0,35,0
1715608416578,CSS 202S,A01,494387,Mignozzetti; Umberto,35,0,35,0
1715608417606,DSC 197,001,628532,Eldridge; Justin Matthew,9995,0,9999,4
1715608418631,EAP 100,A00,516065,Staff,9799,0,9999,200
1715608419665,ECE 45,A01,507414,Staff,31,0,60,29
1715608421720,ECE 111,A01,507420,Staff,11,0,50,39
1715608422745,ECE 197,001,548057,Sievenpiper; Daniel F.,9991,0,9999,8
1715608423771,EDS 115,A00,507243,Choi; Bailey Miyeon,7,0,28,21
1715608424801,EDS 117,A01,494379,Staff,0,6,34,34
1715608425828,EDS 125,A00,507246,Hopkins; Megan Beth,8,0,30,22
1715608426858,EDS 128A,A01,507264,Fargason; Sharon Gayle,6,0,26,20
1715608427888,EDS 128B,A01,507293,Pappas; Elizabeth,10,0,30,20
1715608428917,EDS 139,A00,507294,Fargason; Sharon Gayle,10,0,30,20
1715608428917,EDS 139,B00,507313,Pappas; Elizabeth,11,0,30,19
1715608429941,EDS 201,A00,507315,Staff,10,0,30,20
1715608430968,EDS 203,A01,507317,Halter; Christopher P.,10,0,30,20
1715608431997,EDS 204R,A01,507319,Halter; Christopher P.,0,3,30,30
1715608431997,EDS 204R,B01,507331,Heinzman; Erica M.,14,0,30,16
1715608433025,EDS 206R,A00,507332,Staff,0,4,30,30
1715608433025,EDS 206R,B00,507343,Staff,15,0,30,15
1715608434053,EDS 250,A00,507344,Hemans; Patricia Ann Benitez,20,0,40,20
1715608435081,EDS 281,A00,507345,Daly; Alan J.,18,0,18,0
1715608436107,EDS 284,A00,507350,Daly; Alan J.,16,0,16,0
1715608437135,EDS 286,A00,507359,Fine; Sarah,18,0,18,0
1715608438160,EDS 289C,A01,507361,Daly; Alan J.,18,0,18,0
1715608439186,EDS 290,A00,507366,Hofstetter; Carolyn,15,0,15,0
1715608440213,LIGM 5A,A00,507421,Fischer-Grunski; Eva K,17,0,20,3
1715608441254,LIGM 5B,A00,507423,Fischer-Grunski; Eva K,19,0,20,1
1715608442281,LIGM 5C,A00,507425,Fischer-Grunski; Eva K,19,0,20,1
1715608443317,LIIT 5AS,A00,507427,Carnelos; Chiara,20,0,20,0
1715608444346,LIIT 5BS,A00,507430,Carnelos; Chiara,20,0,20,0
1715608445372,LIIT 5CS,A00,507432,Carnelos; Chiara,20,0,20,0
1715608446398,LISP 5A,A00,507541,Munoz Sanchez; Alicia,11,0,20,9
1715608447424,LISP 5B,A00,507671,Munoz Sanchez; Alicia,9,0,20,11
1715608448452,LISP 5C,A00,507696,Munoz Sanchez; Alicia,9,0,20,11
1715608449482,MAE 197,001,528363,Boechler; Nicholas Sebastia,9998,0,9999,1
1715608450513,MATH 197,001,523477,Kedlaya; Kiran S.,9994,0,9999,5
1715608450513,MATH 197,002,563811,Zhang; Danna,9994,0,9999,5
1715608450513,MATH 197,003,628552,Dumitriu; Ioana,9998,0,9999,1
1715608450513,MATH 197,004,660885,Floyd; Eric,9999,0,9999,0
1715608451539,MCWP 40R,A00,518780,Staff,2,0,20,18
1715608451539,MCWP 40R,B00,518781,Staff,11,0,20,9
1715608451539,MCWP 40R,C00,518783,Staff,5,0,20,15
1715608452565,MCWP 50R,A00,518791,Staff,0,1,20,20
1715608452565,MCWP 50R,B00,518792,Staff,0,2,20,20
1715608452565,MCWP 50R,C00,518793,Staff,0,4,20,20
1715608452565,MCWP 50R,D00,518794,Staff,0,1,20,20
1715608452565,MCWP 50R,E00,518795,Staff,0,2,20,20
1715608452565,MCWP 50R,F00,518796,Staff,0,1,20,20
1715608452565,MCWP 50R,G00,518797,Staff,0,1,20,20
1715608453604,MMW 12R,A01,514034,Herbst; Matthew,0,2,16,16
1715608453604,MMW 12R,A02,514035,Herbst; Matthew,0,0,16,16
1715608454630,MMW 13R,A01,514037,Staff,0,5,16,16
1715608454630,MMW 13R,A02,514039,Staff,0,5,16,16
1715608454630,MMW 13R,A03,628519,Staff,0,4,16,16
1715608456681,SIO 295LS,A00,523233,Staff,10,0,30,20
1715608457706,SIO 295S,A00,523232,Staff,10,0,30,20
1715608458734,SIOC 290S,A01,637330,Merrifield; Mark A,23,0,30,7
1715608459770,SIOC 291S,A01,637333,Gabriel; Corey John,23,0,30,7
1715608460797,SOCI 117,A01,494376,Staff,0,5,5,5
1715608461822,WES 237B,A00,494380,Staff,10,0,20,10
1715608463905,AESE 279B,A00,494370,Wade; Jon P,0,0,33,33
1715608464929,AIP 97,001,660915,Van Den Einde; Yael Dahlia,9999,0,9999,0
1715608465957,AIP 197,001,627712,Vespa; Emanuel Ignacio,9995,0,9999,4
1715608465957,AIP 197,002,650778,Amir; On,9998,0,9999,1
1715608465957,AIP 197,003,650933,Avenancio-Leon; Carlos,9998,0,9999,1
1715608465957,AIP 197,004,658530,Heyman; Gail D.,9998,0,9999,1
1715608465957,AIP 197,005,658631,Neal; Sonya E,9998,0,9999,1
1715608465957,AIP 197,006,658671,Du; Songzi,9998,0,9999,1
1715608466983,ANAR 135S,A00,494369,Braswell; Geoffrey E.,0,0,0,0
1715608468010,BENG 196,001,628496,Engler; Adam J.,9998,0,9999,1
1715608468010,BENG 196,002,660916,Watson; John Thomas,9999,0,9999,0
1715608469037,BISP 197,001,650773,Wilhelm; James E.,9994,0,9999,5
1715608469037,BISP 197,002,658904,Coleman; Aaron B.,9998,0,9999,1
1715608470063,CAT 124RS,A01,519847,Geibel; William,0,0,20,20
1715608471089,CAT 125RS,A01,515971,Geibel; William,0,0,20,20
1715608472116,CLRE 250,A00,511389,Morris; Sheldon,9992,0,9999,7
1715608473144,CLRE 251,A00,507176,Mehta; Ravindra L.,9992,0,9999,7
1715608473144,CLRE 251,B00,511410,Mehta; Ravindra L.,9998,0,9999,1
1715608474171,CLRE 252,A00,507189,Cuomo; Raphael Eduardo,9994,0,9999,5
1715608475198,CLRE 253,A00,507199,Vaida; Florin,9994,0,9999,5
1715608475198,CLRE 253,B00,507202,Vaida; Florin,9999,0,9999,0
1715608476224,CLRE 259,A00,507211,Patel; Hemal,9996,0,9999,3
1715608477250,CLRE 260,A00,507221,Cuomo; Raphael Eduardo,9999,0,9999,0
1715608478274,CLRE 297,001,507242,Cuomo; Raphael Eduardo,9999,0,9999,0
1715608479300,COGS 197,001,638244,Voytek; Bradley Thomas,9997,0,9999,2
1715608480326,CSE 191,A00,516875,Minnes Kemp; Mor Mia,9991,0,9999,8
1715608481350,CSE 197,001,637388,Minnes Kemp; Mor Mia,9992,0,9999,7
1715608482382,CSS 201S,A01,494383,Mignozzetti; Umberto,35,0,35,0
1715608483408,CSS 202S,A01,494387,Mignozzetti; Umberto,35,0,35,0
1715608484433,DSC 197,001,628532,Eldridge; Justin Matthew,9995,0,9999,4
1715608485458,EAP 100,A00,516065,Staff,9799,0,9999,200
1715608486486,ECE 45,A01,507414,Staff,31,0,60,29
1715608488535,ECE 111,A01,507420,Staff,11,0,50,39
1715608489561,ECE 197,001,548057,Sievenpiper; Daniel F.,9991,0,9999,8
1715608490587,EDS 115,A00,507243,Choi; Bailey Miyeon,7,0,28,21
1715608491614,EDS 117,A01,494379,Staff,0,6,34,34
1715608492640,EDS 125,A00,507246,Hopkins; Megan Beth,8,0,30,22
1715608493668,EDS 128A,A01,507264,Fargason; Sharon Gayle,6,0,26,20
1715608494695,EDS 128B,A01,507293,Pappas; Elizabeth,10,0,30,20
1715608495722,EDS 139,A00,507294,Fargason; Sharon Gayle,10,0,30,20
1715608495722,EDS 139,B00,507313,Pappas; Elizabeth,11,0,30,19
1715608496750,EDS 201,A00,507315,Staff,10,0,30,20
1715608497776,EDS 203,A01,507317,Halter; Christopher P.,10,0,30,20
1715608498800,EDS 204R,A01,507319,Halter; Christopher P.,0,3,30,30
1715608498800,EDS 204R,B01,507331,Heinzman; Erica M.,14,0,30,16
1715608499826,EDS 206R,A00,507332,Staff,0,4,30,30
1715608499826,EDS 206R,B00,507343,Staff,15,0,30,15
1715608500857,EDS 250,A00,507344,Hemans; Patricia Ann Benitez,20,0,40,20
1715608501886,EDS 281,A00,507345,Daly; Alan J.,18,0,18,0
1715608502913,EDS 284,A00,507350,Daly; Alan J.,16,0,16,0
1715608503942,EDS 286,A00,507359,Fine; Sarah,18,0,18,0
1715608504970,EDS 289C,A01,507361,Daly; Alan J.,18,0,18,0
1715608505998,EDS 290,A00,507366,Hofstetter; Carolyn,15,0,15,0
1715608507025,LIGM 5A,A00,507421,Fischer-Grunski; Eva K,17,0,20,3
1715608508053,LIGM 5B,A00,507423,Fischer-Grunski; Eva K,19,0,20,1
1715608509078,LIGM 5C,A00,507425,Fischer-Grunski; Eva K,19,0,20,1
1715608510108,LIIT 5AS,A00,507427,Carnelos; Chiara,20,0,20,0
1715608511134,LIIT 5BS,A00,507430,Carnelos; Chiara,20,0,20,0
1715608512162,LIIT 5CS,A00,507432,Carnelos; Chiara,20,0,20,0
1715608513196,LISP 5A,A00,507541,Munoz Sanchez; Alicia,11,0,20,9
1715608514223,LISP 5B,A00,507671,Munoz Sanchez; Alicia,9,0,20,11
1715608515251,LISP 5C,A00,507696,Munoz Sanchez; Alicia,9,0,20,11
1715608516278,MAE 197,001,528363,Boechler; Nicholas Sebastia,9998,0,9999,1
1715608517314,MATH 197,001,523477,Kedlaya; Kiran S.,9994,0,9999,5
1715608517314,MATH 197,002,563811,Zhang; Danna,9994,0,9999,5
1715608517314,MATH 197,003,628552,Dumitriu; Ioana,9998,0,9999,1
1715608517314,MATH 197,004,660885,Floyd; Eric,9999,0,9999,0
1715608518344,MCWP 40R,A00,518780,Staff,2,0,20,18
1715608518344,MCWP 40R,B00,518781,Staff,11,0,20,9
1715608518344,MCWP 40R,C00,518783,Staff,5,0,20,15
1715608519376,MCWP 50R,A00,518791,Staff,0,1,20,20
1715608519376,MCWP 50R,B00,518792,Staff,0,2,20,20
1715608519376,MCWP 50R,C00,518793,Staff,0,4,20,20
1715608519376,MCWP 50R,D00,518794,Staff,0,1,20,20
1715608519376,MCWP 50R,E00,518795,Staff,0,2,20,20
1715608519376,MCWP 50R,F00,518796,Staff,0,1,20,20
1715608519376,MCWP 50R,G00,518797,Staff,0,1,20,20
1715608520403,MMW 12R,A01,514034,Herbst; Matthew,0,2,16,16
1715608520403,MMW 12R,A02,514035,Herbst; Matthew,0,0,16,16
1715608521431,MMW 13R,A01,514037,Staff,0,5,16,16
1715608521431,MMW 13R,A02,514039,Staff,0,5,16,16
1715608521431,MMW 13R,A03,628519,Staff,0,4,16,16
1715608523483,SIO 295LS,A00,523233,Staff,10,0,30,20
1715608524511,SIO 295S,A00,523232,Staff,10,0,30,20
1715608525542,SIOC 290S,A01,637330,Merrifield; Mark A,23,0,30,7
1715608526570,SIOC 291S,A01,637333,Gabriel; Corey John,23,0,30,7
1715608527597,SOCI 117,A01,494376,Staff,0,5,5,5
1715608528629,WES 237B,A00,494380,Staff,10,0,20,10
1715608530705,AESE 279B,A00,494370,Wade; Jon P,0,0,33,33
1715608531729,AIP 97,001,660915,Van Den Einde; Yael Dahlia,9999,0,9999,0
1715608532759,AIP 197,001,627712,Vespa; Emanuel Ignacio,9995,0,9999,4
1715608532759,AIP 197,002,650778,Amir; On,9998,0,9999,1
1715608532759,AIP 197,003,650933,Avenancio-Leon; Carlos,9998,0,9999,1
1715608532759,AIP 197,004,658530,Heyman; Gail D.,9998,0,9999,1
1715608532759,AIP 197,005,658631,Neal; Sonya E,9998,0,9999,1
1715608532759,AIP 197,006,658671,Du; Songzi,9998,0,9999,1
1715608533784,ANAR 135S,A00,494369,Braswell; Geoffrey E.,0,0,0,0
1715608534813,BENG 196,001,628496,Engler; Adam J.,9998,0,9999,1
1715608534813,BENG 196,002,660916,Watson; John Thomas,9999,0,9999,0
1715608535842,BISP 197,001,650773,Wilhelm; James E.,9994,0,9999,5
1715608535842,BISP 197,002,658904,Coleman; Aaron B.,9998,0,9999,1
1715608536870,CAT 124RS,A01,519847,Geibel; William,0,0,20,20
1715608537896,CAT 125RS,A01,515971,Geibel; William,0,0,20,20
1715608538921,CLRE 250,A00,511389,Morris; Sheldon,9992,0,9999,7
1715608539954,CLRE 251,A00,507176,Mehta; Ravindra L.,9992,0,9999,7
1715608539954,CLRE 251,B00,511410,Mehta; Ravindra L.,9998,0,9999,1
1715608540982,CLRE 252,A00,507189,Cuomo; Raphael Eduardo,9994,0,9999,5
1715608542012,CLRE 253,A00,507199,Vaida; Florin,9994,0,9999,5
1715608542012,CLRE 253,B00,507202,Vaida; Florin,9999,0,9999,0
1715608543038,CLRE 259,A00,507211,Patel; Hemal,9996,0,9999,3
1715608544065,CLRE 260,A00,507221,Cuomo; Raphael Eduardo,9999,0,9999,0
1715608545091,CLRE 297,001,507242,Cuomo; Raphael Eduardo,9999,0,9999,0
1715608546116,COGS 197,001,638244,Voytek; Bradley Thomas,9997,0,9999,2
1715608547144,CSE 191,A00,516875,Minnes Kemp; Mor Mia,9991,0,9999,8
1715608548169,CSE 197,001,637388,Minnes Kemp; Mor Mia,9992,0,9999,7
1715608549197,CSS 201S,A01,494383,Mignozzetti; Umberto,35,0,35,0
1715608550222,CSS 202S,A01,494387,Mignozzetti; Umberto,35,0,35,0
1715608551246,DSC 197,001,628532,Eldridge; Justin Matthew,9995,0,9999,4
1715608552274,EAP 100,A00,516065,Staff,9799,0,9999,200
1715608553299,ECE 45,A01,507414,Staff,31,0,60,29
1715608555351,ECE 111,A01,507420,Staff,11,0,50,39
1715608556377,ECE 197,001,548057,Sievenpiper; Daniel F.,9991,0,9999,8
1715608557408,EDS 115,A00,507243,Choi; Bailey Miyeon,7,0,28,21
1715608558435,EDS 117,A01,494379,Staff,0,6,34,34
1715608559464,EDS 125,A00,507246,Hopkins; Megan Beth,8,0,30,22
1715608560490,EDS 128A,A01,507264,Fargason; Sharon Gayle,6,0,26,20
1715608561515,EDS 128B,A01,507293,Pappas; Elizabeth,10,0,30,20
1715608562548,EDS 139,A00,507294,Fargason; Sharon Gayle,10,0,30,20
1715608562548,EDS 139,B00,507313,Pappas; Elizabeth,11,0,30,19
1715608563578,EDS 201,A00,507315,Staff,10,0,30,20
1715608564606,EDS 203,A01,507317,Halter; Christopher P.,10,0,30,20
1715608565634,EDS 204R,A01,507319,Halter; Christopher P.,0,3,30,30
1715608565634,EDS 204R,B01,507331,Heinzman; Erica M.,14,0,30,16
1715608566658,EDS 206R,A00,507332,Staff,0,4,30,30
1715608566658,EDS 206R,B00,507343,Staff,15,0,30,15
1715608567687,EDS 250,A00,507344,Hemans; Patricia Ann Benitez,20,0,40,20
1715608568717,EDS 281,A00,507345,Daly; Alan J.,18,0,18,0
1715608569744,EDS 284,A00,507350,Daly; Alan J.,16,0,16,0
1715608570770,EDS 286,A00,507359,Fine; Sarah,18,0,18,0
1715608571797,EDS 289C,A01,507361,Daly; Alan J.,18,0,18,0
1715608572822,EDS 290,A00,507366,Hofstetter; Carolyn,15,0,15,0
1715608573848,LIGM 5A,A00,507421,Fischer-Grunski; Eva K,17,0,20,3
1715608574871,LIGM 5B,A00,507423,Fischer-Grunski; Eva K,19,0,20,1
1715608575902,LIGM 5C,A00,507425,Fischer-Grunski; Eva K,19,0,20,1
1715608576928,LIIT 5AS,A00,507427,Carnelos; Chiara,20,0,20,0
1715608577953,LIIT 5BS,A00,507430,Carnelos; Chiara,20,0,20,0
1715608578982,LIIT 5CS,A00,507432,Carnelos; Chiara,20,0,20,0
1715608580007,LISP 5A,A00,507541,Munoz Sanchez; Alicia,11,0,20,9
1715608581037,LISP 5B,A00,507671,Munoz Sanchez; Alicia,9,0,20,11
1715608582066,LISP 5C,A00,507696,Munoz Sanchez; Alicia,9,0,20,11
1715608583093,MAE 197,001,528363,Boechler; Nicholas Sebastia,9998,0,9999,1
1715608584121,MATH 197,001,523477,Kedlaya; Kiran S.,9994,0,9999,5
1715608584121,MATH 197,002,563811,Zhang; Danna,9994,0,9999,5
1715608584121,MATH 197,003,628552,Dumitriu; Ioana,9998,0,9999,1
1715608584121,MATH 197,004,660885,Floyd; Eric,9999,0,9999,0
1715608585148,MCWP 40R,A00,518780,Staff,2,0,20,18
1715608585148,MCWP 40R,B00,518781,Staff,11,0,20,9
1715608585148,MCWP 40R,C00,518783,Staff,5,0,20,15
1715608586173,MCWP 50R,A00,518791,Staff,0,1,20,20
1715608586173,MCWP 50R,B00,518792,Staff,0,2,20,20
1715608586173,MCWP 50R,C00,518793,Staff,0,4,20,20
1715608586173,MCWP 50R,D00,518794,Staff,0,1,20,20
1715608586173,MCWP 50R,E00,518795,Staff,0,2,20,20
1715608586173,MCWP 50R,F00,518796,Staff,0,1,20,20
1715608586173,MCWP 50R,G00,518797,Staff,0,1,20,20
1715608587200,MMW 12R,A01,514034,Herbst; Matthew,0,2,16,16
1715608587200,MMW 12R,A02,514035,Herbst; Matthew,0,0,16,16
1715608588226,MMW 13R,A01,514037,Staff,0,5,16,16
1715608588226,MMW 13R,A02,514039,Staff,0,5,16,16
1715608588226,MMW 13R,A03,628519,Staff,0,4,16,16
1715608590285,SIO 295LS,A00,523233,Staff,10,0,30,20
1715608591313,SIO 295S,A00,523232,Staff,10,0,30,20
1715608592339,SIOC 290S,A01,637330,Merrifield; Mark A,23,0,30,7
1715608593368,SIOC 291S,A01,637333,Gabriel; Corey John,23,0,30,7
1715608594394,SOCI 117,A01,494376,Staff,0,5,5,5
1715608595421,WES 237B,A00,494380,Staff,10,0,20,10
1715608597491,AESE 279B,A00,494370,Wade; Jon P,0,0,33,33
1715608598520,AIP 97,001,660915,Van Den Einde; Yael Dahlia,9999,0,9999,0
1715608599550,AIP 197,001,627712,Vespa; Emanuel Ignacio,9995,0,9999,4
1715608599550,AIP 197,002,650778,Amir; On,9998,0,9999,1
1715608599550,AIP 197,003,650933,Avenancio-Leon; Carlos,9998,0,9999,1
1715608599550,AIP 197,004,658530,Heyman; Gail D.,9998,0,9999,1
1715608599550,AIP 197,005,658631,Neal; Sonya E,9998,0,9999,1
1715608599550,AIP 197,006,658671,Du; Songzi,9998,0,9999,1
1715608600578,ANAR 135S,A00,494369,Braswell; Geoffrey E.,0,0,0,0
1715608601606,BENG 196,001,628496,Engler; Adam J.,9998,0,9999,1
1715608601606,BENG 196,002,660916,Watson; John Thomas,9999,0,9999,0
1715608602632,BISP 197,001,650773,Wilhelm; James E.,9994,0,9999,5
1715608602632,BISP 197,002,658904,Coleman; Aaron B.,9998,0,9999,1
1715608603657,CAT 124RS,A01,519847,Geibel; William,0,0,20,20
1715608604682,CAT 125RS,A01,515971,Geibel; William,0,0,20,20
1715608605710,CLRE 250,A00,511389,Morris; Sheldon,9992,0,9999,7
1715608606740,CLRE 251,A00,507176,Mehta; Ravindra L.,9992,0,9999,7
1715608606740,CLRE 251,B00,511410,Mehta; Ravindra L.,9998,0,9999,1
1715608607768,CLRE 252,A00,507189,Cuomo; Raphael Eduardo,9994,0,9999,5
1715608608798,CLRE 253,A00,507199,Vaida; Florin,9994,0,9999,5
1715608608798,CLRE 253,B00,507202,Vaida; Florin,9999,0,9999,0
1715608609824,CLRE 259,A00,507211,Patel; Hemal,9996,0,9999,3
1715608610850,CLRE 260,A00,507221,Cuomo; Raphael Eduardo,9999,0,9999,0
1715608611880,CLRE 297,001,507242,Cuomo; Raphael Eduardo,9999,0,9999,0
1715608612906,COGS 197,001,638244,Voytek; Bradley Thomas,9997,0,9999,2
1715608613933,CSE 191,A00,516875,Minnes Kemp; Mor Mia,9991,0,9999,8
1715608614958,CSE 197,001,637388,Minnes Kemp; Mor Mia,9992,0,9999,7
1715608615988,CSS 201S,A01,494383,Mignozzetti; Umberto,35,0,35,0
1715608617016,CSS 202S,A01,494387,Mignozzetti; Umberto,35,0,35,0
1715608618042,DSC 197,001,628532,Eldridge; Justin Matthew,9995,0,9999,4
1715608619068,EAP 100,A00,516065,Staff,9799,0,9999,200
1715608620095,ECE 45,A01,507414,Staff,31,0,60,29
1715608622145,ECE 111,A01,507420,Staff,11,0,50,39
1715608623182,ECE 197,001,548057,Sievenpiper; Daniel F.,9991,0,9999,8
1715608624209,EDS 115,A00,507243,Choi; Bailey Miyeon,7,0,28,21
1715608625238,EDS 117,A01,494379,Staff,0,6,34,34
1715608626263,EDS 125,A00,507246,Hopkins; Megan Beth,8,0,30,22
1715608627290,EDS 128A,A01,507264,Fargason; Sharon Gayle,6,0,26,20
1715608628317,EDS 128B,A01,507293,Pappas; Elizabeth,10,0,30,20
1715608629343,EDS 139,A00,507294,Fargason; Sharon Gayle,10,0,30,20
1715608629343,EDS 139,B00,507313,Pappas; Elizabeth,11,0,30,19
1715608630369,EDS 201,A00,507315,Staff,10,0,30,20
1715608631399,EDS 203,A01,507317,Halter; Christopher P.,10,0,30,20
1715608632426,EDS 204R,A01,507319,Halter; Christopher P.,0,3,30,30
1715608632426,EDS 204R,B01,507331,Heinzman; Erica M.,14,0,30,16
1715608633452,EDS 206R,A00,507332,Staff,0,4,30,30
1715608633452,EDS 206R,B00,507343,Staff,15,0,30,15
1715608634479,EDS 250,A00,507344,Hemans; Patricia Ann Benitez,20,0,40,20
1715608635508,EDS 281,A00,507345,Daly; Alan J.,18,0,18,0
1715608636533,EDS 284,A00,507350,Daly; Alan J.,16,0,16,0
1715608637560,EDS 286,A00,507359,Fine; Sarah,18,0,18,0
1715608638589,EDS 289C,A01,507361,Daly; Alan J.,18,0,18,0
1715608639614,EDS 290,A00,507366,Hofstetter; Carolyn,15,0,15,0
1715608640643,LIGM 5A,A00,507421,Fischer-Grunski; Eva K,17,0,20,3
1715608641669,LIGM 5B,A00,507423,Fischer-Grunski; Eva K,19,0,20,1
1715608642697,LIGM 5C,A00,507425,Fischer-Grunski; Eva K,19,0,20,1
1715608643723,LIIT 5AS,A00,507427,Carnelos; Chiara,20,0,20,0
1715608644751,LIIT 5BS,A00,507430,Carnelos; Chiara,20,0,20,0
1715608645780,LIIT 5CS,A00,507432,Carnelos; Chiara,20,0,20,0
1715608646809,LISP 5A,A00,507541,Munoz Sanchez; Alicia,11,0,20,9
1715608647836,LISP 5B,A00,507671,Munoz Sanchez; Alicia,9,0,20,11
1715608648865,LISP 5C,A00,507696,Munoz Sanchez; Alicia,9,0,20,11
1715608649893,MAE 197,001,528363,Boechler; Nicholas Sebastia,9998,0,9999,1
1715608650924,MATH 197,001,523477,Kedlaya; Kiran S.,9994,0,9999,5
1715608650924,MATH 197,002,563811,Zhang; Danna,9994,0,9999,5
1715608650924,MATH 197,003,628552,Dumitriu; Ioana,9998,0,9999,1
1715608650924,MATH 197,004,660885,Floyd; Eric,9999,0,9999,0
1715608651951,MCWP 40R,A00,518780,Staff,2,0,20,18
1715608651951,MCWP 40R,B00,518781,Staff,11,0,20,9
1715608651951,MCWP 40R,C00,518783,Staff,5,0,20,15
1715608652981,MCWP 50R,A00,518791,Staff,0,1,20,20
1715608652981,MCWP 50R,B00,518792,Staff,0,2,20,20
1715608652981,MCWP 50R,C00,518793,Staff,0,4,20,20
1715608652981,MCWP 50R,D00,518794,Staff,0,1,20,20
1715608652981,MCWP 50R,E00,518795,Staff,0,2,20,20
1715608652981,MCWP 50R,F00,518796,Staff,0,1,20,20
1715608652981,MCWP 50R,G00,518797,Staff,0,1,20,20
1715608654008,MMW 12R,A01,514034,Herbst; Matthew,0,2,16,16
1715608654008,MMW 12R,A02,514035,Herbst; Matthew,0,0,16,16
1715608655034,MMW 13R,A01,514037,Staff,0,5,16,16
1715608655034,MMW 13R,A02,514039,Staff,0,5,16,16
1715608655034,MMW 13R,A03,628519,Staff,0,4,16,16
1715608657088,SIO 295LS,A00,523233,Staff,10,0,30,20
1715608658115,SIO 295S,A00,523232,Staff,10,0,30,20
1715608659144,SIOC 290S,A01,637330,Merrifield; Mark A,23,0,30,7
1715608660174,SIOC 291S,A01,637333,Gabriel; Corey John,23,0,30,7
1715608661201,SOCI 117,A01,494376,Staff,0,5,5,5
1715608662232,WES 237B,A00,494380,Staff,10,0,20,10
1715608664306,AESE 279B,A00,494370,Wade; Jon P,0,0,33,33
1715608665333,AIP 97,001,660915,Van Den Einde; Yael Dahlia,9999,0,9999,0
1715608666361,AIP 197,001,627712,Vespa; Emanuel Ignacio,9995,0,9999,4
1715608666361,AIP 197,002,650778,Amir; On,9998,0,9999,1
1715608666361,AIP 197,003,650933,Avenancio-Leon; Carlos,9998,0,9999,1
1715608666361,AIP 197,004,658530,Heyman; Gail D.,9998,0,9999,1
1715608666361,AIP 197,005,658631,Neal; Sonya E,9998,0,9999,1
1715608666361,AIP 197,006,658671,Du; Songzi,9998,0,9999,1
1715608667386,ANAR 135S,A00,494369,Braswell; Geoffrey E.,0,0,0,0
1715608668410,BENG 196,001,628496,Engler; Adam J.,9998,0,9999,1
1715608668410,BENG 196,002,660916,Watson; John Thomas,9999,0,9999,0
1715608669435,BISP 197,001,650773,Wilhelm; James E.,9994,0,9999,5
1715608669435,BISP 197,002,658904,Coleman; Aaron B.,9998,0,9999,1
1715608670461,CAT 124RS,A01,519847,Geibel; William,0,0,20,20
1715608671501,CAT 125RS,A01,515971,Geibel; William,0,0,20,20
1715608672527,CLRE 250,A00,511389,Morris; Sheldon,9992,0,9999,7
1715608673562,CLRE 251,A00,507176,Mehta; Ravindra L.,9992,0,9999,7
1715608673562,CLRE 251,B00,511410,Mehta; Ravindra L.,9998,0,9999,1
1715608674593,CLRE 252,A00,507189,Cuomo; Raphael Eduardo,9994,0,9999,5
1715608675619,CLRE 253,A00,507199,Vaida; Florin,9994,0,9999,5
1715608675619,CLRE 253,B00,507202,Vaida; Florin,9999,0,9999,0
1715608676646,CLRE 259,A00,507211,Patel; Hemal,9996,0,9999,3
1715608677676,CLRE 260,A00,507221,Cuomo; Raphael Eduardo,9999,0,9999,0
1715608678701,CLRE 297,001,507242,Cuomo; Raphael Eduardo,9999,0,9999,0
1715608679727,COGS 197,001,638244,Voytek; Bradley Thomas,9997,0,9999,2
1715608680753,CSE 191,A00,516875,Minnes Kemp; Mor Mia,9991,0,9999,8
1715608681778,CSE 197,001,637388,Minnes Kemp; Mor Mia,9992,0,9999,7
1715608682808,CSS 201S,A01,494383,Mignozzetti; Umberto,35,0,35,0
1715608683835,CSS 202S,A01,494387,Mignozzetti; Umberto,35,0,35,0
1715608684860,DSC 197,001,628532,Eldridge; Justin Matthew,9995,0,9999,4
1715608685888,EAP 100,A00,516065,Staff,9799,0,9999,200
1715608686920,ECE 45,A01,507414,Staff,31,0,60,29
1715608688973,ECE 111,A01,507420,Staff,11,0,50,39
1715608690001,ECE 197,001,548057,Sievenpiper; Daniel F.,9991,0,9999,8
1715608691027,EDS 115,A00,507243,Choi; Bailey Miyeon,7,0,28,21
1715608692052,EDS 117,A01,494379,Staff,0,6,34,34
1715608693079,EDS 125,A00,507246,Hopkins; Megan Beth,8,0,30,22
1715608694109,EDS 128A,A01,507264,Fargason; Sharon Gayle,6,0,26,20
1715608695136,EDS 128B,A01,507293,Pappas; Elizabeth,10,0,30,20
1715608696161,EDS 139,A00,507294,Fargason; Sharon Gayle,10,0,30,20
1715608696161,EDS 139,B00,507313,Pappas; Elizabeth,11,0,30,19
1715608697187,EDS 201,A00,507315,Staff,10,0,30,20
1715608698213,EDS 203,A01,507317,Halter; Christopher P.,10,0,30,20
1715608699241,EDS 204R,A01,507319,Halter; Christopher P.,0,3,30,30
1715608699241,EDS 204R,B01,507331,Heinzman; Erica M.,14,0,30,16
1715608700264,EDS 206R,A00,507332,Staff,0,4,30,30
1715608700264,EDS 206R,B00,507343,Staff,15,0,30,15
1715608701290,EDS 250,A00,507344,Hemans; Patricia Ann Benitez,20,0,40,20
1715608702316,EDS 281,A00,507345,Daly; Alan J.,18,0,18,0
1715608703343,EDS 284,A00,507350,Daly; Alan J.,16,0,16,0
1715608704372,EDS 286,A00,507359,Fine; Sarah,18,0,18,0
1715608705397,EDS 289C,A01,507361,Daly; Alan J.,18,0,18,0
1715608706422,EDS 290,A00,507366,Hofstetter; Carolyn,15,0,15,0
1715608707451,LIGM 5A,A00,507421,Fischer-Grunski; Eva K,17,0,20,3
1715608708477,LIGM 5B,A00,507423,Fischer-Grunski; Eva K,19,0,20,1
1715608709505,LIGM 5C,A00,507425,Fischer-Grunski; Eva K,19,0,20,1
1715608710531,LIIT 5AS,A00,507427,Carnelos; Chiara,20,0,20,0
1715608711558,LIIT 5BS,A00,507430,Carnelos; Chiara,20,0,20,0
1715608712586,LIIT 5CS,A00,507432,Carnelos; Chiara,20,0,20,0
1715608713610,LISP 5A,A00,507541,Munoz Sanchez; Alicia,11,0,20,9
1715608714636,LISP 5B,A00,507671,Munoz Sanchez; Alicia,9,0,20,11
1715608715660,LISP 5C,A00,507696,Munoz Sanchez; Alicia,9,0,20,11
1715608716686,MAE 197,001,528363,Boechler; Nicholas Sebastia,9998,0,9999,1
1715608717714,MATH 197,001,523477,Kedlaya; Kiran S.,9994,0,9999,5
1715608717714,MATH 197,002,563811,Zhang; Danna,9994,0,9999,5
1715608717714,MATH 197,003,628552,Dumitriu; Ioana,9998,0,9999,1
1715608717714,MATH 197,004,660885,Floyd; Eric,9999,0,9999,0
1715608718740,MCWP 40R,A00,518780,Staff,2,0,20,18
1715608718740,MCWP 40R,B00,518781,Staff,11,0,20,9
1715608718740,MCWP 40R,C00,518783,Staff,5,0,20,15
1715608719767,MCWP 50R,A00,518791,Staff,0,1,20,20
1715608719767,MCWP 50R,B00,518792,Staff,0,2,20,20
1715608719767,MCWP 50R,C00,518793,Staff,0,4,20,20
1715608719767,MCWP 50R,D00,518794,Staff,0,1,20,20
1715608719767,MCWP 50R,E00,518795,Staff,0,2,20,20
1715608719767,MCWP 50R,F00,518796,Staff,0,1,20,20
1715608719767,MCWP 50R,G00,518797,Staff,0,1,20,20
1715608720793,MMW 12R,A01,514034,Herbst; Matthew,0,2,16,16
1715608720793,MMW 12R,A02,514035,Herbst; Matthew,0,0,16,16
1715608721819,MMW 13R,A01,514037,Staff,0,5,16,16
1715608721819,MMW 13R,A02,514039,Staff,0,5,16,16
1715608721819,MMW 13R,A03,628519,Staff,0,4,16,16
1715608723880,SIO 295LS,A00,523233,Staff,10,0,30,20
1715608724907,SIO 295S,A00,523232,Staff,10,0,30,20
1715608725939,SIOC 290S,A01,637330,Merrifield; Mark A,23,0,30,7
1715608727004,SIOC 291S,A01,637333,Gabriel; Corey John,23,0,30,7
1715608728033,SOCI 117,A01,494376,Staff,0,5,5,5
1715608729058,WES 237B,A00,494380,Staff,10,0,20,10
1715608731130,AESE 279B,A00,494370,Wade; Jon P,0,0,33,33
1715608732155,AIP 97,001,660915,Van Den Einde; Yael Dahlia,9999,0,9999,0
1715608733185,AIP 197,001,627712,Vespa; Emanuel Ignacio,9995,0,9999,4
1715608733185,AIP 197,002,650778,Amir; On,9998,0,9999,1
1715608733185,AIP 197,003,650933,Avenancio-Leon; Carlos,9998,0,9999,1
1715608733185,AIP 197,004,658530,Heyman; Gail D.,9998,0,9999,1
1715608733185,AIP 197,005,658631,Neal; Sonya E,9998,0,9999,1
1715608733185,AIP 197,006,658671,Du; Songzi,9998,0,9999,1
1715608734210,ANAR 135S,A00,494369,Braswell; Geoffrey E.,0,0,0,0
1715608735240,BENG 196,001,628496,Engler; Adam J.,9998,0,9999,1
1715608735240,BENG 196,002,660916,Watson; John Thomas,9999,0,9999,0
1715608736269,BISP 197,001,650773,Wilhelm; James E.,9994,0,9999,5
1715608736269,BISP 197,002,658904,Coleman; Aaron B.,9998,0,9999,1
1715608737301,CAT 124RS,A01,519847,Geibel; William,0,0,20,20
1715608738326,CAT 125RS,A01,515971,Geibel; William,0,0,20,20
1715608739355,CLRE 250,A00,511389,Morris; Sheldon,9992,0,9999,7
1715608740382,CLRE 251,A00,507176,Mehta; Ravindra L.,9992,0,9999,7
1715608740382,CLRE 251,B00,511410,Mehta; Ravindra L.,9998,0,9999,1
1715608741409,CLRE 252,A00,507189,Cuomo; Raphael Eduardo,9994,0,9999,5
1715608742436,CLRE 253,A00,507199,Vaida; Florin,9994,0,9999,5
1715608742436,CLRE 253,B00,507202,Vaida; Florin,9999,0,9999,0
1715608743465,CLRE 259,A00,507211,Patel; Hemal,9996,0,9999,3
1715608744490,CLRE 260,A00,507221,Cuomo; Raphael Eduardo,9999,0,9999,0
1715608745518,CLRE 297,001,507242,Cuomo; Raphael Eduardo,9999,0,9999,0
1715608746545,COGS 197,001,638244,Voytek; Bradley Thomas,9997,0,9999,2
1715608747572,CSE 191,A00,516875,Minnes Kemp; Mor Mia,9991,0,9999,8
1715608748599,CSE 197,001,637388,Minnes Kemp; Mor Mia,9992,0,9999,7
1715608749626,CSS 201S,A01,494383,Mignozzetti; Umberto,35,0,35,0
1715608750651,CSS 202S,A01,494387,Mignozzetti; Umberto,35,0,35,0
1715608751683,DSC 197,001,628532,Eldridge; Justin Matthew,9995,0,9999,4
1715608752709,EAP 100,A00,516065,Staff,9799,0,9999,200
1715608753734,ECE 45,A01,507414,Staff,31,0,60,29
1715608755788,ECE 111,A01,507420,Staff,11,0,50,39
1715608756813,ECE 197,001,548057,Sievenpiper; Daniel F.,9991,0,9999,8
1715608757842,EDS 115,A00,507243,Choi; Bailey Miyeon,7,0,28,21
1715608758869,EDS 117,A01,494379,Staff,0,6,34,34
1715608759893,EDS 125,A00,507246,Hopkins; Megan Beth,8,0,30,22
1715608760922,EDS 128A,A01,507264,Fargason; Sharon Gayle,6,0,26,20
1715608761951,EDS 128B,A01,507293,Pappas; Elizabeth,10,0,30,20
1715608762979,EDS 139,A00,507294,Fargason; Sharon Gayle,10,0,30,20
1715608762979,EDS 139,B00,507313,Pappas; Elizabeth,11,0,30,19
1715608764005,EDS 201,A00,507315,Staff,10,0,30,20
1715608765034,EDS 203,A01,507317,Halter; Christopher P.,10,0,30,20
1715608766060,EDS 204R,A01,507319,Halter; Christopher P.,0,3,30,30
1715608766060,EDS 204R,B01,507331,Heinzman; Erica M.,14,0,30,16
1715608767085,EDS 206R,A00,507332,Staff,0,4,30,30
1715608767085,EDS 206R,B00,507343,Staff,15,0,30,15
1715608768115,EDS 250,A00,507344,Hemans; Patricia Ann Benitez,20,0,40,20
1715608769140,EDS 281,A00,507345,Daly; Alan J.,18,0,18,0
1715608770168,EDS 284,A00,507350,Daly; Alan J.,16,0,16,0
1715608771195,EDS 286,A00,507359,Fine; Sarah,18,0,18,0
1715608772220,EDS 289C,A01,507361,Daly; Alan J.,18,0,18,0
1715608773246,EDS 290,A00,507366,Hofstetter; Carolyn,15,0,15,0
1715608774273,LIGM 5A,A00,507421,Fischer-Grunski; Eva K,17,0,20,3
1715608775302,LIGM 5B,A00,507423,Fischer-Grunski; Eva K,19,0,20,1
1715608776325,LIGM 5C,A00,507425,Fischer-Grunski; Eva K,19,0,20,1
1715608777353,LIIT 5AS,A00,507427,Carnelos; Chiara,20,0,20,0
1715608778385,LIIT 5BS,A00,507430,Carnelos; Chiara,20,0,20,0
1715608779410,LIIT 5CS,A00,507432,Carnelos; Chiara,20,0,20,0
1715608780434,LISP 5A,A00,507541,Munoz Sanchez; Alicia,11,0,20,9
1715608781459,LISP 5B,A00,507671,Munoz Sanchez; Alicia,9,0,20,11
1715608782485,LISP 5C,A00,507696,Munoz Sanchez; Alicia,9,0,20,11
1715608783512,MAE 197,001,528363,Boechler; Nicholas Sebastia,9998,0,9999,1
1715608784543,MATH 197,001,523477,Kedlaya; Kiran S.,9994,0,9999,5
1715608784543,MATH 197,002,563811,Zhang; Danna,9994,0,9999,5
1715608784543,MATH 197,003,628552,Dumitriu; Ioana,9998,0,9999,1
1715608784543,MATH 197,004,660885,Floyd; Eric,9999,0,9999,0
1715608785569,MCWP 40R,A00,518780,Staff,2,0,20,18
1715608785569,MCWP 40R,B00,518781,Staff,11,0,20,9
1715608785569,MCWP 40R,C00,518783,Staff,5,0,20,15
1715608786596,MCWP 50R,A00,518791,Staff,0,1,20,20
1715608786596,MCWP 50R,B00,518792,Staff,0,2,20,20
1715608786596,MCWP 50R,C00,518793,Staff,0,4,20,20
1715608786596,MCWP 50R,D00,518794,Staff,0,1,20,20
1715608786596,MCWP 50R,E00,518795,Staff,0,2,20,20
1715608786596,MCWP 50R,F00,518796,Staff,0,1,20,20
1715608786596,MCWP 50R,G00,518797,Staff,0,1,20,20
1715608787622,MMW 12R,A01,514034,Herbst; Matthew,0,2,16,16
1715608787622,MMW 12R,A02,514035,Herbst; Matthew,0,0,16,16
1715608788647,MMW 13R,A01,514037,Staff,0,5,16,16
1715608788647,MMW 13R,A02,514039,Staff,0,5,16,16
1715608788647,MMW 13R,A03,628519,Staff,0,4,16,16
1715608790699,SIO 295LS,A00,523233,Staff,10,0,30,20
1715608791726,SIO 295S,A00,523232,Staff,10,0,30,20
1715608792757,SIOC 290S,A01,637330,Merrifield; Mark A,23,0,30,7
1715608793787,SIOC 291S,A01,637333,Gabriel; Corey John,23,0,30,7
1715608794815,SOCI 117,A01,494376,Staff,0,5,5,5
1715608795841,WES 237B,A00,494380,Staff,10,0,20,10
1715608797913,AESE 279B,A00,494370,Wade; Jon P,0,0,33,33
1715608798942,AIP 97,001,660915,Van Den Einde; Yael Dahlia,9999,0,9999,0
1715608799972,AIP 197,001,627712,Vespa; Emanuel Ignacio,9995,0,9999,4
1715608799972,AIP 197,002,650778,Amir; On,9998,0,9999,1
1715608799972,AIP 197,003,650933,Avenancio-Leon; Carlos,9998,0,9999,1
1715608799972,AIP 197,004,658530,Heyman; Gail D.,9998,0,9999,1
1715608799972,AIP 197,005,658631,Neal; Sonya E,9998,0,9999,1
1715608799972,AIP 197,006,658671,Du; Songzi,9998,0,9999,1
1715608800998,ANAR 135S,A00,494369,Braswell; Geoffrey E.,0,0,0,0
1715608802027,BENG 196,001,628496,Engler; Adam J.,9998,0,9999,1
1715608802027,BENG 196,002,660916,Watson; John Thomas,9999,0,9999,0
1715608803057,BISP 197,001,650773,Wilhelm; James E.,9994,0,9999,5
1715608803057,BISP 197,002,658904,Coleman; Aaron B.,9998,0,9999,1
1715608804084,CAT 124RS,A01,519847,Geibel; William,0,0,20,20
1715608805110,CAT 125RS,A01,515971,Geibel; William,0,0,20,20
1715608806136,CLRE 250,A00,511389,Morris; Sheldon,9992,0,9999,7
1715608807166,CLRE 251,A00,507176,Mehta; Ravindra L.,9992,0,9999,7
1715608807166,CLRE 251,B00,511410,Mehta; Ravindra L.,9998,0,9999,1
1715608808190,CLRE 252,A00,507189,Cuomo; Raphael Eduardo,9994,0,9999,5
1715608809216,CLRE 253,A00,507199,Vaida; Florin,9994,0,9999,5
1715608809216,CLRE 253,B00,507202,Vaida; Florin,9999,0,9999,0
1715608810242,CLRE 259,A00,507211,Patel; Hemal,9996,0,9999,3
1715608811267,CLRE 260,A00,507221,Cuomo; Raphael Eduardo,9999,0,9999,0
1715608812292,CLRE 297,001,507242,Cuomo; Raphael Eduardo,9999,0,9999,0
1715608813317,COGS 197,001,638244,Voytek; Bradley Thomas,9997,0,9999,2
1715608814346,CSE 191,A00,516875,Minnes Kemp; Mor Mia,9991,0,9999,8
1715608815374,CSE 197,001,637388,Minnes Kemp; Mor Mia,9992,0,9999,7
1715608816408,CSS 201S,A01,494383,Mignozzetti; Umberto,35,0,35,0
1715608817435,CSS 202S,A01,494387,Mignozzetti; Umberto,35,0,35,0
1715608818460,DSC 197,001,628532,Eldridge; Justin Matthew,9995,0,9999,4
1715608819485,EAP 100,A00,516065,Staff,9799,0,9999,200
1715608820514,ECE 45,A01,507414,Staff,31,0,60,29
1715608822570,ECE 111,A01,507420,Staff,11,0,50,39
1715608823596,ECE 197,001,548057,Sievenpiper; Daniel F.,9991,0,9999,8
1715608824623,EDS 115,A00,507243,Choi; Bailey Miyeon,7,0,28,21
1715608825650,EDS 117,A01,494379,Staff,0,6,34,34
1715608826680,EDS 125,A00,507246,Hopkins; Megan Beth,8,0,30,22
1715608827708,EDS 128A,A01,507264,Fargason; Sharon Gayle,6,0,26,20
1715608828734,EDS 128B,A01,507293,Pappas; Elizabeth,10,0,30,20
1715608829764,EDS 139,A00,507294,Fargason; Sharon Gayle,10,0,30,20
1715608829764,EDS 139,B00,507313,Pappas; Elizabeth,11,0,30,19
1715608830789,EDS 201,A00,507315,Staff,10,0,30,20
1715608831816,EDS 203,A01,507317,Halter; Christopher P.,10,0,30,20
1715608832846,EDS 204R,A01,507319,Halter; Christopher P.,0,3,30,30
1715608832846,EDS 204R,B01,507331,Heinzman; Erica M.,14,0,30,16
1715608833883,EDS 206R,A00,507332,Staff,0,4,30,30
1715608833883,EDS 206R,B00,507343,Staff,15,0,30,15
1715608834911,EDS 250,A00,507344,Hemans; Patricia Ann Benitez,20,0,40,20
1715608835939,EDS 281,A00,507345,Daly; Alan J.,18,0,18,0
1715608836966,EDS 284,A00,507350,Daly; Alan J.,16,0,16,0
1715608837995,EDS 286,A00,507359,Fine; Sarah,18,0,18,0
1715608839021,EDS 289C,A01,507361,Daly; Alan J.,18,0,18,0
1715608840046,EDS 290,A00,507366,Hofstetter; Carolyn,15,0,15,0
1715608841074,LIGM 5A,A00,507421,Fischer-Grunski; Eva K,17,0,20,3
1715608842103,LIGM 5B,A00,507423,Fischer-Grunski; Eva K,19,0,20,1
1715608843133,LIGM 5C,A00,507425,Fischer-Grunski; Eva K,19,0,20,1
1715608844161,LIIT 5AS,A00,507427,Carnelos; Chiara,20,0,20,0
1715608845189,LIIT 5BS,A00,507430,Carnelos; Chiara,20,0,20,0
1715608846213,LIIT 5CS,A00,507432,Carnelos; Chiara,20,0,20,0
1715608847240,LISP 5A,A00,507541,Munoz Sanchez; Alicia,11,0,20,9
1715608848272,LISP 5B,A00,507671,Munoz Sanchez; Alicia,9,0,20,11
1715608849298,LISP 5C,A00,507696,Munoz Sanchez; Alicia,9,0,20,11
1715608850325,MAE 197,001,528363,Boechler; Nicholas Sebastia,9998,0,9999,1
1715608851360,MATH 197,001,523477,Kedlaya; Kiran S.,9994,0,9999,5
1715608851360,MATH 197,002,563811,Zhang; Danna,9994,0,9999,5
1715608851360,MATH 197,003,628552,Dumitriu; Ioana,9998,0,9999,1
1715608851360,MATH 197,004,660885,Floyd; Eric,9999,0,9999,0
1715608852386,MCWP 40R,A00,518780,Staff,2,0,20,18
1715608852386,MCWP 40R,B00,518781,Staff,11,0,20,9
1715608852386,MCWP 40R,C00,518783,Staff,5,0,20,15
1715608853417,MCWP 50R,A00,518791,Staff,0,1,20,20
1715608853417,MCWP 50R,B00,518792,Staff,0,2,20,20
1715608853417,MCWP 50R,C00,518793,Staff,0,4,20,20
1715608853417,MCWP 50R,D00,518794,Staff,0,1,20,20
1715608853417,MCWP 50R,E00,518795,Staff,0,2,20,20
1715608853417,MCWP 50R,F00,518796,Staff,0,1,20,20
1715608853417,MCWP 50R,G00,518797,Staff,0,1,20,20
1715608854448,MMW 12R,A01,514034,Herbst; Matthew,0,2,16,16
1715608854448,MMW 12R,A02,514035,Herbst; Matthew,0,0,16,16
1715608855478,MMW 13R,A01,514037,Staff,0,5,16,16
1715608855478,MMW 13R,A02,514039,Staff,0,5,16,16
1715608855478,MMW 13R,A03,628519,Staff,0,4,16,16
1715608857537,SIO 295LS,A00,523233,Staff,10,0,30,20
1715608858564,SIO 295S,A00,523232,Staff,10,0,30,20
1715608859594,SIOC 290S,A01,637330,Merrifield; Mark A,23,0,30,7
1715608860628,SIOC 291S,A01,637333,Gabriel; Corey John,23,0,30,7
1715608861659,SOCI 117,A01,494376,Staff,0,5,5,5
1715608862686,WES 237B,A00,494380,Staff,10,0,20,10
1715608864757,AESE 279B,A00,494370,Wade; Jon P,0,0,33,33
1715608865787,AIP 97,001,660915,Van Den Einde; Yael Dahlia,9999,0,9999,0
1715608866831,AIP 197,001,627712,Vespa; Emanuel Ignacio,9995,0,9999,4
1715608866831,AIP 197,002,650778,Amir; On,9998,0,9999,1
1715608866831,AIP 197,003,650933,Avenancio-Leon; Carlos,9998,0,9999,1
1715608866831,AIP 197,004,658530,Heyman; Gail D.,9998,0,9999,1
1715608866831,AIP 197,005,658631,Neal; Sonya E,9998,0,9999,1
1715608866831,AIP 197,006,658671,Du; Songzi,9998,0,9999,1
1715608867858,ANAR 135S,A00,494369,Braswell; Geoffrey E.,0,0,0,0
1715608868888,BENG 196,001,628496,Engler; Adam J.,9998,0,9999,1
1715608868888,BENG 196,002,660916,Watson; John Thomas,9999,0,9999,0
1715608869914,BISP 197,001,650773,Wilhelm; James E.,9994,0,9999,5
1715608869914,BISP 197,002,658904,Coleman; Aaron B.,9998,0,9999,1
1715608870940,CAT 124RS,A01,519847,Geibel; William,0,0,20,20
1715608871966,CAT 125RS,A01,515971,Geibel; William,0,0,20,20
1715608872993,CLRE 250,A00,511389,Morris; Sheldon,9992,0,9999,7
1715608874022,CLRE 251,A00,507176,Mehta; Ravindra L.,9992,0,9999,7
1715608874022,CLRE 251,B00,511410,Mehta; Ravindra L.,9998,0,9999,1
1715608875049,CLRE 252,A00,507189,Cuomo; Raphael Eduardo,9994,0,9999,5
1715608876076,CLRE 253,A00,507199,Vaida; Florin,9994,0,9999,5
1715608876076,CLRE 253,B00,507202,Vaida; Florin,9999,0,9999,0
1715608877102,CLRE 259,A00,507211,Patel; Hemal,9996,0,9999,3
1715608878132,CLRE 260,A00,507221,Cuomo; Raphael Eduardo,9999,0,9999,0
1715608879161,CLRE 297,001,507242,Cuomo; Raphael Eduardo,9999,0,9999,0
1715608880192,COGS 197,001,638244,Voytek; Bradley Thomas,9997,0,9999,2
1715608881218,CSE 191,A00,516875,Minnes Kemp; Mor Mia,9991,0,9999,8
1715608882244,CSE 197,001,637388,Minnes Kemp; Mor Mia,9992,0,9999,7
1715608883273,CSS 201S,A01,494383,Mignozzetti; Umberto,35,0,35,0
1715608884300,CSS 202S,A01,494387,Mignozzetti; Umberto,35,0,35,0
1715608885329,DSC 197,001,628532,Eldridge; Justin Matthew,9995,0,9999,4
1715608886354,EAP 100,A00,516065,Staff,9799,0,9999,200
1715608887392,ECE 45,A01,507414,Staff,31,0,60,29
1715608889445,ECE 111,A01,507420,Staff,11,0,50,39
1715608890480,ECE 197,001,548057,Sievenpiper; Daniel F.,9991,0,9999,8
1715608891511,EDS 115,A00,507243,Choi; Bailey Miyeon,7,0,28,21
1715608892544,EDS 117,A01,494379,Staff,0,6,34,34
1715608893572,EDS 125,A00,507246,Hopkins; Megan Beth,8,0,30,22
1715608894600,EDS 128A,A01,507264,Fargason; Sharon Gayle,6,0,26,20
1715608895628,EDS 128B,A01,507293,Pappas; Elizabeth,10,0,30,20
1715608896657,EDS 139,A00,507294,Fargason; Sharon Gayle,10,0,30,20
1715608896657,EDS 139,B00,507313,Pappas; Elizabeth,11,0,30,19
1715608897682,EDS 201,A00,507315,Staff,10,0,30,20
1715608898802,EDS 203,A01,507317,Halter; Christopher P.,10,0,30,20
1715608899832,EDS 204R,A01,507319,Halter; Christopher P.,0,3,30,30
1715608899832,EDS 204R,B01,507331,Heinzman; Erica M.,14,0,30,16
1715608900861,EDS 206R,A00,507332,Staff,0,4,30,30
1715608900861,EDS 206R,B00,507343,Staff,15,0,30,15
1715608901893,EDS 250,A00,507344,Hemans; Patricia Ann Benitez,20,0,40,20
1715608902921,EDS 281,A00,507345,Daly; Alan J.,18,0,18,0
1715608903947,EDS 284,A00,507350,Daly; Alan J.,16,0,16,0
1715608904977,EDS 286,A00,507359,Fine; Sarah,18,0,18,0
1715608906005,EDS 289C,A01,507361,Daly; Alan J.,18,0,18,0
1715608907030,EDS 290,A00,507366,Hofstetter; Carolyn,15,0,15,0
1715608908060,LIGM 5A,A00,507421,Fischer-Grunski; Eva K,17,0,20,3
1715608909086,LIGM 5B,A00,507423,Fischer-Grunski; Eva K,19,0,20,1
1715608910119,LIGM 5C,A00,507425,Fischer-Grunski; Eva K,19,0,20,1
1715608911152,LIIT 5AS,A00,507427,Carnelos; Chiara,20,0,20,0
1715608912179,LIIT 5BS,A00,507430,Carnelos; Chiara,20,0,20,0
1715608913210,LIIT 5CS,A00,507432,Carnelos; Chiara,20,0,20,0
1715608914238,LISP 5A,A00,507541,Munoz Sanchez; Alicia,11,0,20,9
1715608915263,LISP 5B,A00,507671,Munoz Sanchez; Alicia,9,0,20,11
1715608916289,LISP 5C,A00,507696,Munoz Sanchez; Alicia,9,0,20,11
1715608917315,MAE 197,001,528363,Boechler; Nicholas Sebastia,9998,0,9999,1
1715608918354,MATH 197,001,523477,Kedlaya; Kiran S.,9994,0,9999,5
1715608918354,MATH 197,002,563811,Zhang; Danna,9994,0,9999,5
1715608918354,MATH 197,003,628552,Dumitriu; Ioana,9998,0,9999,1
1715608918354,MATH 197,004,660885,Floyd; Eric,9999,0,9999,0
1715608919381,MCWP 40R,A00,518780,Staff,2,0,20,18
1715608919381,MCWP 40R,B00,518781,Staff,11,0,20,9
1715608919381,MCWP 40R,C00,518783,Staff,5,0,20,15
1715608920413,MCWP 50R,A00,518791,Staff,0,1,20,20
1715608920413,MCWP 50R,B00,518792,Staff,0,2,20,20
1715608920413,MCWP 50R,C00,518793,Staff,0,4,20,20
1715608920413,MCWP 50R,D00,518794,Staff,0,1,20,20
1715608920413,MCWP 50R,E00,518795,Staff,0,2,20,20
1715608920413,MCWP 50R,F00,518796,Staff,0,1,20,20
1715608920413,MCWP 50R,G00,518797,Staff,0,1,20,20
1715608921438,MMW 12R,A01,514034,Herbst; Matthew,0,2,16,16
1715608921438,MMW 12R,A02,514035,Herbst; Matthew,0,0,16,16
1715608922469,MMW 13R,A01,514037,Staff,0,5,16,16
1715608922469,MMW 13R,A02,514039,Staff,0,5,16,16
1715608922469,MMW 13R,A03,628519,Staff,0,4,16,16
1715608924525,SIO 295LS,A00,523233,Staff,10,0,30,20
1715608925552,SIO 295S,A00,523232,Staff,10,0,30,20
1715608926586,SIOC 290S,A01,637330,Merrifield; Mark A,23,0,30,7
1715608927619,SIOC 291S,A01,637333,Gabriel; Corey John,23,0,30,7
1715608928649,SOCI 117,A01,494376,Staff,0,5,5,5
1715608929676,WES 237B,A00,494380,Staff,10,0,20,10
1715608931764,AESE 279B,A00,494370,Wade; Jon P,0,0,33,33
1715608932790,AIP 97,001,660915,Van Den Einde; Yael Dahlia,9999,0,9999,0
1715608933825,AIP 197,001,627712,Vespa; Emanuel Ignacio,9995,0,9999,4
1715608933825,AIP 197,002,650778,Amir; On,9998,0,9999,1
1715608933825,AIP 197,003,650933,Avenancio-Leon; Carlos,9998,0,9999,1
1715608933825,AIP 197,004,658530,Heyman; Gail D.,9998,0,9999,1
1715608933825,AIP 197,005,658631,Neal; Sonya E,9998,0,9999,1
1715608933825,AIP 197,006,658671,Du; Songzi,9998,0,9999,1
1715608934856,ANAR 135S,A00,494369,Braswell; Geoffrey E.,0,0,0,0
1715608935890,BENG 196,001,628496,Engler; Adam J.,9998,0,9999,1
1715608935890,BENG 196,002,660916,Watson; John Thomas,9999,0,9999,0
1715608936916,BISP 197,001,650773,Wilhelm; James E.,9994,0,9999,5
1715608936916,BISP 197,002,658904,Coleman; Aaron B.,9998,0,9999,1
1715608937942,CAT 124RS,A01,519847,Geibel; William,0,0,20,20
1715608938969,CAT 125RS,A01,515971,Geibel; William,0,0,20,20
1715608940000,CLRE 250,A00,511389,Morris; Sheldon,9992,0,9999,7
1715608941028,CLRE 251,A00,507176,Mehta; Ravindra L.,9992,0,9999,7
1715608941028,CLRE 251,B00,511410,Mehta; Ravindra L.,9998,0,9999,1
1715608942060,CLRE 252,A00,507189,Cuomo; Raphael Eduardo,9994,0,9999,5
1715608943089,CLRE 253,A00,507199,Vaida; Florin,9994,0,9999,5
1715608943089,CLRE 253,B00,507202,Vaida; Florin,9999,0,9999,0
1715608944114,CLRE 259,A00,507211,Patel; Hemal,9996,0,9999,3
1715608945143,CLRE 260,A00,507221,Cuomo; Raphael Eduardo,9999,0,9999,0
1715608946169,CLRE 297,001,507242,Cuomo; Raphael Eduardo,9999,0,9999,0
1715608947195,COGS 197,001,638244,Voytek; Bradley Thomas,9997,0,9999,2
1715608948220,CSE 191,A00,516875,Minnes Kemp; Mor Mia,9991,0,9999,8
1715608949248,CSE 197,001,637388,Minnes Kemp; Mor Mia,9992,0,9999,7
1715608950285,CSS 201S,A01,494383,Mignozzetti; Umberto,35,0,35,0
1715608951314,CSS 202S,A01,494387,Mignozzetti; Umberto,35,0,35,0
1715608952343,DSC 197,001,628532,Eldridge; Justin Matthew,9995,0,9999,4
1715608953371,EAP 100,A00,516065,Staff,9799,0,9999,200
1715608954403,ECE 45,A01,507414,Staff,31,0,60,29
1715608956456,ECE 111,A01,507420,Staff,11,0,50,39
1715608957487,ECE 197,001,548057,Sievenpiper; Daniel F.,9991,0,9999,8
1715608958519,EDS 115,A00,507243,Choi; Bailey Miyeon,7,0,28,21
1715608959548,EDS 117,A01,494379,Staff,0,6,34,34
1715608960573,EDS 125,A00,507246,Hopkins; Megan Beth,8,0,30,22
1715608961603,EDS 128A,A01,507264,Fargason; Sharon Gayle,6,0,26,20
1715608962629,EDS 128B,A01,507293,Pappas; Elizabeth,10,0,30,20
1715608963657,EDS 139,A00,507294,Fargason; Sharon Gayle,10,0,30,20
1715608963657,EDS 139,B00,507313,Pappas; Elizabeth,11,0,30,19
1715608964682,EDS 201,A00,507315,Staff,10,0,30,20
1715608965708,EDS 203,A01,507317,Halter; Christopher P.,10,0,30,20
1715608966735,EDS 204R,A01,507319,Halter; Christopher P.,0,3,30,30
1715608966735,EDS 204R,B01,507331,Heinzman; Erica M.,14,0,30,16
1715608967764,EDS 206R,A00,507332,Staff,0,4,30,30
1715608967764,EDS 206R,B00,507343,Staff,15,0,30,15
1715608968792,EDS 250,A00,507344,Hemans; Patricia Ann Benitez,20,0,40,20
1715608969816,EDS 281,A00,507345,Daly; Alan J.,18,0,18,0
1715608970842,EDS 284,A00,507350,Daly; Alan J.,16,0,16,0
1715608971871,EDS 286,A00,507359,Fine; Sarah,18,0,18,0
1715608972898,EDS 289C,A01,507361,Daly; Alan J.,18,0,18,0
1715608973925,EDS 290,A00,507366,Hofstetter; Carolyn,15,0,15,0
1715608974957,LIGM 5A,A00,507421,Fischer-Grunski; Eva K,17,0,20,3
1715608975983,LIGM 5B,A00,507423,Fischer-Grunski; Eva K,19,0,20,1
1715608977010,LIGM 5C,A00,507425,Fischer-Grunski; Eva K,19,0,20,1
1715608978042,LIIT 5AS,A00,507427,Carnelos; Chiara,20,0,20,0
1715608979069,LIIT 5BS,A00,507430,Carnelos; Chiara,20,0,20,0
1715608980097,LIIT 5CS,A00,507432,Carnelos; Chiara,20,0,20,0
1715608981128,LISP 5A,A00,507541,Munoz Sanchez; Alicia,11,0,20,9
1715608982156,LISP 5B,A00,507671,Munoz Sanchez; Alicia,9,0,20,11
1715608983184,LISP 5C,A00,507696,Munoz Sanchez; Alicia,9,0,20,11
1715608984212,MAE 197,001,528363,Boechler; Nicholas Sebastia,9998,0,9999,1
1715608985240,MATH 197,001,523477,Kedlaya; Kiran S.,9994,0,9999,5
1715608985240,MATH 197,002,563811,Zhang; Danna,9994,0,9999,5
1715608985240,MATH 197,003,628552,Dumitriu; Ioana,9998,0,9999,1
1715608985240,MATH 197,004,660885,Floyd; Eric,9999,0,9999,0
1715608986272,MCWP 40R,A00,518780,Staff,2,0,20,18
1715608986272,MCWP 40R,B00,518781,Staff,11,0,20,9
1715608986272,MCWP 40R,C00,518783,Staff,5,0,20,15
1715608987297,MCWP 50R,A00,518791,Staff,0,1,20,20
1715608987297,MCWP 50R,B00,518792,Staff,0,2,20,20
1715608987297,MCWP 50R,C00,518793,Staff,0,4,20,20
1715608987297,MCWP 50R,D00,518794,Staff,0,1,20,20
1715608987297,MCWP 50R,E00,518795,Staff,0,2,20,20
1715608987297,MCWP 50R,F00,518796,Staff,0,1,20,20
1715608987297,MCWP 50R,G00,518797,Staff,0,1,20,20
1715608988328,MMW 12R,A01,514034,Herbst; Matthew,0,2,16,16
1715608988328,MMW 12R,A02,514035,Herbst; Matthew,0,0,16,16
1715608989354,MMW 13R,A01,514037,Staff,0,5,16,16
1715608989354,MMW 13R,A02,514039,Staff,0,5,16,16
1715608989354,MMW 13R,A03,628519,Staff,0,4,16,16
1715608991409,SIO 295LS,A00,523233,Staff,10,0,30,20
1715608992438,SIO 295S,A00,523232,Staff,10,0,30,20
1715608993472,SIOC 290S,A01,637330,Merrifield; Mark A,23,0,30,7
1715608994500,SIOC 291S,A01,637333,Gabriel; Corey John,23,0,30,7
1715608995527,SOCI 117,A01,494376,Staff,0,5,5,5
1715608996556,WES 237B,A00,494380,Staff,10,0,20,10
1715608998640,AESE 279B,A00,494370,Wade; Jon P,0,0,33,33
1715608999669,AIP 97,001,660915,Van Den Einde; Yael Dahlia,9999,0,9999,0
1715609000700,AIP 197,001,627712,Vespa; Emanuel Ignacio,9995,0,9999,4
1715609000700,AIP 197,002,650778,Amir; On,9998,0,9999,1
1715609000700,AIP 197,003,650933,Avenancio-Leon; Carlos,9998,0,9999,1
1715609000700,AIP 197,004,658530,Heyman; Gail D.,9998,0,9999,1
1715609000700,AIP 197,005,658631,Neal; Sonya E,9998,0,9999,1
1715609000700,AIP 197,006,658671,Du; Songzi,9998,0,9999,1
1715609001729,ANAR 135S,A00,494369,Braswell; Geoffrey E.,0,0,0,0
1715609002757,BENG 196,001,628496,Engler; Adam J.,9998,0,9999,1
1715609002757,BENG 196,002,660916,Watson; John Thomas,9999,0,9999,0
1715609003789,BISP 197,001,650773,Wilhelm; James E.,9994,0,9999,5
1715609003789,BISP 197,002,658904,Coleman; Aaron B.,9998,0,9999,1
1715609004816,CAT 124RS,A01,519847,Geibel; William,0,0,20,20
1715609005842,CAT 125RS,A01,515971,Geibel; William,0,0,20,20
1715609006868,CLRE 250,A00,511389,Morris; Sheldon,9992,0,9999,7
1715609007902,CLRE 251,A00,507176,Mehta; Ravindra L.,9992,0,9999,7
1715609007902,CLRE 251,B00,511410,Mehta; Ravindra L.,9998,0,9999,1
1715609008928,CLRE 252,A00,507189,Cuomo; Raphael Eduardo,9994,0,9999,5
1715609009953,CLRE 253,A00,507199,Vaida; Florin,9994,0,9999,5
1715609009953,CLRE 253,B00,507202,Vaida; Florin,9999,0,9999,0
1715609010980,CLRE 259,A00,507211,Patel; Hemal,9996,0,9999,3
1715609012010,CLRE 260,A00,507221,Cuomo; Raphael Eduardo,9999,0,9999,0
1715609013036,CLRE 297,001,507242,Cuomo; Raphael Eduardo,9999,0,9999,0
1715609014064,COGS 197,001,638244,Voytek; Bradley Thomas,9997,0,9999,2
1715609015097,CSE 191,A00,516875,Minnes Kemp; Mor Mia,9991,0,9999,8
1715609016124,CSE 197,001,637388,Minnes Kemp; Mor Mia,9992,0,9999,7
1715609017150,CSS 201S,A01,494383,Mignozzetti; Umberto,35,0,35,0
1715609018178,CSS 202S,A01,494387,Mignozzetti; Umberto,35,0,35,0
1715609019204,DSC 197,001,628532,Eldridge; Justin Matthew,9995,0,9999,4
1715609020230,EAP 100,A00,516065,Staff,9799,0,9999,200
1715609021259,ECE 45,A01,507414,Staff,31,0,60,29
1715609023309,ECE 111,A01,507420,Staff,11,0,50,39
1715609024336,ECE 197,001,548057,Sievenpiper; Daniel F.,9991,0,9999,8
1715609025364,EDS 115,A00,507243,Choi; Bailey Miyeon,7,0,28,21
1715609026396,EDS 117,A01,494379,Staff,0,6,34,34
1715609027424,EDS 125,A00,507246,Hopkins; Megan Beth,8,0,30,22
1715609028455,EDS 128A,A01,507264,Fargason; Sharon Gayle,6,0,26,20
1715609029485,EDS 128B,A01,507293,Pappas; Elizabeth,10,0,30,20
1715609030512,EDS 139,A00,507294,Fargason; Sharon Gayle,10,0,30,20
1715609030512,EDS 139,B00,507313,Pappas; Elizabeth,11,0,30,19
1715609031541,EDS 201,A00,507315,Staff,10,0,30,20
1715609032569,EDS 203,A01,507317,Halter; Christopher P.,10,0,30,20
1715609033600,EDS 204R,A01,507319,Halter; Christopher P.,0,3,30,30
1715609033600,EDS 204R,B01,507331,Heinzman; Erica M.,14,0,30,16
1715609034630,EDS 206R,A00,507332,Staff,0,4,30,30
1715609034630,EDS 206R,B00,507343,Staff,15,0,30,15
1715609035658,EDS 250,A00,507344,Hemans; Patricia Ann Benitez,20,0,40,20
1715609036685,EDS 281,A00,507345,Daly; Alan J.,18,0,18,0
1715609037711,EDS 284,A00,507350,Daly; Alan J.,16,0,16,0
1715609038736,EDS 286,A00,507359,Fine; Sarah,18,0,18,0
1715609039763,EDS 289C,A01,507361,Daly; Alan J.,18,0,18,0
1715609040794,EDS 290,A00,507366,Hofstetter; Carolyn,15,0,15,0
1715609041827,LIGM 5A,A00,507421,Fischer-Grunski; Eva K,17,0,20,3
1715609042854,LIGM 5B,A00,507423,Fischer-Grunski; Eva K,19,0,20,1
1715609043882,LIGM 5C,A00,507425,Fischer-Grunski; Eva K,19,0,20,1
1715609044908,LIIT 5AS,A00,507427,Carnelos; Chiara,20,0,20,0
1715609045935,LIIT 5BS,A00,507430,Carnelos; Chiara,20,0,20,0
1715609046961,LIIT 5CS,A00,507432,Carnelos; Chiara,20,0,20,0
1715609047996,LISP 5A,A00,507541,Munoz Sanchez; Alicia,11,0,20,9
1715609049028,LISP 5B,A00,507671,Munoz Sanchez; Alicia,9,0,20,11
1715609050054,LISP 5C,A00,507696,Munoz Sanchez; Alicia,9,0,20,11
1715609051080,MAE 197,001,528363,Boechler; Nicholas Sebastia,9998,0,9999,1
1715609052109,MATH 197,001,523477,Kedlaya; Kiran S.,9994,0,9999,5
1715609052109,MATH 197,002,563811,Zhang; Danna,9994,0,9999,5
1715609052109,MATH 197,003,628552,Dumitriu; Ioana,9998,0,9999,1
1715609052109,MATH 197,004,660885,Floyd; Eric,9999,0,9999,0
1715609053137,MCWP 40R,A00,518780,Staff,2,0,20,18
1715609053137,MCWP 40R,B00,518781,Staff,11,0,20,9
1715609053137,MCWP 40R,C00,518783,Staff,5,0,20,15
1715609054167,MCWP 50R,A00,518791,Staff,0,1,20,20
1715609054167,MCWP 50R,B00,518792,Staff,0,2,20,20
1715609054167,MCWP 50R,C00,518793,Staff,0,4,20,20
1715609054167,MCWP 50R,D00,518794,Staff,0,1,20,20
1715609054167,MCWP 50R,E00,518795,Staff,0,2,20,20
1715609054167,MCWP 50R,F00,518796,Staff,0,1,20,20
1715609054167,MCWP 50R,G00,518797,Staff,0,1,20,20
1715609055194,MMW 12R,A01,514034,Herbst; Matthew,0,2,16,16
1715609055194,MMW 12R,A02,514035,Herbst; Matthew,0,0,16,16
1715609056220,MMW 13R,A01,514037,Staff,0,5,16,16
1715609056220,MMW 13R,A02,514039,Staff,0,5,16,16
1715609056220,MMW 13R,A03,628519,Staff,0,4,16,16
1715609058277,SIO 295LS,A00,523233,Staff,10,0,30,20
1715609059303,SIO 295S,A00,523232,Staff,10,0,30,20
1715609060331,SIOC 290S,A01,637330,Merrifield; Mark A,23,0,30,7
1715609061360,SIOC 291S,A01,637333,Gabriel; Corey John,23,0,30,7
1715609062389,SOCI 117,A01,494376,Staff,0,5,5,5
1715609063416,WES 237B,A00,494380,Staff,10,0,20,10
1715609065557,AESE 279B,A00,494370,Wade; Jon P,0,0,33,33
1715609066582,AIP 97,001,660915,Van Den Einde; Yael Dahlia,9999,0,9999,0
1715609067621,AIP 197,001,627712,Vespa; Emanuel Ignacio,9995,0,9999,4
1715609067621,AIP 197,002,650778,Amir; On,9998,0,9999,1
1715609067621,AIP 197,003,650933,Avenancio-Leon; Carlos,9998,0,9999,1
1715609067621,AIP 197,004,658530,Heyman; Gail D.,9998,0,9999,1
1715609067621,AIP 197,005,658631,Neal; Sonya E,9998,0,9999,1
1715609067621,AIP 197,006,658671,Du; Songzi,9998,0,9999,1
1715609068651,ANAR 135S,A00,494369,Braswell; Geoffrey E.,0,0,0,0
1715609069681,BENG 196,001,628496,Engler; Adam J.,9998,0,9999,1
1715609069681,BENG 196,002,660916,Watson; John Thomas,9999,0,9999,0
1715609070713,BISP 197,001,650773,Wilhelm; James E.,9994,0,9999,5
1715609070713,BISP 197,002,658904,Coleman; Aaron B.,9998,0,9999,1
1715609071739,CAT 124RS,A01,519847,Geibel; William,0,0,20,20
1715609072775,CAT 125RS,A01,515971,Geibel; William,0,0,20,20
1715609073809,CLRE 250,A00,511389,Morris; Sheldon,9992,0,9999,7
1715609074836,CLRE 251,A00,507176,Mehta; Ravindra L.,9992,0,9999,7
1715609074836,CLRE 251,B00,511410,Mehta; Ravindra L.,9998,0,9999,1
1715609075863,CLRE 252,A00,507189,Cuomo; Raphael Eduardo,9994,0,9999,5
1715609076888,CLRE 253,A00,507199,Vaida; Florin,9994,0,9999,5
1715609076888,CLRE 253,B00,507202,Vaida; Florin,9999,0,9999,0
1715609077917,CLRE 259,A00,507211,Patel; Hemal,9996,0,9999,3
1715609078944,CLRE 260,A00,507221,Cuomo; Raphael Eduardo,9999,0,9999,0
1715609079970,CLRE 297,001,507242,Cuomo; Raphael Eduardo,9999,0,9999,0
1715609081001,COGS 197,001,638244,Voytek; Bradley Thomas,9997,0,9999,2
1715609082028,CSE 191,A00,516875,Minnes Kemp; Mor Mia,9991,0,9999,8
1715609083057,CSE 197,001,637388,Minnes Kemp; Mor Mia,9992,0,9999,7
1715609084089,CSS 201S,A01,494383,Mignozzetti; Umberto,35,0,35,0
1715609085116,CSS 202S,A01,494387,Mignozzetti; Umberto,35,0,35,0
1715609086144,DSC 197,001,628532,Eldridge; Justin Matthew,9995,0,9999,4
1715609087172,EAP 100,A00,516065,Staff,9799,0,9999,200
1715609088201,ECE 45,A01,507414,Staff,31,0,60,29
1715609090253,ECE 111,A01,507420,Staff,11,0,50,39
1715609091284,ECE 197,001,548057,Sievenpiper; Daniel F.,9991,0,9999,8
1715609092311,EDS 115,A00,507243,Choi; Bailey Miyeon,7,0,28,21
1715609093339,EDS 117,A01,494379,Staff,0,6,34,34
1715609094368,EDS 125,A00,507246,Hopkins; Megan Beth,8,0,30,22
1715609095397,EDS 128A,A01,507264,Fargason; Sharon Gayle,6,0,26,20
1715609096426,EDS 128B,A01,507293,Pappas; Elizabeth,10,0,30,20
1715609097452,EDS 139,A00,507294,Fargason; Sharon Gayle,10,0,30,20
1715609097452,EDS 139,B00,507313,Pappas; Elizabeth,11,0,30,19
1715609098478,EDS 201,A00,507315,Staff,10,0,30,20
1715609099504,EDS 203,A01,507317,Halter; Christopher P.,10,0,30,20
1715609100530,EDS 204R,A01,507319,Halter; Christopher P.,0,3,30,30
1715609100530,EDS 204R,B01,507331,Heinzman; Erica M.,14,0,30,16
1715609101554,EDS 206R,A00,507332,Staff,0,4,30,30
1715609101554,EDS 206R,B00,507343,Staff,15,0,30,15
1715609102584,EDS 250,A00,507344,Hemans; Patricia Ann Benitez,20,0,40,20
1715609103610,EDS 281,A00,507345,Daly; Alan J.,18,0,18,0
1715609104635,EDS 284,A00,507350,Daly; Alan J.,16,0,16,0
1715609105668,EDS 286,A00,507359,Fine; Sarah,18,0,18,0
1715609106697,EDS 289C,A01,507361,Daly; Alan J.,18,0,18,0
1715609107734,EDS 290,A00,507366,Hofstetter; Carolyn,15,0,15,0
1715609108773,LIGM 5A,A00,507421,Fischer-Grunski; Eva K,17,0,20,3
1715609109801,LIGM 5B,A00,507423,Fischer-Grunski; Eva K,19,0,20,1
1715609110826,LIGM 5C,A00,507425,Fischer-Grunski; Eva K,19,0,20,1
1715609111852,LIIT 5AS,A00,507427,Carnelos; Chiara,20,0,20,0
1715609112885,LIIT 5BS,A00,507430,Carnelos; Chiara,20,0,20,0
1715609113911,LIIT 5CS,A00,507432,Carnelos; Chiara,20,0,20,0
1715609114945,LISP 5A,A00,507541,Munoz Sanchez; Alicia,11,0,20,9
1715609115978,LISP 5B,A00,507671,Munoz Sanchez; Alicia,9,0,20,11
1715609117003,LISP 5C,A00,507696,Munoz Sanchez; Alicia,9,0,20,11
1715609118032,MAE 197,001,528363,Boechler; Nicholas Sebastia,9998,0,9999,1
1715609119063,MATH 197,001,523477,Kedlaya; Kiran S.,9994,0,9999,5
1715609119063,MATH 197,002,563811,Zhang; Danna,9994,0,9999,5
1715609119063,MATH 197,003,628552,Dumitriu; Ioana,9998,0,9999,1
1715609119063,MATH 197,004,660885,Floyd; Eric,9999,0,9999,0
1715609120091,MCWP 40R,A00,518780,Staff,2,0,20,18
1715609120091,MCWP 40R,B00,518781,Staff,11,0,20,9
1715609120091,MCWP 40R,C00,518783,Staff,5,0,20,15
1715609121123,MCWP 50R,A00,518791,Staff,0,1,20,20
1715609121123,MCWP 50R,B00,518792,Staff,0,2,20,20
1715609121123,MCWP 50R,C00,518793,Staff,0,4,20,20
1715609121123,MCWP 50R,D00,518794,Staff,0,1,20,20
1715609121123,MCWP 50R,E00,518795,Staff,0,2,20,20
1715609121123,MCWP 50R,F00,518796,Staff,0,1,20,20
1715609121123,MCWP 50R,G00,518797,Staff,0,1,20,20
1715609122155,MMW 12R,A01,514034,Herbst; Matthew,0,2,16,16
1715609122155,MMW 12R,A02,514035,Herbst; Matthew,0,0,16,16
1715609123182,MMW 13R,A01,514037,Staff,0,5,16,16
1715609123182,MMW 13R,A02,514039,Staff,0,5,16,16
1715609123182,MMW 13R,A03,628519,Staff,0,4,16,16
1715609125241,SIO 295LS,A00,523233,Staff,10,0,30,20
1715609126268,SIO 295S,A00,523232,Staff,10,0,30,20
1715609127298,SIOC 290S,A01,637330,Merrifield; Mark A,23,0,30,7
1715609128330,SIOC 291S,A01,637333,Gabriel; Corey John,23,0,30,7
1715609129357,SOCI 117,A01,494376,Staff,0,5,5,5
1715609130384,WES 237B,A00,494380,Staff,10,0,20,10
1715609132523,AESE 279B,A00,494370,Wade; Jon P,0,0,33,33
1715609133552,AIP 97,001,660915,Van Den Einde; Yael Dahlia,9999,0,9999,0
1715609134596,AIP 197,001,627712,Vespa; Emanuel Ignacio,9995,0,9999,4
1715609134596,AIP 197,002,650778,Amir; On,9998,0,9999,1
1715609134596,AIP 197,003,650933,Avenancio-Leon; Carlos,9998,0,9999,1
1715609134596,AIP 197,004,658530,Heyman; Gail D.,9998,0,9999,1
1715609134596,AIP 197,005,658631,Neal; Sonya E,9998,0,9999,1
1715609134596,AIP 197,006,658671,Du; Songzi,9998,0,9999,1
1715609135622,ANAR 135S,A00,494369,Braswell; Geoffrey E.,0,0,0,0
1715609136649,BENG 196,001,628496,Engler; Adam J.,9998,0,9999,1
1715609136649,BENG 196,002,660916,Watson; John Thomas,9999,0,9999,0
1715609137676,BISP 197,001,650773,Wilhelm; James E.,9994,0,9999,5
1715609137676,BISP 197,002,658904,Coleman; Aaron B.,9998,0,9999,1
1715609138725,CAT 124RS,A01,519847,Geibel; William,0,0,20,20
1715609139758,CAT 125RS,A01,515971,Geibel; William,0,0,20,20
1715609140785,CLRE 250,A00,511389,Morris; Sheldon,9992,0,9999,7
1715609141820,CLRE 251,A00,507176,Mehta; Ravindra L.,9992,0,9999,7
1715609141820,CLRE 251,B00,511410,Mehta; Ravindra L.,9998,0,9999,1
1715609142852,CLRE 252,A00,507189,Cuomo; Raphael Eduardo,9994,0,9999,5
1715609143879,CLRE 253,A00,507199,Vaida; Florin,9994,0,9999,5
1715609143879,CLRE 253,B00,507202,Vaida; Florin,9999,0,9999,0
1715609144912,CLRE 259,A00,507211,Patel; Hemal,9996,0,9999,3
1715609145939,CLRE 260,A00,507221,Cuomo; Raphael Eduardo,9999,0,9999,0
1715609146975,CLRE 297,001,507242,Cuomo; Raphael Eduardo,9999,0,9999,0
1715609148010,COGS 197,001,638244,Voytek; Bradley Thomas,9997,0,9999,2
1715609149041,CSE 191,A00,516875,Minnes Kemp; Mor Mia,9991,0,9999,8
1715609150071,CSE 197,001,637388,Minnes Kemp; Mor Mia,9992,0,9999,7
1715609151100,CSS 201S,A01,494383,Mignozzetti; Umberto,35,0,35,0
1715609152139,CSS 202S,A01,494387,Mignozzetti; Umberto,35,0,35,0
1715609153189,DSC 197,001,628532,Eldridge; Justin Matthew,9995,0,9999,4
1715609154217,EAP 100,A00,516065,Staff,9799,0,9999,200
1715609155261,ECE 45,A01,507414,Staff,31,0,60,29
1715609157320,ECE 111,A01,507420,Staff,11,0,50,39
1715609158348,ECE 197,001,548057,Sievenpiper; Daniel F.,9991,0,9999,8
1715609159377,EDS 115,A00,507243,Choi; Bailey Miyeon,7,0,28,21
1715609160415,EDS 117,A01,494379,Staff,0,6,34,34
1715609161446,EDS 125,A00,507246,Hopkins; Megan Beth,8,0,30,22
1715609162478,EDS 128A,A01,507264,Fargason; Sharon Gayle,6,0,26,20
1715609163508,EDS 128B,A01,507293,Pappas; Elizabeth,10,0,30,20
1715609164539,EDS 139,A00,507294,Fargason; Sharon Gayle,10,0,30,20
1715609164539,EDS 139,B00,507313,Pappas; Elizabeth,11,0,30,19
1715609165567,EDS 201,A00,507315,Staff,10,0,30,20
1715609166594,EDS 203,A01,507317,Halter; Christopher P.,10,0,30,20
1715609167622,EDS 204R,A01,507319,Halter; Christopher P.,0,3,30,30
1715609167622,EDS 204R,B01,507331,Heinzman; Erica M.,14,0,30,16
1715609168726,EDS 206R,A00,507332,Staff,0,4,30,30
1715609168726,EDS 206R,B00,507343,Staff,15,0,30,15
1715609169756,EDS 250,A00,507344,Hemans; Patricia Ann Benitez,20,0,40,20
1715609170805,EDS 281,A00,507345,Daly; Alan J.,18,0,18,0
1715609171836,EDS 284,A00,507350,Daly; Alan J.,16,0,16,0
1715609172863,EDS 286,A00,507359,Fine; Sarah,18,0,18,0
1715609173893,EDS 289C,A01,507361,Daly; Alan J.,18,0,18,0
1715609174918,EDS 290,A00,507366,Hofstetter; Carolyn,15,0,15,0
1715609175944,LIGM 5A,A00,507421,Fischer-Grunski; Eva K,17,0,20,3
1715609176969,LIGM 5B,A00,507423,Fischer-Grunski; Eva K,19,0,20,1
1715609177996,LIGM 5C,A00,507425,Fischer-Grunski; Eva K,19,0,20,1
1715609179023,LIIT 5AS,A00,507427,Carnelos; Chiara,20,0,20,0
1715609180050,LIIT 5BS,A00,507430,Carnelos; Chiara,20,0,20,0
1715609181076,LIIT 5CS,A00,507432,Carnelos; Chiara,20,0,20,0
1715609182102,LISP 5A,A00,507541,Munoz Sanchez; Alicia,11,0,20,9
1715609183130,LISP 5B,A00,507671,Munoz Sanchez; Alicia,9,0,20,11
1715609184156,LISP 5C,A00,507696,Munoz Sanchez; Alicia,9,0,20,11
1715609185184,MAE 197,001,528363,Boechler; Nicholas Sebastia,9998,0,9999,1
1715609186222,MATH 197,001,523477,Kedlaya; Kiran S.,9994,0,9999,5
1715609186222,MATH 197,002,563811,Zhang; Danna,9994,0,9999,5
1715609186222,MATH 197,003,628552,Dumitriu; Ioana,9998,0,9999,1
1715609186222,MATH 197,004,660885,Floyd; Eric,9999,0,9999,0
1715609187249,MCWP 40R,A00,518780,Staff,2,0,20,18
1715609187249,MCWP 40R,B00,518781,Staff,11,0,20,9
1715609187249,MCWP 40R,C00,518783,Staff,5,0,20,15
1715609188279,MCWP 50R,A00,518791,Staff,0,1,20,20
1715609188279,MCWP 50R,B00,518792,Staff,0,2,20,20
1715609188279,MCWP 50R,C00,518793,Staff,0,4,20,20
1715609188279,MCWP 50R,D00,518794,Staff,0,1,20,20
1715609188279,MCWP 50R,E00,518795,Staff,0,2,20,20
1715609188279,MCWP 50R,F00,518796,Staff,0,1,20,20
1715609188279,MCWP 50R,G00,518797,Staff,0,1,20,20
1715609189307,MMW 12R,A01,514034,Herbst; Matthew,0,2,16,16
1715609189307,MMW 12R,A02,514035,Herbst; Matthew,0,0,16,16
1715609190333,MMW 13R,A01,514037,Staff,0,5,16,16
1715609190333,MMW 13R,A02,514039,Staff,0,5,16,16
1715609190333,MMW 13R,A03,628519,Staff,0,4,16,16
1715609192390,SIO 295LS,A00,523233,Staff,10,0,30,20
1715609193420,SIO 295S,A00,523232,Staff,10,0,30,20
1715609194456,SIOC 290S,A01,637330,Merrifield; Mark A,23,0,30,7
1715609195483,SIOC 291S,A01,637333,Gabriel; Corey John,23,0,30,7
1715609196508,SOCI 117,A01,494376,Staff,0,5,5,5
1715609197539,WES 237B,A00,494380,Staff,10,0,20,10
1715609199620,AESE 279B,A00,494370,Wade; Jon P,0,0,33,33
1715609200649,AIP 97,001,660915,Van Den Einde; Yael Dahlia,9999,0,9999,0
1715609201683,AIP 197,001,627712,Vespa; Emanuel Ignacio,9995,0,9999,4
1715609201683,AIP 197,002,650778,Amir; On,9998,0,9999,1
1715609201683,AIP 197,003,650933,Avenancio-Leon; Carlos,9998,0,9999,1
1715609201683,AIP 197,004,658530,Heyman; Gail D.,9998,0,9999,1
1715609201683,AIP 197,005,658631,Neal; Sonya E,9998,0,9999,1
1715609201683,AIP 197,006,658671,Du; Songzi,9998,0,9999,1
1715609202710,ANAR 135S,A00,494369,Braswell; Geoffrey E.,0,0,0,0
1715609203737,BENG 196,001,628496,Engler; Adam J.,9998,0,9999,1
1715609203737,BENG 196,002,660916,Watson; John Thomas,9999,0,9999,0
1715609204762,BISP 197,001,650773,Wilhelm; James E.,9994,0,9999,5
1715609204762,BISP 197,002,658904,Coleman; Aaron B.,9998,0,9999,1
1715609205791,CAT 124RS,A01,519847,Geibel; William,0,0,20,20
1715609206819,CAT 125RS,A01,515971,Geibel; William,0,0,20,20
1715609207845,CLRE 250,A00,511389,Morris; Sheldon,9992,0,9999,7
1715609208876,CLRE 251,A00,507176,Mehta; Ravindra L.,9992,0,9999,7
1715609208876,CLRE 251,B00,511410,Mehta; Ravindra L.,9998,0,9999,1
1715609209902,CLRE 252,A00,507189,Cuomo; Raphael Eduardo,9994,0,9999,5
1715609210928,CLRE 253,A00,507199,Vaida; Florin,9994,0,9999,5
1715609210928,CLRE 253,B00,507202,Vaida; Florin,9999,0,9999,0
1715609211956,CLRE 259,A00,507211,Patel; Hemal,9996,0,9999,3
1715609212982,CLRE 260,A00,507221,Cuomo; Raphael Eduardo,9999,0,9999,0
1715609214007,CLRE 297,001,507242,Cuomo; Raphael Eduardo,9999,0,9999,0
1715609215033,COGS 197,001,638244,Voytek; Bradley Thomas,9997,0,9999,2
1715609216064,CSE 191,A00,516875,Minnes Kemp; Mor Mia,9991,0,9999,8
1715609217089,CSE 197,001,637388,Minnes Kemp; Mor Mia,9992,0,9999,7
1715609218117,CSS 201S,A01,494383,Mignozzetti; Umberto,35,0,35,0
1715609219150,CSS 202S,A01,494387,Mignozzetti; Umberto,35,0,35,0
1715609220177,DSC 197,001,628532,Eldridge; Justin Matthew,9995,0,9999,4
1715609221201,EAP 100,A00,516065,Staff,9799,0,9999,200
1715609222230,ECE 45,A01,507414,Staff,31,0,60,29
1715609224292,ECE 111,A01,507420,Staff,11,0,50,39
1715609225322,ECE 197,001,548057,Sievenpiper; Daniel F.,9991,0,9999,8
1715609226356,EDS 115,A00,507243,Choi; Bailey Miyeon,7,0,28,21
1715609227388,EDS 117,A01,494379,Staff,0,6,34,34
1715609228416,EDS 125,A00,507246,Hopkins; Megan Beth,8,0,30,22
1715609229440,EDS 128A,A01,507264,Fargason; Sharon Gayle,6,0,26,20
1715609230467,EDS 128B,A01,507293,Pappas; Elizabeth,10,0,30,20
1715609231502,EDS 139,A00,507294,Fargason; Sharon Gayle,10,0,30,20
1715609231502,EDS 139,B00,507313,Pappas; Elizabeth,11,0,30,19
1715609232527,EDS 201,A00,507315,Staff,10,0,30,20
1715609233553,EDS 203,A01,507317,Halter; Christopher P.,10,0,30,20
1715609234582,EDS 204R,A01,507319,Halter; Christopher P.,0,3,30,30
1715609234582,EDS 204R,B01,507331,Heinzman; Erica M.,14,0,30,16
1715609235608,EDS 206R,A00,507332,Staff,0,4,30,30
1715609235608,EDS 206R,B00,507343,Staff,15,0,30,15
1715609236635,EDS 250,A00,507344,Hemans; Patricia Ann Benitez,20,0,40,20
1715609237662,EDS 281,A00,507345,Daly; Alan J.,18,0,18,0
1715609238688,EDS 284,A00,507350,Daly; Alan J.,16,0,16,0
1715609239718,EDS 286,A00,507359,Fine; Sarah,18,0,18,0
1715609240742,EDS 289C,A01,507361,Daly; Alan J.,18,0,18,0
1715609241770,EDS 290,A00,507366,Hofstetter; Carolyn,15,0,15,0
1715609242801,LIGM 5A,A00,507421,Fischer-Grunski; Eva K,17,0,20,3
1715609243827,LIGM 5B,A00,507423,Fischer-Grunski; Eva K,19,0,20,1
1715609244853,LIGM 5C,A00,507425,Fischer-Grunski; Eva K,19,0,20,1
1715609245879,LIIT 5AS,A00,507427,Carnelos; Chiara,20,0,20,0
1715609246905,LIIT 5BS,A00,507430,Carnelos; Chiara,20,0,20,0
1715609247932,LIIT 5CS,A00,507432,Carnelos; Chiara,20,0,20,0
1715609248964,LISP 5A,A00,507541,Munoz Sanchez; Alicia,11,0,20,9
1715609249990,LISP 5B,A00,507671,Munoz Sanchez; Alicia,9,0,20,11
1715609251017,LISP 5C,A00,507696,Munoz Sanchez; Alicia,9,0,20,11
1715609252048,MAE 197,001,528363,Boechler; Nicholas Sebastia,9998,0,9999,1
1715609253077,MATH 197,001,523477,Kedlaya; Kiran S.,9994,0,9999,5
1715609253077,MATH 197,002,563811,Zhang; Danna,9994,0,9999,5
1715609253077,MATH 197,003,628552,Dumitriu; Ioana,9998,0,9999,1
1715609253077,MATH 197,004,660885,Floyd; Eric,9999,0,9999,0
1715609254103,MCWP 40R,A00,518780,Staff,2,0,20,18
1715609254103,MCWP 40R,B00,518781,Staff,11,0,20,9
1715609254103,MCWP 40R,C00,518783,Staff,5,0,20,15
1715609255130,MCWP 50R,A00,518791,Staff,0,1,20,20
1715609255130,MCWP 50R,B00,518792,Staff,0,2,20,20
1715609255130,MCWP 50R,C00,518793,Staff,0,4,20,20
1715609255130,MCWP 50R,D00,518794,Staff,0,1,20,20
1715609255130,MCWP 50R,E00,518795,Staff,0,2,20,20
1715609255130,MCWP 50R,F00,518796,Staff,0,1,20,20
1715609255130,MCWP 50R,G00,518797,Staff,0,1,20,20
1715609256159,MMW 12R,A01,514034,Herbst; Matthew,0,2,16,16
1715609256159,MMW 12R,A02,514035,Herbst; Matthew,0,0,16,16
1715609257184,MMW 13R,A01,514037,Staff,0,5,16,16
1715609257184,MMW 13R,A02,514039,Staff,0,5,16,16
1715609257184,MMW 13R,A03,628519,Staff,0,4,16,16
1715609259241,SIO 295LS,A00,523233,Staff,10,0,30,20
1715609260270,SIO 295S,A00,523232,Staff,10,0,30,20
1715609261297,SIOC 290S,A01,637330,Merrifield; Mark A,23,0,30,7
1715609262322,SIOC 291S,A01,637333,Gabriel; Corey John,23,0,30,7
1715609263349,SOCI 117,A01,494376,Staff,0,5,5,5
1715609264378,WES 237B,A00,494380,Staff,10,0,20,10
1715609266462,AESE 279B,A00,494370,Wade; Jon P,0,0,33,33
1715609267492,AIP 97,001,660915,Van Den Einde; Yael Dahlia,9999,0,9999,0
1715609268522,AIP 197,001,627712,Vespa; Emanuel Ignacio,9995,0,9999,4
1715609268522,AIP 197,002,650778,Amir; On,9998,0,9999,1
1715609268522,AIP 197,003,650933,Avenancio-Leon; Carlos,9998,0,9999,1
1715609268522,AIP 197,004,658530,Heyman; Gail D.,9998,0,9999,1
1715609268522,AIP 197,005,658631,Neal; Sonya E,9998,0,9999,1
1715609268522,AIP 197,006,658671,Du; Songzi,9998,0,9999,1
1715609269548,ANAR 135S,A00,494369,Braswell; Geoffrey E.,0,0,0,0
1715609270574,BENG 196,001,628496,Engler; Adam J.,9998,0,9999,1
1715609270574,BENG 196,002,660916,Watson; John Thomas,9999,0,9999,0
1715609271602,BISP 197,001,650773,Wilhelm; James E.,9994,0,9999,5
1715609271602,BISP 197,002,658904,Coleman; Aaron B.,9998,0,9999,1
1715609272685,CAT 124RS,A01,519847,Geibel; William,0,0,20,20
1715609273710,CAT 125RS,A01,515971,Geibel; William,0,0,20,20
1715609274738,CLRE 250,A00,511389,Morris; Sheldon,9992,0,9999,7
1715609275770,CLRE 251,A00,507176,Mehta; Ravindra L.,9992,0,9999,7
1715609275770,CLRE 251,B00,511410,Mehta; Ravindra L.,9998,0,9999,1
1715609276797,CLRE 252,A00,507189,Cuomo; Raphael Eduardo,9994,0,9999,5
1715609277823,CLRE 253,A00,507199,Vaida; Florin,9994,0,9999,5
1715609277823,CLRE 253,B00,507202,Vaida; Florin,9999,0,9999,0
1715609278851,CLRE 259,A00,507211,Patel; Hemal,9996,0,9999,3
1715609279876,CLRE 260,A00,507221,Cuomo; Raphael Eduardo,9999,0,9999,0
1715609280908,CLRE 297,001,507242,Cuomo; Raphael Eduardo,9999,0,9999,0
1715609281934,COGS 197,001,638244,Voytek; Bradley Thomas,9997,0,9999,2
1715609282964,CSE 191,A00,516875,Minnes Kemp; Mor Mia,9991,0,9999,8
1715609283993,CSE 197,001,637388,Minnes Kemp; Mor Mia,9992,0,9999,7
1715609285022,CSS 201S,A01,494383,Mignozzetti; Umberto,35,0,35,0
1715609286048,CSS 202S,A01,494387,Mignozzetti; Umberto,35,0,35,0
1715609287074,DSC 197,001,628532,Eldridge; Justin Matthew,9995,0,9999,4
1715609288099,EAP 100,A00,516065,Staff,9799,0,9999,200
1715609289130,ECE 45,A01,507414,Staff,31,0,60,29
1715609291186,ECE 111,A01,507420,Staff,11,0,50,39
1715609292212,ECE 197,001,548057,Sievenpiper; Daniel F.,9991,0,9999,8
1715609293242,EDS 115,A00,507243,Choi; Bailey Miyeon,7,0,28,21
1715609294269,EDS 117,A01,494379,Staff,0,6,34,34
1715609295299,EDS 125,A00,507246,Hopkins; Megan Beth,8,0,30,22
1715609296326,EDS 128A,A01,507264,Fargason; Sharon Gayle,6,0,26,20
1715609297354,EDS 128B,A01,507293,Pappas; Elizabeth,10,0,30,20
1715609298381,EDS 139,A00,507294,Fargason; Sharon Gayle,10,0,30,20
1715609298381,EDS 139,B00,507313,Pappas; Elizabeth,11,0,30,19
1715609299411,EDS 201,A00,507315,Staff,10,0,30,20
1715609300436,EDS 203,A01,507317,Halter; Christopher P.,10,0,30,20
1715609301462,EDS 204R,A01,507319,Halter; Christopher P.,0,3,30,30
1715609301462,EDS 204R,B01,507331,Heinzman; Erica M.,14,0,30,16
1715609302490,EDS 206R,A00,507332,Staff,0,4,30,30
1715609302490,EDS 206R,B00,507343,Staff,15,0,30,15
1715609303520,EDS 250,A00,507344,Hemans; Patricia Ann Benitez,20,0,40,20
1715609304548,EDS 281,A00,507345,Daly; Alan J.,18,0,18,0
1715609305573,EDS 284,A00,507350,Daly; Alan J.,16,0,16,0
1715609306599,EDS 286,A00,507359,Fine; Sarah,18,0,18,0
1715609307625,EDS 289C,A01,507361,Daly; Alan J.,18,0,18,0
1715609308654,EDS 290,A00,507366,Hofstetter; Carolyn,15,0,15,0
1715609309684,LIGM 5A,A00,507421,Fischer-Grunski; Eva K,17,0,20,3
1715609310713,LIGM 5B,A00,507423,Fischer-Grunski; Eva K,19,0,20,1
1715609311741,LIGM 5C,A00,507425,Fischer-Grunski; Eva K,19,0,20,1
1715609312765,LIIT 5AS,A00,507427,Carnelos; Chiara,20,0,20,0
1715609313790,LIIT 5BS,A00,507430,Carnelos; Chiara,20,0,20,0
1715609314821,LIIT 5CS,A00,507432,Carnelos; Chiara,20,0,20,0
1715609315850,LISP 5A,A00,507541,Munoz Sanchez; Alicia,11,0,20,9
1715609316877,LISP 5B,A00,507671,Munoz Sanchez; Alicia,9,0,20,11
1715609317904,LISP 5C,A00,507696,Munoz Sanchez; Alicia,9,0,20,11
1715609318929,MAE 197,001,528363,Boechler; Nicholas Sebastia,9998,0,9999,1
1715609319958,MATH 197,001,523477,Kedlaya; Kiran S.,9994,0,9999,5
1715609319958,MATH 197,002,563811,Zhang; Danna,9994,0,9999,5
1715609319958,MATH 197,003,628552,Dumitriu; Ioana,9998,0,9999,1
1715609319958,MATH 197,004,660885,Floyd; Eric,9999,0,9999,0
1715609320984,MCWP 40R,A00,518780,Staff,2,0,20,18
1715609320984,MCWP 40R,B00,518781,Staff,11,0,20,9
1715609320984,MCWP 40R,C00,518783,Staff,5,0,20,15
1715609322014,MCWP 50R,A00,518791,Staff,0,1,20,20
1715609322014,MCWP 50R,B00,518792,Staff,0,2,20,20
1715609322014,MCWP 50R,C00,518793,Staff,0,4,20,20
1715609322014,MCWP 50R,D00,518794,Staff,0,1,20,20
1715609322014,MCWP 50R,E00,518795,Staff,0,2,20,20
1715609322014,MCWP 50R,F00,518796,Staff,0,1,20,20
1715609322014,MCWP 50R,G00,518797,Staff,0,1,20,20
1715609323041,MMW 12R,A01,514034,Herbst; Matthew,0,2,16,16
1715609323041,MMW 12R,A02,514035,Herbst; Matthew,0,0,16,16
1715609324071,MMW 13R,A01,514037,Staff,0,5,16,16
1715609324071,MMW 13R,A02,514039,Staff,0,5,16,16
1715609324071,MMW 13R,A03,628519,Staff,0,4,16,16
1715609326125,SIO 295LS,A00,523233,Staff,10,0,30,20
1715609327150,SIO 295S,A00,523232,Staff,10,0,30,20
1715609328182,SIOC 290S,A01,637330,Merrifield; Mark A,23,0,30,7
1715609329208,SIOC 291S,A01,637333,Gabriel; Corey John,23,0,30,7
1715609330235,SOCI 117,A01,494376,Staff,0,5,5,5
1715609331263,WES 237B,A00,494380,Staff,10,0,20,10
1715609333352,AESE 279B,A00,494370,Wade; Jon P,0,0,33,33
1715609334381,AIP 97,001,660915,Van Den Einde; Yael Dahlia,9999,0,9999,0
1715609335415,AIP 197,001,627712,Vespa; Emanuel Ignacio,9995,0,9999,4
1715609335415,AIP 197,002,650778,Amir; On,9998,0,9999,1
1715609335415,AIP 197,003,650933,Avenancio-Leon; Carlos,9998,0,9999,1
1715609335415,AIP 197,004,658530,Heyman; Gail D.,9998,0,9999,1
1715609335415,AIP 197,005,658631,Neal; Sonya E,9998,0,9999,1
1715609335415,AIP 197,006,658671,Du; Songzi,9998,0,9999,1
1715609336442,ANAR 135S,A00,494369,Braswell; Geoffrey E.,0,0,0,0
1715609337471,BENG 196,001,628496,Engler; Adam J.,9998,0,9999,1
1715609337471,BENG 196,002,660916,Watson; John Thomas,9999,0,9999,0
1715609338500,BISP 197,001,650773,Wilhelm; James E.,9994,0,9999,5
1715609338500,BISP 197,002,658904,Coleman; Aaron B.,9998,0,9999,1
1715609339525,CAT 124RS,A01,519847,Geibel; William,0,0,20,20
1715609340550,CAT 125RS,A01,515971,Geibel; William,0,0,20,20
1715609341582,CLRE 250,A00,511389,Morris; Sheldon,9992,0,9999,7
1715609342614,CLRE 251,A00,507176,Mehta; Ravindra L.,9992,0,9999,7
1715609342614,CLRE 251,B00,511410,Mehta; Ravindra L.,9998,0,9999,1
1715609343644,CLRE 252,A00,507189,Cuomo; Raphael Eduardo,9994,0,9999,5
1715609344673,CLRE 253,A00,507199,Vaida; Florin,9994,0,9999,5
1715609344673,CLRE 253,B00,507202,Vaida; Florin,9999,0,9999,0
1715609345700,CLRE 259,A00,507211,Patel; Hemal,9996,0,9999,3
1715609346729,CLRE 260,A00,507221,Cuomo; Raphael Eduardo,9999,0,9999,0
1715609347755,CLRE 297,001,507242,Cuomo; Raphael Eduardo,9999,0,9999,0
1715609348781,COGS 197,001,638244,Voytek; Bradley Thomas,9997,0,9999,2
1715609349812,CSE 191,A00,516875,Minnes Kemp; Mor Mia,9991,0,9999,8
1715609350837,CSE 197,001,637388,Minnes Kemp; Mor Mia,9992,0,9999,7
1715609351864,CSS 201S,A01,494383,Mignozzetti; Umberto,35,0,35,0
1715609352896,CSS 202S,A01,494387,Mignozzetti; Umberto,35,0,35,0
1715609353922,DSC 197,001,628532,Eldridge; Justin Matthew,9995,0,9999,4
1715609354950,EAP 100,A00,516065,Staff,9799,0,9999,200
1715609355980,ECE 45,A01,507414,Staff,31,0,60,29
1715609358031,ECE 111,A01,507420,Staff,11,0,50,39
1715609359056,ECE 197,001,548057,Sievenpiper; Daniel F.,9991,0,9999,8
1715609360087,EDS 115,A00,507243,Choi; Bailey Miyeon,7,0,28,21
1715609361115,EDS 117,A01,494379,Staff,0,6,34,34
1715609362142,EDS 125,A00,507246,Hopkins; Megan Beth,8,0,30,22
1715609363171,EDS 128A,A01,507264,Fargason; Sharon Gayle,6,0,26,20
1715609364199,EDS 128B,A01,507293,Pappas; Elizabeth,10,0,30,20
1715609365224,EDS 139,A00,507294,Fargason; Sharon Gayle,10,0,30,20
1715609365224,EDS 139,B00,507313,Pappas; Elizabeth,11,0,30,19
1715609366251,EDS 201,A00,507315,Staff,10,0,30,20
1715609367279,EDS 203,A01,507317,Halter; Christopher P.,10,0,30,20
1715609368306,EDS 204R,A01,507319,Halter; Christopher P.,0,3,30,30
1715609368306,EDS 204R,B01,507331,Heinzman; Erica M.,14,0,30,16
1715609369331,EDS 206R,A00,507332,Staff,0,4,30,30
1715609369331,EDS 206R,B00,507343,Staff,15,0,30,15
1715609370356,EDS 250,A00,507344,Hemans; Patricia Ann Benitez,20,0,40,20
1715609371384,EDS 281,A00,507345,Daly; Alan J.,18,0,18,0
1715609372409,EDS 284,A00,507350,Daly; Alan J.,16,0,16,0
1715609373436,EDS 286,A00,507359,Fine; Sarah,18,0,18,0
1715609374467,EDS 289C,A01,507361,Daly; Alan J.,18,0,18,0
1715609375496,EDS 290,A00,507366,Hofstetter; Carolyn,15,0,15,0
1715609376580,LIGM 5A,A00,507421,Fischer-Grunski; Eva K,17,0,20,3
1715609377609,LIGM 5B,A00,507423,Fischer-Grunski; Eva K,19,0,20,1
1715609378636,LIGM 5C,A00,507425,Fischer-Grunski; Eva K,19,0,20,1
1715609379666,LIIT 5AS,A00,507427,Carnelos; Chiara,20,0,20,0
1715609380691,LIIT 5BS,A00,507430,Carnelos; Chiara,20,0,20,0
1715609381720,LIIT 5CS,A00,507432,Carnelos; Chiara,20,0,20,0
1715609382747,LISP 5A,A00,507541,Munoz Sanchez; Alicia,11,0,20,9
1715609383773,LISP 5B,A00,507671,Munoz Sanchez; Alicia,9,0,20,11
1715609384802,LISP 5C,A00,507696,Munoz Sanchez; Alicia,9,0,20,11
1715609385828,MAE 197,001,528363,Boechler; Nicholas Sebastia,9998,0,9999,1
1715609386858,MATH 197,001,523477,Kedlaya; Kiran S.,9994,0,9999,5
1715609386858,MATH 197,002,563811,Zhang; Danna,9994,0,9999,5
1715609386858,MATH 197,003,628552,Dumitriu; Ioana,9998,0,9999,1
1715609386858,MATH 197,004,660885,Floyd; Eric,9999,0,9999,0
1715609387888,MCWP 40R,A00,518780,Staff,2,0,20,18
1715609387888,MCWP 40R,B00,518781,Staff,11,0,20,9
1715609387888,MCWP 40R,C00,518783,Staff,5,0,20,15
1715609388914,MCWP 50R,A00,518791,Staff,0,1,20,20
1715609388914,MCWP 50R,B00,518792,Staff,0,2,20,20
1715609388914,MCWP 50R,C00,518793,Staff,0,4,20,20
1715609388914,MCWP 50R,D00,518794,Staff,0,1,20,20
1715609388914,MCWP 50R,E00,518795,Staff,0,2,20,20
1715609388914,MCWP 50R,F00,518796,Staff,0,1,20,20
1715609388914,MCWP 50R,G00,518797,Staff,0,1,20,20
1715609389938,MMW 12R,A01,514034,Herbst; Matthew,0,2,16,16
1715609389938,MMW 12R,A02,514035,Herbst; Matthew,0,0,16,16
1715609390966,MMW 13R,A01,514037,Staff,0,5,16,16
1715609390966,MMW 13R,A02,514039,Staff,0,5,16,16
1715609390966,MMW 13R,A03,628519,Staff,0,4,16,16
1715609393020,SIO 295LS,A00,523233,Staff,10,0,30,20
1715609394045,SIO 295S,A00,523232,Staff,10,0,30,20
1715609395077,SIOC 290S,A01,637330,Merrifield; Mark A,23,0,30,7
1715609396107,SIOC 291S,A01,637333,Gabriel; Corey John,23,0,30,7
1715609397134,SOCI 117,A01,494376,Staff,0,5,5,5
1715609398158,WES 237B,A00,494380,Staff,10,0,20,10
1715609400248,AESE 279B,A00,494370,Wade; Jon P,0,0,33,33
1715609401276,AIP 97,001,660915,Van Den Einde; Yael Dahlia,9999,0,9999,0
1715609402307,AIP 197,001,627712,Vespa; Emanuel Ignacio,9995,0,9999,4
1715609402307,AIP 197,002,650778,Amir; On,9998,0,9999,1
1715609402307,AIP 197,003,650933,Avenancio-Leon; Carlos,9998,0,9999,1
1715609402307,AIP 197,004,658530,Heyman; Gail D.,9998,0,9999,1
1715609402307,AIP 197,005,658631,Neal; Sonya E,9998,0,9999,1
1715609402307,AIP 197,006,658671,Du; Songzi,9998,0,9999,1
1715609403333,ANAR 135S,A00,494369,Braswell; Geoffrey E.,0,0,0,0
1715609404360,BENG 196,001,628496,Engler; Adam J.,9998,0,9999,1
1715609404360,BENG 196,002,660916,Watson; John Thomas,9999,0,9999,0
1715609405387,BISP 197,001,650773,Wilhelm; James E.,9994,0,9999,5
1715609405387,BISP 197,002,658904,Coleman; Aaron B.,9998,0,9999,1
1715609406415,CAT 124RS,A01,519847,Geibel; William,0,0,20,20
1715609407441,CAT 125RS,A01,515971,Geibel; William,0,0,20,20
1715609408471,CLRE 250,A00,511389,Morris; Sheldon,9992,0,9999,7
1715609409498,CLRE 251,A00,507176,Mehta; Ravindra L.,9992,0,9999,7
1715609409498,CLRE 251,B00,511410,Mehta; Ravindra L.,9998,0,9999,1
1715609410529,CLRE 252,A00,507189,Cuomo; Raphael Eduardo,9994,0,9999,5
1715609411557,CLRE 253,A00,507199,Vaida; Florin,9994,0,9999,5
1715609411557,CLRE 253,B00,507202,Vaida; Florin,9999,0,9999,0
1715609412582,CLRE 259,A00,507211,Patel; Hemal,9996,0,9999,3
1715609413607,CLRE 260,A00,507221,Cuomo; Raphael Eduardo,9999,0,9999,0
1715609414635,CLRE 297,001,507242,Cuomo; Raphael Eduardo,9999,0,9999,0
1715609415663,COGS 197,001,638244,Voytek; Bradley Thomas,9997,0,9999,2
1715609416691,CSE 191,A00,516875,Minnes Kemp; Mor Mia,9991,0,9999,8
1715609417717,CSE 197,001,637388,Minnes Kemp; Mor Mia,9992,0,9999,7
1715609418744,CSS 201S,A01,494383,Mignozzetti; Umberto,35,0,35,0
1715609419771,CSS 202S,A01,494387,Mignozzetti; Umberto,35,0,35,0
1715609420801,DSC 197,001,628532,Eldridge; Justin Matthew,9995,0,9999,4
1715609421828,EAP 100,A00,516065,Staff,9799,0,9999,200
1715609422854,ECE 45,A01,507414,Staff,31,0,60,29
1715609424923,ECE 111,A01,507420,Staff,11,0,50,39
1715609425952,ECE 197,001,548057,Sievenpiper; Daniel F.,9991,0,9999,8
1715609426985,EDS 115,A00,507243,Choi; Bailey Miyeon,7,0,28,21
1715609428010,EDS 117,A01,494379,Staff,0,6,34,34
1715609429036,EDS 125,A00,507246,Hopkins; Megan Beth,8,0,30,22
1715609430062,EDS 128A,A01,507264,Fargason; Sharon Gayle,6,0,26,20
1715609431090,EDS 128B,A01,507293,Pappas; Elizabeth,10,0,30,20
1715609432119,EDS 139,A00,507294,Fargason; Sharon Gayle,10,0,30,20
1715609432119,EDS 139,B00,507313,Pappas; Elizabeth,11,0,30,19
1715609433144,EDS 201,A00,507315,Staff,10,0,30,20
1715609434174,EDS 203,A01,507317,Halter; Christopher P.,10,0,30,20
1715609435203,EDS 204R,A01,507319,Halter; Christopher P.,0,3,30,30
1715609435203,EDS 204R,B01,507331,Heinzman; Erica M.,14,0,30,16
1715609436229,EDS 206R,A00,507332,Staff,0,4,30,30
1715609436229,EDS 206R,B00,507343,Staff,15,0,30,15
1715609437260,EDS 250,A00,507344,Hemans; Patricia Ann Benitez,20,0,40,20
1715609438289,EDS 281,A00,507345,Daly; Alan J.,18,0,18,0
1715609439315,EDS 284,A00,507350,Daly; Alan J.,16,0,16,0
1715609440341,EDS 286,A00,507359,Fine; Sarah,18,0,18,0
1715609441368,EDS 289C,A01,507361,Daly; Alan J.,18,0,18,0
1715609442394,EDS 290,A00,507366,Hofstetter; Carolyn,15,0,15,0
1715609443436,LIGM 5A,A00,507421,Fischer-Grunski; Eva K,17,0,20,3
1715609444463,LIGM 5B,A00,507423,Fischer-Grunski; Eva K,19,0,20,1
1715609445491,LIGM 5C,A00,507425,Fischer-Grunski; Eva K,19,0,20,1
1715609446521,LIIT 5AS,A00,507427,Carnelos; Chiara,20,0,20,0
1715609447551,LIIT 5BS,A00,507430,Carnelos; Chiara,20,0,20,0
1715609448581,LIIT 5CS,A00,507432,Carnelos; Chiara,20,0,20,0
1715609449613,LISP 5A,A00,507541,Munoz Sanchez; Alicia,11,0,20,9
1715609450640,LISP 5B,A00,507671,Munoz Sanchez; Alicia,9,0,20,11
1715609451668,LISP 5C,A00,507696,Munoz Sanchez; Alicia,9,0,20,11
1715609452696,MAE 197,001,528363,Boechler; Nicholas Sebastia,9998,0,9999,1
1715609453725,MATH 197,001,523477,Kedlaya; Kiran S.,9994,0,9999,5
1715609453725,MATH 197,002,563811,Zhang; Danna,9994,0,9999,5
1715609453725,MATH 197,003,628552,Dumitriu; Ioana,9998,0,9999,1
1715609453725,MATH 197,004,660885,Floyd; Eric,9999,0,9999,0
1715609454751,MCWP 40R,A00,518780,Staff,2,0,20,18
1715609454751,MCWP 40R,B00,518781,Staff,11,0,20,9
1715609454751,MCWP 40R,C00,518783,Staff,5,0,20,15
1715609455777,MCWP 50R,A00,518791,Staff,0,1,20,20
1715609455777,MCWP 50R,B00,518792,Staff,0,2,20,20
1715609455777,MCWP 50R,C00,518793,Staff,0,4,20,20
1715609455777,MCWP 50R,D00,518794,Staff,0,1,20,20
1715609455777,MCWP 50R,E00,518795,Staff,0,2,20,20
1715609455777,MCWP 50R,F00,518796,Staff,0,1,20,20
1715609455777,MCWP 50R,G00,518797,Staff,0,1,20,20
1715609456803,MMW 12R,A01,514034,Herbst; Matthew,0,2,16,16
1715609456803,MMW 12R,A02,514035,Herbst; Matthew,0,0,16,16
1715609457829,MMW 13R,A01,514037,Staff,0,5,16,16
1715609457829,MMW 13R,A02,514039,Staff,0,5,16,16
1715609457829,MMW 13R,A03,628519,Staff,0,4,16,16
1715609459882,SIO 295LS,A00,523233,Staff,10,0,30,20
1715609460907,SIO 295S,A00,523232,Staff,10,0,30,20
1715609461933,SIOC 290S,A01,637330,Merrifield; Mark A,23,0,30,7
1715609462960,SIOC 291S,A01,637333,Gabriel; Corey John,23,0,30,7
1715609463987,SOCI 117,A01,494376,Staff,0,5,5,5
1715609465012,WES 237B,A00,494380,Staff,10,0,20,10
1715609467093,AESE 279B,A00,494370,Wade; Jon P,0,0,33,33
1715609468122,AIP 97,001,660915,Van Den Einde; Yael Dahlia,9999,0,9999,0
1715609469155,AIP 197,001,627712,Vespa; Emanuel Ignacio,9995,0,9999,4
1715609469155,AIP 197,002,650778,Amir; On,9998,0,9999,1
1715609469155,AIP 197,003,650933,Avenancio-Leon; Carlos,9998,0,9999,1
1715609469155,AIP 197,004,658530,Heyman; Gail D.,9998,0,9999,1
1715609469155,AIP 197,005,658631,Neal; Sonya E,9998,0,9999,1
1715609469155,AIP 197,006,658671,Du; Songzi,9998,0,9999,1
1715609470183,ANAR 135S,A00,494369,Braswell; Geoffrey E.,0,0,0,0
1715609471209,BENG 196,001,628496,Engler; Adam J.,9998,0,9999,1
1715609471209,BENG 196,002,660916,Watson; John Thomas,9999,0,9999,0
1715609472236,BISP 197,001,650773,Wilhelm; James E.,9994,0,9999,5
1715609472236,BISP 197,002,658904,Coleman; Aaron B.,9998,0,9999,1
1715609473263,CAT 124RS,A01,519847,Geibel; William,0,0,20,20
1715609474289,CAT 125RS,A01,515971,Geibel; William,0,0,20,20
1715609475315,CLRE 250,A00,511389,Morris; Sheldon,9992,0,9999,7
1715609476345,CLRE 251,A00,507176,Mehta; Ravindra L.,9992,0,9999,7
1715609476345,CLRE 251,B00,511410,Mehta; Ravindra L.,9998,0,9999,1
1715609477372,CLRE 252,A00,507189,Cuomo; Raphael Eduardo,9994,0,9999,5
1715609478398,CLRE 253,A00,507199,Vaida; Florin,9994,0,9999,5
1715609478398,CLRE 253,B00,507202,Vaida; Florin,9999,0,9999,0
1715609479426,CLRE 259,A00,507211,Patel; Hemal,9996,0,9999,3
1715609480505,CLRE 260,A00,507221,Cuomo; Raphael Eduardo,9999,0,9999,0
1715609481531,CLRE 297,001,507242,Cuomo; Raphael Eduardo,9999,0,9999,0
1715609482558,COGS 197,001,638244,Voytek; Bradley Thomas,9997,0,9999,2
1715609483584,CSE 191,A00,516875,Minnes Kemp; Mor Mia,9991,0,9999,8
1715609484609,CSE 197,001,637388,Minnes Kemp; Mor Mia,9992,0,9999,7
1715609485635,CSS 201S,A01,494383,Mignozzetti; Umberto,35,0,35,0
1715609486661,CSS 202S,A01,494387,Mignozzetti; Umberto,35,0,35,0
1715609487690,DSC 197,001,628532,Eldridge; Justin Matthew,9995,0,9999,4
1715609488716,EAP 100,A00,516065,Staff,9799,0,9999,200
1715609489748,ECE 45,A01,507414,Staff,31,0,60,29
1715609491804,ECE 111,A01,507420,Staff,11,0,50,39
1715609492831,ECE 197,001,548057,Sievenpiper; Daniel F.,9991,0,9999,8
1715609493870,EDS 115,A00,507243,Choi; Bailey Miyeon,7,0,28,21
1715609494898,EDS 117,A01,494379,Staff,0,6,34,34
1715609495928,EDS 125,A00,507246,Hopkins; Megan Beth,8,0,30,22
1715609496959,EDS 128A,A01,507264,Fargason; Sharon Gayle,6,0,26,20
1715609497984,EDS 128B,A01,507293,Pappas; Elizabeth,10,0,30,20
1715609499014,EDS 139,A00,507294,Fargason; Sharon Gayle,10,0,30,20
1715609499014,EDS 139,B00,507313,Pappas; Elizabeth,11,0,30,19
1715609500038,EDS 201,A00,507315,Staff,10,0,30,20
1715609501063,EDS 203,A01,507317,Halter; Christopher P.,10,0,30,20
1715609502090,EDS 204R,A01,507319,Halter; Christopher P.,0,3,30,30
1715609502090,EDS 204R,B01,507331,Heinzman; Erica M.,14,0,30,16
1715609503117,EDS 206R,A00,507332,Staff,0,4,30,30
1715609503117,EDS 206R,B00,507343,Staff,15,0,30,15
1715609504145,EDS 250,A00,507344,Hemans; Patricia Ann Benitez,20,0,40,20
1715609505172,EDS 281,A00,507345,Daly; Alan J.,18,0,18,0
1715609506198,EDS 284,A00,507350,Daly; Alan J.,16,0,16,0
1715609507224,EDS 286,A00,507359,Fine; Sarah,18,0,18,0
1715609508254,EDS 289C,A01,507361,Daly; Alan J.,18,0,18,0
1715609509283,EDS 290,A00,507366,Hofstetter; Carolyn,15,0,15,0
1715609510310,LIGM 5A,A00,507421,Fischer-Grunski; Eva K,17,0,20,3
1715609511337,LIGM 5B,A00,507423,Fischer-Grunski; Eva K,19,0,20,1
1715609512367,LIGM 5C,A00,507425,Fischer-Grunski; Eva K,19,0,20,1
1715609513397,LIIT 5AS,A00,507427,Carnelos; Chiara,20,0,20,0
1715609514421,LIIT 5BS,A00,507430,Carnelos; Chiara,20,0,20,0
1715609515448,LIIT 5CS,A00,507432,Carnelos; Chiara,20,0,20,0
1715609516480,LISP 5A,A00,507541,Munoz Sanchez; Alicia,11,0,20,9
1715609517509,LISP 5B,A00,507671,Munoz Sanchez; Alicia,9,0,20,11
1715609518535,LISP 5C,A00,507696,Munoz Sanchez; Alicia,9,0,20,11
1715609519562,MAE 197,001,528363,Boechler; Nicholas Sebastia,9998,0,9999,1
1715609520594,MATH 197,001,523477,Kedlaya; Kiran S.,9994,0,9999,5
1715609520594,MATH 197,002,563811,Zhang; Danna,9994,0,9999,5
1715609520594,MATH 197,003,628552,Dumitriu; Ioana,9998,0,9999,1
1715609520594,MATH 197,004,660885,Floyd; Eric,9999,0,9999,0
1715609521626,MCWP 40R,A00,518780,Staff,2,0,20,18
1715609521626,MCWP 40R,B00,518781,Staff,11,0,20,9
1715609521626,MCWP 40R,C00,518783,Staff,5,0,20,15
1715609522656,MCWP 50R,A00,518791,Staff,0,1,20,20
1715609522656,MCWP 50R,B00,518792,Staff,0,2,20,20
1715609522656,MCWP 50R,C00,518793,Staff,0,4,20,20
1715609522656,MCWP 50R,D00,518794,Staff,0,1,20,20
1715609522656,MCWP 50R,E00,518795,Staff,0,2,20,20
1715609522656,MCWP 50R,F00,518796,Staff,0,1,20,20
1715609522656,MCWP 50R,G00,518797,Staff,0,1,20,20
1715609523684,MMW 12R,A01,514034,Herbst; Matthew,0,2,16,16
1715609523684,MMW 12R,A02,514035,Herbst; Matthew,0,0,16,16
1715609524709,MMW 13R,A01,514037,Staff,0,5,16,16
1715609524709,MMW 13R,A02,514039,Staff,0,5,16,16
1715609524709,MMW 13R,A03,628519,Staff,0,4,16,16
1715609526762,SIO 295LS,A00,523233,Staff,10,0,30,20
1715609527786,SIO 295S,A00,523232,Staff,10,0,30,20
1715609528816,SIOC 290S,A01,637330,Merrifield; Mark A,23,0,30,7
1715609529843,SIOC 291S,A01,637333,Gabriel; Corey John,23,0,30,7
1715609530869,SOCI 117,A01,494376,Staff,0,5,5,5
1715609531897,WES 237B,A00,494380,Staff,10,0,20,10
1715609533989,AESE 279B,A00,494370,Wade; Jon P,0,0,33,33
1715609535014,AIP 97,001,660915,Van Den Einde; Yael Dahlia,9999,0,9999,0
1715609536048,AIP 197,001,627712,Vespa; Emanuel Ignacio,9995,0,9999,4
1715609536048,AIP 197,002,650778,Amir; On,9998,0,9999,1
1715609536048,AIP 197,003,650933,Avenancio-Leon; Carlos,9998,0,9999,1
1715609536048,AIP 197,004,658530,Heyman; Gail D.,9998,0,9999,1
1715609536048,AIP 197,005,658631,Neal; Sonya E,9998,0,9999,1
1715609536048,AIP 197,006,658671,Du; Songzi,9998,0,9999,1
1715609537075,ANAR 135S,A00,494369,Braswell; Geoffrey E.,0,0,0,0
1715609538105,BENG 196,001,628496,Engler; Adam J.,9998,0,9999,1
1715609538105,BENG 196,002,660916,Watson; John Thomas,9999,0,9999,0
1715609539130,BISP 197,001,650773,Wilhelm; James E.,9994,0,9999,5
1715609539130,BISP 197,002,658904,Coleman; Aaron B.,9998,0,9999,1
1715609540157,CAT 124RS,A01,519847,Geibel; William,0,0,20,20
1715609541185,CAT 125RS,A01,515971,Geibel; William,0,0,20,20
1715609542213,CLRE 250,A00,511389,Morris; Sheldon,9992,0,9999,7
1715609543242,CLRE 251,A00,507176,Mehta; Ravindra L.,9992,0,9999,7
1715609543242,CLRE 251,B00,511410,Mehta; Ravindra L.,9998,0,9999,1
1715609544268,CLRE 252,A00,507189,Cuomo; Raphael Eduardo,9994,0,9999,5
1715609545295,CLRE 253,A00,507199,Vaida; Florin,9994,0,9999,5
1715609545295,CLRE 253,B00,507202,Vaida; Florin,9999,0,9999,0
1715609546324,CLRE 259,A00,507211,Patel; Hemal,9996,0,9999,3
1715609547349,CLRE 260,A00,507221,Cuomo; Raphael Eduardo,9999,0,9999,0
1715609548375,CLRE 297,001,507242,Cuomo; Raphael Eduardo,9999,0,9999,0
1715609549402,COGS 197,001,638244,Voytek; Bradley Thomas,9997,0,9999,2
1715609550428,CSE 191,A00,516875,Minnes Kemp; Mor Mia,9991,0,9999,8
1715609551453,CSE 197,001,637388,Minnes Kemp; Mor Mia,9992,0,9999,7
1715609552486,CSS 201S,A01,494383,Mignozzetti; Umberto,35,0,35,0
1715609553517,CSS 202S,A01,494387,Mignozzetti; Umberto,35,0,35,0
1715609554543,DSC 197,001,628532,Eldridge; Justin Matthew,9995,0,9999,4
1715609555568,EAP 100,A00,516065,Staff,9799,0,9999,200
1715609556605,ECE 45,A01,507414,Staff,31,0,60,29
1715609558659,ECE 111,A01,507420,Staff,11,0,50,39
1715609559690,ECE 197,001,548057,Sievenpiper; Daniel F.,9991,0,9999,8
1715609560716,EDS 115,A00,507243,Choi; Bailey Miyeon,7,0,28,21
1715609561742,EDS 117,A01,494379,Staff,0,6,34,34
1715609562771,EDS 125,A00,507246,Hopkins; Megan Beth,8,0,30,22
1715609563800,EDS 128A,A01,507264,Fargason; Sharon Gayle,6,0,26,20
1715609564827,EDS 128B,A01,507293,Pappas; Elizabeth,10,0,30,20
1715609565855,EDS 139,A00,507294,Fargason; Sharon Gayle,10,0,30,20
1715609565855,EDS 139,B00,507313,Pappas; Elizabeth,11,0,30,19
1715609566881,EDS 201,A00,507315,Staff,10,0,30,20
1715609567906,EDS 203,A01,507317,Halter; Christopher P.,10,0,30,20
1715609568934,EDS 204R,A01,507319,Halter; Christopher P.,0,3,30,30
1715609568934,EDS 204R,B01,507331,Heinzman; Erica M.,14,0,30,16
1715609569961,EDS 206R,A00,507332,Staff,0,4,30,30
1715609569961,EDS 206R,B00,507343,Staff,15,0,30,15
1715609570986,EDS 250,A00,507344,Hemans; Patricia Ann Benitez,20,0,40,20
1715609572014,EDS 281,A00,507345,Daly; Alan J.,18,0,18,0
1715609573041,EDS 284,A00,507350,Daly; Alan J.,16,0,16,0
1715609574067,EDS 286,A00,507359,Fine; Sarah,18,0,18,0
1715609575092,EDS 289C,A01,507361,Daly; Alan J.,18,0,18,0
1715609576120,EDS 290,A00,507366,Hofstetter; Carolyn,15,0,15,0
1715609577147,LIGM 5A,A00,507421,Fischer-Grunski; Eva K,17,0,20,3
1715609578173,LIGM 5B,A00,507423,Fischer-Grunski; Eva K,19,0,20,1
1715609579201,LIGM 5C,A00,507425,Fischer-Grunski; Eva K,19,0,20,1
1715609580228,LIIT 5AS,A00,507427,Carnelos; Chiara,20,0,20,0
1715609581253,LIIT 5BS,A00,507430,Carnelos; Chiara,20,0,20,0
1715609582279,LIIT 5CS,A00,507432,Carnelos; Chiara,20,0,20,0
1715609583310,LISP 5A,A00,507541,Munoz Sanchez; Alicia,11,0,20,9
1715609584396,LISP 5B,A00,507671,Munoz Sanchez; Alicia,9,0,20,11
1715609585423,LISP 5C,A00,507696,Munoz Sanchez; Alicia,9,0,20,11
1715609586449,MAE 197,001,528363,Boechler; Nicholas Sebastia,9998,0,9999,1
1715609587484,MATH 197,001,523477,Kedlaya; Kiran S.,9994,0,9999,5
1715609587484,MATH 197,002,563811,Zhang; Danna,9994,0,9999,5
1715609587484,MATH 197,003,628552,Dumitriu; Ioana,9998,0,9999,1
1715609587484,MATH 197,004,660885,Floyd; Eric,9999,0,9999,0
1715609588510,MCWP 40R,A00,518780,Staff,2,0,20,18
1715609588510,MCWP 40R,B00,518781,Staff,11,0,20,9
1715609588510,MCWP 40R,C00,518783,Staff,5,0,20,15
1715609589539,MCWP 50R,A00,518791,Staff,0,1,20,20
1715609589539,MCWP 50R,B00,518792,Staff,0,2,20,20
1715609589539,MCWP 50R,C00,518793,Staff,0,4,20,20
1715609589539,MCWP 50R,D00,518794,Staff,0,1,20,20
1715609589539,MCWP 50R,E00,518795,Staff,0,2,20,20
1715609589539,MCWP 50R,F00,518796,Staff,0,1,20,20
1715609589539,MCWP 50R,G00,518797,Staff,0,1,20,20
1715609590570,MMW 12R,A01,514034,Herbst; Matthew,0,2,16,16
1715609590570,MMW 12R,A02,514035,Herbst; Matthew,0,0,16,16
1715609591597,MMW 13R,A01,514037,Staff,0,5,16,16
1715609591597,MMW 13R,A02,514039,Staff,0,5,16,16
1715609591597,MMW 13R,A03,628519,Staff,0,4,16,16
1715609593647,SIO 295LS,A00,523233,Staff,10,0,30,20
1715609594675,SIO 295S,A00,523232,Staff,10,0,30,20
1715609595708,SIOC 290S,A01,637330,Merrifield; Mark A,23,0,30,7
1715609596733,SIOC 291S,A01,637333,Gabriel; Corey John,23,0,30,7
1715609597759,SOCI 117,A01,494376,Staff,0,5,5,5
1715609598785,WES 237B,A00,494380,Staff,10,0,20,10
1715609600862,AESE 279B,A00,494370,Wade; Jon P,0,0,33,33
1715609601889,AIP 97,001,660915,Van Den Einde; Yael Dahlia,9999,0,9999,0
1715609602916,AIP 197,001,627712,Vespa; Emanuel Ignacio,9995,0,9999,4
1715609602916,AIP 197,002,650778,Amir; On,9998,0,9999,1
1715609602916,AIP 197,003,650933,Avenancio-Leon; Carlos,9998,0,9999,1
1715609602916,AIP 197,004,658530,Heyman; Gail D.,9998,0,9999,1
1715609602916,AIP 197,005,658631,Neal; Sonya E,9998,0,9999,1
1715609602916,AIP 197,006,658671,Du; Songzi,9998,0,9999,1
1715609603945,ANAR 135S,A00,494369,Braswell; Geoffrey E.,0,0,0,0
1715609604973,BENG 196,001,628496,Engler; Adam J.,9998,0,9999,1
1715609604973,BENG 196,002,660916,Watson; John Thomas,9999,0,9999,0
1715609605999,BISP 197,001,650773,Wilhelm; James E.,9994,0,9999,5
1715609605999,BISP 197,002,658904,Coleman; Aaron B.,9998,0,9999,1
1715609607027,CAT 124RS,A01,519847,Geibel; William,0,0,20,20
1715609608052,CAT 125RS,A01,515971,Geibel; William,0,0,20,20
1715609609081,CLRE 250,A00,511389,Morris; Sheldon,9992,0,9999,7
1715609610116,CLRE 251,A00,507176,Mehta; Ravindra L.,9992,0,9999,7
1715609610116,CLRE 251,B00,511410,Mehta; Ravindra L.,9998,0,9999,1
1715609611145,CLRE 252,A00,507189,Cuomo; Raphael Eduardo,9994,0,9999,5
1715609612178,CLRE 253,A00,507199,Vaida; Florin,9994,0,9999,5
1715609612178,CLRE 253,B00,507202,Vaida; Florin,9999,0,9999,0
1715609613204,CLRE 259,A00,507211,Patel; Hemal,9996,0,9999,3
1715609614229,CLRE 260,A00,507221,Cuomo; Raphael Eduardo,9999,0,9999,0
1715609615254,CLRE 297,001,507242,Cuomo; Raphael Eduardo,9999,0,9999,0
1715609616280,COGS 197,001,638244,Voytek; Bradley Thomas,9997,0,9999,2
1715609617308,CSE 191,A00,516875,Minnes Kemp; Mor Mia,9991,0,9999,8
1715609618333,CSE 197,001,637388,Minnes Kemp; Mor Mia,9992,0,9999,7
1715609619364,CSS 201S,A01,494383,Mignozzetti; Umberto,35,0,35,0
1715609620391,CSS 202S,A01,494387,Mignozzetti; Umberto,35,0,35,0
1715609621419,DSC 197,001,628532,Eldridge; Justin Matthew,9995,0,9999,4
1715609622445,EAP 100,A00,516065,Staff,9799,0,9999,200
1715609623473,ECE 45,A01,507414,Staff,31,0,60,29
1715609625524,ECE 111,A01,507420,Staff,11,0,50,39
1715609626550,ECE 197,001,548057,Sievenpiper; Daniel F.,9991,0,9999,8
1715609627576,EDS 115,A00,507243,Choi; Bailey Miyeon,7,0,28,21
1715609628606,EDS 117,A01,494379,Staff,0,6,34,34
1715609629632,EDS 125,A00,507246,Hopkins; Megan Beth,8,0,30,22
1715609630661,EDS 128A,A01,507264,Fargason; Sharon Gayle,6,0,26,20
1715609631689,EDS 128B,A01,507293,Pappas; Elizabeth,10,0,30,20
1715609632718,EDS 139,A00,507294,Fargason; Sharon Gayle,10,0,30,20
1715609632718,EDS 139,B00,507313,Pappas; Elizabeth,11,0,30,19
1715609633744,EDS 201,A00,507315,Staff,10,0,30,20
1715609634771,EDS 203,A01,507317,Halter; Christopher P.,10,0,30,20
1715609635796,EDS 204R,A01,507319,Halter; Christopher P.,0,3,30,30
1715609635796,EDS 204R,B01,507331,Heinzman; Erica M.,14,0,30,16
1715609636822,EDS 206R,A00,507332,Staff,0,4,30,30
1715609636822,EDS 206R,B00,507343,Staff,15,0,30,15
1715609637850,EDS 250,A00,507344,Hemans; Patricia Ann Benitez,20,0,40,20
1715609638879,EDS 281,A00,507345,Daly; Alan J.,18,0,18,0
1715609639904,EDS 284,A00,507350,Daly; Alan J.,16,0,16,0
1715609640929,EDS 286,A00,507359,Fine; Sarah,18,0,18,0
1715609641954,EDS 289C,A01,507361,Daly; Alan J.,18,0,18,0
1715609642980,EDS 290,A00,507366,Hofstetter; Carolyn,15,0,15,0
1715609644007,LIGM 5A,A00,507421,Fischer-Grunski; Eva K,17,0,20,3
1715609645034,LIGM 5B,A00,507423,Fischer-Grunski; Eva K,19,0,20,1
1715609646060,LIGM 5C,A00,507425,Fischer-Grunski; Eva K,19,0,20,1
1715609647091,LIIT 5AS,A00,507427,Carnelos; Chiara,20,0,20,0
1715609648119,LIIT 5BS,A00,507430,Carnelos; Chiara,20,0,20,0
1715609649146,LIIT 5CS,A00,507432,Carnelos; Chiara,20,0,20,0
1715609650171,LISP 5A,A00,507541,Munoz Sanchez; Alicia,11,0,20,9
1715609651198,LISP 5B,A00,507671,Munoz Sanchez; Alicia,9,0,20,11
1715609652225,LISP 5C,A00,507696,Munoz Sanchez; Alicia,9,0,20,11
1715609653251,MAE 197,001,528363,Boechler; Nicholas Sebastia,9998,0,9999,1
1715609654283,MATH 197,001,523477,Kedlaya; Kiran S.,9994,0,9999,5
1715609654283,MATH 197,002,563811,Zhang; Danna,9994,0,9999,5
1715609654283,MATH 197,003,628552,Dumitriu; Ioana,9998,0,9999,1
1715609654283,MATH 197,004,660885,Floyd; Eric,9999,0,9999,0
1715609655310,MCWP 40R,A00,518780,Staff,2,0,20,18
1715609655310,MCWP 40R,B00,518781,Staff,11,0,20,9
1715609655310,MCWP 40R,C00,518783,Staff,5,0,20,15
1715609656341,MCWP 50R,A00,518791,Staff,0,1,20,20
1715609656341,MCWP 50R,B00,518792,Staff,0,2,20,20
1715609656341,MCWP 50R,C00,518793,Staff,0,4,20,20
1715609656341,MCWP 50R,D00,518794,Staff,0,1,20,20
1715609656341,MCWP 50R,E00,518795,Staff,0,2,20,20
1715609656341,MCWP 50R,F00,518796,Staff,0,1,20,20
1715609656341,MCWP 50R,G00,518797,Staff,0,1,20,20
1715609657368,MMW 12R,A01,514034,Herbst; Matthew,0,2,16,16
1715609657368,MMW 12R,A02,514035,Herbst; Matthew,0,0,16,16
1715609658393,MMW 13R,A01,514037,Staff,0,5,16,16
1715609658393,MMW 13R,A02,514039,Staff,0,5,16,16
1715609658393,MMW 13R,A03,628519,Staff,0,4,16,16
1715609660444,SIO 295LS,A00,523233,Staff,10,0,30,20
1715609661472,SIO 295S,A00,523232,Staff,10,0,30,20
1715609662503,SIOC 290S,A01,637330,Merrifield; Mark A,23,0,30,7
1715609663530,SIOC 291S,A01,637333,Gabriel; Corey John,23,0,30,7
1715609664558,SOCI 117,A01,494376,Staff,0,5,5,5
1715609665584,WES 237B,A00,494380,Staff,10,0,20,10
1715609667661,AESE 279B,A00,494370,Wade; Jon P,0,0,33,33
1715609668686,AIP 97,001,660915,Van Den Einde; Yael Dahlia,9999,0,9999,0
1715609669715,AIP 197,001,627712,Vespa; Emanuel Ignacio,9995,0,9999,4
1715609669715,AIP 197,002,650778,Amir; On,9998,0,9999,1
1715609669715,AIP 197,003,650933,Avenancio-Leon; Carlos,9998,0,9999,1
1715609669715,AIP 197,004,658530,Heyman; Gail D.,9998,0,9999,1
1715609669715,AIP 197,005,658631,Neal; Sonya E,9998,0,9999,1
1715609669715,AIP 197,006,658671,Du; Songzi,9998,0,9999,1
1715609670746,ANAR 135S,A00,494369,Braswell; Geoffrey E.,0,0,0,0
1715609671772,BENG 196,001,628496,Engler; Adam J.,9998,0,9999,1
1715609671772,BENG 196,002,660916,Watson; John Thomas,9999,0,9999,0
1715609672800,BISP 197,001,650773,Wilhelm; James E.,9994,0,9999,5
1715609672800,BISP 197,002,658904,Coleman; Aaron B.,9998,0,9999,1
1715609673825,CAT 124RS,A01,519847,Geibel; William,0,0,20,20
1715609674851,CAT 125RS,A01,515971,Geibel; William,0,0,20,20
1715609675878,CLRE 250,A00,511389,Morris; Sheldon,9992,0,9999,7
1715609676905,CLRE 251,A00,507176,Mehta; Ravindra L.,9992,0,9999,7
1715609676905,CLRE 251,B00,511410,Mehta; Ravindra L.,9998,0,9999,1
1715609677932,CLRE 252,A00,507189,Cuomo; Raphael Eduardo,9994,0,9999,5
1715609678959,CLRE 253,A00,507199,Vaida; Florin,9994,0,9999,5
1715609678959,CLRE 253,B00,507202,Vaida; Florin,9999,0,9999,0
1715609679984,CLRE 259,A00,507211,Patel; Hemal,9996,0,9999,3
1715609681016,CLRE 260,A00,507221,Cuomo; Raphael Eduardo,9999,0,9999,0
1715609682042,CLRE 297,001,507242,Cuomo; Raphael Eduardo,9999,0,9999,0
1715609683071,COGS 197,001,638244,Voytek; Bradley Thomas,9997,0,9999,2
1715609684098,CSE 191,A00,516875,Minnes Kemp; Mor Mia,9991,0,9999,8
1715609685122,CSE 197,001,637388,Minnes Kemp; Mor Mia,9992,0,9999,7
1715609686148,CSS 201S,A01,494383,Mignozzetti; Umberto,35,0,35,0
1715609687174,CSS 202S,A01,494387,Mignozzetti; Umberto,35,0,35,0
1715609688257,DSC 197,001,628532,Eldridge; Justin Matthew,9995,0,9999,4
1715609689284,EAP 100,A00,516065,Staff,9799,0,9999,200
1715609690312,ECE 45,A01,507414,Staff,31,0,60,29
1715609692362,ECE 111,A01,507420,Staff,11,0,50,39
1715609693388,ECE 197,001,548057,Sievenpiper; Daniel F.,9991,0,9999,8
1715609694415,EDS 115,A00,507243,Choi; Bailey Miyeon,7,0,28,21
1715609695442,EDS 117,A01,494379,Staff,0,6,34,34
1715609696469,EDS 125,A00,507246,Hopkins; Megan Beth,8,0,30,22
1715609697495,EDS 128A,A01,507264,Fargason; Sharon Gayle,6,0,26,20
1715609698522,EDS 128B,A01,507293,Pappas; Elizabeth,10,0,30,20
1715609699548,EDS 139,A00,507294,Fargason; Sharon Gayle,10,0,30,20
1715609699548,EDS 139,B00,507313,Pappas; Elizabeth,11,0,30,19
1715609700577,EDS 201,A00,507315,Staff,10,0,30,20
1715609701607,EDS 203,A01,507317,Halter; Christopher P.,10,0,30,20
1715609702633,EDS 204R,A01,507319,Halter; Christopher P.,0,3,30,30
1715609702633,EDS 204R,B01,507331,Heinzman; Erica M.,14,0,30,16
1715609704713,EDS 206R,A00,507332,Staff,0,4,30,30
1715609704713,EDS 206R,B00,507343,Staff,15,0,30,15
1715609705739,EDS 250,A00,507344,Hemans; Patricia Ann Benitez,20,0,40,20
1715609706768,EDS 281,A00,507345,Daly; Alan J.,18,0,18,0
1715609707794,EDS 284,A00,507350,Daly; Alan J.,16,0,16,0
1715609708820,EDS 286,A00,507359,Fine; Sarah,18,0,18,0
1715609709849,EDS 289C,A01,507361,Daly; Alan J.,18,0,18,0
1715609710881,EDS 290,A00,507366,Hofstetter; Carolyn,15,0,15,0
1715609711910,LIGM 5A,A00,507421,Fischer-Grunski; Eva K,17,0,20,3
1715609712936,LIGM 5B,A00,507423,Fischer-Grunski; Eva K,19,0,20,1
1715609713965,LIGM 5C,A00,507425,Fischer-Grunski; Eva K,19,0,20,1
1715609714994,LIIT 5AS,A00,507427,Carnelos; Chiara,20,0,20,0
1715609716025,LIIT 5BS,A00,507430,Carnelos; Chiara,20,0,20,0
1715609717051,LIIT 5CS,A00,507432,Carnelos; Chiara,20,0,20,0
1715609718078,LISP 5A,A00,507541,Munoz Sanchez; Alicia,11,0,20,9
1715609719103,LISP 5B,A00,507671,Munoz Sanchez; Alicia,9,0,20,11
1715609720130,LISP 5C,A00,507696,Munoz Sanchez; Alicia,9,0,20,11
1715609721158,MAE 197,001,528363,Boechler; Nicholas Sebastia,9998,0,9999,1
1715609722191,MATH 197,001,523477,Kedlaya; Kiran S.,9994,0,9999,5
1715609722191,MATH 197,002,563811,Zhang; Danna,9994,0,9999,5
1715609722191,MATH 197,003,628552,Dumitriu; Ioana,9998,0,9999,1
1715609722191,MATH 197,004,660885,Floyd; Eric,9999,0,9999,0
1715609723218,MCWP 40R,A00,518780,Staff,2,0,20,18
1715609723218,MCWP 40R,B00,518781,Staff,11,0,20,9
1715609723218,MCWP 40R,C00,518783,Staff,5,0,20,15
1715609724249,MCWP 50R,A00,518791,Staff,0,1,20,20
1715609724249,MCWP 50R,B00,518792,Staff,0,2,20,20
1715609724249,MCWP 50R,C00,518793,Staff,0,4,20,20
1715609724249,MCWP 50R,D00,518794,Staff,0,1,20,20
1715609724249,MCWP 50R,E00,518795,Staff,0,2,20,20
1715609724249,MCWP 50R,F00,518796,Staff,0,1,20,20
1715609724249,MCWP 50R,G00,518797,Staff,0,1,20,20
1715609725275,MMW 12R,A01,514034,Herbst; Matthew,0,2,16,16
1715609725275,MMW 12R,A02,514035,Herbst; Matthew,0,0,16,16
1715609726302,MMW 13R,A01,514037,Staff,0,5,16,16
1715609726302,MMW 13R,A02,514039,Staff,0,5,16,16
1715609726302,MMW 13R,A03,628519,Staff,0,4,16,16
1715609728359,SIO 295LS,A00,523233,Staff,10,0,30,20
1715609729386,SIO 295S,A00,523232,Staff,10,0,30,20
1715609730416,SIOC 290S,A01,637330,Merrifield; Mark A,23,0,30,7
1715609731444,SIOC 291S,A01,637333,Gabriel; Corey John,23,0,30,7
1715609732475,SOCI 117,A01,494376,Staff,0,5,5,5
1715609733502,WES 237B,A00,494380,Staff,10,0,20,10
1715609735589,AESE 279B,A00,494370,Wade; Jon P,0,0,33,33
1715609736614,AIP 97,001,660915,Van Den Einde; Yael Dahlia,9999,0,9999,0
1715609737642,AIP 197,001,627712,Vespa; Emanuel Ignacio,9995,0,9999,4
1715609737642,AIP 197,002,650778,Amir; On,9998,0,9999,1
1715609737642,AIP 197,003,650933,Avenancio-Leon; Carlos,9998,0,9999,1
1715609737642,AIP 197,004,658530,Heyman; Gail D.,9998,0,9999,1
1715609737642,AIP 197,005,658631,Neal; Sonya E,9998,0,9999,1
1715609737642,AIP 197,006,658671,Du; Songzi,9998,0,9999,1
1715609738670,ANAR 135S,A00,494369,Braswell; Geoffrey E.,0,0,0,0
1715609739697,BENG 196,001,628496,Engler; Adam J.,9998,0,9999,1
1715609739697,BENG 196,002,660916,Watson; John Thomas,9999,0,9999,0
1715609740729,BISP 197,001,650773,Wilhelm; James E.,9994,0,9999,5
1715609740729,BISP 197,002,658904,Coleman; Aaron B.,9998,0,9999,1
1715609741755,CAT 124RS,A01,519847,Geibel; William,0,0,20,20
1715609742783,CAT 125RS,A01,515971,Geibel; William,0,0,20,20
1715609743809,CLRE 250,A00,511389,Morris; Sheldon,9992,0,9999,7
1715609744837,CLRE 251,A00,507176,Mehta; Ravindra L.,9992,0,9999,7
1715609744837,CLRE 251,B00,511410,Mehta; Ravindra L.,9998,0,9999,1
1715609745866,CLRE 252,A00,507189,Cuomo; Raphael Eduardo,9994,0,9999,5
1715609746893,CLRE 253,A00,507199,Vaida; Florin,9994,0,9999,5
1715609746893,CLRE 253,B00,507202,Vaida; Florin,9999,0,9999,0
1715609747920,CLRE 259,A00,507211,Patel; Hemal,9996,0,9999,3
1715609748949,CLRE 260,A00,507221,Cuomo; Raphael Eduardo,9999,0,9999,0
1715609749975,CLRE 297,001,507242,Cuomo; Raphael Eduardo,9999,0,9999,0
1715609751002,COGS 197,001,638244,Voytek; Bradley Thomas,9997,0,9999,2
1715609752031,CSE 191,A00,516875,Minnes Kemp; Mor Mia,9991,0,9999,8
1715609753057,CSE 197,001,637388,Minnes Kemp; Mor Mia,9992,0,9999,7
1715609754085,CSS 201S,A01,494383,Mignozzetti; Umberto,35,0,35,0
1715609755116,CSS 202S,A01,494387,Mignozzetti; Umberto,35,0,35,0
1715609756144,DSC 197,001,628532,Eldridge; Justin Matthew,9995,0,9999,4
1715609757168,EAP 100,A00,516065,Staff,9799,0,9999,200
1715609758197,ECE 45,A01,507414,Staff,31,0,60,29
1715609760252,ECE 111,A01,507420,Staff,11,0,50,39
1715609761279,ECE 197,001,548057,Sievenpiper; Daniel F.,9991,0,9999,8
1715609762309,EDS 115,A00,507243,Choi; Bailey Miyeon,7,0,28,21
1715609763336,EDS 117,A01,494379,Staff,0,6,34,34
1715609764362,EDS 125,A00,507246,Hopkins; Megan Beth,8,0,30,22
1715609765390,EDS 128A,A01,507264,Fargason; Sharon Gayle,6,0,26,20
1715609766419,EDS 128B,A01,507293,Pappas; Elizabeth,10,0,30,20
1715609767447,EDS 139,A00,507294,Fargason; Sharon Gayle,10,0,30,20
1715609767447,EDS 139,B00,507313,Pappas; Elizabeth,11,0,30,19
1715609768472,EDS 201,A00,507315,Staff,10,0,30,20
1715609769498,EDS 203,A01,507317,Halter; Christopher P.,10,0,30,20
1715609770525,EDS 204R,A01,507319,Halter; Christopher P.,0,3,30,30
1715609770525,EDS 204R,B01,507331,Heinzman; Erica M.,14,0,30,16
1715609771551,EDS 206R,A00,507332,Staff,0,4,30,30
1715609771551,EDS 206R,B00,507343,Staff,15,0,30,15
1715609772578,EDS 250,A00,507344,Hemans; Patricia Ann Benitez,20,0,40,20
1715609773607,EDS 281,A00,507345,Daly; Alan J.,18,0,18,0
1715609774633,EDS 284,A00,507350,Daly; Alan J.,16,0,16,0
1715609775662,EDS 286,A00,507359,Fine; Sarah,18,0,18,0
1715609776686,EDS 289C,A01,507361,Daly; Alan J.,18,0,18,0
1715609777714,EDS 290,A00,507366,Hofstetter; Carolyn,15,0,15,0
1715609778745,LIGM 5A,A00,507421,Fischer-Grunski; Eva K,17,0,20,3
1715609779772,LIGM 5B,A00,507423,Fischer-Grunski; Eva K,19,0,20,1
1715609780801,LIGM 5C,A00,507425,Fischer-Grunski; Eva K,19,0,20,1
1715609781826,LIIT 5AS,A00,507427,Carnelos; Chiara,20,0,20,0
1715609782856,LIIT 5BS,A00,507430,Carnelos; Chiara,20,0,20,0
1715609783897,LIIT 5CS,A00,507432,Carnelos; Chiara,20,0,20,0
1715609784927,LISP 5A,A00,507541,Munoz Sanchez; Alicia,11,0,20,9
1715609785954,LISP 5B,A00,507671,Munoz Sanchez; Alicia,9,0,20,11
1715609786982,LISP 5C,A00,507696,Munoz Sanchez; Alicia,9,0,20,11
1715609788011,MAE 197,001,528363,Boechler; Nicholas Sebastia,9998,0,9999,1
1715609789044,MATH 197,001,523477,Kedlaya; Kiran S.,9994,0,9999,5
1715609789044,MATH 197,002,563811,Zhang; Danna,9994,0,9999,5
1715609789044,MATH 197,003,628552,Dumitriu; Ioana,9998,0,9999,1
1715609789044,MATH 197,004,660885,Floyd; Eric,9999,0,9999,0
1715609790071,MCWP 40R,A00,518780,Staff,2,0,20,18
1715609790071,MCWP 40R,B00,518781,Staff,11,0,20,9
1715609790071,MCWP 40R,C00,518783,Staff,5,0,20,15
1715609791097,MCWP 50R,A00,518791,Staff,0,1,20,20
1715609791097,MCWP 50R,B00,518792,Staff,0,2,20,20
1715609791097,MCWP 50R,C00,518793,Staff,0,4,20,20
1715609791097,MCWP 50R,D00,518794,Staff,0,1,20,20
1715609791097,MCWP 50R,E00,518795,Staff,0,2,20,20
1715609791097,MCWP 50R,F00,518796,Staff,0,1,20,20
1715609791097,MCWP 50R,G00,518797,Staff,0,1,20,20
1715609792126,MMW 12R,A01,514034,Herbst; Matthew,0,2,16,16
1715609792126,MMW 12R,A02,514035,Herbst; Matthew,0,0,16,16
1715609793151,MMW 13R,A01,514037,Staff,0,5,16,16
1715609793151,MMW 13R,A02,514039,Staff,0,5,16,16
1715609793151,MMW 13R,A03,628519,Staff,0,4,16,16
1715609795207,SIO 295LS,A00,523233,Staff,10,0,30,20
1715609796294,SIO 295S,A00,523232,Staff,10,0,30,20
1715609797324,SIOC 290S,A01,637330,Merrifield; Mark A,23,0,30,7
1715609798353,SIOC 291S,A01,637333,Gabriel; Corey John,23,0,30,7
1715609799380,SOCI 117,A01,494376,Staff,0,5,5,5
1715609800405,WES 237B,A00,494380,Staff,10,0,20,10
1715609802490,AESE 279B,A00,494370,Wade; Jon P,0,0,33,33
1715609803516,AIP 97,001,660915,Van Den Einde; Yael Dahlia,9999,0,9999,0
1715609804548,AIP 197,001,627712,Vespa; Emanuel Ignacio,9995,0,9999,4
1715609804548,AIP 197,002,650778,Amir; On,9998,0,9999,1
1715609804548,AIP 197,003,650933,Avenancio-Leon; Carlos,9998,0,9999,1
1715609804548,AIP 197,004,658530,Heyman; Gail D.,9998,0,9999,1
1715609804548,AIP 197,005,658631,Neal; Sonya E,9998,0,9999,1
1715609804548,AIP 197,006,658671,Du; Songzi,9998,0,9999,1
1715609805577,ANAR 135S,A00,494369,Braswell; Geoffrey E.,0,0,0,0
1715609806603,BENG 196,001,628496,Engler; Adam J.,9998,0,9999,1
1715609806603,BENG 196,002,660916,Watson; John Thomas,9999,0,9999,0
1715609807632,BISP 197,001,650773,Wilhelm; James E.,9994,0,9999,5
1715609807632,BISP 197,002,658904,Coleman; Aaron B.,9998,0,9999,1
1715609808664,CAT 124RS,A01,519847,Geibel; William,0,0,20,20
1715609809693,CAT 125RS,A01,515971,Geibel; William,0,0,20,20
1715609810719,CLRE 250,A00,511389,Morris; Sheldon,9992,0,9999,7
1715609811747,CLRE 251,A00,507176,Mehta; Ravindra L.,9992,0,9999,7
1715609811747,CLRE 251,B00,511410,Mehta; Ravindra L.,9998,0,9999,1
1715609812775,CLRE 252,A00,507189,Cuomo; Raphael Eduardo,9994,0,9999,5
1715609813802,CLRE 253,A00,507199,Vaida; Florin,9994,0,9999,5
1715609813802,CLRE 253,B00,507202,Vaida; Florin,9999,0,9999,0
1715609814829,CLRE 259,A00,507211,Patel; Hemal,9996,0,9999,3
1715609815858,CLRE 260,A00,507221,Cuomo; Raphael Eduardo,9999,0,9999,0
1715609816884,CLRE 297,001,507242,Cuomo; Raphael Eduardo,9999,0,9999,0
1715609817914,COGS 197,001,638244,Voytek; Bradley Thomas,9997,0,9999,2
1715609818942,CSE 191,A00,516875,Minnes Kemp; Mor Mia,9991,0,9999,8
1715609819967,CSE 197,001,637388,Minnes Kemp; Mor Mia,9992,0,9999,7
1715609820998,CSS 201S,A01,494383,Mignozzetti; Umberto,35,0,35,0
1715609822028,CSS 202S,A01,494387,Mignozzetti; Umberto,35,0,35,0
1715609823055,DSC 197,001,628532,Eldridge; Justin Matthew,9995,0,9999,4
1715609824081,EAP 100,A00,516065,Staff,9799,0,9999,200
1715609825110,ECE 45,A01,507414,Staff,31,0,60,29
1715609827168,ECE 111,A01,507420,Staff,11,0,50,39
1715609828195,ECE 197,001,548057,Sievenpiper; Daniel F.,9991,0,9999,8
1715609829221,EDS 115,A00,507243,Choi; Bailey Miyeon,7,0,28,21
1715609830255,EDS 117,A01,494379,Staff,0,6,34,34
1715609831284,EDS 125,A00,507246,Hopkins; Megan Beth,8,0,30,22
1715609832314,EDS 128A,A01,507264,Fargason; Sharon Gayle,6,0,26,20
1715609833340,EDS 128B,A01,507293,Pappas; Elizabeth,10,0,30,20
1715609834366,EDS 139,A00,507294,Fargason; Sharon Gayle,10,0,30,20
1715609834366,EDS 139,B00,507313,Pappas; Elizabeth,11,0,30,19
1715609835392,EDS 201,A00,507315,Staff,10,0,30,20
1715609836420,EDS 203,A01,507317,Halter; Christopher P.,10,0,30,20
1715609837450,EDS 204R,A01,507319,Halter; Christopher P.,0,3,30,30
1715609837450,EDS 204R,B01,507331,Heinzman; Erica M.,14,0,30,16
1715609838475,EDS 206R,A00,507332,Staff,0,4,30,30
1715609838475,EDS 206R,B00,507343,Staff,15,0,30,15
1715609839503,EDS 250,A00,507344,Hemans; Patricia Ann Benitez,20,0,40,20
1715609840528,EDS 281,A00,507345,Daly; Alan J.,18,0,18,0
1715609841554,EDS 284,A00,507350,Daly; Alan J.,16,0,16,0
1715609842582,EDS 286,A00,507359,Fine; Sarah,18,0,18,0
1715609843608,EDS 289C,A01,507361,Daly; Alan J.,18,0,18,0
1715609844633,EDS 290,A00,507366,Hofstetter; Carolyn,15,0,15,0
1715609845659,LIGM 5A,A00,507421,Fischer-Grunski; Eva K,17,0,20,3
1715609846686,LIGM 5B,A00,507423,Fischer-Grunski; Eva K,19,0,20,1
1715609847716,LIGM 5C,A00,507425,Fischer-Grunski; Eva K,19,0,20,1
1715609848742,LIIT 5AS,A00,507427,Carnelos; Chiara,20,0,20,0
1715609849770,LIIT 5BS,A00,507430,Carnelos; Chiara,20,0,20,0
1715609850800,LIIT 5CS,A00,507432,Carnelos; Chiara,20,0,20,0
1715609851825,LISP 5A,A00,507541,Munoz Sanchez; Alicia,11,0,20,9
1715609852852,LISP 5B,A00,507671,Munoz Sanchez; Alicia,9,0,20,11
1715609853880,LISP 5C,A00,507696,Munoz Sanchez; Alicia,9,0,20,11
1715609854908,MAE 197,001,528363,Boechler; Nicholas Sebastia,9998,0,9999,1
1715609855940,MATH 197,001,523477,Kedlaya; Kiran S.,9994,0,9999,5
1715609855940,MATH 197,002,563811,Zhang; Danna,9994,0,9999,5
1715609855940,MATH 197,003,628552,Dumitriu; Ioana,9998,0,9999,1
1715609855940,MATH 197,004,660885,Floyd; Eric,9999,0,9999,0
1715609856967,MCWP 40R,A00,518780,Staff,2,0,20,18
1715609856967,MCWP 40R,B00,518781,Staff,11,0,20,9
1715609856967,MCWP 40R,C00,518783,Staff,5,0,20,15
1715609857992,MCWP 50R,A00,518791,Staff,0,1,20,20
1715609857992,MCWP 50R,B00,518792,Staff,0,2,20,20
1715609857992,MCWP 50R,C00,518793,Staff,0,4,20,20
1715609857992,MCWP 50R,D00,518794,Staff,0,1,20,20
1715609857992,MCWP 50R,E00,518795,Staff,0,2,20,20
1715609857992,MCWP 50R,F00,518796,Staff,0,1,20,20
1715609857992,MCWP 50R,G00,518797,Staff,0,1,20,20
1715609859018,MMW 12R,A01,514034,Herbst; Matthew,0,2,16,16
1715609859018,MMW 12R,A02,514035,Herbst; Matthew,0,0,16,16
1715609860048,MMW 13R,A01,514037,Staff,0,5,16,16
1715609860048,MMW 13R,A02,514039,Staff,0,5,16,16
1715609860048,MMW 13R,A03,628519,Staff,0,4,16,16
1715609862109,SIO 295LS,A00,523233,Staff,10,0,30,20
1715609863136,SIO 295S,A00,523232,Staff,10,0,30,20
1715609864167,SIOC 290S,A01,637330,Merrifield; Mark A,23,0,30,7
1715609865195,SIOC 291S,A01,637333,Gabriel; Corey John,23,0,30,7
1715609866222,SOCI 117,A01,494376,Staff,0,5,5,5
1715609867250,WES 237B,A00,494380,Staff,10,0,20,10
1715609869332,AESE 279B,A00,494370,Wade; Jon P,0,0,33,33
1715609870358,AIP 97,001,660915,Van Den Einde; Yael Dahlia,9999,0,9999,0
1715609871390,AIP 197,001,627712,Vespa; Emanuel Ignacio,9995,0,9999,4
1715609871390,AIP 197,002,650778,Amir; On,9998,0,9999,1
1715609871390,AIP 197,003,650933,Avenancio-Leon; Carlos,9998,0,9999,1
1715609871390,AIP 197,004,658530,Heyman; Gail D.,9998,0,9999,1
1715609871390,AIP 197,005,658631,Neal; Sonya E,9998,0,9999,1
1715609871390,AIP 197,006,658671,Du; Songzi,9998,0,9999,1
1715609872418,ANAR 135S,A00,494369,Braswell; Geoffrey E.,0,0,0,0
1715609873443,BENG 196,001,628496,Engler; Adam J.,9998,0,9999,1
1715609873443,BENG 196,002,660916,Watson; John Thomas,9999,0,9999,0
1715609874468,BISP 197,001,650773,Wilhelm; James E.,9994,0,9999,5
1715609874468,BISP 197,002,658904,Coleman; Aaron B.,9998,0,9999,1
1715609875498,CAT 124RS,A01,519847,Geibel; William,0,0,20,20
1715609876526,CAT 125RS,A01,515971,Geibel; William,0,0,20,20
1715609877557,CLRE 250,A00,511389,Morris; Sheldon,9992,0,9999,7
1715609878584,CLRE 251,A00,507176,Mehta; Ravindra L.,9992,0,9999,7
1715609878584,CLRE 251,B00,511410,Mehta; Ravindra L.,9998,0,9999,1
1715609879611,CLRE 252,A00,507189,Cuomo; Raphael Eduardo,9994,0,9999,5
1715609880642,CLRE 253,A00,507199,Vaida; Florin,9994,0,9999,5
1715609880642,CLRE 253,B00,507202,Vaida; Florin,9999,0,9999,0
1715609881669,CLRE 259,A00,507211,Patel; Hemal,9996,0,9999,3
1715609882699,CLRE 260,A00,507221,Cuomo; Raphael Eduardo,9999,0,9999,0
1715609883723,CLRE 297,001,507242,Cuomo; Raphael Eduardo,9999,0,9999,0
1715609884753,COGS 197,001,638244,Voytek; Bradley Thomas,9997,0,9999,2
1715609885778,CSE 191,A00,516875,Minnes Kemp; Mor Mia,9991,0,9999,8
1715609886804,CSE 197,001,637388,Minnes Kemp; Mor Mia,9992,0,9999,7
1715609887831,CSS 201S,A01,494383,Mignozzetti; Umberto,35,0,35,0
1715609888859,CSS 202S,A01,494387,Mignozzetti; Umberto,35,0,35,0
1715609889888,DSC 197,001,628532,Eldridge; Justin Matthew,9995,0,9999,4
1715609890915,EAP 100,A00,516065,Staff,9799,0,9999,200
1715609891945,ECE 45,A01,507414,Staff,31,0,60,29
1715609894002,ECE 111,A01,507420,Staff,11,0,50,39
1715609895027,ECE 197,001,548057,Sievenpiper; Daniel F.,9991,0,9999,8
1715609896058,EDS 115,A00,507243,Choi; Bailey Miyeon,7,0,28,21
1715609897084,EDS 117,A01,494379,Staff,0,6,34,34
1715609898110,EDS 125,A00,507246,Hopkins; Megan Beth,8,0,30,22
1715609899147,EDS 128A,A01,507264,Fargason; Sharon Gayle,6,0,26,20
1715609900231,EDS 128B,A01,507293,Pappas; Elizabeth,10,0,30,20
1715609901258,EDS 139,A00,507294,Fargason; Sharon Gayle,10,0,30,20
1715609901258,EDS 139,B00,507313,Pappas; Elizabeth,11,0,30,19
1715609902285,EDS 201,A00,507315,Staff,10,0,30,20
1715609903311,EDS 203,A01,507317,Halter; Christopher P.,10,0,30,20
1715609904344,EDS 204R,A01,507319,Halter; Christopher P.,0,3,30,30
1715609904344,EDS 204R,B01,507331,Heinzman; Erica M.,14,0,30,16
1715609905370,EDS 206R,A00,507332,Staff,0,4,30,30
1715609905370,EDS 206R,B00,507343,Staff,15,0,30,15
1715609906400,EDS 250,A00,507344,Hemans; Patricia Ann Benitez,20,0,40,20
1715609907429,EDS 281,A00,507345,Daly; Alan J.,18,0,18,0
1715609908456,EDS 284,A00,507350,Daly; Alan J.,16,0,16,0
1715609909484,EDS 286,A00,507359,Fine; Sarah,18,0,18,0
1715609910509,EDS 289C,A01,507361,Daly; Alan J.,18,0,18,0
1715609911538,EDS 290,A00,507366,Hofstetter; Carolyn,15,0,15,0
1715609912565,LIGM 5A,A00,507421,Fischer-Grunski; Eva K,17,0,20,3
1715609913593,LIGM 5B,A00,507423,Fischer-Grunski; Eva K,19,0,20,1
1715609914619,LIGM 5C,A00,507425,Fischer-Grunski; Eva K,19,0,20,1
1715609915645,LIIT 5AS,A00,507427,Carnelos; Chiara,20,0,20,0
1715609916672,LIIT 5BS,A00,507430,Carnelos; Chiara,20,0,20,0
1715609917699,LIIT 5CS,A00,507432,Carnelos; Chiara,20,0,20,0
1715609918726,LISP 5A,A00,507541,Munoz Sanchez; Alicia,11,0,20,9
1715609919751,LISP 5B,A00,507671,Munoz Sanchez; Alicia,9,0,20,11
1715609920779,LISP 5C,A00,507696,Munoz Sanchez; Alicia,9,0,20,11
1715609921807,MAE 197,001,528363,Boechler; Nicholas Sebastia,9998,0,9999,1
1715609922833,MATH 197,001,523477,Kedlaya; Kiran S.,9994,0,9999,5
1715609922833,MATH 197,002,563811,Zhang; Danna,9994,0,9999,5
1715609922833,MATH 197,003,628552,Dumitriu; Ioana,9998,0,9999,1
1715609922833,MATH 197,004,660885,Floyd; Eric,9999,0,9999,0
1715609923860,MCWP 40R,A00,518780,Staff,2,0,20,18
1715609923860,MCWP 40R,B00,518781,Staff,11,0,20,9
1715609923860,MCWP 40R,C00,518783,Staff,5,0,20,15
1715609924890,MCWP 50R,A00,518791,Staff,0,1,20,20
1715609924890,MCWP 50R,B00,518792,Staff,0,2,20,20
1715609924890,MCWP 50R,C00,518793,Staff,0,4,20,20
1715609924890,MCWP 50R,D00,518794,Staff,0,1,20,20
1715609924890,MCWP 50R,E00,518795,Staff,0,2,20,20
1715609924890,MCWP 50R,F00,518796,Staff,0,1,20,20
1715609924890,MCWP 50R,G00,518797,Staff,0,1,20,20
1715609925916,MMW 12R,A01,514034,Herbst; Matthew,0,2,16,16
1715609925916,MMW 12R,A02,514035,Herbst; Matthew,0,0,16,16
1715609926941,MMW 13R,A01,514037,Staff,0,5,16,16
1715609926941,MMW 13R,A02,514039,Staff,0,5,16,16
1715609926941,MMW 13R,A03,628519,Staff,0,4,16,16
1715609928997,SIO 295LS,A00,523233,Staff,10,0,30,20
1715609930023,SIO 295S,A00,523232,Staff,10,0,30,20
1715609931050,SIOC 290S,A01,637330,Merrifield; Mark A,23,0,30,7
1715609932077,SIOC 291S,A01,637333,Gabriel; Corey John,23,0,30,7
1715609933103,SOCI 117,A01,494376,Staff,0,5,5,5
1715609934130,WES 237B,A00,494380,Staff,10,0,20,10
1715609936215,AESE 279B,A00,494370,Wade; Jon P,0,0,33,33
1715609937241,AIP 97,001,660915,Van Den Einde; Yael Dahlia,9999,0,9999,0
1715609938277,AIP 197,001,627712,Vespa; Emanuel Ignacio,9995,0,9999,4
1715609938277,AIP 197,002,650778,Amir; On,9998,0,9999,1
1715609938277,AIP 197,003,650933,Avenancio-Leon; Carlos,9998,0,9999,1
1715609938277,AIP 197,004,658530,Heyman; Gail D.,9998,0,9999,1
1715609938277,AIP 197,005,658631,Neal; Sonya E,9998,0,9999,1
1715609938277,AIP 197,006,658671,Du; Songzi,9998,0,9999,1
1715609939303,ANAR 135S,A00,494369,Braswell; Geoffrey E.,0,0,0,0
1715609940330,BENG 196,001,628496,Engler; Adam J.,9998,0,9999,1
1715609940330,BENG 196,002,660916,Watson; John Thomas,9999,0,9999,0
1715609941358,BISP 197,001,650773,Wilhelm; James E.,9994,0,9999,5
1715609941358,BISP 197,002,658904,Coleman; Aaron B.,9998,0,9999,1
1715609942384,CAT 124RS,A01,519847,Geibel; William,0,0,20,20
1715609943409,CAT 125RS,A01,515971,Geibel; William,0,0,20,20
1715609944436,CLRE 250,A00,511389,Morris; Sheldon,9992,0,9999,7
1715609945466,CLRE 251,A00,507176,Mehta; Ravindra L.,9992,0,9999,7
1715609945466,CLRE 251,B00,511410,Mehta; Ravindra L.,9998,0,9999,1
1715609946492,CLRE 252,A00,507189,Cuomo; Raphael Eduardo,9994,0,9999,5
1715609947517,CLRE 253,A00,507199,Vaida; Florin,9994,0,9999,5
1715609947517,CLRE 253,B00,507202,Vaida; Florin,9999,0,9999,0
1715609948546,CLRE 259,A00,507211,Patel; Hemal,9996,0,9999,3
1715609949572,CLRE 260,A00,507221,Cuomo; Raphael Eduardo,9999,0,9999,0
1715609950599,CLRE 297,001,507242,Cuomo; Raphael Eduardo,9999,0,9999,0
1715609951626,COGS 197,001,638244,Voytek; Bradley Thomas,9997,0,9999,2
1715609952654,CSE 191,A00,516875,Minnes Kemp; Mor Mia,9991,0,9999,8
1715609953683,CSE 197,001,637388,Minnes Kemp; Mor Mia,9992,0,9999,7
1715609954709,CSS 201S,A01,494383,Mignozzetti; Umberto,35,0,35,0
1715609955734,CSS 202S,A01,494387,Mignozzetti; Umberto,35,0,35,0
1715609956759,DSC 197,001,628532,Eldridge; Justin Matthew,9995,0,9999,4
1715609957786,EAP 100,A00,516065,Staff,9799,0,9999,200
1715609958819,ECE 45,A01,507414,Staff,31,0,60,29
1715609960872,ECE 111,A01,507420,Staff,11,0,50,39
1715609961899,ECE 197,001,548057,Sievenpiper; Daniel F.,9991,0,9999,8
1715609962929,EDS 115,A00,507243,Choi; Bailey Miyeon,7,0,28,21
1715609963956,EDS 117,A01,494379,Staff,0,6,34,34
1715609964985,EDS 125,A00,507246,Hopkins; Megan Beth,8,0,30,22
1715609966013,EDS 128A,A01,507264,Fargason; Sharon Gayle,6,0,26,20
1715609967041,EDS 128B,A01,507293,Pappas; Elizabeth,10,0,30,20
1715609968067,EDS 139,A00,507294,Fargason; Sharon Gayle,10,0,30,20
1715609968067,EDS 139,B00,507313,Pappas; Elizabeth,11,0,30,19
1715609969093,EDS 201,A00,507315,Staff,10,0,30,20
1715609970121,EDS 203,A01,507317,Halter; Christopher P.,10,0,30,20
1715609971148,EDS 204R,A01,507319,Halter; Christopher P.,0,3,30,30
1715609971148,EDS 204R,B01,507331,Heinzman; Erica M.,14,0,30,16
1715609972177,EDS 206R,A00,507332,Staff,0,4,30,30
1715609972177,EDS 206R,B00,507343,Staff,15,0,30,15
1715609973206,EDS 250,A00,507344,Hemans; Patricia Ann Benitez,20,0,40,20
1715609974232,EDS 281,A00,507345,Daly; Alan J.,18,0,18,0
1715609975264,EDS 284,A00,507350,Daly; Alan J.,16,0,16,0
1715609976292,EDS 286,A00,507359,Fine; Sarah,18,0,18,0
1715609977319,EDS 289C,A01,507361,Daly; Alan J.,18,0,18,0
1715609978349,EDS 290,A00,507366,Hofstetter; Carolyn,15,0,15,0
1715609979376,LIGM 5A,A00,507421,Fischer-Grunski; Eva K,17,0,20,3
1715609980402,LIGM 5B,A00,507423,Fischer-Grunski; Eva K,19,0,20,1
1715609981428,LIGM 5C,A00,507425,Fischer-Grunski; Eva K,19,0,20,1
1715609982457,LIIT 5AS,A00,507427,Carnelos; Chiara,20,0,20,0
1715609983486,LIIT 5BS,A00,507430,Carnelos; Chiara,20,0,20,0
1715609984516,LIIT 5CS,A00,507432,Carnelos; Chiara,20,0,20,0
1715609985544,LISP 5A,A00,507541,Munoz Sanchez; Alicia,11,0,20,9
1715609986571,LISP 5B,A00,507671,Munoz Sanchez; Alicia,9,0,20,11
1715609987597,LISP 5C,A00,507696,Munoz Sanchez; Alicia,9,0,20,11
1715609988625,MAE 197,001,528363,Boechler; Nicholas Sebastia,9998,0,9999,1
1715609989652,MATH 197,001,523477,Kedlaya; Kiran S.,9994,0,9999,5
1715609989652,MATH 197,002,563811,Zhang; Danna,9994,0,9999,5
1715609989652,MATH 197,003,628552,Dumitriu; Ioana,9998,0,9999,1
1715609989652,MATH 197,004,660885,Floyd; Eric,9999,0,9999,0
1715609990683,MCWP 40R,A00,518780,Staff,2,0,20,18
1715609990683,MCWP 40R,B00,518781,Staff,11,0,20,9
1715609990683,MCWP 40R,C00,518783,Staff,5,0,20,15
1715609991713,MCWP 50R,A00,518791,Staff,0,1,20,20
1715609991713,MCWP 50R,B00,518792,Staff,0,2,20,20
1715609991713,MCWP 50R,C00,518793,Staff,0,4,20,20
1715609991713,MCWP 50R,D00,518794,Staff,0,1,20,20
1715609991713,MCWP 50R,E00,518795,Staff,0,2,20,20
1715609991713,MCWP 50R,F00,518796,Staff,0,1,20,20
1715609991713,MCWP 50R,G00,518797,Staff,0,1,20,20
1715609992740,MMW 12R,A01,514034,Herbst; Matthew,0,2,16,16
1715609992740,MMW 12R,A02,514035,Herbst; Matthew,0,0,16,16
1715609993765,MMW 13R,A01,514037,Staff,0,5,16,16
1715609993765,MMW 13R,A02,514039,Staff,0,5,16,16
1715609993765,MMW 13R,A03,628519,Staff,0,4,16,16
1715609995816,SIO 295LS,A00,523233,Staff,10,0,30,20
1715609996844,SIO 295S,A00,523232,Staff,10,0,30,20
1715609997868,SIOC 290S,A01,637330,Merrifield; Mark A,23,0,30,7
1715609998897,SIOC 291S,A01,637333,Gabriel; Corey John,23,0,30,7
1715609999924,SOCI 117,A01,494376,Staff,0,5,5,5
1715610000949,WES 237B,A00,494380,Staff,10,0,20,10
1715610003026,AESE 279B,A00,494370,Wade; Jon P,0,0,33,33
1715610004113,AIP 97,001,660915,Van Den Einde; Yael Dahlia,9999,0,9999,0
1715610005142,AIP 197,001,627712,Vespa; Emanuel Ignacio,9995,0,9999,4
1715610005142,AIP 197,002,650778,Amir; On,9998,0,9999,1
1715610005142,AIP 197,003,650933,Avenancio-Leon; Carlos,9998,0,9999,1
1715610005142,AIP 197,004,658530,Heyman; Gail D.,9998,0,9999,1
1715610005142,AIP 197,005,658631,Neal; Sonya E,9998,0,9999,1
1715610005142,AIP 197,006,658671,Du; Songzi,9998,0,9999,1
1715610006167,ANAR 135S,A00,494369,Braswell; Geoffrey E.,0,0,0,0
1715610007193,BENG 196,001,628496,Engler; Adam J.,9998,0,9999,1
1715610007193,BENG 196,002,660916,Watson; John Thomas,9999,0,9999,0
1715610008220,BISP 197,001,650773,Wilhelm; James E.,9994,0,9999,5
1715610008220,BISP 197,002,658904,Coleman; Aaron B.,9998,0,9999,1
1715610009246,CAT 124RS,A01,519847,Geibel; William,0,0,20,20
1715610010271,CAT 125RS,A01,515971,Geibel; William,0,0,20,20
1715610011301,CLRE 250,A00,511389,Morris; Sheldon,9992,0,9999,7
1715610012329,CLRE 251,A00,507176,Mehta; Ravindra L.,9992,0,9999,7
1715610012329,CLRE 251,B00,511410,Mehta; Ravindra L.,9998,0,9999,1
1715610013353,CLRE 252,A00,507189,Cuomo; Raphael Eduardo,9994,0,9999,5
1715610014380,CLRE 253,A00,507199,Vaida; Florin,9994,0,9999,5
1715610014380,CLRE 253,B00,507202,Vaida; Florin,9999,0,9999,0
1715610015406,CLRE 259,A00,507211,Patel; Hemal,9996,0,9999,3
1715610016435,CLRE 260,A00,507221,Cuomo; Raphael Eduardo,9999,0,9999,0
1715610017463,CLRE 297,001,507242,Cuomo; Raphael Eduardo,9999,0,9999,0
1715610018489,COGS 197,001,638244,Voytek; Bradley Thomas,9997,0,9999,2
1715610019515,CSE 191,A00,516875,Minnes Kemp; Mor Mia,9991,0,9999,8
1715610020540,CSE 197,001,637388,Minnes Kemp; Mor Mia,9992,0,9999,7
1715610021565,CSS 201S,A01,494383,Mignozzetti; Umberto,35,0,35,0
1715610022594,CSS 202S,A01,494387,Mignozzetti; Umberto,35,0,35,0
1715610023622,DSC 197,001,628532,Eldridge; Justin Matthew,9995,0,9999,4
1715610024646,EAP 100,A00,516065,Staff,9799,0,9999,200
1715610025676,ECE 45,A01,507414,Staff,31,0,60,29
1715610027730,ECE 111,A01,507420,Staff,11,0,50,39
1715610028759,ECE 197,001,548057,Sievenpiper; Daniel F.,9991,0,9999,8
1715610029785,EDS 115,A00,507243,Choi; Bailey Miyeon,7,0,28,21
1715610030813,EDS 117,A01,494379,Staff,0,6,34,34
1715610031842,EDS 125,A00,507246,Hopkins; Megan Beth,8,0,30,22
1715610032867,EDS 128A,A01,507264,Fargason; Sharon Gayle,6,0,26,20
1715610033905,EDS 128B,A01,507293,Pappas; Elizabeth,10,0,30,20
1715610034932,EDS 139,A00,507294,Fargason; Sharon Gayle,10,0,30,20
1715610034932,EDS 139,B00,507313,Pappas; Elizabeth,11,0,30,19
1715610035956,EDS 201,A00,507315,Staff,10,0,30,20
1715610036983,EDS 203,A01,507317,Halter; Christopher P.,10,0,30,20
1715610038012,EDS 204R,A01,507319,Halter; Christopher P.,0,3,30,30
1715610038012,EDS 204R,B01,507331,Heinzman; Erica M.,14,0,30,16
1715610039040,EDS 206R,A00,507332,Staff,0,4,30,30
1715610039040,EDS 206R,B00,507343,Staff,15,0,30,15
1715610040064,EDS 250,A00,507344,Hemans; Patricia Ann Benitez,20,0,40,20
1715610041090,EDS 281,A00,507345,Daly; Alan J.,18,0,18,0
1715610042116,EDS 284,A00,507350,Daly; Alan J.,16,0,16,0
1715610043145,EDS 286,A00,507359,Fine; Sarah,18,0,18,0
1715610044173,EDS 289C,A01,507361,Daly; Alan J.,18,0,18,0
1715610045198,EDS 290,A00,507366,Hofstetter; Carolyn,15,0,15,0
1715610046230,LIGM 5A,A00,507421,Fischer-Grunski; Eva K,17,0,20,3
1715610047254,LIGM 5B,A00,507423,Fischer-Grunski; Eva K,19,0,20,1
1715610048283,LIGM 5C,A00,507425,Fischer-Grunski; Eva K,19,0,20,1
1715610049311,LIIT 5AS,A00,507427,Carnelos; Chiara,20,0,20,0
1715610050341,LIIT 5BS,A00,507430,Carnelos; Chiara,20,0,20,0
1715610051370,LIIT 5CS,A00,507432,Carnelos; Chiara,20,0,20,0
1715610052397,LISP 5A,A00,507541,Munoz Sanchez; Alicia,11,0,20,9
1715610053426,LISP 5B,A00,507671,Munoz Sanchez; Alicia,9,0,20,11
1715610054455,LISP 5C,A00,507696,Munoz Sanchez; Alicia,9,0,20,11
1715610055481,MAE 197,001,528363,Boechler; Nicholas Sebastia,9998,0,9999,1
1715610056510,MATH 197,001,523477,Kedlaya; Kiran S.,9994,0,9999,5
1715610056510,MATH 197,002,563811,Zhang; Danna,9994,0,9999,5
1715610056510,MATH 197,003,628552,Dumitriu; Ioana,9998,0,9999,1
1715610056510,MATH 197,004,660885,Floyd; Eric,9999,0,9999,0
1715610057536,MCWP 40R,A00,518780,Staff,2,0,20,18
1715610057536,MCWP 40R,B00,518781,Staff,11,0,20,9
1715610057536,MCWP 40R,C00,518783,Staff,5,0,20,15
1715610058562,MCWP 50R,A00,518791,Staff,0,1,20,20
1715610058562,MCWP 50R,B00,518792,Staff,0,2,20,20
1715610058562,MCWP 50R,C00,518793,Staff,0,4,20,20
1715610058562,MCWP 50R,D00,518794,Staff,0,1,20,20
1715610058562,MCWP 50R,E00,518795,Staff,0,2,20,20
1715610058562,MCWP 50R,F00,518796,Staff,0,1,20,20
1715610058562,MCWP 50R,G00,518797,Staff,0,1,20,20
1715610059591,MMW 12R,A01,514034,Herbst; Matthew,0,2,16,16
1715610059591,MMW 12R,A02,514035,Herbst; Matthew,0,0,16,16
1715610060617,MMW 13R,A01,514037,Staff,0,5,16,16
1715610060617,MMW 13R,A02,514039,Staff,0,5,16,16
1715610060617,MMW 13R,A03,628519,Staff,0,4,16,16
1715610062671,SIO 295LS,A00,523233,Staff,10,0,30,20
1715610063700,SIO 295S,A00,523232,Staff,10,0,30,20
1715610064727,SIOC 290S,A01,637330,Merrifield; Mark A,23,0,30,7
1715610065754,SIOC 291S,A01,637333,Gabriel; Corey John,23,0,30,7
1715610066785,SOCI 117,A01,494376,Staff,0,5,5,5
1715610067811,WES 237B,A00,494380,Staff,10,0,20,10
1715610069888,AESE 279B,A00,494370,Wade; Jon P,0,0,33,33
1715610070918,AIP 97,001,660915,Van Den Einde; Yael Dahlia,9999,0,9999,0
1715610071946,AIP 197,001,627712,Vespa; Emanuel Ignacio,9995,0,9999,4
1715610071946,AIP 197,002,650778,Amir; On,9998,0,9999,1
1715610071946,AIP 197,003,650933,Avenancio-Leon; Carlos,9998,0,9999,1
1715610071946,AIP 197,004,658530,Heyman; Gail D.,9998,0,9999,1
1715610071946,AIP 197,005,658631,Neal; Sonya E,9998,0,9999,1
1715610071946,AIP 197,006,658671,Du; Songzi,9998,0,9999,1
1715610072973,ANAR 135S,A00,494369,Braswell; Geoffrey E.,0,0,0,0
1715610073997,BENG 196,001,628496,Engler; Adam J.,9998,0,9999,1
1715610073997,BENG 196,002,660916,Watson; John Thomas,9999,0,9999,0
1715610075023,BISP 197,001,650773,Wilhelm; James E.,9994,0,9999,5
1715610075023,BISP 197,002,658904,Coleman; Aaron B.,9998,0,9999,1
1715610076049,CAT 124RS,A01,519847,Geibel; William,0,0,20,20
1715610077078,CAT 125RS,A01,515971,Geibel; William,0,0,20,20
1715610078104,CLRE 250,A00,511389,Morris; Sheldon,9992,0,9999,7
1715610079134,CLRE 251,A00,507176,Mehta; Ravindra L.,9992,0,9999,7
1715610079134,CLRE 251,B00,511410,Mehta; Ravindra L.,9998,0,9999,1
1715610080165,CLRE 252,A00,507189,Cuomo; Raphael Eduardo,9994,0,9999,5
1715610081191,CLRE 253,A00,507199,Vaida; Florin,9994,0,9999,5
1715610081191,CLRE 253,B00,507202,Vaida; Florin,9999,0,9999,0
1715610082218,CLRE 259,A00,507211,Patel; Hemal,9996,0,9999,3
1715610083242,CLRE 260,A00,507221,Cuomo; Raphael Eduardo,9999,0,9999,0
1715610084267,CLRE 297,001,507242,Cuomo; Raphael Eduardo,9999,0,9999,0
1715610085294,COGS 197,001,638244,Voytek; Bradley Thomas,9997,0,9999,2
1715610086322,CSE 191,A00,516875,Minnes Kemp; Mor Mia,9991,0,9999,8
1715610087347,CSE 197,001,637388,Minnes Kemp; Mor Mia,9992,0,9999,7
1715610088378,CSS 201S,A01,494383,Mignozzetti; Umberto,35,0,35,0
1715610089409,CSS 202S,A01,494387,Mignozzetti; Umberto,35,0,35,0
1715610090436,DSC 197,001,628532,Eldridge; Justin Matthew,9995,0,9999,4
1715610091462,EAP 100,A00,516065,Staff,9799,0,9999,200
1715610092489,ECE 45,A01,507414,Staff,31,0,60,29
1715610094542,ECE 111,A01,507420,Staff,11,0,50,39
1715610095570,ECE 197,001,548057,Sievenpiper; Daniel F.,9991,0,9999,8
1715610096597,EDS 115,A00,507243,Choi; Bailey Miyeon,7,0,28,21
1715610097624,EDS 117,A01,494379,Staff,0,6,34,34
1715610098651,EDS 125,A00,507246,Hopkins; Megan Beth,8,0,30,22
1715610099677,EDS 128A,A01,507264,Fargason; Sharon Gayle,6,0,26,20
1715610100701,EDS 128B,A01,507293,Pappas; Elizabeth,10,0,30,20
1715610101730,EDS 139,A00,507294,Fargason; Sharon Gayle,10,0,30,20
1715610101730,EDS 139,B00,507313,Pappas; Elizabeth,11,0,30,19
1715610102757,EDS 201,A00,507315,Staff,10,0,30,20
1715610103787,EDS 203,A01,507317,Halter; Christopher P.,10,0,30,20
1715610104815,EDS 204R,A01,507319,Halter; Christopher P.,0,3,30,30
1715610104815,EDS 204R,B01,507331,Heinzman; Erica M.,14,0,30,16
1715610105843,EDS 206R,A00,507332,Staff,0,4,30,30
1715610105843,EDS 206R,B00,507343,Staff,15,0,30,15
1715610106869,EDS 250,A00,507344,Hemans; Patricia Ann Benitez,20,0,40,20
1715610107895,EDS 281,A00,507345,Daly; Alan J.,18,0,18,0
1715610108922,EDS 284,A00,507350,Daly; Alan J.,16,0,16,0
1715610109949,EDS 286,A00,507359,Fine; Sarah,18,0,18,0
1715610110976,EDS 289C,A01,507361,Daly; Alan J.,18,0,18,0
1715610112001,EDS 290,A00,507366,Hofstetter; Carolyn,15,0,15,0
1715610113028,LIGM 5A,A00,507421,Fischer-Grunski; Eva K,17,0,20,3
1715610114057,LIGM 5B,A00,507423,Fischer-Grunski; Eva K,19,0,20,1
1715610115087,LIGM 5C,A00,507425,Fischer-Grunski; Eva K,19,0,20,1
1715610116113,LIIT 5AS,A00,507427,Carnelos; Chiara,20,0,20,0
1715610117139,LIIT 5BS,A00,507430,Carnelos; Chiara,20,0,20,0
1715610118166,LIIT 5CS,A00,507432,Carnelos; Chiara,20,0,20,0
1715610119198,LISP 5A,A00,507541,Munoz Sanchez; Alicia,11,0,20,9
1715610120227,LISP 5B,A00,507671,Munoz Sanchez; Alicia,9,0,20,11
1715610121255,LISP 5C,A00,507696,Munoz Sanchez; Alicia,9,0,20,11
1715610122281,MAE 197,001,528363,Boechler; Nicholas Sebastia,9998,0,9999,1
1715610123312,MATH 197,001,523477,Kedlaya; Kiran S.,9994,0,9999,5
1715610123312,MATH 197,002,563811,Zhang; Danna,9994,0,9999,5
1715610123312,MATH 197,003,628552,Dumitriu; Ioana,9998,0,9999,1
1715610123312,MATH 197,004,660885,Floyd; Eric,9999,0,9999,0
1715610124339,MCWP 40R,A00,518780,Staff,2,0,20,18
1715610124339,MCWP 40R,B00,518781,Staff,11,0,20,9
1715610124339,MCWP 40R,C00,518783,Staff,5,0,20,15
1715610125368,MCWP 50R,A00,518791,Staff,0,1,20,20
1715610125368,MCWP 50R,B00,518792,Staff,0,2,20,20
1715610125368,MCWP 50R,C00,518793,Staff,0,4,20,20
1715610125368,MCWP 50R,D00,518794,Staff,0,1,20,20
1715610125368,MCWP 50R,E00,518795,Staff,0,2,20,20
1715610125368,MCWP 50R,F00,518796,Staff,0,1,20,20
1715610125368,MCWP 50R,G00,518797,Staff,0,1,20,20
1715610126394,MMW 12R,A01,514034,Herbst; Matthew,0,2,16,16
1715610126394,MMW 12R,A02,514035,Herbst; Matthew,0,0,16,16
1715610127421,MMW 13R,A01,514037,Staff,0,5,16,16
1715610127421,MMW 13R,A02,514039,Staff,0,5,16,16
1715610127421,MMW 13R,A03,628519,Staff,0,4,16,16
1715610129472,SIO 295LS,A00,523233,Staff,10,0,30,20
1715610130504,SIO 295S,A00,523232,Staff,10,0,30,20
1715610131534,SIOC 290S,A01,637330,Merrifield; Mark A,23,0,30,7
1715610132564,SIOC 291S,A01,637333,Gabriel; Corey John,23,0,30,7
1715610133590,SOCI 117,A01,494376,Staff,0,5,5,5
1715610134618,WES 237B,A00,494380,Staff,10,0,20,10
1715610136686,AESE 279B,A00,494370,Wade; Jon P,0,0,33,33
1715610137713,AIP 97,001,660915,Van Den Einde; Yael Dahlia,9999,0,9999,0
1715610138748,AIP 197,001,627712,Vespa; Emanuel Ignacio,9995,0,9999,4
1715610138748,AIP 197,002,650778,Amir; On,9998,0,9999,1
1715610138748,AIP 197,003,650933,Avenancio-Leon; Carlos,9998,0,9999,1
1715610138748,AIP 197,004,658530,Heyman; Gail D.,9998,0,9999,1
1715610138748,AIP 197,005,658631,Neal; Sonya E,9998,0,9999,1
1715610138748,AIP 197,006,658671,Du; Songzi,9998,0,9999,1
1715610139777,ANAR 135S,A00,494369,Braswell; Geoffrey E.,0,0,0,0
1715610140804,BENG 196,001,628496,Engler; Adam J.,9998,0,9999,1
1715610140804,BENG 196,002,660916,Watson; John Thomas,9999,0,9999,0
1715610141834,BISP 197,001,650773,Wilhelm; James E.,9994,0,9999,5
1715610141834,BISP 197,002,658904,Coleman; Aaron B.,9998,0,9999,1
1715610142859,CAT 124RS,A01,519847,Geibel; William,0,0,20,20
1715610143886,CAT 125RS,A01,515971,Geibel; William,0,0,20,20
1715610144914,CLRE 250,A00,511389,Morris; Sheldon,9992,0,9999,7
1715610145945,CLRE 251,A00,507176,Mehta; Ravindra L.,9992,0,9999,7
1715610145945,CLRE 251,B00,511410,Mehta; Ravindra L.,9998,0,9999,1
1715610146976,CLRE 252,A00,507189,Cuomo; Raphael Eduardo,9994,0,9999,5
1715610148004,CLRE 253,A00,507199,Vaida; Florin,9994,0,9999,5
1715610148004,CLRE 253,B00,507202,Vaida; Florin,9999,0,9999,0
1715610149029,CLRE 259,A00,507211,Patel; Hemal,9996,0,9999,3
1715610150055,CLRE 260,A00,507221,Cuomo; Raphael Eduardo,9999,0,9999,0
1715610151082,CLRE 297,001,507242,Cuomo; Raphael Eduardo,9999,0,9999,0
1715610152107,COGS 197,001,638244,Voytek; Bradley Thomas,9997,0,9999,2
1715610153133,CSE 191,A00,516875,Minnes Kemp; Mor Mia,9991,0,9999,8
1715610154158,CSE 197,001,637388,Minnes Kemp; Mor Mia,9992,0,9999,7
1715610155191,CSS 201S,A01,494383,Mignozzetti; Umberto,35,0,35,0
1715610156216,CSS 202S,A01,494387,Mignozzetti; Umberto,35,0,35,0
1715610157244,DSC 197,001,628532,Eldridge; Justin Matthew,9995,0,9999,4
1715610158269,EAP 100,A00,516065,Staff,9799,0,9999,200
1715610159296,ECE 45,A01,507414,Staff,31,0,60,29
1715610161353,ECE 111,A01,507420,Staff,11,0,50,39
1715610162381,ECE 197,001,548057,Sievenpiper; Daniel F.,9991,0,9999,8
1715610163407,EDS 115,A00,507243,Choi; Bailey Miyeon,7,0,28,21
1715610164436,EDS 117,A01,494379,Staff,0,6,34,34
1715610165465,EDS 125,A00,507246,Hopkins; Megan Beth,8,0,30,22
1715610166495,EDS 128A,A01,507264,Fargason; Sharon Gayle,6,0,26,20
1715610167519,EDS 128B,A01,507293,Pappas; Elizabeth,10,0,30,20
1715610168545,EDS 139,A00,507294,Fargason; Sharon Gayle,10,0,30,20
1715610168545,EDS 139,B00,507313,Pappas; Elizabeth,11,0,30,19
1715610169568,EDS 201,A00,507315,Staff,10,0,30,20
1715610170596,EDS 203,A01,507317,Halter; Christopher P.,10,0,30,20
1715610171621,EDS 204R,A01,507319,Halter; Christopher P.,0,3,30,30
1715610171621,EDS 204R,B01,507331,Heinzman; Erica M.,14,0,30,16
1715610172648,EDS 206R,A00,507332,Staff,0,4,30,30
1715610172648,EDS 206R,B00,507343,Staff,15,0,30,15
1715610173672,EDS 250,A00,507344,Hemans; Patricia Ann Benitez,20,0,40,20
1715610174700,EDS 281,A00,507345,Daly; Alan J.,18,0,18,0
1715610175725,EDS 284,A00,507350,Daly; Alan J.,16,0,16,0
1715610176755,EDS 286,A00,507359,Fine; Sarah,18,0,18,0
1715610177782,EDS 289C,A01,507361,Daly; Alan J.,18,0,18,0
1715610178808,EDS 290,A00,507366,Hofstetter; Carolyn,15,0,15,0
1715610179835,LIGM 5A,A00,507421,Fischer-Grunski; Eva K,17,0,20,3
1715610180860,LIGM 5B,A00,507423,Fischer-Grunski; Eva K,19,0,20,1
1715610181889,LIGM 5C,A00,507425,Fischer-Grunski; Eva K,19,0,20,1
1715610182916,LIIT 5AS,A00,507427,Carnelos; Chiara,20,0,20,0
1715610183940,LIIT 5BS,A00,507430,Carnelos; Chiara,20,0,20,0
1715610184966,LIIT 5CS,A00,507432,Carnelos; Chiara,20,0,20,0
1715610185998,LISP 5A,A00,507541,Munoz Sanchez; Alicia,11,0,20,9
1715610187027,LISP 5B,A00,507671,Munoz Sanchez; Alicia,9,0,20,11
1715610188052,LISP 5C,A00,507696,Munoz Sanchez; Alicia,9,0,20,11
1715610189082,MAE 197,001,528363,Boechler; Nicholas Sebastia,9998,0,9999,1
1715610190115,MATH 197,001,523477,Kedlaya; Kiran S.,9994,0,9999,5
1715610190115,MATH 197,002,563811,Zhang; Danna,9994,0,9999,5
1715610190115,MATH 197,003,628552,Dumitriu; Ioana,9998,0,9999,1
1715610190115,MATH 197,004,660885,Floyd; Eric,9999,0,9999,0
1715610191141,MCWP 40R,A00,518780,Staff,2,0,20,18
1715610191141,MCWP 40R,B00,518781,Staff,11,0,20,9
1715610191141,MCWP 40R,C00,518783,Staff,5,0,20,15
1715610192171,MCWP 50R,A00,518791,Staff,0,1,20,20
1715610192171,MCWP 50R,B00,518792,Staff,0,2,20,20
1715610192171,MCWP 50R,C00,518793,Staff,0,4,20,20
1715610192171,MCWP 50R,D00,518794,Staff,0,1,20,20
1715610192171,MCWP 50R,E00,518795,Staff,0,2,20,20
1715610192171,MCWP 50R,F00,518796,Staff,0,1,20,20
1715610192171,MCWP 50R,G00,518797,Staff,0,1,20,20
1715610193195,MMW 12R,A01,514034,Herbst; Matthew,0,2,16,16
1715610193195,MMW 12R,A02,514035,Herbst; Matthew,0,0,16,16
1715610194222,MMW 13R,A01,514037,Staff,0,5,16,16
1715610194222,MMW 13R,A02,514039,Staff,0,5,16,16
1715610194222,MMW 13R,A03,628519,Staff,0,4,16,16
1715610196277,SIO 295LS,A00,523233,Staff,10,0,30,20
1715610197302,SIO 295S,A00,523232,Staff,10,0,30,20
1715610198333,SIOC 290S,A01,637330,Merrifield; Mark A,23,0,30,7
1715610199358,SIOC 291S,A01,637333,Gabriel; Corey John,23,0,30,7
1715610200385,SOCI 117,A01,494376,Staff,0,5,5,5
1715610201412,WES 237B,A00,494380,Staff,10,0,20,10
1715610203499,AESE 279B,A00,494370,Wade; Jon P,0,0,33,33
1715610204524,AIP 97,001,660915,Van Den Einde; Yael Dahlia,9999,0,9999,0
1715610205553,AIP 197,001,627712,Vespa; Emanuel Ignacio,9995,0,9999,4
1715610205553,AIP 197,002,650778,Amir; On,9998,0,9999,1
1715610205553,AIP 197,003,650933,Avenancio-Leon; Carlos,9998,0,9999,1
1715610205553,AIP 197,004,658530,Heyman; Gail D.,9998,0,9999,1
1715610205553,AIP 197,005,658631,Neal; Sonya E,9998,0,9999,1
1715610205553,AIP 197,006,658671,Du; Songzi,9998,0,9999,1
1715610206582,ANAR 135S,A00,494369,Braswell; Geoffrey E.,0,0,0,0
1715610207612,BENG 196,001,628496,Engler; Adam J.,9998,0,9999,1
1715610207612,BENG 196,002,660916,Watson; John Thomas,9999,0,9999,0
1715610208639,BISP 197,001,650773,Wilhelm; James E.,9994,0,9999,5
1715610208639,BISP 197,002,658904,Coleman; Aaron B.,9998,0,9999,1
1715610209665,CAT 124RS,A01,519847,Geibel; William,0,0,20,20
1715610210694,CAT 125RS,A01,515971,Geibel; William,0,0,20,20
1715610211720,CLRE 250,A00,511389,Morris; Sheldon,9992,0,9999,7
1715610212749,CLRE 251,A00,507176,Mehta; Ravindra L.,9992,0,9999,7
1715610212749,CLRE 251,B00,511410,Mehta; Ravindra L.,9998,0,9999,1
1715610213778,CLRE 252,A00,507189,Cuomo; Raphael Eduardo,9994,0,9999,5
1715610214803,CLRE 253,A00,507199,Vaida; Florin,9994,0,9999,5
1715610214803,CLRE 253,B00,507202,Vaida; Florin,9999,0,9999,0
1715610215829,CLRE 259,A00,507211,Patel; Hemal,9996,0,9999,3
1715610216857,CLRE 260,A00,507221,Cuomo; Raphael Eduardo,9999,0,9999,0
1715610217884,CLRE 297,001,507242,Cuomo; Raphael Eduardo,9999,0,9999,0
1715610218914,COGS 197,001,638244,Voytek; Bradley Thomas,9997,0,9999,2
1715610219941,CSE 191,A00,516875,Minnes Kemp; Mor Mia,9991,0,9999,8
1715610220965,CSE 197,001,637388,Minnes Kemp; Mor Mia,9992,0,9999,7
1715610221992,CSS 201S,A01,494383,Mignozzetti; Umberto,35,0,35,0
1715610223022,CSS 202S,A01,494387,Mignozzetti; Umberto,35,0,35,0
1715610224051,DSC 197,001,628532,Eldridge; Justin Matthew,9995,0,9999,4
1715610225076,EAP 100,A00,516065,Staff,9799,0,9999,200
1715610226105,ECE 45,A01,507414,Staff,31,0,60,29
1715610228157,ECE 111,A01,507420,Staff,11,0,50,39
1715610229183,ECE 197,001,548057,Sievenpiper; Daniel F.,9991,0,9999,8
1715610230212,EDS 115,A00,507243,Choi; Bailey Miyeon,7,0,28,21
1715610231238,EDS 117,A01,494379,Staff,0,6,34,34
1715610232265,EDS 125,A00,507246,Hopkins; Megan Beth,8,0,30,22
1715610233291,EDS 128A,A01,507264,Fargason; Sharon Gayle,6,0,26,20
1715610234317,EDS 128B,A01,507293,Pappas; Elizabeth,10,0,30,20
1715610235343,EDS 139,A00,507294,Fargason; Sharon Gayle,10,0,30,20
1715610235343,EDS 139,B00,507313,Pappas; Elizabeth,11,0,30,19
1715610236370,EDS 201,A00,507315,Staff,10,0,30,20
1715610237396,EDS 203,A01,507317,Halter; Christopher P.,10,0,30,20
1715610238427,EDS 204R,A01,507319,Halter; Christopher P.,0,3,30,30
1715610238427,EDS 204R,B01,507331,Heinzman; Erica M.,14,0,30,16
1715610239457,EDS 206R,A00,507332,Staff,0,4,30,30
1715610239457,EDS 206R,B00,507343,Staff,15,0,30,15
1715610240485,EDS 250,A00,507344,Hemans; Patricia Ann Benitez,20,0,40,20
1715610241510,EDS 281,A00,507345,Daly; Alan J.,18,0,18,0
1715610242539,EDS 284,A00,507350,Daly; Alan J.,16,0,16,0
1715610243569,EDS 286,A00,507359,Fine; Sarah,18,0,18,0
1715610244598,EDS 289C,A01,507361,Daly; Alan J.,18,0,18,0
1715610245629,EDS 290,A00,507366,Hofstetter; Carolyn,15,0,15,0
1715610246661,LIGM 5A,A00,507421,Fischer-Grunski; Eva K,17,0,20,3
1715610247685,LIGM 5B,A00,507423,Fischer-Grunski; Eva K,19,0,20,1
1715610248714,LIGM 5C,A00,507425,Fischer-Grunski; Eva K,19,0,20,1
1715610249740,LIIT 5AS,A00,507427,Carnelos; Chiara,20,0,20,0
1715610250765,LIIT 5BS,A00,507430,Carnelos; Chiara,20,0,20,0
1715610251792,LIIT 5CS,A00,507432,Carnelos; Chiara,20,0,20,0
1715610252822,LISP 5A,A00,507541,Munoz Sanchez; Alicia,11,0,20,9
1715610253848,LISP 5B,A00,507671,Munoz Sanchez; Alicia,9,0,20,11
1715610254874,LISP 5C,A00,507696,Munoz Sanchez; Alicia,9,0,20,11
1715610255899,MAE 197,001,528363,Boechler; Nicholas Sebastia,9998,0,9999,1
1715610256929,MATH 197,001,523477,Kedlaya; Kiran S.,9994,0,9999,5
1715610256929,MATH 197,002,563811,Zhang; Danna,9994,0,9999,5
1715610256929,MATH 197,003,628552,Dumitriu; Ioana,9998,0,9999,1
1715610256929,MATH 197,004,660885,Floyd; Eric,9999,0,9999,0
1715610257957,MCWP 40R,A00,518780,Staff,2,0,20,18
1715610257957,MCWP 40R,B00,518781,Staff,11,0,20,9
1715610257957,MCWP 40R,C00,518783,Staff,5,0,20,15
1715610258983,MCWP 50R,A00,518791,Staff,0,1,20,20
1715610258983,MCWP 50R,B00,518792,Staff,0,2,20,20
1715610258983,MCWP 50R,C00,518793,Staff,0,4,20,20
1715610258983,MCWP 50R,D00,518794,Staff,0,1,20,20
1715610258983,MCWP 50R,E00,518795,Staff,0,2,20,20
1715610258983,MCWP 50R,F00,518796,Staff,0,1,20,20
1715610258983,MCWP 50R,G00,518797,Staff,0,1,20,20
1715610260010,MMW 12R,A01,514034,Herbst; Matthew,0,2,16,16
1715610260010,MMW 12R,A02,514035,Herbst; Matthew,0,0,16,16
1715610261038,MMW 13R,A01,514037,Staff,0,5,16,16
1715610261038,MMW 13R,A02,514039,Staff,0,5,16,16
1715610261038,MMW 13R,A03,628519,Staff,0,4,16,16
1715610263092,SIO 295LS,A00,523233,Staff,10,0,30,20
1715610264118,SIO 295S,A00,523232,Staff,10,0,30,20
1715610265145,SIOC 290S,A01,637330,Merrifield; Mark A,23,0,30,7
1715610266171,SIOC 291S,A01,637333,Gabriel; Corey John,23,0,30,7
1715610267197,SOCI 117,A01,494376,Staff,0,5,5,5
1715610268222,WES 237B,A00,494380,Staff,10,0,20,10
1715610270293,AESE 279B,A00,494370,Wade; Jon P,0,0,33,33
1715610271319,AIP 97,001,660915,Van Den Einde; Yael Dahlia,9999,0,9999,0
1715610272348,AIP 197,001,627712,Vespa; Emanuel Ignacio,9995,0,9999,4
1715610272348,AIP 197,002,650778,Amir; On,9998,0,9999,1
1715610272348,AIP 197,003,650933,Avenancio-Leon; Carlos,9998,0,9999,1
1715610272348,AIP 197,004,658530,Heyman; Gail D.,9998,0,9999,1
1715610272348,AIP 197,005,658631,Neal; Sonya E,9998,0,9999,1
1715610272348,AIP 197,006,658671,Du; Songzi,9998,0,9999,1
1715610273377,ANAR 135S,A00,494369,Braswell; Geoffrey E.,0,0,0,0
1715610274407,BENG 196,001,628496,Engler; Adam J.,9998,0,9999,1
1715610274407,BENG 196,002,660916,Watson; John Thomas,9999,0,9999,0
1715610275432,BISP 197,001,650773,Wilhelm; James E.,9994,0,9999,5
1715610275432,BISP 197,002,658904,Coleman; Aaron B.,9998,0,9999,1
1715610276459,CAT 124RS,A01,519847,Geibel; William,0,0,20,20
1715610277485,CAT 125RS,A01,515971,Geibel; William,0,0,20,20
1715610278512,CLRE 250,A00,511389,Morris; Sheldon,9992,0,9999,7
1715610279539,CLRE 251,A00,507176,Mehta; Ravindra L.,9992,0,9999,7
1715610279539,CLRE 251,B00,511410,Mehta; Ravindra L.,9998,0,9999,1
1715610280570,CLRE 252,A00,507189,Cuomo; Raphael Eduardo,9994,0,9999,5
1715610281600,CLRE 253,A00,507199,Vaida; Florin,9994,0,9999,5
1715610281600,CLRE 253,B00,507202,Vaida; Florin,9999,0,9999,0
1715610282626,CLRE 259,A00,507211,Patel; Hemal,9996,0,9999,3
1715610283650,CLRE 260,A00,507221,Cuomo; Raphael Eduardo,9999,0,9999,0
1715610284676,CLRE 297,001,507242,Cuomo; Raphael Eduardo,9999,0,9999,0
1715610285701,COGS 197,001,638244,Voytek; Bradley Thomas,9997,0,9999,2
1715610286729,CSE 191,A00,516875,Minnes Kemp; Mor Mia,9991,0,9999,8
1715610287757,CSE 197,001,637388,Minnes Kemp; Mor Mia,9992,0,9999,7
1715610288788,CSS 201S,A01,494383,Mignozzetti; Umberto,35,0,35,0
1715610289818,CSS 202S,A01,494387,Mignozzetti; Umberto,35,0,35,0
1715610290848,DSC 197,001,628532,Eldridge; Justin Matthew,9995,0,9999,4
1715610291874,EAP 100,A00,516065,Staff,9799,0,9999,200
1715610292902,ECE 45,A01,507414,Staff,31,0,60,29
1715610294960,ECE 111,A01,507420,Staff,11,0,50,39
1715610295986,ECE 197,001,548057,Sievenpiper; Daniel F.,9991,0,9999,8
1715610297012,EDS 115,A00,507243,Choi; Bailey Miyeon,7,0,28,21
1715610298043,EDS 117,A01,494379,Staff,0,6,34,34
1715610299069,EDS 125,A00,507246,Hopkins; Megan Beth,8,0,30,22
1715610300095,EDS 128A,A01,507264,Fargason; Sharon Gayle,6,0,26,20
1715610301124,EDS 128B,A01,507293,Pappas; Elizabeth,10,0,30,20
1715610302151,EDS 139,A00,507294,Fargason; Sharon Gayle,10,0,30,20
1715610302151,EDS 139,B00,507313,Pappas; Elizabeth,11,0,30,19
1715610303178,EDS 201,A00,507315,Staff,10,0,30,20
1715610304205,EDS 203,A01,507317,Halter; Christopher P.,10,0,30,20
1715610305230,EDS 204R,A01,507319,Halter; Christopher P.,0,3,30,30
1715610305230,EDS 204R,B01,507331,Heinzman; Erica M.,14,0,30,16
1715610306256,EDS 206R,A00,507332,Staff,0,4,30,30
1715610306256,EDS 206R,B00,507343,Staff,15,0,30,15
1715610307284,EDS 250,A00,507344,Hemans; Patricia Ann Benitez,20,0,40,20
1715610308311,EDS 281,A00,507345,Daly; Alan J.,18,0,18,0
1715610309339,EDS 284,A00,507350,Daly; Alan J.,16,0,16,0
1715610310365,EDS 286,A00,507359,Fine; Sarah,18,0,18,0
1715610311389,EDS 289C,A01,507361,Daly; Alan J.,18,0,18,0
1715610312414,EDS 290,A00,507366,Hofstetter; Carolyn,15,0,15,0
1715610313442,LIGM 5A,A00,507421,Fischer-Grunski; Eva K,17,0,20,3
1715610314469,LIGM 5B,A00,507423,Fischer-Grunski; Eva K,19,0,20,1
1715610315495,LIGM 5C,A00,507425,Fischer-Grunski; Eva K,19,0,20,1
1715610316524,LIIT 5AS,A00,507427,Carnelos; Chiara,20,0,20,0
1715610317550,LIIT 5BS,A00,507430,Carnelos; Chiara,20,0,20,0
1715610318577,LIIT 5CS,A00,507432,Carnelos; Chiara,20,0,20,0
1715610319602,LISP 5A,A00,507541,Munoz Sanchez; Alicia,11,0,20,9
1715610320632,LISP 5B,A00,507671,Munoz Sanchez; Alicia,9,0,20,11
1715610321661,LISP 5C,A00,507696,Munoz Sanchez; Alicia,9,0,20,11
1715610322686,MAE 197,001,528363,Boechler; Nicholas Sebastia,9998,0,9999,1
1715610323718,MATH 197,001,523477,Kedlaya; Kiran S.,9994,0,9999,5
1715610323718,MATH 197,002,563811,Zhang; Danna,9994,0,9999,5
1715610323718,MATH 197,003,628552,Dumitriu; Ioana,9998,0,9999,1
1715610323718,MATH 197,004,660885,Floyd; Eric,9999,0,9999,0
1715610324744,MCWP 40R,A00,518780,Staff,2,0,20,18
1715610324744,MCWP 40R,B00,518781,Staff,11,0,20,9
1715610324744,MCWP 40R,C00,518783,Staff,5,0,20,15
1715610325771,MCWP 50R,A00,518791,Staff,0,1,20,20
1715610325771,MCWP 50R,B00,518792,Staff,0,2,20,20
1715610325771,MCWP 50R,C00,518793,Staff,0,4,20,20
1715610325771,MCWP 50R,D00,518794,Staff,0,1,20,20
1715610325771,MCWP 50R,E00,518795,Staff,0,2,20,20
1715610325771,MCWP 50R,F00,518796,Staff,0,1,20,20
1715610325771,MCWP 50R,G00,518797,Staff,0,1,20,20
1715610326798,MMW 12R,A01,514034,Herbst; Matthew,0,2,16,16
1715610326798,MMW 12R,A02,514035,Herbst; Matthew,0,0,16,16
1715610327827,MMW 13R,A01,514037,Staff,0,5,16,16
1715610327827,MMW 13R,A02,514039,Staff,0,5,16,16
1715610327827,MMW 13R,A03,628519,Staff,0,4,16,16
1715610329879,SIO 295LS,A00,523233,Staff,10,0,30,20
1715610330904,SIO 295S,A00,523232,Staff,10,0,30,20
1715610331936,SIOC 290S,A01,637330,Merrifield; Mark A,23,0,30,7
1715610332966,SIOC 291S,A01,637333,Gabriel; Corey John,23,0,30,7
1715610333992,SOCI 117,A01,494376,Staff,0,5,5,5
1715610335021,WES 237B,A00,494380,Staff,10,0,20,10
1715610337106,AESE 279B,A00,494370,Wade; Jon P,0,0,33,33
1715610338133,AIP 97,001,660915,Van Den Einde; Yael Dahlia,9999,0,9999,0
1715610339162,AIP 197,001,627712,Vespa; Emanuel Ignacio,9995,0,9999,4
1715610339162,AIP 197,002,650778,Amir; On,9998,0,9999,1
1715610339162,AIP 197,003,650933,Avenancio-Leon; Carlos,9998,0,9999,1
1715610339162,AIP 197,004,658530,Heyman; Gail D.,9998,0,9999,1
1715610339162,AIP 197,005,658631,Neal; Sonya E,9998,0,9999,1
1715610339162,AIP 197,006,658671,Du; Songzi,9998,0,9999,1
1715610340189,ANAR 135S,A00,494369,Braswell; Geoffrey E.,0,0,0,0
1715610341214,BENG 196,001,628496,Engler; Adam J.,9998,0,9999,1
1715610341214,BENG 196,002,660916,Watson; John Thomas,9999,0,9999,0
1715610342242,BISP 197,001,650773,Wilhelm; James E.,9994,0,9999,5
1715610342242,BISP 197,002,658904,Coleman; Aaron B.,9998,0,9999,1
1715610343268,CAT 124RS,A01,519847,Geibel; William,0,0,20,20
1715610344296,CAT 125RS,A01,515971,Geibel; William,0,0,20,20
1715610345327,CLRE 250,A00,511389,Morris; Sheldon,9992,0,9999,7
1715610346354,CLRE 251,A00,507176,Mehta; Ravindra L.,9992,0,9999,7
1715610346354,CLRE 251,B00,511410,Mehta; Ravindra L.,9998,0,9999,1
1715610347383,CLRE 252,A00,507189,Cuomo; Raphael Eduardo,9994,0,9999,5
1715610348409,CLRE 253,A00,507199,Vaida; Florin,9994,0,9999,5
1715610348409,CLRE 253,B00,507202,Vaida; Florin,9999,0,9999,0
1715610349439,CLRE 259,A00,507211,Patel; Hemal,9996,0,9999,3
1715610350464,CLRE 260,A00,507221,Cuomo; Raphael Eduardo,9999,0,9999,0
1715610351490,CLRE 297,001,507242,Cuomo; Raphael Eduardo,9999,0,9999,0
1715610352516,COGS 197,001,638244,Voytek; Bradley Thomas,9997,0,9999,2
1715610353541,CSE 191,A00,516875,Minnes Kemp; Mor Mia,9991,0,9999,8
1715610354566,CSE 197,001,637388,Minnes Kemp; Mor Mia,9992,0,9999,7
1715610355597,CSS 201S,A01,494383,Mignozzetti; Umberto,35,0,35,0
1715610356626,CSS 202S,A01,494387,Mignozzetti; Umberto,35,0,35,0
1715610357654,DSC 197,001,628532,Eldridge; Justin Matthew,9995,0,9999,4
1715610358682,EAP 100,A00,516065,Staff,9799,0,9999,200
1715610359715,ECE 45,A01,507414,Staff,31,0,60,29
1715610361769,ECE 111,A01,507420,Staff,11,0,50,39
1715610362795,ECE 197,001,548057,Sievenpiper; Daniel F.,9991,0,9999,8
1715610363822,EDS 115,A00,507243,Choi; Bailey Miyeon,7,0,28,21
1715610364851,EDS 117,A01,494379,Staff,0,6,34,34
1715610365878,EDS 125,A00,507246,Hopkins; Megan Beth,8,0,30,22
1715610366907,EDS 128A,A01,507264,Fargason; Sharon Gayle,6,0,26,20
1715610367932,EDS 128B,A01,507293,Pappas; Elizabeth,10,0,30,20
1715610368960,EDS 139,A00,507294,Fargason; Sharon Gayle,10,0,30,20
1715610368960,EDS 139,B00,507313,Pappas; Elizabeth,11,0,30,19
1715610369986,EDS 201,A00,507315,Staff,10,0,30,20
1715610371011,EDS 203,A01,507317,Halter; Christopher P.,10,0,30,20
1715610372042,EDS 204R,A01,507319,Halter; Christopher P.,0,3,30,30
1715610372042,EDS 204R,B01,507331,Heinzman; Erica M.,14,0,30,16
1715610373070,EDS 206R,A00,507332,Staff,0,4,30,30
1715610373070,EDS 206R,B00,507343,Staff,15,0,30,15
1715610374095,EDS 250,A00,507344,Hemans; Patricia Ann Benitez,20,0,40,20
1715610375120,EDS 281,A00,507345,Daly; Alan J.,18,0,18,0
1715610376147,EDS 284,A00,507350,Daly; Alan J.,16,0,16,0
1715610377176,EDS 286,A00,507359,Fine; Sarah,18,0,18,0
1715610378205,EDS 289C,A01,507361,Daly; Alan J.,18,0,18,0
1715610379232,EDS 290,A00,507366,Hofstetter; Carolyn,15,0,15,0
1715610380259,LIGM 5A,A00,507421,Fischer-Grunski; Eva K,17,0,20,3
1715610381285,LIGM 5B,A00,507423,Fischer-Grunski; Eva K,19,0,20,1
1715610382314,LIGM 5C,A00,507425,Fischer-Grunski; Eva K,19,0,20,1
1715610383345,LIIT 5AS,A00,507427,Carnelos; Chiara,20,0,20,0
1715610384373,LIIT 5BS,A00,507430,Carnelos; Chiara,20,0,20,0
1715610385403,LIIT 5CS,A00,507432,Carnelos; Chiara,20,0,20,0
1715610386429,LISP 5A,A00,507541,Munoz Sanchez; Alicia,11,0,20,9
1715610387457,LISP 5B,A00,507671,Munoz Sanchez; Alicia,9,0,20,11
1715610388483,LISP 5C,A00,507696,Munoz Sanchez; Alicia,9,0,20,11
1715610389508,MAE 197,001,528363,Boechler; Nicholas Sebastia,9998,0,9999,1
1715610390538,MATH 197,001,523477,Kedlaya; Kiran S.,9994,0,9999,5
1715610390538,MATH 197,002,563811,Zhang; Danna,9994,0,9999,5
1715610390538,MATH 197,003,628552,Dumitriu; Ioana,9998,0,9999,1
1715610390538,MATH 197,004,660885,Floyd; Eric,9999,0,9999,0
1715610391567,MCWP 40R,A00,518780,Staff,2,0,20,18
1715610391567,MCWP 40R,B00,518781,Staff,11,0,20,9
1715610391567,MCWP 40R,C00,518783,Staff,5,0,20,15
1715610392596,MCWP 50R,A00,518791,Staff,0,1,20,20
1715610392596,MCWP 50R,B00,518792,Staff,0,2,20,20
1715610392596,MCWP 50R,C00,518793,Staff,0,4,20,20
1715610392596,MCWP 50R,D00,518794,Staff,0,1,20,20
1715610392596,MCWP 50R,E00,518795,Staff,0,2,20,20
1715610392596,MCWP 50R,F00,518796,Staff,0,1,20,20
1715610392596,MCWP 50R,G00,518797,Staff,0,1,20,20
1715610393624,MMW 12R,A01,514034,Herbst; Matthew,0,2,16,16
1715610393624,MMW 12R,A02,514035,Herbst; Matthew,0,0,16,16
1715610394648,MMW 13R,A01,514037,Staff,0,5,16,16
1715610394648,MMW 13R,A02,514039,Staff,0,5,16,16
1715610394648,MMW 13R,A03,628519,Staff,0,4,16,16
1715610396701,SIO 295LS,A00,523233,Staff,10,0,30,20
1715610397729,SIO 295S,A00,523232,Staff,10,0,30,20
1715610398755,SIOC 290S,A01,637330,Merrifield; Mark A,23,0,30,7
1715610399789,SIOC 291S,A01,637333,Gabriel; Corey John,23,0,30,7
1715610400818,SOCI 117,A01,494376,Staff,0,5,5,5
1715610401844,WES 237B,A00,494380,Staff,10,0,20,10
1715610403934,AESE 279B,A00,494370,Wade; Jon P,0,0,33,33
1715610404959,AIP 97,001,660915,Van Den Einde; Yael Dahlia,9999,0,9999,0
1715610405992,AIP 197,001,627712,Vespa; Emanuel Ignacio,9995,0,9999,4
1715610405992,AIP 197,002,650778,Amir; On,9998,0,9999,1
1715610405992,AIP 197,003,650933,Avenancio-Leon; Carlos,9998,0,9999,1
1715610405992,AIP 197,004,658530,Heyman; Gail D.,9998,0,9999,1
1715610405992,AIP 197,005,658631,Neal; Sonya E,9998,0,9999,1
1715610405992,AIP 197,006,658671,Du; Songzi,9998,0,9999,1
1715610407018,ANAR 135S,A00,494369,Braswell; Geoffrey E.,0,0,0,0
1715610408044,BENG 196,001,628496,Engler; Adam J.,9998,0,9999,1
1715610408044,BENG 196,002,660916,Watson; John Thomas,9999,0,9999,0
1715610409071,BISP 197,001,650773,Wilhelm; James E.,9994,0,9999,5
1715610409071,BISP 197,002,658904,Coleman; Aaron B.,9998,0,9999,1
1715610410099,CAT 124RS,A01,519847,Geibel; William,0,0,20,20
1715610411124,CAT 125RS,A01,515971,Geibel; William,0,0,20,20
1715610412150,CLRE 250,A00,511389,Morris; Sheldon,9992,0,9999,7
1715610413178,CLRE 251,A00,507176,Mehta; Ravindra L.,9992,0,9999,7
1715610413178,CLRE 251,B00,511410,Mehta; Ravindra L.,9998,0,9999,1
1715610414206,CLRE 252,A00,507189,Cuomo; Raphael Eduardo,9994,0,9999,5
1715610415235,CLRE 253,A00,507199,Vaida; Florin,9994,0,9999,5
1715610415235,CLRE 253,B00,507202,Vaida; Florin,9999,0,9999,0
1715610416262,CLRE 259,A00,507211,Patel; Hemal,9996,0,9999,3
1715610417287,CLRE 260,A00,507221,Cuomo; Raphael Eduardo,9999,0,9999,0
1715610418312,CLRE 297,001,507242,Cuomo; Raphael Eduardo,9999,0,9999,0
1715610419338,COGS 197,001,638244,Voytek; Bradley Thomas,9997,0,9999,2
1715610420367,CSE 191,A00,516875,Minnes Kemp; Mor Mia,9991,0,9999,8
1715610421393,CSE 197,001,637388,Minnes Kemp; Mor Mia,9992,0,9999,7
1715610422418,CSS 201S,A01,494383,Mignozzetti; Umberto,35,0,35,0
1715610423446,CSS 202S,A01,494387,Mignozzetti; Umberto,35,0,35,0
1715610424472,DSC 197,001,628532,Eldridge; Justin Matthew,9995,0,9999,4
1715610425500,EAP 100,A00,516065,Staff,9799,0,9999,200
1715610426527,ECE 45,A01,507414,Staff,31,0,60,29
1715610428581,ECE 111,A01,507420,Staff,11,0,50,39
1715610429605,ECE 197,001,548057,Sievenpiper; Daniel F.,9991,0,9999,8
1715610430632,EDS 115,A00,507243,Choi; Bailey Miyeon,7,0,28,21
1715610431779,EDS 117,A01,494379,Staff,0,6,34,34
1715610432808,EDS 125,A00,507246,Hopkins; Megan Beth,8,0,30,22
1715610433833,EDS 128A,A01,507264,Fargason; Sharon Gayle,6,0,26,20
1715610434860,EDS 128B,A01,507293,Pappas; Elizabeth,10,0,30,20
1715610435886,EDS 139,A00,507294,Fargason; Sharon Gayle,10,0,30,20
1715610435886,EDS 139,B00,507313,Pappas; Elizabeth,11,0,30,19
1715610436914,EDS 201,A00,507315,Staff,10,0,30,20
1715610437941,EDS 203,A01,507317,Halter; Christopher P.,10,0,30,20
1715610438970,EDS 204R,A01,507319,Halter; Christopher P.,0,3,30,30
1715610438970,EDS 204R,B01,507331,Heinzman; Erica M.,14,0,30,16
1715610439997,EDS 206R,A00,507332,Staff,0,4,30,30
1715610439997,EDS 206R,B00,507343,Staff,15,0,30,15
1715610441025,EDS 250,A00,507344,Hemans; Patricia Ann Benitez,20,0,40,20
1715610442055,EDS 281,A00,507345,Daly; Alan J.,18,0,18,0
1715610443084,EDS 284,A00,507350,Daly; Alan J.,16,0,16,0
1715610444112,EDS 286,A00,507359,Fine; Sarah,18,0,18,0
1715610445138,EDS 289C,A01,507361,Daly; Alan J.,18,0,18,0
1715610446164,EDS 290,A00,507366,Hofstetter; Carolyn,15,0,15,0
1715610447192,LIGM 5A,A00,507421,Fischer-Grunski; Eva K,17,0,20,3
1715610448221,LIGM 5B,A00,507423,Fischer-Grunski; Eva K,19,0,20,1
1715610449244,LIGM 5C,A00,507425,Fischer-Grunski; Eva K,19,0,20,1
1715610450272,LIIT 5AS,A00,507427,Carnelos; Chiara,20,0,20,0
1715610451297,LIIT 5BS,A00,507430,Carnelos; Chiara,20,0,20,0
1715610452323,LIIT 5CS,A00,507432,Carnelos; Chiara,20,0,20,0
1715610453350,LISP 5A,A00,507541,Munoz Sanchez; Alicia,11,0,20,9
1715610454375,LISP 5B,A00,507671,Munoz Sanchez; Alicia,9,0,20,11
1715610455404,LISP 5C,A00,507696,Munoz Sanchez; Alicia,9,0,20,11
1715610456430,MAE 197,001,528363,Boechler; Nicholas Sebastia,9998,0,9999,1
1715610457459,MATH 197,001,523477,Kedlaya; Kiran S.,9994,0,9999,5
1715610457459,MATH 197,002,563811,Zhang; Danna,9994,0,9999,5
1715610457459,MATH 197,003,628552,Dumitriu; Ioana,9998,0,9999,1
1715610457459,MATH 197,004,660885,Floyd; Eric,9999,0,9999,0
1715610458486,MCWP 40R,A00,518780,Staff,2,0,20,18
1715610458486,MCWP 40R,B00,518781,Staff,11,0,20,9
1715610458486,MCWP 40R,C00,518783,Staff,5,0,20,15
1715610459513,MCWP 50R,A00,518791,Staff,0,1,20,20
1715610459513,MCWP 50R,B00,518792,Staff,0,2,20,20
1715610459513,MCWP 50R,C00,518793,Staff,0,4,20,20
1715610459513,MCWP 50R,D00,518794,Staff,0,1,20,20
1715610459513,MCWP 50R,E00,518795,Staff,0,2,20,20
1715610459513,MCWP 50R,F00,518796,Staff,0,1,20,20
1715610459513,MCWP 50R,G00,518797,Staff,0,1,20,20
1715610460540,MMW 12R,A01,514034,Herbst; Matthew,0,2,16,16
1715610460540,MMW 12R,A02,514035,Herbst; Matthew,0,0,16,16
1715610461565,MMW 13R,A01,514037,Staff,0,5,16,16
1715610461565,MMW 13R,A02,514039,Staff,0,5,16,16
1715610461565,MMW 13R,A03,628519,Staff,0,4,16,16
1715610463617,SIO 295LS,A00,523233,Staff,10,0,30,20
1715610464641,SIO 295S,A00,523232,Staff,10,0,30,20
1715610465668,SIOC 290S,A01,637330,Merrifield; Mark A,23,0,30,7
1715610466694,SIOC 291S,A01,637333,Gabriel; Corey John,23,0,30,7
1715610467720,SOCI 117,A01,494376,Staff,0,5,5,5
1715610468748,WES 237B,A00,494380,Staff,10,0,20,10
1715610470818,AESE 279B,A00,494370,Wade; Jon P,0,0,33,33
1715610471847,AIP 97,001,660915,Van Den Einde; Yael Dahlia,9999,0,9999,0
1715610472878,AIP 197,001,627712,Vespa; Emanuel Ignacio,9995,0,9999,4
1715610472878,AIP 197,002,650778,Amir; On,9998,0,9999,1
1715610472878,AIP 197,003,650933,Avenancio-Leon; Carlos,9998,0,9999,1
1715610472878,AIP 197,004,658530,Heyman; Gail D.,9998,0,9999,1
1715610472878,AIP 197,005,658631,Neal; Sonya E,9998,0,9999,1
1715610472878,AIP 197,006,658671,Du; Songzi,9998,0,9999,1
1715610473905,ANAR 135S,A00,494369,Braswell; Geoffrey E.,0,0,0,0
1715610474933,BENG 196,001,628496,Engler; Adam J.,9998,0,9999,1
1715610474933,BENG 196,002,660916,Watson; John Thomas,9999,0,9999,0
1715610475958,BISP 197,001,650773,Wilhelm; James E.,9994,0,9999,5
1715610475958,BISP 197,002,658904,Coleman; Aaron B.,9998,0,9999,1
1715610476986,CAT 124RS,A01,519847,Geibel; William,0,0,20,20
1715610478013,CAT 125RS,A01,515971,Geibel; William,0,0,20,20
1715610479038,CLRE 250,A00,511389,Morris; Sheldon,9992,0,9999,7
1715610480066,CLRE 251,A00,507176,Mehta; Ravindra L.,9992,0,9999,7
1715610480066,CLRE 251,B00,511410,Mehta; Ravindra L.,9998,0,9999,1
1715610481090,CLRE 252,A00,507189,Cuomo; Raphael Eduardo,9994,0,9999,5
1715610482120,CLRE 253,A00,507199,Vaida; Florin,9994,0,9999,5
1715610482120,CLRE 253,B00,507202,Vaida; Florin,9999,0,9999,0
1715610483147,CLRE 259,A00,507211,Patel; Hemal,9996,0,9999,3
1715610484172,CLRE 260,A00,507221,Cuomo; Raphael Eduardo,9999,0,9999,0
1715610485199,CLRE 297,001,507242,Cuomo; Raphael Eduardo,9999,0,9999,0
1715610486227,COGS 197,001,638244,Voytek; Bradley Thomas,9997,0,9999,2
1715610487253,CSE 191,A00,516875,Minnes Kemp; Mor Mia,9991,0,9999,8
1715610488280,CSE 197,001,637388,Minnes Kemp; Mor Mia,9992,0,9999,7
1715610489311,CSS 201S,A01,494383,Mignozzetti; Umberto,35,0,35,0
1715610490337,CSS 202S,A01,494387,Mignozzetti; Umberto,35,0,35,0
1715610491421,DSC 197,001,628532,Eldridge; Justin Matthew,9995,0,9999,4
1715610492445,EAP 100,A00,516065,Staff,9799,0,9999,200
1715610493472,ECE 45,A01,507414,Staff,31,0,60,29
1715610495524,ECE 111,A01,507420,Staff,11,0,50,39
1715610496550,ECE 197,001,548057,Sievenpiper; Daniel F.,9991,0,9999,8
1715610497576,EDS 115,A00,507243,Choi; Bailey Miyeon,7,0,28,21
1715610498602,EDS 117,A01,494379,Staff,0,6,34,34
1715610499632,EDS 125,A00,507246,Hopkins; Megan Beth,8,0,30,22
1715610500659,EDS 128A,A01,507264,Fargason; Sharon Gayle,6,0,26,20
1715610501683,EDS 128B,A01,507293,Pappas; Elizabeth,10,0,30,20
1715610502708,EDS 139,A00,507294,Fargason; Sharon Gayle,10,0,30,20
1715610502708,EDS 139,B00,507313,Pappas; Elizabeth,11,0,30,19
1715610503735,EDS 201,A00,507315,Staff,10,0,30,20
1715610504761,EDS 203,A01,507317,Halter; Christopher P.,10,0,30,20
1715610505790,EDS 204R,A01,507319,Halter; Christopher P.,0,3,30,30
1715610505790,EDS 204R,B01,507331,Heinzman; Erica M.,14,0,30,16
1715610506816,EDS 206R,A00,507332,Staff,0,4,30,30
1715610506816,EDS 206R,B00,507343,Staff,15,0,30,15
1715610507843,EDS 250,A00,507344,Hemans; Patricia Ann Benitez,20,0,40,20
1715610508869,EDS 281,A00,507345,Daly; Alan J.,18,0,18,0
1715610509894,EDS 284,A00,507350,Daly; Alan J.,16,0,16,0
1715610510923,EDS 286,A00,507359,Fine; Sarah,18,0,18,0
1715610511948,EDS 289C,A01,507361,Daly; Alan J.,18,0,18,0
1715610512975,EDS 290,A00,507366,Hofstetter; Carolyn,15,0,15,0
1715610514006,LIGM 5A,A00,507421,Fischer-Grunski; Eva K,17,0,20,3
1715610515034,LIGM 5B,A00,507423,Fischer-Grunski; Eva K,19,0,20,1
1715610516060,LIGM 5C,A00,507425,Fischer-Grunski; Eva K,19,0,20,1
1715610517091,LIIT 5AS,A00,507427,Carnelos; Chiara,20,0,20,0
1715610518118,LIIT 5BS,A00,507430,Carnelos; Chiara,20,0,20,0
1715610519142,LIIT 5CS,A00,507432,Carnelos; Chiara,20,0,20,0
1715610520169,LISP 5A,A00,507541,Munoz Sanchez; Alicia,11,0,20,9
1715610521198,LISP 5B,A00,507671,Munoz Sanchez; Alicia,9,0,20,11
1715610522224,LISP 5C,A00,507696,Munoz Sanchez; Alicia,9,0,20,11
1715610523251,MAE 197,001,528363,Boechler; Nicholas Sebastia,9998,0,9999,1
1715610524285,MATH 197,001,523477,Kedlaya; Kiran S.,9994,0,9999,5
1715610524285,MATH 197,002,563811,Zhang; Danna,9994,0,9999,5
1715610524285,MATH 197,003,628552,Dumitriu; Ioana,9998,0,9999,1
1715610524285,MATH 197,004,660885,Floyd; Eric,9999,0,9999,0
1715610525317,MCWP 40R,A00,518780,Staff,2,0,20,18
1715610525317,MCWP 40R,B00,518781,Staff,11,0,20,9
1715610525317,MCWP 40R,C00,518783,Staff,5,0,20,15
1715610526345,MCWP 50R,A00,518791,Staff,0,1,20,20
1715610526345,MCWP 50R,B00,518792,Staff,0,2,20,20
1715610526345,MCWP 50R,C00,518793,Staff,0,4,20,20
1715610526345,MCWP 50R,D00,518794,Staff,0,1,20,20
1715610526345,MCWP 50R,E00,518795,Staff,0,2,20,20
1715610526345,MCWP 50R,F00,518796,Staff,0,1,20,20
1715610526345,MCWP 50R,G00,518797,Staff,0,1,20,20
1715610527371,MMW 12R,A01,514034,Herbst; Matthew,0,2,16,16
1715610527371,MMW 12R,A02,514035,Herbst; Matthew,0,0,16,16
1715610528397,MMW 13R,A01,514037,Staff,0,5,16,16
1715610528397,MMW 13R,A02,514039,Staff,0,5,16,16
1715610528397,MMW 13R,A03,628519,Staff,0,4,16,16
1715610530454,SIO 295LS,A00,523233,Staff,10,0,30,20
1715610531480,SIO 295S,A00,523232,Staff,10,0,30,20
1715610532511,SIOC 290S,A01,637330,Merrifield; Mark A,23,0,30,7
1715610533537,SIOC 291S,A01,637333,Gabriel; Corey John,23,0,30,7
1715610534563,SOCI 117,A01,494376,Staff,0,5,5,5
1715610535591,WES 237B,A00,494380,Staff,10,0,20,10
1715610537673,AESE 279B,A00,494370,Wade; Jon P,0,0,33,33
1715610538703,AIP 97,001,660915,Van Den Einde; Yael Dahlia,9999,0,9999,0
1715610539731,AIP 197,001,627712,Vespa; Emanuel Ignacio,9995,0,9999,4
1715610539731,AIP 197,002,650778,Amir; On,9998,0,9999,1
1715610539731,AIP 197,003,650933,Avenancio-Leon; Carlos,9998,0,9999,1
1715610539731,AIP 197,004,658530,Heyman; Gail D.,9998,0,9999,1
1715610539731,AIP 197,005,658631,Neal; Sonya E,9998,0,9999,1
1715610539731,AIP 197,006,658671,Du; Songzi,9998,0,9999,1
1715610540762,ANAR 135S,A00,494369,Braswell; Geoffrey E.,0,0,0,0
1715610541786,BENG 196,001,628496,Engler; Adam J.,9998,0,9999,1
1715610541786,BENG 196,002,660916,Watson; John Thomas,9999,0,9999,0
1715610542814,BISP 197,001,650773,Wilhelm; James E.,9994,0,9999,5
1715610542814,BISP 197,002,658904,Coleman; Aaron B.,9998,0,9999,1
1715610543843,CAT 124RS,A01,519847,Geibel; William,0,0,20,20
1715610544872,CAT 125RS,A01,515971,Geibel; William,0,0,20,20
1715610545899,CLRE 250,A00,511389,Morris; Sheldon,9992,0,9999,7
1715610546927,CLRE 251,A00,507176,Mehta; Ravindra L.,9992,0,9999,7
1715610546927,CLRE 251,B00,511410,Mehta; Ravindra L.,9998,0,9999,1
1715610547951,CLRE 252,A00,507189,Cuomo; Raphael Eduardo,9994,0,9999,5
1715610548981,CLRE 253,A00,507199,Vaida; Florin,9994,0,9999,5
1715610548981,CLRE 253,B00,507202,Vaida; Florin,9999,0,9999,0
1715610550007,CLRE 259,A00,507211,Patel; Hemal,9996,0,9999,3
1715610551035,CLRE 260,A00,507221,Cuomo; Raphael Eduardo,9999,0,9999,0
1715610552062,CLRE 297,001,507242,Cuomo; Raphael Eduardo,9999,0,9999,0
1715610553090,COGS 197,001,638244,Voytek; Bradley Thomas,9997,0,9999,2
1715610554116,CSE 191,A00,516875,Minnes Kemp; Mor Mia,9991,0,9999,8
1715610555142,CSE 197,001,637388,Minnes Kemp; Mor Mia,9992,0,9999,7
1715610556174,CSS 201S,A01,494383,Mignozzetti; Umberto,35,0,35,0
1715610557201,CSS 202S,A01,494387,Mignozzetti; Umberto,35,0,35,0
1715610558229,DSC 197,001,628532,Eldridge; Justin Matthew,9995,0,9999,4
1715610559255,EAP 100,A00,516065,Staff,9799,0,9999,200
1715610560285,ECE 45,A01,507414,Staff,31,0,60,29
1715610562339,ECE 111,A01,507420,Staff,11,0,50,39
1715610563365,ECE 197,001,548057,Sievenpiper; Daniel F.,9991,0,9999,8
1715610564392,EDS 115,A00,507243,Choi; Bailey Miyeon,7,0,28,21
1715610565421,EDS 117,A01,494379,Staff,0,6,34,34
1715610566445,EDS 125,A00,507246,Hopkins; Megan Beth,8,0,30,22
1715610567472,EDS 128A,A01,507264,Fargason; Sharon Gayle,6,0,26,20
1715610568501,EDS 128B,A01,507293,Pappas; Elizabeth,10,0,30,20
1715610569526,EDS 139,A00,507294,Fargason; Sharon Gayle,10,0,30,20
1715610569526,EDS 139,B00,507313,Pappas; Elizabeth,11,0,30,19
1715610570551,EDS 201,A00,507315,Staff,10,0,30,20
1715610571577,EDS 203,A01,507317,Halter; Christopher P.,10,0,30,20
1715610572603,EDS 204R,A01,507319,Halter; Christopher P.,0,3,30,30
1715610572603,EDS 204R,B01,507331,Heinzman; Erica M.,14,0,30,16
1715610573630,EDS 206R,A00,507332,Staff,0,4,30,30
1715610573630,EDS 206R,B00,507343,Staff,15,0,30,15
1715610574658,EDS 250,A00,507344,Hemans; Patricia Ann Benitez,20,0,40,20
1715610575685,EDS 281,A00,507345,Daly; Alan J.,18,0,18,0
1715610576710,EDS 284,A00,507350,Daly; Alan J.,16,0,16,0
1715610577735,EDS 286,A00,507359,Fine; Sarah,18,0,18,0
1715610578760,EDS 289C,A01,507361,Daly; Alan J.,18,0,18,0
1715610579786,EDS 290,A00,507366,Hofstetter; Carolyn,15,0,15,0
1715610580813,LIGM 5A,A00,507421,Fischer-Grunski; Eva K,17,0,20,3
1715610581840,LIGM 5B,A00,507423,Fischer-Grunski; Eva K,19,0,20,1
1715610582866,LIGM 5C,A00,507425,Fischer-Grunski; Eva K,19,0,20,1
1715610583890,LIIT 5AS,A00,507427,Carnelos; Chiara,20,0,20,0
1715610584918,LIIT 5BS,A00,507430,Carnelos; Chiara,20,0,20,0
1715610585947,LIIT 5CS,A00,507432,Carnelos; Chiara,20,0,20,0
1715610586973,LISP 5A,A00,507541,Munoz Sanchez; Alicia,11,0,20,9
1715610588002,LISP 5B,A00,507671,Munoz Sanchez; Alicia,9,0,20,11
1715610589026,LISP 5C,A00,507696,Munoz Sanchez; Alicia,9,0,20,11
1715610590051,MAE 197,001,528363,Boechler; Nicholas Sebastia,9998,0,9999,1
1715610591080,MATH 197,001,523477,Kedlaya; Kiran S.,9994,0,9999,5
1715610591080,MATH 197,002,563811,Zhang; Danna,9994,0,9999,5
1715610591080,MATH 197,003,628552,Dumitriu; Ioana,9998,0,9999,1
1715610591080,MATH 197,004,660885,Floyd; Eric,9999,0,9999,0
1715610592107,MCWP 40R,A00,518780,Staff,2,0,20,18
1715610592107,MCWP 40R,B00,518781,Staff,11,0,20,9
1715610592107,MCWP 40R,C00,518783,Staff,5,0,20,15
1715610593133,MCWP 50R,A00,518791,Staff,0,1,20,20
1715610593133,MCWP 50R,B00,518792,Staff,0,2,20,20
1715610593133,MCWP 50R,C00,518793,Staff,0,4,20,20
1715610593133,MCWP 50R,D00,518794,Staff,0,1,20,20
1715610593133,MCWP 50R,E00,518795,Staff,0,2,20,20
1715610593133,MCWP 50R,F00,518796,Staff,0,1,20,20
1715610593133,MCWP 50R,G00,518797,Staff,0,1,20,20
1715610594163,MMW 12R,A01,514034,Herbst; Matthew,0,2,16,16
1715610594163,MMW 12R,A02,514035,Herbst; Matthew,0,0,16,16
1715610595193,MMW 13R,A01,514037,Staff,0,5,16,16
1715610595193,MMW 13R,A02,514039,Staff,0,5,16,16
1715610595193,MMW 13R,A03,628519,Staff,0,4,16,16
1715610597246,SIO 295LS,A00,523233,Staff,10,0,30,20
1715610598271,SIO 295S,A00,523232,Staff,10,0,30,20
1715610599300,SIOC 290S,A01,637330,Merrifield; Mark A,23,0,30,7
1715610600328,SIOC 291S,A01,637333,Gabriel; Corey John,23,0,30,7
1715610601356,SOCI 117,A01,494376,Staff,0,5,5,5
1715610602381,WES 237B,A00,494380,Staff,10,0,20,10
1715610604468,AESE 279B,A00,494370,Wade; Jon P,0,0,33,33
1715610605493,AIP 97,001,660915,Van Den Einde; Yael Dahlia,9999,0,9999,0
1715610606525,AIP 197,001,627712,Vespa; Emanuel Ignacio,9995,0,9999,4
1715610606525,AIP 197,002,650778,Amir; On,9998,0,9999,1
1715610606525,AIP 197,003,650933,Avenancio-Leon; Carlos,9998,0,9999,1
1715610606525,AIP 197,004,658530,Heyman; Gail D.,9998,0,9999,1
1715610606525,AIP 197,005,658631,Neal; Sonya E,9998,0,9999,1
1715610606525,AIP 197,006,658671,Du; Songzi,9998,0,9999,1
1715610607550,ANAR 135S,A00,494369,Braswell; Geoffrey E.,0,0,0,0
1715610608575,BENG 196,001,628496,Engler; Adam J.,9998,0,9999,1
1715610608575,BENG 196,002,660916,Watson; John Thomas,9999,0,9999,0
1715610609602,BISP 197,001,650773,Wilhelm; James E.,9994,0,9999,5
1715610609602,BISP 197,002,658904,Coleman; Aaron B.,9998,0,9999,1
1715610610630,CAT 124RS,A01,519847,Geibel; William,0,0,20,20
1715610611656,CAT 125RS,A01,515971,Geibel; William,0,0,20,20
1715610612688,CLRE 250,A00,511389,Morris; Sheldon,9992,0,9999,7
1715610613721,CLRE 251,A00,507176,Mehta; Ravindra L.,9992,0,9999,7
1715610613721,CLRE 251,B00,511410,Mehta; Ravindra L.,9998,0,9999,1
1715610614749,CLRE 252,A00,507189,Cuomo; Raphael Eduardo,9994,0,9999,5
1715610615777,CLRE 253,A00,507199,Vaida; Florin,9994,0,9999,5
1715610615777,CLRE 253,B00,507202,Vaida; Florin,9999,0,9999,0
1715610616802,CLRE 259,A00,507211,Patel; Hemal,9996,0,9999,3
1715610617830,CLRE 260,A00,507221,Cuomo; Raphael Eduardo,9999,0,9999,0
1715610618858,CLRE 297,001,507242,Cuomo; Raphael Eduardo,9999,0,9999,0
1715610619886,COGS 197,001,638244,Voytek; Bradley Thomas,9997,0,9999,2
1715610620913,CSE 191,A00,516875,Minnes Kemp; Mor Mia,9991,0,9999,8
1715610621941,CSE 197,001,637388,Minnes Kemp; Mor Mia,9992,0,9999,7
1715610622970,CSS 201S,A01,494383,Mignozzetti; Umberto,35,0,35,0
1715610623996,CSS 202S,A01,494387,Mignozzetti; Umberto,35,0,35,0
1715610625022,DSC 197,001,628532,Eldridge; Justin Matthew,9995,0,9999,4
1715610626049,EAP 100,A00,516065,Staff,9799,0,9999,200
1715610627078,ECE 45,A01,507414,Staff,31,0,60,29
1715610629132,ECE 111,A01,507420,Staff,11,0,50,39
1715610630161,ECE 197,001,548057,Sievenpiper; Daniel F.,9991,0,9999,8
1715610631185,EDS 115,A00,507243,Choi; Bailey Miyeon,7,0,28,21
1715610632212,EDS 117,A01,494379,Staff,0,6,34,34
1715610633242,EDS 125,A00,507246,Hopkins; Megan Beth,8,0,30,22
1715610634273,EDS 128A,A01,507264,Fargason; Sharon Gayle,6,0,26,20
1715610635302,EDS 128B,A01,507293,Pappas; Elizabeth,10,0,30,20
1715610636329,EDS 139,A00,507294,Fargason; Sharon Gayle,10,0,30,20
1715610636329,EDS 139,B00,507313,Pappas; Elizabeth,11,0,30,19
1715610637356,EDS 201,A00,507315,Staff,10,0,30,20
1715610638383,EDS 203,A01,507317,Halter; Christopher P.,10,0,30,20
1715610639421,EDS 204R,A01,507319,Halter; Christopher P.,0,3,30,30
1715610639421,EDS 204R,B01,507331,Heinzman; Erica M.,14,0,30,16
1715610640446,EDS 206R,A00,507332,Staff,0,4,30,30
1715610640446,EDS 206R,B00,507343,Staff,15,0,30,15
1715610641473,EDS 250,A00,507344,Hemans; Patricia Ann Benitez,20,0,40,20
1715610642498,EDS 281,A00,507345,Daly; Alan J.,18,0,18,0
1715610643526,EDS 284,A00,507350,Daly; Alan J.,16,0,16,0
1715610644553,EDS 286,A00,507359,Fine; Sarah,18,0,18,0
1715610645581,EDS 289C,A01,507361,Daly; Alan J.,18,0,18,0
1715610646606,EDS 290,A00,507366,Hofstetter; Carolyn,15,0,15,0
1715610647637,LIGM 5A,A00,507421,Fischer-Grunski; Eva K,17,0,20,3
1715610648662,LIGM 5B,A00,507423,Fischer-Grunski; Eva K,19,0,20,1
1715610649690,LIGM 5C,A00,507425,Fischer-Grunski; Eva K,19,0,20,1
1715610650717,LIIT 5AS,A00,507427,Carnelos; Chiara,20,0,20,0
1715610651746,LIIT 5BS,A00,507430,Carnelos; Chiara,20,0,20,0
1715610652774,LIIT 5CS,A00,507432,Carnelos; Chiara,20,0,20,0
1715610653802,LISP 5A,A00,507541,Munoz Sanchez; Alicia,11,0,20,9
1715610654827,LISP 5B,A00,507671,Munoz Sanchez; Alicia,9,0,20,11
1715610655853,LISP 5C,A00,507696,Munoz Sanchez; Alicia,9,0,20,11
1715610656879,MAE 197,001,528363,Boechler; Nicholas Sebastia,9998,0,9999,1
1715610657909,MATH 197,001,523477,Kedlaya; Kiran S.,9994,0,9999,5
1715610657909,MATH 197,002,563811,Zhang; Danna,9994,0,9999,5
1715610657909,MATH 197,003,628552,Dumitriu; Ioana,9998,0,9999,1
1715610657909,MATH 197,004,660885,Floyd; Eric,9999,0,9999,0
1715610658937,MCWP 40R,A00,518780,Staff,2,0,20,18
1715610658937,MCWP 40R,B00,518781,Staff,11,0,20,9
1715610658937,MCWP 40R,C00,518783,Staff,5,0,20,15
1715610659965,MCWP 50R,A00,518791,Staff,0,1,20,20
1715610659965,MCWP 50R,B00,518792,Staff,0,2,20,20
1715610659965,MCWP 50R,C00,518793,Staff,0,4,20,20
1715610659965,MCWP 50R,D00,518794,Staff,0,1,20,20
1715610659965,MCWP 50R,E00,518795,Staff,0,2,20,20
1715610659965,MCWP 50R,F00,518796,Staff,0,1,20,20
1715610659965,MCWP 50R,G00,518797,Staff,0,1,20,20
1715610660991,MMW 12R,A01,514034,Herbst; Matthew,0,2,16,16
1715610660991,MMW 12R,A02,514035,Herbst; Matthew,0,0,16,16
1715610662019,MMW 13R,A01,514037,Staff,0,5,16,16
1715610662019,MMW 13R,A02,514039,Staff,0,5,16,16
1715610662019,MMW 13R,A03,628519,Staff,0,4,16,16
1715610664078,SIO 295LS,A00,523233,Staff,10,0,30,20
1715610665107,SIO 295S,A00,523232,Staff,10,0,30,20
1715610666134,SIOC 290S,A01,637330,Merrifield; Mark A,23,0,30,7
1715610667162,SIOC 291S,A01,637333,Gabriel; Corey John,23,0,30,7
1715610668266,SOCI 117,A01,494376,Staff,0,5,5,5
1715610669295,WES 237B,A00,494380,Staff,10,0,20,10
1715610671383,AESE 279B,A00,494370,Wade; Jon P,0,0,33,33
1715610672412,AIP 97,001,660915,Van Den Einde; Yael Dahlia,9999,0,9999,0
1715610673445,AIP 197,001,627712,Vespa; Emanuel Ignacio,9995,0,9999,4
1715610673445,AIP 197,002,650778,Amir; On,9998,0,9999,1
1715610673445,AIP 197,003,650933,Avenancio-Leon; Carlos,9998,0,9999,1
1715610673445,AIP 197,004,658530,Heyman; Gail D.,9998,0,9999,1
1715610673445,AIP 197,005,658631,Neal; Sonya E,9998,0,9999,1
1715610673445,AIP 197,006,658671,Du; Songzi,9998,0,9999,1
1715610674473,ANAR 135S,A00,494369,Braswell; Geoffrey E.,0,0,0,0
1715610675501,BENG 196,001,628496,Engler; Adam J.,9998,0,9999,1
1715610675501,BENG 196,002,660916,Watson; John Thomas,9999,0,9999,0
1715610676527,BISP 197,001,650773,Wilhelm; James E.,9994,0,9999,5
1715610676527,BISP 197,002,658904,Coleman; Aaron B.,9998,0,9999,1
1715610677555,CAT 124RS,A01,519847,Geibel; William,0,0,20,20
1715610678581,CAT 125RS,A01,515971,Geibel; William,0,0,20,20
1715610679606,CLRE 250,A00,511389,Morris; Sheldon,9992,0,9999,7
1715610680634,CLRE 251,A00,507176,Mehta; Ravindra L.,9992,0,9999,7
1715610680634,CLRE 251,B00,511410,Mehta; Ravindra L.,9998,0,9999,1
1715610681659,CLRE 252,A00,507189,Cuomo; Raphael Eduardo,9994,0,9999,5
1715610682687,CLRE 253,A00,507199,Vaida; Florin,9994,0,9999,5
1715610682687,CLRE 253,B00,507202,Vaida; Florin,9999,0,9999,0
1715610683713,CLRE 259,A00,507211,Patel; Hemal,9996,0,9999,3
1715610684739,CLRE 260,A00,507221,Cuomo; Raphael Eduardo,9999,0,9999,0
1715610685769,CLRE 297,001,507242,Cuomo; Raphael Eduardo,9999,0,9999,0
1715610686795,COGS 197,001,638244,Voytek; Bradley Thomas,9997,0,9999,2
1715610687823,CSE 191,A00,516875,Minnes Kemp; Mor Mia,9991,0,9999,8
1715610688848,CSE 197,001,637388,Minnes Kemp; Mor Mia,9992,0,9999,7
1715610689882,CSS 201S,A01,494383,Mignozzetti; Umberto,35,0,35,0
1715610690910,CSS 202S,A01,494387,Mignozzetti; Umberto,35,0,35,0
1715610691938,DSC 197,001,628532,Eldridge; Justin Matthew,9995,0,9999,4
1715610692962,EAP 100,A00,516065,Staff,9799,0,9999,200
1715610693994,ECE 45,A01,507414,Staff,31,0,60,29
1715610696045,ECE 111,A01,507420,Staff,11,0,50,39
1715610697072,ECE 197,001,548057,Sievenpiper; Daniel F.,9991,0,9999,8
1715610698099,EDS 115,A00,507243,Choi; Bailey Miyeon,7,0,28,21
1715610699129,EDS 117,A01,494379,Staff,0,6,34,34
1715610700157,EDS 125,A00,507246,Hopkins; Megan Beth,8,0,30,22
1715610701183,EDS 128A,A01,507264,Fargason; Sharon Gayle,6,0,26,20
1715610702209,EDS 128B,A01,507293,Pappas; Elizabeth,10,0,30,20
1715610703237,EDS 139,A00,507294,Fargason; Sharon Gayle,10,0,30,20
1715610703237,EDS 139,B00,507313,Pappas; Elizabeth,11,0,30,19
1715610704266,EDS 201,A00,507315,Staff,10,0,30,20
1715610705296,EDS 203,A01,507317,Halter; Christopher P.,10,0,30,20
1715610706323,EDS 204R,A01,507319,Halter; Christopher P.,0,3,30,30
1715610706323,EDS 204R,B01,507331,Heinzman; Erica M.,14,0,30,16
1715610707351,EDS 206R,A00,507332,Staff,0,4,30,30
1715610707351,EDS 206R,B00,507343,Staff,15,0,30,15
1715610708378,EDS 250,A00,507344,Hemans; Patricia Ann Benitez,20,0,40,20
1715610709405,EDS 281,A00,507345,Daly; Alan J.,18,0,18,0
1715610710431,EDS 284,A00,507350,Daly; Alan J.,16,0,16,0
1715610711459,EDS 286,A00,507359,Fine; Sarah,18,0,18,0
1715610712484,EDS 289C,A01,507361,Daly; Alan J.,18,0,18,0
1715610713510,EDS 290,A00,507366,Hofstetter; Carolyn,15,0,15,0
1715610714541,LIGM 5A,A00,507421,Fischer-Grunski; Eva K,17,0,20,3
1715610715567,LIGM 5B,A00,507423,Fischer-Grunski; Eva K,19,0,20,1
1715610716593,LIGM 5C,A00,507425,Fischer-Grunski; Eva K,19,0,20,1
1715610717623,LIIT 5AS,A00,507427,Carnelos; Chiara,20,0,20,0
1715610718651,LIIT 5BS,A00,507430,Carnelos; Chiara,20,0,20,0
1715610719680,LIIT 5CS,A00,507432,Carnelos; Chiara,20,0,20,0
1715610720711,LISP 5A,A00,507541,Munoz Sanchez; Alicia,11,0,20,9
1715610721741,LISP 5B,A00,507671,Munoz Sanchez; Alicia,9,0,20,11
1715610722767,LISP 5C,A00,507696,Munoz Sanchez; Alicia,9,0,20,11
1715610723795,MAE 197,001,528363,Boechler; Nicholas Sebastia,9998,0,9999,1
1715610724825,MATH 197,001,523477,Kedlaya; Kiran S.,9994,0,9999,5
1715610724825,MATH 197,002,563811,Zhang; Danna,9994,0,9999,5
1715610724825,MATH 197,003,628552,Dumitriu; Ioana,9998,0,9999,1
1715610724825,MATH 197,004,660885,Floyd; Eric,9999,0,9999,0
1715610725852,MCWP 40R,A00,518780,Staff,2,0,20,18
1715610725852,MCWP 40R,B00,518781,Staff,11,0,20,9
1715610725852,MCWP 40R,C00,518783,Staff,5,0,20,15
1715610726881,MCWP 50R,A00,518791,Staff,0,1,20,20
1715610726881,MCWP 50R,B00,518792,Staff,0,2,20,20
1715610726881,MCWP 50R,C00,518793,Staff,0,4,20,20
1715610726881,MCWP 50R,D00,518794,Staff,0,1,20,20
1715610726881,MCWP 50R,E00,518795,Staff,0,2,20,20
1715610726881,MCWP 50R,F00,518796,Staff,0,1,20,20
1715610726881,MCWP 50R,G00,518797,Staff,0,1,20,20
1715610727909,MMW 12R,A01,514034,Herbst; Matthew,0,2,16,16
1715610727909,MMW 12R,A02,514035,Herbst; Matthew,0,0,16,16
1715610728934,MMW 13R,A01,514037,Staff,0,5,16,16
1715610728934,MMW 13R,A02,514039,Staff,0,5,16,16
1715610728934,MMW 13R,A03,628519,Staff,0,4,16,16
1715610730987,SIO 295LS,A00,523233,Staff,10,0,30,20
1715610732014,SIO 295S,A00,523232,Staff,10,0,30,20
1715610733043,SIOC 290S,A01,637330,Merrifield; Mark A,23,0,30,7
1715610734127,SIOC 291S,A01,637333,Gabriel; Corey John,23,0,30,7
1715610735151,SOCI 117,A01,494376,Staff,0,5,5,5
1715610736180,WES 237B,A00,494380,Staff,10,0,20,10
1715610738253,AESE 279B,A00,494370,Wade; Jon P,0,0,33,33
1715610739282,AIP 97,001,660915,Van Den Einde; Yael Dahlia,9999,0,9999,0
1715610740314,AIP 197,001,627712,Vespa; Emanuel Ignacio,9995,0,9999,4
1715610740314,AIP 197,002,650778,Amir; On,9998,0,9999,1
1715610740314,AIP 197,003,650933,Avenancio-Leon; Carlos,9998,0,9999,1
1715610740314,AIP 197,004,658530,Heyman; Gail D.,9998,0,9999,1
1715610740314,AIP 197,005,658631,Neal; Sonya E,9998,0,9999,1
1715610740314,AIP 197,006,658671,Du; Songzi,9998,0,9999,1
1715610741341,ANAR 135S,A00,494369,Braswell; Geoffrey E.,0,0,0,0
1715610742371,BENG 196,001,628496,Engler; Adam J.,9998,0,9999,1
1715610742371,BENG 196,002,660916,Watson; John Thomas,9999,0,9999,0
1715610743399,BISP 197,001,650773,Wilhelm; James E.,9994,0,9999,5
1715610743399,BISP 197,002,658904,Coleman; Aaron B.,9998,0,9999,1
1715610744425,CAT 124RS,A01,519847,Geibel; William,0,0,20,20
1715610745451,CAT 125RS,A01,515971,Geibel; William,0,0,20,20
1715610746479,CLRE 250,A00,511389,Morris; Sheldon,9992,0,9999,7
1715610747505,CLRE 251,A00,507176,Mehta; Ravindra L.,9992,0,9999,7
1715610747505,CLRE 251,B00,511410,Mehta; Ravindra L.,9998,0,9999,1
1715610748534,CLRE 252,A00,507189,Cuomo; Raphael Eduardo,9994,0,9999,5
1715610749560,CLRE 253,A00,507199,Vaida; Florin,9994,0,9999,5
1715610749560,CLRE 253,B00,507202,Vaida; Florin,9999,0,9999,0
1715610750586,CLRE 259,A00,507211,Patel; Hemal,9996,0,9999,3
1715610751614,CLRE 260,A00,507221,Cuomo; Raphael Eduardo,9999,0,9999,0
1715610752639,CLRE 297,001,507242,Cuomo; Raphael Eduardo,9999,0,9999,0
1715610753669,COGS 197,001,638244,Voytek; Bradley Thomas,9997,0,9999,2
1715610754693,CSE 191,A00,516875,Minnes Kemp; Mor Mia,9991,0,9999,8
1715610755720,CSE 197,001,637388,Minnes Kemp; Mor Mia,9992,0,9999,7
1715610756750,CSS 201S,A01,494383,Mignozzetti; Umberto,35,0,35,0
1715610757775,CSS 202S,A01,494387,Mignozzetti; Umberto,35,0,35,0
1715610758802,DSC 197,001,628532,Eldridge; Justin Matthew,9995,0,9999,4
1715610759831,EAP 100,A00,516065,Staff,9799,0,9999,200
1715610760867,ECE 45,A01,507414,Staff,31,0,60,29
1715610762919,ECE 111,A01,507420,Staff,11,0,50,39
1715610763944,ECE 197,001,548057,Sievenpiper; Daniel F.,9991,0,9999,8
1715610764973,EDS 115,A00,507243,Choi; Bailey Miyeon,7,0,28,21
1715610766001,EDS 117,A01,494379,Staff,0,6,34,34
1715610767026,EDS 125,A00,507246,Hopkins; Megan Beth,8,0,30,22
1715610768056,EDS 128A,A01,507264,Fargason; Sharon Gayle,6,0,26,20
1715610769085,EDS 128B,A01,507293,Pappas; Elizabeth,10,0,30,20
1715610770108,EDS 139,A00,507294,Fargason; Sharon Gayle,10,0,30,20
1715610770108,EDS 139,B00,507313,Pappas; Elizabeth,11,0,30,19
1715610771135,EDS 201,A00,507315,Staff,10,0,30,20
1715610772161,EDS 203,A01,507317,Halter; Christopher P.,10,0,30,20
1715610773192,EDS 204R,A01,507319,Halter; Christopher P.,0,3,30,30
1715610773192,EDS 204R,B01,507331,Heinzman; Erica M.,14,0,30,16
1715610774217,EDS 206R,A00,507332,Staff,0,4,30,30
1715610774217,EDS 206R,B00,507343,Staff,15,0,30,15
1715610775245,EDS 250,A00,507344,Hemans; Patricia Ann Benitez,20,0,40,20
1715610776270,EDS 281,A00,507345,Daly; Alan J.,18,0,18,0
1715610777296,EDS 284,A00,507350,Daly; Alan J.,16,0,16,0
1715610778321,EDS 286,A00,507359,Fine; Sarah,18,0,18,0
1715610779348,EDS 289C,A01,507361,Daly; Alan J.,18,0,18,0
1715610780374,EDS 290,A00,507366,Hofstetter; Carolyn,15,0,15,0
1715610781404,LIGM 5A,A00,507421,Fischer-Grunski; Eva K,17,0,20,3
1715610782431,LIGM 5B,A00,507423,Fischer-Grunski; Eva K,19,0,20,1
1715610783459,LIGM 5C,A00,507425,Fischer-Grunski; Eva K,19,0,20,1
1715610784485,LIIT 5AS,A00,507427,Carnelos; Chiara,20,0,20,0
1715610785511,LIIT 5BS,A00,507430,Carnelos; Chiara,20,0,20,0
1715610786537,LIIT 5CS,A00,507432,Carnelos; Chiara,20,0,20,0
1715610787566,LISP 5A,A00,507541,Munoz Sanchez; Alicia,11,0,20,9
1715610788593,LISP 5B,A00,507671,Munoz Sanchez; Alicia,9,0,20,11
1715610789618,LISP 5C,A00,507696,Munoz Sanchez; Alicia,9,0,20,11
1715610790643,MAE 197,001,528363,Boechler; Nicholas Sebastia,9998,0,9999,1
1715610791673,MATH 197,001,523477,Kedlaya; Kiran S.,9994,0,9999,5
1715610791673,MATH 197,002,563811,Zhang; Danna,9994,0,9999,5
1715610791673,MATH 197,003,628552,Dumitriu; Ioana,9998,0,9999,1
1715610791673,MATH 197,004,660885,Floyd; Eric,9999,0,9999,0
1715610792699,MCWP 40R,A00,518780,Staff,2,0,20,18
1715610792699,MCWP 40R,B00,518781,Staff,11,0,20,9
1715610792699,MCWP 40R,C00,518783,Staff,5,0,20,15
1715610793723,MCWP 50R,A00,518791,Staff,0,1,20,20
1715610793723,MCWP 50R,B00,518792,Staff,0,2,20,20
1715610793723,MCWP 50R,C00,518793,Staff,0,4,20,20
1715610793723,MCWP 50R,D00,518794,Staff,0,1,20,20
1715610793723,MCWP 50R,E00,518795,Staff,0,2,20,20
1715610793723,MCWP 50R,F00,518796,Staff,0,1,20,20
1715610793723,MCWP 50R,G00,518797,Staff,0,1,20,20
1715610794751,MMW 12R,A01,514034,Herbst; Matthew,0,2,16,16
1715610794751,MMW 12R,A02,514035,Herbst; Matthew,0,0,16,16
1715610795776,MMW 13R,A01,514037,Staff,0,5,16,16
1715610795776,MMW 13R,A02,514039,Staff,0,5,16,16
1715610795776,MMW 13R,A03,628519,Staff,0,4,16,16
1715610797831,SIO 295LS,A00,523233,Staff,10,0,30,20
1715610798858,SIO 295S,A00,523232,Staff,10,0,30,20
1715610799887,SIOC 290S,A01,637330,Merrifield; Mark A,23,0,30,7
1715610800915,SIOC 291S,A01,637333,Gabriel; Corey John,23,0,30,7
1715610801941,SOCI 117,A01,494376,Staff,0,5,5,5
1715610802970,WES 237B,A00,494380,Staff,10,0,20,10
1715610805053,AESE 279B,A00,494370,Wade; Jon P,0,0,33,33
1715610806080,AIP 97,001,660915,Van Den Einde; Yael Dahlia,9999,0,9999,0
1715610807111,AIP 197,001,627712,Vespa; Emanuel Ignacio,9995,0,9999,4
1715610807111,AIP 197,002,650778,Amir; On,9998,0,9999,1
1715610807111,AIP 197,003,650933,Avenancio-Leon; Carlos,9998,0,9999,1
1715610807111,AIP 197,004,658530,Heyman; Gail D.,9998,0,9999,1
1715610807111,AIP 197,005,658631,Neal; Sonya E,9998,0,9999,1
1715610807111,AIP 197,006,658671,Du; Songzi,9998,0,9999,1
1715610808136,ANAR 135S,A00,494369,Braswell; Geoffrey E.,0,0,0,0
1715610809163,BENG 196,001,628496,Engler; Adam J.,9998,0,9999,1
1715610809163,BENG 196,002,660916,Watson; John Thomas,9999,0,9999,0
1715610810188,BISP 197,001,650773,Wilhelm; James E.,9994,0,9999,5
1715610810188,BISP 197,002,658904,Coleman; Aaron B.,9998,0,9999,1
1715610811214,CAT 124RS,A01,519847,Geibel; William,0,0,20,20
1715610812241,CAT 125RS,A01,515971,Geibel; William,0,0,20,20
1715610813267,CLRE 250,A00,511389,Morris; Sheldon,9992,0,9999,7
1715610814297,CLRE 251,A00,507176,Mehta; Ravindra L.,9992,0,9999,7
1715610814297,CLRE 251,B00,511410,Mehta; Ravindra L.,9998,0,9999,1
1715610815322,CLRE 252,A00,507189,Cuomo; Raphael Eduardo,9994,0,9999,5
1715610816348,CLRE 253,A00,507199,Vaida; Florin,9994,0,9999,5
1715610816348,CLRE 253,B00,507202,Vaida; Florin,9999,0,9999,0
1715610817374,CLRE 259,A00,507211,Patel; Hemal,9996,0,9999,3
1715610818401,CLRE 260,A00,507221,Cuomo; Raphael Eduardo,9999,0,9999,0
1715610819428,CLRE 297,001,507242,Cuomo; Raphael Eduardo,9999,0,9999,0
1715610820455,COGS 197,001,638244,Voytek; Bradley Thomas,9997,0,9999,2
1715610821480,CSE 191,A00,516875,Minnes Kemp; Mor Mia,9991,0,9999,8
1715610822506,CSE 197,001,637388,Minnes Kemp; Mor Mia,9992,0,9999,7
1715610823533,CSS 201S,A01,494383,Mignozzetti; Umberto,35,0,35,0
1715610824558,CSS 202S,A01,494387,Mignozzetti; Umberto,35,0,35,0
1715610825584,DSC 197,001,628532,Eldridge; Justin Matthew,9995,0,9999,4
1715610826612,EAP 100,A00,516065,Staff,9799,0,9999,200
1715610827636,ECE 45,A01,507414,Staff,31,0,60,29
1715610829688,ECE 111,A01,507420,Staff,11,0,50,39
1715610830716,ECE 197,001,548057,Sievenpiper; Daniel F.,9991,0,9999,8
1715610831741,EDS 115,A00,507243,Choi; Bailey Miyeon,7,0,28,21
1715610832766,EDS 117,A01,494379,Staff,0,6,34,34
1715610833791,EDS 125,A00,507246,Hopkins; Megan Beth,8,0,30,22
1715610834820,EDS 128A,A01,507264,Fargason; Sharon Gayle,6,0,26,20
1715610835848,EDS 128B,A01,507293,Pappas; Elizabeth,10,0,30,20
1715610836878,EDS 139,A00,507294,Fargason; Sharon Gayle,10,0,30,20
1715610836878,EDS 139,B00,507313,Pappas; Elizabeth,11,0,30,19
1715610837978,EDS 201,A00,507315,Staff,10,0,30,20
1715610839003,EDS 203,A01,507317,Halter; Christopher P.,10,0,30,20
1715610840034,EDS 204R,A01,507319,Halter; Christopher P.,0,3,30,30
1715610840034,EDS 204R,B01,507331,Heinzman; Erica M.,14,0,30,16
1715610841060,EDS 206R,A00,507332,Staff,0,4,30,30
1715610841060,EDS 206R,B00,507343,Staff,15,0,30,15
1715610842087,EDS 250,A00,507344,Hemans; Patricia Ann Benitez,20,0,40,20
1715610843111,EDS 281,A00,507345,Daly; Alan J.,18,0,18,0
1715610844139,EDS 284,A00,507350,Daly; Alan J.,16,0,16,0
1715610845167,EDS 286,A00,507359,Fine; Sarah,18,0,18,0
1715610846194,EDS 289C,A01,507361,Daly; Alan J.,18,0,18,0
1715610847220,EDS 290,A00,507366,Hofstetter; Carolyn,15,0,15,0
1715610848272,LIGM 5A,A00,507421,Fischer-Grunski; Eva K,17,0,20,3
1715610849299,LIGM 5B,A00,507423,Fischer-Grunski; Eva K,19,0,20,1
1715610850324,LIGM 5C,A00,507425,Fischer-Grunski; Eva K,19,0,20,1
1715610851354,LIIT 5AS,A00,507427,Carnelos; Chiara,20,0,20,0
1715610852379,LIIT 5BS,A00,507430,Carnelos; Chiara,20,0,20,0
1715610853406,LIIT 5CS,A00,507432,Carnelos; Chiara,20,0,20,0
1715610854433,LISP 5A,A00,507541,Munoz Sanchez; Alicia,11,0,20,9
1715610855462,LISP 5B,A00,507671,Munoz Sanchez; Alicia,9,0,20,11
1715610856494,LISP 5C,A00,507696,Munoz Sanchez; Alicia,9,0,20,11
1715610857520,MAE 197,001,528363,Boechler; Nicholas Sebastia,9998,0,9999,1
1715610858545,MATH 197,001,523477,Kedlaya; Kiran S.,9994,0,9999,5
1715610858545,MATH 197,002,563811,Zhang; Danna,9994,0,9999,5
1715610858545,MATH 197,003,628552,Dumitriu; Ioana,9998,0,9999,1
1715610858545,MATH 197,004,660885,Floyd; Eric,9999,0,9999,0
1715610859569,MCWP 40R,A00,518780,Staff,2,0,20,18
1715610859569,MCWP 40R,B00,518781,Staff,11,0,20,9
1715610859569,MCWP 40R,C00,518783,Staff,5,0,20,15
1715610860598,MCWP 50R,A00,518791,Staff,0,1,20,20
1715610860598,MCWP 50R,B00,518792,Staff,0,2,20,20
1715610860598,MCWP 50R,C00,518793,Staff,0,4,20,20
1715610860598,MCWP 50R,D00,518794,Staff,0,1,20,20
1715610860598,MCWP 50R,E00,518795,Staff,0,2,20,20
1715610860598,MCWP 50R,F00,518796,Staff,0,1,20,20
1715610860598,MCWP 50R,G00,518797,Staff,0,1,20,20
1715610861623,MMW 12R,A01,514034,Herbst; Matthew,0,2,16,16
1715610861623,MMW 12R,A02,514035,Herbst; Matthew,0,0,16,16
1715610862648,MMW 13R,A01,514037,Staff,0,5,16,16
1715610862648,MMW 13R,A02,514039,Staff,0,5,16,16
1715610862648,MMW 13R,A03,628519,Staff,0,4,16,16
1715610864701,SIO 295LS,A00,523233,Staff,10,0,30,20
1715610865725,SIO 295S,A00,523232,Staff,10,0,30,20
1715610866756,SIOC 290S,A01,637330,Merrifield; Mark A,23,0,30,7
1715610867782,SIOC 291S,A01,637333,Gabriel; Corey John,23,0,30,7
1715610868808,SOCI 117,A01,494376,Staff,0,5,5,5
1715610869835,WES 237B,A00,494380,Staff,10,0,20,10
1715610871909,AESE 279B,A00,494370,Wade; Jon P,0,0,33,33
1715610872936,AIP 97,001,660915,Van Den Einde; Yael Dahlia,9999,0,9999,0
1715610873964,AIP 197,001,627712,Vespa; Emanuel Ignacio,9995,0,9999,4
1715610873964,AIP 197,002,650778,Amir; On,9998,0,9999,1
1715610873964,AIP 197,003,650933,Avenancio-Leon; Carlos,9998,0,9999,1
1715610873964,AIP 197,004,658530,Heyman; Gail D.,9998,0,9999,1
1715610873964,AIP 197,005,658631,Neal; Sonya E,9998,0,9999,1
1715610873964,AIP 197,006,658671,Du; Songzi,9998,0,9999,1
1715610874992,ANAR 135S,A00,494369,Braswell; Geoffrey E.,0,0,0,0
1715610876019,BENG 196,001,628496,Engler; Adam J.,9998,0,9999,1
1715610876019,BENG 196,002,660916,Watson; John Thomas,9999,0,9999,0
1715610877047,BISP 197,001,650773,Wilhelm; James E.,9994,0,9999,5
1715610877047,BISP 197,002,658904,Coleman; Aaron B.,9998,0,9999,1
1715610878074,CAT 124RS,A01,519847,Geibel; William,0,0,20,20
1715610879099,CAT 125RS,A01,515971,Geibel; William,0,0,20,20
1715610880124,CLRE 250,A00,511389,Morris; Sheldon,9992,0,9999,7
1715610881154,CLRE 251,A00,507176,Mehta; Ravindra L.,9992,0,9999,7
1715610881154,CLRE 251,B00,511410,Mehta; Ravindra L.,9998,0,9999,1
1715610882180,CLRE 252,A00,507189,Cuomo; Raphael Eduardo,9994,0,9999,5
1715610883211,CLRE 253,A00,507199,Vaida; Florin,9994,0,9999,5
1715610883211,CLRE 253,B00,507202,Vaida; Florin,9999,0,9999,0
1715610884242,CLRE 259,A00,507211,Patel; Hemal,9996,0,9999,3
1715610885272,CLRE 260,A00,507221,Cuomo; Raphael Eduardo,9999,0,9999,0
1715610886297,CLRE 297,001,507242,Cuomo; Raphael Eduardo,9999,0,9999,0
1715610887324,COGS 197,001,638244,Voytek; Bradley Thomas,9997,0,9999,2
1715610888353,CSE 191,A00,516875,Minnes Kemp; Mor Mia,9991,0,9999,8
1715610889378,CSE 197,001,637388,Minnes Kemp; Mor Mia,9992,0,9999,7
1715610890407,CSS 201S,A01,494383,Mignozzetti; Umberto,35,0,35,0
1715610891433,CSS 202S,A01,494387,Mignozzetti; Umberto,35,0,35,0
1715610892459,DSC 197,001,628532,Eldridge; Justin Matthew,9995,0,9999,4
1715610893488,EAP 100,A00,516065,Staff,9799,0,9999,200
1715610894523,ECE 45,A01,507414,Staff,31,0,60,29
1715610896574,ECE 111,A01,507420,Staff,11,0,50,39
1715610897602,ECE 197,001,548057,Sievenpiper; Daniel F.,9991,0,9999,8
1715610898628,EDS 115,A00,507243,Choi; Bailey Miyeon,7,0,28,21
1715610899659,EDS 117,A01,494379,Staff,0,6,34,34
1715610900686,EDS 125,A00,507246,Hopkins; Megan Beth,8,0,30,22
1715610901712,EDS 128A,A01,507264,Fargason; Sharon Gayle,6,0,26,20
1715610902741,EDS 128B,A01,507293,Pappas; Elizabeth,10,0,30,20
1715610903768,EDS 139,A00,507294,Fargason; Sharon Gayle,10,0,30,20
1715610903768,EDS 139,B00,507313,Pappas; Elizabeth,11,0,30,19
1715610904795,EDS 201,A00,507315,Staff,10,0,30,20
1715610905822,EDS 203,A01,507317,Halter; Christopher P.,10,0,30,20
1715610906852,EDS 204R,A01,507319,Halter; Christopher P.,0,3,30,30
1715610906852,EDS 204R,B01,507331,Heinzman; Erica M.,14,0,30,16
1715610907877,EDS 206R,A00,507332,Staff,0,4,30,30
1715610907877,EDS 206R,B00,507343,Staff,15,0,30,15
1715610908905,EDS 250,A00,507344,Hemans; Patricia Ann Benitez,20,0,40,20
1715610909934,EDS 281,A00,507345,Daly; Alan J.,18,0,18,0
1715610910962,EDS 284,A00,507350,Daly; Alan J.,16,0,16,0
1715610911989,EDS 286,A00,507359,Fine; Sarah,18,0,18,0
1715610913018,EDS 289C,A01,507361,Daly; Alan J.,18,0,18,0
1715610914045,EDS 290,A00,507366,Hofstetter; Carolyn,15,0,15,0
1715610915078,LIGM 5A,A00,507421,Fischer-Grunski; Eva K,17,0,20,3
1715610916104,LIGM 5B,A00,507423,Fischer-Grunski; Eva K,19,0,20,1
1715610917133,LIGM 5C,A00,507425,Fischer-Grunski; Eva K,19,0,20,1
1715610918163,LIIT 5AS,A00,507427,Carnelos; Chiara,20,0,20,0
1715610919195,LIIT 5BS,A00,507430,Carnelos; Chiara,20,0,20,0
1715610920223,LIIT 5CS,A00,507432,Carnelos; Chiara,20,0,20,0
1715610921250,LISP 5A,A00,507541,Munoz Sanchez; Alicia,11,0,20,9
1715610922282,LISP 5B,A00,507671,Munoz Sanchez; Alicia,9,0,20,11
1715610923310,LISP 5C,A00,507696,Munoz Sanchez; Alicia,9,0,20,11
1715610924336,MAE 197,001,528363,Boechler; Nicholas Sebastia,9998,0,9999,1
1715610925370,MATH 197,001,523477,Kedlaya; Kiran S.,9994,0,9999,5
1715610925370,MATH 197,002,563811,Zhang; Danna,9994,0,9999,5
1715610925370,MATH 197,003,628552,Dumitriu; Ioana,9998,0,9999,1
1715610925370,MATH 197,004,660885,Floyd; Eric,9999,0,9999,0
1715610926397,MCWP 40R,A00,518780,Staff,2,0,20,18
1715610926397,MCWP 40R,B00,518781,Staff,11,0,20,9
1715610926397,MCWP 40R,C00,518783,Staff,5,0,20,15
1715610927427,MCWP 50R,A00,518791,Staff,0,1,20,20
1715610927427,MCWP 50R,B00,518792,Staff,0,2,20,20
1715610927427,MCWP 50R,C00,518793,Staff,0,4,20,20
1715610927427,MCWP 50R,D00,518794,Staff,0,1,20,20
1715610927427,MCWP 50R,E00,518795,Staff,0,2,20,20
1715610927427,MCWP 50R,F00,518796,Staff,0,1,20,20
1715610927427,MCWP 50R,G00,518797,Staff,0,1,20,20
1715610928456,MMW 12R,A01,514034,Herbst; Matthew,0,2,16,16
1715610928456,MMW 12R,A02,514035,Herbst; Matthew,0,0,16,16
1715610929483,MMW 13R,A01,514037,Staff,0,5,16,16
1715610929483,MMW 13R,A02,514039,Staff,0,5,16,16
1715610929483,MMW 13R,A03,628519,Staff,0,4,16,16
1715610931533,SIO 295LS,A00,523233,Staff,10,0,30,20
1715610932560,SIO 295S,A00,523232,Staff,10,0,30,20
1715610933588,SIOC 290S,A01,637330,Merrifield; Mark A,23,0,30,7
1715610934616,SIOC 291S,A01,637333,Gabriel; Corey John,23,0,30,7
1715610935643,SOCI 117,A01,494376,Staff,0,5,5,5
1715610936669,WES 237B,A00,494380,Staff,10,0,20,10
1715610938752,AESE 279B,A00,494370,Wade; Jon P,0,0,33,33
1715610939777,AIP 97,001,660915,Van Den Einde; Yael Dahlia,9999,0,9999,0
1715610940806,AIP 197,001,627712,Vespa; Emanuel Ignacio,9995,0,9999,4
1715610940806,AIP 197,002,650778,Amir; On,9998,0,9999,1
1715610940806,AIP 197,003,650933,Avenancio-Leon; Carlos,9998,0,9999,1
1715610940806,AIP 197,004,658530,Heyman; Gail D.,9998,0,9999,1
1715610940806,AIP 197,005,658631,Neal; Sonya E,9998,0,9999,1
1715610940806,AIP 197,006,658671,Du; Songzi,9998,0,9999,1
1715610941831,ANAR 135S,A00,494369,Braswell; Geoffrey E.,0,0,0,0
1715610942856,BENG 196,001,628496,Engler; Adam J.,9998,0,9999,1
1715610942856,BENG 196,002,660916,Watson; John Thomas,9999,0,9999,0
1715610943882,BISP 197,001,650773,Wilhelm; James E.,9994,0,9999,5
1715610943882,BISP 197,002,658904,Coleman; Aaron B.,9998,0,9999,1
1715610944909,CAT 124RS,A01,519847,Geibel; William,0,0,20,20
1715610945937,CAT 125RS,A01,515971,Geibel; William,0,0,20,20
1715610946967,CLRE 250,A00,511389,Morris; Sheldon,9992,0,9999,7
1715610947997,CLRE 251,A00,507176,Mehta; Ravindra L.,9992,0,9999,7
1715610947997,CLRE 251,B00,511410,Mehta; Ravindra L.,9998,0,9999,1
1715610949029,CLRE 252,A00,507189,Cuomo; Raphael Eduardo,9994,0,9999,5
1715610950053,CLRE 253,A00,507199,Vaida; Florin,9994,0,9999,5
1715610950053,CLRE 253,B00,507202,Vaida; Florin,9999,0,9999,0
1715610951077,CLRE 259,A00,507211,Patel; Hemal,9996,0,9999,3
1715610952104,CLRE 260,A00,507221,Cuomo; Raphael Eduardo,9999,0,9999,0
1715610953131,CLRE 297,001,507242,Cuomo; Raphael Eduardo,9999,0,9999,0
1715610954157,COGS 197,001,638244,Voytek; Bradley Thomas,9997,0,9999,2
1715610955184,CSE 191,A00,516875,Minnes Kemp; Mor Mia,9991,0,9999,8
1715610956212,CSE 197,001,637388,Minnes Kemp; Mor Mia,9992,0,9999,7
1715610957241,CSS 201S,A01,494383,Mignozzetti; Umberto,35,0,35,0
1715610958269,CSS 202S,A01,494387,Mignozzetti; Umberto,35,0,35,0
1715610959296,DSC 197,001,628532,Eldridge; Justin Matthew,9995,0,9999,4
1715610960321,EAP 100,A00,516065,Staff,9799,0,9999,200
1715610961352,ECE 45,A01,507414,Staff,31,0,60,29
1715610963407,ECE 111,A01,507420,Staff,11,0,50,39
1715610964431,ECE 197,001,548057,Sievenpiper; Daniel F.,9991,0,9999,8
1715610965462,EDS 115,A00,507243,Choi; Bailey Miyeon,7,0,28,21
1715610966491,EDS 117,A01,494379,Staff,0,6,34,34
1715610967517,EDS 125,A00,507246,Hopkins; Megan Beth,8,0,30,22
1715610968542,EDS 128A,A01,507264,Fargason; Sharon Gayle,6,0,26,20
1715610969569,EDS 128B,A01,507293,Pappas; Elizabeth,10,0,30,20
1715610970593,EDS 139,A00,507294,Fargason; Sharon Gayle,10,0,30,20
1715610970593,EDS 139,B00,507313,Pappas; Elizabeth,11,0,30,19
1715610971619,EDS 201,A00,507315,Staff,10,0,30,20
1715610972649,EDS 203,A01,507317,Halter; Christopher P.,10,0,30,20
1715610973696,EDS 204R,A01,507319,Halter; Christopher P.,0,3,30,30
1715610973696,EDS 204R,B01,507331,Heinzman; Erica M.,14,0,30,16
1715610974722,EDS 206R,A00,507332,Staff,0,4,30,30
1715610974722,EDS 206R,B00,507343,Staff,15,0,30,15
1715610975750,EDS 250,A00,507344,Hemans; Patricia Ann Benitez,20,0,40,20
1715610976774,EDS 281,A00,507345,Daly; Alan J.,18,0,18,0
1715610977804,EDS 284,A00,507350,Daly; Alan J.,16,0,16,0
1715610978831,EDS 286,A00,507359,Fine; Sarah,18,0,18,0
1715610979854,EDS 289C,A01,507361,Daly; Alan J.,18,0,18,0
1715610980880,EDS 290,A00,507366,Hofstetter; Carolyn,15,0,15,0
1715610981910,LIGM 5A,A00,507421,Fischer-Grunski; Eva K,17,0,20,3
1715610982938,LIGM 5B,A00,507423,Fischer-Grunski; Eva K,19,0,20,1
1715610983962,LIGM 5C,A00,507425,Fischer-Grunski; Eva K,19,0,20,1
1715610984990,LIIT 5AS,A00,507427,Carnelos; Chiara,20,0,20,0
1715610986018,LIIT 5BS,A00,507430,Carnelos; Chiara,20,0,20,0
1715610987043,LIIT 5CS,A00,507432,Carnelos; Chiara,20,0,20,0
1715610988070,LISP 5A,A00,507541,Munoz Sanchez; Alicia,11,0,20,9
1715610989099,LISP 5B,A00,507671,Munoz Sanchez; Alicia,9,0,20,11
1715610990125,LISP 5C,A00,507696,Munoz Sanchez; Alicia,9,0,20,11
1715610991149,MAE 197,001,528363,Boechler; Nicholas Sebastia,9998,0,9999,1
1715610992178,MATH 197,001,523477,Kedlaya; Kiran S.,9994,0,9999,5
1715610992178,MATH 197,002,563811,Zhang; Danna,9994,0,9999,5
1715610992178,MATH 197,003,628552,Dumitriu; Ioana,9998,0,9999,1
1715610992178,MATH 197,004,660885,Floyd; Eric,9999,0,9999,0
1715610993207,MCWP 40R,A00,518780,Staff,2,0,20,18
1715610993207,MCWP 40R,B00,518781,Staff,11,0,20,9
1715610993207,MCWP 40R,C00,518783,Staff,5,0,20,15
1715610994238,MCWP 50R,A00,518791,Staff,0,1,20,20
1715610994238,MCWP 50R,B00,518792,Staff,0,2,20,20
1715610994238,MCWP 50R,C00,518793,Staff,0,4,20,20
1715610994238,MCWP 50R,D00,518794,Staff,0,1,20,20
1715610994238,MCWP 50R,E00,518795,Staff,0,2,20,20
1715610994238,MCWP 50R,F00,518796,Staff,0,1,20,20
1715610994238,MCWP 50R,G00,518797,Staff,0,1,20,20
1715610995263,MMW 12R,A01,514034,Herbst; Matthew,0,2,16,16
1715610995263,MMW 12R,A02,514035,Herbst; Matthew,0,0,16,16
1715610996292,MMW 13R,A01,514037,Staff,0,5,16,16
1715610996292,MMW 13R,A02,514039,Staff,0,5,16,16
1715610996292,MMW 13R,A03,628519,Staff,0,4,16,16
1715610998340,SIO 295LS,A00,523233,Staff,10,0,30,20
1715610999366,SIO 295S,A00,523232,Staff,10,0,30,20
1715611000397,SIOC 290S,A01,637330,Merrifield; Mark A,23,0,30,7
1715611001423,SIOC 291S,A01,637333,Gabriel; Corey John,23,0,30,7
1715611002450,SOCI 117,A01,494376,Staff,0,5,5,5
1715611003477,WES 237B,A00,494380,Staff,10,0,20,10
1715611005549,AESE 279B,A00,494370,Wade; Jon P,0,0,33,33
1715611006579,AIP 97,001,660915,Van Den Einde; Yael Dahlia,9999,0,9999,0
1715611007612,AIP 197,001,627712,Vespa; Emanuel Ignacio,9995,0,9999,4
1715611007612,AIP 197,002,650778,Amir; On,9998,0,9999,1
1715611007612,AIP 197,003,650933,Avenancio-Leon; Carlos,9998,0,9999,1
1715611007612,AIP 197,004,658530,Heyman; Gail D.,9998,0,9999,1
1715611007612,AIP 197,005,658631,Neal; Sonya E,9998,0,9999,1
1715611007612,AIP 197,006,658671,Du; Songzi,9998,0,9999,1
1715611008638,ANAR 135S,A00,494369,Braswell; Geoffrey E.,0,0,0,0
1715611009668,BENG 196,001,628496,Engler; Adam J.,9998,0,9999,1
1715611009668,BENG 196,002,660916,Watson; John Thomas,9999,0,9999,0
1715611010696,BISP 197,001,650773,Wilhelm; James E.,9994,0,9999,5
1715611010696,BISP 197,002,658904,Coleman; Aaron B.,9998,0,9999,1
1715611011730,CAT 124RS,A01,519847,Geibel; William,0,0,20,20
1715611012754,CAT 125RS,A01,515971,Geibel; William,0,0,20,20
1715611013780,CLRE 250,A00,511389,Morris; Sheldon,9992,0,9999,7
1715611014809,CLRE 251,A00,507176,Mehta; Ravindra L.,9992,0,9999,7
1715611014809,CLRE 251,B00,511410,Mehta; Ravindra L.,9998,0,9999,1
1715611015835,CLRE 252,A00,507189,Cuomo; Raphael Eduardo,9994,0,9999,5
1715611016864,CLRE 253,A00,507199,Vaida; Florin,9994,0,9999,5
1715611016864,CLRE 253,B00,507202,Vaida; Florin,9999,0,9999,0
1715611017889,CLRE 259,A00,507211,Patel; Hemal,9996,0,9999,3
1715611018916,CLRE 260,A00,507221,Cuomo; Raphael Eduardo,9999,0,9999,0
1715611019941,CLRE 297,001,507242,Cuomo; Raphael Eduardo,9999,0,9999,0
1715611020970,COGS 197,001,638244,Voytek; Bradley Thomas,9997,0,9999,2
1715611021997,CSE 191,A00,516875,Minnes Kemp; Mor Mia,9991,0,9999,8
1715611023024,CSE 197,001,637388,Minnes Kemp; Mor Mia,9992,0,9999,7
1715611024058,CSS 201S,A01,494383,Mignozzetti; Umberto,35,0,35,0
1715611025086,CSS 202S,A01,494387,Mignozzetti; Umberto,35,0,35,0
1715611026113,DSC 197,001,628532,Eldridge; Justin Matthew,9995,0,9999,4
1715611027138,EAP 100,A00,516065,Staff,9799,0,9999,200
1715611028167,ECE 45,A01,507414,Staff,31,0,60,29
1715611030218,ECE 111,A01,507420,Staff,11,0,50,39
1715611031245,ECE 197,001,548057,Sievenpiper; Daniel F.,9991,0,9999,8
1715611032274,EDS 115,A00,507243,Choi; Bailey Miyeon,7,0,28,21
1715611033303,EDS 117,A01,494379,Staff,0,6,34,34
1715611034330,EDS 125,A00,507246,Hopkins; Megan Beth,8,0,30,22
1715611035355,EDS 128A,A01,507264,Fargason; Sharon Gayle,6,0,26,20
1715611036384,EDS 128B,A01,507293,Pappas; Elizabeth,10,0,30,20
1715611037409,EDS 139,A00,507294,Fargason; Sharon Gayle,10,0,30,20
1715611037409,EDS 139,B00,507313,Pappas; Elizabeth,11,0,30,19
1715611038435,EDS 201,A00,507315,Staff,10,0,30,20
1715611039461,EDS 203,A01,507317,Halter; Christopher P.,10,0,30,20
1715611040490,EDS 204R,A01,507319,Halter; Christopher P.,0,3,30,30
1715611040490,EDS 204R,B01,507331,Heinzman; Erica M.,14,0,30,16
1715611041518,EDS 206R,A00,507332,Staff,0,4,30,30
1715611041518,EDS 206R,B00,507343,Staff,15,0,30,15
1715611042547,EDS 250,A00,507344,Hemans; Patricia Ann Benitez,20,0,40,20
1715611043574,EDS 281,A00,507345,Daly; Alan J.,18,0,18,0
1715611044603,EDS 284,A00,507350,Daly; Alan J.,16,0,16,0
1715611045627,EDS 286,A00,507359,Fine; Sarah,18,0,18,0
1715611046654,EDS 289C,A01,507361,Daly; Alan J.,18,0,18,0
1715611047680,EDS 290,A00,507366,Hofstetter; Carolyn,15,0,15,0
1715611048706,LIGM 5A,A00,507421,Fischer-Grunski; Eva K,17,0,20,3
1715611049732,LIGM 5B,A00,507423,Fischer-Grunski; Eva K,19,0,20,1
1715611050761,LIGM 5C,A00,507425,Fischer-Grunski; Eva K,19,0,20,1
1715611051787,LIIT 5AS,A00,507427,Carnelos; Chiara,20,0,20,0
1715611052812,LIIT 5BS,A00,507430,Carnelos; Chiara,20,0,20,0
1715611053837,LIIT 5CS,A00,507432,Carnelos; Chiara,20,0,20,0
1715611054867,LISP 5A,A00,507541,Munoz Sanchez; Alicia,11,0,20,9
1715611055896,LISP 5B,A00,507671,Munoz Sanchez; Alicia,9,0,20,11
1715611056925,LISP 5C,A00,507696,Munoz Sanchez; Alicia,9,0,20,11
1715611057952,MAE 197,001,528363,Boechler; Nicholas Sebastia,9998,0,9999,1
1715611058985,MATH 197,001,523477,Kedlaya; Kiran S.,9994,0,9999,5
1715611058985,MATH 197,002,563811,Zhang; Danna,9994,0,9999,5
1715611058985,MATH 197,003,628552,Dumitriu; Ioana,9998,0,9999,1
1715611058985,MATH 197,004,660885,Floyd; Eric,9999,0,9999,0
1715611060013,MCWP 40R,A00,518780,Staff,2,0,20,18
1715611060013,MCWP 40R,B00,518781,Staff,11,0,20,9
1715611060013,MCWP 40R,C00,518783,Staff,5,0,20,15
1715611061040,MCWP 50R,A00,518791,Staff,0,1,20,20
1715611061040,MCWP 50R,B00,518792,Staff,0,2,20,20
1715611061040,MCWP 50R,C00,518793,Staff,0,4,20,20
1715611061040,MCWP 50R,D00,518794,Staff,0,1,20,20
1715611061040,MCWP 50R,E00,518795,Staff,0,2,20,20
1715611061040,MCWP 50R,F00,518796,Staff,0,1,20,20
1715611061040,MCWP 50R,G00,518797,Staff,0,1,20,20
1715611062067,MMW 12R,A01,514034,Herbst; Matthew,0,2,16,16
1715611062067,MMW 12R,A02,514035,Herbst; Matthew,0,0,16,16
1715611063095,MMW 13R,A01,514037,Staff,0,5,16,16
1715611063095,MMW 13R,A02,514039,Staff,0,5,16,16
1715611063095,MMW 13R,A03,628519,Staff,0,4,16,16
1715611065151,SIO 295LS,A00,523233,Staff,10,0,30,20
1715611066233,SIO 295S,A00,523232,Staff,10,0,30,20
1715611067263,SIOC 290S,A01,637330,Merrifield; Mark A,23,0,30,7
1715611068295,SIOC 291S,A01,637333,Gabriel; Corey John,23,0,30,7
1715611069324,SOCI 117,A01,494376,Staff,0,5,5,5
1715611070352,WES 237B,A00,494380,Staff,10,0,20,10
1715611072425,AESE 279B,A00,494370,Wade; Jon P,0,0,33,33
1715611073455,AIP 97,001,660915,Van Den Einde; Yael Dahlia,9999,0,9999,0
1715611074485,AIP 197,001,627712,Vespa; Emanuel Ignacio,9995,0,9999,4
1715611074485,AIP 197,002,650778,Amir; On,9998,0,9999,1
1715611074485,AIP 197,003,650933,Avenancio-Leon; Carlos,9998,0,9999,1
1715611074485,AIP 197,004,658530,Heyman; Gail D.,9998,0,9999,1
1715611074485,AIP 197,005,658631,Neal; Sonya E,9998,0,9999,1
1715611074485,AIP 197,006,658671,Du; Songzi,9998,0,9999,1
1715611075511,ANAR 135S,A00,494369,Braswell; Geoffrey E.,0,0,0,0
1715611076540,BENG 196,001,628496,Engler; Adam J.,9998,0,9999,1
1715611076540,BENG 196,002,660916,Watson; John Thomas,9999,0,9999,0
1715611077567,BISP 197,001,650773,Wilhelm; James E.,9994,0,9999,5
1715611077567,BISP 197,002,658904,Coleman; Aaron B.,9998,0,9999,1
1715611078594,CAT 124RS,A01,519847,Geibel; William,0,0,20,20
1715611079621,CAT 125RS,A01,515971,Geibel; William,0,0,20,20
1715611080646,CLRE 250,A00,511389,Morris; Sheldon,9992,0,9999,7
1715611081681,CLRE 251,A00,507176,Mehta; Ravindra L.,9992,0,9999,7
1715611081681,CLRE 251,B00,511410,Mehta; Ravindra L.,9998,0,9999,1
1715611082711,CLRE 252,A00,507189,Cuomo; Raphael Eduardo,9994,0,9999,5
1715611083737,CLRE 253,A00,507199,Vaida; Florin,9994,0,9999,5
1715611083737,CLRE 253,B00,507202,Vaida; Florin,9999,0,9999,0
1715611084763,CLRE 259,A00,507211,Patel; Hemal,9996,0,9999,3
1715611085791,CLRE 260,A00,507221,Cuomo; Raphael Eduardo,9999,0,9999,0
1715611086817,CLRE 297,001,507242,Cuomo; Raphael Eduardo,9999,0,9999,0
1715611087845,COGS 197,001,638244,Voytek; Bradley Thomas,9997,0,9999,2
1715611088874,CSE 191,A00,516875,Minnes Kemp; Mor Mia,9991,0,9999,8
1715611089900,CSE 197,001,637388,Minnes Kemp; Mor Mia,9992,0,9999,7
1715611090931,CSS 201S,A01,494383,Mignozzetti; Umberto,35,0,35,0
1715611091958,CSS 202S,A01,494387,Mignozzetti; Umberto,35,0,35,0
1715611092983,DSC 197,001,628532,Eldridge; Justin Matthew,9995,0,9999,4
1715611094007,EAP 100,A00,516065,Staff,9799,0,9999,200
1715611095033,ECE 45,A01,507414,Staff,31,0,60,29
1715611097083,ECE 111,A01,507420,Staff,11,0,50,39
1715611098111,ECE 197,001,548057,Sievenpiper; Daniel F.,9991,0,9999,8
1715611099141,EDS 115,A00,507243,Choi; Bailey Miyeon,7,0,28,21
1715611100168,EDS 117,A01,494379,Staff,0,6,34,34
1715611101198,EDS 125,A00,507246,Hopkins; Megan Beth,8,0,30,22
1715611102226,EDS 128A,A01,507264,Fargason; Sharon Gayle,6,0,26,20
1715611103252,EDS 128B,A01,507293,Pappas; Elizabeth,10,0,30,20
1715611104280,EDS 139,A00,507294,Fargason; Sharon Gayle,10,0,30,20
1715611104280,EDS 139,B00,507313,Pappas; Elizabeth,11,0,30,19
1715611105307,EDS 201,A00,507315,Staff,10,0,30,20
1715611106333,EDS 203,A01,507317,Halter; Christopher P.,10,0,30,20
1715611107364,EDS 204R,A01,507319,Halter; Christopher P.,0,3,30,30
1715611107364,EDS 204R,B01,507331,Heinzman; Erica M.,14,0,30,16
1715611108391,EDS 206R,A00,507332,Staff,0,4,30,30
1715611108391,EDS 206R,B00,507343,Staff,15,0,30,15
1715611109418,EDS 250,A00,507344,Hemans; Patricia Ann Benitez,20,0,40,20
1715611110449,EDS 281,A00,507345,Daly; Alan J.,18,0,18,0
1715611111473,EDS 284,A00,507350,Daly; Alan J.,16,0,16,0
1715611112497,EDS 286,A00,507359,Fine; Sarah,18,0,18,0
1715611113524,EDS 289C,A01,507361,Daly; Alan J.,18,0,18,0
1715611114550,EDS 290,A00,507366,Hofstetter; Carolyn,15,0,15,0
1715611115578,LIGM 5A,A00,507421,Fischer-Grunski; Eva K,17,0,20,3
1715611116605,LIGM 5B,A00,507423,Fischer-Grunski; Eva K,19,0,20,1
1715611117631,LIGM 5C,A00,507425,Fischer-Grunski; Eva K,19,0,20,1
1715611118657,LIIT 5AS,A00,507427,Carnelos; Chiara,20,0,20,0
1715611119682,LIIT 5BS,A00,507430,Carnelos; Chiara,20,0,20,0
1715611120710,LIIT 5CS,A00,507432,Carnelos; Chiara,20,0,20,0
1715611121737,LISP 5A,A00,507541,Munoz Sanchez; Alicia,11,0,20,9
1715611122766,LISP 5B,A00,507671,Munoz Sanchez; Alicia,9,0,20,11
1715611123794,LISP 5C,A00,507696,Munoz Sanchez; Alicia,9,0,20,11
1715611124821,MAE 197,001,528363,Boechler; Nicholas Sebastia,9998,0,9999,1
1715611125849,MATH 197,001,523477,Kedlaya; Kiran S.,9994,0,9999,5
1715611125849,MATH 197,002,563811,Zhang; Danna,9994,0,9999,5
1715611125849,MATH 197,003,628552,Dumitriu; Ioana,9998,0,9999,1
1715611125849,MATH 197,004,660885,Floyd; Eric,9999,0,9999,0
1715611126875,MCWP 40R,A00,518780,Staff,2,0,20,18
1715611126875,MCWP 40R,B00,518781,Staff,11,0,20,9
1715611126875,MCWP 40R,C00,518783,Staff,5,0,20,15
1715611127902,MCWP 50R,A00,518791,Staff,0,1,20,20
1715611127902,MCWP 50R,B00,518792,Staff,0,2,20,20
1715611127902,MCWP 50R,C00,518793,Staff,0,4,20,20
1715611127902,MCWP 50R,D00,518794,Staff,0,1,20,20
1715611127902,MCWP 50R,E00,518795,Staff,0,2,20,20
1715611127902,MCWP 50R,F00,518796,Staff,0,1,20,20
1715611127902,MCWP 50R,G00,518797,Staff,0,1,20,20
1715611128933,MMW 12R,A01,514034,Herbst; Matthew,0,2,16,16
1715611128933,MMW 12R,A02,514035,Herbst; Matthew,0,0,16,16
1715611129960,MMW 13R,A01,514037,Staff,0,5,16,16
1715611129960,MMW 13R,A02,514039,Staff,0,5,16,16
1715611129960,MMW 13R,A03,628519,Staff,0,4,16,16
1715611132015,SIO 295LS,A00,523233,Staff,10,0,30,20
1715611133041,SIO 295S,A00,523232,Staff,10,0,30,20
1715611134073,SIOC 290S,A01,637330,Merrifield; Mark A,23,0,30,7
1715611135107,SIOC 291S,A01,637333,Gabriel; Corey John,23,0,30,7
1715611136135,SOCI 117,A01,494376,Staff,0,5,5,5
1715611137163,WES 237B,A00,494380,Staff,10,0,20,10
1715611139249,AESE 279B,A00,494370,Wade; Jon P,0,0,33,33
1715611140279,AIP 97,001,660915,Van Den Einde; Yael Dahlia,9999,0,9999,0
1715611141309,AIP 197,001,627712,Vespa; Emanuel Ignacio,9995,0,9999,4
1715611141309,AIP 197,002,650778,Amir; On,9998,0,9999,1
1715611141309,AIP 197,003,650933,Avenancio-Leon; Carlos,9998,0,9999,1
1715611141309,AIP 197,004,658530,Heyman; Gail D.,9998,0,9999,1
1715611141309,AIP 197,005,658631,Neal; Sonya E,9998,0,9999,1
1715611141309,AIP 197,006,658671,Du; Songzi,9998,0,9999,1
1715611142335,ANAR 135S,A00,494369,Braswell; Geoffrey E.,0,0,0,0
1715611143366,BENG 196,001,628496,Engler; Adam J.,9998,0,9999,1
1715611143366,BENG 196,002,660916,Watson; John Thomas,9999,0,9999,0
1715611144401,BISP 197,001,650773,Wilhelm; James E.,9994,0,9999,5
1715611144401,BISP 197,002,658904,Coleman; Aaron B.,9998,0,9999,1
1715611145430,CAT 124RS,A01,519847,Geibel; William,0,0,20,20
1715611146460,CAT 125RS,A01,515971,Geibel; William,0,0,20,20
1715611147491,CLRE 250,A00,511389,Morris; Sheldon,9992,0,9999,7
1715611148519,CLRE 251,A00,507176,Mehta; Ravindra L.,9992,0,9999,7
1715611148519,CLRE 251,B00,511410,Mehta; Ravindra L.,9998,0,9999,1
1715611149546,CLRE 252,A00,507189,Cuomo; Raphael Eduardo,9994,0,9999,5
1715611150575,CLRE 253,A00,507199,Vaida; Florin,9994,0,9999,5
1715611150575,CLRE 253,B00,507202,Vaida; Florin,9999,0,9999,0
1715611151601,CLRE 259,A00,507211,Patel; Hemal,9996,0,9999,3
1715611152627,CLRE 260,A00,507221,Cuomo; Raphael Eduardo,9999,0,9999,0
1715611153657,CLRE 297,001,507242,Cuomo; Raphael Eduardo,9999,0,9999,0
1715611154686,COGS 197,001,638244,Voytek; Bradley Thomas,9997,0,9999,2
1715611155712,CSE 191,A00,516875,Minnes Kemp; Mor Mia,9991,0,9999,8
1715611156738,CSE 197,001,637388,Minnes Kemp; Mor Mia,9992,0,9999,7
1715611157770,CSS 201S,A01,494383,Mignozzetti; Umberto,35,0,35,0
1715611158798,CSS 202S,A01,494387,Mignozzetti; Umberto,35,0,35,0
1715611159822,DSC 197,001,628532,Eldridge; Justin Matthew,9995,0,9999,4
1715611160847,EAP 100,A00,516065,Staff,9799,0,9999,200
1715611161874,ECE 45,A01,507414,Staff,31,0,60,29
1715611163930,ECE 111,A01,507420,Staff,11,0,50,39
1715611164960,ECE 197,001,548057,Sievenpiper; Daniel F.,9991,0,9999,8
1715611165986,EDS 115,A00,507243,Choi; Bailey Miyeon,7,0,28,21
1715611167014,EDS 117,A01,494379,Staff,0,6,34,34
1715611168044,EDS 125,A00,507246,Hopkins; Megan Beth,8,0,30,22
1715611169075,EDS 128A,A01,507264,Fargason; Sharon Gayle,6,0,26,20
1715611170156,EDS 128B,A01,507293,Pappas; Elizabeth,10,0,30,20
1715611171181,EDS 139,A00,507294,Fargason; Sharon Gayle,10,0,30,20
1715611171181,EDS 139,B00,507313,Pappas; Elizabeth,11,0,30,19
1715611172206,EDS 201,A00,507315,Staff,10,0,30,20
1715611173235,EDS 203,A01,507317,Halter; Christopher P.,10,0,30,20
1715611174259,EDS 204R,A01,507319,Halter; Christopher P.,0,3,30,30
1715611174259,EDS 204R,B01,507331,Heinzman; Erica M.,14,0,30,16
1715611175288,EDS 206R,A00,507332,Staff,0,4,30,30
1715611175288,EDS 206R,B00,507343,Staff,15,0,30,15
1715611176314,EDS 250,A00,507344,Hemans; Patricia Ann Benitez,20,0,40,20
1715611177341,EDS 281,A00,507345,Daly; Alan J.,18,0,18,0
1715611178367,EDS 284,A00,507350,Daly; Alan J.,16,0,16,0
1715611179393,EDS 286,A00,507359,Fine; Sarah,18,0,18,0
1715611180419,EDS 289C,A01,507361,Daly; Alan J.,18,0,18,0
1715611181448,EDS 290,A00,507366,Hofstetter; Carolyn,15,0,15,0
1715611182475,LIGM 5A,A00,507421,Fischer-Grunski; Eva K,17,0,20,3
1715611183501,LIGM 5B,A00,507423,Fischer-Grunski; Eva K,19,0,20,1
1715611184531,LIGM 5C,A00,507425,Fischer-Grunski; Eva K,19,0,20,1
1715611185556,LIIT 5AS,A00,507427,Carnelos; Chiara,20,0,20,0
1715611186583,LIIT 5BS,A00,507430,Carnelos; Chiara,20,0,20,0
1715611187607,LIIT 5CS,A00,507432,Carnelos; Chiara,20,0,20,0
1715611188634,LISP 5A,A00,507541,Munoz Sanchez; Alicia,11,0,20,9
1715611189662,LISP 5B,A00,507671,Munoz Sanchez; Alicia,9,0,20,11
1715611190693,LISP 5C,A00,507696,Munoz Sanchez; Alicia,9,0,20,11
1715611191719,MAE 197,001,528363,Boechler; Nicholas Sebastia,9998,0,9999,1
1715611192754,MATH 197,001,523477,Kedlaya; Kiran S.,9994,0,9999,5
1715611192754,MATH 197,002,563811,Zhang; Danna,9994,0,9999,5
1715611192754,MATH 197,003,628552,Dumitriu; Ioana,9998,0,9999,1
1715611192754,MATH 197,004,660885,Floyd; Eric,9999,0,9999,0
1715611193781,MCWP 40R,A00,518780,Staff,2,0,20,18
1715611193781,MCWP 40R,B00,518781,Staff,11,0,20,9
1715611193781,MCWP 40R,C00,518783,Staff,5,0,20,15
1715611194809,MCWP 50R,A00,518791,Staff,0,1,20,20
1715611194809,MCWP 50R,B00,518792,Staff,0,2,20,20
1715611194809,MCWP 50R,C00,518793,Staff,0,4,20,20
1715611194809,MCWP 50R,D00,518794,Staff,0,1,20,20
1715611194809,MCWP 50R,E00,518795,Staff,0,2,20,20
1715611194809,MCWP 50R,F00,518796,Staff,0,1,20,20
1715611194809,MCWP 50R,G00,518797,Staff,0,1,20,20
1715611195835,MMW 12R,A01,514034,Herbst; Matthew,0,2,16,16
1715611195835,MMW 12R,A02,514035,Herbst; Matthew,0,0,16,16
1715611196861,MMW 13R,A01,514037,Staff,0,5,16,16
1715611196861,MMW 13R,A02,514039,Staff,0,5,16,16
1715611196861,MMW 13R,A03,628519,Staff,0,4,16,16
1715611198915,SIO 295LS,A00,523233,Staff,10,0,30,20
1715611199943,SIO 295S,A00,523232,Staff,10,0,30,20
1715611200969,SIOC 290S,A01,637330,Merrifield; Mark A,23,0,30,7
1715611202001,SIOC 291S,A01,637333,Gabriel; Corey John,23,0,30,7
1715611203032,SOCI 117,A01,494376,Staff,0,5,5,5
1715611204058,WES 237B,A00,494380,Staff,10,0,20,10
1715611206142,AESE 279B,A00,494370,Wade; Jon P,0,0,33,33
1715611207169,AIP 97,001,660915,Van Den Einde; Yael Dahlia,9999,0,9999,0
1715611208198,AIP 197,001,627712,Vespa; Emanuel Ignacio,9995,0,9999,4
1715611208198,AIP 197,002,650778,Amir; On,9998,0,9999,1
1715611208198,AIP 197,003,650933,Avenancio-Leon; Carlos,9998,0,9999,1
1715611208198,AIP 197,004,658530,Heyman; Gail D.,9998,0,9999,1
1715611208198,AIP 197,005,658631,Neal; Sonya E,9998,0,9999,1
1715611208198,AIP 197,006,658671,Du; Songzi,9998,0,9999,1
1715611209225,ANAR 135S,A00,494369,Braswell; Geoffrey E.,0,0,0,0
1715611210254,BENG 196,001,628496,Engler; Adam J.,9998,0,9999,1
1715611210254,BENG 196,002,660916,Watson; John Thomas,9999,0,9999,0
1715611211281,BISP 197,001,650773,Wilhelm; James E.,9994,0,9999,5
1715611211281,BISP 197,002,658904,Coleman; Aaron B.,9998,0,9999,1
1715611212307,CAT 124RS,A01,519847,Geibel; William,0,0,20,20
1715611213335,CAT 125RS,A01,515971,Geibel; William,0,0,20,20
1715611214363,CLRE 250,A00,511389,Morris; Sheldon,9992,0,9999,7
1715611215394,CLRE 251,A00,507176,Mehta; Ravindra L.,9992,0,9999,7
1715611215394,CLRE 251,B00,511410,Mehta; Ravindra L.,9998,0,9999,1
1715611216419,CLRE 252,A00,507189,Cuomo; Raphael Eduardo,9994,0,9999,5
1715611217448,CLRE 253,A00,507199,Vaida; Florin,9994,0,9999,5
1715611217448,CLRE 253,B00,507202,Vaida; Florin,9999,0,9999,0
1715611220258,CLRE 259,A00,507211,Patel; Hemal,9996,0,9999,3
1715611221285,CLRE 260,A00,507221,Cuomo; Raphael Eduardo,9999,0,9999,0
1715611222313,CLRE 297,001,507242,Cuomo; Raphael Eduardo,9999,0,9999,0
1715611223341,COGS 197,001,638244,Voytek; Bradley Thomas,9997,0,9999,2
1715611224365,CSE 191,A00,516875,Minnes Kemp; Mor Mia,9991,0,9999,8
1715611225393,CSE 197,001,637388,Minnes Kemp; Mor Mia,9992,0,9999,7
1715611226422,CSS 201S,A01,494383,Mignozzetti; Umberto,35,0,35,0
1715611227449,CSS 202S,A01,494387,Mignozzetti; Umberto,35,0,35,0
1715611228479,DSC 197,001,628532,Eldridge; Justin Matthew,9995,0,9999,4
1715611229507,EAP 100,A00,516065,Staff,9799,0,9999,200
1715611230538,ECE 45,A01,507414,Staff,31,0,60,29
1715611232589,ECE 111,A01,507420,Staff,11,0,50,39
1715611233613,ECE 197,001,548057,Sievenpiper; Daniel F.,9991,0,9999,8
1715611234640,EDS 115,A00,507243,Choi; Bailey Miyeon,7,0,28,21
1715611235668,EDS 117,A01,494379,Staff,0,6,34,34
1715611236694,EDS 125,A00,507246,Hopkins; Megan Beth,8,0,30,22
1715611237719,EDS 128A,A01,507264,Fargason; Sharon Gayle,6,0,26,20
1715611238748,EDS 128B,A01,507293,Pappas; Elizabeth,10,0,30,20
1715611239775,EDS 139,A00,507294,Fargason; Sharon Gayle,10,0,30,20
1715611239775,EDS 139,B00,507313,Pappas; Elizabeth,11,0,30,19
1715611240800,EDS 201,A00,507315,Staff,10,0,30,20
1715611241828,EDS 203,A01,507317,Halter; Christopher P.,10,0,30,20
1715611242856,EDS 204R,A01,507319,Halter; Christopher P.,0,3,30,30
1715611242856,EDS 204R,B01,507331,Heinzman; Erica M.,14,0,30,16
1715611243882,EDS 206R,A00,507332,Staff,0,4,30,30
1715611243882,EDS 206R,B00,507343,Staff,15,0,30,15
1715611244907,EDS 250,A00,507344,Hemans; Patricia Ann Benitez,20,0,40,20
1715611245931,EDS 281,A00,507345,Daly; Alan J.,18,0,18,0
1715611246960,EDS 284,A00,507350,Daly; Alan J.,16,0,16,0
1715611247985,EDS 286,A00,507359,Fine; Sarah,18,0,18,0
1715611249011,EDS 289C,A01,507361,Daly; Alan J.,18,0,18,0
1715611250042,EDS 290,A00,507366,Hofstetter; Carolyn,15,0,15,0
1715611251070,LIGM 5A,A00,507421,Fischer-Grunski; Eva K,17,0,20,3
1715611252095,LIGM 5B,A00,507423,Fischer-Grunski; Eva K,19,0,20,1
1715611253121,LIGM 5C,A00,507425,Fischer-Grunski; Eva K,19,0,20,1
1715611254149,LIIT 5AS,A00,507427,Carnelos; Chiara,20,0,20,0
1715611255174,LIIT 5BS,A00,507430,Carnelos; Chiara,20,0,20,0
1715611256199,LIIT 5CS,A00,507432,Carnelos; Chiara,20,0,20,0
1715611257230,LISP 5A,A00,507541,Munoz Sanchez; Alicia,11,0,20,9
1715611258258,LISP 5B,A00,507671,Munoz Sanchez; Alicia,9,0,20,11
1715611259286,LISP 5C,A00,507696,Munoz Sanchez; Alicia,9,0,20,11
1715611260315,MAE 197,001,528363,Boechler; Nicholas Sebastia,9998,0,9999,1
1715611261342,MATH 197,001,523477,Kedlaya; Kiran S.,9994,0,9999,5
1715611261342,MATH 197,002,563811,Zhang; Danna,9994,0,9999,5
1715611261342,MATH 197,003,628552,Dumitriu; Ioana,9998,0,9999,1
1715611261342,MATH 197,004,660885,Floyd; Eric,9999,0,9999,0
1715611262365,MCWP 40R,A00,518780,Staff,2,0,20,18
1715611262365,MCWP 40R,B00,518781,Staff,11,0,20,9
1715611262365,MCWP 40R,C00,518783,Staff,5,0,20,15
1715611263395,MCWP 50R,A00,518791,Staff,0,1,20,20
1715611263395,MCWP 50R,B00,518792,Staff,0,2,20,20
1715611263395,MCWP 50R,C00,518793,Staff,0,4,20,20
1715611263395,MCWP 50R,D00,518794,Staff,0,1,20,20
1715611263395,MCWP 50R,E00,518795,Staff,0,2,20,20
1715611263395,MCWP 50R,F00,518796,Staff,0,1,20,20
1715611263395,MCWP 50R,G00,518797,Staff,0,1,20,20
1715611264421,MMW 12R,A01,514034,Herbst; Matthew,0,2,16,16
1715611264421,MMW 12R,A02,514035,Herbst; Matthew,0,0,16,16
1715611265448,MMW 13R,A01,514037,Staff,0,5,16,16
1715611265448,MMW 13R,A02,514039,Staff,0,5,16,16
1715611265448,MMW 13R,A03,628519,Staff,0,4,16,16
1715611267502,SIO 295LS,A00,523233,Staff,10,0,30,20
1715611268529,SIO 295S,A00,523232,Staff,10,0,30,20
1715611269559,SIOC 290S,A01,637330,Merrifield; Mark A,23,0,30,7
1715611270588,SIOC 291S,A01,637333,Gabriel; Corey John,23,0,30,7
1715611271615,SOCI 117,A01,494376,Staff,0,5,5,5
1715611272641,WES 237B,A00,494380,Staff,10,0,20,10
1715611274713,AESE 279B,A00,494370,Wade; Jon P,0,0,33,33
1715611275737,AIP 97,001,660915,Van Den Einde; Yael Dahlia,9999,0,9999,0
1715611276761,AIP 197,001,627712,Vespa; Emanuel Ignacio,9995,0,9999,4
1715611276761,AIP 197,002,650778,Amir; On,9998,0,9999,1
1715611276761,AIP 197,003,650933,Avenancio-Leon; Carlos,9998,0,9999,1
1715611276761,AIP 197,004,658530,Heyman; Gail D.,9998,0,9999,1
1715611276761,AIP 197,005,658631,Neal; Sonya E,9998,0,9999,1
1715611276761,AIP 197,006,658671,Du; Songzi,9998,0,9999,1
1715611277785,ANAR 135S,A00,494369,Braswell; Geoffrey E.,0,0,0,0
1715611278844,BENG 196,001,628496,Engler; Adam J.,9998,0,9999,1
1715611278844,BENG 196,002,660916,Watson; John Thomas,9999,0,9999,0
1715611279872,BISP 197,001,650773,Wilhelm; James E.,9994,0,9999,5
1715611279872,BISP 197,002,658904,Coleman; Aaron B.,9998,0,9999,1
1715611280900,CAT 124RS,A01,519847,Geibel; William,0,0,20,20
1715611281925,CAT 125RS,A01,515971,Geibel; William,0,0,20,20
1715611282953,CLRE 250,A00,511389,Morris; Sheldon,9992,0,9999,7
1715611284010,CLRE 251,A00,507176,Mehta; Ravindra L.,9992,0,9999,7
1715611284010,CLRE 251,B00,511410,Mehta; Ravindra L.,9998,0,9999,1
1715611285038,CLRE 252,A00,507189,Cuomo; Raphael Eduardo,9994,0,9999,5
1715611286064,CLRE 253,A00,507199,Vaida; Florin,9994,0,9999,5
1715611286064,CLRE 253,B00,507202,Vaida; Florin,9999,0,9999,0
1715611287092,CLRE 259,A00,507211,Patel; Hemal,9996,0,9999,3
1715611288115,CLRE 260,A00,507221,Cuomo; Raphael Eduardo,9999,0,9999,0
1715611289143,CLRE 297,001,507242,Cuomo; Raphael Eduardo,9999,0,9999,0
1715611290168,COGS 197,001,638244,Voytek; Bradley Thomas,9997,0,9999,2
1715611291191,CSE 191,A00,516875,Minnes Kemp; Mor Mia,9991,0,9999,8
1715611292219,CSE 197,001,637388,Minnes Kemp; Mor Mia,9992,0,9999,7
1715611293244,CSS 201S,A01,494383,Mignozzetti; Umberto,35,0,35,0
1715611294274,CSS 202S,A01,494387,Mignozzetti; Umberto,35,0,35,0
1715611295301,DSC 197,001,628532,Eldridge; Justin Matthew,9995,0,9999,4
1715611296324,EAP 100,A00,516065,Staff,9799,0,9999,200
1715611297351,ECE 45,A01,507414,Staff,31,0,60,29
1715611299405,ECE 111,A01,507420,Staff,11,0,50,39
1715611300431,ECE 197,001,548057,Sievenpiper; Daniel F.,9991,0,9999,8
1715611301461,EDS 115,A00,507243,Choi; Bailey Miyeon,7,0,28,21
1715611302491,EDS 117,A01,494379,Staff,0,6,34,34
1715611303521,EDS 125,A00,507246,Hopkins; Megan Beth,8,0,30,22
1715611304547,EDS 128A,A01,507264,Fargason; Sharon Gayle,6,0,26,20
1715611305573,EDS 128B,A01,507293,Pappas; Elizabeth,10,0,30,20
1715611306601,EDS 139,A00,507294,Fargason; Sharon Gayle,10,0,30,20
1715611306601,EDS 139,B00,507313,Pappas; Elizabeth,11,0,30,19
1715611307627,EDS 201,A00,507315,Staff,10,0,30,20
1715611308655,EDS 203,A01,507317,Halter; Christopher P.,10,0,30,20
1715611309681,EDS 204R,A01,507319,Halter; Christopher P.,0,3,30,30
1715611309681,EDS 204R,B01,507331,Heinzman; Erica M.,14,0,30,16
1715611310707,EDS 206R,A00,507332,Staff,0,4,30,30
1715611310707,EDS 206R,B00,507343,Staff,15,0,30,15
1715611311733,EDS 250,A00,507344,Hemans; Patricia Ann Benitez,20,0,40,20
1715611312761,EDS 281,A00,507345,Daly; Alan J.,18,0,18,0
1715611313790,EDS 284,A00,507350,Daly; Alan J.,16,0,16,0
1715611314816,EDS 286,A00,507359,Fine; Sarah,18,0,18,0
1715611315841,EDS 289C,A01,507361,Daly; Alan J.,18,0,18,0
1715611316867,EDS 290,A00,507366,Hofstetter; Carolyn,15,0,15,0
1715611317897,LIGM 5A,A00,507421,Fischer-Grunski; Eva K,17,0,20,3
1715611318923,LIGM 5B,A00,507423,Fischer-Grunski; Eva K,19,0,20,1
1715611319949,LIGM 5C,A00,507425,Fischer-Grunski; Eva K,19,0,20,1
1715611320974,LIIT 5AS,A00,507427,Carnelos; Chiara,20,0,20,0
1715611322000,LIIT 5BS,A00,507430,Carnelos; Chiara,20,0,20,0
1715611323029,LIIT 5CS,A00,507432,Carnelos; Chiara,20,0,20,0
1715611324058,LISP 5A,A00,507541,Munoz Sanchez; Alicia,11,0,20,9
1715611325084,LISP 5B,A00,507671,Munoz Sanchez; Alicia,9,0,20,11
1715611326111,LISP 5C,A00,507696,Munoz Sanchez; Alicia,9,0,20,11
1715611327136,MAE 197,001,528363,Boechler; Nicholas Sebastia,9998,0,9999,1
1715611328165,MATH 197,001,523477,Kedlaya; Kiran S.,9994,0,9999,5
1715611328165,MATH 197,002,563811,Zhang; Danna,9994,0,9999,5
1715611328165,MATH 197,003,628552,Dumitriu; Ioana,9998,0,9999,1
1715611328165,MATH 197,004,660885,Floyd; Eric,9999,0,9999,0
1715611329194,MCWP 40R,A00,518780,Staff,2,0,20,18
1715611329194,MCWP 40R,B00,518781,Staff,11,0,20,9
1715611329194,MCWP 40R,C00,518783,Staff,5,0,20,15
1715611330223,MCWP 50R,A00,518791,Staff,0,1,20,20
1715611330223,MCWP 50R,B00,518792,Staff,0,2,20,20
1715611330223,MCWP 50R,C00,518793,Staff,0,4,20,20
1715611330223,MCWP 50R,D00,518794,Staff,0,1,20,20
1715611330223,MCWP 50R,E00,518795,Staff,0,2,20,20
1715611330223,MCWP 50R,F00,518796,Staff,0,1,20,20
1715611330223,MCWP 50R,G00,518797,Staff,0,1,20,20
1715611331251,MMW 12R,A01,514034,Herbst; Matthew,0,2,16,16
1715611331251,MMW 12R,A02,514035,Herbst; Matthew,0,0,16,16
1715611332279,MMW 13R,A01,514037,Staff,0,5,16,16
1715611332279,MMW 13R,A02,514039,Staff,0,5,16,16
1715611332279,MMW 13R,A03,628519,Staff,0,4,16,16
1715611334333,SIO 295LS,A00,523233,Staff,10,0,30,20
1715611335362,SIO 295S,A00,523232,Staff,10,0,30,20
1715611336392,SIOC 290S,A01,637330,Merrifield; Mark A,23,0,30,7
1715611337423,SIOC 291S,A01,637333,Gabriel; Corey John,23,0,30,7
1715611338449,SOCI 117,A01,494376,Staff,0,5,5,5
1715611339476,WES 237B,A00,494380,Staff,10,0,20,10
1715611341534,AESE 279B,A00,494370,Wade; Jon P,0,0,33,33
1715611342560,AIP 97,001,660915,Van Den Einde; Yael Dahlia,9999,0,9999,0
1715611343587,AIP 197,001,627712,Vespa; Emanuel Ignacio,9995,0,9999,4
1715611343587,AIP 197,002,650778,Amir; On,9998,0,9999,1
1715611343587,AIP 197,003,650933,Avenancio-Leon; Carlos,9998,0,9999,1
1715611343587,AIP 197,004,658530,Heyman; Gail D.,9998,0,9999,1
1715611343587,AIP 197,005,658631,Neal; Sonya E,9998,0,9999,1
1715611343587,AIP 197,006,658671,Du; Songzi,9998,0,9999,1
1715611344618,ANAR 135S,A00,494369,Braswell; Geoffrey E.,0,0,0,0
1715611345645,BENG 196,001,628496,Engler; Adam J.,9998,0,9999,1
1715611345645,BENG 196,002,660916,Watson; John Thomas,9999,0,9999,0
1715611346672,BISP 197,001,650773,Wilhelm; James E.,9994,0,9999,5
1715611346672,BISP 197,002,658904,Coleman; Aaron B.,9998,0,9999,1
1715611347697,CAT 124RS,A01,519847,Geibel; William,0,0,20,20
1715611348721,CAT 125RS,A01,515971,Geibel; William,0,0,20,20
1715611349752,CLRE 250,A00,511389,Morris; Sheldon,9992,0,9999,7
1715611350779,CLRE 251,A00,507176,Mehta; Ravindra L.,9992,0,9999,7
1715611350779,CLRE 251,B00,511410,Mehta; Ravindra L.,9998,0,9999,1
1715611351805,CLRE 252,A00,507189,Cuomo; Raphael Eduardo,9994,0,9999,5
1715611352830,CLRE 253,A00,507199,Vaida; Florin,9994,0,9999,5
1715611352830,CLRE 253,B00,507202,Vaida; Florin,9999,0,9999,0
1715611353855,CLRE 259,A00,507211,Patel; Hemal,9996,0,9999,3
1715611354880,CLRE 260,A00,507221,Cuomo; Raphael Eduardo,9999,0,9999,0
1715611355909,CLRE 297,001,507242,Cuomo; Raphael Eduardo,9999,0,9999,0
1715611356935,COGS 197,001,638244,Voytek; Bradley Thomas,9997,0,9999,2
1715611357959,CSE 191,A00,516875,Minnes Kemp; Mor Mia,9991,0,9999,8
1715611358985,CSE 197,001,637388,Minnes Kemp; Mor Mia,9992,0,9999,7
1715611360010,CSS 201S,A01,494383,Mignozzetti; Umberto,35,0,35,0
1715611361036,CSS 202S,A01,494387,Mignozzetti; Umberto,35,0,35,0
1715611362061,DSC 197,001,628532,Eldridge; Justin Matthew,9995,0,9999,4
1715611363088,EAP 100,A00,516065,Staff,9799,0,9999,200
1715611364119,ECE 45,A01,507414,Staff,31,0,60,29
1715611366174,ECE 111,A01,507420,Staff,11,0,50,39
1715611367203,ECE 197,001,548057,Sievenpiper; Daniel F.,9991,0,9999,8
1715611368229,EDS 115,A00,507243,Choi; Bailey Miyeon,7,0,28,21
1715611369254,EDS 117,A01,494379,Staff,0,6,34,34
1715611370283,EDS 125,A00,507246,Hopkins; Megan Beth,8,0,30,22
1715611371309,EDS 128A,A01,507264,Fargason; Sharon Gayle,6,0,26,20
1715611372341,EDS 128B,A01,507293,Pappas; Elizabeth,10,0,30,20
1715611373366,EDS 139,A00,507294,Fargason; Sharon Gayle,10,0,30,20
1715611373366,EDS 139,B00,507313,Pappas; Elizabeth,11,0,30,19
1715611374392,EDS 201,A00,507315,Staff,10,0,30,20
1715611375420,EDS 203,A01,507317,Halter; Christopher P.,10,0,30,20
1715611376445,EDS 204R,A01,507319,Halter; Christopher P.,0,3,30,30
1715611376445,EDS 204R,B01,507331,Heinzman; Erica M.,14,0,30,16
1715611377474,EDS 206R,A00,507332,Staff,0,4,30,30
1715611377474,EDS 206R,B00,507343,Staff,15,0,30,15
1715611378501,EDS 250,A00,507344,Hemans; Patricia Ann Benitez,20,0,40,20
1715611379529,EDS 281,A00,507345,Daly; Alan J.,18,0,18,0
1715611380554,EDS 284,A00,507350,Daly; Alan J.,16,0,16,0
1715611381581,EDS 286,A00,507359,Fine; Sarah,18,0,18,0
1715611382609,EDS 289C,A01,507361,Daly; Alan J.,18,0,18,0
1715611383636,EDS 290,A00,507366,Hofstetter; Carolyn,15,0,15,0
1715611384666,LIGM 5A,A00,507421,Fischer-Grunski; Eva K,17,0,20,3
1715611385694,LIGM 5B,A00,507423,Fischer-Grunski; Eva K,19,0,20,1
1715611386720,LIGM 5C,A00,507425,Fischer-Grunski; Eva K,19,0,20,1
1715611387745,LIIT 5AS,A00,507427,Carnelos; Chiara,20,0,20,0
1715611388771,LIIT 5BS,A00,507430,Carnelos; Chiara,20,0,20,0
1715611389801,LIIT 5CS,A00,507432,Carnelos; Chiara,20,0,20,0
1715611390827,LISP 5A,A00,507541,Munoz Sanchez; Alicia,11,0,20,9
1715611391852,LISP 5B,A00,507671,Munoz Sanchez; Alicia,9,0,20,11
1715611392877,LISP 5C,A00,507696,Munoz Sanchez; Alicia,9,0,20,11
1715611393905,MAE 197,001,528363,Boechler; Nicholas Sebastia,9998,0,9999,1
1715611394934,MATH 197,001,523477,Kedlaya; Kiran S.,9994,0,9999,5
1715611394934,MATH 197,002,563811,Zhang; Danna,9994,0,9999,5
1715611394934,MATH 197,003,628552,Dumitriu; Ioana,9998,0,9999,1
1715611394934,MATH 197,004,660885,Floyd; Eric,9999,0,9999,0
1715611395960,MCWP 40R,A00,518780,Staff,2,0,20,18
1715611395960,MCWP 40R,B00,518781,Staff,11,0,20,9
1715611395960,MCWP 40R,C00,518783,Staff,5,0,20,15
1715611396990,MCWP 50R,A00,518791,Staff,0,1,20,20
1715611396990,MCWP 50R,B00,518792,Staff,0,2,20,20
1715611396990,MCWP 50R,C00,518793,Staff,0,4,20,20
1715611396990,MCWP 50R,D00,518794,Staff,0,1,20,20
1715611396990,MCWP 50R,E00,518795,Staff,0,2,20,20
1715611396990,MCWP 50R,F00,518796,Staff,0,1,20,20
1715611396990,MCWP 50R,G00,518797,Staff,0,1,20,20
1715611398017,MMW 12R,A01,514034,Herbst; Matthew,0,2,16,16
1715611398017,MMW 12R,A02,514035,Herbst; Matthew,0,0,16,16
1715611399045,MMW 13R,A01,514037,Staff,0,5,16,16
1715611399045,MMW 13R,A02,514039,Staff,0,5,16,16
1715611399045,MMW 13R,A03,628519,Staff,0,4,16,16
1715611401098,SIO 295LS,A00,523233,Staff,10,0,30,20
1715611402124,SIO 295S,A00,523232,Staff,10,0,30,20
1715611403152,SIOC 290S,A01,637330,Merrifield; Mark A,23,0,30,7
1715611404178,SIOC 291S,A01,637333,Gabriel; Corey John,23,0,30,7
1715611405206,SOCI 117,A01,494376,Staff,0,5,5,5
1715611406231,WES 237B,A00,494380,Staff,10,0,20,10
1715611408304,AESE 279B,A00,494370,Wade; Jon P,0,0,33,33
1715611409329,AIP 97,001,660915,Van Den Einde; Yael Dahlia,9999,0,9999,0
1715611410359,AIP 197,001,627712,Vespa; Emanuel Ignacio,9995,0,9999,4
1715611410359,AIP 197,002,650778,Amir; On,9998,0,9999,1
1715611410359,AIP 197,003,650933,Avenancio-Leon; Carlos,9998,0,9999,1
1715611410359,AIP 197,004,658530,Heyman; Gail D.,9998,0,9999,1
1715611410359,AIP 197,005,658631,Neal; Sonya E,9998,0,9999,1
1715611410359,AIP 197,006,658671,Du; Songzi,9998,0,9999,1
1715611411386,ANAR 135S,A00,494369,Braswell; Geoffrey E.,0,0,0,0
1715611412411,BENG 196,001,628496,Engler; Adam J.,9998,0,9999,1
1715611412411,BENG 196,002,660916,Watson; John Thomas,9999,0,9999,0
1715611413441,BISP 197,001,650773,Wilhelm; James E.,9994,0,9999,5
1715611413441,BISP 197,002,658904,Coleman; Aaron B.,9998,0,9999,1
1715611414468,CAT 124RS,A01,519847,Geibel; William,0,0,20,20
1715611415493,CAT 125RS,A01,515971,Geibel; William,0,0,20,20
1715611416522,CLRE 250,A00,511389,Morris; Sheldon,9992,0,9999,7
1715611417548,CLRE 251,A00,507176,Mehta; Ravindra L.,9992,0,9999,7
1715611417548,CLRE 251,B00,511410,Mehta; Ravindra L.,9998,0,9999,1
1715611418579,CLRE 252,A00,507189,Cuomo; Raphael Eduardo,9994,0,9999,5
1715611419606,CLRE 253,A00,507199,Vaida; Florin,9994,0,9999,5
1715611419606,CLRE 253,B00,507202,Vaida; Florin,9999,0,9999,0
1715611420631,CLRE 259,A00,507211,Patel; Hemal,9996,0,9999,3
1715611421661,CLRE 260,A00,507221,Cuomo; Raphael Eduardo,9999,0,9999,0
1715611422691,CLRE 297,001,507242,Cuomo; Raphael Eduardo,9999,0,9999,0
1715611423717,COGS 197,001,638244,Voytek; Bradley Thomas,9997,0,9999,2
1715611424754,CSE 191,A00,516875,Minnes Kemp; Mor Mia,9991,0,9999,8
1715611425779,CSE 197,001,637388,Minnes Kemp; Mor Mia,9992,0,9999,7
1715611426805,CSS 201S,A01,494383,Mignozzetti; Umberto,35,0,35,0
1715611427832,CSS 202S,A01,494387,Mignozzetti; Umberto,35,0,35,0
1715611428858,DSC 197,001,628532,Eldridge; Justin Matthew,9995,0,9999,4
1715611429884,EAP 100,A00,516065,Staff,9799,0,9999,200
1715611430913,ECE 45,A01,507414,Staff,31,0,60,29
1715611432965,ECE 111,A01,507420,Staff,11,0,50,39
1715611433992,ECE 197,001,548057,Sievenpiper; Daniel F.,9991,0,9999,8
1715611435021,EDS 115,A00,507243,Choi; Bailey Miyeon,7,0,28,21
1715611436047,EDS 117,A01,494379,Staff,0,6,34,34
1715611437073,EDS 125,A00,507246,Hopkins; Megan Beth,8,0,30,22
1715611438100,EDS 128A,A01,507264,Fargason; Sharon Gayle,6,0,26,20
1715611439129,EDS 128B,A01,507293,Pappas; Elizabeth,10,0,30,20
1715611440158,EDS 139,A00,507294,Fargason; Sharon Gayle,10,0,30,20
1715611440158,EDS 139,B00,507313,Pappas; Elizabeth,11,0,30,19
1715611441183,EDS 201,A00,507315,Staff,10,0,30,20
1715611442217,EDS 203,A01,507317,Halter; Christopher P.,10,0,30,20
1715611443248,EDS 204R,A01,507319,Halter; Christopher P.,0,3,30,30
1715611443248,EDS 204R,B01,507331,Heinzman; Erica M.,14,0,30,16
1715611444273,EDS 206R,A00,507332,Staff,0,4,30,30
1715611444273,EDS 206R,B00,507343,Staff,15,0,30,15
1715611445302,EDS 250,A00,507344,Hemans; Patricia Ann Benitez,20,0,40,20
1715611446327,EDS 281,A00,507345,Daly; Alan J.,18,0,18,0
1715611447357,EDS 284,A00,507350,Daly; Alan J.,16,0,16,0
1715611448382,EDS 286,A00,507359,Fine; Sarah,18,0,18,0
1715611449410,EDS 289C,A01,507361,Daly; Alan J.,18,0,18,0
1715611450435,EDS 290,A00,507366,Hofstetter; Carolyn,15,0,15,0
1715611451463,LIGM 5A,A00,507421,Fischer-Grunski; Eva K,17,0,20,3
1715611452489,LIGM 5B,A00,507423,Fischer-Grunski; Eva K,19,0,20,1
1715611453519,LIGM 5C,A00,507425,Fischer-Grunski; Eva K,19,0,20,1
1715611454543,LIIT 5AS,A00,507427,Carnelos; Chiara,20,0,20,0
1715611455572,LIIT 5BS,A00,507430,Carnelos; Chiara,20,0,20,0
1715611456602,LIIT 5CS,A00,507432,Carnelos; Chiara,20,0,20,0
1715611457629,LISP 5A,A00,507541,Munoz Sanchez; Alicia,11,0,20,9
1715611458655,LISP 5B,A00,507671,Munoz Sanchez; Alicia,9,0,20,11
1715611459679,LISP 5C,A00,507696,Munoz Sanchez; Alicia,9,0,20,11
1715611460708,MAE 197,001,528363,Boechler; Nicholas Sebastia,9998,0,9999,1
1715611461734,MATH 197,001,523477,Kedlaya; Kiran S.,9994,0,9999,5
1715611461734,MATH 197,002,563811,Zhang; Danna,9994,0,9999,5
1715611461734,MATH 197,003,628552,Dumitriu; Ioana,9998,0,9999,1
1715611461734,MATH 197,004,660885,Floyd; Eric,9999,0,9999,0
1715611462760,MCWP 40R,A00,518780,Staff,2,0,20,18
1715611462760,MCWP 40R,B00,518781,Staff,11,0,20,9
1715611462760,MCWP 40R,C00,518783,Staff,5,0,20,15
1715611463787,MCWP 50R,A00,518791,Staff,0,1,20,20
1715611463787,MCWP 50R,B00,518792,Staff,0,2,20,20
1715611463787,MCWP 50R,C00,518793,Staff,0,4,20,20
1715611463787,MCWP 50R,D00,518794,Staff,0,1,20,20
1715611463787,MCWP 50R,E00,518795,Staff,0,2,20,20
1715611463787,MCWP 50R,F00,518796,Staff,0,1,20,20
1715611463787,MCWP 50R,G00,518797,Staff,0,1,20,20
1715611464812,MMW 12R,A01,514034,Herbst; Matthew,0,2,16,16
1715611464812,MMW 12R,A02,514035,Herbst; Matthew,0,0,16,16
1715611465839,MMW 13R,A01,514037,Staff,0,5,16,16
1715611465839,MMW 13R,A02,514039,Staff,0,5,16,16
1715611465839,MMW 13R,A03,628519,Staff,0,4,16,16
1715611467892,SIO 295LS,A00,523233,Staff,10,0,30,20
1715611468918,SIO 295S,A00,523232,Staff,10,0,30,20
1715611469947,SIOC 290S,A01,637330,Merrifield; Mark A,23,0,30,7
1715611470974,SIOC 291S,A01,637333,Gabriel; Corey John,23,0,30,7
1715611472001,SOCI 117,A01,494376,Staff,0,5,5,5
1715611473028,WES 237B,A00,494380,Staff,10,0,20,10
1715611475088,AESE 279B,A00,494370,Wade; Jon P,0,0,33,33
1715611476119,AIP 97,001,660915,Van Den Einde; Yael Dahlia,9999,0,9999,0
1715611477143,AIP 197,001,627712,Vespa; Emanuel Ignacio,9995,0,9999,4
1715611477143,AIP 197,002,650778,Amir; On,9998,0,9999,1
1715611477143,AIP 197,003,650933,Avenancio-Leon; Carlos,9998,0,9999,1
1715611477143,AIP 197,004,658530,Heyman; Gail D.,9998,0,9999,1
1715611477143,AIP 197,005,658631,Neal; Sonya E,9998,0,9999,1
1715611477143,AIP 197,006,658671,Du; Songzi,9998,0,9999,1
1715611478167,ANAR 135S,A00,494369,Braswell; Geoffrey E.,0,0,0,0
1715611479196,BENG 196,001,628496,Engler; Adam J.,9998,0,9999,1
1715611479196,BENG 196,002,660916,Watson; John Thomas,9999,0,9999,0
1715611480223,BISP 197,001,650773,Wilhelm; James E.,9994,0,9999,5
1715611480223,BISP 197,002,658904,Coleman; Aaron B.,9998,0,9999,1
1715611481248,CAT 124RS,A01,519847,Geibel; William,0,0,20,20
1715611482274,CAT 125RS,A01,515971,Geibel; William,0,0,20,20
1715611483299,CLRE 250,A00,511389,Morris; Sheldon,9992,0,9999,7
1715611484327,CLRE 251,A00,507176,Mehta; Ravindra L.,9992,0,9999,7
1715611484327,CLRE 251,B00,511410,Mehta; Ravindra L.,9998,0,9999,1
1715611485357,CLRE 252,A00,507189,Cuomo; Raphael Eduardo,9994,0,9999,5
1715611486382,CLRE 253,A00,507199,Vaida; Florin,9994,0,9999,5
1715611486382,CLRE 253,B00,507202,Vaida; Florin,9999,0,9999,0
1715611487410,CLRE 259,A00,507211,Patel; Hemal,9996,0,9999,3
1715611488438,CLRE 260,A00,507221,Cuomo; Raphael Eduardo,9999,0,9999,0
1715611489466,CLRE 297,001,507242,Cuomo; Raphael Eduardo,9999,0,9999,0
1715611490496,COGS 197,001,638244,Voytek; Bradley Thomas,9997,0,9999,2
1715611491523,CSE 191,A00,516875,Minnes Kemp; Mor Mia,9991,0,9999,8
1715611492551,CSE 197,001,637388,Minnes Kemp; Mor Mia,9992,0,9999,7
1715611493576,CSS 201S,A01,494383,Mignozzetti; Umberto,35,0,35,0
1715611494601,CSS 202S,A01,494387,Mignozzetti; Umberto,35,0,35,0
1715611495626,DSC 197,001,628532,Eldridge; Justin Matthew,9995,0,9999,4
1715611496654,EAP 100,A00,516065,Staff,9799,0,9999,200
1715611497677,ECE 45,A01,507414,Staff,31,0,60,29
1715611499728,ECE 111,A01,507420,Staff,11,0,50,39
1715611500753,ECE 197,001,548057,Sievenpiper; Daniel F.,9991,0,9999,8
1715611501783,EDS 115,A00,507243,Choi; Bailey Miyeon,7,0,28,21
1715611502811,EDS 117,A01,494379,Staff,0,6,34,34
1715611503839,EDS 125,A00,507246,Hopkins; Megan Beth,8,0,30,22
1715611504864,EDS 128A,A01,507264,Fargason; Sharon Gayle,6,0,26,20
1715611505888,EDS 128B,A01,507293,Pappas; Elizabeth,10,0,30,20
1715611506916,EDS 139,A00,507294,Fargason; Sharon Gayle,10,0,30,20
1715611506916,EDS 139,B00,507313,Pappas; Elizabeth,11,0,30,19
1715611507948,EDS 201,A00,507315,Staff,10,0,30,20
1715611508976,EDS 203,A01,507317,Halter; Christopher P.,10,0,30,20
1715611510001,EDS 204R,A01,507319,Halter; Christopher P.,0,3,30,30
1715611510001,EDS 204R,B01,507331,Heinzman; Erica M.,14,0,30,16
1715611511027,EDS 206R,A00,507332,Staff,0,4,30,30
1715611511027,EDS 206R,B00,507343,Staff,15,0,30,15
1715611512054,EDS 250,A00,507344,Hemans; Patricia Ann Benitez,20,0,40,20
1715611513079,EDS 281,A00,507345,Daly; Alan J.,18,0,18,0
1715611514106,EDS 284,A00,507350,Daly; Alan J.,16,0,16,0
1715611515130,EDS 286,A00,507359,Fine; Sarah,18,0,18,0
1715611516155,EDS 289C,A01,507361,Daly; Alan J.,18,0,18,0
1715611517182,EDS 290,A00,507366,Hofstetter; Carolyn,15,0,15,0
1715611518213,LIGM 5A,A00,507421,Fischer-Grunski; Eva K,17,0,20,3
1715611519237,LIGM 5B,A00,507423,Fischer-Grunski; Eva K,19,0,20,1
1715611520264,LIGM 5C,A00,507425,Fischer-Grunski; Eva K,19,0,20,1
1715611521294,LIIT 5AS,A00,507427,Carnelos; Chiara,20,0,20,0
1715611522323,LIIT 5BS,A00,507430,Carnelos; Chiara,20,0,20,0
1715611523349,LIIT 5CS,A00,507432,Carnelos; Chiara,20,0,20,0
1715611524380,LISP 5A,A00,507541,Munoz Sanchez; Alicia,11,0,20,9
1715611525406,LISP 5B,A00,507671,Munoz Sanchez; Alicia,9,0,20,11
1715611526433,LISP 5C,A00,507696,Munoz Sanchez; Alicia,9,0,20,11
1715611527457,MAE 197,001,528363,Boechler; Nicholas Sebastia,9998,0,9999,1
1715611528486,MATH 197,001,523477,Kedlaya; Kiran S.,9994,0,9999,5
1715611528486,MATH 197,002,563811,Zhang; Danna,9994,0,9999,5
1715611528486,MATH 197,003,628552,Dumitriu; Ioana,9998,0,9999,1
1715611528486,MATH 197,004,660885,Floyd; Eric,9999,0,9999,0
1715611529511,MCWP 40R,A00,518780,Staff,2,0,20,18
1715611529511,MCWP 40R,B00,518781,Staff,11,0,20,9
1715611529511,MCWP 40R,C00,518783,Staff,5,0,20,15
1715611530539,MCWP 50R,A00,518791,Staff,0,1,20,20
1715611530539,MCWP 50R,B00,518792,Staff,0,2,20,20
1715611530539,MCWP 50R,C00,518793,Staff,0,4,20,20
1715611530539,MCWP 50R,D00,518794,Staff,0,1,20,20
1715611530539,MCWP 50R,E00,518795,Staff,0,2,20,20
1715611530539,MCWP 50R,F00,518796,Staff,0,1,20,20
1715611530539,MCWP 50R,G00,518797,Staff,0,1,20,20
1715611531568,MMW 12R,A01,514034,Herbst; Matthew,0,2,16,16
1715611531568,MMW 12R,A02,514035,Herbst; Matthew,0,0,16,16
1715611532597,MMW 13R,A01,514037,Staff,0,5,16,16
1715611532597,MMW 13R,A02,514039,Staff,0,5,16,16
1715611532597,MMW 13R,A03,628519,Staff,0,4,16,16
1715611534649,SIO 295LS,A00,523233,Staff,10,0,30,20
1715611535675,SIO 295S,A00,523232,Staff,10,0,30,20
1715611536701,SIOC 290S,A01,637330,Merrifield; Mark A,23,0,30,7
1715611537727,SIOC 291S,A01,637333,Gabriel; Corey John,23,0,30,7
1715611538757,SOCI 117,A01,494376,Staff,0,5,5,5
1715611539782,WES 237B,A00,494380,Staff,10,0,20,10
1715611541853,AESE 279B,A00,494370,Wade; Jon P,0,0,33,33
1715611542881,AIP 97,001,660915,Van Den Einde; Yael Dahlia,9999,0,9999,0
1715611543907,AIP 197,001,627712,Vespa; Emanuel Ignacio,9995,0,9999,4
1715611543907,AIP 197,002,650778,Amir; On,9998,0,9999,1
1715611543907,AIP 197,003,650933,Avenancio-Leon; Carlos,9998,0,9999,1
1715611543907,AIP 197,004,658530,Heyman; Gail D.,9998,0,9999,1
1715611543907,AIP 197,005,658631,Neal; Sonya E,9998,0,9999,1
1715611543907,AIP 197,006,658671,Du; Songzi,9998,0,9999,1
1715611544934,ANAR 135S,A00,494369,Braswell; Geoffrey E.,0,0,0,0
1715611545960,BENG 196,001,628496,Engler; Adam J.,9998,0,9999,1
1715611545960,BENG 196,002,660916,Watson; John Thomas,9999,0,9999,0
1715611546986,BISP 197,001,650773,Wilhelm; James E.,9994,0,9999,5
1715611546986,BISP 197,002,658904,Coleman; Aaron B.,9998,0,9999,1
1715611548013,CAT 124RS,A01,519847,Geibel; William,0,0,20,20
1715611549040,CAT 125RS,A01,515971,Geibel; William,0,0,20,20
1715611550068,CLRE 250,A00,511389,Morris; Sheldon,9992,0,9999,7
1715611551095,CLRE 251,A00,507176,Mehta; Ravindra L.,9992,0,9999,7
1715611551095,CLRE 251,B00,511410,Mehta; Ravindra L.,9998,0,9999,1
1715611552122,CLRE 252,A00,507189,Cuomo; Raphael Eduardo,9994,0,9999,5
1715611553148,CLRE 253,A00,507199,Vaida; Florin,9994,0,9999,5
1715611553148,CLRE 253,B00,507202,Vaida; Florin,9999,0,9999,0
1715611554176,CLRE 259,A00,507211,Patel; Hemal,9996,0,9999,3
1715611555203,CLRE 260,A00,507221,Cuomo; Raphael Eduardo,9999,0,9999,0
1715611556230,CLRE 297,001,507242,Cuomo; Raphael Eduardo,9999,0,9999,0
1715611557255,COGS 197,001,638244,Voytek; Bradley Thomas,9997,0,9999,2
1715611558280,CSE 191,A00,516875,Minnes Kemp; Mor Mia,9991,0,9999,8
1715611559306,CSE 197,001,637388,Minnes Kemp; Mor Mia,9992,0,9999,7
1715611560335,CSS 201S,A01,494383,Mignozzetti; Umberto,35,0,35,0
1715611561361,CSS 202S,A01,494387,Mignozzetti; Umberto,35,0,35,0
1715611562389,DSC 197,001,628532,Eldridge; Justin Matthew,9995,0,9999,4
1715611563415,EAP 100,A00,516065,Staff,9799,0,9999,200
1715611564439,ECE 45,A01,507414,Staff,31,0,60,29
1715611566495,ECE 111,A01,507420,Staff,11,0,50,39
1715611567521,ECE 197,001,548057,Sievenpiper; Daniel F.,9991,0,9999,8
1715611568548,EDS 115,A00,507243,Choi; Bailey Miyeon,7,0,28,21
1715611569577,EDS 117,A01,494379,Staff,0,6,34,34
1715611570604,EDS 125,A00,507246,Hopkins; Megan Beth,8,0,30,22
1715611571635,EDS 128A,A01,507264,Fargason; Sharon Gayle,6,0,26,20
1715611572662,EDS 128B,A01,507293,Pappas; Elizabeth,10,0,30,20
1715611573687,EDS 139,A00,507294,Fargason; Sharon Gayle,10,0,30,20
1715611573687,EDS 139,B00,507313,Pappas; Elizabeth,11,0,30,19
1715611574713,EDS 201,A00,507315,Staff,10,0,30,20
1715611575743,EDS 203,A01,507317,Halter; Christopher P.,10,0,30,20
1715611576768,EDS 204R,A01,507319,Halter; Christopher P.,0,3,30,30
1715611576768,EDS 204R,B01,507331,Heinzman; Erica M.,14,0,30,16
1715611577797,EDS 206R,A00,507332,Staff,0,4,30,30
1715611577797,EDS 206R,B00,507343,Staff,15,0,30,15
1715611578825,EDS 250,A00,507344,Hemans; Patricia Ann Benitez,20,0,40,20
1715611579849,EDS 281,A00,507345,Daly; Alan J.,18,0,18,0
1715611580878,EDS 284,A00,507350,Daly; Alan J.,16,0,16,0
1715611581905,EDS 286,A00,507359,Fine; Sarah,18,0,18,0
1715611582931,EDS 289C,A01,507361,Daly; Alan J.,18,0,18,0
1715611583955,EDS 290,A00,507366,Hofstetter; Carolyn,15,0,15,0
1715611584986,LIGM 5A,A00,507421,Fischer-Grunski; Eva K,17,0,20,3
1715611586016,LIGM 5B,A00,507423,Fischer-Grunski; Eva K,19,0,20,1
1715611587046,LIGM 5C,A00,507425,Fischer-Grunski; Eva K,19,0,20,1
1715611588072,LIIT 5AS,A00,507427,Carnelos; Chiara,20,0,20,0
1715611589097,LIIT 5BS,A00,507430,Carnelos; Chiara,20,0,20,0
1715611590122,LIIT 5CS,A00,507432,Carnelos; Chiara,20,0,20,0
1715611591151,LISP 5A,A00,507541,Munoz Sanchez; Alicia,11,0,20,9
1715611592176,LISP 5B,A00,507671,Munoz Sanchez; Alicia,9,0,20,11
1715611593202,LISP 5C,A00,507696,Munoz Sanchez; Alicia,9,0,20,11
1715611594228,MAE 197,001,528363,Boechler; Nicholas Sebastia,9998,0,9999,1
1715611595255,MATH 197,001,523477,Kedlaya; Kiran S.,9994,0,9999,5
1715611595255,MATH 197,002,563811,Zhang; Danna,9994,0,9999,5
1715611595255,MATH 197,003,628552,Dumitriu; Ioana,9998,0,9999,1
1715611595255,MATH 197,004,660885,Floyd; Eric,9999,0,9999,0
1715611596283,MCWP 40R,A00,518780,Staff,2,0,20,18
1715611596283,MCWP 40R,B00,518781,Staff,11,0,20,9
1715611596283,MCWP 40R,C00,518783,Staff,5,0,20,15
1715611597313,MCWP 50R,A00,518791,Staff,0,1,20,20
1715611597313,MCWP 50R,B00,518792,Staff,0,2,20,20
1715611597313,MCWP 50R,C00,518793,Staff,0,4,20,20
1715611597313,MCWP 50R,D00,518794,Staff,0,1,20,20
1715611597313,MCWP 50R,E00,518795,Staff,0,2,20,20
1715611597313,MCWP 50R,F00,518796,Staff,0,1,20,20
1715611597313,MCWP 50R,G00,518797,Staff,0,1,20,20
1715611598337,MMW 12R,A01,514034,Herbst; Matthew,0,2,16,16
1715611598337,MMW 12R,A02,514035,Herbst; Matthew,0,0,16,16
1715611599361,MMW 13R,A01,514037,Staff,0,5,16,16
1715611599361,MMW 13R,A02,514039,Staff,0,5,16,16
1715611599361,MMW 13R,A03,628519,Staff,0,4,16,16
1715611601415,SIO 295LS,A00,523233,Staff,10,0,30,20
1715611602441,SIO 295S,A00,523232,Staff,10,0,30,20
1715611603472,SIOC 290S,A01,637330,Merrifield; Mark A,23,0,30,7
1715611604501,SIOC 291S,A01,637333,Gabriel; Corey John,23,0,30,7
1715611605528,SOCI 117,A01,494376,Staff,0,5,5,5
1715611606556,WES 237B,A00,494380,Staff,10,0,20,10
1715611608616,AESE 279B,A00,494370,Wade; Jon P,0,0,33,33
1715611609640,AIP 97,001,660915,Van Den Einde; Yael Dahlia,9999,0,9999,0
1715611610667,AIP 197,001,627712,Vespa; Emanuel Ignacio,9995,0,9999,4
1715611610667,AIP 197,002,650778,Amir; On,9998,0,9999,1
1715611610667,AIP 197,003,650933,Avenancio-Leon; Carlos,9998,0,9999,1
1715611610667,AIP 197,004,658530,Heyman; Gail D.,9998,0,9999,1
1715611610667,AIP 197,005,658631,Neal; Sonya E,9998,0,9999,1
1715611610667,AIP 197,006,658671,Du; Songzi,9998,0,9999,1
1715611611694,ANAR 135S,A00,494369,Braswell; Geoffrey E.,0,0,0,0
1715611612718,BENG 196,001,628496,Engler; Adam J.,9998,0,9999,1
1715611612718,BENG 196,002,660916,Watson; John Thomas,9999,0,9999,0
1715611613746,BISP 197,001,650773,Wilhelm; James E.,9994,0,9999,5
1715611613746,BISP 197,002,658904,Coleman; Aaron B.,9998,0,9999,1
1715611614770,CAT 124RS,A01,519847,Geibel; William,0,0,20,20
1715611615798,CAT 125RS,A01,515971,Geibel; William,0,0,20,20
1715611616825,CLRE 250,A00,511389,Morris; Sheldon,9992,0,9999,7
1715611617852,CLRE 251,A00,507176,Mehta; Ravindra L.,9992,0,9999,7
1715611617852,CLRE 251,B00,511410,Mehta; Ravindra L.,9998,0,9999,1
1715611618880,CLRE 252,A00,507189,Cuomo; Raphael Eduardo,9994,0,9999,5
1715611619907,CLRE 253,A00,507199,Vaida; Florin,9994,0,9999,5
1715611619907,CLRE 253,B00,507202,Vaida; Florin,9999,0,9999,0
1715611620935,CLRE 259,A00,507211,Patel; Hemal,9996,0,9999,3
1715611621961,CLRE 260,A00,507221,Cuomo; Raphael Eduardo,9999,0,9999,0
1715611622990,CLRE 297,001,507242,Cuomo; Raphael Eduardo,9999,0,9999,0
1715611624014,COGS 197,001,638244,Voytek; Bradley Thomas,9997,0,9999,2
1715611625043,CSE 191,A00,516875,Minnes Kemp; Mor Mia,9991,0,9999,8
1715611626070,CSE 197,001,637388,Minnes Kemp; Mor Mia,9992,0,9999,7
1715611627095,CSS 201S,A01,494383,Mignozzetti; Umberto,35,0,35,0
1715611628120,CSS 202S,A01,494387,Mignozzetti; Umberto,35,0,35,0
1715611629147,DSC 197,001,628532,Eldridge; Justin Matthew,9995,0,9999,4
1715611630173,EAP 100,A00,516065,Staff,9799,0,9999,200
1715611631200,ECE 45,A01,507414,Staff,31,0,60,29
1715611633253,ECE 111,A01,507420,Staff,11,0,50,39
1715611634279,ECE 197,001,548057,Sievenpiper; Daniel F.,9991,0,9999,8
1715611635306,EDS 115,A00,507243,Choi; Bailey Miyeon,7,0,28,21
1715611636333,EDS 117,A01,494379,Staff,0,6,34,34
1715611637362,EDS 125,A00,507246,Hopkins; Megan Beth,8,0,30,22
1715611638390,EDS 128A,A01,507264,Fargason; Sharon Gayle,6,0,26,20
1715611639416,EDS 128B,A01,507293,Pappas; Elizabeth,10,0,30,20
1715611640445,EDS 139,A00,507294,Fargason; Sharon Gayle,10,0,30,20
1715611640445,EDS 139,B00,507313,Pappas; Elizabeth,11,0,30,19
1715611641470,EDS 201,A00,507315,Staff,10,0,30,20
1715611642500,EDS 203,A01,507317,Halter; Christopher P.,10,0,30,20
1715611643526,EDS 204R,A01,507319,Halter; Christopher P.,0,3,30,30
1715611643526,EDS 204R,B01,507331,Heinzman; Erica M.,14,0,30,16
1715611644551,EDS 206R,A00,507332,Staff,0,4,30,30
1715611644551,EDS 206R,B00,507343,Staff,15,0,30,15
1715611645579,EDS 250,A00,507344,Hemans; Patricia Ann Benitez,20,0,40,20
1715611646605,EDS 281,A00,507345,Daly; Alan J.,18,0,18,0
1715611647635,EDS 284,A00,507350,Daly; Alan J.,16,0,16,0
1715611648659,EDS 286,A00,507359,Fine; Sarah,18,0,18,0
1715611649687,EDS 289C,A01,507361,Daly; Alan J.,18,0,18,0
1715611650712,EDS 290,A00,507366,Hofstetter; Carolyn,15,0,15,0
1715611651743,LIGM 5A,A00,507421,Fischer-Grunski; Eva K,17,0,20,3
1715611652769,LIGM 5B,A00,507423,Fischer-Grunski; Eva K,19,0,20,1
1715611653799,LIGM 5C,A00,507425,Fischer-Grunski; Eva K,19,0,20,1
1715611654828,LIIT 5AS,A00,507427,Carnelos; Chiara,20,0,20,0
1715611655859,LIIT 5BS,A00,507430,Carnelos; Chiara,20,0,20,0
1715611656885,LIIT 5CS,A00,507432,Carnelos; Chiara,20,0,20,0
1715611657914,LISP 5A,A00,507541,Munoz Sanchez; Alicia,11,0,20,9
1715611658939,LISP 5B,A00,507671,Munoz Sanchez; Alicia,9,0,20,11
1715611659966,LISP 5C,A00,507696,Munoz Sanchez; Alicia,9,0,20,11
1715611660992,MAE 197,001,528363,Boechler; Nicholas Sebastia,9998,0,9999,1
1715611662020,MATH 197,001,523477,Kedlaya; Kiran S.,9994,0,9999,5
1715611662020,MATH 197,002,563811,Zhang; Danna,9994,0,9999,5
1715611662020,MATH 197,003,628552,Dumitriu; Ioana,9998,0,9999,1
1715611662020,MATH 197,004,660885,Floyd; Eric,9999,0,9999,0
1715611663047,MCWP 40R,A00,518780,Staff,2,0,20,18
1715611663047,MCWP 40R,B00,518781,Staff,11,0,20,9
1715611663047,MCWP 40R,C00,518783,Staff,5,0,20,15
1715611664075,MCWP 50R,A00,518791,Staff,0,1,20,20
1715611664075,MCWP 50R,B00,518792,Staff,0,2,20,20
1715611664075,MCWP 50R,C00,518793,Staff,0,4,20,20
1715611664075,MCWP 50R,D00,518794,Staff,0,1,20,20
1715611664075,MCWP 50R,E00,518795,Staff,0,2,20,20
1715611664075,MCWP 50R,F00,518796,Staff,0,1,20,20
1715611664075,MCWP 50R,G00,518797,Staff,0,1,20,20
1715611665105,MMW 12R,A01,514034,Herbst; Matthew,0,2,16,16
1715611665105,MMW 12R,A02,514035,Herbst; Matthew,0,0,16,16
1715611666132,MMW 13R,A01,514037,Staff,0,5,16,16
1715611666132,MMW 13R,A02,514039,Staff,0,5,16,16
1715611666132,MMW 13R,A03,628519,Staff,0,4,16,16
1715611668183,SIO 295LS,A00,523233,Staff,10,0,30,20
1715611669207,SIO 295S,A00,523232,Staff,10,0,30,20
1715611670234,SIOC 290S,A01,637330,Merrifield; Mark A,23,0,30,7
1715611671264,SIOC 291S,A01,637333,Gabriel; Corey John,23,0,30,7
1715611672293,SOCI 117,A01,494376,Staff,0,5,5,5
1715611673322,WES 237B,A00,494380,Staff,10,0,20,10
1715611675396,AESE 279B,A00,494370,Wade; Jon P,0,0,33,33
1715611676425,AIP 97,001,660915,Van Den Einde; Yael Dahlia,9999,0,9999,0
1715611677452,AIP 197,001,627712,Vespa; Emanuel Ignacio,9995,0,9999,4
1715611677452,AIP 197,002,650778,Amir; On,9998,0,9999,1
1715611677452,AIP 197,003,650933,Avenancio-Leon; Carlos,9998,0,9999,1
1715611677452,AIP 197,004,658530,Heyman; Gail D.,9998,0,9999,1
1715611677452,AIP 197,005,658631,Neal; Sonya E,9998,0,9999,1
1715611677452,AIP 197,006,658671,Du; Songzi,9998,0,9999,1
1715611678479,ANAR 135S,A00,494369,Braswell; Geoffrey E.,0,0,0,0
1715611679505,BENG 196,001,628496,Engler; Adam J.,9998,0,9999,1
1715611679505,BENG 196,002,660916,Watson; John Thomas,9999,0,9999,0
1715611680530,BISP 197,001,650773,Wilhelm; James E.,9994,0,9999,5
1715611680530,BISP 197,002,658904,Coleman; Aaron B.,9998,0,9999,1
1715611681559,CAT 124RS,A01,519847,Geibel; William,0,0,20,20
1715611682584,CAT 125RS,A01,515971,Geibel; William,0,0,20,20
1715611683612,CLRE 250,A00,511389,Morris; Sheldon,9992,0,9999,7
1715611684636,CLRE 251,A00,507176,Mehta; Ravindra L.,9992,0,9999,7
1715611684636,CLRE 251,B00,511410,Mehta; Ravindra L.,9998,0,9999,1
1715611685662,CLRE 252,A00,507189,Cuomo; Raphael Eduardo,9994,0,9999,5
1715611686686,CLRE 253,A00,507199,Vaida; Florin,9994,0,9999,5
1715611686686,CLRE 253,B00,507202,Vaida; Florin,9999,0,9999,0
1715611687714,CLRE 259,A00,507211,Patel; Hemal,9996,0,9999,3
1715611688739,CLRE 260,A00,507221,Cuomo; Raphael Eduardo,9999,0,9999,0
1715611689767,CLRE 297,001,507242,Cuomo; Raphael Eduardo,9999,0,9999,0
1715611690793,COGS 197,001,638244,Voytek; Bradley Thomas,9997,0,9999,2
1715611691823,CSE 191,A00,516875,Minnes Kemp; Mor Mia,9991,0,9999,8
1715611692851,CSE 197,001,637388,Minnes Kemp; Mor Mia,9992,0,9999,7
1715611693879,CSS 201S,A01,494383,Mignozzetti; Umberto,35,0,35,0
1715611694909,CSS 202S,A01,494387,Mignozzetti; Umberto,35,0,35,0
1715611695938,DSC 197,001,628532,Eldridge; Justin Matthew,9995,0,9999,4
1715611696965,EAP 100,A00,516065,Staff,9799,0,9999,200
1715611697993,ECE 45,A01,507414,Staff,31,0,60,29
1715611700049,ECE 111,A01,507420,Staff,11,0,50,39
1715611701075,ECE 197,001,548057,Sievenpiper; Daniel F.,9991,0,9999,8
1715611702105,EDS 115,A00,507243,Choi; Bailey Miyeon,7,0,28,21
1715611703134,EDS 117,A01,494379,Staff,0,6,34,34
1715611704162,EDS 125,A00,507246,Hopkins; Megan Beth,8,0,30,22
1715611705191,EDS 128A,A01,507264,Fargason; Sharon Gayle,6,0,26,20
1715611706218,EDS 128B,A01,507293,Pappas; Elizabeth,10,0,30,20
1715611707246,EDS 139,A00,507294,Fargason; Sharon Gayle,10,0,30,20
1715611707246,EDS 139,B00,507313,Pappas; Elizabeth,11,0,30,19
1715611708276,EDS 201,A00,507315,Staff,10,0,30,20
1715611709302,EDS 203,A01,507317,Halter; Christopher P.,10,0,30,20
1715611710330,EDS 204R,A01,507319,Halter; Christopher P.,0,3,30,30
1715611710330,EDS 204R,B01,507331,Heinzman; Erica M.,14,0,30,16
1715611711357,EDS 206R,A00,507332,Staff,0,4,30,30
1715611711357,EDS 206R,B00,507343,Staff,15,0,30,15
1715611712384,EDS 250,A00,507344,Hemans; Patricia Ann Benitez,20,0,40,20
1715611713409,EDS 281,A00,507345,Daly; Alan J.,18,0,18,0
1715611714437,EDS 284,A00,507350,Daly; Alan J.,16,0,16,0
1715611715463,EDS 286,A00,507359,Fine; Sarah,18,0,18,0
1715611716492,EDS 289C,A01,507361,Daly; Alan J.,18,0,18,0
1715611717517,EDS 290,A00,507366,Hofstetter; Carolyn,15,0,15,0
1715611718545,LIGM 5A,A00,507421,Fischer-Grunski; Eva K,17,0,20,3
1715611719571,LIGM 5B,A00,507423,Fischer-Grunski; Eva K,19,0,20,1
1715611720597,LIGM 5C,A00,507425,Fischer-Grunski; Eva K,19,0,20,1
1715611721623,LIIT 5AS,A00,507427,Carnelos; Chiara,20,0,20,0
1715611722658,LIIT 5BS,A00,507430,Carnelos; Chiara,20,0,20,0
1715611723685,LIIT 5CS,A00,507432,Carnelos; Chiara,20,0,20,0
1715611724710,LISP 5A,A00,507541,Munoz Sanchez; Alicia,11,0,20,9
1715611725744,LISP 5B,A00,507671,Munoz Sanchez; Alicia,9,0,20,11
1715611726782,LISP 5C,A00,507696,Munoz Sanchez; Alicia,9,0,20,11
1715611727808,MAE 197,001,528363,Boechler; Nicholas Sebastia,9998,0,9999,1
1715611728836,MATH 197,001,523477,Kedlaya; Kiran S.,9994,0,9999,5
1715611728836,MATH 197,002,563811,Zhang; Danna,9994,0,9999,5
1715611728836,MATH 197,003,628552,Dumitriu; Ioana,9998,0,9999,1
1715611728836,MATH 197,004,660885,Floyd; Eric,9999,0,9999,0
1715611729861,MCWP 40R,A00,518780,Staff,2,0,20,18
1715611729861,MCWP 40R,B00,518781,Staff,11,0,20,9
1715611729861,MCWP 40R,C00,518783,Staff,5,0,20,15
1715611730889,MCWP 50R,A00,518791,Staff,0,1,20,20
1715611730889,MCWP 50R,B00,518792,Staff,0,2,20,20
1715611730889,MCWP 50R,C00,518793,Staff,0,4,20,20
1715611730889,MCWP 50R,D00,518794,Staff,0,1,20,20
1715611730889,MCWP 50R,E00,518795,Staff,0,2,20,20
1715611730889,MCWP 50R,F00,518796,Staff,0,1,20,20
1715611730889,MCWP 50R,G00,518797,Staff,0,1,20,20
1715611731913,MMW 12R,A01,514034,Herbst; Matthew,0,2,16,16
1715611731913,MMW 12R,A02,514035,Herbst; Matthew,0,0,16,16
1715611736067,MMW 13R,A01,514037,Staff,0,5,16,16
1715611736067,MMW 13R,A02,514039,Staff,0,5,16,16
1715611736067,MMW 13R,A03,628519,Staff,0,4,16,16
1715611738119,SIO 295LS,A00,523233,Staff,10,0,30,20
1715611739146,SIO 295S,A00,523232,Staff,10,0,30,20
1715611740174,SIOC 290S,A01,637330,Merrifield; Mark A,23,0,30,7
1715611741204,SIOC 291S,A01,637333,Gabriel; Corey John,23,0,30,7
1715611742231,SOCI 117,A01,494376,Staff,0,5,5,5
1715611743262,WES 237B,A00,494380,Staff,10,0,20,10
1715611745324,AESE 279B,A00,494370,Wade; Jon P,0,0,33,33
1715611746352,AIP 97,001,660915,Van Den Einde; Yael Dahlia,9999,0,9999,0
1715611747385,AIP 197,001,627712,Vespa; Emanuel Ignacio,9995,0,9999,4
1715611747385,AIP 197,002,650778,Amir; On,9998,0,9999,1
1715611747385,AIP 197,003,650933,Avenancio-Leon; Carlos,9998,0,9999,1
1715611747385,AIP 197,004,658530,Heyman; Gail D.,9998,0,9999,1
1715611747385,AIP 197,005,658631,Neal; Sonya E,9998,0,9999,1
1715611747385,AIP 197,006,658671,Du; Songzi,9998,0,9999,1
1715611748412,ANAR 135S,A00,494369,Braswell; Geoffrey E.,0,0,0,0
1715611749441,BENG 196,001,628496,Engler; Adam J.,9998,0,9999,1
1715611749441,BENG 196,002,660916,Watson; John Thomas,9999,0,9999,0
1715611750468,BISP 197,001,650773,Wilhelm; James E.,9994,0,9999,5
1715611750468,BISP 197,002,658904,Coleman; Aaron B.,9998,0,9999,1
1715611751494,CAT 124RS,A01,519847,Geibel; William,0,0,20,20
1715611752520,CAT 125RS,A01,515971,Geibel; William,0,0,20,20
1715611753548,CLRE 250,A00,511389,Morris; Sheldon,9992,0,9999,7
1715611754576,CLRE 251,A00,507176,Mehta; Ravindra L.,9992,0,9999,7
1715611754576,CLRE 251,B00,511410,Mehta; Ravindra L.,9998,0,9999,1
1715611755602,CLRE 252,A00,507189,Cuomo; Raphael Eduardo,9994,0,9999,5
1715611756628,CLRE 253,A00,507199,Vaida; Florin,9994,0,9999,5
1715611756628,CLRE 253,B00,507202,Vaida; Florin,9999,0,9999,0
1715611757653,CLRE 259,A00,507211,Patel; Hemal,9996,0,9999,3
1715611758679,CLRE 260,A00,507221,Cuomo; Raphael Eduardo,9999,0,9999,0
1715611759708,CLRE 297,001,507242,Cuomo; Raphael Eduardo,9999,0,9999,0
1715611760734,COGS 197,001,638244,Voytek; Bradley Thomas,9997,0,9999,2
1715611761762,CSE 191,A00,516875,Minnes Kemp; Mor Mia,9991,0,9999,8
1715611762786,CSE 197,001,637388,Minnes Kemp; Mor Mia,9992,0,9999,7
1715611763818,CSS 201S,A01,494383,Mignozzetti; Umberto,35,0,35,0
1715611764847,CSS 202S,A01,494387,Mignozzetti; Umberto,35,0,35,0
1715611765872,DSC 197,001,628532,Eldridge; Justin Matthew,9995,0,9999,4
1715611766899,EAP 100,A00,516065,Staff,9799,0,9999,200
1715611767926,ECE 45,A01,507414,Staff,31,0,60,29
1715611769981,ECE 111,A01,507420,Staff,11,0,50,39
1715611771007,ECE 197,001,548057,Sievenpiper; Daniel F.,9991,0,9999,8
1715611772034,EDS 115,A00,507243,Choi; Bailey Miyeon,7,0,28,21
1715611773060,EDS 117,A01,494379,Staff,0,6,34,34
1715611774087,EDS 125,A00,507246,Hopkins; Megan Beth,8,0,30,22
1715611775112,EDS 128A,A01,507264,Fargason; Sharon Gayle,6,0,26,20
1715611776139,EDS 128B,A01,507293,Pappas; Elizabeth,10,0,30,20
1715611777166,EDS 139,A00,507294,Fargason; Sharon Gayle,10,0,30,20
1715611777166,EDS 139,B00,507313,Pappas; Elizabeth,11,0,30,19
1715611778191,EDS 201,A00,507315,Staff,10,0,30,20
1715611779216,EDS 203,A01,507317,Halter; Christopher P.,10,0,30,20
1715611780247,EDS 204R,A01,507319,Halter; Christopher P.,0,3,30,30
1715611780247,EDS 204R,B01,507331,Heinzman; Erica M.,14,0,30,16
1715611781275,EDS 206R,A00,507332,Staff,0,4,30,30
1715611781275,EDS 206R,B00,507343,Staff,15,0,30,15
1715611782304,EDS 250,A00,507344,Hemans; Patricia Ann Benitez,20,0,40,20
1715611783331,EDS 281,A00,507345,Daly; Alan J.,18,0,18,0
1715611784361,EDS 284,A00,507350,Daly; Alan J.,16,0,16,0
1715611785422,EDS 286,A00,507359,Fine; Sarah,18,0,18,0
1715611786454,EDS 289C,A01,507361,Daly; Alan J.,18,0,18,0
1715611787483,EDS 290,A00,507366,Hofstetter; Carolyn,15,0,15,0
1715611788514,LIGM 5A,A00,507421,Fischer-Grunski; Eva K,17,0,20,3
1715611789542,LIGM 5B,A00,507423,Fischer-Grunski; Eva K,19,0,20,1
1715611790572,LIGM 5C,A00,507425,Fischer-Grunski; Eva K,19,0,20,1
1715611791596,LIIT 5AS,A00,507427,Carnelos; Chiara,20,0,20,0
1715611792625,LIIT 5BS,A00,507430,Carnelos; Chiara,20,0,20,0
1715611793654,LIIT 5CS,A00,507432,Carnelos; Chiara,20,0,20,0
1715611794680,LISP 5A,A00,507541,Munoz Sanchez; Alicia,11,0,20,9
1715611795705,LISP 5B,A00,507671,Munoz Sanchez; Alicia,9,0,20,11
1715611796736,LISP 5C,A00,507696,Munoz Sanchez; Alicia,9,0,20,11
1715611797764,MAE 197,001,528363,Boechler; Nicholas Sebastia,9998,0,9999,1
1715611798790,MATH 197,001,523477,Kedlaya; Kiran S.,9994,0,9999,5
1715611798790,MATH 197,002,563811,Zhang; Danna,9994,0,9999,5
1715611798790,MATH 197,003,628552,Dumitriu; Ioana,9998,0,9999,1
1715611798790,MATH 197,004,660885,Floyd; Eric,9999,0,9999,0
1715611799819,MCWP 40R,A00,518780,Staff,2,0,20,18
1715611799819,MCWP 40R,B00,518781,Staff,11,0,20,9
1715611799819,MCWP 40R,C00,518783,Staff,5,0,20,15
1715611800850,MCWP 50R,A00,518791,Staff,0,1,20,20
1715611800850,MCWP 50R,B00,518792,Staff,0,2,20,20
1715611800850,MCWP 50R,C00,518793,Staff,0,4,20,20
1715611800850,MCWP 50R,D00,518794,Staff,0,1,20,20
1715611800850,MCWP 50R,E00,518795,Staff,0,2,20,20
1715611800850,MCWP 50R,F00,518796,Staff,0,1,20,20
1715611800850,MCWP 50R,G00,518797,Staff,0,1,20,20
1715611801879,MMW 12R,A01,514034,Herbst; Matthew,0,2,16,16
1715611801879,MMW 12R,A02,514035,Herbst; Matthew,0,0,16,16
1715611802905,MMW 13R,A01,514037,Staff,0,5,16,16
1715611802905,MMW 13R,A02,514039,Staff,0,5,16,16
1715611802905,MMW 13R,A03,628519,Staff,0,4,16,16
1715611804959,SIO 295LS,A00,523233,Staff,10,0,30,20
1715611805985,SIO 295S,A00,523232,Staff,10,0,30,20
1715611807012,SIOC 290S,A01,637330,Merrifield; Mark A,23,0,30,7
1715611808039,SIOC 291S,A01,637333,Gabriel; Corey John,23,0,30,7
1715611809064,SOCI 117,A01,494376,Staff,0,5,5,5
1715611810092,WES 237B,A00,494380,Staff,10,0,20,10
1715611812172,AESE 279B,A00,494370,Wade; Jon P,0,0,33,33
1715611813201,AIP 97,001,660915,Van Den Einde; Yael Dahlia,9999,0,9999,0
1715611814226,AIP 197,001,627712,Vespa; Emanuel Ignacio,9995,0,9999,4
1715611814226,AIP 197,002,650778,Amir; On,9998,0,9999,1
1715611814226,AIP 197,003,650933,Avenancio-Leon; Carlos,9998,0,9999,1
1715611814226,AIP 197,004,658530,Heyman; Gail D.,9998,0,9999,1
1715611814226,AIP 197,005,658631,Neal; Sonya E,9998,0,9999,1
1715611814226,AIP 197,006,658671,Du; Songzi,9998,0,9999,1
1715611815256,ANAR 135S,A00,494369,Braswell; Geoffrey E.,0,0,0,0
1715611816282,BENG 196,001,628496,Engler; Adam J.,9998,0,9999,1
1715611816282,BENG 196,002,660916,Watson; John Thomas,9999,0,9999,0
1715611817310,BISP 197,001,650773,Wilhelm; James E.,9994,0,9999,5
1715611817310,BISP 197,002,658904,Coleman; Aaron B.,9998,0,9999,1
1715611818336,CAT 124RS,A01,519847,Geibel; William,0,0,20,20
1715611819364,CAT 125RS,A01,515971,Geibel; William,0,0,20,20
1715611820392,CLRE 250,A00,511389,Morris; Sheldon,9992,0,9999,7
1715611821423,CLRE 251,A00,507176,Mehta; Ravindra L.,9992,0,9999,7
1715611821423,CLRE 251,B00,511410,Mehta; Ravindra L.,9998,0,9999,1
1715611822451,CLRE 252,A00,507189,Cuomo; Raphael Eduardo,9994,0,9999,5
1715611823476,CLRE 253,A00,507199,Vaida; Florin,9994,0,9999,5
1715611823476,CLRE 253,B00,507202,Vaida; Florin,9999,0,9999,0
1715611824503,CLRE 259,A00,507211,Patel; Hemal,9996,0,9999,3
1715611825531,CLRE 260,A00,507221,Cuomo; Raphael Eduardo,9999,0,9999,0
1715611826560,CLRE 297,001,507242,Cuomo; Raphael Eduardo,9999,0,9999,0
1715611827588,COGS 197,001,638244,Voytek; Bradley Thomas,9997,0,9999,2
1715611828615,CSE 191,A00,516875,Minnes Kemp; Mor Mia,9991,0,9999,8
1715611829643,CSE 197,001,637388,Minnes Kemp; Mor Mia,9992,0,9999,7
1715611830674,CSS 201S,A01,494383,Mignozzetti; Umberto,35,0,35,0
1715611831701,CSS 202S,A01,494387,Mignozzetti; Umberto,35,0,35,0
1715611832727,DSC 197,001,628532,Eldridge; Justin Matthew,9995,0,9999,4
1715611833752,EAP 100,A00,516065,Staff,9799,0,9999,200
1715611834780,ECE 45,A01,507414,Staff,31,0,60,29
1715611836833,ECE 111,A01,507420,Staff,11,0,50,39
1715611837860,ECE 197,001,548057,Sievenpiper; Daniel F.,9991,0,9999,8
1715611838890,EDS 115,A00,507243,Choi; Bailey Miyeon,7,0,28,21
1715611839920,EDS 117,A01,494379,Staff,0,6,34,34
1715611840948,EDS 125,A00,507246,Hopkins; Megan Beth,8,0,30,22
1715611841979,EDS 128A,A01,507264,Fargason; Sharon Gayle,6,0,26,20
1715611843009,EDS 128B,A01,507293,Pappas; Elizabeth,10,0,30,20
1715611844034,EDS 139,A00,507294,Fargason; Sharon Gayle,10,0,30,20
1715611844034,EDS 139,B00,507313,Pappas; Elizabeth,11,0,30,19
1715611845063,EDS 201,A00,507315,Staff,10,0,30,20
1715611846092,EDS 203,A01,507317,Halter; Christopher P.,10,0,30,20
1715611847119,EDS 204R,A01,507319,Halter; Christopher P.,0,3,30,30
1715611847119,EDS 204R,B01,507331,Heinzman; Erica M.,14,0,30,16
1715611848146,EDS 206R,A00,507332,Staff,0,4,30,30
1715611848146,EDS 206R,B00,507343,Staff,15,0,30,15
1715611849172,EDS 250,A00,507344,Hemans; Patricia Ann Benitez,20,0,40,20
1715611850198,EDS 281,A00,507345,Daly; Alan J.,18,0,18,0
1715611851223,EDS 284,A00,507350,Daly; Alan J.,16,0,16,0
1715611852250,EDS 286,A00,507359,Fine; Sarah,18,0,18,0
1715611853275,EDS 289C,A01,507361,Daly; Alan J.,18,0,18,0
1715611854299,EDS 290,A00,507366,Hofstetter; Carolyn,15,0,15,0
1715611855326,LIGM 5A,A00,507421,Fischer-Grunski; Eva K,17,0,20,3
1715611856350,LIGM 5B,A00,507423,Fischer-Grunski; Eva K,19,0,20,1
1715611857380,LIGM 5C,A00,507425,Fischer-Grunski; Eva K,19,0,20,1
1715611858405,LIIT 5AS,A00,507427,Carnelos; Chiara,20,0,20,0
1715611859434,LIIT 5BS,A00,507430,Carnelos; Chiara,20,0,20,0
1715611860460,LIIT 5CS,A00,507432,Carnelos; Chiara,20,0,20,0
1715611861489,LISP 5A,A00,507541,Munoz Sanchez; Alicia,11,0,20,9
1715611862517,LISP 5B,A00,507671,Munoz Sanchez; Alicia,9,0,20,11
1715611863544,LISP 5C,A00,507696,Munoz Sanchez; Alicia,9,0,20,11
1715611864570,MAE 197,001,528363,Boechler; Nicholas Sebastia,9998,0,9999,1
1715611865597,MATH 197,001,523477,Kedlaya; Kiran S.,9994,0,9999,5
1715611865597,MATH 197,002,563811,Zhang; Danna,9994,0,9999,5
1715611865597,MATH 197,003,628552,Dumitriu; Ioana,9998,0,9999,1
1715611865597,MATH 197,004,660885,Floyd; Eric,9999,0,9999,0
1715611866625,MCWP 40R,A00,518780,Staff,2,0,20,18
1715611866625,MCWP 40R,B00,518781,Staff,11,0,20,9
1715611866625,MCWP 40R,C00,518783,Staff,5,0,20,15
1715611867651,MCWP 50R,A00,518791,Staff,0,1,20,20
1715611867651,MCWP 50R,B00,518792,Staff,0,2,20,20
1715611867651,MCWP 50R,C00,518793,Staff,0,4,20,20
1715611867651,MCWP 50R,D00,518794,Staff,0,1,20,20
1715611867651,MCWP 50R,E00,518795,Staff,0,2,20,20
1715611867651,MCWP 50R,F00,518796,Staff,0,1,20,20
1715611867651,MCWP 50R,G00,518797,Staff,0,1,20,20
1715611868677,MMW 12R,A01,514034,Herbst; Matthew,0,2,16,16
1715611868677,MMW 12R,A02,514035,Herbst; Matthew,0,0,16,16
1715611869703,MMW 13R,A01,514037,Staff,0,5,16,16
1715611869703,MMW 13R,A02,514039,Staff,0,5,16,16
1715611869703,MMW 13R,A03,628519,Staff,0,4,16,16
1715611871757,SIO 295LS,A00,523233,Staff,10,0,30,20
1715611872782,SIO 295S,A00,523232,Staff,10,0,30,20
1715611873811,SIOC 290S,A01,637330,Merrifield; Mark A,23,0,30,7
1715611874840,SIOC 291S,A01,637333,Gabriel; Corey John,23,0,30,7
1715611875867,SOCI 117,A01,494376,Staff,0,5,5,5
1715611876895,WES 237B,A00,494380,Staff,10,0,20,10
1715611878964,AESE 279B,A00,494370,Wade; Jon P,0,0,33,33
1715611879990,AIP 97,001,660915,Van Den Einde; Yael Dahlia,9999,0,9999,0
1715611881017,AIP 197,001,627712,Vespa; Emanuel Ignacio,9995,0,9999,4
1715611881017,AIP 197,002,650778,Amir; On,9998,0,9999,1
1715611881017,AIP 197,003,650933,Avenancio-Leon; Carlos,9998,0,9999,1
1715611881017,AIP 197,004,658530,Heyman; Gail D.,9998,0,9999,1
1715611881017,AIP 197,005,658631,Neal; Sonya E,9998,0,9999,1
1715611881017,AIP 197,006,658671,Du; Songzi,9998,0,9999,1
1715611882042,ANAR 135S,A00,494369,Braswell; Geoffrey E.,0,0,0,0
1715611883068,BENG 196,001,628496,Engler; Adam J.,9998,0,9999,1
1715611883068,BENG 196,002,660916,Watson; John Thomas,9999,0,9999,0
1715611884094,BISP 197,001,650773,Wilhelm; James E.,9994,0,9999,5
1715611884094,BISP 197,002,658904,Coleman; Aaron B.,9998,0,9999,1
1715611885127,CAT 124RS,A01,519847,Geibel; William,0,0,20,20
1715611886152,CAT 125RS,A01,515971,Geibel; William,0,0,20,20
1715611887177,CLRE 250,A00,511389,Morris; Sheldon,9992,0,9999,7
1715611888209,CLRE 251,A00,507176,Mehta; Ravindra L.,9992,0,9999,7
1715611888209,CLRE 251,B00,511410,Mehta; Ravindra L.,9998,0,9999,1
1715611889234,CLRE 252,A00,507189,Cuomo; Raphael Eduardo,9994,0,9999,5
1715611890263,CLRE 253,A00,507199,Vaida; Florin,9994,0,9999,5
1715611890263,CLRE 253,B00,507202,Vaida; Florin,9999,0,9999,0
1715611891290,CLRE 259,A00,507211,Patel; Hemal,9996,0,9999,3
1715611892316,CLRE 260,A00,507221,Cuomo; Raphael Eduardo,9999,0,9999,0
1715611893343,CLRE 297,001,507242,Cuomo; Raphael Eduardo,9999,0,9999,0
1715611894370,COGS 197,001,638244,Voytek; Bradley Thomas,9997,0,9999,2
1715611895395,CSE 191,A00,516875,Minnes Kemp; Mor Mia,9991,0,9999,8
1715611896419,CSE 197,001,637388,Minnes Kemp; Mor Mia,9992,0,9999,7
1715611897450,CSS 201S,A01,494383,Mignozzetti; Umberto,35,0,35,0
1715611898479,CSS 202S,A01,494387,Mignozzetti; Umberto,35,0,35,0
1715611899505,DSC 197,001,628532,Eldridge; Justin Matthew,9995,0,9999,4
1715611900531,EAP 100,A00,516065,Staff,9799,0,9999,200
1715611901559,ECE 45,A01,507414,Staff,31,0,60,29
1715611903616,ECE 111,A01,507420,Staff,11,0,50,39
1715611904643,ECE 197,001,548057,Sievenpiper; Daniel F.,9991,0,9999,8
1715611905668,EDS 115,A00,507243,Choi; Bailey Miyeon,7,0,28,21
1715611906695,EDS 117,A01,494379,Staff,0,6,34,34
1715611907721,EDS 125,A00,507246,Hopkins; Megan Beth,8,0,30,22
1715611908745,EDS 128A,A01,507264,Fargason; Sharon Gayle,6,0,26,20
1715611909771,EDS 128B,A01,507293,Pappas; Elizabeth,10,0,30,20
1715611910799,EDS 139,A00,507294,Fargason; Sharon Gayle,10,0,30,20
1715611910799,EDS 139,B00,507313,Pappas; Elizabeth,11,0,30,19
1715611911828,EDS 201,A00,507315,Staff,10,0,30,20
1715611912854,EDS 203,A01,507317,Halter; Christopher P.,10,0,30,20
1715611913884,EDS 204R,A01,507319,Halter; Christopher P.,0,3,30,30
1715611913884,EDS 204R,B01,507331,Heinzman; Erica M.,14,0,30,16
1715611914912,EDS 206R,A00,507332,Staff,0,4,30,30
1715611914912,EDS 206R,B00,507343,Staff,15,0,30,15
1715611915940,EDS 250,A00,507344,Hemans; Patricia Ann Benitez,20,0,40,20
1715611916965,EDS 281,A00,507345,Daly; Alan J.,18,0,18,0
1715611917994,EDS 284,A00,507350,Daly; Alan J.,16,0,16,0
1715611919024,EDS 286,A00,507359,Fine; Sarah,18,0,18,0
1715611920051,EDS 289C,A01,507361,Daly; Alan J.,18,0,18,0
1715611921078,EDS 290,A00,507366,Hofstetter; Carolyn,15,0,15,0
1715611922102,LIGM 5A,A00,507421,Fischer-Grunski; Eva K,17,0,20,3
1715611923126,LIGM 5B,A00,507423,Fischer-Grunski; Eva K,19,0,20,1
1715611924156,LIGM 5C,A00,507425,Fischer-Grunski; Eva K,19,0,20,1
1715611925186,LIIT 5AS,A00,507427,Carnelos; Chiara,20,0,20,0
1715611926214,LIIT 5BS,A00,507430,Carnelos; Chiara,20,0,20,0
1715611927241,LIIT 5CS,A00,507432,Carnelos; Chiara,20,0,20,0
1715611928266,LISP 5A,A00,507541,Munoz Sanchez; Alicia,11,0,20,9
1715611929293,LISP 5B,A00,507671,Munoz Sanchez; Alicia,9,0,20,11
1715611930319,LISP 5C,A00,507696,Munoz Sanchez; Alicia,9,0,20,11
1715611931345,MAE 197,001,528363,Boechler; Nicholas Sebastia,9998,0,9999,1
1715611932374,MATH 197,001,523477,Kedlaya; Kiran S.,9994,0,9999,5
1715611932374,MATH 197,002,563811,Zhang; Danna,9994,0,9999,5
1715611932374,MATH 197,003,628552,Dumitriu; Ioana,9998,0,9999,1
1715611932374,MATH 197,004,660885,Floyd; Eric,9999,0,9999,0
1715611933400,MCWP 40R,A00,518780,Staff,2,0,20,18
1715611933400,MCWP 40R,B00,518781,Staff,11,0,20,9
1715611933400,MCWP 40R,C00,518783,Staff,5,0,20,15
1715611934426,MCWP 50R,A00,518791,Staff,0,1,20,20
1715611934426,MCWP 50R,B00,518792,Staff,0,2,20,20
1715611934426,MCWP 50R,C00,518793,Staff,0,4,20,20
1715611934426,MCWP 50R,D00,518794,Staff,0,1,20,20
1715611934426,MCWP 50R,E00,518795,Staff,0,2,20,20
1715611934426,MCWP 50R,F00,518796,Staff,0,1,20,20
1715611934426,MCWP 50R,G00,518797,Staff,0,1,20,20
1715611935451,MMW 12R,A01,514034,Herbst; Matthew,0,2,16,16
1715611935451,MMW 12R,A02,514035,Herbst; Matthew,0,0,16,16
1715611936477,MMW 13R,A01,514037,Staff,0,5,16,16
1715611936477,MMW 13R,A02,514039,Staff,0,5,16,16
1715611936477,MMW 13R,A03,628519,Staff,0,4,16,16
1715611938530,SIO 295LS,A00,523233,Staff,10,0,30,20
1715611939555,SIO 295S,A00,523232,Staff,10,0,30,20
1715611940585,SIOC 290S,A01,637330,Merrifield; Mark A,23,0,30,7
1715611941611,SIOC 291S,A01,637333,Gabriel; Corey John,23,0,30,7
1715611942637,SOCI 117,A01,494376,Staff,0,5,5,5
1715611943663,WES 237B,A00,494380,Staff,10,0,20,10
1715611945723,AESE 279B,A00,494370,Wade; Jon P,0,0,33,33
1715611946749,AIP 97,001,660915,Van Den Einde; Yael Dahlia,9999,0,9999,0
1715611947777,AIP 197,001,627712,Vespa; Emanuel Ignacio,9995,0,9999,4
1715611947777,AIP 197,002,650778,Amir; On,9998,0,9999,1
1715611947777,AIP 197,003,650933,Avenancio-Leon; Carlos,9998,0,9999,1
1715611947777,AIP 197,004,658530,Heyman; Gail D.,9998,0,9999,1
1715611947777,AIP 197,005,658631,Neal; Sonya E,9998,0,9999,1
1715611947777,AIP 197,006,658671,Du; Songzi,9998,0,9999,1
1715611948802,ANAR 135S,A00,494369,Braswell; Geoffrey E.,0,0,0,0
1715611949886,BENG 196,001,628496,Engler; Adam J.,9998,0,9999,1
1715611949886,BENG 196,002,660916,Watson; John Thomas,9999,0,9999,0
1715611950913,BISP 197,001,650773,Wilhelm; James E.,9994,0,9999,5
1715611950913,BISP 197,002,658904,Coleman; Aaron B.,9998,0,9999,1
1715611951938,CAT 124RS,A01,519847,Geibel; William,0,0,20,20
1715611952967,CAT 125RS,A01,515971,Geibel; William,0,0,20,20
1715611953995,CLRE 250,A00,511389,Morris; Sheldon,9992,0,9999,7
1715611955021,CLRE 251,A00,507176,Mehta; Ravindra L.,9992,0,9999,7
1715611955021,CLRE 251,B00,511410,Mehta; Ravindra L.,9998,0,9999,1
1715611956047,CLRE 252,A00,507189,Cuomo; Raphael Eduardo,9994,0,9999,5
1715611957077,CLRE 253,A00,507199,Vaida; Florin,9994,0,9999,5
1715611957077,CLRE 253,B00,507202,Vaida; Florin,9999,0,9999,0
1715611958103,CLRE 259,A00,507211,Patel; Hemal,9996,0,9999,3
1715611959129,CLRE 260,A00,507221,Cuomo; Raphael Eduardo,9999,0,9999,0
1715611960158,CLRE 297,001,507242,Cuomo; Raphael Eduardo,9999,0,9999,0
1715611961183,COGS 197,001,638244,Voytek; Bradley Thomas,9997,0,9999,2
1715611962213,CSE 191,A00,516875,Minnes Kemp; Mor Mia,9991,0,9999,8
1715611963238,CSE 197,001,637388,Minnes Kemp; Mor Mia,9992,0,9999,7
1715611964265,CSS 201S,A01,494383,Mignozzetti; Umberto,35,0,35,0
1715611965291,CSS 202S,A01,494387,Mignozzetti; Umberto,35,0,35,0
1715611966321,DSC 197,001,628532,Eldridge; Justin Matthew,9995,0,9999,4
1715611967349,EAP 100,A00,516065,Staff,9799,0,9999,200
1715611968375,ECE 45,A01,507414,Staff,31,0,60,29
1715611970426,ECE 111,A01,507420,Staff,11,0,50,39
1715611971454,ECE 197,001,548057,Sievenpiper; Daniel F.,9991,0,9999,8
1715611972479,EDS 115,A00,507243,Choi; Bailey Miyeon,7,0,28,21
1715611973509,EDS 117,A01,494379,Staff,0,6,34,34
1715611974539,EDS 125,A00,507246,Hopkins; Megan Beth,8,0,30,22
1715611975568,EDS 128A,A01,507264,Fargason; Sharon Gayle,6,0,26,20
1715611976593,EDS 128B,A01,507293,Pappas; Elizabeth,10,0,30,20
1715611977619,EDS 139,A00,507294,Fargason; Sharon Gayle,10,0,30,20
1715611977619,EDS 139,B00,507313,Pappas; Elizabeth,11,0,30,19
1715611978645,EDS 201,A00,507315,Staff,10,0,30,20
1715611979675,EDS 203,A01,507317,Halter; Christopher P.,10,0,30,20
1715611980703,EDS 204R,A01,507319,Halter; Christopher P.,0,3,30,30
1715611980703,EDS 204R,B01,507331,Heinzman; Erica M.,14,0,30,16
1715611981729,EDS 206R,A00,507332,Staff,0,4,30,30
1715611981729,EDS 206R,B00,507343,Staff,15,0,30,15
1715611982755,EDS 250,A00,507344,Hemans; Patricia Ann Benitez,20,0,40,20
1715611983785,EDS 281,A00,507345,Daly; Alan J.,18,0,18,0
1715611984812,EDS 284,A00,507350,Daly; Alan J.,16,0,16,0
1715611985839,EDS 286,A00,507359,Fine; Sarah,18,0,18,0
1715611986868,EDS 289C,A01,507361,Daly; Alan J.,18,0,18,0
1715611987895,EDS 290,A00,507366,Hofstetter; Carolyn,15,0,15,0
1715611988920,LIGM 5A,A00,507421,Fischer-Grunski; Eva K,17,0,20,3
1715611989945,LIGM 5B,A00,507423,Fischer-Grunski; Eva K,19,0,20,1
1715611990971,LIGM 5C,A00,507425,Fischer-Grunski; Eva K,19,0,20,1
1715611992000,LIIT 5AS,A00,507427,Carnelos; Chiara,20,0,20,0
1715611993029,LIIT 5BS,A00,507430,Carnelos; Chiara,20,0,20,0
1715611994057,LIIT 5CS,A00,507432,Carnelos; Chiara,20,0,20,0
1715611995084,LISP 5A,A00,507541,Munoz Sanchez; Alicia,11,0,20,9
1715611996115,LISP 5B,A00,507671,Munoz Sanchez; Alicia,9,0,20,11
1715611997140,LISP 5C,A00,507696,Munoz Sanchez; Alicia,9,0,20,11
1715611998169,MAE 197,001,528363,Boechler; Nicholas Sebastia,9998,0,9999,1
1715611999196,MATH 197,001,523477,Kedlaya; Kiran S.,9994,0,9999,5
1715611999196,MATH 197,002,563811,Zhang; Danna,9994,0,9999,5
1715611999196,MATH 197,003,628552,Dumitriu; Ioana,9998,0,9999,1
1715611999196,MATH 197,004,660885,Floyd; Eric,9999,0,9999,0
1715612000223,MCWP 40R,A00,518780,Staff,2,0,20,18
1715612000223,MCWP 40R,B00,518781,Staff,11,0,20,9
1715612000223,MCWP 40R,C00,518783,Staff,5,0,20,15
1715612001251,MCWP 50R,A00,518791,Staff,0,1,20,20
1715612001251,MCWP 50R,B00,518792,Staff,0,2,20,20
1715612001251,MCWP 50R,C00,518793,Staff,0,4,20,20
1715612001251,MCWP 50R,D00,518794,Staff,0,1,20,20
1715612001251,MCWP 50R,E00,518795,Staff,0,2,20,20
1715612001251,MCWP 50R,F00,518796,Staff,0,1,20,20
1715612001251,MCWP 50R,G00,518797,Staff,0,1,20,20
1715612002279,MMW 12R,A01,514034,Herbst; Matthew,0,2,16,16
1715612002279,MMW 12R,A02,514035,Herbst; Matthew,0,0,16,16
1715612003308,MMW 13R,A01,514037,Staff,0,5,16,16
1715612003308,MMW 13R,A02,514039,Staff,0,5,16,16
1715612003308,MMW 13R,A03,628519,Staff,0,4,16,16
1715612005361,SIO 295LS,A00,523233,Staff,10,0,30,20
1715612006386,SIO 295S,A00,523232,Staff,10,0,30,20
1715612007412,SIOC 290S,A01,637330,Merrifield; Mark A,23,0,30,7
1715612008438,SIOC 291S,A01,637333,Gabriel; Corey John,23,0,30,7
1715612009464,SOCI 117,A01,494376,Staff,0,5,5,5
1715612010492,WES 237B,A00,494380,Staff,10,0,20,10
1715612012552,AESE 279B,A00,494370,Wade; Jon P,0,0,33,33
1715612013579,AIP 97,001,660915,Van Den Einde; Yael Dahlia,9999,0,9999,0
1715612014604,AIP 197,001,627712,Vespa; Emanuel Ignacio,9995,0,9999,4
1715612014604,AIP 197,002,650778,Amir; On,9998,0,9999,1
1715612014604,AIP 197,003,650933,Avenancio-Leon; Carlos,9998,0,9999,1
1715612014604,AIP 197,004,658530,Heyman; Gail D.,9998,0,9999,1
1715612014604,AIP 197,005,658631,Neal; Sonya E,9998,0,9999,1
1715612014604,AIP 197,006,658671,Du; Songzi,9998,0,9999,1
1715612015632,ANAR 135S,A00,494369,Braswell; Geoffrey E.,0,0,0,0
1715612016657,BENG 196,001,628496,Engler; Adam J.,9998,0,9999,1
1715612016657,BENG 196,002,660916,Watson; John Thomas,9999,0,9999,0
1715612017685,BISP 197,001,650773,Wilhelm; James E.,9994,0,9999,5
1715612017685,BISP 197,002,658904,Coleman; Aaron B.,9998,0,9999,1
1715612018711,CAT 124RS,A01,519847,Geibel; William,0,0,20,20
1715612019738,CAT 125RS,A01,515971,Geibel; William,0,0,20,20
1715612020765,CLRE 250,A00,511389,Morris; Sheldon,9992,0,9999,7
1715612021791,CLRE 251,A00,507176,Mehta; Ravindra L.,9992,0,9999,7
1715612021791,CLRE 251,B00,511410,Mehta; Ravindra L.,9998,0,9999,1
1715612022817,CLRE 252,A00,507189,Cuomo; Raphael Eduardo,9994,0,9999,5
1715612023843,CLRE 253,A00,507199,Vaida; Florin,9994,0,9999,5
1715612023843,CLRE 253,B00,507202,Vaida; Florin,9999,0,9999,0
1715612024870,CLRE 259,A00,507211,Patel; Hemal,9996,0,9999,3
1715612025895,CLRE 260,A00,507221,Cuomo; Raphael Eduardo,9999,0,9999,0
1715612026923,CLRE 297,001,507242,Cuomo; Raphael Eduardo,9999,0,9999,0
1715612027950,COGS 197,001,638244,Voytek; Bradley Thomas,9997,0,9999,2
1715612028974,CSE 191,A00,516875,Minnes Kemp; Mor Mia,9991,0,9999,8
1715612030002,CSE 197,001,637388,Minnes Kemp; Mor Mia,9992,0,9999,7
1715612031032,CSS 201S,A01,494383,Mignozzetti; Umberto,35,0,35,0
1715612032059,CSS 202S,A01,494387,Mignozzetti; Umberto,35,0,35,0
1715612033085,DSC 197,001,628532,Eldridge; Justin Matthew,9995,0,9999,4
1715612034115,EAP 100,A00,516065,Staff,9799,0,9999,200
1715612035143,ECE 45,A01,507414,Staff,31,0,60,29
1715612037199,ECE 111,A01,507420,Staff,11,0,50,39
1715612038226,ECE 197,001,548057,Sievenpiper; Daniel F.,9991,0,9999,8
1715612039254,EDS 115,A00,507243,Choi; Bailey Miyeon,7,0,28,21
1715612040283,EDS 117,A01,494379,Staff,0,6,34,34
1715612041310,EDS 125,A00,507246,Hopkins; Megan Beth,8,0,30,22
1715612042345,EDS 128A,A01,507264,Fargason; Sharon Gayle,6,0,26,20
1715612043373,EDS 128B,A01,507293,Pappas; Elizabeth,10,0,30,20
1715612044398,EDS 139,A00,507294,Fargason; Sharon Gayle,10,0,30,20
1715612044398,EDS 139,B00,507313,Pappas; Elizabeth,11,0,30,19
1715612045425,EDS 201,A00,507315,Staff,10,0,30,20
1715612046452,EDS 203,A01,507317,Halter; Christopher P.,10,0,30,20
1715612047479,EDS 204R,A01,507319,Halter; Christopher P.,0,3,30,30
1715612047479,EDS 204R,B01,507331,Heinzman; Erica M.,14,0,30,16
1715612048506,EDS 206R,A00,507332,Staff,0,4,30,30
1715612048506,EDS 206R,B00,507343,Staff,15,0,30,15
1715612049535,EDS 250,A00,507344,Hemans; Patricia Ann Benitez,20,0,40,20
1715612050563,EDS 281,A00,507345,Daly; Alan J.,18,0,18,0
1715612051588,EDS 284,A00,507350,Daly; Alan J.,16,0,16,0
1715612052614,EDS 286,A00,507359,Fine; Sarah,18,0,18,0
1715612053640,EDS 289C,A01,507361,Daly; Alan J.,18,0,18,0
1715612054665,EDS 290,A00,507366,Hofstetter; Carolyn,15,0,15,0
1715612055690,LIGM 5A,A00,507421,Fischer-Grunski; Eva K,17,0,20,3
1715612056715,LIGM 5B,A00,507423,Fischer-Grunski; Eva K,19,0,20,1
1715612057742,LIGM 5C,A00,507425,Fischer-Grunski; Eva K,19,0,20,1
1715612058767,LIIT 5AS,A00,507427,Carnelos; Chiara,20,0,20,0
1715612059795,LIIT 5BS,A00,507430,Carnelos; Chiara,20,0,20,0
1715612060821,LIIT 5CS,A00,507432,Carnelos; Chiara,20,0,20,0
1715612061849,LISP 5A,A00,507541,Munoz Sanchez; Alicia,11,0,20,9
1715612062874,LISP 5B,A00,507671,Munoz Sanchez; Alicia,9,0,20,11
1715612063903,LISP 5C,A00,507696,Munoz Sanchez; Alicia,9,0,20,11
1715612064928,MAE 197,001,528363,Boechler; Nicholas Sebastia,9998,0,9999,1
1715612065956,MATH 197,001,523477,Kedlaya; Kiran S.,9994,0,9999,5
1715612065956,MATH 197,002,563811,Zhang; Danna,9994,0,9999,5
1715612065956,MATH 197,003,628552,Dumitriu; Ioana,9998,0,9999,1
1715612065956,MATH 197,004,660885,Floyd; Eric,9999,0,9999,0
1715612066984,MCWP 40R,A00,518780,Staff,2,0,20,18
1715612066984,MCWP 40R,B00,518781,Staff,11,0,20,9
1715612066984,MCWP 40R,C00,518783,Staff,5,0,20,15
1715612068021,MCWP 50R,A00,518791,Staff,0,1,20,20
1715612068021,MCWP 50R,B00,518792,Staff,0,2,20,20
1715612068021,MCWP 50R,C00,518793,Staff,0,4,20,20
1715612068021,MCWP 50R,D00,518794,Staff,0,1,20,20
1715612068021,MCWP 50R,E00,518795,Staff,0,2,20,20
1715612068021,MCWP 50R,F00,518796,Staff,0,1,20,20
1715612068021,MCWP 50R,G00,518797,Staff,0,1,20,20
1715612069049,MMW 12R,A01,514034,Herbst; Matthew,0,2,16,16
1715612069049,MMW 12R,A02,514035,Herbst; Matthew,0,0,16,16
1715612070076,MMW 13R,A01,514037,Staff,0,5,16,16
1715612070076,MMW 13R,A02,514039,Staff,0,5,16,16
1715612070076,MMW 13R,A03,628519,Staff,0,4,16,16
1715612072137,SIO 295LS,A00,523233,Staff,10,0,30,20
1715612073167,SIO 295S,A00,523232,Staff,10,0,30,20
1715612074192,SIOC 290S,A01,637330,Merrifield; Mark A,23,0,30,7
1715612075221,SIOC 291S,A01,637333,Gabriel; Corey John,23,0,30,7
1715612076247,SOCI 117,A01,494376,Staff,0,5,5,5
1715612077273,WES 237B,A00,494380,Staff,10,0,20,10
1715612079356,AESE 279B,A00,494370,Wade; Jon P,0,0,33,33
1715612080385,AIP 97,001,660915,Van Den Einde; Yael Dahlia,9999,0,9999,0
1715612081411,AIP 197,001,627712,Vespa; Emanuel Ignacio,9995,0,9999,4
1715612081411,AIP 197,002,650778,Amir; On,9998,0,9999,1
1715612081411,AIP 197,003,650933,Avenancio-Leon; Carlos,9998,0,9999,1
1715612081411,AIP 197,004,658530,Heyman; Gail D.,9998,0,9999,1
1715612081411,AIP 197,005,658631,Neal; Sonya E,9998,0,9999,1
1715612081411,AIP 197,006,658671,Du; Songzi,9998,0,9999,1
1715612082437,ANAR 135S,A00,494369,Braswell; Geoffrey E.,0,0,0,0
1715612083463,BENG 196,001,628496,Engler; Adam J.,9998,0,9999,1
1715612083463,BENG 196,002,660916,Watson; John Thomas,9999,0,9999,0
1715612084490,BISP 197,001,650773,Wilhelm; James E.,9994,0,9999,5
1715612084490,BISP 197,002,658904,Coleman; Aaron B.,9998,0,9999,1
1715612085517,CAT 124RS,A01,519847,Geibel; William,0,0,20,20
1715612086541,CAT 125RS,A01,515971,Geibel; William,0,0,20,20
1715612087569,CLRE 250,A00,511389,Morris; Sheldon,9992,0,9999,7
1715612088592,CLRE 251,A00,507176,Mehta; Ravindra L.,9992,0,9999,7
1715612088592,CLRE 251,B00,511410,Mehta; Ravindra L.,9998,0,9999,1
1715612089619,CLRE 252,A00,507189,Cuomo; Raphael Eduardo,9994,0,9999,5
1715612090647,CLRE 253,A00,507199,Vaida; Florin,9994,0,9999,5
1715612090647,CLRE 253,B00,507202,Vaida; Florin,9999,0,9999,0
1715612091674,CLRE 259,A00,507211,Patel; Hemal,9996,0,9999,3
1715612092697,CLRE 260,A00,507221,Cuomo; Raphael Eduardo,9999,0,9999,0
1715612093726,CLRE 297,001,507242,Cuomo; Raphael Eduardo,9999,0,9999,0
1715612094753,COGS 197,001,638244,Voytek; Bradley Thomas,9997,0,9999,2
1715612095777,CSE 191,A00,516875,Minnes Kemp; Mor Mia,9991,0,9999,8
1715612096801,CSE 197,001,637388,Minnes Kemp; Mor Mia,9992,0,9999,7
1715612097833,CSS 201S,A01,494383,Mignozzetti; Umberto,35,0,35,0
1715612098860,CSS 202S,A01,494387,Mignozzetti; Umberto,35,0,35,0
1715612099889,DSC 197,001,628532,Eldridge; Justin Matthew,9995,0,9999,4
1715612100917,EAP 100,A00,516065,Staff,9799,0,9999,200
1715612101946,ECE 45,A01,507414,Staff,31,0,60,29
1715612104009,ECE 111,A01,507420,Staff,11,0,50,39
1715612105036,ECE 197,001,548057,Sievenpiper; Daniel F.,9991,0,9999,8
1715612106065,EDS 115,A00,507243,Choi; Bailey Miyeon,7,0,28,21
1715612107091,EDS 117,A01,494379,Staff,0,6,34,34
1715612108117,EDS 125,A00,507246,Hopkins; Megan Beth,8,0,30,22
1715612109148,EDS 128A,A01,507264,Fargason; Sharon Gayle,6,0,26,20
1715612110176,EDS 128B,A01,507293,Pappas; Elizabeth,10,0,30,20
1715612111204,EDS 139,A00,507294,Fargason; Sharon Gayle,10,0,30,20
1715612111204,EDS 139,B00,507313,Pappas; Elizabeth,11,0,30,19
1715612112233,EDS 201,A00,507315,Staff,10,0,30,20
1715612113262,EDS 203,A01,507317,Halter; Christopher P.,10,0,30,20
1715612114290,EDS 204R,A01,507319,Halter; Christopher P.,0,3,30,30
1715612114290,EDS 204R,B01,507331,Heinzman; Erica M.,14,0,30,16
1715612115321,EDS 206R,A00,507332,Staff,0,4,30,30
1715612115321,EDS 206R,B00,507343,Staff,15,0,30,15
1715612116352,EDS 250,A00,507344,Hemans; Patricia Ann Benitez,20,0,40,20
1715612117377,EDS 281,A00,507345,Daly; Alan J.,18,0,18,0
1715612118404,EDS 284,A00,507350,Daly; Alan J.,16,0,16,0
1715612119432,EDS 286,A00,507359,Fine; Sarah,18,0,18,0
1715612120460,EDS 289C,A01,507361,Daly; Alan J.,18,0,18,0
1715612121487,EDS 290,A00,507366,Hofstetter; Carolyn,15,0,15,0
1715612122518,LIGM 5A,A00,507421,Fischer-Grunski; Eva K,17,0,20,3
1715612123548,LIGM 5B,A00,507423,Fischer-Grunski; Eva K,19,0,20,1
1715612124575,LIGM 5C,A00,507425,Fischer-Grunski; Eva K,19,0,20,1
1715612125601,LIIT 5AS,A00,507427,Carnelos; Chiara,20,0,20,0
1715612126632,LIIT 5BS,A00,507430,Carnelos; Chiara,20,0,20,0
1715612127661,LIIT 5CS,A00,507432,Carnelos; Chiara,20,0,20,0
1715612128687,LISP 5A,A00,507541,Munoz Sanchez; Alicia,11,0,20,9
1715612129716,LISP 5B,A00,507671,Munoz Sanchez; Alicia,9,0,20,11
1715612130743,LISP 5C,A00,507696,Munoz Sanchez; Alicia,9,0,20,11
1715612131770,MAE 197,001,528363,Boechler; Nicholas Sebastia,9998,0,9999,1
1715612132799,MATH 197,001,523477,Kedlaya; Kiran S.,9994,0,9999,5
1715612132799,MATH 197,002,563811,Zhang; Danna,9994,0,9999,5
1715612132799,MATH 197,003,628552,Dumitriu; Ioana,9998,0,9999,1
1715612132799,MATH 197,004,660885,Floyd; Eric,9999,0,9999,0
1715612133826,MCWP 40R,A00,518780,Staff,2,0,20,18
1715612133826,MCWP 40R,B00,518781,Staff,11,0,20,9
1715612133826,MCWP 40R,C00,518783,Staff,5,0,20,15
1715612134855,MCWP 50R,A00,518791,Staff,0,1,20,20
1715612134855,MCWP 50R,B00,518792,Staff,0,2,20,20
1715612134855,MCWP 50R,C00,518793,Staff,0,4,20,20
1715612134855,MCWP 50R,D00,518794,Staff,0,1,20,20
1715612134855,MCWP 50R,E00,518795,Staff,0,2,20,20
1715612134855,MCWP 50R,F00,518796,Staff,0,1,20,20
1715612134855,MCWP 50R,G00,518797,Staff,0,1,20,20
1715612135883,MMW 12R,A01,514034,Herbst; Matthew,0,2,16,16
1715612135883,MMW 12R,A02,514035,Herbst; Matthew,0,0,16,16
1715612136910,MMW 13R,A01,514037,Staff,0,5,16,16
1715612136910,MMW 13R,A02,514039,Staff,0,5,16,16
1715612136910,MMW 13R,A03,628519,Staff,0,4,16,16
1715612138963,SIO 295LS,A00,523233,Staff,10,0,30,20
1715612139991,SIO 295S,A00,523232,Staff,10,0,30,20
1715612141018,SIOC 290S,A01,637330,Merrifield; Mark A,23,0,30,7
1715612142048,SIOC 291S,A01,637333,Gabriel; Corey John,23,0,30,7
1715612143076,SOCI 117,A01,494376,Staff,0,5,5,5
1715612144102,WES 237B,A00,494380,Staff,10,0,20,10
1715612146165,AESE 279B,A00,494370,Wade; Jon P,0,0,33,33
1715612147190,AIP 97,001,660915,Van Den Einde; Yael Dahlia,9999,0,9999,0
1715612148219,AIP 197,001,627712,Vespa; Emanuel Ignacio,9995,0,9999,4
1715612148219,AIP 197,002,650778,Amir; On,9998,0,9999,1
1715612148219,AIP 197,003,650933,Avenancio-Leon; Carlos,9998,0,9999,1
1715612148219,AIP 197,004,658530,Heyman; Gail D.,9998,0,9999,1
1715612148219,AIP 197,005,658631,Neal; Sonya E,9998,0,9999,1
1715612148219,AIP 197,006,658671,Du; Songzi,9998,0,9999,1
1715612149245,ANAR 135S,A00,494369,Braswell; Geoffrey E.,0,0,0,0
1715612150275,BENG 196,001,628496,Engler; Adam J.,9998,0,9999,1
1715612150275,BENG 196,002,660916,Watson; John Thomas,9999,0,9999,0
1715612151299,BISP 197,001,650773,Wilhelm; James E.,9994,0,9999,5
1715612151299,BISP 197,002,658904,Coleman; Aaron B.,9998,0,9999,1
1715612152326,CAT 124RS,A01,519847,Geibel; William,0,0,20,20
1715612153352,CAT 125RS,A01,515971,Geibel; William,0,0,20,20
1715612154380,CLRE 250,A00,511389,Morris; Sheldon,9992,0,9999,7
1715612155409,CLRE 251,A00,507176,Mehta; Ravindra L.,9992,0,9999,7
1715612155409,CLRE 251,B00,511410,Mehta; Ravindra L.,9998,0,9999,1
1715612156438,CLRE 252,A00,507189,Cuomo; Raphael Eduardo,9994,0,9999,5
1715612157466,CLRE 253,A00,507199,Vaida; Florin,9994,0,9999,5
1715612157466,CLRE 253,B00,507202,Vaida; Florin,9999,0,9999,0
1715612158490,CLRE 259,A00,507211,Patel; Hemal,9996,0,9999,3
1715612159517,CLRE 260,A00,507221,Cuomo; Raphael Eduardo,9999,0,9999,0
1715612160543,CLRE 297,001,507242,Cuomo; Raphael Eduardo,9999,0,9999,0
1715612161569,COGS 197,001,638244,Voytek; Bradley Thomas,9997,0,9999,2
1715612162595,CSE 191,A00,516875,Minnes Kemp; Mor Mia,9991,0,9999,8
1715612163622,CSE 197,001,637388,Minnes Kemp; Mor Mia,9992,0,9999,7
1715612164646,CSS 201S,A01,494383,Mignozzetti; Umberto,35,0,35,0
1715612165675,CSS 202S,A01,494387,Mignozzetti; Umberto,35,0,35,0
1715612166699,DSC 197,001,628532,Eldridge; Justin Matthew,9995,0,9999,4
1715612167724,EAP 100,A00,516065,Staff,9799,0,9999,200
1715612168754,ECE 45,A01,507414,Staff,31,0,60,29
1715612170809,ECE 111,A01,507420,Staff,11,0,50,39
1715612171835,ECE 197,001,548057,Sievenpiper; Daniel F.,9991,0,9999,8
1715612172859,EDS 115,A00,507243,Choi; Bailey Miyeon,7,0,28,21
1715612173887,EDS 117,A01,494379,Staff,0,6,34,34
1715612174912,EDS 125,A00,507246,Hopkins; Megan Beth,8,0,30,22
1715612175938,EDS 128A,A01,507264,Fargason; Sharon Gayle,6,0,26,20
1715612176965,EDS 128B,A01,507293,Pappas; Elizabeth,10,0,30,20
1715612177989,EDS 139,A00,507294,Fargason; Sharon Gayle,10,0,30,20
1715612177989,EDS 139,B00,507313,Pappas; Elizabeth,11,0,30,19
1715612179017,EDS 201,A00,507315,Staff,10,0,30,20
1715612180045,EDS 203,A01,507317,Halter; Christopher P.,10,0,30,20
1715612181070,EDS 204R,A01,507319,Halter; Christopher P.,0,3,30,30
1715612181070,EDS 204R,B01,507331,Heinzman; Erica M.,14,0,30,16
1715612182095,EDS 206R,A00,507332,Staff,0,4,30,30
1715612182095,EDS 206R,B00,507343,Staff,15,0,30,15
1715612183121,EDS 250,A00,507344,Hemans; Patricia Ann Benitez,20,0,40,20
1715612184145,EDS 281,A00,507345,Daly; Alan J.,18,0,18,0
1715612185172,EDS 284,A00,507350,Daly; Alan J.,16,0,16,0
1715612186198,EDS 286,A00,507359,Fine; Sarah,18,0,18,0
1715612187225,EDS 289C,A01,507361,Daly; Alan J.,18,0,18,0
1715612188250,EDS 290,A00,507366,Hofstetter; Carolyn,15,0,15,0
1715612189278,LIGM 5A,A00,507421,Fischer-Grunski; Eva K,17,0,20,3
1715612190302,LIGM 5B,A00,507423,Fischer-Grunski; Eva K,19,0,20,1
1715612191327,LIGM 5C,A00,507425,Fischer-Grunski; Eva K,19,0,20,1
1715612192357,LIIT 5AS,A00,507427,Carnelos; Chiara,20,0,20,0
1715612193386,LIIT 5BS,A00,507430,Carnelos; Chiara,20,0,20,0
1715612194410,LIIT 5CS,A00,507432,Carnelos; Chiara,20,0,20,0
1715612195442,LISP 5A,A00,507541,Munoz Sanchez; Alicia,11,0,20,9
1715612196467,LISP 5B,A00,507671,Munoz Sanchez; Alicia,9,0,20,11
1715612197496,LISP 5C,A00,507696,Munoz Sanchez; Alicia,9,0,20,11
1715612198522,MAE 197,001,528363,Boechler; Nicholas Sebastia,9998,0,9999,1
1715612199551,MATH 197,001,523477,Kedlaya; Kiran S.,9994,0,9999,5
1715612199551,MATH 197,002,563811,Zhang; Danna,9994,0,9999,5
1715612199551,MATH 197,003,628552,Dumitriu; Ioana,9998,0,9999,1
1715612199551,MATH 197,004,660885,Floyd; Eric,9999,0,9999,0
1715612200577,MCWP 40R,A00,518780,Staff,2,0,20,18
1715612200577,MCWP 40R,B00,518781,Staff,11,0,20,9
1715612200577,MCWP 40R,C00,518783,Staff,5,0,20,15
1715612201602,MCWP 50R,A00,518791,Staff,0,1,20,20
1715612201602,MCWP 50R,B00,518792,Staff,0,2,20,20
1715612201602,MCWP 50R,C00,518793,Staff,0,4,20,20
1715612201602,MCWP 50R,D00,518794,Staff,0,1,20,20
1715612201602,MCWP 50R,E00,518795,Staff,0,2,20,20
1715612201602,MCWP 50R,F00,518796,Staff,0,1,20,20
1715612201602,MCWP 50R,G00,518797,Staff,0,1,20,20
1715612202632,MMW 12R,A01,514034,Herbst; Matthew,0,2,16,16
1715612202632,MMW 12R,A02,514035,Herbst; Matthew,0,0,16,16
1715612203659,MMW 13R,A01,514037,Staff,0,5,16,16
1715612203659,MMW 13R,A02,514039,Staff,0,5,16,16
1715612203659,MMW 13R,A03,628519,Staff,0,4,16,16
1715612205712,SIO 295LS,A00,523233,Staff,10,0,30,20
1715612206736,SIO 295S,A00,523232,Staff,10,0,30,20
1715612207762,SIOC 290S,A01,637330,Merrifield; Mark A,23,0,30,7
1715612208791,SIOC 291S,A01,637333,Gabriel; Corey John,23,0,30,7
1715612209815,SOCI 117,A01,494376,Staff,0,5,5,5
1715612210840,WES 237B,A00,494380,Staff,10,0,20,10
1715612212905,AESE 279B,A00,494370,Wade; Jon P,0,0,33,33
1715612213932,AIP 97,001,660915,Van Den Einde; Yael Dahlia,9999,0,9999,0
1715612214963,AIP 197,001,627712,Vespa; Emanuel Ignacio,9995,0,9999,4
1715612214963,AIP 197,002,650778,Amir; On,9998,0,9999,1
1715612214963,AIP 197,003,650933,Avenancio-Leon; Carlos,9998,0,9999,1
1715612214963,AIP 197,004,658530,Heyman; Gail D.,9998,0,9999,1
1715612214963,AIP 197,005,658631,Neal; Sonya E,9998,0,9999,1
1715612214963,AIP 197,006,658671,Du; Songzi,9998,0,9999,1
1715612215987,ANAR 135S,A00,494369,Braswell; Geoffrey E.,0,0,0,0
1715612217014,BENG 196,001,628496,Engler; Adam J.,9998,0,9999,1
1715612217014,BENG 196,002,660916,Watson; John Thomas,9999,0,9999,0
1715612218039,BISP 197,001,650773,Wilhelm; James E.,9994,0,9999,5
1715612218039,BISP 197,002,658904,Coleman; Aaron B.,9998,0,9999,1
1715612219063,CAT 124RS,A01,519847,Geibel; William,0,0,20,20
1715612220089,CAT 125RS,A01,515971,Geibel; William,0,0,20,20
1715612221119,CLRE 250,A00,511389,Morris; Sheldon,9992,0,9999,7
1715612222146,CLRE 251,A00,507176,Mehta; Ravindra L.,9992,0,9999,7
1715612222146,CLRE 251,B00,511410,Mehta; Ravindra L.,9998,0,9999,1
1715612223175,CLRE 252,A00,507189,Cuomo; Raphael Eduardo,9994,0,9999,5
1715612224202,CLRE 253,A00,507199,Vaida; Florin,9994,0,9999,5
1715612224202,CLRE 253,B00,507202,Vaida; Florin,9999,0,9999,0
1715612225230,CLRE 259,A00,507211,Patel; Hemal,9996,0,9999,3
1715612226256,CLRE 260,A00,507221,Cuomo; Raphael Eduardo,9999,0,9999,0
1715612227283,CLRE 297,001,507242,Cuomo; Raphael Eduardo,9999,0,9999,0
1715612228310,COGS 197,001,638244,Voytek; Bradley Thomas,9997,0,9999,2
1715612229336,CSE 191,A00,516875,Minnes Kemp; Mor Mia,9991,0,9999,8
1715612230363,CSE 197,001,637388,Minnes Kemp; Mor Mia,9992,0,9999,7
1715612231390,CSS 201S,A01,494383,Mignozzetti; Umberto,35,0,35,0
1715612232416,CSS 202S,A01,494387,Mignozzetti; Umberto,35,0,35,0
1715612233442,DSC 197,001,628532,Eldridge; Justin Matthew,9995,0,9999,4
1715612234468,EAP 100,A00,516065,Staff,9799,0,9999,200
1715612235496,ECE 45,A01,507414,Staff,31,0,60,29
1715612237554,ECE 111,A01,507420,Staff,11,0,50,39
1715612238581,ECE 197,001,548057,Sievenpiper; Daniel F.,9991,0,9999,8
1715612239607,EDS 115,A00,507243,Choi; Bailey Miyeon,7,0,28,21
1715612240636,EDS 117,A01,494379,Staff,0,6,34,34
1715612241660,EDS 125,A00,507246,Hopkins; Megan Beth,8,0,30,22
1715612242689,EDS 128A,A01,507264,Fargason; Sharon Gayle,6,0,26,20
1715612243714,EDS 128B,A01,507293,Pappas; Elizabeth,10,0,30,20
1715612244740,EDS 139,A00,507294,Fargason; Sharon Gayle,10,0,30,20
1715612244740,EDS 139,B00,507313,Pappas; Elizabeth,11,0,30,19
1715612245767,EDS 201,A00,507315,Staff,10,0,30,20
1715612246793,EDS 203,A01,507317,Halter; Christopher P.,10,0,30,20
1715612247819,EDS 204R,A01,507319,Halter; Christopher P.,0,3,30,30
1715612247819,EDS 204R,B01,507331,Heinzman; Erica M.,14,0,30,16
1715612248847,EDS 206R,A00,507332,Staff,0,4,30,30
1715612248847,EDS 206R,B00,507343,Staff,15,0,30,15
1715612249874,EDS 250,A00,507344,Hemans; Patricia Ann Benitez,20,0,40,20
1715612250903,EDS 281,A00,507345,Daly; Alan J.,18,0,18,0
1715612251927,EDS 284,A00,507350,Daly; Alan J.,16,0,16,0
1715612252954,EDS 286,A00,507359,Fine; Sarah,18,0,18,0
1715612253981,EDS 289C,A01,507361,Daly; Alan J.,18,0,18,0
1715612255005,EDS 290,A00,507366,Hofstetter; Carolyn,15,0,15,0
1715612256033,LIGM 5A,A00,507421,Fischer-Grunski; Eva K,17,0,20,3
1715612257063,LIGM 5B,A00,507423,Fischer-Grunski; Eva K,19,0,20,1
1715612258088,LIGM 5C,A00,507425,Fischer-Grunski; Eva K,19,0,20,1
1715612259112,LIIT 5AS,A00,507427,Carnelos; Chiara,20,0,20,0
1715612260138,LIIT 5BS,A00,507430,Carnelos; Chiara,20,0,20,0
1715612261161,LIIT 5CS,A00,507432,Carnelos; Chiara,20,0,20,0
1715612262186,LISP 5A,A00,507541,Munoz Sanchez; Alicia,11,0,20,9
1715612263210,LISP 5B,A00,507671,Munoz Sanchez; Alicia,9,0,20,11
1715612264236,LISP 5C,A00,507696,Munoz Sanchez; Alicia,9,0,20,11
1715612265264,MAE 197,001,528363,Boechler; Nicholas Sebastia,9998,0,9999,1
1715612266295,MATH 197,001,523477,Kedlaya; Kiran S.,9994,0,9999,5
1715612266295,MATH 197,002,563811,Zhang; Danna,9994,0,9999,5
1715612266295,MATH 197,003,628552,Dumitriu; Ioana,9998,0,9999,1
1715612266295,MATH 197,004,660885,Floyd; Eric,9999,0,9999,0
1715612267318,MCWP 40R,A00,518780,Staff,2,0,20,18
1715612267318,MCWP 40R,B00,518781,Staff,11,0,20,9
1715612267318,MCWP 40R,C00,518783,Staff,5,0,20,15
1715612268348,MCWP 50R,A00,518791,Staff,0,1,20,20
1715612268348,MCWP 50R,B00,518792,Staff,0,2,20,20
1715612268348,MCWP 50R,C00,518793,Staff,0,4,20,20
1715612268348,MCWP 50R,D00,518794,Staff,0,1,20,20
1715612268348,MCWP 50R,E00,518795,Staff,0,2,20,20
1715612268348,MCWP 50R,F00,518796,Staff,0,1,20,20
1715612268348,MCWP 50R,G00,518797,Staff,0,1,20,20
1715612269375,MMW 12R,A01,514034,Herbst; Matthew,0,2,16,16
1715612269375,MMW 12R,A02,514035,Herbst; Matthew,0,0,16,16
1715612270402,MMW 13R,A01,514037,Staff,0,5,16,16
1715612270402,MMW 13R,A02,514039,Staff,0,5,16,16
1715612270402,MMW 13R,A03,628519,Staff,0,4,16,16
1715612272454,SIO 295LS,A00,523233,Staff,10,0,30,20
1715612273478,SIO 295S,A00,523232,Staff,10,0,30,20
1715612274508,SIOC 290S,A01,637330,Merrifield; Mark A,23,0,30,7
1715612275534,SIOC 291S,A01,637333,Gabriel; Corey John,23,0,30,7
1715612276557,SOCI 117,A01,494376,Staff,0,5,5,5
1715612277581,WES 237B,A00,494380,Staff,10,0,20,10
1715612279639,AESE 279B,A00,494370,Wade; Jon P,0,0,33,33
1715612280663,AIP 97,001,660915,Van Den Einde; Yael Dahlia,9999,0,9999,0
1715612281688,AIP 197,001,627712,Vespa; Emanuel Ignacio,9995,0,9999,4
1715612281688,AIP 197,002,650778,Amir; On,9998,0,9999,1
1715612281688,AIP 197,003,650933,Avenancio-Leon; Carlos,9998,0,9999,1
1715612281688,AIP 197,004,658530,Heyman; Gail D.,9998,0,9999,1
1715612281688,AIP 197,005,658631,Neal; Sonya E,9998,0,9999,1
1715612281688,AIP 197,006,658671,Du; Songzi,9998,0,9999,1
1715612282713,ANAR 135S,A00,494369,Braswell; Geoffrey E.,0,0,0,0
1715612283743,BENG 196,001,628496,Engler; Adam J.,9998,0,9999,1
1715612283743,BENG 196,002,660916,Watson; John Thomas,9999,0,9999,0
1715612284766,BISP 197,001,650773,Wilhelm; James E.,9994,0,9999,5
1715612284766,BISP 197,002,658904,Coleman; Aaron B.,9998,0,9999,1
1715612285795,CAT 124RS,A01,519847,Geibel; William,0,0,20,20
1715612286819,CAT 125RS,A01,515971,Geibel; William,0,0,20,20
1715612287847,CLRE 250,A00,511389,Morris; Sheldon,9992,0,9999,7
1715612288874,CLRE 251,A00,507176,Mehta; Ravindra L.,9992,0,9999,7
1715612288874,CLRE 251,B00,511410,Mehta; Ravindra L.,9998,0,9999,1
1715612289901,CLRE 252,A00,507189,Cuomo; Raphael Eduardo,9994,0,9999,5
1715612290931,CLRE 253,A00,507199,Vaida; Florin,9994,0,9999,5
1715612290931,CLRE 253,B00,507202,Vaida; Florin,9999,0,9999,0
1715612291957,CLRE 259,A00,507211,Patel; Hemal,9996,0,9999,3
1715612292984,CLRE 260,A00,507221,Cuomo; Raphael Eduardo,9999,0,9999,0
1715612294011,CLRE 297,001,507242,Cuomo; Raphael Eduardo,9999,0,9999,0
1715612295043,COGS 197,001,638244,Voytek; Bradley Thomas,9997,0,9999,2
1715612296070,CSE 191,A00,516875,Minnes Kemp; Mor Mia,9991,0,9999,8
1715612297097,CSE 197,001,637388,Minnes Kemp; Mor Mia,9992,0,9999,7
1715612298125,CSS 201S,A01,494383,Mignozzetti; Umberto,35,0,35,0
1715612299153,CSS 202S,A01,494387,Mignozzetti; Umberto,35,0,35,0
1715612300180,DSC 197,001,628532,Eldridge; Justin Matthew,9995,0,9999,4
1715612301207,EAP 100,A00,516065,Staff,9799,0,9999,200
1715612302233,ECE 45,A01,507414,Staff,31,0,60,29
1715612304287,ECE 111,A01,507420,Staff,11,0,50,39
1715612305314,ECE 197,001,548057,Sievenpiper; Daniel F.,9991,0,9999,8
1715612306343,EDS 115,A00,507243,Choi; Bailey Miyeon,7,0,28,21
1715612307372,EDS 117,A01,494379,Staff,0,6,34,34
1715612308399,EDS 125,A00,507246,Hopkins; Megan Beth,8,0,30,22
1715612309426,EDS 128A,A01,507264,Fargason; Sharon Gayle,6,0,26,20
1715612310452,EDS 128B,A01,507293,Pappas; Elizabeth,10,0,30,20
1715612311480,EDS 139,A00,507294,Fargason; Sharon Gayle,10,0,30,20
1715612311480,EDS 139,B00,507313,Pappas; Elizabeth,11,0,30,19
1715612312508,EDS 201,A00,507315,Staff,10,0,30,20
1715612313533,EDS 203,A01,507317,Halter; Christopher P.,10,0,30,20
1715612314562,EDS 204R,A01,507319,Halter; Christopher P.,0,3,30,30
1715612314562,EDS 204R,B01,507331,Heinzman; Erica M.,14,0,30,16
1715612315591,EDS 206R,A00,507332,Staff,0,4,30,30
1715612315591,EDS 206R,B00,507343,Staff,15,0,30,15
1715612316621,EDS 250,A00,507344,Hemans; Patricia Ann Benitez,20,0,40,20
1715612317647,EDS 281,A00,507345,Daly; Alan J.,18,0,18,0
1715612318676,EDS 284,A00,507350,Daly; Alan J.,16,0,16,0
1715612319703,EDS 286,A00,507359,Fine; Sarah,18,0,18,0
1715612320731,EDS 289C,A01,507361,Daly; Alan J.,18,0,18,0
1715612321760,EDS 290,A00,507366,Hofstetter; Carolyn,15,0,15,0
1715612322786,LIGM 5A,A00,507421,Fischer-Grunski; Eva K,17,0,20,3
1715612323815,LIGM 5B,A00,507423,Fischer-Grunski; Eva K,19,0,20,1
1715612324838,LIGM 5C,A00,507425,Fischer-Grunski; Eva K,19,0,20,1
1715612325869,LIIT 5AS,A00,507427,Carnelos; Chiara,20,0,20,0
1715612326897,LIIT 5BS,A00,507430,Carnelos; Chiara,20,0,20,0
1715612327922,LIIT 5CS,A00,507432,Carnelos; Chiara,20,0,20,0
1715612328947,LISP 5A,A00,507541,Munoz Sanchez; Alicia,11,0,20,9
1715612329977,LISP 5B,A00,507671,Munoz Sanchez; Alicia,9,0,20,11
1715612331006,LISP 5C,A00,507696,Munoz Sanchez; Alicia,9,0,20,11
1715612332032,MAE 197,001,528363,Boechler; Nicholas Sebastia,9998,0,9999,1
1715612333060,MATH 197,001,523477,Kedlaya; Kiran S.,9994,0,9999,5
1715612333060,MATH 197,002,563811,Zhang; Danna,9994,0,9999,5
1715612333060,MATH 197,003,628552,Dumitriu; Ioana,9998,0,9999,1
1715612333060,MATH 197,004,660885,Floyd; Eric,9999,0,9999,0
1715612334090,MCWP 40R,A00,518780,Staff,2,0,20,18
1715612334090,MCWP 40R,B00,518781,Staff,11,0,20,9
1715612334090,MCWP 40R,C00,518783,Staff,5,0,20,15
1715612335119,MCWP 50R,A00,518791,Staff,0,1,20,20
1715612335119,MCWP 50R,B00,518792,Staff,0,2,20,20
1715612335119,MCWP 50R,C00,518793,Staff,0,4,20,20
1715612335119,MCWP 50R,D00,518794,Staff,0,1,20,20
1715612335119,MCWP 50R,E00,518795,Staff,0,2,20,20
1715612335119,MCWP 50R,F00,518796,Staff,0,1,20,20
1715612335119,MCWP 50R,G00,518797,Staff,0,1,20,20
1715612336145,MMW 12R,A01,514034,Herbst; Matthew,0,2,16,16
1715612336145,MMW 12R,A02,514035,Herbst; Matthew,0,0,16,16
1715612337171,MMW 13R,A01,514037,Staff,0,5,16,16
1715612337171,MMW 13R,A02,514039,Staff,0,5,16,16
1715612337171,MMW 13R,A03,628519,Staff,0,4,16,16
1715612339224,SIO 295LS,A00,523233,Staff,10,0,30,20
1715612340252,SIO 295S,A00,523232,Staff,10,0,30,20
1715612341282,SIOC 290S,A01,637330,Merrifield; Mark A,23,0,30,7
1715612342307,SIOC 291S,A01,637333,Gabriel; Corey John,23,0,30,7
1715612343334,SOCI 117,A01,494376,Staff,0,5,5,5
1715612344361,WES 237B,A00,494380,Staff,10,0,20,10
1715612346434,AESE 279B,A00,494370,Wade; Jon P,0,0,33,33
1715612347461,AIP 97,001,660915,Van Den Einde; Yael Dahlia,9999,0,9999,0
1715612348489,AIP 197,001,627712,Vespa; Emanuel Ignacio,9995,0,9999,4
1715612348489,AIP 197,002,650778,Amir; On,9998,0,9999,1
1715612348489,AIP 197,003,650933,Avenancio-Leon; Carlos,9998,0,9999,1
1715612348489,AIP 197,004,658530,Heyman; Gail D.,9998,0,9999,1
1715612348489,AIP 197,005,658631,Neal; Sonya E,9998,0,9999,1
1715612348489,AIP 197,006,658671,Du; Songzi,9998,0,9999,1
1715612349516,ANAR 135S,A00,494369,Braswell; Geoffrey E.,0,0,0,0
1715612350542,BENG 196,001,628496,Engler; Adam J.,9998,0,9999,1
1715612350542,BENG 196,002,660916,Watson; John Thomas,9999,0,9999,0
1715612351574,BISP 197,001,650773,Wilhelm; James E.,9994,0,9999,5
1715612351574,BISP 197,002,658904,Coleman; Aaron B.,9998,0,9999,1
1715612352604,CAT 124RS,A01,519847,Geibel; William,0,0,20,20
1715612353631,CAT 125RS,A01,515971,Geibel; William,0,0,20,20
1715612354659,CLRE 250,A00,511389,Morris; Sheldon,9992,0,9999,7
1715612355689,CLRE 251,A00,507176,Mehta; Ravindra L.,9992,0,9999,7
1715612355689,CLRE 251,B00,511410,Mehta; Ravindra L.,9998,0,9999,1
1715612356715,CLRE 252,A00,507189,Cuomo; Raphael Eduardo,9994,0,9999,5
1715612357742,CLRE 253,A00,507199,Vaida; Florin,9994,0,9999,5
1715612357742,CLRE 253,B00,507202,Vaida; Florin,9999,0,9999,0
1715612358770,CLRE 259,A00,507211,Patel; Hemal,9996,0,9999,3
1715612359794,CLRE 260,A00,507221,Cuomo; Raphael Eduardo,9999,0,9999,0
1715612360819,CLRE 297,001,507242,Cuomo; Raphael Eduardo,9999,0,9999,0
1715612361845,COGS 197,001,638244,Voytek; Bradley Thomas,9997,0,9999,2
1715612362870,CSE 191,A00,516875,Minnes Kemp; Mor Mia,9991,0,9999,8
1715612363906,CSE 197,001,637388,Minnes Kemp; Mor Mia,9992,0,9999,7
1715612364936,CSS 201S,A01,494383,Mignozzetti; Umberto,35,0,35,0
1715612365960,CSS 202S,A01,494387,Mignozzetti; Umberto,35,0,35,0
1715612366987,DSC 197,001,628532,Eldridge; Justin Matthew,9995,0,9999,4
1715612368014,EAP 100,A00,516065,Staff,9799,0,9999,200
1715612369042,ECE 45,A01,507414,Staff,31,0,60,29
1715612371100,ECE 111,A01,507420,Staff,11,0,50,39
1715612372130,ECE 197,001,548057,Sievenpiper; Daniel F.,9991,0,9999,8
1715612373157,EDS 115,A00,507243,Choi; Bailey Miyeon,7,0,28,21
1715612374186,EDS 117,A01,494379,Staff,0,6,34,34
1715612375212,EDS 125,A00,507246,Hopkins; Megan Beth,8,0,30,22
1715612376236,EDS 128A,A01,507264,Fargason; Sharon Gayle,6,0,26,20
1715612377265,EDS 128B,A01,507293,Pappas; Elizabeth,10,0,30,20
1715612378290,EDS 139,A00,507294,Fargason; Sharon Gayle,10,0,30,20
1715612378290,EDS 139,B00,507313,Pappas; Elizabeth,11,0,30,19
1715612379319,EDS 201,A00,507315,Staff,10,0,30,20
1715612380348,EDS 203,A01,507317,Halter; Christopher P.,10,0,30,20
1715612381378,EDS 204R,A01,507319,Halter; Christopher P.,0,3,30,30
1715612381378,EDS 204R,B01,507331,Heinzman; Erica M.,14,0,30,16
1715612382404,EDS 206R,A00,507332,Staff,0,4,30,30
1715612382404,EDS 206R,B00,507343,Staff,15,0,30,15
1715612383433,EDS 250,A00,507344,Hemans; Patricia Ann Benitez,20,0,40,20
1715612384458,EDS 281,A00,507345,Daly; Alan J.,18,0,18,0
1715612385485,EDS 284,A00,507350,Daly; Alan J.,16,0,16,0
1715612386510,EDS 286,A00,507359,Fine; Sarah,18,0,18,0
1715612387538,EDS 289C,A01,507361,Daly; Alan J.,18,0,18,0
1715612388563,EDS 290,A00,507366,Hofstetter; Carolyn,15,0,15,0
1715612389588,LIGM 5A,A00,507421,Fischer-Grunski; Eva K,17,0,20,3
1715612390617,LIGM 5B,A00,507423,Fischer-Grunski; Eva K,19,0,20,1
1715612391644,LIGM 5C,A00,507425,Fischer-Grunski; Eva K,19,0,20,1
1715612392667,LIIT 5AS,A00,507427,Carnelos; Chiara,20,0,20,0
1715612393693,LIIT 5BS,A00,507430,Carnelos; Chiara,20,0,20,0
1715612394718,LIIT 5CS,A00,507432,Carnelos; Chiara,20,0,20,0
1715612395742,LISP 5A,A00,507541,Munoz Sanchez; Alicia,11,0,20,9
1715612396771,LISP 5B,A00,507671,Munoz Sanchez; Alicia,9,0,20,11
1715612397796,LISP 5C,A00,507696,Munoz Sanchez; Alicia,9,0,20,11
1715612398825,MAE 197,001,528363,Boechler; Nicholas Sebastia,9998,0,9999,1
1715612399852,MATH 197,001,523477,Kedlaya; Kiran S.,9994,0,9999,5
1715612399852,MATH 197,002,563811,Zhang; Danna,9994,0,9999,5
1715612399852,MATH 197,003,628552,Dumitriu; Ioana,9998,0,9999,1
1715612399852,MATH 197,004,660885,Floyd; Eric,9999,0,9999,0
1715612400881,MCWP 40R,A00,518780,Staff,2,0,20,18
1715612400881,MCWP 40R,B00,518781,Staff,11,0,20,9
1715612400881,MCWP 40R,C00,518783,Staff,5,0,20,15
1715612401906,MCWP 50R,A00,518791,Staff,0,1,20,20
1715612401906,MCWP 50R,B00,518792,Staff,0,2,20,20
1715612401906,MCWP 50R,C00,518793,Staff,0,4,20,20
1715612401906,MCWP 50R,D00,518794,Staff,0,1,20,20
1715612401906,MCWP 50R,E00,518795,Staff,0,2,20,20
1715612401906,MCWP 50R,F00,518796,Staff,0,1,20,20
1715612401906,MCWP 50R,G00,518797,Staff,0,1,20,20
1715612402933,MMW 12R,A01,514034,Herbst; Matthew,0,2,16,16
1715612402933,MMW 12R,A02,514035,Herbst; Matthew,0,0,16,16
1715612403958,MMW 13R,A01,514037,Staff,0,5,16,16
1715612403958,MMW 13R,A02,514039,Staff,0,5,16,16
1715612403958,MMW 13R,A03,628519,Staff,0,4,16,16
1715612406014,SIO 295LS,A00,523233,Staff,10,0,30,20
1715612407039,SIO 295S,A00,523232,Staff,10,0,30,20
1715612408068,SIOC 290S,A01,637330,Merrifield; Mark A,23,0,30,7
1715612409094,SIOC 291S,A01,637333,Gabriel; Corey John,23,0,30,7
1715612410120,SOCI 117,A01,494376,Staff,0,5,5,5
1715612411145,WES 237B,A00,494380,Staff,10,0,20,10
1715612413210,AESE 279B,A00,494370,Wade; Jon P,0,0,33,33
1715612414235,AIP 97,001,660915,Van Den Einde; Yael Dahlia,9999,0,9999,0
1715612415266,AIP 197,001,627712,Vespa; Emanuel Ignacio,9995,0,9999,4
1715612415266,AIP 197,002,650778,Amir; On,9998,0,9999,1
1715612415266,AIP 197,003,650933,Avenancio-Leon; Carlos,9998,0,9999,1
1715612415266,AIP 197,004,658530,Heyman; Gail D.,9998,0,9999,1
1715612415266,AIP 197,005,658631,Neal; Sonya E,9998,0,9999,1
1715612415266,AIP 197,006,658671,Du; Songzi,9998,0,9999,1
1715612416293,ANAR 135S,A00,494369,Braswell; Geoffrey E.,0,0,0,0
1715612417321,BENG 196,001,628496,Engler; Adam J.,9998,0,9999,1
1715612417321,BENG 196,002,660916,Watson; John Thomas,9999,0,9999,0
1715612418347,BISP 197,001,650773,Wilhelm; James E.,9994,0,9999,5
1715612418347,BISP 197,002,658904,Coleman; Aaron B.,9998,0,9999,1
1715612419374,CAT 124RS,A01,519847,Geibel; William,0,0,20,20
1715612420399,CAT 125RS,A01,515971,Geibel; William,0,0,20,20
1715612421423,CLRE 250,A00,511389,Morris; Sheldon,9992,0,9999,7
1715612422456,CLRE 251,A00,507176,Mehta; Ravindra L.,9992,0,9999,7
1715612422456,CLRE 251,B00,511410,Mehta; Ravindra L.,9998,0,9999,1
1715612423481,CLRE 252,A00,507189,Cuomo; Raphael Eduardo,9994,0,9999,5
1715612424509,CLRE 253,A00,507199,Vaida; Florin,9994,0,9999,5
1715612424509,CLRE 253,B00,507202,Vaida; Florin,9999,0,9999,0
1715612425537,CLRE 259,A00,507211,Patel; Hemal,9996,0,9999,3
1715612426565,CLRE 260,A00,507221,Cuomo; Raphael Eduardo,9999,0,9999,0
1715612427592,CLRE 297,001,507242,Cuomo; Raphael Eduardo,9999,0,9999,0
1715612428619,COGS 197,001,638244,Voytek; Bradley Thomas,9997,0,9999,2
1715612429645,CSE 191,A00,516875,Minnes Kemp; Mor Mia,9991,0,9999,8
1715612430676,CSE 197,001,637388,Minnes Kemp; Mor Mia,9992,0,9999,7
1715612431706,CSS 201S,A01,494383,Mignozzetti; Umberto,35,0,35,0
1715612432736,CSS 202S,A01,494387,Mignozzetti; Umberto,35,0,35,0
1715612433761,DSC 197,001,628532,Eldridge; Justin Matthew,9995,0,9999,4
1715612434788,EAP 100,A00,516065,Staff,9799,0,9999,200
1715612435815,ECE 45,A01,507414,Staff,31,0,60,29
1715612437867,ECE 111,A01,507420,Staff,11,0,50,39
1715612438897,ECE 197,001,548057,Sievenpiper; Daniel F.,9991,0,9999,8
1715612439927,EDS 115,A00,507243,Choi; Bailey Miyeon,7,0,28,21
1715612440954,EDS 117,A01,494379,Staff,0,6,34,34
1715612441983,EDS 125,A00,507246,Hopkins; Megan Beth,8,0,30,22
1715612443009,EDS 128A,A01,507264,Fargason; Sharon Gayle,6,0,26,20
1715612444038,EDS 128B,A01,507293,Pappas; Elizabeth,10,0,30,20
1715612445063,EDS 139,A00,507294,Fargason; Sharon Gayle,10,0,30,20
1715612445063,EDS 139,B00,507313,Pappas; Elizabeth,11,0,30,19
1715612446090,EDS 201,A00,507315,Staff,10,0,30,20
1715612447116,EDS 203,A01,507317,Halter; Christopher P.,10,0,30,20
1715612448142,EDS 204R,A01,507319,Halter; Christopher P.,0,3,30,30
1715612448142,EDS 204R,B01,507331,Heinzman; Erica M.,14,0,30,16
1715612449169,EDS 206R,A00,507332,Staff,0,4,30,30
1715612449169,EDS 206R,B00,507343,Staff,15,0,30,15
1715612450195,EDS 250,A00,507344,Hemans; Patricia Ann Benitez,20,0,40,20
1715612451223,EDS 281,A00,507345,Daly; Alan J.,18,0,18,0
1715612452250,EDS 284,A00,507350,Daly; Alan J.,16,0,16,0
1715612453279,EDS 286,A00,507359,Fine; Sarah,18,0,18,0
1715612454307,EDS 289C,A01,507361,Daly; Alan J.,18,0,18,0
1715612455333,EDS 290,A00,507366,Hofstetter; Carolyn,15,0,15,0
1715612456361,LIGM 5A,A00,507421,Fischer-Grunski; Eva K,17,0,20,3
1715612457389,LIGM 5B,A00,507423,Fischer-Grunski; Eva K,19,0,20,1
1715612458420,LIGM 5C,A00,507425,Fischer-Grunski; Eva K,19,0,20,1
1715612459448,LIIT 5AS,A00,507427,Carnelos; Chiara,20,0,20,0
1715612460481,LIIT 5BS,A00,507430,Carnelos; Chiara,20,0,20,0
1715612461506,LIIT 5CS,A00,507432,Carnelos; Chiara,20,0,20,0
1715612462531,LISP 5A,A00,507541,Munoz Sanchez; Alicia,11,0,20,9
1715612463559,LISP 5B,A00,507671,Munoz Sanchez; Alicia,9,0,20,11
1715612464589,LISP 5C,A00,507696,Munoz Sanchez; Alicia,9,0,20,11
1715612465615,MAE 197,001,528363,Boechler; Nicholas Sebastia,9998,0,9999,1
1715612466643,MATH 197,001,523477,Kedlaya; Kiran S.,9994,0,9999,5
1715612466643,MATH 197,002,563811,Zhang; Danna,9994,0,9999,5
1715612466643,MATH 197,003,628552,Dumitriu; Ioana,9998,0,9999,1
1715612466643,MATH 197,004,660885,Floyd; Eric,9999,0,9999,0
1715612467669,MCWP 40R,A00,518780,Staff,2,0,20,18
1715612467669,MCWP 40R,B00,518781,Staff,11,0,20,9
1715612467669,MCWP 40R,C00,518783,Staff,5,0,20,15
1715612468695,MCWP 50R,A00,518791,Staff,0,1,20,20
1715612468695,MCWP 50R,B00,518792,Staff,0,2,20,20
1715612468695,MCWP 50R,C00,518793,Staff,0,4,20,20
1715612468695,MCWP 50R,D00,518794,Staff,0,1,20,20
1715612468695,MCWP 50R,E00,518795,Staff,0,2,20,20
1715612468695,MCWP 50R,F00,518796,Staff,0,1,20,20
1715612468695,MCWP 50R,G00,518797,Staff,0,1,20,20
1715612469723,MMW 12R,A01,514034,Herbst; Matthew,0,2,16,16
1715612469723,MMW 12R,A02,514035,Herbst; Matthew,0,0,16,16
1715612470753,MMW 13R,A01,514037,Staff,0,5,16,16
1715612470753,MMW 13R,A02,514039,Staff,0,5,16,16
1715612470753,MMW 13R,A03,628519,Staff,0,4,16,16
1715612472806,SIO 295LS,A00,523233,Staff,10,0,30,20
1715612473833,SIO 295S,A00,523232,Staff,10,0,30,20
1715612474859,SIOC 290S,A01,637330,Merrifield; Mark A,23,0,30,7
1715612475889,SIOC 291S,A01,637333,Gabriel; Corey John,23,0,30,7
1715612476915,SOCI 117,A01,494376,Staff,0,5,5,5
1715612477939,WES 237B,A00,494380,Staff,10,0,20,10
1715612480019,AESE 279B,A00,494370,Wade; Jon P,0,0,33,33
1715612481045,AIP 97,001,660915,Van Den Einde; Yael Dahlia,9999,0,9999,0
1715612482070,AIP 197,001,627712,Vespa; Emanuel Ignacio,9995,0,9999,4
1715612482070,AIP 197,002,650778,Amir; On,9998,0,9999,1
1715612482070,AIP 197,003,650933,Avenancio-Leon; Carlos,9998,0,9999,1
1715612482070,AIP 197,004,658530,Heyman; Gail D.,9998,0,9999,1
1715612482070,AIP 197,005,658631,Neal; Sonya E,9998,0,9999,1
1715612482070,AIP 197,006,658671,Du; Songzi,9998,0,9999,1
1715612483098,ANAR 135S,A00,494369,Braswell; Geoffrey E.,0,0,0,0
1715612484127,BENG 196,001,628496,Engler; Adam J.,9998,0,9999,1
1715612484127,BENG 196,002,660916,Watson; John Thomas,9999,0,9999,0
1715612485153,BISP 197,001,650773,Wilhelm; James E.,9994,0,9999,5
1715612485153,BISP 197,002,658904,Coleman; Aaron B.,9998,0,9999,1
1715612486177,CAT 124RS,A01,519847,Geibel; William,0,0,20,20
1715612487204,CAT 125RS,A01,515971,Geibel; William,0,0,20,20
1715612488229,CLRE 250,A00,511389,Morris; Sheldon,9992,0,9999,7
1715612489258,CLRE 251,A00,507176,Mehta; Ravindra L.,9992,0,9999,7
1715612489258,CLRE 251,B00,511410,Mehta; Ravindra L.,9998,0,9999,1
1715612490289,CLRE 252,A00,507189,Cuomo; Raphael Eduardo,9994,0,9999,5
1715612491316,CLRE 253,A00,507199,Vaida; Florin,9994,0,9999,5
1715612491316,CLRE 253,B00,507202,Vaida; Florin,9999,0,9999,0
1715612492343,CLRE 259,A00,507211,Patel; Hemal,9996,0,9999,3
1715612493369,CLRE 260,A00,507221,Cuomo; Raphael Eduardo,9999,0,9999,0
1715612494395,CLRE 297,001,507242,Cuomo; Raphael Eduardo,9999,0,9999,0
1715612495424,COGS 197,001,638244,Voytek; Bradley Thomas,9997,0,9999,2
1715612496452,CSE 191,A00,516875,Minnes Kemp; Mor Mia,9991,0,9999,8
1715612497479,CSE 197,001,637388,Minnes Kemp; Mor Mia,9992,0,9999,7
1715612498506,CSS 201S,A01,494383,Mignozzetti; Umberto,35,0,35,0
1715612499536,CSS 202S,A01,494387,Mignozzetti; Umberto,35,0,35,0
1715612500563,DSC 197,001,628532,Eldridge; Justin Matthew,9995,0,9999,4
1715612501588,EAP 100,A00,516065,Staff,9799,0,9999,200
1715612502619,ECE 45,A01,507414,Staff,31,0,60,29
1715612504670,ECE 111,A01,507420,Staff,11,0,50,39
1715612505698,ECE 197,001,548057,Sievenpiper; Daniel F.,9991,0,9999,8
1715612506724,EDS 115,A00,507243,Choi; Bailey Miyeon,7,0,28,21
1715612507749,EDS 117,A01,494379,Staff,0,6,34,34
1715612508775,EDS 125,A00,507246,Hopkins; Megan Beth,8,0,30,22
1715612509802,EDS 128A,A01,507264,Fargason; Sharon Gayle,6,0,26,20
1715612510828,EDS 128B,A01,507293,Pappas; Elizabeth,10,0,30,20
1715612511852,EDS 139,A00,507294,Fargason; Sharon Gayle,10,0,30,20
1715612511852,EDS 139,B00,507313,Pappas; Elizabeth,11,0,30,19
1715612512878,EDS 201,A00,507315,Staff,10,0,30,20
1715612513904,EDS 203,A01,507317,Halter; Christopher P.,10,0,30,20
1715612514930,EDS 204R,A01,507319,Halter; Christopher P.,0,3,30,30
1715612514930,EDS 204R,B01,507331,Heinzman; Erica M.,14,0,30,16
1715612515958,EDS 206R,A00,507332,Staff,0,4,30,30
1715612515958,EDS 206R,B00,507343,Staff,15,0,30,15
1715612516984,EDS 250,A00,507344,Hemans; Patricia Ann Benitez,20,0,40,20
1715612518013,EDS 281,A00,507345,Daly; Alan J.,18,0,18,0
1715612519039,EDS 284,A00,507350,Daly; Alan J.,16,0,16,0
1715612520067,EDS 286,A00,507359,Fine; Sarah,18,0,18,0
1715612521095,EDS 289C,A01,507361,Daly; Alan J.,18,0,18,0
1715612522122,EDS 290,A00,507366,Hofstetter; Carolyn,15,0,15,0
1715612523149,LIGM 5A,A00,507421,Fischer-Grunski; Eva K,17,0,20,3
1715612524177,LIGM 5B,A00,507423,Fischer-Grunski; Eva K,19,0,20,1
1715612525203,LIGM 5C,A00,507425,Fischer-Grunski; Eva K,19,0,20,1
1715612526229,LIIT 5AS,A00,507427,Carnelos; Chiara,20,0,20,0
1715612527256,LIIT 5BS,A00,507430,Carnelos; Chiara,20,0,20,0
1715612528285,LIIT 5CS,A00,507432,Carnelos; Chiara,20,0,20,0
1715612529315,LISP 5A,A00,507541,Munoz Sanchez; Alicia,11,0,20,9
1715612530341,LISP 5B,A00,507671,Munoz Sanchez; Alicia,9,0,20,11
1715612531369,LISP 5C,A00,507696,Munoz Sanchez; Alicia,9,0,20,11
1715612532398,MAE 197,001,528363,Boechler; Nicholas Sebastia,9998,0,9999,1
1715612533429,MATH 197,001,523477,Kedlaya; Kiran S.,9994,0,9999,5
1715612533429,MATH 197,002,563811,Zhang; Danna,9994,0,9999,5
1715612533429,MATH 197,003,628552,Dumitriu; Ioana,9998,0,9999,1
1715612533429,MATH 197,004,660885,Floyd; Eric,9999,0,9999,0
1715612534455,MCWP 40R,A00,518780,Staff,2,0,20,18
1715612534455,MCWP 40R,B00,518781,Staff,11,0,20,9
1715612534455,MCWP 40R,C00,518783,Staff,5,0,20,15
1715612535481,MCWP 50R,A00,518791,Staff,0,1,20,20
1715612535481,MCWP 50R,B00,518792,Staff,0,2,20,20
1715612535481,MCWP 50R,C00,518793,Staff,0,4,20,20
1715612535481,MCWP 50R,D00,518794,Staff,0,1,20,20
1715612535481,MCWP 50R,E00,518795,Staff,0,2,20,20
1715612535481,MCWP 50R,F00,518796,Staff,0,1,20,20
1715612535481,MCWP 50R,G00,518797,Staff,0,1,20,20
1715612536506,MMW 12R,A01,514034,Herbst; Matthew,0,2,16,16
1715612536506,MMW 12R,A02,514035,Herbst; Matthew,0,0,16,16
1715612537533,MMW 13R,A01,514037,Staff,0,5,16,16
1715612537533,MMW 13R,A02,514039,Staff,0,5,16,16
1715612537533,MMW 13R,A03,628519,Staff,0,4,16,16
1715612539587,SIO 295LS,A00,523233,Staff,10,0,30,20
1715612540615,SIO 295S,A00,523232,Staff,10,0,30,20
1715612541643,SIOC 290S,A01,637330,Merrifield; Mark A,23,0,30,7
1715612542670,SIOC 291S,A01,637333,Gabriel; Corey John,23,0,30,7
1715612543697,SOCI 117,A01,494376,Staff,0,5,5,5
1715612544722,WES 237B,A00,494380,Staff,10,0,20,10
1715612546797,AESE 279B,A00,494370,Wade; Jon P,0,0,33,33
1715612547825,AIP 97,001,660915,Van Den Einde; Yael Dahlia,9999,0,9999,0
1715612548855,AIP 197,001,627712,Vespa; Emanuel Ignacio,9995,0,9999,4
1715612548855,AIP 197,002,650778,Amir; On,9998,0,9999,1
1715612548855,AIP 197,003,650933,Avenancio-Leon; Carlos,9998,0,9999,1
1715612548855,AIP 197,004,658530,Heyman; Gail D.,9998,0,9999,1
1715612548855,AIP 197,005,658631,Neal; Sonya E,9998,0,9999,1
1715612548855,AIP 197,006,658671,Du; Songzi,9998,0,9999,1
1715612549883,ANAR 135S,A00,494369,Braswell; Geoffrey E.,0,0,0,0
1715612550911,BENG 196,001,628496,Engler; Adam J.,9998,0,9999,1
1715612550911,BENG 196,002,660916,Watson; John Thomas,9999,0,9999,0
1715612551937,BISP 197,001,650773,Wilhelm; James E.,9994,0,9999,5
1715612551937,BISP 197,002,658904,Coleman; Aaron B.,9998,0,9999,1
1715612552963,CAT 124RS,A01,519847,Geibel; William,0,0,20,20
1715612553988,CAT 125RS,A01,515971,Geibel; William,0,0,20,20
1715612555012,CLRE 250,A00,511389,Morris; Sheldon,9992,0,9999,7
1715612556044,CLRE 251,A00,507176,Mehta; Ravindra L.,9992,0,9999,7
1715612556044,CLRE 251,B00,511410,Mehta; Ravindra L.,9998,0,9999,1
1715612557068,CLRE 252,A00,507189,Cuomo; Raphael Eduardo,9994,0,9999,5
1715612558094,CLRE 253,A00,507199,Vaida; Florin,9994,0,9999,5
1715612558094,CLRE 253,B00,507202,Vaida; Florin,9999,0,9999,0
1715612559122,CLRE 259,A00,507211,Patel; Hemal,9996,0,9999,3
1715612560150,CLRE 260,A00,507221,Cuomo; Raphael Eduardo,9999,0,9999,0
1715612561178,CLRE 297,001,507242,Cuomo; Raphael Eduardo,9999,0,9999,0
1715612562207,COGS 197,001,638244,Voytek; Bradley Thomas,9997,0,9999,2
1715612563234,CSE 191,A00,516875,Minnes Kemp; Mor Mia,9991,0,9999,8
1715612564259,CSE 197,001,637388,Minnes Kemp; Mor Mia,9992,0,9999,7
1715612565289,CSS 201S,A01,494383,Mignozzetti; Umberto,35,0,35,0
1715612566314,CSS 202S,A01,494387,Mignozzetti; Umberto,35,0,35,0
1715612567341,DSC 197,001,628532,Eldridge; Justin Matthew,9995,0,9999,4
1715612568365,EAP 100,A00,516065,Staff,9799,0,9999,200
1715612569393,ECE 45,A01,507414,Staff,31,0,60,29
1715612571444,ECE 111,A01,507420,Staff,11,0,50,39
1715612572470,ECE 197,001,548057,Sievenpiper; Daniel F.,9991,0,9999,8
1715612573498,EDS 115,A00,507243,Choi; Bailey Miyeon,7,0,28,21
1715612574525,EDS 117,A01,494379,Staff,0,6,34,34
1715612575554,EDS 125,A00,507246,Hopkins; Megan Beth,8,0,30,22
1715612576578,EDS 128A,A01,507264,Fargason; Sharon Gayle,6,0,26,20
1715612577605,EDS 128B,A01,507293,Pappas; Elizabeth,10,0,30,20
1715612578633,EDS 139,A00,507294,Fargason; Sharon Gayle,10,0,30,20
1715612578633,EDS 139,B00,507313,Pappas; Elizabeth,11,0,30,19
1715612579661,EDS 201,A00,507315,Staff,10,0,30,20
1715612580686,EDS 203,A01,507317,Halter; Christopher P.,10,0,30,20
1715612581710,EDS 204R,A01,507319,Halter; Christopher P.,0,3,30,30
1715612581710,EDS 204R,B01,507331,Heinzman; Erica M.,14,0,30,16
1715612582736,EDS 206R,A00,507332,Staff,0,4,30,30
1715612582736,EDS 206R,B00,507343,Staff,15,0,30,15
1715612583764,EDS 250,A00,507344,Hemans; Patricia Ann Benitez,20,0,40,20
1715612584791,EDS 281,A00,507345,Daly; Alan J.,18,0,18,0
1715612585820,EDS 284,A00,507350,Daly; Alan J.,16,0,16,0
1715612586848,EDS 286,A00,507359,Fine; Sarah,18,0,18,0
1715612587877,EDS 289C,A01,507361,Daly; Alan J.,18,0,18,0
1715612588905,EDS 290,A00,507366,Hofstetter; Carolyn,15,0,15,0
1715612589931,LIGM 5A,A00,507421,Fischer-Grunski; Eva K,17,0,20,3
1715612590957,LIGM 5B,A00,507423,Fischer-Grunski; Eva K,19,0,20,1
1715612591986,LIGM 5C,A00,507425,Fischer-Grunski; Eva K,19,0,20,1
1715612593012,LIIT 5AS,A00,507427,Carnelos; Chiara,20,0,20,0
1715612594037,LIIT 5BS,A00,507430,Carnelos; Chiara,20,0,20,0
1715612595061,LIIT 5CS,A00,507432,Carnelos; Chiara,20,0,20,0
1715612596087,LISP 5A,A00,507541,Munoz Sanchez; Alicia,11,0,20,9
1715612597118,LISP 5B,A00,507671,Munoz Sanchez; Alicia,9,0,20,11
1715612598147,LISP 5C,A00,507696,Munoz Sanchez; Alicia,9,0,20,11
1715612599173,MAE 197,001,528363,Boechler; Nicholas Sebastia,9998,0,9999,1
1715612600199,MATH 197,001,523477,Kedlaya; Kiran S.,9994,0,9999,5
1715612600199,MATH 197,002,563811,Zhang; Danna,9994,0,9999,5
1715612600199,MATH 197,003,628552,Dumitriu; Ioana,9998,0,9999,1
1715612600199,MATH 197,004,660885,Floyd; Eric,9999,0,9999,0
1715612601225,MCWP 40R,A00,518780,Staff,2,0,20,18
1715612601225,MCWP 40R,B00,518781,Staff,11,0,20,9
1715612601225,MCWP 40R,C00,518783,Staff,5,0,20,15
1715612602253,MCWP 50R,A00,518791,Staff,0,1,20,20
1715612602253,MCWP 50R,B00,518792,Staff,0,2,20,20
1715612602253,MCWP 50R,C00,518793,Staff,0,4,20,20
1715612602253,MCWP 50R,D00,518794,Staff,0,1,20,20
1715612602253,MCWP 50R,E00,518795,Staff,0,2,20,20
1715612602253,MCWP 50R,F00,518796,Staff,0,1,20,20
1715612602253,MCWP 50R,G00,518797,Staff,0,1,20,20
1715612603278,MMW 12R,A01,514034,Herbst; Matthew,0,2,16,16
1715612603278,MMW 12R,A02,514035,Herbst; Matthew,0,0,16,16
1715612604308,MMW 13R,A01,514037,Staff,0,5,16,16
1715612604308,MMW 13R,A02,514039,Staff,0,5,16,16
1715612604308,MMW 13R,A03,628519,Staff,0,4,16,16
1715612606361,SIO 295LS,A00,523233,Staff,10,0,30,20
1715612607387,SIO 295S,A00,523232,Staff,10,0,30,20
1715612608414,SIOC 290S,A01,637330,Merrifield; Mark A,23,0,30,7
1715612609439,SIOC 291S,A01,637333,Gabriel; Corey John,23,0,30,7
1715612610467,SOCI 117,A01,494376,Staff,0,5,5,5
1715612611494,WES 237B,A00,494380,Staff,10,0,20,10
1715612613556,AESE 279B,A00,494370,Wade; Jon P,0,0,33,33
1715612614583,AIP 97,001,660915,Van Den Einde; Yael Dahlia,9999,0,9999,0
1715612615615,AIP 197,001,627712,Vespa; Emanuel Ignacio,9995,0,9999,4
1715612615615,AIP 197,002,650778,Amir; On,9998,0,9999,1
1715612615615,AIP 197,003,650933,Avenancio-Leon; Carlos,9998,0,9999,1
1715612615615,AIP 197,004,658530,Heyman; Gail D.,9998,0,9999,1
1715612615615,AIP 197,005,658631,Neal; Sonya E,9998,0,9999,1
1715612615615,AIP 197,006,658671,Du; Songzi,9998,0,9999,1
1715612616639,ANAR 135S,A00,494369,Braswell; Geoffrey E.,0,0,0,0
1715612617668,BENG 196,001,628496,Engler; Adam J.,9998,0,9999,1
1715612617668,BENG 196,002,660916,Watson; John Thomas,9999,0,9999,0
1715612618695,BISP 197,001,650773,Wilhelm; James E.,9994,0,9999,5
1715612618695,BISP 197,002,658904,Coleman; Aaron B.,9998,0,9999,1
1715612619723,CAT 124RS,A01,519847,Geibel; William,0,0,20,20
1715612620749,CAT 125RS,A01,515971,Geibel; William,0,0,20,20
1715612621775,CLRE 250,A00,511389,Morris; Sheldon,9992,0,9999,7
1715612622799,CLRE 251,A00,507176,Mehta; Ravindra L.,9992,0,9999,7
1715612622799,CLRE 251,B00,511410,Mehta; Ravindra L.,9998,0,9999,1
1715612623824,CLRE 252,A00,507189,Cuomo; Raphael Eduardo,9994,0,9999,5
1715612624849,CLRE 253,A00,507199,Vaida; Florin,9994,0,9999,5
1715612624849,CLRE 253,B00,507202,Vaida; Florin,9999,0,9999,0
1715612625878,CLRE 259,A00,507211,Patel; Hemal,9996,0,9999,3
1715612626902,CLRE 260,A00,507221,Cuomo; Raphael Eduardo,9999,0,9999,0
1715612627927,CLRE 297,001,507242,Cuomo; Raphael Eduardo,9999,0,9999,0
1715612628955,COGS 197,001,638244,Voytek; Bradley Thomas,9997,0,9999,2
1715612629981,CSE 191,A00,516875,Minnes Kemp; Mor Mia,9991,0,9999,8
1715612631006,CSE 197,001,637388,Minnes Kemp; Mor Mia,9992,0,9999,7
1715612632033,CSS 201S,A01,494383,Mignozzetti; Umberto,35,0,35,0
1715612633064,CSS 202S,A01,494387,Mignozzetti; Umberto,35,0,35,0
1715612634092,DSC 197,001,628532,Eldridge; Justin Matthew,9995,0,9999,4
1715612635123,EAP 100,A00,516065,Staff,9799,0,9999,200
1715612636155,ECE 45,A01,507414,Staff,31,0,60,29
1715612638207,ECE 111,A01,507420,Staff,11,0,50,39
1715612639232,ECE 197,001,548057,Sievenpiper; Daniel F.,9991,0,9999,8
1715612640266,EDS 115,A00,507243,Choi; Bailey Miyeon,7,0,28,21
1715612641295,EDS 117,A01,494379,Staff,0,6,34,34
1715612642323,EDS 125,A00,507246,Hopkins; Megan Beth,8,0,30,22
1715612643351,EDS 128A,A01,507264,Fargason; Sharon Gayle,6,0,26,20
1715612644377,EDS 128B,A01,507293,Pappas; Elizabeth,10,0,30,20
1715612645404,EDS 139,A00,507294,Fargason; Sharon Gayle,10,0,30,20
1715612645404,EDS 139,B00,507313,Pappas; Elizabeth,11,0,30,19
1715612646431,EDS 201,A00,507315,Staff,10,0,30,20
1715612647461,EDS 203,A01,507317,Halter; Christopher P.,10,0,30,20
1715612648489,EDS 204R,A01,507319,Halter; Christopher P.,0,3,30,30
1715612648489,EDS 204R,B01,507331,Heinzman; Erica M.,14,0,30,16
1715612649514,EDS 206R,A00,507332,Staff,0,4,30,30
1715612649514,EDS 206R,B00,507343,Staff,15,0,30,15
1715612650539,EDS 250,A00,507344,Hemans; Patricia Ann Benitez,20,0,40,20
1715612651564,EDS 281,A00,507345,Daly; Alan J.,18,0,18,0
1715612652592,EDS 284,A00,507350,Daly; Alan J.,16,0,16,0
1715612653619,EDS 286,A00,507359,Fine; Sarah,18,0,18,0
1715612654643,EDS 289C,A01,507361,Daly; Alan J.,18,0,18,0
1715612655669,EDS 290,A00,507366,Hofstetter; Carolyn,15,0,15,0
1715612656696,LIGM 5A,A00,507421,Fischer-Grunski; Eva K,17,0,20,3
1715612657725,LIGM 5B,A00,507423,Fischer-Grunski; Eva K,19,0,20,1
1715612658753,LIGM 5C,A00,507425,Fischer-Grunski; Eva K,19,0,20,1
1715612659783,LIIT 5AS,A00,507427,Carnelos; Chiara,20,0,20,0
1715612660810,LIIT 5BS,A00,507430,Carnelos; Chiara,20,0,20,0
1715612661834,LIIT 5CS,A00,507432,Carnelos; Chiara,20,0,20,0
1715612662865,LISP 5A,A00,507541,Munoz Sanchez; Alicia,11,0,20,9
1715612663907,LISP 5B,A00,507671,Munoz Sanchez; Alicia,9,0,20,11
1715612664937,LISP 5C,A00,507696,Munoz Sanchez; Alicia,9,0,20,11
1715612665964,MAE 197,001,528363,Boechler; Nicholas Sebastia,9998,0,9999,1
1715612666989,MATH 197,001,523477,Kedlaya; Kiran S.,9994,0,9999,5
1715612666989,MATH 197,002,563811,Zhang; Danna,9994,0,9999,5
1715612666989,MATH 197,003,628552,Dumitriu; Ioana,9998,0,9999,1
1715612666989,MATH 197,004,660885,Floyd; Eric,9999,0,9999,0
1715612668014,MCWP 40R,A00,518780,Staff,2,0,20,18
1715612668014,MCWP 40R,B00,518781,Staff,11,0,20,9
1715612668014,MCWP 40R,C00,518783,Staff,5,0,20,15
1715612669040,MCWP 50R,A00,518791,Staff,0,1,20,20
1715612669040,MCWP 50R,B00,518792,Staff,0,2,20,20
1715612669040,MCWP 50R,C00,518793,Staff,0,4,20,20
1715612669040,MCWP 50R,D00,518794,Staff,0,1,20,20
1715612669040,MCWP 50R,E00,518795,Staff,0,2,20,20
1715612669040,MCWP 50R,F00,518796,Staff,0,1,20,20
1715612669040,MCWP 50R,G00,518797,Staff,0,1,20,20
1715612670065,MMW 12R,A01,514034,Herbst; Matthew,0,2,16,16
1715612670065,MMW 12R,A02,514035,Herbst; Matthew,0,0,16,16
1715612671091,MMW 13R,A01,514037,Staff,0,5,16,16
1715612671091,MMW 13R,A02,514039,Staff,0,5,16,16
1715612671091,MMW 13R,A03,628519,Staff,0,4,16,16
1715612673167,SIO 295LS,A00,523233,Staff,10,0,30,20
1715612674193,SIO 295S,A00,523232,Staff,10,0,30,20
1715612675219,SIOC 290S,A01,637330,Merrifield; Mark A,23,0,30,7
1715612676244,SIOC 291S,A01,637333,Gabriel; Corey John,23,0,30,7
1715612677270,SOCI 117,A01,494376,Staff,0,5,5,5
1715612678297,WES 237B,A00,494380,Staff,10,0,20,10
1715612680364,AESE 279B,A00,494370,Wade; Jon P,0,0,33,33
1715612681390,AIP 97,001,660915,Van Den Einde; Yael Dahlia,9999,0,9999,0
1715612682417,AIP 197,001,627712,Vespa; Emanuel Ignacio,9995,0,9999,4
1715612682417,AIP 197,002,650778,Amir; On,9998,0,9999,1
1715612682417,AIP 197,003,650933,Avenancio-Leon; Carlos,9998,0,9999,1
1715612682417,AIP 197,004,658530,Heyman; Gail D.,9998,0,9999,1
1715612682417,AIP 197,005,658631,Neal; Sonya E,9998,0,9999,1
1715612682417,AIP 197,006,658671,Du; Songzi,9998,0,9999,1
1715612683448,ANAR 135S,A00,494369,Braswell; Geoffrey E.,0,0,0,0
1715612684474,BENG 196,001,628496,Engler; Adam J.,9998,0,9999,1
1715612684474,BENG 196,002,660916,Watson; John Thomas,9999,0,9999,0
1715612685502,BISP 197,001,650773,Wilhelm; James E.,9994,0,9999,5
1715612685502,BISP 197,002,658904,Coleman; Aaron B.,9998,0,9999,1
1715612686531,CAT 124RS,A01,519847,Geibel; William,0,0,20,20
1715612687557,CAT 125RS,A01,515971,Geibel; William,0,0,20,20
1715612688584,CLRE 250,A00,511389,Morris; Sheldon,9992,0,9999,7
1715612689611,CLRE 251,A00,507176,Mehta; Ravindra L.,9992,0,9999,7
1715612689611,CLRE 251,B00,511410,Mehta; Ravindra L.,9998,0,9999,1
1715612690636,CLRE 252,A00,507189,Cuomo; Raphael Eduardo,9994,0,9999,5
1715612691664,CLRE 253,A00,507199,Vaida; Florin,9994,0,9999,5
1715612691664,CLRE 253,B00,507202,Vaida; Florin,9999,0,9999,0
1715612692692,CLRE 259,A00,507211,Patel; Hemal,9996,0,9999,3
1715612693717,CLRE 260,A00,507221,Cuomo; Raphael Eduardo,9999,0,9999,0
1715612694743,CLRE 297,001,507242,Cuomo; Raphael Eduardo,9999,0,9999,0
1715612695769,COGS 197,001,638244,Voytek; Bradley Thomas,9997,0,9999,2
1715612696798,CSE 191,A00,516875,Minnes Kemp; Mor Mia,9991,0,9999,8
1715612697823,CSE 197,001,637388,Minnes Kemp; Mor Mia,9992,0,9999,7
1715612698850,CSS 201S,A01,494383,Mignozzetti; Umberto,35,0,35,0
1715612699881,CSS 202S,A01,494387,Mignozzetti; Umberto,35,0,35,0
1715612700909,DSC 197,001,628532,Eldridge; Justin Matthew,9995,0,9999,4
1715612701934,EAP 100,A00,516065,Staff,9799,0,9999,200
1715612702967,ECE 45,A01,507414,Staff,31,0,60,29
1715612705024,ECE 111,A01,507420,Staff,11,0,50,39
1715612706053,ECE 197,001,548057,Sievenpiper; Daniel F.,9991,0,9999,8
1715612707080,EDS 115,A00,507243,Choi; Bailey Miyeon,7,0,28,21
1715612708109,EDS 117,A01,494379,Staff,0,6,34,34
1715612709141,EDS 125,A00,507246,Hopkins; Megan Beth,8,0,30,22
1715612710167,EDS 128A,A01,507264,Fargason; Sharon Gayle,6,0,26,20
1715612711251,EDS 128B,A01,507293,Pappas; Elizabeth,10,0,30,20
1715612712278,EDS 139,A00,507294,Fargason; Sharon Gayle,10,0,30,20
1715612712278,EDS 139,B00,507313,Pappas; Elizabeth,11,0,30,19
1715612713304,EDS 201,A00,507315,Staff,10,0,30,20
1715612714333,EDS 203,A01,507317,Halter; Christopher P.,10,0,30,20
1715612715364,EDS 204R,A01,507319,Halter; Christopher P.,0,3,30,30
1715612715364,EDS 204R,B01,507331,Heinzman; Erica M.,14,0,30,16
1715612716389,EDS 206R,A00,507332,Staff,0,4,30,30
1715612716389,EDS 206R,B00,507343,Staff,15,0,30,15
1715612717413,EDS 250,A00,507344,Hemans; Patricia Ann Benitez,20,0,40,20
1715612718439,EDS 281,A00,507345,Daly; Alan J.,18,0,18,0
1715612719466,EDS 284,A00,507350,Daly; Alan J.,16,0,16,0
1715612720493,EDS 286,A00,507359,Fine; Sarah,18,0,18,0
1715612721518,EDS 289C,A01,507361,Daly; Alan J.,18,0,18,0
1715612722547,EDS 290,A00,507366,Hofstetter; Carolyn,15,0,15,0
1715612723577,LIGM 5A,A00,507421,Fischer-Grunski; Eva K,17,0,20,3
1715612724605,LIGM 5B,A00,507423,Fischer-Grunski; Eva K,19,0,20,1
1715612725630,LIGM 5C,A00,507425,Fischer-Grunski; Eva K,19,0,20,1
1715612726655,LIIT 5AS,A00,507427,Carnelos; Chiara,20,0,20,0
1715612727681,LIIT 5BS,A00,507430,Carnelos; Chiara,20,0,20,0
1715612728709,LIIT 5CS,A00,507432,Carnelos; Chiara,20,0,20,0
1715612729735,LISP 5A,A00,507541,Munoz Sanchez; Alicia,11,0,20,9
1715612730761,LISP 5B,A00,507671,Munoz Sanchez; Alicia,9,0,20,11
1715612731787,LISP 5C,A00,507696,Munoz Sanchez; Alicia,9,0,20,11
1715612732812,MAE 197,001,528363,Boechler; Nicholas Sebastia,9998,0,9999,1
1715612733838,MATH 197,001,523477,Kedlaya; Kiran S.,9994,0,9999,5
1715612733838,MATH 197,002,563811,Zhang; Danna,9994,0,9999,5
1715612733838,MATH 197,003,628552,Dumitriu; Ioana,9998,0,9999,1
1715612733838,MATH 197,004,660885,Floyd; Eric,9999,0,9999,0
1715612734863,MCWP 40R,A00,518780,Staff,2,0,20,18
1715612734863,MCWP 40R,B00,518781,Staff,11,0,20,9
1715612734863,MCWP 40R,C00,518783,Staff,5,0,20,15
1715612735889,MCWP 50R,A00,518791,Staff,0,1,20,20
1715612735889,MCWP 50R,B00,518792,Staff,0,2,20,20
1715612735889,MCWP 50R,C00,518793,Staff,0,4,20,20
1715612735889,MCWP 50R,D00,518794,Staff,0,1,20,20
1715612735889,MCWP 50R,E00,518795,Staff,0,2,20,20
1715612735889,MCWP 50R,F00,518796,Staff,0,1,20,20
1715612735889,MCWP 50R,G00,518797,Staff,0,1,20,20
1715612736917,MMW 12R,A01,514034,Herbst; Matthew,0,2,16,16
1715612736917,MMW 12R,A02,514035,Herbst; Matthew,0,0,16,16
1715612737941,MMW 13R,A01,514037,Staff,0,5,16,16
1715612737941,MMW 13R,A02,514039,Staff,0,5,16,16
1715612737941,MMW 13R,A03,628519,Staff,0,4,16,16
1715612739990,SIO 295LS,A00,523233,Staff,10,0,30,20
1715612741018,SIO 295S,A00,523232,Staff,10,0,30,20
1715612742045,SIOC 290S,A01,637330,Merrifield; Mark A,23,0,30,7
1715612743070,SIOC 291S,A01,637333,Gabriel; Corey John,23,0,30,7
1715612744099,SOCI 117,A01,494376,Staff,0,5,5,5
1715612745125,WES 237B,A00,494380,Staff,10,0,20,10
1715612747192,AESE 279B,A00,494370,Wade; Jon P,0,0,33,33
1715612748220,AIP 97,001,660915,Van Den Einde; Yael Dahlia,9999,0,9999,0
1715612749245,AIP 197,001,627712,Vespa; Emanuel Ignacio,9995,0,9999,4
1715612749245,AIP 197,002,650778,Amir; On,9998,0,9999,1
1715612749245,AIP 197,003,650933,Avenancio-Leon; Carlos,9998,0,9999,1
1715612749245,AIP 197,004,658530,Heyman; Gail D.,9998,0,9999,1
1715612749245,AIP 197,005,658631,Neal; Sonya E,9998,0,9999,1
1715612749245,AIP 197,006,658671,Du; Songzi,9998,0,9999,1
1715612750270,ANAR 135S,A00,494369,Braswell; Geoffrey E.,0,0,0,0
1715612751300,BENG 196,001,628496,Engler; Adam J.,9998,0,9999,1
1715612751300,BENG 196,002,660916,Watson; John Thomas,9999,0,9999,0
1715612752324,BISP 197,001,650773,Wilhelm; James E.,9994,0,9999,5
1715612752324,BISP 197,002,658904,Coleman; Aaron B.,9998,0,9999,1
1715612753350,CAT 124RS,A01,519847,Geibel; William,0,0,20,20
1715612754376,CAT 125RS,A01,515971,Geibel; William,0,0,20,20
1715612755403,CLRE 250,A00,511389,Morris; Sheldon,9992,0,9999,7
1715612756434,CLRE 251,A00,507176,Mehta; Ravindra L.,9992,0,9999,7
1715612756434,CLRE 251,B00,511410,Mehta; Ravindra L.,9998,0,9999,1
1715612757458,CLRE 252,A00,507189,Cuomo; Raphael Eduardo,9994,0,9999,5
1715612758487,CLRE 253,A00,507199,Vaida; Florin,9994,0,9999,5
1715612758487,CLRE 253,B00,507202,Vaida; Florin,9999,0,9999,0
1715612759514,CLRE 259,A00,507211,Patel; Hemal,9996,0,9999,3
1715612760542,CLRE 260,A00,507221,Cuomo; Raphael Eduardo,9999,0,9999,0
1715612761570,CLRE 297,001,507242,Cuomo; Raphael Eduardo,9999,0,9999,0
1715612762597,COGS 197,001,638244,Voytek; Bradley Thomas,9997,0,9999,2
1715612763621,CSE 191,A00,516875,Minnes Kemp; Mor Mia,9991,0,9999,8
1715612764646,CSE 197,001,637388,Minnes Kemp; Mor Mia,9992,0,9999,7
1715612765725,CSS 201S,A01,494383,Mignozzetti; Umberto,35,0,35,0
1715612766748,CSS 202S,A01,494387,Mignozzetti; Umberto,35,0,35,0
1715612767776,DSC 197,001,628532,Eldridge; Justin Matthew,9995,0,9999,4
1715612768805,EAP 100,A00,516065,Staff,9799,0,9999,200
1715612769837,ECE 45,A01,507414,Staff,31,0,60,29
1715612771891,ECE 111,A01,507420,Staff,11,0,50,39
1715612772916,ECE 197,001,548057,Sievenpiper; Daniel F.,9991,0,9999,8
1715612773945,EDS 115,A00,507243,Choi; Bailey Miyeon,7,0,28,21
1715612774971,EDS 117,A01,494379,Staff,0,6,34,34
1715612775997,EDS 125,A00,507246,Hopkins; Megan Beth,8,0,30,22
1715612777021,EDS 128A,A01,507264,Fargason; Sharon Gayle,6,0,26,20
1715612778047,EDS 128B,A01,507293,Pappas; Elizabeth,10,0,30,20
1715612779074,EDS 139,A00,507294,Fargason; Sharon Gayle,10,0,30,20
1715612779074,EDS 139,B00,507313,Pappas; Elizabeth,11,0,30,19
1715612780103,EDS 201,A00,507315,Staff,10,0,30,20
1715612781128,EDS 203,A01,507317,Halter; Christopher P.,10,0,30,20
1715612782154,EDS 204R,A01,507319,Halter; Christopher P.,0,3,30,30
1715612782154,EDS 204R,B01,507331,Heinzman; Erica M.,14,0,30,16
1715612783235,EDS 206R,A00,507332,Staff,0,4,30,30
1715612783235,EDS 206R,B00,507343,Staff,15,0,30,15
1715612784265,EDS 250,A00,507344,Hemans; Patricia Ann Benitez,20,0,40,20
1715612785289,EDS 281,A00,507345,Daly; Alan J.,18,0,18,0
1715612786317,EDS 284,A00,507350,Daly; Alan J.,16,0,16,0
1715612787342,EDS 286,A00,507359,Fine; Sarah,18,0,18,0
1715612788372,EDS 289C,A01,507361,Daly; Alan J.,18,0,18,0
1715612789400,EDS 290,A00,507366,Hofstetter; Carolyn,15,0,15,0
1715612790430,LIGM 5A,A00,507421,Fischer-Grunski; Eva K,17,0,20,3
1715612791457,LIGM 5B,A00,507423,Fischer-Grunski; Eva K,19,0,20,1
1715612792482,LIGM 5C,A00,507425,Fischer-Grunski; Eva K,19,0,20,1
1715612793513,LIIT 5AS,A00,507427,Carnelos; Chiara,20,0,20,0
1715612794540,LIIT 5BS,A00,507430,Carnelos; Chiara,20,0,20,0
1715612795565,LIIT 5CS,A00,507432,Carnelos; Chiara,20,0,20,0
1715612796594,LISP 5A,A00,507541,Munoz Sanchez; Alicia,11,0,20,9
1715612797620,LISP 5B,A00,507671,Munoz Sanchez; Alicia,9,0,20,11
1715612798649,LISP 5C,A00,507696,Munoz Sanchez; Alicia,9,0,20,11
1715612799678,MAE 197,001,528363,Boechler; Nicholas Sebastia,9998,0,9999,1
1715612800709,MATH 197,001,523477,Kedlaya; Kiran S.,9994,0,9999,5
1715612800709,MATH 197,002,563811,Zhang; Danna,9994,0,9999,5
1715612800709,MATH 197,003,628552,Dumitriu; Ioana,9998,0,9999,1
1715612800709,MATH 197,004,660885,Floyd; Eric,9999,0,9999,0
1715612801733,MCWP 40R,A00,518780,Staff,2,0,20,18
1715612801733,MCWP 40R,B00,518781,Staff,11,0,20,9
1715612801733,MCWP 40R,C00,518783,Staff,5,0,20,15
1715612802760,MCWP 50R,A00,518791,Staff,0,1,20,20
1715612802760,MCWP 50R,B00,518792,Staff,0,2,20,20
1715612802760,MCWP 50R,C00,518793,Staff,0,4,20,20
1715612802760,MCWP 50R,D00,518794,Staff,0,1,20,20
1715612802760,MCWP 50R,E00,518795,Staff,0,2,20,20
1715612802760,MCWP 50R,F00,518796,Staff,0,1,20,20
1715612802760,MCWP 50R,G00,518797,Staff,0,1,20,20
1715612803787,MMW 12R,A01,514034,Herbst; Matthew,0,2,16,16
1715612803787,MMW 12R,A02,514035,Herbst; Matthew,0,0,16,16
1715612804818,MMW 13R,A01,514037,Staff,0,5,16,16
1715612804818,MMW 13R,A02,514039,Staff,0,5,16,16
1715612804818,MMW 13R,A03,628519,Staff,0,4,16,16
1715612806872,SIO 295LS,A00,523233,Staff,10,0,30,20
1715612807902,SIO 295S,A00,523232,Staff,10,0,30,20
1715612808933,SIOC 290S,A01,637330,Merrifield; Mark A,23,0,30,7
1715612809960,SIOC 291S,A01,637333,Gabriel; Corey John,23,0,30,7
1715612810987,SOCI 117,A01,494376,Staff,0,5,5,5
1715612812013,WES 237B,A00,494380,Staff,10,0,20,10
1715612814082,AESE 279B,A00,494370,Wade; Jon P,0,0,33,33
1715612815107,AIP 97,001,660915,Van Den Einde; Yael Dahlia,9999,0,9999,0
1715612816136,AIP 197,001,627712,Vespa; Emanuel Ignacio,9995,0,9999,4
1715612816136,AIP 197,002,650778,Amir; On,9998,0,9999,1
1715612816136,AIP 197,003,650933,Avenancio-Leon; Carlos,9998,0,9999,1
1715612816136,AIP 197,004,658530,Heyman; Gail D.,9998,0,9999,1
1715612816136,AIP 197,005,658631,Neal; Sonya E,9998,0,9999,1
1715612816136,AIP 197,006,658671,Du; Songzi,9998,0,9999,1
1715612817160,ANAR 135S,A00,494369,Braswell; Geoffrey E.,0,0,0,0
1715612818187,BENG 196,001,628496,Engler; Adam J.,9998,0,9999,1
1715612818187,BENG 196,002,660916,Watson; John Thomas,9999,0,9999,0
1715612819214,BISP 197,001,650773,Wilhelm; James E.,9994,0,9999,5
1715612819214,BISP 197,002,658904,Coleman; Aaron B.,9998,0,9999,1
1715612820239,CAT 124RS,A01,519847,Geibel; William,0,0,20,20
1715612821264,CAT 125RS,A01,515971,Geibel; William,0,0,20,20
1715612822293,CLRE 250,A00,511389,Morris; Sheldon,9992,0,9999,7
1715612823319,CLRE 251,A00,507176,Mehta; Ravindra L.,9992,0,9999,7
1715612823319,CLRE 251,B00,511410,Mehta; Ravindra L.,9998,0,9999,1
1715612824348,CLRE 252,A00,507189,Cuomo; Raphael Eduardo,9994,0,9999,5
1715612825378,CLRE 253,A00,507199,Vaida; Florin,9994,0,9999,5
1715612825378,CLRE 253,B00,507202,Vaida; Florin,9999,0,9999,0
1715612826406,CLRE 259,A00,507211,Patel; Hemal,9996,0,9999,3
1715612827433,CLRE 260,A00,507221,Cuomo; Raphael Eduardo,9999,0,9999,0
1715612828457,CLRE 297,001,507242,Cuomo; Raphael Eduardo,9999,0,9999,0
1715612829483,COGS 197,001,638244,Voytek; Bradley Thomas,9997,0,9999,2
1715612830509,CSE 191,A00,516875,Minnes Kemp; Mor Mia,9991,0,9999,8
1715612831538,CSE 197,001,637388,Minnes Kemp; Mor Mia,9992,0,9999,7
1715612832566,CSS 201S,A01,494383,Mignozzetti; Umberto,35,0,35,0
1715612833596,CSS 202S,A01,494387,Mignozzetti; Umberto,35,0,35,0
1715612834624,DSC 197,001,628532,Eldridge; Justin Matthew,9995,0,9999,4
1715612835649,EAP 100,A00,516065,Staff,9799,0,9999,200
1715612836675,ECE 45,A01,507414,Staff,31,0,60,29
1715612838728,ECE 111,A01,507420,Staff,11,0,50,39
1715612839754,ECE 197,001,548057,Sievenpiper; Daniel F.,9991,0,9999,8
1715612840779,EDS 115,A00,507243,Choi; Bailey Miyeon,7,0,28,21
1715612841806,EDS 117,A01,494379,Staff,0,6,34,34
1715612842832,EDS 125,A00,507246,Hopkins; Megan Beth,8,0,30,22
1715612843861,EDS 128A,A01,507264,Fargason; Sharon Gayle,6,0,26,20
1715612844887,EDS 128B,A01,507293,Pappas; Elizabeth,10,0,30,20
1715612845911,EDS 139,A00,507294,Fargason; Sharon Gayle,10,0,30,20
1715612845911,EDS 139,B00,507313,Pappas; Elizabeth,11,0,30,19
1715612846938,EDS 201,A00,507315,Staff,10,0,30,20
1715612847967,EDS 203,A01,507317,Halter; Christopher P.,10,0,30,20
1715612848995,EDS 204R,A01,507319,Halter; Christopher P.,0,3,30,30
1715612848995,EDS 204R,B01,507331,Heinzman; Erica M.,14,0,30,16
1715612850024,EDS 206R,A00,507332,Staff,0,4,30,30
1715612850024,EDS 206R,B00,507343,Staff,15,0,30,15
1715612851050,EDS 250,A00,507344,Hemans; Patricia Ann Benitez,20,0,40,20
1715612852076,EDS 281,A00,507345,Daly; Alan J.,18,0,18,0
1715612853100,EDS 284,A00,507350,Daly; Alan J.,16,0,16,0
1715612854130,EDS 286,A00,507359,Fine; Sarah,18,0,18,0
1715612855154,EDS 289C,A01,507361,Daly; Alan J.,18,0,18,0
1715612856180,EDS 290,A00,507366,Hofstetter; Carolyn,15,0,15,0
1715612857211,LIGM 5A,A00,507421,Fischer-Grunski; Eva K,17,0,20,3
1715612858241,LIGM 5B,A00,507423,Fischer-Grunski; Eva K,19,0,20,1
1715612859266,LIGM 5C,A00,507425,Fischer-Grunski; Eva K,19,0,20,1
1715612860296,LIIT 5AS,A00,507427,Carnelos; Chiara,20,0,20,0
1715612861321,LIIT 5BS,A00,507430,Carnelos; Chiara,20,0,20,0
1715612862346,LIIT 5CS,A00,507432,Carnelos; Chiara,20,0,20,0
1715612863373,LISP 5A,A00,507541,Munoz Sanchez; Alicia,11,0,20,9
1715612864402,LISP 5B,A00,507671,Munoz Sanchez; Alicia,9,0,20,11
1715612865439,LISP 5C,A00,507696,Munoz Sanchez; Alicia,9,0,20,11
1715612866466,MAE 197,001,528363,Boechler; Nicholas Sebastia,9998,0,9999,1
1715612867495,MATH 197,001,523477,Kedlaya; Kiran S.,9994,0,9999,5
1715612867495,MATH 197,002,563811,Zhang; Danna,9994,0,9999,5
1715612867495,MATH 197,003,628552,Dumitriu; Ioana,9998,0,9999,1
1715612867495,MATH 197,004,660885,Floyd; Eric,9999,0,9999,0
1715612868520,MCWP 40R,A00,518780,Staff,2,0,20,18
1715612868520,MCWP 40R,B00,518781,Staff,11,0,20,9
1715612868520,MCWP 40R,C00,518783,Staff,5,0,20,15
1715612869546,MCWP 50R,A00,518791,Staff,0,1,20,20
1715612869546,MCWP 50R,B00,518792,Staff,0,2,20,20
1715612869546,MCWP 50R,C00,518793,Staff,0,4,20,20
1715612869546,MCWP 50R,D00,518794,Staff,0,1,20,20
1715612869546,MCWP 50R,E00,518795,Staff,0,2,20,20
1715612869546,MCWP 50R,F00,518796,Staff,0,1,20,20
1715612869546,MCWP 50R,G00,518797,Staff,0,1,20,20
1715612870575,MMW 12R,A01,514034,Herbst; Matthew,0,2,16,16
1715612870575,MMW 12R,A02,514035,Herbst; Matthew,0,0,16,16
1715612871603,MMW 13R,A01,514037,Staff,0,5,16,16
1715612871603,MMW 13R,A02,514039,Staff,0,5,16,16
1715612871603,MMW 13R,A03,628519,Staff,0,4,16,16
1715612873656,SIO 295LS,A00,523233,Staff,10,0,30,20
1715612874684,SIO 295S,A00,523232,Staff,10,0,30,20
1715612875714,SIOC 290S,A01,637330,Merrifield; Mark A,23,0,30,7
1715612876745,SIOC 291S,A01,637333,Gabriel; Corey John,23,0,30,7
1715612877773,SOCI 117,A01,494376,Staff,0,5,5,5
1715612878798,WES 237B,A00,494380,Staff,10,0,20,10
1715612880856,AESE 279B,A00,494370,Wade; Jon P,0,0,33,33
1715612881884,AIP 97,001,660915,Van Den Einde; Yael Dahlia,9999,0,9999,0
1715612882911,AIP 197,001,627712,Vespa; Emanuel Ignacio,9995,0,9999,4
1715612882911,AIP 197,002,650778,Amir; On,9998,0,9999,1
1715612882911,AIP 197,003,650933,Avenancio-Leon; Carlos,9998,0,9999,1
1715612882911,AIP 197,004,658530,Heyman; Gail D.,9998,0,9999,1
1715612882911,AIP 197,005,658631,Neal; Sonya E,9998,0,9999,1
1715612882911,AIP 197,006,658671,Du; Songzi,9998,0,9999,1
1715612883936,ANAR 135S,A00,494369,Braswell; Geoffrey E.,0,0,0,0
1715612884962,BENG 196,001,628496,Engler; Adam J.,9998,0,9999,1
1715612884962,BENG 196,002,660916,Watson; John Thomas,9999,0,9999,0
1715612885988,BISP 197,001,650773,Wilhelm; James E.,9994,0,9999,5
1715612885988,BISP 197,002,658904,Coleman; Aaron B.,9998,0,9999,1
1715612887013,CAT 124RS,A01,519847,Geibel; William,0,0,20,20
1715612888040,CAT 125RS,A01,515971,Geibel; William,0,0,20,20
1715612889064,CLRE 250,A00,511389,Morris; Sheldon,9992,0,9999,7
1715612890090,CLRE 251,A00,507176,Mehta; Ravindra L.,9992,0,9999,7
1715612890090,CLRE 251,B00,511410,Mehta; Ravindra L.,9998,0,9999,1
1715612891117,CLRE 252,A00,507189,Cuomo; Raphael Eduardo,9994,0,9999,5
1715612892142,CLRE 253,A00,507199,Vaida; Florin,9994,0,9999,5
1715612892142,CLRE 253,B00,507202,Vaida; Florin,9999,0,9999,0
1715612893168,CLRE 259,A00,507211,Patel; Hemal,9996,0,9999,3
1715612894192,CLRE 260,A00,507221,Cuomo; Raphael Eduardo,9999,0,9999,0
1715612895217,CLRE 297,001,507242,Cuomo; Raphael Eduardo,9999,0,9999,0
1715612896245,COGS 197,001,638244,Voytek; Bradley Thomas,9997,0,9999,2
1715612897270,CSE 191,A00,516875,Minnes Kemp; Mor Mia,9991,0,9999,8
1715612898296,CSE 197,001,637388,Minnes Kemp; Mor Mia,9992,0,9999,7
1715612899322,CSS 201S,A01,494383,Mignozzetti; Umberto,35,0,35,0
1715612900350,CSS 202S,A01,494387,Mignozzetti; Umberto,35,0,35,0
1715612901375,DSC 197,001,628532,Eldridge; Justin Matthew,9995,0,9999,4
1715612902403,EAP 100,A00,516065,Staff,9799,0,9999,200
1715612903429,ECE 45,A01,507414,Staff,31,0,60,29
1715612905479,ECE 111,A01,507420,Staff,11,0,50,39
1715612906506,ECE 197,001,548057,Sievenpiper; Daniel F.,9991,0,9999,8
1715612907532,EDS 115,A00,507243,Choi; Bailey Miyeon,7,0,28,21
1715612908557,EDS 117,A01,494379,Staff,0,6,34,34
1715612909581,EDS 125,A00,507246,Hopkins; Megan Beth,8,0,30,22
1715612910610,EDS 128A,A01,507264,Fargason; Sharon Gayle,6,0,26,20
1715612911641,EDS 128B,A01,507293,Pappas; Elizabeth,10,0,30,20
1715612912664,EDS 139,A00,507294,Fargason; Sharon Gayle,10,0,30,20
1715612912664,EDS 139,B00,507313,Pappas; Elizabeth,11,0,30,19
1715612913690,EDS 201,A00,507315,Staff,10,0,30,20
1715612914714,EDS 203,A01,507317,Halter; Christopher P.,10,0,30,20
1715612915740,EDS 204R,A01,507319,Halter; Christopher P.,0,3,30,30
1715612915740,EDS 204R,B01,507331,Heinzman; Erica M.,14,0,30,16
1715612916768,EDS 206R,A00,507332,Staff,0,4,30,30
1715612916768,EDS 206R,B00,507343,Staff,15,0,30,15
1715612917793,EDS 250,A00,507344,Hemans; Patricia Ann Benitez,20,0,40,20
1715612918821,EDS 281,A00,507345,Daly; Alan J.,18,0,18,0
1715612919846,EDS 284,A00,507350,Daly; Alan J.,16,0,16,0
1715612920873,EDS 286,A00,507359,Fine; Sarah,18,0,18,0
1715612921899,EDS 289C,A01,507361,Daly; Alan J.,18,0,18,0
1715612922923,EDS 290,A00,507366,Hofstetter; Carolyn,15,0,15,0
1715612923951,LIGM 5A,A00,507421,Fischer-Grunski; Eva K,17,0,20,3
1715612924977,LIGM 5B,A00,507423,Fischer-Grunski; Eva K,19,0,20,1
1715612926002,LIGM 5C,A00,507425,Fischer-Grunski; Eva K,19,0,20,1
1715612927026,LIIT 5AS,A00,507427,Carnelos; Chiara,20,0,20,0
1715612928052,LIIT 5BS,A00,507430,Carnelos; Chiara,20,0,20,0
1715612929078,LIIT 5CS,A00,507432,Carnelos; Chiara,20,0,20,0
1715612930107,LISP 5A,A00,507541,Munoz Sanchez; Alicia,11,0,20,9
1715612931144,LISP 5B,A00,507671,Munoz Sanchez; Alicia,9,0,20,11
1715612932174,LISP 5C,A00,507696,Munoz Sanchez; Alicia,9,0,20,11
1715612933201,MAE 197,001,528363,Boechler; Nicholas Sebastia,9998,0,9999,1
1715612934231,MATH 197,001,523477,Kedlaya; Kiran S.,9994,0,9999,5
1715612934231,MATH 197,002,563811,Zhang; Danna,9994,0,9999,5
1715612934231,MATH 197,003,628552,Dumitriu; Ioana,9998,0,9999,1
1715612934231,MATH 197,004,660885,Floyd; Eric,9999,0,9999,0
1715612935257,MCWP 40R,A00,518780,Staff,2,0,20,18
1715612935257,MCWP 40R,B00,518781,Staff,11,0,20,9
1715612935257,MCWP 40R,C00,518783,Staff,5,0,20,15
1715612936286,MCWP 50R,A00,518791,Staff,0,1,20,20
1715612936286,MCWP 50R,B00,518792,Staff,0,2,20,20
1715612936286,MCWP 50R,C00,518793,Staff,0,4,20,20
1715612936286,MCWP 50R,D00,518794,Staff,0,1,20,20
1715612936286,MCWP 50R,E00,518795,Staff,0,2,20,20
1715612936286,MCWP 50R,F00,518796,Staff,0,1,20,20
1715612936286,MCWP 50R,G00,518797,Staff,0,1,20,20
1715612937312,MMW 12R,A01,514034,Herbst; Matthew,0,2,16,16
1715612937312,MMW 12R,A02,514035,Herbst; Matthew,0,0,16,16
1715612938340,MMW 13R,A01,514037,Staff,0,5,16,16
1715612938340,MMW 13R,A02,514039,Staff,0,5,16,16
1715612938340,MMW 13R,A03,628519,Staff,0,4,16,16
1715612940398,SIO 295LS,A00,523233,Staff,10,0,30,20
1715612941425,SIO 295S,A00,523232,Staff,10,0,30,20
1715612942452,SIOC 290S,A01,637330,Merrifield; Mark A,23,0,30,7
1715612943482,SIOC 291S,A01,637333,Gabriel; Corey John,23,0,30,7
1715612944509,SOCI 117,A01,494376,Staff,0,5,5,5
1715612945533,WES 237B,A00,494380,Staff,10,0,20,10
1715612947603,AESE 279B,A00,494370,Wade; Jon P,0,0,33,33
1715612948628,AIP 97,001,660915,Van Den Einde; Yael Dahlia,9999,0,9999,0
1715612949659,AIP 197,001,627712,Vespa; Emanuel Ignacio,9995,0,9999,4
1715612949659,AIP 197,002,650778,Amir; On,9998,0,9999,1
1715612949659,AIP 197,003,650933,Avenancio-Leon; Carlos,9998,0,9999,1
1715612949659,AIP 197,004,658530,Heyman; Gail D.,9998,0,9999,1
1715612949659,AIP 197,005,658631,Neal; Sonya E,9998,0,9999,1
1715612949659,AIP 197,006,658671,Du; Songzi,9998,0,9999,1
1715612950683,ANAR 135S,A00,494369,Braswell; Geoffrey E.,0,0,0,0
1715612951710,BENG 196,001,628496,Engler; Adam J.,9998,0,9999,1
1715612951710,BENG 196,002,660916,Watson; John Thomas,9999,0,9999,0
1715612952733,BISP 197,001,650773,Wilhelm; James E.,9994,0,9999,5
1715612952733,BISP 197,002,658904,Coleman; Aaron B.,9998,0,9999,1
1715612953759,CAT 124RS,A01,519847,Geibel; William,0,0,20,20
1715612954784,CAT 125RS,A01,515971,Geibel; William,0,0,20,20
1715612955811,CLRE 250,A00,511389,Morris; Sheldon,9992,0,9999,7
1715612956838,CLRE 251,A00,507176,Mehta; Ravindra L.,9992,0,9999,7
1715612956838,CLRE 251,B00,511410,Mehta; Ravindra L.,9998,0,9999,1
1715612957864,CLRE 252,A00,507189,Cuomo; Raphael Eduardo,9994,0,9999,5
1715612958891,CLRE 253,A00,507199,Vaida; Florin,9994,0,9999,5
1715612958891,CLRE 253,B00,507202,Vaida; Florin,9999,0,9999,0
1715612959917,CLRE 259,A00,507211,Patel; Hemal,9996,0,9999,3
1715612960942,CLRE 260,A00,507221,Cuomo; Raphael Eduardo,9999,0,9999,0
1715612961967,CLRE 297,001,507242,Cuomo; Raphael Eduardo,9999,0,9999,0
1715612962994,COGS 197,001,638244,Voytek; Bradley Thomas,9997,0,9999,2
1715612964019,CSE 191,A00,516875,Minnes Kemp; Mor Mia,9991,0,9999,8
1715612965047,CSE 197,001,637388,Minnes Kemp; Mor Mia,9992,0,9999,7
1715612966073,CSS 201S,A01,494383,Mignozzetti; Umberto,35,0,35,0
1715612967100,CSS 202S,A01,494387,Mignozzetti; Umberto,35,0,35,0
1715612968125,DSC 197,001,628532,Eldridge; Justin Matthew,9995,0,9999,4
1715612969151,EAP 100,A00,516065,Staff,9799,0,9999,200
1715612970180,ECE 45,A01,507414,Staff,31,0,60,29
1715612972244,ECE 111,A01,507420,Staff,11,0,50,39
1715612973274,ECE 197,001,548057,Sievenpiper; Daniel F.,9991,0,9999,8
1715612974302,EDS 115,A00,507243,Choi; Bailey Miyeon,7,0,28,21
1715612975331,EDS 117,A01,494379,Staff,0,6,34,34
1715612976358,EDS 125,A00,507246,Hopkins; Megan Beth,8,0,30,22
1715612977387,EDS 128A,A01,507264,Fargason; Sharon Gayle,6,0,26,20
1715612978413,EDS 128B,A01,507293,Pappas; Elizabeth,10,0,30,20
1715612979438,EDS 139,A00,507294,Fargason; Sharon Gayle,10,0,30,20
1715612979438,EDS 139,B00,507313,Pappas; Elizabeth,11,0,30,19
1715612980466,EDS 201,A00,507315,Staff,10,0,30,20
1715612981491,EDS 203,A01,507317,Halter; Christopher P.,10,0,30,20
1715612982516,EDS 204R,A01,507319,Halter; Christopher P.,0,3,30,30
1715612982516,EDS 204R,B01,507331,Heinzman; Erica M.,14,0,30,16
1715612983545,EDS 206R,A00,507332,Staff,0,4,30,30
1715612983545,EDS 206R,B00,507343,Staff,15,0,30,15
1715612984576,EDS 250,A00,507344,Hemans; Patricia Ann Benitez,20,0,40,20
1715612985604,EDS 281,A00,507345,Daly; Alan J.,18,0,18,0
1715612986629,EDS 284,A00,507350,Daly; Alan J.,16,0,16,0
1715612987656,EDS 286,A00,507359,Fine; Sarah,18,0,18,0
1715612988683,EDS 289C,A01,507361,Daly; Alan J.,18,0,18,0
1715612989708,EDS 290,A00,507366,Hofstetter; Carolyn,15,0,15,0
1715612990793,LIGM 5A,A00,507421,Fischer-Grunski; Eva K,17,0,20,3
1715612991818,LIGM 5B,A00,507423,Fischer-Grunski; Eva K,19,0,20,1
1715612992847,LIGM 5C,A00,507425,Fischer-Grunski; Eva K,19,0,20,1
1715612993878,LIIT 5AS,A00,507427,Carnelos; Chiara,20,0,20,0
1715612994907,LIIT 5BS,A00,507430,Carnelos; Chiara,20,0,20,0
1715612995935,LIIT 5CS,A00,507432,Carnelos; Chiara,20,0,20,0
1715612996960,LISP 5A,A00,507541,Munoz Sanchez; Alicia,11,0,20,9
1715612997987,LISP 5B,A00,507671,Munoz Sanchez; Alicia,9,0,20,11
1715612999013,LISP 5C,A00,507696,Munoz Sanchez; Alicia,9,0,20,11
1715613000038,MAE 197,001,528363,Boechler; Nicholas Sebastia,9998,0,9999,1
1715613001064,MATH 197,001,523477,Kedlaya; Kiran S.,9994,0,9999,5
1715613001064,MATH 197,002,563811,Zhang; Danna,9994,0,9999,5
1715613001064,MATH 197,003,628552,Dumitriu; Ioana,9998,0,9999,1
1715613001064,MATH 197,004,660885,Floyd; Eric,9999,0,9999,0
1715613002093,MCWP 40R,A00,518780,Staff,2,0,20,18
1715613002093,MCWP 40R,B00,518781,Staff,11,0,20,9
1715613002093,MCWP 40R,C00,518783,Staff,5,0,20,15
1715613003120,MCWP 50R,A00,518791,Staff,0,1,20,20
1715613003120,MCWP 50R,B00,518792,Staff,0,2,20,20
1715613003120,MCWP 50R,C00,518793,Staff,0,4,20,20
1715613003120,MCWP 50R,D00,518794,Staff,0,1,20,20
1715613003120,MCWP 50R,E00,518795,Staff,0,2,20,20
1715613003120,MCWP 50R,F00,518796,Staff,0,1,20,20
1715613003120,MCWP 50R,G00,518797,Staff,0,1,20,20
1715613004148,MMW 12R,A01,514034,Herbst; Matthew,0,2,16,16
1715613004148,MMW 12R,A02,514035,Herbst; Matthew,0,0,16,16
1715613005175,MMW 13R,A01,514037,Staff,0,5,16,16
1715613005175,MMW 13R,A02,514039,Staff,0,5,16,16
1715613005175,MMW 13R,A03,628519,Staff,0,4,16,16
1715613007226,SIO 295LS,A00,523233,Staff,10,0,30,20
1715613008254,SIO 295S,A00,523232,Staff,10,0,30,20
1715613009281,SIOC 290S,A01,637330,Merrifield; Mark A,23,0,30,7
1715613010312,SIOC 291S,A01,637333,Gabriel; Corey John,23,0,30,7
1715613011339,SOCI 117,A01,494376,Staff,0,5,5,5
1715613012366,WES 237B,A00,494380,Staff,10,0,20,10
1715613014429,AESE 279B,A00,494370,Wade; Jon P,0,0,33,33
1715613015455,AIP 97,001,660915,Van Den Einde; Yael Dahlia,9999,0,9999,0
1715613016479,AIP 197,001,627712,Vespa; Emanuel Ignacio,9995,0,9999,4
1715613016479,AIP 197,002,650778,Amir; On,9998,0,9999,1
1715613016479,AIP 197,003,650933,Avenancio-Leon; Carlos,9998,0,9999,1
1715613016479,AIP 197,004,658530,Heyman; Gail D.,9998,0,9999,1
1715613016479,AIP 197,005,658631,Neal; Sonya E,9998,0,9999,1
1715613016479,AIP 197,006,658671,Du; Songzi,9998,0,9999,1
1715613017507,ANAR 135S,A00,494369,Braswell; Geoffrey E.,0,0,0,0
1715613018533,BENG 196,001,628496,Engler; Adam J.,9998,0,9999,1
1715613018533,BENG 196,002,660916,Watson; John Thomas,9999,0,9999,0
1715613019558,BISP 197,001,650773,Wilhelm; James E.,9994,0,9999,5
1715613019558,BISP 197,002,658904,Coleman; Aaron B.,9998,0,9999,1
1715613020583,CAT 124RS,A01,519847,Geibel; William,0,0,20,20
1715613021613,CAT 125RS,A01,515971,Geibel; William,0,0,20,20
1715613022639,CLRE 250,A00,511389,Morris; Sheldon,9992,0,9999,7
1715613023665,CLRE 251,A00,507176,Mehta; Ravindra L.,9992,0,9999,7
1715613023665,CLRE 251,B00,511410,Mehta; Ravindra L.,9998,0,9999,1
1715613024692,CLRE 252,A00,507189,Cuomo; Raphael Eduardo,9994,0,9999,5
1715613025773,CLRE 253,A00,507199,Vaida; Florin,9994,0,9999,5
1715613025773,CLRE 253,B00,507202,Vaida; Florin,9999,0,9999,0
1715613026801,CLRE 259,A00,507211,Patel; Hemal,9996,0,9999,3
1715613027826,CLRE 260,A00,507221,Cuomo; Raphael Eduardo,9999,0,9999,0
1715613028853,CLRE 297,001,507242,Cuomo; Raphael Eduardo,9999,0,9999,0
1715613029878,COGS 197,001,638244,Voytek; Bradley Thomas,9997,0,9999,2
1715613030904,CSE 191,A00,516875,Minnes Kemp; Mor Mia,9991,0,9999,8
1715613031932,CSE 197,001,637388,Minnes Kemp; Mor Mia,9992,0,9999,7
1715613032960,CSS 201S,A01,494383,Mignozzetti; Umberto,35,0,35,0
1715613033987,CSS 202S,A01,494387,Mignozzetti; Umberto,35,0,35,0
1715613035013,DSC 197,001,628532,Eldridge; Justin Matthew,9995,0,9999,4
1715613036038,EAP 100,A00,516065,Staff,9799,0,9999,200
1715613037068,ECE 45,A01,507414,Staff,31,0,60,29
1715613039119,ECE 111,A01,507420,Staff,11,0,50,39
1715613040144,ECE 197,001,548057,Sievenpiper; Daniel F.,9991,0,9999,8
1715613041172,EDS 115,A00,507243,Choi; Bailey Miyeon,7,0,28,21
1715613042197,EDS 117,A01,494379,Staff,0,6,34,34
1715613043221,EDS 125,A00,507246,Hopkins; Megan Beth,8,0,30,22
1715613044249,EDS 128A,A01,507264,Fargason; Sharon Gayle,6,0,26,20
1715613045274,EDS 128B,A01,507293,Pappas; Elizabeth,10,0,30,20
1715613046303,EDS 139,A00,507294,Fargason; Sharon Gayle,10,0,30,20
1715613046303,EDS 139,B00,507313,Pappas; Elizabeth,11,0,30,19
1715613047329,EDS 201,A00,507315,Staff,10,0,30,20
1715613048355,EDS 203,A01,507317,Halter; Christopher P.,10,0,30,20
1715613049382,EDS 204R,A01,507319,Halter; Christopher P.,0,3,30,30
1715613049382,EDS 204R,B01,507331,Heinzman; Erica M.,14,0,30,16
1715613050410,EDS 206R,A00,507332,Staff,0,4,30,30
1715613050410,EDS 206R,B00,507343,Staff,15,0,30,15
1715613051435,EDS 250,A00,507344,Hemans; Patricia Ann Benitez,20,0,40,20
1715613052463,EDS 281,A00,507345,Daly; Alan J.,18,0,18,0
1715613053488,EDS 284,A00,507350,Daly; Alan J.,16,0,16,0
1715613054515,EDS 286,A00,507359,Fine; Sarah,18,0,18,0
1715613055540,EDS 289C,A01,507361,Daly; Alan J.,18,0,18,0
1715613056566,EDS 290,A00,507366,Hofstetter; Carolyn,15,0,15,0
1715613057595,LIGM 5A,A00,507421,Fischer-Grunski; Eva K,17,0,20,3
1715613058624,LIGM 5B,A00,507423,Fischer-Grunski; Eva K,19,0,20,1
1715613059652,LIGM 5C,A00,507425,Fischer-Grunski; Eva K,19,0,20,1
1715613060682,LIIT 5AS,A00,507427,Carnelos; Chiara,20,0,20,0
1715613061709,LIIT 5BS,A00,507430,Carnelos; Chiara,20,0,20,0
1715613062735,LIIT 5CS,A00,507432,Carnelos; Chiara,20,0,20,0
1715613063764,LISP 5A,A00,507541,Munoz Sanchez; Alicia,11,0,20,9
1715613064791,LISP 5B,A00,507671,Munoz Sanchez; Alicia,9,0,20,11
1715613065821,LISP 5C,A00,507696,Munoz Sanchez; Alicia,9,0,20,11
1715613066846,MAE 197,001,528363,Boechler; Nicholas Sebastia,9998,0,9999,1
1715613067871,MATH 197,001,523477,Kedlaya; Kiran S.,9994,0,9999,5
1715613067871,MATH 197,002,563811,Zhang; Danna,9994,0,9999,5
1715613067871,MATH 197,003,628552,Dumitriu; Ioana,9998,0,9999,1
1715613067871,MATH 197,004,660885,Floyd; Eric,9999,0,9999,0
1715613068899,MCWP 40R,A00,518780,Staff,2,0,20,18
1715613068899,MCWP 40R,B00,518781,Staff,11,0,20,9
1715613068899,MCWP 40R,C00,518783,Staff,5,0,20,15
1715613069929,MCWP 50R,A00,518791,Staff,0,1,20,20
1715613069929,MCWP 50R,B00,518792,Staff,0,2,20,20
1715613069929,MCWP 50R,C00,518793,Staff,0,4,20,20
1715613069929,MCWP 50R,D00,518794,Staff,0,1,20,20
1715613069929,MCWP 50R,E00,518795,Staff,0,2,20,20
1715613069929,MCWP 50R,F00,518796,Staff,0,1,20,20
1715613069929,MCWP 50R,G00,518797,Staff,0,1,20,20
1715613070954,MMW 12R,A01,514034,Herbst; Matthew,0,2,16,16
1715613070954,MMW 12R,A02,514035,Herbst; Matthew,0,0,16,16
1715613071983,MMW 13R,A01,514037,Staff,0,5,16,16
1715613071983,MMW 13R,A02,514039,Staff,0,5,16,16
1715613071983,MMW 13R,A03,628519,Staff,0,4,16,16
1715613074039,SIO 295LS,A00,523233,Staff,10,0,30,20
1715613075067,SIO 295S,A00,523232,Staff,10,0,30,20
1715613076093,SIOC 290S,A01,637330,Merrifield; Mark A,23,0,30,7
1715613077118,SIOC 291S,A01,637333,Gabriel; Corey John,23,0,30,7
1715613078145,SOCI 117,A01,494376,Staff,0,5,5,5
1715613079170,WES 237B,A00,494380,Staff,10,0,20,10
1715613081248,AESE 279B,A00,494370,Wade; Jon P,0,0,33,33
1715613082273,AIP 97,001,660915,Van Den Einde; Yael Dahlia,9999,0,9999,0
1715613083303,AIP 197,001,627712,Vespa; Emanuel Ignacio,9995,0,9999,4
1715613083303,AIP 197,002,650778,Amir; On,9998,0,9999,1
1715613083303,AIP 197,003,650933,Avenancio-Leon; Carlos,9998,0,9999,1
1715613083303,AIP 197,004,658530,Heyman; Gail D.,9998,0,9999,1
1715613083303,AIP 197,005,658631,Neal; Sonya E,9998,0,9999,1
1715613083303,AIP 197,006,658671,Du; Songzi,9998,0,9999,1
1715613084328,ANAR 135S,A00,494369,Braswell; Geoffrey E.,0,0,0,0
1715613085356,BENG 196,001,628496,Engler; Adam J.,9998,0,9999,1
1715613085356,BENG 196,002,660916,Watson; John Thomas,9999,0,9999,0
1715613086384,BISP 197,001,650773,Wilhelm; James E.,9994,0,9999,5
1715613086384,BISP 197,002,658904,Coleman; Aaron B.,9998,0,9999,1
1715613087410,CAT 124RS,A01,519847,Geibel; William,0,0,20,20
1715613088439,CAT 125RS,A01,515971,Geibel; William,0,0,20,20
1715613089467,CLRE 250,A00,511389,Morris; Sheldon,9992,0,9999,7
1715613090492,CLRE 251,A00,507176,Mehta; Ravindra L.,9992,0,9999,7
1715613090492,CLRE 251,B00,511410,Mehta; Ravindra L.,9998,0,9999,1
1715613091517,CLRE 252,A00,507189,Cuomo; Raphael Eduardo,9994,0,9999,5
1715613092542,CLRE 253,A00,507199,Vaida; Florin,9994,0,9999,5
1715613092542,CLRE 253,B00,507202,Vaida; Florin,9999,0,9999,0
1715613093566,CLRE 259,A00,507211,Patel; Hemal,9996,0,9999,3
1715613094591,CLRE 260,A00,507221,Cuomo; Raphael Eduardo,9999,0,9999,0
1715613095617,CLRE 297,001,507242,Cuomo; Raphael Eduardo,9999,0,9999,0
1715613096641,COGS 197,001,638244,Voytek; Bradley Thomas,9997,0,9999,2
1715613097666,CSE 191,A00,516875,Minnes Kemp; Mor Mia,9991,0,9999,8
1715613098694,CSE 197,001,637388,Minnes Kemp; Mor Mia,9992,0,9999,7
1715613099721,CSS 201S,A01,494383,Mignozzetti; Umberto,35,0,35,0
1715613100747,CSS 202S,A01,494387,Mignozzetti; Umberto,35,0,35,0
1715613101776,DSC 197,001,628532,Eldridge; Justin Matthew,9995,0,9999,4
1715613102802,EAP 100,A00,516065,Staff,9799,0,9999,200
1715613103826,ECE 45,A01,507414,Staff,31,0,60,29
1715613105879,ECE 111,A01,507420,Staff,11,0,50,39
1715613106904,ECE 197,001,548057,Sievenpiper; Daniel F.,9991,0,9999,8
1715613107929,EDS 115,A00,507243,Choi; Bailey Miyeon,7,0,28,21
1715613108953,EDS 117,A01,494379,Staff,0,6,34,34
1715613109982,EDS 125,A00,507246,Hopkins; Megan Beth,8,0,30,22
1715613111008,EDS 128A,A01,507264,Fargason; Sharon Gayle,6,0,26,20
1715613112034,EDS 128B,A01,507293,Pappas; Elizabeth,10,0,30,20
1715613113061,EDS 139,A00,507294,Fargason; Sharon Gayle,10,0,30,20
1715613113061,EDS 139,B00,507313,Pappas; Elizabeth,11,0,30,19
1715613114087,EDS 201,A00,507315,Staff,10,0,30,20
1715613115115,EDS 203,A01,507317,Halter; Christopher P.,10,0,30,20
1715613116141,EDS 204R,A01,507319,Halter; Christopher P.,0,3,30,30
1715613116141,EDS 204R,B01,507331,Heinzman; Erica M.,14,0,30,16
1715613117169,EDS 206R,A00,507332,Staff,0,4,30,30
1715613117169,EDS 206R,B00,507343,Staff,15,0,30,15
1715613118194,EDS 250,A00,507344,Hemans; Patricia Ann Benitez,20,0,40,20
1715613119222,EDS 281,A00,507345,Daly; Alan J.,18,0,18,0
1715613120246,EDS 284,A00,507350,Daly; Alan J.,16,0,16,0
1715613121269,EDS 286,A00,507359,Fine; Sarah,18,0,18,0
1715613122295,EDS 289C,A01,507361,Daly; Alan J.,18,0,18,0
1715613123324,EDS 290,A00,507366,Hofstetter; Carolyn,15,0,15,0
1715613124349,LIGM 5A,A00,507421,Fischer-Grunski; Eva K,17,0,20,3
1715613125433,LIGM 5B,A00,507423,Fischer-Grunski; Eva K,19,0,20,1
1715613126464,LIGM 5C,A00,507425,Fischer-Grunski; Eva K,19,0,20,1
1715613127495,LIIT 5AS,A00,507427,Carnelos; Chiara,20,0,20,0
1715613128524,LIIT 5BS,A00,507430,Carnelos; Chiara,20,0,20,0
1715613129551,LIIT 5CS,A00,507432,Carnelos; Chiara,20,0,20,0
1715613130577,LISP 5A,A00,507541,Munoz Sanchez; Alicia,11,0,20,9
1715613131605,LISP 5B,A00,507671,Munoz Sanchez; Alicia,9,0,20,11
1715613132628,LISP 5C,A00,507696,Munoz Sanchez; Alicia,9,0,20,11
1715613133655,MAE 197,001,528363,Boechler; Nicholas Sebastia,9998,0,9999,1
1715613134684,MATH 197,001,523477,Kedlaya; Kiran S.,9994,0,9999,5
1715613134684,MATH 197,002,563811,Zhang; Danna,9994,0,9999,5
1715613134684,MATH 197,003,628552,Dumitriu; Ioana,9998,0,9999,1
1715613134684,MATH 197,004,660885,Floyd; Eric,9999,0,9999,0
1715613135711,MCWP 40R,A00,518780,Staff,2,0,20,18
1715613135711,MCWP 40R,B00,518781,Staff,11,0,20,9
1715613135711,MCWP 40R,C00,518783,Staff,5,0,20,15
1715613136737,MCWP 50R,A00,518791,Staff,0,1,20,20
1715613136737,MCWP 50R,B00,518792,Staff,0,2,20,20
1715613136737,MCWP 50R,C00,518793,Staff,0,4,20,20
1715613136737,MCWP 50R,D00,518794,Staff,0,1,20,20
1715613136737,MCWP 50R,E00,518795,Staff,0,2,20,20
1715613136737,MCWP 50R,F00,518796,Staff,0,1,20,20
1715613136737,MCWP 50R,G00,518797,Staff,0,1,20,20
1715613137764,MMW 12R,A01,514034,Herbst; Matthew,0,2,16,16
1715613137764,MMW 12R,A02,514035,Herbst; Matthew,0,0,16,16
1715613138788,MMW 13R,A01,514037,Staff,0,5,16,16
1715613138788,MMW 13R,A02,514039,Staff,0,5,16,16
1715613138788,MMW 13R,A03,628519,Staff,0,4,16,16
1715613140839,SIO 295LS,A00,523233,Staff,10,0,30,20
1715613141863,SIO 295S,A00,523232,Staff,10,0,30,20
1715613142892,SIOC 290S,A01,637330,Merrifield; Mark A,23,0,30,7
1715613143916,SIOC 291S,A01,637333,Gabriel; Corey John,23,0,30,7
1715613144939,SOCI 117,A01,494376,Staff,0,5,5,5
1715613145962,WES 237B,A00,494380,Staff,10,0,20,10
1715613148031,AESE 279B,A00,494370,Wade; Jon P,0,0,33,33
1715613149056,AIP 97,001,660915,Van Den Einde; Yael Dahlia,9999,0,9999,0
1715613150086,AIP 197,001,627712,Vespa; Emanuel Ignacio,9995,0,9999,4
1715613150086,AIP 197,002,650778,Amir; On,9998,0,9999,1
1715613150086,AIP 197,003,650933,Avenancio-Leon; Carlos,9998,0,9999,1
1715613150086,AIP 197,004,658530,Heyman; Gail D.,9998,0,9999,1
1715613150086,AIP 197,005,658631,Neal; Sonya E,9998,0,9999,1
1715613150086,AIP 197,006,658671,Du; Songzi,9998,0,9999,1
1715613151114,ANAR 135S,A00,494369,Braswell; Geoffrey E.,0,0,0,0
1715613152138,BENG 196,001,628496,Engler; Adam J.,9998,0,9999,1
1715613152138,BENG 196,002,660916,Watson; John Thomas,9999,0,9999,0
1715613153168,BISP 197,001,650773,Wilhelm; James E.,9994,0,9999,5
1715613153168,BISP 197,002,658904,Coleman; Aaron B.,9998,0,9999,1
1715613154215,CAT 124RS,A01,519847,Geibel; William,0,0,20,20
1715613155240,CAT 125RS,A01,515971,Geibel; William,0,0,20,20
1715613156266,CLRE 250,A00,511389,Morris; Sheldon,9992,0,9999,7
1715613157292,CLRE 251,A00,507176,Mehta; Ravindra L.,9992,0,9999,7
1715613157292,CLRE 251,B00,511410,Mehta; Ravindra L.,9998,0,9999,1
1715613158321,CLRE 252,A00,507189,Cuomo; Raphael Eduardo,9994,0,9999,5
1715613159347,CLRE 253,A00,507199,Vaida; Florin,9994,0,9999,5
1715613159347,CLRE 253,B00,507202,Vaida; Florin,9999,0,9999,0
1715613160373,CLRE 259,A00,507211,Patel; Hemal,9996,0,9999,3
1715613161399,CLRE 260,A00,507221,Cuomo; Raphael Eduardo,9999,0,9999,0
1715613162423,CLRE 297,001,507242,Cuomo; Raphael Eduardo,9999,0,9999,0
1715613163451,COGS 197,001,638244,Voytek; Bradley Thomas,9997,0,9999,2
1715613164479,CSE 191,A00,516875,Minnes Kemp; Mor Mia,9991,0,9999,8
1715613165507,CSE 197,001,637388,Minnes Kemp; Mor Mia,9992,0,9999,7
1715613166537,CSS 201S,A01,494383,Mignozzetti; Umberto,35,0,35,0
1715613167563,CSS 202S,A01,494387,Mignozzetti; Umberto,35,0,35,0
1715613168591,DSC 197,001,628532,Eldridge; Justin Matthew,9995,0,9999,4
1715613169616,EAP 100,A00,516065,Staff,9799,0,9999,200
1715613170642,ECE 45,A01,507414,Staff,31,0,60,29
1715613172693,ECE 111,A01,507420,Staff,11,0,50,39
1715613173719,ECE 197,001,548057,Sievenpiper; Daniel F.,9991,0,9999,8
1715613174745,EDS 115,A00,507243,Choi; Bailey Miyeon,7,0,28,21
1715613175771,EDS 117,A01,494379,Staff,0,6,34,34
1715613176797,EDS 125,A00,507246,Hopkins; Megan Beth,8,0,30,22
1715613177821,EDS 128A,A01,507264,Fargason; Sharon Gayle,6,0,26,20
1715613178852,EDS 128B,A01,507293,Pappas; Elizabeth,10,0,30,20
1715613179882,EDS 139,A00,507294,Fargason; Sharon Gayle,10,0,30,20
1715613179882,EDS 139,B00,507313,Pappas; Elizabeth,11,0,30,19
1715613180911,EDS 201,A00,507315,Staff,10,0,30,20
1715613181940,EDS 203,A01,507317,Halter; Christopher P.,10,0,30,20
1715613182968,EDS 204R,A01,507319,Halter; Christopher P.,0,3,30,30
1715613182968,EDS 204R,B01,507331,Heinzman; Erica M.,14,0,30,16
1715613183996,EDS 206R,A00,507332,Staff,0,4,30,30
1715613183996,EDS 206R,B00,507343,Staff,15,0,30,15
1715613185022,EDS 250,A00,507344,Hemans; Patricia Ann Benitez,20,0,40,20
1715613186051,EDS 281,A00,507345,Daly; Alan J.,18,0,18,0
1715613187079,EDS 284,A00,507350,Daly; Alan J.,16,0,16,0
1715613188106,EDS 286,A00,507359,Fine; Sarah,18,0,18,0
1715613189133,EDS 289C,A01,507361,Daly; Alan J.,18,0,18,0
1715613190161,EDS 290,A00,507366,Hofstetter; Carolyn,15,0,15,0
1715613191187,LIGM 5A,A00,507421,Fischer-Grunski; Eva K,17,0,20,3
1715613192216,LIGM 5B,A00,507423,Fischer-Grunski; Eva K,19,0,20,1
1715613193243,LIGM 5C,A00,507425,Fischer-Grunski; Eva K,19,0,20,1
1715613194273,LIIT 5AS,A00,507427,Carnelos; Chiara,20,0,20,0
1715613195300,LIIT 5BS,A00,507430,Carnelos; Chiara,20,0,20,0
1715613196331,LIIT 5CS,A00,507432,Carnelos; Chiara,20,0,20,0
1715613197362,LISP 5A,A00,507541,Munoz Sanchez; Alicia,11,0,20,9
1715613198399,LISP 5B,A00,507671,Munoz Sanchez; Alicia,9,0,20,11
1715613199426,LISP 5C,A00,507696,Munoz Sanchez; Alicia,9,0,20,11
1715613200452,MAE 197,001,528363,Boechler; Nicholas Sebastia,9998,0,9999,1
1715613201478,MATH 197,001,523477,Kedlaya; Kiran S.,9994,0,9999,5
1715613201478,MATH 197,002,563811,Zhang; Danna,9994,0,9999,5
1715613201478,MATH 197,003,628552,Dumitriu; Ioana,9998,0,9999,1
1715613201478,MATH 197,004,660885,Floyd; Eric,9999,0,9999,0
1715613202505,MCWP 40R,A00,518780,Staff,2,0,20,18
1715613202505,MCWP 40R,B00,518781,Staff,11,0,20,9
1715613202505,MCWP 40R,C00,518783,Staff,5,0,20,15
1715613203539,MCWP 50R,A00,518791,Staff,0,1,20,20
1715613203539,MCWP 50R,B00,518792,Staff,0,2,20,20
1715613203539,MCWP 50R,C00,518793,Staff,0,4,20,20
1715613203539,MCWP 50R,D00,518794,Staff,0,1,20,20
1715613203539,MCWP 50R,E00,518795,Staff,0,2,20,20
1715613203539,MCWP 50R,F00,518796,Staff,0,1,20,20
1715613203539,MCWP 50R,G00,518797,Staff,0,1,20,20
1715613204568,MMW 12R,A01,514034,Herbst; Matthew,0,2,16,16
1715613204568,MMW 12R,A02,514035,Herbst; Matthew,0,0,16,16
1715613205598,MMW 13R,A01,514037,Staff,0,5,16,16
1715613205598,MMW 13R,A02,514039,Staff,0,5,16,16
1715613205598,MMW 13R,A03,628519,Staff,0,4,16,16
1715613207649,SIO 295LS,A00,523233,Staff,10,0,30,20
1715613208677,SIO 295S,A00,523232,Staff,10,0,30,20
1715613209704,SIOC 290S,A01,637330,Merrifield; Mark A,23,0,30,7
1715613210734,SIOC 291S,A01,637333,Gabriel; Corey John,23,0,30,7
1715613211763,SOCI 117,A01,494376,Staff,0,5,5,5
1715613212789,WES 237B,A00,494380,Staff,10,0,20,10
1715613214860,AESE 279B,A00,494370,Wade; Jon P,0,0,33,33
1715613215887,AIP 97,001,660915,Van Den Einde; Yael Dahlia,9999,0,9999,0
1715613216913,AIP 197,001,627712,Vespa; Emanuel Ignacio,9995,0,9999,4
1715613216913,AIP 197,002,650778,Amir; On,9998,0,9999,1
1715613216913,AIP 197,003,650933,Avenancio-Leon; Carlos,9998,0,9999,1
1715613216913,AIP 197,004,658530,Heyman; Gail D.,9998,0,9999,1
1715613216913,AIP 197,005,658631,Neal; Sonya E,9998,0,9999,1
1715613216913,AIP 197,006,658671,Du; Songzi,9998,0,9999,1
1715613217937,ANAR 135S,A00,494369,Braswell; Geoffrey E.,0,0,0,0
1715613218966,BENG 196,001,628496,Engler; Adam J.,9998,0,9999,1
1715613218966,BENG 196,002,660916,Watson; John Thomas,9999,0,9999,0
1715613219993,BISP 197,001,650773,Wilhelm; James E.,9994,0,9999,5
1715613219993,BISP 197,002,658904,Coleman; Aaron B.,9998,0,9999,1
1715613221019,CAT 124RS,A01,519847,Geibel; William,0,0,20,20
1715613222046,CAT 125RS,A01,515971,Geibel; William,0,0,20,20
1715613223074,CLRE 250,A00,511389,Morris; Sheldon,9992,0,9999,7
1715613224101,CLRE 251,A00,507176,Mehta; Ravindra L.,9992,0,9999,7
1715613224101,CLRE 251,B00,511410,Mehta; Ravindra L.,9998,0,9999,1
1715613225130,CLRE 252,A00,507189,Cuomo; Raphael Eduardo,9994,0,9999,5
1715613226154,CLRE 253,A00,507199,Vaida; Florin,9994,0,9999,5
1715613226154,CLRE 253,B00,507202,Vaida; Florin,9999,0,9999,0
1715613227180,CLRE 259,A00,507211,Patel; Hemal,9996,0,9999,3
1715613228207,CLRE 260,A00,507221,Cuomo; Raphael Eduardo,9999,0,9999,0
1715613229234,CLRE 297,001,507242,Cuomo; Raphael Eduardo,9999,0,9999,0
1715613230262,COGS 197,001,638244,Voytek; Bradley Thomas,9997,0,9999,2
1715613231287,CSE 191,A00,516875,Minnes Kemp; Mor Mia,9991,0,9999,8
1715613232312,CSE 197,001,637388,Minnes Kemp; Mor Mia,9992,0,9999,7
1715613233339,CSS 201S,A01,494383,Mignozzetti; Umberto,35,0,35,0
1715613234365,CSS 202S,A01,494387,Mignozzetti; Umberto,35,0,35,0
1715613235394,DSC 197,001,628532,Eldridge; Justin Matthew,9995,0,9999,4
1715613236418,EAP 100,A00,516065,Staff,9799,0,9999,200
1715613237444,ECE 45,A01,507414,Staff,31,0,60,29
1715613239493,ECE 111,A01,507420,Staff,11,0,50,39
1715613240522,ECE 197,001,548057,Sievenpiper; Daniel F.,9991,0,9999,8
1715613241548,EDS 115,A00,507243,Choi; Bailey Miyeon,7,0,28,21
1715613242576,EDS 117,A01,494379,Staff,0,6,34,34
1715613243601,EDS 125,A00,507246,Hopkins; Megan Beth,8,0,30,22
1715613244625,EDS 128A,A01,507264,Fargason; Sharon Gayle,6,0,26,20
1715613245651,EDS 128B,A01,507293,Pappas; Elizabeth,10,0,30,20
1715613246676,EDS 139,A00,507294,Fargason; Sharon Gayle,10,0,30,20
1715613246676,EDS 139,B00,507313,Pappas; Elizabeth,11,0,30,19
1715613247701,EDS 201,A00,507315,Staff,10,0,30,20
1715613248727,EDS 203,A01,507317,Halter; Christopher P.,10,0,30,20
1715613249756,EDS 204R,A01,507319,Halter; Christopher P.,0,3,30,30
1715613249756,EDS 204R,B01,507331,Heinzman; Erica M.,14,0,30,16
1715613250780,EDS 206R,A00,507332,Staff,0,4,30,30
1715613250780,EDS 206R,B00,507343,Staff,15,0,30,15
1715613251805,EDS 250,A00,507344,Hemans; Patricia Ann Benitez,20,0,40,20
1715613252831,EDS 281,A00,507345,Daly; Alan J.,18,0,18,0
1715613253857,EDS 284,A00,507350,Daly; Alan J.,16,0,16,0
1715613254884,EDS 286,A00,507359,Fine; Sarah,18,0,18,0
1715613255910,EDS 289C,A01,507361,Daly; Alan J.,18,0,18,0
1715613256936,EDS 290,A00,507366,Hofstetter; Carolyn,15,0,15,0
1715613257965,LIGM 5A,A00,507421,Fischer-Grunski; Eva K,17,0,20,3
1715613258994,LIGM 5B,A00,507423,Fischer-Grunski; Eva K,19,0,20,1
1715613260020,LIGM 5C,A00,507425,Fischer-Grunski; Eva K,19,0,20,1
1715613261050,LIIT 5AS,A00,507427,Carnelos; Chiara,20,0,20,0
1715613262076,LIIT 5BS,A00,507430,Carnelos; Chiara,20,0,20,0
1715613263105,LIIT 5CS,A00,507432,Carnelos; Chiara,20,0,20,0
1715613264134,LISP 5A,A00,507541,Munoz Sanchez; Alicia,11,0,20,9
1715613265181,LISP 5B,A00,507671,Munoz Sanchez; Alicia,9,0,20,11
1715613266207,LISP 5C,A00,507696,Munoz Sanchez; Alicia,9,0,20,11
1715613267232,MAE 197,001,528363,Boechler; Nicholas Sebastia,9998,0,9999,1
1715613268259,MATH 197,001,523477,Kedlaya; Kiran S.,9994,0,9999,5
1715613268259,MATH 197,002,563811,Zhang; Danna,9994,0,9999,5
1715613268259,MATH 197,003,628552,Dumitriu; Ioana,9998,0,9999,1
1715613268259,MATH 197,004,660885,Floyd; Eric,9999,0,9999,0
1715613269285,MCWP 40R,A00,518780,Staff,2,0,20,18
1715613269285,MCWP 40R,B00,518781,Staff,11,0,20,9
1715613269285,MCWP 40R,C00,518783,Staff,5,0,20,15
1715613270310,MCWP 50R,A00,518791,Staff,0,1,20,20
1715613270310,MCWP 50R,B00,518792,Staff,0,2,20,20
1715613270310,MCWP 50R,C00,518793,Staff,0,4,20,20
1715613270310,MCWP 50R,D00,518794,Staff,0,1,20,20
1715613270310,MCWP 50R,E00,518795,Staff,0,2,20,20
1715613270310,MCWP 50R,F00,518796,Staff,0,1,20,20
1715613270310,MCWP 50R,G00,518797,Staff,0,1,20,20
1715613271339,MMW 12R,A01,514034,Herbst; Matthew,0,2,16,16
1715613271339,MMW 12R,A02,514035,Herbst; Matthew,0,0,16,16
1715613272367,MMW 13R,A01,514037,Staff,0,5,16,16
1715613272367,MMW 13R,A02,514039,Staff,0,5,16,16
1715613272367,MMW 13R,A03,628519,Staff,0,4,16,16
1715613274419,SIO 295LS,A00,523233,Staff,10,0,30,20
1715613275444,SIO 295S,A00,523232,Staff,10,0,30,20
1715613276469,SIOC 290S,A01,637330,Merrifield; Mark A,23,0,30,7
1715613277497,SIOC 291S,A01,637333,Gabriel; Corey John,23,0,30,7
1715613278526,SOCI 117,A01,494376,Staff,0,5,5,5
1715613279550,WES 237B,A00,494380,Staff,10,0,20,10
1715613281607,AESE 279B,A00,494370,Wade; Jon P,0,0,33,33
1715613282642,AIP 97,001,660915,Van Den Einde; Yael Dahlia,9999,0,9999,0
1715613283689,AIP 197,001,627712,Vespa; Emanuel Ignacio,9995,0,9999,4
1715613283689,AIP 197,002,650778,Amir; On,9998,0,9999,1
1715613283689,AIP 197,003,650933,Avenancio-Leon; Carlos,9998,0,9999,1
1715613283689,AIP 197,004,658530,Heyman; Gail D.,9998,0,9999,1
1715613283689,AIP 197,005,658631,Neal; Sonya E,9998,0,9999,1
1715613283689,AIP 197,006,658671,Du; Songzi,9998,0,9999,1
1715613284715,ANAR 135S,A00,494369,Braswell; Geoffrey E.,0,0,0,0
1715613285744,BENG 196,001,628496,Engler; Adam J.,9998,0,9999,1
1715613285744,BENG 196,002,660916,Watson; John Thomas,9999,0,9999,0
1715613286769,BISP 197,001,650773,Wilhelm; James E.,9994,0,9999,5
1715613286769,BISP 197,002,658904,Coleman; Aaron B.,9998,0,9999,1
1715613287793,CAT 124RS,A01,519847,Geibel; William,0,0,20,20
1715613288819,CAT 125RS,A01,515971,Geibel; William,0,0,20,20
1715613289842,CLRE 250,A00,511389,Morris; Sheldon,9992,0,9999,7
1715613290867,CLRE 251,A00,507176,Mehta; Ravindra L.,9992,0,9999,7
1715613290867,CLRE 251,B00,511410,Mehta; Ravindra L.,9998,0,9999,1
1715613291896,CLRE 252,A00,507189,Cuomo; Raphael Eduardo,9994,0,9999,5
1715613292925,CLRE 253,A00,507199,Vaida; Florin,9994,0,9999,5
1715613292925,CLRE 253,B00,507202,Vaida; Florin,9999,0,9999,0
1715613293950,CLRE 259,A00,507211,Patel; Hemal,9996,0,9999,3
1715613294975,CLRE 260,A00,507221,Cuomo; Raphael Eduardo,9999,0,9999,0
1715613296000,CLRE 297,001,507242,Cuomo; Raphael Eduardo,9999,0,9999,0
1715613297024,COGS 197,001,638244,Voytek; Bradley Thomas,9997,0,9999,2
1715613298051,CSE 191,A00,516875,Minnes Kemp; Mor Mia,9991,0,9999,8
1715613299079,CSE 197,001,637388,Minnes Kemp; Mor Mia,9992,0,9999,7
1715613300109,CSS 201S,A01,494383,Mignozzetti; Umberto,35,0,35,0
1715613301140,CSS 202S,A01,494387,Mignozzetti; Umberto,35,0,35,0
1715613302168,DSC 197,001,628532,Eldridge; Justin Matthew,9995,0,9999,4
1715613303197,EAP 100,A00,516065,Staff,9799,0,9999,200
1715613304223,ECE 45,A01,507414,Staff,31,0,60,29
1715613306277,ECE 111,A01,507420,Staff,11,0,50,39
1715613307302,ECE 197,001,548057,Sievenpiper; Daniel F.,9991,0,9999,8
1715613308328,EDS 115,A00,507243,Choi; Bailey Miyeon,7,0,28,21
1715613309355,EDS 117,A01,494379,Staff,0,6,34,34
1715613310384,EDS 125,A00,507246,Hopkins; Megan Beth,8,0,30,22
1715613311417,EDS 128A,A01,507264,Fargason; Sharon Gayle,6,0,26,20
1715613312441,EDS 128B,A01,507293,Pappas; Elizabeth,10,0,30,20
1715613313467,EDS 139,A00,507294,Fargason; Sharon Gayle,10,0,30,20
1715613313467,EDS 139,B00,507313,Pappas; Elizabeth,11,0,30,19
1715613314491,EDS 201,A00,507315,Staff,10,0,30,20
1715613315519,EDS 203,A01,507317,Halter; Christopher P.,10,0,30,20
1715613316543,EDS 204R,A01,507319,Halter; Christopher P.,0,3,30,30
1715613316543,EDS 204R,B01,507331,Heinzman; Erica M.,14,0,30,16
1715613317569,EDS 206R,A00,507332,Staff,0,4,30,30
1715613317569,EDS 206R,B00,507343,Staff,15,0,30,15
1715613318592,EDS 250,A00,507344,Hemans; Patricia Ann Benitez,20,0,40,20
1715613319620,EDS 281,A00,507345,Daly; Alan J.,18,0,18,0
1715613320645,EDS 284,A00,507350,Daly; Alan J.,16,0,16,0
1715613321674,EDS 286,A00,507359,Fine; Sarah,18,0,18,0
1715613322705,EDS 289C,A01,507361,Daly; Alan J.,18,0,18,0
1715613323729,EDS 290,A00,507366,Hofstetter; Carolyn,15,0,15,0
1715613324753,LIGM 5A,A00,507421,Fischer-Grunski; Eva K,17,0,20,3
1715613325777,LIGM 5B,A00,507423,Fischer-Grunski; Eva K,19,0,20,1
1715613326806,LIGM 5C,A00,507425,Fischer-Grunski; Eva K,19,0,20,1
1715613327834,LIIT 5AS,A00,507427,Carnelos; Chiara,20,0,20,0
1715613328863,LIIT 5BS,A00,507430,Carnelos; Chiara,20,0,20,0
1715613329891,LIIT 5CS,A00,507432,Carnelos; Chiara,20,0,20,0
1715613330916,LISP 5A,A00,507541,Munoz Sanchez; Alicia,11,0,20,9
1715613331946,LISP 5B,A00,507671,Munoz Sanchez; Alicia,9,0,20,11
1715613332971,LISP 5C,A00,507696,Munoz Sanchez; Alicia,9,0,20,11
1715613333995,MAE 197,001,528363,Boechler; Nicholas Sebastia,9998,0,9999,1
1715613335021,MATH 197,001,523477,Kedlaya; Kiran S.,9994,0,9999,5
1715613335021,MATH 197,002,563811,Zhang; Danna,9994,0,9999,5
1715613335021,MATH 197,003,628552,Dumitriu; Ioana,9998,0,9999,1
1715613335021,MATH 197,004,660885,Floyd; Eric,9999,0,9999,0
1715613336046,MCWP 40R,A00,518780,Staff,2,0,20,18
1715613336046,MCWP 40R,B00,518781,Staff,11,0,20,9
1715613336046,MCWP 40R,C00,518783,Staff,5,0,20,15
1715613337071,MCWP 50R,A00,518791,Staff,0,1,20,20
1715613337071,MCWP 50R,B00,518792,Staff,0,2,20,20
1715613337071,MCWP 50R,C00,518793,Staff,0,4,20,20
1715613337071,MCWP 50R,D00,518794,Staff,0,1,20,20
1715613337071,MCWP 50R,E00,518795,Staff,0,2,20,20
1715613337071,MCWP 50R,F00,518796,Staff,0,1,20,20
1715613337071,MCWP 50R,G00,518797,Staff,0,1,20,20
1715613338097,MMW 12R,A01,514034,Herbst; Matthew,0,2,16,16
1715613338097,MMW 12R,A02,514035,Herbst; Matthew,0,0,16,16
1715613339121,MMW 13R,A01,514037,Staff,0,5,16,16
1715613339121,MMW 13R,A02,514039,Staff,0,5,16,16
1715613339121,MMW 13R,A03,628519,Staff,0,4,16,16
1715613341173,SIO 295LS,A00,523233,Staff,10,0,30,20
1715613342201,SIO 295S,A00,523232,Staff,10,0,30,20
1715613343233,SIOC 290S,A01,637330,Merrifield; Mark A,23,0,30,7
1715613344262,SIOC 291S,A01,637333,Gabriel; Corey John,23,0,30,7
1715613345291,SOCI 117,A01,494376,Staff,0,5,5,5
1715613346320,WES 237B,A00,494380,Staff,10,0,20,10
1715613348380,AESE 279B,A00,494370,Wade; Jon P,0,0,33,33
1715613349405,AIP 97,001,660915,Van Den Einde; Yael Dahlia,9999,0,9999,0
1715613350433,AIP 197,001,627712,Vespa; Emanuel Ignacio,9995,0,9999,4
1715613350433,AIP 197,002,650778,Amir; On,9998,0,9999,1
1715613350433,AIP 197,003,650933,Avenancio-Leon; Carlos,9998,0,9999,1
1715613350433,AIP 197,004,658530,Heyman; Gail D.,9998,0,9999,1
1715613350433,AIP 197,005,658631,Neal; Sonya E,9998,0,9999,1
1715613350433,AIP 197,006,658671,Du; Songzi,9998,0,9999,1
1715613351458,ANAR 135S,A00,494369,Braswell; Geoffrey E.,0,0,0,0
1715613352485,BENG 196,001,628496,Engler; Adam J.,9998,0,9999,1
1715613352485,BENG 196,002,660916,Watson; John Thomas,9999,0,9999,0
1715613353509,BISP 197,001,650773,Wilhelm; James E.,9994,0,9999,5
1715613353509,BISP 197,002,658904,Coleman; Aaron B.,9998,0,9999,1
1715613354536,CAT 124RS,A01,519847,Geibel; William,0,0,20,20
1715613355565,CAT 125RS,A01,515971,Geibel; William,0,0,20,20
1715613356589,CLRE 250,A00,511389,Morris; Sheldon,9992,0,9999,7
1715613357617,CLRE 251,A00,507176,Mehta; Ravindra L.,9992,0,9999,7
1715613357617,CLRE 251,B00,511410,Mehta; Ravindra L.,9998,0,9999,1
1715613358643,CLRE 252,A00,507189,Cuomo; Raphael Eduardo,9994,0,9999,5
1715613359673,CLRE 253,A00,507199,Vaida; Florin,9994,0,9999,5
1715613359673,CLRE 253,B00,507202,Vaida; Florin,9999,0,9999,0
1715613360703,CLRE 259,A00,507211,Patel; Hemal,9996,0,9999,3
1715613361729,CLRE 260,A00,507221,Cuomo; Raphael Eduardo,9999,0,9999,0
1715613362756,CLRE 297,001,507242,Cuomo; Raphael Eduardo,9999,0,9999,0
1715613363783,COGS 197,001,638244,Voytek; Bradley Thomas,9997,0,9999,2
1715613364809,CSE 191,A00,516875,Minnes Kemp; Mor Mia,9991,0,9999,8
1715613365838,CSE 197,001,637388,Minnes Kemp; Mor Mia,9992,0,9999,7
1715613366866,CSS 201S,A01,494383,Mignozzetti; Umberto,35,0,35,0
1715613367895,CSS 202S,A01,494387,Mignozzetti; Umberto,35,0,35,0
1715613368923,DSC 197,001,628532,Eldridge; Justin Matthew,9995,0,9999,4
1715613369950,EAP 100,A00,516065,Staff,9799,0,9999,200
1715613370980,ECE 45,A01,507414,Staff,31,0,60,29
1715613373032,ECE 111,A01,507420,Staff,11,0,50,39
1715613374058,ECE 197,001,548057,Sievenpiper; Daniel F.,9991,0,9999,8
1715613375083,EDS 115,A00,507243,Choi; Bailey Miyeon,7,0,28,21
1715613376109,EDS 117,A01,494379,Staff,0,6,34,34
1715613377135,EDS 125,A00,507246,Hopkins; Megan Beth,8,0,30,22
1715613378161,EDS 128A,A01,507264,Fargason; Sharon Gayle,6,0,26,20
1715613379191,EDS 128B,A01,507293,Pappas; Elizabeth,10,0,30,20
1715613380219,EDS 139,A00,507294,Fargason; Sharon Gayle,10,0,30,20
1715613380219,EDS 139,B00,507313,Pappas; Elizabeth,11,0,30,19
1715613381248,EDS 201,A00,507315,Staff,10,0,30,20
1715613382274,EDS 203,A01,507317,Halter; Christopher P.,10,0,30,20
1715613383303,EDS 204R,A01,507319,Halter; Christopher P.,0,3,30,30
1715613383303,EDS 204R,B01,507331,Heinzman; Erica M.,14,0,30,16
1715613384330,EDS 206R,A00,507332,Staff,0,4,30,30
1715613384330,EDS 206R,B00,507343,Staff,15,0,30,15
1715613385356,EDS 250,A00,507344,Hemans; Patricia Ann Benitez,20,0,40,20
1715613386383,EDS 281,A00,507345,Daly; Alan J.,18,0,18,0
1715613387408,EDS 284,A00,507350,Daly; Alan J.,16,0,16,0
1715613388434,EDS 286,A00,507359,Fine; Sarah,18,0,18,0
1715613389460,EDS 289C,A01,507361,Daly; Alan J.,18,0,18,0
1715613390486,EDS 290,A00,507366,Hofstetter; Carolyn,15,0,15,0
1715613391513,LIGM 5A,A00,507421,Fischer-Grunski; Eva K,17,0,20,3
1715613392539,LIGM 5B,A00,507423,Fischer-Grunski; Eva K,19,0,20,1
1715613393571,LIGM 5C,A00,507425,Fischer-Grunski; Eva K,19,0,20,1
1715613394597,LIIT 5AS,A00,507427,Carnelos; Chiara,20,0,20,0
1715613395621,LIIT 5BS,A00,507430,Carnelos; Chiara,20,0,20,0
1715613396651,LIIT 5CS,A00,507432,Carnelos; Chiara,20,0,20,0
1715613397675,LISP 5A,A00,507541,Munoz Sanchez; Alicia,11,0,20,9
1715613398707,LISP 5B,A00,507671,Munoz Sanchez; Alicia,9,0,20,11
1715613399739,LISP 5C,A00,507696,Munoz Sanchez; Alicia,9,0,20,11
1715613400764,MAE 197,001,528363,Boechler; Nicholas Sebastia,9998,0,9999,1
1715613401791,MATH 197,001,523477,Kedlaya; Kiran S.,9994,0,9999,5
1715613401791,MATH 197,002,563811,Zhang; Danna,9994,0,9999,5
1715613401791,MATH 197,003,628552,Dumitriu; Ioana,9998,0,9999,1
1715613401791,MATH 197,004,660885,Floyd; Eric,9999,0,9999,0
1715613402816,MCWP 40R,A00,518780,Staff,2,0,20,18
1715613402816,MCWP 40R,B00,518781,Staff,11,0,20,9
1715613402816,MCWP 40R,C00,518783,Staff,5,0,20,15
1715613403976,MCWP 50R,A00,518791,Staff,0,1,20,20
1715613403976,MCWP 50R,B00,518792,Staff,0,2,20,20
1715613403976,MCWP 50R,C00,518793,Staff,0,4,20,20
1715613403976,MCWP 50R,D00,518794,Staff,0,1,20,20
1715613403976,MCWP 50R,E00,518795,Staff,0,2,20,20
1715613403976,MCWP 50R,F00,518796,Staff,0,1,20,20
1715613403976,MCWP 50R,G00,518797,Staff,0,1,20,20
1715613405000,MMW 12R,A01,514034,Herbst; Matthew,0,2,16,16
1715613405000,MMW 12R,A02,514035,Herbst; Matthew,0,0,16,16
1715613406026,MMW 13R,A01,514037,Staff,0,5,16,16
1715613406026,MMW 13R,A02,514039,Staff,0,5,16,16
1715613406026,MMW 13R,A03,628519,Staff,0,4,16,16
1715613408078,SIO 295LS,A00,523233,Staff,10,0,30,20
1715613409107,SIO 295S,A00,523232,Staff,10,0,30,20
1715613410136,SIOC 290S,A01,637330,Merrifield; Mark A,23,0,30,7
1715613411167,SIOC 291S,A01,637333,Gabriel; Corey John,23,0,30,7
1715613412193,SOCI 117,A01,494376,Staff,0,5,5,5
1715613413221,WES 237B,A00,494380,Staff,10,0,20,10
1715613415301,AESE 279B,A00,494370,Wade; Jon P,0,0,33,33
1715613416325,AIP 97,001,660915,Van Den Einde; Yael Dahlia,9999,0,9999,0
1715613417352,AIP 197,001,627712,Vespa; Emanuel Ignacio,9995,0,9999,4
1715613417352,AIP 197,002,650778,Amir; On,9998,0,9999,1
1715613417352,AIP 197,003,650933,Avenancio-Leon; Carlos,9998,0,9999,1
1715613417352,AIP 197,004,658530,Heyman; Gail D.,9998,0,9999,1
1715613417352,AIP 197,005,658631,Neal; Sonya E,9998,0,9999,1
1715613417352,AIP 197,006,658671,Du; Songzi,9998,0,9999,1
1715613418377,ANAR 135S,A00,494369,Braswell; Geoffrey E.,0,0,0,0
1715613419404,BENG 196,001,628496,Engler; Adam J.,9998,0,9999,1
1715613419404,BENG 196,002,660916,Watson; John Thomas,9999,0,9999,0
1715613420430,BISP 197,001,650773,Wilhelm; James E.,9994,0,9999,5
1715613420430,BISP 197,002,658904,Coleman; Aaron B.,9998,0,9999,1
1715613421458,CAT 124RS,A01,519847,Geibel; William,0,0,20,20
1715613422485,CAT 125RS,A01,515971,Geibel; William,0,0,20,20
1715613423513,CLRE 250,A00,511389,Morris; Sheldon,9992,0,9999,7
1715613424538,CLRE 251,A00,507176,Mehta; Ravindra L.,9992,0,9999,7
1715613424538,CLRE 251,B00,511410,Mehta; Ravindra L.,9998,0,9999,1
1715613425563,CLRE 252,A00,507189,Cuomo; Raphael Eduardo,9994,0,9999,5
1715613426590,CLRE 253,A00,507199,Vaida; Florin,9994,0,9999,5
1715613426590,CLRE 253,B00,507202,Vaida; Florin,9999,0,9999,0
1715613427615,CLRE 259,A00,507211,Patel; Hemal,9996,0,9999,3
1715613428644,CLRE 260,A00,507221,Cuomo; Raphael Eduardo,9999,0,9999,0
1715613429670,CLRE 297,001,507242,Cuomo; Raphael Eduardo,9999,0,9999,0
1715613430700,COGS 197,001,638244,Voytek; Bradley Thomas,9997,0,9999,2
1715613431726,CSE 191,A00,516875,Minnes Kemp; Mor Mia,9991,0,9999,8
1715613432754,CSE 197,001,637388,Minnes Kemp; Mor Mia,9992,0,9999,7
1715613433780,CSS 201S,A01,494383,Mignozzetti; Umberto,35,0,35,0
1715613434804,CSS 202S,A01,494387,Mignozzetti; Umberto,35,0,35,0
1715613435832,DSC 197,001,628532,Eldridge; Justin Matthew,9995,0,9999,4
1715613436856,EAP 100,A00,516065,Staff,9799,0,9999,200
1715613437886,ECE 45,A01,507414,Staff,31,0,60,29
1715613439935,ECE 111,A01,507420,Staff,11,0,50,39
1715613440962,ECE 197,001,548057,Sievenpiper; Daniel F.,9991,0,9999,8
1715613441989,EDS 115,A00,507243,Choi; Bailey Miyeon,7,0,28,21
1715613443014,EDS 117,A01,494379,Staff,0,6,34,34
1715613444040,EDS 125,A00,507246,Hopkins; Megan Beth,8,0,30,22
1715613445067,EDS 128A,A01,507264,Fargason; Sharon Gayle,6,0,26,20
1715613446096,EDS 128B,A01,507293,Pappas; Elizabeth,10,0,30,20
1715613447123,EDS 139,A00,507294,Fargason; Sharon Gayle,10,0,30,20
1715613447123,EDS 139,B00,507313,Pappas; Elizabeth,11,0,30,19
1715613448150,EDS 201,A00,507315,Staff,10,0,30,20
1715613449177,EDS 203,A01,507317,Halter; Christopher P.,10,0,30,20
1715613450202,EDS 204R,A01,507319,Halter; Christopher P.,0,3,30,30
1715613450202,EDS 204R,B01,507331,Heinzman; Erica M.,14,0,30,16
1715613451228,EDS 206R,A00,507332,Staff,0,4,30,30
1715613451228,EDS 206R,B00,507343,Staff,15,0,30,15
1715613452255,EDS 250,A00,507344,Hemans; Patricia Ann Benitez,20,0,40,20
1715613453281,EDS 281,A00,507345,Daly; Alan J.,18,0,18,0
1715613454306,EDS 284,A00,507350,Daly; Alan J.,16,0,16,0
1715613455331,EDS 286,A00,507359,Fine; Sarah,18,0,18,0
1715613456356,EDS 289C,A01,507361,Daly; Alan J.,18,0,18,0
1715613457389,EDS 290,A00,507366,Hofstetter; Carolyn,15,0,15,0
1715613458416,LIGM 5A,A00,507421,Fischer-Grunski; Eva K,17,0,20,3
1715613459443,LIGM 5B,A00,507423,Fischer-Grunski; Eva K,19,0,20,1
1715613460468,LIGM 5C,A00,507425,Fischer-Grunski; Eva K,19,0,20,1
1715613461494,LIIT 5AS,A00,507427,Carnelos; Chiara,20,0,20,0
1715613462520,LIIT 5BS,A00,507430,Carnelos; Chiara,20,0,20,0
1715613463550,LIIT 5CS,A00,507432,Carnelos; Chiara,20,0,20,0
1715613464575,LISP 5A,A00,507541,Munoz Sanchez; Alicia,11,0,20,9
1715613465601,LISP 5B,A00,507671,Munoz Sanchez; Alicia,9,0,20,11
1715613466629,LISP 5C,A00,507696,Munoz Sanchez; Alicia,9,0,20,11
1715613467657,MAE 197,001,528363,Boechler; Nicholas Sebastia,9998,0,9999,1
1715613468686,MATH 197,001,523477,Kedlaya; Kiran S.,9994,0,9999,5
1715613468686,MATH 197,002,563811,Zhang; Danna,9994,0,9999,5
1715613468686,MATH 197,003,628552,Dumitriu; Ioana,9998,0,9999,1
1715613468686,MATH 197,004,660885,Floyd; Eric,9999,0,9999,0
1715613469709,MCWP 40R,A00,518780,Staff,2,0,20,18
1715613469709,MCWP 40R,B00,518781,Staff,11,0,20,9
1715613469709,MCWP 40R,C00,518783,Staff,5,0,20,15
1715613470738,MCWP 50R,A00,518791,Staff,0,1,20,20
1715613470738,MCWP 50R,B00,518792,Staff,0,2,20,20
1715613470738,MCWP 50R,C00,518793,Staff,0,4,20,20
1715613470738,MCWP 50R,D00,518794,Staff,0,1,20,20
1715613470738,MCWP 50R,E00,518795,Staff,0,2,20,20
1715613470738,MCWP 50R,F00,518796,Staff,0,1,20,20
1715613470738,MCWP 50R,G00,518797,Staff,0,1,20,20
1715613471764,MMW 12R,A01,514034,Herbst; Matthew,0,2,16,16
1715613471764,MMW 12R,A02,514035,Herbst; Matthew,0,0,16,16
1715613472794,MMW 13R,A01,514037,Staff,0,5,16,16
1715613472794,MMW 13R,A02,514039,Staff,0,5,16,16
1715613472794,MMW 13R,A03,628519,Staff,0,4,16,16
1715613474851,SIO 295LS,A00,523233,Staff,10,0,30,20
1715613475877,SIO 295S,A00,523232,Staff,10,0,30,20
1715613476903,SIOC 290S,A01,637330,Merrifield; Mark A,23,0,30,7
1715613477930,SIOC 291S,A01,637333,Gabriel; Corey John,23,0,30,7
1715613478953,SOCI 117,A01,494376,Staff,0,5,5,5
1715613479981,WES 237B,A00,494380,Staff,10,0,20,10
1715613482041,AESE 279B,A00,494370,Wade; Jon P,0,0,33,33
1715613483069,AIP 97,001,660915,Van Den Einde; Yael Dahlia,9999,0,9999,0
1715613484097,AIP 197,001,627712,Vespa; Emanuel Ignacio,9995,0,9999,4
1715613484097,AIP 197,002,650778,Amir; On,9998,0,9999,1
1715613484097,AIP 197,003,650933,Avenancio-Leon; Carlos,9998,0,9999,1
1715613484097,AIP 197,004,658530,Heyman; Gail D.,9998,0,9999,1
1715613484097,AIP 197,005,658631,Neal; Sonya E,9998,0,9999,1
1715613484097,AIP 197,006,658671,Du; Songzi,9998,0,9999,1
1715613485124,ANAR 135S,A00,494369,Braswell; Geoffrey E.,0,0,0,0
1715613486152,BENG 196,001,628496,Engler; Adam J.,9998,0,9999,1
1715613486152,BENG 196,002,660916,Watson; John Thomas,9999,0,9999,0
1715613487181,BISP 197,001,650773,Wilhelm; James E.,9994,0,9999,5
1715613487181,BISP 197,002,658904,Coleman; Aaron B.,9998,0,9999,1
1715613488211,CAT 124RS,A01,519847,Geibel; William,0,0,20,20
1715613489242,CAT 125RS,A01,515971,Geibel; William,0,0,20,20
1715613490270,CLRE 250,A00,511389,Morris; Sheldon,9992,0,9999,7
1715613491296,CLRE 251,A00,507176,Mehta; Ravindra L.,9992,0,9999,7
1715613491296,CLRE 251,B00,511410,Mehta; Ravindra L.,9998,0,9999,1
1715613492322,CLRE 252,A00,507189,Cuomo; Raphael Eduardo,9994,0,9999,5
1715613493354,CLRE 253,A00,507199,Vaida; Florin,9994,0,9999,5
1715613493354,CLRE 253,B00,507202,Vaida; Florin,9999,0,9999,0
1715613494383,CLRE 259,A00,507211,Patel; Hemal,9996,0,9999,3
1715613495410,CLRE 260,A00,507221,Cuomo; Raphael Eduardo,9999,0,9999,0
1715613496435,CLRE 297,001,507242,Cuomo; Raphael Eduardo,9999,0,9999,0
1715613497461,COGS 197,001,638244,Voytek; Bradley Thomas,9997,0,9999,2
1715613498487,CSE 191,A00,516875,Minnes Kemp; Mor Mia,9991,0,9999,8
1715613499516,CSE 197,001,637388,Minnes Kemp; Mor Mia,9992,0,9999,7
1715613500544,CSS 201S,A01,494383,Mignozzetti; Umberto,35,0,35,0
1715613501571,CSS 202S,A01,494387,Mignozzetti; Umberto,35,0,35,0
1715613502596,DSC 197,001,628532,Eldridge; Justin Matthew,9995,0,9999,4
1715613503626,EAP 100,A00,516065,Staff,9799,0,9999,200
1715613504652,ECE 45,A01,507414,Staff,31,0,60,29
1715613506706,ECE 111,A01,507420,Staff,11,0,50,39
1715613507733,ECE 197,001,548057,Sievenpiper; Daniel F.,9991,0,9999,8
1715613508758,EDS 115,A00,507243,Choi; Bailey Miyeon,7,0,28,21
1715613509783,EDS 117,A01,494379,Staff,0,6,34,34
1715613510813,EDS 125,A00,507246,Hopkins; Megan Beth,8,0,30,22
1715613511842,EDS 128A,A01,507264,Fargason; Sharon Gayle,6,0,26,20
1715613512867,EDS 128B,A01,507293,Pappas; Elizabeth,10,0,30,20
1715613513899,EDS 139,A00,507294,Fargason; Sharon Gayle,10,0,30,20
1715613513899,EDS 139,B00,507313,Pappas; Elizabeth,11,0,30,19
1715613514926,EDS 201,A00,507315,Staff,10,0,30,20
1715613515950,EDS 203,A01,507317,Halter; Christopher P.,10,0,30,20
1715613516977,EDS 204R,A01,507319,Halter; Christopher P.,0,3,30,30
1715613516977,EDS 204R,B01,507331,Heinzman; Erica M.,14,0,30,16
1715613518005,EDS 206R,A00,507332,Staff,0,4,30,30
1715613518005,EDS 206R,B00,507343,Staff,15,0,30,15
1715613519031,EDS 250,A00,507344,Hemans; Patricia Ann Benitez,20,0,40,20
1715613520059,EDS 281,A00,507345,Daly; Alan J.,18,0,18,0
1715613521088,EDS 284,A00,507350,Daly; Alan J.,16,0,16,0
1715613522117,EDS 286,A00,507359,Fine; Sarah,18,0,18,0
1715613523143,EDS 289C,A01,507361,Daly; Alan J.,18,0,18,0
1715613524170,EDS 290,A00,507366,Hofstetter; Carolyn,15,0,15,0
1715613525198,LIGM 5A,A00,507421,Fischer-Grunski; Eva K,17,0,20,3
1715613526225,LIGM 5B,A00,507423,Fischer-Grunski; Eva K,19,0,20,1
1715613527256,LIGM 5C,A00,507425,Fischer-Grunski; Eva K,19,0,20,1
1715613528283,LIIT 5AS,A00,507427,Carnelos; Chiara,20,0,20,0
1715613529314,LIIT 5BS,A00,507430,Carnelos; Chiara,20,0,20,0
1715613530345,LIIT 5CS,A00,507432,Carnelos; Chiara,20,0,20,0
1715613531375,LISP 5A,A00,507541,Munoz Sanchez; Alicia,11,0,20,9
1715613532402,LISP 5B,A00,507671,Munoz Sanchez; Alicia,9,0,20,11
1715613533431,LISP 5C,A00,507696,Munoz Sanchez; Alicia,9,0,20,11
1715613534457,MAE 197,001,528363,Boechler; Nicholas Sebastia,9998,0,9999,1
1715613535488,MATH 197,001,523477,Kedlaya; Kiran S.,9994,0,9999,5
1715613535488,MATH 197,002,563811,Zhang; Danna,9994,0,9999,5
1715613535488,MATH 197,003,628552,Dumitriu; Ioana,9998,0,9999,1
1715613535488,MATH 197,004,660885,Floyd; Eric,9999,0,9999,0
1715613536512,MCWP 40R,A00,518780,Staff,2,0,20,18
1715613536512,MCWP 40R,B00,518781,Staff,11,0,20,9
1715613536512,MCWP 40R,C00,518783,Staff,5,0,20,15
1715613537547,MCWP 50R,A00,518791,Staff,0,1,20,20
1715613537547,MCWP 50R,B00,518792,Staff,0,2,20,20
1715613537547,MCWP 50R,C00,518793,Staff,0,4,20,20
1715613537547,MCWP 50R,D00,518794,Staff,0,1,20,20
1715613537547,MCWP 50R,E00,518795,Staff,0,2,20,20
1715613537547,MCWP 50R,F00,518796,Staff,0,1,20,20
1715613537547,MCWP 50R,G00,518797,Staff,0,1,20,20
1715613538632,MMW 12R,A01,514034,Herbst; Matthew,0,2,16,16
1715613538632,MMW 12R,A02,514035,Herbst; Matthew,0,0,16,16
1715613539660,MMW 13R,A01,514037,Staff,0,5,16,16
1715613539660,MMW 13R,A02,514039,Staff,0,5,16,16
1715613539660,MMW 13R,A03,628519,Staff,0,4,16,16
1715613541714,SIO 295LS,A00,523233,Staff,10,0,30,20
1715613542739,SIO 295S,A00,523232,Staff,10,0,30,20
1715613543767,SIOC 290S,A01,637330,Merrifield; Mark A,23,0,30,7
1715613544796,SIOC 291S,A01,637333,Gabriel; Corey John,23,0,30,7
1715613545823,SOCI 117,A01,494376,Staff,0,5,5,5
1715613546850,WES 237B,A00,494380,Staff,10,0,20,10
1715613548921,AESE 279B,A00,494370,Wade; Jon P,0,0,33,33
1715613549946,AIP 97,001,660915,Van Den Einde; Yael Dahlia,9999,0,9999,0
1715613550974,AIP 197,001,627712,Vespa; Emanuel Ignacio,9995,0,9999,4
1715613550974,AIP 197,002,650778,Amir; On,9998,0,9999,1
1715613550974,AIP 197,003,650933,Avenancio-Leon; Carlos,9998,0,9999,1
1715613550974,AIP 197,004,658530,Heyman; Gail D.,9998,0,9999,1
1715613550974,AIP 197,005,658631,Neal; Sonya E,9998,0,9999,1
1715613550974,AIP 197,006,658671,Du; Songzi,9998,0,9999,1
1715613552001,ANAR 135S,A00,494369,Braswell; Geoffrey E.,0,0,0,0
1715613553030,BENG 196,001,628496,Engler; Adam J.,9998,0,9999,1
1715613553030,BENG 196,002,660916,Watson; John Thomas,9999,0,9999,0
1715613554059,BISP 197,001,650773,Wilhelm; James E.,9994,0,9999,5
1715613554059,BISP 197,002,658904,Coleman; Aaron B.,9998,0,9999,1
1715613555084,CAT 124RS,A01,519847,Geibel; William,0,0,20,20
1715613556113,CAT 125RS,A01,515971,Geibel; William,0,0,20,20
1715613557138,CLRE 250,A00,511389,Morris; Sheldon,9992,0,9999,7
1715613558164,CLRE 251,A00,507176,Mehta; Ravindra L.,9992,0,9999,7
1715613558164,CLRE 251,B00,511410,Mehta; Ravindra L.,9998,0,9999,1
1715613559195,CLRE 252,A00,507189,Cuomo; Raphael Eduardo,9994,0,9999,5
1715613560224,CLRE 253,A00,507199,Vaida; Florin,9994,0,9999,5
1715613560224,CLRE 253,B00,507202,Vaida; Florin,9999,0,9999,0
1715613561252,CLRE 259,A00,507211,Patel; Hemal,9996,0,9999,3
1715613562281,CLRE 260,A00,507221,Cuomo; Raphael Eduardo,9999,0,9999,0
1715613563306,CLRE 297,001,507242,Cuomo; Raphael Eduardo,9999,0,9999,0
1715613564334,COGS 197,001,638244,Voytek; Bradley Thomas,9997,0,9999,2
1715613565360,CSE 191,A00,516875,Minnes Kemp; Mor Mia,9991,0,9999,8
1715613566385,CSE 197,001,637388,Minnes Kemp; Mor Mia,9992,0,9999,7
1715613567413,CSS 201S,A01,494383,Mignozzetti; Umberto,35,0,35,0
1715613568438,CSS 202S,A01,494387,Mignozzetti; Umberto,35,0,35,0
1715613569463,DSC 197,001,628532,Eldridge; Justin Matthew,9995,0,9999,4
1715613570491,EAP 100,A00,516065,Staff,9799,0,9999,200
1715613571522,ECE 45,A01,507414,Staff,31,0,60,29
1715613573575,ECE 111,A01,507420,Staff,11,0,50,39
1715613574603,ECE 197,001,548057,Sievenpiper; Daniel F.,9991,0,9999,8
1715613575628,EDS 115,A00,507243,Choi; Bailey Miyeon,7,0,28,21
1715613576655,EDS 117,A01,494379,Staff,0,6,34,34
1715613577684,EDS 125,A00,507246,Hopkins; Megan Beth,8,0,30,22
1715613578709,EDS 128A,A01,507264,Fargason; Sharon Gayle,6,0,26,20
1715613579732,EDS 128B,A01,507293,Pappas; Elizabeth,10,0,30,20
1715613580761,EDS 139,A00,507294,Fargason; Sharon Gayle,10,0,30,20
1715613580761,EDS 139,B00,507313,Pappas; Elizabeth,11,0,30,19
1715613581786,EDS 201,A00,507315,Staff,10,0,30,20
1715613582811,EDS 203,A01,507317,Halter; Christopher P.,10,0,30,20
1715613583837,EDS 204R,A01,507319,Halter; Christopher P.,0,3,30,30
1715613583837,EDS 204R,B01,507331,Heinzman; Erica M.,14,0,30,16
1715613584865,EDS 206R,A00,507332,Staff,0,4,30,30
1715613584865,EDS 206R,B00,507343,Staff,15,0,30,15
1715613585893,EDS 250,A00,507344,Hemans; Patricia Ann Benitez,20,0,40,20
1715613586920,EDS 281,A00,507345,Daly; Alan J.,18,0,18,0
1715613588019,EDS 284,A00,507350,Daly; Alan J.,16,0,16,0
1715613589047,EDS 286,A00,507359,Fine; Sarah,18,0,18,0
1715613590074,EDS 289C,A01,507361,Daly; Alan J.,18,0,18,0
1715613591099,EDS 290,A00,507366,Hofstetter; Carolyn,15,0,15,0
1715613592125,LIGM 5A,A00,507421,Fischer-Grunski; Eva K,17,0,20,3
1715613593153,LIGM 5B,A00,507423,Fischer-Grunski; Eva K,19,0,20,1
1715613594183,LIGM 5C,A00,507425,Fischer-Grunski; Eva K,19,0,20,1
1715613595210,LIIT 5AS,A00,507427,Carnelos; Chiara,20,0,20,0
1715613596236,LIIT 5BS,A00,507430,Carnelos; Chiara,20,0,20,0
1715613597262,LIIT 5CS,A00,507432,Carnelos; Chiara,20,0,20,0
1715613598290,LISP 5A,A00,507541,Munoz Sanchez; Alicia,11,0,20,9
1715613599320,LISP 5B,A00,507671,Munoz Sanchez; Alicia,9,0,20,11
1715613600349,LISP 5C,A00,507696,Munoz Sanchez; Alicia,9,0,20,11
1715613601381,MAE 197,001,528363,Boechler; Nicholas Sebastia,9998,0,9999,1
1715613602409,MATH 197,001,523477,Kedlaya; Kiran S.,9994,0,9999,5
1715613602409,MATH 197,002,563811,Zhang; Danna,9994,0,9999,5
1715613602409,MATH 197,003,628552,Dumitriu; Ioana,9998,0,9999,1
1715613602409,MATH 197,004,660885,Floyd; Eric,9999,0,9999,0
1715613603436,MCWP 40R,A00,518780,Staff,2,0,20,18
1715613603436,MCWP 40R,B00,518781,Staff,11,0,20,9
1715613603436,MCWP 40R,C00,518783,Staff,5,0,20,15
1715613604467,MCWP 50R,A00,518791,Staff,0,1,20,20
1715613604467,MCWP 50R,B00,518792,Staff,0,2,20,20
1715613604467,MCWP 50R,C00,518793,Staff,0,4,20,20
1715613604467,MCWP 50R,D00,518794,Staff,0,1,20,20
1715613604467,MCWP 50R,E00,518795,Staff,0,2,20,20
1715613604467,MCWP 50R,F00,518796,Staff,0,1,20,20
1715613604467,MCWP 50R,G00,518797,Staff,0,1,20,20
1715613605493,MMW 12R,A01,514034,Herbst; Matthew,0,2,16,16
1715613605493,MMW 12R,A02,514035,Herbst; Matthew,0,0,16,16
1715613606522,MMW 13R,A01,514037,Staff,0,5,16,16
1715613606522,MMW 13R,A02,514039,Staff,0,5,16,16
1715613606522,MMW 13R,A03,628519,Staff,0,4,16,16
1715613608572,SIO 295LS,A00,523233,Staff,10,0,30,20
1715613609599,SIO 295S,A00,523232,Staff,10,0,30,20
1715613610632,SIOC 290S,A01,637330,Merrifield; Mark A,23,0,30,7
1715613611661,SIOC 291S,A01,637333,Gabriel; Corey John,23,0,30,7
1715613612688,SOCI 117,A01,494376,Staff,0,5,5,5
1715613613712,WES 237B,A00,494380,Staff,10,0,20,10
1715613615782,AESE 279B,A00,494370,Wade; Jon P,0,0,33,33
1715613616809,AIP 97,001,660915,Van Den Einde; Yael Dahlia,9999,0,9999,0
1715613617840,AIP 197,001,627712,Vespa; Emanuel Ignacio,9995,0,9999,4
1715613617840,AIP 197,002,650778,Amir; On,9998,0,9999,1
1715613617840,AIP 197,003,650933,Avenancio-Leon; Carlos,9998,0,9999,1
1715613617840,AIP 197,004,658530,Heyman; Gail D.,9998,0,9999,1
1715613617840,AIP 197,005,658631,Neal; Sonya E,9998,0,9999,1
1715613617840,AIP 197,006,658671,Du; Songzi,9998,0,9999,1
1715613618869,ANAR 135S,A00,494369,Braswell; Geoffrey E.,0,0,0,0
1715613619891,BENG 196,001,628496,Engler; Adam J.,9998,0,9999,1
1715613619891,BENG 196,002,660916,Watson; John Thomas,9999,0,9999,0
1715613620916,BISP 197,001,650773,Wilhelm; James E.,9994,0,9999,5
1715613620916,BISP 197,002,658904,Coleman; Aaron B.,9998,0,9999,1
1715613621943,CAT 124RS,A01,519847,Geibel; William,0,0,20,20
1715613622967,CAT 125RS,A01,515971,Geibel; William,0,0,20,20
1715613623993,CLRE 250,A00,511389,Morris; Sheldon,9992,0,9999,7
1715613625021,CLRE 251,A00,507176,Mehta; Ravindra L.,9992,0,9999,7
1715613625021,CLRE 251,B00,511410,Mehta; Ravindra L.,9998,0,9999,1
1715613626047,CLRE 252,A00,507189,Cuomo; Raphael Eduardo,9994,0,9999,5
1715613627078,CLRE 253,A00,507199,Vaida; Florin,9994,0,9999,5
1715613627078,CLRE 253,B00,507202,Vaida; Florin,9999,0,9999,0
1715613628103,CLRE 259,A00,507211,Patel; Hemal,9996,0,9999,3
1715613629131,CLRE 260,A00,507221,Cuomo; Raphael Eduardo,9999,0,9999,0
1715613630160,CLRE 297,001,507242,Cuomo; Raphael Eduardo,9999,0,9999,0
1715613631186,COGS 197,001,638244,Voytek; Bradley Thomas,9997,0,9999,2
1715613632210,CSE 191,A00,516875,Minnes Kemp; Mor Mia,9991,0,9999,8
1715613633235,CSE 197,001,637388,Minnes Kemp; Mor Mia,9992,0,9999,7
1715613634261,CSS 201S,A01,494383,Mignozzetti; Umberto,35,0,35,0
1715613635287,CSS 202S,A01,494387,Mignozzetti; Umberto,35,0,35,0
1715613636312,DSC 197,001,628532,Eldridge; Justin Matthew,9995,0,9999,4
1715613637338,EAP 100,A00,516065,Staff,9799,0,9999,200
1715613638365,ECE 45,A01,507414,Staff,31,0,60,29
1715613640420,ECE 111,A01,507420,Staff,11,0,50,39
1715613641445,ECE 197,001,548057,Sievenpiper; Daniel F.,9991,0,9999,8
1715613642469,EDS 115,A00,507243,Choi; Bailey Miyeon,7,0,28,21
1715613643496,EDS 117,A01,494379,Staff,0,6,34,34
1715613644523,EDS 125,A00,507246,Hopkins; Megan Beth,8,0,30,22
1715613645549,EDS 128A,A01,507264,Fargason; Sharon Gayle,6,0,26,20
1715613646574,EDS 128B,A01,507293,Pappas; Elizabeth,10,0,30,20
1715613647603,EDS 139,A00,507294,Fargason; Sharon Gayle,10,0,30,20
1715613647603,EDS 139,B00,507313,Pappas; Elizabeth,11,0,30,19
1715613648630,EDS 201,A00,507315,Staff,10,0,30,20
1715613649657,EDS 203,A01,507317,Halter; Christopher P.,10,0,30,20
1715613650681,EDS 204R,A01,507319,Halter; Christopher P.,0,3,30,30
1715613650681,EDS 204R,B01,507331,Heinzman; Erica M.,14,0,30,16
1715613651705,EDS 206R,A00,507332,Staff,0,4,30,30
1715613651705,EDS 206R,B00,507343,Staff,15,0,30,15
1715613652734,EDS 250,A00,507344,Hemans; Patricia Ann Benitez,20,0,40,20
1715613653761,EDS 281,A00,507345,Daly; Alan J.,18,0,18,0
1715613654785,EDS 284,A00,507350,Daly; Alan J.,16,0,16,0
1715613655813,EDS 286,A00,507359,Fine; Sarah,18,0,18,0
1715613656841,EDS 289C,A01,507361,Daly; Alan J.,18,0,18,0
1715613657867,EDS 290,A00,507366,Hofstetter; Carolyn,15,0,15,0
1715613658892,LIGM 5A,A00,507421,Fischer-Grunski; Eva K,17,0,20,3
1715613659919,LIGM 5B,A00,507423,Fischer-Grunski; Eva K,19,0,20,1
1715613660946,LIGM 5C,A00,507425,Fischer-Grunski; Eva K,19,0,20,1
1715613661970,LIIT 5AS,A00,507427,Carnelos; Chiara,20,0,20,0
1715613662997,LIIT 5BS,A00,507430,Carnelos; Chiara,20,0,20,0
1715613664022,LIIT 5CS,A00,507432,Carnelos; Chiara,20,0,20,0
1715613665051,LISP 5A,A00,507541,Munoz Sanchez; Alicia,11,0,20,9
1715613666084,LISP 5B,A00,507671,Munoz Sanchez; Alicia,9,0,20,11
1715613667114,LISP 5C,A00,507696,Munoz Sanchez; Alicia,9,0,20,11
1715613668140,MAE 197,001,528363,Boechler; Nicholas Sebastia,9998,0,9999,1
1715613669165,MATH 197,001,523477,Kedlaya; Kiran S.,9994,0,9999,5
1715613669165,MATH 197,002,563811,Zhang; Danna,9994,0,9999,5
1715613669165,MATH 197,003,628552,Dumitriu; Ioana,9998,0,9999,1
1715613669165,MATH 197,004,660885,Floyd; Eric,9999,0,9999,0
1715613670193,MCWP 40R,A00,518780,Staff,2,0,20,18
1715613670193,MCWP 40R,B00,518781,Staff,11,0,20,9
1715613670193,MCWP 40R,C00,518783,Staff,5,0,20,15
1715613671222,MCWP 50R,A00,518791,Staff,0,1,20,20
1715613671222,MCWP 50R,B00,518792,Staff,0,2,20,20
1715613671222,MCWP 50R,C00,518793,Staff,0,4,20,20
1715613671222,MCWP 50R,D00,518794,Staff,0,1,20,20
1715613671222,MCWP 50R,E00,518795,Staff,0,2,20,20
1715613671222,MCWP 50R,F00,518796,Staff,0,1,20,20
1715613671222,MCWP 50R,G00,518797,Staff,0,1,20,20
1715613672250,MMW 12R,A01,514034,Herbst; Matthew,0,2,16,16
1715613672250,MMW 12R,A02,514035,Herbst; Matthew,0,0,16,16
1715613673276,MMW 13R,A01,514037,Staff,0,5,16,16
1715613673276,MMW 13R,A02,514039,Staff,0,5,16,16
1715613673276,MMW 13R,A03,628519,Staff,0,4,16,16
1715613675330,SIO 295LS,A00,523233,Staff,10,0,30,20
1715613676356,SIO 295S,A00,523232,Staff,10,0,30,20
1715613677381,SIOC 290S,A01,637330,Merrifield; Mark A,23,0,30,7
1715613678410,SIOC 291S,A01,637333,Gabriel; Corey John,23,0,30,7
1715613679436,SOCI 117,A01,494376,Staff,0,5,5,5
1715613680463,WES 237B,A00,494380,Staff,10,0,20,10
1715613682524,AESE 279B,A00,494370,Wade; Jon P,0,0,33,33
1715613683548,AIP 97,001,660915,Van Den Einde; Yael Dahlia,9999,0,9999,0
1715613684573,AIP 197,001,627712,Vespa; Emanuel Ignacio,9995,0,9999,4
1715613684573,AIP 197,002,650778,Amir; On,9998,0,9999,1
1715613684573,AIP 197,003,650933,Avenancio-Leon; Carlos,9998,0,9999,1
1715613684573,AIP 197,004,658530,Heyman; Gail D.,9998,0,9999,1
1715613684573,AIP 197,005,658631,Neal; Sonya E,9998,0,9999,1
1715613684573,AIP 197,006,658671,Du; Songzi,9998,0,9999,1
1715613685597,ANAR 135S,A00,494369,Braswell; Geoffrey E.,0,0,0,0
1715613686623,BENG 196,001,628496,Engler; Adam J.,9998,0,9999,1
1715613686623,BENG 196,002,660916,Watson; John Thomas,9999,0,9999,0
1715613687654,BISP 197,001,650773,Wilhelm; James E.,9994,0,9999,5
1715613687654,BISP 197,002,658904,Coleman; Aaron B.,9998,0,9999,1
1715613688682,CAT 124RS,A01,519847,Geibel; William,0,0,20,20
1715613689707,CAT 125RS,A01,515971,Geibel; William,0,0,20,20
1715613690735,CLRE 250,A00,511389,Morris; Sheldon,9992,0,9999,7
1715613691761,CLRE 251,A00,507176,Mehta; Ravindra L.,9992,0,9999,7
1715613691761,CLRE 251,B00,511410,Mehta; Ravindra L.,9998,0,9999,1
1715613692787,CLRE 252,A00,507189,Cuomo; Raphael Eduardo,9994,0,9999,5
1715613693816,CLRE 253,A00,507199,Vaida; Florin,9994,0,9999,5
1715613693816,CLRE 253,B00,507202,Vaida; Florin,9999,0,9999,0
1715613694841,CLRE 259,A00,507211,Patel; Hemal,9996,0,9999,3
1715613695865,CLRE 260,A00,507221,Cuomo; Raphael Eduardo,9999,0,9999,0
1715613696891,CLRE 297,001,507242,Cuomo; Raphael Eduardo,9999,0,9999,0
1715613697915,COGS 197,001,638244,Voytek; Bradley Thomas,9997,0,9999,2
1715613698943,CSE 191,A00,516875,Minnes Kemp; Mor Mia,9991,0,9999,8
1715613699968,CSE 197,001,637388,Minnes Kemp; Mor Mia,9992,0,9999,7
1715613700992,CSS 201S,A01,494383,Mignozzetti; Umberto,35,0,35,0
1715613702016,CSS 202S,A01,494387,Mignozzetti; Umberto,35,0,35,0
1715613703043,DSC 197,001,628532,Eldridge; Justin Matthew,9995,0,9999,4
1715613704074,EAP 100,A00,516065,Staff,9799,0,9999,200
1715613705103,ECE 45,A01,507414,Staff,31,0,60,29
1715613707153,ECE 111,A01,507420,Staff,11,0,50,39
1715613708176,ECE 197,001,548057,Sievenpiper; Daniel F.,9991,0,9999,8
1715613709205,EDS 115,A00,507243,Choi; Bailey Miyeon,7,0,28,21
1715613710230,EDS 117,A01,494379,Staff,0,6,34,34
1715613711256,EDS 125,A00,507246,Hopkins; Megan Beth,8,0,30,22
1715613712287,EDS 128A,A01,507264,Fargason; Sharon Gayle,6,0,26,20
1715613713312,EDS 128B,A01,507293,Pappas; Elizabeth,10,0,30,20
1715613714340,EDS 139,A00,507294,Fargason; Sharon Gayle,10,0,30,20
1715613714340,EDS 139,B00,507313,Pappas; Elizabeth,11,0,30,19
1715613715369,EDS 201,A00,507315,Staff,10,0,30,20
1715613716399,EDS 203,A01,507317,Halter; Christopher P.,10,0,30,20
1715613717424,EDS 204R,A01,507319,Halter; Christopher P.,0,3,30,30
1715613717424,EDS 204R,B01,507331,Heinzman; Erica M.,14,0,30,16
1715613718449,EDS 206R,A00,507332,Staff,0,4,30,30
1715613718449,EDS 206R,B00,507343,Staff,15,0,30,15
1715613719476,EDS 250,A00,507344,Hemans; Patricia Ann Benitez,20,0,40,20
1715613720503,EDS 281,A00,507345,Daly; Alan J.,18,0,18,0
1715613721558,EDS 284,A00,507350,Daly; Alan J.,16,0,16,0
1715613722583,EDS 286,A00,507359,Fine; Sarah,18,0,18,0
1715613723611,EDS 289C,A01,507361,Daly; Alan J.,18,0,18,0
1715613724640,EDS 290,A00,507366,Hofstetter; Carolyn,15,0,15,0
1715613725667,LIGM 5A,A00,507421,Fischer-Grunski; Eva K,17,0,20,3
1715613726694,LIGM 5B,A00,507423,Fischer-Grunski; Eva K,19,0,20,1
1715613727719,LIGM 5C,A00,507425,Fischer-Grunski; Eva K,19,0,20,1
1715613728746,LIIT 5AS,A00,507427,Carnelos; Chiara,20,0,20,0
1715613729775,LIIT 5BS,A00,507430,Carnelos; Chiara,20,0,20,0
1715613730813,LIIT 5CS,A00,507432,Carnelos; Chiara,20,0,20,0
1715613731839,LISP 5A,A00,507541,Munoz Sanchez; Alicia,11,0,20,9
1715613732865,LISP 5B,A00,507671,Munoz Sanchez; Alicia,9,0,20,11
1715613733891,LISP 5C,A00,507696,Munoz Sanchez; Alicia,9,0,20,11
1715613734914,MAE 197,001,528363,Boechler; Nicholas Sebastia,9998,0,9999,1
1715613735938,MATH 197,001,523477,Kedlaya; Kiran S.,9994,0,9999,5
1715613735938,MATH 197,002,563811,Zhang; Danna,9994,0,9999,5
1715613735938,MATH 197,003,628552,Dumitriu; Ioana,9998,0,9999,1
1715613735938,MATH 197,004,660885,Floyd; Eric,9999,0,9999,0
1715613736967,MCWP 40R,A00,518780,Staff,2,0,20,18
1715613736967,MCWP 40R,B00,518781,Staff,11,0,20,9
1715613736967,MCWP 40R,C00,518783,Staff,5,0,20,15
1715613737997,MCWP 50R,A00,518791,Staff,0,1,20,20
1715613737997,MCWP 50R,B00,518792,Staff,0,2,20,20
1715613737997,MCWP 50R,C00,518793,Staff,0,4,20,20
1715613737997,MCWP 50R,D00,518794,Staff,0,1,20,20
1715613737997,MCWP 50R,E00,518795,Staff,0,2,20,20
1715613737997,MCWP 50R,F00,518796,Staff,0,1,20,20
1715613737997,MCWP 50R,G00,518797,Staff,0,1,20,20
1715613739020,MMW 12R,A01,514034,Herbst; Matthew,0,2,16,16
1715613739020,MMW 12R,A02,514035,Herbst; Matthew,0,0,16,16
1715613740050,MMW 13R,A01,514037,Staff,0,5,16,16
1715613740050,MMW 13R,A02,514039,Staff,0,5,16,16
1715613740050,MMW 13R,A03,628519,Staff,0,4,16,16
1715613742098,SIO 295LS,A00,523233,Staff,10,0,30,20
1715613743123,SIO 295S,A00,523232,Staff,10,0,30,20
1715613744153,SIOC 290S,A01,637330,Merrifield; Mark A,23,0,30,7
1715613745181,SIOC 291S,A01,637333,Gabriel; Corey John,23,0,30,7
1715613746206,SOCI 117,A01,494376,Staff,0,5,5,5
1715613747233,WES 237B,A00,494380,Staff,10,0,20,10
1715613749289,AESE 279B,A00,494370,Wade; Jon P,0,0,33,33
1715613750313,AIP 97,001,660915,Van Den Einde; Yael Dahlia,9999,0,9999,0
1715613751338,AIP 197,001,627712,Vespa; Emanuel Ignacio,9995,0,9999,4
1715613751338,AIP 197,002,650778,Amir; On,9998,0,9999,1
1715613751338,AIP 197,003,650933,Avenancio-Leon; Carlos,9998,0,9999,1
1715613751338,AIP 197,004,658530,Heyman; Gail D.,9998,0,9999,1
1715613751338,AIP 197,005,658631,Neal; Sonya E,9998,0,9999,1
1715613751338,AIP 197,006,658671,Du; Songzi,9998,0,9999,1
1715613752365,ANAR 135S,A00,494369,Braswell; Geoffrey E.,0,0,0,0
1715613753394,BENG 196,001,628496,Engler; Adam J.,9998,0,9999,1
1715613753394,BENG 196,002,660916,Watson; John Thomas,9999,0,9999,0
1715613754419,BISP 197,001,650773,Wilhelm; James E.,9994,0,9999,5
1715613754419,BISP 197,002,658904,Coleman; Aaron B.,9998,0,9999,1
1715613755444,CAT 124RS,A01,519847,Geibel; William,0,0,20,20
1715613756471,CAT 125RS,A01,515971,Geibel; William,0,0,20,20
1715613757496,CLRE 250,A00,511389,Morris; Sheldon,9992,0,9999,7
1715613758525,CLRE 251,A00,507176,Mehta; Ravindra L.,9992,0,9999,7
1715613758525,CLRE 251,B00,511410,Mehta; Ravindra L.,9998,0,9999,1
1715613759573,CLRE 252,A00,507189,Cuomo; Raphael Eduardo,9994,0,9999,5
1715613760601,CLRE 253,A00,507199,Vaida; Florin,9994,0,9999,5
1715613760601,CLRE 253,B00,507202,Vaida; Florin,9999,0,9999,0
1715613761627,CLRE 259,A00,507211,Patel; Hemal,9996,0,9999,3
1715613762654,CLRE 260,A00,507221,Cuomo; Raphael Eduardo,9999,0,9999,0
1715613763681,CLRE 297,001,507242,Cuomo; Raphael Eduardo,9999,0,9999,0
1715613764705,COGS 197,001,638244,Voytek; Bradley Thomas,9997,0,9999,2
1715613765731,CSE 191,A00,516875,Minnes Kemp; Mor Mia,9991,0,9999,8
1715613766756,CSE 197,001,637388,Minnes Kemp; Mor Mia,9992,0,9999,7
1715613767786,CSS 201S,A01,494383,Mignozzetti; Umberto,35,0,35,0
1715613768811,CSS 202S,A01,494387,Mignozzetti; Umberto,35,0,35,0
1715613769835,DSC 197,001,628532,Eldridge; Justin Matthew,9995,0,9999,4
1715613770860,EAP 100,A00,516065,Staff,9799,0,9999,200
1715613771893,ECE 45,A01,507414,Staff,31,0,60,29
1715613773943,ECE 111,A01,507420,Staff,11,0,50,39
1715613774968,ECE 197,001,548057,Sievenpiper; Daniel F.,9991,0,9999,8
1715613775994,EDS 115,A00,507243,Choi; Bailey Miyeon,7,0,28,21
1715613777020,EDS 117,A01,494379,Staff,0,6,34,34
1715613778045,EDS 125,A00,507246,Hopkins; Megan Beth,8,0,30,22
1715613779073,EDS 128A,A01,507264,Fargason; Sharon Gayle,6,0,26,20
1715613780101,EDS 128B,A01,507293,Pappas; Elizabeth,10,0,30,20
1715613781131,EDS 139,A00,507294,Fargason; Sharon Gayle,10,0,30,20
1715613781131,EDS 139,B00,507313,Pappas; Elizabeth,11,0,30,19
1715613782161,EDS 201,A00,507315,Staff,10,0,30,20
1715613783190,EDS 203,A01,507317,Halter; Christopher P.,10,0,30,20
1715613784215,EDS 204R,A01,507319,Halter; Christopher P.,0,3,30,30
1715613784215,EDS 204R,B01,507331,Heinzman; Erica M.,14,0,30,16
1715613785242,EDS 206R,A00,507332,Staff,0,4,30,30
1715613785242,EDS 206R,B00,507343,Staff,15,0,30,15
1715613786268,EDS 250,A00,507344,Hemans; Patricia Ann Benitez,20,0,40,20
1715613787296,EDS 281,A00,507345,Daly; Alan J.,18,0,18,0
1715613788322,EDS 284,A00,507350,Daly; Alan J.,16,0,16,0
1715613789355,EDS 286,A00,507359,Fine; Sarah,18,0,18,0
1715613790383,EDS 289C,A01,507361,Daly; Alan J.,18,0,18,0
1715613791408,EDS 290,A00,507366,Hofstetter; Carolyn,15,0,15,0
1715613792435,LIGM 5A,A00,507421,Fischer-Grunski; Eva K,17,0,20,3
1715613793462,LIGM 5B,A00,507423,Fischer-Grunski; Eva K,19,0,20,1
1715613794488,LIGM 5C,A00,507425,Fischer-Grunski; Eva K,19,0,20,1
1715613795514,LIIT 5AS,A00,507427,Carnelos; Chiara,20,0,20,0
1715613796540,LIIT 5BS,A00,507430,Carnelos; Chiara,20,0,20,0
1715613797565,LIIT 5CS,A00,507432,Carnelos; Chiara,20,0,20,0
1715613798591,LISP 5A,A00,507541,Munoz Sanchez; Alicia,11,0,20,9
1715613799620,LISP 5B,A00,507671,Munoz Sanchez; Alicia,9,0,20,11
1715613800649,LISP 5C,A00,507696,Munoz Sanchez; Alicia,9,0,20,11
1715613801674,MAE 197,001,528363,Boechler; Nicholas Sebastia,9998,0,9999,1
1715613802698,MATH 197,001,523477,Kedlaya; Kiran S.,9994,0,9999,5
1715613802698,MATH 197,002,563811,Zhang; Danna,9994,0,9999,5
1715613802698,MATH 197,003,628552,Dumitriu; Ioana,9998,0,9999,1
1715613802698,MATH 197,004,660885,Floyd; Eric,9999,0,9999,0
1715613803727,MCWP 40R,A00,518780,Staff,2,0,20,18
1715613803727,MCWP 40R,B00,518781,Staff,11,0,20,9
1715613803727,MCWP 40R,C00,518783,Staff,5,0,20,15
1715613804752,MCWP 50R,A00,518791,Staff,0,1,20,20
1715613804752,MCWP 50R,B00,518792,Staff,0,2,20,20
1715613804752,MCWP 50R,C00,518793,Staff,0,4,20,20
1715613804752,MCWP 50R,D00,518794,Staff,0,1,20,20
1715613804752,MCWP 50R,E00,518795,Staff,0,2,20,20
1715613804752,MCWP 50R,F00,518796,Staff,0,1,20,20
1715613804752,MCWP 50R,G00,518797,Staff,0,1,20,20
1715613805781,MMW 12R,A01,514034,Herbst; Matthew,0,2,16,16
1715613805781,MMW 12R,A02,514035,Herbst; Matthew,0,0,16,16
1715613806807,MMW 13R,A01,514037,Staff,0,5,16,16
1715613806807,MMW 13R,A02,514039,Staff,0,5,16,16
1715613806807,MMW 13R,A03,628519,Staff,0,4,16,16
1715613808860,SIO 295LS,A00,523233,Staff,10,0,30,20
1715613809887,SIO 295S,A00,523232,Staff,10,0,30,20
1715613810915,SIOC 290S,A01,637330,Merrifield; Mark A,23,0,30,7
1715613811944,SIOC 291S,A01,637333,Gabriel; Corey John,23,0,30,7
1715613812973,SOCI 117,A01,494376,Staff,0,5,5,5
1715613814000,WES 237B,A00,494380,Staff,10,0,20,10
1715613816072,AESE 279B,A00,494370,Wade; Jon P,0,0,33,33
1715613817098,AIP 97,001,660915,Van Den Einde; Yael Dahlia,9999,0,9999,0
1715613818129,AIP 197,001,627712,Vespa; Emanuel Ignacio,9995,0,9999,4
1715613818129,AIP 197,002,650778,Amir; On,9998,0,9999,1
1715613818129,AIP 197,003,650933,Avenancio-Leon; Carlos,9998,0,9999,1
1715613818129,AIP 197,004,658530,Heyman; Gail D.,9998,0,9999,1
1715613818129,AIP 197,005,658631,Neal; Sonya E,9998,0,9999,1
1715613818129,AIP 197,006,658671,Du; Songzi,9998,0,9999,1
1715613819157,ANAR 135S,A00,494369,Braswell; Geoffrey E.,0,0,0,0
1715613820186,BENG 196,001,628496,Engler; Adam J.,9998,0,9999,1
1715613820186,BENG 196,002,660916,Watson; John Thomas,9999,0,9999,0
1715613821216,BISP 197,001,650773,Wilhelm; James E.,9994,0,9999,5
1715613821216,BISP 197,002,658904,Coleman; Aaron B.,9998,0,9999,1
1715613822243,CAT 124RS,A01,519847,Geibel; William,0,0,20,20
1715613823272,CAT 125RS,A01,515971,Geibel; William,0,0,20,20
1715613824300,CLRE 250,A00,511389,Morris; Sheldon,9992,0,9999,7
1715613825470,CLRE 251,A00,507176,Mehta; Ravindra L.,9992,0,9999,7
1715613825470,CLRE 251,B00,511410,Mehta; Ravindra L.,9998,0,9999,1
1715613826496,CLRE 252,A00,507189,Cuomo; Raphael Eduardo,9994,0,9999,5
1715613827521,CLRE 253,A00,507199,Vaida; Florin,9994,0,9999,5
1715613827521,CLRE 253,B00,507202,Vaida; Florin,9999,0,9999,0
1715613828546,CLRE 259,A00,507211,Patel; Hemal,9996,0,9999,3
1715613829573,CLRE 260,A00,507221,Cuomo; Raphael Eduardo,9999,0,9999,0
1715613830600,CLRE 297,001,507242,Cuomo; Raphael Eduardo,9999,0,9999,0
1715613831624,COGS 197,001,638244,Voytek; Bradley Thomas,9997,0,9999,2
1715613832651,CSE 191,A00,516875,Minnes Kemp; Mor Mia,9991,0,9999,8
1715613833679,CSE 197,001,637388,Minnes Kemp; Mor Mia,9992,0,9999,7
1715613834709,CSS 201S,A01,494383,Mignozzetti; Umberto,35,0,35,0
1715613835734,CSS 202S,A01,494387,Mignozzetti; Umberto,35,0,35,0
1715613836759,DSC 197,001,628532,Eldridge; Justin Matthew,9995,0,9999,4
1715613837785,EAP 100,A00,516065,Staff,9799,0,9999,200
1715613838810,ECE 45,A01,507414,Staff,31,0,60,29
1715613840871,ECE 111,A01,507420,Staff,11,0,50,39
1715613841958,ECE 197,001,548057,Sievenpiper; Daniel F.,9991,0,9999,8
1715613842983,EDS 115,A00,507243,Choi; Bailey Miyeon,7,0,28,21
1715613844009,EDS 117,A01,494379,Staff,0,6,34,34
1715613845035,EDS 125,A00,507246,Hopkins; Megan Beth,8,0,30,22
1715613846061,EDS 128A,A01,507264,Fargason; Sharon Gayle,6,0,26,20
1715613847087,EDS 128B,A01,507293,Pappas; Elizabeth,10,0,30,20
1715613848114,EDS 139,A00,507294,Fargason; Sharon Gayle,10,0,30,20
1715613848114,EDS 139,B00,507313,Pappas; Elizabeth,11,0,30,19
1715613849140,EDS 201,A00,507315,Staff,10,0,30,20
1715613850167,EDS 203,A01,507317,Halter; Christopher P.,10,0,30,20
1715613851193,EDS 204R,A01,507319,Halter; Christopher P.,0,3,30,30
1715613851193,EDS 204R,B01,507331,Heinzman; Erica M.,14,0,30,16
1715613852221,EDS 206R,A00,507332,Staff,0,4,30,30
1715613852221,EDS 206R,B00,507343,Staff,15,0,30,15
1715613853247,EDS 250,A00,507344,Hemans; Patricia Ann Benitez,20,0,40,20
1715613854276,EDS 281,A00,507345,Daly; Alan J.,18,0,18,0
1715613855301,EDS 284,A00,507350,Daly; Alan J.,16,0,16,0
1715613856328,EDS 286,A00,507359,Fine; Sarah,18,0,18,0
1715613857354,EDS 289C,A01,507361,Daly; Alan J.,18,0,18,0
1715613858380,EDS 290,A00,507366,Hofstetter; Carolyn,15,0,15,0
1715613859410,LIGM 5A,A00,507421,Fischer-Grunski; Eva K,17,0,20,3
1715613860440,LIGM 5B,A00,507423,Fischer-Grunski; Eva K,19,0,20,1
1715613861468,LIGM 5C,A00,507425,Fischer-Grunski; Eva K,19,0,20,1
1715613862496,LIIT 5AS,A00,507427,Carnelos; Chiara,20,0,20,0
1715613863525,LIIT 5BS,A00,507430,Carnelos; Chiara,20,0,20,0
1715613864553,LIIT 5CS,A00,507432,Carnelos; Chiara,20,0,20,0
1715613865578,LISP 5A,A00,507541,Munoz Sanchez; Alicia,11,0,20,9
1715613866607,LISP 5B,A00,507671,Munoz Sanchez; Alicia,9,0,20,11
1715613867635,LISP 5C,A00,507696,Munoz Sanchez; Alicia,9,0,20,11
1715613868659,MAE 197,001,528363,Boechler; Nicholas Sebastia,9998,0,9999,1
1715613869685,MATH 197,001,523477,Kedlaya; Kiran S.,9994,0,9999,5
1715613869685,MATH 197,002,563811,Zhang; Danna,9994,0,9999,5
1715613869685,MATH 197,003,628552,Dumitriu; Ioana,9998,0,9999,1
1715613869685,MATH 197,004,660885,Floyd; Eric,9999,0,9999,0
1715613870710,MCWP 40R,A00,518780,Staff,2,0,20,18
1715613870710,MCWP 40R,B00,518781,Staff,11,0,20,9
1715613870710,MCWP 40R,C00,518783,Staff,5,0,20,15
1715613871738,MCWP 50R,A00,518791,Staff,0,1,20,20
1715613871738,MCWP 50R,B00,518792,Staff,0,2,20,20
1715613871738,MCWP 50R,C00,518793,Staff,0,4,20,20
1715613871738,MCWP 50R,D00,518794,Staff,0,1,20,20
1715613871738,MCWP 50R,E00,518795,Staff,0,2,20,20
1715613871738,MCWP 50R,F00,518796,Staff,0,1,20,20
1715613871738,MCWP 50R,G00,518797,Staff,0,1,20,20
1715613872761,MMW 12R,A01,514034,Herbst; Matthew,0,2,16,16
1715613872761,MMW 12R,A02,514035,Herbst; Matthew,0,0,16,16
1715613873787,MMW 13R,A01,514037,Staff,0,5,16,16
1715613873787,MMW 13R,A02,514039,Staff,0,5,16,16
1715613873787,MMW 13R,A03,628519,Staff,0,4,16,16
1715613875838,SIO 295LS,A00,523233,Staff,10,0,30,20
1715613876866,SIO 295S,A00,523232,Staff,10,0,30,20
1715613877892,SIOC 290S,A01,637330,Merrifield; Mark A,23,0,30,7
1715613878918,SIOC 291S,A01,637333,Gabriel; Corey John,23,0,30,7
1715613879943,SOCI 117,A01,494376,Staff,0,5,5,5
1715613880971,WES 237B,A00,494380,Staff,10,0,20,10
1715613883030,AESE 279B,A00,494370,Wade; Jon P,0,0,33,33
1715613884058,AIP 97,001,660915,Van Den Einde; Yael Dahlia,9999,0,9999,0
1715613885093,AIP 197,001,627712,Vespa; Emanuel Ignacio,9995,0,9999,4
1715613885093,AIP 197,002,650778,Amir; On,9998,0,9999,1
1715613885093,AIP 197,003,650933,Avenancio-Leon; Carlos,9998,0,9999,1
1715613885093,AIP 197,004,658530,Heyman; Gail D.,9998,0,9999,1
1715613885093,AIP 197,005,658631,Neal; Sonya E,9998,0,9999,1
1715613885093,AIP 197,006,658671,Du; Songzi,9998,0,9999,1
1715613886120,ANAR 135S,A00,494369,Braswell; Geoffrey E.,0,0,0,0
1715613887145,BENG 196,001,628496,Engler; Adam J.,9998,0,9999,1
1715613887145,BENG 196,002,660916,Watson; John Thomas,9999,0,9999,0
1715613888176,BISP 197,001,650773,Wilhelm; James E.,9994,0,9999,5
1715613888176,BISP 197,002,658904,Coleman; Aaron B.,9998,0,9999,1
1715613889199,CAT 124RS,A01,519847,Geibel; William,0,0,20,20
1715613890223,CAT 125RS,A01,515971,Geibel; William,0,0,20,20
1715613891249,CLRE 250,A00,511389,Morris; Sheldon,9992,0,9999,7
1715613892279,CLRE 251,A00,507176,Mehta; Ravindra L.,9992,0,9999,7
1715613892279,CLRE 251,B00,511410,Mehta; Ravindra L.,9998,0,9999,1
1715613893306,CLRE 252,A00,507189,Cuomo; Raphael Eduardo,9994,0,9999,5
1715613894333,CLRE 253,A00,507199,Vaida; Florin,9994,0,9999,5
1715613894333,CLRE 253,B00,507202,Vaida; Florin,9999,0,9999,0
1715613895361,CLRE 259,A00,507211,Patel; Hemal,9996,0,9999,3
1715613896387,CLRE 260,A00,507221,Cuomo; Raphael Eduardo,9999,0,9999,0
1715613897412,CLRE 297,001,507242,Cuomo; Raphael Eduardo,9999,0,9999,0
1715613898438,COGS 197,001,638244,Voytek; Bradley Thomas,9997,0,9999,2
1715613899467,CSE 191,A00,516875,Minnes Kemp; Mor Mia,9991,0,9999,8
1715613900495,CSE 197,001,637388,Minnes Kemp; Mor Mia,9992,0,9999,7
1715613901521,CSS 201S,A01,494383,Mignozzetti; Umberto,35,0,35,0
1715613902547,CSS 202S,A01,494387,Mignozzetti; Umberto,35,0,35,0
1715613903576,DSC 197,001,628532,Eldridge; Justin Matthew,9995,0,9999,4
1715613904604,EAP 100,A00,516065,Staff,9799,0,9999,200
1715613905629,ECE 45,A01,507414,Staff,31,0,60,29
1715613907686,ECE 111,A01,507420,Staff,11,0,50,39
1715613908715,ECE 197,001,548057,Sievenpiper; Daniel F.,9991,0,9999,8
1715613909740,EDS 115,A00,507243,Choi; Bailey Miyeon,7,0,28,21
1715613910764,EDS 117,A01,494379,Staff,0,6,34,34
1715613911789,EDS 125,A00,507246,Hopkins; Megan Beth,8,0,30,22
1715613912816,EDS 128A,A01,507264,Fargason; Sharon Gayle,6,0,26,20
1715613913844,EDS 128B,A01,507293,Pappas; Elizabeth,10,0,30,20
1715613914868,EDS 139,A00,507294,Fargason; Sharon Gayle,10,0,30,20
1715613914868,EDS 139,B00,507313,Pappas; Elizabeth,11,0,30,19
1715613915898,EDS 201,A00,507315,Staff,10,0,30,20
1715613916923,EDS 203,A01,507317,Halter; Christopher P.,10,0,30,20
1715613917950,EDS 204R,A01,507319,Halter; Christopher P.,0,3,30,30
1715613917950,EDS 204R,B01,507331,Heinzman; Erica M.,14,0,30,16
1715613918978,EDS 206R,A00,507332,Staff,0,4,30,30
1715613918978,EDS 206R,B00,507343,Staff,15,0,30,15
1715613920003,EDS 250,A00,507344,Hemans; Patricia Ann Benitez,20,0,40,20
1715613921029,EDS 281,A00,507345,Daly; Alan J.,18,0,18,0
1715613922058,EDS 284,A00,507350,Daly; Alan J.,16,0,16,0
1715613923084,EDS 286,A00,507359,Fine; Sarah,18,0,18,0
1715613924111,EDS 289C,A01,507361,Daly; Alan J.,18,0,18,0
1715613925134,EDS 290,A00,507366,Hofstetter; Carolyn,15,0,15,0
1715613926164,LIGM 5A,A00,507421,Fischer-Grunski; Eva K,17,0,20,3
1715613927190,LIGM 5B,A00,507423,Fischer-Grunski; Eva K,19,0,20,1
1715613928217,LIGM 5C,A00,507425,Fischer-Grunski; Eva K,19,0,20,1
1715613929245,LIIT 5AS,A00,507427,Carnelos; Chiara,20,0,20,0
1715613930276,LIIT 5BS,A00,507430,Carnelos; Chiara,20,0,20,0
1715613931302,LIIT 5CS,A00,507432,Carnelos; Chiara,20,0,20,0
1715613932327,LISP 5A,A00,507541,Munoz Sanchez; Alicia,11,0,20,9
1715613933353,LISP 5B,A00,507671,Munoz Sanchez; Alicia,9,0,20,11
1715613934378,LISP 5C,A00,507696,Munoz Sanchez; Alicia,9,0,20,11
1715613935403,MAE 197,001,528363,Boechler; Nicholas Sebastia,9998,0,9999,1
1715613936429,MATH 197,001,523477,Kedlaya; Kiran S.,9994,0,9999,5
1715613936429,MATH 197,002,563811,Zhang; Danna,9994,0,9999,5
1715613936429,MATH 197,003,628552,Dumitriu; Ioana,9998,0,9999,1
1715613936429,MATH 197,004,660885,Floyd; Eric,9999,0,9999,0
1715613937454,MCWP 40R,A00,518780,Staff,2,0,20,18
1715613937454,MCWP 40R,B00,518781,Staff,11,0,20,9
1715613937454,MCWP 40R,C00,518783,Staff,5,0,20,15
1715613938480,MCWP 50R,A00,518791,Staff,0,1,20,20
1715613938480,MCWP 50R,B00,518792,Staff,0,2,20,20
1715613938480,MCWP 50R,C00,518793,Staff,0,4,20,20
1715613938480,MCWP 50R,D00,518794,Staff,0,1,20,20
1715613938480,MCWP 50R,E00,518795,Staff,0,2,20,20
1715613938480,MCWP 50R,F00,518796,Staff,0,1,20,20
1715613938480,MCWP 50R,G00,518797,Staff,0,1,20,20
1715613939505,MMW 12R,A01,514034,Herbst; Matthew,0,2,16,16
1715613939505,MMW 12R,A02,514035,Herbst; Matthew,0,0,16,16
1715613940532,MMW 13R,A01,514037,Staff,0,5,16,16
1715613940532,MMW 13R,A02,514039,Staff,0,5,16,16
1715613940532,MMW 13R,A03,628519,Staff,0,4,16,16
1715613942584,SIO 295LS,A00,523233,Staff,10,0,30,20
1715613943612,SIO 295S,A00,523232,Staff,10,0,30,20
1715613944642,SIOC 290S,A01,637330,Merrifield; Mark A,23,0,30,7
1715613945673,SIOC 291S,A01,637333,Gabriel; Corey John,23,0,30,7
1715613946697,SOCI 117,A01,494376,Staff,0,5,5,5
1715613947720,WES 237B,A00,494380,Staff,10,0,20,10
1715613949783,AESE 279B,A00,494370,Wade; Jon P,0,0,33,33
1715613950808,AIP 97,001,660915,Van Den Einde; Yael Dahlia,9999,0,9999,0
1715613951833,AIP 197,001,627712,Vespa; Emanuel Ignacio,9995,0,9999,4
1715613951833,AIP 197,002,650778,Amir; On,9998,0,9999,1
1715613951833,AIP 197,003,650933,Avenancio-Leon; Carlos,9998,0,9999,1
1715613951833,AIP 197,004,658530,Heyman; Gail D.,9998,0,9999,1
1715613951833,AIP 197,005,658631,Neal; Sonya E,9998,0,9999,1
1715613951833,AIP 197,006,658671,Du; Songzi,9998,0,9999,1
1715613952858,ANAR 135S,A00,494369,Braswell; Geoffrey E.,0,0,0,0
1715613953882,BENG 196,001,628496,Engler; Adam J.,9998,0,9999,1
1715613953882,BENG 196,002,660916,Watson; John Thomas,9999,0,9999,0
1715613954907,BISP 197,001,650773,Wilhelm; James E.,9994,0,9999,5
1715613954907,BISP 197,002,658904,Coleman; Aaron B.,9998,0,9999,1
1715613955932,CAT 124RS,A01,519847,Geibel; William,0,0,20,20
1715613956958,CAT 125RS,A01,515971,Geibel; William,0,0,20,20
1715613957983,CLRE 250,A00,511389,Morris; Sheldon,9992,0,9999,7
1715613959011,CLRE 251,A00,507176,Mehta; Ravindra L.,9992,0,9999,7
1715613959011,CLRE 251,B00,511410,Mehta; Ravindra L.,9998,0,9999,1
1715613960038,CLRE 252,A00,507189,Cuomo; Raphael Eduardo,9994,0,9999,5
1715613961061,CLRE 253,A00,507199,Vaida; Florin,9994,0,9999,5
1715613961061,CLRE 253,B00,507202,Vaida; Florin,9999,0,9999,0
1715613962090,CLRE 259,A00,507211,Patel; Hemal,9996,0,9999,3
1715613963113,CLRE 260,A00,507221,Cuomo; Raphael Eduardo,9999,0,9999,0
1715613964138,CLRE 297,001,507242,Cuomo; Raphael Eduardo,9999,0,9999,0
1715613965163,COGS 197,001,638244,Voytek; Bradley Thomas,9997,0,9999,2
1715613966190,CSE 191,A00,516875,Minnes Kemp; Mor Mia,9991,0,9999,8
1715613967215,CSE 197,001,637388,Minnes Kemp; Mor Mia,9992,0,9999,7
1715613968242,CSS 201S,A01,494383,Mignozzetti; Umberto,35,0,35,0
1715613969272,CSS 202S,A01,494387,Mignozzetti; Umberto,35,0,35,0
1715613970302,DSC 197,001,628532,Eldridge; Justin Matthew,9995,0,9999,4
1715613971330,EAP 100,A00,516065,Staff,9799,0,9999,200
1715613972360,ECE 45,A01,507414,Staff,31,0,60,29
1715613974412,ECE 111,A01,507420,Staff,11,0,50,39
1715613975439,ECE 197,001,548057,Sievenpiper; Daniel F.,9991,0,9999,8
1715613976464,EDS 115,A00,507243,Choi; Bailey Miyeon,7,0,28,21
1715613977492,EDS 117,A01,494379,Staff,0,6,34,34
1715613978520,EDS 125,A00,507246,Hopkins; Megan Beth,8,0,30,22
1715613979552,EDS 128A,A01,507264,Fargason; Sharon Gayle,6,0,26,20
1715613980633,EDS 128B,A01,507293,Pappas; Elizabeth,10,0,30,20
1715613981662,EDS 139,A00,507294,Fargason; Sharon Gayle,10,0,30,20
1715613981662,EDS 139,B00,507313,Pappas; Elizabeth,11,0,30,19
1715613982687,EDS 201,A00,507315,Staff,10,0,30,20
1715613983712,EDS 203,A01,507317,Halter; Christopher P.,10,0,30,20
1715613984739,EDS 204R,A01,507319,Halter; Christopher P.,0,3,30,30
1715613984739,EDS 204R,B01,507331,Heinzman; Erica M.,14,0,30,16
1715613985766,EDS 206R,A00,507332,Staff,0,4,30,30
1715613985766,EDS 206R,B00,507343,Staff,15,0,30,15
1715613986793,EDS 250,A00,507344,Hemans; Patricia Ann Benitez,20,0,40,20
1715613987821,EDS 281,A00,507345,Daly; Alan J.,18,0,18,0
1715613988849,EDS 284,A00,507350,Daly; Alan J.,16,0,16,0
1715613989874,EDS 286,A00,507359,Fine; Sarah,18,0,18,0
1715613990899,EDS 289C,A01,507361,Daly; Alan J.,18,0,18,0
1715613991924,EDS 290,A00,507366,Hofstetter; Carolyn,15,0,15,0
1715613992955,LIGM 5A,A00,507421,Fischer-Grunski; Eva K,17,0,20,3
1715613993982,LIGM 5B,A00,507423,Fischer-Grunski; Eva K,19,0,20,1
1715613995007,LIGM 5C,A00,507425,Fischer-Grunski; Eva K,19,0,20,1
1715613996031,LIIT 5AS,A00,507427,Carnelos; Chiara,20,0,20,0
1715613997057,LIIT 5BS,A00,507430,Carnelos; Chiara,20,0,20,0
1715613998083,LIIT 5CS,A00,507432,Carnelos; Chiara,20,0,20,0
1715613999113,LISP 5A,A00,507541,Munoz Sanchez; Alicia,11,0,20,9
1715614000138,LISP 5B,A00,507671,Munoz Sanchez; Alicia,9,0,20,11
1715614001165,LISP 5C,A00,507696,Munoz Sanchez; Alicia,9,0,20,11
1715614002190,MAE 197,001,528363,Boechler; Nicholas Sebastia,9998,0,9999,1
1715614003215,MATH 197,001,523477,Kedlaya; Kiran S.,9994,0,9999,5
1715614003215,MATH 197,002,563811,Zhang; Danna,9994,0,9999,5
1715614003215,MATH 197,003,628552,Dumitriu; Ioana,9998,0,9999,1
1715614003215,MATH 197,004,660885,Floyd; Eric,9999,0,9999,0
1715614004240,MCWP 40R,A00,518780,Staff,2,0,20,18
1715614004240,MCWP 40R,B00,518781,Staff,11,0,20,9
1715614004240,MCWP 40R,C00,518783,Staff,5,0,20,15
1715614005269,MCWP 50R,A00,518791,Staff,0,1,20,20
1715614005269,MCWP 50R,B00,518792,Staff,0,2,20,20
1715614005269,MCWP 50R,C00,518793,Staff,0,4,20,20
1715614005269,MCWP 50R,D00,518794,Staff,0,1,20,20
1715614005269,MCWP 50R,E00,518795,Staff,0,2,20,20
1715614005269,MCWP 50R,F00,518796,Staff,0,1,20,20
1715614005269,MCWP 50R,G00,518797,Staff,0,1,20,20
1715614006298,MMW 12R,A01,514034,Herbst; Matthew,0,2,16,16
1715614006298,MMW 12R,A02,514035,Herbst; Matthew,0,0,16,16
1715614007324,MMW 13R,A01,514037,Staff,0,5,16,16
1715614007324,MMW 13R,A02,514039,Staff,0,5,16,16
1715614007324,MMW 13R,A03,628519,Staff,0,4,16,16
1715614009376,SIO 295LS,A00,523233,Staff,10,0,30,20
1715614010405,SIO 295S,A00,523232,Staff,10,0,30,20
1715614011436,SIOC 290S,A01,637330,Merrifield; Mark A,23,0,30,7
1715614012462,SIOC 291S,A01,637333,Gabriel; Corey John,23,0,30,7
1715614013489,SOCI 117,A01,494376,Staff,0,5,5,5
1715614014516,WES 237B,A00,494380,Staff,10,0,20,10
1715614016575,AESE 279B,A00,494370,Wade; Jon P,0,0,33,33
1715614017601,AIP 97,001,660915,Van Den Einde; Yael Dahlia,9999,0,9999,0
1715614018630,AIP 197,001,627712,Vespa; Emanuel Ignacio,9995,0,9999,4
1715614018630,AIP 197,002,650778,Amir; On,9998,0,9999,1
1715614018630,AIP 197,003,650933,Avenancio-Leon; Carlos,9998,0,9999,1
1715614018630,AIP 197,004,658530,Heyman; Gail D.,9998,0,9999,1
1715614018630,AIP 197,005,658631,Neal; Sonya E,9998,0,9999,1
1715614018630,AIP 197,006,658671,Du; Songzi,9998,0,9999,1
1715614019655,ANAR 135S,A00,494369,Braswell; Geoffrey E.,0,0,0,0
1715614020684,BENG 196,001,628496,Engler; Adam J.,9998,0,9999,1
1715614020684,BENG 196,002,660916,Watson; John Thomas,9999,0,9999,0
1715614021709,BISP 197,001,650773,Wilhelm; James E.,9994,0,9999,5
1715614021709,BISP 197,002,658904,Coleman; Aaron B.,9998,0,9999,1
1715614022736,CAT 124RS,A01,519847,Geibel; William,0,0,20,20
1715614023762,CAT 125RS,A01,515971,Geibel; William,0,0,20,20
1715614024806,CLRE 250,A00,511389,Morris; Sheldon,9992,0,9999,7
1715614025835,CLRE 251,A00,507176,Mehta; Ravindra L.,9992,0,9999,7
1715614025835,CLRE 251,B00,511410,Mehta; Ravindra L.,9998,0,9999,1
1715614026863,CLRE 252,A00,507189,Cuomo; Raphael Eduardo,9994,0,9999,5
1715614027887,CLRE 253,A00,507199,Vaida; Florin,9994,0,9999,5
1715614027887,CLRE 253,B00,507202,Vaida; Florin,9999,0,9999,0
1715614028912,CLRE 259,A00,507211,Patel; Hemal,9996,0,9999,3
1715614029938,CLRE 260,A00,507221,Cuomo; Raphael Eduardo,9999,0,9999,0
1715614030964,CLRE 297,001,507242,Cuomo; Raphael Eduardo,9999,0,9999,0
1715614031989,COGS 197,001,638244,Voytek; Bradley Thomas,9997,0,9999,2
1715614033018,CSE 191,A00,516875,Minnes Kemp; Mor Mia,9991,0,9999,8
1715614034045,CSE 197,001,637388,Minnes Kemp; Mor Mia,9992,0,9999,7
1715614035074,CSS 201S,A01,494383,Mignozzetti; Umberto,35,0,35,0
1715614036103,CSS 202S,A01,494387,Mignozzetti; Umberto,35,0,35,0
1715614037130,DSC 197,001,628532,Eldridge; Justin Matthew,9995,0,9999,4
1715614038156,EAP 100,A00,516065,Staff,9799,0,9999,200
1715614039187,ECE 45,A01,507414,Staff,31,0,60,29
1715614041239,ECE 111,A01,507420,Staff,11,0,50,39
1715614042267,ECE 197,001,548057,Sievenpiper; Daniel F.,9991,0,9999,8
1715614043293,EDS 115,A00,507243,Choi; Bailey Miyeon,7,0,28,21
1715614044320,EDS 117,A01,494379,Staff,0,6,34,34
1715614045347,EDS 125,A00,507246,Hopkins; Megan Beth,8,0,30,22
1715614046374,EDS 128A,A01,507264,Fargason; Sharon Gayle,6,0,26,20
1715614047399,EDS 128B,A01,507293,Pappas; Elizabeth,10,0,30,20
1715614048428,EDS 139,A00,507294,Fargason; Sharon Gayle,10,0,30,20
1715614048428,EDS 139,B00,507313,Pappas; Elizabeth,11,0,30,19
1715614049456,EDS 201,A00,507315,Staff,10,0,30,20
1715614050484,EDS 203,A01,507317,Halter; Christopher P.,10,0,30,20
1715614051511,EDS 204R,A01,507319,Halter; Christopher P.,0,3,30,30
1715614051511,EDS 204R,B01,507331,Heinzman; Erica M.,14,0,30,16
1715614052536,EDS 206R,A00,507332,Staff,0,4,30,30
1715614052536,EDS 206R,B00,507343,Staff,15,0,30,15
1715614053562,EDS 250,A00,507344,Hemans; Patricia Ann Benitez,20,0,40,20
1715614054589,EDS 281,A00,507345,Daly; Alan J.,18,0,18,0
1715614055614,EDS 284,A00,507350,Daly; Alan J.,16,0,16,0
1715614056640,EDS 286,A00,507359,Fine; Sarah,18,0,18,0
1715614057664,EDS 289C,A01,507361,Daly; Alan J.,18,0,18,0
1715614058688,EDS 290,A00,507366,Hofstetter; Carolyn,15,0,15,0
1715614059718,LIGM 5A,A00,507421,Fischer-Grunski; Eva K,17,0,20,3
1715614060747,LIGM 5B,A00,507423,Fischer-Grunski; Eva K,19,0,20,1
1715614061775,LIGM 5C,A00,507425,Fischer-Grunski; Eva K,19,0,20,1
1715614062805,LIIT 5AS,A00,507427,Carnelos; Chiara,20,0,20,0
1715614063834,LIIT 5BS,A00,507430,Carnelos; Chiara,20,0,20,0
1715614064859,LIIT 5CS,A00,507432,Carnelos; Chiara,20,0,20,0
1715614065885,LISP 5A,A00,507541,Munoz Sanchez; Alicia,11,0,20,9
1715614066910,LISP 5B,A00,507671,Munoz Sanchez; Alicia,9,0,20,11
1715614067937,LISP 5C,A00,507696,Munoz Sanchez; Alicia,9,0,20,11
1715614068966,MAE 197,001,528363,Boechler; Nicholas Sebastia,9998,0,9999,1
1715614069990,MATH 197,001,523477,Kedlaya; Kiran S.,9994,0,9999,5
1715614069990,MATH 197,002,563811,Zhang; Danna,9994,0,9999,5
1715614069990,MATH 197,003,628552,Dumitriu; Ioana,9998,0,9999,1
1715614069990,MATH 197,004,660885,Floyd; Eric,9999,0,9999,0
1715614071016,MCWP 40R,A00,518780,Staff,2,0,20,18
1715614071016,MCWP 40R,B00,518781,Staff,11,0,20,9
1715614071016,MCWP 40R,C00,518783,Staff,5,0,20,15
1715614072042,MCWP 50R,A00,518791,Staff,0,1,20,20
1715614072042,MCWP 50R,B00,518792,Staff,0,2,20,20
1715614072042,MCWP 50R,C00,518793,Staff,0,4,20,20
1715614072042,MCWP 50R,D00,518794,Staff,0,1,20,20
1715614072042,MCWP 50R,E00,518795,Staff,0,2,20,20
1715614072042,MCWP 50R,F00,518796,Staff,0,1,20,20
1715614072042,MCWP 50R,G00,518797,Staff,0,1,20,20
1715614073068,MMW 12R,A01,514034,Herbst; Matthew,0,2,16,16
1715614073068,MMW 12R,A02,514035,Herbst; Matthew,0,0,16,16
1715614074094,MMW 13R,A01,514037,Staff,0,5,16,16
1715614074094,MMW 13R,A02,514039,Staff,0,5,16,16
1715614074094,MMW 13R,A03,628519,Staff,0,4,16,16
1715614076150,SIO 295LS,A00,523233,Staff,10,0,30,20
1715614077178,SIO 295S,A00,523232,Staff,10,0,30,20
1715614078203,SIOC 290S,A01,637330,Merrifield; Mark A,23,0,30,7
1715614079230,SIOC 291S,A01,637333,Gabriel; Corey John,23,0,30,7
1715614080257,SOCI 117,A01,494376,Staff,0,5,5,5
1715614081282,WES 237B,A00,494380,Staff,10,0,20,10
1715614083351,AESE 279B,A00,494370,Wade; Jon P,0,0,33,33
1715614084431,AIP 97,001,660915,Van Den Einde; Yael Dahlia,9999,0,9999,0
1715614085461,AIP 197,001,627712,Vespa; Emanuel Ignacio,9995,0,9999,4
1715614085461,AIP 197,002,650778,Amir; On,9998,0,9999,1
1715614085461,AIP 197,003,650933,Avenancio-Leon; Carlos,9998,0,9999,1
1715614085461,AIP 197,004,658530,Heyman; Gail D.,9998,0,9999,1
1715614085461,AIP 197,005,658631,Neal; Sonya E,9998,0,9999,1
1715614085461,AIP 197,006,658671,Du; Songzi,9998,0,9999,1
1715614086491,ANAR 135S,A00,494369,Braswell; Geoffrey E.,0,0,0,0
1715614087521,BENG 196,001,628496,Engler; Adam J.,9998,0,9999,1
1715614087521,BENG 196,002,660916,Watson; John Thomas,9999,0,9999,0
1715614088548,BISP 197,001,650773,Wilhelm; James E.,9994,0,9999,5
1715614088548,BISP 197,002,658904,Coleman; Aaron B.,9998,0,9999,1
1715614089575,CAT 124RS,A01,519847,Geibel; William,0,0,20,20
1715614090600,CAT 125RS,A01,515971,Geibel; William,0,0,20,20
1715614091625,CLRE 250,A00,511389,Morris; Sheldon,9992,0,9999,7
1715614092653,CLRE 251,A00,507176,Mehta; Ravindra L.,9992,0,9999,7
1715614092653,CLRE 251,B00,511410,Mehta; Ravindra L.,9998,0,9999,1
1715614093682,CLRE 252,A00,507189,Cuomo; Raphael Eduardo,9994,0,9999,5
1715614094710,CLRE 253,A00,507199,Vaida; Florin,9994,0,9999,5
1715614094710,CLRE 253,B00,507202,Vaida; Florin,9999,0,9999,0
1715614095736,CLRE 259,A00,507211,Patel; Hemal,9996,0,9999,3
1715614096762,CLRE 260,A00,507221,Cuomo; Raphael Eduardo,9999,0,9999,0
1715614097788,CLRE 297,001,507242,Cuomo; Raphael Eduardo,9999,0,9999,0
1715614098811,COGS 197,001,638244,Voytek; Bradley Thomas,9997,0,9999,2
1715614099835,CSE 191,A00,516875,Minnes Kemp; Mor Mia,9991,0,9999,8
1715614100863,CSE 197,001,637388,Minnes Kemp; Mor Mia,9992,0,9999,7
1715614101891,CSS 201S,A01,494383,Mignozzetti; Umberto,35,0,35,0
1715614102921,CSS 202S,A01,494387,Mignozzetti; Umberto,35,0,35,0
1715614103946,DSC 197,001,628532,Eldridge; Justin Matthew,9995,0,9999,4
1715614104972,EAP 100,A00,516065,Staff,9799,0,9999,200
1715614105998,ECE 45,A01,507414,Staff,31,0,60,29
1715614108050,ECE 111,A01,507420,Staff,11,0,50,39
1715614109075,ECE 197,001,548057,Sievenpiper; Daniel F.,9991,0,9999,8
1715614110102,EDS 115,A00,507243,Choi; Bailey Miyeon,7,0,28,21
1715614111128,EDS 117,A01,494379,Staff,0,6,34,34
1715614112155,EDS 125,A00,507246,Hopkins; Megan Beth,8,0,30,22
1715614113184,EDS 128A,A01,507264,Fargason; Sharon Gayle,6,0,26,20
1715614114209,EDS 128B,A01,507293,Pappas; Elizabeth,10,0,30,20
1715614115235,EDS 139,A00,507294,Fargason; Sharon Gayle,10,0,30,20
1715614115235,EDS 139,B00,507313,Pappas; Elizabeth,11,0,30,19
1715614116260,EDS 201,A00,507315,Staff,10,0,30,20
1715614117289,EDS 203,A01,507317,Halter; Christopher P.,10,0,30,20
1715614118316,EDS 204R,A01,507319,Halter; Christopher P.,0,3,30,30
1715614118316,EDS 204R,B01,507331,Heinzman; Erica M.,14,0,30,16
1715614119344,EDS 206R,A00,507332,Staff,0,4,30,30
1715614119344,EDS 206R,B00,507343,Staff,15,0,30,15
1715614120373,EDS 250,A00,507344,Hemans; Patricia Ann Benitez,20,0,40,20
1715614121401,EDS 281,A00,507345,Daly; Alan J.,18,0,18,0
1715614122430,EDS 284,A00,507350,Daly; Alan J.,16,0,16,0
1715614123458,EDS 286,A00,507359,Fine; Sarah,18,0,18,0
1715614124482,EDS 289C,A01,507361,Daly; Alan J.,18,0,18,0
1715614125510,EDS 290,A00,507366,Hofstetter; Carolyn,15,0,15,0
1715614126536,LIGM 5A,A00,507421,Fischer-Grunski; Eva K,17,0,20,3
1715614127562,LIGM 5B,A00,507423,Fischer-Grunski; Eva K,19,0,20,1
1715614128591,LIGM 5C,A00,507425,Fischer-Grunski; Eva K,19,0,20,1
1715614129625,LIIT 5AS,A00,507427,Carnelos; Chiara,20,0,20,0
1715614130651,LIIT 5BS,A00,507430,Carnelos; Chiara,20,0,20,0
1715614131677,LIIT 5CS,A00,507432,Carnelos; Chiara,20,0,20,0
1715614132709,LISP 5A,A00,507541,Munoz Sanchez; Alicia,11,0,20,9
1715614133734,LISP 5B,A00,507671,Munoz Sanchez; Alicia,9,0,20,11
1715614134759,LISP 5C,A00,507696,Munoz Sanchez; Alicia,9,0,20,11
1715614135787,MAE 197,001,528363,Boechler; Nicholas Sebastia,9998,0,9999,1
1715614136815,MATH 197,001,523477,Kedlaya; Kiran S.,9994,0,9999,5
1715614136815,MATH 197,002,563811,Zhang; Danna,9994,0,9999,5
1715614136815,MATH 197,003,628552,Dumitriu; Ioana,9998,0,9999,1
1715614136815,MATH 197,004,660885,Floyd; Eric,9999,0,9999,0
1715614137843,MCWP 40R,A00,518780,Staff,2,0,20,18
1715614137843,MCWP 40R,B00,518781,Staff,11,0,20,9
1715614137843,MCWP 40R,C00,518783,Staff,5,0,20,15
1715614138872,MCWP 50R,A00,518791,Staff,0,1,20,20
1715614138872,MCWP 50R,B00,518792,Staff,0,2,20,20
1715614138872,MCWP 50R,C00,518793,Staff,0,4,20,20
1715614138872,MCWP 50R,D00,518794,Staff,0,1,20,20
1715614138872,MCWP 50R,E00,518795,Staff,0,2,20,20
1715614138872,MCWP 50R,F00,518796,Staff,0,1,20,20
1715614138872,MCWP 50R,G00,518797,Staff,0,1,20,20
1715614139898,MMW 12R,A01,514034,Herbst; Matthew,0,2,16,16
1715614139898,MMW 12R,A02,514035,Herbst; Matthew,0,0,16,16
1715614140930,MMW 13R,A01,514037,Staff,0,5,16,16
1715614140930,MMW 13R,A02,514039,Staff,0,5,16,16
1715614140930,MMW 13R,A03,628519,Staff,0,4,16,16
1715614142989,SIO 295LS,A00,523233,Staff,10,0,30,20
1715614144017,SIO 295S,A00,523232,Staff,10,0,30,20
1715614145043,SIOC 290S,A01,637330,Merrifield; Mark A,23,0,30,7
1715614146069,SIOC 291S,A01,637333,Gabriel; Corey John,23,0,30,7
1715614147094,SOCI 117,A01,494376,Staff,0,5,5,5
1715614148119,WES 237B,A00,494380,Staff,10,0,20,10
1715614150179,AESE 279B,A00,494370,Wade; Jon P,0,0,33,33
1715614151206,AIP 97,001,660915,Van Den Einde; Yael Dahlia,9999,0,9999,0
1715614152235,AIP 197,001,627712,Vespa; Emanuel Ignacio,9995,0,9999,4
1715614152235,AIP 197,002,650778,Amir; On,9998,0,9999,1
1715614152235,AIP 197,003,650933,Avenancio-Leon; Carlos,9998,0,9999,1
1715614152235,AIP 197,004,658530,Heyman; Gail D.,9998,0,9999,1
1715614152235,AIP 197,005,658631,Neal; Sonya E,9998,0,9999,1
1715614152235,AIP 197,006,658671,Du; Songzi,9998,0,9999,1
1715614153265,ANAR 135S,A00,494369,Braswell; Geoffrey E.,0,0,0,0
1715614154293,BENG 196,001,628496,Engler; Adam J.,9998,0,9999,1
1715614154293,BENG 196,002,660916,Watson; John Thomas,9999,0,9999,0
1715614155318,BISP 197,001,650773,Wilhelm; James E.,9994,0,9999,5
1715614155318,BISP 197,002,658904,Coleman; Aaron B.,9998,0,9999,1
1715614156344,CAT 124RS,A01,519847,Geibel; William,0,0,20,20
1715614157371,CAT 125RS,A01,515971,Geibel; William,0,0,20,20
1715614158398,CLRE 250,A00,511389,Morris; Sheldon,9992,0,9999,7
1715614159422,CLRE 251,A00,507176,Mehta; Ravindra L.,9992,0,9999,7
1715614159422,CLRE 251,B00,511410,Mehta; Ravindra L.,9998,0,9999,1
1715614160451,CLRE 252,A00,507189,Cuomo; Raphael Eduardo,9994,0,9999,5
1715614161475,CLRE 253,A00,507199,Vaida; Florin,9994,0,9999,5
1715614161475,CLRE 253,B00,507202,Vaida; Florin,9999,0,9999,0
1715614162505,CLRE 259,A00,507211,Patel; Hemal,9996,0,9999,3
1715614163532,CLRE 260,A00,507221,Cuomo; Raphael Eduardo,9999,0,9999,0
1715614164561,CLRE 297,001,507242,Cuomo; Raphael Eduardo,9999,0,9999,0
1715614165587,COGS 197,001,638244,Voytek; Bradley Thomas,9997,0,9999,2
1715614166614,CSE 191,A00,516875,Minnes Kemp; Mor Mia,9991,0,9999,8
1715614167639,CSE 197,001,637388,Minnes Kemp; Mor Mia,9992,0,9999,7
1715614168668,CSS 201S,A01,494383,Mignozzetti; Umberto,35,0,35,0
1715614169693,CSS 202S,A01,494387,Mignozzetti; Umberto,35,0,35,0
1715614170719,DSC 197,001,628532,Eldridge; Justin Matthew,9995,0,9999,4
1715614171746,EAP 100,A00,516065,Staff,9799,0,9999,200
1715614172773,ECE 45,A01,507414,Staff,31,0,60,29
1715614174826,ECE 111,A01,507420,Staff,11,0,50,39
1715614175851,ECE 197,001,548057,Sievenpiper; Daniel F.,9991,0,9999,8
1715614176882,EDS 115,A00,507243,Choi; Bailey Miyeon,7,0,28,21
1715614177910,EDS 117,A01,494379,Staff,0,6,34,34
1715614178937,EDS 125,A00,507246,Hopkins; Megan Beth,8,0,30,22
1715614179966,EDS 128A,A01,507264,Fargason; Sharon Gayle,6,0,26,20
1715614180995,EDS 128B,A01,507293,Pappas; Elizabeth,10,0,30,20
1715614182021,EDS 139,A00,507294,Fargason; Sharon Gayle,10,0,30,20
1715614182021,EDS 139,B00,507313,Pappas; Elizabeth,11,0,30,19
1715614183048,EDS 201,A00,507315,Staff,10,0,30,20
1715614184076,EDS 203,A01,507317,Halter; Christopher P.,10,0,30,20
1715614185105,EDS 204R,A01,507319,Halter; Christopher P.,0,3,30,30
1715614185105,EDS 204R,B01,507331,Heinzman; Erica M.,14,0,30,16
1715614186131,EDS 206R,A00,507332,Staff,0,4,30,30
1715614186131,EDS 206R,B00,507343,Staff,15,0,30,15
1715614187158,EDS 250,A00,507344,Hemans; Patricia Ann Benitez,20,0,40,20
1715614188241,EDS 281,A00,507345,Daly; Alan J.,18,0,18,0
1715614189273,EDS 284,A00,507350,Daly; Alan J.,16,0,16,0
1715614190299,EDS 286,A00,507359,Fine; Sarah,18,0,18,0
1715614191325,EDS 289C,A01,507361,Daly; Alan J.,18,0,18,0
1715614192350,EDS 290,A00,507366,Hofstetter; Carolyn,15,0,15,0
1715614193376,LIGM 5A,A00,507421,Fischer-Grunski; Eva K,17,0,20,3
1715614194401,LIGM 5B,A00,507423,Fischer-Grunski; Eva K,19,0,20,1
1715614195426,LIGM 5C,A00,507425,Fischer-Grunski; Eva K,19,0,20,1
1715614196453,LIIT 5AS,A00,507427,Carnelos; Chiara,20,0,20,0
1715614197477,LIIT 5BS,A00,507430,Carnelos; Chiara,20,0,20,0
1715614198504,LIIT 5CS,A00,507432,Carnelos; Chiara,20,0,20,0
1715614199535,LISP 5A,A00,507541,Munoz Sanchez; Alicia,11,0,20,9
1715614200561,LISP 5B,A00,507671,Munoz Sanchez; Alicia,9,0,20,11
1715614201590,LISP 5C,A00,507696,Munoz Sanchez; Alicia,9,0,20,11
1715614202618,MAE 197,001,528363,Boechler; Nicholas Sebastia,9998,0,9999,1
1715614203645,MATH 197,001,523477,Kedlaya; Kiran S.,9994,0,9999,5
1715614203645,MATH 197,002,563811,Zhang; Danna,9994,0,9999,5
1715614203645,MATH 197,003,628552,Dumitriu; Ioana,9998,0,9999,1
1715614203645,MATH 197,004,660885,Floyd; Eric,9999,0,9999,0
1715614204670,MCWP 40R,A00,518780,Staff,2,0,20,18
1715614204670,MCWP 40R,B00,518781,Staff,11,0,20,9
1715614204670,MCWP 40R,C00,518783,Staff,5,0,20,15
1715614205701,MCWP 50R,A00,518791,Staff,0,1,20,20
1715614205701,MCWP 50R,B00,518792,Staff,0,2,20,20
1715614205701,MCWP 50R,C00,518793,Staff,0,4,20,20
1715614205701,MCWP 50R,D00,518794,Staff,0,1,20,20
1715614205701,MCWP 50R,E00,518795,Staff,0,2,20,20
1715614205701,MCWP 50R,F00,518796,Staff,0,1,20,20
1715614205701,MCWP 50R,G00,518797,Staff,0,1,20,20
1715614206725,MMW 12R,A01,514034,Herbst; Matthew,0,2,16,16
1715614206725,MMW 12R,A02,514035,Herbst; Matthew,0,0,16,16
1715614207751,MMW 13R,A01,514037,Staff,0,5,16,16
1715614207751,MMW 13R,A02,514039,Staff,0,5,16,16
1715614207751,MMW 13R,A03,628519,Staff,0,4,16,16
1715614209802,SIO 295LS,A00,523233,Staff,10,0,30,20
1715614210831,SIO 295S,A00,523232,Staff,10,0,30,20
1715614211858,SIOC 290S,A01,637330,Merrifield; Mark A,23,0,30,7
1715614212889,SIOC 291S,A01,637333,Gabriel; Corey John,23,0,30,7
1715614213913,SOCI 117,A01,494376,Staff,0,5,5,5
1715614214941,WES 237B,A00,494380,Staff,10,0,20,10
1715614217000,AESE 279B,A00,494370,Wade; Jon P,0,0,33,33
1715614218031,AIP 97,001,660915,Van Den Einde; Yael Dahlia,9999,0,9999,0
1715614219059,AIP 197,001,627712,Vespa; Emanuel Ignacio,9995,0,9999,4
1715614219059,AIP 197,002,650778,Amir; On,9998,0,9999,1
1715614219059,AIP 197,003,650933,Avenancio-Leon; Carlos,9998,0,9999,1
1715614219059,AIP 197,004,658530,Heyman; Gail D.,9998,0,9999,1
1715614219059,AIP 197,005,658631,Neal; Sonya E,9998,0,9999,1
1715614219059,AIP 197,006,658671,Du; Songzi,9998,0,9999,1
1715614220087,ANAR 135S,A00,494369,Braswell; Geoffrey E.,0,0,0,0
1715614221113,BENG 196,001,628496,Engler; Adam J.,9998,0,9999,1
1715614221113,BENG 196,002,660916,Watson; John Thomas,9999,0,9999,0
1715614222139,BISP 197,001,650773,Wilhelm; James E.,9994,0,9999,5
1715614222139,BISP 197,002,658904,Coleman; Aaron B.,9998,0,9999,1
1715614223165,CAT 124RS,A01,519847,Geibel; William,0,0,20,20
1715614224193,CAT 125RS,A01,515971,Geibel; William,0,0,20,20
1715614225219,CLRE 250,A00,511389,Morris; Sheldon,9992,0,9999,7
1715614226249,CLRE 251,A00,507176,Mehta; Ravindra L.,9992,0,9999,7
1715614226249,CLRE 251,B00,511410,Mehta; Ravindra L.,9998,0,9999,1
1715614227277,CLRE 252,A00,507189,Cuomo; Raphael Eduardo,9994,0,9999,5
1715614228305,CLRE 253,A00,507199,Vaida; Florin,9994,0,9999,5
1715614228305,CLRE 253,B00,507202,Vaida; Florin,9999,0,9999,0
1715614229332,CLRE 259,A00,507211,Patel; Hemal,9996,0,9999,3
1715614230359,CLRE 260,A00,507221,Cuomo; Raphael Eduardo,9999,0,9999,0
1715614231385,CLRE 297,001,507242,Cuomo; Raphael Eduardo,9999,0,9999,0
1715614232411,COGS 197,001,638244,Voytek; Bradley Thomas,9997,0,9999,2
1715614233440,CSE 191,A00,516875,Minnes Kemp; Mor Mia,9991,0,9999,8
1715614234466,CSE 197,001,637388,Minnes Kemp; Mor Mia,9992,0,9999,7
1715614235492,CSS 201S,A01,494383,Mignozzetti; Umberto,35,0,35,0
1715614236517,CSS 202S,A01,494387,Mignozzetti; Umberto,35,0,35,0
1715614237544,DSC 197,001,628532,Eldridge; Justin Matthew,9995,0,9999,4
1715614238572,EAP 100,A00,516065,Staff,9799,0,9999,200
1715614239601,ECE 45,A01,507414,Staff,31,0,60,29
1715614241652,ECE 111,A01,507420,Staff,11,0,50,39
1715614242677,ECE 197,001,548057,Sievenpiper; Daniel F.,9991,0,9999,8
1715614243701,EDS 115,A00,507243,Choi; Bailey Miyeon,7,0,28,21
1715614244727,EDS 117,A01,494379,Staff,0,6,34,34
1715614245752,EDS 125,A00,507246,Hopkins; Megan Beth,8,0,30,22
1715614246780,EDS 128A,A01,507264,Fargason; Sharon Gayle,6,0,26,20
1715614247809,EDS 128B,A01,507293,Pappas; Elizabeth,10,0,30,20
1715614248835,EDS 139,A00,507294,Fargason; Sharon Gayle,10,0,30,20
1715614248835,EDS 139,B00,507313,Pappas; Elizabeth,11,0,30,19
1715614249861,EDS 201,A00,507315,Staff,10,0,30,20
1715614250891,EDS 203,A01,507317,Halter; Christopher P.,10,0,30,20
1715614251918,EDS 204R,A01,507319,Halter; Christopher P.,0,3,30,30
1715614251918,EDS 204R,B01,507331,Heinzman; Erica M.,14,0,30,16
1715614252946,EDS 206R,A00,507332,Staff,0,4,30,30
1715614252946,EDS 206R,B00,507343,Staff,15,0,30,15
1715614253975,EDS 250,A00,507344,Hemans; Patricia Ann Benitez,20,0,40,20
1715614255001,EDS 281,A00,507345,Daly; Alan J.,18,0,18,0
1715614256027,EDS 284,A00,507350,Daly; Alan J.,16,0,16,0
1715614257052,EDS 286,A00,507359,Fine; Sarah,18,0,18,0
1715614258081,EDS 289C,A01,507361,Daly; Alan J.,18,0,18,0
1715614259110,EDS 290,A00,507366,Hofstetter; Carolyn,15,0,15,0
1715614260136,LIGM 5A,A00,507421,Fischer-Grunski; Eva K,17,0,20,3
1715614261167,LIGM 5B,A00,507423,Fischer-Grunski; Eva K,19,0,20,1
1715614262193,LIGM 5C,A00,507425,Fischer-Grunski; Eva K,19,0,20,1
1715614263225,LIIT 5AS,A00,507427,Carnelos; Chiara,20,0,20,0
1715614264255,LIIT 5BS,A00,507430,Carnelos; Chiara,20,0,20,0
1715614265281,LIIT 5CS,A00,507432,Carnelos; Chiara,20,0,20,0
1715614266311,LISP 5A,A00,507541,Munoz Sanchez; Alicia,11,0,20,9
1715614267337,LISP 5B,A00,507671,Munoz Sanchez; Alicia,9,0,20,11
1715614268363,LISP 5C,A00,507696,Munoz Sanchez; Alicia,9,0,20,11
1715614269389,MAE 197,001,528363,Boechler; Nicholas Sebastia,9998,0,9999,1
1715614270416,MATH 197,001,523477,Kedlaya; Kiran S.,9994,0,9999,5
1715614270416,MATH 197,002,563811,Zhang; Danna,9994,0,9999,5
1715614270416,MATH 197,003,628552,Dumitriu; Ioana,9998,0,9999,1
1715614270416,MATH 197,004,660885,Floyd; Eric,9999,0,9999,0
1715614271441,MCWP 40R,A00,518780,Staff,2,0,20,18
1715614271441,MCWP 40R,B00,518781,Staff,11,0,20,9
1715614271441,MCWP 40R,C00,518783,Staff,5,0,20,15
1715614272468,MCWP 50R,A00,518791,Staff,0,1,20,20
1715614272468,MCWP 50R,B00,518792,Staff,0,2,20,20
1715614272468,MCWP 50R,C00,518793,Staff,0,4,20,20
1715614272468,MCWP 50R,D00,518794,Staff,0,1,20,20
1715614272468,MCWP 50R,E00,518795,Staff,0,2,20,20
1715614272468,MCWP 50R,F00,518796,Staff,0,1,20,20
1715614272468,MCWP 50R,G00,518797,Staff,0,1,20,20
1715614273494,MMW 12R,A01,514034,Herbst; Matthew,0,2,16,16
1715614273494,MMW 12R,A02,514035,Herbst; Matthew,0,0,16,16
1715614274521,MMW 13R,A01,514037,Staff,0,5,16,16
1715614274521,MMW 13R,A02,514039,Staff,0,5,16,16
1715614274521,MMW 13R,A03,628519,Staff,0,4,16,16
1715614276571,SIO 295LS,A00,523233,Staff,10,0,30,20
1715614277597,SIO 295S,A00,523232,Staff,10,0,30,20
1715614278626,SIOC 290S,A01,637330,Merrifield; Mark A,23,0,30,7
1715614279653,SIOC 291S,A01,637333,Gabriel; Corey John,23,0,30,7
1715614280680,SOCI 117,A01,494376,Staff,0,5,5,5
1715614281705,WES 237B,A00,494380,Staff,10,0,20,10
1715614283767,AESE 279B,A00,494370,Wade; Jon P,0,0,33,33
1715614284795,AIP 97,001,660915,Van Den Einde; Yael Dahlia,9999,0,9999,0
1715614285824,AIP 197,001,627712,Vespa; Emanuel Ignacio,9995,0,9999,4
1715614285824,AIP 197,002,650778,Amir; On,9998,0,9999,1
1715614285824,AIP 197,003,650933,Avenancio-Leon; Carlos,9998,0,9999,1
1715614285824,AIP 197,004,658530,Heyman; Gail D.,9998,0,9999,1
1715614285824,AIP 197,005,658631,Neal; Sonya E,9998,0,9999,1
1715614285824,AIP 197,006,658671,Du; Songzi,9998,0,9999,1
1715614286848,ANAR 135S,A00,494369,Braswell; Geoffrey E.,0,0,0,0
1715614287878,BENG 196,001,628496,Engler; Adam J.,9998,0,9999,1
1715614287878,BENG 196,002,660916,Watson; John Thomas,9999,0,9999,0
1715614288905,BISP 197,001,650773,Wilhelm; James E.,9994,0,9999,5
1715614288905,BISP 197,002,658904,Coleman; Aaron B.,9998,0,9999,1
1715614289930,CAT 124RS,A01,519847,Geibel; William,0,0,20,20
1715614290956,CAT 125RS,A01,515971,Geibel; William,0,0,20,20
1715614292039,CLRE 250,A00,511389,Morris; Sheldon,9992,0,9999,7
1715614293065,CLRE 251,A00,507176,Mehta; Ravindra L.,9992,0,9999,7
1715614293065,CLRE 251,B00,511410,Mehta; Ravindra L.,9998,0,9999,1
1715614294094,CLRE 252,A00,507189,Cuomo; Raphael Eduardo,9994,0,9999,5
1715614295120,CLRE 253,A00,507199,Vaida; Florin,9994,0,9999,5
1715614295120,CLRE 253,B00,507202,Vaida; Florin,9999,0,9999,0
1715614296145,CLRE 259,A00,507211,Patel; Hemal,9996,0,9999,3
1715614297172,CLRE 260,A00,507221,Cuomo; Raphael Eduardo,9999,0,9999,0
1715614298199,CLRE 297,001,507242,Cuomo; Raphael Eduardo,9999,0,9999,0
1715614299226,COGS 197,001,638244,Voytek; Bradley Thomas,9997,0,9999,2
1715614300253,CSE 191,A00,516875,Minnes Kemp; Mor Mia,9991,0,9999,8
1715614301283,CSE 197,001,637388,Minnes Kemp; Mor Mia,9992,0,9999,7
1715614302312,CSS 201S,A01,494383,Mignozzetti; Umberto,35,0,35,0
1715614303339,CSS 202S,A01,494387,Mignozzetti; Umberto,35,0,35,0
1715614304365,DSC 197,001,628532,Eldridge; Justin Matthew,9995,0,9999,4
1715614305391,EAP 100,A00,516065,Staff,9799,0,9999,200
1715614306422,ECE 45,A01,507414,Staff,31,0,60,29
1715614308478,ECE 111,A01,507420,Staff,11,0,50,39
1715614309503,ECE 197,001,548057,Sievenpiper; Daniel F.,9991,0,9999,8
1715614310529,EDS 115,A00,507243,Choi; Bailey Miyeon,7,0,28,21
1715614311554,EDS 117,A01,494379,Staff,0,6,34,34
1715614312580,EDS 125,A00,507246,Hopkins; Megan Beth,8,0,30,22
1715614313606,EDS 128A,A01,507264,Fargason; Sharon Gayle,6,0,26,20
1715614314634,EDS 128B,A01,507293,Pappas; Elizabeth,10,0,30,20
1715614315660,EDS 139,A00,507294,Fargason; Sharon Gayle,10,0,30,20
1715614315660,EDS 139,B00,507313,Pappas; Elizabeth,11,0,30,19
1715614316685,EDS 201,A00,507315,Staff,10,0,30,20
1715614317713,EDS 203,A01,507317,Halter; Christopher P.,10,0,30,20
1715614318738,EDS 204R,A01,507319,Halter; Christopher P.,0,3,30,30
1715614318738,EDS 204R,B01,507331,Heinzman; Erica M.,14,0,30,16
1715614319763,EDS 206R,A00,507332,Staff,0,4,30,30
1715614319763,EDS 206R,B00,507343,Staff,15,0,30,15
1715614320789,EDS 250,A00,507344,Hemans; Patricia Ann Benitez,20,0,40,20
1715614321815,EDS 281,A00,507345,Daly; Alan J.,18,0,18,0
1715614322840,EDS 284,A00,507350,Daly; Alan J.,16,0,16,0
1715614323869,EDS 286,A00,507359,Fine; Sarah,18,0,18,0
1715614324897,EDS 289C,A01,507361,Daly; Alan J.,18,0,18,0
1715614325922,EDS 290,A00,507366,Hofstetter; Carolyn,15,0,15,0
1715614326948,LIGM 5A,A00,507421,Fischer-Grunski; Eva K,17,0,20,3
1715614327974,LIGM 5B,A00,507423,Fischer-Grunski; Eva K,19,0,20,1
1715614329002,LIGM 5C,A00,507425,Fischer-Grunski; Eva K,19,0,20,1
1715614330029,LIIT 5AS,A00,507427,Carnelos; Chiara,20,0,20,0
1715614331055,LIIT 5BS,A00,507430,Carnelos; Chiara,20,0,20,0
1715614332084,LIIT 5CS,A00,507432,Carnelos; Chiara,20,0,20,0
1715614333109,LISP 5A,A00,507541,Munoz Sanchez; Alicia,11,0,20,9
1715614334135,LISP 5B,A00,507671,Munoz Sanchez; Alicia,9,0,20,11
1715614335164,LISP 5C,A00,507696,Munoz Sanchez; Alicia,9,0,20,11
1715614336190,MAE 197,001,528363,Boechler; Nicholas Sebastia,9998,0,9999,1
1715614337215,MATH 197,001,523477,Kedlaya; Kiran S.,9994,0,9999,5
1715614337215,MATH 197,002,563811,Zhang; Danna,9994,0,9999,5
1715614337215,MATH 197,003,628552,Dumitriu; Ioana,9998,0,9999,1
1715614337215,MATH 197,004,660885,Floyd; Eric,9999,0,9999,0
1715614338241,MCWP 40R,A00,518780,Staff,2,0,20,18
1715614338241,MCWP 40R,B00,518781,Staff,11,0,20,9
1715614338241,MCWP 40R,C00,518783,Staff,5,0,20,15
1715614339271,MCWP 50R,A00,518791,Staff,0,1,20,20
1715614339271,MCWP 50R,B00,518792,Staff,0,2,20,20
1715614339271,MCWP 50R,C00,518793,Staff,0,4,20,20
1715614339271,MCWP 50R,D00,518794,Staff,0,1,20,20
1715614339271,MCWP 50R,E00,518795,Staff,0,2,20,20
1715614339271,MCWP 50R,F00,518796,Staff,0,1,20,20
1715614339271,MCWP 50R,G00,518797,Staff,0,1,20,20
1715614340295,MMW 12R,A01,514034,Herbst; Matthew,0,2,16,16
1715614340295,MMW 12R,A02,514035,Herbst; Matthew,0,0,16,16
1715614341322,MMW 13R,A01,514037,Staff,0,5,16,16
1715614341322,MMW 13R,A02,514039,Staff,0,5,16,16
1715614341322,MMW 13R,A03,628519,Staff,0,4,16,16
1715614343378,SIO 295LS,A00,523233,Staff,10,0,30,20
1715614344405,SIO 295S,A00,523232,Staff,10,0,30,20
1715614345429,SIOC 290S,A01,637330,Merrifield; Mark A,23,0,30,7
1715614346457,SIOC 291S,A01,637333,Gabriel; Corey John,23,0,30,7
1715614347486,SOCI 117,A01,494376,Staff,0,5,5,5
1715614348514,WES 237B,A00,494380,Staff,10,0,20,10
1715614350584,AESE 279B,A00,494370,Wade; Jon P,0,0,33,33
1715614351613,AIP 97,001,660915,Van Den Einde; Yael Dahlia,9999,0,9999,0
1715614352639,AIP 197,001,627712,Vespa; Emanuel Ignacio,9995,0,9999,4
1715614352639,AIP 197,002,650778,Amir; On,9998,0,9999,1
1715614352639,AIP 197,003,650933,Avenancio-Leon; Carlos,9998,0,9999,1
1715614352639,AIP 197,004,658530,Heyman; Gail D.,9998,0,9999,1
1715614352639,AIP 197,005,658631,Neal; Sonya E,9998,0,9999,1
1715614352639,AIP 197,006,658671,Du; Songzi,9998,0,9999,1
1715614353664,ANAR 135S,A00,494369,Braswell; Geoffrey E.,0,0,0,0
1715614354691,BENG 196,001,628496,Engler; Adam J.,9998,0,9999,1
1715614354691,BENG 196,002,660916,Watson; John Thomas,9999,0,9999,0
1715614355719,BISP 197,001,650773,Wilhelm; James E.,9994,0,9999,5
1715614355719,BISP 197,002,658904,Coleman; Aaron B.,9998,0,9999,1
1715614356745,CAT 124RS,A01,519847,Geibel; William,0,0,20,20
1715614357769,CAT 125RS,A01,515971,Geibel; William,0,0,20,20
1715614358797,CLRE 250,A00,511389,Morris; Sheldon,9992,0,9999,7
1715614359827,CLRE 251,A00,507176,Mehta; Ravindra L.,9992,0,9999,7
1715614359827,CLRE 251,B00,511410,Mehta; Ravindra L.,9998,0,9999,1
1715614360852,CLRE 252,A00,507189,Cuomo; Raphael Eduardo,9994,0,9999,5
1715614361884,CLRE 253,A00,507199,Vaida; Florin,9994,0,9999,5
1715614361884,CLRE 253,B00,507202,Vaida; Florin,9999,0,9999,0
1715614362913,CLRE 259,A00,507211,Patel; Hemal,9996,0,9999,3
1715614363937,CLRE 260,A00,507221,Cuomo; Raphael Eduardo,9999,0,9999,0
1715614364965,CLRE 297,001,507242,Cuomo; Raphael Eduardo,9999,0,9999,0
1715614365989,COGS 197,001,638244,Voytek; Bradley Thomas,9997,0,9999,2
1715614367014,CSE 191,A00,516875,Minnes Kemp; Mor Mia,9991,0,9999,8
1715614368039,CSE 197,001,637388,Minnes Kemp; Mor Mia,9992,0,9999,7
1715614369066,CSS 201S,A01,494383,Mignozzetti; Umberto,35,0,35,0
1715614370095,CSS 202S,A01,494387,Mignozzetti; Umberto,35,0,35,0
1715614371121,DSC 197,001,628532,Eldridge; Justin Matthew,9995,0,9999,4
1715614372147,EAP 100,A00,516065,Staff,9799,0,9999,200
1715614373172,ECE 45,A01,507414,Staff,31,0,60,29
1715614375226,ECE 111,A01,507420,Staff,11,0,50,39
1715614376251,ECE 197,001,548057,Sievenpiper; Daniel F.,9991,0,9999,8
1715614377277,EDS 115,A00,507243,Choi; Bailey Miyeon,7,0,28,21
1715614378303,EDS 117,A01,494379,Staff,0,6,34,34
1715614379333,EDS 125,A00,507246,Hopkins; Megan Beth,8,0,30,22
1715614380357,EDS 128A,A01,507264,Fargason; Sharon Gayle,6,0,26,20
1715614381383,EDS 128B,A01,507293,Pappas; Elizabeth,10,0,30,20
1715614382410,EDS 139,A00,507294,Fargason; Sharon Gayle,10,0,30,20
1715614382410,EDS 139,B00,507313,Pappas; Elizabeth,11,0,30,19
1715614383438,EDS 201,A00,507315,Staff,10,0,30,20
1715614384463,EDS 203,A01,507317,Halter; Christopher P.,10,0,30,20
1715614385489,EDS 204R,A01,507319,Halter; Christopher P.,0,3,30,30
1715614385489,EDS 204R,B01,507331,Heinzman; Erica M.,14,0,30,16
1715614386514,EDS 206R,A00,507332,Staff,0,4,30,30
1715614386514,EDS 206R,B00,507343,Staff,15,0,30,15
1715614387543,EDS 250,A00,507344,Hemans; Patricia Ann Benitez,20,0,40,20
1715614388567,EDS 281,A00,507345,Daly; Alan J.,18,0,18,0
1715614389596,EDS 284,A00,507350,Daly; Alan J.,16,0,16,0
1715614390624,EDS 286,A00,507359,Fine; Sarah,18,0,18,0
1715614391650,EDS 289C,A01,507361,Daly; Alan J.,18,0,18,0
1715614392677,EDS 290,A00,507366,Hofstetter; Carolyn,15,0,15,0
1715614393702,LIGM 5A,A00,507421,Fischer-Grunski; Eva K,17,0,20,3
1715614394727,LIGM 5B,A00,507423,Fischer-Grunski; Eva K,19,0,20,1
1715614395810,LIGM 5C,A00,507425,Fischer-Grunski; Eva K,19,0,20,1
1715614396835,LIIT 5AS,A00,507427,Carnelos; Chiara,20,0,20,0
1715614397860,LIIT 5BS,A00,507430,Carnelos; Chiara,20,0,20,0
1715614398886,LIIT 5CS,A00,507432,Carnelos; Chiara,20,0,20,0
1715614400124,LISP 5A,A00,507541,Munoz Sanchez; Alicia,11,0,20,9
1715614401151,LISP 5B,A00,507671,Munoz Sanchez; Alicia,9,0,20,11
1715614402176,LISP 5C,A00,507696,Munoz Sanchez; Alicia,9,0,20,11
1715614403202,MAE 197,001,528363,Boechler; Nicholas Sebastia,9998,0,9999,1
1715614404230,MATH 197,001,523477,Kedlaya; Kiran S.,9994,0,9999,5
1715614404230,MATH 197,002,563811,Zhang; Danna,9994,0,9999,5
1715614404230,MATH 197,003,628552,Dumitriu; Ioana,9998,0,9999,1
1715614404230,MATH 197,004,660885,Floyd; Eric,9999,0,9999,0
1715614405255,MCWP 40R,A00,518780,Staff,2,0,20,18
1715614405255,MCWP 40R,B00,518781,Staff,11,0,20,9
1715614405255,MCWP 40R,C00,518783,Staff,5,0,20,15
1715614406285,MCWP 50R,A00,518791,Staff,0,1,20,20
1715614406285,MCWP 50R,B00,518792,Staff,0,2,20,20
1715614406285,MCWP 50R,C00,518793,Staff,0,4,20,20
1715614406285,MCWP 50R,D00,518794,Staff,0,1,20,20
1715614406285,MCWP 50R,E00,518795,Staff,0,2,20,20
1715614406285,MCWP 50R,F00,518796,Staff,0,1,20,20
1715614406285,MCWP 50R,G00,518797,Staff,0,1,20,20
1715614407309,MMW 12R,A01,514034,Herbst; Matthew,0,2,16,16
1715614407309,MMW 12R,A02,514035,Herbst; Matthew,0,0,16,16
1715614408335,MMW 13R,A01,514037,Staff,0,5,16,16
1715614408335,MMW 13R,A02,514039,Staff,0,5,16,16
1715614408335,MMW 13R,A03,628519,Staff,0,4,16,16
1715614410389,SIO 295LS,A00,523233,Staff,10,0,30,20
1715614411417,SIO 295S,A00,523232,Staff,10,0,30,20
1715614412443,SIOC 290S,A01,637330,Merrifield; Mark A,23,0,30,7
1715614413469,SIOC 291S,A01,637333,Gabriel; Corey John,23,0,30,7
1715614414493,SOCI 117,A01,494376,Staff,0,5,5,5
1715614415521,WES 237B,A00,494380,Staff,10,0,20,10
1715614417580,AESE 279B,A00,494370,Wade; Jon P,0,0,33,33
1715614418609,AIP 97,001,660915,Van Den Einde; Yael Dahlia,9999,0,9999,0
1715614419635,AIP 197,001,627712,Vespa; Emanuel Ignacio,9995,0,9999,4
1715614419635,AIP 197,002,650778,Amir; On,9998,0,9999,1
1715614419635,AIP 197,003,650933,Avenancio-Leon; Carlos,9998,0,9999,1
1715614419635,AIP 197,004,658530,Heyman; Gail D.,9998,0,9999,1
1715614419635,AIP 197,005,658631,Neal; Sonya E,9998,0,9999,1
1715614419635,AIP 197,006,658671,Du; Songzi,9998,0,9999,1
1715614420661,ANAR 135S,A00,494369,Braswell; Geoffrey E.,0,0,0,0
1715614421688,BENG 196,001,628496,Engler; Adam J.,9998,0,9999,1
1715614421688,BENG 196,002,660916,Watson; John Thomas,9999,0,9999,0
1715614422714,BISP 197,001,650773,Wilhelm; James E.,9994,0,9999,5
1715614422714,BISP 197,002,658904,Coleman; Aaron B.,9998,0,9999,1
1715614423741,CAT 124RS,A01,519847,Geibel; William,0,0,20,20
1715614424767,CAT 125RS,A01,515971,Geibel; William,0,0,20,20
1715614425794,CLRE 250,A00,511389,Morris; Sheldon,9992,0,9999,7
1715614426820,CLRE 251,A00,507176,Mehta; Ravindra L.,9992,0,9999,7
1715614426820,CLRE 251,B00,511410,Mehta; Ravindra L.,9998,0,9999,1
1715614427845,CLRE 252,A00,507189,Cuomo; Raphael Eduardo,9994,0,9999,5
1715614428870,CLRE 253,A00,507199,Vaida; Florin,9994,0,9999,5
1715614428870,CLRE 253,B00,507202,Vaida; Florin,9999,0,9999,0
1715614429897,CLRE 259,A00,507211,Patel; Hemal,9996,0,9999,3
1715614430921,CLRE 260,A00,507221,Cuomo; Raphael Eduardo,9999,0,9999,0
1715614431945,CLRE 297,001,507242,Cuomo; Raphael Eduardo,9999,0,9999,0
1715614432971,COGS 197,001,638244,Voytek; Bradley Thomas,9997,0,9999,2
1715614433998,CSE 191,A00,516875,Minnes Kemp; Mor Mia,9991,0,9999,8
1715614435024,CSE 197,001,637388,Minnes Kemp; Mor Mia,9992,0,9999,7
1715614436051,CSS 201S,A01,494383,Mignozzetti; Umberto,35,0,35,0
1715614437078,CSS 202S,A01,494387,Mignozzetti; Umberto,35,0,35,0
1715614438104,DSC 197,001,628532,Eldridge; Justin Matthew,9995,0,9999,4
1715614439129,EAP 100,A00,516065,Staff,9799,0,9999,200
1715614440161,ECE 45,A01,507414,Staff,31,0,60,29
1715614442218,ECE 111,A01,507420,Staff,11,0,50,39
1715614443242,ECE 197,001,548057,Sievenpiper; Daniel F.,9991,0,9999,8
1715614444268,EDS 115,A00,507243,Choi; Bailey Miyeon,7,0,28,21
1715614445295,EDS 117,A01,494379,Staff,0,6,34,34
1715614446325,EDS 125,A00,507246,Hopkins; Megan Beth,8,0,30,22
1715614447352,EDS 128A,A01,507264,Fargason; Sharon Gayle,6,0,26,20
1715614448378,EDS 128B,A01,507293,Pappas; Elizabeth,10,0,30,20
1715614449406,EDS 139,A00,507294,Fargason; Sharon Gayle,10,0,30,20
1715614449406,EDS 139,B00,507313,Pappas; Elizabeth,11,0,30,19
1715614450432,EDS 201,A00,507315,Staff,10,0,30,20
1715614451462,EDS 203,A01,507317,Halter; Christopher P.,10,0,30,20
1715614452489,EDS 204R,A01,507319,Halter; Christopher P.,0,3,30,30
1715614452489,EDS 204R,B01,507331,Heinzman; Erica M.,14,0,30,16
1715614453514,EDS 206R,A00,507332,Staff,0,4,30,30
1715614453514,EDS 206R,B00,507343,Staff,15,0,30,15
1715614454542,EDS 250,A00,507344,Hemans; Patricia Ann Benitez,20,0,40,20
1715614455569,EDS 281,A00,507345,Daly; Alan J.,18,0,18,0
1715614456594,EDS 284,A00,507350,Daly; Alan J.,16,0,16,0
1715614457620,EDS 286,A00,507359,Fine; Sarah,18,0,18,0
1715614458646,EDS 289C,A01,507361,Daly; Alan J.,18,0,18,0
1715614459670,EDS 290,A00,507366,Hofstetter; Carolyn,15,0,15,0
1715614460697,LIGM 5A,A00,507421,Fischer-Grunski; Eva K,17,0,20,3
1715614461725,LIGM 5B,A00,507423,Fischer-Grunski; Eva K,19,0,20,1
1715614462752,LIGM 5C,A00,507425,Fischer-Grunski; Eva K,19,0,20,1
1715614463780,LIIT 5AS,A00,507427,Carnelos; Chiara,20,0,20,0
1715614464808,LIIT 5BS,A00,507430,Carnelos; Chiara,20,0,20,0
1715614465834,LIIT 5CS,A00,507432,Carnelos; Chiara,20,0,20,0
1715614466860,LISP 5A,A00,507541,Munoz Sanchez; Alicia,11,0,20,9
1715614467887,LISP 5B,A00,507671,Munoz Sanchez; Alicia,9,0,20,11
1715614468913,LISP 5C,A00,507696,Munoz Sanchez; Alicia,9,0,20,11
1715614469937,MAE 197,001,528363,Boechler; Nicholas Sebastia,9998,0,9999,1
1715614470963,MATH 197,001,523477,Kedlaya; Kiran S.,9994,0,9999,5
1715614470963,MATH 197,002,563811,Zhang; Danna,9994,0,9999,5
1715614470963,MATH 197,003,628552,Dumitriu; Ioana,9998,0,9999,1
1715614470963,MATH 197,004,660885,Floyd; Eric,9999,0,9999,0
1715614471987,MCWP 40R,A00,518780,Staff,2,0,20,18
1715614471987,MCWP 40R,B00,518781,Staff,11,0,20,9
1715614471987,MCWP 40R,C00,518783,Staff,5,0,20,15
1715614473013,MCWP 50R,A00,518791,Staff,0,1,20,20
1715614473013,MCWP 50R,B00,518792,Staff,0,2,20,20
1715614473013,MCWP 50R,C00,518793,Staff,0,4,20,20
1715614473013,MCWP 50R,D00,518794,Staff,0,1,20,20
1715614473013,MCWP 50R,E00,518795,Staff,0,2,20,20
1715614473013,MCWP 50R,F00,518796,Staff,0,1,20,20
1715614473013,MCWP 50R,G00,518797,Staff,0,1,20,20
1715614474038,MMW 12R,A01,514034,Herbst; Matthew,0,2,16,16
1715614474038,MMW 12R,A02,514035,Herbst; Matthew,0,0,16,16
1715614475062,MMW 13R,A01,514037,Staff,0,5,16,16
1715614475062,MMW 13R,A02,514039,Staff,0,5,16,16
1715614475062,MMW 13R,A03,628519,Staff,0,4,16,16
1715614477118,SIO 295LS,A00,523233,Staff,10,0,30,20
1715614478145,SIO 295S,A00,523232,Staff,10,0,30,20
1715614479172,SIOC 290S,A01,637330,Merrifield; Mark A,23,0,30,7
1715614480199,SIOC 291S,A01,637333,Gabriel; Corey John,23,0,30,7
1715614481228,SOCI 117,A01,494376,Staff,0,5,5,5
1715614482257,WES 237B,A00,494380,Staff,10,0,20,10
1715614484319,AESE 279B,A00,494370,Wade; Jon P,0,0,33,33
1715614485348,AIP 97,001,660915,Van Den Einde; Yael Dahlia,9999,0,9999,0
1715614486373,AIP 197,001,627712,Vespa; Emanuel Ignacio,9995,0,9999,4
1715614486373,AIP 197,002,650778,Amir; On,9998,0,9999,1
1715614486373,AIP 197,003,650933,Avenancio-Leon; Carlos,9998,0,9999,1
1715614486373,AIP 197,004,658530,Heyman; Gail D.,9998,0,9999,1
1715614486373,AIP 197,005,658631,Neal; Sonya E,9998,0,9999,1
1715614486373,AIP 197,006,658671,Du; Songzi,9998,0,9999,1
1715614487402,ANAR 135S,A00,494369,Braswell; Geoffrey E.,0,0,0,0
1715614488427,BENG 196,001,628496,Engler; Adam J.,9998,0,9999,1
1715614488427,BENG 196,002,660916,Watson; John Thomas,9999,0,9999,0
1715614489453,BISP 197,001,650773,Wilhelm; James E.,9994,0,9999,5
1715614489453,BISP 197,002,658904,Coleman; Aaron B.,9998,0,9999,1
1715614490481,CAT 124RS,A01,519847,Geibel; William,0,0,20,20
1715614491510,CAT 125RS,A01,515971,Geibel; William,0,0,20,20
1715614492535,CLRE 250,A00,511389,Morris; Sheldon,9992,0,9999,7
1715614493565,CLRE 251,A00,507176,Mehta; Ravindra L.,9992,0,9999,7
1715614493565,CLRE 251,B00,511410,Mehta; Ravindra L.,9998,0,9999,1
1715614494591,CLRE 252,A00,507189,Cuomo; Raphael Eduardo,9994,0,9999,5
1715614495617,CLRE 253,A00,507199,Vaida; Florin,9994,0,9999,5
1715614495617,CLRE 253,B00,507202,Vaida; Florin,9999,0,9999,0
1715614496642,CLRE 259,A00,507211,Patel; Hemal,9996,0,9999,3
1715614497667,CLRE 260,A00,507221,Cuomo; Raphael Eduardo,9999,0,9999,0
1715614498694,CLRE 297,001,507242,Cuomo; Raphael Eduardo,9999,0,9999,0
1715614499778,COGS 197,001,638244,Voytek; Bradley Thomas,9997,0,9999,2
1715614500809,CSE 191,A00,516875,Minnes Kemp; Mor Mia,9991,0,9999,8
1715614501837,CSE 197,001,637388,Minnes Kemp; Mor Mia,9992,0,9999,7
1715614502864,CSS 201S,A01,494383,Mignozzetti; Umberto,35,0,35,0
1715614503890,CSS 202S,A01,494387,Mignozzetti; Umberto,35,0,35,0
1715614504915,DSC 197,001,628532,Eldridge; Justin Matthew,9995,0,9999,4
1715614505941,EAP 100,A00,516065,Staff,9799,0,9999,200
1715614506968,ECE 45,A01,507414,Staff,31,0,60,29
1715614509024,ECE 111,A01,507420,Staff,11,0,50,39
1715614510050,ECE 197,001,548057,Sievenpiper; Daniel F.,9991,0,9999,8
1715614511078,EDS 115,A00,507243,Choi; Bailey Miyeon,7,0,28,21
1715614512102,EDS 117,A01,494379,Staff,0,6,34,34
1715614513128,EDS 125,A00,507246,Hopkins; Megan Beth,8,0,30,22
1715614514153,EDS 128A,A01,507264,Fargason; Sharon Gayle,6,0,26,20
1715614515178,EDS 128B,A01,507293,Pappas; Elizabeth,10,0,30,20
1715614516203,EDS 139,A00,507294,Fargason; Sharon Gayle,10,0,30,20
1715614516203,EDS 139,B00,507313,Pappas; Elizabeth,11,0,30,19
1715614517231,EDS 201,A00,507315,Staff,10,0,30,20
1715614518257,EDS 203,A01,507317,Halter; Christopher P.,10,0,30,20
1715614519287,EDS 204R,A01,507319,Halter; Christopher P.,0,3,30,30
1715614519287,EDS 204R,B01,507331,Heinzman; Erica M.,14,0,30,16
1715614520315,EDS 206R,A00,507332,Staff,0,4,30,30
1715614520315,EDS 206R,B00,507343,Staff,15,0,30,15
1715614521344,EDS 250,A00,507344,Hemans; Patricia Ann Benitez,20,0,40,20
1715614522372,EDS 281,A00,507345,Daly; Alan J.,18,0,18,0
1715614523398,EDS 284,A00,507350,Daly; Alan J.,16,0,16,0
1715614524426,EDS 286,A00,507359,Fine; Sarah,18,0,18,0
1715614525451,EDS 289C,A01,507361,Daly; Alan J.,18,0,18,0
1715614526479,EDS 290,A00,507366,Hofstetter; Carolyn,15,0,15,0
1715614527505,LIGM 5A,A00,507421,Fischer-Grunski; Eva K,17,0,20,3
1715614528530,LIGM 5B,A00,507423,Fischer-Grunski; Eva K,19,0,20,1
1715614529557,LIGM 5C,A00,507425,Fischer-Grunski; Eva K,19,0,20,1
1715614530583,LIIT 5AS,A00,507427,Carnelos; Chiara,20,0,20,0
1715614531614,LIIT 5BS,A00,507430,Carnelos; Chiara,20,0,20,0
1715614532639,LIIT 5CS,A00,507432,Carnelos; Chiara,20,0,20,0
1715614533667,LISP 5A,A00,507541,Munoz Sanchez; Alicia,11,0,20,9
1715614534694,LISP 5B,A00,507671,Munoz Sanchez; Alicia,9,0,20,11
1715614535720,LISP 5C,A00,507696,Munoz Sanchez; Alicia,9,0,20,11
1715614536748,MAE 197,001,528363,Boechler; Nicholas Sebastia,9998,0,9999,1
1715614537773,MATH 197,001,523477,Kedlaya; Kiran S.,9994,0,9999,5
1715614537773,MATH 197,002,563811,Zhang; Danna,9994,0,9999,5
1715614537773,MATH 197,003,628552,Dumitriu; Ioana,9998,0,9999,1
1715614537773,MATH 197,004,660885,Floyd; Eric,9999,0,9999,0
1715614538801,MCWP 40R,A00,518780,Staff,2,0,20,18
1715614538801,MCWP 40R,B00,518781,Staff,11,0,20,9
1715614538801,MCWP 40R,C00,518783,Staff,5,0,20,15
1715614539831,MCWP 50R,A00,518791,Staff,0,1,20,20
1715614539831,MCWP 50R,B00,518792,Staff,0,2,20,20
1715614539831,MCWP 50R,C00,518793,Staff,0,4,20,20
1715614539831,MCWP 50R,D00,518794,Staff,0,1,20,20
1715614539831,MCWP 50R,E00,518795,Staff,0,2,20,20
1715614539831,MCWP 50R,F00,518796,Staff,0,1,20,20
1715614539831,MCWP 50R,G00,518797,Staff,0,1,20,20
1715614540856,MMW 12R,A01,514034,Herbst; Matthew,0,2,16,16
1715614540856,MMW 12R,A02,514035,Herbst; Matthew,0,0,16,16
1715614541882,MMW 13R,A01,514037,Staff,0,5,16,16
1715614541882,MMW 13R,A02,514039,Staff,0,5,16,16
1715614541882,MMW 13R,A03,628519,Staff,0,4,16,16
1715614543933,SIO 295LS,A00,523233,Staff,10,0,30,20
1715614544960,SIO 295S,A00,523232,Staff,10,0,30,20
1715614545985,SIOC 290S,A01,637330,Merrifield; Mark A,23,0,30,7
1715614547010,SIOC 291S,A01,637333,Gabriel; Corey John,23,0,30,7
1715614548034,SOCI 117,A01,494376,Staff,0,5,5,5
1715614549063,WES 237B,A00,494380,Staff,10,0,20,10
1715614551126,AESE 279B,A00,494370,Wade; Jon P,0,0,33,33
1715614552153,AIP 97,001,660915,Van Den Einde; Yael Dahlia,9999,0,9999,0
1715614553180,AIP 197,001,627712,Vespa; Emanuel Ignacio,9995,0,9999,4
1715614553180,AIP 197,002,650778,Amir; On,9998,0,9999,1
1715614553180,AIP 197,003,650933,Avenancio-Leon; Carlos,9998,0,9999,1
1715614553180,AIP 197,004,658530,Heyman; Gail D.,9998,0,9999,1
1715614553180,AIP 197,005,658631,Neal; Sonya E,9998,0,9999,1
1715614553180,AIP 197,006,658671,Du; Songzi,9998,0,9999,1
1715614554205,ANAR 135S,A00,494369,Braswell; Geoffrey E.,0,0,0,0
1715614555286,BENG 196,001,628496,Engler; Adam J.,9998,0,9999,1
1715614555286,BENG 196,002,660916,Watson; John Thomas,9999,0,9999,0
1715614556312,BISP 197,001,650773,Wilhelm; James E.,9994,0,9999,5
1715614556312,BISP 197,002,658904,Coleman; Aaron B.,9998,0,9999,1
1715614557342,CAT 124RS,A01,519847,Geibel; William,0,0,20,20
1715614558369,CAT 125RS,A01,515971,Geibel; William,0,0,20,20
1715614559396,CLRE 250,A00,511389,Morris; Sheldon,9992,0,9999,7
1715614560422,CLRE 251,A00,507176,Mehta; Ravindra L.,9992,0,9999,7
1715614560422,CLRE 251,B00,511410,Mehta; Ravindra L.,9998,0,9999,1
1715614561451,CLRE 252,A00,507189,Cuomo; Raphael Eduardo,9994,0,9999,5
1715614562480,CLRE 253,A00,507199,Vaida; Florin,9994,0,9999,5
1715614562480,CLRE 253,B00,507202,Vaida; Florin,9999,0,9999,0
1715614563506,CLRE 259,A00,507211,Patel; Hemal,9996,0,9999,3
1715614564535,CLRE 260,A00,507221,Cuomo; Raphael Eduardo,9999,0,9999,0
1715614565561,CLRE 297,001,507242,Cuomo; Raphael Eduardo,9999,0,9999,0
1715614566591,COGS 197,001,638244,Voytek; Bradley Thomas,9997,0,9999,2
1715614567617,CSE 191,A00,516875,Minnes Kemp; Mor Mia,9991,0,9999,8
1715614568643,CSE 197,001,637388,Minnes Kemp; Mor Mia,9992,0,9999,7
1715614569669,CSS 201S,A01,494383,Mignozzetti; Umberto,35,0,35,0
1715614570696,CSS 202S,A01,494387,Mignozzetti; Umberto,35,0,35,0
1715614571721,DSC 197,001,628532,Eldridge; Justin Matthew,9995,0,9999,4
1715614572746,EAP 100,A00,516065,Staff,9799,0,9999,200
1715614573773,ECE 45,A01,507414,Staff,31,0,60,29
1715614575822,ECE 111,A01,507420,Staff,11,0,50,39
1715614576847,ECE 197,001,548057,Sievenpiper; Daniel F.,9991,0,9999,8
1715614577875,EDS 115,A00,507243,Choi; Bailey Miyeon,7,0,28,21
1715614578915,EDS 117,A01,494379,Staff,0,6,34,34
1715614579942,EDS 125,A00,507246,Hopkins; Megan Beth,8,0,30,22
1715614580968,EDS 128A,A01,507264,Fargason; Sharon Gayle,6,0,26,20
1715614581998,EDS 128B,A01,507293,Pappas; Elizabeth,10,0,30,20
1715614583027,EDS 139,A00,507294,Fargason; Sharon Gayle,10,0,30,20
1715614583027,EDS 139,B00,507313,Pappas; Elizabeth,11,0,30,19
1715614584052,EDS 201,A00,507315,Staff,10,0,30,20
1715614585084,EDS 203,A01,507317,Halter; Christopher P.,10,0,30,20
1715614586110,EDS 204R,A01,507319,Halter; Christopher P.,0,3,30,30
1715614586110,EDS 204R,B01,507331,Heinzman; Erica M.,14,0,30,16
1715614587136,EDS 206R,A00,507332,Staff,0,4,30,30
1715614587136,EDS 206R,B00,507343,Staff,15,0,30,15
1715614588164,EDS 250,A00,507344,Hemans; Patricia Ann Benitez,20,0,40,20
1715614589190,EDS 281,A00,507345,Daly; Alan J.,18,0,18,0
1715614590218,EDS 284,A00,507350,Daly; Alan J.,16,0,16,0
1715614591244,EDS 286,A00,507359,Fine; Sarah,18,0,18,0
1715614592268,EDS 289C,A01,507361,Daly; Alan J.,18,0,18,0
1715614593295,EDS 290,A00,507366,Hofstetter; Carolyn,15,0,15,0
1715614594321,LIGM 5A,A00,507421,Fischer-Grunski; Eva K,17,0,20,3
1715614595348,LIGM 5B,A00,507423,Fischer-Grunski; Eva K,19,0,20,1
1715614596374,LIGM 5C,A00,507425,Fischer-Grunski; Eva K,19,0,20,1
1715614597403,LIIT 5AS,A00,507427,Carnelos; Chiara,20,0,20,0
1715614598432,LIIT 5BS,A00,507430,Carnelos; Chiara,20,0,20,0
1715614599457,LIIT 5CS,A00,507432,Carnelos; Chiara,20,0,20,0
1715614600484,LISP 5A,A00,507541,Munoz Sanchez; Alicia,11,0,20,9
1715614601509,LISP 5B,A00,507671,Munoz Sanchez; Alicia,9,0,20,11
1715614602537,LISP 5C,A00,507696,Munoz Sanchez; Alicia,9,0,20,11
1715614603615,MAE 197,001,528363,Boechler; Nicholas Sebastia,9998,0,9999,1
1715614604643,MATH 197,001,523477,Kedlaya; Kiran S.,9994,0,9999,5
1715614604643,MATH 197,002,563811,Zhang; Danna,9994,0,9999,5
1715614604643,MATH 197,003,628552,Dumitriu; Ioana,9998,0,9999,1
1715614604643,MATH 197,004,660885,Floyd; Eric,9999,0,9999,0
1715614605670,MCWP 40R,A00,518780,Staff,2,0,20,18
1715614605670,MCWP 40R,B00,518781,Staff,11,0,20,9
1715614605670,MCWP 40R,C00,518783,Staff,5,0,20,15
1715614606696,MCWP 50R,A00,518791,Staff,0,1,20,20
1715614606696,MCWP 50R,B00,518792,Staff,0,2,20,20
1715614606696,MCWP 50R,C00,518793,Staff,0,4,20,20
1715614606696,MCWP 50R,D00,518794,Staff,0,1,20,20
1715614606696,MCWP 50R,E00,518795,Staff,0,2,20,20
1715614606696,MCWP 50R,F00,518796,Staff,0,1,20,20
1715614606696,MCWP 50R,G00,518797,Staff,0,1,20,20
1715614607725,MMW 12R,A01,514034,Herbst; Matthew,0,2,16,16
1715614607725,MMW 12R,A02,514035,Herbst; Matthew,0,0,16,16
1715614608751,MMW 13R,A01,514037,Staff,0,5,16,16
1715614608751,MMW 13R,A02,514039,Staff,0,5,16,16
1715614608751,MMW 13R,A03,628519,Staff,0,4,16,16
1715614610807,SIO 295LS,A00,523233,Staff,10,0,30,20
1715614611831,SIO 295S,A00,523232,Staff,10,0,30,20
1715614612857,SIOC 290S,A01,637330,Merrifield; Mark A,23,0,30,7
1715614613897,SIOC 291S,A01,637333,Gabriel; Corey John,23,0,30,7
1715614614924,SOCI 117,A01,494376,Staff,0,5,5,5
1715614615951,WES 237B,A00,494380,Staff,10,0,20,10
1715614618009,AESE 279B,A00,494370,Wade; Jon P,0,0,33,33
1715614619033,AIP 97,001,660915,Van Den Einde; Yael Dahlia,9999,0,9999,0
1715614620058,AIP 197,001,627712,Vespa; Emanuel Ignacio,9995,0,9999,4
1715614620058,AIP 197,002,650778,Amir; On,9998,0,9999,1
1715614620058,AIP 197,003,650933,Avenancio-Leon; Carlos,9998,0,9999,1
1715614620058,AIP 197,004,658530,Heyman; Gail D.,9998,0,9999,1
1715614620058,AIP 197,005,658631,Neal; Sonya E,9998,0,9999,1
1715614620058,AIP 197,006,658671,Du; Songzi,9998,0,9999,1
1715614621082,ANAR 135S,A00,494369,Braswell; Geoffrey E.,0,0,0,0
1715614622114,BENG 196,001,628496,Engler; Adam J.,9998,0,9999,1
1715614622114,BENG 196,002,660916,Watson; John Thomas,9999,0,9999,0
1715614623144,BISP 197,001,650773,Wilhelm; James E.,9994,0,9999,5
1715614623144,BISP 197,002,658904,Coleman; Aaron B.,9998,0,9999,1
1715614624174,CAT 124RS,A01,519847,Geibel; William,0,0,20,20
1715614625198,CAT 125RS,A01,515971,Geibel; William,0,0,20,20
1715614626225,CLRE 250,A00,511389,Morris; Sheldon,9992,0,9999,7
1715614627254,CLRE 251,A00,507176,Mehta; Ravindra L.,9992,0,9999,7
1715614627254,CLRE 251,B00,511410,Mehta; Ravindra L.,9998,0,9999,1
1715614628281,CLRE 252,A00,507189,Cuomo; Raphael Eduardo,9994,0,9999,5
1715614629311,CLRE 253,A00,507199,Vaida; Florin,9994,0,9999,5
1715614629311,CLRE 253,B00,507202,Vaida; Florin,9999,0,9999,0
1715614630336,CLRE 259,A00,507211,Patel; Hemal,9996,0,9999,3
1715614631362,CLRE 260,A00,507221,Cuomo; Raphael Eduardo,9999,0,9999,0
1715614632388,CLRE 297,001,507242,Cuomo; Raphael Eduardo,9999,0,9999,0
1715614633416,COGS 197,001,638244,Voytek; Bradley Thomas,9997,0,9999,2
1715614634441,CSE 191,A00,516875,Minnes Kemp; Mor Mia,9991,0,9999,8
1715614635466,CSE 197,001,637388,Minnes Kemp; Mor Mia,9992,0,9999,7
1715614636493,CSS 201S,A01,494383,Mignozzetti; Umberto,35,0,35,0
1715614637519,CSS 202S,A01,494387,Mignozzetti; Umberto,35,0,35,0
1715614638544,DSC 197,001,628532,Eldridge; Justin Matthew,9995,0,9999,4
1715614639572,EAP 100,A00,516065,Staff,9799,0,9999,200
1715614640598,ECE 45,A01,507414,Staff,31,0,60,29
1715614642649,ECE 111,A01,507420,Staff,11,0,50,39
1715614643674,ECE 197,001,548057,Sievenpiper; Daniel F.,9991,0,9999,8
1715614644700,EDS 115,A00,507243,Choi; Bailey Miyeon,7,0,28,21
1715614645726,EDS 117,A01,494379,Staff,0,6,34,34
1715614646752,EDS 125,A00,507246,Hopkins; Megan Beth,8,0,30,22
1715614647777,EDS 128A,A01,507264,Fargason; Sharon Gayle,6,0,26,20
1715614648803,EDS 128B,A01,507293,Pappas; Elizabeth,10,0,30,20
1715614649827,EDS 139,A00,507294,Fargason; Sharon Gayle,10,0,30,20
1715614649827,EDS 139,B00,507313,Pappas; Elizabeth,11,0,30,19
1715614650853,EDS 201,A00,507315,Staff,10,0,30,20
1715614651882,EDS 203,A01,507317,Halter; Christopher P.,10,0,30,20
1715614652907,EDS 204R,A01,507319,Halter; Christopher P.,0,3,30,30
1715614652907,EDS 204R,B01,507331,Heinzman; Erica M.,14,0,30,16
1715614653933,EDS 206R,A00,507332,Staff,0,4,30,30
1715614653933,EDS 206R,B00,507343,Staff,15,0,30,15
1715614654961,EDS 250,A00,507344,Hemans; Patricia Ann Benitez,20,0,40,20
1715614655988,EDS 281,A00,507345,Daly; Alan J.,18,0,18,0
1715614657015,EDS 284,A00,507350,Daly; Alan J.,16,0,16,0
1715614658040,EDS 286,A00,507359,Fine; Sarah,18,0,18,0
1715614659065,EDS 289C,A01,507361,Daly; Alan J.,18,0,18,0
1715614660090,EDS 290,A00,507366,Hofstetter; Carolyn,15,0,15,0
1715614661120,LIGM 5A,A00,507421,Fischer-Grunski; Eva K,17,0,20,3
1715614662145,LIGM 5B,A00,507423,Fischer-Grunski; Eva K,19,0,20,1
1715614663171,LIGM 5C,A00,507425,Fischer-Grunski; Eva K,19,0,20,1
1715614664196,LIIT 5AS,A00,507427,Carnelos; Chiara,20,0,20,0
1715614665223,LIIT 5BS,A00,507430,Carnelos; Chiara,20,0,20,0
1715614666251,LIIT 5CS,A00,507432,Carnelos; Chiara,20,0,20,0
1715614667278,LISP 5A,A00,507541,Munoz Sanchez; Alicia,11,0,20,9
1715614668309,LISP 5B,A00,507671,Munoz Sanchez; Alicia,9,0,20,11
1715614669338,LISP 5C,A00,507696,Munoz Sanchez; Alicia,9,0,20,11
1715614670363,MAE 197,001,528363,Boechler; Nicholas Sebastia,9998,0,9999,1
1715614671392,MATH 197,001,523477,Kedlaya; Kiran S.,9994,0,9999,5
1715614671392,MATH 197,002,563811,Zhang; Danna,9994,0,9999,5
1715614671392,MATH 197,003,628552,Dumitriu; Ioana,9998,0,9999,1
1715614671392,MATH 197,004,660885,Floyd; Eric,9999,0,9999,0
1715614672418,MCWP 40R,A00,518780,Staff,2,0,20,18
1715614672418,MCWP 40R,B00,518781,Staff,11,0,20,9
1715614672418,MCWP 40R,C00,518783,Staff,5,0,20,15
1715614673446,MCWP 50R,A00,518791,Staff,0,1,20,20
1715614673446,MCWP 50R,B00,518792,Staff,0,2,20,20
1715614673446,MCWP 50R,C00,518793,Staff,0,4,20,20
1715614673446,MCWP 50R,D00,518794,Staff,0,1,20,20
1715614673446,MCWP 50R,E00,518795,Staff,0,2,20,20
1715614673446,MCWP 50R,F00,518796,Staff,0,1,20,20
1715614673446,MCWP 50R,G00,518797,Staff,0,1,20,20
1715614674474,MMW 12R,A01,514034,Herbst; Matthew,0,2,16,16
1715614674474,MMW 12R,A02,514035,Herbst; Matthew,0,0,16,16
1715614675499,MMW 13R,A01,514037,Staff,0,5,16,16
1715614675499,MMW 13R,A02,514039,Staff,0,5,16,16
1715614675499,MMW 13R,A03,628519,Staff,0,4,16,16
1715614677553,SIO 295LS,A00,523233,Staff,10,0,30,20
1715614678579,SIO 295S,A00,523232,Staff,10,0,30,20
1715614679608,SIOC 290S,A01,637330,Merrifield; Mark A,23,0,30,7
1715614680636,SIOC 291S,A01,637333,Gabriel; Corey John,23,0,30,7
1715614681663,SOCI 117,A01,494376,Staff,0,5,5,5
1715614682688,WES 237B,A00,494380,Staff,10,0,20,10
1715614684746,AESE 279B,A00,494370,Wade; Jon P,0,0,33,33
1715614685772,AIP 97,001,660915,Van Den Einde; Yael Dahlia,9999,0,9999,0
1715614686822,AIP 197,001,627712,Vespa; Emanuel Ignacio,9995,0,9999,4
1715614686822,AIP 197,002,650778,Amir; On,9998,0,9999,1
1715614686822,AIP 197,003,650933,Avenancio-Leon; Carlos,9998,0,9999,1
1715614686822,AIP 197,004,658530,Heyman; Gail D.,9998,0,9999,1
1715614686822,AIP 197,005,658631,Neal; Sonya E,9998,0,9999,1
1715614686822,AIP 197,006,658671,Du; Songzi,9998,0,9999,1
1715614687847,ANAR 135S,A00,494369,Braswell; Geoffrey E.,0,0,0,0
1715614688872,BENG 196,001,628496,Engler; Adam J.,9998,0,9999,1
1715614688872,BENG 196,002,660916,Watson; John Thomas,9999,0,9999,0
1715614689900,BISP 197,001,650773,Wilhelm; James E.,9994,0,9999,5
1715614689900,BISP 197,002,658904,Coleman; Aaron B.,9998,0,9999,1
1715614690928,CAT 124RS,A01,519847,Geibel; William,0,0,20,20
1715614691954,CAT 125RS,A01,515971,Geibel; William,0,0,20,20
1715614692980,CLRE 250,A00,511389,Morris; Sheldon,9992,0,9999,7
1715614694007,CLRE 251,A00,507176,Mehta; Ravindra L.,9992,0,9999,7
1715614694007,CLRE 251,B00,511410,Mehta; Ravindra L.,9998,0,9999,1
1715614695031,CLRE 252,A00,507189,Cuomo; Raphael Eduardo,9994,0,9999,5
1715614696057,CLRE 253,A00,507199,Vaida; Florin,9994,0,9999,5
1715614696057,CLRE 253,B00,507202,Vaida; Florin,9999,0,9999,0
1715614697082,CLRE 259,A00,507211,Patel; Hemal,9996,0,9999,3
1715614698111,CLRE 260,A00,507221,Cuomo; Raphael Eduardo,9999,0,9999,0
1715614699141,CLRE 297,001,507242,Cuomo; Raphael Eduardo,9999,0,9999,0
1715614700167,COGS 197,001,638244,Voytek; Bradley Thomas,9997,0,9999,2
1715614701191,CSE 191,A00,516875,Minnes Kemp; Mor Mia,9991,0,9999,8
1715614702215,CSE 197,001,637388,Minnes Kemp; Mor Mia,9992,0,9999,7
1715614703245,CSS 201S,A01,494383,Mignozzetti; Umberto,35,0,35,0
1715614704271,CSS 202S,A01,494387,Mignozzetti; Umberto,35,0,35,0
1715614705300,DSC 197,001,628532,Eldridge; Justin Matthew,9995,0,9999,4
1715614706328,EAP 100,A00,516065,Staff,9799,0,9999,200
1715614707354,ECE 45,A01,507414,Staff,31,0,60,29
1715614709408,ECE 111,A01,507420,Staff,11,0,50,39
1715614710433,ECE 197,001,548057,Sievenpiper; Daniel F.,9991,0,9999,8
1715614711458,EDS 115,A00,507243,Choi; Bailey Miyeon,7,0,28,21
1715614712486,EDS 117,A01,494379,Staff,0,6,34,34
1715614713514,EDS 125,A00,507246,Hopkins; Megan Beth,8,0,30,22
1715614714538,EDS 128A,A01,507264,Fargason; Sharon Gayle,6,0,26,20
1715614715567,EDS 128B,A01,507293,Pappas; Elizabeth,10,0,30,20
1715614716593,EDS 139,A00,507294,Fargason; Sharon Gayle,10,0,30,20
1715614716593,EDS 139,B00,507313,Pappas; Elizabeth,11,0,30,19
1715614717617,EDS 201,A00,507315,Staff,10,0,30,20
1715614718701,EDS 203,A01,507317,Halter; Christopher P.,10,0,30,20
1715614719725,EDS 204R,A01,507319,Halter; Christopher P.,0,3,30,30
1715614719725,EDS 204R,B01,507331,Heinzman; Erica M.,14,0,30,16
1715614720749,EDS 206R,A00,507332,Staff,0,4,30,30
1715614720749,EDS 206R,B00,507343,Staff,15,0,30,15
1715614721774,EDS 250,A00,507344,Hemans; Patricia Ann Benitez,20,0,40,20
1715614722799,EDS 281,A00,507345,Daly; Alan J.,18,0,18,0
1715614723825,EDS 284,A00,507350,Daly; Alan J.,16,0,16,0
1715614724851,EDS 286,A00,507359,Fine; Sarah,18,0,18,0
1715614725876,EDS 289C,A01,507361,Daly; Alan J.,18,0,18,0
1715614726904,EDS 290,A00,507366,Hofstetter; Carolyn,15,0,15,0
1715614727930,LIGM 5A,A00,507421,Fischer-Grunski; Eva K,17,0,20,3
1715614728954,LIGM 5B,A00,507423,Fischer-Grunski; Eva K,19,0,20,1
1715614729980,LIGM 5C,A00,507425,Fischer-Grunski; Eva K,19,0,20,1
1715614731009,LIIT 5AS,A00,507427,Carnelos; Chiara,20,0,20,0
1715614732037,LIIT 5BS,A00,507430,Carnelos; Chiara,20,0,20,0
1715614733067,LIIT 5CS,A00,507432,Carnelos; Chiara,20,0,20,0
1715614734093,LISP 5A,A00,507541,Munoz Sanchez; Alicia,11,0,20,9
1715614735120,LISP 5B,A00,507671,Munoz Sanchez; Alicia,9,0,20,11
1715614736149,LISP 5C,A00,507696,Munoz Sanchez; Alicia,9,0,20,11
1715614737176,MAE 197,001,528363,Boechler; Nicholas Sebastia,9998,0,9999,1
1715614738202,MATH 197,001,523477,Kedlaya; Kiran S.,9994,0,9999,5
1715614738202,MATH 197,002,563811,Zhang; Danna,9994,0,9999,5
1715614738202,MATH 197,003,628552,Dumitriu; Ioana,9998,0,9999,1
1715614738202,MATH 197,004,660885,Floyd; Eric,9999,0,9999,0
1715614739228,MCWP 40R,A00,518780,Staff,2,0,20,18
1715614739228,MCWP 40R,B00,518781,Staff,11,0,20,9
1715614739228,MCWP 40R,C00,518783,Staff,5,0,20,15
1715614740258,MCWP 50R,A00,518791,Staff,0,1,20,20
1715614740258,MCWP 50R,B00,518792,Staff,0,2,20,20
1715614740258,MCWP 50R,C00,518793,Staff,0,4,20,20
1715614740258,MCWP 50R,D00,518794,Staff,0,1,20,20
1715614740258,MCWP 50R,E00,518795,Staff,0,2,20,20
1715614740258,MCWP 50R,F00,518796,Staff,0,1,20,20
1715614740258,MCWP 50R,G00,518797,Staff,0,1,20,20
1715614741289,MMW 12R,A01,514034,Herbst; Matthew,0,2,16,16
1715614741289,MMW 12R,A02,514035,Herbst; Matthew,0,0,16,16
1715614742315,MMW 13R,A01,514037,Staff,0,5,16,16
1715614742315,MMW 13R,A02,514039,Staff,0,5,16,16
1715614742315,MMW 13R,A03,628519,Staff,0,4,16,16
1715614744365,SIO 295LS,A00,523233,Staff,10,0,30,20
1715614745395,SIO 295S,A00,523232,Staff,10,0,30,20
1715614746423,SIOC 290S,A01,637330,Merrifield; Mark A,23,0,30,7
1715614747449,SIOC 291S,A01,637333,Gabriel; Corey John,23,0,30,7
1715614748476,SOCI 117,A01,494376,Staff,0,5,5,5
1715614749503,WES 237B,A00,494380,Staff,10,0,20,10
1715614751566,AESE 279B,A00,494370,Wade; Jon P,0,0,33,33
1715614752593,AIP 97,001,660915,Van Den Einde; Yael Dahlia,9999,0,9999,0
1715614753627,AIP 197,001,627712,Vespa; Emanuel Ignacio,9995,0,9999,4
1715614753627,AIP 197,002,650778,Amir; On,9998,0,9999,1
1715614753627,AIP 197,003,650933,Avenancio-Leon; Carlos,9998,0,9999,1
1715614753627,AIP 197,004,658530,Heyman; Gail D.,9998,0,9999,1
1715614753627,AIP 197,005,658631,Neal; Sonya E,9998,0,9999,1
1715614753627,AIP 197,006,658671,Du; Songzi,9998,0,9999,1
1715614754654,ANAR 135S,A00,494369,Braswell; Geoffrey E.,0,0,0,0
1715614755680,BENG 196,001,628496,Engler; Adam J.,9998,0,9999,1
1715614755680,BENG 196,002,660916,Watson; John Thomas,9999,0,9999,0
1715614756706,BISP 197,001,650773,Wilhelm; James E.,9994,0,9999,5
1715614756706,BISP 197,002,658904,Coleman; Aaron B.,9998,0,9999,1
1715614757733,CAT 124RS,A01,519847,Geibel; William,0,0,20,20
1715614758759,CAT 125RS,A01,515971,Geibel; William,0,0,20,20
1715614759784,CLRE 250,A00,511389,Morris; Sheldon,9992,0,9999,7
1715614760811,CLRE 251,A00,507176,Mehta; Ravindra L.,9992,0,9999,7
1715614760811,CLRE 251,B00,511410,Mehta; Ravindra L.,9998,0,9999,1
1715614761836,CLRE 252,A00,507189,Cuomo; Raphael Eduardo,9994,0,9999,5
1715614762861,CLRE 253,A00,507199,Vaida; Florin,9994,0,9999,5
1715614762861,CLRE 253,B00,507202,Vaida; Florin,9999,0,9999,0
1715614763898,CLRE 259,A00,507211,Patel; Hemal,9996,0,9999,3
1715614764926,CLRE 260,A00,507221,Cuomo; Raphael Eduardo,9999,0,9999,0
1715614765953,CLRE 297,001,507242,Cuomo; Raphael Eduardo,9999,0,9999,0
1715614766982,COGS 197,001,638244,Voytek; Bradley Thomas,9997,0,9999,2
1715614768010,CSE 191,A00,516875,Minnes Kemp; Mor Mia,9991,0,9999,8
1715614769037,CSE 197,001,637388,Minnes Kemp; Mor Mia,9992,0,9999,7
1715614770063,CSS 201S,A01,494383,Mignozzetti; Umberto,35,0,35,0
1715614771089,CSS 202S,A01,494387,Mignozzetti; Umberto,35,0,35,0
1715614772116,DSC 197,001,628532,Eldridge; Justin Matthew,9995,0,9999,4
1715614773140,EAP 100,A00,516065,Staff,9799,0,9999,200
1715614774166,ECE 45,A01,507414,Staff,31,0,60,29
1715614776219,ECE 111,A01,507420,Staff,11,0,50,39
1715614777246,ECE 197,001,548057,Sievenpiper; Daniel F.,9991,0,9999,8
1715614778276,EDS 115,A00,507243,Choi; Bailey Miyeon,7,0,28,21
1715614779304,EDS 117,A01,494379,Staff,0,6,34,34
1715614780333,EDS 125,A00,507246,Hopkins; Megan Beth,8,0,30,22
1715614781360,EDS 128A,A01,507264,Fargason; Sharon Gayle,6,0,26,20
1715614782389,EDS 128B,A01,507293,Pappas; Elizabeth,10,0,30,20
1715614783413,EDS 139,A00,507294,Fargason; Sharon Gayle,10,0,30,20
1715614783413,EDS 139,B00,507313,Pappas; Elizabeth,11,0,30,19
1715614784441,EDS 201,A00,507315,Staff,10,0,30,20
1715614785470,EDS 203,A01,507317,Halter; Christopher P.,10,0,30,20
1715614786495,EDS 204R,A01,507319,Halter; Christopher P.,0,3,30,30
1715614786495,EDS 204R,B01,507331,Heinzman; Erica M.,14,0,30,16
1715614787523,EDS 206R,A00,507332,Staff,0,4,30,30
1715614787523,EDS 206R,B00,507343,Staff,15,0,30,15
1715614788555,EDS 250,A00,507344,Hemans; Patricia Ann Benitez,20,0,40,20
1715614789580,EDS 281,A00,507345,Daly; Alan J.,18,0,18,0
1715614790605,EDS 284,A00,507350,Daly; Alan J.,16,0,16,0
1715614791628,EDS 286,A00,507359,Fine; Sarah,18,0,18,0
1715614792656,EDS 289C,A01,507361,Daly; Alan J.,18,0,18,0
1715614793681,EDS 290,A00,507366,Hofstetter; Carolyn,15,0,15,0
1715614794710,LIGM 5A,A00,507421,Fischer-Grunski; Eva K,17,0,20,3
1715614795736,LIGM 5B,A00,507423,Fischer-Grunski; Eva K,19,0,20,1
1715614796761,LIGM 5C,A00,507425,Fischer-Grunski; Eva K,19,0,20,1
1715614797790,LIIT 5AS,A00,507427,Carnelos; Chiara,20,0,20,0
1715614798815,LIIT 5BS,A00,507430,Carnelos; Chiara,20,0,20,0
1715614799839,LIIT 5CS,A00,507432,Carnelos; Chiara,20,0,20,0
1715614800865,LISP 5A,A00,507541,Munoz Sanchez; Alicia,11,0,20,9
1715614801891,LISP 5B,A00,507671,Munoz Sanchez; Alicia,9,0,20,11
1715614802917,LISP 5C,A00,507696,Munoz Sanchez; Alicia,9,0,20,11
1715614803942,MAE 197,001,528363,Boechler; Nicholas Sebastia,9998,0,9999,1
1715614804966,MATH 197,001,523477,Kedlaya; Kiran S.,9994,0,9999,5
1715614804966,MATH 197,002,563811,Zhang; Danna,9994,0,9999,5
1715614804966,MATH 197,003,628552,Dumitriu; Ioana,9998,0,9999,1
1715614804966,MATH 197,004,660885,Floyd; Eric,9999,0,9999,0
1715614805991,MCWP 40R,A00,518780,Staff,2,0,20,18
1715614805991,MCWP 40R,B00,518781,Staff,11,0,20,9
1715614805991,MCWP 40R,C00,518783,Staff,5,0,20,15
1715614807017,MCWP 50R,A00,518791,Staff,0,1,20,20
1715614807017,MCWP 50R,B00,518792,Staff,0,2,20,20
1715614807017,MCWP 50R,C00,518793,Staff,0,4,20,20
1715614807017,MCWP 50R,D00,518794,Staff,0,1,20,20
1715614807017,MCWP 50R,E00,518795,Staff,0,2,20,20
1715614807017,MCWP 50R,F00,518796,Staff,0,1,20,20
1715614807017,MCWP 50R,G00,518797,Staff,0,1,20,20
1715614808044,MMW 12R,A01,514034,Herbst; Matthew,0,2,16,16
1715614808044,MMW 12R,A02,514035,Herbst; Matthew,0,0,16,16
1715614809071,MMW 13R,A01,514037,Staff,0,5,16,16
1715614809071,MMW 13R,A02,514039,Staff,0,5,16,16
1715614809071,MMW 13R,A03,628519,Staff,0,4,16,16
1715614811121,SIO 295LS,A00,523233,Staff,10,0,30,20
1715614812149,SIO 295S,A00,523232,Staff,10,0,30,20
1715614813173,SIOC 290S,A01,637330,Merrifield; Mark A,23,0,30,7
1715614814198,SIOC 291S,A01,637333,Gabriel; Corey John,23,0,30,7
1715614815223,SOCI 117,A01,494376,Staff,0,5,5,5
1715614816249,WES 237B,A00,494380,Staff,10,0,20,10
1715614818306,AESE 279B,A00,494370,Wade; Jon P,0,0,33,33
1715614819332,AIP 97,001,660915,Van Den Einde; Yael Dahlia,9999,0,9999,0
1715614820359,AIP 197,001,627712,Vespa; Emanuel Ignacio,9995,0,9999,4
1715614820359,AIP 197,002,650778,Amir; On,9998,0,9999,1
1715614820359,AIP 197,003,650933,Avenancio-Leon; Carlos,9998,0,9999,1
1715614820359,AIP 197,004,658530,Heyman; Gail D.,9998,0,9999,1
1715614820359,AIP 197,005,658631,Neal; Sonya E,9998,0,9999,1
1715614820359,AIP 197,006,658671,Du; Songzi,9998,0,9999,1
1715614821502,ANAR 135S,A00,494369,Braswell; Geoffrey E.,0,0,0,0
1715614822587,BENG 196,001,628496,Engler; Adam J.,9998,0,9999,1
1715614822587,BENG 196,002,660916,Watson; John Thomas,9999,0,9999,0
1715614823613,BISP 197,001,650773,Wilhelm; James E.,9994,0,9999,5
1715614823613,BISP 197,002,658904,Coleman; Aaron B.,9998,0,9999,1
1715614824637,CAT 124RS,A01,519847,Geibel; William,0,0,20,20
1715614825663,CAT 125RS,A01,515971,Geibel; William,0,0,20,20
1715614826689,CLRE 250,A00,511389,Morris; Sheldon,9992,0,9999,7
1715614827799,CLRE 251,A00,507176,Mehta; Ravindra L.,9992,0,9999,7
1715614827799,CLRE 251,B00,511410,Mehta; Ravindra L.,9998,0,9999,1
1715614828827,CLRE 252,A00,507189,Cuomo; Raphael Eduardo,9994,0,9999,5
1715614829856,CLRE 253,A00,507199,Vaida; Florin,9994,0,9999,5
1715614829856,CLRE 253,B00,507202,Vaida; Florin,9999,0,9999,0
1715614830881,CLRE 259,A00,507211,Patel; Hemal,9996,0,9999,3
1715614831906,CLRE 260,A00,507221,Cuomo; Raphael Eduardo,9999,0,9999,0
1715614832931,CLRE 297,001,507242,Cuomo; Raphael Eduardo,9999,0,9999,0
1715614833959,COGS 197,001,638244,Voytek; Bradley Thomas,9997,0,9999,2
1715614834985,CSE 191,A00,516875,Minnes Kemp; Mor Mia,9991,0,9999,8
1715614836010,CSE 197,001,637388,Minnes Kemp; Mor Mia,9992,0,9999,7
1715614837042,CSS 201S,A01,494383,Mignozzetti; Umberto,35,0,35,0
1715614838068,CSS 202S,A01,494387,Mignozzetti; Umberto,35,0,35,0
1715614839093,DSC 197,001,628532,Eldridge; Justin Matthew,9995,0,9999,4
1715614840122,EAP 100,A00,516065,Staff,9799,0,9999,200
1715614841148,ECE 45,A01,507414,Staff,31,0,60,29
1715614843205,ECE 111,A01,507420,Staff,11,0,50,39
1715614844233,ECE 197,001,548057,Sievenpiper; Daniel F.,9991,0,9999,8
1715614845260,EDS 115,A00,507243,Choi; Bailey Miyeon,7,0,28,21
1715614846285,EDS 117,A01,494379,Staff,0,6,34,34
1715614847311,EDS 125,A00,507246,Hopkins; Megan Beth,8,0,30,22
1715614848336,EDS 128A,A01,507264,Fargason; Sharon Gayle,6,0,26,20
1715614849359,EDS 128B,A01,507293,Pappas; Elizabeth,10,0,30,20
1715614850389,EDS 139,A00,507294,Fargason; Sharon Gayle,10,0,30,20
1715614850389,EDS 139,B00,507313,Pappas; Elizabeth,11,0,30,19
1715614851415,EDS 201,A00,507315,Staff,10,0,30,20
1715614852497,EDS 203,A01,507317,Halter; Christopher P.,10,0,30,20
1715614853526,EDS 204R,A01,507319,Halter; Christopher P.,0,3,30,30
1715614853526,EDS 204R,B01,507331,Heinzman; Erica M.,14,0,30,16
1715614854553,EDS 206R,A00,507332,Staff,0,4,30,30
1715614854553,EDS 206R,B00,507343,Staff,15,0,30,15
1715614855578,EDS 250,A00,507344,Hemans; Patricia Ann Benitez,20,0,40,20
1715614856602,EDS 281,A00,507345,Daly; Alan J.,18,0,18,0
1715614857628,EDS 284,A00,507350,Daly; Alan J.,16,0,16,0
1715614858653,EDS 286,A00,507359,Fine; Sarah,18,0,18,0
1715614859681,EDS 289C,A01,507361,Daly; Alan J.,18,0,18,0
1715614860706,EDS 290,A00,507366,Hofstetter; Carolyn,15,0,15,0
1715614861738,LIGM 5A,A00,507421,Fischer-Grunski; Eva K,17,0,20,3
1715614862764,LIGM 5B,A00,507423,Fischer-Grunski; Eva K,19,0,20,1
1715614863843,LIGM 5C,A00,507425,Fischer-Grunski; Eva K,19,0,20,1
1715614864898,LIIT 5AS,A00,507427,Carnelos; Chiara,20,0,20,0
1715614865923,LIIT 5BS,A00,507430,Carnelos; Chiara,20,0,20,0
1715614866948,LIIT 5CS,A00,507432,Carnelos; Chiara,20,0,20,0
1715614867976,LISP 5A,A00,507541,Munoz Sanchez; Alicia,11,0,20,9
1715614869006,LISP 5B,A00,507671,Munoz Sanchez; Alicia,9,0,20,11
1715614870036,LISP 5C,A00,507696,Munoz Sanchez; Alicia,9,0,20,11
1715614871062,MAE 197,001,528363,Boechler; Nicholas Sebastia,9998,0,9999,1
1715614872088,MATH 197,001,523477,Kedlaya; Kiran S.,9994,0,9999,5
1715614872088,MATH 197,002,563811,Zhang; Danna,9994,0,9999,5
1715614872088,MATH 197,003,628552,Dumitriu; Ioana,9998,0,9999,1
1715614872088,MATH 197,004,660885,Floyd; Eric,9999,0,9999,0
1715614873115,MCWP 40R,A00,518780,Staff,2,0,20,18
1715614873115,MCWP 40R,B00,518781,Staff,11,0,20,9
1715614873115,MCWP 40R,C00,518783,Staff,5,0,20,15
1715614874146,MCWP 50R,A00,518791,Staff,0,1,20,20
1715614874146,MCWP 50R,B00,518792,Staff,0,2,20,20
1715614874146,MCWP 50R,C00,518793,Staff,0,4,20,20
1715614874146,MCWP 50R,D00,518794,Staff,0,1,20,20
1715614874146,MCWP 50R,E00,518795,Staff,0,2,20,20
1715614874146,MCWP 50R,F00,518796,Staff,0,1,20,20
1715614874146,MCWP 50R,G00,518797,Staff,0,1,20,20
1715614875174,MMW 12R,A01,514034,Herbst; Matthew,0,2,16,16
1715614875174,MMW 12R,A02,514035,Herbst; Matthew,0,0,16,16
1715614876200,MMW 13R,A01,514037,Staff,0,5,16,16
1715614876200,MMW 13R,A02,514039,Staff,0,5,16,16
1715614876200,MMW 13R,A03,628519,Staff,0,4,16,16
1715614878256,SIO 295LS,A00,523233,Staff,10,0,30,20
1715614879282,SIO 295S,A00,523232,Staff,10,0,30,20
1715614880308,SIOC 290S,A01,637330,Merrifield; Mark A,23,0,30,7
1715614881333,SIOC 291S,A01,637333,Gabriel; Corey John,23,0,30,7
1715614882362,SOCI 117,A01,494376,Staff,0,5,5,5
1715614883387,WES 237B,A00,494380,Staff,10,0,20,10
1715614885450,AESE 279B,A00,494370,Wade; Jon P,0,0,33,33
1715614886477,AIP 97,001,660915,Van Den Einde; Yael Dahlia,9999,0,9999,0
1715614887502,AIP 197,001,627712,Vespa; Emanuel Ignacio,9995,0,9999,4
1715614887502,AIP 197,002,650778,Amir; On,9998,0,9999,1
1715614887502,AIP 197,003,650933,Avenancio-Leon; Carlos,9998,0,9999,1
1715614887502,AIP 197,004,658530,Heyman; Gail D.,9998,0,9999,1
1715614887502,AIP 197,005,658631,Neal; Sonya E,9998,0,9999,1
1715614887502,AIP 197,006,658671,Du; Songzi,9998,0,9999,1
1715614888526,ANAR 135S,A00,494369,Braswell; Geoffrey E.,0,0,0,0
1715614889551,BENG 196,001,628496,Engler; Adam J.,9998,0,9999,1
1715614889551,BENG 196,002,660916,Watson; John Thomas,9999,0,9999,0
1715614890577,BISP 197,001,650773,Wilhelm; James E.,9994,0,9999,5
1715614890577,BISP 197,002,658904,Coleman; Aaron B.,9998,0,9999,1
1715614891607,CAT 124RS,A01,519847,Geibel; William,0,0,20,20
1715614892635,CAT 125RS,A01,515971,Geibel; William,0,0,20,20
1715614893661,CLRE 250,A00,511389,Morris; Sheldon,9992,0,9999,7
1715614894690,CLRE 251,A00,507176,Mehta; Ravindra L.,9992,0,9999,7
1715614894690,CLRE 251,B00,511410,Mehta; Ravindra L.,9998,0,9999,1
1715614895719,CLRE 252,A00,507189,Cuomo; Raphael Eduardo,9994,0,9999,5
1715614896747,CLRE 253,A00,507199,Vaida; Florin,9994,0,9999,5
1715614896747,CLRE 253,B00,507202,Vaida; Florin,9999,0,9999,0
1715614897772,CLRE 259,A00,507211,Patel; Hemal,9996,0,9999,3
1715614898797,CLRE 260,A00,507221,Cuomo; Raphael Eduardo,9999,0,9999,0
1715614899824,CLRE 297,001,507242,Cuomo; Raphael Eduardo,9999,0,9999,0
1715614900850,COGS 197,001,638244,Voytek; Bradley Thomas,9997,0,9999,2
1715614901877,CSE 191,A00,516875,Minnes Kemp; Mor Mia,9991,0,9999,8
1715614902905,CSE 197,001,637388,Minnes Kemp; Mor Mia,9992,0,9999,7
1715614903931,CSS 201S,A01,494383,Mignozzetti; Umberto,35,0,35,0
1715614904959,CSS 202S,A01,494387,Mignozzetti; Umberto,35,0,35,0
1715614905983,DSC 197,001,628532,Eldridge; Justin Matthew,9995,0,9999,4
1715614907007,EAP 100,A00,516065,Staff,9799,0,9999,200
1715614908037,ECE 45,A01,507414,Staff,31,0,60,29
1715614910094,ECE 111,A01,507420,Staff,11,0,50,39
1715614911119,ECE 197,001,548057,Sievenpiper; Daniel F.,9991,0,9999,8
1715614912143,EDS 115,A00,507243,Choi; Bailey Miyeon,7,0,28,21
1715614913167,EDS 117,A01,494379,Staff,0,6,34,34
1715614914193,EDS 125,A00,507246,Hopkins; Megan Beth,8,0,30,22
1715614915217,EDS 128A,A01,507264,Fargason; Sharon Gayle,6,0,26,20
1715614916244,EDS 128B,A01,507293,Pappas; Elizabeth,10,0,30,20
1715614917273,EDS 139,A00,507294,Fargason; Sharon Gayle,10,0,30,20
1715614917273,EDS 139,B00,507313,Pappas; Elizabeth,11,0,30,19
1715614918300,EDS 201,A00,507315,Staff,10,0,30,20
1715614919326,EDS 203,A01,507317,Halter; Christopher P.,10,0,30,20
1715614920351,EDS 204R,A01,507319,Halter; Christopher P.,0,3,30,30
1715614920351,EDS 204R,B01,507331,Heinzman; Erica M.,14,0,30,16
1715614921377,EDS 206R,A00,507332,Staff,0,4,30,30
1715614921377,EDS 206R,B00,507343,Staff,15,0,30,15
1715614922405,EDS 250,A00,507344,Hemans; Patricia Ann Benitez,20,0,40,20
1715614923431,EDS 281,A00,507345,Daly; Alan J.,18,0,18,0
1715614924458,EDS 284,A00,507350,Daly; Alan J.,16,0,16,0
1715614925485,EDS 286,A00,507359,Fine; Sarah,18,0,18,0
1715614926512,EDS 289C,A01,507361,Daly; Alan J.,18,0,18,0
1715614927537,EDS 290,A00,507366,Hofstetter; Carolyn,15,0,15,0
1715614928566,LIGM 5A,A00,507421,Fischer-Grunski; Eva K,17,0,20,3
1715614929593,LIGM 5B,A00,507423,Fischer-Grunski; Eva K,19,0,20,1
1715614930618,LIGM 5C,A00,507425,Fischer-Grunski; Eva K,19,0,20,1
1715614931649,LIIT 5AS,A00,507427,Carnelos; Chiara,20,0,20,0
1715614932676,LIIT 5BS,A00,507430,Carnelos; Chiara,20,0,20,0
1715614933701,LIIT 5CS,A00,507432,Carnelos; Chiara,20,0,20,0
1715614934726,LISP 5A,A00,507541,Munoz Sanchez; Alicia,11,0,20,9
1715614935751,LISP 5B,A00,507671,Munoz Sanchez; Alicia,9,0,20,11
1715614936777,LISP 5C,A00,507696,Munoz Sanchez; Alicia,9,0,20,11
1715614937803,MAE 197,001,528363,Boechler; Nicholas Sebastia,9998,0,9999,1
1715614938833,MATH 197,001,523477,Kedlaya; Kiran S.,9994,0,9999,5
1715614938833,MATH 197,002,563811,Zhang; Danna,9994,0,9999,5
1715614938833,MATH 197,003,628552,Dumitriu; Ioana,9998,0,9999,1
1715614938833,MATH 197,004,660885,Floyd; Eric,9999,0,9999,0
1715614939859,MCWP 40R,A00,518780,Staff,2,0,20,18
1715614939859,MCWP 40R,B00,518781,Staff,11,0,20,9
1715614939859,MCWP 40R,C00,518783,Staff,5,0,20,15
1715614940888,MCWP 50R,A00,518791,Staff,0,1,20,20
1715614940888,MCWP 50R,B00,518792,Staff,0,2,20,20
1715614940888,MCWP 50R,C00,518793,Staff,0,4,20,20
1715614940888,MCWP 50R,D00,518794,Staff,0,1,20,20
1715614940888,MCWP 50R,E00,518795,Staff,0,2,20,20
1715614940888,MCWP 50R,F00,518796,Staff,0,1,20,20
1715614940888,MCWP 50R,G00,518797,Staff,0,1,20,20
1715614941919,MMW 12R,A01,514034,Herbst; Matthew,0,2,16,16
1715614941919,MMW 12R,A02,514035,Herbst; Matthew,0,0,16,16
1715614942948,MMW 13R,A01,514037,Staff,0,5,16,16
1715614942948,MMW 13R,A02,514039,Staff,0,5,16,16
1715614942948,MMW 13R,A03,628519,Staff,0,4,16,16
1715614944998,SIO 295LS,A00,523233,Staff,10,0,30,20
1715614946026,SIO 295S,A00,523232,Staff,10,0,30,20
1715614947056,SIOC 290S,A01,637330,Merrifield; Mark A,23,0,30,7
1715614948084,SIOC 291S,A01,637333,Gabriel; Corey John,23,0,30,7
1715614949108,SOCI 117,A01,494376,Staff,0,5,5,5
1715614950135,WES 237B,A00,494380,Staff,10,0,20,10
1715614952210,AESE 279B,A00,494370,Wade; Jon P,0,0,33,33
1715614953239,AIP 97,001,660915,Van Den Einde; Yael Dahlia,9999,0,9999,0
1715614954266,AIP 197,001,627712,Vespa; Emanuel Ignacio,9995,0,9999,4
1715614954266,AIP 197,002,650778,Amir; On,9998,0,9999,1
1715614954266,AIP 197,003,650933,Avenancio-Leon; Carlos,9998,0,9999,1
1715614954266,AIP 197,004,658530,Heyman; Gail D.,9998,0,9999,1
1715614954266,AIP 197,005,658631,Neal; Sonya E,9998,0,9999,1
1715614954266,AIP 197,006,658671,Du; Songzi,9998,0,9999,1
1715614955290,ANAR 135S,A00,494369,Braswell; Geoffrey E.,0,0,0,0
1715614956316,BENG 196,001,628496,Engler; Adam J.,9998,0,9999,1
1715614956316,BENG 196,002,660916,Watson; John Thomas,9999,0,9999,0
1715614957348,BISP 197,001,650773,Wilhelm; James E.,9994,0,9999,5
1715614957348,BISP 197,002,658904,Coleman; Aaron B.,9998,0,9999,1
1715614958374,CAT 124RS,A01,519847,Geibel; William,0,0,20,20
1715614959402,CAT 125RS,A01,515971,Geibel; William,0,0,20,20
1715614960429,CLRE 250,A00,511389,Morris; Sheldon,9992,0,9999,7
1715614961456,CLRE 251,A00,507176,Mehta; Ravindra L.,9992,0,9999,7
1715614961456,CLRE 251,B00,511410,Mehta; Ravindra L.,9998,0,9999,1
1715614962535,CLRE 252,A00,507189,Cuomo; Raphael Eduardo,9994,0,9999,5
1715614963560,CLRE 253,A00,507199,Vaida; Florin,9994,0,9999,5
1715614963560,CLRE 253,B00,507202,Vaida; Florin,9999,0,9999,0
1715614964589,CLRE 259,A00,507211,Patel; Hemal,9996,0,9999,3
1715614965614,CLRE 260,A00,507221,Cuomo; Raphael Eduardo,9999,0,9999,0
1715614966644,CLRE 297,001,507242,Cuomo; Raphael Eduardo,9999,0,9999,0
1715614967671,COGS 197,001,638244,Voytek; Bradley Thomas,9997,0,9999,2
1715614968697,CSE 191,A00,516875,Minnes Kemp; Mor Mia,9991,0,9999,8
1715614969721,CSE 197,001,637388,Minnes Kemp; Mor Mia,9992,0,9999,7
1715614970746,CSS 201S,A01,494383,Mignozzetti; Umberto,35,0,35,0
1715614971777,CSS 202S,A01,494387,Mignozzetti; Umberto,35,0,35,0
1715614972804,DSC 197,001,628532,Eldridge; Justin Matthew,9995,0,9999,4
1715614973831,EAP 100,A00,516065,Staff,9799,0,9999,200
1715614974857,ECE 45,A01,507414,Staff,31,0,60,29
1715614976910,ECE 111,A01,507420,Staff,11,0,50,39
1715614977935,ECE 197,001,548057,Sievenpiper; Daniel F.,9991,0,9999,8
1715614978963,EDS 115,A00,507243,Choi; Bailey Miyeon,7,0,28,21
1715614979991,EDS 117,A01,494379,Staff,0,6,34,34
1715614981017,EDS 125,A00,507246,Hopkins; Megan Beth,8,0,30,22
1715614982043,EDS 128A,A01,507264,Fargason; Sharon Gayle,6,0,26,20
1715614983070,EDS 128B,A01,507293,Pappas; Elizabeth,10,0,30,20
1715614984095,EDS 139,A00,507294,Fargason; Sharon Gayle,10,0,30,20
1715614984095,EDS 139,B00,507313,Pappas; Elizabeth,11,0,30,19
1715614985121,EDS 201,A00,507315,Staff,10,0,30,20
1715614986145,EDS 203,A01,507317,Halter; Christopher P.,10,0,30,20
1715614987175,EDS 204R,A01,507319,Halter; Christopher P.,0,3,30,30
1715614987175,EDS 204R,B01,507331,Heinzman; Erica M.,14,0,30,16
1715614988202,EDS 206R,A00,507332,Staff,0,4,30,30
1715614988202,EDS 206R,B00,507343,Staff,15,0,30,15
1715614989231,EDS 250,A00,507344,Hemans; Patricia Ann Benitez,20,0,40,20
1715614990260,EDS 281,A00,507345,Daly; Alan J.,18,0,18,0
1715614991286,EDS 284,A00,507350,Daly; Alan J.,16,0,16,0
1715614992313,EDS 286,A00,507359,Fine; Sarah,18,0,18,0
1715614993340,EDS 289C,A01,507361,Daly; Alan J.,18,0,18,0
1715614994368,EDS 290,A00,507366,Hofstetter; Carolyn,15,0,15,0
1715614995398,LIGM 5A,A00,507421,Fischer-Grunski; Eva K,17,0,20,3
1715614996424,LIGM 5B,A00,507423,Fischer-Grunski; Eva K,19,0,20,1
1715614997460,LIGM 5C,A00,507425,Fischer-Grunski; Eva K,19,0,20,1
1715614998486,LIIT 5AS,A00,507427,Carnelos; Chiara,20,0,20,0
1715614999510,LIIT 5BS,A00,507430,Carnelos; Chiara,20,0,20,0
1715615000538,LIIT 5CS,A00,507432,Carnelos; Chiara,20,0,20,0
1715615001568,LISP 5A,A00,507541,Munoz Sanchez; Alicia,11,0,20,9
1715615002592,LISP 5B,A00,507671,Munoz Sanchez; Alicia,9,0,20,11
1715615003617,LISP 5C,A00,507696,Munoz Sanchez; Alicia,9,0,20,11
1715615004645,MAE 197,001,528363,Boechler; Nicholas Sebastia,9998,0,9999,1
1715615005671,MATH 197,001,523477,Kedlaya; Kiran S.,9994,0,9999,5
1715615005671,MATH 197,002,563811,Zhang; Danna,9994,0,9999,5
1715615005671,MATH 197,003,628552,Dumitriu; Ioana,9998,0,9999,1
1715615005671,MATH 197,004,660885,Floyd; Eric,9999,0,9999,0
1715615006698,MCWP 40R,A00,518780,Staff,2,0,20,18
1715615006698,MCWP 40R,B00,518781,Staff,11,0,20,9
1715615006698,MCWP 40R,C00,518783,Staff,5,0,20,15
1715615007727,MCWP 50R,A00,518791,Staff,0,1,20,20
1715615007727,MCWP 50R,B00,518792,Staff,0,2,20,20
1715615007727,MCWP 50R,C00,518793,Staff,0,4,20,20
1715615007727,MCWP 50R,D00,518794,Staff,0,1,20,20
1715615007727,MCWP 50R,E00,518795,Staff,0,2,20,20
1715615007727,MCWP 50R,F00,518796,Staff,0,1,20,20
1715615007727,MCWP 50R,G00,518797,Staff,0,1,20,20
1715615008755,MMW 12R,A01,514034,Herbst; Matthew,0,2,16,16
1715615008755,MMW 12R,A02,514035,Herbst; Matthew,0,0,16,16
1715615009779,MMW 13R,A01,514037,Staff,0,5,16,16
1715615009779,MMW 13R,A02,514039,Staff,0,5,16,16
1715615009779,MMW 13R,A03,628519,Staff,0,4,16,16
1715615011831,SIO 295LS,A00,523233,Staff,10,0,30,20
1715615012859,SIO 295S,A00,523232,Staff,10,0,30,20
1715615013885,SIOC 290S,A01,637330,Merrifield; Mark A,23,0,30,7
1715615014914,SIOC 291S,A01,637333,Gabriel; Corey John,23,0,30,7
1715615015938,SOCI 117,A01,494376,Staff,0,5,5,5
1715615016965,WES 237B,A00,494380,Staff,10,0,20,10
1715615019026,AESE 279B,A00,494370,Wade; Jon P,0,0,33,33
1715615020058,AIP 97,001,660915,Van Den Einde; Yael Dahlia,9999,0,9999,0
1715615021085,AIP 197,001,627712,Vespa; Emanuel Ignacio,9995,0,9999,4
1715615021085,AIP 197,002,650778,Amir; On,9998,0,9999,1
1715615021085,AIP 197,003,650933,Avenancio-Leon; Carlos,9998,0,9999,1
1715615021085,AIP 197,004,658530,Heyman; Gail D.,9998,0,9999,1
1715615021085,AIP 197,005,658631,Neal; Sonya E,9998,0,9999,1
1715615021085,AIP 197,006,658671,Du; Songzi,9998,0,9999,1
1715615022111,ANAR 135S,A00,494369,Braswell; Geoffrey E.,0,0,0,0
1715615023136,BENG 196,001,628496,Engler; Adam J.,9998,0,9999,1
1715615023136,BENG 196,002,660916,Watson; John Thomas,9999,0,9999,0
1715615024163,BISP 197,001,650773,Wilhelm; James E.,9994,0,9999,5
1715615024163,BISP 197,002,658904,Coleman; Aaron B.,9998,0,9999,1
1715615025189,CAT 124RS,A01,519847,Geibel; William,0,0,20,20
1715615026218,CAT 125RS,A01,515971,Geibel; William,0,0,20,20
1715615027245,CLRE 250,A00,511389,Morris; Sheldon,9992,0,9999,7
1715615028270,CLRE 251,A00,507176,Mehta; Ravindra L.,9992,0,9999,7
1715615028270,CLRE 251,B00,511410,Mehta; Ravindra L.,9998,0,9999,1
1715615029294,CLRE 252,A00,507189,Cuomo; Raphael Eduardo,9994,0,9999,5
1715615030319,CLRE 253,A00,507199,Vaida; Florin,9994,0,9999,5
1715615030319,CLRE 253,B00,507202,Vaida; Florin,9999,0,9999,0
1715615031345,CLRE 259,A00,507211,Patel; Hemal,9996,0,9999,3
1715615032370,CLRE 260,A00,507221,Cuomo; Raphael Eduardo,9999,0,9999,0
1715615033395,CLRE 297,001,507242,Cuomo; Raphael Eduardo,9999,0,9999,0
1715615034419,COGS 197,001,638244,Voytek; Bradley Thomas,9997,0,9999,2
1715615035444,CSE 191,A00,516875,Minnes Kemp; Mor Mia,9991,0,9999,8
1715615036472,CSE 197,001,637388,Minnes Kemp; Mor Mia,9992,0,9999,7
1715615037497,CSS 201S,A01,494383,Mignozzetti; Umberto,35,0,35,0
1715615038528,CSS 202S,A01,494387,Mignozzetti; Umberto,35,0,35,0
1715615039553,DSC 197,001,628532,Eldridge; Justin Matthew,9995,0,9999,4
1715615040581,EAP 100,A00,516065,Staff,9799,0,9999,200
1715615041608,ECE 45,A01,507414,Staff,31,0,60,29
1715615043661,ECE 111,A01,507420,Staff,11,0,50,39
1715615044686,ECE 197,001,548057,Sievenpiper; Daniel F.,9991,0,9999,8
1715615045719,EDS 115,A00,507243,Choi; Bailey Miyeon,7,0,28,21
1715615046748,EDS 117,A01,494379,Staff,0,6,34,34
1715615047777,EDS 125,A00,507246,Hopkins; Megan Beth,8,0,30,22
1715615048807,EDS 128A,A01,507264,Fargason; Sharon Gayle,6,0,26,20
1715615049832,EDS 128B,A01,507293,Pappas; Elizabeth,10,0,30,20
1715615050857,EDS 139,A00,507294,Fargason; Sharon Gayle,10,0,30,20
1715615050857,EDS 139,B00,507313,Pappas; Elizabeth,11,0,30,19
1715615051881,EDS 201,A00,507315,Staff,10,0,30,20
1715615052906,EDS 203,A01,507317,Halter; Christopher P.,10,0,30,20
1715615053935,EDS 204R,A01,507319,Halter; Christopher P.,0,3,30,30
1715615053935,EDS 204R,B01,507331,Heinzman; Erica M.,14,0,30,16
1715615054965,EDS 206R,A00,507332,Staff,0,4,30,30
1715615054965,EDS 206R,B00,507343,Staff,15,0,30,15
1715615055994,EDS 250,A00,507344,Hemans; Patricia Ann Benitez,20,0,40,20
1715615057022,EDS 281,A00,507345,Daly; Alan J.,18,0,18,0
1715615058050,EDS 284,A00,507350,Daly; Alan J.,16,0,16,0
1715615059075,EDS 286,A00,507359,Fine; Sarah,18,0,18,0
1715615060101,EDS 289C,A01,507361,Daly; Alan J.,18,0,18,0
1715615061125,EDS 290,A00,507366,Hofstetter; Carolyn,15,0,15,0
1715615062154,LIGM 5A,A00,507421,Fischer-Grunski; Eva K,17,0,20,3
1715615063182,LIGM 5B,A00,507423,Fischer-Grunski; Eva K,19,0,20,1
1715615064213,LIGM 5C,A00,507425,Fischer-Grunski; Eva K,19,0,20,1
1715615065241,LIIT 5AS,A00,507427,Carnelos; Chiara,20,0,20,0
1715615066326,LIIT 5BS,A00,507430,Carnelos; Chiara,20,0,20,0
1715615067356,LIIT 5CS,A00,507432,Carnelos; Chiara,20,0,20,0
1715615068383,LISP 5A,A00,507541,Munoz Sanchez; Alicia,11,0,20,9
1715615069409,LISP 5B,A00,507671,Munoz Sanchez; Alicia,9,0,20,11
1715615070434,LISP 5C,A00,507696,Munoz Sanchez; Alicia,9,0,20,11
1715615071461,MAE 197,001,528363,Boechler; Nicholas Sebastia,9998,0,9999,1
1715615072490,MATH 197,001,523477,Kedlaya; Kiran S.,9994,0,9999,5
1715615072490,MATH 197,002,563811,Zhang; Danna,9994,0,9999,5
1715615072490,MATH 197,003,628552,Dumitriu; Ioana,9998,0,9999,1
1715615072490,MATH 197,004,660885,Floyd; Eric,9999,0,9999,0
1715615073516,MCWP 40R,A00,518780,Staff,2,0,20,18
1715615073516,MCWP 40R,B00,518781,Staff,11,0,20,9
1715615073516,MCWP 40R,C00,518783,Staff,5,0,20,15
1715615074545,MCWP 50R,A00,518791,Staff,0,1,20,20
1715615074545,MCWP 50R,B00,518792,Staff,0,2,20,20
1715615074545,MCWP 50R,C00,518793,Staff,0,4,20,20
1715615074545,MCWP 50R,D00,518794,Staff,0,1,20,20
1715615074545,MCWP 50R,E00,518795,Staff,0,2,20,20
1715615074545,MCWP 50R,F00,518796,Staff,0,1,20,20
1715615074545,MCWP 50R,G00,518797,Staff,0,1,20,20
1715615075571,MMW 12R,A01,514034,Herbst; Matthew,0,2,16,16
1715615075571,MMW 12R,A02,514035,Herbst; Matthew,0,0,16,16
1715615076603,MMW 13R,A01,514037,Staff,0,5,16,16
1715615076603,MMW 13R,A02,514039,Staff,0,5,16,16
1715615076603,MMW 13R,A03,628519,Staff,0,4,16,16
1715615078654,SIO 295LS,A00,523233,Staff,10,0,30,20
1715615079679,SIO 295S,A00,523232,Staff,10,0,30,20
1715615080705,SIOC 290S,A01,637330,Merrifield; Mark A,23,0,30,7
1715615081734,SIOC 291S,A01,637333,Gabriel; Corey John,23,0,30,7
1715615082762,SOCI 117,A01,494376,Staff,0,5,5,5
1715615083787,WES 237B,A00,494380,Staff,10,0,20,10
1715615085857,AESE 279B,A00,494370,Wade; Jon P,0,0,33,33
1715615086882,AIP 97,001,660915,Van Den Einde; Yael Dahlia,9999,0,9999,0
1715615087908,AIP 197,001,627712,Vespa; Emanuel Ignacio,9995,0,9999,4
1715615087908,AIP 197,002,650778,Amir; On,9998,0,9999,1
1715615087908,AIP 197,003,650933,Avenancio-Leon; Carlos,9998,0,9999,1
1715615087908,AIP 197,004,658530,Heyman; Gail D.,9998,0,9999,1
1715615087908,AIP 197,005,658631,Neal; Sonya E,9998,0,9999,1
1715615087908,AIP 197,006,658671,Du; Songzi,9998,0,9999,1
1715615088935,ANAR 135S,A00,494369,Braswell; Geoffrey E.,0,0,0,0
1715615089960,BENG 196,001,628496,Engler; Adam J.,9998,0,9999,1
1715615089960,BENG 196,002,660916,Watson; John Thomas,9999,0,9999,0
1715615090985,BISP 197,001,650773,Wilhelm; James E.,9994,0,9999,5
1715615090985,BISP 197,002,658904,Coleman; Aaron B.,9998,0,9999,1
1715615092011,CAT 124RS,A01,519847,Geibel; William,0,0,20,20
1715615093036,CAT 125RS,A01,515971,Geibel; William,0,0,20,20
1715615094062,CLRE 250,A00,511389,Morris; Sheldon,9992,0,9999,7
1715615095093,CLRE 251,A00,507176,Mehta; Ravindra L.,9992,0,9999,7
1715615095093,CLRE 251,B00,511410,Mehta; Ravindra L.,9998,0,9999,1
1715615096121,CLRE 252,A00,507189,Cuomo; Raphael Eduardo,9994,0,9999,5
1715615097150,CLRE 253,A00,507199,Vaida; Florin,9994,0,9999,5
1715615097150,CLRE 253,B00,507202,Vaida; Florin,9999,0,9999,0
1715615098175,CLRE 259,A00,507211,Patel; Hemal,9996,0,9999,3
1715615099202,CLRE 260,A00,507221,Cuomo; Raphael Eduardo,9999,0,9999,0
1715615100230,CLRE 297,001,507242,Cuomo; Raphael Eduardo,9999,0,9999,0
1715615101257,COGS 197,001,638244,Voytek; Bradley Thomas,9997,0,9999,2
1715615102284,CSE 191,A00,516875,Minnes Kemp; Mor Mia,9991,0,9999,8
1715615103310,CSE 197,001,637388,Minnes Kemp; Mor Mia,9992,0,9999,7
1715615104338,CSS 201S,A01,494383,Mignozzetti; Umberto,35,0,35,0
1715615105362,CSS 202S,A01,494387,Mignozzetti; Umberto,35,0,35,0
1715615106388,DSC 197,001,628532,Eldridge; Justin Matthew,9995,0,9999,4
1715615107413,EAP 100,A00,516065,Staff,9799,0,9999,200
1715615108439,ECE 45,A01,507414,Staff,31,0,60,29
1715615110493,ECE 111,A01,507420,Staff,11,0,50,39
1715615111517,ECE 197,001,548057,Sievenpiper; Daniel F.,9991,0,9999,8
1715615112542,EDS 115,A00,507243,Choi; Bailey Miyeon,7,0,28,21
1715615113570,EDS 117,A01,494379,Staff,0,6,34,34
1715615114596,EDS 125,A00,507246,Hopkins; Megan Beth,8,0,30,22
1715615115621,EDS 128A,A01,507264,Fargason; Sharon Gayle,6,0,26,20
1715615116646,EDS 128B,A01,507293,Pappas; Elizabeth,10,0,30,20
1715615117673,EDS 139,A00,507294,Fargason; Sharon Gayle,10,0,30,20
1715615117673,EDS 139,B00,507313,Pappas; Elizabeth,11,0,30,19
1715615118700,EDS 201,A00,507315,Staff,10,0,30,20
1715615119729,EDS 203,A01,507317,Halter; Christopher P.,10,0,30,20
1715615120757,EDS 204R,A01,507319,Halter; Christopher P.,0,3,30,30
1715615120757,EDS 204R,B01,507331,Heinzman; Erica M.,14,0,30,16
1715615121785,EDS 206R,A00,507332,Staff,0,4,30,30
1715615121785,EDS 206R,B00,507343,Staff,15,0,30,15
1715615122810,EDS 250,A00,507344,Hemans; Patricia Ann Benitez,20,0,40,20
1715615123840,EDS 281,A00,507345,Daly; Alan J.,18,0,18,0
1715615124865,EDS 284,A00,507350,Daly; Alan J.,16,0,16,0
1715615125890,EDS 286,A00,507359,Fine; Sarah,18,0,18,0
1715615126917,EDS 289C,A01,507361,Daly; Alan J.,18,0,18,0
1715615127945,EDS 290,A00,507366,Hofstetter; Carolyn,15,0,15,0
1715615128969,LIGM 5A,A00,507421,Fischer-Grunski; Eva K,17,0,20,3
1715615129996,LIGM 5B,A00,507423,Fischer-Grunski; Eva K,19,0,20,1
1715615131023,LIGM 5C,A00,507425,Fischer-Grunski; Eva K,19,0,20,1
1715615132054,LIIT 5AS,A00,507427,Carnelos; Chiara,20,0,20,0
1715615133080,LIIT 5BS,A00,507430,Carnelos; Chiara,20,0,20,0
1715615134105,LIIT 5CS,A00,507432,Carnelos; Chiara,20,0,20,0
1715615135133,LISP 5A,A00,507541,Munoz Sanchez; Alicia,11,0,20,9
1715615136163,LISP 5B,A00,507671,Munoz Sanchez; Alicia,9,0,20,11
1715615137189,LISP 5C,A00,507696,Munoz Sanchez; Alicia,9,0,20,11
1715615138214,MAE 197,001,528363,Boechler; Nicholas Sebastia,9998,0,9999,1
1715615139240,MATH 197,001,523477,Kedlaya; Kiran S.,9994,0,9999,5
1715615139240,MATH 197,002,563811,Zhang; Danna,9994,0,9999,5
1715615139240,MATH 197,003,628552,Dumitriu; Ioana,9998,0,9999,1
1715615139240,MATH 197,004,660885,Floyd; Eric,9999,0,9999,0
1715615140270,MCWP 40R,A00,518780,Staff,2,0,20,18
1715615140270,MCWP 40R,B00,518781,Staff,11,0,20,9
1715615140270,MCWP 40R,C00,518783,Staff,5,0,20,15
1715615141300,MCWP 50R,A00,518791,Staff,0,1,20,20
1715615141300,MCWP 50R,B00,518792,Staff,0,2,20,20
1715615141300,MCWP 50R,C00,518793,Staff,0,4,20,20
1715615141300,MCWP 50R,D00,518794,Staff,0,1,20,20
1715615141300,MCWP 50R,E00,518795,Staff,0,2,20,20
1715615141300,MCWP 50R,F00,518796,Staff,0,1,20,20
1715615141300,MCWP 50R,G00,518797,Staff,0,1,20,20
1715615142325,MMW 12R,A01,514034,Herbst; Matthew,0,2,16,16
1715615142325,MMW 12R,A02,514035,Herbst; Matthew,0,0,16,16
1715615143350,MMW 13R,A01,514037,Staff,0,5,16,16
1715615143350,MMW 13R,A02,514039,Staff,0,5,16,16
1715615143350,MMW 13R,A03,628519,Staff,0,4,16,16
1715615145400,SIO 295LS,A00,523233,Staff,10,0,30,20
1715615146426,SIO 295S,A00,523232,Staff,10,0,30,20
1715615147451,SIOC 290S,A01,637330,Merrifield; Mark A,23,0,30,7
1715615148476,SIOC 291S,A01,637333,Gabriel; Corey John,23,0,30,7
1715615149501,SOCI 117,A01,494376,Staff,0,5,5,5
1715615150526,WES 237B,A00,494380,Staff,10,0,20,10
1715615152595,AESE 279B,A00,494370,Wade; Jon P,0,0,33,33
1715615153622,AIP 97,001,660915,Van Den Einde; Yael Dahlia,9999,0,9999,0
1715615154647,AIP 197,001,627712,Vespa; Emanuel Ignacio,9995,0,9999,4
1715615154647,AIP 197,002,650778,Amir; On,9998,0,9999,1
1715615154647,AIP 197,003,650933,Avenancio-Leon; Carlos,9998,0,9999,1
1715615154647,AIP 197,004,658530,Heyman; Gail D.,9998,0,9999,1
1715615154647,AIP 197,005,658631,Neal; Sonya E,9998,0,9999,1
1715615154647,AIP 197,006,658671,Du; Songzi,9998,0,9999,1
1715615155673,ANAR 135S,A00,494369,Braswell; Geoffrey E.,0,0,0,0
1715615156702,BENG 196,001,628496,Engler; Adam J.,9998,0,9999,1
1715615156702,BENG 196,002,660916,Watson; John Thomas,9999,0,9999,0
1715615157728,BISP 197,001,650773,Wilhelm; James E.,9994,0,9999,5
1715615157728,BISP 197,002,658904,Coleman; Aaron B.,9998,0,9999,1
1715615158757,CAT 124RS,A01,519847,Geibel; William,0,0,20,20
1715615159785,CAT 125RS,A01,515971,Geibel; William,0,0,20,20
1715615160809,CLRE 250,A00,511389,Morris; Sheldon,9992,0,9999,7
1715615161836,CLRE 251,A00,507176,Mehta; Ravindra L.,9992,0,9999,7
1715615161836,CLRE 251,B00,511410,Mehta; Ravindra L.,9998,0,9999,1
1715615162865,CLRE 252,A00,507189,Cuomo; Raphael Eduardo,9994,0,9999,5
1715615163907,CLRE 253,A00,507199,Vaida; Florin,9994,0,9999,5
1715615163907,CLRE 253,B00,507202,Vaida; Florin,9999,0,9999,0
1715615164934,CLRE 259,A00,507211,Patel; Hemal,9996,0,9999,3
1715615165959,CLRE 260,A00,507221,Cuomo; Raphael Eduardo,9999,0,9999,0
1715615166985,CLRE 297,001,507242,Cuomo; Raphael Eduardo,9999,0,9999,0
1715615168012,COGS 197,001,638244,Voytek; Bradley Thomas,9997,0,9999,2
1715615169039,CSE 191,A00,516875,Minnes Kemp; Mor Mia,9991,0,9999,8
1715615170118,CSE 197,001,637388,Minnes Kemp; Mor Mia,9992,0,9999,7
1715615171143,CSS 201S,A01,494383,Mignozzetti; Umberto,35,0,35,0
1715615172169,CSS 202S,A01,494387,Mignozzetti; Umberto,35,0,35,0
1715615173195,DSC 197,001,628532,Eldridge; Justin Matthew,9995,0,9999,4
1715615174219,EAP 100,A00,516065,Staff,9799,0,9999,200
1715615175246,ECE 45,A01,507414,Staff,31,0,60,29
1715615177299,ECE 111,A01,507420,Staff,11,0,50,39
1715615178327,ECE 197,001,548057,Sievenpiper; Daniel F.,9991,0,9999,8
1715615179352,EDS 115,A00,507243,Choi; Bailey Miyeon,7,0,28,21
1715615180380,EDS 117,A01,494379,Staff,0,6,34,34
1715615181406,EDS 125,A00,507246,Hopkins; Megan Beth,8,0,30,22
1715615182431,EDS 128A,A01,507264,Fargason; Sharon Gayle,6,0,26,20
1715615183461,EDS 128B,A01,507293,Pappas; Elizabeth,10,0,30,20
1715615184490,EDS 139,A00,507294,Fargason; Sharon Gayle,10,0,30,20
1715615184490,EDS 139,B00,507313,Pappas; Elizabeth,11,0,30,19
1715615185518,EDS 201,A00,507315,Staff,10,0,30,20
1715615186547,EDS 203,A01,507317,Halter; Christopher P.,10,0,30,20
1715615187571,EDS 204R,A01,507319,Halter; Christopher P.,0,3,30,30
1715615187571,EDS 204R,B01,507331,Heinzman; Erica M.,14,0,30,16
1715615188598,EDS 206R,A00,507332,Staff,0,4,30,30
1715615188598,EDS 206R,B00,507343,Staff,15,0,30,15
1715615189625,EDS 250,A00,507344,Hemans; Patricia Ann Benitez,20,0,40,20
1715615190651,EDS 281,A00,507345,Daly; Alan J.,18,0,18,0
1715615191679,EDS 284,A00,507350,Daly; Alan J.,16,0,16,0
1715615192704,EDS 286,A00,507359,Fine; Sarah,18,0,18,0
1715615193729,EDS 289C,A01,507361,Daly; Alan J.,18,0,18,0
1715615194755,EDS 290,A00,507366,Hofstetter; Carolyn,15,0,15,0
1715615195781,LIGM 5A,A00,507421,Fischer-Grunski; Eva K,17,0,20,3
1715615196810,LIGM 5B,A00,507423,Fischer-Grunski; Eva K,19,0,20,1
1715615197834,LIGM 5C,A00,507425,Fischer-Grunski; Eva K,19,0,20,1
1715615198859,LIIT 5AS,A00,507427,Carnelos; Chiara,20,0,20,0
1715615199888,LIIT 5BS,A00,507430,Carnelos; Chiara,20,0,20,0
1715615200913,LIIT 5CS,A00,507432,Carnelos; Chiara,20,0,20,0
1715615201941,LISP 5A,A00,507541,Munoz Sanchez; Alicia,11,0,20,9
1715615202966,LISP 5B,A00,507671,Munoz Sanchez; Alicia,9,0,20,11
1715615203992,LISP 5C,A00,507696,Munoz Sanchez; Alicia,9,0,20,11
1715615205017,MAE 197,001,528363,Boechler; Nicholas Sebastia,9998,0,9999,1
1715615206042,MATH 197,001,523477,Kedlaya; Kiran S.,9994,0,9999,5
1715615206042,MATH 197,002,563811,Zhang; Danna,9994,0,9999,5
1715615206042,MATH 197,003,628552,Dumitriu; Ioana,9998,0,9999,1
1715615206042,MATH 197,004,660885,Floyd; Eric,9999,0,9999,0
1715615207067,MCWP 40R,A00,518780,Staff,2,0,20,18
1715615207067,MCWP 40R,B00,518781,Staff,11,0,20,9
1715615207067,MCWP 40R,C00,518783,Staff,5,0,20,15
1715615208093,MCWP 50R,A00,518791,Staff,0,1,20,20
1715615208093,MCWP 50R,B00,518792,Staff,0,2,20,20
1715615208093,MCWP 50R,C00,518793,Staff,0,4,20,20
1715615208093,MCWP 50R,D00,518794,Staff,0,1,20,20
1715615208093,MCWP 50R,E00,518795,Staff,0,2,20,20
1715615208093,MCWP 50R,F00,518796,Staff,0,1,20,20
1715615208093,MCWP 50R,G00,518797,Staff,0,1,20,20
1715615209118,MMW 12R,A01,514034,Herbst; Matthew,0,2,16,16
1715615209118,MMW 12R,A02,514035,Herbst; Matthew,0,0,16,16
1715615210145,MMW 13R,A01,514037,Staff,0,5,16,16
1715615210145,MMW 13R,A02,514039,Staff,0,5,16,16
1715615210145,MMW 13R,A03,628519,Staff,0,4,16,16
1715615212195,SIO 295LS,A00,523233,Staff,10,0,30,20
1715615213221,SIO 295S,A00,523232,Staff,10,0,30,20
1715615214249,SIOC 290S,A01,637330,Merrifield; Mark A,23,0,30,7
1715615215277,SIOC 291S,A01,637333,Gabriel; Corey John,23,0,30,7
1715615216303,SOCI 117,A01,494376,Staff,0,5,5,5
1715615217327,WES 237B,A00,494380,Staff,10,0,20,10
1715615219398,AESE 279B,A00,494370,Wade; Jon P,0,0,33,33
1715615220429,AIP 97,001,660915,Van Den Einde; Yael Dahlia,9999,0,9999,0
1715615221454,AIP 197,001,627712,Vespa; Emanuel Ignacio,9995,0,9999,4
1715615221454,AIP 197,002,650778,Amir; On,9998,0,9999,1
1715615221454,AIP 197,003,650933,Avenancio-Leon; Carlos,9998,0,9999,1
1715615221454,AIP 197,004,658530,Heyman; Gail D.,9998,0,9999,1
1715615221454,AIP 197,005,658631,Neal; Sonya E,9998,0,9999,1
1715615221454,AIP 197,006,658671,Du; Songzi,9998,0,9999,1
1715615222482,ANAR 135S,A00,494369,Braswell; Geoffrey E.,0,0,0,0
1715615223510,BENG 196,001,628496,Engler; Adam J.,9998,0,9999,1
1715615223510,BENG 196,002,660916,Watson; John Thomas,9999,0,9999,0
1715615224537,BISP 197,001,650773,Wilhelm; James E.,9994,0,9999,5
1715615224537,BISP 197,002,658904,Coleman; Aaron B.,9998,0,9999,1
1715615225561,CAT 124RS,A01,519847,Geibel; William,0,0,20,20
1715615226587,CAT 125RS,A01,515971,Geibel; William,0,0,20,20
1715615227615,CLRE 250,A00,511389,Morris; Sheldon,9992,0,9999,7
1715615228645,CLRE 251,A00,507176,Mehta; Ravindra L.,9992,0,9999,7
1715615228645,CLRE 251,B00,511410,Mehta; Ravindra L.,9998,0,9999,1
1715615229670,CLRE 252,A00,507189,Cuomo; Raphael Eduardo,9994,0,9999,5
1715615230697,CLRE 253,A00,507199,Vaida; Florin,9994,0,9999,5
1715615230697,CLRE 253,B00,507202,Vaida; Florin,9999,0,9999,0
1715615231723,CLRE 259,A00,507211,Patel; Hemal,9996,0,9999,3
1715615232751,CLRE 260,A00,507221,Cuomo; Raphael Eduardo,9999,0,9999,0
1715615233777,CLRE 297,001,507242,Cuomo; Raphael Eduardo,9999,0,9999,0
1715615234801,COGS 197,001,638244,Voytek; Bradley Thomas,9997,0,9999,2
1715615235828,CSE 191,A00,516875,Minnes Kemp; Mor Mia,9991,0,9999,8
1715615236853,CSE 197,001,637388,Minnes Kemp; Mor Mia,9992,0,9999,7
1715615237881,CSS 201S,A01,494383,Mignozzetti; Umberto,35,0,35,0
1715615238909,CSS 202S,A01,494387,Mignozzetti; Umberto,35,0,35,0
1715615239935,DSC 197,001,628532,Eldridge; Justin Matthew,9995,0,9999,4
1715615240962,EAP 100,A00,516065,Staff,9799,0,9999,200
1715615241990,ECE 45,A01,507414,Staff,31,0,60,29
1715615244045,ECE 111,A01,507420,Staff,11,0,50,39
1715615245069,ECE 197,001,548057,Sievenpiper; Daniel F.,9991,0,9999,8
1715615246095,EDS 115,A00,507243,Choi; Bailey Miyeon,7,0,28,21
1715615247125,EDS 117,A01,494379,Staff,0,6,34,34
1715615248154,EDS 125,A00,507246,Hopkins; Megan Beth,8,0,30,22
1715615249179,EDS 128A,A01,507264,Fargason; Sharon Gayle,6,0,26,20
1715615250203,EDS 128B,A01,507293,Pappas; Elizabeth,10,0,30,20
1715615251231,EDS 139,A00,507294,Fargason; Sharon Gayle,10,0,30,20
1715615251231,EDS 139,B00,507313,Pappas; Elizabeth,11,0,30,19
1715615252258,EDS 201,A00,507315,Staff,10,0,30,20
1715615253282,EDS 203,A01,507317,Halter; Christopher P.,10,0,30,20
1715615254309,EDS 204R,A01,507319,Halter; Christopher P.,0,3,30,30
1715615254309,EDS 204R,B01,507331,Heinzman; Erica M.,14,0,30,16
1715615255337,EDS 206R,A00,507332,Staff,0,4,30,30
1715615255337,EDS 206R,B00,507343,Staff,15,0,30,15
1715615256365,EDS 250,A00,507344,Hemans; Patricia Ann Benitez,20,0,40,20
1715615257390,EDS 281,A00,507345,Daly; Alan J.,18,0,18,0
1715615258418,EDS 284,A00,507350,Daly; Alan J.,16,0,16,0
1715615259443,EDS 286,A00,507359,Fine; Sarah,18,0,18,0
1715615260469,EDS 289C,A01,507361,Daly; Alan J.,18,0,18,0
1715615261495,EDS 290,A00,507366,Hofstetter; Carolyn,15,0,15,0
1715615262521,LIGM 5A,A00,507421,Fischer-Grunski; Eva K,17,0,20,3
1715615263546,LIGM 5B,A00,507423,Fischer-Grunski; Eva K,19,0,20,1
1715615264575,LIGM 5C,A00,507425,Fischer-Grunski; Eva K,19,0,20,1
1715615265604,LIIT 5AS,A00,507427,Carnelos; Chiara,20,0,20,0
1715615266632,LIIT 5BS,A00,507430,Carnelos; Chiara,20,0,20,0
1715615267663,LIIT 5CS,A00,507432,Carnelos; Chiara,20,0,20,0
1715615268689,LISP 5A,A00,507541,Munoz Sanchez; Alicia,11,0,20,9
1715615269717,LISP 5B,A00,507671,Munoz Sanchez; Alicia,9,0,20,11
1715615270743,LISP 5C,A00,507696,Munoz Sanchez; Alicia,9,0,20,11
1715615271769,MAE 197,001,528363,Boechler; Nicholas Sebastia,9998,0,9999,1
1715615272794,MATH 197,001,523477,Kedlaya; Kiran S.,9994,0,9999,5
1715615272794,MATH 197,002,563811,Zhang; Danna,9994,0,9999,5
1715615272794,MATH 197,003,628552,Dumitriu; Ioana,9998,0,9999,1
1715615272794,MATH 197,004,660885,Floyd; Eric,9999,0,9999,0
1715615273879,MCWP 40R,A00,518780,Staff,2,0,20,18
1715615273879,MCWP 40R,B00,518781,Staff,11,0,20,9
1715615273879,MCWP 40R,C00,518783,Staff,5,0,20,15
1715615274905,MCWP 50R,A00,518791,Staff,0,1,20,20
1715615274905,MCWP 50R,B00,518792,Staff,0,2,20,20
1715615274905,MCWP 50R,C00,518793,Staff,0,4,20,20
1715615274905,MCWP 50R,D00,518794,Staff,0,1,20,20
1715615274905,MCWP 50R,E00,518795,Staff,0,2,20,20
1715615274905,MCWP 50R,F00,518796,Staff,0,1,20,20
1715615274905,MCWP 50R,G00,518797,Staff,0,1,20,20
1715615275929,MMW 12R,A01,514034,Herbst; Matthew,0,2,16,16
1715615275929,MMW 12R,A02,514035,Herbst; Matthew,0,0,16,16
1715615276958,MMW 13R,A01,514037,Staff,0,5,16,16
1715615276958,MMW 13R,A02,514039,Staff,0,5,16,16
1715615276958,MMW 13R,A03,628519,Staff,0,4,16,16
1715615279013,SIO 295LS,A00,523233,Staff,10,0,30,20
1715615280040,SIO 295S,A00,523232,Staff,10,0,30,20
1715615281069,SIOC 290S,A01,637330,Merrifield; Mark A,23,0,30,7
1715615282095,SIOC 291S,A01,637333,Gabriel; Corey John,23,0,30,7
1715615283119,SOCI 117,A01,494376,Staff,0,5,5,5
1715615284144,WES 237B,A00,494380,Staff,10,0,20,10
1715615286205,AESE 279B,A00,494370,Wade; Jon P,0,0,33,33
1715615287231,AIP 97,001,660915,Van Den Einde; Yael Dahlia,9999,0,9999,0
1715615288257,AIP 197,001,627712,Vespa; Emanuel Ignacio,9995,0,9999,4
1715615288257,AIP 197,002,650778,Amir; On,9998,0,9999,1
1715615288257,AIP 197,003,650933,Avenancio-Leon; Carlos,9998,0,9999,1
1715615288257,AIP 197,004,658530,Heyman; Gail D.,9998,0,9999,1
1715615288257,AIP 197,005,658631,Neal; Sonya E,9998,0,9999,1
1715615288257,AIP 197,006,658671,Du; Songzi,9998,0,9999,1
1715615289284,ANAR 135S,A00,494369,Braswell; Geoffrey E.,0,0,0,0
1715615290310,BENG 196,001,628496,Engler; Adam J.,9998,0,9999,1
1715615290310,BENG 196,002,660916,Watson; John Thomas,9999,0,9999,0
1715615291341,BISP 197,001,650773,Wilhelm; James E.,9994,0,9999,5
1715615291341,BISP 197,002,658904,Coleman; Aaron B.,9998,0,9999,1
1715615292367,CAT 124RS,A01,519847,Geibel; William,0,0,20,20
1715615293394,CAT 125RS,A01,515971,Geibel; William,0,0,20,20
1715615294420,CLRE 250,A00,511389,Morris; Sheldon,9992,0,9999,7
1715615295447,CLRE 251,A00,507176,Mehta; Ravindra L.,9992,0,9999,7
1715615295447,CLRE 251,B00,511410,Mehta; Ravindra L.,9998,0,9999,1
1715615296473,CLRE 252,A00,507189,Cuomo; Raphael Eduardo,9994,0,9999,5
1715615297502,CLRE 253,A00,507199,Vaida; Florin,9994,0,9999,5
1715615297502,CLRE 253,B00,507202,Vaida; Florin,9999,0,9999,0
1715615298527,CLRE 259,A00,507211,Patel; Hemal,9996,0,9999,3
1715615299555,CLRE 260,A00,507221,Cuomo; Raphael Eduardo,9999,0,9999,0
1715615300580,CLRE 297,001,507242,Cuomo; Raphael Eduardo,9999,0,9999,0
1715615301605,COGS 197,001,638244,Voytek; Bradley Thomas,9997,0,9999,2
1715615302633,CSE 191,A00,516875,Minnes Kemp; Mor Mia,9991,0,9999,8
1715615303657,CSE 197,001,637388,Minnes Kemp; Mor Mia,9992,0,9999,7
1715615304685,CSS 201S,A01,494383,Mignozzetti; Umberto,35,0,35,0
1715615305711,CSS 202S,A01,494387,Mignozzetti; Umberto,35,0,35,0
1715615306741,DSC 197,001,628532,Eldridge; Justin Matthew,9995,0,9999,4
1715615307765,EAP 100,A00,516065,Staff,9799,0,9999,200
1715615308799,ECE 45,A01,507414,Staff,31,0,60,29
1715615310855,ECE 111,A01,507420,Staff,11,0,50,39
1715615311882,ECE 197,001,548057,Sievenpiper; Daniel F.,9991,0,9999,8
1715615312907,EDS 115,A00,507243,Choi; Bailey Miyeon,7,0,28,21
1715615313932,EDS 117,A01,494379,Staff,0,6,34,34
1715615314961,EDS 125,A00,507246,Hopkins; Megan Beth,8,0,30,22
1715615315991,EDS 128A,A01,507264,Fargason; Sharon Gayle,6,0,26,20
1715615317015,EDS 128B,A01,507293,Pappas; Elizabeth,10,0,30,20
1715615318039,EDS 139,A00,507294,Fargason; Sharon Gayle,10,0,30,20
1715615318039,EDS 139,B00,507313,Pappas; Elizabeth,11,0,30,19
1715615319073,EDS 201,A00,507315,Staff,10,0,30,20
1715615320102,EDS 203,A01,507317,Halter; Christopher P.,10,0,30,20
1715615321128,EDS 204R,A01,507319,Halter; Christopher P.,0,3,30,30
1715615321128,EDS 204R,B01,507331,Heinzman; Erica M.,14,0,30,16
1715615322153,EDS 206R,A00,507332,Staff,0,4,30,30
1715615322153,EDS 206R,B00,507343,Staff,15,0,30,15
1715615323182,EDS 250,A00,507344,Hemans; Patricia Ann Benitez,20,0,40,20
1715615324208,EDS 281,A00,507345,Daly; Alan J.,18,0,18,0
1715615325241,EDS 284,A00,507350,Daly; Alan J.,16,0,16,0
1715615326265,EDS 286,A00,507359,Fine; Sarah,18,0,18,0
1715615327293,EDS 289C,A01,507361,Daly; Alan J.,18,0,18,0
1715615328318,EDS 290,A00,507366,Hofstetter; Carolyn,15,0,15,0
1715615329405,LIGM 5A,A00,507421,Fischer-Grunski; Eva K,17,0,20,3
1715615330430,LIGM 5B,A00,507423,Fischer-Grunski; Eva K,19,0,20,1
1715615331456,LIGM 5C,A00,507425,Fischer-Grunski; Eva K,19,0,20,1
1715615332481,LIIT 5AS,A00,507427,Carnelos; Chiara,20,0,20,0
1715615333506,LIIT 5BS,A00,507430,Carnelos; Chiara,20,0,20,0
1715615334531,LIIT 5CS,A00,507432,Carnelos; Chiara,20,0,20,0
1715615335559,LISP 5A,A00,507541,Munoz Sanchez; Alicia,11,0,20,9
1715615336585,LISP 5B,A00,507671,Munoz Sanchez; Alicia,9,0,20,11
1715615337611,LISP 5C,A00,507696,Munoz Sanchez; Alicia,9,0,20,11
1715615338638,MAE 197,001,528363,Boechler; Nicholas Sebastia,9998,0,9999,1
1715615339665,MATH 197,001,523477,Kedlaya; Kiran S.,9994,0,9999,5
1715615339665,MATH 197,002,563811,Zhang; Danna,9994,0,9999,5
1715615339665,MATH 197,003,628552,Dumitriu; Ioana,9998,0,9999,1
1715615339665,MATH 197,004,660885,Floyd; Eric,9999,0,9999,0
1715615340693,MCWP 40R,A00,518780,Staff,2,0,20,18
1715615340693,MCWP 40R,B00,518781,Staff,11,0,20,9
1715615340693,MCWP 40R,C00,518783,Staff,5,0,20,15
1715615341723,MCWP 50R,A00,518791,Staff,0,1,20,20
1715615341723,MCWP 50R,B00,518792,Staff,0,2,20,20
1715615341723,MCWP 50R,C00,518793,Staff,0,4,20,20
1715615341723,MCWP 50R,D00,518794,Staff,0,1,20,20
1715615341723,MCWP 50R,E00,518795,Staff,0,2,20,20
1715615341723,MCWP 50R,F00,518796,Staff,0,1,20,20
1715615341723,MCWP 50R,G00,518797,Staff,0,1,20,20
1715615342749,MMW 12R,A01,514034,Herbst; Matthew,0,2,16,16
1715615342749,MMW 12R,A02,514035,Herbst; Matthew,0,0,16,16
1715615343777,MMW 13R,A01,514037,Staff,0,5,16,16
1715615343777,MMW 13R,A02,514039,Staff,0,5,16,16
1715615343777,MMW 13R,A03,628519,Staff,0,4,16,16
1715615345827,SIO 295LS,A00,523233,Staff,10,0,30,20
1715615346857,SIO 295S,A00,523232,Staff,10,0,30,20
1715615347892,SIOC 290S,A01,637330,Merrifield; Mark A,23,0,30,7
1715615348918,SIOC 291S,A01,637333,Gabriel; Corey John,23,0,30,7
1715615349943,SOCI 117,A01,494376,Staff,0,5,5,5
1715615350968,WES 237B,A00,494380,Staff,10,0,20,10
1715615353035,AESE 279B,A00,494370,Wade; Jon P,0,0,33,33
1715615354064,AIP 97,001,660915,Van Den Einde; Yael Dahlia,9999,0,9999,0
1715615355088,AIP 197,001,627712,Vespa; Emanuel Ignacio,9995,0,9999,4
1715615355088,AIP 197,002,650778,Amir; On,9998,0,9999,1
1715615355088,AIP 197,003,650933,Avenancio-Leon; Carlos,9998,0,9999,1
1715615355088,AIP 197,004,658530,Heyman; Gail D.,9998,0,9999,1
1715615355088,AIP 197,005,658631,Neal; Sonya E,9998,0,9999,1
1715615355088,AIP 197,006,658671,Du; Songzi,9998,0,9999,1
1715615356118,ANAR 135S,A00,494369,Braswell; Geoffrey E.,0,0,0,0
1715615357142,BENG 196,001,628496,Engler; Adam J.,9998,0,9999,1
1715615357142,BENG 196,002,660916,Watson; John Thomas,9999,0,9999,0
1715615358166,BISP 197,001,650773,Wilhelm; James E.,9994,0,9999,5
1715615358166,BISP 197,002,658904,Coleman; Aaron B.,9998,0,9999,1
1715615359192,CAT 124RS,A01,519847,Geibel; William,0,0,20,20
1715615360219,CAT 125RS,A01,515971,Geibel; William,0,0,20,20
1715615361244,CLRE 250,A00,511389,Morris; Sheldon,9992,0,9999,7
1715615362269,CLRE 251,A00,507176,Mehta; Ravindra L.,9992,0,9999,7
1715615362269,CLRE 251,B00,511410,Mehta; Ravindra L.,9998,0,9999,1
1715615363295,CLRE 252,A00,507189,Cuomo; Raphael Eduardo,9994,0,9999,5
1715615364321,CLRE 253,A00,507199,Vaida; Florin,9994,0,9999,5
1715615364321,CLRE 253,B00,507202,Vaida; Florin,9999,0,9999,0
1715615365347,CLRE 259,A00,507211,Patel; Hemal,9996,0,9999,3
1715615366374,CLRE 260,A00,507221,Cuomo; Raphael Eduardo,9999,0,9999,0
1715615367402,CLRE 297,001,507242,Cuomo; Raphael Eduardo,9999,0,9999,0
1715615368429,COGS 197,001,638244,Voytek; Bradley Thomas,9997,0,9999,2
1715615369455,CSE 191,A00,516875,Minnes Kemp; Mor Mia,9991,0,9999,8
1715615370484,CSE 197,001,637388,Minnes Kemp; Mor Mia,9992,0,9999,7
1715615371514,CSS 201S,A01,494383,Mignozzetti; Umberto,35,0,35,0
1715615372540,CSS 202S,A01,494387,Mignozzetti; Umberto,35,0,35,0
1715615373565,DSC 197,001,628532,Eldridge; Justin Matthew,9995,0,9999,4
1715615374591,EAP 100,A00,516065,Staff,9799,0,9999,200
1715615375621,ECE 45,A01,507414,Staff,31,0,60,29
1715615377672,ECE 111,A01,507420,Staff,11,0,50,39
1715615378697,ECE 197,001,548057,Sievenpiper; Daniel F.,9991,0,9999,8
1715615379724,EDS 115,A00,507243,Choi; Bailey Miyeon,7,0,28,21
1715615380752,EDS 117,A01,494379,Staff,0,6,34,34
1715615381776,EDS 125,A00,507246,Hopkins; Megan Beth,8,0,30,22
1715615382801,EDS 128A,A01,507264,Fargason; Sharon Gayle,6,0,26,20
1715615383830,EDS 128B,A01,507293,Pappas; Elizabeth,10,0,30,20
1715615384857,EDS 139,A00,507294,Fargason; Sharon Gayle,10,0,30,20
1715615384857,EDS 139,B00,507313,Pappas; Elizabeth,11,0,30,19
1715615385884,EDS 201,A00,507315,Staff,10,0,30,20
1715615386912,EDS 203,A01,507317,Halter; Christopher P.,10,0,30,20
1715615387942,EDS 204R,A01,507319,Halter; Christopher P.,0,3,30,30
1715615387942,EDS 204R,B01,507331,Heinzman; Erica M.,14,0,30,16
1715615388967,EDS 206R,A00,507332,Staff,0,4,30,30
1715615388967,EDS 206R,B00,507343,Staff,15,0,30,15
1715615389992,EDS 250,A00,507344,Hemans; Patricia Ann Benitez,20,0,40,20
1715615391016,EDS 281,A00,507345,Daly; Alan J.,18,0,18,0
1715615392042,EDS 284,A00,507350,Daly; Alan J.,16,0,16,0
1715615393070,EDS 286,A00,507359,Fine; Sarah,18,0,18,0
1715615394097,EDS 289C,A01,507361,Daly; Alan J.,18,0,18,0
1715615395124,EDS 290,A00,507366,Hofstetter; Carolyn,15,0,15,0
1715615396150,LIGM 5A,A00,507421,Fischer-Grunski; Eva K,17,0,20,3
1715615397179,LIGM 5B,A00,507423,Fischer-Grunski; Eva K,19,0,20,1
1715615398206,LIGM 5C,A00,507425,Fischer-Grunski; Eva K,19,0,20,1
1715615399236,LIIT 5AS,A00,507427,Carnelos; Chiara,20,0,20,0
1715615400266,LIIT 5BS,A00,507430,Carnelos; Chiara,20,0,20,0
1715615401293,LIIT 5CS,A00,507432,Carnelos; Chiara,20,0,20,0
1715615402322,LISP 5A,A00,507541,Munoz Sanchez; Alicia,11,0,20,9
1715615403351,LISP 5B,A00,507671,Munoz Sanchez; Alicia,9,0,20,11
1715615404378,LISP 5C,A00,507696,Munoz Sanchez; Alicia,9,0,20,11
1715615405403,MAE 197,001,528363,Boechler; Nicholas Sebastia,9998,0,9999,1
1715615406428,MATH 197,001,523477,Kedlaya; Kiran S.,9994,0,9999,5
1715615406428,MATH 197,002,563811,Zhang; Danna,9994,0,9999,5
1715615406428,MATH 197,003,628552,Dumitriu; Ioana,9998,0,9999,1
1715615406428,MATH 197,004,660885,Floyd; Eric,9999,0,9999,0
1715615407454,MCWP 40R,A00,518780,Staff,2,0,20,18
1715615407454,MCWP 40R,B00,518781,Staff,11,0,20,9
1715615407454,MCWP 40R,C00,518783,Staff,5,0,20,15
1715615408480,MCWP 50R,A00,518791,Staff,0,1,20,20
1715615408480,MCWP 50R,B00,518792,Staff,0,2,20,20
1715615408480,MCWP 50R,C00,518793,Staff,0,4,20,20
1715615408480,MCWP 50R,D00,518794,Staff,0,1,20,20
1715615408480,MCWP 50R,E00,518795,Staff,0,2,20,20
1715615408480,MCWP 50R,F00,518796,Staff,0,1,20,20
1715615408480,MCWP 50R,G00,518797,Staff,0,1,20,20
1715615409505,MMW 12R,A01,514034,Herbst; Matthew,0,2,16,16
1715615409505,MMW 12R,A02,514035,Herbst; Matthew,0,0,16,16
1715615410531,MMW 13R,A01,514037,Staff,0,5,16,16
1715615410531,MMW 13R,A02,514039,Staff,0,5,16,16
1715615410531,MMW 13R,A03,628519,Staff,0,4,16,16
1715615412636,SIO 295LS,A00,523233,Staff,10,0,30,20
1715615413663,SIO 295S,A00,523232,Staff,10,0,30,20
1715615414689,SIOC 290S,A01,637330,Merrifield; Mark A,23,0,30,7
1715615415715,SIOC 291S,A01,637333,Gabriel; Corey John,23,0,30,7
1715615416741,SOCI 117,A01,494376,Staff,0,5,5,5
1715615417766,WES 237B,A00,494380,Staff,10,0,20,10
1715615419829,AESE 279B,A00,494370,Wade; Jon P,0,0,33,33
1715615420857,AIP 97,001,660915,Van Den Einde; Yael Dahlia,9999,0,9999,0
1715615421884,AIP 197,001,627712,Vespa; Emanuel Ignacio,9995,0,9999,4
1715615421884,AIP 197,002,650778,Amir; On,9998,0,9999,1
1715615421884,AIP 197,003,650933,Avenancio-Leon; Carlos,9998,0,9999,1
1715615421884,AIP 197,004,658530,Heyman; Gail D.,9998,0,9999,1
1715615421884,AIP 197,005,658631,Neal; Sonya E,9998,0,9999,1
1715615421884,AIP 197,006,658671,Du; Songzi,9998,0,9999,1
1715615422909,ANAR 135S,A00,494369,Braswell; Geoffrey E.,0,0,0,0
1715615423937,BENG 196,001,628496,Engler; Adam J.,9998,0,9999,1
1715615423937,BENG 196,002,660916,Watson; John Thomas,9999,0,9999,0
1715615424963,BISP 197,001,650773,Wilhelm; James E.,9994,0,9999,5
1715615424963,BISP 197,002,658904,Coleman; Aaron B.,9998,0,9999,1
1715615425990,CAT 124RS,A01,519847,Geibel; William,0,0,20,20
1715615427016,CAT 125RS,A01,515971,Geibel; William,0,0,20,20
1715615428041,CLRE 250,A00,511389,Morris; Sheldon,9992,0,9999,7
1715615429073,CLRE 251,A00,507176,Mehta; Ravindra L.,9992,0,9999,7
1715615429073,CLRE 251,B00,511410,Mehta; Ravindra L.,9998,0,9999,1
1715615430099,CLRE 252,A00,507189,Cuomo; Raphael Eduardo,9994,0,9999,5
1715615431128,CLRE 253,A00,507199,Vaida; Florin,9994,0,9999,5
1715615431128,CLRE 253,B00,507202,Vaida; Florin,9999,0,9999,0
1715615432153,CLRE 259,A00,507211,Patel; Hemal,9996,0,9999,3
1715615433182,CLRE 260,A00,507221,Cuomo; Raphael Eduardo,9999,0,9999,0
1715615434207,CLRE 297,001,507242,Cuomo; Raphael Eduardo,9999,0,9999,0
1715615435236,COGS 197,001,638244,Voytek; Bradley Thomas,9997,0,9999,2
1715615436263,CSE 191,A00,516875,Minnes Kemp; Mor Mia,9991,0,9999,8
1715615437316,CSE 197,001,637388,Minnes Kemp; Mor Mia,9992,0,9999,7
1715615438339,CSS 201S,A01,494383,Mignozzetti; Umberto,35,0,35,0
1715615439367,CSS 202S,A01,494387,Mignozzetti; Umberto,35,0,35,0
1715615440393,DSC 197,001,628532,Eldridge; Justin Matthew,9995,0,9999,4
1715615441421,EAP 100,A00,516065,Staff,9799,0,9999,200
1715615442448,ECE 45,A01,507414,Staff,31,0,60,29
1715615444503,ECE 111,A01,507420,Staff,11,0,50,39
1715615445531,ECE 197,001,548057,Sievenpiper; Daniel F.,9991,0,9999,8
1715615446558,EDS 115,A00,507243,Choi; Bailey Miyeon,7,0,28,21
1715615447588,EDS 117,A01,494379,Staff,0,6,34,34
1715615448618,EDS 125,A00,507246,Hopkins; Megan Beth,8,0,30,22
1715615449645,EDS 128A,A01,507264,Fargason; Sharon Gayle,6,0,26,20
1715615450675,EDS 128B,A01,507293,Pappas; Elizabeth,10,0,30,20
1715615451704,EDS 139,A00,507294,Fargason; Sharon Gayle,10,0,30,20
1715615451704,EDS 139,B00,507313,Pappas; Elizabeth,11,0,30,19
1715615452733,EDS 201,A00,507315,Staff,10,0,30,20
1715615453759,EDS 203,A01,507317,Halter; Christopher P.,10,0,30,20
1715615454784,EDS 204R,A01,507319,Halter; Christopher P.,0,3,30,30
1715615454784,EDS 204R,B01,507331,Heinzman; Erica M.,14,0,30,16
1715615455812,EDS 206R,A00,507332,Staff,0,4,30,30
1715615455812,EDS 206R,B00,507343,Staff,15,0,30,15
1715615456836,EDS 250,A00,507344,Hemans; Patricia Ann Benitez,20,0,40,20
1715615457865,EDS 281,A00,507345,Daly; Alan J.,18,0,18,0
1715615458893,EDS 284,A00,507350,Daly; Alan J.,16,0,16,0
1715615459922,EDS 286,A00,507359,Fine; Sarah,18,0,18,0
1715615460947,EDS 289C,A01,507361,Daly; Alan J.,18,0,18,0
1715615461973,EDS 290,A00,507366,Hofstetter; Carolyn,15,0,15,0
1715615462999,LIGM 5A,A00,507421,Fischer-Grunski; Eva K,17,0,20,3
1715615464029,LIGM 5B,A00,507423,Fischer-Grunski; Eva K,19,0,20,1
1715615465058,LIGM 5C,A00,507425,Fischer-Grunski; Eva K,19,0,20,1
1715615466086,LIIT 5AS,A00,507427,Carnelos; Chiara,20,0,20,0
1715615467112,LIIT 5BS,A00,507430,Carnelos; Chiara,20,0,20,0
1715615468141,LIIT 5CS,A00,507432,Carnelos; Chiara,20,0,20,0
1715615469168,LISP 5A,A00,507541,Munoz Sanchez; Alicia,11,0,20,9
1715615470193,LISP 5B,A00,507671,Munoz Sanchez; Alicia,9,0,20,11
1715615471222,LISP 5C,A00,507696,Munoz Sanchez; Alicia,9,0,20,11
1715615472248,MAE 197,001,528363,Boechler; Nicholas Sebastia,9998,0,9999,1
1715615473278,MATH 197,001,523477,Kedlaya; Kiran S.,9994,0,9999,5
1715615473278,MATH 197,002,563811,Zhang; Danna,9994,0,9999,5
1715615473278,MATH 197,003,628552,Dumitriu; Ioana,9998,0,9999,1
1715615473278,MATH 197,004,660885,Floyd; Eric,9999,0,9999,0
1715615474307,MCWP 40R,A00,518780,Staff,2,0,20,18
1715615474307,MCWP 40R,B00,518781,Staff,11,0,20,9
1715615474307,MCWP 40R,C00,518783,Staff,5,0,20,15
1715615475336,MCWP 50R,A00,518791,Staff,0,1,20,20
1715615475336,MCWP 50R,B00,518792,Staff,0,2,20,20
1715615475336,MCWP 50R,C00,518793,Staff,0,4,20,20
1715615475336,MCWP 50R,D00,518794,Staff,0,1,20,20
1715615475336,MCWP 50R,E00,518795,Staff,0,2,20,20
1715615475336,MCWP 50R,F00,518796,Staff,0,1,20,20
1715615475336,MCWP 50R,G00,518797,Staff,0,1,20,20
1715615476361,MMW 12R,A01,514034,Herbst; Matthew,0,2,16,16
1715615476361,MMW 12R,A02,514035,Herbst; Matthew,0,0,16,16
1715615477389,MMW 13R,A01,514037,Staff,0,5,16,16
1715615477389,MMW 13R,A02,514039,Staff,0,5,16,16
1715615477389,MMW 13R,A03,628519,Staff,0,4,16,16
1715615479443,SIO 295LS,A00,523233,Staff,10,0,30,20
1715615480469,SIO 295S,A00,523232,Staff,10,0,30,20
1715615481498,SIOC 290S,A01,637330,Merrifield; Mark A,23,0,30,7
1715615482525,SIOC 291S,A01,637333,Gabriel; Corey John,23,0,30,7
1715615483553,SOCI 117,A01,494376,Staff,0,5,5,5
1715615484579,WES 237B,A00,494380,Staff,10,0,20,10
1715615486654,AESE 279B,A00,494370,Wade; Jon P,0,0,33,33
1715615487679,AIP 97,001,660915,Van Den Einde; Yael Dahlia,9999,0,9999,0
1715615488707,AIP 197,001,627712,Vespa; Emanuel Ignacio,9995,0,9999,4
1715615488707,AIP 197,002,650778,Amir; On,9998,0,9999,1
1715615488707,AIP 197,003,650933,Avenancio-Leon; Carlos,9998,0,9999,1
1715615488707,AIP 197,004,658530,Heyman; Gail D.,9998,0,9999,1
1715615488707,AIP 197,005,658631,Neal; Sonya E,9998,0,9999,1
1715615488707,AIP 197,006,658671,Du; Songzi,9998,0,9999,1
1715615489735,ANAR 135S,A00,494369,Braswell; Geoffrey E.,0,0,0,0
1715615490849,BENG 196,001,628496,Engler; Adam J.,9998,0,9999,1
1715615490849,BENG 196,002,660916,Watson; John Thomas,9999,0,9999,0
1715615491876,BISP 197,001,650773,Wilhelm; James E.,9994,0,9999,5
1715615491876,BISP 197,002,658904,Coleman; Aaron B.,9998,0,9999,1
1715615492903,CAT 124RS,A01,519847,Geibel; William,0,0,20,20
1715615493928,CAT 125RS,A01,515971,Geibel; William,0,0,20,20
1715615494955,CLRE 250,A00,511389,Morris; Sheldon,9992,0,9999,7
1715615495983,CLRE 251,A00,507176,Mehta; Ravindra L.,9992,0,9999,7
1715615495983,CLRE 251,B00,511410,Mehta; Ravindra L.,9998,0,9999,1
1715615497013,CLRE 252,A00,507189,Cuomo; Raphael Eduardo,9994,0,9999,5
1715615498038,CLRE 253,A00,507199,Vaida; Florin,9994,0,9999,5
1715615498038,CLRE 253,B00,507202,Vaida; Florin,9999,0,9999,0
1715615499085,CLRE 259,A00,507211,Patel; Hemal,9996,0,9999,3
1715615500111,CLRE 260,A00,507221,Cuomo; Raphael Eduardo,9999,0,9999,0
1715615501136,CLRE 297,001,507242,Cuomo; Raphael Eduardo,9999,0,9999,0
1715615502162,COGS 197,001,638244,Voytek; Bradley Thomas,9997,0,9999,2
1715615503188,CSE 191,A00,516875,Minnes Kemp; Mor Mia,9991,0,9999,8
1715615504214,CSE 197,001,637388,Minnes Kemp; Mor Mia,9992,0,9999,7
1715615505240,CSS 201S,A01,494383,Mignozzetti; Umberto,35,0,35,0
1715615506266,CSS 202S,A01,494387,Mignozzetti; Umberto,35,0,35,0
1715615507293,DSC 197,001,628532,Eldridge; Justin Matthew,9995,0,9999,4
1715615508318,EAP 100,A00,516065,Staff,9799,0,9999,200
1715615509342,ECE 45,A01,507414,Staff,31,0,60,29
1715615511397,ECE 111,A01,507420,Staff,11,0,50,39
1715615512425,ECE 197,001,548057,Sievenpiper; Daniel F.,9991,0,9999,8
1715615513454,EDS 115,A00,507243,Choi; Bailey Miyeon,7,0,28,21
1715615514479,EDS 117,A01,494379,Staff,0,6,34,34
1715615515506,EDS 125,A00,507246,Hopkins; Megan Beth,8,0,30,22
1715615516537,EDS 128A,A01,507264,Fargason; Sharon Gayle,6,0,26,20
1715615517564,EDS 128B,A01,507293,Pappas; Elizabeth,10,0,30,20
1715615518594,EDS 139,A00,507294,Fargason; Sharon Gayle,10,0,30,20
1715615518594,EDS 139,B00,507313,Pappas; Elizabeth,11,0,30,19
1715615519623,EDS 201,A00,507315,Staff,10,0,30,20
1715615520647,EDS 203,A01,507317,Halter; Christopher P.,10,0,30,20
1715615521678,EDS 204R,A01,507319,Halter; Christopher P.,0,3,30,30
1715615521678,EDS 204R,B01,507331,Heinzman; Erica M.,14,0,30,16
1715615522703,EDS 206R,A00,507332,Staff,0,4,30,30
1715615522703,EDS 206R,B00,507343,Staff,15,0,30,15
1715615523730,EDS 250,A00,507344,Hemans; Patricia Ann Benitez,20,0,40,20
1715615524755,EDS 281,A00,507345,Daly; Alan J.,18,0,18,0
1715615525782,EDS 284,A00,507350,Daly; Alan J.,16,0,16,0
1715615526811,EDS 286,A00,507359,Fine; Sarah,18,0,18,0
1715615527840,EDS 289C,A01,507361,Daly; Alan J.,18,0,18,0
1715615528865,EDS 290,A00,507366,Hofstetter; Carolyn,15,0,15,0
1715615529893,LIGM 5A,A00,507421,Fischer-Grunski; Eva K,17,0,20,3
1715615530921,LIGM 5B,A00,507423,Fischer-Grunski; Eva K,19,0,20,1
1715615531949,LIGM 5C,A00,507425,Fischer-Grunski; Eva K,19,0,20,1
1715615532980,LIIT 5AS,A00,507427,Carnelos; Chiara,20,0,20,0
1715615534007,LIIT 5BS,A00,507430,Carnelos; Chiara,20,0,20,0
1715615535035,LIIT 5CS,A00,507432,Carnelos; Chiara,20,0,20,0
1715615536062,LISP 5A,A00,507541,Munoz Sanchez; Alicia,11,0,20,9
1715615537088,LISP 5B,A00,507671,Munoz Sanchez; Alicia,9,0,20,11
1715615538118,LISP 5C,A00,507696,Munoz Sanchez; Alicia,9,0,20,11
1715615539144,MAE 197,001,528363,Boechler; Nicholas Sebastia,9998,0,9999,1
1715615540173,MATH 197,001,523477,Kedlaya; Kiran S.,9994,0,9999,5
1715615540173,MATH 197,002,563811,Zhang; Danna,9994,0,9999,5
1715615540173,MATH 197,003,628552,Dumitriu; Ioana,9998,0,9999,1
1715615540173,MATH 197,004,660885,Floyd; Eric,9999,0,9999,0
1715615541203,MCWP 40R,A00,518780,Staff,2,0,20,18
1715615541203,MCWP 40R,B00,518781,Staff,11,0,20,9
1715615541203,MCWP 40R,C00,518783,Staff,5,0,20,15
1715615542231,MCWP 50R,A00,518791,Staff,0,1,20,20
1715615542231,MCWP 50R,B00,518792,Staff,0,2,20,20
1715615542231,MCWP 50R,C00,518793,Staff,0,4,20,20
1715615542231,MCWP 50R,D00,518794,Staff,0,1,20,20
1715615542231,MCWP 50R,E00,518795,Staff,0,2,20,20
1715615542231,MCWP 50R,F00,518796,Staff,0,1,20,20
1715615542231,MCWP 50R,G00,518797,Staff,0,1,20,20
1715615543261,MMW 12R,A01,514034,Herbst; Matthew,0,2,16,16
1715615543261,MMW 12R,A02,514035,Herbst; Matthew,0,0,16,16
1715615544288,MMW 13R,A01,514037,Staff,0,5,16,16
1715615544288,MMW 13R,A02,514039,Staff,0,5,16,16
1715615544288,MMW 13R,A03,628519,Staff,0,4,16,16
1715615546339,SIO 295LS,A00,523233,Staff,10,0,30,20
1715615547365,SIO 295S,A00,523232,Staff,10,0,30,20
1715615548391,SIOC 290S,A01,637330,Merrifield; Mark A,23,0,30,7
1715615549417,SIOC 291S,A01,637333,Gabriel; Corey John,23,0,30,7
1715615550444,SOCI 117,A01,494376,Staff,0,5,5,5
1715615551471,WES 237B,A00,494380,Staff,10,0,20,10
1715615553541,AESE 279B,A00,494370,Wade; Jon P,0,0,33,33
1715615554566,AIP 97,001,660915,Van Den Einde; Yael Dahlia,9999,0,9999,0
1715615555594,AIP 197,001,627712,Vespa; Emanuel Ignacio,9995,0,9999,4
1715615555594,AIP 197,002,650778,Amir; On,9998,0,9999,1
1715615555594,AIP 197,003,650933,Avenancio-Leon; Carlos,9998,0,9999,1
1715615555594,AIP 197,004,658530,Heyman; Gail D.,9998,0,9999,1
1715615555594,AIP 197,005,658631,Neal; Sonya E,9998,0,9999,1
1715615555594,AIP 197,006,658671,Du; Songzi,9998,0,9999,1
1715615556621,ANAR 135S,A00,494369,Braswell; Geoffrey E.,0,0,0,0
1715615557647,BENG 196,001,628496,Engler; Adam J.,9998,0,9999,1
1715615557647,BENG 196,002,660916,Watson; John Thomas,9999,0,9999,0
1715615558674,BISP 197,001,650773,Wilhelm; James E.,9994,0,9999,5
1715615558674,BISP 197,002,658904,Coleman; Aaron B.,9998,0,9999,1
1715615559699,CAT 124RS,A01,519847,Geibel; William,0,0,20,20
1715615560724,CAT 125RS,A01,515971,Geibel; William,0,0,20,20
1715615561751,CLRE 250,A00,511389,Morris; Sheldon,9992,0,9999,7
1715615562777,CLRE 251,A00,507176,Mehta; Ravindra L.,9992,0,9999,7
1715615562777,CLRE 251,B00,511410,Mehta; Ravindra L.,9998,0,9999,1
1715615563802,CLRE 252,A00,507189,Cuomo; Raphael Eduardo,9994,0,9999,5
1715615564832,CLRE 253,A00,507199,Vaida; Florin,9994,0,9999,5
1715615564832,CLRE 253,B00,507202,Vaida; Florin,9999,0,9999,0
1715615565857,CLRE 259,A00,507211,Patel; Hemal,9996,0,9999,3
1715615566882,CLRE 260,A00,507221,Cuomo; Raphael Eduardo,9999,0,9999,0
1715615567910,CLRE 297,001,507242,Cuomo; Raphael Eduardo,9999,0,9999,0
1715615568935,COGS 197,001,638244,Voytek; Bradley Thomas,9997,0,9999,2
1715615569958,CSE 191,A00,516875,Minnes Kemp; Mor Mia,9991,0,9999,8
1715615570986,CSE 197,001,637388,Minnes Kemp; Mor Mia,9992,0,9999,7
1715615572015,CSS 201S,A01,494383,Mignozzetti; Umberto,35,0,35,0
1715615573045,CSS 202S,A01,494387,Mignozzetti; Umberto,35,0,35,0
1715615574072,DSC 197,001,628532,Eldridge; Justin Matthew,9995,0,9999,4
1715615575101,EAP 100,A00,516065,Staff,9799,0,9999,200
1715615576131,ECE 45,A01,507414,Staff,31,0,60,29
1715615578189,ECE 111,A01,507420,Staff,11,0,50,39
1715615579213,ECE 197,001,548057,Sievenpiper; Daniel F.,9991,0,9999,8
1715615580239,EDS 115,A00,507243,Choi; Bailey Miyeon,7,0,28,21
1715615581267,EDS 117,A01,494379,Staff,0,6,34,34
1715615582296,EDS 125,A00,507246,Hopkins; Megan Beth,8,0,30,22
1715615583332,EDS 128A,A01,507264,Fargason; Sharon Gayle,6,0,26,20
1715615584358,EDS 128B,A01,507293,Pappas; Elizabeth,10,0,30,20
1715615585387,EDS 139,A00,507294,Fargason; Sharon Gayle,10,0,30,20
1715615585387,EDS 139,B00,507313,Pappas; Elizabeth,11,0,30,19
1715615586413,EDS 201,A00,507315,Staff,10,0,30,20
1715615587443,EDS 203,A01,507317,Halter; Christopher P.,10,0,30,20
1715615588470,EDS 204R,A01,507319,Halter; Christopher P.,0,3,30,30
1715615588470,EDS 204R,B01,507331,Heinzman; Erica M.,14,0,30,16
1715615589496,EDS 206R,A00,507332,Staff,0,4,30,30
1715615589496,EDS 206R,B00,507343,Staff,15,0,30,15
1715615590521,EDS 250,A00,507344,Hemans; Patricia Ann Benitez,20,0,40,20
1715615591549,EDS 281,A00,507345,Daly; Alan J.,18,0,18,0
1715615592577,EDS 284,A00,507350,Daly; Alan J.,16,0,16,0
1715615593602,EDS 286,A00,507359,Fine; Sarah,18,0,18,0
1715615594631,EDS 289C,A01,507361,Daly; Alan J.,18,0,18,0
1715615595656,EDS 290,A00,507366,Hofstetter; Carolyn,15,0,15,0
1715615596685,LIGM 5A,A00,507421,Fischer-Grunski; Eva K,17,0,20,3
1715615597710,LIGM 5B,A00,507423,Fischer-Grunski; Eva K,19,0,20,1
1715615598735,LIGM 5C,A00,507425,Fischer-Grunski; Eva K,19,0,20,1
1715615599767,LIIT 5AS,A00,507427,Carnelos; Chiara,20,0,20,0
1715615600792,LIIT 5BS,A00,507430,Carnelos; Chiara,20,0,20,0
1715615601816,LIIT 5CS,A00,507432,Carnelos; Chiara,20,0,20,0
1715615602841,LISP 5A,A00,507541,Munoz Sanchez; Alicia,11,0,20,9
1715615603878,LISP 5B,A00,507671,Munoz Sanchez; Alicia,9,0,20,11
1715615604905,LISP 5C,A00,507696,Munoz Sanchez; Alicia,9,0,20,11
1715615605931,MAE 197,001,528363,Boechler; Nicholas Sebastia,9998,0,9999,1
1715615606959,MATH 197,001,523477,Kedlaya; Kiran S.,9994,0,9999,5
1715615606959,MATH 197,002,563811,Zhang; Danna,9994,0,9999,5
1715615606959,MATH 197,003,628552,Dumitriu; Ioana,9998,0,9999,1
1715615606959,MATH 197,004,660885,Floyd; Eric,9999,0,9999,0
1715615607986,MCWP 40R,A00,518780,Staff,2,0,20,18
1715615607986,MCWP 40R,B00,518781,Staff,11,0,20,9
1715615607986,MCWP 40R,C00,518783,Staff,5,0,20,15
1715615609011,MCWP 50R,A00,518791,Staff,0,1,20,20
1715615609011,MCWP 50R,B00,518792,Staff,0,2,20,20
1715615609011,MCWP 50R,C00,518793,Staff,0,4,20,20
1715615609011,MCWP 50R,D00,518794,Staff,0,1,20,20
1715615609011,MCWP 50R,E00,518795,Staff,0,2,20,20
1715615609011,MCWP 50R,F00,518796,Staff,0,1,20,20
1715615609011,MCWP 50R,G00,518797,Staff,0,1,20,20
1715615610036,MMW 12R,A01,514034,Herbst; Matthew,0,2,16,16
1715615610036,MMW 12R,A02,514035,Herbst; Matthew,0,0,16,16
1715615611061,MMW 13R,A01,514037,Staff,0,5,16,16
1715615611061,MMW 13R,A02,514039,Staff,0,5,16,16
1715615611061,MMW 13R,A03,628519,Staff,0,4,16,16
1715615613112,SIO 295LS,A00,523233,Staff,10,0,30,20
1715615614137,SIO 295S,A00,523232,Staff,10,0,30,20
1715615615166,SIOC 290S,A01,637330,Merrifield; Mark A,23,0,30,7
1715615616196,SIOC 291S,A01,637333,Gabriel; Corey John,23,0,30,7
1715615617223,SOCI 117,A01,494376,Staff,0,5,5,5
1715615618247,WES 237B,A00,494380,Staff,10,0,20,10
1715615620318,AESE 279B,A00,494370,Wade; Jon P,0,0,33,33
1715615621345,AIP 97,001,660915,Van Den Einde; Yael Dahlia,9998,0,9999,1
1715615622375,AIP 197,001,627712,Vespa; Emanuel Ignacio,9995,0,9999,4
1715615622375,AIP 197,002,650778,Amir; On,9998,0,9999,1
1715615622375,AIP 197,003,650933,Avenancio-Leon; Carlos,9998,0,9999,1
1715615622375,AIP 197,004,658530,Heyman; Gail D.,9998,0,9999,1
1715615622375,AIP 197,005,658631,Neal; Sonya E,9998,0,9999,1
1715615622375,AIP 197,006,658671,Du; Songzi,9998,0,9999,1
1715615623403,ANAR 135S,A00,494369,Braswell; Geoffrey E.,0,0,0,0
1715615624432,BENG 196,001,628496,Engler; Adam J.,9998,0,9999,1
1715615624432,BENG 196,002,660916,Watson; John Thomas,9999,0,9999,0
1715615625461,BISP 197,001,650773,Wilhelm; James E.,9994,0,9999,5
1715615625461,BISP 197,002,658904,Coleman; Aaron B.,9998,0,9999,1
1715615626488,CAT 124RS,A01,519847,Geibel; William,0,0,20,20
1715615627518,CAT 125RS,A01,515971,Geibel; William,0,0,20,20
1715615628544,CLRE 250,A00,511389,Morris; Sheldon,9992,0,9999,7
1715615629571,CLRE 251,A00,507176,Mehta; Ravindra L.,9992,0,9999,7
1715615629571,CLRE 251,B00,511410,Mehta; Ravindra L.,9998,0,9999,1
1715615630600,CLRE 252,A00,507189,Cuomo; Raphael Eduardo,9994,0,9999,5
1715615631626,CLRE 253,A00,507199,Vaida; Florin,9994,0,9999,5
1715615631626,CLRE 253,B00,507202,Vaida; Florin,9999,0,9999,0
1715615632653,CLRE 259,A00,507211,Patel; Hemal,9996,0,9999,3
1715615633679,CLRE 260,A00,507221,Cuomo; Raphael Eduardo,9999,0,9999,0
1715615634703,CLRE 297,001,507242,Cuomo; Raphael Eduardo,9999,0,9999,0
1715615635728,COGS 197,001,638244,Voytek; Bradley Thomas,9997,0,9999,2
1715615636753,CSE 191,A00,516875,Minnes Kemp; Mor Mia,9991,0,9999,8
1715615637781,CSE 197,001,637388,Minnes Kemp; Mor Mia,9992,0,9999,7
1715615638809,CSS 201S,A01,494383,Mignozzetti; Umberto,35,0,35,0
1715615639840,CSS 202S,A01,494387,Mignozzetti; Umberto,35,0,35,0
1715615640865,DSC 197,001,628532,Eldridge; Justin Matthew,9995,0,9999,4
1715615641892,EAP 100,A00,516065,Staff,9799,0,9999,200
1715615642921,ECE 45,A01,507414,Staff,31,0,60,29
1715615644974,ECE 111,A01,507420,Staff,11,0,50,39
1715615646000,ECE 197,001,548057,Sievenpiper; Daniel F.,9991,0,9999,8
1715615647027,EDS 115,A00,507243,Choi; Bailey Miyeon,7,0,28,21
1715615648054,EDS 117,A01,494379,Staff,0,6,34,34
1715615649083,EDS 125,A00,507246,Hopkins; Megan Beth,8,0,30,22
1715615650110,EDS 128A,A01,507264,Fargason; Sharon Gayle,6,0,26,20
1715615651136,EDS 128B,A01,507293,Pappas; Elizabeth,10,0,30,20
1715615652161,EDS 139,A00,507294,Fargason; Sharon Gayle,10,0,30,20
1715615652161,EDS 139,B00,507313,Pappas; Elizabeth,11,0,30,19
1715615653186,EDS 201,A00,507315,Staff,10,0,30,20
1715615654211,EDS 203,A01,507317,Halter; Christopher P.,10,0,30,20
1715615655242,EDS 204R,A01,507319,Halter; Christopher P.,0,3,30,30
1715615655242,EDS 204R,B01,507331,Heinzman; Erica M.,14,0,30,16
1715615656271,EDS 206R,A00,507332,Staff,0,4,30,30
1715615656271,EDS 206R,B00,507343,Staff,15,0,30,15
1715615657296,EDS 250,A00,507344,Hemans; Patricia Ann Benitez,20,0,40,20
1715615658321,EDS 281,A00,507345,Daly; Alan J.,18,0,18,0
1715615659346,EDS 284,A00,507350,Daly; Alan J.,16,0,16,0
1715615660373,EDS 286,A00,507359,Fine; Sarah,18,0,18,0
1715615661399,EDS 289C,A01,507361,Daly; Alan J.,18,0,18,0
1715615662425,EDS 290,A00,507366,Hofstetter; Carolyn,15,0,15,0
1715615663450,LIGM 5A,A00,507421,Fischer-Grunski; Eva K,17,0,20,3
1715615664479,LIGM 5B,A00,507423,Fischer-Grunski; Eva K,19,0,20,1
1715615665506,LIGM 5C,A00,507425,Fischer-Grunski; Eva K,19,0,20,1
1715615666537,LIIT 5AS,A00,507427,Carnelos; Chiara,20,0,20,0
1715615667563,LIIT 5BS,A00,507430,Carnelos; Chiara,20,0,20,0
1715615668597,LIIT 5CS,A00,507432,Carnelos; Chiara,20,0,20,0
1715615669628,LISP 5A,A00,507541,Munoz Sanchez; Alicia,11,0,20,9
1715615670659,LISP 5B,A00,507671,Munoz Sanchez; Alicia,9,0,20,11
1715615671686,LISP 5C,A00,507696,Munoz Sanchez; Alicia,9,0,20,11
1715615672715,MAE 197,001,528363,Boechler; Nicholas Sebastia,9998,0,9999,1
1715615673741,MATH 197,001,523477,Kedlaya; Kiran S.,9994,0,9999,5
1715615673741,MATH 197,002,563811,Zhang; Danna,9994,0,9999,5
1715615673741,MATH 197,003,628552,Dumitriu; Ioana,9998,0,9999,1
1715615673741,MATH 197,004,660885,Floyd; Eric,9999,0,9999,0
1715615674770,MCWP 40R,A00,518780,Staff,2,0,20,18
1715615674770,MCWP 40R,B00,518781,Staff,11,0,20,9
1715615674770,MCWP 40R,C00,518783,Staff,5,0,20,15
1715615675796,MCWP 50R,A00,518791,Staff,0,1,20,20
1715615675796,MCWP 50R,B00,518792,Staff,0,2,20,20
1715615675796,MCWP 50R,C00,518793,Staff,0,4,20,20
1715615675796,MCWP 50R,D00,518794,Staff,0,1,20,20
1715615675796,MCWP 50R,E00,518795,Staff,0,2,20,20
1715615675796,MCWP 50R,F00,518796,Staff,0,1,20,20
1715615675796,MCWP 50R,G00,518797,Staff,0,1,20,20
1715615676825,MMW 12R,A01,514034,Herbst; Matthew,0,2,16,16
1715615676825,MMW 12R,A02,514035,Herbst; Matthew,0,0,16,16
1715615677852,MMW 13R,A01,514037,Staff,0,5,16,16
1715615677852,MMW 13R,A02,514039,Staff,0,5,16,16
1715615677852,MMW 13R,A03,628519,Staff,0,4,16,16
1715615679902,SIO 295LS,A00,523233,Staff,10,0,30,20
1715615680925,SIO 295S,A00,523232,Staff,10,0,30,20
1715615681955,SIOC 290S,A01,637330,Merrifield; Mark A,23,0,30,7
1715615682981,SIOC 291S,A01,637333,Gabriel; Corey John,23,0,30,7
1715615684005,SOCI 117,A01,494376,Staff,0,5,5,5
1715615685032,WES 237B,A00,494380,Staff,10,0,20,10
1715615687091,AESE 279B,A00,494370,Wade; Jon P,0,0,33,33
1715615688117,AIP 97,001,660915,Van Den Einde; Yael Dahlia,9998,0,9999,1
1715615689146,AIP 197,001,627712,Vespa; Emanuel Ignacio,9995,0,9999,4
1715615689146,AIP 197,002,650778,Amir; On,9998,0,9999,1
1715615689146,AIP 197,003,650933,Avenancio-Leon; Carlos,9998,0,9999,1
1715615689146,AIP 197,004,658530,Heyman; Gail D.,9998,0,9999,1
1715615689146,AIP 197,005,658631,Neal; Sonya E,9998,0,9999,1
1715615689146,AIP 197,006,658671,Du; Songzi,9998,0,9999,1
1715615690173,ANAR 135S,A00,494369,Braswell; Geoffrey E.,0,0,0,0
1715615691199,BENG 196,001,628496,Engler; Adam J.,9998,0,9999,1
1715615691199,BENG 196,002,660916,Watson; John Thomas,9999,0,9999,0
1715615692227,BISP 197,001,650773,Wilhelm; James E.,9994,0,9999,5
1715615692227,BISP 197,002,658904,Coleman; Aaron B.,9998,0,9999,1
1715615693252,CAT 124RS,A01,519847,Geibel; William,0,0,20,20
1715615694277,CAT 125RS,A01,515971,Geibel; William,0,0,20,20
1715615695303,CLRE 250,A00,511389,Morris; Sheldon,9992,0,9999,7
1715615696332,CLRE 251,A00,507176,Mehta; Ravindra L.,9992,0,9999,7
1715615696332,CLRE 251,B00,511410,Mehta; Ravindra L.,9998,0,9999,1
1715615697357,CLRE 252,A00,507189,Cuomo; Raphael Eduardo,9994,0,9999,5
1715615698384,CLRE 253,A00,507199,Vaida; Florin,9994,0,9999,5
1715615698384,CLRE 253,B00,507202,Vaida; Florin,9999,0,9999,0
1715615699410,CLRE 259,A00,507211,Patel; Hemal,9996,0,9999,3
1715615700435,CLRE 260,A00,507221,Cuomo; Raphael Eduardo,9999,0,9999,0
1715615701462,CLRE 297,001,507242,Cuomo; Raphael Eduardo,9999,0,9999,0
1715615702488,COGS 197,001,638244,Voytek; Bradley Thomas,9997,0,9999,2
1715615703515,CSE 191,A00,516875,Minnes Kemp; Mor Mia,9991,0,9999,8
1715615704543,CSE 197,001,637388,Minnes Kemp; Mor Mia,9992,0,9999,7
1715615705570,CSS 201S,A01,494383,Mignozzetti; Umberto,35,0,35,0
1715615706597,CSS 202S,A01,494387,Mignozzetti; Umberto,35,0,35,0
1715615707622,DSC 197,001,628532,Eldridge; Justin Matthew,9995,0,9999,4
1715615708650,EAP 100,A00,516065,Staff,9799,0,9999,200
1715615709674,ECE 45,A01,507414,Staff,31,0,60,29
1715615711723,ECE 111,A01,507420,Staff,11,0,50,39
1715615712749,ECE 197,001,548057,Sievenpiper; Daniel F.,9991,0,9999,8
1715615713779,EDS 115,A00,507243,Choi; Bailey Miyeon,7,0,28,21
1715615714804,EDS 117,A01,494379,Staff,0,6,34,34
1715615715829,EDS 125,A00,507246,Hopkins; Megan Beth,8,0,30,22
1715615716857,EDS 128A,A01,507264,Fargason; Sharon Gayle,6,0,26,20
1715615717885,EDS 128B,A01,507293,Pappas; Elizabeth,10,0,30,20
1715615718974,EDS 139,A00,507294,Fargason; Sharon Gayle,10,0,30,20
1715615718974,EDS 139,B00,507313,Pappas; Elizabeth,11,0,30,19
1715615720002,EDS 201,A00,507315,Staff,10,0,30,20
1715615721030,EDS 203,A01,507317,Halter; Christopher P.,10,0,30,20
1715615722061,EDS 204R,A01,507319,Halter; Christopher P.,0,3,30,30
1715615722061,EDS 204R,B01,507331,Heinzman; Erica M.,14,0,30,16
1715615723087,EDS 206R,A00,507332,Staff,0,4,30,30
1715615723087,EDS 206R,B00,507343,Staff,15,0,30,15
1715615724115,EDS 250,A00,507344,Hemans; Patricia Ann Benitez,20,0,40,20
1715615725140,EDS 281,A00,507345,Daly; Alan J.,18,0,18,0
1715615726165,EDS 284,A00,507350,Daly; Alan J.,16,0,16,0
1715615727190,EDS 286,A00,507359,Fine; Sarah,18,0,18,0
1715615728214,EDS 289C,A01,507361,Daly; Alan J.,18,0,18,0
1715615729243,EDS 290,A00,507366,Hofstetter; Carolyn,15,0,15,0
1715615730268,LIGM 5A,A00,507421,Fischer-Grunski; Eva K,17,0,20,3
1715615731295,LIGM 5B,A00,507423,Fischer-Grunski; Eva K,19,0,20,1
1715615732322,LIGM 5C,A00,507425,Fischer-Grunski; Eva K,19,0,20,1
1715615733351,LIIT 5AS,A00,507427,Carnelos; Chiara,20,0,20,0
1715615734380,LIIT 5BS,A00,507430,Carnelos; Chiara,20,0,20,0
1715615735407,LIIT 5CS,A00,507432,Carnelos; Chiara,20,0,20,0
1715615736434,LISP 5A,A00,507541,Munoz Sanchez; Alicia,11,0,20,9
1715615737461,LISP 5B,A00,507671,Munoz Sanchez; Alicia,9,0,20,11
1715615738487,LISP 5C,A00,507696,Munoz Sanchez; Alicia,9,0,20,11
1715615739511,MAE 197,001,528363,Boechler; Nicholas Sebastia,9998,0,9999,1
1715615740541,MATH 197,001,523477,Kedlaya; Kiran S.,9994,0,9999,5
1715615740541,MATH 197,002,563811,Zhang; Danna,9994,0,9999,5
1715615740541,MATH 197,003,628552,Dumitriu; Ioana,9998,0,9999,1
1715615740541,MATH 197,004,660885,Floyd; Eric,9999,0,9999,0
1715615741566,MCWP 40R,A00,518780,Staff,2,0,20,18
1715615741566,MCWP 40R,B00,518781,Staff,11,0,20,9
1715615741566,MCWP 40R,C00,518783,Staff,5,0,20,15
1715615742593,MCWP 50R,A00,518791,Staff,0,1,20,20
1715615742593,MCWP 50R,B00,518792,Staff,0,2,20,20
1715615742593,MCWP 50R,C00,518793,Staff,0,4,20,20
1715615742593,MCWP 50R,D00,518794,Staff,0,1,20,20
1715615742593,MCWP 50R,E00,518795,Staff,0,2,20,20
1715615742593,MCWP 50R,F00,518796,Staff,0,1,20,20
1715615742593,MCWP 50R,G00,518797,Staff,0,1,20,20
1715615743621,MMW 12R,A01,514034,Herbst; Matthew,0,2,16,16
1715615743621,MMW 12R,A02,514035,Herbst; Matthew,0,0,16,16
1715615744648,MMW 13R,A01,514037,Staff,0,5,16,16
1715615744648,MMW 13R,A02,514039,Staff,0,5,16,16
1715615744648,MMW 13R,A03,628519,Staff,0,4,16,16
1715615746703,SIO 295LS,A00,523233,Staff,10,0,30,20
1715615747729,SIO 295S,A00,523232,Staff,10,0,30,20
1715615748759,SIOC 290S,A01,637330,Merrifield; Mark A,23,0,30,7
1715615749784,SIOC 291S,A01,637333,Gabriel; Corey John,23,0,30,7
1715615750814,SOCI 117,A01,494376,Staff,0,5,5,5
1715615751840,WES 237B,A00,494380,Staff,10,0,20,10
1715615753909,AESE 279B,A00,494370,Wade; Jon P,0,0,33,33
1715615754938,AIP 97,001,660915,Van Den Einde; Yael Dahlia,9998,0,9999,1
1715615755965,AIP 197,001,627712,Vespa; Emanuel Ignacio,9995,0,9999,4
1715615755965,AIP 197,002,650778,Amir; On,9998,0,9999,1
1715615755965,AIP 197,003,650933,Avenancio-Leon; Carlos,9998,0,9999,1
1715615755965,AIP 197,004,658530,Heyman; Gail D.,9998,0,9999,1
1715615755965,AIP 197,005,658631,Neal; Sonya E,9998,0,9999,1
1715615755965,AIP 197,006,658671,Du; Songzi,9998,0,9999,1
1715615756990,ANAR 135S,A00,494369,Braswell; Geoffrey E.,0,0,0,0
1715615758019,BENG 196,001,628496,Engler; Adam J.,9998,0,9999,1
1715615758019,BENG 196,002,660916,Watson; John Thomas,9999,0,9999,0
1715615759046,BISP 197,001,650773,Wilhelm; James E.,9994,0,9999,5
1715615759046,BISP 197,002,658904,Coleman; Aaron B.,9998,0,9999,1
1715615760076,CAT 124RS,A01,519847,Geibel; William,0,0,20,20
1715615761102,CAT 125RS,A01,515971,Geibel; William,0,0,20,20
1715615762127,CLRE 250,A00,511389,Morris; Sheldon,9992,0,9999,7
1715615763155,CLRE 251,A00,507176,Mehta; Ravindra L.,9992,0,9999,7
1715615763155,CLRE 251,B00,511410,Mehta; Ravindra L.,9998,0,9999,1
1715615764180,CLRE 252,A00,507189,Cuomo; Raphael Eduardo,9994,0,9999,5
1715615765209,CLRE 253,A00,507199,Vaida; Florin,9994,0,9999,5
1715615765209,CLRE 253,B00,507202,Vaida; Florin,9999,0,9999,0
1715615766239,CLRE 259,A00,507211,Patel; Hemal,9996,0,9999,3
1715615767267,CLRE 260,A00,507221,Cuomo; Raphael Eduardo,9999,0,9999,0
1715615768293,CLRE 297,001,507242,Cuomo; Raphael Eduardo,9999,0,9999,0
1715615769322,COGS 197,001,638244,Voytek; Bradley Thomas,9997,0,9999,2
1715615770348,CSE 191,A00,516875,Minnes Kemp; Mor Mia,9991,0,9999,8
1715615771374,CSE 197,001,637388,Minnes Kemp; Mor Mia,9992,0,9999,7
1715615772405,CSS 201S,A01,494383,Mignozzetti; Umberto,35,0,35,0
1715615773431,CSS 202S,A01,494387,Mignozzetti; Umberto,35,0,35,0
1715615774456,DSC 197,001,628532,Eldridge; Justin Matthew,9995,0,9999,4
1715615775482,EAP 100,A00,516065,Staff,9799,0,9999,200
1715615776513,ECE 45,A01,507414,Staff,31,0,60,29
1715615778568,ECE 111,A01,507420,Staff,11,0,50,39
1715615779592,ECE 197,001,548057,Sievenpiper; Daniel F.,9991,0,9999,8
1715615780619,EDS 115,A00,507243,Choi; Bailey Miyeon,7,0,28,21
1715615781646,EDS 117,A01,494379,Staff,0,6,34,34
1715615782671,EDS 125,A00,507246,Hopkins; Megan Beth,8,0,30,22
1715615783697,EDS 128A,A01,507264,Fargason; Sharon Gayle,6,0,26,20
1715615784723,EDS 128B,A01,507293,Pappas; Elizabeth,10,0,30,20
1715615785747,EDS 139,A00,507294,Fargason; Sharon Gayle,10,0,30,20
1715615785747,EDS 139,B00,507313,Pappas; Elizabeth,11,0,30,19
1715615786775,EDS 201,A00,507315,Staff,10,0,30,20
1715615787801,EDS 203,A01,507317,Halter; Christopher P.,10,0,30,20
1715615788831,EDS 204R,A01,507319,Halter; Christopher P.,0,3,30,30
1715615788831,EDS 204R,B01,507331,Heinzman; Erica M.,14,0,30,16
1715615789857,EDS 206R,A00,507332,Staff,0,4,30,30
1715615789857,EDS 206R,B00,507343,Staff,15,0,30,15
1715615790882,EDS 250,A00,507344,Hemans; Patricia Ann Benitez,20,0,40,20
1715615791908,EDS 281,A00,507345,Daly; Alan J.,18,0,18,0
1715615792934,EDS 284,A00,507350,Daly; Alan J.,16,0,16,0
1715615793960,EDS 286,A00,507359,Fine; Sarah,18,0,18,0
1715615794984,EDS 289C,A01,507361,Daly; Alan J.,18,0,18,0
1715615796011,EDS 290,A00,507366,Hofstetter; Carolyn,15,0,15,0
1715615797036,LIGM 5A,A00,507421,Fischer-Grunski; Eva K,17,0,20,3
1715615798065,LIGM 5B,A00,507423,Fischer-Grunski; Eva K,19,0,20,1
1715615799090,LIGM 5C,A00,507425,Fischer-Grunski; Eva K,19,0,20,1
1715615800116,LIIT 5AS,A00,507427,Carnelos; Chiara,20,0,20,0
1715615801144,LIIT 5BS,A00,507430,Carnelos; Chiara,20,0,20,0
1715615802173,LIIT 5CS,A00,507432,Carnelos; Chiara,20,0,20,0
1715615803199,LISP 5A,A00,507541,Munoz Sanchez; Alicia,11,0,20,9
1715615804229,LISP 5B,A00,507671,Munoz Sanchez; Alicia,9,0,20,11
1715615805253,LISP 5C,A00,507696,Munoz Sanchez; Alicia,9,0,20,11
1715615806280,MAE 197,001,528363,Boechler; Nicholas Sebastia,9998,0,9999,1
1715615807305,MATH 197,001,523477,Kedlaya; Kiran S.,9994,0,9999,5
1715615807305,MATH 197,002,563811,Zhang; Danna,9994,0,9999,5
1715615807305,MATH 197,003,628552,Dumitriu; Ioana,9998,0,9999,1
1715615807305,MATH 197,004,660885,Floyd; Eric,9999,0,9999,0
1715615808333,MCWP 40R,A00,518780,Staff,2,0,20,18
1715615808333,MCWP 40R,B00,518781,Staff,11,0,20,9
1715615808333,MCWP 40R,C00,518783,Staff,5,0,20,15
1715615809364,MCWP 50R,A00,518791,Staff,0,1,20,20
1715615809364,MCWP 50R,B00,518792,Staff,0,2,20,20
1715615809364,MCWP 50R,C00,518793,Staff,0,4,20,20
1715615809364,MCWP 50R,D00,518794,Staff,0,1,20,20
1715615809364,MCWP 50R,E00,518795,Staff,0,2,20,20
1715615809364,MCWP 50R,F00,518796,Staff,0,1,20,20
1715615809364,MCWP 50R,G00,518797,Staff,0,1,20,20
1715615810392,MMW 12R,A01,514034,Herbst; Matthew,0,2,16,16
1715615810392,MMW 12R,A02,514035,Herbst; Matthew,0,0,16,16
1715615811420,MMW 13R,A01,514037,Staff,0,5,16,16
1715615811420,MMW 13R,A02,514039,Staff,0,5,16,16
1715615811420,MMW 13R,A03,628519,Staff,0,4,16,16
1715615813475,SIO 295LS,A00,523233,Staff,10,0,30,20
1715615814500,SIO 295S,A00,523232,Staff,10,0,30,20
1715615815529,SIOC 290S,A01,637330,Merrifield; Mark A,23,0,30,7
1715615816558,SIOC 291S,A01,637333,Gabriel; Corey John,23,0,30,7
1715615817586,SOCI 117,A01,494376,Staff,0,5,5,5
1715615818613,WES 237B,A00,494380,Staff,10,0,20,10
1715615820694,AESE 279B,A00,494370,Wade; Jon P,0,0,33,33
1715615821719,AIP 97,001,660915,Van Den Einde; Yael Dahlia,9998,0,9999,1
1715615822743,AIP 197,001,627712,Vespa; Emanuel Ignacio,9995,0,9999,4
1715615822743,AIP 197,002,650778,Amir; On,9998,0,9999,1
1715615822743,AIP 197,003,650933,Avenancio-Leon; Carlos,9998,0,9999,1
1715615822743,AIP 197,004,658530,Heyman; Gail D.,9998,0,9999,1
1715615822743,AIP 197,005,658631,Neal; Sonya E,9998,0,9999,1
1715615822743,AIP 197,006,658671,Du; Songzi,9998,0,9999,1
1715615823772,ANAR 135S,A00,494369,Braswell; Geoffrey E.,0,0,0,0
1715615824799,BENG 196,001,628496,Engler; Adam J.,9998,0,9999,1
1715615824799,BENG 196,002,660916,Watson; John Thomas,9999,0,9999,0
1715615825879,BISP 197,001,650773,Wilhelm; James E.,9994,0,9999,5
1715615825879,BISP 197,002,658904,Coleman; Aaron B.,9998,0,9999,1
1715615826906,CAT 124RS,A01,519847,Geibel; William,0,0,20,20
1715615827933,CAT 125RS,A01,515971,Geibel; William,0,0,20,20
1715615828959,CLRE 250,A00,511389,Morris; Sheldon,9992,0,9999,7
1715615829986,CLRE 251,A00,507176,Mehta; Ravindra L.,9992,0,9999,7
1715615829986,CLRE 251,B00,511410,Mehta; Ravindra L.,9998,0,9999,1
1715615831014,CLRE 252,A00,507189,Cuomo; Raphael Eduardo,9994,0,9999,5
1715615832039,CLRE 253,A00,507199,Vaida; Florin,9994,0,9999,5
1715615832039,CLRE 253,B00,507202,Vaida; Florin,9999,0,9999,0
1715615833067,CLRE 259,A00,507211,Patel; Hemal,9996,0,9999,3
1715615834098,CLRE 260,A00,507221,Cuomo; Raphael Eduardo,9999,0,9999,0
1715615835122,CLRE 297,001,507242,Cuomo; Raphael Eduardo,9999,0,9999,0
1715615836151,COGS 197,001,638244,Voytek; Bradley Thomas,9997,0,9999,2
1715615837179,CSE 191,A00,516875,Minnes Kemp; Mor Mia,9991,0,9999,8
1715615838207,CSE 197,001,637388,Minnes Kemp; Mor Mia,9992,0,9999,7
1715615839235,CSS 201S,A01,494383,Mignozzetti; Umberto,35,0,35,0
1715615840261,CSS 202S,A01,494387,Mignozzetti; Umberto,35,0,35,0
1715615841288,DSC 197,001,628532,Eldridge; Justin Matthew,9995,0,9999,4
1715615842314,EAP 100,A00,516065,Staff,9799,0,9999,200
1715615843344,ECE 45,A01,507414,Staff,31,0,60,29
1715615845395,ECE 111,A01,507420,Staff,11,0,50,39
1715615846421,ECE 197,001,548057,Sievenpiper; Daniel F.,9991,0,9999,8
1715615847446,EDS 115,A00,507243,Choi; Bailey Miyeon,7,0,28,21
1715615848471,EDS 117,A01,494379,Staff,0,6,34,34
1715615849497,EDS 125,A00,507246,Hopkins; Megan Beth,8,0,30,22
1715615850521,EDS 128A,A01,507264,Fargason; Sharon Gayle,6,0,26,20
1715615851546,EDS 128B,A01,507293,Pappas; Elizabeth,10,0,30,20
1715615852571,EDS 139,A00,507294,Fargason; Sharon Gayle,10,0,30,20
1715615852571,EDS 139,B00,507313,Pappas; Elizabeth,11,0,30,19
1715615853597,EDS 201,A00,507315,Staff,10,0,30,20
1715615854625,EDS 203,A01,507317,Halter; Christopher P.,10,0,30,20
1715615855653,EDS 204R,A01,507319,Halter; Christopher P.,0,3,30,30
1715615855653,EDS 204R,B01,507331,Heinzman; Erica M.,14,0,30,16
1715615856678,EDS 206R,A00,507332,Staff,0,4,30,30
1715615856678,EDS 206R,B00,507343,Staff,15,0,30,15
1715615857706,EDS 250,A00,507344,Hemans; Patricia Ann Benitez,20,0,40,20
1715615858733,EDS 281,A00,507345,Daly; Alan J.,18,0,18,0
1715615859761,EDS 284,A00,507350,Daly; Alan J.,16,0,16,0
1715615860787,EDS 286,A00,507359,Fine; Sarah,18,0,18,0
1715615861814,EDS 289C,A01,507361,Daly; Alan J.,18,0,18,0
1715615862839,EDS 290,A00,507366,Hofstetter; Carolyn,15,0,15,0
1715615863868,LIGM 5A,A00,507421,Fischer-Grunski; Eva K,17,0,20,3
1715615864896,LIGM 5B,A00,507423,Fischer-Grunski; Eva K,19,0,20,1
1715615865922,LIGM 5C,A00,507425,Fischer-Grunski; Eva K,19,0,20,1
1715615866953,LIIT 5AS,A00,507427,Carnelos; Chiara,20,0,20,0
1715615867982,LIIT 5BS,A00,507430,Carnelos; Chiara,20,0,20,0
1715615869009,LIIT 5CS,A00,507432,Carnelos; Chiara,20,0,20,0
1715615870033,LISP 5A,A00,507541,Munoz Sanchez; Alicia,11,0,20,9
1715615871059,LISP 5B,A00,507671,Munoz Sanchez; Alicia,9,0,20,11
1715615872085,LISP 5C,A00,507696,Munoz Sanchez; Alicia,9,0,20,11
1715615873111,MAE 197,001,528363,Boechler; Nicholas Sebastia,9998,0,9999,1
1715615874139,MATH 197,001,523477,Kedlaya; Kiran S.,9994,0,9999,5
1715615874139,MATH 197,002,563811,Zhang; Danna,9994,0,9999,5
1715615874139,MATH 197,003,628552,Dumitriu; Ioana,9998,0,9999,1
1715615874139,MATH 197,004,660885,Floyd; Eric,9999,0,9999,0
1715615875167,MCWP 40R,A00,518780,Staff,2,0,20,18
1715615875167,MCWP 40R,B00,518781,Staff,11,0,20,9
1715615875167,MCWP 40R,C00,518783,Staff,5,0,20,15
1715615876197,MCWP 50R,A00,518791,Staff,0,1,20,20
1715615876197,MCWP 50R,B00,518792,Staff,0,2,20,20
1715615876197,MCWP 50R,C00,518793,Staff,0,4,20,20
1715615876197,MCWP 50R,D00,518794,Staff,0,1,20,20
1715615876197,MCWP 50R,E00,518795,Staff,0,2,20,20
1715615876197,MCWP 50R,F00,518796,Staff,0,1,20,20
1715615876197,MCWP 50R,G00,518797,Staff,0,1,20,20
1715615877222,MMW 12R,A01,514034,Herbst; Matthew,0,2,16,16
1715615877222,MMW 12R,A02,514035,Herbst; Matthew,0,0,16,16
1715615878247,MMW 13R,A01,514037,Staff,0,5,16,16
1715615878247,MMW 13R,A02,514039,Staff,0,5,16,16
1715615878247,MMW 13R,A03,628519,Staff,0,4,16,16
1715615880305,SIO 295LS,A00,523233,Staff,10,0,30,20
1715615881333,SIO 295S,A00,523232,Staff,10,0,30,20
1715615882364,SIOC 290S,A01,637330,Merrifield; Mark A,23,0,30,7
1715615883392,SIOC 291S,A01,637333,Gabriel; Corey John,23,0,30,7
1715615884421,SOCI 117,A01,494376,Staff,0,5,5,5
1715615885450,WES 237B,A00,494380,Staff,10,0,20,10
1715615887508,AESE 279B,A00,494370,Wade; Jon P,0,0,33,33
1715615888533,AIP 97,001,660915,Van Den Einde; Yael Dahlia,9998,0,9999,1
1715615889561,AIP 197,001,627712,Vespa; Emanuel Ignacio,9995,0,9999,4
1715615889561,AIP 197,002,650778,Amir; On,9998,0,9999,1
1715615889561,AIP 197,003,650933,Avenancio-Leon; Carlos,9998,0,9999,1
1715615889561,AIP 197,004,658530,Heyman; Gail D.,9998,0,9999,1
1715615889561,AIP 197,005,658631,Neal; Sonya E,9998,0,9999,1
1715615889561,AIP 197,006,658671,Du; Songzi,9998,0,9999,1
1715615890589,ANAR 135S,A00,494369,Braswell; Geoffrey E.,0,0,0,0
1715615891615,BENG 196,001,628496,Engler; Adam J.,9998,0,9999,1
1715615891615,BENG 196,002,660916,Watson; John Thomas,9999,0,9999,0
1715615892641,BISP 197,001,650773,Wilhelm; James E.,9994,0,9999,5
1715615892641,BISP 197,002,658904,Coleman; Aaron B.,9998,0,9999,1
1715615893666,CAT 124RS,A01,519847,Geibel; William,0,0,20,20
1715615894693,CAT 125RS,A01,515971,Geibel; William,0,0,20,20
1715615895717,CLRE 250,A00,511389,Morris; Sheldon,9992,0,9999,7
1715615896744,CLRE 251,A00,507176,Mehta; Ravindra L.,9992,0,9999,7
1715615896744,CLRE 251,B00,511410,Mehta; Ravindra L.,9998,0,9999,1
1715615897772,CLRE 252,A00,507189,Cuomo; Raphael Eduardo,9994,0,9999,5
1715615898799,CLRE 253,A00,507199,Vaida; Florin,9994,0,9999,5
1715615898799,CLRE 253,B00,507202,Vaida; Florin,9999,0,9999,0
1715615899826,CLRE 259,A00,507211,Patel; Hemal,9996,0,9999,3
1715615900851,CLRE 260,A00,507221,Cuomo; Raphael Eduardo,9999,0,9999,0
1715615901875,CLRE 297,001,507242,Cuomo; Raphael Eduardo,9999,0,9999,0
1715615902903,COGS 197,001,638244,Voytek; Bradley Thomas,9997,0,9999,2
1715615903928,CSE 191,A00,516875,Minnes Kemp; Mor Mia,9991,0,9999,8
1715615904955,CSE 197,001,637388,Minnes Kemp; Mor Mia,9992,0,9999,7
1715615905981,CSS 201S,A01,494383,Mignozzetti; Umberto,35,0,35,0
1715615907007,CSS 202S,A01,494387,Mignozzetti; Umberto,35,0,35,0
1715615908032,DSC 197,001,628532,Eldridge; Justin Matthew,9995,0,9999,4
1715615909057,EAP 100,A00,516065,Staff,9799,0,9999,200
1715615910084,ECE 45,A01,507414,Staff,31,0,60,29
1715615912135,ECE 111,A01,507420,Staff,11,0,50,39
1715615913163,ECE 197,001,548057,Sievenpiper; Daniel F.,9991,0,9999,8
1715615914187,EDS 115,A00,507243,Choi; Bailey Miyeon,7,0,28,21
1715615915212,EDS 117,A01,494379,Staff,0,6,34,34
1715615916240,EDS 125,A00,507246,Hopkins; Megan Beth,8,0,30,22
1715615917268,EDS 128A,A01,507264,Fargason; Sharon Gayle,6,0,26,20
1715615918297,EDS 128B,A01,507293,Pappas; Elizabeth,10,0,30,20
1715615919324,EDS 139,A00,507294,Fargason; Sharon Gayle,10,0,30,20
1715615919324,EDS 139,B00,507313,Pappas; Elizabeth,11,0,30,19
1715615920351,EDS 201,A00,507315,Staff,10,0,30,20
1715615921377,EDS 203,A01,507317,Halter; Christopher P.,10,0,30,20
1715615922406,EDS 204R,A01,507319,Halter; Christopher P.,0,3,30,30
1715615922406,EDS 204R,B01,507331,Heinzman; Erica M.,14,0,30,16
1715615923433,EDS 206R,A00,507332,Staff,0,4,30,30
1715615923433,EDS 206R,B00,507343,Staff,15,0,30,15
1715615924462,EDS 250,A00,507344,Hemans; Patricia Ann Benitez,20,0,40,20
1715615925486,EDS 281,A00,507345,Daly; Alan J.,18,0,18,0
1715615926513,EDS 284,A00,507350,Daly; Alan J.,16,0,16,0
1715615927536,EDS 286,A00,507359,Fine; Sarah,18,0,18,0
1715615928561,EDS 289C,A01,507361,Daly; Alan J.,18,0,18,0
1715615929645,EDS 290,A00,507366,Hofstetter; Carolyn,15,0,15,0
1715615930670,LIGM 5A,A00,507421,Fischer-Grunski; Eva K,17,0,20,3
1715615931700,LIGM 5B,A00,507423,Fischer-Grunski; Eva K,19,0,20,1
1715615932730,LIGM 5C,A00,507425,Fischer-Grunski; Eva K,19,0,20,1
1715615933760,LIIT 5AS,A00,507427,Carnelos; Chiara,20,0,20,0
1715615934786,LIIT 5BS,A00,507430,Carnelos; Chiara,20,0,20,0
1715615935814,LIIT 5CS,A00,507432,Carnelos; Chiara,20,0,20,0
1715615936843,LISP 5A,A00,507541,Munoz Sanchez; Alicia,11,0,20,9
1715615937869,LISP 5B,A00,507671,Munoz Sanchez; Alicia,9,0,20,11
1715615938897,LISP 5C,A00,507696,Munoz Sanchez; Alicia,9,0,20,11
1715615939922,MAE 197,001,528363,Boechler; Nicholas Sebastia,9998,0,9999,1
1715615940949,MATH 197,001,523477,Kedlaya; Kiran S.,9994,0,9999,5
1715615940949,MATH 197,002,563811,Zhang; Danna,9994,0,9999,5
1715615940949,MATH 197,003,628552,Dumitriu; Ioana,9998,0,9999,1
1715615940949,MATH 197,004,660885,Floyd; Eric,9999,0,9999,0
1715615941979,MCWP 40R,A00,518780,Staff,2,0,20,18
1715615941979,MCWP 40R,B00,518781,Staff,11,0,20,9
1715615941979,MCWP 40R,C00,518783,Staff,5,0,20,15
1715615943015,MCWP 50R,A00,518791,Staff,0,1,20,20
1715615943015,MCWP 50R,B00,518792,Staff,0,2,20,20
1715615943015,MCWP 50R,C00,518793,Staff,0,4,20,20
1715615943015,MCWP 50R,D00,518794,Staff,0,1,20,20
1715615943015,MCWP 50R,E00,518795,Staff,0,2,20,20
1715615943015,MCWP 50R,F00,518796,Staff,0,1,20,20
1715615943015,MCWP 50R,G00,518797,Staff,0,1,20,20
1715615944042,MMW 12R,A01,514034,Herbst; Matthew,0,2,16,16
1715615944042,MMW 12R,A02,514035,Herbst; Matthew,0,0,16,16
1715615945070,MMW 13R,A01,514037,Staff,0,5,16,16
1715615945070,MMW 13R,A02,514039,Staff,0,5,16,16
1715615945070,MMW 13R,A03,628519,Staff,0,4,16,16
1715615947124,SIO 295LS,A00,523233,Staff,10,0,30,20
1715615948150,SIO 295S,A00,523232,Staff,10,0,30,20
1715615949177,SIOC 290S,A01,637330,Merrifield; Mark A,23,0,30,7
1715615950205,SIOC 291S,A01,637333,Gabriel; Corey John,23,0,30,7
1715615951233,SOCI 117,A01,494376,Staff,0,5,5,5
1715615952262,WES 237B,A00,494380,Staff,10,0,20,10
1715615954330,AESE 279B,A00,494370,Wade; Jon P,0,0,33,33
1715615955356,AIP 97,001,660915,Van Den Einde; Yael Dahlia,9998,0,9999,1
1715615956383,AIP 197,001,627712,Vespa; Emanuel Ignacio,9995,0,9999,4
1715615956383,AIP 197,002,650778,Amir; On,9998,0,9999,1
1715615956383,AIP 197,003,650933,Avenancio-Leon; Carlos,9998,0,9999,1
1715615956383,AIP 197,004,658530,Heyman; Gail D.,9998,0,9999,1
1715615956383,AIP 197,005,658631,Neal; Sonya E,9998,0,9999,1
1715615956383,AIP 197,006,658671,Du; Songzi,9998,0,9999,1
1715615957411,ANAR 135S,A00,494369,Braswell; Geoffrey E.,0,0,0,0
1715615958436,BENG 196,001,628496,Engler; Adam J.,9998,0,9999,1
1715615958436,BENG 196,002,660916,Watson; John Thomas,9999,0,9999,0
1715615959461,BISP 197,001,650773,Wilhelm; James E.,9994,0,9999,5
1715615959461,BISP 197,002,658904,Coleman; Aaron B.,9998,0,9999,1
1715615960490,CAT 124RS,A01,519847,Geibel; William,0,0,20,20
1715615961518,CAT 125RS,A01,515971,Geibel; William,0,0,20,20
1715615962544,CLRE 250,A00,511389,Morris; Sheldon,9992,0,9999,7
1715615963569,CLRE 251,A00,507176,Mehta; Ravindra L.,9992,0,9999,7
1715615963569,CLRE 251,B00,511410,Mehta; Ravindra L.,9998,0,9999,1
1715615964598,CLRE 252,A00,507189,Cuomo; Raphael Eduardo,9994,0,9999,5
1715615965624,CLRE 253,A00,507199,Vaida; Florin,9994,0,9999,5
1715615965624,CLRE 253,B00,507202,Vaida; Florin,9999,0,9999,0
1715615966653,CLRE 259,A00,507211,Patel; Hemal,9996,0,9999,3
1715615967679,CLRE 260,A00,507221,Cuomo; Raphael Eduardo,9999,0,9999,0
1715615968703,CLRE 297,001,507242,Cuomo; Raphael Eduardo,9999,0,9999,0
1715615969728,COGS 197,001,638244,Voytek; Bradley Thomas,9997,0,9999,2
1715615970753,CSE 191,A00,516875,Minnes Kemp; Mor Mia,9991,0,9999,8
1715615971777,CSE 197,001,637388,Minnes Kemp; Mor Mia,9992,0,9999,7
1715615972802,CSS 201S,A01,494383,Mignozzetti; Umberto,35,0,35,0
1715615973830,CSS 202S,A01,494387,Mignozzetti; Umberto,35,0,35,0
1715615974853,DSC 197,001,628532,Eldridge; Justin Matthew,9995,0,9999,4
1715615975881,EAP 100,A00,516065,Staff,9799,0,9999,200
1715615976909,ECE 45,A01,507414,Staff,31,0,60,29
1715615978960,ECE 111,A01,507420,Staff,11,0,50,39
1715615979986,ECE 197,001,548057,Sievenpiper; Daniel F.,9991,0,9999,8
1715615981011,EDS 115,A00,507243,Choi; Bailey Miyeon,7,0,28,21
1715615982038,EDS 117,A01,494379,Staff,0,6,34,34
1715615983062,EDS 125,A00,507246,Hopkins; Megan Beth,8,0,30,22
1715615984087,EDS 128A,A01,507264,Fargason; Sharon Gayle,6,0,26,20
1715615985115,EDS 128B,A01,507293,Pappas; Elizabeth,10,0,30,20
1715615986144,EDS 139,A00,507294,Fargason; Sharon Gayle,10,0,30,20
1715615986144,EDS 139,B00,507313,Pappas; Elizabeth,11,0,30,19
1715615987171,EDS 201,A00,507315,Staff,10,0,30,20
1715615988199,EDS 203,A01,507317,Halter; Christopher P.,10,0,30,20
1715615989224,EDS 204R,A01,507319,Halter; Christopher P.,0,3,30,30
1715615989224,EDS 204R,B01,507331,Heinzman; Erica M.,14,0,30,16
1715615990250,EDS 206R,A00,507332,Staff,0,4,30,30
1715615990250,EDS 206R,B00,507343,Staff,15,0,30,15
1715615991276,EDS 250,A00,507344,Hemans; Patricia Ann Benitez,20,0,40,20
1715615992301,EDS 281,A00,507345,Daly; Alan J.,18,0,18,0
1715615993328,EDS 284,A00,507350,Daly; Alan J.,16,0,16,0
1715615994354,EDS 286,A00,507359,Fine; Sarah,18,0,18,0
1715615995381,EDS 289C,A01,507361,Daly; Alan J.,18,0,18,0
1715615996405,EDS 290,A00,507366,Hofstetter; Carolyn,15,0,15,0
1715615997428,LIGM 5A,A00,507421,Fischer-Grunski; Eva K,17,0,20,3
1715615998458,LIGM 5B,A00,507423,Fischer-Grunski; Eva K,19,0,20,1
1715615999485,LIGM 5C,A00,507425,Fischer-Grunski; Eva K,19,0,20,1
1715616000517,LIIT 5AS,A00,507427,Carnelos; Chiara,20,0,20,0
1715616001545,LIIT 5BS,A00,507430,Carnelos; Chiara,20,0,20,0
1715616002573,LIIT 5CS,A00,507432,Carnelos; Chiara,20,0,20,0
1715616003599,LISP 5A,A00,507541,Munoz Sanchez; Alicia,11,0,20,9
1715616004625,LISP 5B,A00,507671,Munoz Sanchez; Alicia,9,0,20,11
1715616005650,LISP 5C,A00,507696,Munoz Sanchez; Alicia,9,0,20,11
1715616006674,MAE 197,001,528363,Boechler; Nicholas Sebastia,9998,0,9999,1
1715616007715,MATH 197,001,523477,Kedlaya; Kiran S.,9994,0,9999,5
1715616007715,MATH 197,002,563811,Zhang; Danna,9994,0,9999,5
1715616007715,MATH 197,003,628552,Dumitriu; Ioana,9998,0,9999,1
1715616007715,MATH 197,004,660885,Floyd; Eric,9999,0,9999,0
1715616008743,MCWP 40R,A00,518780,Staff,2,0,20,18
1715616008743,MCWP 40R,B00,518781,Staff,11,0,20,9
1715616008743,MCWP 40R,C00,518783,Staff,5,0,20,15
1715616009770,MCWP 50R,A00,518791,Staff,0,1,20,20
1715616009770,MCWP 50R,B00,518792,Staff,0,2,20,20
1715616009770,MCWP 50R,C00,518793,Staff,0,4,20,20
1715616009770,MCWP 50R,D00,518794,Staff,0,1,20,20
1715616009770,MCWP 50R,E00,518795,Staff,0,2,20,20
1715616009770,MCWP 50R,F00,518796,Staff,0,1,20,20
1715616009770,MCWP 50R,G00,518797,Staff,0,1,20,20
1715616010793,MMW 12R,A01,514034,Herbst; Matthew,0,2,16,16
1715616010793,MMW 12R,A02,514035,Herbst; Matthew,0,0,16,16
1715616011819,MMW 13R,A01,514037,Staff,0,5,16,16
1715616011819,MMW 13R,A02,514039,Staff,0,5,16,16
1715616011819,MMW 13R,A03,628519,Staff,0,4,16,16
1715616013886,SIO 295LS,A00,523233,Staff,10,0,30,20
1715616014910,SIO 295S,A00,523232,Staff,10,0,30,20
1715616015942,SIOC 290S,A01,637330,Merrifield; Mark A,23,0,30,7
1715616016966,SIOC 291S,A01,637333,Gabriel; Corey John,23,0,30,7
1715616017992,SOCI 117,A01,494376,Staff,0,5,5,5
1715616019016,WES 237B,A00,494380,Staff,10,0,20,10
1715616021085,AESE 279B,A00,494370,Wade; Jon P,0,0,33,33
1715616022108,AIP 97,001,660915,Van Den Einde; Yael Dahlia,9998,0,9999,1
1715616023138,AIP 197,001,627712,Vespa; Emanuel Ignacio,9995,0,9999,4
1715616023138,AIP 197,002,650778,Amir; On,9998,0,9999,1
1715616023138,AIP 197,003,650933,Avenancio-Leon; Carlos,9998,0,9999,1
1715616023138,AIP 197,004,658530,Heyman; Gail D.,9998,0,9999,1
1715616023138,AIP 197,005,658631,Neal; Sonya E,9998,0,9999,1
1715616023138,AIP 197,006,658671,Du; Songzi,9998,0,9999,1
1715616024164,ANAR 135S,A00,494369,Braswell; Geoffrey E.,0,0,0,0
1715616025193,BENG 196,001,628496,Engler; Adam J.,9998,0,9999,1
1715616025193,BENG 196,002,660916,Watson; John Thomas,9999,0,9999,0
1715616026220,BISP 197,001,650773,Wilhelm; James E.,9994,0,9999,5
1715616026220,BISP 197,002,658904,Coleman; Aaron B.,9998,0,9999,1
1715616027247,CAT 124RS,A01,519847,Geibel; William,0,0,20,20
1715616028276,CAT 125RS,A01,515971,Geibel; William,0,0,20,20
1715616029304,CLRE 250,A00,511389,Morris; Sheldon,9992,0,9999,7
1715616030331,CLRE 251,A00,507176,Mehta; Ravindra L.,9992,0,9999,7
1715616030331,CLRE 251,B00,511410,Mehta; Ravindra L.,9998,0,9999,1
1715616031357,CLRE 252,A00,507189,Cuomo; Raphael Eduardo,9994,0,9999,5
1715616032382,CLRE 253,A00,507199,Vaida; Florin,9994,0,9999,5
1715616032382,CLRE 253,B00,507202,Vaida; Florin,9999,0,9999,0
1715616033463,CLRE 259,A00,507211,Patel; Hemal,9996,0,9999,3
1715616034491,CLRE 260,A00,507221,Cuomo; Raphael Eduardo,9999,0,9999,0
1715616035516,CLRE 297,001,507242,Cuomo; Raphael Eduardo,9999,0,9999,0
1715616036542,COGS 197,001,638244,Voytek; Bradley Thomas,9997,0,9999,2
1715616037569,CSE 191,A00,516875,Minnes Kemp; Mor Mia,9991,0,9999,8
1715616038594,CSE 197,001,637388,Minnes Kemp; Mor Mia,9992,0,9999,7
1715616039625,CSS 201S,A01,494383,Mignozzetti; Umberto,35,0,35,0
1715616040654,CSS 202S,A01,494387,Mignozzetti; Umberto,35,0,35,0
1715616041679,DSC 197,001,628532,Eldridge; Justin Matthew,9995,0,9999,4
1715616042704,EAP 100,A00,516065,Staff,9799,0,9999,200
1715616043730,ECE 45,A01,507414,Staff,31,0,60,29
1715616045787,ECE 111,A01,507420,Staff,11,0,50,39
1715616046812,ECE 197,001,548057,Sievenpiper; Daniel F.,9991,0,9999,8
1715616047836,EDS 115,A00,507243,Choi; Bailey Miyeon,7,0,28,21
1715616048862,EDS 117,A01,494379,Staff,0,6,34,34
1715616049886,EDS 125,A00,507246,Hopkins; Megan Beth,8,0,30,22
1715616050911,EDS 128A,A01,507264,Fargason; Sharon Gayle,6,0,26,20
1715616051938,EDS 128B,A01,507293,Pappas; Elizabeth,10,0,30,20
1715616052962,EDS 139,A00,507294,Fargason; Sharon Gayle,10,0,30,20
1715616052962,EDS 139,B00,507313,Pappas; Elizabeth,11,0,30,19
1715616053989,EDS 201,A00,507315,Staff,10,0,30,20
1715616055014,EDS 203,A01,507317,Halter; Christopher P.,10,0,30,20
1715616056041,EDS 204R,A01,507319,Halter; Christopher P.,0,3,30,30
1715616056041,EDS 204R,B01,507331,Heinzman; Erica M.,14,0,30,16
1715616057066,EDS 206R,A00,507332,Staff,0,4,30,30
1715616057066,EDS 206R,B00,507343,Staff,15,0,30,15
1715616058094,EDS 250,A00,507344,Hemans; Patricia Ann Benitez,20,0,40,20
1715616059121,EDS 281,A00,507345,Daly; Alan J.,18,0,18,0
1715616060149,EDS 284,A00,507350,Daly; Alan J.,16,0,16,0
1715616061176,EDS 286,A00,507359,Fine; Sarah,18,0,18,0
1715616062201,EDS 289C,A01,507361,Daly; Alan J.,18,0,18,0
1715616063228,EDS 290,A00,507366,Hofstetter; Carolyn,15,0,15,0
1715616064254,LIGM 5A,A00,507421,Fischer-Grunski; Eva K,17,0,20,3
1715616065278,LIGM 5B,A00,507423,Fischer-Grunski; Eva K,19,0,20,1
1715616066304,LIGM 5C,A00,507425,Fischer-Grunski; Eva K,19,0,20,1
1715616067333,LIIT 5AS,A00,507427,Carnelos; Chiara,20,0,20,0
1715616068363,LIIT 5BS,A00,507430,Carnelos; Chiara,20,0,20,0
1715616069393,LIIT 5CS,A00,507432,Carnelos; Chiara,20,0,20,0
1715616070421,LISP 5A,A00,507541,Munoz Sanchez; Alicia,11,0,20,9
1715616071447,LISP 5B,A00,507671,Munoz Sanchez; Alicia,9,0,20,11
1715616072473,LISP 5C,A00,507696,Munoz Sanchez; Alicia,9,0,20,11
1715616073498,MAE 197,001,528363,Boechler; Nicholas Sebastia,9998,0,9999,1
1715616074523,MATH 197,001,523477,Kedlaya; Kiran S.,9994,0,9999,5
1715616074523,MATH 197,002,563811,Zhang; Danna,9994,0,9999,5
1715616074523,MATH 197,003,628552,Dumitriu; Ioana,9998,0,9999,1
1715616074523,MATH 197,004,660885,Floyd; Eric,9999,0,9999,0
1715616075552,MCWP 40R,A00,518780,Staff,2,0,20,18
1715616075552,MCWP 40R,B00,518781,Staff,11,0,20,9
1715616075552,MCWP 40R,C00,518783,Staff,5,0,20,15
1715616076578,MCWP 50R,A00,518791,Staff,0,1,20,20
1715616076578,MCWP 50R,B00,518792,Staff,0,2,20,20
1715616076578,MCWP 50R,C00,518793,Staff,0,4,20,20
1715616076578,MCWP 50R,D00,518794,Staff,0,1,20,20
1715616076578,MCWP 50R,E00,518795,Staff,0,2,20,20
1715616076578,MCWP 50R,F00,518796,Staff,0,1,20,20
1715616076578,MCWP 50R,G00,518797,Staff,0,1,20,20
1715616077605,MMW 12R,A01,514034,Herbst; Matthew,0,2,16,16
1715616077605,MMW 12R,A02,514035,Herbst; Matthew,0,0,16,16
1715616078635,MMW 13R,A01,514037,Staff,0,5,16,16
1715616078635,MMW 13R,A02,514039,Staff,0,5,16,16
1715616078635,MMW 13R,A03,628519,Staff,0,4,16,16
1715616080691,SIO 295LS,A00,523233,Staff,10,0,30,20
1715616081716,SIO 295S,A00,523232,Staff,10,0,30,20
1715616082744,SIOC 290S,A01,637330,Merrifield; Mark A,23,0,30,7
1715616083773,SIOC 291S,A01,637333,Gabriel; Corey John,23,0,30,7
1715616084801,SOCI 117,A01,494376,Staff,0,5,5,5
1715616085829,WES 237B,A00,494380,Staff,10,0,20,10
1715616087891,AESE 279B,A00,494370,Wade; Jon P,0,0,33,33
1715616088918,AIP 97,001,660915,Van Den Einde; Yael Dahlia,9998,0,9999,1
1715616089946,AIP 197,001,627712,Vespa; Emanuel Ignacio,9995,0,9999,4
1715616089946,AIP 197,002,650778,Amir; On,9998,0,9999,1
1715616089946,AIP 197,003,650933,Avenancio-Leon; Carlos,9998,0,9999,1
1715616089946,AIP 197,004,658530,Heyman; Gail D.,9998,0,9999,1
1715616089946,AIP 197,005,658631,Neal; Sonya E,9998,0,9999,1
1715616089946,AIP 197,006,658671,Du; Songzi,9998,0,9999,1
1715616090976,ANAR 135S,A00,494369,Braswell; Geoffrey E.,0,0,0,0
1715616092002,BENG 196,001,628496,Engler; Adam J.,9998,0,9999,1
1715616092002,BENG 196,002,660916,Watson; John Thomas,9999,0,9999,0
1715616093030,BISP 197,001,650773,Wilhelm; James E.,9994,0,9999,5
1715616093030,BISP 197,002,658904,Coleman; Aaron B.,9998,0,9999,1
1715616094059,CAT 124RS,A01,519847,Geibel; William,0,0,20,20
1715616095086,CAT 125RS,A01,515971,Geibel; William,0,0,20,20
1715616096112,CLRE 250,A00,511389,Morris; Sheldon,9992,0,9999,7
1715616097141,CLRE 251,A00,507176,Mehta; Ravindra L.,9992,0,9999,7
1715616097141,CLRE 251,B00,511410,Mehta; Ravindra L.,9998,0,9999,1
1715616098172,CLRE 252,A00,507189,Cuomo; Raphael Eduardo,9994,0,9999,5
1715616099201,CLRE 253,A00,507199,Vaida; Florin,9994,0,9999,5
1715616099201,CLRE 253,B00,507202,Vaida; Florin,9999,0,9999,0
1715616100230,CLRE 259,A00,507211,Patel; Hemal,9996,0,9999,3
1715616101256,CLRE 260,A00,507221,Cuomo; Raphael Eduardo,9999,0,9999,0
1715616102281,CLRE 297,001,507242,Cuomo; Raphael Eduardo,9999,0,9999,0
1715616103309,COGS 197,001,638244,Voytek; Bradley Thomas,9997,0,9999,2
1715616104337,CSE 191,A00,516875,Minnes Kemp; Mor Mia,9991,0,9999,8
1715616105360,CSE 197,001,637388,Minnes Kemp; Mor Mia,9992,0,9999,7
1715616106897,CSS 201S,A01,494383,Mignozzetti; Umberto,35,0,35,0
1715616107923,CSS 202S,A01,494387,Mignozzetti; Umberto,35,0,35,0
1715616108951,DSC 197,001,628532,Eldridge; Justin Matthew,9995,0,9999,4
1715616109978,EAP 100,A00,516065,Staff,9799,0,9999,200
1715616111004,ECE 45,A01,507414,Staff,31,0,60,29
1715616113059,ECE 111,A01,507420,Staff,11,0,50,39
1715616114088,ECE 197,001,548057,Sievenpiper; Daniel F.,9991,0,9999,8
1715616115114,EDS 115,A00,507243,Choi; Bailey Miyeon,7,0,28,21
1715616116147,EDS 117,A01,494379,Staff,0,6,34,34
1715616117173,EDS 125,A00,507246,Hopkins; Megan Beth,8,0,30,22
1715616118200,EDS 128A,A01,507264,Fargason; Sharon Gayle,6,0,26,20
1715616119226,EDS 128B,A01,507293,Pappas; Elizabeth,10,0,30,20
1715616120255,EDS 139,A00,507294,Fargason; Sharon Gayle,10,0,30,20
1715616120255,EDS 139,B00,507313,Pappas; Elizabeth,11,0,30,19
1715616121283,EDS 201,A00,507315,Staff,10,0,30,20
1715616122312,EDS 203,A01,507317,Halter; Christopher P.,10,0,30,20
1715616123342,EDS 204R,A01,507319,Halter; Christopher P.,0,3,30,30
1715616123342,EDS 204R,B01,507331,Heinzman; Erica M.,14,0,30,16
1715616124369,EDS 206R,A00,507332,Staff,0,4,30,30
1715616124369,EDS 206R,B00,507343,Staff,15,0,30,15
1715616125394,EDS 250,A00,507344,Hemans; Patricia Ann Benitez,20,0,40,20
1715616126420,EDS 281,A00,507345,Daly; Alan J.,18,0,18,0
1715616127444,EDS 284,A00,507350,Daly; Alan J.,16,0,16,0
1715616128470,EDS 286,A00,507359,Fine; Sarah,18,0,18,0
1715616129499,EDS 289C,A01,507361,Daly; Alan J.,18,0,18,0
1715616130524,EDS 290,A00,507366,Hofstetter; Carolyn,15,0,15,0
1715616131554,LIGM 5A,A00,507421,Fischer-Grunski; Eva K,17,0,20,3
1715616132581,LIGM 5B,A00,507423,Fischer-Grunski; Eva K,19,0,20,1
1715616133611,LIGM 5C,A00,507425,Fischer-Grunski; Eva K,19,0,20,1
1715616134637,LIIT 5AS,A00,507427,Carnelos; Chiara,20,0,20,0
1715616135662,LIIT 5BS,A00,507430,Carnelos; Chiara,20,0,20,0
1715616136689,LIIT 5CS,A00,507432,Carnelos; Chiara,20,0,20,0
1715616137716,LISP 5A,A00,507541,Munoz Sanchez; Alicia,11,0,20,9
1715616138745,LISP 5B,A00,507671,Munoz Sanchez; Alicia,9,0,20,11
1715616139770,LISP 5C,A00,507696,Munoz Sanchez; Alicia,9,0,20,11
1715616140796,MAE 197,001,528363,Boechler; Nicholas Sebastia,9998,0,9999,1
1715616141890,MATH 197,001,523477,Kedlaya; Kiran S.,9994,0,9999,5
1715616141890,MATH 197,002,563811,Zhang; Danna,9994,0,9999,5
1715616141890,MATH 197,003,628552,Dumitriu; Ioana,9998,0,9999,1
1715616141890,MATH 197,004,660885,Floyd; Eric,9999,0,9999,0
1715616142919,MCWP 40R,A00,518780,Staff,2,0,20,18
1715616142919,MCWP 40R,B00,518781,Staff,11,0,20,9
1715616142919,MCWP 40R,C00,518783,Staff,5,0,20,15
1715616143947,MCWP 50R,A00,518791,Staff,0,1,20,20
1715616143947,MCWP 50R,B00,518792,Staff,0,2,20,20
1715616143947,MCWP 50R,C00,518793,Staff,0,4,20,20
1715616143947,MCWP 50R,D00,518794,Staff,0,1,20,20
1715616143947,MCWP 50R,E00,518795,Staff,0,2,20,20
1715616143947,MCWP 50R,F00,518796,Staff,0,1,20,20
1715616143947,MCWP 50R,G00,518797,Staff,0,1,20,20
1715616144971,MMW 12R,A01,514034,Herbst; Matthew,0,2,16,16
1715616144971,MMW 12R,A02,514035,Herbst; Matthew,0,0,16,16
1715616146000,MMW 13R,A01,514037,Staff,0,5,16,16
1715616146000,MMW 13R,A02,514039,Staff,0,5,16,16
1715616146000,MMW 13R,A03,628519,Staff,0,4,16,16
1715616148053,SIO 295LS,A00,523233,Staff,10,0,30,20
1715616149079,SIO 295S,A00,523232,Staff,10,0,30,20
1715616150106,SIOC 290S,A01,637330,Merrifield; Mark A,23,0,30,7
1715616151132,SIOC 291S,A01,637333,Gabriel; Corey John,23,0,30,7
1715616152157,SOCI 117,A01,494376,Staff,0,5,5,5
1715616153183,WES 237B,A00,494380,Staff,10,0,20,10
1715616155252,AESE 279B,A00,494370,Wade; Jon P,0,0,33,33
1715616156277,AIP 97,001,660915,Van Den Einde; Yael Dahlia,9998,0,9999,1
1715616157307,AIP 197,001,627712,Vespa; Emanuel Ignacio,9995,0,9999,4
1715616157307,AIP 197,002,650778,Amir; On,9998,0,9999,1
1715616157307,AIP 197,003,650933,Avenancio-Leon; Carlos,9998,0,9999,1
1715616157307,AIP 197,004,658530,Heyman; Gail D.,9998,0,9999,1
1715616157307,AIP 197,005,658631,Neal; Sonya E,9998,0,9999,1
1715616157307,AIP 197,006,658671,Du; Songzi,9998,0,9999,1
1715616158335,ANAR 135S,A00,494369,Braswell; Geoffrey E.,0,0,0,0
1715616159361,BENG 196,001,628496,Engler; Adam J.,9998,0,9999,1
1715616159361,BENG 196,002,660916,Watson; John Thomas,9999,0,9999,0
1715616160387,BISP 197,001,650773,Wilhelm; James E.,9994,0,9999,5
1715616160387,BISP 197,002,658904,Coleman; Aaron B.,9998,0,9999,1
1715616161413,CAT 124RS,A01,519847,Geibel; William,0,0,20,20
1715616162441,CAT 125RS,A01,515971,Geibel; William,0,0,20,20
1715616163466,CLRE 250,A00,511389,Morris; Sheldon,9992,0,9999,7
1715616164493,CLRE 251,A00,507176,Mehta; Ravindra L.,9992,0,9999,7
1715616164493,CLRE 251,B00,511410,Mehta; Ravindra L.,9998,0,9999,1
1715616165523,CLRE 252,A00,507189,Cuomo; Raphael Eduardo,9994,0,9999,5
1715616166552,CLRE 253,A00,507199,Vaida; Florin,9994,0,9999,5
1715616166552,CLRE 253,B00,507202,Vaida; Florin,9999,0,9999,0
1715616167581,CLRE 259,A00,507211,Patel; Hemal,9996,0,9999,3
1715616168608,CLRE 260,A00,507221,Cuomo; Raphael Eduardo,9999,0,9999,0
1715616169633,CLRE 297,001,507242,Cuomo; Raphael Eduardo,9999,0,9999,0
1715616170661,COGS 197,001,638244,Voytek; Bradley Thomas,9997,0,9999,2
1715616171689,CSE 191,A00,516875,Minnes Kemp; Mor Mia,9991,0,9999,8
1715616172712,CSE 197,001,637388,Minnes Kemp; Mor Mia,9992,0,9999,7
1715616173739,CSS 201S,A01,494383,Mignozzetti; Umberto,35,0,35,0
1715616174766,CSS 202S,A01,494387,Mignozzetti; Umberto,35,0,35,0
1715616175791,DSC 197,001,628532,Eldridge; Justin Matthew,9995,0,9999,4
1715616176819,EAP 100,A00,516065,Staff,9799,0,9999,200
1715616177846,ECE 45,A01,507414,Staff,31,0,60,29
1715616179896,ECE 111,A01,507420,Staff,11,0,50,39
1715616180922,ECE 197,001,548057,Sievenpiper; Daniel F.,9991,0,9999,8
1715616181947,EDS 115,A00,507243,Choi; Bailey Miyeon,7,0,28,21
1715616182975,EDS 117,A01,494379,Staff,0,6,34,34
1715616184000,EDS 125,A00,507246,Hopkins; Megan Beth,8,0,30,22
1715616185024,EDS 128A,A01,507264,Fargason; Sharon Gayle,6,0,26,20
1715616186051,EDS 128B,A01,507293,Pappas; Elizabeth,10,0,30,20
1715616187079,EDS 139,A00,507294,Fargason; Sharon Gayle,10,0,30,20
1715616187079,EDS 139,B00,507313,Pappas; Elizabeth,11,0,30,19
1715616188105,EDS 201,A00,507315,Staff,10,0,30,20
1715616189133,EDS 203,A01,507317,Halter; Christopher P.,10,0,30,20
1715616190159,EDS 204R,A01,507319,Halter; Christopher P.,0,3,30,30
1715616190159,EDS 204R,B01,507331,Heinzman; Erica M.,14,0,30,16
1715616191185,EDS 206R,A00,507332,Staff,0,4,30,30
1715616191185,EDS 206R,B00,507343,Staff,15,0,30,15
1715616192211,EDS 250,A00,507344,Hemans; Patricia Ann Benitez,20,0,40,20
1715616193237,EDS 281,A00,507345,Daly; Alan J.,18,0,18,0
1715616194266,EDS 284,A00,507350,Daly; Alan J.,16,0,16,0
1715616195294,EDS 286,A00,507359,Fine; Sarah,18,0,18,0
1715616196321,EDS 289C,A01,507361,Daly; Alan J.,18,0,18,0
1715616197350,EDS 290,A00,507366,Hofstetter; Carolyn,15,0,15,0
1715616198375,LIGM 5A,A00,507421,Fischer-Grunski; Eva K,17,0,20,3
1715616199402,LIGM 5B,A00,507423,Fischer-Grunski; Eva K,19,0,20,1
1715616200430,LIGM 5C,A00,507425,Fischer-Grunski; Eva K,19,0,20,1
1715616201455,LIIT 5AS,A00,507427,Carnelos; Chiara,20,0,20,0
1715616202484,LIIT 5BS,A00,507430,Carnelos; Chiara,20,0,20,0
1715616203510,LIIT 5CS,A00,507432,Carnelos; Chiara,20,0,20,0
1715616204539,LISP 5A,A00,507541,Munoz Sanchez; Alicia,11,0,20,9
1715616205569,LISP 5B,A00,507671,Munoz Sanchez; Alicia,9,0,20,11
1715616206595,LISP 5C,A00,507696,Munoz Sanchez; Alicia,9,0,20,11
1715616207620,MAE 197,001,528363,Boechler; Nicholas Sebastia,9998,0,9999,1
1715616208646,MATH 197,001,523477,Kedlaya; Kiran S.,9994,0,9999,5
1715616208646,MATH 197,002,563811,Zhang; Danna,9994,0,9999,5
1715616208646,MATH 197,003,628552,Dumitriu; Ioana,9998,0,9999,1
1715616208646,MATH 197,004,660885,Floyd; Eric,9999,0,9999,0
1715616209675,MCWP 40R,A00,518780,Staff,2,0,20,18
1715616209675,MCWP 40R,B00,518781,Staff,11,0,20,9
1715616209675,MCWP 40R,C00,518783,Staff,5,0,20,15
1715616210702,MCWP 50R,A00,518791,Staff,0,1,20,20
1715616210702,MCWP 50R,B00,518792,Staff,0,2,20,20
1715616210702,MCWP 50R,C00,518793,Staff,0,4,20,20
1715616210702,MCWP 50R,D00,518794,Staff,0,1,20,20
1715616210702,MCWP 50R,E00,518795,Staff,0,2,20,20
1715616210702,MCWP 50R,F00,518796,Staff,0,1,20,20
1715616210702,MCWP 50R,G00,518797,Staff,0,1,20,20
1715616211732,MMW 12R,A01,514034,Herbst; Matthew,0,2,16,16
1715616211732,MMW 12R,A02,514035,Herbst; Matthew,0,0,16,16
1715616212757,MMW 13R,A01,514037,Staff,0,5,16,16
1715616212757,MMW 13R,A02,514039,Staff,0,5,16,16
1715616212757,MMW 13R,A03,628519,Staff,0,4,16,16
1715616214811,SIO 295LS,A00,523233,Staff,10,0,30,20
1715616215837,SIO 295S,A00,523232,Staff,10,0,30,20
1715616216866,SIOC 290S,A01,637330,Merrifield; Mark A,23,0,30,7
1715616217892,SIOC 291S,A01,637333,Gabriel; Corey John,23,0,30,7
1715616218921,SOCI 117,A01,494376,Staff,0,5,5,5
1715616219945,WES 237B,A00,494380,Staff,10,0,20,10
1715616222015,AESE 279B,A00,494370,Wade; Jon P,0,0,33,33
1715616223042,AIP 97,001,660915,Van Den Einde; Yael Dahlia,9998,0,9999,1
1715616224069,AIP 197,001,627712,Vespa; Emanuel Ignacio,9995,0,9999,4
1715616224069,AIP 197,002,650778,Amir; On,9998,0,9999,1
1715616224069,AIP 197,003,650933,Avenancio-Leon; Carlos,9998,0,9999,1
1715616224069,AIP 197,004,658530,Heyman; Gail D.,9998,0,9999,1
1715616224069,AIP 197,005,658631,Neal; Sonya E,9998,0,9999,1
1715616224069,AIP 197,006,658671,Du; Songzi,9998,0,9999,1
1715616225097,ANAR 135S,A00,494369,Braswell; Geoffrey E.,0,0,0,0
1715616226123,BENG 196,001,628496,Engler; Adam J.,9998,0,9999,1
1715616226123,BENG 196,002,660916,Watson; John Thomas,9999,0,9999,0
1715616227149,BISP 197,001,650773,Wilhelm; James E.,9994,0,9999,5
1715616227149,BISP 197,002,658904,Coleman; Aaron B.,9998,0,9999,1
1715616228177,CAT 124RS,A01,519847,Geibel; William,0,0,20,20
1715616229201,CAT 125RS,A01,515971,Geibel; William,0,0,20,20
1715616230230,CLRE 250,A00,511389,Morris; Sheldon,9992,0,9999,7
1715616231259,CLRE 251,A00,507176,Mehta; Ravindra L.,9992,0,9999,7
1715616231259,CLRE 251,B00,511410,Mehta; Ravindra L.,9998,0,9999,1
1715616232286,CLRE 252,A00,507189,Cuomo; Raphael Eduardo,9994,0,9999,5
1715616233311,CLRE 253,A00,507199,Vaida; Florin,9994,0,9999,5
1715616233311,CLRE 253,B00,507202,Vaida; Florin,9999,0,9999,0
1715616234337,CLRE 259,A00,507211,Patel; Hemal,9996,0,9999,3
1715616235363,CLRE 260,A00,507221,Cuomo; Raphael Eduardo,9999,0,9999,0
1715616236390,CLRE 297,001,507242,Cuomo; Raphael Eduardo,9999,0,9999,0
1715616237417,COGS 197,001,638244,Voytek; Bradley Thomas,9997,0,9999,2
1715616238446,CSE 191,A00,516875,Minnes Kemp; Mor Mia,9991,0,9999,8
1715616239475,CSE 197,001,637388,Minnes Kemp; Mor Mia,9992,0,9999,7
1715616240505,CSS 201S,A01,494383,Mignozzetti; Umberto,35,0,35,0
1715616241534,CSS 202S,A01,494387,Mignozzetti; Umberto,35,0,35,0
1715616242559,DSC 197,001,628532,Eldridge; Justin Matthew,9995,0,9999,4
1715616243643,EAP 100,A00,516065,Staff,9799,0,9999,200
1715616244670,ECE 45,A01,507414,Staff,31,0,60,29
1715616246724,ECE 111,A01,507420,Staff,11,0,50,39
1715616247752,ECE 197,001,548057,Sievenpiper; Daniel F.,9991,0,9999,8
1715616248781,EDS 115,A00,507243,Choi; Bailey Miyeon,7,0,28,21
1715616249812,EDS 117,A01,494379,Staff,0,6,34,34
1715616250839,EDS 125,A00,507246,Hopkins; Megan Beth,8,0,30,22
1715616251867,EDS 128A,A01,507264,Fargason; Sharon Gayle,6,0,26,20
1715616252898,EDS 128B,A01,507293,Pappas; Elizabeth,10,0,30,20
1715616253926,EDS 139,A00,507294,Fargason; Sharon Gayle,10,0,30,20
1715616253926,EDS 139,B00,507313,Pappas; Elizabeth,11,0,30,19
1715616254957,EDS 201,A00,507315,Staff,10,0,30,20
1715616255982,EDS 203,A01,507317,Halter; Christopher P.,10,0,30,20
1715616257009,EDS 204R,A01,507319,Halter; Christopher P.,0,3,30,30
1715616257009,EDS 204R,B01,507331,Heinzman; Erica M.,14,0,30,16
1715616258034,EDS 206R,A00,507332,Staff,0,4,30,30
1715616258034,EDS 206R,B00,507343,Staff,15,0,30,15
1715616259065,EDS 250,A00,507344,Hemans; Patricia Ann Benitez,20,0,40,20
1715616260094,EDS 281,A00,507345,Daly; Alan J.,18,0,18,0
1715616261119,EDS 284,A00,507350,Daly; Alan J.,16,0,16,0
1715616262145,EDS 286,A00,507359,Fine; Sarah,18,0,18,0
1715616263170,EDS 289C,A01,507361,Daly; Alan J.,18,0,18,0
1715616264199,EDS 290,A00,507366,Hofstetter; Carolyn,15,0,15,0
1715616265227,LIGM 5A,A00,507421,Fischer-Grunski; Eva K,17,0,20,3
1715616266252,LIGM 5B,A00,507423,Fischer-Grunski; Eva K,19,0,20,1
1715616267282,LIGM 5C,A00,507425,Fischer-Grunski; Eva K,19,0,20,1
1715616268311,LIIT 5AS,A00,507427,Carnelos; Chiara,20,0,20,0
1715616269338,LIIT 5BS,A00,507430,Carnelos; Chiara,20,0,20,0
1715616270367,LIIT 5CS,A00,507432,Carnelos; Chiara,20,0,20,0
1715616271397,LISP 5A,A00,507541,Munoz Sanchez; Alicia,11,0,20,9
1715616272424,LISP 5B,A00,507671,Munoz Sanchez; Alicia,9,0,20,11
1715616273453,LISP 5C,A00,507696,Munoz Sanchez; Alicia,9,0,20,11
1715616274481,MAE 197,001,528363,Boechler; Nicholas Sebastia,9998,0,9999,1
1715616275507,MATH 197,001,523477,Kedlaya; Kiran S.,9994,0,9999,5
1715616275507,MATH 197,002,563811,Zhang; Danna,9994,0,9999,5
1715616275507,MATH 197,003,628552,Dumitriu; Ioana,9998,0,9999,1
1715616275507,MATH 197,004,660885,Floyd; Eric,9999,0,9999,0
1715616276533,MCWP 40R,A00,518780,Staff,2,0,20,18
1715616276533,MCWP 40R,B00,518781,Staff,11,0,20,9
1715616276533,MCWP 40R,C00,518783,Staff,5,0,20,15
1715616277558,MCWP 50R,A00,518791,Staff,0,1,20,20
1715616277558,MCWP 50R,B00,518792,Staff,0,2,20,20
1715616277558,MCWP 50R,C00,518793,Staff,0,4,20,20
1715616277558,MCWP 50R,D00,518794,Staff,0,1,20,20
1715616277558,MCWP 50R,E00,518795,Staff,0,2,20,20
1715616277558,MCWP 50R,F00,518796,Staff,0,1,20,20
1715616277558,MCWP 50R,G00,518797,Staff,0,1,20,20
1715616278583,MMW 12R,A01,514034,Herbst; Matthew,0,2,16,16
1715616278583,MMW 12R,A02,514035,Herbst; Matthew,0,0,16,16
1715616279611,MMW 13R,A01,514037,Staff,0,5,16,16
1715616279611,MMW 13R,A02,514039,Staff,0,5,16,16
1715616279611,MMW 13R,A03,628519,Staff,0,4,16,16
1715616281663,SIO 295LS,A00,523233,Staff,10,0,30,20
1715616282689,SIO 295S,A00,523232,Staff,10,0,30,20
1715616283718,SIOC 290S,A01,637330,Merrifield; Mark A,23,0,30,7
1715616284744,SIOC 291S,A01,637333,Gabriel; Corey John,23,0,30,7
1715616285770,SOCI 117,A01,494376,Staff,0,5,5,5
1715616286795,WES 237B,A00,494380,Staff,10,0,20,10
1715616288852,AESE 279B,A00,494370,Wade; Jon P,0,0,33,33
1715616289878,AIP 97,001,660915,Van Den Einde; Yael Dahlia,9998,0,9999,1
1715616290907,AIP 197,001,627712,Vespa; Emanuel Ignacio,9995,0,9999,4
1715616290907,AIP 197,002,650778,Amir; On,9998,0,9999,1
1715616290907,AIP 197,003,650933,Avenancio-Leon; Carlos,9998,0,9999,1
1715616290907,AIP 197,004,658530,Heyman; Gail D.,9998,0,9999,1
1715616290907,AIP 197,005,658631,Neal; Sonya E,9998,0,9999,1
1715616290907,AIP 197,006,658671,Du; Songzi,9998,0,9999,1
1715616291933,ANAR 135S,A00,494369,Braswell; Geoffrey E.,0,0,0,0
1715616292958,BENG 196,001,628496,Engler; Adam J.,9998,0,9999,1
1715616292958,BENG 196,002,660916,Watson; John Thomas,9999,0,9999,0
1715616293982,BISP 197,001,650773,Wilhelm; James E.,9994,0,9999,5
1715616293982,BISP 197,002,658904,Coleman; Aaron B.,9998,0,9999,1
1715616295006,CAT 124RS,A01,519847,Geibel; William,0,0,20,20
1715616296032,CAT 125RS,A01,515971,Geibel; William,0,0,20,20
1715616297057,CLRE 250,A00,511389,Morris; Sheldon,9992,0,9999,7
1715616298087,CLRE 251,A00,507176,Mehta; Ravindra L.,9992,0,9999,7
1715616298087,CLRE 251,B00,511410,Mehta; Ravindra L.,9998,0,9999,1
1715616299113,CLRE 252,A00,507189,Cuomo; Raphael Eduardo,9994,0,9999,5
1715616300140,CLRE 253,A00,507199,Vaida; Florin,9994,0,9999,5
1715616300140,CLRE 253,B00,507202,Vaida; Florin,9999,0,9999,0
1715616301166,CLRE 259,A00,507211,Patel; Hemal,9996,0,9999,3
1715616302190,CLRE 260,A00,507221,Cuomo; Raphael Eduardo,9999,0,9999,0
1715616303216,CLRE 297,001,507242,Cuomo; Raphael Eduardo,9999,0,9999,0
1715616304241,COGS 197,001,638244,Voytek; Bradley Thomas,9997,0,9999,2
1715616305273,CSE 191,A00,516875,Minnes Kemp; Mor Mia,9991,0,9999,8
1715616306300,CSE 197,001,637388,Minnes Kemp; Mor Mia,9992,0,9999,7
1715616307325,CSS 201S,A01,494383,Mignozzetti; Umberto,35,0,35,0
1715616308356,CSS 202S,A01,494387,Mignozzetti; Umberto,35,0,35,0
1715616309383,DSC 197,001,628532,Eldridge; Justin Matthew,9995,0,9999,4
1715616310410,EAP 100,A00,516065,Staff,9799,0,9999,200
1715616311439,ECE 45,A01,507414,Staff,31,0,60,29
1715616313492,ECE 111,A01,507420,Staff,11,0,50,39
1715616314517,ECE 197,001,548057,Sievenpiper; Daniel F.,9991,0,9999,8
1715616315544,EDS 115,A00,507243,Choi; Bailey Miyeon,7,0,28,21
1715616316572,EDS 117,A01,494379,Staff,0,6,34,34
1715616317601,EDS 125,A00,507246,Hopkins; Megan Beth,8,0,30,22
1715616318629,EDS 128A,A01,507264,Fargason; Sharon Gayle,6,0,26,20
1715616319655,EDS 128B,A01,507293,Pappas; Elizabeth,10,0,30,20
1715616320681,EDS 139,A00,507294,Fargason; Sharon Gayle,10,0,30,20
1715616320681,EDS 139,B00,507313,Pappas; Elizabeth,11,0,30,19
1715616321708,EDS 201,A00,507315,Staff,10,0,30,20
1715616322734,EDS 203,A01,507317,Halter; Christopher P.,10,0,30,20
1715616323764,EDS 204R,A01,507319,Halter; Christopher P.,0,3,30,30
1715616323764,EDS 204R,B01,507331,Heinzman; Erica M.,14,0,30,16
1715616324789,EDS 206R,A00,507332,Staff,0,4,30,30
1715616324789,EDS 206R,B00,507343,Staff,15,0,30,15
1715616325814,EDS 250,A00,507344,Hemans; Patricia Ann Benitez,20,0,40,20
1715616326840,EDS 281,A00,507345,Daly; Alan J.,18,0,18,0
1715616327866,EDS 284,A00,507350,Daly; Alan J.,16,0,16,0
1715616328891,EDS 286,A00,507359,Fine; Sarah,18,0,18,0
1715616329916,EDS 289C,A01,507361,Daly; Alan J.,18,0,18,0
1715616330942,EDS 290,A00,507366,Hofstetter; Carolyn,15,0,15,0
1715616331970,LIGM 5A,A00,507421,Fischer-Grunski; Eva K,17,0,20,3
1715616332996,LIGM 5B,A00,507423,Fischer-Grunski; Eva K,19,0,20,1
1715616334022,LIGM 5C,A00,507425,Fischer-Grunski; Eva K,19,0,20,1
1715616335051,LIIT 5AS,A00,507427,Carnelos; Chiara,20,0,20,0
1715616336078,LIIT 5BS,A00,507430,Carnelos; Chiara,20,0,20,0
1715616337102,LIIT 5CS,A00,507432,Carnelos; Chiara,20,0,20,0
1715616338126,LISP 5A,A00,507541,Munoz Sanchez; Alicia,11,0,20,9
1715616339155,LISP 5B,A00,507671,Munoz Sanchez; Alicia,9,0,20,11
1715616340181,LISP 5C,A00,507696,Munoz Sanchez; Alicia,9,0,20,11
1715616341204,MAE 197,001,528363,Boechler; Nicholas Sebastia,9998,0,9999,1
1715616342233,MATH 197,001,523477,Kedlaya; Kiran S.,9994,0,9999,5
1715616342233,MATH 197,002,563811,Zhang; Danna,9994,0,9999,5
1715616342233,MATH 197,003,628552,Dumitriu; Ioana,9998,0,9999,1
1715616342233,MATH 197,004,660885,Floyd; Eric,9999,0,9999,0
1715616343262,MCWP 40R,A00,518780,Staff,2,0,20,18
1715616343262,MCWP 40R,B00,518781,Staff,11,0,20,9
1715616343262,MCWP 40R,C00,518783,Staff,5,0,20,15
1715616344289,MCWP 50R,A00,518791,Staff,0,1,20,20
1715616344289,MCWP 50R,B00,518792,Staff,0,2,20,20
1715616344289,MCWP 50R,C00,518793,Staff,0,4,20,20
1715616344289,MCWP 50R,D00,518794,Staff,0,1,20,20
1715616344289,MCWP 50R,E00,518795,Staff,0,2,20,20
1715616344289,MCWP 50R,F00,518796,Staff,0,1,20,20
1715616344289,MCWP 50R,G00,518797,Staff,0,1,20,20
1715616345318,MMW 12R,A01,514034,Herbst; Matthew,0,2,16,16
1715616345318,MMW 12R,A02,514035,Herbst; Matthew,0,0,16,16
1715616346343,MMW 13R,A01,514037,Staff,0,5,16,16
1715616346343,MMW 13R,A02,514039,Staff,0,5,16,16
1715616346343,MMW 13R,A03,628519,Staff,0,4,16,16
1715616348394,SIO 295LS,A00,523233,Staff,10,0,30,20
1715616349419,SIO 295S,A00,523232,Staff,10,0,30,20
1715616350449,SIOC 290S,A01,637330,Merrifield; Mark A,23,0,30,7
1715616351479,SIOC 291S,A01,637333,Gabriel; Corey John,23,0,30,7
1715616352509,SOCI 117,A01,494376,Staff,0,5,5,5
1715616353535,WES 237B,A00,494380,Staff,10,0,20,10
1715616355601,AESE 279B,A00,494370,Wade; Jon P,0,0,33,33
1715616356625,AIP 97,001,660915,Van Den Einde; Yael Dahlia,9998,0,9999,1
1715616357656,AIP 197,001,627712,Vespa; Emanuel Ignacio,9995,0,9999,4
1715616357656,AIP 197,002,650778,Amir; On,9998,0,9999,1
1715616357656,AIP 197,003,650933,Avenancio-Leon; Carlos,9998,0,9999,1
1715616357656,AIP 197,004,658530,Heyman; Gail D.,9998,0,9999,1
1715616357656,AIP 197,005,658631,Neal; Sonya E,9998,0,9999,1
1715616357656,AIP 197,006,658671,Du; Songzi,9998,0,9999,1
1715616358685,ANAR 135S,A00,494369,Braswell; Geoffrey E.,0,0,0,0
1715616359710,BENG 196,001,628496,Engler; Adam J.,9998,0,9999,1
1715616359710,BENG 196,002,660916,Watson; John Thomas,9999,0,9999,0
1715616360737,BISP 197,001,650773,Wilhelm; James E.,9994,0,9999,5
1715616360737,BISP 197,002,658904,Coleman; Aaron B.,9998,0,9999,1
1715616361763,CAT 124RS,A01,519847,Geibel; William,0,0,20,20
1715616362787,CAT 125RS,A01,515971,Geibel; William,0,0,20,20
1715616363814,CLRE 250,A00,511389,Morris; Sheldon,9992,0,9999,7
1715616364840,CLRE 251,A00,507176,Mehta; Ravindra L.,9992,0,9999,7
1715616364840,CLRE 251,B00,511410,Mehta; Ravindra L.,9998,0,9999,1
1715616365867,CLRE 252,A00,507189,Cuomo; Raphael Eduardo,9994,0,9999,5
1715616366894,CLRE 253,A00,507199,Vaida; Florin,9994,0,9999,5
1715616366894,CLRE 253,B00,507202,Vaida; Florin,9999,0,9999,0
1715616367942,CLRE 259,A00,507211,Patel; Hemal,9996,0,9999,3
1715616368967,CLRE 260,A00,507221,Cuomo; Raphael Eduardo,9999,0,9999,0
1715616369991,CLRE 297,001,507242,Cuomo; Raphael Eduardo,9999,0,9999,0
1715616371016,COGS 197,001,638244,Voytek; Bradley Thomas,9997,0,9999,2
1715616372043,CSE 191,A00,516875,Minnes Kemp; Mor Mia,9991,0,9999,8
1715616373071,CSE 197,001,637388,Minnes Kemp; Mor Mia,9992,0,9999,7
1715616374102,CSS 201S,A01,494383,Mignozzetti; Umberto,35,0,35,0
1715616375126,CSS 202S,A01,494387,Mignozzetti; Umberto,35,0,35,0
1715616376154,DSC 197,001,628532,Eldridge; Justin Matthew,9995,0,9999,4
1715616377181,EAP 100,A00,516065,Staff,9799,0,9999,200
1715616378213,ECE 45,A01,507414,Staff,31,0,60,29
1715616380267,ECE 111,A01,507420,Staff,11,0,50,39
1715616381296,ECE 197,001,548057,Sievenpiper; Daniel F.,9991,0,9999,8
1715616382326,EDS 115,A00,507243,Choi; Bailey Miyeon,7,0,28,21
1715616383356,EDS 117,A01,494379,Staff,0,6,34,34
1715616384386,EDS 125,A00,507246,Hopkins; Megan Beth,8,0,30,22
1715616385417,EDS 128A,A01,507264,Fargason; Sharon Gayle,6,0,26,20
1715616386503,EDS 128B,A01,507293,Pappas; Elizabeth,10,0,30,20
1715616387531,EDS 139,A00,507294,Fargason; Sharon Gayle,10,0,30,20
1715616387531,EDS 139,B00,507313,Pappas; Elizabeth,11,0,30,19
1715616388555,EDS 201,A00,507315,Staff,10,0,30,20
1715616389580,EDS 203,A01,507317,Halter; Christopher P.,10,0,30,20
1715616390610,EDS 204R,A01,507319,Halter; Christopher P.,0,3,30,30
1715616390610,EDS 204R,B01,507331,Heinzman; Erica M.,14,0,30,16
1715616391640,EDS 206R,A00,507332,Staff,0,4,30,30
1715616391640,EDS 206R,B00,507343,Staff,15,0,30,15
1715616392667,EDS 250,A00,507344,Hemans; Patricia Ann Benitez,20,0,40,20
1715616393694,EDS 281,A00,507345,Daly; Alan J.,18,0,18,0
1715616394720,EDS 284,A00,507350,Daly; Alan J.,16,0,16,0
1715616395747,EDS 286,A00,507359,Fine; Sarah,18,0,18,0
1715616396772,EDS 289C,A01,507361,Daly; Alan J.,18,0,18,0
1715616397796,EDS 290,A00,507366,Hofstetter; Carolyn,15,0,15,0
1715616398827,LIGM 5A,A00,507421,Fischer-Grunski; Eva K,17,0,20,3
1715616399856,LIGM 5B,A00,507423,Fischer-Grunski; Eva K,19,0,20,1
1715616400882,LIGM 5C,A00,507425,Fischer-Grunski; Eva K,19,0,20,1
1715616401911,LIIT 5AS,A00,507427,Carnelos; Chiara,20,0,20,0
1715616402941,LIIT 5BS,A00,507430,Carnelos; Chiara,20,0,20,0
1715616403965,LIIT 5CS,A00,507432,Carnelos; Chiara,20,0,20,0
1715616404992,LISP 5A,A00,507541,Munoz Sanchez; Alicia,11,0,20,9
1715616406022,LISP 5B,A00,507671,Munoz Sanchez; Alicia,9,0,20,11
1715616407048,LISP 5C,A00,507696,Munoz Sanchez; Alicia,9,0,20,11
1715616408074,MAE 197,001,528363,Boechler; Nicholas Sebastia,9998,0,9999,1
1715616409102,MATH 197,001,523477,Kedlaya; Kiran S.,9994,0,9999,5
1715616409102,MATH 197,002,563811,Zhang; Danna,9994,0,9999,5
1715616409102,MATH 197,003,628552,Dumitriu; Ioana,9998,0,9999,1
1715616409102,MATH 197,004,660885,Floyd; Eric,9999,0,9999,0
1715616410129,MCWP 40R,A00,518780,Staff,2,0,20,18
1715616410129,MCWP 40R,B00,518781,Staff,11,0,20,9
1715616410129,MCWP 40R,C00,518783,Staff,5,0,20,15
1715616411160,MCWP 50R,A00,518791,Staff,0,1,20,20
1715616411160,MCWP 50R,B00,518792,Staff,0,2,20,20
1715616411160,MCWP 50R,C00,518793,Staff,0,4,20,20
1715616411160,MCWP 50R,D00,518794,Staff,0,1,20,20
1715616411160,MCWP 50R,E00,518795,Staff,0,2,20,20
1715616411160,MCWP 50R,F00,518796,Staff,0,1,20,20
1715616411160,MCWP 50R,G00,518797,Staff,0,1,20,20
1715616412186,MMW 12R,A01,514034,Herbst; Matthew,0,2,16,16
1715616412186,MMW 12R,A02,514035,Herbst; Matthew,0,0,16,16
1715616413212,MMW 13R,A01,514037,Staff,0,5,16,16
1715616413212,MMW 13R,A02,514039,Staff,0,5,16,16
1715616413212,MMW 13R,A03,628519,Staff,0,4,16,16
1715616415266,SIO 295LS,A00,523233,Staff,10,0,30,20
1715616416291,SIO 295S,A00,523232,Staff,10,0,30,20
1715616417318,SIOC 290S,A01,637330,Merrifield; Mark A,23,0,30,7
1715616418345,SIOC 291S,A01,637333,Gabriel; Corey John,23,0,30,7
1715616419375,SOCI 117,A01,494376,Staff,0,5,5,5
1715616420401,WES 237B,A00,494380,Staff,10,0,20,10
1715616422478,AESE 279B,A00,494370,Wade; Jon P,0,0,33,33
1715616423503,AIP 97,001,660915,Van Den Einde; Yael Dahlia,9998,0,9999,1
1715616424536,AIP 197,001,627712,Vespa; Emanuel Ignacio,9995,0,9999,4
1715616424536,AIP 197,002,650778,Amir; On,9998,0,9999,1
1715616424536,AIP 197,003,650933,Avenancio-Leon; Carlos,9998,0,9999,1
1715616424536,AIP 197,004,658530,Heyman; Gail D.,9998,0,9999,1
1715616424536,AIP 197,005,658631,Neal; Sonya E,9998,0,9999,1
1715616424536,AIP 197,006,658671,Du; Songzi,9998,0,9999,1
1715616425562,ANAR 135S,A00,494369,Braswell; Geoffrey E.,0,0,0,0
1715616426591,BENG 196,001,628496,Engler; Adam J.,9998,0,9999,1
1715616426591,BENG 196,002,660916,Watson; John Thomas,9999,0,9999,0
1715616427621,BISP 197,001,650773,Wilhelm; James E.,9994,0,9999,5
1715616427621,BISP 197,002,658904,Coleman; Aaron B.,9998,0,9999,1
1715616428647,CAT 124RS,A01,519847,Geibel; William,0,0,20,20
1715616429672,CAT 125RS,A01,515971,Geibel; William,0,0,20,20
1715616430697,CLRE 250,A00,511389,Morris; Sheldon,9992,0,9999,7
1715616431726,CLRE 251,A00,507176,Mehta; Ravindra L.,9992,0,9999,7
1715616431726,CLRE 251,B00,511410,Mehta; Ravindra L.,9998,0,9999,1
1715616432754,CLRE 252,A00,507189,Cuomo; Raphael Eduardo,9994,0,9999,5
1715616433780,CLRE 253,A00,507199,Vaida; Florin,9994,0,9999,5
1715616433780,CLRE 253,B00,507202,Vaida; Florin,9999,0,9999,0
1715616434807,CLRE 259,A00,507211,Patel; Hemal,9996,0,9999,3
1715616435835,CLRE 260,A00,507221,Cuomo; Raphael Eduardo,9999,0,9999,0
1715616436863,CLRE 297,001,507242,Cuomo; Raphael Eduardo,9999,0,9999,0
1715616437888,COGS 197,001,638244,Voytek; Bradley Thomas,9997,0,9999,2
1715616438915,CSE 191,A00,516875,Minnes Kemp; Mor Mia,9991,0,9999,8
1715616439942,CSE 197,001,637388,Minnes Kemp; Mor Mia,9992,0,9999,7
1715616440967,CSS 201S,A01,494383,Mignozzetti; Umberto,35,0,35,0
1715616441996,CSS 202S,A01,494387,Mignozzetti; Umberto,35,0,35,0
1715616443022,DSC 197,001,628532,Eldridge; Justin Matthew,9995,0,9999,4
1715616444049,EAP 100,A00,516065,Staff,9799,0,9999,200
1715616445078,ECE 45,A01,507414,Staff,31,0,60,29
1715616447134,ECE 111,A01,507420,Staff,11,0,50,39
1715616448163,ECE 197,001,548057,Sievenpiper; Daniel F.,9991,0,9999,8
1715616449195,EDS 115,A00,507243,Choi; Bailey Miyeon,7,0,28,21
1715616450224,EDS 117,A01,494379,Staff,0,6,34,34
1715616451252,EDS 125,A00,507246,Hopkins; Megan Beth,8,0,30,22
1715616452281,EDS 128A,A01,507264,Fargason; Sharon Gayle,6,0,26,20
1715616453307,EDS 128B,A01,507293,Pappas; Elizabeth,10,0,30,20
1715616454333,EDS 139,A00,507294,Fargason; Sharon Gayle,10,0,30,20
1715616454333,EDS 139,B00,507313,Pappas; Elizabeth,11,0,30,19
1715616455358,EDS 201,A00,507315,Staff,10,0,30,20
1715616456387,EDS 203,A01,507317,Halter; Christopher P.,10,0,30,20
1715616457418,EDS 204R,A01,507319,Halter; Christopher P.,0,3,30,30
1715616457418,EDS 204R,B01,507331,Heinzman; Erica M.,14,0,30,16
1715616458443,EDS 206R,A00,507332,Staff,0,4,30,30
1715616458443,EDS 206R,B00,507343,Staff,15,0,30,15
1715616459470,EDS 250,A00,507344,Hemans; Patricia Ann Benitez,20,0,40,20
1715616460495,EDS 281,A00,507345,Daly; Alan J.,18,0,18,0
1715616461522,EDS 284,A00,507350,Daly; Alan J.,16,0,16,0
1715616462549,EDS 286,A00,507359,Fine; Sarah,18,0,18,0
1715616463574,EDS 289C,A01,507361,Daly; Alan J.,18,0,18,0
1715616464600,EDS 290,A00,507366,Hofstetter; Carolyn,15,0,15,0
1715616465628,LIGM 5A,A00,507421,Fischer-Grunski; Eva K,17,0,20,3
1715616466653,LIGM 5B,A00,507423,Fischer-Grunski; Eva K,19,0,20,1
1715616467681,LIGM 5C,A00,507425,Fischer-Grunski; Eva K,19,0,20,1
1715616468712,LIIT 5AS,A00,507427,Carnelos; Chiara,20,0,20,0
1715616469741,LIIT 5BS,A00,507430,Carnelos; Chiara,20,0,20,0
1715616470766,LIIT 5CS,A00,507432,Carnelos; Chiara,20,0,20,0
1715616471791,LISP 5A,A00,507541,Munoz Sanchez; Alicia,11,0,20,9
1715616472819,LISP 5B,A00,507671,Munoz Sanchez; Alicia,9,0,20,11
1715616473847,LISP 5C,A00,507696,Munoz Sanchez; Alicia,9,0,20,11
1715616474873,MAE 197,001,528363,Boechler; Nicholas Sebastia,9998,0,9999,1
1715616475908,MATH 197,001,523477,Kedlaya; Kiran S.,9994,0,9999,5
1715616475908,MATH 197,002,563811,Zhang; Danna,9994,0,9999,5
1715616475908,MATH 197,003,628552,Dumitriu; Ioana,9998,0,9999,1
1715616475908,MATH 197,004,660885,Floyd; Eric,9999,0,9999,0
1715616477145,MCWP 40R,A00,518780,Staff,2,0,20,18
1715616477145,MCWP 40R,B00,518781,Staff,11,0,20,9
1715616477145,MCWP 40R,C00,518783,Staff,5,0,20,15
1715616478172,MCWP 50R,A00,518791,Staff,0,1,20,20
1715616478172,MCWP 50R,B00,518792,Staff,0,2,20,20
1715616478172,MCWP 50R,C00,518793,Staff,0,4,20,20
1715616478172,MCWP 50R,D00,518794,Staff,0,1,20,20
1715616478172,MCWP 50R,E00,518795,Staff,0,2,20,20
1715616478172,MCWP 50R,F00,518796,Staff,0,1,20,20
1715616478172,MCWP 50R,G00,518797,Staff,0,1,20,20
1715616479197,MMW 12R,A01,514034,Herbst; Matthew,0,2,16,16
1715616479197,MMW 12R,A02,514035,Herbst; Matthew,0,0,16,16
1715616480227,MMW 13R,A01,514037,Staff,0,5,16,16
1715616480227,MMW 13R,A02,514039,Staff,0,5,16,16
1715616480227,MMW 13R,A03,628519,Staff,0,4,16,16
1715616482283,SIO 295LS,A00,523233,Staff,10,0,30,20
1715616483308,SIO 295S,A00,523232,Staff,10,0,30,20
1715616484334,SIOC 290S,A01,637330,Merrifield; Mark A,23,0,30,7
1715616485361,SIOC 291S,A01,637333,Gabriel; Corey John,23,0,30,7
1715616486390,SOCI 117,A01,494376,Staff,0,5,5,5
1715616487418,WES 237B,A00,494380,Staff,10,0,20,10
1715616489486,AESE 279B,A00,494370,Wade; Jon P,0,0,33,33
1715616490513,AIP 97,001,660915,Van Den Einde; Yael Dahlia,9998,0,9999,1
1715616491541,AIP 197,001,627712,Vespa; Emanuel Ignacio,9995,0,9999,4
1715616491541,AIP 197,002,650778,Amir; On,9998,0,9999,1
1715616491541,AIP 197,003,650933,Avenancio-Leon; Carlos,9998,0,9999,1
1715616491541,AIP 197,004,658530,Heyman; Gail D.,9998,0,9999,1
1715616491541,AIP 197,005,658631,Neal; Sonya E,9998,0,9999,1
1715616491541,AIP 197,006,658671,Du; Songzi,9998,0,9999,1
1715616492572,ANAR 135S,A00,494369,Braswell; Geoffrey E.,0,0,0,0
1715616493597,BENG 196,001,628496,Engler; Adam J.,9998,0,9999,1
1715616493597,BENG 196,002,660916,Watson; John Thomas,9999,0,9999,0
1715616494626,BISP 197,001,650773,Wilhelm; James E.,9994,0,9999,5
1715616494626,BISP 197,002,658904,Coleman; Aaron B.,9998,0,9999,1
1715616495650,CAT 124RS,A01,519847,Geibel; William,0,0,20,20
1715616496676,CAT 125RS,A01,515971,Geibel; William,0,0,20,20
1715616497704,CLRE 250,A00,511389,Morris; Sheldon,9992,0,9999,7
1715616498732,CLRE 251,A00,507176,Mehta; Ravindra L.,9992,0,9999,7
1715616498732,CLRE 251,B00,511410,Mehta; Ravindra L.,9998,0,9999,1
1715616499764,CLRE 252,A00,507189,Cuomo; Raphael Eduardo,9994,0,9999,5
1715616500794,CLRE 253,A00,507199,Vaida; Florin,9994,0,9999,5
1715616500794,CLRE 253,B00,507202,Vaida; Florin,9999,0,9999,0
1715616501822,CLRE 259,A00,507211,Patel; Hemal,9996,0,9999,3
1715616502848,CLRE 260,A00,507221,Cuomo; Raphael Eduardo,9999,0,9999,0
1715616503874,CLRE 297,001,507242,Cuomo; Raphael Eduardo,9999,0,9999,0
1715616504920,COGS 197,001,638244,Voytek; Bradley Thomas,9997,0,9999,2
1715616505943,CSE 191,A00,516875,Minnes Kemp; Mor Mia,9991,0,9999,8
1715616506970,CSE 197,001,637388,Minnes Kemp; Mor Mia,9992,0,9999,7
1715616507998,CSS 201S,A01,494383,Mignozzetti; Umberto,35,0,35,0
1715616509026,CSS 202S,A01,494387,Mignozzetti; Umberto,35,0,35,0
1715616510055,DSC 197,001,628532,Eldridge; Justin Matthew,9995,0,9999,4
1715616511079,EAP 100,A00,516065,Staff,9799,0,9999,200
1715616512113,ECE 45,A01,507414,Staff,31,0,60,29
1715616514164,ECE 111,A01,507420,Staff,11,0,50,39
1715616515193,ECE 197,001,548057,Sievenpiper; Daniel F.,9991,0,9999,8
1715616516222,EDS 115,A00,507243,Choi; Bailey Miyeon,7,0,28,21
1715616517248,EDS 117,A01,494379,Staff,0,6,34,34
1715616518276,EDS 125,A00,507246,Hopkins; Megan Beth,8,0,30,22
1715616519301,EDS 128A,A01,507264,Fargason; Sharon Gayle,6,0,26,20
1715616520329,EDS 128B,A01,507293,Pappas; Elizabeth,10,0,30,20
1715616521355,EDS 139,A00,507294,Fargason; Sharon Gayle,10,0,30,20
1715616521355,EDS 139,B00,507313,Pappas; Elizabeth,11,0,30,19
1715616522379,EDS 201,A00,507315,Staff,10,0,30,20
1715616523409,EDS 203,A01,507317,Halter; Christopher P.,10,0,30,20
1715616524435,EDS 204R,A01,507319,Halter; Christopher P.,0,3,30,30
1715616524435,EDS 204R,B01,507331,Heinzman; Erica M.,14,0,30,16
1715616525463,EDS 206R,A00,507332,Staff,0,4,30,30
1715616525463,EDS 206R,B00,507343,Staff,15,0,30,15
1715616526488,EDS 250,A00,507344,Hemans; Patricia Ann Benitez,20,0,40,20
1715616527516,EDS 281,A00,507345,Daly; Alan J.,18,0,18,0
1715616528540,EDS 284,A00,507350,Daly; Alan J.,16,0,16,0
1715616529566,EDS 286,A00,507359,Fine; Sarah,18,0,18,0
1715616530589,EDS 289C,A01,507361,Daly; Alan J.,18,0,18,0
1715616531615,EDS 290,A00,507366,Hofstetter; Carolyn,15,0,15,0
1715616532642,LIGM 5A,A00,507421,Fischer-Grunski; Eva K,17,0,20,3
1715616533666,LIGM 5B,A00,507423,Fischer-Grunski; Eva K,19,0,20,1
1715616534694,LIGM 5C,A00,507425,Fischer-Grunski; Eva K,19,0,20,1
1715616535720,LIIT 5AS,A00,507427,Carnelos; Chiara,20,0,20,0
1715616536745,LIIT 5BS,A00,507430,Carnelos; Chiara,20,0,20,0
1715616537771,LIIT 5CS,A00,507432,Carnelos; Chiara,20,0,20,0
1715616538796,LISP 5A,A00,507541,Munoz Sanchez; Alicia,11,0,20,9
1715616539822,LISP 5B,A00,507671,Munoz Sanchez; Alicia,9,0,20,11
1715616540851,LISP 5C,A00,507696,Munoz Sanchez; Alicia,9,0,20,11
1715616541878,MAE 197,001,528363,Boechler; Nicholas Sebastia,9998,0,9999,1
1715616542911,MATH 197,001,523477,Kedlaya; Kiran S.,9994,0,9999,5
1715616542911,MATH 197,002,563811,Zhang; Danna,9994,0,9999,5
1715616542911,MATH 197,003,628552,Dumitriu; Ioana,9998,0,9999,1
1715616542911,MATH 197,004,660885,Floyd; Eric,9999,0,9999,0
1715616543941,MCWP 40R,A00,518780,Staff,2,0,20,18
1715616543941,MCWP 40R,B00,518781,Staff,11,0,20,9
1715616543941,MCWP 40R,C00,518783,Staff,5,0,20,15
1715616544970,MCWP 50R,A00,518791,Staff,0,1,20,20
1715616544970,MCWP 50R,B00,518792,Staff,0,2,20,20
1715616544970,MCWP 50R,C00,518793,Staff,0,4,20,20
1715616544970,MCWP 50R,D00,518794,Staff,0,1,20,20
1715616544970,MCWP 50R,E00,518795,Staff,0,2,20,20
1715616544970,MCWP 50R,F00,518796,Staff,0,1,20,20
1715616544970,MCWP 50R,G00,518797,Staff,0,1,20,20
1715616545996,MMW 12R,A01,514034,Herbst; Matthew,0,2,16,16
1715616545996,MMW 12R,A02,514035,Herbst; Matthew,0,0,16,16
1715616547023,MMW 13R,A01,514037,Staff,0,5,16,16
1715616547023,MMW 13R,A02,514039,Staff,0,5,16,16
1715616547023,MMW 13R,A03,628519,Staff,0,4,16,16
1715616549081,SIO 295LS,A00,523233,Staff,10,0,30,20
1715616550107,SIO 295S,A00,523232,Staff,10,0,30,20
1715616551137,SIOC 290S,A01,637330,Merrifield; Mark A,23,0,30,7
1715616552162,SIOC 291S,A01,637333,Gabriel; Corey John,23,0,30,7
1715616553189,SOCI 117,A01,494376,Staff,0,5,5,5
1715616554215,WES 237B,A00,494380,Staff,10,0,20,10
1715616556292,AESE 279B,A00,494370,Wade; Jon P,0,0,33,33
1715616557322,AIP 97,001,660915,Van Den Einde; Yael Dahlia,9998,0,9999,1
1715616558358,AIP 197,001,627712,Vespa; Emanuel Ignacio,9995,0,9999,4
1715616558358,AIP 197,002,650778,Amir; On,9998,0,9999,1
1715616558358,AIP 197,003,650933,Avenancio-Leon; Carlos,9998,0,9999,1
1715616558358,AIP 197,004,658530,Heyman; Gail D.,9998,0,9999,1
1715616558358,AIP 197,005,658631,Neal; Sonya E,9998,0,9999,1
1715616558358,AIP 197,006,658671,Du; Songzi,9998,0,9999,1
1715616559383,ANAR 135S,A00,494369,Braswell; Geoffrey E.,0,0,0,0
1715616560410,BENG 196,001,628496,Engler; Adam J.,9998,0,9999,1
1715616560410,BENG 196,002,660916,Watson; John Thomas,9999,0,9999,0
1715616561436,BISP 197,001,650773,Wilhelm; James E.,9994,0,9999,5
1715616561436,BISP 197,002,658904,Coleman; Aaron B.,9998,0,9999,1
1715616562464,CAT 124RS,A01,519847,Geibel; William,0,0,20,20
1715616563492,CAT 125RS,A01,515971,Geibel; William,0,0,20,20
1715616564519,CLRE 250,A00,511389,Morris; Sheldon,9992,0,9999,7
1715616565552,CLRE 251,A00,507176,Mehta; Ravindra L.,9992,0,9999,7
1715616565552,CLRE 251,B00,511410,Mehta; Ravindra L.,9998,0,9999,1
1715616566578,CLRE 252,A00,507189,Cuomo; Raphael Eduardo,9994,0,9999,5
1715616567605,CLRE 253,A00,507199,Vaida; Florin,9994,0,9999,5
1715616567605,CLRE 253,B00,507202,Vaida; Florin,9999,0,9999,0
1715616568634,CLRE 259,A00,507211,Patel; Hemal,9996,0,9999,3
1715616569660,CLRE 260,A00,507221,Cuomo; Raphael Eduardo,9999,0,9999,0
1715616570687,CLRE 297,001,507242,Cuomo; Raphael Eduardo,9999,0,9999,0
1715616571716,COGS 197,001,638244,Voytek; Bradley Thomas,9997,0,9999,2
1715616572741,CSE 191,A00,516875,Minnes Kemp; Mor Mia,9991,0,9999,8
1715616573765,CSE 197,001,637388,Minnes Kemp; Mor Mia,9992,0,9999,7
1715616574797,CSS 201S,A01,494383,Mignozzetti; Umberto,35,0,35,0
1715616575826,CSS 202S,A01,494387,Mignozzetti; Umberto,35,0,35,0
1715616576853,DSC 197,001,628532,Eldridge; Justin Matthew,9995,0,9999,4
1715616577879,EAP 100,A00,516065,Staff,9799,0,9999,200
1715616578907,ECE 45,A01,507414,Staff,31,0,60,29
1715616580958,ECE 111,A01,507420,Staff,11,0,50,39
1715616581987,ECE 197,001,548057,Sievenpiper; Daniel F.,9991,0,9999,8
1715616583015,EDS 115,A00,507243,Choi; Bailey Miyeon,7,0,28,21
1715616584040,EDS 117,A01,494379,Staff,0,6,34,34
1715616585069,EDS 125,A00,507246,Hopkins; Megan Beth,8,0,30,22
1715616586094,EDS 128A,A01,507264,Fargason; Sharon Gayle,6,0,26,20
1715616587122,EDS 128B,A01,507293,Pappas; Elizabeth,10,0,30,20
1715616588147,EDS 139,A00,507294,Fargason; Sharon Gayle,10,0,30,20
1715616588147,EDS 139,B00,507313,Pappas; Elizabeth,11,0,30,19
1715616589180,EDS 201,A00,507315,Staff,10,0,30,20
1715616590211,EDS 203,A01,507317,Halter; Christopher P.,10,0,30,20
1715616610588,EDS 204R,A01,507319,Halter; Christopher P.,0,3,30,30
1715616610588,EDS 204R,B01,507331,Heinzman; Erica M.,14,0,30,16
1715616611615,EDS 206R,A00,507332,Staff,0,4,30,30
1715616611615,EDS 206R,B00,507343,Staff,15,0,30,15
1715616612642,EDS 250,A00,507344,Hemans; Patricia Ann Benitez,20,0,40,20
1715616613666,EDS 281,A00,507345,Daly; Alan J.,18,0,18,0
1715616614691,EDS 284,A00,507350,Daly; Alan J.,16,0,16,0
1715616615716,EDS 286,A00,507359,Fine; Sarah,18,0,18,0
1715616616743,EDS 289C,A01,507361,Daly; Alan J.,18,0,18,0
1715616617773,EDS 290,A00,507366,Hofstetter; Carolyn,15,0,15,0
1715616618800,LIGM 5A,A00,507421,Fischer-Grunski; Eva K,17,0,20,3
1715616619825,LIGM 5B,A00,507423,Fischer-Grunski; Eva K,19,0,20,1
1715616620856,LIGM 5C,A00,507425,Fischer-Grunski; Eva K,19,0,20,1
1715616621881,LIIT 5AS,A00,507427,Carnelos; Chiara,20,0,20,0
1715616622909,LIIT 5BS,A00,507430,Carnelos; Chiara,20,0,20,0
1715616623935,LIIT 5CS,A00,507432,Carnelos; Chiara,20,0,20,0
1715616624965,LISP 5A,A00,507541,Munoz Sanchez; Alicia,11,0,20,9
1715616625990,LISP 5B,A00,507671,Munoz Sanchez; Alicia,9,0,20,11
1715616627015,LISP 5C,A00,507696,Munoz Sanchez; Alicia,9,0,20,11
1715616628040,MAE 197,001,528363,Boechler; Nicholas Sebastia,9998,0,9999,1
1715616629069,MATH 197,001,523477,Kedlaya; Kiran S.,9994,0,9999,5
1715616629069,MATH 197,002,563811,Zhang; Danna,9994,0,9999,5
1715616629069,MATH 197,003,628552,Dumitriu; Ioana,9998,0,9999,1
1715616629069,MATH 197,004,660885,Floyd; Eric,9999,0,9999,0
1715616630096,MCWP 40R,A00,518780,Staff,2,0,20,18
1715616630096,MCWP 40R,B00,518781,Staff,11,0,20,9
1715616630096,MCWP 40R,C00,518783,Staff,5,0,20,15
1715616631123,MCWP 50R,A00,518791,Staff,0,1,20,20
1715616631123,MCWP 50R,B00,518792,Staff,0,2,20,20
1715616631123,MCWP 50R,C00,518793,Staff,0,4,20,20
1715616631123,MCWP 50R,D00,518794,Staff,0,1,20,20
1715616631123,MCWP 50R,E00,518795,Staff,0,2,20,20
1715616631123,MCWP 50R,F00,518796,Staff,0,1,20,20
1715616631123,MCWP 50R,G00,518797,Staff,0,1,20,20
1715616632150,MMW 12R,A01,514034,Herbst; Matthew,0,2,16,16
1715616632150,MMW 12R,A02,514035,Herbst; Matthew,0,0,16,16
1715616633175,MMW 13R,A01,514037,Staff,0,5,16,16
1715616633175,MMW 13R,A02,514039,Staff,0,5,16,16
1715616633175,MMW 13R,A03,628519,Staff,0,4,16,16
1715616635232,SIO 295LS,A00,523233,Staff,10,0,30,20
1715616636258,SIO 295S,A00,523232,Staff,10,0,30,20
1715616637287,SIOC 290S,A01,637330,Merrifield; Mark A,23,0,30,7
1715616638314,SIOC 291S,A01,637333,Gabriel; Corey John,23,0,30,7
1715616639342,SOCI 117,A01,494376,Staff,0,5,5,5
1715616640367,WES 237B,A00,494380,Staff,10,0,20,10
1715616642437,AESE 279B,A00,494370,Wade; Jon P,0,0,33,33
1715616643465,AIP 97,001,660915,Van Den Einde; Yael Dahlia,9998,0,9999,1
1715616644490,AIP 197,001,627712,Vespa; Emanuel Ignacio,9995,0,9999,4
1715616644490,AIP 197,002,650778,Amir; On,9998,0,9999,1
1715616644490,AIP 197,003,650933,Avenancio-Leon; Carlos,9998,0,9999,1
1715616644490,AIP 197,004,658530,Heyman; Gail D.,9998,0,9999,1
1715616644490,AIP 197,005,658631,Neal; Sonya E,9998,0,9999,1
1715616644490,AIP 197,006,658671,Du; Songzi,9998,0,9999,1
1715616645517,ANAR 135S,A00,494369,Braswell; Geoffrey E.,0,0,0,0
1715616646543,BENG 196,001,628496,Engler; Adam J.,9998,0,9999,1
1715616646543,BENG 196,002,660916,Watson; John Thomas,9999,0,9999,0
1715616647569,BISP 197,001,650773,Wilhelm; James E.,9994,0,9999,5
1715616647569,BISP 197,002,658904,Coleman; Aaron B.,9998,0,9999,1
1715616648596,CAT 124RS,A01,519847,Geibel; William,0,0,20,20
1715616649620,CAT 125RS,A01,515971,Geibel; William,0,0,20,20
1715616650645,CLRE 250,A00,511389,Morris; Sheldon,9992,0,9999,7
1715616651673,CLRE 251,A00,507176,Mehta; Ravindra L.,9992,0,9999,7
1715616651673,CLRE 251,B00,511410,Mehta; Ravindra L.,9998,0,9999,1
1715616652705,CLRE 252,A00,507189,Cuomo; Raphael Eduardo,9994,0,9999,5
1715616653734,CLRE 253,A00,507199,Vaida; Florin,9994,0,9999,5
1715616653734,CLRE 253,B00,507202,Vaida; Florin,9999,0,9999,0
1715616654758,CLRE 259,A00,507211,Patel; Hemal,9996,0,9999,3
1715616655785,CLRE 260,A00,507221,Cuomo; Raphael Eduardo,9999,0,9999,0
1715616656810,CLRE 297,001,507242,Cuomo; Raphael Eduardo,9999,0,9999,0
1715616657838,COGS 197,001,638244,Voytek; Bradley Thomas,9997,0,9999,2
1715616658864,CSE 191,A00,516875,Minnes Kemp; Mor Mia,9991,0,9999,8
1715616659890,CSE 197,001,637388,Minnes Kemp; Mor Mia,9992,0,9999,7
1715616660917,CSS 201S,A01,494383,Mignozzetti; Umberto,35,0,35,0
1715616661941,CSS 202S,A01,494387,Mignozzetti; Umberto,35,0,35,0
1715616662966,DSC 197,001,628532,Eldridge; Justin Matthew,9995,0,9999,4
1715616663993,EAP 100,A00,516065,Staff,9799,0,9999,200
1715616665022,ECE 45,A01,507414,Staff,31,0,60,29
1715616667075,ECE 111,A01,507420,Staff,11,0,50,39
1715616668103,ECE 197,001,548057,Sievenpiper; Daniel F.,9991,0,9999,8
1715616669144,EDS 115,A00,507243,Choi; Bailey Miyeon,7,0,28,21
1715616670170,EDS 117,A01,494379,Staff,0,6,34,34
1715616671196,EDS 125,A00,507246,Hopkins; Megan Beth,8,0,30,22
1715616672224,EDS 128A,A01,507264,Fargason; Sharon Gayle,6,0,26,20
1715616673250,EDS 128B,A01,507293,Pappas; Elizabeth,10,0,30,20
1715616674278,EDS 139,A00,507294,Fargason; Sharon Gayle,10,0,30,20
1715616674278,EDS 139,B00,507313,Pappas; Elizabeth,11,0,30,19
1715616675302,EDS 201,A00,507315,Staff,10,0,30,20
1715616676329,EDS 203,A01,507317,Halter; Christopher P.,10,0,30,20
1715616677355,EDS 204R,A01,507319,Halter; Christopher P.,0,3,30,30
1715616677355,EDS 204R,B01,507331,Heinzman; Erica M.,14,0,30,16
1715616678383,EDS 206R,A00,507332,Staff,0,4,30,30
1715616678383,EDS 206R,B00,507343,Staff,15,0,30,15
1715616679410,EDS 250,A00,507344,Hemans; Patricia Ann Benitez,20,0,40,20
1715616680438,EDS 281,A00,507345,Daly; Alan J.,18,0,18,0
1715616681462,EDS 284,A00,507350,Daly; Alan J.,16,0,16,0
1715616682488,EDS 286,A00,507359,Fine; Sarah,18,0,18,0
1715616683514,EDS 289C,A01,507361,Daly; Alan J.,18,0,18,0
1715616684539,EDS 290,A00,507366,Hofstetter; Carolyn,15,0,15,0
1715616685567,LIGM 5A,A00,507421,Fischer-Grunski; Eva K,17,0,20,3
1715616686594,LIGM 5B,A00,507423,Fischer-Grunski; Eva K,19,0,20,1
1715616687622,LIGM 5C,A00,507425,Fischer-Grunski; Eva K,19,0,20,1
1715616688651,LIIT 5AS,A00,507427,Carnelos; Chiara,20,0,20,0
1715616689676,LIIT 5BS,A00,507430,Carnelos; Chiara,20,0,20,0
1715616690702,LIIT 5CS,A00,507432,Carnelos; Chiara,20,0,20,0
1715616691729,LISP 5A,A00,507541,Munoz Sanchez; Alicia,11,0,20,9
1715616693273,LISP 5B,A00,507671,Munoz Sanchez; Alicia,9,0,20,11
1715616694299,LISP 5C,A00,507696,Munoz Sanchez; Alicia,9,0,20,11
1715616695325,MAE 197,001,528363,Boechler; Nicholas Sebastia,9998,0,9999,1
1715616696357,MATH 197,001,523477,Kedlaya; Kiran S.,9994,0,9999,5
1715616696357,MATH 197,002,563811,Zhang; Danna,9994,0,9999,5
1715616696357,MATH 197,003,628552,Dumitriu; Ioana,9998,0,9999,1
1715616696357,MATH 197,004,660885,Floyd; Eric,9999,0,9999,0
1715616697382,MCWP 40R,A00,518780,Staff,2,0,20,18
1715616697382,MCWP 40R,B00,518781,Staff,11,0,20,9
1715616697382,MCWP 40R,C00,518783,Staff,5,0,20,15
1715616698409,MCWP 50R,A00,518791,Staff,0,1,20,20
1715616698409,MCWP 50R,B00,518792,Staff,0,2,20,20
1715616698409,MCWP 50R,C00,518793,Staff,0,4,20,20
1715616698409,MCWP 50R,D00,518794,Staff,0,1,20,20
1715616698409,MCWP 50R,E00,518795,Staff,0,2,20,20
1715616698409,MCWP 50R,F00,518796,Staff,0,1,20,20
1715616698409,MCWP 50R,G00,518797,Staff,0,1,20,20
1715616699437,MMW 12R,A01,514034,Herbst; Matthew,0,2,16,16
1715616699437,MMW 12R,A02,514035,Herbst; Matthew,0,0,16,16
1715616700463,MMW 13R,A01,514037,Staff,0,5,16,16
1715616700463,MMW 13R,A02,514039,Staff,0,5,16,16
1715616700463,MMW 13R,A03,628519,Staff,0,4,16,16
1715616702520,SIO 295LS,A00,523233,Staff,10,0,30,20
1715616703548,SIO 295S,A00,523232,Staff,10,0,30,20
1715616704576,SIOC 290S,A01,637330,Merrifield; Mark A,23,0,30,7
1715616705601,SIOC 291S,A01,637333,Gabriel; Corey John,23,0,30,7
1715616706628,SOCI 117,A01,494376,Staff,0,5,5,5
1715616707654,WES 237B,A00,494380,Staff,10,0,20,10
1715616709732,AESE 279B,A00,494370,Wade; Jon P,0,0,33,33
1715616710761,AIP 97,001,660915,Van Den Einde; Yael Dahlia,9998,0,9999,1
1715616711790,AIP 197,001,627712,Vespa; Emanuel Ignacio,9995,0,9999,4
1715616711790,AIP 197,002,650778,Amir; On,9998,0,9999,1
1715616711790,AIP 197,003,650933,Avenancio-Leon; Carlos,9998,0,9999,1
1715616711790,AIP 197,004,658530,Heyman; Gail D.,9998,0,9999,1
1715616711790,AIP 197,005,658631,Neal; Sonya E,9998,0,9999,1
1715616711790,AIP 197,006,658671,Du; Songzi,9998,0,9999,1
1715616712816,ANAR 135S,A00,494369,Braswell; Geoffrey E.,0,0,0,0
1715616713844,BENG 196,001,628496,Engler; Adam J.,9998,0,9999,1
1715616713844,BENG 196,002,660916,Watson; John Thomas,9999,0,9999,0
1715616714890,BISP 197,001,650773,Wilhelm; James E.,9994,0,9999,5
1715616714890,BISP 197,002,658904,Coleman; Aaron B.,9998,0,9999,1
1715616715917,CAT 124RS,A01,519847,Geibel; William,0,0,20,20
1715616716944,CAT 125RS,A01,515971,Geibel; William,0,0,20,20
1715616717970,CLRE 250,A00,511389,Morris; Sheldon,9992,0,9999,7
1715616718994,CLRE 251,A00,507176,Mehta; Ravindra L.,9992,0,9999,7
1715616718994,CLRE 251,B00,511410,Mehta; Ravindra L.,9998,0,9999,1
1715616720022,CLRE 252,A00,507189,Cuomo; Raphael Eduardo,9994,0,9999,5
1715616721051,CLRE 253,A00,507199,Vaida; Florin,9994,0,9999,5
1715616721051,CLRE 253,B00,507202,Vaida; Florin,9999,0,9999,0
1715616722078,CLRE 259,A00,507211,Patel; Hemal,9996,0,9999,3
1715616723104,CLRE 260,A00,507221,Cuomo; Raphael Eduardo,9999,0,9999,0
1715616724128,CLRE 297,001,507242,Cuomo; Raphael Eduardo,9999,0,9999,0
1715616725158,COGS 197,001,638244,Voytek; Bradley Thomas,9997,0,9999,2
1715616726184,CSE 191,A00,516875,Minnes Kemp; Mor Mia,9991,0,9999,8
1715616727212,CSE 197,001,637388,Minnes Kemp; Mor Mia,9992,0,9999,7
1715616728241,CSS 201S,A01,494383,Mignozzetti; Umberto,35,0,35,0
1715616729267,CSS 202S,A01,494387,Mignozzetti; Umberto,35,0,35,0
1715616730292,DSC 197,001,628532,Eldridge; Justin Matthew,9995,0,9999,4
1715616731318,EAP 100,A00,516065,Staff,9799,0,9999,200
1715616732344,ECE 45,A01,507414,Staff,31,0,60,29
1715616734399,ECE 111,A01,507420,Staff,11,0,50,39
1715616735424,ECE 197,001,548057,Sievenpiper; Daniel F.,9991,0,9999,8
1715616736449,EDS 115,A00,507243,Choi; Bailey Miyeon,7,0,28,21
1715616737475,EDS 117,A01,494379,Staff,0,6,34,34
1715616738501,EDS 125,A00,507246,Hopkins; Megan Beth,8,0,30,22
1715616739529,EDS 128A,A01,507264,Fargason; Sharon Gayle,6,0,26,20
1715616740553,EDS 128B,A01,507293,Pappas; Elizabeth,10,0,30,20
1715616741578,EDS 139,A00,507294,Fargason; Sharon Gayle,10,0,30,20
1715616741578,EDS 139,B00,507313,Pappas; Elizabeth,11,0,30,19
1715616742623,EDS 201,A00,507315,Staff,10,0,30,20
1715616743651,EDS 203,A01,507317,Halter; Christopher P.,10,0,30,20
1715616744683,EDS 204R,A01,507319,Halter; Christopher P.,0,3,30,30
1715616744683,EDS 204R,B01,507331,Heinzman; Erica M.,14,0,30,16
1715616745710,EDS 206R,A00,507332,Staff,0,4,30,30
1715616745710,EDS 206R,B00,507343,Staff,15,0,30,15
1715616746734,EDS 250,A00,507344,Hemans; Patricia Ann Benitez,20,0,40,20
1715616747763,EDS 281,A00,507345,Daly; Alan J.,18,0,18,0
1715616748789,EDS 284,A00,507350,Daly; Alan J.,16,0,16,0
1715616749813,EDS 286,A00,507359,Fine; Sarah,18,0,18,0
1715616750838,EDS 289C,A01,507361,Daly; Alan J.,18,0,18,0
1715616751863,EDS 290,A00,507366,Hofstetter; Carolyn,15,0,15,0
1715616752892,LIGM 5A,A00,507421,Fischer-Grunski; Eva K,17,0,20,3
1715616753921,LIGM 5B,A00,507423,Fischer-Grunski; Eva K,19,0,20,1
1715616754947,LIGM 5C,A00,507425,Fischer-Grunski; Eva K,19,0,20,1
1715616755972,LIIT 5AS,A00,507427,Carnelos; Chiara,20,0,20,0
1715616757001,LIIT 5BS,A00,507430,Carnelos; Chiara,20,0,20,0
1715616758026,LIIT 5CS,A00,507432,Carnelos; Chiara,20,0,20,0
1715616759054,LISP 5A,A00,507541,Munoz Sanchez; Alicia,11,0,20,9
1715616760079,LISP 5B,A00,507671,Munoz Sanchez; Alicia,9,0,20,11
1715616761107,LISP 5C,A00,507696,Munoz Sanchez; Alicia,9,0,20,11
1715616762134,MAE 197,001,528363,Boechler; Nicholas Sebastia,9998,0,9999,1
1715616763161,MATH 197,001,523477,Kedlaya; Kiran S.,9994,0,9999,5
1715616763161,MATH 197,002,563811,Zhang; Danna,9994,0,9999,5
1715616763161,MATH 197,003,628552,Dumitriu; Ioana,9998,0,9999,1
1715616763161,MATH 197,004,660885,Floyd; Eric,9999,0,9999,0
1715616764191,MCWP 40R,A00,518780,Staff,2,0,20,18
1715616764191,MCWP 40R,B00,518781,Staff,11,0,20,9
1715616764191,MCWP 40R,C00,518783,Staff,5,0,20,15
1715616765220,MCWP 50R,A00,518791,Staff,0,1,20,20
1715616765220,MCWP 50R,B00,518792,Staff,0,2,20,20
1715616765220,MCWP 50R,C00,518793,Staff,0,4,20,20
1715616765220,MCWP 50R,D00,518794,Staff,0,1,20,20
1715616765220,MCWP 50R,E00,518795,Staff,0,2,20,20
1715616765220,MCWP 50R,F00,518796,Staff,0,1,20,20
1715616765220,MCWP 50R,G00,518797,Staff,0,1,20,20
1715616766249,MMW 12R,A01,514034,Herbst; Matthew,0,2,16,16
1715616766249,MMW 12R,A02,514035,Herbst; Matthew,0,0,16,16
1715616767277,MMW 13R,A01,514037,Staff,0,5,16,16
1715616767277,MMW 13R,A02,514039,Staff,0,5,16,16
1715616767277,MMW 13R,A03,628519,Staff,0,4,16,16
1715616769333,SIO 295LS,A00,523233,Staff,10,0,30,20
1715616770358,SIO 295S,A00,523232,Staff,10,0,30,20
1715616771384,SIOC 290S,A01,637330,Merrifield; Mark A,23,0,30,7
1715616772408,SIOC 291S,A01,637333,Gabriel; Corey John,23,0,30,7
1715616773434,SOCI 117,A01,494376,Staff,0,5,5,5
1715616774459,WES 237B,A00,494380,Staff,10,0,20,10
1715616776531,AESE 279B,A00,494370,Wade; Jon P,0,0,33,33
1715616777557,AIP 97,001,660915,Van Den Einde; Yael Dahlia,9998,0,9999,1
1715616778640,AIP 197,001,627712,Vespa; Emanuel Ignacio,9995,0,9999,4
1715616778640,AIP 197,002,650778,Amir; On,9998,0,9999,1
1715616778640,AIP 197,003,650933,Avenancio-Leon; Carlos,9998,0,9999,1
1715616778640,AIP 197,004,658530,Heyman; Gail D.,9998,0,9999,1
1715616778640,AIP 197,005,658631,Neal; Sonya E,9998,0,9999,1
1715616778640,AIP 197,006,658671,Du; Songzi,9998,0,9999,1
1715616779664,ANAR 135S,A00,494369,Braswell; Geoffrey E.,0,0,0,0
1715616780692,BENG 196,001,628496,Engler; Adam J.,9998,0,9999,1
1715616780692,BENG 196,002,660916,Watson; John Thomas,9999,0,9999,0
1715616781717,BISP 197,001,650773,Wilhelm; James E.,9994,0,9999,5
1715616781717,BISP 197,002,658904,Coleman; Aaron B.,9998,0,9999,1
1715616782744,CAT 124RS,A01,519847,Geibel; William,0,0,20,20
1715616783769,CAT 125RS,A01,515971,Geibel; William,0,0,20,20
1715616784796,CLRE 250,A00,511389,Morris; Sheldon,9992,0,9999,7
1715616785823,CLRE 251,A00,507176,Mehta; Ravindra L.,9992,0,9999,7
1715616785823,CLRE 251,B00,511410,Mehta; Ravindra L.,9998,0,9999,1
1715616786848,CLRE 252,A00,507189,Cuomo; Raphael Eduardo,9994,0,9999,5
1715616787876,CLRE 253,A00,507199,Vaida; Florin,9994,0,9999,5
1715616787876,CLRE 253,B00,507202,Vaida; Florin,9999,0,9999,0
1715616788905,CLRE 259,A00,507211,Patel; Hemal,9996,0,9999,3
1715616789932,CLRE 260,A00,507221,Cuomo; Raphael Eduardo,9999,0,9999,0
1715616790958,CLRE 297,001,507242,Cuomo; Raphael Eduardo,9999,0,9999,0
1715616791986,COGS 197,001,638244,Voytek; Bradley Thomas,9997,0,9999,2
1715616793013,CSE 191,A00,516875,Minnes Kemp; Mor Mia,9991,0,9999,8
1715616794044,CSE 197,001,637388,Minnes Kemp; Mor Mia,9992,0,9999,7
1715616795068,CSS 201S,A01,494383,Mignozzetti; Umberto,35,0,35,0
1715616796096,CSS 202S,A01,494387,Mignozzetti; Umberto,35,0,35,0
1715616797122,DSC 197,001,628532,Eldridge; Justin Matthew,9995,0,9999,4
1715616798148,EAP 100,A00,516065,Staff,9799,0,9999,200
1715616799177,ECE 45,A01,507414,Staff,31,0,60,29
1715616801226,ECE 111,A01,507420,Staff,11,0,50,39
1715616802251,ECE 197,001,548057,Sievenpiper; Daniel F.,9991,0,9999,8
1715616803279,EDS 115,A00,507243,Choi; Bailey Miyeon,7,0,28,21
1715616804303,EDS 117,A01,494379,Staff,0,6,34,34
1715616805331,EDS 125,A00,507246,Hopkins; Megan Beth,8,0,30,22
1715616806359,EDS 128A,A01,507264,Fargason; Sharon Gayle,6,0,26,20
1715616807387,EDS 128B,A01,507293,Pappas; Elizabeth,10,0,30,20
1715616808415,EDS 139,A00,507294,Fargason; Sharon Gayle,10,0,30,20
1715616808415,EDS 139,B00,507313,Pappas; Elizabeth,11,0,30,19
1715616809444,EDS 201,A00,507315,Staff,10,0,30,20
1715616810470,EDS 203,A01,507317,Halter; Christopher P.,10,0,30,20
1715616811495,EDS 204R,A01,507319,Halter; Christopher P.,0,3,30,30
1715616811495,EDS 204R,B01,507331,Heinzman; Erica M.,14,0,30,16
1715616812521,EDS 206R,A00,507332,Staff,0,4,30,30
1715616812521,EDS 206R,B00,507343,Staff,15,0,30,15
1715616813546,EDS 250,A00,507344,Hemans; Patricia Ann Benitez,20,0,40,20
1715616814571,EDS 281,A00,507345,Daly; Alan J.,18,0,18,0
1715616815598,EDS 284,A00,507350,Daly; Alan J.,16,0,16,0
1715616816627,EDS 286,A00,507359,Fine; Sarah,18,0,18,0
1715616817651,EDS 289C,A01,507361,Daly; Alan J.,18,0,18,0
1715616818681,EDS 290,A00,507366,Hofstetter; Carolyn,15,0,15,0
1715616819706,LIGM 5A,A00,507421,Fischer-Grunski; Eva K,17,0,20,3
1715616820731,LIGM 5B,A00,507423,Fischer-Grunski; Eva K,19,0,20,1
1715616821757,LIGM 5C,A00,507425,Fischer-Grunski; Eva K,19,0,20,1
1715616822785,LIIT 5AS,A00,507427,Carnelos; Chiara,20,0,20,0
1715616823814,LIIT 5BS,A00,507430,Carnelos; Chiara,20,0,20,0
1715616824842,LIIT 5CS,A00,507432,Carnelos; Chiara,20,0,20,0
1715616825867,LISP 5A,A00,507541,Munoz Sanchez; Alicia,11,0,20,9
1715616826897,LISP 5B,A00,507671,Munoz Sanchez; Alicia,9,0,20,11
1715616827922,LISP 5C,A00,507696,Munoz Sanchez; Alicia,9,0,20,11
1715616828950,MAE 197,001,528363,Boechler; Nicholas Sebastia,9998,0,9999,1
1715616829977,MATH 197,001,523477,Kedlaya; Kiran S.,9994,0,9999,5
1715616829977,MATH 197,002,563811,Zhang; Danna,9994,0,9999,5
1715616829977,MATH 197,003,628552,Dumitriu; Ioana,9998,0,9999,1
1715616829977,MATH 197,004,660885,Floyd; Eric,9999,0,9999,0
1715616831007,MCWP 40R,A00,518780,Staff,2,0,20,18
1715616831007,MCWP 40R,B00,518781,Staff,11,0,20,9
1715616831007,MCWP 40R,C00,518783,Staff,5,0,20,15
1715616832035,MCWP 50R,A00,518791,Staff,0,1,20,20
1715616832035,MCWP 50R,B00,518792,Staff,0,2,20,20
1715616832035,MCWP 50R,C00,518793,Staff,0,4,20,20
1715616832035,MCWP 50R,D00,518794,Staff,0,1,20,20
1715616832035,MCWP 50R,E00,518795,Staff,0,2,20,20
1715616832035,MCWP 50R,F00,518796,Staff,0,1,20,20
1715616832035,MCWP 50R,G00,518797,Staff,0,1,20,20
1715616833061,MMW 12R,A01,514034,Herbst; Matthew,0,2,16,16
1715616833061,MMW 12R,A02,514035,Herbst; Matthew,0,0,16,16
1715616834089,MMW 13R,A01,514037,Staff,0,5,16,16
1715616834089,MMW 13R,A02,514039,Staff,0,5,16,16
1715616834089,MMW 13R,A03,628519,Staff,0,4,16,16
1715616836141,SIO 295LS,A00,523233,Staff,10,0,30,20
1715616837169,SIO 295S,A00,523232,Staff,10,0,30,20
1715616838194,SIOC 290S,A01,637330,Merrifield; Mark A,23,0,30,7
1715616839220,SIOC 291S,A01,637333,Gabriel; Corey John,23,0,30,7
1715616840248,SOCI 117,A01,494376,Staff,0,5,5,5
1715616841277,WES 237B,A00,494380,Staff,10,0,20,10
1715616843345,AESE 279B,A00,494370,Wade; Jon P,0,0,33,33
1715616844371,AIP 97,001,660915,Van Den Einde; Yael Dahlia,9998,0,9999,1
1715616845399,AIP 197,001,627712,Vespa; Emanuel Ignacio,9995,0,9999,4
1715616845399,AIP 197,002,650778,Amir; On,9998,0,9999,1
1715616845399,AIP 197,003,650933,Avenancio-Leon; Carlos,9998,0,9999,1
1715616845399,AIP 197,004,658530,Heyman; Gail D.,9998,0,9999,1
1715616845399,AIP 197,005,658631,Neal; Sonya E,9998,0,9999,1
1715616845399,AIP 197,006,658671,Du; Songzi,9998,0,9999,1
1715616846427,ANAR 135S,A00,494369,Braswell; Geoffrey E.,0,0,0,0
1715616847455,BENG 196,001,628496,Engler; Adam J.,9998,0,9999,1
1715616847455,BENG 196,002,660916,Watson; John Thomas,9999,0,9999,0
1715616848482,BISP 197,001,650773,Wilhelm; James E.,9994,0,9999,5
1715616848482,BISP 197,002,658904,Coleman; Aaron B.,9998,0,9999,1
1715616849507,CAT 124RS,A01,519847,Geibel; William,0,0,20,20
1715616850534,CAT 125RS,A01,515971,Geibel; William,0,0,20,20
1715616851567,CLRE 250,A00,511389,Morris; Sheldon,9992,0,9999,7
1715616852594,CLRE 251,A00,507176,Mehta; Ravindra L.,9992,0,9999,7
1715616852594,CLRE 251,B00,511410,Mehta; Ravindra L.,9998,0,9999,1
1715616853621,CLRE 252,A00,507189,Cuomo; Raphael Eduardo,9994,0,9999,5
1715616854650,CLRE 253,A00,507199,Vaida; Florin,9994,0,9999,5
1715616854650,CLRE 253,B00,507202,Vaida; Florin,9999,0,9999,0
1715616855677,CLRE 259,A00,507211,Patel; Hemal,9996,0,9999,3
1715616856703,CLRE 260,A00,507221,Cuomo; Raphael Eduardo,9999,0,9999,0
1715616857730,CLRE 297,001,507242,Cuomo; Raphael Eduardo,9999,0,9999,0
1715616858756,COGS 197,001,638244,Voytek; Bradley Thomas,9997,0,9999,2
1715616859781,CSE 191,A00,516875,Minnes Kemp; Mor Mia,9991,0,9999,8
1715616860810,CSE 197,001,637388,Minnes Kemp; Mor Mia,9992,0,9999,7
1715616861836,CSS 201S,A01,494383,Mignozzetti; Umberto,35,0,35,0
1715616862861,CSS 202S,A01,494387,Mignozzetti; Umberto,35,0,35,0
1715616863898,DSC 197,001,628532,Eldridge; Justin Matthew,9995,0,9999,4
1715616864922,EAP 100,A00,516065,Staff,9799,0,9999,200
1715616865947,ECE 45,A01,507414,Staff,31,0,60,29
1715616868001,ECE 111,A01,507420,Staff,11,0,50,39
1715616869027,ECE 197,001,548057,Sievenpiper; Daniel F.,9991,0,9999,8
1715616870054,EDS 115,A00,507243,Choi; Bailey Miyeon,7,0,28,21
1715616871085,EDS 117,A01,494379,Staff,0,6,34,34
1715616872114,EDS 125,A00,507246,Hopkins; Megan Beth,8,0,30,22
1715616873139,EDS 128A,A01,507264,Fargason; Sharon Gayle,6,0,26,20
1715616874165,EDS 128B,A01,507293,Pappas; Elizabeth,10,0,30,20
1715616875192,EDS 139,A00,507294,Fargason; Sharon Gayle,10,0,30,20
1715616875192,EDS 139,B00,507313,Pappas; Elizabeth,11,0,30,19
1715616876221,EDS 201,A00,507315,Staff,10,0,30,20
1715616877246,EDS 203,A01,507317,Halter; Christopher P.,10,0,30,20
1715616878305,EDS 204R,A01,507319,Halter; Christopher P.,0,3,30,30
1715616878305,EDS 204R,B01,507331,Heinzman; Erica M.,14,0,30,16
1715616879330,EDS 206R,A00,507332,Staff,0,4,30,30
1715616879330,EDS 206R,B00,507343,Staff,15,0,30,15
1715616880357,EDS 250,A00,507344,Hemans; Patricia Ann Benitez,20,0,40,20
1715616881382,EDS 281,A00,507345,Daly; Alan J.,18,0,18,0
1715616882408,EDS 284,A00,507350,Daly; Alan J.,16,0,16,0
1715616883434,EDS 286,A00,507359,Fine; Sarah,18,0,18,0
1715616884459,EDS 289C,A01,507361,Daly; Alan J.,18,0,18,0
1715616885485,EDS 290,A00,507366,Hofstetter; Carolyn,15,0,15,0
1715616886514,LIGM 5A,A00,507421,Fischer-Grunski; Eva K,17,0,20,3
1715616887541,LIGM 5B,A00,507423,Fischer-Grunski; Eva K,19,0,20,1
1715616888569,LIGM 5C,A00,507425,Fischer-Grunski; Eva K,19,0,20,1
1715616889595,LIIT 5AS,A00,507427,Carnelos; Chiara,20,0,20,0
1715616890622,LIIT 5BS,A00,507430,Carnelos; Chiara,20,0,20,0
1715616891650,LIIT 5CS,A00,507432,Carnelos; Chiara,20,0,20,0
1715616892678,LISP 5A,A00,507541,Munoz Sanchez; Alicia,11,0,20,9
1715616893704,LISP 5B,A00,507671,Munoz Sanchez; Alicia,9,0,20,11
1715616894732,LISP 5C,A00,507696,Munoz Sanchez; Alicia,9,0,20,11
1715616895758,MAE 197,001,528363,Boechler; Nicholas Sebastia,9998,0,9999,1
1715616896786,MATH 197,001,523477,Kedlaya; Kiran S.,9994,0,9999,5
1715616896786,MATH 197,002,563811,Zhang; Danna,9994,0,9999,5
1715616896786,MATH 197,003,628552,Dumitriu; Ioana,9998,0,9999,1
1715616896786,MATH 197,004,660885,Floyd; Eric,9999,0,9999,0
1715616897814,MCWP 40R,A00,518780,Staff,2,0,20,18
1715616897814,MCWP 40R,B00,518781,Staff,11,0,20,9
1715616897814,MCWP 40R,C00,518783,Staff,5,0,20,15
1715616898839,MCWP 50R,A00,518791,Staff,0,1,20,20
1715616898839,MCWP 50R,B00,518792,Staff,0,2,20,20
1715616898839,MCWP 50R,C00,518793,Staff,0,4,20,20
1715616898839,MCWP 50R,D00,518794,Staff,0,1,20,20
1715616898839,MCWP 50R,E00,518795,Staff,0,2,20,20
1715616898839,MCWP 50R,F00,518796,Staff,0,1,20,20
1715616898839,MCWP 50R,G00,518797,Staff,0,1,20,20
1715616899866,MMW 12R,A01,514034,Herbst; Matthew,0,2,16,16
1715616899866,MMW 12R,A02,514035,Herbst; Matthew,0,0,16,16
1715616900893,MMW 13R,A01,514037,Staff,0,5,16,16
1715616900893,MMW 13R,A02,514039,Staff,0,5,16,16
1715616900893,MMW 13R,A03,628519,Staff,0,4,16,16
1715616902944,SIO 295LS,A00,523233,Staff,10,0,30,20
1715616903972,SIO 295S,A00,523232,Staff,10,0,30,20
1715616904998,SIOC 290S,A01,637330,Merrifield; Mark A,23,0,30,7
1715616906023,SIOC 291S,A01,637333,Gabriel; Corey John,23,0,30,7
1715616907051,SOCI 117,A01,494376,Staff,0,5,5,5
1715616908077,WES 237B,A00,494380,Staff,10,0,20,10
1715616910149,AESE 279B,A00,494370,Wade; Jon P,0,0,33,33
1715616911179,AIP 97,001,660915,Van Den Einde; Yael Dahlia,9998,0,9999,1
1715616912211,AIP 197,001,627712,Vespa; Emanuel Ignacio,9995,0,9999,4
1715616912211,AIP 197,002,650778,Amir; On,9998,0,9999,1
1715616912211,AIP 197,003,650933,Avenancio-Leon; Carlos,9998,0,9999,1
1715616912211,AIP 197,004,658530,Heyman; Gail D.,9998,0,9999,1
1715616912211,AIP 197,005,658631,Neal; Sonya E,9998,0,9999,1
1715616912211,AIP 197,006,658671,Du; Songzi,9998,0,9999,1
1715616913242,ANAR 135S,A00,494369,Braswell; Geoffrey E.,0,0,0,0
1715616914271,BENG 196,001,628496,Engler; Adam J.,9998,0,9999,1
1715616914271,BENG 196,002,660916,Watson; John Thomas,9999,0,9999,0
1715616915301,BISP 197,001,650773,Wilhelm; James E.,9994,0,9999,5
1715616915301,BISP 197,002,658904,Coleman; Aaron B.,9998,0,9999,1
1715616916327,CAT 124RS,A01,519847,Geibel; William,0,0,20,20
1715616917352,CAT 125RS,A01,515971,Geibel; William,0,0,20,20
1715616918380,CLRE 250,A00,511389,Morris; Sheldon,9992,0,9999,7
1715616919407,CLRE 251,A00,507176,Mehta; Ravindra L.,9992,0,9999,7
1715616919407,CLRE 251,B00,511410,Mehta; Ravindra L.,9998,0,9999,1
1715616920681,CLRE 252,A00,507189,Cuomo; Raphael Eduardo,9994,0,9999,5
1715616921706,CLRE 253,A00,507199,Vaida; Florin,9994,0,9999,5
1715616921706,CLRE 253,B00,507202,Vaida; Florin,9999,0,9999,0
1715616922736,CLRE 259,A00,507211,Patel; Hemal,9996,0,9999,3
1715616923764,CLRE 260,A00,507221,Cuomo; Raphael Eduardo,9999,0,9999,0
1715616924790,CLRE 297,001,507242,Cuomo; Raphael Eduardo,9999,0,9999,0
1715616925815,COGS 197,001,638244,Voytek; Bradley Thomas,9997,0,9999,2
1715616926844,CSE 191,A00,516875,Minnes Kemp; Mor Mia,9991,0,9999,8
1715616927868,CSE 197,001,637388,Minnes Kemp; Mor Mia,9992,0,9999,7
1715616928895,CSS 201S,A01,494383,Mignozzetti; Umberto,35,0,35,0
1715616929921,CSS 202S,A01,494387,Mignozzetti; Umberto,35,0,35,0
1715616930949,DSC 197,001,628532,Eldridge; Justin Matthew,9995,0,9999,4
1715616931977,EAP 100,A00,516065,Staff,9799,0,9999,200
1715616933009,ECE 45,A01,507414,Staff,31,0,60,29
1715616935059,ECE 111,A01,507420,Staff,11,0,50,39
1715616936088,ECE 197,001,548057,Sievenpiper; Daniel F.,9991,0,9999,8
1715616937114,EDS 115,A00,507243,Choi; Bailey Miyeon,7,0,28,21
1715616938141,EDS 117,A01,494379,Staff,0,6,34,34
1715616939167,EDS 125,A00,507246,Hopkins; Megan Beth,8,0,30,22
1715616940195,EDS 128A,A01,507264,Fargason; Sharon Gayle,6,0,26,20
1715616941221,EDS 128B,A01,507293,Pappas; Elizabeth,10,0,30,20
1715616942250,EDS 139,A00,507294,Fargason; Sharon Gayle,10,0,30,20
1715616942250,EDS 139,B00,507313,Pappas; Elizabeth,11,0,30,19
1715616943282,EDS 201,A00,507315,Staff,10,0,30,20
1715616944311,EDS 203,A01,507317,Halter; Christopher P.,10,0,30,20
1715616945337,EDS 204R,A01,507319,Halter; Christopher P.,0,3,30,30
1715616945337,EDS 204R,B01,507331,Heinzman; Erica M.,14,0,30,16
1715616946366,EDS 206R,A00,507332,Staff,0,4,30,30
1715616946366,EDS 206R,B00,507343,Staff,15,0,30,15
1715616947391,EDS 250,A00,507344,Hemans; Patricia Ann Benitez,20,0,40,20
1715616948416,EDS 281,A00,507345,Daly; Alan J.,18,0,18,0
1715616949443,EDS 284,A00,507350,Daly; Alan J.,16,0,16,0
1715616950473,EDS 286,A00,507359,Fine; Sarah,18,0,18,0
1715616951498,EDS 289C,A01,507361,Daly; Alan J.,18,0,18,0
1715616952522,EDS 290,A00,507366,Hofstetter; Carolyn,15,0,15,0
1715616953547,LIGM 5A,A00,507421,Fischer-Grunski; Eva K,17,0,20,3
1715616954576,LIGM 5B,A00,507423,Fischer-Grunski; Eva K,19,0,20,1
1715616955606,LIGM 5C,A00,507425,Fischer-Grunski; Eva K,19,0,20,1
1715616956634,LIIT 5AS,A00,507427,Carnelos; Chiara,20,0,20,0
1715616957658,LIIT 5BS,A00,507430,Carnelos; Chiara,20,0,20,0
1715616958685,LIIT 5CS,A00,507432,Carnelos; Chiara,20,0,20,0
1715616959712,LISP 5A,A00,507541,Munoz Sanchez; Alicia,11,0,20,9
1715616960737,LISP 5B,A00,507671,Munoz Sanchez; Alicia,9,0,20,11
1715616961765,LISP 5C,A00,507696,Munoz Sanchez; Alicia,9,0,20,11
1715616962790,MAE 197,001,528363,Boechler; Nicholas Sebastia,9998,0,9999,1
1715616963816,MATH 197,001,523477,Kedlaya; Kiran S.,9994,0,9999,5
1715616963816,MATH 197,002,563811,Zhang; Danna,9994,0,9999,5
1715616963816,MATH 197,003,628552,Dumitriu; Ioana,9998,0,9999,1
1715616963816,MATH 197,004,660885,Floyd; Eric,9999,0,9999,0
1715616964842,MCWP 40R,A00,518780,Staff,2,0,20,18
1715616964842,MCWP 40R,B00,518781,Staff,11,0,20,9
1715616964842,MCWP 40R,C00,518783,Staff,5,0,20,15
1715616965872,MCWP 50R,A00,518791,Staff,0,1,20,20
1715616965872,MCWP 50R,B00,518792,Staff,0,2,20,20
1715616965872,MCWP 50R,C00,518793,Staff,0,4,20,20
1715616965872,MCWP 50R,D00,518794,Staff,0,1,20,20
1715616965872,MCWP 50R,E00,518795,Staff,0,2,20,20
1715616965872,MCWP 50R,F00,518796,Staff,0,1,20,20
1715616965872,MCWP 50R,G00,518797,Staff,0,1,20,20
1715616966898,MMW 12R,A01,514034,Herbst; Matthew,0,2,16,16
1715616966898,MMW 12R,A02,514035,Herbst; Matthew,0,0,16,16
1715616967924,MMW 13R,A01,514037,Staff,0,5,16,16
1715616967924,MMW 13R,A02,514039,Staff,0,5,16,16
1715616967924,MMW 13R,A03,628519,Staff,0,4,16,16
1715616969979,SIO 295LS,A00,523233,Staff,10,0,30,20
1715616971003,SIO 295S,A00,523232,Staff,10,0,30,20
1715616972030,SIOC 290S,A01,637330,Merrifield; Mark A,23,0,30,7
1715616973059,SIOC 291S,A01,637333,Gabriel; Corey John,23,0,30,7
1715616974088,SOCI 117,A01,494376,Staff,0,5,5,5
1715616975115,WES 237B,A00,494380,Staff,10,0,20,10
1715616977175,AESE 279B,A00,494370,Wade; Jon P,0,0,33,33
1715616978201,AIP 97,001,660915,Van Den Einde; Yael Dahlia,9998,0,9999,1
1715616979231,AIP 197,001,627712,Vespa; Emanuel Ignacio,9995,0,9999,4
1715616979231,AIP 197,002,650778,Amir; On,9998,0,9999,1
1715616979231,AIP 197,003,650933,Avenancio-Leon; Carlos,9998,0,9999,1
1715616979231,AIP 197,004,658530,Heyman; Gail D.,9998,0,9999,1
1715616979231,AIP 197,005,658631,Neal; Sonya E,9998,0,9999,1
1715616979231,AIP 197,006,658671,Du; Songzi,9998,0,9999,1
1715616980254,ANAR 135S,A00,494369,Braswell; Geoffrey E.,0,0,0,0
1715616981282,BENG 196,001,628496,Engler; Adam J.,9998,0,9999,1
1715616981282,BENG 196,002,660916,Watson; John Thomas,9999,0,9999,0
1715616982311,BISP 197,001,650773,Wilhelm; James E.,9994,0,9999,5
1715616982311,BISP 197,002,658904,Coleman; Aaron B.,9998,0,9999,1
1715616983336,CAT 124RS,A01,519847,Geibel; William,0,0,20,20
1715616984362,CAT 125RS,A01,515971,Geibel; William,0,0,20,20
1715616985386,CLRE 250,A00,511389,Morris; Sheldon,9992,0,9999,7
1715616986488,CLRE 251,A00,507176,Mehta; Ravindra L.,9992,0,9999,7
1715616986488,CLRE 251,B00,511410,Mehta; Ravindra L.,9998,0,9999,1
1715616987513,CLRE 252,A00,507189,Cuomo; Raphael Eduardo,9994,0,9999,5
1715616988539,CLRE 253,A00,507199,Vaida; Florin,9994,0,9999,5
1715616988539,CLRE 253,B00,507202,Vaida; Florin,9999,0,9999,0
1715616989567,CLRE 259,A00,507211,Patel; Hemal,9996,0,9999,3
1715616990595,CLRE 260,A00,507221,Cuomo; Raphael Eduardo,9999,0,9999,0
1715616991622,CLRE 297,001,507242,Cuomo; Raphael Eduardo,9999,0,9999,0
1715616992647,COGS 197,001,638244,Voytek; Bradley Thomas,9997,0,9999,2
1715616993675,CSE 191,A00,516875,Minnes Kemp; Mor Mia,9991,0,9999,8
1715616994701,CSE 197,001,637388,Minnes Kemp; Mor Mia,9992,0,9999,7
1715616995732,CSS 201S,A01,494383,Mignozzetti; Umberto,35,0,35,0
1715616996758,CSS 202S,A01,494387,Mignozzetti; Umberto,35,0,35,0
1715616997782,DSC 197,001,628532,Eldridge; Justin Matthew,9995,0,9999,4
1715616998807,EAP 100,A00,516065,Staff,9799,0,9999,200
1715616999834,ECE 45,A01,507414,Staff,31,0,60,29
1715617001890,ECE 111,A01,507420,Staff,11,0,50,39
1715617002917,ECE 197,001,548057,Sievenpiper; Daniel F.,9991,0,9999,8
1715617003945,EDS 115,A00,507243,Choi; Bailey Miyeon,7,0,28,21
1715617004973,EDS 117,A01,494379,Staff,0,6,34,34
1715617005997,EDS 125,A00,507246,Hopkins; Megan Beth,8,0,30,22
1715617007027,EDS 128A,A01,507264,Fargason; Sharon Gayle,6,0,26,20
1715617008052,EDS 128B,A01,507293,Pappas; Elizabeth,10,0,30,20
1715617009081,EDS 139,A00,507294,Fargason; Sharon Gayle,10,0,30,20
1715617009081,EDS 139,B00,507313,Pappas; Elizabeth,11,0,30,19
1715617010106,EDS 201,A00,507315,Staff,10,0,30,20
1715617011136,EDS 203,A01,507317,Halter; Christopher P.,10,0,30,20
1715617012164,EDS 204R,A01,507319,Halter; Christopher P.,0,3,30,30
1715617012164,EDS 204R,B01,507331,Heinzman; Erica M.,14,0,30,16
1715617013190,EDS 206R,A00,507332,Staff,0,4,30,30
1715617013190,EDS 206R,B00,507343,Staff,15,0,30,15
1715617014218,EDS 250,A00,507344,Hemans; Patricia Ann Benitez,20,0,40,20
1715617015245,EDS 281,A00,507345,Daly; Alan J.,18,0,18,0
1715617016270,EDS 284,A00,507350,Daly; Alan J.,16,0,16,0
1715617017296,EDS 286,A00,507359,Fine; Sarah,18,0,18,0
1715617018319,EDS 289C,A01,507361,Daly; Alan J.,18,0,18,0
1715617019347,EDS 290,A00,507366,Hofstetter; Carolyn,15,0,15,0
1715617020373,LIGM 5A,A00,507421,Fischer-Grunski; Eva K,17,0,20,3
1715617021400,LIGM 5B,A00,507423,Fischer-Grunski; Eva K,19,0,20,1
1715617022428,LIGM 5C,A00,507425,Fischer-Grunski; Eva K,19,0,20,1
1715617023458,LIIT 5AS,A00,507427,Carnelos; Chiara,20,0,20,0
1715617024483,LIIT 5BS,A00,507430,Carnelos; Chiara,20,0,20,0
1715617025513,LIIT 5CS,A00,507432,Carnelos; Chiara,20,0,20,0
1715617026539,LISP 5A,A00,507541,Munoz Sanchez; Alicia,11,0,20,9
1715617027567,LISP 5B,A00,507671,Munoz Sanchez; Alicia,9,0,20,11
1715617028593,LISP 5C,A00,507696,Munoz Sanchez; Alicia,9,0,20,11
1715617029621,MAE 197,001,528363,Boechler; Nicholas Sebastia,9998,0,9999,1
1715617030647,MATH 197,001,523477,Kedlaya; Kiran S.,9994,0,9999,5
1715617030647,MATH 197,002,563811,Zhang; Danna,9994,0,9999,5
1715617030647,MATH 197,003,628552,Dumitriu; Ioana,9998,0,9999,1
1715617030647,MATH 197,004,660885,Floyd; Eric,9999,0,9999,0
1715617031673,MCWP 40R,A00,518780,Staff,2,0,20,18
1715617031673,MCWP 40R,B00,518781,Staff,11,0,20,9
1715617031673,MCWP 40R,C00,518783,Staff,5,0,20,15
1715617032702,MCWP 50R,A00,518791,Staff,0,1,20,20
1715617032702,MCWP 50R,B00,518792,Staff,0,2,20,20
1715617032702,MCWP 50R,C00,518793,Staff,0,4,20,20
1715617032702,MCWP 50R,D00,518794,Staff,0,1,20,20
1715617032702,MCWP 50R,E00,518795,Staff,0,2,20,20
1715617032702,MCWP 50R,F00,518796,Staff,0,1,20,20
1715617032702,MCWP 50R,G00,518797,Staff,0,1,20,20
1715617033726,MMW 12R,A01,514034,Herbst; Matthew,0,2,16,16
1715617033726,MMW 12R,A02,514035,Herbst; Matthew,0,0,16,16
1715617034751,MMW 13R,A01,514037,Staff,0,5,16,16
1715617034751,MMW 13R,A02,514039,Staff,0,5,16,16
1715617034751,MMW 13R,A03,628519,Staff,0,4,16,16
1715617036800,SIO 295LS,A00,523233,Staff,10,0,30,20
1715617037828,SIO 295S,A00,523232,Staff,10,0,30,20
1715617038853,SIOC 290S,A01,637330,Merrifield; Mark A,23,0,30,7
1715617039878,SIOC 291S,A01,637333,Gabriel; Corey John,23,0,30,7
1715617040907,SOCI 117,A01,494376,Staff,0,5,5,5
1715617041936,WES 237B,A00,494380,Staff,10,0,20,10
1715617043997,AESE 279B,A00,494370,Wade; Jon P,0,0,33,33
1715617045021,AIP 97,001,660915,Van Den Einde; Yael Dahlia,9998,0,9999,1
1715617046047,AIP 197,001,627712,Vespa; Emanuel Ignacio,9995,0,9999,4
1715617046047,AIP 197,002,650778,Amir; On,9998,0,9999,1
1715617046047,AIP 197,003,650933,Avenancio-Leon; Carlos,9998,0,9999,1
1715617046047,AIP 197,004,658530,Heyman; Gail D.,9998,0,9999,1
1715617046047,AIP 197,005,658631,Neal; Sonya E,9998,0,9999,1
1715617046047,AIP 197,006,658671,Du; Songzi,9998,0,9999,1
1715617047073,ANAR 135S,A00,494369,Braswell; Geoffrey E.,0,0,0,0
1715617048098,BENG 196,001,628496,Engler; Adam J.,9998,0,9999,1
1715617048098,BENG 196,002,660916,Watson; John Thomas,9999,0,9999,0
1715617049125,BISP 197,001,650773,Wilhelm; James E.,9994,0,9999,5
1715617049125,BISP 197,002,658904,Coleman; Aaron B.,9998,0,9999,1
1715617050151,CAT 124RS,A01,519847,Geibel; William,0,0,20,20
1715617051179,CAT 125RS,A01,515971,Geibel; William,0,0,20,20
1715617052207,CLRE 250,A00,511389,Morris; Sheldon,9992,0,9999,7
1715617053234,CLRE 251,A00,507176,Mehta; Ravindra L.,9992,0,9999,7
1715617053234,CLRE 251,B00,511410,Mehta; Ravindra L.,9998,0,9999,1
1715617054260,CLRE 252,A00,507189,Cuomo; Raphael Eduardo,9994,0,9999,5
1715617055285,CLRE 253,A00,507199,Vaida; Florin,9994,0,9999,5
1715617055285,CLRE 253,B00,507202,Vaida; Florin,9999,0,9999,0
1715617056311,CLRE 259,A00,507211,Patel; Hemal,9996,0,9999,3
1715617057336,CLRE 260,A00,507221,Cuomo; Raphael Eduardo,9999,0,9999,0
1715617058361,CLRE 297,001,507242,Cuomo; Raphael Eduardo,9999,0,9999,0
1715617059385,COGS 197,001,638244,Voytek; Bradley Thomas,9997,0,9999,2
1715617060410,CSE 191,A00,516875,Minnes Kemp; Mor Mia,9991,0,9999,8
1715617061440,CSE 197,001,637388,Minnes Kemp; Mor Mia,9992,0,9999,7
1715617062473,CSS 201S,A01,494383,Mignozzetti; Umberto,35,0,35,0
1715617063510,CSS 202S,A01,494387,Mignozzetti; Umberto,35,0,35,0
1715617064533,DSC 197,001,628532,Eldridge; Justin Matthew,9995,0,9999,4
1715617065559,EAP 100,A00,516065,Staff,9799,0,9999,200
1715617066586,ECE 45,A01,507414,Staff,31,0,60,29
1715617068638,ECE 111,A01,507420,Staff,11,0,50,39
1715617069666,ECE 197,001,548057,Sievenpiper; Daniel F.,9991,0,9999,8
1715617070690,EDS 115,A00,507243,Choi; Bailey Miyeon,7,0,28,21
1715617071717,EDS 117,A01,494379,Staff,0,6,34,34
1715617072741,EDS 125,A00,507246,Hopkins; Megan Beth,8,0,30,22
1715617073769,EDS 128A,A01,507264,Fargason; Sharon Gayle,6,0,26,20
1715617074797,EDS 128B,A01,507293,Pappas; Elizabeth,10,0,30,20
1715617075822,EDS 139,A00,507294,Fargason; Sharon Gayle,10,0,30,20
1715617075822,EDS 139,B00,507313,Pappas; Elizabeth,11,0,30,19
1715617076849,EDS 201,A00,507315,Staff,10,0,30,20
1715617077873,EDS 203,A01,507317,Halter; Christopher P.,10,0,30,20
1715617078901,EDS 204R,A01,507319,Halter; Christopher P.,0,3,30,30
1715617078901,EDS 204R,B01,507331,Heinzman; Erica M.,14,0,30,16
1715617079926,EDS 206R,A00,507332,Staff,0,4,30,30
1715617079926,EDS 206R,B00,507343,Staff,15,0,30,15
1715617080952,EDS 250,A00,507344,Hemans; Patricia Ann Benitez,20,0,40,20
1715617081979,EDS 281,A00,507345,Daly; Alan J.,18,0,18,0
1715617083005,EDS 284,A00,507350,Daly; Alan J.,16,0,16,0
1715617084032,EDS 286,A00,507359,Fine; Sarah,18,0,18,0
1715617085056,EDS 289C,A01,507361,Daly; Alan J.,18,0,18,0
1715617086081,EDS 290,A00,507366,Hofstetter; Carolyn,15,0,15,0
1715617087106,LIGM 5A,A00,507421,Fischer-Grunski; Eva K,17,0,20,3
1715617088133,LIGM 5B,A00,507423,Fischer-Grunski; Eva K,19,0,20,1
1715617089158,LIGM 5C,A00,507425,Fischer-Grunski; Eva K,19,0,20,1
1715617090261,LIIT 5AS,A00,507427,Carnelos; Chiara,20,0,20,0
1715617091288,LIIT 5BS,A00,507430,Carnelos; Chiara,20,0,20,0
1715617092318,LIIT 5CS,A00,507432,Carnelos; Chiara,20,0,20,0
1715617093347,LISP 5A,A00,507541,Munoz Sanchez; Alicia,11,0,20,9
1715617094372,LISP 5B,A00,507671,Munoz Sanchez; Alicia,9,0,20,11
1715617095399,LISP 5C,A00,507696,Munoz Sanchez; Alicia,9,0,20,11
1715617096424,MAE 197,001,528363,Boechler; Nicholas Sebastia,9998,0,9999,1
1715617097455,MATH 197,001,523477,Kedlaya; Kiran S.,9994,0,9999,5
1715617097455,MATH 197,002,563811,Zhang; Danna,9994,0,9999,5
1715617097455,MATH 197,003,628552,Dumitriu; Ioana,9998,0,9999,1
1715617097455,MATH 197,004,660885,Floyd; Eric,9999,0,9999,0
1715617098484,MCWP 40R,A00,518780,Staff,2,0,20,18
1715617098484,MCWP 40R,B00,518781,Staff,11,0,20,9
1715617098484,MCWP 40R,C00,518783,Staff,5,0,20,15
1715617099513,MCWP 50R,A00,518791,Staff,0,1,20,20
1715617099513,MCWP 50R,B00,518792,Staff,0,2,20,20
1715617099513,MCWP 50R,C00,518793,Staff,0,4,20,20
1715617099513,MCWP 50R,D00,518794,Staff,0,1,20,20
1715617099513,MCWP 50R,E00,518795,Staff,0,2,20,20
1715617099513,MCWP 50R,F00,518796,Staff,0,1,20,20
1715617099513,MCWP 50R,G00,518797,Staff,0,1,20,20
1715617100541,MMW 12R,A01,514034,Herbst; Matthew,0,2,16,16
1715617100541,MMW 12R,A02,514035,Herbst; Matthew,0,0,16,16
1715617101570,MMW 13R,A01,514037,Staff,0,5,16,16
1715617101570,MMW 13R,A02,514039,Staff,0,5,16,16
1715617101570,MMW 13R,A03,628519,Staff,0,4,16,16
1715617103622,SIO 295LS,A00,523233,Staff,10,0,30,20
1715617104649,SIO 295S,A00,523232,Staff,10,0,30,20
1715617105675,SIOC 290S,A01,637330,Merrifield; Mark A,23,0,30,7
1715617106700,SIOC 291S,A01,637333,Gabriel; Corey John,23,0,30,7
1715617107728,SOCI 117,A01,494376,Staff,0,5,5,5
1715617108754,WES 237B,A00,494380,Staff,10,0,20,10
1715617110819,AESE 279B,A00,494370,Wade; Jon P,0,0,33,33
1715617111847,AIP 97,001,660915,Van Den Einde; Yael Dahlia,9998,0,9999,1
1715617112881,AIP 197,001,627712,Vespa; Emanuel Ignacio,9995,0,9999,4
1715617112881,AIP 197,002,650778,Amir; On,9998,0,9999,1
1715617112881,AIP 197,003,650933,Avenancio-Leon; Carlos,9998,0,9999,1
1715617112881,AIP 197,004,658530,Heyman; Gail D.,9998,0,9999,1
1715617112881,AIP 197,005,658631,Neal; Sonya E,9998,0,9999,1
1715617112881,AIP 197,006,658671,Du; Songzi,9998,0,9999,1
1715617113906,ANAR 135S,A00,494369,Braswell; Geoffrey E.,0,0,0,0
1715617114932,BENG 196,001,628496,Engler; Adam J.,9998,0,9999,1
1715617114932,BENG 196,002,660916,Watson; John Thomas,9999,0,9999,0
1715617115957,BISP 197,001,650773,Wilhelm; James E.,9994,0,9999,5
1715617115957,BISP 197,002,658904,Coleman; Aaron B.,9998,0,9999,1
1715617116983,CAT 124RS,A01,519847,Geibel; William,0,0,20,20
1715617118007,CAT 125RS,A01,515971,Geibel; William,0,0,20,20
1715617119031,CLRE 250,A00,511389,Morris; Sheldon,9992,0,9999,7
1715617120056,CLRE 251,A00,507176,Mehta; Ravindra L.,9992,0,9999,7
1715617120056,CLRE 251,B00,511410,Mehta; Ravindra L.,9998,0,9999,1
1715617121082,CLRE 252,A00,507189,Cuomo; Raphael Eduardo,9994,0,9999,5
1715617122109,CLRE 253,A00,507199,Vaida; Florin,9994,0,9999,5
1715617122109,CLRE 253,B00,507202,Vaida; Florin,9999,0,9999,0
1715617123135,CLRE 259,A00,507211,Patel; Hemal,9996,0,9999,3
1715617124161,CLRE 260,A00,507221,Cuomo; Raphael Eduardo,9999,0,9999,0
1715617125189,CLRE 297,001,507242,Cuomo; Raphael Eduardo,9999,0,9999,0
1715617126216,COGS 197,001,638244,Voytek; Bradley Thomas,9997,0,9999,2
1715617127243,CSE 191,A00,516875,Minnes Kemp; Mor Mia,9991,0,9999,8
1715617128267,CSE 197,001,637388,Minnes Kemp; Mor Mia,9992,0,9999,7
1715617129292,CSS 201S,A01,494383,Mignozzetti; Umberto,35,0,35,0
1715617130319,CSS 202S,A01,494387,Mignozzetti; Umberto,35,0,35,0
1715617131343,DSC 197,001,628532,Eldridge; Justin Matthew,9995,0,9999,4
1715617132371,EAP 100,A00,516065,Staff,9799,0,9999,200
1715617133399,ECE 45,A01,507414,Staff,31,0,60,29
1715617135456,ECE 111,A01,507420,Staff,11,0,50,39
1715617136482,ECE 197,001,548057,Sievenpiper; Daniel F.,9991,0,9999,8
1715617137510,EDS 115,A00,507243,Choi; Bailey Miyeon,7,0,28,21
1715617138537,EDS 117,A01,494379,Staff,0,6,34,34
1715617139563,EDS 125,A00,507246,Hopkins; Megan Beth,8,0,30,22
1715617140591,EDS 128A,A01,507264,Fargason; Sharon Gayle,6,0,26,20
1715617141616,EDS 128B,A01,507293,Pappas; Elizabeth,10,0,30,20
1715617142644,EDS 139,A00,507294,Fargason; Sharon Gayle,10,0,30,20
1715617142644,EDS 139,B00,507313,Pappas; Elizabeth,11,0,30,19
1715617143670,EDS 201,A00,507315,Staff,10,0,30,20
1715617144695,EDS 203,A01,507317,Halter; Christopher P.,10,0,30,20
1715617145727,EDS 204R,A01,507319,Halter; Christopher P.,0,3,30,30
1715617145727,EDS 204R,B01,507331,Heinzman; Erica M.,14,0,30,16
1715617146756,EDS 206R,A00,507332,Staff,0,4,30,30
1715617146756,EDS 206R,B00,507343,Staff,15,0,30,15
1715617147780,EDS 250,A00,507344,Hemans; Patricia Ann Benitez,20,0,40,20
1715617148809,EDS 281,A00,507345,Daly; Alan J.,18,0,18,0
1715617149836,EDS 284,A00,507350,Daly; Alan J.,16,0,16,0
1715617150863,EDS 286,A00,507359,Fine; Sarah,18,0,18,0
1715617151891,EDS 289C,A01,507361,Daly; Alan J.,18,0,18,0
1715617152916,EDS 290,A00,507366,Hofstetter; Carolyn,15,0,15,0
1715617153943,LIGM 5A,A00,507421,Fischer-Grunski; Eva K,17,0,20,3
1715617154969,LIGM 5B,A00,507423,Fischer-Grunski; Eva K,19,0,20,1
1715617155998,LIGM 5C,A00,507425,Fischer-Grunski; Eva K,19,0,20,1
1715617157024,LIIT 5AS,A00,507427,Carnelos; Chiara,20,0,20,0
1715617158052,LIIT 5BS,A00,507430,Carnelos; Chiara,20,0,20,0
1715617159080,LIIT 5CS,A00,507432,Carnelos; Chiara,20,0,20,0
1715617160107,LISP 5A,A00,507541,Munoz Sanchez; Alicia,11,0,20,9
1715617161135,LISP 5B,A00,507671,Munoz Sanchez; Alicia,9,0,20,11
1715617162162,LISP 5C,A00,507696,Munoz Sanchez; Alicia,9,0,20,11
1715617163188,MAE 197,001,528363,Boechler; Nicholas Sebastia,9998,0,9999,1
1715617164215,MATH 197,001,523477,Kedlaya; Kiran S.,9994,0,9999,5
1715617164215,MATH 197,002,563811,Zhang; Danna,9994,0,9999,5
1715617164215,MATH 197,003,628552,Dumitriu; Ioana,9998,0,9999,1
1715617164215,MATH 197,004,660885,Floyd; Eric,9999,0,9999,0
1715617165239,MCWP 40R,A00,518780,Staff,2,0,20,18
1715617165239,MCWP 40R,B00,518781,Staff,11,0,20,9
1715617165239,MCWP 40R,C00,518783,Staff,5,0,20,15
1715617166267,MCWP 50R,A00,518791,Staff,0,1,20,20
1715617166267,MCWP 50R,B00,518792,Staff,0,2,20,20
1715617166267,MCWP 50R,C00,518793,Staff,0,4,20,20
1715617166267,MCWP 50R,D00,518794,Staff,0,1,20,20
1715617166267,MCWP 50R,E00,518795,Staff,0,2,20,20
1715617166267,MCWP 50R,F00,518796,Staff,0,1,20,20
1715617166267,MCWP 50R,G00,518797,Staff,0,1,20,20
1715617167294,MMW 12R,A01,514034,Herbst; Matthew,0,2,16,16
1715617167294,MMW 12R,A02,514035,Herbst; Matthew,0,0,16,16
1715617168322,MMW 13R,A01,514037,Staff,0,5,16,16
1715617168322,MMW 13R,A02,514039,Staff,0,5,16,16
1715617168322,MMW 13R,A03,628519,Staff,0,4,16,16
1715617170377,SIO 295LS,A00,523233,Staff,10,0,30,20
1715617171402,SIO 295S,A00,523232,Staff,10,0,30,20
1715617172431,SIOC 290S,A01,637330,Merrifield; Mark A,23,0,30,7
1715617173457,SIOC 291S,A01,637333,Gabriel; Corey John,23,0,30,7
1715617174482,SOCI 117,A01,494376,Staff,0,5,5,5
1715617175507,WES 237B,A00,494380,Staff,10,0,20,10
1715617177586,AESE 279B,A00,494370,Wade; Jon P,0,0,33,33
1715617178612,AIP 97,001,660915,Van Den Einde; Yael Dahlia,9998,0,9999,1
1715617179638,AIP 197,001,627712,Vespa; Emanuel Ignacio,9995,0,9999,4
1715617179638,AIP 197,002,650778,Amir; On,9998,0,9999,1
1715617179638,AIP 197,003,650933,Avenancio-Leon; Carlos,9998,0,9999,1
1715617179638,AIP 197,004,658530,Heyman; Gail D.,9998,0,9999,1
1715617179638,AIP 197,005,658631,Neal; Sonya E,9998,0,9999,1
1715617179638,AIP 197,006,658671,Du; Songzi,9998,0,9999,1
1715617180661,ANAR 135S,A00,494369,Braswell; Geoffrey E.,0,0,0,0
1715617181687,BENG 196,001,628496,Engler; Adam J.,9998,0,9999,1
1715617181687,BENG 196,002,660916,Watson; John Thomas,9999,0,9999,0
1715617182714,BISP 197,001,650773,Wilhelm; James E.,9994,0,9999,5
1715617182714,BISP 197,002,658904,Coleman; Aaron B.,9998,0,9999,1
1715617183739,CAT 124RS,A01,519847,Geibel; William,0,0,20,20
1715617184763,CAT 125RS,A01,515971,Geibel; William,0,0,20,20
1715617185789,CLRE 250,A00,511389,Morris; Sheldon,9992,0,9999,7
1715617186816,CLRE 251,A00,507176,Mehta; Ravindra L.,9992,0,9999,7
1715617186816,CLRE 251,B00,511410,Mehta; Ravindra L.,9998,0,9999,1
1715617187842,CLRE 252,A00,507189,Cuomo; Raphael Eduardo,9994,0,9999,5
1715617188867,CLRE 253,A00,507199,Vaida; Florin,9994,0,9999,5
1715617188867,CLRE 253,B00,507202,Vaida; Florin,9999,0,9999,0
1715617189892,CLRE 259,A00,507211,Patel; Hemal,9996,0,9999,3
1715617190916,CLRE 260,A00,507221,Cuomo; Raphael Eduardo,9999,0,9999,0
1715617191941,CLRE 297,001,507242,Cuomo; Raphael Eduardo,9999,0,9999,0
1715617192966,COGS 197,001,638244,Voytek; Bradley Thomas,9997,0,9999,2
1715617194048,CSE 191,A00,516875,Minnes Kemp; Mor Mia,9991,0,9999,8
1715617195073,CSE 197,001,637388,Minnes Kemp; Mor Mia,9992,0,9999,7
1715617196103,CSS 201S,A01,494383,Mignozzetti; Umberto,35,0,35,0
1715617197130,CSS 202S,A01,494387,Mignozzetti; Umberto,35,0,35,0
1715617198156,DSC 197,001,628532,Eldridge; Justin Matthew,9995,0,9999,4
1715617199181,EAP 100,A00,516065,Staff,9799,0,9999,200
1715617200212,ECE 45,A01,507414,Staff,31,0,60,29
1715617202266,ECE 111,A01,507420,Staff,11,0,50,39
1715617203295,ECE 197,001,548057,Sievenpiper; Daniel F.,9991,0,9999,8
1715617204321,EDS 115,A00,507243,Choi; Bailey Miyeon,7,0,28,21
1715617205351,EDS 117,A01,494379,Staff,0,6,34,34
1715617206376,EDS 125,A00,507246,Hopkins; Megan Beth,8,0,30,22
1715617207403,EDS 128A,A01,507264,Fargason; Sharon Gayle,6,0,26,20
1715617208433,EDS 128B,A01,507293,Pappas; Elizabeth,10,0,30,20
1715617209462,EDS 139,A00,507294,Fargason; Sharon Gayle,10,0,30,20
1715617209462,EDS 139,B00,507313,Pappas; Elizabeth,11,0,30,19
1715617210491,EDS 201,A00,507315,Staff,10,0,30,20
1715617211516,EDS 203,A01,507317,Halter; Christopher P.,10,0,30,20
1715617212540,EDS 204R,A01,507319,Halter; Christopher P.,0,3,30,30
1715617212540,EDS 204R,B01,507331,Heinzman; Erica M.,14,0,30,16
1715617213566,EDS 206R,A00,507332,Staff,0,4,30,30
1715617213566,EDS 206R,B00,507343,Staff,15,0,30,15
1715617214593,EDS 250,A00,507344,Hemans; Patricia Ann Benitez,20,0,40,20
1715617215621,EDS 281,A00,507345,Daly; Alan J.,18,0,18,0
1715617216650,EDS 284,A00,507350,Daly; Alan J.,16,0,16,0
1715617217676,EDS 286,A00,507359,Fine; Sarah,18,0,18,0
1715617218701,EDS 289C,A01,507361,Daly; Alan J.,18,0,18,0
1715617219727,EDS 290,A00,507366,Hofstetter; Carolyn,15,0,15,0
1715617220755,LIGM 5A,A00,507421,Fischer-Grunski; Eva K,17,0,20,3
1715617221781,LIGM 5B,A00,507423,Fischer-Grunski; Eva K,19,0,20,1
1715617222806,LIGM 5C,A00,507425,Fischer-Grunski; Eva K,19,0,20,1
1715617223831,LIIT 5AS,A00,507427,Carnelos; Chiara,20,0,20,0
1715617224861,LIIT 5BS,A00,507430,Carnelos; Chiara,20,0,20,0
1715617225887,LIIT 5CS,A00,507432,Carnelos; Chiara,20,0,20,0
1715617226914,LISP 5A,A00,507541,Munoz Sanchez; Alicia,11,0,20,9
1715617227943,LISP 5B,A00,507671,Munoz Sanchez; Alicia,9,0,20,11
1715617228973,LISP 5C,A00,507696,Munoz Sanchez; Alicia,9,0,20,11
1715617229999,MAE 197,001,528363,Boechler; Nicholas Sebastia,9998,0,9999,1
1715617231025,MATH 197,001,523477,Kedlaya; Kiran S.,9994,0,9999,5
1715617231025,MATH 197,002,563811,Zhang; Danna,9994,0,9999,5
1715617231025,MATH 197,003,628552,Dumitriu; Ioana,9998,0,9999,1
1715617231025,MATH 197,004,660885,Floyd; Eric,9999,0,9999,0
1715617232050,MCWP 40R,A00,518780,Staff,2,0,20,18
1715617232050,MCWP 40R,B00,518781,Staff,11,0,20,9
1715617232050,MCWP 40R,C00,518783,Staff,5,0,20,15
1715617233076,MCWP 50R,A00,518791,Staff,0,1,20,20
1715617233076,MCWP 50R,B00,518792,Staff,0,2,20,20
1715617233076,MCWP 50R,C00,518793,Staff,0,4,20,20
1715617233076,MCWP 50R,D00,518794,Staff,0,1,20,20
1715617233076,MCWP 50R,E00,518795,Staff,0,2,20,20
1715617233076,MCWP 50R,F00,518796,Staff,0,1,20,20
1715617233076,MCWP 50R,G00,518797,Staff,0,1,20,20
1715617234104,MMW 12R,A01,514034,Herbst; Matthew,0,2,16,16
1715617234104,MMW 12R,A02,514035,Herbst; Matthew,0,0,16,16
1715617235132,MMW 13R,A01,514037,Staff,0,5,16,16
1715617235132,MMW 13R,A02,514039,Staff,0,5,16,16
1715617235132,MMW 13R,A03,628519,Staff,0,4,16,16
1715617237182,SIO 295LS,A00,523233,Staff,10,0,30,20
1715617238210,SIO 295S,A00,523232,Staff,10,0,30,20
1715617239235,SIOC 290S,A01,637330,Merrifield; Mark A,23,0,30,7
1715617240262,SIOC 291S,A01,637333,Gabriel; Corey John,23,0,30,7
1715617241287,SOCI 117,A01,494376,Staff,0,5,5,5
1715617242313,WES 237B,A00,494380,Staff,10,0,20,10
1715617244384,AESE 279B,A00,494370,Wade; Jon P,0,0,33,33
1715617245412,AIP 97,001,660915,Van Den Einde; Yael Dahlia,9998,0,9999,1
1715617246440,AIP 197,001,627712,Vespa; Emanuel Ignacio,9995,0,9999,4
1715617246440,AIP 197,002,650778,Amir; On,9998,0,9999,1
1715617246440,AIP 197,003,650933,Avenancio-Leon; Carlos,9998,0,9999,1
1715617246440,AIP 197,004,658530,Heyman; Gail D.,9998,0,9999,1
1715617246440,AIP 197,005,658631,Neal; Sonya E,9998,0,9999,1
1715617246440,AIP 197,006,658671,Du; Songzi,9998,0,9999,1
1715617247467,ANAR 135S,A00,494369,Braswell; Geoffrey E.,0,0,0,0
1715617248493,BENG 196,001,628496,Engler; Adam J.,9998,0,9999,1
1715617248493,BENG 196,002,660916,Watson; John Thomas,9999,0,9999,0
1715617249524,BISP 197,001,650773,Wilhelm; James E.,9994,0,9999,5
1715617249524,BISP 197,002,658904,Coleman; Aaron B.,9998,0,9999,1
1715617250553,CAT 124RS,A01,519847,Geibel; William,0,0,20,20
1715617251580,CAT 125RS,A01,515971,Geibel; William,0,0,20,20
1715617252611,CLRE 250,A00,511389,Morris; Sheldon,9992,0,9999,7
1715617253638,CLRE 251,A00,507176,Mehta; Ravindra L.,9992,0,9999,7
1715617253638,CLRE 251,B00,511410,Mehta; Ravindra L.,9998,0,9999,1
1715617254667,CLRE 252,A00,507189,Cuomo; Raphael Eduardo,9994,0,9999,5
1715617255692,CLRE 253,A00,507199,Vaida; Florin,9994,0,9999,5
1715617255692,CLRE 253,B00,507202,Vaida; Florin,9999,0,9999,0
1715617256720,CLRE 259,A00,507211,Patel; Hemal,9996,0,9999,3
1715617257747,CLRE 260,A00,507221,Cuomo; Raphael Eduardo,9999,0,9999,0
1715617258772,CLRE 297,001,507242,Cuomo; Raphael Eduardo,9999,0,9999,0
1715617259799,COGS 197,001,638244,Voytek; Bradley Thomas,9997,0,9999,2
1715617260828,CSE 191,A00,516875,Minnes Kemp; Mor Mia,9991,0,9999,8
1715617261855,CSE 197,001,637388,Minnes Kemp; Mor Mia,9992,0,9999,7
1715617262888,CSS 201S,A01,494383,Mignozzetti; Umberto,35,0,35,0
1715617263913,CSS 202S,A01,494387,Mignozzetti; Umberto,35,0,35,0
1715617264938,DSC 197,001,628532,Eldridge; Justin Matthew,9995,0,9999,4
1715617265964,EAP 100,A00,516065,Staff,9799,0,9999,200
1715617266995,ECE 45,A01,507414,Staff,31,0,60,29
1715617269051,ECE 111,A01,507420,Staff,11,0,50,39
1715617270079,ECE 197,001,548057,Sievenpiper; Daniel F.,9991,0,9999,8
1715617271107,EDS 115,A00,507243,Choi; Bailey Miyeon,7,0,28,21
1715617272133,EDS 117,A01,494379,Staff,0,6,34,34
1715617273161,EDS 125,A00,507246,Hopkins; Megan Beth,8,0,30,22
1715617274188,EDS 128A,A01,507264,Fargason; Sharon Gayle,6,0,26,20
1715617275217,EDS 128B,A01,507293,Pappas; Elizabeth,10,0,30,20
1715617276240,EDS 139,A00,507294,Fargason; Sharon Gayle,10,0,30,20
1715617276240,EDS 139,B00,507313,Pappas; Elizabeth,11,0,30,19
1715617277265,EDS 201,A00,507315,Staff,10,0,30,20
1715617278293,EDS 203,A01,507317,Halter; Christopher P.,10,0,30,20
1715617279320,EDS 204R,A01,507319,Halter; Christopher P.,0,3,30,30
1715617279320,EDS 204R,B01,507331,Heinzman; Erica M.,14,0,30,16
1715617280570,EDS 206R,A00,507332,Staff,0,4,30,30
1715617280570,EDS 206R,B00,507343,Staff,15,0,30,15
1715617281596,EDS 250,A00,507344,Hemans; Patricia Ann Benitez,20,0,40,20
1715617282622,EDS 281,A00,507345,Daly; Alan J.,18,0,18,0
1715617283648,EDS 284,A00,507350,Daly; Alan J.,16,0,16,0
1715617284674,EDS 286,A00,507359,Fine; Sarah,18,0,18,0
1715617285699,EDS 289C,A01,507361,Daly; Alan J.,18,0,18,0
1715617286724,EDS 290,A00,507366,Hofstetter; Carolyn,15,0,15,0
1715617287750,LIGM 5A,A00,507421,Fischer-Grunski; Eva K,17,0,20,3
1715617288779,LIGM 5B,A00,507423,Fischer-Grunski; Eva K,19,0,20,1
1715617289810,LIGM 5C,A00,507425,Fischer-Grunski; Eva K,19,0,20,1
1715617290838,LIIT 5AS,A00,507427,Carnelos; Chiara,20,0,20,0
1715617291864,LIIT 5BS,A00,507430,Carnelos; Chiara,20,0,20,0
1715617292891,LIIT 5CS,A00,507432,Carnelos; Chiara,20,0,20,0
1715617293916,LISP 5A,A00,507541,Munoz Sanchez; Alicia,11,0,20,9
1715617294940,LISP 5B,A00,507671,Munoz Sanchez; Alicia,9,0,20,11
1715617295968,LISP 5C,A00,507696,Munoz Sanchez; Alicia,9,0,20,11
1715617296998,MAE 197,001,528363,Boechler; Nicholas Sebastia,9998,0,9999,1
1715617298078,MATH 197,001,523477,Kedlaya; Kiran S.,9994,0,9999,5
1715617298078,MATH 197,002,563811,Zhang; Danna,9994,0,9999,5
1715617298078,MATH 197,003,628552,Dumitriu; Ioana,9998,0,9999,1
1715617298078,MATH 197,004,660885,Floyd; Eric,9999,0,9999,0
1715617299104,MCWP 40R,A00,518780,Staff,2,0,20,18
1715617299104,MCWP 40R,B00,518781,Staff,11,0,20,9
1715617299104,MCWP 40R,C00,518783,Staff,5,0,20,15
1715617300131,MCWP 50R,A00,518791,Staff,0,1,20,20
1715617300131,MCWP 50R,B00,518792,Staff,0,2,20,20
1715617300131,MCWP 50R,C00,518793,Staff,0,4,20,20
1715617300131,MCWP 50R,D00,518794,Staff,0,1,20,20
1715617300131,MCWP 50R,E00,518795,Staff,0,2,20,20
1715617300131,MCWP 50R,F00,518796,Staff,0,1,20,20
1715617300131,MCWP 50R,G00,518797,Staff,0,1,20,20
1715617301157,MMW 12R,A01,514034,Herbst; Matthew,0,2,16,16
1715617301157,MMW 12R,A02,514035,Herbst; Matthew,0,0,16,16
1715617302186,MMW 13R,A01,514037,Staff,0,5,16,16
1715617302186,MMW 13R,A02,514039,Staff,0,5,16,16
1715617302186,MMW 13R,A03,628519,Staff,0,4,16,16
1715617304241,SIO 295LS,A00,523233,Staff,10,0,30,20
1715617305267,SIO 295S,A00,523232,Staff,10,0,30,20
1715617306295,SIOC 290S,A01,637330,Merrifield; Mark A,23,0,30,7
1715617307322,SIOC 291S,A01,637333,Gabriel; Corey John,23,0,30,7
1715617308352,SOCI 117,A01,494376,Staff,0,5,5,5
1715617309380,WES 237B,A00,494380,Staff,10,0,20,10
1715617311454,AESE 279B,A00,494370,Wade; Jon P,0,0,33,33
1715617312481,AIP 97,001,660915,Van Den Einde; Yael Dahlia,9998,0,9999,1
1715617313511,AIP 197,001,627712,Vespa; Emanuel Ignacio,9995,0,9999,4
1715617313511,AIP 197,002,650778,Amir; On,9998,0,9999,1
1715617313511,AIP 197,003,650933,Avenancio-Leon; Carlos,9998,0,9999,1
1715617313511,AIP 197,004,658530,Heyman; Gail D.,9998,0,9999,1
1715617313511,AIP 197,005,658631,Neal; Sonya E,9998,0,9999,1
1715617313511,AIP 197,006,658671,Du; Songzi,9998,0,9999,1
1715617314536,ANAR 135S,A00,494369,Braswell; Geoffrey E.,0,0,0,0
1715617315566,BENG 196,001,628496,Engler; Adam J.,9998,0,9999,1
1715617315566,BENG 196,002,660916,Watson; John Thomas,9999,0,9999,0
1715617316591,BISP 197,001,650773,Wilhelm; James E.,9994,0,9999,5
1715617316591,BISP 197,002,658904,Coleman; Aaron B.,9998,0,9999,1
1715617317618,CAT 124RS,A01,519847,Geibel; William,0,0,20,20
1715617318648,CAT 125RS,A01,515971,Geibel; William,0,0,20,20
1715617319678,CLRE 250,A00,511389,Morris; Sheldon,9992,0,9999,7
1715617320704,CLRE 251,A00,507176,Mehta; Ravindra L.,9992,0,9999,7
1715617320704,CLRE 251,B00,511410,Mehta; Ravindra L.,9998,0,9999,1
1715617321733,CLRE 252,A00,507189,Cuomo; Raphael Eduardo,9994,0,9999,5
1715617322765,CLRE 253,A00,507199,Vaida; Florin,9994,0,9999,5
1715617322765,CLRE 253,B00,507202,Vaida; Florin,9999,0,9999,0
1715617323791,CLRE 259,A00,507211,Patel; Hemal,9996,0,9999,3
1715617324820,CLRE 260,A00,507221,Cuomo; Raphael Eduardo,9999,0,9999,0
1715617325849,CLRE 297,001,507242,Cuomo; Raphael Eduardo,9999,0,9999,0
1715617326875,COGS 197,001,638244,Voytek; Bradley Thomas,9997,0,9999,2
1715617327901,CSE 191,A00,516875,Minnes Kemp; Mor Mia,9991,0,9999,8
1715617328927,CSE 197,001,637388,Minnes Kemp; Mor Mia,9992,0,9999,7
1715617329956,CSS 201S,A01,494383,Mignozzetti; Umberto,35,0,35,0
1715617330980,CSS 202S,A01,494387,Mignozzetti; Umberto,35,0,35,0
1715617332007,DSC 197,001,628532,Eldridge; Justin Matthew,9995,0,9999,4
1715617333033,EAP 100,A00,516065,Staff,9799,0,9999,200
1715617334061,ECE 45,A01,507414,Staff,31,0,60,29
1715617336114,ECE 111,A01,507420,Staff,11,0,50,39
1715617337140,ECE 197,001,548057,Sievenpiper; Daniel F.,9991,0,9999,8
1715617338169,EDS 115,A00,507243,Choi; Bailey Miyeon,7,0,28,21
1715617339196,EDS 117,A01,494379,Staff,0,6,34,34
1715617340221,EDS 125,A00,507246,Hopkins; Megan Beth,8,0,30,22
1715617341245,EDS 128A,A01,507264,Fargason; Sharon Gayle,6,0,26,20
1715617342271,EDS 128B,A01,507293,Pappas; Elizabeth,10,0,30,20
1715617343297,EDS 139,A00,507294,Fargason; Sharon Gayle,10,0,30,20
1715617343297,EDS 139,B00,507313,Pappas; Elizabeth,11,0,30,19
1715617344322,EDS 201,A00,507315,Staff,10,0,30,20
1715617345352,EDS 203,A01,507317,Halter; Christopher P.,10,0,30,20
1715617346378,EDS 204R,A01,507319,Halter; Christopher P.,0,3,30,30
1715617346378,EDS 204R,B01,507331,Heinzman; Erica M.,14,0,30,16
1715617347403,EDS 206R,A00,507332,Staff,0,4,30,30
1715617347403,EDS 206R,B00,507343,Staff,15,0,30,15
1715617348427,EDS 250,A00,507344,Hemans; Patricia Ann Benitez,20,0,40,20
1715617349452,EDS 281,A00,507345,Daly; Alan J.,18,0,18,0
1715617350480,EDS 284,A00,507350,Daly; Alan J.,16,0,16,0
1715617351507,EDS 286,A00,507359,Fine; Sarah,18,0,18,0
1715617352536,EDS 289C,A01,507361,Daly; Alan J.,18,0,18,0
1715617353563,EDS 290,A00,507366,Hofstetter; Carolyn,15,0,15,0
1715617354590,LIGM 5A,A00,507421,Fischer-Grunski; Eva K,17,0,20,3
1715617355617,LIGM 5B,A00,507423,Fischer-Grunski; Eva K,19,0,20,1
1715617356644,LIGM 5C,A00,507425,Fischer-Grunski; Eva K,19,0,20,1
1715617357670,LIIT 5AS,A00,507427,Carnelos; Chiara,20,0,20,0
1715617358694,LIIT 5BS,A00,507430,Carnelos; Chiara,20,0,20,0
1715617359718,LIIT 5CS,A00,507432,Carnelos; Chiara,20,0,20,0
1715617360750,LISP 5A,A00,507541,Munoz Sanchez; Alicia,11,0,20,9
1715617361778,LISP 5B,A00,507671,Munoz Sanchez; Alicia,9,0,20,11
1715617362804,LISP 5C,A00,507696,Munoz Sanchez; Alicia,9,0,20,11
1715617363830,MAE 197,001,528363,Boechler; Nicholas Sebastia,9998,0,9999,1
1715617364857,MATH 197,001,523477,Kedlaya; Kiran S.,9994,0,9999,5
1715617364857,MATH 197,002,563811,Zhang; Danna,9994,0,9999,5
1715617364857,MATH 197,003,628552,Dumitriu; Ioana,9998,0,9999,1
1715617364857,MATH 197,004,660885,Floyd; Eric,9999,0,9999,0
1715617365883,MCWP 40R,A00,518780,Staff,2,0,20,18
1715617365883,MCWP 40R,B00,518781,Staff,11,0,20,9
1715617365883,MCWP 40R,C00,518783,Staff,5,0,20,15
1715617366910,MCWP 50R,A00,518791,Staff,0,1,20,20
1715617366910,MCWP 50R,B00,518792,Staff,0,2,20,20
1715617366910,MCWP 50R,C00,518793,Staff,0,4,20,20
1715617366910,MCWP 50R,D00,518794,Staff,0,1,20,20
1715617366910,MCWP 50R,E00,518795,Staff,0,2,20,20
1715617366910,MCWP 50R,F00,518796,Staff,0,1,20,20
1715617366910,MCWP 50R,G00,518797,Staff,0,1,20,20
1715617367937,MMW 12R,A01,514034,Herbst; Matthew,0,2,16,16
1715617367937,MMW 12R,A02,514035,Herbst; Matthew,0,0,16,16
1715617368966,MMW 13R,A01,514037,Staff,0,5,16,16
1715617368966,MMW 13R,A02,514039,Staff,0,5,16,16
1715617368966,MMW 13R,A03,628519,Staff,0,4,16,16
1715617371019,SIO 295LS,A00,523233,Staff,10,0,30,20
1715617372044,SIO 295S,A00,523232,Staff,10,0,30,20
1715617373069,SIOC 290S,A01,637330,Merrifield; Mark A,23,0,30,7
1715617374095,SIOC 291S,A01,637333,Gabriel; Corey John,23,0,30,7
1715617375124,SOCI 117,A01,494376,Staff,0,5,5,5
1715617376151,WES 237B,A00,494380,Staff,10,0,20,10
1715617378207,AESE 279B,A00,494370,Wade; Jon P,0,0,33,33
1715617379233,AIP 97,001,660915,Van Den Einde; Yael Dahlia,9998,0,9999,1
1715617380259,AIP 197,001,627712,Vespa; Emanuel Ignacio,9995,0,9999,4
1715617380259,AIP 197,002,650778,Amir; On,9998,0,9999,1
1715617380259,AIP 197,003,650933,Avenancio-Leon; Carlos,9998,0,9999,1
1715617380259,AIP 197,004,658530,Heyman; Gail D.,9998,0,9999,1
1715617380259,AIP 197,005,658631,Neal; Sonya E,9998,0,9999,1
1715617380259,AIP 197,006,658671,Du; Songzi,9998,0,9999,1
1715617381285,ANAR 135S,A00,494369,Braswell; Geoffrey E.,0,0,0,0
1715617382311,BENG 196,001,628496,Engler; Adam J.,9998,0,9999,1
1715617382311,BENG 196,002,660916,Watson; John Thomas,9999,0,9999,0
1715617383337,BISP 197,001,650773,Wilhelm; James E.,9994,0,9999,5
1715617383337,BISP 197,002,658904,Coleman; Aaron B.,9998,0,9999,1
1715617384363,CAT 124RS,A01,519847,Geibel; William,0,0,20,20
1715617385387,CAT 125RS,A01,515971,Geibel; William,0,0,20,20
1715617386413,CLRE 250,A00,511389,Morris; Sheldon,9992,0,9999,7
1715617387440,CLRE 251,A00,507176,Mehta; Ravindra L.,9992,0,9999,7
1715617387440,CLRE 251,B00,511410,Mehta; Ravindra L.,9998,0,9999,1
1715617388466,CLRE 252,A00,507189,Cuomo; Raphael Eduardo,9994,0,9999,5
1715617389495,CLRE 253,A00,507199,Vaida; Florin,9994,0,9999,5
1715617389495,CLRE 253,B00,507202,Vaida; Florin,9999,0,9999,0
1715617390520,CLRE 259,A00,507211,Patel; Hemal,9996,0,9999,3
1715617391547,CLRE 260,A00,507221,Cuomo; Raphael Eduardo,9999,0,9999,0
1715617392572,CLRE 297,001,507242,Cuomo; Raphael Eduardo,9999,0,9999,0
1715617393598,COGS 197,001,638244,Voytek; Bradley Thomas,9997,0,9999,2
1715617394626,CSE 191,A00,516875,Minnes Kemp; Mor Mia,9991,0,9999,8
1715617395657,CSE 197,001,637388,Minnes Kemp; Mor Mia,9992,0,9999,7
1715617396682,CSS 201S,A01,494383,Mignozzetti; Umberto,35,0,35,0
1715617397709,CSS 202S,A01,494387,Mignozzetti; Umberto,35,0,35,0
1715617398738,DSC 197,001,628532,Eldridge; Justin Matthew,9995,0,9999,4
1715617399764,EAP 100,A00,516065,Staff,9799,0,9999,200
1715617400790,ECE 45,A01,507414,Staff,31,0,60,29
1715617402899,ECE 111,A01,507420,Staff,11,0,50,39
1715617403926,ECE 197,001,548057,Sievenpiper; Daniel F.,9991,0,9999,8
1715617404955,EDS 115,A00,507243,Choi; Bailey Miyeon,7,0,28,21
1715617405979,EDS 117,A01,494379,Staff,0,6,34,34
1715617407004,EDS 125,A00,507246,Hopkins; Megan Beth,8,0,30,22
1715617408028,EDS 128A,A01,507264,Fargason; Sharon Gayle,6,0,26,20
1715617409057,EDS 128B,A01,507293,Pappas; Elizabeth,10,0,30,20
1715617410082,EDS 139,A00,507294,Fargason; Sharon Gayle,10,0,30,20
1715617410082,EDS 139,B00,507313,Pappas; Elizabeth,11,0,30,19
1715617411111,EDS 201,A00,507315,Staff,10,0,30,20
1715617412136,EDS 203,A01,507317,Halter; Christopher P.,10,0,30,20
1715617413163,EDS 204R,A01,507319,Halter; Christopher P.,0,3,30,30
1715617413163,EDS 204R,B01,507331,Heinzman; Erica M.,14,0,30,16
1715617414191,EDS 206R,A00,507332,Staff,0,4,30,30
1715617414191,EDS 206R,B00,507343,Staff,15,0,30,15
1715617415217,EDS 250,A00,507344,Hemans; Patricia Ann Benitez,20,0,40,20
1715617416245,EDS 281,A00,507345,Daly; Alan J.,18,0,18,0
1715617417273,EDS 284,A00,507350,Daly; Alan J.,16,0,16,0
1715617418301,EDS 286,A00,507359,Fine; Sarah,18,0,18,0
1715617419328,EDS 289C,A01,507361,Daly; Alan J.,18,0,18,0
1715617420355,EDS 290,A00,507366,Hofstetter; Carolyn,15,0,15,0
1715617421385,LIGM 5A,A00,507421,Fischer-Grunski; Eva K,17,0,20,3
1715617422415,LIGM 5B,A00,507423,Fischer-Grunski; Eva K,19,0,20,1
1715617423441,LIGM 5C,A00,507425,Fischer-Grunski; Eva K,19,0,20,1
1715617424466,LIIT 5AS,A00,507427,Carnelos; Chiara,20,0,20,0
1715617425494,LIIT 5BS,A00,507430,Carnelos; Chiara,20,0,20,0
1715617426519,LIIT 5CS,A00,507432,Carnelos; Chiara,20,0,20,0
1715617427546,LISP 5A,A00,507541,Munoz Sanchez; Alicia,11,0,20,9
1715617428571,LISP 5B,A00,507671,Munoz Sanchez; Alicia,9,0,20,11
1715617429595,LISP 5C,A00,507696,Munoz Sanchez; Alicia,9,0,20,11
1715617430621,MAE 197,001,528363,Boechler; Nicholas Sebastia,9998,0,9999,1
1715617431652,MATH 197,001,523477,Kedlaya; Kiran S.,9994,0,9999,5
1715617431652,MATH 197,002,563811,Zhang; Danna,9994,0,9999,5
1715617431652,MATH 197,003,628552,Dumitriu; Ioana,9998,0,9999,1
1715617431652,MATH 197,004,660885,Floyd; Eric,9999,0,9999,0
1715617432677,MCWP 40R,A00,518780,Staff,2,0,20,18
1715617432677,MCWP 40R,B00,518781,Staff,11,0,20,9
1715617432677,MCWP 40R,C00,518783,Staff,5,0,20,15
1715617433702,MCWP 50R,A00,518791,Staff,0,1,20,20
1715617433702,MCWP 50R,B00,518792,Staff,0,2,20,20
1715617433702,MCWP 50R,C00,518793,Staff,0,4,20,20
1715617433702,MCWP 50R,D00,518794,Staff,0,1,20,20
1715617433702,MCWP 50R,E00,518795,Staff,0,2,20,20
1715617433702,MCWP 50R,F00,518796,Staff,0,1,20,20
1715617433702,MCWP 50R,G00,518797,Staff,0,1,20,20
1715617434728,MMW 12R,A01,514034,Herbst; Matthew,0,2,16,16
1715617434728,MMW 12R,A02,514035,Herbst; Matthew,0,0,16,16
1715617435757,MMW 13R,A01,514037,Staff,0,5,16,16
1715617435757,MMW 13R,A02,514039,Staff,0,5,16,16
1715617435757,MMW 13R,A03,628519,Staff,0,4,16,16
1715617437813,SIO 295LS,A00,523233,Staff,10,0,30,20
1715617438839,SIO 295S,A00,523232,Staff,10,0,30,20
1715617439869,SIOC 290S,A01,637330,Merrifield; Mark A,23,0,30,7
1715617440898,SIOC 291S,A01,637333,Gabriel; Corey John,23,0,30,7
1715617441926,SOCI 117,A01,494376,Staff,0,5,5,5
1715617442955,WES 237B,A00,494380,Staff,10,0,20,10
1715617445012,AESE 279B,A00,494370,Wade; Jon P,0,0,33,33
1715617446041,AIP 97,001,660915,Van Den Einde; Yael Dahlia,9998,0,9999,1
1715617447073,AIP 197,001,627712,Vespa; Emanuel Ignacio,9995,0,9999,4
1715617447073,AIP 197,002,650778,Amir; On,9998,0,9999,1
1715617447073,AIP 197,003,650933,Avenancio-Leon; Carlos,9998,0,9999,1
1715617447073,AIP 197,004,658530,Heyman; Gail D.,9998,0,9999,1
1715617447073,AIP 197,005,658631,Neal; Sonya E,9998,0,9999,1
1715617447073,AIP 197,006,658671,Du; Songzi,9998,0,9999,1
1715617448099,ANAR 135S,A00,494369,Braswell; Geoffrey E.,0,0,0,0
1715617449131,BENG 196,001,628496,Engler; Adam J.,9998,0,9999,1
1715617449131,BENG 196,002,660916,Watson; John Thomas,9999,0,9999,0
1715617450163,BISP 197,001,650773,Wilhelm; James E.,9994,0,9999,5
1715617450163,BISP 197,002,658904,Coleman; Aaron B.,9998,0,9999,1
1715617451194,CAT 124RS,A01,519847,Geibel; William,0,0,20,20
1715617452220,CAT 125RS,A01,515971,Geibel; William,0,0,20,20
1715617453246,CLRE 250,A00,511389,Morris; Sheldon,9992,0,9999,7
1715617454275,CLRE 251,A00,507176,Mehta; Ravindra L.,9992,0,9999,7
1715617454275,CLRE 251,B00,511410,Mehta; Ravindra L.,9998,0,9999,1
1715617455302,CLRE 252,A00,507189,Cuomo; Raphael Eduardo,9994,0,9999,5
1715617456328,CLRE 253,A00,507199,Vaida; Florin,9994,0,9999,5
1715617456328,CLRE 253,B00,507202,Vaida; Florin,9999,0,9999,0
1715617457355,CLRE 259,A00,507211,Patel; Hemal,9996,0,9999,3
1715617458384,CLRE 260,A00,507221,Cuomo; Raphael Eduardo,9999,0,9999,0
1715617459410,CLRE 297,001,507242,Cuomo; Raphael Eduardo,9999,0,9999,0
1715617460435,COGS 197,001,638244,Voytek; Bradley Thomas,9997,0,9999,2
1715617461462,CSE 191,A00,516875,Minnes Kemp; Mor Mia,9991,0,9999,8
1715617462487,CSE 197,001,637388,Minnes Kemp; Mor Mia,9992,0,9999,7
1715617463520,CSS 201S,A01,494383,Mignozzetti; Umberto,35,0,35,0
1715617464547,CSS 202S,A01,494387,Mignozzetti; Umberto,35,0,35,0
1715617465572,DSC 197,001,628532,Eldridge; Justin Matthew,9995,0,9999,4
1715617466597,EAP 100,A00,516065,Staff,9799,0,9999,200
1715617467629,ECE 45,A01,507414,Staff,31,0,60,29
1715617469679,ECE 111,A01,507420,Staff,11,0,50,39
1715617470707,ECE 197,001,548057,Sievenpiper; Daniel F.,9991,0,9999,8
1715617471733,EDS 115,A00,507243,Choi; Bailey Miyeon,7,0,28,21
1715617472759,EDS 117,A01,494379,Staff,0,6,34,34
1715617473784,EDS 125,A00,507246,Hopkins; Megan Beth,8,0,30,22
1715617474812,EDS 128A,A01,507264,Fargason; Sharon Gayle,6,0,26,20
1715617475838,EDS 128B,A01,507293,Pappas; Elizabeth,10,0,30,20
1715617476863,EDS 139,A00,507294,Fargason; Sharon Gayle,10,0,30,20
1715617476863,EDS 139,B00,507313,Pappas; Elizabeth,11,0,30,19
1715617477888,EDS 201,A00,507315,Staff,10,0,30,20
1715617478913,EDS 203,A01,507317,Halter; Christopher P.,10,0,30,20
1715617479940,EDS 204R,A01,507319,Halter; Christopher P.,0,3,30,30
1715617479940,EDS 204R,B01,507331,Heinzman; Erica M.,14,0,30,16
1715617480965,EDS 206R,A00,507332,Staff,0,4,30,30
1715617480965,EDS 206R,B00,507343,Staff,15,0,30,15
1715617481991,EDS 250,A00,507344,Hemans; Patricia Ann Benitez,20,0,40,20
1715617483016,EDS 281,A00,507345,Daly; Alan J.,18,0,18,0
1715617484041,EDS 284,A00,507350,Daly; Alan J.,16,0,16,0
1715617485066,EDS 286,A00,507359,Fine; Sarah,18,0,18,0
1715617486095,EDS 289C,A01,507361,Daly; Alan J.,18,0,18,0
1715617487121,EDS 290,A00,507366,Hofstetter; Carolyn,15,0,15,0
1715617488149,LIGM 5A,A00,507421,Fischer-Grunski; Eva K,17,0,20,3
1715617489182,LIGM 5B,A00,507423,Fischer-Grunski; Eva K,19,0,20,1
1715617490208,LIGM 5C,A00,507425,Fischer-Grunski; Eva K,19,0,20,1
1715617491238,LIIT 5AS,A00,507427,Carnelos; Chiara,20,0,20,0
1715617492266,LIIT 5BS,A00,507430,Carnelos; Chiara,20,0,20,0
1715617493291,LIIT 5CS,A00,507432,Carnelos; Chiara,20,0,20,0
1715617494318,LISP 5A,A00,507541,Munoz Sanchez; Alicia,11,0,20,9
1715617495342,LISP 5B,A00,507671,Munoz Sanchez; Alicia,9,0,20,11
1715617496367,LISP 5C,A00,507696,Munoz Sanchez; Alicia,9,0,20,11
1715617497394,MAE 197,001,528363,Boechler; Nicholas Sebastia,9998,0,9999,1
1715617498422,MATH 197,001,523477,Kedlaya; Kiran S.,9994,0,9999,5
1715617498422,MATH 197,002,563811,Zhang; Danna,9994,0,9999,5
1715617498422,MATH 197,003,628552,Dumitriu; Ioana,9998,0,9999,1
1715617498422,MATH 197,004,660885,Floyd; Eric,9999,0,9999,0
1715617499448,MCWP 40R,A00,518780,Staff,2,0,20,18
1715617499448,MCWP 40R,B00,518781,Staff,11,0,20,9
1715617499448,MCWP 40R,C00,518783,Staff,5,0,20,15
1715617500477,MCWP 50R,A00,518791,Staff,0,1,20,20
1715617500477,MCWP 50R,B00,518792,Staff,0,2,20,20
1715617500477,MCWP 50R,C00,518793,Staff,0,4,20,20
1715617500477,MCWP 50R,D00,518794,Staff,0,1,20,20
1715617500477,MCWP 50R,E00,518795,Staff,0,2,20,20
1715617500477,MCWP 50R,F00,518796,Staff,0,1,20,20
1715617500477,MCWP 50R,G00,518797,Staff,0,1,20,20
1715617501508,MMW 12R,A01,514034,Herbst; Matthew,0,2,16,16
1715617501508,MMW 12R,A02,514035,Herbst; Matthew,0,0,16,16
1715617502538,MMW 13R,A01,514037,Staff,0,5,16,16
1715617502538,MMW 13R,A02,514039,Staff,0,5,16,16
1715617502538,MMW 13R,A03,628519,Staff,0,4,16,16
1715617504591,SIO 295LS,A00,523233,Staff,10,0,30,20
1715617505617,SIO 295S,A00,523232,Staff,10,0,30,20
1715617506647,SIOC 290S,A01,637330,Merrifield; Mark A,23,0,30,7
1715617507674,SIOC 291S,A01,637333,Gabriel; Corey John,23,0,30,7
1715617508706,SOCI 117,A01,494376,Staff,0,5,5,5
1715617509733,WES 237B,A00,494380,Staff,10,0,20,10
1715617511804,AESE 279B,A00,494370,Wade; Jon P,0,0,33,33
1715617512833,AIP 97,001,660915,Van Den Einde; Yael Dahlia,9998,0,9999,1
1715617513862,AIP 197,001,627712,Vespa; Emanuel Ignacio,9995,0,9999,4
1715617513862,AIP 197,002,650778,Amir; On,9998,0,9999,1
1715617513862,AIP 197,003,650933,Avenancio-Leon; Carlos,9998,0,9999,1
1715617513862,AIP 197,004,658530,Heyman; Gail D.,9998,0,9999,1
1715617513862,AIP 197,005,658631,Neal; Sonya E,9998,0,9999,1
1715617513862,AIP 197,006,658671,Du; Songzi,9998,0,9999,1
1715617514889,ANAR 135S,A00,494369,Braswell; Geoffrey E.,0,0,0,0
1715617515916,BENG 196,001,628496,Engler; Adam J.,9998,0,9999,1
1715617515916,BENG 196,002,660916,Watson; John Thomas,9999,0,9999,0
1715617516943,BISP 197,001,650773,Wilhelm; James E.,9994,0,9999,5
1715617516943,BISP 197,002,658904,Coleman; Aaron B.,9998,0,9999,1
1715617517970,CAT 124RS,A01,519847,Geibel; William,0,0,20,20
1715617518997,CAT 125RS,A01,515971,Geibel; William,0,0,20,20
1715617520028,CLRE 250,A00,511389,Morris; Sheldon,9992,0,9999,7
1715617521054,CLRE 251,A00,507176,Mehta; Ravindra L.,9992,0,9999,7
1715617521054,CLRE 251,B00,511410,Mehta; Ravindra L.,9998,0,9999,1
1715617522081,CLRE 252,A00,507189,Cuomo; Raphael Eduardo,9994,0,9999,5
1715617523110,CLRE 253,A00,507199,Vaida; Florin,9994,0,9999,5
1715617523110,CLRE 253,B00,507202,Vaida; Florin,9999,0,9999,0
1715617524137,CLRE 259,A00,507211,Patel; Hemal,9996,0,9999,3
1715617525163,CLRE 260,A00,507221,Cuomo; Raphael Eduardo,9999,0,9999,0
1715617526191,CLRE 297,001,507242,Cuomo; Raphael Eduardo,9999,0,9999,0
1715617527217,COGS 197,001,638244,Voytek; Bradley Thomas,9997,0,9999,2
1715617528245,CSE 191,A00,516875,Minnes Kemp; Mor Mia,9991,0,9999,8
1715617529272,CSE 197,001,637388,Minnes Kemp; Mor Mia,9992,0,9999,7
1715617530298,CSS 201S,A01,494383,Mignozzetti; Umberto,35,0,35,0
1715617531326,CSS 202S,A01,494387,Mignozzetti; Umberto,35,0,35,0
1715617532354,DSC 197,001,628532,Eldridge; Justin Matthew,9995,0,9999,4
1715617533381,EAP 100,A00,516065,Staff,9799,0,9999,200
1715617534413,ECE 45,A01,507414,Staff,31,0,60,29
1715617536468,ECE 111,A01,507420,Staff,11,0,50,39
1715617537499,ECE 197,001,548057,Sievenpiper; Daniel F.,9991,0,9999,8
1715617538526,EDS 115,A00,507243,Choi; Bailey Miyeon,7,0,28,21
1715617539557,EDS 117,A01,494379,Staff,0,6,34,34
1715617540584,EDS 125,A00,507246,Hopkins; Megan Beth,8,0,30,22
1715617541615,EDS 128A,A01,507264,Fargason; Sharon Gayle,6,0,26,20
1715617542641,EDS 128B,A01,507293,Pappas; Elizabeth,10,0,30,20
1715617543665,EDS 139,A00,507294,Fargason; Sharon Gayle,10,0,30,20
1715617543665,EDS 139,B00,507313,Pappas; Elizabeth,11,0,30,19
1715617544690,EDS 201,A00,507315,Staff,10,0,30,20
1715617545716,EDS 203,A01,507317,Halter; Christopher P.,10,0,30,20
1715617546741,EDS 204R,A01,507319,Halter; Christopher P.,0,3,30,30
1715617546741,EDS 204R,B01,507331,Heinzman; Erica M.,14,0,30,16
1715617547766,EDS 206R,A00,507332,Staff,0,4,30,30
1715617547766,EDS 206R,B00,507343,Staff,15,0,30,15
1715617548794,EDS 250,A00,507344,Hemans; Patricia Ann Benitez,20,0,40,20
1715617549822,EDS 281,A00,507345,Daly; Alan J.,18,0,18,0
1715617550846,EDS 284,A00,507350,Daly; Alan J.,16,0,16,0
1715617551870,EDS 286,A00,507359,Fine; Sarah,18,0,18,0
1715617552898,EDS 289C,A01,507361,Daly; Alan J.,18,0,18,0
1715617553927,EDS 290,A00,507366,Hofstetter; Carolyn,15,0,15,0
1715617554955,LIGM 5A,A00,507421,Fischer-Grunski; Eva K,17,0,20,3
1715617555983,LIGM 5B,A00,507423,Fischer-Grunski; Eva K,19,0,20,1
1715617557015,LIGM 5C,A00,507425,Fischer-Grunski; Eva K,19,0,20,1
1715617558039,LIIT 5AS,A00,507427,Carnelos; Chiara,20,0,20,0
1715617559068,LIIT 5BS,A00,507430,Carnelos; Chiara,20,0,20,0
1715617560097,LIIT 5CS,A00,507432,Carnelos; Chiara,20,0,20,0
1715617561122,LISP 5A,A00,507541,Munoz Sanchez; Alicia,11,0,20,9
1715617562154,LISP 5B,A00,507671,Munoz Sanchez; Alicia,9,0,20,11
1715617563186,LISP 5C,A00,507696,Munoz Sanchez; Alicia,9,0,20,11
1715617564209,MAE 197,001,528363,Boechler; Nicholas Sebastia,9998,0,9999,1
1715617565237,MATH 197,001,523477,Kedlaya; Kiran S.,9994,0,9999,5
1715617565237,MATH 197,002,563811,Zhang; Danna,9994,0,9999,5
1715617565237,MATH 197,003,628552,Dumitriu; Ioana,9998,0,9999,1
1715617565237,MATH 197,004,660885,Floyd; Eric,9999,0,9999,0
1715617566262,MCWP 40R,A00,518780,Staff,2,0,20,18
1715617566262,MCWP 40R,B00,518781,Staff,11,0,20,9
1715617566262,MCWP 40R,C00,518783,Staff,5,0,20,15
1715617567292,MCWP 50R,A00,518791,Staff,0,1,20,20
1715617567292,MCWP 50R,B00,518792,Staff,0,2,20,20
1715617567292,MCWP 50R,C00,518793,Staff,0,4,20,20
1715617567292,MCWP 50R,D00,518794,Staff,0,1,20,20
1715617567292,MCWP 50R,E00,518795,Staff,0,2,20,20
1715617567292,MCWP 50R,F00,518796,Staff,0,1,20,20
1715617567292,MCWP 50R,G00,518797,Staff,0,1,20,20
1715617568321,MMW 12R,A01,514034,Herbst; Matthew,0,2,16,16
1715617568321,MMW 12R,A02,514035,Herbst; Matthew,0,0,16,16
1715617569351,MMW 13R,A01,514037,Staff,0,5,16,16
1715617569351,MMW 13R,A02,514039,Staff,0,5,16,16
1715617569351,MMW 13R,A03,628519,Staff,0,4,16,16
1715617571403,SIO 295LS,A00,523233,Staff,10,0,30,20
1715617572431,SIO 295S,A00,523232,Staff,10,0,30,20
1715617573455,SIOC 290S,A01,637330,Merrifield; Mark A,23,0,30,7
1715617574483,SIOC 291S,A01,637333,Gabriel; Corey John,23,0,30,7
1715617575509,SOCI 117,A01,494376,Staff,0,5,5,5
1715617576534,WES 237B,A00,494380,Staff,10,0,20,10
1715617578597,AESE 279B,A00,494370,Wade; Jon P,0,0,33,33
1715617579622,AIP 97,001,660915,Van Den Einde; Yael Dahlia,9998,0,9999,1
1715617580650,AIP 197,001,627712,Vespa; Emanuel Ignacio,9995,0,9999,4
1715617580650,AIP 197,002,650778,Amir; On,9998,0,9999,1
1715617580650,AIP 197,003,650933,Avenancio-Leon; Carlos,9998,0,9999,1
1715617580650,AIP 197,004,658530,Heyman; Gail D.,9998,0,9999,1
1715617580650,AIP 197,005,658631,Neal; Sonya E,9998,0,9999,1
1715617580650,AIP 197,006,658671,Du; Songzi,9998,0,9999,1
1715617581674,ANAR 135S,A00,494369,Braswell; Geoffrey E.,0,0,0,0
1715617582702,BENG 196,001,628496,Engler; Adam J.,9998,0,9999,1
1715617582702,BENG 196,002,660916,Watson; John Thomas,9999,0,9999,0
1715617583733,BISP 197,001,650773,Wilhelm; James E.,9994,0,9999,5
1715617583733,BISP 197,002,658904,Coleman; Aaron B.,9998,0,9999,1
1715617584759,CAT 124RS,A01,519847,Geibel; William,0,0,20,20
1715617585787,CAT 125RS,A01,515971,Geibel; William,0,0,20,20
1715617586815,CLRE 250,A00,511389,Morris; Sheldon,9992,0,9999,7
1715617587845,CLRE 251,A00,507176,Mehta; Ravindra L.,9992,0,9999,7
1715617587845,CLRE 251,B00,511410,Mehta; Ravindra L.,9998,0,9999,1
1715617588901,CLRE 252,A00,507189,Cuomo; Raphael Eduardo,9994,0,9999,5
1715617589926,CLRE 253,A00,507199,Vaida; Florin,9994,0,9999,5
1715617589926,CLRE 253,B00,507202,Vaida; Florin,9999,0,9999,0
1715617590952,CLRE 259,A00,507211,Patel; Hemal,9996,0,9999,3
1715617591978,CLRE 260,A00,507221,Cuomo; Raphael Eduardo,9999,0,9999,0
1715617593003,CLRE 297,001,507242,Cuomo; Raphael Eduardo,9999,0,9999,0
1715617594026,COGS 197,001,638244,Voytek; Bradley Thomas,9997,0,9999,2
1715617595053,CSE 191,A00,516875,Minnes Kemp; Mor Mia,9991,0,9999,8
1715617596077,CSE 197,001,637388,Minnes Kemp; Mor Mia,9992,0,9999,7
1715617597103,CSS 201S,A01,494383,Mignozzetti; Umberto,35,0,35,0
1715617598129,CSS 202S,A01,494387,Mignozzetti; Umberto,35,0,35,0
1715617599156,DSC 197,001,628532,Eldridge; Justin Matthew,9995,0,9999,4
1715617600183,EAP 100,A00,516065,Staff,9799,0,9999,200
1715617601214,ECE 45,A01,507414,Staff,31,0,60,29
1715617603463,ECE 111,A01,507420,Staff,11,0,50,39
1715617604489,ECE 197,001,548057,Sievenpiper; Daniel F.,9991,0,9999,8
1715617605517,EDS 115,A00,507243,Choi; Bailey Miyeon,7,0,28,21
1715617606547,EDS 117,A01,494379,Staff,0,6,34,34
1715617607574,EDS 125,A00,507246,Hopkins; Megan Beth,8,0,30,22
1715617608600,EDS 128A,A01,507264,Fargason; Sharon Gayle,6,0,26,20
1715617609626,EDS 128B,A01,507293,Pappas; Elizabeth,10,0,30,20
1715617610655,EDS 139,A00,507294,Fargason; Sharon Gayle,10,0,30,20
1715617610655,EDS 139,B00,507313,Pappas; Elizabeth,11,0,30,19
1715617611684,EDS 201,A00,507315,Staff,10,0,30,20
1715617612710,EDS 203,A01,507317,Halter; Christopher P.,10,0,30,20
1715617613737,EDS 204R,A01,507319,Halter; Christopher P.,0,3,30,30
1715617613737,EDS 204R,B01,507331,Heinzman; Erica M.,14,0,30,16
1715617614765,EDS 206R,A00,507332,Staff,0,4,30,30
1715617614765,EDS 206R,B00,507343,Staff,15,0,30,15
1715617615792,EDS 250,A00,507344,Hemans; Patricia Ann Benitez,20,0,40,20
1715617616820,EDS 281,A00,507345,Daly; Alan J.,18,0,18,0
1715617617845,EDS 284,A00,507350,Daly; Alan J.,16,0,16,0
1715617618869,EDS 286,A00,507359,Fine; Sarah,18,0,18,0
1715617619897,EDS 289C,A01,507361,Daly; Alan J.,18,0,18,0
1715617620923,EDS 290,A00,507366,Hofstetter; Carolyn,15,0,15,0
1715617621950,LIGM 5A,A00,507421,Fischer-Grunski; Eva K,17,0,20,3
1715617622978,LIGM 5B,A00,507423,Fischer-Grunski; Eva K,19,0,20,1
1715617624003,LIGM 5C,A00,507425,Fischer-Grunski; Eva K,19,0,20,1
1715617625029,LIIT 5AS,A00,507427,Carnelos; Chiara,20,0,20,0
1715617626077,LIIT 5BS,A00,507430,Carnelos; Chiara,20,0,20,0
1715617627106,LIIT 5CS,A00,507432,Carnelos; Chiara,20,0,20,0
1715617628132,LISP 5A,A00,507541,Munoz Sanchez; Alicia,11,0,20,9
1715617629158,LISP 5B,A00,507671,Munoz Sanchez; Alicia,9,0,20,11
1715617630184,LISP 5C,A00,507696,Munoz Sanchez; Alicia,9,0,20,11
1715617631217,MAE 197,001,528363,Boechler; Nicholas Sebastia,9998,0,9999,1
1715617632244,MATH 197,001,523477,Kedlaya; Kiran S.,9994,0,9999,5
1715617632244,MATH 197,002,563811,Zhang; Danna,9994,0,9999,5
1715617632244,MATH 197,003,628552,Dumitriu; Ioana,9998,0,9999,1
1715617632244,MATH 197,004,660885,Floyd; Eric,9999,0,9999,0
1715617633272,MCWP 40R,A00,518780,Staff,2,0,20,18
1715617633272,MCWP 40R,B00,518781,Staff,11,0,20,9
1715617633272,MCWP 40R,C00,518783,Staff,5,0,20,15
1715617634299,MCWP 50R,A00,518791,Staff,0,1,20,20
1715617634299,MCWP 50R,B00,518792,Staff,0,2,20,20
1715617634299,MCWP 50R,C00,518793,Staff,0,4,20,20
1715617634299,MCWP 50R,D00,518794,Staff,0,1,20,20
1715617634299,MCWP 50R,E00,518795,Staff,0,2,20,20
1715617634299,MCWP 50R,F00,518796,Staff,0,1,20,20
1715617634299,MCWP 50R,G00,518797,Staff,0,1,20,20
1715617635327,MMW 12R,A01,514034,Herbst; Matthew,0,2,16,16
1715617635327,MMW 12R,A02,514035,Herbst; Matthew,0,0,16,16
1715617636355,MMW 13R,A01,514037,Staff,0,5,16,16
1715617636355,MMW 13R,A02,514039,Staff,0,5,16,16
1715617636355,MMW 13R,A03,628519,Staff,0,4,16,16
1715617638417,SIO 295LS,A00,523233,Staff,10,0,30,20
1715617639442,SIO 295S,A00,523232,Staff,10,0,30,20
1715617640470,SIOC 290S,A01,637330,Merrifield; Mark A,23,0,30,7
1715617641498,SIOC 291S,A01,637333,Gabriel; Corey John,23,0,30,7
1715617642524,SOCI 117,A01,494376,Staff,0,5,5,5
1715617643549,WES 237B,A00,494380,Staff,10,0,20,10
1715617645617,AESE 279B,A00,494370,Wade; Jon P,0,0,33,33
1715617646643,AIP 97,001,660915,Van Den Einde; Yael Dahlia,9998,0,9999,1
1715617647669,AIP 197,001,627712,Vespa; Emanuel Ignacio,9995,0,9999,4
1715617647669,AIP 197,002,650778,Amir; On,9998,0,9999,1
1715617647669,AIP 197,003,650933,Avenancio-Leon; Carlos,9998,0,9999,1
1715617647669,AIP 197,004,658530,Heyman; Gail D.,9998,0,9999,1
1715617647669,AIP 197,005,658631,Neal; Sonya E,9998,0,9999,1
1715617647669,AIP 197,006,658671,Du; Songzi,9998,0,9999,1
1715617648693,ANAR 135S,A00,494369,Braswell; Geoffrey E.,0,0,0,0
1715617649720,BENG 196,001,628496,Engler; Adam J.,9998,0,9999,1
1715617649720,BENG 196,002,660916,Watson; John Thomas,9999,0,9999,0
1715617650747,BISP 197,001,650773,Wilhelm; James E.,9994,0,9999,5
1715617650747,BISP 197,002,658904,Coleman; Aaron B.,9998,0,9999,1
1715617651775,CAT 124RS,A01,519847,Geibel; William,0,0,20,20
1715617652803,CAT 125RS,A01,515971,Geibel; William,0,0,20,20
1715617653830,CLRE 250,A00,511389,Morris; Sheldon,9992,0,9999,7
1715617654855,CLRE 251,A00,507176,Mehta; Ravindra L.,9992,0,9999,7
1715617654855,CLRE 251,B00,511410,Mehta; Ravindra L.,9998,0,9999,1
1715617655884,CLRE 252,A00,507189,Cuomo; Raphael Eduardo,9994,0,9999,5
1715617656911,CLRE 253,A00,507199,Vaida; Florin,9994,0,9999,5
1715617656911,CLRE 253,B00,507202,Vaida; Florin,9999,0,9999,0
1715617657938,CLRE 259,A00,507211,Patel; Hemal,9996,0,9999,3
1715617658965,CLRE 260,A00,507221,Cuomo; Raphael Eduardo,9999,0,9999,0
1715617659991,CLRE 297,001,507242,Cuomo; Raphael Eduardo,9999,0,9999,0
1715617661018,COGS 197,001,638244,Voytek; Bradley Thomas,9997,0,9999,2
1715617662045,CSE 191,A00,516875,Minnes Kemp; Mor Mia,9991,0,9999,8
1715617663071,CSE 197,001,637388,Minnes Kemp; Mor Mia,9992,0,9999,7
1715617664098,CSS 201S,A01,494383,Mignozzetti; Umberto,35,0,35,0
1715617665127,CSS 202S,A01,494387,Mignozzetti; Umberto,35,0,35,0
1715617666153,DSC 197,001,628532,Eldridge; Justin Matthew,9995,0,9999,4
1715617667175,EAP 100,A00,516065,Staff,9799,0,9999,200
1715617668203,ECE 45,A01,507414,Staff,31,0,60,29
1715617670258,ECE 111,A01,507420,Staff,11,0,50,39
1715617671284,ECE 197,001,548057,Sievenpiper; Daniel F.,9991,0,9999,8
1715617672310,EDS 115,A00,507243,Choi; Bailey Miyeon,7,0,28,21
1715617673335,EDS 117,A01,494379,Staff,0,6,34,34
1715617674361,EDS 125,A00,507246,Hopkins; Megan Beth,8,0,30,22
1715617675387,EDS 128A,A01,507264,Fargason; Sharon Gayle,6,0,26,20
1715617676412,EDS 128B,A01,507293,Pappas; Elizabeth,10,0,30,20
1715617677438,EDS 139,A00,507294,Fargason; Sharon Gayle,10,0,30,20
1715617677438,EDS 139,B00,507313,Pappas; Elizabeth,11,0,30,19
1715617678465,EDS 201,A00,507315,Staff,10,0,30,20
1715617679490,EDS 203,A01,507317,Halter; Christopher P.,10,0,30,20
1715617680519,EDS 204R,A01,507319,Halter; Christopher P.,0,3,30,30
1715617680519,EDS 204R,B01,507331,Heinzman; Erica M.,14,0,30,16
1715617681544,EDS 206R,A00,507332,Staff,0,4,30,30
1715617681544,EDS 206R,B00,507343,Staff,15,0,30,15
1715617682573,EDS 250,A00,507344,Hemans; Patricia Ann Benitez,20,0,40,20
1715617683598,EDS 281,A00,507345,Daly; Alan J.,18,0,18,0
1715617684626,EDS 284,A00,507350,Daly; Alan J.,16,0,16,0
1715617685653,EDS 286,A00,507359,Fine; Sarah,18,0,18,0
1715617686677,EDS 289C,A01,507361,Daly; Alan J.,18,0,18,0
1715617687706,EDS 290,A00,507366,Hofstetter; Carolyn,15,0,15,0
1715617688735,LIGM 5A,A00,507421,Fischer-Grunski; Eva K,17,0,20,3
1715617689764,LIGM 5B,A00,507423,Fischer-Grunski; Eva K,19,0,20,1
1715617690788,LIGM 5C,A00,507425,Fischer-Grunski; Eva K,19,0,20,1
1715617691818,LIIT 5AS,A00,507427,Carnelos; Chiara,20,0,20,0
1715617692847,LIIT 5BS,A00,507430,Carnelos; Chiara,20,0,20,0
1715617693876,LIIT 5CS,A00,507432,Carnelos; Chiara,20,0,20,0
1715617694959,LISP 5A,A00,507541,Munoz Sanchez; Alicia,11,0,20,9
1715617695985,LISP 5B,A00,507671,Munoz Sanchez; Alicia,9,0,20,11
1715617697009,LISP 5C,A00,507696,Munoz Sanchez; Alicia,9,0,20,11
1715617698036,MAE 197,001,528363,Boechler; Nicholas Sebastia,9998,0,9999,1
1715617699065,MATH 197,001,523477,Kedlaya; Kiran S.,9994,0,9999,5
1715617699065,MATH 197,002,563811,Zhang; Danna,9994,0,9999,5
1715617699065,MATH 197,003,628552,Dumitriu; Ioana,9998,0,9999,1
1715617699065,MATH 197,004,660885,Floyd; Eric,9999,0,9999,0
1715617700090,MCWP 40R,A00,518780,Staff,2,0,20,18
1715617700090,MCWP 40R,B00,518781,Staff,11,0,20,9
1715617700090,MCWP 40R,C00,518783,Staff,5,0,20,15
1715617701117,MCWP 50R,A00,518791,Staff,0,1,20,20
1715617701117,MCWP 50R,B00,518792,Staff,0,2,20,20
1715617701117,MCWP 50R,C00,518793,Staff,0,4,20,20
1715617701117,MCWP 50R,D00,518794,Staff,0,1,20,20
1715617701117,MCWP 50R,E00,518795,Staff,0,2,20,20
1715617701117,MCWP 50R,F00,518796,Staff,0,1,20,20
1715617701117,MCWP 50R,G00,518797,Staff,0,1,20,20
1715617702143,MMW 12R,A01,514034,Herbst; Matthew,0,2,16,16
1715617702143,MMW 12R,A02,514035,Herbst; Matthew,0,0,16,16
1715617703173,MMW 13R,A01,514037,Staff,0,5,16,16
1715617703173,MMW 13R,A02,514039,Staff,0,5,16,16
1715617703173,MMW 13R,A03,628519,Staff,0,4,16,16
1715617705224,SIO 295LS,A00,523233,Staff,10,0,30,20
1715617706253,SIO 295S,A00,523232,Staff,10,0,30,20
1715617707281,SIOC 290S,A01,637330,Merrifield; Mark A,23,0,30,7
1715617708310,SIOC 291S,A01,637333,Gabriel; Corey John,23,0,30,7
1715617709339,SOCI 117,A01,494376,Staff,0,5,5,5
1715617710366,WES 237B,A00,494380,Staff,10,0,20,10
1715617712437,AESE 279B,A00,494370,Wade; Jon P,0,0,33,33
1715617713463,AIP 97,001,660915,Van Den Einde; Yael Dahlia,9998,0,9999,1
1715617714488,AIP 197,001,627712,Vespa; Emanuel Ignacio,9995,0,9999,4
1715617714488,AIP 197,002,650778,Amir; On,9998,0,9999,1
1715617714488,AIP 197,003,650933,Avenancio-Leon; Carlos,9998,0,9999,1
1715617714488,AIP 197,004,658530,Heyman; Gail D.,9998,0,9999,1
1715617714488,AIP 197,005,658631,Neal; Sonya E,9998,0,9999,1
1715617714488,AIP 197,006,658671,Du; Songzi,9998,0,9999,1
1715617715515,ANAR 135S,A00,494369,Braswell; Geoffrey E.,0,0,0,0
1715617716541,BENG 196,001,628496,Engler; Adam J.,9998,0,9999,1
1715617716541,BENG 196,002,660916,Watson; John Thomas,9999,0,9999,0
1715617717569,BISP 197,001,650773,Wilhelm; James E.,9994,0,9999,5
1715617717569,BISP 197,002,658904,Coleman; Aaron B.,9998,0,9999,1
1715617718594,CAT 124RS,A01,519847,Geibel; William,0,0,20,20
1715617719619,CAT 125RS,A01,515971,Geibel; William,0,0,20,20
1715617720645,CLRE 250,A00,511389,Morris; Sheldon,9992,0,9999,7
1715617721676,CLRE 251,A00,507176,Mehta; Ravindra L.,9992,0,9999,7
1715617721676,CLRE 251,B00,511410,Mehta; Ravindra L.,9998,0,9999,1
1715617722702,CLRE 252,A00,507189,Cuomo; Raphael Eduardo,9994,0,9999,5
1715617723731,CLRE 253,A00,507199,Vaida; Florin,9994,0,9999,5
1715617723731,CLRE 253,B00,507202,Vaida; Florin,9999,0,9999,0
1715617724759,CLRE 259,A00,507211,Patel; Hemal,9996,0,9999,3
1715617725787,CLRE 260,A00,507221,Cuomo; Raphael Eduardo,9999,0,9999,0
1715617726816,CLRE 297,001,507242,Cuomo; Raphael Eduardo,9999,0,9999,0
1715617727842,COGS 197,001,638244,Voytek; Bradley Thomas,9997,0,9999,2
1715617728867,CSE 191,A00,516875,Minnes Kemp; Mor Mia,9991,0,9999,8
1715617729894,CSE 197,001,637388,Minnes Kemp; Mor Mia,9992,0,9999,7
1715617730925,CSS 201S,A01,494383,Mignozzetti; Umberto,35,0,35,0
1715617731951,CSS 202S,A01,494387,Mignozzetti; Umberto,35,0,35,0
1715617732977,DSC 197,001,628532,Eldridge; Justin Matthew,9995,0,9999,4
1715617734004,EAP 100,A00,516065,Staff,9799,0,9999,200
1715617735031,ECE 45,A01,507414,Staff,31,0,60,29
1715617737086,ECE 111,A01,507420,Staff,11,0,50,39
1715617738113,ECE 197,001,548057,Sievenpiper; Daniel F.,9991,0,9999,8
1715617739139,EDS 115,A00,507243,Choi; Bailey Miyeon,7,0,28,21
1715617740167,EDS 117,A01,494379,Staff,0,6,34,34
1715617741193,EDS 125,A00,507246,Hopkins; Megan Beth,8,0,30,22
1715617742224,EDS 128A,A01,507264,Fargason; Sharon Gayle,6,0,26,20
1715617743251,EDS 128B,A01,507293,Pappas; Elizabeth,10,0,30,20
1715617744277,EDS 139,A00,507294,Fargason; Sharon Gayle,10,0,30,20
1715617744277,EDS 139,B00,507313,Pappas; Elizabeth,11,0,30,19
1715617745303,EDS 201,A00,507315,Staff,10,0,30,20
1715617746329,EDS 203,A01,507317,Halter; Christopher P.,10,0,30,20
1715617747354,EDS 204R,A01,507319,Halter; Christopher P.,0,3,30,30
1715617747354,EDS 204R,B01,507331,Heinzman; Erica M.,14,0,30,16
1715617748380,EDS 206R,A00,507332,Staff,0,4,30,30
1715617748380,EDS 206R,B00,507343,Staff,15,0,30,15
1715617749405,EDS 250,A00,507344,Hemans; Patricia Ann Benitez,20,0,40,20
1715617750432,EDS 281,A00,507345,Daly; Alan J.,18,0,18,0
1715617751459,EDS 284,A00,507350,Daly; Alan J.,16,0,16,0
1715617752488,EDS 286,A00,507359,Fine; Sarah,18,0,18,0
1715617753516,EDS 289C,A01,507361,Daly; Alan J.,18,0,18,0
1715617754541,EDS 290,A00,507366,Hofstetter; Carolyn,15,0,15,0
1715617755565,LIGM 5A,A00,507421,Fischer-Grunski; Eva K,17,0,20,3
1715617756591,LIGM 5B,A00,507423,Fischer-Grunski; Eva K,19,0,20,1
1715617757620,LIGM 5C,A00,507425,Fischer-Grunski; Eva K,19,0,20,1
1715617758647,LIIT 5AS,A00,507427,Carnelos; Chiara,20,0,20,0
1715617759671,LIIT 5BS,A00,507430,Carnelos; Chiara,20,0,20,0
1715617760697,LIIT 5CS,A00,507432,Carnelos; Chiara,20,0,20,0
1715617761723,LISP 5A,A00,507541,Munoz Sanchez; Alicia,11,0,20,9
1715617762753,LISP 5B,A00,507671,Munoz Sanchez; Alicia,9,0,20,11
1715617763783,LISP 5C,A00,507696,Munoz Sanchez; Alicia,9,0,20,11
1715617764812,MAE 197,001,528363,Boechler; Nicholas Sebastia,9998,0,9999,1
1715617765842,MATH 197,001,523477,Kedlaya; Kiran S.,9994,0,9999,5
1715617765842,MATH 197,002,563811,Zhang; Danna,9994,0,9999,5
1715617765842,MATH 197,003,628552,Dumitriu; Ioana,9998,0,9999,1
1715617765842,MATH 197,004,660885,Floyd; Eric,9999,0,9999,0
1715617766871,MCWP 40R,A00,518780,Staff,2,0,20,18
1715617766871,MCWP 40R,B00,518781,Staff,11,0,20,9
1715617766871,MCWP 40R,C00,518783,Staff,5,0,20,15
1715617767896,MCWP 50R,A00,518791,Staff,0,1,20,20
1715617767896,MCWP 50R,B00,518792,Staff,0,2,20,20
1715617767896,MCWP 50R,C00,518793,Staff,0,4,20,20
1715617767896,MCWP 50R,D00,518794,Staff,0,1,20,20
1715617767896,MCWP 50R,E00,518795,Staff,0,2,20,20
1715617767896,MCWP 50R,F00,518796,Staff,0,1,20,20
1715617767896,MCWP 50R,G00,518797,Staff,0,1,20,20
1715617768921,MMW 12R,A01,514034,Herbst; Matthew,0,2,16,16
1715617768921,MMW 12R,A02,514035,Herbst; Matthew,0,0,16,16
1715617769945,MMW 13R,A01,514037,Staff,0,5,16,16
1715617769945,MMW 13R,A02,514039,Staff,0,5,16,16
1715617769945,MMW 13R,A03,628519,Staff,0,4,16,16
1715617771999,SIO 295LS,A00,523233,Staff,10,0,30,20
1715617773024,SIO 295S,A00,523232,Staff,10,0,30,20
1715617774052,SIOC 290S,A01,637330,Merrifield; Mark A,23,0,30,7
1715617775077,SIOC 291S,A01,637333,Gabriel; Corey John,23,0,30,7
1715617776102,SOCI 117,A01,494376,Staff,0,5,5,5
1715617777128,WES 237B,A00,494380,Staff,10,0,20,10
1715617779191,AESE 279B,A00,494370,Wade; Jon P,0,0,33,33
1715617780218,AIP 97,001,660915,Van Den Einde; Yael Dahlia,9998,0,9999,1
1715617781244,AIP 197,001,627712,Vespa; Emanuel Ignacio,9995,0,9999,4
1715617781244,AIP 197,002,650778,Amir; On,9998,0,9999,1
1715617781244,AIP 197,003,650933,Avenancio-Leon; Carlos,9998,0,9999,1
1715617781244,AIP 197,004,658530,Heyman; Gail D.,9998,0,9999,1
1715617781244,AIP 197,005,658631,Neal; Sonya E,9998,0,9999,1
1715617781244,AIP 197,006,658671,Du; Songzi,9998,0,9999,1
1715617782271,ANAR 135S,A00,494369,Braswell; Geoffrey E.,0,0,0,0
1715617783297,BENG 196,001,628496,Engler; Adam J.,9998,0,9999,1
1715617783297,BENG 196,002,660916,Watson; John Thomas,9999,0,9999,0
1715617784325,BISP 197,001,650773,Wilhelm; James E.,9994,0,9999,5
1715617784325,BISP 197,002,658904,Coleman; Aaron B.,9998,0,9999,1
1715617785350,CAT 124RS,A01,519847,Geibel; William,0,0,20,20
1715617786375,CAT 125RS,A01,515971,Geibel; William,0,0,20,20
1715617787400,CLRE 250,A00,511389,Morris; Sheldon,9992,0,9999,7
1715617788430,CLRE 251,A00,507176,Mehta; Ravindra L.,9992,0,9999,7
1715617788430,CLRE 251,B00,511410,Mehta; Ravindra L.,9998,0,9999,1
1715617789455,CLRE 252,A00,507189,Cuomo; Raphael Eduardo,9994,0,9999,5
1715617790484,CLRE 253,A00,507199,Vaida; Florin,9994,0,9999,5
1715617790484,CLRE 253,B00,507202,Vaida; Florin,9999,0,9999,0
1715617791510,CLRE 259,A00,507211,Patel; Hemal,9996,0,9999,3
1715617792537,CLRE 260,A00,507221,Cuomo; Raphael Eduardo,9999,0,9999,0
1715617793561,CLRE 297,001,507242,Cuomo; Raphael Eduardo,9999,0,9999,0
1715617794586,COGS 197,001,638244,Voytek; Bradley Thomas,9997,0,9999,2
1715617795610,CSE 191,A00,516875,Minnes Kemp; Mor Mia,9991,0,9999,8
1715617796636,CSE 197,001,637388,Minnes Kemp; Mor Mia,9992,0,9999,7
1715617797660,CSS 201S,A01,494383,Mignozzetti; Umberto,35,0,35,0
1715617798690,CSS 202S,A01,494387,Mignozzetti; Umberto,35,0,35,0
1715617799714,DSC 197,001,628532,Eldridge; Justin Matthew,9995,0,9999,4
1715617800741,EAP 100,A00,516065,Staff,9799,0,9999,200
1715617801768,ECE 45,A01,507414,Staff,31,0,60,29
1715617803821,ECE 111,A01,507420,Staff,11,0,50,39
1715617804845,ECE 197,001,548057,Sievenpiper; Daniel F.,9991,0,9999,8
1715617805871,EDS 115,A00,507243,Choi; Bailey Miyeon,7,0,28,21
1715617806901,EDS 117,A01,494379,Staff,0,6,34,34
1715617807925,EDS 125,A00,507246,Hopkins; Megan Beth,8,0,30,22
1715617808950,EDS 128A,A01,507264,Fargason; Sharon Gayle,6,0,26,20
1715617809977,EDS 128B,A01,507293,Pappas; Elizabeth,10,0,30,20
1715617811002,EDS 139,A00,507294,Fargason; Sharon Gayle,10,0,30,20
1715617811002,EDS 139,B00,507313,Pappas; Elizabeth,11,0,30,19
1715617812026,EDS 201,A00,507315,Staff,10,0,30,20
1715617813050,EDS 203,A01,507317,Halter; Christopher P.,10,0,30,20
1715617814077,EDS 204R,A01,507319,Halter; Christopher P.,0,3,30,30
1715617814077,EDS 204R,B01,507331,Heinzman; Erica M.,14,0,30,16
1715617815103,EDS 206R,A00,507332,Staff,0,4,30,30
1715617815103,EDS 206R,B00,507343,Staff,15,0,30,15
1715617816130,EDS 250,A00,507344,Hemans; Patricia Ann Benitez,20,0,40,20
1715617817155,EDS 281,A00,507345,Daly; Alan J.,18,0,18,0
1715617818180,EDS 284,A00,507350,Daly; Alan J.,16,0,16,0
1715617819204,EDS 286,A00,507359,Fine; Sarah,18,0,18,0
1715617820230,EDS 289C,A01,507361,Daly; Alan J.,18,0,18,0
1715617821256,EDS 290,A00,507366,Hofstetter; Carolyn,15,0,15,0
1715617822281,LIGM 5A,A00,507421,Fischer-Grunski; Eva K,17,0,20,3
1715617823308,LIGM 5B,A00,507423,Fischer-Grunski; Eva K,19,0,20,1
1715617824335,LIGM 5C,A00,507425,Fischer-Grunski; Eva K,19,0,20,1
1715617825364,LIIT 5AS,A00,507427,Carnelos; Chiara,20,0,20,0
1715617826389,LIIT 5BS,A00,507430,Carnelos; Chiara,20,0,20,0
1715617827417,LIIT 5CS,A00,507432,Carnelos; Chiara,20,0,20,0
1715617828445,LISP 5A,A00,507541,Munoz Sanchez; Alicia,11,0,20,9
1715617829471,LISP 5B,A00,507671,Munoz Sanchez; Alicia,9,0,20,11
1715617830497,LISP 5C,A00,507696,Munoz Sanchez; Alicia,9,0,20,11
1715617831522,MAE 197,001,528363,Boechler; Nicholas Sebastia,9998,0,9999,1
1715617832553,MATH 197,001,523477,Kedlaya; Kiran S.,9994,0,9999,5
1715617832553,MATH 197,002,563811,Zhang; Danna,9994,0,9999,5
1715617832553,MATH 197,003,628552,Dumitriu; Ioana,9998,0,9999,1
1715617832553,MATH 197,004,660885,Floyd; Eric,9999,0,9999,0
1715617833581,MCWP 40R,A00,518780,Staff,2,0,20,18
1715617833581,MCWP 40R,B00,518781,Staff,11,0,20,9
1715617833581,MCWP 40R,C00,518783,Staff,5,0,20,15
1715617834608,MCWP 50R,A00,518791,Staff,0,1,20,20
1715617834608,MCWP 50R,B00,518792,Staff,0,2,20,20
1715617834608,MCWP 50R,C00,518793,Staff,0,4,20,20
1715617834608,MCWP 50R,D00,518794,Staff,0,1,20,20
1715617834608,MCWP 50R,E00,518795,Staff,0,2,20,20
1715617834608,MCWP 50R,F00,518796,Staff,0,1,20,20
1715617834608,MCWP 50R,G00,518797,Staff,0,1,20,20
1715617835637,MMW 12R,A01,514034,Herbst; Matthew,0,2,16,16
1715617835637,MMW 12R,A02,514035,Herbst; Matthew,0,0,16,16
1715617836663,MMW 13R,A01,514037,Staff,0,5,16,16
1715617836663,MMW 13R,A02,514039,Staff,0,5,16,16
1715617836663,MMW 13R,A03,628519,Staff,0,4,16,16
1715617838722,SIO 295LS,A00,523233,Staff,10,0,30,20
1715617839746,SIO 295S,A00,523232,Staff,10,0,30,20
1715617840776,SIOC 290S,A01,637330,Merrifield; Mark A,23,0,30,7
1715617841803,SIOC 291S,A01,637333,Gabriel; Corey John,23,0,30,7
1715617842833,SOCI 117,A01,494376,Staff,0,5,5,5
1715617843871,WES 237B,A00,494380,Staff,10,0,20,10
1715617845947,AESE 279B,A00,494370,Wade; Jon P,0,0,33,33
1715617846972,AIP 97,001,660915,Van Den Einde; Yael Dahlia,9998,0,9999,1
1715617847997,AIP 197,001,627712,Vespa; Emanuel Ignacio,9995,0,9999,4
1715617847997,AIP 197,002,650778,Amir; On,9998,0,9999,1
1715617847997,AIP 197,003,650933,Avenancio-Leon; Carlos,9998,0,9999,1
1715617847997,AIP 197,004,658530,Heyman; Gail D.,9998,0,9999,1
1715617847997,AIP 197,005,658631,Neal; Sonya E,9998,0,9999,1
1715617847997,AIP 197,006,658671,Du; Songzi,9998,0,9999,1
1715617849021,ANAR 135S,A00,494369,Braswell; Geoffrey E.,0,0,0,0
1715617850045,BENG 196,001,628496,Engler; Adam J.,9998,0,9999,1
1715617850045,BENG 196,002,660916,Watson; John Thomas,9999,0,9999,0
1715617851074,BISP 197,001,650773,Wilhelm; James E.,9994,0,9999,5
1715617851074,BISP 197,002,658904,Coleman; Aaron B.,9998,0,9999,1
1715617852097,CAT 124RS,A01,519847,Geibel; William,0,0,20,20
1715617853123,CAT 125RS,A01,515971,Geibel; William,0,0,20,20
1715617854149,CLRE 250,A00,511389,Morris; Sheldon,9992,0,9999,7
1715617855173,CLRE 251,A00,507176,Mehta; Ravindra L.,9992,0,9999,7
1715617855173,CLRE 251,B00,511410,Mehta; Ravindra L.,9998,0,9999,1
1715617856200,CLRE 252,A00,507189,Cuomo; Raphael Eduardo,9994,0,9999,5
1715617857228,CLRE 253,A00,507199,Vaida; Florin,9994,0,9999,5
1715617857228,CLRE 253,B00,507202,Vaida; Florin,9999,0,9999,0
1715617858252,CLRE 259,A00,507211,Patel; Hemal,9996,0,9999,3
1715617859278,CLRE 260,A00,507221,Cuomo; Raphael Eduardo,9999,0,9999,0
1715617860302,CLRE 297,001,507242,Cuomo; Raphael Eduardo,9999,0,9999,0
1715617861326,COGS 197,001,638244,Voytek; Bradley Thomas,9997,0,9999,2
1715617862372,CSE 191,A00,516875,Minnes Kemp; Mor Mia,9991,0,9999,8
1715617863398,CSE 197,001,637388,Minnes Kemp; Mor Mia,9992,0,9999,7
1715617864425,CSS 201S,A01,494383,Mignozzetti; Umberto,35,0,35,0
1715617865454,CSS 202S,A01,494387,Mignozzetti; Umberto,35,0,35,0
1715617866477,DSC 197,001,628532,Eldridge; Justin Matthew,9995,0,9999,4
1715617867501,EAP 100,A00,516065,Staff,9799,0,9999,200
1715617868526,ECE 45,A01,507414,Staff,31,0,60,29
1715617870576,ECE 111,A01,507420,Staff,11,0,50,39
1715617871601,ECE 197,001,548057,Sievenpiper; Daniel F.,9991,0,9999,8
1715617872627,EDS 115,A00,507243,Choi; Bailey Miyeon,7,0,28,21
1715617873652,EDS 117,A01,494379,Staff,0,6,34,34
1715617874681,EDS 125,A00,507246,Hopkins; Megan Beth,8,0,30,22
1715617875708,EDS 128A,A01,507264,Fargason; Sharon Gayle,6,0,26,20
1715617876732,EDS 128B,A01,507293,Pappas; Elizabeth,10,0,30,20
1715617877758,EDS 139,A00,507294,Fargason; Sharon Gayle,10,0,30,20
1715617877758,EDS 139,B00,507313,Pappas; Elizabeth,11,0,30,19
1715617878785,EDS 201,A00,507315,Staff,10,0,30,20
1715617879810,EDS 203,A01,507317,Halter; Christopher P.,10,0,30,20
1715617880839,EDS 204R,A01,507319,Halter; Christopher P.,0,3,30,30
1715617880839,EDS 204R,B01,507331,Heinzman; Erica M.,14,0,30,16
1715617881867,EDS 206R,A00,507332,Staff,0,4,30,30
1715617881867,EDS 206R,B00,507343,Staff,15,0,30,15
1715617882893,EDS 250,A00,507344,Hemans; Patricia Ann Benitez,20,0,40,20
1715617883919,EDS 281,A00,507345,Daly; Alan J.,18,0,18,0
1715617884945,EDS 284,A00,507350,Daly; Alan J.,16,0,16,0
1715617885974,EDS 286,A00,507359,Fine; Sarah,18,0,18,0
1715617886998,EDS 289C,A01,507361,Daly; Alan J.,18,0,18,0
1715617888025,EDS 290,A00,507366,Hofstetter; Carolyn,15,0,15,0
1715617889053,LIGM 5A,A00,507421,Fischer-Grunski; Eva K,17,0,20,3
1715617890081,LIGM 5B,A00,507423,Fischer-Grunski; Eva K,19,0,20,1
1715617891116,LIGM 5C,A00,507425,Fischer-Grunski; Eva K,19,0,20,1
1715617892145,LIIT 5AS,A00,507427,Carnelos; Chiara,20,0,20,0
1715617893171,LIIT 5BS,A00,507430,Carnelos; Chiara,20,0,20,0
1715617894198,LIIT 5CS,A00,507432,Carnelos; Chiara,20,0,20,0
1715617895227,LISP 5A,A00,507541,Munoz Sanchez; Alicia,11,0,20,9
1715617896257,LISP 5B,A00,507671,Munoz Sanchez; Alicia,9,0,20,11
1715617897287,LISP 5C,A00,507696,Munoz Sanchez; Alicia,9,0,20,11
1715617898315,MAE 197,001,528363,Boechler; Nicholas Sebastia,9998,0,9999,1
1715617899341,MATH 197,001,523477,Kedlaya; Kiran S.,9994,0,9999,5
1715617899341,MATH 197,002,563811,Zhang; Danna,9994,0,9999,5
1715617899341,MATH 197,003,628552,Dumitriu; Ioana,9998,0,9999,1
1715617899341,MATH 197,004,660885,Floyd; Eric,9999,0,9999,0
1715617900369,MCWP 40R,A00,518780,Staff,2,0,20,18
1715617900369,MCWP 40R,B00,518781,Staff,11,0,20,9
1715617900369,MCWP 40R,C00,518783,Staff,5,0,20,15
1715617901398,MCWP 50R,A00,518791,Staff,0,1,20,20
1715617901398,MCWP 50R,B00,518792,Staff,0,2,20,20
1715617901398,MCWP 50R,C00,518793,Staff,0,4,20,20
1715617901398,MCWP 50R,D00,518794,Staff,0,1,20,20
1715617901398,MCWP 50R,E00,518795,Staff,0,2,20,20
1715617901398,MCWP 50R,F00,518796,Staff,0,1,20,20
1715617901398,MCWP 50R,G00,518797,Staff,0,1,20,20
1715617902425,MMW 12R,A01,514034,Herbst; Matthew,0,2,16,16
1715617902425,MMW 12R,A02,514035,Herbst; Matthew,0,0,16,16
1715617903452,MMW 13R,A01,514037,Staff,0,5,16,16
1715617903452,MMW 13R,A02,514039,Staff,0,5,16,16
1715617903452,MMW 13R,A03,628519,Staff,0,4,16,16
1715617905504,SIO 295LS,A00,523233,Staff,10,0,30,20
1715617906532,SIO 295S,A00,523232,Staff,10,0,30,20
1715617907559,SIOC 290S,A01,637330,Merrifield; Mark A,23,0,30,7
1715617908585,SIOC 291S,A01,637333,Gabriel; Corey John,23,0,30,7
1715617909611,SOCI 117,A01,494376,Staff,0,5,5,5
1715617910642,WES 237B,A00,494380,Staff,10,0,20,10
1715617912709,AESE 279B,A00,494370,Wade; Jon P,0,0,33,33
1715617913735,AIP 97,001,660915,Van Den Einde; Yael Dahlia,9998,0,9999,1
1715617914766,AIP 197,001,627712,Vespa; Emanuel Ignacio,9995,0,9999,4
1715617914766,AIP 197,002,650778,Amir; On,9998,0,9999,1
1715617914766,AIP 197,003,650933,Avenancio-Leon; Carlos,9998,0,9999,1
1715617914766,AIP 197,004,658530,Heyman; Gail D.,9998,0,9999,1
1715617914766,AIP 197,005,658631,Neal; Sonya E,9998,0,9999,1
1715617914766,AIP 197,006,658671,Du; Songzi,9998,0,9999,1
1715617915792,ANAR 135S,A00,494369,Braswell; Geoffrey E.,0,0,0,0
1715617916817,BENG 196,001,628496,Engler; Adam J.,9998,0,9999,1
1715617916817,BENG 196,002,660916,Watson; John Thomas,9999,0,9999,0
1715617917843,BISP 197,001,650773,Wilhelm; James E.,9994,0,9999,5
1715617917843,BISP 197,002,658904,Coleman; Aaron B.,9998,0,9999,1
1715617918868,CAT 124RS,A01,519847,Geibel; William,0,0,20,20
1715617919895,CAT 125RS,A01,515971,Geibel; William,0,0,20,20
1715617920925,CLRE 250,A00,511389,Morris; Sheldon,9992,0,9999,7
1715617921950,CLRE 251,A00,507176,Mehta; Ravindra L.,9992,0,9999,7
1715617921950,CLRE 251,B00,511410,Mehta; Ravindra L.,9998,0,9999,1
1715617922977,CLRE 252,A00,507189,Cuomo; Raphael Eduardo,9994,0,9999,5
1715617924005,CLRE 253,A00,507199,Vaida; Florin,9994,0,9999,5
1715617924005,CLRE 253,B00,507202,Vaida; Florin,9999,0,9999,0
1715617925031,CLRE 259,A00,507211,Patel; Hemal,9996,0,9999,3
1715617926057,CLRE 260,A00,507221,Cuomo; Raphael Eduardo,9999,0,9999,0
1715617927082,CLRE 297,001,507242,Cuomo; Raphael Eduardo,9999,0,9999,0
1715617928110,COGS 197,001,638244,Voytek; Bradley Thomas,9997,0,9999,2
1715617929135,CSE 191,A00,516875,Minnes Kemp; Mor Mia,9991,0,9999,8
1715617930161,CSE 197,001,637388,Minnes Kemp; Mor Mia,9992,0,9999,7
1715617931192,CSS 201S,A01,494383,Mignozzetti; Umberto,35,0,35,0
1715617932221,CSS 202S,A01,494387,Mignozzetti; Umberto,35,0,35,0
1715617933248,DSC 197,001,628532,Eldridge; Justin Matthew,9995,0,9999,4
1715617934275,EAP 100,A00,516065,Staff,9799,0,9999,200
1715617935302,ECE 45,A01,507414,Staff,31,0,60,29
1715617937358,ECE 111,A01,507420,Staff,11,0,50,39
1715617938385,ECE 197,001,548057,Sievenpiper; Daniel F.,9991,0,9999,8
1715617939411,EDS 115,A00,507243,Choi; Bailey Miyeon,7,0,28,21
1715617940438,EDS 117,A01,494379,Staff,0,6,34,34
1715617941462,EDS 125,A00,507246,Hopkins; Megan Beth,8,0,30,22
1715617942490,EDS 128A,A01,507264,Fargason; Sharon Gayle,6,0,26,20
1715617943520,EDS 128B,A01,507293,Pappas; Elizabeth,10,0,30,20
1715617944544,EDS 139,A00,507294,Fargason; Sharon Gayle,10,0,30,20
1715617944544,EDS 139,B00,507313,Pappas; Elizabeth,11,0,30,19
1715617945569,EDS 201,A00,507315,Staff,10,0,30,20
1715617946594,EDS 203,A01,507317,Halter; Christopher P.,10,0,30,20
1715617947619,EDS 204R,A01,507319,Halter; Christopher P.,0,3,30,30
1715617947619,EDS 204R,B01,507331,Heinzman; Erica M.,14,0,30,16
1715617948647,EDS 206R,A00,507332,Staff,0,4,30,30
1715617948647,EDS 206R,B00,507343,Staff,15,0,30,15
1715617949676,EDS 250,A00,507344,Hemans; Patricia Ann Benitez,20,0,40,20
1715617950701,EDS 281,A00,507345,Daly; Alan J.,18,0,18,0
1715617951726,EDS 284,A00,507350,Daly; Alan J.,16,0,16,0
1715617952750,EDS 286,A00,507359,Fine; Sarah,18,0,18,0
1715617953777,EDS 289C,A01,507361,Daly; Alan J.,18,0,18,0
1715617954802,EDS 290,A00,507366,Hofstetter; Carolyn,15,0,15,0
1715617955832,LIGM 5A,A00,507421,Fischer-Grunski; Eva K,17,0,20,3
1715617956857,LIGM 5B,A00,507423,Fischer-Grunski; Eva K,19,0,20,1
1715617957882,LIGM 5C,A00,507425,Fischer-Grunski; Eva K,19,0,20,1
1715617958909,LIIT 5AS,A00,507427,Carnelos; Chiara,20,0,20,0
1715617959937,LIIT 5BS,A00,507430,Carnelos; Chiara,20,0,20,0
1715617960962,LIIT 5CS,A00,507432,Carnelos; Chiara,20,0,20,0
1715617961988,LISP 5A,A00,507541,Munoz Sanchez; Alicia,11,0,20,9
1715617963017,LISP 5B,A00,507671,Munoz Sanchez; Alicia,9,0,20,11
1715617964044,LISP 5C,A00,507696,Munoz Sanchez; Alicia,9,0,20,11
1715617965069,MAE 197,001,528363,Boechler; Nicholas Sebastia,9998,0,9999,1
1715617966096,MATH 197,001,523477,Kedlaya; Kiran S.,9994,0,9999,5
1715617966096,MATH 197,002,563811,Zhang; Danna,9994,0,9999,5
1715617966096,MATH 197,003,628552,Dumitriu; Ioana,9998,0,9999,1
1715617966096,MATH 197,004,660885,Floyd; Eric,9999,0,9999,0
1715617967124,MCWP 40R,A00,518780,Staff,2,0,20,18
1715617967124,MCWP 40R,B00,518781,Staff,11,0,20,9
1715617967124,MCWP 40R,C00,518783,Staff,5,0,20,15
1715617968154,MCWP 50R,A00,518791,Staff,0,1,20,20
1715617968154,MCWP 50R,B00,518792,Staff,0,2,20,20
1715617968154,MCWP 50R,C00,518793,Staff,0,4,20,20
1715617968154,MCWP 50R,D00,518794,Staff,0,1,20,20
1715617968154,MCWP 50R,E00,518795,Staff,0,2,20,20
1715617968154,MCWP 50R,F00,518796,Staff,0,1,20,20
1715617968154,MCWP 50R,G00,518797,Staff,0,1,20,20
1715617969183,MMW 12R,A01,514034,Herbst; Matthew,0,2,16,16
1715617969183,MMW 12R,A02,514035,Herbst; Matthew,0,0,16,16
1715617970208,MMW 13R,A01,514037,Staff,0,5,16,16
1715617970208,MMW 13R,A02,514039,Staff,0,5,16,16
1715617970208,MMW 13R,A03,628519,Staff,0,4,16,16
1715617972269,SIO 295LS,A00,523233,Staff,10,0,30,20
1715617973296,SIO 295S,A00,523232,Staff,10,0,30,20
1715617974327,SIOC 290S,A01,637330,Merrifield; Mark A,23,0,30,7
1715617975353,SIOC 291S,A01,637333,Gabriel; Corey John,23,0,30,7
1715617976385,SOCI 117,A01,494376,Staff,0,5,5,5
1715617977411,WES 237B,A00,494380,Staff,10,0,20,10
1715617979493,AESE 279B,A00,494370,Wade; Jon P,0,0,33,33
1715617980521,AIP 97,001,660915,Van Den Einde; Yael Dahlia,9998,0,9999,1
1715617981549,AIP 197,001,627712,Vespa; Emanuel Ignacio,9995,0,9999,4
1715617981549,AIP 197,002,650778,Amir; On,9998,0,9999,1
1715617981549,AIP 197,003,650933,Avenancio-Leon; Carlos,9998,0,9999,1
1715617981549,AIP 197,004,658530,Heyman; Gail D.,9998,0,9999,1
1715617981549,AIP 197,005,658631,Neal; Sonya E,9998,0,9999,1
1715617981549,AIP 197,006,658671,Du; Songzi,9998,0,9999,1
1715617982580,ANAR 135S,A00,494369,Braswell; Geoffrey E.,0,0,0,0
1715617983607,BENG 196,001,628496,Engler; Adam J.,9998,0,9999,1
1715617983607,BENG 196,002,660916,Watson; John Thomas,9999,0,9999,0
1715617984633,BISP 197,001,650773,Wilhelm; James E.,9994,0,9999,5
1715617984633,BISP 197,002,658904,Coleman; Aaron B.,9998,0,9999,1
1715617985658,CAT 124RS,A01,519847,Geibel; William,0,0,20,20
1715617986685,CAT 125RS,A01,515971,Geibel; William,0,0,20,20
1715617987710,CLRE 250,A00,511389,Morris; Sheldon,9992,0,9999,7
1715617988740,CLRE 251,A00,507176,Mehta; Ravindra L.,9992,0,9999,7
1715617988740,CLRE 251,B00,511410,Mehta; Ravindra L.,9998,0,9999,1
1715617989766,CLRE 252,A00,507189,Cuomo; Raphael Eduardo,9994,0,9999,5
1715617990791,CLRE 253,A00,507199,Vaida; Florin,9994,0,9999,5
1715617990791,CLRE 253,B00,507202,Vaida; Florin,9999,0,9999,0
1715617991820,CLRE 259,A00,507211,Patel; Hemal,9996,0,9999,3
1715617992845,CLRE 260,A00,507221,Cuomo; Raphael Eduardo,9999,0,9999,0
1715617993877,CLRE 297,001,507242,Cuomo; Raphael Eduardo,9999,0,9999,0
1715617994904,COGS 197,001,638244,Voytek; Bradley Thomas,9997,0,9999,2
1715617995931,CSE 191,A00,516875,Minnes Kemp; Mor Mia,9991,0,9999,8
1715617996956,CSE 197,001,637388,Minnes Kemp; Mor Mia,9992,0,9999,7
1715617997986,CSS 201S,A01,494383,Mignozzetti; Umberto,35,0,35,0
1715617999049,CSS 202S,A01,494387,Mignozzetti; Umberto,35,0,35,0
1715618000076,DSC 197,001,628532,Eldridge; Justin Matthew,9995,0,9999,4
1715618001103,EAP 100,A00,516065,Staff,9799,0,9999,200
1715618002130,ECE 45,A01,507414,Staff,31,0,60,29
1715618004184,ECE 111,A01,507420,Staff,11,0,50,39
1715618005211,ECE 197,001,548057,Sievenpiper; Daniel F.,9991,0,9999,8
1715618006236,EDS 115,A00,507243,Choi; Bailey Miyeon,7,0,28,21
1715618007261,EDS 117,A01,494379,Staff,0,6,34,34
1715618008288,EDS 125,A00,507246,Hopkins; Megan Beth,8,0,30,22
1715618009318,EDS 128A,A01,507264,Fargason; Sharon Gayle,6,0,26,20
1715618010347,EDS 128B,A01,507293,Pappas; Elizabeth,10,0,30,20
1715618011374,EDS 139,A00,507294,Fargason; Sharon Gayle,10,0,30,20
1715618011374,EDS 139,B00,507313,Pappas; Elizabeth,11,0,30,19
1715618012403,EDS 201,A00,507315,Staff,10,0,30,20
1715618013432,EDS 203,A01,507317,Halter; Christopher P.,10,0,30,20
1715618014460,EDS 204R,A01,507319,Halter; Christopher P.,0,3,30,30
1715618014460,EDS 204R,B01,507331,Heinzman; Erica M.,14,0,30,16
1715618015484,EDS 206R,A00,507332,Staff,0,4,30,30
1715618015484,EDS 206R,B00,507343,Staff,15,0,30,15
1715618016509,EDS 250,A00,507344,Hemans; Patricia Ann Benitez,20,0,40,20
1715618017534,EDS 281,A00,507345,Daly; Alan J.,18,0,18,0
1715618018559,EDS 284,A00,507350,Daly; Alan J.,16,0,16,0
1715618019585,EDS 286,A00,507359,Fine; Sarah,18,0,18,0
1715618020610,EDS 289C,A01,507361,Daly; Alan J.,18,0,18,0
1715618021635,EDS 290,A00,507366,Hofstetter; Carolyn,15,0,15,0
1715618022661,LIGM 5A,A00,507421,Fischer-Grunski; Eva K,17,0,20,3
1715618023687,LIGM 5B,A00,507423,Fischer-Grunski; Eva K,19,0,20,1
1715618024713,LIGM 5C,A00,507425,Fischer-Grunski; Eva K,19,0,20,1
1715618025739,LIIT 5AS,A00,507427,Carnelos; Chiara,20,0,20,0
1715618026764,LIIT 5BS,A00,507430,Carnelos; Chiara,20,0,20,0
1715618027790,LIIT 5CS,A00,507432,Carnelos; Chiara,20,0,20,0
1715618028819,LISP 5A,A00,507541,Munoz Sanchez; Alicia,11,0,20,9
1715618029854,LISP 5B,A00,507671,Munoz Sanchez; Alicia,9,0,20,11
1715618030878,LISP 5C,A00,507696,Munoz Sanchez; Alicia,9,0,20,11
1715618031907,MAE 197,001,528363,Boechler; Nicholas Sebastia,9998,0,9999,1
1715618032937,MATH 197,001,523477,Kedlaya; Kiran S.,9994,0,9999,5
1715618032937,MATH 197,002,563811,Zhang; Danna,9994,0,9999,5
1715618032937,MATH 197,003,628552,Dumitriu; Ioana,9998,0,9999,1
1715618032937,MATH 197,004,660885,Floyd; Eric,9999,0,9999,0
1715618033963,MCWP 40R,A00,518780,Staff,2,0,20,18
1715618033963,MCWP 40R,B00,518781,Staff,11,0,20,9
1715618033963,MCWP 40R,C00,518783,Staff,5,0,20,15
1715618034989,MCWP 50R,A00,518791,Staff,0,1,20,20
1715618034989,MCWP 50R,B00,518792,Staff,0,2,20,20
1715618034989,MCWP 50R,C00,518793,Staff,0,4,20,20
1715618034989,MCWP 50R,D00,518794,Staff,0,1,20,20
1715618034989,MCWP 50R,E00,518795,Staff,0,2,20,20
1715618034989,MCWP 50R,F00,518796,Staff,0,1,20,20
1715618034989,MCWP 50R,G00,518797,Staff,0,1,20,20
1715618036013,MMW 12R,A01,514034,Herbst; Matthew,0,2,16,16
1715618036013,MMW 12R,A02,514035,Herbst; Matthew,0,0,16,16
1715618037041,MMW 13R,A01,514037,Staff,0,5,16,16
1715618037041,MMW 13R,A02,514039,Staff,0,5,16,16
1715618037041,MMW 13R,A03,628519,Staff,0,4,16,16
1715618039095,SIO 295LS,A00,523233,Staff,10,0,30,20
1715618040122,SIO 295S,A00,523232,Staff,10,0,30,20
1715618041146,SIOC 290S,A01,637330,Merrifield; Mark A,23,0,30,7
1715618042174,SIOC 291S,A01,637333,Gabriel; Corey John,23,0,30,7
1715618043201,SOCI 117,A01,494376,Staff,0,5,5,5
1715618044227,WES 237B,A00,494380,Staff,10,0,20,10
1715618046294,AESE 279B,A00,494370,Wade; Jon P,0,0,33,33
1715618047319,AIP 97,001,660915,Van Den Einde; Yael Dahlia,9998,0,9999,1
1715618048348,AIP 197,001,627712,Vespa; Emanuel Ignacio,9995,0,9999,4
1715618048348,AIP 197,002,650778,Amir; On,9998,0,9999,1
1715618048348,AIP 197,003,650933,Avenancio-Leon; Carlos,9998,0,9999,1
1715618048348,AIP 197,004,658530,Heyman; Gail D.,9998,0,9999,1
1715618048348,AIP 197,005,658631,Neal; Sonya E,9998,0,9999,1
1715618048348,AIP 197,006,658671,Du; Songzi,9998,0,9999,1
1715618049372,ANAR 135S,A00,494369,Braswell; Geoffrey E.,0,0,0,0
1715618050400,BENG 196,001,628496,Engler; Adam J.,9998,0,9999,1
1715618050400,BENG 196,002,660916,Watson; John Thomas,9999,0,9999,0
1715618051425,BISP 197,001,650773,Wilhelm; James E.,9994,0,9999,5
1715618051425,BISP 197,002,658904,Coleman; Aaron B.,9998,0,9999,1
1715618052450,CAT 124RS,A01,519847,Geibel; William,0,0,20,20
1715618053477,CAT 125RS,A01,515971,Geibel; William,0,0,20,20
1715618054502,CLRE 250,A00,511389,Morris; Sheldon,9992,0,9999,7
1715618055529,CLRE 251,A00,507176,Mehta; Ravindra L.,9992,0,9999,7
1715618055529,CLRE 251,B00,511410,Mehta; Ravindra L.,9998,0,9999,1
1715618056555,CLRE 252,A00,507189,Cuomo; Raphael Eduardo,9994,0,9999,5
1715618057579,CLRE 253,A00,507199,Vaida; Florin,9994,0,9999,5
1715618057579,CLRE 253,B00,507202,Vaida; Florin,9999,0,9999,0
1715618058604,CLRE 259,A00,507211,Patel; Hemal,9996,0,9999,3
1715618059630,CLRE 260,A00,507221,Cuomo; Raphael Eduardo,9999,0,9999,0
1715618060656,CLRE 297,001,507242,Cuomo; Raphael Eduardo,9999,0,9999,0
1715618061682,COGS 197,001,638244,Voytek; Bradley Thomas,9997,0,9999,2
1715618062707,CSE 191,A00,516875,Minnes Kemp; Mor Mia,9991,0,9999,8
1715618063733,CSE 197,001,637388,Minnes Kemp; Mor Mia,9992,0,9999,7
1715618064763,CSS 201S,A01,494383,Mignozzetti; Umberto,35,0,35,0
1715618065788,CSS 202S,A01,494387,Mignozzetti; Umberto,35,0,35,0
1715618066816,DSC 197,001,628532,Eldridge; Justin Matthew,9995,0,9999,4
1715618067842,EAP 100,A00,516065,Staff,9799,0,9999,200
1715618068867,ECE 45,A01,507414,Staff,31,0,60,29
1715618070919,ECE 111,A01,507420,Staff,11,0,50,39
1715618071946,ECE 197,001,548057,Sievenpiper; Daniel F.,9991,0,9999,8
1715618072972,EDS 115,A00,507243,Choi; Bailey Miyeon,7,0,28,21
1715618073997,EDS 117,A01,494379,Staff,0,6,34,34
1715618075025,EDS 125,A00,507246,Hopkins; Megan Beth,8,0,30,22
1715618076049,EDS 128A,A01,507264,Fargason; Sharon Gayle,6,0,26,20
1715618077075,EDS 128B,A01,507293,Pappas; Elizabeth,10,0,30,20
1715618078100,EDS 139,A00,507294,Fargason; Sharon Gayle,10,0,30,20
1715618078100,EDS 139,B00,507313,Pappas; Elizabeth,11,0,30,19
1715618079124,EDS 201,A00,507315,Staff,10,0,30,20
1715618080152,EDS 203,A01,507317,Halter; Christopher P.,10,0,30,20
1715618081181,EDS 204R,A01,507319,Halter; Christopher P.,0,3,30,30
1715618081181,EDS 204R,B01,507331,Heinzman; Erica M.,14,0,30,16
1715618082206,EDS 206R,A00,507332,Staff,0,4,30,30
1715618082206,EDS 206R,B00,507343,Staff,15,0,30,15
1715618083231,EDS 250,A00,507344,Hemans; Patricia Ann Benitez,20,0,40,20
1715618084256,EDS 281,A00,507345,Daly; Alan J.,18,0,18,0
1715618085281,EDS 284,A00,507350,Daly; Alan J.,16,0,16,0
1715618086308,EDS 286,A00,507359,Fine; Sarah,18,0,18,0
1715618087333,EDS 289C,A01,507361,Daly; Alan J.,18,0,18,0
1715618088360,EDS 290,A00,507366,Hofstetter; Carolyn,15,0,15,0
1715618089392,LIGM 5A,A00,507421,Fischer-Grunski; Eva K,17,0,20,3
1715618090417,LIGM 5B,A00,507423,Fischer-Grunski; Eva K,19,0,20,1
1715618091448,LIGM 5C,A00,507425,Fischer-Grunski; Eva K,19,0,20,1
1715618092475,LIIT 5AS,A00,507427,Carnelos; Chiara,20,0,20,0
1715618093501,LIIT 5BS,A00,507430,Carnelos; Chiara,20,0,20,0
1715618094528,LIIT 5CS,A00,507432,Carnelos; Chiara,20,0,20,0
1715618095558,LISP 5A,A00,507541,Munoz Sanchez; Alicia,11,0,20,9
1715618096584,LISP 5B,A00,507671,Munoz Sanchez; Alicia,9,0,20,11
1715618097613,LISP 5C,A00,507696,Munoz Sanchez; Alicia,9,0,20,11
1715618098645,MAE 197,001,528363,Boechler; Nicholas Sebastia,9998,0,9999,1
1715618099676,MATH 197,001,523477,Kedlaya; Kiran S.,9994,0,9999,5
1715618099676,MATH 197,002,563811,Zhang; Danna,9994,0,9999,5
1715618099676,MATH 197,003,628552,Dumitriu; Ioana,9998,0,9999,1
1715618099676,MATH 197,004,660885,Floyd; Eric,9999,0,9999,0
1715618100705,MCWP 40R,A00,518780,Staff,2,0,20,18
1715618100705,MCWP 40R,B00,518781,Staff,11,0,20,9
1715618100705,MCWP 40R,C00,518783,Staff,5,0,20,15
1715618101733,MCWP 50R,A00,518791,Staff,0,1,20,20
1715618101733,MCWP 50R,B00,518792,Staff,0,2,20,20
1715618101733,MCWP 50R,C00,518793,Staff,0,4,20,20
1715618101733,MCWP 50R,D00,518794,Staff,0,1,20,20
1715618101733,MCWP 50R,E00,518795,Staff,0,2,20,20
1715618101733,MCWP 50R,F00,518796,Staff,0,1,20,20
1715618101733,MCWP 50R,G00,518797,Staff,0,1,20,20
1715618102787,MMW 12R,A01,514034,Herbst; Matthew,0,2,16,16
1715618102787,MMW 12R,A02,514035,Herbst; Matthew,0,0,16,16
1715618103814,MMW 13R,A01,514037,Staff,0,5,16,16
1715618103814,MMW 13R,A02,514039,Staff,0,5,16,16
1715618103814,MMW 13R,A03,628519,Staff,0,4,16,16
1715618105865,SIO 295LS,A00,523233,Staff,10,0,30,20
1715618106893,SIO 295S,A00,523232,Staff,10,0,30,20
1715618107917,SIOC 290S,A01,637330,Merrifield; Mark A,23,0,30,7
1715618108948,SIOC 291S,A01,637333,Gabriel; Corey John,23,0,30,7
1715618109979,SOCI 117,A01,494376,Staff,0,5,5,5
1715618111007,WES 237B,A00,494380,Staff,10,0,20,10
1715618113077,AESE 279B,A00,494370,Wade; Jon P,0,0,33,33
1715618114100,AIP 97,001,660915,Van Den Einde; Yael Dahlia,9998,0,9999,1
1715618115128,AIP 197,001,627712,Vespa; Emanuel Ignacio,9995,0,9999,4
1715618115128,AIP 197,002,650778,Amir; On,9998,0,9999,1
1715618115128,AIP 197,003,650933,Avenancio-Leon; Carlos,9998,0,9999,1
1715618115128,AIP 197,004,658530,Heyman; Gail D.,9998,0,9999,1
1715618115128,AIP 197,005,658631,Neal; Sonya E,9998,0,9999,1
1715618115128,AIP 197,006,658671,Du; Songzi,9998,0,9999,1
1715618116156,ANAR 135S,A00,494369,Braswell; Geoffrey E.,0,0,0,0
1715618117187,BENG 196,001,628496,Engler; Adam J.,9998,0,9999,1
1715618117187,BENG 196,002,660916,Watson; John Thomas,9999,0,9999,0
1715618118213,BISP 197,001,650773,Wilhelm; James E.,9994,0,9999,5
1715618118213,BISP 197,002,658904,Coleman; Aaron B.,9998,0,9999,1
1715618119239,CAT 124RS,A01,519847,Geibel; William,0,0,20,20
1715618120265,CAT 125RS,A01,515971,Geibel; William,0,0,20,20
1715618121290,CLRE 250,A00,511389,Morris; Sheldon,9992,0,9999,7
1715618122316,CLRE 251,A00,507176,Mehta; Ravindra L.,9992,0,9999,7
1715618122316,CLRE 251,B00,511410,Mehta; Ravindra L.,9998,0,9999,1
1715618123342,CLRE 252,A00,507189,Cuomo; Raphael Eduardo,9994,0,9999,5
1715618124367,CLRE 253,A00,507199,Vaida; Florin,9994,0,9999,5
1715618124367,CLRE 253,B00,507202,Vaida; Florin,9999,0,9999,0
1715618125395,CLRE 259,A00,507211,Patel; Hemal,9996,0,9999,3
1715618126421,CLRE 260,A00,507221,Cuomo; Raphael Eduardo,9999,0,9999,0
1715618127446,CLRE 297,001,507242,Cuomo; Raphael Eduardo,9999,0,9999,0
1715618128473,COGS 197,001,638244,Voytek; Bradley Thomas,9997,0,9999,2
1715618129498,CSE 191,A00,516875,Minnes Kemp; Mor Mia,9991,0,9999,8
1715618130524,CSE 197,001,637388,Minnes Kemp; Mor Mia,9992,0,9999,7
1715618131556,CSS 201S,A01,494383,Mignozzetti; Umberto,35,0,35,0
1715618132583,CSS 202S,A01,494387,Mignozzetti; Umberto,35,0,35,0
1715618133610,DSC 197,001,628532,Eldridge; Justin Matthew,9995,0,9999,4
1715618134634,EAP 100,A00,516065,Staff,9799,0,9999,200
1715618135665,ECE 45,A01,507414,Staff,31,0,60,29
1715618137722,ECE 111,A01,507420,Staff,11,0,50,39
1715618138749,ECE 197,001,548057,Sievenpiper; Daniel F.,9991,0,9999,8
1715618139774,EDS 115,A00,507243,Choi; Bailey Miyeon,7,0,28,21
1715618140803,EDS 117,A01,494379,Staff,0,6,34,34
1715618141829,EDS 125,A00,507246,Hopkins; Megan Beth,8,0,30,22
1715618142853,EDS 128A,A01,507264,Fargason; Sharon Gayle,6,0,26,20
1715618143880,EDS 128B,A01,507293,Pappas; Elizabeth,10,0,30,20
1715618144905,EDS 139,A00,507294,Fargason; Sharon Gayle,10,0,30,20
1715618144905,EDS 139,B00,507313,Pappas; Elizabeth,11,0,30,19
1715618145930,EDS 201,A00,507315,Staff,10,0,30,20
1715618146958,EDS 203,A01,507317,Halter; Christopher P.,10,0,30,20
1715618147988,EDS 204R,A01,507319,Halter; Christopher P.,0,3,30,30
1715618147988,EDS 204R,B01,507331,Heinzman; Erica M.,14,0,30,16
1715618149016,EDS 206R,A00,507332,Staff,0,4,30,30
1715618149016,EDS 206R,B00,507343,Staff,15,0,30,15
1715618150042,EDS 250,A00,507344,Hemans; Patricia Ann Benitez,20,0,40,20
1715618151070,EDS 281,A00,507345,Daly; Alan J.,18,0,18,0
1715618152098,EDS 284,A00,507350,Daly; Alan J.,16,0,16,0
1715618153124,EDS 286,A00,507359,Fine; Sarah,18,0,18,0
1715618154150,EDS 289C,A01,507361,Daly; Alan J.,18,0,18,0
1715618155177,EDS 290,A00,507366,Hofstetter; Carolyn,15,0,15,0
1715618156204,LIGM 5A,A00,507421,Fischer-Grunski; Eva K,17,0,20,3
1715618157232,LIGM 5B,A00,507423,Fischer-Grunski; Eva K,19,0,20,1
1715618158258,LIGM 5C,A00,507425,Fischer-Grunski; Eva K,19,0,20,1
1715618159283,LIIT 5AS,A00,507427,Carnelos; Chiara,20,0,20,0
1715618160307,LIIT 5BS,A00,507430,Carnelos; Chiara,20,0,20,0
1715618161336,LIIT 5CS,A00,507432,Carnelos; Chiara,20,0,20,0
1715618162361,LISP 5A,A00,507541,Munoz Sanchez; Alicia,11,0,20,9
1715618163390,LISP 5B,A00,507671,Munoz Sanchez; Alicia,9,0,20,11
1715618164414,LISP 5C,A00,507696,Munoz Sanchez; Alicia,9,0,20,11
1715618165441,MAE 197,001,528363,Boechler; Nicholas Sebastia,9998,0,9999,1
1715618166470,MATH 197,001,523477,Kedlaya; Kiran S.,9994,0,9999,5
1715618166470,MATH 197,002,563811,Zhang; Danna,9994,0,9999,5
1715618166470,MATH 197,003,628552,Dumitriu; Ioana,9998,0,9999,1
1715618166470,MATH 197,004,660885,Floyd; Eric,9998,0,9999,1
1715618167498,MCWP 40R,A00,518780,Staff,2,0,20,18
1715618167498,MCWP 40R,B00,518781,Staff,11,0,20,9
1715618167498,MCWP 40R,C00,518783,Staff,5,0,20,15
1715618168527,MCWP 50R,A00,518791,Staff,0,1,20,20
1715618168527,MCWP 50R,B00,518792,Staff,0,2,20,20
1715618168527,MCWP 50R,C00,518793,Staff,0,4,20,20
1715618168527,MCWP 50R,D00,518794,Staff,0,1,20,20
1715618168527,MCWP 50R,E00,518795,Staff,0,2,20,20
1715618168527,MCWP 50R,F00,518796,Staff,0,1,20,20
1715618168527,MCWP 50R,G00,518797,Staff,0,1,20,20
1715618169551,MMW 12R,A01,514034,Herbst; Matthew,0,2,16,16
1715618169551,MMW 12R,A02,514035,Herbst; Matthew,0,0,16,16
1715618170576,MMW 13R,A01,514037,Staff,0,5,16,16
1715618170576,MMW 13R,A02,514039,Staff,0,5,16,16
1715618170576,MMW 13R,A03,628519,Staff,0,4,16,16
1715618172630,SIO 295LS,A00,523233,Staff,10,0,30,20
1715618173655,SIO 295S,A00,523232,Staff,10,0,30,20
1715618174681,SIOC 290S,A01,637330,Merrifield; Mark A,23,0,30,7
1715618175706,SIOC 291S,A01,637333,Gabriel; Corey John,23,0,30,7
1715618176732,SOCI 117,A01,494376,Staff,0,5,5,5
1715618177759,WES 237B,A00,494380,Staff,10,0,20,10
1715618179817,AESE 279B,A00,494370,Wade; Jon P,0,0,33,33
1715618180845,AIP 97,001,660915,Van Den Einde; Yael Dahlia,9998,0,9999,1
1715618181875,AIP 197,001,627712,Vespa; Emanuel Ignacio,9995,0,9999,4
1715618181875,AIP 197,002,650778,Amir; On,9998,0,9999,1
1715618181875,AIP 197,003,650933,Avenancio-Leon; Carlos,9998,0,9999,1
1715618181875,AIP 197,004,658530,Heyman; Gail D.,9998,0,9999,1
1715618181875,AIP 197,005,658631,Neal; Sonya E,9998,0,9999,1
1715618181875,AIP 197,006,658671,Du; Songzi,9998,0,9999,1
1715618182903,ANAR 135S,A00,494369,Braswell; Geoffrey E.,0,0,0,0
1715618183932,BENG 196,001,628496,Engler; Adam J.,9998,0,9999,1
1715618183932,BENG 196,002,660916,Watson; John Thomas,9999,0,9999,0
1715618184961,BISP 197,001,650773,Wilhelm; James E.,9994,0,9999,5
1715618184961,BISP 197,002,658904,Coleman; Aaron B.,9998,0,9999,1
1715618185986,CAT 124RS,A01,519847,Geibel; William,0,0,20,20
1715618187011,CAT 125RS,A01,515971,Geibel; William,0,0,20,20
1715618188040,CLRE 250,A00,511389,Morris; Sheldon,9992,0,9999,7
1715618189067,CLRE 251,A00,507176,Mehta; Ravindra L.,9992,0,9999,7
1715618189067,CLRE 251,B00,511410,Mehta; Ravindra L.,9998,0,9999,1
1715618190095,CLRE 252,A00,507189,Cuomo; Raphael Eduardo,9994,0,9999,5
1715618191125,CLRE 253,A00,507199,Vaida; Florin,9994,0,9999,5
1715618191125,CLRE 253,B00,507202,Vaida; Florin,9999,0,9999,0
1715618192152,CLRE 259,A00,507211,Patel; Hemal,9996,0,9999,3
1715618193177,CLRE 260,A00,507221,Cuomo; Raphael Eduardo,9999,0,9999,0
1715618194202,CLRE 297,001,507242,Cuomo; Raphael Eduardo,9999,0,9999,0
1715618195226,COGS 197,001,638244,Voytek; Bradley Thomas,9997,0,9999,2
1715618196250,CSE 191,A00,516875,Minnes Kemp; Mor Mia,9991,0,9999,8
1715618197276,CSE 197,001,637388,Minnes Kemp; Mor Mia,9992,0,9999,7
1715618198301,CSS 201S,A01,494383,Mignozzetti; Umberto,35,0,35,0
1715618199331,CSS 202S,A01,494387,Mignozzetti; Umberto,35,0,35,0
1715618200360,DSC 197,001,628532,Eldridge; Justin Matthew,9995,0,9999,4
1715618201386,EAP 100,A00,516065,Staff,9799,0,9999,200
1715618202413,ECE 45,A01,507414,Staff,31,0,60,29
1715618204467,ECE 111,A01,507420,Staff,11,0,50,39
1715618205496,ECE 197,001,548057,Sievenpiper; Daniel F.,9991,0,9999,8
1715618206524,EDS 115,A00,507243,Choi; Bailey Miyeon,7,0,28,21
1715618207554,EDS 117,A01,494379,Staff,0,6,34,34
1715618208579,EDS 125,A00,507246,Hopkins; Megan Beth,8,0,30,22
1715618209608,EDS 128A,A01,507264,Fargason; Sharon Gayle,6,0,26,20
1715618210634,EDS 128B,A01,507293,Pappas; Elizabeth,10,0,30,20
1715618211661,EDS 139,A00,507294,Fargason; Sharon Gayle,10,0,30,20
1715618211661,EDS 139,B00,507313,Pappas; Elizabeth,11,0,30,19
1715618212687,EDS 201,A00,507315,Staff,10,0,30,20
1715618213714,EDS 203,A01,507317,Halter; Christopher P.,10,0,30,20
1715618214740,EDS 204R,A01,507319,Halter; Christopher P.,0,3,30,30
1715618214740,EDS 204R,B01,507331,Heinzman; Erica M.,14,0,30,16
1715618215769,EDS 206R,A00,507332,Staff,0,4,30,30
1715618215769,EDS 206R,B00,507343,Staff,15,0,30,15
1715618216795,EDS 250,A00,507344,Hemans; Patricia Ann Benitez,20,0,40,20
1715618217824,EDS 281,A00,507345,Daly; Alan J.,18,0,18,0
1715618218851,EDS 284,A00,507350,Daly; Alan J.,16,0,16,0
1715618219878,EDS 286,A00,507359,Fine; Sarah,18,0,18,0
1715618220906,EDS 289C,A01,507361,Daly; Alan J.,18,0,18,0
1715618221935,EDS 290,A00,507366,Hofstetter; Carolyn,15,0,15,0
1715618223018,LIGM 5A,A00,507421,Fischer-Grunski; Eva K,17,0,20,3
1715618224046,LIGM 5B,A00,507423,Fischer-Grunski; Eva K,19,0,20,1
1715618225071,LIGM 5C,A00,507425,Fischer-Grunski; Eva K,19,0,20,1
1715618226097,LIIT 5AS,A00,507427,Carnelos; Chiara,20,0,20,0
1715618227127,LIIT 5BS,A00,507430,Carnelos; Chiara,20,0,20,0
1715618228153,LIIT 5CS,A00,507432,Carnelos; Chiara,20,0,20,0
1715618229183,LISP 5A,A00,507541,Munoz Sanchez; Alicia,11,0,20,9
1715618230212,LISP 5B,A00,507671,Munoz Sanchez; Alicia,9,0,20,11
1715618231242,LISP 5C,A00,507696,Munoz Sanchez; Alicia,9,0,20,11
1715618232270,MAE 197,001,528363,Boechler; Nicholas Sebastia,9998,0,9999,1
1715618233296,MATH 197,001,523477,Kedlaya; Kiran S.,9994,0,9999,5
1715618233296,MATH 197,002,563811,Zhang; Danna,9994,0,9999,5
1715618233296,MATH 197,003,628552,Dumitriu; Ioana,9998,0,9999,1
1715618233296,MATH 197,004,660885,Floyd; Eric,9998,0,9999,1
1715618234324,MCWP 40R,A00,518780,Staff,2,0,20,18
1715618234324,MCWP 40R,B00,518781,Staff,11,0,20,9
1715618234324,MCWP 40R,C00,518783,Staff,5,0,20,15
1715618235353,MCWP 50R,A00,518791,Staff,0,1,20,20
1715618235353,MCWP 50R,B00,518792,Staff,0,2,20,20
1715618235353,MCWP 50R,C00,518793,Staff,0,4,20,20
1715618235353,MCWP 50R,D00,518794,Staff,0,1,20,20
1715618235353,MCWP 50R,E00,518795,Staff,0,2,20,20
1715618235353,MCWP 50R,F00,518796,Staff,0,1,20,20
1715618235353,MCWP 50R,G00,518797,Staff,0,1,20,20
1715618236381,MMW 12R,A01,514034,Herbst; Matthew,0,2,16,16
1715618236381,MMW 12R,A02,514035,Herbst; Matthew,0,0,16,16
1715618237406,MMW 13R,A01,514037,Staff,0,5,16,16
1715618237406,MMW 13R,A02,514039,Staff,0,5,16,16
1715618237406,MMW 13R,A03,628519,Staff,0,4,16,16
1715618239462,SIO 295LS,A00,523233,Staff,10,0,30,20
1715618240486,SIO 295S,A00,523232,Staff,10,0,30,20
1715618241512,SIOC 290S,A01,637330,Merrifield; Mark A,23,0,30,7
1715618242537,SIOC 291S,A01,637333,Gabriel; Corey John,23,0,30,7
1715618243561,SOCI 117,A01,494376,Staff,0,5,5,5
1715618244586,WES 237B,A00,494380,Staff,10,0,20,10
1715618246655,AESE 279B,A00,494370,Wade; Jon P,0,0,33,33
1715618247679,AIP 97,001,660915,Van Den Einde; Yael Dahlia,9998,0,9999,1
1715618248706,AIP 197,001,627712,Vespa; Emanuel Ignacio,9995,0,9999,4
1715618248706,AIP 197,002,650778,Amir; On,9998,0,9999,1
1715618248706,AIP 197,003,650933,Avenancio-Leon; Carlos,9998,0,9999,1
1715618248706,AIP 197,004,658530,Heyman; Gail D.,9998,0,9999,1
1715618248706,AIP 197,005,658631,Neal; Sonya E,9998,0,9999,1
1715618248706,AIP 197,006,658671,Du; Songzi,9998,0,9999,1
1715618249734,ANAR 135S,A00,494369,Braswell; Geoffrey E.,0,0,0,0
1715618250762,BENG 196,001,628496,Engler; Adam J.,9998,0,9999,1
1715618250762,BENG 196,002,660916,Watson; John Thomas,9999,0,9999,0
1715618251789,BISP 197,001,650773,Wilhelm; James E.,9994,0,9999,5
1715618251789,BISP 197,002,658904,Coleman; Aaron B.,9998,0,9999,1
1715618252825,CAT 124RS,A01,519847,Geibel; William,0,0,20,20
1715618253851,CAT 125RS,A01,515971,Geibel; William,0,0,20,20
1715618254876,CLRE 250,A00,511389,Morris; Sheldon,9992,0,9999,7
1715618255901,CLRE 251,A00,507176,Mehta; Ravindra L.,9992,0,9999,7
1715618255901,CLRE 251,B00,511410,Mehta; Ravindra L.,9998,0,9999,1
1715618256928,CLRE 252,A00,507189,Cuomo; Raphael Eduardo,9994,0,9999,5
1715618257957,CLRE 253,A00,507199,Vaida; Florin,9994,0,9999,5
1715618257957,CLRE 253,B00,507202,Vaida; Florin,9999,0,9999,0
1715618258981,CLRE 259,A00,507211,Patel; Hemal,9996,0,9999,3
1715618260007,CLRE 260,A00,507221,Cuomo; Raphael Eduardo,9999,0,9999,0
1715618261033,CLRE 297,001,507242,Cuomo; Raphael Eduardo,9999,0,9999,0
1715618262058,COGS 197,001,638244,Voytek; Bradley Thomas,9997,0,9999,2
1715618263084,CSE 191,A00,516875,Minnes Kemp; Mor Mia,9991,0,9999,8
1715618264109,CSE 197,001,637388,Minnes Kemp; Mor Mia,9992,0,9999,7
1715618265137,CSS 201S,A01,494383,Mignozzetti; Umberto,35,0,35,0
1715618266163,CSS 202S,A01,494387,Mignozzetti; Umberto,35,0,35,0
1715618267192,DSC 197,001,628532,Eldridge; Justin Matthew,9995,0,9999,4
1715618268217,EAP 100,A00,516065,Staff,9799,0,9999,200
1715618269243,ECE 45,A01,507414,Staff,31,0,60,29
1715618271294,ECE 111,A01,507420,Staff,11,0,50,39
1715618272320,ECE 197,001,548057,Sievenpiper; Daniel F.,9991,0,9999,8
1715618273348,EDS 115,A00,507243,Choi; Bailey Miyeon,7,0,28,21
1715618274373,EDS 117,A01,494379,Staff,0,6,34,34
1715618275400,EDS 125,A00,507246,Hopkins; Megan Beth,8,0,30,22
1715618276425,EDS 128A,A01,507264,Fargason; Sharon Gayle,6,0,26,20
1715618277450,EDS 128B,A01,507293,Pappas; Elizabeth,10,0,30,20
1715618278476,EDS 139,A00,507294,Fargason; Sharon Gayle,10,0,30,20
1715618278476,EDS 139,B00,507313,Pappas; Elizabeth,11,0,30,19
1715618279501,EDS 201,A00,507315,Staff,10,0,30,20
1715618280528,EDS 203,A01,507317,Halter; Christopher P.,10,0,30,20
1715618281553,EDS 204R,A01,507319,Halter; Christopher P.,0,3,30,30
1715618281553,EDS 204R,B01,507331,Heinzman; Erica M.,14,0,30,16
1715618282579,EDS 206R,A00,507332,Staff,0,4,30,30
1715618282579,EDS 206R,B00,507343,Staff,15,0,30,15
1715618283608,EDS 250,A00,507344,Hemans; Patricia Ann Benitez,20,0,40,20
1715618284633,EDS 281,A00,507345,Daly; Alan J.,18,0,18,0
1715618285661,EDS 284,A00,507350,Daly; Alan J.,16,0,16,0
1715618286686,EDS 286,A00,507359,Fine; Sarah,18,0,18,0
1715618287710,EDS 289C,A01,507361,Daly; Alan J.,18,0,18,0
1715618288735,EDS 290,A00,507366,Hofstetter; Carolyn,15,0,15,0
1715618289761,LIGM 5A,A00,507421,Fischer-Grunski; Eva K,17,0,20,3
1715618290786,LIGM 5B,A00,507423,Fischer-Grunski; Eva K,19,0,20,1
1715618291814,LIGM 5C,A00,507425,Fischer-Grunski; Eva K,19,0,20,1
1715618292840,LIIT 5AS,A00,507427,Carnelos; Chiara,20,0,20,0
1715618293882,LIIT 5BS,A00,507430,Carnelos; Chiara,20,0,20,0
1715618294909,LIIT 5CS,A00,507432,Carnelos; Chiara,20,0,20,0
1715618295938,LISP 5A,A00,507541,Munoz Sanchez; Alicia,11,0,20,9
1715618296965,LISP 5B,A00,507671,Munoz Sanchez; Alicia,9,0,20,11
1715618297991,LISP 5C,A00,507696,Munoz Sanchez; Alicia,9,0,20,11
1715618299017,MAE 197,001,528363,Boechler; Nicholas Sebastia,9998,0,9999,1
1715618300042,MATH 197,001,523477,Kedlaya; Kiran S.,9994,0,9999,5
1715618300042,MATH 197,002,563811,Zhang; Danna,9994,0,9999,5
1715618300042,MATH 197,003,628552,Dumitriu; Ioana,9998,0,9999,1
1715618300042,MATH 197,004,660885,Floyd; Eric,9998,0,9999,1
1715618301071,MCWP 40R,A00,518780,Staff,2,0,20,18
1715618301071,MCWP 40R,B00,518781,Staff,11,0,20,9
1715618301071,MCWP 40R,C00,518783,Staff,5,0,20,15
1715618302097,MCWP 50R,A00,518791,Staff,0,1,20,20
1715618302097,MCWP 50R,B00,518792,Staff,0,2,20,20
1715618302097,MCWP 50R,C00,518793,Staff,0,4,20,20
1715618302097,MCWP 50R,D00,518794,Staff,0,1,20,20
1715618302097,MCWP 50R,E00,518795,Staff,0,2,20,20
1715618302097,MCWP 50R,F00,518796,Staff,0,1,20,20
1715618302097,MCWP 50R,G00,518797,Staff,0,1,20,20
1715618303122,MMW 12R,A01,514034,Herbst; Matthew,0,2,16,16
1715618303122,MMW 12R,A02,514035,Herbst; Matthew,0,0,16,16
1715618304147,MMW 13R,A01,514037,Staff,0,5,16,16
1715618304147,MMW 13R,A02,514039,Staff,0,5,16,16
1715618304147,MMW 13R,A03,628519,Staff,0,4,16,16
1715618306201,SIO 295LS,A00,523233,Staff,10,0,30,20
1715618307226,SIO 295S,A00,523232,Staff,10,0,30,20
1715618308250,SIOC 290S,A01,637330,Merrifield; Mark A,23,0,30,7
1715618309277,SIOC 291S,A01,637333,Gabriel; Corey John,23,0,30,7
1715618310304,SOCI 117,A01,494376,Staff,0,5,5,5
1715618311330,WES 237B,A00,494380,Staff,10,0,20,10
1715618313407,AESE 279B,A00,494370,Wade; Jon P,0,0,33,33
1715618314430,AIP 97,001,660915,Van Den Einde; Yael Dahlia,9998,0,9999,1
1715618315458,AIP 197,001,627712,Vespa; Emanuel Ignacio,9995,0,9999,4
1715618315458,AIP 197,002,650778,Amir; On,9998,0,9999,1
1715618315458,AIP 197,003,650933,Avenancio-Leon; Carlos,9998,0,9999,1
1715618315458,AIP 197,004,658530,Heyman; Gail D.,9998,0,9999,1
1715618315458,AIP 197,005,658631,Neal; Sonya E,9998,0,9999,1
1715618315458,AIP 197,006,658671,Du; Songzi,9998,0,9999,1
1715618316486,ANAR 135S,A00,494369,Braswell; Geoffrey E.,0,0,0,0
1715618317516,BENG 196,001,628496,Engler; Adam J.,9998,0,9999,1
1715618317516,BENG 196,002,660916,Watson; John Thomas,9999,0,9999,0
1715618318544,BISP 197,001,650773,Wilhelm; James E.,9994,0,9999,5
1715618318544,BISP 197,002,658904,Coleman; Aaron B.,9998,0,9999,1
1715618319575,CAT 124RS,A01,519847,Geibel; William,0,0,20,20
1715618320602,CAT 125RS,A01,515971,Geibel; William,0,0,20,20
1715618321627,CLRE 250,A00,511389,Morris; Sheldon,9992,0,9999,7
1715618322653,CLRE 251,A00,507176,Mehta; Ravindra L.,9992,0,9999,7
1715618322653,CLRE 251,B00,511410,Mehta; Ravindra L.,9998,0,9999,1
1715618323680,CLRE 252,A00,507189,Cuomo; Raphael Eduardo,9994,0,9999,5
1715618324706,CLRE 253,A00,507199,Vaida; Florin,9994,0,9999,5
1715618324706,CLRE 253,B00,507202,Vaida; Florin,9999,0,9999,0
1715618325731,CLRE 259,A00,507211,Patel; Hemal,9996,0,9999,3
1715618326757,CLRE 260,A00,507221,Cuomo; Raphael Eduardo,9999,0,9999,0
1715618327843,CLRE 297,001,507242,Cuomo; Raphael Eduardo,9999,0,9999,0
1715618328871,COGS 197,001,638244,Voytek; Bradley Thomas,9997,0,9999,2
1715618329894,CSE 191,A00,516875,Minnes Kemp; Mor Mia,9991,0,9999,8
1715618330918,CSE 197,001,637388,Minnes Kemp; Mor Mia,9992,0,9999,7
1715618331945,CSS 201S,A01,494383,Mignozzetti; Umberto,35,0,35,0
1715618332971,CSS 202S,A01,494387,Mignozzetti; Umberto,35,0,35,0
1715618333998,DSC 197,001,628532,Eldridge; Justin Matthew,9995,0,9999,4
1715618335024,EAP 100,A00,516065,Staff,9799,0,9999,200
1715618336051,ECE 45,A01,507414,Staff,31,0,60,29
1715618338102,ECE 111,A01,507420,Staff,11,0,50,39
1715618339128,ECE 197,001,548057,Sievenpiper; Daniel F.,9991,0,9999,8
1715618340157,EDS 115,A00,507243,Choi; Bailey Miyeon,7,0,28,21
1715618341184,EDS 117,A01,494379,Staff,0,6,34,34
1715618342215,EDS 125,A00,507246,Hopkins; Megan Beth,8,0,30,22
1715618343245,EDS 128A,A01,507264,Fargason; Sharon Gayle,6,0,26,20
1715618344273,EDS 128B,A01,507293,Pappas; Elizabeth,10,0,30,20
1715618345301,EDS 139,A00,507294,Fargason; Sharon Gayle,10,0,30,20
1715618345301,EDS 139,B00,507313,Pappas; Elizabeth,11,0,30,19
1715618346326,EDS 201,A00,507315,Staff,10,0,30,20
1715618347357,EDS 203,A01,507317,Halter; Christopher P.,10,0,30,20
1715618348385,EDS 204R,A01,507319,Halter; Christopher P.,0,3,30,30
1715618348385,EDS 204R,B01,507331,Heinzman; Erica M.,14,0,30,16
1715618349414,EDS 206R,A00,507332,Staff,0,4,30,30
1715618349414,EDS 206R,B00,507343,Staff,15,0,30,15
1715618350442,EDS 250,A00,507344,Hemans; Patricia Ann Benitez,20,0,40,20
1715618351467,EDS 281,A00,507345,Daly; Alan J.,18,0,18,0
1715618352496,EDS 284,A00,507350,Daly; Alan J.,16,0,16,0
1715618353522,EDS 286,A00,507359,Fine; Sarah,18,0,18,0
1715618354550,EDS 289C,A01,507361,Daly; Alan J.,18,0,18,0
1715618355574,EDS 290,A00,507366,Hofstetter; Carolyn,15,0,15,0
1715618356600,LIGM 5A,A00,507421,Fischer-Grunski; Eva K,17,0,20,3
1715618357625,LIGM 5B,A00,507423,Fischer-Grunski; Eva K,19,0,20,1
1715618358653,LIGM 5C,A00,507425,Fischer-Grunski; Eva K,19,0,20,1
1715618359684,LIIT 5AS,A00,507427,Carnelos; Chiara,20,0,20,0
1715618360712,LIIT 5BS,A00,507430,Carnelos; Chiara,20,0,20,0
1715618361740,LIIT 5CS,A00,507432,Carnelos; Chiara,20,0,20,0
1715618362766,LISP 5A,A00,507541,Munoz Sanchez; Alicia,11,0,20,9
1715618363797,LISP 5B,A00,507671,Munoz Sanchez; Alicia,9,0,20,11
1715618364822,LISP 5C,A00,507696,Munoz Sanchez; Alicia,9,0,20,11
1715618365850,MAE 197,001,528363,Boechler; Nicholas Sebastia,9998,0,9999,1
1715618366876,MATH 197,001,523477,Kedlaya; Kiran S.,9994,0,9999,5
1715618366876,MATH 197,002,563811,Zhang; Danna,9994,0,9999,5
1715618366876,MATH 197,003,628552,Dumitriu; Ioana,9998,0,9999,1
1715618366876,MATH 197,004,660885,Floyd; Eric,9998,0,9999,1
1715618367902,MCWP 40R,A00,518780,Staff,2,0,20,18
1715618367902,MCWP 40R,B00,518781,Staff,11,0,20,9
1715618367902,MCWP 40R,C00,518783,Staff,5,0,20,15
1715618368927,MCWP 50R,A00,518791,Staff,0,1,20,20
1715618368927,MCWP 50R,B00,518792,Staff,0,2,20,20
1715618368927,MCWP 50R,C00,518793,Staff,0,4,20,20
1715618368927,MCWP 50R,D00,518794,Staff,0,1,20,20
1715618368927,MCWP 50R,E00,518795,Staff,0,2,20,20
1715618368927,MCWP 50R,F00,518796,Staff,0,1,20,20
1715618368927,MCWP 50R,G00,518797,Staff,0,1,20,20
1715618369952,MMW 12R,A01,514034,Herbst; Matthew,0,2,16,16
1715618369952,MMW 12R,A02,514035,Herbst; Matthew,0,0,16,16
1715618370981,MMW 13R,A01,514037,Staff,0,5,16,16
1715618370981,MMW 13R,A02,514039,Staff,0,5,16,16
1715618370981,MMW 13R,A03,628519,Staff,0,4,16,16
1715618373033,SIO 295LS,A00,523233,Staff,10,0,30,20
1715618374058,SIO 295S,A00,523232,Staff,10,0,30,20
1715618375084,SIOC 290S,A01,637330,Merrifield; Mark A,23,0,30,7
1715618376111,SIOC 291S,A01,637333,Gabriel; Corey John,23,0,30,7
1715618377138,SOCI 117,A01,494376,Staff,0,5,5,5
1715618378163,WES 237B,A00,494380,Staff,10,0,20,10
1715618380234,AESE 279B,A00,494370,Wade; Jon P,0,0,33,33
1715618381259,AIP 97,001,660915,Van Den Einde; Yael Dahlia,9998,0,9999,1
1715618382287,AIP 197,001,627712,Vespa; Emanuel Ignacio,9995,0,9999,4
1715618382287,AIP 197,002,650778,Amir; On,9998,0,9999,1
1715618382287,AIP 197,003,650933,Avenancio-Leon; Carlos,9998,0,9999,1
1715618382287,AIP 197,004,658530,Heyman; Gail D.,9998,0,9999,1
1715618382287,AIP 197,005,658631,Neal; Sonya E,9998,0,9999,1
1715618382287,AIP 197,006,658671,Du; Songzi,9998,0,9999,1
1715618383315,ANAR 135S,A00,494369,Braswell; Geoffrey E.,0,0,0,0
1715618384341,BENG 196,001,628496,Engler; Adam J.,9998,0,9999,1
1715618384341,BENG 196,002,660916,Watson; John Thomas,9999,0,9999,0
1715618385366,BISP 197,001,650773,Wilhelm; James E.,9994,0,9999,5
1715618385366,BISP 197,002,658904,Coleman; Aaron B.,9998,0,9999,1
1715618386391,CAT 124RS,A01,519847,Geibel; William,0,0,20,20
1715618387417,CAT 125RS,A01,515971,Geibel; William,0,0,20,20
1715618388442,CLRE 250,A00,511389,Morris; Sheldon,9992,0,9999,7
1715618389472,CLRE 251,A00,507176,Mehta; Ravindra L.,9992,0,9999,7
1715618389472,CLRE 251,B00,511410,Mehta; Ravindra L.,9998,0,9999,1
1715618390499,CLRE 252,A00,507189,Cuomo; Raphael Eduardo,9994,0,9999,5
1715618391524,CLRE 253,A00,507199,Vaida; Florin,9994,0,9999,5
1715618391524,CLRE 253,B00,507202,Vaida; Florin,9999,0,9999,0
1715618392548,CLRE 259,A00,507211,Patel; Hemal,9996,0,9999,3
1715618393577,CLRE 260,A00,507221,Cuomo; Raphael Eduardo,9999,0,9999,0
1715618394603,CLRE 297,001,507242,Cuomo; Raphael Eduardo,9999,0,9999,0
1715618395630,COGS 197,001,638244,Voytek; Bradley Thomas,9997,0,9999,2
1715618396656,CSE 191,A00,516875,Minnes Kemp; Mor Mia,9991,0,9999,8
1715618397682,CSE 197,001,637388,Minnes Kemp; Mor Mia,9992,0,9999,7
1715618398712,CSS 201S,A01,494383,Mignozzetti; Umberto,35,0,35,0
1715618399738,CSS 202S,A01,494387,Mignozzetti; Umberto,35,0,35,0
1715618400763,DSC 197,001,628532,Eldridge; Justin Matthew,9995,0,9999,4
1715618401789,EAP 100,A00,516065,Staff,9799,0,9999,200
1715618402819,ECE 45,A01,507414,Staff,31,0,60,29
1715618404873,ECE 111,A01,507420,Staff,11,0,50,39
1715618405900,ECE 197,001,548057,Sievenpiper; Daniel F.,9991,0,9999,8
1715618406926,EDS 115,A00,507243,Choi; Bailey Miyeon,7,0,28,21
1715618407951,EDS 117,A01,494379,Staff,0,6,34,34
1715618408977,EDS 125,A00,507246,Hopkins; Megan Beth,8,0,30,22
1715618410003,EDS 128A,A01,507264,Fargason; Sharon Gayle,6,0,26,20
1715618411027,EDS 128B,A01,507293,Pappas; Elizabeth,10,0,30,20
1715618412055,EDS 139,A00,507294,Fargason; Sharon Gayle,10,0,30,20
1715618412055,EDS 139,B00,507313,Pappas; Elizabeth,11,0,30,19
1715618413080,EDS 201,A00,507315,Staff,10,0,30,20
1715618414105,EDS 203,A01,507317,Halter; Christopher P.,10,0,30,20
1715618415131,EDS 204R,A01,507319,Halter; Christopher P.,0,3,30,30
1715618415131,EDS 204R,B01,507331,Heinzman; Erica M.,14,0,30,16
1715618416156,EDS 206R,A00,507332,Staff,0,4,30,30
1715618416156,EDS 206R,B00,507343,Staff,15,0,30,15
1715618417185,EDS 250,A00,507344,Hemans; Patricia Ann Benitez,20,0,40,20
1715618418212,EDS 281,A00,507345,Daly; Alan J.,18,0,18,0
1715618419235,EDS 284,A00,507350,Daly; Alan J.,16,0,16,0
1715618420261,EDS 286,A00,507359,Fine; Sarah,18,0,18,0
1715618421286,EDS 289C,A01,507361,Daly; Alan J.,18,0,18,0
1715618422310,EDS 290,A00,507366,Hofstetter; Carolyn,15,0,15,0
1715618423336,LIGM 5A,A00,507421,Fischer-Grunski; Eva K,17,0,20,3
1715618424362,LIGM 5B,A00,507423,Fischer-Grunski; Eva K,19,0,20,1
1715618425387,LIGM 5C,A00,507425,Fischer-Grunski; Eva K,19,0,20,1
1715618426412,LIIT 5AS,A00,507427,Carnelos; Chiara,20,0,20,0
1715618427437,LIIT 5BS,A00,507430,Carnelos; Chiara,20,0,20,0
1715618428466,LIIT 5CS,A00,507432,Carnelos; Chiara,20,0,20,0
1715618429495,LISP 5A,A00,507541,Munoz Sanchez; Alicia,11,0,20,9
1715618430519,LISP 5B,A00,507671,Munoz Sanchez; Alicia,9,0,20,11
1715618431603,LISP 5C,A00,507696,Munoz Sanchez; Alicia,9,0,20,11
1715618432634,MAE 197,001,528363,Boechler; Nicholas Sebastia,9998,0,9999,1
1715618433664,MATH 197,001,523477,Kedlaya; Kiran S.,9994,0,9999,5
1715618433664,MATH 197,002,563811,Zhang; Danna,9994,0,9999,5
1715618433664,MATH 197,003,628552,Dumitriu; Ioana,9998,0,9999,1
1715618433664,MATH 197,004,660885,Floyd; Eric,9998,0,9999,1
1715618434690,MCWP 40R,A00,518780,Staff,2,0,20,18
1715618434690,MCWP 40R,B00,518781,Staff,11,0,20,9
1715618434690,MCWP 40R,C00,518783,Staff,5,0,20,15
1715618435719,MCWP 50R,A00,518791,Staff,0,1,20,20
1715618435719,MCWP 50R,B00,518792,Staff,0,2,20,20
1715618435719,MCWP 50R,C00,518793,Staff,0,4,20,20
1715618435719,MCWP 50R,D00,518794,Staff,0,1,20,20
1715618435719,MCWP 50R,E00,518795,Staff,0,2,20,20
1715618435719,MCWP 50R,F00,518796,Staff,0,1,20,20
1715618435719,MCWP 50R,G00,518797,Staff,0,1,20,20
1715618436744,MMW 12R,A01,514034,Herbst; Matthew,0,2,16,16
1715618436744,MMW 12R,A02,514035,Herbst; Matthew,0,0,16,16
1715618437772,MMW 13R,A01,514037,Staff,0,5,16,16
1715618437772,MMW 13R,A02,514039,Staff,0,5,16,16
1715618437772,MMW 13R,A03,628519,Staff,0,4,16,16
1715618439823,SIO 295LS,A00,523233,Staff,10,0,30,20
1715618440849,SIO 295S,A00,523232,Staff,10,0,30,20
1715618441878,SIOC 290S,A01,637330,Merrifield; Mark A,23,0,30,7
1715618442903,SIOC 291S,A01,637333,Gabriel; Corey John,23,0,30,7
1715618443927,SOCI 117,A01,494376,Staff,0,5,5,5
1715618444951,WES 237B,A00,494380,Staff,10,0,20,10
1715618447033,AESE 279B,A00,494370,Wade; Jon P,0,0,33,33
1715618448060,AIP 97,001,660915,Van Den Einde; Yael Dahlia,9998,0,9999,1
1715618449089,AIP 197,001,627712,Vespa; Emanuel Ignacio,9995,0,9999,4
1715618449089,AIP 197,002,650778,Amir; On,9998,0,9999,1
1715618449089,AIP 197,003,650933,Avenancio-Leon; Carlos,9998,0,9999,1
1715618449089,AIP 197,004,658530,Heyman; Gail D.,9998,0,9999,1
1715618449089,AIP 197,005,658631,Neal; Sonya E,9998,0,9999,1
1715618449089,AIP 197,006,658671,Du; Songzi,9998,0,9999,1
1715618450115,ANAR 135S,A00,494369,Braswell; Geoffrey E.,0,0,0,0
1715618451144,BENG 196,001,628496,Engler; Adam J.,9998,0,9999,1
1715618451144,BENG 196,002,660916,Watson; John Thomas,9999,0,9999,0
1715618452172,BISP 197,001,650773,Wilhelm; James E.,9994,0,9999,5
1715618452172,BISP 197,002,658904,Coleman; Aaron B.,9998,0,9999,1
1715618453198,CAT 124RS,A01,519847,Geibel; William,0,0,20,20
1715618454225,CAT 125RS,A01,515971,Geibel; William,0,0,20,20
1715618455250,CLRE 250,A00,511389,Morris; Sheldon,9992,0,9999,7
1715618456276,CLRE 251,A00,507176,Mehta; Ravindra L.,9992,0,9999,7
1715618456276,CLRE 251,B00,511410,Mehta; Ravindra L.,9998,0,9999,1
1715618457302,CLRE 252,A00,507189,Cuomo; Raphael Eduardo,9994,0,9999,5
1715618458326,CLRE 253,A00,507199,Vaida; Florin,9994,0,9999,5
1715618458326,CLRE 253,B00,507202,Vaida; Florin,9999,0,9999,0
1715618459353,CLRE 259,A00,507211,Patel; Hemal,9996,0,9999,3
1715618460379,CLRE 260,A00,507221,Cuomo; Raphael Eduardo,9999,0,9999,0
1715618461407,CLRE 297,001,507242,Cuomo; Raphael Eduardo,9999,0,9999,0
1715618462435,COGS 197,001,638244,Voytek; Bradley Thomas,9997,0,9999,2
1715618463463,CSE 191,A00,516875,Minnes Kemp; Mor Mia,9991,0,9999,8
1715618464486,CSE 197,001,637388,Minnes Kemp; Mor Mia,9992,0,9999,7
1715618465513,CSS 201S,A01,494383,Mignozzetti; Umberto,35,0,35,0
1715618466542,CSS 202S,A01,494387,Mignozzetti; Umberto,35,0,35,0
1715618467567,DSC 197,001,628532,Eldridge; Justin Matthew,9995,0,9999,4
1715618468592,EAP 100,A00,516065,Staff,9799,0,9999,200
1715618469620,ECE 45,A01,507414,Staff,31,0,60,29
1715618471671,ECE 111,A01,507420,Staff,11,0,50,39
1715618472696,ECE 197,001,548057,Sievenpiper; Daniel F.,9991,0,9999,8
1715618473723,EDS 115,A00,507243,Choi; Bailey Miyeon,7,0,28,21
1715618474748,EDS 117,A01,494379,Staff,0,6,34,34
1715618475773,EDS 125,A00,507246,Hopkins; Megan Beth,8,0,30,22
1715618476797,EDS 128A,A01,507264,Fargason; Sharon Gayle,6,0,26,20
1715618477823,EDS 128B,A01,507293,Pappas; Elizabeth,10,0,30,20
1715618478849,EDS 139,A00,507294,Fargason; Sharon Gayle,10,0,30,20
1715618478849,EDS 139,B00,507313,Pappas; Elizabeth,11,0,30,19
1715618479875,EDS 201,A00,507315,Staff,10,0,30,20
1715618480901,EDS 203,A01,507317,Halter; Christopher P.,10,0,30,20
1715618481927,EDS 204R,A01,507319,Halter; Christopher P.,0,3,30,30
1715618481927,EDS 204R,B01,507331,Heinzman; Erica M.,14,0,30,16
1715618482952,EDS 206R,A00,507332,Staff,0,4,30,30
1715618482952,EDS 206R,B00,507343,Staff,15,0,30,15
1715618483978,EDS 250,A00,507344,Hemans; Patricia Ann Benitez,20,0,40,20
1715618485003,EDS 281,A00,507345,Daly; Alan J.,18,0,18,0
1715618486026,EDS 284,A00,507350,Daly; Alan J.,16,0,16,0
1715618487054,EDS 286,A00,507359,Fine; Sarah,18,0,18,0
1715618488080,EDS 289C,A01,507361,Daly; Alan J.,18,0,18,0
1715618489107,EDS 290,A00,507366,Hofstetter; Carolyn,15,0,15,0
1715618490133,LIGM 5A,A00,507421,Fischer-Grunski; Eva K,17,0,20,3
1715618491157,LIGM 5B,A00,507423,Fischer-Grunski; Eva K,19,0,20,1
1715618492183,LIGM 5C,A00,507425,Fischer-Grunski; Eva K,19,0,20,1
1715618493209,LIIT 5AS,A00,507427,Carnelos; Chiara,20,0,20,0
1715618494234,LIIT 5BS,A00,507430,Carnelos; Chiara,20,0,20,0
1715618495260,LIIT 5CS,A00,507432,Carnelos; Chiara,20,0,20,0
1715618496285,LISP 5A,A00,507541,Munoz Sanchez; Alicia,11,0,20,9
1715618497309,LISP 5B,A00,507671,Munoz Sanchez; Alicia,9,0,20,11
1715618498335,LISP 5C,A00,507696,Munoz Sanchez; Alicia,9,0,20,11
1715618499361,MAE 197,001,528363,Boechler; Nicholas Sebastia,9998,0,9999,1
1715618500387,MATH 197,001,523477,Kedlaya; Kiran S.,9994,0,9999,5
1715618500387,MATH 197,002,563811,Zhang; Danna,9994,0,9999,5
1715618500387,MATH 197,003,628552,Dumitriu; Ioana,9998,0,9999,1
1715618500387,MATH 197,004,660885,Floyd; Eric,9998,0,9999,1
1715618501412,MCWP 40R,A00,518780,Staff,2,0,20,18
1715618501412,MCWP 40R,B00,518781,Staff,11,0,20,9
1715618501412,MCWP 40R,C00,518783,Staff,5,0,20,15
1715618502442,MCWP 50R,A00,518791,Staff,0,1,20,20
1715618502442,MCWP 50R,B00,518792,Staff,0,2,20,20
1715618502442,MCWP 50R,C00,518793,Staff,0,4,20,20
1715618502442,MCWP 50R,D00,518794,Staff,0,1,20,20
1715618502442,MCWP 50R,E00,518795,Staff,0,2,20,20
1715618502442,MCWP 50R,F00,518796,Staff,0,1,20,20
1715618502442,MCWP 50R,G00,518797,Staff,0,1,20,20
1715618503467,MMW 12R,A01,514034,Herbst; Matthew,0,2,16,16
1715618503467,MMW 12R,A02,514035,Herbst; Matthew,0,0,16,16
1715618504492,MMW 13R,A01,514037,Staff,0,5,16,16
1715618504492,MMW 13R,A02,514039,Staff,0,5,16,16
1715618504492,MMW 13R,A03,628519,Staff,0,4,16,16
1715618506544,SIO 295LS,A00,523233,Staff,10,0,30,20
1715618507571,SIO 295S,A00,523232,Staff,10,0,30,20
1715618508597,SIOC 290S,A01,637330,Merrifield; Mark A,23,0,30,7
1715618509623,SIOC 291S,A01,637333,Gabriel; Corey John,23,0,30,7
1715618510648,SOCI 117,A01,494376,Staff,0,5,5,5
1715618511674,WES 237B,A00,494380,Staff,10,0,20,10
1715618513749,AESE 279B,A00,494370,Wade; Jon P,0,0,33,33
1715618514775,AIP 97,001,660915,Van Den Einde; Yael Dahlia,9998,0,9999,1
1715618515805,AIP 197,001,627712,Vespa; Emanuel Ignacio,9995,0,9999,4
1715618515805,AIP 197,002,650778,Amir; On,9998,0,9999,1
1715618515805,AIP 197,003,650933,Avenancio-Leon; Carlos,9998,0,9999,1
1715618515805,AIP 197,004,658530,Heyman; Gail D.,9998,0,9999,1
1715618515805,AIP 197,005,658631,Neal; Sonya E,9998,0,9999,1
1715618515805,AIP 197,006,658671,Du; Songzi,9998,0,9999,1
1715618516830,ANAR 135S,A00,494369,Braswell; Geoffrey E.,0,0,0,0
1715618517858,BENG 196,001,628496,Engler; Adam J.,9998,0,9999,1
1715618517858,BENG 196,002,660916,Watson; John Thomas,9999,0,9999,0
1715618518883,BISP 197,001,650773,Wilhelm; James E.,9994,0,9999,5
1715618518883,BISP 197,002,658904,Coleman; Aaron B.,9998,0,9999,1
1715618519910,CAT 124RS,A01,519847,Geibel; William,0,0,20,20
1715618520936,CAT 125RS,A01,515971,Geibel; William,0,0,20,20
1715618521961,CLRE 250,A00,511389,Morris; Sheldon,9992,0,9999,7
1715618522988,CLRE 251,A00,507176,Mehta; Ravindra L.,9992,0,9999,7
1715618522988,CLRE 251,B00,511410,Mehta; Ravindra L.,9998,0,9999,1
1715618524015,CLRE 252,A00,507189,Cuomo; Raphael Eduardo,9994,0,9999,5
1715618525042,CLRE 253,A00,507199,Vaida; Florin,9994,0,9999,5
1715618525042,CLRE 253,B00,507202,Vaida; Florin,9999,0,9999,0
1715618526065,CLRE 259,A00,507211,Patel; Hemal,9996,0,9999,3
1715618527092,CLRE 260,A00,507221,Cuomo; Raphael Eduardo,9999,0,9999,0
1715618528118,CLRE 297,001,507242,Cuomo; Raphael Eduardo,9999,0,9999,0
1715618529142,COGS 197,001,638244,Voytek; Bradley Thomas,9997,0,9999,2
1715618530167,CSE 191,A00,516875,Minnes Kemp; Mor Mia,9991,0,9999,8
1715618531194,CSE 197,001,637388,Minnes Kemp; Mor Mia,9992,0,9999,7
1715618532219,CSS 201S,A01,494383,Mignozzetti; Umberto,35,0,35,0
1715618533245,CSS 202S,A01,494387,Mignozzetti; Umberto,35,0,35,0
1715618534274,DSC 197,001,628532,Eldridge; Justin Matthew,9995,0,9999,4
1715618535297,EAP 100,A00,516065,Staff,9799,0,9999,200
1715618536328,ECE 45,A01,507414,Staff,31,0,60,29
1715618538380,ECE 111,A01,507420,Staff,11,0,50,39
1715618539404,ECE 197,001,548057,Sievenpiper; Daniel F.,9991,0,9999,8
1715618540431,EDS 115,A00,507243,Choi; Bailey Miyeon,7,0,28,21
1715618541456,EDS 117,A01,494379,Staff,0,6,34,34
1715618542486,EDS 125,A00,507246,Hopkins; Megan Beth,8,0,30,22
1715618543516,EDS 128A,A01,507264,Fargason; Sharon Gayle,6,0,26,20
1715618544541,EDS 128B,A01,507293,Pappas; Elizabeth,10,0,30,20
1715618545566,EDS 139,A00,507294,Fargason; Sharon Gayle,10,0,30,20
1715618545566,EDS 139,B00,507313,Pappas; Elizabeth,11,0,30,19
1715618546591,EDS 201,A00,507315,Staff,10,0,30,20
1715618547619,EDS 203,A01,507317,Halter; Christopher P.,10,0,30,20
1715618548650,EDS 204R,A01,507319,Halter; Christopher P.,0,3,30,30
1715618548650,EDS 204R,B01,507331,Heinzman; Erica M.,14,0,30,16
1715618549675,EDS 206R,A00,507332,Staff,0,4,30,30
1715618549675,EDS 206R,B00,507343,Staff,15,0,30,15
1715618550700,EDS 250,A00,507344,Hemans; Patricia Ann Benitez,20,0,40,20
1715618551726,EDS 281,A00,507345,Daly; Alan J.,18,0,18,0
1715618552755,EDS 284,A00,507350,Daly; Alan J.,16,0,16,0
1715618553784,EDS 286,A00,507359,Fine; Sarah,18,0,18,0
1715618554811,EDS 289C,A01,507361,Daly; Alan J.,18,0,18,0
1715618555836,EDS 290,A00,507366,Hofstetter; Carolyn,15,0,15,0
1715618556863,LIGM 5A,A00,507421,Fischer-Grunski; Eva K,17,0,20,3
1715618557892,LIGM 5B,A00,507423,Fischer-Grunski; Eva K,19,0,20,1
1715618558921,LIGM 5C,A00,507425,Fischer-Grunski; Eva K,19,0,20,1
1715618559951,LIIT 5AS,A00,507427,Carnelos; Chiara,20,0,20,0
1715618560978,LIIT 5BS,A00,507430,Carnelos; Chiara,20,0,20,0
1715618562004,LIIT 5CS,A00,507432,Carnelos; Chiara,20,0,20,0
1715618563031,LISP 5A,A00,507541,Munoz Sanchez; Alicia,11,0,20,9
1715618564060,LISP 5B,A00,507671,Munoz Sanchez; Alicia,9,0,20,11
1715618565089,LISP 5C,A00,507696,Munoz Sanchez; Alicia,9,0,20,11
1715618566114,MAE 197,001,528363,Boechler; Nicholas Sebastia,9998,0,9999,1
1715618567140,MATH 197,001,523477,Kedlaya; Kiran S.,9994,0,9999,5
1715618567140,MATH 197,002,563811,Zhang; Danna,9994,0,9999,5
1715618567140,MATH 197,003,628552,Dumitriu; Ioana,9998,0,9999,1
1715618567140,MATH 197,004,660885,Floyd; Eric,9998,0,9999,1
1715618568165,MCWP 40R,A00,518780,Staff,2,0,20,18
1715618568165,MCWP 40R,B00,518781,Staff,11,0,20,9
1715618568165,MCWP 40R,C00,518783,Staff,5,0,20,15
1715618569192,MCWP 50R,A00,518791,Staff,0,1,20,20
1715618569192,MCWP 50R,B00,518792,Staff,0,2,20,20
1715618569192,MCWP 50R,C00,518793,Staff,0,4,20,20
1715618569192,MCWP 50R,D00,518794,Staff,0,1,20,20
1715618569192,MCWP 50R,E00,518795,Staff,0,2,20,20
1715618569192,MCWP 50R,F00,518796,Staff,0,1,20,20
1715618569192,MCWP 50R,G00,518797,Staff,0,1,20,20
1715618570273,MMW 12R,A01,514034,Herbst; Matthew,0,2,16,16
1715618570273,MMW 12R,A02,514035,Herbst; Matthew,0,0,16,16
1715618571297,MMW 13R,A01,514037,Staff,0,5,16,16
1715618571297,MMW 13R,A02,514039,Staff,0,5,16,16
1715618571297,MMW 13R,A03,628519,Staff,0,4,16,16
1715618573347,SIO 295LS,A00,523233,Staff,10,0,30,20
1715618574372,SIO 295S,A00,523232,Staff,10,0,30,20
1715618575397,SIOC 290S,A01,637330,Merrifield; Mark A,23,0,30,7
1715618576428,SIOC 291S,A01,637333,Gabriel; Corey John,23,0,30,7
1715618577458,SOCI 117,A01,494376,Staff,0,5,5,5
1715618578483,WES 237B,A00,494380,Staff,10,0,20,10
1715618580553,AESE 279B,A00,494370,Wade; Jon P,0,0,33,33
1715618581579,AIP 97,001,660915,Van Den Einde; Yael Dahlia,9998,0,9999,1
1715618582613,AIP 197,001,627712,Vespa; Emanuel Ignacio,9995,0,9999,4
1715618582613,AIP 197,002,650778,Amir; On,9998,0,9999,1
1715618582613,AIP 197,003,650933,Avenancio-Leon; Carlos,9998,0,9999,1
1715618582613,AIP 197,004,658530,Heyman; Gail D.,9998,0,9999,1
1715618582613,AIP 197,005,658631,Neal; Sonya E,9998,0,9999,1
1715618582613,AIP 197,006,658671,Du; Songzi,9998,0,9999,1
1715618583637,ANAR 135S,A00,494369,Braswell; Geoffrey E.,0,0,0,0
1715618584663,BENG 196,001,628496,Engler; Adam J.,9998,0,9999,1
1715618584663,BENG 196,002,660916,Watson; John Thomas,9999,0,9999,0
1715618585688,BISP 197,001,650773,Wilhelm; James E.,9994,0,9999,5
1715618585688,BISP 197,002,658904,Coleman; Aaron B.,9998,0,9999,1
1715618586718,CAT 124RS,A01,519847,Geibel; William,0,0,20,20
1715618587747,CAT 125RS,A01,515971,Geibel; William,0,0,20,20
1715618588776,CLRE 250,A00,511389,Morris; Sheldon,9992,0,9999,7
1715618589802,CLRE 251,A00,507176,Mehta; Ravindra L.,9992,0,9999,7
1715618589802,CLRE 251,B00,511410,Mehta; Ravindra L.,9998,0,9999,1
1715618590827,CLRE 252,A00,507189,Cuomo; Raphael Eduardo,9994,0,9999,5
1715618591857,CLRE 253,A00,507199,Vaida; Florin,9994,0,9999,5
1715618591857,CLRE 253,B00,507202,Vaida; Florin,9999,0,9999,0
1715618592884,CLRE 259,A00,507211,Patel; Hemal,9996,0,9999,3
1715618593911,CLRE 260,A00,507221,Cuomo; Raphael Eduardo,9999,0,9999,0
1715618594937,CLRE 297,001,507242,Cuomo; Raphael Eduardo,9999,0,9999,0
1715618595962,COGS 197,001,638244,Voytek; Bradley Thomas,9997,0,9999,2
1715618596987,CSE 191,A00,516875,Minnes Kemp; Mor Mia,9991,0,9999,8
1715618598013,CSE 197,001,637388,Minnes Kemp; Mor Mia,9992,0,9999,7
1715618599039,CSS 201S,A01,494383,Mignozzetti; Umberto,35,0,35,0
1715618600064,CSS 202S,A01,494387,Mignozzetti; Umberto,35,0,35,0
1715618601092,DSC 197,001,628532,Eldridge; Justin Matthew,9995,0,9999,4
1715618602117,EAP 100,A00,516065,Staff,9799,0,9999,200
1715618603146,ECE 45,A01,507414,Staff,31,0,60,29
1715618605201,ECE 111,A01,507420,Staff,11,0,50,39
1715618606229,ECE 197,001,548057,Sievenpiper; Daniel F.,9991,0,9999,8
1715618607255,EDS 115,A00,507243,Choi; Bailey Miyeon,7,0,28,21
1715618608283,EDS 117,A01,494379,Staff,0,6,34,34
1715618609310,EDS 125,A00,507246,Hopkins; Megan Beth,8,0,30,22
1715618610334,EDS 128A,A01,507264,Fargason; Sharon Gayle,6,0,26,20
1715618611358,EDS 128B,A01,507293,Pappas; Elizabeth,10,0,30,20
1715618612386,EDS 139,A00,507294,Fargason; Sharon Gayle,10,0,30,20
1715618612386,EDS 139,B00,507313,Pappas; Elizabeth,11,0,30,19
1715618613412,EDS 201,A00,507315,Staff,10,0,30,20
1715618614439,EDS 203,A01,507317,Halter; Christopher P.,10,0,30,20
1715618615468,EDS 204R,A01,507319,Halter; Christopher P.,0,3,30,30
1715618615468,EDS 204R,B01,507331,Heinzman; Erica M.,14,0,30,16
1715618616497,EDS 206R,A00,507332,Staff,0,4,30,30
1715618616497,EDS 206R,B00,507343,Staff,15,0,30,15
1715618617525,EDS 250,A00,507344,Hemans; Patricia Ann Benitez,20,0,40,20
1715618618549,EDS 281,A00,507345,Daly; Alan J.,18,0,18,0
1715618619578,EDS 284,A00,507350,Daly; Alan J.,16,0,16,0
1715618620608,EDS 286,A00,507359,Fine; Sarah,18,0,18,0
1715618621635,EDS 289C,A01,507361,Daly; Alan J.,18,0,18,0
1715618622659,EDS 290,A00,507366,Hofstetter; Carolyn,15,0,15,0
1715618623690,LIGM 5A,A00,507421,Fischer-Grunski; Eva K,17,0,20,3
1715618624716,LIGM 5B,A00,507423,Fischer-Grunski; Eva K,19,0,20,1
1715618625745,LIGM 5C,A00,507425,Fischer-Grunski; Eva K,19,0,20,1
1715618626774,LIIT 5AS,A00,507427,Carnelos; Chiara,20,0,20,0
1715618627799,LIIT 5BS,A00,507430,Carnelos; Chiara,20,0,20,0
1715618628828,LIIT 5CS,A00,507432,Carnelos; Chiara,20,0,20,0
1715618629852,LISP 5A,A00,507541,Munoz Sanchez; Alicia,11,0,20,9
1715618630879,LISP 5B,A00,507671,Munoz Sanchez; Alicia,9,0,20,11
1715618631907,LISP 5C,A00,507696,Munoz Sanchez; Alicia,9,0,20,11
1715618632933,MAE 197,001,528363,Boechler; Nicholas Sebastia,9998,0,9999,1
1715618633961,MATH 197,001,523477,Kedlaya; Kiran S.,9994,0,9999,5
1715618633961,MATH 197,002,563811,Zhang; Danna,9994,0,9999,5
1715618633961,MATH 197,003,628552,Dumitriu; Ioana,9998,0,9999,1
1715618633961,MATH 197,004,660885,Floyd; Eric,9998,0,9999,1
1715618634990,MCWP 40R,A00,518780,Staff,2,0,20,18
1715618634990,MCWP 40R,B00,518781,Staff,11,0,20,9
1715618634990,MCWP 40R,C00,518783,Staff,5,0,20,15
1715618636020,MCWP 50R,A00,518791,Staff,0,1,20,20
1715618636020,MCWP 50R,B00,518792,Staff,0,2,20,20
1715618636020,MCWP 50R,C00,518793,Staff,0,4,20,20
1715618636020,MCWP 50R,D00,518794,Staff,0,1,20,20
1715618636020,MCWP 50R,E00,518795,Staff,0,2,20,20
1715618636020,MCWP 50R,F00,518796,Staff,0,1,20,20
1715618636020,MCWP 50R,G00,518797,Staff,0,1,20,20
1715618637049,MMW 12R,A01,514034,Herbst; Matthew,0,2,16,16
1715618637049,MMW 12R,A02,514035,Herbst; Matthew,0,0,16,16
1715618638075,MMW 13R,A01,514037,Staff,0,5,16,16
1715618638075,MMW 13R,A02,514039,Staff,0,5,16,16
1715618638075,MMW 13R,A03,628519,Staff,0,4,16,16
1715618640130,SIO 295LS,A00,523233,Staff,10,0,30,20
1715618641156,SIO 295S,A00,523232,Staff,10,0,30,20
1715618642184,SIOC 290S,A01,637330,Merrifield; Mark A,23,0,30,7
1715618643211,SIOC 291S,A01,637333,Gabriel; Corey John,23,0,30,7
1715618644236,SOCI 117,A01,494376,Staff,0,5,5,5
1715618645264,WES 237B,A00,494380,Staff,10,0,20,10
1715618647335,AESE 279B,A00,494370,Wade; Jon P,0,0,33,33
1715618648359,AIP 97,001,660915,Van Den Einde; Yael Dahlia,9998,0,9999,1
1715618649406,AIP 197,001,627712,Vespa; Emanuel Ignacio,9995,0,9999,4
1715618649406,AIP 197,002,650778,Amir; On,9998,0,9999,1
1715618649406,AIP 197,003,650933,Avenancio-Leon; Carlos,9998,0,9999,1
1715618649406,AIP 197,004,658530,Heyman; Gail D.,9998,0,9999,1
1715618649406,AIP 197,005,658631,Neal; Sonya E,9998,0,9999,1
1715618649406,AIP 197,006,658671,Du; Songzi,9998,0,9999,1
1715618650431,ANAR 135S,A00,494369,Braswell; Geoffrey E.,0,0,0,0
1715618651456,BENG 196,001,628496,Engler; Adam J.,9998,0,9999,1
1715618651456,BENG 196,002,660916,Watson; John Thomas,9999,0,9999,0
1715618652483,BISP 197,001,650773,Wilhelm; James E.,9994,0,9999,5
1715618652483,BISP 197,002,658904,Coleman; Aaron B.,9998,0,9999,1
1715618653507,CAT 124RS,A01,519847,Geibel; William,0,0,20,20
1715618654534,CAT 125RS,A01,515971,Geibel; William,0,0,20,20
1715618655559,CLRE 250,A00,511389,Morris; Sheldon,9992,0,9999,7
1715618656584,CLRE 251,A00,507176,Mehta; Ravindra L.,9992,0,9999,7
1715618656584,CLRE 251,B00,511410,Mehta; Ravindra L.,9998,0,9999,1
1715618657614,CLRE 252,A00,507189,Cuomo; Raphael Eduardo,9994,0,9999,5
1715618658639,CLRE 253,A00,507199,Vaida; Florin,9994,0,9999,5
1715618658639,CLRE 253,B00,507202,Vaida; Florin,9999,0,9999,0
1715618659667,CLRE 259,A00,507211,Patel; Hemal,9996,0,9999,3
1715618660694,CLRE 260,A00,507221,Cuomo; Raphael Eduardo,9999,0,9999,0
1715618661719,CLRE 297,001,507242,Cuomo; Raphael Eduardo,9999,0,9999,0
1715618662745,COGS 197,001,638244,Voytek; Bradley Thomas,9997,0,9999,2
1715618663773,CSE 191,A00,516875,Minnes Kemp; Mor Mia,9991,0,9999,8
1715618664800,CSE 197,001,637388,Minnes Kemp; Mor Mia,9992,0,9999,7
1715618665830,CSS 201S,A01,494383,Mignozzetti; Umberto,35,0,35,0
1715618666856,CSS 202S,A01,494387,Mignozzetti; Umberto,35,0,35,0
1715618667881,DSC 197,001,628532,Eldridge; Justin Matthew,9995,0,9999,4
1715618668909,EAP 100,A00,516065,Staff,9799,0,9999,200
1715618669938,ECE 45,A01,507414,Staff,31,0,60,29
1715618671993,ECE 111,A01,507420,Staff,11,0,50,39
1715618673021,ECE 197,001,548057,Sievenpiper; Daniel F.,9991,0,9999,8
1715618674046,EDS 115,A00,507243,Choi; Bailey Miyeon,7,0,28,21
1715618675070,EDS 117,A01,494379,Staff,0,6,34,34
1715618676095,EDS 125,A00,507246,Hopkins; Megan Beth,8,0,30,22
1715618677124,EDS 128A,A01,507264,Fargason; Sharon Gayle,6,0,26,20
1715618678152,EDS 128B,A01,507293,Pappas; Elizabeth,10,0,30,20
1715618679178,EDS 139,A00,507294,Fargason; Sharon Gayle,10,0,30,20
1715618679178,EDS 139,B00,507313,Pappas; Elizabeth,11,0,30,19
1715618680204,EDS 201,A00,507315,Staff,10,0,30,20
1715618681233,EDS 203,A01,507317,Halter; Christopher P.,10,0,30,20
1715618682259,EDS 204R,A01,507319,Halter; Christopher P.,0,3,30,30
1715618682259,EDS 204R,B01,507331,Heinzman; Erica M.,14,0,30,16
1715618683289,EDS 206R,A00,507332,Staff,0,4,30,30
1715618683289,EDS 206R,B00,507343,Staff,15,0,30,15
1715618684317,EDS 250,A00,507344,Hemans; Patricia Ann Benitez,20,0,40,20
1715618685342,EDS 281,A00,507345,Daly; Alan J.,18,0,18,0
1715618686366,EDS 284,A00,507350,Daly; Alan J.,16,0,16,0
1715618687392,EDS 286,A00,507359,Fine; Sarah,18,0,18,0
1715618688420,EDS 289C,A01,507361,Daly; Alan J.,18,0,18,0
1715618689448,EDS 290,A00,507366,Hofstetter; Carolyn,15,0,15,0
1715618690478,LIGM 5A,A00,507421,Fischer-Grunski; Eva K,17,0,20,3
1715618691502,LIGM 5B,A00,507423,Fischer-Grunski; Eva K,19,0,20,1
1715618692529,LIGM 5C,A00,507425,Fischer-Grunski; Eva K,19,0,20,1
1715618693557,LIIT 5AS,A00,507427,Carnelos; Chiara,20,0,20,0
1715618694582,LIIT 5BS,A00,507430,Carnelos; Chiara,20,0,20,0
1715618695607,LIIT 5CS,A00,507432,Carnelos; Chiara,20,0,20,0
1715618696635,LISP 5A,A00,507541,Munoz Sanchez; Alicia,11,0,20,9
1715618697660,LISP 5B,A00,507671,Munoz Sanchez; Alicia,9,0,20,11
1715618698686,LISP 5C,A00,507696,Munoz Sanchez; Alicia,9,0,20,11
1715618699714,MAE 197,001,528363,Boechler; Nicholas Sebastia,9998,0,9999,1
1715618700740,MATH 197,001,523477,Kedlaya; Kiran S.,9994,0,9999,5
1715618700740,MATH 197,002,563811,Zhang; Danna,9994,0,9999,5
1715618700740,MATH 197,003,628552,Dumitriu; Ioana,9998,0,9999,1
1715618700740,MATH 197,004,660885,Floyd; Eric,9998,0,9999,1
1715618701767,MCWP 40R,A00,518780,Staff,2,0,20,18
1715618701767,MCWP 40R,B00,518781,Staff,11,0,20,9
1715618701767,MCWP 40R,C00,518783,Staff,5,0,20,15
1715618702796,MCWP 50R,A00,518791,Staff,0,1,20,20
1715618702796,MCWP 50R,B00,518792,Staff,0,2,20,20
1715618702796,MCWP 50R,C00,518793,Staff,0,4,20,20
1715618702796,MCWP 50R,D00,518794,Staff,0,1,20,20
1715618702796,MCWP 50R,E00,518795,Staff,0,2,20,20
1715618702796,MCWP 50R,F00,518796,Staff,0,1,20,20
1715618702796,MCWP 50R,G00,518797,Staff,0,1,20,20
1715618703822,MMW 12R,A01,514034,Herbst; Matthew,0,2,16,16
1715618703822,MMW 12R,A02,514035,Herbst; Matthew,0,0,16,16
1715618704846,MMW 13R,A01,514037,Staff,0,5,16,16
1715618704846,MMW 13R,A02,514039,Staff,0,5,16,16
1715618704846,MMW 13R,A03,628519,Staff,0,4,16,16
1715618706898,SIO 295LS,A00,523233,Staff,10,0,30,20
1715618707922,SIO 295S,A00,523232,Staff,10,0,30,20
1715618708950,SIOC 290S,A01,637330,Merrifield; Mark A,23,0,30,7
1715618709979,SIOC 291S,A01,637333,Gabriel; Corey John,23,0,30,7
1715618711004,SOCI 117,A01,494376,Staff,0,5,5,5
1715618712030,WES 237B,A00,494380,Staff,10,0,20,10
1715618714091,AESE 279B,A00,494370,Wade; Jon P,0,0,33,33
1715618715114,AIP 97,001,660915,Van Den Einde; Yael Dahlia,9998,0,9999,1
1715618716143,AIP 197,001,627712,Vespa; Emanuel Ignacio,9995,0,9999,4
1715618716143,AIP 197,002,650778,Amir; On,9998,0,9999,1
1715618716143,AIP 197,003,650933,Avenancio-Leon; Carlos,9998,0,9999,1
1715618716143,AIP 197,004,658530,Heyman; Gail D.,9998,0,9999,1
1715618716143,AIP 197,005,658631,Neal; Sonya E,9998,0,9999,1
1715618716143,AIP 197,006,658671,Du; Songzi,9998,0,9999,1
1715618717167,ANAR 135S,A00,494369,Braswell; Geoffrey E.,0,0,0,0
1715618718194,BENG 196,001,628496,Engler; Adam J.,9998,0,9999,1
1715618718194,BENG 196,002,660916,Watson; John Thomas,9999,0,9999,0
1715618719222,BISP 197,001,650773,Wilhelm; James E.,9994,0,9999,5
1715618719222,BISP 197,002,658904,Coleman; Aaron B.,9998,0,9999,1
1715618720251,CAT 124RS,A01,519847,Geibel; William,0,0,20,20
1715618721280,CAT 125RS,A01,515971,Geibel; William,0,0,20,20
1715618722305,CLRE 250,A00,511389,Morris; Sheldon,9992,0,9999,7
1715618723331,CLRE 251,A00,507176,Mehta; Ravindra L.,9992,0,9999,7
1715618723331,CLRE 251,B00,511410,Mehta; Ravindra L.,9998,0,9999,1
1715618724355,CLRE 252,A00,507189,Cuomo; Raphael Eduardo,9994,0,9999,5
1715618725381,CLRE 253,A00,507199,Vaida; Florin,9994,0,9999,5
1715618725381,CLRE 253,B00,507202,Vaida; Florin,9999,0,9999,0
1715618726407,CLRE 259,A00,507211,Patel; Hemal,9996,0,9999,3
1715618727436,CLRE 260,A00,507221,Cuomo; Raphael Eduardo,9999,0,9999,0
1715618728462,CLRE 297,001,507242,Cuomo; Raphael Eduardo,9999,0,9999,0
1715618729489,COGS 197,001,638244,Voytek; Bradley Thomas,9997,0,9999,2
1715618730516,CSE 191,A00,516875,Minnes Kemp; Mor Mia,9991,0,9999,8
1715618731545,CSE 197,001,637388,Minnes Kemp; Mor Mia,9992,0,9999,7
1715618732571,CSS 201S,A01,494383,Mignozzetti; Umberto,35,0,35,0
1715618733599,CSS 202S,A01,494387,Mignozzetti; Umberto,35,0,35,0
1715618734625,DSC 197,001,628532,Eldridge; Justin Matthew,9995,0,9999,4
1715618735651,EAP 100,A00,516065,Staff,9799,0,9999,200
1715618736683,ECE 45,A01,507414,Staff,31,0,60,29
1715618738732,ECE 111,A01,507420,Staff,11,0,50,39
1715618739760,ECE 197,001,548057,Sievenpiper; Daniel F.,9991,0,9999,8
1715618740785,EDS 115,A00,507243,Choi; Bailey Miyeon,7,0,28,21
1715618741812,EDS 117,A01,494379,Staff,0,6,34,34
1715618742837,EDS 125,A00,507246,Hopkins; Megan Beth,8,0,30,22
1715618743870,EDS 128A,A01,507264,Fargason; Sharon Gayle,6,0,26,20
1715618744897,EDS 128B,A01,507293,Pappas; Elizabeth,10,0,30,20
1715618745925,EDS 139,A00,507294,Fargason; Sharon Gayle,10,0,30,20
1715618745925,EDS 139,B00,507313,Pappas; Elizabeth,11,0,30,19
1715618746949,EDS 201,A00,507315,Staff,10,0,30,20
1715618747975,EDS 203,A01,507317,Halter; Christopher P.,10,0,30,20
1715618749004,EDS 204R,A01,507319,Halter; Christopher P.,0,3,30,30
1715618749004,EDS 204R,B01,507331,Heinzman; Erica M.,14,0,30,16
1715618750029,EDS 206R,A00,507332,Staff,0,4,30,30
1715618750029,EDS 206R,B00,507343,Staff,15,0,30,15
1715618751055,EDS 250,A00,507344,Hemans; Patricia Ann Benitez,20,0,40,20
1715618752079,EDS 281,A00,507345,Daly; Alan J.,18,0,18,0
1715618753105,EDS 284,A00,507350,Daly; Alan J.,16,0,16,0
1715618754131,EDS 286,A00,507359,Fine; Sarah,18,0,18,0
1715618755158,EDS 289C,A01,507361,Daly; Alan J.,18,0,18,0
1715618756185,EDS 290,A00,507366,Hofstetter; Carolyn,15,0,15,0
1715618757212,LIGM 5A,A00,507421,Fischer-Grunski; Eva K,17,0,20,3
1715618758241,LIGM 5B,A00,507423,Fischer-Grunski; Eva K,19,0,20,1
1715618759270,LIGM 5C,A00,507425,Fischer-Grunski; Eva K,19,0,20,1
1715618760299,LIIT 5AS,A00,507427,Carnelos; Chiara,20,0,20,0
1715618761330,LIIT 5BS,A00,507430,Carnelos; Chiara,20,0,20,0
1715618762356,LIIT 5CS,A00,507432,Carnelos; Chiara,20,0,20,0
1715618763385,LISP 5A,A00,507541,Munoz Sanchez; Alicia,11,0,20,9
1715618764413,LISP 5B,A00,507671,Munoz Sanchez; Alicia,9,0,20,11
1715618765442,LISP 5C,A00,507696,Munoz Sanchez; Alicia,9,0,20,11
1715618766472,MAE 197,001,528363,Boechler; Nicholas Sebastia,9998,0,9999,1
1715618767529,MATH 197,001,523477,Kedlaya; Kiran S.,9994,0,9999,5
1715618767529,MATH 197,002,563811,Zhang; Danna,9994,0,9999,5
1715618767529,MATH 197,003,628552,Dumitriu; Ioana,9998,0,9999,1
1715618767529,MATH 197,004,660885,Floyd; Eric,9998,0,9999,1
1715618768561,MCWP 40R,A00,518780,Staff,2,0,20,18
1715618768561,MCWP 40R,B00,518781,Staff,11,0,20,9
1715618768561,MCWP 40R,C00,518783,Staff,5,0,20,15
1715618769588,MCWP 50R,A00,518791,Staff,0,1,20,20
1715618769588,MCWP 50R,B00,518792,Staff,0,2,20,20
1715618769588,MCWP 50R,C00,518793,Staff,0,4,20,20
1715618769588,MCWP 50R,D00,518794,Staff,0,1,20,20
1715618769588,MCWP 50R,E00,518795,Staff,0,2,20,20
1715618769588,MCWP 50R,F00,518796,Staff,0,1,20,20
1715618769588,MCWP 50R,G00,518797,Staff,0,1,20,20
1715618770617,MMW 12R,A01,514034,Herbst; Matthew,0,2,16,16
1715618770617,MMW 12R,A02,514035,Herbst; Matthew,0,0,16,16
1715618771643,MMW 13R,A01,514037,Staff,0,5,16,16
1715618771643,MMW 13R,A02,514039,Staff,0,5,16,16
1715618771643,MMW 13R,A03,628519,Staff,0,4,16,16
1715618773693,SIO 295LS,A00,523233,Staff,10,0,30,20
1715618774719,SIO 295S,A00,523232,Staff,10,0,30,20
1715618775745,SIOC 290S,A01,637330,Merrifield; Mark A,23,0,30,7
1715618776774,SIOC 291S,A01,637333,Gabriel; Corey John,23,0,30,7
1715618777800,SOCI 117,A01,494376,Staff,0,5,5,5
1715618778826,WES 237B,A00,494380,Staff,10,0,20,10
1715618780901,AESE 279B,A00,494370,Wade; Jon P,0,0,33,33
1715618781928,AIP 97,001,660915,Van Den Einde; Yael Dahlia,9998,0,9999,1
1715618782954,AIP 197,001,627712,Vespa; Emanuel Ignacio,9995,0,9999,4
1715618782954,AIP 197,002,650778,Amir; On,9998,0,9999,1
1715618782954,AIP 197,003,650933,Avenancio-Leon; Carlos,9998,0,9999,1
1715618782954,AIP 197,004,658530,Heyman; Gail D.,9998,0,9999,1
1715618782954,AIP 197,005,658631,Neal; Sonya E,9998,0,9999,1
1715618782954,AIP 197,006,658671,Du; Songzi,9998,0,9999,1
1715618783979,ANAR 135S,A00,494369,Braswell; Geoffrey E.,0,0,0,0
1715618785005,BENG 196,001,628496,Engler; Adam J.,9998,0,9999,1
1715618785005,BENG 196,002,660916,Watson; John Thomas,9999,0,9999,0
1715618786029,BISP 197,001,650773,Wilhelm; James E.,9994,0,9999,5
1715618786029,BISP 197,002,658904,Coleman; Aaron B.,9998,0,9999,1
1715618787054,CAT 124RS,A01,519847,Geibel; William,0,0,20,20
1715618788079,CAT 125RS,A01,515971,Geibel; William,0,0,20,20
1715618789107,CLRE 250,A00,511389,Morris; Sheldon,9992,0,9999,7
1715618790132,CLRE 251,A00,507176,Mehta; Ravindra L.,9992,0,9999,7
1715618790132,CLRE 251,B00,511410,Mehta; Ravindra L.,9998,0,9999,1
1715618791157,CLRE 252,A00,507189,Cuomo; Raphael Eduardo,9994,0,9999,5
1715618792183,CLRE 253,A00,507199,Vaida; Florin,9994,0,9999,5
1715618792183,CLRE 253,B00,507202,Vaida; Florin,9999,0,9999,0
1715618793211,CLRE 259,A00,507211,Patel; Hemal,9996,0,9999,3
1715618794236,CLRE 260,A00,507221,Cuomo; Raphael Eduardo,9999,0,9999,0
1715618795262,CLRE 297,001,507242,Cuomo; Raphael Eduardo,9999,0,9999,0
1715618796287,COGS 197,001,638244,Voytek; Bradley Thomas,9997,0,9999,2
1715618797312,CSE 191,A00,516875,Minnes Kemp; Mor Mia,9991,0,9999,8
1715618798336,CSE 197,001,637388,Minnes Kemp; Mor Mia,9992,0,9999,7
1715618799364,CSS 201S,A01,494383,Mignozzetti; Umberto,35,0,35,0
1715618800389,CSS 202S,A01,494387,Mignozzetti; Umberto,35,0,35,0
1715618801413,DSC 197,001,628532,Eldridge; Justin Matthew,9995,0,9999,4
1715618802441,EAP 100,A00,516065,Staff,9799,0,9999,200
1715618803468,ECE 45,A01,507414,Staff,31,0,60,29
1715618805523,ECE 111,A01,507420,Staff,11,0,50,39
1715618806549,ECE 197,001,548057,Sievenpiper; Daniel F.,9991,0,9999,8
1715618807577,EDS 115,A00,507243,Choi; Bailey Miyeon,7,0,28,21
1715618808604,EDS 117,A01,494379,Staff,0,6,34,34
1715618809631,EDS 125,A00,507246,Hopkins; Megan Beth,8,0,30,22
1715618810657,EDS 128A,A01,507264,Fargason; Sharon Gayle,6,0,26,20
1715618811683,EDS 128B,A01,507293,Pappas; Elizabeth,10,0,30,20
1715618812709,EDS 139,A00,507294,Fargason; Sharon Gayle,10,0,30,20
1715618812709,EDS 139,B00,507313,Pappas; Elizabeth,11,0,30,19
1715618813739,EDS 201,A00,507315,Staff,10,0,30,20
1715618814768,EDS 203,A01,507317,Halter; Christopher P.,10,0,30,20
1715618815794,EDS 204R,A01,507319,Halter; Christopher P.,0,3,30,30
1715618815794,EDS 204R,B01,507331,Heinzman; Erica M.,14,0,30,16
1715618816819,EDS 206R,A00,507332,Staff,0,4,30,30
1715618816819,EDS 206R,B00,507343,Staff,15,0,30,15
1715618817848,EDS 250,A00,507344,Hemans; Patricia Ann Benitez,20,0,40,20
1715618818873,EDS 281,A00,507345,Daly; Alan J.,18,0,18,0
1715618819898,EDS 284,A00,507350,Daly; Alan J.,16,0,16,0
1715618820923,EDS 286,A00,507359,Fine; Sarah,18,0,18,0
1715618821947,EDS 289C,A01,507361,Daly; Alan J.,18,0,18,0
1715618822974,EDS 290,A00,507366,Hofstetter; Carolyn,15,0,15,0
1715618824004,LIGM 5A,A00,507421,Fischer-Grunski; Eva K,17,0,20,3
1715618825032,LIGM 5B,A00,507423,Fischer-Grunski; Eva K,19,0,20,1
1715618826061,LIGM 5C,A00,507425,Fischer-Grunski; Eva K,19,0,20,1
1715618827092,LIIT 5AS,A00,507427,Carnelos; Chiara,20,0,20,0
1715618828119,LIIT 5BS,A00,507430,Carnelos; Chiara,20,0,20,0
1715618829146,LIIT 5CS,A00,507432,Carnelos; Chiara,20,0,20,0
1715618830172,LISP 5A,A00,507541,Munoz Sanchez; Alicia,11,0,20,9
1715618831197,LISP 5B,A00,507671,Munoz Sanchez; Alicia,9,0,20,11
1715618832223,LISP 5C,A00,507696,Munoz Sanchez; Alicia,9,0,20,11
1715618833249,MAE 197,001,528363,Boechler; Nicholas Sebastia,9998,0,9999,1
1715618834275,MATH 197,001,523477,Kedlaya; Kiran S.,9994,0,9999,5
1715618834275,MATH 197,002,563811,Zhang; Danna,9994,0,9999,5
1715618834275,MATH 197,003,628552,Dumitriu; Ioana,9998,0,9999,1
1715618834275,MATH 197,004,660885,Floyd; Eric,9998,0,9999,1
1715618835302,MCWP 40R,A00,518780,Staff,2,0,20,18
1715618835302,MCWP 40R,B00,518781,Staff,11,0,20,9
1715618835302,MCWP 40R,C00,518783,Staff,5,0,20,15
1715618836328,MCWP 50R,A00,518791,Staff,0,1,20,20
1715618836328,MCWP 50R,B00,518792,Staff,0,2,20,20
1715618836328,MCWP 50R,C00,518793,Staff,0,4,20,20
1715618836328,MCWP 50R,D00,518794,Staff,0,1,20,20
1715618836328,MCWP 50R,E00,518795,Staff,0,2,20,20
1715618836328,MCWP 50R,F00,518796,Staff,0,1,20,20
1715618836328,MCWP 50R,G00,518797,Staff,0,1,20,20
1715618837353,MMW 12R,A01,514034,Herbst; Matthew,0,2,16,16
1715618837353,MMW 12R,A02,514035,Herbst; Matthew,0,0,16,16
1715618838378,MMW 13R,A01,514037,Staff,0,5,16,16
1715618838378,MMW 13R,A02,514039,Staff,0,5,16,16
1715618838378,MMW 13R,A03,628519,Staff,0,4,16,16
1715618840428,SIO 295LS,A00,523233,Staff,10,0,30,20
1715618841452,SIO 295S,A00,523232,Staff,10,0,30,20
1715618842482,SIOC 290S,A01,637330,Merrifield; Mark A,23,0,30,7
1715618843510,SIOC 291S,A01,637333,Gabriel; Corey John,23,0,30,7
1715618844536,SOCI 117,A01,494376,Staff,0,5,5,5
1715618845561,WES 237B,A00,494380,Staff,10,0,20,10
1715618847634,AESE 279B,A00,494370,Wade; Jon P,0,0,33,33
1715618848661,AIP 97,001,660915,Van Den Einde; Yael Dahlia,9998,0,9999,1
1715618849691,AIP 197,001,627712,Vespa; Emanuel Ignacio,9995,0,9999,4
1715618849691,AIP 197,002,650778,Amir; On,9998,0,9999,1
1715618849691,AIP 197,003,650933,Avenancio-Leon; Carlos,9998,0,9999,1
1715618849691,AIP 197,004,658530,Heyman; Gail D.,9998,0,9999,1
1715618849691,AIP 197,005,658631,Neal; Sonya E,9998,0,9999,1
1715618849691,AIP 197,006,658671,Du; Songzi,9998,0,9999,1
1715618850718,ANAR 135S,A00,494369,Braswell; Geoffrey E.,0,0,0,0
1715618851743,BENG 196,001,628496,Engler; Adam J.,9998,0,9999,1
1715618851743,BENG 196,002,660916,Watson; John Thomas,9999,0,9999,0
1715618852773,BISP 197,001,650773,Wilhelm; James E.,9994,0,9999,5
1715618852773,BISP 197,002,658904,Coleman; Aaron B.,9998,0,9999,1
1715618853799,CAT 124RS,A01,519847,Geibel; William,0,0,20,20
1715618854827,CAT 125RS,A01,515971,Geibel; William,0,0,20,20
1715618855855,CLRE 250,A00,511389,Morris; Sheldon,9992,0,9999,7
1715618856881,CLRE 251,A00,507176,Mehta; Ravindra L.,9992,0,9999,7
1715618856881,CLRE 251,B00,511410,Mehta; Ravindra L.,9998,0,9999,1
1715618857909,CLRE 252,A00,507189,Cuomo; Raphael Eduardo,9994,0,9999,5
1715618858934,CLRE 253,A00,507199,Vaida; Florin,9994,0,9999,5
1715618858934,CLRE 253,B00,507202,Vaida; Florin,9999,0,9999,0
1715618859960,CLRE 259,A00,507211,Patel; Hemal,9996,0,9999,3
1715618860986,CLRE 260,A00,507221,Cuomo; Raphael Eduardo,9999,0,9999,0
1715618862011,CLRE 297,001,507242,Cuomo; Raphael Eduardo,9999,0,9999,0
1715618863039,COGS 197,001,638244,Voytek; Bradley Thomas,9997,0,9999,2
1715618864065,CSE 191,A00,516875,Minnes Kemp; Mor Mia,9991,0,9999,8
1715618865091,CSE 197,001,637388,Minnes Kemp; Mor Mia,9992,0,9999,7
1715618866117,CSS 201S,A01,494383,Mignozzetti; Umberto,35,0,35,0
1715618867147,CSS 202S,A01,494387,Mignozzetti; Umberto,35,0,35,0
1715618868174,DSC 197,001,628532,Eldridge; Justin Matthew,9995,0,9999,4
1715618869199,EAP 100,A00,516065,Staff,9799,0,9999,200
1715618870233,ECE 45,A01,507414,Staff,31,0,60,29
1715618872282,ECE 111,A01,507420,Staff,11,0,50,39
1715618873313,ECE 197,001,548057,Sievenpiper; Daniel F.,9991,0,9999,8
1715618874338,EDS 115,A00,507243,Choi; Bailey Miyeon,7,0,28,21
1715618875363,EDS 117,A01,494379,Staff,0,6,34,34
1715618876391,EDS 125,A00,507246,Hopkins; Megan Beth,8,0,30,22
1715618877416,EDS 128A,A01,507264,Fargason; Sharon Gayle,6,0,26,20
1715618878443,EDS 128B,A01,507293,Pappas; Elizabeth,10,0,30,20
1715618879470,EDS 139,A00,507294,Fargason; Sharon Gayle,10,0,30,20
1715618879470,EDS 139,B00,507313,Pappas; Elizabeth,11,0,30,19
1715618880496,EDS 201,A00,507315,Staff,10,0,30,20
1715618881522,EDS 203,A01,507317,Halter; Christopher P.,10,0,30,20
1715618882547,EDS 204R,A01,507319,Halter; Christopher P.,0,3,30,30
1715618882547,EDS 204R,B01,507331,Heinzman; Erica M.,14,0,30,16
1715618883572,EDS 206R,A00,507332,Staff,0,4,30,30
1715618883572,EDS 206R,B00,507343,Staff,15,0,30,15
1715618884598,EDS 250,A00,507344,Hemans; Patricia Ann Benitez,20,0,40,20
1715618885622,EDS 281,A00,507345,Daly; Alan J.,18,0,18,0
1715618886649,EDS 284,A00,507350,Daly; Alan J.,16,0,16,0
1715618887675,EDS 286,A00,507359,Fine; Sarah,18,0,18,0
1715618888700,EDS 289C,A01,507361,Daly; Alan J.,18,0,18,0
1715618889727,EDS 290,A00,507366,Hofstetter; Carolyn,15,0,15,0
1715618890754,LIGM 5A,A00,507421,Fischer-Grunski; Eva K,17,0,20,3
1715618891784,LIGM 5B,A00,507423,Fischer-Grunski; Eva K,19,0,20,1
1715618892810,LIGM 5C,A00,507425,Fischer-Grunski; Eva K,19,0,20,1
1715618893834,LIIT 5AS,A00,507427,Carnelos; Chiara,20,0,20,0
1715618894863,LIIT 5BS,A00,507430,Carnelos; Chiara,20,0,20,0
1715618895893,LIIT 5CS,A00,507432,Carnelos; Chiara,20,0,20,0
1715618896919,LISP 5A,A00,507541,Munoz Sanchez; Alicia,11,0,20,9
1715618897946,LISP 5B,A00,507671,Munoz Sanchez; Alicia,9,0,20,11
1715618898972,LISP 5C,A00,507696,Munoz Sanchez; Alicia,9,0,20,11
1715618899998,MAE 197,001,528363,Boechler; Nicholas Sebastia,9998,0,9999,1
1715618901027,MATH 197,001,523477,Kedlaya; Kiran S.,9994,0,9999,5
1715618901027,MATH 197,002,563811,Zhang; Danna,9994,0,9999,5
1715618901027,MATH 197,003,628552,Dumitriu; Ioana,9998,0,9999,1
1715618901027,MATH 197,004,660885,Floyd; Eric,9998,0,9999,1
1715618902054,MCWP 40R,A00,518780,Staff,2,0,20,18
1715618902054,MCWP 40R,B00,518781,Staff,11,0,20,9
1715618902054,MCWP 40R,C00,518783,Staff,5,0,20,15
1715618903084,MCWP 50R,A00,518791,Staff,0,1,20,20
1715618903084,MCWP 50R,B00,518792,Staff,0,2,20,20
1715618903084,MCWP 50R,C00,518793,Staff,0,4,20,20
1715618903084,MCWP 50R,D00,518794,Staff,0,1,20,20
1715618903084,MCWP 50R,E00,518795,Staff,0,2,20,20
1715618903084,MCWP 50R,F00,518796,Staff,0,1,20,20
1715618903084,MCWP 50R,G00,518797,Staff,0,1,20,20
1715618904111,MMW 12R,A01,514034,Herbst; Matthew,0,2,16,16
1715618904111,MMW 12R,A02,514035,Herbst; Matthew,0,0,16,16
1715618905139,MMW 13R,A01,514037,Staff,0,5,16,16
1715618905139,MMW 13R,A02,514039,Staff,0,5,16,16
1715618905139,MMW 13R,A03,628519,Staff,0,4,16,16
1715618907194,SIO 295LS,A00,523233,Staff,10,0,30,20
1715618908218,SIO 295S,A00,523232,Staff,10,0,30,20
1715618909244,SIOC 290S,A01,637330,Merrifield; Mark A,23,0,30,7
1715618910270,SIOC 291S,A01,637333,Gabriel; Corey John,23,0,30,7
1715618911295,SOCI 117,A01,494376,Staff,0,5,5,5
1715618912320,WES 237B,A00,494380,Staff,10,0,20,10
1715618914397,AESE 279B,A00,494370,Wade; Jon P,0,0,33,33
1715618915421,AIP 97,001,660915,Van Den Einde; Yael Dahlia,9998,0,9999,1
1715618916450,AIP 197,001,627712,Vespa; Emanuel Ignacio,9995,0,9999,4
1715618916450,AIP 197,002,650778,Amir; On,9998,0,9999,1
1715618916450,AIP 197,003,650933,Avenancio-Leon; Carlos,9998,0,9999,1
1715618916450,AIP 197,004,658530,Heyman; Gail D.,9998,0,9999,1
1715618916450,AIP 197,005,658631,Neal; Sonya E,9998,0,9999,1
1715618916450,AIP 197,006,658671,Du; Songzi,9998,0,9999,1
1715618917476,ANAR 135S,A00,494369,Braswell; Geoffrey E.,0,0,0,0
1715618918501,BENG 196,001,628496,Engler; Adam J.,9998,0,9999,1
1715618918501,BENG 196,002,660916,Watson; John Thomas,9999,0,9999,0
1715618919530,BISP 197,001,650773,Wilhelm; James E.,9994,0,9999,5
1715618919530,BISP 197,002,658904,Coleman; Aaron B.,9998,0,9999,1
1715618920559,CAT 124RS,A01,519847,Geibel; William,0,0,20,20
1715618921589,CAT 125RS,A01,515971,Geibel; William,0,0,20,20
1715618922613,CLRE 250,A00,511389,Morris; Sheldon,9992,0,9999,7
1715618923639,CLRE 251,A00,507176,Mehta; Ravindra L.,9992,0,9999,7
1715618923639,CLRE 251,B00,511410,Mehta; Ravindra L.,9998,0,9999,1
1715618924664,CLRE 252,A00,507189,Cuomo; Raphael Eduardo,9994,0,9999,5
1715618925692,CLRE 253,A00,507199,Vaida; Florin,9994,0,9999,5
1715618925692,CLRE 253,B00,507202,Vaida; Florin,9999,0,9999,0
1715618926777,CLRE 259,A00,507211,Patel; Hemal,9996,0,9999,3
1715618927801,CLRE 260,A00,507221,Cuomo; Raphael Eduardo,9999,0,9999,0
1715618928828,CLRE 297,001,507242,Cuomo; Raphael Eduardo,9999,0,9999,0
1715618929855,COGS 197,001,638244,Voytek; Bradley Thomas,9997,0,9999,2
1715618930882,CSE 191,A00,516875,Minnes Kemp; Mor Mia,9991,0,9999,8
1715618931910,CSE 197,001,637388,Minnes Kemp; Mor Mia,9992,0,9999,7
1715618932933,CSS 201S,A01,494383,Mignozzetti; Umberto,35,0,35,0
1715618933966,CSS 202S,A01,494387,Mignozzetti; Umberto,35,0,35,0
1715618934992,DSC 197,001,628532,Eldridge; Justin Matthew,9995,0,9999,4
1715618936020,EAP 100,A00,516065,Staff,9799,0,9999,200
1715618937050,ECE 45,A01,507414,Staff,31,0,60,29
1715618939102,ECE 111,A01,507420,Staff,11,0,50,39
1715618940131,ECE 197,001,548057,Sievenpiper; Daniel F.,9991,0,9999,8
1715618941156,EDS 115,A00,507243,Choi; Bailey Miyeon,7,0,28,21
1715618942183,EDS 117,A01,494379,Staff,0,6,34,34
1715618943209,EDS 125,A00,507246,Hopkins; Megan Beth,8,0,30,22
1715618944238,EDS 128A,A01,507264,Fargason; Sharon Gayle,6,0,26,20
1715618945263,EDS 128B,A01,507293,Pappas; Elizabeth,10,0,30,20
1715618946290,EDS 139,A00,507294,Fargason; Sharon Gayle,10,0,30,20
1715618946290,EDS 139,B00,507313,Pappas; Elizabeth,11,0,30,19
1715618947315,EDS 201,A00,507315,Staff,10,0,30,20
1715618948341,EDS 203,A01,507317,Halter; Christopher P.,10,0,30,20
1715618949369,EDS 204R,A01,507319,Halter; Christopher P.,0,3,30,30
1715618949369,EDS 204R,B01,507331,Heinzman; Erica M.,14,0,30,16
1715618950395,EDS 206R,A00,507332,Staff,0,4,30,30
1715618950395,EDS 206R,B00,507343,Staff,15,0,30,15
1715618951424,EDS 250,A00,507344,Hemans; Patricia Ann Benitez,20,0,40,20
1715618952450,EDS 281,A00,507345,Daly; Alan J.,18,0,18,0
1715618953476,EDS 284,A00,507350,Daly; Alan J.,16,0,16,0
1715618954501,EDS 286,A00,507359,Fine; Sarah,18,0,18,0
1715618955526,EDS 289C,A01,507361,Daly; Alan J.,18,0,18,0
1715618956550,EDS 290,A00,507366,Hofstetter; Carolyn,15,0,15,0
1715618957577,LIGM 5A,A00,507421,Fischer-Grunski; Eva K,17,0,20,3
1715618958608,LIGM 5B,A00,507423,Fischer-Grunski; Eva K,19,0,20,1
1715618959650,LIGM 5C,A00,507425,Fischer-Grunski; Eva K,19,0,20,1
1715618960677,LIIT 5AS,A00,507427,Carnelos; Chiara,20,0,20,0
1715618961703,LIIT 5BS,A00,507430,Carnelos; Chiara,20,0,20,0
1715618962732,LIIT 5CS,A00,507432,Carnelos; Chiara,20,0,20,0
1715618963758,LISP 5A,A00,507541,Munoz Sanchez; Alicia,11,0,20,9
1715618964787,LISP 5B,A00,507671,Munoz Sanchez; Alicia,9,0,20,11
1715618965814,LISP 5C,A00,507696,Munoz Sanchez; Alicia,9,0,20,11
1715618966840,MAE 197,001,528363,Boechler; Nicholas Sebastia,9998,0,9999,1
1715618967870,MATH 197,001,523477,Kedlaya; Kiran S.,9994,0,9999,5
1715618967870,MATH 197,002,563811,Zhang; Danna,9994,0,9999,5
1715618967870,MATH 197,003,628552,Dumitriu; Ioana,9998,0,9999,1
1715618967870,MATH 197,004,660885,Floyd; Eric,9998,0,9999,1
1715618968897,MCWP 40R,A00,518780,Staff,2,0,20,18
1715618968897,MCWP 40R,B00,518781,Staff,11,0,20,9
1715618968897,MCWP 40R,C00,518783,Staff,5,0,20,15
1715618969923,MCWP 50R,A00,518791,Staff,0,1,20,20
1715618969923,MCWP 50R,B00,518792,Staff,0,2,20,20
1715618969923,MCWP 50R,C00,518793,Staff,0,4,20,20
1715618969923,MCWP 50R,D00,518794,Staff,0,1,20,20
1715618969923,MCWP 50R,E00,518795,Staff,0,2,20,20
1715618969923,MCWP 50R,F00,518796,Staff,0,1,20,20
1715618969923,MCWP 50R,G00,518797,Staff,0,1,20,20
1715618970949,MMW 12R,A01,514034,Herbst; Matthew,0,2,16,16
1715618970949,MMW 12R,A02,514035,Herbst; Matthew,0,0,16,16
1715618971973,MMW 13R,A01,514037,Staff,0,5,16,16
1715618971973,MMW 13R,A02,514039,Staff,0,5,16,16
1715618971973,MMW 13R,A03,628519,Staff,0,4,16,16
1715618974027,SIO 295LS,A00,523233,Staff,10,0,30,20
1715618975053,SIO 295S,A00,523232,Staff,10,0,30,20
1715618976082,SIOC 290S,A01,637330,Merrifield; Mark A,23,0,30,7
1715618977107,SIOC 291S,A01,637333,Gabriel; Corey John,23,0,30,7
1715618978134,SOCI 117,A01,494376,Staff,0,5,5,5
1715618979163,WES 237B,A00,494380,Staff,10,0,20,10
1715618981224,AESE 279B,A00,494370,Wade; Jon P,0,0,33,33
1715618982251,AIP 97,001,660915,Van Den Einde; Yael Dahlia,9998,0,9999,1
1715618983277,AIP 197,001,627712,Vespa; Emanuel Ignacio,9995,0,9999,4
1715618983277,AIP 197,002,650778,Amir; On,9998,0,9999,1
1715618983277,AIP 197,003,650933,Avenancio-Leon; Carlos,9998,0,9999,1
1715618983277,AIP 197,004,658530,Heyman; Gail D.,9998,0,9999,1
1715618983277,AIP 197,005,658631,Neal; Sonya E,9998,0,9999,1
1715618983277,AIP 197,006,658671,Du; Songzi,9998,0,9999,1
1715618984303,ANAR 135S,A00,494369,Braswell; Geoffrey E.,0,0,0,0
1715618985329,BENG 196,001,628496,Engler; Adam J.,9998,0,9999,1
1715618985329,BENG 196,002,660916,Watson; John Thomas,9999,0,9999,0
1715618986354,BISP 197,001,650773,Wilhelm; James E.,9994,0,9999,5
1715618986354,BISP 197,002,658904,Coleman; Aaron B.,9998,0,9999,1
1715618987380,CAT 124RS,A01,519847,Geibel; William,0,0,20,20
1715618988411,CAT 125RS,A01,515971,Geibel; William,0,0,20,20
1715618989442,CLRE 250,A00,511389,Morris; Sheldon,9992,0,9999,7
1715618990466,CLRE 251,A00,507176,Mehta; Ravindra L.,9992,0,9999,7
1715618990466,CLRE 251,B00,511410,Mehta; Ravindra L.,9998,0,9999,1
1715618991494,CLRE 252,A00,507189,Cuomo; Raphael Eduardo,9994,0,9999,5
1715618992521,CLRE 253,A00,507199,Vaida; Florin,9994,0,9999,5
1715618992521,CLRE 253,B00,507202,Vaida; Florin,9999,0,9999,0
1715618993549,CLRE 259,A00,507211,Patel; Hemal,9996,0,9999,3
1715618994575,CLRE 260,A00,507221,Cuomo; Raphael Eduardo,9999,0,9999,0
1715618995601,CLRE 297,001,507242,Cuomo; Raphael Eduardo,9999,0,9999,0
1715618996628,COGS 197,001,638244,Voytek; Bradley Thomas,9997,0,9999,2
1715618997653,CSE 191,A00,516875,Minnes Kemp; Mor Mia,9991,0,9999,8
1715618998681,CSE 197,001,637388,Minnes Kemp; Mor Mia,9992,0,9999,7
1715618999710,CSS 201S,A01,494383,Mignozzetti; Umberto,35,0,35,0
1715619000737,CSS 202S,A01,494387,Mignozzetti; Umberto,35,0,35,0
1715619001761,DSC 197,001,628532,Eldridge; Justin Matthew,9995,0,9999,4
1715619002785,EAP 100,A00,516065,Staff,9799,0,9999,200
1715619003817,ECE 45,A01,507414,Staff,31,0,60,29
1715619005873,ECE 111,A01,507420,Staff,11,0,50,39
1715619006900,ECE 197,001,548057,Sievenpiper; Daniel F.,9991,0,9999,8
1715619007932,EDS 115,A00,507243,Choi; Bailey Miyeon,7,0,28,21
1715619008958,EDS 117,A01,494379,Staff,0,6,34,34
1715619009985,EDS 125,A00,507246,Hopkins; Megan Beth,8,0,30,22
1715619011014,EDS 128A,A01,507264,Fargason; Sharon Gayle,6,0,26,20
1715619012043,EDS 128B,A01,507293,Pappas; Elizabeth,10,0,30,20
1715619013065,EDS 139,A00,507294,Fargason; Sharon Gayle,10,0,30,20
1715619013065,EDS 139,B00,507313,Pappas; Elizabeth,11,0,30,19
1715619014091,EDS 201,A00,507315,Staff,10,0,30,20
1715619015117,EDS 203,A01,507317,Halter; Christopher P.,10,0,30,20
1715619016146,EDS 204R,A01,507319,Halter; Christopher P.,0,3,30,30
1715619016146,EDS 204R,B01,507331,Heinzman; Erica M.,14,0,30,16
1715619017175,EDS 206R,A00,507332,Staff,0,4,30,30
1715619017175,EDS 206R,B00,507343,Staff,15,0,30,15
1715619018202,EDS 250,A00,507344,Hemans; Patricia Ann Benitez,20,0,40,20
1715619019229,EDS 281,A00,507345,Daly; Alan J.,18,0,18,0
1715619020254,EDS 284,A00,507350,Daly; Alan J.,16,0,16,0
1715619021279,EDS 286,A00,507359,Fine; Sarah,18,0,18,0
1715619022305,EDS 289C,A01,507361,Daly; Alan J.,18,0,18,0
1715619023330,EDS 290,A00,507366,Hofstetter; Carolyn,15,0,15,0
1715619024361,LIGM 5A,A00,507421,Fischer-Grunski; Eva K,17,0,20,3
1715619025387,LIGM 5B,A00,507423,Fischer-Grunski; Eva K,19,0,20,1
1715619026416,LIGM 5C,A00,507425,Fischer-Grunski; Eva K,19,0,20,1
1715619027444,LIIT 5AS,A00,507427,Carnelos; Chiara,20,0,20,0
1715619028470,LIIT 5BS,A00,507430,Carnelos; Chiara,20,0,20,0
1715619029497,LIIT 5CS,A00,507432,Carnelos; Chiara,20,0,20,0
1715619030582,LISP 5A,A00,507541,Munoz Sanchez; Alicia,11,0,20,9
1715619031607,LISP 5B,A00,507671,Munoz Sanchez; Alicia,9,0,20,11
1715619032634,LISP 5C,A00,507696,Munoz Sanchez; Alicia,9,0,20,11
1715619033659,MAE 197,001,528363,Boechler; Nicholas Sebastia,9998,0,9999,1
1715619034685,MATH 197,001,523477,Kedlaya; Kiran S.,9994,0,9999,5
1715619034685,MATH 197,002,563811,Zhang; Danna,9994,0,9999,5
1715619034685,MATH 197,003,628552,Dumitriu; Ioana,9998,0,9999,1
1715619034685,MATH 197,004,660885,Floyd; Eric,9998,0,9999,1
1715619035711,MCWP 40R,A00,518780,Staff,2,0,20,18
1715619035711,MCWP 40R,B00,518781,Staff,11,0,20,9
1715619035711,MCWP 40R,C00,518783,Staff,5,0,20,15
1715619036739,MCWP 50R,A00,518791,Staff,0,1,20,20
1715619036739,MCWP 50R,B00,518792,Staff,0,2,20,20
1715619036739,MCWP 50R,C00,518793,Staff,0,4,20,20
1715619036739,MCWP 50R,D00,518794,Staff,0,1,20,20
1715619036739,MCWP 50R,E00,518795,Staff,0,2,20,20
1715619036739,MCWP 50R,F00,518796,Staff,0,1,20,20
1715619036739,MCWP 50R,G00,518797,Staff,0,1,20,20
1715619037765,MMW 12R,A01,514034,Herbst; Matthew,0,2,16,16
1715619037765,MMW 12R,A02,514035,Herbst; Matthew,0,0,16,16
1715619038793,MMW 13R,A01,514037,Staff,0,5,16,16
1715619038793,MMW 13R,A02,514039,Staff,0,5,16,16
1715619038793,MMW 13R,A03,628519,Staff,0,4,16,16
1715619040846,SIO 295LS,A00,523233,Staff,10,0,30,20
1715619041875,SIO 295S,A00,523232,Staff,10,0,30,20
1715619042900,SIOC 290S,A01,637330,Merrifield; Mark A,23,0,30,7
1715619043925,SIOC 291S,A01,637333,Gabriel; Corey John,23,0,30,7
1715619044950,SOCI 117,A01,494376,Staff,0,5,5,5
1715619045974,WES 237B,A00,494380,Staff,10,0,20,10
1715619048048,AESE 279B,A00,494370,Wade; Jon P,0,0,33,33
1715619049075,AIP 97,001,660915,Van Den Einde; Yael Dahlia,9998,0,9999,1
1715619050102,AIP 197,001,627712,Vespa; Emanuel Ignacio,9995,0,9999,4
1715619050102,AIP 197,002,650778,Amir; On,9998,0,9999,1
1715619050102,AIP 197,003,650933,Avenancio-Leon; Carlos,9998,0,9999,1
1715619050102,AIP 197,004,658530,Heyman; Gail D.,9998,0,9999,1
1715619050102,AIP 197,005,658631,Neal; Sonya E,9998,0,9999,1
1715619050102,AIP 197,006,658671,Du; Songzi,9998,0,9999,1
1715619051127,ANAR 135S,A00,494369,Braswell; Geoffrey E.,0,0,0,0
1715619052154,BENG 196,001,628496,Engler; Adam J.,9998,0,9999,1
1715619052154,BENG 196,002,660916,Watson; John Thomas,9999,0,9999,0
1715619053181,BISP 197,001,650773,Wilhelm; James E.,9994,0,9999,5
1715619053181,BISP 197,002,658904,Coleman; Aaron B.,9998,0,9999,1
1715619054207,CAT 124RS,A01,519847,Geibel; William,0,0,20,20
1715619055234,CAT 125RS,A01,515971,Geibel; William,0,0,20,20
1715619056261,CLRE 250,A00,511389,Morris; Sheldon,9992,0,9999,7
1715619057286,CLRE 251,A00,507176,Mehta; Ravindra L.,9992,0,9999,7
1715619057286,CLRE 251,B00,511410,Mehta; Ravindra L.,9998,0,9999,1
1715619058312,CLRE 252,A00,507189,Cuomo; Raphael Eduardo,9994,0,9999,5
1715619059342,CLRE 253,A00,507199,Vaida; Florin,9994,0,9999,5
1715619059342,CLRE 253,B00,507202,Vaida; Florin,9999,0,9999,0
1715619060368,CLRE 259,A00,507211,Patel; Hemal,9996,0,9999,3
1715619061395,CLRE 260,A00,507221,Cuomo; Raphael Eduardo,9999,0,9999,0
1715619062421,CLRE 297,001,507242,Cuomo; Raphael Eduardo,9999,0,9999,0
1715619063447,COGS 197,001,638244,Voytek; Bradley Thomas,9997,0,9999,2
1715619064476,CSE 191,A00,516875,Minnes Kemp; Mor Mia,9991,0,9999,8
1715619065504,CSE 197,001,637388,Minnes Kemp; Mor Mia,9992,0,9999,7
1715619066530,CSS 201S,A01,494383,Mignozzetti; Umberto,35,0,35,0
1715619067556,CSS 202S,A01,494387,Mignozzetti; Umberto,35,0,35,0
1715619068580,DSC 197,001,628532,Eldridge; Justin Matthew,9995,0,9999,4
1715619069606,EAP 100,A00,516065,Staff,9799,0,9999,200
1715619070633,ECE 45,A01,507414,Staff,31,0,60,29
1715619072684,ECE 111,A01,507420,Staff,11,0,50,39
1715619073712,ECE 197,001,548057,Sievenpiper; Daniel F.,9991,0,9999,8
1715619074738,EDS 115,A00,507243,Choi; Bailey Miyeon,7,0,28,21
1715619075766,EDS 117,A01,494379,Staff,0,6,34,34
1715619076792,EDS 125,A00,507246,Hopkins; Megan Beth,8,0,30,22
1715619077817,EDS 128A,A01,507264,Fargason; Sharon Gayle,6,0,26,20
1715619078845,EDS 128B,A01,507293,Pappas; Elizabeth,10,0,30,20
1715619079871,EDS 139,A00,507294,Fargason; Sharon Gayle,10,0,30,20
1715619079871,EDS 139,B00,507313,Pappas; Elizabeth,11,0,30,19
1715619080900,EDS 201,A00,507315,Staff,10,0,30,20
1715619081923,EDS 203,A01,507317,Halter; Christopher P.,10,0,30,20
1715619082947,EDS 204R,A01,507319,Halter; Christopher P.,0,3,30,30
1715619082947,EDS 204R,B01,507331,Heinzman; Erica M.,14,0,30,16
1715619083972,EDS 206R,A00,507332,Staff,0,4,30,30
1715619083972,EDS 206R,B00,507343,Staff,15,0,30,15
1715619085003,EDS 250,A00,507344,Hemans; Patricia Ann Benitez,20,0,40,20
1715619086027,EDS 281,A00,507345,Daly; Alan J.,18,0,18,0
1715619087054,EDS 284,A00,507350,Daly; Alan J.,16,0,16,0
1715619088083,EDS 286,A00,507359,Fine; Sarah,18,0,18,0
1715619089110,EDS 289C,A01,507361,Daly; Alan J.,18,0,18,0
1715619090138,EDS 290,A00,507366,Hofstetter; Carolyn,15,0,15,0
1715619091164,LIGM 5A,A00,507421,Fischer-Grunski; Eva K,17,0,20,3
1715619092190,LIGM 5B,A00,507423,Fischer-Grunski; Eva K,19,0,20,1
1715619093219,LIGM 5C,A00,507425,Fischer-Grunski; Eva K,19,0,20,1
1715619094245,LIIT 5AS,A00,507427,Carnelos; Chiara,20,0,20,0
1715619095269,LIIT 5BS,A00,507430,Carnelos; Chiara,20,0,20,0
1715619096296,LIIT 5CS,A00,507432,Carnelos; Chiara,20,0,20,0
1715619097322,LISP 5A,A00,507541,Munoz Sanchez; Alicia,11,0,20,9
1715619098350,LISP 5B,A00,507671,Munoz Sanchez; Alicia,9,0,20,11
1715619099376,LISP 5C,A00,507696,Munoz Sanchez; Alicia,9,0,20,11
1715619100402,MAE 197,001,528363,Boechler; Nicholas Sebastia,9998,0,9999,1
1715619101428,MATH 197,001,523477,Kedlaya; Kiran S.,9994,0,9999,5
1715619101428,MATH 197,002,563811,Zhang; Danna,9994,0,9999,5
1715619101428,MATH 197,003,628552,Dumitriu; Ioana,9998,0,9999,1
1715619101428,MATH 197,004,660885,Floyd; Eric,9998,0,9999,1
1715619102453,MCWP 40R,A00,518780,Staff,2,0,20,18
1715619102453,MCWP 40R,B00,518781,Staff,11,0,20,9
1715619102453,MCWP 40R,C00,518783,Staff,5,0,20,15
1715619103479,MCWP 50R,A00,518791,Staff,0,1,20,20
1715619103479,MCWP 50R,B00,518792,Staff,0,2,20,20
1715619103479,MCWP 50R,C00,518793,Staff,0,4,20,20
1715619103479,MCWP 50R,D00,518794,Staff,0,1,20,20
1715619103479,MCWP 50R,E00,518795,Staff,0,2,20,20
1715619103479,MCWP 50R,F00,518796,Staff,0,1,20,20
1715619103479,MCWP 50R,G00,518797,Staff,0,1,20,20
1715619104506,MMW 12R,A01,514034,Herbst; Matthew,0,2,16,16
1715619104506,MMW 12R,A02,514035,Herbst; Matthew,0,0,16,16
1715619105534,MMW 13R,A01,514037,Staff,0,5,16,16
1715619105534,MMW 13R,A02,514039,Staff,0,5,16,16
1715619105534,MMW 13R,A03,628519,Staff,0,4,16,16
1715619107584,SIO 295LS,A00,523233,Staff,10,0,30,20
1715619108611,SIO 295S,A00,523232,Staff,10,0,30,20
1715619109638,SIOC 290S,A01,637330,Merrifield; Mark A,23,0,30,7
1715619110663,SIOC 291S,A01,637333,Gabriel; Corey John,23,0,30,7
1715619111688,SOCI 117,A01,494376,Staff,0,5,5,5
1715619112714,WES 237B,A00,494380,Staff,10,0,20,10
1715619114783,AESE 279B,A00,494370,Wade; Jon P,0,0,33,33
1715619115807,AIP 97,001,660915,Van Den Einde; Yael Dahlia,9998,0,9999,1
1715619116834,AIP 197,001,627712,Vespa; Emanuel Ignacio,9995,0,9999,4
1715619116834,AIP 197,002,650778,Amir; On,9998,0,9999,1
1715619116834,AIP 197,003,650933,Avenancio-Leon; Carlos,9998,0,9999,1
1715619116834,AIP 197,004,658530,Heyman; Gail D.,9998,0,9999,1
1715619116834,AIP 197,005,658631,Neal; Sonya E,9998,0,9999,1
1715619116834,AIP 197,006,658671,Du; Songzi,9998,0,9999,1
1715619117859,ANAR 135S,A00,494369,Braswell; Geoffrey E.,0,0,0,0
1715619118884,BENG 196,001,628496,Engler; Adam J.,9998,0,9999,1
1715619118884,BENG 196,002,660916,Watson; John Thomas,9999,0,9999,0
1715619119910,BISP 197,001,650773,Wilhelm; James E.,9994,0,9999,5
1715619119910,BISP 197,002,658904,Coleman; Aaron B.,9998,0,9999,1
1715619120934,CAT 124RS,A01,519847,Geibel; William,0,0,20,20
1715619121959,CAT 125RS,A01,515971,Geibel; William,0,0,20,20
1715619122989,CLRE 250,A00,511389,Morris; Sheldon,9992,0,9999,7
1715619124018,CLRE 251,A00,507176,Mehta; Ravindra L.,9992,0,9999,7
1715619124018,CLRE 251,B00,511410,Mehta; Ravindra L.,9998,0,9999,1
1715619125043,CLRE 252,A00,507189,Cuomo; Raphael Eduardo,9994,0,9999,5
1715619126069,CLRE 253,A00,507199,Vaida; Florin,9994,0,9999,5
1715619126069,CLRE 253,B00,507202,Vaida; Florin,9999,0,9999,0
1715619127098,CLRE 259,A00,507211,Patel; Hemal,9996,0,9999,3
1715619128127,CLRE 260,A00,507221,Cuomo; Raphael Eduardo,9999,0,9999,0
1715619129156,CLRE 297,001,507242,Cuomo; Raphael Eduardo,9999,0,9999,0
1715619130183,COGS 197,001,638244,Voytek; Bradley Thomas,9997,0,9999,2
1715619131211,CSE 191,A00,516875,Minnes Kemp; Mor Mia,9991,0,9999,8
1715619132241,CSE 197,001,637388,Minnes Kemp; Mor Mia,9992,0,9999,7
1715619133268,CSS 201S,A01,494383,Mignozzetti; Umberto,35,0,35,0
1715619134350,CSS 202S,A01,494387,Mignozzetti; Umberto,35,0,35,0
1715619135376,DSC 197,001,628532,Eldridge; Justin Matthew,9995,0,9999,4
1715619136404,EAP 100,A00,516065,Staff,9799,0,9999,200
1715619137435,ECE 45,A01,507414,Staff,31,0,60,29
1715619139486,ECE 111,A01,507420,Staff,11,0,50,39
1715619140509,ECE 197,001,548057,Sievenpiper; Daniel F.,9991,0,9999,8
1715619141534,EDS 115,A00,507243,Choi; Bailey Miyeon,7,0,28,21
1715619142563,EDS 117,A01,494379,Staff,0,6,34,34
1715619143587,EDS 125,A00,507246,Hopkins; Megan Beth,8,0,30,22
1715619144613,EDS 128A,A01,507264,Fargason; Sharon Gayle,6,0,26,20
1715619145641,EDS 128B,A01,507293,Pappas; Elizabeth,10,0,30,20
1715619146668,EDS 139,A00,507294,Fargason; Sharon Gayle,10,0,30,20
1715619146668,EDS 139,B00,507313,Pappas; Elizabeth,11,0,30,19
1715619147696,EDS 201,A00,507315,Staff,10,0,30,20
1715619148722,EDS 203,A01,507317,Halter; Christopher P.,10,0,30,20
1715619149751,EDS 204R,A01,507319,Halter; Christopher P.,0,3,30,30
1715619149751,EDS 204R,B01,507331,Heinzman; Erica M.,14,0,30,16
1715619150777,EDS 206R,A00,507332,Staff,0,4,30,30
1715619150777,EDS 206R,B00,507343,Staff,15,0,30,15
1715619151807,EDS 250,A00,507344,Hemans; Patricia Ann Benitez,20,0,40,20
1715619152833,EDS 281,A00,507345,Daly; Alan J.,18,0,18,0
1715619153862,EDS 284,A00,507350,Daly; Alan J.,16,0,16,0
1715619154888,EDS 286,A00,507359,Fine; Sarah,18,0,18,0
1715619155914,EDS 289C,A01,507361,Daly; Alan J.,18,0,18,0
1715619156941,EDS 290,A00,507366,Hofstetter; Carolyn,15,0,15,0
1715619157965,LIGM 5A,A00,507421,Fischer-Grunski; Eva K,17,0,20,3
1715619158993,LIGM 5B,A00,507423,Fischer-Grunski; Eva K,19,0,20,1
1715619160018,LIGM 5C,A00,507425,Fischer-Grunski; Eva K,19,0,20,1
1715619161049,LIIT 5AS,A00,507427,Carnelos; Chiara,20,0,20,0
1715619162074,LIIT 5BS,A00,507430,Carnelos; Chiara,20,0,20,0
1715619163099,LIIT 5CS,A00,507432,Carnelos; Chiara,20,0,20,0
1715619164125,LISP 5A,A00,507541,Munoz Sanchez; Alicia,11,0,20,9
1715619165153,LISP 5B,A00,507671,Munoz Sanchez; Alicia,9,0,20,11
1715619166183,LISP 5C,A00,507696,Munoz Sanchez; Alicia,9,0,20,11
1715619167208,MAE 197,001,528363,Boechler; Nicholas Sebastia,9998,0,9999,1
1715619168238,MATH 197,001,523477,Kedlaya; Kiran S.,9994,0,9999,5
1715619168238,MATH 197,002,563811,Zhang; Danna,9994,0,9999,5
1715619168238,MATH 197,003,628552,Dumitriu; Ioana,9998,0,9999,1
1715619168238,MATH 197,004,660885,Floyd; Eric,9998,0,9999,1
1715619169263,MCWP 40R,A00,518780,Staff,2,0,20,18
1715619169263,MCWP 40R,B00,518781,Staff,11,0,20,9
1715619169263,MCWP 40R,C00,518783,Staff,5,0,20,15
1715619170289,MCWP 50R,A00,518791,Staff,0,1,20,20
1715619170289,MCWP 50R,B00,518792,Staff,0,2,20,20
1715619170289,MCWP 50R,C00,518793,Staff,0,4,20,20
1715619170289,MCWP 50R,D00,518794,Staff,0,1,20,20
1715619170289,MCWP 50R,E00,518795,Staff,0,2,20,20
1715619170289,MCWP 50R,F00,518796,Staff,0,1,20,20
1715619170289,MCWP 50R,G00,518797,Staff,0,1,20,20
1715619171315,MMW 12R,A01,514034,Herbst; Matthew,0,2,16,16
1715619171315,MMW 12R,A02,514035,Herbst; Matthew,0,0,16,16
1715619172341,MMW 13R,A01,514037,Staff,0,5,16,16
1715619172341,MMW 13R,A02,514039,Staff,0,5,16,16
1715619172341,MMW 13R,A03,628519,Staff,0,4,16,16
1715619174393,SIO 295LS,A00,523233,Staff,10,0,30,20
1715619175421,SIO 295S,A00,523232,Staff,10,0,30,20
1715619176450,SIOC 290S,A01,637330,Merrifield; Mark A,23,0,30,7
1715619177478,SIOC 291S,A01,637333,Gabriel; Corey John,23,0,30,7
1715619178508,SOCI 117,A01,494376,Staff,0,5,5,5
1715619179534,WES 237B,A00,494380,Staff,10,0,20,10
1715619181613,AESE 279B,A00,494370,Wade; Jon P,0,0,33,33
1715619182641,AIP 97,001,660915,Van Den Einde; Yael Dahlia,9998,0,9999,1
1715619183670,AIP 197,001,627712,Vespa; Emanuel Ignacio,9995,0,9999,4
1715619183670,AIP 197,002,650778,Amir; On,9998,0,9999,1
1715619183670,AIP 197,003,650933,Avenancio-Leon; Carlos,9998,0,9999,1
1715619183670,AIP 197,004,658530,Heyman; Gail D.,9998,0,9999,1
1715619183670,AIP 197,005,658631,Neal; Sonya E,9998,0,9999,1
1715619183670,AIP 197,006,658671,Du; Songzi,9998,0,9999,1
1715619184696,ANAR 135S,A00,494369,Braswell; Geoffrey E.,0,0,0,0
1715619185724,BENG 196,001,628496,Engler; Adam J.,9998,0,9999,1
1715619185724,BENG 196,002,660916,Watson; John Thomas,9999,0,9999,0
1715619186750,BISP 197,001,650773,Wilhelm; James E.,9994,0,9999,5
1715619186750,BISP 197,002,658904,Coleman; Aaron B.,9998,0,9999,1
1715619187777,CAT 124RS,A01,519847,Geibel; William,0,0,20,20
1715619188801,CAT 125RS,A01,515971,Geibel; William,0,0,20,20
1715619189825,CLRE 250,A00,511389,Morris; Sheldon,9992,0,9999,7
1715619190851,CLRE 251,A00,507176,Mehta; Ravindra L.,9992,0,9999,7
1715619190851,CLRE 251,B00,511410,Mehta; Ravindra L.,9998,0,9999,1
1715619191881,CLRE 252,A00,507189,Cuomo; Raphael Eduardo,9994,0,9999,5
1715619192910,CLRE 253,A00,507199,Vaida; Florin,9994,0,9999,5
1715619192910,CLRE 253,B00,507202,Vaida; Florin,9999,0,9999,0
1715619193933,CLRE 259,A00,507211,Patel; Hemal,9996,0,9999,3
1715619194960,CLRE 260,A00,507221,Cuomo; Raphael Eduardo,9999,0,9999,0
1715619195985,CLRE 297,001,507242,Cuomo; Raphael Eduardo,9999,0,9999,0
1715619197012,COGS 197,001,638244,Voytek; Bradley Thomas,9997,0,9999,2
1715619198038,CSE 191,A00,516875,Minnes Kemp; Mor Mia,9991,0,9999,8
1715619199064,CSE 197,001,637388,Minnes Kemp; Mor Mia,9992,0,9999,7
1715619200093,CSS 201S,A01,494383,Mignozzetti; Umberto,35,0,35,0
1715619201116,CSS 202S,A01,494387,Mignozzetti; Umberto,35,0,35,0
1715619202142,DSC 197,001,628532,Eldridge; Justin Matthew,9995,0,9999,4
1715619203166,EAP 100,A00,516065,Staff,9799,0,9999,200
1715619204198,ECE 45,A01,507414,Staff,31,0,60,29
1715619206250,ECE 111,A01,507420,Staff,11,0,50,39
1715619207275,ECE 197,001,548057,Sievenpiper; Daniel F.,9991,0,9999,8
1715619208300,EDS 115,A00,507243,Choi; Bailey Miyeon,7,0,28,21
1715619209327,EDS 117,A01,494379,Staff,0,6,34,34
1715619210351,EDS 125,A00,507246,Hopkins; Megan Beth,8,0,30,22
1715619211376,EDS 128A,A01,507264,Fargason; Sharon Gayle,6,0,26,20
1715619212405,EDS 128B,A01,507293,Pappas; Elizabeth,10,0,30,20
1715619213429,EDS 139,A00,507294,Fargason; Sharon Gayle,10,0,30,20
1715619213429,EDS 139,B00,507313,Pappas; Elizabeth,11,0,30,19
1715619214456,EDS 201,A00,507315,Staff,10,0,30,20
1715619215481,EDS 203,A01,507317,Halter; Christopher P.,10,0,30,20
1715619216506,EDS 204R,A01,507319,Halter; Christopher P.,0,3,30,30
1715619216506,EDS 204R,B01,507331,Heinzman; Erica M.,14,0,30,16
1715619217530,EDS 206R,A00,507332,Staff,0,4,30,30
1715619217530,EDS 206R,B00,507343,Staff,15,0,30,15
1715619218556,EDS 250,A00,507344,Hemans; Patricia Ann Benitez,20,0,40,20
1715619219582,EDS 281,A00,507345,Daly; Alan J.,18,0,18,0
1715619220606,EDS 284,A00,507350,Daly; Alan J.,16,0,16,0
1715619221843,EDS 286,A00,507359,Fine; Sarah,18,0,18,0
1715619222866,EDS 289C,A01,507361,Daly; Alan J.,18,0,18,0
1715619223903,EDS 290,A00,507366,Hofstetter; Carolyn,15,0,15,0
1715619224929,LIGM 5A,A00,507421,Fischer-Grunski; Eva K,17,0,20,3
1715619225958,LIGM 5B,A00,507423,Fischer-Grunski; Eva K,19,0,20,1
1715619226983,LIGM 5C,A00,507425,Fischer-Grunski; Eva K,19,0,20,1
1715619228016,LIIT 5AS,A00,507427,Carnelos; Chiara,20,0,20,0
1715619229043,LIIT 5BS,A00,507430,Carnelos; Chiara,20,0,20,0
1715619230068,LIIT 5CS,A00,507432,Carnelos; Chiara,20,0,20,0
1715619231097,LISP 5A,A00,507541,Munoz Sanchez; Alicia,11,0,20,9
1715619232126,LISP 5B,A00,507671,Munoz Sanchez; Alicia,9,0,20,11
1715619233152,LISP 5C,A00,507696,Munoz Sanchez; Alicia,9,0,20,11
1715619234177,MAE 197,001,528363,Boechler; Nicholas Sebastia,9998,0,9999,1
1715619235205,MATH 197,001,523477,Kedlaya; Kiran S.,9994,0,9999,5
1715619235205,MATH 197,002,563811,Zhang; Danna,9994,0,9999,5
1715619235205,MATH 197,003,628552,Dumitriu; Ioana,9998,0,9999,1
1715619235205,MATH 197,004,660885,Floyd; Eric,9998,0,9999,1
1715619236230,MCWP 40R,A00,518780,Staff,2,0,20,18
1715619236230,MCWP 40R,B00,518781,Staff,11,0,20,9
1715619236230,MCWP 40R,C00,518783,Staff,5,0,20,15
1715619237261,MCWP 50R,A00,518791,Staff,0,1,20,20
1715619237261,MCWP 50R,B00,518792,Staff,0,2,20,20
1715619237261,MCWP 50R,C00,518793,Staff,0,4,20,20
1715619237261,MCWP 50R,D00,518794,Staff,0,1,20,20
1715619237261,MCWP 50R,E00,518795,Staff,0,2,20,20
1715619237261,MCWP 50R,F00,518796,Staff,0,1,20,20
1715619237261,MCWP 50R,G00,518797,Staff,0,1,20,20
1715619238290,MMW 12R,A01,514034,Herbst; Matthew,0,2,16,16
1715619238290,MMW 12R,A02,514035,Herbst; Matthew,0,0,16,16
1715619239319,MMW 13R,A01,514037,Staff,0,5,16,16
1715619239319,MMW 13R,A02,514039,Staff,0,5,16,16
1715619239319,MMW 13R,A03,628519,Staff,0,4,16,16
1715619241376,SIO 295LS,A00,523233,Staff,10,0,30,20
1715619242403,SIO 295S,A00,523232,Staff,10,0,30,20
1715619243429,SIOC 290S,A01,637330,Merrifield; Mark A,23,0,30,7
1715619244455,SIOC 291S,A01,637333,Gabriel; Corey John,23,0,30,7
1715619245483,SOCI 117,A01,494376,Staff,0,5,5,5
1715619246510,WES 237B,A00,494380,Staff,10,0,20,10
1715619248585,AESE 279B,A00,494370,Wade; Jon P,0,0,33,33
1715619249612,AIP 97,001,660915,Van Den Einde; Yael Dahlia,9998,0,9999,1
1715619250639,AIP 197,001,627712,Vespa; Emanuel Ignacio,9995,0,9999,4
1715619250639,AIP 197,002,650778,Amir; On,9998,0,9999,1
1715619250639,AIP 197,003,650933,Avenancio-Leon; Carlos,9998,0,9999,1
1715619250639,AIP 197,004,658530,Heyman; Gail D.,9998,0,9999,1
1715619250639,AIP 197,005,658631,Neal; Sonya E,9998,0,9999,1
1715619250639,AIP 197,006,658671,Du; Songzi,9998,0,9999,1
1715619251666,ANAR 135S,A00,494369,Braswell; Geoffrey E.,0,0,0,0
1715619252695,BENG 196,001,628496,Engler; Adam J.,9998,0,9999,1
1715619252695,BENG 196,002,660916,Watson; John Thomas,9999,0,9999,0
1715619253722,BISP 197,001,650773,Wilhelm; James E.,9994,0,9999,5
1715619253722,BISP 197,002,658904,Coleman; Aaron B.,9998,0,9999,1
1715619254801,CAT 124RS,A01,519847,Geibel; William,0,0,20,20
1715619255826,CAT 125RS,A01,515971,Geibel; William,0,0,20,20
1715619256855,CLRE 250,A00,511389,Morris; Sheldon,9992,0,9999,7
1715619257885,CLRE 251,A00,507176,Mehta; Ravindra L.,9992,0,9999,7
1715619257885,CLRE 251,B00,511410,Mehta; Ravindra L.,9998,0,9999,1
1715619258911,CLRE 252,A00,507189,Cuomo; Raphael Eduardo,9994,0,9999,5
1715619259936,CLRE 253,A00,507199,Vaida; Florin,9994,0,9999,5
1715619259936,CLRE 253,B00,507202,Vaida; Florin,9999,0,9999,0
1715619260963,CLRE 259,A00,507211,Patel; Hemal,9996,0,9999,3
1715619261989,CLRE 260,A00,507221,Cuomo; Raphael Eduardo,9999,0,9999,0
1715619263014,CLRE 297,001,507242,Cuomo; Raphael Eduardo,9999,0,9999,0
1715619264039,COGS 197,001,638244,Voytek; Bradley Thomas,9997,0,9999,2
1715619265065,CSE 191,A00,516875,Minnes Kemp; Mor Mia,9991,0,9999,8
1715619266091,CSE 197,001,637388,Minnes Kemp; Mor Mia,9992,0,9999,7
1715619267118,CSS 201S,A01,494383,Mignozzetti; Umberto,35,0,35,0
1715619268148,CSS 202S,A01,494387,Mignozzetti; Umberto,35,0,35,0
1715619269172,DSC 197,001,628532,Eldridge; Justin Matthew,9995,0,9999,4
1715619270200,EAP 100,A00,516065,Staff,9799,0,9999,200
1715619271227,ECE 45,A01,507414,Staff,31,0,60,29
1715619273286,ECE 111,A01,507420,Staff,11,0,50,39
1715619274311,ECE 197,001,548057,Sievenpiper; Daniel F.,9991,0,9999,8
1715619275337,EDS 115,A00,507243,Choi; Bailey Miyeon,7,0,28,21
1715619276363,EDS 117,A01,494379,Staff,0,6,34,34
1715619277389,EDS 125,A00,507246,Hopkins; Megan Beth,8,0,30,22
1715619278418,EDS 128A,A01,507264,Fargason; Sharon Gayle,6,0,26,20
1715619279445,EDS 128B,A01,507293,Pappas; Elizabeth,10,0,30,20
1715619280471,EDS 139,A00,507294,Fargason; Sharon Gayle,10,0,30,20
1715619280471,EDS 139,B00,507313,Pappas; Elizabeth,11,0,30,19
1715619281497,EDS 201,A00,507315,Staff,10,0,30,20
1715619282525,EDS 203,A01,507317,Halter; Christopher P.,10,0,30,20
1715619283553,EDS 204R,A01,507319,Halter; Christopher P.,0,3,30,30
1715619283553,EDS 204R,B01,507331,Heinzman; Erica M.,14,0,30,16
1715619284578,EDS 206R,A00,507332,Staff,0,4,30,30
1715619284578,EDS 206R,B00,507343,Staff,15,0,30,15
1715619285607,EDS 250,A00,507344,Hemans; Patricia Ann Benitez,20,0,40,20
1715619286634,EDS 281,A00,507345,Daly; Alan J.,18,0,18,0
1715619287659,EDS 284,A00,507350,Daly; Alan J.,16,0,16,0
1715619288683,EDS 286,A00,507359,Fine; Sarah,18,0,18,0
1715619289710,EDS 289C,A01,507361,Daly; Alan J.,18,0,18,0
1715619290738,EDS 290,A00,507366,Hofstetter; Carolyn,15,0,15,0
1715619291767,LIGM 5A,A00,507421,Fischer-Grunski; Eva K,17,0,20,3
1715619292791,LIGM 5B,A00,507423,Fischer-Grunski; Eva K,19,0,20,1
1715619293816,LIGM 5C,A00,507425,Fischer-Grunski; Eva K,19,0,20,1
1715619294845,LIIT 5AS,A00,507427,Carnelos; Chiara,20,0,20,0
1715619295874,LIIT 5BS,A00,507430,Carnelos; Chiara,20,0,20,0
1715619296900,LIIT 5CS,A00,507432,Carnelos; Chiara,20,0,20,0
1715619297926,LISP 5A,A00,507541,Munoz Sanchez; Alicia,11,0,20,9
1715619298951,LISP 5B,A00,507671,Munoz Sanchez; Alicia,9,0,20,11
1715619299978,LISP 5C,A00,507696,Munoz Sanchez; Alicia,9,0,20,11
1715619301007,MAE 197,001,528363,Boechler; Nicholas Sebastia,9998,0,9999,1
1715619302037,MATH 197,001,523477,Kedlaya; Kiran S.,9994,0,9999,5
1715619302037,MATH 197,002,563811,Zhang; Danna,9994,0,9999,5
1715619302037,MATH 197,003,628552,Dumitriu; Ioana,9998,0,9999,1
1715619302037,MATH 197,004,660885,Floyd; Eric,9998,0,9999,1
1715619303065,MCWP 40R,A00,518780,Staff,2,0,20,18
1715619303065,MCWP 40R,B00,518781,Staff,11,0,20,9
1715619303065,MCWP 40R,C00,518783,Staff,5,0,20,15
1715619304092,MCWP 50R,A00,518791,Staff,0,1,20,20
1715619304092,MCWP 50R,B00,518792,Staff,0,2,20,20
1715619304092,MCWP 50R,C00,518793,Staff,0,4,20,20
1715619304092,MCWP 50R,D00,518794,Staff,0,1,20,20
1715619304092,MCWP 50R,E00,518795,Staff,0,2,20,20
1715619304092,MCWP 50R,F00,518796,Staff,0,1,20,20
1715619304092,MCWP 50R,G00,518797,Staff,0,1,20,20
1715619305118,MMW 12R,A01,514034,Herbst; Matthew,0,2,16,16
1715619305118,MMW 12R,A02,514035,Herbst; Matthew,0,0,16,16
1715619306146,MMW 13R,A01,514037,Staff,0,5,16,16
1715619306146,MMW 13R,A02,514039,Staff,0,5,16,16
1715619306146,MMW 13R,A03,628519,Staff,0,4,16,16
1715619308202,SIO 295LS,A00,523233,Staff,10,0,30,20
1715619309230,SIO 295S,A00,523232,Staff,10,0,30,20
1715619310257,SIOC 290S,A01,637330,Merrifield; Mark A,23,0,30,7
1715619311282,SIOC 291S,A01,637333,Gabriel; Corey John,23,0,30,7
1715619312308,SOCI 117,A01,494376,Staff,0,5,5,5
1715619313337,WES 237B,A00,494380,Staff,10,0,20,10
1715619315404,AESE 279B,A00,494370,Wade; Jon P,0,0,33,33
1715619316431,AIP 97,001,660915,Van Den Einde; Yael Dahlia,9998,0,9999,1
1715619317458,AIP 197,001,627712,Vespa; Emanuel Ignacio,9995,0,9999,4
1715619317458,AIP 197,002,650778,Amir; On,9998,0,9999,1
1715619317458,AIP 197,003,650933,Avenancio-Leon; Carlos,9998,0,9999,1
1715619317458,AIP 197,004,658530,Heyman; Gail D.,9998,0,9999,1
1715619317458,AIP 197,005,658631,Neal; Sonya E,9998,0,9999,1
1715619317458,AIP 197,006,658671,Du; Songzi,9998,0,9999,1
1715619318487,ANAR 135S,A00,494369,Braswell; Geoffrey E.,0,0,0,0
1715619319513,BENG 196,001,628496,Engler; Adam J.,9998,0,9999,1
1715619319513,BENG 196,002,660916,Watson; John Thomas,9999,0,9999,0
1715619320539,BISP 197,001,650773,Wilhelm; James E.,9994,0,9999,5
1715619320539,BISP 197,002,658904,Coleman; Aaron B.,9998,0,9999,1
1715619321567,CAT 124RS,A01,519847,Geibel; William,0,0,20,20
1715619322592,CAT 125RS,A01,515971,Geibel; William,0,0,20,20
1715619323621,CLRE 250,A00,511389,Morris; Sheldon,9992,0,9999,7
1715619324653,CLRE 251,A00,507176,Mehta; Ravindra L.,9992,0,9999,7
1715619324653,CLRE 251,B00,511410,Mehta; Ravindra L.,9998,0,9999,1
1715619325679,CLRE 252,A00,507189,Cuomo; Raphael Eduardo,9994,0,9999,5
1715619326706,CLRE 253,A00,507199,Vaida; Florin,9994,0,9999,5
1715619326706,CLRE 253,B00,507202,Vaida; Florin,9999,0,9999,0
1715619327732,CLRE 259,A00,507211,Patel; Hemal,9996,0,9999,3
1715619328757,CLRE 260,A00,507221,Cuomo; Raphael Eduardo,9999,0,9999,0
1715619329785,CLRE 297,001,507242,Cuomo; Raphael Eduardo,9999,0,9999,0
1715619330812,COGS 197,001,638244,Voytek; Bradley Thomas,9997,0,9999,2
1715619331838,CSE 191,A00,516875,Minnes Kemp; Mor Mia,9991,0,9999,8
1715619332863,CSE 197,001,637388,Minnes Kemp; Mor Mia,9992,0,9999,7
1715619333890,CSS 201S,A01,494383,Mignozzetti; Umberto,35,0,35,0
1715619334919,CSS 202S,A01,494387,Mignozzetti; Umberto,35,0,35,0
1715619335944,DSC 197,001,628532,Eldridge; Justin Matthew,9995,0,9999,4
1715619336970,EAP 100,A00,516065,Staff,9799,0,9999,200
1715619337995,ECE 45,A01,507414,Staff,31,0,60,29
1715619340047,ECE 111,A01,507420,Staff,11,0,50,39
1715619341072,ECE 197,001,548057,Sievenpiper; Daniel F.,9991,0,9999,8
1715619342101,EDS 115,A00,507243,Choi; Bailey Miyeon,7,0,28,21
1715619343130,EDS 117,A01,494379,Staff,0,6,34,34
1715619344155,EDS 125,A00,507246,Hopkins; Megan Beth,8,0,30,22
1715619345180,EDS 128A,A01,507264,Fargason; Sharon Gayle,6,0,26,20
1715619346209,EDS 128B,A01,507293,Pappas; Elizabeth,10,0,30,20
1715619347233,EDS 139,A00,507294,Fargason; Sharon Gayle,10,0,30,20
1715619347233,EDS 139,B00,507313,Pappas; Elizabeth,11,0,30,19
1715619348258,EDS 201,A00,507315,Staff,10,0,30,20
1715619349284,EDS 203,A01,507317,Halter; Christopher P.,10,0,30,20
1715619350313,EDS 204R,A01,507319,Halter; Christopher P.,0,3,30,30
1715619350313,EDS 204R,B01,507331,Heinzman; Erica M.,14,0,30,16
1715619351338,EDS 206R,A00,507332,Staff,0,4,30,30
1715619351338,EDS 206R,B00,507343,Staff,15,0,30,15
1715619352365,EDS 250,A00,507344,Hemans; Patricia Ann Benitez,20,0,40,20
1715619353390,EDS 281,A00,507345,Daly; Alan J.,18,0,18,0
1715619354415,EDS 284,A00,507350,Daly; Alan J.,16,0,16,0
1715619355441,EDS 286,A00,507359,Fine; Sarah,18,0,18,0
1715619356464,EDS 289C,A01,507361,Daly; Alan J.,18,0,18,0
1715619357490,EDS 290,A00,507366,Hofstetter; Carolyn,15,0,15,0
1715619358588,LIGM 5A,A00,507421,Fischer-Grunski; Eva K,17,0,20,3
1715619359618,LIGM 5B,A00,507423,Fischer-Grunski; Eva K,19,0,20,1
1715619360644,LIGM 5C,A00,507425,Fischer-Grunski; Eva K,19,0,20,1
1715619361670,LIIT 5AS,A00,507427,Carnelos; Chiara,20,0,20,0
1715619362694,LIIT 5BS,A00,507430,Carnelos; Chiara,20,0,20,0
1715619363719,LIIT 5CS,A00,507432,Carnelos; Chiara,20,0,20,0
1715619364749,LISP 5A,A00,507541,Munoz Sanchez; Alicia,11,0,20,9
1715619365775,LISP 5B,A00,507671,Munoz Sanchez; Alicia,9,0,20,11
1715619366802,LISP 5C,A00,507696,Munoz Sanchez; Alicia,9,0,20,11
1715619367829,MAE 197,001,528363,Boechler; Nicholas Sebastia,9998,0,9999,1
1715619368855,MATH 197,001,523477,Kedlaya; Kiran S.,9994,0,9999,5
1715619368855,MATH 197,002,563811,Zhang; Danna,9994,0,9999,5
1715619368855,MATH 197,003,628552,Dumitriu; Ioana,9998,0,9999,1
1715619368855,MATH 197,004,660885,Floyd; Eric,9998,0,9999,1
1715619369883,MCWP 40R,A00,518780,Staff,2,0,20,18
1715619369883,MCWP 40R,B00,518781,Staff,11,0,20,9
1715619369883,MCWP 40R,C00,518783,Staff,5,0,20,15
1715619370913,MCWP 50R,A00,518791,Staff,0,1,20,20
1715619370913,MCWP 50R,B00,518792,Staff,0,2,20,20
1715619370913,MCWP 50R,C00,518793,Staff,0,4,20,20
1715619370913,MCWP 50R,D00,518794,Staff,0,1,20,20
1715619370913,MCWP 50R,E00,518795,Staff,0,2,20,20
1715619370913,MCWP 50R,F00,518796,Staff,0,1,20,20
1715619370913,MCWP 50R,G00,518797,Staff,0,1,20,20
1715619371943,MMW 12R,A01,514034,Herbst; Matthew,0,2,16,16
1715619371943,MMW 12R,A02,514035,Herbst; Matthew,0,0,16,16
1715619372969,MMW 13R,A01,514037,Staff,0,5,16,16
1715619372969,MMW 13R,A02,514039,Staff,0,5,16,16
1715619372969,MMW 13R,A03,628519,Staff,0,4,16,16
1715619375021,SIO 295LS,A00,523233,Staff,10,0,30,20
1715619376048,SIO 295S,A00,523232,Staff,10,0,30,20
1715619377071,SIOC 290S,A01,637330,Merrifield; Mark A,23,0,30,7
1715619378101,SIOC 291S,A01,637333,Gabriel; Corey John,23,0,30,7
1715619379128,SOCI 117,A01,494376,Staff,0,5,5,5
1715619380154,WES 237B,A00,494380,Staff,10,0,20,10
1715619382237,AESE 279B,A00,494370,Wade; Jon P,0,0,33,33
1715619383263,AIP 97,001,660915,Van Den Einde; Yael Dahlia,9998,0,9999,1
1715619384295,AIP 197,001,627712,Vespa; Emanuel Ignacio,9995,0,9999,4
1715619384295,AIP 197,002,650778,Amir; On,9998,0,9999,1
1715619384295,AIP 197,003,650933,Avenancio-Leon; Carlos,9998,0,9999,1
1715619384295,AIP 197,004,658530,Heyman; Gail D.,9998,0,9999,1
1715619384295,AIP 197,005,658631,Neal; Sonya E,9998,0,9999,1
1715619384295,AIP 197,006,658671,Du; Songzi,9998,0,9999,1
1715619385320,ANAR 135S,A00,494369,Braswell; Geoffrey E.,0,0,0,0
1715619386346,BENG 196,001,628496,Engler; Adam J.,9998,0,9999,1
1715619386346,BENG 196,002,660916,Watson; John Thomas,9999,0,9999,0
1715619387377,BISP 197,001,650773,Wilhelm; James E.,9994,0,9999,5
1715619387377,BISP 197,002,658904,Coleman; Aaron B.,9998,0,9999,1
1715619388405,CAT 124RS,A01,519847,Geibel; William,0,0,20,20
1715619389433,CAT 125RS,A01,515971,Geibel; William,0,0,20,20
1715619390457,CLRE 250,A00,511389,Morris; Sheldon,9992,0,9999,7
1715619391487,CLRE 251,A00,507176,Mehta; Ravindra L.,9992,0,9999,7
1715619391487,CLRE 251,B00,511410,Mehta; Ravindra L.,9998,0,9999,1
1715619392511,CLRE 252,A00,507189,Cuomo; Raphael Eduardo,9994,0,9999,5
1715619393541,CLRE 253,A00,507199,Vaida; Florin,9994,0,9999,5
1715619393541,CLRE 253,B00,507202,Vaida; Florin,9999,0,9999,0
1715619394567,CLRE 259,A00,507211,Patel; Hemal,9996,0,9999,3
1715619395592,CLRE 260,A00,507221,Cuomo; Raphael Eduardo,9999,0,9999,0
1715619396621,CLRE 297,001,507242,Cuomo; Raphael Eduardo,9999,0,9999,0
1715619397648,COGS 197,001,638244,Voytek; Bradley Thomas,9997,0,9999,2
1715619398672,CSE 191,A00,516875,Minnes Kemp; Mor Mia,9991,0,9999,8
1715619399698,CSE 197,001,637388,Minnes Kemp; Mor Mia,9992,0,9999,7
1715619400724,CSS 201S,A01,494383,Mignozzetti; Umberto,35,0,35,0
1715619401749,CSS 202S,A01,494387,Mignozzetti; Umberto,35,0,35,0
1715619402785,DSC 197,001,628532,Eldridge; Justin Matthew,9995,0,9999,4
1715619403809,EAP 100,A00,516065,Staff,9799,0,9999,200
1715619404838,ECE 45,A01,507414,Staff,31,0,60,29
1715619406893,ECE 111,A01,507420,Staff,11,0,50,39
1715619407919,ECE 197,001,548057,Sievenpiper; Daniel F.,9991,0,9999,8
1715619408947,EDS 115,A00,507243,Choi; Bailey Miyeon,7,0,28,21
1715619409974,EDS 117,A01,494379,Staff,0,6,34,34
1715619411000,EDS 125,A00,507246,Hopkins; Megan Beth,8,0,30,22
1715619412029,EDS 128A,A01,507264,Fargason; Sharon Gayle,6,0,26,20
1715619413057,EDS 128B,A01,507293,Pappas; Elizabeth,10,0,30,20
1715619414084,EDS 139,A00,507294,Fargason; Sharon Gayle,10,0,30,20
1715619414084,EDS 139,B00,507313,Pappas; Elizabeth,11,0,30,19
1715619415112,EDS 201,A00,507315,Staff,10,0,30,20
1715619416139,EDS 203,A01,507317,Halter; Christopher P.,10,0,30,20
1715619417164,EDS 204R,A01,507319,Halter; Christopher P.,0,3,30,30
1715619417164,EDS 204R,B01,507331,Heinzman; Erica M.,14,0,30,16
1715619418188,EDS 206R,A00,507332,Staff,0,4,30,30
1715619418188,EDS 206R,B00,507343,Staff,15,0,30,15
1715619419213,EDS 250,A00,507344,Hemans; Patricia Ann Benitez,20,0,40,20
1715619420237,EDS 281,A00,507345,Daly; Alan J.,18,0,18,0
1715619421264,EDS 284,A00,507350,Daly; Alan J.,16,0,16,0
1715619422290,EDS 286,A00,507359,Fine; Sarah,18,0,18,0
1715619423317,EDS 289C,A01,507361,Daly; Alan J.,18,0,18,0
1715619424348,EDS 290,A00,507366,Hofstetter; Carolyn,15,0,15,0
1715619425379,LIGM 5A,A00,507421,Fischer-Grunski; Eva K,17,0,20,3
1715619426406,LIGM 5B,A00,507423,Fischer-Grunski; Eva K,19,0,20,1
1715619427433,LIGM 5C,A00,507425,Fischer-Grunski; Eva K,19,0,20,1
1715619428459,LIIT 5AS,A00,507427,Carnelos; Chiara,20,0,20,0
1715619429485,LIIT 5BS,A00,507430,Carnelos; Chiara,20,0,20,0
1715619430515,LIIT 5CS,A00,507432,Carnelos; Chiara,20,0,20,0
1715619431543,LISP 5A,A00,507541,Munoz Sanchez; Alicia,11,0,20,9
1715619432571,LISP 5B,A00,507671,Munoz Sanchez; Alicia,9,0,20,11
1715619433600,LISP 5C,A00,507696,Munoz Sanchez; Alicia,9,0,20,11
1715619434626,MAE 197,001,528363,Boechler; Nicholas Sebastia,9998,0,9999,1
1715619435651,MATH 197,001,523477,Kedlaya; Kiran S.,9994,0,9999,5
1715619435651,MATH 197,002,563811,Zhang; Danna,9994,0,9999,5
1715619435651,MATH 197,003,628552,Dumitriu; Ioana,9998,0,9999,1
1715619435651,MATH 197,004,660885,Floyd; Eric,9998,0,9999,1
1715619436677,MCWP 40R,A00,518780,Staff,2,0,20,18
1715619436677,MCWP 40R,B00,518781,Staff,11,0,20,9
1715619436677,MCWP 40R,C00,518783,Staff,5,0,20,15
1715619437702,MCWP 50R,A00,518791,Staff,0,1,20,20
1715619437702,MCWP 50R,B00,518792,Staff,0,2,20,20
1715619437702,MCWP 50R,C00,518793,Staff,0,4,20,20
1715619437702,MCWP 50R,D00,518794,Staff,0,1,20,20
1715619437702,MCWP 50R,E00,518795,Staff,0,2,20,20
1715619437702,MCWP 50R,F00,518796,Staff,0,1,20,20
1715619437702,MCWP 50R,G00,518797,Staff,0,1,20,20
1715619438729,MMW 12R,A01,514034,Herbst; Matthew,0,2,16,16
1715619438729,MMW 12R,A02,514035,Herbst; Matthew,0,0,16,16
1715619439758,MMW 13R,A01,514037,Staff,0,5,16,16
1715619439758,MMW 13R,A02,514039,Staff,0,5,16,16
1715619439758,MMW 13R,A03,628519,Staff,0,4,16,16
1715619441807,SIO 295LS,A00,523233,Staff,10,0,30,20
1715619442834,SIO 295S,A00,523232,Staff,10,0,30,20
1715619443870,SIOC 290S,A01,637330,Merrifield; Mark A,23,0,30,7
1715619444897,SIOC 291S,A01,637333,Gabriel; Corey John,23,0,30,7
1715619445922,SOCI 117,A01,494376,Staff,0,5,5,5
1715619446945,WES 237B,A00,494380,Staff,10,0,20,10
1715619449007,AESE 279B,A00,494370,Wade; Jon P,0,0,33,33
1715619450038,AIP 97,001,660915,Van Den Einde; Yael Dahlia,9998,0,9999,1
1715619451066,AIP 197,001,627712,Vespa; Emanuel Ignacio,9995,0,9999,4
1715619451066,AIP 197,002,650778,Amir; On,9998,0,9999,1
1715619451066,AIP 197,003,650933,Avenancio-Leon; Carlos,9998,0,9999,1
1715619451066,AIP 197,004,658530,Heyman; Gail D.,9998,0,9999,1
1715619451066,AIP 197,005,658631,Neal; Sonya E,9998,0,9999,1
1715619451066,AIP 197,006,658671,Du; Songzi,9998,0,9999,1
1715619452108,ANAR 135S,A00,494369,Braswell; Geoffrey E.,0,0,0,0
1715619453133,BENG 196,001,628496,Engler; Adam J.,9998,0,9999,1
1715619453133,BENG 196,002,660916,Watson; John Thomas,9999,0,9999,0
1715619454159,BISP 197,001,650773,Wilhelm; James E.,9994,0,9999,5
1715619454159,BISP 197,002,658904,Coleman; Aaron B.,9998,0,9999,1
1715619455186,CAT 124RS,A01,519847,Geibel; William,0,0,20,20
1715619456213,CAT 125RS,A01,515971,Geibel; William,0,0,20,20
1715619457238,CLRE 250,A00,511389,Morris; Sheldon,9992,0,9999,7
1715619458266,CLRE 251,A00,507176,Mehta; Ravindra L.,9992,0,9999,7
1715619458266,CLRE 251,B00,511410,Mehta; Ravindra L.,9998,0,9999,1
1715619459292,CLRE 252,A00,507189,Cuomo; Raphael Eduardo,9994,0,9999,5
1715619460318,CLRE 253,A00,507199,Vaida; Florin,9994,0,9999,5
1715619460318,CLRE 253,B00,507202,Vaida; Florin,9999,0,9999,0
1715619461342,CLRE 259,A00,507211,Patel; Hemal,9996,0,9999,3
1715619462369,CLRE 260,A00,507221,Cuomo; Raphael Eduardo,9999,0,9999,0
1715619463394,CLRE 297,001,507242,Cuomo; Raphael Eduardo,9999,0,9999,0
1715619464422,COGS 197,001,638244,Voytek; Bradley Thomas,9997,0,9999,2
1715619465448,CSE 191,A00,516875,Minnes Kemp; Mor Mia,9991,0,9999,8
1715619466473,CSE 197,001,637388,Minnes Kemp; Mor Mia,9992,0,9999,7
1715619467502,CSS 201S,A01,494383,Mignozzetti; Umberto,35,0,35,0
1715619468531,CSS 202S,A01,494387,Mignozzetti; Umberto,35,0,35,0
1715619469556,DSC 197,001,628532,Eldridge; Justin Matthew,9995,0,9999,4
1715619470582,EAP 100,A00,516065,Staff,9799,0,9999,200
1715619471609,ECE 45,A01,507414,Staff,31,0,60,29
1715619473659,ECE 111,A01,507420,Staff,11,0,50,39
1715619474683,ECE 197,001,548057,Sievenpiper; Daniel F.,9991,0,9999,8
1715619475710,EDS 115,A00,507243,Choi; Bailey Miyeon,7,0,28,21
1715619476734,EDS 117,A01,494379,Staff,0,6,34,34
1715619477758,EDS 125,A00,507246,Hopkins; Megan Beth,8,0,30,22
1715619478783,EDS 128A,A01,507264,Fargason; Sharon Gayle,6,0,26,20
1715619479811,EDS 128B,A01,507293,Pappas; Elizabeth,10,0,30,20
1715619480839,EDS 139,A00,507294,Fargason; Sharon Gayle,10,0,30,20
1715619480839,EDS 139,B00,507313,Pappas; Elizabeth,11,0,30,19
1715619481866,EDS 201,A00,507315,Staff,10,0,30,20
1715619482891,EDS 203,A01,507317,Halter; Christopher P.,10,0,30,20
1715619483918,EDS 204R,A01,507319,Halter; Christopher P.,0,3,30,30
1715619483918,EDS 204R,B01,507331,Heinzman; Erica M.,14,0,30,16
1715619484943,EDS 206R,A00,507332,Staff,0,4,30,30
1715619484943,EDS 206R,B00,507343,Staff,15,0,30,15
1715619485971,EDS 250,A00,507344,Hemans; Patricia Ann Benitez,20,0,40,20
1715619487001,EDS 281,A00,507345,Daly; Alan J.,18,0,18,0
1715619488028,EDS 284,A00,507350,Daly; Alan J.,16,0,16,0
1715619489057,EDS 286,A00,507359,Fine; Sarah,18,0,18,0
1715619490087,EDS 289C,A01,507361,Daly; Alan J.,18,0,18,0
1715619491114,EDS 290,A00,507366,Hofstetter; Carolyn,15,0,15,0
1715619492142,LIGM 5A,A00,507421,Fischer-Grunski; Eva K,17,0,20,3
1715619493169,LIGM 5B,A00,507423,Fischer-Grunski; Eva K,19,0,20,1
1715619494197,LIGM 5C,A00,507425,Fischer-Grunski; Eva K,19,0,20,1
1715619495227,LIIT 5AS,A00,507427,Carnelos; Chiara,20,0,20,0
1715619496258,LIIT 5BS,A00,507430,Carnelos; Chiara,20,0,20,0
1715619497286,LIIT 5CS,A00,507432,Carnelos; Chiara,20,0,20,0
1715619498312,LISP 5A,A00,507541,Munoz Sanchez; Alicia,11,0,20,9
1715619499338,LISP 5B,A00,507671,Munoz Sanchez; Alicia,9,0,20,11
1715619500363,LISP 5C,A00,507696,Munoz Sanchez; Alicia,9,0,20,11
1715619501387,MAE 197,001,528363,Boechler; Nicholas Sebastia,9998,0,9999,1
1715619502411,MATH 197,001,523477,Kedlaya; Kiran S.,9994,0,9999,5
1715619502411,MATH 197,002,563811,Zhang; Danna,9994,0,9999,5
1715619502411,MATH 197,003,628552,Dumitriu; Ioana,9998,0,9999,1
1715619502411,MATH 197,004,660885,Floyd; Eric,9998,0,9999,1
1715619503438,MCWP 40R,A00,518780,Staff,2,0,20,18
1715619503438,MCWP 40R,B00,518781,Staff,11,0,20,9
1715619503438,MCWP 40R,C00,518783,Staff,5,0,20,15
1715619504468,MCWP 50R,A00,518791,Staff,0,1,20,20
1715619504468,MCWP 50R,B00,518792,Staff,0,2,20,20
1715619504468,MCWP 50R,C00,518793,Staff,0,4,20,20
1715619504468,MCWP 50R,D00,518794,Staff,0,1,20,20
1715619504468,MCWP 50R,E00,518795,Staff,0,2,20,20
1715619504468,MCWP 50R,F00,518796,Staff,0,1,20,20
1715619504468,MCWP 50R,G00,518797,Staff,0,1,20,20
1715619505494,MMW 12R,A01,514034,Herbst; Matthew,0,2,16,16
1715619505494,MMW 12R,A02,514035,Herbst; Matthew,0,0,16,16
1715619506519,MMW 13R,A01,514037,Staff,0,5,16,16
1715619506519,MMW 13R,A02,514039,Staff,0,5,16,16
1715619506519,MMW 13R,A03,628519,Staff,0,4,16,16
1715619508573,SIO 295LS,A00,523233,Staff,10,0,30,20
1715619509599,SIO 295S,A00,523232,Staff,10,0,30,20
1715619510628,SIOC 290S,A01,637330,Merrifield; Mark A,23,0,30,7
1715619511657,SIOC 291S,A01,637333,Gabriel; Corey John,23,0,30,7
1715619512687,SOCI 117,A01,494376,Staff,0,5,5,5
1715619513714,WES 237B,A00,494380,Staff,10,0,20,10
1715619515785,AESE 279B,A00,494370,Wade; Jon P,0,0,33,33
1715619516810,AIP 97,001,660915,Van Den Einde; Yael Dahlia,9998,0,9999,1
1715619517841,AIP 197,001,627712,Vespa; Emanuel Ignacio,9995,0,9999,4
1715619517841,AIP 197,002,650778,Amir; On,9998,0,9999,1
1715619517841,AIP 197,003,650933,Avenancio-Leon; Carlos,9998,0,9999,1
1715619517841,AIP 197,004,658530,Heyman; Gail D.,9998,0,9999,1
1715619517841,AIP 197,005,658631,Neal; Sonya E,9998,0,9999,1
1715619517841,AIP 197,006,658671,Du; Songzi,9998,0,9999,1
1715619518867,ANAR 135S,A00,494369,Braswell; Geoffrey E.,0,0,0,0
1715619519895,BENG 196,001,628496,Engler; Adam J.,9998,0,9999,1
1715619519895,BENG 196,002,660916,Watson; John Thomas,9999,0,9999,0
1715619520921,BISP 197,001,650773,Wilhelm; James E.,9994,0,9999,5
1715619520921,BISP 197,002,658904,Coleman; Aaron B.,9998,0,9999,1
1715619521953,CAT 124RS,A01,519847,Geibel; William,0,0,20,20
1715619522979,CAT 125RS,A01,515971,Geibel; William,0,0,20,20
1715619524006,CLRE 250,A00,511389,Morris; Sheldon,9992,0,9999,7
1715619525037,CLRE 251,A00,507176,Mehta; Ravindra L.,9992,0,9999,7
1715619525037,CLRE 251,B00,511410,Mehta; Ravindra L.,9998,0,9999,1
1715619526066,CLRE 252,A00,507189,Cuomo; Raphael Eduardo,9994,0,9999,5
1715619527092,CLRE 253,A00,507199,Vaida; Florin,9994,0,9999,5
1715619527092,CLRE 253,B00,507202,Vaida; Florin,9999,0,9999,0
1715619528117,CLRE 259,A00,507211,Patel; Hemal,9996,0,9999,3
1715619529143,CLRE 260,A00,507221,Cuomo; Raphael Eduardo,9999,0,9999,0
1715619530170,CLRE 297,001,507242,Cuomo; Raphael Eduardo,9999,0,9999,0
1715619531196,COGS 197,001,638244,Voytek; Bradley Thomas,9997,0,9999,2
1715619532222,CSE 191,A00,516875,Minnes Kemp; Mor Mia,9991,0,9999,8
1715619533248,CSE 197,001,637388,Minnes Kemp; Mor Mia,9992,0,9999,7
1715619534277,CSS 201S,A01,494383,Mignozzetti; Umberto,35,0,35,0
1715619535302,CSS 202S,A01,494387,Mignozzetti; Umberto,35,0,35,0
1715619536330,DSC 197,001,628532,Eldridge; Justin Matthew,9995,0,9999,4
1715619537353,EAP 100,A00,516065,Staff,9799,0,9999,200
1715619538383,ECE 45,A01,507414,Staff,31,0,60,29
1715619540438,ECE 111,A01,507420,Staff,11,0,50,39
1715619541469,ECE 197,001,548057,Sievenpiper; Daniel F.,9991,0,9999,8
1715619542496,EDS 115,A00,507243,Choi; Bailey Miyeon,7,0,28,21
1715619543525,EDS 117,A01,494379,Staff,0,6,34,34
1715619544550,EDS 125,A00,507246,Hopkins; Megan Beth,8,0,30,22
1715619545576,EDS 128A,A01,507264,Fargason; Sharon Gayle,6,0,26,20
1715619546604,EDS 128B,A01,507293,Pappas; Elizabeth,10,0,30,20
1715619547633,EDS 139,A00,507294,Fargason; Sharon Gayle,10,0,30,20
1715619547633,EDS 139,B00,507313,Pappas; Elizabeth,11,0,30,19
1715619548659,EDS 201,A00,507315,Staff,10,0,30,20
1715619549685,EDS 203,A01,507317,Halter; Christopher P.,10,0,30,20
1715619550710,EDS 204R,A01,507319,Halter; Christopher P.,0,3,30,30
1715619550710,EDS 204R,B01,507331,Heinzman; Erica M.,14,0,30,16
1715619551739,EDS 206R,A00,507332,Staff,0,4,30,30
1715619551739,EDS 206R,B00,507343,Staff,15,0,30,15
1715619552764,EDS 250,A00,507344,Hemans; Patricia Ann Benitez,20,0,40,20
1715619553790,EDS 281,A00,507345,Daly; Alan J.,18,0,18,0
1715619554817,EDS 284,A00,507350,Daly; Alan J.,16,0,16,0
1715619555845,EDS 286,A00,507359,Fine; Sarah,18,0,18,0
1715619556873,EDS 289C,A01,507361,Daly; Alan J.,18,0,18,0
1715619557899,EDS 290,A00,507366,Hofstetter; Carolyn,15,0,15,0
1715619558929,LIGM 5A,A00,507421,Fischer-Grunski; Eva K,17,0,20,3
1715619559954,LIGM 5B,A00,507423,Fischer-Grunski; Eva K,19,0,20,1
1715619560984,LIGM 5C,A00,507425,Fischer-Grunski; Eva K,19,0,20,1
1715619562009,LIIT 5AS,A00,507427,Carnelos; Chiara,20,0,20,0
1715619563036,LIIT 5BS,A00,507430,Carnelos; Chiara,20,0,20,0
1715619564066,LIIT 5CS,A00,507432,Carnelos; Chiara,20,0,20,0
1715619565095,LISP 5A,A00,507541,Munoz Sanchez; Alicia,11,0,20,9
1715619566121,LISP 5B,A00,507671,Munoz Sanchez; Alicia,9,0,20,11
1715619567146,LISP 5C,A00,507696,Munoz Sanchez; Alicia,9,0,20,11
1715619568171,MAE 197,001,528363,Boechler; Nicholas Sebastia,9998,0,9999,1
1715619569198,MATH 197,001,523477,Kedlaya; Kiran S.,9994,0,9999,5
1715619569198,MATH 197,002,563811,Zhang; Danna,9994,0,9999,5
1715619569198,MATH 197,003,628552,Dumitriu; Ioana,9998,0,9999,1
1715619569198,MATH 197,004,660885,Floyd; Eric,9998,0,9999,1
1715619570226,MCWP 40R,A00,518780,Staff,2,0,20,18
1715619570226,MCWP 40R,B00,518781,Staff,11,0,20,9
1715619570226,MCWP 40R,C00,518783,Staff,5,0,20,15
1715619571253,MCWP 50R,A00,518791,Staff,0,1,20,20
1715619571253,MCWP 50R,B00,518792,Staff,0,2,20,20
1715619571253,MCWP 50R,C00,518793,Staff,0,4,20,20
1715619571253,MCWP 50R,D00,518794,Staff,0,1,20,20
1715619571253,MCWP 50R,E00,518795,Staff,0,2,20,20
1715619571253,MCWP 50R,F00,518796,Staff,0,1,20,20
1715619571253,MCWP 50R,G00,518797,Staff,0,1,20,20
1715619572281,MMW 12R,A01,514034,Herbst; Matthew,0,2,16,16
1715619572281,MMW 12R,A02,514035,Herbst; Matthew,0,0,16,16
1715619573306,MMW 13R,A01,514037,Staff,0,5,16,16
1715619573306,MMW 13R,A02,514039,Staff,0,5,16,16
1715619573306,MMW 13R,A03,628519,Staff,0,4,16,16
1715619575357,SIO 295LS,A00,523233,Staff,10,0,30,20
1715619576385,SIO 295S,A00,523232,Staff,10,0,30,20
1715619577412,SIOC 290S,A01,637330,Merrifield; Mark A,23,0,30,7
1715619578438,SIOC 291S,A01,637333,Gabriel; Corey John,23,0,30,7
1715619579469,SOCI 117,A01,494376,Staff,0,5,5,5
1715619580496,WES 237B,A00,494380,Staff,10,0,20,10
1715619582557,AESE 279B,A00,494370,Wade; Jon P,0,0,33,33
1715619583583,AIP 97,001,660915,Van Den Einde; Yael Dahlia,9998,0,9999,1
1715619584609,AIP 197,001,627712,Vespa; Emanuel Ignacio,9995,0,9999,4
1715619584609,AIP 197,002,650778,Amir; On,9998,0,9999,1
1715619584609,AIP 197,003,650933,Avenancio-Leon; Carlos,9998,0,9999,1
1715619584609,AIP 197,004,658530,Heyman; Gail D.,9998,0,9999,1
1715619584609,AIP 197,005,658631,Neal; Sonya E,9998,0,9999,1
1715619584609,AIP 197,006,658671,Du; Songzi,9998,0,9999,1
1715619585639,ANAR 135S,A00,494369,Braswell; Geoffrey E.,0,0,0,0
1715619586668,BENG 196,001,628496,Engler; Adam J.,9998,0,9999,1
1715619586668,BENG 196,002,660916,Watson; John Thomas,9999,0,9999,0
1715619587698,BISP 197,001,650773,Wilhelm; James E.,9994,0,9999,5
1715619587698,BISP 197,002,658904,Coleman; Aaron B.,9998,0,9999,1
1715619588725,CAT 124RS,A01,519847,Geibel; William,0,0,20,20
1715619589750,CAT 125RS,A01,515971,Geibel; William,0,0,20,20
1715619590778,CLRE 250,A00,511389,Morris; Sheldon,9992,0,9999,7
1715619591860,CLRE 251,A00,507176,Mehta; Ravindra L.,9992,0,9999,7
1715619591860,CLRE 251,B00,511410,Mehta; Ravindra L.,9998,0,9999,1
1715619592887,CLRE 252,A00,507189,Cuomo; Raphael Eduardo,9994,0,9999,5
1715619593913,CLRE 253,A00,507199,Vaida; Florin,9994,0,9999,5
1715619593913,CLRE 253,B00,507202,Vaida; Florin,9999,0,9999,0
1715619594940,CLRE 259,A00,507211,Patel; Hemal,9996,0,9999,3
1715619595967,CLRE 260,A00,507221,Cuomo; Raphael Eduardo,9999,0,9999,0
1715619596996,CLRE 297,001,507242,Cuomo; Raphael Eduardo,9999,0,9999,0
1715619598022,COGS 197,001,638244,Voytek; Bradley Thomas,9997,0,9999,2
1715619599050,CSE 191,A00,516875,Minnes Kemp; Mor Mia,9991,0,9999,8
1715619600076,CSE 197,001,637388,Minnes Kemp; Mor Mia,9992,0,9999,7
1715619601103,CSS 201S,A01,494383,Mignozzetti; Umberto,35,0,35,0
1715619602134,CSS 202S,A01,494387,Mignozzetti; Umberto,35,0,35,0
1715619603160,DSC 197,001,628532,Eldridge; Justin Matthew,9995,0,9999,4
1715619604186,EAP 100,A00,516065,Staff,9799,0,9999,200
1715619605219,ECE 45,A01,507414,Staff,31,0,60,29
1715619607275,ECE 111,A01,507420,Staff,11,0,50,39
1715619608302,ECE 197,001,548057,Sievenpiper; Daniel F.,9991,0,9999,8
1715619609335,EDS 115,A00,507243,Choi; Bailey Miyeon,7,0,28,21
1715619610364,EDS 117,A01,494379,Staff,0,6,34,34
1715619611390,EDS 125,A00,507246,Hopkins; Megan Beth,8,0,30,22
1715619612420,EDS 128A,A01,507264,Fargason; Sharon Gayle,6,0,26,20
1715619613446,EDS 128B,A01,507293,Pappas; Elizabeth,10,0,30,20
1715619614471,EDS 139,A00,507294,Fargason; Sharon Gayle,10,0,30,20
1715619614471,EDS 139,B00,507313,Pappas; Elizabeth,11,0,30,19
1715619615496,EDS 201,A00,507315,Staff,10,0,30,20
1715619616523,EDS 203,A01,507317,Halter; Christopher P.,10,0,30,20
1715619617551,EDS 204R,A01,507319,Halter; Christopher P.,0,3,30,30
1715619617551,EDS 204R,B01,507331,Heinzman; Erica M.,14,0,30,16
1715619618575,EDS 206R,A00,507332,Staff,0,4,30,30
1715619618575,EDS 206R,B00,507343,Staff,15,0,30,15
1715619619600,EDS 250,A00,507344,Hemans; Patricia Ann Benitez,20,0,40,20
1715619620624,EDS 281,A00,507345,Daly; Alan J.,18,0,18,0
1715619621651,EDS 284,A00,507350,Daly; Alan J.,16,0,16,0
1715619622674,EDS 286,A00,507359,Fine; Sarah,18,0,18,0
1715619623699,EDS 289C,A01,507361,Daly; Alan J.,18,0,18,0
1715619624730,EDS 290,A00,507366,Hofstetter; Carolyn,15,0,15,0
1715619625756,LIGM 5A,A00,507421,Fischer-Grunski; Eva K,17,0,20,3
1715619626783,LIGM 5B,A00,507423,Fischer-Grunski; Eva K,19,0,20,1
1715619627807,LIGM 5C,A00,507425,Fischer-Grunski; Eva K,19,0,20,1
1715619628839,LIIT 5AS,A00,507427,Carnelos; Chiara,20,0,20,0
1715619629864,LIIT 5BS,A00,507430,Carnelos; Chiara,20,0,20,0
1715619630895,LIIT 5CS,A00,507432,Carnelos; Chiara,20,0,20,0
1715619631923,LISP 5A,A00,507541,Munoz Sanchez; Alicia,11,0,20,9
1715619632949,LISP 5B,A00,507671,Munoz Sanchez; Alicia,9,0,20,11
1715619633978,LISP 5C,A00,507696,Munoz Sanchez; Alicia,9,0,20,11
1715619635003,MAE 197,001,528363,Boechler; Nicholas Sebastia,9998,0,9999,1
1715619636030,MATH 197,001,523477,Kedlaya; Kiran S.,9994,0,9999,5
1715619636030,MATH 197,002,563811,Zhang; Danna,9994,0,9999,5
1715619636030,MATH 197,003,628552,Dumitriu; Ioana,9998,0,9999,1
1715619636030,MATH 197,004,660885,Floyd; Eric,9998,0,9999,1
1715619637057,MCWP 40R,A00,518780,Staff,2,0,20,18
1715619637057,MCWP 40R,B00,518781,Staff,11,0,20,9
1715619637057,MCWP 40R,C00,518783,Staff,5,0,20,15
1715619638083,MCWP 50R,A00,518791,Staff,0,1,20,20
1715619638083,MCWP 50R,B00,518792,Staff,0,2,20,20
1715619638083,MCWP 50R,C00,518793,Staff,0,4,20,20
1715619638083,MCWP 50R,D00,518794,Staff,0,1,20,20
1715619638083,MCWP 50R,E00,518795,Staff,0,2,20,20
1715619638083,MCWP 50R,F00,518796,Staff,0,1,20,20
1715619638083,MCWP 50R,G00,518797,Staff,0,1,20,20
1715619639110,MMW 12R,A01,514034,Herbst; Matthew,0,2,16,16
1715619639110,MMW 12R,A02,514035,Herbst; Matthew,0,0,16,16
1715619640140,MMW 13R,A01,514037,Staff,0,5,16,16
1715619640140,MMW 13R,A02,514039,Staff,0,5,16,16
1715619640140,MMW 13R,A03,628519,Staff,0,4,16,16
1715619642190,SIO 295LS,A00,523233,Staff,10,0,30,20
1715619643219,SIO 295S,A00,523232,Staff,10,0,30,20
1715619644244,SIOC 290S,A01,637330,Merrifield; Mark A,23,0,30,7
1715619645273,SIOC 291S,A01,637333,Gabriel; Corey John,23,0,30,7
1715619646301,SOCI 117,A01,494376,Staff,0,5,5,5
1715619647329,WES 237B,A00,494380,Staff,10,0,20,10
1715619649401,AESE 279B,A00,494370,Wade; Jon P,0,0,33,33
1715619650427,AIP 97,001,660915,Van Den Einde; Yael Dahlia,9998,0,9999,1
1715619651458,AIP 197,001,627712,Vespa; Emanuel Ignacio,9995,0,9999,4
1715619651458,AIP 197,002,650778,Amir; On,9998,0,9999,1
1715619651458,AIP 197,003,650933,Avenancio-Leon; Carlos,9998,0,9999,1
1715619651458,AIP 197,004,658530,Heyman; Gail D.,9998,0,9999,1
1715619651458,AIP 197,005,658631,Neal; Sonya E,9998,0,9999,1
1715619651458,AIP 197,006,658671,Du; Songzi,9998,0,9999,1
1715619652486,ANAR 135S,A00,494369,Braswell; Geoffrey E.,0,0,0,0
1715619653513,BENG 196,001,628496,Engler; Adam J.,9998,0,9999,1
1715619653513,BENG 196,002,660916,Watson; John Thomas,9999,0,9999,0
1715619654541,BISP 197,001,650773,Wilhelm; James E.,9994,0,9999,5
1715619654541,BISP 197,002,658904,Coleman; Aaron B.,9998,0,9999,1
1715619655567,CAT 124RS,A01,519847,Geibel; William,0,0,20,20
1715619656595,CAT 125RS,A01,515971,Geibel; William,0,0,20,20
1715619657620,CLRE 250,A00,511389,Morris; Sheldon,9992,0,9999,7
1715619658649,CLRE 251,A00,507176,Mehta; Ravindra L.,9992,0,9999,7
1715619658649,CLRE 251,B00,511410,Mehta; Ravindra L.,9998,0,9999,1
1715619659675,CLRE 252,A00,507189,Cuomo; Raphael Eduardo,9994,0,9999,5
1715619660709,CLRE 253,A00,507199,Vaida; Florin,9994,0,9999,5
1715619660709,CLRE 253,B00,507202,Vaida; Florin,9999,0,9999,0
1715619661735,CLRE 259,A00,507211,Patel; Hemal,9996,0,9999,3
1715619662763,CLRE 260,A00,507221,Cuomo; Raphael Eduardo,9999,0,9999,0
1715619663789,CLRE 297,001,507242,Cuomo; Raphael Eduardo,9999,0,9999,0
1715619664819,COGS 197,001,638244,Voytek; Bradley Thomas,9997,0,9999,2
1715619665849,CSE 191,A00,516875,Minnes Kemp; Mor Mia,9991,0,9999,8
1715619666875,CSE 197,001,637388,Minnes Kemp; Mor Mia,9992,0,9999,7
1715619667902,CSS 201S,A01,494383,Mignozzetti; Umberto,35,0,35,0
1715619668929,CSS 202S,A01,494387,Mignozzetti; Umberto,35,0,35,0
1715619669954,DSC 197,001,628532,Eldridge; Justin Matthew,9995,0,9999,4
1715619670978,EAP 100,A00,516065,Staff,9799,0,9999,200
1715619672004,ECE 45,A01,507414,Staff,31,0,60,29
1715619674058,ECE 111,A01,507420,Staff,11,0,50,39
1715619675084,ECE 197,001,548057,Sievenpiper; Daniel F.,9991,0,9999,8
1715619676110,EDS 115,A00,507243,Choi; Bailey Miyeon,7,0,28,21
1715619677135,EDS 117,A01,494379,Staff,0,6,34,34
1715619678164,EDS 125,A00,507246,Hopkins; Megan Beth,8,0,30,22
1715619679195,EDS 128A,A01,507264,Fargason; Sharon Gayle,6,0,26,20
1715619680222,EDS 128B,A01,507293,Pappas; Elizabeth,10,0,30,20
1715619681247,EDS 139,A00,507294,Fargason; Sharon Gayle,10,0,30,20
1715619681247,EDS 139,B00,507313,Pappas; Elizabeth,11,0,30,19
1715619682273,EDS 201,A00,507315,Staff,10,0,30,20
1715619683299,EDS 203,A01,507317,Halter; Christopher P.,10,0,30,20
1715619684327,EDS 204R,A01,507319,Halter; Christopher P.,0,3,30,30
1715619684327,EDS 204R,B01,507331,Heinzman; Erica M.,14,0,30,16
1715619685352,EDS 206R,A00,507332,Staff,0,4,30,30
1715619685352,EDS 206R,B00,507343,Staff,15,0,30,15
1715619686378,EDS 250,A00,507344,Hemans; Patricia Ann Benitez,20,0,40,20
1715619687403,EDS 281,A00,507345,Daly; Alan J.,18,0,18,0
1715619688431,EDS 284,A00,507350,Daly; Alan J.,16,0,16,0
1715619689459,EDS 286,A00,507359,Fine; Sarah,18,0,18,0
1715619690484,EDS 289C,A01,507361,Daly; Alan J.,18,0,18,0
1715619691513,EDS 290,A00,507366,Hofstetter; Carolyn,15,0,15,0
1715619692546,LIGM 5A,A00,507421,Fischer-Grunski; Eva K,17,0,20,3
1715619693576,LIGM 5B,A00,507423,Fischer-Grunski; Eva K,19,0,20,1
1715619694604,LIGM 5C,A00,507425,Fischer-Grunski; Eva K,19,0,20,1
1715619695633,LIIT 5AS,A00,507427,Carnelos; Chiara,20,0,20,0
1715619696658,LIIT 5BS,A00,507430,Carnelos; Chiara,20,0,20,0
1715619697683,LIIT 5CS,A00,507432,Carnelos; Chiara,20,0,20,0
1715619698713,LISP 5A,A00,507541,Munoz Sanchez; Alicia,11,0,20,9
1715619699740,LISP 5B,A00,507671,Munoz Sanchez; Alicia,9,0,20,11
1715619700766,LISP 5C,A00,507696,Munoz Sanchez; Alicia,9,0,20,11
1715619701791,MAE 197,001,528363,Boechler; Nicholas Sebastia,9998,0,9999,1
1715619702821,MATH 197,001,523477,Kedlaya; Kiran S.,9994,0,9999,5
1715619702821,MATH 197,002,563811,Zhang; Danna,9994,0,9999,5
1715619702821,MATH 197,003,628552,Dumitriu; Ioana,9998,0,9999,1
1715619702821,MATH 197,004,660885,Floyd; Eric,9998,0,9999,1
1715619703847,MCWP 40R,A00,518780,Staff,2,0,20,18
1715619703847,MCWP 40R,B00,518781,Staff,11,0,20,9
1715619703847,MCWP 40R,C00,518783,Staff,5,0,20,15
1715619704877,MCWP 50R,A00,518791,Staff,0,1,20,20
1715619704877,MCWP 50R,B00,518792,Staff,0,2,20,20
1715619704877,MCWP 50R,C00,518793,Staff,0,4,20,20
1715619704877,MCWP 50R,D00,518794,Staff,0,1,20,20
1715619704877,MCWP 50R,E00,518795,Staff,0,2,20,20
1715619704877,MCWP 50R,F00,518796,Staff,0,1,20,20
1715619704877,MCWP 50R,G00,518797,Staff,0,1,20,20
1715619705902,MMW 12R,A01,514034,Herbst; Matthew,0,2,16,16
1715619705902,MMW 12R,A02,514035,Herbst; Matthew,0,0,16,16
1715619706927,MMW 13R,A01,514037,Staff,0,5,16,16
1715619706927,MMW 13R,A02,514039,Staff,0,5,16,16
1715619706927,MMW 13R,A03,628519,Staff,0,4,16,16
1715619708982,SIO 295LS,A00,523233,Staff,10,0,30,20
1715619710008,SIO 295S,A00,523232,Staff,10,0,30,20
1715619711041,SIOC 290S,A01,637330,Merrifield; Mark A,23,0,30,7
1715619712065,SIOC 291S,A01,637333,Gabriel; Corey John,23,0,30,7
1715619713093,SOCI 117,A01,494376,Staff,0,5,5,5
1715619714116,WES 237B,A00,494380,Staff,10,0,20,10
1715619716200,AESE 279B,A00,494370,Wade; Jon P,0,0,33,33
1715619717224,AIP 97,001,660915,Van Den Einde; Yael Dahlia,9998,0,9999,1
1715619718250,AIP 197,001,627712,Vespa; Emanuel Ignacio,9995,0,9999,4
1715619718250,AIP 197,002,650778,Amir; On,9998,0,9999,1
1715619718250,AIP 197,003,650933,Avenancio-Leon; Carlos,9998,0,9999,1
1715619718250,AIP 197,004,658530,Heyman; Gail D.,9998,0,9999,1
1715619718250,AIP 197,005,658631,Neal; Sonya E,9998,0,9999,1
1715619718250,AIP 197,006,658671,Du; Songzi,9998,0,9999,1
1715619719281,ANAR 135S,A00,494369,Braswell; Geoffrey E.,0,0,0,0
1715619720306,BENG 196,001,628496,Engler; Adam J.,9998,0,9999,1
1715619720306,BENG 196,002,660916,Watson; John Thomas,9999,0,9999,0
1715619721332,BISP 197,001,650773,Wilhelm; James E.,9994,0,9999,5
1715619721332,BISP 197,002,658904,Coleman; Aaron B.,9998,0,9999,1
1715619722358,CAT 124RS,A01,519847,Geibel; William,0,0,20,20
1715619723384,CAT 125RS,A01,515971,Geibel; William,0,0,20,20
1715619724431,CLRE 250,A00,511389,Morris; Sheldon,9992,0,9999,7
1715619725462,CLRE 251,A00,507176,Mehta; Ravindra L.,9992,0,9999,7
1715619725462,CLRE 251,B00,511410,Mehta; Ravindra L.,9998,0,9999,1
1715619726486,CLRE 252,A00,507189,Cuomo; Raphael Eduardo,9994,0,9999,5
1715619727512,CLRE 253,A00,507199,Vaida; Florin,9994,0,9999,5
1715619727512,CLRE 253,B00,507202,Vaida; Florin,9999,0,9999,0
1715619728546,CLRE 259,A00,507211,Patel; Hemal,9996,0,9999,3
1715619729570,CLRE 260,A00,507221,Cuomo; Raphael Eduardo,9999,0,9999,0
1715619730597,CLRE 297,001,507242,Cuomo; Raphael Eduardo,9999,0,9999,0
1715619731627,COGS 197,001,638244,Voytek; Bradley Thomas,9997,0,9999,2
1715619732656,CSE 191,A00,516875,Minnes Kemp; Mor Mia,9991,0,9999,8
1715619733682,CSE 197,001,637388,Minnes Kemp; Mor Mia,9992,0,9999,7
1715619734712,CSS 201S,A01,494383,Mignozzetti; Umberto,35,0,35,0
1715619735738,CSS 202S,A01,494387,Mignozzetti; Umberto,35,0,35,0
1715619736763,DSC 197,001,628532,Eldridge; Justin Matthew,9995,0,9999,4
1715619737790,EAP 100,A00,516065,Staff,9799,0,9999,200
1715619738819,ECE 45,A01,507414,Staff,31,0,60,29
1715619740873,ECE 111,A01,507420,Staff,11,0,50,39
1715619741900,ECE 197,001,548057,Sievenpiper; Daniel F.,9991,0,9999,8
1715619742928,EDS 115,A00,507243,Choi; Bailey Miyeon,7,0,28,21
1715619743956,EDS 117,A01,494379,Staff,0,6,34,34
1715619744997,EDS 125,A00,507246,Hopkins; Megan Beth,8,0,30,22
1715619746027,EDS 128A,A01,507264,Fargason; Sharon Gayle,6,0,26,20
1715619747052,EDS 128B,A01,507293,Pappas; Elizabeth,10,0,30,20
1715619748080,EDS 139,A00,507294,Fargason; Sharon Gayle,10,0,30,20
1715619748080,EDS 139,B00,507313,Pappas; Elizabeth,11,0,30,19
1715619749109,EDS 201,A00,507315,Staff,10,0,30,20
1715619750139,EDS 203,A01,507317,Halter; Christopher P.,10,0,30,20
1715619751165,EDS 204R,A01,507319,Halter; Christopher P.,0,3,30,30
1715619751165,EDS 204R,B01,507331,Heinzman; Erica M.,14,0,30,16
1715619752190,EDS 206R,A00,507332,Staff,0,4,30,30
1715619752190,EDS 206R,B00,507343,Staff,15,0,30,15
1715619753216,EDS 250,A00,507344,Hemans; Patricia Ann Benitez,20,0,40,20
1715619754243,EDS 281,A00,507345,Daly; Alan J.,18,0,18,0
1715619755268,EDS 284,A00,507350,Daly; Alan J.,16,0,16,0
1715619756295,EDS 286,A00,507359,Fine; Sarah,18,0,18,0
1715619757323,EDS 289C,A01,507361,Daly; Alan J.,18,0,18,0
1715619758348,EDS 290,A00,507366,Hofstetter; Carolyn,15,0,15,0
1715619759376,LIGM 5A,A00,507421,Fischer-Grunski; Eva K,17,0,20,3
1715619760405,LIGM 5B,A00,507423,Fischer-Grunski; Eva K,19,0,20,1
1715619761430,LIGM 5C,A00,507425,Fischer-Grunski; Eva K,19,0,20,1
1715619762454,LIIT 5AS,A00,507427,Carnelos; Chiara,20,0,20,0
1715619763482,LIIT 5BS,A00,507430,Carnelos; Chiara,20,0,20,0
1715619764507,LIIT 5CS,A00,507432,Carnelos; Chiara,20,0,20,0
1715619765536,LISP 5A,A00,507541,Munoz Sanchez; Alicia,11,0,20,9
1715619766560,LISP 5B,A00,507671,Munoz Sanchez; Alicia,9,0,20,11
1715619767587,LISP 5C,A00,507696,Munoz Sanchez; Alicia,9,0,20,11
1715619768612,MAE 197,001,528363,Boechler; Nicholas Sebastia,9998,0,9999,1
1715619769645,MATH 197,001,523477,Kedlaya; Kiran S.,9994,0,9999,5
1715619769645,MATH 197,002,563811,Zhang; Danna,9994,0,9999,5
1715619769645,MATH 197,003,628552,Dumitriu; Ioana,9998,0,9999,1
1715619769645,MATH 197,004,660885,Floyd; Eric,9998,0,9999,1
1715619770671,MCWP 40R,A00,518780,Staff,2,0,20,18
1715619770671,MCWP 40R,B00,518781,Staff,11,0,20,9
1715619770671,MCWP 40R,C00,518783,Staff,5,0,20,15
1715619771700,MCWP 50R,A00,518791,Staff,0,1,20,20
1715619771700,MCWP 50R,B00,518792,Staff,0,2,20,20
1715619771700,MCWP 50R,C00,518793,Staff,0,4,20,20
1715619771700,MCWP 50R,D00,518794,Staff,0,1,20,20
1715619771700,MCWP 50R,E00,518795,Staff,0,2,20,20
1715619771700,MCWP 50R,F00,518796,Staff,0,1,20,20
1715619771700,MCWP 50R,G00,518797,Staff,0,1,20,20
1715619772727,MMW 12R,A01,514034,Herbst; Matthew,0,2,16,16
1715619772727,MMW 12R,A02,514035,Herbst; Matthew,0,0,16,16
1715619773755,MMW 13R,A01,514037,Staff,0,5,16,16
1715619773755,MMW 13R,A02,514039,Staff,0,5,16,16
1715619773755,MMW 13R,A03,628519,Staff,0,4,16,16
1715619775809,SIO 295LS,A00,523233,Staff,10,0,30,20
1715619776834,SIO 295S,A00,523232,Staff,10,0,30,20
1715619777864,SIOC 290S,A01,637330,Merrifield; Mark A,23,0,30,7
1715619778889,SIOC 291S,A01,637333,Gabriel; Corey John,23,0,30,7
1715619779916,SOCI 117,A01,494376,Staff,0,5,5,5
1715619780944,WES 237B,A00,494380,Staff,10,0,20,10
1715619783001,AESE 279B,A00,494370,Wade; Jon P,0,0,33,33
1715619784029,AIP 97,001,660915,Van Den Einde; Yael Dahlia,9998,0,9999,1
1715619785056,AIP 197,001,627712,Vespa; Emanuel Ignacio,9995,0,9999,4
1715619785056,AIP 197,002,650778,Amir; On,9998,0,9999,1
1715619785056,AIP 197,003,650933,Avenancio-Leon; Carlos,9998,0,9999,1
1715619785056,AIP 197,004,658530,Heyman; Gail D.,9998,0,9999,1
1715619785056,AIP 197,005,658631,Neal; Sonya E,9998,0,9999,1
1715619785056,AIP 197,006,658671,Du; Songzi,9998,0,9999,1
1715619786082,ANAR 135S,A00,494369,Braswell; Geoffrey E.,0,0,0,0
1715619787107,BENG 196,001,628496,Engler; Adam J.,9998,0,9999,1
1715619787107,BENG 196,002,660916,Watson; John Thomas,9999,0,9999,0
1715619788138,BISP 197,001,650773,Wilhelm; James E.,9994,0,9999,5
1715619788138,BISP 197,002,658904,Coleman; Aaron B.,9998,0,9999,1
1715619789163,CAT 124RS,A01,519847,Geibel; William,0,0,20,20
1715619790191,CAT 125RS,A01,515971,Geibel; William,0,0,20,20
1715619791217,CLRE 250,A00,511389,Morris; Sheldon,9992,0,9999,7
1715619792243,CLRE 251,A00,507176,Mehta; Ravindra L.,9992,0,9999,7
1715619792243,CLRE 251,B00,511410,Mehta; Ravindra L.,9998,0,9999,1
1715619793273,CLRE 252,A00,507189,Cuomo; Raphael Eduardo,9994,0,9999,5
1715619794298,CLRE 253,A00,507199,Vaida; Florin,9994,0,9999,5
1715619794298,CLRE 253,B00,507202,Vaida; Florin,9999,0,9999,0
1715619795326,CLRE 259,A00,507211,Patel; Hemal,9996,0,9999,3
1715619796351,CLRE 260,A00,507221,Cuomo; Raphael Eduardo,9999,0,9999,0
1715619797379,CLRE 297,001,507242,Cuomo; Raphael Eduardo,9999,0,9999,0
1715619798405,COGS 197,001,638244,Voytek; Bradley Thomas,9997,0,9999,2
1715619799430,CSE 191,A00,516875,Minnes Kemp; Mor Mia,9991,0,9999,8
1715619800455,CSE 197,001,637388,Minnes Kemp; Mor Mia,9992,0,9999,7
1715619801486,CSS 201S,A01,494383,Mignozzetti; Umberto,35,0,35,0
1715619802511,CSS 202S,A01,494387,Mignozzetti; Umberto,35,0,35,0
1715619803540,DSC 197,001,628532,Eldridge; Justin Matthew,9995,0,9999,4
1715619804567,EAP 100,A00,516065,Staff,9799,0,9999,200
1715619805595,ECE 45,A01,507414,Staff,31,0,60,29
1715619807648,ECE 111,A01,507420,Staff,11,0,50,39
1715619808674,ECE 197,001,548057,Sievenpiper; Daniel F.,9991,0,9999,8
1715619809700,EDS 115,A00,507243,Choi; Bailey Miyeon,7,0,28,21
1715619810729,EDS 117,A01,494379,Staff,0,6,34,34
1715619811755,EDS 125,A00,507246,Hopkins; Megan Beth,8,0,30,22
1715619812781,EDS 128A,A01,507264,Fargason; Sharon Gayle,6,0,26,20
1715619813809,EDS 128B,A01,507293,Pappas; Elizabeth,10,0,30,20
1715619814835,EDS 139,A00,507294,Fargason; Sharon Gayle,10,0,30,20
1715619814835,EDS 139,B00,507313,Pappas; Elizabeth,11,0,30,19
1715619815861,EDS 201,A00,507315,Staff,10,0,30,20
1715619816887,EDS 203,A01,507317,Halter; Christopher P.,10,0,30,20
1715619817914,EDS 204R,A01,507319,Halter; Christopher P.,0,3,30,30
1715619817914,EDS 204R,B01,507331,Heinzman; Erica M.,14,0,30,16
1715619818940,EDS 206R,A00,507332,Staff,0,4,30,30
1715619818940,EDS 206R,B00,507343,Staff,15,0,30,15
1715619819969,EDS 250,A00,507344,Hemans; Patricia Ann Benitez,20,0,40,20
1715619820995,EDS 281,A00,507345,Daly; Alan J.,18,0,18,0
1715619822025,EDS 284,A00,507350,Daly; Alan J.,16,0,16,0
1715619823053,EDS 286,A00,507359,Fine; Sarah,18,0,18,0
1715619824081,EDS 289C,A01,507361,Daly; Alan J.,18,0,18,0
1715619825106,EDS 290,A00,507366,Hofstetter; Carolyn,15,0,15,0
1715619826131,LIGM 5A,A00,507421,Fischer-Grunski; Eva K,17,0,20,3
1715619827161,LIGM 5B,A00,507423,Fischer-Grunski; Eva K,19,0,20,1
1715619828187,LIGM 5C,A00,507425,Fischer-Grunski; Eva K,19,0,20,1
1715619829217,LIIT 5AS,A00,507427,Carnelos; Chiara,20,0,20,0
1715619830245,LIIT 5BS,A00,507430,Carnelos; Chiara,20,0,20,0
1715619831275,LIIT 5CS,A00,507432,Carnelos; Chiara,20,0,20,0
1715619832301,LISP 5A,A00,507541,Munoz Sanchez; Alicia,11,0,20,9
1715619833331,LISP 5B,A00,507671,Munoz Sanchez; Alicia,9,0,20,11
1715619834358,LISP 5C,A00,507696,Munoz Sanchez; Alicia,9,0,20,11
1715619835386,MAE 197,001,528363,Boechler; Nicholas Sebastia,9998,0,9999,1
1715619836412,MATH 197,001,523477,Kedlaya; Kiran S.,9994,0,9999,5
1715619836412,MATH 197,002,563811,Zhang; Danna,9994,0,9999,5
1715619836412,MATH 197,003,628552,Dumitriu; Ioana,9998,0,9999,1
1715619836412,MATH 197,004,660885,Floyd; Eric,9998,0,9999,1
1715619837438,MCWP 40R,A00,518780,Staff,2,0,20,18
1715619837438,MCWP 40R,B00,518781,Staff,11,0,20,9
1715619837438,MCWP 40R,C00,518783,Staff,5,0,20,15
1715619838463,MCWP 50R,A00,518791,Staff,0,1,20,20
1715619838463,MCWP 50R,B00,518792,Staff,0,2,20,20
1715619838463,MCWP 50R,C00,518793,Staff,0,4,20,20
1715619838463,MCWP 50R,D00,518794,Staff,0,1,20,20
1715619838463,MCWP 50R,E00,518795,Staff,0,2,20,20
1715619838463,MCWP 50R,F00,518796,Staff,0,1,20,20
1715619838463,MCWP 50R,G00,518797,Staff,0,1,20,20
1715619839490,MMW 12R,A01,514034,Herbst; Matthew,0,2,16,16
1715619839490,MMW 12R,A02,514035,Herbst; Matthew,0,0,16,16
1715619840518,MMW 13R,A01,514037,Staff,0,5,16,16
1715619840518,MMW 13R,A02,514039,Staff,0,5,16,16
1715619840518,MMW 13R,A03,628519,Staff,0,4,16,16
1715619842574,SIO 295LS,A00,523233,Staff,10,0,30,20
1715619843604,SIO 295S,A00,523232,Staff,10,0,30,20
1715619844637,SIOC 290S,A01,637330,Merrifield; Mark A,23,0,30,7
1715619845663,SIOC 291S,A01,637333,Gabriel; Corey John,23,0,30,7
1715619846687,SOCI 117,A01,494376,Staff,0,5,5,5
1715619847715,WES 237B,A00,494380,Staff,10,0,20,10
1715619849794,AESE 279B,A00,494370,Wade; Jon P,0,0,33,33
1715619850824,AIP 97,001,660915,Van Den Einde; Yael Dahlia,9998,0,9999,1
1715619851854,AIP 197,001,627712,Vespa; Emanuel Ignacio,9995,0,9999,4
1715619851854,AIP 197,002,650778,Amir; On,9998,0,9999,1
1715619851854,AIP 197,003,650933,Avenancio-Leon; Carlos,9998,0,9999,1
1715619851854,AIP 197,004,658530,Heyman; Gail D.,9998,0,9999,1
1715619851854,AIP 197,005,658631,Neal; Sonya E,9998,0,9999,1
1715619851854,AIP 197,006,658671,Du; Songzi,9998,0,9999,1
1715619852885,ANAR 135S,A00,494369,Braswell; Geoffrey E.,0,0,0,0
1715619853914,BENG 196,001,628496,Engler; Adam J.,9998,0,9999,1
1715619853914,BENG 196,002,660916,Watson; John Thomas,9999,0,9999,0
1715619854942,BISP 197,001,650773,Wilhelm; James E.,9994,0,9999,5
1715619854942,BISP 197,002,658904,Coleman; Aaron B.,9998,0,9999,1
1715619855970,CAT 124RS,A01,519847,Geibel; William,0,0,20,20
1715619856996,CAT 125RS,A01,515971,Geibel; William,0,0,20,20
1715619858021,CLRE 250,A00,511389,Morris; Sheldon,9992,0,9999,7
1715619859048,CLRE 251,A00,507176,Mehta; Ravindra L.,9992,0,9999,7
1715619859048,CLRE 251,B00,511410,Mehta; Ravindra L.,9998,0,9999,1
1715619860075,CLRE 252,A00,507189,Cuomo; Raphael Eduardo,9994,0,9999,5
1715619861110,CLRE 253,A00,507199,Vaida; Florin,9994,0,9999,5
1715619861110,CLRE 253,B00,507202,Vaida; Florin,9999,0,9999,0
1715619862136,CLRE 259,A00,507211,Patel; Hemal,9996,0,9999,3
1715619863216,CLRE 260,A00,507221,Cuomo; Raphael Eduardo,9999,0,9999,0
1715619864241,CLRE 297,001,507242,Cuomo; Raphael Eduardo,9999,0,9999,0
1715619865268,COGS 197,001,638244,Voytek; Bradley Thomas,9997,0,9999,2
1715619866294,CSE 191,A00,516875,Minnes Kemp; Mor Mia,9991,0,9999,8
1715619867321,CSE 197,001,637388,Minnes Kemp; Mor Mia,9992,0,9999,7
1715619868351,CSS 201S,A01,494383,Mignozzetti; Umberto,35,0,35,0
1715619869382,CSS 202S,A01,494387,Mignozzetti; Umberto,35,0,35,0
1715619870407,DSC 197,001,628532,Eldridge; Justin Matthew,9995,0,9999,4
1715619871435,EAP 100,A00,516065,Staff,9799,0,9999,200
1715619872462,ECE 45,A01,507414,Staff,31,0,60,29
1715619874515,ECE 111,A01,507420,Staff,11,0,50,39
1715619875541,ECE 197,001,548057,Sievenpiper; Daniel F.,9991,0,9999,8
1715619876567,EDS 115,A00,507243,Choi; Bailey Miyeon,7,0,28,21
1715619877593,EDS 117,A01,494379,Staff,0,6,34,34
1715619878622,EDS 125,A00,507246,Hopkins; Megan Beth,8,0,30,22
1715619879648,EDS 128A,A01,507264,Fargason; Sharon Gayle,6,0,26,20
1715619880678,EDS 128B,A01,507293,Pappas; Elizabeth,10,0,30,20
1715619881704,EDS 139,A00,507294,Fargason; Sharon Gayle,10,0,30,20
1715619881704,EDS 139,B00,507313,Pappas; Elizabeth,11,0,30,19
1715619882734,EDS 201,A00,507315,Staff,10,0,30,20
1715619883761,EDS 203,A01,507317,Halter; Christopher P.,10,0,30,20
1715619884787,EDS 204R,A01,507319,Halter; Christopher P.,0,3,30,30
1715619884787,EDS 204R,B01,507331,Heinzman; Erica M.,14,0,30,16
1715619885814,EDS 206R,A00,507332,Staff,0,4,30,30
1715619885814,EDS 206R,B00,507343,Staff,15,0,30,15
1715619886842,EDS 250,A00,507344,Hemans; Patricia Ann Benitez,20,0,40,20
1715619887870,EDS 281,A00,507345,Daly; Alan J.,18,0,18,0
1715619888898,EDS 284,A00,507350,Daly; Alan J.,16,0,16,0
1715619889922,EDS 286,A00,507359,Fine; Sarah,18,0,18,0
1715619890948,EDS 289C,A01,507361,Daly; Alan J.,18,0,18,0
1715619891973,EDS 290,A00,507366,Hofstetter; Carolyn,15,0,15,0
1715619892997,LIGM 5A,A00,507421,Fischer-Grunski; Eva K,17,0,20,3
1715619894025,LIGM 5B,A00,507423,Fischer-Grunski; Eva K,19,0,20,1
1715619895056,LIGM 5C,A00,507425,Fischer-Grunski; Eva K,19,0,20,1
1715619896084,LIIT 5AS,A00,507427,Carnelos; Chiara,20,0,20,0
1715619897109,LIIT 5BS,A00,507430,Carnelos; Chiara,20,0,20,0
1715619898134,LIIT 5CS,A00,507432,Carnelos; Chiara,20,0,20,0
1715619899162,LISP 5A,A00,507541,Munoz Sanchez; Alicia,11,0,20,9
1715619900191,LISP 5B,A00,507671,Munoz Sanchez; Alicia,9,0,20,11
1715619901216,LISP 5C,A00,507696,Munoz Sanchez; Alicia,9,0,20,11
1715619902240,MAE 197,001,528363,Boechler; Nicholas Sebastia,9998,0,9999,1
1715619903271,MATH 197,001,523477,Kedlaya; Kiran S.,9994,0,9999,5
1715619903271,MATH 197,002,563811,Zhang; Danna,9994,0,9999,5
1715619903271,MATH 197,003,628552,Dumitriu; Ioana,9998,0,9999,1
1715619903271,MATH 197,004,660885,Floyd; Eric,9998,0,9999,1
1715619904305,MCWP 40R,A00,518780,Staff,2,0,20,18
1715619904305,MCWP 40R,B00,518781,Staff,11,0,20,9
1715619904305,MCWP 40R,C00,518783,Staff,5,0,20,15
1715619905334,MCWP 50R,A00,518791,Staff,0,1,20,20
1715619905334,MCWP 50R,B00,518792,Staff,0,2,20,20
1715619905334,MCWP 50R,C00,518793,Staff,0,4,20,20
1715619905334,MCWP 50R,D00,518794,Staff,0,1,20,20
1715619905334,MCWP 50R,E00,518795,Staff,0,2,20,20
1715619905334,MCWP 50R,F00,518796,Staff,0,1,20,20
1715619905334,MCWP 50R,G00,518797,Staff,0,1,20,20
1715619906362,MMW 12R,A01,514034,Herbst; Matthew,0,2,16,16
1715619906362,MMW 12R,A02,514035,Herbst; Matthew,0,0,16,16
1715619907387,MMW 13R,A01,514037,Staff,0,5,16,16
1715619907387,MMW 13R,A02,514039,Staff,0,5,16,16
1715619907387,MMW 13R,A03,628519,Staff,0,4,16,16
1715619909438,SIO 295LS,A00,523233,Staff,10,0,30,20
1715619910465,SIO 295S,A00,523232,Staff,10,0,30,20
1715619911493,SIOC 290S,A01,637330,Merrifield; Mark A,23,0,30,7
1715619912519,SIOC 291S,A01,637333,Gabriel; Corey John,23,0,30,7
1715619913545,SOCI 117,A01,494376,Staff,0,5,5,5
1715619914573,WES 237B,A00,494380,Staff,10,0,20,10
1715619916646,AESE 279B,A00,494370,Wade; Jon P,0,0,33,33
1715619917675,AIP 97,001,660915,Van Den Einde; Yael Dahlia,9998,0,9999,1
1715619918702,AIP 197,001,627712,Vespa; Emanuel Ignacio,9995,0,9999,4
1715619918702,AIP 197,002,650778,Amir; On,9998,0,9999,1
1715619918702,AIP 197,003,650933,Avenancio-Leon; Carlos,9998,0,9999,1
1715619918702,AIP 197,004,658530,Heyman; Gail D.,9998,0,9999,1
1715619918702,AIP 197,005,658631,Neal; Sonya E,9998,0,9999,1
1715619918702,AIP 197,006,658671,Du; Songzi,9998,0,9999,1
1715619919725,ANAR 135S,A00,494369,Braswell; Geoffrey E.,0,0,0,0
1715619920750,BENG 196,001,628496,Engler; Adam J.,9998,0,9999,1
1715619920750,BENG 196,002,660916,Watson; John Thomas,9999,0,9999,0
1715619921781,BISP 197,001,650773,Wilhelm; James E.,9994,0,9999,5
1715619921781,BISP 197,002,658904,Coleman; Aaron B.,9998,0,9999,1
1715619922806,CAT 124RS,A01,519847,Geibel; William,0,0,20,20
1715619923833,CAT 125RS,A01,515971,Geibel; William,0,0,20,20
1715619924860,CLRE 250,A00,511389,Morris; Sheldon,9992,0,9999,7
1715619925892,CLRE 251,A00,507176,Mehta; Ravindra L.,9992,0,9999,7
1715619925892,CLRE 251,B00,511410,Mehta; Ravindra L.,9998,0,9999,1
1715619926922,CLRE 252,A00,507189,Cuomo; Raphael Eduardo,9994,0,9999,5
1715619927950,CLRE 253,A00,507199,Vaida; Florin,9994,0,9999,5
1715619927950,CLRE 253,B00,507202,Vaida; Florin,9999,0,9999,0
1715619928978,CLRE 259,A00,507211,Patel; Hemal,9996,0,9999,3
1715619930004,CLRE 260,A00,507221,Cuomo; Raphael Eduardo,9999,0,9999,0
1715619931030,CLRE 297,001,507242,Cuomo; Raphael Eduardo,9999,0,9999,0
1715619932056,COGS 197,001,638244,Voytek; Bradley Thomas,9997,0,9999,2
1715619933081,CSE 191,A00,516875,Minnes Kemp; Mor Mia,9991,0,9999,8
1715619934106,CSE 197,001,637388,Minnes Kemp; Mor Mia,9992,0,9999,7
1715619935133,CSS 201S,A01,494383,Mignozzetti; Umberto,35,0,35,0
1715619936160,CSS 202S,A01,494387,Mignozzetti; Umberto,35,0,35,0
1715619937187,DSC 197,001,628532,Eldridge; Justin Matthew,9995,0,9999,4
1715619938211,EAP 100,A00,516065,Staff,9799,0,9999,200
1715619939237,ECE 45,A01,507414,Staff,31,0,60,29
1715619941291,ECE 111,A01,507420,Staff,11,0,50,39
1715619942316,ECE 197,001,548057,Sievenpiper; Daniel F.,9991,0,9999,8
1715619943340,EDS 115,A00,507243,Choi; Bailey Miyeon,7,0,28,21
1715619944365,EDS 117,A01,494379,Staff,0,6,34,34
1715619945391,EDS 125,A00,507246,Hopkins; Megan Beth,8,0,30,22
1715619946416,EDS 128A,A01,507264,Fargason; Sharon Gayle,6,0,26,20
1715619947441,EDS 128B,A01,507293,Pappas; Elizabeth,10,0,30,20
1715619948468,EDS 139,A00,507294,Fargason; Sharon Gayle,10,0,30,20
1715619948468,EDS 139,B00,507313,Pappas; Elizabeth,11,0,30,19
1715619949495,EDS 201,A00,507315,Staff,10,0,30,20
1715619950525,EDS 203,A01,507317,Halter; Christopher P.,10,0,30,20
1715619951553,EDS 204R,A01,507319,Halter; Christopher P.,0,3,30,30
1715619951553,EDS 204R,B01,507331,Heinzman; Erica M.,14,0,30,16
1715619952579,EDS 206R,A00,507332,Staff,0,4,30,30
1715619952579,EDS 206R,B00,507343,Staff,15,0,30,15
1715619953605,EDS 250,A00,507344,Hemans; Patricia Ann Benitez,20,0,40,20
1715619954629,EDS 281,A00,507345,Daly; Alan J.,18,0,18,0
1715619955654,EDS 284,A00,507350,Daly; Alan J.,16,0,16,0
1715619956680,EDS 286,A00,507359,Fine; Sarah,18,0,18,0
1715619957704,EDS 289C,A01,507361,Daly; Alan J.,18,0,18,0
1715619958728,EDS 290,A00,507366,Hofstetter; Carolyn,15,0,15,0
1715619959754,LIGM 5A,A00,507421,Fischer-Grunski; Eva K,17,0,20,3
1715619960780,LIGM 5B,A00,507423,Fischer-Grunski; Eva K,19,0,20,1
1715619961805,LIGM 5C,A00,507425,Fischer-Grunski; Eva K,19,0,20,1
1715619962831,LIIT 5AS,A00,507427,Carnelos; Chiara,20,0,20,0
1715619963857,LIIT 5BS,A00,507430,Carnelos; Chiara,20,0,20,0
1715619964883,LIIT 5CS,A00,507432,Carnelos; Chiara,20,0,20,0
1715619965909,LISP 5A,A00,507541,Munoz Sanchez; Alicia,11,0,20,9
1715619966989,LISP 5B,A00,507671,Munoz Sanchez; Alicia,9,0,20,11
1715619968016,LISP 5C,A00,507696,Munoz Sanchez; Alicia,9,0,20,11
1715619969044,MAE 197,001,528363,Boechler; Nicholas Sebastia,9998,0,9999,1
1715619970072,MATH 197,001,523477,Kedlaya; Kiran S.,9994,0,9999,5
1715619970072,MATH 197,002,563811,Zhang; Danna,9994,0,9999,5
1715619970072,MATH 197,003,628552,Dumitriu; Ioana,9998,0,9999,1
1715619970072,MATH 197,004,660885,Floyd; Eric,9998,0,9999,1
1715619971100,MCWP 40R,A00,518780,Staff,2,0,20,18
1715619971100,MCWP 40R,B00,518781,Staff,11,0,20,9
1715619971100,MCWP 40R,C00,518783,Staff,5,0,20,15
1715619972126,MCWP 50R,A00,518791,Staff,0,1,20,20
1715619972126,MCWP 50R,B00,518792,Staff,0,2,20,20
1715619972126,MCWP 50R,C00,518793,Staff,0,4,20,20
1715619972126,MCWP 50R,D00,518794,Staff,0,1,20,20
1715619972126,MCWP 50R,E00,518795,Staff,0,2,20,20
1715619972126,MCWP 50R,F00,518796,Staff,0,1,20,20
1715619972126,MCWP 50R,G00,518797,Staff,0,1,20,20
1715619973154,MMW 12R,A01,514034,Herbst; Matthew,0,2,16,16
1715619973154,MMW 12R,A02,514035,Herbst; Matthew,0,0,16,16
1715619974179,MMW 13R,A01,514037,Staff,0,5,16,16
1715619974179,MMW 13R,A02,514039,Staff,0,5,16,16
1715619974179,MMW 13R,A03,628519,Staff,0,4,16,16
1715619976230,SIO 295LS,A00,523233,Staff,10,0,30,20
1715619977255,SIO 295S,A00,523232,Staff,10,0,30,20
1715619978280,SIOC 290S,A01,637330,Merrifield; Mark A,23,0,30,7
1715619979309,SIOC 291S,A01,637333,Gabriel; Corey John,23,0,30,7
1715619980335,SOCI 117,A01,494376,Staff,0,5,5,5
1715619981362,WES 237B,A00,494380,Staff,10,0,20,10
1715619983435,AESE 279B,A00,494370,Wade; Jon P,0,0,33,33
1715619984463,AIP 97,001,660915,Van Den Einde; Yael Dahlia,9998,0,9999,1
1715619985496,AIP 197,001,627712,Vespa; Emanuel Ignacio,9995,0,9999,4
1715619985496,AIP 197,002,650778,Amir; On,9998,0,9999,1
1715619985496,AIP 197,003,650933,Avenancio-Leon; Carlos,9998,0,9999,1
1715619985496,AIP 197,004,658530,Heyman; Gail D.,9998,0,9999,1
1715619985496,AIP 197,005,658631,Neal; Sonya E,9998,0,9999,1
1715619985496,AIP 197,006,658671,Du; Songzi,9998,0,9999,1
1715619986524,ANAR 135S,A00,494369,Braswell; Geoffrey E.,0,0,0,0
1715619987549,BENG 196,001,628496,Engler; Adam J.,9998,0,9999,1
1715619987549,BENG 196,002,660916,Watson; John Thomas,9999,0,9999,0
1715619988575,BISP 197,001,650773,Wilhelm; James E.,9994,0,9999,5
1715619988575,BISP 197,002,658904,Coleman; Aaron B.,9998,0,9999,1
1715619989603,CAT 124RS,A01,519847,Geibel; William,0,0,20,20
1715619990628,CAT 125RS,A01,515971,Geibel; William,0,0,20,20
1715619991654,CLRE 250,A00,511389,Morris; Sheldon,9992,0,9999,7
1715619992683,CLRE 251,A00,507176,Mehta; Ravindra L.,9992,0,9999,7
1715619992683,CLRE 251,B00,511410,Mehta; Ravindra L.,9998,0,9999,1
1715619993707,CLRE 252,A00,507189,Cuomo; Raphael Eduardo,9994,0,9999,5
1715619994734,CLRE 253,A00,507199,Vaida; Florin,9994,0,9999,5
1715619994734,CLRE 253,B00,507202,Vaida; Florin,9999,0,9999,0
1715619995759,CLRE 259,A00,507211,Patel; Hemal,9996,0,9999,3
1715619996783,CLRE 260,A00,507221,Cuomo; Raphael Eduardo,9999,0,9999,0
1715619997807,CLRE 297,001,507242,Cuomo; Raphael Eduardo,9999,0,9999,0
1715619998834,COGS 197,001,638244,Voytek; Bradley Thomas,9997,0,9999,2
1715619999860,CSE 191,A00,516875,Minnes Kemp; Mor Mia,9991,0,9999,8
1715620000886,CSE 197,001,637388,Minnes Kemp; Mor Mia,9992,0,9999,7
1715620001917,CSS 201S,A01,494383,Mignozzetti; Umberto,35,0,35,0
1715620002942,CSS 202S,A01,494387,Mignozzetti; Umberto,35,0,35,0
1715620003969,DSC 197,001,628532,Eldridge; Justin Matthew,9995,0,9999,4
1715620004995,EAP 100,A00,516065,Staff,9799,0,9999,200
1715620006026,ECE 45,A01,507414,Staff,31,0,60,29
1715620008076,ECE 111,A01,507420,Staff,11,0,50,39
1715620009101,ECE 197,001,548057,Sievenpiper; Daniel F.,9991,0,9999,8
1715620010127,EDS 115,A00,507243,Choi; Bailey Miyeon,7,0,28,21
1715620011153,EDS 117,A01,494379,Staff,0,6,34,34
1715620012179,EDS 125,A00,507246,Hopkins; Megan Beth,8,0,30,22
1715620013205,EDS 128A,A01,507264,Fargason; Sharon Gayle,6,0,26,20
1715620014231,EDS 128B,A01,507293,Pappas; Elizabeth,10,0,30,20
1715620015255,EDS 139,A00,507294,Fargason; Sharon Gayle,10,0,30,20
1715620015255,EDS 139,B00,507313,Pappas; Elizabeth,11,0,30,19
1715620016281,EDS 201,A00,507315,Staff,10,0,30,20
1715620017306,EDS 203,A01,507317,Halter; Christopher P.,10,0,30,20
1715620018331,EDS 204R,A01,507319,Halter; Christopher P.,0,3,30,30
1715620018331,EDS 204R,B01,507331,Heinzman; Erica M.,14,0,30,16
1715620019355,EDS 206R,A00,507332,Staff,0,4,30,30
1715620019355,EDS 206R,B00,507343,Staff,15,0,30,15
1715620020381,EDS 250,A00,507344,Hemans; Patricia Ann Benitez,20,0,40,20
1715620021406,EDS 281,A00,507345,Daly; Alan J.,18,0,18,0
1715620022436,EDS 284,A00,507350,Daly; Alan J.,16,0,16,0
1715620023462,EDS 286,A00,507359,Fine; Sarah,18,0,18,0
1715620024490,EDS 289C,A01,507361,Daly; Alan J.,18,0,18,0
1715620025517,EDS 290,A00,507366,Hofstetter; Carolyn,15,0,15,0
1715620026543,LIGM 5A,A00,507421,Fischer-Grunski; Eva K,17,0,20,3
1715620027573,LIGM 5B,A00,507423,Fischer-Grunski; Eva K,19,0,20,1
1715620028602,LIGM 5C,A00,507425,Fischer-Grunski; Eva K,19,0,20,1
1715620029627,LIIT 5AS,A00,507427,Carnelos; Chiara,20,0,20,0
1715620030654,LIIT 5BS,A00,507430,Carnelos; Chiara,20,0,20,0
1715620031679,LIIT 5CS,A00,507432,Carnelos; Chiara,20,0,20,0
1715620032706,LISP 5A,A00,507541,Munoz Sanchez; Alicia,11,0,20,9
1715620033734,LISP 5B,A00,507671,Munoz Sanchez; Alicia,9,0,20,11
1715620034762,LISP 5C,A00,507696,Munoz Sanchez; Alicia,9,0,20,11
1715620035790,MAE 197,001,528363,Boechler; Nicholas Sebastia,9998,0,9999,1
1715620036818,MATH 197,001,523477,Kedlaya; Kiran S.,9994,0,9999,5
1715620036818,MATH 197,002,563811,Zhang; Danna,9994,0,9999,5
1715620036818,MATH 197,003,628552,Dumitriu; Ioana,9998,0,9999,1
1715620036818,MATH 197,004,660885,Floyd; Eric,9998,0,9999,1
1715620037843,MCWP 40R,A00,518780,Staff,2,0,20,18
1715620037843,MCWP 40R,B00,518781,Staff,11,0,20,9
1715620037843,MCWP 40R,C00,518783,Staff,5,0,20,15
1715620038869,MCWP 50R,A00,518791,Staff,0,1,20,20
1715620038869,MCWP 50R,B00,518792,Staff,0,2,20,20
1715620038869,MCWP 50R,C00,518793,Staff,0,4,20,20
1715620038869,MCWP 50R,D00,518794,Staff,0,1,20,20
1715620038869,MCWP 50R,E00,518795,Staff,0,2,20,20
1715620038869,MCWP 50R,F00,518796,Staff,0,1,20,20
1715620038869,MCWP 50R,G00,518797,Staff,0,1,20,20
1715620039894,MMW 12R,A01,514034,Herbst; Matthew,0,2,16,16
1715620039894,MMW 12R,A02,514035,Herbst; Matthew,0,0,16,16
1715620040918,MMW 13R,A01,514037,Staff,0,5,16,16
1715620040918,MMW 13R,A02,514039,Staff,0,5,16,16
1715620040918,MMW 13R,A03,628519,Staff,0,4,16,16
1715620042969,SIO 295LS,A00,523233,Staff,10,0,30,20
1715620043994,SIO 295S,A00,523232,Staff,10,0,30,20
1715620045024,SIOC 290S,A01,637330,Merrifield; Mark A,23,0,30,7
1715620046057,SIOC 291S,A01,637333,Gabriel; Corey John,23,0,30,7
1715620047083,SOCI 117,A01,494376,Staff,0,5,5,5
1715620048108,WES 237B,A00,494380,Staff,10,0,20,10
1715620050167,AESE 279B,A00,494370,Wade; Jon P,0,0,33,33
1715620051195,AIP 97,001,660915,Van Den Einde; Yael Dahlia,9998,0,9999,1
1715620052224,AIP 197,001,627712,Vespa; Emanuel Ignacio,9995,0,9999,4
1715620052224,AIP 197,002,650778,Amir; On,9998,0,9999,1
1715620052224,AIP 197,003,650933,Avenancio-Leon; Carlos,9998,0,9999,1
1715620052224,AIP 197,004,658530,Heyman; Gail D.,9998,0,9999,1
1715620052224,AIP 197,005,658631,Neal; Sonya E,9998,0,9999,1
1715620052224,AIP 197,006,658671,Du; Songzi,9998,0,9999,1
1715620053250,ANAR 135S,A00,494369,Braswell; Geoffrey E.,0,0,0,0
1715620054279,BENG 196,001,628496,Engler; Adam J.,9998,0,9999,1
1715620054279,BENG 196,002,660916,Watson; John Thomas,9999,0,9999,0
1715620055307,BISP 197,001,650773,Wilhelm; James E.,9994,0,9999,5
1715620055307,BISP 197,002,658904,Coleman; Aaron B.,9998,0,9999,1
1715620056335,CAT 124RS,A01,519847,Geibel; William,0,0,20,20
1715620057361,CAT 125RS,A01,515971,Geibel; William,0,0,20,20
1715620058390,CLRE 250,A00,511389,Morris; Sheldon,9992,0,9999,7
1715620059416,CLRE 251,A00,507176,Mehta; Ravindra L.,9992,0,9999,7
1715620059416,CLRE 251,B00,511410,Mehta; Ravindra L.,9998,0,9999,1
1715620060441,CLRE 252,A00,507189,Cuomo; Raphael Eduardo,9994,0,9999,5
1715620061469,CLRE 253,A00,507199,Vaida; Florin,9994,0,9999,5
1715620061469,CLRE 253,B00,507202,Vaida; Florin,9999,0,9999,0
1715620062496,CLRE 259,A00,507211,Patel; Hemal,9996,0,9999,3
1715620063522,CLRE 260,A00,507221,Cuomo; Raphael Eduardo,9999,0,9999,0
1715620064549,CLRE 297,001,507242,Cuomo; Raphael Eduardo,9999,0,9999,0
1715620065577,COGS 197,001,638244,Voytek; Bradley Thomas,9997,0,9999,2
1715620066606,CSE 191,A00,516875,Minnes Kemp; Mor Mia,9991,0,9999,8
1715620067632,CSE 197,001,637388,Minnes Kemp; Mor Mia,9992,0,9999,7
1715620068658,CSS 201S,A01,494383,Mignozzetti; Umberto,35,0,35,0
1715620069681,CSS 202S,A01,494387,Mignozzetti; Umberto,35,0,35,0
1715620070763,DSC 197,001,628532,Eldridge; Justin Matthew,9995,0,9999,4
1715620071788,EAP 100,A00,516065,Staff,9799,0,9999,200
1715620072819,ECE 45,A01,507414,Staff,31,0,60,29
1715620074872,ECE 111,A01,507420,Staff,11,0,50,39
1715620075899,ECE 197,001,548057,Sievenpiper; Daniel F.,9991,0,9999,8
1715620076927,EDS 115,A00,507243,Choi; Bailey Miyeon,7,0,28,21
1715620077956,EDS 117,A01,494379,Staff,0,6,34,34
1715620078982,EDS 125,A00,507246,Hopkins; Megan Beth,8,0,30,22
1715620080014,EDS 128A,A01,507264,Fargason; Sharon Gayle,6,0,26,20
1715620081044,EDS 128B,A01,507293,Pappas; Elizabeth,10,0,30,20
1715620082070,EDS 139,A00,507294,Fargason; Sharon Gayle,10,0,30,20
1715620082070,EDS 139,B00,507313,Pappas; Elizabeth,11,0,30,19
1715620083098,EDS 201,A00,507315,Staff,10,0,30,20
1715620084123,EDS 203,A01,507317,Halter; Christopher P.,10,0,30,20
1715620085150,EDS 204R,A01,507319,Halter; Christopher P.,0,3,30,30
1715620085150,EDS 204R,B01,507331,Heinzman; Erica M.,14,0,30,16
1715620086176,EDS 206R,A00,507332,Staff,0,4,30,30
1715620086176,EDS 206R,B00,507343,Staff,15,0,30,15
1715620087205,EDS 250,A00,507344,Hemans; Patricia Ann Benitez,20,0,40,20
1715620088230,EDS 281,A00,507345,Daly; Alan J.,18,0,18,0
1715620089255,EDS 284,A00,507350,Daly; Alan J.,16,0,16,0
1715620090282,EDS 286,A00,507359,Fine; Sarah,18,0,18,0
1715620091309,EDS 289C,A01,507361,Daly; Alan J.,18,0,18,0
1715620092336,EDS 290,A00,507366,Hofstetter; Carolyn,15,0,15,0
1715620093368,LIGM 5A,A00,507421,Fischer-Grunski; Eva K,17,0,20,3
1715620094396,LIGM 5B,A00,507423,Fischer-Grunski; Eva K,19,0,20,1
1715620095423,LIGM 5C,A00,507425,Fischer-Grunski; Eva K,19,0,20,1
1715620096449,LIIT 5AS,A00,507427,Carnelos; Chiara,20,0,20,0
1715620097478,LIIT 5BS,A00,507430,Carnelos; Chiara,20,0,20,0
1715620098504,LIIT 5CS,A00,507432,Carnelos; Chiara,20,0,20,0
1715620099533,LISP 5A,A00,507541,Munoz Sanchez; Alicia,11,0,20,9
1715620100557,LISP 5B,A00,507671,Munoz Sanchez; Alicia,9,0,20,11
1715620101583,LISP 5C,A00,507696,Munoz Sanchez; Alicia,9,0,20,11
1715620102607,MAE 197,001,528363,Boechler; Nicholas Sebastia,9998,0,9999,1
1715620103639,MATH 197,001,523477,Kedlaya; Kiran S.,9994,0,9999,5
1715620103639,MATH 197,002,563811,Zhang; Danna,9994,0,9999,5
1715620103639,MATH 197,003,628552,Dumitriu; Ioana,9998,0,9999,1
1715620103639,MATH 197,004,660885,Floyd; Eric,9998,0,9999,1
1715620104665,MCWP 40R,A00,518780,Staff,2,0,20,18
1715620104665,MCWP 40R,B00,518781,Staff,11,0,20,9
1715620104665,MCWP 40R,C00,518783,Staff,5,0,20,15
1715620105695,MCWP 50R,A00,518791,Staff,0,1,20,20
1715620105695,MCWP 50R,B00,518792,Staff,0,2,20,20
1715620105695,MCWP 50R,C00,518793,Staff,0,4,20,20
1715620105695,MCWP 50R,D00,518794,Staff,0,1,20,20
1715620105695,MCWP 50R,E00,518795,Staff,0,2,20,20
1715620105695,MCWP 50R,F00,518796,Staff,0,1,20,20
1715620105695,MCWP 50R,G00,518797,Staff,0,1,20,20
1715620106721,MMW 12R,A01,514034,Herbst; Matthew,0,2,16,16
1715620106721,MMW 12R,A02,514035,Herbst; Matthew,0,0,16,16
1715620107750,MMW 13R,A01,514037,Staff,0,5,16,16
1715620107750,MMW 13R,A02,514039,Staff,0,5,16,16
1715620107750,MMW 13R,A03,628519,Staff,0,4,16,16
1715620109803,SIO 295LS,A00,523233,Staff,10,0,30,20
1715620110830,SIO 295S,A00,523232,Staff,10,0,30,20
1715620111854,SIOC 290S,A01,637330,Merrifield; Mark A,23,0,30,7
1715620112878,SIOC 291S,A01,637333,Gabriel; Corey John,23,0,30,7
1715620113904,SOCI 117,A01,494376,Staff,0,5,5,5
1715620114939,WES 237B,A00,494380,Staff,10,0,20,10
1715620117000,AESE 279B,A00,494370,Wade; Jon P,0,0,33,33
1715620118024,AIP 97,001,660915,Van Den Einde; Yael Dahlia,9998,0,9999,1
1715620119052,AIP 197,001,627712,Vespa; Emanuel Ignacio,9995,0,9999,4
1715620119052,AIP 197,002,650778,Amir; On,9998,0,9999,1
1715620119052,AIP 197,003,650933,Avenancio-Leon; Carlos,9998,0,9999,1
1715620119052,AIP 197,004,658530,Heyman; Gail D.,9998,0,9999,1
1715620119052,AIP 197,005,658631,Neal; Sonya E,9998,0,9999,1
1715620119052,AIP 197,006,658671,Du; Songzi,9998,0,9999,1
1715620120078,ANAR 135S,A00,494369,Braswell; Geoffrey E.,0,0,0,0
1715620121103,BENG 196,001,628496,Engler; Adam J.,9998,0,9999,1
1715620121103,BENG 196,002,660916,Watson; John Thomas,9999,0,9999,0
1715620122130,BISP 197,001,650773,Wilhelm; James E.,9994,0,9999,5
1715620122130,BISP 197,002,658904,Coleman; Aaron B.,9998,0,9999,1
1715620123154,CAT 124RS,A01,519847,Geibel; William,0,0,20,20
1715620124179,CAT 125RS,A01,515971,Geibel; William,0,0,20,20
1715620125204,CLRE 250,A00,511389,Morris; Sheldon,9992,0,9999,7
1715620126233,CLRE 251,A00,507176,Mehta; Ravindra L.,9992,0,9999,7
1715620126233,CLRE 251,B00,511410,Mehta; Ravindra L.,9998,0,9999,1
1715620127260,CLRE 252,A00,507189,Cuomo; Raphael Eduardo,9994,0,9999,5
1715620128285,CLRE 253,A00,507199,Vaida; Florin,9994,0,9999,5
1715620128285,CLRE 253,B00,507202,Vaida; Florin,9999,0,9999,0
1715620129310,CLRE 259,A00,507211,Patel; Hemal,9996,0,9999,3
1715620130334,CLRE 260,A00,507221,Cuomo; Raphael Eduardo,9999,0,9999,0
1715620131359,CLRE 297,001,507242,Cuomo; Raphael Eduardo,9999,0,9999,0
1715620132385,COGS 197,001,638244,Voytek; Bradley Thomas,9997,0,9999,2
1715620133413,CSE 191,A00,516875,Minnes Kemp; Mor Mia,9991,0,9999,8
1715620134438,CSE 197,001,637388,Minnes Kemp; Mor Mia,9992,0,9999,7
1715620135463,CSS 201S,A01,494383,Mignozzetti; Umberto,35,0,35,0
1715620136491,CSS 202S,A01,494387,Mignozzetti; Umberto,35,0,35,0
1715620137516,DSC 197,001,628532,Eldridge; Justin Matthew,9995,0,9999,4
1715620138542,EAP 100,A00,516065,Staff,9799,0,9999,200
1715620139569,ECE 45,A01,507414,Staff,31,0,60,29
1715620141626,ECE 111,A01,507420,Staff,11,0,50,39
1715620142651,ECE 197,001,548057,Sievenpiper; Daniel F.,9991,0,9999,8
1715620143682,EDS 115,A00,507243,Choi; Bailey Miyeon,7,0,28,21
1715620144710,EDS 117,A01,494379,Staff,0,6,34,34
1715620145736,EDS 125,A00,507246,Hopkins; Megan Beth,8,0,30,22
1715620146767,EDS 128A,A01,507264,Fargason; Sharon Gayle,6,0,26,20
1715620147794,EDS 128B,A01,507293,Pappas; Elizabeth,10,0,30,20
1715620148821,EDS 139,A00,507294,Fargason; Sharon Gayle,10,0,30,20
1715620148821,EDS 139,B00,507313,Pappas; Elizabeth,11,0,30,19
1715620149845,EDS 201,A00,507315,Staff,10,0,30,20
1715620150874,EDS 203,A01,507317,Halter; Christopher P.,10,0,30,20
1715620151903,EDS 204R,A01,507319,Halter; Christopher P.,0,3,30,30
1715620151903,EDS 204R,B01,507331,Heinzman; Erica M.,14,0,30,16
1715620152927,EDS 206R,A00,507332,Staff,0,4,30,30
1715620152927,EDS 206R,B00,507343,Staff,15,0,30,15
1715620153955,EDS 250,A00,507344,Hemans; Patricia Ann Benitez,20,0,40,20
1715620154982,EDS 281,A00,507345,Daly; Alan J.,18,0,18,0
1715620156007,EDS 284,A00,507350,Daly; Alan J.,16,0,16,0
1715620157034,EDS 286,A00,507359,Fine; Sarah,18,0,18,0
1715620158061,EDS 289C,A01,507361,Daly; Alan J.,18,0,18,0
1715620159087,EDS 290,A00,507366,Hofstetter; Carolyn,15,0,15,0
1715620160117,LIGM 5A,A00,507421,Fischer-Grunski; Eva K,17,0,20,3
1715620161142,LIGM 5B,A00,507423,Fischer-Grunski; Eva K,19,0,20,1
1715620162168,LIGM 5C,A00,507425,Fischer-Grunski; Eva K,19,0,20,1
1715620163194,LIIT 5AS,A00,507427,Carnelos; Chiara,20,0,20,0
1715620164226,LIIT 5BS,A00,507430,Carnelos; Chiara,20,0,20,0
1715620165252,LIIT 5CS,A00,507432,Carnelos; Chiara,20,0,20,0
1715620166279,LISP 5A,A00,507541,Munoz Sanchez; Alicia,11,0,20,9
1715620167305,LISP 5B,A00,507671,Munoz Sanchez; Alicia,9,0,20,11
1715620168336,LISP 5C,A00,507696,Munoz Sanchez; Alicia,9,0,20,11
1715620169359,MAE 197,001,528363,Boechler; Nicholas Sebastia,9998,0,9999,1
1715620170390,MATH 197,001,523477,Kedlaya; Kiran S.,9994,0,9999,5
1715620170390,MATH 197,002,563811,Zhang; Danna,9994,0,9999,5
1715620170390,MATH 197,003,628552,Dumitriu; Ioana,9998,0,9999,1
1715620170390,MATH 197,004,660885,Floyd; Eric,9998,0,9999,1
1715620171418,MCWP 40R,A00,518780,Staff,2,0,20,18
1715620171418,MCWP 40R,B00,518781,Staff,11,0,20,9
1715620171418,MCWP 40R,C00,518783,Staff,5,0,20,15
1715620172501,MCWP 50R,A00,518791,Staff,0,1,20,20
1715620172501,MCWP 50R,B00,518792,Staff,0,2,20,20
1715620172501,MCWP 50R,C00,518793,Staff,0,4,20,20
1715620172501,MCWP 50R,D00,518794,Staff,0,1,20,20
1715620172501,MCWP 50R,E00,518795,Staff,0,2,20,20
1715620172501,MCWP 50R,F00,518796,Staff,0,1,20,20
1715620172501,MCWP 50R,G00,518797,Staff,0,1,20,20
1715620173528,MMW 12R,A01,514034,Herbst; Matthew,0,2,16,16
1715620173528,MMW 12R,A02,514035,Herbst; Matthew,0,0,16,16
1715620174557,MMW 13R,A01,514037,Staff,0,5,16,16
1715620174557,MMW 13R,A02,514039,Staff,0,5,16,16
1715620174557,MMW 13R,A03,628519,Staff,0,4,16,16
1715620176609,SIO 295LS,A00,523233,Staff,10,0,30,20
1715620177635,SIO 295S,A00,523232,Staff,10,0,30,20
1715620178661,SIOC 290S,A01,637330,Merrifield; Mark A,23,0,30,7
1715620179687,SIOC 291S,A01,637333,Gabriel; Corey John,23,0,30,7
1715620180714,SOCI 117,A01,494376,Staff,0,5,5,5
1715620181738,WES 237B,A00,494380,Staff,10,0,20,10
1715620183794,AESE 279B,A00,494370,Wade; Jon P,0,0,33,33
1715620184819,AIP 97,001,660915,Van Den Einde; Yael Dahlia,9998,0,9999,1
1715620185846,AIP 197,001,627712,Vespa; Emanuel Ignacio,9995,0,9999,4
1715620185846,AIP 197,002,650778,Amir; On,9998,0,9999,1
1715620185846,AIP 197,003,650933,Avenancio-Leon; Carlos,9998,0,9999,1
1715620185846,AIP 197,004,658530,Heyman; Gail D.,9998,0,9999,1
1715620185846,AIP 197,005,658631,Neal; Sonya E,9998,0,9999,1
1715620185846,AIP 197,006,658671,Du; Songzi,9998,0,9999,1
1715620186872,ANAR 135S,A00,494369,Braswell; Geoffrey E.,0,0,0,0
1715620187899,BENG 196,001,628496,Engler; Adam J.,9998,0,9999,1
1715620187899,BENG 196,002,660916,Watson; John Thomas,9999,0,9999,0
1715620188926,BISP 197,001,650773,Wilhelm; James E.,9994,0,9999,5
1715620188926,BISP 197,002,658904,Coleman; Aaron B.,9998,0,9999,1
1715620189950,CAT 124RS,A01,519847,Geibel; William,0,0,20,20
1715620190976,CAT 125RS,A01,515971,Geibel; William,0,0,20,20
1715620192002,CLRE 250,A00,511389,Morris; Sheldon,9992,0,9999,7
1715620193027,CLRE 251,A00,507176,Mehta; Ravindra L.,9992,0,9999,7
1715620193027,CLRE 251,B00,511410,Mehta; Ravindra L.,9998,0,9999,1
1715620194054,CLRE 252,A00,507189,Cuomo; Raphael Eduardo,9994,0,9999,5
1715620195085,CLRE 253,A00,507199,Vaida; Florin,9994,0,9999,5
1715620195085,CLRE 253,B00,507202,Vaida; Florin,9999,0,9999,0
1715620196109,CLRE 259,A00,507211,Patel; Hemal,9996,0,9999,3
1715620197134,CLRE 260,A00,507221,Cuomo; Raphael Eduardo,9999,0,9999,0
1715620198161,CLRE 297,001,507242,Cuomo; Raphael Eduardo,9999,0,9999,0
1715620199186,COGS 197,001,638244,Voytek; Bradley Thomas,9997,0,9999,2
1715620200211,CSE 191,A00,516875,Minnes Kemp; Mor Mia,9991,0,9999,8
1715620201234,CSE 197,001,637388,Minnes Kemp; Mor Mia,9992,0,9999,7
1715620202264,CSS 201S,A01,494383,Mignozzetti; Umberto,35,0,35,0
1715620203289,CSS 202S,A01,494387,Mignozzetti; Umberto,35,0,35,0
1715620204317,DSC 197,001,628532,Eldridge; Justin Matthew,9995,0,9999,4
1715620205341,EAP 100,A00,516065,Staff,9799,0,9999,200
1715620206375,ECE 45,A01,507414,Staff,31,0,60,29
1715620208431,ECE 111,A01,507420,Staff,11,0,50,39
1715620209457,ECE 197,001,548057,Sievenpiper; Daniel F.,9991,0,9999,8
1715620210485,EDS 115,A00,507243,Choi; Bailey Miyeon,7,0,28,21
1715620211509,EDS 117,A01,494379,Staff,0,6,34,34
1715620212534,EDS 125,A00,507246,Hopkins; Megan Beth,8,0,30,22
1715620213561,EDS 128A,A01,507264,Fargason; Sharon Gayle,6,0,26,20
1715620214591,EDS 128B,A01,507293,Pappas; Elizabeth,10,0,30,20
1715620215618,EDS 139,A00,507294,Fargason; Sharon Gayle,10,0,30,20
1715620215618,EDS 139,B00,507313,Pappas; Elizabeth,11,0,30,19
1715620216645,EDS 201,A00,507315,Staff,10,0,30,20
1715620217674,EDS 203,A01,507317,Halter; Christopher P.,10,0,30,20
1715620218697,EDS 204R,A01,507319,Halter; Christopher P.,0,3,30,30
1715620218697,EDS 204R,B01,507331,Heinzman; Erica M.,14,0,30,16
1715620219725,EDS 206R,A00,507332,Staff,0,4,30,30
1715620219725,EDS 206R,B00,507343,Staff,15,0,30,15
1715620220751,EDS 250,A00,507344,Hemans; Patricia Ann Benitez,20,0,40,20
1715620221777,EDS 281,A00,507345,Daly; Alan J.,18,0,18,0
1715620222804,EDS 284,A00,507350,Daly; Alan J.,16,0,16,0
1715620223829,EDS 286,A00,507359,Fine; Sarah,18,0,18,0
1715620224855,EDS 289C,A01,507361,Daly; Alan J.,18,0,18,0
1715620225881,EDS 290,A00,507366,Hofstetter; Carolyn,15,0,15,0
1715620226907,LIGM 5A,A00,507421,Fischer-Grunski; Eva K,17,0,20,3
1715620227932,LIGM 5B,A00,507423,Fischer-Grunski; Eva K,19,0,20,1
1715620228958,LIGM 5C,A00,507425,Fischer-Grunski; Eva K,19,0,20,1
1715620229984,LIIT 5AS,A00,507427,Carnelos; Chiara,20,0,20,0
1715620231014,LIIT 5BS,A00,507430,Carnelos; Chiara,20,0,20,0
1715620232044,LIIT 5CS,A00,507432,Carnelos; Chiara,20,0,20,0
1715620233069,LISP 5A,A00,507541,Munoz Sanchez; Alicia,11,0,20,9
1715620234095,LISP 5B,A00,507671,Munoz Sanchez; Alicia,9,0,20,11
1715620235122,LISP 5C,A00,507696,Munoz Sanchez; Alicia,9,0,20,11
1715620236146,MAE 197,001,528363,Boechler; Nicholas Sebastia,9998,0,9999,1
1715620237179,MATH 197,001,523477,Kedlaya; Kiran S.,9994,0,9999,5
1715620237179,MATH 197,002,563811,Zhang; Danna,9994,0,9999,5
1715620237179,MATH 197,003,628552,Dumitriu; Ioana,9998,0,9999,1
1715620237179,MATH 197,004,660885,Floyd; Eric,9998,0,9999,1
1715620238203,MCWP 40R,A00,518780,Staff,2,0,20,18
1715620238203,MCWP 40R,B00,518781,Staff,11,0,20,9
1715620238203,MCWP 40R,C00,518783,Staff,5,0,20,15
1715620239229,MCWP 50R,A00,518791,Staff,0,1,20,20
1715620239229,MCWP 50R,B00,518792,Staff,0,2,20,20
1715620239229,MCWP 50R,C00,518793,Staff,0,4,20,20
1715620239229,MCWP 50R,D00,518794,Staff,0,1,20,20
1715620239229,MCWP 50R,E00,518795,Staff,0,2,20,20
1715620239229,MCWP 50R,F00,518796,Staff,0,1,20,20
1715620239229,MCWP 50R,G00,518797,Staff,0,1,20,20
1715620240256,MMW 12R,A01,514034,Herbst; Matthew,0,2,16,16
1715620240256,MMW 12R,A02,514035,Herbst; Matthew,0,0,16,16
1715620241282,MMW 13R,A01,514037,Staff,0,5,16,16
1715620241282,MMW 13R,A02,514039,Staff,0,5,16,16
1715620241282,MMW 13R,A03,628519,Staff,0,4,16,16
1715620243338,SIO 295LS,A00,523233,Staff,10,0,30,20
1715620244366,SIO 295S,A00,523232,Staff,10,0,30,20
1715620245393,SIOC 290S,A01,637330,Merrifield; Mark A,23,0,30,7
1715620246418,SIOC 291S,A01,637333,Gabriel; Corey John,23,0,30,7
1715620247447,SOCI 117,A01,494376,Staff,0,5,5,5
1715620248472,WES 237B,A00,494380,Staff,10,0,20,10
1715620250552,AESE 279B,A00,494370,Wade; Jon P,0,0,33,33
1715620251578,AIP 97,001,660915,Van Den Einde; Yael Dahlia,9998,0,9999,1
1715620252604,AIP 197,001,627712,Vespa; Emanuel Ignacio,9995,0,9999,4
1715620252604,AIP 197,002,650778,Amir; On,9998,0,9999,1
1715620252604,AIP 197,003,650933,Avenancio-Leon; Carlos,9998,0,9999,1
1715620252604,AIP 197,004,658530,Heyman; Gail D.,9998,0,9999,1
1715620252604,AIP 197,005,658631,Neal; Sonya E,9998,0,9999,1
1715620252604,AIP 197,006,658671,Du; Songzi,9998,0,9999,1
1715620253632,ANAR 135S,A00,494369,Braswell; Geoffrey E.,0,0,0,0
1715620254660,BENG 196,001,628496,Engler; Adam J.,9998,0,9999,1
1715620254660,BENG 196,002,660916,Watson; John Thomas,9999,0,9999,0
1715620255690,BISP 197,001,650773,Wilhelm; James E.,9994,0,9999,5
1715620255690,BISP 197,002,658904,Coleman; Aaron B.,9998,0,9999,1
1715620256720,CAT 124RS,A01,519847,Geibel; William,0,0,20,20
1715620257745,CAT 125RS,A01,515971,Geibel; William,0,0,20,20
1715620258773,CLRE 250,A00,511389,Morris; Sheldon,9992,0,9999,7
1715620259806,CLRE 251,A00,507176,Mehta; Ravindra L.,9992,0,9999,7
1715620259806,CLRE 251,B00,511410,Mehta; Ravindra L.,9998,0,9999,1
1715620260833,CLRE 252,A00,507189,Cuomo; Raphael Eduardo,9994,0,9999,5
1715620261858,CLRE 253,A00,507199,Vaida; Florin,9994,0,9999,5
1715620261858,CLRE 253,B00,507202,Vaida; Florin,9999,0,9999,0
1715620262885,CLRE 259,A00,507211,Patel; Hemal,9996,0,9999,3
1715620263912,CLRE 260,A00,507221,Cuomo; Raphael Eduardo,9999,0,9999,0
1715620264939,CLRE 297,001,507242,Cuomo; Raphael Eduardo,9999,0,9999,0
1715620265965,COGS 197,001,638244,Voytek; Bradley Thomas,9997,0,9999,2
1715620266991,CSE 191,A00,516875,Minnes Kemp; Mor Mia,9991,0,9999,8
1715620268015,CSE 197,001,637388,Minnes Kemp; Mor Mia,9992,0,9999,7
1715620269046,CSS 201S,A01,494383,Mignozzetti; Umberto,35,0,35,0
1715620270076,CSS 202S,A01,494387,Mignozzetti; Umberto,35,0,35,0
1715620271105,DSC 197,001,628532,Eldridge; Justin Matthew,9995,0,9999,4
1715620272128,EAP 100,A00,516065,Staff,9799,0,9999,200
1715620273156,ECE 45,A01,507414,Staff,31,0,60,29
1715620275207,ECE 111,A01,507420,Staff,11,0,50,39
1715620276236,ECE 197,001,548057,Sievenpiper; Daniel F.,9991,0,9999,8
1715620277263,EDS 115,A00,507243,Choi; Bailey Miyeon,7,0,28,21
1715620278291,EDS 117,A01,494379,Staff,0,6,34,34
1715620279371,EDS 125,A00,507246,Hopkins; Megan Beth,8,0,30,22
1715620280400,EDS 128A,A01,507264,Fargason; Sharon Gayle,6,0,26,20
1715620281425,EDS 128B,A01,507293,Pappas; Elizabeth,10,0,30,20
1715620282451,EDS 139,A00,507294,Fargason; Sharon Gayle,10,0,30,20
1715620282451,EDS 139,B00,507313,Pappas; Elizabeth,11,0,30,19
1715620283476,EDS 201,A00,507315,Staff,10,0,30,20
1715620284504,EDS 203,A01,507317,Halter; Christopher P.,10,0,30,20
1715620285529,EDS 204R,A01,507319,Halter; Christopher P.,0,3,30,30
1715620285529,EDS 204R,B01,507331,Heinzman; Erica M.,14,0,30,16
1715620286555,EDS 206R,A00,507332,Staff,0,4,30,30
1715620286555,EDS 206R,B00,507343,Staff,15,0,30,15
1715620287584,EDS 250,A00,507344,Hemans; Patricia Ann Benitez,20,0,40,20
1715620288614,EDS 281,A00,507345,Daly; Alan J.,18,0,18,0
1715620289642,EDS 284,A00,507350,Daly; Alan J.,16,0,16,0
1715620290670,EDS 286,A00,507359,Fine; Sarah,18,0,18,0
1715620291697,EDS 289C,A01,507361,Daly; Alan J.,18,0,18,0
1715620292726,EDS 290,A00,507366,Hofstetter; Carolyn,15,0,15,0
1715620293751,LIGM 5A,A00,507421,Fischer-Grunski; Eva K,17,0,20,3
1715620294777,LIGM 5B,A00,507423,Fischer-Grunski; Eva K,19,0,20,1
1715620295808,LIGM 5C,A00,507425,Fischer-Grunski; Eva K,19,0,20,1
1715620296836,LIIT 5AS,A00,507427,Carnelos; Chiara,20,0,20,0
1715620297861,LIIT 5BS,A00,507430,Carnelos; Chiara,20,0,20,0
1715620298890,LIIT 5CS,A00,507432,Carnelos; Chiara,20,0,20,0
1715620299919,LISP 5A,A00,507541,Munoz Sanchez; Alicia,11,0,20,9
1715620300949,LISP 5B,A00,507671,Munoz Sanchez; Alicia,9,0,20,11
1715620301977,LISP 5C,A00,507696,Munoz Sanchez; Alicia,9,0,20,11
1715620303002,MAE 197,001,528363,Boechler; Nicholas Sebastia,9998,0,9999,1
1715620304029,MATH 197,001,523477,Kedlaya; Kiran S.,9994,0,9999,5
1715620304029,MATH 197,002,563811,Zhang; Danna,9994,0,9999,5
1715620304029,MATH 197,003,628552,Dumitriu; Ioana,9998,0,9999,1
1715620304029,MATH 197,004,660885,Floyd; Eric,9998,0,9999,1
1715620305054,MCWP 40R,A00,518780,Staff,2,0,20,18
1715620305054,MCWP 40R,B00,518781,Staff,11,0,20,9
1715620305054,MCWP 40R,C00,518783,Staff,5,0,20,15
1715620306087,MCWP 50R,A00,518791,Staff,0,1,20,20
1715620306087,MCWP 50R,B00,518792,Staff,0,2,20,20
1715620306087,MCWP 50R,C00,518793,Staff,0,4,20,20
1715620306087,MCWP 50R,D00,518794,Staff,0,1,20,20
1715620306087,MCWP 50R,E00,518795,Staff,0,2,20,20
1715620306087,MCWP 50R,F00,518796,Staff,0,1,20,20
1715620306087,MCWP 50R,G00,518797,Staff,0,1,20,20
1715620307114,MMW 12R,A01,514034,Herbst; Matthew,0,2,16,16
1715620307114,MMW 12R,A02,514035,Herbst; Matthew,0,0,16,16
1715620308139,MMW 13R,A01,514037,Staff,0,5,16,16
1715620308139,MMW 13R,A02,514039,Staff,0,5,16,16
1715620308139,MMW 13R,A03,628519,Staff,0,4,16,16
1715620310193,SIO 295LS,A00,523233,Staff,10,0,30,20
1715620311217,SIO 295S,A00,523232,Staff,10,0,30,20
1715620312245,SIOC 290S,A01,637330,Merrifield; Mark A,23,0,30,7
1715620313270,SIOC 291S,A01,637333,Gabriel; Corey John,23,0,30,7
1715620314299,SOCI 117,A01,494376,Staff,0,5,5,5
1715620315323,WES 237B,A00,494380,Staff,10,0,20,10
1715620317389,AESE 279B,A00,494370,Wade; Jon P,0,0,33,33
1715620318414,AIP 97,001,660915,Van Den Einde; Yael Dahlia,9998,0,9999,1
1715620319440,AIP 197,001,627712,Vespa; Emanuel Ignacio,9995,0,9999,4
1715620319440,AIP 197,002,650778,Amir; On,9998,0,9999,1
1715620319440,AIP 197,003,650933,Avenancio-Leon; Carlos,9998,0,9999,1
1715620319440,AIP 197,004,658530,Heyman; Gail D.,9998,0,9999,1
1715620319440,AIP 197,005,658631,Neal; Sonya E,9998,0,9999,1
1715620319440,AIP 197,006,658671,Du; Songzi,9998,0,9999,1
1715620320466,ANAR 135S,A00,494369,Braswell; Geoffrey E.,0,0,0,0
1715620321500,BENG 196,001,628496,Engler; Adam J.,9998,0,9999,1
1715620321500,BENG 196,002,660916,Watson; John Thomas,9999,0,9999,0
1715620322528,BISP 197,001,650773,Wilhelm; James E.,9994,0,9999,5
1715620322528,BISP 197,002,658904,Coleman; Aaron B.,9998,0,9999,1
1715620323553,CAT 124RS,A01,519847,Geibel; William,0,0,20,20
1715620324577,CAT 125RS,A01,515971,Geibel; William,0,0,20,20
1715620325605,CLRE 250,A00,511389,Morris; Sheldon,9992,0,9999,7
1715620326637,CLRE 251,A00,507176,Mehta; Ravindra L.,9992,0,9999,7
1715620326637,CLRE 251,B00,511410,Mehta; Ravindra L.,9998,0,9999,1
1715620327662,CLRE 252,A00,507189,Cuomo; Raphael Eduardo,9994,0,9999,5
1715620328691,CLRE 253,A00,507199,Vaida; Florin,9994,0,9999,5
1715620328691,CLRE 253,B00,507202,Vaida; Florin,9999,0,9999,0
1715620329719,CLRE 259,A00,507211,Patel; Hemal,9996,0,9999,3
1715620330743,CLRE 260,A00,507221,Cuomo; Raphael Eduardo,9999,0,9999,0
1715620331770,CLRE 297,001,507242,Cuomo; Raphael Eduardo,9999,0,9999,0
1715620332795,COGS 197,001,638244,Voytek; Bradley Thomas,9997,0,9999,2
1715620333820,CSE 191,A00,516875,Minnes Kemp; Mor Mia,9991,0,9999,8
1715620334847,CSE 197,001,637388,Minnes Kemp; Mor Mia,9992,0,9999,7
1715620335872,CSS 201S,A01,494383,Mignozzetti; Umberto,35,0,35,0
1715620336903,CSS 202S,A01,494387,Mignozzetti; Umberto,35,0,35,0
1715620337930,DSC 197,001,628532,Eldridge; Justin Matthew,9995,0,9999,4
1715620338957,EAP 100,A00,516065,Staff,9799,0,9999,200
1715620339984,ECE 45,A01,507414,Staff,31,0,60,29
1715620342038,ECE 111,A01,507420,Staff,11,0,50,39
1715620343067,ECE 197,001,548057,Sievenpiper; Daniel F.,9991,0,9999,8
1715620344094,EDS 115,A00,507243,Choi; Bailey Miyeon,7,0,28,21
1715620345121,EDS 117,A01,494379,Staff,0,6,34,34
1715620346147,EDS 125,A00,507246,Hopkins; Megan Beth,8,0,30,22
1715620347174,EDS 128A,A01,507264,Fargason; Sharon Gayle,6,0,26,20
1715620348199,EDS 128B,A01,507293,Pappas; Elizabeth,10,0,30,20
1715620349228,EDS 139,A00,507294,Fargason; Sharon Gayle,10,0,30,20
1715620349228,EDS 139,B00,507313,Pappas; Elizabeth,11,0,30,19
1715620350254,EDS 201,A00,507315,Staff,10,0,30,20
1715620351280,EDS 203,A01,507317,Halter; Christopher P.,10,0,30,20
1715620352311,EDS 204R,A01,507319,Halter; Christopher P.,0,3,30,30
1715620352311,EDS 204R,B01,507331,Heinzman; Erica M.,14,0,30,16
1715620353335,EDS 206R,A00,507332,Staff,0,4,30,30
1715620353335,EDS 206R,B00,507343,Staff,15,0,30,15
1715620354360,EDS 250,A00,507344,Hemans; Patricia Ann Benitez,20,0,40,20
1715620355385,EDS 281,A00,507345,Daly; Alan J.,18,0,18,0
1715620356413,EDS 284,A00,507350,Daly; Alan J.,16,0,16,0
1715620357442,EDS 286,A00,507359,Fine; Sarah,18,0,18,0
1715620358468,EDS 289C,A01,507361,Daly; Alan J.,18,0,18,0
1715620359494,EDS 290,A00,507366,Hofstetter; Carolyn,15,0,15,0
1715620360537,LIGM 5A,A00,507421,Fischer-Grunski; Eva K,17,0,20,3
1715620361564,LIGM 5B,A00,507423,Fischer-Grunski; Eva K,19,0,20,1
1715620362589,LIGM 5C,A00,507425,Fischer-Grunski; Eva K,19,0,20,1
1715620363615,LIIT 5AS,A00,507427,Carnelos; Chiara,20,0,20,0
1715620364641,LIIT 5BS,A00,507430,Carnelos; Chiara,20,0,20,0
1715620365667,LIIT 5CS,A00,507432,Carnelos; Chiara,20,0,20,0
1715620366694,LISP 5A,A00,507541,Munoz Sanchez; Alicia,11,0,20,9
1715620367720,LISP 5B,A00,507671,Munoz Sanchez; Alicia,9,0,20,11
1715620368746,LISP 5C,A00,507696,Munoz Sanchez; Alicia,9,0,20,11
1715620369773,MAE 197,001,528363,Boechler; Nicholas Sebastia,9998,0,9999,1
1715620370801,MATH 197,001,523477,Kedlaya; Kiran S.,9994,0,9999,5
1715620370801,MATH 197,002,563811,Zhang; Danna,9994,0,9999,5
1715620370801,MATH 197,003,628552,Dumitriu; Ioana,9998,0,9999,1
1715620370801,MATH 197,004,660885,Floyd; Eric,9998,0,9999,1
1715620371827,MCWP 40R,A00,518780,Staff,2,0,20,18
1715620371827,MCWP 40R,B00,518781,Staff,11,0,20,9
1715620371827,MCWP 40R,C00,518783,Staff,5,0,20,15
1715620372853,MCWP 50R,A00,518791,Staff,0,1,20,20
1715620372853,MCWP 50R,B00,518792,Staff,0,2,20,20
1715620372853,MCWP 50R,C00,518793,Staff,0,4,20,20
1715620372853,MCWP 50R,D00,518794,Staff,0,1,20,20
1715620372853,MCWP 50R,E00,518795,Staff,0,2,20,20
1715620372853,MCWP 50R,F00,518796,Staff,0,1,20,20
1715620372853,MCWP 50R,G00,518797,Staff,0,1,20,20
1715620373881,MMW 12R,A01,514034,Herbst; Matthew,0,2,16,16
1715620373881,MMW 12R,A02,514035,Herbst; Matthew,0,0,16,16
1715620374908,MMW 13R,A01,514037,Staff,0,5,16,16
1715620374908,MMW 13R,A02,514039,Staff,0,5,16,16
1715620374908,MMW 13R,A03,628519,Staff,0,4,16,16
1715620376962,SIO 295LS,A00,523233,Staff,10,0,30,20
1715620377988,SIO 295S,A00,523232,Staff,10,0,30,20
1715620379014,SIOC 290S,A01,637330,Merrifield; Mark A,23,0,30,7
1715620380040,SIOC 291S,A01,637333,Gabriel; Corey John,23,0,30,7
1715620381066,SOCI 117,A01,494376,Staff,0,5,5,5
1715620382094,WES 237B,A00,494380,Staff,10,0,20,10
1715620384239,AESE 279B,A00,494370,Wade; Jon P,0,0,33,33
1715620385267,AIP 97,001,660915,Van Den Einde; Yael Dahlia,9998,0,9999,1
1715620386296,AIP 197,001,627712,Vespa; Emanuel Ignacio,9995,0,9999,4
1715620386296,AIP 197,002,650778,Amir; On,9998,0,9999,1
1715620386296,AIP 197,003,650933,Avenancio-Leon; Carlos,9998,0,9999,1
1715620386296,AIP 197,004,658530,Heyman; Gail D.,9998,0,9999,1
1715620386296,AIP 197,005,658631,Neal; Sonya E,9998,0,9999,1
1715620386296,AIP 197,006,658671,Du; Songzi,9998,0,9999,1
1715620387327,ANAR 135S,A00,494369,Braswell; Geoffrey E.,0,0,0,0
1715620388353,BENG 196,001,628496,Engler; Adam J.,9998,0,9999,1
1715620388353,BENG 196,002,660916,Watson; John Thomas,9999,0,9999,0
1715620389379,BISP 197,001,650773,Wilhelm; James E.,9994,0,9999,5
1715620389379,BISP 197,002,658904,Coleman; Aaron B.,9998,0,9999,1
1715620390412,CAT 124RS,A01,519847,Geibel; William,0,0,20,20
1715620391441,CAT 125RS,A01,515971,Geibel; William,0,0,20,20
1715620392469,CLRE 250,A00,511389,Morris; Sheldon,9992,0,9999,7
1715620393496,CLRE 251,A00,507176,Mehta; Ravindra L.,9992,0,9999,7
1715620393496,CLRE 251,B00,511410,Mehta; Ravindra L.,9998,0,9999,1
1715620394522,CLRE 252,A00,507189,Cuomo; Raphael Eduardo,9994,0,9999,5
1715620395548,CLRE 253,A00,507199,Vaida; Florin,9994,0,9999,5
1715620395548,CLRE 253,B00,507202,Vaida; Florin,9999,0,9999,0
1715620396574,CLRE 259,A00,507211,Patel; Hemal,9996,0,9999,3
1715620397599,CLRE 260,A00,507221,Cuomo; Raphael Eduardo,9999,0,9999,0
1715620398638,CLRE 297,001,507242,Cuomo; Raphael Eduardo,9999,0,9999,0
1715620399663,COGS 197,001,638244,Voytek; Bradley Thomas,9997,0,9999,2
1715620400693,CSE 191,A00,516875,Minnes Kemp; Mor Mia,9991,0,9999,8
1715620401720,CSE 197,001,637388,Minnes Kemp; Mor Mia,9992,0,9999,7
1715620402757,CSS 201S,A01,494383,Mignozzetti; Umberto,35,0,35,0
1715620403784,CSS 202S,A01,494387,Mignozzetti; Umberto,35,0,35,0
1715620404812,DSC 197,001,628532,Eldridge; Justin Matthew,9995,0,9999,4
1715620405838,EAP 100,A00,516065,Staff,9799,0,9999,200
1715620406871,ECE 45,A01,507414,Staff,31,0,60,29
1715620408927,ECE 111,A01,507420,Staff,11,0,50,39
1715620409956,ECE 197,001,548057,Sievenpiper; Daniel F.,9991,0,9999,8
1715620410982,EDS 115,A00,507243,Choi; Bailey Miyeon,7,0,28,21
1715620412008,EDS 117,A01,494379,Staff,0,6,34,34
1715620413036,EDS 125,A00,507246,Hopkins; Megan Beth,8,0,30,22
1715620414066,EDS 128A,A01,507264,Fargason; Sharon Gayle,6,0,26,20
1715620415092,EDS 128B,A01,507293,Pappas; Elizabeth,10,0,30,20
1715620416119,EDS 139,A00,507294,Fargason; Sharon Gayle,10,0,30,20
1715620416119,EDS 139,B00,507313,Pappas; Elizabeth,11,0,30,19
1715620417146,EDS 201,A00,507315,Staff,10,0,30,20
1715620418170,EDS 203,A01,507317,Halter; Christopher P.,10,0,30,20
1715620419197,EDS 204R,A01,507319,Halter; Christopher P.,0,3,30,30
1715620419197,EDS 204R,B01,507331,Heinzman; Erica M.,14,0,30,16
1715620420222,EDS 206R,A00,507332,Staff,0,4,30,30
1715620420222,EDS 206R,B00,507343,Staff,15,0,30,15
1715620421247,EDS 250,A00,507344,Hemans; Patricia Ann Benitez,20,0,40,20
1715620422276,EDS 281,A00,507345,Daly; Alan J.,18,0,18,0
1715620423303,EDS 284,A00,507350,Daly; Alan J.,16,0,16,0
1715620424328,EDS 286,A00,507359,Fine; Sarah,18,0,18,0
1715620425354,EDS 289C,A01,507361,Daly; Alan J.,18,0,18,0
1715620426382,EDS 290,A00,507366,Hofstetter; Carolyn,15,0,15,0
1715620427418,LIGM 5A,A00,507421,Fischer-Grunski; Eva K,17,0,20,3
1715620428443,LIGM 5B,A00,507423,Fischer-Grunski; Eva K,19,0,20,1
1715620429471,LIGM 5C,A00,507425,Fischer-Grunski; Eva K,19,0,20,1
1715620430496,LIIT 5AS,A00,507427,Carnelos; Chiara,20,0,20,0
1715620431523,LIIT 5BS,A00,507430,Carnelos; Chiara,20,0,20,0
1715620432557,LIIT 5CS,A00,507432,Carnelos; Chiara,20,0,20,0
1715620433582,LISP 5A,A00,507541,Munoz Sanchez; Alicia,11,0,20,9
1715620434607,LISP 5B,A00,507671,Munoz Sanchez; Alicia,9,0,20,11
1715620435633,LISP 5C,A00,507696,Munoz Sanchez; Alicia,9,0,20,11
1715620436658,MAE 197,001,528363,Boechler; Nicholas Sebastia,9998,0,9999,1
1715620437688,MATH 197,001,523477,Kedlaya; Kiran S.,9994,0,9999,5
1715620437688,MATH 197,002,563811,Zhang; Danna,9994,0,9999,5
1715620437688,MATH 197,003,628552,Dumitriu; Ioana,9998,0,9999,1
1715620437688,MATH 197,004,660885,Floyd; Eric,9998,0,9999,1
1715620438714,MCWP 40R,A00,518780,Staff,2,0,20,18
1715620438714,MCWP 40R,B00,518781,Staff,11,0,20,9
1715620438714,MCWP 40R,C00,518783,Staff,5,0,20,15
1715620439741,MCWP 50R,A00,518791,Staff,0,1,20,20
1715620439741,MCWP 50R,B00,518792,Staff,0,2,20,20
1715620439741,MCWP 50R,C00,518793,Staff,0,4,20,20
1715620439741,MCWP 50R,D00,518794,Staff,0,1,20,20
1715620439741,MCWP 50R,E00,518795,Staff,0,2,20,20
1715620439741,MCWP 50R,F00,518796,Staff,0,1,20,20
1715620439741,MCWP 50R,G00,518797,Staff,0,1,20,20
1715620440768,MMW 12R,A01,514034,Herbst; Matthew,0,2,16,16
1715620440768,MMW 12R,A02,514035,Herbst; Matthew,0,0,16,16
1715620441793,MMW 13R,A01,514037,Staff,0,5,16,16
1715620441793,MMW 13R,A02,514039,Staff,0,5,16,16
1715620441793,MMW 13R,A03,628519,Staff,0,4,16,16
1715620443841,SIO 295LS,A00,523233,Staff,10,0,30,20
1715620444866,SIO 295S,A00,523232,Staff,10,0,30,20
1715620445894,SIOC 290S,A01,637330,Merrifield; Mark A,23,0,30,7
1715620446926,SIOC 291S,A01,637333,Gabriel; Corey John,23,0,30,7
1715620447955,SOCI 117,A01,494376,Staff,0,5,5,5
1715620448983,WES 237B,A00,494380,Staff,10,0,20,10
1715620451055,AESE 279B,A00,494370,Wade; Jon P,0,0,33,33
1715620452079,AIP 97,001,660915,Van Den Einde; Yael Dahlia,9998,0,9999,1
1715620453104,AIP 197,001,627712,Vespa; Emanuel Ignacio,9995,0,9999,4
1715620453104,AIP 197,002,650778,Amir; On,9998,0,9999,1
1715620453104,AIP 197,003,650933,Avenancio-Leon; Carlos,9998,0,9999,1
1715620453104,AIP 197,004,658530,Heyman; Gail D.,9998,0,9999,1
1715620453104,AIP 197,005,658631,Neal; Sonya E,9998,0,9999,1
1715620453104,AIP 197,006,658671,Du; Songzi,9998,0,9999,1
1715620454129,ANAR 135S,A00,494369,Braswell; Geoffrey E.,0,0,0,0
1715620455157,BENG 196,001,628496,Engler; Adam J.,9998,0,9999,1
1715620455157,BENG 196,002,660916,Watson; John Thomas,9999,0,9999,0
1715620456183,BISP 197,001,650773,Wilhelm; James E.,9994,0,9999,5
1715620456183,BISP 197,002,658904,Coleman; Aaron B.,9998,0,9999,1
1715620457209,CAT 124RS,A01,519847,Geibel; William,0,0,20,20
1715620458237,CAT 125RS,A01,515971,Geibel; William,0,0,20,20
1715620459264,CLRE 250,A00,511389,Morris; Sheldon,9992,0,9999,7
1715620460291,CLRE 251,A00,507176,Mehta; Ravindra L.,9992,0,9999,7
1715620460291,CLRE 251,B00,511410,Mehta; Ravindra L.,9998,0,9999,1
1715620461315,CLRE 252,A00,507189,Cuomo; Raphael Eduardo,9994,0,9999,5
1715620462340,CLRE 253,A00,507199,Vaida; Florin,9994,0,9999,5
1715620462340,CLRE 253,B00,507202,Vaida; Florin,9999,0,9999,0
1715620463365,CLRE 259,A00,507211,Patel; Hemal,9996,0,9999,3
1715620464391,CLRE 260,A00,507221,Cuomo; Raphael Eduardo,9999,0,9999,0
1715620465417,CLRE 297,001,507242,Cuomo; Raphael Eduardo,9999,0,9999,0
1715620466443,COGS 197,001,638244,Voytek; Bradley Thomas,9997,0,9999,2
1715620467471,CSE 191,A00,516875,Minnes Kemp; Mor Mia,9991,0,9999,8
1715620468495,CSE 197,001,637388,Minnes Kemp; Mor Mia,9992,0,9999,7
1715620469520,CSS 201S,A01,494383,Mignozzetti; Umberto,35,0,35,0
1715620470550,CSS 202S,A01,494387,Mignozzetti; Umberto,35,0,35,0
1715620471573,DSC 197,001,628532,Eldridge; Justin Matthew,9995,0,9999,4
1715620472600,EAP 100,A00,516065,Staff,9799,0,9999,200
1715620473633,ECE 45,A01,507414,Staff,31,0,60,29
1715620475683,ECE 111,A01,507420,Staff,11,0,50,39
1715620476710,ECE 197,001,548057,Sievenpiper; Daniel F.,9991,0,9999,8
1715620477735,EDS 115,A00,507243,Choi; Bailey Miyeon,7,0,28,21
1715620478761,EDS 117,A01,494379,Staff,0,6,34,34
1715620479790,EDS 125,A00,507246,Hopkins; Megan Beth,8,0,30,22
1715620480819,EDS 128A,A01,507264,Fargason; Sharon Gayle,6,0,26,20
1715620481845,EDS 128B,A01,507293,Pappas; Elizabeth,10,0,30,20
1715620482874,EDS 139,A00,507294,Fargason; Sharon Gayle,10,0,30,20
1715620482874,EDS 139,B00,507313,Pappas; Elizabeth,11,0,30,19
1715620483900,EDS 201,A00,507315,Staff,10,0,30,20
1715620484925,EDS 203,A01,507317,Halter; Christopher P.,10,0,30,20
1715620485950,EDS 204R,A01,507319,Halter; Christopher P.,0,3,30,30
1715620485950,EDS 204R,B01,507331,Heinzman; Erica M.,14,0,30,16
1715620487030,EDS 206R,A00,507332,Staff,0,4,30,30
1715620487030,EDS 206R,B00,507343,Staff,15,0,30,15
1715620488058,EDS 250,A00,507344,Hemans; Patricia Ann Benitez,20,0,40,20
1715620489086,EDS 281,A00,507345,Daly; Alan J.,18,0,18,0
1715620490113,EDS 284,A00,507350,Daly; Alan J.,16,0,16,0
1715620491138,EDS 286,A00,507359,Fine; Sarah,18,0,18,0
1715620492167,EDS 289C,A01,507361,Daly; Alan J.,18,0,18,0
1715620493195,EDS 290,A00,507366,Hofstetter; Carolyn,15,0,15,0
1715620494226,LIGM 5A,A00,507421,Fischer-Grunski; Eva K,17,0,20,3
1715620495252,LIGM 5B,A00,507423,Fischer-Grunski; Eva K,19,0,20,1
1715620496278,LIGM 5C,A00,507425,Fischer-Grunski; Eva K,19,0,20,1
1715620497303,LIIT 5AS,A00,507427,Carnelos; Chiara,20,0,20,0
1715620498328,LIIT 5BS,A00,507430,Carnelos; Chiara,20,0,20,0
1715620499355,LIIT 5CS,A00,507432,Carnelos; Chiara,20,0,20,0
1715620500380,LISP 5A,A00,507541,Munoz Sanchez; Alicia,11,0,20,9
1715620501409,LISP 5B,A00,507671,Munoz Sanchez; Alicia,9,0,20,11
1715620502437,LISP 5C,A00,507696,Munoz Sanchez; Alicia,9,0,20,11
1715620503461,MAE 197,001,528363,Boechler; Nicholas Sebastia,9998,0,9999,1
1715620504487,MATH 197,001,523477,Kedlaya; Kiran S.,9994,0,9999,5
1715620504487,MATH 197,002,563811,Zhang; Danna,9994,0,9999,5
1715620504487,MATH 197,003,628552,Dumitriu; Ioana,9998,0,9999,1
1715620504487,MATH 197,004,660885,Floyd; Eric,9998,0,9999,1
1715620505513,MCWP 40R,A00,518780,Staff,2,0,20,18
1715620505513,MCWP 40R,B00,518781,Staff,11,0,20,9
1715620505513,MCWP 40R,C00,518783,Staff,5,0,20,15
1715620506538,MCWP 50R,A00,518791,Staff,0,1,20,20
1715620506538,MCWP 50R,B00,518792,Staff,0,2,20,20
1715620506538,MCWP 50R,C00,518793,Staff,0,4,20,20
1715620506538,MCWP 50R,D00,518794,Staff,0,1,20,20
1715620506538,MCWP 50R,E00,518795,Staff,0,2,20,20
1715620506538,MCWP 50R,F00,518796,Staff,0,1,20,20
1715620506538,MCWP 50R,G00,518797,Staff,0,1,20,20
1715620507568,MMW 12R,A01,514034,Herbst; Matthew,0,2,16,16
1715620507568,MMW 12R,A02,514035,Herbst; Matthew,0,0,16,16
1715620508598,MMW 13R,A01,514037,Staff,0,5,16,16
1715620508598,MMW 13R,A02,514039,Staff,0,5,16,16
1715620508598,MMW 13R,A03,628519,Staff,0,4,16,16
1715620510650,SIO 295LS,A00,523233,Staff,10,0,30,20
1715620511679,SIO 295S,A00,523232,Staff,10,0,30,20
1715620512709,SIOC 290S,A01,637330,Merrifield; Mark A,23,0,30,7
1715620513735,SIOC 291S,A01,637333,Gabriel; Corey John,23,0,30,7
1715620514762,SOCI 117,A01,494376,Staff,0,5,5,5
1715620515787,WES 237B,A00,494380,Staff,10,0,20,10
1715620517849,AESE 279B,A00,494370,Wade; Jon P,0,0,33,33
1715620518877,AIP 97,001,660915,Van Den Einde; Yael Dahlia,9998,0,9999,1
1715620519902,AIP 197,001,627712,Vespa; Emanuel Ignacio,9995,0,9999,4
1715620519902,AIP 197,002,650778,Amir; On,9998,0,9999,1
1715620519902,AIP 197,003,650933,Avenancio-Leon; Carlos,9998,0,9999,1
1715620519902,AIP 197,004,658530,Heyman; Gail D.,9998,0,9999,1
1715620519902,AIP 197,005,658631,Neal; Sonya E,9998,0,9999,1
1715620519902,AIP 197,006,658671,Du; Songzi,9998,0,9999,1
1715620520931,ANAR 135S,A00,494369,Braswell; Geoffrey E.,0,0,0,0
1715620522012,BENG 196,001,628496,Engler; Adam J.,9998,0,9999,1
1715620522012,BENG 196,002,660916,Watson; John Thomas,9999,0,9999,0
1715620523043,BISP 197,001,650773,Wilhelm; James E.,9994,0,9999,5
1715620523043,BISP 197,002,658904,Coleman; Aaron B.,9998,0,9999,1
1715620524071,CAT 124RS,A01,519847,Geibel; William,0,0,20,20
1715620525099,CAT 125RS,A01,515971,Geibel; William,0,0,20,20
1715620526127,CLRE 250,A00,511389,Morris; Sheldon,9992,0,9999,7
1715620527154,CLRE 251,A00,507176,Mehta; Ravindra L.,9992,0,9999,7
1715620527154,CLRE 251,B00,511410,Mehta; Ravindra L.,9998,0,9999,1
1715620528184,CLRE 252,A00,507189,Cuomo; Raphael Eduardo,9994,0,9999,5
1715620529212,CLRE 253,A00,507199,Vaida; Florin,9994,0,9999,5
1715620529212,CLRE 253,B00,507202,Vaida; Florin,9999,0,9999,0
1715620530238,CLRE 259,A00,507211,Patel; Hemal,9996,0,9999,3
1715620531267,CLRE 260,A00,507221,Cuomo; Raphael Eduardo,9999,0,9999,0
1715620532296,CLRE 297,001,507242,Cuomo; Raphael Eduardo,9999,0,9999,0
1715620533323,COGS 197,001,638244,Voytek; Bradley Thomas,9997,0,9999,2
1715620534350,CSE 191,A00,516875,Minnes Kemp; Mor Mia,9991,0,9999,8
1715620535378,CSE 197,001,637388,Minnes Kemp; Mor Mia,9992,0,9999,7
1715620536409,CSS 201S,A01,494383,Mignozzetti; Umberto,35,0,35,0
1715620537438,CSS 202S,A01,494387,Mignozzetti; Umberto,35,0,35,0
1715620538463,DSC 197,001,628532,Eldridge; Justin Matthew,9995,0,9999,4
1715620539489,EAP 100,A00,516065,Staff,9799,0,9999,200
1715620540517,ECE 45,A01,507414,Staff,31,0,60,29
1715620542572,ECE 111,A01,507420,Staff,11,0,50,39
1715620543597,ECE 197,001,548057,Sievenpiper; Daniel F.,9991,0,9999,8
1715620544624,EDS 115,A00,507243,Choi; Bailey Miyeon,7,0,28,21
1715620545649,EDS 117,A01,494379,Staff,0,6,34,34
1715620546674,EDS 125,A00,507246,Hopkins; Megan Beth,8,0,30,22
1715620547698,EDS 128A,A01,507264,Fargason; Sharon Gayle,6,0,26,20
1715620548725,EDS 128B,A01,507293,Pappas; Elizabeth,10,0,30,20
1715620549766,EDS 139,A00,507294,Fargason; Sharon Gayle,10,0,30,20
1715620549766,EDS 139,B00,507313,Pappas; Elizabeth,11,0,30,19
1715620550794,EDS 201,A00,507315,Staff,10,0,30,20
1715620551819,EDS 203,A01,507317,Halter; Christopher P.,10,0,30,20
1715620552845,EDS 204R,A01,507319,Halter; Christopher P.,0,3,30,30
1715620552845,EDS 204R,B01,507331,Heinzman; Erica M.,14,0,30,16
1715620553879,EDS 206R,A00,507332,Staff,0,4,30,30
1715620553879,EDS 206R,B00,507343,Staff,15,0,30,15
1715620554904,EDS 250,A00,507344,Hemans; Patricia Ann Benitez,20,0,40,20
1715620555928,EDS 281,A00,507345,Daly; Alan J.,18,0,18,0
1715620556953,EDS 284,A00,507350,Daly; Alan J.,16,0,16,0
1715620557979,EDS 286,A00,507359,Fine; Sarah,18,0,18,0
1715620559005,EDS 289C,A01,507361,Daly; Alan J.,18,0,18,0
1715620560031,EDS 290,A00,507366,Hofstetter; Carolyn,15,0,15,0
1715620561059,LIGM 5A,A00,507421,Fischer-Grunski; Eva K,17,0,20,3
1715620562085,LIGM 5B,A00,507423,Fischer-Grunski; Eva K,19,0,20,1
1715620563109,LIGM 5C,A00,507425,Fischer-Grunski; Eva K,19,0,20,1
1715620564138,LIIT 5AS,A00,507427,Carnelos; Chiara,20,0,20,0
1715620565168,LIIT 5BS,A00,507430,Carnelos; Chiara,20,0,20,0
1715620566192,LIIT 5CS,A00,507432,Carnelos; Chiara,20,0,20,0
1715620567219,LISP 5A,A00,507541,Munoz Sanchez; Alicia,11,0,20,9
1715620568245,LISP 5B,A00,507671,Munoz Sanchez; Alicia,9,0,20,11
1715620569270,LISP 5C,A00,507696,Munoz Sanchez; Alicia,9,0,20,11
1715620570296,MAE 197,001,528363,Boechler; Nicholas Sebastia,9998,0,9999,1
1715620571323,MATH 197,001,523477,Kedlaya; Kiran S.,9994,0,9999,5
1715620571323,MATH 197,002,563811,Zhang; Danna,9994,0,9999,5
1715620571323,MATH 197,003,628552,Dumitriu; Ioana,9998,0,9999,1
1715620571323,MATH 197,004,660885,Floyd; Eric,9998,0,9999,1
1715620572353,MCWP 40R,A00,518780,Staff,2,0,20,18
1715620572353,MCWP 40R,B00,518781,Staff,11,0,20,9
1715620572353,MCWP 40R,C00,518783,Staff,5,0,20,15
1715620573380,MCWP 50R,A00,518791,Staff,0,1,20,20
1715620573380,MCWP 50R,B00,518792,Staff,0,2,20,20
1715620573380,MCWP 50R,C00,518793,Staff,0,4,20,20
1715620573380,MCWP 50R,D00,518794,Staff,0,1,20,20
1715620573380,MCWP 50R,E00,518795,Staff,0,2,20,20
1715620573380,MCWP 50R,F00,518796,Staff,0,1,20,20
1715620573380,MCWP 50R,G00,518797,Staff,0,1,20,20
1715620574407,MMW 12R,A01,514034,Herbst; Matthew,0,2,16,16
1715620574407,MMW 12R,A02,514035,Herbst; Matthew,0,0,16,16
1715620575434,MMW 13R,A01,514037,Staff,0,5,16,16
1715620575434,MMW 13R,A02,514039,Staff,0,5,16,16
1715620575434,MMW 13R,A03,628519,Staff,0,4,16,16
1715620577493,SIO 295LS,A00,523233,Staff,10,0,30,20
1715620578518,SIO 295S,A00,523232,Staff,10,0,30,20
1715620579546,SIOC 290S,A01,637330,Merrifield; Mark A,23,0,30,7
1715620580575,SIOC 291S,A01,637333,Gabriel; Corey John,23,0,30,7
1715620581606,SOCI 117,A01,494376,Staff,0,5,5,5
1715620582631,WES 237B,A00,494380,Staff,10,0,20,10
1715620584702,AESE 279B,A00,494370,Wade; Jon P,0,0,33,33
1715620585727,AIP 97,001,660915,Van Den Einde; Yael Dahlia,9998,0,9999,1
1715620586754,AIP 197,001,627712,Vespa; Emanuel Ignacio,9995,0,9999,4
1715620586754,AIP 197,002,650778,Amir; On,9998,0,9999,1
1715620586754,AIP 197,003,650933,Avenancio-Leon; Carlos,9998,0,9999,1
1715620586754,AIP 197,004,658530,Heyman; Gail D.,9998,0,9999,1
1715620586754,AIP 197,005,658631,Neal; Sonya E,9998,0,9999,1
1715620586754,AIP 197,006,658671,Du; Songzi,9998,0,9999,1
1715620587781,ANAR 135S,A00,494369,Braswell; Geoffrey E.,0,0,0,0
1715620588810,BENG 196,001,628496,Engler; Adam J.,9998,0,9999,1
1715620588810,BENG 196,002,660916,Watson; John Thomas,9999,0,9999,0
1715620589837,BISP 197,001,650773,Wilhelm; James E.,9994,0,9999,5
1715620589837,BISP 197,002,658904,Coleman; Aaron B.,9998,0,9999,1
1715620590887,CAT 124RS,A01,519847,Geibel; William,0,0,20,20
1715620591914,CAT 125RS,A01,515971,Geibel; William,0,0,20,20
1715620592943,CLRE 250,A00,511389,Morris; Sheldon,9992,0,9999,7
1715620593973,CLRE 251,A00,507176,Mehta; Ravindra L.,9992,0,9999,7
1715620593973,CLRE 251,B00,511410,Mehta; Ravindra L.,9998,0,9999,1
1715620595001,CLRE 252,A00,507189,Cuomo; Raphael Eduardo,9994,0,9999,5
1715620596025,CLRE 253,A00,507199,Vaida; Florin,9994,0,9999,5
1715620596025,CLRE 253,B00,507202,Vaida; Florin,9999,0,9999,0
1715620597053,CLRE 259,A00,507211,Patel; Hemal,9996,0,9999,3
1715620598079,CLRE 260,A00,507221,Cuomo; Raphael Eduardo,9999,0,9999,0
1715620599106,CLRE 297,001,507242,Cuomo; Raphael Eduardo,9999,0,9999,0
1715620600131,COGS 197,001,638244,Voytek; Bradley Thomas,9997,0,9999,2
1715620601157,CSE 191,A00,516875,Minnes Kemp; Mor Mia,9991,0,9999,8
1715620602196,CSE 197,001,637388,Minnes Kemp; Mor Mia,9992,0,9999,7
1715620603226,CSS 201S,A01,494383,Mignozzetti; Umberto,35,0,35,0
1715620604255,CSS 202S,A01,494387,Mignozzetti; Umberto,35,0,35,0
1715620605280,DSC 197,001,628532,Eldridge; Justin Matthew,9995,0,9999,4
1715620606306,EAP 100,A00,516065,Staff,9799,0,9999,200
1715620607332,ECE 45,A01,507414,Staff,31,0,60,29
1715620609386,ECE 111,A01,507420,Staff,11,0,50,39
1715620610410,ECE 197,001,548057,Sievenpiper; Daniel F.,9991,0,9999,8
1715620611437,EDS 115,A00,507243,Choi; Bailey Miyeon,7,0,28,21
1715620612466,EDS 117,A01,494379,Staff,0,6,34,34
1715620613490,EDS 125,A00,507246,Hopkins; Megan Beth,8,0,30,22
1715620614515,EDS 128A,A01,507264,Fargason; Sharon Gayle,6,0,26,20
1715620615540,EDS 128B,A01,507293,Pappas; Elizabeth,10,0,30,20
1715620616567,EDS 139,A00,507294,Fargason; Sharon Gayle,10,0,30,20
1715620616567,EDS 139,B00,507313,Pappas; Elizabeth,11,0,30,19
1715620617594,EDS 201,A00,507315,Staff,10,0,30,20
1715620618622,EDS 203,A01,507317,Halter; Christopher P.,10,0,30,20
1715620619648,EDS 204R,A01,507319,Halter; Christopher P.,0,3,30,30
1715620619648,EDS 204R,B01,507331,Heinzman; Erica M.,14,0,30,16
1715620620674,EDS 206R,A00,507332,Staff,0,4,30,30
1715620620674,EDS 206R,B00,507343,Staff,15,0,30,15
1715620621700,EDS 250,A00,507344,Hemans; Patricia Ann Benitez,20,0,40,20
1715620622726,EDS 281,A00,507345,Daly; Alan J.,18,0,18,0
1715620623751,EDS 284,A00,507350,Daly; Alan J.,16,0,16,0
1715620624779,EDS 286,A00,507359,Fine; Sarah,18,0,18,0
1715620625806,EDS 289C,A01,507361,Daly; Alan J.,18,0,18,0
1715620626835,EDS 290,A00,507366,Hofstetter; Carolyn,15,0,15,0
1715620627863,LIGM 5A,A00,507421,Fischer-Grunski; Eva K,17,0,20,3
1715620628893,LIGM 5B,A00,507423,Fischer-Grunski; Eva K,19,0,20,1
1715620629922,LIGM 5C,A00,507425,Fischer-Grunski; Eva K,19,0,20,1
1715620630952,LIIT 5AS,A00,507427,Carnelos; Chiara,20,0,20,0
1715620631978,LIIT 5BS,A00,507430,Carnelos; Chiara,20,0,20,0
1715620633005,LIIT 5CS,A00,507432,Carnelos; Chiara,20,0,20,0
1715620634028,LISP 5A,A00,507541,Munoz Sanchez; Alicia,11,0,20,9
1715620635054,LISP 5B,A00,507671,Munoz Sanchez; Alicia,9,0,20,11
1715620636081,LISP 5C,A00,507696,Munoz Sanchez; Alicia,9,0,20,11
1715620637107,MAE 197,001,528363,Boechler; Nicholas Sebastia,9998,0,9999,1
1715620638133,MATH 197,001,523477,Kedlaya; Kiran S.,9994,0,9999,5
1715620638133,MATH 197,002,563811,Zhang; Danna,9994,0,9999,5
1715620638133,MATH 197,003,628552,Dumitriu; Ioana,9998,0,9999,1
1715620638133,MATH 197,004,660885,Floyd; Eric,9998,0,9999,1
1715620639164,MCWP 40R,A00,518780,Staff,2,0,20,18
1715620639164,MCWP 40R,B00,518781,Staff,11,0,20,9
1715620639164,MCWP 40R,C00,518783,Staff,5,0,20,15
1715620640194,MCWP 50R,A00,518791,Staff,0,1,20,20
1715620640194,MCWP 50R,B00,518792,Staff,0,2,20,20
1715620640194,MCWP 50R,C00,518793,Staff,0,4,20,20
1715620640194,MCWP 50R,D00,518794,Staff,0,1,20,20
1715620640194,MCWP 50R,E00,518795,Staff,0,2,20,20
1715620640194,MCWP 50R,F00,518796,Staff,0,1,20,20
1715620640194,MCWP 50R,G00,518797,Staff,0,1,20,20
1715620641220,MMW 12R,A01,514034,Herbst; Matthew,0,2,16,16
1715620641220,MMW 12R,A02,514035,Herbst; Matthew,0,0,16,16
1715620642250,MMW 13R,A01,514037,Staff,0,5,16,16
1715620642250,MMW 13R,A02,514039,Staff,0,5,16,16
1715620642250,MMW 13R,A03,628519,Staff,0,4,16,16
1715620644310,SIO 295LS,A00,523233,Staff,10,0,30,20
1715620645335,SIO 295S,A00,523232,Staff,10,0,30,20
1715620646362,SIOC 290S,A01,637330,Merrifield; Mark A,23,0,30,7
1715620647391,SIOC 291S,A01,637333,Gabriel; Corey John,23,0,30,7
1715620648418,SOCI 117,A01,494376,Staff,0,5,5,5
1715620649447,WES 237B,A00,494380,Staff,10,0,20,10
1715620651507,AESE 279B,A00,494370,Wade; Jon P,0,0,33,33
1715620652538,AIP 97,001,660915,Van Den Einde; Yael Dahlia,9998,0,9999,1
1715620653568,AIP 197,001,627712,Vespa; Emanuel Ignacio,9995,0,9999,4
1715620653568,AIP 197,002,650778,Amir; On,9998,0,9999,1
1715620653568,AIP 197,003,650933,Avenancio-Leon; Carlos,9998,0,9999,1
1715620653568,AIP 197,004,658530,Heyman; Gail D.,9998,0,9999,1
1715620653568,AIP 197,005,658631,Neal; Sonya E,9998,0,9999,1
1715620653568,AIP 197,006,658671,Du; Songzi,9998,0,9999,1
1715620654598,ANAR 135S,A00,494369,Braswell; Geoffrey E.,0,0,0,0
1715620655628,BENG 196,001,628496,Engler; Adam J.,9998,0,9999,1
1715620655628,BENG 196,002,660916,Watson; John Thomas,9999,0,9999,0
1715620656657,BISP 197,001,650773,Wilhelm; James E.,9994,0,9999,5
1715620656657,BISP 197,002,658904,Coleman; Aaron B.,9998,0,9999,1
1715620657685,CAT 124RS,A01,519847,Geibel; William,0,0,20,20
1715620658711,CAT 125RS,A01,515971,Geibel; William,0,0,20,20
1715620659736,CLRE 250,A00,511389,Morris; Sheldon,9992,0,9999,7
1715620660762,CLRE 251,A00,507176,Mehta; Ravindra L.,9992,0,9999,7
1715620660762,CLRE 251,B00,511410,Mehta; Ravindra L.,9998,0,9999,1
1715620661789,CLRE 252,A00,507189,Cuomo; Raphael Eduardo,9994,0,9999,5
1715620662818,CLRE 253,A00,507199,Vaida; Florin,9994,0,9999,5
1715620662818,CLRE 253,B00,507202,Vaida; Florin,9999,0,9999,0
1715620663846,CLRE 259,A00,507211,Patel; Hemal,9996,0,9999,3
1715620664871,CLRE 260,A00,507221,Cuomo; Raphael Eduardo,9999,0,9999,0
1715620665898,CLRE 297,001,507242,Cuomo; Raphael Eduardo,9999,0,9999,0
1715620666928,COGS 197,001,638244,Voytek; Bradley Thomas,9997,0,9999,2
1715620667953,CSE 191,A00,516875,Minnes Kemp; Mor Mia,9991,0,9999,8
1715620668979,CSE 197,001,637388,Minnes Kemp; Mor Mia,9992,0,9999,7
1715620670011,CSS 201S,A01,494383,Mignozzetti; Umberto,35,0,35,0
1715620671040,CSS 202S,A01,494387,Mignozzetti; Umberto,35,0,35,0
1715620672067,DSC 197,001,628532,Eldridge; Justin Matthew,9995,0,9999,4
1715620673091,EAP 100,A00,516065,Staff,9799,0,9999,200
1715620674122,ECE 45,A01,507414,Staff,31,0,60,29
1715620676173,ECE 111,A01,507420,Staff,11,0,50,39
1715620677200,ECE 197,001,548057,Sievenpiper; Daniel F.,9991,0,9999,8
1715620678229,EDS 115,A00,507243,Choi; Bailey Miyeon,7,0,28,21
1715620679256,EDS 117,A01,494379,Staff,0,6,34,34
1715620680286,EDS 125,A00,507246,Hopkins; Megan Beth,8,0,30,22
1715620681313,EDS 128A,A01,507264,Fargason; Sharon Gayle,6,0,26,20
1715620682340,EDS 128B,A01,507293,Pappas; Elizabeth,10,0,30,20
1715620683368,EDS 139,A00,507294,Fargason; Sharon Gayle,10,0,30,20
1715620683368,EDS 139,B00,507313,Pappas; Elizabeth,11,0,30,19
1715620684395,EDS 201,A00,507315,Staff,10,0,30,20
1715620685424,EDS 203,A01,507317,Halter; Christopher P.,10,0,30,20
1715620686455,EDS 204R,A01,507319,Halter; Christopher P.,0,3,30,30
1715620686455,EDS 204R,B01,507331,Heinzman; Erica M.,14,0,30,16
1715620687484,EDS 206R,A00,507332,Staff,0,4,30,30
1715620687484,EDS 206R,B00,507343,Staff,15,0,30,15
1715620688510,EDS 250,A00,507344,Hemans; Patricia Ann Benitez,20,0,40,20
1715620689539,EDS 281,A00,507345,Daly; Alan J.,18,0,18,0
1715620690564,EDS 284,A00,507350,Daly; Alan J.,16,0,16,0
1715620691591,EDS 286,A00,507359,Fine; Sarah,18,0,18,0
1715620692616,EDS 289C,A01,507361,Daly; Alan J.,18,0,18,0
1715620693643,EDS 290,A00,507366,Hofstetter; Carolyn,15,0,15,0
1715620694675,LIGM 5A,A00,507421,Fischer-Grunski; Eva K,17,0,20,3
1715620695704,LIGM 5B,A00,507423,Fischer-Grunski; Eva K,19,0,20,1
1715620696735,LIGM 5C,A00,507425,Fischer-Grunski; Eva K,19,0,20,1
1715620697763,LIIT 5AS,A00,507427,Carnelos; Chiara,20,0,20,0
1715620698789,LIIT 5BS,A00,507430,Carnelos; Chiara,20,0,20,0
1715620699814,LIIT 5CS,A00,507432,Carnelos; Chiara,20,0,20,0
1715620700838,LISP 5A,A00,507541,Munoz Sanchez; Alicia,11,0,20,9
1715620701865,LISP 5B,A00,507671,Munoz Sanchez; Alicia,9,0,20,11
1715620702891,LISP 5C,A00,507696,Munoz Sanchez; Alicia,9,0,20,11
1715620703914,MAE 197,001,528363,Boechler; Nicholas Sebastia,9998,0,9999,1
1715620704941,MATH 197,001,523477,Kedlaya; Kiran S.,9994,0,9999,5
1715620704941,MATH 197,002,563811,Zhang; Danna,9994,0,9999,5
1715620704941,MATH 197,003,628552,Dumitriu; Ioana,9998,0,9999,1
1715620704941,MATH 197,004,660885,Floyd; Eric,9998,0,9999,1
1715620705966,MCWP 40R,A00,518780,Staff,2,0,20,18
1715620705966,MCWP 40R,B00,518781,Staff,11,0,20,9
1715620705966,MCWP 40R,C00,518783,Staff,5,0,20,15
1715620706991,MCWP 50R,A00,518791,Staff,0,1,20,20
1715620706991,MCWP 50R,B00,518792,Staff,0,2,20,20
1715620706991,MCWP 50R,C00,518793,Staff,0,4,20,20
1715620706991,MCWP 50R,D00,518794,Staff,0,1,20,20
1715620706991,MCWP 50R,E00,518795,Staff,0,2,20,20
1715620706991,MCWP 50R,F00,518796,Staff,0,1,20,20
1715620706991,MCWP 50R,G00,518797,Staff,0,1,20,20
1715620708020,MMW 12R,A01,514034,Herbst; Matthew,0,2,16,16
1715620708020,MMW 12R,A02,514035,Herbst; Matthew,0,0,16,16
1715620709049,MMW 13R,A01,514037,Staff,0,5,16,16
1715620709049,MMW 13R,A02,514039,Staff,0,5,16,16
1715620709049,MMW 13R,A03,628519,Staff,0,4,16,16
1715620711103,SIO 295LS,A00,523233,Staff,10,0,30,20
1715620712130,SIO 295S,A00,523232,Staff,10,0,30,20
1715620713156,SIOC 290S,A01,637330,Merrifield; Mark A,23,0,30,7
1715620714181,SIOC 291S,A01,637333,Gabriel; Corey John,23,0,30,7
1715620715208,SOCI 117,A01,494376,Staff,0,5,5,5
1715620716236,WES 237B,A00,494380,Staff,10,0,20,10
1715620718307,AESE 279B,A00,494370,Wade; Jon P,0,0,33,33
1715620719332,AIP 97,001,660915,Van Den Einde; Yael Dahlia,9998,0,9999,1
1715620720360,AIP 197,001,627712,Vespa; Emanuel Ignacio,9995,0,9999,4
1715620720360,AIP 197,002,650778,Amir; On,9998,0,9999,1
1715620720360,AIP 197,003,650933,Avenancio-Leon; Carlos,9998,0,9999,1
1715620720360,AIP 197,004,658530,Heyman; Gail D.,9998,0,9999,1
1715620720360,AIP 197,005,658631,Neal; Sonya E,9998,0,9999,1
1715620720360,AIP 197,006,658671,Du; Songzi,9998,0,9999,1
1715620721385,ANAR 135S,A00,494369,Braswell; Geoffrey E.,0,0,0,0
1715620722411,BENG 196,001,628496,Engler; Adam J.,9998,0,9999,1
1715620722411,BENG 196,002,660916,Watson; John Thomas,9999,0,9999,0
1715620723441,BISP 197,001,650773,Wilhelm; James E.,9994,0,9999,5
1715620723441,BISP 197,002,658904,Coleman; Aaron B.,9998,0,9999,1
1715620724466,CAT 124RS,A01,519847,Geibel; William,0,0,20,20
1715620725495,CAT 125RS,A01,515971,Geibel; William,0,0,20,20
1715620726519,CLRE 250,A00,511389,Morris; Sheldon,9992,0,9999,7
1715620727548,CLRE 251,A00,507176,Mehta; Ravindra L.,9992,0,9999,7
1715620727548,CLRE 251,B00,511410,Mehta; Ravindra L.,9998,0,9999,1
1715620728575,CLRE 252,A00,507189,Cuomo; Raphael Eduardo,9994,0,9999,5
1715620729599,CLRE 253,A00,507199,Vaida; Florin,9994,0,9999,5
1715620729599,CLRE 253,B00,507202,Vaida; Florin,9999,0,9999,0
1715620730627,CLRE 259,A00,507211,Patel; Hemal,9996,0,9999,3
1715620731656,CLRE 260,A00,507221,Cuomo; Raphael Eduardo,9999,0,9999,0
1715620732682,CLRE 297,001,507242,Cuomo; Raphael Eduardo,9999,0,9999,0
1715620733710,COGS 197,001,638244,Voytek; Bradley Thomas,9997,0,9999,2
1715620734735,CSE 191,A00,516875,Minnes Kemp; Mor Mia,9991,0,9999,8
1715620735761,CSE 197,001,637388,Minnes Kemp; Mor Mia,9992,0,9999,7
1715620736796,CSS 201S,A01,494383,Mignozzetti; Umberto,35,0,35,0
1715620737823,CSS 202S,A01,494387,Mignozzetti; Umberto,35,0,35,0
1715620738849,DSC 197,001,628532,Eldridge; Justin Matthew,9995,0,9999,4
1715620739875,EAP 100,A00,516065,Staff,9799,0,9999,200
1715620740902,ECE 45,A01,507414,Staff,31,0,60,29
1715620742959,ECE 111,A01,507420,Staff,11,0,50,39
1715620743984,ECE 197,001,548057,Sievenpiper; Daniel F.,9991,0,9999,8
1715620745012,EDS 115,A00,507243,Choi; Bailey Miyeon,7,0,28,21
1715620746044,EDS 117,A01,494379,Staff,0,6,34,34
1715620747071,EDS 125,A00,507246,Hopkins; Megan Beth,8,0,30,22
1715620748100,EDS 128A,A01,507264,Fargason; Sharon Gayle,6,0,26,20
1715620749126,EDS 128B,A01,507293,Pappas; Elizabeth,10,0,30,20
1715620750153,EDS 139,A00,507294,Fargason; Sharon Gayle,10,0,30,20
1715620750153,EDS 139,B00,507313,Pappas; Elizabeth,11,0,30,19
1715620751181,EDS 201,A00,507315,Staff,10,0,30,20
1715620752207,EDS 203,A01,507317,Halter; Christopher P.,10,0,30,20
1715620753237,EDS 204R,A01,507319,Halter; Christopher P.,0,3,30,30
1715620753237,EDS 204R,B01,507331,Heinzman; Erica M.,14,0,30,16
1715620754262,EDS 206R,A00,507332,Staff,0,4,30,30
1715620754262,EDS 206R,B00,507343,Staff,15,0,30,15
1715620755290,EDS 250,A00,507344,Hemans; Patricia Ann Benitez,20,0,40,20
1715620756316,EDS 281,A00,507345,Daly; Alan J.,18,0,18,0
1715620757342,EDS 284,A00,507350,Daly; Alan J.,16,0,16,0
1715620758370,EDS 286,A00,507359,Fine; Sarah,18,0,18,0
1715620759395,EDS 289C,A01,507361,Daly; Alan J.,18,0,18,0
1715620760420,EDS 290,A00,507366,Hofstetter; Carolyn,15,0,15,0
1715620761450,LIGM 5A,A00,507421,Fischer-Grunski; Eva K,17,0,20,3
1715620762479,LIGM 5B,A00,507423,Fischer-Grunski; Eva K,19,0,20,1
1715620763508,LIGM 5C,A00,507425,Fischer-Grunski; Eva K,19,0,20,1
1715620764537,LIIT 5AS,A00,507427,Carnelos; Chiara,20,0,20,0
1715620765563,LIIT 5BS,A00,507430,Carnelos; Chiara,20,0,20,0
1715620766589,LIIT 5CS,A00,507432,Carnelos; Chiara,20,0,20,0
1715620767618,LISP 5A,A00,507541,Munoz Sanchez; Alicia,11,0,20,9
1715620768647,LISP 5B,A00,507671,Munoz Sanchez; Alicia,9,0,20,11
1715620769673,LISP 5C,A00,507696,Munoz Sanchez; Alicia,9,0,20,11
1715620770702,MAE 197,001,528363,Boechler; Nicholas Sebastia,9998,0,9999,1
1715620771728,MATH 197,001,523477,Kedlaya; Kiran S.,9994,0,9999,5
1715620771728,MATH 197,002,563811,Zhang; Danna,9994,0,9999,5
1715620771728,MATH 197,003,628552,Dumitriu; Ioana,9998,0,9999,1
1715620771728,MATH 197,004,660885,Floyd; Eric,9998,0,9999,1
1715620772758,MCWP 40R,A00,518780,Staff,2,0,20,18
1715620772758,MCWP 40R,B00,518781,Staff,11,0,20,9
1715620772758,MCWP 40R,C00,518783,Staff,5,0,20,15
1715620773783,MCWP 50R,A00,518791,Staff,0,1,20,20
1715620773783,MCWP 50R,B00,518792,Staff,0,2,20,20
1715620773783,MCWP 50R,C00,518793,Staff,0,4,20,20
1715620773783,MCWP 50R,D00,518794,Staff,0,1,20,20
1715620773783,MCWP 50R,E00,518795,Staff,0,2,20,20
1715620773783,MCWP 50R,F00,518796,Staff,0,1,20,20
1715620773783,MCWP 50R,G00,518797,Staff,0,1,20,20
1715620774809,MMW 12R,A01,514034,Herbst; Matthew,0,2,16,16
1715620774809,MMW 12R,A02,514035,Herbst; Matthew,0,0,16,16
1715620775839,MMW 13R,A01,514037,Staff,0,5,16,16
1715620775839,MMW 13R,A02,514039,Staff,0,5,16,16
1715620775839,MMW 13R,A03,628519,Staff,0,4,16,16
1715620777893,SIO 295LS,A00,523233,Staff,10,0,30,20
1715620778919,SIO 295S,A00,523232,Staff,10,0,30,20
1715620779946,SIOC 290S,A01,637330,Merrifield; Mark A,23,0,30,7
1715620780974,SIOC 291S,A01,637333,Gabriel; Corey John,23,0,30,7
1715620782000,SOCI 117,A01,494376,Staff,0,5,5,5
1715620783027,WES 237B,A00,494380,Staff,10,0,20,10
1715620785109,AESE 279B,A00,494370,Wade; Jon P,0,0,33,33
1715620786136,AIP 97,001,660915,Van Den Einde; Yael Dahlia,9998,0,9999,1
1715620787166,AIP 197,001,627712,Vespa; Emanuel Ignacio,9995,0,9999,4
1715620787166,AIP 197,002,650778,Amir; On,9998,0,9999,1
1715620787166,AIP 197,003,650933,Avenancio-Leon; Carlos,9998,0,9999,1
1715620787166,AIP 197,004,658530,Heyman; Gail D.,9998,0,9999,1
1715620787166,AIP 197,005,658631,Neal; Sonya E,9998,0,9999,1
1715620787166,AIP 197,006,658671,Du; Songzi,9998,0,9999,1
1715620788195,ANAR 135S,A00,494369,Braswell; Geoffrey E.,0,0,0,0
1715620789224,BENG 196,001,628496,Engler; Adam J.,9998,0,9999,1
1715620789224,BENG 196,002,660916,Watson; John Thomas,9999,0,9999,0
1715620790250,BISP 197,001,650773,Wilhelm; James E.,9994,0,9999,5
1715620790250,BISP 197,002,658904,Coleman; Aaron B.,9998,0,9999,1
1715620791278,CAT 124RS,A01,519847,Geibel; William,0,0,20,20
1715620792309,CAT 125RS,A01,515971,Geibel; William,0,0,20,20
1715620793337,CLRE 250,A00,511389,Morris; Sheldon,9992,0,9999,7
1715620794361,CLRE 251,A00,507176,Mehta; Ravindra L.,9992,0,9999,7
1715620794361,CLRE 251,B00,511410,Mehta; Ravindra L.,9998,0,9999,1
1715620795387,CLRE 252,A00,507189,Cuomo; Raphael Eduardo,9994,0,9999,5
1715620796413,CLRE 253,A00,507199,Vaida; Florin,9994,0,9999,5
1715620796413,CLRE 253,B00,507202,Vaida; Florin,9999,0,9999,0
1715620797439,CLRE 259,A00,507211,Patel; Hemal,9996,0,9999,3
1715620798463,CLRE 260,A00,507221,Cuomo; Raphael Eduardo,9999,0,9999,0
1715620799491,CLRE 297,001,507242,Cuomo; Raphael Eduardo,9999,0,9999,0
1715620800517,COGS 197,001,638244,Voytek; Bradley Thomas,9997,0,9999,2
1715620801544,CSE 191,A00,516875,Minnes Kemp; Mor Mia,9991,0,9999,8
1715620802569,CSE 197,001,637388,Minnes Kemp; Mor Mia,9992,0,9999,7
1715620803600,CSS 201S,A01,494383,Mignozzetti; Umberto,35,0,35,0
1715620804632,CSS 202S,A01,494387,Mignozzetti; Umberto,35,0,35,0
1715620805660,DSC 197,001,628532,Eldridge; Justin Matthew,9995,0,9999,4
1715620806684,EAP 100,A00,516065,Staff,9799,0,9999,200
1715620807713,ECE 45,A01,507414,Staff,31,0,60,29
1715620809769,ECE 111,A01,507420,Staff,11,0,50,39
1715620810798,ECE 197,001,548057,Sievenpiper; Daniel F.,9991,0,9999,8
1715620811824,EDS 115,A00,507243,Choi; Bailey Miyeon,7,0,28,21
1715620812851,EDS 117,A01,494379,Staff,0,6,34,34
1715620813882,EDS 125,A00,507246,Hopkins; Megan Beth,8,0,30,22
1715620814906,EDS 128A,A01,507264,Fargason; Sharon Gayle,6,0,26,20
1715620815935,EDS 128B,A01,507293,Pappas; Elizabeth,10,0,30,20
1715620816963,EDS 139,A00,507294,Fargason; Sharon Gayle,10,0,30,20
1715620816963,EDS 139,B00,507313,Pappas; Elizabeth,11,0,30,19
1715620817986,EDS 201,A00,507315,Staff,10,0,30,20
1715620819015,EDS 203,A01,507317,Halter; Christopher P.,10,0,30,20
1715620820039,EDS 204R,A01,507319,Halter; Christopher P.,0,3,30,30
1715620820039,EDS 204R,B01,507331,Heinzman; Erica M.,14,0,30,16
1715620821065,EDS 206R,A00,507332,Staff,0,4,30,30
1715620821065,EDS 206R,B00,507343,Staff,15,0,30,15
1715620822093,EDS 250,A00,507344,Hemans; Patricia Ann Benitez,20,0,40,20
1715620823121,EDS 281,A00,507345,Daly; Alan J.,18,0,18,0
1715620824147,EDS 284,A00,507350,Daly; Alan J.,16,0,16,0
1715620825176,EDS 286,A00,507359,Fine; Sarah,18,0,18,0
1715620826202,EDS 289C,A01,507361,Daly; Alan J.,18,0,18,0
1715620827231,EDS 290,A00,507366,Hofstetter; Carolyn,15,0,15,0
1715620828262,LIGM 5A,A00,507421,Fischer-Grunski; Eva K,17,0,20,3
1715620829290,LIGM 5B,A00,507423,Fischer-Grunski; Eva K,19,0,20,1
1715620830315,LIGM 5C,A00,507425,Fischer-Grunski; Eva K,19,0,20,1
1715620831344,LIIT 5AS,A00,507427,Carnelos; Chiara,20,0,20,0
1715620832372,LIIT 5BS,A00,507430,Carnelos; Chiara,20,0,20,0
1715620833398,LIIT 5CS,A00,507432,Carnelos; Chiara,20,0,20,0
1715620834424,LISP 5A,A00,507541,Munoz Sanchez; Alicia,11,0,20,9
1715620835450,LISP 5B,A00,507671,Munoz Sanchez; Alicia,9,0,20,11
1715620836475,LISP 5C,A00,507696,Munoz Sanchez; Alicia,9,0,20,11
1715620837503,MAE 197,001,528363,Boechler; Nicholas Sebastia,9998,0,9999,1
1715620838530,MATH 197,001,523477,Kedlaya; Kiran S.,9994,0,9999,5
1715620838530,MATH 197,002,563811,Zhang; Danna,9994,0,9999,5
1715620838530,MATH 197,003,628552,Dumitriu; Ioana,9998,0,9999,1
1715620838530,MATH 197,004,660885,Floyd; Eric,9998,0,9999,1
1715620839559,MCWP 40R,A00,518780,Staff,2,0,20,18
1715620839559,MCWP 40R,B00,518781,Staff,11,0,20,9
1715620839559,MCWP 40R,C00,518783,Staff,5,0,20,15
1715620840585,MCWP 50R,A00,518791,Staff,0,1,20,20
1715620840585,MCWP 50R,B00,518792,Staff,0,2,20,20
1715620840585,MCWP 50R,C00,518793,Staff,0,4,20,20
1715620840585,MCWP 50R,D00,518794,Staff,0,1,20,20
1715620840585,MCWP 50R,E00,518795,Staff,0,2,20,20
1715620840585,MCWP 50R,F00,518796,Staff,0,1,20,20
1715620840585,MCWP 50R,G00,518797,Staff,0,1,20,20
1715620841615,MMW 12R,A01,514034,Herbst; Matthew,0,2,16,16
1715620841615,MMW 12R,A02,514035,Herbst; Matthew,0,0,16,16
1715620842640,MMW 13R,A01,514037,Staff,0,5,16,16
1715620842640,MMW 13R,A02,514039,Staff,0,5,16,16
1715620842640,MMW 13R,A03,628519,Staff,0,4,16,16
1715620844699,SIO 295LS,A00,523233,Staff,10,0,30,20
1715620845722,SIO 295S,A00,523232,Staff,10,0,30,20
1715620846749,SIOC 290S,A01,637330,Merrifield; Mark A,23,0,30,7
1715620847778,SIOC 291S,A01,637333,Gabriel; Corey John,23,0,30,7
1715620848803,SOCI 117,A01,494376,Staff,0,5,5,5
1715620849828,WES 237B,A00,494380,Staff,10,0,20,10
1715620851883,AESE 279B,A00,494370,Wade; Jon P,0,0,33,33
1715620852912,AIP 97,001,660915,Van Den Einde; Yael Dahlia,9998,0,9999,1
1715620853943,AIP 197,001,627712,Vespa; Emanuel Ignacio,9995,0,9999,4
1715620853943,AIP 197,002,650778,Amir; On,9998,0,9999,1
1715620853943,AIP 197,003,650933,Avenancio-Leon; Carlos,9998,0,9999,1
1715620853943,AIP 197,004,658530,Heyman; Gail D.,9998,0,9999,1
1715620853943,AIP 197,005,658631,Neal; Sonya E,9998,0,9999,1
1715620853943,AIP 197,006,658671,Du; Songzi,9998,0,9999,1
1715620854969,ANAR 135S,A00,494369,Braswell; Geoffrey E.,0,0,0,0
1715620855998,BENG 196,001,628496,Engler; Adam J.,9998,0,9999,1
1715620855998,BENG 196,002,660916,Watson; John Thomas,9999,0,9999,0
1715620857027,BISP 197,001,650773,Wilhelm; James E.,9994,0,9999,5
1715620857027,BISP 197,002,658904,Coleman; Aaron B.,9998,0,9999,1
1715620858053,CAT 124RS,A01,519847,Geibel; William,0,0,20,20
1715620859079,CAT 125RS,A01,515971,Geibel; William,0,0,20,20
1715620860104,CLRE 250,A00,511389,Morris; Sheldon,9992,0,9999,7
1715620861137,CLRE 251,A00,507176,Mehta; Ravindra L.,9992,0,9999,7
1715620861137,CLRE 251,B00,511410,Mehta; Ravindra L.,9998,0,9999,1
1715620862163,CLRE 252,A00,507189,Cuomo; Raphael Eduardo,9994,0,9999,5
1715620863189,CLRE 253,A00,507199,Vaida; Florin,9994,0,9999,5
1715620863189,CLRE 253,B00,507202,Vaida; Florin,9999,0,9999,0
1715620864215,CLRE 259,A00,507211,Patel; Hemal,9996,0,9999,3
1715620865242,CLRE 260,A00,507221,Cuomo; Raphael Eduardo,9999,0,9999,0
1715620866268,CLRE 297,001,507242,Cuomo; Raphael Eduardo,9999,0,9999,0
1715620867293,COGS 197,001,638244,Voytek; Bradley Thomas,9997,0,9999,2
1715620868321,CSE 191,A00,516875,Minnes Kemp; Mor Mia,9991,0,9999,8
1715620869345,CSE 197,001,637388,Minnes Kemp; Mor Mia,9992,0,9999,7
1715620870372,CSS 201S,A01,494383,Mignozzetti; Umberto,35,0,35,0
1715620871402,CSS 202S,A01,494387,Mignozzetti; Umberto,35,0,35,0
1715620872430,DSC 197,001,628532,Eldridge; Justin Matthew,9995,0,9999,4
1715620873456,EAP 100,A00,516065,Staff,9799,0,9999,200
1715620874483,ECE 45,A01,507414,Staff,31,0,60,29
1715620876538,ECE 111,A01,507420,Staff,11,0,50,39
1715620877562,ECE 197,001,548057,Sievenpiper; Daniel F.,9991,0,9999,8
1715620878588,EDS 115,A00,507243,Choi; Bailey Miyeon,7,0,28,21
1715620879616,EDS 117,A01,494379,Staff,0,6,34,34
1715620880643,EDS 125,A00,507246,Hopkins; Megan Beth,8,0,30,22
1715620881672,EDS 128A,A01,507264,Fargason; Sharon Gayle,6,0,26,20
1715620882697,EDS 128B,A01,507293,Pappas; Elizabeth,10,0,30,20
1715620883723,EDS 139,A00,507294,Fargason; Sharon Gayle,10,0,30,20
1715620883723,EDS 139,B00,507313,Pappas; Elizabeth,11,0,30,19
1715620884754,EDS 201,A00,507315,Staff,10,0,30,20
1715620885782,EDS 203,A01,507317,Halter; Christopher P.,10,0,30,20
1715620886808,EDS 204R,A01,507319,Halter; Christopher P.,0,3,30,30
1715620886808,EDS 204R,B01,507331,Heinzman; Erica M.,14,0,30,16
1715620887836,EDS 206R,A00,507332,Staff,0,4,30,30
1715620887836,EDS 206R,B00,507343,Staff,15,0,30,15
1715620888862,EDS 250,A00,507344,Hemans; Patricia Ann Benitez,20,0,40,20
1715620889887,EDS 281,A00,507345,Daly; Alan J.,18,0,18,0
1715620890917,EDS 284,A00,507350,Daly; Alan J.,16,0,16,0
1715620891942,EDS 286,A00,507359,Fine; Sarah,18,0,18,0
1715620892969,EDS 289C,A01,507361,Daly; Alan J.,18,0,18,0
1715620893996,EDS 290,A00,507366,Hofstetter; Carolyn,15,0,15,0
1715620895021,LIGM 5A,A00,507421,Fischer-Grunski; Eva K,17,0,20,3
1715620896048,LIGM 5B,A00,507423,Fischer-Grunski; Eva K,19,0,20,1
1715620897077,LIGM 5C,A00,507425,Fischer-Grunski; Eva K,19,0,20,1
1715620898103,LIIT 5AS,A00,507427,Carnelos; Chiara,20,0,20,0
1715620899130,LIIT 5BS,A00,507430,Carnelos; Chiara,20,0,20,0
1715620900156,LIIT 5CS,A00,507432,Carnelos; Chiara,20,0,20,0
1715620901187,LISP 5A,A00,507541,Munoz Sanchez; Alicia,11,0,20,9
1715620902213,LISP 5B,A00,507671,Munoz Sanchez; Alicia,9,0,20,11
1715620903242,LISP 5C,A00,507696,Munoz Sanchez; Alicia,9,0,20,11
1715620904268,MAE 197,001,528363,Boechler; Nicholas Sebastia,9998,0,9999,1
1715620905294,MATH 197,001,523477,Kedlaya; Kiran S.,9994,0,9999,5
1715620905294,MATH 197,002,563811,Zhang; Danna,9994,0,9999,5
1715620905294,MATH 197,003,628552,Dumitriu; Ioana,9998,0,9999,1
1715620905294,MATH 197,004,660885,Floyd; Eric,9998,0,9999,1
1715620906320,MCWP 40R,A00,518780,Staff,2,0,20,18
1715620906320,MCWP 40R,B00,518781,Staff,11,0,20,9
1715620906320,MCWP 40R,C00,518783,Staff,5,0,20,15
1715620907350,MCWP 50R,A00,518791,Staff,0,1,20,20
1715620907350,MCWP 50R,B00,518792,Staff,0,2,20,20
1715620907350,MCWP 50R,C00,518793,Staff,0,4,20,20
1715620907350,MCWP 50R,D00,518794,Staff,0,1,20,20
1715620907350,MCWP 50R,E00,518795,Staff,0,2,20,20
1715620907350,MCWP 50R,F00,518796,Staff,0,1,20,20
1715620907350,MCWP 50R,G00,518797,Staff,0,1,20,20
1715620908379,MMW 12R,A01,514034,Herbst; Matthew,0,2,16,16
1715620908379,MMW 12R,A02,514035,Herbst; Matthew,0,0,16,16
1715620909405,MMW 13R,A01,514037,Staff,0,5,16,16
1715620909405,MMW 13R,A02,514039,Staff,0,5,16,16
1715620909405,MMW 13R,A03,628519,Staff,0,4,16,16
1715620911460,SIO 295LS,A00,523233,Staff,10,0,30,20
1715620912488,SIO 295S,A00,523232,Staff,10,0,30,20
1715620913516,SIOC 290S,A01,637330,Merrifield; Mark A,23,0,30,7
1715620914545,SIOC 291S,A01,637333,Gabriel; Corey John,23,0,30,7
1715620915572,SOCI 117,A01,494376,Staff,0,5,5,5
1715620916599,WES 237B,A00,494380,Staff,10,0,20,10
1715620918676,AESE 279B,A00,494370,Wade; Jon P,0,0,33,33
1715620919701,AIP 97,001,660915,Van Den Einde; Yael Dahlia,9998,0,9999,1
1715620920732,AIP 197,001,627712,Vespa; Emanuel Ignacio,9995,0,9999,4
1715620920732,AIP 197,002,650778,Amir; On,9998,0,9999,1
1715620920732,AIP 197,003,650933,Avenancio-Leon; Carlos,9998,0,9999,1
1715620920732,AIP 197,004,658530,Heyman; Gail D.,9998,0,9999,1
1715620920732,AIP 197,005,658631,Neal; Sonya E,9998,0,9999,1
1715620920732,AIP 197,006,658671,Du; Songzi,9998,0,9999,1
1715620921758,ANAR 135S,A00,494369,Braswell; Geoffrey E.,0,0,0,0
1715620922784,BENG 196,001,628496,Engler; Adam J.,9998,0,9999,1
1715620922784,BENG 196,002,660916,Watson; John Thomas,9999,0,9999,0
1715620923811,BISP 197,001,650773,Wilhelm; James E.,9994,0,9999,5
1715620923811,BISP 197,002,658904,Coleman; Aaron B.,9998,0,9999,1
1715620924836,CAT 124RS,A01,519847,Geibel; William,0,0,20,20
1715620925863,CAT 125RS,A01,515971,Geibel; William,0,0,20,20
1715620926887,CLRE 250,A00,511389,Morris; Sheldon,9992,0,9999,7
1715620927917,CLRE 251,A00,507176,Mehta; Ravindra L.,9992,0,9999,7
1715620927917,CLRE 251,B00,511410,Mehta; Ravindra L.,9998,0,9999,1
1715620928943,CLRE 252,A00,507189,Cuomo; Raphael Eduardo,9994,0,9999,5
1715620929971,CLRE 253,A00,507199,Vaida; Florin,9994,0,9999,5
1715620929971,CLRE 253,B00,507202,Vaida; Florin,9999,0,9999,0
1715620930999,CLRE 259,A00,507211,Patel; Hemal,9996,0,9999,3
1715620932025,CLRE 260,A00,507221,Cuomo; Raphael Eduardo,9999,0,9999,0
1715620933053,CLRE 297,001,507242,Cuomo; Raphael Eduardo,9999,0,9999,0
1715620934082,COGS 197,001,638244,Voytek; Bradley Thomas,9997,0,9999,2
1715620935111,CSE 191,A00,516875,Minnes Kemp; Mor Mia,9991,0,9999,8
1715620936135,CSE 197,001,637388,Minnes Kemp; Mor Mia,9992,0,9999,7
1715620937163,CSS 201S,A01,494383,Mignozzetti; Umberto,35,0,35,0
1715620938187,CSS 202S,A01,494387,Mignozzetti; Umberto,35,0,35,0
1715620939213,DSC 197,001,628532,Eldridge; Justin Matthew,9995,0,9999,4
1715620940238,EAP 100,A00,516065,Staff,9799,0,9999,200
1715620941271,ECE 45,A01,507414,Staff,31,0,60,29
1715620943324,ECE 111,A01,507420,Staff,11,0,50,39
1715620944353,ECE 197,001,548057,Sievenpiper; Daniel F.,9991,0,9999,8
1715620945378,EDS 115,A00,507243,Choi; Bailey Miyeon,7,0,28,21
1715620946403,EDS 117,A01,494379,Staff,0,6,34,34
1715620947427,EDS 125,A00,507246,Hopkins; Megan Beth,8,0,30,22
1715620948455,EDS 128A,A01,507264,Fargason; Sharon Gayle,6,0,26,20
1715620949483,EDS 128B,A01,507293,Pappas; Elizabeth,10,0,30,20
1715620950512,EDS 139,A00,507294,Fargason; Sharon Gayle,10,0,30,20
1715620950512,EDS 139,B00,507313,Pappas; Elizabeth,11,0,30,19
1715620951536,EDS 201,A00,507315,Staff,10,0,30,20
1715620952563,EDS 203,A01,507317,Halter; Christopher P.,10,0,30,20
1715620953590,EDS 204R,A01,507319,Halter; Christopher P.,0,3,30,30
1715620953590,EDS 204R,B01,507331,Heinzman; Erica M.,14,0,30,16
1715620954615,EDS 206R,A00,507332,Staff,0,4,30,30
1715620954615,EDS 206R,B00,507343,Staff,15,0,30,15
1715620955641,EDS 250,A00,507344,Hemans; Patricia Ann Benitez,20,0,40,20
1715620956667,EDS 281,A00,507345,Daly; Alan J.,18,0,18,0
1715620957693,EDS 284,A00,507350,Daly; Alan J.,16,0,16,0
1715620958720,EDS 286,A00,507359,Fine; Sarah,18,0,18,0
1715620959746,EDS 289C,A01,507361,Daly; Alan J.,18,0,18,0
1715620960771,EDS 290,A00,507366,Hofstetter; Carolyn,15,0,15,0
1715620961797,LIGM 5A,A00,507421,Fischer-Grunski; Eva K,17,0,20,3
1715620962825,LIGM 5B,A00,507423,Fischer-Grunski; Eva K,19,0,20,1
1715620963852,LIGM 5C,A00,507425,Fischer-Grunski; Eva K,19,0,20,1
1715620964881,LIIT 5AS,A00,507427,Carnelos; Chiara,20,0,20,0
1715620965907,LIIT 5BS,A00,507430,Carnelos; Chiara,20,0,20,0
1715620966937,LIIT 5CS,A00,507432,Carnelos; Chiara,20,0,20,0
1715620967967,LISP 5A,A00,507541,Munoz Sanchez; Alicia,11,0,20,9
1715620968996,LISP 5B,A00,507671,Munoz Sanchez; Alicia,9,0,20,11
1715620970021,LISP 5C,A00,507696,Munoz Sanchez; Alicia,9,0,20,11
1715620971051,MAE 197,001,528363,Boechler; Nicholas Sebastia,9998,0,9999,1
1715620972077,MATH 197,001,523477,Kedlaya; Kiran S.,9994,0,9999,5
1715620972077,MATH 197,002,563811,Zhang; Danna,9994,0,9999,5
1715620972077,MATH 197,003,628552,Dumitriu; Ioana,9998,0,9999,1
1715620972077,MATH 197,004,660885,Floyd; Eric,9998,0,9999,1
1715620973107,MCWP 40R,A00,518780,Staff,2,0,20,18
1715620973107,MCWP 40R,B00,518781,Staff,11,0,20,9
1715620973107,MCWP 40R,C00,518783,Staff,5,0,20,15
1715620974136,MCWP 50R,A00,518791,Staff,0,1,20,20
1715620974136,MCWP 50R,B00,518792,Staff,0,2,20,20
1715620974136,MCWP 50R,C00,518793,Staff,0,4,20,20
1715620974136,MCWP 50R,D00,518794,Staff,0,1,20,20
1715620974136,MCWP 50R,E00,518795,Staff,0,2,20,20
1715620974136,MCWP 50R,F00,518796,Staff,0,1,20,20
1715620974136,MCWP 50R,G00,518797,Staff,0,1,20,20
1715620975163,MMW 12R,A01,514034,Herbst; Matthew,0,2,16,16
1715620975163,MMW 12R,A02,514035,Herbst; Matthew,0,0,16,16
1715620976190,MMW 13R,A01,514037,Staff,0,5,16,16
1715620976190,MMW 13R,A02,514039,Staff,0,5,16,16
1715620976190,MMW 13R,A03,628519,Staff,0,4,16,16
1715620978249,SIO 295LS,A00,523233,Staff,10,0,30,20
1715620979278,SIO 295S,A00,523232,Staff,10,0,30,20
1715620980305,SIOC 290S,A01,637330,Merrifield; Mark A,23,0,30,7
1715620981329,SIOC 291S,A01,637333,Gabriel; Corey John,23,0,30,7
1715620982355,SOCI 117,A01,494376,Staff,0,5,5,5
1715620983384,WES 237B,A00,494380,Staff,10,0,20,10
1715620985449,AESE 279B,A00,494370,Wade; Jon P,0,0,33,33
1715620986474,AIP 97,001,660915,Van Den Einde; Yael Dahlia,9998,0,9999,1
1715620987500,AIP 197,001,627712,Vespa; Emanuel Ignacio,9995,0,9999,4
1715620987500,AIP 197,002,650778,Amir; On,9998,0,9999,1
1715620987500,AIP 197,003,650933,Avenancio-Leon; Carlos,9998,0,9999,1
1715620987500,AIP 197,004,658530,Heyman; Gail D.,9998,0,9999,1
1715620987500,AIP 197,005,658631,Neal; Sonya E,9998,0,9999,1
1715620987500,AIP 197,006,658671,Du; Songzi,9998,0,9999,1
1715620988526,ANAR 135S,A00,494369,Braswell; Geoffrey E.,0,0,0,0
1715620989554,BENG 196,001,628496,Engler; Adam J.,9998,0,9999,1
1715620989554,BENG 196,002,660916,Watson; John Thomas,9999,0,9999,0
1715620990582,BISP 197,001,650773,Wilhelm; James E.,9994,0,9999,5
1715620990582,BISP 197,002,658904,Coleman; Aaron B.,9998,0,9999,1
1715620991663,CAT 124RS,A01,519847,Geibel; William,0,0,20,20
1715620992691,CAT 125RS,A01,515971,Geibel; William,0,0,20,20
1715620993718,CLRE 250,A00,511389,Morris; Sheldon,9992,0,9999,7
1715620994748,CLRE 251,A00,507176,Mehta; Ravindra L.,9992,0,9999,7
1715620994748,CLRE 251,B00,511410,Mehta; Ravindra L.,9998,0,9999,1
1715620995775,CLRE 252,A00,507189,Cuomo; Raphael Eduardo,9994,0,9999,5
1715620996800,CLRE 253,A00,507199,Vaida; Florin,9994,0,9999,5
1715620996800,CLRE 253,B00,507202,Vaida; Florin,9999,0,9999,0
1715620997826,CLRE 259,A00,507211,Patel; Hemal,9996,0,9999,3
1715620998852,CLRE 260,A00,507221,Cuomo; Raphael Eduardo,9999,0,9999,0
1715620999879,CLRE 297,001,507242,Cuomo; Raphael Eduardo,9999,0,9999,0
1715621000905,COGS 197,001,638244,Voytek; Bradley Thomas,9997,0,9999,2
1715621001931,CSE 191,A00,516875,Minnes Kemp; Mor Mia,9991,0,9999,8
1715621002957,CSE 197,001,637388,Minnes Kemp; Mor Mia,9992,0,9999,7
1715621003990,CSS 201S,A01,494383,Mignozzetti; Umberto,35,0,35,0
1715621005019,CSS 202S,A01,494387,Mignozzetti; Umberto,35,0,35,0
1715621006045,DSC 197,001,628532,Eldridge; Justin Matthew,9995,0,9999,4
1715621007071,EAP 100,A00,516065,Staff,9799,0,9999,200
1715621008098,ECE 45,A01,507414,Staff,31,0,60,29
1715621010148,ECE 111,A01,507420,Staff,11,0,50,39
1715621011177,ECE 197,001,548057,Sievenpiper; Daniel F.,9991,0,9999,8
1715621012207,EDS 115,A00,507243,Choi; Bailey Miyeon,7,0,28,21
1715621013234,EDS 117,A01,494379,Staff,0,6,34,34
1715621014264,EDS 125,A00,507246,Hopkins; Megan Beth,8,0,30,22
1715621015293,EDS 128A,A01,507264,Fargason; Sharon Gayle,6,0,26,20
1715621016318,EDS 128B,A01,507293,Pappas; Elizabeth,10,0,30,20
1715621017347,EDS 139,A00,507294,Fargason; Sharon Gayle,10,0,30,20
1715621017347,EDS 139,B00,507313,Pappas; Elizabeth,11,0,30,19
1715621018374,EDS 201,A00,507315,Staff,10,0,30,20
1715621019402,EDS 203,A01,507317,Halter; Christopher P.,10,0,30,20
1715621020428,EDS 204R,A01,507319,Halter; Christopher P.,0,3,30,30
1715621020428,EDS 204R,B01,507331,Heinzman; Erica M.,14,0,30,16
1715621021453,EDS 206R,A00,507332,Staff,0,4,30,30
1715621021453,EDS 206R,B00,507343,Staff,15,0,30,15
1715621022480,EDS 250,A00,507344,Hemans; Patricia Ann Benitez,20,0,40,20
1715621023506,EDS 281,A00,507345,Daly; Alan J.,18,0,18,0
1715621024530,EDS 284,A00,507350,Daly; Alan J.,16,0,16,0
1715621025559,EDS 286,A00,507359,Fine; Sarah,18,0,18,0
1715621026586,EDS 289C,A01,507361,Daly; Alan J.,18,0,18,0
1715621027612,EDS 290,A00,507366,Hofstetter; Carolyn,15,0,15,0
1715621028640,LIGM 5A,A00,507421,Fischer-Grunski; Eva K,17,0,20,3
1715621029669,LIGM 5B,A00,507423,Fischer-Grunski; Eva K,19,0,20,1
1715621030697,LIGM 5C,A00,507425,Fischer-Grunski; Eva K,19,0,20,1
1715621031722,LIIT 5AS,A00,507427,Carnelos; Chiara,20,0,20,0
1715621032747,LIIT 5BS,A00,507430,Carnelos; Chiara,20,0,20,0
1715621033773,LIIT 5CS,A00,507432,Carnelos; Chiara,20,0,20,0
1715621034799,LISP 5A,A00,507541,Munoz Sanchez; Alicia,11,0,20,9
1715621035822,LISP 5B,A00,507671,Munoz Sanchez; Alicia,9,0,20,11
1715621036848,LISP 5C,A00,507696,Munoz Sanchez; Alicia,9,0,20,11
1715621037873,MAE 197,001,528363,Boechler; Nicholas Sebastia,9998,0,9999,1
1715621038902,MATH 197,001,523477,Kedlaya; Kiran S.,9994,0,9999,5
1715621038902,MATH 197,002,563811,Zhang; Danna,9994,0,9999,5
1715621038902,MATH 197,003,628552,Dumitriu; Ioana,9998,0,9999,1
1715621038902,MATH 197,004,660885,Floyd; Eric,9998,0,9999,1
1715621039927,MCWP 40R,A00,518780,Staff,2,0,20,18
1715621039927,MCWP 40R,B00,518781,Staff,11,0,20,9
1715621039927,MCWP 40R,C00,518783,Staff,5,0,20,15
1715621040957,MCWP 50R,A00,518791,Staff,0,1,20,20
1715621040957,MCWP 50R,B00,518792,Staff,0,2,20,20
1715621040957,MCWP 50R,C00,518793,Staff,0,4,20,20
1715621040957,MCWP 50R,D00,518794,Staff,0,1,20,20
1715621040957,MCWP 50R,E00,518795,Staff,0,2,20,20
1715621040957,MCWP 50R,F00,518796,Staff,0,1,20,20
1715621040957,MCWP 50R,G00,518797,Staff,0,1,20,20
1715621041981,MMW 12R,A01,514034,Herbst; Matthew,0,2,16,16
1715621041981,MMW 12R,A02,514035,Herbst; Matthew,0,0,16,16
1715621043006,MMW 13R,A01,514037,Staff,0,5,16,16
1715621043006,MMW 13R,A02,514039,Staff,0,5,16,16
1715621043006,MMW 13R,A03,628519,Staff,0,4,16,16
1715621045058,SIO 295LS,A00,523233,Staff,10,0,30,20
1715621046084,SIO 295S,A00,523232,Staff,10,0,30,20
1715621047110,SIOC 290S,A01,637330,Merrifield; Mark A,23,0,30,7
1715621048139,SIOC 291S,A01,637333,Gabriel; Corey John,23,0,30,7
1715621049165,SOCI 117,A01,494376,Staff,0,5,5,5
1715621050194,WES 237B,A00,494380,Staff,10,0,20,10
1715621052256,AESE 279B,A00,494370,Wade; Jon P,0,0,33,33
1715621053282,AIP 97,001,660915,Van Den Einde; Yael Dahlia,9998,0,9999,1
1715621054309,AIP 197,001,627712,Vespa; Emanuel Ignacio,9995,0,9999,4
1715621054309,AIP 197,002,650778,Amir; On,9998,0,9999,1
1715621054309,AIP 197,003,650933,Avenancio-Leon; Carlos,9998,0,9999,1
1715621054309,AIP 197,004,658530,Heyman; Gail D.,9998,0,9999,1
1715621054309,AIP 197,005,658631,Neal; Sonya E,9998,0,9999,1
1715621054309,AIP 197,006,658671,Du; Songzi,9998,0,9999,1
1715621055334,ANAR 135S,A00,494369,Braswell; Geoffrey E.,0,0,0,0
1715621056360,BENG 196,001,628496,Engler; Adam J.,9998,0,9999,1
1715621056360,BENG 196,002,660916,Watson; John Thomas,9999,0,9999,0
1715621057385,BISP 197,001,650773,Wilhelm; James E.,9994,0,9999,5
1715621057385,BISP 197,002,658904,Coleman; Aaron B.,9998,0,9999,1
1715621058415,CAT 124RS,A01,519847,Geibel; William,0,0,20,20
1715621059440,CAT 125RS,A01,515971,Geibel; William,0,0,20,20
1715621060465,CLRE 250,A00,511389,Morris; Sheldon,9992,0,9999,7
1715621061492,CLRE 251,A00,507176,Mehta; Ravindra L.,9992,0,9999,7
1715621061492,CLRE 251,B00,511410,Mehta; Ravindra L.,9998,0,9999,1
1715621062520,CLRE 252,A00,507189,Cuomo; Raphael Eduardo,9994,0,9999,5
1715621063545,CLRE 253,A00,507199,Vaida; Florin,9994,0,9999,5
1715621063545,CLRE 253,B00,507202,Vaida; Florin,9999,0,9999,0
1715621064571,CLRE 259,A00,507211,Patel; Hemal,9996,0,9999,3
1715621065596,CLRE 260,A00,507221,Cuomo; Raphael Eduardo,9999,0,9999,0
1715621066621,CLRE 297,001,507242,Cuomo; Raphael Eduardo,9999,0,9999,0
1715621067647,COGS 197,001,638244,Voytek; Bradley Thomas,9997,0,9999,2
1715621068672,CSE 191,A00,516875,Minnes Kemp; Mor Mia,9991,0,9999,8
1715621069697,CSE 197,001,637388,Minnes Kemp; Mor Mia,9992,0,9999,7
1715621070725,CSS 201S,A01,494383,Mignozzetti; Umberto,35,0,35,0
1715621071751,CSS 202S,A01,494387,Mignozzetti; Umberto,35,0,35,0
1715621072776,DSC 197,001,628532,Eldridge; Justin Matthew,9995,0,9999,4
1715621073801,EAP 100,A00,516065,Staff,9799,0,9999,200
1715621074833,ECE 45,A01,507414,Staff,31,0,60,29
1715621076891,ECE 111,A01,507420,Staff,11,0,50,39
1715621077918,ECE 197,001,548057,Sievenpiper; Daniel F.,9991,0,9999,8
1715621078943,EDS 115,A00,507243,Choi; Bailey Miyeon,7,0,28,21
1715621079969,EDS 117,A01,494379,Staff,0,6,34,34
1715621080994,EDS 125,A00,507246,Hopkins; Megan Beth,8,0,30,22
1715621082023,EDS 128A,A01,507264,Fargason; Sharon Gayle,6,0,26,20
1715621083048,EDS 128B,A01,507293,Pappas; Elizabeth,10,0,30,20
1715621084077,EDS 139,A00,507294,Fargason; Sharon Gayle,10,0,30,20
1715621084077,EDS 139,B00,507313,Pappas; Elizabeth,11,0,30,19
1715621085106,EDS 201,A00,507315,Staff,10,0,30,20
1715621086136,EDS 203,A01,507317,Halter; Christopher P.,10,0,30,20
1715621087162,EDS 204R,A01,507319,Halter; Christopher P.,0,3,30,30
1715621087162,EDS 204R,B01,507331,Heinzman; Erica M.,14,0,30,16
1715621088187,EDS 206R,A00,507332,Staff,0,4,30,30
1715621088187,EDS 206R,B00,507343,Staff,15,0,30,15
1715621089214,EDS 250,A00,507344,Hemans; Patricia Ann Benitez,20,0,40,20
1715621090239,EDS 281,A00,507345,Daly; Alan J.,18,0,18,0
1715621091264,EDS 284,A00,507350,Daly; Alan J.,16,0,16,0
1715621092290,EDS 286,A00,507359,Fine; Sarah,18,0,18,0
1715621093316,EDS 289C,A01,507361,Daly; Alan J.,18,0,18,0
1715621094342,EDS 290,A00,507366,Hofstetter; Carolyn,15,0,15,0
1715621095428,LIGM 5A,A00,507421,Fischer-Grunski; Eva K,17,0,20,3
1715621096454,LIGM 5B,A00,507423,Fischer-Grunski; Eva K,19,0,20,1
1715621097481,LIGM 5C,A00,507425,Fischer-Grunski; Eva K,19,0,20,1
1715621098508,LIIT 5AS,A00,507427,Carnelos; Chiara,20,0,20,0
1715621099534,LIIT 5BS,A00,507430,Carnelos; Chiara,20,0,20,0
1715621100557,LIIT 5CS,A00,507432,Carnelos; Chiara,20,0,20,0
1715621101582,LISP 5A,A00,507541,Munoz Sanchez; Alicia,11,0,20,9
1715621102608,LISP 5B,A00,507671,Munoz Sanchez; Alicia,9,0,20,11
1715621103638,LISP 5C,A00,507696,Munoz Sanchez; Alicia,9,0,20,11
1715621104672,MAE 197,001,528363,Boechler; Nicholas Sebastia,9998,0,9999,1
1715621105698,MATH 197,001,523477,Kedlaya; Kiran S.,9994,0,9999,5
1715621105698,MATH 197,002,563811,Zhang; Danna,9994,0,9999,5
1715621105698,MATH 197,003,628552,Dumitriu; Ioana,9998,0,9999,1
1715621105698,MATH 197,004,660885,Floyd; Eric,9998,0,9999,1
1715621106726,MCWP 40R,A00,518780,Staff,2,0,20,18
1715621106726,MCWP 40R,B00,518781,Staff,11,0,20,9
1715621106726,MCWP 40R,C00,518783,Staff,5,0,20,15
1715621107752,MCWP 50R,A00,518791,Staff,0,1,20,20
1715621107752,MCWP 50R,B00,518792,Staff,0,2,20,20
1715621107752,MCWP 50R,C00,518793,Staff,0,4,20,20
1715621107752,MCWP 50R,D00,518794,Staff,0,1,20,20
1715621107752,MCWP 50R,E00,518795,Staff,0,2,20,20
1715621107752,MCWP 50R,F00,518796,Staff,0,1,20,20
1715621107752,MCWP 50R,G00,518797,Staff,0,1,20,20
1715621108778,MMW 12R,A01,514034,Herbst; Matthew,0,2,16,16
1715621108778,MMW 12R,A02,514035,Herbst; Matthew,0,0,16,16
1715621109803,MMW 13R,A01,514037,Staff,0,5,16,16
1715621109803,MMW 13R,A02,514039,Staff,0,5,16,16
1715621109803,MMW 13R,A03,628519,Staff,0,4,16,16
1715621111856,SIO 295LS,A00,523233,Staff,10,0,30,20
1715621112882,SIO 295S,A00,523232,Staff,10,0,30,20
1715621113908,SIOC 290S,A01,637330,Merrifield; Mark A,23,0,30,7
1715621114938,SIOC 291S,A01,637333,Gabriel; Corey John,23,0,30,7
1715621115964,SOCI 117,A01,494376,Staff,0,5,5,5
1715621116991,WES 237B,A00,494380,Staff,10,0,20,10
1715621119056,AESE 279B,A00,494370,Wade; Jon P,0,0,33,33
1715621120082,AIP 97,001,660915,Van Den Einde; Yael Dahlia,9998,0,9999,1
1715621121108,AIP 197,001,627712,Vespa; Emanuel Ignacio,9995,0,9999,4
1715621121108,AIP 197,002,650778,Amir; On,9998,0,9999,1
1715621121108,AIP 197,003,650933,Avenancio-Leon; Carlos,9998,0,9999,1
1715621121108,AIP 197,004,658530,Heyman; Gail D.,9998,0,9999,1
1715621121108,AIP 197,005,658631,Neal; Sonya E,9998,0,9999,1
1715621121108,AIP 197,006,658671,Du; Songzi,9998,0,9999,1
1715621122136,ANAR 135S,A00,494369,Braswell; Geoffrey E.,0,0,0,0
1715621123163,BENG 196,001,628496,Engler; Adam J.,9998,0,9999,1
1715621123163,BENG 196,002,660916,Watson; John Thomas,9999,0,9999,0
1715621124190,BISP 197,001,650773,Wilhelm; James E.,9994,0,9999,5
1715621124190,BISP 197,002,658904,Coleman; Aaron B.,9998,0,9999,1
1715621125218,CAT 124RS,A01,519847,Geibel; William,0,0,20,20
1715621126245,CAT 125RS,A01,515971,Geibel; William,0,0,20,20
1715621127271,CLRE 250,A00,511389,Morris; Sheldon,9992,0,9999,7
1715621128297,CLRE 251,A00,507176,Mehta; Ravindra L.,9992,0,9999,7
1715621128297,CLRE 251,B00,511410,Mehta; Ravindra L.,9998,0,9999,1
1715621129326,CLRE 252,A00,507189,Cuomo; Raphael Eduardo,9994,0,9999,5
1715621130353,CLRE 253,A00,507199,Vaida; Florin,9994,0,9999,5
1715621130353,CLRE 253,B00,507202,Vaida; Florin,9999,0,9999,0
1715621131380,CLRE 259,A00,507211,Patel; Hemal,9996,0,9999,3
1715621132407,CLRE 260,A00,507221,Cuomo; Raphael Eduardo,9999,0,9999,0
1715621133435,CLRE 297,001,507242,Cuomo; Raphael Eduardo,9999,0,9999,0
1715621134464,COGS 197,001,638244,Voytek; Bradley Thomas,9997,0,9999,2
1715621135490,CSE 191,A00,516875,Minnes Kemp; Mor Mia,9991,0,9999,8
1715621136516,CSE 197,001,637388,Minnes Kemp; Mor Mia,9992,0,9999,7
1715621137544,CSS 201S,A01,494383,Mignozzetti; Umberto,35,0,35,0
1715621138575,CSS 202S,A01,494387,Mignozzetti; Umberto,35,0,35,0
1715621139605,DSC 197,001,628532,Eldridge; Justin Matthew,9995,0,9999,4
1715621140633,EAP 100,A00,516065,Staff,9799,0,9999,200
1715621141669,ECE 45,A01,507414,Staff,31,0,60,29
1715621143728,ECE 111,A01,507420,Staff,11,0,50,39
1715621144755,ECE 197,001,548057,Sievenpiper; Daniel F.,9991,0,9999,8
1715621145787,EDS 115,A00,507243,Choi; Bailey Miyeon,7,0,28,21
1715621146817,EDS 117,A01,494379,Staff,0,6,34,34
1715621147842,EDS 125,A00,507246,Hopkins; Megan Beth,8,0,30,22
1715621148871,EDS 128A,A01,507264,Fargason; Sharon Gayle,6,0,26,20
1715621149899,EDS 128B,A01,507293,Pappas; Elizabeth,10,0,30,20
1715621150925,EDS 139,A00,507294,Fargason; Sharon Gayle,10,0,30,20
1715621150925,EDS 139,B00,507313,Pappas; Elizabeth,11,0,30,19
1715621151952,EDS 201,A00,507315,Staff,10,0,30,20
1715621152983,EDS 203,A01,507317,Halter; Christopher P.,10,0,30,20
1715621154008,EDS 204R,A01,507319,Halter; Christopher P.,0,3,30,30
1715621154008,EDS 204R,B01,507331,Heinzman; Erica M.,14,0,30,16
1715621155035,EDS 206R,A00,507332,Staff,0,4,30,30
1715621155035,EDS 206R,B00,507343,Staff,15,0,30,15
1715621156060,EDS 250,A00,507344,Hemans; Patricia Ann Benitez,20,0,40,20
1715621157088,EDS 281,A00,507345,Daly; Alan J.,18,0,18,0
1715621158115,EDS 284,A00,507350,Daly; Alan J.,16,0,16,0
1715621159140,EDS 286,A00,507359,Fine; Sarah,18,0,18,0
1715621160163,EDS 289C,A01,507361,Daly; Alan J.,18,0,18,0
1715621161187,EDS 290,A00,507366,Hofstetter; Carolyn,15,0,15,0
1715621162213,LIGM 5A,A00,507421,Fischer-Grunski; Eva K,17,0,20,3
1715621163238,LIGM 5B,A00,507423,Fischer-Grunski; Eva K,19,0,20,1
1715621164268,LIGM 5C,A00,507425,Fischer-Grunski; Eva K,19,0,20,1
1715621165295,LIIT 5AS,A00,507427,Carnelos; Chiara,20,0,20,0
1715621166322,LIIT 5BS,A00,507430,Carnelos; Chiara,20,0,20,0
1715621167349,LIIT 5CS,A00,507432,Carnelos; Chiara,20,0,20,0
1715621168374,LISP 5A,A00,507541,Munoz Sanchez; Alicia,11,0,20,9
1715621169402,LISP 5B,A00,507671,Munoz Sanchez; Alicia,9,0,20,11
1715621170427,LISP 5C,A00,507696,Munoz Sanchez; Alicia,9,0,20,11
1715621171452,MAE 197,001,528363,Boechler; Nicholas Sebastia,9998,0,9999,1
1715621172478,MATH 197,001,523477,Kedlaya; Kiran S.,9994,0,9999,5
1715621172478,MATH 197,002,563811,Zhang; Danna,9994,0,9999,5
1715621172478,MATH 197,003,628552,Dumitriu; Ioana,9998,0,9999,1
1715621172478,MATH 197,004,660885,Floyd; Eric,9998,0,9999,1
1715621173507,MCWP 40R,A00,518780,Staff,2,0,20,18
1715621173507,MCWP 40R,B00,518781,Staff,11,0,20,9
1715621173507,MCWP 40R,C00,518783,Staff,5,0,20,15
1715621174530,MCWP 50R,A00,518791,Staff,0,1,20,20
1715621174530,MCWP 50R,B00,518792,Staff,0,2,20,20
1715621174530,MCWP 50R,C00,518793,Staff,0,4,20,20
1715621174530,MCWP 50R,D00,518794,Staff,0,1,20,20
1715621174530,MCWP 50R,E00,518795,Staff,0,2,20,20
1715621174530,MCWP 50R,F00,518796,Staff,0,1,20,20
1715621174530,MCWP 50R,G00,518797,Staff,0,1,20,20
1715621175559,MMW 12R,A01,514034,Herbst; Matthew,0,2,16,16
1715621175559,MMW 12R,A02,514035,Herbst; Matthew,0,0,16,16
1715621176584,MMW 13R,A01,514037,Staff,0,5,16,16
1715621176584,MMW 13R,A02,514039,Staff,0,5,16,16
1715621176584,MMW 13R,A03,628519,Staff,0,4,16,16
1715621178636,SIO 295LS,A00,523233,Staff,10,0,30,20
1715621179661,SIO 295S,A00,523232,Staff,10,0,30,20
1715621180687,SIOC 290S,A01,637330,Merrifield; Mark A,23,0,30,7
1715621181712,SIOC 291S,A01,637333,Gabriel; Corey John,23,0,30,7
1715621182736,SOCI 117,A01,494376,Staff,0,5,5,5
1715621183762,WES 237B,A00,494380,Staff,10,0,20,10
1715621185837,AESE 279B,A00,494370,Wade; Jon P,0,0,33,33
1715621186865,AIP 97,001,660915,Van Den Einde; Yael Dahlia,9998,0,9999,1
1715621187891,AIP 197,001,627712,Vespa; Emanuel Ignacio,9995,0,9999,4
1715621187891,AIP 197,002,650778,Amir; On,9998,0,9999,1
1715621187891,AIP 197,003,650933,Avenancio-Leon; Carlos,9998,0,9999,1
1715621187891,AIP 197,004,658530,Heyman; Gail D.,9998,0,9999,1
1715621187891,AIP 197,005,658631,Neal; Sonya E,9998,0,9999,1
1715621187891,AIP 197,006,658671,Du; Songzi,9998,0,9999,1
1715621188916,ANAR 135S,A00,494369,Braswell; Geoffrey E.,0,0,0,0
1715621189944,BENG 196,001,628496,Engler; Adam J.,9998,0,9999,1
1715621189944,BENG 196,002,660916,Watson; John Thomas,9999,0,9999,0
1715621190971,BISP 197,001,650773,Wilhelm; James E.,9994,0,9999,5
1715621190971,BISP 197,002,658904,Coleman; Aaron B.,9998,0,9999,1
1715621191999,CAT 124RS,A01,519847,Geibel; William,0,0,20,20
1715621193026,CAT 125RS,A01,515971,Geibel; William,0,0,20,20
1715621194051,CLRE 250,A00,511389,Morris; Sheldon,9992,0,9999,7
1715621195082,CLRE 251,A00,507176,Mehta; Ravindra L.,9992,0,9999,7
1715621195082,CLRE 251,B00,511410,Mehta; Ravindra L.,9998,0,9999,1
1715621196108,CLRE 252,A00,507189,Cuomo; Raphael Eduardo,9994,0,9999,5
1715621197132,CLRE 253,A00,507199,Vaida; Florin,9994,0,9999,5
1715621197132,CLRE 253,B00,507202,Vaida; Florin,9999,0,9999,0
1715621198163,CLRE 259,A00,507211,Patel; Hemal,9996,0,9999,3
1715621199189,CLRE 260,A00,507221,Cuomo; Raphael Eduardo,9999,0,9999,0
1715621200214,CLRE 297,001,507242,Cuomo; Raphael Eduardo,9999,0,9999,0
1715621201239,COGS 197,001,638244,Voytek; Bradley Thomas,9997,0,9999,2
1715621202268,CSE 191,A00,516875,Minnes Kemp; Mor Mia,9991,0,9999,8
1715621203298,CSE 197,001,637388,Minnes Kemp; Mor Mia,9992,0,9999,7
1715621204324,CSS 201S,A01,494383,Mignozzetti; Umberto,35,0,35,0
1715621205354,CSS 202S,A01,494387,Mignozzetti; Umberto,35,0,35,0
1715621206379,DSC 197,001,628532,Eldridge; Justin Matthew,9995,0,9999,4
1715621207403,EAP 100,A00,516065,Staff,9799,0,9999,200
1715621208429,ECE 45,A01,507414,Staff,31,0,60,29
1715621210483,ECE 111,A01,507420,Staff,11,0,50,39
1715621211508,ECE 197,001,548057,Sievenpiper; Daniel F.,9991,0,9999,8
1715621212535,EDS 115,A00,507243,Choi; Bailey Miyeon,7,0,28,21
1715621213564,EDS 117,A01,494379,Staff,0,6,34,34
1715621214592,EDS 125,A00,507246,Hopkins; Megan Beth,8,0,30,22
1715621215619,EDS 128A,A01,507264,Fargason; Sharon Gayle,6,0,26,20
1715621216643,EDS 128B,A01,507293,Pappas; Elizabeth,10,0,30,20
1715621217671,EDS 139,A00,507294,Fargason; Sharon Gayle,10,0,30,20
1715621217671,EDS 139,B00,507313,Pappas; Elizabeth,11,0,30,19
1715621218695,EDS 201,A00,507315,Staff,10,0,30,20
1715621219721,EDS 203,A01,507317,Halter; Christopher P.,10,0,30,20
1715621220748,EDS 204R,A01,507319,Halter; Christopher P.,0,3,30,30
1715621220748,EDS 204R,B01,507331,Heinzman; Erica M.,14,0,30,16
1715621221772,EDS 206R,A00,507332,Staff,0,4,30,30
1715621221772,EDS 206R,B00,507343,Staff,15,0,30,15
1715621222798,EDS 250,A00,507344,Hemans; Patricia Ann Benitez,20,0,40,20
1715621223830,EDS 281,A00,507345,Daly; Alan J.,18,0,18,0
1715621224856,EDS 284,A00,507350,Daly; Alan J.,16,0,16,0
1715621225884,EDS 286,A00,507359,Fine; Sarah,18,0,18,0
1715621226911,EDS 289C,A01,507361,Daly; Alan J.,18,0,18,0
1715621227937,EDS 290,A00,507366,Hofstetter; Carolyn,15,0,15,0
1715621228963,LIGM 5A,A00,507421,Fischer-Grunski; Eva K,17,0,20,3
1715621229989,LIGM 5B,A00,507423,Fischer-Grunski; Eva K,19,0,20,1
1715621231017,LIGM 5C,A00,507425,Fischer-Grunski; Eva K,19,0,20,1
1715621232047,LIIT 5AS,A00,507427,Carnelos; Chiara,20,0,20,0
1715621233093,LIIT 5BS,A00,507430,Carnelos; Chiara,20,0,20,0
1715621234122,LIIT 5CS,A00,507432,Carnelos; Chiara,20,0,20,0
1715621235153,LISP 5A,A00,507541,Munoz Sanchez; Alicia,11,0,20,9
1715621236182,LISP 5B,A00,507671,Munoz Sanchez; Alicia,9,0,20,11
1715621237210,LISP 5C,A00,507696,Munoz Sanchez; Alicia,9,0,20,11
1715621238236,MAE 197,001,528363,Boechler; Nicholas Sebastia,9998,0,9999,1
1715621239262,MATH 197,001,523477,Kedlaya; Kiran S.,9994,0,9999,5
1715621239262,MATH 197,002,563811,Zhang; Danna,9994,0,9999,5
1715621239262,MATH 197,003,628552,Dumitriu; Ioana,9998,0,9999,1
1715621239262,MATH 197,004,660885,Floyd; Eric,9998,0,9999,1
1715621240288,MCWP 40R,A00,518780,Staff,2,0,20,18
1715621240288,MCWP 40R,B00,518781,Staff,11,0,20,9
1715621240288,MCWP 40R,C00,518783,Staff,5,0,20,15
1715621241318,MCWP 50R,A00,518791,Staff,0,1,20,20
1715621241318,MCWP 50R,B00,518792,Staff,0,2,20,20
1715621241318,MCWP 50R,C00,518793,Staff,0,4,20,20
1715621241318,MCWP 50R,D00,518794,Staff,0,1,20,20
1715621241318,MCWP 50R,E00,518795,Staff,0,2,20,20
1715621241318,MCWP 50R,F00,518796,Staff,0,1,20,20
1715621241318,MCWP 50R,G00,518797,Staff,0,1,20,20
1715621242347,MMW 12R,A01,514034,Herbst; Matthew,0,2,16,16
1715621242347,MMW 12R,A02,514035,Herbst; Matthew,0,0,16,16
1715621243373,MMW 13R,A01,514037,Staff,0,5,16,16
1715621243373,MMW 13R,A02,514039,Staff,0,5,16,16
1715621243373,MMW 13R,A03,628519,Staff,0,4,16,16
1715621245430,SIO 295LS,A00,523233,Staff,10,0,30,20
1715621246455,SIO 295S,A00,523232,Staff,10,0,30,20
1715621247481,SIOC 290S,A01,637330,Merrifield; Mark A,23,0,30,7
1715621248507,SIOC 291S,A01,637333,Gabriel; Corey John,23,0,30,7
1715621249532,SOCI 117,A01,494376,Staff,0,5,5,5
1715621250557,WES 237B,A00,494380,Staff,10,0,20,10
1715621252633,AESE 279B,A00,494370,Wade; Jon P,0,0,33,33
1715621253660,AIP 97,001,660915,Van Den Einde; Yael Dahlia,9998,0,9999,1
1715621254690,AIP 197,001,627712,Vespa; Emanuel Ignacio,9995,0,9999,4
1715621254690,AIP 197,002,650778,Amir; On,9998,0,9999,1
1715621254690,AIP 197,003,650933,Avenancio-Leon; Carlos,9998,0,9999,1
1715621254690,AIP 197,004,658530,Heyman; Gail D.,9998,0,9999,1
1715621254690,AIP 197,005,658631,Neal; Sonya E,9998,0,9999,1
1715621254690,AIP 197,006,658671,Du; Songzi,9998,0,9999,1
1715621255715,ANAR 135S,A00,494369,Braswell; Geoffrey E.,0,0,0,0
1715621256744,BENG 196,001,628496,Engler; Adam J.,9998,0,9999,1
1715621256744,BENG 196,002,660916,Watson; John Thomas,9999,0,9999,0
1715621257774,BISP 197,001,650773,Wilhelm; James E.,9994,0,9999,5
1715621257774,BISP 197,002,658904,Coleman; Aaron B.,9998,0,9999,1
1715621258799,CAT 124RS,A01,519847,Geibel; William,0,0,20,20
1715621259825,CAT 125RS,A01,515971,Geibel; William,0,0,20,20
1715621260850,CLRE 250,A00,511389,Morris; Sheldon,9992,0,9999,7
1715621261879,CLRE 251,A00,507176,Mehta; Ravindra L.,9992,0,9999,7
1715621261879,CLRE 251,B00,511410,Mehta; Ravindra L.,9998,0,9999,1
1715621262904,CLRE 252,A00,507189,Cuomo; Raphael Eduardo,9994,0,9999,5
1715621263928,CLRE 253,A00,507199,Vaida; Florin,9994,0,9999,5
1715621263928,CLRE 253,B00,507202,Vaida; Florin,9999,0,9999,0
1715621264953,CLRE 259,A00,507211,Patel; Hemal,9996,0,9999,3
1715621265980,CLRE 260,A00,507221,Cuomo; Raphael Eduardo,9999,0,9999,0
1715621267003,CLRE 297,001,507242,Cuomo; Raphael Eduardo,9999,0,9999,0
1715621268030,COGS 197,001,638244,Voytek; Bradley Thomas,9997,0,9999,2
1715621269112,CSE 191,A00,516875,Minnes Kemp; Mor Mia,9991,0,9999,8
1715621270138,CSE 197,001,637388,Minnes Kemp; Mor Mia,9992,0,9999,7
1715621271175,CSS 201S,A01,494383,Mignozzetti; Umberto,35,0,35,0
1715621272201,CSS 202S,A01,494387,Mignozzetti; Umberto,35,0,35,0
1715621273227,DSC 197,001,628532,Eldridge; Justin Matthew,9995,0,9999,4
1715621274254,EAP 100,A00,516065,Staff,9799,0,9999,200
1715621275279,ECE 45,A01,507414,Staff,31,0,60,29
1715621277332,ECE 111,A01,507420,Staff,11,0,50,39
1715621278360,ECE 197,001,548057,Sievenpiper; Daniel F.,9991,0,9999,8
1715621279386,EDS 115,A00,507243,Choi; Bailey Miyeon,7,0,28,21
1715621280412,EDS 117,A01,494379,Staff,0,6,34,34
1715621281440,EDS 125,A00,507246,Hopkins; Megan Beth,8,0,30,22
1715621282467,EDS 128A,A01,507264,Fargason; Sharon Gayle,6,0,26,20
1715621283497,EDS 128B,A01,507293,Pappas; Elizabeth,10,0,30,20
1715621284521,EDS 139,A00,507294,Fargason; Sharon Gayle,10,0,30,20
1715621284521,EDS 139,B00,507313,Pappas; Elizabeth,11,0,30,19
1715621285547,EDS 201,A00,507315,Staff,10,0,30,20
1715621286575,EDS 203,A01,507317,Halter; Christopher P.,10,0,30,20
1715621287601,EDS 204R,A01,507319,Halter; Christopher P.,0,3,30,30
1715621287601,EDS 204R,B01,507331,Heinzman; Erica M.,14,0,30,16
1715621288627,EDS 206R,A00,507332,Staff,0,4,30,30
1715621288627,EDS 206R,B00,507343,Staff,15,0,30,15
1715621289654,EDS 250,A00,507344,Hemans; Patricia Ann Benitez,20,0,40,20
1715621290682,EDS 281,A00,507345,Daly; Alan J.,18,0,18,0
1715621291709,EDS 284,A00,507350,Daly; Alan J.,16,0,16,0
1715621292738,EDS 286,A00,507359,Fine; Sarah,18,0,18,0
1715621293764,EDS 289C,A01,507361,Daly; Alan J.,18,0,18,0
1715621294788,EDS 290,A00,507366,Hofstetter; Carolyn,15,0,15,0
1715621295813,LIGM 5A,A00,507421,Fischer-Grunski; Eva K,17,0,20,3
1715621296841,LIGM 5B,A00,507423,Fischer-Grunski; Eva K,19,0,20,1
1715621297866,LIGM 5C,A00,507425,Fischer-Grunski; Eva K,19,0,20,1
1715621298891,LIIT 5AS,A00,507427,Carnelos; Chiara,20,0,20,0
1715621299920,LIIT 5BS,A00,507430,Carnelos; Chiara,20,0,20,0
1715621300946,LIIT 5CS,A00,507432,Carnelos; Chiara,20,0,20,0
1715621301975,LISP 5A,A00,507541,Munoz Sanchez; Alicia,11,0,20,9
1715621302999,LISP 5B,A00,507671,Munoz Sanchez; Alicia,9,0,20,11
1715621304028,LISP 5C,A00,507696,Munoz Sanchez; Alicia,9,0,20,11
1715621305054,MAE 197,001,528363,Boechler; Nicholas Sebastia,9998,0,9999,1
1715621306115,MATH 197,001,523477,Kedlaya; Kiran S.,9994,0,9999,5
1715621306115,MATH 197,002,563811,Zhang; Danna,9994,0,9999,5
1715621306115,MATH 197,003,628552,Dumitriu; Ioana,9998,0,9999,1
1715621306115,MATH 197,004,660885,Floyd; Eric,9998,0,9999,1
1715621307146,MCWP 40R,A00,518780,Staff,2,0,20,18
1715621307146,MCWP 40R,B00,518781,Staff,11,0,20,9
1715621307146,MCWP 40R,C00,518783,Staff,5,0,20,15
1715621308175,MCWP 50R,A00,518791,Staff,0,1,20,20
1715621308175,MCWP 50R,B00,518792,Staff,0,2,20,20
1715621308175,MCWP 50R,C00,518793,Staff,0,4,20,20
1715621308175,MCWP 50R,D00,518794,Staff,0,1,20,20
1715621308175,MCWP 50R,E00,518795,Staff,0,2,20,20
1715621308175,MCWP 50R,F00,518796,Staff,0,1,20,20
1715621308175,MCWP 50R,G00,518797,Staff,0,1,20,20
1715621309200,MMW 12R,A01,514034,Herbst; Matthew,0,2,16,16
1715621309200,MMW 12R,A02,514035,Herbst; Matthew,0,0,16,16
1715621310227,MMW 13R,A01,514037,Staff,0,5,16,16
1715621310227,MMW 13R,A02,514039,Staff,0,5,16,16
1715621310227,MMW 13R,A03,628519,Staff,0,4,16,16
1715621312278,SIO 295LS,A00,523233,Staff,10,0,30,20
1715621313302,SIO 295S,A00,523232,Staff,10,0,30,20
1715621314326,SIOC 290S,A01,637330,Merrifield; Mark A,23,0,30,7
1715621315356,SIOC 291S,A01,637333,Gabriel; Corey John,23,0,30,7
1715621316383,SOCI 117,A01,494376,Staff,0,5,5,5
1715621317411,WES 237B,A00,494380,Staff,10,0,20,10
1715621319482,AESE 279B,A00,494370,Wade; Jon P,0,0,33,33
1715621320506,AIP 97,001,660915,Van Den Einde; Yael Dahlia,9998,0,9999,1
1715621321534,AIP 197,001,627712,Vespa; Emanuel Ignacio,9995,0,9999,4
1715621321534,AIP 197,002,650778,Amir; On,9998,0,9999,1
1715621321534,AIP 197,003,650933,Avenancio-Leon; Carlos,9998,0,9999,1
1715621321534,AIP 197,004,658530,Heyman; Gail D.,9998,0,9999,1
1715621321534,AIP 197,005,658631,Neal; Sonya E,9998,0,9999,1
1715621321534,AIP 197,006,658671,Du; Songzi,9998,0,9999,1
1715621322561,ANAR 135S,A00,494369,Braswell; Geoffrey E.,0,0,0,0
1715621323586,BENG 196,001,628496,Engler; Adam J.,9998,0,9999,1
1715621323586,BENG 196,002,660916,Watson; John Thomas,9999,0,9999,0
1715621324613,BISP 197,001,650773,Wilhelm; James E.,9994,0,9999,5
1715621324613,BISP 197,002,658904,Coleman; Aaron B.,9998,0,9999,1
1715621325641,CAT 124RS,A01,519847,Geibel; William,0,0,20,20
1715621326666,CAT 125RS,A01,515971,Geibel; William,0,0,20,20
1715621327691,CLRE 250,A00,511389,Morris; Sheldon,9992,0,9999,7
1715621328716,CLRE 251,A00,507176,Mehta; Ravindra L.,9992,0,9999,7
1715621328716,CLRE 251,B00,511410,Mehta; Ravindra L.,9998,0,9999,1
1715621329740,CLRE 252,A00,507189,Cuomo; Raphael Eduardo,9994,0,9999,5
1715621330766,CLRE 253,A00,507199,Vaida; Florin,9994,0,9999,5
1715621330766,CLRE 253,B00,507202,Vaida; Florin,9999,0,9999,0
1715621331794,CLRE 259,A00,507211,Patel; Hemal,9996,0,9999,3
1715621332819,CLRE 260,A00,507221,Cuomo; Raphael Eduardo,9999,0,9999,0
1715621333844,CLRE 297,001,507242,Cuomo; Raphael Eduardo,9999,0,9999,0
1715621334871,COGS 197,001,638244,Voytek; Bradley Thomas,9997,0,9999,2
1715621335899,CSE 191,A00,516875,Minnes Kemp; Mor Mia,9991,0,9999,8
1715621336923,CSE 197,001,637388,Minnes Kemp; Mor Mia,9992,0,9999,7
1715621337953,CSS 201S,A01,494383,Mignozzetti; Umberto,35,0,35,0
1715621338983,CSS 202S,A01,494387,Mignozzetti; Umberto,35,0,35,0
1715621340010,DSC 197,001,628532,Eldridge; Justin Matthew,9995,0,9999,4
1715621341042,EAP 100,A00,516065,Staff,9799,0,9999,200
1715621342074,ECE 45,A01,507414,Staff,31,0,60,29
1715621344182,ECE 111,A01,507420,Staff,11,0,50,39
1715621345208,ECE 197,001,548057,Sievenpiper; Daniel F.,9991,0,9999,8
1715621346243,EDS 115,A00,507243,Choi; Bailey Miyeon,7,0,28,21
1715621347272,EDS 117,A01,494379,Staff,0,6,34,34
1715621348298,EDS 125,A00,507246,Hopkins; Megan Beth,8,0,30,22
1715621349327,EDS 128A,A01,507264,Fargason; Sharon Gayle,6,0,26,20
1715621350355,EDS 128B,A01,507293,Pappas; Elizabeth,10,0,30,20
1715621351383,EDS 139,A00,507294,Fargason; Sharon Gayle,10,0,30,20
1715621351383,EDS 139,B00,507313,Pappas; Elizabeth,11,0,30,19
1715621352409,EDS 201,A00,507315,Staff,10,0,30,20
1715621353440,EDS 203,A01,507317,Halter; Christopher P.,10,0,30,20
1715621354471,EDS 204R,A01,507319,Halter; Christopher P.,0,3,30,30
1715621354471,EDS 204R,B01,507331,Heinzman; Erica M.,14,0,30,16
1715621355497,EDS 206R,A00,507332,Staff,0,4,30,30
1715621355497,EDS 206R,B00,507343,Staff,15,0,30,15
1715621356522,EDS 250,A00,507344,Hemans; Patricia Ann Benitez,20,0,40,20
1715621357551,EDS 281,A00,507345,Daly; Alan J.,18,0,18,0
1715621358575,EDS 284,A00,507350,Daly; Alan J.,16,0,16,0
1715621359604,EDS 286,A00,507359,Fine; Sarah,18,0,18,0
1715621360629,EDS 289C,A01,507361,Daly; Alan J.,18,0,18,0
1715621361655,EDS 290,A00,507366,Hofstetter; Carolyn,15,0,15,0
1715621362686,LIGM 5A,A00,507421,Fischer-Grunski; Eva K,17,0,20,3
1715621363711,LIGM 5B,A00,507423,Fischer-Grunski; Eva K,19,0,20,1
1715621364737,LIGM 5C,A00,507425,Fischer-Grunski; Eva K,19,0,20,1
1715621365767,LIIT 5AS,A00,507427,Carnelos; Chiara,20,0,20,0
1715621366793,LIIT 5BS,A00,507430,Carnelos; Chiara,20,0,20,0
1715621367819,LIIT 5CS,A00,507432,Carnelos; Chiara,20,0,20,0
1715621368847,LISP 5A,A00,507541,Munoz Sanchez; Alicia,11,0,20,9
1715621369871,LISP 5B,A00,507671,Munoz Sanchez; Alicia,9,0,20,11
1715621370898,LISP 5C,A00,507696,Munoz Sanchez; Alicia,9,0,20,11
1715621371923,MAE 197,001,528363,Boechler; Nicholas Sebastia,9998,0,9999,1
1715621372949,MATH 197,001,523477,Kedlaya; Kiran S.,9994,0,9999,5
1715621372949,MATH 197,002,563811,Zhang; Danna,9994,0,9999,5
1715621372949,MATH 197,003,628552,Dumitriu; Ioana,9998,0,9999,1
1715621372949,MATH 197,004,660885,Floyd; Eric,9998,0,9999,1
1715621373977,MCWP 40R,A00,518780,Staff,2,0,20,18
1715621373977,MCWP 40R,B00,518781,Staff,11,0,20,9
1715621373977,MCWP 40R,C00,518783,Staff,5,0,20,15
1715621375008,MCWP 50R,A00,518791,Staff,0,1,20,20
1715621375008,MCWP 50R,B00,518792,Staff,0,2,20,20
1715621375008,MCWP 50R,C00,518793,Staff,0,4,20,20
1715621375008,MCWP 50R,D00,518794,Staff,0,1,20,20
1715621375008,MCWP 50R,E00,518795,Staff,0,2,20,20
1715621375008,MCWP 50R,F00,518796,Staff,0,1,20,20
1715621375008,MCWP 50R,G00,518797,Staff,0,1,20,20
1715621376035,MMW 12R,A01,514034,Herbst; Matthew,0,2,16,16
1715621376035,MMW 12R,A02,514035,Herbst; Matthew,0,0,16,16
1715621377061,MMW 13R,A01,514037,Staff,0,5,16,16
1715621377061,MMW 13R,A02,514039,Staff,0,5,16,16
1715621377061,MMW 13R,A03,628519,Staff,0,4,16,16
1715621379114,SIO 295LS,A00,523233,Staff,10,0,30,20
1715621380142,SIO 295S,A00,523232,Staff,10,0,30,20
1715621381167,SIOC 290S,A01,637330,Merrifield; Mark A,23,0,30,7
1715621382194,SIOC 291S,A01,637333,Gabriel; Corey John,23,0,30,7
1715621383220,SOCI 117,A01,494376,Staff,0,5,5,5
1715621384251,WES 237B,A00,494380,Staff,10,0,20,10
1715621386343,AESE 279B,A00,494370,Wade; Jon P,0,0,33,33
1715621387368,AIP 97,001,660915,Van Den Einde; Yael Dahlia,9998,0,9999,1
1715621388394,AIP 197,001,627712,Vespa; Emanuel Ignacio,9995,0,9999,4
1715621388394,AIP 197,002,650778,Amir; On,9998,0,9999,1
1715621388394,AIP 197,003,650933,Avenancio-Leon; Carlos,9998,0,9999,1
1715621388394,AIP 197,004,658530,Heyman; Gail D.,9998,0,9999,1
1715621388394,AIP 197,005,658631,Neal; Sonya E,9998,0,9999,1
1715621388394,AIP 197,006,658671,Du; Songzi,9998,0,9999,1
1715621389418,ANAR 135S,A00,494369,Braswell; Geoffrey E.,0,0,0,0
1715621390445,BENG 196,001,628496,Engler; Adam J.,9998,0,9999,1
1715621390445,BENG 196,002,660916,Watson; John Thomas,9999,0,9999,0
1715621391469,BISP 197,001,650773,Wilhelm; James E.,9994,0,9999,5
1715621391469,BISP 197,002,658904,Coleman; Aaron B.,9998,0,9999,1
1715621392496,CAT 124RS,A01,519847,Geibel; William,0,0,20,20
1715621393522,CAT 125RS,A01,515971,Geibel; William,0,0,20,20
1715621394547,CLRE 250,A00,511389,Morris; Sheldon,9992,0,9999,7
1715621395572,CLRE 251,A00,507176,Mehta; Ravindra L.,9992,0,9999,7
1715621395572,CLRE 251,B00,511410,Mehta; Ravindra L.,9998,0,9999,1
1715621396603,CLRE 252,A00,507189,Cuomo; Raphael Eduardo,9994,0,9999,5
1715621397633,CLRE 253,A00,507199,Vaida; Florin,9994,0,9999,5
1715621397633,CLRE 253,B00,507202,Vaida; Florin,9999,0,9999,0
1715621398661,CLRE 259,A00,507211,Patel; Hemal,9996,0,9999,3
1715621399688,CLRE 260,A00,507221,Cuomo; Raphael Eduardo,9999,0,9999,0
1715621400714,CLRE 297,001,507242,Cuomo; Raphael Eduardo,9999,0,9999,0
1715621401749,COGS 197,001,638244,Voytek; Bradley Thomas,9997,0,9999,2
1715621402775,CSE 191,A00,516875,Minnes Kemp; Mor Mia,9991,0,9999,8
1715621403803,CSE 197,001,637388,Minnes Kemp; Mor Mia,9992,0,9999,7
1715621404829,CSS 201S,A01,494383,Mignozzetti; Umberto,35,0,35,0
1715621405858,CSS 202S,A01,494387,Mignozzetti; Umberto,35,0,35,0
1715621406891,DSC 197,001,628532,Eldridge; Justin Matthew,9995,0,9999,4
1715621407918,EAP 100,A00,516065,Staff,9799,0,9999,200
1715621408950,ECE 45,A01,507414,Staff,31,0,60,29
1715621411001,ECE 111,A01,507420,Staff,11,0,50,39
1715621412029,ECE 197,001,548057,Sievenpiper; Daniel F.,9991,0,9999,8
1715621413059,EDS 115,A00,507243,Choi; Bailey Miyeon,7,0,28,21
1715621414086,EDS 117,A01,494379,Staff,0,6,34,34
1715621415111,EDS 125,A00,507246,Hopkins; Megan Beth,8,0,30,22
1715621416136,EDS 128A,A01,507264,Fargason; Sharon Gayle,6,0,26,20
1715621417162,EDS 128B,A01,507293,Pappas; Elizabeth,10,0,30,20
1715621418187,EDS 139,A00,507294,Fargason; Sharon Gayle,10,0,30,20
1715621418187,EDS 139,B00,507313,Pappas; Elizabeth,11,0,30,19
1715621419211,EDS 201,A00,507315,Staff,10,0,30,20
1715621420239,EDS 203,A01,507317,Halter; Christopher P.,10,0,30,20
1715621421267,EDS 204R,A01,507319,Halter; Christopher P.,0,3,30,30
1715621421267,EDS 204R,B01,507331,Heinzman; Erica M.,14,0,30,16
1715621422294,EDS 206R,A00,507332,Staff,0,4,30,30
1715621422294,EDS 206R,B00,507343,Staff,15,0,30,15
1715621423320,EDS 250,A00,507344,Hemans; Patricia Ann Benitez,20,0,40,20
1715621424348,EDS 281,A00,507345,Daly; Alan J.,18,0,18,0
1715621425375,EDS 284,A00,507350,Daly; Alan J.,16,0,16,0
1715621426402,EDS 286,A00,507359,Fine; Sarah,18,0,18,0
1715621427430,EDS 289C,A01,507361,Daly; Alan J.,18,0,18,0
1715621428455,EDS 290,A00,507366,Hofstetter; Carolyn,15,0,15,0
1715621429483,LIGM 5A,A00,507421,Fischer-Grunski; Eva K,17,0,20,3
1715621430508,LIGM 5B,A00,507423,Fischer-Grunski; Eva K,19,0,20,1
1715621431536,LIGM 5C,A00,507425,Fischer-Grunski; Eva K,19,0,20,1
1715621432564,LIIT 5AS,A00,507427,Carnelos; Chiara,20,0,20,0
1715621433589,LIIT 5BS,A00,507430,Carnelos; Chiara,20,0,20,0
1715621434618,LIIT 5CS,A00,507432,Carnelos; Chiara,20,0,20,0
1715621435647,LISP 5A,A00,507541,Munoz Sanchez; Alicia,11,0,20,9
1715621436671,LISP 5B,A00,507671,Munoz Sanchez; Alicia,9,0,20,11
1715621437696,LISP 5C,A00,507696,Munoz Sanchez; Alicia,9,0,20,11
1715621438722,MAE 197,001,528363,Boechler; Nicholas Sebastia,9998,0,9999,1
1715621439750,MATH 197,001,523477,Kedlaya; Kiran S.,9994,0,9999,5
1715621439750,MATH 197,002,563811,Zhang; Danna,9994,0,9999,5
1715621439750,MATH 197,003,628552,Dumitriu; Ioana,9998,0,9999,1
1715621439750,MATH 197,004,660885,Floyd; Eric,9998,0,9999,1
1715621440776,MCWP 40R,A00,518780,Staff,2,0,20,18
1715621440776,MCWP 40R,B00,518781,Staff,11,0,20,9
1715621440776,MCWP 40R,C00,518783,Staff,5,0,20,15
1715621441805,MCWP 50R,A00,518791,Staff,0,1,20,20
1715621441805,MCWP 50R,B00,518792,Staff,0,2,20,20
1715621441805,MCWP 50R,C00,518793,Staff,0,4,20,20
1715621441805,MCWP 50R,D00,518794,Staff,0,1,20,20
1715621441805,MCWP 50R,E00,518795,Staff,0,2,20,20
1715621441805,MCWP 50R,F00,518796,Staff,0,1,20,20
1715621441805,MCWP 50R,G00,518797,Staff,0,1,20,20
1715621442831,MMW 12R,A01,514034,Herbst; Matthew,0,2,16,16
1715621442831,MMW 12R,A02,514035,Herbst; Matthew,0,0,16,16
1715621443856,MMW 13R,A01,514037,Staff,0,5,16,16
1715621443856,MMW 13R,A02,514039,Staff,0,5,16,16
1715621443856,MMW 13R,A03,628519,Staff,0,4,16,16
1715621445908,SIO 295LS,A00,523233,Staff,10,0,30,20
1715621446934,SIO 295S,A00,523232,Staff,10,0,30,20
1715621448017,SIOC 290S,A01,637330,Merrifield; Mark A,23,0,30,7
1715621449044,SIOC 291S,A01,637333,Gabriel; Corey John,23,0,30,7
1715621450070,SOCI 117,A01,494376,Staff,0,5,5,5
1715621451097,WES 237B,A00,494380,Staff,10,0,20,10
1715621453162,AESE 279B,A00,494370,Wade; Jon P,0,0,33,33
1715621454190,AIP 97,001,660915,Van Den Einde; Yael Dahlia,9998,0,9999,1
1715621455222,AIP 197,001,627712,Vespa; Emanuel Ignacio,9995,0,9999,4
1715621455222,AIP 197,002,650778,Amir; On,9998,0,9999,1
1715621455222,AIP 197,003,650933,Avenancio-Leon; Carlos,9998,0,9999,1
1715621455222,AIP 197,004,658530,Heyman; Gail D.,9998,0,9999,1
1715621455222,AIP 197,005,658631,Neal; Sonya E,9998,0,9999,1
1715621455222,AIP 197,006,658671,Du; Songzi,9998,0,9999,1
1715621456249,ANAR 135S,A00,494369,Braswell; Geoffrey E.,0,0,0,0
1715621457280,BENG 196,001,628496,Engler; Adam J.,9998,0,9999,1
1715621457280,BENG 196,002,660916,Watson; John Thomas,9999,0,9999,0
1715621458309,BISP 197,001,650773,Wilhelm; James E.,9994,0,9999,5
1715621458309,BISP 197,002,658904,Coleman; Aaron B.,9998,0,9999,1
1715621459333,CAT 124RS,A01,519847,Geibel; William,0,0,20,20
1715621460360,CAT 125RS,A01,515971,Geibel; William,0,0,20,20
1715621461400,CLRE 250,A00,511389,Morris; Sheldon,9992,0,9999,7
1715621462428,CLRE 251,A00,507176,Mehta; Ravindra L.,9992,0,9999,7
1715621462428,CLRE 251,B00,511410,Mehta; Ravindra L.,9998,0,9999,1
1715621463453,CLRE 252,A00,507189,Cuomo; Raphael Eduardo,9994,0,9999,5
1715621464479,CLRE 253,A00,507199,Vaida; Florin,9994,0,9999,5
1715621464479,CLRE 253,B00,507202,Vaida; Florin,9999,0,9999,0
1715621465504,CLRE 259,A00,507211,Patel; Hemal,9996,0,9999,3
1715621466532,CLRE 260,A00,507221,Cuomo; Raphael Eduardo,9999,0,9999,0
1715621467557,CLRE 297,001,507242,Cuomo; Raphael Eduardo,9999,0,9999,0
1715621468581,COGS 197,001,638244,Voytek; Bradley Thomas,9997,0,9999,2
1715621469611,CSE 191,A00,516875,Minnes Kemp; Mor Mia,9991,0,9999,8
1715621470638,CSE 197,001,637388,Minnes Kemp; Mor Mia,9992,0,9999,7
1715621471664,CSS 201S,A01,494383,Mignozzetti; Umberto,35,0,35,0
1715621472691,CSS 202S,A01,494387,Mignozzetti; Umberto,35,0,35,0
1715621473717,DSC 197,001,628532,Eldridge; Justin Matthew,9995,0,9999,4
1715621474742,EAP 100,A00,516065,Staff,9799,0,9999,200
1715621475774,ECE 45,A01,507414,Staff,31,0,60,29
1715621477832,ECE 111,A01,507420,Staff,11,0,50,39
1715621478858,ECE 197,001,548057,Sievenpiper; Daniel F.,9991,0,9999,8
1715621479883,EDS 115,A00,507243,Choi; Bailey Miyeon,7,0,28,21
1715621480910,EDS 117,A01,494379,Staff,0,6,34,34
1715621481938,EDS 125,A00,507246,Hopkins; Megan Beth,8,0,30,22
1715621482964,EDS 128A,A01,507264,Fargason; Sharon Gayle,6,0,26,20
1715621483993,EDS 128B,A01,507293,Pappas; Elizabeth,10,0,30,20
1715621485018,EDS 139,A00,507294,Fargason; Sharon Gayle,10,0,30,20
1715621485018,EDS 139,B00,507313,Pappas; Elizabeth,11,0,30,19
1715621486044,EDS 201,A00,507315,Staff,10,0,30,20
1715621487074,EDS 203,A01,507317,Halter; Christopher P.,10,0,30,20
1715621488103,EDS 204R,A01,507319,Halter; Christopher P.,0,3,30,30
1715621488103,EDS 204R,B01,507331,Heinzman; Erica M.,14,0,30,16
1715621489130,EDS 206R,A00,507332,Staff,0,4,30,30
1715621489130,EDS 206R,B00,507343,Staff,15,0,30,15
1715621490160,EDS 250,A00,507344,Hemans; Patricia Ann Benitez,20,0,40,20
1715621491185,EDS 281,A00,507345,Daly; Alan J.,18,0,18,0
1715621492211,EDS 284,A00,507350,Daly; Alan J.,16,0,16,0
1715621493235,EDS 286,A00,507359,Fine; Sarah,18,0,18,0
1715621494262,EDS 289C,A01,507361,Daly; Alan J.,18,0,18,0
1715621495286,EDS 290,A00,507366,Hofstetter; Carolyn,15,0,15,0
1715621496313,LIGM 5A,A00,507421,Fischer-Grunski; Eva K,17,0,20,3
1715621497339,LIGM 5B,A00,507423,Fischer-Grunski; Eva K,19,0,20,1
1715621498365,LIGM 5C,A00,507425,Fischer-Grunski; Eva K,19,0,20,1
1715621499395,LIIT 5AS,A00,507427,Carnelos; Chiara,20,0,20,0
1715621500425,LIIT 5BS,A00,507430,Carnelos; Chiara,20,0,20,0
1715621501450,LIIT 5CS,A00,507432,Carnelos; Chiara,20,0,20,0
1715621502480,LISP 5A,A00,507541,Munoz Sanchez; Alicia,11,0,20,9
1715621503506,LISP 5B,A00,507671,Munoz Sanchez; Alicia,9,0,20,11
1715621504536,LISP 5C,A00,507696,Munoz Sanchez; Alicia,9,0,20,11
1715621505562,MAE 197,001,528363,Boechler; Nicholas Sebastia,9998,0,9999,1
1715621506588,MATH 197,001,523477,Kedlaya; Kiran S.,9994,0,9999,5
1715621506588,MATH 197,002,563811,Zhang; Danna,9994,0,9999,5
1715621506588,MATH 197,003,628552,Dumitriu; Ioana,9998,0,9999,1
1715621506588,MATH 197,004,660885,Floyd; Eric,9998,0,9999,1
1715621507616,MCWP 40R,A00,518780,Staff,2,0,20,18
1715621507616,MCWP 40R,B00,518781,Staff,11,0,20,9
1715621507616,MCWP 40R,C00,518783,Staff,5,0,20,15
1715621508643,MCWP 50R,A00,518791,Staff,0,1,20,20
1715621508643,MCWP 50R,B00,518792,Staff,0,2,20,20
1715621508643,MCWP 50R,C00,518793,Staff,0,4,20,20
1715621508643,MCWP 50R,D00,518794,Staff,0,1,20,20
1715621508643,MCWP 50R,E00,518795,Staff,0,2,20,20
1715621508643,MCWP 50R,F00,518796,Staff,0,1,20,20
1715621508643,MCWP 50R,G00,518797,Staff,0,1,20,20
1715621509670,MMW 12R,A01,514034,Herbst; Matthew,0,2,16,16
1715621509670,MMW 12R,A02,514035,Herbst; Matthew,0,0,16,16
1715621510698,MMW 13R,A01,514037,Staff,0,5,16,16
1715621510698,MMW 13R,A02,514039,Staff,0,5,16,16
1715621510698,MMW 13R,A03,628519,Staff,0,4,16,16
1715621512754,SIO 295LS,A00,523233,Staff,10,0,30,20
1715621513782,SIO 295S,A00,523232,Staff,10,0,30,20
1715621514808,SIOC 290S,A01,637330,Merrifield; Mark A,23,0,30,7
1715621515832,SIOC 291S,A01,637333,Gabriel; Corey John,23,0,30,7
1715621516860,SOCI 117,A01,494376,Staff,0,5,5,5
1715621517887,WES 237B,A00,494380,Staff,10,0,20,10
1715621519955,AESE 279B,A00,494370,Wade; Jon P,0,0,33,33
1715621520980,AIP 97,001,660915,Van Den Einde; Yael Dahlia,9998,0,9999,1
1715621522014,AIP 197,001,627712,Vespa; Emanuel Ignacio,9995,0,9999,4
1715621522014,AIP 197,002,650778,Amir; On,9998,0,9999,1
1715621522014,AIP 197,003,650933,Avenancio-Leon; Carlos,9998,0,9999,1
1715621522014,AIP 197,004,658530,Heyman; Gail D.,9998,0,9999,1
1715621522014,AIP 197,005,658631,Neal; Sonya E,9998,0,9999,1
1715621522014,AIP 197,006,658671,Du; Songzi,9998,0,9999,1
1715621523042,ANAR 135S,A00,494369,Braswell; Geoffrey E.,0,0,0,0
1715621524068,BENG 196,001,628496,Engler; Adam J.,9998,0,9999,1
1715621524068,BENG 196,002,660916,Watson; John Thomas,9999,0,9999,0
1715621525094,BISP 197,001,650773,Wilhelm; James E.,9994,0,9999,5
1715621525094,BISP 197,002,658904,Coleman; Aaron B.,9998,0,9999,1
1715621526120,CAT 124RS,A01,519847,Geibel; William,0,0,20,20
1715621527149,CAT 125RS,A01,515971,Geibel; William,0,0,20,20
1715621528175,CLRE 250,A00,511389,Morris; Sheldon,9992,0,9999,7
1715621529201,CLRE 251,A00,507176,Mehta; Ravindra L.,9992,0,9999,7
1715621529201,CLRE 251,B00,511410,Mehta; Ravindra L.,9998,0,9999,1
1715621530231,CLRE 252,A00,507189,Cuomo; Raphael Eduardo,9994,0,9999,5
1715621531257,CLRE 253,A00,507199,Vaida; Florin,9994,0,9999,5
1715621531257,CLRE 253,B00,507202,Vaida; Florin,9999,0,9999,0
1715621532282,CLRE 259,A00,507211,Patel; Hemal,9996,0,9999,3
1715621533309,CLRE 260,A00,507221,Cuomo; Raphael Eduardo,9999,0,9999,0
1715621534336,CLRE 297,001,507242,Cuomo; Raphael Eduardo,9999,0,9999,0
1715621535360,COGS 197,001,638244,Voytek; Bradley Thomas,9997,0,9999,2
1715621536386,CSE 191,A00,516875,Minnes Kemp; Mor Mia,9991,0,9999,8
1715621537411,CSE 197,001,637388,Minnes Kemp; Mor Mia,9992,0,9999,7
1715621538439,CSS 201S,A01,494383,Mignozzetti; Umberto,35,0,35,0
1715621539465,CSS 202S,A01,494387,Mignozzetti; Umberto,35,0,35,0
1715621540494,DSC 197,001,628532,Eldridge; Justin Matthew,9995,0,9999,4
1715621541518,EAP 100,A00,516065,Staff,9799,0,9999,200
1715621542546,ECE 45,A01,507414,Staff,31,0,60,29
1715621544596,ECE 111,A01,507420,Staff,11,0,50,39
1715621545624,ECE 197,001,548057,Sievenpiper; Daniel F.,9991,0,9999,8
1715621546651,EDS 115,A00,507243,Choi; Bailey Miyeon,7,0,28,21
1715621547677,EDS 117,A01,494379,Staff,0,6,34,34
1715621548701,EDS 125,A00,507246,Hopkins; Megan Beth,8,0,30,22
1715621549730,EDS 128A,A01,507264,Fargason; Sharon Gayle,6,0,26,20
1715621550755,EDS 128B,A01,507293,Pappas; Elizabeth,10,0,30,20
1715621551836,EDS 139,A00,507294,Fargason; Sharon Gayle,10,0,30,20
1715621551836,EDS 139,B00,507313,Pappas; Elizabeth,11,0,30,19
1715621552865,EDS 201,A00,507315,Staff,10,0,30,20
1715621553923,EDS 203,A01,507317,Halter; Christopher P.,10,0,30,20
1715621554951,EDS 204R,A01,507319,Halter; Christopher P.,0,3,30,30
1715621554951,EDS 204R,B01,507331,Heinzman; Erica M.,14,0,30,16
1715621555976,EDS 206R,A00,507332,Staff,0,4,30,30
1715621555976,EDS 206R,B00,507343,Staff,15,0,30,15
1715621557005,EDS 250,A00,507344,Hemans; Patricia Ann Benitez,20,0,40,20
1715621558035,EDS 281,A00,507345,Daly; Alan J.,18,0,18,0
1715621559059,EDS 284,A00,507350,Daly; Alan J.,16,0,16,0
1715621560088,EDS 286,A00,507359,Fine; Sarah,18,0,18,0
1715621561116,EDS 289C,A01,507361,Daly; Alan J.,18,0,18,0
1715621562142,EDS 290,A00,507366,Hofstetter; Carolyn,15,0,15,0
1715621563168,LIGM 5A,A00,507421,Fischer-Grunski; Eva K,17,0,20,3
1715621564195,LIGM 5B,A00,507423,Fischer-Grunski; Eva K,19,0,20,1
1715621565220,LIGM 5C,A00,507425,Fischer-Grunski; Eva K,19,0,20,1
1715621566247,LIIT 5AS,A00,507427,Carnelos; Chiara,20,0,20,0
1715621567273,LIIT 5BS,A00,507430,Carnelos; Chiara,20,0,20,0
1715621568302,LIIT 5CS,A00,507432,Carnelos; Chiara,20,0,20,0
1715621569328,LISP 5A,A00,507541,Munoz Sanchez; Alicia,11,0,20,9
1715621570352,LISP 5B,A00,507671,Munoz Sanchez; Alicia,9,0,20,11
1715621571383,LISP 5C,A00,507696,Munoz Sanchez; Alicia,9,0,20,11
1715621572409,MAE 197,001,528363,Boechler; Nicholas Sebastia,9998,0,9999,1
1715621573438,MATH 197,001,523477,Kedlaya; Kiran S.,9994,0,9999,5
1715621573438,MATH 197,002,563811,Zhang; Danna,9994,0,9999,5
1715621573438,MATH 197,003,628552,Dumitriu; Ioana,9998,0,9999,1
1715621573438,MATH 197,004,660885,Floyd; Eric,9998,0,9999,1
1715621574467,MCWP 40R,A00,518780,Staff,2,0,20,18
1715621574467,MCWP 40R,B00,518781,Staff,11,0,20,9
1715621574467,MCWP 40R,C00,518783,Staff,5,0,20,15
1715621575493,MCWP 50R,A00,518791,Staff,0,1,20,20
1715621575493,MCWP 50R,B00,518792,Staff,0,2,20,20
1715621575493,MCWP 50R,C00,518793,Staff,0,4,20,20
1715621575493,MCWP 50R,D00,518794,Staff,0,1,20,20
1715621575493,MCWP 50R,E00,518795,Staff,0,2,20,20
1715621575493,MCWP 50R,F00,518796,Staff,0,1,20,20
1715621575493,MCWP 50R,G00,518797,Staff,0,1,20,20
1715621576520,MMW 12R,A01,514034,Herbst; Matthew,0,2,16,16
1715621576520,MMW 12R,A02,514035,Herbst; Matthew,0,0,16,16
1715621577544,MMW 13R,A01,514037,Staff,0,5,16,16
1715621577544,MMW 13R,A02,514039,Staff,0,5,16,16
1715621577544,MMW 13R,A03,628519,Staff,0,4,16,16
1715621579600,SIO 295LS,A00,523233,Staff,10,0,30,20
1715621580625,SIO 295S,A00,523232,Staff,10,0,30,20
1715621581655,SIOC 290S,A01,637330,Merrifield; Mark A,23,0,30,7
1715621582680,SIOC 291S,A01,637333,Gabriel; Corey John,23,0,30,7
1715621583704,SOCI 117,A01,494376,Staff,0,5,5,5
1715621584729,WES 237B,A00,494380,Staff,10,0,20,10
1715621586796,AESE 279B,A00,494370,Wade; Jon P,0,0,33,33
1715621587824,AIP 97,001,660915,Van Den Einde; Yael Dahlia,9998,0,9999,1
1715621588856,AIP 197,001,627712,Vespa; Emanuel Ignacio,9995,0,9999,4
1715621588856,AIP 197,002,650778,Amir; On,9998,0,9999,1
1715621588856,AIP 197,003,650933,Avenancio-Leon; Carlos,9998,0,9999,1
1715621588856,AIP 197,004,658530,Heyman; Gail D.,9998,0,9999,1
1715621588856,AIP 197,005,658631,Neal; Sonya E,9998,0,9999,1
1715621588856,AIP 197,006,658671,Du; Songzi,9998,0,9999,1
1715621589883,ANAR 135S,A00,494369,Braswell; Geoffrey E.,0,0,0,0
1715621590911,BENG 196,001,628496,Engler; Adam J.,9998,0,9999,1
1715621590911,BENG 196,002,660916,Watson; John Thomas,9999,0,9999,0
1715621591938,BISP 197,001,650773,Wilhelm; James E.,9994,0,9999,5
1715621591938,BISP 197,002,658904,Coleman; Aaron B.,9998,0,9999,1
1715621592963,CAT 124RS,A01,519847,Geibel; William,0,0,20,20
1715621593988,CAT 125RS,A01,515971,Geibel; William,0,0,20,20
1715621595013,CLRE 250,A00,511389,Morris; Sheldon,9992,0,9999,7
1715621596039,CLRE 251,A00,507176,Mehta; Ravindra L.,9992,0,9999,7
1715621596039,CLRE 251,B00,511410,Mehta; Ravindra L.,9998,0,9999,1
1715621597065,CLRE 252,A00,507189,Cuomo; Raphael Eduardo,9994,0,9999,5
1715621598091,CLRE 253,A00,507199,Vaida; Florin,9994,0,9999,5
1715621598091,CLRE 253,B00,507202,Vaida; Florin,9999,0,9999,0
1715621599119,CLRE 259,A00,507211,Patel; Hemal,9996,0,9999,3
1715621600146,CLRE 260,A00,507221,Cuomo; Raphael Eduardo,9999,0,9999,0
1715621601174,CLRE 297,001,507242,Cuomo; Raphael Eduardo,9999,0,9999,0
1715621602202,COGS 197,001,638244,Voytek; Bradley Thomas,9997,0,9999,2
1715621603229,CSE 191,A00,516875,Minnes Kemp; Mor Mia,9991,0,9999,8
1715621604257,CSE 197,001,637388,Minnes Kemp; Mor Mia,9992,0,9999,7
1715621605283,CSS 201S,A01,494383,Mignozzetti; Umberto,35,0,35,0
1715621606309,CSS 202S,A01,494387,Mignozzetti; Umberto,35,0,35,0
1715621607337,DSC 197,001,628532,Eldridge; Justin Matthew,9995,0,9999,4
1715621608362,EAP 100,A00,516065,Staff,9799,0,9999,200
1715621609395,ECE 45,A01,507414,Staff,31,0,60,29
1715621611446,ECE 111,A01,507420,Staff,11,0,50,39
1715621612470,ECE 197,001,548057,Sievenpiper; Daniel F.,9991,0,9999,8
1715621613497,EDS 115,A00,507243,Choi; Bailey Miyeon,7,0,28,21
1715621614523,EDS 117,A01,494379,Staff,0,6,34,34
1715621615548,EDS 125,A00,507246,Hopkins; Megan Beth,8,0,30,22
1715621616573,EDS 128A,A01,507264,Fargason; Sharon Gayle,6,0,26,20
1715621617602,EDS 128B,A01,507293,Pappas; Elizabeth,10,0,30,20
1715621618628,EDS 139,A00,507294,Fargason; Sharon Gayle,10,0,30,20
1715621618628,EDS 139,B00,507313,Pappas; Elizabeth,11,0,30,19
1715621619657,EDS 201,A00,507315,Staff,10,0,30,20
1715621620691,EDS 203,A01,507317,Halter; Christopher P.,10,0,30,20
1715621621719,EDS 204R,A01,507319,Halter; Christopher P.,0,3,30,30
1715621621719,EDS 204R,B01,507331,Heinzman; Erica M.,14,0,30,16
1715621622744,EDS 206R,A00,507332,Staff,0,4,30,30
1715621622744,EDS 206R,B00,507343,Staff,15,0,30,15
1715621623771,EDS 250,A00,507344,Hemans; Patricia Ann Benitez,20,0,40,20
1715621624802,EDS 281,A00,507345,Daly; Alan J.,18,0,18,0
1715621625827,EDS 284,A00,507350,Daly; Alan J.,16,0,16,0
1715621626855,EDS 286,A00,507359,Fine; Sarah,18,0,18,0
1715621627881,EDS 289C,A01,507361,Daly; Alan J.,18,0,18,0
1715621628921,EDS 290,A00,507366,Hofstetter; Carolyn,15,0,15,0
1715621629946,LIGM 5A,A00,507421,Fischer-Grunski; Eva K,17,0,20,3
1715621630969,LIGM 5B,A00,507423,Fischer-Grunski; Eva K,19,0,20,1
1715621631995,LIGM 5C,A00,507425,Fischer-Grunski; Eva K,19,0,20,1
1715621633019,LIIT 5AS,A00,507427,Carnelos; Chiara,20,0,20,0
1715621634043,LIIT 5BS,A00,507430,Carnelos; Chiara,20,0,20,0
1715621635070,LIIT 5CS,A00,507432,Carnelos; Chiara,20,0,20,0
1715621636096,LISP 5A,A00,507541,Munoz Sanchez; Alicia,11,0,20,9
1715621637135,LISP 5B,A00,507671,Munoz Sanchez; Alicia,9,0,20,11
1715621638161,LISP 5C,A00,507696,Munoz Sanchez; Alicia,9,0,20,11
1715621639187,MAE 197,001,528363,Boechler; Nicholas Sebastia,9998,0,9999,1
1715621640217,MATH 197,001,523477,Kedlaya; Kiran S.,9994,0,9999,5
1715621640217,MATH 197,002,563811,Zhang; Danna,9994,0,9999,5
1715621640217,MATH 197,003,628552,Dumitriu; Ioana,9998,0,9999,1
1715621640217,MATH 197,004,660885,Floyd; Eric,9998,0,9999,1
1715621641244,MCWP 40R,A00,518780,Staff,2,0,20,18
1715621641244,MCWP 40R,B00,518781,Staff,11,0,20,9
1715621641244,MCWP 40R,C00,518783,Staff,5,0,20,15
1715621642275,MCWP 50R,A00,518791,Staff,0,1,20,20
1715621642275,MCWP 50R,B00,518792,Staff,0,2,20,20
1715621642275,MCWP 50R,C00,518793,Staff,0,4,20,20
1715621642275,MCWP 50R,D00,518794,Staff,0,1,20,20
1715621642275,MCWP 50R,E00,518795,Staff,0,2,20,20
1715621642275,MCWP 50R,F00,518796,Staff,0,1,20,20
1715621642275,MCWP 50R,G00,518797,Staff,0,1,20,20
1715621643300,MMW 12R,A01,514034,Herbst; Matthew,0,2,16,16
1715621643300,MMW 12R,A02,514035,Herbst; Matthew,0,0,16,16
1715621644327,MMW 13R,A01,514037,Staff,0,5,16,16
1715621644327,MMW 13R,A02,514039,Staff,0,5,16,16
1715621644327,MMW 13R,A03,628519,Staff,0,4,16,16
1715621646383,SIO 295LS,A00,523233,Staff,10,0,30,20
1715621647410,SIO 295S,A00,523232,Staff,10,0,30,20
1715621648439,SIOC 290S,A01,637330,Merrifield; Mark A,23,0,30,7
1715621649467,SIOC 291S,A01,637333,Gabriel; Corey John,23,0,30,7
1715621650493,SOCI 117,A01,494376,Staff,0,5,5,5
1715621651522,WES 237B,A00,494380,Staff,10,0,20,10
1715621653604,AESE 279B,A00,494370,Wade; Jon P,0,0,33,33
1715621654631,AIP 97,001,660915,Van Den Einde; Yael Dahlia,9998,0,9999,1
1715621655668,AIP 197,001,627712,Vespa; Emanuel Ignacio,9995,0,9999,4
1715621655668,AIP 197,002,650778,Amir; On,9998,0,9999,1
1715621655668,AIP 197,003,650933,Avenancio-Leon; Carlos,9998,0,9999,1
1715621655668,AIP 197,004,658530,Heyman; Gail D.,9998,0,9999,1
1715621655668,AIP 197,005,658631,Neal; Sonya E,9998,0,9999,1
1715621655668,AIP 197,006,658671,Du; Songzi,9998,0,9999,1
1715621656692,ANAR 135S,A00,494369,Braswell; Geoffrey E.,0,0,0,0
1715621657720,BENG 196,001,628496,Engler; Adam J.,9998,0,9999,1
1715621657720,BENG 196,002,660916,Watson; John Thomas,9999,0,9999,0
1715621658744,BISP 197,001,650773,Wilhelm; James E.,9994,0,9999,5
1715621658744,BISP 197,002,658904,Coleman; Aaron B.,9998,0,9999,1
1715621659769,CAT 124RS,A01,519847,Geibel; William,0,0,20,20
1715621660797,CAT 125RS,A01,515971,Geibel; William,0,0,20,20
1715621661822,CLRE 250,A00,511389,Morris; Sheldon,9992,0,9999,7
1715621662849,CLRE 251,A00,507176,Mehta; Ravindra L.,9992,0,9999,7
1715621662849,CLRE 251,B00,511410,Mehta; Ravindra L.,9998,0,9999,1
1715621663877,CLRE 252,A00,507189,Cuomo; Raphael Eduardo,9994,0,9999,5
1715621664905,CLRE 253,A00,507199,Vaida; Florin,9994,0,9999,5
1715621664905,CLRE 253,B00,507202,Vaida; Florin,9999,0,9999,0
1715621665930,CLRE 259,A00,507211,Patel; Hemal,9996,0,9999,3
1715621666957,CLRE 260,A00,507221,Cuomo; Raphael Eduardo,9999,0,9999,0
1715621667982,CLRE 297,001,507242,Cuomo; Raphael Eduardo,9999,0,9999,0
1715621669010,COGS 197,001,638244,Voytek; Bradley Thomas,9997,0,9999,2
1715621670037,CSE 191,A00,516875,Minnes Kemp; Mor Mia,9991,0,9999,8
1715621671064,CSE 197,001,637388,Minnes Kemp; Mor Mia,9992,0,9999,7
1715621672090,CSS 201S,A01,494383,Mignozzetti; Umberto,35,0,35,0
1715621673119,CSS 202S,A01,494387,Mignozzetti; Umberto,35,0,35,0
1715621674147,DSC 197,001,628532,Eldridge; Justin Matthew,9995,0,9999,4
1715621675176,EAP 100,A00,516065,Staff,9799,0,9999,200
1715621676209,ECE 45,A01,507414,Staff,31,0,60,29
1715621678263,ECE 111,A01,507420,Staff,11,0,50,39
1715621679288,ECE 197,001,548057,Sievenpiper; Daniel F.,9991,0,9999,8
1715621680314,EDS 115,A00,507243,Choi; Bailey Miyeon,7,0,28,21
1715621681340,EDS 117,A01,494379,Staff,0,6,34,34
1715621682367,EDS 125,A00,507246,Hopkins; Megan Beth,8,0,30,22
1715621683408,EDS 128A,A01,507264,Fargason; Sharon Gayle,6,0,26,20
1715621684432,EDS 128B,A01,507293,Pappas; Elizabeth,10,0,30,20
1715621685461,EDS 139,A00,507294,Fargason; Sharon Gayle,10,0,30,20
1715621685461,EDS 139,B00,507313,Pappas; Elizabeth,11,0,30,19
1715621686485,EDS 201,A00,507315,Staff,10,0,30,20
1715621687515,EDS 203,A01,507317,Halter; Christopher P.,10,0,30,20
1715621688540,EDS 204R,A01,507319,Halter; Christopher P.,0,3,30,30
1715621688540,EDS 204R,B01,507331,Heinzman; Erica M.,14,0,30,16
1715621689566,EDS 206R,A00,507332,Staff,0,4,30,30
1715621689566,EDS 206R,B00,507343,Staff,15,0,30,15
1715621690596,EDS 250,A00,507344,Hemans; Patricia Ann Benitez,20,0,40,20
1715621691622,EDS 281,A00,507345,Daly; Alan J.,18,0,18,0
1715621692649,EDS 284,A00,507350,Daly; Alan J.,16,0,16,0
1715621693682,EDS 286,A00,507359,Fine; Sarah,18,0,18,0
1715621694707,EDS 289C,A01,507361,Daly; Alan J.,18,0,18,0
1715621695733,EDS 290,A00,507366,Hofstetter; Carolyn,15,0,15,0
1715621696757,LIGM 5A,A00,507421,Fischer-Grunski; Eva K,17,0,20,3
1715621697784,LIGM 5B,A00,507423,Fischer-Grunski; Eva K,19,0,20,1
1715621698810,LIGM 5C,A00,507425,Fischer-Grunski; Eva K,19,0,20,1
1715621699840,LIIT 5AS,A00,507427,Carnelos; Chiara,20,0,20,0
1715621700868,LIIT 5BS,A00,507430,Carnelos; Chiara,20,0,20,0
1715621701897,LIIT 5CS,A00,507432,Carnelos; Chiara,20,0,20,0
1715621702923,LISP 5A,A00,507541,Munoz Sanchez; Alicia,11,0,20,9
1715621703950,LISP 5B,A00,507671,Munoz Sanchez; Alicia,9,0,20,11
1715621704977,LISP 5C,A00,507696,Munoz Sanchez; Alicia,9,0,20,11
1715621706007,MAE 197,001,528363,Boechler; Nicholas Sebastia,9998,0,9999,1
1715621707033,MATH 197,001,523477,Kedlaya; Kiran S.,9994,0,9999,5
1715621707033,MATH 197,002,563811,Zhang; Danna,9994,0,9999,5
1715621707033,MATH 197,003,628552,Dumitriu; Ioana,9998,0,9999,1
1715621707033,MATH 197,004,660885,Floyd; Eric,9998,0,9999,1
1715621708058,MCWP 40R,A00,518780,Staff,2,0,20,18
1715621708058,MCWP 40R,B00,518781,Staff,11,0,20,9
1715621708058,MCWP 40R,C00,518783,Staff,5,0,20,15
1715621709085,MCWP 50R,A00,518791,Staff,0,1,20,20
1715621709085,MCWP 50R,B00,518792,Staff,0,2,20,20
1715621709085,MCWP 50R,C00,518793,Staff,0,4,20,20
1715621709085,MCWP 50R,D00,518794,Staff,0,1,20,20
1715621709085,MCWP 50R,E00,518795,Staff,0,2,20,20
1715621709085,MCWP 50R,F00,518796,Staff,0,1,20,20
1715621709085,MCWP 50R,G00,518797,Staff,0,1,20,20
1715621710111,MMW 12R,A01,514034,Herbst; Matthew,0,2,16,16
1715621710111,MMW 12R,A02,514035,Herbst; Matthew,0,0,16,16
1715621711138,MMW 13R,A01,514037,Staff,0,5,16,16
1715621711138,MMW 13R,A02,514039,Staff,0,5,16,16
1715621711138,MMW 13R,A03,628519,Staff,0,4,16,16
1715621713192,SIO 295LS,A00,523233,Staff,10,0,30,20
1715621714220,SIO 295S,A00,523232,Staff,10,0,30,20
1715621715247,SIOC 290S,A01,637330,Merrifield; Mark A,23,0,30,7
1715621716276,SIOC 291S,A01,637333,Gabriel; Corey John,23,0,30,7
1715621717300,SOCI 117,A01,494376,Staff,0,5,5,5
1715621718325,WES 237B,A00,494380,Staff,10,0,20,10
1715621720390,AESE 279B,A00,494370,Wade; Jon P,0,0,33,33
1715621721417,AIP 97,001,660915,Van Den Einde; Yael Dahlia,9998,0,9999,1
1715621722447,AIP 197,001,627712,Vespa; Emanuel Ignacio,9995,0,9999,4
1715621722447,AIP 197,002,650778,Amir; On,9998,0,9999,1
1715621722447,AIP 197,003,650933,Avenancio-Leon; Carlos,9998,0,9999,1
1715621722447,AIP 197,004,658530,Heyman; Gail D.,9998,0,9999,1
1715621722447,AIP 197,005,658631,Neal; Sonya E,9998,0,9999,1
1715621722447,AIP 197,006,658671,Du; Songzi,9998,0,9999,1
1715621723473,ANAR 135S,A00,494369,Braswell; Geoffrey E.,0,0,0,0
1715621724502,BENG 196,001,628496,Engler; Adam J.,9998,0,9999,1
1715621724502,BENG 196,002,660916,Watson; John Thomas,9999,0,9999,0
1715621725528,BISP 197,001,650773,Wilhelm; James E.,9994,0,9999,5
1715621725528,BISP 197,002,658904,Coleman; Aaron B.,9998,0,9999,1
1715621726555,CAT 124RS,A01,519847,Geibel; William,0,0,20,20
1715621727581,CAT 125RS,A01,515971,Geibel; William,0,0,20,20
1715621728606,CLRE 250,A00,511389,Morris; Sheldon,9992,0,9999,7
1715621729633,CLRE 251,A00,507176,Mehta; Ravindra L.,9992,0,9999,7
1715621729633,CLRE 251,B00,511410,Mehta; Ravindra L.,9998,0,9999,1
1715621730661,CLRE 252,A00,507189,Cuomo; Raphael Eduardo,9994,0,9999,5
1715621731687,CLRE 253,A00,507199,Vaida; Florin,9994,0,9999,5
1715621731687,CLRE 253,B00,507202,Vaida; Florin,9999,0,9999,0
1715621732713,CLRE 259,A00,507211,Patel; Hemal,9996,0,9999,3
1715621733740,CLRE 260,A00,507221,Cuomo; Raphael Eduardo,9999,0,9999,0
1715621734765,CLRE 297,001,507242,Cuomo; Raphael Eduardo,9999,0,9999,0
1715621735796,COGS 197,001,638244,Voytek; Bradley Thomas,9997,0,9999,2
1715621736824,CSE 191,A00,516875,Minnes Kemp; Mor Mia,9991,0,9999,8
1715621737853,CSE 197,001,637388,Minnes Kemp; Mor Mia,9992,0,9999,7
1715621738883,CSS 201S,A01,494383,Mignozzetti; Umberto,35,0,35,0
1715621739909,CSS 202S,A01,494387,Mignozzetti; Umberto,35,0,35,0
1715621740937,DSC 197,001,628532,Eldridge; Justin Matthew,9995,0,9999,4
1715621741962,EAP 100,A00,516065,Staff,9799,0,9999,200
1715621742993,ECE 45,A01,507414,Staff,31,0,60,29
1715621745045,ECE 111,A01,507420,Staff,11,0,50,39
1715621746071,ECE 197,001,548057,Sievenpiper; Daniel F.,9991,0,9999,8
1715621747101,EDS 115,A00,507243,Choi; Bailey Miyeon,7,0,28,21
1715621748128,EDS 117,A01,494379,Staff,0,6,34,34
1715621749153,EDS 125,A00,507246,Hopkins; Megan Beth,8,0,30,22
1715621750181,EDS 128A,A01,507264,Fargason; Sharon Gayle,6,0,26,20
1715621751206,EDS 128B,A01,507293,Pappas; Elizabeth,10,0,30,20
1715621752234,EDS 139,A00,507294,Fargason; Sharon Gayle,10,0,30,20
1715621752234,EDS 139,B00,507313,Pappas; Elizabeth,11,0,30,19
1715621753262,EDS 201,A00,507315,Staff,10,0,30,20
1715621754287,EDS 203,A01,507317,Halter; Christopher P.,10,0,30,20
1715621755315,EDS 204R,A01,507319,Halter; Christopher P.,0,3,30,30
1715621755315,EDS 204R,B01,507331,Heinzman; Erica M.,14,0,30,16
1715621756340,EDS 206R,A00,507332,Staff,0,4,30,30
1715621756340,EDS 206R,B00,507343,Staff,15,0,30,15
1715621757365,EDS 250,A00,507344,Hemans; Patricia Ann Benitez,20,0,40,20
1715621758394,EDS 281,A00,507345,Daly; Alan J.,18,0,18,0
1715621759420,EDS 284,A00,507350,Daly; Alan J.,16,0,16,0
1715621760448,EDS 286,A00,507359,Fine; Sarah,18,0,18,0
1715621761500,EDS 289C,A01,507361,Daly; Alan J.,18,0,18,0
1715621762524,EDS 290,A00,507366,Hofstetter; Carolyn,15,0,15,0
1715621763552,LIGM 5A,A00,507421,Fischer-Grunski; Eva K,17,0,20,3
1715621764580,LIGM 5B,A00,507423,Fischer-Grunski; Eva K,19,0,20,1
1715621765606,LIGM 5C,A00,507425,Fischer-Grunski; Eva K,19,0,20,1
1715621766633,LIIT 5AS,A00,507427,Carnelos; Chiara,20,0,20,0
1715621767659,LIIT 5BS,A00,507430,Carnelos; Chiara,20,0,20,0
1715621768684,LIIT 5CS,A00,507432,Carnelos; Chiara,20,0,20,0
1715621769713,LISP 5A,A00,507541,Munoz Sanchez; Alicia,11,0,20,9
1715621770739,LISP 5B,A00,507671,Munoz Sanchez; Alicia,9,0,20,11
1715621771823,LISP 5C,A00,507696,Munoz Sanchez; Alicia,9,0,20,11
1715621772851,MAE 197,001,528363,Boechler; Nicholas Sebastia,9998,0,9999,1
1715621773883,MATH 197,001,523477,Kedlaya; Kiran S.,9994,0,9999,5
1715621773883,MATH 197,002,563811,Zhang; Danna,9994,0,9999,5
1715621773883,MATH 197,003,628552,Dumitriu; Ioana,9998,0,9999,1
1715621773883,MATH 197,004,660885,Floyd; Eric,9998,0,9999,1
1715621774914,MCWP 40R,A00,518780,Staff,2,0,20,18
1715621774914,MCWP 40R,B00,518781,Staff,11,0,20,9
1715621774914,MCWP 40R,C00,518783,Staff,5,0,20,15
1715621775940,MCWP 50R,A00,518791,Staff,0,1,20,20
1715621775940,MCWP 50R,B00,518792,Staff,0,2,20,20
1715621775940,MCWP 50R,C00,518793,Staff,0,4,20,20
1715621775940,MCWP 50R,D00,518794,Staff,0,1,20,20
1715621775940,MCWP 50R,E00,518795,Staff,0,2,20,20
1715621775940,MCWP 50R,F00,518796,Staff,0,1,20,20
1715621775940,MCWP 50R,G00,518797,Staff,0,1,20,20
1715621776966,MMW 12R,A01,514034,Herbst; Matthew,0,2,16,16
1715621776966,MMW 12R,A02,514035,Herbst; Matthew,0,0,16,16
1715621777992,MMW 13R,A01,514037,Staff,0,5,16,16
1715621777992,MMW 13R,A02,514039,Staff,0,5,16,16
1715621777992,MMW 13R,A03,628519,Staff,0,4,16,16
1715621780047,SIO 295LS,A00,523233,Staff,10,0,30,20
1715621781073,SIO 295S,A00,523232,Staff,10,0,30,20
1715621782097,SIOC 290S,A01,637330,Merrifield; Mark A,23,0,30,7
1715621783124,SIOC 291S,A01,637333,Gabriel; Corey John,23,0,30,7
1715621784149,SOCI 117,A01,494376,Staff,0,5,5,5
1715621785174,WES 237B,A00,494380,Staff,10,0,20,10
1715621787252,AESE 279B,A00,494370,Wade; Jon P,0,0,33,33
1715621788279,AIP 97,001,660915,Van Den Einde; Yael Dahlia,9998,0,9999,1
1715621789310,AIP 197,001,627712,Vespa; Emanuel Ignacio,9995,0,9999,4
1715621789310,AIP 197,002,650778,Amir; On,9998,0,9999,1
1715621789310,AIP 197,003,650933,Avenancio-Leon; Carlos,9998,0,9999,1
1715621789310,AIP 197,004,658530,Heyman; Gail D.,9998,0,9999,1
1715621789310,AIP 197,005,658631,Neal; Sonya E,9998,0,9999,1
1715621789310,AIP 197,006,658671,Du; Songzi,9998,0,9999,1
1715621790335,ANAR 135S,A00,494369,Braswell; Geoffrey E.,0,0,0,0
1715621791364,BENG 196,001,628496,Engler; Adam J.,9998,0,9999,1
1715621791364,BENG 196,002,660916,Watson; John Thomas,9999,0,9999,0
1715621792391,BISP 197,001,650773,Wilhelm; James E.,9994,0,9999,5
1715621792391,BISP 197,002,658904,Coleman; Aaron B.,9998,0,9999,1
1715621793416,CAT 124RS,A01,519847,Geibel; William,0,0,20,20
1715621794442,CAT 125RS,A01,515971,Geibel; William,0,0,20,20
1715621795468,CLRE 250,A00,511389,Morris; Sheldon,9992,0,9999,7
1715621796496,CLRE 251,A00,507176,Mehta; Ravindra L.,9992,0,9999,7
1715621796496,CLRE 251,B00,511410,Mehta; Ravindra L.,9998,0,9999,1
1715621797522,CLRE 252,A00,507189,Cuomo; Raphael Eduardo,9994,0,9999,5
1715621798549,CLRE 253,A00,507199,Vaida; Florin,9994,0,9999,5
1715621798549,CLRE 253,B00,507202,Vaida; Florin,9999,0,9999,0
1715621799579,CLRE 259,A00,507211,Patel; Hemal,9996,0,9999,3
1715621800605,CLRE 260,A00,507221,Cuomo; Raphael Eduardo,9999,0,9999,0
1715621801633,CLRE 297,001,507242,Cuomo; Raphael Eduardo,9999,0,9999,0
1715621802662,COGS 197,001,638244,Voytek; Bradley Thomas,9997,0,9999,2
1715621803687,CSE 191,A00,516875,Minnes Kemp; Mor Mia,9991,0,9999,8
1715621804716,CSE 197,001,637388,Minnes Kemp; Mor Mia,9992,0,9999,7
1715621805742,CSS 201S,A01,494383,Mignozzetti; Umberto,35,0,35,0
1715621806772,CSS 202S,A01,494387,Mignozzetti; Umberto,35,0,35,0
1715621807799,DSC 197,001,628532,Eldridge; Justin Matthew,9995,0,9999,4
1715621808827,EAP 100,A00,516065,Staff,9799,0,9999,200
1715621809856,ECE 45,A01,507414,Staff,31,0,60,29
1715621811912,ECE 111,A01,507420,Staff,11,0,50,39
1715621812937,ECE 197,001,548057,Sievenpiper; Daniel F.,9991,0,9999,8
1715621813964,EDS 115,A00,507243,Choi; Bailey Miyeon,7,0,28,21
1715621814990,EDS 117,A01,494379,Staff,0,6,34,34
1715621816015,EDS 125,A00,507246,Hopkins; Megan Beth,8,0,30,22
1715621817043,EDS 128A,A01,507264,Fargason; Sharon Gayle,6,0,26,20
1715621818070,EDS 128B,A01,507293,Pappas; Elizabeth,10,0,30,20
1715621819098,EDS 139,A00,507294,Fargason; Sharon Gayle,10,0,30,20
1715621819098,EDS 139,B00,507313,Pappas; Elizabeth,11,0,30,19
1715621820126,EDS 201,A00,507315,Staff,10,0,30,20
1715621821152,EDS 203,A01,507317,Halter; Christopher P.,10,0,30,20
1715621822178,EDS 204R,A01,507319,Halter; Christopher P.,0,3,30,30
1715621822178,EDS 204R,B01,507331,Heinzman; Erica M.,14,0,30,16
1715621823202,EDS 206R,A00,507332,Staff,0,4,30,30
1715621823202,EDS 206R,B00,507343,Staff,15,0,30,15
1715621824232,EDS 250,A00,507344,Hemans; Patricia Ann Benitez,20,0,40,20
1715621825257,EDS 281,A00,507345,Daly; Alan J.,18,0,18,0
1715621826284,EDS 284,A00,507350,Daly; Alan J.,16,0,16,0
1715621827311,EDS 286,A00,507359,Fine; Sarah,18,0,18,0
1715621828337,EDS 289C,A01,507361,Daly; Alan J.,18,0,18,0
1715621829363,EDS 290,A00,507366,Hofstetter; Carolyn,15,0,15,0
1715621830390,LIGM 5A,A00,507421,Fischer-Grunski; Eva K,17,0,20,3
1715621831416,LIGM 5B,A00,507423,Fischer-Grunski; Eva K,19,0,20,1
1715621832446,LIGM 5C,A00,507425,Fischer-Grunski; Eva K,19,0,20,1
1715621833472,LIIT 5AS,A00,507427,Carnelos; Chiara,20,0,20,0
1715621834497,LIIT 5BS,A00,507430,Carnelos; Chiara,20,0,20,0
1715621835527,LIIT 5CS,A00,507432,Carnelos; Chiara,20,0,20,0
1715621836552,LISP 5A,A00,507541,Munoz Sanchez; Alicia,11,0,20,9
1715621837577,LISP 5B,A00,507671,Munoz Sanchez; Alicia,9,0,20,11
1715621838606,LISP 5C,A00,507696,Munoz Sanchez; Alicia,9,0,20,11
1715621839637,MAE 197,001,528363,Boechler; Nicholas Sebastia,9998,0,9999,1
1715621840665,MATH 197,001,523477,Kedlaya; Kiran S.,9994,0,9999,5
1715621840665,MATH 197,002,563811,Zhang; Danna,9994,0,9999,5
1715621840665,MATH 197,003,628552,Dumitriu; Ioana,9998,0,9999,1
1715621840665,MATH 197,004,660885,Floyd; Eric,9998,0,9999,1
1715621841693,MCWP 40R,A00,518780,Staff,2,0,20,18
1715621841693,MCWP 40R,B00,518781,Staff,11,0,20,9
1715621841693,MCWP 40R,C00,518783,Staff,5,0,20,15
1715621842718,MCWP 50R,A00,518791,Staff,0,1,20,20
1715621842718,MCWP 50R,B00,518792,Staff,0,2,20,20
1715621842718,MCWP 50R,C00,518793,Staff,0,4,20,20
1715621842718,MCWP 50R,D00,518794,Staff,0,1,20,20
1715621842718,MCWP 50R,E00,518795,Staff,0,2,20,20
1715621842718,MCWP 50R,F00,518796,Staff,0,1,20,20
1715621842718,MCWP 50R,G00,518797,Staff,0,1,20,20
1715621843743,MMW 12R,A01,514034,Herbst; Matthew,0,2,16,16
1715621843743,MMW 12R,A02,514035,Herbst; Matthew,0,0,16,16
1715621844769,MMW 13R,A01,514037,Staff,0,5,16,16
1715621844769,MMW 13R,A02,514039,Staff,0,5,16,16
1715621844769,MMW 13R,A03,628519,Staff,0,4,16,16
1715621846821,SIO 295LS,A00,523233,Staff,10,0,30,20
1715621847849,SIO 295S,A00,523232,Staff,10,0,30,20
1715621848874,SIOC 290S,A01,637330,Merrifield; Mark A,23,0,30,7
1715621849900,SIOC 291S,A01,637333,Gabriel; Corey John,23,0,30,7
1715621850927,SOCI 117,A01,494376,Staff,0,5,5,5
1715621851955,WES 237B,A00,494380,Staff,10,0,20,10
1715621854019,AESE 279B,A00,494370,Wade; Jon P,0,0,33,33
1715621855045,AIP 97,001,660915,Van Den Einde; Yael Dahlia,9998,0,9999,1
1715621856071,AIP 197,001,627712,Vespa; Emanuel Ignacio,9995,0,9999,4
1715621856071,AIP 197,002,650778,Amir; On,9998,0,9999,1
1715621856071,AIP 197,003,650933,Avenancio-Leon; Carlos,9998,0,9999,1
1715621856071,AIP 197,004,658530,Heyman; Gail D.,9998,0,9999,1
1715621856071,AIP 197,005,658631,Neal; Sonya E,9998,0,9999,1
1715621856071,AIP 197,006,658671,Du; Songzi,9998,0,9999,1
1715621857099,ANAR 135S,A00,494369,Braswell; Geoffrey E.,0,0,0,0
1715621858129,BENG 196,001,628496,Engler; Adam J.,9998,0,9999,1
1715621858129,BENG 196,002,660916,Watson; John Thomas,9999,0,9999,0
1715621859159,BISP 197,001,650773,Wilhelm; James E.,9994,0,9999,5
1715621859159,BISP 197,002,658904,Coleman; Aaron B.,9998,0,9999,1
1715621860184,CAT 124RS,A01,519847,Geibel; William,0,0,20,20
1715621861209,CAT 125RS,A01,515971,Geibel; William,0,0,20,20
1715621862237,CLRE 250,A00,511389,Morris; Sheldon,9992,0,9999,7
1715621863264,CLRE 251,A00,507176,Mehta; Ravindra L.,9992,0,9999,7
1715621863264,CLRE 251,B00,511410,Mehta; Ravindra L.,9998,0,9999,1
1715621864293,CLRE 252,A00,507189,Cuomo; Raphael Eduardo,9994,0,9999,5
1715621865320,CLRE 253,A00,507199,Vaida; Florin,9994,0,9999,5
1715621865320,CLRE 253,B00,507202,Vaida; Florin,9999,0,9999,0
1715621866347,CLRE 259,A00,507211,Patel; Hemal,9996,0,9999,3
1715621867372,CLRE 260,A00,507221,Cuomo; Raphael Eduardo,9999,0,9999,0
1715621868396,CLRE 297,001,507242,Cuomo; Raphael Eduardo,9999,0,9999,0
1715621869422,COGS 197,001,638244,Voytek; Bradley Thomas,9997,0,9999,2
1715621870448,CSE 191,A00,516875,Minnes Kemp; Mor Mia,9991,0,9999,8
1715621871472,CSE 197,001,637388,Minnes Kemp; Mor Mia,9992,0,9999,7
1715621872499,CSS 201S,A01,494383,Mignozzetti; Umberto,35,0,35,0
1715621873530,CSS 202S,A01,494387,Mignozzetti; Umberto,35,0,35,0
1715621874560,DSC 197,001,628532,Eldridge; Justin Matthew,9995,0,9999,4
1715621875585,EAP 100,A00,516065,Staff,9799,0,9999,200
1715621876614,ECE 45,A01,507414,Staff,31,0,60,29
1715621878668,ECE 111,A01,507420,Staff,11,0,50,39
1715621879694,ECE 197,001,548057,Sievenpiper; Daniel F.,9991,0,9999,8
1715621880718,EDS 115,A00,507243,Choi; Bailey Miyeon,7,0,28,21
1715621881743,EDS 117,A01,494379,Staff,0,6,34,34
1715621882767,EDS 125,A00,507246,Hopkins; Megan Beth,8,0,30,22
1715621883797,EDS 128A,A01,507264,Fargason; Sharon Gayle,6,0,26,20
1715621884821,EDS 128B,A01,507293,Pappas; Elizabeth,10,0,30,20
1715621885846,EDS 139,A00,507294,Fargason; Sharon Gayle,10,0,30,20
1715621885846,EDS 139,B00,507313,Pappas; Elizabeth,11,0,30,19
1715621886874,EDS 201,A00,507315,Staff,10,0,30,20
1715621887900,EDS 203,A01,507317,Halter; Christopher P.,10,0,30,20
1715621888930,EDS 204R,A01,507319,Halter; Christopher P.,0,3,30,30
1715621888930,EDS 204R,B01,507331,Heinzman; Erica M.,14,0,30,16
1715621889956,EDS 206R,A00,507332,Staff,0,4,30,30
1715621889956,EDS 206R,B00,507343,Staff,15,0,30,15
1715621890981,EDS 250,A00,507344,Hemans; Patricia Ann Benitez,20,0,40,20
1715621892006,EDS 281,A00,507345,Daly; Alan J.,18,0,18,0
1715621893030,EDS 284,A00,507350,Daly; Alan J.,16,0,16,0
1715621894055,EDS 286,A00,507359,Fine; Sarah,18,0,18,0
1715621895078,EDS 289C,A01,507361,Daly; Alan J.,18,0,18,0
1715621896106,EDS 290,A00,507366,Hofstetter; Carolyn,15,0,15,0
1715621897135,LIGM 5A,A00,507421,Fischer-Grunski; Eva K,17,0,20,3
1715621898161,LIGM 5B,A00,507423,Fischer-Grunski; Eva K,19,0,20,1
1715621899186,LIGM 5C,A00,507425,Fischer-Grunski; Eva K,19,0,20,1
1715621900211,LIIT 5AS,A00,507427,Carnelos; Chiara,20,0,20,0
1715621901240,LIIT 5BS,A00,507430,Carnelos; Chiara,20,0,20,0
1715621902266,LIIT 5CS,A00,507432,Carnelos; Chiara,20,0,20,0
1715621903292,LISP 5A,A00,507541,Munoz Sanchez; Alicia,11,0,20,9
1715621904318,LISP 5B,A00,507671,Munoz Sanchez; Alicia,9,0,20,11
1715621905350,LISP 5C,A00,507696,Munoz Sanchez; Alicia,9,0,20,11
1715621906375,MAE 197,001,528363,Boechler; Nicholas Sebastia,9998,0,9999,1
1715621907400,MATH 197,001,523477,Kedlaya; Kiran S.,9994,0,9999,5
1715621907400,MATH 197,002,563811,Zhang; Danna,9994,0,9999,5
1715621907400,MATH 197,003,628552,Dumitriu; Ioana,9998,0,9999,1
1715621907400,MATH 197,004,660885,Floyd; Eric,9998,0,9999,1
1715621908425,MCWP 40R,A00,518780,Staff,2,0,20,18
1715621908425,MCWP 40R,B00,518781,Staff,11,0,20,9
1715621908425,MCWP 40R,C00,518783,Staff,5,0,20,15
1715621909455,MCWP 50R,A00,518791,Staff,0,1,20,20
1715621909455,MCWP 50R,B00,518792,Staff,0,2,20,20
1715621909455,MCWP 50R,C00,518793,Staff,0,4,20,20
1715621909455,MCWP 50R,D00,518794,Staff,0,1,20,20
1715621909455,MCWP 50R,E00,518795,Staff,0,2,20,20
1715621909455,MCWP 50R,F00,518796,Staff,0,1,20,20
1715621909455,MCWP 50R,G00,518797,Staff,0,1,20,20
1715621910486,MMW 12R,A01,514034,Herbst; Matthew,0,2,16,16
1715621910486,MMW 12R,A02,514035,Herbst; Matthew,0,0,16,16
1715621911512,MMW 13R,A01,514037,Staff,0,5,16,16
1715621911512,MMW 13R,A02,514039,Staff,0,5,16,16
1715621911512,MMW 13R,A03,628519,Staff,0,4,16,16
1715621913562,SIO 295LS,A00,523233,Staff,10,0,30,20
1715621914586,SIO 295S,A00,523232,Staff,10,0,30,20
1715621915617,SIOC 290S,A01,637330,Merrifield; Mark A,23,0,30,7
1715621916647,SIOC 291S,A01,637333,Gabriel; Corey John,23,0,30,7
1715621917674,SOCI 117,A01,494376,Staff,0,5,5,5
1715621918700,WES 237B,A00,494380,Staff,10,0,20,10
1715621920764,AESE 279B,A00,494370,Wade; Jon P,0,0,33,33
1715621921792,AIP 97,001,660915,Van Den Einde; Yael Dahlia,9998,0,9999,1
1715621922819,AIP 197,001,627712,Vespa; Emanuel Ignacio,9995,0,9999,4
1715621922819,AIP 197,002,650778,Amir; On,9998,0,9999,1
1715621922819,AIP 197,003,650933,Avenancio-Leon; Carlos,9998,0,9999,1
1715621922819,AIP 197,004,658530,Heyman; Gail D.,9998,0,9999,1
1715621922819,AIP 197,005,658631,Neal; Sonya E,9998,0,9999,1
1715621922819,AIP 197,006,658671,Du; Songzi,9998,0,9999,1
1715621923845,ANAR 135S,A00,494369,Braswell; Geoffrey E.,0,0,0,0
1715621924873,BENG 196,001,628496,Engler; Adam J.,9998,0,9999,1
1715621924873,BENG 196,002,660916,Watson; John Thomas,9999,0,9999,0
1715621925898,BISP 197,001,650773,Wilhelm; James E.,9994,0,9999,5
1715621925898,BISP 197,002,658904,Coleman; Aaron B.,9998,0,9999,1
1715621926924,CAT 124RS,A01,519847,Geibel; William,0,0,20,20
1715621927949,CAT 125RS,A01,515971,Geibel; William,0,0,20,20
1715621928977,CLRE 250,A00,511389,Morris; Sheldon,9992,0,9999,7
1715621930008,CLRE 251,A00,507176,Mehta; Ravindra L.,9992,0,9999,7
1715621930008,CLRE 251,B00,511410,Mehta; Ravindra L.,9998,0,9999,1
1715621931037,CLRE 252,A00,507189,Cuomo; Raphael Eduardo,9994,0,9999,5
1715621932063,CLRE 253,A00,507199,Vaida; Florin,9994,0,9999,5
1715621932063,CLRE 253,B00,507202,Vaida; Florin,9999,0,9999,0
1715621933094,CLRE 259,A00,507211,Patel; Hemal,9996,0,9999,3
1715621934119,CLRE 260,A00,507221,Cuomo; Raphael Eduardo,9999,0,9999,0
1715621935147,CLRE 297,001,507242,Cuomo; Raphael Eduardo,9999,0,9999,0
1715621936178,COGS 197,001,638244,Voytek; Bradley Thomas,9997,0,9999,2
1715621937206,CSE 191,A00,516875,Minnes Kemp; Mor Mia,9991,0,9999,8
1715621938234,CSE 197,001,637388,Minnes Kemp; Mor Mia,9992,0,9999,7
1715621939261,CSS 201S,A01,494383,Mignozzetti; Umberto,35,0,35,0
1715621940293,CSS 202S,A01,494387,Mignozzetti; Umberto,35,0,35,0
1715621941322,DSC 197,001,628532,Eldridge; Justin Matthew,9995,0,9999,4
1715621942347,EAP 100,A00,516065,Staff,9799,0,9999,200
1715621943380,ECE 45,A01,507414,Staff,31,0,60,29
1715621945489,ECE 111,A01,507420,Staff,11,0,50,39
1715621946517,ECE 197,001,548057,Sievenpiper; Daniel F.,9991,0,9999,8
1715621947546,EDS 115,A00,507243,Choi; Bailey Miyeon,7,0,28,21
1715621948575,EDS 117,A01,494379,Staff,0,6,34,34
1715621949603,EDS 125,A00,507246,Hopkins; Megan Beth,8,0,30,22
1715621950632,EDS 128A,A01,507264,Fargason; Sharon Gayle,6,0,26,20
1715621951658,EDS 128B,A01,507293,Pappas; Elizabeth,10,0,30,20
1715621952684,EDS 139,A00,507294,Fargason; Sharon Gayle,10,0,30,20
1715621952684,EDS 139,B00,507313,Pappas; Elizabeth,11,0,30,19
1715621953707,EDS 201,A00,507315,Staff,10,0,30,20
1715621954737,EDS 203,A01,507317,Halter; Christopher P.,10,0,30,20
1715621955763,EDS 204R,A01,507319,Halter; Christopher P.,0,3,30,30
1715621955763,EDS 204R,B01,507331,Heinzman; Erica M.,14,0,30,16
1715621956789,EDS 206R,A00,507332,Staff,0,4,30,30
1715621956789,EDS 206R,B00,507343,Staff,15,0,30,15
1715621957815,EDS 250,A00,507344,Hemans; Patricia Ann Benitez,20,0,40,20
1715621958844,EDS 281,A00,507345,Daly; Alan J.,18,0,18,0
1715621959871,EDS 284,A00,507350,Daly; Alan J.,16,0,16,0
1715621960898,EDS 286,A00,507359,Fine; Sarah,18,0,18,0
1715621961928,EDS 289C,A01,507361,Daly; Alan J.,18,0,18,0
1715621962952,EDS 290,A00,507366,Hofstetter; Carolyn,15,0,15,0
1715621963978,LIGM 5A,A00,507421,Fischer-Grunski; Eva K,17,0,20,3
1715621965003,LIGM 5B,A00,507423,Fischer-Grunski; Eva K,19,0,20,1
1715621966032,LIGM 5C,A00,507425,Fischer-Grunski; Eva K,19,0,20,1
1715621967059,LIIT 5AS,A00,507427,Carnelos; Chiara,20,0,20,0
1715621968088,LIIT 5BS,A00,507430,Carnelos; Chiara,20,0,20,0
1715621969112,LIIT 5CS,A00,507432,Carnelos; Chiara,20,0,20,0
1715621970141,LISP 5A,A00,507541,Munoz Sanchez; Alicia,11,0,20,9
1715621971168,LISP 5B,A00,507671,Munoz Sanchez; Alicia,9,0,20,11
1715621972197,LISP 5C,A00,507696,Munoz Sanchez; Alicia,9,0,20,11
1715621973243,MAE 197,001,528363,Boechler; Nicholas Sebastia,9998,0,9999,1
1715621974271,MATH 197,001,523477,Kedlaya; Kiran S.,9994,0,9999,5
1715621974271,MATH 197,002,563811,Zhang; Danna,9994,0,9999,5
1715621974271,MATH 197,003,628552,Dumitriu; Ioana,9998,0,9999,1
1715621974271,MATH 197,004,660885,Floyd; Eric,9998,0,9999,1
1715621975297,MCWP 40R,A00,518780,Staff,2,0,20,18
1715621975297,MCWP 40R,B00,518781,Staff,11,0,20,9
1715621975297,MCWP 40R,C00,518783,Staff,5,0,20,15
1715621976324,MCWP 50R,A00,518791,Staff,0,1,20,20
1715621976324,MCWP 50R,B00,518792,Staff,0,2,20,20
1715621976324,MCWP 50R,C00,518793,Staff,0,4,20,20
1715621976324,MCWP 50R,D00,518794,Staff,0,1,20,20
1715621976324,MCWP 50R,E00,518795,Staff,0,2,20,20
1715621976324,MCWP 50R,F00,518796,Staff,0,1,20,20
1715621976324,MCWP 50R,G00,518797,Staff,0,1,20,20
1715621977353,MMW 12R,A01,514034,Herbst; Matthew,0,2,16,16
1715621977353,MMW 12R,A02,514035,Herbst; Matthew,0,0,16,16
1715621978381,MMW 13R,A01,514037,Staff,0,5,16,16
1715621978381,MMW 13R,A02,514039,Staff,0,5,16,16
1715621978381,MMW 13R,A03,628519,Staff,0,4,16,16
1715621980433,SIO 295LS,A00,523233,Staff,10,0,30,20
1715621981457,SIO 295S,A00,523232,Staff,10,0,30,20
1715621982483,SIOC 290S,A01,637330,Merrifield; Mark A,23,0,30,7
1715621983507,SIOC 291S,A01,637333,Gabriel; Corey John,23,0,30,7
1715621984536,SOCI 117,A01,494376,Staff,0,5,5,5
1715621985560,WES 237B,A00,494380,Staff,10,0,20,10
1715621987636,AESE 279B,A00,494370,Wade; Jon P,0,0,33,33
1715621988662,AIP 97,001,660915,Van Den Einde; Yael Dahlia,9998,0,9999,1
1715621989687,AIP 197,001,627712,Vespa; Emanuel Ignacio,9995,0,9999,4
1715621989687,AIP 197,002,650778,Amir; On,9998,0,9999,1
1715621989687,AIP 197,003,650933,Avenancio-Leon; Carlos,9998,0,9999,1
1715621989687,AIP 197,004,658530,Heyman; Gail D.,9998,0,9999,1
1715621989687,AIP 197,005,658631,Neal; Sonya E,9998,0,9999,1
1715621989687,AIP 197,006,658671,Du; Songzi,9998,0,9999,1
1715621990712,ANAR 135S,A00,494369,Braswell; Geoffrey E.,0,0,0,0
1715621991738,BENG 196,001,628496,Engler; Adam J.,9998,0,9999,1
1715621991738,BENG 196,002,660916,Watson; John Thomas,9999,0,9999,0
1715621992765,BISP 197,001,650773,Wilhelm; James E.,9994,0,9999,5
1715621992765,BISP 197,002,658904,Coleman; Aaron B.,9998,0,9999,1
1715621993792,CAT 124RS,A01,519847,Geibel; William,0,0,20,20
1715621994821,CAT 125RS,A01,515971,Geibel; William,0,0,20,20
1715621995847,CLRE 250,A00,511389,Morris; Sheldon,9992,0,9999,7
1715621996871,CLRE 251,A00,507176,Mehta; Ravindra L.,9992,0,9999,7
1715621996871,CLRE 251,B00,511410,Mehta; Ravindra L.,9998,0,9999,1
1715621997897,CLRE 252,A00,507189,Cuomo; Raphael Eduardo,9994,0,9999,5
1715621998923,CLRE 253,A00,507199,Vaida; Florin,9994,0,9999,5
1715621998923,CLRE 253,B00,507202,Vaida; Florin,9999,0,9999,0
1715621999948,CLRE 259,A00,507211,Patel; Hemal,9996,0,9999,3
1715622000975,CLRE 260,A00,507221,Cuomo; Raphael Eduardo,9999,0,9999,0
1715622002005,CLRE 297,001,507242,Cuomo; Raphael Eduardo,9999,0,9999,0
1715622003030,COGS 197,001,638244,Voytek; Bradley Thomas,9997,0,9999,2
1715622004059,CSE 191,A00,516875,Minnes Kemp; Mor Mia,9991,0,9999,8
1715622005088,CSE 197,001,637388,Minnes Kemp; Mor Mia,9992,0,9999,7
1715622006114,CSS 201S,A01,494383,Mignozzetti; Umberto,35,0,35,0
1715622007140,CSS 202S,A01,494387,Mignozzetti; Umberto,35,0,35,0
1715622008167,DSC 197,001,628532,Eldridge; Justin Matthew,9995,0,9999,4
1715622009192,EAP 100,A00,516065,Staff,9799,0,9999,200
1715622010222,ECE 45,A01,507414,Staff,31,0,60,29
1715622012276,ECE 111,A01,507420,Staff,11,0,50,39
1715622013305,ECE 197,001,548057,Sievenpiper; Daniel F.,9991,0,9999,8
1715622014332,EDS 115,A00,507243,Choi; Bailey Miyeon,7,0,28,21
1715622015360,EDS 117,A01,494379,Staff,0,6,34,34
1715622016389,EDS 125,A00,507246,Hopkins; Megan Beth,8,0,30,22
1715622017414,EDS 128A,A01,507264,Fargason; Sharon Gayle,6,0,26,20
1715622018438,EDS 128B,A01,507293,Pappas; Elizabeth,10,0,30,20
1715622019465,EDS 139,A00,507294,Fargason; Sharon Gayle,10,0,30,20
1715622019465,EDS 139,B00,507313,Pappas; Elizabeth,11,0,30,19
1715622020490,EDS 201,A00,507315,Staff,10,0,30,20
1715622021518,EDS 203,A01,507317,Halter; Christopher P.,10,0,30,20
1715622022547,EDS 204R,A01,507319,Halter; Christopher P.,0,3,30,30
1715622022547,EDS 204R,B01,507331,Heinzman; Erica M.,14,0,30,16
1715622023576,EDS 206R,A00,507332,Staff,0,4,30,30
1715622023576,EDS 206R,B00,507343,Staff,15,0,30,15
1715622024606,EDS 250,A00,507344,Hemans; Patricia Ann Benitez,20,0,40,20
1715622025637,EDS 281,A00,507345,Daly; Alan J.,18,0,18,0
1715622026663,EDS 284,A00,507350,Daly; Alan J.,16,0,16,0
1715622027688,EDS 286,A00,507359,Fine; Sarah,18,0,18,0
1715622028717,EDS 289C,A01,507361,Daly; Alan J.,18,0,18,0
1715622029745,EDS 290,A00,507366,Hofstetter; Carolyn,15,0,15,0
1715622030774,LIGM 5A,A00,507421,Fischer-Grunski; Eva K,17,0,20,3
1715622031800,LIGM 5B,A00,507423,Fischer-Grunski; Eva K,19,0,20,1
1715622032828,LIGM 5C,A00,507425,Fischer-Grunski; Eva K,19,0,20,1
1715622033856,LIIT 5AS,A00,507427,Carnelos; Chiara,20,0,20,0
1715622034882,LIIT 5BS,A00,507430,Carnelos; Chiara,20,0,20,0
1715622035906,LIIT 5CS,A00,507432,Carnelos; Chiara,20,0,20,0
1715622036934,LISP 5A,A00,507541,Munoz Sanchez; Alicia,11,0,20,9
1715622037960,LISP 5B,A00,507671,Munoz Sanchez; Alicia,9,0,20,11
1715622038989,LISP 5C,A00,507696,Munoz Sanchez; Alicia,9,0,20,11
1715622040015,MAE 197,001,528363,Boechler; Nicholas Sebastia,9998,0,9999,1
1715622041042,MATH 197,001,523477,Kedlaya; Kiran S.,9994,0,9999,5
1715622041042,MATH 197,002,563811,Zhang; Danna,9994,0,9999,5
1715622041042,MATH 197,003,628552,Dumitriu; Ioana,9998,0,9999,1
1715622041042,MATH 197,004,660885,Floyd; Eric,9998,0,9999,1
1715622042068,MCWP 40R,A00,518780,Staff,2,0,20,18
1715622042068,MCWP 40R,B00,518781,Staff,11,0,20,9
1715622042068,MCWP 40R,C00,518783,Staff,5,0,20,15
1715622043093,MCWP 50R,A00,518791,Staff,0,1,20,20
1715622043093,MCWP 50R,B00,518792,Staff,0,2,20,20
1715622043093,MCWP 50R,C00,518793,Staff,0,4,20,20
1715622043093,MCWP 50R,D00,518794,Staff,0,1,20,20
1715622043093,MCWP 50R,E00,518795,Staff,0,2,20,20
1715622043093,MCWP 50R,F00,518796,Staff,0,1,20,20
1715622043093,MCWP 50R,G00,518797,Staff,0,1,20,20
1715622044117,MMW 12R,A01,514034,Herbst; Matthew,0,2,16,16
1715622044117,MMW 12R,A02,514035,Herbst; Matthew,0,0,16,16
1715622045142,MMW 13R,A01,514037,Staff,0,5,16,16
1715622045142,MMW 13R,A02,514039,Staff,0,5,16,16
1715622045142,MMW 13R,A03,628519,Staff,0,4,16,16
1715622047193,SIO 295LS,A00,523233,Staff,10,0,30,20
1715622048271,SIO 295S,A00,523232,Staff,10,0,30,20
1715622049297,SIOC 290S,A01,637330,Merrifield; Mark A,23,0,30,7
1715622050323,SIOC 291S,A01,637333,Gabriel; Corey John,23,0,30,7
1715622051348,SOCI 117,A01,494376,Staff,0,5,5,5
1715622052377,WES 237B,A00,494380,Staff,10,0,20,10
1715622054441,AESE 279B,A00,494370,Wade; Jon P,0,0,33,33
1715622055466,AIP 97,001,660915,Van Den Einde; Yael Dahlia,9998,0,9999,1
1715622056499,AIP 197,001,627712,Vespa; Emanuel Ignacio,9995,0,9999,4
1715622056499,AIP 197,002,650778,Amir; On,9998,0,9999,1
1715622056499,AIP 197,003,650933,Avenancio-Leon; Carlos,9998,0,9999,1
1715622056499,AIP 197,004,658530,Heyman; Gail D.,9998,0,9999,1
1715622056499,AIP 197,005,658631,Neal; Sonya E,9998,0,9999,1
1715622056499,AIP 197,006,658671,Du; Songzi,9998,0,9999,1
1715622057528,ANAR 135S,A00,494369,Braswell; Geoffrey E.,0,0,0,0
1715622058555,BENG 196,001,628496,Engler; Adam J.,9998,0,9999,1
1715622058555,BENG 196,002,660916,Watson; John Thomas,9999,0,9999,0
1715622059585,BISP 197,001,650773,Wilhelm; James E.,9994,0,9999,5
1715622059585,BISP 197,002,658904,Coleman; Aaron B.,9998,0,9999,1
1715622060612,CAT 124RS,A01,519847,Geibel; William,0,0,20,20
1715622061640,CAT 125RS,A01,515971,Geibel; William,0,0,20,20
1715622062665,CLRE 250,A00,511389,Morris; Sheldon,9992,0,9999,7
1715622063692,CLRE 251,A00,507176,Mehta; Ravindra L.,9992,0,9999,7
1715622063692,CLRE 251,B00,511410,Mehta; Ravindra L.,9998,0,9999,1
1715622064720,CLRE 252,A00,507189,Cuomo; Raphael Eduardo,9994,0,9999,5
1715622065749,CLRE 253,A00,507199,Vaida; Florin,9994,0,9999,5
1715622065749,CLRE 253,B00,507202,Vaida; Florin,9999,0,9999,0
1715622066777,CLRE 259,A00,507211,Patel; Hemal,9996,0,9999,3
1715622067804,CLRE 260,A00,507221,Cuomo; Raphael Eduardo,9999,0,9999,0
1715622068832,CLRE 297,001,507242,Cuomo; Raphael Eduardo,9999,0,9999,0
1715622069858,COGS 197,001,638244,Voytek; Bradley Thomas,9997,0,9999,2
1715622070884,CSE 191,A00,516875,Minnes Kemp; Mor Mia,9991,0,9999,8
1715622071910,CSE 197,001,637388,Minnes Kemp; Mor Mia,9992,0,9999,7
1715622072939,CSS 201S,A01,494383,Mignozzetti; Umberto,35,0,35,0
1715622073964,CSS 202S,A01,494387,Mignozzetti; Umberto,35,0,35,0
1715622074990,DSC 197,001,628532,Eldridge; Justin Matthew,9995,0,9999,4
1715622076017,EAP 100,A00,516065,Staff,9799,0,9999,200
1715622077044,ECE 45,A01,507414,Staff,31,0,60,29
1715622079096,ECE 111,A01,507420,Staff,11,0,50,39
1715622080124,ECE 197,001,548057,Sievenpiper; Daniel F.,9991,0,9999,8
1715622081149,EDS 115,A00,507243,Choi; Bailey Miyeon,7,0,28,21
1715622082176,EDS 117,A01,494379,Staff,0,6,34,34
1715622083206,EDS 125,A00,507246,Hopkins; Megan Beth,8,0,30,22
1715622084234,EDS 128A,A01,507264,Fargason; Sharon Gayle,6,0,26,20
1715622085263,EDS 128B,A01,507293,Pappas; Elizabeth,10,0,30,20
1715622086292,EDS 139,A00,507294,Fargason; Sharon Gayle,10,0,30,20
1715622086292,EDS 139,B00,507313,Pappas; Elizabeth,11,0,30,19
1715622087316,EDS 201,A00,507315,Staff,10,0,30,20
1715622088344,EDS 203,A01,507317,Halter; Christopher P.,10,0,30,20
1715622089375,EDS 204R,A01,507319,Halter; Christopher P.,0,3,30,30
1715622089375,EDS 204R,B01,507331,Heinzman; Erica M.,14,0,30,16
1715622090400,EDS 206R,A00,507332,Staff,0,4,30,30
1715622090400,EDS 206R,B00,507343,Staff,15,0,30,15
1715622091427,EDS 250,A00,507344,Hemans; Patricia Ann Benitez,20,0,40,20
1715622092454,EDS 281,A00,507345,Daly; Alan J.,18,0,18,0
1715622093481,EDS 284,A00,507350,Daly; Alan J.,16,0,16,0
1715622094508,EDS 286,A00,507359,Fine; Sarah,18,0,18,0
1715622095534,EDS 289C,A01,507361,Daly; Alan J.,18,0,18,0
1715622096560,EDS 290,A00,507366,Hofstetter; Carolyn,15,0,15,0
1715622097586,LIGM 5A,A00,507421,Fischer-Grunski; Eva K,17,0,20,3
1715622098615,LIGM 5B,A00,507423,Fischer-Grunski; Eva K,19,0,20,1
1715622099642,LIGM 5C,A00,507425,Fischer-Grunski; Eva K,19,0,20,1
1715622100671,LIIT 5AS,A00,507427,Carnelos; Chiara,20,0,20,0
1715622101706,LIIT 5BS,A00,507430,Carnelos; Chiara,20,0,20,0
1715622102732,LIIT 5CS,A00,507432,Carnelos; Chiara,20,0,20,0
1715622103759,LISP 5A,A00,507541,Munoz Sanchez; Alicia,11,0,20,9
1715622104785,LISP 5B,A00,507671,Munoz Sanchez; Alicia,9,0,20,11
1715622105809,LISP 5C,A00,507696,Munoz Sanchez; Alicia,9,0,20,11
1715622106834,MAE 197,001,528363,Boechler; Nicholas Sebastia,9998,0,9999,1
1715622107865,MATH 197,001,523477,Kedlaya; Kiran S.,9994,0,9999,5
1715622107865,MATH 197,002,563811,Zhang; Danna,9994,0,9999,5
1715622107865,MATH 197,003,628552,Dumitriu; Ioana,9998,0,9999,1
1715622107865,MATH 197,004,660885,Floyd; Eric,9998,0,9999,1
1715622108892,MCWP 40R,A00,518780,Staff,2,0,20,18
1715622108892,MCWP 40R,B00,518781,Staff,11,0,20,9
1715622108892,MCWP 40R,C00,518783,Staff,5,0,20,15
1715622109917,MCWP 50R,A00,518791,Staff,0,1,20,20
1715622109917,MCWP 50R,B00,518792,Staff,0,2,20,20
1715622109917,MCWP 50R,C00,518793,Staff,0,4,20,20
1715622109917,MCWP 50R,D00,518794,Staff,0,1,20,20
1715622109917,MCWP 50R,E00,518795,Staff,0,2,20,20
1715622109917,MCWP 50R,F00,518796,Staff,0,1,20,20
1715622109917,MCWP 50R,G00,518797,Staff,0,1,20,20
1715622110944,MMW 12R,A01,514034,Herbst; Matthew,0,2,16,16
1715622110944,MMW 12R,A02,514035,Herbst; Matthew,0,0,16,16
1715622111968,MMW 13R,A01,514037,Staff,0,5,16,16
1715622111968,MMW 13R,A02,514039,Staff,0,5,16,16
1715622111968,MMW 13R,A03,628519,Staff,0,4,16,16
1715622114025,SIO 295LS,A00,523233,Staff,10,0,30,20
1715622115052,SIO 295S,A00,523232,Staff,10,0,30,20
1715622116082,SIOC 290S,A01,637330,Merrifield; Mark A,23,0,30,7
1715622117106,SIOC 291S,A01,637333,Gabriel; Corey John,23,0,30,7
1715622118134,SOCI 117,A01,494376,Staff,0,5,5,5
1715622119161,WES 237B,A00,494380,Staff,10,0,20,10
1715622121246,AESE 279B,A00,494370,Wade; Jon P,0,0,33,33
1715622122275,AIP 97,001,660915,Van Den Einde; Yael Dahlia,9998,0,9999,1
1715622123309,AIP 197,001,627712,Vespa; Emanuel Ignacio,9995,0,9999,4
1715622123309,AIP 197,002,650778,Amir; On,9998,0,9999,1
1715622123309,AIP 197,003,650933,Avenancio-Leon; Carlos,9998,0,9999,1
1715622123309,AIP 197,004,658530,Heyman; Gail D.,9998,0,9999,1
1715622123309,AIP 197,005,658631,Neal; Sonya E,9998,0,9999,1
1715622123309,AIP 197,006,658671,Du; Songzi,9998,0,9999,1
1715622124334,ANAR 135S,A00,494369,Braswell; Geoffrey E.,0,0,0,0
1715622125361,BENG 196,001,628496,Engler; Adam J.,9998,0,9999,1
1715622125361,BENG 196,002,660916,Watson; John Thomas,9999,0,9999,0
1715622126390,BISP 197,001,650773,Wilhelm; James E.,9994,0,9999,5
1715622126390,BISP 197,002,658904,Coleman; Aaron B.,9998,0,9999,1
1715622127414,CAT 124RS,A01,519847,Geibel; William,0,0,20,20
1715622128440,CAT 125RS,A01,515971,Geibel; William,0,0,20,20
1715622129496,CLRE 250,A00,511389,Morris; Sheldon,9992,0,9999,7
1715622130521,CLRE 251,A00,507176,Mehta; Ravindra L.,9992,0,9999,7
1715622130521,CLRE 251,B00,511410,Mehta; Ravindra L.,9998,0,9999,1
1715622131550,CLRE 252,A00,507189,Cuomo; Raphael Eduardo,9994,0,9999,5
1715622132576,CLRE 253,A00,507199,Vaida; Florin,9994,0,9999,5
1715622132576,CLRE 253,B00,507202,Vaida; Florin,9999,0,9999,0
1715622133602,CLRE 259,A00,507211,Patel; Hemal,9996,0,9999,3
1715622134629,CLRE 260,A00,507221,Cuomo; Raphael Eduardo,9999,0,9999,0
1715622135655,CLRE 297,001,507242,Cuomo; Raphael Eduardo,9999,0,9999,0
1715622136682,COGS 197,001,638244,Voytek; Bradley Thomas,9997,0,9999,2
1715622137709,CSE 191,A00,516875,Minnes Kemp; Mor Mia,9991,0,9999,8
1715622138735,CSE 197,001,637388,Minnes Kemp; Mor Mia,9992,0,9999,7
1715622139763,CSS 201S,A01,494383,Mignozzetti; Umberto,35,0,35,0
1715622140792,CSS 202S,A01,494387,Mignozzetti; Umberto,35,0,35,0
1715622141822,DSC 197,001,628532,Eldridge; Justin Matthew,9995,0,9999,4
1715622142847,EAP 100,A00,516065,Staff,9799,0,9999,200
1715622143881,ECE 45,A01,507414,Staff,31,0,60,29
1715622145945,ECE 111,A01,507420,Staff,11,0,50,39
1715622146972,ECE 197,001,548057,Sievenpiper; Daniel F.,9991,0,9999,8
1715622148002,EDS 115,A00,507243,Choi; Bailey Miyeon,7,0,28,21
1715622149028,EDS 117,A01,494379,Staff,0,6,34,34
1715622150057,EDS 125,A00,507246,Hopkins; Megan Beth,8,0,30,22
1715622151083,EDS 128A,A01,507264,Fargason; Sharon Gayle,6,0,26,20
1715622152181,EDS 128B,A01,507293,Pappas; Elizabeth,10,0,30,20
1715622153204,EDS 139,A00,507294,Fargason; Sharon Gayle,10,0,30,20
1715622153204,EDS 139,B00,507313,Pappas; Elizabeth,11,0,30,19
1715622154229,EDS 201,A00,507315,Staff,10,0,30,20
1715622155256,EDS 203,A01,507317,Halter; Christopher P.,10,0,30,20
1715622156282,EDS 204R,A01,507319,Halter; Christopher P.,0,3,30,30
1715622156282,EDS 204R,B01,507331,Heinzman; Erica M.,14,0,30,16
1715622157310,EDS 206R,A00,507332,Staff,0,4,30,30
1715622157310,EDS 206R,B00,507343,Staff,15,0,30,15
1715622158334,EDS 250,A00,507344,Hemans; Patricia Ann Benitez,20,0,40,20
1715622159359,EDS 281,A00,507345,Daly; Alan J.,18,0,18,0
1715622160383,EDS 284,A00,507350,Daly; Alan J.,16,0,16,0
1715622161411,EDS 286,A00,507359,Fine; Sarah,18,0,18,0
1715622162436,EDS 289C,A01,507361,Daly; Alan J.,18,0,18,0
1715622163462,EDS 290,A00,507366,Hofstetter; Carolyn,15,0,15,0
1715622164487,LIGM 5A,A00,507421,Fischer-Grunski; Eva K,17,0,20,3
1715622165514,LIGM 5B,A00,507423,Fischer-Grunski; Eva K,19,0,20,1
1715622166545,LIGM 5C,A00,507425,Fischer-Grunski; Eva K,19,0,20,1
1715622167576,LIIT 5AS,A00,507427,Carnelos; Chiara,20,0,20,0
1715622168601,LIIT 5BS,A00,507430,Carnelos; Chiara,20,0,20,0
1715622169629,LIIT 5CS,A00,507432,Carnelos; Chiara,20,0,20,0
1715622170657,LISP 5A,A00,507541,Munoz Sanchez; Alicia,11,0,20,9
1715622171687,LISP 5B,A00,507671,Munoz Sanchez; Alicia,9,0,20,11
1715622172712,LISP 5C,A00,507696,Munoz Sanchez; Alicia,9,0,20,11
1715622173740,MAE 197,001,528363,Boechler; Nicholas Sebastia,9998,0,9999,1
1715622174765,MATH 197,001,523477,Kedlaya; Kiran S.,9994,0,9999,5
1715622174765,MATH 197,002,563811,Zhang; Danna,9994,0,9999,5
1715622174765,MATH 197,003,628552,Dumitriu; Ioana,9998,0,9999,1
1715622174765,MATH 197,004,660885,Floyd; Eric,9998,0,9999,1
1715622175791,MCWP 40R,A00,518780,Staff,2,0,20,18
1715622175791,MCWP 40R,B00,518781,Staff,11,0,20,9
1715622175791,MCWP 40R,C00,518783,Staff,5,0,20,15
1715622176822,MCWP 50R,A00,518791,Staff,0,1,20,20
1715622176822,MCWP 50R,B00,518792,Staff,0,2,20,20
1715622176822,MCWP 50R,C00,518793,Staff,0,4,20,20
1715622176822,MCWP 50R,D00,518794,Staff,0,1,20,20
1715622176822,MCWP 50R,E00,518795,Staff,0,2,20,20
1715622176822,MCWP 50R,F00,518796,Staff,0,1,20,20
1715622176822,MCWP 50R,G00,518797,Staff,0,1,20,20
1715622177848,MMW 12R,A01,514034,Herbst; Matthew,0,2,16,16
1715622177848,MMW 12R,A02,514035,Herbst; Matthew,0,0,16,16
1715622178872,MMW 13R,A01,514037,Staff,0,5,16,16
1715622178872,MMW 13R,A02,514039,Staff,0,5,16,16
1715622178872,MMW 13R,A03,628519,Staff,0,4,16,16
1715622180922,SIO 295LS,A00,523233,Staff,10,0,30,20
1715622181949,SIO 295S,A00,523232,Staff,10,0,30,20
1715622182975,SIOC 290S,A01,637330,Merrifield; Mark A,23,0,30,7
1715622184007,SIOC 291S,A01,637333,Gabriel; Corey John,23,0,30,7
1715622185031,SOCI 117,A01,494376,Staff,0,5,5,5
1715622186056,WES 237B,A00,494380,Staff,10,0,20,10
1715622188120,AESE 279B,A00,494370,Wade; Jon P,0,0,33,33
1715622189147,AIP 97,001,660915,Van Den Einde; Yael Dahlia,9998,0,9999,1
1715622190178,AIP 197,001,627712,Vespa; Emanuel Ignacio,9995,0,9999,4
1715622190178,AIP 197,002,650778,Amir; On,9998,0,9999,1
1715622190178,AIP 197,003,650933,Avenancio-Leon; Carlos,9998,0,9999,1
1715622190178,AIP 197,004,658530,Heyman; Gail D.,9998,0,9999,1
1715622190178,AIP 197,005,658631,Neal; Sonya E,9998,0,9999,1
1715622190178,AIP 197,006,658671,Du; Songzi,9998,0,9999,1
1715622191205,ANAR 135S,A00,494369,Braswell; Geoffrey E.,0,0,0,0
1715622192233,BENG 196,001,628496,Engler; Adam J.,9998,0,9999,1
1715622192233,BENG 196,002,660916,Watson; John Thomas,9999,0,9999,0
1715622193261,BISP 197,001,650773,Wilhelm; James E.,9994,0,9999,5
1715622193261,BISP 197,002,658904,Coleman; Aaron B.,9998,0,9999,1
1715622194291,CAT 124RS,A01,519847,Geibel; William,0,0,20,20
1715622195319,CAT 125RS,A01,515971,Geibel; William,0,0,20,20
1715622196349,CLRE 250,A00,511389,Morris; Sheldon,9992,0,9999,7
1715622197377,CLRE 251,A00,507176,Mehta; Ravindra L.,9992,0,9999,7
1715622197377,CLRE 251,B00,511410,Mehta; Ravindra L.,9998,0,9999,1
1715622198402,CLRE 252,A00,507189,Cuomo; Raphael Eduardo,9994,0,9999,5
1715622199430,CLRE 253,A00,507199,Vaida; Florin,9994,0,9999,5
1715622199430,CLRE 253,B00,507202,Vaida; Florin,9999,0,9999,0
1715622200458,CLRE 259,A00,507211,Patel; Hemal,9996,0,9999,3
1715622201487,CLRE 260,A00,507221,Cuomo; Raphael Eduardo,9999,0,9999,0
1715622202511,CLRE 297,001,507242,Cuomo; Raphael Eduardo,9999,0,9999,0
1715622203539,COGS 197,001,638244,Voytek; Bradley Thomas,9997,0,9999,2
1715622204563,CSE 191,A00,516875,Minnes Kemp; Mor Mia,9991,0,9999,8
1715622205587,CSE 197,001,637388,Minnes Kemp; Mor Mia,9992,0,9999,7
1715622206618,CSS 201S,A01,494383,Mignozzetti; Umberto,35,0,35,0
1715622207647,CSS 202S,A01,494387,Mignozzetti; Umberto,35,0,35,0
1715622208675,DSC 197,001,628532,Eldridge; Justin Matthew,9995,0,9999,4
1715622209702,EAP 100,A00,516065,Staff,9799,0,9999,200
1715622210729,ECE 45,A01,507414,Staff,31,0,60,29
1715622212779,ECE 111,A01,507420,Staff,11,0,50,39
1715622213806,ECE 197,001,548057,Sievenpiper; Daniel F.,9991,0,9999,8
1715622214836,EDS 115,A00,507243,Choi; Bailey Miyeon,7,0,28,21
1715622215867,EDS 117,A01,494379,Staff,0,6,34,34
1715622216894,EDS 125,A00,507246,Hopkins; Megan Beth,8,0,30,22
1715622217924,EDS 128A,A01,507264,Fargason; Sharon Gayle,6,0,26,20
1715622218949,EDS 128B,A01,507293,Pappas; Elizabeth,10,0,30,20
1715622219973,EDS 139,A00,507294,Fargason; Sharon Gayle,10,0,30,20
1715622219973,EDS 139,B00,507313,Pappas; Elizabeth,11,0,30,19
1715622221002,EDS 201,A00,507315,Staff,10,0,30,20
1715622222028,EDS 203,A01,507317,Halter; Christopher P.,10,0,30,20
1715622223052,EDS 204R,A01,507319,Halter; Christopher P.,0,3,30,30
1715622223052,EDS 204R,B01,507331,Heinzman; Erica M.,14,0,30,16
1715622224079,EDS 206R,A00,507332,Staff,0,4,30,30
1715622224079,EDS 206R,B00,507343,Staff,15,0,30,15
1715622225105,EDS 250,A00,507344,Hemans; Patricia Ann Benitez,20,0,40,20
1715622226132,EDS 281,A00,507345,Daly; Alan J.,18,0,18,0
1715622227159,EDS 284,A00,507350,Daly; Alan J.,16,0,16,0
1715622228185,EDS 286,A00,507359,Fine; Sarah,18,0,18,0
1715622229210,EDS 289C,A01,507361,Daly; Alan J.,18,0,18,0
1715622230237,EDS 290,A00,507366,Hofstetter; Carolyn,15,0,15,0
1715622231267,LIGM 5A,A00,507421,Fischer-Grunski; Eva K,17,0,20,3
1715622232292,LIGM 5B,A00,507423,Fischer-Grunski; Eva K,19,0,20,1
1715622233318,LIGM 5C,A00,507425,Fischer-Grunski; Eva K,19,0,20,1
1715622234343,LIIT 5AS,A00,507427,Carnelos; Chiara,20,0,20,0
1715622235372,LIIT 5BS,A00,507430,Carnelos; Chiara,20,0,20,0
1715622236397,LIIT 5CS,A00,507432,Carnelos; Chiara,20,0,20,0
1715622237423,LISP 5A,A00,507541,Munoz Sanchez; Alicia,11,0,20,9
1715622238449,LISP 5B,A00,507671,Munoz Sanchez; Alicia,9,0,20,11
1715622239535,LISP 5C,A00,507696,Munoz Sanchez; Alicia,9,0,20,11
1715622240561,MAE 197,001,528363,Boechler; Nicholas Sebastia,9998,0,9999,1
1715622241593,MATH 197,001,523477,Kedlaya; Kiran S.,9994,0,9999,5
1715622241593,MATH 197,002,563811,Zhang; Danna,9994,0,9999,5
1715622241593,MATH 197,003,628552,Dumitriu; Ioana,9998,0,9999,1
1715622241593,MATH 197,004,660885,Floyd; Eric,9998,0,9999,1
1715622242618,MCWP 40R,A00,518780,Staff,2,0,20,18
1715622242618,MCWP 40R,B00,518781,Staff,11,0,20,9
1715622242618,MCWP 40R,C00,518783,Staff,5,0,20,15
1715622243648,MCWP 50R,A00,518791,Staff,0,1,20,20
1715622243648,MCWP 50R,B00,518792,Staff,0,2,20,20
1715622243648,MCWP 50R,C00,518793,Staff,0,4,20,20
1715622243648,MCWP 50R,D00,518794,Staff,0,1,20,20
1715622243648,MCWP 50R,E00,518795,Staff,0,2,20,20
1715622243648,MCWP 50R,F00,518796,Staff,0,1,20,20
1715622243648,MCWP 50R,G00,518797,Staff,0,1,20,20
1715622244674,MMW 12R,A01,514034,Herbst; Matthew,0,2,16,16
1715622244674,MMW 12R,A02,514035,Herbst; Matthew,0,0,16,16
1715622245699,MMW 13R,A01,514037,Staff,0,5,16,16
1715622245699,MMW 13R,A02,514039,Staff,0,5,16,16
1715622245699,MMW 13R,A03,628519,Staff,0,4,16,16
1715622247753,SIO 295LS,A00,523233,Staff,10,0,30,20
1715622248782,SIO 295S,A00,523232,Staff,10,0,30,20
1715622249812,SIOC 290S,A01,637330,Merrifield; Mark A,23,0,30,7
1715622250841,SIOC 291S,A01,637333,Gabriel; Corey John,23,0,30,7
1715622251865,SOCI 117,A01,494376,Staff,0,5,5,5
1715622252890,WES 237B,A00,494380,Staff,10,0,20,10
1715622254968,AESE 279B,A00,494370,Wade; Jon P,0,0,33,33
1715622255993,AIP 97,001,660915,Van Den Einde; Yael Dahlia,9998,0,9999,1
1715622257019,AIP 197,001,627712,Vespa; Emanuel Ignacio,9995,0,9999,4
1715622257019,AIP 197,002,650778,Amir; On,9998,0,9999,1
1715622257019,AIP 197,003,650933,Avenancio-Leon; Carlos,9998,0,9999,1
1715622257019,AIP 197,004,658530,Heyman; Gail D.,9998,0,9999,1
1715622257019,AIP 197,005,658631,Neal; Sonya E,9998,0,9999,1
1715622257019,AIP 197,006,658671,Du; Songzi,9998,0,9999,1
1715622258049,ANAR 135S,A00,494369,Braswell; Geoffrey E.,0,0,0,0
1715622259076,BENG 196,001,628496,Engler; Adam J.,9998,0,9999,1
1715622259076,BENG 196,002,660916,Watson; John Thomas,9999,0,9999,0
1715622260102,BISP 197,001,650773,Wilhelm; James E.,9994,0,9999,5
1715622260102,BISP 197,002,658904,Coleman; Aaron B.,9998,0,9999,1
1715622261127,CAT 124RS,A01,519847,Geibel; William,0,0,20,20
1715622262155,CAT 125RS,A01,515971,Geibel; William,0,0,20,20
1715622263185,CLRE 250,A00,511389,Morris; Sheldon,9992,0,9999,7
1715622264211,CLRE 251,A00,507176,Mehta; Ravindra L.,9992,0,9999,7
1715622264211,CLRE 251,B00,511410,Mehta; Ravindra L.,9998,0,9999,1
1715622265240,CLRE 252,A00,507189,Cuomo; Raphael Eduardo,9994,0,9999,5
1715622266269,CLRE 253,A00,507199,Vaida; Florin,9994,0,9999,5
1715622266269,CLRE 253,B00,507202,Vaida; Florin,9999,0,9999,0
1715622267300,CLRE 259,A00,507211,Patel; Hemal,9996,0,9999,3
1715622268324,CLRE 260,A00,507221,Cuomo; Raphael Eduardo,9999,0,9999,0
1715622269350,CLRE 297,001,507242,Cuomo; Raphael Eduardo,9999,0,9999,0
1715622270379,COGS 197,001,638244,Voytek; Bradley Thomas,9997,0,9999,2
1715622271406,CSE 191,A00,516875,Minnes Kemp; Mor Mia,9991,0,9999,8
1715622272431,CSE 197,001,637388,Minnes Kemp; Mor Mia,9992,0,9999,7
1715622273459,CSS 201S,A01,494383,Mignozzetti; Umberto,35,0,35,0
1715622274490,CSS 202S,A01,494387,Mignozzetti; Umberto,35,0,35,0
1715622275515,DSC 197,001,628532,Eldridge; Justin Matthew,9995,0,9999,4
1715622276540,EAP 100,A00,516065,Staff,9799,0,9999,200
1715622277574,ECE 45,A01,507414,Staff,31,0,60,29
1715622279628,ECE 111,A01,507420,Staff,11,0,50,39
1715622280655,ECE 197,001,548057,Sievenpiper; Daniel F.,9991,0,9999,8
1715622281682,EDS 115,A00,507243,Choi; Bailey Miyeon,7,0,28,21
1715622282710,EDS 117,A01,494379,Staff,0,6,34,34
1715622283740,EDS 125,A00,507246,Hopkins; Megan Beth,8,0,30,22
1715622284765,EDS 128A,A01,507264,Fargason; Sharon Gayle,6,0,26,20
1715622285793,EDS 128B,A01,507293,Pappas; Elizabeth,10,0,30,20
1715622286819,EDS 139,A00,507294,Fargason; Sharon Gayle,10,0,30,20
1715622286819,EDS 139,B00,507313,Pappas; Elizabeth,11,0,30,19
1715622287844,EDS 201,A00,507315,Staff,10,0,30,20
1715622288869,EDS 203,A01,507317,Halter; Christopher P.,10,0,30,20
1715622289894,EDS 204R,A01,507319,Halter; Christopher P.,0,3,30,30
1715622289894,EDS 204R,B01,507331,Heinzman; Erica M.,14,0,30,16
1715622290919,EDS 206R,A00,507332,Staff,0,4,30,30
1715622290919,EDS 206R,B00,507343,Staff,15,0,30,15
1715622291944,EDS 250,A00,507344,Hemans; Patricia Ann Benitez,20,0,40,20
1715622292968,EDS 281,A00,507345,Daly; Alan J.,18,0,18,0
1715622293997,EDS 284,A00,507350,Daly; Alan J.,16,0,16,0
1715622295023,EDS 286,A00,507359,Fine; Sarah,18,0,18,0
1715622296048,EDS 289C,A01,507361,Daly; Alan J.,18,0,18,0
1715622297072,EDS 290,A00,507366,Hofstetter; Carolyn,15,0,15,0
1715622298100,LIGM 5A,A00,507421,Fischer-Grunski; Eva K,17,0,20,3
1715622299131,LIGM 5B,A00,507423,Fischer-Grunski; Eva K,19,0,20,1
1715622300160,LIGM 5C,A00,507425,Fischer-Grunski; Eva K,19,0,20,1
1715622301183,LIIT 5AS,A00,507427,Carnelos; Chiara,20,0,20,0
1715622302212,LIIT 5BS,A00,507430,Carnelos; Chiara,20,0,20,0
1715622303237,LIIT 5CS,A00,507432,Carnelos; Chiara,20,0,20,0
1715622304264,LISP 5A,A00,507541,Munoz Sanchez; Alicia,11,0,20,9
1715622305291,LISP 5B,A00,507671,Munoz Sanchez; Alicia,9,0,20,11
1715622306315,LISP 5C,A00,507696,Munoz Sanchez; Alicia,9,0,20,11
1715622307340,MAE 197,001,528363,Boechler; Nicholas Sebastia,9998,0,9999,1
1715622308368,MATH 197,001,523477,Kedlaya; Kiran S.,9994,0,9999,5
1715622308368,MATH 197,002,563811,Zhang; Danna,9994,0,9999,5
1715622308368,MATH 197,003,628552,Dumitriu; Ioana,9998,0,9999,1
1715622308368,MATH 197,004,660885,Floyd; Eric,9998,0,9999,1
1715622309397,MCWP 40R,A00,518780,Staff,2,0,20,18
1715622309397,MCWP 40R,B00,518781,Staff,11,0,20,9
1715622309397,MCWP 40R,C00,518783,Staff,5,0,20,15
1715622310423,MCWP 50R,A00,518791,Staff,0,1,20,20
1715622310423,MCWP 50R,B00,518792,Staff,0,2,20,20
1715622310423,MCWP 50R,C00,518793,Staff,0,4,20,20
1715622310423,MCWP 50R,D00,518794,Staff,0,1,20,20
1715622310423,MCWP 50R,E00,518795,Staff,0,2,20,20
1715622310423,MCWP 50R,F00,518796,Staff,0,1,20,20
1715622310423,MCWP 50R,G00,518797,Staff,0,1,20,20
1715622311452,MMW 12R,A01,514034,Herbst; Matthew,0,2,16,16
1715622311452,MMW 12R,A02,514035,Herbst; Matthew,0,0,16,16
1715622312478,MMW 13R,A01,514037,Staff,0,5,16,16
1715622312478,MMW 13R,A02,514039,Staff,0,5,16,16
1715622312478,MMW 13R,A03,628519,Staff,0,4,16,16
1715622314529,SIO 295LS,A00,523233,Staff,10,0,30,20
1715622315558,SIO 295S,A00,523232,Staff,10,0,30,20
1715622316583,SIOC 290S,A01,637330,Merrifield; Mark A,23,0,30,7
1715622317609,SIOC 291S,A01,637333,Gabriel; Corey John,23,0,30,7
1715622318633,SOCI 117,A01,494376,Staff,0,5,5,5
1715622319660,WES 237B,A00,494380,Staff,10,0,20,10
1715622321725,AESE 279B,A00,494370,Wade; Jon P,0,0,33,33
1715622322753,AIP 97,001,660915,Van Den Einde; Yael Dahlia,9998,0,9999,1
1715622323779,AIP 197,001,627712,Vespa; Emanuel Ignacio,9995,0,9999,4
1715622323779,AIP 197,002,650778,Amir; On,9998,0,9999,1
1715622323779,AIP 197,003,650933,Avenancio-Leon; Carlos,9998,0,9999,1
1715622323779,AIP 197,004,658530,Heyman; Gail D.,9998,0,9999,1
1715622323779,AIP 197,005,658631,Neal; Sonya E,9998,0,9999,1
1715622323779,AIP 197,006,658671,Du; Songzi,9998,0,9999,1
1715622324807,ANAR 135S,A00,494369,Braswell; Geoffrey E.,0,0,0,0
1715622325836,BENG 196,001,628496,Engler; Adam J.,9998,0,9999,1
1715622325836,BENG 196,002,660916,Watson; John Thomas,9999,0,9999,0
1715622326862,BISP 197,001,650773,Wilhelm; James E.,9994,0,9999,5
1715622326862,BISP 197,002,658904,Coleman; Aaron B.,9998,0,9999,1
1715622327887,CAT 124RS,A01,519847,Geibel; William,0,0,20,20
1715622328913,CAT 125RS,A01,515971,Geibel; William,0,0,20,20
1715622329940,CLRE 250,A00,511389,Morris; Sheldon,9992,0,9999,7
1715622330966,CLRE 251,A00,507176,Mehta; Ravindra L.,9992,0,9999,7
1715622330966,CLRE 251,B00,511410,Mehta; Ravindra L.,9998,0,9999,1
1715622331991,CLRE 252,A00,507189,Cuomo; Raphael Eduardo,9994,0,9999,5
1715622333573,CLRE 253,A00,507199,Vaida; Florin,9994,0,9999,5
1715622333573,CLRE 253,B00,507202,Vaida; Florin,9999,0,9999,0
1715622334598,CLRE 259,A00,507211,Patel; Hemal,9996,0,9999,3
1715622335623,CLRE 260,A00,507221,Cuomo; Raphael Eduardo,9999,0,9999,0
1715622336650,CLRE 297,001,507242,Cuomo; Raphael Eduardo,9999,0,9999,0
1715622337673,COGS 197,001,638244,Voytek; Bradley Thomas,9997,0,9999,2
1715622338701,CSE 191,A00,516875,Minnes Kemp; Mor Mia,9991,0,9999,8
1715622339727,CSE 197,001,637388,Minnes Kemp; Mor Mia,9992,0,9999,7
1715622340754,CSS 201S,A01,494383,Mignozzetti; Umberto,35,0,35,0
1715622341779,CSS 202S,A01,494387,Mignozzetti; Umberto,35,0,35,0
1715622342803,DSC 197,001,628532,Eldridge; Justin Matthew,9995,0,9999,4
1715622343828,EAP 100,A00,516065,Staff,9799,0,9999,200
1715622344861,ECE 45,A01,507414,Staff,31,0,60,29
1715622346911,ECE 111,A01,507420,Staff,11,0,50,39
1715622347937,ECE 197,001,548057,Sievenpiper; Daniel F.,9991,0,9999,8
1715622348964,EDS 115,A00,507243,Choi; Bailey Miyeon,7,0,28,21
1715622349990,EDS 117,A01,494379,Staff,0,6,34,34
1715622351018,EDS 125,A00,507246,Hopkins; Megan Beth,8,0,30,22
1715622352046,EDS 128A,A01,507264,Fargason; Sharon Gayle,6,0,26,20
1715622353071,EDS 128B,A01,507293,Pappas; Elizabeth,10,0,30,20
1715622354097,EDS 139,A00,507294,Fargason; Sharon Gayle,10,0,30,20
1715622354097,EDS 139,B00,507313,Pappas; Elizabeth,11,0,30,19
1715622355122,EDS 201,A00,507315,Staff,10,0,30,20
1715622356148,EDS 203,A01,507317,Halter; Christopher P.,10,0,30,20
1715622357176,EDS 204R,A01,507319,Halter; Christopher P.,0,3,30,30
1715622357176,EDS 204R,B01,507331,Heinzman; Erica M.,14,0,30,16
1715622358206,EDS 206R,A00,507332,Staff,0,4,30,30
1715622358206,EDS 206R,B00,507343,Staff,15,0,30,15
1715622359232,EDS 250,A00,507344,Hemans; Patricia Ann Benitez,20,0,40,20
1715622360259,EDS 281,A00,507345,Daly; Alan J.,18,0,18,0
1715622361287,EDS 284,A00,507350,Daly; Alan J.,16,0,16,0
1715622362312,EDS 286,A00,507359,Fine; Sarah,18,0,18,0
1715622363340,EDS 289C,A01,507361,Daly; Alan J.,18,0,18,0
1715622364366,EDS 290,A00,507366,Hofstetter; Carolyn,15,0,15,0
1715622365399,LIGM 5A,A00,507421,Fischer-Grunski; Eva K,17,0,20,3
1715622366423,LIGM 5B,A00,507423,Fischer-Grunski; Eva K,19,0,20,1
1715622367451,LIGM 5C,A00,507425,Fischer-Grunski; Eva K,19,0,20,1
1715622368479,LIIT 5AS,A00,507427,Carnelos; Chiara,20,0,20,0
1715622369504,LIIT 5BS,A00,507430,Carnelos; Chiara,20,0,20,0
1715622370529,LIIT 5CS,A00,507432,Carnelos; Chiara,20,0,20,0
1715622371554,LISP 5A,A00,507541,Munoz Sanchez; Alicia,11,0,20,9
1715622372584,LISP 5B,A00,507671,Munoz Sanchez; Alicia,9,0,20,11
1715622373608,LISP 5C,A00,507696,Munoz Sanchez; Alicia,9,0,20,11
1715622374635,MAE 197,001,528363,Boechler; Nicholas Sebastia,9998,0,9999,1
1715622375664,MATH 197,001,523477,Kedlaya; Kiran S.,9994,0,9999,5
1715622375664,MATH 197,002,563811,Zhang; Danna,9994,0,9999,5
1715622375664,MATH 197,003,628552,Dumitriu; Ioana,9998,0,9999,1
1715622375664,MATH 197,004,660885,Floyd; Eric,9998,0,9999,1
1715622376690,MCWP 40R,A00,518780,Staff,2,0,20,18
1715622376690,MCWP 40R,B00,518781,Staff,11,0,20,9
1715622376690,MCWP 40R,C00,518783,Staff,5,0,20,15
1715622377785,MCWP 50R,A00,518791,Staff,0,1,20,20
1715622377785,MCWP 50R,B00,518792,Staff,0,2,20,20
1715622377785,MCWP 50R,C00,518793,Staff,0,4,20,20
1715622377785,MCWP 50R,D00,518794,Staff,0,1,20,20
1715622377785,MCWP 50R,E00,518795,Staff,0,2,20,20
1715622377785,MCWP 50R,F00,518796,Staff,0,1,20,20
1715622377785,MCWP 50R,G00,518797,Staff,0,1,20,20
1715622378813,MMW 12R,A01,514034,Herbst; Matthew,0,2,16,16
1715622378813,MMW 12R,A02,514035,Herbst; Matthew,0,0,16,16
1715622379837,MMW 13R,A01,514037,Staff,0,5,16,16
1715622379837,MMW 13R,A02,514039,Staff,0,5,16,16
1715622379837,MMW 13R,A03,628519,Staff,0,4,16,16
1715622381888,SIO 295LS,A00,523233,Staff,10,0,30,20
1715622382914,SIO 295S,A00,523232,Staff,10,0,30,20
1715622383940,SIOC 290S,A01,637330,Merrifield; Mark A,23,0,30,7
1715622384969,SIOC 291S,A01,637333,Gabriel; Corey John,23,0,30,7
1715622385995,SOCI 117,A01,494376,Staff,0,5,5,5
1715622387020,WES 237B,A00,494380,Staff,10,0,20,10
1715622389092,AESE 279B,A00,494370,Wade; Jon P,0,0,33,33
1715622390118,AIP 97,001,660915,Van Den Einde; Yael Dahlia,9998,0,9999,1
1715622391149,AIP 197,001,627712,Vespa; Emanuel Ignacio,9995,0,9999,4
1715622391149,AIP 197,002,650778,Amir; On,9998,0,9999,1
1715622391149,AIP 197,003,650933,Avenancio-Leon; Carlos,9998,0,9999,1
1715622391149,AIP 197,004,658530,Heyman; Gail D.,9998,0,9999,1
1715622391149,AIP 197,005,658631,Neal; Sonya E,9998,0,9999,1
1715622391149,AIP 197,006,658671,Du; Songzi,9998,0,9999,1
1715622392174,ANAR 135S,A00,494369,Braswell; Geoffrey E.,0,0,0,0
1715622393199,BENG 196,001,628496,Engler; Adam J.,9998,0,9999,1
1715622393199,BENG 196,002,660916,Watson; John Thomas,9999,0,9999,0
1715622394226,BISP 197,001,650773,Wilhelm; James E.,9994,0,9999,5
1715622394226,BISP 197,002,658904,Coleman; Aaron B.,9998,0,9999,1
1715622395251,CAT 124RS,A01,519847,Geibel; William,0,0,20,20
1715622396276,CAT 125RS,A01,515971,Geibel; William,0,0,20,20
1715622397309,CLRE 250,A00,511389,Morris; Sheldon,9992,0,9999,7
1715622398341,CLRE 251,A00,507176,Mehta; Ravindra L.,9992,0,9999,7
1715622398341,CLRE 251,B00,511410,Mehta; Ravindra L.,9998,0,9999,1
1715622399367,CLRE 252,A00,507189,Cuomo; Raphael Eduardo,9994,0,9999,5
1715622400391,CLRE 253,A00,507199,Vaida; Florin,9994,0,9999,5
1715622400391,CLRE 253,B00,507202,Vaida; Florin,9999,0,9999,0
1715622401418,CLRE 259,A00,507211,Patel; Hemal,9996,0,9999,3
1715622402444,CLRE 260,A00,507221,Cuomo; Raphael Eduardo,9999,0,9999,0
1715622403468,CLRE 297,001,507242,Cuomo; Raphael Eduardo,9999,0,9999,0
1715622404495,COGS 197,001,638244,Voytek; Bradley Thomas,9997,0,9999,2
1715622405521,CSE 191,A00,516875,Minnes Kemp; Mor Mia,9991,0,9999,8
1715622406545,CSE 197,001,637388,Minnes Kemp; Mor Mia,9992,0,9999,7
1715622407575,CSS 201S,A01,494383,Mignozzetti; Umberto,35,0,35,0
1715622408600,CSS 202S,A01,494387,Mignozzetti; Umberto,35,0,35,0
1715622409626,DSC 197,001,628532,Eldridge; Justin Matthew,9995,0,9999,4
1715622410650,EAP 100,A00,516065,Staff,9799,0,9999,200
1715622411677,ECE 45,A01,507414,Staff,31,0,60,29
1715622413731,ECE 111,A01,507420,Staff,11,0,50,39
1715622414755,ECE 197,001,548057,Sievenpiper; Daniel F.,9991,0,9999,8
1715622415780,EDS 115,A00,507243,Choi; Bailey Miyeon,7,0,28,21
1715622416808,EDS 117,A01,494379,Staff,0,6,34,34
1715622417837,EDS 125,A00,507246,Hopkins; Megan Beth,8,0,30,22
1715622418862,EDS 128A,A01,507264,Fargason; Sharon Gayle,6,0,26,20
1715622419892,EDS 128B,A01,507293,Pappas; Elizabeth,10,0,30,20
1715622420916,EDS 139,A00,507294,Fargason; Sharon Gayle,10,0,30,20
1715622420916,EDS 139,B00,507313,Pappas; Elizabeth,11,0,30,19
1715622421939,EDS 201,A00,507315,Staff,10,0,30,20
1715622422966,EDS 203,A01,507317,Halter; Christopher P.,10,0,30,20
1715622423991,EDS 204R,A01,507319,Halter; Christopher P.,0,3,30,30
1715622423991,EDS 204R,B01,507331,Heinzman; Erica M.,14,0,30,16
1715622425014,EDS 206R,A00,507332,Staff,0,4,30,30
1715622425014,EDS 206R,B00,507343,Staff,15,0,30,15
1715622426045,EDS 250,A00,507344,Hemans; Patricia Ann Benitez,20,0,40,20
1715622427072,EDS 281,A00,507345,Daly; Alan J.,18,0,18,0
1715622428097,EDS 284,A00,507350,Daly; Alan J.,16,0,16,0
1715622429123,EDS 286,A00,507359,Fine; Sarah,18,0,18,0
1715622430148,EDS 289C,A01,507361,Daly; Alan J.,18,0,18,0
1715622431171,EDS 290,A00,507366,Hofstetter; Carolyn,15,0,15,0
1715622432195,LIGM 5A,A00,507421,Fischer-Grunski; Eva K,17,0,20,3
1715622433221,LIGM 5B,A00,507423,Fischer-Grunski; Eva K,19,0,20,1
1715622434245,LIGM 5C,A00,507425,Fischer-Grunski; Eva K,19,0,20,1
1715622435270,LIIT 5AS,A00,507427,Carnelos; Chiara,20,0,20,0
1715622436293,LIIT 5BS,A00,507430,Carnelos; Chiara,20,0,20,0
1715622437437,LIIT 5CS,A00,507432,Carnelos; Chiara,20,0,20,0
1715622438466,LISP 5A,A00,507541,Munoz Sanchez; Alicia,11,0,20,9
1715622439491,LISP 5B,A00,507671,Munoz Sanchez; Alicia,9,0,20,11
1715622440518,LISP 5C,A00,507696,Munoz Sanchez; Alicia,9,0,20,11
1715622441542,MAE 197,001,528363,Boechler; Nicholas Sebastia,9998,0,9999,1
1715622442569,MATH 197,001,523477,Kedlaya; Kiran S.,9994,0,9999,5
1715622442569,MATH 197,002,563811,Zhang; Danna,9994,0,9999,5
1715622442569,MATH 197,003,628552,Dumitriu; Ioana,9998,0,9999,1
1715622442569,MATH 197,004,660885,Floyd; Eric,9998,0,9999,1
1715622443592,MCWP 40R,A00,518780,Staff,2,0,20,18
1715622443592,MCWP 40R,B00,518781,Staff,11,0,20,9
1715622443592,MCWP 40R,C00,518783,Staff,5,0,20,15
1715622444621,MCWP 50R,A00,518791,Staff,0,1,20,20
1715622444621,MCWP 50R,B00,518792,Staff,0,2,20,20
1715622444621,MCWP 50R,C00,518793,Staff,0,4,20,20
1715622444621,MCWP 50R,D00,518794,Staff,0,1,20,20
1715622444621,MCWP 50R,E00,518795,Staff,0,2,20,20
1715622444621,MCWP 50R,F00,518796,Staff,0,1,20,20
1715622444621,MCWP 50R,G00,518797,Staff,0,1,20,20
1715622445647,MMW 12R,A01,514034,Herbst; Matthew,0,2,16,16
1715622445647,MMW 12R,A02,514035,Herbst; Matthew,0,0,16,16
1715622446673,MMW 13R,A01,514037,Staff,0,5,16,16
1715622446673,MMW 13R,A02,514039,Staff,0,5,16,16
1715622446673,MMW 13R,A03,628519,Staff,0,4,16,16
1715622448725,SIO 295LS,A00,523233,Staff,10,0,30,20
1715622449751,SIO 295S,A00,523232,Staff,10,0,30,20
1715622450776,SIOC 290S,A01,637330,Merrifield; Mark A,23,0,30,7
1715622451801,SIOC 291S,A01,637333,Gabriel; Corey John,23,0,30,7
1715622452832,SOCI 117,A01,494376,Staff,0,5,5,5
1715622453857,WES 237B,A00,494380,Staff,10,0,20,10
1715622455918,AESE 279B,A00,494370,Wade; Jon P,0,0,33,33
1715622456942,AIP 97,001,660915,Van Den Einde; Yael Dahlia,9998,0,9999,1
1715622457972,AIP 197,001,627712,Vespa; Emanuel Ignacio,9995,0,9999,4
1715622457972,AIP 197,002,650778,Amir; On,9998,0,9999,1
1715622457972,AIP 197,003,650933,Avenancio-Leon; Carlos,9998,0,9999,1
1715622457972,AIP 197,004,658530,Heyman; Gail D.,9998,0,9999,1
1715622457972,AIP 197,005,658631,Neal; Sonya E,9998,0,9999,1
1715622457972,AIP 197,006,658671,Du; Songzi,9998,0,9999,1
1715622459003,ANAR 135S,A00,494369,Braswell; Geoffrey E.,0,0,0,0
1715622460029,BENG 196,001,628496,Engler; Adam J.,9998,0,9999,1
1715622460029,BENG 196,002,660916,Watson; John Thomas,9999,0,9999,0
1715622461058,BISP 197,001,650773,Wilhelm; James E.,9994,0,9999,5
1715622461058,BISP 197,002,658904,Coleman; Aaron B.,9998,0,9999,1
1715622462085,CAT 124RS,A01,519847,Geibel; William,0,0,20,20
1715622463112,CAT 125RS,A01,515971,Geibel; William,0,0,20,20
1715622464137,CLRE 250,A00,511389,Morris; Sheldon,9992,0,9999,7
1715622465164,CLRE 251,A00,507176,Mehta; Ravindra L.,9992,0,9999,7
1715622465164,CLRE 251,B00,511410,Mehta; Ravindra L.,9998,0,9999,1
1715622466190,CLRE 252,A00,507189,Cuomo; Raphael Eduardo,9994,0,9999,5
1715622467217,CLRE 253,A00,507199,Vaida; Florin,9994,0,9999,5
1715622467217,CLRE 253,B00,507202,Vaida; Florin,9999,0,9999,0
1715622468242,CLRE 259,A00,507211,Patel; Hemal,9996,0,9999,3
1715622469283,CLRE 260,A00,507221,Cuomo; Raphael Eduardo,9999,0,9999,0
1715622470307,CLRE 297,001,507242,Cuomo; Raphael Eduardo,9999,0,9999,0
1715622471334,COGS 197,001,638244,Voytek; Bradley Thomas,9997,0,9999,2
1715622472361,CSE 191,A00,516875,Minnes Kemp; Mor Mia,9991,0,9999,8
1715622473390,CSE 197,001,637388,Minnes Kemp; Mor Mia,9992,0,9999,7
1715622474427,CSS 201S,A01,494383,Mignozzetti; Umberto,35,0,35,0
1715622475452,CSS 202S,A01,494387,Mignozzetti; Umberto,35,0,35,0
1715622476482,DSC 197,001,628532,Eldridge; Justin Matthew,9995,0,9999,4
1715622477508,EAP 100,A00,516065,Staff,9799,0,9999,200
1715622478537,ECE 45,A01,507414,Staff,31,0,60,29
1715622480592,ECE 111,A01,507420,Staff,11,0,50,39
1715622481620,ECE 197,001,548057,Sievenpiper; Daniel F.,9991,0,9999,8
1715622482649,EDS 115,A00,507243,Choi; Bailey Miyeon,7,0,28,21
1715622483673,EDS 117,A01,494379,Staff,0,6,34,34
1715622484699,EDS 125,A00,507246,Hopkins; Megan Beth,8,0,30,22
1715622485722,EDS 128A,A01,507264,Fargason; Sharon Gayle,6,0,26,20
1715622486751,EDS 128B,A01,507293,Pappas; Elizabeth,10,0,30,20
1715622487777,EDS 139,A00,507294,Fargason; Sharon Gayle,10,0,30,20
1715622487777,EDS 139,B00,507313,Pappas; Elizabeth,11,0,30,19
1715622488802,EDS 201,A00,507315,Staff,10,0,30,20
1715622489827,EDS 203,A01,507317,Halter; Christopher P.,10,0,30,20
1715622490851,EDS 204R,A01,507319,Halter; Christopher P.,0,3,30,30
1715622490851,EDS 204R,B01,507331,Heinzman; Erica M.,14,0,30,16
1715622491879,EDS 206R,A00,507332,Staff,0,4,30,30
1715622491879,EDS 206R,B00,507343,Staff,15,0,30,15
1715622492908,EDS 250,A00,507344,Hemans; Patricia Ann Benitez,20,0,40,20
1715622493933,EDS 281,A00,507345,Daly; Alan J.,18,0,18,0
1715622494959,EDS 284,A00,507350,Daly; Alan J.,16,0,16,0
1715622495982,EDS 286,A00,507359,Fine; Sarah,18,0,18,0
1715622497061,EDS 289C,A01,507361,Daly; Alan J.,18,0,18,0
1715622498086,EDS 290,A00,507366,Hofstetter; Carolyn,15,0,15,0
1715622499111,LIGM 5A,A00,507421,Fischer-Grunski; Eva K,17,0,20,3
1715622500137,LIGM 5B,A00,507423,Fischer-Grunski; Eva K,19,0,20,1
1715622501163,LIGM 5C,A00,507425,Fischer-Grunski; Eva K,19,0,20,1
1715622502192,LIIT 5AS,A00,507427,Carnelos; Chiara,20,0,20,0
1715622503220,LIIT 5BS,A00,507430,Carnelos; Chiara,20,0,20,0
1715622504246,LIIT 5CS,A00,507432,Carnelos; Chiara,20,0,20,0
1715622505271,LISP 5A,A00,507541,Munoz Sanchez; Alicia,11,0,20,9
1715622506299,LISP 5B,A00,507671,Munoz Sanchez; Alicia,9,0,20,11
1715622507327,LISP 5C,A00,507696,Munoz Sanchez; Alicia,9,0,20,11
1715622508351,MAE 197,001,528363,Boechler; Nicholas Sebastia,9998,0,9999,1
1715622509380,MATH 197,001,523477,Kedlaya; Kiran S.,9994,0,9999,5
1715622509380,MATH 197,002,563811,Zhang; Danna,9994,0,9999,5
1715622509380,MATH 197,003,628552,Dumitriu; Ioana,9998,0,9999,1
1715622509380,MATH 197,004,660885,Floyd; Eric,9998,0,9999,1
1715622510405,MCWP 40R,A00,518780,Staff,2,0,20,18
1715622510405,MCWP 40R,B00,518781,Staff,11,0,20,9
1715622510405,MCWP 40R,C00,518783,Staff,5,0,20,15
1715622511431,MCWP 50R,A00,518791,Staff,0,1,20,20
1715622511431,MCWP 50R,B00,518792,Staff,0,2,20,20
1715622511431,MCWP 50R,C00,518793,Staff,0,4,20,20
1715622511431,MCWP 50R,D00,518794,Staff,0,1,20,20
1715622511431,MCWP 50R,E00,518795,Staff,0,2,20,20
1715622511431,MCWP 50R,F00,518796,Staff,0,1,20,20
1715622511431,MCWP 50R,G00,518797,Staff,0,1,20,20
1715622512454,MMW 12R,A01,514034,Herbst; Matthew,0,2,16,16
1715622512454,MMW 12R,A02,514035,Herbst; Matthew,0,0,16,16
1715622513479,MMW 13R,A01,514037,Staff,0,5,16,16
1715622513479,MMW 13R,A02,514039,Staff,0,5,16,16
1715622513479,MMW 13R,A03,628519,Staff,0,4,16,16
1715622515532,SIO 295LS,A00,523233,Staff,10,0,30,20
1715622516557,SIO 295S,A00,523232,Staff,10,0,30,20
1715622517585,SIOC 290S,A01,637330,Merrifield; Mark A,23,0,30,7
1715622518611,SIOC 291S,A01,637333,Gabriel; Corey John,23,0,30,7
1715622519638,SOCI 117,A01,494376,Staff,0,5,5,5
1715622520662,WES 237B,A00,494380,Staff,10,0,20,10
1715622522738,AESE 279B,A00,494370,Wade; Jon P,0,0,33,33
1715622523762,AIP 97,001,660915,Van Den Einde; Yael Dahlia,9998,0,9999,1
1715622524788,AIP 197,001,627712,Vespa; Emanuel Ignacio,9995,0,9999,4
1715622524788,AIP 197,002,650778,Amir; On,9998,0,9999,1
1715622524788,AIP 197,003,650933,Avenancio-Leon; Carlos,9998,0,9999,1
1715622524788,AIP 197,004,658530,Heyman; Gail D.,9998,0,9999,1
1715622524788,AIP 197,005,658631,Neal; Sonya E,9998,0,9999,1
1715622524788,AIP 197,006,658671,Du; Songzi,9998,0,9999,1
1715622525814,ANAR 135S,A00,494369,Braswell; Geoffrey E.,0,0,0,0
1715622526840,BENG 196,001,628496,Engler; Adam J.,9998,0,9999,1
1715622526840,BENG 196,002,660916,Watson; John Thomas,9999,0,9999,0
1715622527869,BISP 197,001,650773,Wilhelm; James E.,9994,0,9999,5
1715622527869,BISP 197,002,658904,Coleman; Aaron B.,9998,0,9999,1
1715622528896,CAT 124RS,A01,519847,Geibel; William,0,0,20,20
1715622529922,CAT 125RS,A01,515971,Geibel; William,0,0,20,20
1715622530950,CLRE 250,A00,511389,Morris; Sheldon,9992,0,9999,7
1715622531975,CLRE 251,A00,507176,Mehta; Ravindra L.,9992,0,9999,7
1715622531975,CLRE 251,B00,511410,Mehta; Ravindra L.,9998,0,9999,1
1715622533003,CLRE 252,A00,507189,Cuomo; Raphael Eduardo,9994,0,9999,5
1715622534027,CLRE 253,A00,507199,Vaida; Florin,9994,0,9999,5
1715622534027,CLRE 253,B00,507202,Vaida; Florin,9999,0,9999,0
1715622535055,CLRE 259,A00,507211,Patel; Hemal,9996,0,9999,3
1715622536081,CLRE 260,A00,507221,Cuomo; Raphael Eduardo,9999,0,9999,0
1715622537107,CLRE 297,001,507242,Cuomo; Raphael Eduardo,9999,0,9999,0
1715622538136,COGS 197,001,638244,Voytek; Bradley Thomas,9997,0,9999,2
1715622539161,CSE 191,A00,516875,Minnes Kemp; Mor Mia,9991,0,9999,8
1715622540188,CSE 197,001,637388,Minnes Kemp; Mor Mia,9992,0,9999,7
1715622541214,CSS 201S,A01,494383,Mignozzetti; Umberto,35,0,35,0
1715622542239,CSS 202S,A01,494387,Mignozzetti; Umberto,35,0,35,0
1715622543270,DSC 197,001,628532,Eldridge; Justin Matthew,9995,0,9999,4
1715622544294,EAP 100,A00,516065,Staff,9799,0,9999,200
1715622545322,ECE 45,A01,507414,Staff,31,0,60,29
1715622547377,ECE 111,A01,507420,Staff,11,0,50,39
1715622548403,ECE 197,001,548057,Sievenpiper; Daniel F.,9991,0,9999,8
1715622549430,EDS 115,A00,507243,Choi; Bailey Miyeon,7,0,28,21
1715622550454,EDS 117,A01,494379,Staff,0,6,34,34
1715622551481,EDS 125,A00,507246,Hopkins; Megan Beth,8,0,30,22
1715622552507,EDS 128A,A01,507264,Fargason; Sharon Gayle,6,0,26,20
1715622553533,EDS 128B,A01,507293,Pappas; Elizabeth,10,0,30,20
1715622554562,EDS 139,A00,507294,Fargason; Sharon Gayle,10,0,30,20
1715622554562,EDS 139,B00,507313,Pappas; Elizabeth,11,0,30,19
1715622555586,EDS 201,A00,507315,Staff,10,0,30,20
1715622556610,EDS 203,A01,507317,Halter; Christopher P.,10,0,30,20
1715622557636,EDS 204R,A01,507319,Halter; Christopher P.,0,3,30,30
1715622557636,EDS 204R,B01,507331,Heinzman; Erica M.,14,0,30,16
1715622558661,EDS 206R,A00,507332,Staff,0,4,30,30
1715622558661,EDS 206R,B00,507343,Staff,15,0,30,15
1715622559686,EDS 250,A00,507344,Hemans; Patricia Ann Benitez,20,0,40,20
1715622560710,EDS 281,A00,507345,Daly; Alan J.,18,0,18,0
1715622561733,EDS 284,A00,507350,Daly; Alan J.,16,0,16,0
1715622562760,EDS 286,A00,507359,Fine; Sarah,18,0,18,0
1715622563786,EDS 289C,A01,507361,Daly; Alan J.,18,0,18,0
1715622564811,EDS 290,A00,507366,Hofstetter; Carolyn,15,0,15,0
1715622565839,LIGM 5A,A00,507421,Fischer-Grunski; Eva K,17,0,20,3
1715622566867,LIGM 5B,A00,507423,Fischer-Grunski; Eva K,19,0,20,1
1715622567892,LIGM 5C,A00,507425,Fischer-Grunski; Eva K,19,0,20,1
1715622568920,LIIT 5AS,A00,507427,Carnelos; Chiara,20,0,20,0
1715622569949,LIIT 5BS,A00,507430,Carnelos; Chiara,20,0,20,0
1715622570973,LIIT 5CS,A00,507432,Carnelos; Chiara,20,0,20,0
1715622571997,LISP 5A,A00,507541,Munoz Sanchez; Alicia,11,0,20,9
1715622573025,LISP 5B,A00,507671,Munoz Sanchez; Alicia,9,0,20,11
1715622574050,LISP 5C,A00,507696,Munoz Sanchez; Alicia,9,0,20,11
1715622575074,MAE 197,001,528363,Boechler; Nicholas Sebastia,9998,0,9999,1
1715622576099,MATH 197,001,523477,Kedlaya; Kiran S.,9994,0,9999,5
1715622576099,MATH 197,002,563811,Zhang; Danna,9994,0,9999,5
1715622576099,MATH 197,003,628552,Dumitriu; Ioana,9998,0,9999,1
1715622576099,MATH 197,004,660885,Floyd; Eric,9998,0,9999,1
1715622577125,MCWP 40R,A00,518780,Staff,2,0,20,18
1715622577125,MCWP 40R,B00,518781,Staff,11,0,20,9
1715622577125,MCWP 40R,C00,518783,Staff,5,0,20,15
1715622578152,MCWP 50R,A00,518791,Staff,0,1,20,20
1715622578152,MCWP 50R,B00,518792,Staff,0,2,20,20
1715622578152,MCWP 50R,C00,518793,Staff,0,4,20,20
1715622578152,MCWP 50R,D00,518794,Staff,0,1,20,20
1715622578152,MCWP 50R,E00,518795,Staff,0,2,20,20
1715622578152,MCWP 50R,F00,518796,Staff,0,1,20,20
1715622578152,MCWP 50R,G00,518797,Staff,0,1,20,20
1715622579187,MMW 12R,A01,514034,Herbst; Matthew,0,2,16,16
1715622579187,MMW 12R,A02,514035,Herbst; Matthew,0,0,16,16
1715622580211,MMW 13R,A01,514037,Staff,0,5,16,16
1715622580211,MMW 13R,A02,514039,Staff,0,5,16,16
1715622580211,MMW 13R,A03,628519,Staff,0,4,16,16
1715622582262,SIO 295LS,A00,523233,Staff,10,0,30,20
1715622583288,SIO 295S,A00,523232,Staff,10,0,30,20
1715622584315,SIOC 290S,A01,637330,Merrifield; Mark A,23,0,30,7
1715622585341,SIOC 291S,A01,637333,Gabriel; Corey John,23,0,30,7
1715622586369,SOCI 117,A01,494376,Staff,0,5,5,5
1715622587397,WES 237B,A00,494380,Staff,10,0,20,10
1715622589468,AESE 279B,A00,494370,Wade; Jon P,0,0,33,33
1715622590493,AIP 97,001,660915,Van Den Einde; Yael Dahlia,9998,0,9999,1
1715622591521,AIP 197,001,627712,Vespa; Emanuel Ignacio,9995,0,9999,4
1715622591521,AIP 197,002,650778,Amir; On,9998,0,9999,1
1715622591521,AIP 197,003,650933,Avenancio-Leon; Carlos,9998,0,9999,1
1715622591521,AIP 197,004,658530,Heyman; Gail D.,9998,0,9999,1
1715622591521,AIP 197,005,658631,Neal; Sonya E,9998,0,9999,1
1715622591521,AIP 197,006,658671,Du; Songzi,9998,0,9999,1
1715622592549,ANAR 135S,A00,494369,Braswell; Geoffrey E.,0,0,0,0
1715622593574,BENG 196,001,628496,Engler; Adam J.,9998,0,9999,1
1715622593574,BENG 196,002,660916,Watson; John Thomas,9999,0,9999,0
1715622594599,BISP 197,001,650773,Wilhelm; James E.,9994,0,9999,5
1715622594599,BISP 197,002,658904,Coleman; Aaron B.,9998,0,9999,1
1715622595628,CAT 124RS,A01,519847,Geibel; William,0,0,20,20
1715622596652,CAT 125RS,A01,515971,Geibel; William,0,0,20,20
1715622597681,CLRE 250,A00,511389,Morris; Sheldon,9992,0,9999,7
1715622598714,CLRE 251,A00,507176,Mehta; Ravindra L.,9992,0,9999,7
1715622598714,CLRE 251,B00,511410,Mehta; Ravindra L.,9998,0,9999,1
1715622599743,CLRE 252,A00,507189,Cuomo; Raphael Eduardo,9994,0,9999,5
1715622600772,CLRE 253,A00,507199,Vaida; Florin,9994,0,9999,5
1715622600772,CLRE 253,B00,507202,Vaida; Florin,9999,0,9999,0
1715622601799,CLRE 259,A00,507211,Patel; Hemal,9996,0,9999,3
1715622602826,CLRE 260,A00,507221,Cuomo; Raphael Eduardo,9999,0,9999,0
1715622603853,CLRE 297,001,507242,Cuomo; Raphael Eduardo,9999,0,9999,0
1715622604878,COGS 197,001,638244,Voytek; Bradley Thomas,9997,0,9999,2
1715622605904,CSE 191,A00,516875,Minnes Kemp; Mor Mia,9991,0,9999,8
1715622606929,CSE 197,001,637388,Minnes Kemp; Mor Mia,9992,0,9999,7
1715622607954,CSS 201S,A01,494383,Mignozzetti; Umberto,35,0,35,0
1715622608980,CSS 202S,A01,494387,Mignozzetti; Umberto,35,0,35,0
1715622610008,DSC 197,001,628532,Eldridge; Justin Matthew,9995,0,9999,4
1715622611033,EAP 100,A00,516065,Staff,9799,0,9999,200
1715622612071,ECE 45,A01,507414,Staff,31,0,60,29
1715622614121,ECE 111,A01,507420,Staff,11,0,50,39
1715622615147,ECE 197,001,548057,Sievenpiper; Daniel F.,9991,0,9999,8
1715622616174,EDS 115,A00,507243,Choi; Bailey Miyeon,7,0,28,21
1715622617202,EDS 117,A01,494379,Staff,0,6,34,34
1715622618228,EDS 125,A00,507246,Hopkins; Megan Beth,8,0,30,22
1715622619255,EDS 128A,A01,507264,Fargason; Sharon Gayle,6,0,26,20
1715622620283,EDS 128B,A01,507293,Pappas; Elizabeth,10,0,30,20
1715622621313,EDS 139,A00,507294,Fargason; Sharon Gayle,10,0,30,20
1715622621313,EDS 139,B00,507313,Pappas; Elizabeth,11,0,30,19
1715622622339,EDS 201,A00,507315,Staff,10,0,30,20
1715622623367,EDS 203,A01,507317,Halter; Christopher P.,10,0,30,20
1715622624393,EDS 204R,A01,507319,Halter; Christopher P.,0,3,30,30
1715622624393,EDS 204R,B01,507331,Heinzman; Erica M.,14,0,30,16
1715622625418,EDS 206R,A00,507332,Staff,0,4,30,30
1715622625418,EDS 206R,B00,507343,Staff,15,0,30,15
1715622626444,EDS 250,A00,507344,Hemans; Patricia Ann Benitez,20,0,40,20
1715622627472,EDS 281,A00,507345,Daly; Alan J.,18,0,18,0
1715622628498,EDS 284,A00,507350,Daly; Alan J.,16,0,16,0
1715622629528,EDS 286,A00,507359,Fine; Sarah,18,0,18,0
1715622630556,EDS 289C,A01,507361,Daly; Alan J.,18,0,18,0
1715622631585,EDS 290,A00,507366,Hofstetter; Carolyn,15,0,15,0
1715622632610,LIGM 5A,A00,507421,Fischer-Grunski; Eva K,17,0,20,3
1715622633644,LIGM 5B,A00,507423,Fischer-Grunski; Eva K,19,0,20,1
1715622634668,LIGM 5C,A00,507425,Fischer-Grunski; Eva K,19,0,20,1
1715622635695,LIIT 5AS,A00,507427,Carnelos; Chiara,20,0,20,0
1715622636726,LIIT 5BS,A00,507430,Carnelos; Chiara,20,0,20,0
1715622637751,LIIT 5CS,A00,507432,Carnelos; Chiara,20,0,20,0
1715622638778,LISP 5A,A00,507541,Munoz Sanchez; Alicia,11,0,20,9
1715622639807,LISP 5B,A00,507671,Munoz Sanchez; Alicia,9,0,20,11
1715622640831,LISP 5C,A00,507696,Munoz Sanchez; Alicia,9,0,20,11
1715622641855,MAE 197,001,528363,Boechler; Nicholas Sebastia,9998,0,9999,1
1715622642882,MATH 197,001,523477,Kedlaya; Kiran S.,9994,0,9999,5
1715622642882,MATH 197,002,563811,Zhang; Danna,9994,0,9999,5
1715622642882,MATH 197,003,628552,Dumitriu; Ioana,9998,0,9999,1
1715622642882,MATH 197,004,660885,Floyd; Eric,9998,0,9999,1
1715622643911,MCWP 40R,A00,518780,Staff,2,0,20,18
1715622643911,MCWP 40R,B00,518781,Staff,11,0,20,9
1715622643911,MCWP 40R,C00,518783,Staff,5,0,20,15
1715622644942,MCWP 50R,A00,518791,Staff,0,1,20,20
1715622644942,MCWP 50R,B00,518792,Staff,0,2,20,20
1715622644942,MCWP 50R,C00,518793,Staff,0,4,20,20
1715622644942,MCWP 50R,D00,518794,Staff,0,1,20,20
1715622644942,MCWP 50R,E00,518795,Staff,0,2,20,20
1715622644942,MCWP 50R,F00,518796,Staff,0,1,20,20
1715622644942,MCWP 50R,G00,518797,Staff,0,1,20,20
1715622645968,MMW 12R,A01,514034,Herbst; Matthew,0,2,16,16
1715622645968,MMW 12R,A02,514035,Herbst; Matthew,0,0,16,16
1715622646993,MMW 13R,A01,514037,Staff,0,5,16,16
1715622646993,MMW 13R,A02,514039,Staff,0,5,16,16
1715622646993,MMW 13R,A03,628519,Staff,0,4,16,16
1715622649046,SIO 295LS,A00,523233,Staff,10,0,30,20
1715622650072,SIO 295S,A00,523232,Staff,10,0,30,20
1715622651100,SIOC 290S,A01,637330,Merrifield; Mark A,23,0,30,7
1715622652129,SIOC 291S,A01,637333,Gabriel; Corey John,23,0,30,7
1715622653157,SOCI 117,A01,494376,Staff,0,5,5,5
1715622654184,WES 237B,A00,494380,Staff,10,0,20,10
1715622656261,AESE 279B,A00,494370,Wade; Jon P,0,0,33,33
1715622657288,AIP 97,001,660915,Van Den Einde; Yael Dahlia,9998,0,9999,1
1715622658316,AIP 197,001,627712,Vespa; Emanuel Ignacio,9995,0,9999,4
1715622658316,AIP 197,002,650778,Amir; On,9998,0,9999,1
1715622658316,AIP 197,003,650933,Avenancio-Leon; Carlos,9998,0,9999,1
1715622658316,AIP 197,004,658530,Heyman; Gail D.,9998,0,9999,1
1715622658316,AIP 197,005,658631,Neal; Sonya E,9998,0,9999,1
1715622658316,AIP 197,006,658671,Du; Songzi,9998,0,9999,1
1715622659342,ANAR 135S,A00,494369,Braswell; Geoffrey E.,0,0,0,0
1715622660367,BENG 196,001,628496,Engler; Adam J.,9998,0,9999,1
1715622660367,BENG 196,002,660916,Watson; John Thomas,9999,0,9999,0
1715622661393,BISP 197,001,650773,Wilhelm; James E.,9994,0,9999,5
1715622661393,BISP 197,002,658904,Coleman; Aaron B.,9998,0,9999,1
1715622662419,CAT 124RS,A01,519847,Geibel; William,0,0,20,20
1715622663445,CAT 125RS,A01,515971,Geibel; William,0,0,20,20
1715622664471,CLRE 250,A00,511389,Morris; Sheldon,9992,0,9999,7
1715622665500,CLRE 251,A00,507176,Mehta; Ravindra L.,9992,0,9999,7
1715622665500,CLRE 251,B00,511410,Mehta; Ravindra L.,9998,0,9999,1
1715622666527,CLRE 252,A00,507189,Cuomo; Raphael Eduardo,9994,0,9999,5
1715622667554,CLRE 253,A00,507199,Vaida; Florin,9994,0,9999,5
1715622667554,CLRE 253,B00,507202,Vaida; Florin,9999,0,9999,0
1715622668583,CLRE 259,A00,507211,Patel; Hemal,9996,0,9999,3
1715622669607,CLRE 260,A00,507221,Cuomo; Raphael Eduardo,9999,0,9999,0
1715622670632,CLRE 297,001,507242,Cuomo; Raphael Eduardo,9999,0,9999,0
1715622671657,COGS 197,001,638244,Voytek; Bradley Thomas,9997,0,9999,2
1715622672681,CSE 191,A00,516875,Minnes Kemp; Mor Mia,9991,0,9999,8
1715622673706,CSE 197,001,637388,Minnes Kemp; Mor Mia,9992,0,9999,7
1715622674734,CSS 201S,A01,494383,Mignozzetti; Umberto,35,0,35,0
1715622675761,CSS 202S,A01,494387,Mignozzetti; Umberto,35,0,35,0
1715622676789,DSC 197,001,628532,Eldridge; Justin Matthew,9995,0,9999,4
1715622677814,EAP 100,A00,516065,Staff,9799,0,9999,200
1715622678842,ECE 45,A01,507414,Staff,31,0,60,29
1715622680898,ECE 111,A01,507420,Staff,11,0,50,39
1715622681924,ECE 197,001,548057,Sievenpiper; Daniel F.,9991,0,9999,8
1715622682949,EDS 115,A00,507243,Choi; Bailey Miyeon,7,0,28,21
1715622683976,EDS 117,A01,494379,Staff,0,6,34,34
1715622685005,EDS 125,A00,507246,Hopkins; Megan Beth,8,0,30,22
1715622686029,EDS 128A,A01,507264,Fargason; Sharon Gayle,6,0,26,20
1715622687057,EDS 128B,A01,507293,Pappas; Elizabeth,10,0,30,20
1715622688083,EDS 139,A00,507294,Fargason; Sharon Gayle,10,0,30,20
1715622688083,EDS 139,B00,507313,Pappas; Elizabeth,11,0,30,19
1715622689109,EDS 201,A00,507315,Staff,10,0,30,20
1715622690138,EDS 203,A01,507317,Halter; Christopher P.,10,0,30,20
1715622691164,EDS 204R,A01,507319,Halter; Christopher P.,0,3,30,30
1715622691164,EDS 204R,B01,507331,Heinzman; Erica M.,14,0,30,16
1715622692189,EDS 206R,A00,507332,Staff,0,4,30,30
1715622692189,EDS 206R,B00,507343,Staff,15,0,30,15
1715622693214,EDS 250,A00,507344,Hemans; Patricia Ann Benitez,20,0,40,20
1715622694243,EDS 281,A00,507345,Daly; Alan J.,18,0,18,0
1715622695274,EDS 284,A00,507350,Daly; Alan J.,16,0,16,0
1715622696299,EDS 286,A00,507359,Fine; Sarah,18,0,18,0
1715622697325,EDS 289C,A01,507361,Daly; Alan J.,18,0,18,0
1715622698351,EDS 290,A00,507366,Hofstetter; Carolyn,15,0,15,0
1715622699380,LIGM 5A,A00,507421,Fischer-Grunski; Eva K,17,0,20,3
1715622700409,LIGM 5B,A00,507423,Fischer-Grunski; Eva K,19,0,20,1
1715622701437,LIGM 5C,A00,507425,Fischer-Grunski; Eva K,19,0,20,1
1715622702466,LIIT 5AS,A00,507427,Carnelos; Chiara,20,0,20,0
1715622703496,LIIT 5BS,A00,507430,Carnelos; Chiara,20,0,20,0
1715622704527,LIIT 5CS,A00,507432,Carnelos; Chiara,20,0,20,0
1715622705555,LISP 5A,A00,507541,Munoz Sanchez; Alicia,11,0,20,9
1715622706582,LISP 5B,A00,507671,Munoz Sanchez; Alicia,9,0,20,11
1715622707608,LISP 5C,A00,507696,Munoz Sanchez; Alicia,9,0,20,11
1715622708636,MAE 197,001,528363,Boechler; Nicholas Sebastia,9998,0,9999,1
1715622709668,MATH 197,001,523477,Kedlaya; Kiran S.,9994,0,9999,5
1715622709668,MATH 197,002,563811,Zhang; Danna,9994,0,9999,5
1715622709668,MATH 197,003,628552,Dumitriu; Ioana,9998,0,9999,1
1715622709668,MATH 197,004,660885,Floyd; Eric,9998,0,9999,1
1715622710694,MCWP 40R,A00,518780,Staff,2,0,20,18
1715622710694,MCWP 40R,B00,518781,Staff,11,0,20,9
1715622710694,MCWP 40R,C00,518783,Staff,5,0,20,15
1715622711722,MCWP 50R,A00,518791,Staff,0,1,20,20
1715622711722,MCWP 50R,B00,518792,Staff,0,2,20,20
1715622711722,MCWP 50R,C00,518793,Staff,0,4,20,20
1715622711722,MCWP 50R,D00,518794,Staff,0,1,20,20
1715622711722,MCWP 50R,E00,518795,Staff,0,2,20,20
1715622711722,MCWP 50R,F00,518796,Staff,0,1,20,20
1715622711722,MCWP 50R,G00,518797,Staff,0,1,20,20
1715622712751,MMW 12R,A01,514034,Herbst; Matthew,0,2,16,16
1715622712751,MMW 12R,A02,514035,Herbst; Matthew,0,0,16,16
1715622713780,MMW 13R,A01,514037,Staff,0,5,16,16
1715622713780,MMW 13R,A02,514039,Staff,0,5,16,16
1715622713780,MMW 13R,A03,628519,Staff,0,4,16,16
1715622715833,SIO 295LS,A00,523233,Staff,10,0,30,20
1715622716863,SIO 295S,A00,523232,Staff,10,0,30,20
1715622717889,SIOC 290S,A01,637330,Merrifield; Mark A,23,0,30,7
1715622718916,SIOC 291S,A01,637333,Gabriel; Corey John,23,0,30,7
1715622719944,SOCI 117,A01,494376,Staff,0,5,5,5
1715622720971,WES 237B,A00,494380,Staff,10,0,20,10
1715622723048,AESE 279B,A00,494370,Wade; Jon P,0,0,33,33
1715622724073,AIP 97,001,660915,Van Den Einde; Yael Dahlia,9998,0,9999,1
1715622725105,AIP 197,001,627712,Vespa; Emanuel Ignacio,9995,0,9999,4
1715622725105,AIP 197,002,650778,Amir; On,9998,0,9999,1
1715622725105,AIP 197,003,650933,Avenancio-Leon; Carlos,9998,0,9999,1
1715622725105,AIP 197,004,658530,Heyman; Gail D.,9998,0,9999,1
1715622725105,AIP 197,005,658631,Neal; Sonya E,9998,0,9999,1
1715622725105,AIP 197,006,658671,Du; Songzi,9998,0,9999,1
1715622726133,ANAR 135S,A00,494369,Braswell; Geoffrey E.,0,0,0,0
1715622727158,BENG 196,001,628496,Engler; Adam J.,9998,0,9999,1
1715622727158,BENG 196,002,660916,Watson; John Thomas,9999,0,9999,0
1715622728183,BISP 197,001,650773,Wilhelm; James E.,9994,0,9999,5
1715622728183,BISP 197,002,658904,Coleman; Aaron B.,9998,0,9999,1
1715622729212,CAT 124RS,A01,519847,Geibel; William,0,0,20,20
1715622730240,CAT 125RS,A01,515971,Geibel; William,0,0,20,20
1715622731266,CLRE 250,A00,511389,Morris; Sheldon,9992,0,9999,7
1715622732292,CLRE 251,A00,507176,Mehta; Ravindra L.,9992,0,9999,7
1715622732292,CLRE 251,B00,511410,Mehta; Ravindra L.,9998,0,9999,1
1715622733324,CLRE 252,A00,507189,Cuomo; Raphael Eduardo,9994,0,9999,5
1715622734353,CLRE 253,A00,507199,Vaida; Florin,9994,0,9999,5
1715622734353,CLRE 253,B00,507202,Vaida; Florin,9999,0,9999,0
1715622735379,CLRE 259,A00,507211,Patel; Hemal,9996,0,9999,3
1715622736404,CLRE 260,A00,507221,Cuomo; Raphael Eduardo,9999,0,9999,0
1715622737428,CLRE 297,001,507242,Cuomo; Raphael Eduardo,9999,0,9999,0
1715622738456,COGS 197,001,638244,Voytek; Bradley Thomas,9997,0,9999,2
1715622739482,CSE 191,A00,516875,Minnes Kemp; Mor Mia,9991,0,9999,8
1715622740509,CSE 197,001,637388,Minnes Kemp; Mor Mia,9992,0,9999,7
1715622741534,CSS 201S,A01,494383,Mignozzetti; Umberto,35,0,35,0
1715622742563,CSS 202S,A01,494387,Mignozzetti; Umberto,35,0,35,0
1715622743589,DSC 197,001,628532,Eldridge; Justin Matthew,9995,0,9999,4
1715622744614,EAP 100,A00,516065,Staff,9799,0,9999,200
1715622745644,ECE 45,A01,507414,Staff,31,0,60,29
1715622747723,ECE 111,A01,507420,Staff,11,0,50,39
1715622748752,ECE 197,001,548057,Sievenpiper; Daniel F.,9991,0,9999,8
1715622749777,EDS 115,A00,507243,Choi; Bailey Miyeon,7,0,28,21
1715622750809,EDS 117,A01,494379,Staff,0,6,34,34
1715622751835,EDS 125,A00,507246,Hopkins; Megan Beth,8,0,30,22
1715622752862,EDS 128A,A01,507264,Fargason; Sharon Gayle,6,0,26,20
1715622753898,EDS 128B,A01,507293,Pappas; Elizabeth,10,0,30,20
1715622754923,EDS 139,A00,507294,Fargason; Sharon Gayle,10,0,30,20
1715622754923,EDS 139,B00,507313,Pappas; Elizabeth,11,0,30,19
1715622755949,EDS 201,A00,507315,Staff,10,0,30,20
1715622756975,EDS 203,A01,507317,Halter; Christopher P.,10,0,30,20
1715622758000,EDS 204R,A01,507319,Halter; Christopher P.,0,3,30,30
1715622758000,EDS 204R,B01,507331,Heinzman; Erica M.,14,0,30,16
1715622759026,EDS 206R,A00,507332,Staff,0,4,30,30
1715622759026,EDS 206R,B00,507343,Staff,15,0,30,15
1715622760051,EDS 250,A00,507344,Hemans; Patricia Ann Benitez,20,0,40,20
1715622761075,EDS 281,A00,507345,Daly; Alan J.,18,0,18,0
1715622762100,EDS 284,A00,507350,Daly; Alan J.,16,0,16,0
1715622763127,EDS 286,A00,507359,Fine; Sarah,18,0,18,0
1715622764155,EDS 289C,A01,507361,Daly; Alan J.,18,0,18,0
1715622765182,EDS 290,A00,507366,Hofstetter; Carolyn,15,0,15,0
1715622766208,LIGM 5A,A00,507421,Fischer-Grunski; Eva K,17,0,20,3
1715622767234,LIGM 5B,A00,507423,Fischer-Grunski; Eva K,19,0,20,1
1715622768260,LIGM 5C,A00,507425,Fischer-Grunski; Eva K,19,0,20,1
1715622769291,LIIT 5AS,A00,507427,Carnelos; Chiara,20,0,20,0
1715622770317,LIIT 5BS,A00,507430,Carnelos; Chiara,20,0,20,0
1715622771347,LIIT 5CS,A00,507432,Carnelos; Chiara,20,0,20,0
1715622772372,LISP 5A,A00,507541,Munoz Sanchez; Alicia,11,0,20,9
1715622773398,LISP 5B,A00,507671,Munoz Sanchez; Alicia,9,0,20,11
1715622774425,LISP 5C,A00,507696,Munoz Sanchez; Alicia,9,0,20,11
1715622775450,MAE 197,001,528363,Boechler; Nicholas Sebastia,9998,0,9999,1
1715622776477,MATH 197,001,523477,Kedlaya; Kiran S.,9994,0,9999,5
1715622776477,MATH 197,002,563811,Zhang; Danna,9994,0,9999,5
1715622776477,MATH 197,003,628552,Dumitriu; Ioana,9998,0,9999,1
1715622776477,MATH 197,004,660885,Floyd; Eric,9998,0,9999,1
1715622777508,MCWP 40R,A00,518780,Staff,2,0,20,18
1715622777508,MCWP 40R,B00,518781,Staff,11,0,20,9
1715622777508,MCWP 40R,C00,518783,Staff,5,0,20,15
1715622778535,MCWP 50R,A00,518791,Staff,0,1,20,20
1715622778535,MCWP 50R,B00,518792,Staff,0,2,20,20
1715622778535,MCWP 50R,C00,518793,Staff,0,4,20,20
1715622778535,MCWP 50R,D00,518794,Staff,0,1,20,20
1715622778535,MCWP 50R,E00,518795,Staff,0,2,20,20
1715622778535,MCWP 50R,F00,518796,Staff,0,1,20,20
1715622778535,MCWP 50R,G00,518797,Staff,0,1,20,20
1715622779564,MMW 12R,A01,514034,Herbst; Matthew,0,2,16,16
1715622779564,MMW 12R,A02,514035,Herbst; Matthew,0,0,16,16
1715622780590,MMW 13R,A01,514037,Staff,0,5,16,16
1715622780590,MMW 13R,A02,514039,Staff,0,5,16,16
1715622780590,MMW 13R,A03,628519,Staff,0,4,16,16
1715622782648,SIO 295LS,A00,523233,Staff,10,0,30,20
1715622783674,SIO 295S,A00,523232,Staff,10,0,30,20
1715622784702,SIOC 290S,A01,637330,Merrifield; Mark A,23,0,30,7
1715622785734,SIOC 291S,A01,637333,Gabriel; Corey John,23,0,30,7
1715622786763,SOCI 117,A01,494376,Staff,0,5,5,5
1715622787791,WES 237B,A00,494380,Staff,10,0,20,10
1715622789857,AESE 279B,A00,494370,Wade; Jon P,0,0,33,33
1715622790883,AIP 97,001,660915,Van Den Einde; Yael Dahlia,9998,0,9999,1
1715622791913,AIP 197,001,627712,Vespa; Emanuel Ignacio,9995,0,9999,4
1715622791913,AIP 197,002,650778,Amir; On,9998,0,9999,1
1715622791913,AIP 197,003,650933,Avenancio-Leon; Carlos,9998,0,9999,1
1715622791913,AIP 197,004,658530,Heyman; Gail D.,9998,0,9999,1
1715622791913,AIP 197,005,658631,Neal; Sonya E,9998,0,9999,1
1715622791913,AIP 197,006,658671,Du; Songzi,9998,0,9999,1
1715622792944,ANAR 135S,A00,494369,Braswell; Geoffrey E.,0,0,0,0
1715622793972,BENG 196,001,628496,Engler; Adam J.,9998,0,9999,1
1715622793972,BENG 196,002,660916,Watson; John Thomas,9999,0,9999,0
1715622795002,BISP 197,001,650773,Wilhelm; James E.,9994,0,9999,5
1715622795002,BISP 197,002,658904,Coleman; Aaron B.,9998,0,9999,1
1715622796030,CAT 124RS,A01,519847,Geibel; William,0,0,20,20
1715622797055,CAT 125RS,A01,515971,Geibel; William,0,0,20,20
1715622798080,CLRE 250,A00,511389,Morris; Sheldon,9992,0,9999,7
1715622799106,CLRE 251,A00,507176,Mehta; Ravindra L.,9992,0,9999,7
1715622799106,CLRE 251,B00,511410,Mehta; Ravindra L.,9998,0,9999,1
1715622800134,CLRE 252,A00,507189,Cuomo; Raphael Eduardo,9994,0,9999,5
1715622801160,CLRE 253,A00,507199,Vaida; Florin,9994,0,9999,5
1715622801160,CLRE 253,B00,507202,Vaida; Florin,9999,0,9999,0
1715622802189,CLRE 259,A00,507211,Patel; Hemal,9996,0,9999,3
1715622803214,CLRE 260,A00,507221,Cuomo; Raphael Eduardo,9999,0,9999,0
1715622804239,CLRE 297,001,507242,Cuomo; Raphael Eduardo,9999,0,9999,0
1715622805266,COGS 197,001,638244,Voytek; Bradley Thomas,9997,0,9999,2
1715622806298,CSE 191,A00,516875,Minnes Kemp; Mor Mia,9991,0,9999,8
1715622807323,CSE 197,001,637388,Minnes Kemp; Mor Mia,9992,0,9999,7
1715622808353,CSS 201S,A01,494383,Mignozzetti; Umberto,35,0,35,0
1715622809383,CSS 202S,A01,494387,Mignozzetti; Umberto,35,0,35,0
1715622810410,DSC 197,001,628532,Eldridge; Justin Matthew,9995,0,9999,4
1715622811435,EAP 100,A00,516065,Staff,9799,0,9999,200
1715622812578,ECE 45,A01,507414,Staff,31,0,60,29
1715622814637,ECE 111,A01,507420,Staff,11,0,50,39
1715622815664,ECE 197,001,548057,Sievenpiper; Daniel F.,9991,0,9999,8
1715622816693,EDS 115,A00,507243,Choi; Bailey Miyeon,7,0,28,21
1715622817719,EDS 117,A01,494379,Staff,0,6,34,34
1715622818747,EDS 125,A00,507246,Hopkins; Megan Beth,8,0,30,22
1715622819774,EDS 128A,A01,507264,Fargason; Sharon Gayle,6,0,26,20
1715622820802,EDS 128B,A01,507293,Pappas; Elizabeth,10,0,30,20
1715622821828,EDS 139,A00,507294,Fargason; Sharon Gayle,10,0,30,20
1715622821828,EDS 139,B00,507313,Pappas; Elizabeth,11,0,30,19
1715622822854,EDS 201,A00,507315,Staff,10,0,30,20
1715622823883,EDS 203,A01,507317,Halter; Christopher P.,10,0,30,20
1715622824911,EDS 204R,A01,507319,Halter; Christopher P.,0,3,30,30
1715622824911,EDS 204R,B01,507331,Heinzman; Erica M.,14,0,30,16
1715622825936,EDS 206R,A00,507332,Staff,0,4,30,30
1715622825936,EDS 206R,B00,507343,Staff,15,0,30,15
1715622826965,EDS 250,A00,507344,Hemans; Patricia Ann Benitez,20,0,40,20
1715622827993,EDS 281,A00,507345,Daly; Alan J.,18,0,18,0
1715622829021,EDS 284,A00,507350,Daly; Alan J.,16,0,16,0
1715622830046,EDS 286,A00,507359,Fine; Sarah,18,0,18,0
1715622831078,EDS 289C,A01,507361,Daly; Alan J.,18,0,18,0
1715622832107,EDS 290,A00,507366,Hofstetter; Carolyn,15,0,15,0
1715622833140,LIGM 5A,A00,507421,Fischer-Grunski; Eva K,17,0,20,3
1715622834166,LIGM 5B,A00,507423,Fischer-Grunski; Eva K,19,0,20,1
1715622835191,LIGM 5C,A00,507425,Fischer-Grunski; Eva K,19,0,20,1
1715622836219,LIIT 5AS,A00,507427,Carnelos; Chiara,20,0,20,0
1715622837249,LIIT 5BS,A00,507430,Carnelos; Chiara,20,0,20,0
1715622838277,LIIT 5CS,A00,507432,Carnelos; Chiara,20,0,20,0
1715622839308,LISP 5A,A00,507541,Munoz Sanchez; Alicia,11,0,20,9
1715622840333,LISP 5B,A00,507671,Munoz Sanchez; Alicia,9,0,20,11
1715622841366,LISP 5C,A00,507696,Munoz Sanchez; Alicia,9,0,20,11
1715622842391,MAE 197,001,528363,Boechler; Nicholas Sebastia,9998,0,9999,1
1715622843425,MATH 197,001,523477,Kedlaya; Kiran S.,9994,0,9999,5
1715622843425,MATH 197,002,563811,Zhang; Danna,9994,0,9999,5
1715622843425,MATH 197,003,628552,Dumitriu; Ioana,9998,0,9999,1
1715622843425,MATH 197,004,660885,Floyd; Eric,9998,0,9999,1
1715622844455,MCWP 40R,A00,518780,Staff,2,0,20,18
1715622844455,MCWP 40R,B00,518781,Staff,11,0,20,9
1715622844455,MCWP 40R,C00,518783,Staff,5,0,20,15
1715622845484,MCWP 50R,A00,518791,Staff,0,1,20,20
1715622845484,MCWP 50R,B00,518792,Staff,0,2,20,20
1715622845484,MCWP 50R,C00,518793,Staff,0,4,20,20
1715622845484,MCWP 50R,D00,518794,Staff,0,1,20,20
1715622845484,MCWP 50R,E00,518795,Staff,0,2,20,20
1715622845484,MCWP 50R,F00,518796,Staff,0,1,20,20
1715622845484,MCWP 50R,G00,518797,Staff,0,1,20,20
1715622846512,MMW 12R,A01,514034,Herbst; Matthew,0,2,16,16
1715622846512,MMW 12R,A02,514035,Herbst; Matthew,0,0,16,16
1715622847540,MMW 13R,A01,514037,Staff,0,5,16,16
1715622847540,MMW 13R,A02,514039,Staff,0,5,16,16
1715622847540,MMW 13R,A03,628519,Staff,0,4,16,16
1715622849591,SIO 295LS,A00,523233,Staff,10,0,30,20
1715622850622,SIO 295S,A00,523232,Staff,10,0,30,20
1715622851649,SIOC 290S,A01,637330,Merrifield; Mark A,23,0,30,7
1715622852676,SIOC 291S,A01,637333,Gabriel; Corey John,23,0,30,7
1715622853704,SOCI 117,A01,494376,Staff,0,5,5,5
1715622854729,WES 237B,A00,494380,Staff,10,0,20,10
1715622856802,AESE 279B,A00,494370,Wade; Jon P,0,0,33,33
1715622857829,AIP 97,001,660915,Van Den Einde; Yael Dahlia,9998,0,9999,1
1715622858856,AIP 197,001,627712,Vespa; Emanuel Ignacio,9995,0,9999,4
1715622858856,AIP 197,002,650778,Amir; On,9998,0,9999,1
1715622858856,AIP 197,003,650933,Avenancio-Leon; Carlos,9998,0,9999,1
1715622858856,AIP 197,004,658530,Heyman; Gail D.,9998,0,9999,1
1715622858856,AIP 197,005,658631,Neal; Sonya E,9998,0,9999,1
1715622858856,AIP 197,006,658671,Du; Songzi,9998,0,9999,1
1715622859881,ANAR 135S,A00,494369,Braswell; Geoffrey E.,0,0,0,0
1715622860905,BENG 196,001,628496,Engler; Adam J.,9998,0,9999,1
1715622860905,BENG 196,002,660916,Watson; John Thomas,9999,0,9999,0
1715622861929,BISP 197,001,650773,Wilhelm; James E.,9994,0,9999,5
1715622861929,BISP 197,002,658904,Coleman; Aaron B.,9998,0,9999,1
1715622862954,CAT 124RS,A01,519847,Geibel; William,0,0,20,20
1715622863984,CAT 125RS,A01,515971,Geibel; William,0,0,20,20
1715622865013,CLRE 250,A00,511389,Morris; Sheldon,9992,0,9999,7
1715622866044,CLRE 251,A00,507176,Mehta; Ravindra L.,9992,0,9999,7
1715622866044,CLRE 251,B00,511410,Mehta; Ravindra L.,9998,0,9999,1
1715622867072,CLRE 252,A00,507189,Cuomo; Raphael Eduardo,9994,0,9999,5
1715622868100,CLRE 253,A00,507199,Vaida; Florin,9994,0,9999,5
1715622868100,CLRE 253,B00,507202,Vaida; Florin,9999,0,9999,0
1715622869126,CLRE 259,A00,507211,Patel; Hemal,9996,0,9999,3
1715622870155,CLRE 260,A00,507221,Cuomo; Raphael Eduardo,9999,0,9999,0
1715622871178,CLRE 297,001,507242,Cuomo; Raphael Eduardo,9999,0,9999,0
1715622872205,COGS 197,001,638244,Voytek; Bradley Thomas,9997,0,9999,2
1715622873231,CSE 191,A00,516875,Minnes Kemp; Mor Mia,9991,0,9999,8
1715622874256,CSE 197,001,637388,Minnes Kemp; Mor Mia,9992,0,9999,7
1715622875289,CSS 201S,A01,494383,Mignozzetti; Umberto,35,0,35,0
1715622876316,CSS 202S,A01,494387,Mignozzetti; Umberto,35,0,35,0
1715622877344,DSC 197,001,628532,Eldridge; Justin Matthew,9995,0,9999,4
1715622878371,EAP 100,A00,516065,Staff,9799,0,9999,200
1715622879399,ECE 45,A01,507414,Staff,31,0,60,29
1715622881452,ECE 111,A01,507420,Staff,11,0,50,39
1715622882478,ECE 197,001,548057,Sievenpiper; Daniel F.,9991,0,9999,8
1715622883503,EDS 115,A00,507243,Choi; Bailey Miyeon,7,0,28,21
1715622884533,EDS 117,A01,494379,Staff,0,6,34,34
1715622885559,EDS 125,A00,507246,Hopkins; Megan Beth,8,0,30,22
1715622886585,EDS 128A,A01,507264,Fargason; Sharon Gayle,6,0,26,20
1715622887614,EDS 128B,A01,507293,Pappas; Elizabeth,10,0,30,20
1715622888643,EDS 139,A00,507294,Fargason; Sharon Gayle,10,0,30,20
1715622888643,EDS 139,B00,507313,Pappas; Elizabeth,11,0,30,19
1715622889669,EDS 201,A00,507315,Staff,10,0,30,20
1715622890695,EDS 203,A01,507317,Halter; Christopher P.,10,0,30,20
1715622891726,EDS 204R,A01,507319,Halter; Christopher P.,0,3,30,30
1715622891726,EDS 204R,B01,507331,Heinzman; Erica M.,14,0,30,16
1715622892750,EDS 206R,A00,507332,Staff,0,4,30,30
1715622892750,EDS 206R,B00,507343,Staff,15,0,30,15
1715622893780,EDS 250,A00,507344,Hemans; Patricia Ann Benitez,20,0,40,20
1715622894807,EDS 281,A00,507345,Daly; Alan J.,18,0,18,0
1715622895833,EDS 284,A00,507350,Daly; Alan J.,16,0,16,0
1715622896862,EDS 286,A00,507359,Fine; Sarah,18,0,18,0
1715622897886,EDS 289C,A01,507361,Daly; Alan J.,18,0,18,0
1715622898912,EDS 290,A00,507366,Hofstetter; Carolyn,15,0,15,0
1715622899939,LIGM 5A,A00,507421,Fischer-Grunski; Eva K,17,0,20,3
1715622900965,LIGM 5B,A00,507423,Fischer-Grunski; Eva K,19,0,20,1
1715622901996,LIGM 5C,A00,507425,Fischer-Grunski; Eva K,19,0,20,1
1715622903022,LIIT 5AS,A00,507427,Carnelos; Chiara,20,0,20,0
1715622904047,LIIT 5BS,A00,507430,Carnelos; Chiara,20,0,20,0
1715622905077,LIIT 5CS,A00,507432,Carnelos; Chiara,20,0,20,0
1715622906106,LISP 5A,A00,507541,Munoz Sanchez; Alicia,11,0,20,9
1715622907137,LISP 5B,A00,507671,Munoz Sanchez; Alicia,9,0,20,11
1715622908164,LISP 5C,A00,507696,Munoz Sanchez; Alicia,9,0,20,11
1715622909191,MAE 197,001,528363,Boechler; Nicholas Sebastia,9998,0,9999,1
1715622910225,MATH 197,001,523477,Kedlaya; Kiran S.,9994,0,9999,5
1715622910225,MATH 197,002,563811,Zhang; Danna,9994,0,9999,5
1715622910225,MATH 197,003,628552,Dumitriu; Ioana,9998,0,9999,1
1715622910225,MATH 197,004,660885,Floyd; Eric,9998,0,9999,1
1715622911250,MCWP 40R,A00,518780,Staff,2,0,20,18
1715622911250,MCWP 40R,B00,518781,Staff,11,0,20,9
1715622911250,MCWP 40R,C00,518783,Staff,5,0,20,15
1715622912276,MCWP 50R,A00,518791,Staff,0,1,20,20
1715622912276,MCWP 50R,B00,518792,Staff,0,2,20,20
1715622912276,MCWP 50R,C00,518793,Staff,0,4,20,20
1715622912276,MCWP 50R,D00,518794,Staff,0,1,20,20
1715622912276,MCWP 50R,E00,518795,Staff,0,2,20,20
1715622912276,MCWP 50R,F00,518796,Staff,0,1,20,20
1715622912276,MCWP 50R,G00,518797,Staff,0,1,20,20
1715622913303,MMW 12R,A01,514034,Herbst; Matthew,0,2,16,16
1715622913303,MMW 12R,A02,514035,Herbst; Matthew,0,0,16,16
1715622914332,MMW 13R,A01,514037,Staff,0,5,16,16
1715622914332,MMW 13R,A02,514039,Staff,0,5,16,16
1715622914332,MMW 13R,A03,628519,Staff,0,4,16,16
1715622916385,SIO 295LS,A00,523233,Staff,10,0,30,20
1715622917413,SIO 295S,A00,523232,Staff,10,0,30,20
1715622918442,SIOC 290S,A01,637330,Merrifield; Mark A,23,0,30,7
1715622919468,SIOC 291S,A01,637333,Gabriel; Corey John,23,0,30,7
1715622920494,SOCI 117,A01,494376,Staff,0,5,5,5
1715622921521,WES 237B,A00,494380,Staff,10,0,20,10
1715622923599,AESE 279B,A00,494370,Wade; Jon P,0,0,33,33
1715622924625,AIP 97,001,660915,Van Den Einde; Yael Dahlia,9998,0,9999,1
1715622925650,AIP 197,001,627712,Vespa; Emanuel Ignacio,9995,0,9999,4
1715622925650,AIP 197,002,650778,Amir; On,9998,0,9999,1
1715622925650,AIP 197,003,650933,Avenancio-Leon; Carlos,9998,0,9999,1
1715622925650,AIP 197,004,658530,Heyman; Gail D.,9998,0,9999,1
1715622925650,AIP 197,005,658631,Neal; Sonya E,9998,0,9999,1
1715622925650,AIP 197,006,658671,Du; Songzi,9998,0,9999,1
1715622926675,ANAR 135S,A00,494369,Braswell; Geoffrey E.,0,0,0,0
1715622927698,BENG 196,001,628496,Engler; Adam J.,9998,0,9999,1
1715622927698,BENG 196,002,660916,Watson; John Thomas,9999,0,9999,0
1715622928725,BISP 197,001,650773,Wilhelm; James E.,9994,0,9999,5
1715622928725,BISP 197,002,658904,Coleman; Aaron B.,9998,0,9999,1
1715622929750,CAT 124RS,A01,519847,Geibel; William,0,0,20,20
1715622930774,CAT 125RS,A01,515971,Geibel; William,0,0,20,20
1715622931801,CLRE 250,A00,511389,Morris; Sheldon,9992,0,9999,7
1715622932826,CLRE 251,A00,507176,Mehta; Ravindra L.,9992,0,9999,7
1715622932826,CLRE 251,B00,511410,Mehta; Ravindra L.,9998,0,9999,1
1715622933882,CLRE 252,A00,507189,Cuomo; Raphael Eduardo,9994,0,9999,5
1715622934910,CLRE 253,A00,507199,Vaida; Florin,9994,0,9999,5
1715622934910,CLRE 253,B00,507202,Vaida; Florin,9999,0,9999,0
1715622935934,CLRE 259,A00,507211,Patel; Hemal,9996,0,9999,3
1715622936962,CLRE 260,A00,507221,Cuomo; Raphael Eduardo,9999,0,9999,0
1715622937989,CLRE 297,001,507242,Cuomo; Raphael Eduardo,9999,0,9999,0
1715622939017,COGS 197,001,638244,Voytek; Bradley Thomas,9997,0,9999,2
1715622940041,CSE 191,A00,516875,Minnes Kemp; Mor Mia,9991,0,9999,8
1715622941069,CSE 197,001,637388,Minnes Kemp; Mor Mia,9992,0,9999,7
1715622942098,CSS 201S,A01,494383,Mignozzetti; Umberto,35,0,35,0
1715622943124,CSS 202S,A01,494387,Mignozzetti; Umberto,35,0,35,0
1715622944149,DSC 197,001,628532,Eldridge; Justin Matthew,9995,0,9999,4
1715622945176,EAP 100,A00,516065,Staff,9799,0,9999,200
1715622946203,ECE 45,A01,507414,Staff,31,0,60,29
1715622948253,ECE 111,A01,507420,Staff,11,0,50,39
1715622949279,ECE 197,001,548057,Sievenpiper; Daniel F.,9991,0,9999,8
1715622950306,EDS 115,A00,507243,Choi; Bailey Miyeon,7,0,28,21
1715622951334,EDS 117,A01,494379,Staff,0,6,34,34
1715622952358,EDS 125,A00,507246,Hopkins; Megan Beth,8,0,30,22
1715622953382,EDS 128A,A01,507264,Fargason; Sharon Gayle,6,0,26,20
1715622954408,EDS 128B,A01,507293,Pappas; Elizabeth,10,0,30,20
1715622955435,EDS 139,A00,507294,Fargason; Sharon Gayle,10,0,30,20
1715622955435,EDS 139,B00,507313,Pappas; Elizabeth,11,0,30,19
1715622956461,EDS 201,A00,507315,Staff,10,0,30,20
1715622957490,EDS 203,A01,507317,Halter; Christopher P.,10,0,30,20
1715622958516,EDS 204R,A01,507319,Halter; Christopher P.,0,3,30,30
1715622958516,EDS 204R,B01,507331,Heinzman; Erica M.,14,0,30,16
1715622959540,EDS 206R,A00,507332,Staff,0,4,30,30
1715622959540,EDS 206R,B00,507343,Staff,15,0,30,15
1715622960564,EDS 250,A00,507344,Hemans; Patricia Ann Benitez,20,0,40,20
1715622961589,EDS 281,A00,507345,Daly; Alan J.,18,0,18,0
1715622962615,EDS 284,A00,507350,Daly; Alan J.,16,0,16,0
1715622963641,EDS 286,A00,507359,Fine; Sarah,18,0,18,0
1715622964666,EDS 289C,A01,507361,Daly; Alan J.,18,0,18,0
1715622965693,EDS 290,A00,507366,Hofstetter; Carolyn,15,0,15,0
1715622966721,LIGM 5A,A00,507421,Fischer-Grunski; Eva K,17,0,20,3
1715622967745,LIGM 5B,A00,507423,Fischer-Grunski; Eva K,19,0,20,1
1715622968771,LIGM 5C,A00,507425,Fischer-Grunski; Eva K,19,0,20,1
1715622969801,LIIT 5AS,A00,507427,Carnelos; Chiara,20,0,20,0
1715622970827,LIIT 5BS,A00,507430,Carnelos; Chiara,20,0,20,0
1715622971855,LIIT 5CS,A00,507432,Carnelos; Chiara,20,0,20,0
1715622972881,LISP 5A,A00,507541,Munoz Sanchez; Alicia,11,0,20,9
1715622973905,LISP 5B,A00,507671,Munoz Sanchez; Alicia,9,0,20,11
1715622974931,LISP 5C,A00,507696,Munoz Sanchez; Alicia,9,0,20,11
1715622975956,MAE 197,001,528363,Boechler; Nicholas Sebastia,9998,0,9999,1
1715622976983,MATH 197,001,523477,Kedlaya; Kiran S.,9994,0,9999,5
1715622976983,MATH 197,002,563811,Zhang; Danna,9994,0,9999,5
1715622976983,MATH 197,003,628552,Dumitriu; Ioana,9998,0,9999,1
1715622976983,MATH 197,004,660885,Floyd; Eric,9998,0,9999,1
1715622978010,MCWP 40R,A00,518780,Staff,2,0,20,18
1715622978010,MCWP 40R,B00,518781,Staff,11,0,20,9
1715622978010,MCWP 40R,C00,518783,Staff,5,0,20,15
1715622979036,MCWP 50R,A00,518791,Staff,0,1,20,20
1715622979036,MCWP 50R,B00,518792,Staff,0,2,20,20
1715622979036,MCWP 50R,C00,518793,Staff,0,4,20,20
1715622979036,MCWP 50R,D00,518794,Staff,0,1,20,20
1715622979036,MCWP 50R,E00,518795,Staff,0,2,20,20
1715622979036,MCWP 50R,F00,518796,Staff,0,1,20,20
1715622979036,MCWP 50R,G00,518797,Staff,0,1,20,20
1715622980062,MMW 12R,A01,514034,Herbst; Matthew,0,2,16,16
1715622980062,MMW 12R,A02,514035,Herbst; Matthew,0,0,16,16
1715622981087,MMW 13R,A01,514037,Staff,0,5,16,16
1715622981087,MMW 13R,A02,514039,Staff,0,5,16,16
1715622981087,MMW 13R,A03,628519,Staff,0,4,16,16
1715622983139,SIO 295LS,A00,523233,Staff,10,0,30,20
1715622984167,SIO 295S,A00,523232,Staff,10,0,30,20
1715622985193,SIOC 290S,A01,637330,Merrifield; Mark A,23,0,30,7
1715622986221,SIOC 291S,A01,637333,Gabriel; Corey John,23,0,30,7
1715622987248,SOCI 117,A01,494376,Staff,0,5,5,5
1715622988275,WES 237B,A00,494380,Staff,10,0,20,10
1715622990338,AESE 279B,A00,494370,Wade; Jon P,0,0,33,33
1715622991363,AIP 97,001,660915,Van Den Einde; Yael Dahlia,9998,0,9999,1
1715622992394,AIP 197,001,627712,Vespa; Emanuel Ignacio,9995,0,9999,4
1715622992394,AIP 197,002,650778,Amir; On,9998,0,9999,1
1715622992394,AIP 197,003,650933,Avenancio-Leon; Carlos,9998,0,9999,1
1715622992394,AIP 197,004,658530,Heyman; Gail D.,9998,0,9999,1
1715622992394,AIP 197,005,658631,Neal; Sonya E,9998,0,9999,1
1715622992394,AIP 197,006,658671,Du; Songzi,9998,0,9999,1
1715622993418,ANAR 135S,A00,494369,Braswell; Geoffrey E.,0,0,0,0
1715622994448,BENG 196,001,628496,Engler; Adam J.,9998,0,9999,1
1715622994448,BENG 196,002,660916,Watson; John Thomas,9999,0,9999,0
1715622995473,BISP 197,001,650773,Wilhelm; James E.,9994,0,9999,5
1715622995473,BISP 197,002,658904,Coleman; Aaron B.,9998,0,9999,1
1715622996502,CAT 124RS,A01,519847,Geibel; William,0,0,20,20
1715622997529,CAT 125RS,A01,515971,Geibel; William,0,0,20,20
1715622998558,CLRE 250,A00,511389,Morris; Sheldon,9992,0,9999,7
1715622999590,CLRE 251,A00,507176,Mehta; Ravindra L.,9992,0,9999,7
1715622999590,CLRE 251,B00,511410,Mehta; Ravindra L.,9998,0,9999,1
1715623000615,CLRE 252,A00,507189,Cuomo; Raphael Eduardo,9994,0,9999,5
1715623001643,CLRE 253,A00,507199,Vaida; Florin,9994,0,9999,5
1715623001643,CLRE 253,B00,507202,Vaida; Florin,9999,0,9999,0
1715623002671,CLRE 259,A00,507211,Patel; Hemal,9996,0,9999,3
1715623003698,CLRE 260,A00,507221,Cuomo; Raphael Eduardo,9999,0,9999,0
1715623004727,CLRE 297,001,507242,Cuomo; Raphael Eduardo,9999,0,9999,0
1715623005756,COGS 197,001,638244,Voytek; Bradley Thomas,9997,0,9999,2
1715623006785,CSE 191,A00,516875,Minnes Kemp; Mor Mia,9991,0,9999,8
1715623007811,CSE 197,001,637388,Minnes Kemp; Mor Mia,9992,0,9999,7
1715623008841,CSS 201S,A01,494383,Mignozzetti; Umberto,35,0,35,0
1715623009866,CSS 202S,A01,494387,Mignozzetti; Umberto,35,0,35,0
1715623010893,DSC 197,001,628532,Eldridge; Justin Matthew,9995,0,9999,4
1715623011920,EAP 100,A00,516065,Staff,9799,0,9999,200
1715623012945,ECE 45,A01,507414,Staff,31,0,60,29
1715623014997,ECE 111,A01,507420,Staff,11,0,50,39
1715623016023,ECE 197,001,548057,Sievenpiper; Daniel F.,9991,0,9999,8
1715623017049,EDS 115,A00,507243,Choi; Bailey Miyeon,7,0,28,21
1715623018074,EDS 117,A01,494379,Staff,0,6,34,34
1715623019100,EDS 125,A00,507246,Hopkins; Megan Beth,8,0,30,22
1715623020126,EDS 128A,A01,507264,Fargason; Sharon Gayle,6,0,26,20
1715623021155,EDS 128B,A01,507293,Pappas; Elizabeth,10,0,30,20
1715623022179,EDS 139,A00,507294,Fargason; Sharon Gayle,10,0,30,20
1715623022179,EDS 139,B00,507313,Pappas; Elizabeth,11,0,30,19
1715623023206,EDS 201,A00,507315,Staff,10,0,30,20
1715623024235,EDS 203,A01,507317,Halter; Christopher P.,10,0,30,20
1715623025259,EDS 204R,A01,507319,Halter; Christopher P.,0,3,30,30
1715623025259,EDS 204R,B01,507331,Heinzman; Erica M.,14,0,30,16
1715623026285,EDS 206R,A00,507332,Staff,0,4,30,30
1715623026285,EDS 206R,B00,507343,Staff,15,0,30,15
1715623027309,EDS 250,A00,507344,Hemans; Patricia Ann Benitez,20,0,40,20
1715623028335,EDS 281,A00,507345,Daly; Alan J.,18,0,18,0
1715623029365,EDS 284,A00,507350,Daly; Alan J.,16,0,16,0
1715623030391,EDS 286,A00,507359,Fine; Sarah,18,0,18,0
1715623031415,EDS 289C,A01,507361,Daly; Alan J.,18,0,18,0
1715623032462,EDS 290,A00,507366,Hofstetter; Carolyn,15,0,15,0
1715623033488,LIGM 5A,A00,507421,Fischer-Grunski; Eva K,17,0,20,3
1715623034513,LIGM 5B,A00,507423,Fischer-Grunski; Eva K,19,0,20,1
1715623035540,LIGM 5C,A00,507425,Fischer-Grunski; Eva K,19,0,20,1
1715623036568,LIIT 5AS,A00,507427,Carnelos; Chiara,20,0,20,0
1715623037592,LIIT 5BS,A00,507430,Carnelos; Chiara,20,0,20,0
1715623038619,LIIT 5CS,A00,507432,Carnelos; Chiara,20,0,20,0
1715623039648,LISP 5A,A00,507541,Munoz Sanchez; Alicia,11,0,20,9
1715623040674,LISP 5B,A00,507671,Munoz Sanchez; Alicia,9,0,20,11
1715623041703,LISP 5C,A00,507696,Munoz Sanchez; Alicia,9,0,20,11
1715623042729,MAE 197,001,528363,Boechler; Nicholas Sebastia,9998,0,9999,1
1715623043757,MATH 197,001,523477,Kedlaya; Kiran S.,9994,0,9999,5
1715623043757,MATH 197,002,563811,Zhang; Danna,9994,0,9999,5
1715623043757,MATH 197,003,628552,Dumitriu; Ioana,9998,0,9999,1
1715623043757,MATH 197,004,660885,Floyd; Eric,9998,0,9999,1
1715623044784,MCWP 40R,A00,518780,Staff,2,0,20,18
1715623044784,MCWP 40R,B00,518781,Staff,11,0,20,9
1715623044784,MCWP 40R,C00,518783,Staff,5,0,20,15
1715623045809,MCWP 50R,A00,518791,Staff,0,1,20,20
1715623045809,MCWP 50R,B00,518792,Staff,0,2,20,20
1715623045809,MCWP 50R,C00,518793,Staff,0,4,20,20
1715623045809,MCWP 50R,D00,518794,Staff,0,1,20,20
1715623045809,MCWP 50R,E00,518795,Staff,0,2,20,20
1715623045809,MCWP 50R,F00,518796,Staff,0,1,20,20
1715623045809,MCWP 50R,G00,518797,Staff,0,1,20,20
1715623046835,MMW 12R,A01,514034,Herbst; Matthew,0,2,16,16
1715623046835,MMW 12R,A02,514035,Herbst; Matthew,0,0,16,16
1715623047861,MMW 13R,A01,514037,Staff,0,5,16,16
1715623047861,MMW 13R,A02,514039,Staff,0,5,16,16
1715623047861,MMW 13R,A03,628519,Staff,0,4,16,16
1715623049917,SIO 295LS,A00,523233,Staff,10,0,30,20
1715623050943,SIO 295S,A00,523232,Staff,10,0,30,20
1715623051969,SIOC 290S,A01,637330,Merrifield; Mark A,23,0,30,7
1715623053000,SIOC 291S,A01,637333,Gabriel; Corey John,23,0,30,7
1715623054028,SOCI 117,A01,494376,Staff,0,5,5,5
1715623055054,WES 237B,A00,494380,Staff,10,0,20,10
1715623057114,AESE 279B,A00,494370,Wade; Jon P,0,0,33,33
1715623058141,AIP 97,001,660915,Van Den Einde; Yael Dahlia,9998,0,9999,1
1715623059181,AIP 197,001,627712,Vespa; Emanuel Ignacio,9995,0,9999,4
1715623059181,AIP 197,002,650778,Amir; On,9998,0,9999,1
1715623059181,AIP 197,003,650933,Avenancio-Leon; Carlos,9998,0,9999,1
1715623059181,AIP 197,004,658530,Heyman; Gail D.,9998,0,9999,1
1715623059181,AIP 197,005,658631,Neal; Sonya E,9998,0,9999,1
1715623059181,AIP 197,006,658671,Du; Songzi,9998,0,9999,1
1715623060207,ANAR 135S,A00,494369,Braswell; Geoffrey E.,0,0,0,0
1715623061233,BENG 196,001,628496,Engler; Adam J.,9998,0,9999,1
1715623061233,BENG 196,002,660916,Watson; John Thomas,9999,0,9999,0
1715623062265,BISP 197,001,650773,Wilhelm; James E.,9994,0,9999,5
1715623062265,BISP 197,002,658904,Coleman; Aaron B.,9998,0,9999,1
1715623063291,CAT 124RS,A01,519847,Geibel; William,0,0,20,20
1715623064316,CAT 125RS,A01,515971,Geibel; William,0,0,20,20
1715623065341,CLRE 250,A00,511389,Morris; Sheldon,9992,0,9999,7
1715623066367,CLRE 251,A00,507176,Mehta; Ravindra L.,9992,0,9999,7
1715623066367,CLRE 251,B00,511410,Mehta; Ravindra L.,9998,0,9999,1
1715623067397,CLRE 252,A00,507189,Cuomo; Raphael Eduardo,9994,0,9999,5
1715623068424,CLRE 253,A00,507199,Vaida; Florin,9994,0,9999,5
1715623068424,CLRE 253,B00,507202,Vaida; Florin,9999,0,9999,0
1715623069451,CLRE 259,A00,507211,Patel; Hemal,9996,0,9999,3
1715623070478,CLRE 260,A00,507221,Cuomo; Raphael Eduardo,9999,0,9999,0
1715623071509,CLRE 297,001,507242,Cuomo; Raphael Eduardo,9999,0,9999,0
1715623072542,COGS 197,001,638244,Voytek; Bradley Thomas,9997,0,9999,2
1715623073569,CSE 191,A00,516875,Minnes Kemp; Mor Mia,9991,0,9999,8
1715623074599,CSE 197,001,637388,Minnes Kemp; Mor Mia,9992,0,9999,7
1715623075633,CSS 201S,A01,494383,Mignozzetti; Umberto,35,0,35,0
1715623076661,CSS 202S,A01,494387,Mignozzetti; Umberto,35,0,35,0
1715623077689,DSC 197,001,628532,Eldridge; Justin Matthew,9995,0,9999,4
1715623078713,EAP 100,A00,516065,Staff,9799,0,9999,200
1715623079741,ECE 45,A01,507414,Staff,31,0,60,29
1715623081796,ECE 111,A01,507420,Staff,11,0,50,39
1715623082821,ECE 197,001,548057,Sievenpiper; Daniel F.,9991,0,9999,8
1715623083847,EDS 115,A00,507243,Choi; Bailey Miyeon,7,0,28,21
1715623084874,EDS 117,A01,494379,Staff,0,6,34,34
1715623085901,EDS 125,A00,507246,Hopkins; Megan Beth,8,0,30,22
1715623086927,EDS 128A,A01,507264,Fargason; Sharon Gayle,6,0,26,20
1715623087959,EDS 128B,A01,507293,Pappas; Elizabeth,10,0,30,20
1715623088986,EDS 139,A00,507294,Fargason; Sharon Gayle,10,0,30,20
1715623088986,EDS 139,B00,507313,Pappas; Elizabeth,11,0,30,19
1715623090013,EDS 201,A00,507315,Staff,10,0,30,20
1715623091043,EDS 203,A01,507317,Halter; Christopher P.,10,0,30,20
1715623092070,EDS 204R,A01,507319,Halter; Christopher P.,0,3,30,30
1715623092070,EDS 204R,B01,507331,Heinzman; Erica M.,14,0,30,16
1715623093096,EDS 206R,A00,507332,Staff,0,4,30,30
1715623093096,EDS 206R,B00,507343,Staff,15,0,30,15
1715623094123,EDS 250,A00,507344,Hemans; Patricia Ann Benitez,20,0,40,20
1715623095147,EDS 281,A00,507345,Daly; Alan J.,18,0,18,0
1715623096175,EDS 284,A00,507350,Daly; Alan J.,16,0,16,0
1715623097200,EDS 286,A00,507359,Fine; Sarah,18,0,18,0
1715623098229,EDS 289C,A01,507361,Daly; Alan J.,18,0,18,0
1715623099255,EDS 290,A00,507366,Hofstetter; Carolyn,15,0,15,0
1715623100280,LIGM 5A,A00,507421,Fischer-Grunski; Eva K,17,0,20,3
1715623101310,LIGM 5B,A00,507423,Fischer-Grunski; Eva K,19,0,20,1
1715623102339,LIGM 5C,A00,507425,Fischer-Grunski; Eva K,19,0,20,1
1715623103369,LIIT 5AS,A00,507427,Carnelos; Chiara,20,0,20,0
1715623104394,LIIT 5BS,A00,507430,Carnelos; Chiara,20,0,20,0
1715623105425,LIIT 5CS,A00,507432,Carnelos; Chiara,20,0,20,0
1715623106451,LISP 5A,A00,507541,Munoz Sanchez; Alicia,11,0,20,9
1715623107478,LISP 5B,A00,507671,Munoz Sanchez; Alicia,9,0,20,11
1715623108504,LISP 5C,A00,507696,Munoz Sanchez; Alicia,9,0,20,11
1715623109530,MAE 197,001,528363,Boechler; Nicholas Sebastia,9998,0,9999,1
1715623110559,MATH 197,001,523477,Kedlaya; Kiran S.,9994,0,9999,5
1715623110559,MATH 197,002,563811,Zhang; Danna,9994,0,9999,5
1715623110559,MATH 197,003,628552,Dumitriu; Ioana,9998,0,9999,1
1715623110559,MATH 197,004,660885,Floyd; Eric,9998,0,9999,1
1715623111586,MCWP 40R,A00,518780,Staff,2,0,20,18
1715623111586,MCWP 40R,B00,518781,Staff,11,0,20,9
1715623111586,MCWP 40R,C00,518783,Staff,5,0,20,15
1715623112612,MCWP 50R,A00,518791,Staff,0,1,20,20
1715623112612,MCWP 50R,B00,518792,Staff,0,2,20,20
1715623112612,MCWP 50R,C00,518793,Staff,0,4,20,20
1715623112612,MCWP 50R,D00,518794,Staff,0,1,20,20
1715623112612,MCWP 50R,E00,518795,Staff,0,2,20,20
1715623112612,MCWP 50R,F00,518796,Staff,0,1,20,20
1715623112612,MCWP 50R,G00,518797,Staff,0,1,20,20
1715623113638,MMW 12R,A01,514034,Herbst; Matthew,0,2,16,16
1715623113638,MMW 12R,A02,514035,Herbst; Matthew,0,0,16,16
1715623114664,MMW 13R,A01,514037,Staff,0,5,16,16
1715623114664,MMW 13R,A02,514039,Staff,0,5,16,16
1715623114664,MMW 13R,A03,628519,Staff,0,4,16,16
1715623116716,SIO 295LS,A00,523233,Staff,10,0,30,20
1715623117741,SIO 295S,A00,523232,Staff,10,0,30,20
1715623118767,SIOC 290S,A01,637330,Merrifield; Mark A,23,0,30,7
1715623119792,SIOC 291S,A01,637333,Gabriel; Corey John,23,0,30,7
1715623120818,SOCI 117,A01,494376,Staff,0,5,5,5
1715623121844,WES 237B,A00,494380,Staff,10,0,20,10
1715623123917,AESE 279B,A00,494370,Wade; Jon P,0,0,33,33
1715623124946,AIP 97,001,660915,Van Den Einde; Yael Dahlia,9998,0,9999,1
1715623125975,AIP 197,001,627712,Vespa; Emanuel Ignacio,9995,0,9999,4
1715623125975,AIP 197,002,650778,Amir; On,9998,0,9999,1
1715623125975,AIP 197,003,650933,Avenancio-Leon; Carlos,9998,0,9999,1
1715623125975,AIP 197,004,658530,Heyman; Gail D.,9998,0,9999,1
1715623125975,AIP 197,005,658631,Neal; Sonya E,9998,0,9999,1
1715623125975,AIP 197,006,658671,Du; Songzi,9998,0,9999,1
1715623127001,ANAR 135S,A00,494369,Braswell; Geoffrey E.,0,0,0,0
1715623128027,BENG 196,001,628496,Engler; Adam J.,9998,0,9999,1
1715623128027,BENG 196,002,660916,Watson; John Thomas,9999,0,9999,0
1715623129052,BISP 197,001,650773,Wilhelm; James E.,9994,0,9999,5
1715623129052,BISP 197,002,658904,Coleman; Aaron B.,9998,0,9999,1
1715623130078,CAT 124RS,A01,519847,Geibel; William,0,0,20,20
1715623131111,CAT 125RS,A01,515971,Geibel; William,0,0,20,20
1715623132136,CLRE 250,A00,511389,Morris; Sheldon,9992,0,9999,7
1715623133165,CLRE 251,A00,507176,Mehta; Ravindra L.,9992,0,9999,7
1715623133165,CLRE 251,B00,511410,Mehta; Ravindra L.,9998,0,9999,1
1715623134196,CLRE 252,A00,507189,Cuomo; Raphael Eduardo,9994,0,9999,5
1715623135228,CLRE 253,A00,507199,Vaida; Florin,9994,0,9999,5
1715623135228,CLRE 253,B00,507202,Vaida; Florin,9999,0,9999,0
1715623136253,CLRE 259,A00,507211,Patel; Hemal,9996,0,9999,3
1715623137279,CLRE 260,A00,507221,Cuomo; Raphael Eduardo,9999,0,9999,0
1715623138307,CLRE 297,001,507242,Cuomo; Raphael Eduardo,9999,0,9999,0
1715623139335,COGS 197,001,638244,Voytek; Bradley Thomas,9997,0,9999,2
1715623140361,CSE 191,A00,516875,Minnes Kemp; Mor Mia,9991,0,9999,8
1715623141388,CSE 197,001,637388,Minnes Kemp; Mor Mia,9992,0,9999,7
1715623142414,CSS 201S,A01,494383,Mignozzetti; Umberto,35,0,35,0
1715623143445,CSS 202S,A01,494387,Mignozzetti; Umberto,35,0,35,0
1715623144470,DSC 197,001,628532,Eldridge; Justin Matthew,9995,0,9999,4
1715623145500,EAP 100,A00,516065,Staff,9799,0,9999,200
1715623146528,ECE 45,A01,507414,Staff,31,0,60,29
1715623148582,ECE 111,A01,507420,Staff,11,0,50,39
1715623149610,ECE 197,001,548057,Sievenpiper; Daniel F.,9991,0,9999,8
1715623150634,EDS 115,A00,507243,Choi; Bailey Miyeon,7,0,28,21
1715623151662,EDS 117,A01,494379,Staff,0,6,34,34
1715623152689,EDS 125,A00,507246,Hopkins; Megan Beth,8,0,30,22
1715623153717,EDS 128A,A01,507264,Fargason; Sharon Gayle,6,0,26,20
1715623154740,EDS 128B,A01,507293,Pappas; Elizabeth,10,0,30,20
1715623155768,EDS 139,A00,507294,Fargason; Sharon Gayle,10,0,30,20
1715623155768,EDS 139,B00,507313,Pappas; Elizabeth,11,0,30,19
1715623156793,EDS 201,A00,507315,Staff,10,0,30,20
1715623157822,EDS 203,A01,507317,Halter; Christopher P.,10,0,30,20
1715623158851,EDS 204R,A01,507319,Halter; Christopher P.,0,3,30,30
1715623158851,EDS 204R,B01,507331,Heinzman; Erica M.,14,0,30,16
1715623159877,EDS 206R,A00,507332,Staff,0,4,30,30
1715623159877,EDS 206R,B00,507343,Staff,15,0,30,15
1715623160902,EDS 250,A00,507344,Hemans; Patricia Ann Benitez,20,0,40,20
1715623161928,EDS 281,A00,507345,Daly; Alan J.,18,0,18,0
1715623162957,EDS 284,A00,507350,Daly; Alan J.,16,0,16,0
1715623163983,EDS 286,A00,507359,Fine; Sarah,18,0,18,0
1715623165007,EDS 289C,A01,507361,Daly; Alan J.,18,0,18,0
1715623166032,EDS 290,A00,507366,Hofstetter; Carolyn,15,0,15,0
1715623167059,LIGM 5A,A00,507421,Fischer-Grunski; Eva K,17,0,20,3
1715623168087,LIGM 5B,A00,507423,Fischer-Grunski; Eva K,19,0,20,1
1715623169122,LIGM 5C,A00,507425,Fischer-Grunski; Eva K,19,0,20,1
1715623170153,LIIT 5AS,A00,507427,Carnelos; Chiara,20,0,20,0
1715623171182,LIIT 5BS,A00,507430,Carnelos; Chiara,20,0,20,0
1715623172207,LIIT 5CS,A00,507432,Carnelos; Chiara,20,0,20,0
1715623173238,LISP 5A,A00,507541,Munoz Sanchez; Alicia,11,0,20,9
1715623174264,LISP 5B,A00,507671,Munoz Sanchez; Alicia,9,0,20,11
1715623175289,LISP 5C,A00,507696,Munoz Sanchez; Alicia,9,0,20,11
1715623176316,MAE 197,001,528363,Boechler; Nicholas Sebastia,9998,0,9999,1
1715623177344,MATH 197,001,523477,Kedlaya; Kiran S.,9994,0,9999,5
1715623177344,MATH 197,002,563811,Zhang; Danna,9994,0,9999,5
1715623177344,MATH 197,003,628552,Dumitriu; Ioana,9998,0,9999,1
1715623177344,MATH 197,004,660885,Floyd; Eric,9998,0,9999,1
1715623178371,MCWP 40R,A00,518780,Staff,2,0,20,18
1715623178371,MCWP 40R,B00,518781,Staff,11,0,20,9
1715623178371,MCWP 40R,C00,518783,Staff,5,0,20,15
1715623179397,MCWP 50R,A00,518791,Staff,0,1,20,20
1715623179397,MCWP 50R,B00,518792,Staff,0,2,20,20
1715623179397,MCWP 50R,C00,518793,Staff,0,4,20,20
1715623179397,MCWP 50R,D00,518794,Staff,0,1,20,20
1715623179397,MCWP 50R,E00,518795,Staff,0,2,20,20
1715623179397,MCWP 50R,F00,518796,Staff,0,1,20,20
1715623179397,MCWP 50R,G00,518797,Staff,0,1,20,20
1715623180423,MMW 12R,A01,514034,Herbst; Matthew,0,2,16,16
1715623180423,MMW 12R,A02,514035,Herbst; Matthew,0,0,16,16
1715623181449,MMW 13R,A01,514037,Staff,0,5,16,16
1715623181449,MMW 13R,A02,514039,Staff,0,5,16,16
1715623181449,MMW 13R,A03,628519,Staff,0,4,16,16
1715623183501,SIO 295LS,A00,523233,Staff,10,0,30,20
1715623184530,SIO 295S,A00,523232,Staff,10,0,30,20
1715623185564,SIOC 290S,A01,637330,Merrifield; Mark A,23,0,30,7
1715623186592,SIOC 291S,A01,637333,Gabriel; Corey John,23,0,30,7
1715623187622,SOCI 117,A01,494376,Staff,0,5,5,5
1715623188645,WES 237B,A00,494380,Staff,10,0,20,10
1715623190726,AESE 279B,A00,494370,Wade; Jon P,0,0,33,33
1715623191750,AIP 97,001,660915,Van Den Einde; Yael Dahlia,9998,0,9999,1
1715623192776,AIP 197,001,627712,Vespa; Emanuel Ignacio,9995,0,9999,4
1715623192776,AIP 197,002,650778,Amir; On,9998,0,9999,1
1715623192776,AIP 197,003,650933,Avenancio-Leon; Carlos,9998,0,9999,1
1715623192776,AIP 197,004,658530,Heyman; Gail D.,9998,0,9999,1
1715623192776,AIP 197,005,658631,Neal; Sonya E,9998,0,9999,1
1715623192776,AIP 197,006,658671,Du; Songzi,9998,0,9999,1
1715623193807,ANAR 135S,A00,494369,Braswell; Geoffrey E.,0,0,0,0
1715623194845,BENG 196,001,628496,Engler; Adam J.,9998,0,9999,1
1715623194845,BENG 196,002,660916,Watson; John Thomas,9999,0,9999,0
1715623195873,BISP 197,001,650773,Wilhelm; James E.,9994,0,9999,5
1715623195873,BISP 197,002,658904,Coleman; Aaron B.,9998,0,9999,1
1715623196901,CAT 124RS,A01,519847,Geibel; William,0,0,20,20
1715623197929,CAT 125RS,A01,515971,Geibel; William,0,0,20,20
1715623198957,CLRE 250,A00,511389,Morris; Sheldon,9992,0,9999,7
1715623199988,CLRE 251,A00,507176,Mehta; Ravindra L.,9992,0,9999,7
1715623199988,CLRE 251,B00,511410,Mehta; Ravindra L.,9998,0,9999,1
1715623201012,CLRE 252,A00,507189,Cuomo; Raphael Eduardo,9994,0,9999,5
1715623202044,CLRE 253,A00,507199,Vaida; Florin,9994,0,9999,5
1715623202044,CLRE 253,B00,507202,Vaida; Florin,9999,0,9999,0
1715623203071,CLRE 259,A00,507211,Patel; Hemal,9996,0,9999,3
1715623204098,CLRE 260,A00,507221,Cuomo; Raphael Eduardo,9999,0,9999,0
1715623205123,CLRE 297,001,507242,Cuomo; Raphael Eduardo,9999,0,9999,0
1715623206148,COGS 197,001,638244,Voytek; Bradley Thomas,9997,0,9999,2
1715623207174,CSE 191,A00,516875,Minnes Kemp; Mor Mia,9991,0,9999,8
1715623208203,CSE 197,001,637388,Minnes Kemp; Mor Mia,9992,0,9999,7
1715623209232,CSS 201S,A01,494383,Mignozzetti; Umberto,35,0,35,0
1715623210263,CSS 202S,A01,494387,Mignozzetti; Umberto,35,0,35,0
1715623211288,DSC 197,001,628532,Eldridge; Justin Matthew,9995,0,9999,4
1715623212317,EAP 100,A00,516065,Staff,9799,0,9999,200
1715623213346,ECE 45,A01,507414,Staff,31,0,60,29
1715623215453,ECE 111,A01,507420,Staff,11,0,50,39
1715623216485,ECE 197,001,548057,Sievenpiper; Daniel F.,9991,0,9999,8
1715623217513,EDS 115,A00,507243,Choi; Bailey Miyeon,7,0,28,21
1715623218539,EDS 117,A01,494379,Staff,0,6,34,34
1715623219566,EDS 125,A00,507246,Hopkins; Megan Beth,8,0,30,22
1715623220595,EDS 128A,A01,507264,Fargason; Sharon Gayle,6,0,26,20
1715623221623,EDS 128B,A01,507293,Pappas; Elizabeth,10,0,30,20
1715623222647,EDS 139,A00,507294,Fargason; Sharon Gayle,10,0,30,20
1715623222647,EDS 139,B00,507313,Pappas; Elizabeth,11,0,30,19
1715623223673,EDS 201,A00,507315,Staff,10,0,30,20
1715623224701,EDS 203,A01,507317,Halter; Christopher P.,10,0,30,20
1715623225727,EDS 204R,A01,507319,Halter; Christopher P.,0,3,30,30
1715623225727,EDS 204R,B01,507331,Heinzman; Erica M.,14,0,30,16
1715623226755,EDS 206R,A00,507332,Staff,0,4,30,30
1715623226755,EDS 206R,B00,507343,Staff,15,0,30,15
1715623227784,EDS 250,A00,507344,Hemans; Patricia Ann Benitez,20,0,40,20
1715623228809,EDS 281,A00,507345,Daly; Alan J.,18,0,18,0
1715623229835,EDS 284,A00,507350,Daly; Alan J.,16,0,16,0
1715623230862,EDS 286,A00,507359,Fine; Sarah,18,0,18,0
1715623231885,EDS 289C,A01,507361,Daly; Alan J.,18,0,18,0
1715623232909,EDS 290,A00,507366,Hofstetter; Carolyn,15,0,15,0
1715623233934,LIGM 5A,A00,507421,Fischer-Grunski; Eva K,17,0,20,3
1715623234963,LIGM 5B,A00,507423,Fischer-Grunski; Eva K,19,0,20,1
1715623235993,LIGM 5C,A00,507425,Fischer-Grunski; Eva K,19,0,20,1
1715623237018,LIIT 5AS,A00,507427,Carnelos; Chiara,20,0,20,0
1715623238043,LIIT 5BS,A00,507430,Carnelos; Chiara,20,0,20,0
1715623239070,LIIT 5CS,A00,507432,Carnelos; Chiara,20,0,20,0
1715623240098,LISP 5A,A00,507541,Munoz Sanchez; Alicia,11,0,20,9
1715623241180,LISP 5B,A00,507671,Munoz Sanchez; Alicia,9,0,20,11
1715623242206,LISP 5C,A00,507696,Munoz Sanchez; Alicia,9,0,20,11
1715623243237,MAE 197,001,528363,Boechler; Nicholas Sebastia,9998,0,9999,1
1715623244267,MATH 197,001,523477,Kedlaya; Kiran S.,9994,0,9999,5
1715623244267,MATH 197,002,563811,Zhang; Danna,9994,0,9999,5
1715623244267,MATH 197,003,628552,Dumitriu; Ioana,9998,0,9999,1
1715623244267,MATH 197,004,660885,Floyd; Eric,9998,0,9999,1
1715623245294,MCWP 40R,A00,518780,Staff,2,0,20,18
1715623245294,MCWP 40R,B00,518781,Staff,11,0,20,9
1715623245294,MCWP 40R,C00,518783,Staff,5,0,20,15
1715623246320,MCWP 50R,A00,518791,Staff,0,1,20,20
1715623246320,MCWP 50R,B00,518792,Staff,0,2,20,20
1715623246320,MCWP 50R,C00,518793,Staff,0,4,20,20
1715623246320,MCWP 50R,D00,518794,Staff,0,1,20,20
1715623246320,MCWP 50R,E00,518795,Staff,0,2,20,20
1715623246320,MCWP 50R,F00,518796,Staff,0,1,20,20
1715623246320,MCWP 50R,G00,518797,Staff,0,1,20,20
1715623247349,MMW 12R,A01,514034,Herbst; Matthew,0,2,16,16
1715623247349,MMW 12R,A02,514035,Herbst; Matthew,0,0,16,16
1715623248376,MMW 13R,A01,514037,Staff,0,5,16,16
1715623248376,MMW 13R,A02,514039,Staff,0,5,16,16
1715623248376,MMW 13R,A03,628519,Staff,0,4,16,16
1715623250432,SIO 295LS,A00,523233,Staff,10,0,30,20
1715623251457,SIO 295S,A00,523232,Staff,10,0,30,20
1715623252482,SIOC 290S,A01,637330,Merrifield; Mark A,23,0,30,7
1715623253511,SIOC 291S,A01,637333,Gabriel; Corey John,23,0,30,7
1715623254537,SOCI 117,A01,494376,Staff,0,5,5,5
1715623255561,WES 237B,A00,494380,Staff,10,0,20,10
1715623257634,AESE 279B,A00,494370,Wade; Jon P,0,0,33,33
1715623258657,AIP 97,001,660915,Van Den Einde; Yael Dahlia,9998,0,9999,1
1715623259684,AIP 197,001,627712,Vespa; Emanuel Ignacio,9995,0,9999,4
1715623259684,AIP 197,002,650778,Amir; On,9998,0,9999,1
1715623259684,AIP 197,003,650933,Avenancio-Leon; Carlos,9998,0,9999,1
1715623259684,AIP 197,004,658530,Heyman; Gail D.,9998,0,9999,1
1715623259684,AIP 197,005,658631,Neal; Sonya E,9998,0,9999,1
1715623259684,AIP 197,006,658671,Du; Songzi,9998,0,9999,1
1715623260713,ANAR 135S,A00,494369,Braswell; Geoffrey E.,0,0,0,0
1715623261738,BENG 196,001,628496,Engler; Adam J.,9998,0,9999,1
1715623261738,BENG 196,002,660916,Watson; John Thomas,9999,0,9999,0
1715623262767,BISP 197,001,650773,Wilhelm; James E.,9994,0,9999,5
1715623262767,BISP 197,002,658904,Coleman; Aaron B.,9998,0,9999,1
1715623263795,CAT 124RS,A01,519847,Geibel; William,0,0,20,20
1715623264823,CAT 125RS,A01,515971,Geibel; William,0,0,20,20
1715623265849,CLRE 250,A00,511389,Morris; Sheldon,9992,0,9999,7
1715623266880,CLRE 251,A00,507176,Mehta; Ravindra L.,9992,0,9999,7
1715623266880,CLRE 251,B00,511410,Mehta; Ravindra L.,9998,0,9999,1
1715623267908,CLRE 252,A00,507189,Cuomo; Raphael Eduardo,9994,0,9999,5
1715623268937,CLRE 253,A00,507199,Vaida; Florin,9994,0,9999,5
1715623268937,CLRE 253,B00,507202,Vaida; Florin,9999,0,9999,0
1715623269964,CLRE 259,A00,507211,Patel; Hemal,9996,0,9999,3
1715623270992,CLRE 260,A00,507221,Cuomo; Raphael Eduardo,9999,0,9999,0
1715623272019,CLRE 297,001,507242,Cuomo; Raphael Eduardo,9999,0,9999,0
1715623273043,COGS 197,001,638244,Voytek; Bradley Thomas,9997,0,9999,2
1715623274067,CSE 191,A00,516875,Minnes Kemp; Mor Mia,9991,0,9999,8
1715623275096,CSE 197,001,637388,Minnes Kemp; Mor Mia,9992,0,9999,7
1715623276122,CSS 201S,A01,494383,Mignozzetti; Umberto,35,0,35,0
1715623277146,CSS 202S,A01,494387,Mignozzetti; Umberto,35,0,35,0
1715623278171,DSC 197,001,628532,Eldridge; Justin Matthew,9995,0,9999,4
1715623279197,EAP 100,A00,516065,Staff,9799,0,9999,200
1715623280231,ECE 45,A01,507414,Staff,31,0,60,29
1715623282286,ECE 111,A01,507420,Staff,11,0,50,39
1715623283311,ECE 197,001,548057,Sievenpiper; Daniel F.,9991,0,9999,8
1715623284389,EDS 115,A00,507243,Choi; Bailey Miyeon,7,0,28,21
1715623285418,EDS 117,A01,494379,Staff,0,6,34,34
1715623286442,EDS 125,A00,507246,Hopkins; Megan Beth,8,0,30,22
1715623287467,EDS 128A,A01,507264,Fargason; Sharon Gayle,6,0,26,20
1715623288497,EDS 128B,A01,507293,Pappas; Elizabeth,10,0,30,20
1715623289521,EDS 139,A00,507294,Fargason; Sharon Gayle,10,0,30,20
1715623289521,EDS 139,B00,507313,Pappas; Elizabeth,11,0,30,19
1715623290547,EDS 201,A00,507315,Staff,10,0,30,20
1715623291574,EDS 203,A01,507317,Halter; Christopher P.,10,0,30,20
1715623292604,EDS 204R,A01,507319,Halter; Christopher P.,0,3,30,30
1715623292604,EDS 204R,B01,507331,Heinzman; Erica M.,14,0,30,16
1715623293632,EDS 206R,A00,507332,Staff,0,4,30,30
1715623293632,EDS 206R,B00,507343,Staff,15,0,30,15
1715623294663,EDS 250,A00,507344,Hemans; Patricia Ann Benitez,20,0,40,20
1715623295690,EDS 281,A00,507345,Daly; Alan J.,18,0,18,0
1715623296718,EDS 284,A00,507350,Daly; Alan J.,16,0,16,0
1715623297743,EDS 286,A00,507359,Fine; Sarah,18,0,18,0
1715623298773,EDS 289C,A01,507361,Daly; Alan J.,18,0,18,0
1715623299803,EDS 290,A00,507366,Hofstetter; Carolyn,15,0,15,0
1715623300829,LIGM 5A,A00,507421,Fischer-Grunski; Eva K,17,0,20,3
1715623301858,LIGM 5B,A00,507423,Fischer-Grunski; Eva K,19,0,20,1
1715623302882,LIGM 5C,A00,507425,Fischer-Grunski; Eva K,19,0,20,1
1715623303907,LIIT 5AS,A00,507427,Carnelos; Chiara,20,0,20,0
1715623304934,LIIT 5BS,A00,507430,Carnelos; Chiara,20,0,20,0
1715623305962,LIIT 5CS,A00,507432,Carnelos; Chiara,20,0,20,0
1715623306989,LISP 5A,A00,507541,Munoz Sanchez; Alicia,11,0,20,9
1715623308019,LISP 5B,A00,507671,Munoz Sanchez; Alicia,9,0,20,11
1715623309047,LISP 5C,A00,507696,Munoz Sanchez; Alicia,9,0,20,11
1715623310078,MAE 197,001,528363,Boechler; Nicholas Sebastia,9998,0,9999,1
1715623311110,MATH 197,001,523477,Kedlaya; Kiran S.,9994,0,9999,5
1715623311110,MATH 197,002,563811,Zhang; Danna,9994,0,9999,5
1715623311110,MATH 197,003,628552,Dumitriu; Ioana,9998,0,9999,1
1715623311110,MATH 197,004,660885,Floyd; Eric,9998,0,9999,1
1715623312139,MCWP 40R,A00,518780,Staff,2,0,20,18
1715623312139,MCWP 40R,B00,518781,Staff,11,0,20,9
1715623312139,MCWP 40R,C00,518783,Staff,5,0,20,15
1715623313172,MCWP 50R,A00,518791,Staff,0,1,20,20
1715623313172,MCWP 50R,B00,518792,Staff,0,2,20,20
1715623313172,MCWP 50R,C00,518793,Staff,0,4,20,20
1715623313172,MCWP 50R,D00,518794,Staff,0,1,20,20
1715623313172,MCWP 50R,E00,518795,Staff,0,2,20,20
1715623313172,MCWP 50R,F00,518796,Staff,0,1,20,20
1715623313172,MCWP 50R,G00,518797,Staff,0,1,20,20
1715623314202,MMW 12R,A01,514034,Herbst; Matthew,0,2,16,16
1715623314202,MMW 12R,A02,514035,Herbst; Matthew,0,0,16,16
1715623315231,MMW 13R,A01,514037,Staff,0,5,16,16
1715623315231,MMW 13R,A02,514039,Staff,0,5,16,16
1715623315231,MMW 13R,A03,628519,Staff,0,4,16,16
1715623317287,SIO 295LS,A00,523233,Staff,10,0,30,20
1715623318312,SIO 295S,A00,523232,Staff,10,0,30,20
1715623319343,SIOC 290S,A01,637330,Merrifield; Mark A,23,0,30,7
1715623320369,SIOC 291S,A01,637333,Gabriel; Corey John,23,0,30,7
1715623321395,SOCI 117,A01,494376,Staff,0,5,5,5
1715623322422,WES 237B,A00,494380,Staff,10,0,20,10
1715623324493,AESE 279B,A00,494370,Wade; Jon P,0,0,33,33
1715623325521,AIP 97,001,660915,Van Den Einde; Yael Dahlia,9998,0,9999,1
1715623326547,AIP 197,001,627712,Vespa; Emanuel Ignacio,9995,0,9999,4
1715623326547,AIP 197,002,650778,Amir; On,9998,0,9999,1
1715623326547,AIP 197,003,650933,Avenancio-Leon; Carlos,9998,0,9999,1
1715623326547,AIP 197,004,658530,Heyman; Gail D.,9998,0,9999,1
1715623326547,AIP 197,005,658631,Neal; Sonya E,9998,0,9999,1
1715623326547,AIP 197,006,658671,Du; Songzi,9998,0,9999,1
1715623327572,ANAR 135S,A00,494369,Braswell; Geoffrey E.,0,0,0,0
1715623328599,BENG 196,001,628496,Engler; Adam J.,9998,0,9999,1
1715623328599,BENG 196,002,660916,Watson; John Thomas,9999,0,9999,0
1715623329624,BISP 197,001,650773,Wilhelm; James E.,9994,0,9999,5
1715623329624,BISP 197,002,658904,Coleman; Aaron B.,9998,0,9999,1
1715623330651,CAT 124RS,A01,519847,Geibel; William,0,0,20,20
1715623331680,CAT 125RS,A01,515971,Geibel; William,0,0,20,20
1715623332706,CLRE 250,A00,511389,Morris; Sheldon,9992,0,9999,7
1715623333734,CLRE 251,A00,507176,Mehta; Ravindra L.,9992,0,9999,7
1715623333734,CLRE 251,B00,511410,Mehta; Ravindra L.,9998,0,9999,1
1715623334759,CLRE 252,A00,507189,Cuomo; Raphael Eduardo,9994,0,9999,5
1715623335788,CLRE 253,A00,507199,Vaida; Florin,9994,0,9999,5
1715623335788,CLRE 253,B00,507202,Vaida; Florin,9999,0,9999,0
1715623336814,CLRE 259,A00,507211,Patel; Hemal,9996,0,9999,3
1715623337841,CLRE 260,A00,507221,Cuomo; Raphael Eduardo,9999,0,9999,0
1715623338871,CLRE 297,001,507242,Cuomo; Raphael Eduardo,9999,0,9999,0
1715623339907,COGS 197,001,638244,Voytek; Bradley Thomas,9997,0,9999,2
1715623340937,CSE 191,A00,516875,Minnes Kemp; Mor Mia,9991,0,9999,8
1715623341965,CSE 197,001,637388,Minnes Kemp; Mor Mia,9992,0,9999,7
1715623342992,CSS 201S,A01,494383,Mignozzetti; Umberto,35,0,35,0
1715623344021,CSS 202S,A01,494387,Mignozzetti; Umberto,35,0,35,0
1715623345047,DSC 197,001,628532,Eldridge; Justin Matthew,9995,0,9999,4
1715623346130,EAP 100,A00,516065,Staff,9799,0,9999,200
1715623347161,ECE 45,A01,507414,Staff,31,0,60,29
1715623349215,ECE 111,A01,507420,Staff,11,0,50,39
1715623350242,ECE 197,001,548057,Sievenpiper; Daniel F.,9991,0,9999,8
1715623351268,EDS 115,A00,507243,Choi; Bailey Miyeon,7,0,28,21
1715623352298,EDS 117,A01,494379,Staff,0,6,34,34
1715623353324,EDS 125,A00,507246,Hopkins; Megan Beth,8,0,30,22
1715623354354,EDS 128A,A01,507264,Fargason; Sharon Gayle,6,0,26,20
1715623355381,EDS 128B,A01,507293,Pappas; Elizabeth,10,0,30,20
1715623356406,EDS 139,A00,507294,Fargason; Sharon Gayle,10,0,30,20
1715623356406,EDS 139,B00,507313,Pappas; Elizabeth,11,0,30,19
1715623357439,EDS 201,A00,507315,Staff,10,0,30,20
1715623358465,EDS 203,A01,507317,Halter; Christopher P.,10,0,30,20
1715623359491,EDS 204R,A01,507319,Halter; Christopher P.,0,3,30,30
1715623359491,EDS 204R,B01,507331,Heinzman; Erica M.,14,0,30,16
1715623360520,EDS 206R,A00,507332,Staff,0,4,30,30
1715623360520,EDS 206R,B00,507343,Staff,15,0,30,15
1715623361549,EDS 250,A00,507344,Hemans; Patricia Ann Benitez,20,0,40,20
1715623362576,EDS 281,A00,507345,Daly; Alan J.,18,0,18,0
1715623363601,EDS 284,A00,507350,Daly; Alan J.,16,0,16,0
1715623364631,EDS 286,A00,507359,Fine; Sarah,18,0,18,0
1715623365657,EDS 289C,A01,507361,Daly; Alan J.,18,0,18,0
1715623366684,EDS 290,A00,507366,Hofstetter; Carolyn,15,0,15,0
1715623367711,LIGM 5A,A00,507421,Fischer-Grunski; Eva K,17,0,20,3
1715623368739,LIGM 5B,A00,507423,Fischer-Grunski; Eva K,19,0,20,1
1715623369768,LIGM 5C,A00,507425,Fischer-Grunski; Eva K,19,0,20,1
1715623370792,LIIT 5AS,A00,507427,Carnelos; Chiara,20,0,20,0
1715623371821,LIIT 5BS,A00,507430,Carnelos; Chiara,20,0,20,0
1715623372847,LIIT 5CS,A00,507432,Carnelos; Chiara,20,0,20,0
1715623373872,LISP 5A,A00,507541,Munoz Sanchez; Alicia,11,0,20,9
1715623374897,LISP 5B,A00,507671,Munoz Sanchez; Alicia,9,0,20,11
1715623375927,LISP 5C,A00,507696,Munoz Sanchez; Alicia,9,0,20,11
1715623376952,MAE 197,001,528363,Boechler; Nicholas Sebastia,9998,0,9999,1
1715623377978,MATH 197,001,523477,Kedlaya; Kiran S.,9994,0,9999,5
1715623377978,MATH 197,002,563811,Zhang; Danna,9994,0,9999,5
1715623377978,MATH 197,003,628552,Dumitriu; Ioana,9998,0,9999,1
1715623377978,MATH 197,004,660885,Floyd; Eric,9998,0,9999,1
1715623379002,MCWP 40R,A00,518780,Staff,2,0,20,18
1715623379002,MCWP 40R,B00,518781,Staff,11,0,20,9
1715623379002,MCWP 40R,C00,518783,Staff,5,0,20,15
1715623380031,MCWP 50R,A00,518791,Staff,0,1,20,20
1715623380031,MCWP 50R,B00,518792,Staff,0,2,20,20
1715623380031,MCWP 50R,C00,518793,Staff,0,4,20,20
1715623380031,MCWP 50R,D00,518794,Staff,0,1,20,20
1715623380031,MCWP 50R,E00,518795,Staff,0,2,20,20
1715623380031,MCWP 50R,F00,518796,Staff,0,1,20,20
1715623380031,MCWP 50R,G00,518797,Staff,0,1,20,20
1715623381057,MMW 12R,A01,514034,Herbst; Matthew,0,2,16,16
1715623381057,MMW 12R,A02,514035,Herbst; Matthew,0,0,16,16
1715623382085,MMW 13R,A01,514037,Staff,0,5,16,16
1715623382085,MMW 13R,A02,514039,Staff,0,5,16,16
1715623382085,MMW 13R,A03,628519,Staff,0,4,16,16
1715623384145,SIO 295LS,A00,523233,Staff,10,0,30,20
1715623385174,SIO 295S,A00,523232,Staff,10,0,30,20
1715623386204,SIOC 290S,A01,637330,Merrifield; Mark A,23,0,30,7
1715623387235,SIOC 291S,A01,637333,Gabriel; Corey John,23,0,30,7
1715623388262,SOCI 117,A01,494376,Staff,0,5,5,5
1715623389289,WES 237B,A00,494380,Staff,10,0,20,10
1715623391357,AESE 279B,A00,494370,Wade; Jon P,0,0,33,33
1715623392383,AIP 97,001,660915,Van Den Einde; Yael Dahlia,9998,0,9999,1
1715623393414,AIP 197,001,627712,Vespa; Emanuel Ignacio,9995,0,9999,4
1715623393414,AIP 197,002,650778,Amir; On,9998,0,9999,1
1715623393414,AIP 197,003,650933,Avenancio-Leon; Carlos,9998,0,9999,1
1715623393414,AIP 197,004,658530,Heyman; Gail D.,9998,0,9999,1
1715623393414,AIP 197,005,658631,Neal; Sonya E,9998,0,9999,1
1715623393414,AIP 197,006,658671,Du; Songzi,9998,0,9999,1
1715623394441,ANAR 135S,A00,494369,Braswell; Geoffrey E.,0,0,0,0
1715623395470,BENG 196,001,628496,Engler; Adam J.,9998,0,9999,1
1715623395470,BENG 196,002,660916,Watson; John Thomas,9999,0,9999,0
1715623396499,BISP 197,001,650773,Wilhelm; James E.,9994,0,9999,5
1715623396499,BISP 197,002,658904,Coleman; Aaron B.,9998,0,9999,1
1715623397533,CAT 124RS,A01,519847,Geibel; William,0,0,20,20
1715623398562,CAT 125RS,A01,515971,Geibel; William,0,0,20,20
1715623399589,CLRE 250,A00,511389,Morris; Sheldon,9992,0,9999,7
1715623400617,CLRE 251,A00,507176,Mehta; Ravindra L.,9992,0,9999,7
1715623400617,CLRE 251,B00,511410,Mehta; Ravindra L.,9998,0,9999,1
1715623401643,CLRE 252,A00,507189,Cuomo; Raphael Eduardo,9994,0,9999,5
1715623402669,CLRE 253,A00,507199,Vaida; Florin,9994,0,9999,5
1715623402669,CLRE 253,B00,507202,Vaida; Florin,9999,0,9999,0
1715623403695,CLRE 259,A00,507211,Patel; Hemal,9996,0,9999,3
1715623404721,CLRE 260,A00,507221,Cuomo; Raphael Eduardo,9999,0,9999,0
1715623405747,CLRE 297,001,507242,Cuomo; Raphael Eduardo,9999,0,9999,0
1715623406770,COGS 197,001,638244,Voytek; Bradley Thomas,9997,0,9999,2
1715623407796,CSE 191,A00,516875,Minnes Kemp; Mor Mia,9991,0,9999,8
1715623408821,CSE 197,001,637388,Minnes Kemp; Mor Mia,9992,0,9999,7
1715623409847,CSS 201S,A01,494383,Mignozzetti; Umberto,35,0,35,0
1715623410879,CSS 202S,A01,494387,Mignozzetti; Umberto,35,0,35,0
1715623411905,DSC 197,001,628532,Eldridge; Justin Matthew,9995,0,9999,4
1715623412930,EAP 100,A00,516065,Staff,9799,0,9999,200
1715623413961,ECE 45,A01,507414,Staff,31,0,60,29
1715623416016,ECE 111,A01,507420,Staff,11,0,50,39
1715623417043,ECE 197,001,548057,Sievenpiper; Daniel F.,9991,0,9999,8
1715623418068,EDS 115,A00,507243,Choi; Bailey Miyeon,7,0,28,21
1715623419093,EDS 117,A01,494379,Staff,0,6,34,34
1715623420119,EDS 125,A00,507246,Hopkins; Megan Beth,8,0,30,22
1715623421148,EDS 128A,A01,507264,Fargason; Sharon Gayle,6,0,26,20
1715623422178,EDS 128B,A01,507293,Pappas; Elizabeth,10,0,30,20
1715623423203,EDS 139,A00,507294,Fargason; Sharon Gayle,10,0,30,20
1715623423203,EDS 139,B00,507313,Pappas; Elizabeth,11,0,30,19
1715623424228,EDS 201,A00,507315,Staff,10,0,30,20
1715623425256,EDS 203,A01,507317,Halter; Christopher P.,10,0,30,20
1715623426283,EDS 204R,A01,507319,Halter; Christopher P.,0,3,30,30
1715623426283,EDS 204R,B01,507331,Heinzman; Erica M.,14,0,30,16
1715623427312,EDS 206R,A00,507332,Staff,0,4,30,30
1715623427312,EDS 206R,B00,507343,Staff,15,0,30,15
1715623428340,EDS 250,A00,507344,Hemans; Patricia Ann Benitez,20,0,40,20
1715623429368,EDS 281,A00,507345,Daly; Alan J.,18,0,18,0
1715623430398,EDS 284,A00,507350,Daly; Alan J.,16,0,16,0
1715623431424,EDS 286,A00,507359,Fine; Sarah,18,0,18,0
1715623432450,EDS 289C,A01,507361,Daly; Alan J.,18,0,18,0
1715623433483,EDS 290,A00,507366,Hofstetter; Carolyn,15,0,15,0
1715623434513,LIGM 5A,A00,507421,Fischer-Grunski; Eva K,17,0,20,3
1715623435539,LIGM 5B,A00,507423,Fischer-Grunski; Eva K,19,0,20,1
1715623436565,LIGM 5C,A00,507425,Fischer-Grunski; Eva K,19,0,20,1
1715623437593,LIIT 5AS,A00,507427,Carnelos; Chiara,20,0,20,0
1715623438623,LIIT 5BS,A00,507430,Carnelos; Chiara,20,0,20,0
1715623439648,LIIT 5CS,A00,507432,Carnelos; Chiara,20,0,20,0
1715623440676,LISP 5A,A00,507541,Munoz Sanchez; Alicia,11,0,20,9
1715623441700,LISP 5B,A00,507671,Munoz Sanchez; Alicia,9,0,20,11
1715623442740,LISP 5C,A00,507696,Munoz Sanchez; Alicia,9,0,20,11
1715623443766,MAE 197,001,528363,Boechler; Nicholas Sebastia,9998,0,9999,1
1715623444796,MATH 197,001,523477,Kedlaya; Kiran S.,9994,0,9999,5
1715623444796,MATH 197,002,563811,Zhang; Danna,9994,0,9999,5
1715623444796,MATH 197,003,628552,Dumitriu; Ioana,9998,0,9999,1
1715623444796,MATH 197,004,660885,Floyd; Eric,9998,0,9999,1
1715623445823,MCWP 40R,A00,518780,Staff,2,0,20,18
1715623445823,MCWP 40R,B00,518781,Staff,11,0,20,9
1715623445823,MCWP 40R,C00,518783,Staff,5,0,20,15
1715623446850,MCWP 50R,A00,518791,Staff,0,1,20,20
1715623446850,MCWP 50R,B00,518792,Staff,0,2,20,20
1715623446850,MCWP 50R,C00,518793,Staff,0,4,20,20
1715623446850,MCWP 50R,D00,518794,Staff,0,1,20,20
1715623446850,MCWP 50R,E00,518795,Staff,0,2,20,20
1715623446850,MCWP 50R,F00,518796,Staff,0,1,20,20
1715623446850,MCWP 50R,G00,518797,Staff,0,1,20,20
1715623447877,MMW 12R,A01,514034,Herbst; Matthew,0,2,16,16
1715623447877,MMW 12R,A02,514035,Herbst; Matthew,0,0,16,16
1715623448902,MMW 13R,A01,514037,Staff,0,5,16,16
1715623448902,MMW 13R,A02,514039,Staff,0,5,16,16
1715623448902,MMW 13R,A03,628519,Staff,0,4,16,16
1715623451010,SIO 295LS,A00,523233,Staff,10,0,30,20
1715623452039,SIO 295S,A00,523232,Staff,10,0,30,20
1715623453067,SIOC 290S,A01,637330,Merrifield; Mark A,23,0,30,7
1715623454096,SIOC 291S,A01,637333,Gabriel; Corey John,23,0,30,7
1715623455121,SOCI 117,A01,494376,Staff,0,5,5,5
1715623456147,WES 237B,A00,494380,Staff,10,0,20,10
1715623458204,AESE 279B,A00,494370,Wade; Jon P,0,0,33,33
1715623459230,AIP 97,001,660915,Van Den Einde; Yael Dahlia,9998,0,9999,1
1715623460261,AIP 197,001,627712,Vespa; Emanuel Ignacio,9995,0,9999,4
1715623460261,AIP 197,002,650778,Amir; On,9998,0,9999,1
1715623460261,AIP 197,003,650933,Avenancio-Leon; Carlos,9998,0,9999,1
1715623460261,AIP 197,004,658530,Heyman; Gail D.,9998,0,9999,1
1715623460261,AIP 197,005,658631,Neal; Sonya E,9998,0,9999,1
1715623460261,AIP 197,006,658671,Du; Songzi,9998,0,9999,1
1715623461286,ANAR 135S,A00,494369,Braswell; Geoffrey E.,0,0,0,0
1715623462315,BENG 196,001,628496,Engler; Adam J.,9998,0,9999,1
1715623462315,BENG 196,002,660916,Watson; John Thomas,9999,0,9999,0
1715623463340,BISP 197,001,650773,Wilhelm; James E.,9994,0,9999,5
1715623463340,BISP 197,002,658904,Coleman; Aaron B.,9998,0,9999,1
1715623464367,CAT 124RS,A01,519847,Geibel; William,0,0,20,20
1715623465393,CAT 125RS,A01,515971,Geibel; William,0,0,20,20
1715623466420,CLRE 250,A00,511389,Morris; Sheldon,9992,0,9999,7
1715623467458,CLRE 251,A00,507176,Mehta; Ravindra L.,9992,0,9999,7
1715623467458,CLRE 251,B00,511410,Mehta; Ravindra L.,9998,0,9999,1
1715623468485,CLRE 252,A00,507189,Cuomo; Raphael Eduardo,9994,0,9999,5
1715623469513,CLRE 253,A00,507199,Vaida; Florin,9994,0,9999,5
1715623469513,CLRE 253,B00,507202,Vaida; Florin,9999,0,9999,0
1715623470542,CLRE 259,A00,507211,Patel; Hemal,9996,0,9999,3
1715623471567,CLRE 260,A00,507221,Cuomo; Raphael Eduardo,9999,0,9999,0
1715623472594,CLRE 297,001,507242,Cuomo; Raphael Eduardo,9999,0,9999,0
1715623473627,COGS 197,001,638244,Voytek; Bradley Thomas,9997,0,9999,2
1715623474655,CSE 191,A00,516875,Minnes Kemp; Mor Mia,9991,0,9999,8
1715623475679,CSE 197,001,637388,Minnes Kemp; Mor Mia,9992,0,9999,7
1715623476705,CSS 201S,A01,494383,Mignozzetti; Umberto,35,0,35,0
1715623477732,CSS 202S,A01,494387,Mignozzetti; Umberto,35,0,35,0
1715623478756,DSC 197,001,628532,Eldridge; Justin Matthew,9995,0,9999,4
1715623479783,EAP 100,A00,516065,Staff,9799,0,9999,200
1715623480810,ECE 45,A01,507414,Staff,31,0,60,29
1715623482862,ECE 111,A01,507420,Staff,11,0,50,39
1715623483898,ECE 197,001,548057,Sievenpiper; Daniel F.,9991,0,9999,8
1715623484928,EDS 115,A00,507243,Choi; Bailey Miyeon,7,0,28,21
1715623485955,EDS 117,A01,494379,Staff,0,6,34,34
1715623486979,EDS 125,A00,507246,Hopkins; Megan Beth,8,0,30,22
1715623488005,EDS 128A,A01,507264,Fargason; Sharon Gayle,6,0,26,20
1715623489031,EDS 128B,A01,507293,Pappas; Elizabeth,10,0,30,20
1715623490059,EDS 139,A00,507294,Fargason; Sharon Gayle,10,0,30,20
1715623490059,EDS 139,B00,507313,Pappas; Elizabeth,11,0,30,19
1715623491085,EDS 201,A00,507315,Staff,10,0,30,20
1715623492112,EDS 203,A01,507317,Halter; Christopher P.,10,0,30,20
1715623493140,EDS 204R,A01,507319,Halter; Christopher P.,0,3,30,30
1715623493140,EDS 204R,B01,507331,Heinzman; Erica M.,14,0,30,16
1715623494178,EDS 206R,A00,507332,Staff,0,4,30,30
1715623494178,EDS 206R,B00,507343,Staff,15,0,30,15
1715623495205,EDS 250,A00,507344,Hemans; Patricia Ann Benitez,20,0,40,20
1715623496233,EDS 281,A00,507345,Daly; Alan J.,18,0,18,0
1715623497260,EDS 284,A00,507350,Daly; Alan J.,16,0,16,0
1715623498284,EDS 286,A00,507359,Fine; Sarah,18,0,18,0
1715623499308,EDS 289C,A01,507361,Daly; Alan J.,18,0,18,0
1715623500336,EDS 290,A00,507366,Hofstetter; Carolyn,15,0,15,0
1715623501364,LIGM 5A,A00,507421,Fischer-Grunski; Eva K,17,0,20,3
1715623502394,LIGM 5B,A00,507423,Fischer-Grunski; Eva K,19,0,20,1
1715623503426,LIGM 5C,A00,507425,Fischer-Grunski; Eva K,19,0,20,1
1715623504451,LIIT 5AS,A00,507427,Carnelos; Chiara,20,0,20,0
1715623505480,LIIT 5BS,A00,507430,Carnelos; Chiara,20,0,20,0
1715623506510,LIIT 5CS,A00,507432,Carnelos; Chiara,20,0,20,0
1715623507536,LISP 5A,A00,507541,Munoz Sanchez; Alicia,11,0,20,9
1715623508561,LISP 5B,A00,507671,Munoz Sanchez; Alicia,9,0,20,11
1715623509589,LISP 5C,A00,507696,Munoz Sanchez; Alicia,9,0,20,11
1715623510616,MAE 197,001,528363,Boechler; Nicholas Sebastia,9998,0,9999,1
1715623511646,MATH 197,001,523477,Kedlaya; Kiran S.,9994,0,9999,5
1715623511646,MATH 197,002,563811,Zhang; Danna,9994,0,9999,5
1715623511646,MATH 197,003,628552,Dumitriu; Ioana,9998,0,9999,1
1715623511646,MATH 197,004,660885,Floyd; Eric,9998,0,9999,1
1715623512675,MCWP 40R,A00,518780,Staff,2,0,20,18
1715623512675,MCWP 40R,B00,518781,Staff,11,0,20,9
1715623512675,MCWP 40R,C00,518783,Staff,5,0,20,15
1715623513701,MCWP 50R,A00,518791,Staff,0,1,20,20
1715623513701,MCWP 50R,B00,518792,Staff,0,2,20,20
1715623513701,MCWP 50R,C00,518793,Staff,0,4,20,20
1715623513701,MCWP 50R,D00,518794,Staff,0,1,20,20
1715623513701,MCWP 50R,E00,518795,Staff,0,2,20,20
1715623513701,MCWP 50R,F00,518796,Staff,0,1,20,20
1715623513701,MCWP 50R,G00,518797,Staff,0,1,20,20
1715623514726,MMW 12R,A01,514034,Herbst; Matthew,0,2,16,16
1715623514726,MMW 12R,A02,514035,Herbst; Matthew,0,0,16,16
1715623515752,MMW 13R,A01,514037,Staff,0,5,16,16
1715623515752,MMW 13R,A02,514039,Staff,0,5,16,16
1715623515752,MMW 13R,A03,628519,Staff,0,4,16,16
1715623517806,SIO 295LS,A00,523233,Staff,10,0,30,20
1715623518831,SIO 295S,A00,523232,Staff,10,0,30,20
1715623519860,SIOC 290S,A01,637330,Merrifield; Mark A,23,0,30,7
1715623520886,SIOC 291S,A01,637333,Gabriel; Corey John,23,0,30,7
1715623521914,SOCI 117,A01,494376,Staff,0,5,5,5
1715623522942,WES 237B,A00,494380,Staff,10,0,20,10
1715623525009,AESE 279B,A00,494370,Wade; Jon P,0,0,33,33
1715623526033,AIP 97,001,660915,Van Den Einde; Yael Dahlia,9998,0,9999,1
1715623527061,AIP 197,001,627712,Vespa; Emanuel Ignacio,9995,0,9999,4
1715623527061,AIP 197,002,650778,Amir; On,9998,0,9999,1
1715623527061,AIP 197,003,650933,Avenancio-Leon; Carlos,9998,0,9999,1
1715623527061,AIP 197,004,658530,Heyman; Gail D.,9998,0,9999,1
1715623527061,AIP 197,005,658631,Neal; Sonya E,9998,0,9999,1
1715623527061,AIP 197,006,658671,Du; Songzi,9998,0,9999,1
1715623528089,ANAR 135S,A00,494369,Braswell; Geoffrey E.,0,0,0,0
1715623529118,BENG 196,001,628496,Engler; Adam J.,9998,0,9999,1
1715623529118,BENG 196,002,660916,Watson; John Thomas,9999,0,9999,0
1715623530145,BISP 197,001,650773,Wilhelm; James E.,9994,0,9999,5
1715623530145,BISP 197,002,658904,Coleman; Aaron B.,9998,0,9999,1
1715623531170,CAT 124RS,A01,519847,Geibel; William,0,0,20,20
1715623532194,CAT 125RS,A01,515971,Geibel; William,0,0,20,20
1715623533223,CLRE 250,A00,511389,Morris; Sheldon,9992,0,9999,7
1715623534249,CLRE 251,A00,507176,Mehta; Ravindra L.,9992,0,9999,7
1715623534249,CLRE 251,B00,511410,Mehta; Ravindra L.,9998,0,9999,1
1715623535279,CLRE 252,A00,507189,Cuomo; Raphael Eduardo,9994,0,9999,5
1715623536305,CLRE 253,A00,507199,Vaida; Florin,9994,0,9999,5
1715623536305,CLRE 253,B00,507202,Vaida; Florin,9999,0,9999,0
1715623537329,CLRE 259,A00,507211,Patel; Hemal,9996,0,9999,3
1715623538357,CLRE 260,A00,507221,Cuomo; Raphael Eduardo,9999,0,9999,0
1715623539383,CLRE 297,001,507242,Cuomo; Raphael Eduardo,9999,0,9999,0
1715623540410,COGS 197,001,638244,Voytek; Bradley Thomas,9997,0,9999,2
1715623541436,CSE 191,A00,516875,Minnes Kemp; Mor Mia,9991,0,9999,8
1715623542462,CSE 197,001,637388,Minnes Kemp; Mor Mia,9992,0,9999,7
1715623543493,CSS 201S,A01,494383,Mignozzetti; Umberto,35,0,35,0
1715623544520,CSS 202S,A01,494387,Mignozzetti; Umberto,35,0,35,0
1715623545545,DSC 197,001,628532,Eldridge; Justin Matthew,9995,0,9999,4
1715623546570,EAP 100,A00,516065,Staff,9799,0,9999,200
1715623547597,ECE 45,A01,507414,Staff,31,0,60,29
1715623549647,ECE 111,A01,507420,Staff,11,0,50,39
1715623550675,ECE 197,001,548057,Sievenpiper; Daniel F.,9991,0,9999,8
1715623551704,EDS 115,A00,507243,Choi; Bailey Miyeon,7,0,28,21
1715623552730,EDS 117,A01,494379,Staff,0,6,34,34
1715623553810,EDS 125,A00,507246,Hopkins; Megan Beth,8,0,30,22
1715623554840,EDS 128A,A01,507264,Fargason; Sharon Gayle,6,0,26,20
1715623555866,EDS 128B,A01,507293,Pappas; Elizabeth,10,0,30,20
1715623556890,EDS 139,A00,507294,Fargason; Sharon Gayle,10,0,30,20
1715623556890,EDS 139,B00,507313,Pappas; Elizabeth,11,0,30,19
1715623557918,EDS 201,A00,507315,Staff,10,0,30,20
1715623558945,EDS 203,A01,507317,Halter; Christopher P.,10,0,30,20
1715623559981,EDS 204R,A01,507319,Halter; Christopher P.,0,3,30,30
1715623559981,EDS 204R,B01,507331,Heinzman; Erica M.,14,0,30,16
1715623561006,EDS 206R,A00,507332,Staff,0,4,30,30
1715623561006,EDS 206R,B00,507343,Staff,15,0,30,15
1715623562033,EDS 250,A00,507344,Hemans; Patricia Ann Benitez,20,0,40,20
1715623563060,EDS 281,A00,507345,Daly; Alan J.,18,0,18,0
1715623564084,EDS 284,A00,507350,Daly; Alan J.,16,0,16,0
1715623565110,EDS 286,A00,507359,Fine; Sarah,18,0,18,0
1715623566137,EDS 289C,A01,507361,Daly; Alan J.,18,0,18,0
1715623567163,EDS 290,A00,507366,Hofstetter; Carolyn,15,0,15,0
1715623568194,LIGM 5A,A00,507421,Fischer-Grunski; Eva K,17,0,20,3
1715623569219,LIGM 5B,A00,507423,Fischer-Grunski; Eva K,19,0,20,1
1715623570248,LIGM 5C,A00,507425,Fischer-Grunski; Eva K,19,0,20,1
1715623571273,LIIT 5AS,A00,507427,Carnelos; Chiara,20,0,20,0
1715623572298,LIIT 5BS,A00,507430,Carnelos; Chiara,20,0,20,0
1715623573324,LIIT 5CS,A00,507432,Carnelos; Chiara,20,0,20,0
1715623574351,LISP 5A,A00,507541,Munoz Sanchez; Alicia,11,0,20,9
1715623575378,LISP 5B,A00,507671,Munoz Sanchez; Alicia,9,0,20,11
1715623576407,LISP 5C,A00,507696,Munoz Sanchez; Alicia,9,0,20,11
1715623577434,MAE 197,001,528363,Boechler; Nicholas Sebastia,9998,0,9999,1
1715623578458,MATH 197,001,523477,Kedlaya; Kiran S.,9994,0,9999,5
1715623578458,MATH 197,002,563811,Zhang; Danna,9994,0,9999,5
1715623578458,MATH 197,003,628552,Dumitriu; Ioana,9998,0,9999,1
1715623578458,MATH 197,004,660885,Floyd; Eric,9998,0,9999,1
1715623579484,MCWP 40R,A00,518780,Staff,2,0,20,18
1715623579484,MCWP 40R,B00,518781,Staff,11,0,20,9
1715623579484,MCWP 40R,C00,518783,Staff,5,0,20,15
1715623580513,MCWP 50R,A00,518791,Staff,0,1,20,20
1715623580513,MCWP 50R,B00,518792,Staff,0,2,20,20
1715623580513,MCWP 50R,C00,518793,Staff,0,4,20,20
1715623580513,MCWP 50R,D00,518794,Staff,0,1,20,20
1715623580513,MCWP 50R,E00,518795,Staff,0,2,20,20
1715623580513,MCWP 50R,F00,518796,Staff,0,1,20,20
1715623580513,MCWP 50R,G00,518797,Staff,0,1,20,20
1715623581541,MMW 12R,A01,514034,Herbst; Matthew,0,2,16,16
1715623581541,MMW 12R,A02,514035,Herbst; Matthew,0,0,16,16
1715623582570,MMW 13R,A01,514037,Staff,0,5,16,16
1715623582570,MMW 13R,A02,514039,Staff,0,5,16,16
1715623582570,MMW 13R,A03,628519,Staff,0,4,16,16
1715623584625,SIO 295LS,A00,523233,Staff,10,0,30,20
1715623585651,SIO 295S,A00,523232,Staff,10,0,30,20
1715623586680,SIOC 290S,A01,637330,Merrifield; Mark A,23,0,30,7
1715623587709,SIOC 291S,A01,637333,Gabriel; Corey John,23,0,30,7
1715623588735,SOCI 117,A01,494376,Staff,0,5,5,5
1715623589765,WES 237B,A00,494380,Staff,10,0,20,10
1715623591843,AESE 279B,A00,494370,Wade; Jon P,0,0,33,33
1715623592869,AIP 97,001,660915,Van Den Einde; Yael Dahlia,9998,0,9999,1
1715623593904,AIP 197,001,627712,Vespa; Emanuel Ignacio,9995,0,9999,4
1715623593904,AIP 197,002,650778,Amir; On,9998,0,9999,1
1715623593904,AIP 197,003,650933,Avenancio-Leon; Carlos,9998,0,9999,1
1715623593904,AIP 197,004,658530,Heyman; Gail D.,9998,0,9999,1
1715623593904,AIP 197,005,658631,Neal; Sonya E,9998,0,9999,1
1715623593904,AIP 197,006,658671,Du; Songzi,9998,0,9999,1
1715623594931,ANAR 135S,A00,494369,Braswell; Geoffrey E.,0,0,0,0
1715623595957,BENG 196,001,628496,Engler; Adam J.,9998,0,9999,1
1715623595957,BENG 196,002,660916,Watson; John Thomas,9999,0,9999,0
1715623596986,BISP 197,001,650773,Wilhelm; James E.,9994,0,9999,5
1715623596986,BISP 197,002,658904,Coleman; Aaron B.,9998,0,9999,1
1715623598013,CAT 124RS,A01,519847,Geibel; William,0,0,20,20
1715623599038,CAT 125RS,A01,515971,Geibel; William,0,0,20,20
1715623600067,CLRE 250,A00,511389,Morris; Sheldon,9992,0,9999,7
1715623601096,CLRE 251,A00,507176,Mehta; Ravindra L.,9992,0,9999,7
1715623601096,CLRE 251,B00,511410,Mehta; Ravindra L.,9998,0,9999,1
1715623602125,CLRE 252,A00,507189,Cuomo; Raphael Eduardo,9994,0,9999,5
1715623603152,CLRE 253,A00,507199,Vaida; Florin,9994,0,9999,5
1715623603152,CLRE 253,B00,507202,Vaida; Florin,9999,0,9999,0
1715623604178,CLRE 259,A00,507211,Patel; Hemal,9996,0,9999,3
1715623605203,CLRE 260,A00,507221,Cuomo; Raphael Eduardo,9999,0,9999,0
1715623606229,CLRE 297,001,507242,Cuomo; Raphael Eduardo,9999,0,9999,0
1715623607256,COGS 197,001,638244,Voytek; Bradley Thomas,9997,0,9999,2
1715623608282,CSE 191,A00,516875,Minnes Kemp; Mor Mia,9991,0,9999,8
1715623609306,CSE 197,001,637388,Minnes Kemp; Mor Mia,9992,0,9999,7
1715623610332,CSS 201S,A01,494383,Mignozzetti; Umberto,35,0,35,0
1715623611361,CSS 202S,A01,494387,Mignozzetti; Umberto,35,0,35,0
1715623612386,DSC 197,001,628532,Eldridge; Justin Matthew,9995,0,9999,4
1715623613412,EAP 100,A00,516065,Staff,9799,0,9999,200
1715623614440,ECE 45,A01,507414,Staff,31,0,60,29
1715623616495,ECE 111,A01,507420,Staff,11,0,50,39
1715623617523,ECE 197,001,548057,Sievenpiper; Daniel F.,9991,0,9999,8
1715623618548,EDS 115,A00,507243,Choi; Bailey Miyeon,7,0,28,21
1715623619576,EDS 117,A01,494379,Staff,0,6,34,34
1715623620602,EDS 125,A00,507246,Hopkins; Megan Beth,8,0,30,22
1715623621629,EDS 128A,A01,507264,Fargason; Sharon Gayle,6,0,26,20
1715623622655,EDS 128B,A01,507293,Pappas; Elizabeth,10,0,30,20
1715623623682,EDS 139,A00,507294,Fargason; Sharon Gayle,10,0,30,20
1715623623682,EDS 139,B00,507313,Pappas; Elizabeth,11,0,30,19
1715623624707,EDS 201,A00,507315,Staff,10,0,30,20
1715623625735,EDS 203,A01,507317,Halter; Christopher P.,10,0,30,20
1715623626765,EDS 204R,A01,507319,Halter; Christopher P.,0,3,30,30
1715623626765,EDS 204R,B01,507331,Heinzman; Erica M.,14,0,30,16
1715623627790,EDS 206R,A00,507332,Staff,0,4,30,30
1715623627790,EDS 206R,B00,507343,Staff,15,0,30,15
1715623628817,EDS 250,A00,507344,Hemans; Patricia Ann Benitez,20,0,40,20
1715623629842,EDS 281,A00,507345,Daly; Alan J.,18,0,18,0
1715623630870,EDS 284,A00,507350,Daly; Alan J.,16,0,16,0
1715623631895,EDS 286,A00,507359,Fine; Sarah,18,0,18,0
1715623632922,EDS 289C,A01,507361,Daly; Alan J.,18,0,18,0
1715623633945,EDS 290,A00,507366,Hofstetter; Carolyn,15,0,15,0
1715623634972,LIGM 5A,A00,507421,Fischer-Grunski; Eva K,17,0,20,3
1715623635997,LIGM 5B,A00,507423,Fischer-Grunski; Eva K,19,0,20,1
1715623637023,LIGM 5C,A00,507425,Fischer-Grunski; Eva K,19,0,20,1
1715623638053,LIIT 5AS,A00,507427,Carnelos; Chiara,20,0,20,0
1715623639082,LIIT 5BS,A00,507430,Carnelos; Chiara,20,0,20,0
1715623640107,LIIT 5CS,A00,507432,Carnelos; Chiara,20,0,20,0
1715623641136,LISP 5A,A00,507541,Munoz Sanchez; Alicia,11,0,20,9
1715623642164,LISP 5B,A00,507671,Munoz Sanchez; Alicia,9,0,20,11
1715623643193,LISP 5C,A00,507696,Munoz Sanchez; Alicia,9,0,20,11
1715623644221,MAE 197,001,528363,Boechler; Nicholas Sebastia,9998,0,9999,1
1715623645256,MATH 197,001,523477,Kedlaya; Kiran S.,9994,0,9999,5
1715623645256,MATH 197,002,563811,Zhang; Danna,9994,0,9999,5
1715623645256,MATH 197,003,628552,Dumitriu; Ioana,9998,0,9999,1
1715623645256,MATH 197,004,660885,Floyd; Eric,9998,0,9999,1
1715623646284,MCWP 40R,A00,518780,Staff,2,0,20,18
1715623646284,MCWP 40R,B00,518781,Staff,11,0,20,9
1715623646284,MCWP 40R,C00,518783,Staff,5,0,20,15
1715623647309,MCWP 50R,A00,518791,Staff,0,1,20,20
1715623647309,MCWP 50R,B00,518792,Staff,0,2,20,20
1715623647309,MCWP 50R,C00,518793,Staff,0,4,20,20
1715623647309,MCWP 50R,D00,518794,Staff,0,1,20,20
1715623647309,MCWP 50R,E00,518795,Staff,0,2,20,20
1715623647309,MCWP 50R,F00,518796,Staff,0,1,20,20
1715623647309,MCWP 50R,G00,518797,Staff,0,1,20,20
1715623648334,MMW 12R,A01,514034,Herbst; Matthew,0,2,16,16
1715623648334,MMW 12R,A02,514035,Herbst; Matthew,0,0,16,16
1715623649360,MMW 13R,A01,514037,Staff,0,5,16,16
1715623649360,MMW 13R,A02,514039,Staff,0,5,16,16
1715623649360,MMW 13R,A03,628519,Staff,0,4,16,16
1715623651414,SIO 295LS,A00,523233,Staff,10,0,30,20
1715623652441,SIO 295S,A00,523232,Staff,10,0,30,20
1715623653466,SIOC 290S,A01,637330,Merrifield; Mark A,23,0,30,7
1715623654497,SIOC 291S,A01,637333,Gabriel; Corey John,23,0,30,7
1715623655523,SOCI 117,A01,494376,Staff,0,5,5,5
1715623656551,WES 237B,A00,494380,Staff,10,0,20,10
1715623658682,AESE 279B,A00,494370,Wade; Jon P,0,0,33,33
1715623659707,AIP 97,001,660915,Van Den Einde; Yael Dahlia,9998,0,9999,1
1715623660732,AIP 197,001,627712,Vespa; Emanuel Ignacio,9995,0,9999,4
1715623660732,AIP 197,002,650778,Amir; On,9998,0,9999,1
1715623660732,AIP 197,003,650933,Avenancio-Leon; Carlos,9998,0,9999,1
1715623660732,AIP 197,004,658530,Heyman; Gail D.,9998,0,9999,1
1715623660732,AIP 197,005,658631,Neal; Sonya E,9998,0,9999,1
1715623660732,AIP 197,006,658671,Du; Songzi,9998,0,9999,1
1715623661757,ANAR 135S,A00,494369,Braswell; Geoffrey E.,0,0,0,0
1715623662782,BENG 196,001,628496,Engler; Adam J.,9998,0,9999,1
1715623662782,BENG 196,002,660916,Watson; John Thomas,9999,0,9999,0
1715623663808,BISP 197,001,650773,Wilhelm; James E.,9994,0,9999,5
1715623663808,BISP 197,002,658904,Coleman; Aaron B.,9998,0,9999,1
1715623664834,CAT 124RS,A01,519847,Geibel; William,0,0,20,20
1715623665858,CAT 125RS,A01,515971,Geibel; William,0,0,20,20
1715623666886,CLRE 250,A00,511389,Morris; Sheldon,9992,0,9999,7
1715623667913,CLRE 251,A00,507176,Mehta; Ravindra L.,9992,0,9999,7
1715623667913,CLRE 251,B00,511410,Mehta; Ravindra L.,9998,0,9999,1
1715623668940,CLRE 252,A00,507189,Cuomo; Raphael Eduardo,9994,0,9999,5
1715623669964,CLRE 253,A00,507199,Vaida; Florin,9994,0,9999,5
1715623669964,CLRE 253,B00,507202,Vaida; Florin,9999,0,9999,0
1715623670988,CLRE 259,A00,507211,Patel; Hemal,9996,0,9999,3
1715623672013,CLRE 260,A00,507221,Cuomo; Raphael Eduardo,9999,0,9999,0
1715623673040,CLRE 297,001,507242,Cuomo; Raphael Eduardo,9999,0,9999,0
1715623674067,COGS 197,001,638244,Voytek; Bradley Thomas,9997,0,9999,2
1715623675094,CSE 191,A00,516875,Minnes Kemp; Mor Mia,9991,0,9999,8
1715623676119,CSE 197,001,637388,Minnes Kemp; Mor Mia,9992,0,9999,7
1715623677145,CSS 201S,A01,494383,Mignozzetti; Umberto,35,0,35,0
1715623678175,CSS 202S,A01,494387,Mignozzetti; Umberto,35,0,35,0
1715623679201,DSC 197,001,628532,Eldridge; Justin Matthew,9995,0,9999,4
1715623680226,EAP 100,A00,516065,Staff,9799,0,9999,200
1715623681258,ECE 45,A01,507414,Staff,31,0,60,29
1715623683315,ECE 111,A01,507420,Staff,11,0,50,39
1715623684341,ECE 197,001,548057,Sievenpiper; Daniel F.,9991,0,9999,8
1715623685369,EDS 115,A00,507243,Choi; Bailey Miyeon,7,0,28,21
1715623686396,EDS 117,A01,494379,Staff,0,6,34,34
1715623687422,EDS 125,A00,507246,Hopkins; Megan Beth,8,0,30,22
1715623688452,EDS 128A,A01,507264,Fargason; Sharon Gayle,6,0,26,20
1715623689481,EDS 128B,A01,507293,Pappas; Elizabeth,10,0,30,20
1715623690509,EDS 139,A00,507294,Fargason; Sharon Gayle,10,0,30,20
1715623690509,EDS 139,B00,507313,Pappas; Elizabeth,11,0,30,19
1715623691538,EDS 201,A00,507315,Staff,10,0,30,20
1715623692567,EDS 203,A01,507317,Halter; Christopher P.,10,0,30,20
1715623693594,EDS 204R,A01,507319,Halter; Christopher P.,0,3,30,30
1715623693594,EDS 204R,B01,507331,Heinzman; Erica M.,14,0,30,16
1715623694624,EDS 206R,A00,507332,Staff,0,4,30,30
1715623694624,EDS 206R,B00,507343,Staff,15,0,30,15
1715623695650,EDS 250,A00,507344,Hemans; Patricia Ann Benitez,20,0,40,20
1715623696676,EDS 281,A00,507345,Daly; Alan J.,18,0,18,0
1715623697704,EDS 284,A00,507350,Daly; Alan J.,16,0,16,0
1715623698729,EDS 286,A00,507359,Fine; Sarah,18,0,18,0
1715623699754,EDS 289C,A01,507361,Daly; Alan J.,18,0,18,0
1715623700780,EDS 290,A00,507366,Hofstetter; Carolyn,15,0,15,0
1715623701811,LIGM 5A,A00,507421,Fischer-Grunski; Eva K,17,0,20,3
1715623702837,LIGM 5B,A00,507423,Fischer-Grunski; Eva K,19,0,20,1
1715623703870,LIGM 5C,A00,507425,Fischer-Grunski; Eva K,19,0,20,1
1715623704898,LIIT 5AS,A00,507427,Carnelos; Chiara,20,0,20,0
1715623705927,LIIT 5BS,A00,507430,Carnelos; Chiara,20,0,20,0
1715623706955,LIIT 5CS,A00,507432,Carnelos; Chiara,20,0,20,0
1715623707985,LISP 5A,A00,507541,Munoz Sanchez; Alicia,11,0,20,9
1715623709014,LISP 5B,A00,507671,Munoz Sanchez; Alicia,9,0,20,11
1715623710043,LISP 5C,A00,507696,Munoz Sanchez; Alicia,9,0,20,11
1715623711068,MAE 197,001,528363,Boechler; Nicholas Sebastia,9998,0,9999,1
1715623712099,MATH 197,001,523477,Kedlaya; Kiran S.,9994,0,9999,5
1715623712099,MATH 197,002,563811,Zhang; Danna,9994,0,9999,5
1715623712099,MATH 197,003,628552,Dumitriu; Ioana,9998,0,9999,1
1715623712099,MATH 197,004,660885,Floyd; Eric,9998,0,9999,1
1715623713129,MCWP 40R,A00,518780,Staff,2,0,20,18
1715623713129,MCWP 40R,B00,518781,Staff,11,0,20,9
1715623713129,MCWP 40R,C00,518783,Staff,5,0,20,15
1715623714162,MCWP 50R,A00,518791,Staff,0,1,20,20
1715623714162,MCWP 50R,B00,518792,Staff,0,2,20,20
1715623714162,MCWP 50R,C00,518793,Staff,0,4,20,20
1715623714162,MCWP 50R,D00,518794,Staff,0,1,20,20
1715623714162,MCWP 50R,E00,518795,Staff,0,2,20,20
1715623714162,MCWP 50R,F00,518796,Staff,0,1,20,20
1715623714162,MCWP 50R,G00,518797,Staff,0,1,20,20
1715623715189,MMW 12R,A01,514034,Herbst; Matthew,0,2,16,16
1715623715189,MMW 12R,A02,514035,Herbst; Matthew,0,0,16,16
1715623716214,MMW 13R,A01,514037,Staff,0,5,16,16
1715623716214,MMW 13R,A02,514039,Staff,0,5,16,16
1715623716214,MMW 13R,A03,628519,Staff,0,4,16,16
1715623718271,SIO 295LS,A00,523233,Staff,10,0,30,20
1715623719299,SIO 295S,A00,523232,Staff,10,0,30,20
1715623720325,SIOC 290S,A01,637330,Merrifield; Mark A,23,0,30,7
1715623721352,SIOC 291S,A01,637333,Gabriel; Corey John,23,0,30,7
1715623722377,SOCI 117,A01,494376,Staff,0,5,5,5
1715623723403,WES 237B,A00,494380,Staff,10,0,20,10
1715623725473,AESE 279B,A00,494370,Wade; Jon P,0,0,33,33
1715623726498,AIP 97,001,660915,Van Den Einde; Yael Dahlia,9998,0,9999,1
1715623727529,AIP 197,001,627712,Vespa; Emanuel Ignacio,9995,0,9999,4
1715623727529,AIP 197,002,650778,Amir; On,9998,0,9999,1
1715623727529,AIP 197,003,650933,Avenancio-Leon; Carlos,9998,0,9999,1
1715623727529,AIP 197,004,658530,Heyman; Gail D.,9998,0,9999,1
1715623727529,AIP 197,005,658631,Neal; Sonya E,9998,0,9999,1
1715623727529,AIP 197,006,658671,Du; Songzi,9998,0,9999,1
1715623728560,ANAR 135S,A00,494369,Braswell; Geoffrey E.,0,0,0,0
1715623729589,BENG 196,001,628496,Engler; Adam J.,9998,0,9999,1
1715623729589,BENG 196,002,660916,Watson; John Thomas,9999,0,9999,0
1715623730613,BISP 197,001,650773,Wilhelm; James E.,9994,0,9999,5
1715623730613,BISP 197,002,658904,Coleman; Aaron B.,9998,0,9999,1
1715623731640,CAT 124RS,A01,519847,Geibel; William,0,0,20,20
1715623732663,CAT 125RS,A01,515971,Geibel; William,0,0,20,20
1715623733692,CLRE 250,A00,511389,Morris; Sheldon,9992,0,9999,7
1715623734723,CLRE 251,A00,507176,Mehta; Ravindra L.,9992,0,9999,7
1715623734723,CLRE 251,B00,511410,Mehta; Ravindra L.,9998,0,9999,1
1715623735748,CLRE 252,A00,507189,Cuomo; Raphael Eduardo,9994,0,9999,5
1715623736774,CLRE 253,A00,507199,Vaida; Florin,9994,0,9999,5
1715623736774,CLRE 253,B00,507202,Vaida; Florin,9999,0,9999,0
1715623737800,CLRE 259,A00,507211,Patel; Hemal,9996,0,9999,3
1715623738825,CLRE 260,A00,507221,Cuomo; Raphael Eduardo,9999,0,9999,0
1715623739856,CLRE 297,001,507242,Cuomo; Raphael Eduardo,9999,0,9999,0
1715623740882,COGS 197,001,638244,Voytek; Bradley Thomas,9997,0,9999,2
1715623741911,CSE 191,A00,516875,Minnes Kemp; Mor Mia,9991,0,9999,8
1715623742936,CSE 197,001,637388,Minnes Kemp; Mor Mia,9992,0,9999,7
1715623743963,CSS 201S,A01,494383,Mignozzetti; Umberto,35,0,35,0
1715623744988,CSS 202S,A01,494387,Mignozzetti; Umberto,35,0,35,0
1715623746015,DSC 197,001,628532,Eldridge; Justin Matthew,9995,0,9999,4
1715623747041,EAP 100,A00,516065,Staff,9799,0,9999,200
1715623748073,ECE 45,A01,507414,Staff,31,0,60,29
1715623750124,ECE 111,A01,507420,Staff,11,0,50,39
1715623751153,ECE 197,001,548057,Sievenpiper; Daniel F.,9991,0,9999,8
1715623752181,EDS 115,A00,507243,Choi; Bailey Miyeon,7,0,28,21
1715623753209,EDS 117,A01,494379,Staff,0,6,34,34
1715623754238,EDS 125,A00,507246,Hopkins; Megan Beth,8,0,30,22
1715623755263,EDS 128A,A01,507264,Fargason; Sharon Gayle,6,0,26,20
1715623756290,EDS 128B,A01,507293,Pappas; Elizabeth,10,0,30,20
1715623757318,EDS 139,A00,507294,Fargason; Sharon Gayle,10,0,30,20
1715623757318,EDS 139,B00,507313,Pappas; Elizabeth,11,0,30,19
1715623758342,EDS 201,A00,507315,Staff,10,0,30,20
1715623759368,EDS 203,A01,507317,Halter; Christopher P.,10,0,30,20
1715623760397,EDS 204R,A01,507319,Halter; Christopher P.,0,3,30,30
1715623760397,EDS 204R,B01,507331,Heinzman; Erica M.,14,0,30,16
1715623761477,EDS 206R,A00,507332,Staff,0,4,30,30
1715623761477,EDS 206R,B00,507343,Staff,15,0,30,15
1715623762502,EDS 250,A00,507344,Hemans; Patricia Ann Benitez,20,0,40,20
1715623763531,EDS 281,A00,507345,Daly; Alan J.,18,0,18,0
1715623764560,EDS 284,A00,507350,Daly; Alan J.,16,0,16,0
1715623765587,EDS 286,A00,507359,Fine; Sarah,18,0,18,0
1715623766615,EDS 289C,A01,507361,Daly; Alan J.,18,0,18,0
1715623767641,EDS 290,A00,507366,Hofstetter; Carolyn,15,0,15,0
1715623768667,LIGM 5A,A00,507421,Fischer-Grunski; Eva K,17,0,20,3
1715623769694,LIGM 5B,A00,507423,Fischer-Grunski; Eva K,19,0,20,1
1715623770720,LIGM 5C,A00,507425,Fischer-Grunski; Eva K,19,0,20,1
1715623771749,LIIT 5AS,A00,507427,Carnelos; Chiara,20,0,20,0
1715623772775,LIIT 5BS,A00,507430,Carnelos; Chiara,20,0,20,0
1715623773803,LIIT 5CS,A00,507432,Carnelos; Chiara,20,0,20,0
1715623774830,LISP 5A,A00,507541,Munoz Sanchez; Alicia,11,0,20,9
1715623775859,LISP 5B,A00,507671,Munoz Sanchez; Alicia,9,0,20,11
1715623776888,LISP 5C,A00,507696,Munoz Sanchez; Alicia,9,0,20,11
1715623777912,MAE 197,001,528363,Boechler; Nicholas Sebastia,9998,0,9999,1
1715623778946,MATH 197,001,523477,Kedlaya; Kiran S.,9994,0,9999,5
1715623778946,MATH 197,002,563811,Zhang; Danna,9994,0,9999,5
1715623778946,MATH 197,003,628552,Dumitriu; Ioana,9998,0,9999,1
1715623778946,MATH 197,004,660885,Floyd; Eric,9998,0,9999,1
1715623779975,MCWP 40R,A00,518780,Staff,2,0,20,18
1715623779975,MCWP 40R,B00,518781,Staff,11,0,20,9
1715623779975,MCWP 40R,C00,518783,Staff,5,0,20,15
1715623781005,MCWP 50R,A00,518791,Staff,0,1,20,20
1715623781005,MCWP 50R,B00,518792,Staff,0,2,20,20
1715623781005,MCWP 50R,C00,518793,Staff,0,4,20,20
1715623781005,MCWP 50R,D00,518794,Staff,0,1,20,20
1715623781005,MCWP 50R,E00,518795,Staff,0,2,20,20
1715623781005,MCWP 50R,F00,518796,Staff,0,1,20,20
1715623781005,MCWP 50R,G00,518797,Staff,0,1,20,20
1715623782036,MMW 12R,A01,514034,Herbst; Matthew,0,2,16,16
1715623782036,MMW 12R,A02,514035,Herbst; Matthew,0,0,16,16
1715623783062,MMW 13R,A01,514037,Staff,0,5,16,16
1715623783062,MMW 13R,A02,514039,Staff,0,5,16,16
1715623783062,MMW 13R,A03,628519,Staff,0,4,16,16
1715623785115,SIO 295LS,A00,523233,Staff,10,0,30,20
1715623786141,SIO 295S,A00,523232,Staff,10,0,30,20
1715623787171,SIOC 290S,A01,637330,Merrifield; Mark A,23,0,30,7
1715623788198,SIOC 291S,A01,637333,Gabriel; Corey John,23,0,30,7
1715623789225,SOCI 117,A01,494376,Staff,0,5,5,5
1715623790250,WES 237B,A00,494380,Staff,10,0,20,10
1715623792314,AESE 279B,A00,494370,Wade; Jon P,0,0,33,33
1715623793342,AIP 97,001,660915,Van Den Einde; Yael Dahlia,9998,0,9999,1
1715623794370,AIP 197,001,627712,Vespa; Emanuel Ignacio,9995,0,9999,4
1715623794370,AIP 197,002,650778,Amir; On,9998,0,9999,1
1715623794370,AIP 197,003,650933,Avenancio-Leon; Carlos,9998,0,9999,1
1715623794370,AIP 197,004,658530,Heyman; Gail D.,9998,0,9999,1
1715623794370,AIP 197,005,658631,Neal; Sonya E,9998,0,9999,1
1715623794370,AIP 197,006,658671,Du; Songzi,9998,0,9999,1
1715623795399,ANAR 135S,A00,494369,Braswell; Geoffrey E.,0,0,0,0
1715623796426,BENG 196,001,628496,Engler; Adam J.,9998,0,9999,1
1715623796426,BENG 196,002,660916,Watson; John Thomas,9999,0,9999,0
1715623797450,BISP 197,001,650773,Wilhelm; James E.,9994,0,9999,5
1715623797450,BISP 197,002,658904,Coleman; Aaron B.,9998,0,9999,1
1715623798480,CAT 124RS,A01,519847,Geibel; William,0,0,20,20
1715623799506,CAT 125RS,A01,515971,Geibel; William,0,0,20,20
1715623800531,CLRE 250,A00,511389,Morris; Sheldon,9992,0,9999,7
1715623801565,CLRE 251,A00,507176,Mehta; Ravindra L.,9992,0,9999,7
1715623801565,CLRE 251,B00,511410,Mehta; Ravindra L.,9998,0,9999,1
1715623802590,CLRE 252,A00,507189,Cuomo; Raphael Eduardo,9994,0,9999,5
1715623803615,CLRE 253,A00,507199,Vaida; Florin,9994,0,9999,5
1715623803615,CLRE 253,B00,507202,Vaida; Florin,9999,0,9999,0
1715623804642,CLRE 259,A00,507211,Patel; Hemal,9996,0,9999,3
1715623805667,CLRE 260,A00,507221,Cuomo; Raphael Eduardo,9999,0,9999,0
1715623806691,CLRE 297,001,507242,Cuomo; Raphael Eduardo,9999,0,9999,0
1715623807717,COGS 197,001,638244,Voytek; Bradley Thomas,9997,0,9999,2
1715623808741,CSE 191,A00,516875,Minnes Kemp; Mor Mia,9991,0,9999,8
1715623809768,CSE 197,001,637388,Minnes Kemp; Mor Mia,9992,0,9999,7
1715623810793,CSS 201S,A01,494383,Mignozzetti; Umberto,35,0,35,0
1715623811822,CSS 202S,A01,494387,Mignozzetti; Umberto,35,0,35,0
1715623812847,DSC 197,001,628532,Eldridge; Justin Matthew,9995,0,9999,4
1715623813883,EAP 100,A00,516065,Staff,9799,0,9999,200
1715623814911,ECE 45,A01,507414,Staff,31,0,60,29
1715623816965,ECE 111,A01,507420,Staff,11,0,50,39
1715623817990,ECE 197,001,548057,Sievenpiper; Daniel F.,9991,0,9999,8
1715623819018,EDS 115,A00,507243,Choi; Bailey Miyeon,7,0,28,21
1715623820043,EDS 117,A01,494379,Staff,0,6,34,34
1715623821068,EDS 125,A00,507246,Hopkins; Megan Beth,8,0,30,22
1715623822095,EDS 128A,A01,507264,Fargason; Sharon Gayle,6,0,26,20
1715623823119,EDS 128B,A01,507293,Pappas; Elizabeth,10,0,30,20
1715623824147,EDS 139,A00,507294,Fargason; Sharon Gayle,10,0,30,20
1715623824147,EDS 139,B00,507313,Pappas; Elizabeth,11,0,30,19
1715623825172,EDS 201,A00,507315,Staff,10,0,30,20
1715623826197,EDS 203,A01,507317,Halter; Christopher P.,10,0,30,20
1715623827238,EDS 204R,A01,507319,Halter; Christopher P.,0,3,30,30
1715623827238,EDS 204R,B01,507331,Heinzman; Erica M.,14,0,30,16
1715623828263,EDS 206R,A00,507332,Staff,0,4,30,30
1715623828263,EDS 206R,B00,507343,Staff,15,0,30,15
1715623829289,EDS 250,A00,507344,Hemans; Patricia Ann Benitez,20,0,40,20
1715623830315,EDS 281,A00,507345,Daly; Alan J.,18,0,18,0
1715623831341,EDS 284,A00,507350,Daly; Alan J.,16,0,16,0
1715623832369,EDS 286,A00,507359,Fine; Sarah,18,0,18,0
1715623833397,EDS 289C,A01,507361,Daly; Alan J.,18,0,18,0
1715623834423,EDS 290,A00,507366,Hofstetter; Carolyn,15,0,15,0
1715623835450,LIGM 5A,A00,507421,Fischer-Grunski; Eva K,17,0,20,3
1715623836480,LIGM 5B,A00,507423,Fischer-Grunski; Eva K,19,0,20,1
1715623837506,LIGM 5C,A00,507425,Fischer-Grunski; Eva K,19,0,20,1
1715623838531,LIIT 5AS,A00,507427,Carnelos; Chiara,20,0,20,0
1715623839560,LIIT 5BS,A00,507430,Carnelos; Chiara,20,0,20,0
1715623840586,LIIT 5CS,A00,507432,Carnelos; Chiara,20,0,20,0
1715623841617,LISP 5A,A00,507541,Munoz Sanchez; Alicia,11,0,20,9
1715623842647,LISP 5B,A00,507671,Munoz Sanchez; Alicia,9,0,20,11
1715623843673,LISP 5C,A00,507696,Munoz Sanchez; Alicia,9,0,20,11
1715623844699,MAE 197,001,528363,Boechler; Nicholas Sebastia,9998,0,9999,1
1715623845725,MATH 197,001,523477,Kedlaya; Kiran S.,9994,0,9999,5
1715623845725,MATH 197,002,563811,Zhang; Danna,9994,0,9999,5
1715623845725,MATH 197,003,628552,Dumitriu; Ioana,9998,0,9999,1
1715623845725,MATH 197,004,660885,Floyd; Eric,9998,0,9999,1
1715623846749,MCWP 40R,A00,518780,Staff,2,0,20,18
1715623846749,MCWP 40R,B00,518781,Staff,11,0,20,9
1715623846749,MCWP 40R,C00,518783,Staff,5,0,20,15
1715623847776,MCWP 50R,A00,518791,Staff,0,1,20,20
1715623847776,MCWP 50R,B00,518792,Staff,0,2,20,20
1715623847776,MCWP 50R,C00,518793,Staff,0,4,20,20
1715623847776,MCWP 50R,D00,518794,Staff,0,1,20,20
1715623847776,MCWP 50R,E00,518795,Staff,0,2,20,20
1715623847776,MCWP 50R,F00,518796,Staff,0,1,20,20
1715623847776,MCWP 50R,G00,518797,Staff,0,1,20,20
1715623848805,MMW 12R,A01,514034,Herbst; Matthew,0,2,16,16
1715623848805,MMW 12R,A02,514035,Herbst; Matthew,0,0,16,16
1715623849828,MMW 13R,A01,514037,Staff,0,5,16,16
1715623849828,MMW 13R,A02,514039,Staff,0,5,16,16
1715623849828,MMW 13R,A03,628519,Staff,0,4,16,16
1715623851880,SIO 295LS,A00,523233,Staff,10,0,30,20
1715623852909,SIO 295S,A00,523232,Staff,10,0,30,20
1715623853939,SIOC 290S,A01,637330,Merrifield; Mark A,23,0,30,7
1715623854965,SIOC 291S,A01,637333,Gabriel; Corey John,23,0,30,7
1715623855991,SOCI 117,A01,494376,Staff,0,5,5,5
1715623857018,WES 237B,A00,494380,Staff,10,0,20,10
1715623859088,AESE 279B,A00,494370,Wade; Jon P,0,0,33,33
1715623860115,AIP 97,001,660915,Van Den Einde; Yael Dahlia,9998,0,9999,1
1715623861147,AIP 197,001,627712,Vespa; Emanuel Ignacio,9995,0,9999,4
1715623861147,AIP 197,002,650778,Amir; On,9998,0,9999,1
1715623861147,AIP 197,003,650933,Avenancio-Leon; Carlos,9998,0,9999,1
1715623861147,AIP 197,004,658530,Heyman; Gail D.,9998,0,9999,1
1715623861147,AIP 197,005,658631,Neal; Sonya E,9998,0,9999,1
1715623861147,AIP 197,006,658671,Du; Songzi,9998,0,9999,1
1715623862176,ANAR 135S,A00,494369,Braswell; Geoffrey E.,0,0,0,0
1715623863201,BENG 196,001,628496,Engler; Adam J.,9998,0,9999,1
1715623863201,BENG 196,002,660916,Watson; John Thomas,9999,0,9999,0
1715623864227,BISP 197,001,650773,Wilhelm; James E.,9994,0,9999,5
1715623864227,BISP 197,002,658904,Coleman; Aaron B.,9998,0,9999,1
1715623865256,CAT 124RS,A01,519847,Geibel; William,0,0,20,20
1715623866280,CAT 125RS,A01,515971,Geibel; William,0,0,20,20
1715623867310,CLRE 250,A00,511389,Morris; Sheldon,9992,0,9999,7
1715623868340,CLRE 251,A00,507176,Mehta; Ravindra L.,9992,0,9999,7
1715623868340,CLRE 251,B00,511410,Mehta; Ravindra L.,9998,0,9999,1
1715623869367,CLRE 252,A00,507189,Cuomo; Raphael Eduardo,9994,0,9999,5
1715623870397,CLRE 253,A00,507199,Vaida; Florin,9994,0,9999,5
1715623870397,CLRE 253,B00,507202,Vaida; Florin,9999,0,9999,0
1715623871426,CLRE 259,A00,507211,Patel; Hemal,9996,0,9999,3
1715623872452,CLRE 260,A00,507221,Cuomo; Raphael Eduardo,9999,0,9999,0
1715623873481,CLRE 297,001,507242,Cuomo; Raphael Eduardo,9999,0,9999,0
1715623874506,COGS 197,001,638244,Voytek; Bradley Thomas,9997,0,9999,2
1715623875532,CSE 191,A00,516875,Minnes Kemp; Mor Mia,9991,0,9999,8
1715623876560,CSE 197,001,637388,Minnes Kemp; Mor Mia,9992,0,9999,7
1715623877588,CSS 201S,A01,494383,Mignozzetti; Umberto,35,0,35,0
1715623878619,CSS 202S,A01,494387,Mignozzetti; Umberto,35,0,35,0
1715623879644,DSC 197,001,628532,Eldridge; Justin Matthew,9995,0,9999,4
1715623880671,EAP 100,A00,516065,Staff,9799,0,9999,200
1715623881699,ECE 45,A01,507414,Staff,31,0,60,29
1715623883754,ECE 111,A01,507420,Staff,11,0,50,39
1715623884781,ECE 197,001,548057,Sievenpiper; Daniel F.,9991,0,9999,8
1715623885810,EDS 115,A00,507243,Choi; Bailey Miyeon,7,0,28,21
1715623886838,EDS 117,A01,494379,Staff,0,6,34,34
1715623887867,EDS 125,A00,507246,Hopkins; Megan Beth,8,0,30,22
1715623888894,EDS 128A,A01,507264,Fargason; Sharon Gayle,6,0,26,20
1715623889924,EDS 128B,A01,507293,Pappas; Elizabeth,10,0,30,20
1715623890949,EDS 139,A00,507294,Fargason; Sharon Gayle,10,0,30,20
1715623890949,EDS 139,B00,507313,Pappas; Elizabeth,11,0,30,19
1715623891974,EDS 201,A00,507315,Staff,10,0,30,20
1715623893001,EDS 203,A01,507317,Halter; Christopher P.,10,0,30,20
1715623894026,EDS 204R,A01,507319,Halter; Christopher P.,0,3,30,30
1715623894026,EDS 204R,B01,507331,Heinzman; Erica M.,14,0,30,16
1715623895055,EDS 206R,A00,507332,Staff,0,4,30,30
1715623895055,EDS 206R,B00,507343,Staff,15,0,30,15
1715623896081,EDS 250,A00,507344,Hemans; Patricia Ann Benitez,20,0,40,20
1715623897107,EDS 281,A00,507345,Daly; Alan J.,18,0,18,0
1715623898133,EDS 284,A00,507350,Daly; Alan J.,16,0,16,0
1715623899160,EDS 286,A00,507359,Fine; Sarah,18,0,18,0
1715623900186,EDS 289C,A01,507361,Daly; Alan J.,18,0,18,0
1715623901211,EDS 290,A00,507366,Hofstetter; Carolyn,15,0,15,0
1715623902240,LIGM 5A,A00,507421,Fischer-Grunski; Eva K,17,0,20,3
1715623903269,LIGM 5B,A00,507423,Fischer-Grunski; Eva K,19,0,20,1
1715623904298,LIGM 5C,A00,507425,Fischer-Grunski; Eva K,19,0,20,1
1715623905329,LIIT 5AS,A00,507427,Carnelos; Chiara,20,0,20,0
1715623906358,LIIT 5BS,A00,507430,Carnelos; Chiara,20,0,20,0
1715623907382,LIIT 5CS,A00,507432,Carnelos; Chiara,20,0,20,0
1715623908411,LISP 5A,A00,507541,Munoz Sanchez; Alicia,11,0,20,9
1715623909439,LISP 5B,A00,507671,Munoz Sanchez; Alicia,9,0,20,11
1715623910463,LISP 5C,A00,507696,Munoz Sanchez; Alicia,9,0,20,11
1715623911491,MAE 197,001,528363,Boechler; Nicholas Sebastia,9998,0,9999,1
1715623912521,MATH 197,001,523477,Kedlaya; Kiran S.,9994,0,9999,5
1715623912521,MATH 197,002,563811,Zhang; Danna,9994,0,9999,5
1715623912521,MATH 197,003,628552,Dumitriu; Ioana,9998,0,9999,1
1715623912521,MATH 197,004,660885,Floyd; Eric,9998,0,9999,1
1715623913556,MCWP 40R,A00,518780,Staff,2,0,20,18
1715623913556,MCWP 40R,B00,518781,Staff,11,0,20,9
1715623913556,MCWP 40R,C00,518783,Staff,5,0,20,15
1715623914587,MCWP 50R,A00,518791,Staff,0,1,20,20
1715623914587,MCWP 50R,B00,518792,Staff,0,2,20,20
1715623914587,MCWP 50R,C00,518793,Staff,0,4,20,20
1715623914587,MCWP 50R,D00,518794,Staff,0,1,20,20
1715623914587,MCWP 50R,E00,518795,Staff,0,2,20,20
1715623914587,MCWP 50R,F00,518796,Staff,0,1,20,20
1715623914587,MCWP 50R,G00,518797,Staff,0,1,20,20
1715623915613,MMW 12R,A01,514034,Herbst; Matthew,0,2,16,16
1715623915613,MMW 12R,A02,514035,Herbst; Matthew,0,0,16,16
1715623916638,MMW 13R,A01,514037,Staff,0,5,16,16
1715623916638,MMW 13R,A02,514039,Staff,0,5,16,16
1715623916638,MMW 13R,A03,628519,Staff,0,4,16,16
1715623918692,SIO 295LS,A00,523233,Staff,10,0,30,20
1715623919719,SIO 295S,A00,523232,Staff,10,0,30,20
1715623920744,SIOC 290S,A01,637330,Merrifield; Mark A,23,0,30,7
1715623921770,SIOC 291S,A01,637333,Gabriel; Corey John,23,0,30,7
1715623922799,SOCI 117,A01,494376,Staff,0,5,5,5
1715623923824,WES 237B,A00,494380,Staff,10,0,20,10
1715623925900,AESE 279B,A00,494370,Wade; Jon P,0,0,33,33
1715623926928,AIP 97,001,660915,Van Den Einde; Yael Dahlia,9998,0,9999,1
1715623927954,AIP 197,001,627712,Vespa; Emanuel Ignacio,9995,0,9999,4
1715623927954,AIP 197,002,650778,Amir; On,9998,0,9999,1
1715623927954,AIP 197,003,650933,Avenancio-Leon; Carlos,9998,0,9999,1
1715623927954,AIP 197,004,658530,Heyman; Gail D.,9998,0,9999,1
1715623927954,AIP 197,005,658631,Neal; Sonya E,9998,0,9999,1
1715623927954,AIP 197,006,658671,Du; Songzi,9998,0,9999,1
1715623928979,ANAR 135S,A00,494369,Braswell; Geoffrey E.,0,0,0,0
1715623930006,BENG 196,001,628496,Engler; Adam J.,9998,0,9999,1
1715623930006,BENG 196,002,660916,Watson; John Thomas,9999,0,9999,0
1715623931031,BISP 197,001,650773,Wilhelm; James E.,9994,0,9999,5
1715623931031,BISP 197,002,658904,Coleman; Aaron B.,9998,0,9999,1
1715623932057,CAT 124RS,A01,519847,Geibel; William,0,0,20,20
1715623933083,CAT 125RS,A01,515971,Geibel; William,0,0,20,20
1715623934108,CLRE 250,A00,511389,Morris; Sheldon,9992,0,9999,7
1715623935138,CLRE 251,A00,507176,Mehta; Ravindra L.,9992,0,9999,7
1715623935138,CLRE 251,B00,511410,Mehta; Ravindra L.,9998,0,9999,1
1715623936168,CLRE 252,A00,507189,Cuomo; Raphael Eduardo,9994,0,9999,5
1715623937195,CLRE 253,A00,507199,Vaida; Florin,9994,0,9999,5
1715623937195,CLRE 253,B00,507202,Vaida; Florin,9999,0,9999,0
1715623938223,CLRE 259,A00,507211,Patel; Hemal,9996,0,9999,3
1715623939251,CLRE 260,A00,507221,Cuomo; Raphael Eduardo,9999,0,9999,0
1715623940277,CLRE 297,001,507242,Cuomo; Raphael Eduardo,9999,0,9999,0
1715623941305,COGS 197,001,638244,Voytek; Bradley Thomas,9997,0,9999,2
1715623942332,CSE 191,A00,516875,Minnes Kemp; Mor Mia,9991,0,9999,8
1715623943358,CSE 197,001,637388,Minnes Kemp; Mor Mia,9992,0,9999,7
1715623944389,CSS 201S,A01,494383,Mignozzetti; Umberto,35,0,35,0
1715623945415,CSS 202S,A01,494387,Mignozzetti; Umberto,35,0,35,0
1715623946442,DSC 197,001,628532,Eldridge; Justin Matthew,9995,0,9999,4
1715623947472,EAP 100,A00,516065,Staff,9799,0,9999,200
1715623948498,ECE 45,A01,507414,Staff,31,0,60,29
1715623950552,ECE 111,A01,507420,Staff,11,0,50,39
1715623951576,ECE 197,001,548057,Sievenpiper; Daniel F.,9991,0,9999,8
1715623952605,EDS 115,A00,507243,Choi; Bailey Miyeon,7,0,28,21
1715623953631,EDS 117,A01,494379,Staff,0,6,34,34
1715623954659,EDS 125,A00,507246,Hopkins; Megan Beth,8,0,30,22
1715623955688,EDS 128A,A01,507264,Fargason; Sharon Gayle,6,0,26,20
1715623956717,EDS 128B,A01,507293,Pappas; Elizabeth,10,0,30,20
1715623957744,EDS 139,A00,507294,Fargason; Sharon Gayle,10,0,30,20
1715623957744,EDS 139,B00,507313,Pappas; Elizabeth,11,0,30,19
1715623958772,EDS 201,A00,507315,Staff,10,0,30,20
1715623959917,EDS 203,A01,507317,Halter; Christopher P.,10,0,30,20
1715623960942,EDS 204R,A01,507319,Halter; Christopher P.,0,3,30,30
1715623960942,EDS 204R,B01,507331,Heinzman; Erica M.,14,0,30,16
1715623961968,EDS 206R,A00,507332,Staff,0,4,30,30
1715623961968,EDS 206R,B00,507343,Staff,15,0,30,15
1715623962993,EDS 250,A00,507344,Hemans; Patricia Ann Benitez,20,0,40,20
1715623964020,EDS 281,A00,507345,Daly; Alan J.,18,0,18,0
1715623965045,EDS 284,A00,507350,Daly; Alan J.,16,0,16,0
1715623966073,EDS 286,A00,507359,Fine; Sarah,18,0,18,0
1715623967098,EDS 289C,A01,507361,Daly; Alan J.,18,0,18,0
1715623968123,EDS 290,A00,507366,Hofstetter; Carolyn,15,0,15,0
1715623969152,LIGM 5A,A00,507421,Fischer-Grunski; Eva K,17,0,20,3
1715623970178,LIGM 5B,A00,507423,Fischer-Grunski; Eva K,19,0,20,1
1715623971207,LIGM 5C,A00,507425,Fischer-Grunski; Eva K,19,0,20,1
1715623972234,LIIT 5AS,A00,507427,Carnelos; Chiara,20,0,20,0
1715623973262,LIIT 5BS,A00,507430,Carnelos; Chiara,20,0,20,0
1715623974289,LIIT 5CS,A00,507432,Carnelos; Chiara,20,0,20,0
1715623975315,LISP 5A,A00,507541,Munoz Sanchez; Alicia,11,0,20,9
1715623976341,LISP 5B,A00,507671,Munoz Sanchez; Alicia,9,0,20,11
1715623977371,LISP 5C,A00,507696,Munoz Sanchez; Alicia,9,0,20,11
1715623978396,MAE 197,001,528363,Boechler; Nicholas Sebastia,9998,0,9999,1
1715623979423,MATH 197,001,523477,Kedlaya; Kiran S.,9994,0,9999,5
1715623979423,MATH 197,002,563811,Zhang; Danna,9994,0,9999,5
1715623979423,MATH 197,003,628552,Dumitriu; Ioana,9998,0,9999,1
1715623979423,MATH 197,004,660885,Floyd; Eric,9998,0,9999,1
1715623980449,MCWP 40R,A00,518780,Staff,2,0,20,18
1715623980449,MCWP 40R,B00,518781,Staff,11,0,20,9
1715623980449,MCWP 40R,C00,518783,Staff,5,0,20,15
1715623981480,MCWP 50R,A00,518791,Staff,0,1,20,20
1715623981480,MCWP 50R,B00,518792,Staff,0,2,20,20
1715623981480,MCWP 50R,C00,518793,Staff,0,4,20,20
1715623981480,MCWP 50R,D00,518794,Staff,0,1,20,20
1715623981480,MCWP 50R,E00,518795,Staff,0,2,20,20
1715623981480,MCWP 50R,F00,518796,Staff,0,1,20,20
1715623981480,MCWP 50R,G00,518797,Staff,0,1,20,20
1715623982506,MMW 12R,A01,514034,Herbst; Matthew,0,2,16,16
1715623982506,MMW 12R,A02,514035,Herbst; Matthew,0,0,16,16
1715623983532,MMW 13R,A01,514037,Staff,0,5,16,16
1715623983532,MMW 13R,A02,514039,Staff,0,5,16,16
1715623983532,MMW 13R,A03,628519,Staff,0,4,16,16
1715623985583,SIO 295LS,A00,523233,Staff,10,0,30,20
1715623986611,SIO 295S,A00,523232,Staff,10,0,30,20
1715623987645,SIOC 290S,A01,637330,Merrifield; Mark A,23,0,30,7
1715623988677,SIOC 291S,A01,637333,Gabriel; Corey John,23,0,30,7
1715623989707,SOCI 117,A01,494376,Staff,0,5,5,5
1715623990734,WES 237B,A00,494380,Staff,10,0,20,10
1715623992805,AESE 279B,A00,494370,Wade; Jon P,0,0,33,33
1715623993833,AIP 97,001,660915,Van Den Einde; Yael Dahlia,9998,0,9999,1
1715623994865,AIP 197,001,627712,Vespa; Emanuel Ignacio,9995,0,9999,4
1715623994865,AIP 197,002,650778,Amir; On,9998,0,9999,1
1715623994865,AIP 197,003,650933,Avenancio-Leon; Carlos,9998,0,9999,1
1715623994865,AIP 197,004,658530,Heyman; Gail D.,9998,0,9999,1
1715623994865,AIP 197,005,658631,Neal; Sonya E,9998,0,9999,1
1715623994865,AIP 197,006,658671,Du; Songzi,9998,0,9999,1
1715623995895,ANAR 135S,A00,494369,Braswell; Geoffrey E.,0,0,0,0
1715623996921,BENG 196,001,628496,Engler; Adam J.,9998,0,9999,1
1715623996921,BENG 196,002,660916,Watson; John Thomas,9999,0,9999,0
1715623997950,BISP 197,001,650773,Wilhelm; James E.,9994,0,9999,5
1715623997950,BISP 197,002,658904,Coleman; Aaron B.,9998,0,9999,1
1715623998981,CAT 124RS,A01,519847,Geibel; William,0,0,20,20
1715624000007,CAT 125RS,A01,515971,Geibel; William,0,0,20,20
1715624001034,CLRE 250,A00,511389,Morris; Sheldon,9992,0,9999,7
1715624002066,CLRE 251,A00,507176,Mehta; Ravindra L.,9992,0,9999,7
1715624002066,CLRE 251,B00,511410,Mehta; Ravindra L.,9998,0,9999,1
1715624003092,CLRE 252,A00,507189,Cuomo; Raphael Eduardo,9994,0,9999,5
1715624004119,CLRE 253,A00,507199,Vaida; Florin,9994,0,9999,5
1715624004119,CLRE 253,B00,507202,Vaida; Florin,9999,0,9999,0
1715624005147,CLRE 259,A00,507211,Patel; Hemal,9996,0,9999,3
1715624006172,CLRE 260,A00,507221,Cuomo; Raphael Eduardo,9999,0,9999,0
1715624007199,CLRE 297,001,507242,Cuomo; Raphael Eduardo,9999,0,9999,0
1715624008227,COGS 197,001,638244,Voytek; Bradley Thomas,9997,0,9999,2
1715624009257,CSE 191,A00,516875,Minnes Kemp; Mor Mia,9991,0,9999,8
1715624010282,CSE 197,001,637388,Minnes Kemp; Mor Mia,9992,0,9999,7
1715624011310,CSS 201S,A01,494383,Mignozzetti; Umberto,35,0,35,0
1715624012343,CSS 202S,A01,494387,Mignozzetti; Umberto,35,0,35,0
1715624013377,DSC 197,001,628532,Eldridge; Justin Matthew,9995,0,9999,4
1715624014404,EAP 100,A00,516065,Staff,9799,0,9999,200
1715624015436,ECE 45,A01,507414,Staff,31,0,60,29
1715624017489,ECE 111,A01,507420,Staff,11,0,50,39
1715624018514,ECE 197,001,548057,Sievenpiper; Daniel F.,9991,0,9999,8
1715624019541,EDS 115,A00,507243,Choi; Bailey Miyeon,7,0,28,21
1715624020571,EDS 117,A01,494379,Staff,0,6,34,34
1715624021597,EDS 125,A00,507246,Hopkins; Megan Beth,8,0,30,22
1715624022624,EDS 128A,A01,507264,Fargason; Sharon Gayle,6,0,26,20
1715624023650,EDS 128B,A01,507293,Pappas; Elizabeth,10,0,30,20
1715624024676,EDS 139,A00,507294,Fargason; Sharon Gayle,10,0,30,20
1715624024676,EDS 139,B00,507313,Pappas; Elizabeth,11,0,30,19
1715624025702,EDS 201,A00,507315,Staff,10,0,30,20
1715624026728,EDS 203,A01,507317,Halter; Christopher P.,10,0,30,20
1715624027754,EDS 204R,A01,507319,Halter; Christopher P.,0,3,30,30
1715624027754,EDS 204R,B01,507331,Heinzman; Erica M.,14,0,30,16
1715624028779,EDS 206R,A00,507332,Staff,0,4,30,30
1715624028779,EDS 206R,B00,507343,Staff,15,0,30,15
1715624029803,EDS 250,A00,507344,Hemans; Patricia Ann Benitez,20,0,40,20
1715624030829,EDS 281,A00,507345,Daly; Alan J.,18,0,18,0
1715624031854,EDS 284,A00,507350,Daly; Alan J.,16,0,16,0
1715624032880,EDS 286,A00,507359,Fine; Sarah,18,0,18,0
1715624033904,EDS 289C,A01,507361,Daly; Alan J.,18,0,18,0
1715624034930,EDS 290,A00,507366,Hofstetter; Carolyn,15,0,15,0
1715624035958,LIGM 5A,A00,507421,Fischer-Grunski; Eva K,17,0,20,3
1715624036988,LIGM 5B,A00,507423,Fischer-Grunski; Eva K,19,0,20,1
1715624038018,LIGM 5C,A00,507425,Fischer-Grunski; Eva K,19,0,20,1
1715624039045,LIIT 5AS,A00,507427,Carnelos; Chiara,20,0,20,0
1715624040074,LIIT 5BS,A00,507430,Carnelos; Chiara,20,0,20,0
1715624041101,LIIT 5CS,A00,507432,Carnelos; Chiara,20,0,20,0
1715624042126,LISP 5A,A00,507541,Munoz Sanchez; Alicia,11,0,20,9
1715624043153,LISP 5B,A00,507671,Munoz Sanchez; Alicia,9,0,20,11
1715624044178,LISP 5C,A00,507696,Munoz Sanchez; Alicia,9,0,20,11
1715624045203,MAE 197,001,528363,Boechler; Nicholas Sebastia,9998,0,9999,1
1715624046233,MATH 197,001,523477,Kedlaya; Kiran S.,9994,0,9999,5
1715624046233,MATH 197,002,563811,Zhang; Danna,9994,0,9999,5
1715624046233,MATH 197,003,628552,Dumitriu; Ioana,9998,0,9999,1
1715624046233,MATH 197,004,660885,Floyd; Eric,9998,0,9999,1
1715624047261,MCWP 40R,A00,518780,Staff,2,0,20,18
1715624047261,MCWP 40R,B00,518781,Staff,11,0,20,9
1715624047261,MCWP 40R,C00,518783,Staff,5,0,20,15
1715624048287,MCWP 50R,A00,518791,Staff,0,1,20,20
1715624048287,MCWP 50R,B00,518792,Staff,0,2,20,20
1715624048287,MCWP 50R,C00,518793,Staff,0,4,20,20
1715624048287,MCWP 50R,D00,518794,Staff,0,1,20,20
1715624048287,MCWP 50R,E00,518795,Staff,0,2,20,20
1715624048287,MCWP 50R,F00,518796,Staff,0,1,20,20
1715624048287,MCWP 50R,G00,518797,Staff,0,1,20,20
1715624049312,MMW 12R,A01,514034,Herbst; Matthew,0,2,16,16
1715624049312,MMW 12R,A02,514035,Herbst; Matthew,0,0,16,16
1715624050340,MMW 13R,A01,514037,Staff,0,5,16,16
1715624050340,MMW 13R,A02,514039,Staff,0,5,16,16
1715624050340,MMW 13R,A03,628519,Staff,0,4,16,16
1715624052390,SIO 295LS,A00,523233,Staff,10,0,30,20
1715624053418,SIO 295S,A00,523232,Staff,10,0,30,20
1715624054446,SIOC 290S,A01,637330,Merrifield; Mark A,23,0,30,7
1715624055477,SIOC 291S,A01,637333,Gabriel; Corey John,23,0,30,7
1715624056505,SOCI 117,A01,494376,Staff,0,5,5,5
1715624057532,WES 237B,A00,494380,Staff,10,0,20,10
1715624059610,AESE 279B,A00,494370,Wade; Jon P,0,0,33,33
1715624060637,AIP 97,001,660915,Van Den Einde; Yael Dahlia,9998,0,9999,1
1715624061665,AIP 197,001,627712,Vespa; Emanuel Ignacio,9995,0,9999,4
1715624061665,AIP 197,002,650778,Amir; On,9998,0,9999,1
1715624061665,AIP 197,003,650933,Avenancio-Leon; Carlos,9998,0,9999,1
1715624061665,AIP 197,004,658530,Heyman; Gail D.,9998,0,9999,1
1715624061665,AIP 197,005,658631,Neal; Sonya E,9998,0,9999,1
1715624061665,AIP 197,006,658671,Du; Songzi,9998,0,9999,1
1715624062690,ANAR 135S,A00,494369,Braswell; Geoffrey E.,0,0,0,0
1715624063716,BENG 196,001,628496,Engler; Adam J.,9998,0,9999,1
1715624063716,BENG 196,002,660916,Watson; John Thomas,9999,0,9999,0
1715624064745,BISP 197,001,650773,Wilhelm; James E.,9994,0,9999,5
1715624064745,BISP 197,002,658904,Coleman; Aaron B.,9998,0,9999,1
1715624065770,CAT 124RS,A01,519847,Geibel; William,0,0,20,20
1715624066799,CAT 125RS,A01,515971,Geibel; William,0,0,20,20
1715624067829,CLRE 250,A00,511389,Morris; Sheldon,9992,0,9999,7
1715624068856,CLRE 251,A00,507176,Mehta; Ravindra L.,9992,0,9999,7
1715624068856,CLRE 251,B00,511410,Mehta; Ravindra L.,9998,0,9999,1
1715624069882,CLRE 252,A00,507189,Cuomo; Raphael Eduardo,9994,0,9999,5
1715624070914,CLRE 253,A00,507199,Vaida; Florin,9994,0,9999,5
1715624070914,CLRE 253,B00,507202,Vaida; Florin,9999,0,9999,0
1715624071939,CLRE 259,A00,507211,Patel; Hemal,9996,0,9999,3
1715624073019,CLRE 260,A00,507221,Cuomo; Raphael Eduardo,9999,0,9999,0
1715624074046,CLRE 297,001,507242,Cuomo; Raphael Eduardo,9999,0,9999,0
1715624075073,COGS 197,001,638244,Voytek; Bradley Thomas,9997,0,9999,2
1715624076100,CSE 191,A00,516875,Minnes Kemp; Mor Mia,9991,0,9999,8
1715624077129,CSE 197,001,637388,Minnes Kemp; Mor Mia,9992,0,9999,7
1715624078157,CSS 201S,A01,494383,Mignozzetti; Umberto,35,0,35,0
1715624079190,CSS 202S,A01,494387,Mignozzetti; Umberto,35,0,35,0
1715624080218,DSC 197,001,628532,Eldridge; Justin Matthew,9995,0,9999,4
1715624081244,EAP 100,A00,516065,Staff,9799,0,9999,200
1715624082276,ECE 45,A01,507414,Staff,31,0,60,29
1715624084323,ECE 111,A01,507420,Staff,11,0,50,39
1715624085351,ECE 197,001,548057,Sievenpiper; Daniel F.,9991,0,9999,8
1715624086376,EDS 115,A00,507243,Choi; Bailey Miyeon,7,0,28,21
1715624087404,EDS 117,A01,494379,Staff,0,6,34,34
1715624088432,EDS 125,A00,507246,Hopkins; Megan Beth,8,0,30,22
1715624089457,EDS 128A,A01,507264,Fargason; Sharon Gayle,6,0,26,20
1715624090483,EDS 128B,A01,507293,Pappas; Elizabeth,10,0,30,20
1715624091507,EDS 139,A00,507294,Fargason; Sharon Gayle,10,0,30,20
1715624091507,EDS 139,B00,507313,Pappas; Elizabeth,11,0,30,19
1715624092531,EDS 201,A00,507315,Staff,10,0,30,20
1715624093556,EDS 203,A01,507317,Halter; Christopher P.,10,0,30,20
1715624094585,EDS 204R,A01,507319,Halter; Christopher P.,0,3,30,30
1715624094585,EDS 204R,B01,507331,Heinzman; Erica M.,14,0,30,16
1715624095614,EDS 206R,A00,507332,Staff,0,4,30,30
1715624095614,EDS 206R,B00,507343,Staff,15,0,30,15
1715624096643,EDS 250,A00,507344,Hemans; Patricia Ann Benitez,20,0,40,20
1715624097667,EDS 281,A00,507345,Daly; Alan J.,18,0,18,0
1715624098693,EDS 284,A00,507350,Daly; Alan J.,16,0,16,0
1715624099722,EDS 286,A00,507359,Fine; Sarah,18,0,18,0
1715624100746,EDS 289C,A01,507361,Daly; Alan J.,18,0,18,0
1715624101773,EDS 290,A00,507366,Hofstetter; Carolyn,15,0,15,0
1715624102798,LIGM 5A,A00,507421,Fischer-Grunski; Eva K,17,0,20,3
1715624103825,LIGM 5B,A00,507423,Fischer-Grunski; Eva K,19,0,20,1
1715624104854,LIGM 5C,A00,507425,Fischer-Grunski; Eva K,19,0,20,1
1715624105879,LIIT 5AS,A00,507427,Carnelos; Chiara,20,0,20,0
1715624106905,LIIT 5BS,A00,507430,Carnelos; Chiara,20,0,20,0
1715624107930,LIIT 5CS,A00,507432,Carnelos; Chiara,20,0,20,0
1715624108954,LISP 5A,A00,507541,Munoz Sanchez; Alicia,11,0,20,9
1715624109982,LISP 5B,A00,507671,Munoz Sanchez; Alicia,9,0,20,11
1715624111007,LISP 5C,A00,507696,Munoz Sanchez; Alicia,9,0,20,11
1715624112034,MAE 197,001,528363,Boechler; Nicholas Sebastia,9998,0,9999,1
1715624113059,MATH 197,001,523477,Kedlaya; Kiran S.,9994,0,9999,5
1715624113059,MATH 197,002,563811,Zhang; Danna,9994,0,9999,5
1715624113059,MATH 197,003,628552,Dumitriu; Ioana,9998,0,9999,1
1715624113059,MATH 197,004,660885,Floyd; Eric,9998,0,9999,1
1715624114085,MCWP 40R,A00,518780,Staff,2,0,20,18
1715624114085,MCWP 40R,B00,518781,Staff,11,0,20,9
1715624114085,MCWP 40R,C00,518783,Staff,5,0,20,15
1715624115111,MCWP 50R,A00,518791,Staff,0,1,20,20
1715624115111,MCWP 50R,B00,518792,Staff,0,2,20,20
1715624115111,MCWP 50R,C00,518793,Staff,0,4,20,20
1715624115111,MCWP 50R,D00,518794,Staff,0,1,20,20
1715624115111,MCWP 50R,E00,518795,Staff,0,2,20,20
1715624115111,MCWP 50R,F00,518796,Staff,0,1,20,20
1715624115111,MCWP 50R,G00,518797,Staff,0,1,20,20
1715624116136,MMW 12R,A01,514034,Herbst; Matthew,0,2,16,16
1715624116136,MMW 12R,A02,514035,Herbst; Matthew,0,0,16,16
1715624117160,MMW 13R,A01,514037,Staff,0,5,16,16
1715624117160,MMW 13R,A02,514039,Staff,0,5,16,16
1715624117160,MMW 13R,A03,628519,Staff,0,4,16,16
1715624119212,SIO 295LS,A00,523233,Staff,10,0,30,20
1715624120240,SIO 295S,A00,523232,Staff,10,0,30,20
1715624121274,SIOC 290S,A01,637330,Merrifield; Mark A,23,0,30,7
1715624122299,SIOC 291S,A01,637333,Gabriel; Corey John,23,0,30,7
1715624123328,SOCI 117,A01,494376,Staff,0,5,5,5
1715624124355,WES 237B,A00,494380,Staff,10,0,20,10
1715624126414,AESE 279B,A00,494370,Wade; Jon P,0,0,33,33
1715624127442,AIP 97,001,660915,Van Den Einde; Yael Dahlia,9998,0,9999,1
1715624128471,AIP 197,001,627712,Vespa; Emanuel Ignacio,9995,0,9999,4
1715624128471,AIP 197,002,650778,Amir; On,9998,0,9999,1
1715624128471,AIP 197,003,650933,Avenancio-Leon; Carlos,9998,0,9999,1
1715624128471,AIP 197,004,658530,Heyman; Gail D.,9998,0,9999,1
1715624128471,AIP 197,005,658631,Neal; Sonya E,9998,0,9999,1
1715624128471,AIP 197,006,658671,Du; Songzi,9998,0,9999,1
1715624129497,ANAR 135S,A00,494369,Braswell; Geoffrey E.,0,0,0,0
1715624130526,BENG 196,001,628496,Engler; Adam J.,9998,0,9999,1
1715624130526,BENG 196,002,660916,Watson; John Thomas,9999,0,9999,0
1715624131553,BISP 197,001,650773,Wilhelm; James E.,9994,0,9999,5
1715624131553,BISP 197,002,658904,Coleman; Aaron B.,9998,0,9999,1
1715624132582,CAT 124RS,A01,519847,Geibel; William,0,0,20,20
1715624133611,CAT 125RS,A01,515971,Geibel; William,0,0,20,20
1715624134638,CLRE 250,A00,511389,Morris; Sheldon,9992,0,9999,7
1715624135666,CLRE 251,A00,507176,Mehta; Ravindra L.,9992,0,9999,7
1715624135666,CLRE 251,B00,511410,Mehta; Ravindra L.,9998,0,9999,1
1715624136694,CLRE 252,A00,507189,Cuomo; Raphael Eduardo,9994,0,9999,5
1715624137719,CLRE 253,A00,507199,Vaida; Florin,9994,0,9999,5
1715624137719,CLRE 253,B00,507202,Vaida; Florin,9999,0,9999,0
1715624138747,CLRE 259,A00,507211,Patel; Hemal,9996,0,9999,3
1715624139772,CLRE 260,A00,507221,Cuomo; Raphael Eduardo,9999,0,9999,0
1715624140796,CLRE 297,001,507242,Cuomo; Raphael Eduardo,9999,0,9999,0
1715624141823,COGS 197,001,638244,Voytek; Bradley Thomas,9997,0,9999,2
1715624142848,CSE 191,A00,516875,Minnes Kemp; Mor Mia,9991,0,9999,8
1715624143929,CSE 197,001,637388,Minnes Kemp; Mor Mia,9992,0,9999,7
1715624144959,CSS 201S,A01,494383,Mignozzetti; Umberto,35,0,35,0
1715624145989,CSS 202S,A01,494387,Mignozzetti; Umberto,35,0,35,0
1715624147016,DSC 197,001,628532,Eldridge; Justin Matthew,9995,0,9999,4
1715624148041,EAP 100,A00,516065,Staff,9799,0,9999,200
1715624149068,ECE 45,A01,507414,Staff,31,0,60,29
1715624151122,ECE 111,A01,507420,Staff,11,0,50,39
1715624152148,ECE 197,001,548057,Sievenpiper; Daniel F.,9991,0,9999,8
1715624153173,EDS 115,A00,507243,Choi; Bailey Miyeon,7,0,28,21
1715624154199,EDS 117,A01,494379,Staff,0,6,34,34
1715624155225,EDS 125,A00,507246,Hopkins; Megan Beth,8,0,30,22
1715624156250,EDS 128A,A01,507264,Fargason; Sharon Gayle,6,0,26,20
1715624157275,EDS 128B,A01,507293,Pappas; Elizabeth,10,0,30,20
1715624158300,EDS 139,A00,507294,Fargason; Sharon Gayle,10,0,30,20
1715624158300,EDS 139,B00,507313,Pappas; Elizabeth,11,0,30,19
1715624159329,EDS 201,A00,507315,Staff,10,0,30,20
1715624160352,EDS 203,A01,507317,Halter; Christopher P.,10,0,30,20
1715624161377,EDS 204R,A01,507319,Halter; Christopher P.,0,3,30,30
1715624161377,EDS 204R,B01,507331,Heinzman; Erica M.,14,0,30,16
1715624162405,EDS 206R,A00,507332,Staff,0,4,30,30
1715624162405,EDS 206R,B00,507343,Staff,15,0,30,15
1715624163430,EDS 250,A00,507344,Hemans; Patricia Ann Benitez,20,0,40,20
1715624164454,EDS 281,A00,507345,Daly; Alan J.,18,0,18,0
1715624165479,EDS 284,A00,507350,Daly; Alan J.,16,0,16,0
1715624166504,EDS 286,A00,507359,Fine; Sarah,18,0,18,0
1715624167532,EDS 289C,A01,507361,Daly; Alan J.,18,0,18,0
1715624168560,EDS 290,A00,507366,Hofstetter; Carolyn,15,0,15,0
1715624169586,LIGM 5A,A00,507421,Fischer-Grunski; Eva K,17,0,20,3
1715624170613,LIGM 5B,A00,507423,Fischer-Grunski; Eva K,19,0,20,1
1715624171641,LIGM 5C,A00,507425,Fischer-Grunski; Eva K,19,0,20,1
1715624172666,LIIT 5AS,A00,507427,Carnelos; Chiara,20,0,20,0
1715624173693,LIIT 5BS,A00,507430,Carnelos; Chiara,20,0,20,0
1715624174719,LIIT 5CS,A00,507432,Carnelos; Chiara,20,0,20,0
1715624175743,LISP 5A,A00,507541,Munoz Sanchez; Alicia,11,0,20,9
1715624176770,LISP 5B,A00,507671,Munoz Sanchez; Alicia,9,0,20,11
1715624177796,LISP 5C,A00,507696,Munoz Sanchez; Alicia,9,0,20,11
1715624178826,MAE 197,001,528363,Boechler; Nicholas Sebastia,9998,0,9999,1
1715624179853,MATH 197,001,523477,Kedlaya; Kiran S.,9994,0,9999,5
1715624179853,MATH 197,002,563811,Zhang; Danna,9994,0,9999,5
1715624179853,MATH 197,003,628552,Dumitriu; Ioana,9998,0,9999,1
1715624179853,MATH 197,004,660885,Floyd; Eric,9998,0,9999,1
1715624180879,MCWP 40R,A00,518780,Staff,2,0,20,18
1715624180879,MCWP 40R,B00,518781,Staff,11,0,20,9
1715624180879,MCWP 40R,C00,518783,Staff,5,0,20,15
1715624181911,MCWP 50R,A00,518791,Staff,0,1,20,20
1715624181911,MCWP 50R,B00,518792,Staff,0,2,20,20
1715624181911,MCWP 50R,C00,518793,Staff,0,4,20,20
1715624181911,MCWP 50R,D00,518794,Staff,0,1,20,20
1715624181911,MCWP 50R,E00,518795,Staff,0,2,20,20
1715624181911,MCWP 50R,F00,518796,Staff,0,1,20,20
1715624181911,MCWP 50R,G00,518797,Staff,0,1,20,20
1715624182941,MMW 12R,A01,514034,Herbst; Matthew,0,2,16,16
1715624182941,MMW 12R,A02,514035,Herbst; Matthew,0,0,16,16
1715624183968,MMW 13R,A01,514037,Staff,0,5,16,16
1715624183968,MMW 13R,A02,514039,Staff,0,5,16,16
1715624183968,MMW 13R,A03,628519,Staff,0,4,16,16
1715624186025,SIO 295LS,A00,523233,Staff,10,0,30,20
1715624187053,SIO 295S,A00,523232,Staff,10,0,30,20
1715624188078,SIOC 290S,A01,637330,Merrifield; Mark A,23,0,30,7
1715624189109,SIOC 291S,A01,637333,Gabriel; Corey John,23,0,30,7
1715624190135,SOCI 117,A01,494376,Staff,0,5,5,5
1715624191162,WES 237B,A00,494380,Staff,10,0,20,10
1715624193236,AESE 279B,A00,494370,Wade; Jon P,0,0,33,33
1715624194258,AIP 97,001,660915,Van Den Einde; Yael Dahlia,9998,0,9999,1
1715624195291,AIP 197,001,627712,Vespa; Emanuel Ignacio,9995,0,9999,4
1715624195291,AIP 197,002,650778,Amir; On,9998,0,9999,1
1715624195291,AIP 197,003,650933,Avenancio-Leon; Carlos,9998,0,9999,1
1715624195291,AIP 197,004,658530,Heyman; Gail D.,9998,0,9999,1
1715624195291,AIP 197,005,658631,Neal; Sonya E,9998,0,9999,1
1715624195291,AIP 197,006,658671,Du; Songzi,9998,0,9999,1
1715624196316,ANAR 135S,A00,494369,Braswell; Geoffrey E.,0,0,0,0
1715624197341,BENG 196,001,628496,Engler; Adam J.,9998,0,9999,1
1715624197341,BENG 196,002,660916,Watson; John Thomas,9999,0,9999,0
1715624198366,BISP 197,001,650773,Wilhelm; James E.,9994,0,9999,5
1715624198366,BISP 197,002,658904,Coleman; Aaron B.,9998,0,9999,1
1715624199395,CAT 124RS,A01,519847,Geibel; William,0,0,20,20
1715624200419,CAT 125RS,A01,515971,Geibel; William,0,0,20,20
1715624201448,CLRE 250,A00,511389,Morris; Sheldon,9992,0,9999,7
1715624202478,CLRE 251,A00,507176,Mehta; Ravindra L.,9992,0,9999,7
1715624202478,CLRE 251,B00,511410,Mehta; Ravindra L.,9998,0,9999,1
1715624203507,CLRE 252,A00,507189,Cuomo; Raphael Eduardo,9994,0,9999,5
1715624204535,CLRE 253,A00,507199,Vaida; Florin,9994,0,9999,5
1715624204535,CLRE 253,B00,507202,Vaida; Florin,9999,0,9999,0
1715624205561,CLRE 259,A00,507211,Patel; Hemal,9996,0,9999,3
1715624206589,CLRE 260,A00,507221,Cuomo; Raphael Eduardo,9999,0,9999,0
1715624207615,CLRE 297,001,507242,Cuomo; Raphael Eduardo,9999,0,9999,0
1715624208643,COGS 197,001,638244,Voytek; Bradley Thomas,9997,0,9999,2
1715624209668,CSE 191,A00,516875,Minnes Kemp; Mor Mia,9991,0,9999,8
1715624210696,CSE 197,001,637388,Minnes Kemp; Mor Mia,9992,0,9999,7
1715624211725,CSS 201S,A01,494383,Mignozzetti; Umberto,35,0,35,0
1715624212752,CSS 202S,A01,494387,Mignozzetti; Umberto,35,0,35,0
1715624213778,DSC 197,001,628532,Eldridge; Justin Matthew,9995,0,9999,4
1715624214804,EAP 100,A00,516065,Staff,9799,0,9999,200
1715624215833,ECE 45,A01,507414,Staff,31,0,60,29
1715624217887,ECE 111,A01,507420,Staff,11,0,50,39
1715624218914,ECE 197,001,548057,Sievenpiper; Daniel F.,9991,0,9999,8
1715624219940,EDS 115,A00,507243,Choi; Bailey Miyeon,7,0,28,21
1715624220969,EDS 117,A01,494379,Staff,0,6,34,34
1715624221999,EDS 125,A00,507246,Hopkins; Megan Beth,8,0,30,22
1715624223025,EDS 128A,A01,507264,Fargason; Sharon Gayle,6,0,26,20
1715624224052,EDS 128B,A01,507293,Pappas; Elizabeth,10,0,30,20
1715624225079,EDS 139,A00,507294,Fargason; Sharon Gayle,10,0,30,20
1715624225079,EDS 139,B00,507313,Pappas; Elizabeth,11,0,30,19
1715624226107,EDS 201,A00,507315,Staff,10,0,30,20
1715624227134,EDS 203,A01,507317,Halter; Christopher P.,10,0,30,20
1715624228164,EDS 204R,A01,507319,Halter; Christopher P.,0,3,30,30
1715624228164,EDS 204R,B01,507331,Heinzman; Erica M.,14,0,30,16
1715624229192,EDS 206R,A00,507332,Staff,0,4,30,30
1715624229192,EDS 206R,B00,507343,Staff,15,0,30,15
1715624230217,EDS 250,A00,507344,Hemans; Patricia Ann Benitez,20,0,40,20
1715624231245,EDS 281,A00,507345,Daly; Alan J.,18,0,18,0
1715624232273,EDS 284,A00,507350,Daly; Alan J.,16,0,16,0
1715624233354,EDS 286,A00,507359,Fine; Sarah,18,0,18,0
1715624234380,EDS 289C,A01,507361,Daly; Alan J.,18,0,18,0
1715624235406,EDS 290,A00,507366,Hofstetter; Carolyn,15,0,15,0
1715624236436,LIGM 5A,A00,507421,Fischer-Grunski; Eva K,17,0,20,3
1715624237463,LIGM 5B,A00,507423,Fischer-Grunski; Eva K,19,0,20,1
1715624238491,LIGM 5C,A00,507425,Fischer-Grunski; Eva K,19,0,20,1
1715624239519,LIIT 5AS,A00,507427,Carnelos; Chiara,20,0,20,0
1715624240544,LIIT 5BS,A00,507430,Carnelos; Chiara,20,0,20,0
1715624241575,LIIT 5CS,A00,507432,Carnelos; Chiara,20,0,20,0
1715624242604,LISP 5A,A00,507541,Munoz Sanchez; Alicia,11,0,20,9
1715624243628,LISP 5B,A00,507671,Munoz Sanchez; Alicia,9,0,20,11
1715624244653,LISP 5C,A00,507696,Munoz Sanchez; Alicia,9,0,20,11
1715624245680,MAE 197,001,528363,Boechler; Nicholas Sebastia,9998,0,9999,1
1715624246706,MATH 197,001,523477,Kedlaya; Kiran S.,9994,0,9999,5
1715624246706,MATH 197,002,563811,Zhang; Danna,9994,0,9999,5
1715624246706,MATH 197,003,628552,Dumitriu; Ioana,9998,0,9999,1
1715624246706,MATH 197,004,660885,Floyd; Eric,9998,0,9999,1
1715624247736,MCWP 40R,A00,518780,Staff,2,0,20,18
1715624247736,MCWP 40R,B00,518781,Staff,11,0,20,9
1715624247736,MCWP 40R,C00,518783,Staff,5,0,20,15
1715624248760,MCWP 50R,A00,518791,Staff,0,1,20,20
1715624248760,MCWP 50R,B00,518792,Staff,0,2,20,20
1715624248760,MCWP 50R,C00,518793,Staff,0,4,20,20
1715624248760,MCWP 50R,D00,518794,Staff,0,1,20,20
1715624248760,MCWP 50R,E00,518795,Staff,0,2,20,20
1715624248760,MCWP 50R,F00,518796,Staff,0,1,20,20
1715624248760,MCWP 50R,G00,518797,Staff,0,1,20,20
1715624249785,MMW 12R,A01,514034,Herbst; Matthew,0,2,16,16
1715624249785,MMW 12R,A02,514035,Herbst; Matthew,0,0,16,16
1715624250810,MMW 13R,A01,514037,Staff,0,5,16,16
1715624250810,MMW 13R,A02,514039,Staff,0,5,16,16
1715624250810,MMW 13R,A03,628519,Staff,0,4,16,16
1715624252865,SIO 295LS,A00,523233,Staff,10,0,30,20
1715624253905,SIO 295S,A00,523232,Staff,10,0,30,20
1715624254932,SIOC 290S,A01,637330,Merrifield; Mark A,23,0,30,7
1715624255962,SIOC 291S,A01,637333,Gabriel; Corey John,23,0,30,7
1715624256988,SOCI 117,A01,494376,Staff,0,5,5,5
1715624258013,WES 237B,A00,494380,Staff,10,0,20,10
1715624260083,AESE 279B,A00,494370,Wade; Jon P,0,0,33,33
1715624261112,AIP 97,001,660915,Van Den Einde; Yael Dahlia,9998,0,9999,1
1715624262144,AIP 197,001,627712,Vespa; Emanuel Ignacio,9995,0,9999,4
1715624262144,AIP 197,002,650778,Amir; On,9998,0,9999,1
1715624262144,AIP 197,003,650933,Avenancio-Leon; Carlos,9998,0,9999,1
1715624262144,AIP 197,004,658530,Heyman; Gail D.,9998,0,9999,1
1715624262144,AIP 197,005,658631,Neal; Sonya E,9998,0,9999,1
1715624262144,AIP 197,006,658671,Du; Songzi,9998,0,9999,1
1715624263172,ANAR 135S,A00,494369,Braswell; Geoffrey E.,0,0,0,0
1715624264200,BENG 196,001,628496,Engler; Adam J.,9998,0,9999,1
1715624264200,BENG 196,002,660916,Watson; John Thomas,9999,0,9999,0
1715624265226,BISP 197,001,650773,Wilhelm; James E.,9994,0,9999,5
1715624265226,BISP 197,002,658904,Coleman; Aaron B.,9998,0,9999,1
1715624266251,CAT 124RS,A01,519847,Geibel; William,0,0,20,20
1715624267279,CAT 125RS,A01,515971,Geibel; William,0,0,20,20
1715624268307,CLRE 250,A00,511389,Morris; Sheldon,9992,0,9999,7
1715624269332,CLRE 251,A00,507176,Mehta; Ravindra L.,9992,0,9999,7
1715624269332,CLRE 251,B00,511410,Mehta; Ravindra L.,9998,0,9999,1
1715624270358,CLRE 252,A00,507189,Cuomo; Raphael Eduardo,9994,0,9999,5
1715624271384,CLRE 253,A00,507199,Vaida; Florin,9994,0,9999,5
1715624271384,CLRE 253,B00,507202,Vaida; Florin,9999,0,9999,0
1715624272412,CLRE 259,A00,507211,Patel; Hemal,9996,0,9999,3
1715624273440,CLRE 260,A00,507221,Cuomo; Raphael Eduardo,9999,0,9999,0
1715624274465,CLRE 297,001,507242,Cuomo; Raphael Eduardo,9999,0,9999,0
1715624275493,COGS 197,001,638244,Voytek; Bradley Thomas,9997,0,9999,2
1715624276518,CSE 191,A00,516875,Minnes Kemp; Mor Mia,9991,0,9999,8
1715624277544,CSE 197,001,637388,Minnes Kemp; Mor Mia,9992,0,9999,7
1715624278575,CSS 201S,A01,494383,Mignozzetti; Umberto,35,0,35,0
1715624279605,CSS 202S,A01,494387,Mignozzetti; Umberto,35,0,35,0
1715624280629,DSC 197,001,628532,Eldridge; Justin Matthew,9995,0,9999,4
1715624281656,EAP 100,A00,516065,Staff,9799,0,9999,200
1715624282684,ECE 45,A01,507414,Staff,31,0,60,29
1715624284738,ECE 111,A01,507420,Staff,11,0,50,39
1715624285766,ECE 197,001,548057,Sievenpiper; Daniel F.,9991,0,9999,8
1715624286792,EDS 115,A00,507243,Choi; Bailey Miyeon,7,0,28,21
1715624287821,EDS 117,A01,494379,Staff,0,6,34,34
1715624288847,EDS 125,A00,507246,Hopkins; Megan Beth,8,0,30,22
1715624289875,EDS 128A,A01,507264,Fargason; Sharon Gayle,6,0,26,20
1715624290899,EDS 128B,A01,507293,Pappas; Elizabeth,10,0,30,20
1715624291926,EDS 139,A00,507294,Fargason; Sharon Gayle,10,0,30,20
1715624291926,EDS 139,B00,507313,Pappas; Elizabeth,11,0,30,19
1715624292952,EDS 201,A00,507315,Staff,10,0,30,20
1715624293978,EDS 203,A01,507317,Halter; Christopher P.,10,0,30,20
1715624295002,EDS 204R,A01,507319,Halter; Christopher P.,0,3,30,30
1715624295002,EDS 204R,B01,507331,Heinzman; Erica M.,14,0,30,16
1715624296028,EDS 206R,A00,507332,Staff,0,4,30,30
1715624296028,EDS 206R,B00,507343,Staff,15,0,30,15
1715624297055,EDS 250,A00,507344,Hemans; Patricia Ann Benitez,20,0,40,20
1715624298080,EDS 281,A00,507345,Daly; Alan J.,18,0,18,0
1715624299105,EDS 284,A00,507350,Daly; Alan J.,16,0,16,0
1715624300129,EDS 286,A00,507359,Fine; Sarah,18,0,18,0
1715624301155,EDS 289C,A01,507361,Daly; Alan J.,18,0,18,0
1715624302180,EDS 290,A00,507366,Hofstetter; Carolyn,15,0,15,0
1715624303205,LIGM 5A,A00,507421,Fischer-Grunski; Eva K,17,0,20,3
1715624304233,LIGM 5B,A00,507423,Fischer-Grunski; Eva K,19,0,20,1
1715624305257,LIGM 5C,A00,507425,Fischer-Grunski; Eva K,19,0,20,1
1715624306287,LIIT 5AS,A00,507427,Carnelos; Chiara,20,0,20,0
1715624307312,LIIT 5BS,A00,507430,Carnelos; Chiara,20,0,20,0
1715624308337,LIIT 5CS,A00,507432,Carnelos; Chiara,20,0,20,0
1715624309362,LISP 5A,A00,507541,Munoz Sanchez; Alicia,11,0,20,9
1715624310388,LISP 5B,A00,507671,Munoz Sanchez; Alicia,9,0,20,11
1715624311416,LISP 5C,A00,507696,Munoz Sanchez; Alicia,9,0,20,11
1715624312441,MAE 197,001,528363,Boechler; Nicholas Sebastia,9998,0,9999,1
1715624313470,MATH 197,001,523477,Kedlaya; Kiran S.,9994,0,9999,5
1715624313470,MATH 197,002,563811,Zhang; Danna,9994,0,9999,5
1715624313470,MATH 197,003,628552,Dumitriu; Ioana,9998,0,9999,1
1715624313470,MATH 197,004,660885,Floyd; Eric,9998,0,9999,1
1715624314496,MCWP 40R,A00,518780,Staff,2,0,20,18
1715624314496,MCWP 40R,B00,518781,Staff,11,0,20,9
1715624314496,MCWP 40R,C00,518783,Staff,5,0,20,15
1715624315527,MCWP 50R,A00,518791,Staff,0,1,20,20
1715624315527,MCWP 50R,B00,518792,Staff,0,2,20,20
1715624315527,MCWP 50R,C00,518793,Staff,0,4,20,20
1715624315527,MCWP 50R,D00,518794,Staff,0,1,20,20
1715624315527,MCWP 50R,E00,518795,Staff,0,2,20,20
1715624315527,MCWP 50R,F00,518796,Staff,0,1,20,20
1715624315527,MCWP 50R,G00,518797,Staff,0,1,20,20
1715624316555,MMW 12R,A01,514034,Herbst; Matthew,0,2,16,16
1715624316555,MMW 12R,A02,514035,Herbst; Matthew,0,0,16,16
1715624317585,MMW 13R,A01,514037,Staff,0,5,16,16
1715624317585,MMW 13R,A02,514039,Staff,0,5,16,16
1715624317585,MMW 13R,A03,628519,Staff,0,4,16,16
1715624319635,SIO 295LS,A00,523233,Staff,10,0,30,20
1715624320665,SIO 295S,A00,523232,Staff,10,0,30,20
1715624321692,SIOC 290S,A01,637330,Merrifield; Mark A,23,0,30,7
1715624322722,SIOC 291S,A01,637333,Gabriel; Corey John,23,0,30,7
1715624323755,SOCI 117,A01,494376,Staff,0,5,5,5
1715624324783,WES 237B,A00,494380,Staff,10,0,20,10
1715624326873,AESE 279B,A00,494370,Wade; Jon P,0,0,33,33
1715624327901,AIP 97,001,660915,Van Den Einde; Yael Dahlia,9998,0,9999,1
1715624328937,AIP 197,001,627712,Vespa; Emanuel Ignacio,9995,0,9999,4
1715624328937,AIP 197,002,650778,Amir; On,9998,0,9999,1
1715624328937,AIP 197,003,650933,Avenancio-Leon; Carlos,9998,0,9999,1
1715624328937,AIP 197,004,658530,Heyman; Gail D.,9998,0,9999,1
1715624328937,AIP 197,005,658631,Neal; Sonya E,9998,0,9999,1
1715624328937,AIP 197,006,658671,Du; Songzi,9998,0,9999,1
1715624329965,ANAR 135S,A00,494369,Braswell; Geoffrey E.,0,0,0,0
1715624330992,BENG 196,001,628496,Engler; Adam J.,9998,0,9999,1
1715624330992,BENG 196,002,660916,Watson; John Thomas,9999,0,9999,0
1715624332020,BISP 197,001,650773,Wilhelm; James E.,9994,0,9999,5
1715624332020,BISP 197,002,658904,Coleman; Aaron B.,9998,0,9999,1
1715624333046,CAT 124RS,A01,519847,Geibel; William,0,0,20,20
1715624334092,CAT 125RS,A01,515971,Geibel; William,0,0,20,20
1715624335118,CLRE 250,A00,511389,Morris; Sheldon,9992,0,9999,7
1715624336148,CLRE 251,A00,507176,Mehta; Ravindra L.,9992,0,9999,7
1715624336148,CLRE 251,B00,511410,Mehta; Ravindra L.,9998,0,9999,1
1715624337173,CLRE 252,A00,507189,Cuomo; Raphael Eduardo,9994,0,9999,5
1715624338203,CLRE 253,A00,507199,Vaida; Florin,9994,0,9999,5
1715624338203,CLRE 253,B00,507202,Vaida; Florin,9999,0,9999,0
1715624339231,CLRE 259,A00,507211,Patel; Hemal,9996,0,9999,3
1715624340256,CLRE 260,A00,507221,Cuomo; Raphael Eduardo,9999,0,9999,0
1715624341281,CLRE 297,001,507242,Cuomo; Raphael Eduardo,9999,0,9999,0
1715624342306,COGS 197,001,638244,Voytek; Bradley Thomas,9997,0,9999,2
1715624343330,CSE 191,A00,516875,Minnes Kemp; Mor Mia,9991,0,9999,8
1715624344359,CSE 197,001,637388,Minnes Kemp; Mor Mia,9992,0,9999,7
1715624345386,CSS 201S,A01,494383,Mignozzetti; Umberto,35,0,35,0
1715624346412,CSS 202S,A01,494387,Mignozzetti; Umberto,35,0,35,0
1715624347441,DSC 197,001,628532,Eldridge; Justin Matthew,9995,0,9999,4
1715624348469,EAP 100,A00,516065,Staff,9799,0,9999,200
1715624349496,ECE 45,A01,507414,Staff,31,0,60,29
1715624351552,ECE 111,A01,507420,Staff,11,0,50,39
1715624352580,ECE 197,001,548057,Sievenpiper; Daniel F.,9991,0,9999,8
1715624353608,EDS 115,A00,507243,Choi; Bailey Miyeon,7,0,28,21
1715624354634,EDS 117,A01,494379,Staff,0,6,34,34
1715624355664,EDS 125,A00,507246,Hopkins; Megan Beth,8,0,30,22
1715624356690,EDS 128A,A01,507264,Fargason; Sharon Gayle,6,0,26,20
1715624357714,EDS 128B,A01,507293,Pappas; Elizabeth,10,0,30,20
1715624358744,EDS 139,A00,507294,Fargason; Sharon Gayle,10,0,30,20
1715624358744,EDS 139,B00,507313,Pappas; Elizabeth,11,0,30,19
1715624359771,EDS 201,A00,507315,Staff,10,0,30,20
1715624360799,EDS 203,A01,507317,Halter; Christopher P.,10,0,30,20
1715624361825,EDS 204R,A01,507319,Halter; Christopher P.,0,3,30,30
1715624361825,EDS 204R,B01,507331,Heinzman; Erica M.,14,0,30,16
1715624362849,EDS 206R,A00,507332,Staff,0,4,30,30
1715624362849,EDS 206R,B00,507343,Staff,15,0,30,15
1715624363877,EDS 250,A00,507344,Hemans; Patricia Ann Benitez,20,0,40,20
1715624364904,EDS 281,A00,507345,Daly; Alan J.,18,0,18,0
1715624365930,EDS 284,A00,507350,Daly; Alan J.,16,0,16,0
1715624366956,EDS 286,A00,507359,Fine; Sarah,18,0,18,0
1715624367982,EDS 289C,A01,507361,Daly; Alan J.,18,0,18,0
1715624369012,EDS 290,A00,507366,Hofstetter; Carolyn,15,0,15,0
1715624370039,LIGM 5A,A00,507421,Fischer-Grunski; Eva K,17,0,20,3
1715624371066,LIGM 5B,A00,507423,Fischer-Grunski; Eva K,19,0,20,1
1715624372097,LIGM 5C,A00,507425,Fischer-Grunski; Eva K,19,0,20,1
1715624373124,LIIT 5AS,A00,507427,Carnelos; Chiara,20,0,20,0
1715624374149,LIIT 5BS,A00,507430,Carnelos; Chiara,20,0,20,0
1715624375176,LIIT 5CS,A00,507432,Carnelos; Chiara,20,0,20,0
1715624376206,LISP 5A,A00,507541,Munoz Sanchez; Alicia,11,0,20,9
1715624377231,LISP 5B,A00,507671,Munoz Sanchez; Alicia,9,0,20,11
1715624378261,LISP 5C,A00,507696,Munoz Sanchez; Alicia,9,0,20,11
1715624379288,MAE 197,001,528363,Boechler; Nicholas Sebastia,9998,0,9999,1
1715624380315,MATH 197,001,523477,Kedlaya; Kiran S.,9994,0,9999,5
1715624380315,MATH 197,002,563811,Zhang; Danna,9994,0,9999,5
1715624380315,MATH 197,003,628552,Dumitriu; Ioana,9998,0,9999,1
1715624380315,MATH 197,004,660885,Floyd; Eric,9998,0,9999,1
1715624381342,MCWP 40R,A00,518780,Staff,2,0,20,18
1715624381342,MCWP 40R,B00,518781,Staff,11,0,20,9
1715624381342,MCWP 40R,C00,518783,Staff,5,0,20,15
1715624382371,MCWP 50R,A00,518791,Staff,0,1,20,20
1715624382371,MCWP 50R,B00,518792,Staff,0,2,20,20
1715624382371,MCWP 50R,C00,518793,Staff,0,4,20,20
1715624382371,MCWP 50R,D00,518794,Staff,0,1,20,20
1715624382371,MCWP 50R,E00,518795,Staff,0,2,20,20
1715624382371,MCWP 50R,F00,518796,Staff,0,1,20,20
1715624382371,MCWP 50R,G00,518797,Staff,0,1,20,20
1715624383397,MMW 12R,A01,514034,Herbst; Matthew,0,2,16,16
1715624383397,MMW 12R,A02,514035,Herbst; Matthew,0,0,16,16
1715624384425,MMW 13R,A01,514037,Staff,0,5,16,16
1715624384425,MMW 13R,A02,514039,Staff,0,5,16,16
1715624384425,MMW 13R,A03,628519,Staff,0,4,16,16
1715624386474,SIO 295LS,A00,523233,Staff,10,0,30,20
1715624387499,SIO 295S,A00,523232,Staff,10,0,30,20
1715624388528,SIOC 290S,A01,637330,Merrifield; Mark A,23,0,30,7
1715624389554,SIOC 291S,A01,637333,Gabriel; Corey John,23,0,30,7
1715624390580,SOCI 117,A01,494376,Staff,0,5,5,5
1715624391606,WES 237B,A00,494380,Staff,10,0,20,10
1715624393678,AESE 279B,A00,494370,Wade; Jon P,0,0,33,33
1715624394702,AIP 97,001,660915,Van Den Einde; Yael Dahlia,9998,0,9999,1
1715624395729,AIP 197,001,627712,Vespa; Emanuel Ignacio,9995,0,9999,4
1715624395729,AIP 197,002,650778,Amir; On,9998,0,9999,1
1715624395729,AIP 197,003,650933,Avenancio-Leon; Carlos,9998,0,9999,1
1715624395729,AIP 197,004,658530,Heyman; Gail D.,9998,0,9999,1
1715624395729,AIP 197,005,658631,Neal; Sonya E,9998,0,9999,1
1715624395729,AIP 197,006,658671,Du; Songzi,9998,0,9999,1
1715624396754,ANAR 135S,A00,494369,Braswell; Geoffrey E.,0,0,0,0
1715624397780,BENG 196,001,628496,Engler; Adam J.,9998,0,9999,1
1715624397780,BENG 196,002,660916,Watson; John Thomas,9999,0,9999,0
1715624398804,BISP 197,001,650773,Wilhelm; James E.,9994,0,9999,5
1715624398804,BISP 197,002,658904,Coleman; Aaron B.,9998,0,9999,1
1715624399830,CAT 124RS,A01,519847,Geibel; William,0,0,20,20
1715624400854,CAT 125RS,A01,515971,Geibel; William,0,0,20,20
1715624401880,CLRE 250,A00,511389,Morris; Sheldon,9992,0,9999,7
1715624402908,CLRE 251,A00,507176,Mehta; Ravindra L.,9992,0,9999,7
1715624402908,CLRE 251,B00,511410,Mehta; Ravindra L.,9998,0,9999,1
1715624403935,CLRE 252,A00,507189,Cuomo; Raphael Eduardo,9994,0,9999,5
1715624404960,CLRE 253,A00,507199,Vaida; Florin,9994,0,9999,5
1715624404960,CLRE 253,B00,507202,Vaida; Florin,9999,0,9999,0
1715624405986,CLRE 259,A00,507211,Patel; Hemal,9996,0,9999,3
1715624407011,CLRE 260,A00,507221,Cuomo; Raphael Eduardo,9999,0,9999,0
1715624408034,CLRE 297,001,507242,Cuomo; Raphael Eduardo,9999,0,9999,0
1715624409063,COGS 197,001,638244,Voytek; Bradley Thomas,9997,0,9999,2
1715624410090,CSE 191,A00,516875,Minnes Kemp; Mor Mia,9991,0,9999,8
1715624411118,CSE 197,001,637388,Minnes Kemp; Mor Mia,9992,0,9999,7
1715624412148,CSS 201S,A01,494383,Mignozzetti; Umberto,35,0,35,0
1715624413229,CSS 202S,A01,494387,Mignozzetti; Umberto,35,0,35,0
1715624414255,DSC 197,001,628532,Eldridge; Justin Matthew,9995,0,9999,4
1715624415280,EAP 100,A00,516065,Staff,9799,0,9999,200
1715624416310,ECE 45,A01,507414,Staff,31,0,60,29
1715624418364,ECE 111,A01,507420,Staff,11,0,50,39
1715624419390,ECE 197,001,548057,Sievenpiper; Daniel F.,9991,0,9999,8
1715624420415,EDS 115,A00,507243,Choi; Bailey Miyeon,7,0,28,21
1715624421443,EDS 117,A01,494379,Staff,0,6,34,34
1715624422468,EDS 125,A00,507246,Hopkins; Megan Beth,8,0,30,22
1715624423496,EDS 128A,A01,507264,Fargason; Sharon Gayle,6,0,26,20
1715624424521,EDS 128B,A01,507293,Pappas; Elizabeth,10,0,30,20
1715624425551,EDS 139,A00,507294,Fargason; Sharon Gayle,10,0,30,20
1715624425551,EDS 139,B00,507313,Pappas; Elizabeth,11,0,30,19
1715624426579,EDS 201,A00,507315,Staff,10,0,30,20
1715624427604,EDS 203,A01,507317,Halter; Christopher P.,10,0,30,20
1715624428629,EDS 204R,A01,507319,Halter; Christopher P.,0,3,30,30
1715624428629,EDS 204R,B01,507331,Heinzman; Erica M.,14,0,30,16
1715624429658,EDS 206R,A00,507332,Staff,0,4,30,30
1715624429658,EDS 206R,B00,507343,Staff,15,0,30,15
1715624430683,EDS 250,A00,507344,Hemans; Patricia Ann Benitez,20,0,40,20
1715624431710,EDS 281,A00,507345,Daly; Alan J.,18,0,18,0
1715624432737,EDS 284,A00,507350,Daly; Alan J.,16,0,16,0
1715624433763,EDS 286,A00,507359,Fine; Sarah,18,0,18,0
1715624434791,EDS 289C,A01,507361,Daly; Alan J.,18,0,18,0
1715624435820,EDS 290,A00,507366,Hofstetter; Carolyn,15,0,15,0
1715624436846,LIGM 5A,A00,507421,Fischer-Grunski; Eva K,17,0,20,3
1715624437874,LIGM 5B,A00,507423,Fischer-Grunski; Eva K,19,0,20,1
1715624438898,LIGM 5C,A00,507425,Fischer-Grunski; Eva K,19,0,20,1
1715624439927,LIIT 5AS,A00,507427,Carnelos; Chiara,20,0,20,0
1715624440953,LIIT 5BS,A00,507430,Carnelos; Chiara,20,0,20,0
1715624441988,LIIT 5CS,A00,507432,Carnelos; Chiara,20,0,20,0
1715624443017,LISP 5A,A00,507541,Munoz Sanchez; Alicia,11,0,20,9
1715624444044,LISP 5B,A00,507671,Munoz Sanchez; Alicia,9,0,20,11
1715624445068,LISP 5C,A00,507696,Munoz Sanchez; Alicia,9,0,20,11
1715624446095,MAE 197,001,528363,Boechler; Nicholas Sebastia,9998,0,9999,1
1715624447123,MATH 197,001,523477,Kedlaya; Kiran S.,9994,0,9999,5
1715624447123,MATH 197,002,563811,Zhang; Danna,9994,0,9999,5
1715624447123,MATH 197,003,628552,Dumitriu; Ioana,9998,0,9999,1
1715624447123,MATH 197,004,660885,Floyd; Eric,9998,0,9999,1
1715624448148,MCWP 40R,A00,518780,Staff,2,0,20,18
1715624448148,MCWP 40R,B00,518781,Staff,11,0,20,9
1715624448148,MCWP 40R,C00,518783,Staff,5,0,20,15
1715624449178,MCWP 50R,A00,518791,Staff,0,1,20,20
1715624449178,MCWP 50R,B00,518792,Staff,0,2,20,20
1715624449178,MCWP 50R,C00,518793,Staff,0,4,20,20
1715624449178,MCWP 50R,D00,518794,Staff,0,1,20,20
1715624449178,MCWP 50R,E00,518795,Staff,0,2,20,20
1715624449178,MCWP 50R,F00,518796,Staff,0,1,20,20
1715624449178,MCWP 50R,G00,518797,Staff,0,1,20,20
1715624450206,MMW 12R,A01,514034,Herbst; Matthew,0,2,16,16
1715624450206,MMW 12R,A02,514035,Herbst; Matthew,0,0,16,16
1715624451231,MMW 13R,A01,514037,Staff,0,5,16,16
1715624451231,MMW 13R,A02,514039,Staff,0,5,16,16
1715624451231,MMW 13R,A03,628519,Staff,0,4,16,16
1715624453279,SIO 295LS,A00,523233,Staff,10,0,30,20
1715624454304,SIO 295S,A00,523232,Staff,10,0,30,20
1715624455334,SIOC 290S,A01,637330,Merrifield; Mark A,23,0,30,7
1715624456358,SIOC 291S,A01,637333,Gabriel; Corey John,23,0,30,7
1715624457382,SOCI 117,A01,494376,Staff,0,5,5,5
1715624458408,WES 237B,A00,494380,Staff,10,0,20,10
1715624460491,AESE 279B,A00,494370,Wade; Jon P,0,0,33,33
1715624461517,AIP 97,001,660915,Van Den Einde; Yael Dahlia,9998,0,9999,1
1715624462542,AIP 197,001,627712,Vespa; Emanuel Ignacio,9995,0,9999,4
1715624462542,AIP 197,002,650778,Amir; On,9998,0,9999,1
1715624462542,AIP 197,003,650933,Avenancio-Leon; Carlos,9998,0,9999,1
1715624462542,AIP 197,004,658530,Heyman; Gail D.,9998,0,9999,1
1715624462542,AIP 197,005,658631,Neal; Sonya E,9998,0,9999,1
1715624462542,AIP 197,006,658671,Du; Songzi,9998,0,9999,1
1715624463568,ANAR 135S,A00,494369,Braswell; Geoffrey E.,0,0,0,0
1715624464595,BENG 196,001,628496,Engler; Adam J.,9998,0,9999,1
1715624464595,BENG 196,002,660916,Watson; John Thomas,9999,0,9999,0
1715624465620,BISP 197,001,650773,Wilhelm; James E.,9994,0,9999,5
1715624465620,BISP 197,002,658904,Coleman; Aaron B.,9998,0,9999,1
1715624466648,CAT 124RS,A01,519847,Geibel; William,0,0,20,20
1715624467680,CAT 125RS,A01,515971,Geibel; William,0,0,20,20
1715624468707,CLRE 250,A00,511389,Morris; Sheldon,9992,0,9999,7
1715624469734,CLRE 251,A00,507176,Mehta; Ravindra L.,9992,0,9999,7
1715624469734,CLRE 251,B00,511410,Mehta; Ravindra L.,9998,0,9999,1
1715624470759,CLRE 252,A00,507189,Cuomo; Raphael Eduardo,9994,0,9999,5
1715624471784,CLRE 253,A00,507199,Vaida; Florin,9994,0,9999,5
1715624471784,CLRE 253,B00,507202,Vaida; Florin,9999,0,9999,0
1715624472808,CLRE 259,A00,507211,Patel; Hemal,9996,0,9999,3
1715624473832,CLRE 260,A00,507221,Cuomo; Raphael Eduardo,9999,0,9999,0
1715624474856,CLRE 297,001,507242,Cuomo; Raphael Eduardo,9999,0,9999,0
1715624475882,COGS 197,001,638244,Voytek; Bradley Thomas,9997,0,9999,2
1715624476907,CSE 191,A00,516875,Minnes Kemp; Mor Mia,9991,0,9999,8
1715624477932,CSE 197,001,637388,Minnes Kemp; Mor Mia,9992,0,9999,7
1715624478960,CSS 201S,A01,494383,Mignozzetti; Umberto,35,0,35,0
1715624479985,CSS 202S,A01,494387,Mignozzetti; Umberto,35,0,35,0
1715624481009,DSC 197,001,628532,Eldridge; Justin Matthew,9995,0,9999,4
1715624482033,EAP 100,A00,516065,Staff,9799,0,9999,200
1715624483060,ECE 45,A01,507414,Staff,31,0,60,29
1715624485166,ECE 111,A01,507420,Staff,11,0,50,39
1715624486194,ECE 197,001,548057,Sievenpiper; Daniel F.,9991,0,9999,8
1715624487217,EDS 115,A00,507243,Choi; Bailey Miyeon,7,0,28,21
1715624488248,EDS 117,A01,494379,Staff,0,6,34,34
1715624489275,EDS 125,A00,507246,Hopkins; Megan Beth,8,0,30,22
1715624490303,EDS 128A,A01,507264,Fargason; Sharon Gayle,6,0,26,20
1715624491327,EDS 128B,A01,507293,Pappas; Elizabeth,10,0,30,20
1715624492352,EDS 139,A00,507294,Fargason; Sharon Gayle,10,0,30,20
1715624492352,EDS 139,B00,507313,Pappas; Elizabeth,11,0,30,19
1715624493378,EDS 201,A00,507315,Staff,10,0,30,20
1715624494404,EDS 203,A01,507317,Halter; Christopher P.,10,0,30,20
1715624495432,EDS 204R,A01,507319,Halter; Christopher P.,0,3,30,30
1715624495432,EDS 204R,B01,507331,Heinzman; Erica M.,14,0,30,16
1715624496460,EDS 206R,A00,507332,Staff,0,4,30,30
1715624496460,EDS 206R,B00,507343,Staff,15,0,30,15
1715624497489,EDS 250,A00,507344,Hemans; Patricia Ann Benitez,20,0,40,20
1715624498514,EDS 281,A00,507345,Daly; Alan J.,18,0,18,0
1715624499542,EDS 284,A00,507350,Daly; Alan J.,16,0,16,0
1715624500568,EDS 286,A00,507359,Fine; Sarah,18,0,18,0
1715624501591,EDS 289C,A01,507361,Daly; Alan J.,18,0,18,0
1715624502619,EDS 290,A00,507366,Hofstetter; Carolyn,15,0,15,0
1715624503646,LIGM 5A,A00,507421,Fischer-Grunski; Eva K,17,0,20,3
1715624504672,LIGM 5B,A00,507423,Fischer-Grunski; Eva K,19,0,20,1
1715624505697,LIGM 5C,A00,507425,Fischer-Grunski; Eva K,19,0,20,1
1715624506721,LIIT 5AS,A00,507427,Carnelos; Chiara,20,0,20,0
1715624507749,LIIT 5BS,A00,507430,Carnelos; Chiara,20,0,20,0
1715624508778,LIIT 5CS,A00,507432,Carnelos; Chiara,20,0,20,0
1715624509806,LISP 5A,A00,507541,Munoz Sanchez; Alicia,11,0,20,9
1715624510832,LISP 5B,A00,507671,Munoz Sanchez; Alicia,9,0,20,11
1715624511858,LISP 5C,A00,507696,Munoz Sanchez; Alicia,9,0,20,11
1715624512883,MAE 197,001,528363,Boechler; Nicholas Sebastia,9998,0,9999,1
1715624513910,MATH 197,001,523477,Kedlaya; Kiran S.,9994,0,9999,5
1715624513910,MATH 197,002,563811,Zhang; Danna,9994,0,9999,5
1715624513910,MATH 197,003,628552,Dumitriu; Ioana,9998,0,9999,1
1715624513910,MATH 197,004,660885,Floyd; Eric,9998,0,9999,1
1715624514940,MCWP 40R,A00,518780,Staff,2,0,20,18
1715624514940,MCWP 40R,B00,518781,Staff,11,0,20,9
1715624514940,MCWP 40R,C00,518783,Staff,5,0,20,15
1715624515974,MCWP 50R,A00,518791,Staff,0,1,20,20
1715624515974,MCWP 50R,B00,518792,Staff,0,2,20,20
1715624515974,MCWP 50R,C00,518793,Staff,0,4,20,20
1715624515974,MCWP 50R,D00,518794,Staff,0,1,20,20
1715624515974,MCWP 50R,E00,518795,Staff,0,2,20,20
1715624515974,MCWP 50R,F00,518796,Staff,0,1,20,20
1715624515974,MCWP 50R,G00,518797,Staff,0,1,20,20
1715624516999,MMW 12R,A01,514034,Herbst; Matthew,0,2,16,16
1715624516999,MMW 12R,A02,514035,Herbst; Matthew,0,0,16,16
1715624518029,MMW 13R,A01,514037,Staff,0,5,16,16
1715624518029,MMW 13R,A02,514039,Staff,0,5,16,16
1715624518029,MMW 13R,A03,628519,Staff,0,4,16,16
1715624520084,SIO 295LS,A00,523233,Staff,10,0,30,20
1715624521109,SIO 295S,A00,523232,Staff,10,0,30,20
1715624522140,SIOC 290S,A01,637330,Merrifield; Mark A,23,0,30,7
1715624523170,SIOC 291S,A01,637333,Gabriel; Corey John,23,0,30,7
1715624524195,SOCI 117,A01,494376,Staff,0,5,5,5
1715624525224,WES 237B,A00,494380,Staff,10,0,20,10
1715624527286,AESE 279B,A00,494370,Wade; Jon P,0,0,33,33
1715624528312,AIP 97,001,660915,Van Den Einde; Yael Dahlia,9998,0,9999,1
1715624529338,AIP 197,001,627712,Vespa; Emanuel Ignacio,9995,0,9999,4
1715624529338,AIP 197,002,650778,Amir; On,9998,0,9999,1
1715624529338,AIP 197,003,650933,Avenancio-Leon; Carlos,9998,0,9999,1
1715624529338,AIP 197,004,658530,Heyman; Gail D.,9998,0,9999,1
1715624529338,AIP 197,005,658631,Neal; Sonya E,9998,0,9999,1
1715624529338,AIP 197,006,658671,Du; Songzi,9998,0,9999,1
1715624530369,ANAR 135S,A00,494369,Braswell; Geoffrey E.,0,0,0,0
1715624531397,BENG 196,001,628496,Engler; Adam J.,9998,0,9999,1
1715624531397,BENG 196,002,660916,Watson; John Thomas,9999,0,9999,0
1715624532424,BISP 197,001,650773,Wilhelm; James E.,9994,0,9999,5
1715624532424,BISP 197,002,658904,Coleman; Aaron B.,9998,0,9999,1
1715624533454,CAT 124RS,A01,519847,Geibel; William,0,0,20,20
1715624534479,CAT 125RS,A01,515971,Geibel; William,0,0,20,20
1715624535505,CLRE 250,A00,511389,Morris; Sheldon,9992,0,9999,7
1715624536534,CLRE 251,A00,507176,Mehta; Ravindra L.,9992,0,9999,7
1715624536534,CLRE 251,B00,511410,Mehta; Ravindra L.,9998,0,9999,1
1715624537560,CLRE 252,A00,507189,Cuomo; Raphael Eduardo,9994,0,9999,5
1715624538586,CLRE 253,A00,507199,Vaida; Florin,9994,0,9999,5
1715624538586,CLRE 253,B00,507202,Vaida; Florin,9999,0,9999,0
1715624539611,CLRE 259,A00,507211,Patel; Hemal,9996,0,9999,3
1715624540638,CLRE 260,A00,507221,Cuomo; Raphael Eduardo,9999,0,9999,0
1715624541665,CLRE 297,001,507242,Cuomo; Raphael Eduardo,9999,0,9999,0
1715624542689,COGS 197,001,638244,Voytek; Bradley Thomas,9997,0,9999,2
1715624543716,CSE 191,A00,516875,Minnes Kemp; Mor Mia,9991,0,9999,8
1715624544742,CSE 197,001,637388,Minnes Kemp; Mor Mia,9992,0,9999,7
1715624545767,CSS 201S,A01,494383,Mignozzetti; Umberto,35,0,35,0
1715624546798,CSS 202S,A01,494387,Mignozzetti; Umberto,35,0,35,0
1715624547828,DSC 197,001,628532,Eldridge; Justin Matthew,9995,0,9999,4
1715624548856,EAP 100,A00,516065,Staff,9799,0,9999,200
1715624549889,ECE 45,A01,507414,Staff,31,0,60,29
1715624551944,ECE 111,A01,507420,Staff,11,0,50,39
1715624552970,ECE 197,001,548057,Sievenpiper; Daniel F.,9991,0,9999,8
1715624553996,EDS 115,A00,507243,Choi; Bailey Miyeon,7,0,28,21
1715624555021,EDS 117,A01,494379,Staff,0,6,34,34
1715624556052,EDS 125,A00,507246,Hopkins; Megan Beth,8,0,30,22
1715624557076,EDS 128A,A01,507264,Fargason; Sharon Gayle,6,0,26,20
1715624558104,EDS 128B,A01,507293,Pappas; Elizabeth,10,0,30,20
1715624559129,EDS 139,A00,507294,Fargason; Sharon Gayle,10,0,30,20
1715624559129,EDS 139,B00,507313,Pappas; Elizabeth,11,0,30,19
1715624560153,EDS 201,A00,507315,Staff,10,0,30,20
1715624561179,EDS 203,A01,507317,Halter; Christopher P.,10,0,30,20
1715624562208,EDS 204R,A01,507319,Halter; Christopher P.,0,3,30,30
1715624562208,EDS 204R,B01,507331,Heinzman; Erica M.,14,0,30,16
1715624563234,EDS 206R,A00,507332,Staff,0,4,30,30
1715624563234,EDS 206R,B00,507343,Staff,15,0,30,15
1715624564260,EDS 250,A00,507344,Hemans; Patricia Ann Benitez,20,0,40,20
1715624565290,EDS 281,A00,507345,Daly; Alan J.,18,0,18,0
1715624566314,EDS 284,A00,507350,Daly; Alan J.,16,0,16,0
1715624567341,EDS 286,A00,507359,Fine; Sarah,18,0,18,0
1715624568367,EDS 289C,A01,507361,Daly; Alan J.,18,0,18,0
1715624569393,EDS 290,A00,507366,Hofstetter; Carolyn,15,0,15,0
1715624570423,LIGM 5A,A00,507421,Fischer-Grunski; Eva K,17,0,20,3
1715624571453,LIGM 5B,A00,507423,Fischer-Grunski; Eva K,19,0,20,1
1715624572495,LIGM 5C,A00,507425,Fischer-Grunski; Eva K,19,0,20,1
1715624573520,LIIT 5AS,A00,507427,Carnelos; Chiara,20,0,20,0
1715624574546,LIIT 5BS,A00,507430,Carnelos; Chiara,20,0,20,0
1715624575576,LIIT 5CS,A00,507432,Carnelos; Chiara,20,0,20,0
1715624576603,LISP 5A,A00,507541,Munoz Sanchez; Alicia,11,0,20,9
1715624577632,LISP 5B,A00,507671,Munoz Sanchez; Alicia,9,0,20,11
1715624578657,LISP 5C,A00,507696,Munoz Sanchez; Alicia,9,0,20,11
1715624579687,MAE 197,001,528363,Boechler; Nicholas Sebastia,9998,0,9999,1
1715624580717,MATH 197,001,523477,Kedlaya; Kiran S.,9994,0,9999,5
1715624580717,MATH 197,002,563811,Zhang; Danna,9994,0,9999,5
1715624580717,MATH 197,003,628552,Dumitriu; Ioana,9998,0,9999,1
1715624580717,MATH 197,004,660885,Floyd; Eric,9998,0,9999,1
1715624581745,MCWP 40R,A00,518780,Staff,2,0,20,18
1715624581745,MCWP 40R,B00,518781,Staff,11,0,20,9
1715624581745,MCWP 40R,C00,518783,Staff,5,0,20,15
1715624582781,MCWP 50R,A00,518791,Staff,0,1,20,20
1715624582781,MCWP 50R,B00,518792,Staff,0,2,20,20
1715624582781,MCWP 50R,C00,518793,Staff,0,4,20,20
1715624582781,MCWP 50R,D00,518794,Staff,0,1,20,20
1715624582781,MCWP 50R,E00,518795,Staff,0,2,20,20
1715624582781,MCWP 50R,F00,518796,Staff,0,1,20,20
1715624582781,MCWP 50R,G00,518797,Staff,0,1,20,20
1715624583808,MMW 12R,A01,514034,Herbst; Matthew,0,2,16,16
1715624583808,MMW 12R,A02,514035,Herbst; Matthew,0,0,16,16
1715624584835,MMW 13R,A01,514037,Staff,0,5,16,16
1715624584835,MMW 13R,A02,514039,Staff,0,5,16,16
1715624584835,MMW 13R,A03,628519,Staff,0,4,16,16
1715624586889,SIO 295LS,A00,523233,Staff,10,0,30,20
1715624587916,SIO 295S,A00,523232,Staff,10,0,30,20
1715624588947,SIOC 290S,A01,637330,Merrifield; Mark A,23,0,30,7
1715624589976,SIOC 291S,A01,637333,Gabriel; Corey John,23,0,30,7
1715624591001,SOCI 117,A01,494376,Staff,0,5,5,5
1715624592029,WES 237B,A00,494380,Staff,10,0,20,10
1715624594102,AESE 279B,A00,494370,Wade; Jon P,0,0,33,33
1715624595127,AIP 97,001,660915,Van Den Einde; Yael Dahlia,9998,0,9999,1
1715624596212,AIP 197,001,627712,Vespa; Emanuel Ignacio,9995,0,9999,4
1715624596212,AIP 197,002,650778,Amir; On,9998,0,9999,1
1715624596212,AIP 197,003,650933,Avenancio-Leon; Carlos,9998,0,9999,1
1715624596212,AIP 197,004,658530,Heyman; Gail D.,9998,0,9999,1
1715624596212,AIP 197,005,658631,Neal; Sonya E,9998,0,9999,1
1715624596212,AIP 197,006,658671,Du; Songzi,9998,0,9999,1
1715624597242,ANAR 135S,A00,494369,Braswell; Geoffrey E.,0,0,0,0
1715624598267,BENG 196,001,628496,Engler; Adam J.,9998,0,9999,1
1715624598267,BENG 196,002,660916,Watson; John Thomas,9999,0,9999,0
1715624599296,BISP 197,001,650773,Wilhelm; James E.,9994,0,9999,5
1715624599296,BISP 197,002,658904,Coleman; Aaron B.,9998,0,9999,1
1715624600330,CAT 124RS,A01,519847,Geibel; William,0,0,20,20
1715624601358,CAT 125RS,A01,515971,Geibel; William,0,0,20,20
1715624602383,CLRE 250,A00,511389,Morris; Sheldon,9992,0,9999,7
1715624603408,CLRE 251,A00,507176,Mehta; Ravindra L.,9992,0,9999,7
1715624603408,CLRE 251,B00,511410,Mehta; Ravindra L.,9998,0,9999,1
1715624604434,CLRE 252,A00,507189,Cuomo; Raphael Eduardo,9994,0,9999,5
1715624605459,CLRE 253,A00,507199,Vaida; Florin,9994,0,9999,5
1715624605459,CLRE 253,B00,507202,Vaida; Florin,9999,0,9999,0
1715624606488,CLRE 259,A00,507211,Patel; Hemal,9996,0,9999,3
1715624607517,CLRE 260,A00,507221,Cuomo; Raphael Eduardo,9999,0,9999,0
1715624608543,CLRE 297,001,507242,Cuomo; Raphael Eduardo,9999,0,9999,0
1715624609568,COGS 197,001,638244,Voytek; Bradley Thomas,9997,0,9999,2
1715624610595,CSE 191,A00,516875,Minnes Kemp; Mor Mia,9991,0,9999,8
1715624611623,CSE 197,001,637388,Minnes Kemp; Mor Mia,9992,0,9999,7
1715624612652,CSS 201S,A01,494383,Mignozzetti; Umberto,35,0,35,0
1715624613679,CSS 202S,A01,494387,Mignozzetti; Umberto,35,0,35,0
1715624614708,DSC 197,001,628532,Eldridge; Justin Matthew,9995,0,9999,4
1715624615733,EAP 100,A00,516065,Staff,9799,0,9999,200
1715624616762,ECE 45,A01,507414,Staff,31,0,60,29
1715624618814,ECE 111,A01,507420,Staff,11,0,50,39
1715624619845,ECE 197,001,548057,Sievenpiper; Daniel F.,9991,0,9999,8
1715624620874,EDS 115,A00,507243,Choi; Bailey Miyeon,7,0,28,21
1715624621901,EDS 117,A01,494379,Staff,0,6,34,34
1715624622926,EDS 125,A00,507246,Hopkins; Megan Beth,8,0,30,22
1715624623956,EDS 128A,A01,507264,Fargason; Sharon Gayle,6,0,26,20
1715624624985,EDS 128B,A01,507293,Pappas; Elizabeth,10,0,30,20
1715624626012,EDS 139,A00,507294,Fargason; Sharon Gayle,10,0,30,20
1715624626012,EDS 139,B00,507313,Pappas; Elizabeth,11,0,30,19
1715624627040,EDS 201,A00,507315,Staff,10,0,30,20
1715624628070,EDS 203,A01,507317,Halter; Christopher P.,10,0,30,20
1715624629097,EDS 204R,A01,507319,Halter; Christopher P.,0,3,30,30
1715624629097,EDS 204R,B01,507331,Heinzman; Erica M.,14,0,30,16
1715624630126,EDS 206R,A00,507332,Staff,0,4,30,30
1715624630126,EDS 206R,B00,507343,Staff,15,0,30,15
1715624631152,EDS 250,A00,507344,Hemans; Patricia Ann Benitez,20,0,40,20
1715624632179,EDS 281,A00,507345,Daly; Alan J.,18,0,18,0
1715624633209,EDS 284,A00,507350,Daly; Alan J.,16,0,16,0
1715624634237,EDS 286,A00,507359,Fine; Sarah,18,0,18,0
1715624635265,EDS 289C,A01,507361,Daly; Alan J.,18,0,18,0
1715624636290,EDS 290,A00,507366,Hofstetter; Carolyn,15,0,15,0
1715624637319,LIGM 5A,A00,507421,Fischer-Grunski; Eva K,17,0,20,3
1715624638348,LIGM 5B,A00,507423,Fischer-Grunski; Eva K,19,0,20,1
1715624639376,LIGM 5C,A00,507425,Fischer-Grunski; Eva K,19,0,20,1
1715624640403,LIIT 5AS,A00,507427,Carnelos; Chiara,20,0,20,0
1715624641432,LIIT 5BS,A00,507430,Carnelos; Chiara,20,0,20,0
1715624642458,LIIT 5CS,A00,507432,Carnelos; Chiara,20,0,20,0
1715624643485,LISP 5A,A00,507541,Munoz Sanchez; Alicia,11,0,20,9
1715624644515,LISP 5B,A00,507671,Munoz Sanchez; Alicia,9,0,20,11
1715624645544,LISP 5C,A00,507696,Munoz Sanchez; Alicia,9,0,20,11
1715624646571,MAE 197,001,528363,Boechler; Nicholas Sebastia,9998,0,9999,1
1715624647605,MATH 197,001,523477,Kedlaya; Kiran S.,9994,0,9999,5
1715624647605,MATH 197,002,563811,Zhang; Danna,9994,0,9999,5
1715624647605,MATH 197,003,628552,Dumitriu; Ioana,9998,0,9999,1
1715624647605,MATH 197,004,660885,Floyd; Eric,9998,0,9999,1
1715624648629,MCWP 40R,A00,518780,Staff,2,0,20,18
1715624648629,MCWP 40R,B00,518781,Staff,11,0,20,9
1715624648629,MCWP 40R,C00,518783,Staff,5,0,20,15
1715624649656,MCWP 50R,A00,518791,Staff,0,1,20,20
1715624649656,MCWP 50R,B00,518792,Staff,0,2,20,20
1715624649656,MCWP 50R,C00,518793,Staff,0,4,20,20
1715624649656,MCWP 50R,D00,518794,Staff,0,1,20,20
1715624649656,MCWP 50R,E00,518795,Staff,0,2,20,20
1715624649656,MCWP 50R,F00,518796,Staff,0,1,20,20
1715624649656,MCWP 50R,G00,518797,Staff,0,1,20,20
1715624650684,MMW 12R,A01,514034,Herbst; Matthew,0,2,16,16
1715624650684,MMW 12R,A02,514035,Herbst; Matthew,0,0,16,16
1715624651712,MMW 13R,A01,514037,Staff,0,5,16,16
1715624651712,MMW 13R,A02,514039,Staff,0,5,16,16
1715624651712,MMW 13R,A03,628519,Staff,0,4,16,16
1715624653763,SIO 295LS,A00,523233,Staff,10,0,30,20
1715624654789,SIO 295S,A00,523232,Staff,10,0,30,20
1715624655819,SIOC 290S,A01,637330,Merrifield; Mark A,23,0,30,7
1715624656848,SIOC 291S,A01,637333,Gabriel; Corey John,23,0,30,7
1715624657874,SOCI 117,A01,494376,Staff,0,5,5,5
1715624658899,WES 237B,A00,494380,Staff,10,0,20,10
1715624660977,AESE 279B,A00,494370,Wade; Jon P,0,0,33,33
1715624662002,AIP 97,001,660915,Van Den Einde; Yael Dahlia,9998,0,9999,1
1715624663028,AIP 197,001,627712,Vespa; Emanuel Ignacio,9995,0,9999,4
1715624663028,AIP 197,002,650778,Amir; On,9998,0,9999,1
1715624663028,AIP 197,003,650933,Avenancio-Leon; Carlos,9998,0,9999,1
1715624663028,AIP 197,004,658530,Heyman; Gail D.,9998,0,9999,1
1715624663028,AIP 197,005,658631,Neal; Sonya E,9998,0,9999,1
1715624663028,AIP 197,006,658671,Du; Songzi,9998,0,9999,1
1715624664052,ANAR 135S,A00,494369,Braswell; Geoffrey E.,0,0,0,0
1715624665077,BENG 196,001,628496,Engler; Adam J.,9998,0,9999,1
1715624665077,BENG 196,002,660916,Watson; John Thomas,9999,0,9999,0
1715624666108,BISP 197,001,650773,Wilhelm; James E.,9994,0,9999,5
1715624666108,BISP 197,002,658904,Coleman; Aaron B.,9998,0,9999,1
1715624667134,CAT 124RS,A01,519847,Geibel; William,0,0,20,20
1715624668159,CAT 125RS,A01,515971,Geibel; William,0,0,20,20
1715624669205,CLRE 250,A00,511389,Morris; Sheldon,9992,0,9999,7
1715624670232,CLRE 251,A00,507176,Mehta; Ravindra L.,9992,0,9999,7
1715624670232,CLRE 251,B00,511410,Mehta; Ravindra L.,9998,0,9999,1
1715624671257,CLRE 252,A00,507189,Cuomo; Raphael Eduardo,9994,0,9999,5
1715624672282,CLRE 253,A00,507199,Vaida; Florin,9994,0,9999,5
1715624672282,CLRE 253,B00,507202,Vaida; Florin,9999,0,9999,0
1715624673307,CLRE 259,A00,507211,Patel; Hemal,9996,0,9999,3
1715624674333,CLRE 260,A00,507221,Cuomo; Raphael Eduardo,9999,0,9999,0
1715624675359,CLRE 297,001,507242,Cuomo; Raphael Eduardo,9999,0,9999,0
1715624676386,COGS 197,001,638244,Voytek; Bradley Thomas,9997,0,9999,2
1715624677412,CSE 191,A00,516875,Minnes Kemp; Mor Mia,9991,0,9999,8
1715624678436,CSE 197,001,637388,Minnes Kemp; Mor Mia,9992,0,9999,7
1715624679460,CSS 201S,A01,494383,Mignozzetti; Umberto,35,0,35,0
1715624680488,CSS 202S,A01,494387,Mignozzetti; Umberto,35,0,35,0
1715624681513,DSC 197,001,628532,Eldridge; Justin Matthew,9995,0,9999,4
1715624682538,EAP 100,A00,516065,Staff,9799,0,9999,200
1715624683568,ECE 45,A01,507414,Staff,31,0,60,29
1715624685621,ECE 111,A01,507420,Staff,11,0,50,39
1715624686650,ECE 197,001,548057,Sievenpiper; Daniel F.,9991,0,9999,8
1715624687677,EDS 115,A00,507243,Choi; Bailey Miyeon,7,0,28,21
1715624688702,EDS 117,A01,494379,Staff,0,6,34,34
1715624689731,EDS 125,A00,507246,Hopkins; Megan Beth,8,0,30,22
1715624690759,EDS 128A,A01,507264,Fargason; Sharon Gayle,6,0,26,20
1715624691788,EDS 128B,A01,507293,Pappas; Elizabeth,10,0,30,20
1715624692813,EDS 139,A00,507294,Fargason; Sharon Gayle,10,0,30,20
1715624692813,EDS 139,B00,507313,Pappas; Elizabeth,11,0,30,19
1715624693839,EDS 201,A00,507315,Staff,10,0,30,20
1715624694864,EDS 203,A01,507317,Halter; Christopher P.,10,0,30,20
1715624695889,EDS 204R,A01,507319,Halter; Christopher P.,0,3,30,30
1715624695889,EDS 204R,B01,507331,Heinzman; Erica M.,14,0,30,16
1715624696920,EDS 206R,A00,507332,Staff,0,4,30,30
1715624696920,EDS 206R,B00,507343,Staff,15,0,30,15
1715624697949,EDS 250,A00,507344,Hemans; Patricia Ann Benitez,20,0,40,20
1715624698978,EDS 281,A00,507345,Daly; Alan J.,18,0,18,0
1715624700007,EDS 284,A00,507350,Daly; Alan J.,16,0,16,0
1715624701036,EDS 286,A00,507359,Fine; Sarah,18,0,18,0
1715624702067,EDS 289C,A01,507361,Daly; Alan J.,18,0,18,0
1715624703094,EDS 290,A00,507366,Hofstetter; Carolyn,15,0,15,0
1715624704123,LIGM 5A,A00,507421,Fischer-Grunski; Eva K,17,0,20,3
1715624705153,LIGM 5B,A00,507423,Fischer-Grunski; Eva K,19,0,20,1
1715624706181,LIGM 5C,A00,507425,Fischer-Grunski; Eva K,19,0,20,1
1715624707208,LIIT 5AS,A00,507427,Carnelos; Chiara,20,0,20,0
1715624708236,LIIT 5BS,A00,507430,Carnelos; Chiara,20,0,20,0
1715624709267,LIIT 5CS,A00,507432,Carnelos; Chiara,20,0,20,0
1715624710292,LISP 5A,A00,507541,Munoz Sanchez; Alicia,11,0,20,9
1715624711318,LISP 5B,A00,507671,Munoz Sanchez; Alicia,9,0,20,11
1715624712344,LISP 5C,A00,507696,Munoz Sanchez; Alicia,9,0,20,11
1715624713373,MAE 197,001,528363,Boechler; Nicholas Sebastia,9998,0,9999,1
1715624714407,MATH 197,001,523477,Kedlaya; Kiran S.,9994,0,9999,5
1715624714407,MATH 197,002,563811,Zhang; Danna,9994,0,9999,5
1715624714407,MATH 197,003,628552,Dumitriu; Ioana,9998,0,9999,1
1715624714407,MATH 197,004,660885,Floyd; Eric,9998,0,9999,1
1715624715433,MCWP 40R,A00,518780,Staff,2,0,20,18
1715624715433,MCWP 40R,B00,518781,Staff,11,0,20,9
1715624715433,MCWP 40R,C00,518783,Staff,5,0,20,15
1715624716460,MCWP 50R,A00,518791,Staff,0,1,20,20
1715624716460,MCWP 50R,B00,518792,Staff,0,2,20,20
1715624716460,MCWP 50R,C00,518793,Staff,0,4,20,20
1715624716460,MCWP 50R,D00,518794,Staff,0,1,20,20
1715624716460,MCWP 50R,E00,518795,Staff,0,2,20,20
1715624716460,MCWP 50R,F00,518796,Staff,0,1,20,20
1715624716460,MCWP 50R,G00,518797,Staff,0,1,20,20
1715624717489,MMW 12R,A01,514034,Herbst; Matthew,0,2,16,16
1715624717489,MMW 12R,A02,514035,Herbst; Matthew,0,0,16,16
1715624718516,MMW 13R,A01,514037,Staff,0,5,16,16
1715624718516,MMW 13R,A02,514039,Staff,0,5,16,16
1715624718516,MMW 13R,A03,628519,Staff,0,4,16,16
1715624720567,SIO 295LS,A00,523233,Staff,10,0,30,20
1715624721592,SIO 295S,A00,523232,Staff,10,0,30,20
1715624722619,SIOC 290S,A01,637330,Merrifield; Mark A,23,0,30,7
1715624723644,SIOC 291S,A01,637333,Gabriel; Corey John,23,0,30,7
1715624724669,SOCI 117,A01,494376,Staff,0,5,5,5
1715624725696,WES 237B,A00,494380,Staff,10,0,20,10
1715624727757,AESE 279B,A00,494370,Wade; Jon P,0,0,33,33
1715624728781,AIP 97,001,660915,Van Den Einde; Yael Dahlia,9998,0,9999,1
1715624729814,AIP 197,001,627712,Vespa; Emanuel Ignacio,9995,0,9999,4
1715624729814,AIP 197,002,650778,Amir; On,9998,0,9999,1
1715624729814,AIP 197,003,650933,Avenancio-Leon; Carlos,9998,0,9999,1
1715624729814,AIP 197,004,658530,Heyman; Gail D.,9998,0,9999,1
1715624729814,AIP 197,005,658631,Neal; Sonya E,9998,0,9999,1
1715624729814,AIP 197,006,658671,Du; Songzi,9998,0,9999,1
1715624730844,ANAR 135S,A00,494369,Braswell; Geoffrey E.,0,0,0,0
1715624731868,BENG 196,001,628496,Engler; Adam J.,9998,0,9999,1
1715624731868,BENG 196,002,660916,Watson; John Thomas,9999,0,9999,0
1715624732897,BISP 197,001,650773,Wilhelm; James E.,9994,0,9999,5
1715624732897,BISP 197,002,658904,Coleman; Aaron B.,9998,0,9999,1
1715624733924,CAT 124RS,A01,519847,Geibel; William,0,0,20,20
1715624734952,CAT 125RS,A01,515971,Geibel; William,0,0,20,20
1715624735984,CLRE 250,A00,511389,Morris; Sheldon,9992,0,9999,7
1715624737015,CLRE 251,A00,507176,Mehta; Ravindra L.,9992,0,9999,7
1715624737015,CLRE 251,B00,511410,Mehta; Ravindra L.,9998,0,9999,1
1715624738040,CLRE 252,A00,507189,Cuomo; Raphael Eduardo,9994,0,9999,5
1715624739065,CLRE 253,A00,507199,Vaida; Florin,9994,0,9999,5
1715624739065,CLRE 253,B00,507202,Vaida; Florin,9999,0,9999,0
1715624740092,CLRE 259,A00,507211,Patel; Hemal,9996,0,9999,3
1715624741118,CLRE 260,A00,507221,Cuomo; Raphael Eduardo,9999,0,9999,0
1715624742147,CLRE 297,001,507242,Cuomo; Raphael Eduardo,9999,0,9999,0
1715624743173,COGS 197,001,638244,Voytek; Bradley Thomas,9997,0,9999,2
1715624744201,CSE 191,A00,516875,Minnes Kemp; Mor Mia,9991,0,9999,8
1715624745228,CSE 197,001,637388,Minnes Kemp; Mor Mia,9992,0,9999,7
1715624746254,CSS 201S,A01,494383,Mignozzetti; Umberto,35,0,35,0
1715624747285,CSS 202S,A01,494387,Mignozzetti; Umberto,35,0,35,0
1715624748311,DSC 197,001,628532,Eldridge; Justin Matthew,9995,0,9999,4
1715624749337,EAP 100,A00,516065,Staff,9799,0,9999,200
1715624750365,ECE 45,A01,507414,Staff,31,0,60,29
1715624752418,ECE 111,A01,507420,Staff,11,0,50,39
1715624753444,ECE 197,001,548057,Sievenpiper; Daniel F.,9991,0,9999,8
1715624754470,EDS 115,A00,507243,Choi; Bailey Miyeon,7,0,28,21
1715624755494,EDS 117,A01,494379,Staff,0,6,34,34
1715624756520,EDS 125,A00,507246,Hopkins; Megan Beth,8,0,30,22
1715624757548,EDS 128A,A01,507264,Fargason; Sharon Gayle,6,0,26,20
1715624758576,EDS 128B,A01,507293,Pappas; Elizabeth,10,0,30,20
1715624759600,EDS 139,A00,507294,Fargason; Sharon Gayle,10,0,30,20
1715624759600,EDS 139,B00,507313,Pappas; Elizabeth,11,0,30,19
1715624760630,EDS 201,A00,507315,Staff,10,0,30,20
1715624761654,EDS 203,A01,507317,Halter; Christopher P.,10,0,30,20
1715624762678,EDS 204R,A01,507319,Halter; Christopher P.,0,3,30,30
1715624762678,EDS 204R,B01,507331,Heinzman; Erica M.,14,0,30,16
1715624763705,EDS 206R,A00,507332,Staff,0,4,30,30
1715624763705,EDS 206R,B00,507343,Staff,15,0,30,15
1715624764733,EDS 250,A00,507344,Hemans; Patricia Ann Benitez,20,0,40,20
1715624765758,EDS 281,A00,507345,Daly; Alan J.,18,0,18,0
1715624766781,EDS 284,A00,507350,Daly; Alan J.,16,0,16,0
1715624767805,EDS 286,A00,507359,Fine; Sarah,18,0,18,0
1715624768835,EDS 289C,A01,507361,Daly; Alan J.,18,0,18,0
1715624769861,EDS 290,A00,507366,Hofstetter; Carolyn,15,0,15,0
1715624770887,LIGM 5A,A00,507421,Fischer-Grunski; Eva K,17,0,20,3
1715624771915,LIGM 5B,A00,507423,Fischer-Grunski; Eva K,19,0,20,1
1715624772941,LIGM 5C,A00,507425,Fischer-Grunski; Eva K,19,0,20,1
1715624773964,LIIT 5AS,A00,507427,Carnelos; Chiara,20,0,20,0
1715624774987,LIIT 5BS,A00,507430,Carnelos; Chiara,20,0,20,0
1715624776012,LIIT 5CS,A00,507432,Carnelos; Chiara,20,0,20,0
1715624777036,LISP 5A,A00,507541,Munoz Sanchez; Alicia,11,0,20,9
1715624778062,LISP 5B,A00,507671,Munoz Sanchez; Alicia,9,0,20,11
1715624779087,LISP 5C,A00,507696,Munoz Sanchez; Alicia,9,0,20,11
1715624780114,MAE 197,001,528363,Boechler; Nicholas Sebastia,9998,0,9999,1
1715624781140,MATH 197,001,523477,Kedlaya; Kiran S.,9994,0,9999,5
1715624781140,MATH 197,002,563811,Zhang; Danna,9994,0,9999,5
1715624781140,MATH 197,003,628552,Dumitriu; Ioana,9998,0,9999,1
1715624781140,MATH 197,004,660885,Floyd; Eric,9998,0,9999,1
1715624782220,MCWP 40R,A00,518780,Staff,2,0,20,18
1715624782220,MCWP 40R,B00,518781,Staff,11,0,20,9
1715624782220,MCWP 40R,C00,518783,Staff,5,0,20,15
1715624783248,MCWP 50R,A00,518791,Staff,0,1,20,20
1715624783248,MCWP 50R,B00,518792,Staff,0,2,20,20
1715624783248,MCWP 50R,C00,518793,Staff,0,4,20,20
1715624783248,MCWP 50R,D00,518794,Staff,0,1,20,20
1715624783248,MCWP 50R,E00,518795,Staff,0,2,20,20
1715624783248,MCWP 50R,F00,518796,Staff,0,1,20,20
1715624783248,MCWP 50R,G00,518797,Staff,0,1,20,20
1715624784274,MMW 12R,A01,514034,Herbst; Matthew,0,2,16,16
1715624784274,MMW 12R,A02,514035,Herbst; Matthew,0,0,16,16
1715624785302,MMW 13R,A01,514037,Staff,0,5,16,16
1715624785302,MMW 13R,A02,514039,Staff,0,5,16,16
1715624785302,MMW 13R,A03,628519,Staff,0,4,16,16
1715624787353,SIO 295LS,A00,523233,Staff,10,0,30,20
1715624788380,SIO 295S,A00,523232,Staff,10,0,30,20
1715624789405,SIOC 290S,A01,637330,Merrifield; Mark A,23,0,30,7
1715624790431,SIOC 291S,A01,637333,Gabriel; Corey John,23,0,30,7
1715624791457,SOCI 117,A01,494376,Staff,0,5,5,5
1715624792484,WES 237B,A00,494380,Staff,10,0,20,10
1715624794558,AESE 279B,A00,494370,Wade; Jon P,0,0,33,33
1715624795583,AIP 97,001,660915,Van Den Einde; Yael Dahlia,9998,0,9999,1
1715624796614,AIP 197,001,627712,Vespa; Emanuel Ignacio,9995,0,9999,4
1715624796614,AIP 197,002,650778,Amir; On,9998,0,9999,1
1715624796614,AIP 197,003,650933,Avenancio-Leon; Carlos,9998,0,9999,1
1715624796614,AIP 197,004,658530,Heyman; Gail D.,9998,0,9999,1
1715624796614,AIP 197,005,658631,Neal; Sonya E,9998,0,9999,1
1715624796614,AIP 197,006,658671,Du; Songzi,9998,0,9999,1
1715624797638,ANAR 135S,A00,494369,Braswell; Geoffrey E.,0,0,0,0
1715624798667,BENG 196,001,628496,Engler; Adam J.,9998,0,9999,1
1715624798667,BENG 196,002,660916,Watson; John Thomas,9999,0,9999,0
1715624799696,BISP 197,001,650773,Wilhelm; James E.,9994,0,9999,5
1715624799696,BISP 197,002,658904,Coleman; Aaron B.,9998,0,9999,1
1715624800721,CAT 124RS,A01,519847,Geibel; William,0,0,20,20
1715624801745,CAT 125RS,A01,515971,Geibel; William,0,0,20,20
1715624802773,CLRE 250,A00,511389,Morris; Sheldon,9992,0,9999,7
1715624803804,CLRE 251,A00,507176,Mehta; Ravindra L.,9992,0,9999,7
1715624803804,CLRE 251,B00,511410,Mehta; Ravindra L.,9998,0,9999,1
1715624804829,CLRE 252,A00,507189,Cuomo; Raphael Eduardo,9994,0,9999,5
1715624805853,CLRE 253,A00,507199,Vaida; Florin,9994,0,9999,5
1715624805853,CLRE 253,B00,507202,Vaida; Florin,9999,0,9999,0
1715624806878,CLRE 259,A00,507211,Patel; Hemal,9996,0,9999,3
1715624807904,CLRE 260,A00,507221,Cuomo; Raphael Eduardo,9999,0,9999,0
1715624808931,CLRE 297,001,507242,Cuomo; Raphael Eduardo,9999,0,9999,0
1715624809955,COGS 197,001,638244,Voytek; Bradley Thomas,9997,0,9999,2
1715624810982,CSE 191,A00,516875,Minnes Kemp; Mor Mia,9991,0,9999,8
1715624812010,CSE 197,001,637388,Minnes Kemp; Mor Mia,9992,0,9999,7
1715624813036,CSS 201S,A01,494383,Mignozzetti; Umberto,35,0,35,0
1715624814068,CSS 202S,A01,494387,Mignozzetti; Umberto,35,0,35,0
1715624815093,DSC 197,001,628532,Eldridge; Justin Matthew,9995,0,9999,4
1715624816120,EAP 100,A00,516065,Staff,9799,0,9999,200
1715624817150,ECE 45,A01,507414,Staff,31,0,60,29
1715624819207,ECE 111,A01,507420,Staff,11,0,50,39
1715624820235,ECE 197,001,548057,Sievenpiper; Daniel F.,9991,0,9999,8
1715624821260,EDS 115,A00,507243,Choi; Bailey Miyeon,7,0,28,21
1715624822288,EDS 117,A01,494379,Staff,0,6,34,34
1715624823313,EDS 125,A00,507246,Hopkins; Megan Beth,8,0,30,22
1715624824350,EDS 128A,A01,507264,Fargason; Sharon Gayle,6,0,26,20
1715624825379,EDS 128B,A01,507293,Pappas; Elizabeth,10,0,30,20
1715624826405,EDS 139,A00,507294,Fargason; Sharon Gayle,10,0,30,20
1715624826405,EDS 139,B00,507313,Pappas; Elizabeth,11,0,30,19
1715624827435,EDS 201,A00,507315,Staff,10,0,30,20
1715624828460,EDS 203,A01,507317,Halter; Christopher P.,10,0,30,20
1715624829490,EDS 204R,A01,507319,Halter; Christopher P.,0,3,30,30
1715624829490,EDS 204R,B01,507331,Heinzman; Erica M.,14,0,30,16
1715624830517,EDS 206R,A00,507332,Staff,0,4,30,30
1715624830517,EDS 206R,B00,507343,Staff,15,0,30,15
1715624831542,EDS 250,A00,507344,Hemans; Patricia Ann Benitez,20,0,40,20
1715624832569,EDS 281,A00,507345,Daly; Alan J.,18,0,18,0
1715624833595,EDS 284,A00,507350,Daly; Alan J.,16,0,16,0
1715624834624,EDS 286,A00,507359,Fine; Sarah,18,0,18,0
1715624835653,EDS 289C,A01,507361,Daly; Alan J.,18,0,18,0
1715624836680,EDS 290,A00,507366,Hofstetter; Carolyn,15,0,15,0
1715624837705,LIGM 5A,A00,507421,Fischer-Grunski; Eva K,17,0,20,3
1715624838730,LIGM 5B,A00,507423,Fischer-Grunski; Eva K,19,0,20,1
1715624839755,LIGM 5C,A00,507425,Fischer-Grunski; Eva K,19,0,20,1
1715624840781,LIIT 5AS,A00,507427,Carnelos; Chiara,20,0,20,0
1715624841807,LIIT 5BS,A00,507430,Carnelos; Chiara,20,0,20,0
1715624842831,LIIT 5CS,A00,507432,Carnelos; Chiara,20,0,20,0
1715624843869,LISP 5A,A00,507541,Munoz Sanchez; Alicia,11,0,20,9
1715624844895,LISP 5B,A00,507671,Munoz Sanchez; Alicia,9,0,20,11
1715624845923,LISP 5C,A00,507696,Munoz Sanchez; Alicia,9,0,20,11
1715624846950,MAE 197,001,528363,Boechler; Nicholas Sebastia,9998,0,9999,1
1715624847978,MATH 197,001,523477,Kedlaya; Kiran S.,9994,0,9999,5
1715624847978,MATH 197,002,563811,Zhang; Danna,9994,0,9999,5
1715624847978,MATH 197,003,628552,Dumitriu; Ioana,9998,0,9999,1
1715624847978,MATH 197,004,660885,Floyd; Eric,9998,0,9999,1
1715624849003,MCWP 40R,A00,518780,Staff,2,0,20,18
1715624849003,MCWP 40R,B00,518781,Staff,11,0,20,9
1715624849003,MCWP 40R,C00,518783,Staff,5,0,20,15
1715624850032,MCWP 50R,A00,518791,Staff,0,1,20,20
1715624850032,MCWP 50R,B00,518792,Staff,0,2,20,20
1715624850032,MCWP 50R,C00,518793,Staff,0,4,20,20
1715624850032,MCWP 50R,D00,518794,Staff,0,1,20,20
1715624850032,MCWP 50R,E00,518795,Staff,0,2,20,20
1715624850032,MCWP 50R,F00,518796,Staff,0,1,20,20
1715624850032,MCWP 50R,G00,518797,Staff,0,1,20,20
1715624851058,MMW 12R,A01,514034,Herbst; Matthew,0,2,16,16
1715624851058,MMW 12R,A02,514035,Herbst; Matthew,0,0,16,16
1715624852085,MMW 13R,A01,514037,Staff,0,5,16,16
1715624852085,MMW 13R,A02,514039,Staff,0,5,16,16
1715624852085,MMW 13R,A03,628519,Staff,0,4,16,16
1715624854136,SIO 295LS,A00,523233,Staff,10,0,30,20
1715624855164,SIO 295S,A00,523232,Staff,10,0,30,20
1715624856195,SIOC 290S,A01,637330,Merrifield; Mark A,23,0,30,7
1715624857220,SIOC 291S,A01,637333,Gabriel; Corey John,23,0,30,7
1715624858244,SOCI 117,A01,494376,Staff,0,5,5,5
1715624859270,WES 237B,A00,494380,Staff,10,0,20,10
1715624861348,AESE 279B,A00,494370,Wade; Jon P,0,0,33,33
1715624862375,AIP 97,001,660915,Van Den Einde; Yael Dahlia,9998,0,9999,1
1715624863407,AIP 197,001,627712,Vespa; Emanuel Ignacio,9995,0,9999,4
1715624863407,AIP 197,002,650778,Amir; On,9998,0,9999,1
1715624863407,AIP 197,003,650933,Avenancio-Leon; Carlos,9998,0,9999,1
1715624863407,AIP 197,004,658530,Heyman; Gail D.,9998,0,9999,1
1715624863407,AIP 197,005,658631,Neal; Sonya E,9998,0,9999,1
1715624863407,AIP 197,006,658671,Du; Songzi,9998,0,9999,1
1715624864434,ANAR 135S,A00,494369,Braswell; Geoffrey E.,0,0,0,0
1715624865463,BENG 196,001,628496,Engler; Adam J.,9998,0,9999,1
1715624865463,BENG 196,002,660916,Watson; John Thomas,9999,0,9999,0
1715624866489,BISP 197,001,650773,Wilhelm; James E.,9994,0,9999,5
1715624866489,BISP 197,002,658904,Coleman; Aaron B.,9998,0,9999,1
1715624867515,CAT 124RS,A01,519847,Geibel; William,0,0,20,20
1715624868539,CAT 125RS,A01,515971,Geibel; William,0,0,20,20
1715624869567,CLRE 250,A00,511389,Morris; Sheldon,9992,0,9999,7
1715624870592,CLRE 251,A00,507176,Mehta; Ravindra L.,9992,0,9999,7
1715624870592,CLRE 251,B00,511410,Mehta; Ravindra L.,9998,0,9999,1
1715624871617,CLRE 252,A00,507189,Cuomo; Raphael Eduardo,9994,0,9999,5
1715624872643,CLRE 253,A00,507199,Vaida; Florin,9994,0,9999,5
1715624872643,CLRE 253,B00,507202,Vaida; Florin,9999,0,9999,0
1715624873669,CLRE 259,A00,507211,Patel; Hemal,9996,0,9999,3
1715624874695,CLRE 260,A00,507221,Cuomo; Raphael Eduardo,9999,0,9999,0
1715624875723,CLRE 297,001,507242,Cuomo; Raphael Eduardo,9999,0,9999,0
1715624876751,COGS 197,001,638244,Voytek; Bradley Thomas,9997,0,9999,2
1715624877775,CSE 191,A00,516875,Minnes Kemp; Mor Mia,9991,0,9999,8
1715624878800,CSE 197,001,637388,Minnes Kemp; Mor Mia,9992,0,9999,7
1715624879827,CSS 201S,A01,494383,Mignozzetti; Umberto,35,0,35,0
1715624880853,CSS 202S,A01,494387,Mignozzetti; Umberto,35,0,35,0
1715624881879,DSC 197,001,628532,Eldridge; Justin Matthew,9995,0,9999,4
1715624882904,EAP 100,A00,516065,Staff,9799,0,9999,200
1715624883930,ECE 45,A01,507414,Staff,31,0,60,29
1715624885982,ECE 111,A01,507420,Staff,11,0,50,39
1715624887007,ECE 197,001,548057,Sievenpiper; Daniel F.,9991,0,9999,8
1715624888032,EDS 115,A00,507243,Choi; Bailey Miyeon,7,0,28,21
1715624889062,EDS 117,A01,494379,Staff,0,6,34,34
1715624890089,EDS 125,A00,507246,Hopkins; Megan Beth,8,0,30,22
1715624891118,EDS 128A,A01,507264,Fargason; Sharon Gayle,6,0,26,20
1715624892145,EDS 128B,A01,507293,Pappas; Elizabeth,10,0,30,20
1715624893170,EDS 139,A00,507294,Fargason; Sharon Gayle,10,0,30,20
1715624893170,EDS 139,B00,507313,Pappas; Elizabeth,11,0,30,19
1715624894198,EDS 201,A00,507315,Staff,10,0,30,20
1715624895223,EDS 203,A01,507317,Halter; Christopher P.,10,0,30,20
1715624896249,EDS 204R,A01,507319,Halter; Christopher P.,0,3,30,30
1715624896249,EDS 204R,B01,507331,Heinzman; Erica M.,14,0,30,16
1715624897276,EDS 206R,A00,507332,Staff,0,4,30,30
1715624897276,EDS 206R,B00,507343,Staff,15,0,30,15
1715624898301,EDS 250,A00,507344,Hemans; Patricia Ann Benitez,20,0,40,20
1715624899328,EDS 281,A00,507345,Daly; Alan J.,18,0,18,0
1715624900352,EDS 284,A00,507350,Daly; Alan J.,16,0,16,0
1715624901377,EDS 286,A00,507359,Fine; Sarah,18,0,18,0
1715624902402,EDS 289C,A01,507361,Daly; Alan J.,18,0,18,0
1715624903484,EDS 290,A00,507366,Hofstetter; Carolyn,15,0,15,0
1715624904509,LIGM 5A,A00,507421,Fischer-Grunski; Eva K,17,0,20,3
1715624905537,LIGM 5B,A00,507423,Fischer-Grunski; Eva K,19,0,20,1
1715624906564,LIGM 5C,A00,507425,Fischer-Grunski; Eva K,19,0,20,1
1715624907590,LIIT 5AS,A00,507427,Carnelos; Chiara,20,0,20,0
1715624908616,LIIT 5BS,A00,507430,Carnelos; Chiara,20,0,20,0
1715624909641,LIIT 5CS,A00,507432,Carnelos; Chiara,20,0,20,0
1715624910667,LISP 5A,A00,507541,Munoz Sanchez; Alicia,11,0,20,9
1715624911692,LISP 5B,A00,507671,Munoz Sanchez; Alicia,9,0,20,11
1715624912717,LISP 5C,A00,507696,Munoz Sanchez; Alicia,9,0,20,11
1715624913750,MAE 197,001,528363,Boechler; Nicholas Sebastia,9998,0,9999,1
1715624914780,MATH 197,001,523477,Kedlaya; Kiran S.,9994,0,9999,5
1715624914780,MATH 197,002,563811,Zhang; Danna,9994,0,9999,5
1715624914780,MATH 197,003,628552,Dumitriu; Ioana,9998,0,9999,1
1715624914780,MATH 197,004,660885,Floyd; Eric,9998,0,9999,1
1715624915806,MCWP 40R,A00,518780,Staff,2,0,20,18
1715624915806,MCWP 40R,B00,518781,Staff,11,0,20,9
1715624915806,MCWP 40R,C00,518783,Staff,5,0,20,15
1715624916831,MCWP 50R,A00,518791,Staff,0,1,20,20
1715624916831,MCWP 50R,B00,518792,Staff,0,2,20,20
1715624916831,MCWP 50R,C00,518793,Staff,0,4,20,20
1715624916831,MCWP 50R,D00,518794,Staff,0,1,20,20
1715624916831,MCWP 50R,E00,518795,Staff,0,2,20,20
1715624916831,MCWP 50R,F00,518796,Staff,0,1,20,20
1715624916831,MCWP 50R,G00,518797,Staff,0,1,20,20
1715624917858,MMW 12R,A01,514034,Herbst; Matthew,0,2,16,16
1715624917858,MMW 12R,A02,514035,Herbst; Matthew,0,0,16,16
1715624918884,MMW 13R,A01,514037,Staff,0,5,16,16
1715624918884,MMW 13R,A02,514039,Staff,0,5,16,16
1715624918884,MMW 13R,A03,628519,Staff,0,4,16,16
1715624920933,SIO 295LS,A00,523233,Staff,10,0,30,20
1715624921961,SIO 295S,A00,523232,Staff,10,0,30,20
1715624922994,SIOC 290S,A01,637330,Merrifield; Mark A,23,0,30,7
1715624924022,SIOC 291S,A01,637333,Gabriel; Corey John,23,0,30,7
1715624925048,SOCI 117,A01,494376,Staff,0,5,5,5
1715624926073,WES 237B,A00,494380,Staff,10,0,20,10
1715624928151,AESE 279B,A00,494370,Wade; Jon P,0,0,33,33
1715624929179,AIP 97,001,660915,Van Den Einde; Yael Dahlia,9998,0,9999,1
1715624930210,AIP 197,001,627712,Vespa; Emanuel Ignacio,9995,0,9999,4
1715624930210,AIP 197,002,650778,Amir; On,9998,0,9999,1
1715624930210,AIP 197,003,650933,Avenancio-Leon; Carlos,9998,0,9999,1
1715624930210,AIP 197,004,658530,Heyman; Gail D.,9998,0,9999,1
1715624930210,AIP 197,005,658631,Neal; Sonya E,9998,0,9999,1
1715624930210,AIP 197,006,658671,Du; Songzi,9998,0,9999,1
1715624931236,ANAR 135S,A00,494369,Braswell; Geoffrey E.,0,0,0,0
1715624932262,BENG 196,001,628496,Engler; Adam J.,9998,0,9999,1
1715624932262,BENG 196,002,660916,Watson; John Thomas,9999,0,9999,0
1715624933288,BISP 197,001,650773,Wilhelm; James E.,9994,0,9999,5
1715624933288,BISP 197,002,658904,Coleman; Aaron B.,9998,0,9999,1
1715624934317,CAT 124RS,A01,519847,Geibel; William,0,0,20,20
1715624935343,CAT 125RS,A01,515971,Geibel; William,0,0,20,20
1715624936372,CLRE 250,A00,511389,Morris; Sheldon,9992,0,9999,7
1715624937402,CLRE 251,A00,507176,Mehta; Ravindra L.,9992,0,9999,7
1715624937402,CLRE 251,B00,511410,Mehta; Ravindra L.,9998,0,9999,1
1715624938428,CLRE 252,A00,507189,Cuomo; Raphael Eduardo,9994,0,9999,5
1715624939456,CLRE 253,A00,507199,Vaida; Florin,9994,0,9999,5
1715624939456,CLRE 253,B00,507202,Vaida; Florin,9999,0,9999,0
1715624940481,CLRE 259,A00,507211,Patel; Hemal,9996,0,9999,3
1715624941516,CLRE 260,A00,507221,Cuomo; Raphael Eduardo,9999,0,9999,0
1715624942543,CLRE 297,001,507242,Cuomo; Raphael Eduardo,9999,0,9999,0
1715624943569,COGS 197,001,638244,Voytek; Bradley Thomas,9997,0,9999,2
1715624944594,CSE 191,A00,516875,Minnes Kemp; Mor Mia,9991,0,9999,8
1715624945621,CSE 197,001,637388,Minnes Kemp; Mor Mia,9992,0,9999,7
1715624946646,CSS 201S,A01,494383,Mignozzetti; Umberto,35,0,35,0
1715624947676,CSS 202S,A01,494387,Mignozzetti; Umberto,35,0,35,0
1715624948704,DSC 197,001,628532,Eldridge; Justin Matthew,9995,0,9999,4
1715624949729,EAP 100,A00,516065,Staff,9799,0,9999,200
1715624950762,ECE 45,A01,507414,Staff,31,0,60,29
1715624952816,ECE 111,A01,507420,Staff,11,0,50,39
1715624953844,ECE 197,001,548057,Sievenpiper; Daniel F.,9991,0,9999,8
1715624954873,EDS 115,A00,507243,Choi; Bailey Miyeon,7,0,28,21
1715624955900,EDS 117,A01,494379,Staff,0,6,34,34
1715624956925,EDS 125,A00,507246,Hopkins; Megan Beth,8,0,30,22
1715624957956,EDS 128A,A01,507264,Fargason; Sharon Gayle,6,0,26,20
1715624958984,EDS 128B,A01,507293,Pappas; Elizabeth,10,0,30,20
1715624960008,EDS 139,A00,507294,Fargason; Sharon Gayle,10,0,30,20
1715624960008,EDS 139,B00,507313,Pappas; Elizabeth,11,0,30,19
1715624961036,EDS 201,A00,507315,Staff,10,0,30,20
1715624962061,EDS 203,A01,507317,Halter; Christopher P.,10,0,30,20
1715624963088,EDS 204R,A01,507319,Halter; Christopher P.,0,3,30,30
1715624963088,EDS 204R,B01,507331,Heinzman; Erica M.,14,0,30,16
1715624964113,EDS 206R,A00,507332,Staff,0,4,30,30
1715624964113,EDS 206R,B00,507343,Staff,15,0,30,15
1715624965140,EDS 250,A00,507344,Hemans; Patricia Ann Benitez,20,0,40,20
1715624966168,EDS 281,A00,507345,Daly; Alan J.,18,0,18,0
1715624967195,EDS 284,A00,507350,Daly; Alan J.,16,0,16,0
1715624968223,EDS 286,A00,507359,Fine; Sarah,18,0,18,0
1715624969251,EDS 289C,A01,507361,Daly; Alan J.,18,0,18,0
1715624970278,EDS 290,A00,507366,Hofstetter; Carolyn,15,0,15,0
1715624971309,LIGM 5A,A00,507421,Fischer-Grunski; Eva K,17,0,20,3
1715624972336,LIGM 5B,A00,507423,Fischer-Grunski; Eva K,19,0,20,1
1715624973366,LIGM 5C,A00,507425,Fischer-Grunski; Eva K,19,0,20,1
1715624974392,LIIT 5AS,A00,507427,Carnelos; Chiara,20,0,20,0
1715624975420,LIIT 5BS,A00,507430,Carnelos; Chiara,20,0,20,0
1715624976445,LIIT 5CS,A00,507432,Carnelos; Chiara,20,0,20,0
1715624977473,LISP 5A,A00,507541,Munoz Sanchez; Alicia,11,0,20,9
1715624978502,LISP 5B,A00,507671,Munoz Sanchez; Alicia,9,0,20,11
1715624979525,LISP 5C,A00,507696,Munoz Sanchez; Alicia,9,0,20,11
1715624980551,MAE 197,001,528363,Boechler; Nicholas Sebastia,9998,0,9999,1
1715624981579,MATH 197,001,523477,Kedlaya; Kiran S.,9994,0,9999,5
1715624981579,MATH 197,002,563811,Zhang; Danna,9994,0,9999,5
1715624981579,MATH 197,003,628552,Dumitriu; Ioana,9998,0,9999,1
1715624981579,MATH 197,004,660885,Floyd; Eric,9998,0,9999,1
1715624982609,MCWP 40R,A00,518780,Staff,2,0,20,18
1715624982609,MCWP 40R,B00,518781,Staff,11,0,20,9
1715624982609,MCWP 40R,C00,518783,Staff,5,0,20,15
1715624983853,MCWP 50R,A00,518791,Staff,0,1,20,20
1715624983853,MCWP 50R,B00,518792,Staff,0,2,20,20
1715624983853,MCWP 50R,C00,518793,Staff,0,4,20,20
1715624983853,MCWP 50R,D00,518794,Staff,0,1,20,20
1715624983853,MCWP 50R,E00,518795,Staff,0,2,20,20
1715624983853,MCWP 50R,F00,518796,Staff,0,1,20,20
1715624983853,MCWP 50R,G00,518797,Staff,0,1,20,20
1715624984879,MMW 12R,A01,514034,Herbst; Matthew,0,2,16,16
1715624984879,MMW 12R,A02,514035,Herbst; Matthew,0,0,16,16
1715624985905,MMW 13R,A01,514037,Staff,0,5,16,16
1715624985905,MMW 13R,A02,514039,Staff,0,5,16,16
1715624985905,MMW 13R,A03,628519,Staff,0,4,16,16
1715624987960,SIO 295LS,A00,523233,Staff,10,0,30,20
1715624988985,SIO 295S,A00,523232,Staff,10,0,30,20
1715624990014,SIOC 290S,A01,637330,Merrifield; Mark A,23,0,30,7
1715624991042,SIOC 291S,A01,637333,Gabriel; Corey John,23,0,30,7
1715624992073,SOCI 117,A01,494376,Staff,0,5,5,5
1715624993102,WES 237B,A00,494380,Staff,10,0,20,10
1715624995163,AESE 279B,A00,494370,Wade; Jon P,0,0,33,33
1715624996189,AIP 97,001,660915,Van Den Einde; Yael Dahlia,9998,0,9999,1
1715624997215,AIP 197,001,627712,Vespa; Emanuel Ignacio,9995,0,9999,4
1715624997215,AIP 197,002,650778,Amir; On,9998,0,9999,1
1715624997215,AIP 197,003,650933,Avenancio-Leon; Carlos,9998,0,9999,1
1715624997215,AIP 197,004,658530,Heyman; Gail D.,9998,0,9999,1
1715624997215,AIP 197,005,658631,Neal; Sonya E,9998,0,9999,1
1715624997215,AIP 197,006,658671,Du; Songzi,9998,0,9999,1
1715624998239,ANAR 135S,A00,494369,Braswell; Geoffrey E.,0,0,0,0
1715624999265,BENG 196,001,628496,Engler; Adam J.,9998,0,9999,1
1715624999265,BENG 196,002,660916,Watson; John Thomas,9999,0,9999,0
1715625000292,BISP 197,001,650773,Wilhelm; James E.,9994,0,9999,5
1715625000292,BISP 197,002,658904,Coleman; Aaron B.,9998,0,9999,1
1715625001318,CAT 124RS,A01,519847,Geibel; William,0,0,20,20
1715625002346,CAT 125RS,A01,515971,Geibel; William,0,0,20,20
1715625003379,CLRE 250,A00,511389,Morris; Sheldon,9992,0,9999,7
1715625004404,CLRE 251,A00,507176,Mehta; Ravindra L.,9992,0,9999,7
1715625004404,CLRE 251,B00,511410,Mehta; Ravindra L.,9998,0,9999,1
1715625005429,CLRE 252,A00,507189,Cuomo; Raphael Eduardo,9994,0,9999,5
1715625006453,CLRE 253,A00,507199,Vaida; Florin,9994,0,9999,5
1715625006453,CLRE 253,B00,507202,Vaida; Florin,9999,0,9999,0
1715625007477,CLRE 259,A00,507211,Patel; Hemal,9996,0,9999,3
1715625008502,CLRE 260,A00,507221,Cuomo; Raphael Eduardo,9999,0,9999,0
1715625009526,CLRE 297,001,507242,Cuomo; Raphael Eduardo,9999,0,9999,0
1715625010553,COGS 197,001,638244,Voytek; Bradley Thomas,9997,0,9999,2
1715625011582,CSE 191,A00,516875,Minnes Kemp; Mor Mia,9991,0,9999,8
1715625012610,CSE 197,001,637388,Minnes Kemp; Mor Mia,9992,0,9999,7
1715625013640,CSS 201S,A01,494383,Mignozzetti; Umberto,35,0,35,0
1715625014671,CSS 202S,A01,494387,Mignozzetti; Umberto,35,0,35,0
1715625015696,DSC 197,001,628532,Eldridge; Justin Matthew,9995,0,9999,4
1715625016720,EAP 100,A00,516065,Staff,9799,0,9999,200
1715625017750,ECE 45,A01,507414,Staff,31,0,60,29
1715625019803,ECE 111,A01,507420,Staff,11,0,50,39
1715625020885,ECE 197,001,548057,Sievenpiper; Daniel F.,9991,0,9999,8
1715625021915,EDS 115,A00,507243,Choi; Bailey Miyeon,7,0,28,21
1715625022944,EDS 117,A01,494379,Staff,0,6,34,34
1715625023973,EDS 125,A00,507246,Hopkins; Megan Beth,8,0,30,22
1715625024999,EDS 128A,A01,507264,Fargason; Sharon Gayle,6,0,26,20
1715625026025,EDS 128B,A01,507293,Pappas; Elizabeth,10,0,30,20
1715625027053,EDS 139,A00,507294,Fargason; Sharon Gayle,10,0,30,20
1715625027053,EDS 139,B00,507313,Pappas; Elizabeth,11,0,30,19
1715625028078,EDS 201,A00,507315,Staff,10,0,30,20
1715625029103,EDS 203,A01,507317,Halter; Christopher P.,10,0,30,20
1715625030131,EDS 204R,A01,507319,Halter; Christopher P.,0,3,30,30
1715625030131,EDS 204R,B01,507331,Heinzman; Erica M.,14,0,30,16
1715625031157,EDS 206R,A00,507332,Staff,0,4,30,30
1715625031157,EDS 206R,B00,507343,Staff,15,0,30,15
1715625032182,EDS 250,A00,507344,Hemans; Patricia Ann Benitez,20,0,40,20
1715625033206,EDS 281,A00,507345,Daly; Alan J.,18,0,18,0
1715625034232,EDS 284,A00,507350,Daly; Alan J.,16,0,16,0
1715625035257,EDS 286,A00,507359,Fine; Sarah,18,0,18,0
1715625036282,EDS 289C,A01,507361,Daly; Alan J.,18,0,18,0
1715625037310,EDS 290,A00,507366,Hofstetter; Carolyn,15,0,15,0
1715625038338,LIGM 5A,A00,507421,Fischer-Grunski; Eva K,17,0,20,3
1715625039368,LIGM 5B,A00,507423,Fischer-Grunski; Eva K,19,0,20,1
1715625040398,LIGM 5C,A00,507425,Fischer-Grunski; Eva K,19,0,20,1
1715625041426,LIIT 5AS,A00,507427,Carnelos; Chiara,20,0,20,0
1715625042453,LIIT 5BS,A00,507430,Carnelos; Chiara,20,0,20,0
1715625043479,LIIT 5CS,A00,507432,Carnelos; Chiara,20,0,20,0
1715625044504,LISP 5A,A00,507541,Munoz Sanchez; Alicia,11,0,20,9
1715625045531,LISP 5B,A00,507671,Munoz Sanchez; Alicia,9,0,20,11
1715625046560,LISP 5C,A00,507696,Munoz Sanchez; Alicia,9,0,20,11
1715625047585,MAE 197,001,528363,Boechler; Nicholas Sebastia,9998,0,9999,1
1715625048611,MATH 197,001,523477,Kedlaya; Kiran S.,9994,0,9999,5
1715625048611,MATH 197,002,563811,Zhang; Danna,9994,0,9999,5
1715625048611,MATH 197,003,628552,Dumitriu; Ioana,9998,0,9999,1
1715625048611,MATH 197,004,660885,Floyd; Eric,9998,0,9999,1
1715625049635,MCWP 40R,A00,518780,Staff,2,0,20,18
1715625049635,MCWP 40R,B00,518781,Staff,11,0,20,9
1715625049635,MCWP 40R,C00,518783,Staff,5,0,20,15
1715625050665,MCWP 50R,A00,518791,Staff,0,1,20,20
1715625050665,MCWP 50R,B00,518792,Staff,0,2,20,20
1715625050665,MCWP 50R,C00,518793,Staff,0,4,20,20
1715625050665,MCWP 50R,D00,518794,Staff,0,1,20,20
1715625050665,MCWP 50R,E00,518795,Staff,0,2,20,20
1715625050665,MCWP 50R,F00,518796,Staff,0,1,20,20
1715625050665,MCWP 50R,G00,518797,Staff,0,1,20,20
1715625051694,MMW 12R,A01,514034,Herbst; Matthew,0,2,16,16
1715625051694,MMW 12R,A02,514035,Herbst; Matthew,0,0,16,16
1715625052720,MMW 13R,A01,514037,Staff,0,5,16,16
1715625052720,MMW 13R,A02,514039,Staff,0,5,16,16
1715625052720,MMW 13R,A03,628519,Staff,0,4,16,16
1715625054771,SIO 295LS,A00,523233,Staff,10,0,30,20
1715625055795,SIO 295S,A00,523232,Staff,10,0,30,20
1715625056820,SIOC 290S,A01,637330,Merrifield; Mark A,23,0,30,7
1715625057851,SIOC 291S,A01,637333,Gabriel; Corey John,23,0,30,7
1715625058883,SOCI 117,A01,494376,Staff,0,5,5,5
1715625059909,WES 237B,A00,494380,Staff,10,0,20,10
1715625061975,AESE 279B,A00,494370,Wade; Jon P,0,0,33,33
1715625063000,AIP 97,001,660915,Van Den Einde; Yael Dahlia,9998,0,9999,1
1715625064032,AIP 197,001,627712,Vespa; Emanuel Ignacio,9995,0,9999,4
1715625064032,AIP 197,002,650778,Amir; On,9998,0,9999,1
1715625064032,AIP 197,003,650933,Avenancio-Leon; Carlos,9998,0,9999,1
1715625064032,AIP 197,004,658530,Heyman; Gail D.,9998,0,9999,1
1715625064032,AIP 197,005,658631,Neal; Sonya E,9998,0,9999,1
1715625064032,AIP 197,006,658671,Du; Songzi,9998,0,9999,1
1715625065060,ANAR 135S,A00,494369,Braswell; Geoffrey E.,0,0,0,0
1715625066086,BENG 196,001,628496,Engler; Adam J.,9998,0,9999,1
1715625066086,BENG 196,002,660916,Watson; John Thomas,9999,0,9999,0
1715625067112,BISP 197,001,650773,Wilhelm; James E.,9994,0,9999,5
1715625067112,BISP 197,002,658904,Coleman; Aaron B.,9998,0,9999,1
1715625068138,CAT 124RS,A01,519847,Geibel; William,0,0,20,20
1715625069166,CAT 125RS,A01,515971,Geibel; William,0,0,20,20
1715625070194,CLRE 250,A00,511389,Morris; Sheldon,9992,0,9999,7
1715625071224,CLRE 251,A00,507176,Mehta; Ravindra L.,9992,0,9999,7
1715625071224,CLRE 251,B00,511410,Mehta; Ravindra L.,9998,0,9999,1
1715625072251,CLRE 252,A00,507189,Cuomo; Raphael Eduardo,9994,0,9999,5
1715625073277,CLRE 253,A00,507199,Vaida; Florin,9994,0,9999,5
1715625073277,CLRE 253,B00,507202,Vaida; Florin,9999,0,9999,0
1715625074305,CLRE 259,A00,507211,Patel; Hemal,9996,0,9999,3
1715625075331,CLRE 260,A00,507221,Cuomo; Raphael Eduardo,9999,0,9999,0
1715625076358,CLRE 297,001,507242,Cuomo; Raphael Eduardo,9999,0,9999,0
1715625077384,COGS 197,001,638244,Voytek; Bradley Thomas,9997,0,9999,2
1715625078409,CSE 191,A00,516875,Minnes Kemp; Mor Mia,9991,0,9999,8
1715625079435,CSE 197,001,637388,Minnes Kemp; Mor Mia,9992,0,9999,7
1715625080465,CSS 201S,A01,494383,Mignozzetti; Umberto,35,0,35,0
1715625081490,CSS 202S,A01,494387,Mignozzetti; Umberto,35,0,35,0
1715625082520,DSC 197,001,628532,Eldridge; Justin Matthew,9995,0,9999,4
1715625083548,EAP 100,A00,516065,Staff,9799,0,9999,200
1715625084580,ECE 45,A01,507414,Staff,31,0,60,29
1715625086631,ECE 111,A01,507420,Staff,11,0,50,39
1715625087660,ECE 197,001,548057,Sievenpiper; Daniel F.,9991,0,9999,8
1715625088686,EDS 115,A00,507243,Choi; Bailey Miyeon,7,0,28,21
1715625089714,EDS 117,A01,494379,Staff,0,6,34,34
1715625090747,EDS 125,A00,507246,Hopkins; Megan Beth,8,0,30,22
1715625091776,EDS 128A,A01,507264,Fargason; Sharon Gayle,6,0,26,20
1715625092802,EDS 128B,A01,507293,Pappas; Elizabeth,10,0,30,20
1715625093834,EDS 139,A00,507294,Fargason; Sharon Gayle,10,0,30,20
1715625093834,EDS 139,B00,507313,Pappas; Elizabeth,11,0,30,19
1715625094863,EDS 201,A00,507315,Staff,10,0,30,20
1715625095893,EDS 203,A01,507317,Halter; Christopher P.,10,0,30,20
1715625096919,EDS 204R,A01,507319,Halter; Christopher P.,0,3,30,30
1715625096919,EDS 204R,B01,507331,Heinzman; Erica M.,14,0,30,16
1715625097945,EDS 206R,A00,507332,Staff,0,4,30,30
1715625097945,EDS 206R,B00,507343,Staff,15,0,30,15
1715625098970,EDS 250,A00,507344,Hemans; Patricia Ann Benitez,20,0,40,20
1715625099995,EDS 281,A00,507345,Daly; Alan J.,18,0,18,0
1715625101021,EDS 284,A00,507350,Daly; Alan J.,16,0,16,0
1715625102047,EDS 286,A00,507359,Fine; Sarah,18,0,18,0
1715625103075,EDS 289C,A01,507361,Daly; Alan J.,18,0,18,0
1715625104100,EDS 290,A00,507366,Hofstetter; Carolyn,15,0,15,0
1715625105126,LIGM 5A,A00,507421,Fischer-Grunski; Eva K,17,0,20,3
1715625106156,LIGM 5B,A00,507423,Fischer-Grunski; Eva K,19,0,20,1
1715625107184,LIGM 5C,A00,507425,Fischer-Grunski; Eva K,19,0,20,1
1715625108213,LIIT 5AS,A00,507427,Carnelos; Chiara,20,0,20,0
1715625109239,LIIT 5BS,A00,507430,Carnelos; Chiara,20,0,20,0
1715625110269,LIIT 5CS,A00,507432,Carnelos; Chiara,20,0,20,0
1715625111297,LISP 5A,A00,507541,Munoz Sanchez; Alicia,11,0,20,9
1715625112326,LISP 5B,A00,507671,Munoz Sanchez; Alicia,9,0,20,11
1715625113353,LISP 5C,A00,507696,Munoz Sanchez; Alicia,9,0,20,11
1715625114379,MAE 197,001,528363,Boechler; Nicholas Sebastia,9998,0,9999,1
1715625115405,MATH 197,001,523477,Kedlaya; Kiran S.,9994,0,9999,5
1715625115405,MATH 197,002,563811,Zhang; Danna,9994,0,9999,5
1715625115405,MATH 197,003,628552,Dumitriu; Ioana,9998,0,9999,1
1715625115405,MATH 197,004,660885,Floyd; Eric,9998,0,9999,1
1715625116430,MCWP 40R,A00,518780,Staff,2,0,20,18
1715625116430,MCWP 40R,B00,518781,Staff,11,0,20,9
1715625116430,MCWP 40R,C00,518783,Staff,5,0,20,15
1715625117460,MCWP 50R,A00,518791,Staff,0,1,20,20
1715625117460,MCWP 50R,B00,518792,Staff,0,2,20,20
1715625117460,MCWP 50R,C00,518793,Staff,0,4,20,20
1715625117460,MCWP 50R,D00,518794,Staff,0,1,20,20
1715625117460,MCWP 50R,E00,518795,Staff,0,2,20,20
1715625117460,MCWP 50R,F00,518796,Staff,0,1,20,20
1715625117460,MCWP 50R,G00,518797,Staff,0,1,20,20
1715625118488,MMW 12R,A01,514034,Herbst; Matthew,0,2,16,16
1715625118488,MMW 12R,A02,514035,Herbst; Matthew,0,0,16,16
1715625119572,MMW 13R,A01,514037,Staff,0,5,16,16
1715625119572,MMW 13R,A02,514039,Staff,0,5,16,16
1715625119572,MMW 13R,A03,628519,Staff,0,4,16,16
1715625121626,SIO 295LS,A00,523233,Staff,10,0,30,20
1715625122656,SIO 295S,A00,523232,Staff,10,0,30,20
1715625123685,SIOC 290S,A01,637330,Merrifield; Mark A,23,0,30,7
1715625124710,SIOC 291S,A01,637333,Gabriel; Corey John,23,0,30,7
1715625125736,SOCI 117,A01,494376,Staff,0,5,5,5
1715625126765,WES 237B,A00,494380,Staff,10,0,20,10
1715625128846,AESE 279B,A00,494370,Wade; Jon P,0,0,33,33
1715625129872,AIP 97,001,660915,Van Den Einde; Yael Dahlia,9998,0,9999,1
1715625130899,AIP 197,001,627712,Vespa; Emanuel Ignacio,9995,0,9999,4
1715625130899,AIP 197,002,650778,Amir; On,9998,0,9999,1
1715625130899,AIP 197,003,650933,Avenancio-Leon; Carlos,9998,0,9999,1
1715625130899,AIP 197,004,658530,Heyman; Gail D.,9998,0,9999,1
1715625130899,AIP 197,005,658631,Neal; Sonya E,9998,0,9999,1
1715625130899,AIP 197,006,658671,Du; Songzi,9998,0,9999,1
1715625131928,ANAR 135S,A00,494369,Braswell; Geoffrey E.,0,0,0,0
1715625132959,BENG 196,001,628496,Engler; Adam J.,9998,0,9999,1
1715625132959,BENG 196,002,660916,Watson; John Thomas,9999,0,9999,0
1715625133986,BISP 197,001,650773,Wilhelm; James E.,9994,0,9999,5
1715625133986,BISP 197,002,658904,Coleman; Aaron B.,9998,0,9999,1
1715625135012,CAT 124RS,A01,519847,Geibel; William,0,0,20,20
1715625136038,CAT 125RS,A01,515971,Geibel; William,0,0,20,20
1715625137067,CLRE 250,A00,511389,Morris; Sheldon,9992,0,9999,7
1715625138095,CLRE 251,A00,507176,Mehta; Ravindra L.,9992,0,9999,7
1715625138095,CLRE 251,B00,511410,Mehta; Ravindra L.,9998,0,9999,1
1715625139122,CLRE 252,A00,507189,Cuomo; Raphael Eduardo,9994,0,9999,5
1715625140151,CLRE 253,A00,507199,Vaida; Florin,9994,0,9999,5
1715625140151,CLRE 253,B00,507202,Vaida; Florin,9999,0,9999,0
1715625141180,CLRE 259,A00,507211,Patel; Hemal,9996,0,9999,3
1715625142204,CLRE 260,A00,507221,Cuomo; Raphael Eduardo,9999,0,9999,0
1715625143232,CLRE 297,001,507242,Cuomo; Raphael Eduardo,9999,0,9999,0
1715625144259,COGS 197,001,638244,Voytek; Bradley Thomas,9997,0,9999,2
1715625145284,CSE 191,A00,516875,Minnes Kemp; Mor Mia,9991,0,9999,8
1715625146310,CSE 197,001,637388,Minnes Kemp; Mor Mia,9992,0,9999,7
1715625147335,CSS 201S,A01,494383,Mignozzetti; Umberto,35,0,35,0
1715625148362,CSS 202S,A01,494387,Mignozzetti; Umberto,35,0,35,0
1715625149388,DSC 197,001,628532,Eldridge; Justin Matthew,9995,0,9999,4
1715625150415,EAP 100,A00,516065,Staff,9799,0,9999,200
1715625151444,ECE 45,A01,507414,Staff,31,0,60,29
1715625153494,ECE 111,A01,507420,Staff,11,0,50,39
1715625154523,ECE 197,001,548057,Sievenpiper; Daniel F.,9991,0,9999,8
1715625155549,EDS 115,A00,507243,Choi; Bailey Miyeon,7,0,28,21
1715625156579,EDS 117,A01,494379,Staff,0,6,34,34
1715625157606,EDS 125,A00,507246,Hopkins; Megan Beth,8,0,30,22
1715625158632,EDS 128A,A01,507264,Fargason; Sharon Gayle,6,0,26,20
1715625159658,EDS 128B,A01,507293,Pappas; Elizabeth,10,0,30,20
1715625160684,EDS 139,A00,507294,Fargason; Sharon Gayle,10,0,30,20
1715625160684,EDS 139,B00,507313,Pappas; Elizabeth,11,0,30,19
1715625161713,EDS 201,A00,507315,Staff,10,0,30,20
1715625162739,EDS 203,A01,507317,Halter; Christopher P.,10,0,30,20
1715625163768,EDS 204R,A01,507319,Halter; Christopher P.,0,3,30,30
1715625163768,EDS 204R,B01,507331,Heinzman; Erica M.,14,0,30,16
1715625164794,EDS 206R,A00,507332,Staff,0,4,30,30
1715625164794,EDS 206R,B00,507343,Staff,15,0,30,15
1715625165822,EDS 250,A00,507344,Hemans; Patricia Ann Benitez,20,0,40,20
1715625166848,EDS 281,A00,507345,Daly; Alan J.,18,0,18,0
1715625167876,EDS 284,A00,507350,Daly; Alan J.,16,0,16,0
1715625168903,EDS 286,A00,507359,Fine; Sarah,18,0,18,0
1715625169931,EDS 289C,A01,507361,Daly; Alan J.,18,0,18,0
1715625170958,EDS 290,A00,507366,Hofstetter; Carolyn,15,0,15,0
1715625171984,LIGM 5A,A00,507421,Fischer-Grunski; Eva K,17,0,20,3
1715625173010,LIGM 5B,A00,507423,Fischer-Grunski; Eva K,19,0,20,1
1715625174040,LIGM 5C,A00,507425,Fischer-Grunski; Eva K,19,0,20,1
1715625175070,LIIT 5AS,A00,507427,Carnelos; Chiara,20,0,20,0
1715625176096,LIIT 5BS,A00,507430,Carnelos; Chiara,20,0,20,0
1715625177123,LIIT 5CS,A00,507432,Carnelos; Chiara,20,0,20,0
1715625178150,LISP 5A,A00,507541,Munoz Sanchez; Alicia,11,0,20,9
1715625179176,LISP 5B,A00,507671,Munoz Sanchez; Alicia,9,0,20,11
1715625180202,LISP 5C,A00,507696,Munoz Sanchez; Alicia,9,0,20,11
1715625181229,MAE 197,001,528363,Boechler; Nicholas Sebastia,9998,0,9999,1
1715625182259,MATH 197,001,523477,Kedlaya; Kiran S.,9994,0,9999,5
1715625182259,MATH 197,002,563811,Zhang; Danna,9994,0,9999,5
1715625182259,MATH 197,003,628552,Dumitriu; Ioana,9998,0,9999,1
1715625182259,MATH 197,004,660885,Floyd; Eric,9998,0,9999,1
1715625183284,MCWP 40R,A00,518780,Staff,2,0,20,18
1715625183284,MCWP 40R,B00,518781,Staff,11,0,20,9
1715625183284,MCWP 40R,C00,518783,Staff,5,0,20,15
1715625184317,MCWP 50R,A00,518791,Staff,0,1,20,20
1715625184317,MCWP 50R,B00,518792,Staff,0,2,20,20
1715625184317,MCWP 50R,C00,518793,Staff,0,4,20,20
1715625184317,MCWP 50R,D00,518794,Staff,0,1,20,20
1715625184317,MCWP 50R,E00,518795,Staff,0,2,20,20
1715625184317,MCWP 50R,F00,518796,Staff,0,1,20,20
1715625184317,MCWP 50R,G00,518797,Staff,0,1,20,20
1715625185342,MMW 12R,A01,514034,Herbst; Matthew,0,2,16,16
1715625185342,MMW 12R,A02,514035,Herbst; Matthew,0,0,16,16
1715625186369,MMW 13R,A01,514037,Staff,0,5,16,16
1715625186369,MMW 13R,A02,514039,Staff,0,5,16,16
1715625186369,MMW 13R,A03,628519,Staff,0,4,16,16
1715625188420,SIO 295LS,A00,523233,Staff,10,0,30,20
1715625189445,SIO 295S,A00,523232,Staff,10,0,30,20
1715625190472,SIOC 290S,A01,637330,Merrifield; Mark A,23,0,30,7
1715625191498,SIOC 291S,A01,637333,Gabriel; Corey John,23,0,30,7
1715625192524,SOCI 117,A01,494376,Staff,0,5,5,5
1715625193552,WES 237B,A00,494380,Staff,10,0,20,10
1715625195630,AESE 279B,A00,494370,Wade; Jon P,0,0,33,33
1715625196658,AIP 97,001,660915,Van Den Einde; Yael Dahlia,9998,0,9999,1
1715625197692,AIP 197,001,627712,Vespa; Emanuel Ignacio,9995,0,9999,4
1715625197692,AIP 197,002,650778,Amir; On,9998,0,9999,1
1715625197692,AIP 197,003,650933,Avenancio-Leon; Carlos,9998,0,9999,1
1715625197692,AIP 197,004,658530,Heyman; Gail D.,9998,0,9999,1
1715625197692,AIP 197,005,658631,Neal; Sonya E,9998,0,9999,1
1715625197692,AIP 197,006,658671,Du; Songzi,9998,0,9999,1
1715625198719,ANAR 135S,A00,494369,Braswell; Geoffrey E.,0,0,0,0
1715625199746,BENG 196,001,628496,Engler; Adam J.,9998,0,9999,1
1715625199746,BENG 196,002,660916,Watson; John Thomas,9999,0,9999,0
1715625200775,BISP 197,001,650773,Wilhelm; James E.,9994,0,9999,5
1715625200775,BISP 197,002,658904,Coleman; Aaron B.,9998,0,9999,1
1715625201800,CAT 124RS,A01,519847,Geibel; William,0,0,20,20
1715625202825,CAT 125RS,A01,515971,Geibel; William,0,0,20,20
1715625203854,CLRE 250,A00,511389,Morris; Sheldon,9992,0,9999,7
1715625204886,CLRE 251,A00,507176,Mehta; Ravindra L.,9992,0,9999,7
1715625204886,CLRE 251,B00,511410,Mehta; Ravindra L.,9998,0,9999,1
1715625205913,CLRE 252,A00,507189,Cuomo; Raphael Eduardo,9994,0,9999,5
1715625206941,CLRE 253,A00,507199,Vaida; Florin,9994,0,9999,5
1715625206941,CLRE 253,B00,507202,Vaida; Florin,9999,0,9999,0
1715625207969,CLRE 259,A00,507211,Patel; Hemal,9996,0,9999,3
1715625208995,CLRE 260,A00,507221,Cuomo; Raphael Eduardo,9999,0,9999,0
1715625210023,CLRE 297,001,507242,Cuomo; Raphael Eduardo,9999,0,9999,0
1715625211048,COGS 197,001,638244,Voytek; Bradley Thomas,9997,0,9999,2
1715625212073,CSE 191,A00,516875,Minnes Kemp; Mor Mia,9991,0,9999,8
1715625213097,CSE 197,001,637388,Minnes Kemp; Mor Mia,9992,0,9999,7
1715625214128,CSS 201S,A01,494383,Mignozzetti; Umberto,35,0,35,0
1715625215153,CSS 202S,A01,494387,Mignozzetti; Umberto,35,0,35,0
1715625216181,DSC 197,001,628532,Eldridge; Justin Matthew,9995,0,9999,4
1715625217209,EAP 100,A00,516065,Staff,9799,0,9999,200
1715625218236,ECE 45,A01,507414,Staff,31,0,60,29
1715625220289,ECE 111,A01,507420,Staff,11,0,50,39
1715625221315,ECE 197,001,548057,Sievenpiper; Daniel F.,9991,0,9999,8
1715625222342,EDS 115,A00,507243,Choi; Bailey Miyeon,7,0,28,21
1715625223370,EDS 117,A01,494379,Staff,0,6,34,34
1715625224399,EDS 125,A00,507246,Hopkins; Megan Beth,8,0,30,22
1715625225424,EDS 128A,A01,507264,Fargason; Sharon Gayle,6,0,26,20
1715625226450,EDS 128B,A01,507293,Pappas; Elizabeth,10,0,30,20
1715625227474,EDS 139,A00,507294,Fargason; Sharon Gayle,10,0,30,20
1715625227474,EDS 139,B00,507313,Pappas; Elizabeth,11,0,30,19
1715625228501,EDS 201,A00,507315,Staff,10,0,30,20
1715625229532,EDS 203,A01,507317,Halter; Christopher P.,10,0,30,20
1715625230563,EDS 204R,A01,507319,Halter; Christopher P.,0,3,30,30
1715625230563,EDS 204R,B01,507331,Heinzman; Erica M.,14,0,30,16
1715625231591,EDS 206R,A00,507332,Staff,0,4,30,30
1715625231591,EDS 206R,B00,507343,Staff,15,0,30,15
1715625232617,EDS 250,A00,507344,Hemans; Patricia Ann Benitez,20,0,40,20
1715625233641,EDS 281,A00,507345,Daly; Alan J.,18,0,18,0
1715625234728,EDS 284,A00,507350,Daly; Alan J.,16,0,16,0
1715625235752,EDS 286,A00,507359,Fine; Sarah,18,0,18,0
1715625236778,EDS 289C,A01,507361,Daly; Alan J.,18,0,18,0
1715625237809,EDS 290,A00,507366,Hofstetter; Carolyn,15,0,15,0
1715625238838,LIGM 5A,A00,507421,Fischer-Grunski; Eva K,17,0,20,3
1715625239863,LIGM 5B,A00,507423,Fischer-Grunski; Eva K,19,0,20,1
1715625240892,LIGM 5C,A00,507425,Fischer-Grunski; Eva K,19,0,20,1
1715625241922,LIIT 5AS,A00,507427,Carnelos; Chiara,20,0,20,0
1715625242950,LIIT 5BS,A00,507430,Carnelos; Chiara,20,0,20,0
1715625243975,LIIT 5CS,A00,507432,Carnelos; Chiara,20,0,20,0
1715625245001,LISP 5A,A00,507541,Munoz Sanchez; Alicia,11,0,20,9
1715625246026,LISP 5B,A00,507671,Munoz Sanchez; Alicia,9,0,20,11
1715625247056,LISP 5C,A00,507696,Munoz Sanchez; Alicia,9,0,20,11
1715625248081,MAE 197,001,528363,Boechler; Nicholas Sebastia,9998,0,9999,1
1715625249107,MATH 197,001,523477,Kedlaya; Kiran S.,9994,0,9999,5
1715625249107,MATH 197,002,563811,Zhang; Danna,9994,0,9999,5
1715625249107,MATH 197,003,628552,Dumitriu; Ioana,9998,0,9999,1
1715625249107,MATH 197,004,660885,Floyd; Eric,9998,0,9999,1
1715625250134,MCWP 40R,A00,518780,Staff,2,0,20,18
1715625250134,MCWP 40R,B00,518781,Staff,11,0,20,9
1715625250134,MCWP 40R,C00,518783,Staff,5,0,20,15
1715625251164,MCWP 50R,A00,518791,Staff,0,1,20,20
1715625251164,MCWP 50R,B00,518792,Staff,0,2,20,20
1715625251164,MCWP 50R,C00,518793,Staff,0,4,20,20
1715625251164,MCWP 50R,D00,518794,Staff,0,1,20,20
1715625251164,MCWP 50R,E00,518795,Staff,0,2,20,20
1715625251164,MCWP 50R,F00,518796,Staff,0,1,20,20
1715625251164,MCWP 50R,G00,518797,Staff,0,1,20,20
1715625252191,MMW 12R,A01,514034,Herbst; Matthew,0,2,16,16
1715625252191,MMW 12R,A02,514035,Herbst; Matthew,0,0,16,16
1715625253217,MMW 13R,A01,514037,Staff,0,5,16,16
1715625253217,MMW 13R,A02,514039,Staff,0,5,16,16
1715625253217,MMW 13R,A03,628519,Staff,0,4,16,16
1715625255270,SIO 295LS,A00,523233,Staff,10,0,30,20
1715625256296,SIO 295S,A00,523232,Staff,10,0,30,20
1715625257328,SIOC 290S,A01,637330,Merrifield; Mark A,23,0,30,7
1715625258357,SIOC 291S,A01,637333,Gabriel; Corey John,23,0,30,7
1715625259384,SOCI 117,A01,494376,Staff,0,5,5,5
1715625260410,WES 237B,A00,494380,Staff,10,0,20,10
1715625262482,AESE 279B,A00,494370,Wade; Jon P,0,0,33,33
1715625263506,AIP 97,001,660915,Van Den Einde; Yael Dahlia,9998,0,9999,1
1715625264536,AIP 197,001,627712,Vespa; Emanuel Ignacio,9995,0,9999,4
1715625264536,AIP 197,002,650778,Amir; On,9998,0,9999,1
1715625264536,AIP 197,003,650933,Avenancio-Leon; Carlos,9998,0,9999,1
1715625264536,AIP 197,004,658530,Heyman; Gail D.,9998,0,9999,1
1715625264536,AIP 197,005,658631,Neal; Sonya E,9998,0,9999,1
1715625264536,AIP 197,006,658671,Du; Songzi,9998,0,9999,1
1715625265561,ANAR 135S,A00,494369,Braswell; Geoffrey E.,0,0,0,0
1715625266587,BENG 196,001,628496,Engler; Adam J.,9998,0,9999,1
1715625266587,BENG 196,002,660916,Watson; John Thomas,9999,0,9999,0
1715625267613,BISP 197,001,650773,Wilhelm; James E.,9994,0,9999,5
1715625267613,BISP 197,002,658904,Coleman; Aaron B.,9998,0,9999,1
1715625268638,CAT 124RS,A01,519847,Geibel; William,0,0,20,20
1715625269663,CAT 125RS,A01,515971,Geibel; William,0,0,20,20
1715625270688,CLRE 250,A00,511389,Morris; Sheldon,9992,0,9999,7
1715625271717,CLRE 251,A00,507176,Mehta; Ravindra L.,9992,0,9999,7
1715625271717,CLRE 251,B00,511410,Mehta; Ravindra L.,9998,0,9999,1
1715625272742,CLRE 252,A00,507189,Cuomo; Raphael Eduardo,9994,0,9999,5
1715625273770,CLRE 253,A00,507199,Vaida; Florin,9994,0,9999,5
1715625273770,CLRE 253,B00,507202,Vaida; Florin,9999,0,9999,0
1715625274797,CLRE 259,A00,507211,Patel; Hemal,9996,0,9999,3
1715625275826,CLRE 260,A00,507221,Cuomo; Raphael Eduardo,9999,0,9999,0
1715625276853,CLRE 297,001,507242,Cuomo; Raphael Eduardo,9999,0,9999,0
1715625277881,COGS 197,001,638244,Voytek; Bradley Thomas,9997,0,9999,2
1715625278920,CSE 191,A00,516875,Minnes Kemp; Mor Mia,9991,0,9999,8
1715625279945,CSE 197,001,637388,Minnes Kemp; Mor Mia,9992,0,9999,7
1715625280976,CSS 201S,A01,494383,Mignozzetti; Umberto,35,0,35,0
1715625282008,CSS 202S,A01,494387,Mignozzetti; Umberto,35,0,35,0
1715625283038,DSC 197,001,628532,Eldridge; Justin Matthew,9995,0,9999,4
1715625284066,EAP 100,A00,516065,Staff,9799,0,9999,200
1715625285095,ECE 45,A01,507414,Staff,31,0,60,29
1715625287148,ECE 111,A01,507420,Staff,11,0,50,39
1715625288174,ECE 197,001,548057,Sievenpiper; Daniel F.,9991,0,9999,8
1715625289204,EDS 115,A00,507243,Choi; Bailey Miyeon,7,0,28,21
1715625290232,EDS 117,A01,494379,Staff,0,6,34,34
1715625291259,EDS 125,A00,507246,Hopkins; Megan Beth,8,0,30,22
1715625292286,EDS 128A,A01,507264,Fargason; Sharon Gayle,6,0,26,20
1715625293314,EDS 128B,A01,507293,Pappas; Elizabeth,10,0,30,20
1715625294366,EDS 139,A00,507294,Fargason; Sharon Gayle,10,0,30,20
1715625294366,EDS 139,B00,507313,Pappas; Elizabeth,11,0,30,19
1715625295391,EDS 201,A00,507315,Staff,10,0,30,20
1715625296416,EDS 203,A01,507317,Halter; Christopher P.,10,0,30,20
1715625297441,EDS 204R,A01,507319,Halter; Christopher P.,0,3,30,30
1715625297441,EDS 204R,B01,507331,Heinzman; Erica M.,14,0,30,16
1715625298467,EDS 206R,A00,507332,Staff,0,4,30,30
1715625298467,EDS 206R,B00,507343,Staff,15,0,30,15
1715625299492,EDS 250,A00,507344,Hemans; Patricia Ann Benitez,20,0,40,20
1715625300518,EDS 281,A00,507345,Daly; Alan J.,18,0,18,0
1715625301546,EDS 284,A00,507350,Daly; Alan J.,16,0,16,0
1715625302573,EDS 286,A00,507359,Fine; Sarah,18,0,18,0
1715625303600,EDS 289C,A01,507361,Daly; Alan J.,18,0,18,0
1715625304629,EDS 290,A00,507366,Hofstetter; Carolyn,15,0,15,0
1715625305654,LIGM 5A,A00,507421,Fischer-Grunski; Eva K,17,0,20,3
1715625306679,LIGM 5B,A00,507423,Fischer-Grunski; Eva K,19,0,20,1
1715625307710,LIGM 5C,A00,507425,Fischer-Grunski; Eva K,19,0,20,1
1715625308742,LIIT 5AS,A00,507427,Carnelos; Chiara,20,0,20,0
1715625309768,LIIT 5BS,A00,507430,Carnelos; Chiara,20,0,20,0
1715625310795,LIIT 5CS,A00,507432,Carnelos; Chiara,20,0,20,0
1715625311824,LISP 5A,A00,507541,Munoz Sanchez; Alicia,11,0,20,9
1715625312849,LISP 5B,A00,507671,Munoz Sanchez; Alicia,9,0,20,11
1715625313878,LISP 5C,A00,507696,Munoz Sanchez; Alicia,9,0,20,11
1715625314905,MAE 197,001,528363,Boechler; Nicholas Sebastia,9998,0,9999,1
1715625315932,MATH 197,001,523477,Kedlaya; Kiran S.,9994,0,9999,5
1715625315932,MATH 197,002,563811,Zhang; Danna,9994,0,9999,5
1715625315932,MATH 197,003,628552,Dumitriu; Ioana,9998,0,9999,1
1715625315932,MATH 197,004,660885,Floyd; Eric,9998,0,9999,1
1715625316957,MCWP 40R,A00,518780,Staff,2,0,20,18
1715625316957,MCWP 40R,B00,518781,Staff,11,0,20,9
1715625316957,MCWP 40R,C00,518783,Staff,5,0,20,15
1715625317987,MCWP 50R,A00,518791,Staff,0,1,20,20
1715625317987,MCWP 50R,B00,518792,Staff,0,2,20,20
1715625317987,MCWP 50R,C00,518793,Staff,0,4,20,20
1715625317987,MCWP 50R,D00,518794,Staff,0,1,20,20
1715625317987,MCWP 50R,E00,518795,Staff,0,2,20,20
1715625317987,MCWP 50R,F00,518796,Staff,0,1,20,20
1715625317987,MCWP 50R,G00,518797,Staff,0,1,20,20
1715625319014,MMW 12R,A01,514034,Herbst; Matthew,0,2,16,16
1715625319014,MMW 12R,A02,514035,Herbst; Matthew,0,0,16,16
1715625320041,MMW 13R,A01,514037,Staff,0,5,16,16
1715625320041,MMW 13R,A02,514039,Staff,0,5,16,16
1715625320041,MMW 13R,A03,628519,Staff,0,4,16,16
1715625322090,SIO 295LS,A00,523233,Staff,10,0,30,20
1715625323116,SIO 295S,A00,523232,Staff,10,0,30,20
1715625324142,SIOC 290S,A01,637330,Merrifield; Mark A,23,0,30,7
1715625325171,SIOC 291S,A01,637333,Gabriel; Corey John,23,0,30,7
1715625326200,SOCI 117,A01,494376,Staff,0,5,5,5
1715625327225,WES 237B,A00,494380,Staff,10,0,20,10
1715625329284,AESE 279B,A00,494370,Wade; Jon P,0,0,33,33
1715625330310,AIP 97,001,660915,Van Den Einde; Yael Dahlia,9998,0,9999,1
1715625331340,AIP 197,001,627712,Vespa; Emanuel Ignacio,9995,0,9999,4
1715625331340,AIP 197,002,650778,Amir; On,9998,0,9999,1
1715625331340,AIP 197,003,650933,Avenancio-Leon; Carlos,9998,0,9999,1
1715625331340,AIP 197,004,658530,Heyman; Gail D.,9998,0,9999,1
1715625331340,AIP 197,005,658631,Neal; Sonya E,9998,0,9999,1
1715625331340,AIP 197,006,658671,Du; Songzi,9998,0,9999,1
1715625332367,ANAR 135S,A00,494369,Braswell; Geoffrey E.,0,0,0,0
1715625333393,BENG 196,001,628496,Engler; Adam J.,9998,0,9999,1
1715625333393,BENG 196,002,660916,Watson; John Thomas,9999,0,9999,0
1715625334418,BISP 197,001,650773,Wilhelm; James E.,9994,0,9999,5
1715625334418,BISP 197,002,658904,Coleman; Aaron B.,9998,0,9999,1
1715625335446,CAT 124RS,A01,519847,Geibel; William,0,0,20,20
1715625336472,CAT 125RS,A01,515971,Geibel; William,0,0,20,20
1715625337500,CLRE 250,A00,511389,Morris; Sheldon,9992,0,9999,7
1715625338526,CLRE 251,A00,507176,Mehta; Ravindra L.,9992,0,9999,7
1715625338526,CLRE 251,B00,511410,Mehta; Ravindra L.,9998,0,9999,1
1715625339553,CLRE 252,A00,507189,Cuomo; Raphael Eduardo,9994,0,9999,5
1715625340580,CLRE 253,A00,507199,Vaida; Florin,9994,0,9999,5
1715625340580,CLRE 253,B00,507202,Vaida; Florin,9999,0,9999,0
1715625341606,CLRE 259,A00,507211,Patel; Hemal,9996,0,9999,3
1715625342632,CLRE 260,A00,507221,Cuomo; Raphael Eduardo,9999,0,9999,0
1715625343657,CLRE 297,001,507242,Cuomo; Raphael Eduardo,9999,0,9999,0
1715625344689,COGS 197,001,638244,Voytek; Bradley Thomas,9997,0,9999,2
1715625345716,CSE 191,A00,516875,Minnes Kemp; Mor Mia,9991,0,9999,8
1715625346741,CSE 197,001,637388,Minnes Kemp; Mor Mia,9992,0,9999,7
1715625347771,CSS 201S,A01,494383,Mignozzetti; Umberto,35,0,35,0
1715625348800,CSS 202S,A01,494387,Mignozzetti; Umberto,35,0,35,0
1715625349823,DSC 197,001,628532,Eldridge; Justin Matthew,9995,0,9999,4
1715625350851,EAP 100,A00,516065,Staff,9799,0,9999,200
1715625351881,ECE 45,A01,507414,Staff,31,0,60,29
1715625353938,ECE 111,A01,507420,Staff,11,0,50,39
1715625354962,ECE 197,001,548057,Sievenpiper; Daniel F.,9991,0,9999,8
1715625355991,EDS 115,A00,507243,Choi; Bailey Miyeon,7,0,28,21
1715625357020,EDS 117,A01,494379,Staff,0,6,34,34
1715625358046,EDS 125,A00,507246,Hopkins; Megan Beth,8,0,30,22
1715625359074,EDS 128A,A01,507264,Fargason; Sharon Gayle,6,0,26,20
1715625360099,EDS 128B,A01,507293,Pappas; Elizabeth,10,0,30,20
1715625361124,EDS 139,A00,507294,Fargason; Sharon Gayle,10,0,30,20
1715625361124,EDS 139,B00,507313,Pappas; Elizabeth,11,0,30,19
1715625362151,EDS 201,A00,507315,Staff,10,0,30,20
1715625363176,EDS 203,A01,507317,Halter; Christopher P.,10,0,30,20
1715625364200,EDS 204R,A01,507319,Halter; Christopher P.,0,3,30,30
1715625364200,EDS 204R,B01,507331,Heinzman; Erica M.,14,0,30,16
1715625365225,EDS 206R,A00,507332,Staff,0,4,30,30
1715625365225,EDS 206R,B00,507343,Staff,15,0,30,15
1715625366254,EDS 250,A00,507344,Hemans; Patricia Ann Benitez,20,0,40,20
1715625367280,EDS 281,A00,507345,Daly; Alan J.,18,0,18,0
1715625368308,EDS 284,A00,507350,Daly; Alan J.,16,0,16,0
1715625369335,EDS 286,A00,507359,Fine; Sarah,18,0,18,0
1715625370361,EDS 289C,A01,507361,Daly; Alan J.,18,0,18,0
1715625371390,EDS 290,A00,507366,Hofstetter; Carolyn,15,0,15,0
1715625372415,LIGM 5A,A00,507421,Fischer-Grunski; Eva K,17,0,20,3
1715625373445,LIGM 5B,A00,507423,Fischer-Grunski; Eva K,19,0,20,1
1715625374472,LIGM 5C,A00,507425,Fischer-Grunski; Eva K,19,0,20,1
1715625375501,LIIT 5AS,A00,507427,Carnelos; Chiara,20,0,20,0
1715625376530,LIIT 5BS,A00,507430,Carnelos; Chiara,20,0,20,0
1715625377555,LIIT 5CS,A00,507432,Carnelos; Chiara,20,0,20,0
1715625378586,LISP 5A,A00,507541,Munoz Sanchez; Alicia,11,0,20,9
1715625379612,LISP 5B,A00,507671,Munoz Sanchez; Alicia,9,0,20,11
1715625380638,LISP 5C,A00,507696,Munoz Sanchez; Alicia,9,0,20,11
1715625381665,MAE 197,001,528363,Boechler; Nicholas Sebastia,9998,0,9999,1
1715625382690,MATH 197,001,523477,Kedlaya; Kiran S.,9994,0,9999,5
1715625382690,MATH 197,002,563811,Zhang; Danna,9994,0,9999,5
1715625382690,MATH 197,003,628552,Dumitriu; Ioana,9998,0,9999,1
1715625382690,MATH 197,004,660885,Floyd; Eric,9998,0,9999,1
1715625383717,MCWP 40R,A00,518780,Staff,2,0,20,18
1715625383717,MCWP 40R,B00,518781,Staff,11,0,20,9
1715625383717,MCWP 40R,C00,518783,Staff,5,0,20,15
1715625384744,MCWP 50R,A00,518791,Staff,0,1,20,20
1715625384744,MCWP 50R,B00,518792,Staff,0,2,20,20
1715625384744,MCWP 50R,C00,518793,Staff,0,4,20,20
1715625384744,MCWP 50R,D00,518794,Staff,0,1,20,20
1715625384744,MCWP 50R,E00,518795,Staff,0,2,20,20
1715625384744,MCWP 50R,F00,518796,Staff,0,1,20,20
1715625384744,MCWP 50R,G00,518797,Staff,0,1,20,20
1715625385770,MMW 12R,A01,514034,Herbst; Matthew,0,2,16,16
1715625385770,MMW 12R,A02,514035,Herbst; Matthew,0,0,16,16
1715625386795,MMW 13R,A01,514037,Staff,0,5,16,16
1715625386795,MMW 13R,A02,514039,Staff,0,5,16,16
1715625386795,MMW 13R,A03,628519,Staff,0,4,16,16
1715625388849,SIO 295LS,A00,523233,Staff,10,0,30,20
1715625389877,SIO 295S,A00,523232,Staff,10,0,30,20
1715625390903,SIOC 290S,A01,637330,Merrifield; Mark A,23,0,30,7
1715625391931,SIOC 291S,A01,637333,Gabriel; Corey John,23,0,30,7
1715625392966,SOCI 117,A01,494376,Staff,0,5,5,5
1715625393990,WES 237B,A00,494380,Staff,10,0,20,10
1715625396073,AESE 279B,A00,494370,Wade; Jon P,0,0,33,33
1715625397099,AIP 97,001,660915,Van Den Einde; Yael Dahlia,9998,0,9999,1
1715625398125,AIP 197,001,627712,Vespa; Emanuel Ignacio,9995,0,9999,4
1715625398125,AIP 197,002,650778,Amir; On,9998,0,9999,1
1715625398125,AIP 197,003,650933,Avenancio-Leon; Carlos,9998,0,9999,1
1715625398125,AIP 197,004,658530,Heyman; Gail D.,9998,0,9999,1
1715625398125,AIP 197,005,658631,Neal; Sonya E,9998,0,9999,1
1715625398125,AIP 197,006,658671,Du; Songzi,9998,0,9999,1
1715625399152,ANAR 135S,A00,494369,Braswell; Geoffrey E.,0,0,0,0
1715625400178,BENG 196,001,628496,Engler; Adam J.,9998,0,9999,1
1715625400178,BENG 196,002,660916,Watson; John Thomas,9999,0,9999,0
1715625401202,BISP 197,001,650773,Wilhelm; James E.,9994,0,9999,5
1715625401202,BISP 197,002,658904,Coleman; Aaron B.,9998,0,9999,1
1715625402235,CAT 124RS,A01,519847,Geibel; William,0,0,20,20
1715625403260,CAT 125RS,A01,515971,Geibel; William,0,0,20,20
1715625404285,CLRE 250,A00,511389,Morris; Sheldon,9992,0,9999,7
1715625405315,CLRE 251,A00,507176,Mehta; Ravindra L.,9992,0,9999,7
1715625405315,CLRE 251,B00,511410,Mehta; Ravindra L.,9998,0,9999,1
1715625406339,CLRE 252,A00,507189,Cuomo; Raphael Eduardo,9994,0,9999,5
1715625407365,CLRE 253,A00,507199,Vaida; Florin,9994,0,9999,5
1715625407365,CLRE 253,B00,507202,Vaida; Florin,9999,0,9999,0
1715625408461,CLRE 259,A00,507211,Patel; Hemal,9996,0,9999,3
1715625409489,CLRE 260,A00,507221,Cuomo; Raphael Eduardo,9999,0,9999,0
1715625410517,CLRE 297,001,507242,Cuomo; Raphael Eduardo,9999,0,9999,0
1715625411542,COGS 197,001,638244,Voytek; Bradley Thomas,9997,0,9999,2
1715625412568,CSE 191,A00,516875,Minnes Kemp; Mor Mia,9991,0,9999,8
1715625413592,CSE 197,001,637388,Minnes Kemp; Mor Mia,9992,0,9999,7
1715625414621,CSS 201S,A01,494383,Mignozzetti; Umberto,35,0,35,0
1715625415650,CSS 202S,A01,494387,Mignozzetti; Umberto,35,0,35,0
1715625416678,DSC 197,001,628532,Eldridge; Justin Matthew,9995,0,9999,4
1715625417705,EAP 100,A00,516065,Staff,9799,0,9999,200
1715625418735,ECE 45,A01,507414,Staff,31,0,60,29
1715625420789,ECE 111,A01,507420,Staff,11,0,50,39
1715625421813,ECE 197,001,548057,Sievenpiper; Daniel F.,9991,0,9999,8
1715625422840,EDS 115,A00,507243,Choi; Bailey Miyeon,7,0,28,21
1715625423879,EDS 117,A01,494379,Staff,0,6,34,34
1715625424908,EDS 125,A00,507246,Hopkins; Megan Beth,8,0,30,22
1715625425937,EDS 128A,A01,507264,Fargason; Sharon Gayle,6,0,26,20
1715625426967,EDS 128B,A01,507293,Pappas; Elizabeth,10,0,30,20
1715625427992,EDS 139,A00,507294,Fargason; Sharon Gayle,10,0,30,20
1715625427992,EDS 139,B00,507313,Pappas; Elizabeth,11,0,30,19
1715625429016,EDS 201,A00,507315,Staff,10,0,30,20
1715625430042,EDS 203,A01,507317,Halter; Christopher P.,10,0,30,20
1715625431068,EDS 204R,A01,507319,Halter; Christopher P.,0,3,30,30
1715625431068,EDS 204R,B01,507331,Heinzman; Erica M.,14,0,30,16
1715625432094,EDS 206R,A00,507332,Staff,0,4,30,30
1715625432094,EDS 206R,B00,507343,Staff,15,0,30,15
1715625433121,EDS 250,A00,507344,Hemans; Patricia Ann Benitez,20,0,40,20
1715625434147,EDS 281,A00,507345,Daly; Alan J.,18,0,18,0
1715625435172,EDS 284,A00,507350,Daly; Alan J.,16,0,16,0
1715625436200,EDS 286,A00,507359,Fine; Sarah,18,0,18,0
1715625437225,EDS 289C,A01,507361,Daly; Alan J.,18,0,18,0
1715625438249,EDS 290,A00,507366,Hofstetter; Carolyn,15,0,15,0
1715625439275,LIGM 5A,A00,507421,Fischer-Grunski; Eva K,17,0,20,3
1715625440302,LIGM 5B,A00,507423,Fischer-Grunski; Eva K,19,0,20,1
1715625441328,LIGM 5C,A00,507425,Fischer-Grunski; Eva K,19,0,20,1
1715625442357,LIIT 5AS,A00,507427,Carnelos; Chiara,20,0,20,0
1715625443386,LIIT 5BS,A00,507430,Carnelos; Chiara,20,0,20,0
1715625444412,LIIT 5CS,A00,507432,Carnelos; Chiara,20,0,20,0
1715625445439,LISP 5A,A00,507541,Munoz Sanchez; Alicia,11,0,20,9
1715625446468,LISP 5B,A00,507671,Munoz Sanchez; Alicia,9,0,20,11
1715625447495,LISP 5C,A00,507696,Munoz Sanchez; Alicia,9,0,20,11
1715625448523,MAE 197,001,528363,Boechler; Nicholas Sebastia,9998,0,9999,1
1715625449555,MATH 197,001,523477,Kedlaya; Kiran S.,9994,0,9999,5
1715625449555,MATH 197,002,563811,Zhang; Danna,9994,0,9999,5
1715625449555,MATH 197,003,628552,Dumitriu; Ioana,9998,0,9999,1
1715625449555,MATH 197,004,660885,Floyd; Eric,9998,0,9999,1
1715625450584,MCWP 40R,A00,518780,Staff,2,0,20,18
1715625450584,MCWP 40R,B00,518781,Staff,11,0,20,9
1715625450584,MCWP 40R,C00,518783,Staff,5,0,20,15
1715625451610,MCWP 50R,A00,518791,Staff,0,1,20,20
1715625451610,MCWP 50R,B00,518792,Staff,0,2,20,20
1715625451610,MCWP 50R,C00,518793,Staff,0,4,20,20
1715625451610,MCWP 50R,D00,518794,Staff,0,1,20,20
1715625451610,MCWP 50R,E00,518795,Staff,0,2,20,20
1715625451610,MCWP 50R,F00,518796,Staff,0,1,20,20
1715625451610,MCWP 50R,G00,518797,Staff,0,1,20,20
1715625452637,MMW 12R,A01,514034,Herbst; Matthew,0,2,16,16
1715625452637,MMW 12R,A02,514035,Herbst; Matthew,0,0,16,16
1715625453665,MMW 13R,A01,514037,Staff,0,5,16,16
1715625453665,MMW 13R,A02,514039,Staff,0,5,16,16
1715625453665,MMW 13R,A03,628519,Staff,0,4,16,16
1715625455721,SIO 295LS,A00,523233,Staff,10,0,30,20
1715625456745,SIO 295S,A00,523232,Staff,10,0,30,20
1715625457770,SIOC 290S,A01,637330,Merrifield; Mark A,22,0,30,8
1715625458797,SIOC 291S,A01,637333,Gabriel; Corey John,22,0,30,8
1715625459821,SOCI 117,A01,494376,Staff,0,5,5,5
1715625460847,WES 237B,A00,494380,Staff,10,0,20,10
1715625462916,AESE 279B,A00,494370,Wade; Jon P,0,0,33,33
1715625463941,AIP 97,001,660915,Van Den Einde; Yael Dahlia,9998,0,9999,1
1715625464972,AIP 197,001,627712,Vespa; Emanuel Ignacio,9995,0,9999,4
1715625464972,AIP 197,002,650778,Amir; On,9998,0,9999,1
1715625464972,AIP 197,003,650933,Avenancio-Leon; Carlos,9998,0,9999,1
1715625464972,AIP 197,004,658530,Heyman; Gail D.,9998,0,9999,1
1715625464972,AIP 197,005,658631,Neal; Sonya E,9998,0,9999,1
1715625464972,AIP 197,006,658671,Du; Songzi,9998,0,9999,1
1715625465998,ANAR 135S,A00,494369,Braswell; Geoffrey E.,0,0,0,0
1715625467026,BENG 196,001,628496,Engler; Adam J.,9998,0,9999,1
1715625467026,BENG 196,002,660916,Watson; John Thomas,9999,0,9999,0
1715625468051,BISP 197,001,650773,Wilhelm; James E.,9994,0,9999,5
1715625468051,BISP 197,002,658904,Coleman; Aaron B.,9998,0,9999,1
1715625469075,CAT 124RS,A01,519847,Geibel; William,0,0,20,20
1715625470099,CAT 125RS,A01,515971,Geibel; William,0,0,20,20
1715625471126,CLRE 250,A00,511389,Morris; Sheldon,9992,0,9999,7
1715625472152,CLRE 251,A00,507176,Mehta; Ravindra L.,9992,0,9999,7
1715625472152,CLRE 251,B00,511410,Mehta; Ravindra L.,9998,0,9999,1
1715625473180,CLRE 252,A00,507189,Cuomo; Raphael Eduardo,9994,0,9999,5
1715625474212,CLRE 253,A00,507199,Vaida; Florin,9994,0,9999,5
1715625474212,CLRE 253,B00,507202,Vaida; Florin,9999,0,9999,0
1715625475237,CLRE 259,A00,507211,Patel; Hemal,9996,0,9999,3
1715625476266,CLRE 260,A00,507221,Cuomo; Raphael Eduardo,9999,0,9999,0
1715625477291,CLRE 297,001,507242,Cuomo; Raphael Eduardo,9999,0,9999,0
1715625478313,COGS 197,001,638244,Voytek; Bradley Thomas,9997,0,9999,2
1715625479341,CSE 191,A00,516875,Minnes Kemp; Mor Mia,9991,0,9999,8
1715625480367,CSE 197,001,637388,Minnes Kemp; Mor Mia,9992,0,9999,7
1715625481393,CSS 201S,A01,494383,Mignozzetti; Umberto,35,0,35,0
1715625482416,CSS 202S,A01,494387,Mignozzetti; Umberto,35,0,35,0
1715625483444,DSC 197,001,628532,Eldridge; Justin Matthew,9995,0,9999,4
1715625484473,EAP 100,A00,516065,Staff,9799,0,9999,200
1715625485497,ECE 45,A01,507414,Staff,31,0,60,29
1715625487546,ECE 111,A01,507420,Staff,11,0,50,39
1715625488572,ECE 197,001,548057,Sievenpiper; Daniel F.,9991,0,9999,8
1715625489597,EDS 115,A00,507243,Choi; Bailey Miyeon,7,0,28,21
1715625490624,EDS 117,A01,494379,Staff,0,6,34,34
1715625491648,EDS 125,A00,507246,Hopkins; Megan Beth,8,0,30,22
1715625492678,EDS 128A,A01,507264,Fargason; Sharon Gayle,6,0,26,20
1715625493703,EDS 128B,A01,507293,Pappas; Elizabeth,10,0,30,20
1715625494736,EDS 139,A00,507294,Fargason; Sharon Gayle,10,0,30,20
1715625494736,EDS 139,B00,507313,Pappas; Elizabeth,11,0,30,19
1715625495764,EDS 201,A00,507315,Staff,10,0,30,20
1715625496789,EDS 203,A01,507317,Halter; Christopher P.,10,0,30,20
1715625497813,EDS 204R,A01,507319,Halter; Christopher P.,0,3,30,30
1715625497813,EDS 204R,B01,507331,Heinzman; Erica M.,14,0,30,16
1715625498839,EDS 206R,A00,507332,Staff,0,4,30,30
1715625498839,EDS 206R,B00,507343,Staff,15,0,30,15
1715625499866,EDS 250,A00,507344,Hemans; Patricia Ann Benitez,20,0,40,20
1715625500890,EDS 281,A00,507345,Daly; Alan J.,18,0,18,0
1715625501914,EDS 284,A00,507350,Daly; Alan J.,16,0,16,0
1715625502939,EDS 286,A00,507359,Fine; Sarah,18,0,18,0
1715625503964,EDS 289C,A01,507361,Daly; Alan J.,18,0,18,0
1715625504990,EDS 290,A00,507366,Hofstetter; Carolyn,15,0,15,0
1715625506015,LIGM 5A,A00,507421,Fischer-Grunski; Eva K,17,0,20,3
1715625507043,LIGM 5B,A00,507423,Fischer-Grunski; Eva K,19,0,20,1
1715625508068,LIGM 5C,A00,507425,Fischer-Grunski; Eva K,19,0,20,1
1715625509094,LIIT 5AS,A00,507427,Carnelos; Chiara,20,0,20,0
1715625510123,LIIT 5BS,A00,507430,Carnelos; Chiara,20,0,20,0
1715625511147,LIIT 5CS,A00,507432,Carnelos; Chiara,20,0,20,0
1715625512230,LISP 5A,A00,507541,Munoz Sanchez; Alicia,11,0,20,9
1715625513255,LISP 5B,A00,507671,Munoz Sanchez; Alicia,9,0,20,11
1715625514281,LISP 5C,A00,507696,Munoz Sanchez; Alicia,9,0,20,11
1715625515306,MAE 197,001,528363,Boechler; Nicholas Sebastia,9998,0,9999,1
1715625516333,MATH 197,001,523477,Kedlaya; Kiran S.,9994,0,9999,5
1715625516333,MATH 197,002,563811,Zhang; Danna,9994,0,9999,5
1715625516333,MATH 197,003,628552,Dumitriu; Ioana,9998,0,9999,1
1715625516333,MATH 197,004,660885,Floyd; Eric,9998,0,9999,1
1715625517358,MCWP 40R,A00,518780,Staff,2,0,20,18
1715625517358,MCWP 40R,B00,518781,Staff,11,0,20,9
1715625517358,MCWP 40R,C00,518783,Staff,5,0,20,15
1715625518384,MCWP 50R,A00,518791,Staff,0,1,20,20
1715625518384,MCWP 50R,B00,518792,Staff,0,2,20,20
1715625518384,MCWP 50R,C00,518793,Staff,0,4,20,20
1715625518384,MCWP 50R,D00,518794,Staff,0,1,20,20
1715625518384,MCWP 50R,E00,518795,Staff,0,2,20,20
1715625518384,MCWP 50R,F00,518796,Staff,0,1,20,20
1715625518384,MCWP 50R,G00,518797,Staff,0,1,20,20
1715625519409,MMW 12R,A01,514034,Herbst; Matthew,0,2,16,16
1715625519409,MMW 12R,A02,514035,Herbst; Matthew,0,0,16,16
1715625520438,MMW 13R,A01,514037,Staff,0,5,16,16
1715625520438,MMW 13R,A02,514039,Staff,0,5,16,16
1715625520438,MMW 13R,A03,628519,Staff,0,4,16,16
1715625522493,SIO 295LS,A00,523233,Staff,10,0,30,20
1715625523521,SIO 295S,A00,523232,Staff,10,0,30,20
1715625524552,SIOC 290S,A01,637330,Merrifield; Mark A,22,0,30,8
1715625525578,SIOC 291S,A01,637333,Gabriel; Corey John,22,0,30,8
1715625526604,SOCI 117,A01,494376,Staff,0,5,5,5
1715625527629,WES 237B,A00,494380,Staff,10,0,20,10
1715625529691,AESE 279B,A00,494370,Wade; Jon P,0,0,33,33
1715625530717,AIP 97,001,660915,Van Den Einde; Yael Dahlia,9998,0,9999,1
1715625531744,AIP 197,001,627712,Vespa; Emanuel Ignacio,9995,0,9999,4
1715625531744,AIP 197,002,650778,Amir; On,9998,0,9999,1
1715625531744,AIP 197,003,650933,Avenancio-Leon; Carlos,9998,0,9999,1
1715625531744,AIP 197,004,658530,Heyman; Gail D.,9998,0,9999,1
1715625531744,AIP 197,005,658631,Neal; Sonya E,9998,0,9999,1
1715625531744,AIP 197,006,658671,Du; Songzi,9998,0,9999,1
1715625532771,ANAR 135S,A00,494369,Braswell; Geoffrey E.,0,0,0,0
1715625533795,BENG 196,001,628496,Engler; Adam J.,9998,0,9999,1
1715625533795,BENG 196,002,660916,Watson; John Thomas,9999,0,9999,0
1715625534824,BISP 197,001,650773,Wilhelm; James E.,9994,0,9999,5
1715625534824,BISP 197,002,658904,Coleman; Aaron B.,9998,0,9999,1
1715625535851,CAT 124RS,A01,519847,Geibel; William,0,0,20,20
1715625536877,CAT 125RS,A01,515971,Geibel; William,0,0,20,20
1715625537904,CLRE 250,A00,511389,Morris; Sheldon,9992,0,9999,7
1715625538930,CLRE 251,A00,507176,Mehta; Ravindra L.,9992,0,9999,7
1715625538930,CLRE 251,B00,511410,Mehta; Ravindra L.,9998,0,9999,1
1715625539956,CLRE 252,A00,507189,Cuomo; Raphael Eduardo,9994,0,9999,5
1715625540982,CLRE 253,A00,507199,Vaida; Florin,9994,0,9999,5
1715625540982,CLRE 253,B00,507202,Vaida; Florin,9999,0,9999,0
1715625542009,CLRE 259,A00,507211,Patel; Hemal,9996,0,9999,3
1715625543035,CLRE 260,A00,507221,Cuomo; Raphael Eduardo,9999,0,9999,0
1715625544065,CLRE 297,001,507242,Cuomo; Raphael Eduardo,9999,0,9999,0
1715625545092,COGS 197,001,638244,Voytek; Bradley Thomas,9997,0,9999,2
1715625546123,CSE 191,A00,516875,Minnes Kemp; Mor Mia,9991,0,9999,8
1715625547149,CSE 197,001,637388,Minnes Kemp; Mor Mia,9992,0,9999,7
1715625548177,CSS 201S,A01,494383,Mignozzetti; Umberto,35,0,35,0
1715625549203,CSS 202S,A01,494387,Mignozzetti; Umberto,35,0,35,0
1715625550233,DSC 197,001,628532,Eldridge; Justin Matthew,9995,0,9999,4
1715625551258,EAP 100,A00,516065,Staff,9799,0,9999,200
1715625552284,ECE 45,A01,507414,Staff,31,0,60,29
1715625554335,ECE 111,A01,507420,Staff,11,0,50,39
1715625555360,ECE 197,001,548057,Sievenpiper; Daniel F.,9991,0,9999,8
1715625556388,EDS 115,A00,507243,Choi; Bailey Miyeon,7,0,28,21
1715625557412,EDS 117,A01,494379,Staff,0,6,34,34
1715625558440,EDS 125,A00,507246,Hopkins; Megan Beth,8,0,30,22
1715625559469,EDS 128A,A01,507264,Fargason; Sharon Gayle,6,0,26,20
1715625560502,EDS 128B,A01,507293,Pappas; Elizabeth,10,0,30,20
1715625561527,EDS 139,A00,507294,Fargason; Sharon Gayle,10,0,30,20
1715625561527,EDS 139,B00,507313,Pappas; Elizabeth,11,0,30,19
1715625562554,EDS 201,A00,507315,Staff,10,0,30,20
1715625563582,EDS 203,A01,507317,Halter; Christopher P.,10,0,30,20
1715625564608,EDS 204R,A01,507319,Halter; Christopher P.,0,3,30,30
1715625564608,EDS 204R,B01,507331,Heinzman; Erica M.,14,0,30,16
1715625565634,EDS 206R,A00,507332,Staff,0,4,30,30
1715625565634,EDS 206R,B00,507343,Staff,15,0,30,15
1715625566663,EDS 250,A00,507344,Hemans; Patricia Ann Benitez,20,0,40,20
1715625567688,EDS 281,A00,507345,Daly; Alan J.,18,0,18,0
1715625568713,EDS 284,A00,507350,Daly; Alan J.,16,0,16,0
1715625569738,EDS 286,A00,507359,Fine; Sarah,18,0,18,0
1715625570763,EDS 289C,A01,507361,Daly; Alan J.,18,0,18,0
1715625571792,EDS 290,A00,507366,Hofstetter; Carolyn,15,0,15,0
1715625572817,LIGM 5A,A00,507421,Fischer-Grunski; Eva K,17,0,20,3
1715625573845,LIGM 5B,A00,507423,Fischer-Grunski; Eva K,19,0,20,1
1715625574870,LIGM 5C,A00,507425,Fischer-Grunski; Eva K,19,0,20,1
1715625575899,LIIT 5AS,A00,507427,Carnelos; Chiara,20,0,20,0
1715625576929,LIIT 5BS,A00,507430,Carnelos; Chiara,20,0,20,0
1715625577956,LIIT 5CS,A00,507432,Carnelos; Chiara,20,0,20,0
1715625578981,LISP 5A,A00,507541,Munoz Sanchez; Alicia,11,0,20,9
1715625580010,LISP 5B,A00,507671,Munoz Sanchez; Alicia,9,0,20,11
1715625581034,LISP 5C,A00,507696,Munoz Sanchez; Alicia,9,0,20,11
1715625582060,MAE 197,001,528363,Boechler; Nicholas Sebastia,9998,0,9999,1
1715625583090,MATH 197,001,523477,Kedlaya; Kiran S.,9994,0,9999,5
1715625583090,MATH 197,002,563811,Zhang; Danna,9994,0,9999,5
1715625583090,MATH 197,003,628552,Dumitriu; Ioana,9998,0,9999,1
1715625583090,MATH 197,004,660885,Floyd; Eric,9998,0,9999,1
1715625584115,MCWP 40R,A00,518780,Staff,2,0,20,18
1715625584115,MCWP 40R,B00,518781,Staff,11,0,20,9
1715625584115,MCWP 40R,C00,518783,Staff,5,0,20,15
1715625585146,MCWP 50R,A00,518791,Staff,0,1,20,20
1715625585146,MCWP 50R,B00,518792,Staff,0,2,20,20
1715625585146,MCWP 50R,C00,518793,Staff,0,4,20,20
1715625585146,MCWP 50R,D00,518794,Staff,0,1,20,20
1715625585146,MCWP 50R,E00,518795,Staff,0,2,20,20
1715625585146,MCWP 50R,F00,518796,Staff,0,1,20,20
1715625585146,MCWP 50R,G00,518797,Staff,0,1,20,20
1715625586172,MMW 12R,A01,514034,Herbst; Matthew,0,2,16,16
1715625586172,MMW 12R,A02,514035,Herbst; Matthew,0,0,16,16
1715625587199,MMW 13R,A01,514037,Staff,0,5,16,16
1715625587199,MMW 13R,A02,514039,Staff,0,5,16,16
1715625587199,MMW 13R,A03,628519,Staff,0,4,16,16
1715625589253,SIO 295LS,A00,523233,Staff,10,0,30,20
1715625590282,SIO 295S,A00,523232,Staff,10,0,30,20
1715625591309,SIOC 290S,A01,637330,Merrifield; Mark A,22,0,30,8
1715625592334,SIOC 291S,A01,637333,Gabriel; Corey John,22,0,30,8
1715625593362,SOCI 117,A01,494376,Staff,0,5,5,5
1715625594386,WES 237B,A00,494380,Staff,10,0,20,10
1715625596454,AESE 279B,A00,494370,Wade; Jon P,0,0,33,33
1715625597481,AIP 97,001,660915,Van Den Einde; Yael Dahlia,9998,0,9999,1
1715625598507,AIP 197,001,627712,Vespa; Emanuel Ignacio,9995,0,9999,4
1715625598507,AIP 197,002,650778,Amir; On,9998,0,9999,1
1715625598507,AIP 197,003,650933,Avenancio-Leon; Carlos,9998,0,9999,1
1715625598507,AIP 197,004,658530,Heyman; Gail D.,9998,0,9999,1
1715625598507,AIP 197,005,658631,Neal; Sonya E,9998,0,9999,1
1715625598507,AIP 197,006,658671,Du; Songzi,9998,0,9999,1
1715625599531,ANAR 135S,A00,494369,Braswell; Geoffrey E.,0,0,0,0
1715625600556,BENG 196,001,628496,Engler; Adam J.,9998,0,9999,1
1715625600556,BENG 196,002,660916,Watson; John Thomas,9999,0,9999,0
1715625601581,BISP 197,001,650773,Wilhelm; James E.,9994,0,9999,5
1715625601581,BISP 197,002,658904,Coleman; Aaron B.,9998,0,9999,1
1715625602609,CAT 124RS,A01,519847,Geibel; William,0,0,20,20
1715625603637,CAT 125RS,A01,515971,Geibel; William,0,0,20,20
1715625604666,CLRE 250,A00,511389,Morris; Sheldon,9992,0,9999,7
1715625605694,CLRE 251,A00,507176,Mehta; Ravindra L.,9992,0,9999,7
1715625605694,CLRE 251,B00,511410,Mehta; Ravindra L.,9998,0,9999,1
1715625606719,CLRE 252,A00,507189,Cuomo; Raphael Eduardo,9994,0,9999,5
1715625607748,CLRE 253,A00,507199,Vaida; Florin,9994,0,9999,5
1715625607748,CLRE 253,B00,507202,Vaida; Florin,9999,0,9999,0
1715625608776,CLRE 259,A00,507211,Patel; Hemal,9996,0,9999,3
1715625609803,CLRE 260,A00,507221,Cuomo; Raphael Eduardo,9999,0,9999,0
1715625610827,CLRE 297,001,507242,Cuomo; Raphael Eduardo,9999,0,9999,0
1715625611851,COGS 197,001,638244,Voytek; Bradley Thomas,9997,0,9999,2
1715625612878,CSE 191,A00,516875,Minnes Kemp; Mor Mia,9991,0,9999,8
1715625613906,CSE 197,001,637388,Minnes Kemp; Mor Mia,9992,0,9999,7
1715625614937,CSS 201S,A01,494383,Mignozzetti; Umberto,35,0,35,0
1715625616021,CSS 202S,A01,494387,Mignozzetti; Umberto,35,0,35,0
1715625617047,DSC 197,001,628532,Eldridge; Justin Matthew,9995,0,9999,4
1715625618071,EAP 100,A00,516065,Staff,9799,0,9999,200
1715625619099,ECE 45,A01,507414,Staff,31,0,60,29
1715625621158,ECE 111,A01,507420,Staff,11,0,50,39
1715625622183,ECE 197,001,548057,Sievenpiper; Daniel F.,9991,0,9999,8
1715625623210,EDS 115,A00,507243,Choi; Bailey Miyeon,7,0,28,21
1715625624236,EDS 117,A01,494379,Staff,0,6,34,34
1715625625262,EDS 125,A00,507246,Hopkins; Megan Beth,8,0,30,22
1715625626285,EDS 128A,A01,507264,Fargason; Sharon Gayle,6,0,26,20
1715625627312,EDS 128B,A01,507293,Pappas; Elizabeth,10,0,30,20
1715625628338,EDS 139,A00,507294,Fargason; Sharon Gayle,10,0,30,20
1715625628338,EDS 139,B00,507313,Pappas; Elizabeth,11,0,30,19
1715625629363,EDS 201,A00,507315,Staff,10,0,30,20
1715625630389,EDS 203,A01,507317,Halter; Christopher P.,10,0,30,20
1715625631418,EDS 204R,A01,507319,Halter; Christopher P.,0,3,30,30
1715625631418,EDS 204R,B01,507331,Heinzman; Erica M.,14,0,30,16
1715625632446,EDS 206R,A00,507332,Staff,0,4,30,30
1715625632446,EDS 206R,B00,507343,Staff,15,0,30,15
1715625633471,EDS 250,A00,507344,Hemans; Patricia Ann Benitez,20,0,40,20
1715625634501,EDS 281,A00,507345,Daly; Alan J.,18,0,18,0
1715625635525,EDS 284,A00,507350,Daly; Alan J.,16,0,16,0
1715625636552,EDS 286,A00,507359,Fine; Sarah,18,0,18,0
1715625637578,EDS 289C,A01,507361,Daly; Alan J.,18,0,18,0
1715625638603,EDS 290,A00,507366,Hofstetter; Carolyn,15,0,15,0
1715625639632,LIGM 5A,A00,507421,Fischer-Grunski; Eva K,17,0,20,3
1715625640663,LIGM 5B,A00,507423,Fischer-Grunski; Eva K,19,0,20,1
1715625641692,LIGM 5C,A00,507425,Fischer-Grunski; Eva K,19,0,20,1
1715625642717,LIIT 5AS,A00,507427,Carnelos; Chiara,20,0,20,0
1715625643742,LIIT 5BS,A00,507430,Carnelos; Chiara,20,0,20,0
1715625644767,LIIT 5CS,A00,507432,Carnelos; Chiara,20,0,20,0
1715625645794,LISP 5A,A00,507541,Munoz Sanchez; Alicia,11,0,20,9
1715625646818,LISP 5B,A00,507671,Munoz Sanchez; Alicia,9,0,20,11
1715625647848,LISP 5C,A00,507696,Munoz Sanchez; Alicia,9,0,20,11
1715625648872,MAE 197,001,528363,Boechler; Nicholas Sebastia,9998,0,9999,1
1715625649900,MATH 197,001,523477,Kedlaya; Kiran S.,9994,0,9999,5
1715625649900,MATH 197,002,563811,Zhang; Danna,9994,0,9999,5
1715625649900,MATH 197,003,628552,Dumitriu; Ioana,9998,0,9999,1
1715625649900,MATH 197,004,660885,Floyd; Eric,9998,0,9999,1
1715625650929,MCWP 40R,A00,518780,Staff,2,0,20,18
1715625650929,MCWP 40R,B00,518781,Staff,11,0,20,9
1715625650929,MCWP 40R,C00,518783,Staff,5,0,20,15
1715625651956,MCWP 50R,A00,518791,Staff,0,1,20,20
1715625651956,MCWP 50R,B00,518792,Staff,0,2,20,20
1715625651956,MCWP 50R,C00,518793,Staff,0,4,20,20
1715625651956,MCWP 50R,D00,518794,Staff,0,1,20,20
1715625651956,MCWP 50R,E00,518795,Staff,0,2,20,20
1715625651956,MCWP 50R,F00,518796,Staff,0,1,20,20
1715625651956,MCWP 50R,G00,518797,Staff,0,1,20,20
1715625652983,MMW 12R,A01,514034,Herbst; Matthew,0,2,16,16
1715625652983,MMW 12R,A02,514035,Herbst; Matthew,0,0,16,16
1715625654012,MMW 13R,A01,514037,Staff,0,5,16,16
1715625654012,MMW 13R,A02,514039,Staff,0,5,16,16
1715625654012,MMW 13R,A03,628519,Staff,0,4,16,16
1715625656062,SIO 295LS,A00,523233,Staff,10,0,30,20
1715625657088,SIO 295S,A00,523232,Staff,10,0,30,20
1715625658113,SIOC 290S,A01,637330,Merrifield; Mark A,22,0,30,8
1715625659139,SIOC 291S,A01,637333,Gabriel; Corey John,22,0,30,8
1715625660168,SOCI 117,A01,494376,Staff,0,5,5,5
1715625661193,WES 237B,A00,494380,Staff,10,0,20,10
1715625663256,AESE 279B,A00,494370,Wade; Jon P,0,0,33,33
1715625664280,AIP 97,001,660915,Van Den Einde; Yael Dahlia,9998,0,9999,1
1715625665306,AIP 197,001,627712,Vespa; Emanuel Ignacio,9995,0,9999,4
1715625665306,AIP 197,002,650778,Amir; On,9998,0,9999,1
1715625665306,AIP 197,003,650933,Avenancio-Leon; Carlos,9998,0,9999,1
1715625665306,AIP 197,004,658530,Heyman; Gail D.,9998,0,9999,1
1715625665306,AIP 197,005,658631,Neal; Sonya E,9998,0,9999,1
1715625665306,AIP 197,006,658671,Du; Songzi,9998,0,9999,1
1715625666334,ANAR 135S,A00,494369,Braswell; Geoffrey E.,0,0,0,0
1715625667361,BENG 196,001,628496,Engler; Adam J.,9998,0,9999,1
1715625667361,BENG 196,002,660916,Watson; John Thomas,9999,0,9999,0
1715625668389,BISP 197,001,650773,Wilhelm; James E.,9994,0,9999,5
1715625668389,BISP 197,002,658904,Coleman; Aaron B.,9998,0,9999,1
1715625669419,CAT 124RS,A01,519847,Geibel; William,0,0,20,20
1715625670444,CAT 125RS,A01,515971,Geibel; William,0,0,20,20
1715625671470,CLRE 250,A00,511389,Morris; Sheldon,9992,0,9999,7
1715625672495,CLRE 251,A00,507176,Mehta; Ravindra L.,9992,0,9999,7
1715625672495,CLRE 251,B00,511410,Mehta; Ravindra L.,9998,0,9999,1
1715625673520,CLRE 252,A00,507189,Cuomo; Raphael Eduardo,9994,0,9999,5
1715625674551,CLRE 253,A00,507199,Vaida; Florin,9994,0,9999,5
1715625674551,CLRE 253,B00,507202,Vaida; Florin,9999,0,9999,0
1715625675576,CLRE 259,A00,507211,Patel; Hemal,9996,0,9999,3
1715625676606,CLRE 260,A00,507221,Cuomo; Raphael Eduardo,9999,0,9999,0
1715625677632,CLRE 297,001,507242,Cuomo; Raphael Eduardo,9999,0,9999,0
1715625678658,COGS 197,001,638244,Voytek; Bradley Thomas,9997,0,9999,2
1715625679685,CSE 191,A00,516875,Minnes Kemp; Mor Mia,9991,0,9999,8
1715625680713,CSE 197,001,637388,Minnes Kemp; Mor Mia,9992,0,9999,7
1715625681739,CSS 201S,A01,494383,Mignozzetti; Umberto,35,0,35,0
1715625682769,CSS 202S,A01,494387,Mignozzetti; Umberto,35,0,35,0
1715625683793,DSC 197,001,628532,Eldridge; Justin Matthew,9995,0,9999,4
1715625684820,EAP 100,A00,516065,Staff,9799,0,9999,200
1715625685847,ECE 45,A01,507414,Staff,31,0,60,29
1715625687902,ECE 111,A01,507420,Staff,11,0,50,39
1715625688930,ECE 197,001,548057,Sievenpiper; Daniel F.,9991,0,9999,8
1715625689959,EDS 115,A00,507243,Choi; Bailey Miyeon,7,0,28,21
1715625690986,EDS 117,A01,494379,Staff,0,6,34,34
1715625692010,EDS 125,A00,507246,Hopkins; Megan Beth,8,0,30,22
1715625693038,EDS 128A,A01,507264,Fargason; Sharon Gayle,6,0,26,20
1715625694065,EDS 128B,A01,507293,Pappas; Elizabeth,10,0,30,20
1715625695091,EDS 139,A00,507294,Fargason; Sharon Gayle,10,0,30,20
1715625695091,EDS 139,B00,507313,Pappas; Elizabeth,11,0,30,19
1715625696118,EDS 201,A00,507315,Staff,10,0,30,20
1715625697147,EDS 203,A01,507317,Halter; Christopher P.,10,0,30,20
1715625698173,EDS 204R,A01,507319,Halter; Christopher P.,0,3,30,30
1715625698173,EDS 204R,B01,507331,Heinzman; Erica M.,14,0,30,16
1715625699204,EDS 206R,A00,507332,Staff,0,4,30,30
1715625699204,EDS 206R,B00,507343,Staff,15,0,30,15
1715625700231,EDS 250,A00,507344,Hemans; Patricia Ann Benitez,20,0,40,20
1715625701261,EDS 281,A00,507345,Daly; Alan J.,18,0,18,0
1715625702286,EDS 284,A00,507350,Daly; Alan J.,16,0,16,0
1715625703311,EDS 286,A00,507359,Fine; Sarah,18,0,18,0
1715625704338,EDS 289C,A01,507361,Daly; Alan J.,18,0,18,0
1715625705365,EDS 290,A00,507366,Hofstetter; Carolyn,15,0,15,0
1715625706389,LIGM 5A,A00,507421,Fischer-Grunski; Eva K,17,0,20,3
1715625707419,LIGM 5B,A00,507423,Fischer-Grunski; Eva K,19,0,20,1
1715625708442,LIGM 5C,A00,507425,Fischer-Grunski; Eva K,19,0,20,1
1715625709468,LIIT 5AS,A00,507427,Carnelos; Chiara,20,0,20,0
1715625710494,LIIT 5BS,A00,507430,Carnelos; Chiara,20,0,20,0
1715625711520,LIIT 5CS,A00,507432,Carnelos; Chiara,20,0,20,0
1715625712551,LISP 5A,A00,507541,Munoz Sanchez; Alicia,11,0,20,9
1715625713578,LISP 5B,A00,507671,Munoz Sanchez; Alicia,9,0,20,11
1715625714605,LISP 5C,A00,507696,Munoz Sanchez; Alicia,9,0,20,11
1715625715630,MAE 197,001,528363,Boechler; Nicholas Sebastia,9998,0,9999,1
1715625716659,MATH 197,001,523477,Kedlaya; Kiran S.,9994,0,9999,5
1715625716659,MATH 197,002,563811,Zhang; Danna,9994,0,9999,5
1715625716659,MATH 197,003,628552,Dumitriu; Ioana,9998,0,9999,1
1715625716659,MATH 197,004,660885,Floyd; Eric,9998,0,9999,1
1715625717684,MCWP 40R,A00,518780,Staff,2,0,20,18
1715625717684,MCWP 40R,B00,518781,Staff,11,0,20,9
1715625717684,MCWP 40R,C00,518783,Staff,5,0,20,15
1715625718709,MCWP 50R,A00,518791,Staff,0,1,20,20
1715625718709,MCWP 50R,B00,518792,Staff,0,2,20,20
1715625718709,MCWP 50R,C00,518793,Staff,0,4,20,20
1715625718709,MCWP 50R,D00,518794,Staff,0,1,20,20
1715625718709,MCWP 50R,E00,518795,Staff,0,2,20,20
1715625718709,MCWP 50R,F00,518796,Staff,0,1,20,20
1715625718709,MCWP 50R,G00,518797,Staff,0,1,20,20
1715625719789,MMW 12R,A01,514034,Herbst; Matthew,0,2,16,16
1715625719789,MMW 12R,A02,514035,Herbst; Matthew,0,0,16,16
1715625720813,MMW 13R,A01,514037,Staff,0,5,16,16
1715625720813,MMW 13R,A02,514039,Staff,0,5,16,16
1715625720813,MMW 13R,A03,628519,Staff,0,4,16,16
1715625722866,SIO 295LS,A00,523233,Staff,10,0,30,20
1715625723890,SIO 295S,A00,523232,Staff,10,0,30,20
1715625724913,SIOC 290S,A01,637330,Merrifield; Mark A,22,0,30,8
1715625725941,SIOC 291S,A01,637333,Gabriel; Corey John,22,0,30,8
1715625726967,SOCI 117,A01,494376,Staff,0,5,5,5
1715625727991,WES 237B,A00,494380,Staff,10,0,20,10
1715625730048,AESE 279B,A00,494370,Wade; Jon P,0,0,33,33
1715625731077,AIP 97,001,660915,Van Den Einde; Yael Dahlia,9998,0,9999,1
1715625732105,AIP 197,001,627712,Vespa; Emanuel Ignacio,9995,0,9999,4
1715625732105,AIP 197,002,650778,Amir; On,9998,0,9999,1
1715625732105,AIP 197,003,650933,Avenancio-Leon; Carlos,9998,0,9999,1
1715625732105,AIP 197,004,658530,Heyman; Gail D.,9998,0,9999,1
1715625732105,AIP 197,005,658631,Neal; Sonya E,9998,0,9999,1
1715625732105,AIP 197,006,658671,Du; Songzi,9998,0,9999,1
1715625733132,ANAR 135S,A00,494369,Braswell; Geoffrey E.,0,0,0,0
1715625734160,BENG 196,001,628496,Engler; Adam J.,9998,0,9999,1
1715625734160,BENG 196,002,660916,Watson; John Thomas,9999,0,9999,0
1715625735187,BISP 197,001,650773,Wilhelm; James E.,9994,0,9999,5
1715625735187,BISP 197,002,658904,Coleman; Aaron B.,9998,0,9999,1
1715625736217,CAT 124RS,A01,519847,Geibel; William,0,0,20,20
1715625737242,CAT 125RS,A01,515971,Geibel; William,0,0,20,20
1715625738273,CLRE 250,A00,511389,Morris; Sheldon,9992,0,9999,7
1715625739303,CLRE 251,A00,507176,Mehta; Ravindra L.,9992,0,9999,7
1715625739303,CLRE 251,B00,511410,Mehta; Ravindra L.,9998,0,9999,1
1715625740330,CLRE 252,A00,507189,Cuomo; Raphael Eduardo,9994,0,9999,5
1715625741356,CLRE 253,A00,507199,Vaida; Florin,9994,0,9999,5
1715625741356,CLRE 253,B00,507202,Vaida; Florin,9999,0,9999,0
1715625742384,CLRE 259,A00,507211,Patel; Hemal,9996,0,9999,3
1715625743409,CLRE 260,A00,507221,Cuomo; Raphael Eduardo,9999,0,9999,0
1715625744435,CLRE 297,001,507242,Cuomo; Raphael Eduardo,9999,0,9999,0
1715625745463,COGS 197,001,638244,Voytek; Bradley Thomas,9997,0,9999,2
1715625746489,CSE 191,A00,516875,Minnes Kemp; Mor Mia,9991,0,9999,8
1715625747515,CSE 197,001,637388,Minnes Kemp; Mor Mia,9992,0,9999,7
1715625748540,CSS 201S,A01,494383,Mignozzetti; Umberto,35,0,35,0
1715625749569,CSS 202S,A01,494387,Mignozzetti; Umberto,35,0,35,0
1715625750595,DSC 197,001,628532,Eldridge; Justin Matthew,9995,0,9999,4
1715625751622,EAP 100,A00,516065,Staff,9799,0,9999,200
1715625752648,ECE 45,A01,507414,Staff,31,0,60,29
1715625754701,ECE 111,A01,507420,Staff,11,0,50,39
1715625755728,ECE 197,001,548057,Sievenpiper; Daniel F.,9991,0,9999,8
1715625756754,EDS 115,A00,507243,Choi; Bailey Miyeon,7,0,28,21
1715625757784,EDS 117,A01,494379,Staff,0,6,34,34
1715625758808,EDS 125,A00,507246,Hopkins; Megan Beth,8,0,30,22
1715625759838,EDS 128A,A01,507264,Fargason; Sharon Gayle,6,0,26,20
1715625760863,EDS 128B,A01,507293,Pappas; Elizabeth,10,0,30,20
1715625761890,EDS 139,A00,507294,Fargason; Sharon Gayle,10,0,30,20
1715625761890,EDS 139,B00,507313,Pappas; Elizabeth,11,0,30,19
1715625762914,EDS 201,A00,507315,Staff,10,0,30,20
1715625763943,EDS 203,A01,507317,Halter; Christopher P.,10,0,30,20
1715625764972,EDS 204R,A01,507319,Halter; Christopher P.,0,3,30,30
1715625764972,EDS 204R,B01,507331,Heinzman; Erica M.,14,0,30,16
1715625765998,EDS 206R,A00,507332,Staff,0,4,30,30
1715625765998,EDS 206R,B00,507343,Staff,15,0,30,15
1715625767023,EDS 250,A00,507344,Hemans; Patricia Ann Benitez,20,0,40,20
1715625768048,EDS 281,A00,507345,Daly; Alan J.,18,0,18,0
1715625769104,EDS 284,A00,507350,Daly; Alan J.,16,0,16,0
1715625770129,EDS 286,A00,507359,Fine; Sarah,18,0,18,0
1715625771155,EDS 289C,A01,507361,Daly; Alan J.,18,0,18,0
1715625772180,EDS 290,A00,507366,Hofstetter; Carolyn,15,0,15,0
1715625773203,LIGM 5A,A00,507421,Fischer-Grunski; Eva K,17,0,20,3
1715625774228,LIGM 5B,A00,507423,Fischer-Grunski; Eva K,19,0,20,1
1715625775258,LIGM 5C,A00,507425,Fischer-Grunski; Eva K,19,0,20,1
1715625776286,LIIT 5AS,A00,507427,Carnelos; Chiara,20,0,20,0
1715625777315,LIIT 5BS,A00,507430,Carnelos; Chiara,20,0,20,0
1715625778345,LIIT 5CS,A00,507432,Carnelos; Chiara,20,0,20,0
1715625779371,LISP 5A,A00,507541,Munoz Sanchez; Alicia,11,0,20,9
1715625780396,LISP 5B,A00,507671,Munoz Sanchez; Alicia,9,0,20,11
1715625781424,LISP 5C,A00,507696,Munoz Sanchez; Alicia,9,0,20,11
1715625782450,MAE 197,001,528363,Boechler; Nicholas Sebastia,9998,0,9999,1
1715625783479,MATH 197,001,523477,Kedlaya; Kiran S.,9994,0,9999,5
1715625783479,MATH 197,002,563811,Zhang; Danna,9994,0,9999,5
1715625783479,MATH 197,003,628552,Dumitriu; Ioana,9998,0,9999,1
1715625783479,MATH 197,004,660885,Floyd; Eric,9998,0,9999,1
1715625784506,MCWP 40R,A00,518780,Staff,2,0,20,18
1715625784506,MCWP 40R,B00,518781,Staff,11,0,20,9
1715625784506,MCWP 40R,C00,518783,Staff,5,0,20,15
1715625785533,MCWP 50R,A00,518791,Staff,0,1,20,20
1715625785533,MCWP 50R,B00,518792,Staff,0,2,20,20
1715625785533,MCWP 50R,C00,518793,Staff,0,4,20,20
1715625785533,MCWP 50R,D00,518794,Staff,0,1,20,20
1715625785533,MCWP 50R,E00,518795,Staff,0,2,20,20
1715625785533,MCWP 50R,F00,518796,Staff,0,1,20,20
1715625785533,MCWP 50R,G00,518797,Staff,0,1,20,20
1715625786562,MMW 12R,A01,514034,Herbst; Matthew,0,2,16,16
1715625786562,MMW 12R,A02,514035,Herbst; Matthew,0,0,16,16
1715625787592,MMW 13R,A01,514037,Staff,0,5,16,16
1715625787592,MMW 13R,A02,514039,Staff,0,5,16,16
1715625787592,MMW 13R,A03,628519,Staff,0,4,16,16
1715625789646,SIO 295LS,A00,523233,Staff,10,0,30,20
1715625790671,SIO 295S,A00,523232,Staff,10,0,30,20
1715625791701,SIOC 290S,A01,637330,Merrifield; Mark A,22,0,30,8
1715625792853,SIOC 291S,A01,637333,Gabriel; Corey John,22,0,30,8
1715625793880,SOCI 117,A01,494376,Staff,0,5,5,5
1715625794905,WES 237B,A00,494380,Staff,10,0,20,10
1715625796980,AESE 279B,A00,494370,Wade; Jon P,0,0,33,33
1715625798006,AIP 97,001,660915,Van Den Einde; Yael Dahlia,9998,0,9999,1
1715625799031,AIP 197,001,627712,Vespa; Emanuel Ignacio,9995,0,9999,4
1715625799031,AIP 197,002,650778,Amir; On,9998,0,9999,1
1715625799031,AIP 197,003,650933,Avenancio-Leon; Carlos,9998,0,9999,1
1715625799031,AIP 197,004,658530,Heyman; Gail D.,9998,0,9999,1
1715625799031,AIP 197,005,658631,Neal; Sonya E,9998,0,9999,1
1715625799031,AIP 197,006,658671,Du; Songzi,9998,0,9999,1
1715625800060,ANAR 135S,A00,494369,Braswell; Geoffrey E.,0,0,0,0
1715625801086,BENG 196,001,628496,Engler; Adam J.,9998,0,9999,1
1715625801086,BENG 196,002,660916,Watson; John Thomas,9999,0,9999,0
1715625802114,BISP 197,001,650773,Wilhelm; James E.,9994,0,9999,5
1715625802114,BISP 197,002,658904,Coleman; Aaron B.,9998,0,9999,1
1715625803140,CAT 124RS,A01,519847,Geibel; William,0,0,20,20
1715625804168,CAT 125RS,A01,515971,Geibel; William,0,0,20,20
1715625805197,CLRE 250,A00,511389,Morris; Sheldon,9992,0,9999,7
1715625806228,CLRE 251,A00,507176,Mehta; Ravindra L.,9992,0,9999,7
1715625806228,CLRE 251,B00,511410,Mehta; Ravindra L.,9998,0,9999,1
1715625807258,CLRE 252,A00,507189,Cuomo; Raphael Eduardo,9994,0,9999,5
1715625808284,CLRE 253,A00,507199,Vaida; Florin,9994,0,9999,5
1715625808284,CLRE 253,B00,507202,Vaida; Florin,9999,0,9999,0
1715625809312,CLRE 259,A00,507211,Patel; Hemal,9996,0,9999,3
1715625810338,CLRE 260,A00,507221,Cuomo; Raphael Eduardo,9999,0,9999,0
1715625811367,CLRE 297,001,507242,Cuomo; Raphael Eduardo,9999,0,9999,0
1715625812393,COGS 197,001,638244,Voytek; Bradley Thomas,9997,0,9999,2
1715625813422,CSE 191,A00,516875,Minnes Kemp; Mor Mia,9991,0,9999,8
1715625814448,CSE 197,001,637388,Minnes Kemp; Mor Mia,9992,0,9999,7
1715625815473,CSS 201S,A01,494383,Mignozzetti; Umberto,35,0,35,0
1715625816499,CSS 202S,A01,494387,Mignozzetti; Umberto,35,0,35,0
1715625817527,DSC 197,001,628532,Eldridge; Justin Matthew,9995,0,9999,4
1715625818552,EAP 100,A00,516065,Staff,9799,0,9999,200
1715625819584,ECE 45,A01,507414,Staff,31,0,60,29
1715625821640,ECE 111,A01,507420,Staff,11,0,50,39
1715625822668,ECE 197,001,548057,Sievenpiper; Daniel F.,9991,0,9999,8
1715625823700,EDS 115,A00,507243,Choi; Bailey Miyeon,7,0,28,21
1715625824726,EDS 117,A01,494379,Staff,0,6,34,34
1715625825752,EDS 125,A00,507246,Hopkins; Megan Beth,8,0,30,22
1715625826778,EDS 128A,A01,507264,Fargason; Sharon Gayle,6,0,26,20
1715625827805,EDS 128B,A01,507293,Pappas; Elizabeth,10,0,30,20
1715625828831,EDS 139,A00,507294,Fargason; Sharon Gayle,10,0,30,20
1715625828831,EDS 139,B00,507313,Pappas; Elizabeth,11,0,30,19
1715625829854,EDS 201,A00,507315,Staff,10,0,30,20
1715625830882,EDS 203,A01,507317,Halter; Christopher P.,10,0,30,20
1715625831911,EDS 204R,A01,507319,Halter; Christopher P.,0,3,30,30
1715625831911,EDS 204R,B01,507331,Heinzman; Erica M.,14,0,30,16
1715625832939,EDS 206R,A00,507332,Staff,0,4,30,30
1715625832939,EDS 206R,B00,507343,Staff,15,0,30,15
1715625833965,EDS 250,A00,507344,Hemans; Patricia Ann Benitez,20,0,40,20
1715625834990,EDS 281,A00,507345,Daly; Alan J.,18,0,18,0
1715625836014,EDS 284,A00,507350,Daly; Alan J.,16,0,16,0
1715625837040,EDS 286,A00,507359,Fine; Sarah,18,0,18,0
1715625838065,EDS 289C,A01,507361,Daly; Alan J.,18,0,18,0
1715625839090,EDS 290,A00,507366,Hofstetter; Carolyn,15,0,15,0
1715625840116,LIGM 5A,A00,507421,Fischer-Grunski; Eva K,17,0,20,3
1715625841141,LIGM 5B,A00,507423,Fischer-Grunski; Eva K,19,0,20,1
1715625842167,LIGM 5C,A00,507425,Fischer-Grunski; Eva K,19,0,20,1
1715625843196,LIIT 5AS,A00,507427,Carnelos; Chiara,20,0,20,0
1715625844232,LIIT 5BS,A00,507430,Carnelos; Chiara,20,0,20,0
1715625845315,LIIT 5CS,A00,507432,Carnelos; Chiara,20,0,20,0
1715625846344,LISP 5A,A00,507541,Munoz Sanchez; Alicia,11,0,20,9
1715625847369,LISP 5B,A00,507671,Munoz Sanchez; Alicia,9,0,20,11
1715625848396,LISP 5C,A00,507696,Munoz Sanchez; Alicia,9,0,20,11
1715625849421,MAE 197,001,528363,Boechler; Nicholas Sebastia,9998,0,9999,1
1715625850450,MATH 197,001,523477,Kedlaya; Kiran S.,9994,0,9999,5
1715625850450,MATH 197,002,563811,Zhang; Danna,9994,0,9999,5
1715625850450,MATH 197,003,628552,Dumitriu; Ioana,9998,0,9999,1
1715625850450,MATH 197,004,660885,Floyd; Eric,9998,0,9999,1
1715625851479,MCWP 40R,A00,518780,Staff,2,0,20,18
1715625851479,MCWP 40R,B00,518781,Staff,11,0,20,9
1715625851479,MCWP 40R,C00,518783,Staff,5,0,20,15
1715625852505,MCWP 50R,A00,518791,Staff,0,1,20,20
1715625852505,MCWP 50R,B00,518792,Staff,0,2,20,20
1715625852505,MCWP 50R,C00,518793,Staff,0,4,20,20
1715625852505,MCWP 50R,D00,518794,Staff,0,1,20,20
1715625852505,MCWP 50R,E00,518795,Staff,0,2,20,20
1715625852505,MCWP 50R,F00,518796,Staff,0,1,20,20
1715625852505,MCWP 50R,G00,518797,Staff,0,1,20,20
1715625853532,MMW 12R,A01,514034,Herbst; Matthew,0,2,16,16
1715625853532,MMW 12R,A02,514035,Herbst; Matthew,0,0,16,16
1715625854559,MMW 13R,A01,514037,Staff,0,5,16,16
1715625854559,MMW 13R,A02,514039,Staff,0,5,16,16
1715625854559,MMW 13R,A03,628519,Staff,0,4,16,16
1715625856614,SIO 295LS,A00,523233,Staff,10,0,30,20
1715625857640,SIO 295S,A00,523232,Staff,10,0,30,20
1715625858667,SIOC 290S,A01,637330,Merrifield; Mark A,22,0,30,8
1715625859692,SIOC 291S,A01,637333,Gabriel; Corey John,22,0,30,8
1715625860718,SOCI 117,A01,494376,Staff,0,5,5,5
1715625861745,WES 237B,A00,494380,Staff,10,0,20,10
1715625863823,AESE 279B,A00,494370,Wade; Jon P,0,0,33,33
1715625864850,AIP 97,001,660915,Van Den Einde; Yael Dahlia,9998,0,9999,1
1715625865876,AIP 197,001,627712,Vespa; Emanuel Ignacio,9995,0,9999,4
1715625865876,AIP 197,002,650778,Amir; On,9998,0,9999,1
1715625865876,AIP 197,003,650933,Avenancio-Leon; Carlos,9998,0,9999,1
1715625865876,AIP 197,004,658530,Heyman; Gail D.,9998,0,9999,1
1715625865876,AIP 197,005,658631,Neal; Sonya E,9998,0,9999,1
1715625865876,AIP 197,006,658671,Du; Songzi,9998,0,9999,1
1715625866901,ANAR 135S,A00,494369,Braswell; Geoffrey E.,0,0,0,0
1715625867931,BENG 196,001,628496,Engler; Adam J.,9998,0,9999,1
1715625867931,BENG 196,002,660916,Watson; John Thomas,9999,0,9999,0
1715625868956,BISP 197,001,650773,Wilhelm; James E.,9994,0,9999,5
1715625868956,BISP 197,002,658904,Coleman; Aaron B.,9998,0,9999,1
1715625869983,CAT 124RS,A01,519847,Geibel; William,0,0,20,20
1715625871010,CAT 125RS,A01,515971,Geibel; William,0,0,20,20
1715625872038,CLRE 250,A00,511389,Morris; Sheldon,9992,0,9999,7
1715625873064,CLRE 251,A00,507176,Mehta; Ravindra L.,9992,0,9999,7
1715625873064,CLRE 251,B00,511410,Mehta; Ravindra L.,9998,0,9999,1
1715625874091,CLRE 252,A00,507189,Cuomo; Raphael Eduardo,9994,0,9999,5
1715625875118,CLRE 253,A00,507199,Vaida; Florin,9994,0,9999,5
1715625875118,CLRE 253,B00,507202,Vaida; Florin,9999,0,9999,0
1715625876144,CLRE 259,A00,507211,Patel; Hemal,9996,0,9999,3
1715625877173,CLRE 260,A00,507221,Cuomo; Raphael Eduardo,9999,0,9999,0
1715625878198,CLRE 297,001,507242,Cuomo; Raphael Eduardo,9999,0,9999,0
1715625879224,COGS 197,001,638244,Voytek; Bradley Thomas,9997,0,9999,2
1715625880251,CSE 191,A00,516875,Minnes Kemp; Mor Mia,9991,0,9999,8
1715625881276,CSE 197,001,637388,Minnes Kemp; Mor Mia,9992,0,9999,7
1715625882458,CSS 201S,A01,494383,Mignozzetti; Umberto,35,0,35,0
1715625883484,CSS 202S,A01,494387,Mignozzetti; Umberto,35,0,35,0
1715625884510,DSC 197,001,628532,Eldridge; Justin Matthew,9995,0,9999,4
1715625885534,EAP 100,A00,516065,Staff,9799,0,9999,200
1715625886561,ECE 45,A01,507414,Staff,31,0,60,29
1715625888615,ECE 111,A01,507420,Staff,11,0,50,39
1715625889641,ECE 197,001,548057,Sievenpiper; Daniel F.,9991,0,9999,8
1715625890672,EDS 115,A00,507243,Choi; Bailey Miyeon,7,0,28,21
1715625891696,EDS 117,A01,494379,Staff,0,6,34,34
1715625892724,EDS 125,A00,507246,Hopkins; Megan Beth,8,0,30,22
1715625893750,EDS 128A,A01,507264,Fargason; Sharon Gayle,6,0,26,20
1715625894775,EDS 128B,A01,507293,Pappas; Elizabeth,10,0,30,20
1715625895800,EDS 139,A00,507294,Fargason; Sharon Gayle,10,0,30,20
1715625895800,EDS 139,B00,507313,Pappas; Elizabeth,11,0,30,19
1715625896827,EDS 201,A00,507315,Staff,10,0,30,20
1715625897855,EDS 203,A01,507317,Halter; Christopher P.,10,0,30,20
1715625898882,EDS 204R,A01,507319,Halter; Christopher P.,0,3,30,30
1715625898882,EDS 204R,B01,507331,Heinzman; Erica M.,14,0,30,16
1715625899907,EDS 206R,A00,507332,Staff,0,4,30,30
1715625899907,EDS 206R,B00,507343,Staff,15,0,30,15
1715625900934,EDS 250,A00,507344,Hemans; Patricia Ann Benitez,20,0,40,20
1715625901961,EDS 281,A00,507345,Daly; Alan J.,18,0,18,0
1715625913872,EDS 284,A00,507350,Daly; Alan J.,16,0,16,0
1715625914901,EDS 286,A00,507359,Fine; Sarah,18,0,18,0
1715625915927,EDS 289C,A01,507361,Daly; Alan J.,18,0,18,0
1715625916952,EDS 290,A00,507366,Hofstetter; Carolyn,15,0,15,0
1715625917984,LIGM 5A,A00,507421,Fischer-Grunski; Eva K,17,0,20,3
1715625919010,LIGM 5B,A00,507423,Fischer-Grunski; Eva K,19,0,20,1
1715625920036,LIGM 5C,A00,507425,Fischer-Grunski; Eva K,19,0,20,1
1715625921063,LIIT 5AS,A00,507427,Carnelos; Chiara,20,0,20,0
1715625922089,LIIT 5BS,A00,507430,Carnelos; Chiara,20,0,20,0
1715625923116,LIIT 5CS,A00,507432,Carnelos; Chiara,20,0,20,0
1715625924144,LISP 5A,A00,507541,Munoz Sanchez; Alicia,11,0,20,9
1715625925175,LISP 5B,A00,507671,Munoz Sanchez; Alicia,9,0,20,11
1715625926202,LISP 5C,A00,507696,Munoz Sanchez; Alicia,9,0,20,11
1715625927231,MAE 197,001,528363,Boechler; Nicholas Sebastia,9998,0,9999,1
1715625928259,MATH 197,001,523477,Kedlaya; Kiran S.,9994,0,9999,5
1715625928259,MATH 197,002,563811,Zhang; Danna,9994,0,9999,5
1715625928259,MATH 197,003,628552,Dumitriu; Ioana,9998,0,9999,1
1715625928259,MATH 197,004,660885,Floyd; Eric,9998,0,9999,1
1715625929287,MCWP 40R,A00,518780,Staff,2,0,20,18
1715625929287,MCWP 40R,B00,518781,Staff,11,0,20,9
1715625929287,MCWP 40R,C00,518783,Staff,5,0,20,15
1715625930321,MCWP 50R,A00,518791,Staff,0,1,20,20
1715625930321,MCWP 50R,B00,518792,Staff,0,2,20,20
1715625930321,MCWP 50R,C00,518793,Staff,0,4,20,20
1715625930321,MCWP 50R,D00,518794,Staff,0,1,20,20
1715625930321,MCWP 50R,E00,518795,Staff,0,2,20,20
1715625930321,MCWP 50R,F00,518796,Staff,0,1,20,20
1715625930321,MCWP 50R,G00,518797,Staff,0,1,20,20
1715625931347,MMW 12R,A01,514034,Herbst; Matthew,0,2,16,16
1715625931347,MMW 12R,A02,514035,Herbst; Matthew,0,0,16,16
1715625932375,MMW 13R,A01,514037,Staff,0,5,16,16
1715625932375,MMW 13R,A02,514039,Staff,0,5,16,16
1715625932375,MMW 13R,A03,628519,Staff,0,4,16,16
1715625934424,SIO 295LS,A00,523233,Staff,10,0,30,20
1715625935449,SIO 295S,A00,523232,Staff,10,0,30,20
1715625936476,SIOC 290S,A01,637330,Merrifield; Mark A,22,0,30,8
1715625937503,SIOC 291S,A01,637333,Gabriel; Corey John,22,0,30,8
1715625938530,SOCI 117,A01,494376,Staff,0,5,5,5
1715625939557,WES 237B,A00,494380,Staff,10,0,20,10
1715625941632,AESE 279B,A00,494370,Wade; Jon P,0,0,33,33
1715625942660,AIP 97,001,660915,Van Den Einde; Yael Dahlia,9998,0,9999,1
1715625943685,AIP 197,001,627712,Vespa; Emanuel Ignacio,9995,0,9999,4
1715625943685,AIP 197,002,650778,Amir; On,9998,0,9999,1
1715625943685,AIP 197,003,650933,Avenancio-Leon; Carlos,9998,0,9999,1
1715625943685,AIP 197,004,658530,Heyman; Gail D.,9998,0,9999,1
1715625943685,AIP 197,005,658631,Neal; Sonya E,9998,0,9999,1
1715625943685,AIP 197,006,658671,Du; Songzi,9998,0,9999,1
1715625944716,ANAR 135S,A00,494369,Braswell; Geoffrey E.,0,0,0,0
1715625945741,BENG 196,001,628496,Engler; Adam J.,9998,0,9999,1
1715625945741,BENG 196,002,660916,Watson; John Thomas,9999,0,9999,0
1715625946769,BISP 197,001,650773,Wilhelm; James E.,9994,0,9999,5
1715625946769,BISP 197,002,658904,Coleman; Aaron B.,9998,0,9999,1
1715625947796,CAT 124RS,A01,519847,Geibel; William,0,0,20,20
1715625948822,CAT 125RS,A01,515971,Geibel; William,0,0,20,20
1715625949845,CLRE 250,A00,511389,Morris; Sheldon,9992,0,9999,7
1715625950872,CLRE 251,A00,507176,Mehta; Ravindra L.,9992,0,9999,7
1715625950872,CLRE 251,B00,511410,Mehta; Ravindra L.,9998,0,9999,1
1715625951898,CLRE 252,A00,507189,Cuomo; Raphael Eduardo,9994,0,9999,5
1715625952923,CLRE 253,A00,507199,Vaida; Florin,9994,0,9999,5
1715625952923,CLRE 253,B00,507202,Vaida; Florin,9999,0,9999,0
1715625953951,CLRE 259,A00,507211,Patel; Hemal,9996,0,9999,3
1715625954975,CLRE 260,A00,507221,Cuomo; Raphael Eduardo,9999,0,9999,0
1715625956001,CLRE 297,001,507242,Cuomo; Raphael Eduardo,9999,0,9999,0
1715625957029,COGS 197,001,638244,Voytek; Bradley Thomas,9997,0,9999,2
1715625958054,CSE 191,A00,516875,Minnes Kemp; Mor Mia,9991,0,9999,8
1715625959079,CSE 197,001,637388,Minnes Kemp; Mor Mia,9992,0,9999,7
1715625960113,CSS 201S,A01,494383,Mignozzetti; Umberto,35,0,35,0
1715625961137,CSS 202S,A01,494387,Mignozzetti; Umberto,35,0,35,0
1715625962164,DSC 197,001,628532,Eldridge; Justin Matthew,9995,0,9999,4
1715625963191,EAP 100,A00,516065,Staff,9799,0,9999,200
1715625964226,ECE 45,A01,507414,Staff,31,0,60,29
1715625966286,ECE 111,A01,507420,Staff,11,0,50,39
1715625967310,ECE 197,001,548057,Sievenpiper; Daniel F.,9991,0,9999,8
1715625968338,EDS 115,A00,507243,Choi; Bailey Miyeon,7,0,28,21
1715625969364,EDS 117,A01,494379,Staff,0,6,34,34
1715625970391,EDS 125,A00,507246,Hopkins; Megan Beth,8,0,30,22
1715625971420,EDS 128A,A01,507264,Fargason; Sharon Gayle,6,0,26,20
1715625972450,EDS 128B,A01,507293,Pappas; Elizabeth,10,0,30,20
1715625973476,EDS 139,A00,507294,Fargason; Sharon Gayle,10,0,30,20
1715625973476,EDS 139,B00,507313,Pappas; Elizabeth,11,0,30,19
1715625974505,EDS 201,A00,507315,Staff,10,0,30,20
1715625975532,EDS 203,A01,507317,Halter; Christopher P.,10,0,30,20
1715625976557,EDS 204R,A01,507319,Halter; Christopher P.,0,3,30,30
1715625976557,EDS 204R,B01,507331,Heinzman; Erica M.,14,0,30,16
1715625977584,EDS 206R,A00,507332,Staff,0,4,30,30
1715625977584,EDS 206R,B00,507343,Staff,15,0,30,15
1715625978614,EDS 250,A00,507344,Hemans; Patricia Ann Benitez,20,0,40,20
1715625979643,EDS 281,A00,507345,Daly; Alan J.,18,0,18,0
1715625980671,EDS 284,A00,507350,Daly; Alan J.,16,0,16,0
1715625981697,EDS 286,A00,507359,Fine; Sarah,18,0,18,0
1715625982723,EDS 289C,A01,507361,Daly; Alan J.,18,0,18,0
1715625983750,EDS 290,A00,507366,Hofstetter; Carolyn,15,0,15,0
1715625984778,LIGM 5A,A00,507421,Fischer-Grunski; Eva K,17,0,20,3
1715625985803,LIGM 5B,A00,507423,Fischer-Grunski; Eva K,19,0,20,1
1715625986829,LIGM 5C,A00,507425,Fischer-Grunski; Eva K,19,0,20,1
1715625987859,LIIT 5AS,A00,507427,Carnelos; Chiara,20,0,20,0
1715625988884,LIIT 5BS,A00,507430,Carnelos; Chiara,20,0,20,0
1715625989914,LIIT 5CS,A00,507432,Carnelos; Chiara,20,0,20,0
1715625990942,LISP 5A,A00,507541,Munoz Sanchez; Alicia,11,0,20,9
1715625991966,LISP 5B,A00,507671,Munoz Sanchez; Alicia,9,0,20,11
1715625992993,LISP 5C,A00,507696,Munoz Sanchez; Alicia,9,0,20,11
1715625994019,MAE 197,001,528363,Boechler; Nicholas Sebastia,9998,0,9999,1
1715625995050,MATH 197,001,523477,Kedlaya; Kiran S.,9994,0,9999,5
1715625995050,MATH 197,002,563811,Zhang; Danna,9994,0,9999,5
1715625995050,MATH 197,003,628552,Dumitriu; Ioana,9998,0,9999,1
1715625995050,MATH 197,004,660885,Floyd; Eric,9998,0,9999,1
1715625996080,MCWP 40R,A00,518780,Staff,2,0,20,18
1715625996080,MCWP 40R,B00,518781,Staff,11,0,20,9
1715625996080,MCWP 40R,C00,518783,Staff,5,0,20,15
1715625997106,MCWP 50R,A00,518791,Staff,0,1,20,20
1715625997106,MCWP 50R,B00,518792,Staff,0,2,20,20
1715625997106,MCWP 50R,C00,518793,Staff,0,4,20,20
1715625997106,MCWP 50R,D00,518794,Staff,0,1,20,20
1715625997106,MCWP 50R,E00,518795,Staff,0,2,20,20
1715625997106,MCWP 50R,F00,518796,Staff,0,1,20,20
1715625997106,MCWP 50R,G00,518797,Staff,0,1,20,20
1715625998132,MMW 12R,A01,514034,Herbst; Matthew,0,2,16,16
1715625998132,MMW 12R,A02,514035,Herbst; Matthew,0,0,16,16
1715625999159,MMW 13R,A01,514037,Staff,0,5,16,16
1715625999159,MMW 13R,A02,514039,Staff,0,5,16,16
1715625999159,MMW 13R,A03,628519,Staff,0,4,16,16
1715626001210,SIO 295LS,A00,523233,Staff,10,0,30,20
1715626002237,SIO 295S,A00,523232,Staff,10,0,30,20
1715626003263,SIOC 290S,A01,637330,Merrifield; Mark A,22,0,30,8
1715626004293,SIOC 291S,A01,637333,Gabriel; Corey John,22,0,30,8
1715626005318,SOCI 117,A01,494376,Staff,0,5,5,5
1715626006343,WES 237B,A00,494380,Staff,10,0,20,10
1715626008418,AESE 279B,A00,494370,Wade; Jon P,0,0,33,33
1715626009443,AIP 97,001,660915,Van Den Einde; Yael Dahlia,9998,0,9999,1
1715626010471,AIP 197,001,627712,Vespa; Emanuel Ignacio,9995,0,9999,4
1715626010471,AIP 197,002,650778,Amir; On,9998,0,9999,1
1715626010471,AIP 197,003,650933,Avenancio-Leon; Carlos,9998,0,9999,1
1715626010471,AIP 197,004,658530,Heyman; Gail D.,9998,0,9999,1
1715626010471,AIP 197,005,658631,Neal; Sonya E,9998,0,9999,1
1715626010471,AIP 197,006,658671,Du; Songzi,9998,0,9999,1
1715626011510,ANAR 135S,A00,494369,Braswell; Geoffrey E.,0,0,0,0
1715626012536,BENG 196,001,628496,Engler; Adam J.,9998,0,9999,1
1715626012536,BENG 196,002,660916,Watson; John Thomas,9999,0,9999,0
1715626013561,BISP 197,001,650773,Wilhelm; James E.,9994,0,9999,5
1715626013561,BISP 197,002,658904,Coleman; Aaron B.,9998,0,9999,1
1715626014589,CAT 124RS,A01,519847,Geibel; William,0,0,20,20
1715626015613,CAT 125RS,A01,515971,Geibel; William,0,0,20,20
1715626016636,CLRE 250,A00,511389,Morris; Sheldon,9992,0,9999,7
1715626017666,CLRE 251,A00,507176,Mehta; Ravindra L.,9992,0,9999,7
1715626017666,CLRE 251,B00,511410,Mehta; Ravindra L.,9998,0,9999,1
1715626018689,CLRE 252,A00,507189,Cuomo; Raphael Eduardo,9994,0,9999,5
1715626019713,CLRE 253,A00,507199,Vaida; Florin,9994,0,9999,5
1715626019713,CLRE 253,B00,507202,Vaida; Florin,9999,0,9999,0
1715626020766,CLRE 259,A00,507211,Patel; Hemal,9996,0,9999,3
1715626021793,CLRE 260,A00,507221,Cuomo; Raphael Eduardo,9999,0,9999,0
1715626022820,CLRE 297,001,507242,Cuomo; Raphael Eduardo,9999,0,9999,0
1715626023845,COGS 197,001,638244,Voytek; Bradley Thomas,9997,0,9999,2
1715626024868,CSE 191,A00,516875,Minnes Kemp; Mor Mia,9991,0,9999,8
1715626025892,CSE 197,001,637388,Minnes Kemp; Mor Mia,9992,0,9999,7
1715626026924,CSS 201S,A01,494383,Mignozzetti; Umberto,35,0,35,0
1715626027947,CSS 202S,A01,494387,Mignozzetti; Umberto,35,0,35,0
1715626028971,DSC 197,001,628532,Eldridge; Justin Matthew,9995,0,9999,4
1715626029996,EAP 100,A00,516065,Staff,9799,0,9999,200
1715626031022,ECE 45,A01,507414,Staff,31,0,60,29
1715626033076,ECE 111,A01,507420,Staff,11,0,50,39
1715626034100,ECE 197,001,548057,Sievenpiper; Daniel F.,9991,0,9999,8
1715626035124,EDS 115,A00,507243,Choi; Bailey Miyeon,7,0,28,21
1715626036151,EDS 117,A01,494379,Staff,0,6,34,34
1715626037180,EDS 125,A00,507246,Hopkins; Megan Beth,8,0,30,22
1715626038206,EDS 128A,A01,507264,Fargason; Sharon Gayle,6,0,26,20
1715626039230,EDS 128B,A01,507293,Pappas; Elizabeth,10,0,30,20
1715626040257,EDS 139,A00,507294,Fargason; Sharon Gayle,10,0,30,20
1715626040257,EDS 139,B00,507313,Pappas; Elizabeth,11,0,30,19
1715626041284,EDS 201,A00,507315,Staff,10,0,30,20
1715626042308,EDS 203,A01,507317,Halter; Christopher P.,10,0,30,20
1715626043332,EDS 204R,A01,507319,Halter; Christopher P.,0,3,30,30
1715626043332,EDS 204R,B01,507331,Heinzman; Erica M.,14,0,30,16
1715626044366,EDS 206R,A00,507332,Staff,0,4,30,30
1715626044366,EDS 206R,B00,507343,Staff,15,0,30,15
1715626045392,EDS 250,A00,507344,Hemans; Patricia Ann Benitez,20,0,40,20
1715626046418,EDS 281,A00,507345,Daly; Alan J.,18,0,18,0
1715626047443,EDS 284,A00,507350,Daly; Alan J.,16,0,16,0
1715626048472,EDS 286,A00,507359,Fine; Sarah,18,0,18,0
1715626049498,EDS 289C,A01,507361,Daly; Alan J.,18,0,18,0
1715626050526,EDS 290,A00,507366,Hofstetter; Carolyn,15,0,15,0
1715626051555,LIGM 5A,A00,507421,Fischer-Grunski; Eva K,17,0,20,3
1715626052582,LIGM 5B,A00,507423,Fischer-Grunski; Eva K,19,0,20,1
1715626053609,LIGM 5C,A00,507425,Fischer-Grunski; Eva K,19,0,20,1
1715626054636,LIIT 5AS,A00,507427,Carnelos; Chiara,20,0,20,0
1715626055661,LIIT 5BS,A00,507430,Carnelos; Chiara,20,0,20,0
1715626056686,LIIT 5CS,A00,507432,Carnelos; Chiara,20,0,20,0
1715626057715,LISP 5A,A00,507541,Munoz Sanchez; Alicia,11,0,20,9
1715626058744,LISP 5B,A00,507671,Munoz Sanchez; Alicia,9,0,20,11
1715626059773,LISP 5C,A00,507696,Munoz Sanchez; Alicia,9,0,20,11
1715626060799,MAE 197,001,528363,Boechler; Nicholas Sebastia,9998,0,9999,1
1715626061844,MATH 197,001,523477,Kedlaya; Kiran S.,9994,0,9999,5
1715626061844,MATH 197,002,563811,Zhang; Danna,9994,0,9999,5
1715626061844,MATH 197,003,628552,Dumitriu; Ioana,9998,0,9999,1
1715626061844,MATH 197,004,660885,Floyd; Eric,9998,0,9999,1
1715626062871,MCWP 40R,A00,518780,Staff,2,0,20,18
1715626062871,MCWP 40R,B00,518781,Staff,11,0,20,9
1715626062871,MCWP 40R,C00,518783,Staff,5,0,20,15
1715626063909,MCWP 50R,A00,518791,Staff,0,1,20,20
1715626063909,MCWP 50R,B00,518792,Staff,0,2,20,20
1715626063909,MCWP 50R,C00,518793,Staff,0,4,20,20
1715626063909,MCWP 50R,D00,518794,Staff,0,1,20,20
1715626063909,MCWP 50R,E00,518795,Staff,0,2,20,20
1715626063909,MCWP 50R,F00,518796,Staff,0,1,20,20
1715626063909,MCWP 50R,G00,518797,Staff,0,1,20,20
1715626064936,MMW 12R,A01,514034,Herbst; Matthew,0,2,16,16
1715626064936,MMW 12R,A02,514035,Herbst; Matthew,0,0,16,16
1715626065965,MMW 13R,A01,514037,Staff,0,5,16,16
1715626065965,MMW 13R,A02,514039,Staff,0,5,16,16
1715626065965,MMW 13R,A03,628519,Staff,0,4,16,16
1715626068018,SIO 295LS,A00,523233,Staff,10,0,30,20
1715626069044,SIO 295S,A00,523232,Staff,10,0,30,20
1715626070070,SIOC 290S,A01,637330,Merrifield; Mark A,22,0,30,8
1715626071099,SIOC 291S,A01,637333,Gabriel; Corey John,22,0,30,8
1715626072128,SOCI 117,A01,494376,Staff,0,5,5,5
1715626073158,WES 237B,A00,494380,Staff,10,0,20,10
1715626075235,AESE 279B,A00,494370,Wade; Jon P,0,0,33,33
1715626076261,AIP 97,001,660915,Van Den Einde; Yael Dahlia,9998,0,9999,1
1715626077285,AIP 197,001,627712,Vespa; Emanuel Ignacio,9995,0,9999,4
1715626077285,AIP 197,002,650778,Amir; On,9998,0,9999,1
1715626077285,AIP 197,003,650933,Avenancio-Leon; Carlos,9998,0,9999,1
1715626077285,AIP 197,004,658530,Heyman; Gail D.,9998,0,9999,1
1715626077285,AIP 197,005,658631,Neal; Sonya E,9998,0,9999,1
1715626077285,AIP 197,006,658671,Du; Songzi,9998,0,9999,1
1715626078310,ANAR 135S,A00,494369,Braswell; Geoffrey E.,0,0,0,0
1715626079335,BENG 196,001,628496,Engler; Adam J.,9998,0,9999,1
1715626079335,BENG 196,002,660916,Watson; John Thomas,9999,0,9999,0
1715626080360,BISP 197,001,650773,Wilhelm; James E.,9994,0,9999,5
1715626080360,BISP 197,002,658904,Coleman; Aaron B.,9998,0,9999,1
1715626081389,CAT 124RS,A01,519847,Geibel; William,0,0,20,20
1715626082418,CAT 125RS,A01,515971,Geibel; William,0,0,20,20
1715626083446,CLRE 250,A00,511389,Morris; Sheldon,9992,0,9999,7
1715626084471,CLRE 251,A00,507176,Mehta; Ravindra L.,9992,0,9999,7
1715626084471,CLRE 251,B00,511410,Mehta; Ravindra L.,9998,0,9999,1
1715626085498,CLRE 252,A00,507189,Cuomo; Raphael Eduardo,9994,0,9999,5
1715626086526,CLRE 253,A00,507199,Vaida; Florin,9994,0,9999,5
1715626086526,CLRE 253,B00,507202,Vaida; Florin,9999,0,9999,0
1715626087555,CLRE 259,A00,507211,Patel; Hemal,9996,0,9999,3
1715626088581,CLRE 260,A00,507221,Cuomo; Raphael Eduardo,9999,0,9999,0
1715626089607,CLRE 297,001,507242,Cuomo; Raphael Eduardo,9999,0,9999,0
1715626090633,COGS 197,001,638244,Voytek; Bradley Thomas,9997,0,9999,2
1715626091657,CSE 191,A00,516875,Minnes Kemp; Mor Mia,9991,0,9999,8
1715626092684,CSE 197,001,637388,Minnes Kemp; Mor Mia,9992,0,9999,7
1715626093709,CSS 201S,A01,494383,Mignozzetti; Umberto,35,0,35,0
1715626094735,CSS 202S,A01,494387,Mignozzetti; Umberto,35,0,35,0
1715626095761,DSC 197,001,628532,Eldridge; Justin Matthew,9995,0,9999,4
1715626096788,EAP 100,A00,516065,Staff,9799,0,9999,200
1715626097816,ECE 45,A01,507414,Staff,31,0,60,29
1715626099868,ECE 111,A01,507420,Staff,11,0,50,39
1715626100896,ECE 197,001,548057,Sievenpiper; Daniel F.,9991,0,9999,8
1715626101923,EDS 115,A00,507243,Choi; Bailey Miyeon,7,0,28,21
1715626102952,EDS 117,A01,494379,Staff,0,6,34,34
1715626103979,EDS 125,A00,507246,Hopkins; Megan Beth,8,0,30,22
1715626105004,EDS 128A,A01,507264,Fargason; Sharon Gayle,6,0,26,20
1715626106031,EDS 128B,A01,507293,Pappas; Elizabeth,10,0,30,20
1715626107059,EDS 139,A00,507294,Fargason; Sharon Gayle,10,0,30,20
1715626107059,EDS 139,B00,507313,Pappas; Elizabeth,11,0,30,19
1715626108083,EDS 201,A00,507315,Staff,10,0,30,20
1715626109114,EDS 203,A01,507317,Halter; Christopher P.,10,0,30,20
1715626110142,EDS 204R,A01,507319,Halter; Christopher P.,0,3,30,30
1715626110142,EDS 204R,B01,507331,Heinzman; Erica M.,14,0,30,16
1715626111171,EDS 206R,A00,507332,Staff,0,4,30,30
1715626111171,EDS 206R,B00,507343,Staff,15,0,30,15
1715626112196,EDS 250,A00,507344,Hemans; Patricia Ann Benitez,20,0,40,20
1715626113228,EDS 281,A00,507345,Daly; Alan J.,18,0,18,0
1715626114258,EDS 284,A00,507350,Daly; Alan J.,16,0,16,0
1715626115286,EDS 286,A00,507359,Fine; Sarah,18,0,18,0
1715626116312,EDS 289C,A01,507361,Daly; Alan J.,18,0,18,0
1715626117338,EDS 290,A00,507366,Hofstetter; Carolyn,15,0,15,0
1715626118368,LIGM 5A,A00,507421,Fischer-Grunski; Eva K,17,0,20,3
1715626119393,LIGM 5B,A00,507423,Fischer-Grunski; Eva K,19,0,20,1
1715626120477,LIGM 5C,A00,507425,Fischer-Grunski; Eva K,19,0,20,1
1715626121503,LIIT 5AS,A00,507427,Carnelos; Chiara,20,0,20,0
1715626122528,LIIT 5BS,A00,507430,Carnelos; Chiara,20,0,20,0
1715626123554,LIIT 5CS,A00,507432,Carnelos; Chiara,20,0,20,0
1715626124581,LISP 5A,A00,507541,Munoz Sanchez; Alicia,11,0,20,9
1715626125606,LISP 5B,A00,507671,Munoz Sanchez; Alicia,9,0,20,11
1715626126634,LISP 5C,A00,507696,Munoz Sanchez; Alicia,9,0,20,11
1715626127663,MAE 197,001,528363,Boechler; Nicholas Sebastia,9998,0,9999,1
1715626128690,MATH 197,001,523477,Kedlaya; Kiran S.,9994,0,9999,5
1715626128690,MATH 197,002,563811,Zhang; Danna,9994,0,9999,5
1715626128690,MATH 197,003,628552,Dumitriu; Ioana,9998,0,9999,1
1715626128690,MATH 197,004,660885,Floyd; Eric,9998,0,9999,1
1715626129719,MCWP 40R,A00,518780,Staff,2,0,20,18
1715626129719,MCWP 40R,B00,518781,Staff,11,0,20,9
1715626129719,MCWP 40R,C00,518783,Staff,5,0,20,15
1715626130749,MCWP 50R,A00,518791,Staff,0,1,20,20
1715626130749,MCWP 50R,B00,518792,Staff,0,2,20,20
1715626130749,MCWP 50R,C00,518793,Staff,0,4,20,20
1715626130749,MCWP 50R,D00,518794,Staff,0,1,20,20
1715626130749,MCWP 50R,E00,518795,Staff,0,2,20,20
1715626130749,MCWP 50R,F00,518796,Staff,0,1,20,20
1715626130749,MCWP 50R,G00,518797,Staff,0,1,20,20
1715626131777,MMW 12R,A01,514034,Herbst; Matthew,0,2,16,16
1715626131777,MMW 12R,A02,514035,Herbst; Matthew,0,0,16,16
1715626132802,MMW 13R,A01,514037,Staff,0,5,16,16
1715626132802,MMW 13R,A02,514039,Staff,0,5,16,16
1715626132802,MMW 13R,A03,628519,Staff,0,4,16,16
1715626134854,SIO 295LS,A00,523233,Staff,10,0,30,20
1715626135881,SIO 295S,A00,523232,Staff,10,0,30,20
1715626136914,SIOC 290S,A01,637330,Merrifield; Mark A,22,0,30,8
1715626137940,SIOC 291S,A01,637333,Gabriel; Corey John,22,0,30,8
1715626138972,SOCI 117,A01,494376,Staff,0,5,5,5
1715626139998,WES 237B,A00,494380,Staff,10,0,20,10
1715626142068,AESE 279B,A00,494370,Wade; Jon P,0,0,33,33
1715626143100,AIP 97,001,660915,Van Den Einde; Yael Dahlia,9998,0,9999,1
1715626144134,AIP 197,001,627712,Vespa; Emanuel Ignacio,9995,0,9999,4
1715626144134,AIP 197,002,650778,Amir; On,9998,0,9999,1
1715626144134,AIP 197,003,650933,Avenancio-Leon; Carlos,9998,0,9999,1
1715626144134,AIP 197,004,658530,Heyman; Gail D.,9998,0,9999,1
1715626144134,AIP 197,005,658631,Neal; Sonya E,9998,0,9999,1
1715626144134,AIP 197,006,658671,Du; Songzi,9998,0,9999,1
1715626145161,ANAR 135S,A00,494369,Braswell; Geoffrey E.,0,0,0,0
1715626146187,BENG 196,001,628496,Engler; Adam J.,9998,0,9999,1
1715626146187,BENG 196,002,660916,Watson; John Thomas,9999,0,9999,0
1715626147213,BISP 197,001,650773,Wilhelm; James E.,9994,0,9999,5
1715626147213,BISP 197,002,658904,Coleman; Aaron B.,9998,0,9999,1
1715626148237,CAT 124RS,A01,519847,Geibel; William,0,0,20,20
1715626149265,CAT 125RS,A01,515971,Geibel; William,0,0,20,20
1715626150294,CLRE 250,A00,511389,Morris; Sheldon,9992,0,9999,7
1715626151321,CLRE 251,A00,507176,Mehta; Ravindra L.,9992,0,9999,7
1715626151321,CLRE 251,B00,511410,Mehta; Ravindra L.,9998,0,9999,1
1715626152346,CLRE 252,A00,507189,Cuomo; Raphael Eduardo,9994,0,9999,5
1715626153373,CLRE 253,A00,507199,Vaida; Florin,9994,0,9999,5
1715626153373,CLRE 253,B00,507202,Vaida; Florin,9999,0,9999,0
1715626154398,CLRE 259,A00,507211,Patel; Hemal,9996,0,9999,3
1715626155422,CLRE 260,A00,507221,Cuomo; Raphael Eduardo,9999,0,9999,0
1715626156449,CLRE 297,001,507242,Cuomo; Raphael Eduardo,9999,0,9999,0
1715626157477,COGS 197,001,638244,Voytek; Bradley Thomas,9997,0,9999,2
1715626158503,CSE 191,A00,516875,Minnes Kemp; Mor Mia,9991,0,9999,8
1715626159530,CSE 197,001,637388,Minnes Kemp; Mor Mia,9992,0,9999,7
1715626160556,CSS 201S,A01,494383,Mignozzetti; Umberto,35,0,35,0
1715626161584,CSS 202S,A01,494387,Mignozzetti; Umberto,35,0,35,0
1715626162612,DSC 197,001,628532,Eldridge; Justin Matthew,9995,0,9999,4
1715626163640,EAP 100,A00,516065,Staff,9799,0,9999,200
1715626164674,ECE 45,A01,507414,Staff,31,0,60,29
1715626166723,ECE 111,A01,507420,Staff,11,0,50,39
1715626167752,ECE 197,001,548057,Sievenpiper; Daniel F.,9991,0,9999,8
1715626168778,EDS 115,A00,507243,Choi; Bailey Miyeon,7,0,28,21
1715626169805,EDS 117,A01,494379,Staff,0,6,34,34
1715626170830,EDS 125,A00,507246,Hopkins; Megan Beth,8,0,30,22
1715626171859,EDS 128A,A01,507264,Fargason; Sharon Gayle,6,0,26,20
1715626172889,EDS 128B,A01,507293,Pappas; Elizabeth,10,0,30,20
1715626173916,EDS 139,A00,507294,Fargason; Sharon Gayle,10,0,30,20
1715626173916,EDS 139,B00,507313,Pappas; Elizabeth,11,0,30,19
1715626174940,EDS 201,A00,507315,Staff,10,0,30,20
1715626175966,EDS 203,A01,507317,Halter; Christopher P.,10,0,30,20
1715626176995,EDS 204R,A01,507319,Halter; Christopher P.,0,3,30,30
1715626176995,EDS 204R,B01,507331,Heinzman; Erica M.,14,0,30,16
1715626178019,EDS 206R,A00,507332,Staff,0,4,30,30
1715626178019,EDS 206R,B00,507343,Staff,15,0,30,15
1715626179046,EDS 250,A00,507344,Hemans; Patricia Ann Benitez,20,0,40,20
1715626180070,EDS 281,A00,507345,Daly; Alan J.,18,0,18,0
1715626181097,EDS 284,A00,507350,Daly; Alan J.,16,0,16,0
1715626182124,EDS 286,A00,507359,Fine; Sarah,18,0,18,0
1715626183149,EDS 289C,A01,507361,Daly; Alan J.,18,0,18,0
1715626184175,EDS 290,A00,507366,Hofstetter; Carolyn,15,0,15,0
1715626185202,LIGM 5A,A00,507421,Fischer-Grunski; Eva K,17,0,20,3
1715626186228,LIGM 5B,A00,507423,Fischer-Grunski; Eva K,19,0,20,1
1715626187258,LIGM 5C,A00,507425,Fischer-Grunski; Eva K,19,0,20,1
1715626188284,LIIT 5AS,A00,507427,Carnelos; Chiara,20,0,20,0
1715626189310,LIIT 5BS,A00,507430,Carnelos; Chiara,20,0,20,0
1715626190334,LIIT 5CS,A00,507432,Carnelos; Chiara,20,0,20,0
1715626191364,LISP 5A,A00,507541,Munoz Sanchez; Alicia,11,0,20,9
1715626192394,LISP 5B,A00,507671,Munoz Sanchez; Alicia,9,0,20,11
1715626193422,LISP 5C,A00,507696,Munoz Sanchez; Alicia,9,0,20,11
1715626194448,MAE 197,001,528363,Boechler; Nicholas Sebastia,9998,0,9999,1
1715626195478,MATH 197,001,523477,Kedlaya; Kiran S.,9994,0,9999,5
1715626195478,MATH 197,002,563811,Zhang; Danna,9994,0,9999,5
1715626195478,MATH 197,003,628552,Dumitriu; Ioana,9998,0,9999,1
1715626195478,MATH 197,004,660885,Floyd; Eric,9998,0,9999,1
1715626196504,MCWP 40R,A00,518780,Staff,2,0,20,18
1715626196504,MCWP 40R,B00,518781,Staff,11,0,20,9
1715626196504,MCWP 40R,C00,518783,Staff,5,0,20,15
1715626197535,MCWP 50R,A00,518791,Staff,0,1,20,20
1715626197535,MCWP 50R,B00,518792,Staff,0,2,20,20
1715626197535,MCWP 50R,C00,518793,Staff,0,4,20,20
1715626197535,MCWP 50R,D00,518794,Staff,0,1,20,20
1715626197535,MCWP 50R,E00,518795,Staff,0,2,20,20
1715626197535,MCWP 50R,F00,518796,Staff,0,1,20,20
1715626197535,MCWP 50R,G00,518797,Staff,0,1,20,20
1715626198566,MMW 12R,A01,514034,Herbst; Matthew,0,2,16,16
1715626198566,MMW 12R,A02,514035,Herbst; Matthew,0,0,16,16
1715626199594,MMW 13R,A01,514037,Staff,0,5,16,16
1715626199594,MMW 13R,A02,514039,Staff,0,5,16,16
1715626199594,MMW 13R,A03,628519,Staff,0,4,16,16
1715626201647,SIO 295LS,A00,523233,Staff,10,0,30,20
1715626202673,SIO 295S,A00,523232,Staff,10,0,30,20
1715626203697,SIOC 290S,A01,637330,Merrifield; Mark A,22,0,30,8
1715626204724,SIOC 291S,A01,637333,Gabriel; Corey John,22,0,30,8
1715626205751,SOCI 117,A01,494376,Staff,0,5,5,5
1715626206776,WES 237B,A00,494380,Staff,10,0,20,10
1715626208859,AESE 279B,A00,494370,Wade; Jon P,0,0,33,33
1715626209884,AIP 97,001,660915,Van Den Einde; Yael Dahlia,9998,0,9999,1
1715626210913,AIP 197,001,627712,Vespa; Emanuel Ignacio,9995,0,9999,4
1715626210913,AIP 197,002,650778,Amir; On,9998,0,9999,1
1715626210913,AIP 197,003,650933,Avenancio-Leon; Carlos,9998,0,9999,1
1715626210913,AIP 197,004,658530,Heyman; Gail D.,9998,0,9999,1
1715626210913,AIP 197,005,658631,Neal; Sonya E,9998,0,9999,1
1715626210913,AIP 197,006,658671,Du; Songzi,9998,0,9999,1
1715626211937,ANAR 135S,A00,494369,Braswell; Geoffrey E.,0,0,0,0
1715626212962,BENG 196,001,628496,Engler; Adam J.,9998,0,9999,1
1715626212962,BENG 196,002,660916,Watson; John Thomas,9999,0,9999,0
1715626213986,BISP 197,001,650773,Wilhelm; James E.,9994,0,9999,5
1715626213986,BISP 197,002,658904,Coleman; Aaron B.,9998,0,9999,1
1715626215013,CAT 124RS,A01,519847,Geibel; William,0,0,20,20
1715626216037,CAT 125RS,A01,515971,Geibel; William,0,0,20,20
1715626217066,CLRE 250,A00,511389,Morris; Sheldon,9992,0,9999,7
1715626218095,CLRE 251,A00,507176,Mehta; Ravindra L.,9992,0,9999,7
1715626218095,CLRE 251,B00,511410,Mehta; Ravindra L.,9998,0,9999,1
1715626219123,CLRE 252,A00,507189,Cuomo; Raphael Eduardo,9994,0,9999,5
1715626220148,CLRE 253,A00,507199,Vaida; Florin,9994,0,9999,5
1715626220148,CLRE 253,B00,507202,Vaida; Florin,9999,0,9999,0
1715626221176,CLRE 259,A00,507211,Patel; Hemal,9996,0,9999,3
1715626222203,CLRE 260,A00,507221,Cuomo; Raphael Eduardo,9999,0,9999,0
1715626223227,CLRE 297,001,507242,Cuomo; Raphael Eduardo,9999,0,9999,0
1715626224253,COGS 197,001,638244,Voytek; Bradley Thomas,9997,0,9999,2
1715626225280,CSE 191,A00,516875,Minnes Kemp; Mor Mia,9991,0,9999,8
1715626226306,CSE 197,001,637388,Minnes Kemp; Mor Mia,9992,0,9999,7
1715626227337,CSS 201S,A01,494383,Mignozzetti; Umberto,35,0,35,0
1715626228364,CSS 202S,A01,494387,Mignozzetti; Umberto,35,0,35,0
1715626229389,DSC 197,001,628532,Eldridge; Justin Matthew,9995,0,9999,4
1715626230416,EAP 100,A00,516065,Staff,9799,0,9999,200
1715626231444,ECE 45,A01,507414,Staff,31,0,60,29
1715626233497,ECE 111,A01,507420,Staff,11,0,50,39
1715626234525,ECE 197,001,548057,Sievenpiper; Daniel F.,9991,0,9999,8
1715626235555,EDS 115,A00,507243,Choi; Bailey Miyeon,7,0,28,21
1715626236583,EDS 117,A01,494379,Staff,0,6,34,34
1715626237609,EDS 125,A00,507246,Hopkins; Megan Beth,8,0,30,22
1715626238636,EDS 128A,A01,507264,Fargason; Sharon Gayle,6,0,26,20
1715626239666,EDS 128B,A01,507293,Pappas; Elizabeth,10,0,30,20
1715626240693,EDS 139,A00,507294,Fargason; Sharon Gayle,10,0,30,20
1715626240693,EDS 139,B00,507313,Pappas; Elizabeth,11,0,30,19
1715626241717,EDS 201,A00,507315,Staff,10,0,30,20
1715626242744,EDS 203,A01,507317,Halter; Christopher P.,10,0,30,20
1715626243773,EDS 204R,A01,507319,Halter; Christopher P.,0,3,30,30
1715626243773,EDS 204R,B01,507331,Heinzman; Erica M.,14,0,30,16
1715626244798,EDS 206R,A00,507332,Staff,0,4,30,30
1715626244798,EDS 206R,B00,507343,Staff,15,0,30,15
1715626245826,EDS 250,A00,507344,Hemans; Patricia Ann Benitez,20,0,40,20
1715626246852,EDS 281,A00,507345,Daly; Alan J.,18,0,18,0
1715626247880,EDS 284,A00,507350,Daly; Alan J.,16,0,16,0
1715626248907,EDS 286,A00,507359,Fine; Sarah,18,0,18,0
1715626249931,EDS 289C,A01,507361,Daly; Alan J.,18,0,18,0
1715626250957,EDS 290,A00,507366,Hofstetter; Carolyn,15,0,15,0
1715626251982,LIGM 5A,A00,507421,Fischer-Grunski; Eva K,17,0,20,3
1715626253008,LIGM 5B,A00,507423,Fischer-Grunski; Eva K,19,0,20,1
1715626254037,LIGM 5C,A00,507425,Fischer-Grunski; Eva K,19,0,20,1
1715626255063,LIIT 5AS,A00,507427,Carnelos; Chiara,20,0,20,0
1715626256089,LIIT 5BS,A00,507430,Carnelos; Chiara,20,0,20,0
1715626257115,LIIT 5CS,A00,507432,Carnelos; Chiara,20,0,20,0
1715626258142,LISP 5A,A00,507541,Munoz Sanchez; Alicia,11,0,20,9
1715626259169,LISP 5B,A00,507671,Munoz Sanchez; Alicia,9,0,20,11
1715626260202,LISP 5C,A00,507696,Munoz Sanchez; Alicia,9,0,20,11
1715626261229,MAE 197,001,528363,Boechler; Nicholas Sebastia,9998,0,9999,1
1715626262257,MATH 197,001,523477,Kedlaya; Kiran S.,9994,0,9999,5
1715626262257,MATH 197,002,563811,Zhang; Danna,9994,0,9999,5
1715626262257,MATH 197,003,628552,Dumitriu; Ioana,9998,0,9999,1
1715626262257,MATH 197,004,660885,Floyd; Eric,9998,0,9999,1
1715626263302,MCWP 40R,A00,518780,Staff,2,0,20,18
1715626263302,MCWP 40R,B00,518781,Staff,11,0,20,9
1715626263302,MCWP 40R,C00,518783,Staff,5,0,20,15
1715626264333,MCWP 50R,A00,518791,Staff,0,1,20,20
1715626264333,MCWP 50R,B00,518792,Staff,0,2,20,20
1715626264333,MCWP 50R,C00,518793,Staff,0,4,20,20
1715626264333,MCWP 50R,D00,518794,Staff,0,1,20,20
1715626264333,MCWP 50R,E00,518795,Staff,0,2,20,20
1715626264333,MCWP 50R,F00,518796,Staff,0,1,20,20
1715626264333,MCWP 50R,G00,518797,Staff,0,1,20,20
1715626265362,MMW 12R,A01,514034,Herbst; Matthew,0,2,16,16
1715626265362,MMW 12R,A02,514035,Herbst; Matthew,0,0,16,16
1715626266392,MMW 13R,A01,514037,Staff,0,5,16,16
1715626266392,MMW 13R,A02,514039,Staff,0,5,16,16
1715626266392,MMW 13R,A03,628519,Staff,0,4,16,16
1715626268447,SIO 295LS,A00,523233,Staff,10,0,30,20
1715626269472,SIO 295S,A00,523232,Staff,10,0,30,20
1715626270502,SIOC 290S,A01,637330,Merrifield; Mark A,22,0,30,8
1715626271529,SIOC 291S,A01,637333,Gabriel; Corey John,22,0,30,8
1715626272554,SOCI 117,A01,494376,Staff,0,5,5,5
1715626273583,WES 237B,A00,494380,Staff,10,0,20,10
1715626275658,AESE 279B,A00,494370,Wade; Jon P,0,0,33,33
1715626276684,AIP 97,001,660915,Van Den Einde; Yael Dahlia,9998,0,9999,1
1715626277711,AIP 197,001,627712,Vespa; Emanuel Ignacio,9995,0,9999,4
1715626277711,AIP 197,002,650778,Amir; On,9998,0,9999,1
1715626277711,AIP 197,003,650933,Avenancio-Leon; Carlos,9998,0,9999,1
1715626277711,AIP 197,004,658530,Heyman; Gail D.,9998,0,9999,1
1715626277711,AIP 197,005,658631,Neal; Sonya E,9998,0,9999,1
1715626277711,AIP 197,006,658671,Du; Songzi,9998,0,9999,1
1715626278738,ANAR 135S,A00,494369,Braswell; Geoffrey E.,0,0,0,0
1715626279764,BENG 196,001,628496,Engler; Adam J.,9998,0,9999,1
1715626279764,BENG 196,002,660916,Watson; John Thomas,9999,0,9999,0
1715626280792,BISP 197,001,650773,Wilhelm; James E.,9994,0,9999,5
1715626280792,BISP 197,002,658904,Coleman; Aaron B.,9998,0,9999,1
1715626281821,CAT 124RS,A01,519847,Geibel; William,0,0,20,20
1715626282848,CAT 125RS,A01,515971,Geibel; William,0,0,20,20
1715626283874,CLRE 250,A00,511389,Morris; Sheldon,9992,0,9999,7
1715626284904,CLRE 251,A00,507176,Mehta; Ravindra L.,9992,0,9999,7
1715626284904,CLRE 251,B00,511410,Mehta; Ravindra L.,9998,0,9999,1
1715626285928,CLRE 252,A00,507189,Cuomo; Raphael Eduardo,9994,0,9999,5
1715626286955,CLRE 253,A00,507199,Vaida; Florin,9994,0,9999,5
1715626286955,CLRE 253,B00,507202,Vaida; Florin,9999,0,9999,0
1715626287981,CLRE 259,A00,507211,Patel; Hemal,9996,0,9999,3
1715626289008,CLRE 260,A00,507221,Cuomo; Raphael Eduardo,9999,0,9999,0
1715626290033,CLRE 297,001,507242,Cuomo; Raphael Eduardo,9999,0,9999,0
1715626291059,COGS 197,001,638244,Voytek; Bradley Thomas,9997,0,9999,2
1715626292086,CSE 191,A00,516875,Minnes Kemp; Mor Mia,9991,0,9999,8
1715626293112,CSE 197,001,637388,Minnes Kemp; Mor Mia,9992,0,9999,7
1715626294140,CSS 201S,A01,494383,Mignozzetti; Umberto,35,0,35,0
1715626295167,CSS 202S,A01,494387,Mignozzetti; Umberto,35,0,35,0
1715626296197,DSC 197,001,628532,Eldridge; Justin Matthew,9995,0,9999,4
1715626297226,EAP 100,A00,516065,Staff,9799,0,9999,200
1715626298254,ECE 45,A01,507414,Staff,31,0,60,29
1715626300309,ECE 111,A01,507420,Staff,11,0,50,39
1715626301339,ECE 197,001,548057,Sievenpiper; Daniel F.,9991,0,9999,8
1715626302363,EDS 115,A00,507243,Choi; Bailey Miyeon,7,0,28,21
1715626303391,EDS 117,A01,494379,Staff,0,6,34,34
1715626304422,EDS 125,A00,507246,Hopkins; Megan Beth,8,0,30,22
1715626305448,EDS 128A,A01,507264,Fargason; Sharon Gayle,6,0,26,20
1715626306476,EDS 128B,A01,507293,Pappas; Elizabeth,10,0,30,20
1715626307502,EDS 139,A00,507294,Fargason; Sharon Gayle,10,0,30,20
1715626307502,EDS 139,B00,507313,Pappas; Elizabeth,11,0,30,19
1715626308532,EDS 201,A00,507315,Staff,10,0,30,20
1715626309558,EDS 203,A01,507317,Halter; Christopher P.,10,0,30,20
1715626310588,EDS 204R,A01,507319,Halter; Christopher P.,0,3,30,30
1715626310588,EDS 204R,B01,507331,Heinzman; Erica M.,14,0,30,16
1715626311619,EDS 206R,A00,507332,Staff,0,4,30,30
1715626311619,EDS 206R,B00,507343,Staff,15,0,30,15
1715626312646,EDS 250,A00,507344,Hemans; Patricia Ann Benitez,20,0,40,20
1715626313673,EDS 281,A00,507345,Daly; Alan J.,18,0,18,0
1715626314697,EDS 284,A00,507350,Daly; Alan J.,16,0,16,0
1715626315723,EDS 286,A00,507359,Fine; Sarah,18,0,18,0
1715626316749,EDS 289C,A01,507361,Daly; Alan J.,18,0,18,0
1715626317779,EDS 290,A00,507366,Hofstetter; Carolyn,15,0,15,0
1715626318809,LIGM 5A,A00,507421,Fischer-Grunski; Eva K,17,0,20,3
1715626319838,LIGM 5B,A00,507423,Fischer-Grunski; Eva K,19,0,20,1
1715626320866,LIGM 5C,A00,507425,Fischer-Grunski; Eva K,19,0,20,1
1715626321892,LIIT 5AS,A00,507427,Carnelos; Chiara,20,0,20,0
1715626322921,LIIT 5BS,A00,507430,Carnelos; Chiara,20,0,20,0
1715626323948,LIIT 5CS,A00,507432,Carnelos; Chiara,20,0,20,0
1715626324979,LISP 5A,A00,507541,Munoz Sanchez; Alicia,11,0,20,9
1715626326011,LISP 5B,A00,507671,Munoz Sanchez; Alicia,9,0,20,11
1715626327044,LISP 5C,A00,507696,Munoz Sanchez; Alicia,9,0,20,11
1715626328075,MAE 197,001,528363,Boechler; Nicholas Sebastia,9998,0,9999,1
1715626329101,MATH 197,001,523477,Kedlaya; Kiran S.,9994,0,9999,5
1715626329101,MATH 197,002,563811,Zhang; Danna,9994,0,9999,5
1715626329101,MATH 197,003,628552,Dumitriu; Ioana,9998,0,9999,1
1715626329101,MATH 197,004,660885,Floyd; Eric,9998,0,9999,1
1715626330127,MCWP 40R,A00,518780,Staff,2,0,20,18
1715626330127,MCWP 40R,B00,518781,Staff,11,0,20,9
1715626330127,MCWP 40R,C00,518783,Staff,5,0,20,15
1715626331156,MCWP 50R,A00,518791,Staff,0,1,20,20
1715626331156,MCWP 50R,B00,518792,Staff,0,2,20,20
1715626331156,MCWP 50R,C00,518793,Staff,0,4,20,20
1715626331156,MCWP 50R,D00,518794,Staff,0,1,20,20
1715626331156,MCWP 50R,E00,518795,Staff,0,2,20,20
1715626331156,MCWP 50R,F00,518796,Staff,0,1,20,20
1715626331156,MCWP 50R,G00,518797,Staff,0,1,20,20
1715626332182,MMW 12R,A01,514034,Herbst; Matthew,0,2,16,16
1715626332182,MMW 12R,A02,514035,Herbst; Matthew,0,0,16,16
1715626333207,MMW 13R,A01,514037,Staff,0,5,16,16
1715626333207,MMW 13R,A02,514039,Staff,0,5,16,16
1715626333207,MMW 13R,A03,628519,Staff,0,4,16,16
1715626335260,SIO 295LS,A00,523233,Staff,10,0,30,20
1715626336287,SIO 295S,A00,523232,Staff,10,0,30,20
1715626337318,SIOC 290S,A01,637330,Merrifield; Mark A,22,0,30,8
1715626338348,SIOC 291S,A01,637333,Gabriel; Corey John,22,0,30,8
1715626339375,SOCI 117,A01,494376,Staff,0,5,5,5
1715626340401,WES 237B,A00,494380,Staff,10,0,20,10
1715626342466,AESE 279B,A00,494370,Wade; Jon P,0,0,33,33
1715626343491,AIP 97,001,660915,Van Den Einde; Yael Dahlia,9998,0,9999,1
1715626344517,AIP 197,001,627712,Vespa; Emanuel Ignacio,9995,0,9999,4
1715626344517,AIP 197,002,650778,Amir; On,9998,0,9999,1
1715626344517,AIP 197,003,650933,Avenancio-Leon; Carlos,9998,0,9999,1
1715626344517,AIP 197,004,658530,Heyman; Gail D.,9998,0,9999,1
1715626344517,AIP 197,005,658631,Neal; Sonya E,9998,0,9999,1
1715626344517,AIP 197,006,658671,Du; Songzi,9998,0,9999,1
1715626345546,ANAR 135S,A00,494369,Braswell; Geoffrey E.,0,0,0,0
1715626346570,BENG 196,001,628496,Engler; Adam J.,9998,0,9999,1
1715626346570,BENG 196,002,660916,Watson; John Thomas,9999,0,9999,0
1715626347599,BISP 197,001,650773,Wilhelm; James E.,9994,0,9999,5
1715626347599,BISP 197,002,658904,Coleman; Aaron B.,9998,0,9999,1
1715626348626,CAT 124RS,A01,519847,Geibel; William,0,0,20,20
1715626349652,CAT 125RS,A01,515971,Geibel; William,0,0,20,20
1715626350680,CLRE 250,A00,511389,Morris; Sheldon,9992,0,9999,7
1715626351709,CLRE 251,A00,507176,Mehta; Ravindra L.,9992,0,9999,7
1715626351709,CLRE 251,B00,511410,Mehta; Ravindra L.,9998,0,9999,1
1715626352738,CLRE 252,A00,507189,Cuomo; Raphael Eduardo,9994,0,9999,5
1715626353767,CLRE 253,A00,507199,Vaida; Florin,9994,0,9999,5
1715626353767,CLRE 253,B00,507202,Vaida; Florin,9999,0,9999,0
1715626354794,CLRE 259,A00,507211,Patel; Hemal,9996,0,9999,3
1715626355817,CLRE 260,A00,507221,Cuomo; Raphael Eduardo,9999,0,9999,0
1715626356847,CLRE 297,001,507242,Cuomo; Raphael Eduardo,9999,0,9999,0
1715626357874,COGS 197,001,638244,Voytek; Bradley Thomas,9997,0,9999,2
1715626358899,CSE 191,A00,516875,Minnes Kemp; Mor Mia,9991,0,9999,8
1715626359928,CSE 197,001,637388,Minnes Kemp; Mor Mia,9992,0,9999,7
1715626361143,CSS 201S,A01,494383,Mignozzetti; Umberto,35,0,35,0
1715626362174,CSS 202S,A01,494387,Mignozzetti; Umberto,35,0,35,0
1715626363200,DSC 197,001,628532,Eldridge; Justin Matthew,9995,0,9999,4
1715626364225,EAP 100,A00,516065,Staff,9799,0,9999,200
1715626365255,ECE 45,A01,507414,Staff,31,0,60,29
1715626367308,ECE 111,A01,507420,Staff,11,0,50,39
1715626368331,ECE 197,001,548057,Sievenpiper; Daniel F.,9991,0,9999,8
1715626369356,EDS 115,A00,507243,Choi; Bailey Miyeon,7,0,28,21
1715626370385,EDS 117,A01,494379,Staff,0,6,34,34
1715626371415,EDS 125,A00,507246,Hopkins; Megan Beth,8,0,30,22
1715626372445,EDS 128A,A01,507264,Fargason; Sharon Gayle,6,0,26,20
1715626373475,EDS 128B,A01,507293,Pappas; Elizabeth,10,0,30,20
1715626374501,EDS 139,A00,507294,Fargason; Sharon Gayle,10,0,30,20
1715626374501,EDS 139,B00,507313,Pappas; Elizabeth,11,0,30,19
1715626375527,EDS 201,A00,507315,Staff,10,0,30,20
1715626376556,EDS 203,A01,507317,Halter; Christopher P.,10,0,30,20
1715626377581,EDS 204R,A01,507319,Halter; Christopher P.,0,3,30,30
1715626377581,EDS 204R,B01,507331,Heinzman; Erica M.,14,0,30,16
1715626378604,EDS 206R,A00,507332,Staff,0,4,30,30
1715626378604,EDS 206R,B00,507343,Staff,15,0,30,15
1715626379634,EDS 250,A00,507344,Hemans; Patricia Ann Benitez,20,0,40,20
1715626380660,EDS 281,A00,507345,Daly; Alan J.,18,0,18,0
1715626381687,EDS 284,A00,507350,Daly; Alan J.,16,0,16,0
1715626382713,EDS 286,A00,507359,Fine; Sarah,18,0,18,0
1715626383737,EDS 289C,A01,507361,Daly; Alan J.,18,0,18,0
1715626384765,EDS 290,A00,507366,Hofstetter; Carolyn,15,0,15,0
1715626385790,LIGM 5A,A00,507421,Fischer-Grunski; Eva K,17,0,20,3
1715626386817,LIGM 5B,A00,507423,Fischer-Grunski; Eva K,19,0,20,1
1715626387847,LIGM 5C,A00,507425,Fischer-Grunski; Eva K,19,0,20,1
1715626388878,LIIT 5AS,A00,507427,Carnelos; Chiara,20,0,20,0
1715626389904,LIIT 5BS,A00,507430,Carnelos; Chiara,20,0,20,0
1715626390929,LIIT 5CS,A00,507432,Carnelos; Chiara,20,0,20,0
1715626391956,LISP 5A,A00,507541,Munoz Sanchez; Alicia,11,0,20,9
1715626392982,LISP 5B,A00,507671,Munoz Sanchez; Alicia,9,0,20,11
1715626394013,LISP 5C,A00,507696,Munoz Sanchez; Alicia,9,0,20,11
1715626395038,MAE 197,001,528363,Boechler; Nicholas Sebastia,9998,0,9999,1
1715626396067,MATH 197,001,523477,Kedlaya; Kiran S.,9994,0,9999,5
1715626396067,MATH 197,002,563811,Zhang; Danna,9994,0,9999,5
1715626396067,MATH 197,003,628552,Dumitriu; Ioana,9998,0,9999,1
1715626396067,MATH 197,004,660885,Floyd; Eric,9998,0,9999,1
1715626397097,MCWP 40R,A00,518780,Staff,2,0,20,18
1715626397097,MCWP 40R,B00,518781,Staff,11,0,20,9
1715626397097,MCWP 40R,C00,518783,Staff,5,0,20,15
1715626398124,MCWP 50R,A00,518791,Staff,0,1,20,20
1715626398124,MCWP 50R,B00,518792,Staff,0,2,20,20
1715626398124,MCWP 50R,C00,518793,Staff,0,4,20,20
1715626398124,MCWP 50R,D00,518794,Staff,0,1,20,20
1715626398124,MCWP 50R,E00,518795,Staff,0,2,20,20
1715626398124,MCWP 50R,F00,518796,Staff,0,1,20,20
1715626398124,MCWP 50R,G00,518797,Staff,0,1,20,20
1715626399149,MMW 12R,A01,514034,Herbst; Matthew,0,2,16,16
1715626399149,MMW 12R,A02,514035,Herbst; Matthew,0,0,16,16
1715626400174,MMW 13R,A01,514037,Staff,0,5,16,16
1715626400174,MMW 13R,A02,514039,Staff,0,5,16,16
1715626400174,MMW 13R,A03,628519,Staff,0,4,16,16
1715626402226,SIO 295LS,A00,523233,Staff,10,0,30,20
1715626403249,SIO 295S,A00,523232,Staff,10,0,30,20
1715626404276,SIOC 290S,A01,637330,Merrifield; Mark A,22,0,30,8
1715626405301,SIOC 291S,A01,637333,Gabriel; Corey John,22,0,30,8
1715626406329,SOCI 117,A01,494376,Staff,0,5,5,5
1715626407355,WES 237B,A00,494380,Staff,10,0,20,10
1715626409418,AESE 279B,A00,494370,Wade; Jon P,0,0,33,33
1715626410441,AIP 97,001,660915,Van Den Einde; Yael Dahlia,9998,0,9999,1
1715626411467,AIP 197,001,627712,Vespa; Emanuel Ignacio,9995,0,9999,4
1715626411467,AIP 197,002,650778,Amir; On,9998,0,9999,1
1715626411467,AIP 197,003,650933,Avenancio-Leon; Carlos,9998,0,9999,1
1715626411467,AIP 197,004,658530,Heyman; Gail D.,9998,0,9999,1
1715626411467,AIP 197,005,658631,Neal; Sonya E,9998,0,9999,1
1715626411467,AIP 197,006,658671,Du; Songzi,9998,0,9999,1
1715626412491,ANAR 135S,A00,494369,Braswell; Geoffrey E.,0,0,0,0
1715626413519,BENG 196,001,628496,Engler; Adam J.,9998,0,9999,1
1715626413519,BENG 196,002,660916,Watson; John Thomas,9999,0,9999,0
1715626414545,BISP 197,001,650773,Wilhelm; James E.,9994,0,9999,5
1715626414545,BISP 197,002,658904,Coleman; Aaron B.,9998,0,9999,1
1715626415573,CAT 124RS,A01,519847,Geibel; William,0,0,20,20
1715626416600,CAT 125RS,A01,515971,Geibel; William,0,0,20,20
1715626417625,CLRE 250,A00,511389,Morris; Sheldon,9992,0,9999,7
1715626418658,CLRE 251,A00,507176,Mehta; Ravindra L.,9992,0,9999,7
1715626418658,CLRE 251,B00,511410,Mehta; Ravindra L.,9998,0,9999,1
1715626419686,CLRE 252,A00,507189,Cuomo; Raphael Eduardo,9994,0,9999,5
1715626420712,CLRE 253,A00,507199,Vaida; Florin,9994,0,9999,5
1715626420712,CLRE 253,B00,507202,Vaida; Florin,9999,0,9999,0
1715626421741,CLRE 259,A00,507211,Patel; Hemal,9996,0,9999,3
1715626422766,CLRE 260,A00,507221,Cuomo; Raphael Eduardo,9999,0,9999,0
1715626423791,CLRE 297,001,507242,Cuomo; Raphael Eduardo,9999,0,9999,0
1715626424820,COGS 197,001,638244,Voytek; Bradley Thomas,9997,0,9999,2
1715626425847,CSE 191,A00,516875,Minnes Kemp; Mor Mia,9991,0,9999,8
1715626426872,CSE 197,001,637388,Minnes Kemp; Mor Mia,9992,0,9999,7
1715626427897,CSS 201S,A01,494383,Mignozzetti; Umberto,35,0,35,0
1715626428925,CSS 202S,A01,494387,Mignozzetti; Umberto,35,0,35,0
1715626429951,DSC 197,001,628532,Eldridge; Justin Matthew,9995,0,9999,4
1715626430977,EAP 100,A00,516065,Staff,9799,0,9999,200
1715626432005,ECE 45,A01,507414,Staff,31,0,60,29
1715626434061,ECE 111,A01,507420,Staff,11,0,50,39
1715626435087,ECE 197,001,548057,Sievenpiper; Daniel F.,9991,0,9999,8
1715626436117,EDS 115,A00,507243,Choi; Bailey Miyeon,7,0,28,21
1715626437147,EDS 117,A01,494379,Staff,0,6,34,34
1715626438174,EDS 125,A00,507246,Hopkins; Megan Beth,8,0,30,22
1715626439203,EDS 128A,A01,507264,Fargason; Sharon Gayle,6,0,26,20
1715626440228,EDS 128B,A01,507293,Pappas; Elizabeth,10,0,30,20
1715626441256,EDS 139,A00,507294,Fargason; Sharon Gayle,10,0,30,20
1715626441256,EDS 139,B00,507313,Pappas; Elizabeth,11,0,30,19
1715626442283,EDS 201,A00,507315,Staff,10,0,30,20
1715626443312,EDS 203,A01,507317,Halter; Christopher P.,10,0,30,20
1715626444341,EDS 204R,A01,507319,Halter; Christopher P.,0,3,30,30
1715626444341,EDS 204R,B01,507331,Heinzman; Erica M.,14,0,30,16
1715626445367,EDS 206R,A00,507332,Staff,0,4,30,30
1715626445367,EDS 206R,B00,507343,Staff,15,0,30,15
1715626446392,EDS 250,A00,507344,Hemans; Patricia Ann Benitez,20,0,40,20
1715626447421,EDS 281,A00,507345,Daly; Alan J.,18,0,18,0
1715626448449,EDS 284,A00,507350,Daly; Alan J.,16,0,16,0
1715626449477,EDS 286,A00,507359,Fine; Sarah,18,0,18,0
1715626450504,EDS 289C,A01,507361,Daly; Alan J.,18,0,18,0
1715626451529,EDS 290,A00,507366,Hofstetter; Carolyn,15,0,15,0
1715626452558,LIGM 5A,A00,507421,Fischer-Grunski; Eva K,17,0,20,3
1715626453586,LIGM 5B,A00,507423,Fischer-Grunski; Eva K,19,0,20,1
1715626454615,LIGM 5C,A00,507425,Fischer-Grunski; Eva K,19,0,20,1
1715626455644,LIIT 5AS,A00,507427,Carnelos; Chiara,20,0,20,0
1715626456679,LIIT 5BS,A00,507430,Carnelos; Chiara,20,0,20,0
1715626457707,LIIT 5CS,A00,507432,Carnelos; Chiara,20,0,20,0
1715626458734,LISP 5A,A00,507541,Munoz Sanchez; Alicia,11,0,20,9
1715626459759,LISP 5B,A00,507671,Munoz Sanchez; Alicia,9,0,20,11
1715626460785,LISP 5C,A00,507696,Munoz Sanchez; Alicia,9,0,20,11
1715626461811,MAE 197,001,528363,Boechler; Nicholas Sebastia,9998,0,9999,1
1715626462838,MATH 197,001,523477,Kedlaya; Kiran S.,9994,0,9999,5
1715626462838,MATH 197,002,563811,Zhang; Danna,9994,0,9999,5
1715626462838,MATH 197,003,628552,Dumitriu; Ioana,9998,0,9999,1
1715626462838,MATH 197,004,660885,Floyd; Eric,9998,0,9999,1
1715626463865,MCWP 40R,A00,518780,Staff,2,0,20,18
1715626463865,MCWP 40R,B00,518781,Staff,11,0,20,9
1715626463865,MCWP 40R,C00,518783,Staff,5,0,20,15
1715626464890,MCWP 50R,A00,518791,Staff,0,1,20,20
1715626464890,MCWP 50R,B00,518792,Staff,0,2,20,20
1715626464890,MCWP 50R,C00,518793,Staff,0,4,20,20
1715626464890,MCWP 50R,D00,518794,Staff,0,1,20,20
1715626464890,MCWP 50R,E00,518795,Staff,0,2,20,20
1715626464890,MCWP 50R,F00,518796,Staff,0,1,20,20
1715626464890,MCWP 50R,G00,518797,Staff,0,1,20,20
1715626465918,MMW 12R,A01,514034,Herbst; Matthew,0,2,16,16
1715626465918,MMW 12R,A02,514035,Herbst; Matthew,0,0,16,16
1715626466943,MMW 13R,A01,514037,Staff,0,5,16,16
1715626466943,MMW 13R,A02,514039,Staff,0,5,16,16
1715626466943,MMW 13R,A03,628519,Staff,0,4,16,16
1715626468998,SIO 295LS,A00,523233,Staff,10,0,30,20
1715626470025,SIO 295S,A00,523232,Staff,10,0,30,20
1715626471054,SIOC 290S,A01,637330,Merrifield; Mark A,22,0,30,8
1715626472080,SIOC 291S,A01,637333,Gabriel; Corey John,22,0,30,8
1715626473107,SOCI 117,A01,494376,Staff,0,5,5,5
1715626474133,WES 237B,A00,494380,Staff,10,0,20,10
1715626476201,AESE 279B,A00,494370,Wade; Jon P,0,0,33,33
1715626477228,AIP 97,001,660915,Van Den Einde; Yael Dahlia,9998,0,9999,1
1715626478259,AIP 197,001,627712,Vespa; Emanuel Ignacio,9995,0,9999,4
1715626478259,AIP 197,002,650778,Amir; On,9998,0,9999,1
1715626478259,AIP 197,003,650933,Avenancio-Leon; Carlos,9998,0,9999,1
1715626478259,AIP 197,004,658530,Heyman; Gail D.,9998,0,9999,1
1715626478259,AIP 197,005,658631,Neal; Sonya E,9998,0,9999,1
1715626478259,AIP 197,006,658671,Du; Songzi,9998,0,9999,1
1715626479287,ANAR 135S,A00,494369,Braswell; Geoffrey E.,0,0,0,0
1715626480311,BENG 196,001,628496,Engler; Adam J.,9998,0,9999,1
1715626480311,BENG 196,002,660916,Watson; John Thomas,9999,0,9999,0
1715626481339,BISP 197,001,650773,Wilhelm; James E.,9994,0,9999,5
1715626481339,BISP 197,002,658904,Coleman; Aaron B.,9998,0,9999,1
1715626482367,CAT 124RS,A01,519847,Geibel; William,0,0,20,20
1715626483391,CAT 125RS,A01,515971,Geibel; William,0,0,20,20
1715626484416,CLRE 250,A00,511389,Morris; Sheldon,9992,0,9999,7
1715626485443,CLRE 251,A00,507176,Mehta; Ravindra L.,9992,0,9999,7
1715626485443,CLRE 251,B00,511410,Mehta; Ravindra L.,9998,0,9999,1
1715626486469,CLRE 252,A00,507189,Cuomo; Raphael Eduardo,9994,0,9999,5
1715626487495,CLRE 253,A00,507199,Vaida; Florin,9994,0,9999,5
1715626487495,CLRE 253,B00,507202,Vaida; Florin,9999,0,9999,0
1715626488520,CLRE 259,A00,507211,Patel; Hemal,9996,0,9999,3
1715626489546,CLRE 260,A00,507221,Cuomo; Raphael Eduardo,9999,0,9999,0
1715626490573,CLRE 297,001,507242,Cuomo; Raphael Eduardo,9999,0,9999,0
1715626491599,COGS 197,001,638244,Voytek; Bradley Thomas,9997,0,9999,2
1715626492627,CSE 191,A00,516875,Minnes Kemp; Mor Mia,9991,0,9999,8
1715626493653,CSE 197,001,637388,Minnes Kemp; Mor Mia,9992,0,9999,7
1715626494684,CSS 201S,A01,494383,Mignozzetti; Umberto,35,0,35,0
1715626495710,CSS 202S,A01,494387,Mignozzetti; Umberto,35,0,35,0
1715626496735,DSC 197,001,628532,Eldridge; Justin Matthew,9995,0,9999,4
1715626497761,EAP 100,A00,516065,Staff,9799,0,9999,200
1715626498791,ECE 45,A01,507414,Staff,31,0,60,29
1715626500846,ECE 111,A01,507420,Staff,11,0,50,39
1715626501873,ECE 197,001,548057,Sievenpiper; Daniel F.,9991,0,9999,8
1715626502900,EDS 115,A00,507243,Choi; Bailey Miyeon,7,0,28,21
1715626503926,EDS 117,A01,494379,Staff,0,6,34,34
1715626504950,EDS 125,A00,507246,Hopkins; Megan Beth,8,0,30,22
1715626505978,EDS 128A,A01,507264,Fargason; Sharon Gayle,6,0,26,20
1715626507007,EDS 128B,A01,507293,Pappas; Elizabeth,10,0,30,20
1715626508033,EDS 139,A00,507294,Fargason; Sharon Gayle,10,0,30,20
1715626508033,EDS 139,B00,507313,Pappas; Elizabeth,11,0,30,19
1715626509061,EDS 201,A00,507315,Staff,10,0,30,20
1715626510087,EDS 203,A01,507317,Halter; Christopher P.,10,0,30,20
1715626511116,EDS 204R,A01,507319,Halter; Christopher P.,0,3,30,30
1715626511116,EDS 204R,B01,507331,Heinzman; Erica M.,14,0,30,16
1715626512142,EDS 206R,A00,507332,Staff,0,4,30,30
1715626512142,EDS 206R,B00,507343,Staff,15,0,30,15
1715626513167,EDS 250,A00,507344,Hemans; Patricia Ann Benitez,20,0,40,20
1715626514193,EDS 281,A00,507345,Daly; Alan J.,18,0,18,0
1715626515218,EDS 284,A00,507350,Daly; Alan J.,16,0,16,0
1715626516247,EDS 286,A00,507359,Fine; Sarah,18,0,18,0
1715626517271,EDS 289C,A01,507361,Daly; Alan J.,18,0,18,0
1715626518300,EDS 290,A00,507366,Hofstetter; Carolyn,15,0,15,0
1715626519328,LIGM 5A,A00,507421,Fischer-Grunski; Eva K,17,0,20,3
1715626520356,LIGM 5B,A00,507423,Fischer-Grunski; Eva K,19,0,20,1
1715626521384,LIGM 5C,A00,507425,Fischer-Grunski; Eva K,19,0,20,1
1715626522413,LIIT 5AS,A00,507427,Carnelos; Chiara,20,0,20,0
1715626523447,LIIT 5BS,A00,507430,Carnelos; Chiara,20,0,20,0
1715626524479,LIIT 5CS,A00,507432,Carnelos; Chiara,20,0,20,0
1715626525504,LISP 5A,A00,507541,Munoz Sanchez; Alicia,11,0,20,9
1715626526533,LISP 5B,A00,507671,Munoz Sanchez; Alicia,9,0,20,11
1715626527564,LISP 5C,A00,507696,Munoz Sanchez; Alicia,9,0,20,11
1715626528592,MAE 197,001,528363,Boechler; Nicholas Sebastia,9998,0,9999,1
1715626529618,MATH 197,001,523477,Kedlaya; Kiran S.,9994,0,9999,5
1715626529618,MATH 197,002,563811,Zhang; Danna,9994,0,9999,5
1715626529618,MATH 197,003,628552,Dumitriu; Ioana,9998,0,9999,1
1715626529618,MATH 197,004,660885,Floyd; Eric,9998,0,9999,1
1715626530698,MCWP 40R,A00,518780,Staff,2,0,20,18
1715626530698,MCWP 40R,B00,518781,Staff,11,0,20,9
1715626530698,MCWP 40R,C00,518783,Staff,5,0,20,15
1715626531724,MCWP 50R,A00,518791,Staff,0,1,20,20
1715626531724,MCWP 50R,B00,518792,Staff,0,2,20,20
1715626531724,MCWP 50R,C00,518793,Staff,0,4,20,20
1715626531724,MCWP 50R,D00,518794,Staff,0,1,20,20
1715626531724,MCWP 50R,E00,518795,Staff,0,2,20,20
1715626531724,MCWP 50R,F00,518796,Staff,0,1,20,20
1715626531724,MCWP 50R,G00,518797,Staff,0,1,20,20
1715626532752,MMW 12R,A01,514034,Herbst; Matthew,0,2,16,16
1715626532752,MMW 12R,A02,514035,Herbst; Matthew,0,0,16,16
1715626533780,MMW 13R,A01,514037,Staff,0,5,16,16
1715626533780,MMW 13R,A02,514039,Staff,0,5,16,16
1715626533780,MMW 13R,A03,628519,Staff,0,4,16,16
1715626535832,SIO 295LS,A00,523233,Staff,10,0,30,20
1715626536859,SIO 295S,A00,523232,Staff,10,0,30,20
1715626537883,SIOC 290S,A01,637330,Merrifield; Mark A,22,0,30,8
1715626538908,SIOC 291S,A01,637333,Gabriel; Corey John,22,0,30,8
1715626539936,SOCI 117,A01,494376,Staff,0,5,5,5
1715626540963,WES 237B,A00,494380,Staff,10,0,20,10
1715626543038,AESE 279B,A00,494370,Wade; Jon P,0,0,33,33
1715626544063,AIP 97,001,660915,Van Den Einde; Yael Dahlia,9998,0,9999,1
1715626545091,AIP 197,001,627712,Vespa; Emanuel Ignacio,9995,0,9999,4
1715626545091,AIP 197,002,650778,Amir; On,9998,0,9999,1
1715626545091,AIP 197,003,650933,Avenancio-Leon; Carlos,9998,0,9999,1
1715626545091,AIP 197,004,658530,Heyman; Gail D.,9998,0,9999,1
1715626545091,AIP 197,005,658631,Neal; Sonya E,9998,0,9999,1
1715626545091,AIP 197,006,658671,Du; Songzi,9998,0,9999,1
1715626546122,ANAR 135S,A00,494369,Braswell; Geoffrey E.,0,0,0,0
1715626547151,BENG 196,001,628496,Engler; Adam J.,9998,0,9999,1
1715626547151,BENG 196,002,660916,Watson; John Thomas,9999,0,9999,0
1715626548180,BISP 197,001,650773,Wilhelm; James E.,9994,0,9999,5
1715626548180,BISP 197,002,658904,Coleman; Aaron B.,9998,0,9999,1
1715626549208,CAT 124RS,A01,519847,Geibel; William,0,0,20,20
1715626550233,CAT 125RS,A01,515971,Geibel; William,0,0,20,20
1715626551261,CLRE 250,A00,511389,Morris; Sheldon,9992,0,9999,7
1715626552287,CLRE 251,A00,507176,Mehta; Ravindra L.,9992,0,9999,7
1715626552287,CLRE 251,B00,511410,Mehta; Ravindra L.,9998,0,9999,1
1715626553312,CLRE 252,A00,507189,Cuomo; Raphael Eduardo,9994,0,9999,5
1715626554337,CLRE 253,A00,507199,Vaida; Florin,9994,0,9999,5
1715626554337,CLRE 253,B00,507202,Vaida; Florin,9999,0,9999,0
1715626555361,CLRE 259,A00,507211,Patel; Hemal,9996,0,9999,3
1715626556386,CLRE 260,A00,507221,Cuomo; Raphael Eduardo,9999,0,9999,0
1715626557413,CLRE 297,001,507242,Cuomo; Raphael Eduardo,9999,0,9999,0
1715626558441,COGS 197,001,638244,Voytek; Bradley Thomas,9997,0,9999,2
1715626559468,CSE 191,A00,516875,Minnes Kemp; Mor Mia,9991,0,9999,8
1715626560494,CSE 197,001,637388,Minnes Kemp; Mor Mia,9992,0,9999,7
1715626561519,CSS 201S,A01,494383,Mignozzetti; Umberto,35,0,35,0
1715626562545,CSS 202S,A01,494387,Mignozzetti; Umberto,35,0,35,0
1715626563573,DSC 197,001,628532,Eldridge; Justin Matthew,9995,0,9999,4
1715626564600,EAP 100,A00,516065,Staff,9799,0,9999,200
1715626740917,EDS 128B,A01,507293,Pappas; Elizabeth,10,0,30,20
1715626741946,EDS 139,A00,507294,Fargason; Sharon Gayle,10,0,30,20
1715626741946,EDS 139,B00,507313,Pappas; Elizabeth,11,0,30,19
1715626742976,EDS 201,A00,507315,Staff,10,0,30,20
1715626744008,EDS 203,A01,507317,Halter; Christopher P.,10,0,30,20
1715626745036,EDS 204R,A01,507319,Halter; Christopher P.,0,3,30,30
1715626745036,EDS 204R,B01,507331,Heinzman; Erica M.,14,0,30,16
1715626746221,EDS 206R,A00,507332,Staff,0,4,30,30
1715626746221,EDS 206R,B00,507343,Staff,15,0,30,15
1715626747248,EDS 250,A00,507344,Hemans; Patricia Ann Benitez,20,0,40,20
1715626748275,EDS 281,A00,507345,Daly; Alan J.,18,0,18,0
1715626749301,EDS 284,A00,507350,Daly; Alan J.,16,0,16,0
1715626750328,EDS 286,A00,507359,Fine; Sarah,18,0,18,0
1715626751354,EDS 289C,A01,507361,Daly; Alan J.,18,0,18,0
1715626752380,EDS 290,A00,507366,Hofstetter; Carolyn,15,0,15,0
1715626753407,LIGM 5A,A00,507421,Fischer-Grunski; Eva K,17,0,20,3
1715626754434,LIGM 5B,A00,507423,Fischer-Grunski; Eva K,19,0,20,1
1715626755459,LIGM 5C,A00,507425,Fischer-Grunski; Eva K,19,0,20,1
1715626756487,LIIT 5AS,A00,507427,Carnelos; Chiara,20,0,20,0
1715626757512,LIIT 5BS,A00,507430,Carnelos; Chiara,20,0,20,0
1715626758538,LIIT 5CS,A00,507432,Carnelos; Chiara,20,0,20,0
1715626759566,LISP 5A,A00,507541,Munoz Sanchez; Alicia,11,0,20,9
1715626760591,LISP 5B,A00,507671,Munoz Sanchez; Alicia,9,0,20,11
1715626761621,LISP 5C,A00,507696,Munoz Sanchez; Alicia,9,0,20,11
1715626762647,MAE 197,001,528363,Boechler; Nicholas Sebastia,9998,0,9999,1
1715626763681,MATH 197,001,523477,Kedlaya; Kiran S.,9994,0,9999,5
1715626763681,MATH 197,002,563811,Zhang; Danna,9994,0,9999,5
1715626763681,MATH 197,003,628552,Dumitriu; Ioana,9998,0,9999,1
1715626763681,MATH 197,004,660885,Floyd; Eric,9998,0,9999,1
1715626764706,MCWP 40R,A00,518780,Staff,2,0,20,18
1715626764706,MCWP 40R,B00,518781,Staff,11,0,20,9
1715626764706,MCWP 40R,C00,518783,Staff,5,0,20,15
1715626765739,MCWP 50R,A00,518791,Staff,0,1,20,20
1715626765739,MCWP 50R,B00,518792,Staff,0,2,20,20
1715626765739,MCWP 50R,C00,518793,Staff,0,4,20,20
1715626765739,MCWP 50R,D00,518794,Staff,0,1,20,20
1715626765739,MCWP 50R,E00,518795,Staff,0,2,20,20
1715626765739,MCWP 50R,F00,518796,Staff,0,1,20,20
1715626765739,MCWP 50R,G00,518797,Staff,0,1,20,20
1715626766765,MMW 12R,A01,514034,Herbst; Matthew,0,2,16,16
1715626766765,MMW 12R,A02,514035,Herbst; Matthew,0,0,16,16
1715626767793,MMW 13R,A01,514037,Staff,0,5,16,16
1715626767793,MMW 13R,A02,514039,Staff,0,5,16,16
1715626767793,MMW 13R,A03,628519,Staff,0,4,16,16
1715626769847,SIO 295LS,A00,523233,Staff,10,0,30,20
1715626770877,SIO 295S,A00,523232,Staff,10,0,30,20
1715626771906,SIOC 290S,A01,637330,Merrifield; Mark A,22,0,30,8
1715626772933,SIOC 291S,A01,637333,Gabriel; Corey John,22,0,30,8
1715626773960,SOCI 117,A01,494376,Staff,0,5,5,5
1715626774988,WES 237B,A00,494380,Staff,10,0,20,10
1715626777078,AESE 279B,A00,494370,Wade; Jon P,0,0,33,33
1715626778105,AIP 97,001,660915,Van Den Einde; Yael Dahlia,9998,0,9999,1
1715626779132,AIP 197,001,627712,Vespa; Emanuel Ignacio,9995,0,9999,4
1715626779132,AIP 197,002,650778,Amir; On,9998,0,9999,1
1715626779132,AIP 197,003,650933,Avenancio-Leon; Carlos,9998,0,9999,1
1715626779132,AIP 197,004,658530,Heyman; Gail D.,9998,0,9999,1
1715626779132,AIP 197,005,658631,Neal; Sonya E,9998,0,9999,1
1715626779132,AIP 197,006,658671,Du; Songzi,9998,0,9999,1
1715626780156,ANAR 135S,A00,494369,Braswell; Geoffrey E.,0,0,0,0
1715626781184,BENG 196,001,628496,Engler; Adam J.,9998,0,9999,1
1715626781184,BENG 196,002,660916,Watson; John Thomas,9999,0,9999,0
1715626782210,BISP 197,001,650773,Wilhelm; James E.,9994,0,9999,5
1715626782210,BISP 197,002,658904,Coleman; Aaron B.,9998,0,9999,1
1715626783236,CAT 124RS,A01,519847,Geibel; William,0,0,20,20
1715626784264,CAT 125RS,A01,515971,Geibel; William,0,0,20,20
1715626785291,CLRE 250,A00,511389,Morris; Sheldon,9992,0,9999,7
1715626786317,CLRE 251,A00,507176,Mehta; Ravindra L.,9992,0,9999,7
1715626786317,CLRE 251,B00,511410,Mehta; Ravindra L.,9998,0,9999,1
1715626787343,CLRE 252,A00,507189,Cuomo; Raphael Eduardo,9994,0,9999,5
1715626788376,CLRE 253,A00,507199,Vaida; Florin,9994,0,9999,5
1715626788376,CLRE 253,B00,507202,Vaida; Florin,9999,0,9999,0
1715626789403,CLRE 259,A00,507211,Patel; Hemal,9996,0,9999,3
1715626790433,CLRE 260,A00,507221,Cuomo; Raphael Eduardo,9999,0,9999,0
1715626791461,CLRE 297,001,507242,Cuomo; Raphael Eduardo,9999,0,9999,0
1715626792486,COGS 197,001,638244,Voytek; Bradley Thomas,9997,0,9999,2
1715626793513,CSE 191,A00,516875,Minnes Kemp; Mor Mia,9991,0,9999,8
1715626794541,CSE 197,001,637388,Minnes Kemp; Mor Mia,9992,0,9999,7
1715626795568,CSS 201S,A01,494383,Mignozzetti; Umberto,35,0,35,0
1715626796595,CSS 202S,A01,494387,Mignozzetti; Umberto,35,0,35,0
1715626797623,DSC 197,001,628532,Eldridge; Justin Matthew,9995,0,9999,4
1715626798651,EAP 100,A00,516065,Staff,9799,0,9999,200
1715626799679,ECE 45,A01,507414,Staff,31,0,60,29
1715626801735,ECE 111,A01,507420,Staff,11,0,50,39
1715626802763,ECE 197,001,548057,Sievenpiper; Daniel F.,9991,0,9999,8
1715626803789,EDS 115,A00,507243,Choi; Bailey Miyeon,7,0,28,21
1715626804815,EDS 117,A01,494379,Staff,0,6,34,34
1715626805844,EDS 125,A00,507246,Hopkins; Megan Beth,8,0,30,22
1715626806868,EDS 128A,A01,507264,Fargason; Sharon Gayle,6,0,26,20
1715626807894,EDS 128B,A01,507293,Pappas; Elizabeth,10,0,30,20
1715626808918,EDS 139,A00,507294,Fargason; Sharon Gayle,10,0,30,20
1715626808918,EDS 139,B00,507313,Pappas; Elizabeth,11,0,30,19
1715626809946,EDS 201,A00,507315,Staff,10,0,30,20
1715626810974,EDS 203,A01,507317,Halter; Christopher P.,10,0,30,20
1715626812002,EDS 204R,A01,507319,Halter; Christopher P.,0,3,30,30
1715626812002,EDS 204R,B01,507331,Heinzman; Erica M.,14,0,30,16
1715626813030,EDS 206R,A00,507332,Staff,0,4,30,30
1715626813030,EDS 206R,B00,507343,Staff,15,0,30,15
1715626814054,EDS 250,A00,507344,Hemans; Patricia Ann Benitez,20,0,40,20
1715626815080,EDS 281,A00,507345,Daly; Alan J.,18,0,18,0
1715626816112,EDS 284,A00,507350,Daly; Alan J.,16,0,16,0
1715626817139,EDS 286,A00,507359,Fine; Sarah,18,0,18,0
1715626818163,EDS 289C,A01,507361,Daly; Alan J.,18,0,18,0
1715626819192,EDS 290,A00,507366,Hofstetter; Carolyn,15,0,15,0
1715626820218,LIGM 5A,A00,507421,Fischer-Grunski; Eva K,17,0,20,3
1715626821242,LIGM 5B,A00,507423,Fischer-Grunski; Eva K,19,0,20,1
1715626822269,LIGM 5C,A00,507425,Fischer-Grunski; Eva K,19,0,20,1
1715626823296,LIIT 5AS,A00,507427,Carnelos; Chiara,20,0,20,0
1715626824322,LIIT 5BS,A00,507430,Carnelos; Chiara,20,0,20,0
1715626825347,LIIT 5CS,A00,507432,Carnelos; Chiara,20,0,20,0
1715626826373,LISP 5A,A00,507541,Munoz Sanchez; Alicia,11,0,20,9
1715626827399,LISP 5B,A00,507671,Munoz Sanchez; Alicia,9,0,20,11
1715626828427,LISP 5C,A00,507696,Munoz Sanchez; Alicia,9,0,20,11
1715626829453,MAE 197,001,528363,Boechler; Nicholas Sebastia,9998,0,9999,1
1715626830488,MATH 197,001,523477,Kedlaya; Kiran S.,9994,0,9999,5
1715626830488,MATH 197,002,563811,Zhang; Danna,9994,0,9999,5
1715626830488,MATH 197,003,628552,Dumitriu; Ioana,9998,0,9999,1
1715626830488,MATH 197,004,660885,Floyd; Eric,9998,0,9999,1
1715626831519,MCWP 40R,A00,518780,Staff,2,0,20,18
1715626831519,MCWP 40R,B00,518781,Staff,11,0,20,9
1715626831519,MCWP 40R,C00,518783,Staff,5,0,20,15
1715626832549,MCWP 50R,A00,518791,Staff,0,1,20,20
1715626832549,MCWP 50R,B00,518792,Staff,0,2,20,20
1715626832549,MCWP 50R,C00,518793,Staff,0,4,20,20
1715626832549,MCWP 50R,D00,518794,Staff,0,1,20,20
1715626832549,MCWP 50R,E00,518795,Staff,0,2,20,20
1715626832549,MCWP 50R,F00,518796,Staff,0,1,20,20
1715626832549,MCWP 50R,G00,518797,Staff,0,1,20,20
1715626833575,MMW 12R,A01,514034,Herbst; Matthew,0,2,16,16
1715626833575,MMW 12R,A02,514035,Herbst; Matthew,0,0,16,16
1715626834603,MMW 13R,A01,514037,Staff,0,5,16,16
1715626834603,MMW 13R,A02,514039,Staff,0,5,16,16
1715626834603,MMW 13R,A03,628519,Staff,0,4,16,16
1715626836659,SIO 295LS,A00,523233,Staff,10,0,30,20
1715626837687,SIO 295S,A00,523232,Staff,10,0,30,20
1715626838713,SIOC 290S,A01,637330,Merrifield; Mark A,22,0,30,8
1715626839739,SIOC 291S,A01,637333,Gabriel; Corey John,22,0,30,8
1715626840764,SOCI 117,A01,494376,Staff,0,5,5,5
1715626841790,WES 237B,A00,494380,Staff,10,0,20,10
1715626843860,AESE 279B,A00,494370,Wade; Jon P,0,0,33,33
1715626844886,AIP 97,001,660915,Van Den Einde; Yael Dahlia,9998,0,9999,1
1715626845914,AIP 197,001,627712,Vespa; Emanuel Ignacio,9995,0,9999,4
1715626845914,AIP 197,002,650778,Amir; On,9998,0,9999,1
1715626845914,AIP 197,003,650933,Avenancio-Leon; Carlos,9998,0,9999,1
1715626845914,AIP 197,004,658530,Heyman; Gail D.,9998,0,9999,1
1715626845914,AIP 197,005,658631,Neal; Sonya E,9998,0,9999,1
1715626845914,AIP 197,006,658671,Du; Songzi,9998,0,9999,1
1715626846939,ANAR 135S,A00,494369,Braswell; Geoffrey E.,0,0,0,0
1715626847967,BENG 196,001,628496,Engler; Adam J.,9998,0,9999,1
1715626847967,BENG 196,002,660916,Watson; John Thomas,9999,0,9999,0
1715626848993,BISP 197,001,650773,Wilhelm; James E.,9994,0,9999,5
1715626848993,BISP 197,002,658904,Coleman; Aaron B.,9998,0,9999,1
1715626850019,CAT 124RS,A01,519847,Geibel; William,0,0,20,20
1715626851044,CAT 125RS,A01,515971,Geibel; William,0,0,20,20
1715626852070,CLRE 250,A00,511389,Morris; Sheldon,9992,0,9999,7
1715626853104,CLRE 251,A00,507176,Mehta; Ravindra L.,9992,0,9999,7
1715626853104,CLRE 251,B00,511410,Mehta; Ravindra L.,9998,0,9999,1
1715626854132,CLRE 252,A00,507189,Cuomo; Raphael Eduardo,9994,0,9999,5
1715626855159,CLRE 253,A00,507199,Vaida; Florin,9994,0,9999,5
1715626855159,CLRE 253,B00,507202,Vaida; Florin,9999,0,9999,0
1715626856187,CLRE 259,A00,507211,Patel; Hemal,9996,0,9999,3
1715626857213,CLRE 260,A00,507221,Cuomo; Raphael Eduardo,9999,0,9999,0
1715626858238,CLRE 297,001,507242,Cuomo; Raphael Eduardo,9999,0,9999,0
1715626859263,COGS 197,001,638244,Voytek; Bradley Thomas,9997,0,9999,2
1715626860295,CSE 191,A00,516875,Minnes Kemp; Mor Mia,9991,0,9999,8
1715626861320,CSE 197,001,637388,Minnes Kemp; Mor Mia,9992,0,9999,7
1715626862352,CSS 201S,A01,494383,Mignozzetti; Umberto,35,0,35,0
1715626863379,CSS 202S,A01,494387,Mignozzetti; Umberto,35,0,35,0
1715626864403,DSC 197,001,628532,Eldridge; Justin Matthew,9995,0,9999,4
1715626865430,EAP 100,A00,516065,Staff,9799,0,9999,200
1715626866460,ECE 45,A01,507414,Staff,31,0,60,29
1715626868519,ECE 111,A01,507420,Staff,11,0,50,39
1715626869544,ECE 197,001,548057,Sievenpiper; Daniel F.,9991,0,9999,8
1715626870570,EDS 115,A00,507243,Choi; Bailey Miyeon,7,0,28,21
1715626871600,EDS 117,A01,494379,Staff,0,6,34,34
1715626872627,EDS 125,A00,507246,Hopkins; Megan Beth,8,0,30,22
1715626873657,EDS 128A,A01,507264,Fargason; Sharon Gayle,6,0,26,20
1715626874692,EDS 128B,A01,507293,Pappas; Elizabeth,10,0,30,20
1715626875718,EDS 139,A00,507294,Fargason; Sharon Gayle,10,0,30,20
1715626875718,EDS 139,B00,507313,Pappas; Elizabeth,11,0,30,19
1715626876746,EDS 201,A00,507315,Staff,10,0,30,20
1715626877776,EDS 203,A01,507317,Halter; Christopher P.,10,0,30,20
1715626878803,EDS 204R,A01,507319,Halter; Christopher P.,0,3,30,30
1715626878803,EDS 204R,B01,507331,Heinzman; Erica M.,14,0,30,16
1715626879827,EDS 206R,A00,507332,Staff,0,4,30,30
1715626879827,EDS 206R,B00,507343,Staff,15,0,30,15
1715626880851,EDS 250,A00,507344,Hemans; Patricia Ann Benitez,20,0,40,20
1715626881882,EDS 281,A00,507345,Daly; Alan J.,18,0,18,0
1715626882910,EDS 284,A00,507350,Daly; Alan J.,16,0,16,0
1715626883937,EDS 286,A00,507359,Fine; Sarah,18,0,18,0
1715626884964,EDS 289C,A01,507361,Daly; Alan J.,18,0,18,0
1715626885992,EDS 290,A00,507366,Hofstetter; Carolyn,15,0,15,0
1715626887020,LIGM 5A,A00,507421,Fischer-Grunski; Eva K,17,0,20,3
1715626888047,LIGM 5B,A00,507423,Fischer-Grunski; Eva K,19,0,20,1
1715626889073,LIGM 5C,A00,507425,Fischer-Grunski; Eva K,19,0,20,1
1715626892219,LIIT 5AS,A00,507427,Carnelos; Chiara,20,0,20,0
1715626893248,LIIT 5BS,A00,507430,Carnelos; Chiara,20,0,20,0
1715626894276,LIIT 5CS,A00,507432,Carnelos; Chiara,20,0,20,0
1715626895304,LISP 5A,A00,507541,Munoz Sanchez; Alicia,11,0,20,9
1715626896332,LISP 5B,A00,507671,Munoz Sanchez; Alicia,9,0,20,11
1715626897362,LISP 5C,A00,507696,Munoz Sanchez; Alicia,9,0,20,11
1715626898389,MAE 197,001,528363,Boechler; Nicholas Sebastia,9998,0,9999,1
1715626899420,MATH 197,001,523477,Kedlaya; Kiran S.,9994,0,9999,5
1715626899420,MATH 197,002,563811,Zhang; Danna,9994,0,9999,5
1715626899420,MATH 197,003,628552,Dumitriu; Ioana,9998,0,9999,1
1715626899420,MATH 197,004,660885,Floyd; Eric,9998,0,9999,1
1715626900449,MCWP 40R,A00,518780,Staff,2,0,20,18
1715626900449,MCWP 40R,B00,518781,Staff,11,0,20,9
1715626900449,MCWP 40R,C00,518783,Staff,5,0,20,15
1715626901478,MCWP 50R,A00,518791,Staff,0,1,20,20
1715626901478,MCWP 50R,B00,518792,Staff,0,2,20,20
1715626901478,MCWP 50R,C00,518793,Staff,0,4,20,20
1715626901478,MCWP 50R,D00,518794,Staff,0,1,20,20
1715626901478,MCWP 50R,E00,518795,Staff,0,2,20,20
1715626901478,MCWP 50R,F00,518796,Staff,0,1,20,20
1715626901478,MCWP 50R,G00,518797,Staff,0,1,20,20
1715626902504,MMW 12R,A01,514034,Herbst; Matthew,0,2,16,16
1715626902504,MMW 12R,A02,514035,Herbst; Matthew,0,0,16,16
1715626903534,MMW 13R,A01,514037,Staff,0,5,16,16
1715626903534,MMW 13R,A02,514039,Staff,0,5,16,16
1715626903534,MMW 13R,A03,628519,Staff,0,4,16,16
1715626905588,SIO 295LS,A00,523233,Staff,10,0,30,20
1715626906615,SIO 295S,A00,523232,Staff,10,0,30,20
1715626907639,SIOC 290S,A01,637330,Merrifield; Mark A,22,0,30,8
1715626908670,SIOC 291S,A01,637333,Gabriel; Corey John,22,0,30,8
1715626909694,SOCI 117,A01,494376,Staff,0,5,5,5
1715626910721,WES 237B,A00,494380,Staff,10,0,20,10
1715626912803,AESE 279B,A00,494370,Wade; Jon P,0,0,33,33
1715626913828,AIP 97,001,660915,Van Den Einde; Yael Dahlia,9998,0,9999,1
1715626914856,AIP 197,001,627712,Vespa; Emanuel Ignacio,9995,0,9999,4
1715626914856,AIP 197,002,650778,Amir; On,9998,0,9999,1
1715626914856,AIP 197,003,650933,Avenancio-Leon; Carlos,9998,0,9999,1
1715626914856,AIP 197,004,658530,Heyman; Gail D.,9998,0,9999,1
1715626914856,AIP 197,005,658631,Neal; Sonya E,9998,0,9999,1
1715626914856,AIP 197,006,658671,Du; Songzi,9998,0,9999,1
1715626915882,ANAR 135S,A00,494369,Braswell; Geoffrey E.,0,0,0,0
1715626916909,BENG 196,001,628496,Engler; Adam J.,9998,0,9999,1
1715626916909,BENG 196,002,660916,Watson; John Thomas,9999,0,9999,0
1715626917937,BISP 197,001,650773,Wilhelm; James E.,9994,0,9999,5
1715626917937,BISP 197,002,658904,Coleman; Aaron B.,9998,0,9999,1
1715626918962,CAT 124RS,A01,519847,Geibel; William,0,0,20,20
1715626919989,CAT 125RS,A01,515971,Geibel; William,0,0,20,20
1715626921015,CLRE 250,A00,511389,Morris; Sheldon,9992,0,9999,7
1715626922049,CLRE 251,A00,507176,Mehta; Ravindra L.,9992,0,9999,7
1715626922049,CLRE 251,B00,511410,Mehta; Ravindra L.,9998,0,9999,1
1715626923074,CLRE 252,A00,507189,Cuomo; Raphael Eduardo,9994,0,9999,5
1715626924101,CLRE 253,A00,507199,Vaida; Florin,9994,0,9999,5
1715626924101,CLRE 253,B00,507202,Vaida; Florin,9999,0,9999,0
1715626925127,CLRE 259,A00,507211,Patel; Hemal,9996,0,9999,3
1715626926151,CLRE 260,A00,507221,Cuomo; Raphael Eduardo,9999,0,9999,0
1715626927177,CLRE 297,001,507242,Cuomo; Raphael Eduardo,9999,0,9999,0
1715626928201,COGS 197,001,638244,Voytek; Bradley Thomas,9997,0,9999,2
1715626929225,CSE 191,A00,516875,Minnes Kemp; Mor Mia,9991,0,9999,8
1715626930249,CSE 197,001,637388,Minnes Kemp; Mor Mia,9992,0,9999,7
1715626931280,CSS 201S,A01,494383,Mignozzetti; Umberto,35,0,35,0
1715626932304,CSS 202S,A01,494387,Mignozzetti; Umberto,35,0,35,0
1715626933328,DSC 197,001,628532,Eldridge; Justin Matthew,9995,0,9999,4
1715626934352,EAP 100,A00,516065,Staff,9799,0,9999,200
1715626935379,ECE 45,A01,507414,Staff,31,0,60,29
1715626937435,ECE 111,A01,507420,Staff,11,0,50,39
1715626938462,ECE 197,001,548057,Sievenpiper; Daniel F.,9991,0,9999,8
1715626939487,EDS 115,A00,507243,Choi; Bailey Miyeon,7,0,28,21
1715626940511,EDS 117,A01,494379,Staff,0,6,34,34
1715626941536,EDS 125,A00,507246,Hopkins; Megan Beth,8,0,30,22
1715626942560,EDS 128A,A01,507264,Fargason; Sharon Gayle,6,0,26,20
1715626943587,EDS 128B,A01,507293,Pappas; Elizabeth,10,0,30,20
1715626944615,EDS 139,A00,507294,Fargason; Sharon Gayle,10,0,30,20
1715626944615,EDS 139,B00,507313,Pappas; Elizabeth,11,0,30,19
1715626945645,EDS 201,A00,507315,Staff,10,0,30,20
1715626946671,EDS 203,A01,507317,Halter; Christopher P.,10,0,30,20
1715626947700,EDS 204R,A01,507319,Halter; Christopher P.,0,3,30,30
1715626947700,EDS 204R,B01,507331,Heinzman; Erica M.,14,0,30,16
1715626948728,EDS 206R,A00,507332,Staff,0,4,30,30
1715626948728,EDS 206R,B00,507343,Staff,15,0,30,15
1715626949760,EDS 250,A00,507344,Hemans; Patricia Ann Benitez,20,0,40,20
1715626950790,EDS 281,A00,507345,Daly; Alan J.,18,0,18,0
1715626951817,EDS 284,A00,507350,Daly; Alan J.,16,0,16,0
1715626952846,EDS 286,A00,507359,Fine; Sarah,18,0,18,0
1715626953876,EDS 289C,A01,507361,Daly; Alan J.,18,0,18,0
1715626954904,EDS 290,A00,507366,Hofstetter; Carolyn,15,0,15,0
1715626955931,LIGM 5A,A00,507421,Fischer-Grunski; Eva K,17,0,20,3
1715626956960,LIGM 5B,A00,507423,Fischer-Grunski; Eva K,19,0,20,1
1715626957986,LIGM 5C,A00,507425,Fischer-Grunski; Eva K,19,0,20,1
1715626959015,LIIT 5AS,A00,507427,Carnelos; Chiara,20,0,20,0
1715626960038,LIIT 5BS,A00,507430,Carnelos; Chiara,20,0,20,0
1715626961064,LIIT 5CS,A00,507432,Carnelos; Chiara,20,0,20,0
1715626962091,LISP 5A,A00,507541,Munoz Sanchez; Alicia,11,0,20,9
1715626963122,LISP 5B,A00,507671,Munoz Sanchez; Alicia,9,0,20,11
1715626964150,LISP 5C,A00,507696,Munoz Sanchez; Alicia,9,0,20,11
1715626965176,MAE 197,001,528363,Boechler; Nicholas Sebastia,9998,0,9999,1
1715626966208,MATH 197,001,523477,Kedlaya; Kiran S.,9994,0,9999,5
1715626966208,MATH 197,002,563811,Zhang; Danna,9994,0,9999,5
1715626966208,MATH 197,003,628552,Dumitriu; Ioana,9998,0,9999,1
1715626966208,MATH 197,004,660885,Floyd; Eric,9998,0,9999,1
1715626967237,MCWP 40R,A00,518780,Staff,2,0,20,18
1715626967237,MCWP 40R,B00,518781,Staff,11,0,20,9
1715626967237,MCWP 40R,C00,518783,Staff,5,0,20,15
1715626968264,MCWP 50R,A00,518791,Staff,0,1,20,20
1715626968264,MCWP 50R,B00,518792,Staff,0,2,20,20
1715626968264,MCWP 50R,C00,518793,Staff,0,4,20,20
1715626968264,MCWP 50R,D00,518794,Staff,0,1,20,20
1715626968264,MCWP 50R,E00,518795,Staff,0,2,20,20
1715626968264,MCWP 50R,F00,518796,Staff,0,1,20,20
1715626968264,MCWP 50R,G00,518797,Staff,0,1,20,20
1715626969289,MMW 12R,A01,514034,Herbst; Matthew,0,2,16,16
1715626969289,MMW 12R,A02,514035,Herbst; Matthew,0,0,16,16
1715626970314,MMW 13R,A01,514037,Staff,0,5,16,16
1715626970314,MMW 13R,A02,514039,Staff,0,5,16,16
1715626970314,MMW 13R,A03,628519,Staff,0,4,16,16
1715626972362,SIO 295LS,A00,523233,Staff,10,0,30,20
1715626973389,SIO 295S,A00,523232,Staff,10,0,30,20
1715626974416,SIOC 290S,A01,637330,Merrifield; Mark A,22,0,30,8
1715626975444,SIOC 291S,A01,637333,Gabriel; Corey John,22,0,30,8
1715626976471,SOCI 117,A01,494376,Staff,0,5,5,5
1715626977501,WES 237B,A00,494380,Staff,10,0,20,10
1715626979574,AESE 279B,A00,494370,Wade; Jon P,0,0,33,33
1715626980600,AIP 97,001,660915,Van Den Einde; Yael Dahlia,9998,0,9999,1
1715626981634,AIP 197,001,627712,Vespa; Emanuel Ignacio,9995,0,9999,4
1715626981634,AIP 197,002,650778,Amir; On,9998,0,9999,1
1715626981634,AIP 197,003,650933,Avenancio-Leon; Carlos,9998,0,9999,1
1715626981634,AIP 197,004,658530,Heyman; Gail D.,9998,0,9999,1
1715626981634,AIP 197,005,658631,Neal; Sonya E,9998,0,9999,1
1715626981634,AIP 197,006,658671,Du; Songzi,9998,0,9999,1
1715626982662,ANAR 135S,A00,494369,Braswell; Geoffrey E.,0,0,0,0
1715626983689,BENG 196,001,628496,Engler; Adam J.,9998,0,9999,1
1715626983689,BENG 196,002,660916,Watson; John Thomas,9999,0,9999,0
1715626984718,BISP 197,001,650773,Wilhelm; James E.,9994,0,9999,5
1715626984718,BISP 197,002,658904,Coleman; Aaron B.,9998,0,9999,1
1715626985743,CAT 124RS,A01,519847,Geibel; William,0,0,20,20
1715626986766,CAT 125RS,A01,515971,Geibel; William,0,0,20,20
1715626987791,CLRE 250,A00,511389,Morris; Sheldon,9992,0,9999,7
1715626988819,CLRE 251,A00,507176,Mehta; Ravindra L.,9992,0,9999,7
1715626988819,CLRE 251,B00,511410,Mehta; Ravindra L.,9998,0,9999,1
1715626989843,CLRE 252,A00,507189,Cuomo; Raphael Eduardo,9994,0,9999,5
1715626990868,CLRE 253,A00,507199,Vaida; Florin,9994,0,9999,5
1715626990868,CLRE 253,B00,507202,Vaida; Florin,9999,0,9999,0
1715626991893,CLRE 259,A00,507211,Patel; Hemal,9996,0,9999,3
1715626992926,CLRE 260,A00,507221,Cuomo; Raphael Eduardo,9999,0,9999,0
1715626993954,CLRE 297,001,507242,Cuomo; Raphael Eduardo,9999,0,9999,0
1715626995013,COGS 197,001,638244,Voytek; Bradley Thomas,9997,0,9999,2
1715626997036,CSE 191,A00,516875,Minnes Kemp; Mor Mia,9991,0,9999,8
1715626998063,CSE 197,001,637388,Minnes Kemp; Mor Mia,9992,0,9999,7
1715626999091,CSS 201S,A01,494383,Mignozzetti; Umberto,35,0,35,0
1715627000326,CSS 202S,A01,494387,Mignozzetti; Umberto,35,0,35,0
1715627001357,DSC 197,001,628532,Eldridge; Justin Matthew,9995,0,9999,4
1715627002384,EAP 100,A00,516065,Staff,9799,0,9999,200
1715627003414,ECE 45,A01,507414,Staff,31,0,60,29
1715627005470,ECE 111,A01,507420,Staff,11,0,50,39
1715627006496,ECE 197,001,548057,Sievenpiper; Daniel F.,9991,0,9999,8
1715627007524,EDS 115,A00,507243,Choi; Bailey Miyeon,7,0,28,21
1715627008551,EDS 117,A01,494379,Staff,0,6,34,34
1715627009580,EDS 125,A00,507246,Hopkins; Megan Beth,8,0,30,22
1715627010607,EDS 128A,A01,507264,Fargason; Sharon Gayle,6,0,26,20
1715627011636,EDS 128B,A01,507293,Pappas; Elizabeth,10,0,30,20
1715627012664,EDS 139,A00,507294,Fargason; Sharon Gayle,10,0,30,20
1715627012664,EDS 139,B00,507313,Pappas; Elizabeth,11,0,30,19
1715627013690,EDS 201,A00,507315,Staff,10,0,30,20
1715627014721,EDS 203,A01,507317,Halter; Christopher P.,10,0,30,20
1715627015746,EDS 204R,A01,507319,Halter; Christopher P.,0,3,30,30
1715627015746,EDS 204R,B01,507331,Heinzman; Erica M.,14,0,30,16
1715627016775,EDS 206R,A00,507332,Staff,0,4,30,30
1715627016775,EDS 206R,B00,507343,Staff,15,0,30,15
1715627017801,EDS 250,A00,507344,Hemans; Patricia Ann Benitez,20,0,40,20
1715627018831,EDS 281,A00,507345,Daly; Alan J.,18,0,18,0
1715627019856,EDS 284,A00,507350,Daly; Alan J.,16,0,16,0
1715627020885,EDS 286,A00,507359,Fine; Sarah,18,0,18,0
1715627021911,EDS 289C,A01,507361,Daly; Alan J.,18,0,18,0
1715627022935,EDS 290,A00,507366,Hofstetter; Carolyn,15,0,15,0
1715627023966,LIGM 5A,A00,507421,Fischer-Grunski; Eva K,17,0,20,3
1715627024991,LIGM 5B,A00,507423,Fischer-Grunski; Eva K,19,0,20,1
1715627026016,LIGM 5C,A00,507425,Fischer-Grunski; Eva K,19,0,20,1
1715627027045,LIIT 5AS,A00,507427,Carnelos; Chiara,20,0,20,0
1715627028073,LIIT 5BS,A00,507430,Carnelos; Chiara,20,0,20,0
1715627029101,LIIT 5CS,A00,507432,Carnelos; Chiara,20,0,20,0
1715627030127,LISP 5A,A00,507541,Munoz Sanchez; Alicia,11,0,20,9
1715627031152,LISP 5B,A00,507671,Munoz Sanchez; Alicia,9,0,20,11
1715627032182,LISP 5C,A00,507696,Munoz Sanchez; Alicia,9,0,20,11
1715627033207,MAE 197,001,528363,Boechler; Nicholas Sebastia,9998,0,9999,1
1715627034235,MATH 197,001,523477,Kedlaya; Kiran S.,9994,0,9999,5
1715627034235,MATH 197,002,563811,Zhang; Danna,9994,0,9999,5
1715627034235,MATH 197,003,628552,Dumitriu; Ioana,9998,0,9999,1
1715627034235,MATH 197,004,660885,Floyd; Eric,9998,0,9999,1
1715627035262,MCWP 40R,A00,518780,Staff,2,0,20,18
1715627035262,MCWP 40R,B00,518781,Staff,11,0,20,9
1715627035262,MCWP 40R,C00,518783,Staff,5,0,20,15
1715627036293,MCWP 50R,A00,518791,Staff,0,1,20,20
1715627036293,MCWP 50R,B00,518792,Staff,0,2,20,20
1715627036293,MCWP 50R,C00,518793,Staff,0,4,20,20
1715627036293,MCWP 50R,D00,518794,Staff,0,1,20,20
1715627036293,MCWP 50R,E00,518795,Staff,0,2,20,20
1715627036293,MCWP 50R,F00,518796,Staff,0,1,20,20
1715627036293,MCWP 50R,G00,518797,Staff,0,1,20,20
1715627037317,MMW 12R,A01,514034,Herbst; Matthew,0,2,16,16
1715627037317,MMW 12R,A02,514035,Herbst; Matthew,0,0,16,16
1715627038347,MMW 13R,A01,514037,Staff,0,5,16,16
1715627038347,MMW 13R,A02,514039,Staff,0,5,16,16
1715627038347,MMW 13R,A03,628519,Staff,0,4,16,16
1715627040402,SIO 295LS,A00,523233,Staff,10,0,30,20
1715627041428,SIO 295S,A00,523232,Staff,10,0,30,20
1715627042459,SIOC 290S,A01,637330,Merrifield; Mark A,22,0,30,8
1715627043488,SIOC 291S,A01,637333,Gabriel; Corey John,22,0,30,8
1715627044516,SOCI 117,A01,494376,Staff,0,5,5,5
1715627045543,WES 237B,A00,494380,Staff,10,0,20,10
1715627047614,AESE 279B,A00,494370,Wade; Jon P,0,0,33,33
1715627048639,AIP 97,001,660915,Van Den Einde; Yael Dahlia,9998,0,9999,1
1715627049667,AIP 197,001,627712,Vespa; Emanuel Ignacio,9995,0,9999,4
1715627049667,AIP 197,002,650778,Amir; On,9998,0,9999,1
1715627049667,AIP 197,003,650933,Avenancio-Leon; Carlos,9998,0,9999,1
1715627049667,AIP 197,004,658530,Heyman; Gail D.,9998,0,9999,1
1715627049667,AIP 197,005,658631,Neal; Sonya E,9998,0,9999,1
1715627049667,AIP 197,006,658671,Du; Songzi,9998,0,9999,1
1715627050693,ANAR 135S,A00,494369,Braswell; Geoffrey E.,0,0,0,0
1715627051721,BENG 196,001,628496,Engler; Adam J.,9998,0,9999,1
1715627051721,BENG 196,002,660916,Watson; John Thomas,9999,0,9999,0
1715627052747,BISP 197,001,650773,Wilhelm; James E.,9994,0,9999,5
1715627052747,BISP 197,002,658904,Coleman; Aaron B.,9998,0,9999,1
1715627053773,CAT 124RS,A01,519847,Geibel; William,0,0,20,20
1715627054797,CAT 125RS,A01,515971,Geibel; William,0,0,20,20
1715627055823,CLRE 250,A00,511389,Morris; Sheldon,9992,0,9999,7
1715627056854,CLRE 251,A00,507176,Mehta; Ravindra L.,9992,0,9999,7
1715627056854,CLRE 251,B00,511410,Mehta; Ravindra L.,9998,0,9999,1
1715627057880,CLRE 252,A00,507189,Cuomo; Raphael Eduardo,9994,0,9999,5
1715627058907,CLRE 253,A00,507199,Vaida; Florin,9994,0,9999,5
1715627058907,CLRE 253,B00,507202,Vaida; Florin,9999,0,9999,0
1715627059931,CLRE 259,A00,507211,Patel; Hemal,9996,0,9999,3
1715627060955,CLRE 260,A00,507221,Cuomo; Raphael Eduardo,9999,0,9999,0
1715627061982,CLRE 297,001,507242,Cuomo; Raphael Eduardo,9999,0,9999,0
1715627063007,COGS 197,001,638244,Voytek; Bradley Thomas,9997,0,9999,2
1715627064035,CSE 191,A00,516875,Minnes Kemp; Mor Mia,9991,0,9999,8
1715627065058,CSE 197,001,637388,Minnes Kemp; Mor Mia,9992,0,9999,7
1715627066089,CSS 201S,A01,494383,Mignozzetti; Umberto,35,0,35,0
1715627067118,CSS 202S,A01,494387,Mignozzetti; Umberto,35,0,35,0
1715627068145,DSC 197,001,628532,Eldridge; Justin Matthew,9995,0,9999,4
1715627069171,EAP 100,A00,516065,Staff,9799,0,9999,200
1715627070203,ECE 45,A01,507414,Staff,31,0,60,29
1715627072254,ECE 111,A01,507420,Staff,11,0,50,39
1715627073279,ECE 197,001,548057,Sievenpiper; Daniel F.,9991,0,9999,8
1715627074308,EDS 115,A00,507243,Choi; Bailey Miyeon,7,0,28,21
1715627075341,EDS 117,A01,494379,Staff,0,6,34,34
1715627076367,EDS 125,A00,507246,Hopkins; Megan Beth,8,0,30,22
1715627077393,EDS 128A,A01,507264,Fargason; Sharon Gayle,6,0,26,20
1715627078421,EDS 128B,A01,507293,Pappas; Elizabeth,10,0,30,20
1715627079447,EDS 139,A00,507294,Fargason; Sharon Gayle,10,0,30,20
1715627079447,EDS 139,B00,507313,Pappas; Elizabeth,11,0,30,19
1715627080475,EDS 201,A00,507315,Staff,10,0,30,20
1715627081502,EDS 203,A01,507317,Halter; Christopher P.,10,0,30,20
1715627082534,EDS 204R,A01,507319,Halter; Christopher P.,0,3,30,30
1715627082534,EDS 204R,B01,507331,Heinzman; Erica M.,14,0,30,16
1715627083559,EDS 206R,A00,507332,Staff,0,4,30,30
1715627083559,EDS 206R,B00,507343,Staff,15,0,30,15
1715627084585,EDS 250,A00,507344,Hemans; Patricia Ann Benitez,20,0,40,20
1715627085612,EDS 281,A00,507345,Daly; Alan J.,18,0,18,0
1715627086639,EDS 284,A00,507350,Daly; Alan J.,16,0,16,0
1715627087668,EDS 286,A00,507359,Fine; Sarah,18,0,18,0
1715627088697,EDS 289C,A01,507361,Daly; Alan J.,18,0,18,0
1715627089723,EDS 290,A00,507366,Hofstetter; Carolyn,15,0,15,0
1715627090752,LIGM 5A,A00,507421,Fischer-Grunski; Eva K,17,0,20,3
1715627091781,LIGM 5B,A00,507423,Fischer-Grunski; Eva K,19,0,20,1
1715627092809,LIGM 5C,A00,507425,Fischer-Grunski; Eva K,19,0,20,1
1715627093839,LIIT 5AS,A00,507427,Carnelos; Chiara,20,0,20,0
1715627094868,LIIT 5BS,A00,507430,Carnelos; Chiara,20,0,20,0
1715627095892,LIIT 5CS,A00,507432,Carnelos; Chiara,20,0,20,0
1715627096922,LISP 5A,A00,507541,Munoz Sanchez; Alicia,11,0,20,9
1715627097952,LISP 5B,A00,507671,Munoz Sanchez; Alicia,9,0,20,11
1715627098979,LISP 5C,A00,507696,Munoz Sanchez; Alicia,9,0,20,11
1715627100011,MAE 197,001,528363,Boechler; Nicholas Sebastia,9998,0,9999,1
1715627101048,MATH 197,001,523477,Kedlaya; Kiran S.,9994,0,9999,5
1715627101048,MATH 197,002,563811,Zhang; Danna,9994,0,9999,5
1715627101048,MATH 197,003,628552,Dumitriu; Ioana,9998,0,9999,1
1715627101048,MATH 197,004,660885,Floyd; Eric,9998,0,9999,1
1715627102077,MCWP 40R,A00,518780,Staff,2,0,20,18
1715627102077,MCWP 40R,B00,518781,Staff,11,0,20,9
1715627102077,MCWP 40R,C00,518783,Staff,5,0,20,15
1715627103105,MCWP 50R,A00,518791,Staff,0,1,20,20
1715627103105,MCWP 50R,B00,518792,Staff,0,2,20,20
1715627103105,MCWP 50R,C00,518793,Staff,0,4,20,20
1715627103105,MCWP 50R,D00,518794,Staff,0,1,20,20
1715627103105,MCWP 50R,E00,518795,Staff,0,2,20,20
1715627103105,MCWP 50R,F00,518796,Staff,0,1,20,20
1715627103105,MCWP 50R,G00,518797,Staff,0,1,20,20
1715627104132,MMW 12R,A01,514034,Herbst; Matthew,0,2,16,16
1715627104132,MMW 12R,A02,514035,Herbst; Matthew,0,0,16,16
1715627105159,MMW 13R,A01,514037,Staff,0,5,16,16
1715627105159,MMW 13R,A02,514039,Staff,0,5,16,16
1715627105159,MMW 13R,A03,628519,Staff,0,4,16,16
1715627107214,SIO 295LS,A00,523233,Staff,10,0,30,20
1715627108242,SIO 295S,A00,523232,Staff,10,0,30,20
1715627109270,SIOC 290S,A01,637330,Merrifield; Mark A,22,0,30,8
1715627110296,SIOC 291S,A01,637333,Gabriel; Corey John,22,0,30,8
1715627111325,SOCI 117,A01,494376,Staff,0,5,5,5
1715627112354,WES 237B,A00,494380,Staff,10,0,20,10
