time,subj_course_id,sec_code,sec_id,prof,available,waitlist,total,enrolled_ct
1714368033432,AESE 279B,A00,494370,Wade; Jon P,0,0,33,33
1714368034458,AIP 197,001,627712,Vespa; Emanuel Ignacio,9998,0,9999,1
1714368035484,ANAR 135S,A00,494369,Braswell; Geoffrey E.,0,0,0,0
1714368036508,BENG 196,001,628496,Engler; Adam J.,9998,0,9999,1
1714368037532,CAT 124RS,A01,519847,Geibel; William,0,0,20,20
1714368038560,CAT 125RS,A01,515971,Geibel; William,0,0,20,20
1714368039586,CLRE 250,A00,511389,Morris; Sheldon,9993,0,9999,6
1714368040614,CLRE 251,A00,507176,Mehta; Ravindra L.,9993,0,9999,6
1714368040614,CLRE 251,B00,511410,Mehta; Ravindra L.,9998,0,9999,1
1714368041643,CLRE 252,A00,507189,Cuomo; Raphael Eduardo,9995,0,9999,4
1714368042667,CLRE 253,A00,507199,Vaida; Florin,9994,0,9999,5
1714368042667,CLRE 253,B00,507202,Vaida; Florin,9999,0,9999,0
1714368043694,CLRE 259,A00,507211,Patel; Hemal,9996,0,9999,3
1714368044718,CLRE 260,A00,507221,Cuomo; Raphael Eduardo,9999,0,9999,0
1714368045743,CLRE 297,001,507242,Cuomo; Raphael Eduardo,9999,0,9999,0
1714368046768,COGS 197,001,638244,Voytek; Bradley Thomas,9999,0,9999,0
1714368047796,CSE 191,A00,516875,Minnes Kemp; Mor Mia,9993,0,9999,6
1714368048822,CSE 197,001,637388,Minnes Kemp; Mor Mia,9998,0,9999,1
1714368049851,CSS 201S,A01,494383,Staff,35,0,35,0
1714368050880,CSS 202S,A01,494387,Staff,35,0,35,0
1714368051906,DSC 197,001,628532,Eldridge; Justin Matthew,9996,0,9999,3
1714368052929,EAP 100,A00,516065,Staff,9797,0,9999,202
1714368053955,ECE 45,A01,507414,Staff,33,0,60,27
1714368056012,ECE 111,A01,507420,Staff,19,0,50,31
1714368057037,ECE 197,001,548057,Sievenpiper; Daniel F.,9994,0,9999,5
1714368058065,EDS 115,A00,507243,Choi; Bailey Miyeon,12,0,28,16
1714368059092,EDS 117,A01,494379,Staff,0,2,30,30
1714368060123,EDS 125,A00,507246,Hopkins; Megan Beth,12,0,30,18
1714368061154,EDS 128A,A01,507264,Fargason; Sharon Gayle,14,0,26,12
1714368062182,EDS 128B,A01,507293,Pappas; Elizabeth,18,0,30,12
1714368063207,EDS 139,A00,507294,Fargason; Sharon Gayle,18,0,30,12
1714368063207,EDS 139,B00,507313,Pappas; Elizabeth,15,0,30,15
1714368064232,EDS 201,A00,507315,Staff,13,0,30,17
1714368065258,EDS 203,A01,507317,Halter; Christopher P.,12,0,30,18
1714368066284,EDS 204R,A01,507319,Halter; Christopher P.,0,3,30,30
1714368066284,EDS 204R,B01,507331,Heinzman; Erica M.,17,0,30,13
1714368067311,EDS 206R,A00,507332,Staff,0,4,30,30
1714368067311,EDS 206R,B00,507343,Staff,18,0,30,12
1714368068340,EDS 250,A00,507344,Hemans; Patricia Ann Benitez,22,0,40,18
1714368069364,EDS 281,A00,507345,Daly; Alan J.,18,0,18,0
1714368070391,EDS 284,A00,507350,Daly; Alan J.,16,0,16,0
1714368071415,EDS 286,A00,507359,Fine; Sarah,18,0,18,0
1714368072440,EDS 289C,A01,507361,Daly; Alan J.,18,0,18,0
1714368073465,EDS 290,A00,507366,Hofstetter; Carolyn,15,0,15,0
1714368074491,LIGM 5A,A00,507421,Fischer-Grunski; Eva K,18,0,20,2
1714368075520,LIGM 5B,A00,507423,Fischer-Grunski; Eva K,19,0,20,1
1714368076545,LIGM 5C,A00,507425,Fischer-Grunski; Eva K,19,0,20,1
1714368077569,LIIT 5AS,A00,507427,Carnelos; Chiara,20,0,20,0
1714368078594,LIIT 5BS,A00,507430,Carnelos; Chiara,20,0,20,0
1714368079620,LIIT 5CS,A00,507432,Carnelos; Chiara,20,0,20,0
1714368080645,LISP 5A,A00,507541,Munoz Sanchez; Alicia,11,0,20,9
1714368081675,LISP 5B,A00,507671,Munoz Sanchez; Alicia,9,0,20,11
1714368082704,LISP 5C,A00,507696,Munoz Sanchez; Alicia,9,0,20,11
1714368083732,MAE 197,001,528363,Boechler; Nicholas Sebastia,9998,0,9999,1
1714368084761,MATH 197,001,523477,Kedlaya; Kiran S.,9996,0,9999,3
1714368084761,MATH 197,002,563811,Zhang; Danna,9995,0,9999,4
1714368084761,MATH 197,003,628552,Dumitriu; Ioana,9998,0,9999,1
1714368085786,MCWP 40R,A00,518780,Staff,5,0,20,15
1714368085786,MCWP 40R,B00,518781,Staff,7,0,20,13
1714368085786,MCWP 40R,C00,518783,Staff,5,0,20,15
1714368086812,MCWP 50R,A00,518791,Staff,0,0,20,20
1714368086812,MCWP 50R,B00,518792,Staff,0,1,20,20
1714368086812,MCWP 50R,C00,518793,Staff,0,1,20,20
1714368086812,MCWP 50R,D00,518794,Staff,0,0,20,20
1714368086812,MCWP 50R,E00,518795,Staff,0,1,20,20
1714368086812,MCWP 50R,F00,518796,Staff,0,0,20,20
1714368086812,MCWP 50R,G00,518797,Staff,0,1,20,20
1714368087840,MMW 12R,A01,514034,Herbst; Matthew,0,1,16,16
1714368087840,MMW 12R,A02,514035,Herbst; Matthew,2,0,16,14
1714368088865,MMW 13R,A01,514037,Staff,0,4,16,16
1714368088865,MMW 13R,A02,514039,Staff,0,2,16,16
1714368088865,MMW 13R,A03,628519,Staff,0,2,16,16
1714368090918,SIO 295LS,A00,523233,Staff,12,0,30,18
1714368091942,SIO 295S,A00,523232,Staff,12,0,30,18
1714368092969,SIOC 290S,A01,637330,Merrifield; Mark A,27,0,30,3
1714368093996,SIOC 291S,A01,637333,Gabriel; Corey John,27,0,30,3
1714368095024,SOCI 117,A01,494376,Staff,0,3,5,5
1714368096051,WES 237B,A00,494380,Staff,9,0,20,11
1714368098118,AESE 279B,A00,494370,Wade; Jon P,0,0,33,33
1714368099143,AIP 197,001,627712,Vespa; Emanuel Ignacio,9998,0,9999,1
1714368100168,ANAR 135S,A00,494369,Braswell; Geoffrey E.,0,0,0,0
1714368101194,BENG 196,001,628496,Engler; Adam J.,9998,0,9999,1
1714368102219,CAT 124RS,A01,519847,Geibel; William,0,0,20,20
1714368103246,CAT 125RS,A01,515971,Geibel; William,0,0,20,20
1714368104273,CLRE 250,A00,511389,Morris; Sheldon,9993,0,9999,6
1714368105300,CLRE 251,A00,507176,Mehta; Ravindra L.,9993,0,9999,6
1714368105300,CLRE 251,B00,511410,Mehta; Ravindra L.,9998,0,9999,1
1714368106327,CLRE 252,A00,507189,Cuomo; Raphael Eduardo,9995,0,9999,4
1714368107352,CLRE 253,A00,507199,Vaida; Florin,9994,0,9999,5
1714368107352,CLRE 253,B00,507202,Vaida; Florin,9999,0,9999,0
1714368108378,CLRE 259,A00,507211,Patel; Hemal,9996,0,9999,3
1714368109402,CLRE 260,A00,507221,Cuomo; Raphael Eduardo,9999,0,9999,0
1714368110429,CLRE 297,001,507242,Cuomo; Raphael Eduardo,9999,0,9999,0
1714368111454,COGS 197,001,638244,Voytek; Bradley Thomas,9999,0,9999,0
1714368112478,CSE 191,A00,516875,Minnes Kemp; Mor Mia,9993,0,9999,6
1714368113519,CSE 197,001,637388,Minnes Kemp; Mor Mia,9998,0,9999,1
1714368114545,CSS 201S,A01,494383,Staff,35,0,35,0
1714368115574,CSS 202S,A01,494387,Staff,35,0,35,0
1714368116600,DSC 197,001,628532,Eldridge; Justin Matthew,9996,0,9999,3
1714368117627,EAP 100,A00,516065,Staff,9797,0,9999,202
1714368118655,ECE 45,A01,507414,Staff,33,0,60,27
1714368120706,ECE 111,A01,507420,Staff,19,0,50,31
1714368121731,ECE 197,001,548057,Sievenpiper; Daniel F.,9994,0,9999,5
1714368122757,EDS 115,A00,507243,Choi; Bailey Miyeon,12,0,28,16
1714368123839,EDS 117,A01,494379,Staff,0,2,30,30
1714368124864,EDS 125,A00,507246,Hopkins; Megan Beth,12,0,30,18
1714368125900,EDS 128A,A01,507264,Fargason; Sharon Gayle,14,0,26,12
1714368126926,EDS 128B,A01,507293,Pappas; Elizabeth,18,0,30,12
1714368127954,EDS 139,A00,507294,Fargason; Sharon Gayle,18,0,30,12
1714368127954,EDS 139,B00,507313,Pappas; Elizabeth,15,0,30,15
1714368128979,EDS 201,A00,507315,Staff,13,0,30,17
1714368130005,EDS 203,A01,507317,Halter; Christopher P.,12,0,30,18
1714368131030,EDS 204R,A01,507319,Halter; Christopher P.,0,3,30,30
1714368131030,EDS 204R,B01,507331,Heinzman; Erica M.,17,0,30,13
1714368132054,EDS 206R,A00,507332,Staff,0,4,30,30
1714368132054,EDS 206R,B00,507343,Staff,18,0,30,12
1714368133080,EDS 250,A00,507344,Hemans; Patricia Ann Benitez,22,0,40,18
1714368134104,EDS 281,A00,507345,Daly; Alan J.,18,0,18,0
1714368135132,EDS 284,A00,507350,Daly; Alan J.,16,0,16,0
1714368136160,EDS 286,A00,507359,Fine; Sarah,18,0,18,0
1714368137188,EDS 289C,A01,507361,Daly; Alan J.,18,0,18,0
1714368138215,EDS 290,A00,507366,Hofstetter; Carolyn,15,0,15,0
1714368139240,LIGM 5A,A00,507421,Fischer-Grunski; Eva K,18,0,20,2
1714368140265,LIGM 5B,A00,507423,Fischer-Grunski; Eva K,19,0,20,1
1714368141291,LIGM 5C,A00,507425,Fischer-Grunski; Eva K,19,0,20,1
1714368142321,LIIT 5AS,A00,507427,Carnelos; Chiara,20,0,20,0
1714368143343,LIIT 5BS,A00,507430,Carnelos; Chiara,20,0,20,0
1714368144368,LIIT 5CS,A00,507432,Carnelos; Chiara,20,0,20,0
1714368145395,LISP 5A,A00,507541,Munoz Sanchez; Alicia,11,0,20,9
1714368146423,LISP 5B,A00,507671,Munoz Sanchez; Alicia,9,0,20,11
1714368147449,LISP 5C,A00,507696,Munoz Sanchez; Alicia,9,0,20,11
1714368148478,MAE 197,001,528363,Boechler; Nicholas Sebastia,9998,0,9999,1
1714368149503,MATH 197,001,523477,Kedlaya; Kiran S.,9996,0,9999,3
1714368149503,MATH 197,002,563811,Zhang; Danna,9995,0,9999,4
1714368149503,MATH 197,003,628552,Dumitriu; Ioana,9998,0,9999,1
1714368150530,MCWP 40R,A00,518780,Staff,5,0,20,15
1714368150530,MCWP 40R,B00,518781,Staff,7,0,20,13
1714368150530,MCWP 40R,C00,518783,Staff,5,0,20,15
1714368151554,MCWP 50R,A00,518791,Staff,0,0,20,20
1714368151554,MCWP 50R,B00,518792,Staff,0,1,20,20
1714368151554,MCWP 50R,C00,518793,Staff,0,1,20,20
1714368151554,MCWP 50R,D00,518794,Staff,0,0,20,20
1714368151554,MCWP 50R,E00,518795,Staff,0,1,20,20
1714368151554,MCWP 50R,F00,518796,Staff,0,0,20,20
1714368151554,MCWP 50R,G00,518797,Staff,0,1,20,20
1714368152580,MMW 12R,A01,514034,Herbst; Matthew,0,1,16,16
1714368152580,MMW 12R,A02,514035,Herbst; Matthew,2,0,16,14
1714368153607,MMW 13R,A01,514037,Staff,0,4,16,16
1714368153607,MMW 13R,A02,514039,Staff,0,2,16,16
1714368153607,MMW 13R,A03,628519,Staff,0,2,16,16
1714368155658,SIO 295LS,A00,523233,Staff,12,0,30,18
1714368156683,SIO 295S,A00,523232,Staff,12,0,30,18
1714368157709,SIOC 290S,A01,637330,Merrifield; Mark A,27,0,30,3
1714368158738,SIOC 291S,A01,637333,Gabriel; Corey John,27,0,30,3
1714368159763,SOCI 117,A01,494376,Staff,0,3,5,5
1714368160791,WES 237B,A00,494380,Staff,9,0,20,11
1714368162865,AESE 279B,A00,494370,Wade; Jon P,0,0,33,33
1714368163905,AIP 197,001,627712,Vespa; Emanuel Ignacio,9998,0,9999,1
1714368164930,ANAR 135S,A00,494369,Braswell; Geoffrey E.,0,0,0,0
1714368165958,BENG 196,001,628496,Engler; Adam J.,9998,0,9999,1
1714368166988,CAT 124RS,A01,519847,Geibel; William,0,0,20,20
1714368168017,CAT 125RS,A01,515971,Geibel; William,0,0,20,20
1714368169048,CLRE 250,A00,511389,Morris; Sheldon,9993,0,9999,6
1714368170079,CLRE 251,A00,507176,Mehta; Ravindra L.,9993,0,9999,6
1714368170079,CLRE 251,B00,511410,Mehta; Ravindra L.,9998,0,9999,1
1714368171103,CLRE 252,A00,507189,Cuomo; Raphael Eduardo,9995,0,9999,4
1714368172129,CLRE 253,A00,507199,Vaida; Florin,9994,0,9999,5
1714368172129,CLRE 253,B00,507202,Vaida; Florin,9999,0,9999,0
1714368173155,CLRE 259,A00,507211,Patel; Hemal,9996,0,9999,3
1714368174181,CLRE 260,A00,507221,Cuomo; Raphael Eduardo,9999,0,9999,0
1714368175206,CLRE 297,001,507242,Cuomo; Raphael Eduardo,9999,0,9999,0
1714368176232,COGS 197,001,638244,Voytek; Bradley Thomas,9999,0,9999,0
1714368177260,CSE 191,A00,516875,Minnes Kemp; Mor Mia,9993,0,9999,6
1714368178286,CSE 197,001,637388,Minnes Kemp; Mor Mia,9998,0,9999,1
1714368179312,CSS 201S,A01,494383,Staff,35,0,35,0
1714368180350,CSS 202S,A01,494387,Staff,35,0,35,0
1714368181378,DSC 197,001,628532,Eldridge; Justin Matthew,9996,0,9999,3
1714368182405,EAP 100,A00,516065,Staff,9797,0,9999,202
1714368183431,ECE 45,A01,507414,Staff,33,0,60,27
1714368185483,ECE 111,A01,507420,Staff,19,0,50,31
1714368186511,ECE 197,001,548057,Sievenpiper; Daniel F.,9994,0,9999,5
1714368187539,EDS 115,A00,507243,Choi; Bailey Miyeon,12,0,28,16
1714368188565,EDS 117,A01,494379,Staff,0,2,30,30
1714368189591,EDS 125,A00,507246,Hopkins; Megan Beth,12,0,30,18
1714368190618,EDS 128A,A01,507264,Fargason; Sharon Gayle,14,0,26,12
1714368191646,EDS 128B,A01,507293,Pappas; Elizabeth,18,0,30,12
1714368192674,EDS 139,A00,507294,Fargason; Sharon Gayle,18,0,30,12
1714368192674,EDS 139,B00,507313,Pappas; Elizabeth,15,0,30,15
1714368193700,EDS 201,A00,507315,Staff,13,0,30,17
1714368194729,EDS 203,A01,507317,Halter; Christopher P.,12,0,30,18
1714368195759,EDS 204R,A01,507319,Halter; Christopher P.,0,3,30,30
1714368195759,EDS 204R,B01,507331,Heinzman; Erica M.,17,0,30,13
1714368196787,EDS 206R,A00,507332,Staff,0,4,30,30
1714368196787,EDS 206R,B00,507343,Staff,18,0,30,12
1714368197812,EDS 250,A00,507344,Hemans; Patricia Ann Benitez,22,0,40,18
1714368198837,EDS 281,A00,507345,Daly; Alan J.,18,0,18,0
1714368199863,EDS 284,A00,507350,Daly; Alan J.,16,0,16,0
1714368200889,EDS 286,A00,507359,Fine; Sarah,18,0,18,0
1714368201915,EDS 289C,A01,507361,Daly; Alan J.,18,0,18,0
1714368202940,EDS 290,A00,507366,Hofstetter; Carolyn,15,0,15,0
1714368203968,LIGM 5A,A00,507421,Fischer-Grunski; Eva K,18,0,20,2
1714368204994,LIGM 5B,A00,507423,Fischer-Grunski; Eva K,19,0,20,1
1714368206024,LIGM 5C,A00,507425,Fischer-Grunski; Eva K,19,0,20,1
1714368207053,LIIT 5AS,A00,507427,Carnelos; Chiara,20,0,20,0
1714368208080,LIIT 5BS,A00,507430,Carnelos; Chiara,20,0,20,0
1714368209109,LIIT 5CS,A00,507432,Carnelos; Chiara,20,0,20,0
1714368210135,LISP 5A,A00,507541,Munoz Sanchez; Alicia,11,0,20,9
1714368211162,LISP 5B,A00,507671,Munoz Sanchez; Alicia,9,0,20,11
1714368212187,LISP 5C,A00,507696,Munoz Sanchez; Alicia,9,0,20,11
1714368213211,MAE 197,001,528363,Boechler; Nicholas Sebastia,9998,0,9999,1
1714368214241,MATH 197,001,523477,Kedlaya; Kiran S.,9996,0,9999,3
1714368214241,MATH 197,002,563811,Zhang; Danna,9995,0,9999,4
1714368214241,MATH 197,003,628552,Dumitriu; Ioana,9998,0,9999,1
1714368215265,MCWP 40R,A00,518780,Staff,5,0,20,15
1714368215265,MCWP 40R,B00,518781,Staff,7,0,20,13
1714368215265,MCWP 40R,C00,518783,Staff,5,0,20,15
1714368216292,MCWP 50R,A00,518791,Staff,0,0,20,20
1714368216292,MCWP 50R,B00,518792,Staff,0,1,20,20
1714368216292,MCWP 50R,C00,518793,Staff,0,1,20,20
1714368216292,MCWP 50R,D00,518794,Staff,0,0,20,20
1714368216292,MCWP 50R,E00,518795,Staff,0,1,20,20
1714368216292,MCWP 50R,F00,518796,Staff,0,0,20,20
1714368216292,MCWP 50R,G00,518797,Staff,0,1,20,20
1714368217317,MMW 12R,A01,514034,Herbst; Matthew,0,1,16,16
1714368217317,MMW 12R,A02,514035,Herbst; Matthew,2,0,16,14
1714368218345,MMW 13R,A01,514037,Staff,0,4,16,16
1714368218345,MMW 13R,A02,514039,Staff,0,2,16,16
1714368218345,MMW 13R,A03,628519,Staff,0,2,16,16
1714368220400,SIO 295LS,A00,523233,Staff,12,0,30,18
1714368221428,SIO 295S,A00,523232,Staff,12,0,30,18
1714368222456,SIOC 290S,A01,637330,Merrifield; Mark A,27,0,30,3
1714368223482,SIOC 291S,A01,637333,Gabriel; Corey John,27,0,30,3
1714368224511,SOCI 117,A01,494376,Staff,0,3,5,5
1714368225535,WES 237B,A00,494380,Staff,9,0,20,11
1714368227649,AESE 279B,A00,494370,Wade; Jon P,0,0,33,33
1714368228678,AIP 197,001,627712,Vespa; Emanuel Ignacio,9998,0,9999,1
1714368229704,ANAR 135S,A00,494369,Braswell; Geoffrey E.,0,0,0,0
1714368230730,BENG 196,001,628496,Engler; Adam J.,9998,0,9999,1
1714368231756,CAT 124RS,A01,519847,Geibel; William,0,0,20,20
1714368232783,CAT 125RS,A01,515971,Geibel; William,0,0,20,20
1714368233810,CLRE 250,A00,511389,Morris; Sheldon,9993,0,9999,6
1714368234841,CLRE 251,A00,507176,Mehta; Ravindra L.,9993,0,9999,6
1714368234841,CLRE 251,B00,511410,Mehta; Ravindra L.,9998,0,9999,1
1714368235864,CLRE 252,A00,507189,Cuomo; Raphael Eduardo,9995,0,9999,4
1714368236889,CLRE 253,A00,507199,Vaida; Florin,9994,0,9999,5
1714368236889,CLRE 253,B00,507202,Vaida; Florin,9999,0,9999,0
1714368237915,CLRE 259,A00,507211,Patel; Hemal,9996,0,9999,3
1714368238943,CLRE 260,A00,507221,Cuomo; Raphael Eduardo,9999,0,9999,0
1714368239972,CLRE 297,001,507242,Cuomo; Raphael Eduardo,9999,0,9999,0
1714368240998,COGS 197,001,638244,Voytek; Bradley Thomas,9999,0,9999,0
1714368242025,CSE 191,A00,516875,Minnes Kemp; Mor Mia,9993,0,9999,6
1714368243054,CSE 197,001,637388,Minnes Kemp; Mor Mia,9998,0,9999,1
1714368244084,CSS 201S,A01,494383,Staff,35,0,35,0
1714368245113,CSS 202S,A01,494387,Staff,35,0,35,0
1714368246139,DSC 197,001,628532,Eldridge; Justin Matthew,9996,0,9999,3
1714368247164,EAP 100,A00,516065,Staff,9797,0,9999,202
1714368248193,ECE 45,A01,507414,Staff,33,0,60,27
1714368250247,ECE 111,A01,507420,Staff,19,0,50,31
1714368251271,ECE 197,001,548057,Sievenpiper; Daniel F.,9994,0,9999,5
1714368252299,EDS 115,A00,507243,Choi; Bailey Miyeon,12,0,28,16
1714368253329,EDS 117,A01,494379,Staff,0,2,30,30
1714368254360,EDS 125,A00,507246,Hopkins; Megan Beth,12,0,30,18
1714368255385,EDS 128A,A01,507264,Fargason; Sharon Gayle,14,0,26,12
1714368256412,EDS 128B,A01,507293,Pappas; Elizabeth,18,0,30,12
1714368257436,EDS 139,A00,507294,Fargason; Sharon Gayle,18,0,30,12
1714368257436,EDS 139,B00,507313,Pappas; Elizabeth,15,0,30,15
1714368258463,EDS 201,A00,507315,Staff,13,0,30,17
1714368259491,EDS 203,A01,507317,Halter; Christopher P.,12,0,30,18
1714368260519,EDS 204R,A01,507319,Halter; Christopher P.,0,3,30,30
1714368260519,EDS 204R,B01,507331,Heinzman; Erica M.,17,0,30,13
1714368261544,EDS 206R,A00,507332,Staff,0,4,30,30
1714368261544,EDS 206R,B00,507343,Staff,18,0,30,12
1714368262570,EDS 250,A00,507344,Hemans; Patricia Ann Benitez,22,0,40,18
1714368263596,EDS 281,A00,507345,Daly; Alan J.,18,0,18,0
1714368264620,EDS 284,A00,507350,Daly; Alan J.,16,0,16,0
1714368265646,EDS 286,A00,507359,Fine; Sarah,18,0,18,0
1714368266673,EDS 289C,A01,507361,Daly; Alan J.,18,0,18,0
1714368267700,EDS 290,A00,507366,Hofstetter; Carolyn,15,0,15,0
1714368268731,LIGM 5A,A00,507421,Fischer-Grunski; Eva K,18,0,20,2
1714368269757,LIGM 5B,A00,507423,Fischer-Grunski; Eva K,19,0,20,1
1714368270784,LIGM 5C,A00,507425,Fischer-Grunski; Eva K,19,0,20,1
1714368271813,LIIT 5AS,A00,507427,Carnelos; Chiara,20,0,20,0
1714368272837,LIIT 5BS,A00,507430,Carnelos; Chiara,20,0,20,0
1714368273865,LIIT 5CS,A00,507432,Carnelos; Chiara,20,0,20,0
1714368274890,LISP 5A,A00,507541,Munoz Sanchez; Alicia,11,0,20,9
1714368275916,LISP 5B,A00,507671,Munoz Sanchez; Alicia,9,0,20,11
1714368276941,LISP 5C,A00,507696,Munoz Sanchez; Alicia,9,0,20,11
1714368277969,MAE 197,001,528363,Boechler; Nicholas Sebastia,9998,0,9999,1
1714368278996,MATH 197,001,523477,Kedlaya; Kiran S.,9996,0,9999,3
1714368278996,MATH 197,002,563811,Zhang; Danna,9995,0,9999,4
1714368278996,MATH 197,003,628552,Dumitriu; Ioana,9998,0,9999,1
1714368280026,MCWP 40R,A00,518780,Staff,5,0,20,15
1714368280026,MCWP 40R,B00,518781,Staff,7,0,20,13
1714368280026,MCWP 40R,C00,518783,Staff,5,0,20,15
1714368281054,MCWP 50R,A00,518791,Staff,0,0,20,20
1714368281054,MCWP 50R,B00,518792,Staff,0,1,20,20
1714368281054,MCWP 50R,C00,518793,Staff,0,1,20,20
1714368281054,MCWP 50R,D00,518794,Staff,0,0,20,20
1714368281054,MCWP 50R,E00,518795,Staff,0,1,20,20
1714368281054,MCWP 50R,F00,518796,Staff,0,0,20,20
1714368281054,MCWP 50R,G00,518797,Staff,0,1,20,20
1714368282082,MMW 12R,A01,514034,Herbst; Matthew,0,1,16,16
1714368282082,MMW 12R,A02,514035,Herbst; Matthew,2,0,16,14
1714368283115,MMW 13R,A01,514037,Staff,0,4,16,16
1714368283115,MMW 13R,A02,514039,Staff,0,2,16,16
1714368283115,MMW 13R,A03,628519,Staff,0,2,16,16
1714368285167,SIO 295LS,A00,523233,Staff,12,0,30,18
1714368286197,SIO 295S,A00,523232,Staff,12,0,30,18
1714368287222,SIOC 290S,A01,637330,Merrifield; Mark A,27,0,30,3
1714368288247,SIOC 291S,A01,637333,Gabriel; Corey John,27,0,30,3
1714368289274,SOCI 117,A01,494376,Staff,0,3,5,5
1714368290300,WES 237B,A00,494380,Staff,9,0,20,11
1714368292371,AESE 279B,A00,494370,Wade; Jon P,0,0,33,33
1714368293397,AIP 197,001,627712,Vespa; Emanuel Ignacio,9998,0,9999,1
1714368294423,ANAR 135S,A00,494369,Braswell; Geoffrey E.,0,0,0,0
1714368295448,BENG 196,001,628496,Engler; Adam J.,9998,0,9999,1
1714368296474,CAT 124RS,A01,519847,Geibel; William,0,0,20,20
1714368297499,CAT 125RS,A01,515971,Geibel; William,0,0,20,20
1714368298524,CLRE 250,A00,511389,Morris; Sheldon,9993,0,9999,6
1714368299548,CLRE 251,A00,507176,Mehta; Ravindra L.,9993,0,9999,6
1714368299548,CLRE 251,B00,511410,Mehta; Ravindra L.,9998,0,9999,1
1714368300573,CLRE 252,A00,507189,Cuomo; Raphael Eduardo,9995,0,9999,4
1714368301601,CLRE 253,A00,507199,Vaida; Florin,9994,0,9999,5
1714368301601,CLRE 253,B00,507202,Vaida; Florin,9999,0,9999,0
1714368302634,CLRE 259,A00,507211,Patel; Hemal,9996,0,9999,3
1714368303659,CLRE 260,A00,507221,Cuomo; Raphael Eduardo,9999,0,9999,0
1714368304682,CLRE 297,001,507242,Cuomo; Raphael Eduardo,9999,0,9999,0
1714368305709,COGS 197,001,638244,Voytek; Bradley Thomas,9999,0,9999,0
1714368306734,CSE 191,A00,516875,Minnes Kemp; Mor Mia,9993,0,9999,6
1714368307758,CSE 197,001,637388,Minnes Kemp; Mor Mia,9998,0,9999,1
1714368308788,CSS 201S,A01,494383,Staff,35,0,35,0
1714368309812,CSS 202S,A01,494387,Staff,35,0,35,0
1714368310842,DSC 197,001,628532,Eldridge; Justin Matthew,9996,0,9999,3
1714368311867,EAP 100,A00,516065,Staff,9797,0,9999,202
1714368312894,ECE 45,A01,507414,Staff,33,0,60,27
1714368314951,ECE 111,A01,507420,Staff,19,0,50,31
1714368315977,ECE 197,001,548057,Sievenpiper; Daniel F.,9994,0,9999,5
1714368317003,EDS 115,A00,507243,Choi; Bailey Miyeon,12,0,28,16
1714368318027,EDS 117,A01,494379,Staff,0,2,30,30
1714368319054,EDS 125,A00,507246,Hopkins; Megan Beth,12,0,30,18
1714368320080,EDS 128A,A01,507264,Fargason; Sharon Gayle,14,0,26,12
1714368321308,EDS 128B,A01,507293,Pappas; Elizabeth,18,0,30,12
1714368322333,EDS 139,A00,507294,Fargason; Sharon Gayle,18,0,30,12
1714368322333,EDS 139,B00,507313,Pappas; Elizabeth,15,0,30,15
1714368323363,EDS 201,A00,507315,Staff,13,0,30,17
1714368324389,EDS 203,A01,507317,Halter; Christopher P.,12,0,30,18
1714368325417,EDS 204R,A01,507319,Halter; Christopher P.,0,3,30,30
1714368325417,EDS 204R,B01,507331,Heinzman; Erica M.,17,0,30,13
1714368326444,EDS 206R,A00,507332,Staff,0,4,30,30
1714368326444,EDS 206R,B00,507343,Staff,18,0,30,12
1714368327469,EDS 250,A00,507344,Hemans; Patricia Ann Benitez,22,0,40,18
1714368328496,EDS 281,A00,507345,Daly; Alan J.,18,0,18,0
1714368329521,EDS 284,A00,507350,Daly; Alan J.,16,0,16,0
1714368330547,EDS 286,A00,507359,Fine; Sarah,18,0,18,0
1714368331627,EDS 289C,A01,507361,Daly; Alan J.,18,0,18,0
1714368332651,EDS 290,A00,507366,Hofstetter; Carolyn,15,0,15,0
1714368333677,LIGM 5A,A00,507421,Fischer-Grunski; Eva K,18,0,20,2
1714368334703,LIGM 5B,A00,507423,Fischer-Grunski; Eva K,19,0,20,1
1714368335729,LIGM 5C,A00,507425,Fischer-Grunski; Eva K,19,0,20,1
1714368336757,LIIT 5AS,A00,507427,Carnelos; Chiara,20,0,20,0
1714368337785,LIIT 5BS,A00,507430,Carnelos; Chiara,20,0,20,0
1714368338811,LIIT 5CS,A00,507432,Carnelos; Chiara,20,0,20,0
1714368339836,LISP 5A,A00,507541,Munoz Sanchez; Alicia,11,0,20,9
1714368340864,LISP 5B,A00,507671,Munoz Sanchez; Alicia,9,0,20,11
1714368341888,LISP 5C,A00,507696,Munoz Sanchez; Alicia,9,0,20,11
1714368342913,MAE 197,001,528363,Boechler; Nicholas Sebastia,9998,0,9999,1
1714368343937,MATH 197,001,523477,Kedlaya; Kiran S.,9996,0,9999,3
1714368343937,MATH 197,002,563811,Zhang; Danna,9995,0,9999,4
1714368343937,MATH 197,003,628552,Dumitriu; Ioana,9998,0,9999,1
1714368344963,MCWP 40R,A00,518780,Staff,5,0,20,15
1714368344963,MCWP 40R,B00,518781,Staff,7,0,20,13
1714368344963,MCWP 40R,C00,518783,Staff,5,0,20,15
1714368345991,MCWP 50R,A00,518791,Staff,0,0,20,20
1714368345991,MCWP 50R,B00,518792,Staff,0,1,20,20
1714368345991,MCWP 50R,C00,518793,Staff,0,1,20,20
1714368345991,MCWP 50R,D00,518794,Staff,0,0,20,20
1714368345991,MCWP 50R,E00,518795,Staff,0,1,20,20
1714368345991,MCWP 50R,F00,518796,Staff,0,0,20,20
1714368345991,MCWP 50R,G00,518797,Staff,0,1,20,20
1714368347020,MMW 12R,A01,514034,Herbst; Matthew,0,1,16,16
1714368347020,MMW 12R,A02,514035,Herbst; Matthew,2,0,16,14
1714368348042,MMW 13R,A01,514037,Staff,0,4,16,16
1714368348042,MMW 13R,A02,514039,Staff,0,2,16,16
1714368348042,MMW 13R,A03,628519,Staff,0,2,16,16
1714368350089,SIO 295LS,A00,523233,Staff,12,0,30,18
1714368351113,SIO 295S,A00,523232,Staff,12,0,30,18
1714368352139,SIOC 290S,A01,637330,Merrifield; Mark A,27,0,30,3
1714368353168,SIOC 291S,A01,637333,Gabriel; Corey John,27,0,30,3
1714368354195,SOCI 117,A01,494376,Staff,0,3,5,5
1714368355217,WES 237B,A00,494380,Staff,9,0,20,11
1714368357285,AESE 279B,A00,494370,Wade; Jon P,0,0,33,33
1714368358312,AIP 197,001,627712,Vespa; Emanuel Ignacio,9998,0,9999,1
1714368359339,ANAR 135S,A00,494369,Braswell; Geoffrey E.,0,0,0,0
1714368360367,BENG 196,001,628496,Engler; Adam J.,9998,0,9999,1
1714368361392,CAT 124RS,A01,519847,Geibel; William,0,0,20,20
1714368362417,CAT 125RS,A01,515971,Geibel; William,0,0,20,20
1714368363445,CLRE 250,A00,511389,Morris; Sheldon,9993,0,9999,6
1714368364475,CLRE 251,A00,507176,Mehta; Ravindra L.,9993,0,9999,6
1714368364475,CLRE 251,B00,511410,Mehta; Ravindra L.,9998,0,9999,1
1714368365500,CLRE 252,A00,507189,Cuomo; Raphael Eduardo,9995,0,9999,4
1714368366524,CLRE 253,A00,507199,Vaida; Florin,9994,0,9999,5
1714368366524,CLRE 253,B00,507202,Vaida; Florin,9999,0,9999,0
1714368367549,CLRE 259,A00,507211,Patel; Hemal,9996,0,9999,3
1714368368574,CLRE 260,A00,507221,Cuomo; Raphael Eduardo,9999,0,9999,0
1714368369600,CLRE 297,001,507242,Cuomo; Raphael Eduardo,9999,0,9999,0
1714368370625,COGS 197,001,638244,Voytek; Bradley Thomas,9999,0,9999,0
1714368371649,CSE 191,A00,516875,Minnes Kemp; Mor Mia,9993,0,9999,6
1714368372676,CSE 197,001,637388,Minnes Kemp; Mor Mia,9998,0,9999,1
1714368373701,CSS 201S,A01,494383,Staff,35,0,35,0
1714368374726,CSS 202S,A01,494387,Staff,35,0,35,0
1714368375753,DSC 197,001,628532,Eldridge; Justin Matthew,9996,0,9999,3
1714368376779,EAP 100,A00,516065,Staff,9797,0,9999,202
1714368377804,ECE 45,A01,507414,Staff,33,0,60,27
1714368379854,ECE 111,A01,507420,Staff,19,0,50,31
1714368380883,ECE 197,001,548057,Sievenpiper; Daniel F.,9994,0,9999,5
1714368381912,EDS 115,A00,507243,Choi; Bailey Miyeon,12,0,28,16
1714368382940,EDS 117,A01,494379,Staff,0,2,30,30
1714368383965,EDS 125,A00,507246,Hopkins; Megan Beth,12,0,30,18
1714368384990,EDS 128A,A01,507264,Fargason; Sharon Gayle,14,0,26,12
1714368386014,EDS 128B,A01,507293,Pappas; Elizabeth,18,0,30,12
1714368387038,EDS 139,A00,507294,Fargason; Sharon Gayle,18,0,30,12
1714368387038,EDS 139,B00,507313,Pappas; Elizabeth,15,0,30,15
1714368388066,EDS 201,A00,507315,Staff,13,0,30,17
1714368389092,EDS 203,A01,507317,Halter; Christopher P.,12,0,30,18
1714368390119,EDS 204R,A01,507319,Halter; Christopher P.,0,3,30,30
1714368390119,EDS 204R,B01,507331,Heinzman; Erica M.,17,0,30,13
1714368391143,EDS 206R,A00,507332,Staff,0,4,30,30
1714368391143,EDS 206R,B00,507343,Staff,18,0,30,12
1714368392168,EDS 250,A00,507344,Hemans; Patricia Ann Benitez,22,0,40,18
1714368393193,EDS 281,A00,507345,Daly; Alan J.,18,0,18,0
1714368394217,EDS 284,A00,507350,Daly; Alan J.,16,0,16,0
1714368395245,EDS 286,A00,507359,Fine; Sarah,18,0,18,0
1714368396271,EDS 289C,A01,507361,Daly; Alan J.,18,0,18,0
1714368397297,EDS 290,A00,507366,Hofstetter; Carolyn,15,0,15,0
1714368398321,LIGM 5A,A00,507421,Fischer-Grunski; Eva K,18,0,20,2
1714368399346,LIGM 5B,A00,507423,Fischer-Grunski; Eva K,19,0,20,1
1714368400372,LIGM 5C,A00,507425,Fischer-Grunski; Eva K,19,0,20,1
1714368401402,LIIT 5AS,A00,507427,Carnelos; Chiara,20,0,20,0
1714368402427,LIIT 5BS,A00,507430,Carnelos; Chiara,20,0,20,0
1714368403451,LIIT 5CS,A00,507432,Carnelos; Chiara,20,0,20,0
1714368404476,LISP 5A,A00,507541,Munoz Sanchez; Alicia,11,0,20,9
1714368405499,LISP 5B,A00,507671,Munoz Sanchez; Alicia,9,0,20,11
1714368406527,LISP 5C,A00,507696,Munoz Sanchez; Alicia,9,0,20,11
1714368407552,MAE 197,001,528363,Boechler; Nicholas Sebastia,9998,0,9999,1
1714368408581,MATH 197,001,523477,Kedlaya; Kiran S.,9996,0,9999,3
1714368408581,MATH 197,002,563811,Zhang; Danna,9995,0,9999,4
1714368408581,MATH 197,003,628552,Dumitriu; Ioana,9998,0,9999,1
1714368409609,MCWP 40R,A00,518780,Staff,5,0,20,15
1714368409609,MCWP 40R,B00,518781,Staff,7,0,20,13
1714368409609,MCWP 40R,C00,518783,Staff,5,0,20,15
1714368410635,MCWP 50R,A00,518791,Staff,0,0,20,20
1714368410635,MCWP 50R,B00,518792,Staff,0,1,20,20
1714368410635,MCWP 50R,C00,518793,Staff,0,1,20,20
1714368410635,MCWP 50R,D00,518794,Staff,0,0,20,20
1714368410635,MCWP 50R,E00,518795,Staff,0,1,20,20
1714368410635,MCWP 50R,F00,518796,Staff,0,0,20,20
1714368410635,MCWP 50R,G00,518797,Staff,0,1,20,20
1714368411661,MMW 12R,A01,514034,Herbst; Matthew,0,1,16,16
1714368411661,MMW 12R,A02,514035,Herbst; Matthew,2,0,16,14
1714368412686,MMW 13R,A01,514037,Staff,0,4,16,16
1714368412686,MMW 13R,A02,514039,Staff,0,2,16,16
1714368412686,MMW 13R,A03,628519,Staff,0,2,16,16
1714368414739,SIO 295LS,A00,523233,Staff,12,0,30,18
1714368415767,SIO 295S,A00,523232,Staff,12,0,30,18
1714368416792,SIOC 290S,A01,637330,Merrifield; Mark A,27,0,30,3
1714368417821,SIOC 291S,A01,637333,Gabriel; Corey John,27,0,30,3
1714368418846,SOCI 117,A01,494376,Staff,0,3,5,5
1714368419871,WES 237B,A00,494380,Staff,9,0,20,11
1714368421929,AESE 279B,A00,494370,Wade; Jon P,0,0,33,33
1714368422956,AIP 197,001,627712,Vespa; Emanuel Ignacio,9998,0,9999,1
1714368423981,ANAR 135S,A00,494369,Braswell; Geoffrey E.,0,0,0,0
1714368425009,BENG 196,001,628496,Engler; Adam J.,9998,0,9999,1
1714368426033,CAT 124RS,A01,519847,Geibel; William,0,0,20,20
1714368427058,CAT 125RS,A01,515971,Geibel; William,0,0,20,20
1714368428082,CLRE 250,A00,511389,Morris; Sheldon,9993,0,9999,6
1714368429113,CLRE 251,A00,507176,Mehta; Ravindra L.,9993,0,9999,6
1714368429113,CLRE 251,B00,511410,Mehta; Ravindra L.,9998,0,9999,1
1714368430142,CLRE 252,A00,507189,Cuomo; Raphael Eduardo,9995,0,9999,4
1714368431168,CLRE 253,A00,507199,Vaida; Florin,9994,0,9999,5
1714368431168,CLRE 253,B00,507202,Vaida; Florin,9999,0,9999,0
1714368432197,CLRE 259,A00,507211,Patel; Hemal,9996,0,9999,3
1714368433222,CLRE 260,A00,507221,Cuomo; Raphael Eduardo,9999,0,9999,0
1714368434249,CLRE 297,001,507242,Cuomo; Raphael Eduardo,9999,0,9999,0
1714368435346,COGS 197,001,638244,Voytek; Bradley Thomas,9999,0,9999,0
1714368436370,CSE 191,A00,516875,Minnes Kemp; Mor Mia,9993,0,9999,6
1714368437395,CSE 197,001,637388,Minnes Kemp; Mor Mia,9998,0,9999,1
1714368438421,CSS 201S,A01,494383,Staff,35,0,35,0
1714368439450,CSS 202S,A01,494387,Staff,35,0,35,0
1714368440475,DSC 197,001,628532,Eldridge; Justin Matthew,9996,0,9999,3
1714368441500,EAP 100,A00,516065,Staff,9797,0,9999,202
1714368442523,ECE 45,A01,507414,Staff,33,0,60,27
1714368444576,ECE 111,A01,507420,Staff,19,0,50,31
1714368445601,ECE 197,001,548057,Sievenpiper; Daniel F.,9994,0,9999,5
1714368446629,EDS 115,A00,507243,Choi; Bailey Miyeon,12,0,28,16
1714368447654,EDS 117,A01,494379,Staff,0,2,30,30
1714368448679,EDS 125,A00,507246,Hopkins; Megan Beth,12,0,30,18
1714368449707,EDS 128A,A01,507264,Fargason; Sharon Gayle,14,0,26,12
1714368450732,EDS 128B,A01,507293,Pappas; Elizabeth,18,0,30,12
1714368451760,EDS 139,A00,507294,Fargason; Sharon Gayle,18,0,30,12
1714368451760,EDS 139,B00,507313,Pappas; Elizabeth,15,0,30,15
1714368452785,EDS 201,A00,507315,Staff,13,0,30,17
1714368453811,EDS 203,A01,507317,Halter; Christopher P.,12,0,30,18
1714368454839,EDS 204R,A01,507319,Halter; Christopher P.,0,3,30,30
1714368454839,EDS 204R,B01,507331,Heinzman; Erica M.,17,0,30,13
1714368455867,EDS 206R,A00,507332,Staff,0,4,30,30
1714368455867,EDS 206R,B00,507343,Staff,18,0,30,12
1714368456895,EDS 250,A00,507344,Hemans; Patricia Ann Benitez,22,0,40,18
1714368457920,EDS 281,A00,507345,Daly; Alan J.,18,0,18,0
1714368458945,EDS 284,A00,507350,Daly; Alan J.,16,0,16,0
1714368459972,EDS 286,A00,507359,Fine; Sarah,18,0,18,0
1714368460997,EDS 289C,A01,507361,Daly; Alan J.,18,0,18,0
1714368462025,EDS 290,A00,507366,Hofstetter; Carolyn,15,0,15,0
1714368463054,LIGM 5A,A00,507421,Fischer-Grunski; Eva K,18,0,20,2
1714368464083,LIGM 5B,A00,507423,Fischer-Grunski; Eva K,19,0,20,1
1714368465111,LIGM 5C,A00,507425,Fischer-Grunski; Eva K,19,0,20,1
1714368466138,LIIT 5AS,A00,507427,Carnelos; Chiara,20,0,20,0
1714368467166,LIIT 5BS,A00,507430,Carnelos; Chiara,20,0,20,0
1714368468194,LIIT 5CS,A00,507432,Carnelos; Chiara,20,0,20,0
1714368469221,LISP 5A,A00,507541,Munoz Sanchez; Alicia,11,0,20,9
1714368470247,LISP 5B,A00,507671,Munoz Sanchez; Alicia,9,0,20,11
1714368471275,LISP 5C,A00,507696,Munoz Sanchez; Alicia,9,0,20,11
1714368472299,MAE 197,001,528363,Boechler; Nicholas Sebastia,9998,0,9999,1
1714368473324,MATH 197,001,523477,Kedlaya; Kiran S.,9996,0,9999,3
1714368473324,MATH 197,002,563811,Zhang; Danna,9995,0,9999,4
1714368473324,MATH 197,003,628552,Dumitriu; Ioana,9998,0,9999,1
1714368474351,MCWP 40R,A00,518780,Staff,5,0,20,15
1714368474351,MCWP 40R,B00,518781,Staff,7,0,20,13
1714368474351,MCWP 40R,C00,518783,Staff,5,0,20,15
1714368475379,MCWP 50R,A00,518791,Staff,0,0,20,20
1714368475379,MCWP 50R,B00,518792,Staff,0,1,20,20
1714368475379,MCWP 50R,C00,518793,Staff,0,1,20,20
1714368475379,MCWP 50R,D00,518794,Staff,0,0,20,20
1714368475379,MCWP 50R,E00,518795,Staff,0,1,20,20
1714368475379,MCWP 50R,F00,518796,Staff,0,0,20,20
1714368475379,MCWP 50R,G00,518797,Staff,0,1,20,20
1714368476406,MMW 12R,A01,514034,Herbst; Matthew,0,1,16,16
1714368476406,MMW 12R,A02,514035,Herbst; Matthew,2,0,16,14
1714368477433,MMW 13R,A01,514037,Staff,0,4,16,16
1714368477433,MMW 13R,A02,514039,Staff,0,2,16,16
1714368477433,MMW 13R,A03,628519,Staff,0,2,16,16
1714368479486,SIO 295LS,A00,523233,Staff,12,0,30,18
1714368480514,SIO 295S,A00,523232,Staff,12,0,30,18
1714368481540,SIOC 290S,A01,637330,Merrifield; Mark A,27,0,30,3
1714368482566,SIOC 291S,A01,637333,Gabriel; Corey John,27,0,30,3
1714368483595,SOCI 117,A01,494376,Staff,0,3,5,5
1714368484623,WES 237B,A00,494380,Staff,9,0,20,11
1714368486680,AESE 279B,A00,494370,Wade; Jon P,0,0,33,33
1714368487705,AIP 197,001,627712,Vespa; Emanuel Ignacio,9998,0,9999,1
1714368488731,ANAR 135S,A00,494369,Braswell; Geoffrey E.,0,0,0,0
1714368489760,BENG 196,001,628496,Engler; Adam J.,9998,0,9999,1
1714368490789,CAT 124RS,A01,519847,Geibel; William,0,0,20,20
1714368491814,CAT 125RS,A01,515971,Geibel; William,0,0,20,20
1714368492843,CLRE 250,A00,511389,Morris; Sheldon,9993,0,9999,6
1714368493869,CLRE 251,A00,507176,Mehta; Ravindra L.,9993,0,9999,6
1714368493869,CLRE 251,B00,511410,Mehta; Ravindra L.,9998,0,9999,1
1714368494894,CLRE 252,A00,507189,Cuomo; Raphael Eduardo,9995,0,9999,4
1714368495920,CLRE 253,A00,507199,Vaida; Florin,9994,0,9999,5
1714368495920,CLRE 253,B00,507202,Vaida; Florin,9999,0,9999,0
1714368496945,CLRE 259,A00,507211,Patel; Hemal,9996,0,9999,3
1714368497969,CLRE 260,A00,507221,Cuomo; Raphael Eduardo,9999,0,9999,0
1714368498996,CLRE 297,001,507242,Cuomo; Raphael Eduardo,9999,0,9999,0
1714368500021,COGS 197,001,638244,Voytek; Bradley Thomas,9999,0,9999,0
1714368501046,CSE 191,A00,516875,Minnes Kemp; Mor Mia,9993,0,9999,6
1714368502070,CSE 197,001,637388,Minnes Kemp; Mor Mia,9998,0,9999,1
1714368503094,CSS 201S,A01,494383,Staff,35,0,35,0
1714368504123,CSS 202S,A01,494387,Staff,35,0,35,0
1714368505147,DSC 197,001,628532,Eldridge; Justin Matthew,9996,0,9999,3
1714368506174,EAP 100,A00,516065,Staff,9797,0,9999,202
1714368507202,ECE 45,A01,507414,Staff,33,0,60,27
1714368509254,ECE 111,A01,507420,Staff,19,0,50,31
1714368510279,ECE 197,001,548057,Sievenpiper; Daniel F.,9994,0,9999,5
1714368511308,EDS 115,A00,507243,Choi; Bailey Miyeon,12,0,28,16
1714368512338,EDS 117,A01,494379,Staff,0,2,30,30
1714368513362,EDS 125,A00,507246,Hopkins; Megan Beth,12,0,30,18
1714368514391,EDS 128A,A01,507264,Fargason; Sharon Gayle,14,0,26,12
1714368515419,EDS 128B,A01,507293,Pappas; Elizabeth,18,0,30,12
1714368516445,EDS 139,A00,507294,Fargason; Sharon Gayle,18,0,30,12
1714368516445,EDS 139,B00,507313,Pappas; Elizabeth,15,0,30,15
1714368517471,EDS 201,A00,507315,Staff,13,0,30,17
1714368518499,EDS 203,A01,507317,Halter; Christopher P.,12,0,30,18
1714368519524,EDS 204R,A01,507319,Halter; Christopher P.,0,3,30,30
1714368519524,EDS 204R,B01,507331,Heinzman; Erica M.,17,0,30,13
1714368520549,EDS 206R,A00,507332,Staff,0,4,30,30
1714368520549,EDS 206R,B00,507343,Staff,18,0,30,12
1714368521574,EDS 250,A00,507344,Hemans; Patricia Ann Benitez,22,0,40,18
1714368522602,EDS 281,A00,507345,Daly; Alan J.,18,0,18,0
1714368523629,EDS 284,A00,507350,Daly; Alan J.,16,0,16,0
1714368524661,EDS 286,A00,507359,Fine; Sarah,18,0,18,0
1714368525687,EDS 289C,A01,507361,Daly; Alan J.,18,0,18,0
1714368526716,EDS 290,A00,507366,Hofstetter; Carolyn,15,0,15,0
1714368527754,LIGM 5A,A00,507421,Fischer-Grunski; Eva K,18,0,20,2
1714368528780,LIGM 5B,A00,507423,Fischer-Grunski; Eva K,19,0,20,1
1714368529807,LIGM 5C,A00,507425,Fischer-Grunski; Eva K,19,0,20,1
1714368530832,LIIT 5AS,A00,507427,Carnelos; Chiara,20,0,20,0
1714368531860,LIIT 5BS,A00,507430,Carnelos; Chiara,20,0,20,0
1714368532888,LIIT 5CS,A00,507432,Carnelos; Chiara,20,0,20,0
1714368533917,LISP 5A,A00,507541,Munoz Sanchez; Alicia,11,0,20,9
1714368534946,LISP 5B,A00,507671,Munoz Sanchez; Alicia,9,0,20,11
1714368535971,LISP 5C,A00,507696,Munoz Sanchez; Alicia,9,0,20,11
1714368536997,MAE 197,001,528363,Boechler; Nicholas Sebastia,9998,0,9999,1
1714368538027,MATH 197,001,523477,Kedlaya; Kiran S.,9996,0,9999,3
1714368538027,MATH 197,002,563811,Zhang; Danna,9995,0,9999,4
1714368538027,MATH 197,003,628552,Dumitriu; Ioana,9998,0,9999,1
1714368539110,MCWP 40R,A00,518780,Staff,5,0,20,15
1714368539110,MCWP 40R,B00,518781,Staff,7,0,20,13
1714368539110,MCWP 40R,C00,518783,Staff,5,0,20,15
1714368540136,MCWP 50R,A00,518791,Staff,0,0,20,20
1714368540136,MCWP 50R,B00,518792,Staff,0,1,20,20
1714368540136,MCWP 50R,C00,518793,Staff,0,1,20,20
1714368540136,MCWP 50R,D00,518794,Staff,0,0,20,20
1714368540136,MCWP 50R,E00,518795,Staff,0,1,20,20
1714368540136,MCWP 50R,F00,518796,Staff,0,0,20,20
1714368540136,MCWP 50R,G00,518797,Staff,0,1,20,20
1714368541163,MMW 12R,A01,514034,Herbst; Matthew,0,1,16,16
1714368541163,MMW 12R,A02,514035,Herbst; Matthew,2,0,16,14
1714368542188,MMW 13R,A01,514037,Staff,0,4,16,16
1714368542188,MMW 13R,A02,514039,Staff,0,2,16,16
1714368542188,MMW 13R,A03,628519,Staff,0,2,16,16
1714368544239,SIO 295LS,A00,523233,Staff,12,0,30,18
1714368545265,SIO 295S,A00,523232,Staff,12,0,30,18
1714368546290,SIOC 290S,A01,637330,Merrifield; Mark A,27,0,30,3
1714368547316,SIOC 291S,A01,637333,Gabriel; Corey John,27,0,30,3
1714368548342,SOCI 117,A01,494376,Staff,0,3,5,5
1714368549368,WES 237B,A00,494380,Staff,9,0,20,11
1714368551434,AESE 279B,A00,494370,Wade; Jon P,0,0,33,33
1714368552462,AIP 197,001,627712,Vespa; Emanuel Ignacio,9998,0,9999,1
1714368553488,ANAR 135S,A00,494369,Braswell; Geoffrey E.,0,0,0,0
1714368554515,BENG 196,001,628496,Engler; Adam J.,9998,0,9999,1
1714368555541,CAT 124RS,A01,519847,Geibel; William,0,0,20,20
1714368556564,CAT 125RS,A01,515971,Geibel; William,0,0,20,20
1714368557588,CLRE 250,A00,511389,Morris; Sheldon,9993,0,9999,6
1714368558616,CLRE 251,A00,507176,Mehta; Ravindra L.,9993,0,9999,6
1714368558616,CLRE 251,B00,511410,Mehta; Ravindra L.,9998,0,9999,1
1714368559641,CLRE 252,A00,507189,Cuomo; Raphael Eduardo,9995,0,9999,4
1714368560666,CLRE 253,A00,507199,Vaida; Florin,9994,0,9999,5
1714368560666,CLRE 253,B00,507202,Vaida; Florin,9999,0,9999,0
1714368561690,CLRE 259,A00,507211,Patel; Hemal,9996,0,9999,3
1714368562714,CLRE 260,A00,507221,Cuomo; Raphael Eduardo,9999,0,9999,0
1714368563739,CLRE 297,001,507242,Cuomo; Raphael Eduardo,9999,0,9999,0
1714368564766,COGS 197,001,638244,Voytek; Bradley Thomas,9999,0,9999,0
1714368565794,CSE 191,A00,516875,Minnes Kemp; Mor Mia,9993,0,9999,6
1714368566821,CSE 197,001,637388,Minnes Kemp; Mor Mia,9998,0,9999,1
1714368567851,CSS 201S,A01,494383,Staff,35,0,35,0
1714368568880,CSS 202S,A01,494387,Staff,35,0,35,0
1714368569905,DSC 197,001,628532,Eldridge; Justin Matthew,9996,0,9999,3
1714368570931,EAP 100,A00,516065,Staff,9797,0,9999,202
1714368571959,ECE 45,A01,507414,Staff,33,0,60,27
1714368574009,ECE 111,A01,507420,Staff,19,0,50,31
1714368575032,ECE 197,001,548057,Sievenpiper; Daniel F.,9994,0,9999,5
1714368576060,EDS 115,A00,507243,Choi; Bailey Miyeon,12,0,28,16
1714368577085,EDS 117,A01,494379,Staff,0,2,30,30
1714368578108,EDS 125,A00,507246,Hopkins; Megan Beth,12,0,30,18
1714368579134,EDS 128A,A01,507264,Fargason; Sharon Gayle,14,0,26,12
1714368580159,EDS 128B,A01,507293,Pappas; Elizabeth,18,0,30,12
1714368581188,EDS 139,A00,507294,Fargason; Sharon Gayle,18,0,30,12
1714368581188,EDS 139,B00,507313,Pappas; Elizabeth,15,0,30,15
1714368582212,EDS 201,A00,507315,Staff,13,0,30,17
1714368583236,EDS 203,A01,507317,Halter; Christopher P.,12,0,30,18
1714368584262,EDS 204R,A01,507319,Halter; Christopher P.,0,3,30,30
1714368584262,EDS 204R,B01,507331,Heinzman; Erica M.,17,0,30,13
1714368585287,EDS 206R,A00,507332,Staff,0,4,30,30
1714368585287,EDS 206R,B00,507343,Staff,18,0,30,12
1714368586312,EDS 250,A00,507344,Hemans; Patricia Ann Benitez,22,0,40,18
1714368587337,EDS 281,A00,507345,Daly; Alan J.,18,0,18,0
1714368588364,EDS 284,A00,507350,Daly; Alan J.,16,0,16,0
1714368589390,EDS 286,A00,507359,Fine; Sarah,18,0,18,0
1714368590415,EDS 289C,A01,507361,Daly; Alan J.,18,0,18,0
1714368591440,EDS 290,A00,507366,Hofstetter; Carolyn,15,0,15,0
1714368592471,LIGM 5A,A00,507421,Fischer-Grunski; Eva K,18,0,20,2
1714368593499,LIGM 5B,A00,507423,Fischer-Grunski; Eva K,19,0,20,1
1714368594527,LIGM 5C,A00,507425,Fischer-Grunski; Eva K,19,0,20,1
1714368595552,LIIT 5AS,A00,507427,Carnelos; Chiara,20,0,20,0
1714368596576,LIIT 5BS,A00,507430,Carnelos; Chiara,20,0,20,0
1714368597601,LIIT 5CS,A00,507432,Carnelos; Chiara,20,0,20,0
1714368598627,LISP 5A,A00,507541,Munoz Sanchez; Alicia,11,0,20,9
1714368599656,LISP 5B,A00,507671,Munoz Sanchez; Alicia,9,0,20,11
1714368600684,LISP 5C,A00,507696,Munoz Sanchez; Alicia,9,0,20,11
1714368601710,MAE 197,001,528363,Boechler; Nicholas Sebastia,9998,0,9999,1
1714368602746,MATH 197,001,523477,Kedlaya; Kiran S.,9996,0,9999,3
1714368602746,MATH 197,002,563811,Zhang; Danna,9995,0,9999,4
1714368602746,MATH 197,003,628552,Dumitriu; Ioana,9998,0,9999,1
1714368603772,MCWP 40R,A00,518780,Staff,5,0,20,15
1714368603772,MCWP 40R,B00,518781,Staff,7,0,20,13
1714368603772,MCWP 40R,C00,518783,Staff,5,0,20,15
1714368604797,MCWP 50R,A00,518791,Staff,0,0,20,20
1714368604797,MCWP 50R,B00,518792,Staff,0,1,20,20
1714368604797,MCWP 50R,C00,518793,Staff,0,1,20,20
1714368604797,MCWP 50R,D00,518794,Staff,0,0,20,20
1714368604797,MCWP 50R,E00,518795,Staff,0,1,20,20
1714368604797,MCWP 50R,F00,518796,Staff,0,0,20,20
1714368604797,MCWP 50R,G00,518797,Staff,0,1,20,20
1714368605825,MMW 12R,A01,514034,Herbst; Matthew,0,1,16,16
1714368605825,MMW 12R,A02,514035,Herbst; Matthew,2,0,16,14
1714368606849,MMW 13R,A01,514037,Staff,0,4,16,16
1714368606849,MMW 13R,A02,514039,Staff,0,2,16,16
1714368606849,MMW 13R,A03,628519,Staff,0,2,16,16
1714368608901,SIO 295LS,A00,523233,Staff,12,0,30,18
1714368609928,SIO 295S,A00,523232,Staff,12,0,30,18
1714368610953,SIOC 290S,A01,637330,Merrifield; Mark A,27,0,30,3
1714368611979,SIOC 291S,A01,637333,Gabriel; Corey John,27,0,30,3
1714368613004,SOCI 117,A01,494376,Staff,0,3,5,5
1714368614029,WES 237B,A00,494380,Staff,9,0,20,11
1714368616103,AESE 279B,A00,494370,Wade; Jon P,0,0,33,33
1714368617130,AIP 197,001,627712,Vespa; Emanuel Ignacio,9998,0,9999,1
1714368618156,ANAR 135S,A00,494369,Braswell; Geoffrey E.,0,0,0,0
1714368619182,BENG 196,001,628496,Engler; Adam J.,9998,0,9999,1
1714368620210,CAT 124RS,A01,519847,Geibel; William,0,0,20,20
1714368621236,CAT 125RS,A01,515971,Geibel; William,0,0,20,20
1714368622261,CLRE 250,A00,511389,Morris; Sheldon,9993,0,9999,6
1714368623287,CLRE 251,A00,507176,Mehta; Ravindra L.,9993,0,9999,6
1714368623287,CLRE 251,B00,511410,Mehta; Ravindra L.,9998,0,9999,1
1714368624311,CLRE 252,A00,507189,Cuomo; Raphael Eduardo,9995,0,9999,4
1714368625336,CLRE 253,A00,507199,Vaida; Florin,9994,0,9999,5
1714368625336,CLRE 253,B00,507202,Vaida; Florin,9999,0,9999,0
1714368626367,CLRE 259,A00,507211,Patel; Hemal,9996,0,9999,3
1714368627392,CLRE 260,A00,507221,Cuomo; Raphael Eduardo,9999,0,9999,0
1714368628420,CLRE 297,001,507242,Cuomo; Raphael Eduardo,9999,0,9999,0
1714368629447,COGS 197,001,638244,Voytek; Bradley Thomas,9999,0,9999,0
1714368630471,CSE 191,A00,516875,Minnes Kemp; Mor Mia,9993,0,9999,6
1714368631495,CSE 197,001,637388,Minnes Kemp; Mor Mia,9998,0,9999,1
1714368632522,CSS 201S,A01,494383,Staff,35,0,35,0
1714368633549,CSS 202S,A01,494387,Staff,35,0,35,0
1714368634578,DSC 197,001,628532,Eldridge; Justin Matthew,9996,0,9999,3
1714368635604,EAP 100,A00,516065,Staff,9797,0,9999,202
1714368636630,ECE 45,A01,507414,Staff,33,0,60,27
1714368638678,ECE 111,A01,507420,Staff,19,0,50,31
1714368639702,ECE 197,001,548057,Sievenpiper; Daniel F.,9994,0,9999,5
1714368640728,EDS 115,A00,507243,Choi; Bailey Miyeon,12,0,28,16
1714368641753,EDS 117,A01,494379,Staff,0,2,30,30
1714368642835,EDS 125,A00,507246,Hopkins; Megan Beth,12,0,30,18
1714368643874,EDS 128A,A01,507264,Fargason; Sharon Gayle,14,0,26,12
1714368644900,EDS 128B,A01,507293,Pappas; Elizabeth,18,0,30,12
1714368645925,EDS 139,A00,507294,Fargason; Sharon Gayle,18,0,30,12
1714368645925,EDS 139,B00,507313,Pappas; Elizabeth,15,0,30,15
1714368646950,EDS 201,A00,507315,Staff,13,0,30,17
1714368647976,EDS 203,A01,507317,Halter; Christopher P.,12,0,30,18
1714368649003,EDS 204R,A01,507319,Halter; Christopher P.,0,3,30,30
1714368649003,EDS 204R,B01,507331,Heinzman; Erica M.,17,0,30,13
1714368650028,EDS 206R,A00,507332,Staff,0,4,30,30
1714368650028,EDS 206R,B00,507343,Staff,18,0,30,12
1714368651054,EDS 250,A00,507344,Hemans; Patricia Ann Benitez,22,0,40,18
1714368652080,EDS 281,A00,507345,Daly; Alan J.,18,0,18,0
1714368653105,EDS 284,A00,507350,Daly; Alan J.,16,0,16,0
1714368654130,EDS 286,A00,507359,Fine; Sarah,18,0,18,0
1714368655156,EDS 289C,A01,507361,Daly; Alan J.,18,0,18,0
1714368656183,EDS 290,A00,507366,Hofstetter; Carolyn,15,0,15,0
1714368657211,LIGM 5A,A00,507421,Fischer-Grunski; Eva K,18,0,20,2
1714368658235,LIGM 5B,A00,507423,Fischer-Grunski; Eva K,19,0,20,1
1714368659260,LIGM 5C,A00,507425,Fischer-Grunski; Eva K,19,0,20,1
1714368660286,LIIT 5AS,A00,507427,Carnelos; Chiara,20,0,20,0
1714368661314,LIIT 5BS,A00,507430,Carnelos; Chiara,20,0,20,0
1714368662339,LIIT 5CS,A00,507432,Carnelos; Chiara,20,0,20,0
1714368663367,LISP 5A,A00,507541,Munoz Sanchez; Alicia,11,0,20,9
1714368664396,LISP 5B,A00,507671,Munoz Sanchez; Alicia,9,0,20,11
1714368665422,LISP 5C,A00,507696,Munoz Sanchez; Alicia,9,0,20,11
1714368666446,MAE 197,001,528363,Boechler; Nicholas Sebastia,9998,0,9999,1
1714368667477,MATH 197,001,523477,Kedlaya; Kiran S.,9996,0,9999,3
1714368667477,MATH 197,002,563811,Zhang; Danna,9995,0,9999,4
1714368667477,MATH 197,003,628552,Dumitriu; Ioana,9998,0,9999,1
1714368668502,MCWP 40R,A00,518780,Staff,5,0,20,15
1714368668502,MCWP 40R,B00,518781,Staff,7,0,20,13
1714368668502,MCWP 40R,C00,518783,Staff,5,0,20,15
1714368669529,MCWP 50R,A00,518791,Staff,0,0,20,20
1714368669529,MCWP 50R,B00,518792,Staff,0,1,20,20
1714368669529,MCWP 50R,C00,518793,Staff,0,1,20,20
1714368669529,MCWP 50R,D00,518794,Staff,0,0,20,20
1714368669529,MCWP 50R,E00,518795,Staff,0,1,20,20
1714368669529,MCWP 50R,F00,518796,Staff,0,0,20,20
1714368669529,MCWP 50R,G00,518797,Staff,0,1,20,20
1714368670558,MMW 12R,A01,514034,Herbst; Matthew,0,1,16,16
1714368670558,MMW 12R,A02,514035,Herbst; Matthew,2,0,16,14
1714368671590,MMW 13R,A01,514037,Staff,0,4,16,16
1714368671590,MMW 13R,A02,514039,Staff,0,2,16,16
1714368671590,MMW 13R,A03,628519,Staff,0,2,16,16
1714368673643,SIO 295LS,A00,523233,Staff,12,0,30,18
1714368674668,SIO 295S,A00,523232,Staff,12,0,30,18
1714368675697,SIOC 290S,A01,637330,Merrifield; Mark A,27,0,30,3
1714368676723,SIOC 291S,A01,637333,Gabriel; Corey John,27,0,30,3
1714368677748,SOCI 117,A01,494376,Staff,0,3,5,5
1714368678774,WES 237B,A00,494380,Staff,9,0,20,11
1714368680858,AESE 279B,A00,494370,Wade; Jon P,0,0,33,33
1714368681882,AIP 197,001,627712,Vespa; Emanuel Ignacio,9998,0,9999,1
1714368682908,ANAR 135S,A00,494369,Braswell; Geoffrey E.,0,0,0,0
1714368683934,BENG 196,001,628496,Engler; Adam J.,9998,0,9999,1
1714368684958,CAT 124RS,A01,519847,Geibel; William,0,0,20,20
1714368685982,CAT 125RS,A01,515971,Geibel; William,0,0,20,20
1714368687008,CLRE 250,A00,511389,Morris; Sheldon,9993,0,9999,6
1714368688033,CLRE 251,A00,507176,Mehta; Ravindra L.,9993,0,9999,6
1714368688033,CLRE 251,B00,511410,Mehta; Ravindra L.,9998,0,9999,1
1714368689061,CLRE 252,A00,507189,Cuomo; Raphael Eduardo,9995,0,9999,4
1714368690090,CLRE 253,A00,507199,Vaida; Florin,9994,0,9999,5
1714368690090,CLRE 253,B00,507202,Vaida; Florin,9999,0,9999,0
1714368691119,CLRE 259,A00,507211,Patel; Hemal,9996,0,9999,3
1714368692145,CLRE 260,A00,507221,Cuomo; Raphael Eduardo,9999,0,9999,0
1714368693173,CLRE 297,001,507242,Cuomo; Raphael Eduardo,9999,0,9999,0
1714368694198,COGS 197,001,638244,Voytek; Bradley Thomas,9999,0,9999,0
1714368695224,CSE 191,A00,516875,Minnes Kemp; Mor Mia,9993,0,9999,6
1714368696249,CSE 197,001,637388,Minnes Kemp; Mor Mia,9998,0,9999,1
1714368697274,CSS 201S,A01,494383,Staff,35,0,35,0
1714368698304,CSS 202S,A01,494387,Staff,35,0,35,0
1714368699330,DSC 197,001,628532,Eldridge; Justin Matthew,9996,0,9999,3
1714368700356,EAP 100,A00,516065,Staff,9797,0,9999,202
1714368701381,ECE 45,A01,507414,Staff,33,0,60,27
1714368703432,ECE 111,A01,507420,Staff,19,0,50,31
1714368704457,ECE 197,001,548057,Sievenpiper; Daniel F.,9994,0,9999,5
1714368705483,EDS 115,A00,507243,Choi; Bailey Miyeon,12,0,28,16
1714368706511,EDS 117,A01,494379,Staff,0,2,30,30
1714368707538,EDS 125,A00,507246,Hopkins; Megan Beth,12,0,30,18
1714368708563,EDS 128A,A01,507264,Fargason; Sharon Gayle,14,0,26,12
1714368709591,EDS 128B,A01,507293,Pappas; Elizabeth,18,0,30,12
1714368710616,EDS 139,A00,507294,Fargason; Sharon Gayle,18,0,30,12
1714368710616,EDS 139,B00,507313,Pappas; Elizabeth,15,0,30,15
1714368711642,EDS 201,A00,507315,Staff,13,0,30,17
1714368712671,EDS 203,A01,507317,Halter; Christopher P.,12,0,30,18
1714368713696,EDS 204R,A01,507319,Halter; Christopher P.,0,3,30,30
1714368713696,EDS 204R,B01,507331,Heinzman; Erica M.,17,0,30,13
1714368714721,EDS 206R,A00,507332,Staff,0,4,30,30
1714368714721,EDS 206R,B00,507343,Staff,18,0,30,12
1714368715745,EDS 250,A00,507344,Hemans; Patricia Ann Benitez,22,0,40,18
1714368716773,EDS 281,A00,507345,Daly; Alan J.,18,0,18,0
1714368717798,EDS 284,A00,507350,Daly; Alan J.,16,0,16,0
1714368718823,EDS 286,A00,507359,Fine; Sarah,18,0,18,0
1714368719852,EDS 289C,A01,507361,Daly; Alan J.,18,0,18,0
1714368720880,EDS 290,A00,507366,Hofstetter; Carolyn,15,0,15,0
1714368721906,LIGM 5A,A00,507421,Fischer-Grunski; Eva K,18,0,20,2
1714368722932,LIGM 5B,A00,507423,Fischer-Grunski; Eva K,19,0,20,1
1714368723960,LIGM 5C,A00,507425,Fischer-Grunski; Eva K,19,0,20,1
1714368724985,LIIT 5AS,A00,507427,Carnelos; Chiara,20,0,20,0
1714368726014,LIIT 5BS,A00,507430,Carnelos; Chiara,20,0,20,0
1714368727039,LIIT 5CS,A00,507432,Carnelos; Chiara,20,0,20,0
1714368728064,LISP 5A,A00,507541,Munoz Sanchez; Alicia,11,0,20,9
1714368729089,LISP 5B,A00,507671,Munoz Sanchez; Alicia,9,0,20,11
1714368730115,LISP 5C,A00,507696,Munoz Sanchez; Alicia,9,0,20,11
1714368731144,MAE 197,001,528363,Boechler; Nicholas Sebastia,9998,0,9999,1
1714368732173,MATH 197,001,523477,Kedlaya; Kiran S.,9996,0,9999,3
1714368732173,MATH 197,002,563811,Zhang; Danna,9995,0,9999,4
1714368732173,MATH 197,003,628552,Dumitriu; Ioana,9998,0,9999,1
1714368733199,MCWP 40R,A00,518780,Staff,5,0,20,15
1714368733199,MCWP 40R,B00,518781,Staff,7,0,20,13
1714368733199,MCWP 40R,C00,518783,Staff,5,0,20,15
1714368734228,MCWP 50R,A00,518791,Staff,0,0,20,20
1714368734228,MCWP 50R,B00,518792,Staff,0,1,20,20
1714368734228,MCWP 50R,C00,518793,Staff,0,1,20,20
1714368734228,MCWP 50R,D00,518794,Staff,0,0,20,20
1714368734228,MCWP 50R,E00,518795,Staff,0,1,20,20
1714368734228,MCWP 50R,F00,518796,Staff,0,0,20,20
1714368734228,MCWP 50R,G00,518797,Staff,0,1,20,20
1714368735253,MMW 12R,A01,514034,Herbst; Matthew,0,1,16,16
1714368735253,MMW 12R,A02,514035,Herbst; Matthew,2,0,16,14
1714368736277,MMW 13R,A01,514037,Staff,0,4,16,16
1714368736277,MMW 13R,A02,514039,Staff,0,2,16,16
1714368736277,MMW 13R,A03,628519,Staff,0,2,16,16
1714368738331,SIO 295LS,A00,523233,Staff,12,0,30,18
1714368739355,SIO 295S,A00,523232,Staff,12,0,30,18
1714368740381,SIOC 290S,A01,637330,Merrifield; Mark A,27,0,30,3
1714368741407,SIOC 291S,A01,637333,Gabriel; Corey John,27,0,30,3
1714368742434,SOCI 117,A01,494376,Staff,0,3,5,5
1714368743461,WES 237B,A00,494380,Staff,9,0,20,11
1714368745527,AESE 279B,A00,494370,Wade; Jon P,0,0,33,33
1714368746607,AIP 197,001,627712,Vespa; Emanuel Ignacio,9998,0,9999,1
1714368747633,ANAR 135S,A00,494369,Braswell; Geoffrey E.,0,0,0,0
1714368748658,BENG 196,001,628496,Engler; Adam J.,9998,0,9999,1
1714368749685,CAT 124RS,A01,519847,Geibel; William,0,0,20,20
1714368750711,CAT 125RS,A01,515971,Geibel; William,0,0,20,20
1714368751735,CLRE 250,A00,511389,Morris; Sheldon,9993,0,9999,6
1714368752760,CLRE 251,A00,507176,Mehta; Ravindra L.,9993,0,9999,6
1714368752760,CLRE 251,B00,511410,Mehta; Ravindra L.,9998,0,9999,1
1714368753789,CLRE 252,A00,507189,Cuomo; Raphael Eduardo,9995,0,9999,4
1714368754816,CLRE 253,A00,507199,Vaida; Florin,9994,0,9999,5
1714368754816,CLRE 253,B00,507202,Vaida; Florin,9999,0,9999,0
1714368755841,CLRE 259,A00,507211,Patel; Hemal,9996,0,9999,3
1714368756866,CLRE 260,A00,507221,Cuomo; Raphael Eduardo,9999,0,9999,0
1714368757894,CLRE 297,001,507242,Cuomo; Raphael Eduardo,9999,0,9999,0
1714368758921,COGS 197,001,638244,Voytek; Bradley Thomas,9999,0,9999,0
1714368759946,CSE 191,A00,516875,Minnes Kemp; Mor Mia,9993,0,9999,6
1714368760974,CSE 197,001,637388,Minnes Kemp; Mor Mia,9998,0,9999,1
1714368762000,CSS 201S,A01,494383,Staff,35,0,35,0
1714368763029,CSS 202S,A01,494387,Staff,35,0,35,0
1714368764057,DSC 197,001,628532,Eldridge; Justin Matthew,9996,0,9999,3
1714368765084,EAP 100,A00,516065,Staff,9797,0,9999,202
1714368766109,ECE 45,A01,507414,Staff,33,0,60,27
1714368768163,ECE 111,A01,507420,Staff,19,0,50,31
1714368769188,ECE 197,001,548057,Sievenpiper; Daniel F.,9994,0,9999,5
1714368770215,EDS 115,A00,507243,Choi; Bailey Miyeon,12,0,28,16
1714368771241,EDS 117,A01,494379,Staff,0,2,30,30
1714368772265,EDS 125,A00,507246,Hopkins; Megan Beth,12,0,30,18
1714368773290,EDS 128A,A01,507264,Fargason; Sharon Gayle,14,0,26,12
1714368774315,EDS 128B,A01,507293,Pappas; Elizabeth,18,0,30,12
1714368775343,EDS 139,A00,507294,Fargason; Sharon Gayle,18,0,30,12
1714368775343,EDS 139,B00,507313,Pappas; Elizabeth,15,0,30,15
1714368776368,EDS 201,A00,507315,Staff,13,0,30,17
1714368777391,EDS 203,A01,507317,Halter; Christopher P.,12,0,30,18
1714368778417,EDS 204R,A01,507319,Halter; Christopher P.,0,3,30,30
1714368778417,EDS 204R,B01,507331,Heinzman; Erica M.,17,0,30,13
1714368779442,EDS 206R,A00,507332,Staff,0,4,30,30
1714368779442,EDS 206R,B00,507343,Staff,18,0,30,12
1714368780467,EDS 250,A00,507344,Hemans; Patricia Ann Benitez,22,0,40,18
1714368781491,EDS 281,A00,507345,Daly; Alan J.,18,0,18,0
1714368782516,EDS 284,A00,507350,Daly; Alan J.,16,0,16,0
1714368783542,EDS 286,A00,507359,Fine; Sarah,18,0,18,0
1714368784571,EDS 289C,A01,507361,Daly; Alan J.,18,0,18,0
1714368785598,EDS 290,A00,507366,Hofstetter; Carolyn,15,0,15,0
1714368786626,LIGM 5A,A00,507421,Fischer-Grunski; Eva K,18,0,20,2
1714368787655,LIGM 5B,A00,507423,Fischer-Grunski; Eva K,19,0,20,1
1714368788684,LIGM 5C,A00,507425,Fischer-Grunski; Eva K,19,0,20,1
1714368789713,LIIT 5AS,A00,507427,Carnelos; Chiara,20,0,20,0
1714368790739,LIIT 5BS,A00,507430,Carnelos; Chiara,20,0,20,0
1714368791768,LIIT 5CS,A00,507432,Carnelos; Chiara,20,0,20,0
1714368792797,LISP 5A,A00,507541,Munoz Sanchez; Alicia,11,0,20,9
1714368793823,LISP 5B,A00,507671,Munoz Sanchez; Alicia,9,0,20,11
1714368794847,LISP 5C,A00,507696,Munoz Sanchez; Alicia,9,0,20,11
1714368795874,MAE 197,001,528363,Boechler; Nicholas Sebastia,9998,0,9999,1
1714368796900,MATH 197,001,523477,Kedlaya; Kiran S.,9996,0,9999,3
1714368796900,MATH 197,002,563811,Zhang; Danna,9995,0,9999,4
1714368796900,MATH 197,003,628552,Dumitriu; Ioana,9998,0,9999,1
1714368797926,MCWP 40R,A00,518780,Staff,5,0,20,15
1714368797926,MCWP 40R,B00,518781,Staff,7,0,20,13
1714368797926,MCWP 40R,C00,518783,Staff,5,0,20,15
1714368798951,MCWP 50R,A00,518791,Staff,0,0,20,20
1714368798951,MCWP 50R,B00,518792,Staff,0,1,20,20
1714368798951,MCWP 50R,C00,518793,Staff,0,1,20,20
1714368798951,MCWP 50R,D00,518794,Staff,0,0,20,20
1714368798951,MCWP 50R,E00,518795,Staff,0,1,20,20
1714368798951,MCWP 50R,F00,518796,Staff,0,0,20,20
1714368798951,MCWP 50R,G00,518797,Staff,0,1,20,20
1714368799976,MMW 12R,A01,514034,Herbst; Matthew,0,1,16,16
1714368799976,MMW 12R,A02,514035,Herbst; Matthew,2,0,16,14
1714368801003,MMW 13R,A01,514037,Staff,0,4,16,16
1714368801003,MMW 13R,A02,514039,Staff,0,2,16,16
1714368801003,MMW 13R,A03,628519,Staff,0,2,16,16
1714368803051,SIO 295LS,A00,523233,Staff,12,0,30,18
1714368804079,SIO 295S,A00,523232,Staff,12,0,30,18
1714368805105,SIOC 290S,A01,637330,Merrifield; Mark A,27,0,30,3
1714368806134,SIOC 291S,A01,637333,Gabriel; Corey John,27,0,30,3
1714368807158,SOCI 117,A01,494376,Staff,0,3,5,5
1714368808184,WES 237B,A00,494380,Staff,9,0,20,11
1714368810245,AESE 279B,A00,494370,Wade; Jon P,0,0,33,33
1714368811273,AIP 197,001,627712,Vespa; Emanuel Ignacio,9998,0,9999,1
1714368812299,ANAR 135S,A00,494369,Braswell; Geoffrey E.,0,0,0,0
1714368813324,BENG 196,001,628496,Engler; Adam J.,9998,0,9999,1
1714368814351,CAT 124RS,A01,519847,Geibel; William,0,0,20,20
1714368815379,CAT 125RS,A01,515971,Geibel; William,0,0,20,20
1714368816405,CLRE 250,A00,511389,Morris; Sheldon,9993,0,9999,6
1714368817434,CLRE 251,A00,507176,Mehta; Ravindra L.,9993,0,9999,6
1714368817434,CLRE 251,B00,511410,Mehta; Ravindra L.,9998,0,9999,1
1714368818458,CLRE 252,A00,507189,Cuomo; Raphael Eduardo,9995,0,9999,4
1714368819482,CLRE 253,A00,507199,Vaida; Florin,9994,0,9999,5
1714368819482,CLRE 253,B00,507202,Vaida; Florin,9999,0,9999,0
1714368820508,CLRE 259,A00,507211,Patel; Hemal,9996,0,9999,3
1714368821534,CLRE 260,A00,507221,Cuomo; Raphael Eduardo,9999,0,9999,0
1714368822562,CLRE 297,001,507242,Cuomo; Raphael Eduardo,9999,0,9999,0
1714368823586,COGS 197,001,638244,Voytek; Bradley Thomas,9999,0,9999,0
1714368824614,CSE 191,A00,516875,Minnes Kemp; Mor Mia,9993,0,9999,6
1714368825641,CSE 197,001,637388,Minnes Kemp; Mor Mia,9998,0,9999,1
1714368826668,CSS 201S,A01,494383,Staff,35,0,35,0
1714368827693,CSS 202S,A01,494387,Staff,35,0,35,0
1714368828718,DSC 197,001,628532,Eldridge; Justin Matthew,9996,0,9999,3
1714368829744,EAP 100,A00,516065,Staff,9797,0,9999,202
1714368830773,ECE 45,A01,507414,Staff,33,0,60,27
1714368832828,ECE 111,A01,507420,Staff,19,0,50,31
1714368833854,ECE 197,001,548057,Sievenpiper; Daniel F.,9994,0,9999,5
1714368834882,EDS 115,A00,507243,Choi; Bailey Miyeon,12,0,28,16
1714368835909,EDS 117,A01,494379,Staff,0,2,30,30
1714368836936,EDS 125,A00,507246,Hopkins; Megan Beth,12,0,30,18
1714368837962,EDS 128A,A01,507264,Fargason; Sharon Gayle,14,0,26,12
1714368838992,EDS 128B,A01,507293,Pappas; Elizabeth,18,0,30,12
1714368840020,EDS 139,A00,507294,Fargason; Sharon Gayle,18,0,30,12
1714368840020,EDS 139,B00,507313,Pappas; Elizabeth,15,0,30,15
1714368841046,EDS 201,A00,507315,Staff,13,0,30,17
1714368842075,EDS 203,A01,507317,Halter; Christopher P.,12,0,30,18
1714368843105,EDS 204R,A01,507319,Halter; Christopher P.,0,3,30,30
1714368843105,EDS 204R,B01,507331,Heinzman; Erica M.,17,0,30,13
1714368844133,EDS 206R,A00,507332,Staff,0,4,30,30
1714368844133,EDS 206R,B00,507343,Staff,18,0,30,12
1714368845159,EDS 250,A00,507344,Hemans; Patricia Ann Benitez,22,0,40,18
1714368846185,EDS 281,A00,507345,Daly; Alan J.,18,0,18,0
1714368847211,EDS 284,A00,507350,Daly; Alan J.,16,0,16,0
1714368848238,EDS 286,A00,507359,Fine; Sarah,18,0,18,0
1714368849265,EDS 289C,A01,507361,Daly; Alan J.,18,0,18,0
1714368850347,EDS 290,A00,507366,Hofstetter; Carolyn,15,0,15,0
1714368851370,LIGM 5A,A00,507421,Fischer-Grunski; Eva K,18,0,20,2
1714368852399,LIGM 5B,A00,507423,Fischer-Grunski; Eva K,19,0,20,1
1714368853424,LIGM 5C,A00,507425,Fischer-Grunski; Eva K,19,0,20,1
1714368854454,LIIT 5AS,A00,507427,Carnelos; Chiara,20,0,20,0
1714368855482,LIIT 5BS,A00,507430,Carnelos; Chiara,20,0,20,0
1714368856507,LIIT 5CS,A00,507432,Carnelos; Chiara,20,0,20,0
1714368857533,LISP 5A,A00,507541,Munoz Sanchez; Alicia,11,0,20,9
1714368858559,LISP 5B,A00,507671,Munoz Sanchez; Alicia,9,0,20,11
1714368859586,LISP 5C,A00,507696,Munoz Sanchez; Alicia,9,0,20,11
1714368860613,MAE 197,001,528363,Boechler; Nicholas Sebastia,9998,0,9999,1
1714368861640,MATH 197,001,523477,Kedlaya; Kiran S.,9996,0,9999,3
1714368861640,MATH 197,002,563811,Zhang; Danna,9995,0,9999,4
1714368861640,MATH 197,003,628552,Dumitriu; Ioana,9998,0,9999,1
1714368862666,MCWP 40R,A00,518780,Staff,5,0,20,15
1714368862666,MCWP 40R,B00,518781,Staff,7,0,20,13
1714368862666,MCWP 40R,C00,518783,Staff,5,0,20,15
1714368863691,MCWP 50R,A00,518791,Staff,0,0,20,20
1714368863691,MCWP 50R,B00,518792,Staff,0,1,20,20
1714368863691,MCWP 50R,C00,518793,Staff,0,1,20,20
1714368863691,MCWP 50R,D00,518794,Staff,0,0,20,20
1714368863691,MCWP 50R,E00,518795,Staff,0,1,20,20
1714368863691,MCWP 50R,F00,518796,Staff,0,0,20,20
1714368863691,MCWP 50R,G00,518797,Staff,0,1,20,20
1714368864719,MMW 12R,A01,514034,Herbst; Matthew,0,1,16,16
1714368864719,MMW 12R,A02,514035,Herbst; Matthew,2,0,16,14
1714368865747,MMW 13R,A01,514037,Staff,0,4,16,16
1714368865747,MMW 13R,A02,514039,Staff,0,2,16,16
1714368865747,MMW 13R,A03,628519,Staff,0,2,16,16
1714368867797,SIO 295LS,A00,523233,Staff,12,0,30,18
1714368868827,SIO 295S,A00,523232,Staff,12,0,30,18
1714368869854,SIOC 290S,A01,637330,Merrifield; Mark A,27,0,30,3
1714368870880,SIOC 291S,A01,637333,Gabriel; Corey John,27,0,30,3
1714368871905,SOCI 117,A01,494376,Staff,0,3,5,5
1714368872931,WES 237B,A00,494380,Staff,9,0,20,11
1714368874990,AESE 279B,A00,494370,Wade; Jon P,0,0,33,33
1714368876018,AIP 197,001,627712,Vespa; Emanuel Ignacio,9998,0,9999,1
1714368877042,ANAR 135S,A00,494369,Braswell; Geoffrey E.,0,0,0,0
1714368878066,BENG 196,001,628496,Engler; Adam J.,9998,0,9999,1
1714368879092,CAT 124RS,A01,519847,Geibel; William,0,0,20,20
1714368880123,CAT 125RS,A01,515971,Geibel; William,0,0,20,20
1714368881149,CLRE 250,A00,511389,Morris; Sheldon,9993,0,9999,6
1714368882176,CLRE 251,A00,507176,Mehta; Ravindra L.,9993,0,9999,6
1714368882176,CLRE 251,B00,511410,Mehta; Ravindra L.,9998,0,9999,1
1714368883205,CLRE 252,A00,507189,Cuomo; Raphael Eduardo,9995,0,9999,4
1714368884231,CLRE 253,A00,507199,Vaida; Florin,9994,0,9999,5
1714368884231,CLRE 253,B00,507202,Vaida; Florin,9999,0,9999,0
1714368885259,CLRE 259,A00,507211,Patel; Hemal,9996,0,9999,3
1714368886287,CLRE 260,A00,507221,Cuomo; Raphael Eduardo,9999,0,9999,0
1714368887313,CLRE 297,001,507242,Cuomo; Raphael Eduardo,9999,0,9999,0
1714368888340,COGS 197,001,638244,Voytek; Bradley Thomas,9999,0,9999,0
1714368889366,CSE 191,A00,516875,Minnes Kemp; Mor Mia,9993,0,9999,6
1714368890394,CSE 197,001,637388,Minnes Kemp; Mor Mia,9998,0,9999,1
1714368891422,CSS 201S,A01,494383,Staff,35,0,35,0
1714368892448,CSS 202S,A01,494387,Staff,35,0,35,0
1714368893472,DSC 197,001,628532,Eldridge; Justin Matthew,9996,0,9999,3
1714368894501,EAP 100,A00,516065,Staff,9797,0,9999,202
1714368895525,ECE 45,A01,507414,Staff,33,0,60,27
1714368897579,ECE 111,A01,507420,Staff,19,0,50,31
1714368898605,ECE 197,001,548057,Sievenpiper; Daniel F.,9994,0,9999,5
1714368899631,EDS 115,A00,507243,Choi; Bailey Miyeon,12,0,28,16
1714368900659,EDS 117,A01,494379,Staff,0,2,30,30
1714368901687,EDS 125,A00,507246,Hopkins; Megan Beth,12,0,30,18
1714368902711,EDS 128A,A01,507264,Fargason; Sharon Gayle,14,0,26,12
1714368903740,EDS 128B,A01,507293,Pappas; Elizabeth,18,0,30,12
1714368904765,EDS 139,A00,507294,Fargason; Sharon Gayle,18,0,30,12
1714368904765,EDS 139,B00,507313,Pappas; Elizabeth,15,0,30,15
1714368905791,EDS 201,A00,507315,Staff,13,0,30,17
1714368906817,EDS 203,A01,507317,Halter; Christopher P.,12,0,30,18
1714368907846,EDS 204R,A01,507319,Halter; Christopher P.,0,3,30,30
1714368907846,EDS 204R,B01,507331,Heinzman; Erica M.,17,0,30,13
1714368908871,EDS 206R,A00,507332,Staff,0,4,30,30
1714368908871,EDS 206R,B00,507343,Staff,18,0,30,12
1714368909896,EDS 250,A00,507344,Hemans; Patricia Ann Benitez,22,0,40,18
1714368910921,EDS 281,A00,507345,Daly; Alan J.,18,0,18,0
1714368911947,EDS 284,A00,507350,Daly; Alan J.,16,0,16,0
1714368912976,EDS 286,A00,507359,Fine; Sarah,18,0,18,0
1714368914004,EDS 289C,A01,507361,Daly; Alan J.,18,0,18,0
1714368915031,EDS 290,A00,507366,Hofstetter; Carolyn,15,0,15,0
1714368916062,LIGM 5A,A00,507421,Fischer-Grunski; Eva K,18,0,20,2
1714368917087,LIGM 5B,A00,507423,Fischer-Grunski; Eva K,19,0,20,1
1714368918116,LIGM 5C,A00,507425,Fischer-Grunski; Eva K,19,0,20,1
1714368919143,LIIT 5AS,A00,507427,Carnelos; Chiara,20,0,20,0
1714368920171,LIIT 5BS,A00,507430,Carnelos; Chiara,20,0,20,0
1714368921200,LIIT 5CS,A00,507432,Carnelos; Chiara,20,0,20,0
1714368922230,LISP 5A,A00,507541,Munoz Sanchez; Alicia,11,0,20,9
1714368923256,LISP 5B,A00,507671,Munoz Sanchez; Alicia,9,0,20,11
1714368924284,LISP 5C,A00,507696,Munoz Sanchez; Alicia,9,0,20,11
1714368925312,MAE 197,001,528363,Boechler; Nicholas Sebastia,9998,0,9999,1
1714368926338,MATH 197,001,523477,Kedlaya; Kiran S.,9996,0,9999,3
1714368926338,MATH 197,002,563811,Zhang; Danna,9995,0,9999,4
1714368926338,MATH 197,003,628552,Dumitriu; Ioana,9998,0,9999,1
1714368927364,MCWP 40R,A00,518780,Staff,5,0,20,15
1714368927364,MCWP 40R,B00,518781,Staff,7,0,20,13
1714368927364,MCWP 40R,C00,518783,Staff,5,0,20,15
1714368928394,MCWP 50R,A00,518791,Staff,0,0,20,20
1714368928394,MCWP 50R,B00,518792,Staff,0,1,20,20
1714368928394,MCWP 50R,C00,518793,Staff,0,1,20,20
1714368928394,MCWP 50R,D00,518794,Staff,0,0,20,20
1714368928394,MCWP 50R,E00,518795,Staff,0,1,20,20
1714368928394,MCWP 50R,F00,518796,Staff,0,0,20,20
1714368928394,MCWP 50R,G00,518797,Staff,0,1,20,20
1714368929423,MMW 12R,A01,514034,Herbst; Matthew,0,1,16,16
1714368929423,MMW 12R,A02,514035,Herbst; Matthew,2,0,16,14
1714368930448,MMW 13R,A01,514037,Staff,0,4,16,16
1714368930448,MMW 13R,A02,514039,Staff,0,2,16,16
1714368930448,MMW 13R,A03,628519,Staff,0,2,16,16
1714368932499,SIO 295LS,A00,523233,Staff,12,0,30,18
1714368933527,SIO 295S,A00,523232,Staff,12,0,30,18
1714368934552,SIOC 290S,A01,637330,Merrifield; Mark A,27,0,30,3
1714368935582,SIOC 291S,A01,637333,Gabriel; Corey John,27,0,30,3
1714368936610,SOCI 117,A01,494376,Staff,0,3,5,5
1714368937638,WES 237B,A00,494380,Staff,9,0,20,11
1714368939698,AESE 279B,A00,494370,Wade; Jon P,0,0,33,33
1714368940723,AIP 197,001,627712,Vespa; Emanuel Ignacio,9998,0,9999,1
1714368941748,ANAR 135S,A00,494369,Braswell; Geoffrey E.,0,0,0,0
1714368942771,BENG 196,001,628496,Engler; Adam J.,9998,0,9999,1
1714368943797,CAT 124RS,A01,519847,Geibel; William,0,0,20,20
1714368944823,CAT 125RS,A01,515971,Geibel; William,0,0,20,20
1714368945851,CLRE 250,A00,511389,Morris; Sheldon,9993,0,9999,6
1714368946881,CLRE 251,A00,507176,Mehta; Ravindra L.,9993,0,9999,6
1714368946881,CLRE 251,B00,511410,Mehta; Ravindra L.,9998,0,9999,1
1714368947908,CLRE 252,A00,507189,Cuomo; Raphael Eduardo,9995,0,9999,4
1714368948933,CLRE 253,A00,507199,Vaida; Florin,9994,0,9999,5
1714368948933,CLRE 253,B00,507202,Vaida; Florin,9999,0,9999,0
1714368949961,CLRE 259,A00,507211,Patel; Hemal,9996,0,9999,3
1714368950989,CLRE 260,A00,507221,Cuomo; Raphael Eduardo,9999,0,9999,0
1714368952016,CLRE 297,001,507242,Cuomo; Raphael Eduardo,9999,0,9999,0
1714368953040,COGS 197,001,638244,Voytek; Bradley Thomas,9999,0,9999,0
1714368954121,CSE 191,A00,516875,Minnes Kemp; Mor Mia,9993,0,9999,6
1714368955149,CSE 197,001,637388,Minnes Kemp; Mor Mia,9998,0,9999,1
1714368956174,CSS 201S,A01,494383,Staff,35,0,35,0
1714368957203,CSS 202S,A01,494387,Staff,35,0,35,0
1714368958227,DSC 197,001,628532,Eldridge; Justin Matthew,9996,0,9999,3
1714368959252,EAP 100,A00,516065,Staff,9797,0,9999,202
1714368960277,ECE 45,A01,507414,Staff,33,0,60,27
1714368962328,ECE 111,A01,507420,Staff,19,0,50,31
1714368963354,ECE 197,001,548057,Sievenpiper; Daniel F.,9994,0,9999,5
1714368964379,EDS 115,A00,507243,Choi; Bailey Miyeon,12,0,28,16
1714368965406,EDS 117,A01,494379,Staff,0,2,30,30
1714368966429,EDS 125,A00,507246,Hopkins; Megan Beth,12,0,30,18
1714368967456,EDS 128A,A01,507264,Fargason; Sharon Gayle,14,0,26,12
1714368968485,EDS 128B,A01,507293,Pappas; Elizabeth,18,0,30,12
1714368969510,EDS 139,A00,507294,Fargason; Sharon Gayle,18,0,30,12
1714368969510,EDS 139,B00,507313,Pappas; Elizabeth,15,0,30,15
1714368970537,EDS 201,A00,507315,Staff,13,0,30,17
1714368971561,EDS 203,A01,507317,Halter; Christopher P.,12,0,30,18
1714368972590,EDS 204R,A01,507319,Halter; Christopher P.,0,3,30,30
1714368972590,EDS 204R,B01,507331,Heinzman; Erica M.,17,0,30,13
1714368973613,EDS 206R,A00,507332,Staff,0,4,30,30
1714368973613,EDS 206R,B00,507343,Staff,18,0,30,12
1714368974643,EDS 250,A00,507344,Hemans; Patricia Ann Benitez,22,0,40,18
1714368975668,EDS 281,A00,507345,Daly; Alan J.,18,0,18,0
1714368976693,EDS 284,A00,507350,Daly; Alan J.,16,0,16,0
1714368977717,EDS 286,A00,507359,Fine; Sarah,18,0,18,0
1714368978743,EDS 289C,A01,507361,Daly; Alan J.,18,0,18,0
1714368979768,EDS 290,A00,507366,Hofstetter; Carolyn,15,0,15,0
1714368980797,LIGM 5A,A00,507421,Fischer-Grunski; Eva K,18,0,20,2
1714368981822,LIGM 5B,A00,507423,Fischer-Grunski; Eva K,19,0,20,1
1714368982848,LIGM 5C,A00,507425,Fischer-Grunski; Eva K,19,0,20,1
1714368983872,LIIT 5AS,A00,507427,Carnelos; Chiara,20,0,20,0
1714368984901,LIIT 5BS,A00,507430,Carnelos; Chiara,20,0,20,0
1714368985927,LIIT 5CS,A00,507432,Carnelos; Chiara,20,0,20,0
1714368986954,LISP 5A,A00,507541,Munoz Sanchez; Alicia,11,0,20,9
1714368987980,LISP 5B,A00,507671,Munoz Sanchez; Alicia,9,0,20,11
1714368989007,LISP 5C,A00,507696,Munoz Sanchez; Alicia,9,0,20,11
1714368990031,MAE 197,001,528363,Boechler; Nicholas Sebastia,9998,0,9999,1
1714368991057,MATH 197,001,523477,Kedlaya; Kiran S.,9996,0,9999,3
1714368991057,MATH 197,002,563811,Zhang; Danna,9995,0,9999,4
1714368991057,MATH 197,003,628552,Dumitriu; Ioana,9998,0,9999,1
1714368992083,MCWP 40R,A00,518780,Staff,5,0,20,15
1714368992083,MCWP 40R,B00,518781,Staff,7,0,20,13
1714368992083,MCWP 40R,C00,518783,Staff,5,0,20,15
1714368993109,MCWP 50R,A00,518791,Staff,0,0,20,20
1714368993109,MCWP 50R,B00,518792,Staff,0,1,20,20
1714368993109,MCWP 50R,C00,518793,Staff,0,1,20,20
1714368993109,MCWP 50R,D00,518794,Staff,0,0,20,20
1714368993109,MCWP 50R,E00,518795,Staff,0,1,20,20
1714368993109,MCWP 50R,F00,518796,Staff,0,0,20,20
1714368993109,MCWP 50R,G00,518797,Staff,0,1,20,20
1714368994133,MMW 12R,A01,514034,Herbst; Matthew,0,1,16,16
1714368994133,MMW 12R,A02,514035,Herbst; Matthew,2,0,16,14
1714368995161,MMW 13R,A01,514037,Staff,0,4,16,16
1714368995161,MMW 13R,A02,514039,Staff,0,2,16,16
1714368995161,MMW 13R,A03,628519,Staff,0,2,16,16
1714368997215,SIO 295LS,A00,523233,Staff,12,0,30,18
1714368998241,SIO 295S,A00,523232,Staff,12,0,30,18
1714368999270,SIOC 290S,A01,637330,Merrifield; Mark A,27,0,30,3
1714369000294,SIOC 291S,A01,637333,Gabriel; Corey John,27,0,30,3
1714369001319,SOCI 117,A01,494376,Staff,0,3,5,5
1714369002347,WES 237B,A00,494380,Staff,9,0,20,11
1714369004402,AESE 279B,A00,494370,Wade; Jon P,0,0,33,33
1714369005430,AIP 197,001,627712,Vespa; Emanuel Ignacio,9998,0,9999,1
1714369006455,ANAR 135S,A00,494369,Braswell; Geoffrey E.,0,0,0,0
1714369007480,BENG 196,001,628496,Engler; Adam J.,9998,0,9999,1
1714369008504,CAT 124RS,A01,519847,Geibel; William,0,0,20,20
1714369009528,CAT 125RS,A01,515971,Geibel; William,0,0,20,20
1714369010555,CLRE 250,A00,511389,Morris; Sheldon,9993,0,9999,6
1714369011580,CLRE 251,A00,507176,Mehta; Ravindra L.,9993,0,9999,6
1714369011580,CLRE 251,B00,511410,Mehta; Ravindra L.,9998,0,9999,1
1714369012604,CLRE 252,A00,507189,Cuomo; Raphael Eduardo,9995,0,9999,4
1714369013630,CLRE 253,A00,507199,Vaida; Florin,9994,0,9999,5
1714369013630,CLRE 253,B00,507202,Vaida; Florin,9999,0,9999,0
1714369014654,CLRE 259,A00,507211,Patel; Hemal,9996,0,9999,3
1714369015679,CLRE 260,A00,507221,Cuomo; Raphael Eduardo,9999,0,9999,0
1714369016703,CLRE 297,001,507242,Cuomo; Raphael Eduardo,9999,0,9999,0
1714369017728,COGS 197,001,638244,Voytek; Bradley Thomas,9999,0,9999,0
1714369018751,CSE 191,A00,516875,Minnes Kemp; Mor Mia,9993,0,9999,6
1714369019775,CSE 197,001,637388,Minnes Kemp; Mor Mia,9998,0,9999,1
1714369020800,CSS 201S,A01,494383,Staff,35,0,35,0
1714369021828,CSS 202S,A01,494387,Staff,35,0,35,0
1714369022852,DSC 197,001,628532,Eldridge; Justin Matthew,9996,0,9999,3
1714369023878,EAP 100,A00,516065,Staff,9797,0,9999,202
1714369024905,ECE 45,A01,507414,Staff,33,0,60,27
1714369026954,ECE 111,A01,507420,Staff,19,0,50,31
1714369027980,ECE 197,001,548057,Sievenpiper; Daniel F.,9994,0,9999,5
1714369029014,EDS 115,A00,507243,Choi; Bailey Miyeon,12,0,28,16
1714369030039,EDS 117,A01,494379,Staff,0,2,30,30
1714369031064,EDS 125,A00,507246,Hopkins; Megan Beth,12,0,30,18
1714369032090,EDS 128A,A01,507264,Fargason; Sharon Gayle,14,0,26,12
1714369033114,EDS 128B,A01,507293,Pappas; Elizabeth,18,0,30,12
1714369034141,EDS 139,A00,507294,Fargason; Sharon Gayle,18,0,30,12
1714369034141,EDS 139,B00,507313,Pappas; Elizabeth,15,0,30,15
1714369035169,EDS 201,A00,507315,Staff,13,0,30,17
1714369036198,EDS 203,A01,507317,Halter; Christopher P.,12,0,30,18
1714369037228,EDS 204R,A01,507319,Halter; Christopher P.,0,3,30,30
1714369037228,EDS 204R,B01,507331,Heinzman; Erica M.,17,0,30,13
1714369038254,EDS 206R,A00,507332,Staff,0,4,30,30
1714369038254,EDS 206R,B00,507343,Staff,18,0,30,12
1714369039279,EDS 250,A00,507344,Hemans; Patricia Ann Benitez,22,0,40,18
1714369040306,EDS 281,A00,507345,Daly; Alan J.,18,0,18,0
1714369041330,EDS 284,A00,507350,Daly; Alan J.,16,0,16,0
1714369042355,EDS 286,A00,507359,Fine; Sarah,18,0,18,0
1714369043381,EDS 289C,A01,507361,Daly; Alan J.,18,0,18,0
1714369044406,EDS 290,A00,507366,Hofstetter; Carolyn,15,0,15,0
1714369045432,LIGM 5A,A00,507421,Fischer-Grunski; Eva K,18,0,20,2
1714369046457,LIGM 5B,A00,507423,Fischer-Grunski; Eva K,19,0,20,1
1714369047485,LIGM 5C,A00,507425,Fischer-Grunski; Eva K,19,0,20,1
1714369048512,LIIT 5AS,A00,507427,Carnelos; Chiara,20,0,20,0
1714369049538,LIIT 5BS,A00,507430,Carnelos; Chiara,20,0,20,0
1714369050567,LIIT 5CS,A00,507432,Carnelos; Chiara,20,0,20,0
1714369051597,LISP 5A,A00,507541,Munoz Sanchez; Alicia,11,0,20,9
1714369052621,LISP 5B,A00,507671,Munoz Sanchez; Alicia,9,0,20,11
1714369053647,LISP 5C,A00,507696,Munoz Sanchez; Alicia,9,0,20,11
1714369054671,MAE 197,001,528363,Boechler; Nicholas Sebastia,9998,0,9999,1
1714369055698,MATH 197,001,523477,Kedlaya; Kiran S.,9996,0,9999,3
1714369055698,MATH 197,002,563811,Zhang; Danna,9995,0,9999,4
1714369055698,MATH 197,003,628552,Dumitriu; Ioana,9998,0,9999,1
1714369056723,MCWP 40R,A00,518780,Staff,5,0,20,15
1714369056723,MCWP 40R,B00,518781,Staff,7,0,20,13
1714369056723,MCWP 40R,C00,518783,Staff,5,0,20,15
1714369057820,MCWP 50R,A00,518791,Staff,0,0,20,20
1714369057820,MCWP 50R,B00,518792,Staff,0,1,20,20
1714369057820,MCWP 50R,C00,518793,Staff,0,1,20,20
1714369057820,MCWP 50R,D00,518794,Staff,0,0,20,20
1714369057820,MCWP 50R,E00,518795,Staff,0,1,20,20
1714369057820,MCWP 50R,F00,518796,Staff,0,0,20,20
1714369057820,MCWP 50R,G00,518797,Staff,0,1,20,20
1714369058849,MMW 12R,A01,514034,Herbst; Matthew,0,1,16,16
1714369058849,MMW 12R,A02,514035,Herbst; Matthew,2,0,16,14
1714369059875,MMW 13R,A01,514037,Staff,0,4,16,16
1714369059875,MMW 13R,A02,514039,Staff,0,2,16,16
1714369059875,MMW 13R,A03,628519,Staff,0,2,16,16
1714369061927,SIO 295LS,A00,523233,Staff,12,0,30,18
1714369062951,SIO 295S,A00,523232,Staff,12,0,30,18
1714369063977,SIOC 290S,A01,637330,Merrifield; Mark A,27,0,30,3
1714369065004,SIOC 291S,A01,637333,Gabriel; Corey John,27,0,30,3
1714369066030,SOCI 117,A01,494376,Staff,0,3,5,5
1714369067053,WES 237B,A00,494380,Staff,9,0,20,11
1714369069110,AESE 279B,A00,494370,Wade; Jon P,0,0,33,33
1714369070135,AIP 197,001,627712,Vespa; Emanuel Ignacio,9998,0,9999,1
1714369071159,ANAR 135S,A00,494369,Braswell; Geoffrey E.,0,0,0,0
1714369072183,BENG 196,001,628496,Engler; Adam J.,9998,0,9999,1
1714369073208,CAT 124RS,A01,519847,Geibel; William,0,0,20,20
1714369074233,CAT 125RS,A01,515971,Geibel; William,0,0,20,20
1714369075261,CLRE 250,A00,511389,Morris; Sheldon,9993,0,9999,6
1714369076287,CLRE 251,A00,507176,Mehta; Ravindra L.,9993,0,9999,6
1714369076287,CLRE 251,B00,511410,Mehta; Ravindra L.,9998,0,9999,1
1714369077312,CLRE 252,A00,507189,Cuomo; Raphael Eduardo,9995,0,9999,4
1714369078335,CLRE 253,A00,507199,Vaida; Florin,9994,0,9999,5
1714369078335,CLRE 253,B00,507202,Vaida; Florin,9999,0,9999,0
1714369079362,CLRE 259,A00,507211,Patel; Hemal,9996,0,9999,3
1714369080390,CLRE 260,A00,507221,Cuomo; Raphael Eduardo,9999,0,9999,0
1714369081414,CLRE 297,001,507242,Cuomo; Raphael Eduardo,9999,0,9999,0
1714369082440,COGS 197,001,638244,Voytek; Bradley Thomas,9999,0,9999,0
1714369083464,CSE 191,A00,516875,Minnes Kemp; Mor Mia,9993,0,9999,6
1714369084490,CSE 197,001,637388,Minnes Kemp; Mor Mia,9998,0,9999,1
1714369085520,CSS 201S,A01,494383,Staff,35,0,35,0
1714369086546,CSS 202S,A01,494387,Staff,35,0,35,0
1714369087572,DSC 197,001,628532,Eldridge; Justin Matthew,9996,0,9999,3
1714369088599,EAP 100,A00,516065,Staff,9797,0,9999,202
1714369089624,ECE 45,A01,507414,Staff,33,0,60,27
1714369091671,ECE 111,A01,507420,Staff,19,0,50,31
1714369092695,ECE 197,001,548057,Sievenpiper; Daniel F.,9994,0,9999,5
1714369093723,EDS 115,A00,507243,Choi; Bailey Miyeon,12,0,28,16
1714369094752,EDS 117,A01,494379,Staff,0,2,30,30
1714369095778,EDS 125,A00,507246,Hopkins; Megan Beth,12,0,30,18
1714369096804,EDS 128A,A01,507264,Fargason; Sharon Gayle,14,0,26,12
1714369097831,EDS 128B,A01,507293,Pappas; Elizabeth,18,0,30,12
1714369098855,EDS 139,A00,507294,Fargason; Sharon Gayle,18,0,30,12
1714369098855,EDS 139,B00,507313,Pappas; Elizabeth,15,0,30,15
1714369099883,EDS 201,A00,507315,Staff,13,0,30,17
1714369100910,EDS 203,A01,507317,Halter; Christopher P.,12,0,30,18
1714369101934,EDS 204R,A01,507319,Halter; Christopher P.,0,3,30,30
1714369101934,EDS 204R,B01,507331,Heinzman; Erica M.,17,0,30,13
1714369102958,EDS 206R,A00,507332,Staff,0,4,30,30
1714369102958,EDS 206R,B00,507343,Staff,18,0,30,12
1714369103987,EDS 250,A00,507344,Hemans; Patricia Ann Benitez,22,0,40,18
1714369105012,EDS 281,A00,507345,Daly; Alan J.,18,0,18,0
1714369106036,EDS 284,A00,507350,Daly; Alan J.,16,0,16,0
1714369107061,EDS 286,A00,507359,Fine; Sarah,18,0,18,0
1714369108089,EDS 289C,A01,507361,Daly; Alan J.,18,0,18,0
1714369109117,EDS 290,A00,507366,Hofstetter; Carolyn,15,0,15,0
1714369110142,LIGM 5A,A00,507421,Fischer-Grunski; Eva K,18,0,20,2
1714369111229,LIGM 5B,A00,507423,Fischer-Grunski; Eva K,19,0,20,1
1714369112259,LIGM 5C,A00,507425,Fischer-Grunski; Eva K,19,0,20,1
1714369113285,LIIT 5AS,A00,507427,Carnelos; Chiara,20,0,20,0
1714369114311,LIIT 5BS,A00,507430,Carnelos; Chiara,20,0,20,0
1714369115337,LIIT 5CS,A00,507432,Carnelos; Chiara,20,0,20,0
1714369116365,LISP 5A,A00,507541,Munoz Sanchez; Alicia,11,0,20,9
1714369117389,LISP 5B,A00,507671,Munoz Sanchez; Alicia,9,0,20,11
1714369118414,LISP 5C,A00,507696,Munoz Sanchez; Alicia,9,0,20,11
1714369119439,MAE 197,001,528363,Boechler; Nicholas Sebastia,9998,0,9999,1
1714369120463,MATH 197,001,523477,Kedlaya; Kiran S.,9996,0,9999,3
1714369120463,MATH 197,002,563811,Zhang; Danna,9995,0,9999,4
1714369120463,MATH 197,003,628552,Dumitriu; Ioana,9998,0,9999,1
1714369121492,MCWP 40R,A00,518780,Staff,5,0,20,15
1714369121492,MCWP 40R,B00,518781,Staff,7,0,20,13
1714369121492,MCWP 40R,C00,518783,Staff,5,0,20,15
1714369122521,MCWP 50R,A00,518791,Staff,0,0,20,20
1714369122521,MCWP 50R,B00,518792,Staff,0,1,20,20
1714369122521,MCWP 50R,C00,518793,Staff,0,1,20,20
1714369122521,MCWP 50R,D00,518794,Staff,0,0,20,20
1714369122521,MCWP 50R,E00,518795,Staff,0,1,20,20
1714369122521,MCWP 50R,F00,518796,Staff,0,0,20,20
1714369122521,MCWP 50R,G00,518797,Staff,0,1,20,20
1714369123549,MMW 12R,A01,514034,Herbst; Matthew,0,1,16,16
1714369123549,MMW 12R,A02,514035,Herbst; Matthew,2,0,16,14
1714369124573,MMW 13R,A01,514037,Staff,0,4,16,16
1714369124573,MMW 13R,A02,514039,Staff,0,2,16,16
1714369124573,MMW 13R,A03,628519,Staff,0,2,16,16
1714369126629,SIO 295LS,A00,523233,Staff,12,0,30,18
1714369127655,SIO 295S,A00,523232,Staff,12,0,30,18
1714369128681,SIOC 290S,A01,637330,Merrifield; Mark A,27,0,30,3
1714369129705,SIOC 291S,A01,637333,Gabriel; Corey John,27,0,30,3
1714369130732,SOCI 117,A01,494376,Staff,0,3,5,5
1714369131774,WES 237B,A00,494380,Staff,9,0,20,11
1714369133838,AESE 279B,A00,494370,Wade; Jon P,0,0,33,33
1714369134861,AIP 197,001,627712,Vespa; Emanuel Ignacio,9998,0,9999,1
1714369135885,ANAR 135S,A00,494369,Braswell; Geoffrey E.,0,0,0,0
1714369136911,BENG 196,001,628496,Engler; Adam J.,9998,0,9999,1
1714369137938,CAT 124RS,A01,519847,Geibel; William,0,0,20,20
1714369138966,CAT 125RS,A01,515971,Geibel; William,0,0,20,20
1714369139994,CLRE 250,A00,511389,Morris; Sheldon,9993,0,9999,6
1714369141023,CLRE 251,A00,507176,Mehta; Ravindra L.,9993,0,9999,6
1714369141023,CLRE 251,B00,511410,Mehta; Ravindra L.,9998,0,9999,1
1714369142047,CLRE 252,A00,507189,Cuomo; Raphael Eduardo,9995,0,9999,4
1714369143080,CLRE 253,A00,507199,Vaida; Florin,9994,0,9999,5
1714369143080,CLRE 253,B00,507202,Vaida; Florin,9999,0,9999,0
1714369144104,CLRE 259,A00,507211,Patel; Hemal,9996,0,9999,3
1714369145128,CLRE 260,A00,507221,Cuomo; Raphael Eduardo,9999,0,9999,0
1714369146154,CLRE 297,001,507242,Cuomo; Raphael Eduardo,9999,0,9999,0
1714369147178,COGS 197,001,638244,Voytek; Bradley Thomas,9999,0,9999,0
1714369148204,CSE 191,A00,516875,Minnes Kemp; Mor Mia,9993,0,9999,6
1714369149230,CSE 197,001,637388,Minnes Kemp; Mor Mia,9998,0,9999,1
1714369150259,CSS 201S,A01,494383,Staff,35,0,35,0
1714369151289,CSS 202S,A01,494387,Staff,35,0,35,0
1714369152317,DSC 197,001,628532,Eldridge; Justin Matthew,9996,0,9999,3
1714369153341,EAP 100,A00,516065,Staff,9797,0,9999,202
1714369154368,ECE 45,A01,507414,Staff,33,0,60,27
1714369156421,ECE 111,A01,507420,Staff,19,0,50,31
1714369157448,ECE 197,001,548057,Sievenpiper; Daniel F.,9994,0,9999,5
1714369158476,EDS 115,A00,507243,Choi; Bailey Miyeon,12,0,28,16
1714369159528,EDS 117,A01,494379,Staff,0,2,30,30
1714369160555,EDS 125,A00,507246,Hopkins; Megan Beth,12,0,30,18
1714369161635,EDS 128A,A01,507264,Fargason; Sharon Gayle,14,0,26,12
1714369162662,EDS 128B,A01,507293,Pappas; Elizabeth,18,0,30,12
1714369163690,EDS 139,A00,507294,Fargason; Sharon Gayle,18,0,30,12
1714369163690,EDS 139,B00,507313,Pappas; Elizabeth,15,0,30,15
1714369164715,EDS 201,A00,507315,Staff,13,0,30,17
1714369165745,EDS 203,A01,507317,Halter; Christopher P.,12,0,30,18
1714369166774,EDS 204R,A01,507319,Halter; Christopher P.,0,3,30,30
1714369166774,EDS 204R,B01,507331,Heinzman; Erica M.,17,0,30,13
1714369167802,EDS 206R,A00,507332,Staff,0,4,30,30
1714369167802,EDS 206R,B00,507343,Staff,18,0,30,12
1714369168828,EDS 250,A00,507344,Hemans; Patricia Ann Benitez,22,0,40,18
1714369169853,EDS 281,A00,507345,Daly; Alan J.,18,0,18,0
1714369170876,EDS 284,A00,507350,Daly; Alan J.,16,0,16,0
1714369171905,EDS 286,A00,507359,Fine; Sarah,18,0,18,0
1714369172932,EDS 289C,A01,507361,Daly; Alan J.,18,0,18,0
1714369173960,EDS 290,A00,507366,Hofstetter; Carolyn,15,0,15,0
1714369174990,LIGM 5A,A00,507421,Fischer-Grunski; Eva K,18,0,20,2
1714369176020,LIGM 5B,A00,507423,Fischer-Grunski; Eva K,19,0,20,1
1714369177049,LIGM 5C,A00,507425,Fischer-Grunski; Eva K,19,0,20,1
1714369178078,LIIT 5AS,A00,507427,Carnelos; Chiara,20,0,20,0
1714369179106,LIIT 5BS,A00,507430,Carnelos; Chiara,20,0,20,0
1714369180135,LIIT 5CS,A00,507432,Carnelos; Chiara,20,0,20,0
1714369181160,LISP 5A,A00,507541,Munoz Sanchez; Alicia,11,0,20,9
1714369182189,LISP 5B,A00,507671,Munoz Sanchez; Alicia,9,0,20,11
1714369183219,LISP 5C,A00,507696,Munoz Sanchez; Alicia,9,0,20,11
1714369184245,MAE 197,001,528363,Boechler; Nicholas Sebastia,9998,0,9999,1
1714369185271,MATH 197,001,523477,Kedlaya; Kiran S.,9996,0,9999,3
1714369185271,MATH 197,002,563811,Zhang; Danna,9995,0,9999,4
1714369185271,MATH 197,003,628552,Dumitriu; Ioana,9998,0,9999,1
1714369186295,MCWP 40R,A00,518780,Staff,5,0,20,15
1714369186295,MCWP 40R,B00,518781,Staff,7,0,20,13
1714369186295,MCWP 40R,C00,518783,Staff,5,0,20,15
1714369187323,MCWP 50R,A00,518791,Staff,0,0,20,20
1714369187323,MCWP 50R,B00,518792,Staff,0,1,20,20
1714369187323,MCWP 50R,C00,518793,Staff,0,1,20,20
1714369187323,MCWP 50R,D00,518794,Staff,0,0,20,20
1714369187323,MCWP 50R,E00,518795,Staff,0,1,20,20
1714369187323,MCWP 50R,F00,518796,Staff,0,0,20,20
1714369187323,MCWP 50R,G00,518797,Staff,0,1,20,20
1714369188347,MMW 12R,A01,514034,Herbst; Matthew,0,1,16,16
1714369188347,MMW 12R,A02,514035,Herbst; Matthew,2,0,16,14
1714369189374,MMW 13R,A01,514037,Staff,0,4,16,16
1714369189374,MMW 13R,A02,514039,Staff,0,2,16,16
1714369189374,MMW 13R,A03,628519,Staff,0,2,16,16
1714369191426,SIO 295LS,A00,523233,Staff,12,0,30,18
1714369192452,SIO 295S,A00,523232,Staff,12,0,30,18
1714369193481,SIOC 290S,A01,637330,Merrifield; Mark A,27,0,30,3
1714369194510,SIOC 291S,A01,637333,Gabriel; Corey John,27,0,30,3
1714369195536,SOCI 117,A01,494376,Staff,0,3,5,5
1714369196562,WES 237B,A00,494380,Staff,9,0,20,11
1714369198619,AESE 279B,A00,494370,Wade; Jon P,0,0,33,33
1714369199644,AIP 197,001,627712,Vespa; Emanuel Ignacio,9998,0,9999,1
1714369200670,ANAR 135S,A00,494369,Braswell; Geoffrey E.,0,0,0,0
1714369201696,BENG 196,001,628496,Engler; Adam J.,9998,0,9999,1
1714369202725,CAT 124RS,A01,519847,Geibel; William,0,0,20,20
1714369203749,CAT 125RS,A01,515971,Geibel; William,0,0,20,20
1714369204778,CLRE 250,A00,511389,Morris; Sheldon,9993,0,9999,6
1714369205803,CLRE 251,A00,507176,Mehta; Ravindra L.,9993,0,9999,6
1714369205803,CLRE 251,B00,511410,Mehta; Ravindra L.,9998,0,9999,1
1714369206832,CLRE 252,A00,507189,Cuomo; Raphael Eduardo,9995,0,9999,4
1714369207858,CLRE 253,A00,507199,Vaida; Florin,9994,0,9999,5
1714369207858,CLRE 253,B00,507202,Vaida; Florin,9999,0,9999,0
1714369208883,CLRE 259,A00,507211,Patel; Hemal,9996,0,9999,3
1714369209911,CLRE 260,A00,507221,Cuomo; Raphael Eduardo,9999,0,9999,0
1714369210939,CLRE 297,001,507242,Cuomo; Raphael Eduardo,9999,0,9999,0
1714369211964,COGS 197,001,638244,Voytek; Bradley Thomas,9999,0,9999,0
1714369212988,CSE 191,A00,516875,Minnes Kemp; Mor Mia,9993,0,9999,6
1714369214017,CSE 197,001,637388,Minnes Kemp; Mor Mia,9998,0,9999,1
1714369215042,CSS 201S,A01,494383,Staff,35,0,35,0
1714369216068,CSS 202S,A01,494387,Staff,35,0,35,0
1714369217094,DSC 197,001,628532,Eldridge; Justin Matthew,9996,0,9999,3
1714369218119,EAP 100,A00,516065,Staff,9797,0,9999,202
1714369219145,ECE 45,A01,507414,Staff,33,0,60,27
1714369221197,ECE 111,A01,507420,Staff,19,0,50,31
1714369222224,ECE 197,001,548057,Sievenpiper; Daniel F.,9994,0,9999,5
1714369223254,EDS 115,A00,507243,Choi; Bailey Miyeon,12,0,28,16
1714369224280,EDS 117,A01,494379,Staff,0,2,30,30
1714369225306,EDS 125,A00,507246,Hopkins; Megan Beth,12,0,30,18
1714369226331,EDS 128A,A01,507264,Fargason; Sharon Gayle,14,0,26,12
1714369227361,EDS 128B,A01,507293,Pappas; Elizabeth,18,0,30,12
1714369228389,EDS 139,A00,507294,Fargason; Sharon Gayle,18,0,30,12
1714369228389,EDS 139,B00,507313,Pappas; Elizabeth,15,0,30,15
1714369229414,EDS 201,A00,507315,Staff,13,0,30,17
1714369230444,EDS 203,A01,507317,Halter; Christopher P.,12,0,30,18
1714369231469,EDS 204R,A01,507319,Halter; Christopher P.,0,3,30,30
1714369231469,EDS 204R,B01,507331,Heinzman; Erica M.,17,0,30,13
1714369232497,EDS 206R,A00,507332,Staff,0,4,30,30
1714369232497,EDS 206R,B00,507343,Staff,18,0,30,12
1714369233522,EDS 250,A00,507344,Hemans; Patricia Ann Benitez,22,0,40,18
1714369234549,EDS 281,A00,507345,Daly; Alan J.,18,0,18,0
1714369235574,EDS 284,A00,507350,Daly; Alan J.,16,0,16,0
1714369236598,EDS 286,A00,507359,Fine; Sarah,18,0,18,0
1714369237621,EDS 289C,A01,507361,Daly; Alan J.,18,0,18,0
1714369238650,EDS 290,A00,507366,Hofstetter; Carolyn,15,0,15,0
1714369239676,LIGM 5A,A00,507421,Fischer-Grunski; Eva K,18,0,20,2
1714369240701,LIGM 5B,A00,507423,Fischer-Grunski; Eva K,19,0,20,1
1714369241727,LIGM 5C,A00,507425,Fischer-Grunski; Eva K,19,0,20,1
1714369242752,LIIT 5AS,A00,507427,Carnelos; Chiara,20,0,20,0
1714369243778,LIIT 5BS,A00,507430,Carnelos; Chiara,20,0,20,0
1714369244802,LIIT 5CS,A00,507432,Carnelos; Chiara,20,0,20,0
1714369245831,LISP 5A,A00,507541,Munoz Sanchez; Alicia,11,0,20,9
1714369246856,LISP 5B,A00,507671,Munoz Sanchez; Alicia,9,0,20,11
1714369247880,LISP 5C,A00,507696,Munoz Sanchez; Alicia,9,0,20,11
1714369248907,MAE 197,001,528363,Boechler; Nicholas Sebastia,9998,0,9999,1
1714369249938,MATH 197,001,523477,Kedlaya; Kiran S.,9996,0,9999,3
1714369249938,MATH 197,002,563811,Zhang; Danna,9995,0,9999,4
1714369249938,MATH 197,003,628552,Dumitriu; Ioana,9998,0,9999,1
1714369250968,MCWP 40R,A00,518780,Staff,5,0,20,15
1714369250968,MCWP 40R,B00,518781,Staff,7,0,20,13
1714369250968,MCWP 40R,C00,518783,Staff,5,0,20,15
1714369251997,MCWP 50R,A00,518791,Staff,0,0,20,20
1714369251997,MCWP 50R,B00,518792,Staff,0,1,20,20
1714369251997,MCWP 50R,C00,518793,Staff,0,1,20,20
1714369251997,MCWP 50R,D00,518794,Staff,0,0,20,20
1714369251997,MCWP 50R,E00,518795,Staff,0,1,20,20
1714369251997,MCWP 50R,F00,518796,Staff,0,0,20,20
1714369251997,MCWP 50R,G00,518797,Staff,0,1,20,20
1714369253024,MMW 12R,A01,514034,Herbst; Matthew,0,1,16,16
1714369253024,MMW 12R,A02,514035,Herbst; Matthew,2,0,16,14
1714369254053,MMW 13R,A01,514037,Staff,0,4,16,16
1714369254053,MMW 13R,A02,514039,Staff,0,2,16,16
1714369254053,MMW 13R,A03,628519,Staff,0,2,16,16
1714369256107,SIO 295LS,A00,523233,Staff,12,0,30,18
1714369257133,SIO 295S,A00,523232,Staff,12,0,30,18
1714369258158,SIOC 290S,A01,637330,Merrifield; Mark A,27,0,30,3
1714369259185,SIOC 291S,A01,637333,Gabriel; Corey John,27,0,30,3
1714369260214,SOCI 117,A01,494376,Staff,0,3,5,5
1714369261238,WES 237B,A00,494380,Staff,9,0,20,11
1714369263296,AESE 279B,A00,494370,Wade; Jon P,0,0,33,33
1714369264324,AIP 197,001,627712,Vespa; Emanuel Ignacio,9998,0,9999,1
1714369265402,ANAR 135S,A00,494369,Braswell; Geoffrey E.,0,0,0,0
1714369266426,BENG 196,001,628496,Engler; Adam J.,9998,0,9999,1
1714369267453,CAT 124RS,A01,519847,Geibel; William,0,0,20,20
1714369268477,CAT 125RS,A01,515971,Geibel; William,0,0,20,20
1714369269506,CLRE 250,A00,511389,Morris; Sheldon,9993,0,9999,6
1714369270532,CLRE 251,A00,507176,Mehta; Ravindra L.,9993,0,9999,6
1714369270532,CLRE 251,B00,511410,Mehta; Ravindra L.,9998,0,9999,1
1714369271763,CLRE 252,A00,507189,Cuomo; Raphael Eduardo,9995,0,9999,4
1714369272788,CLRE 253,A00,507199,Vaida; Florin,9994,0,9999,5
1714369272788,CLRE 253,B00,507202,Vaida; Florin,9999,0,9999,0
1714369273814,CLRE 259,A00,507211,Patel; Hemal,9996,0,9999,3
1714369274840,CLRE 260,A00,507221,Cuomo; Raphael Eduardo,9999,0,9999,0
1714369275863,CLRE 297,001,507242,Cuomo; Raphael Eduardo,9999,0,9999,0
1714369276889,COGS 197,001,638244,Voytek; Bradley Thomas,9999,0,9999,0
1714369277916,CSE 191,A00,516875,Minnes Kemp; Mor Mia,9993,0,9999,6
1714369278940,CSE 197,001,637388,Minnes Kemp; Mor Mia,9998,0,9999,1
1714369279967,CSS 201S,A01,494383,Staff,35,0,35,0
1714369280992,CSS 202S,A01,494387,Staff,35,0,35,0
1714369282018,DSC 197,001,628532,Eldridge; Justin Matthew,9996,0,9999,3
1714369283041,EAP 100,A00,516065,Staff,9797,0,9999,202
1714369284069,ECE 45,A01,507414,Staff,33,0,60,27
1714369286125,ECE 111,A01,507420,Staff,19,0,50,31
1714369287153,ECE 197,001,548057,Sievenpiper; Daniel F.,9994,0,9999,5
1714369288179,EDS 115,A00,507243,Choi; Bailey Miyeon,12,0,28,16
1714369289204,EDS 117,A01,494379,Staff,0,2,30,30
1714369290227,EDS 125,A00,507246,Hopkins; Megan Beth,12,0,30,18
1714369291251,EDS 128A,A01,507264,Fargason; Sharon Gayle,14,0,26,12
1714369292275,EDS 128B,A01,507293,Pappas; Elizabeth,18,0,30,12
1714369293299,EDS 139,A00,507294,Fargason; Sharon Gayle,18,0,30,12
1714369293299,EDS 139,B00,507313,Pappas; Elizabeth,15,0,30,15
1714369294327,EDS 201,A00,507315,Staff,13,0,30,17
1714369295355,EDS 203,A01,507317,Halter; Christopher P.,12,0,30,18
1714369296380,EDS 204R,A01,507319,Halter; Christopher P.,0,3,30,30
1714369296380,EDS 204R,B01,507331,Heinzman; Erica M.,17,0,30,13
1714369297407,EDS 206R,A00,507332,Staff,0,4,30,30
1714369297407,EDS 206R,B00,507343,Staff,18,0,30,12
1714369298431,EDS 250,A00,507344,Hemans; Patricia Ann Benitez,22,0,40,18
1714369299455,EDS 281,A00,507345,Daly; Alan J.,18,0,18,0
1714369300482,EDS 284,A00,507350,Daly; Alan J.,16,0,16,0
1714369301510,EDS 286,A00,507359,Fine; Sarah,18,0,18,0
1714369302538,EDS 289C,A01,507361,Daly; Alan J.,18,0,18,0
1714369303563,EDS 290,A00,507366,Hofstetter; Carolyn,15,0,15,0
1714369304587,LIGM 5A,A00,507421,Fischer-Grunski; Eva K,18,0,20,2
1714369305615,LIGM 5B,A00,507423,Fischer-Grunski; Eva K,19,0,20,1
1714369306643,LIGM 5C,A00,507425,Fischer-Grunski; Eva K,19,0,20,1
1714369307668,LIIT 5AS,A00,507427,Carnelos; Chiara,20,0,20,0
1714369308693,LIIT 5BS,A00,507430,Carnelos; Chiara,20,0,20,0
1714369309718,LIIT 5CS,A00,507432,Carnelos; Chiara,20,0,20,0
1714369310745,LISP 5A,A00,507541,Munoz Sanchez; Alicia,11,0,20,9
1714369311770,LISP 5B,A00,507671,Munoz Sanchez; Alicia,9,0,20,11
1714369312796,LISP 5C,A00,507696,Munoz Sanchez; Alicia,9,0,20,11
1714369313824,MAE 197,001,528363,Boechler; Nicholas Sebastia,9998,0,9999,1
1714369314850,MATH 197,001,523477,Kedlaya; Kiran S.,9996,0,9999,3
1714369314850,MATH 197,002,563811,Zhang; Danna,9995,0,9999,4
1714369314850,MATH 197,003,628552,Dumitriu; Ioana,9998,0,9999,1
1714369315875,MCWP 40R,A00,518780,Staff,5,0,20,15
1714369315875,MCWP 40R,B00,518781,Staff,7,0,20,13
1714369315875,MCWP 40R,C00,518783,Staff,5,0,20,15
1714369316906,MCWP 50R,A00,518791,Staff,0,0,20,20
1714369316906,MCWP 50R,B00,518792,Staff,0,1,20,20
1714369316906,MCWP 50R,C00,518793,Staff,0,1,20,20
1714369316906,MCWP 50R,D00,518794,Staff,0,0,20,20
1714369316906,MCWP 50R,E00,518795,Staff,0,1,20,20
1714369316906,MCWP 50R,F00,518796,Staff,0,0,20,20
1714369316906,MCWP 50R,G00,518797,Staff,0,1,20,20
1714369317931,MMW 12R,A01,514034,Herbst; Matthew,0,1,16,16
1714369317931,MMW 12R,A02,514035,Herbst; Matthew,2,0,16,14
1714369318957,MMW 13R,A01,514037,Staff,0,4,16,16
1714369318957,MMW 13R,A02,514039,Staff,0,2,16,16
1714369318957,MMW 13R,A03,628519,Staff,0,2,16,16
1714369321006,SIO 295LS,A00,523233,Staff,12,0,30,18
1714369322031,SIO 295S,A00,523232,Staff,12,0,30,18
1714369323061,SIOC 290S,A01,637330,Merrifield; Mark A,27,0,30,3
1714369324090,SIOC 291S,A01,637333,Gabriel; Corey John,27,0,30,3
1714369325115,SOCI 117,A01,494376,Staff,0,3,5,5
1714369326139,WES 237B,A00,494380,Staff,9,0,20,11
1714369328216,AESE 279B,A00,494370,Wade; Jon P,0,0,33,33
1714369329244,AIP 197,001,627712,Vespa; Emanuel Ignacio,9998,0,9999,1
1714369330271,ANAR 135S,A00,494369,Braswell; Geoffrey E.,0,0,0,0
1714369331299,BENG 196,001,628496,Engler; Adam J.,9998,0,9999,1
1714369332329,CAT 124RS,A01,519847,Geibel; William,0,0,20,20
1714369333353,CAT 125RS,A01,515971,Geibel; William,0,0,20,20
1714369334380,CLRE 250,A00,511389,Morris; Sheldon,9993,0,9999,6
1714369335407,CLRE 251,A00,507176,Mehta; Ravindra L.,9993,0,9999,6
1714369335407,CLRE 251,B00,511410,Mehta; Ravindra L.,9998,0,9999,1
1714369336432,CLRE 252,A00,507189,Cuomo; Raphael Eduardo,9995,0,9999,4
1714369337459,CLRE 253,A00,507199,Vaida; Florin,9994,0,9999,5
1714369337459,CLRE 253,B00,507202,Vaida; Florin,9999,0,9999,0
1714369338485,CLRE 259,A00,507211,Patel; Hemal,9996,0,9999,3
1714369339509,CLRE 260,A00,507221,Cuomo; Raphael Eduardo,9999,0,9999,0
1714369340537,CLRE 297,001,507242,Cuomo; Raphael Eduardo,9999,0,9999,0
1714369341563,COGS 197,001,638244,Voytek; Bradley Thomas,9999,0,9999,0
1714369342589,CSE 191,A00,516875,Minnes Kemp; Mor Mia,9993,0,9999,6
1714369343617,CSE 197,001,637388,Minnes Kemp; Mor Mia,9998,0,9999,1
1714369344644,CSS 201S,A01,494383,Staff,35,0,35,0
1714369345672,CSS 202S,A01,494387,Staff,35,0,35,0
1714369346698,DSC 197,001,628532,Eldridge; Justin Matthew,9996,0,9999,3
1714369347722,EAP 100,A00,516065,Staff,9797,0,9999,202
1714369348750,ECE 45,A01,507414,Staff,33,0,60,27
1714369350798,ECE 111,A01,507420,Staff,19,0,50,31
1714369351823,ECE 197,001,548057,Sievenpiper; Daniel F.,9994,0,9999,5
1714369352850,EDS 115,A00,507243,Choi; Bailey Miyeon,12,0,28,16
1714369353877,EDS 117,A01,494379,Staff,0,2,30,30
1714369354904,EDS 125,A00,507246,Hopkins; Megan Beth,12,0,30,18
1714369355929,EDS 128A,A01,507264,Fargason; Sharon Gayle,14,0,26,12
1714369356958,EDS 128B,A01,507293,Pappas; Elizabeth,18,0,30,12
1714369357984,EDS 139,A00,507294,Fargason; Sharon Gayle,18,0,30,12
1714369357984,EDS 139,B00,507313,Pappas; Elizabeth,15,0,30,15
1714369359012,EDS 201,A00,507315,Staff,13,0,30,17
1714369360037,EDS 203,A01,507317,Halter; Christopher P.,12,0,30,18
1714369361063,EDS 204R,A01,507319,Halter; Christopher P.,0,3,30,30
1714369361063,EDS 204R,B01,507331,Heinzman; Erica M.,17,0,30,13
1714369362089,EDS 206R,A00,507332,Staff,0,4,30,30
1714369362089,EDS 206R,B00,507343,Staff,18,0,30,12
1714369363117,EDS 250,A00,507344,Hemans; Patricia Ann Benitez,22,0,40,18
1714369364143,EDS 281,A00,507345,Daly; Alan J.,18,0,18,0
1714369365169,EDS 284,A00,507350,Daly; Alan J.,16,0,16,0
1714369366194,EDS 286,A00,507359,Fine; Sarah,18,0,18,0
1714369367221,EDS 289C,A01,507361,Daly; Alan J.,18,0,18,0
1714369368247,EDS 290,A00,507366,Hofstetter; Carolyn,15,0,15,0
1714369369331,LIGM 5A,A00,507421,Fischer-Grunski; Eva K,18,0,20,2
1714369370357,LIGM 5B,A00,507423,Fischer-Grunski; Eva K,19,0,20,1
1714369371382,LIGM 5C,A00,507425,Fischer-Grunski; Eva K,19,0,20,1
1714369372411,LIIT 5AS,A00,507427,Carnelos; Chiara,20,0,20,0
1714369373444,LIIT 5BS,A00,507430,Carnelos; Chiara,20,0,20,0
1714369374470,LIIT 5CS,A00,507432,Carnelos; Chiara,20,0,20,0
1714369375495,LISP 5A,A00,507541,Munoz Sanchez; Alicia,11,0,20,9
1714369376524,LISP 5B,A00,507671,Munoz Sanchez; Alicia,9,0,20,11
1714369377549,LISP 5C,A00,507696,Munoz Sanchez; Alicia,9,0,20,11
1714369378574,MAE 197,001,528363,Boechler; Nicholas Sebastia,9998,0,9999,1
1714369379600,MATH 197,001,523477,Kedlaya; Kiran S.,9996,0,9999,3
1714369379600,MATH 197,002,563811,Zhang; Danna,9995,0,9999,4
1714369379600,MATH 197,003,628552,Dumitriu; Ioana,9998,0,9999,1
1714369380631,MCWP 40R,A00,518780,Staff,5,0,20,15
1714369380631,MCWP 40R,B00,518781,Staff,7,0,20,13
1714369380631,MCWP 40R,C00,518783,Staff,5,0,20,15
1714369381656,MCWP 50R,A00,518791,Staff,0,0,20,20
1714369381656,MCWP 50R,B00,518792,Staff,0,1,20,20
1714369381656,MCWP 50R,C00,518793,Staff,0,1,20,20
1714369381656,MCWP 50R,D00,518794,Staff,0,0,20,20
1714369381656,MCWP 50R,E00,518795,Staff,0,1,20,20
1714369381656,MCWP 50R,F00,518796,Staff,0,0,20,20
1714369381656,MCWP 50R,G00,518797,Staff,0,1,20,20
1714369382684,MMW 12R,A01,514034,Herbst; Matthew,0,1,16,16
1714369382684,MMW 12R,A02,514035,Herbst; Matthew,2,0,16,14
1714369383709,MMW 13R,A01,514037,Staff,0,4,16,16
1714369383709,MMW 13R,A02,514039,Staff,0,2,16,16
1714369383709,MMW 13R,A03,628519,Staff,0,2,16,16
1714369385760,SIO 295LS,A00,523233,Staff,12,0,30,18
1714369386789,SIO 295S,A00,523232,Staff,12,0,30,18
1714369387820,SIOC 290S,A01,637330,Merrifield; Mark A,27,0,30,3
1714369388848,SIOC 291S,A01,637333,Gabriel; Corey John,27,0,30,3
1714369389873,SOCI 117,A01,494376,Staff,0,3,5,5
1714369390900,WES 237B,A00,494380,Staff,9,0,20,11
1714369392962,AESE 279B,A00,494370,Wade; Jon P,0,0,33,33
1714369393988,AIP 197,001,627712,Vespa; Emanuel Ignacio,9998,0,9999,1
1714369395013,ANAR 135S,A00,494369,Braswell; Geoffrey E.,0,0,0,0
1714369396039,BENG 196,001,628496,Engler; Adam J.,9998,0,9999,1
1714369397064,CAT 124RS,A01,519847,Geibel; William,0,0,20,20
1714369398088,CAT 125RS,A01,515971,Geibel; William,0,0,20,20
1714369399117,CLRE 250,A00,511389,Morris; Sheldon,9993,0,9999,6
1714369400145,CLRE 251,A00,507176,Mehta; Ravindra L.,9993,0,9999,6
1714369400145,CLRE 251,B00,511410,Mehta; Ravindra L.,9998,0,9999,1
1714369401170,CLRE 252,A00,507189,Cuomo; Raphael Eduardo,9995,0,9999,4
1714369402194,CLRE 253,A00,507199,Vaida; Florin,9994,0,9999,5
1714369402194,CLRE 253,B00,507202,Vaida; Florin,9999,0,9999,0
1714369403225,CLRE 259,A00,507211,Patel; Hemal,9996,0,9999,3
1714369404251,CLRE 260,A00,507221,Cuomo; Raphael Eduardo,9999,0,9999,0
1714369405276,CLRE 297,001,507242,Cuomo; Raphael Eduardo,9999,0,9999,0
1714369406300,COGS 197,001,638244,Voytek; Bradley Thomas,9999,0,9999,0
1714369407325,CSE 191,A00,516875,Minnes Kemp; Mor Mia,9993,0,9999,6
1714369408351,CSE 197,001,637388,Minnes Kemp; Mor Mia,9998,0,9999,1
1714369409376,CSS 201S,A01,494383,Staff,35,0,35,0
1714369410404,CSS 202S,A01,494387,Staff,35,0,35,0
1714369411430,DSC 197,001,628532,Eldridge; Justin Matthew,9996,0,9999,3
1714369412456,EAP 100,A00,516065,Staff,9797,0,9999,202
1714369413481,ECE 45,A01,507414,Staff,33,0,60,27
1714369415532,ECE 111,A01,507420,Staff,19,0,50,31
1714369416559,ECE 197,001,548057,Sievenpiper; Daniel F.,9994,0,9999,5
1714369417584,EDS 115,A00,507243,Choi; Bailey Miyeon,12,0,28,16
1714369418609,EDS 117,A01,494379,Staff,0,2,30,30
1714369419633,EDS 125,A00,507246,Hopkins; Megan Beth,12,0,30,18
1714369420659,EDS 128A,A01,507264,Fargason; Sharon Gayle,14,0,26,12
1714369421683,EDS 128B,A01,507293,Pappas; Elizabeth,18,0,30,12
1714369422710,EDS 139,A00,507294,Fargason; Sharon Gayle,18,0,30,12
1714369422710,EDS 139,B00,507313,Pappas; Elizabeth,15,0,30,15
1714369423736,EDS 201,A00,507315,Staff,13,0,30,17
1714369424761,EDS 203,A01,507317,Halter; Christopher P.,12,0,30,18
1714369425785,EDS 204R,A01,507319,Halter; Christopher P.,0,3,30,30
1714369425785,EDS 204R,B01,507331,Heinzman; Erica M.,17,0,30,13
1714369426815,EDS 206R,A00,507332,Staff,0,4,30,30
1714369426815,EDS 206R,B00,507343,Staff,18,0,30,12
1714369427841,EDS 250,A00,507344,Hemans; Patricia Ann Benitez,22,0,40,18
1714369428866,EDS 281,A00,507345,Daly; Alan J.,18,0,18,0
1714369429890,EDS 284,A00,507350,Daly; Alan J.,16,0,16,0
1714369430916,EDS 286,A00,507359,Fine; Sarah,18,0,18,0
1714369431941,EDS 289C,A01,507361,Daly; Alan J.,18,0,18,0
1714369432970,EDS 290,A00,507366,Hofstetter; Carolyn,15,0,15,0
1714369433997,LIGM 5A,A00,507421,Fischer-Grunski; Eva K,18,0,20,2
1714369435021,LIGM 5B,A00,507423,Fischer-Grunski; Eva K,19,0,20,1
1714369436050,LIGM 5C,A00,507425,Fischer-Grunski; Eva K,19,0,20,1
1714369437074,LIIT 5AS,A00,507427,Carnelos; Chiara,20,0,20,0
1714369438103,LIIT 5BS,A00,507430,Carnelos; Chiara,20,0,20,0
1714369439128,LIIT 5CS,A00,507432,Carnelos; Chiara,20,0,20,0
1714369440156,LISP 5A,A00,507541,Munoz Sanchez; Alicia,11,0,20,9
1714369441184,LISP 5B,A00,507671,Munoz Sanchez; Alicia,9,0,20,11
1714369442210,LISP 5C,A00,507696,Munoz Sanchez; Alicia,9,0,20,11
1714369443237,MAE 197,001,528363,Boechler; Nicholas Sebastia,9998,0,9999,1
1714369444264,MATH 197,001,523477,Kedlaya; Kiran S.,9996,0,9999,3
1714369444264,MATH 197,002,563811,Zhang; Danna,9995,0,9999,4
1714369444264,MATH 197,003,628552,Dumitriu; Ioana,9998,0,9999,1
1714369445287,MCWP 40R,A00,518780,Staff,5,0,20,15
1714369445287,MCWP 40R,B00,518781,Staff,7,0,20,13
1714369445287,MCWP 40R,C00,518783,Staff,5,0,20,15
1714369446317,MCWP 50R,A00,518791,Staff,0,0,20,20
1714369446317,MCWP 50R,B00,518792,Staff,0,1,20,20
1714369446317,MCWP 50R,C00,518793,Staff,0,1,20,20
1714369446317,MCWP 50R,D00,518794,Staff,0,0,20,20
1714369446317,MCWP 50R,E00,518795,Staff,0,1,20,20
1714369446317,MCWP 50R,F00,518796,Staff,0,0,20,20
1714369446317,MCWP 50R,G00,518797,Staff,0,1,20,20
1714369447341,MMW 12R,A01,514034,Herbst; Matthew,0,1,16,16
1714369447341,MMW 12R,A02,514035,Herbst; Matthew,2,0,16,14
1714369448368,MMW 13R,A01,514037,Staff,0,4,16,16
1714369448368,MMW 13R,A02,514039,Staff,0,2,16,16
1714369448368,MMW 13R,A03,628519,Staff,0,2,16,16
1714369450422,SIO 295LS,A00,523233,Staff,12,0,30,18
1714369451447,SIO 295S,A00,523232,Staff,12,0,30,18
1714369452473,SIOC 290S,A01,637330,Merrifield; Mark A,27,0,30,3
1714369453502,SIOC 291S,A01,637333,Gabriel; Corey John,27,0,30,3
1714369454530,SOCI 117,A01,494376,Staff,0,3,5,5
1714369455556,WES 237B,A00,494380,Staff,9,0,20,11
1714369457623,AESE 279B,A00,494370,Wade; Jon P,0,0,33,33
1714369458650,AIP 197,001,627712,Vespa; Emanuel Ignacio,9998,0,9999,1
1714369459676,ANAR 135S,A00,494369,Braswell; Geoffrey E.,0,0,0,0
1714369460705,BENG 196,001,628496,Engler; Adam J.,9998,0,9999,1
1714369461728,CAT 124RS,A01,519847,Geibel; William,0,0,20,20
1714369462756,CAT 125RS,A01,515971,Geibel; William,0,0,20,20
1714369463781,CLRE 250,A00,511389,Morris; Sheldon,9993,0,9999,6
1714369464811,CLRE 251,A00,507176,Mehta; Ravindra L.,9993,0,9999,6
1714369464811,CLRE 251,B00,511410,Mehta; Ravindra L.,9998,0,9999,1
1714369465835,CLRE 252,A00,507189,Cuomo; Raphael Eduardo,9995,0,9999,4
1714369466862,CLRE 253,A00,507199,Vaida; Florin,9994,0,9999,5
1714369466862,CLRE 253,B00,507202,Vaida; Florin,9999,0,9999,0
1714369467888,CLRE 259,A00,507211,Patel; Hemal,9996,0,9999,3
1714369468914,CLRE 260,A00,507221,Cuomo; Raphael Eduardo,9999,0,9999,0
1714369469941,CLRE 297,001,507242,Cuomo; Raphael Eduardo,9999,0,9999,0
1714369470972,COGS 197,001,638244,Voytek; Bradley Thomas,9999,0,9999,0
1714369471996,CSE 191,A00,516875,Minnes Kemp; Mor Mia,9993,0,9999,6
1714369473076,CSE 197,001,637388,Minnes Kemp; Mor Mia,9998,0,9999,1
1714369474104,CSS 201S,A01,494383,Staff,35,0,35,0
1714369475131,CSS 202S,A01,494387,Staff,35,0,35,0
1714369476158,DSC 197,001,628532,Eldridge; Justin Matthew,9996,0,9999,3
1714369477185,EAP 100,A00,516065,Staff,9797,0,9999,202
1714369478210,ECE 45,A01,507414,Staff,33,0,60,27
1714369480263,ECE 111,A01,507420,Staff,19,0,50,31
1714369481289,ECE 197,001,548057,Sievenpiper; Daniel F.,9994,0,9999,5
1714369482315,EDS 115,A00,507243,Choi; Bailey Miyeon,12,0,28,16
1714369483341,EDS 117,A01,494379,Staff,0,2,30,30
1714369484365,EDS 125,A00,507246,Hopkins; Megan Beth,12,0,30,18
1714369485390,EDS 128A,A01,507264,Fargason; Sharon Gayle,14,0,26,12
1714369486414,EDS 128B,A01,507293,Pappas; Elizabeth,18,0,30,12
1714369487442,EDS 139,A00,507294,Fargason; Sharon Gayle,18,0,30,12
1714369487442,EDS 139,B00,507313,Pappas; Elizabeth,15,0,30,15
1714369488469,EDS 201,A00,507315,Staff,13,0,30,17
1714369489494,EDS 203,A01,507317,Halter; Christopher P.,12,0,30,18
1714369490520,EDS 204R,A01,507319,Halter; Christopher P.,0,3,30,30
1714369490520,EDS 204R,B01,507331,Heinzman; Erica M.,17,0,30,13
1714369491544,EDS 206R,A00,507332,Staff,0,4,30,30
1714369491544,EDS 206R,B00,507343,Staff,18,0,30,12
1714369492570,EDS 250,A00,507344,Hemans; Patricia Ann Benitez,22,0,40,18
1714369493594,EDS 281,A00,507345,Daly; Alan J.,18,0,18,0
1714369494619,EDS 284,A00,507350,Daly; Alan J.,16,0,16,0
1714369495643,EDS 286,A00,507359,Fine; Sarah,18,0,18,0
1714369496671,EDS 289C,A01,507361,Daly; Alan J.,18,0,18,0
1714369497699,EDS 290,A00,507366,Hofstetter; Carolyn,15,0,15,0
1714369498728,LIGM 5A,A00,507421,Fischer-Grunski; Eva K,18,0,20,2
1714369499755,LIGM 5B,A00,507423,Fischer-Grunski; Eva K,19,0,20,1
1714369500783,LIGM 5C,A00,507425,Fischer-Grunski; Eva K,19,0,20,1
1714369501809,LIIT 5AS,A00,507427,Carnelos; Chiara,20,0,20,0
1714369502835,LIIT 5BS,A00,507430,Carnelos; Chiara,20,0,20,0
1714369503871,LIIT 5CS,A00,507432,Carnelos; Chiara,20,0,20,0
1714369504897,LISP 5A,A00,507541,Munoz Sanchez; Alicia,11,0,20,9
1714369505922,LISP 5B,A00,507671,Munoz Sanchez; Alicia,9,0,20,11
1714369506946,LISP 5C,A00,507696,Munoz Sanchez; Alicia,9,0,20,11
1714369507971,MAE 197,001,528363,Boechler; Nicholas Sebastia,9998,0,9999,1
1714369508997,MATH 197,001,523477,Kedlaya; Kiran S.,9996,0,9999,3
1714369508997,MATH 197,002,563811,Zhang; Danna,9995,0,9999,4
1714369508997,MATH 197,003,628552,Dumitriu; Ioana,9998,0,9999,1
1714369510022,MCWP 40R,A00,518780,Staff,5,0,20,15
1714369510022,MCWP 40R,B00,518781,Staff,7,0,20,13
1714369510022,MCWP 40R,C00,518783,Staff,5,0,20,15
1714369511051,MCWP 50R,A00,518791,Staff,0,0,20,20
1714369511051,MCWP 50R,B00,518792,Staff,0,1,20,20
1714369511051,MCWP 50R,C00,518793,Staff,0,1,20,20
1714369511051,MCWP 50R,D00,518794,Staff,0,0,20,20
1714369511051,MCWP 50R,E00,518795,Staff,0,1,20,20
1714369511051,MCWP 50R,F00,518796,Staff,0,0,20,20
1714369511051,MCWP 50R,G00,518797,Staff,0,1,20,20
1714369512076,MMW 12R,A01,514034,Herbst; Matthew,0,1,16,16
1714369512076,MMW 12R,A02,514035,Herbst; Matthew,2,0,16,14
1714369513104,MMW 13R,A01,514037,Staff,0,4,16,16
1714369513104,MMW 13R,A02,514039,Staff,0,2,16,16
1714369513104,MMW 13R,A03,628519,Staff,0,2,16,16
1714369515157,SIO 295LS,A00,523233,Staff,12,0,30,18
1714369516184,SIO 295S,A00,523232,Staff,12,0,30,18
1714369517208,SIOC 290S,A01,637330,Merrifield; Mark A,27,0,30,3
1714369518234,SIOC 291S,A01,637333,Gabriel; Corey John,27,0,30,3
1714369519259,SOCI 117,A01,494376,Staff,0,3,5,5
1714369520286,WES 237B,A00,494380,Staff,9,0,20,11
1714369522345,AESE 279B,A00,494370,Wade; Jon P,0,0,33,33
1714369523371,AIP 197,001,627712,Vespa; Emanuel Ignacio,9998,0,9999,1
1714369524398,ANAR 135S,A00,494369,Braswell; Geoffrey E.,0,0,0,0
1714369525423,BENG 196,001,628496,Engler; Adam J.,9998,0,9999,1
1714369526449,CAT 124RS,A01,519847,Geibel; William,0,0,20,20
1714369527475,CAT 125RS,A01,515971,Geibel; William,0,0,20,20
1714369528504,CLRE 250,A00,511389,Morris; Sheldon,9993,0,9999,6
1714369529531,CLRE 251,A00,507176,Mehta; Ravindra L.,9993,0,9999,6
1714369529531,CLRE 251,B00,511410,Mehta; Ravindra L.,9998,0,9999,1
1714369530560,CLRE 252,A00,507189,Cuomo; Raphael Eduardo,9995,0,9999,4
1714369531591,CLRE 253,A00,507199,Vaida; Florin,9994,0,9999,5
1714369531591,CLRE 253,B00,507202,Vaida; Florin,9999,0,9999,0
1714369532617,CLRE 259,A00,507211,Patel; Hemal,9996,0,9999,3
1714369533642,CLRE 260,A00,507221,Cuomo; Raphael Eduardo,9999,0,9999,0
1714369534666,CLRE 297,001,507242,Cuomo; Raphael Eduardo,9999,0,9999,0
1714369535692,COGS 197,001,638244,Voytek; Bradley Thomas,9999,0,9999,0
1714369536718,CSE 191,A00,516875,Minnes Kemp; Mor Mia,9993,0,9999,6
1714369537743,CSE 197,001,637388,Minnes Kemp; Mor Mia,9998,0,9999,1
1714369538768,CSS 201S,A01,494383,Staff,35,0,35,0
1714369539796,CSS 202S,A01,494387,Staff,35,0,35,0
1714369540820,DSC 197,001,628532,Eldridge; Justin Matthew,9996,0,9999,3
1714369541845,EAP 100,A00,516065,Staff,9797,0,9999,202
1714369542874,ECE 45,A01,507414,Staff,33,0,60,27
1714369544930,ECE 111,A01,507420,Staff,19,0,50,31
1714369545955,ECE 197,001,548057,Sievenpiper; Daniel F.,9994,0,9999,5
1714369546983,EDS 115,A00,507243,Choi; Bailey Miyeon,12,0,28,16
1714369548010,EDS 117,A01,494379,Staff,0,2,30,30
1714369549036,EDS 125,A00,507246,Hopkins; Megan Beth,12,0,30,18
1714369550061,EDS 128A,A01,507264,Fargason; Sharon Gayle,14,0,26,12
1714369551087,EDS 128B,A01,507293,Pappas; Elizabeth,18,0,30,12
1714369552112,EDS 139,A00,507294,Fargason; Sharon Gayle,18,0,30,12
1714369552112,EDS 139,B00,507313,Pappas; Elizabeth,15,0,30,15
1714369553136,EDS 201,A00,507315,Staff,13,0,30,17
1714369554161,EDS 203,A01,507317,Halter; Christopher P.,12,0,30,18
1714369555187,EDS 204R,A01,507319,Halter; Christopher P.,0,3,30,30
1714369555187,EDS 204R,B01,507331,Heinzman; Erica M.,17,0,30,13
1714369556212,EDS 206R,A00,507332,Staff,0,4,30,30
1714369556212,EDS 206R,B00,507343,Staff,18,0,30,12
1714369557236,EDS 250,A00,507344,Hemans; Patricia Ann Benitez,22,0,40,18
1714369558260,EDS 281,A00,507345,Daly; Alan J.,18,0,18,0
1714369559284,EDS 284,A00,507350,Daly; Alan J.,16,0,16,0
1714369560310,EDS 286,A00,507359,Fine; Sarah,18,0,18,0
1714369561338,EDS 289C,A01,507361,Daly; Alan J.,18,0,18,0
1714369562365,EDS 290,A00,507366,Hofstetter; Carolyn,15,0,15,0
1714369563391,LIGM 5A,A00,507421,Fischer-Grunski; Eva K,18,0,20,2
1714369564416,LIGM 5B,A00,507423,Fischer-Grunski; Eva K,19,0,20,1
1714369565444,LIGM 5C,A00,507425,Fischer-Grunski; Eva K,19,0,20,1
1714369566472,LIIT 5AS,A00,507427,Carnelos; Chiara,20,0,20,0
1714369567499,LIIT 5BS,A00,507430,Carnelos; Chiara,20,0,20,0
1714369568528,LIIT 5CS,A00,507432,Carnelos; Chiara,20,0,20,0
1714369569557,LISP 5A,A00,507541,Munoz Sanchez; Alicia,11,0,20,9
1714369570582,LISP 5B,A00,507671,Munoz Sanchez; Alicia,9,0,20,11
1714369571606,LISP 5C,A00,507696,Munoz Sanchez; Alicia,9,0,20,11
1714369572632,MAE 197,001,528363,Boechler; Nicholas Sebastia,9998,0,9999,1
1714369573659,MATH 197,001,523477,Kedlaya; Kiran S.,9996,0,9999,3
1714369573659,MATH 197,002,563811,Zhang; Danna,9995,0,9999,4
1714369573659,MATH 197,003,628552,Dumitriu; Ioana,9998,0,9999,1
1714369574687,MCWP 40R,A00,518780,Staff,5,0,20,15
1714369574687,MCWP 40R,B00,518781,Staff,7,0,20,13
1714369574687,MCWP 40R,C00,518783,Staff,5,0,20,15
1714369575713,MCWP 50R,A00,518791,Staff,0,0,20,20
1714369575713,MCWP 50R,B00,518792,Staff,0,1,20,20
1714369575713,MCWP 50R,C00,518793,Staff,0,1,20,20
1714369575713,MCWP 50R,D00,518794,Staff,0,0,20,20
1714369575713,MCWP 50R,E00,518795,Staff,0,1,20,20
1714369575713,MCWP 50R,F00,518796,Staff,0,0,20,20
1714369575713,MCWP 50R,G00,518797,Staff,0,1,20,20
1714369576791,MMW 12R,A01,514034,Herbst; Matthew,0,1,16,16
1714369576791,MMW 12R,A02,514035,Herbst; Matthew,2,0,16,14
1714369577815,MMW 13R,A01,514037,Staff,0,4,16,16
1714369577815,MMW 13R,A02,514039,Staff,0,2,16,16
1714369577815,MMW 13R,A03,628519,Staff,0,2,16,16
1714369579865,SIO 295LS,A00,523233,Staff,12,0,30,18
1714369580889,SIO 295S,A00,523232,Staff,12,0,30,18
1714369581915,SIOC 290S,A01,637330,Merrifield; Mark A,27,0,30,3
1714369582944,SIOC 291S,A01,637333,Gabriel; Corey John,27,0,30,3
1714369583975,SOCI 117,A01,494376,Staff,0,3,5,5
1714369584998,WES 237B,A00,494380,Staff,9,0,20,11
1714369587074,AESE 279B,A00,494370,Wade; Jon P,0,0,33,33
1714369588100,AIP 197,001,627712,Vespa; Emanuel Ignacio,9998,0,9999,1
1714369589128,ANAR 135S,A00,494369,Braswell; Geoffrey E.,0,0,0,0
1714369590153,BENG 196,001,628496,Engler; Adam J.,9998,0,9999,1
1714369591179,CAT 124RS,A01,519847,Geibel; William,0,0,20,20
1714369592202,CAT 125RS,A01,515971,Geibel; William,0,0,20,20
1714369593227,CLRE 250,A00,511389,Morris; Sheldon,9993,0,9999,6
1714369594253,CLRE 251,A00,507176,Mehta; Ravindra L.,9993,0,9999,6
1714369594253,CLRE 251,B00,511410,Mehta; Ravindra L.,9998,0,9999,1
1714369595278,CLRE 252,A00,507189,Cuomo; Raphael Eduardo,9995,0,9999,4
1714369596306,CLRE 253,A00,507199,Vaida; Florin,9994,0,9999,5
1714369596306,CLRE 253,B00,507202,Vaida; Florin,9999,0,9999,0
1714369597334,CLRE 259,A00,507211,Patel; Hemal,9996,0,9999,3
1714369598357,CLRE 260,A00,507221,Cuomo; Raphael Eduardo,9999,0,9999,0
1714369599381,CLRE 297,001,507242,Cuomo; Raphael Eduardo,9999,0,9999,0
1714369600404,COGS 197,001,638244,Voytek; Bradley Thomas,9999,0,9999,0
1714369601429,CSE 191,A00,516875,Minnes Kemp; Mor Mia,9993,0,9999,6
1714369602456,CSE 197,001,637388,Minnes Kemp; Mor Mia,9998,0,9999,1
1714369603480,CSS 201S,A01,494383,Staff,35,0,35,0
1714369604507,CSS 202S,A01,494387,Staff,35,0,35,0
1714369605531,DSC 197,001,628532,Eldridge; Justin Matthew,9996,0,9999,3
1714369606554,EAP 100,A00,516065,Staff,9797,0,9999,202
1714369607581,ECE 45,A01,507414,Staff,33,0,60,27
1714369609633,ECE 111,A01,507420,Staff,19,0,50,31
1714369610658,ECE 197,001,548057,Sievenpiper; Daniel F.,9994,0,9999,5
1714369611685,EDS 115,A00,507243,Choi; Bailey Miyeon,12,0,28,16
1714369612711,EDS 117,A01,494379,Staff,0,2,30,30
1714369613739,EDS 125,A00,507246,Hopkins; Megan Beth,12,0,30,18
1714369614769,EDS 128A,A01,507264,Fargason; Sharon Gayle,14,0,26,12
1714369615794,EDS 128B,A01,507293,Pappas; Elizabeth,18,0,30,12
1714369616819,EDS 139,A00,507294,Fargason; Sharon Gayle,18,0,30,12
1714369616819,EDS 139,B00,507313,Pappas; Elizabeth,15,0,30,15
1714369617843,EDS 201,A00,507315,Staff,13,0,30,17
1714369618867,EDS 203,A01,507317,Halter; Christopher P.,12,0,30,18
1714369619892,EDS 204R,A01,507319,Halter; Christopher P.,0,3,30,30
1714369619892,EDS 204R,B01,507331,Heinzman; Erica M.,17,0,30,13
1714369620921,EDS 206R,A00,507332,Staff,0,4,30,30
1714369620921,EDS 206R,B00,507343,Staff,18,0,30,12
1714369621948,EDS 250,A00,507344,Hemans; Patricia Ann Benitez,22,0,40,18
1714369622972,EDS 281,A00,507345,Daly; Alan J.,18,0,18,0
1714369623998,EDS 284,A00,507350,Daly; Alan J.,16,0,16,0
1714369625025,EDS 286,A00,507359,Fine; Sarah,18,0,18,0
1714369626050,EDS 289C,A01,507361,Daly; Alan J.,18,0,18,0
1714369627075,EDS 290,A00,507366,Hofstetter; Carolyn,15,0,15,0
1714369628100,LIGM 5A,A00,507421,Fischer-Grunski; Eva K,18,0,20,2
1714369629128,LIGM 5B,A00,507423,Fischer-Grunski; Eva K,19,0,20,1
1714369630152,LIGM 5C,A00,507425,Fischer-Grunski; Eva K,19,0,20,1
1714369631179,LIIT 5AS,A00,507427,Carnelos; Chiara,20,0,20,0
1714369632208,LIIT 5BS,A00,507430,Carnelos; Chiara,20,0,20,0
1714369633236,LIIT 5CS,A00,507432,Carnelos; Chiara,20,0,20,0
1714369634264,LISP 5A,A00,507541,Munoz Sanchez; Alicia,11,0,20,9
1714369635289,LISP 5B,A00,507671,Munoz Sanchez; Alicia,9,0,20,11
1714369636319,LISP 5C,A00,507696,Munoz Sanchez; Alicia,9,0,20,11
1714369637345,MAE 197,001,528363,Boechler; Nicholas Sebastia,9998,0,9999,1
1714369638370,MATH 197,001,523477,Kedlaya; Kiran S.,9996,0,9999,3
1714369638370,MATH 197,002,563811,Zhang; Danna,9995,0,9999,4
1714369638370,MATH 197,003,628552,Dumitriu; Ioana,9998,0,9999,1
1714369639397,MCWP 40R,A00,518780,Staff,5,0,20,15
1714369639397,MCWP 40R,B00,518781,Staff,7,0,20,13
1714369639397,MCWP 40R,C00,518783,Staff,5,0,20,15
1714369640425,MCWP 50R,A00,518791,Staff,0,0,20,20
1714369640425,MCWP 50R,B00,518792,Staff,0,1,20,20
1714369640425,MCWP 50R,C00,518793,Staff,0,1,20,20
1714369640425,MCWP 50R,D00,518794,Staff,0,0,20,20
1714369640425,MCWP 50R,E00,518795,Staff,0,1,20,20
1714369640425,MCWP 50R,F00,518796,Staff,0,0,20,20
1714369640425,MCWP 50R,G00,518797,Staff,0,1,20,20
1714369641454,MMW 12R,A01,514034,Herbst; Matthew,0,1,16,16
1714369641454,MMW 12R,A02,514035,Herbst; Matthew,2,0,16,14
1714369642480,MMW 13R,A01,514037,Staff,0,4,16,16
1714369642480,MMW 13R,A02,514039,Staff,0,2,16,16
1714369642480,MMW 13R,A03,628519,Staff,0,2,16,16
1714369644532,SIO 295LS,A00,523233,Staff,12,0,30,18
1714369645557,SIO 295S,A00,523232,Staff,12,0,30,18
1714369646582,SIOC 290S,A01,637330,Merrifield; Mark A,27,0,30,3
1714369647607,SIOC 291S,A01,637333,Gabriel; Corey John,27,0,30,3
1714369648635,SOCI 117,A01,494376,Staff,0,3,5,5
1714369649663,WES 237B,A00,494380,Staff,9,0,20,11
1714369651730,AESE 279B,A00,494370,Wade; Jon P,0,0,33,33
1714369652756,AIP 197,001,627712,Vespa; Emanuel Ignacio,9998,0,9999,1
1714369653783,ANAR 135S,A00,494369,Braswell; Geoffrey E.,0,0,0,0
1714369654811,BENG 196,001,628496,Engler; Adam J.,9998,0,9999,1
1714369655839,CAT 124RS,A01,519847,Geibel; William,0,0,20,20
1714369656863,CAT 125RS,A01,515971,Geibel; William,0,0,20,20
1714369657891,CLRE 250,A00,511389,Morris; Sheldon,9993,0,9999,6
1714369658917,CLRE 251,A00,507176,Mehta; Ravindra L.,9993,0,9999,6
1714369658917,CLRE 251,B00,511410,Mehta; Ravindra L.,9998,0,9999,1
1714369659942,CLRE 252,A00,507189,Cuomo; Raphael Eduardo,9995,0,9999,4
1714369660968,CLRE 253,A00,507199,Vaida; Florin,9994,0,9999,5
1714369660968,CLRE 253,B00,507202,Vaida; Florin,9999,0,9999,0
1714369661996,CLRE 259,A00,507211,Patel; Hemal,9996,0,9999,3
1714369663021,CLRE 260,A00,507221,Cuomo; Raphael Eduardo,9999,0,9999,0
1714369664048,CLRE 297,001,507242,Cuomo; Raphael Eduardo,9999,0,9999,0
1714369665075,COGS 197,001,638244,Voytek; Bradley Thomas,9999,0,9999,0
1714369666099,CSE 191,A00,516875,Minnes Kemp; Mor Mia,9993,0,9999,6
1714369667123,CSE 197,001,637388,Minnes Kemp; Mor Mia,9998,0,9999,1
1714369668149,CSS 201S,A01,494383,Staff,35,0,35,0
1714369669175,CSS 202S,A01,494387,Staff,35,0,35,0
1714369670200,DSC 197,001,628532,Eldridge; Justin Matthew,9996,0,9999,3
1714369671227,EAP 100,A00,516065,Staff,9797,0,9999,202
1714369672255,ECE 45,A01,507414,Staff,33,0,60,27
1714369674304,ECE 111,A01,507420,Staff,19,0,50,31
1714369675329,ECE 197,001,548057,Sievenpiper; Daniel F.,9994,0,9999,5
1714369676354,EDS 115,A00,507243,Choi; Bailey Miyeon,12,0,28,16
1714369677382,EDS 117,A01,494379,Staff,0,2,30,30
1714369678409,EDS 125,A00,507246,Hopkins; Megan Beth,12,0,30,18
1714369679435,EDS 128A,A01,507264,Fargason; Sharon Gayle,14,0,26,12
1714369680536,EDS 128B,A01,507293,Pappas; Elizabeth,18,0,30,12
1714369681560,EDS 139,A00,507294,Fargason; Sharon Gayle,18,0,30,12
1714369681560,EDS 139,B00,507313,Pappas; Elizabeth,15,0,30,15
1714369682588,EDS 201,A00,507315,Staff,13,0,30,17
1714369683617,EDS 203,A01,507317,Halter; Christopher P.,12,0,30,18
1714369684640,EDS 204R,A01,507319,Halter; Christopher P.,0,3,30,30
1714369684640,EDS 204R,B01,507331,Heinzman; Erica M.,17,0,30,13
1714369685665,EDS 206R,A00,507332,Staff,0,4,30,30
1714369685665,EDS 206R,B00,507343,Staff,18,0,30,12
1714369686693,EDS 250,A00,507344,Hemans; Patricia Ann Benitez,22,0,40,18
1714369687719,EDS 281,A00,507345,Daly; Alan J.,18,0,18,0
1714369688744,EDS 284,A00,507350,Daly; Alan J.,16,0,16,0
1714369689773,EDS 286,A00,507359,Fine; Sarah,18,0,18,0
1714369690801,EDS 289C,A01,507361,Daly; Alan J.,18,0,18,0
1714369691827,EDS 290,A00,507366,Hofstetter; Carolyn,15,0,15,0
1714369692856,LIGM 5A,A00,507421,Fischer-Grunski; Eva K,18,0,20,2
1714369693884,LIGM 5B,A00,507423,Fischer-Grunski; Eva K,19,0,20,1
1714369694909,LIGM 5C,A00,507425,Fischer-Grunski; Eva K,19,0,20,1
1714369695938,LIIT 5AS,A00,507427,Carnelos; Chiara,20,0,20,0
1714369696967,LIIT 5BS,A00,507430,Carnelos; Chiara,20,0,20,0
1714369697992,LIIT 5CS,A00,507432,Carnelos; Chiara,20,0,20,0
1714369699017,LISP 5A,A00,507541,Munoz Sanchez; Alicia,11,0,20,9
1714369700040,LISP 5B,A00,507671,Munoz Sanchez; Alicia,9,0,20,11
1714369701066,LISP 5C,A00,507696,Munoz Sanchez; Alicia,9,0,20,11
1714369702092,MAE 197,001,528363,Boechler; Nicholas Sebastia,9998,0,9999,1
1714369703120,MATH 197,001,523477,Kedlaya; Kiran S.,9996,0,9999,3
1714369703120,MATH 197,002,563811,Zhang; Danna,9995,0,9999,4
1714369703120,MATH 197,003,628552,Dumitriu; Ioana,9998,0,9999,1
1714369704148,MCWP 40R,A00,518780,Staff,5,0,20,15
1714369704148,MCWP 40R,B00,518781,Staff,7,0,20,13
1714369704148,MCWP 40R,C00,518783,Staff,5,0,20,15
1714369705177,MCWP 50R,A00,518791,Staff,0,0,20,20
1714369705177,MCWP 50R,B00,518792,Staff,0,1,20,20
1714369705177,MCWP 50R,C00,518793,Staff,0,1,20,20
1714369705177,MCWP 50R,D00,518794,Staff,0,0,20,20
1714369705177,MCWP 50R,E00,518795,Staff,0,1,20,20
1714369705177,MCWP 50R,F00,518796,Staff,0,0,20,20
1714369705177,MCWP 50R,G00,518797,Staff,0,1,20,20
1714369706203,MMW 12R,A01,514034,Herbst; Matthew,0,1,16,16
1714369706203,MMW 12R,A02,514035,Herbst; Matthew,2,0,16,14
1714369707227,MMW 13R,A01,514037,Staff,0,4,16,16
1714369707227,MMW 13R,A02,514039,Staff,0,2,16,16
1714369707227,MMW 13R,A03,628519,Staff,0,2,16,16
1714369709279,SIO 295LS,A00,523233,Staff,12,0,30,18
1714369710304,SIO 295S,A00,523232,Staff,12,0,30,18
1714369711336,SIOC 290S,A01,637330,Merrifield; Mark A,27,0,30,3
1714369712362,SIOC 291S,A01,637333,Gabriel; Corey John,27,0,30,3
1714369713390,SOCI 117,A01,494376,Staff,0,3,5,5
1714369714415,WES 237B,A00,494380,Staff,9,0,20,11
1714369716484,AESE 279B,A00,494370,Wade; Jon P,0,0,33,33
1714369717510,AIP 197,001,627712,Vespa; Emanuel Ignacio,9998,0,9999,1
1714369718535,ANAR 135S,A00,494369,Braswell; Geoffrey E.,0,0,0,0
1714369719561,BENG 196,001,628496,Engler; Adam J.,9998,0,9999,1
1714369720585,CAT 124RS,A01,519847,Geibel; William,0,0,20,20
1714369721610,CAT 125RS,A01,515971,Geibel; William,0,0,20,20
1714369722638,CLRE 250,A00,511389,Morris; Sheldon,9993,0,9999,6
1714369723669,CLRE 251,A00,507176,Mehta; Ravindra L.,9993,0,9999,6
1714369723669,CLRE 251,B00,511410,Mehta; Ravindra L.,9998,0,9999,1
1714369724697,CLRE 252,A00,507189,Cuomo; Raphael Eduardo,9995,0,9999,4
1714369725726,CLRE 253,A00,507199,Vaida; Florin,9994,0,9999,5
1714369725726,CLRE 253,B00,507202,Vaida; Florin,9999,0,9999,0
1714369726753,CLRE 259,A00,507211,Patel; Hemal,9996,0,9999,3
1714369727780,CLRE 260,A00,507221,Cuomo; Raphael Eduardo,9999,0,9999,0
1714369728808,CLRE 297,001,507242,Cuomo; Raphael Eduardo,9999,0,9999,0
1714369729832,COGS 197,001,638244,Voytek; Bradley Thomas,9999,0,9999,0
1714369730855,CSE 191,A00,516875,Minnes Kemp; Mor Mia,9993,0,9999,6
1714369731883,CSE 197,001,637388,Minnes Kemp; Mor Mia,9998,0,9999,1
1714369732908,CSS 201S,A01,494383,Staff,35,0,35,0
1714369733936,CSS 202S,A01,494387,Staff,35,0,35,0
1714369734963,DSC 197,001,628532,Eldridge; Justin Matthew,9996,0,9999,3
1714369735991,EAP 100,A00,516065,Staff,9797,0,9999,202
1714369737017,ECE 45,A01,507414,Staff,33,0,60,27
1714369739067,ECE 111,A01,507420,Staff,19,0,50,31
1714369740093,ECE 197,001,548057,Sievenpiper; Daniel F.,9994,0,9999,5
1714369741119,EDS 115,A00,507243,Choi; Bailey Miyeon,12,0,28,16
1714369742148,EDS 117,A01,494379,Staff,0,2,30,30
1714369743179,EDS 125,A00,507246,Hopkins; Megan Beth,12,0,30,18
1714369744203,EDS 128A,A01,507264,Fargason; Sharon Gayle,14,0,26,12
1714369745227,EDS 128B,A01,507293,Pappas; Elizabeth,18,0,30,12
1714369746252,EDS 139,A00,507294,Fargason; Sharon Gayle,18,0,30,12
1714369746252,EDS 139,B00,507313,Pappas; Elizabeth,15,0,30,15
1714369747280,EDS 201,A00,507315,Staff,13,0,30,17
1714369748304,EDS 203,A01,507317,Halter; Christopher P.,12,0,30,18
1714369749333,EDS 204R,A01,507319,Halter; Christopher P.,0,3,30,30
1714369749333,EDS 204R,B01,507331,Heinzman; Erica M.,17,0,30,13
1714369750360,EDS 206R,A00,507332,Staff,0,4,30,30
1714369750360,EDS 206R,B00,507343,Staff,18,0,30,12
1714369751387,EDS 250,A00,507344,Hemans; Patricia Ann Benitez,22,0,40,18
1714369752411,EDS 281,A00,507345,Daly; Alan J.,18,0,18,0
1714369753439,EDS 284,A00,507350,Daly; Alan J.,16,0,16,0
1714369754464,EDS 286,A00,507359,Fine; Sarah,18,0,18,0
1714369755491,EDS 289C,A01,507361,Daly; Alan J.,18,0,18,0
1714369756517,EDS 290,A00,507366,Hofstetter; Carolyn,15,0,15,0
1714369757541,LIGM 5A,A00,507421,Fischer-Grunski; Eva K,18,0,20,2
1714369758564,LIGM 5B,A00,507423,Fischer-Grunski; Eva K,19,0,20,1
1714369759588,LIGM 5C,A00,507425,Fischer-Grunski; Eva K,19,0,20,1
1714369760612,LIIT 5AS,A00,507427,Carnelos; Chiara,20,0,20,0
1714369761636,LIIT 5BS,A00,507430,Carnelos; Chiara,20,0,20,0
1714369762664,LIIT 5CS,A00,507432,Carnelos; Chiara,20,0,20,0
1714369763688,LISP 5A,A00,507541,Munoz Sanchez; Alicia,11,0,20,9
1714369764716,LISP 5B,A00,507671,Munoz Sanchez; Alicia,9,0,20,11
1714369765745,LISP 5C,A00,507696,Munoz Sanchez; Alicia,9,0,20,11
1714369766769,MAE 197,001,528363,Boechler; Nicholas Sebastia,9998,0,9999,1
1714369767794,MATH 197,001,523477,Kedlaya; Kiran S.,9996,0,9999,3
1714369767794,MATH 197,002,563811,Zhang; Danna,9995,0,9999,4
1714369767794,MATH 197,003,628552,Dumitriu; Ioana,9998,0,9999,1
1714369768819,MCWP 40R,A00,518780,Staff,5,0,20,15
1714369768819,MCWP 40R,B00,518781,Staff,7,0,20,13
1714369768819,MCWP 40R,C00,518783,Staff,5,0,20,15
1714369769845,MCWP 50R,A00,518791,Staff,0,0,20,20
1714369769845,MCWP 50R,B00,518792,Staff,0,1,20,20
1714369769845,MCWP 50R,C00,518793,Staff,0,1,20,20
1714369769845,MCWP 50R,D00,518794,Staff,0,0,20,20
1714369769845,MCWP 50R,E00,518795,Staff,0,1,20,20
1714369769845,MCWP 50R,F00,518796,Staff,0,0,20,20
1714369769845,MCWP 50R,G00,518797,Staff,0,1,20,20
1714369770873,MMW 12R,A01,514034,Herbst; Matthew,0,1,16,16
1714369770873,MMW 12R,A02,514035,Herbst; Matthew,2,0,16,14
1714369771900,MMW 13R,A01,514037,Staff,0,4,16,16
1714369771900,MMW 13R,A02,514039,Staff,0,2,16,16
1714369771900,MMW 13R,A03,628519,Staff,0,2,16,16
1714369773950,SIO 295LS,A00,523233,Staff,12,0,30,18
1714369774975,SIO 295S,A00,523232,Staff,12,0,30,18
1714369776000,SIOC 290S,A01,637330,Merrifield; Mark A,27,0,30,3
1714369777027,SIOC 291S,A01,637333,Gabriel; Corey John,27,0,30,3
1714369778051,SOCI 117,A01,494376,Staff,0,3,5,5
1714369779075,WES 237B,A00,494380,Staff,9,0,20,11
1714369781141,AESE 279B,A00,494370,Wade; Jon P,0,0,33,33
1714369782168,AIP 197,001,627712,Vespa; Emanuel Ignacio,9998,0,9999,1
1714369783193,ANAR 135S,A00,494369,Braswell; Geoffrey E.,0,0,0,0
1714369784278,BENG 196,001,628496,Engler; Adam J.,9998,0,9999,1
1714369785304,CAT 124RS,A01,519847,Geibel; William,0,0,20,20
1714369786329,CAT 125RS,A01,515971,Geibel; William,0,0,20,20
1714369787354,CLRE 250,A00,511389,Morris; Sheldon,9993,0,9999,6
1714369788384,CLRE 251,A00,507176,Mehta; Ravindra L.,9993,0,9999,6
1714369788384,CLRE 251,B00,511410,Mehta; Ravindra L.,9998,0,9999,1
1714369789410,CLRE 252,A00,507189,Cuomo; Raphael Eduardo,9995,0,9999,4
1714369790438,CLRE 253,A00,507199,Vaida; Florin,9994,0,9999,5
1714369790438,CLRE 253,B00,507202,Vaida; Florin,9999,0,9999,0
1714369791464,CLRE 259,A00,507211,Patel; Hemal,9996,0,9999,3
1714369792488,CLRE 260,A00,507221,Cuomo; Raphael Eduardo,9999,0,9999,0
1714369793511,CLRE 297,001,507242,Cuomo; Raphael Eduardo,9999,0,9999,0
1714369794536,COGS 197,001,638244,Voytek; Bradley Thomas,9999,0,9999,0
1714369795562,CSE 191,A00,516875,Minnes Kemp; Mor Mia,9993,0,9999,6
1714369796586,CSE 197,001,637388,Minnes Kemp; Mor Mia,9998,0,9999,1
1714369797611,CSS 201S,A01,494383,Staff,35,0,35,0
1714369798636,CSS 202S,A01,494387,Staff,35,0,35,0
1714369799662,DSC 197,001,628532,Eldridge; Justin Matthew,9996,0,9999,3
1714369800686,EAP 100,A00,516065,Staff,9797,0,9999,202
1714369801710,ECE 45,A01,507414,Staff,33,0,60,27
1714369803764,ECE 111,A01,507420,Staff,19,0,50,31
1714369804789,ECE 197,001,548057,Sievenpiper; Daniel F.,9994,0,9999,5
1714369805816,EDS 115,A00,507243,Choi; Bailey Miyeon,12,0,28,16
1714369806844,EDS 117,A01,494379,Staff,0,2,30,30
1714369807869,EDS 125,A00,507246,Hopkins; Megan Beth,12,0,30,18
1714369808898,EDS 128A,A01,507264,Fargason; Sharon Gayle,14,0,26,12
1714369809925,EDS 128B,A01,507293,Pappas; Elizabeth,18,0,30,12
1714369810950,EDS 139,A00,507294,Fargason; Sharon Gayle,18,0,30,12
1714369810950,EDS 139,B00,507313,Pappas; Elizabeth,15,0,30,15
1714369811976,EDS 201,A00,507315,Staff,13,0,30,17
1714369813000,EDS 203,A01,507317,Halter; Christopher P.,12,0,30,18
1714369814030,EDS 204R,A01,507319,Halter; Christopher P.,0,3,30,30
1714369814030,EDS 204R,B01,507331,Heinzman; Erica M.,17,0,30,13
1714369815054,EDS 206R,A00,507332,Staff,0,4,30,30
1714369815054,EDS 206R,B00,507343,Staff,18,0,30,12
1714369816082,EDS 250,A00,507344,Hemans; Patricia Ann Benitez,22,0,40,18
1714369817107,EDS 281,A00,507345,Daly; Alan J.,18,0,18,0
1714369818130,EDS 284,A00,507350,Daly; Alan J.,16,0,16,0
1714369819157,EDS 286,A00,507359,Fine; Sarah,18,0,18,0
1714369820182,EDS 289C,A01,507361,Daly; Alan J.,18,0,18,0
1714369821209,EDS 290,A00,507366,Hofstetter; Carolyn,15,0,15,0
1714369822235,LIGM 5A,A00,507421,Fischer-Grunski; Eva K,18,0,20,2
1714369823261,LIGM 5B,A00,507423,Fischer-Grunski; Eva K,19,0,20,1
1714369824290,LIGM 5C,A00,507425,Fischer-Grunski; Eva K,19,0,20,1
1714369825319,LIIT 5AS,A00,507427,Carnelos; Chiara,20,0,20,0
1714369826343,LIIT 5BS,A00,507430,Carnelos; Chiara,20,0,20,0
1714369827368,LIIT 5CS,A00,507432,Carnelos; Chiara,20,0,20,0
1714369828398,LISP 5A,A00,507541,Munoz Sanchez; Alicia,11,0,20,9
1714369829423,LISP 5B,A00,507671,Munoz Sanchez; Alicia,9,0,20,11
1714369830451,LISP 5C,A00,507696,Munoz Sanchez; Alicia,9,0,20,11
1714369831475,MAE 197,001,528363,Boechler; Nicholas Sebastia,9998,0,9999,1
1714369832501,MATH 197,001,523477,Kedlaya; Kiran S.,9996,0,9999,3
1714369832501,MATH 197,002,563811,Zhang; Danna,9995,0,9999,4
1714369832501,MATH 197,003,628552,Dumitriu; Ioana,9998,0,9999,1
1714369833525,MCWP 40R,A00,518780,Staff,5,0,20,15
1714369833525,MCWP 40R,B00,518781,Staff,7,0,20,13
1714369833525,MCWP 40R,C00,518783,Staff,5,0,20,15
1714369834556,MCWP 50R,A00,518791,Staff,0,0,20,20
1714369834556,MCWP 50R,B00,518792,Staff,0,1,20,20
1714369834556,MCWP 50R,C00,518793,Staff,0,1,20,20
1714369834556,MCWP 50R,D00,518794,Staff,0,0,20,20
1714369834556,MCWP 50R,E00,518795,Staff,0,1,20,20
1714369834556,MCWP 50R,F00,518796,Staff,0,0,20,20
1714369834556,MCWP 50R,G00,518797,Staff,0,1,20,20
1714369835584,MMW 12R,A01,514034,Herbst; Matthew,0,1,16,16
1714369835584,MMW 12R,A02,514035,Herbst; Matthew,2,0,16,14
1714369836608,MMW 13R,A01,514037,Staff,0,4,16,16
1714369836608,MMW 13R,A02,514039,Staff,0,2,16,16
1714369836608,MMW 13R,A03,628519,Staff,0,2,16,16
1714369838659,SIO 295LS,A00,523233,Staff,12,0,30,18
1714369839684,SIO 295S,A00,523232,Staff,12,0,30,18
1714369840708,SIOC 290S,A01,637330,Merrifield; Mark A,27,0,30,3
1714369841736,SIOC 291S,A01,637333,Gabriel; Corey John,27,0,30,3
1714369842762,SOCI 117,A01,494376,Staff,0,3,5,5
1714369843789,WES 237B,A00,494380,Staff,9,0,20,11
1714369845850,AESE 279B,A00,494370,Wade; Jon P,0,0,33,33
1714369846874,AIP 197,001,627712,Vespa; Emanuel Ignacio,9998,0,9999,1
1714369847901,ANAR 135S,A00,494369,Braswell; Geoffrey E.,0,0,0,0
1714369848930,BENG 196,001,628496,Engler; Adam J.,9998,0,9999,1
1714369849956,CAT 124RS,A01,519847,Geibel; William,0,0,20,20
1714369850983,CAT 125RS,A01,515971,Geibel; William,0,0,20,20
1714369852009,CLRE 250,A00,511389,Morris; Sheldon,9993,0,9999,6
1714369853040,CLRE 251,A00,507176,Mehta; Ravindra L.,9993,0,9999,6
1714369853040,CLRE 251,B00,511410,Mehta; Ravindra L.,9998,0,9999,1
1714369854063,CLRE 252,A00,507189,Cuomo; Raphael Eduardo,9995,0,9999,4
1714369855091,CLRE 253,A00,507199,Vaida; Florin,9994,0,9999,5
1714369855091,CLRE 253,B00,507202,Vaida; Florin,9999,0,9999,0
1714369856119,CLRE 259,A00,507211,Patel; Hemal,9996,0,9999,3
1714369857145,CLRE 260,A00,507221,Cuomo; Raphael Eduardo,9999,0,9999,0
1714369858169,CLRE 297,001,507242,Cuomo; Raphael Eduardo,9999,0,9999,0
1714369859192,COGS 197,001,638244,Voytek; Bradley Thomas,9999,0,9999,0
1714369860217,CSE 191,A00,516875,Minnes Kemp; Mor Mia,9993,0,9999,6
1714369861241,CSE 197,001,637388,Minnes Kemp; Mor Mia,9998,0,9999,1
1714369862266,CSS 201S,A01,494383,Staff,35,0,35,0
1714369863291,CSS 202S,A01,494387,Staff,35,0,35,0
1714369864316,DSC 197,001,628532,Eldridge; Justin Matthew,9996,0,9999,3
1714369865340,EAP 100,A00,516065,Staff,9797,0,9999,202
1714369866366,ECE 45,A01,507414,Staff,33,0,60,27
1714369868414,ECE 111,A01,507420,Staff,19,0,50,31
1714369869438,ECE 197,001,548057,Sievenpiper; Daniel F.,9994,0,9999,5
1714369870462,EDS 115,A00,507243,Choi; Bailey Miyeon,12,0,28,16
1714369871489,EDS 117,A01,494379,Staff,0,2,30,30
1714369872513,EDS 125,A00,507246,Hopkins; Megan Beth,12,0,30,18
1714369873537,EDS 128A,A01,507264,Fargason; Sharon Gayle,14,0,26,12
1714369874564,EDS 128B,A01,507293,Pappas; Elizabeth,18,0,30,12
1714369875587,EDS 139,A00,507294,Fargason; Sharon Gayle,18,0,30,12
1714369875587,EDS 139,B00,507313,Pappas; Elizabeth,15,0,30,15
1714369876615,EDS 201,A00,507315,Staff,13,0,30,17
1714369877642,EDS 203,A01,507317,Halter; Christopher P.,12,0,30,18
1714369878667,EDS 204R,A01,507319,Halter; Christopher P.,0,3,30,30
1714369878667,EDS 204R,B01,507331,Heinzman; Erica M.,17,0,30,13
1714369879695,EDS 206R,A00,507332,Staff,0,4,30,30
1714369879695,EDS 206R,B00,507343,Staff,18,0,30,12
1714369880719,EDS 250,A00,507344,Hemans; Patricia Ann Benitez,22,0,40,18
1714369881746,EDS 281,A00,507345,Daly; Alan J.,18,0,18,0
1714369882771,EDS 284,A00,507350,Daly; Alan J.,16,0,16,0
1714369883795,EDS 286,A00,507359,Fine; Sarah,18,0,18,0
1714369884820,EDS 289C,A01,507361,Daly; Alan J.,18,0,18,0
1714369885846,EDS 290,A00,507366,Hofstetter; Carolyn,15,0,15,0
1714369886873,LIGM 5A,A00,507421,Fischer-Grunski; Eva K,18,0,20,2
1714369887958,LIGM 5B,A00,507423,Fischer-Grunski; Eva K,19,0,20,1
1714369888984,LIGM 5C,A00,507425,Fischer-Grunski; Eva K,19,0,20,1
1714369890009,LIIT 5AS,A00,507427,Carnelos; Chiara,20,0,20,0
1714369891038,LIIT 5BS,A00,507430,Carnelos; Chiara,20,0,20,0
1714369892067,LIIT 5CS,A00,507432,Carnelos; Chiara,20,0,20,0
1714369893091,LISP 5A,A00,507541,Munoz Sanchez; Alicia,11,0,20,9
1714369894117,LISP 5B,A00,507671,Munoz Sanchez; Alicia,9,0,20,11
1714369895142,LISP 5C,A00,507696,Munoz Sanchez; Alicia,9,0,20,11
1714369896167,MAE 197,001,528363,Boechler; Nicholas Sebastia,9998,0,9999,1
1714369897192,MATH 197,001,523477,Kedlaya; Kiran S.,9996,0,9999,3
1714369897192,MATH 197,002,563811,Zhang; Danna,9995,0,9999,4
1714369897192,MATH 197,003,628552,Dumitriu; Ioana,9998,0,9999,1
1714369898217,MCWP 40R,A00,518780,Staff,5,0,20,15
1714369898217,MCWP 40R,B00,518781,Staff,7,0,20,13
1714369898217,MCWP 40R,C00,518783,Staff,5,0,20,15
1714369899243,MCWP 50R,A00,518791,Staff,0,0,20,20
1714369899243,MCWP 50R,B00,518792,Staff,0,1,20,20
1714369899243,MCWP 50R,C00,518793,Staff,0,1,20,20
1714369899243,MCWP 50R,D00,518794,Staff,0,0,20,20
1714369899243,MCWP 50R,E00,518795,Staff,0,1,20,20
1714369899243,MCWP 50R,F00,518796,Staff,0,0,20,20
1714369899243,MCWP 50R,G00,518797,Staff,0,1,20,20
1714369900271,MMW 12R,A01,514034,Herbst; Matthew,0,1,16,16
1714369900271,MMW 12R,A02,514035,Herbst; Matthew,2,0,16,14
1714369901301,MMW 13R,A01,514037,Staff,0,4,16,16
1714369901301,MMW 13R,A02,514039,Staff,0,2,16,16
1714369901301,MMW 13R,A03,628519,Staff,0,2,16,16
1714369903352,SIO 295LS,A00,523233,Staff,12,0,30,18
1714369904378,SIO 295S,A00,523232,Staff,12,0,30,18
1714369905403,SIOC 290S,A01,637330,Merrifield; Mark A,27,0,30,3
1714369906427,SIOC 291S,A01,637333,Gabriel; Corey John,27,0,30,3
1714369907456,SOCI 117,A01,494376,Staff,0,3,5,5
1714369908481,WES 237B,A00,494380,Staff,9,0,20,11
1714369910540,AESE 279B,A00,494370,Wade; Jon P,0,0,33,33
1714369911567,AIP 197,001,627712,Vespa; Emanuel Ignacio,9998,0,9999,1
1714369912591,ANAR 135S,A00,494369,Braswell; Geoffrey E.,0,0,0,0
1714369913617,BENG 196,001,628496,Engler; Adam J.,9998,0,9999,1
1714369914646,CAT 124RS,A01,519847,Geibel; William,0,0,20,20
1714369915671,CAT 125RS,A01,515971,Geibel; William,0,0,20,20
1714369916696,CLRE 250,A00,511389,Morris; Sheldon,9993,0,9999,6
1714369917723,CLRE 251,A00,507176,Mehta; Ravindra L.,9993,0,9999,6
1714369917723,CLRE 251,B00,511410,Mehta; Ravindra L.,9998,0,9999,1
1714369918749,CLRE 252,A00,507189,Cuomo; Raphael Eduardo,9995,0,9999,4
1714369919778,CLRE 253,A00,507199,Vaida; Florin,9994,0,9999,5
1714369919778,CLRE 253,B00,507202,Vaida; Florin,9999,0,9999,0
1714369920802,CLRE 259,A00,507211,Patel; Hemal,9996,0,9999,3
1714369921827,CLRE 260,A00,507221,Cuomo; Raphael Eduardo,9999,0,9999,0
1714369922852,CLRE 297,001,507242,Cuomo; Raphael Eduardo,9999,0,9999,0
1714369923876,COGS 197,001,638244,Voytek; Bradley Thomas,9999,0,9999,0
1714369924903,CSE 191,A00,516875,Minnes Kemp; Mor Mia,9993,0,9999,6
1714369925929,CSE 197,001,637388,Minnes Kemp; Mor Mia,9998,0,9999,1
1714369926954,CSS 201S,A01,494383,Staff,35,0,35,0
1714369927981,CSS 202S,A01,494387,Staff,35,0,35,0
1714369929009,DSC 197,001,628532,Eldridge; Justin Matthew,9996,0,9999,3
1714369930037,EAP 100,A00,516065,Staff,9797,0,9999,202
1714369931061,ECE 45,A01,507414,Staff,33,0,60,27
1714369933112,ECE 111,A01,507420,Staff,19,0,50,31
1714369934139,ECE 197,001,548057,Sievenpiper; Daniel F.,9994,0,9999,5
1714369935163,EDS 115,A00,507243,Choi; Bailey Miyeon,12,0,28,16
1714369936190,EDS 117,A01,494379,Staff,0,2,30,30
1714369937219,EDS 125,A00,507246,Hopkins; Megan Beth,12,0,30,18
1714369938245,EDS 128A,A01,507264,Fargason; Sharon Gayle,14,0,26,12
1714369939271,EDS 128B,A01,507293,Pappas; Elizabeth,18,0,30,12
1714369940296,EDS 139,A00,507294,Fargason; Sharon Gayle,18,0,30,12
1714369940296,EDS 139,B00,507313,Pappas; Elizabeth,15,0,30,15
1714369941321,EDS 201,A00,507315,Staff,13,0,30,17
1714369942345,EDS 203,A01,507317,Halter; Christopher P.,12,0,30,18
1714369943370,EDS 204R,A01,507319,Halter; Christopher P.,0,3,30,30
1714369943370,EDS 204R,B01,507331,Heinzman; Erica M.,17,0,30,13
1714369944399,EDS 206R,A00,507332,Staff,0,4,30,30
1714369944399,EDS 206R,B00,507343,Staff,18,0,30,12
1714369945421,EDS 250,A00,507344,Hemans; Patricia Ann Benitez,22,0,40,18
1714369946447,EDS 281,A00,507345,Daly; Alan J.,18,0,18,0
1714369947474,EDS 284,A00,507350,Daly; Alan J.,16,0,16,0
1714369948501,EDS 286,A00,507359,Fine; Sarah,18,0,18,0
1714369949527,EDS 289C,A01,507361,Daly; Alan J.,18,0,18,0
1714369950554,EDS 290,A00,507366,Hofstetter; Carolyn,15,0,15,0
1714369951579,LIGM 5A,A00,507421,Fischer-Grunski; Eva K,18,0,20,2
1714369952605,LIGM 5B,A00,507423,Fischer-Grunski; Eva K,19,0,20,1
1714369953634,LIGM 5C,A00,507425,Fischer-Grunski; Eva K,19,0,20,1
1714369954659,LIIT 5AS,A00,507427,Carnelos; Chiara,20,0,20,0
1714369955688,LIIT 5BS,A00,507430,Carnelos; Chiara,20,0,20,0
1714369956714,LIIT 5CS,A00,507432,Carnelos; Chiara,20,0,20,0
1714369957742,LISP 5A,A00,507541,Munoz Sanchez; Alicia,11,0,20,9
1714369958769,LISP 5B,A00,507671,Munoz Sanchez; Alicia,9,0,20,11
1714369959795,LISP 5C,A00,507696,Munoz Sanchez; Alicia,9,0,20,11
1714369960822,MAE 197,001,528363,Boechler; Nicholas Sebastia,9998,0,9999,1
1714369961848,MATH 197,001,523477,Kedlaya; Kiran S.,9996,0,9999,3
1714369961848,MATH 197,002,563811,Zhang; Danna,9995,0,9999,4
1714369961848,MATH 197,003,628552,Dumitriu; Ioana,9998,0,9999,1
1714369962872,MCWP 40R,A00,518780,Staff,5,0,20,15
1714369962872,MCWP 40R,B00,518781,Staff,7,0,20,13
1714369962872,MCWP 40R,C00,518783,Staff,5,0,20,15
1714369963898,MCWP 50R,A00,518791,Staff,0,0,20,20
1714369963898,MCWP 50R,B00,518792,Staff,0,1,20,20
1714369963898,MCWP 50R,C00,518793,Staff,0,1,20,20
1714369963898,MCWP 50R,D00,518794,Staff,0,0,20,20
1714369963898,MCWP 50R,E00,518795,Staff,0,1,20,20
1714369963898,MCWP 50R,F00,518796,Staff,0,0,20,20
1714369963898,MCWP 50R,G00,518797,Staff,0,1,20,20
1714369964924,MMW 12R,A01,514034,Herbst; Matthew,0,1,16,16
1714369964924,MMW 12R,A02,514035,Herbst; Matthew,2,0,16,14
1714369965950,MMW 13R,A01,514037,Staff,0,4,16,16
1714369965950,MMW 13R,A02,514039,Staff,0,2,16,16
1714369965950,MMW 13R,A03,628519,Staff,0,2,16,16
1714369968001,SIO 295LS,A00,523233,Staff,12,0,30,18
1714369969027,SIO 295S,A00,523232,Staff,12,0,30,18
1714369970057,SIOC 290S,A01,637330,Merrifield; Mark A,27,0,30,3
1714369971083,SIOC 291S,A01,637333,Gabriel; Corey John,27,0,30,3
1714369972109,SOCI 117,A01,494376,Staff,0,3,5,5
1714369973134,WES 237B,A00,494380,Staff,9,0,20,11
1714369975209,AESE 279B,A00,494370,Wade; Jon P,0,0,33,33
1714369976237,AIP 197,001,627712,Vespa; Emanuel Ignacio,9998,0,9999,1
1714369977262,ANAR 135S,A00,494369,Braswell; Geoffrey E.,0,0,0,0
1714369978286,BENG 196,001,628496,Engler; Adam J.,9998,0,9999,1
1714369979311,CAT 124RS,A01,519847,Geibel; William,0,0,20,20
1714369980339,CAT 125RS,A01,515971,Geibel; William,0,0,20,20
1714369981365,CLRE 250,A00,511389,Morris; Sheldon,9993,0,9999,6
1714369982391,CLRE 251,A00,507176,Mehta; Ravindra L.,9993,0,9999,6
1714369982391,CLRE 251,B00,511410,Mehta; Ravindra L.,9998,0,9999,1
1714369983418,CLRE 252,A00,507189,Cuomo; Raphael Eduardo,9995,0,9999,4
1714369984443,CLRE 253,A00,507199,Vaida; Florin,9994,0,9999,5
1714369984443,CLRE 253,B00,507202,Vaida; Florin,9999,0,9999,0
1714369985468,CLRE 259,A00,507211,Patel; Hemal,9996,0,9999,3
1714369986494,CLRE 260,A00,507221,Cuomo; Raphael Eduardo,9999,0,9999,0
1714369987519,CLRE 297,001,507242,Cuomo; Raphael Eduardo,9999,0,9999,0
1714369988546,COGS 197,001,638244,Voytek; Bradley Thomas,9999,0,9999,0
1714369989574,CSE 191,A00,516875,Minnes Kemp; Mor Mia,9993,0,9999,6
1714369990602,CSE 197,001,637388,Minnes Kemp; Mor Mia,9998,0,9999,1
1714369991682,CSS 201S,A01,494383,Staff,35,0,35,0
1714369992709,CSS 202S,A01,494387,Staff,35,0,35,0
1714369993736,DSC 197,001,628532,Eldridge; Justin Matthew,9996,0,9999,3
1714369994762,EAP 100,A00,516065,Staff,9797,0,9999,202
1714369995790,ECE 45,A01,507414,Staff,33,0,60,27
1714369997841,ECE 111,A01,507420,Staff,19,0,50,31
1714369998874,ECE 197,001,548057,Sievenpiper; Daniel F.,9994,0,9999,5
1714369999902,EDS 115,A00,507243,Choi; Bailey Miyeon,12,0,28,16
1714370000928,EDS 117,A01,494379,Staff,0,2,30,30
1714370001952,EDS 125,A00,507246,Hopkins; Megan Beth,12,0,30,18
1714370002978,EDS 128A,A01,507264,Fargason; Sharon Gayle,14,0,26,12
1714370004007,EDS 128B,A01,507293,Pappas; Elizabeth,18,0,30,12
1714370005035,EDS 139,A00,507294,Fargason; Sharon Gayle,18,0,30,12
1714370005035,EDS 139,B00,507313,Pappas; Elizabeth,15,0,30,15
1714370006062,EDS 201,A00,507315,Staff,13,0,30,17
1714370007091,EDS 203,A01,507317,Halter; Christopher P.,12,0,30,18
1714370008120,EDS 204R,A01,507319,Halter; Christopher P.,0,3,30,30
1714370008120,EDS 204R,B01,507331,Heinzman; Erica M.,17,0,30,13
1714370009147,EDS 206R,A00,507332,Staff,0,4,30,30
1714370009147,EDS 206R,B00,507343,Staff,18,0,30,12
1714370010172,EDS 250,A00,507344,Hemans; Patricia Ann Benitez,22,0,40,18
1714370011201,EDS 281,A00,507345,Daly; Alan J.,18,0,18,0
1714370012230,EDS 284,A00,507350,Daly; Alan J.,16,0,16,0
1714370013256,EDS 286,A00,507359,Fine; Sarah,18,0,18,0
1714370014281,EDS 289C,A01,507361,Daly; Alan J.,18,0,18,0
1714370015311,EDS 290,A00,507366,Hofstetter; Carolyn,15,0,15,0
1714370016335,LIGM 5A,A00,507421,Fischer-Grunski; Eva K,18,0,20,2
1714370017364,LIGM 5B,A00,507423,Fischer-Grunski; Eva K,19,0,20,1
1714370018391,LIGM 5C,A00,507425,Fischer-Grunski; Eva K,19,0,20,1
1714370019417,LIIT 5AS,A00,507427,Carnelos; Chiara,20,0,20,0
1714370020442,LIIT 5BS,A00,507430,Carnelos; Chiara,20,0,20,0
1714370021469,LIIT 5CS,A00,507432,Carnelos; Chiara,20,0,20,0
1714370022495,LISP 5A,A00,507541,Munoz Sanchez; Alicia,11,0,20,9
1714370023530,LISP 5B,A00,507671,Munoz Sanchez; Alicia,9,0,20,11
1714370024557,LISP 5C,A00,507696,Munoz Sanchez; Alicia,9,0,20,11
1714370025582,MAE 197,001,528363,Boechler; Nicholas Sebastia,9998,0,9999,1
1714370026612,MATH 197,001,523477,Kedlaya; Kiran S.,9996,0,9999,3
1714370026612,MATH 197,002,563811,Zhang; Danna,9995,0,9999,4
1714370026612,MATH 197,003,628552,Dumitriu; Ioana,9998,0,9999,1
1714370027637,MCWP 40R,A00,518780,Staff,5,0,20,15
1714370027637,MCWP 40R,B00,518781,Staff,7,0,20,13
1714370027637,MCWP 40R,C00,518783,Staff,5,0,20,15
1714370028667,MCWP 50R,A00,518791,Staff,0,0,20,20
1714370028667,MCWP 50R,B00,518792,Staff,0,1,20,20
1714370028667,MCWP 50R,C00,518793,Staff,0,1,20,20
1714370028667,MCWP 50R,D00,518794,Staff,0,0,20,20
1714370028667,MCWP 50R,E00,518795,Staff,0,1,20,20
1714370028667,MCWP 50R,F00,518796,Staff,0,0,20,20
1714370028667,MCWP 50R,G00,518797,Staff,0,1,20,20
1714370029696,MMW 12R,A01,514034,Herbst; Matthew,0,1,16,16
1714370029696,MMW 12R,A02,514035,Herbst; Matthew,2,0,16,14
1714370030724,MMW 13R,A01,514037,Staff,0,4,16,16
1714370030724,MMW 13R,A02,514039,Staff,0,2,16,16
1714370030724,MMW 13R,A03,628519,Staff,0,2,16,16
1714370032777,SIO 295LS,A00,523233,Staff,12,0,30,18
1714370033802,SIO 295S,A00,523232,Staff,12,0,30,18
1714370034827,SIOC 290S,A01,637330,Merrifield; Mark A,27,0,30,3
1714370035853,SIOC 291S,A01,637333,Gabriel; Corey John,27,0,30,3
1714370036879,SOCI 117,A01,494376,Staff,0,3,5,5
1714370037906,WES 237B,A00,494380,Staff,9,0,20,11
1714370039970,AESE 279B,A00,494370,Wade; Jon P,0,0,33,33
1714370041002,AIP 197,001,627712,Vespa; Emanuel Ignacio,9998,0,9999,1
1714370042027,ANAR 135S,A00,494369,Braswell; Geoffrey E.,0,0,0,0
1714370043055,BENG 196,001,628496,Engler; Adam J.,9998,0,9999,1
1714370044080,CAT 124RS,A01,519847,Geibel; William,0,0,20,20
1714370045105,CAT 125RS,A01,515971,Geibel; William,0,0,20,20
1714370046131,CLRE 250,A00,511389,Morris; Sheldon,9993,0,9999,6
1714370047157,CLRE 251,A00,507176,Mehta; Ravindra L.,9993,0,9999,6
1714370047157,CLRE 251,B00,511410,Mehta; Ravindra L.,9998,0,9999,1
1714370048184,CLRE 252,A00,507189,Cuomo; Raphael Eduardo,9995,0,9999,4
1714370049213,CLRE 253,A00,507199,Vaida; Florin,9994,0,9999,5
1714370049213,CLRE 253,B00,507202,Vaida; Florin,9999,0,9999,0
1714370050237,CLRE 259,A00,507211,Patel; Hemal,9996,0,9999,3
1714370051262,CLRE 260,A00,507221,Cuomo; Raphael Eduardo,9999,0,9999,0
1714370052287,CLRE 297,001,507242,Cuomo; Raphael Eduardo,9999,0,9999,0
1714370053317,COGS 197,001,638244,Voytek; Bradley Thomas,9999,0,9999,0
1714370054345,CSE 191,A00,516875,Minnes Kemp; Mor Mia,9993,0,9999,6
1714370055371,CSE 197,001,637388,Minnes Kemp; Mor Mia,9998,0,9999,1
1714370056400,CSS 201S,A01,494383,Staff,35,0,35,0
1714370057425,CSS 202S,A01,494387,Staff,35,0,35,0
1714370058450,DSC 197,001,628532,Eldridge; Justin Matthew,9996,0,9999,3
1714370059476,EAP 100,A00,516065,Staff,9797,0,9999,202
1714370060505,ECE 45,A01,507414,Staff,33,0,60,27
1714370062553,ECE 111,A01,507420,Staff,19,0,50,31
1714370063590,ECE 197,001,548057,Sievenpiper; Daniel F.,9994,0,9999,5
1714370064617,EDS 115,A00,507243,Choi; Bailey Miyeon,12,0,28,16
1714370065645,EDS 117,A01,494379,Staff,0,2,30,30
1714370066671,EDS 125,A00,507246,Hopkins; Megan Beth,12,0,30,18
1714370067697,EDS 128A,A01,507264,Fargason; Sharon Gayle,14,0,26,12
1714370068723,EDS 128B,A01,507293,Pappas; Elizabeth,18,0,30,12
1714370069748,EDS 139,A00,507294,Fargason; Sharon Gayle,18,0,30,12
1714370069748,EDS 139,B00,507313,Pappas; Elizabeth,15,0,30,15
1714370070772,EDS 201,A00,507315,Staff,13,0,30,17
1714370071798,EDS 203,A01,507317,Halter; Christopher P.,12,0,30,18
1714370072823,EDS 204R,A01,507319,Halter; Christopher P.,0,3,30,30
1714370072823,EDS 204R,B01,507331,Heinzman; Erica M.,17,0,30,13
1714370073848,EDS 206R,A00,507332,Staff,0,4,30,30
1714370073848,EDS 206R,B00,507343,Staff,18,0,30,12
1714370074877,EDS 250,A00,507344,Hemans; Patricia Ann Benitez,22,0,40,18
1714370075901,EDS 281,A00,507345,Daly; Alan J.,18,0,18,0
1714370076928,EDS 284,A00,507350,Daly; Alan J.,16,0,16,0
1714370077954,EDS 286,A00,507359,Fine; Sarah,18,0,18,0
1714370078982,EDS 289C,A01,507361,Daly; Alan J.,18,0,18,0
1714370080010,EDS 290,A00,507366,Hofstetter; Carolyn,15,0,15,0
1714370081039,LIGM 5A,A00,507421,Fischer-Grunski; Eva K,18,0,20,2
1714370082064,LIGM 5B,A00,507423,Fischer-Grunski; Eva K,19,0,20,1
1714370083090,LIGM 5C,A00,507425,Fischer-Grunski; Eva K,19,0,20,1
1714370084118,LIIT 5AS,A00,507427,Carnelos; Chiara,20,0,20,0
1714370085146,LIIT 5BS,A00,507430,Carnelos; Chiara,20,0,20,0
1714370086170,LIIT 5CS,A00,507432,Carnelos; Chiara,20,0,20,0
1714370087199,LISP 5A,A00,507541,Munoz Sanchez; Alicia,11,0,20,9
1714370088224,LISP 5B,A00,507671,Munoz Sanchez; Alicia,9,0,20,11
1714370089253,LISP 5C,A00,507696,Munoz Sanchez; Alicia,9,0,20,11
1714370090281,MAE 197,001,528363,Boechler; Nicholas Sebastia,9998,0,9999,1
1714370091308,MATH 197,001,523477,Kedlaya; Kiran S.,9996,0,9999,3
1714370091308,MATH 197,002,563811,Zhang; Danna,9995,0,9999,4
1714370091308,MATH 197,003,628552,Dumitriu; Ioana,9998,0,9999,1
1714370092332,MCWP 40R,A00,518780,Staff,5,0,20,15
1714370092332,MCWP 40R,B00,518781,Staff,7,0,20,13
1714370092332,MCWP 40R,C00,518783,Staff,5,0,20,15
1714370093358,MCWP 50R,A00,518791,Staff,0,0,20,20
1714370093358,MCWP 50R,B00,518792,Staff,0,1,20,20
1714370093358,MCWP 50R,C00,518793,Staff,0,1,20,20
1714370093358,MCWP 50R,D00,518794,Staff,0,0,20,20
1714370093358,MCWP 50R,E00,518795,Staff,0,1,20,20
1714370093358,MCWP 50R,F00,518796,Staff,0,0,20,20
1714370093358,MCWP 50R,G00,518797,Staff,0,1,20,20
1714370094385,MMW 12R,A01,514034,Herbst; Matthew,0,1,16,16
1714370094385,MMW 12R,A02,514035,Herbst; Matthew,2,0,16,14
1714370095468,MMW 13R,A01,514037,Staff,0,4,16,16
1714370095468,MMW 13R,A02,514039,Staff,0,2,16,16
1714370095468,MMW 13R,A03,628519,Staff,0,2,16,16
1714370097521,SIO 295LS,A00,523233,Staff,12,0,30,18
1714370098546,SIO 295S,A00,523232,Staff,12,0,30,18
1714370099573,SIOC 290S,A01,637330,Merrifield; Mark A,27,0,30,3
1714370100600,SIOC 291S,A01,637333,Gabriel; Corey John,27,0,30,3
1714370101627,SOCI 117,A01,494376,Staff,0,3,5,5
1714370102651,WES 237B,A00,494380,Staff,9,0,20,11
1714370104719,AESE 279B,A00,494370,Wade; Jon P,0,0,33,33
1714370105744,AIP 197,001,627712,Vespa; Emanuel Ignacio,9998,0,9999,1
1714370106769,ANAR 135S,A00,494369,Braswell; Geoffrey E.,0,0,0,0
1714370107793,BENG 196,001,628496,Engler; Adam J.,9998,0,9999,1
1714370108823,CAT 124RS,A01,519847,Geibel; William,0,0,20,20
1714370109848,CAT 125RS,A01,515971,Geibel; William,0,0,20,20
1714370110872,CLRE 250,A00,511389,Morris; Sheldon,9993,0,9999,6
1714370111897,CLRE 251,A00,507176,Mehta; Ravindra L.,9993,0,9999,6
1714370111897,CLRE 251,B00,511410,Mehta; Ravindra L.,9998,0,9999,1
1714370112926,CLRE 252,A00,507189,Cuomo; Raphael Eduardo,9995,0,9999,4
1714370113952,CLRE 253,A00,507199,Vaida; Florin,9994,0,9999,5
1714370113952,CLRE 253,B00,507202,Vaida; Florin,9999,0,9999,0
1714370114976,CLRE 259,A00,507211,Patel; Hemal,9996,0,9999,3
1714370116000,CLRE 260,A00,507221,Cuomo; Raphael Eduardo,9999,0,9999,0
1714370117024,CLRE 297,001,507242,Cuomo; Raphael Eduardo,9999,0,9999,0
1714370118052,COGS 197,001,638244,Voytek; Bradley Thomas,9999,0,9999,0
1714370119081,CSE 191,A00,516875,Minnes Kemp; Mor Mia,9993,0,9999,6
1714370120106,CSE 197,001,637388,Minnes Kemp; Mor Mia,9998,0,9999,1
1714370121135,CSS 201S,A01,494383,Staff,35,0,35,0
1714370122164,CSS 202S,A01,494387,Staff,35,0,35,0
1714370123190,DSC 197,001,628532,Eldridge; Justin Matthew,9996,0,9999,3
1714370124218,EAP 100,A00,516065,Staff,9797,0,9999,202
1714370125244,ECE 45,A01,507414,Staff,33,0,60,27
1714370127294,ECE 111,A01,507420,Staff,19,0,50,31
1714370128323,ECE 197,001,548057,Sievenpiper; Daniel F.,9994,0,9999,5
1714370129348,EDS 115,A00,507243,Choi; Bailey Miyeon,12,0,28,16
1714370130374,EDS 117,A01,494379,Staff,0,2,30,30
1714370131399,EDS 125,A00,507246,Hopkins; Megan Beth,12,0,30,18
1714370132425,EDS 128A,A01,507264,Fargason; Sharon Gayle,14,0,26,12
1714370133452,EDS 128B,A01,507293,Pappas; Elizabeth,18,0,30,12
1714370134481,EDS 139,A00,507294,Fargason; Sharon Gayle,18,0,30,12
1714370134481,EDS 139,B00,507313,Pappas; Elizabeth,15,0,30,15
1714370135505,EDS 201,A00,507315,Staff,13,0,30,17
1714370136530,EDS 203,A01,507317,Halter; Christopher P.,12,0,30,18
1714370137553,EDS 204R,A01,507319,Halter; Christopher P.,0,3,30,30
1714370137553,EDS 204R,B01,507331,Heinzman; Erica M.,17,0,30,13
1714370138580,EDS 206R,A00,507332,Staff,0,4,30,30
1714370138580,EDS 206R,B00,507343,Staff,18,0,30,12
1714370139608,EDS 250,A00,507344,Hemans; Patricia Ann Benitez,22,0,40,18
1714370140632,EDS 281,A00,507345,Daly; Alan J.,18,0,18,0
1714370141660,EDS 284,A00,507350,Daly; Alan J.,16,0,16,0
1714370142684,EDS 286,A00,507359,Fine; Sarah,18,0,18,0
1714370143708,EDS 289C,A01,507361,Daly; Alan J.,18,0,18,0
1714370144734,EDS 290,A00,507366,Hofstetter; Carolyn,15,0,15,0
1714370145758,LIGM 5A,A00,507421,Fischer-Grunski; Eva K,18,0,20,2
1714370146782,LIGM 5B,A00,507423,Fischer-Grunski; Eva K,19,0,20,1
1714370147807,LIGM 5C,A00,507425,Fischer-Grunski; Eva K,19,0,20,1
1714370148832,LIIT 5AS,A00,507427,Carnelos; Chiara,20,0,20,0
1714370149861,LIIT 5BS,A00,507430,Carnelos; Chiara,20,0,20,0
1714370150886,LIIT 5CS,A00,507432,Carnelos; Chiara,20,0,20,0
1714370151914,LISP 5A,A00,507541,Munoz Sanchez; Alicia,11,0,20,9
1714370152939,LISP 5B,A00,507671,Munoz Sanchez; Alicia,9,0,20,11
1714370153968,LISP 5C,A00,507696,Munoz Sanchez; Alicia,9,0,20,11
1714370154993,MAE 197,001,528363,Boechler; Nicholas Sebastia,9998,0,9999,1
1714370156021,MATH 197,001,523477,Kedlaya; Kiran S.,9996,0,9999,3
1714370156021,MATH 197,002,563811,Zhang; Danna,9995,0,9999,4
1714370156021,MATH 197,003,628552,Dumitriu; Ioana,9998,0,9999,1
1714370157049,MCWP 40R,A00,518780,Staff,5,0,20,15
1714370157049,MCWP 40R,B00,518781,Staff,7,0,20,13
1714370157049,MCWP 40R,C00,518783,Staff,5,0,20,15
1714370158073,MCWP 50R,A00,518791,Staff,0,0,20,20
1714370158073,MCWP 50R,B00,518792,Staff,0,1,20,20
1714370158073,MCWP 50R,C00,518793,Staff,0,1,20,20
1714370158073,MCWP 50R,D00,518794,Staff,0,0,20,20
1714370158073,MCWP 50R,E00,518795,Staff,0,1,20,20
1714370158073,MCWP 50R,F00,518796,Staff,0,0,20,20
1714370158073,MCWP 50R,G00,518797,Staff,0,1,20,20
1714370159097,MMW 12R,A01,514034,Herbst; Matthew,0,1,16,16
1714370159097,MMW 12R,A02,514035,Herbst; Matthew,2,0,16,14
1714370160123,MMW 13R,A01,514037,Staff,0,4,16,16
1714370160123,MMW 13R,A02,514039,Staff,0,2,16,16
1714370160123,MMW 13R,A03,628519,Staff,0,2,16,16
1714370162175,SIO 295LS,A00,523233,Staff,12,0,30,18
1714370163199,SIO 295S,A00,523232,Staff,12,0,30,18
1714370164225,SIOC 290S,A01,637330,Merrifield; Mark A,27,0,30,3
1714370165251,SIOC 291S,A01,637333,Gabriel; Corey John,27,0,30,3
1714370166278,SOCI 117,A01,494376,Staff,0,3,5,5
1714370167303,WES 237B,A00,494380,Staff,9,0,20,11
1714370169370,AESE 279B,A00,494370,Wade; Jon P,0,0,33,33
1714370170394,AIP 197,001,627712,Vespa; Emanuel Ignacio,9998,0,9999,1
1714370171417,ANAR 135S,A00,494369,Braswell; Geoffrey E.,0,0,0,0
1714370172442,BENG 196,001,628496,Engler; Adam J.,9998,0,9999,1
1714370173470,CAT 124RS,A01,519847,Geibel; William,0,0,20,20
1714370174494,CAT 125RS,A01,515971,Geibel; William,0,0,20,20
1714370175520,CLRE 250,A00,511389,Morris; Sheldon,9993,0,9999,6
1714370176550,CLRE 251,A00,507176,Mehta; Ravindra L.,9993,0,9999,6
1714370176550,CLRE 251,B00,511410,Mehta; Ravindra L.,9998,0,9999,1
1714370177578,CLRE 252,A00,507189,Cuomo; Raphael Eduardo,9995,0,9999,4
1714370178607,CLRE 253,A00,507199,Vaida; Florin,9994,0,9999,5
1714370178607,CLRE 253,B00,507202,Vaida; Florin,9999,0,9999,0
1714370179632,CLRE 259,A00,507211,Patel; Hemal,9996,0,9999,3
1714370180656,CLRE 260,A00,507221,Cuomo; Raphael Eduardo,9999,0,9999,0
1714370181681,CLRE 297,001,507242,Cuomo; Raphael Eduardo,9999,0,9999,0
1714370182707,COGS 197,001,638244,Voytek; Bradley Thomas,9999,0,9999,0
1714370183732,CSE 191,A00,516875,Minnes Kemp; Mor Mia,9993,0,9999,6
1714370184756,CSE 197,001,637388,Minnes Kemp; Mor Mia,9998,0,9999,1
1714370185785,CSS 201S,A01,494383,Staff,35,0,35,0
1714370186810,CSS 202S,A01,494387,Staff,35,0,35,0
1714370187837,DSC 197,001,628532,Eldridge; Justin Matthew,9996,0,9999,3
1714370188864,EAP 100,A00,516065,Staff,9797,0,9999,202
1714370189890,ECE 45,A01,507414,Staff,33,0,60,27
1714370191943,ECE 111,A01,507420,Staff,19,0,50,31
1714370192967,ECE 197,001,548057,Sievenpiper; Daniel F.,9994,0,9999,5
1714370193995,EDS 115,A00,507243,Choi; Bailey Miyeon,12,0,28,16
1714370195024,EDS 117,A01,494379,Staff,0,2,30,30
1714370196049,EDS 125,A00,507246,Hopkins; Megan Beth,12,0,30,18
1714370197074,EDS 128A,A01,507264,Fargason; Sharon Gayle,14,0,26,12
1714370198101,EDS 128B,A01,507293,Pappas; Elizabeth,18,0,30,12
1714370199198,EDS 139,A00,507294,Fargason; Sharon Gayle,18,0,30,12
1714370199198,EDS 139,B00,507313,Pappas; Elizabeth,15,0,30,15
1714370200222,EDS 201,A00,507315,Staff,13,0,30,17
1714370201250,EDS 203,A01,507317,Halter; Christopher P.,12,0,30,18
1714370202276,EDS 204R,A01,507319,Halter; Christopher P.,0,3,30,30
1714370202276,EDS 204R,B01,507331,Heinzman; Erica M.,17,0,30,13
1714370203303,EDS 206R,A00,507332,Staff,0,4,30,30
1714370203303,EDS 206R,B00,507343,Staff,18,0,30,12
1714370204330,EDS 250,A00,507344,Hemans; Patricia Ann Benitez,22,0,40,18
1714370205354,EDS 281,A00,507345,Daly; Alan J.,18,0,18,0
1714370206378,EDS 284,A00,507350,Daly; Alan J.,16,0,16,0
1714370207403,EDS 286,A00,507359,Fine; Sarah,18,0,18,0
1714370208427,EDS 289C,A01,507361,Daly; Alan J.,18,0,18,0
1714370209458,EDS 290,A00,507366,Hofstetter; Carolyn,15,0,15,0
1714370210483,LIGM 5A,A00,507421,Fischer-Grunski; Eva K,18,0,20,2
1714370211507,LIGM 5B,A00,507423,Fischer-Grunski; Eva K,19,0,20,1
1714370212536,LIGM 5C,A00,507425,Fischer-Grunski; Eva K,19,0,20,1
1714370213565,LIIT 5AS,A00,507427,Carnelos; Chiara,20,0,20,0
1714370214593,LIIT 5BS,A00,507430,Carnelos; Chiara,20,0,20,0
1714370215617,LIIT 5CS,A00,507432,Carnelos; Chiara,20,0,20,0
1714370216642,LISP 5A,A00,507541,Munoz Sanchez; Alicia,11,0,20,9
1714370217668,LISP 5B,A00,507671,Munoz Sanchez; Alicia,9,0,20,11
1714370218693,LISP 5C,A00,507696,Munoz Sanchez; Alicia,9,0,20,11
1714370219717,MAE 197,001,528363,Boechler; Nicholas Sebastia,9998,0,9999,1
1714370220746,MATH 197,001,523477,Kedlaya; Kiran S.,9996,0,9999,3
1714370220746,MATH 197,002,563811,Zhang; Danna,9995,0,9999,4
1714370220746,MATH 197,003,628552,Dumitriu; Ioana,9998,0,9999,1
1714370221773,MCWP 40R,A00,518780,Staff,5,0,20,15
1714370221773,MCWP 40R,B00,518781,Staff,7,0,20,13
1714370221773,MCWP 40R,C00,518783,Staff,5,0,20,15
1714370222798,MCWP 50R,A00,518791,Staff,0,0,20,20
1714370222798,MCWP 50R,B00,518792,Staff,0,1,20,20
1714370222798,MCWP 50R,C00,518793,Staff,0,1,20,20
1714370222798,MCWP 50R,D00,518794,Staff,0,0,20,20
1714370222798,MCWP 50R,E00,518795,Staff,0,1,20,20
1714370222798,MCWP 50R,F00,518796,Staff,0,0,20,20
1714370222798,MCWP 50R,G00,518797,Staff,0,1,20,20
1714370223822,MMW 12R,A01,514034,Herbst; Matthew,0,1,16,16
1714370223822,MMW 12R,A02,514035,Herbst; Matthew,2,0,16,14
1714370224849,MMW 13R,A01,514037,Staff,0,4,16,16
1714370224849,MMW 13R,A02,514039,Staff,0,2,16,16
1714370224849,MMW 13R,A03,628519,Staff,0,2,16,16
1714370226901,SIO 295LS,A00,523233,Staff,12,0,30,18
1714370227925,SIO 295S,A00,523232,Staff,12,0,30,18
1714370228950,SIOC 290S,A01,637330,Merrifield; Mark A,27,0,30,3
1714370229974,SIOC 291S,A01,637333,Gabriel; Corey John,27,0,30,3
1714370231000,SOCI 117,A01,494376,Staff,0,3,5,5
1714370232026,WES 237B,A00,494380,Staff,9,0,20,11
1714370234089,AESE 279B,A00,494370,Wade; Jon P,0,0,33,33
1714370235113,AIP 197,001,627712,Vespa; Emanuel Ignacio,9998,0,9999,1
1714370236137,ANAR 135S,A00,494369,Braswell; Geoffrey E.,0,0,0,0
1714370237161,BENG 196,001,628496,Engler; Adam J.,9998,0,9999,1
1714370238189,CAT 124RS,A01,519847,Geibel; William,0,0,20,20
1714370239213,CAT 125RS,A01,515971,Geibel; William,0,0,20,20
1714370240239,CLRE 250,A00,511389,Morris; Sheldon,9993,0,9999,6
1714370241265,CLRE 251,A00,507176,Mehta; Ravindra L.,9993,0,9999,6
1714370241265,CLRE 251,B00,511410,Mehta; Ravindra L.,9998,0,9999,1
1714370242293,CLRE 252,A00,507189,Cuomo; Raphael Eduardo,9995,0,9999,4
1714370243318,CLRE 253,A00,507199,Vaida; Florin,9994,0,9999,5
1714370243318,CLRE 253,B00,507202,Vaida; Florin,9999,0,9999,0
1714370244341,CLRE 259,A00,507211,Patel; Hemal,9996,0,9999,3
1714370245368,CLRE 260,A00,507221,Cuomo; Raphael Eduardo,9999,0,9999,0
1714370246393,CLRE 297,001,507242,Cuomo; Raphael Eduardo,9999,0,9999,0
1714370247417,COGS 197,001,638244,Voytek; Bradley Thomas,9999,0,9999,0
1714370248442,CSE 191,A00,516875,Minnes Kemp; Mor Mia,9993,0,9999,6
1714370249468,CSE 197,001,637388,Minnes Kemp; Mor Mia,9998,0,9999,1
1714370250493,CSS 201S,A01,494383,Staff,35,0,35,0
1714370251521,CSS 202S,A01,494387,Staff,35,0,35,0
1714370252548,DSC 197,001,628532,Eldridge; Justin Matthew,9996,0,9999,3
1714370253574,EAP 100,A00,516065,Staff,9797,0,9999,202
1714370254599,ECE 45,A01,507414,Staff,33,0,60,27
1714370256647,ECE 111,A01,507420,Staff,19,0,50,31
1714370257727,ECE 197,001,548057,Sievenpiper; Daniel F.,9994,0,9999,5
1714370258751,EDS 115,A00,507243,Choi; Bailey Miyeon,12,0,28,16
1714370259778,EDS 117,A01,494379,Staff,0,2,30,30
1714370260805,EDS 125,A00,507246,Hopkins; Megan Beth,12,0,30,18
1714370261833,EDS 128A,A01,507264,Fargason; Sharon Gayle,14,0,26,12
1714370262857,EDS 128B,A01,507293,Pappas; Elizabeth,18,0,30,12
1714370263884,EDS 139,A00,507294,Fargason; Sharon Gayle,18,0,30,12
1714370263884,EDS 139,B00,507313,Pappas; Elizabeth,15,0,30,15
1714370264909,EDS 201,A00,507315,Staff,13,0,30,17
1714370265934,EDS 203,A01,507317,Halter; Christopher P.,12,0,30,18
1714370266963,EDS 204R,A01,507319,Halter; Christopher P.,0,3,30,30
1714370266963,EDS 204R,B01,507331,Heinzman; Erica M.,17,0,30,13
1714370267986,EDS 206R,A00,507332,Staff,0,4,30,30
1714370267986,EDS 206R,B00,507343,Staff,18,0,30,12
1714370269011,EDS 250,A00,507344,Hemans; Patricia Ann Benitez,22,0,40,18
1714370270036,EDS 281,A00,507345,Daly; Alan J.,18,0,18,0
1714370271063,EDS 284,A00,507350,Daly; Alan J.,16,0,16,0
1714370272089,EDS 286,A00,507359,Fine; Sarah,18,0,18,0
1714370273114,EDS 289C,A01,507361,Daly; Alan J.,18,0,18,0
1714370274141,EDS 290,A00,507366,Hofstetter; Carolyn,15,0,15,0
1714370275169,LIGM 5A,A00,507421,Fischer-Grunski; Eva K,18,0,20,2
1714370276195,LIGM 5B,A00,507423,Fischer-Grunski; Eva K,19,0,20,1
1714370277218,LIGM 5C,A00,507425,Fischer-Grunski; Eva K,19,0,20,1
1714370278248,LIIT 5AS,A00,507427,Carnelos; Chiara,20,0,20,0
1714370279278,LIIT 5BS,A00,507430,Carnelos; Chiara,20,0,20,0
1714370280302,LIIT 5CS,A00,507432,Carnelos; Chiara,20,0,20,0
1714370281333,LISP 5A,A00,507541,Munoz Sanchez; Alicia,11,0,20,9
1714370282360,LISP 5B,A00,507671,Munoz Sanchez; Alicia,9,0,20,11
1714370283388,LISP 5C,A00,507696,Munoz Sanchez; Alicia,9,0,20,11
1714370284412,MAE 197,001,528363,Boechler; Nicholas Sebastia,9998,0,9999,1
1714370285437,MATH 197,001,523477,Kedlaya; Kiran S.,9996,0,9999,3
1714370285437,MATH 197,002,563811,Zhang; Danna,9995,0,9999,4
1714370285437,MATH 197,003,628552,Dumitriu; Ioana,9998,0,9999,1
1714370286463,MCWP 40R,A00,518780,Staff,5,0,20,15
1714370286463,MCWP 40R,B00,518781,Staff,7,0,20,13
1714370286463,MCWP 40R,C00,518783,Staff,5,0,20,15
1714370287487,MCWP 50R,A00,518791,Staff,0,0,20,20
1714370287487,MCWP 50R,B00,518792,Staff,0,1,20,20
1714370287487,MCWP 50R,C00,518793,Staff,0,1,20,20
1714370287487,MCWP 50R,D00,518794,Staff,0,0,20,20
1714370287487,MCWP 50R,E00,518795,Staff,0,1,20,20
1714370287487,MCWP 50R,F00,518796,Staff,0,0,20,20
1714370287487,MCWP 50R,G00,518797,Staff,0,1,20,20
1714370288513,MMW 12R,A01,514034,Herbst; Matthew,0,1,16,16
1714370288513,MMW 12R,A02,514035,Herbst; Matthew,2,0,16,14
1714370289541,MMW 13R,A01,514037,Staff,0,4,16,16
1714370289541,MMW 13R,A02,514039,Staff,0,2,16,16
1714370289541,MMW 13R,A03,628519,Staff,0,2,16,16
1714370291598,SIO 295LS,A00,523233,Staff,12,0,30,18
1714370292622,SIO 295S,A00,523232,Staff,12,0,30,18
1714370293646,SIOC 290S,A01,637330,Merrifield; Mark A,27,0,30,3
1714370294674,SIOC 291S,A01,637333,Gabriel; Corey John,27,0,30,3
1714370295699,SOCI 117,A01,494376,Staff,0,3,5,5
1714370296726,WES 237B,A00,494380,Staff,9,0,20,11
1714370298785,AESE 279B,A00,494370,Wade; Jon P,0,0,33,33
1714370299811,AIP 197,001,627712,Vespa; Emanuel Ignacio,9998,0,9999,1
1714370300837,ANAR 135S,A00,494369,Braswell; Geoffrey E.,0,0,0,0
1714370301865,BENG 196,001,628496,Engler; Adam J.,9998,0,9999,1
1714370302944,CAT 124RS,A01,519847,Geibel; William,0,0,20,20
1714370303970,CAT 125RS,A01,515971,Geibel; William,0,0,20,20
1714370304996,CLRE 250,A00,511389,Morris; Sheldon,9993,0,9999,6
1714370306025,CLRE 251,A00,507176,Mehta; Ravindra L.,9993,0,9999,6
1714370306025,CLRE 251,B00,511410,Mehta; Ravindra L.,9998,0,9999,1
1714370307049,CLRE 252,A00,507189,Cuomo; Raphael Eduardo,9995,0,9999,4
1714370308077,CLRE 253,A00,507199,Vaida; Florin,9994,0,9999,5
1714370308077,CLRE 253,B00,507202,Vaida; Florin,9999,0,9999,0
1714370309104,CLRE 259,A00,507211,Patel; Hemal,9996,0,9999,3
1714370310130,CLRE 260,A00,507221,Cuomo; Raphael Eduardo,9999,0,9999,0
1714370311157,CLRE 297,001,507242,Cuomo; Raphael Eduardo,9999,0,9999,0
1714370312182,COGS 197,001,638244,Voytek; Bradley Thomas,9999,0,9999,0
1714370313210,CSE 191,A00,516875,Minnes Kemp; Mor Mia,9993,0,9999,6
1714370314237,CSE 197,001,637388,Minnes Kemp; Mor Mia,9998,0,9999,1
1714370315261,CSS 201S,A01,494383,Staff,35,0,35,0
1714370316286,CSS 202S,A01,494387,Staff,35,0,35,0
1714370317315,DSC 197,001,628532,Eldridge; Justin Matthew,9996,0,9999,3
1714370318340,EAP 100,A00,516065,Staff,9797,0,9999,202
1714370319368,ECE 45,A01,507414,Staff,33,0,60,27
1714370321422,ECE 111,A01,507420,Staff,19,0,50,31
1714370322448,ECE 197,001,548057,Sievenpiper; Daniel F.,9994,0,9999,5
1714370323473,EDS 115,A00,507243,Choi; Bailey Miyeon,12,0,28,16
1714370324501,EDS 117,A01,494379,Staff,0,2,30,30
1714370325531,EDS 125,A00,507246,Hopkins; Megan Beth,12,0,30,18
1714370326557,EDS 128A,A01,507264,Fargason; Sharon Gayle,14,0,26,12
1714370327581,EDS 128B,A01,507293,Pappas; Elizabeth,18,0,30,12
1714370328607,EDS 139,A00,507294,Fargason; Sharon Gayle,18,0,30,12
1714370328607,EDS 139,B00,507313,Pappas; Elizabeth,15,0,30,15
1714370329631,EDS 201,A00,507315,Staff,13,0,30,17
1714370330660,EDS 203,A01,507317,Halter; Christopher P.,12,0,30,18
1714370331684,EDS 204R,A01,507319,Halter; Christopher P.,0,3,30,30
1714370331684,EDS 204R,B01,507331,Heinzman; Erica M.,17,0,30,13
1714370332709,EDS 206R,A00,507332,Staff,0,4,30,30
1714370332709,EDS 206R,B00,507343,Staff,18,0,30,12
1714370333733,EDS 250,A00,507344,Hemans; Patricia Ann Benitez,22,0,40,18
1714370334762,EDS 281,A00,507345,Daly; Alan J.,18,0,18,0
1714370335788,EDS 284,A00,507350,Daly; Alan J.,16,0,16,0
1714370336817,EDS 286,A00,507359,Fine; Sarah,18,0,18,0
1714370337842,EDS 289C,A01,507361,Daly; Alan J.,18,0,18,0
1714370338871,EDS 290,A00,507366,Hofstetter; Carolyn,15,0,15,0
1714370339897,LIGM 5A,A00,507421,Fischer-Grunski; Eva K,18,0,20,2
1714370340923,LIGM 5B,A00,507423,Fischer-Grunski; Eva K,19,0,20,1
1714370341950,LIGM 5C,A00,507425,Fischer-Grunski; Eva K,19,0,20,1
1714370342978,LIIT 5AS,A00,507427,Carnelos; Chiara,20,0,20,0
1714370344008,LIIT 5BS,A00,507430,Carnelos; Chiara,20,0,20,0
1714370345036,LIIT 5CS,A00,507432,Carnelos; Chiara,20,0,20,0
1714370346062,LISP 5A,A00,507541,Munoz Sanchez; Alicia,11,0,20,9
1714370347089,LISP 5B,A00,507671,Munoz Sanchez; Alicia,9,0,20,11
1714370348113,LISP 5C,A00,507696,Munoz Sanchez; Alicia,9,0,20,11
1714370349137,MAE 197,001,528363,Boechler; Nicholas Sebastia,9998,0,9999,1
1714370350162,MATH 197,001,523477,Kedlaya; Kiran S.,9996,0,9999,3
1714370350162,MATH 197,002,563811,Zhang; Danna,9995,0,9999,4
1714370350162,MATH 197,003,628552,Dumitriu; Ioana,9998,0,9999,1
1714370351186,MCWP 40R,A00,518780,Staff,5,0,20,15
1714370351186,MCWP 40R,B00,518781,Staff,7,0,20,13
1714370351186,MCWP 40R,C00,518783,Staff,5,0,20,15
1714370352214,MCWP 50R,A00,518791,Staff,0,0,20,20
1714370352214,MCWP 50R,B00,518792,Staff,0,1,20,20
1714370352214,MCWP 50R,C00,518793,Staff,0,1,20,20
1714370352214,MCWP 50R,D00,518794,Staff,0,0,20,20
1714370352214,MCWP 50R,E00,518795,Staff,0,1,20,20
1714370352214,MCWP 50R,F00,518796,Staff,0,0,20,20
1714370352214,MCWP 50R,G00,518797,Staff,0,1,20,20
1714370353239,MMW 12R,A01,514034,Herbst; Matthew,0,1,16,16
1714370353239,MMW 12R,A02,514035,Herbst; Matthew,2,0,16,14
1714370354266,MMW 13R,A01,514037,Staff,0,4,16,16
1714370354266,MMW 13R,A02,514039,Staff,0,2,16,16
1714370354266,MMW 13R,A03,628519,Staff,0,2,16,16
1714370356315,SIO 295LS,A00,523233,Staff,12,0,30,18
1714370357342,SIO 295S,A00,523232,Staff,12,0,30,18
1714370358375,SIOC 290S,A01,637330,Merrifield; Mark A,27,0,30,3
1714370359401,SIOC 291S,A01,637333,Gabriel; Corey John,27,0,30,3
1714370360426,SOCI 117,A01,494376,Staff,0,3,5,5
1714370361452,WES 237B,A00,494380,Staff,9,0,20,11
1714370363518,AESE 279B,A00,494370,Wade; Jon P,0,0,33,33
1714370364544,AIP 197,001,627712,Vespa; Emanuel Ignacio,9998,0,9999,1
1714370365570,ANAR 135S,A00,494369,Braswell; Geoffrey E.,0,0,0,0
1714370366597,BENG 196,001,628496,Engler; Adam J.,9998,0,9999,1
1714370367626,CAT 124RS,A01,519847,Geibel; William,0,0,20,20
1714370368653,CAT 125RS,A01,515971,Geibel; William,0,0,20,20
1714370369679,CLRE 250,A00,511389,Morris; Sheldon,9993,0,9999,6
1714370370710,CLRE 251,A00,507176,Mehta; Ravindra L.,9993,0,9999,6
1714370370710,CLRE 251,B00,511410,Mehta; Ravindra L.,9998,0,9999,1
1714370371736,CLRE 252,A00,507189,Cuomo; Raphael Eduardo,9995,0,9999,4
1714370372817,CLRE 253,A00,507199,Vaida; Florin,9994,0,9999,5
1714370372817,CLRE 253,B00,507202,Vaida; Florin,9999,0,9999,0
1714370373843,CLRE 259,A00,507211,Patel; Hemal,9996,0,9999,3
1714370374868,CLRE 260,A00,507221,Cuomo; Raphael Eduardo,9999,0,9999,0
1714370375892,CLRE 297,001,507242,Cuomo; Raphael Eduardo,9999,0,9999,0
1714370376917,COGS 197,001,638244,Voytek; Bradley Thomas,9999,0,9999,0
1714370377942,CSE 191,A00,516875,Minnes Kemp; Mor Mia,9993,0,9999,6
1714370378967,CSE 197,001,637388,Minnes Kemp; Mor Mia,9998,0,9999,1
1714370379994,CSS 201S,A01,494383,Staff,35,0,35,0
1714370381020,CSS 202S,A01,494387,Staff,35,0,35,0
1714370382045,DSC 197,001,628532,Eldridge; Justin Matthew,9996,0,9999,3
1714370383073,EAP 100,A00,516065,Staff,9797,0,9999,202
1714370384098,ECE 45,A01,507414,Staff,33,0,60,27
1714370386150,ECE 111,A01,507420,Staff,19,0,50,31
1714370387174,ECE 197,001,548057,Sievenpiper; Daniel F.,9994,0,9999,5
1714370388201,EDS 115,A00,507243,Choi; Bailey Miyeon,12,0,28,16
1714370389226,EDS 117,A01,494379,Staff,0,2,30,30
1714370390251,EDS 125,A00,507246,Hopkins; Megan Beth,12,0,30,18
1714370391280,EDS 128A,A01,507264,Fargason; Sharon Gayle,14,0,26,12
1714370392305,EDS 128B,A01,507293,Pappas; Elizabeth,18,0,30,12
1714370393331,EDS 139,A00,507294,Fargason; Sharon Gayle,18,0,30,12
1714370393331,EDS 139,B00,507313,Pappas; Elizabeth,15,0,30,15
1714370394357,EDS 201,A00,507315,Staff,13,0,30,17
1714370395381,EDS 203,A01,507317,Halter; Christopher P.,12,0,30,18
1714370396406,EDS 204R,A01,507319,Halter; Christopher P.,0,3,30,30
1714370396406,EDS 204R,B01,507331,Heinzman; Erica M.,17,0,30,13
1714370397430,EDS 206R,A00,507332,Staff,0,4,30,30
1714370397430,EDS 206R,B00,507343,Staff,18,0,30,12
1714370398455,EDS 250,A00,507344,Hemans; Patricia Ann Benitez,22,0,40,18
1714370399483,EDS 281,A00,507345,Daly; Alan J.,18,0,18,0
1714370400507,EDS 284,A00,507350,Daly; Alan J.,16,0,16,0
1714370401534,EDS 286,A00,507359,Fine; Sarah,18,0,18,0
1714370402562,EDS 289C,A01,507361,Daly; Alan J.,18,0,18,0
1714370403586,EDS 290,A00,507366,Hofstetter; Carolyn,15,0,15,0
1714370404611,LIGM 5A,A00,507421,Fischer-Grunski; Eva K,18,0,20,2
1714370405637,LIGM 5B,A00,507423,Fischer-Grunski; Eva K,19,0,20,1
1714370406722,LIGM 5C,A00,507425,Fischer-Grunski; Eva K,19,0,20,1
1714370407749,LIIT 5AS,A00,507427,Carnelos; Chiara,20,0,20,0
1714370408773,LIIT 5BS,A00,507430,Carnelos; Chiara,20,0,20,0
1714370409800,LIIT 5CS,A00,507432,Carnelos; Chiara,20,0,20,0
1714370410827,LISP 5A,A00,507541,Munoz Sanchez; Alicia,11,0,20,9
1714370411856,LISP 5B,A00,507671,Munoz Sanchez; Alicia,9,0,20,11
1714370412881,LISP 5C,A00,507696,Munoz Sanchez; Alicia,9,0,20,11
1714370413914,MAE 197,001,528363,Boechler; Nicholas Sebastia,9998,0,9999,1
1714370414945,MATH 197,001,523477,Kedlaya; Kiran S.,9996,0,9999,3
1714370414945,MATH 197,002,563811,Zhang; Danna,9995,0,9999,4
1714370414945,MATH 197,003,628552,Dumitriu; Ioana,9998,0,9999,1
1714370415972,MCWP 40R,A00,518780,Staff,5,0,20,15
1714370415972,MCWP 40R,B00,518781,Staff,7,0,20,13
1714370415972,MCWP 40R,C00,518783,Staff,5,0,20,15
1714370417001,MCWP 50R,A00,518791,Staff,0,0,20,20
1714370417001,MCWP 50R,B00,518792,Staff,0,1,20,20
1714370417001,MCWP 50R,C00,518793,Staff,0,1,20,20
1714370417001,MCWP 50R,D00,518794,Staff,0,0,20,20
1714370417001,MCWP 50R,E00,518795,Staff,0,1,20,20
1714370417001,MCWP 50R,F00,518796,Staff,0,0,20,20
1714370417001,MCWP 50R,G00,518797,Staff,0,1,20,20
1714370418028,MMW 12R,A01,514034,Herbst; Matthew,0,1,16,16
1714370418028,MMW 12R,A02,514035,Herbst; Matthew,2,0,16,14
1714370419057,MMW 13R,A01,514037,Staff,0,4,16,16
1714370419057,MMW 13R,A02,514039,Staff,0,2,16,16
1714370419057,MMW 13R,A03,628519,Staff,0,2,16,16
1714370421108,SIO 295LS,A00,523233,Staff,12,0,30,18
1714370422135,SIO 295S,A00,523232,Staff,12,0,30,18
1714370423165,SIOC 290S,A01,637330,Merrifield; Mark A,27,0,30,3
1714370424195,SIOC 291S,A01,637333,Gabriel; Corey John,27,0,30,3
1714370425220,SOCI 117,A01,494376,Staff,0,3,5,5
1714370426245,WES 237B,A00,494380,Staff,9,0,20,11
1714370428303,AESE 279B,A00,494370,Wade; Jon P,0,0,33,33
1714370429331,AIP 197,001,627712,Vespa; Emanuel Ignacio,9998,0,9999,1
1714370430360,ANAR 135S,A00,494369,Braswell; Geoffrey E.,0,0,0,0
1714370431387,BENG 196,001,628496,Engler; Adam J.,9998,0,9999,1
1714370432412,CAT 124RS,A01,519847,Geibel; William,0,0,20,20
1714370433437,CAT 125RS,A01,515971,Geibel; William,0,0,20,20
1714370434460,CLRE 250,A00,511389,Morris; Sheldon,9993,0,9999,6
1714370435489,CLRE 251,A00,507176,Mehta; Ravindra L.,9993,0,9999,6
1714370435489,CLRE 251,B00,511410,Mehta; Ravindra L.,9998,0,9999,1
1714370436516,CLRE 252,A00,507189,Cuomo; Raphael Eduardo,9995,0,9999,4
1714370437546,CLRE 253,A00,507199,Vaida; Florin,9994,0,9999,5
1714370437546,CLRE 253,B00,507202,Vaida; Florin,9999,0,9999,0
1714370438577,CLRE 259,A00,507211,Patel; Hemal,9996,0,9999,3
1714370439601,CLRE 260,A00,507221,Cuomo; Raphael Eduardo,9999,0,9999,0
1714370440630,CLRE 297,001,507242,Cuomo; Raphael Eduardo,9999,0,9999,0
1714370441657,COGS 197,001,638244,Voytek; Bradley Thomas,9999,0,9999,0
1714370442683,CSE 191,A00,516875,Minnes Kemp; Mor Mia,9993,0,9999,6
1714370443709,CSE 197,001,637388,Minnes Kemp; Mor Mia,9998,0,9999,1
1714370444734,CSS 201S,A01,494383,Staff,35,0,35,0
1714370445765,CSS 202S,A01,494387,Staff,35,0,35,0
1714370446793,DSC 197,001,628532,Eldridge; Justin Matthew,9996,0,9999,3
1714370447817,EAP 100,A00,516065,Staff,9797,0,9999,202
1714370448846,ECE 45,A01,507414,Staff,33,0,60,27
1714370450897,ECE 111,A01,507420,Staff,19,0,50,31
1714370451925,ECE 197,001,548057,Sievenpiper; Daniel F.,9994,0,9999,5
1714370452950,EDS 115,A00,507243,Choi; Bailey Miyeon,12,0,28,16
1714370453974,EDS 117,A01,494379,Staff,0,2,30,30
1714370454999,EDS 125,A00,507246,Hopkins; Megan Beth,12,0,30,18
1714370456025,EDS 128A,A01,507264,Fargason; Sharon Gayle,14,0,26,12
1714370457054,EDS 128B,A01,507293,Pappas; Elizabeth,18,0,30,12
1714370458078,EDS 139,A00,507294,Fargason; Sharon Gayle,18,0,30,12
1714370458078,EDS 139,B00,507313,Pappas; Elizabeth,15,0,30,15
1714370459105,EDS 201,A00,507315,Staff,13,0,30,17
1714370460143,EDS 203,A01,507317,Halter; Christopher P.,12,0,30,18
1714370461174,EDS 204R,A01,507319,Halter; Christopher P.,0,3,30,30
1714370461174,EDS 204R,B01,507331,Heinzman; Erica M.,17,0,30,13
1714370462199,EDS 206R,A00,507332,Staff,0,4,30,30
1714370462199,EDS 206R,B00,507343,Staff,18,0,30,12
1714370463224,EDS 250,A00,507344,Hemans; Patricia Ann Benitez,22,0,40,18
1714370464250,EDS 281,A00,507345,Daly; Alan J.,18,0,18,0
1714370465276,EDS 284,A00,507350,Daly; Alan J.,16,0,16,0
1714370466300,EDS 286,A00,507359,Fine; Sarah,18,0,18,0
1714370467324,EDS 289C,A01,507361,Daly; Alan J.,18,0,18,0
1714370468351,EDS 290,A00,507366,Hofstetter; Carolyn,15,0,15,0
1714370469381,LIGM 5A,A00,507421,Fischer-Grunski; Eva K,18,0,20,2
1714370470405,LIGM 5B,A00,507423,Fischer-Grunski; Eva K,19,0,20,1
1714370471431,LIGM 5C,A00,507425,Fischer-Grunski; Eva K,19,0,20,1
1714370472455,LIIT 5AS,A00,507427,Carnelos; Chiara,20,0,20,0
1714370473491,LIIT 5BS,A00,507430,Carnelos; Chiara,20,0,20,0
1714370474525,LIIT 5CS,A00,507432,Carnelos; Chiara,20,0,20,0
1714370475548,LISP 5A,A00,507541,Munoz Sanchez; Alicia,11,0,20,9
1714370476576,LISP 5B,A00,507671,Munoz Sanchez; Alicia,9,0,20,11
1714370477601,LISP 5C,A00,507696,Munoz Sanchez; Alicia,9,0,20,11
1714370478627,MAE 197,001,528363,Boechler; Nicholas Sebastia,9998,0,9999,1
1714370479652,MATH 197,001,523477,Kedlaya; Kiran S.,9996,0,9999,3
1714370479652,MATH 197,002,563811,Zhang; Danna,9995,0,9999,4
1714370479652,MATH 197,003,628552,Dumitriu; Ioana,9998,0,9999,1
1714370480676,MCWP 40R,A00,518780,Staff,5,0,20,15
1714370480676,MCWP 40R,B00,518781,Staff,7,0,20,13
1714370480676,MCWP 40R,C00,518783,Staff,5,0,20,15
1714370481705,MCWP 50R,A00,518791,Staff,0,0,20,20
1714370481705,MCWP 50R,B00,518792,Staff,0,1,20,20
1714370481705,MCWP 50R,C00,518793,Staff,0,1,20,20
1714370481705,MCWP 50R,D00,518794,Staff,0,0,20,20
1714370481705,MCWP 50R,E00,518795,Staff,0,1,20,20
1714370481705,MCWP 50R,F00,518796,Staff,0,0,20,20
1714370481705,MCWP 50R,G00,518797,Staff,0,1,20,20
1714370482730,MMW 12R,A01,514034,Herbst; Matthew,0,1,16,16
1714370482730,MMW 12R,A02,514035,Herbst; Matthew,2,0,16,14
1714370483765,MMW 13R,A01,514037,Staff,0,4,16,16
1714370483765,MMW 13R,A02,514039,Staff,0,2,16,16
1714370483765,MMW 13R,A03,628519,Staff,0,2,16,16
1714370485817,SIO 295LS,A00,523233,Staff,12,0,30,18
1714370486844,SIO 295S,A00,523232,Staff,12,0,30,18
1714370487872,SIOC 290S,A01,637330,Merrifield; Mark A,27,0,30,3
1714370488897,SIOC 291S,A01,637333,Gabriel; Corey John,27,0,30,3
1714370489925,SOCI 117,A01,494376,Staff,0,3,5,5
1714370490949,WES 237B,A00,494380,Staff,9,0,20,11
1714370493004,AESE 279B,A00,494370,Wade; Jon P,0,0,33,33
1714370494028,AIP 197,001,627712,Vespa; Emanuel Ignacio,9998,0,9999,1
1714370495054,ANAR 135S,A00,494369,Braswell; Geoffrey E.,0,0,0,0
1714370496078,BENG 196,001,628496,Engler; Adam J.,9998,0,9999,1
1714370497105,CAT 124RS,A01,519847,Geibel; William,0,0,20,20
1714370498134,CAT 125RS,A01,515971,Geibel; William,0,0,20,20
1714370499162,CLRE 250,A00,511389,Morris; Sheldon,9993,0,9999,6
1714370500190,CLRE 251,A00,507176,Mehta; Ravindra L.,9993,0,9999,6
1714370500190,CLRE 251,B00,511410,Mehta; Ravindra L.,9998,0,9999,1
1714370501217,CLRE 252,A00,507189,Cuomo; Raphael Eduardo,9995,0,9999,4
1714370502244,CLRE 253,A00,507199,Vaida; Florin,9994,0,9999,5
1714370502244,CLRE 253,B00,507202,Vaida; Florin,9999,0,9999,0
1714370503270,CLRE 259,A00,507211,Patel; Hemal,9996,0,9999,3
1714370504298,CLRE 260,A00,507221,Cuomo; Raphael Eduardo,9999,0,9999,0
1714370505323,CLRE 297,001,507242,Cuomo; Raphael Eduardo,9999,0,9999,0
1714370506347,COGS 197,001,638244,Voytek; Bradley Thomas,9999,0,9999,0
1714370507371,CSE 191,A00,516875,Minnes Kemp; Mor Mia,9993,0,9999,6
1714370508398,CSE 197,001,637388,Minnes Kemp; Mor Mia,9998,0,9999,1
1714370509424,CSS 201S,A01,494383,Staff,35,0,35,0
1714370510504,CSS 202S,A01,494387,Staff,35,0,35,0
1714370511529,DSC 197,001,628532,Eldridge; Justin Matthew,9996,0,9999,3
1714370512555,EAP 100,A00,516065,Staff,9797,0,9999,202
1714370513580,ECE 45,A01,507414,Staff,33,0,60,27
1714370515631,ECE 111,A01,507420,Staff,19,0,50,31
1714370516658,ECE 197,001,548057,Sievenpiper; Daniel F.,9994,0,9999,5
1714370517685,EDS 115,A00,507243,Choi; Bailey Miyeon,12,0,28,16
1714370518708,EDS 117,A01,494379,Staff,0,2,30,30
1714370519733,EDS 125,A00,507246,Hopkins; Megan Beth,12,0,30,18
1714370520765,EDS 128A,A01,507264,Fargason; Sharon Gayle,14,0,26,12
1714370521790,EDS 128B,A01,507293,Pappas; Elizabeth,18,0,30,12
1714370522814,EDS 139,A00,507294,Fargason; Sharon Gayle,18,0,30,12
1714370522814,EDS 139,B00,507313,Pappas; Elizabeth,15,0,30,15
1714370523840,EDS 201,A00,507315,Staff,13,0,30,17
1714370524872,EDS 203,A01,507317,Halter; Christopher P.,12,0,30,18
1714370525897,EDS 204R,A01,507319,Halter; Christopher P.,0,3,30,30
1714370525897,EDS 204R,B01,507331,Heinzman; Erica M.,17,0,30,13
1714370526921,EDS 206R,A00,507332,Staff,0,4,30,30
1714370526921,EDS 206R,B00,507343,Staff,18,0,30,12
1714370527948,EDS 250,A00,507344,Hemans; Patricia Ann Benitez,22,0,40,18
1714370528973,EDS 281,A00,507345,Daly; Alan J.,18,0,18,0
1714370530000,EDS 284,A00,507350,Daly; Alan J.,16,0,16,0
1714370531026,EDS 286,A00,507359,Fine; Sarah,18,0,18,0
1714370532052,EDS 289C,A01,507361,Daly; Alan J.,18,0,18,0
1714370533077,EDS 290,A00,507366,Hofstetter; Carolyn,15,0,15,0
1714370534101,LIGM 5A,A00,507421,Fischer-Grunski; Eva K,18,0,20,2
1714370535128,LIGM 5B,A00,507423,Fischer-Grunski; Eva K,19,0,20,1
1714370536153,LIGM 5C,A00,507425,Fischer-Grunski; Eva K,19,0,20,1
1714370537181,LIIT 5AS,A00,507427,Carnelos; Chiara,20,0,20,0
1714370538208,LIIT 5BS,A00,507430,Carnelos; Chiara,20,0,20,0
1714370539232,LIIT 5CS,A00,507432,Carnelos; Chiara,20,0,20,0
1714370540257,LISP 5A,A00,507541,Munoz Sanchez; Alicia,11,0,20,9
1714370541282,LISP 5B,A00,507671,Munoz Sanchez; Alicia,9,0,20,11
1714370542309,LISP 5C,A00,507696,Munoz Sanchez; Alicia,9,0,20,11
1714370543334,MAE 197,001,528363,Boechler; Nicholas Sebastia,9998,0,9999,1
1714370544360,MATH 197,001,523477,Kedlaya; Kiran S.,9996,0,9999,3
1714370544360,MATH 197,002,563811,Zhang; Danna,9995,0,9999,4
1714370544360,MATH 197,003,628552,Dumitriu; Ioana,9998,0,9999,1
1714370545385,MCWP 40R,A00,518780,Staff,5,0,20,15
1714370545385,MCWP 40R,B00,518781,Staff,7,0,20,13
1714370545385,MCWP 40R,C00,518783,Staff,5,0,20,15
1714370546419,MCWP 50R,A00,518791,Staff,0,0,20,20
1714370546419,MCWP 50R,B00,518792,Staff,0,1,20,20
1714370546419,MCWP 50R,C00,518793,Staff,0,1,20,20
1714370546419,MCWP 50R,D00,518794,Staff,0,0,20,20
1714370546419,MCWP 50R,E00,518795,Staff,0,1,20,20
1714370546419,MCWP 50R,F00,518796,Staff,0,0,20,20
1714370546419,MCWP 50R,G00,518797,Staff,0,1,20,20
1714370547447,MMW 12R,A01,514034,Herbst; Matthew,0,1,16,16
1714370547447,MMW 12R,A02,514035,Herbst; Matthew,2,0,16,14
1714370548472,MMW 13R,A01,514037,Staff,0,4,16,16
1714370548472,MMW 13R,A02,514039,Staff,0,2,16,16
1714370548472,MMW 13R,A03,628519,Staff,0,2,16,16
1714370550527,SIO 295LS,A00,523233,Staff,12,0,30,18
1714370551550,SIO 295S,A00,523232,Staff,12,0,30,18
1714370552575,SIOC 290S,A01,637330,Merrifield; Mark A,27,0,30,3
1714370553606,SIOC 291S,A01,637333,Gabriel; Corey John,27,0,30,3
1714370554632,SOCI 117,A01,494376,Staff,0,3,5,5
1714370555660,WES 237B,A00,494380,Staff,9,0,20,11
1714370557731,AESE 279B,A00,494370,Wade; Jon P,0,0,33,33
1714370558756,AIP 197,001,627712,Vespa; Emanuel Ignacio,9998,0,9999,1
1714370559781,ANAR 135S,A00,494369,Braswell; Geoffrey E.,0,0,0,0
1714370560806,BENG 196,001,628496,Engler; Adam J.,9998,0,9999,1
1714370561831,CAT 124RS,A01,519847,Geibel; William,0,0,20,20
1714370562866,CAT 125RS,A01,515971,Geibel; William,0,0,20,20
1714370563897,CLRE 250,A00,511389,Morris; Sheldon,9993,0,9999,6
1714370564927,CLRE 251,A00,507176,Mehta; Ravindra L.,9993,0,9999,6
1714370564927,CLRE 251,B00,511410,Mehta; Ravindra L.,9998,0,9999,1
1714370565957,CLRE 252,A00,507189,Cuomo; Raphael Eduardo,9995,0,9999,4
1714370566989,CLRE 253,A00,507199,Vaida; Florin,9994,0,9999,5
1714370566989,CLRE 253,B00,507202,Vaida; Florin,9999,0,9999,0
1714370568013,CLRE 259,A00,507211,Patel; Hemal,9996,0,9999,3
1714370569042,CLRE 260,A00,507221,Cuomo; Raphael Eduardo,9999,0,9999,0
1714370570066,CLRE 297,001,507242,Cuomo; Raphael Eduardo,9999,0,9999,0
1714370571091,COGS 197,001,638244,Voytek; Bradley Thomas,9999,0,9999,0
1714370572117,CSE 191,A00,516875,Minnes Kemp; Mor Mia,9993,0,9999,6
1714370573143,CSE 197,001,637388,Minnes Kemp; Mor Mia,9998,0,9999,1
1714370574175,CSS 201S,A01,494383,Staff,35,0,35,0
1714370575204,CSS 202S,A01,494387,Staff,35,0,35,0
1714370576232,DSC 197,001,628532,Eldridge; Justin Matthew,9996,0,9999,3
1714370577259,EAP 100,A00,516065,Staff,9797,0,9999,202
1714370578285,ECE 45,A01,507414,Staff,33,0,60,27
1714370580336,ECE 111,A01,507420,Staff,19,0,50,31
1714370581363,ECE 197,001,548057,Sievenpiper; Daniel F.,9994,0,9999,5
1714370582393,EDS 115,A00,507243,Choi; Bailey Miyeon,12,0,28,16
1714370583425,EDS 117,A01,494379,Staff,0,2,30,30
1714370584452,EDS 125,A00,507246,Hopkins; Megan Beth,12,0,30,18
1714370585479,EDS 128A,A01,507264,Fargason; Sharon Gayle,14,0,26,12
1714370586508,EDS 128B,A01,507293,Pappas; Elizabeth,18,0,30,12
1714370587531,EDS 139,A00,507294,Fargason; Sharon Gayle,18,0,30,12
1714370587531,EDS 139,B00,507313,Pappas; Elizabeth,15,0,30,15
1714370588558,EDS 201,A00,507315,Staff,13,0,30,17
1714370589586,EDS 203,A01,507317,Halter; Christopher P.,12,0,30,18
1714370590614,EDS 204R,A01,507319,Halter; Christopher P.,0,3,30,30
1714370590614,EDS 204R,B01,507331,Heinzman; Erica M.,17,0,30,13
1714370591643,EDS 206R,A00,507332,Staff,0,4,30,30
1714370591643,EDS 206R,B00,507343,Staff,18,0,30,12
1714370592677,EDS 250,A00,507344,Hemans; Patricia Ann Benitez,22,0,40,18
1714370593701,EDS 281,A00,507345,Daly; Alan J.,18,0,18,0
1714370594727,EDS 284,A00,507350,Daly; Alan J.,16,0,16,0
1714370595752,EDS 286,A00,507359,Fine; Sarah,18,0,18,0
1714370596776,EDS 289C,A01,507361,Daly; Alan J.,18,0,18,0
1714370597801,EDS 290,A00,507366,Hofstetter; Carolyn,15,0,15,0
1714370598828,LIGM 5A,A00,507421,Fischer-Grunski; Eva K,18,0,20,2
1714370599853,LIGM 5B,A00,507423,Fischer-Grunski; Eva K,19,0,20,1
1714370600882,LIGM 5C,A00,507425,Fischer-Grunski; Eva K,19,0,20,1
1714370601907,LIIT 5AS,A00,507427,Carnelos; Chiara,20,0,20,0
1714370602942,LIIT 5BS,A00,507430,Carnelos; Chiara,20,0,20,0
1714370603968,LIIT 5CS,A00,507432,Carnelos; Chiara,20,0,20,0
1714370604993,LISP 5A,A00,507541,Munoz Sanchez; Alicia,11,0,20,9
1714370606020,LISP 5B,A00,507671,Munoz Sanchez; Alicia,9,0,20,11
1714370607045,LISP 5C,A00,507696,Munoz Sanchez; Alicia,9,0,20,11
1714370608069,MAE 197,001,528363,Boechler; Nicholas Sebastia,9998,0,9999,1
1714370609097,MATH 197,001,523477,Kedlaya; Kiran S.,9996,0,9999,3
1714370609097,MATH 197,002,563811,Zhang; Danna,9995,0,9999,4
1714370609097,MATH 197,003,628552,Dumitriu; Ioana,9998,0,9999,1
1714370610122,MCWP 40R,A00,518780,Staff,5,0,20,15
1714370610122,MCWP 40R,B00,518781,Staff,7,0,20,13
1714370610122,MCWP 40R,C00,518783,Staff,5,0,20,15
1714370611153,MCWP 50R,A00,518791,Staff,0,0,20,20
1714370611153,MCWP 50R,B00,518792,Staff,0,1,20,20
1714370611153,MCWP 50R,C00,518793,Staff,0,1,20,20
1714370611153,MCWP 50R,D00,518794,Staff,0,0,20,20
1714370611153,MCWP 50R,E00,518795,Staff,0,1,20,20
1714370611153,MCWP 50R,F00,518796,Staff,0,0,20,20
1714370611153,MCWP 50R,G00,518797,Staff,0,1,20,20
1714370612181,MMW 12R,A01,514034,Herbst; Matthew,0,1,16,16
1714370612181,MMW 12R,A02,514035,Herbst; Matthew,2,0,16,14
1714370613212,MMW 13R,A01,514037,Staff,0,4,16,16
1714370613212,MMW 13R,A02,514039,Staff,0,2,16,16
1714370613212,MMW 13R,A03,628519,Staff,0,2,16,16
1714370615329,SIO 295LS,A00,523233,Staff,12,0,30,18
1714370616355,SIO 295S,A00,523232,Staff,12,0,30,18
1714370617379,SIOC 290S,A01,637330,Merrifield; Mark A,27,0,30,3
1714370618418,SIOC 291S,A01,637333,Gabriel; Corey John,27,0,30,3
1714370619443,SOCI 117,A01,494376,Staff,0,3,5,5
1714370620470,WES 237B,A00,494380,Staff,9,0,20,11
1714370622534,AESE 279B,A00,494370,Wade; Jon P,0,0,33,33
1714370623559,AIP 197,001,627712,Vespa; Emanuel Ignacio,9998,0,9999,1
1714370624584,ANAR 135S,A00,494369,Braswell; Geoffrey E.,0,0,0,0
1714370625613,BENG 196,001,628496,Engler; Adam J.,9998,0,9999,1
1714370626643,CAT 124RS,A01,519847,Geibel; William,0,0,20,20
1714370627668,CAT 125RS,A01,515971,Geibel; William,0,0,20,20
1714370628693,CLRE 250,A00,511389,Morris; Sheldon,9993,0,9999,6
1714370629720,CLRE 251,A00,507176,Mehta; Ravindra L.,9993,0,9999,6
1714370629720,CLRE 251,B00,511410,Mehta; Ravindra L.,9998,0,9999,1
1714370630748,CLRE 252,A00,507189,Cuomo; Raphael Eduardo,9995,0,9999,4
1714370631777,CLRE 253,A00,507199,Vaida; Florin,9994,0,9999,5
1714370631777,CLRE 253,B00,507202,Vaida; Florin,9999,0,9999,0
1714370632806,CLRE 259,A00,507211,Patel; Hemal,9996,0,9999,3
1714370633832,CLRE 260,A00,507221,Cuomo; Raphael Eduardo,9999,0,9999,0
1714370634857,CLRE 297,001,507242,Cuomo; Raphael Eduardo,9999,0,9999,0
1714370635885,COGS 197,001,638244,Voytek; Bradley Thomas,9999,0,9999,0
1714370636913,CSE 191,A00,516875,Minnes Kemp; Mor Mia,9993,0,9999,6
1714370637939,CSE 197,001,637388,Minnes Kemp; Mor Mia,9998,0,9999,1
1714370638966,CSS 201S,A01,494383,Staff,35,0,35,0
1714370639993,CSS 202S,A01,494387,Staff,35,0,35,0
1714370641018,DSC 197,001,628532,Eldridge; Justin Matthew,9996,0,9999,3
1714370642048,EAP 100,A00,516065,Staff,9797,0,9999,202
1714370643075,ECE 45,A01,507414,Staff,33,0,60,27
1714370645127,ECE 111,A01,507420,Staff,19,0,50,31
1714370646152,ECE 197,001,548057,Sievenpiper; Daniel F.,9994,0,9999,5
1714370647179,EDS 115,A00,507243,Choi; Bailey Miyeon,12,0,28,16
1714370648208,EDS 117,A01,494379,Staff,0,2,30,30
1714370649233,EDS 125,A00,507246,Hopkins; Megan Beth,12,0,30,18
1714370650258,EDS 128A,A01,507264,Fargason; Sharon Gayle,14,0,26,12
1714370651285,EDS 128B,A01,507293,Pappas; Elizabeth,18,0,30,12
1714370652309,EDS 139,A00,507294,Fargason; Sharon Gayle,18,0,30,12
1714370652309,EDS 139,B00,507313,Pappas; Elizabeth,15,0,30,15
1714370653336,EDS 201,A00,507315,Staff,13,0,30,17
1714370654360,EDS 203,A01,507317,Halter; Christopher P.,12,0,30,18
1714370655389,EDS 204R,A01,507319,Halter; Christopher P.,0,3,30,30
1714370655389,EDS 204R,B01,507331,Heinzman; Erica M.,17,0,30,13
1714370656415,EDS 206R,A00,507332,Staff,0,4,30,30
1714370656415,EDS 206R,B00,507343,Staff,18,0,30,12
1714370657439,EDS 250,A00,507344,Hemans; Patricia Ann Benitez,22,0,40,18
1714370658467,EDS 281,A00,507345,Daly; Alan J.,18,0,18,0
1714370659492,EDS 284,A00,507350,Daly; Alan J.,16,0,16,0
1714370660519,EDS 286,A00,507359,Fine; Sarah,18,0,18,0
1714370661545,EDS 289C,A01,507361,Daly; Alan J.,18,0,18,0
1714370662575,EDS 290,A00,507366,Hofstetter; Carolyn,15,0,15,0
1714370663603,LIGM 5A,A00,507421,Fischer-Grunski; Eva K,18,0,20,2
1714370664635,LIGM 5B,A00,507423,Fischer-Grunski; Eva K,19,0,20,1
1714370665659,LIGM 5C,A00,507425,Fischer-Grunski; Eva K,19,0,20,1
1714370666686,LIIT 5AS,A00,507427,Carnelos; Chiara,20,0,20,0
1714370667714,LIIT 5BS,A00,507430,Carnelos; Chiara,20,0,20,0
1714370668747,LIIT 5CS,A00,507432,Carnelos; Chiara,20,0,20,0
1714370669781,LISP 5A,A00,507541,Munoz Sanchez; Alicia,11,0,20,9
1714370670810,LISP 5B,A00,507671,Munoz Sanchez; Alicia,9,0,20,11
1714370671837,LISP 5C,A00,507696,Munoz Sanchez; Alicia,9,0,20,11
1714370672868,MAE 197,001,528363,Boechler; Nicholas Sebastia,9998,0,9999,1
1714370673906,MATH 197,001,523477,Kedlaya; Kiran S.,9996,0,9999,3
1714370673906,MATH 197,002,563811,Zhang; Danna,9995,0,9999,4
1714370673906,MATH 197,003,628552,Dumitriu; Ioana,9998,0,9999,1
1714370674934,MCWP 40R,A00,518780,Staff,5,0,20,15
1714370674934,MCWP 40R,B00,518781,Staff,7,0,20,13
1714370674934,MCWP 40R,C00,518783,Staff,5,0,20,15
1714370675961,MCWP 50R,A00,518791,Staff,0,0,20,20
1714370675961,MCWP 50R,B00,518792,Staff,0,1,20,20
1714370675961,MCWP 50R,C00,518793,Staff,0,1,20,20
1714370675961,MCWP 50R,D00,518794,Staff,0,0,20,20
1714370675961,MCWP 50R,E00,518795,Staff,0,1,20,20
1714370675961,MCWP 50R,F00,518796,Staff,0,0,20,20
1714370675961,MCWP 50R,G00,518797,Staff,0,1,20,20
1714370676990,MMW 12R,A01,514034,Herbst; Matthew,0,1,16,16
1714370676990,MMW 12R,A02,514035,Herbst; Matthew,2,0,16,14
1714370678014,MMW 13R,A01,514037,Staff,0,4,16,16
1714370678014,MMW 13R,A02,514039,Staff,0,2,16,16
1714370678014,MMW 13R,A03,628519,Staff,0,2,16,16
1714370680066,SIO 295LS,A00,523233,Staff,12,0,30,18
1714370681090,SIO 295S,A00,523232,Staff,12,0,30,18
1714370682116,SIOC 290S,A01,637330,Merrifield; Mark A,27,0,30,3
1714370683143,SIOC 291S,A01,637333,Gabriel; Corey John,27,0,30,3
1714370684171,SOCI 117,A01,494376,Staff,0,3,5,5
1714370685196,WES 237B,A00,494380,Staff,9,0,20,11
1714370687256,AESE 279B,A00,494370,Wade; Jon P,0,0,33,33
1714370688280,AIP 197,001,627712,Vespa; Emanuel Ignacio,9998,0,9999,1
1714370689307,ANAR 135S,A00,494369,Braswell; Geoffrey E.,0,0,0,0
1714370690337,BENG 196,001,628496,Engler; Adam J.,9998,0,9999,1
1714370691366,CAT 124RS,A01,519847,Geibel; William,0,0,20,20
1714370692390,CAT 125RS,A01,515971,Geibel; William,0,0,20,20
1714370693415,CLRE 250,A00,511389,Morris; Sheldon,9993,0,9999,6
1714370694446,CLRE 251,A00,507176,Mehta; Ravindra L.,9993,0,9999,6
1714370694446,CLRE 251,B00,511410,Mehta; Ravindra L.,9998,0,9999,1
1714370695469,CLRE 252,A00,507189,Cuomo; Raphael Eduardo,9995,0,9999,4
1714370696500,CLRE 253,A00,507199,Vaida; Florin,9994,0,9999,5
1714370696500,CLRE 253,B00,507202,Vaida; Florin,9999,0,9999,0
1714370697525,CLRE 259,A00,507211,Patel; Hemal,9996,0,9999,3
1714370698549,CLRE 260,A00,507221,Cuomo; Raphael Eduardo,9999,0,9999,0
1714370699578,CLRE 297,001,507242,Cuomo; Raphael Eduardo,9999,0,9999,0
1714370700603,COGS 197,001,638244,Voytek; Bradley Thomas,9999,0,9999,0
1714370701629,CSE 191,A00,516875,Minnes Kemp; Mor Mia,9993,0,9999,6
1714370702652,CSE 197,001,637388,Minnes Kemp; Mor Mia,9998,0,9999,1
1714370703678,CSS 201S,A01,494383,Staff,35,0,35,0
1714370704704,CSS 202S,A01,494387,Staff,35,0,35,0
1714370705731,DSC 197,001,628532,Eldridge; Justin Matthew,9996,0,9999,3
1714370706756,EAP 100,A00,516065,Staff,9797,0,9999,202
1714370707784,ECE 45,A01,507414,Staff,33,0,60,27
1714370709837,ECE 111,A01,507420,Staff,19,0,50,31
1714370711066,ECE 197,001,548057,Sievenpiper; Daniel F.,9994,0,9999,5
1714370712093,EDS 115,A00,507243,Choi; Bailey Miyeon,12,0,28,16
1714370713116,EDS 117,A01,494379,Staff,0,2,30,30
1714370714144,EDS 125,A00,507246,Hopkins; Megan Beth,12,0,30,18
1714370715170,EDS 128A,A01,507264,Fargason; Sharon Gayle,14,0,26,12
1714370716198,EDS 128B,A01,507293,Pappas; Elizabeth,18,0,30,12
1714370717226,EDS 139,A00,507294,Fargason; Sharon Gayle,18,0,30,12
1714370717226,EDS 139,B00,507313,Pappas; Elizabeth,15,0,30,15
1714370718309,EDS 201,A00,507315,Staff,13,0,30,17
1714370719338,EDS 203,A01,507317,Halter; Christopher P.,12,0,30,18
1714370720365,EDS 204R,A01,507319,Halter; Christopher P.,0,3,30,30
1714370720365,EDS 204R,B01,507331,Heinzman; Erica M.,17,0,30,13
1714370721395,EDS 206R,A00,507332,Staff,0,4,30,30
1714370721395,EDS 206R,B00,507343,Staff,18,0,30,12
1714370722418,EDS 250,A00,507344,Hemans; Patricia Ann Benitez,22,0,40,18
1714370723447,EDS 281,A00,507345,Daly; Alan J.,18,0,18,0
1714370724476,EDS 284,A00,507350,Daly; Alan J.,16,0,16,0
1714370725504,EDS 286,A00,507359,Fine; Sarah,18,0,18,0
1714370726533,EDS 289C,A01,507361,Daly; Alan J.,18,0,18,0
1714370727560,EDS 290,A00,507366,Hofstetter; Carolyn,15,0,15,0
1714370728585,LIGM 5A,A00,507421,Fischer-Grunski; Eva K,18,0,20,2
1714370729617,LIGM 5B,A00,507423,Fischer-Grunski; Eva K,19,0,20,1
1714370730646,LIGM 5C,A00,507425,Fischer-Grunski; Eva K,19,0,20,1
1714370731670,LIIT 5AS,A00,507427,Carnelos; Chiara,20,0,20,0
1714370732700,LIIT 5BS,A00,507430,Carnelos; Chiara,20,0,20,0
1714370733729,LIIT 5CS,A00,507432,Carnelos; Chiara,20,0,20,0
1714370734763,LISP 5A,A00,507541,Munoz Sanchez; Alicia,11,0,20,9
1714370735790,LISP 5B,A00,507671,Munoz Sanchez; Alicia,9,0,20,11
1714370736822,LISP 5C,A00,507696,Munoz Sanchez; Alicia,9,0,20,11
1714370737848,MAE 197,001,528363,Boechler; Nicholas Sebastia,9998,0,9999,1
1714370738877,MATH 197,001,523477,Kedlaya; Kiran S.,9996,0,9999,3
1714370738877,MATH 197,002,563811,Zhang; Danna,9995,0,9999,4
1714370738877,MATH 197,003,628552,Dumitriu; Ioana,9998,0,9999,1
1714370739905,MCWP 40R,A00,518780,Staff,5,0,20,15
1714370739905,MCWP 40R,B00,518781,Staff,7,0,20,13
1714370739905,MCWP 40R,C00,518783,Staff,5,0,20,15
1714370740939,MCWP 50R,A00,518791,Staff,0,0,20,20
1714370740939,MCWP 50R,B00,518792,Staff,0,1,20,20
1714370740939,MCWP 50R,C00,518793,Staff,0,1,20,20
1714370740939,MCWP 50R,D00,518794,Staff,0,0,20,20
1714370740939,MCWP 50R,E00,518795,Staff,0,1,20,20
1714370740939,MCWP 50R,F00,518796,Staff,0,0,20,20
1714370740939,MCWP 50R,G00,518797,Staff,0,1,20,20
1714370741970,MMW 12R,A01,514034,Herbst; Matthew,0,1,16,16
1714370741970,MMW 12R,A02,514035,Herbst; Matthew,2,0,16,14
1714370742996,MMW 13R,A01,514037,Staff,0,4,16,16
1714370742996,MMW 13R,A02,514039,Staff,0,2,16,16
1714370742996,MMW 13R,A03,628519,Staff,0,2,16,16
1714370745047,SIO 295LS,A00,523233,Staff,12,0,30,18
1714370746071,SIO 295S,A00,523232,Staff,12,0,30,18
1714370747096,SIOC 290S,A01,637330,Merrifield; Mark A,27,0,30,3
1714370748124,SIOC 291S,A01,637333,Gabriel; Corey John,27,0,30,3
1714370749149,SOCI 117,A01,494376,Staff,0,3,5,5
1714370750177,WES 237B,A00,494380,Staff,9,0,20,11
1714370752253,AESE 279B,A00,494370,Wade; Jon P,0,0,33,33
1714370753280,AIP 197,001,627712,Vespa; Emanuel Ignacio,9998,0,9999,1
1714370754308,ANAR 135S,A00,494369,Braswell; Geoffrey E.,0,0,0,0
1714370755333,BENG 196,001,628496,Engler; Adam J.,9998,0,9999,1
1714370756362,CAT 124RS,A01,519847,Geibel; William,0,0,20,20
1714370757387,CAT 125RS,A01,515971,Geibel; William,0,0,20,20
1714370758410,CLRE 250,A00,511389,Morris; Sheldon,9993,0,9999,6
1714370759440,CLRE 251,A00,507176,Mehta; Ravindra L.,9993,0,9999,6
1714370759440,CLRE 251,B00,511410,Mehta; Ravindra L.,9998,0,9999,1
1714370760465,CLRE 252,A00,507189,Cuomo; Raphael Eduardo,9995,0,9999,4
1714370761494,CLRE 253,A00,507199,Vaida; Florin,9994,0,9999,5
1714370761494,CLRE 253,B00,507202,Vaida; Florin,9999,0,9999,0
1714370762522,CLRE 259,A00,507211,Patel; Hemal,9996,0,9999,3
1714370763549,CLRE 260,A00,507221,Cuomo; Raphael Eduardo,9999,0,9999,0
1714370764577,CLRE 297,001,507242,Cuomo; Raphael Eduardo,9999,0,9999,0
1714370765606,COGS 197,001,638244,Voytek; Bradley Thomas,9999,0,9999,0
1714370766629,CSE 191,A00,516875,Minnes Kemp; Mor Mia,9993,0,9999,6
1714370767652,CSE 197,001,637388,Minnes Kemp; Mor Mia,9998,0,9999,1
1714370768682,CSS 201S,A01,494383,Staff,35,0,35,0
1714370769708,CSS 202S,A01,494387,Staff,35,0,35,0
1714370770737,DSC 197,001,628532,Eldridge; Justin Matthew,9996,0,9999,3
1714370771763,EAP 100,A00,516065,Staff,9797,0,9999,202
1714370772788,ECE 45,A01,507414,Staff,33,0,60,27
1714370774840,ECE 111,A01,507420,Staff,19,0,50,31
1714370775863,ECE 197,001,548057,Sievenpiper; Daniel F.,9994,0,9999,5
1714370776892,EDS 115,A00,507243,Choi; Bailey Miyeon,12,0,28,16
1714370777920,EDS 117,A01,494379,Staff,0,2,30,30
1714370778946,EDS 125,A00,507246,Hopkins; Megan Beth,12,0,30,18
1714370779972,EDS 128A,A01,507264,Fargason; Sharon Gayle,14,0,26,12
1714370780997,EDS 128B,A01,507293,Pappas; Elizabeth,18,0,30,12
1714370782026,EDS 139,A00,507294,Fargason; Sharon Gayle,18,0,30,12
1714370782026,EDS 139,B00,507313,Pappas; Elizabeth,15,0,30,15
1714370783052,EDS 201,A00,507315,Staff,13,0,30,17
1714370784081,EDS 203,A01,507317,Halter; Christopher P.,12,0,30,18
1714370785107,EDS 204R,A01,507319,Halter; Christopher P.,0,3,30,30
1714370785107,EDS 204R,B01,507331,Heinzman; Erica M.,17,0,30,13
1714370786135,EDS 206R,A00,507332,Staff,0,4,30,30
1714370786135,EDS 206R,B00,507343,Staff,18,0,30,12
1714370787163,EDS 250,A00,507344,Hemans; Patricia Ann Benitez,22,0,40,18
1714370788187,EDS 281,A00,507345,Daly; Alan J.,18,0,18,0
1714370789212,EDS 284,A00,507350,Daly; Alan J.,16,0,16,0
1714370790238,EDS 286,A00,507359,Fine; Sarah,18,0,18,0
1714370791263,EDS 289C,A01,507361,Daly; Alan J.,18,0,18,0
1714370792290,EDS 290,A00,507366,Hofstetter; Carolyn,15,0,15,0
1714370793318,LIGM 5A,A00,507421,Fischer-Grunski; Eva K,18,0,20,2
1714370794342,LIGM 5B,A00,507423,Fischer-Grunski; Eva K,19,0,20,1
1714370795368,LIGM 5C,A00,507425,Fischer-Grunski; Eva K,19,0,20,1
1714370796397,LIIT 5AS,A00,507427,Carnelos; Chiara,20,0,20,0
1714370797426,LIIT 5BS,A00,507430,Carnelos; Chiara,20,0,20,0
1714370798454,LIIT 5CS,A00,507432,Carnelos; Chiara,20,0,20,0
1714370799483,LISP 5A,A00,507541,Munoz Sanchez; Alicia,11,0,20,9
1714370800508,LISP 5B,A00,507671,Munoz Sanchez; Alicia,9,0,20,11
1714370801535,LISP 5C,A00,507696,Munoz Sanchez; Alicia,9,0,20,11
1714370802561,MAE 197,001,528363,Boechler; Nicholas Sebastia,9998,0,9999,1
1714370803591,MATH 197,001,523477,Kedlaya; Kiran S.,9996,0,9999,3
1714370803591,MATH 197,002,563811,Zhang; Danna,9995,0,9999,4
1714370803591,MATH 197,003,628552,Dumitriu; Ioana,9998,0,9999,1
1714370804617,MCWP 40R,A00,518780,Staff,5,0,20,15
1714370804617,MCWP 40R,B00,518781,Staff,7,0,20,13
1714370804617,MCWP 40R,C00,518783,Staff,5,0,20,15
1714370805644,MCWP 50R,A00,518791,Staff,0,0,20,20
1714370805644,MCWP 50R,B00,518792,Staff,0,1,20,20
1714370805644,MCWP 50R,C00,518793,Staff,0,1,20,20
1714370805644,MCWP 50R,D00,518794,Staff,0,0,20,20
1714370805644,MCWP 50R,E00,518795,Staff,0,1,20,20
1714370805644,MCWP 50R,F00,518796,Staff,0,0,20,20
1714370805644,MCWP 50R,G00,518797,Staff,0,1,20,20
1714370806668,MMW 12R,A01,514034,Herbst; Matthew,0,1,16,16
1714370806668,MMW 12R,A02,514035,Herbst; Matthew,2,0,16,14
1714370807697,MMW 13R,A01,514037,Staff,0,4,16,16
1714370807697,MMW 13R,A02,514039,Staff,0,2,16,16
1714370807697,MMW 13R,A03,628519,Staff,0,2,16,16
1714370809805,SIO 295LS,A00,523233,Staff,12,0,30,18
1714370810836,SIO 295S,A00,523232,Staff,12,0,30,18
1714370811864,SIOC 290S,A01,637330,Merrifield; Mark A,27,0,30,3
1714370812889,SIOC 291S,A01,637333,Gabriel; Corey John,27,0,30,3
1714370813913,SOCI 117,A01,494376,Staff,0,3,5,5
1714370814940,WES 237B,A00,494380,Staff,9,0,20,11
1714370817002,AESE 279B,A00,494370,Wade; Jon P,0,0,33,33
1714370818028,AIP 197,001,627712,Vespa; Emanuel Ignacio,9998,0,9999,1
1714370819054,ANAR 135S,A00,494369,Braswell; Geoffrey E.,0,0,0,0
1714370820078,BENG 196,001,628496,Engler; Adam J.,9998,0,9999,1
1714370821106,CAT 124RS,A01,519847,Geibel; William,0,0,20,20
1714370822187,CAT 125RS,A01,515971,Geibel; William,0,0,20,20
1714370823212,CLRE 250,A00,511389,Morris; Sheldon,9993,0,9999,6
1714370824237,CLRE 251,A00,507176,Mehta; Ravindra L.,9993,0,9999,6
1714370824237,CLRE 251,B00,511410,Mehta; Ravindra L.,9998,0,9999,1
1714370825261,CLRE 252,A00,507189,Cuomo; Raphael Eduardo,9995,0,9999,4
1714370826285,CLRE 253,A00,507199,Vaida; Florin,9994,0,9999,5
1714370826285,CLRE 253,B00,507202,Vaida; Florin,9999,0,9999,0
1714370827313,CLRE 259,A00,507211,Patel; Hemal,9996,0,9999,3
1714370828338,CLRE 260,A00,507221,Cuomo; Raphael Eduardo,9999,0,9999,0
1714370829361,CLRE 297,001,507242,Cuomo; Raphael Eduardo,9999,0,9999,0
1714370830386,COGS 197,001,638244,Voytek; Bradley Thomas,9999,0,9999,0
1714370831414,CSE 191,A00,516875,Minnes Kemp; Mor Mia,9993,0,9999,6
1714370832439,CSE 197,001,637388,Minnes Kemp; Mor Mia,9998,0,9999,1
1714370833465,CSS 201S,A01,494383,Staff,35,0,35,0
1714370834494,CSS 202S,A01,494387,Staff,35,0,35,0
1714370835519,DSC 197,001,628532,Eldridge; Justin Matthew,9996,0,9999,3
1714370836544,EAP 100,A00,516065,Staff,9797,0,9999,202
1714370837572,ECE 45,A01,507414,Staff,33,0,60,27
1714370839625,ECE 111,A01,507420,Staff,19,0,50,31
1714370840652,ECE 197,001,548057,Sievenpiper; Daniel F.,9994,0,9999,5
1714370841677,EDS 115,A00,507243,Choi; Bailey Miyeon,12,0,28,16
1714370842703,EDS 117,A01,494379,Staff,0,2,30,30
1714370843733,EDS 125,A00,507246,Hopkins; Megan Beth,12,0,30,18
1714370844761,EDS 128A,A01,507264,Fargason; Sharon Gayle,14,0,26,12
1714370845787,EDS 128B,A01,507293,Pappas; Elizabeth,18,0,30,12
1714370846815,EDS 139,A00,507294,Fargason; Sharon Gayle,18,0,30,12
1714370846815,EDS 139,B00,507313,Pappas; Elizabeth,15,0,30,15
1714370847847,EDS 201,A00,507315,Staff,13,0,30,17
1714370848872,EDS 203,A01,507317,Halter; Christopher P.,12,0,30,18
1714370849897,EDS 204R,A01,507319,Halter; Christopher P.,0,3,30,30
1714370849897,EDS 204R,B01,507331,Heinzman; Erica M.,17,0,30,13
1714370850925,EDS 206R,A00,507332,Staff,0,4,30,30
1714370850925,EDS 206R,B00,507343,Staff,18,0,30,12
1714370851951,EDS 250,A00,507344,Hemans; Patricia Ann Benitez,22,0,40,18
1714370852980,EDS 281,A00,507345,Daly; Alan J.,18,0,18,0
1714370854005,EDS 284,A00,507350,Daly; Alan J.,16,0,16,0
1714370855031,EDS 286,A00,507359,Fine; Sarah,18,0,18,0
1714370856057,EDS 289C,A01,507361,Daly; Alan J.,18,0,18,0
1714370857083,EDS 290,A00,507366,Hofstetter; Carolyn,15,0,15,0
1714370858113,LIGM 5A,A00,507421,Fischer-Grunski; Eva K,18,0,20,2
1714370859139,LIGM 5B,A00,507423,Fischer-Grunski; Eva K,19,0,20,1
1714370860165,LIGM 5C,A00,507425,Fischer-Grunski; Eva K,19,0,20,1
1714370861192,LIIT 5AS,A00,507427,Carnelos; Chiara,20,0,20,0
1714370862217,LIIT 5BS,A00,507430,Carnelos; Chiara,20,0,20,0
1714370863247,LIIT 5CS,A00,507432,Carnelos; Chiara,20,0,20,0
1714370864272,LISP 5A,A00,507541,Munoz Sanchez; Alicia,11,0,20,9
1714370865301,LISP 5B,A00,507671,Munoz Sanchez; Alicia,9,0,20,11
1714370866327,LISP 5C,A00,507696,Munoz Sanchez; Alicia,9,0,20,11
1714370867355,MAE 197,001,528363,Boechler; Nicholas Sebastia,9998,0,9999,1
1714370868385,MATH 197,001,523477,Kedlaya; Kiran S.,9996,0,9999,3
1714370868385,MATH 197,002,563811,Zhang; Danna,9995,0,9999,4
1714370868385,MATH 197,003,628552,Dumitriu; Ioana,9998,0,9999,1
1714370869413,MCWP 40R,A00,518780,Staff,5,0,20,15
1714370869413,MCWP 40R,B00,518781,Staff,7,0,20,13
1714370869413,MCWP 40R,C00,518783,Staff,5,0,20,15
1714370870443,MCWP 50R,A00,518791,Staff,0,0,20,20
1714370870443,MCWP 50R,B00,518792,Staff,0,1,20,20
1714370870443,MCWP 50R,C00,518793,Staff,0,1,20,20
1714370870443,MCWP 50R,D00,518794,Staff,0,0,20,20
1714370870443,MCWP 50R,E00,518795,Staff,0,1,20,20
1714370870443,MCWP 50R,F00,518796,Staff,0,0,20,20
1714370870443,MCWP 50R,G00,518797,Staff,0,1,20,20
1714370871472,MMW 12R,A01,514034,Herbst; Matthew,0,1,16,16
1714370871472,MMW 12R,A02,514035,Herbst; Matthew,2,0,16,14
1714370872499,MMW 13R,A01,514037,Staff,0,4,16,16
1714370872499,MMW 13R,A02,514039,Staff,0,2,16,16
1714370872499,MMW 13R,A03,628519,Staff,0,2,16,16
1714370874554,SIO 295LS,A00,523233,Staff,12,0,30,18
1714370875580,SIO 295S,A00,523232,Staff,12,0,30,18
1714370876609,SIOC 290S,A01,637330,Merrifield; Mark A,27,0,30,3
1714370877640,SIOC 291S,A01,637333,Gabriel; Corey John,27,0,30,3
1714370878664,SOCI 117,A01,494376,Staff,0,3,5,5
1714370879690,WES 237B,A00,494380,Staff,9,0,20,11
1714370881749,AESE 279B,A00,494370,Wade; Jon P,0,0,33,33
1714370882773,AIP 197,001,627712,Vespa; Emanuel Ignacio,9998,0,9999,1
1714370883798,ANAR 135S,A00,494369,Braswell; Geoffrey E.,0,0,0,0
1714370884823,BENG 196,001,628496,Engler; Adam J.,9998,0,9999,1
1714370885853,CAT 124RS,A01,519847,Geibel; William,0,0,20,20
1714370886879,CAT 125RS,A01,515971,Geibel; William,0,0,20,20
1714370887907,CLRE 250,A00,511389,Morris; Sheldon,9993,0,9999,6
1714370888935,CLRE 251,A00,507176,Mehta; Ravindra L.,9993,0,9999,6
1714370888935,CLRE 251,B00,511410,Mehta; Ravindra L.,9998,0,9999,1
1714370889960,CLRE 252,A00,507189,Cuomo; Raphael Eduardo,9995,0,9999,4
1714370890989,CLRE 253,A00,507199,Vaida; Florin,9994,0,9999,5
1714370890989,CLRE 253,B00,507202,Vaida; Florin,9999,0,9999,0
1714370892015,CLRE 259,A00,507211,Patel; Hemal,9996,0,9999,3
1714370893042,CLRE 260,A00,507221,Cuomo; Raphael Eduardo,9999,0,9999,0
1714370894071,CLRE 297,001,507242,Cuomo; Raphael Eduardo,9999,0,9999,0
1714370895105,COGS 197,001,638244,Voytek; Bradley Thomas,9999,0,9999,0
1714370896130,CSE 191,A00,516875,Minnes Kemp; Mor Mia,9993,0,9999,6
1714370897155,CSE 197,001,637388,Minnes Kemp; Mor Mia,9998,0,9999,1
1714370898180,CSS 201S,A01,494383,Staff,35,0,35,0
1714370899204,CSS 202S,A01,494387,Staff,35,0,35,0
1714370900230,DSC 197,001,628532,Eldridge; Justin Matthew,9996,0,9999,3
1714370901255,EAP 100,A00,516065,Staff,9797,0,9999,202
1714370902285,ECE 45,A01,507414,Staff,33,0,60,27
1714370904343,ECE 111,A01,507420,Staff,19,0,50,31
1714370905371,ECE 197,001,548057,Sievenpiper; Daniel F.,9994,0,9999,5
1714370906396,EDS 115,A00,507243,Choi; Bailey Miyeon,12,0,28,16
1714370907420,EDS 117,A01,494379,Staff,0,2,30,30
1714370908447,EDS 125,A00,507246,Hopkins; Megan Beth,12,0,30,18
1714370909473,EDS 128A,A01,507264,Fargason; Sharon Gayle,14,0,26,12
1714370910499,EDS 128B,A01,507293,Pappas; Elizabeth,18,0,30,12
1714370911524,EDS 139,A00,507294,Fargason; Sharon Gayle,18,0,30,12
1714370911524,EDS 139,B00,507313,Pappas; Elizabeth,15,0,30,15
1714370912548,EDS 201,A00,507315,Staff,13,0,30,17
1714370913578,EDS 203,A01,507317,Halter; Christopher P.,12,0,30,18
1714370914607,EDS 204R,A01,507319,Halter; Christopher P.,0,3,30,30
1714370914607,EDS 204R,B01,507331,Heinzman; Erica M.,17,0,30,13
1714370915634,EDS 206R,A00,507332,Staff,0,4,30,30
1714370915634,EDS 206R,B00,507343,Staff,18,0,30,12
1714370916660,EDS 250,A00,507344,Hemans; Patricia Ann Benitez,22,0,40,18
1714370917688,EDS 281,A00,507345,Daly; Alan J.,18,0,18,0
1714370918715,EDS 284,A00,507350,Daly; Alan J.,16,0,16,0
1714370919744,EDS 286,A00,507359,Fine; Sarah,18,0,18,0
1714370920771,EDS 289C,A01,507361,Daly; Alan J.,18,0,18,0
1714370921797,EDS 290,A00,507366,Hofstetter; Carolyn,15,0,15,0
1714370922823,LIGM 5A,A00,507421,Fischer-Grunski; Eva K,18,0,20,2
1714370923852,LIGM 5B,A00,507423,Fischer-Grunski; Eva K,19,0,20,1
1714370924882,LIGM 5C,A00,507425,Fischer-Grunski; Eva K,19,0,20,1
1714370925967,LIIT 5AS,A00,507427,Carnelos; Chiara,20,0,20,0
1714370926993,LIIT 5BS,A00,507430,Carnelos; Chiara,20,0,20,0
1714370928022,LIIT 5CS,A00,507432,Carnelos; Chiara,20,0,20,0
1714370929048,LISP 5A,A00,507541,Munoz Sanchez; Alicia,11,0,20,9
1714370930078,LISP 5B,A00,507671,Munoz Sanchez; Alicia,9,0,20,11
1714370931105,LISP 5C,A00,507696,Munoz Sanchez; Alicia,9,0,20,11
1714370932131,MAE 197,001,528363,Boechler; Nicholas Sebastia,9998,0,9999,1
1714370933161,MATH 197,001,523477,Kedlaya; Kiran S.,9996,0,9999,3
1714370933161,MATH 197,002,563811,Zhang; Danna,9995,0,9999,4
1714370933161,MATH 197,003,628552,Dumitriu; Ioana,9998,0,9999,1
1714370934190,MCWP 40R,A00,518780,Staff,5,0,20,15
1714370934190,MCWP 40R,B00,518781,Staff,7,0,20,13
1714370934190,MCWP 40R,C00,518783,Staff,5,0,20,15
1714370935216,MCWP 50R,A00,518791,Staff,0,0,20,20
1714370935216,MCWP 50R,B00,518792,Staff,0,1,20,20
1714370935216,MCWP 50R,C00,518793,Staff,0,1,20,20
1714370935216,MCWP 50R,D00,518794,Staff,0,0,20,20
1714370935216,MCWP 50R,E00,518795,Staff,0,1,20,20
1714370935216,MCWP 50R,F00,518796,Staff,0,0,20,20
1714370935216,MCWP 50R,G00,518797,Staff,0,1,20,20
1714370936242,MMW 12R,A01,514034,Herbst; Matthew,0,1,16,16
1714370936242,MMW 12R,A02,514035,Herbst; Matthew,2,0,16,14
1714370937267,MMW 13R,A01,514037,Staff,0,4,16,16
1714370937267,MMW 13R,A02,514039,Staff,0,2,16,16
1714370937267,MMW 13R,A03,628519,Staff,0,2,16,16
1714370939324,SIO 295LS,A00,523233,Staff,12,0,30,18
1714370940350,SIO 295S,A00,523232,Staff,12,0,30,18
1714370941375,SIOC 290S,A01,637330,Merrifield; Mark A,27,0,30,3
1714370942401,SIOC 291S,A01,637333,Gabriel; Corey John,27,0,30,3
1714370943465,SOCI 117,A01,494376,Staff,0,3,5,5
1714370944492,WES 237B,A00,494380,Staff,9,0,20,11
1714370946561,AESE 279B,A00,494370,Wade; Jon P,0,0,33,33
1714370947588,AIP 197,001,627712,Vespa; Emanuel Ignacio,9998,0,9999,1
1714370948616,ANAR 135S,A00,494369,Braswell; Geoffrey E.,0,0,0,0
1714370949642,BENG 196,001,628496,Engler; Adam J.,9998,0,9999,1
1714370950669,CAT 124RS,A01,519847,Geibel; William,0,0,20,20
1714370951698,CAT 125RS,A01,515971,Geibel; William,0,0,20,20
1714370952724,CLRE 250,A00,511389,Morris; Sheldon,9993,0,9999,6
1714370953748,CLRE 251,A00,507176,Mehta; Ravindra L.,9993,0,9999,6
1714370953748,CLRE 251,B00,511410,Mehta; Ravindra L.,9998,0,9999,1
1714370954777,CLRE 252,A00,507189,Cuomo; Raphael Eduardo,9995,0,9999,4
1714370955803,CLRE 253,A00,507199,Vaida; Florin,9994,0,9999,5
1714370955803,CLRE 253,B00,507202,Vaida; Florin,9999,0,9999,0
1714370956831,CLRE 259,A00,507211,Patel; Hemal,9996,0,9999,3
1714370957856,CLRE 260,A00,507221,Cuomo; Raphael Eduardo,9999,0,9999,0
1714370958881,CLRE 297,001,507242,Cuomo; Raphael Eduardo,9999,0,9999,0
1714370959906,COGS 197,001,638244,Voytek; Bradley Thomas,9999,0,9999,0
1714370960931,CSE 191,A00,516875,Minnes Kemp; Mor Mia,9993,0,9999,6
1714370961956,CSE 197,001,637388,Minnes Kemp; Mor Mia,9998,0,9999,1
1714370962982,CSS 201S,A01,494383,Staff,35,0,35,0
1714370964008,CSS 202S,A01,494387,Staff,35,0,35,0
1714370965034,DSC 197,001,628532,Eldridge; Justin Matthew,9996,0,9999,3
1714370966059,EAP 100,A00,516065,Staff,9797,0,9999,202
1714370967086,ECE 45,A01,507414,Staff,33,0,60,27
1714370969143,ECE 111,A01,507420,Staff,19,0,50,31
1714370970169,ECE 197,001,548057,Sievenpiper; Daniel F.,9994,0,9999,5
1714370971194,EDS 115,A00,507243,Choi; Bailey Miyeon,12,0,28,16
1714370972221,EDS 117,A01,494379,Staff,0,2,30,30
1714370973248,EDS 125,A00,507246,Hopkins; Megan Beth,12,0,30,18
1714370974273,EDS 128A,A01,507264,Fargason; Sharon Gayle,14,0,26,12
1714370975297,EDS 128B,A01,507293,Pappas; Elizabeth,18,0,30,12
1714370976322,EDS 139,A00,507294,Fargason; Sharon Gayle,18,0,30,12
1714370976322,EDS 139,B00,507313,Pappas; Elizabeth,15,0,30,15
1714370977345,EDS 201,A00,507315,Staff,13,0,30,17
1714370978374,EDS 203,A01,507317,Halter; Christopher P.,12,0,30,18
1714370979400,EDS 204R,A01,507319,Halter; Christopher P.,0,3,30,30
1714370979400,EDS 204R,B01,507331,Heinzman; Erica M.,17,0,30,13
1714370980429,EDS 206R,A00,507332,Staff,0,4,30,30
1714370980429,EDS 206R,B00,507343,Staff,18,0,30,12
1714370981453,EDS 250,A00,507344,Hemans; Patricia Ann Benitez,22,0,40,18
1714370982480,EDS 281,A00,507345,Daly; Alan J.,18,0,18,0
1714370983505,EDS 284,A00,507350,Daly; Alan J.,16,0,16,0
1714370984531,EDS 286,A00,507359,Fine; Sarah,18,0,18,0
1714370985555,EDS 289C,A01,507361,Daly; Alan J.,18,0,18,0
1714370986582,EDS 290,A00,507366,Hofstetter; Carolyn,15,0,15,0
1714370987608,LIGM 5A,A00,507421,Fischer-Grunski; Eva K,18,0,20,2
1714370988638,LIGM 5B,A00,507423,Fischer-Grunski; Eva K,19,0,20,1
1714370989664,LIGM 5C,A00,507425,Fischer-Grunski; Eva K,19,0,20,1
1714370990689,LIIT 5AS,A00,507427,Carnelos; Chiara,20,0,20,0
1714370991714,LIIT 5BS,A00,507430,Carnelos; Chiara,20,0,20,0
1714370992740,LIIT 5CS,A00,507432,Carnelos; Chiara,20,0,20,0
1714370993765,LISP 5A,A00,507541,Munoz Sanchez; Alicia,11,0,20,9
1714370994791,LISP 5B,A00,507671,Munoz Sanchez; Alicia,9,0,20,11
1714370995821,LISP 5C,A00,507696,Munoz Sanchez; Alicia,9,0,20,11
1714370996847,MAE 197,001,528363,Boechler; Nicholas Sebastia,9998,0,9999,1
1714370997873,MATH 197,001,523477,Kedlaya; Kiran S.,9996,0,9999,3
1714370997873,MATH 197,002,563811,Zhang; Danna,9995,0,9999,4
1714370997873,MATH 197,003,628552,Dumitriu; Ioana,9998,0,9999,1
1714370998901,MCWP 40R,A00,518780,Staff,5,0,20,15
1714370998901,MCWP 40R,B00,518781,Staff,7,0,20,13
1714370998901,MCWP 40R,C00,518783,Staff,5,0,20,15
1714370999931,MCWP 50R,A00,518791,Staff,0,0,20,20
1714370999931,MCWP 50R,B00,518792,Staff,0,1,20,20
1714370999931,MCWP 50R,C00,518793,Staff,0,1,20,20
1714370999931,MCWP 50R,D00,518794,Staff,0,0,20,20
1714370999931,MCWP 50R,E00,518795,Staff,0,1,20,20
1714370999931,MCWP 50R,F00,518796,Staff,0,0,20,20
1714370999931,MCWP 50R,G00,518797,Staff,0,1,20,20
1714371000956,MMW 12R,A01,514034,Herbst; Matthew,0,1,16,16
1714371000956,MMW 12R,A02,514035,Herbst; Matthew,2,0,16,14
1714371001983,MMW 13R,A01,514037,Staff,0,4,16,16
1714371001983,MMW 13R,A02,514039,Staff,0,2,16,16
1714371001983,MMW 13R,A03,628519,Staff,0,2,16,16
1714371004038,SIO 295LS,A00,523233,Staff,12,0,30,18
1714371005066,SIO 295S,A00,523232,Staff,12,0,30,18
1714371006091,SIOC 290S,A01,637330,Merrifield; Mark A,27,0,30,3
1714371007119,SIOC 291S,A01,637333,Gabriel; Corey John,27,0,30,3
1714371008146,SOCI 117,A01,494376,Staff,0,3,5,5
1714371009172,WES 237B,A00,494380,Staff,9,0,20,11
1714371011244,AESE 279B,A00,494370,Wade; Jon P,0,0,33,33
1714371012269,AIP 197,001,627712,Vespa; Emanuel Ignacio,9998,0,9999,1
1714371013297,ANAR 135S,A00,494369,Braswell; Geoffrey E.,0,0,0,0
1714371014324,BENG 196,001,628496,Engler; Adam J.,9998,0,9999,1
1714371015352,CAT 124RS,A01,519847,Geibel; William,0,0,20,20
1714371016381,CAT 125RS,A01,515971,Geibel; William,0,0,20,20
1714371017410,CLRE 250,A00,511389,Morris; Sheldon,9993,0,9999,6
1714371018438,CLRE 251,A00,507176,Mehta; Ravindra L.,9993,0,9999,6
1714371018438,CLRE 251,B00,511410,Mehta; Ravindra L.,9998,0,9999,1
1714371019464,CLRE 252,A00,507189,Cuomo; Raphael Eduardo,9995,0,9999,4
1714371020494,CLRE 253,A00,507199,Vaida; Florin,9994,0,9999,5
1714371020494,CLRE 253,B00,507202,Vaida; Florin,9999,0,9999,0
1714371021517,CLRE 259,A00,507211,Patel; Hemal,9996,0,9999,3
1714371022544,CLRE 260,A00,507221,Cuomo; Raphael Eduardo,9999,0,9999,0
1714371023572,CLRE 297,001,507242,Cuomo; Raphael Eduardo,9999,0,9999,0
1714371024599,COGS 197,001,638244,Voytek; Bradley Thomas,9999,0,9999,0
1714371025625,CSE 191,A00,516875,Minnes Kemp; Mor Mia,9993,0,9999,6
1714371026650,CSE 197,001,637388,Minnes Kemp; Mor Mia,9998,0,9999,1
1714371027677,CSS 201S,A01,494383,Staff,35,0,35,0
1714371028701,CSS 202S,A01,494387,Staff,35,0,35,0
1714371029781,DSC 197,001,628532,Eldridge; Justin Matthew,9996,0,9999,3
1714371030809,EAP 100,A00,516065,Staff,9797,0,9999,202
1714371031835,ECE 45,A01,507414,Staff,33,0,60,27
1714371033896,ECE 111,A01,507420,Staff,19,0,50,31
1714371034925,ECE 197,001,548057,Sievenpiper; Daniel F.,9994,0,9999,5
1714371035951,EDS 115,A00,507243,Choi; Bailey Miyeon,12,0,28,16
1714371036982,EDS 117,A01,494379,Staff,0,2,30,30
1714371038010,EDS 125,A00,507246,Hopkins; Megan Beth,12,0,30,18
1714371039035,EDS 128A,A01,507264,Fargason; Sharon Gayle,14,0,26,12
1714371040061,EDS 128B,A01,507293,Pappas; Elizabeth,18,0,30,12
1714371041086,EDS 139,A00,507294,Fargason; Sharon Gayle,18,0,30,12
1714371041086,EDS 139,B00,507313,Pappas; Elizabeth,15,0,30,15
1714371042112,EDS 201,A00,507315,Staff,13,0,30,17
1714371043139,EDS 203,A01,507317,Halter; Christopher P.,12,0,30,18
1714371044165,EDS 204R,A01,507319,Halter; Christopher P.,0,3,30,30
1714371044165,EDS 204R,B01,507331,Heinzman; Erica M.,17,0,30,13
1714371045194,EDS 206R,A00,507332,Staff,0,4,30,30
1714371045194,EDS 206R,B00,507343,Staff,18,0,30,12
1714371046222,EDS 250,A00,507344,Hemans; Patricia Ann Benitez,22,0,40,18
1714371047248,EDS 281,A00,507345,Daly; Alan J.,18,0,18,0
1714371048271,EDS 284,A00,507350,Daly; Alan J.,16,0,16,0
1714371049300,EDS 286,A00,507359,Fine; Sarah,18,0,18,0
1714371050328,EDS 289C,A01,507361,Daly; Alan J.,18,0,18,0
1714371051353,EDS 290,A00,507366,Hofstetter; Carolyn,15,0,15,0
1714371052383,LIGM 5A,A00,507421,Fischer-Grunski; Eva K,18,0,20,2
1714371053415,LIGM 5B,A00,507423,Fischer-Grunski; Eva K,19,0,20,1
1714371054444,LIGM 5C,A00,507425,Fischer-Grunski; Eva K,19,0,20,1
1714371055469,LIIT 5AS,A00,507427,Carnelos; Chiara,20,0,20,0
1714371056494,LIIT 5BS,A00,507430,Carnelos; Chiara,20,0,20,0
1714371057523,LIIT 5CS,A00,507432,Carnelos; Chiara,20,0,20,0
1714371058553,LISP 5A,A00,507541,Munoz Sanchez; Alicia,11,0,20,9
1714371059582,LISP 5B,A00,507671,Munoz Sanchez; Alicia,9,0,20,11
1714371060607,LISP 5C,A00,507696,Munoz Sanchez; Alicia,9,0,20,11
1714371061632,MAE 197,001,528363,Boechler; Nicholas Sebastia,9998,0,9999,1
1714371062663,MATH 197,001,523477,Kedlaya; Kiran S.,9996,0,9999,3
1714371062663,MATH 197,002,563811,Zhang; Danna,9995,0,9999,4
1714371062663,MATH 197,003,628552,Dumitriu; Ioana,9998,0,9999,1
1714371063692,MCWP 40R,A00,518780,Staff,5,0,20,15
1714371063692,MCWP 40R,B00,518781,Staff,7,0,20,13
1714371063692,MCWP 40R,C00,518783,Staff,5,0,20,15
1714371064718,MCWP 50R,A00,518791,Staff,0,0,20,20
1714371064718,MCWP 50R,B00,518792,Staff,0,1,20,20
1714371064718,MCWP 50R,C00,518793,Staff,0,1,20,20
1714371064718,MCWP 50R,D00,518794,Staff,0,0,20,20
1714371064718,MCWP 50R,E00,518795,Staff,0,1,20,20
1714371064718,MCWP 50R,F00,518796,Staff,0,0,20,20
1714371064718,MCWP 50R,G00,518797,Staff,0,1,20,20
1714371065745,MMW 12R,A01,514034,Herbst; Matthew,0,1,16,16
1714371065745,MMW 12R,A02,514035,Herbst; Matthew,2,0,16,14
1714371066770,MMW 13R,A01,514037,Staff,0,4,16,16
1714371066770,MMW 13R,A02,514039,Staff,0,2,16,16
1714371066770,MMW 13R,A03,628519,Staff,0,2,16,16
1714371068819,SIO 295LS,A00,523233,Staff,12,0,30,18
1714371069846,SIO 295S,A00,523232,Staff,12,0,30,18
1714371070870,SIOC 290S,A01,637330,Merrifield; Mark A,27,0,30,3
1714371071896,SIOC 291S,A01,637333,Gabriel; Corey John,27,0,30,3
1714371072922,SOCI 117,A01,494376,Staff,0,3,5,5
1714371073949,WES 237B,A00,494380,Staff,9,0,20,11
1714371076017,AESE 279B,A00,494370,Wade; Jon P,0,0,33,33
1714371077042,AIP 197,001,627712,Vespa; Emanuel Ignacio,9998,0,9999,1
1714371078070,ANAR 135S,A00,494369,Braswell; Geoffrey E.,0,0,0,0
1714371079098,BENG 196,001,628496,Engler; Adam J.,9998,0,9999,1
1714371080124,CAT 124RS,A01,519847,Geibel; William,0,0,20,20
1714371081148,CAT 125RS,A01,515971,Geibel; William,0,0,20,20
1714371082174,CLRE 250,A00,511389,Morris; Sheldon,9993,0,9999,6
1714371083203,CLRE 251,A00,507176,Mehta; Ravindra L.,9993,0,9999,6
1714371083203,CLRE 251,B00,511410,Mehta; Ravindra L.,9998,0,9999,1
1714371084229,CLRE 252,A00,507189,Cuomo; Raphael Eduardo,9995,0,9999,4
1714371085254,CLRE 253,A00,507199,Vaida; Florin,9994,0,9999,5
1714371085254,CLRE 253,B00,507202,Vaida; Florin,9999,0,9999,0
1714371086302,CLRE 259,A00,507211,Patel; Hemal,9996,0,9999,3
1714371087327,CLRE 260,A00,507221,Cuomo; Raphael Eduardo,9999,0,9999,0
1714371088351,CLRE 297,001,507242,Cuomo; Raphael Eduardo,9999,0,9999,0
1714371089380,COGS 197,001,638244,Voytek; Bradley Thomas,9999,0,9999,0
1714371090404,CSE 191,A00,516875,Minnes Kemp; Mor Mia,9993,0,9999,6
1714371091429,CSE 197,001,637388,Minnes Kemp; Mor Mia,9998,0,9999,1
1714371092458,CSS 201S,A01,494383,Staff,35,0,35,0
1714371093485,CSS 202S,A01,494387,Staff,35,0,35,0
1714371094513,DSC 197,001,628532,Eldridge; Justin Matthew,9996,0,9999,3
1714371095540,EAP 100,A00,516065,Staff,9797,0,9999,202
1714371096568,ECE 45,A01,507414,Staff,33,0,60,27
1714371098621,ECE 111,A01,507420,Staff,19,0,50,31
1714371099645,ECE 197,001,548057,Sievenpiper; Daniel F.,9994,0,9999,5
1714371100669,EDS 115,A00,507243,Choi; Bailey Miyeon,12,0,28,16
1714371101696,EDS 117,A01,494379,Staff,0,2,30,30
1714371102724,EDS 125,A00,507246,Hopkins; Megan Beth,12,0,30,18
1714371103749,EDS 128A,A01,507264,Fargason; Sharon Gayle,14,0,26,12
1714371104776,EDS 128B,A01,507293,Pappas; Elizabeth,18,0,30,12
1714371105804,EDS 139,A00,507294,Fargason; Sharon Gayle,18,0,30,12
1714371105804,EDS 139,B00,507313,Pappas; Elizabeth,15,0,30,15
1714371106828,EDS 201,A00,507315,Staff,13,0,30,17
1714371107853,EDS 203,A01,507317,Halter; Christopher P.,12,0,30,18
1714371108879,EDS 204R,A01,507319,Halter; Christopher P.,0,3,30,30
1714371108879,EDS 204R,B01,507331,Heinzman; Erica M.,17,0,30,13
1714371109907,EDS 206R,A00,507332,Staff,0,4,30,30
1714371109907,EDS 206R,B00,507343,Staff,18,0,30,12
1714371110931,EDS 250,A00,507344,Hemans; Patricia Ann Benitez,22,0,40,18
1714371111956,EDS 281,A00,507345,Daly; Alan J.,18,0,18,0
1714371112983,EDS 284,A00,507350,Daly; Alan J.,16,0,16,0
1714371114011,EDS 286,A00,507359,Fine; Sarah,18,0,18,0
1714371115036,EDS 289C,A01,507361,Daly; Alan J.,18,0,18,0
1714371116063,EDS 290,A00,507366,Hofstetter; Carolyn,15,0,15,0
1714371117092,LIGM 5A,A00,507421,Fischer-Grunski; Eva K,18,0,20,2
1714371118118,LIGM 5B,A00,507423,Fischer-Grunski; Eva K,19,0,20,1
1714371119144,LIGM 5C,A00,507425,Fischer-Grunski; Eva K,19,0,20,1
1714371120168,LIIT 5AS,A00,507427,Carnelos; Chiara,20,0,20,0
1714371121194,LIIT 5BS,A00,507430,Carnelos; Chiara,20,0,20,0
1714371122220,LIIT 5CS,A00,507432,Carnelos; Chiara,20,0,20,0
1714371123255,LISP 5A,A00,507541,Munoz Sanchez; Alicia,11,0,20,9
1714371124280,LISP 5B,A00,507671,Munoz Sanchez; Alicia,9,0,20,11
1714371125305,LISP 5C,A00,507696,Munoz Sanchez; Alicia,9,0,20,11
1714371126331,MAE 197,001,528363,Boechler; Nicholas Sebastia,9998,0,9999,1
1714371127354,MATH 197,001,523477,Kedlaya; Kiran S.,9996,0,9999,3
1714371127354,MATH 197,002,563811,Zhang; Danna,9995,0,9999,4
1714371127354,MATH 197,003,628552,Dumitriu; Ioana,9998,0,9999,1
1714371128378,MCWP 40R,A00,518780,Staff,5,0,20,15
1714371128378,MCWP 40R,B00,518781,Staff,7,0,20,13
1714371128378,MCWP 40R,C00,518783,Staff,5,0,20,15
1714371129408,MCWP 50R,A00,518791,Staff,0,0,20,20
1714371129408,MCWP 50R,B00,518792,Staff,0,1,20,20
1714371129408,MCWP 50R,C00,518793,Staff,0,1,20,20
1714371129408,MCWP 50R,D00,518794,Staff,0,0,20,20
1714371129408,MCWP 50R,E00,518795,Staff,0,1,20,20
1714371129408,MCWP 50R,F00,518796,Staff,0,0,20,20
1714371129408,MCWP 50R,G00,518797,Staff,0,1,20,20
1714371130433,MMW 12R,A01,514034,Herbst; Matthew,0,1,16,16
1714371130433,MMW 12R,A02,514035,Herbst; Matthew,2,0,16,14
1714371131461,MMW 13R,A01,514037,Staff,0,4,16,16
1714371131461,MMW 13R,A02,514039,Staff,0,2,16,16
1714371131461,MMW 13R,A03,628519,Staff,0,2,16,16
1714371133569,SIO 295LS,A00,523233,Staff,12,0,30,18
1714371134595,SIO 295S,A00,523232,Staff,12,0,30,18
1714371135620,SIOC 290S,A01,637330,Merrifield; Mark A,27,0,30,3
1714371136647,SIOC 291S,A01,637333,Gabriel; Corey John,27,0,30,3
1714371137672,SOCI 117,A01,494376,Staff,0,3,5,5
1714371138697,WES 237B,A00,494380,Staff,9,0,20,11
1714371140762,AESE 279B,A00,494370,Wade; Jon P,0,0,33,33
1714371141787,AIP 197,001,627712,Vespa; Emanuel Ignacio,9998,0,9999,1
1714371142816,ANAR 135S,A00,494369,Braswell; Geoffrey E.,0,0,0,0
1714371143841,BENG 196,001,628496,Engler; Adam J.,9998,0,9999,1
1714371144868,CAT 124RS,A01,519847,Geibel; William,0,0,20,20
1714371145893,CAT 125RS,A01,515971,Geibel; William,0,0,20,20
1714371146918,CLRE 250,A00,511389,Morris; Sheldon,9993,0,9999,6
1714371147947,CLRE 251,A00,507176,Mehta; Ravindra L.,9993,0,9999,6
1714371147947,CLRE 251,B00,511410,Mehta; Ravindra L.,9998,0,9999,1
1714371148978,CLRE 252,A00,507189,Cuomo; Raphael Eduardo,9995,0,9999,4
1714371150002,CLRE 253,A00,507199,Vaida; Florin,9994,0,9999,5
1714371150002,CLRE 253,B00,507202,Vaida; Florin,9999,0,9999,0
1714371151030,CLRE 259,A00,507211,Patel; Hemal,9996,0,9999,3
1714371152058,CLRE 260,A00,507221,Cuomo; Raphael Eduardo,9999,0,9999,0
1714371153082,CLRE 297,001,507242,Cuomo; Raphael Eduardo,9999,0,9999,0
1714371154108,COGS 197,001,638244,Voytek; Bradley Thomas,9999,0,9999,0
1714371155137,CSE 191,A00,516875,Minnes Kemp; Mor Mia,9993,0,9999,6
1714371156162,CSE 197,001,637388,Minnes Kemp; Mor Mia,9998,0,9999,1
1714371157194,CSS 201S,A01,494383,Staff,35,0,35,0
1714371158224,CSS 202S,A01,494387,Staff,35,0,35,0
1714371159249,DSC 197,001,628532,Eldridge; Justin Matthew,9996,0,9999,3
1714371160275,EAP 100,A00,516065,Staff,9797,0,9999,202
1714371161300,ECE 45,A01,507414,Staff,33,0,60,27
1714371163352,ECE 111,A01,507420,Staff,19,0,50,31
1714371164379,ECE 197,001,548057,Sievenpiper; Daniel F.,9994,0,9999,5
1714371165404,EDS 115,A00,507243,Choi; Bailey Miyeon,12,0,28,16
1714371166431,EDS 117,A01,494379,Staff,0,2,30,30
1714371167456,EDS 125,A00,507246,Hopkins; Megan Beth,12,0,30,18
1714371168482,EDS 128A,A01,507264,Fargason; Sharon Gayle,14,0,26,12
1714371169508,EDS 128B,A01,507293,Pappas; Elizabeth,18,0,30,12
1714371170534,EDS 139,A00,507294,Fargason; Sharon Gayle,18,0,30,12
1714371170534,EDS 139,B00,507313,Pappas; Elizabeth,15,0,30,15
1714371171559,EDS 201,A00,507315,Staff,13,0,30,17
1714371172583,EDS 203,A01,507317,Halter; Christopher P.,12,0,30,18
1714371173615,EDS 204R,A01,507319,Halter; Christopher P.,0,3,30,30
1714371173615,EDS 204R,B01,507331,Heinzman; Erica M.,17,0,30,13
1714371174641,EDS 206R,A00,507332,Staff,0,4,30,30
1714371174641,EDS 206R,B00,507343,Staff,18,0,30,12
1714371175667,EDS 250,A00,507344,Hemans; Patricia Ann Benitez,22,0,40,18
1714371176692,EDS 281,A00,507345,Daly; Alan J.,18,0,18,0
1714371177718,EDS 284,A00,507350,Daly; Alan J.,16,0,16,0
1714371178743,EDS 286,A00,507359,Fine; Sarah,18,0,18,0
1714371179770,EDS 289C,A01,507361,Daly; Alan J.,18,0,18,0
1714371180796,EDS 290,A00,507366,Hofstetter; Carolyn,15,0,15,0
1714371181822,LIGM 5A,A00,507421,Fischer-Grunski; Eva K,18,0,20,2
1714371182848,LIGM 5B,A00,507423,Fischer-Grunski; Eva K,19,0,20,1
1714371183877,LIGM 5C,A00,507425,Fischer-Grunski; Eva K,19,0,20,1
1714371184902,LIIT 5AS,A00,507427,Carnelos; Chiara,20,0,20,0
1714371185929,LIIT 5BS,A00,507430,Carnelos; Chiara,20,0,20,0
1714371186958,LIIT 5CS,A00,507432,Carnelos; Chiara,20,0,20,0
1714371187988,LISP 5A,A00,507541,Munoz Sanchez; Alicia,11,0,20,9
1714371189018,LISP 5B,A00,507671,Munoz Sanchez; Alicia,9,0,20,11
1714371190042,LISP 5C,A00,507696,Munoz Sanchez; Alicia,9,0,20,11
1714371191073,MAE 197,001,528363,Boechler; Nicholas Sebastia,9998,0,9999,1
1714371192102,MATH 197,001,523477,Kedlaya; Kiran S.,9996,0,9999,3
1714371192102,MATH 197,002,563811,Zhang; Danna,9995,0,9999,4
1714371192102,MATH 197,003,628552,Dumitriu; Ioana,9998,0,9999,1
1714371193131,MCWP 40R,A00,518780,Staff,5,0,20,15
1714371193131,MCWP 40R,B00,518781,Staff,7,0,20,13
1714371193131,MCWP 40R,C00,518783,Staff,5,0,20,15
1714371194159,MCWP 50R,A00,518791,Staff,0,0,20,20
1714371194159,MCWP 50R,B00,518792,Staff,0,1,20,20
1714371194159,MCWP 50R,C00,518793,Staff,0,1,20,20
1714371194159,MCWP 50R,D00,518794,Staff,0,0,20,20
1714371194159,MCWP 50R,E00,518795,Staff,0,1,20,20
1714371194159,MCWP 50R,F00,518796,Staff,0,0,20,20
1714371194159,MCWP 50R,G00,518797,Staff,0,1,20,20
1714371195185,MMW 12R,A01,514034,Herbst; Matthew,0,1,16,16
1714371195185,MMW 12R,A02,514035,Herbst; Matthew,2,0,16,14
1714371196210,MMW 13R,A01,514037,Staff,0,4,16,16
1714371196210,MMW 13R,A02,514039,Staff,0,2,16,16
1714371196210,MMW 13R,A03,628519,Staff,0,2,16,16
1714371198261,SIO 295LS,A00,523233,Staff,12,0,30,18
1714371199294,SIO 295S,A00,523232,Staff,12,0,30,18
1714371200319,SIOC 290S,A01,637330,Merrifield; Mark A,27,0,30,3
1714371201344,SIOC 291S,A01,637333,Gabriel; Corey John,27,0,30,3
1714371202367,SOCI 117,A01,494376,Staff,0,3,5,5
1714371203391,WES 237B,A00,494380,Staff,9,0,20,11
1714371205468,AESE 279B,A00,494370,Wade; Jon P,0,0,33,33
1714371206495,AIP 197,001,627712,Vespa; Emanuel Ignacio,9998,0,9999,1
1714371207520,ANAR 135S,A00,494369,Braswell; Geoffrey E.,0,0,0,0
1714371208545,BENG 196,001,628496,Engler; Adam J.,9998,0,9999,1
1714371209573,CAT 124RS,A01,519847,Geibel; William,0,0,20,20
1714371210598,CAT 125RS,A01,515971,Geibel; William,0,0,20,20
1714371211622,CLRE 250,A00,511389,Morris; Sheldon,9993,0,9999,6
1714371212654,CLRE 251,A00,507176,Mehta; Ravindra L.,9993,0,9999,6
1714371212654,CLRE 251,B00,511410,Mehta; Ravindra L.,9998,0,9999,1
1714371213679,CLRE 252,A00,507189,Cuomo; Raphael Eduardo,9995,0,9999,4
1714371214708,CLRE 253,A00,507199,Vaida; Florin,9994,0,9999,5
1714371214708,CLRE 253,B00,507202,Vaida; Florin,9999,0,9999,0
1714371215734,CLRE 259,A00,507211,Patel; Hemal,9996,0,9999,3
1714371216762,CLRE 260,A00,507221,Cuomo; Raphael Eduardo,9999,0,9999,0
1714371217789,CLRE 297,001,507242,Cuomo; Raphael Eduardo,9999,0,9999,0
1714371218818,COGS 197,001,638244,Voytek; Bradley Thomas,9999,0,9999,0
1714371219843,CSE 191,A00,516875,Minnes Kemp; Mor Mia,9993,0,9999,6
1714371220867,CSE 197,001,637388,Minnes Kemp; Mor Mia,9998,0,9999,1
1714371221893,CSS 201S,A01,494383,Staff,35,0,35,0
1714371222918,CSS 202S,A01,494387,Staff,35,0,35,0
1714371223946,DSC 197,001,628532,Eldridge; Justin Matthew,9996,0,9999,3
1714371224971,EAP 100,A00,516065,Staff,9797,0,9999,202
1714371225998,ECE 45,A01,507414,Staff,33,0,60,27
1714371228050,ECE 111,A01,507420,Staff,19,0,50,31
1714371229076,ECE 197,001,548057,Sievenpiper; Daniel F.,9994,0,9999,5
1714371230105,EDS 115,A00,507243,Choi; Bailey Miyeon,12,0,28,16
1714371231133,EDS 117,A01,494379,Staff,0,2,30,30
1714371232158,EDS 125,A00,507246,Hopkins; Megan Beth,12,0,30,18
1714371233183,EDS 128A,A01,507264,Fargason; Sharon Gayle,14,0,26,12
1714371234232,EDS 128B,A01,507293,Pappas; Elizabeth,18,0,30,12
1714371235256,EDS 139,A00,507294,Fargason; Sharon Gayle,18,0,30,12
1714371235256,EDS 139,B00,507313,Pappas; Elizabeth,15,0,30,15
1714371236284,EDS 201,A00,507315,Staff,13,0,30,17
1714371237385,EDS 203,A01,507317,Halter; Christopher P.,12,0,30,18
1714371238410,EDS 204R,A01,507319,Halter; Christopher P.,0,3,30,30
1714371238410,EDS 204R,B01,507331,Heinzman; Erica M.,17,0,30,13
1714371239443,EDS 206R,A00,507332,Staff,0,4,30,30
1714371239443,EDS 206R,B00,507343,Staff,18,0,30,12
1714371240471,EDS 250,A00,507344,Hemans; Patricia Ann Benitez,22,0,40,18
1714371241501,EDS 281,A00,507345,Daly; Alan J.,18,0,18,0
1714371242526,EDS 284,A00,507350,Daly; Alan J.,16,0,16,0
1714371243552,EDS 286,A00,507359,Fine; Sarah,18,0,18,0
1714371244577,EDS 289C,A01,507361,Daly; Alan J.,18,0,18,0
1714371245612,EDS 290,A00,507366,Hofstetter; Carolyn,15,0,15,0
1714371246638,LIGM 5A,A00,507421,Fischer-Grunski; Eva K,18,0,20,2
1714371247666,LIGM 5B,A00,507423,Fischer-Grunski; Eva K,19,0,20,1
1714371248696,LIGM 5C,A00,507425,Fischer-Grunski; Eva K,19,0,20,1
1714371249724,LIIT 5AS,A00,507427,Carnelos; Chiara,20,0,20,0
1714371250749,LIIT 5BS,A00,507430,Carnelos; Chiara,20,0,20,0
1714371251779,LIIT 5CS,A00,507432,Carnelos; Chiara,20,0,20,0
1714371252807,LISP 5A,A00,507541,Munoz Sanchez; Alicia,11,0,20,9
1714371253831,LISP 5B,A00,507671,Munoz Sanchez; Alicia,9,0,20,11
1714371254857,LISP 5C,A00,507696,Munoz Sanchez; Alicia,9,0,20,11
1714371255883,MAE 197,001,528363,Boechler; Nicholas Sebastia,9998,0,9999,1
1714371256913,MATH 197,001,523477,Kedlaya; Kiran S.,9996,0,9999,3
1714371256913,MATH 197,002,563811,Zhang; Danna,9995,0,9999,4
1714371256913,MATH 197,003,628552,Dumitriu; Ioana,9998,0,9999,1
1714371257942,MCWP 40R,A00,518780,Staff,5,0,20,15
1714371257942,MCWP 40R,B00,518781,Staff,7,0,20,13
1714371257942,MCWP 40R,C00,518783,Staff,5,0,20,15
1714371258973,MCWP 50R,A00,518791,Staff,0,0,20,20
1714371258973,MCWP 50R,B00,518792,Staff,0,1,20,20
1714371258973,MCWP 50R,C00,518793,Staff,0,1,20,20
1714371258973,MCWP 50R,D00,518794,Staff,0,0,20,20
1714371258973,MCWP 50R,E00,518795,Staff,0,1,20,20
1714371258973,MCWP 50R,F00,518796,Staff,0,0,20,20
1714371258973,MCWP 50R,G00,518797,Staff,0,1,20,20
1714371260002,MMW 12R,A01,514034,Herbst; Matthew,0,1,16,16
1714371260002,MMW 12R,A02,514035,Herbst; Matthew,2,0,16,14
1714371261027,MMW 13R,A01,514037,Staff,0,4,16,16
1714371261027,MMW 13R,A02,514039,Staff,0,2,16,16
1714371261027,MMW 13R,A03,628519,Staff,0,2,16,16
1714371263082,SIO 295LS,A00,523233,Staff,12,0,30,18
1714371264107,SIO 295S,A00,523232,Staff,12,0,30,18
1714371265134,SIOC 290S,A01,637330,Merrifield; Mark A,27,0,30,3
1714371266159,SIOC 291S,A01,637333,Gabriel; Corey John,27,0,30,3
1714371267187,SOCI 117,A01,494376,Staff,0,3,5,5
1714371268215,WES 237B,A00,494380,Staff,9,0,20,11
1714371270288,AESE 279B,A00,494370,Wade; Jon P,0,0,33,33
1714371271313,AIP 197,001,627712,Vespa; Emanuel Ignacio,9998,0,9999,1
1714371272338,ANAR 135S,A00,494369,Braswell; Geoffrey E.,0,0,0,0
1714371273362,BENG 196,001,628496,Engler; Adam J.,9998,0,9999,1
1714371274387,CAT 124RS,A01,519847,Geibel; William,0,0,20,20
1714371275412,CAT 125RS,A01,515971,Geibel; William,0,0,20,20
1714371276439,CLRE 250,A00,511389,Morris; Sheldon,9993,0,9999,6
1714371277464,CLRE 251,A00,507176,Mehta; Ravindra L.,9993,0,9999,6
1714371277464,CLRE 251,B00,511410,Mehta; Ravindra L.,9998,0,9999,1
1714371278488,CLRE 252,A00,507189,Cuomo; Raphael Eduardo,9995,0,9999,4
1714371279514,CLRE 253,A00,507199,Vaida; Florin,9994,0,9999,5
1714371279514,CLRE 253,B00,507202,Vaida; Florin,9999,0,9999,0
1714371280539,CLRE 259,A00,507211,Patel; Hemal,9996,0,9999,3
1714371281565,CLRE 260,A00,507221,Cuomo; Raphael Eduardo,9999,0,9999,0
1714371282590,CLRE 297,001,507242,Cuomo; Raphael Eduardo,9999,0,9999,0
1714371283615,COGS 197,001,638244,Voytek; Bradley Thomas,9999,0,9999,0
1714371284645,CSE 191,A00,516875,Minnes Kemp; Mor Mia,9993,0,9999,6
1714371285670,CSE 197,001,637388,Minnes Kemp; Mor Mia,9998,0,9999,1
1714371286695,CSS 201S,A01,494383,Staff,35,0,35,0
1714371287725,CSS 202S,A01,494387,Staff,35,0,35,0
1714371288751,DSC 197,001,628532,Eldridge; Justin Matthew,9996,0,9999,3
1714371289775,EAP 100,A00,516065,Staff,9797,0,9999,202
1714371290801,ECE 45,A01,507414,Staff,33,0,60,27
1714371292850,ECE 111,A01,507420,Staff,19,0,50,31
1714371293875,ECE 197,001,548057,Sievenpiper; Daniel F.,9994,0,9999,5
1714371294901,EDS 115,A00,507243,Choi; Bailey Miyeon,12,0,28,16
1714371295929,EDS 117,A01,494379,Staff,0,2,30,30
1714371296955,EDS 125,A00,507246,Hopkins; Megan Beth,12,0,30,18
1714371297980,EDS 128A,A01,507264,Fargason; Sharon Gayle,14,0,26,12
1714371299009,EDS 128B,A01,507293,Pappas; Elizabeth,18,0,30,12
1714371300034,EDS 139,A00,507294,Fargason; Sharon Gayle,18,0,30,12
1714371300034,EDS 139,B00,507313,Pappas; Elizabeth,15,0,30,15
1714371301059,EDS 201,A00,507315,Staff,13,0,30,17
1714371302092,EDS 203,A01,507317,Halter; Christopher P.,12,0,30,18
1714371303120,EDS 204R,A01,507319,Halter; Christopher P.,0,3,30,30
1714371303120,EDS 204R,B01,507331,Heinzman; Erica M.,17,0,30,13
1714371304147,EDS 206R,A00,507332,Staff,0,4,30,30
1714371304147,EDS 206R,B00,507343,Staff,18,0,30,12
1714371305173,EDS 250,A00,507344,Hemans; Patricia Ann Benitez,22,0,40,18
1714371306199,EDS 281,A00,507345,Daly; Alan J.,18,0,18,0
1714371307225,EDS 284,A00,507350,Daly; Alan J.,16,0,16,0
1714371308249,EDS 286,A00,507359,Fine; Sarah,18,0,18,0
1714371309277,EDS 289C,A01,507361,Daly; Alan J.,18,0,18,0
1714371310302,EDS 290,A00,507366,Hofstetter; Carolyn,15,0,15,0
1714371311331,LIGM 5A,A00,507421,Fischer-Grunski; Eva K,18,0,20,2
1714371312356,LIGM 5B,A00,507423,Fischer-Grunski; Eva K,19,0,20,1
1714371313381,LIGM 5C,A00,507425,Fischer-Grunski; Eva K,19,0,20,1
1714371314405,LIIT 5AS,A00,507427,Carnelos; Chiara,20,0,20,0
1714371315431,LIIT 5BS,A00,507430,Carnelos; Chiara,20,0,20,0
1714371316461,LIIT 5CS,A00,507432,Carnelos; Chiara,20,0,20,0
1714371317488,LISP 5A,A00,507541,Munoz Sanchez; Alicia,11,0,20,9
1714371318513,LISP 5B,A00,507671,Munoz Sanchez; Alicia,9,0,20,11
1714371319542,LISP 5C,A00,507696,Munoz Sanchez; Alicia,9,0,20,11
1714371320570,MAE 197,001,528363,Boechler; Nicholas Sebastia,9998,0,9999,1
1714371321599,MATH 197,001,523477,Kedlaya; Kiran S.,9996,0,9999,3
1714371321599,MATH 197,002,563811,Zhang; Danna,9995,0,9999,4
1714371321599,MATH 197,003,628552,Dumitriu; Ioana,9998,0,9999,1
1714371322625,MCWP 40R,A00,518780,Staff,5,0,20,15
1714371322625,MCWP 40R,B00,518781,Staff,7,0,20,13
1714371322625,MCWP 40R,C00,518783,Staff,5,0,20,15
1714371323650,MCWP 50R,A00,518791,Staff,0,0,20,20
1714371323650,MCWP 50R,B00,518792,Staff,0,1,20,20
1714371323650,MCWP 50R,C00,518793,Staff,0,1,20,20
1714371323650,MCWP 50R,D00,518794,Staff,0,0,20,20
1714371323650,MCWP 50R,E00,518795,Staff,0,1,20,20
1714371323650,MCWP 50R,F00,518796,Staff,0,0,20,20
1714371323650,MCWP 50R,G00,518797,Staff,0,1,20,20
1714371324676,MMW 12R,A01,514034,Herbst; Matthew,0,1,16,16
1714371324676,MMW 12R,A02,514035,Herbst; Matthew,2,0,16,14
1714371325703,MMW 13R,A01,514037,Staff,0,4,16,16
1714371325703,MMW 13R,A02,514039,Staff,0,2,16,16
1714371325703,MMW 13R,A03,628519,Staff,0,2,16,16
1714371327757,SIO 295LS,A00,523233,Staff,12,0,30,18
1714371328783,SIO 295S,A00,523232,Staff,12,0,30,18
1714371329810,SIOC 290S,A01,637330,Merrifield; Mark A,27,0,30,3
1714371330834,SIOC 291S,A01,637333,Gabriel; Corey John,27,0,30,3
1714371331860,SOCI 117,A01,494376,Staff,0,3,5,5
1714371332885,WES 237B,A00,494380,Staff,9,0,20,11
1714371334943,AESE 279B,A00,494370,Wade; Jon P,0,0,33,33
1714371335967,AIP 197,001,627712,Vespa; Emanuel Ignacio,9998,0,9999,1
1714371336994,ANAR 135S,A00,494369,Braswell; Geoffrey E.,0,0,0,0
1714371338023,BENG 196,001,628496,Engler; Adam J.,9998,0,9999,1
1714371339050,CAT 124RS,A01,519847,Geibel; William,0,0,20,20
1714371340075,CAT 125RS,A01,515971,Geibel; William,0,0,20,20
1714371341154,CLRE 250,A00,511389,Morris; Sheldon,9993,0,9999,6
1714371342180,CLRE 251,A00,507176,Mehta; Ravindra L.,9993,0,9999,6
1714371342180,CLRE 251,B00,511410,Mehta; Ravindra L.,9998,0,9999,1
1714371343206,CLRE 252,A00,507189,Cuomo; Raphael Eduardo,9995,0,9999,4
1714371344236,CLRE 253,A00,507199,Vaida; Florin,9994,0,9999,5
1714371344236,CLRE 253,B00,507202,Vaida; Florin,9999,0,9999,0
1714371345263,CLRE 259,A00,507211,Patel; Hemal,9996,0,9999,3
1714371346289,CLRE 260,A00,507221,Cuomo; Raphael Eduardo,9999,0,9999,0
1714371347316,CLRE 297,001,507242,Cuomo; Raphael Eduardo,9999,0,9999,0
1714371348340,COGS 197,001,638244,Voytek; Bradley Thomas,9999,0,9999,0
1714371349365,CSE 191,A00,516875,Minnes Kemp; Mor Mia,9993,0,9999,6
1714371350394,CSE 197,001,637388,Minnes Kemp; Mor Mia,9998,0,9999,1
1714371351422,CSS 201S,A01,494383,Staff,35,0,35,0
1714371352449,CSS 202S,A01,494387,Staff,35,0,35,0
1714371353475,DSC 197,001,628532,Eldridge; Justin Matthew,9996,0,9999,3
1714371354501,EAP 100,A00,516065,Staff,9797,0,9999,202
1714371355526,ECE 45,A01,507414,Staff,33,0,60,27
1714371357583,ECE 111,A01,507420,Staff,19,0,50,31
1714371358608,ECE 197,001,548057,Sievenpiper; Daniel F.,9994,0,9999,5
1714371359633,EDS 115,A00,507243,Choi; Bailey Miyeon,12,0,28,16
1714371360659,EDS 117,A01,494379,Staff,0,2,30,30
1714371361687,EDS 125,A00,507246,Hopkins; Megan Beth,12,0,30,18
1714371362712,EDS 128A,A01,507264,Fargason; Sharon Gayle,14,0,26,12
1714371363738,EDS 128B,A01,507293,Pappas; Elizabeth,18,0,30,12
1714371364763,EDS 139,A00,507294,Fargason; Sharon Gayle,18,0,30,12
1714371364763,EDS 139,B00,507313,Pappas; Elizabeth,15,0,30,15
1714371365787,EDS 201,A00,507315,Staff,13,0,30,17
1714371366812,EDS 203,A01,507317,Halter; Christopher P.,12,0,30,18
1714371367838,EDS 204R,A01,507319,Halter; Christopher P.,0,3,30,30
1714371367838,EDS 204R,B01,507331,Heinzman; Erica M.,17,0,30,13
1714371368862,EDS 206R,A00,507332,Staff,0,4,30,30
1714371368862,EDS 206R,B00,507343,Staff,18,0,30,12
1714371369887,EDS 250,A00,507344,Hemans; Patricia Ann Benitez,22,0,40,18
1714371370915,EDS 281,A00,507345,Daly; Alan J.,18,0,18,0
1714371371943,EDS 284,A00,507350,Daly; Alan J.,16,0,16,0
1714371372968,EDS 286,A00,507359,Fine; Sarah,18,0,18,0
1714371373994,EDS 289C,A01,507361,Daly; Alan J.,18,0,18,0
1714371375019,EDS 290,A00,507366,Hofstetter; Carolyn,15,0,15,0
1714371376046,LIGM 5A,A00,507421,Fischer-Grunski; Eva K,18,0,20,2
1714371377071,LIGM 5B,A00,507423,Fischer-Grunski; Eva K,19,0,20,1
1714371378098,LIGM 5C,A00,507425,Fischer-Grunski; Eva K,19,0,20,1
1714371379123,LIIT 5AS,A00,507427,Carnelos; Chiara,20,0,20,0
1714371380151,LIIT 5BS,A00,507430,Carnelos; Chiara,20,0,20,0
1714371381180,LIIT 5CS,A00,507432,Carnelos; Chiara,20,0,20,0
1714371382211,LISP 5A,A00,507541,Munoz Sanchez; Alicia,11,0,20,9
1714371383240,LISP 5B,A00,507671,Munoz Sanchez; Alicia,9,0,20,11
1714371384269,LISP 5C,A00,507696,Munoz Sanchez; Alicia,9,0,20,11
1714371385295,MAE 197,001,528363,Boechler; Nicholas Sebastia,9998,0,9999,1
1714371386319,MATH 197,001,523477,Kedlaya; Kiran S.,9996,0,9999,3
1714371386319,MATH 197,002,563811,Zhang; Danna,9995,0,9999,4
1714371386319,MATH 197,003,628552,Dumitriu; Ioana,9998,0,9999,1
1714371387345,MCWP 40R,A00,518780,Staff,5,0,20,15
1714371387345,MCWP 40R,B00,518781,Staff,7,0,20,13
1714371387345,MCWP 40R,C00,518783,Staff,5,0,20,15
1714371388370,MCWP 50R,A00,518791,Staff,0,0,20,20
1714371388370,MCWP 50R,B00,518792,Staff,0,1,20,20
1714371388370,MCWP 50R,C00,518793,Staff,0,1,20,20
1714371388370,MCWP 50R,D00,518794,Staff,0,0,20,20
1714371388370,MCWP 50R,E00,518795,Staff,0,1,20,20
1714371388370,MCWP 50R,F00,518796,Staff,0,0,20,20
1714371388370,MCWP 50R,G00,518797,Staff,0,1,20,20
1714371389394,MMW 12R,A01,514034,Herbst; Matthew,0,1,16,16
1714371389394,MMW 12R,A02,514035,Herbst; Matthew,2,0,16,14
1714371390420,MMW 13R,A01,514037,Staff,0,4,16,16
1714371390420,MMW 13R,A02,514039,Staff,0,2,16,16
1714371390420,MMW 13R,A03,628519,Staff,0,2,16,16
1714371392476,SIO 295LS,A00,523233,Staff,12,0,30,18
1714371393502,SIO 295S,A00,523232,Staff,12,0,30,18
1714371394527,SIOC 290S,A01,637330,Merrifield; Mark A,27,0,30,3
1714371395553,SIOC 291S,A01,637333,Gabriel; Corey John,27,0,30,3
1714371396579,SOCI 117,A01,494376,Staff,0,3,5,5
1714371397603,WES 237B,A00,494380,Staff,9,0,20,11
1714371399667,AESE 279B,A00,494370,Wade; Jon P,0,0,33,33
1714371400692,AIP 197,001,627712,Vespa; Emanuel Ignacio,9998,0,9999,1
1714371401720,ANAR 135S,A00,494369,Braswell; Geoffrey E.,0,0,0,0
1714371402747,BENG 196,001,628496,Engler; Adam J.,9998,0,9999,1
1714371403772,CAT 124RS,A01,519847,Geibel; William,0,0,20,20
1714371404798,CAT 125RS,A01,515971,Geibel; William,0,0,20,20
1714371405823,CLRE 250,A00,511389,Morris; Sheldon,9993,0,9999,6
1714371406848,CLRE 251,A00,507176,Mehta; Ravindra L.,9993,0,9999,6
1714371406848,CLRE 251,B00,511410,Mehta; Ravindra L.,9998,0,9999,1
1714371407872,CLRE 252,A00,507189,Cuomo; Raphael Eduardo,9995,0,9999,4
1714371408901,CLRE 253,A00,507199,Vaida; Florin,9994,0,9999,5
1714371408901,CLRE 253,B00,507202,Vaida; Florin,9999,0,9999,0
1714371409927,CLRE 259,A00,507211,Patel; Hemal,9996,0,9999,3
1714371410955,CLRE 260,A00,507221,Cuomo; Raphael Eduardo,9999,0,9999,0
1714371411983,CLRE 297,001,507242,Cuomo; Raphael Eduardo,9999,0,9999,0
1714371413015,COGS 197,001,638244,Voytek; Bradley Thomas,9999,0,9999,0
1714371414042,CSE 191,A00,516875,Minnes Kemp; Mor Mia,9993,0,9999,6
1714371415070,CSE 197,001,637388,Minnes Kemp; Mor Mia,9998,0,9999,1
1714371416099,CSS 201S,A01,494383,Staff,35,0,35,0
1714371417128,CSS 202S,A01,494387,Staff,35,0,35,0
1714371418153,DSC 197,001,628532,Eldridge; Justin Matthew,9996,0,9999,3
1714371419177,EAP 100,A00,516065,Staff,9797,0,9999,202
1714371420204,ECE 45,A01,507414,Staff,33,0,60,27
1714371422262,ECE 111,A01,507420,Staff,19,0,50,31
1714371423292,ECE 197,001,548057,Sievenpiper; Daniel F.,9994,0,9999,5
1714371424318,EDS 115,A00,507243,Choi; Bailey Miyeon,12,0,28,16
1714371425345,EDS 117,A01,494379,Staff,0,2,30,30
1714371426371,EDS 125,A00,507246,Hopkins; Megan Beth,12,0,30,18
1714371427398,EDS 128A,A01,507264,Fargason; Sharon Gayle,14,0,26,12
1714371428424,EDS 128B,A01,507293,Pappas; Elizabeth,18,0,30,12
1714371429449,EDS 139,A00,507294,Fargason; Sharon Gayle,18,0,30,12
1714371429449,EDS 139,B00,507313,Pappas; Elizabeth,15,0,30,15
1714371430476,EDS 201,A00,507315,Staff,13,0,30,17
1714371431501,EDS 203,A01,507317,Halter; Christopher P.,12,0,30,18
1714371432525,EDS 204R,A01,507319,Halter; Christopher P.,0,3,30,30
1714371432525,EDS 204R,B01,507331,Heinzman; Erica M.,17,0,30,13
1714371433549,EDS 206R,A00,507332,Staff,0,4,30,30
1714371433549,EDS 206R,B00,507343,Staff,18,0,30,12
1714371434574,EDS 250,A00,507344,Hemans; Patricia Ann Benitez,22,0,40,18
1714371435600,EDS 281,A00,507345,Daly; Alan J.,18,0,18,0
1714371436627,EDS 284,A00,507350,Daly; Alan J.,16,0,16,0
1714371437651,EDS 286,A00,507359,Fine; Sarah,18,0,18,0
1714371438676,EDS 289C,A01,507361,Daly; Alan J.,18,0,18,0
1714371439700,EDS 290,A00,507366,Hofstetter; Carolyn,15,0,15,0
1714371440725,LIGM 5A,A00,507421,Fischer-Grunski; Eva K,18,0,20,2
1714371441749,LIGM 5B,A00,507423,Fischer-Grunski; Eva K,19,0,20,1
1714371442775,LIGM 5C,A00,507425,Fischer-Grunski; Eva K,19,0,20,1
1714371443800,LIIT 5AS,A00,507427,Carnelos; Chiara,20,0,20,0
1714371444883,LIIT 5BS,A00,507430,Carnelos; Chiara,20,0,20,0
1714371445910,LIIT 5CS,A00,507432,Carnelos; Chiara,20,0,20,0
1714371446935,LISP 5A,A00,507541,Munoz Sanchez; Alicia,11,0,20,9
1714371447961,LISP 5B,A00,507671,Munoz Sanchez; Alicia,9,0,20,11
1714371448986,LISP 5C,A00,507696,Munoz Sanchez; Alicia,9,0,20,11
1714371450012,MAE 197,001,528363,Boechler; Nicholas Sebastia,9998,0,9999,1
1714371451038,MATH 197,001,523477,Kedlaya; Kiran S.,9996,0,9999,3
1714371451038,MATH 197,002,563811,Zhang; Danna,9995,0,9999,4
1714371451038,MATH 197,003,628552,Dumitriu; Ioana,9998,0,9999,1
1714371452067,MCWP 40R,A00,518780,Staff,5,0,20,15
1714371452067,MCWP 40R,B00,518781,Staff,7,0,20,13
1714371452067,MCWP 40R,C00,518783,Staff,5,0,20,15
1714371453094,MCWP 50R,A00,518791,Staff,0,0,20,20
1714371453094,MCWP 50R,B00,518792,Staff,0,1,20,20
1714371453094,MCWP 50R,C00,518793,Staff,0,1,20,20
1714371453094,MCWP 50R,D00,518794,Staff,0,0,20,20
1714371453094,MCWP 50R,E00,518795,Staff,0,1,20,20
1714371453094,MCWP 50R,F00,518796,Staff,0,0,20,20
1714371453094,MCWP 50R,G00,518797,Staff,0,1,20,20
1714371454120,MMW 12R,A01,514034,Herbst; Matthew,0,1,16,16
1714371454120,MMW 12R,A02,514035,Herbst; Matthew,2,0,16,14
1714371455147,MMW 13R,A01,514037,Staff,0,4,16,16
1714371455147,MMW 13R,A02,514039,Staff,0,2,16,16
1714371455147,MMW 13R,A03,628519,Staff,0,2,16,16
1714371457197,SIO 295LS,A00,523233,Staff,12,0,30,18
1714371458223,SIO 295S,A00,523232,Staff,12,0,30,18
1714371459254,SIOC 290S,A01,637330,Merrifield; Mark A,27,0,30,3
1714371460281,SIOC 291S,A01,637333,Gabriel; Corey John,27,0,30,3
1714371461308,SOCI 117,A01,494376,Staff,0,3,5,5
1714371462333,WES 237B,A00,494380,Staff,9,0,20,11
1714371464392,AESE 279B,A00,494370,Wade; Jon P,0,0,33,33
1714371465419,AIP 197,001,627712,Vespa; Emanuel Ignacio,9998,0,9999,1
1714371466446,ANAR 135S,A00,494369,Braswell; Geoffrey E.,0,0,0,0
1714371467473,BENG 196,001,628496,Engler; Adam J.,9998,0,9999,1
1714371468503,CAT 124RS,A01,519847,Geibel; William,0,0,20,20
1714371469533,CAT 125RS,A01,515971,Geibel; William,0,0,20,20
1714371470561,CLRE 250,A00,511389,Morris; Sheldon,9993,0,9999,6
1714371471587,CLRE 251,A00,507176,Mehta; Ravindra L.,9993,0,9999,6
1714371471587,CLRE 251,B00,511410,Mehta; Ravindra L.,9998,0,9999,1
1714371472612,CLRE 252,A00,507189,Cuomo; Raphael Eduardo,9995,0,9999,4
1714371473640,CLRE 253,A00,507199,Vaida; Florin,9994,0,9999,5
1714371473640,CLRE 253,B00,507202,Vaida; Florin,9999,0,9999,0
1714371474666,CLRE 259,A00,507211,Patel; Hemal,9996,0,9999,3
1714371475692,CLRE 260,A00,507221,Cuomo; Raphael Eduardo,9999,0,9999,0
1714371476718,CLRE 297,001,507242,Cuomo; Raphael Eduardo,9999,0,9999,0
1714371477747,COGS 197,001,638244,Voytek; Bradley Thomas,9999,0,9999,0
1714371478775,CSE 191,A00,516875,Minnes Kemp; Mor Mia,9993,0,9999,6
1714371479800,CSE 197,001,637388,Minnes Kemp; Mor Mia,9998,0,9999,1
1714371480830,CSS 201S,A01,494383,Staff,35,0,35,0
1714371481860,CSS 202S,A01,494387,Staff,35,0,35,0
1714371482886,DSC 197,001,628532,Eldridge; Justin Matthew,9996,0,9999,3
1714371483915,EAP 100,A00,516065,Staff,9797,0,9999,202
1714371484940,ECE 45,A01,507414,Staff,33,0,60,27
1714371486994,ECE 111,A01,507420,Staff,19,0,50,31
1714371488018,ECE 197,001,548057,Sievenpiper; Daniel F.,9994,0,9999,5
1714371489048,EDS 115,A00,507243,Choi; Bailey Miyeon,12,0,28,16
1714371490072,EDS 117,A01,494379,Staff,0,2,30,30
1714371491097,EDS 125,A00,507246,Hopkins; Megan Beth,12,0,30,18
1714371492126,EDS 128A,A01,507264,Fargason; Sharon Gayle,14,0,26,12
1714371493152,EDS 128B,A01,507293,Pappas; Elizabeth,18,0,30,12
1714371494180,EDS 139,A00,507294,Fargason; Sharon Gayle,18,0,30,12
1714371494180,EDS 139,B00,507313,Pappas; Elizabeth,15,0,30,15
1714371495207,EDS 201,A00,507315,Staff,13,0,30,17
1714371496231,EDS 203,A01,507317,Halter; Christopher P.,12,0,30,18
1714371497256,EDS 204R,A01,507319,Halter; Christopher P.,0,3,30,30
1714371497256,EDS 204R,B01,507331,Heinzman; Erica M.,17,0,30,13
1714371498283,EDS 206R,A00,507332,Staff,0,4,30,30
1714371498283,EDS 206R,B00,507343,Staff,18,0,30,12
1714371499312,EDS 250,A00,507344,Hemans; Patricia Ann Benitez,22,0,40,18
1714371500339,EDS 281,A00,507345,Daly; Alan J.,18,0,18,0
1714371501368,EDS 284,A00,507350,Daly; Alan J.,16,0,16,0
1714371502395,EDS 286,A00,507359,Fine; Sarah,18,0,18,0
1714371503423,EDS 289C,A01,507361,Daly; Alan J.,18,0,18,0
1714371504449,EDS 290,A00,507366,Hofstetter; Carolyn,15,0,15,0
1714371505474,LIGM 5A,A00,507421,Fischer-Grunski; Eva K,18,0,20,2
1714371506499,LIGM 5B,A00,507423,Fischer-Grunski; Eva K,19,0,20,1
1714371507524,LIGM 5C,A00,507425,Fischer-Grunski; Eva K,19,0,20,1
1714371508550,LIIT 5AS,A00,507427,Carnelos; Chiara,20,0,20,0
1714371509578,LIIT 5BS,A00,507430,Carnelos; Chiara,20,0,20,0
1714371510604,LIIT 5CS,A00,507432,Carnelos; Chiara,20,0,20,0
1714371511633,LISP 5A,A00,507541,Munoz Sanchez; Alicia,11,0,20,9
1714371512661,LISP 5B,A00,507671,Munoz Sanchez; Alicia,9,0,20,11
1714371513690,LISP 5C,A00,507696,Munoz Sanchez; Alicia,9,0,20,11
1714371514716,MAE 197,001,528363,Boechler; Nicholas Sebastia,9998,0,9999,1
1714371515741,MATH 197,001,523477,Kedlaya; Kiran S.,9996,0,9999,3
1714371515741,MATH 197,002,563811,Zhang; Danna,9995,0,9999,4
1714371515741,MATH 197,003,628552,Dumitriu; Ioana,9998,0,9999,1
1714371516767,MCWP 40R,A00,518780,Staff,5,0,20,15
1714371516767,MCWP 40R,B00,518781,Staff,7,0,20,13
1714371516767,MCWP 40R,C00,518783,Staff,5,0,20,15
1714371517791,MCWP 50R,A00,518791,Staff,0,0,20,20
1714371517791,MCWP 50R,B00,518792,Staff,0,1,20,20
1714371517791,MCWP 50R,C00,518793,Staff,0,1,20,20
1714371517791,MCWP 50R,D00,518794,Staff,0,0,20,20
1714371517791,MCWP 50R,E00,518795,Staff,0,1,20,20
1714371517791,MCWP 50R,F00,518796,Staff,0,0,20,20
1714371517791,MCWP 50R,G00,518797,Staff,0,1,20,20
1714371518813,MMW 12R,A01,514034,Herbst; Matthew,0,1,16,16
1714371518813,MMW 12R,A02,514035,Herbst; Matthew,2,0,16,14
1714371519841,MMW 13R,A01,514037,Staff,0,4,16,16
1714371519841,MMW 13R,A02,514039,Staff,0,2,16,16
1714371519841,MMW 13R,A03,628519,Staff,0,2,16,16
1714371521896,SIO 295LS,A00,523233,Staff,12,0,30,18
1714371522923,SIO 295S,A00,523232,Staff,12,0,30,18
1714371523956,SIOC 290S,A01,637330,Merrifield; Mark A,27,0,30,3
1714371524983,SIOC 291S,A01,637333,Gabriel; Corey John,27,0,30,3
1714371526012,SOCI 117,A01,494376,Staff,0,3,5,5
1714371527037,WES 237B,A00,494380,Staff,9,0,20,11
1714371529111,AESE 279B,A00,494370,Wade; Jon P,0,0,33,33
1714371530136,AIP 197,001,627712,Vespa; Emanuel Ignacio,9998,0,9999,1
1714371531161,ANAR 135S,A00,494369,Braswell; Geoffrey E.,0,0,0,0
1714371532186,BENG 196,001,628496,Engler; Adam J.,9998,0,9999,1
1714371533214,CAT 124RS,A01,519847,Geibel; William,0,0,20,20
1714371534243,CAT 125RS,A01,515971,Geibel; William,0,0,20,20
1714371535269,CLRE 250,A00,511389,Morris; Sheldon,9993,0,9999,6
1714371536295,CLRE 251,A00,507176,Mehta; Ravindra L.,9993,0,9999,6
1714371536295,CLRE 251,B00,511410,Mehta; Ravindra L.,9998,0,9999,1
1714371537326,CLRE 252,A00,507189,Cuomo; Raphael Eduardo,9995,0,9999,4
1714371538359,CLRE 253,A00,507199,Vaida; Florin,9994,0,9999,5
1714371538359,CLRE 253,B00,507202,Vaida; Florin,9999,0,9999,0
1714371539399,CLRE 259,A00,507211,Patel; Hemal,9996,0,9999,3
1714371540425,CLRE 260,A00,507221,Cuomo; Raphael Eduardo,9999,0,9999,0
1714371541448,CLRE 297,001,507242,Cuomo; Raphael Eduardo,9999,0,9999,0
1714371542476,COGS 197,001,638244,Voytek; Bradley Thomas,9999,0,9999,0
1714371543504,CSE 191,A00,516875,Minnes Kemp; Mor Mia,9993,0,9999,6
1714371544532,CSE 197,001,637388,Minnes Kemp; Mor Mia,9998,0,9999,1
1714371545558,CSS 201S,A01,494383,Staff,35,0,35,0
1714371546588,CSS 202S,A01,494387,Staff,35,0,35,0
1714371547616,DSC 197,001,628532,Eldridge; Justin Matthew,9996,0,9999,3
1714371548697,EAP 100,A00,516065,Staff,9797,0,9999,202
1714371549723,ECE 45,A01,507414,Staff,33,0,60,27
1714371551776,ECE 111,A01,507420,Staff,19,0,50,31
1714371552808,ECE 197,001,548057,Sievenpiper; Daniel F.,9994,0,9999,5
1714371553834,EDS 115,A00,507243,Choi; Bailey Miyeon,12,0,28,16
1714371554866,EDS 117,A01,494379,Staff,0,2,30,30
1714371555895,EDS 125,A00,507246,Hopkins; Megan Beth,12,0,30,18
1714371556925,EDS 128A,A01,507264,Fargason; Sharon Gayle,14,0,26,12
1714371557953,EDS 128B,A01,507293,Pappas; Elizabeth,18,0,30,12
1714371558979,EDS 139,A00,507294,Fargason; Sharon Gayle,18,0,30,12
1714371558979,EDS 139,B00,507313,Pappas; Elizabeth,15,0,30,15
1714371560004,EDS 201,A00,507315,Staff,13,0,30,17
1714371561028,EDS 203,A01,507317,Halter; Christopher P.,12,0,30,18
1714371562059,EDS 204R,A01,507319,Halter; Christopher P.,0,3,30,30
1714371562059,EDS 204R,B01,507331,Heinzman; Erica M.,17,0,30,13
1714371563083,EDS 206R,A00,507332,Staff,0,4,30,30
1714371563083,EDS 206R,B00,507343,Staff,18,0,30,12
1714371564112,EDS 250,A00,507344,Hemans; Patricia Ann Benitez,22,0,40,18
1714371565141,EDS 281,A00,507345,Daly; Alan J.,18,0,18,0
1714371566169,EDS 284,A00,507350,Daly; Alan J.,16,0,16,0
1714371567196,EDS 286,A00,507359,Fine; Sarah,18,0,18,0
1714371568222,EDS 289C,A01,507361,Daly; Alan J.,18,0,18,0
1714371569250,EDS 290,A00,507366,Hofstetter; Carolyn,15,0,15,0
1714371570277,LIGM 5A,A00,507421,Fischer-Grunski; Eva K,18,0,20,2
1714371571303,LIGM 5B,A00,507423,Fischer-Grunski; Eva K,19,0,20,1
1714371572329,LIGM 5C,A00,507425,Fischer-Grunski; Eva K,19,0,20,1
1714371573360,LIIT 5AS,A00,507427,Carnelos; Chiara,20,0,20,0
1714371574395,LIIT 5BS,A00,507430,Carnelos; Chiara,20,0,20,0
1714371575421,LIIT 5CS,A00,507432,Carnelos; Chiara,20,0,20,0
1714371576447,LISP 5A,A00,507541,Munoz Sanchez; Alicia,11,0,20,9
1714371577472,LISP 5B,A00,507671,Munoz Sanchez; Alicia,9,0,20,11
1714371578502,LISP 5C,A00,507696,Munoz Sanchez; Alicia,9,0,20,11
1714371579527,MAE 197,001,528363,Boechler; Nicholas Sebastia,9998,0,9999,1
1714371580553,MATH 197,001,523477,Kedlaya; Kiran S.,9996,0,9999,3
1714371580553,MATH 197,002,563811,Zhang; Danna,9995,0,9999,4
1714371580553,MATH 197,003,628552,Dumitriu; Ioana,9998,0,9999,1
1714371581582,MCWP 40R,A00,518780,Staff,5,0,20,15
1714371581582,MCWP 40R,B00,518781,Staff,7,0,20,13
1714371581582,MCWP 40R,C00,518783,Staff,5,0,20,15
1714371582608,MCWP 50R,A00,518791,Staff,0,0,20,20
1714371582608,MCWP 50R,B00,518792,Staff,0,1,20,20
1714371582608,MCWP 50R,C00,518793,Staff,0,1,20,20
1714371582608,MCWP 50R,D00,518794,Staff,0,0,20,20
1714371582608,MCWP 50R,E00,518795,Staff,0,1,20,20
1714371582608,MCWP 50R,F00,518796,Staff,0,0,20,20
1714371582608,MCWP 50R,G00,518797,Staff,0,1,20,20
1714371583633,MMW 12R,A01,514034,Herbst; Matthew,0,1,16,16
1714371583633,MMW 12R,A02,514035,Herbst; Matthew,2,0,16,14
1714371584660,MMW 13R,A01,514037,Staff,0,4,16,16
1714371584660,MMW 13R,A02,514039,Staff,0,2,16,16
1714371584660,MMW 13R,A03,628519,Staff,0,2,16,16
1714371586720,SIO 295LS,A00,523233,Staff,12,0,30,18
1714371587744,SIO 295S,A00,523232,Staff,12,0,30,18
1714371588770,SIOC 290S,A01,637330,Merrifield; Mark A,27,0,30,3
1714371589797,SIOC 291S,A01,637333,Gabriel; Corey John,27,0,30,3
1714371590823,SOCI 117,A01,494376,Staff,0,3,5,5
1714371591851,WES 237B,A00,494380,Staff,9,0,20,11
1714371593908,AESE 279B,A00,494370,Wade; Jon P,0,0,33,33
1714371594934,AIP 197,001,627712,Vespa; Emanuel Ignacio,9998,0,9999,1
1714371595960,ANAR 135S,A00,494369,Braswell; Geoffrey E.,0,0,0,0
1714371596988,BENG 196,001,628496,Engler; Adam J.,9998,0,9999,1
1714371598016,CAT 124RS,A01,519847,Geibel; William,0,0,20,20
1714371599041,CAT 125RS,A01,515971,Geibel; William,0,0,20,20
1714371600066,CLRE 250,A00,511389,Morris; Sheldon,9993,0,9999,6
1714371601097,CLRE 251,A00,507176,Mehta; Ravindra L.,9993,0,9999,6
1714371601097,CLRE 251,B00,511410,Mehta; Ravindra L.,9998,0,9999,1
1714371602121,CLRE 252,A00,507189,Cuomo; Raphael Eduardo,9995,0,9999,4
1714371603150,CLRE 253,A00,507199,Vaida; Florin,9994,0,9999,5
1714371603150,CLRE 253,B00,507202,Vaida; Florin,9999,0,9999,0
1714371604175,CLRE 259,A00,507211,Patel; Hemal,9996,0,9999,3
1714371605201,CLRE 260,A00,507221,Cuomo; Raphael Eduardo,9999,0,9999,0
1714371606227,CLRE 297,001,507242,Cuomo; Raphael Eduardo,9999,0,9999,0
1714371607253,COGS 197,001,638244,Voytek; Bradley Thomas,9999,0,9999,0
1714371608279,CSE 191,A00,516875,Minnes Kemp; Mor Mia,9993,0,9999,6
1714371609305,CSE 197,001,637388,Minnes Kemp; Mor Mia,9998,0,9999,1
1714371610329,CSS 201S,A01,494383,Staff,35,0,35,0
1714371611356,CSS 202S,A01,494387,Staff,35,0,35,0
1714371612382,DSC 197,001,628532,Eldridge; Justin Matthew,9996,0,9999,3
1714371613407,EAP 100,A00,516065,Staff,9797,0,9999,202
1714371614434,ECE 45,A01,507414,Staff,33,0,60,27
1714371616485,ECE 111,A01,507420,Staff,19,0,50,31
1714371617514,ECE 197,001,548057,Sievenpiper; Daniel F.,9994,0,9999,5
1714371618539,EDS 115,A00,507243,Choi; Bailey Miyeon,12,0,28,16
1714371619565,EDS 117,A01,494379,Staff,0,2,30,30
1714371620594,EDS 125,A00,507246,Hopkins; Megan Beth,12,0,30,18
1714371621619,EDS 128A,A01,507264,Fargason; Sharon Gayle,14,0,26,12
1714371622648,EDS 128B,A01,507293,Pappas; Elizabeth,18,0,30,12
1714371623675,EDS 139,A00,507294,Fargason; Sharon Gayle,18,0,30,12
1714371623675,EDS 139,B00,507313,Pappas; Elizabeth,15,0,30,15
1714371624700,EDS 201,A00,507315,Staff,13,0,30,17
1714371625725,EDS 203,A01,507317,Halter; Christopher P.,12,0,30,18
1714371626757,EDS 204R,A01,507319,Halter; Christopher P.,0,3,30,30
1714371626757,EDS 204R,B01,507331,Heinzman; Erica M.,17,0,30,13
1714371627782,EDS 206R,A00,507332,Staff,0,4,30,30
1714371627782,EDS 206R,B00,507343,Staff,18,0,30,12
1714371628810,EDS 250,A00,507344,Hemans; Patricia Ann Benitez,22,0,40,18
1714371629838,EDS 281,A00,507345,Daly; Alan J.,18,0,18,0
1714371630863,EDS 284,A00,507350,Daly; Alan J.,16,0,16,0
1714371631889,EDS 286,A00,507359,Fine; Sarah,18,0,18,0
1714371632915,EDS 289C,A01,507361,Daly; Alan J.,18,0,18,0
1714371633943,EDS 290,A00,507366,Hofstetter; Carolyn,15,0,15,0
1714371634969,LIGM 5A,A00,507421,Fischer-Grunski; Eva K,18,0,20,2
1714371635995,LIGM 5B,A00,507423,Fischer-Grunski; Eva K,19,0,20,1
1714371637021,LIGM 5C,A00,507425,Fischer-Grunski; Eva K,19,0,20,1
1714371638047,LIIT 5AS,A00,507427,Carnelos; Chiara,20,0,20,0
1714371639073,LIIT 5BS,A00,507430,Carnelos; Chiara,20,0,20,0
1714371640103,LIIT 5CS,A00,507432,Carnelos; Chiara,20,0,20,0
1714371641129,LISP 5A,A00,507541,Munoz Sanchez; Alicia,11,0,20,9
1714371642157,LISP 5B,A00,507671,Munoz Sanchez; Alicia,9,0,20,11
1714371643183,LISP 5C,A00,507696,Munoz Sanchez; Alicia,9,0,20,11
1714371644212,MAE 197,001,528363,Boechler; Nicholas Sebastia,9998,0,9999,1
1714371645239,MATH 197,001,523477,Kedlaya; Kiran S.,9996,0,9999,3
1714371645239,MATH 197,002,563811,Zhang; Danna,9995,0,9999,4
1714371645239,MATH 197,003,628552,Dumitriu; Ioana,9998,0,9999,1
1714371646270,MCWP 40R,A00,518780,Staff,5,0,20,15
1714371646270,MCWP 40R,B00,518781,Staff,7,0,20,13
1714371646270,MCWP 40R,C00,518783,Staff,5,0,20,15
1714371647296,MCWP 50R,A00,518791,Staff,0,0,20,20
1714371647296,MCWP 50R,B00,518792,Staff,0,1,20,20
1714371647296,MCWP 50R,C00,518793,Staff,0,1,20,20
1714371647296,MCWP 50R,D00,518794,Staff,0,0,20,20
1714371647296,MCWP 50R,E00,518795,Staff,0,1,20,20
1714371647296,MCWP 50R,F00,518796,Staff,0,0,20,20
1714371647296,MCWP 50R,G00,518797,Staff,0,1,20,20
1714371648320,MMW 12R,A01,514034,Herbst; Matthew,0,1,16,16
1714371648320,MMW 12R,A02,514035,Herbst; Matthew,2,0,16,14
1714371649346,MMW 13R,A01,514037,Staff,0,4,16,16
1714371649346,MMW 13R,A02,514039,Staff,0,2,16,16
1714371649346,MMW 13R,A03,628519,Staff,0,2,16,16
1714371651410,SIO 295LS,A00,523233,Staff,12,0,30,18
1714371652489,SIO 295S,A00,523232,Staff,12,0,30,18
1714371653518,SIOC 290S,A01,637330,Merrifield; Mark A,27,0,30,3
1714371654548,SIOC 291S,A01,637333,Gabriel; Corey John,27,0,30,3
1714371655581,SOCI 117,A01,494376,Staff,0,3,5,5
1714371656609,WES 237B,A00,494380,Staff,9,0,20,11
1714371658732,AESE 279B,A00,494370,Wade; Jon P,0,0,33,33
1714371659757,AIP 197,001,627712,Vespa; Emanuel Ignacio,9998,0,9999,1
1714371660783,ANAR 135S,A00,494369,Braswell; Geoffrey E.,0,0,0,0
1714371661809,BENG 196,001,628496,Engler; Adam J.,9998,0,9999,1
1714371662834,CAT 124RS,A01,519847,Geibel; William,0,0,20,20
1714371663859,CAT 125RS,A01,515971,Geibel; William,0,0,20,20
1714371664888,CLRE 250,A00,511389,Morris; Sheldon,9993,0,9999,6
1714371665914,CLRE 251,A00,507176,Mehta; Ravindra L.,9993,0,9999,6
1714371665914,CLRE 251,B00,511410,Mehta; Ravindra L.,9998,0,9999,1
1714371666940,CLRE 252,A00,507189,Cuomo; Raphael Eduardo,9995,0,9999,4
1714371667986,CLRE 253,A00,507199,Vaida; Florin,9994,0,9999,5
1714371667986,CLRE 253,B00,507202,Vaida; Florin,9999,0,9999,0
1714371669020,CLRE 259,A00,507211,Patel; Hemal,9996,0,9999,3
1714371670046,CLRE 260,A00,507221,Cuomo; Raphael Eduardo,9999,0,9999,0
1714371671076,CLRE 297,001,507242,Cuomo; Raphael Eduardo,9999,0,9999,0
1714371672104,COGS 197,001,638244,Voytek; Bradley Thomas,9999,0,9999,0
1714371673133,CSE 191,A00,516875,Minnes Kemp; Mor Mia,9993,0,9999,6
1714371674158,CSE 197,001,637388,Minnes Kemp; Mor Mia,9998,0,9999,1
1714371675184,CSS 201S,A01,494383,Staff,35,0,35,0
1714371676209,CSS 202S,A01,494387,Staff,35,0,35,0
1714371677235,DSC 197,001,628532,Eldridge; Justin Matthew,9996,0,9999,3
1714371678261,EAP 100,A00,516065,Staff,9797,0,9999,202
1714371679285,ECE 45,A01,507414,Staff,33,0,60,27
1714371681334,ECE 111,A01,507420,Staff,19,0,50,31
1714371682362,ECE 197,001,548057,Sievenpiper; Daniel F.,9994,0,9999,5
1714371683388,EDS 115,A00,507243,Choi; Bailey Miyeon,12,0,28,16
1714371684413,EDS 117,A01,494379,Staff,0,2,30,30
1714371685442,EDS 125,A00,507246,Hopkins; Megan Beth,12,0,30,18
1714371686468,EDS 128A,A01,507264,Fargason; Sharon Gayle,14,0,26,12
1714371687493,EDS 128B,A01,507293,Pappas; Elizabeth,18,0,30,12
1714371688519,EDS 139,A00,507294,Fargason; Sharon Gayle,18,0,30,12
1714371688519,EDS 139,B00,507313,Pappas; Elizabeth,15,0,30,15
1714371689545,EDS 201,A00,507315,Staff,13,0,30,17
1714371690574,EDS 203,A01,507317,Halter; Christopher P.,12,0,30,18
1714371691613,EDS 204R,A01,507319,Halter; Christopher P.,0,3,30,30
1714371691613,EDS 204R,B01,507331,Heinzman; Erica M.,17,0,30,13
1714371692643,EDS 206R,A00,507332,Staff,0,4,30,30
1714371692643,EDS 206R,B00,507343,Staff,18,0,30,12
1714371693668,EDS 250,A00,507344,Hemans; Patricia Ann Benitez,22,0,40,18
1714371694693,EDS 281,A00,507345,Daly; Alan J.,18,0,18,0
1714371695719,EDS 284,A00,507350,Daly; Alan J.,16,0,16,0
1714371696746,EDS 286,A00,507359,Fine; Sarah,18,0,18,0
1714371697773,EDS 289C,A01,507361,Daly; Alan J.,18,0,18,0
1714371698797,EDS 290,A00,507366,Hofstetter; Carolyn,15,0,15,0
1714371699824,LIGM 5A,A00,507421,Fischer-Grunski; Eva K,18,0,20,2
1714371700855,LIGM 5B,A00,507423,Fischer-Grunski; Eva K,19,0,20,1
1714371701886,LIGM 5C,A00,507425,Fischer-Grunski; Eva K,19,0,20,1
1714371702917,LIIT 5AS,A00,507427,Carnelos; Chiara,20,0,20,0
1714371703943,LIIT 5BS,A00,507430,Carnelos; Chiara,20,0,20,0
1714371704974,LIIT 5CS,A00,507432,Carnelos; Chiara,20,0,20,0
1714371705998,LISP 5A,A00,507541,Munoz Sanchez; Alicia,11,0,20,9
1714371707022,LISP 5B,A00,507671,Munoz Sanchez; Alicia,9,0,20,11
1714371708052,LISP 5C,A00,507696,Munoz Sanchez; Alicia,9,0,20,11
1714371709077,MAE 197,001,528363,Boechler; Nicholas Sebastia,9998,0,9999,1
1714371710103,MATH 197,001,523477,Kedlaya; Kiran S.,9996,0,9999,3
1714371710103,MATH 197,002,563811,Zhang; Danna,9995,0,9999,4
1714371710103,MATH 197,003,628552,Dumitriu; Ioana,9998,0,9999,1
1714371711129,MCWP 40R,A00,518780,Staff,5,0,20,15
1714371711129,MCWP 40R,B00,518781,Staff,7,0,20,13
1714371711129,MCWP 40R,C00,518783,Staff,5,0,20,15
1714371712159,MCWP 50R,A00,518791,Staff,0,0,20,20
1714371712159,MCWP 50R,B00,518792,Staff,0,1,20,20
1714371712159,MCWP 50R,C00,518793,Staff,0,1,20,20
1714371712159,MCWP 50R,D00,518794,Staff,0,0,20,20
1714371712159,MCWP 50R,E00,518795,Staff,0,1,20,20
1714371712159,MCWP 50R,F00,518796,Staff,0,0,20,20
1714371712159,MCWP 50R,G00,518797,Staff,0,1,20,20
1714371713184,MMW 12R,A01,514034,Herbst; Matthew,0,1,16,16
1714371713184,MMW 12R,A02,514035,Herbst; Matthew,2,0,16,14
1714371714209,MMW 13R,A01,514037,Staff,0,4,16,16
1714371714209,MMW 13R,A02,514039,Staff,0,2,16,16
1714371714209,MMW 13R,A03,628519,Staff,0,2,16,16
1714371716262,SIO 295LS,A00,523233,Staff,12,0,30,18
1714371717291,SIO 295S,A00,523232,Staff,12,0,30,18
1714371718317,SIOC 290S,A01,637330,Merrifield; Mark A,27,0,30,3
1714371719348,SIOC 291S,A01,637333,Gabriel; Corey John,27,0,30,3
1714371720378,SOCI 117,A01,494376,Staff,0,3,5,5
1714371721404,WES 237B,A00,494380,Staff,9,0,20,11
1714371723468,AESE 279B,A00,494370,Wade; Jon P,0,0,33,33
1714371724494,AIP 197,001,627712,Vespa; Emanuel Ignacio,9998,0,9999,1
1714371725528,ANAR 135S,A00,494369,Braswell; Geoffrey E.,0,0,0,0
1714371726555,BENG 196,001,628496,Engler; Adam J.,9998,0,9999,1
1714371727585,CAT 124RS,A01,519847,Geibel; William,0,0,20,20
1714371728612,CAT 125RS,A01,515971,Geibel; William,0,0,20,20
1714371729638,CLRE 250,A00,511389,Morris; Sheldon,9993,0,9999,6
1714371730670,CLRE 251,A00,507176,Mehta; Ravindra L.,9993,0,9999,6
1714371730670,CLRE 251,B00,511410,Mehta; Ravindra L.,9998,0,9999,1
1714371731695,CLRE 252,A00,507189,Cuomo; Raphael Eduardo,9995,0,9999,4
1714371732732,CLRE 253,A00,507199,Vaida; Florin,9994,0,9999,5
1714371732732,CLRE 253,B00,507202,Vaida; Florin,9999,0,9999,0
1714371733757,CLRE 259,A00,507211,Patel; Hemal,9996,0,9999,3
1714371734786,CLRE 260,A00,507221,Cuomo; Raphael Eduardo,9999,0,9999,0
1714371735818,CLRE 297,001,507242,Cuomo; Raphael Eduardo,9999,0,9999,0
1714371736847,COGS 197,001,638244,Voytek; Bradley Thomas,9999,0,9999,0
1714371737879,CSE 191,A00,516875,Minnes Kemp; Mor Mia,9993,0,9999,6
1714371738909,CSE 197,001,637388,Minnes Kemp; Mor Mia,9998,0,9999,1
1714371739942,CSS 201S,A01,494383,Staff,35,0,35,0
1714371740972,CSS 202S,A01,494387,Staff,35,0,35,0
1714371742000,DSC 197,001,628532,Eldridge; Justin Matthew,9996,0,9999,3
1714371743026,EAP 100,A00,516065,Staff,9797,0,9999,202
1714371744060,ECE 45,A01,507414,Staff,33,0,60,27
1714371746111,ECE 111,A01,507420,Staff,19,0,50,31
1714371747148,ECE 197,001,548057,Sievenpiper; Daniel F.,9994,0,9999,5
1714371748172,EDS 115,A00,507243,Choi; Bailey Miyeon,12,0,28,16
1714371749212,EDS 117,A01,494379,Staff,0,2,30,30
1714371750240,EDS 125,A00,507246,Hopkins; Megan Beth,12,0,30,18
1714371751274,EDS 128A,A01,507264,Fargason; Sharon Gayle,14,0,26,12
1714371752327,EDS 128B,A01,507293,Pappas; Elizabeth,18,0,30,12
1714371753358,EDS 139,A00,507294,Fargason; Sharon Gayle,18,0,30,12
1714371753358,EDS 139,B00,507313,Pappas; Elizabeth,15,0,30,15
1714371754390,EDS 201,A00,507315,Staff,13,0,30,17
1714371755422,EDS 203,A01,507317,Halter; Christopher P.,12,0,30,18
1714371756505,EDS 204R,A01,507319,Halter; Christopher P.,0,3,30,30
1714371756505,EDS 204R,B01,507331,Heinzman; Erica M.,17,0,30,13
1714371757531,EDS 206R,A00,507332,Staff,0,4,30,30
1714371757531,EDS 206R,B00,507343,Staff,18,0,30,12
1714371758559,EDS 250,A00,507344,Hemans; Patricia Ann Benitez,22,0,40,18
1714371759586,EDS 281,A00,507345,Daly; Alan J.,18,0,18,0
1714371760611,EDS 284,A00,507350,Daly; Alan J.,16,0,16,0
1714371761639,EDS 286,A00,507359,Fine; Sarah,18,0,18,0
1714371762664,EDS 289C,A01,507361,Daly; Alan J.,18,0,18,0
1714371763690,EDS 290,A00,507366,Hofstetter; Carolyn,15,0,15,0
1714371764741,LIGM 5A,A00,507421,Fischer-Grunski; Eva K,18,0,20,2
1714371765778,LIGM 5B,A00,507423,Fischer-Grunski; Eva K,19,0,20,1
1714371766806,LIGM 5C,A00,507425,Fischer-Grunski; Eva K,19,0,20,1
1714371767835,LIIT 5AS,A00,507427,Carnelos; Chiara,20,0,20,0
1714371768863,LIIT 5BS,A00,507430,Carnelos; Chiara,20,0,20,0
1714371769889,LIIT 5CS,A00,507432,Carnelos; Chiara,20,0,20,0
1714371770915,LISP 5A,A00,507541,Munoz Sanchez; Alicia,11,0,20,9
1714371771949,LISP 5B,A00,507671,Munoz Sanchez; Alicia,9,0,20,11
1714371772976,LISP 5C,A00,507696,Munoz Sanchez; Alicia,9,0,20,11
1714371774005,MAE 197,001,528363,Boechler; Nicholas Sebastia,9998,0,9999,1
1714371775039,MATH 197,001,523477,Kedlaya; Kiran S.,9996,0,9999,3
1714371775039,MATH 197,002,563811,Zhang; Danna,9995,0,9999,4
1714371775039,MATH 197,003,628552,Dumitriu; Ioana,9998,0,9999,1
1714371776071,MCWP 40R,A00,518780,Staff,5,0,20,15
1714371776071,MCWP 40R,B00,518781,Staff,7,0,20,13
1714371776071,MCWP 40R,C00,518783,Staff,5,0,20,15
1714371777096,MCWP 50R,A00,518791,Staff,0,0,20,20
1714371777096,MCWP 50R,B00,518792,Staff,0,1,20,20
1714371777096,MCWP 50R,C00,518793,Staff,0,1,20,20
1714371777096,MCWP 50R,D00,518794,Staff,0,0,20,20
1714371777096,MCWP 50R,E00,518795,Staff,0,1,20,20
1714371777096,MCWP 50R,F00,518796,Staff,0,0,20,20
1714371777096,MCWP 50R,G00,518797,Staff,0,1,20,20
1714371778122,MMW 12R,A01,514034,Herbst; Matthew,0,1,16,16
1714371778122,MMW 12R,A02,514035,Herbst; Matthew,2,0,16,14
1714371779148,MMW 13R,A01,514037,Staff,0,4,16,16
1714371779148,MMW 13R,A02,514039,Staff,0,2,16,16
1714371779148,MMW 13R,A03,628519,Staff,0,2,16,16
1714371781197,SIO 295LS,A00,523233,Staff,12,0,30,18
1714371782223,SIO 295S,A00,523232,Staff,12,0,30,18
1714371783250,SIOC 290S,A01,637330,Merrifield; Mark A,27,0,30,3
1714371784275,SIOC 291S,A01,637333,Gabriel; Corey John,27,0,30,3
1714371785300,SOCI 117,A01,494376,Staff,0,3,5,5
1714371786327,WES 237B,A00,494380,Staff,9,0,20,11
1714371788395,AESE 279B,A00,494370,Wade; Jon P,0,0,33,33
1714371789421,AIP 197,001,627712,Vespa; Emanuel Ignacio,9998,0,9999,1
1714371790447,ANAR 135S,A00,494369,Braswell; Geoffrey E.,0,0,0,0
1714371791476,BENG 196,001,628496,Engler; Adam J.,9998,0,9999,1
1714371792504,CAT 124RS,A01,519847,Geibel; William,0,0,20,20
1714371793532,CAT 125RS,A01,515971,Geibel; William,0,0,20,20
1714371794561,CLRE 250,A00,511389,Morris; Sheldon,9993,0,9999,6
1714371795597,CLRE 251,A00,507176,Mehta; Ravindra L.,9993,0,9999,6
1714371795597,CLRE 251,B00,511410,Mehta; Ravindra L.,9998,0,9999,1
1714371796625,CLRE 252,A00,507189,Cuomo; Raphael Eduardo,9995,0,9999,4
1714371797652,CLRE 253,A00,507199,Vaida; Florin,9994,0,9999,5
1714371797652,CLRE 253,B00,507202,Vaida; Florin,9999,0,9999,0
1714371798677,CLRE 259,A00,507211,Patel; Hemal,9996,0,9999,3
1714371799704,CLRE 260,A00,507221,Cuomo; Raphael Eduardo,9999,0,9999,0
1714371800731,CLRE 297,001,507242,Cuomo; Raphael Eduardo,9999,0,9999,0
1714371801756,COGS 197,001,638244,Voytek; Bradley Thomas,9999,0,9999,0
1714371802783,CSE 191,A00,516875,Minnes Kemp; Mor Mia,9993,0,9999,6
1714371803808,CSE 197,001,637388,Minnes Kemp; Mor Mia,9998,0,9999,1
1714371804837,CSS 201S,A01,494383,Staff,35,0,35,0
1714371805861,CSS 202S,A01,494387,Staff,35,0,35,0
1714371806890,DSC 197,001,628532,Eldridge; Justin Matthew,9996,0,9999,3
1714371807916,EAP 100,A00,516065,Staff,9797,0,9999,202
1714371808944,ECE 45,A01,507414,Staff,33,0,60,27
1714371810993,ECE 111,A01,507420,Staff,19,0,50,31
1714371812021,ECE 197,001,548057,Sievenpiper; Daniel F.,9994,0,9999,5
1714371813044,EDS 115,A00,507243,Choi; Bailey Miyeon,12,0,28,16
1714371814073,EDS 117,A01,494379,Staff,0,2,30,30
1714371815100,EDS 125,A00,507246,Hopkins; Megan Beth,12,0,30,18
1714371816126,EDS 128A,A01,507264,Fargason; Sharon Gayle,14,0,26,12
1714371817151,EDS 128B,A01,507293,Pappas; Elizabeth,18,0,30,12
1714371818179,EDS 139,A00,507294,Fargason; Sharon Gayle,18,0,30,12
1714371818179,EDS 139,B00,507313,Pappas; Elizabeth,15,0,30,15
1714371819203,EDS 201,A00,507315,Staff,13,0,30,17
1714371820233,EDS 203,A01,507317,Halter; Christopher P.,12,0,30,18
1714371821260,EDS 204R,A01,507319,Halter; Christopher P.,0,3,30,30
1714371821260,EDS 204R,B01,507331,Heinzman; Erica M.,17,0,30,13
1714371822288,EDS 206R,A00,507332,Staff,0,4,30,30
1714371822288,EDS 206R,B00,507343,Staff,18,0,30,12
1714371823316,EDS 250,A00,507344,Hemans; Patricia Ann Benitez,22,0,40,18
1714371824341,EDS 281,A00,507345,Daly; Alan J.,18,0,18,0
1714371825365,EDS 284,A00,507350,Daly; Alan J.,16,0,16,0
1714371826390,EDS 286,A00,507359,Fine; Sarah,18,0,18,0
1714371827424,EDS 289C,A01,507361,Daly; Alan J.,18,0,18,0
1714371828455,EDS 290,A00,507366,Hofstetter; Carolyn,15,0,15,0
1714371829492,LIGM 5A,A00,507421,Fischer-Grunski; Eva K,18,0,20,2
1714371830523,LIGM 5B,A00,507423,Fischer-Grunski; Eva K,19,0,20,1
1714371831547,LIGM 5C,A00,507425,Fischer-Grunski; Eva K,19,0,20,1
1714371832580,LIIT 5AS,A00,507427,Carnelos; Chiara,20,0,20,0
1714371833609,LIIT 5BS,A00,507430,Carnelos; Chiara,20,0,20,0
1714371834634,LIIT 5CS,A00,507432,Carnelos; Chiara,20,0,20,0
1714371835667,LISP 5A,A00,507541,Munoz Sanchez; Alicia,11,0,20,9
1714371836693,LISP 5B,A00,507671,Munoz Sanchez; Alicia,9,0,20,11
1714371837724,LISP 5C,A00,507696,Munoz Sanchez; Alicia,9,0,20,11
1714371838750,MAE 197,001,528363,Boechler; Nicholas Sebastia,9998,0,9999,1
1714371839783,MATH 197,001,523477,Kedlaya; Kiran S.,9996,0,9999,3
1714371839783,MATH 197,002,563811,Zhang; Danna,9995,0,9999,4
1714371839783,MATH 197,003,628552,Dumitriu; Ioana,9998,0,9999,1
1714371840831,MCWP 40R,A00,518780,Staff,5,0,20,15
1714371840831,MCWP 40R,B00,518781,Staff,7,0,20,13
1714371840831,MCWP 40R,C00,518783,Staff,5,0,20,15
1714371841859,MCWP 50R,A00,518791,Staff,0,0,20,20
1714371841859,MCWP 50R,B00,518792,Staff,0,1,20,20
1714371841859,MCWP 50R,C00,518793,Staff,0,1,20,20
1714371841859,MCWP 50R,D00,518794,Staff,0,0,20,20
1714371841859,MCWP 50R,E00,518795,Staff,0,1,20,20
1714371841859,MCWP 50R,F00,518796,Staff,0,0,20,20
1714371841859,MCWP 50R,G00,518797,Staff,0,1,20,20
1714371842898,MMW 12R,A01,514034,Herbst; Matthew,0,1,16,16
1714371842898,MMW 12R,A02,514035,Herbst; Matthew,2,0,16,14
1714371843924,MMW 13R,A01,514037,Staff,0,4,16,16
1714371843924,MMW 13R,A02,514039,Staff,0,2,16,16
1714371843924,MMW 13R,A03,628519,Staff,0,2,16,16
1714371845975,SIO 295LS,A00,523233,Staff,12,0,30,18
1714371847003,SIO 295S,A00,523232,Staff,12,0,30,18
1714371848029,SIOC 290S,A01,637330,Merrifield; Mark A,27,0,30,3
1714371849058,SIOC 291S,A01,637333,Gabriel; Corey John,27,0,30,3
1714371850084,SOCI 117,A01,494376,Staff,0,3,5,5
1714371851113,WES 237B,A00,494380,Staff,9,0,20,11
1714371853183,AESE 279B,A00,494370,Wade; Jon P,0,0,33,33
1714371854210,AIP 197,001,627712,Vespa; Emanuel Ignacio,9998,0,9999,1
1714371855235,ANAR 135S,A00,494369,Braswell; Geoffrey E.,0,0,0,0
1714371856263,BENG 196,001,628496,Engler; Adam J.,9998,0,9999,1
1714371857289,CAT 124RS,A01,519847,Geibel; William,0,0,20,20
1714371858317,CAT 125RS,A01,515971,Geibel; William,0,0,20,20
1714371859341,CLRE 250,A00,511389,Morris; Sheldon,9993,0,9999,6
1714371860424,CLRE 251,A00,507176,Mehta; Ravindra L.,9993,0,9999,6
1714371860424,CLRE 251,B00,511410,Mehta; Ravindra L.,9998,0,9999,1
1714371861454,CLRE 252,A00,507189,Cuomo; Raphael Eduardo,9995,0,9999,4
1714371862479,CLRE 253,A00,507199,Vaida; Florin,9994,0,9999,5
1714371862479,CLRE 253,B00,507202,Vaida; Florin,9999,0,9999,0
1714371863503,CLRE 259,A00,507211,Patel; Hemal,9996,0,9999,3
1714371864529,CLRE 260,A00,507221,Cuomo; Raphael Eduardo,9999,0,9999,0
1714371865554,CLRE 297,001,507242,Cuomo; Raphael Eduardo,9999,0,9999,0
1714371866581,COGS 197,001,638244,Voytek; Bradley Thomas,9999,0,9999,0
1714371867609,CSE 191,A00,516875,Minnes Kemp; Mor Mia,9993,0,9999,6
1714371868636,CSE 197,001,637388,Minnes Kemp; Mor Mia,9998,0,9999,1
1714371869663,CSS 201S,A01,494383,Staff,35,0,35,0
1714371870689,CSS 202S,A01,494387,Staff,35,0,35,0
1714371871714,DSC 197,001,628532,Eldridge; Justin Matthew,9996,0,9999,3
1714371872738,EAP 100,A00,516065,Staff,9797,0,9999,202
1714371873764,ECE 45,A01,507414,Staff,33,0,60,27
1714371875816,ECE 111,A01,507420,Staff,19,0,50,31
1714371876841,ECE 197,001,548057,Sievenpiper; Daniel F.,9994,0,9999,5
1714371877869,EDS 115,A00,507243,Choi; Bailey Miyeon,12,0,28,16
1714371878896,EDS 117,A01,494379,Staff,0,2,30,30
1714371879922,EDS 125,A00,507246,Hopkins; Megan Beth,12,0,30,18
1714371880945,EDS 128A,A01,507264,Fargason; Sharon Gayle,14,0,26,12
1714371881972,EDS 128B,A01,507293,Pappas; Elizabeth,18,0,30,12
1714371882996,EDS 139,A00,507294,Fargason; Sharon Gayle,18,0,30,12
1714371882996,EDS 139,B00,507313,Pappas; Elizabeth,15,0,30,15
1714371884024,EDS 201,A00,507315,Staff,13,0,30,17
1714371885050,EDS 203,A01,507317,Halter; Christopher P.,12,0,30,18
1714371886077,EDS 204R,A01,507319,Halter; Christopher P.,0,3,30,30
1714371886077,EDS 204R,B01,507331,Heinzman; Erica M.,17,0,30,13
1714371887113,EDS 206R,A00,507332,Staff,0,4,30,30
1714371887113,EDS 206R,B00,507343,Staff,18,0,30,12
1714371888139,EDS 250,A00,507344,Hemans; Patricia Ann Benitez,22,0,40,18
1714371889163,EDS 281,A00,507345,Daly; Alan J.,18,0,18,0
1714371890191,EDS 284,A00,507350,Daly; Alan J.,16,0,16,0
1714371891215,EDS 286,A00,507359,Fine; Sarah,18,0,18,0
1714371892241,EDS 289C,A01,507361,Daly; Alan J.,18,0,18,0
1714371893266,EDS 290,A00,507366,Hofstetter; Carolyn,15,0,15,0
1714371894295,LIGM 5A,A00,507421,Fischer-Grunski; Eva K,18,0,20,2
1714371895321,LIGM 5B,A00,507423,Fischer-Grunski; Eva K,19,0,20,1
1714371896348,LIGM 5C,A00,507425,Fischer-Grunski; Eva K,19,0,20,1
1714371897374,LIIT 5AS,A00,507427,Carnelos; Chiara,20,0,20,0
1714371898400,LIIT 5BS,A00,507430,Carnelos; Chiara,20,0,20,0
1714371899426,LIIT 5CS,A00,507432,Carnelos; Chiara,20,0,20,0
1714371900453,LISP 5A,A00,507541,Munoz Sanchez; Alicia,11,0,20,9
1714371901482,LISP 5B,A00,507671,Munoz Sanchez; Alicia,9,0,20,11
1714371902508,LISP 5C,A00,507696,Munoz Sanchez; Alicia,9,0,20,11
1714371903536,MAE 197,001,528363,Boechler; Nicholas Sebastia,9998,0,9999,1
1714371904576,MATH 197,001,523477,Kedlaya; Kiran S.,9996,0,9999,3
1714371904576,MATH 197,002,563811,Zhang; Danna,9995,0,9999,4
1714371904576,MATH 197,003,628552,Dumitriu; Ioana,9998,0,9999,1
1714371905602,MCWP 40R,A00,518780,Staff,5,0,20,15
1714371905602,MCWP 40R,B00,518781,Staff,7,0,20,13
1714371905602,MCWP 40R,C00,518783,Staff,5,0,20,15
1714371906629,MCWP 50R,A00,518791,Staff,0,0,20,20
1714371906629,MCWP 50R,B00,518792,Staff,0,1,20,20
1714371906629,MCWP 50R,C00,518793,Staff,0,1,20,20
1714371906629,MCWP 50R,D00,518794,Staff,0,0,20,20
1714371906629,MCWP 50R,E00,518795,Staff,0,1,20,20
1714371906629,MCWP 50R,F00,518796,Staff,0,0,20,20
1714371906629,MCWP 50R,G00,518797,Staff,0,1,20,20
1714371907655,MMW 12R,A01,514034,Herbst; Matthew,0,1,16,16
1714371907655,MMW 12R,A02,514035,Herbst; Matthew,2,0,16,14
1714371908681,MMW 13R,A01,514037,Staff,0,4,16,16
1714371908681,MMW 13R,A02,514039,Staff,0,2,16,16
1714371908681,MMW 13R,A03,628519,Staff,0,2,16,16
1714371910732,SIO 295LS,A00,523233,Staff,12,0,30,18
1714371911755,SIO 295S,A00,523232,Staff,12,0,30,18
1714371912781,SIOC 290S,A01,637330,Merrifield; Mark A,27,0,30,3
1714371913807,SIOC 291S,A01,637333,Gabriel; Corey John,27,0,30,3
1714371914835,SOCI 117,A01,494376,Staff,0,3,5,5
1714371915862,WES 237B,A00,494380,Staff,9,0,20,11
1714371917958,AESE 279B,A00,494370,Wade; Jon P,0,0,33,33
1714371918986,AIP 197,001,627712,Vespa; Emanuel Ignacio,9998,0,9999,1
1714371920012,ANAR 135S,A00,494369,Braswell; Geoffrey E.,0,0,0,0
1714371921038,BENG 196,001,628496,Engler; Adam J.,9998,0,9999,1
1714371922063,CAT 124RS,A01,519847,Geibel; William,0,0,20,20
1714371923090,CAT 125RS,A01,515971,Geibel; William,0,0,20,20
1714371924116,CLRE 250,A00,511389,Morris; Sheldon,9993,0,9999,6
1714371925141,CLRE 251,A00,507176,Mehta; Ravindra L.,9993,0,9999,6
1714371925141,CLRE 251,B00,511410,Mehta; Ravindra L.,9998,0,9999,1
1714371926166,CLRE 252,A00,507189,Cuomo; Raphael Eduardo,9995,0,9999,4
1714371927195,CLRE 253,A00,507199,Vaida; Florin,9994,0,9999,5
1714371927195,CLRE 253,B00,507202,Vaida; Florin,9999,0,9999,0
1714371928221,CLRE 259,A00,507211,Patel; Hemal,9996,0,9999,3
1714371929252,CLRE 260,A00,507221,Cuomo; Raphael Eduardo,9999,0,9999,0
1714371930279,CLRE 297,001,507242,Cuomo; Raphael Eduardo,9999,0,9999,0
1714371931311,COGS 197,001,638244,Voytek; Bradley Thomas,9999,0,9999,0
1714371932338,CSE 191,A00,516875,Minnes Kemp; Mor Mia,9993,0,9999,6
1714371933363,CSE 197,001,637388,Minnes Kemp; Mor Mia,9998,0,9999,1
1714371934388,CSS 201S,A01,494383,Staff,35,0,35,0
1714371935415,CSS 202S,A01,494387,Staff,35,0,35,0
1714371936443,DSC 197,001,628532,Eldridge; Justin Matthew,9996,0,9999,3
1714371937470,EAP 100,A00,516065,Staff,9797,0,9999,202
1714371938497,ECE 45,A01,507414,Staff,33,0,60,27
1714371940546,ECE 111,A01,507420,Staff,19,0,50,31
1714371941573,ECE 197,001,548057,Sievenpiper; Daniel F.,9994,0,9999,5
1714371942598,EDS 115,A00,507243,Choi; Bailey Miyeon,12,0,28,16
1714371943621,EDS 117,A01,494379,Staff,0,2,30,30
1714371944646,EDS 125,A00,507246,Hopkins; Megan Beth,12,0,30,18
1714371945671,EDS 128A,A01,507264,Fargason; Sharon Gayle,14,0,26,12
1714371946698,EDS 128B,A01,507293,Pappas; Elizabeth,18,0,30,12
1714371947724,EDS 139,A00,507294,Fargason; Sharon Gayle,18,0,30,12
1714371947724,EDS 139,B00,507313,Pappas; Elizabeth,15,0,30,15
1714371948752,EDS 201,A00,507315,Staff,13,0,30,17
1714371949778,EDS 203,A01,507317,Halter; Christopher P.,12,0,30,18
1714371950816,EDS 204R,A01,507319,Halter; Christopher P.,0,3,30,30
1714371950816,EDS 204R,B01,507331,Heinzman; Erica M.,17,0,30,13
1714371951841,EDS 206R,A00,507332,Staff,0,4,30,30
1714371951841,EDS 206R,B00,507343,Staff,18,0,30,12
1714371952870,EDS 250,A00,507344,Hemans; Patricia Ann Benitez,22,0,40,18
1714371953894,EDS 281,A00,507345,Daly; Alan J.,18,0,18,0
1714371954922,EDS 284,A00,507350,Daly; Alan J.,16,0,16,0
1714371955948,EDS 286,A00,507359,Fine; Sarah,18,0,18,0
1714371956975,EDS 289C,A01,507361,Daly; Alan J.,18,0,18,0
1714371958003,EDS 290,A00,507366,Hofstetter; Carolyn,15,0,15,0
1714371959029,LIGM 5A,A00,507421,Fischer-Grunski; Eva K,18,0,20,2
1714371960055,LIGM 5B,A00,507423,Fischer-Grunski; Eva K,19,0,20,1
1714371961080,LIGM 5C,A00,507425,Fischer-Grunski; Eva K,19,0,20,1
1714371962110,LIIT 5AS,A00,507427,Carnelos; Chiara,20,0,20,0
1714371963141,LIIT 5BS,A00,507430,Carnelos; Chiara,20,0,20,0
1714371964221,LIIT 5CS,A00,507432,Carnelos; Chiara,20,0,20,0
1714371965251,LISP 5A,A00,507541,Munoz Sanchez; Alicia,11,0,20,9
1714371966283,LISP 5B,A00,507671,Munoz Sanchez; Alicia,9,0,20,11
1714371967309,LISP 5C,A00,507696,Munoz Sanchez; Alicia,9,0,20,11
1714371968332,MAE 197,001,528363,Boechler; Nicholas Sebastia,9998,0,9999,1
1714371969358,MATH 197,001,523477,Kedlaya; Kiran S.,9996,0,9999,3
1714371969358,MATH 197,002,563811,Zhang; Danna,9995,0,9999,4
1714371969358,MATH 197,003,628552,Dumitriu; Ioana,9998,0,9999,1
1714371970383,MCWP 40R,A00,518780,Staff,5,0,20,15
1714371970383,MCWP 40R,B00,518781,Staff,7,0,20,13
1714371970383,MCWP 40R,C00,518783,Staff,5,0,20,15
1714371971416,MCWP 50R,A00,518791,Staff,0,0,20,20
1714371971416,MCWP 50R,B00,518792,Staff,0,1,20,20
1714371971416,MCWP 50R,C00,518793,Staff,0,1,20,20
1714371971416,MCWP 50R,D00,518794,Staff,0,0,20,20
1714371971416,MCWP 50R,E00,518795,Staff,0,1,20,20
1714371971416,MCWP 50R,F00,518796,Staff,0,0,20,20
1714371971416,MCWP 50R,G00,518797,Staff,0,1,20,20
1714371972445,MMW 12R,A01,514034,Herbst; Matthew,0,1,16,16
1714371972445,MMW 12R,A02,514035,Herbst; Matthew,2,0,16,14
1714371973472,MMW 13R,A01,514037,Staff,0,4,16,16
1714371973472,MMW 13R,A02,514039,Staff,0,2,16,16
1714371973472,MMW 13R,A03,628519,Staff,0,2,16,16
1714371975525,SIO 295LS,A00,523233,Staff,12,0,30,18
1714371976551,SIO 295S,A00,523232,Staff,12,0,30,18
1714371977578,SIOC 290S,A01,637330,Merrifield; Mark A,27,0,30,3
1714371978603,SIOC 291S,A01,637333,Gabriel; Corey John,27,0,30,3
1714371979632,SOCI 117,A01,494376,Staff,0,3,5,5
1714371980657,WES 237B,A00,494380,Staff,9,0,20,11
1714371982740,AESE 279B,A00,494370,Wade; Jon P,0,0,33,33
1714371983769,AIP 197,001,627712,Vespa; Emanuel Ignacio,9998,0,9999,1
1714371984794,ANAR 135S,A00,494369,Braswell; Geoffrey E.,0,0,0,0
1714371985819,BENG 196,001,628496,Engler; Adam J.,9998,0,9999,1
1714371986845,CAT 124RS,A01,519847,Geibel; William,0,0,20,20
1714371987875,CAT 125RS,A01,515971,Geibel; William,0,0,20,20
1714371988901,CLRE 250,A00,511389,Morris; Sheldon,9993,0,9999,6
1714371989931,CLRE 251,A00,507176,Mehta; Ravindra L.,9993,0,9999,6
1714371989931,CLRE 251,B00,511410,Mehta; Ravindra L.,9998,0,9999,1
1714371990960,CLRE 252,A00,507189,Cuomo; Raphael Eduardo,9995,0,9999,4
1714371991998,CLRE 253,A00,507199,Vaida; Florin,9994,0,9999,5
1714371991998,CLRE 253,B00,507202,Vaida; Florin,9999,0,9999,0
1714371993022,CLRE 259,A00,507211,Patel; Hemal,9996,0,9999,3
1714371994049,CLRE 260,A00,507221,Cuomo; Raphael Eduardo,9999,0,9999,0
1714371995074,CLRE 297,001,507242,Cuomo; Raphael Eduardo,9999,0,9999,0
1714371996099,COGS 197,001,638244,Voytek; Bradley Thomas,9999,0,9999,0
1714371997124,CSE 191,A00,516875,Minnes Kemp; Mor Mia,9993,0,9999,6
1714371998151,CSE 197,001,637388,Minnes Kemp; Mor Mia,9998,0,9999,1
1714371999181,CSS 201S,A01,494383,Staff,35,0,35,0
1714372000206,CSS 202S,A01,494387,Staff,35,0,35,0
1714372001230,DSC 197,001,628532,Eldridge; Justin Matthew,9996,0,9999,3
1714372002257,EAP 100,A00,516065,Staff,9797,0,9999,202
1714372003283,ECE 45,A01,507414,Staff,33,0,60,27
1714372005346,ECE 111,A01,507420,Staff,19,0,50,31
1714372006371,ECE 197,001,548057,Sievenpiper; Daniel F.,9994,0,9999,5
1714372007401,EDS 115,A00,507243,Choi; Bailey Miyeon,12,0,28,16
1714372008426,EDS 117,A01,494379,Staff,0,2,30,30
1714372009451,EDS 125,A00,507246,Hopkins; Megan Beth,12,0,30,18
1714372010477,EDS 128A,A01,507264,Fargason; Sharon Gayle,14,0,26,12
1714372011509,EDS 128B,A01,507293,Pappas; Elizabeth,18,0,30,12
1714372012535,EDS 139,A00,507294,Fargason; Sharon Gayle,18,0,30,12
1714372012535,EDS 139,B00,507313,Pappas; Elizabeth,15,0,30,15
1714372013564,EDS 201,A00,507315,Staff,13,0,30,17
1714372014589,EDS 203,A01,507317,Halter; Christopher P.,12,0,30,18
1714372015615,EDS 204R,A01,507319,Halter; Christopher P.,0,3,30,30
1714372015615,EDS 204R,B01,507331,Heinzman; Erica M.,17,0,30,13
1714372016643,EDS 206R,A00,507332,Staff,0,4,30,30
1714372016643,EDS 206R,B00,507343,Staff,18,0,30,12
1714372017668,EDS 250,A00,507344,Hemans; Patricia Ann Benitez,22,0,40,18
1714372018692,EDS 281,A00,507345,Daly; Alan J.,18,0,18,0
1714372019722,EDS 284,A00,507350,Daly; Alan J.,16,0,16,0
1714372020750,EDS 286,A00,507359,Fine; Sarah,18,0,18,0
1714372021774,EDS 289C,A01,507361,Daly; Alan J.,18,0,18,0
1714372022801,EDS 290,A00,507366,Hofstetter; Carolyn,15,0,15,0
1714372023826,LIGM 5A,A00,507421,Fischer-Grunski; Eva K,18,0,20,2
1714372024855,LIGM 5B,A00,507423,Fischer-Grunski; Eva K,19,0,20,1
1714372025884,LIGM 5C,A00,507425,Fischer-Grunski; Eva K,19,0,20,1
1714372026909,LIIT 5AS,A00,507427,Carnelos; Chiara,20,0,20,0
1714372027938,LIIT 5BS,A00,507430,Carnelos; Chiara,20,0,20,0
1714372028966,LIIT 5CS,A00,507432,Carnelos; Chiara,20,0,20,0
1714372029991,LISP 5A,A00,507541,Munoz Sanchez; Alicia,11,0,20,9
1714372031016,LISP 5B,A00,507671,Munoz Sanchez; Alicia,9,0,20,11
1714372032043,LISP 5C,A00,507696,Munoz Sanchez; Alicia,9,0,20,11
1714372033069,MAE 197,001,528363,Boechler; Nicholas Sebastia,9998,0,9999,1
1714372034095,MATH 197,001,523477,Kedlaya; Kiran S.,9996,0,9999,3
1714372034095,MATH 197,002,563811,Zhang; Danna,9995,0,9999,4
1714372034095,MATH 197,003,628552,Dumitriu; Ioana,9998,0,9999,1
1714372035121,MCWP 40R,A00,518780,Staff,5,0,20,15
1714372035121,MCWP 40R,B00,518781,Staff,7,0,20,13
1714372035121,MCWP 40R,C00,518783,Staff,5,0,20,15
1714372036150,MCWP 50R,A00,518791,Staff,0,0,20,20
1714372036150,MCWP 50R,B00,518792,Staff,0,1,20,20
1714372036150,MCWP 50R,C00,518793,Staff,0,1,20,20
1714372036150,MCWP 50R,D00,518794,Staff,0,0,20,20
1714372036150,MCWP 50R,E00,518795,Staff,0,1,20,20
1714372036150,MCWP 50R,F00,518796,Staff,0,0,20,20
1714372036150,MCWP 50R,G00,518797,Staff,0,1,20,20
1714372037178,MMW 12R,A01,514034,Herbst; Matthew,0,1,16,16
1714372037178,MMW 12R,A02,514035,Herbst; Matthew,2,0,16,14
1714372038206,MMW 13R,A01,514037,Staff,0,4,16,16
1714372038206,MMW 13R,A02,514039,Staff,0,2,16,16
1714372038206,MMW 13R,A03,628519,Staff,0,2,16,16
1714372040259,SIO 295LS,A00,523233,Staff,12,0,30,18
1714372041284,SIO 295S,A00,523232,Staff,12,0,30,18
1714372042310,SIOC 290S,A01,637330,Merrifield; Mark A,27,0,30,3
1714372043334,SIOC 291S,A01,637333,Gabriel; Corey John,27,0,30,3
1714372044360,SOCI 117,A01,494376,Staff,0,3,5,5
1714372045385,WES 237B,A00,494380,Staff,9,0,20,11
1714372047444,AESE 279B,A00,494370,Wade; Jon P,0,0,33,33
1714372048469,AIP 197,001,627712,Vespa; Emanuel Ignacio,9998,0,9999,1
1714372049496,ANAR 135S,A00,494369,Braswell; Geoffrey E.,0,0,0,0
1714372050521,BENG 196,001,628496,Engler; Adam J.,9998,0,9999,1
1714372051546,CAT 124RS,A01,519847,Geibel; William,0,0,20,20
1714372052574,CAT 125RS,A01,515971,Geibel; William,0,0,20,20
1714372053603,CLRE 250,A00,511389,Morris; Sheldon,9993,0,9999,6
1714372054633,CLRE 251,A00,507176,Mehta; Ravindra L.,9993,0,9999,6
1714372054633,CLRE 251,B00,511410,Mehta; Ravindra L.,9998,0,9999,1
1714372055658,CLRE 252,A00,507189,Cuomo; Raphael Eduardo,9995,0,9999,4
1714372056686,CLRE 253,A00,507199,Vaida; Florin,9994,0,9999,5
1714372056686,CLRE 253,B00,507202,Vaida; Florin,9999,0,9999,0
1714372057711,CLRE 259,A00,507211,Patel; Hemal,9996,0,9999,3
1714372058746,CLRE 260,A00,507221,Cuomo; Raphael Eduardo,9999,0,9999,0
1714372059776,CLRE 297,001,507242,Cuomo; Raphael Eduardo,9999,0,9999,0
1714372060801,COGS 197,001,638244,Voytek; Bradley Thomas,9999,0,9999,0
1714372061826,CSE 191,A00,516875,Minnes Kemp; Mor Mia,9993,0,9999,6
1714372062851,CSE 197,001,637388,Minnes Kemp; Mor Mia,9998,0,9999,1
1714372063881,CSS 201S,A01,494383,Staff,35,0,35,0
1714372064906,CSS 202S,A01,494387,Staff,35,0,35,0
1714372065933,DSC 197,001,628532,Eldridge; Justin Matthew,9996,0,9999,3
1714372066958,EAP 100,A00,516065,Staff,9797,0,9999,202
1714372068038,ECE 45,A01,507414,Staff,33,0,60,27
1714372070094,ECE 111,A01,507420,Staff,19,0,50,31
1714372071122,ECE 197,001,548057,Sievenpiper; Daniel F.,9994,0,9999,5
1714372072149,EDS 115,A00,507243,Choi; Bailey Miyeon,12,0,28,16
1714372073175,EDS 117,A01,494379,Staff,0,2,30,30
1714372074205,EDS 125,A00,507246,Hopkins; Megan Beth,12,0,30,18
1714372075232,EDS 128A,A01,507264,Fargason; Sharon Gayle,14,0,26,12
1714372076258,EDS 128B,A01,507293,Pappas; Elizabeth,18,0,30,12
1714372077284,EDS 139,A00,507294,Fargason; Sharon Gayle,18,0,30,12
1714372077284,EDS 139,B00,507313,Pappas; Elizabeth,15,0,30,15
1714372078313,EDS 201,A00,507315,Staff,13,0,30,17
1714372079339,EDS 203,A01,507317,Halter; Christopher P.,12,0,30,18
1714372080370,EDS 204R,A01,507319,Halter; Christopher P.,0,3,30,30
1714372080370,EDS 204R,B01,507331,Heinzman; Erica M.,17,0,30,13
1714372081394,EDS 206R,A00,507332,Staff,0,4,30,30
1714372081394,EDS 206R,B00,507343,Staff,18,0,30,12
1714372082420,EDS 250,A00,507344,Hemans; Patricia Ann Benitez,22,0,40,18
1714372083446,EDS 281,A00,507345,Daly; Alan J.,18,0,18,0
1714372084471,EDS 284,A00,507350,Daly; Alan J.,16,0,16,0
1714372085496,EDS 286,A00,507359,Fine; Sarah,18,0,18,0
1714372086522,EDS 289C,A01,507361,Daly; Alan J.,18,0,18,0
1714372087551,EDS 290,A00,507366,Hofstetter; Carolyn,15,0,15,0
1714372088580,LIGM 5A,A00,507421,Fischer-Grunski; Eva K,18,0,20,2
1714372089606,LIGM 5B,A00,507423,Fischer-Grunski; Eva K,19,0,20,1
1714372090635,LIGM 5C,A00,507425,Fischer-Grunski; Eva K,19,0,20,1
1714372091660,LIIT 5AS,A00,507427,Carnelos; Chiara,20,0,20,0
1714372092691,LIIT 5BS,A00,507430,Carnelos; Chiara,20,0,20,0
1714372093723,LIIT 5CS,A00,507432,Carnelos; Chiara,20,0,20,0
1714372094756,LISP 5A,A00,507541,Munoz Sanchez; Alicia,11,0,20,9
1714372095786,LISP 5B,A00,507671,Munoz Sanchez; Alicia,9,0,20,11
1714372096816,LISP 5C,A00,507696,Munoz Sanchez; Alicia,9,0,20,11
1714372097842,MAE 197,001,528363,Boechler; Nicholas Sebastia,9998,0,9999,1
1714372098867,MATH 197,001,523477,Kedlaya; Kiran S.,9996,0,9999,3
1714372098867,MATH 197,002,563811,Zhang; Danna,9995,0,9999,4
1714372098867,MATH 197,003,628552,Dumitriu; Ioana,9998,0,9999,1
1714372099892,MCWP 40R,A00,518780,Staff,5,0,20,15
1714372099892,MCWP 40R,B00,518781,Staff,7,0,20,13
1714372099892,MCWP 40R,C00,518783,Staff,5,0,20,15
1714372100917,MCWP 50R,A00,518791,Staff,0,0,20,20
1714372100917,MCWP 50R,B00,518792,Staff,0,1,20,20
1714372100917,MCWP 50R,C00,518793,Staff,0,1,20,20
1714372100917,MCWP 50R,D00,518794,Staff,0,0,20,20
1714372100917,MCWP 50R,E00,518795,Staff,0,1,20,20
1714372100917,MCWP 50R,F00,518796,Staff,0,0,20,20
1714372100917,MCWP 50R,G00,518797,Staff,0,1,20,20
1714372101945,MMW 12R,A01,514034,Herbst; Matthew,0,1,16,16
1714372101945,MMW 12R,A02,514035,Herbst; Matthew,2,0,16,14
1714372102970,MMW 13R,A01,514037,Staff,0,4,16,16
1714372102970,MMW 13R,A02,514039,Staff,0,2,16,16
1714372102970,MMW 13R,A03,628519,Staff,0,2,16,16
1714372105023,SIO 295LS,A00,523233,Staff,12,0,30,18
1714372106061,SIO 295S,A00,523232,Staff,12,0,30,18
1714372107095,SIOC 290S,A01,637330,Merrifield; Mark A,27,0,30,3
1714372108123,SIOC 291S,A01,637333,Gabriel; Corey John,27,0,30,3
1714372109153,SOCI 117,A01,494376,Staff,0,3,5,5
1714372110177,WES 237B,A00,494380,Staff,9,0,20,11
1714372112250,AESE 279B,A00,494370,Wade; Jon P,0,0,33,33
1714372113283,AIP 197,001,627712,Vespa; Emanuel Ignacio,9998,0,9999,1
1714372114308,ANAR 135S,A00,494369,Braswell; Geoffrey E.,0,0,0,0
1714372115334,BENG 196,001,628496,Engler; Adam J.,9998,0,9999,1
1714372116370,CAT 124RS,A01,519847,Geibel; William,0,0,20,20
1714372117393,CAT 125RS,A01,515971,Geibel; William,0,0,20,20
1714372118425,CLRE 250,A00,511389,Morris; Sheldon,9993,0,9999,6
1714372119456,CLRE 251,A00,507176,Mehta; Ravindra L.,9993,0,9999,6
1714372119456,CLRE 251,B00,511410,Mehta; Ravindra L.,9998,0,9999,1
1714372120485,CLRE 252,A00,507189,Cuomo; Raphael Eduardo,9995,0,9999,4
1714372121513,CLRE 253,A00,507199,Vaida; Florin,9994,0,9999,5
1714372121513,CLRE 253,B00,507202,Vaida; Florin,9999,0,9999,0
1714372122543,CLRE 259,A00,507211,Patel; Hemal,9996,0,9999,3
1714372123575,CLRE 260,A00,507221,Cuomo; Raphael Eduardo,9999,0,9999,0
1714372124603,CLRE 297,001,507242,Cuomo; Raphael Eduardo,9999,0,9999,0
1714372125632,COGS 197,001,638244,Voytek; Bradley Thomas,9999,0,9999,0
1714372126658,CSE 191,A00,516875,Minnes Kemp; Mor Mia,9993,0,9999,6
1714372127685,CSE 197,001,637388,Minnes Kemp; Mor Mia,9998,0,9999,1
1714372128715,CSS 201S,A01,494383,Staff,35,0,35,0
1714372129746,CSS 202S,A01,494387,Staff,35,0,35,0
1714372130773,DSC 197,001,628532,Eldridge; Justin Matthew,9996,0,9999,3
1714372131803,EAP 100,A00,516065,Staff,9797,0,9999,202
1714372132827,ECE 45,A01,507414,Staff,33,0,60,27
1714372134889,ECE 111,A01,507420,Staff,19,0,50,31
1714372135915,ECE 197,001,548057,Sievenpiper; Daniel F.,9994,0,9999,5
1714372136941,EDS 115,A00,507243,Choi; Bailey Miyeon,12,0,28,16
1714372137972,EDS 117,A01,494379,Staff,0,2,30,30
1714372138997,EDS 125,A00,507246,Hopkins; Megan Beth,12,0,30,18
1714372140032,EDS 128A,A01,507264,Fargason; Sharon Gayle,14,0,26,12
1714372141058,EDS 128B,A01,507293,Pappas; Elizabeth,18,0,30,12
1714372142084,EDS 139,A00,507294,Fargason; Sharon Gayle,18,0,30,12
1714372142084,EDS 139,B00,507313,Pappas; Elizabeth,15,0,30,15
1714372143110,EDS 201,A00,507315,Staff,13,0,30,17
1714372144134,EDS 203,A01,507317,Halter; Christopher P.,12,0,30,18
1714372145159,EDS 204R,A01,507319,Halter; Christopher P.,0,3,30,30
1714372145159,EDS 204R,B01,507331,Heinzman; Erica M.,17,0,30,13
1714372146185,EDS 206R,A00,507332,Staff,0,4,30,30
1714372146185,EDS 206R,B00,507343,Staff,18,0,30,12
1714372147220,EDS 250,A00,507344,Hemans; Patricia Ann Benitez,22,0,40,18
1714372148245,EDS 281,A00,507345,Daly; Alan J.,18,0,18,0
1714372149323,EDS 284,A00,507350,Daly; Alan J.,16,0,16,0
1714372150353,EDS 286,A00,507359,Fine; Sarah,18,0,18,0
1714372151380,EDS 289C,A01,507361,Daly; Alan J.,18,0,18,0
1714372152405,EDS 290,A00,507366,Hofstetter; Carolyn,15,0,15,0
1714372153436,LIGM 5A,A00,507421,Fischer-Grunski; Eva K,18,0,20,2
1714372154465,LIGM 5B,A00,507423,Fischer-Grunski; Eva K,19,0,20,1
1714372155492,LIGM 5C,A00,507425,Fischer-Grunski; Eva K,19,0,20,1
1714372156518,LIIT 5AS,A00,507427,Carnelos; Chiara,20,0,20,0
1714372157546,LIIT 5BS,A00,507430,Carnelos; Chiara,20,0,20,0
1714372158576,LIIT 5CS,A00,507432,Carnelos; Chiara,20,0,20,0
1714372159601,LISP 5A,A00,507541,Munoz Sanchez; Alicia,11,0,20,9
1714372160631,LISP 5B,A00,507671,Munoz Sanchez; Alicia,9,0,20,11
1714372161656,LISP 5C,A00,507696,Munoz Sanchez; Alicia,9,0,20,11
1714372162680,MAE 197,001,528363,Boechler; Nicholas Sebastia,9998,0,9999,1
1714372163709,MATH 197,001,523477,Kedlaya; Kiran S.,9996,0,9999,3
1714372163709,MATH 197,002,563811,Zhang; Danna,9995,0,9999,4
1714372163709,MATH 197,003,628552,Dumitriu; Ioana,9998,0,9999,1
1714372164795,MCWP 40R,A00,518780,Staff,5,0,20,15
1714372164795,MCWP 40R,B00,518781,Staff,7,0,20,13
1714372164795,MCWP 40R,C00,518783,Staff,5,0,20,15
1714372165823,MCWP 50R,A00,518791,Staff,0,0,20,20
1714372165823,MCWP 50R,B00,518792,Staff,0,1,20,20
1714372165823,MCWP 50R,C00,518793,Staff,0,1,20,20
1714372165823,MCWP 50R,D00,518794,Staff,0,0,20,20
1714372165823,MCWP 50R,E00,518795,Staff,0,1,20,20
1714372165823,MCWP 50R,F00,518796,Staff,0,0,20,20
1714372165823,MCWP 50R,G00,518797,Staff,0,1,20,20
1714372166848,MMW 12R,A01,514034,Herbst; Matthew,0,1,16,16
1714372166848,MMW 12R,A02,514035,Herbst; Matthew,2,0,16,14
1714372167880,MMW 13R,A01,514037,Staff,0,4,16,16
1714372167880,MMW 13R,A02,514039,Staff,0,2,16,16
1714372167880,MMW 13R,A03,628519,Staff,0,2,16,16
1714372169931,SIO 295LS,A00,523233,Staff,12,0,30,18
1714372170959,SIO 295S,A00,523232,Staff,12,0,30,18
1714372172042,SIOC 290S,A01,637330,Merrifield; Mark A,27,0,30,3
1714372173072,SIOC 291S,A01,637333,Gabriel; Corey John,27,0,30,3
1714372174096,SOCI 117,A01,494376,Staff,0,3,5,5
1714372175122,WES 237B,A00,494380,Staff,9,0,20,11
1714372177193,AESE 279B,A00,494370,Wade; Jon P,0,0,33,33
1714372178218,AIP 197,001,627712,Vespa; Emanuel Ignacio,9998,0,9999,1
1714372179245,ANAR 135S,A00,494369,Braswell; Geoffrey E.,0,0,0,0
1714372180277,BENG 196,001,628496,Engler; Adam J.,9998,0,9999,1
1714372181302,CAT 124RS,A01,519847,Geibel; William,0,0,20,20
1714372182330,CAT 125RS,A01,515971,Geibel; William,0,0,20,20
1714372183355,CLRE 250,A00,511389,Morris; Sheldon,9993,0,9999,6
1714372184382,CLRE 251,A00,507176,Mehta; Ravindra L.,9993,0,9999,6
1714372184382,CLRE 251,B00,511410,Mehta; Ravindra L.,9998,0,9999,1
1714372185411,CLRE 252,A00,507189,Cuomo; Raphael Eduardo,9995,0,9999,4
1714372186437,CLRE 253,A00,507199,Vaida; Florin,9994,0,9999,5
1714372186437,CLRE 253,B00,507202,Vaida; Florin,9999,0,9999,0
1714372187466,CLRE 259,A00,507211,Patel; Hemal,9996,0,9999,3
1714372188493,CLRE 260,A00,507221,Cuomo; Raphael Eduardo,9999,0,9999,0
1714372189518,CLRE 297,001,507242,Cuomo; Raphael Eduardo,9999,0,9999,0
1714372190545,COGS 197,001,638244,Voytek; Bradley Thomas,9999,0,9999,0
1714372191570,CSE 191,A00,516875,Minnes Kemp; Mor Mia,9993,0,9999,6
1714372192596,CSE 197,001,637388,Minnes Kemp; Mor Mia,9998,0,9999,1
1714372193625,CSS 201S,A01,494383,Staff,35,0,35,0
1714372194651,CSS 202S,A01,494387,Staff,35,0,35,0
1714372195676,DSC 197,001,628532,Eldridge; Justin Matthew,9996,0,9999,3
1714372196703,EAP 100,A00,516065,Staff,9797,0,9999,202
1714372197731,ECE 45,A01,507414,Staff,33,0,60,27
1714372199791,ECE 111,A01,507420,Staff,19,0,50,31
1714372200819,ECE 197,001,548057,Sievenpiper; Daniel F.,9994,0,9999,5
1714372201853,EDS 115,A00,507243,Choi; Bailey Miyeon,12,0,28,16
1714372202887,EDS 117,A01,494379,Staff,0,2,30,30
1714372203916,EDS 125,A00,507246,Hopkins; Megan Beth,12,0,30,18
1714372204946,EDS 128A,A01,507264,Fargason; Sharon Gayle,14,0,26,12
1714372205972,EDS 128B,A01,507293,Pappas; Elizabeth,18,0,30,12
1714372207000,EDS 139,A00,507294,Fargason; Sharon Gayle,18,0,30,12
1714372207000,EDS 139,B00,507313,Pappas; Elizabeth,15,0,30,15
1714372208024,EDS 201,A00,507315,Staff,13,0,30,17
1714372209048,EDS 203,A01,507317,Halter; Christopher P.,12,0,30,18
1714372210073,EDS 204R,A01,507319,Halter; Christopher P.,0,3,30,30
1714372210073,EDS 204R,B01,507331,Heinzman; Erica M.,17,0,30,13
1714372211098,EDS 206R,A00,507332,Staff,0,4,30,30
1714372211098,EDS 206R,B00,507343,Staff,18,0,30,12
1714372212124,EDS 250,A00,507344,Hemans; Patricia Ann Benitez,22,0,40,18
1714372213150,EDS 281,A00,507345,Daly; Alan J.,18,0,18,0
1714372214181,EDS 284,A00,507350,Daly; Alan J.,16,0,16,0
1714372215206,EDS 286,A00,507359,Fine; Sarah,18,0,18,0
1714372216235,EDS 289C,A01,507361,Daly; Alan J.,18,0,18,0
1714372217261,EDS 290,A00,507366,Hofstetter; Carolyn,15,0,15,0
1714372218286,LIGM 5A,A00,507421,Fischer-Grunski; Eva K,18,0,20,2
1714372219315,LIGM 5B,A00,507423,Fischer-Grunski; Eva K,19,0,20,1
1714372220340,LIGM 5C,A00,507425,Fischer-Grunski; Eva K,19,0,20,1
1714372221370,LIIT 5AS,A00,507427,Carnelos; Chiara,20,0,20,0
1714372222395,LIIT 5BS,A00,507430,Carnelos; Chiara,20,0,20,0
1714372223421,LIIT 5CS,A00,507432,Carnelos; Chiara,20,0,20,0
1714372224450,LISP 5A,A00,507541,Munoz Sanchez; Alicia,11,0,20,9
1714372225475,LISP 5B,A00,507671,Munoz Sanchez; Alicia,9,0,20,11
1714372226505,LISP 5C,A00,507696,Munoz Sanchez; Alicia,9,0,20,11
1714372227538,MAE 197,001,528363,Boechler; Nicholas Sebastia,9998,0,9999,1
1714372228565,MATH 197,001,523477,Kedlaya; Kiran S.,9996,0,9999,3
1714372228565,MATH 197,002,563811,Zhang; Danna,9995,0,9999,4
1714372228565,MATH 197,003,628552,Dumitriu; Ioana,9998,0,9999,1
1714372229593,MCWP 40R,A00,518780,Staff,5,0,20,15
1714372229593,MCWP 40R,B00,518781,Staff,7,0,20,13
1714372229593,MCWP 40R,C00,518783,Staff,5,0,20,15
1714372230622,MCWP 50R,A00,518791,Staff,0,0,20,20
1714372230622,MCWP 50R,B00,518792,Staff,0,1,20,20
1714372230622,MCWP 50R,C00,518793,Staff,0,1,20,20
1714372230622,MCWP 50R,D00,518794,Staff,0,0,20,20
1714372230622,MCWP 50R,E00,518795,Staff,0,1,20,20
1714372230622,MCWP 50R,F00,518796,Staff,0,0,20,20
1714372230622,MCWP 50R,G00,518797,Staff,0,1,20,20
1714372231649,MMW 12R,A01,514034,Herbst; Matthew,0,1,16,16
1714372231649,MMW 12R,A02,514035,Herbst; Matthew,2,0,16,14
1714372232674,MMW 13R,A01,514037,Staff,0,4,16,16
1714372232674,MMW 13R,A02,514039,Staff,0,2,16,16
1714372232674,MMW 13R,A03,628519,Staff,0,2,16,16
1714372234730,SIO 295LS,A00,523233,Staff,12,0,30,18
1714372235756,SIO 295S,A00,523232,Staff,12,0,30,18
1714372236782,SIOC 290S,A01,637330,Merrifield; Mark A,27,0,30,3
1714372237810,SIOC 291S,A01,637333,Gabriel; Corey John,27,0,30,3
1714372238837,SOCI 117,A01,494376,Staff,0,3,5,5
1714372239862,WES 237B,A00,494380,Staff,9,0,20,11
1714372241947,AESE 279B,A00,494370,Wade; Jon P,0,0,33,33
1714372242972,AIP 197,001,627712,Vespa; Emanuel Ignacio,9998,0,9999,1
1714372244000,ANAR 135S,A00,494369,Braswell; Geoffrey E.,0,0,0,0
1714372245028,BENG 196,001,628496,Engler; Adam J.,9998,0,9999,1
1714372246055,CAT 124RS,A01,519847,Geibel; William,0,0,20,20
1714372247080,CAT 125RS,A01,515971,Geibel; William,0,0,20,20
1714372248107,CLRE 250,A00,511389,Morris; Sheldon,9993,0,9999,6
1714372249135,CLRE 251,A00,507176,Mehta; Ravindra L.,9993,0,9999,6
1714372249135,CLRE 251,B00,511410,Mehta; Ravindra L.,9998,0,9999,1
1714372250161,CLRE 252,A00,507189,Cuomo; Raphael Eduardo,9995,0,9999,4
1714372251185,CLRE 253,A00,507199,Vaida; Florin,9994,0,9999,5
1714372251185,CLRE 253,B00,507202,Vaida; Florin,9999,0,9999,0
1714372252213,CLRE 259,A00,507211,Patel; Hemal,9996,0,9999,3
1714372253238,CLRE 260,A00,507221,Cuomo; Raphael Eduardo,9999,0,9999,0
1714372254269,CLRE 297,001,507242,Cuomo; Raphael Eduardo,9999,0,9999,0
1714372255303,COGS 197,001,638244,Voytek; Bradley Thomas,9999,0,9999,0
1714372256333,CSE 191,A00,516875,Minnes Kemp; Mor Mia,9993,0,9999,6
1714372257359,CSE 197,001,637388,Minnes Kemp; Mor Mia,9998,0,9999,1
1714372258394,CSS 201S,A01,494383,Staff,35,0,35,0
1714372259419,CSS 202S,A01,494387,Staff,35,0,35,0
1714372260605,DSC 197,001,628532,Eldridge; Justin Matthew,9996,0,9999,3
1714372261630,EAP 100,A00,516065,Staff,9797,0,9999,202
1714372262655,ECE 45,A01,507414,Staff,33,0,60,27
1714372264706,ECE 111,A01,507420,Staff,19,0,50,31
1714372265742,ECE 197,001,548057,Sievenpiper; Daniel F.,9994,0,9999,5
1714372266773,EDS 115,A00,507243,Choi; Bailey Miyeon,12,0,28,16
1714372267801,EDS 117,A01,494379,Staff,0,2,30,30
1714372268826,EDS 125,A00,507246,Hopkins; Megan Beth,12,0,30,18
1714372269857,EDS 128A,A01,507264,Fargason; Sharon Gayle,14,0,26,12
1714372270882,EDS 128B,A01,507293,Pappas; Elizabeth,18,0,30,12
1714372271908,EDS 139,A00,507294,Fargason; Sharon Gayle,18,0,30,12
1714372271908,EDS 139,B00,507313,Pappas; Elizabeth,15,0,30,15
1714372272935,EDS 201,A00,507315,Staff,13,0,30,17
1714372273963,EDS 203,A01,507317,Halter; Christopher P.,12,0,30,18
1714372274988,EDS 204R,A01,507319,Halter; Christopher P.,0,3,30,30
1714372274988,EDS 204R,B01,507331,Heinzman; Erica M.,17,0,30,13
1714372276065,EDS 206R,A00,507332,Staff,0,4,30,30
1714372276065,EDS 206R,B00,507343,Staff,18,0,30,12
1714372277095,EDS 250,A00,507344,Hemans; Patricia Ann Benitez,22,0,40,18
1714372278121,EDS 281,A00,507345,Daly; Alan J.,18,0,18,0
1714372279150,EDS 284,A00,507350,Daly; Alan J.,16,0,16,0
1714372280178,EDS 286,A00,507359,Fine; Sarah,18,0,18,0
1714372281203,EDS 289C,A01,507361,Daly; Alan J.,18,0,18,0
1714372282227,EDS 290,A00,507366,Hofstetter; Carolyn,15,0,15,0
1714372283252,LIGM 5A,A00,507421,Fischer-Grunski; Eva K,18,0,20,2
1714372284281,LIGM 5B,A00,507423,Fischer-Grunski; Eva K,19,0,20,1
1714372285307,LIGM 5C,A00,507425,Fischer-Grunski; Eva K,19,0,20,1
1714372286334,LIIT 5AS,A00,507427,Carnelos; Chiara,20,0,20,0
1714372287358,LIIT 5BS,A00,507430,Carnelos; Chiara,20,0,20,0
1714372288383,LIIT 5CS,A00,507432,Carnelos; Chiara,20,0,20,0
1714372289413,LISP 5A,A00,507541,Munoz Sanchez; Alicia,11,0,20,9
1714372290438,LISP 5B,A00,507671,Munoz Sanchez; Alicia,9,0,20,11
1714372291462,LISP 5C,A00,507696,Munoz Sanchez; Alicia,9,0,20,11
1714372292487,MAE 197,001,528363,Boechler; Nicholas Sebastia,9998,0,9999,1
1714372293514,MATH 197,001,523477,Kedlaya; Kiran S.,9996,0,9999,3
1714372293514,MATH 197,002,563811,Zhang; Danna,9995,0,9999,4
1714372293514,MATH 197,003,628552,Dumitriu; Ioana,9998,0,9999,1
1714372294545,MCWP 40R,A00,518780,Staff,5,0,20,15
1714372294545,MCWP 40R,B00,518781,Staff,7,0,20,13
1714372294545,MCWP 40R,C00,518783,Staff,5,0,20,15
1714372295575,MCWP 50R,A00,518791,Staff,0,0,20,20
1714372295575,MCWP 50R,B00,518792,Staff,0,1,20,20
1714372295575,MCWP 50R,C00,518793,Staff,0,1,20,20
1714372295575,MCWP 50R,D00,518794,Staff,0,0,20,20
1714372295575,MCWP 50R,E00,518795,Staff,0,1,20,20
1714372295575,MCWP 50R,F00,518796,Staff,0,0,20,20
1714372295575,MCWP 50R,G00,518797,Staff,0,1,20,20
1714372296600,MMW 12R,A01,514034,Herbst; Matthew,0,1,16,16
1714372296600,MMW 12R,A02,514035,Herbst; Matthew,2,0,16,14
1714372297626,MMW 13R,A01,514037,Staff,0,4,16,16
1714372297626,MMW 13R,A02,514039,Staff,0,2,16,16
1714372297626,MMW 13R,A03,628519,Staff,0,2,16,16
1714372299682,SIO 295LS,A00,523233,Staff,12,0,30,18
1714372300716,SIO 295S,A00,523232,Staff,12,0,30,18
1714372301741,SIOC 290S,A01,637330,Merrifield; Mark A,27,0,30,3
1714372302774,SIOC 291S,A01,637333,Gabriel; Corey John,27,0,30,3
1714372303800,SOCI 117,A01,494376,Staff,0,3,5,5
1714372304825,WES 237B,A00,494380,Staff,9,0,20,11
1714372306892,AESE 279B,A00,494370,Wade; Jon P,0,0,33,33
1714372307917,AIP 197,001,627712,Vespa; Emanuel Ignacio,9998,0,9999,1
1714372308948,ANAR 135S,A00,494369,Braswell; Geoffrey E.,0,0,0,0
1714372309974,BENG 196,001,628496,Engler; Adam J.,9998,0,9999,1
1714372311005,CAT 124RS,A01,519847,Geibel; William,0,0,20,20
1714372312033,CAT 125RS,A01,515971,Geibel; William,0,0,20,20
1714372313057,CLRE 250,A00,511389,Morris; Sheldon,9993,0,9999,6
1714372314086,CLRE 251,A00,507176,Mehta; Ravindra L.,9993,0,9999,6
1714372314086,CLRE 251,B00,511410,Mehta; Ravindra L.,9998,0,9999,1
1714372315114,CLRE 252,A00,507189,Cuomo; Raphael Eduardo,9995,0,9999,4
1714372316142,CLRE 253,A00,507199,Vaida; Florin,9994,0,9999,5
1714372316142,CLRE 253,B00,507202,Vaida; Florin,9999,0,9999,0
1714372317218,CLRE 259,A00,507211,Patel; Hemal,9996,0,9999,3
1714372318243,CLRE 260,A00,507221,Cuomo; Raphael Eduardo,9999,0,9999,0
1714372319267,CLRE 297,001,507242,Cuomo; Raphael Eduardo,9999,0,9999,0
1714372320296,COGS 197,001,638244,Voytek; Bradley Thomas,9999,0,9999,0
1714372321325,CSE 191,A00,516875,Minnes Kemp; Mor Mia,9993,0,9999,6
1714372322349,CSE 197,001,637388,Minnes Kemp; Mor Mia,9998,0,9999,1
1714372323374,CSS 201S,A01,494383,Staff,35,0,35,0
1714372324398,CSS 202S,A01,494387,Staff,35,0,35,0
1714372325423,DSC 197,001,628532,Eldridge; Justin Matthew,9996,0,9999,3
1714372326450,EAP 100,A00,516065,Staff,9797,0,9999,202
1714372327473,ECE 45,A01,507414,Staff,33,0,60,27
1714372329528,ECE 111,A01,507420,Staff,19,0,50,31
1714372330551,ECE 197,001,548057,Sievenpiper; Daniel F.,9994,0,9999,5
1714372331576,EDS 115,A00,507243,Choi; Bailey Miyeon,12,0,28,16
1714372332604,EDS 117,A01,494379,Staff,0,2,30,30
1714372333627,EDS 125,A00,507246,Hopkins; Megan Beth,12,0,30,18
1714372334652,EDS 128A,A01,507264,Fargason; Sharon Gayle,14,0,26,12
1714372335678,EDS 128B,A01,507293,Pappas; Elizabeth,18,0,30,12
1714372336701,EDS 139,A00,507294,Fargason; Sharon Gayle,18,0,30,12
1714372336701,EDS 139,B00,507313,Pappas; Elizabeth,15,0,30,15
1714372337725,EDS 201,A00,507315,Staff,13,0,30,17
1714372338754,EDS 203,A01,507317,Halter; Christopher P.,12,0,30,18
1714372339783,EDS 204R,A01,507319,Halter; Christopher P.,0,3,30,30
1714372339783,EDS 204R,B01,507331,Heinzman; Erica M.,17,0,30,13
1714372340808,EDS 206R,A00,507332,Staff,0,4,30,30
1714372340808,EDS 206R,B00,507343,Staff,18,0,30,12
1714372341833,EDS 250,A00,507344,Hemans; Patricia Ann Benitez,22,0,40,18
1714372342859,EDS 281,A00,507345,Daly; Alan J.,18,0,18,0
1714372343883,EDS 284,A00,507350,Daly; Alan J.,16,0,16,0
1714372344908,EDS 286,A00,507359,Fine; Sarah,18,0,18,0
1714372345936,EDS 289C,A01,507361,Daly; Alan J.,18,0,18,0
1714372346961,EDS 290,A00,507366,Hofstetter; Carolyn,15,0,15,0
1714372347987,LIGM 5A,A00,507421,Fischer-Grunski; Eva K,18,0,20,2
1714372349012,LIGM 5B,A00,507423,Fischer-Grunski; Eva K,19,0,20,1
1714372350036,LIGM 5C,A00,507425,Fischer-Grunski; Eva K,19,0,20,1
1714372351066,LIIT 5AS,A00,507427,Carnelos; Chiara,20,0,20,0
1714372352091,LIIT 5BS,A00,507430,Carnelos; Chiara,20,0,20,0
1714372353116,LIIT 5CS,A00,507432,Carnelos; Chiara,20,0,20,0
1714372354144,LISP 5A,A00,507541,Munoz Sanchez; Alicia,11,0,20,9
1714372355168,LISP 5B,A00,507671,Munoz Sanchez; Alicia,9,0,20,11
1714372356196,LISP 5C,A00,507696,Munoz Sanchez; Alicia,9,0,20,11
1714372357225,MAE 197,001,528363,Boechler; Nicholas Sebastia,9998,0,9999,1
1714372358251,MATH 197,001,523477,Kedlaya; Kiran S.,9996,0,9999,3
1714372358251,MATH 197,002,563811,Zhang; Danna,9995,0,9999,4
1714372358251,MATH 197,003,628552,Dumitriu; Ioana,9998,0,9999,1
1714372359279,MCWP 40R,A00,518780,Staff,5,0,20,15
1714372359279,MCWP 40R,B00,518781,Staff,7,0,20,13
1714372359279,MCWP 40R,C00,518783,Staff,5,0,20,15
1714372360309,MCWP 50R,A00,518791,Staff,0,0,20,20
1714372360309,MCWP 50R,B00,518792,Staff,0,1,20,20
1714372360309,MCWP 50R,C00,518793,Staff,0,1,20,20
1714372360309,MCWP 50R,D00,518794,Staff,0,0,20,20
1714372360309,MCWP 50R,E00,518795,Staff,0,1,20,20
1714372360309,MCWP 50R,F00,518796,Staff,0,0,20,20
1714372360309,MCWP 50R,G00,518797,Staff,0,1,20,20
1714372361335,MMW 12R,A01,514034,Herbst; Matthew,0,1,16,16
1714372361335,MMW 12R,A02,514035,Herbst; Matthew,2,0,16,14
1714372362361,MMW 13R,A01,514037,Staff,0,4,16,16
1714372362361,MMW 13R,A02,514039,Staff,0,2,16,16
1714372362361,MMW 13R,A03,628519,Staff,0,2,16,16
1714372364409,SIO 295LS,A00,523233,Staff,12,0,30,18
1714372365439,SIO 295S,A00,523232,Staff,12,0,30,18
1714372366467,SIOC 290S,A01,637330,Merrifield; Mark A,27,0,30,3
1714372367492,SIOC 291S,A01,637333,Gabriel; Corey John,27,0,30,3
1714372368517,SOCI 117,A01,494376,Staff,0,3,5,5
1714372369542,WES 237B,A00,494380,Staff,9,0,20,11
1714372371604,AESE 279B,A00,494370,Wade; Jon P,0,0,33,33
1714372372631,AIP 197,001,627712,Vespa; Emanuel Ignacio,9998,0,9999,1
1714372373657,ANAR 135S,A00,494369,Braswell; Geoffrey E.,0,0,0,0
1714372374694,BENG 196,001,628496,Engler; Adam J.,9998,0,9999,1
1714372375719,CAT 124RS,A01,519847,Geibel; William,0,0,20,20
1714372376748,CAT 125RS,A01,515971,Geibel; William,0,0,20,20
1714372377774,CLRE 250,A00,511389,Morris; Sheldon,9993,0,9999,6
1714372378800,CLRE 251,A00,507176,Mehta; Ravindra L.,9993,0,9999,6
1714372378800,CLRE 251,B00,511410,Mehta; Ravindra L.,9998,0,9999,1
1714372379878,CLRE 252,A00,507189,Cuomo; Raphael Eduardo,9995,0,9999,4
1714372380903,CLRE 253,A00,507199,Vaida; Florin,9994,0,9999,5
1714372380903,CLRE 253,B00,507202,Vaida; Florin,9999,0,9999,0
1714372381928,CLRE 259,A00,507211,Patel; Hemal,9996,0,9999,3
1714372382955,CLRE 260,A00,507221,Cuomo; Raphael Eduardo,9999,0,9999,0
1714372383981,CLRE 297,001,507242,Cuomo; Raphael Eduardo,9999,0,9999,0
1714372385006,COGS 197,001,638244,Voytek; Bradley Thomas,9999,0,9999,0
1714372386031,CSE 191,A00,516875,Minnes Kemp; Mor Mia,9993,0,9999,6
1714372387059,CSE 197,001,637388,Minnes Kemp; Mor Mia,9998,0,9999,1
1714372388083,CSS 201S,A01,494383,Staff,35,0,35,0
1714372389112,CSS 202S,A01,494387,Staff,35,0,35,0
1714372390141,DSC 197,001,628532,Eldridge; Justin Matthew,9996,0,9999,3
1714372391169,EAP 100,A00,516065,Staff,9797,0,9999,202
1714372392197,ECE 45,A01,507414,Staff,33,0,60,27
1714372394248,ECE 111,A01,507420,Staff,19,0,50,31
1714372395272,ECE 197,001,548057,Sievenpiper; Daniel F.,9994,0,9999,5
1714372396296,EDS 115,A00,507243,Choi; Bailey Miyeon,12,0,28,16
1714372397325,EDS 117,A01,494379,Staff,0,2,30,30
1714372398350,EDS 125,A00,507246,Hopkins; Megan Beth,12,0,30,18
1714372399377,EDS 128A,A01,507264,Fargason; Sharon Gayle,14,0,26,12
1714372400403,EDS 128B,A01,507293,Pappas; Elizabeth,18,0,30,12
1714372401428,EDS 139,A00,507294,Fargason; Sharon Gayle,18,0,30,12
1714372401428,EDS 139,B00,507313,Pappas; Elizabeth,15,0,30,15
1714372402453,EDS 201,A00,507315,Staff,13,0,30,17
1714372403479,EDS 203,A01,507317,Halter; Christopher P.,12,0,30,18
1714372404504,EDS 204R,A01,507319,Halter; Christopher P.,0,3,30,30
1714372404504,EDS 204R,B01,507331,Heinzman; Erica M.,17,0,30,13
1714372405528,EDS 206R,A00,507332,Staff,0,4,30,30
1714372405528,EDS 206R,B00,507343,Staff,18,0,30,12
1714372406553,EDS 250,A00,507344,Hemans; Patricia Ann Benitez,22,0,40,18
1714372407578,EDS 281,A00,507345,Daly; Alan J.,18,0,18,0
1714372408602,EDS 284,A00,507350,Daly; Alan J.,16,0,16,0
1714372409627,EDS 286,A00,507359,Fine; Sarah,18,0,18,0
1714372410652,EDS 289C,A01,507361,Daly; Alan J.,18,0,18,0
1714372411679,EDS 290,A00,507366,Hofstetter; Carolyn,15,0,15,0
1714372412708,LIGM 5A,A00,507421,Fischer-Grunski; Eva K,18,0,20,2
1714372413736,LIGM 5B,A00,507423,Fischer-Grunski; Eva K,19,0,20,1
1714372414764,LIGM 5C,A00,507425,Fischer-Grunski; Eva K,19,0,20,1
1714372415793,LIIT 5AS,A00,507427,Carnelos; Chiara,20,0,20,0
1714372416819,LIIT 5BS,A00,507430,Carnelos; Chiara,20,0,20,0
1714372417848,LIIT 5CS,A00,507432,Carnelos; Chiara,20,0,20,0
1714372418874,LISP 5A,A00,507541,Munoz Sanchez; Alicia,11,0,20,9
1714372419903,LISP 5B,A00,507671,Munoz Sanchez; Alicia,9,0,20,11
1714372420933,LISP 5C,A00,507696,Munoz Sanchez; Alicia,9,0,20,11
1714372421965,MAE 197,001,528363,Boechler; Nicholas Sebastia,9998,0,9999,1
1714372422990,MATH 197,001,523477,Kedlaya; Kiran S.,9996,0,9999,3
1714372422990,MATH 197,002,563811,Zhang; Danna,9995,0,9999,4
1714372422990,MATH 197,003,628552,Dumitriu; Ioana,9998,0,9999,1
1714372424015,MCWP 40R,A00,518780,Staff,5,0,20,15
1714372424015,MCWP 40R,B00,518781,Staff,7,0,20,13
1714372424015,MCWP 40R,C00,518783,Staff,5,0,20,15
1714372425040,MCWP 50R,A00,518791,Staff,0,0,20,20
1714372425040,MCWP 50R,B00,518792,Staff,0,1,20,20
1714372425040,MCWP 50R,C00,518793,Staff,0,1,20,20
1714372425040,MCWP 50R,D00,518794,Staff,0,0,20,20
1714372425040,MCWP 50R,E00,518795,Staff,0,1,20,20
1714372425040,MCWP 50R,F00,518796,Staff,0,0,20,20
1714372425040,MCWP 50R,G00,518797,Staff,0,1,20,20
1714372426065,MMW 12R,A01,514034,Herbst; Matthew,0,1,16,16
1714372426065,MMW 12R,A02,514035,Herbst; Matthew,2,0,16,14
1714372427094,MMW 13R,A01,514037,Staff,0,4,16,16
1714372427094,MMW 13R,A02,514039,Staff,0,2,16,16
1714372427094,MMW 13R,A03,628519,Staff,0,2,16,16
1714372429150,SIO 295LS,A00,523233,Staff,12,0,30,18
1714372430174,SIO 295S,A00,523232,Staff,12,0,30,18
1714372431199,SIOC 290S,A01,637330,Merrifield; Mark A,27,0,30,3
1714372432224,SIOC 291S,A01,637333,Gabriel; Corey John,27,0,30,3
1714372433253,SOCI 117,A01,494376,Staff,0,3,5,5
1714372434279,WES 237B,A00,494380,Staff,9,0,20,11
1714372436340,AESE 279B,A00,494370,Wade; Jon P,0,0,33,33
1714372437367,AIP 197,001,627712,Vespa; Emanuel Ignacio,9998,0,9999,1
1714372438394,ANAR 135S,A00,494369,Braswell; Geoffrey E.,0,0,0,0
1714372439420,BENG 196,001,628496,Engler; Adam J.,9998,0,9999,1
1714372440482,CAT 124RS,A01,519847,Geibel; William,0,0,20,20
1714372441510,CAT 125RS,A01,515971,Geibel; William,0,0,20,20
1714372442536,CLRE 250,A00,511389,Morris; Sheldon,9993,0,9999,6
1714372443570,CLRE 251,A00,507176,Mehta; Ravindra L.,9993,0,9999,6
1714372443570,CLRE 251,B00,511410,Mehta; Ravindra L.,9998,0,9999,1
1714372444595,CLRE 252,A00,507189,Cuomo; Raphael Eduardo,9995,0,9999,4
1714372445624,CLRE 253,A00,507199,Vaida; Florin,9994,0,9999,5
1714372445624,CLRE 253,B00,507202,Vaida; Florin,9999,0,9999,0
1714372446649,CLRE 259,A00,507211,Patel; Hemal,9996,0,9999,3
1714372447676,CLRE 260,A00,507221,Cuomo; Raphael Eduardo,9999,0,9999,0
1714372448700,CLRE 297,001,507242,Cuomo; Raphael Eduardo,9999,0,9999,0
1714372449728,COGS 197,001,638244,Voytek; Bradley Thomas,9999,0,9999,0
1714372450754,CSE 191,A00,516875,Minnes Kemp; Mor Mia,9993,0,9999,6
1714372451779,CSE 197,001,637388,Minnes Kemp; Mor Mia,9998,0,9999,1
1714372452810,CSS 201S,A01,494383,Staff,35,0,35,0
1714372453834,CSS 202S,A01,494387,Staff,35,0,35,0
1714372454865,DSC 197,001,628532,Eldridge; Justin Matthew,9996,0,9999,3
1714372455893,EAP 100,A00,516065,Staff,9797,0,9999,202
1714372456924,ECE 45,A01,507414,Staff,33,0,60,27
1714372458979,ECE 111,A01,507420,Staff,19,0,50,31
1714372460006,ECE 197,001,548057,Sievenpiper; Daniel F.,9994,0,9999,5
1714372461034,EDS 115,A00,507243,Choi; Bailey Miyeon,12,0,28,16
1714372462061,EDS 117,A01,494379,Staff,0,2,30,30
1714372463090,EDS 125,A00,507246,Hopkins; Megan Beth,12,0,30,18
1714372464119,EDS 128A,A01,507264,Fargason; Sharon Gayle,14,0,26,12
1714372465149,EDS 128B,A01,507293,Pappas; Elizabeth,18,0,30,12
1714372466174,EDS 139,A00,507294,Fargason; Sharon Gayle,18,0,30,12
1714372466174,EDS 139,B00,507313,Pappas; Elizabeth,15,0,30,15
1714372467199,EDS 201,A00,507315,Staff,13,0,30,17
1714372468228,EDS 203,A01,507317,Halter; Christopher P.,12,0,30,18
1714372469256,EDS 204R,A01,507319,Halter; Christopher P.,0,3,30,30
1714372469256,EDS 204R,B01,507331,Heinzman; Erica M.,17,0,30,13
1714372470283,EDS 206R,A00,507332,Staff,0,4,30,30
1714372470283,EDS 206R,B00,507343,Staff,18,0,30,12
1714372471311,EDS 250,A00,507344,Hemans; Patricia Ann Benitez,22,0,40,18
1714372472336,EDS 281,A00,507345,Daly; Alan J.,18,0,18,0
1714372473361,EDS 284,A00,507350,Daly; Alan J.,16,0,16,0
1714372474386,EDS 286,A00,507359,Fine; Sarah,18,0,18,0
1714372475409,EDS 289C,A01,507361,Daly; Alan J.,18,0,18,0
1714372476436,EDS 290,A00,507366,Hofstetter; Carolyn,15,0,15,0
1714372477459,LIGM 5A,A00,507421,Fischer-Grunski; Eva K,18,0,20,2
1714372478485,LIGM 5B,A00,507423,Fischer-Grunski; Eva K,19,0,20,1
1714372479513,LIGM 5C,A00,507425,Fischer-Grunski; Eva K,19,0,20,1
1714372480542,LIIT 5AS,A00,507427,Carnelos; Chiara,20,0,20,0
1714372481571,LIIT 5BS,A00,507430,Carnelos; Chiara,20,0,20,0
1714372482595,LIIT 5CS,A00,507432,Carnelos; Chiara,20,0,20,0
1714372483674,LISP 5A,A00,507541,Munoz Sanchez; Alicia,11,0,20,9
1714372484700,LISP 5B,A00,507671,Munoz Sanchez; Alicia,9,0,20,11
1714372485724,LISP 5C,A00,507696,Munoz Sanchez; Alicia,9,0,20,11
1714372486752,MAE 197,001,528363,Boechler; Nicholas Sebastia,9998,0,9999,1
1714372487783,MATH 197,001,523477,Kedlaya; Kiran S.,9996,0,9999,3
1714372487783,MATH 197,002,563811,Zhang; Danna,9995,0,9999,4
1714372487783,MATH 197,003,628552,Dumitriu; Ioana,9998,0,9999,1
1714372488807,MCWP 40R,A00,518780,Staff,5,0,20,15
1714372488807,MCWP 40R,B00,518781,Staff,7,0,20,13
1714372488807,MCWP 40R,C00,518783,Staff,5,0,20,15
1714372489836,MCWP 50R,A00,518791,Staff,0,0,20,20
1714372489836,MCWP 50R,B00,518792,Staff,0,1,20,20
1714372489836,MCWP 50R,C00,518793,Staff,0,1,20,20
1714372489836,MCWP 50R,D00,518794,Staff,0,0,20,20
1714372489836,MCWP 50R,E00,518795,Staff,0,1,20,20
1714372489836,MCWP 50R,F00,518796,Staff,0,0,20,20
1714372489836,MCWP 50R,G00,518797,Staff,0,1,20,20
1714372490865,MMW 12R,A01,514034,Herbst; Matthew,0,1,16,16
1714372490865,MMW 12R,A02,514035,Herbst; Matthew,2,0,16,14
1714372491893,MMW 13R,A01,514037,Staff,0,4,16,16
1714372491893,MMW 13R,A02,514039,Staff,0,2,16,16
1714372491893,MMW 13R,A03,628519,Staff,0,2,16,16
1714372493948,SIO 295LS,A00,523233,Staff,12,0,30,18
1714372494988,SIO 295S,A00,523232,Staff,12,0,30,18
1714372496017,SIOC 290S,A01,637330,Merrifield; Mark A,27,0,30,3
1714372497046,SIOC 291S,A01,637333,Gabriel; Corey John,27,0,30,3
1714372498072,SOCI 117,A01,494376,Staff,0,3,5,5
1714372499096,WES 237B,A00,494380,Staff,9,0,20,11
1714372501455,AESE 279B,A00,494370,Wade; Jon P,0,0,33,33
1714372502481,AIP 197,001,627712,Vespa; Emanuel Ignacio,9998,0,9999,1
1714372503506,ANAR 135S,A00,494369,Braswell; Geoffrey E.,0,0,0,0
1714372504531,BENG 196,001,628496,Engler; Adam J.,9998,0,9999,1
1714372505560,CAT 124RS,A01,519847,Geibel; William,0,0,20,20
1714372506587,CAT 125RS,A01,515971,Geibel; William,0,0,20,20
1714372507618,CLRE 250,A00,511389,Morris; Sheldon,9993,0,9999,6
1714372508645,CLRE 251,A00,507176,Mehta; Ravindra L.,9993,0,9999,6
1714372508645,CLRE 251,B00,511410,Mehta; Ravindra L.,9998,0,9999,1
1714372509672,CLRE 252,A00,507189,Cuomo; Raphael Eduardo,9995,0,9999,4
1714372510699,CLRE 253,A00,507199,Vaida; Florin,9994,0,9999,5
1714372510699,CLRE 253,B00,507202,Vaida; Florin,9999,0,9999,0
1714372511725,CLRE 259,A00,507211,Patel; Hemal,9996,0,9999,3
1714372512751,CLRE 260,A00,507221,Cuomo; Raphael Eduardo,9999,0,9999,0
1714372513777,CLRE 297,001,507242,Cuomo; Raphael Eduardo,9999,0,9999,0
1714372514805,COGS 197,001,638244,Voytek; Bradley Thomas,9999,0,9999,0
1714372515831,CSE 191,A00,516875,Minnes Kemp; Mor Mia,9993,0,9999,6
1714372516856,CSE 197,001,637388,Minnes Kemp; Mor Mia,9998,0,9999,1
1714372517881,CSS 201S,A01,494383,Staff,35,0,35,0
1714372518912,CSS 202S,A01,494387,Staff,35,0,35,0
1714372519942,DSC 197,001,628532,Eldridge; Justin Matthew,9996,0,9999,3
1714372520968,EAP 100,A00,516065,Staff,9797,0,9999,202
1714372521995,ECE 45,A01,507414,Staff,33,0,60,27
1714372524046,ECE 111,A01,507420,Staff,19,0,50,31
1714372525076,ECE 197,001,548057,Sievenpiper; Daniel F.,9994,0,9999,5
1714372526105,EDS 115,A00,507243,Choi; Bailey Miyeon,12,0,28,16
1714372527131,EDS 117,A01,494379,Staff,0,2,30,30
1714372528161,EDS 125,A00,507246,Hopkins; Megan Beth,12,0,30,18
1714372529188,EDS 128A,A01,507264,Fargason; Sharon Gayle,14,0,26,12
1714372530215,EDS 128B,A01,507293,Pappas; Elizabeth,18,0,30,12
1714372531245,EDS 139,A00,507294,Fargason; Sharon Gayle,18,0,30,12
1714372531245,EDS 139,B00,507313,Pappas; Elizabeth,15,0,30,15
1714372532274,EDS 201,A00,507315,Staff,13,0,30,17
1714372533299,EDS 203,A01,507317,Halter; Christopher P.,12,0,30,18
1714372534325,EDS 204R,A01,507319,Halter; Christopher P.,0,3,30,30
1714372534325,EDS 204R,B01,507331,Heinzman; Erica M.,17,0,30,13
1714372535351,EDS 206R,A00,507332,Staff,0,4,30,30
1714372535351,EDS 206R,B00,507343,Staff,18,0,30,12
1714372536377,EDS 250,A00,507344,Hemans; Patricia Ann Benitez,22,0,40,18
1714372537403,EDS 281,A00,507345,Daly; Alan J.,18,0,18,0
1714372538429,EDS 284,A00,507350,Daly; Alan J.,16,0,16,0
1714372539453,EDS 286,A00,507359,Fine; Sarah,18,0,18,0
1714372540483,EDS 289C,A01,507361,Daly; Alan J.,18,0,18,0
1714372541508,EDS 290,A00,507366,Hofstetter; Carolyn,15,0,15,0
1714372542543,LIGM 5A,A00,507421,Fischer-Grunski; Eva K,18,0,20,2
1714372543572,LIGM 5B,A00,507423,Fischer-Grunski; Eva K,19,0,20,1
1714372544598,LIGM 5C,A00,507425,Fischer-Grunski; Eva K,19,0,20,1
1714372545630,LIIT 5AS,A00,507427,Carnelos; Chiara,20,0,20,0
1714372546660,LIIT 5BS,A00,507430,Carnelos; Chiara,20,0,20,0
1714372547686,LIIT 5CS,A00,507432,Carnelos; Chiara,20,0,20,0
1714372548717,LISP 5A,A00,507541,Munoz Sanchez; Alicia,11,0,20,9
1714372549743,LISP 5B,A00,507671,Munoz Sanchez; Alicia,9,0,20,11
1714372550768,LISP 5C,A00,507696,Munoz Sanchez; Alicia,9,0,20,11
1714372551802,MAE 197,001,528363,Boechler; Nicholas Sebastia,9998,0,9999,1
1714372552830,MATH 197,001,523477,Kedlaya; Kiran S.,9996,0,9999,3
1714372552830,MATH 197,002,563811,Zhang; Danna,9995,0,9999,4
1714372552830,MATH 197,003,628552,Dumitriu; Ioana,9998,0,9999,1
1714372553863,MCWP 40R,A00,518780,Staff,5,0,20,15
1714372553863,MCWP 40R,B00,518781,Staff,7,0,20,13
1714372553863,MCWP 40R,C00,518783,Staff,5,0,20,15
1714372554892,MCWP 50R,A00,518791,Staff,0,0,20,20
1714372554892,MCWP 50R,B00,518792,Staff,0,1,20,20
1714372554892,MCWP 50R,C00,518793,Staff,0,1,20,20
1714372554892,MCWP 50R,D00,518794,Staff,0,0,20,20
1714372554892,MCWP 50R,E00,518795,Staff,0,1,20,20
1714372554892,MCWP 50R,F00,518796,Staff,0,0,20,20
1714372554892,MCWP 50R,G00,518797,Staff,0,1,20,20
1714372555918,MMW 12R,A01,514034,Herbst; Matthew,0,1,16,16
1714372555918,MMW 12R,A02,514035,Herbst; Matthew,2,0,16,14
1714372556944,MMW 13R,A01,514037,Staff,0,4,16,16
1714372556944,MMW 13R,A02,514039,Staff,0,2,16,16
1714372556944,MMW 13R,A03,628519,Staff,0,2,16,16
1714372558999,SIO 295LS,A00,523233,Staff,12,0,30,18
1714372560024,SIO 295S,A00,523232,Staff,12,0,30,18
1714372561052,SIOC 290S,A01,637330,Merrifield; Mark A,27,0,30,3
1714372562081,SIOC 291S,A01,637333,Gabriel; Corey John,27,0,30,3
1714372563106,SOCI 117,A01,494376,Staff,0,3,5,5
1714372564135,WES 237B,A00,494380,Staff,9,0,20,11
1714372566194,AESE 279B,A00,494370,Wade; Jon P,0,0,33,33
1714372567220,AIP 197,001,627712,Vespa; Emanuel Ignacio,9998,0,9999,1
1714372568247,ANAR 135S,A00,494369,Braswell; Geoffrey E.,0,0,0,0
1714372569275,BENG 196,001,628496,Engler; Adam J.,9998,0,9999,1
1714372570301,CAT 124RS,A01,519847,Geibel; William,0,0,20,20
1714372571326,CAT 125RS,A01,515971,Geibel; William,0,0,20,20
1714372572354,CLRE 250,A00,511389,Morris; Sheldon,9993,0,9999,6
1714372573378,CLRE 251,A00,507176,Mehta; Ravindra L.,9993,0,9999,6
1714372573378,CLRE 251,B00,511410,Mehta; Ravindra L.,9998,0,9999,1
1714372574404,CLRE 252,A00,507189,Cuomo; Raphael Eduardo,9995,0,9999,4
1714372575432,CLRE 253,A00,507199,Vaida; Florin,9994,0,9999,5
1714372575432,CLRE 253,B00,507202,Vaida; Florin,9999,0,9999,0
1714372576458,CLRE 259,A00,507211,Patel; Hemal,9996,0,9999,3
1714372577483,CLRE 260,A00,507221,Cuomo; Raphael Eduardo,9999,0,9999,0
1714372578511,CLRE 297,001,507242,Cuomo; Raphael Eduardo,9999,0,9999,0
1714372579773,COGS 197,001,638244,Voytek; Bradley Thomas,9999,0,9999,0
1714372580798,CSE 191,A00,516875,Minnes Kemp; Mor Mia,9993,0,9999,6
1714372581824,CSE 197,001,637388,Minnes Kemp; Mor Mia,9998,0,9999,1
1714372582850,CSS 201S,A01,494383,Staff,35,0,35,0
1714372583883,CSS 202S,A01,494387,Staff,35,0,35,0
1714372584909,DSC 197,001,628532,Eldridge; Justin Matthew,9996,0,9999,3
1714372585936,EAP 100,A00,516065,Staff,9797,0,9999,202
1714372586962,ECE 45,A01,507414,Staff,33,0,60,27
1714372589069,ECE 111,A01,507420,Staff,19,0,50,31
1714372590104,ECE 197,001,548057,Sievenpiper; Daniel F.,9994,0,9999,5
1714372591128,EDS 115,A00,507243,Choi; Bailey Miyeon,12,0,28,16
1714372592153,EDS 117,A01,494379,Staff,0,2,30,30
1714372593178,EDS 125,A00,507246,Hopkins; Megan Beth,12,0,30,18
1714372594204,EDS 128A,A01,507264,Fargason; Sharon Gayle,14,0,26,12
1714372595230,EDS 128B,A01,507293,Pappas; Elizabeth,18,0,30,12
1714372596254,EDS 139,A00,507294,Fargason; Sharon Gayle,18,0,30,12
1714372596254,EDS 139,B00,507313,Pappas; Elizabeth,15,0,30,15
1714372597282,EDS 201,A00,507315,Staff,13,0,30,17
1714372598307,EDS 203,A01,507317,Halter; Christopher P.,12,0,30,18
1714372599333,EDS 204R,A01,507319,Halter; Christopher P.,0,3,30,30
1714372599333,EDS 204R,B01,507331,Heinzman; Erica M.,17,0,30,13
1714372600357,EDS 206R,A00,507332,Staff,0,4,30,30
1714372600357,EDS 206R,B00,507343,Staff,18,0,30,12
1714372601386,EDS 250,A00,507344,Hemans; Patricia Ann Benitez,22,0,40,18
1714372602410,EDS 281,A00,507345,Daly; Alan J.,18,0,18,0
1714372603434,EDS 284,A00,507350,Daly; Alan J.,16,0,16,0
1714372604460,EDS 286,A00,507359,Fine; Sarah,18,0,18,0
1714372605488,EDS 289C,A01,507361,Daly; Alan J.,18,0,18,0
1714372606519,EDS 290,A00,507366,Hofstetter; Carolyn,15,0,15,0
1714372607544,LIGM 5A,A00,507421,Fischer-Grunski; Eva K,18,0,20,2
1714372608579,LIGM 5B,A00,507423,Fischer-Grunski; Eva K,19,0,20,1
1714372609608,LIGM 5C,A00,507425,Fischer-Grunski; Eva K,19,0,20,1
1714372610635,LIIT 5AS,A00,507427,Carnelos; Chiara,20,0,20,0
1714372611665,LIIT 5BS,A00,507430,Carnelos; Chiara,20,0,20,0
1714372612690,LIIT 5CS,A00,507432,Carnelos; Chiara,20,0,20,0
1714372613716,LISP 5A,A00,507541,Munoz Sanchez; Alicia,11,0,20,9
1714372614742,LISP 5B,A00,507671,Munoz Sanchez; Alicia,9,0,20,11
1714372615767,LISP 5C,A00,507696,Munoz Sanchez; Alicia,9,0,20,11
1714372616792,MAE 197,001,528363,Boechler; Nicholas Sebastia,9998,0,9999,1
1714372617822,MATH 197,001,523477,Kedlaya; Kiran S.,9996,0,9999,3
1714372617822,MATH 197,002,563811,Zhang; Danna,9995,0,9999,4
1714372617822,MATH 197,003,628552,Dumitriu; Ioana,9998,0,9999,1
1714372618845,MCWP 40R,A00,518780,Staff,5,0,20,15
1714372618845,MCWP 40R,B00,518781,Staff,7,0,20,13
1714372618845,MCWP 40R,C00,518783,Staff,5,0,20,15
1714372619873,MCWP 50R,A00,518791,Staff,0,0,20,20
1714372619873,MCWP 50R,B00,518792,Staff,0,1,20,20
1714372619873,MCWP 50R,C00,518793,Staff,0,1,20,20
1714372619873,MCWP 50R,D00,518794,Staff,0,0,20,20
1714372619873,MCWP 50R,E00,518795,Staff,0,1,20,20
1714372619873,MCWP 50R,F00,518796,Staff,0,0,20,20
1714372619873,MCWP 50R,G00,518797,Staff,0,1,20,20
1714372620931,MMW 12R,A01,514034,Herbst; Matthew,0,1,16,16
1714372620931,MMW 12R,A02,514035,Herbst; Matthew,2,0,16,14
1714372621959,MMW 13R,A01,514037,Staff,0,4,16,16
1714372621959,MMW 13R,A02,514039,Staff,0,2,16,16
1714372621959,MMW 13R,A03,628519,Staff,0,2,16,16
1714372624016,SIO 295LS,A00,523233,Staff,12,0,30,18
1714372625041,SIO 295S,A00,523232,Staff,12,0,30,18
1714372626070,SIOC 290S,A01,637330,Merrifield; Mark A,27,0,30,3
1714372627098,SIOC 291S,A01,637333,Gabriel; Corey John,27,0,30,3
1714372628127,SOCI 117,A01,494376,Staff,0,3,5,5
1714372629152,WES 237B,A00,494380,Staff,9,0,20,11
1714372631233,AESE 279B,A00,494370,Wade; Jon P,0,0,33,33
1714372632261,AIP 197,001,627712,Vespa; Emanuel Ignacio,9998,0,9999,1
1714372633286,ANAR 135S,A00,494369,Braswell; Geoffrey E.,0,0,0,0
1714372634315,BENG 196,001,628496,Engler; Adam J.,9998,0,9999,1
1714372635340,CAT 124RS,A01,519847,Geibel; William,0,0,20,20
1714372636366,CAT 125RS,A01,515971,Geibel; William,0,0,20,20
1714372637395,CLRE 250,A00,511389,Morris; Sheldon,9993,0,9999,6
1714372638425,CLRE 251,A00,507176,Mehta; Ravindra L.,9993,0,9999,6
1714372638425,CLRE 251,B00,511410,Mehta; Ravindra L.,9998,0,9999,1
1714372639451,CLRE 252,A00,507189,Cuomo; Raphael Eduardo,9995,0,9999,4
1714372640476,CLRE 253,A00,507199,Vaida; Florin,9994,0,9999,5
1714372640476,CLRE 253,B00,507202,Vaida; Florin,9999,0,9999,0
1714372641504,CLRE 259,A00,507211,Patel; Hemal,9996,0,9999,3
1714372642531,CLRE 260,A00,507221,Cuomo; Raphael Eduardo,9999,0,9999,0
1714372643558,CLRE 297,001,507242,Cuomo; Raphael Eduardo,9999,0,9999,0
1714372644586,COGS 197,001,638244,Voytek; Bradley Thomas,9999,0,9999,0
1714372645612,CSE 191,A00,516875,Minnes Kemp; Mor Mia,9993,0,9999,6
1714372646637,CSE 197,001,637388,Minnes Kemp; Mor Mia,9998,0,9999,1
1714372647662,CSS 201S,A01,494383,Staff,35,0,35,0
1714372648692,CSS 202S,A01,494387,Staff,35,0,35,0
1714372649717,DSC 197,001,628532,Eldridge; Justin Matthew,9996,0,9999,3
1714372650744,EAP 100,A00,516065,Staff,9797,0,9999,202
1714372651772,ECE 45,A01,507414,Staff,33,0,60,27
1714372653825,ECE 111,A01,507420,Staff,19,0,50,31
1714372654853,ECE 197,001,548057,Sievenpiper; Daniel F.,9994,0,9999,5
1714372655879,EDS 115,A00,507243,Choi; Bailey Miyeon,12,0,28,16
1714372656908,EDS 117,A01,494379,Staff,0,2,30,30
1714372657933,EDS 125,A00,507246,Hopkins; Megan Beth,12,0,30,18
1714372658960,EDS 128A,A01,507264,Fargason; Sharon Gayle,14,0,26,12
1714372659989,EDS 128B,A01,507293,Pappas; Elizabeth,18,0,30,12
1714372661016,EDS 139,A00,507294,Fargason; Sharon Gayle,18,0,30,12
1714372661016,EDS 139,B00,507313,Pappas; Elizabeth,15,0,30,15
1714372662044,EDS 201,A00,507315,Staff,13,0,30,17
1714372663069,EDS 203,A01,507317,Halter; Christopher P.,12,0,30,18
1714372664093,EDS 204R,A01,507319,Halter; Christopher P.,0,3,30,30
1714372664093,EDS 204R,B01,507331,Heinzman; Erica M.,17,0,30,13
1714372665121,EDS 206R,A00,507332,Staff,0,4,30,30
1714372665121,EDS 206R,B00,507343,Staff,18,0,30,12
1714372666146,EDS 250,A00,507344,Hemans; Patricia Ann Benitez,22,0,40,18
1714372667172,EDS 281,A00,507345,Daly; Alan J.,18,0,18,0
1714372668197,EDS 284,A00,507350,Daly; Alan J.,16,0,16,0
1714372669226,EDS 286,A00,507359,Fine; Sarah,18,0,18,0
1714372670251,EDS 289C,A01,507361,Daly; Alan J.,18,0,18,0
1714372671276,EDS 290,A00,507366,Hofstetter; Carolyn,15,0,15,0
1714372672302,LIGM 5A,A00,507421,Fischer-Grunski; Eva K,18,0,20,2
1714372673332,LIGM 5B,A00,507423,Fischer-Grunski; Eva K,19,0,20,1
1714372674358,LIGM 5C,A00,507425,Fischer-Grunski; Eva K,19,0,20,1
1714372675384,LIIT 5AS,A00,507427,Carnelos; Chiara,20,0,20,0
1714372676410,LIIT 5BS,A00,507430,Carnelos; Chiara,20,0,20,0
1714372677434,LIIT 5CS,A00,507432,Carnelos; Chiara,20,0,20,0
1714372678460,LISP 5A,A00,507541,Munoz Sanchez; Alicia,11,0,20,9
1714372679486,LISP 5B,A00,507671,Munoz Sanchez; Alicia,9,0,20,11
1714372680511,LISP 5C,A00,507696,Munoz Sanchez; Alicia,9,0,20,11
1714372681537,MAE 197,001,528363,Boechler; Nicholas Sebastia,9998,0,9999,1
1714372682564,MATH 197,001,523477,Kedlaya; Kiran S.,9996,0,9999,3
1714372682564,MATH 197,002,563811,Zhang; Danna,9995,0,9999,4
1714372682564,MATH 197,003,628552,Dumitriu; Ioana,9998,0,9999,1
1714372683589,MCWP 40R,A00,518780,Staff,5,0,20,15
1714372683589,MCWP 40R,B00,518781,Staff,7,0,20,13
1714372683589,MCWP 40R,C00,518783,Staff,5,0,20,15
1714372684614,MCWP 50R,A00,518791,Staff,0,0,20,20
1714372684614,MCWP 50R,B00,518792,Staff,0,1,20,20
1714372684614,MCWP 50R,C00,518793,Staff,0,1,20,20
1714372684614,MCWP 50R,D00,518794,Staff,0,0,20,20
1714372684614,MCWP 50R,E00,518795,Staff,0,1,20,20
1714372684614,MCWP 50R,F00,518796,Staff,0,0,20,20
1714372684614,MCWP 50R,G00,518797,Staff,0,1,20,20
1714372685639,MMW 12R,A01,514034,Herbst; Matthew,0,1,16,16
1714372685639,MMW 12R,A02,514035,Herbst; Matthew,2,0,16,14
1714372686667,MMW 13R,A01,514037,Staff,0,4,16,16
1714372686667,MMW 13R,A02,514039,Staff,0,2,16,16
1714372686667,MMW 13R,A03,628519,Staff,0,2,16,16
1714372688718,SIO 295LS,A00,523233,Staff,12,0,30,18
1714372689747,SIO 295S,A00,523232,Staff,12,0,30,18
1714372690778,SIOC 290S,A01,637330,Merrifield; Mark A,27,0,30,3
1714372691858,SIOC 291S,A01,637333,Gabriel; Corey John,27,0,30,3
1714372692887,SOCI 117,A01,494376,Staff,0,3,5,5
1714372693913,WES 237B,A00,494380,Staff,9,0,20,11
1714372695978,AESE 279B,A00,494370,Wade; Jon P,0,0,33,33
1714372697002,AIP 197,001,627712,Vespa; Emanuel Ignacio,9998,0,9999,1
1714372698030,ANAR 135S,A00,494369,Braswell; Geoffrey E.,0,0,0,0
1714372699054,BENG 196,001,628496,Engler; Adam J.,9998,0,9999,1
1714372700079,CAT 124RS,A01,519847,Geibel; William,0,0,20,20
1714372701106,CAT 125RS,A01,515971,Geibel; William,0,0,20,20
1714372702134,CLRE 250,A00,511389,Morris; Sheldon,9993,0,9999,6
1714372703161,CLRE 251,A00,507176,Mehta; Ravindra L.,9993,0,9999,6
1714372703161,CLRE 251,B00,511410,Mehta; Ravindra L.,9998,0,9999,1
1714372704186,CLRE 252,A00,507189,Cuomo; Raphael Eduardo,9995,0,9999,4
1714372705215,CLRE 253,A00,507199,Vaida; Florin,9994,0,9999,5
1714372705215,CLRE 253,B00,507202,Vaida; Florin,9999,0,9999,0
1714372706239,CLRE 259,A00,507211,Patel; Hemal,9996,0,9999,3
1714372707267,CLRE 260,A00,507221,Cuomo; Raphael Eduardo,9999,0,9999,0
1714372708295,CLRE 297,001,507242,Cuomo; Raphael Eduardo,9999,0,9999,0
1714372709319,COGS 197,001,638244,Voytek; Bradley Thomas,9999,0,9999,0
1714372710347,CSE 191,A00,516875,Minnes Kemp; Mor Mia,9993,0,9999,6
1714372711372,CSE 197,001,637388,Minnes Kemp; Mor Mia,9998,0,9999,1
1714372712399,CSS 201S,A01,494383,Staff,35,0,35,0
1714372713429,CSS 202S,A01,494387,Staff,35,0,35,0
1714372714455,DSC 197,001,628532,Eldridge; Justin Matthew,9996,0,9999,3
1714372715478,EAP 100,A00,516065,Staff,9797,0,9999,202
1714372716504,ECE 45,A01,507414,Staff,33,0,60,27
1714372718554,ECE 111,A01,507420,Staff,19,0,50,31
1714372719578,ECE 197,001,548057,Sievenpiper; Daniel F.,9994,0,9999,5
1714372720603,EDS 115,A00,507243,Choi; Bailey Miyeon,12,0,28,16
1714372721631,EDS 117,A01,494379,Staff,0,2,30,30
1714372722655,EDS 125,A00,507246,Hopkins; Megan Beth,12,0,30,18
1714372723680,EDS 128A,A01,507264,Fargason; Sharon Gayle,14,0,26,12
1714372724705,EDS 128B,A01,507293,Pappas; Elizabeth,18,0,30,12
1714372725730,EDS 139,A00,507294,Fargason; Sharon Gayle,18,0,30,12
1714372725730,EDS 139,B00,507313,Pappas; Elizabeth,15,0,30,15
1714372726757,EDS 201,A00,507315,Staff,13,0,30,17
1714372727782,EDS 203,A01,507317,Halter; Christopher P.,12,0,30,18
1714372728806,EDS 204R,A01,507319,Halter; Christopher P.,0,3,30,30
1714372728806,EDS 204R,B01,507331,Heinzman; Erica M.,17,0,30,13
1714372729832,EDS 206R,A00,507332,Staff,0,4,30,30
1714372729832,EDS 206R,B00,507343,Staff,18,0,30,12
1714372730859,EDS 250,A00,507344,Hemans; Patricia Ann Benitez,22,0,40,18
1714372731888,EDS 281,A00,507345,Daly; Alan J.,18,0,18,0
1714372732912,EDS 284,A00,507350,Daly; Alan J.,16,0,16,0
1714372733939,EDS 286,A00,507359,Fine; Sarah,18,0,18,0
1714372734965,EDS 289C,A01,507361,Daly; Alan J.,18,0,18,0
1714372735994,EDS 290,A00,507366,Hofstetter; Carolyn,15,0,15,0
1714372737020,LIGM 5A,A00,507421,Fischer-Grunski; Eva K,18,0,20,2
1714372738047,LIGM 5B,A00,507423,Fischer-Grunski; Eva K,19,0,20,1
1714372739076,LIGM 5C,A00,507425,Fischer-Grunski; Eva K,19,0,20,1
1714372740101,LIIT 5AS,A00,507427,Carnelos; Chiara,20,0,20,0
1714372741126,LIIT 5BS,A00,507430,Carnelos; Chiara,20,0,20,0
1714372742152,LIIT 5CS,A00,507432,Carnelos; Chiara,20,0,20,0
1714372743182,LISP 5A,A00,507541,Munoz Sanchez; Alicia,11,0,20,9
1714372744208,LISP 5B,A00,507671,Munoz Sanchez; Alicia,9,0,20,11
1714372745233,LISP 5C,A00,507696,Munoz Sanchez; Alicia,9,0,20,11
1714372746258,MAE 197,001,528363,Boechler; Nicholas Sebastia,9998,0,9999,1
1714372747288,MATH 197,001,523477,Kedlaya; Kiran S.,9996,0,9999,3
1714372747288,MATH 197,002,563811,Zhang; Danna,9995,0,9999,4
1714372747288,MATH 197,003,628552,Dumitriu; Ioana,9998,0,9999,1
1714372748318,MCWP 40R,A00,518780,Staff,5,0,20,15
1714372748318,MCWP 40R,B00,518781,Staff,7,0,20,13
1714372748318,MCWP 40R,C00,518783,Staff,5,0,20,15
1714372749343,MCWP 50R,A00,518791,Staff,0,0,20,20
1714372749343,MCWP 50R,B00,518792,Staff,0,1,20,20
1714372749343,MCWP 50R,C00,518793,Staff,0,1,20,20
1714372749343,MCWP 50R,D00,518794,Staff,0,0,20,20
1714372749343,MCWP 50R,E00,518795,Staff,0,1,20,20
1714372749343,MCWP 50R,F00,518796,Staff,0,0,20,20
1714372749343,MCWP 50R,G00,518797,Staff,0,1,20,20
1714372750370,MMW 12R,A01,514034,Herbst; Matthew,0,1,16,16
1714372750370,MMW 12R,A02,514035,Herbst; Matthew,2,0,16,14
1714372751399,MMW 13R,A01,514037,Staff,0,4,16,16
1714372751399,MMW 13R,A02,514039,Staff,0,2,16,16
1714372751399,MMW 13R,A03,628519,Staff,0,2,16,16
1714372753452,SIO 295LS,A00,523233,Staff,12,0,30,18
1714372754480,SIO 295S,A00,523232,Staff,12,0,30,18
1714372755513,SIOC 290S,A01,637330,Merrifield; Mark A,27,0,30,3
1714372756540,SIOC 291S,A01,637333,Gabriel; Corey John,27,0,30,3
1714372757564,SOCI 117,A01,494376,Staff,0,3,5,5
1714372758592,WES 237B,A00,494380,Staff,9,0,20,11
1714372760660,AESE 279B,A00,494370,Wade; Jon P,0,0,33,33
1714372761688,AIP 197,001,627712,Vespa; Emanuel Ignacio,9998,0,9999,1
1714372762710,ANAR 135S,A00,494369,Braswell; Geoffrey E.,0,0,0,0
1714372763737,BENG 196,001,628496,Engler; Adam J.,9998,0,9999,1
1714372764762,CAT 124RS,A01,519847,Geibel; William,0,0,20,20
1714372765791,CAT 125RS,A01,515971,Geibel; William,0,0,20,20
1714372766816,CLRE 250,A00,511389,Morris; Sheldon,9993,0,9999,6
1714372767842,CLRE 251,A00,507176,Mehta; Ravindra L.,9993,0,9999,6
1714372767842,CLRE 251,B00,511410,Mehta; Ravindra L.,9998,0,9999,1
1714372768868,CLRE 252,A00,507189,Cuomo; Raphael Eduardo,9995,0,9999,4
1714372769899,CLRE 253,A00,507199,Vaida; Florin,9994,0,9999,5
1714372769899,CLRE 253,B00,507202,Vaida; Florin,9999,0,9999,0
1714372770926,CLRE 259,A00,507211,Patel; Hemal,9996,0,9999,3
1714372771951,CLRE 260,A00,507221,Cuomo; Raphael Eduardo,9999,0,9999,0
1714372772974,CLRE 297,001,507242,Cuomo; Raphael Eduardo,9999,0,9999,0
1714372774002,COGS 197,001,638244,Voytek; Bradley Thomas,9999,0,9999,0
1714372775026,CSE 191,A00,516875,Minnes Kemp; Mor Mia,9993,0,9999,6
1714372776052,CSE 197,001,637388,Minnes Kemp; Mor Mia,9998,0,9999,1
1714372777081,CSS 201S,A01,494383,Staff,35,0,35,0
1714372778109,CSS 202S,A01,494387,Staff,35,0,35,0
1714372779134,DSC 197,001,628532,Eldridge; Justin Matthew,9996,0,9999,3
1714372780159,EAP 100,A00,516065,Staff,9797,0,9999,202
1714372781184,ECE 45,A01,507414,Staff,33,0,60,27
1714372783233,ECE 111,A01,507420,Staff,19,0,50,31
1714372784258,ECE 197,001,548057,Sievenpiper; Daniel F.,9994,0,9999,5
1714372785285,EDS 115,A00,507243,Choi; Bailey Miyeon,12,0,28,16
1714372786310,EDS 117,A01,494379,Staff,0,2,30,30
1714372787334,EDS 125,A00,507246,Hopkins; Megan Beth,12,0,30,18
1714372788363,EDS 128A,A01,507264,Fargason; Sharon Gayle,14,0,26,12
1714372789391,EDS 128B,A01,507293,Pappas; Elizabeth,18,0,30,12
1714372790421,EDS 139,A00,507294,Fargason; Sharon Gayle,18,0,30,12
1714372790421,EDS 139,B00,507313,Pappas; Elizabeth,15,0,30,15
1714372791447,EDS 201,A00,507315,Staff,13,0,30,17
1714372792472,EDS 203,A01,507317,Halter; Christopher P.,12,0,30,18
1714372793497,EDS 204R,A01,507319,Halter; Christopher P.,0,3,30,30
1714372793497,EDS 204R,B01,507331,Heinzman; Erica M.,17,0,30,13
1714372794527,EDS 206R,A00,507332,Staff,0,4,30,30
1714372794527,EDS 206R,B00,507343,Staff,18,0,30,12
1714372795609,EDS 250,A00,507344,Hemans; Patricia Ann Benitez,22,0,40,18
1714372796634,EDS 281,A00,507345,Daly; Alan J.,18,0,18,0
1714372797661,EDS 284,A00,507350,Daly; Alan J.,16,0,16,0
1714372798690,EDS 286,A00,507359,Fine; Sarah,18,0,18,0
1714372799717,EDS 289C,A01,507361,Daly; Alan J.,18,0,18,0
1714372800772,EDS 290,A00,507366,Hofstetter; Carolyn,15,0,15,0
1714372801803,LIGM 5A,A00,507421,Fischer-Grunski; Eva K,18,0,20,2
1714372802836,LIGM 5B,A00,507423,Fischer-Grunski; Eva K,19,0,20,1
1714372803866,LIGM 5C,A00,507425,Fischer-Grunski; Eva K,19,0,20,1
1714372804892,LIIT 5AS,A00,507427,Carnelos; Chiara,20,0,20,0
1714372805920,LIIT 5BS,A00,507430,Carnelos; Chiara,20,0,20,0
1714372806947,LIIT 5CS,A00,507432,Carnelos; Chiara,20,0,20,0
1714372807980,LISP 5A,A00,507541,Munoz Sanchez; Alicia,11,0,20,9
1714372809005,LISP 5B,A00,507671,Munoz Sanchez; Alicia,9,0,20,11
1714372810032,LISP 5C,A00,507696,Munoz Sanchez; Alicia,9,0,20,11
1714372811060,MAE 197,001,528363,Boechler; Nicholas Sebastia,9998,0,9999,1
1714372812089,MATH 197,001,523477,Kedlaya; Kiran S.,9996,0,9999,3
1714372812089,MATH 197,002,563811,Zhang; Danna,9995,0,9999,4
1714372812089,MATH 197,003,628552,Dumitriu; Ioana,9998,0,9999,1
1714372813118,MCWP 40R,A00,518780,Staff,5,0,20,15
1714372813118,MCWP 40R,B00,518781,Staff,7,0,20,13
1714372813118,MCWP 40R,C00,518783,Staff,5,0,20,15
1714372814142,MCWP 50R,A00,518791,Staff,0,0,20,20
1714372814142,MCWP 50R,B00,518792,Staff,0,1,20,20
1714372814142,MCWP 50R,C00,518793,Staff,0,1,20,20
1714372814142,MCWP 50R,D00,518794,Staff,0,0,20,20
1714372814142,MCWP 50R,E00,518795,Staff,0,1,20,20
1714372814142,MCWP 50R,F00,518796,Staff,0,0,20,20
1714372814142,MCWP 50R,G00,518797,Staff,0,1,20,20
1714372815172,MMW 12R,A01,514034,Herbst; Matthew,0,1,16,16
1714372815172,MMW 12R,A02,514035,Herbst; Matthew,2,0,16,14
1714372816198,MMW 13R,A01,514037,Staff,0,4,16,16
1714372816198,MMW 13R,A02,514039,Staff,0,2,16,16
1714372816198,MMW 13R,A03,628519,Staff,0,2,16,16
1714372818254,SIO 295LS,A00,523233,Staff,12,0,30,18
1714372819279,SIO 295S,A00,523232,Staff,12,0,30,18
1714372820305,SIOC 290S,A01,637330,Merrifield; Mark A,27,0,30,3
1714372821343,SIOC 291S,A01,637333,Gabriel; Corey John,27,0,30,3
1714372822368,SOCI 117,A01,494376,Staff,0,3,5,5
1714372823395,WES 237B,A00,494380,Staff,9,0,20,11
1714372825461,AESE 279B,A00,494370,Wade; Jon P,0,0,33,33
1714372826487,AIP 197,001,627712,Vespa; Emanuel Ignacio,9998,0,9999,1
1714372827516,ANAR 135S,A00,494369,Braswell; Geoffrey E.,0,0,0,0
1714372828542,BENG 196,001,628496,Engler; Adam J.,9998,0,9999,1
1714372829569,CAT 124RS,A01,519847,Geibel; William,0,0,20,20
1714372830596,CAT 125RS,A01,515971,Geibel; William,0,0,20,20
1714372831622,CLRE 250,A00,511389,Morris; Sheldon,9993,0,9999,6
1714372832652,CLRE 251,A00,507176,Mehta; Ravindra L.,9993,0,9999,6
1714372832652,CLRE 251,B00,511410,Mehta; Ravindra L.,9998,0,9999,1
1714372833677,CLRE 252,A00,507189,Cuomo; Raphael Eduardo,9995,0,9999,4
1714372834701,CLRE 253,A00,507199,Vaida; Florin,9994,0,9999,5
1714372834701,CLRE 253,B00,507202,Vaida; Florin,9999,0,9999,0
1714372835726,CLRE 259,A00,507211,Patel; Hemal,9996,0,9999,3
1714372836750,CLRE 260,A00,507221,Cuomo; Raphael Eduardo,9999,0,9999,0
1714372837776,CLRE 297,001,507242,Cuomo; Raphael Eduardo,9999,0,9999,0
1714372838802,COGS 197,001,638244,Voytek; Bradley Thomas,9999,0,9999,0
1714372839828,CSE 191,A00,516875,Minnes Kemp; Mor Mia,9993,0,9999,6
1714372840857,CSE 197,001,637388,Minnes Kemp; Mor Mia,9998,0,9999,1
1714372841884,CSS 201S,A01,494383,Staff,35,0,35,0
1714372842909,CSS 202S,A01,494387,Staff,35,0,35,0
1714372843935,DSC 197,001,628532,Eldridge; Justin Matthew,9996,0,9999,3
1714372844959,EAP 100,A00,516065,Staff,9797,0,9999,202
1714372845982,ECE 45,A01,507414,Staff,33,0,60,27
1714372848038,ECE 111,A01,507420,Staff,19,0,50,31
1714372849066,ECE 197,001,548057,Sievenpiper; Daniel F.,9994,0,9999,5
1714372850096,EDS 115,A00,507243,Choi; Bailey Miyeon,12,0,28,16
1714372851121,EDS 117,A01,494379,Staff,0,2,30,30
1714372852150,EDS 125,A00,507246,Hopkins; Megan Beth,12,0,30,18
1714372853176,EDS 128A,A01,507264,Fargason; Sharon Gayle,14,0,26,12
1714372854200,EDS 128B,A01,507293,Pappas; Elizabeth,18,0,30,12
1714372855231,EDS 139,A00,507294,Fargason; Sharon Gayle,18,0,30,12
1714372855231,EDS 139,B00,507313,Pappas; Elizabeth,15,0,30,15
1714372856255,EDS 201,A00,507315,Staff,13,0,30,17
1714372857282,EDS 203,A01,507317,Halter; Christopher P.,12,0,30,18
1714372858307,EDS 204R,A01,507319,Halter; Christopher P.,0,3,30,30
1714372858307,EDS 204R,B01,507331,Heinzman; Erica M.,17,0,30,13
1714372859335,EDS 206R,A00,507332,Staff,0,4,30,30
1714372859335,EDS 206R,B00,507343,Staff,18,0,30,12
1714372860363,EDS 250,A00,507344,Hemans; Patricia Ann Benitez,22,0,40,18
1714372861388,EDS 281,A00,507345,Daly; Alan J.,18,0,18,0
1714372862415,EDS 284,A00,507350,Daly; Alan J.,16,0,16,0
1714372863441,EDS 286,A00,507359,Fine; Sarah,18,0,18,0
1714372864466,EDS 289C,A01,507361,Daly; Alan J.,18,0,18,0
1714372865495,EDS 290,A00,507366,Hofstetter; Carolyn,15,0,15,0
1714372866525,LIGM 5A,A00,507421,Fischer-Grunski; Eva K,18,0,20,2
1714372867549,LIGM 5B,A00,507423,Fischer-Grunski; Eva K,19,0,20,1
1714372868579,LIGM 5C,A00,507425,Fischer-Grunski; Eva K,19,0,20,1
1714372869606,LIIT 5AS,A00,507427,Carnelos; Chiara,20,0,20,0
1714372870630,LIIT 5BS,A00,507430,Carnelos; Chiara,20,0,20,0
1714372871657,LIIT 5CS,A00,507432,Carnelos; Chiara,20,0,20,0
1714372872683,LISP 5A,A00,507541,Munoz Sanchez; Alicia,11,0,20,9
1714372873710,LISP 5B,A00,507671,Munoz Sanchez; Alicia,9,0,20,11
1714372874734,LISP 5C,A00,507696,Munoz Sanchez; Alicia,9,0,20,11
1714372875758,MAE 197,001,528363,Boechler; Nicholas Sebastia,9998,0,9999,1
1714372876785,MATH 197,001,523477,Kedlaya; Kiran S.,9996,0,9999,3
1714372876785,MATH 197,002,563811,Zhang; Danna,9995,0,9999,4
1714372876785,MATH 197,003,628552,Dumitriu; Ioana,9998,0,9999,1
1714372877810,MCWP 40R,A00,518780,Staff,5,0,20,15
1714372877810,MCWP 40R,B00,518781,Staff,7,0,20,13
1714372877810,MCWP 40R,C00,518783,Staff,5,0,20,15
1714372878835,MCWP 50R,A00,518791,Staff,0,0,20,20
1714372878835,MCWP 50R,B00,518792,Staff,0,1,20,20
1714372878835,MCWP 50R,C00,518793,Staff,0,1,20,20
1714372878835,MCWP 50R,D00,518794,Staff,0,0,20,20
1714372878835,MCWP 50R,E00,518795,Staff,0,1,20,20
1714372878835,MCWP 50R,F00,518796,Staff,0,0,20,20
1714372878835,MCWP 50R,G00,518797,Staff,0,1,20,20
1714372879859,MMW 12R,A01,514034,Herbst; Matthew,0,1,16,16
1714372879859,MMW 12R,A02,514035,Herbst; Matthew,2,0,16,14
1714372880887,MMW 13R,A01,514037,Staff,0,4,16,16
1714372880887,MMW 13R,A02,514039,Staff,0,2,16,16
1714372880887,MMW 13R,A03,628519,Staff,0,2,16,16
1714372882940,SIO 295LS,A00,523233,Staff,12,0,30,18
1714372883969,SIO 295S,A00,523232,Staff,12,0,30,18
1714372884995,SIOC 290S,A01,637330,Merrifield; Mark A,27,0,30,3
1714372886023,SIOC 291S,A01,637333,Gabriel; Corey John,27,0,30,3
1714372887048,SOCI 117,A01,494376,Staff,0,3,5,5
1714372888073,WES 237B,A00,494380,Staff,9,0,20,11
1714372890146,AESE 279B,A00,494370,Wade; Jon P,0,0,33,33
1714372891168,AIP 197,001,627712,Vespa; Emanuel Ignacio,9998,0,9999,1
1714372892193,ANAR 135S,A00,494369,Braswell; Geoffrey E.,0,0,0,0
1714372893217,BENG 196,001,628496,Engler; Adam J.,9998,0,9999,1
1714372894244,CAT 124RS,A01,519847,Geibel; William,0,0,20,20
1714372895273,CAT 125RS,A01,515971,Geibel; William,0,0,20,20
1714372896298,CLRE 250,A00,511389,Morris; Sheldon,9993,0,9999,6
1714372897328,CLRE 251,A00,507176,Mehta; Ravindra L.,9993,0,9999,6
1714372897328,CLRE 251,B00,511410,Mehta; Ravindra L.,9998,0,9999,1
1714372898352,CLRE 252,A00,507189,Cuomo; Raphael Eduardo,9995,0,9999,4
1714372899431,CLRE 253,A00,507199,Vaida; Florin,9994,0,9999,5
1714372899431,CLRE 253,B00,507202,Vaida; Florin,9999,0,9999,0
1714372900456,CLRE 259,A00,507211,Patel; Hemal,9996,0,9999,3
1714372901482,CLRE 260,A00,507221,Cuomo; Raphael Eduardo,9999,0,9999,0
1714372902507,CLRE 297,001,507242,Cuomo; Raphael Eduardo,9999,0,9999,0
1714372903537,COGS 197,001,638244,Voytek; Bradley Thomas,9999,0,9999,0
1714372904563,CSE 191,A00,516875,Minnes Kemp; Mor Mia,9993,0,9999,6
1714372905586,CSE 197,001,637388,Minnes Kemp; Mor Mia,9998,0,9999,1
1714372906612,CSS 201S,A01,494383,Staff,35,0,35,0
1714372907640,CSS 202S,A01,494387,Staff,35,0,35,0
1714372908668,DSC 197,001,628532,Eldridge; Justin Matthew,9996,0,9999,3
1714372909695,EAP 100,A00,516065,Staff,9797,0,9999,202
1714372910722,ECE 45,A01,507414,Staff,33,0,60,27
1714372912773,ECE 111,A01,507420,Staff,19,0,50,31
1714372913800,ECE 197,001,548057,Sievenpiper; Daniel F.,9994,0,9999,5
1714372914826,EDS 115,A00,507243,Choi; Bailey Miyeon,12,0,28,16
1714372915854,EDS 117,A01,494379,Staff,0,2,30,30
1714372916882,EDS 125,A00,507246,Hopkins; Megan Beth,12,0,30,18
1714372917907,EDS 128A,A01,507264,Fargason; Sharon Gayle,14,0,26,12
1714372918940,EDS 128B,A01,507293,Pappas; Elizabeth,18,0,30,12
1714372919967,EDS 139,A00,507294,Fargason; Sharon Gayle,18,0,30,12
1714372919967,EDS 139,B00,507313,Pappas; Elizabeth,15,0,30,15
1714372920992,EDS 201,A00,507315,Staff,13,0,30,17
1714372922018,EDS 203,A01,507317,Halter; Christopher P.,12,0,30,18
1714372923045,EDS 204R,A01,507319,Halter; Christopher P.,0,3,30,30
1714372923045,EDS 204R,B01,507331,Heinzman; Erica M.,17,0,30,13
1714372924074,EDS 206R,A00,507332,Staff,0,4,30,30
1714372924074,EDS 206R,B00,507343,Staff,18,0,30,12
1714372925100,EDS 250,A00,507344,Hemans; Patricia Ann Benitez,22,0,40,18
1714372926127,EDS 281,A00,507345,Daly; Alan J.,18,0,18,0
1714372927155,EDS 284,A00,507350,Daly; Alan J.,16,0,16,0
1714372928180,EDS 286,A00,507359,Fine; Sarah,18,0,18,0
1714372929203,EDS 289C,A01,507361,Daly; Alan J.,18,0,18,0
1714372930229,EDS 290,A00,507366,Hofstetter; Carolyn,15,0,15,0
1714372931255,LIGM 5A,A00,507421,Fischer-Grunski; Eva K,18,0,20,2
1714372932281,LIGM 5B,A00,507423,Fischer-Grunski; Eva K,19,0,20,1
1714372933307,LIGM 5C,A00,507425,Fischer-Grunski; Eva K,19,0,20,1
1714372934334,LIIT 5AS,A00,507427,Carnelos; Chiara,20,0,20,0
1714372935359,LIIT 5BS,A00,507430,Carnelos; Chiara,20,0,20,0
1714372936383,LIIT 5CS,A00,507432,Carnelos; Chiara,20,0,20,0
1714372937408,LISP 5A,A00,507541,Munoz Sanchez; Alicia,11,0,20,9
1714372938433,LISP 5B,A00,507671,Munoz Sanchez; Alicia,9,0,20,11
1714372939459,LISP 5C,A00,507696,Munoz Sanchez; Alicia,9,0,20,11
1714372940484,MAE 197,001,528363,Boechler; Nicholas Sebastia,9998,0,9999,1
1714372941512,MATH 197,001,523477,Kedlaya; Kiran S.,9996,0,9999,3
1714372941512,MATH 197,002,563811,Zhang; Danna,9995,0,9999,4
1714372941512,MATH 197,003,628552,Dumitriu; Ioana,9998,0,9999,1
1714372942540,MCWP 40R,A00,518780,Staff,5,0,20,15
1714372942540,MCWP 40R,B00,518781,Staff,7,0,20,13
1714372942540,MCWP 40R,C00,518783,Staff,5,0,20,15
1714372943565,MCWP 50R,A00,518791,Staff,0,0,20,20
1714372943565,MCWP 50R,B00,518792,Staff,0,1,20,20
1714372943565,MCWP 50R,C00,518793,Staff,0,1,20,20
1714372943565,MCWP 50R,D00,518794,Staff,0,0,20,20
1714372943565,MCWP 50R,E00,518795,Staff,0,1,20,20
1714372943565,MCWP 50R,F00,518796,Staff,0,0,20,20
1714372943565,MCWP 50R,G00,518797,Staff,0,1,20,20
1714372944591,MMW 12R,A01,514034,Herbst; Matthew,0,1,16,16
1714372944591,MMW 12R,A02,514035,Herbst; Matthew,2,0,16,14
1714372945616,MMW 13R,A01,514037,Staff,0,4,16,16
1714372945616,MMW 13R,A02,514039,Staff,0,2,16,16
1714372945616,MMW 13R,A03,628519,Staff,0,2,16,16
1714372947682,SIO 295LS,A00,523233,Staff,12,0,30,18
1714372948706,SIO 295S,A00,523232,Staff,12,0,30,18
1714372949732,SIOC 290S,A01,637330,Merrifield; Mark A,27,0,30,3
1714372950757,SIOC 291S,A01,637333,Gabriel; Corey John,27,0,30,3
1714372951782,SOCI 117,A01,494376,Staff,0,3,5,5
1714372952807,WES 237B,A00,494380,Staff,9,0,20,11
1714372954868,AESE 279B,A00,494370,Wade; Jon P,0,0,33,33
1714372955894,AIP 197,001,627712,Vespa; Emanuel Ignacio,9998,0,9999,1
1714372956919,ANAR 135S,A00,494369,Braswell; Geoffrey E.,0,0,0,0
1714372957946,BENG 196,001,628496,Engler; Adam J.,9998,0,9999,1
1714372958971,CAT 124RS,A01,519847,Geibel; William,0,0,20,20
1714372959999,CAT 125RS,A01,515971,Geibel; William,0,0,20,20
1714372961026,CLRE 250,A00,511389,Morris; Sheldon,9993,0,9999,6
1714372962051,CLRE 251,A00,507176,Mehta; Ravindra L.,9993,0,9999,6
1714372962051,CLRE 251,B00,511410,Mehta; Ravindra L.,9998,0,9999,1
1714372963082,CLRE 252,A00,507189,Cuomo; Raphael Eduardo,9995,0,9999,4
1714372964109,CLRE 253,A00,507199,Vaida; Florin,9994,0,9999,5
1714372964109,CLRE 253,B00,507202,Vaida; Florin,9999,0,9999,0
1714372965133,CLRE 259,A00,507211,Patel; Hemal,9996,0,9999,3
1714372966160,CLRE 260,A00,507221,Cuomo; Raphael Eduardo,9999,0,9999,0
1714372967186,CLRE 297,001,507242,Cuomo; Raphael Eduardo,9999,0,9999,0
1714372968212,COGS 197,001,638244,Voytek; Bradley Thomas,9999,0,9999,0
1714372969239,CSE 191,A00,516875,Minnes Kemp; Mor Mia,9993,0,9999,6
1714372970265,CSE 197,001,637388,Minnes Kemp; Mor Mia,9998,0,9999,1
1714372971291,CSS 201S,A01,494383,Staff,35,0,35,0
1714372972319,CSS 202S,A01,494387,Staff,35,0,35,0
1714372973346,DSC 197,001,628532,Eldridge; Justin Matthew,9996,0,9999,3
1714372974372,EAP 100,A00,516065,Staff,9797,0,9999,202
1714372975401,ECE 45,A01,507414,Staff,33,0,60,27
1714372977457,ECE 111,A01,507420,Staff,19,0,50,31
1714372978485,ECE 197,001,548057,Sievenpiper; Daniel F.,9994,0,9999,5
1714372979510,EDS 115,A00,507243,Choi; Bailey Miyeon,12,0,28,16
1714372980535,EDS 117,A01,494379,Staff,0,2,30,30
1714372981564,EDS 125,A00,507246,Hopkins; Megan Beth,12,0,30,18
1714372982595,EDS 128A,A01,507264,Fargason; Sharon Gayle,14,0,26,12
1714372983618,EDS 128B,A01,507293,Pappas; Elizabeth,18,0,30,12
1714372984643,EDS 139,A00,507294,Fargason; Sharon Gayle,18,0,30,12
1714372984643,EDS 139,B00,507313,Pappas; Elizabeth,15,0,30,15
1714372985669,EDS 201,A00,507315,Staff,13,0,30,17
1714372986701,EDS 203,A01,507317,Halter; Christopher P.,12,0,30,18
1714372987730,EDS 204R,A01,507319,Halter; Christopher P.,0,3,30,30
1714372987730,EDS 204R,B01,507331,Heinzman; Erica M.,17,0,30,13
1714372988755,EDS 206R,A00,507332,Staff,0,4,30,30
1714372988755,EDS 206R,B00,507343,Staff,18,0,30,12
1714372989783,EDS 250,A00,507344,Hemans; Patricia Ann Benitez,22,0,40,18
1714372990809,EDS 281,A00,507345,Daly; Alan J.,18,0,18,0
1714372991838,EDS 284,A00,507350,Daly; Alan J.,16,0,16,0
1714372992865,EDS 286,A00,507359,Fine; Sarah,18,0,18,0
1714372993901,EDS 289C,A01,507361,Daly; Alan J.,18,0,18,0
1714372994927,EDS 290,A00,507366,Hofstetter; Carolyn,15,0,15,0
1714372995953,LIGM 5A,A00,507421,Fischer-Grunski; Eva K,18,0,20,2
1714372996978,LIGM 5B,A00,507423,Fischer-Grunski; Eva K,19,0,20,1
1714372998007,LIGM 5C,A00,507425,Fischer-Grunski; Eva K,19,0,20,1
1714372999036,LIIT 5AS,A00,507427,Carnelos; Chiara,20,0,20,0
1714373000063,LIIT 5BS,A00,507430,Carnelos; Chiara,20,0,20,0
1714373001093,LIIT 5CS,A00,507432,Carnelos; Chiara,20,0,20,0
1714373002119,LISP 5A,A00,507541,Munoz Sanchez; Alicia,11,0,20,9
1714373003201,LISP 5B,A00,507671,Munoz Sanchez; Alicia,9,0,20,11
1714373004225,LISP 5C,A00,507696,Munoz Sanchez; Alicia,9,0,20,11
1714373005251,MAE 197,001,528363,Boechler; Nicholas Sebastia,9998,0,9999,1
1714373006275,MATH 197,001,523477,Kedlaya; Kiran S.,9996,0,9999,3
1714373006275,MATH 197,002,563811,Zhang; Danna,9995,0,9999,4
1714373006275,MATH 197,003,628552,Dumitriu; Ioana,9998,0,9999,1
1714373007300,MCWP 40R,A00,518780,Staff,5,0,20,15
1714373007300,MCWP 40R,B00,518781,Staff,7,0,20,13
1714373007300,MCWP 40R,C00,518783,Staff,5,0,20,15
1714373008326,MCWP 50R,A00,518791,Staff,0,0,20,20
1714373008326,MCWP 50R,B00,518792,Staff,0,1,20,20
1714373008326,MCWP 50R,C00,518793,Staff,0,1,20,20
1714373008326,MCWP 50R,D00,518794,Staff,0,0,20,20
1714373008326,MCWP 50R,E00,518795,Staff,0,1,20,20
1714373008326,MCWP 50R,F00,518796,Staff,0,0,20,20
1714373008326,MCWP 50R,G00,518797,Staff,0,1,20,20
1714373009351,MMW 12R,A01,514034,Herbst; Matthew,0,1,16,16
1714373009351,MMW 12R,A02,514035,Herbst; Matthew,2,0,16,14
1714373010375,MMW 13R,A01,514037,Staff,0,4,16,16
1714373010375,MMW 13R,A02,514039,Staff,0,2,16,16
1714373010375,MMW 13R,A03,628519,Staff,0,2,16,16
1714373012432,SIO 295LS,A00,523233,Staff,12,0,30,18
1714373013461,SIO 295S,A00,523232,Staff,12,0,30,18
1714373014489,SIOC 290S,A01,637330,Merrifield; Mark A,27,0,30,3
1714373015520,SIOC 291S,A01,637333,Gabriel; Corey John,27,0,30,3
1714373016547,SOCI 117,A01,494376,Staff,0,3,5,5
1714373017573,WES 237B,A00,494380,Staff,9,0,20,11
1714373019635,AESE 279B,A00,494370,Wade; Jon P,0,0,33,33
1714373020659,AIP 197,001,627712,Vespa; Emanuel Ignacio,9998,0,9999,1
1714373021685,ANAR 135S,A00,494369,Braswell; Geoffrey E.,0,0,0,0
1714373022712,BENG 196,001,628496,Engler; Adam J.,9998,0,9999,1
1714373023738,CAT 124RS,A01,519847,Geibel; William,0,0,20,20
1714373024766,CAT 125RS,A01,515971,Geibel; William,0,0,20,20
1714373025796,CLRE 250,A00,511389,Morris; Sheldon,9993,0,9999,6
1714373026824,CLRE 251,A00,507176,Mehta; Ravindra L.,9993,0,9999,6
1714373026824,CLRE 251,B00,511410,Mehta; Ravindra L.,9998,0,9999,1
1714373027852,CLRE 252,A00,507189,Cuomo; Raphael Eduardo,9995,0,9999,4
1714373028878,CLRE 253,A00,507199,Vaida; Florin,9994,0,9999,5
1714373028878,CLRE 253,B00,507202,Vaida; Florin,9999,0,9999,0
1714373029903,CLRE 259,A00,507211,Patel; Hemal,9996,0,9999,3
1714373030928,CLRE 260,A00,507221,Cuomo; Raphael Eduardo,9999,0,9999,0
1714373031953,CLRE 297,001,507242,Cuomo; Raphael Eduardo,9999,0,9999,0
1714373032981,COGS 197,001,638244,Voytek; Bradley Thomas,9999,0,9999,0
1714373034009,CSE 191,A00,516875,Minnes Kemp; Mor Mia,9993,0,9999,6
1714373035037,CSE 197,001,637388,Minnes Kemp; Mor Mia,9998,0,9999,1
1714373036062,CSS 201S,A01,494383,Staff,35,0,35,0
1714373037088,CSS 202S,A01,494387,Staff,35,0,35,0
1714373038115,DSC 197,001,628532,Eldridge; Justin Matthew,9996,0,9999,3
1714373039139,EAP 100,A00,516065,Staff,9797,0,9999,202
1714373040166,ECE 45,A01,507414,Staff,33,0,60,27
1714373042218,ECE 111,A01,507420,Staff,19,0,50,31
1714373043243,ECE 197,001,548057,Sievenpiper; Daniel F.,9994,0,9999,5
1714373044273,EDS 115,A00,507243,Choi; Bailey Miyeon,12,0,28,16
1714373045300,EDS 117,A01,494379,Staff,0,2,30,30
1714373046326,EDS 125,A00,507246,Hopkins; Megan Beth,12,0,30,18
1714373047352,EDS 128A,A01,507264,Fargason; Sharon Gayle,14,0,26,12
1714373048377,EDS 128B,A01,507293,Pappas; Elizabeth,18,0,30,12
1714373049406,EDS 139,A00,507294,Fargason; Sharon Gayle,18,0,30,12
1714373049406,EDS 139,B00,507313,Pappas; Elizabeth,15,0,30,15
1714373050435,EDS 201,A00,507315,Staff,13,0,30,17
1714373051465,EDS 203,A01,507317,Halter; Christopher P.,12,0,30,18
1714373052489,EDS 204R,A01,507319,Halter; Christopher P.,0,3,30,30
1714373052489,EDS 204R,B01,507331,Heinzman; Erica M.,17,0,30,13
1714373053514,EDS 206R,A00,507332,Staff,0,4,30,30
1714373053514,EDS 206R,B00,507343,Staff,18,0,30,12
1714373054540,EDS 250,A00,507344,Hemans; Patricia Ann Benitez,22,0,40,18
1714373055564,EDS 281,A00,507345,Daly; Alan J.,18,0,18,0
1714373056590,EDS 284,A00,507350,Daly; Alan J.,16,0,16,0
1714373057617,EDS 286,A00,507359,Fine; Sarah,18,0,18,0
1714373058641,EDS 289C,A01,507361,Daly; Alan J.,18,0,18,0
1714373059666,EDS 290,A00,507366,Hofstetter; Carolyn,15,0,15,0
1714373060693,LIGM 5A,A00,507421,Fischer-Grunski; Eva K,18,0,20,2
1714373061722,LIGM 5B,A00,507423,Fischer-Grunski; Eva K,19,0,20,1
1714373062751,LIGM 5C,A00,507425,Fischer-Grunski; Eva K,19,0,20,1
1714373063781,LIIT 5AS,A00,507427,Carnelos; Chiara,20,0,20,0
1714373064809,LIIT 5BS,A00,507430,Carnelos; Chiara,20,0,20,0
1714373065837,LIIT 5CS,A00,507432,Carnelos; Chiara,20,0,20,0
1714373066862,LISP 5A,A00,507541,Munoz Sanchez; Alicia,11,0,20,9
1714373067891,LISP 5B,A00,507671,Munoz Sanchez; Alicia,9,0,20,11
1714373068917,LISP 5C,A00,507696,Munoz Sanchez; Alicia,9,0,20,11
1714373069945,MAE 197,001,528363,Boechler; Nicholas Sebastia,9998,0,9999,1
1714373070970,MATH 197,001,523477,Kedlaya; Kiran S.,9996,0,9999,3
1714373070970,MATH 197,002,563811,Zhang; Danna,9995,0,9999,4
1714373070970,MATH 197,003,628552,Dumitriu; Ioana,9998,0,9999,1
1714373071998,MCWP 40R,A00,518780,Staff,5,0,20,15
1714373071998,MCWP 40R,B00,518781,Staff,7,0,20,13
1714373071998,MCWP 40R,C00,518783,Staff,5,0,20,15
1714373073024,MCWP 50R,A00,518791,Staff,0,0,20,20
1714373073024,MCWP 50R,B00,518792,Staff,0,1,20,20
1714373073024,MCWP 50R,C00,518793,Staff,0,1,20,20
1714373073024,MCWP 50R,D00,518794,Staff,0,0,20,20
1714373073024,MCWP 50R,E00,518795,Staff,0,1,20,20
1714373073024,MCWP 50R,F00,518796,Staff,0,0,20,20
1714373073024,MCWP 50R,G00,518797,Staff,0,1,20,20
1714373074050,MMW 12R,A01,514034,Herbst; Matthew,0,1,16,16
1714373074050,MMW 12R,A02,514035,Herbst; Matthew,2,0,16,14
1714373075074,MMW 13R,A01,514037,Staff,0,4,16,16
1714373075074,MMW 13R,A02,514039,Staff,0,2,16,16
1714373075074,MMW 13R,A03,628519,Staff,0,2,16,16
1714373077124,SIO 295LS,A00,523233,Staff,12,0,30,18
1714373078149,SIO 295S,A00,523232,Staff,12,0,30,18
1714373079175,SIOC 290S,A01,637330,Merrifield; Mark A,27,0,30,3
1714373080201,SIOC 291S,A01,637333,Gabriel; Corey John,27,0,30,3
1714373081227,SOCI 117,A01,494376,Staff,0,3,5,5
1714373082274,WES 237B,A00,494380,Staff,9,0,20,11
1714373084330,AESE 279B,A00,494370,Wade; Jon P,0,0,33,33
1714373085356,AIP 197,001,627712,Vespa; Emanuel Ignacio,9998,0,9999,1
1714373086382,ANAR 135S,A00,494369,Braswell; Geoffrey E.,0,0,0,0
1714373087406,BENG 196,001,628496,Engler; Adam J.,9998,0,9999,1
1714373088432,CAT 124RS,A01,519847,Geibel; William,0,0,20,20
1714373089457,CAT 125RS,A01,515971,Geibel; William,0,0,20,20
1714373090481,CLRE 250,A00,511389,Morris; Sheldon,9993,0,9999,6
1714373091508,CLRE 251,A00,507176,Mehta; Ravindra L.,9993,0,9999,6
1714373091508,CLRE 251,B00,511410,Mehta; Ravindra L.,9998,0,9999,1
1714373092532,CLRE 252,A00,507189,Cuomo; Raphael Eduardo,9995,0,9999,4
1714373093557,CLRE 253,A00,507199,Vaida; Florin,9994,0,9999,5
1714373093557,CLRE 253,B00,507202,Vaida; Florin,9999,0,9999,0
1714373094581,CLRE 259,A00,507211,Patel; Hemal,9996,0,9999,3
1714373095605,CLRE 260,A00,507221,Cuomo; Raphael Eduardo,9999,0,9999,0
1714373096631,CLRE 297,001,507242,Cuomo; Raphael Eduardo,9999,0,9999,0
1714373097658,COGS 197,001,638244,Voytek; Bradley Thomas,9999,0,9999,0
1714373098684,CSE 191,A00,516875,Minnes Kemp; Mor Mia,9993,0,9999,6
1714373099710,CSE 197,001,637388,Minnes Kemp; Mor Mia,9998,0,9999,1
1714373100762,CSS 201S,A01,494383,Staff,35,0,35,0
1714373101792,CSS 202S,A01,494387,Staff,35,0,35,0
1714373102818,DSC 197,001,628532,Eldridge; Justin Matthew,9996,0,9999,3
1714373103844,EAP 100,A00,516065,Staff,9797,0,9999,202
1714373104868,ECE 45,A01,507414,Staff,33,0,60,27
1714373106974,ECE 111,A01,507420,Staff,19,0,50,31
1714373107997,ECE 197,001,548057,Sievenpiper; Daniel F.,9994,0,9999,5
1714373109023,EDS 115,A00,507243,Choi; Bailey Miyeon,12,0,28,16
1714373110051,EDS 117,A01,494379,Staff,0,2,30,30
1714373111080,EDS 125,A00,507246,Hopkins; Megan Beth,12,0,30,18
1714373112106,EDS 128A,A01,507264,Fargason; Sharon Gayle,14,0,26,12
1714373113134,EDS 128B,A01,507293,Pappas; Elizabeth,18,0,30,12
1714373114160,EDS 139,A00,507294,Fargason; Sharon Gayle,18,0,30,12
1714373114160,EDS 139,B00,507313,Pappas; Elizabeth,15,0,30,15
1714373115185,EDS 201,A00,507315,Staff,13,0,30,17
1714373116214,EDS 203,A01,507317,Halter; Christopher P.,12,0,30,18
1714373117239,EDS 204R,A01,507319,Halter; Christopher P.,0,3,30,30
1714373117239,EDS 204R,B01,507331,Heinzman; Erica M.,17,0,30,13
1714373118269,EDS 206R,A00,507332,Staff,0,4,30,30
1714373118269,EDS 206R,B00,507343,Staff,18,0,30,12
1714373119295,EDS 250,A00,507344,Hemans; Patricia Ann Benitez,22,0,40,18
1714373120320,EDS 281,A00,507345,Daly; Alan J.,18,0,18,0
1714373121346,EDS 284,A00,507350,Daly; Alan J.,16,0,16,0
1714373122374,EDS 286,A00,507359,Fine; Sarah,18,0,18,0
1714373123400,EDS 289C,A01,507361,Daly; Alan J.,18,0,18,0
1714373124425,EDS 290,A00,507366,Hofstetter; Carolyn,15,0,15,0
1714373125452,LIGM 5A,A00,507421,Fischer-Grunski; Eva K,18,0,20,2
1714373126477,LIGM 5B,A00,507423,Fischer-Grunski; Eva K,19,0,20,1
1714373127503,LIGM 5C,A00,507425,Fischer-Grunski; Eva K,19,0,20,1
1714373128529,LIIT 5AS,A00,507427,Carnelos; Chiara,20,0,20,0
1714373129554,LIIT 5BS,A00,507430,Carnelos; Chiara,20,0,20,0
1714373130579,LIIT 5CS,A00,507432,Carnelos; Chiara,20,0,20,0
1714373131608,LISP 5A,A00,507541,Munoz Sanchez; Alicia,11,0,20,9
1714373132634,LISP 5B,A00,507671,Munoz Sanchez; Alicia,9,0,20,11
1714373133658,LISP 5C,A00,507696,Munoz Sanchez; Alicia,9,0,20,11
1714373134683,MAE 197,001,528363,Boechler; Nicholas Sebastia,9998,0,9999,1
1714373135711,MATH 197,001,523477,Kedlaya; Kiran S.,9996,0,9999,3
1714373135711,MATH 197,002,563811,Zhang; Danna,9995,0,9999,4
1714373135711,MATH 197,003,628552,Dumitriu; Ioana,9998,0,9999,1
1714373136735,MCWP 40R,A00,518780,Staff,5,0,20,15
1714373136735,MCWP 40R,B00,518781,Staff,7,0,20,13
1714373136735,MCWP 40R,C00,518783,Staff,5,0,20,15
1714373137759,MCWP 50R,A00,518791,Staff,0,0,20,20
1714373137759,MCWP 50R,B00,518792,Staff,0,1,20,20
1714373137759,MCWP 50R,C00,518793,Staff,0,1,20,20
1714373137759,MCWP 50R,D00,518794,Staff,0,0,20,20
1714373137759,MCWP 50R,E00,518795,Staff,0,1,20,20
1714373137759,MCWP 50R,F00,518796,Staff,0,0,20,20
1714373137759,MCWP 50R,G00,518797,Staff,0,1,20,20
1714373138787,MMW 12R,A01,514034,Herbst; Matthew,0,1,16,16
1714373138787,MMW 12R,A02,514035,Herbst; Matthew,2,0,16,14
1714373139811,MMW 13R,A01,514037,Staff,0,4,16,16
1714373139811,MMW 13R,A02,514039,Staff,0,2,16,16
1714373139811,MMW 13R,A03,628519,Staff,0,2,16,16
1714373141860,SIO 295LS,A00,523233,Staff,12,0,30,18
1714373142886,SIO 295S,A00,523232,Staff,12,0,30,18
1714373143912,SIOC 290S,A01,637330,Merrifield; Mark A,27,0,30,3
1714373144938,SIOC 291S,A01,637333,Gabriel; Corey John,27,0,30,3
1714373145968,SOCI 117,A01,494376,Staff,0,3,5,5
1714373146997,WES 237B,A00,494380,Staff,9,0,20,11
1714373149066,AESE 279B,A00,494370,Wade; Jon P,0,0,33,33
1714373150092,AIP 197,001,627712,Vespa; Emanuel Ignacio,9998,0,9999,1
1714373151121,ANAR 135S,A00,494369,Braswell; Geoffrey E.,0,0,0,0
1714373152146,BENG 196,001,628496,Engler; Adam J.,9998,0,9999,1
1714373153175,CAT 124RS,A01,519847,Geibel; William,0,0,20,20
1714373154202,CAT 125RS,A01,515971,Geibel; William,0,0,20,20
1714373155229,CLRE 250,A00,511389,Morris; Sheldon,9993,0,9999,6
1714373156255,CLRE 251,A00,507176,Mehta; Ravindra L.,9993,0,9999,6
1714373156255,CLRE 251,B00,511410,Mehta; Ravindra L.,9998,0,9999,1
1714373157280,CLRE 252,A00,507189,Cuomo; Raphael Eduardo,9995,0,9999,4
1714373158305,CLRE 253,A00,507199,Vaida; Florin,9994,0,9999,5
1714373158305,CLRE 253,B00,507202,Vaida; Florin,9999,0,9999,0
1714373159334,CLRE 259,A00,507211,Patel; Hemal,9996,0,9999,3
1714373160362,CLRE 260,A00,507221,Cuomo; Raphael Eduardo,9999,0,9999,0
1714373161386,CLRE 297,001,507242,Cuomo; Raphael Eduardo,9999,0,9999,0
1714373162411,COGS 197,001,638244,Voytek; Bradley Thomas,9999,0,9999,0
1714373163439,CSE 191,A00,516875,Minnes Kemp; Mor Mia,9993,0,9999,6
1714373164466,CSE 197,001,637388,Minnes Kemp; Mor Mia,9998,0,9999,1
1714373165493,CSS 201S,A01,494383,Staff,35,0,35,0
1714373166519,CSS 202S,A01,494387,Staff,35,0,35,0
1714373167546,DSC 197,001,628532,Eldridge; Justin Matthew,9996,0,9999,3
1714373168570,EAP 100,A00,516065,Staff,9797,0,9999,202
1714373169596,ECE 45,A01,507414,Staff,33,0,60,27
1714373171646,ECE 111,A01,507420,Staff,19,0,50,31
1714373172671,ECE 197,001,548057,Sievenpiper; Daniel F.,9994,0,9999,5
1714373173698,EDS 115,A00,507243,Choi; Bailey Miyeon,12,0,28,16
1714373174724,EDS 117,A01,494379,Staff,0,2,30,30
1714373175755,EDS 125,A00,507246,Hopkins; Megan Beth,12,0,30,18
1714373176783,EDS 128A,A01,507264,Fargason; Sharon Gayle,14,0,26,12
1714373177807,EDS 128B,A01,507293,Pappas; Elizabeth,18,0,30,12
1714373178833,EDS 139,A00,507294,Fargason; Sharon Gayle,18,0,30,12
1714373178833,EDS 139,B00,507313,Pappas; Elizabeth,15,0,30,15
1714373179857,EDS 201,A00,507315,Staff,13,0,30,17
1714373180882,EDS 203,A01,507317,Halter; Christopher P.,12,0,30,18
1714373181908,EDS 204R,A01,507319,Halter; Christopher P.,0,3,30,30
1714373181908,EDS 204R,B01,507331,Heinzman; Erica M.,17,0,30,13
1714373182937,EDS 206R,A00,507332,Staff,0,4,30,30
1714373182937,EDS 206R,B00,507343,Staff,18,0,30,12
1714373183964,EDS 250,A00,507344,Hemans; Patricia Ann Benitez,22,0,40,18
1714373184993,EDS 281,A00,507345,Daly; Alan J.,18,0,18,0
1714373186017,EDS 284,A00,507350,Daly; Alan J.,16,0,16,0
1714373187043,EDS 286,A00,507359,Fine; Sarah,18,0,18,0
1714373188067,EDS 289C,A01,507361,Daly; Alan J.,18,0,18,0
1714373189093,EDS 290,A00,507366,Hofstetter; Carolyn,15,0,15,0
1714373190123,LIGM 5A,A00,507421,Fischer-Grunski; Eva K,18,0,20,2
1714373191151,LIGM 5B,A00,507423,Fischer-Grunski; Eva K,19,0,20,1
1714373192177,LIGM 5C,A00,507425,Fischer-Grunski; Eva K,19,0,20,1
1714373193203,LIIT 5AS,A00,507427,Carnelos; Chiara,20,0,20,0
1714373194229,LIIT 5BS,A00,507430,Carnelos; Chiara,20,0,20,0
1714373195260,LIIT 5CS,A00,507432,Carnelos; Chiara,20,0,20,0
1714373196289,LISP 5A,A00,507541,Munoz Sanchez; Alicia,11,0,20,9
1714373197322,LISP 5B,A00,507671,Munoz Sanchez; Alicia,9,0,20,11
1714373198347,LISP 5C,A00,507696,Munoz Sanchez; Alicia,9,0,20,11
1714373199375,MAE 197,001,528363,Boechler; Nicholas Sebastia,9998,0,9999,1
1714373200401,MATH 197,001,523477,Kedlaya; Kiran S.,9996,0,9999,3
1714373200401,MATH 197,002,563811,Zhang; Danna,9995,0,9999,4
1714373200401,MATH 197,003,628552,Dumitriu; Ioana,9998,0,9999,1
1714373201427,MCWP 40R,A00,518780,Staff,5,0,20,15
1714373201427,MCWP 40R,B00,518781,Staff,7,0,20,13
1714373201427,MCWP 40R,C00,518783,Staff,5,0,20,15
1714373202456,MCWP 50R,A00,518791,Staff,0,0,20,20
1714373202456,MCWP 50R,B00,518792,Staff,0,1,20,20
1714373202456,MCWP 50R,C00,518793,Staff,0,1,20,20
1714373202456,MCWP 50R,D00,518794,Staff,0,0,20,20
1714373202456,MCWP 50R,E00,518795,Staff,0,1,20,20
1714373202456,MCWP 50R,F00,518796,Staff,0,0,20,20
1714373202456,MCWP 50R,G00,518797,Staff,0,1,20,20
1714373203480,MMW 12R,A01,514034,Herbst; Matthew,0,1,16,16
1714373203480,MMW 12R,A02,514035,Herbst; Matthew,2,0,16,14
1714373204507,MMW 13R,A01,514037,Staff,0,4,16,16
1714373204507,MMW 13R,A02,514039,Staff,0,2,16,16
1714373204507,MMW 13R,A03,628519,Staff,0,2,16,16
1714373206558,SIO 295LS,A00,523233,Staff,12,0,30,18
1714373207584,SIO 295S,A00,523232,Staff,12,0,30,18
1714373208611,SIOC 290S,A01,637330,Merrifield; Mark A,27,0,30,3
1714373209636,SIOC 291S,A01,637333,Gabriel; Corey John,27,0,30,3
1714373210714,SOCI 117,A01,494376,Staff,0,3,5,5
1714373211739,WES 237B,A00,494380,Staff,9,0,20,11
1714373213814,AESE 279B,A00,494370,Wade; Jon P,0,0,33,33
1714373214841,AIP 197,001,627712,Vespa; Emanuel Ignacio,9998,0,9999,1
1714373215864,ANAR 135S,A00,494369,Braswell; Geoffrey E.,0,0,0,0
1714373216889,BENG 196,001,628496,Engler; Adam J.,9998,0,9999,1
1714373217913,CAT 124RS,A01,519847,Geibel; William,0,0,20,20
1714373218942,CAT 125RS,A01,515971,Geibel; William,0,0,20,20
1714373219969,CLRE 250,A00,511389,Morris; Sheldon,9993,0,9999,6
1714373220995,CLRE 251,A00,507176,Mehta; Ravindra L.,9993,0,9999,6
1714373220995,CLRE 251,B00,511410,Mehta; Ravindra L.,9998,0,9999,1
1714373222024,CLRE 252,A00,507189,Cuomo; Raphael Eduardo,9995,0,9999,4
1714373223057,CLRE 253,A00,507199,Vaida; Florin,9994,0,9999,5
1714373223057,CLRE 253,B00,507202,Vaida; Florin,9999,0,9999,0
1714373224081,CLRE 259,A00,507211,Patel; Hemal,9996,0,9999,3
1714373225109,CLRE 260,A00,507221,Cuomo; Raphael Eduardo,9999,0,9999,0
1714373226136,CLRE 297,001,507242,Cuomo; Raphael Eduardo,9999,0,9999,0
1714373227163,COGS 197,001,638244,Voytek; Bradley Thomas,9999,0,9999,0
1714373228187,CSE 191,A00,516875,Minnes Kemp; Mor Mia,9993,0,9999,6
1714373229212,CSE 197,001,637388,Minnes Kemp; Mor Mia,9998,0,9999,1
1714373230241,CSS 201S,A01,494383,Staff,35,0,35,0
1714373231267,CSS 202S,A01,494387,Staff,35,0,35,0
1714373232292,DSC 197,001,628532,Eldridge; Justin Matthew,9996,0,9999,3
1714373233317,EAP 100,A00,516065,Staff,9797,0,9999,202
1714373234343,ECE 45,A01,507414,Staff,33,0,60,27
1714373236395,ECE 111,A01,507420,Staff,19,0,50,31
1714373237423,ECE 197,001,548057,Sievenpiper; Daniel F.,9994,0,9999,5
1714373238448,EDS 115,A00,507243,Choi; Bailey Miyeon,12,0,28,16
1714373239476,EDS 117,A01,494379,Staff,0,2,30,30
1714373240505,EDS 125,A00,507246,Hopkins; Megan Beth,12,0,30,18
1714373241531,EDS 128A,A01,507264,Fargason; Sharon Gayle,14,0,26,12
1714373242559,EDS 128B,A01,507293,Pappas; Elizabeth,18,0,30,12
1714373243584,EDS 139,A00,507294,Fargason; Sharon Gayle,18,0,30,12
1714373243584,EDS 139,B00,507313,Pappas; Elizabeth,15,0,30,15
1714373244610,EDS 201,A00,507315,Staff,13,0,30,17
1714373245634,EDS 203,A01,507317,Halter; Christopher P.,12,0,30,18
1714373246659,EDS 204R,A01,507319,Halter; Christopher P.,0,3,30,30
1714373246659,EDS 204R,B01,507331,Heinzman; Erica M.,17,0,30,13
1714373247686,EDS 206R,A00,507332,Staff,0,4,30,30
1714373247686,EDS 206R,B00,507343,Staff,18,0,30,12
1714373248714,EDS 250,A00,507344,Hemans; Patricia Ann Benitez,22,0,40,18
1714373249740,EDS 281,A00,507345,Daly; Alan J.,18,0,18,0
1714373250766,EDS 284,A00,507350,Daly; Alan J.,16,0,16,0
1714373251796,EDS 286,A00,507359,Fine; Sarah,18,0,18,0
1714373252823,EDS 289C,A01,507361,Daly; Alan J.,18,0,18,0
1714373253849,EDS 290,A00,507366,Hofstetter; Carolyn,15,0,15,0
1714373254879,LIGM 5A,A00,507421,Fischer-Grunski; Eva K,18,0,20,2
1714373255910,LIGM 5B,A00,507423,Fischer-Grunski; Eva K,19,0,20,1
1714373256941,LIGM 5C,A00,507425,Fischer-Grunski; Eva K,19,0,20,1
1714373257967,LIIT 5AS,A00,507427,Carnelos; Chiara,20,0,20,0
1714373258993,LIIT 5BS,A00,507430,Carnelos; Chiara,20,0,20,0
1714373260020,LIIT 5CS,A00,507432,Carnelos; Chiara,20,0,20,0
1714373261047,LISP 5A,A00,507541,Munoz Sanchez; Alicia,11,0,20,9
1714373262073,LISP 5B,A00,507671,Munoz Sanchez; Alicia,9,0,20,11
1714373263100,LISP 5C,A00,507696,Munoz Sanchez; Alicia,9,0,20,11
1714373264125,MAE 197,001,528363,Boechler; Nicholas Sebastia,9998,0,9999,1
1714373265151,MATH 197,001,523477,Kedlaya; Kiran S.,9996,0,9999,3
1714373265151,MATH 197,002,563811,Zhang; Danna,9995,0,9999,4
1714373265151,MATH 197,003,628552,Dumitriu; Ioana,9998,0,9999,1
1714373266176,MCWP 40R,A00,518780,Staff,5,0,20,15
1714373266176,MCWP 40R,B00,518781,Staff,7,0,20,13
1714373266176,MCWP 40R,C00,518783,Staff,5,0,20,15
1714373267202,MCWP 50R,A00,518791,Staff,0,0,20,20
1714373267202,MCWP 50R,B00,518792,Staff,0,1,20,20
1714373267202,MCWP 50R,C00,518793,Staff,0,1,20,20
1714373267202,MCWP 50R,D00,518794,Staff,0,0,20,20
1714373267202,MCWP 50R,E00,518795,Staff,0,1,20,20
1714373267202,MCWP 50R,F00,518796,Staff,0,0,20,20
1714373267202,MCWP 50R,G00,518797,Staff,0,1,20,20
1714373268231,MMW 12R,A01,514034,Herbst; Matthew,0,1,16,16
1714373268231,MMW 12R,A02,514035,Herbst; Matthew,2,0,16,14
1714373269256,MMW 13R,A01,514037,Staff,0,4,16,16
1714373269256,MMW 13R,A02,514039,Staff,0,2,16,16
1714373269256,MMW 13R,A03,628519,Staff,0,2,16,16
1714373271308,SIO 295LS,A00,523233,Staff,12,0,30,18
1714373272334,SIO 295S,A00,523232,Staff,12,0,30,18
1714373273360,SIOC 290S,A01,637330,Merrifield; Mark A,27,0,30,3
1714373274389,SIOC 291S,A01,637333,Gabriel; Corey John,27,0,30,3
1714373275416,SOCI 117,A01,494376,Staff,0,3,5,5
1714373276441,WES 237B,A00,494380,Staff,9,0,20,11
1714373278507,AESE 279B,A00,494370,Wade; Jon P,0,0,33,33
1714373279532,AIP 197,001,627712,Vespa; Emanuel Ignacio,9998,0,9999,1
1714373280556,ANAR 135S,A00,494369,Braswell; Geoffrey E.,0,0,0,0
1714373281580,BENG 196,001,628496,Engler; Adam J.,9998,0,9999,1
1714373282607,CAT 124RS,A01,519847,Geibel; William,0,0,20,20
1714373283637,CAT 125RS,A01,515971,Geibel; William,0,0,20,20
1714373284662,CLRE 250,A00,511389,Morris; Sheldon,9993,0,9999,6
1714373285689,CLRE 251,A00,507176,Mehta; Ravindra L.,9993,0,9999,6
1714373285689,CLRE 251,B00,511410,Mehta; Ravindra L.,9998,0,9999,1
1714373286716,CLRE 252,A00,507189,Cuomo; Raphael Eduardo,9995,0,9999,4
1714373287741,CLRE 253,A00,507199,Vaida; Florin,9994,0,9999,5
1714373287741,CLRE 253,B00,507202,Vaida; Florin,9999,0,9999,0
1714373288773,CLRE 259,A00,507211,Patel; Hemal,9996,0,9999,3
1714373289797,CLRE 260,A00,507221,Cuomo; Raphael Eduardo,9999,0,9999,0
1714373290823,CLRE 297,001,507242,Cuomo; Raphael Eduardo,9999,0,9999,0
1714373291848,COGS 197,001,638244,Voytek; Bradley Thomas,9999,0,9999,0
1714373292874,CSE 191,A00,516875,Minnes Kemp; Mor Mia,9993,0,9999,6
1714373293900,CSE 197,001,637388,Minnes Kemp; Mor Mia,9998,0,9999,1
1714373294928,CSS 201S,A01,494383,Staff,35,0,35,0
1714373295958,CSS 202S,A01,494387,Staff,35,0,35,0
1714373296982,DSC 197,001,628532,Eldridge; Justin Matthew,9996,0,9999,3
1714373298009,EAP 100,A00,516065,Staff,9797,0,9999,202
1714373299035,ECE 45,A01,507414,Staff,33,0,60,27
1714373301088,ECE 111,A01,507420,Staff,19,0,50,31
1714373302113,ECE 197,001,548057,Sievenpiper; Daniel F.,9994,0,9999,5
1714373303141,EDS 115,A00,507243,Choi; Bailey Miyeon,12,0,28,16
1714373304166,EDS 117,A01,494379,Staff,0,2,30,30
1714373305193,EDS 125,A00,507246,Hopkins; Megan Beth,12,0,30,18
1714373306219,EDS 128A,A01,507264,Fargason; Sharon Gayle,14,0,26,12
1714373307243,EDS 128B,A01,507293,Pappas; Elizabeth,18,0,30,12
1714373308267,EDS 139,A00,507294,Fargason; Sharon Gayle,18,0,30,12
1714373308267,EDS 139,B00,507313,Pappas; Elizabeth,15,0,30,15
1714373309296,EDS 201,A00,507315,Staff,13,0,30,17
1714373310322,EDS 203,A01,507317,Halter; Christopher P.,12,0,30,18
1714373311347,EDS 204R,A01,507319,Halter; Christopher P.,0,3,30,30
1714373311347,EDS 204R,B01,507331,Heinzman; Erica M.,17,0,30,13
1714373312375,EDS 206R,A00,507332,Staff,0,4,30,30
1714373312375,EDS 206R,B00,507343,Staff,18,0,30,12
1714373313401,EDS 250,A00,507344,Hemans; Patricia Ann Benitez,22,0,40,18
1714373314480,EDS 281,A00,507345,Daly; Alan J.,18,0,18,0
1714373315504,EDS 284,A00,507350,Daly; Alan J.,16,0,16,0
1714373316528,EDS 286,A00,507359,Fine; Sarah,18,0,18,0
1714373317552,EDS 289C,A01,507361,Daly; Alan J.,18,0,18,0
1714373318581,EDS 290,A00,507366,Hofstetter; Carolyn,15,0,15,0
1714373319610,LIGM 5A,A00,507421,Fischer-Grunski; Eva K,18,0,20,2
1714373320635,LIGM 5B,A00,507423,Fischer-Grunski; Eva K,19,0,20,1
1714373321661,LIGM 5C,A00,507425,Fischer-Grunski; Eva K,19,0,20,1
1714373322686,LIIT 5AS,A00,507427,Carnelos; Chiara,20,0,20,0
1714373323711,LIIT 5BS,A00,507430,Carnelos; Chiara,20,0,20,0
1714373324737,LIIT 5CS,A00,507432,Carnelos; Chiara,20,0,20,0
1714373325763,LISP 5A,A00,507541,Munoz Sanchez; Alicia,11,0,20,9
1714373326789,LISP 5B,A00,507671,Munoz Sanchez; Alicia,9,0,20,11
1714373327816,LISP 5C,A00,507696,Munoz Sanchez; Alicia,9,0,20,11
1714373328841,MAE 197,001,528363,Boechler; Nicholas Sebastia,9998,0,9999,1
1714373329866,MATH 197,001,523477,Kedlaya; Kiran S.,9996,0,9999,3
1714373329866,MATH 197,002,563811,Zhang; Danna,9995,0,9999,4
1714373329866,MATH 197,003,628552,Dumitriu; Ioana,9998,0,9999,1
1714373330892,MCWP 40R,A00,518780,Staff,5,0,20,15
1714373330892,MCWP 40R,B00,518781,Staff,7,0,20,13
1714373330892,MCWP 40R,C00,518783,Staff,5,0,20,15
1714373331922,MCWP 50R,A00,518791,Staff,0,0,20,20
1714373331922,MCWP 50R,B00,518792,Staff,0,1,20,20
1714373331922,MCWP 50R,C00,518793,Staff,0,1,20,20
1714373331922,MCWP 50R,D00,518794,Staff,0,0,20,20
1714373331922,MCWP 50R,E00,518795,Staff,0,1,20,20
1714373331922,MCWP 50R,F00,518796,Staff,0,0,20,20
1714373331922,MCWP 50R,G00,518797,Staff,0,1,20,20
1714373332947,MMW 12R,A01,514034,Herbst; Matthew,0,1,16,16
1714373332947,MMW 12R,A02,514035,Herbst; Matthew,2,0,16,14
1714373333975,MMW 13R,A01,514037,Staff,0,4,16,16
1714373333975,MMW 13R,A02,514039,Staff,0,2,16,16
1714373333975,MMW 13R,A03,628519,Staff,0,2,16,16
1714373336029,SIO 295LS,A00,523233,Staff,12,0,30,18
1714373337054,SIO 295S,A00,523232,Staff,12,0,30,18
1714373338081,SIOC 290S,A01,637330,Merrifield; Mark A,27,0,30,3
1714373339109,SIOC 291S,A01,637333,Gabriel; Corey John,27,0,30,3
1714373340143,SOCI 117,A01,494376,Staff,0,3,5,5
1714373341169,WES 237B,A00,494380,Staff,9,0,20,11
1714373343239,AESE 279B,A00,494370,Wade; Jon P,0,0,33,33
1714373344262,AIP 197,001,627712,Vespa; Emanuel Ignacio,9998,0,9999,1
1714373345287,ANAR 135S,A00,494369,Braswell; Geoffrey E.,0,0,0,0
1714373346313,BENG 196,001,628496,Engler; Adam J.,9998,0,9999,1
1714373347338,CAT 124RS,A01,519847,Geibel; William,0,0,20,20
1714373348366,CAT 125RS,A01,515971,Geibel; William,0,0,20,20
1714373349392,CLRE 250,A00,511389,Morris; Sheldon,9993,0,9999,6
1714373350418,CLRE 251,A00,507176,Mehta; Ravindra L.,9993,0,9999,6
1714373350418,CLRE 251,B00,511410,Mehta; Ravindra L.,9998,0,9999,1
1714373351447,CLRE 252,A00,507189,Cuomo; Raphael Eduardo,9995,0,9999,4
1714373352472,CLRE 253,A00,507199,Vaida; Florin,9994,0,9999,5
1714373352472,CLRE 253,B00,507202,Vaida; Florin,9999,0,9999,0
1714373353497,CLRE 259,A00,507211,Patel; Hemal,9996,0,9999,3
1714373354525,CLRE 260,A00,507221,Cuomo; Raphael Eduardo,9999,0,9999,0
1714373355550,CLRE 297,001,507242,Cuomo; Raphael Eduardo,9999,0,9999,0
1714373356576,COGS 197,001,638244,Voytek; Bradley Thomas,9999,0,9999,0
1714373357601,CSE 191,A00,516875,Minnes Kemp; Mor Mia,9993,0,9999,6
1714373358626,CSE 197,001,637388,Minnes Kemp; Mor Mia,9998,0,9999,1
1714373359650,CSS 201S,A01,494383,Staff,35,0,35,0
1714373360677,CSS 202S,A01,494387,Staff,35,0,35,0
1714373361702,DSC 197,001,628532,Eldridge; Justin Matthew,9996,0,9999,3
1714373362727,EAP 100,A00,516065,Staff,9797,0,9999,202
1714373363753,ECE 45,A01,507414,Staff,33,0,60,27
1714373365810,ECE 111,A01,507420,Staff,19,0,50,31
1714373366834,ECE 197,001,548057,Sievenpiper; Daniel F.,9994,0,9999,5
1714373367860,EDS 115,A00,507243,Choi; Bailey Miyeon,12,0,28,16
1714373368887,EDS 117,A01,494379,Staff,0,2,30,30
1714373369911,EDS 125,A00,507246,Hopkins; Megan Beth,12,0,30,18
1714373370939,EDS 128A,A01,507264,Fargason; Sharon Gayle,14,0,26,12
1714373371966,EDS 128B,A01,507293,Pappas; Elizabeth,18,0,30,12
1714373372991,EDS 139,A00,507294,Fargason; Sharon Gayle,18,0,30,12
1714373372991,EDS 139,B00,507313,Pappas; Elizabeth,15,0,30,15
1714373374022,EDS 201,A00,507315,Staff,13,0,30,17
1714373375053,EDS 203,A01,507317,Halter; Christopher P.,12,0,30,18
1714373376084,EDS 204R,A01,507319,Halter; Christopher P.,0,3,30,30
1714373376084,EDS 204R,B01,507331,Heinzman; Erica M.,17,0,30,13
1714373377109,EDS 206R,A00,507332,Staff,0,4,30,30
1714373377109,EDS 206R,B00,507343,Staff,18,0,30,12
1714373378135,EDS 250,A00,507344,Hemans; Patricia Ann Benitez,22,0,40,18
1714373379164,EDS 281,A00,507345,Daly; Alan J.,18,0,18,0
1714373380190,EDS 284,A00,507350,Daly; Alan J.,16,0,16,0
1714373381215,EDS 286,A00,507359,Fine; Sarah,18,0,18,0
1714373382241,EDS 289C,A01,507361,Daly; Alan J.,18,0,18,0
1714373383267,EDS 290,A00,507366,Hofstetter; Carolyn,15,0,15,0
1714373384293,LIGM 5A,A00,507421,Fischer-Grunski; Eva K,18,0,20,2
1714373385318,LIGM 5B,A00,507423,Fischer-Grunski; Eva K,19,0,20,1
1714373386346,LIGM 5C,A00,507425,Fischer-Grunski; Eva K,19,0,20,1
1714373387372,LIIT 5AS,A00,507427,Carnelos; Chiara,20,0,20,0
1714373388398,LIIT 5BS,A00,507430,Carnelos; Chiara,20,0,20,0
1714373389424,LIIT 5CS,A00,507432,Carnelos; Chiara,20,0,20,0
1714373390450,LISP 5A,A00,507541,Munoz Sanchez; Alicia,11,0,20,9
1714373391478,LISP 5B,A00,507671,Munoz Sanchez; Alicia,9,0,20,11
1714373392508,LISP 5C,A00,507696,Munoz Sanchez; Alicia,9,0,20,11
1714373393534,MAE 197,001,528363,Boechler; Nicholas Sebastia,9998,0,9999,1
1714373394560,MATH 197,001,523477,Kedlaya; Kiran S.,9996,0,9999,3
1714373394560,MATH 197,002,563811,Zhang; Danna,9995,0,9999,4
1714373394560,MATH 197,003,628552,Dumitriu; Ioana,9998,0,9999,1
1714373395586,MCWP 40R,A00,518780,Staff,5,0,20,15
1714373395586,MCWP 40R,B00,518781,Staff,7,0,20,13
1714373395586,MCWP 40R,C00,518783,Staff,5,0,20,15
1714373396615,MCWP 50R,A00,518791,Staff,0,0,20,20
1714373396615,MCWP 50R,B00,518792,Staff,0,1,20,20
1714373396615,MCWP 50R,C00,518793,Staff,0,1,20,20
1714373396615,MCWP 50R,D00,518794,Staff,0,0,20,20
1714373396615,MCWP 50R,E00,518795,Staff,0,1,20,20
1714373396615,MCWP 50R,F00,518796,Staff,0,0,20,20
1714373396615,MCWP 50R,G00,518797,Staff,0,1,20,20
1714373397640,MMW 12R,A01,514034,Herbst; Matthew,0,1,16,16
1714373397640,MMW 12R,A02,514035,Herbst; Matthew,2,0,16,14
1714373398664,MMW 13R,A01,514037,Staff,0,4,16,16
1714373398664,MMW 13R,A02,514039,Staff,0,2,16,16
1714373398664,MMW 13R,A03,628519,Staff,0,2,16,16
1714373400719,SIO 295LS,A00,523233,Staff,12,0,30,18
1714373401744,SIO 295S,A00,523232,Staff,12,0,30,18
1714373402773,SIOC 290S,A01,637330,Merrifield; Mark A,27,0,30,3
1714373403799,SIOC 291S,A01,637333,Gabriel; Corey John,27,0,30,3
1714373404825,SOCI 117,A01,494376,Staff,0,3,5,5
1714373405852,WES 237B,A00,494380,Staff,9,0,20,11
1714373407911,AESE 279B,A00,494370,Wade; Jon P,0,0,33,33
1714373408934,AIP 197,001,627712,Vespa; Emanuel Ignacio,9998,0,9999,1
1714373409963,ANAR 135S,A00,494369,Braswell; Geoffrey E.,0,0,0,0
1714373410988,BENG 196,001,628496,Engler; Adam J.,9998,0,9999,1
1714373412012,CAT 124RS,A01,519847,Geibel; William,0,0,20,20
1714373413038,CAT 125RS,A01,515971,Geibel; William,0,0,20,20
1714373414063,CLRE 250,A00,511389,Morris; Sheldon,9993,0,9999,6
1714373415089,CLRE 251,A00,507176,Mehta; Ravindra L.,9993,0,9999,6
1714373415089,CLRE 251,B00,511410,Mehta; Ravindra L.,9998,0,9999,1
1714373416115,CLRE 252,A00,507189,Cuomo; Raphael Eduardo,9995,0,9999,4
1714373417141,CLRE 253,A00,507199,Vaida; Florin,9994,0,9999,5
1714373417141,CLRE 253,B00,507202,Vaida; Florin,9999,0,9999,0
1714373418225,CLRE 259,A00,507211,Patel; Hemal,9996,0,9999,3
1714373419249,CLRE 260,A00,507221,Cuomo; Raphael Eduardo,9999,0,9999,0
1714373420275,CLRE 297,001,507242,Cuomo; Raphael Eduardo,9999,0,9999,0
1714373421300,COGS 197,001,638244,Voytek; Bradley Thomas,9999,0,9999,0
1714373422325,CSE 191,A00,516875,Minnes Kemp; Mor Mia,9993,0,9999,6
1714373423349,CSE 197,001,637388,Minnes Kemp; Mor Mia,9998,0,9999,1
1714373424375,CSS 201S,A01,494383,Staff,35,0,35,0
1714373425399,CSS 202S,A01,494387,Staff,35,0,35,0
1714373426424,DSC 197,001,628532,Eldridge; Justin Matthew,9996,0,9999,3
1714373427449,EAP 100,A00,516065,Staff,9797,0,9999,202
1714373428478,ECE 45,A01,507414,Staff,33,0,60,27
1714373430528,ECE 111,A01,507420,Staff,19,0,50,31
1714373431552,ECE 197,001,548057,Sievenpiper; Daniel F.,9994,0,9999,5
1714373432578,EDS 115,A00,507243,Choi; Bailey Miyeon,12,0,28,16
1714373433608,EDS 117,A01,494379,Staff,0,2,30,30
1714373434632,EDS 125,A00,507246,Hopkins; Megan Beth,12,0,30,18
1714373435658,EDS 128A,A01,507264,Fargason; Sharon Gayle,14,0,26,12
1714373436687,EDS 128B,A01,507293,Pappas; Elizabeth,18,0,30,12
1714373437715,EDS 139,A00,507294,Fargason; Sharon Gayle,18,0,30,12
1714373437715,EDS 139,B00,507313,Pappas; Elizabeth,15,0,30,15
1714373438743,EDS 201,A00,507315,Staff,13,0,30,17
1714373439770,EDS 203,A01,507317,Halter; Christopher P.,12,0,30,18
1714373440798,EDS 204R,A01,507319,Halter; Christopher P.,0,3,30,30
1714373440798,EDS 204R,B01,507331,Heinzman; Erica M.,17,0,30,13
1714373441823,EDS 206R,A00,507332,Staff,0,4,30,30
1714373441823,EDS 206R,B00,507343,Staff,18,0,30,12
1714373442849,EDS 250,A00,507344,Hemans; Patricia Ann Benitez,22,0,40,18
1714373443875,EDS 281,A00,507345,Daly; Alan J.,18,0,18,0
1714373444900,EDS 284,A00,507350,Daly; Alan J.,16,0,16,0
1714373445924,EDS 286,A00,507359,Fine; Sarah,18,0,18,0
1714373446950,EDS 289C,A01,507361,Daly; Alan J.,18,0,18,0
1714373447977,EDS 290,A00,507366,Hofstetter; Carolyn,15,0,15,0
1714373449006,LIGM 5A,A00,507421,Fischer-Grunski; Eva K,18,0,20,2
1714373450037,LIGM 5B,A00,507423,Fischer-Grunski; Eva K,19,0,20,1
1714373451062,LIGM 5C,A00,507425,Fischer-Grunski; Eva K,19,0,20,1
1714373452092,LIIT 5AS,A00,507427,Carnelos; Chiara,20,0,20,0
1714373453118,LIIT 5BS,A00,507430,Carnelos; Chiara,20,0,20,0
1714373454147,LIIT 5CS,A00,507432,Carnelos; Chiara,20,0,20,0
1714373455178,LISP 5A,A00,507541,Munoz Sanchez; Alicia,11,0,20,9
1714373456207,LISP 5B,A00,507671,Munoz Sanchez; Alicia,9,0,20,11
1714373457233,LISP 5C,A00,507696,Munoz Sanchez; Alicia,9,0,20,11
1714373458261,MAE 197,001,528363,Boechler; Nicholas Sebastia,9998,0,9999,1
1714373459286,MATH 197,001,523477,Kedlaya; Kiran S.,9996,0,9999,3
1714373459286,MATH 197,002,563811,Zhang; Danna,9995,0,9999,4
1714373459286,MATH 197,003,628552,Dumitriu; Ioana,9998,0,9999,1
1714373460311,MCWP 40R,A00,518780,Staff,5,0,20,15
1714373460311,MCWP 40R,B00,518781,Staff,7,0,20,13
1714373460311,MCWP 40R,C00,518783,Staff,5,0,20,15
1714373461336,MCWP 50R,A00,518791,Staff,0,0,20,20
1714373461336,MCWP 50R,B00,518792,Staff,0,1,20,20
1714373461336,MCWP 50R,C00,518793,Staff,0,1,20,20
1714373461336,MCWP 50R,D00,518794,Staff,0,0,20,20
1714373461336,MCWP 50R,E00,518795,Staff,0,1,20,20
1714373461336,MCWP 50R,F00,518796,Staff,0,0,20,20
1714373461336,MCWP 50R,G00,518797,Staff,0,1,20,20
1714373462362,MMW 12R,A01,514034,Herbst; Matthew,0,1,16,16
1714373462362,MMW 12R,A02,514035,Herbst; Matthew,2,0,16,14
1714373463391,MMW 13R,A01,514037,Staff,0,4,16,16
1714373463391,MMW 13R,A02,514039,Staff,0,2,16,16
1714373463391,MMW 13R,A03,628519,Staff,0,2,16,16
1714373465447,SIO 295LS,A00,523233,Staff,12,0,30,18
1714373466476,SIO 295S,A00,523232,Staff,12,0,30,18
1714373467505,SIOC 290S,A01,637330,Merrifield; Mark A,27,0,30,3
1714373468530,SIOC 291S,A01,637333,Gabriel; Corey John,27,0,30,3
1714373469555,SOCI 117,A01,494376,Staff,0,3,5,5
1714373470580,WES 237B,A00,494380,Staff,9,0,20,11
1714373472650,AESE 279B,A00,494370,Wade; Jon P,0,0,33,33
1714373473675,AIP 197,001,627712,Vespa; Emanuel Ignacio,9998,0,9999,1
1714373474703,ANAR 135S,A00,494369,Braswell; Geoffrey E.,0,0,0,0
1714373475732,BENG 196,001,628496,Engler; Adam J.,9998,0,9999,1
1714373476758,CAT 124RS,A01,519847,Geibel; William,0,0,20,20
1714373477783,CAT 125RS,A01,515971,Geibel; William,0,0,20,20
1714373478809,CLRE 250,A00,511389,Morris; Sheldon,9993,0,9999,6
1714373479835,CLRE 251,A00,507176,Mehta; Ravindra L.,9993,0,9999,6
1714373479835,CLRE 251,B00,511410,Mehta; Ravindra L.,9998,0,9999,1
1714373480860,CLRE 252,A00,507189,Cuomo; Raphael Eduardo,9995,0,9999,4
1714373481886,CLRE 253,A00,507199,Vaida; Florin,9994,0,9999,5
1714373481886,CLRE 253,B00,507202,Vaida; Florin,9999,0,9999,0
1714373482913,CLRE 259,A00,507211,Patel; Hemal,9996,0,9999,3
1714373483937,CLRE 260,A00,507221,Cuomo; Raphael Eduardo,9999,0,9999,0
1714373484966,CLRE 297,001,507242,Cuomo; Raphael Eduardo,9999,0,9999,0
1714373485993,COGS 197,001,638244,Voytek; Bradley Thomas,9999,0,9999,0
1714373487022,CSE 191,A00,516875,Minnes Kemp; Mor Mia,9993,0,9999,6
1714373488049,CSE 197,001,637388,Minnes Kemp; Mor Mia,9998,0,9999,1
1714373489074,CSS 201S,A01,494383,Staff,35,0,35,0
1714373490098,CSS 202S,A01,494387,Staff,35,0,35,0
1714373491123,DSC 197,001,628532,Eldridge; Justin Matthew,9996,0,9999,3
1714373492148,EAP 100,A00,516065,Staff,9797,0,9999,202
1714373493177,ECE 45,A01,507414,Staff,33,0,60,27
1714373495230,ECE 111,A01,507420,Staff,19,0,50,31
1714373496259,ECE 197,001,548057,Sievenpiper; Daniel F.,9994,0,9999,5
1714373497285,EDS 115,A00,507243,Choi; Bailey Miyeon,12,0,28,16
1714373498313,EDS 117,A01,494379,Staff,0,2,30,30
1714373499338,EDS 125,A00,507246,Hopkins; Megan Beth,12,0,30,18
1714373500365,EDS 128A,A01,507264,Fargason; Sharon Gayle,14,0,26,12
1714373501392,EDS 128B,A01,507293,Pappas; Elizabeth,18,0,30,12
1714373502416,EDS 139,A00,507294,Fargason; Sharon Gayle,18,0,30,12
1714373502416,EDS 139,B00,507313,Pappas; Elizabeth,15,0,30,15
1714373503439,EDS 201,A00,507315,Staff,13,0,30,17
1714373504468,EDS 203,A01,507317,Halter; Christopher P.,12,0,30,18
1714373505493,EDS 204R,A01,507319,Halter; Christopher P.,0,3,30,30
1714373505493,EDS 204R,B01,507331,Heinzman; Erica M.,17,0,30,13
1714373506516,EDS 206R,A00,507332,Staff,0,4,30,30
1714373506516,EDS 206R,B00,507343,Staff,18,0,30,12
1714373507542,EDS 250,A00,507344,Hemans; Patricia Ann Benitez,22,0,40,18
1714373508567,EDS 281,A00,507345,Daly; Alan J.,18,0,18,0
1714373509591,EDS 284,A00,507350,Daly; Alan J.,16,0,16,0
1714373510616,EDS 286,A00,507359,Fine; Sarah,18,0,18,0
1714373511648,EDS 289C,A01,507361,Daly; Alan J.,18,0,18,0
1714373512676,EDS 290,A00,507366,Hofstetter; Carolyn,15,0,15,0
1714373513704,LIGM 5A,A00,507421,Fischer-Grunski; Eva K,18,0,20,2
1714373514729,LIGM 5B,A00,507423,Fischer-Grunski; Eva K,19,0,20,1
1714373515755,LIGM 5C,A00,507425,Fischer-Grunski; Eva K,19,0,20,1
1714373516780,LIIT 5AS,A00,507427,Carnelos; Chiara,20,0,20,0
1714373517809,LIIT 5BS,A00,507430,Carnelos; Chiara,20,0,20,0
1714373518834,LIIT 5CS,A00,507432,Carnelos; Chiara,20,0,20,0
1714373519858,LISP 5A,A00,507541,Munoz Sanchez; Alicia,11,0,20,9
1714373520883,LISP 5B,A00,507671,Munoz Sanchez; Alicia,9,0,20,11
1714373521969,LISP 5C,A00,507696,Munoz Sanchez; Alicia,9,0,20,11
1714373522996,MAE 197,001,528363,Boechler; Nicholas Sebastia,9998,0,9999,1
1714373524026,MATH 197,001,523477,Kedlaya; Kiran S.,9996,0,9999,3
1714373524026,MATH 197,002,563811,Zhang; Danna,9995,0,9999,4
1714373524026,MATH 197,003,628552,Dumitriu; Ioana,9998,0,9999,1
1714373525053,MCWP 40R,A00,518780,Staff,5,0,20,15
1714373525053,MCWP 40R,B00,518781,Staff,7,0,20,13
1714373525053,MCWP 40R,C00,518783,Staff,5,0,20,15
1714373526083,MCWP 50R,A00,518791,Staff,0,0,20,20
1714373526083,MCWP 50R,B00,518792,Staff,0,1,20,20
1714373526083,MCWP 50R,C00,518793,Staff,0,1,20,20
1714373526083,MCWP 50R,D00,518794,Staff,0,0,20,20
1714373526083,MCWP 50R,E00,518795,Staff,0,1,20,20
1714373526083,MCWP 50R,F00,518796,Staff,0,0,20,20
1714373526083,MCWP 50R,G00,518797,Staff,0,1,20,20
1714373527111,MMW 12R,A01,514034,Herbst; Matthew,0,1,16,16
1714373527111,MMW 12R,A02,514035,Herbst; Matthew,2,0,16,14
1714373528136,MMW 13R,A01,514037,Staff,0,4,16,16
1714373528136,MMW 13R,A02,514039,Staff,0,2,16,16
1714373528136,MMW 13R,A03,628519,Staff,0,2,16,16
1714373530186,SIO 295LS,A00,523233,Staff,12,0,30,18
1714373531214,SIO 295S,A00,523232,Staff,12,0,30,18
1714373532243,SIOC 290S,A01,637330,Merrifield; Mark A,27,0,30,3
1714373533269,SIOC 291S,A01,637333,Gabriel; Corey John,27,0,30,3
1714373534296,SOCI 117,A01,494376,Staff,0,3,5,5
1714373535324,WES 237B,A00,494380,Staff,9,0,20,11
1714373537384,AESE 279B,A00,494370,Wade; Jon P,0,0,33,33
1714373538409,AIP 197,001,627712,Vespa; Emanuel Ignacio,9998,0,9999,1
1714373539434,ANAR 135S,A00,494369,Braswell; Geoffrey E.,0,0,0,0
1714373540460,BENG 196,001,628496,Engler; Adam J.,9998,0,9999,1
1714373541489,CAT 124RS,A01,519847,Geibel; William,0,0,20,20
1714373542517,CAT 125RS,A01,515971,Geibel; William,0,0,20,20
1714373543543,CLRE 250,A00,511389,Morris; Sheldon,9993,0,9999,6
1714373544571,CLRE 251,A00,507176,Mehta; Ravindra L.,9993,0,9999,6
1714373544571,CLRE 251,B00,511410,Mehta; Ravindra L.,9998,0,9999,1
1714373545597,CLRE 252,A00,507189,Cuomo; Raphael Eduardo,9995,0,9999,4
1714373546623,CLRE 253,A00,507199,Vaida; Florin,9994,0,9999,5
1714373546623,CLRE 253,B00,507202,Vaida; Florin,9999,0,9999,0
1714373547648,CLRE 259,A00,507211,Patel; Hemal,9996,0,9999,3
1714373548673,CLRE 260,A00,507221,Cuomo; Raphael Eduardo,9999,0,9999,0
1714373549702,CLRE 297,001,507242,Cuomo; Raphael Eduardo,9999,0,9999,0
1714373550728,COGS 197,001,638244,Voytek; Bradley Thomas,9999,0,9999,0
1714373551753,CSE 191,A00,516875,Minnes Kemp; Mor Mia,9993,0,9999,6
1714373552778,CSE 197,001,637388,Minnes Kemp; Mor Mia,9998,0,9999,1
1714373553805,CSS 201S,A01,494383,Staff,35,0,35,0
1714373554834,CSS 202S,A01,494387,Staff,35,0,35,0
1714373555862,DSC 197,001,628532,Eldridge; Justin Matthew,9996,0,9999,3
1714373556887,EAP 100,A00,516065,Staff,9797,0,9999,202
1714373557912,ECE 45,A01,507414,Staff,33,0,60,27
1714373559961,ECE 111,A01,507420,Staff,19,0,50,31
1714373560987,ECE 197,001,548057,Sievenpiper; Daniel F.,9994,0,9999,5
1714373562013,EDS 115,A00,507243,Choi; Bailey Miyeon,12,0,28,16
1714373563040,EDS 117,A01,494379,Staff,0,2,30,30
1714373564066,EDS 125,A00,507246,Hopkins; Megan Beth,12,0,30,18
1714373565094,EDS 128A,A01,507264,Fargason; Sharon Gayle,14,0,26,12
1714373566124,EDS 128B,A01,507293,Pappas; Elizabeth,18,0,30,12
1714373567152,EDS 139,A00,507294,Fargason; Sharon Gayle,18,0,30,12
1714373567152,EDS 139,B00,507313,Pappas; Elizabeth,15,0,30,15
1714373568176,EDS 201,A00,507315,Staff,13,0,30,17
1714373569202,EDS 203,A01,507317,Halter; Christopher P.,12,0,30,18
1714373570226,EDS 204R,A01,507319,Halter; Christopher P.,0,3,30,30
1714373570226,EDS 204R,B01,507331,Heinzman; Erica M.,17,0,30,13
1714373571250,EDS 206R,A00,507332,Staff,0,4,30,30
1714373571250,EDS 206R,B00,507343,Staff,18,0,30,12
1714373572276,EDS 250,A00,507344,Hemans; Patricia Ann Benitez,22,0,40,18
1714373573300,EDS 281,A00,507345,Daly; Alan J.,18,0,18,0
1714373574325,EDS 284,A00,507350,Daly; Alan J.,16,0,16,0
1714373575351,EDS 286,A00,507359,Fine; Sarah,18,0,18,0
1714373576378,EDS 289C,A01,507361,Daly; Alan J.,18,0,18,0
1714373577402,EDS 290,A00,507366,Hofstetter; Carolyn,15,0,15,0
1714373578429,LIGM 5A,A00,507421,Fischer-Grunski; Eva K,18,0,20,2
1714373579454,LIGM 5B,A00,507423,Fischer-Grunski; Eva K,19,0,20,1
1714373580480,LIGM 5C,A00,507425,Fischer-Grunski; Eva K,19,0,20,1
1714373581505,LIIT 5AS,A00,507427,Carnelos; Chiara,20,0,20,0
1714373582529,LIIT 5BS,A00,507430,Carnelos; Chiara,20,0,20,0
1714373583556,LIIT 5CS,A00,507432,Carnelos; Chiara,20,0,20,0
1714373584587,LISP 5A,A00,507541,Munoz Sanchez; Alicia,11,0,20,9
1714373585617,LISP 5B,A00,507671,Munoz Sanchez; Alicia,9,0,20,11
1714373586644,LISP 5C,A00,507696,Munoz Sanchez; Alicia,9,0,20,11
1714373587668,MAE 197,001,528363,Boechler; Nicholas Sebastia,9998,0,9999,1
1714373588693,MATH 197,001,523477,Kedlaya; Kiran S.,9996,0,9999,3
1714373588693,MATH 197,002,563811,Zhang; Danna,9995,0,9999,4
1714373588693,MATH 197,003,628552,Dumitriu; Ioana,9998,0,9999,1
1714373589723,MCWP 40R,A00,518780,Staff,5,0,20,15
1714373589723,MCWP 40R,B00,518781,Staff,7,0,20,13
1714373589723,MCWP 40R,C00,518783,Staff,5,0,20,15
1714373590755,MCWP 50R,A00,518791,Staff,0,0,20,20
1714373590755,MCWP 50R,B00,518792,Staff,0,1,20,20
1714373590755,MCWP 50R,C00,518793,Staff,0,1,20,20
1714373590755,MCWP 50R,D00,518794,Staff,0,0,20,20
1714373590755,MCWP 50R,E00,518795,Staff,0,1,20,20
1714373590755,MCWP 50R,F00,518796,Staff,0,0,20,20
1714373590755,MCWP 50R,G00,518797,Staff,0,1,20,20
1714373591783,MMW 12R,A01,514034,Herbst; Matthew,0,1,16,16
1714373591783,MMW 12R,A02,514035,Herbst; Matthew,2,0,16,14
1714373592812,MMW 13R,A01,514037,Staff,0,4,16,16
1714373592812,MMW 13R,A02,514039,Staff,0,2,16,16
1714373592812,MMW 13R,A03,628519,Staff,0,2,16,16
1714373594864,SIO 295LS,A00,523233,Staff,12,0,30,18
1714373595889,SIO 295S,A00,523232,Staff,12,0,30,18
1714373596917,SIOC 290S,A01,637330,Merrifield; Mark A,27,0,30,3
1714373597943,SIOC 291S,A01,637333,Gabriel; Corey John,27,0,30,3
1714373598968,SOCI 117,A01,494376,Staff,0,3,5,5
1714373599992,WES 237B,A00,494380,Staff,9,0,20,11
1714373602058,AESE 279B,A00,494370,Wade; Jon P,0,0,33,33
1714373603085,AIP 197,001,627712,Vespa; Emanuel Ignacio,9998,0,9999,1
1714373604111,ANAR 135S,A00,494369,Braswell; Geoffrey E.,0,0,0,0
1714373605136,BENG 196,001,628496,Engler; Adam J.,9998,0,9999,1
1714373606161,CAT 124RS,A01,519847,Geibel; William,0,0,20,20
1714373607186,CAT 125RS,A01,515971,Geibel; William,0,0,20,20
1714373608210,CLRE 250,A00,511389,Morris; Sheldon,9993,0,9999,6
1714373609235,CLRE 251,A00,507176,Mehta; Ravindra L.,9993,0,9999,6
1714373609235,CLRE 251,B00,511410,Mehta; Ravindra L.,9998,0,9999,1
1714373610260,CLRE 252,A00,507189,Cuomo; Raphael Eduardo,9995,0,9999,4
1714373611286,CLRE 253,A00,507199,Vaida; Florin,9994,0,9999,5
1714373611286,CLRE 253,B00,507202,Vaida; Florin,9999,0,9999,0
1714373612309,CLRE 259,A00,507211,Patel; Hemal,9996,0,9999,3
1714373613334,CLRE 260,A00,507221,Cuomo; Raphael Eduardo,9999,0,9999,0
1714373614360,CLRE 297,001,507242,Cuomo; Raphael Eduardo,9999,0,9999,0
1714373615385,COGS 197,001,638244,Voytek; Bradley Thomas,9999,0,9999,0
1714373616413,CSE 191,A00,516875,Minnes Kemp; Mor Mia,9993,0,9999,6
1714373617437,CSE 197,001,637388,Minnes Kemp; Mor Mia,9998,0,9999,1
1714373618463,CSS 201S,A01,494383,Staff,35,0,35,0
1714373619489,CSS 202S,A01,494387,Staff,35,0,35,0
1714373620518,DSC 197,001,628532,Eldridge; Justin Matthew,9996,0,9999,3
1714373621547,EAP 100,A00,516065,Staff,9797,0,9999,202
1714373622571,ECE 45,A01,507414,Staff,33,0,60,27
1714373624624,ECE 111,A01,507420,Staff,19,0,50,31
1714373625705,ECE 197,001,548057,Sievenpiper; Daniel F.,9994,0,9999,5
1714373626736,EDS 115,A00,507243,Choi; Bailey Miyeon,12,0,28,16
1714373627766,EDS 117,A01,494379,Staff,0,2,30,30
1714373628796,EDS 125,A00,507246,Hopkins; Megan Beth,12,0,30,18
1714373629823,EDS 128A,A01,507264,Fargason; Sharon Gayle,14,0,26,12
1714373630849,EDS 128B,A01,507293,Pappas; Elizabeth,18,0,30,12
1714373631882,EDS 139,A00,507294,Fargason; Sharon Gayle,18,0,30,12
1714373631882,EDS 139,B00,507313,Pappas; Elizabeth,15,0,30,15
1714373632908,EDS 201,A00,507315,Staff,13,0,30,17
1714373633934,EDS 203,A01,507317,Halter; Christopher P.,12,0,30,18
1714373634966,EDS 204R,A01,507319,Halter; Christopher P.,0,3,30,30
1714373634966,EDS 204R,B01,507331,Heinzman; Erica M.,17,0,30,13
1714373635992,EDS 206R,A00,507332,Staff,0,4,30,30
1714373635992,EDS 206R,B00,507343,Staff,18,0,30,12
1714373637018,EDS 250,A00,507344,Hemans; Patricia Ann Benitez,22,0,40,18
1714373638043,EDS 281,A00,507345,Daly; Alan J.,18,0,18,0
1714373639068,EDS 284,A00,507350,Daly; Alan J.,16,0,16,0
1714373640095,EDS 286,A00,507359,Fine; Sarah,18,0,18,0
1714373641122,EDS 289C,A01,507361,Daly; Alan J.,18,0,18,0
1714373642147,EDS 290,A00,507366,Hofstetter; Carolyn,15,0,15,0
1714373643173,LIGM 5A,A00,507421,Fischer-Grunski; Eva K,18,0,20,2
1714373644198,LIGM 5B,A00,507423,Fischer-Grunski; Eva K,19,0,20,1
1714373645224,LIGM 5C,A00,507425,Fischer-Grunski; Eva K,19,0,20,1
1714373646249,LIIT 5AS,A00,507427,Carnelos; Chiara,20,0,20,0
1714373647278,LIIT 5BS,A00,507430,Carnelos; Chiara,20,0,20,0
1714373648303,LIIT 5CS,A00,507432,Carnelos; Chiara,20,0,20,0
1714373649329,LISP 5A,A00,507541,Munoz Sanchez; Alicia,11,0,20,9
1714373650356,LISP 5B,A00,507671,Munoz Sanchez; Alicia,9,0,20,11
1714373651381,LISP 5C,A00,507696,Munoz Sanchez; Alicia,9,0,20,11
1714373652410,MAE 197,001,528363,Boechler; Nicholas Sebastia,9998,0,9999,1
1714373653434,MATH 197,001,523477,Kedlaya; Kiran S.,9996,0,9999,3
1714373653434,MATH 197,002,563811,Zhang; Danna,9995,0,9999,4
1714373653434,MATH 197,003,628552,Dumitriu; Ioana,9998,0,9999,1
1714373654461,MCWP 40R,A00,518780,Staff,5,0,20,15
1714373654461,MCWP 40R,B00,518781,Staff,7,0,20,13
1714373654461,MCWP 40R,C00,518783,Staff,5,0,20,15
1714373655492,MCWP 50R,A00,518791,Staff,0,0,20,20
1714373655492,MCWP 50R,B00,518792,Staff,0,1,20,20
1714373655492,MCWP 50R,C00,518793,Staff,0,1,20,20
1714373655492,MCWP 50R,D00,518794,Staff,0,0,20,20
1714373655492,MCWP 50R,E00,518795,Staff,0,1,20,20
1714373655492,MCWP 50R,F00,518796,Staff,0,0,20,20
1714373655492,MCWP 50R,G00,518797,Staff,0,1,20,20
1714373656517,MMW 12R,A01,514034,Herbst; Matthew,0,1,16,16
1714373656517,MMW 12R,A02,514035,Herbst; Matthew,2,0,16,14
1714373657545,MMW 13R,A01,514037,Staff,0,4,16,16
1714373657545,MMW 13R,A02,514039,Staff,0,2,16,16
1714373657545,MMW 13R,A03,628519,Staff,0,2,16,16
1714373659596,SIO 295LS,A00,523233,Staff,12,0,30,18
1714373660622,SIO 295S,A00,523232,Staff,12,0,30,18
1714373661651,SIOC 290S,A01,637330,Merrifield; Mark A,27,0,30,3
1714373662681,SIOC 291S,A01,637333,Gabriel; Corey John,27,0,30,3
1714373663711,SOCI 117,A01,494376,Staff,0,3,5,5
1714373664738,WES 237B,A00,494380,Staff,9,0,20,11
1714373666796,AESE 279B,A00,494370,Wade; Jon P,0,0,33,33
1714373667820,AIP 197,001,627712,Vespa; Emanuel Ignacio,9998,0,9999,1
1714373668846,ANAR 135S,A00,494369,Braswell; Geoffrey E.,0,0,0,0
1714373669872,BENG 196,001,628496,Engler; Adam J.,9998,0,9999,1
1714373670898,CAT 124RS,A01,519847,Geibel; William,0,0,20,20
1714373671924,CAT 125RS,A01,515971,Geibel; William,0,0,20,20
1714373672950,CLRE 250,A00,511389,Morris; Sheldon,9993,0,9999,6
1714373673975,CLRE 251,A00,507176,Mehta; Ravindra L.,9993,0,9999,6
1714373673975,CLRE 251,B00,511410,Mehta; Ravindra L.,9998,0,9999,1
1714373675002,CLRE 252,A00,507189,Cuomo; Raphael Eduardo,9995,0,9999,4
1714373676030,CLRE 253,A00,507199,Vaida; Florin,9994,0,9999,5
1714373676030,CLRE 253,B00,507202,Vaida; Florin,9999,0,9999,0
1714373677061,CLRE 259,A00,507211,Patel; Hemal,9996,0,9999,3
1714373678085,CLRE 260,A00,507221,Cuomo; Raphael Eduardo,9999,0,9999,0
1714373679112,CLRE 297,001,507242,Cuomo; Raphael Eduardo,9999,0,9999,0
1714373680138,COGS 197,001,638244,Voytek; Bradley Thomas,9999,0,9999,0
1714373681163,CSE 191,A00,516875,Minnes Kemp; Mor Mia,9993,0,9999,6
1714373682192,CSE 197,001,637388,Minnes Kemp; Mor Mia,9998,0,9999,1
1714373683223,CSS 201S,A01,494383,Staff,35,0,35,0
1714373684249,CSS 202S,A01,494387,Staff,35,0,35,0
1714373685277,DSC 197,001,628532,Eldridge; Justin Matthew,9996,0,9999,3
1714373686305,EAP 100,A00,516065,Staff,9797,0,9999,202
1714373687333,ECE 45,A01,507414,Staff,33,0,60,27
1714373689381,ECE 111,A01,507420,Staff,19,0,50,31
1714373690408,ECE 197,001,548057,Sievenpiper; Daniel F.,9994,0,9999,5
1714373691437,EDS 115,A00,507243,Choi; Bailey Miyeon,12,0,28,16
1714373692464,EDS 117,A01,494379,Staff,0,2,30,30
1714373693492,EDS 125,A00,507246,Hopkins; Megan Beth,12,0,30,18
1714373694520,EDS 128A,A01,507264,Fargason; Sharon Gayle,14,0,26,12
1714373695547,EDS 128B,A01,507293,Pappas; Elizabeth,18,0,30,12
1714373696573,EDS 139,A00,507294,Fargason; Sharon Gayle,18,0,30,12
1714373696573,EDS 139,B00,507313,Pappas; Elizabeth,15,0,30,15
1714373697602,EDS 201,A00,507315,Staff,13,0,30,17
1714373698628,EDS 203,A01,507317,Halter; Christopher P.,12,0,30,18
1714373699654,EDS 204R,A01,507319,Halter; Christopher P.,0,3,30,30
1714373699654,EDS 204R,B01,507331,Heinzman; Erica M.,17,0,30,13
1714373700681,EDS 206R,A00,507332,Staff,0,4,30,30
1714373700681,EDS 206R,B00,507343,Staff,18,0,30,12
1714373701707,EDS 250,A00,507344,Hemans; Patricia Ann Benitez,22,0,40,18
1714373702732,EDS 281,A00,507345,Daly; Alan J.,18,0,18,0
1714373703757,EDS 284,A00,507350,Daly; Alan J.,16,0,16,0
1714373704783,EDS 286,A00,507359,Fine; Sarah,18,0,18,0
1714373705812,EDS 289C,A01,507361,Daly; Alan J.,18,0,18,0
1714373706841,EDS 290,A00,507366,Hofstetter; Carolyn,15,0,15,0
1714373707870,LIGM 5A,A00,507421,Fischer-Grunski; Eva K,18,0,20,2
1714373708896,LIGM 5B,A00,507423,Fischer-Grunski; Eva K,19,0,20,1
1714373709922,LIGM 5C,A00,507425,Fischer-Grunski; Eva K,19,0,20,1
1714373710948,LIIT 5AS,A00,507427,Carnelos; Chiara,20,0,20,0
1714373711977,LIIT 5BS,A00,507430,Carnelos; Chiara,20,0,20,0
1714373713003,LIIT 5CS,A00,507432,Carnelos; Chiara,20,0,20,0
1714373714033,LISP 5A,A00,507541,Munoz Sanchez; Alicia,11,0,20,9
1714373715061,LISP 5B,A00,507671,Munoz Sanchez; Alicia,9,0,20,11
1714373716088,LISP 5C,A00,507696,Munoz Sanchez; Alicia,9,0,20,11
1714373717114,MAE 197,001,528363,Boechler; Nicholas Sebastia,9998,0,9999,1
1714373718142,MATH 197,001,523477,Kedlaya; Kiran S.,9996,0,9999,3
1714373718142,MATH 197,002,563811,Zhang; Danna,9995,0,9999,4
1714373718142,MATH 197,003,628552,Dumitriu; Ioana,9998,0,9999,1
1714373719169,MCWP 40R,A00,518780,Staff,5,0,20,15
1714373719169,MCWP 40R,B00,518781,Staff,7,0,20,13
1714373719169,MCWP 40R,C00,518783,Staff,5,0,20,15
1714373720200,MCWP 50R,A00,518791,Staff,0,0,20,20
1714373720200,MCWP 50R,B00,518792,Staff,0,1,20,20
1714373720200,MCWP 50R,C00,518793,Staff,0,1,20,20
1714373720200,MCWP 50R,D00,518794,Staff,0,0,20,20
1714373720200,MCWP 50R,E00,518795,Staff,0,1,20,20
1714373720200,MCWP 50R,F00,518796,Staff,0,0,20,20
1714373720200,MCWP 50R,G00,518797,Staff,0,1,20,20
1714373721230,MMW 12R,A01,514034,Herbst; Matthew,0,1,16,16
1714373721230,MMW 12R,A02,514035,Herbst; Matthew,2,0,16,14
1714373722261,MMW 13R,A01,514037,Staff,0,4,16,16
1714373722261,MMW 13R,A02,514039,Staff,0,2,16,16
1714373722261,MMW 13R,A03,628519,Staff,0,2,16,16
1714373724313,SIO 295LS,A00,523233,Staff,12,0,30,18
1714373725338,SIO 295S,A00,523232,Staff,12,0,30,18
1714373726363,SIOC 290S,A01,637330,Merrifield; Mark A,27,0,30,3
1714373727392,SIOC 291S,A01,637333,Gabriel; Corey John,27,0,30,3
1714373728418,SOCI 117,A01,494376,Staff,0,3,5,5
1714373729498,WES 237B,A00,494380,Staff,9,0,20,11
1714373731568,AESE 279B,A00,494370,Wade; Jon P,0,0,33,33
1714373732593,AIP 197,001,627712,Vespa; Emanuel Ignacio,9998,0,9999,1
1714373733621,ANAR 135S,A00,494369,Braswell; Geoffrey E.,0,0,0,0
1714373734647,BENG 196,001,628496,Engler; Adam J.,9998,0,9999,1
1714373735672,CAT 124RS,A01,519847,Geibel; William,0,0,20,20
1714373736700,CAT 125RS,A01,515971,Geibel; William,0,0,20,20
1714373737725,CLRE 250,A00,511389,Morris; Sheldon,9993,0,9999,6
1714373738757,CLRE 251,A00,507176,Mehta; Ravindra L.,9993,0,9999,6
1714373738757,CLRE 251,B00,511410,Mehta; Ravindra L.,9998,0,9999,1
1714373739783,CLRE 252,A00,507189,Cuomo; Raphael Eduardo,9995,0,9999,4
1714373740809,CLRE 253,A00,507199,Vaida; Florin,9994,0,9999,5
1714373740809,CLRE 253,B00,507202,Vaida; Florin,9999,0,9999,0
1714373741836,CLRE 259,A00,507211,Patel; Hemal,9996,0,9999,3
1714373742862,CLRE 260,A00,507221,Cuomo; Raphael Eduardo,9999,0,9999,0
1714373743896,CLRE 297,001,507242,Cuomo; Raphael Eduardo,9999,0,9999,0
1714373744926,COGS 197,001,638244,Voytek; Bradley Thomas,9999,0,9999,0
1714373745952,CSE 191,A00,516875,Minnes Kemp; Mor Mia,9993,0,9999,6
1714373746977,CSE 197,001,637388,Minnes Kemp; Mor Mia,9998,0,9999,1
1714373748007,CSS 201S,A01,494383,Staff,35,0,35,0
1714373749031,CSS 202S,A01,494387,Staff,35,0,35,0
1714373750059,DSC 197,001,628532,Eldridge; Justin Matthew,9996,0,9999,3
1714373751088,EAP 100,A00,516065,Staff,9797,0,9999,202
1714373752116,ECE 45,A01,507414,Staff,33,0,60,27
1714373754170,ECE 111,A01,507420,Staff,19,0,50,31
1714373755195,ECE 197,001,548057,Sievenpiper; Daniel F.,9994,0,9999,5
1714373756221,EDS 115,A00,507243,Choi; Bailey Miyeon,12,0,28,16
1714373757249,EDS 117,A01,494379,Staff,0,2,30,30
1714373758277,EDS 125,A00,507246,Hopkins; Megan Beth,12,0,30,18
1714373759306,EDS 128A,A01,507264,Fargason; Sharon Gayle,14,0,26,12
1714373760331,EDS 128B,A01,507293,Pappas; Elizabeth,18,0,30,12
1714373761356,EDS 139,A00,507294,Fargason; Sharon Gayle,18,0,30,12
1714373761356,EDS 139,B00,507313,Pappas; Elizabeth,15,0,30,15
1714373762384,EDS 201,A00,507315,Staff,13,0,30,17
1714373763413,EDS 203,A01,507317,Halter; Christopher P.,12,0,30,18
1714373764440,EDS 204R,A01,507319,Halter; Christopher P.,0,3,30,30
1714373764440,EDS 204R,B01,507331,Heinzman; Erica M.,17,0,30,13
1714373765466,EDS 206R,A00,507332,Staff,0,4,30,30
1714373765466,EDS 206R,B00,507343,Staff,18,0,30,12
1714373766493,EDS 250,A00,507344,Hemans; Patricia Ann Benitez,22,0,40,18
1714373767520,EDS 281,A00,507345,Daly; Alan J.,18,0,18,0
1714373768545,EDS 284,A00,507350,Daly; Alan J.,16,0,16,0
1714373769574,EDS 286,A00,507359,Fine; Sarah,18,0,18,0
1714373770598,EDS 289C,A01,507361,Daly; Alan J.,18,0,18,0
1714373771623,EDS 290,A00,507366,Hofstetter; Carolyn,15,0,15,0
1714373772654,LIGM 5A,A00,507421,Fischer-Grunski; Eva K,18,0,20,2
1714373773679,LIGM 5B,A00,507423,Fischer-Grunski; Eva K,19,0,20,1
1714373774708,LIGM 5C,A00,507425,Fischer-Grunski; Eva K,19,0,20,1
1714373775739,LIIT 5AS,A00,507427,Carnelos; Chiara,20,0,20,0
1714373776768,LIIT 5BS,A00,507430,Carnelos; Chiara,20,0,20,0
1714373777795,LIIT 5CS,A00,507432,Carnelos; Chiara,20,0,20,0
1714373778824,LISP 5A,A00,507541,Munoz Sanchez; Alicia,11,0,20,9
1714373779850,LISP 5B,A00,507671,Munoz Sanchez; Alicia,9,0,20,11
1714373780879,LISP 5C,A00,507696,Munoz Sanchez; Alicia,9,0,20,11
1714373781905,MAE 197,001,528363,Boechler; Nicholas Sebastia,9998,0,9999,1
1714373782936,MATH 197,001,523477,Kedlaya; Kiran S.,9996,0,9999,3
1714373782936,MATH 197,002,563811,Zhang; Danna,9995,0,9999,4
1714373782936,MATH 197,003,628552,Dumitriu; Ioana,9998,0,9999,1
1714373783961,MCWP 40R,A00,518780,Staff,5,0,20,15
1714373783961,MCWP 40R,B00,518781,Staff,7,0,20,13
1714373783961,MCWP 40R,C00,518783,Staff,5,0,20,15
1714373784991,MCWP 50R,A00,518791,Staff,0,0,20,20
1714373784991,MCWP 50R,B00,518792,Staff,0,1,20,20
1714373784991,MCWP 50R,C00,518793,Staff,0,1,20,20
1714373784991,MCWP 50R,D00,518794,Staff,0,0,20,20
1714373784991,MCWP 50R,E00,518795,Staff,0,1,20,20
1714373784991,MCWP 50R,F00,518796,Staff,0,0,20,20
1714373784991,MCWP 50R,G00,518797,Staff,0,1,20,20
1714373786018,MMW 12R,A01,514034,Herbst; Matthew,0,1,16,16
1714373786018,MMW 12R,A02,514035,Herbst; Matthew,2,0,16,14
1714373787048,MMW 13R,A01,514037,Staff,0,4,16,16
1714373787048,MMW 13R,A02,514039,Staff,0,2,16,16
1714373787048,MMW 13R,A03,628519,Staff,0,2,16,16
1714373789099,SIO 295LS,A00,523233,Staff,12,0,30,18
1714373790126,SIO 295S,A00,523232,Staff,12,0,30,18
1714373791152,SIOC 290S,A01,637330,Merrifield; Mark A,27,0,30,3
1714373792179,SIOC 291S,A01,637333,Gabriel; Corey John,27,0,30,3
1714373793208,SOCI 117,A01,494376,Staff,0,3,5,5
1714373794233,WES 237B,A00,494380,Staff,9,0,20,11
1714373796291,AESE 279B,A00,494370,Wade; Jon P,0,0,33,33
1714373797317,AIP 197,001,627712,Vespa; Emanuel Ignacio,9998,0,9999,1
1714373798343,ANAR 135S,A00,494369,Braswell; Geoffrey E.,0,0,0,0
1714373799368,BENG 196,001,628496,Engler; Adam J.,9998,0,9999,1
1714373800399,CAT 124RS,A01,519847,Geibel; William,0,0,20,20
1714373801424,CAT 125RS,A01,515971,Geibel; William,0,0,20,20
1714373802449,CLRE 250,A00,511389,Morris; Sheldon,9993,0,9999,6
1714373803476,CLRE 251,A00,507176,Mehta; Ravindra L.,9993,0,9999,6
1714373803476,CLRE 251,B00,511410,Mehta; Ravindra L.,9998,0,9999,1
1714373804502,CLRE 252,A00,507189,Cuomo; Raphael Eduardo,9995,0,9999,4
1714373805532,CLRE 253,A00,507199,Vaida; Florin,9994,0,9999,5
1714373805532,CLRE 253,B00,507202,Vaida; Florin,9999,0,9999,0
1714373806558,CLRE 259,A00,507211,Patel; Hemal,9996,0,9999,3
1714373807583,CLRE 260,A00,507221,Cuomo; Raphael Eduardo,9999,0,9999,0
1714373808609,CLRE 297,001,507242,Cuomo; Raphael Eduardo,9999,0,9999,0
1714373809634,COGS 197,001,638244,Voytek; Bradley Thomas,9999,0,9999,0
1714373810661,CSE 191,A00,516875,Minnes Kemp; Mor Mia,9993,0,9999,6
1714373811687,CSE 197,001,637388,Minnes Kemp; Mor Mia,9998,0,9999,1
1714373812712,CSS 201S,A01,494383,Staff,35,0,35,0
1714373813739,CSS 202S,A01,494387,Staff,35,0,35,0
1714373814764,DSC 197,001,628532,Eldridge; Justin Matthew,9996,0,9999,3
1714373815793,EAP 100,A00,516065,Staff,9797,0,9999,202
1714373816821,ECE 45,A01,507414,Staff,33,0,60,27
1714373818872,ECE 111,A01,507420,Staff,19,0,50,31
1714373819897,ECE 197,001,548057,Sievenpiper; Daniel F.,9994,0,9999,5
1714373820925,EDS 115,A00,507243,Choi; Bailey Miyeon,12,0,28,16
1714373821950,EDS 117,A01,494379,Staff,0,2,30,30
1714373822981,EDS 125,A00,507246,Hopkins; Megan Beth,12,0,30,18
1714373824011,EDS 128A,A01,507264,Fargason; Sharon Gayle,14,0,26,12
1714373825039,EDS 128B,A01,507293,Pappas; Elizabeth,18,0,30,12
1714373826067,EDS 139,A00,507294,Fargason; Sharon Gayle,18,0,30,12
1714373826067,EDS 139,B00,507313,Pappas; Elizabeth,15,0,30,15
1714373827096,EDS 201,A00,507315,Staff,13,0,30,17
1714373828125,EDS 203,A01,507317,Halter; Christopher P.,12,0,30,18
1714373829155,EDS 204R,A01,507319,Halter; Christopher P.,0,3,30,30
1714373829155,EDS 204R,B01,507331,Heinzman; Erica M.,17,0,30,13
1714373830179,EDS 206R,A00,507332,Staff,0,4,30,30
1714373830179,EDS 206R,B00,507343,Staff,18,0,30,12
1714373831207,EDS 250,A00,507344,Hemans; Patricia Ann Benitez,22,0,40,18
1714373832232,EDS 281,A00,507345,Daly; Alan J.,18,0,18,0
1714373833314,EDS 284,A00,507350,Daly; Alan J.,16,0,16,0
1714373834340,EDS 286,A00,507359,Fine; Sarah,18,0,18,0
1714373835366,EDS 289C,A01,507361,Daly; Alan J.,18,0,18,0
1714373836390,EDS 290,A00,507366,Hofstetter; Carolyn,15,0,15,0
1714373837416,LIGM 5A,A00,507421,Fischer-Grunski; Eva K,18,0,20,2
1714373838441,LIGM 5B,A00,507423,Fischer-Grunski; Eva K,19,0,20,1
1714373839469,LIGM 5C,A00,507425,Fischer-Grunski; Eva K,19,0,20,1
1714373840499,LIIT 5AS,A00,507427,Carnelos; Chiara,20,0,20,0
1714373841524,LIIT 5BS,A00,507430,Carnelos; Chiara,20,0,20,0
1714373842549,LIIT 5CS,A00,507432,Carnelos; Chiara,20,0,20,0
1714373843574,LISP 5A,A00,507541,Munoz Sanchez; Alicia,11,0,20,9
1714373844601,LISP 5B,A00,507671,Munoz Sanchez; Alicia,9,0,20,11
1714373845629,LISP 5C,A00,507696,Munoz Sanchez; Alicia,9,0,20,11
1714373846654,MAE 197,001,528363,Boechler; Nicholas Sebastia,9998,0,9999,1
1714373847680,MATH 197,001,523477,Kedlaya; Kiran S.,9996,0,9999,3
1714373847680,MATH 197,002,563811,Zhang; Danna,9995,0,9999,4
1714373847680,MATH 197,003,628552,Dumitriu; Ioana,9998,0,9999,1
1714373848705,MCWP 40R,A00,518780,Staff,5,0,20,15
1714373848705,MCWP 40R,B00,518781,Staff,7,0,20,13
1714373848705,MCWP 40R,C00,518783,Staff,5,0,20,15
1714373849731,MCWP 50R,A00,518791,Staff,0,0,20,20
1714373849731,MCWP 50R,B00,518792,Staff,0,1,20,20
1714373849731,MCWP 50R,C00,518793,Staff,0,1,20,20
1714373849731,MCWP 50R,D00,518794,Staff,0,0,20,20
1714373849731,MCWP 50R,E00,518795,Staff,0,1,20,20
1714373849731,MCWP 50R,F00,518796,Staff,0,0,20,20
1714373849731,MCWP 50R,G00,518797,Staff,0,1,20,20
1714373850758,MMW 12R,A01,514034,Herbst; Matthew,0,1,16,16
1714373850758,MMW 12R,A02,514035,Herbst; Matthew,2,0,16,14
1714373851784,MMW 13R,A01,514037,Staff,0,4,16,16
1714373851784,MMW 13R,A02,514039,Staff,0,2,16,16
1714373851784,MMW 13R,A03,628519,Staff,0,2,16,16
1714373853835,SIO 295LS,A00,523233,Staff,12,0,30,18
1714373854861,SIO 295S,A00,523232,Staff,12,0,30,18
1714373855887,SIOC 290S,A01,637330,Merrifield; Mark A,27,0,30,3
1714373856915,SIOC 291S,A01,637333,Gabriel; Corey John,27,0,30,3
1714373857940,SOCI 117,A01,494376,Staff,0,3,5,5
1714373858966,WES 237B,A00,494380,Staff,9,0,20,11
1714373861030,AESE 279B,A00,494370,Wade; Jon P,0,0,33,33
1714373862056,AIP 197,001,627712,Vespa; Emanuel Ignacio,9998,0,9999,1
1714373863087,ANAR 135S,A00,494369,Braswell; Geoffrey E.,0,0,0,0
1714373864117,BENG 196,001,628496,Engler; Adam J.,9998,0,9999,1
1714373865142,CAT 124RS,A01,519847,Geibel; William,0,0,20,20
1714373866168,CAT 125RS,A01,515971,Geibel; William,0,0,20,20
1714373867194,CLRE 250,A00,511389,Morris; Sheldon,9993,0,9999,6
1714373868221,CLRE 251,A00,507176,Mehta; Ravindra L.,9993,0,9999,6
1714373868221,CLRE 251,B00,511410,Mehta; Ravindra L.,9998,0,9999,1
1714373869249,CLRE 252,A00,507189,Cuomo; Raphael Eduardo,9995,0,9999,4
1714373870274,CLRE 253,A00,507199,Vaida; Florin,9994,0,9999,5
1714373870274,CLRE 253,B00,507202,Vaida; Florin,9999,0,9999,0
1714373871300,CLRE 259,A00,507211,Patel; Hemal,9996,0,9999,3
1714373872326,CLRE 260,A00,507221,Cuomo; Raphael Eduardo,9999,0,9999,0
1714373873356,CLRE 297,001,507242,Cuomo; Raphael Eduardo,9999,0,9999,0
1714373874383,COGS 197,001,638244,Voytek; Bradley Thomas,9999,0,9999,0
1714373875408,CSE 191,A00,516875,Minnes Kemp; Mor Mia,9993,0,9999,6
1714373876434,CSE 197,001,637388,Minnes Kemp; Mor Mia,9998,0,9999,1
1714373877460,CSS 201S,A01,494383,Staff,35,0,35,0
1714373878485,CSS 202S,A01,494387,Staff,35,0,35,0
1714373879510,DSC 197,001,628532,Eldridge; Justin Matthew,9996,0,9999,3
1714373880534,EAP 100,A00,516065,Staff,9797,0,9999,202
1714373881560,ECE 45,A01,507414,Staff,33,0,60,27
1714373883612,ECE 111,A01,507420,Staff,19,0,50,31
1714373884639,ECE 197,001,548057,Sievenpiper; Daniel F.,9994,0,9999,5
1714373885666,EDS 115,A00,507243,Choi; Bailey Miyeon,12,0,28,16
1714373886690,EDS 117,A01,494379,Staff,0,2,30,30
1714373887716,EDS 125,A00,507246,Hopkins; Megan Beth,12,0,30,18
1714373888742,EDS 128A,A01,507264,Fargason; Sharon Gayle,14,0,26,12
1714373889772,EDS 128B,A01,507293,Pappas; Elizabeth,18,0,30,12
1714373890800,EDS 139,A00,507294,Fargason; Sharon Gayle,18,0,30,12
1714373890800,EDS 139,B00,507313,Pappas; Elizabeth,15,0,30,15
1714373891827,EDS 201,A00,507315,Staff,13,0,30,17
1714373892856,EDS 203,A01,507317,Halter; Christopher P.,12,0,30,18
1714373893882,EDS 204R,A01,507319,Halter; Christopher P.,0,3,30,30
1714373893882,EDS 204R,B01,507331,Heinzman; Erica M.,17,0,30,13
1714373894908,EDS 206R,A00,507332,Staff,0,4,30,30
1714373894908,EDS 206R,B00,507343,Staff,18,0,30,12
1714373895932,EDS 250,A00,507344,Hemans; Patricia Ann Benitez,22,0,40,18
1714373896961,EDS 281,A00,507345,Daly; Alan J.,18,0,18,0
1714373897984,EDS 284,A00,507350,Daly; Alan J.,16,0,16,0
1714373899010,EDS 286,A00,507359,Fine; Sarah,18,0,18,0
1714373900038,EDS 289C,A01,507361,Daly; Alan J.,18,0,18,0
1714373901066,EDS 290,A00,507366,Hofstetter; Carolyn,15,0,15,0
1714373902094,LIGM 5A,A00,507421,Fischer-Grunski; Eva K,18,0,20,2
1714373903122,LIGM 5B,A00,507423,Fischer-Grunski; Eva K,19,0,20,1
1714373904149,LIGM 5C,A00,507425,Fischer-Grunski; Eva K,19,0,20,1
1714373905180,LIIT 5AS,A00,507427,Carnelos; Chiara,20,0,20,0
1714373906210,LIIT 5BS,A00,507430,Carnelos; Chiara,20,0,20,0
1714373907234,LIIT 5CS,A00,507432,Carnelos; Chiara,20,0,20,0
1714373908265,LISP 5A,A00,507541,Munoz Sanchez; Alicia,11,0,20,9
1714373909291,LISP 5B,A00,507671,Munoz Sanchez; Alicia,9,0,20,11
1714373910320,LISP 5C,A00,507696,Munoz Sanchez; Alicia,9,0,20,11
1714373911347,MAE 197,001,528363,Boechler; Nicholas Sebastia,9998,0,9999,1
1714373912372,MATH 197,001,523477,Kedlaya; Kiran S.,9996,0,9999,3
1714373912372,MATH 197,002,563811,Zhang; Danna,9995,0,9999,4
1714373912372,MATH 197,003,628552,Dumitriu; Ioana,9998,0,9999,1
1714373913401,MCWP 40R,A00,518780,Staff,5,0,20,15
1714373913401,MCWP 40R,B00,518781,Staff,7,0,20,13
1714373913401,MCWP 40R,C00,518783,Staff,5,0,20,15
1714373914427,MCWP 50R,A00,518791,Staff,0,0,20,20
1714373914427,MCWP 50R,B00,518792,Staff,0,1,20,20
1714373914427,MCWP 50R,C00,518793,Staff,0,1,20,20
1714373914427,MCWP 50R,D00,518794,Staff,0,0,20,20
1714373914427,MCWP 50R,E00,518795,Staff,0,1,20,20
1714373914427,MCWP 50R,F00,518796,Staff,0,0,20,20
1714373914427,MCWP 50R,G00,518797,Staff,0,1,20,20
1714373915452,MMW 12R,A01,514034,Herbst; Matthew,0,1,16,16
1714373915452,MMW 12R,A02,514035,Herbst; Matthew,2,0,16,14
1714373916477,MMW 13R,A01,514037,Staff,0,4,16,16
1714373916477,MMW 13R,A02,514039,Staff,0,2,16,16
1714373916477,MMW 13R,A03,628519,Staff,0,2,16,16
1714373918530,SIO 295LS,A00,523233,Staff,12,0,30,18
1714373919554,SIO 295S,A00,523232,Staff,12,0,30,18
1714373920580,SIOC 290S,A01,637330,Merrifield; Mark A,27,0,30,3
1714373921607,SIOC 291S,A01,637333,Gabriel; Corey John,27,0,30,3
1714373922636,SOCI 117,A01,494376,Staff,0,3,5,5
1714373923660,WES 237B,A00,494380,Staff,9,0,20,11
1714373925735,AESE 279B,A00,494370,Wade; Jon P,0,0,33,33
1714373926763,AIP 197,001,627712,Vespa; Emanuel Ignacio,9998,0,9999,1
1714373927790,ANAR 135S,A00,494369,Braswell; Geoffrey E.,0,0,0,0
1714373928815,BENG 196,001,628496,Engler; Adam J.,9998,0,9999,1
1714373929844,CAT 124RS,A01,519847,Geibel; William,0,0,20,20
1714373930873,CAT 125RS,A01,515971,Geibel; William,0,0,20,20
1714373931898,CLRE 250,A00,511389,Morris; Sheldon,9993,0,9999,6
1714373932924,CLRE 251,A00,507176,Mehta; Ravindra L.,9993,0,9999,6
1714373932924,CLRE 251,B00,511410,Mehta; Ravindra L.,9998,0,9999,1
1714373933953,CLRE 252,A00,507189,Cuomo; Raphael Eduardo,9995,0,9999,4
1714373934981,CLRE 253,A00,507199,Vaida; Florin,9994,0,9999,5
1714373934981,CLRE 253,B00,507202,Vaida; Florin,9999,0,9999,0
1714373936008,CLRE 259,A00,507211,Patel; Hemal,9996,0,9999,3
1714373937089,CLRE 260,A00,507221,Cuomo; Raphael Eduardo,9999,0,9999,0
1714373938114,CLRE 297,001,507242,Cuomo; Raphael Eduardo,9999,0,9999,0
1714373939140,COGS 197,001,638244,Voytek; Bradley Thomas,9999,0,9999,0
1714373940165,CSE 191,A00,516875,Minnes Kemp; Mor Mia,9993,0,9999,6
1714373941198,CSE 197,001,637388,Minnes Kemp; Mor Mia,9998,0,9999,1
1714373942228,CSS 201S,A01,494383,Staff,35,0,35,0
1714373943254,CSS 202S,A01,494387,Staff,35,0,35,0
1714373944279,DSC 197,001,628532,Eldridge; Justin Matthew,9996,0,9999,3
1714373945303,EAP 100,A00,516065,Staff,9797,0,9999,202
1714373946332,ECE 45,A01,507414,Staff,33,0,60,27
1714373948386,ECE 111,A01,507420,Staff,19,0,50,31
1714373949409,ECE 197,001,548057,Sievenpiper; Daniel F.,9994,0,9999,5
1714373950437,EDS 115,A00,507243,Choi; Bailey Miyeon,12,0,28,16
1714373951462,EDS 117,A01,494379,Staff,0,2,30,30
1714373952487,EDS 125,A00,507246,Hopkins; Megan Beth,12,0,30,18
1714373953524,EDS 128A,A01,507264,Fargason; Sharon Gayle,14,0,26,12
1714373954548,EDS 128B,A01,507293,Pappas; Elizabeth,18,0,30,12
1714373955572,EDS 139,A00,507294,Fargason; Sharon Gayle,18,0,30,12
1714373955572,EDS 139,B00,507313,Pappas; Elizabeth,15,0,30,15
1714373956598,EDS 201,A00,507315,Staff,13,0,30,17
1714373957623,EDS 203,A01,507317,Halter; Christopher P.,12,0,30,18
1714373958648,EDS 204R,A01,507319,Halter; Christopher P.,0,3,30,30
1714373958648,EDS 204R,B01,507331,Heinzman; Erica M.,17,0,30,13
1714373959672,EDS 206R,A00,507332,Staff,0,4,30,30
1714373959672,EDS 206R,B00,507343,Staff,18,0,30,12
1714373960703,EDS 250,A00,507344,Hemans; Patricia Ann Benitez,22,0,40,18
1714373961728,EDS 281,A00,507345,Daly; Alan J.,18,0,18,0
1714373962753,EDS 284,A00,507350,Daly; Alan J.,16,0,16,0
1714373963781,EDS 286,A00,507359,Fine; Sarah,18,0,18,0
1714373964808,EDS 289C,A01,507361,Daly; Alan J.,18,0,18,0
1714373965834,EDS 290,A00,507366,Hofstetter; Carolyn,15,0,15,0
1714373966860,LIGM 5A,A00,507421,Fischer-Grunski; Eva K,18,0,20,2
1714373967891,LIGM 5B,A00,507423,Fischer-Grunski; Eva K,19,0,20,1
1714373968921,LIGM 5C,A00,507425,Fischer-Grunski; Eva K,19,0,20,1
1714373969947,LIIT 5AS,A00,507427,Carnelos; Chiara,20,0,20,0
1714373970974,LIIT 5BS,A00,507430,Carnelos; Chiara,20,0,20,0
1714373972002,LIIT 5CS,A00,507432,Carnelos; Chiara,20,0,20,0
1714373973027,LISP 5A,A00,507541,Munoz Sanchez; Alicia,11,0,20,9
1714373974051,LISP 5B,A00,507671,Munoz Sanchez; Alicia,9,0,20,11
1714373975076,LISP 5C,A00,507696,Munoz Sanchez; Alicia,9,0,20,11
1714373976100,MAE 197,001,528363,Boechler; Nicholas Sebastia,9998,0,9999,1
1714373977130,MATH 197,001,523477,Kedlaya; Kiran S.,9996,0,9999,3
1714373977130,MATH 197,002,563811,Zhang; Danna,9995,0,9999,4
1714373977130,MATH 197,003,628552,Dumitriu; Ioana,9998,0,9999,1
1714373978160,MCWP 40R,A00,518780,Staff,5,0,20,15
1714373978160,MCWP 40R,B00,518781,Staff,7,0,20,13
1714373978160,MCWP 40R,C00,518783,Staff,5,0,20,15
1714373979189,MCWP 50R,A00,518791,Staff,0,0,20,20
1714373979189,MCWP 50R,B00,518792,Staff,0,1,20,20
1714373979189,MCWP 50R,C00,518793,Staff,0,1,20,20
1714373979189,MCWP 50R,D00,518794,Staff,0,0,20,20
1714373979189,MCWP 50R,E00,518795,Staff,0,1,20,20
1714373979189,MCWP 50R,F00,518796,Staff,0,0,20,20
1714373979189,MCWP 50R,G00,518797,Staff,0,1,20,20
1714373980220,MMW 12R,A01,514034,Herbst; Matthew,0,1,16,16
1714373980220,MMW 12R,A02,514035,Herbst; Matthew,2,0,16,14
1714373981248,MMW 13R,A01,514037,Staff,0,4,16,16
1714373981248,MMW 13R,A02,514039,Staff,0,2,16,16
1714373981248,MMW 13R,A03,628519,Staff,0,2,16,16
1714373983303,SIO 295LS,A00,523233,Staff,12,0,30,18
1714373984333,SIO 295S,A00,523232,Staff,12,0,30,18
1714373985358,SIOC 290S,A01,637330,Merrifield; Mark A,27,0,30,3
1714373986386,SIOC 291S,A01,637333,Gabriel; Corey John,27,0,30,3
1714373987411,SOCI 117,A01,494376,Staff,0,3,5,5
1714373988438,WES 237B,A00,494380,Staff,9,0,20,11
1714373990501,AESE 279B,A00,494370,Wade; Jon P,0,0,33,33
1714373991525,AIP 197,001,627712,Vespa; Emanuel Ignacio,9998,0,9999,1
1714373992550,ANAR 135S,A00,494369,Braswell; Geoffrey E.,0,0,0,0
1714373993577,BENG 196,001,628496,Engler; Adam J.,9998,0,9999,1
1714373994601,CAT 124RS,A01,519847,Geibel; William,0,0,20,20
1714373995628,CAT 125RS,A01,515971,Geibel; William,0,0,20,20
1714373996657,CLRE 250,A00,511389,Morris; Sheldon,9993,0,9999,6
1714373997686,CLRE 251,A00,507176,Mehta; Ravindra L.,9993,0,9999,6
1714373997686,CLRE 251,B00,511410,Mehta; Ravindra L.,9998,0,9999,1
1714373998713,CLRE 252,A00,507189,Cuomo; Raphael Eduardo,9995,0,9999,4
1714373999738,CLRE 253,A00,507199,Vaida; Florin,9994,0,9999,5
1714373999738,CLRE 253,B00,507202,Vaida; Florin,9999,0,9999,0
1714374000825,CLRE 259,A00,507211,Patel; Hemal,9996,0,9999,3
1714374001851,CLRE 260,A00,507221,Cuomo; Raphael Eduardo,9999,0,9999,0
1714374002876,CLRE 297,001,507242,Cuomo; Raphael Eduardo,9999,0,9999,0
1714374003911,COGS 197,001,638244,Voytek; Bradley Thomas,9999,0,9999,0
1714374004937,CSE 191,A00,516875,Minnes Kemp; Mor Mia,9993,0,9999,6
1714374005966,CSE 197,001,637388,Minnes Kemp; Mor Mia,9998,0,9999,1
1714374006996,CSS 201S,A01,494383,Staff,35,0,35,0
1714374008030,CSS 202S,A01,494387,Staff,35,0,35,0
1714374009055,DSC 197,001,628532,Eldridge; Justin Matthew,9996,0,9999,3
1714374010083,EAP 100,A00,516065,Staff,9797,0,9999,202
1714374011111,ECE 45,A01,507414,Staff,33,0,60,27
1714374013164,ECE 111,A01,507420,Staff,19,0,50,31
1714374014191,ECE 197,001,548057,Sievenpiper; Daniel F.,9994,0,9999,5
1714374015218,EDS 115,A00,507243,Choi; Bailey Miyeon,12,0,28,16
1714374016245,EDS 117,A01,494379,Staff,0,2,30,30
1714374017275,EDS 125,A00,507246,Hopkins; Megan Beth,12,0,30,18
1714374018302,EDS 128A,A01,507264,Fargason; Sharon Gayle,14,0,26,12
1714374019329,EDS 128B,A01,507293,Pappas; Elizabeth,18,0,30,12
1714374020355,EDS 139,A00,507294,Fargason; Sharon Gayle,18,0,30,12
1714374020355,EDS 139,B00,507313,Pappas; Elizabeth,15,0,30,15
1714374021381,EDS 201,A00,507315,Staff,13,0,30,17
1714374022407,EDS 203,A01,507317,Halter; Christopher P.,12,0,30,18
1714374023432,EDS 204R,A01,507319,Halter; Christopher P.,0,3,30,30
1714374023432,EDS 204R,B01,507331,Heinzman; Erica M.,17,0,30,13
1714374024458,EDS 206R,A00,507332,Staff,0,4,30,30
1714374024458,EDS 206R,B00,507343,Staff,18,0,30,12
1714374025483,EDS 250,A00,507344,Hemans; Patricia Ann Benitez,22,0,40,18
1714374026511,EDS 281,A00,507345,Daly; Alan J.,18,0,18,0
1714374027536,EDS 284,A00,507350,Daly; Alan J.,16,0,16,0
1714374028560,EDS 286,A00,507359,Fine; Sarah,18,0,18,0
1714374029586,EDS 289C,A01,507361,Daly; Alan J.,18,0,18,0
1714374030612,EDS 290,A00,507366,Hofstetter; Carolyn,15,0,15,0
1714374031638,LIGM 5A,A00,507421,Fischer-Grunski; Eva K,18,0,20,2
1714374032662,LIGM 5B,A00,507423,Fischer-Grunski; Eva K,19,0,20,1
1714374033690,LIGM 5C,A00,507425,Fischer-Grunski; Eva K,19,0,20,1
1714374034714,LIIT 5AS,A00,507427,Carnelos; Chiara,20,0,20,0
1714374035741,LIIT 5BS,A00,507430,Carnelos; Chiara,20,0,20,0
1714374036772,LIIT 5CS,A00,507432,Carnelos; Chiara,20,0,20,0
1714374037802,LISP 5A,A00,507541,Munoz Sanchez; Alicia,11,0,20,9
1714374038828,LISP 5B,A00,507671,Munoz Sanchez; Alicia,9,0,20,11
1714374039854,LISP 5C,A00,507696,Munoz Sanchez; Alicia,9,0,20,11
1714374040933,MAE 197,001,528363,Boechler; Nicholas Sebastia,9998,0,9999,1
1714374041958,MATH 197,001,523477,Kedlaya; Kiran S.,9996,0,9999,3
1714374041958,MATH 197,002,563811,Zhang; Danna,9995,0,9999,4
1714374041958,MATH 197,003,628552,Dumitriu; Ioana,9998,0,9999,1
1714374042985,MCWP 40R,A00,518780,Staff,5,0,20,15
1714374042985,MCWP 40R,B00,518781,Staff,7,0,20,13
1714374042985,MCWP 40R,C00,518783,Staff,5,0,20,15
1714374044011,MCWP 50R,A00,518791,Staff,0,0,20,20
1714374044011,MCWP 50R,B00,518792,Staff,0,1,20,20
1714374044011,MCWP 50R,C00,518793,Staff,0,1,20,20
1714374044011,MCWP 50R,D00,518794,Staff,0,0,20,20
1714374044011,MCWP 50R,E00,518795,Staff,0,1,20,20
1714374044011,MCWP 50R,F00,518796,Staff,0,0,20,20
1714374044011,MCWP 50R,G00,518797,Staff,0,1,20,20
1714374045036,MMW 12R,A01,514034,Herbst; Matthew,0,1,16,16
1714374045036,MMW 12R,A02,514035,Herbst; Matthew,2,0,16,14
1714374046064,MMW 13R,A01,514037,Staff,0,4,16,16
1714374046064,MMW 13R,A02,514039,Staff,0,2,16,16
1714374046064,MMW 13R,A03,628519,Staff,0,2,16,16
1714374048116,SIO 295LS,A00,523233,Staff,12,0,30,18
1714374049144,SIO 295S,A00,523232,Staff,12,0,30,18
1714374050169,SIOC 290S,A01,637330,Merrifield; Mark A,27,0,30,3
1714374051199,SIOC 291S,A01,637333,Gabriel; Corey John,27,0,30,3
1714374052227,SOCI 117,A01,494376,Staff,0,3,5,5
1714374053255,WES 237B,A00,494380,Staff,9,0,20,11
1714374055316,AESE 279B,A00,494370,Wade; Jon P,0,0,33,33
1714374056347,AIP 197,001,627712,Vespa; Emanuel Ignacio,9998,0,9999,1
1714374057375,ANAR 135S,A00,494369,Braswell; Geoffrey E.,0,0,0,0
1714374058399,BENG 196,001,628496,Engler; Adam J.,9998,0,9999,1
1714374059424,CAT 124RS,A01,519847,Geibel; William,0,0,20,20
1714374060543,CAT 125RS,A01,515971,Geibel; William,0,0,20,20
1714374061571,CLRE 250,A00,511389,Morris; Sheldon,9993,0,9999,6
1714374062618,CLRE 251,A00,507176,Mehta; Ravindra L.,9993,0,9999,6
1714374062618,CLRE 251,B00,511410,Mehta; Ravindra L.,9998,0,9999,1
1714374063652,CLRE 252,A00,507189,Cuomo; Raphael Eduardo,9995,0,9999,4
1714374064687,CLRE 253,A00,507199,Vaida; Florin,9994,0,9999,5
1714374064687,CLRE 253,B00,507202,Vaida; Florin,9999,0,9999,0
1714374065713,CLRE 259,A00,507211,Patel; Hemal,9996,0,9999,3
1714374066739,CLRE 260,A00,507221,Cuomo; Raphael Eduardo,9999,0,9999,0
1714374067763,CLRE 297,001,507242,Cuomo; Raphael Eduardo,9999,0,9999,0
1714374068790,COGS 197,001,638244,Voytek; Bradley Thomas,9999,0,9999,0
1714374069814,CSE 191,A00,516875,Minnes Kemp; Mor Mia,9993,0,9999,6
1714374070841,CSE 197,001,637388,Minnes Kemp; Mor Mia,9998,0,9999,1
1714374071866,CSS 201S,A01,494383,Staff,35,0,35,0
1714374073089,CSS 202S,A01,494387,Staff,35,0,35,0
1714374074113,DSC 197,001,628532,Eldridge; Justin Matthew,9996,0,9999,3
1714374075137,EAP 100,A00,516065,Staff,9797,0,9999,202
1714374076275,ECE 45,A01,507414,Staff,33,0,60,27
1714374078328,ECE 111,A01,507420,Staff,19,0,50,31
1714374079354,ECE 197,001,548057,Sievenpiper; Daniel F.,9994,0,9999,5
1714374080379,EDS 115,A00,507243,Choi; Bailey Miyeon,12,0,28,16
1714374081480,EDS 117,A01,494379,Staff,0,2,30,30
1714374082504,EDS 125,A00,507246,Hopkins; Megan Beth,12,0,30,18
1714374083529,EDS 128A,A01,507264,Fargason; Sharon Gayle,14,0,26,12
1714374084554,EDS 128B,A01,507293,Pappas; Elizabeth,18,0,30,12
1714374085580,EDS 139,A00,507294,Fargason; Sharon Gayle,18,0,30,12
1714374085580,EDS 139,B00,507313,Pappas; Elizabeth,15,0,30,15
1714374086615,EDS 201,A00,507315,Staff,13,0,30,17
1714374087640,EDS 203,A01,507317,Halter; Christopher P.,12,0,30,18
1714374088665,EDS 204R,A01,507319,Halter; Christopher P.,0,3,30,30
1714374088665,EDS 204R,B01,507331,Heinzman; Erica M.,17,0,30,13
1714374089696,EDS 206R,A00,507332,Staff,0,4,30,30
1714374089696,EDS 206R,B00,507343,Staff,18,0,30,12
1714374090720,EDS 250,A00,507344,Hemans; Patricia Ann Benitez,22,0,40,18
1714374091746,EDS 281,A00,507345,Daly; Alan J.,18,0,18,0
1714374092771,EDS 284,A00,507350,Daly; Alan J.,16,0,16,0
1714374093796,EDS 286,A00,507359,Fine; Sarah,18,0,18,0
1714374094823,EDS 289C,A01,507361,Daly; Alan J.,18,0,18,0
1714374095848,EDS 290,A00,507366,Hofstetter; Carolyn,15,0,15,0
1714374096880,LIGM 5A,A00,507421,Fischer-Grunski; Eva K,18,0,20,2
1714374097915,LIGM 5B,A00,507423,Fischer-Grunski; Eva K,19,0,20,1
1714374098940,LIGM 5C,A00,507425,Fischer-Grunski; Eva K,19,0,20,1
1714374099967,LIIT 5AS,A00,507427,Carnelos; Chiara,20,0,20,0
1714374100994,LIIT 5BS,A00,507430,Carnelos; Chiara,20,0,20,0
1714374102019,LIIT 5CS,A00,507432,Carnelos; Chiara,20,0,20,0
1714374103044,LISP 5A,A00,507541,Munoz Sanchez; Alicia,11,0,20,9
1714374104070,LISP 5B,A00,507671,Munoz Sanchez; Alicia,9,0,20,11
1714374105096,LISP 5C,A00,507696,Munoz Sanchez; Alicia,9,0,20,11
1714374106121,MAE 197,001,528363,Boechler; Nicholas Sebastia,9998,0,9999,1
1714374107150,MATH 197,001,523477,Kedlaya; Kiran S.,9996,0,9999,3
1714374107150,MATH 197,002,563811,Zhang; Danna,9995,0,9999,4
1714374107150,MATH 197,003,628552,Dumitriu; Ioana,9998,0,9999,1
1714374108178,MCWP 40R,A00,518780,Staff,5,0,20,15
1714374108178,MCWP 40R,B00,518781,Staff,7,0,20,13
1714374108178,MCWP 40R,C00,518783,Staff,5,0,20,15
1714374109211,MCWP 50R,A00,518791,Staff,0,0,20,20
1714374109211,MCWP 50R,B00,518792,Staff,0,1,20,20
1714374109211,MCWP 50R,C00,518793,Staff,0,1,20,20
1714374109211,MCWP 50R,D00,518794,Staff,0,0,20,20
1714374109211,MCWP 50R,E00,518795,Staff,0,1,20,20
1714374109211,MCWP 50R,F00,518796,Staff,0,0,20,20
1714374109211,MCWP 50R,G00,518797,Staff,0,1,20,20
1714374110242,MMW 12R,A01,514034,Herbst; Matthew,0,1,16,16
1714374110242,MMW 12R,A02,514035,Herbst; Matthew,2,0,16,14
1714374111271,MMW 13R,A01,514037,Staff,0,4,16,16
1714374111271,MMW 13R,A02,514039,Staff,0,2,16,16
1714374111271,MMW 13R,A03,628519,Staff,0,2,16,16
1714374113322,SIO 295LS,A00,523233,Staff,12,0,30,18
1714374114347,SIO 295S,A00,523232,Staff,12,0,30,18
1714374115599,SIOC 290S,A01,637330,Merrifield; Mark A,27,0,30,3
1714374116625,SIOC 291S,A01,637333,Gabriel; Corey John,27,0,30,3
1714374117653,SOCI 117,A01,494376,Staff,0,3,5,5
1714374118679,WES 237B,A00,494380,Staff,9,0,20,11
1714374120744,AESE 279B,A00,494370,Wade; Jon P,0,0,33,33
1714374121770,AIP 197,001,627712,Vespa; Emanuel Ignacio,9998,0,9999,1
1714374122798,ANAR 135S,A00,494369,Braswell; Geoffrey E.,0,0,0,0
1714374123829,BENG 196,001,628496,Engler; Adam J.,9998,0,9999,1
1714374124856,CAT 124RS,A01,519847,Geibel; William,0,0,20,20
1714374125881,CAT 125RS,A01,515971,Geibel; William,0,0,20,20
1714374126908,CLRE 250,A00,511389,Morris; Sheldon,9993,0,9999,6
1714374127932,CLRE 251,A00,507176,Mehta; Ravindra L.,9993,0,9999,6
1714374127932,CLRE 251,B00,511410,Mehta; Ravindra L.,9998,0,9999,1
1714374128966,CLRE 252,A00,507189,Cuomo; Raphael Eduardo,9995,0,9999,4
1714374129991,CLRE 253,A00,507199,Vaida; Florin,9994,0,9999,5
1714374129991,CLRE 253,B00,507202,Vaida; Florin,9999,0,9999,0
1714374131016,CLRE 259,A00,507211,Patel; Hemal,9996,0,9999,3
1714374132040,CLRE 260,A00,507221,Cuomo; Raphael Eduardo,9999,0,9999,0
1714374133065,CLRE 297,001,507242,Cuomo; Raphael Eduardo,9999,0,9999,0
1714374134090,COGS 197,001,638244,Voytek; Bradley Thomas,9999,0,9999,0
1714374135115,CSE 191,A00,516875,Minnes Kemp; Mor Mia,9993,0,9999,6
1714374136140,CSE 197,001,637388,Minnes Kemp; Mor Mia,9998,0,9999,1
1714374137165,CSS 201S,A01,494383,Staff,35,0,35,0
1714374138191,CSS 202S,A01,494387,Staff,35,0,35,0
1714374139219,DSC 197,001,628532,Eldridge; Justin Matthew,9996,0,9999,3
1714374140243,EAP 100,A00,516065,Staff,9797,0,9999,202
1714374141267,ECE 45,A01,507414,Staff,33,0,60,27
1714374143320,ECE 111,A01,507420,Staff,19,0,50,31
1714374144347,ECE 197,001,548057,Sievenpiper; Daniel F.,9994,0,9999,5
1714374145427,EDS 115,A00,507243,Choi; Bailey Miyeon,12,0,28,16
1714374146452,EDS 117,A01,494379,Staff,0,2,30,30
1714374147478,EDS 125,A00,507246,Hopkins; Megan Beth,12,0,30,18
1714374148507,EDS 128A,A01,507264,Fargason; Sharon Gayle,14,0,26,12
1714374149536,EDS 128B,A01,507293,Pappas; Elizabeth,18,0,30,12
1714374150563,EDS 139,A00,507294,Fargason; Sharon Gayle,18,0,30,12
1714374150563,EDS 139,B00,507313,Pappas; Elizabeth,15,0,30,15
1714374151593,EDS 201,A00,507315,Staff,13,0,30,17
1714374152619,EDS 203,A01,507317,Halter; Christopher P.,12,0,30,18
1714374153647,EDS 204R,A01,507319,Halter; Christopher P.,0,3,30,30
1714374153647,EDS 204R,B01,507331,Heinzman; Erica M.,17,0,30,13
1714374154673,EDS 206R,A00,507332,Staff,0,4,30,30
1714374154673,EDS 206R,B00,507343,Staff,18,0,30,12
1714374155699,EDS 250,A00,507344,Hemans; Patricia Ann Benitez,22,0,40,18
1714374156726,EDS 281,A00,507345,Daly; Alan J.,18,0,18,0
1714374157755,EDS 284,A00,507350,Daly; Alan J.,16,0,16,0
1714374158782,EDS 286,A00,507359,Fine; Sarah,18,0,18,0
1714374159808,EDS 289C,A01,507361,Daly; Alan J.,18,0,18,0
1714374160834,EDS 290,A00,507366,Hofstetter; Carolyn,15,0,15,0
1714374161861,LIGM 5A,A00,507421,Fischer-Grunski; Eva K,18,0,20,2
1714374162888,LIGM 5B,A00,507423,Fischer-Grunski; Eva K,19,0,20,1
1714374163914,LIGM 5C,A00,507425,Fischer-Grunski; Eva K,19,0,20,1
1714374164946,LIIT 5AS,A00,507427,Carnelos; Chiara,20,0,20,0
1714374165972,LIIT 5BS,A00,507430,Carnelos; Chiara,20,0,20,0
1714374166998,LIIT 5CS,A00,507432,Carnelos; Chiara,20,0,20,0
1714374168024,LISP 5A,A00,507541,Munoz Sanchez; Alicia,11,0,20,9
1714374169049,LISP 5B,A00,507671,Munoz Sanchez; Alicia,9,0,20,11
1714374170079,LISP 5C,A00,507696,Munoz Sanchez; Alicia,9,0,20,11
1714374171106,MAE 197,001,528363,Boechler; Nicholas Sebastia,9998,0,9999,1
1714374172139,MATH 197,001,523477,Kedlaya; Kiran S.,9996,0,9999,3
1714374172139,MATH 197,002,563811,Zhang; Danna,9995,0,9999,4
1714374172139,MATH 197,003,628552,Dumitriu; Ioana,9998,0,9999,1
1714374173164,MCWP 40R,A00,518780,Staff,5,0,20,15
1714374173164,MCWP 40R,B00,518781,Staff,7,0,20,13
1714374173164,MCWP 40R,C00,518783,Staff,5,0,20,15
1714374174190,MCWP 50R,A00,518791,Staff,0,0,20,20
1714374174190,MCWP 50R,B00,518792,Staff,0,1,20,20
1714374174190,MCWP 50R,C00,518793,Staff,0,1,20,20
1714374174190,MCWP 50R,D00,518794,Staff,0,0,20,20
1714374174190,MCWP 50R,E00,518795,Staff,0,1,20,20
1714374174190,MCWP 50R,F00,518796,Staff,0,0,20,20
1714374174190,MCWP 50R,G00,518797,Staff,0,1,20,20
1714374175216,MMW 12R,A01,514034,Herbst; Matthew,0,1,16,16
1714374175216,MMW 12R,A02,514035,Herbst; Matthew,2,0,16,14
1714374176242,MMW 13R,A01,514037,Staff,0,4,16,16
1714374176242,MMW 13R,A02,514039,Staff,0,2,16,16
1714374176242,MMW 13R,A03,628519,Staff,0,2,16,16
1714374178294,SIO 295LS,A00,523233,Staff,12,0,30,18
1714374179323,SIO 295S,A00,523232,Staff,12,0,30,18
1714374180349,SIOC 290S,A01,637330,Merrifield; Mark A,27,0,30,3
1714374181374,SIOC 291S,A01,637333,Gabriel; Corey John,27,0,30,3
1714374182401,SOCI 117,A01,494376,Staff,0,3,5,5
1714374183432,WES 237B,A00,494380,Staff,9,0,20,11
1714374185494,AESE 279B,A00,494370,Wade; Jon P,0,0,33,33
1714374186524,AIP 197,001,627712,Vespa; Emanuel Ignacio,9998,0,9999,1
1714374187547,ANAR 135S,A00,494369,Braswell; Geoffrey E.,0,0,0,0
1714374188572,BENG 196,001,628496,Engler; Adam J.,9998,0,9999,1
1714374189603,CAT 124RS,A01,519847,Geibel; William,0,0,20,20
1714374190628,CAT 125RS,A01,515971,Geibel; William,0,0,20,20
1714374191656,CLRE 250,A00,511389,Morris; Sheldon,9993,0,9999,6
1714374192686,CLRE 251,A00,507176,Mehta; Ravindra L.,9993,0,9999,6
1714374192686,CLRE 251,B00,511410,Mehta; Ravindra L.,9998,0,9999,1
1714374193711,CLRE 252,A00,507189,Cuomo; Raphael Eduardo,9995,0,9999,4
1714374194736,CLRE 253,A00,507199,Vaida; Florin,9994,0,9999,5
1714374194736,CLRE 253,B00,507202,Vaida; Florin,9999,0,9999,0
1714374195766,CLRE 259,A00,507211,Patel; Hemal,9996,0,9999,3
1714374196791,CLRE 260,A00,507221,Cuomo; Raphael Eduardo,9999,0,9999,0
1714374197817,CLRE 297,001,507242,Cuomo; Raphael Eduardo,9999,0,9999,0
1714374198841,COGS 197,001,638244,Voytek; Bradley Thomas,9999,0,9999,0
1714374199866,CSE 191,A00,516875,Minnes Kemp; Mor Mia,9993,0,9999,6
1714374200895,CSE 197,001,637388,Minnes Kemp; Mor Mia,9998,0,9999,1
1714374201926,CSS 201S,A01,494383,Staff,35,0,35,0
1714374202958,CSS 202S,A01,494387,Staff,35,0,35,0
1714374203983,DSC 197,001,628532,Eldridge; Justin Matthew,9996,0,9999,3
1714374205013,EAP 100,A00,516065,Staff,9797,0,9999,202
1714374206041,ECE 45,A01,507414,Staff,33,0,60,27
1714374208103,ECE 111,A01,507420,Staff,19,0,50,31
1714374209130,ECE 197,001,548057,Sievenpiper; Daniel F.,9994,0,9999,5
1714374210156,EDS 115,A00,507243,Choi; Bailey Miyeon,12,0,28,16
1714374211184,EDS 117,A01,494379,Staff,0,2,30,30
1714374212215,EDS 125,A00,507246,Hopkins; Megan Beth,12,0,30,18
1714374213239,EDS 128A,A01,507264,Fargason; Sharon Gayle,14,0,26,12
1714374214266,EDS 128B,A01,507293,Pappas; Elizabeth,18,0,30,12
1714374215293,EDS 139,A00,507294,Fargason; Sharon Gayle,18,0,30,12
1714374215293,EDS 139,B00,507313,Pappas; Elizabeth,15,0,30,15
1714374216319,EDS 201,A00,507315,Staff,13,0,30,17
1714374217344,EDS 203,A01,507317,Halter; Christopher P.,12,0,30,18
1714374218370,EDS 204R,A01,507319,Halter; Christopher P.,0,3,30,30
1714374218370,EDS 204R,B01,507331,Heinzman; Erica M.,17,0,30,13
1714374219395,EDS 206R,A00,507332,Staff,0,4,30,30
1714374219395,EDS 206R,B00,507343,Staff,18,0,30,12
1714374220422,EDS 250,A00,507344,Hemans; Patricia Ann Benitez,22,0,40,18
1714374221447,EDS 281,A00,507345,Daly; Alan J.,18,0,18,0
1714374222472,EDS 284,A00,507350,Daly; Alan J.,16,0,16,0
1714374223498,EDS 286,A00,507359,Fine; Sarah,18,0,18,0
1714374224523,EDS 289C,A01,507361,Daly; Alan J.,18,0,18,0
1714374225549,EDS 290,A00,507366,Hofstetter; Carolyn,15,0,15,0
1714374226580,LIGM 5A,A00,507421,Fischer-Grunski; Eva K,18,0,20,2
1714374227605,LIGM 5B,A00,507423,Fischer-Grunski; Eva K,19,0,20,1
1714374228635,LIGM 5C,A00,507425,Fischer-Grunski; Eva K,19,0,20,1
1714374229659,LIIT 5AS,A00,507427,Carnelos; Chiara,20,0,20,0
1714374230690,LIIT 5BS,A00,507430,Carnelos; Chiara,20,0,20,0
1714374231715,LIIT 5CS,A00,507432,Carnelos; Chiara,20,0,20,0
1714374232746,LISP 5A,A00,507541,Munoz Sanchez; Alicia,11,0,20,9
1714374233777,LISP 5B,A00,507671,Munoz Sanchez; Alicia,9,0,20,11
1714374234804,LISP 5C,A00,507696,Munoz Sanchez; Alicia,9,0,20,11
1714374235829,MAE 197,001,528363,Boechler; Nicholas Sebastia,9998,0,9999,1
1714374236854,MATH 197,001,523477,Kedlaya; Kiran S.,9996,0,9999,3
1714374236854,MATH 197,002,563811,Zhang; Danna,9995,0,9999,4
1714374236854,MATH 197,003,628552,Dumitriu; Ioana,9998,0,9999,1
1714374237884,MCWP 40R,A00,518780,Staff,5,0,20,15
1714374237884,MCWP 40R,B00,518781,Staff,7,0,20,13
1714374237884,MCWP 40R,C00,518783,Staff,5,0,20,15
1714374238909,MCWP 50R,A00,518791,Staff,0,0,20,20
1714374238909,MCWP 50R,B00,518792,Staff,0,1,20,20
1714374238909,MCWP 50R,C00,518793,Staff,0,1,20,20
1714374238909,MCWP 50R,D00,518794,Staff,0,0,20,20
1714374238909,MCWP 50R,E00,518795,Staff,0,1,20,20
1714374238909,MCWP 50R,F00,518796,Staff,0,0,20,20
1714374238909,MCWP 50R,G00,518797,Staff,0,1,20,20
1714374239935,MMW 12R,A01,514034,Herbst; Matthew,0,1,16,16
1714374239935,MMW 12R,A02,514035,Herbst; Matthew,2,0,16,14
1714374240960,MMW 13R,A01,514037,Staff,0,4,16,16
1714374240960,MMW 13R,A02,514039,Staff,0,2,16,16
1714374240960,MMW 13R,A03,628519,Staff,0,2,16,16
1714374243015,SIO 295LS,A00,523233,Staff,12,0,30,18
1714374244042,SIO 295S,A00,523232,Staff,12,0,30,18
1714374245069,SIOC 290S,A01,637330,Merrifield; Mark A,27,0,30,3
1714374246096,SIOC 291S,A01,637333,Gabriel; Corey John,27,0,30,3
1714374247125,SOCI 117,A01,494376,Staff,0,3,5,5
1714374248150,WES 237B,A00,494380,Staff,9,0,20,11
1714374250274,AESE 279B,A00,494370,Wade; Jon P,0,0,33,33
1714374251303,AIP 197,001,627712,Vespa; Emanuel Ignacio,9998,0,9999,1
1714374252329,ANAR 135S,A00,494369,Braswell; Geoffrey E.,0,0,0,0
1714374253361,BENG 196,001,628496,Engler; Adam J.,9998,0,9999,1
1714374254387,CAT 124RS,A01,519847,Geibel; William,0,0,20,20
1714374255417,CAT 125RS,A01,515971,Geibel; William,0,0,20,20
1714374256442,CLRE 250,A00,511389,Morris; Sheldon,9993,0,9999,6
1714374257473,CLRE 251,A00,507176,Mehta; Ravindra L.,9993,0,9999,6
1714374257473,CLRE 251,B00,511410,Mehta; Ravindra L.,9998,0,9999,1
1714374258501,CLRE 252,A00,507189,Cuomo; Raphael Eduardo,9995,0,9999,4
1714374259526,CLRE 253,A00,507199,Vaida; Florin,9994,0,9999,5
1714374259526,CLRE 253,B00,507202,Vaida; Florin,9999,0,9999,0
1714374260550,CLRE 259,A00,507211,Patel; Hemal,9996,0,9999,3
1714374261579,CLRE 260,A00,507221,Cuomo; Raphael Eduardo,9999,0,9999,0
1714374262607,CLRE 297,001,507242,Cuomo; Raphael Eduardo,9999,0,9999,0
1714374263635,COGS 197,001,638244,Voytek; Bradley Thomas,9999,0,9999,0
1714374264660,CSE 191,A00,516875,Minnes Kemp; Mor Mia,9993,0,9999,6
1714374265686,CSE 197,001,637388,Minnes Kemp; Mor Mia,9998,0,9999,1
1714374266718,CSS 201S,A01,494383,Staff,35,0,35,0
1714374267748,CSS 202S,A01,494387,Staff,35,0,35,0
1714374268777,DSC 197,001,628532,Eldridge; Justin Matthew,9996,0,9999,3
1714374269803,EAP 100,A00,516065,Staff,9797,0,9999,202
1714374270830,ECE 45,A01,507414,Staff,33,0,60,27
1714374272882,ECE 111,A01,507420,Staff,19,0,50,31
1714374273907,ECE 197,001,548057,Sievenpiper; Daniel F.,9994,0,9999,5
1714374274932,EDS 115,A00,507243,Choi; Bailey Miyeon,12,0,28,16
1714374275958,EDS 117,A01,494379,Staff,0,2,30,30
1714374276984,EDS 125,A00,507246,Hopkins; Megan Beth,12,0,30,18
1714374278014,EDS 128A,A01,507264,Fargason; Sharon Gayle,14,0,26,12
1714374279039,EDS 128B,A01,507293,Pappas; Elizabeth,18,0,30,12
1714374280068,EDS 139,A00,507294,Fargason; Sharon Gayle,18,0,30,12
1714374280068,EDS 139,B00,507313,Pappas; Elizabeth,15,0,30,15
1714374281093,EDS 201,A00,507315,Staff,13,0,30,17
1714374282122,EDS 203,A01,507317,Halter; Christopher P.,12,0,30,18
1714374283148,EDS 204R,A01,507319,Halter; Christopher P.,0,3,30,30
1714374283148,EDS 204R,B01,507331,Heinzman; Erica M.,17,0,30,13
1714374284173,EDS 206R,A00,507332,Staff,0,4,30,30
1714374284173,EDS 206R,B00,507343,Staff,18,0,30,12
1714374285199,EDS 250,A00,507344,Hemans; Patricia Ann Benitez,22,0,40,18
1714374286224,EDS 281,A00,507345,Daly; Alan J.,18,0,18,0
1714374287250,EDS 284,A00,507350,Daly; Alan J.,16,0,16,0
1714374288279,EDS 286,A00,507359,Fine; Sarah,18,0,18,0
1714374289304,EDS 289C,A01,507361,Daly; Alan J.,18,0,18,0
1714374290331,EDS 290,A00,507366,Hofstetter; Carolyn,15,0,15,0
1714374291354,LIGM 5A,A00,507421,Fischer-Grunski; Eva K,18,0,20,2
1714374292379,LIGM 5B,A00,507423,Fischer-Grunski; Eva K,19,0,20,1
1714374293409,LIGM 5C,A00,507425,Fischer-Grunski; Eva K,19,0,20,1
1714374294435,LIIT 5AS,A00,507427,Carnelos; Chiara,20,0,20,0
1714374295461,LIIT 5BS,A00,507430,Carnelos; Chiara,20,0,20,0
1714374296487,LIIT 5CS,A00,507432,Carnelos; Chiara,20,0,20,0
1714374297519,LISP 5A,A00,507541,Munoz Sanchez; Alicia,11,0,20,9
1714374298546,LISP 5B,A00,507671,Munoz Sanchez; Alicia,9,0,20,11
1714374299572,LISP 5C,A00,507696,Munoz Sanchez; Alicia,9,0,20,11
1714374300597,MAE 197,001,528363,Boechler; Nicholas Sebastia,9998,0,9999,1
1714374301625,MATH 197,001,523477,Kedlaya; Kiran S.,9996,0,9999,3
1714374301625,MATH 197,002,563811,Zhang; Danna,9995,0,9999,4
1714374301625,MATH 197,003,628552,Dumitriu; Ioana,9998,0,9999,1
1714374302651,MCWP 40R,A00,518780,Staff,5,0,20,15
1714374302651,MCWP 40R,B00,518781,Staff,7,0,20,13
1714374302651,MCWP 40R,C00,518783,Staff,5,0,20,15
1714374303678,MCWP 50R,A00,518791,Staff,0,0,20,20
1714374303678,MCWP 50R,B00,518792,Staff,0,1,20,20
1714374303678,MCWP 50R,C00,518793,Staff,0,1,20,20
1714374303678,MCWP 50R,D00,518794,Staff,0,0,20,20
1714374303678,MCWP 50R,E00,518795,Staff,0,1,20,20
1714374303678,MCWP 50R,F00,518796,Staff,0,0,20,20
1714374303678,MCWP 50R,G00,518797,Staff,0,1,20,20
1714374304708,MMW 12R,A01,514034,Herbst; Matthew,0,1,16,16
1714374304708,MMW 12R,A02,514035,Herbst; Matthew,2,0,16,14
1714374305734,MMW 13R,A01,514037,Staff,0,4,16,16
1714374305734,MMW 13R,A02,514039,Staff,0,2,16,16
1714374305734,MMW 13R,A03,628519,Staff,0,2,16,16
1714374307793,SIO 295LS,A00,523233,Staff,12,0,30,18
1714374308818,SIO 295S,A00,523232,Staff,12,0,30,18
1714374309846,SIOC 290S,A01,637330,Merrifield; Mark A,27,0,30,3
1714374310876,SIOC 291S,A01,637333,Gabriel; Corey John,27,0,30,3
1714374311912,SOCI 117,A01,494376,Staff,0,3,5,5
1714374312938,WES 237B,A00,494380,Staff,9,0,20,11
1714374315026,AESE 279B,A00,494370,Wade; Jon P,0,0,33,33
1714374316053,AIP 197,001,627712,Vespa; Emanuel Ignacio,9998,0,9999,1
1714374317083,ANAR 135S,A00,494369,Braswell; Geoffrey E.,0,0,0,0
1714374318109,BENG 196,001,628496,Engler; Adam J.,9998,0,9999,1
1714374319135,CAT 124RS,A01,519847,Geibel; William,0,0,20,20
1714374320164,CAT 125RS,A01,515971,Geibel; William,0,0,20,20
1714374321190,CLRE 250,A00,511389,Morris; Sheldon,9993,0,9999,6
1714374322220,CLRE 251,A00,507176,Mehta; Ravindra L.,9993,0,9999,6
1714374322220,CLRE 251,B00,511410,Mehta; Ravindra L.,9998,0,9999,1
1714374323254,CLRE 252,A00,507189,Cuomo; Raphael Eduardo,9995,0,9999,4
1714374324281,CLRE 253,A00,507199,Vaida; Florin,9994,0,9999,5
1714374324281,CLRE 253,B00,507202,Vaida; Florin,9999,0,9999,0
1714374325307,CLRE 259,A00,507211,Patel; Hemal,9996,0,9999,3
1714374326346,CLRE 260,A00,507221,Cuomo; Raphael Eduardo,9999,0,9999,0
1714374327370,CLRE 297,001,507242,Cuomo; Raphael Eduardo,9999,0,9999,0
1714374328395,COGS 197,001,638244,Voytek; Bradley Thomas,9999,0,9999,0
1714374329422,CSE 191,A00,516875,Minnes Kemp; Mor Mia,9993,0,9999,6
1714374330450,CSE 197,001,637388,Minnes Kemp; Mor Mia,9998,0,9999,1
1714374331481,CSS 201S,A01,494383,Staff,35,0,35,0
1714374332512,CSS 202S,A01,494387,Staff,35,0,35,0
1714374333539,DSC 197,001,628532,Eldridge; Justin Matthew,9996,0,9999,3
1714374334568,EAP 100,A00,516065,Staff,9797,0,9999,202
1714374335595,ECE 45,A01,507414,Staff,33,0,60,27
1714374337652,ECE 111,A01,507420,Staff,19,0,50,31
1714374338678,ECE 197,001,548057,Sievenpiper; Daniel F.,9994,0,9999,5
1714374339709,EDS 115,A00,507243,Choi; Bailey Miyeon,12,0,28,16
1714374340745,EDS 117,A01,494379,Staff,0,2,30,30
1714374341770,EDS 125,A00,507246,Hopkins; Megan Beth,12,0,30,18
1714374342797,EDS 128A,A01,507264,Fargason; Sharon Gayle,14,0,26,12
1714374343826,EDS 128B,A01,507293,Pappas; Elizabeth,18,0,30,12
1714374344856,EDS 139,A00,507294,Fargason; Sharon Gayle,18,0,30,12
1714374344856,EDS 139,B00,507313,Pappas; Elizabeth,15,0,30,15
1714374345884,EDS 201,A00,507315,Staff,13,0,30,17
1714374346943,EDS 203,A01,507317,Halter; Christopher P.,12,0,30,18
1714374347969,EDS 204R,A01,507319,Halter; Christopher P.,0,3,30,30
1714374347969,EDS 204R,B01,507331,Heinzman; Erica M.,17,0,30,13
1714374348993,EDS 206R,A00,507332,Staff,0,4,30,30
1714374348993,EDS 206R,B00,507343,Staff,18,0,30,12
1714374350040,EDS 250,A00,507344,Hemans; Patricia Ann Benitez,22,0,40,18
1714374351065,EDS 281,A00,507345,Daly; Alan J.,18,0,18,0
1714374352093,EDS 284,A00,507350,Daly; Alan J.,16,0,16,0
1714374353171,EDS 286,A00,507359,Fine; Sarah,18,0,18,0
1714374354199,EDS 289C,A01,507361,Daly; Alan J.,18,0,18,0
1714374355229,EDS 290,A00,507366,Hofstetter; Carolyn,15,0,15,0
1714374356255,LIGM 5A,A00,507421,Fischer-Grunski; Eva K,18,0,20,2
1714374357284,LIGM 5B,A00,507423,Fischer-Grunski; Eva K,19,0,20,1
1714374358311,LIGM 5C,A00,507425,Fischer-Grunski; Eva K,19,0,20,1
1714374359341,LIIT 5AS,A00,507427,Carnelos; Chiara,20,0,20,0
1714374360371,LIIT 5BS,A00,507430,Carnelos; Chiara,20,0,20,0
1714374361401,LIIT 5CS,A00,507432,Carnelos; Chiara,20,0,20,0
1714374362431,LISP 5A,A00,507541,Munoz Sanchez; Alicia,11,0,20,9
1714374363463,LISP 5B,A00,507671,Munoz Sanchez; Alicia,9,0,20,11
1714374364487,LISP 5C,A00,507696,Munoz Sanchez; Alicia,9,0,20,11
1714374365513,MAE 197,001,528363,Boechler; Nicholas Sebastia,9998,0,9999,1
1714374366541,MATH 197,001,523477,Kedlaya; Kiran S.,9996,0,9999,3
1714374366541,MATH 197,002,563811,Zhang; Danna,9995,0,9999,4
1714374366541,MATH 197,003,628552,Dumitriu; Ioana,9998,0,9999,1
1714374367570,MCWP 40R,A00,518780,Staff,5,0,20,15
1714374367570,MCWP 40R,B00,518781,Staff,7,0,20,13
1714374367570,MCWP 40R,C00,518783,Staff,5,0,20,15
1714374368601,MCWP 50R,A00,518791,Staff,0,0,20,20
1714374368601,MCWP 50R,B00,518792,Staff,0,1,20,20
1714374368601,MCWP 50R,C00,518793,Staff,0,1,20,20
1714374368601,MCWP 50R,D00,518794,Staff,0,0,20,20
1714374368601,MCWP 50R,E00,518795,Staff,0,1,20,20
1714374368601,MCWP 50R,F00,518796,Staff,0,0,20,20
1714374368601,MCWP 50R,G00,518797,Staff,0,1,20,20
1714374369627,MMW 12R,A01,514034,Herbst; Matthew,0,1,16,16
1714374369627,MMW 12R,A02,514035,Herbst; Matthew,2,0,16,14
1714374370655,MMW 13R,A01,514037,Staff,0,4,16,16
1714374370655,MMW 13R,A02,514039,Staff,0,2,16,16
1714374370655,MMW 13R,A03,628519,Staff,0,2,16,16
1714374372706,SIO 295LS,A00,523233,Staff,12,0,30,18
1714374373731,SIO 295S,A00,523232,Staff,12,0,30,18
1714374374757,SIOC 290S,A01,637330,Merrifield; Mark A,27,0,30,3
1714374375784,SIOC 291S,A01,637333,Gabriel; Corey John,27,0,30,3
1714374376813,SOCI 117,A01,494376,Staff,0,3,5,5
1714374377839,WES 237B,A00,494380,Staff,9,0,20,11
1714374379914,AESE 279B,A00,494370,Wade; Jon P,0,0,33,33
1714374380940,AIP 197,001,627712,Vespa; Emanuel Ignacio,9998,0,9999,1
1714374381966,ANAR 135S,A00,494369,Braswell; Geoffrey E.,0,0,0,0
1714374382991,BENG 196,001,628496,Engler; Adam J.,9998,0,9999,1
1714374384018,CAT 124RS,A01,519847,Geibel; William,0,0,20,20
1714374385043,CAT 125RS,A01,515971,Geibel; William,0,0,20,20
1714374386069,CLRE 250,A00,511389,Morris; Sheldon,9993,0,9999,6
1714374387099,CLRE 251,A00,507176,Mehta; Ravindra L.,9993,0,9999,6
1714374387099,CLRE 251,B00,511410,Mehta; Ravindra L.,9998,0,9999,1
1714374388128,CLRE 252,A00,507189,Cuomo; Raphael Eduardo,9995,0,9999,4
1714374389152,CLRE 253,A00,507199,Vaida; Florin,9994,0,9999,5
1714374389152,CLRE 253,B00,507202,Vaida; Florin,9999,0,9999,0
1714374390182,CLRE 259,A00,507211,Patel; Hemal,9996,0,9999,3
1714374391208,CLRE 260,A00,507221,Cuomo; Raphael Eduardo,9999,0,9999,0
1714374392235,CLRE 297,001,507242,Cuomo; Raphael Eduardo,9999,0,9999,0
1714374393262,COGS 197,001,638244,Voytek; Bradley Thomas,9999,0,9999,0
1714374394292,CSE 191,A00,516875,Minnes Kemp; Mor Mia,9993,0,9999,6
1714374395324,CSE 197,001,637388,Minnes Kemp; Mor Mia,9998,0,9999,1
1714374396354,CSS 201S,A01,494383,Staff,35,0,35,0
1714374397379,CSS 202S,A01,494387,Staff,35,0,35,0
1714374398408,DSC 197,001,628532,Eldridge; Justin Matthew,9996,0,9999,3
1714374399431,EAP 100,A00,516065,Staff,9797,0,9999,202
1714374400458,ECE 45,A01,507414,Staff,33,0,60,27
1714374402513,ECE 111,A01,507420,Staff,19,0,50,31
1714374403540,ECE 197,001,548057,Sievenpiper; Daniel F.,9994,0,9999,5
1714374404565,EDS 115,A00,507243,Choi; Bailey Miyeon,12,0,28,16
1714374405592,EDS 117,A01,494379,Staff,0,2,30,30
1714374406622,EDS 125,A00,507246,Hopkins; Megan Beth,12,0,30,18
1714374407647,EDS 128A,A01,507264,Fargason; Sharon Gayle,14,0,26,12
1714374408682,EDS 128B,A01,507293,Pappas; Elizabeth,18,0,30,12
1714374409707,EDS 139,A00,507294,Fargason; Sharon Gayle,18,0,30,12
1714374409707,EDS 139,B00,507313,Pappas; Elizabeth,15,0,30,15
1714374410733,EDS 201,A00,507315,Staff,13,0,30,17
1714374411762,EDS 203,A01,507317,Halter; Christopher P.,12,0,30,18
1714374412789,EDS 204R,A01,507319,Halter; Christopher P.,0,3,30,30
1714374412789,EDS 204R,B01,507331,Heinzman; Erica M.,17,0,30,13
1714374413817,EDS 206R,A00,507332,Staff,0,4,30,30
1714374413817,EDS 206R,B00,507343,Staff,18,0,30,12
1714374414848,EDS 250,A00,507344,Hemans; Patricia Ann Benitez,22,0,40,18
1714374415875,EDS 281,A00,507345,Daly; Alan J.,18,0,18,0
1714374416904,EDS 284,A00,507350,Daly; Alan J.,16,0,16,0
1714374417928,EDS 286,A00,507359,Fine; Sarah,18,0,18,0
1714374418954,EDS 289C,A01,507361,Daly; Alan J.,18,0,18,0
1714374419978,EDS 290,A00,507366,Hofstetter; Carolyn,15,0,15,0
1714374421002,LIGM 5A,A00,507421,Fischer-Grunski; Eva K,18,0,20,2
1714374422027,LIGM 5B,A00,507423,Fischer-Grunski; Eva K,19,0,20,1
1714374423061,LIGM 5C,A00,507425,Fischer-Grunski; Eva K,19,0,20,1
1714374424093,LIIT 5AS,A00,507427,Carnelos; Chiara,20,0,20,0
1714374425117,LIIT 5BS,A00,507430,Carnelos; Chiara,20,0,20,0
1714374426142,LIIT 5CS,A00,507432,Carnelos; Chiara,20,0,20,0
1714374427172,LISP 5A,A00,507541,Munoz Sanchez; Alicia,11,0,20,9
1714374428202,LISP 5B,A00,507671,Munoz Sanchez; Alicia,9,0,20,11
1714374429228,LISP 5C,A00,507696,Munoz Sanchez; Alicia,9,0,20,11
1714374430253,MAE 197,001,528363,Boechler; Nicholas Sebastia,9998,0,9999,1
1714374431280,MATH 197,001,523477,Kedlaya; Kiran S.,9996,0,9999,3
1714374431280,MATH 197,002,563811,Zhang; Danna,9995,0,9999,4
1714374431280,MATH 197,003,628552,Dumitriu; Ioana,9998,0,9999,1
1714374432309,MCWP 40R,A00,518780,Staff,5,0,20,15
1714374432309,MCWP 40R,B00,518781,Staff,7,0,20,13
1714374432309,MCWP 40R,C00,518783,Staff,5,0,20,15
1714374433339,MCWP 50R,A00,518791,Staff,0,0,20,20
1714374433339,MCWP 50R,B00,518792,Staff,0,1,20,20
1714374433339,MCWP 50R,C00,518793,Staff,0,1,20,20
1714374433339,MCWP 50R,D00,518794,Staff,0,0,20,20
1714374433339,MCWP 50R,E00,518795,Staff,0,1,20,20
1714374433339,MCWP 50R,F00,518796,Staff,0,0,20,20
1714374433339,MCWP 50R,G00,518797,Staff,0,1,20,20
1714374434363,MMW 12R,A01,514034,Herbst; Matthew,0,1,16,16
1714374434363,MMW 12R,A02,514035,Herbst; Matthew,2,0,16,14
1714374435390,MMW 13R,A01,514037,Staff,0,4,16,16
1714374435390,MMW 13R,A02,514039,Staff,0,2,16,16
1714374435390,MMW 13R,A03,628519,Staff,0,2,16,16
1714374437439,SIO 295LS,A00,523233,Staff,12,0,30,18
1714374438465,SIO 295S,A00,523232,Staff,12,0,30,18
1714374439495,SIOC 290S,A01,637330,Merrifield; Mark A,27,0,30,3
1714374440527,SIOC 291S,A01,637333,Gabriel; Corey John,27,0,30,3
1714374441556,SOCI 117,A01,494376,Staff,0,3,5,5
1714374442584,WES 237B,A00,494380,Staff,9,0,20,11
1714374444650,AESE 279B,A00,494370,Wade; Jon P,0,0,33,33
1714374445675,AIP 197,001,627712,Vespa; Emanuel Ignacio,9998,0,9999,1
1714374446701,ANAR 135S,A00,494369,Braswell; Geoffrey E.,0,0,0,0
1714374447727,BENG 196,001,628496,Engler; Adam J.,9998,0,9999,1
1714374448760,CAT 124RS,A01,519847,Geibel; William,0,0,20,20
1714374449789,CAT 125RS,A01,515971,Geibel; William,0,0,20,20
1714374450814,CLRE 250,A00,511389,Morris; Sheldon,9993,0,9999,6
1714374451839,CLRE 251,A00,507176,Mehta; Ravindra L.,9993,0,9999,6
1714374451839,CLRE 251,B00,511410,Mehta; Ravindra L.,9998,0,9999,1
1714374452863,CLRE 252,A00,507189,Cuomo; Raphael Eduardo,9995,0,9999,4
1714374453893,CLRE 253,A00,507199,Vaida; Florin,9994,0,9999,5
1714374453893,CLRE 253,B00,507202,Vaida; Florin,9999,0,9999,0
1714374454918,CLRE 259,A00,507211,Patel; Hemal,9996,0,9999,3
1714374455945,CLRE 260,A00,507221,Cuomo; Raphael Eduardo,9999,0,9999,0
1714374457023,CLRE 297,001,507242,Cuomo; Raphael Eduardo,9999,0,9999,0
1714374458052,COGS 197,001,638244,Voytek; Bradley Thomas,9999,0,9999,0
1714374459078,CSE 191,A00,516875,Minnes Kemp; Mor Mia,9993,0,9999,6
1714374460103,CSE 197,001,637388,Minnes Kemp; Mor Mia,9998,0,9999,1
1714374461129,CSS 201S,A01,494383,Staff,35,0,35,0
1714374462160,CSS 202S,A01,494387,Staff,35,0,35,0
1714374463186,DSC 197,001,628532,Eldridge; Justin Matthew,9996,0,9999,3
1714374464212,EAP 100,A00,516065,Staff,9797,0,9999,202
1714374465240,ECE 45,A01,507414,Staff,33,0,60,27
1714374467298,ECE 111,A01,507420,Staff,19,0,50,31
1714374468322,ECE 197,001,548057,Sievenpiper; Daniel F.,9994,0,9999,5
1714374469348,EDS 115,A00,507243,Choi; Bailey Miyeon,12,0,28,16
1714374470374,EDS 117,A01,494379,Staff,0,2,30,30
1714374471397,EDS 125,A00,507246,Hopkins; Megan Beth,12,0,30,18
1714374472423,EDS 128A,A01,507264,Fargason; Sharon Gayle,14,0,26,12
1714374473452,EDS 128B,A01,507293,Pappas; Elizabeth,18,0,30,12
1714374474476,EDS 139,A00,507294,Fargason; Sharon Gayle,18,0,30,12
1714374474476,EDS 139,B00,507313,Pappas; Elizabeth,15,0,30,15
1714374475502,EDS 201,A00,507315,Staff,13,0,30,17
1714374476528,EDS 203,A01,507317,Halter; Christopher P.,12,0,30,18
1714374477559,EDS 204R,A01,507319,Halter; Christopher P.,0,3,30,30
1714374477559,EDS 204R,B01,507331,Heinzman; Erica M.,17,0,30,13
1714374478589,EDS 206R,A00,507332,Staff,0,4,30,30
1714374478589,EDS 206R,B00,507343,Staff,18,0,30,12
1714374479621,EDS 250,A00,507344,Hemans; Patricia Ann Benitez,22,0,40,18
1714374480646,EDS 281,A00,507345,Daly; Alan J.,18,0,18,0
1714374481671,EDS 284,A00,507350,Daly; Alan J.,16,0,16,0
1714374482699,EDS 286,A00,507359,Fine; Sarah,18,0,18,0
1714374483724,EDS 289C,A01,507361,Daly; Alan J.,18,0,18,0
1714374484751,EDS 290,A00,507366,Hofstetter; Carolyn,15,0,15,0
1714374485777,LIGM 5A,A00,507421,Fischer-Grunski; Eva K,18,0,20,2
1714374486804,LIGM 5B,A00,507423,Fischer-Grunski; Eva K,19,0,20,1
1714374487834,LIGM 5C,A00,507425,Fischer-Grunski; Eva K,19,0,20,1
1714374488864,LIIT 5AS,A00,507427,Carnelos; Chiara,20,0,20,0
1714374489891,LIIT 5BS,A00,507430,Carnelos; Chiara,20,0,20,0
1714374490920,LIIT 5CS,A00,507432,Carnelos; Chiara,20,0,20,0
1714374491950,LISP 5A,A00,507541,Munoz Sanchez; Alicia,11,0,20,9
1714374492974,LISP 5B,A00,507671,Munoz Sanchez; Alicia,9,0,20,11
1714374494005,LISP 5C,A00,507696,Munoz Sanchez; Alicia,9,0,20,11
1714374495035,MAE 197,001,528363,Boechler; Nicholas Sebastia,9998,0,9999,1
1714374496061,MATH 197,001,523477,Kedlaya; Kiran S.,9996,0,9999,3
1714374496061,MATH 197,002,563811,Zhang; Danna,9995,0,9999,4
1714374496061,MATH 197,003,628552,Dumitriu; Ioana,9998,0,9999,1
1714374497086,MCWP 40R,A00,518780,Staff,5,0,20,15
1714374497086,MCWP 40R,B00,518781,Staff,7,0,20,13
1714374497086,MCWP 40R,C00,518783,Staff,5,0,20,15
1714374498117,MCWP 50R,A00,518791,Staff,0,0,20,20
1714374498117,MCWP 50R,B00,518792,Staff,0,1,20,20
1714374498117,MCWP 50R,C00,518793,Staff,0,1,20,20
1714374498117,MCWP 50R,D00,518794,Staff,0,0,20,20
1714374498117,MCWP 50R,E00,518795,Staff,0,1,20,20
1714374498117,MCWP 50R,F00,518796,Staff,0,0,20,20
1714374498117,MCWP 50R,G00,518797,Staff,0,1,20,20
1714374499141,MMW 12R,A01,514034,Herbst; Matthew,0,1,16,16
1714374499141,MMW 12R,A02,514035,Herbst; Matthew,2,0,16,14
1714374500166,MMW 13R,A01,514037,Staff,0,4,16,16
1714374500166,MMW 13R,A02,514039,Staff,0,2,16,16
1714374500166,MMW 13R,A03,628519,Staff,0,2,16,16
1714374502220,SIO 295LS,A00,523233,Staff,12,0,30,18
1714374503244,SIO 295S,A00,523232,Staff,12,0,30,18
1714374504275,SIOC 290S,A01,637330,Merrifield; Mark A,27,0,30,3
1714374505299,SIOC 291S,A01,637333,Gabriel; Corey John,27,0,30,3
1714374506328,SOCI 117,A01,494376,Staff,0,4,5,5
1714374507353,WES 237B,A00,494380,Staff,9,0,20,11
1714374509415,AESE 279B,A00,494370,Wade; Jon P,0,0,33,33
1714374510444,AIP 197,001,627712,Vespa; Emanuel Ignacio,9998,0,9999,1
1714374511471,ANAR 135S,A00,494369,Braswell; Geoffrey E.,0,0,0,0
1714374512500,BENG 196,001,628496,Engler; Adam J.,9998,0,9999,1
1714374513524,CAT 124RS,A01,519847,Geibel; William,0,0,20,20
1714374514553,CAT 125RS,A01,515971,Geibel; William,0,0,20,20
1714374515580,CLRE 250,A00,511389,Morris; Sheldon,9993,0,9999,6
1714374516609,CLRE 251,A00,507176,Mehta; Ravindra L.,9993,0,9999,6
1714374516609,CLRE 251,B00,511410,Mehta; Ravindra L.,9998,0,9999,1
1714374517638,CLRE 252,A00,507189,Cuomo; Raphael Eduardo,9995,0,9999,4
1714374518665,CLRE 253,A00,507199,Vaida; Florin,9994,0,9999,5
1714374518665,CLRE 253,B00,507202,Vaida; Florin,9999,0,9999,0
1714374519691,CLRE 259,A00,507211,Patel; Hemal,9996,0,9999,3
1714374520722,CLRE 260,A00,507221,Cuomo; Raphael Eduardo,9999,0,9999,0
1714374521748,CLRE 297,001,507242,Cuomo; Raphael Eduardo,9999,0,9999,0
1714374522777,COGS 197,001,638244,Voytek; Bradley Thomas,9999,0,9999,0
1714374523803,CSE 191,A00,516875,Minnes Kemp; Mor Mia,9993,0,9999,6
1714374524829,CSE 197,001,637388,Minnes Kemp; Mor Mia,9998,0,9999,1
1714374525856,CSS 201S,A01,494383,Staff,35,0,35,0
1714374526887,CSS 202S,A01,494387,Staff,35,0,35,0
1714374527913,DSC 197,001,628532,Eldridge; Justin Matthew,9996,0,9999,3
1714374528938,EAP 100,A00,516065,Staff,9797,0,9999,202
1714374529964,ECE 45,A01,507414,Staff,33,0,60,27
1714374532021,ECE 111,A01,507420,Staff,19,0,50,31
1714374533049,ECE 197,001,548057,Sievenpiper; Daniel F.,9994,0,9999,5
1714374534080,EDS 115,A00,507243,Choi; Bailey Miyeon,12,0,28,16
1714374535109,EDS 117,A01,494379,Staff,0,2,30,30
1714374536138,EDS 125,A00,507246,Hopkins; Megan Beth,12,0,30,18
1714374537163,EDS 128A,A01,507264,Fargason; Sharon Gayle,14,0,26,12
1714374538192,EDS 128B,A01,507293,Pappas; Elizabeth,18,0,30,12
1714374539216,EDS 139,A00,507294,Fargason; Sharon Gayle,18,0,30,12
1714374539216,EDS 139,B00,507313,Pappas; Elizabeth,15,0,30,15
1714374540241,EDS 201,A00,507315,Staff,13,0,30,17
1714374541271,EDS 203,A01,507317,Halter; Christopher P.,12,0,30,18
1714374542355,EDS 204R,A01,507319,Halter; Christopher P.,0,3,30,30
1714374542355,EDS 204R,B01,507331,Heinzman; Erica M.,17,0,30,13
1714374543386,EDS 206R,A00,507332,Staff,0,4,30,30
1714374543386,EDS 206R,B00,507343,Staff,18,0,30,12
1714374544412,EDS 250,A00,507344,Hemans; Patricia Ann Benitez,22,0,40,18
1714374545438,EDS 281,A00,507345,Daly; Alan J.,18,0,18,0
1714374546463,EDS 284,A00,507350,Daly; Alan J.,16,0,16,0
1714374547487,EDS 286,A00,507359,Fine; Sarah,18,0,18,0
1714374548514,EDS 289C,A01,507361,Daly; Alan J.,18,0,18,0
1714374549538,EDS 290,A00,507366,Hofstetter; Carolyn,15,0,15,0
1714374550568,LIGM 5A,A00,507421,Fischer-Grunski; Eva K,18,0,20,2
1714374551599,LIGM 5B,A00,507423,Fischer-Grunski; Eva K,19,0,20,1
1714374552632,LIGM 5C,A00,507425,Fischer-Grunski; Eva K,19,0,20,1
1714374553658,LIIT 5AS,A00,507427,Carnelos; Chiara,20,0,20,0
1714374554687,LIIT 5BS,A00,507430,Carnelos; Chiara,20,0,20,0
1714374555715,LIIT 5CS,A00,507432,Carnelos; Chiara,20,0,20,0
1714374556742,LISP 5A,A00,507541,Munoz Sanchez; Alicia,11,0,20,9
1714374557767,LISP 5B,A00,507671,Munoz Sanchez; Alicia,9,0,20,11
1714374558799,LISP 5C,A00,507696,Munoz Sanchez; Alicia,9,0,20,11
1714374559830,MAE 197,001,528363,Boechler; Nicholas Sebastia,9998,0,9999,1
1714374560914,MATH 197,001,523477,Kedlaya; Kiran S.,9996,0,9999,3
1714374560914,MATH 197,002,563811,Zhang; Danna,9995,0,9999,4
1714374560914,MATH 197,003,628552,Dumitriu; Ioana,9998,0,9999,1
1714374561945,MCWP 40R,A00,518780,Staff,5,0,20,15
1714374561945,MCWP 40R,B00,518781,Staff,7,0,20,13
1714374561945,MCWP 40R,C00,518783,Staff,5,0,20,15
1714374562972,MCWP 50R,A00,518791,Staff,0,0,20,20
1714374562972,MCWP 50R,B00,518792,Staff,0,1,20,20
1714374562972,MCWP 50R,C00,518793,Staff,0,1,20,20
1714374562972,MCWP 50R,D00,518794,Staff,0,0,20,20
1714374562972,MCWP 50R,E00,518795,Staff,0,1,20,20
1714374562972,MCWP 50R,F00,518796,Staff,0,0,20,20
1714374562972,MCWP 50R,G00,518797,Staff,0,1,20,20
1714374564001,MMW 12R,A01,514034,Herbst; Matthew,0,1,16,16
1714374564001,MMW 12R,A02,514035,Herbst; Matthew,2,0,16,14
1714374565031,MMW 13R,A01,514037,Staff,0,4,16,16
1714374565031,MMW 13R,A02,514039,Staff,0,2,16,16
1714374565031,MMW 13R,A03,628519,Staff,0,2,16,16
1714374567090,SIO 295LS,A00,523233,Staff,12,0,30,18
1714374568117,SIO 295S,A00,523232,Staff,12,0,30,18
1714374569143,SIOC 290S,A01,637330,Merrifield; Mark A,27,0,30,3
1714374570169,SIOC 291S,A01,637333,Gabriel; Corey John,27,0,30,3
1714374571195,SOCI 117,A01,494376,Staff,0,4,5,5
1714374572223,WES 237B,A00,494380,Staff,9,0,20,11
1714374574291,AESE 279B,A00,494370,Wade; Jon P,0,0,33,33
1714374575316,AIP 197,001,627712,Vespa; Emanuel Ignacio,9998,0,9999,1
1714374576342,ANAR 135S,A00,494369,Braswell; Geoffrey E.,0,0,0,0
1714374577365,BENG 196,001,628496,Engler; Adam J.,9998,0,9999,1
1714374578394,CAT 124RS,A01,519847,Geibel; William,0,0,20,20
1714374579424,CAT 125RS,A01,515971,Geibel; William,0,0,20,20
1714374580449,CLRE 250,A00,511389,Morris; Sheldon,9993,0,9999,6
1714374581481,CLRE 251,A00,507176,Mehta; Ravindra L.,9993,0,9999,6
1714374581481,CLRE 251,B00,511410,Mehta; Ravindra L.,9998,0,9999,1
1714374582507,CLRE 252,A00,507189,Cuomo; Raphael Eduardo,9995,0,9999,4
1714374583535,CLRE 253,A00,507199,Vaida; Florin,9994,0,9999,5
1714374583535,CLRE 253,B00,507202,Vaida; Florin,9999,0,9999,0
1714374584563,CLRE 259,A00,507211,Patel; Hemal,9996,0,9999,3
1714374585589,CLRE 260,A00,507221,Cuomo; Raphael Eduardo,9999,0,9999,0
1714374586614,CLRE 297,001,507242,Cuomo; Raphael Eduardo,9999,0,9999,0
1714374587639,COGS 197,001,638244,Voytek; Bradley Thomas,9999,0,9999,0
1714374588666,CSE 191,A00,516875,Minnes Kemp; Mor Mia,9993,0,9999,6
1714374589693,CSE 197,001,637388,Minnes Kemp; Mor Mia,9998,0,9999,1
1714374590719,CSS 201S,A01,494383,Staff,35,0,35,0
1714374591744,CSS 202S,A01,494387,Staff,35,0,35,0
1714374592770,DSC 197,001,628532,Eldridge; Justin Matthew,9996,0,9999,3
1714374593798,EAP 100,A00,516065,Staff,9797,0,9999,202
1714374594827,ECE 45,A01,507414,Staff,33,0,60,27
1714374596878,ECE 111,A01,507420,Staff,19,0,50,31
1714374597902,ECE 197,001,548057,Sievenpiper; Daniel F.,9994,0,9999,5
1714374598931,EDS 115,A00,507243,Choi; Bailey Miyeon,12,0,28,16
1714374599956,EDS 117,A01,494379,Staff,0,2,30,30
1714374600982,EDS 125,A00,507246,Hopkins; Megan Beth,12,0,30,18
1714374602010,EDS 128A,A01,507264,Fargason; Sharon Gayle,14,0,26,12
1714374603036,EDS 128B,A01,507293,Pappas; Elizabeth,18,0,30,12
1714374604062,EDS 139,A00,507294,Fargason; Sharon Gayle,18,0,30,12
1714374604062,EDS 139,B00,507313,Pappas; Elizabeth,15,0,30,15
1714374605088,EDS 201,A00,507315,Staff,13,0,30,17
1714374606113,EDS 203,A01,507317,Halter; Christopher P.,12,0,30,18
1714374607139,EDS 204R,A01,507319,Halter; Christopher P.,0,3,30,30
1714374607139,EDS 204R,B01,507331,Heinzman; Erica M.,17,0,30,13
1714374608165,EDS 206R,A00,507332,Staff,0,4,30,30
1714374608165,EDS 206R,B00,507343,Staff,18,0,30,12
1714374609190,EDS 250,A00,507344,Hemans; Patricia Ann Benitez,22,0,40,18
1714374610217,EDS 281,A00,507345,Daly; Alan J.,18,0,18,0
1714374611245,EDS 284,A00,507350,Daly; Alan J.,16,0,16,0
1714374612271,EDS 286,A00,507359,Fine; Sarah,18,0,18,0
1714374613298,EDS 289C,A01,507361,Daly; Alan J.,18,0,18,0
1714374614324,EDS 290,A00,507366,Hofstetter; Carolyn,15,0,15,0
1714374615350,LIGM 5A,A00,507421,Fischer-Grunski; Eva K,18,0,20,2
1714374616375,LIGM 5B,A00,507423,Fischer-Grunski; Eva K,19,0,20,1
1714374617401,LIGM 5C,A00,507425,Fischer-Grunski; Eva K,19,0,20,1
1714374618427,LIIT 5AS,A00,507427,Carnelos; Chiara,20,0,20,0
1714374619453,LIIT 5BS,A00,507430,Carnelos; Chiara,20,0,20,0
1714374620483,LIIT 5CS,A00,507432,Carnelos; Chiara,20,0,20,0
1714374621514,LISP 5A,A00,507541,Munoz Sanchez; Alicia,11,0,20,9
1714374622538,LISP 5B,A00,507671,Munoz Sanchez; Alicia,9,0,20,11
1714374623567,LISP 5C,A00,507696,Munoz Sanchez; Alicia,9,0,20,11
1714374624592,MAE 197,001,528363,Boechler; Nicholas Sebastia,9998,0,9999,1
1714374625619,MATH 197,001,523477,Kedlaya; Kiran S.,9996,0,9999,3
1714374625619,MATH 197,002,563811,Zhang; Danna,9995,0,9999,4
1714374625619,MATH 197,003,628552,Dumitriu; Ioana,9998,0,9999,1
1714374626646,MCWP 40R,A00,518780,Staff,5,0,20,15
1714374626646,MCWP 40R,B00,518781,Staff,7,0,20,13
1714374626646,MCWP 40R,C00,518783,Staff,5,0,20,15
1714374627677,MCWP 50R,A00,518791,Staff,0,0,20,20
1714374627677,MCWP 50R,B00,518792,Staff,0,1,20,20
1714374627677,MCWP 50R,C00,518793,Staff,0,1,20,20
1714374627677,MCWP 50R,D00,518794,Staff,0,0,20,20
1714374627677,MCWP 50R,E00,518795,Staff,0,1,20,20
1714374627677,MCWP 50R,F00,518796,Staff,0,0,20,20
1714374627677,MCWP 50R,G00,518797,Staff,0,1,20,20
1714374628703,MMW 12R,A01,514034,Herbst; Matthew,0,1,16,16
1714374628703,MMW 12R,A02,514035,Herbst; Matthew,2,0,16,14
1714374629729,MMW 13R,A01,514037,Staff,0,4,16,16
1714374629729,MMW 13R,A02,514039,Staff,0,2,16,16
1714374629729,MMW 13R,A03,628519,Staff,0,2,16,16
1714374631779,SIO 295LS,A00,523233,Staff,12,0,30,18
1714374632810,SIO 295S,A00,523232,Staff,12,0,30,18
1714374633837,SIOC 290S,A01,637330,Merrifield; Mark A,27,0,30,3
1714374634862,SIOC 291S,A01,637333,Gabriel; Corey John,27,0,30,3
1714374635891,SOCI 117,A01,494376,Staff,0,4,5,5
1714374636916,WES 237B,A00,494380,Staff,9,0,20,11
1714374638988,AESE 279B,A00,494370,Wade; Jon P,0,0,33,33
1714374640015,AIP 197,001,627712,Vespa; Emanuel Ignacio,9998,0,9999,1
1714374641042,ANAR 135S,A00,494369,Braswell; Geoffrey E.,0,0,0,0
1714374642068,BENG 196,001,628496,Engler; Adam J.,9998,0,9999,1
1714374643096,CAT 124RS,A01,519847,Geibel; William,0,0,20,20
1714374644121,CAT 125RS,A01,515971,Geibel; William,0,0,20,20
1714374645148,CLRE 250,A00,511389,Morris; Sheldon,9993,0,9999,6
1714374646176,CLRE 251,A00,507176,Mehta; Ravindra L.,9993,0,9999,6
1714374646176,CLRE 251,B00,511410,Mehta; Ravindra L.,9998,0,9999,1
1714374647202,CLRE 252,A00,507189,Cuomo; Raphael Eduardo,9995,0,9999,4
1714374648235,CLRE 253,A00,507199,Vaida; Florin,9994,0,9999,5
1714374648235,CLRE 253,B00,507202,Vaida; Florin,9999,0,9999,0
1714374649259,CLRE 259,A00,507211,Patel; Hemal,9996,0,9999,3
1714374650285,CLRE 260,A00,507221,Cuomo; Raphael Eduardo,9999,0,9999,0
1714374651310,CLRE 297,001,507242,Cuomo; Raphael Eduardo,9999,0,9999,0
1714374652336,COGS 197,001,638244,Voytek; Bradley Thomas,9999,0,9999,0
1714374653366,CSE 191,A00,516875,Minnes Kemp; Mor Mia,9993,0,9999,6
1714374654395,CSE 197,001,637388,Minnes Kemp; Mor Mia,9998,0,9999,1
1714374655424,CSS 201S,A01,494383,Staff,35,0,35,0
1714374656450,CSS 202S,A01,494387,Staff,35,0,35,0
1714374657475,DSC 197,001,628532,Eldridge; Justin Matthew,9996,0,9999,3
1714374658509,EAP 100,A00,516065,Staff,9797,0,9999,202
1714374659534,ECE 45,A01,507414,Staff,33,0,60,27
1714374661587,ECE 111,A01,507420,Staff,19,0,50,31
1714374662649,ECE 197,001,548057,Sievenpiper; Daniel F.,9994,0,9999,5
1714374663934,EDS 115,A00,507243,Choi; Bailey Miyeon,12,0,28,16
1714374665027,EDS 117,A01,494379,Staff,0,2,30,30
1714374666060,EDS 125,A00,507246,Hopkins; Megan Beth,12,0,30,18
1714374667086,EDS 128A,A01,507264,Fargason; Sharon Gayle,14,0,26,12
1714374668112,EDS 128B,A01,507293,Pappas; Elizabeth,18,0,30,12
1714374669138,EDS 139,A00,507294,Fargason; Sharon Gayle,18,0,30,12
1714374669138,EDS 139,B00,507313,Pappas; Elizabeth,15,0,30,15
1714374670166,EDS 201,A00,507315,Staff,13,0,30,17
1714374671196,EDS 203,A01,507317,Halter; Christopher P.,12,0,30,18
1714374672224,EDS 204R,A01,507319,Halter; Christopher P.,0,3,30,30
1714374672224,EDS 204R,B01,507331,Heinzman; Erica M.,17,0,30,13
1714374673251,EDS 206R,A00,507332,Staff,0,4,30,30
1714374673251,EDS 206R,B00,507343,Staff,18,0,30,12
1714374674283,EDS 250,A00,507344,Hemans; Patricia Ann Benitez,22,0,40,18
1714374675308,EDS 281,A00,507345,Daly; Alan J.,18,0,18,0
1714374676336,EDS 284,A00,507350,Daly; Alan J.,16,0,16,0
1714374677370,EDS 286,A00,507359,Fine; Sarah,18,0,18,0
1714374678396,EDS 289C,A01,507361,Daly; Alan J.,18,0,18,0
1714374679428,EDS 290,A00,507366,Hofstetter; Carolyn,15,0,15,0
1714374680460,LIGM 5A,A00,507421,Fischer-Grunski; Eva K,18,0,20,2
1714374681489,LIGM 5B,A00,507423,Fischer-Grunski; Eva K,19,0,20,1
1714374682518,LIGM 5C,A00,507425,Fischer-Grunski; Eva K,19,0,20,1
1714374683543,LIIT 5AS,A00,507427,Carnelos; Chiara,20,0,20,0
1714374684570,LIIT 5BS,A00,507430,Carnelos; Chiara,20,0,20,0
1714374685600,LIIT 5CS,A00,507432,Carnelos; Chiara,20,0,20,0
1714374686636,LISP 5A,A00,507541,Munoz Sanchez; Alicia,11,0,20,9
1714374687662,LISP 5B,A00,507671,Munoz Sanchez; Alicia,9,0,20,11
1714374688687,LISP 5C,A00,507696,Munoz Sanchez; Alicia,9,0,20,11
1714374689714,MAE 197,001,528363,Boechler; Nicholas Sebastia,9998,0,9999,1
1714374690739,MATH 197,001,523477,Kedlaya; Kiran S.,9996,0,9999,3
1714374690739,MATH 197,002,563811,Zhang; Danna,9995,0,9999,4
1714374690739,MATH 197,003,628552,Dumitriu; Ioana,9998,0,9999,1
1714374691769,MCWP 40R,A00,518780,Staff,5,0,20,15
1714374691769,MCWP 40R,B00,518781,Staff,7,0,20,13
1714374691769,MCWP 40R,C00,518783,Staff,5,0,20,15
1714374692796,MCWP 50R,A00,518791,Staff,0,0,20,20
1714374692796,MCWP 50R,B00,518792,Staff,0,1,20,20
1714374692796,MCWP 50R,C00,518793,Staff,0,1,20,20
1714374692796,MCWP 50R,D00,518794,Staff,0,0,20,20
1714374692796,MCWP 50R,E00,518795,Staff,0,1,20,20
1714374692796,MCWP 50R,F00,518796,Staff,0,0,20,20
1714374692796,MCWP 50R,G00,518797,Staff,0,1,20,20
1714374693825,MMW 12R,A01,514034,Herbst; Matthew,0,1,16,16
1714374693825,MMW 12R,A02,514035,Herbst; Matthew,2,0,16,14
1714374694849,MMW 13R,A01,514037,Staff,0,4,16,16
1714374694849,MMW 13R,A02,514039,Staff,0,2,16,16
1714374694849,MMW 13R,A03,628519,Staff,0,2,16,16
1714374696903,SIO 295LS,A00,523233,Staff,12,0,30,18
1714374697929,SIO 295S,A00,523232,Staff,12,0,30,18
1714374698962,SIOC 290S,A01,637330,Merrifield; Mark A,27,0,30,3
1714374699993,SIOC 291S,A01,637333,Gabriel; Corey John,27,0,30,3
1714374701022,SOCI 117,A01,494376,Staff,0,4,5,5
1714374702050,WES 237B,A00,494380,Staff,9,0,20,11
1714374704129,AESE 279B,A00,494370,Wade; Jon P,0,0,33,33
1714374705154,AIP 197,001,627712,Vespa; Emanuel Ignacio,9998,0,9999,1
1714374706181,ANAR 135S,A00,494369,Braswell; Geoffrey E.,0,0,0,0
1714374707207,BENG 196,001,628496,Engler; Adam J.,9998,0,9999,1
1714374708232,CAT 124RS,A01,519847,Geibel; William,0,0,20,20
1714374709260,CAT 125RS,A01,515971,Geibel; William,0,0,20,20
1714374710286,CLRE 250,A00,511389,Morris; Sheldon,9993,0,9999,6
1714374711312,CLRE 251,A00,507176,Mehta; Ravindra L.,9993,0,9999,6
1714374711312,CLRE 251,B00,511410,Mehta; Ravindra L.,9998,0,9999,1
1714374712338,CLRE 252,A00,507189,Cuomo; Raphael Eduardo,9995,0,9999,4
1714374713363,CLRE 253,A00,507199,Vaida; Florin,9994,0,9999,5
1714374713363,CLRE 253,B00,507202,Vaida; Florin,9999,0,9999,0
1714374714388,CLRE 259,A00,507211,Patel; Hemal,9996,0,9999,3
1714374715416,CLRE 260,A00,507221,Cuomo; Raphael Eduardo,9999,0,9999,0
1714374716441,CLRE 297,001,507242,Cuomo; Raphael Eduardo,9999,0,9999,0
1714374717466,COGS 197,001,638244,Voytek; Bradley Thomas,9999,0,9999,0
1714374718494,CSE 191,A00,516875,Minnes Kemp; Mor Mia,9993,0,9999,6
1714374719519,CSE 197,001,637388,Minnes Kemp; Mor Mia,9998,0,9999,1
1714374720550,CSS 201S,A01,494383,Staff,35,0,35,0
1714374721575,CSS 202S,A01,494387,Staff,35,0,35,0
1714374722605,DSC 197,001,628532,Eldridge; Justin Matthew,9996,0,9999,3
1714374723629,EAP 100,A00,516065,Staff,9797,0,9999,202
1714374724659,ECE 45,A01,507414,Staff,33,0,60,27
1714374726714,ECE 111,A01,507420,Staff,19,0,50,31
1714374727740,ECE 197,001,548057,Sievenpiper; Daniel F.,9994,0,9999,5
1714374728765,EDS 115,A00,507243,Choi; Bailey Miyeon,12,0,28,16
1714374729794,EDS 117,A01,494379,Staff,0,2,30,30
1714374730819,EDS 125,A00,507246,Hopkins; Megan Beth,12,0,30,18
1714374731851,EDS 128A,A01,507264,Fargason; Sharon Gayle,14,0,26,12
1714374732882,EDS 128B,A01,507293,Pappas; Elizabeth,18,0,30,12
1714374733908,EDS 139,A00,507294,Fargason; Sharon Gayle,18,0,30,12
1714374733908,EDS 139,B00,507313,Pappas; Elizabeth,15,0,30,15
1714374734933,EDS 201,A00,507315,Staff,13,0,30,17
1714374735958,EDS 203,A01,507317,Halter; Christopher P.,12,0,30,18
1714374736983,EDS 204R,A01,507319,Halter; Christopher P.,0,3,30,30
1714374736983,EDS 204R,B01,507331,Heinzman; Erica M.,17,0,30,13
1714374738008,EDS 206R,A00,507332,Staff,0,4,30,30
1714374738008,EDS 206R,B00,507343,Staff,18,0,30,12
1714374739037,EDS 250,A00,507344,Hemans; Patricia Ann Benitez,22,0,40,18
1714374740066,EDS 281,A00,507345,Daly; Alan J.,18,0,18,0
1714374741091,EDS 284,A00,507350,Daly; Alan J.,16,0,16,0
1714374742115,EDS 286,A00,507359,Fine; Sarah,18,0,18,0
1714374743142,EDS 289C,A01,507361,Daly; Alan J.,18,0,18,0
1714374744170,EDS 290,A00,507366,Hofstetter; Carolyn,15,0,15,0
1714374745201,LIGM 5A,A00,507421,Fischer-Grunski; Eva K,18,0,20,2
1714374746233,LIGM 5B,A00,507423,Fischer-Grunski; Eva K,19,0,20,1
1714374747266,LIGM 5C,A00,507425,Fischer-Grunski; Eva K,19,0,20,1
1714374748295,LIIT 5AS,A00,507427,Carnelos; Chiara,20,0,20,0
1714374749325,LIIT 5BS,A00,507430,Carnelos; Chiara,20,0,20,0
1714374750349,LIIT 5CS,A00,507432,Carnelos; Chiara,20,0,20,0
1714374751380,LISP 5A,A00,507541,Munoz Sanchez; Alicia,11,0,20,9
1714374752407,LISP 5B,A00,507671,Munoz Sanchez; Alicia,9,0,20,11
1714374753433,LISP 5C,A00,507696,Munoz Sanchez; Alicia,9,0,20,11
1714374754458,MAE 197,001,528363,Boechler; Nicholas Sebastia,9998,0,9999,1
1714374755482,MATH 197,001,523477,Kedlaya; Kiran S.,9996,0,9999,3
1714374755482,MATH 197,002,563811,Zhang; Danna,9995,0,9999,4
1714374755482,MATH 197,003,628552,Dumitriu; Ioana,9998,0,9999,1
1714374756508,MCWP 40R,A00,518780,Staff,5,0,20,15
1714374756508,MCWP 40R,B00,518781,Staff,7,0,20,13
1714374756508,MCWP 40R,C00,518783,Staff,5,0,20,15
1714374757532,MCWP 50R,A00,518791,Staff,0,0,20,20
1714374757532,MCWP 50R,B00,518792,Staff,0,1,20,20
1714374757532,MCWP 50R,C00,518793,Staff,0,1,20,20
1714374757532,MCWP 50R,D00,518794,Staff,0,0,20,20
1714374757532,MCWP 50R,E00,518795,Staff,0,1,20,20
1714374757532,MCWP 50R,F00,518796,Staff,0,0,20,20
1714374757532,MCWP 50R,G00,518797,Staff,0,1,20,20
1714374758560,MMW 12R,A01,514034,Herbst; Matthew,0,1,16,16
1714374758560,MMW 12R,A02,514035,Herbst; Matthew,2,0,16,14
1714374759586,MMW 13R,A01,514037,Staff,0,4,16,16
1714374759586,MMW 13R,A02,514039,Staff,0,2,16,16
1714374759586,MMW 13R,A03,628519,Staff,0,2,16,16
1714374761635,SIO 295LS,A00,523233,Staff,12,0,30,18
1714374762661,SIO 295S,A00,523232,Staff,12,0,30,18
1714374763687,SIOC 290S,A01,637330,Merrifield; Mark A,27,0,30,3
1714374764717,SIOC 291S,A01,637333,Gabriel; Corey John,27,0,30,3
1714374765745,SOCI 117,A01,494376,Staff,0,4,5,5
1714374766768,WES 237B,A00,494380,Staff,9,0,20,11
1714374768889,AESE 279B,A00,494370,Wade; Jon P,0,0,33,33
1714374769916,AIP 197,001,627712,Vespa; Emanuel Ignacio,9998,0,9999,1
1714374770943,ANAR 135S,A00,494369,Braswell; Geoffrey E.,0,0,0,0
1714374771968,BENG 196,001,628496,Engler; Adam J.,9998,0,9999,1
1714374772992,CAT 124RS,A01,519847,Geibel; William,0,0,20,20
1714374774016,CAT 125RS,A01,515971,Geibel; William,0,0,20,20
1714374775043,CLRE 250,A00,511389,Morris; Sheldon,9993,0,9999,6
1714374776073,CLRE 251,A00,507176,Mehta; Ravindra L.,9993,0,9999,6
1714374776073,CLRE 251,B00,511410,Mehta; Ravindra L.,9998,0,9999,1
1714374777103,CLRE 252,A00,507189,Cuomo; Raphael Eduardo,9995,0,9999,4
1714374778130,CLRE 253,A00,507199,Vaida; Florin,9994,0,9999,5
1714374778130,CLRE 253,B00,507202,Vaida; Florin,9999,0,9999,0
1714374779156,CLRE 259,A00,507211,Patel; Hemal,9996,0,9999,3
1714374780185,CLRE 260,A00,507221,Cuomo; Raphael Eduardo,9999,0,9999,0
1714374781214,CLRE 297,001,507242,Cuomo; Raphael Eduardo,9999,0,9999,0
1714374782240,COGS 197,001,638244,Voytek; Bradley Thomas,9999,0,9999,0
1714374783275,CSE 191,A00,516875,Minnes Kemp; Mor Mia,9993,0,9999,6
1714374784300,CSE 197,001,637388,Minnes Kemp; Mor Mia,9998,0,9999,1
1714374785324,CSS 201S,A01,494383,Staff,35,0,35,0
1714374786359,CSS 202S,A01,494387,Staff,35,0,35,0
1714374787387,DSC 197,001,628532,Eldridge; Justin Matthew,9996,0,9999,3
1714374788413,EAP 100,A00,516065,Staff,9797,0,9999,202
1714374789443,ECE 45,A01,507414,Staff,33,0,60,27
1714374791494,ECE 111,A01,507420,Staff,19,0,50,31
1714374792520,ECE 197,001,548057,Sievenpiper; Daniel F.,9994,0,9999,5
1714374793550,EDS 115,A00,507243,Choi; Bailey Miyeon,12,0,28,16
1714374794575,EDS 117,A01,494379,Staff,0,2,30,30
1714374795604,EDS 125,A00,507246,Hopkins; Megan Beth,12,0,30,18
1714374796634,EDS 128A,A01,507264,Fargason; Sharon Gayle,14,0,26,12
1714374797659,EDS 128B,A01,507293,Pappas; Elizabeth,18,0,30,12
1714374798685,EDS 139,A00,507294,Fargason; Sharon Gayle,18,0,30,12
1714374798685,EDS 139,B00,507313,Pappas; Elizabeth,15,0,30,15
1714374799710,EDS 201,A00,507315,Staff,13,0,30,17
1714374800734,EDS 203,A01,507317,Halter; Christopher P.,12,0,30,18
1714374801759,EDS 204R,A01,507319,Halter; Christopher P.,0,3,30,30
1714374801759,EDS 204R,B01,507331,Heinzman; Erica M.,17,0,30,13
1714374802784,EDS 206R,A00,507332,Staff,0,4,30,30
1714374802784,EDS 206R,B00,507343,Staff,18,0,30,12
1714374803810,EDS 250,A00,507344,Hemans; Patricia Ann Benitez,22,0,40,18
1714374804848,EDS 281,A00,507345,Daly; Alan J.,18,0,18,0
1714374805872,EDS 284,A00,507350,Daly; Alan J.,16,0,16,0
1714374806899,EDS 286,A00,507359,Fine; Sarah,18,0,18,0
1714374807929,EDS 289C,A01,507361,Daly; Alan J.,18,0,18,0
1714374808957,EDS 290,A00,507366,Hofstetter; Carolyn,15,0,15,0
1714374809988,LIGM 5A,A00,507421,Fischer-Grunski; Eva K,18,0,20,2
1714374811031,LIGM 5B,A00,507423,Fischer-Grunski; Eva K,19,0,20,1
1714374812056,LIGM 5C,A00,507425,Fischer-Grunski; Eva K,19,0,20,1
1714374813081,LIIT 5AS,A00,507427,Carnelos; Chiara,20,0,20,0
1714374814105,LIIT 5BS,A00,507430,Carnelos; Chiara,20,0,20,0
1714374815131,LIIT 5CS,A00,507432,Carnelos; Chiara,20,0,20,0
1714374816158,LISP 5A,A00,507541,Munoz Sanchez; Alicia,11,0,20,9
1714374817202,LISP 5B,A00,507671,Munoz Sanchez; Alicia,9,0,20,11
1714374818229,LISP 5C,A00,507696,Munoz Sanchez; Alicia,9,0,20,11
1714374819258,MAE 197,001,528363,Boechler; Nicholas Sebastia,9998,0,9999,1
1714374820284,MATH 197,001,523477,Kedlaya; Kiran S.,9996,0,9999,3
1714374820284,MATH 197,002,563811,Zhang; Danna,9995,0,9999,4
1714374820284,MATH 197,003,628552,Dumitriu; Ioana,9998,0,9999,1
1714374821313,MCWP 40R,A00,518780,Staff,5,0,20,15
1714374821313,MCWP 40R,B00,518781,Staff,7,0,20,13
1714374821313,MCWP 40R,C00,518783,Staff,5,0,20,15
1714374822339,MCWP 50R,A00,518791,Staff,0,0,20,20
1714374822339,MCWP 50R,B00,518792,Staff,0,1,20,20
1714374822339,MCWP 50R,C00,518793,Staff,0,1,20,20
1714374822339,MCWP 50R,D00,518794,Staff,0,0,20,20
1714374822339,MCWP 50R,E00,518795,Staff,0,1,20,20
1714374822339,MCWP 50R,F00,518796,Staff,0,0,20,20
1714374822339,MCWP 50R,G00,518797,Staff,0,1,20,20
1714374823364,MMW 12R,A01,514034,Herbst; Matthew,0,1,16,16
1714374823364,MMW 12R,A02,514035,Herbst; Matthew,2,0,16,14
1714374824393,MMW 13R,A01,514037,Staff,0,4,16,16
1714374824393,MMW 13R,A02,514039,Staff,0,2,16,16
1714374824393,MMW 13R,A03,628519,Staff,0,2,16,16
1714374826448,SIO 295LS,A00,523233,Staff,12,0,30,18
1714374827473,SIO 295S,A00,523232,Staff,12,0,30,18
1714374828501,SIOC 290S,A01,637330,Merrifield; Mark A,27,0,30,3
1714374829525,SIOC 291S,A01,637333,Gabriel; Corey John,27,0,30,3
1714374830554,SOCI 117,A01,494376,Staff,0,4,5,5
1714374831587,WES 237B,A00,494380,Staff,9,0,20,11
1714374833650,AESE 279B,A00,494370,Wade; Jon P,0,0,33,33
1714374834675,AIP 197,001,627712,Vespa; Emanuel Ignacio,9998,0,9999,1
1714374835700,ANAR 135S,A00,494369,Braswell; Geoffrey E.,0,0,0,0
1714374836738,BENG 196,001,628496,Engler; Adam J.,9998,0,9999,1
1714374837767,CAT 124RS,A01,519847,Geibel; William,0,0,20,20
1714374838794,CAT 125RS,A01,515971,Geibel; William,0,0,20,20
1714374839822,CLRE 250,A00,511389,Morris; Sheldon,9993,0,9999,6
1714374840849,CLRE 251,A00,507176,Mehta; Ravindra L.,9993,0,9999,6
1714374840849,CLRE 251,B00,511410,Mehta; Ravindra L.,9998,0,9999,1
1714374841876,CLRE 252,A00,507189,Cuomo; Raphael Eduardo,9995,0,9999,4
1714374842901,CLRE 253,A00,507199,Vaida; Florin,9994,0,9999,5
1714374842901,CLRE 253,B00,507202,Vaida; Florin,9999,0,9999,0
1714374843926,CLRE 259,A00,507211,Patel; Hemal,9996,0,9999,3
1714374844951,CLRE 260,A00,507221,Cuomo; Raphael Eduardo,9999,0,9999,0
1714374845976,CLRE 297,001,507242,Cuomo; Raphael Eduardo,9999,0,9999,0
1714374847001,COGS 197,001,638244,Voytek; Bradley Thomas,9999,0,9999,0
1714374848026,CSE 191,A00,516875,Minnes Kemp; Mor Mia,9993,0,9999,6
1714374849052,CSE 197,001,637388,Minnes Kemp; Mor Mia,9998,0,9999,1
1714374850077,CSS 201S,A01,494383,Staff,35,0,35,0
1714374851103,CSS 202S,A01,494387,Staff,35,0,35,0
1714374852127,DSC 197,001,628532,Eldridge; Justin Matthew,9996,0,9999,3
1714374853154,EAP 100,A00,516065,Staff,9797,0,9999,202
1714374854179,ECE 45,A01,507414,Staff,33,0,60,27
1714374856230,ECE 111,A01,507420,Staff,19,0,50,31
1714374857255,ECE 197,001,548057,Sievenpiper; Daniel F.,9994,0,9999,5
1714374858279,EDS 115,A00,507243,Choi; Bailey Miyeon,12,0,28,16
1714374859308,EDS 117,A01,494379,Staff,0,2,30,30
1714374860336,EDS 125,A00,507246,Hopkins; Megan Beth,12,0,30,18
1714374861364,EDS 128A,A01,507264,Fargason; Sharon Gayle,14,0,26,12
1714374862388,EDS 128B,A01,507293,Pappas; Elizabeth,18,0,30,12
1714374863413,EDS 139,A00,507294,Fargason; Sharon Gayle,18,0,30,12
1714374863413,EDS 139,B00,507313,Pappas; Elizabeth,15,0,30,15
1714374864441,EDS 201,A00,507315,Staff,13,0,30,17
1714374865467,EDS 203,A01,507317,Halter; Christopher P.,12,0,30,18
1714374866492,EDS 204R,A01,507319,Halter; Christopher P.,0,3,30,30
1714374866492,EDS 204R,B01,507331,Heinzman; Erica M.,17,0,30,13
1714374867517,EDS 206R,A00,507332,Staff,0,4,30,30
1714374867517,EDS 206R,B00,507343,Staff,18,0,30,12
1714374868542,EDS 250,A00,507344,Hemans; Patricia Ann Benitez,22,0,40,18
1714374869566,EDS 281,A00,507345,Daly; Alan J.,18,0,18,0
1714374870593,EDS 284,A00,507350,Daly; Alan J.,16,0,16,0
1714374871618,EDS 286,A00,507359,Fine; Sarah,18,0,18,0
1714374872699,EDS 289C,A01,507361,Daly; Alan J.,18,0,18,0
1714374873723,EDS 290,A00,507366,Hofstetter; Carolyn,15,0,15,0
1714374874750,LIGM 5A,A00,507421,Fischer-Grunski; Eva K,18,0,20,2
1714374875778,LIGM 5B,A00,507423,Fischer-Grunski; Eva K,19,0,20,1
1714374876805,LIGM 5C,A00,507425,Fischer-Grunski; Eva K,19,0,20,1
1714374877831,LIIT 5AS,A00,507427,Carnelos; Chiara,20,0,20,0
1714374878856,LIIT 5BS,A00,507430,Carnelos; Chiara,20,0,20,0
1714374879881,LIIT 5CS,A00,507432,Carnelos; Chiara,20,0,20,0
1714374880908,LISP 5A,A00,507541,Munoz Sanchez; Alicia,11,0,20,9
1714374881934,LISP 5B,A00,507671,Munoz Sanchez; Alicia,9,0,20,11
1714374882958,LISP 5C,A00,507696,Munoz Sanchez; Alicia,9,0,20,11
1714374883985,MAE 197,001,528363,Boechler; Nicholas Sebastia,9998,0,9999,1
1714374885015,MATH 197,001,523477,Kedlaya; Kiran S.,9996,0,9999,3
1714374885015,MATH 197,002,563811,Zhang; Danna,9995,0,9999,4
1714374885015,MATH 197,003,628552,Dumitriu; Ioana,9998,0,9999,1
1714374886040,MCWP 40R,A00,518780,Staff,5,0,20,15
1714374886040,MCWP 40R,B00,518781,Staff,7,0,20,13
1714374886040,MCWP 40R,C00,518783,Staff,5,0,20,15
1714374887065,MCWP 50R,A00,518791,Staff,0,0,20,20
1714374887065,MCWP 50R,B00,518792,Staff,0,1,20,20
1714374887065,MCWP 50R,C00,518793,Staff,0,1,20,20
1714374887065,MCWP 50R,D00,518794,Staff,0,0,20,20
1714374887065,MCWP 50R,E00,518795,Staff,0,1,20,20
1714374887065,MCWP 50R,F00,518796,Staff,0,0,20,20
1714374887065,MCWP 50R,G00,518797,Staff,0,1,20,20
1714374888093,MMW 12R,A01,514034,Herbst; Matthew,0,1,16,16
1714374888093,MMW 12R,A02,514035,Herbst; Matthew,2,0,16,14
1714374889122,MMW 13R,A01,514037,Staff,0,4,16,16
1714374889122,MMW 13R,A02,514039,Staff,0,2,16,16
1714374889122,MMW 13R,A03,628519,Staff,0,2,16,16
1714374891175,SIO 295LS,A00,523233,Staff,12,0,30,18
1714374892201,SIO 295S,A00,523232,Staff,12,0,30,18
1714374893231,SIOC 290S,A01,637330,Merrifield; Mark A,27,0,30,3
1714374894258,SIOC 291S,A01,637333,Gabriel; Corey John,27,0,30,3
1714374895288,SOCI 117,A01,494376,Staff,0,4,5,5
1714374896317,WES 237B,A00,494380,Staff,9,0,20,11
1714374898374,AESE 279B,A00,494370,Wade; Jon P,0,0,33,33
1714374899402,AIP 197,001,627712,Vespa; Emanuel Ignacio,9998,0,9999,1
1714374900427,ANAR 135S,A00,494369,Braswell; Geoffrey E.,0,0,0,0
1714374901452,BENG 196,001,628496,Engler; Adam J.,9998,0,9999,1
1714374902477,CAT 124RS,A01,519847,Geibel; William,0,0,20,20
1714374903501,CAT 125RS,A01,515971,Geibel; William,0,0,20,20
1714374904524,CLRE 250,A00,511389,Morris; Sheldon,9993,0,9999,6
1714374905553,CLRE 251,A00,507176,Mehta; Ravindra L.,9993,0,9999,6
1714374905553,CLRE 251,B00,511410,Mehta; Ravindra L.,9998,0,9999,1
1714374906583,CLRE 252,A00,507189,Cuomo; Raphael Eduardo,9995,0,9999,4
1714374907609,CLRE 253,A00,507199,Vaida; Florin,9994,0,9999,5
1714374907609,CLRE 253,B00,507202,Vaida; Florin,9999,0,9999,0
1714374908635,CLRE 259,A00,507211,Patel; Hemal,9996,0,9999,3
1714374909660,CLRE 260,A00,507221,Cuomo; Raphael Eduardo,9999,0,9999,0
1714374910686,CLRE 297,001,507242,Cuomo; Raphael Eduardo,9999,0,9999,0
1714374911713,COGS 197,001,638244,Voytek; Bradley Thomas,9999,0,9999,0
1714374912742,CSE 191,A00,516875,Minnes Kemp; Mor Mia,9993,0,9999,6
1714374913767,CSE 197,001,637388,Minnes Kemp; Mor Mia,9998,0,9999,1
1714374914794,CSS 201S,A01,494383,Staff,35,0,35,0
1714374915820,CSS 202S,A01,494387,Staff,35,0,35,0
1714374916845,DSC 197,001,628532,Eldridge; Justin Matthew,9996,0,9999,3
1714374917872,EAP 100,A00,516065,Staff,9797,0,9999,202
1714374918898,ECE 45,A01,507414,Staff,33,0,60,27
1714374920949,ECE 111,A01,507420,Staff,19,0,50,31
1714374921975,ECE 197,001,548057,Sievenpiper; Daniel F.,9994,0,9999,5
1714374923004,EDS 115,A00,507243,Choi; Bailey Miyeon,12,0,28,16
1714374924035,EDS 117,A01,494379,Staff,0,2,30,30
1714374925060,EDS 125,A00,507246,Hopkins; Megan Beth,12,0,30,18
1714374926085,EDS 128A,A01,507264,Fargason; Sharon Gayle,14,0,26,12
1714374927114,EDS 128B,A01,507293,Pappas; Elizabeth,18,0,30,12
1714374928142,EDS 139,A00,507294,Fargason; Sharon Gayle,18,0,30,12
1714374928142,EDS 139,B00,507313,Pappas; Elizabeth,15,0,30,15
1714374929171,EDS 201,A00,507315,Staff,13,0,30,17
1714374930199,EDS 203,A01,507317,Halter; Christopher P.,12,0,30,18
1714374931224,EDS 204R,A01,507319,Halter; Christopher P.,0,3,30,30
1714374931224,EDS 204R,B01,507331,Heinzman; Erica M.,17,0,30,13
1714374932249,EDS 206R,A00,507332,Staff,0,4,30,30
1714374932249,EDS 206R,B00,507343,Staff,18,0,30,12
1714374933277,EDS 250,A00,507344,Hemans; Patricia Ann Benitez,22,0,40,18
1714374934309,EDS 281,A00,507345,Daly; Alan J.,18,0,18,0
1714374935333,EDS 284,A00,507350,Daly; Alan J.,16,0,16,0
1714374936358,EDS 286,A00,507359,Fine; Sarah,18,0,18,0
1714374937382,EDS 289C,A01,507361,Daly; Alan J.,18,0,18,0
1714374938407,EDS 290,A00,507366,Hofstetter; Carolyn,15,0,15,0
1714374939432,LIGM 5A,A00,507421,Fischer-Grunski; Eva K,18,0,20,2
1714374940457,LIGM 5B,A00,507423,Fischer-Grunski; Eva K,19,0,20,1
1714374941499,LIGM 5C,A00,507425,Fischer-Grunski; Eva K,19,0,20,1
1714374942524,LIIT 5AS,A00,507427,Carnelos; Chiara,20,0,20,0
1714374943549,LIIT 5BS,A00,507430,Carnelos; Chiara,20,0,20,0
1714374944573,LIIT 5CS,A00,507432,Carnelos; Chiara,20,0,20,0
1714374945597,LISP 5A,A00,507541,Munoz Sanchez; Alicia,11,0,20,9
1714374946623,LISP 5B,A00,507671,Munoz Sanchez; Alicia,9,0,20,11
1714374947648,LISP 5C,A00,507696,Munoz Sanchez; Alicia,9,0,20,11
1714374948673,MAE 197,001,528363,Boechler; Nicholas Sebastia,9998,0,9999,1
1714374949699,MATH 197,001,523477,Kedlaya; Kiran S.,9996,0,9999,3
1714374949699,MATH 197,002,563811,Zhang; Danna,9995,0,9999,4
1714374949699,MATH 197,003,628552,Dumitriu; Ioana,9998,0,9999,1
1714374950726,MCWP 40R,A00,518780,Staff,5,0,20,15
1714374950726,MCWP 40R,B00,518781,Staff,7,0,20,13
1714374950726,MCWP 40R,C00,518783,Staff,5,0,20,15
1714374951752,MCWP 50R,A00,518791,Staff,0,0,20,20
1714374951752,MCWP 50R,B00,518792,Staff,0,1,20,20
1714374951752,MCWP 50R,C00,518793,Staff,0,1,20,20
1714374951752,MCWP 50R,D00,518794,Staff,0,0,20,20
1714374951752,MCWP 50R,E00,518795,Staff,0,1,20,20
1714374951752,MCWP 50R,F00,518796,Staff,0,0,20,20
1714374951752,MCWP 50R,G00,518797,Staff,0,1,20,20
1714374952781,MMW 12R,A01,514034,Herbst; Matthew,0,1,16,16
1714374952781,MMW 12R,A02,514035,Herbst; Matthew,2,0,16,14
1714374953809,MMW 13R,A01,514037,Staff,0,4,16,16
1714374953809,MMW 13R,A02,514039,Staff,0,2,16,16
1714374953809,MMW 13R,A03,628519,Staff,0,2,16,16
1714374955866,SIO 295LS,A00,523233,Staff,12,0,30,18
1714374956898,SIO 295S,A00,523232,Staff,12,0,30,18
1714374957924,SIOC 290S,A01,637330,Merrifield; Mark A,27,0,30,3
1714374958951,SIOC 291S,A01,637333,Gabriel; Corey John,27,0,30,3
1714374959976,SOCI 117,A01,494376,Staff,0,4,5,5
1714374961005,WES 237B,A00,494380,Staff,9,0,20,11
1714374963068,AESE 279B,A00,494370,Wade; Jon P,0,0,33,33
1714374964092,AIP 197,001,627712,Vespa; Emanuel Ignacio,9998,0,9999,1
1714374965122,ANAR 135S,A00,494369,Braswell; Geoffrey E.,0,0,0,0
1714374966147,BENG 196,001,628496,Engler; Adam J.,9998,0,9999,1
1714374967172,CAT 124RS,A01,519847,Geibel; William,0,0,20,20
1714374968198,CAT 125RS,A01,515971,Geibel; William,0,0,20,20
1714374969222,CLRE 250,A00,511389,Morris; Sheldon,9993,0,9999,6
1714374970252,CLRE 251,A00,507176,Mehta; Ravindra L.,9993,0,9999,6
1714374970252,CLRE 251,B00,511410,Mehta; Ravindra L.,9998,0,9999,1
1714374971281,CLRE 252,A00,507189,Cuomo; Raphael Eduardo,9995,0,9999,4
1714374972311,CLRE 253,A00,507199,Vaida; Florin,9994,0,9999,5
1714374972311,CLRE 253,B00,507202,Vaida; Florin,9999,0,9999,0
1714374973336,CLRE 259,A00,507211,Patel; Hemal,9996,0,9999,3
1714374974362,CLRE 260,A00,507221,Cuomo; Raphael Eduardo,9999,0,9999,0
1714374975386,CLRE 297,001,507242,Cuomo; Raphael Eduardo,9999,0,9999,0
1714374976468,COGS 197,001,638244,Voytek; Bradley Thomas,9999,0,9999,0
1714374977496,CSE 191,A00,516875,Minnes Kemp; Mor Mia,9993,0,9999,6
1714374978528,CSE 197,001,637388,Minnes Kemp; Mor Mia,9998,0,9999,1
1714374979558,CSS 201S,A01,494383,Staff,35,0,35,0
1714374980591,CSS 202S,A01,494387,Staff,35,0,35,0
1714374981618,DSC 197,001,628532,Eldridge; Justin Matthew,9996,0,9999,3
1714374982642,EAP 100,A00,516065,Staff,9797,0,9999,202
1714374983667,ECE 45,A01,507414,Staff,33,0,60,27
1714374985720,ECE 111,A01,507420,Staff,19,0,50,31
1714374986747,ECE 197,001,548057,Sievenpiper; Daniel F.,9994,0,9999,5
1714374987772,EDS 115,A00,507243,Choi; Bailey Miyeon,12,0,28,16
1714374988796,EDS 117,A01,494379,Staff,0,2,30,30
1714374989825,EDS 125,A00,507246,Hopkins; Megan Beth,12,0,30,18
1714374990855,EDS 128A,A01,507264,Fargason; Sharon Gayle,14,0,26,12
1714374991880,EDS 128B,A01,507293,Pappas; Elizabeth,18,0,30,12
1714374992907,EDS 139,A00,507294,Fargason; Sharon Gayle,18,0,30,12
1714374992907,EDS 139,B00,507313,Pappas; Elizabeth,15,0,30,15
1714374993933,EDS 201,A00,507315,Staff,13,0,30,17
1714374994960,EDS 203,A01,507317,Halter; Christopher P.,12,0,30,18
1714374995984,EDS 204R,A01,507319,Halter; Christopher P.,0,3,30,30
1714374995984,EDS 204R,B01,507331,Heinzman; Erica M.,17,0,30,13
1714374997012,EDS 206R,A00,507332,Staff,0,4,30,30
1714374997012,EDS 206R,B00,507343,Staff,18,0,30,12
1714374998039,EDS 250,A00,507344,Hemans; Patricia Ann Benitez,22,0,40,18
1714374999063,EDS 281,A00,507345,Daly; Alan J.,18,0,18,0
1714375000087,EDS 284,A00,507350,Daly; Alan J.,16,0,16,0
1714375001124,EDS 286,A00,507359,Fine; Sarah,18,0,18,0
1714375002149,EDS 289C,A01,507361,Daly; Alan J.,18,0,18,0
1714375003175,EDS 290,A00,507366,Hofstetter; Carolyn,15,0,15,0
1714375004204,LIGM 5A,A00,507421,Fischer-Grunski; Eva K,18,0,20,2
1714375005230,LIGM 5B,A00,507423,Fischer-Grunski; Eva K,19,0,20,1
1714375006254,LIGM 5C,A00,507425,Fischer-Grunski; Eva K,19,0,20,1
1714375007279,LIIT 5AS,A00,507427,Carnelos; Chiara,20,0,20,0
1714375008309,LIIT 5BS,A00,507430,Carnelos; Chiara,20,0,20,0
1714375009335,LIIT 5CS,A00,507432,Carnelos; Chiara,20,0,20,0
1714375010360,LISP 5A,A00,507541,Munoz Sanchez; Alicia,11,0,20,9
1714375011386,LISP 5B,A00,507671,Munoz Sanchez; Alicia,9,0,20,11
1714375012415,LISP 5C,A00,507696,Munoz Sanchez; Alicia,9,0,20,11
1714375013443,MAE 197,001,528363,Boechler; Nicholas Sebastia,9998,0,9999,1
1714375014469,MATH 197,001,523477,Kedlaya; Kiran S.,9996,0,9999,3
1714375014469,MATH 197,002,563811,Zhang; Danna,9995,0,9999,4
1714375014469,MATH 197,003,628552,Dumitriu; Ioana,9998,0,9999,1
1714375015494,MCWP 40R,A00,518780,Staff,5,0,20,15
1714375015494,MCWP 40R,B00,518781,Staff,7,0,20,13
1714375015494,MCWP 40R,C00,518783,Staff,5,0,20,15
1714375016519,MCWP 50R,A00,518791,Staff,0,0,20,20
1714375016519,MCWP 50R,B00,518792,Staff,0,1,20,20
1714375016519,MCWP 50R,C00,518793,Staff,0,1,20,20
1714375016519,MCWP 50R,D00,518794,Staff,0,0,20,20
1714375016519,MCWP 50R,E00,518795,Staff,0,1,20,20
1714375016519,MCWP 50R,F00,518796,Staff,0,0,20,20
1714375016519,MCWP 50R,G00,518797,Staff,0,1,20,20
1714375017547,MMW 12R,A01,514034,Herbst; Matthew,0,1,16,16
1714375017547,MMW 12R,A02,514035,Herbst; Matthew,2,0,16,14
1714375018575,MMW 13R,A01,514037,Staff,0,4,16,16
1714375018575,MMW 13R,A02,514039,Staff,0,2,16,16
1714375018575,MMW 13R,A03,628519,Staff,0,2,16,16
1714375020625,SIO 295LS,A00,523233,Staff,12,0,30,18
1714375021649,SIO 295S,A00,523232,Staff,12,0,30,18
1714375022674,SIOC 290S,A01,637330,Merrifield; Mark A,27,0,30,3
1714375023700,SIOC 291S,A01,637333,Gabriel; Corey John,27,0,30,3
1714375024729,SOCI 117,A01,494376,Staff,0,4,5,5
1714375025753,WES 237B,A00,494380,Staff,9,0,20,11
1714375027811,AESE 279B,A00,494370,Wade; Jon P,0,0,33,33
1714375028836,AIP 197,001,627712,Vespa; Emanuel Ignacio,9998,0,9999,1
1714375029860,ANAR 135S,A00,494369,Braswell; Geoffrey E.,0,0,0,0
1714375030884,BENG 196,001,628496,Engler; Adam J.,9998,0,9999,1
1714375031908,CAT 124RS,A01,519847,Geibel; William,0,0,20,20
1714375032934,CAT 125RS,A01,515971,Geibel; William,0,0,20,20
1714375033963,CLRE 250,A00,511389,Morris; Sheldon,9993,0,9999,6
1714375034994,CLRE 251,A00,507176,Mehta; Ravindra L.,9993,0,9999,6
1714375034994,CLRE 251,B00,511410,Mehta; Ravindra L.,9998,0,9999,1
1714375036019,CLRE 252,A00,507189,Cuomo; Raphael Eduardo,9995,0,9999,4
1714375037048,CLRE 253,A00,507199,Vaida; Florin,9994,0,9999,5
1714375037048,CLRE 253,B00,507202,Vaida; Florin,9999,0,9999,0
1714375038074,CLRE 259,A00,507211,Patel; Hemal,9996,0,9999,3
1714375039102,CLRE 260,A00,507221,Cuomo; Raphael Eduardo,9999,0,9999,0
1714375040131,CLRE 297,001,507242,Cuomo; Raphael Eduardo,9999,0,9999,0
1714375041171,COGS 197,001,638244,Voytek; Bradley Thomas,9999,0,9999,0
1714375042198,CSE 191,A00,516875,Minnes Kemp; Mor Mia,9993,0,9999,6
1714375043223,CSE 197,001,637388,Minnes Kemp; Mor Mia,9998,0,9999,1
1714375044249,CSS 201S,A01,494383,Staff,35,0,35,0
1714375045279,CSS 202S,A01,494387,Staff,35,0,35,0
1714375046310,DSC 197,001,628532,Eldridge; Justin Matthew,9996,0,9999,3
1714375047336,EAP 100,A00,516065,Staff,9797,0,9999,202
1714375048361,ECE 45,A01,507414,Staff,33,0,60,27
1714375050413,ECE 111,A01,507420,Staff,19,0,50,31
1714375051441,ECE 197,001,548057,Sievenpiper; Daniel F.,9994,0,9999,5
1714375052465,EDS 115,A00,507243,Choi; Bailey Miyeon,12,0,28,16
1714375053492,EDS 117,A01,494379,Staff,0,2,30,30
1714375054518,EDS 125,A00,507246,Hopkins; Megan Beth,12,0,30,18
1714375055547,EDS 128A,A01,507264,Fargason; Sharon Gayle,14,0,26,12
1714375056577,EDS 128B,A01,507293,Pappas; Elizabeth,18,0,30,12
1714375057601,EDS 139,A00,507294,Fargason; Sharon Gayle,18,0,30,12
1714375057601,EDS 139,B00,507313,Pappas; Elizabeth,15,0,30,15
1714375058626,EDS 201,A00,507315,Staff,13,0,30,17
1714375059655,EDS 203,A01,507317,Halter; Christopher P.,12,0,30,18
1714375060680,EDS 204R,A01,507319,Halter; Christopher P.,0,3,30,30
1714375060680,EDS 204R,B01,507331,Heinzman; Erica M.,17,0,30,13
1714375061706,EDS 206R,A00,507332,Staff,0,4,30,30
1714375061706,EDS 206R,B00,507343,Staff,18,0,30,12
1714375062733,EDS 250,A00,507344,Hemans; Patricia Ann Benitez,22,0,40,18
1714375063763,EDS 281,A00,507345,Daly; Alan J.,18,0,18,0
1714375064787,EDS 284,A00,507350,Daly; Alan J.,16,0,16,0
1714375065814,EDS 286,A00,507359,Fine; Sarah,18,0,18,0
1714375066842,EDS 289C,A01,507361,Daly; Alan J.,18,0,18,0
1714375067867,EDS 290,A00,507366,Hofstetter; Carolyn,15,0,15,0
1714375068895,LIGM 5A,A00,507421,Fischer-Grunski; Eva K,18,0,20,2
1714375069924,LIGM 5B,A00,507423,Fischer-Grunski; Eva K,19,0,20,1
1714375070955,LIGM 5C,A00,507425,Fischer-Grunski; Eva K,19,0,20,1
1714375071980,LIIT 5AS,A00,507427,Carnelos; Chiara,20,0,20,0
1714375073012,LIIT 5BS,A00,507430,Carnelos; Chiara,20,0,20,0
1714375074037,LIIT 5CS,A00,507432,Carnelos; Chiara,20,0,20,0
1714375075067,LISP 5A,A00,507541,Munoz Sanchez; Alicia,11,0,20,9
1714375076096,LISP 5B,A00,507671,Munoz Sanchez; Alicia,9,0,20,11
1714375077124,LISP 5C,A00,507696,Munoz Sanchez; Alicia,9,0,20,11
1714375078148,MAE 197,001,528363,Boechler; Nicholas Sebastia,9998,0,9999,1
1714375079173,MATH 197,001,523477,Kedlaya; Kiran S.,9996,0,9999,3
1714375079173,MATH 197,002,563811,Zhang; Danna,9995,0,9999,4
1714375079173,MATH 197,003,628552,Dumitriu; Ioana,9998,0,9999,1
1714375080254,MCWP 40R,A00,518780,Staff,5,0,20,15
1714375080254,MCWP 40R,B00,518781,Staff,7,0,20,13
1714375080254,MCWP 40R,C00,518783,Staff,5,0,20,15
1714375081285,MCWP 50R,A00,518791,Staff,0,0,20,20
1714375081285,MCWP 50R,B00,518792,Staff,0,1,20,20
1714375081285,MCWP 50R,C00,518793,Staff,0,1,20,20
1714375081285,MCWP 50R,D00,518794,Staff,0,0,20,20
1714375081285,MCWP 50R,E00,518795,Staff,0,1,20,20
1714375081285,MCWP 50R,F00,518796,Staff,0,0,20,20
1714375081285,MCWP 50R,G00,518797,Staff,0,1,20,20
1714375082312,MMW 12R,A01,514034,Herbst; Matthew,0,1,16,16
1714375082312,MMW 12R,A02,514035,Herbst; Matthew,2,0,16,14
1714375083339,MMW 13R,A01,514037,Staff,0,4,16,16
1714375083339,MMW 13R,A02,514039,Staff,0,2,16,16
1714375083339,MMW 13R,A03,628519,Staff,0,2,16,16
1714375085392,SIO 295LS,A00,523233,Staff,12,0,30,18
1714375086421,SIO 295S,A00,523232,Staff,12,0,30,18
1714375087447,SIOC 290S,A01,637330,Merrifield; Mark A,27,0,30,3
1714375088474,SIOC 291S,A01,637333,Gabriel; Corey John,27,0,30,3
1714375089498,SOCI 117,A01,494376,Staff,0,4,5,5
1714375090523,WES 237B,A00,494380,Staff,9,0,20,11
1714375092582,AESE 279B,A00,494370,Wade; Jon P,0,0,33,33
1714375093611,AIP 197,001,627712,Vespa; Emanuel Ignacio,9998,0,9999,1
1714375094638,ANAR 135S,A00,494369,Braswell; Geoffrey E.,0,0,0,0
1714375095661,BENG 196,001,628496,Engler; Adam J.,9998,0,9999,1
1714375096690,CAT 124RS,A01,519847,Geibel; William,0,0,20,20
1714375097715,CAT 125RS,A01,515971,Geibel; William,0,0,20,20
1714375098747,CLRE 250,A00,511389,Morris; Sheldon,9993,0,9999,6
1714375099776,CLRE 251,A00,507176,Mehta; Ravindra L.,9993,0,9999,6
1714375099776,CLRE 251,B00,511410,Mehta; Ravindra L.,9998,0,9999,1
1714375100804,CLRE 252,A00,507189,Cuomo; Raphael Eduardo,9995,0,9999,4
1714375101834,CLRE 253,A00,507199,Vaida; Florin,9994,0,9999,5
1714375101834,CLRE 253,B00,507202,Vaida; Florin,9999,0,9999,0
1714375102862,CLRE 259,A00,507211,Patel; Hemal,9996,0,9999,3
1714375103891,CLRE 260,A00,507221,Cuomo; Raphael Eduardo,9999,0,9999,0
1714375104916,CLRE 297,001,507242,Cuomo; Raphael Eduardo,9999,0,9999,0
1714375105943,COGS 197,001,638244,Voytek; Bradley Thomas,9999,0,9999,0
1714375106967,CSE 191,A00,516875,Minnes Kemp; Mor Mia,9993,0,9999,6
1714375107995,CSE 197,001,637388,Minnes Kemp; Mor Mia,9998,0,9999,1
1714375109025,CSS 201S,A01,494383,Staff,35,0,35,0
1714375110049,CSS 202S,A01,494387,Staff,35,0,35,0
1714375111079,DSC 197,001,628532,Eldridge; Justin Matthew,9996,0,9999,3
1714375112107,EAP 100,A00,516065,Staff,9797,0,9999,202
1714375113134,ECE 45,A01,507414,Staff,33,0,60,27
1714375115186,ECE 111,A01,507420,Staff,19,0,50,31
1714375116214,ECE 197,001,548057,Sievenpiper; Daniel F.,9994,0,9999,5
1714375117244,EDS 115,A00,507243,Choi; Bailey Miyeon,12,0,28,16
1714375118273,EDS 117,A01,494379,Staff,0,2,30,30
1714375119298,EDS 125,A00,507246,Hopkins; Megan Beth,12,0,30,18
1714375120328,EDS 128A,A01,507264,Fargason; Sharon Gayle,14,0,26,12
1714375121358,EDS 128B,A01,507293,Pappas; Elizabeth,18,0,30,12
1714375122383,EDS 139,A00,507294,Fargason; Sharon Gayle,18,0,30,12
1714375122383,EDS 139,B00,507313,Pappas; Elizabeth,15,0,30,15
1714375123408,EDS 201,A00,507315,Staff,13,0,30,17
1714375124434,EDS 203,A01,507317,Halter; Christopher P.,12,0,30,18
1714375125458,EDS 204R,A01,507319,Halter; Christopher P.,0,3,30,30
1714375125458,EDS 204R,B01,507331,Heinzman; Erica M.,17,0,30,13
1714375126483,EDS 206R,A00,507332,Staff,0,4,30,30
1714375126483,EDS 206R,B00,507343,Staff,18,0,30,12
1714375127507,EDS 250,A00,507344,Hemans; Patricia Ann Benitez,22,0,40,18
1714375128533,EDS 281,A00,507345,Daly; Alan J.,18,0,18,0
1714375129562,EDS 284,A00,507350,Daly; Alan J.,16,0,16,0
1714375130586,EDS 286,A00,507359,Fine; Sarah,18,0,18,0
1714375131613,EDS 289C,A01,507361,Daly; Alan J.,18,0,18,0
1714375132638,EDS 290,A00,507366,Hofstetter; Carolyn,15,0,15,0
1714375133669,LIGM 5A,A00,507421,Fischer-Grunski; Eva K,18,0,20,2
1714375134697,LIGM 5B,A00,507423,Fischer-Grunski; Eva K,19,0,20,1
1714375135722,LIGM 5C,A00,507425,Fischer-Grunski; Eva K,19,0,20,1
1714375136750,LIIT 5AS,A00,507427,Carnelos; Chiara,20,0,20,0
1714375137775,LIIT 5BS,A00,507430,Carnelos; Chiara,20,0,20,0
1714375138805,LIIT 5CS,A00,507432,Carnelos; Chiara,20,0,20,0
1714375139829,LISP 5A,A00,507541,Munoz Sanchez; Alicia,11,0,20,9
1714375140855,LISP 5B,A00,507671,Munoz Sanchez; Alicia,9,0,20,11
1714375141878,LISP 5C,A00,507696,Munoz Sanchez; Alicia,9,0,20,11
1714375142903,MAE 197,001,528363,Boechler; Nicholas Sebastia,9998,0,9999,1
1714375143928,MATH 197,001,523477,Kedlaya; Kiran S.,9996,0,9999,3
1714375143928,MATH 197,002,563811,Zhang; Danna,9995,0,9999,4
1714375143928,MATH 197,003,628552,Dumitriu; Ioana,9998,0,9999,1
1714375144954,MCWP 40R,A00,518780,Staff,5,0,20,15
1714375144954,MCWP 40R,B00,518781,Staff,7,0,20,13
1714375144954,MCWP 40R,C00,518783,Staff,5,0,20,15
1714375145983,MCWP 50R,A00,518791,Staff,0,0,20,20
1714375145983,MCWP 50R,B00,518792,Staff,0,1,20,20
1714375145983,MCWP 50R,C00,518793,Staff,0,1,20,20
1714375145983,MCWP 50R,D00,518794,Staff,0,0,20,20
1714375145983,MCWP 50R,E00,518795,Staff,0,1,20,20
1714375145983,MCWP 50R,F00,518796,Staff,0,0,20,20
1714375145983,MCWP 50R,G00,518797,Staff,0,1,20,20
1714375147012,MMW 12R,A01,514034,Herbst; Matthew,0,1,16,16
1714375147012,MMW 12R,A02,514035,Herbst; Matthew,2,0,16,14
1714375148039,MMW 13R,A01,514037,Staff,0,4,16,16
1714375148039,MMW 13R,A02,514039,Staff,0,2,16,16
1714375148039,MMW 13R,A03,628519,Staff,0,2,16,16
1714375150096,SIO 295LS,A00,523233,Staff,12,0,30,18
1714375151121,SIO 295S,A00,523232,Staff,12,0,30,18
1714375152149,SIOC 290S,A01,637330,Merrifield; Mark A,27,0,30,3
1714375153178,SIOC 291S,A01,637333,Gabriel; Corey John,27,0,30,3
1714375154205,SOCI 117,A01,494376,Staff,0,4,5,5
1714375155230,WES 237B,A00,494380,Staff,9,0,20,11
1714375157307,AESE 279B,A00,494370,Wade; Jon P,0,0,33,33
1714375158337,AIP 197,001,627712,Vespa; Emanuel Ignacio,9998,0,9999,1
1714375159361,ANAR 135S,A00,494369,Braswell; Geoffrey E.,0,0,0,0
1714375160419,BENG 196,001,628496,Engler; Adam J.,9998,0,9999,1
1714375161443,CAT 124RS,A01,519847,Geibel; William,0,0,20,20
1714375162467,CAT 125RS,A01,515971,Geibel; William,0,0,20,20
1714375163495,CLRE 250,A00,511389,Morris; Sheldon,9993,0,9999,6
1714375164521,CLRE 251,A00,507176,Mehta; Ravindra L.,9993,0,9999,6
1714375164521,CLRE 251,B00,511410,Mehta; Ravindra L.,9998,0,9999,1
1714375165551,CLRE 252,A00,507189,Cuomo; Raphael Eduardo,9995,0,9999,4
1714375166580,CLRE 253,A00,507199,Vaida; Florin,9994,0,9999,5
1714375166580,CLRE 253,B00,507202,Vaida; Florin,9999,0,9999,0
1714375167609,CLRE 259,A00,507211,Patel; Hemal,9996,0,9999,3
1714375168633,CLRE 260,A00,507221,Cuomo; Raphael Eduardo,9999,0,9999,0
1714375169658,CLRE 297,001,507242,Cuomo; Raphael Eduardo,9999,0,9999,0
1714375170684,COGS 197,001,638244,Voytek; Bradley Thomas,9999,0,9999,0
1714375171711,CSE 191,A00,516875,Minnes Kemp; Mor Mia,9993,0,9999,6
1714375172737,CSE 197,001,637388,Minnes Kemp; Mor Mia,9998,0,9999,1
1714375173770,CSS 201S,A01,494383,Staff,35,0,35,0
1714375174799,CSS 202S,A01,494387,Staff,35,0,35,0
1714375175825,DSC 197,001,628532,Eldridge; Justin Matthew,9996,0,9999,3
1714375176850,EAP 100,A00,516065,Staff,9797,0,9999,202
1714375177877,ECE 45,A01,507414,Staff,33,0,60,27
1714375179934,ECE 111,A01,507420,Staff,19,0,50,31
1714375180961,ECE 197,001,548057,Sievenpiper; Daniel F.,9994,0,9999,5
1714375181987,EDS 115,A00,507243,Choi; Bailey Miyeon,12,0,28,16
1714375183016,EDS 117,A01,494379,Staff,0,2,30,30
1714375184098,EDS 125,A00,507246,Hopkins; Megan Beth,12,0,30,18
1714375185128,EDS 128A,A01,507264,Fargason; Sharon Gayle,14,0,26,12
1714375186157,EDS 128B,A01,507293,Pappas; Elizabeth,18,0,30,12
1714375187185,EDS 139,A00,507294,Fargason; Sharon Gayle,18,0,30,12
1714375187185,EDS 139,B00,507313,Pappas; Elizabeth,15,0,30,15
1714375188211,EDS 201,A00,507315,Staff,13,0,30,17
1714375189239,EDS 203,A01,507317,Halter; Christopher P.,12,0,30,18
1714375190265,EDS 204R,A01,507319,Halter; Christopher P.,0,3,30,30
1714375190265,EDS 204R,B01,507331,Heinzman; Erica M.,17,0,30,13
1714375191291,EDS 206R,A00,507332,Staff,0,4,30,30
1714375191291,EDS 206R,B00,507343,Staff,18,0,30,12
1714375192318,EDS 250,A00,507344,Hemans; Patricia Ann Benitez,22,0,40,18
1714375193348,EDS 281,A00,507345,Daly; Alan J.,18,0,18,0
1714375194374,EDS 284,A00,507350,Daly; Alan J.,16,0,16,0
1714375195403,EDS 286,A00,507359,Fine; Sarah,18,0,18,0
1714375196431,EDS 289C,A01,507361,Daly; Alan J.,18,0,18,0
1714375197460,EDS 290,A00,507366,Hofstetter; Carolyn,15,0,15,0
1714375198486,LIGM 5A,A00,507421,Fischer-Grunski; Eva K,18,0,20,2
1714375199511,LIGM 5B,A00,507423,Fischer-Grunski; Eva K,19,0,20,1
1714375200539,LIGM 5C,A00,507425,Fischer-Grunski; Eva K,19,0,20,1
1714375201567,LIIT 5AS,A00,507427,Carnelos; Chiara,20,0,20,0
1714375202595,LIIT 5BS,A00,507430,Carnelos; Chiara,20,0,20,0
1714375203621,LIIT 5CS,A00,507432,Carnelos; Chiara,20,0,20,0
1714375204652,LISP 5A,A00,507541,Munoz Sanchez; Alicia,11,0,20,9
1714375205676,LISP 5B,A00,507671,Munoz Sanchez; Alicia,9,0,20,11
1714375206701,LISP 5C,A00,507696,Munoz Sanchez; Alicia,9,0,20,11
1714375207726,MAE 197,001,528363,Boechler; Nicholas Sebastia,9998,0,9999,1
1714375208754,MATH 197,001,523477,Kedlaya; Kiran S.,9996,0,9999,3
1714375208754,MATH 197,002,563811,Zhang; Danna,9995,0,9999,4
1714375208754,MATH 197,003,628552,Dumitriu; Ioana,9998,0,9999,1
1714375209782,MCWP 40R,A00,518780,Staff,5,0,20,15
1714375209782,MCWP 40R,B00,518781,Staff,7,0,20,13
1714375209782,MCWP 40R,C00,518783,Staff,5,0,20,15
1714375210807,MCWP 50R,A00,518791,Staff,0,0,20,20
1714375210807,MCWP 50R,B00,518792,Staff,0,1,20,20
1714375210807,MCWP 50R,C00,518793,Staff,0,1,20,20
1714375210807,MCWP 50R,D00,518794,Staff,0,0,20,20
1714375210807,MCWP 50R,E00,518795,Staff,0,1,20,20
1714375210807,MCWP 50R,F00,518796,Staff,0,0,20,20
1714375210807,MCWP 50R,G00,518797,Staff,0,1,20,20
1714375211836,MMW 12R,A01,514034,Herbst; Matthew,0,1,16,16
1714375211836,MMW 12R,A02,514035,Herbst; Matthew,2,0,16,14
1714375212862,MMW 13R,A01,514037,Staff,0,4,16,16
1714375212862,MMW 13R,A02,514039,Staff,0,2,16,16
1714375212862,MMW 13R,A03,628519,Staff,0,2,16,16
1714375214913,SIO 295LS,A00,523233,Staff,12,0,30,18
1714375215937,SIO 295S,A00,523232,Staff,12,0,30,18
1714375216967,SIOC 290S,A01,637330,Merrifield; Mark A,27,0,30,3
1714375217993,SIOC 291S,A01,637333,Gabriel; Corey John,27,0,30,3
1714375219020,SOCI 117,A01,494376,Staff,0,4,5,5
1714375220044,WES 237B,A00,494380,Staff,9,0,20,11
1714375222107,AESE 279B,A00,494370,Wade; Jon P,0,0,33,33
1714375223131,AIP 197,001,627712,Vespa; Emanuel Ignacio,9998,0,9999,1
1714375224158,ANAR 135S,A00,494369,Braswell; Geoffrey E.,0,0,0,0
1714375225182,BENG 196,001,628496,Engler; Adam J.,9998,0,9999,1
1714375226206,CAT 124RS,A01,519847,Geibel; William,0,0,20,20
1714375227230,CAT 125RS,A01,515971,Geibel; William,0,0,20,20
1714375228258,CLRE 250,A00,511389,Morris; Sheldon,9993,0,9999,6
1714375229283,CLRE 251,A00,507176,Mehta; Ravindra L.,9993,0,9999,6
1714375229283,CLRE 251,B00,511410,Mehta; Ravindra L.,9998,0,9999,1
1714375230308,CLRE 252,A00,507189,Cuomo; Raphael Eduardo,9995,0,9999,4
1714375231333,CLRE 253,A00,507199,Vaida; Florin,9994,0,9999,5
1714375231333,CLRE 253,B00,507202,Vaida; Florin,9999,0,9999,0
1714375232358,CLRE 259,A00,507211,Patel; Hemal,9996,0,9999,3
1714375233382,CLRE 260,A00,507221,Cuomo; Raphael Eduardo,9999,0,9999,0
1714375234407,CLRE 297,001,507242,Cuomo; Raphael Eduardo,9999,0,9999,0
1714375235434,COGS 197,001,638244,Voytek; Bradley Thomas,9999,0,9999,0
1714375236458,CSE 191,A00,516875,Minnes Kemp; Mor Mia,9993,0,9999,6
1714375237482,CSE 197,001,637388,Minnes Kemp; Mor Mia,9998,0,9999,1
1714375238507,CSS 201S,A01,494383,Staff,35,0,35,0
1714375239536,CSS 202S,A01,494387,Staff,35,0,35,0
1714375240559,DSC 197,001,628532,Eldridge; Justin Matthew,9996,0,9999,3
1714375241585,EAP 100,A00,516065,Staff,9797,0,9999,202
1714375242609,ECE 45,A01,507414,Staff,33,0,60,27
1714375244660,ECE 111,A01,507420,Staff,19,0,50,31
1714375245688,ECE 197,001,548057,Sievenpiper; Daniel F.,9994,0,9999,5
1714375246713,EDS 115,A00,507243,Choi; Bailey Miyeon,12,0,28,16
1714375247737,EDS 117,A01,494379,Staff,0,2,30,30
1714375248763,EDS 125,A00,507246,Hopkins; Megan Beth,12,0,30,18
1714375249791,EDS 128A,A01,507264,Fargason; Sharon Gayle,14,0,26,12
1714375250818,EDS 128B,A01,507293,Pappas; Elizabeth,18,0,30,12
1714375251848,EDS 139,A00,507294,Fargason; Sharon Gayle,18,0,30,12
1714375251848,EDS 139,B00,507313,Pappas; Elizabeth,15,0,30,15
1714375252876,EDS 201,A00,507315,Staff,13,0,30,17
1714375253908,EDS 203,A01,507317,Halter; Christopher P.,12,0,30,18
1714375254933,EDS 204R,A01,507319,Halter; Christopher P.,0,3,30,30
1714375254933,EDS 204R,B01,507331,Heinzman; Erica M.,17,0,30,13
1714375255955,EDS 206R,A00,507332,Staff,0,4,30,30
1714375255955,EDS 206R,B00,507343,Staff,18,0,30,12
1714375256990,EDS 250,A00,507344,Hemans; Patricia Ann Benitez,22,0,40,18
1714375258017,EDS 281,A00,507345,Daly; Alan J.,18,0,18,0
1714375259045,EDS 284,A00,507350,Daly; Alan J.,16,0,16,0
1714375260074,EDS 286,A00,507359,Fine; Sarah,18,0,18,0
1714375261102,EDS 289C,A01,507361,Daly; Alan J.,18,0,18,0
1714375262128,EDS 290,A00,507366,Hofstetter; Carolyn,15,0,15,0
1714375263154,LIGM 5A,A00,507421,Fischer-Grunski; Eva K,18,0,20,2
1714375264184,LIGM 5B,A00,507423,Fischer-Grunski; Eva K,19,0,20,1
1714375265208,LIGM 5C,A00,507425,Fischer-Grunski; Eva K,19,0,20,1
1714375266233,LIIT 5AS,A00,507427,Carnelos; Chiara,20,0,20,0
1714375267258,LIIT 5BS,A00,507430,Carnelos; Chiara,20,0,20,0
1714375268287,LIIT 5CS,A00,507432,Carnelos; Chiara,20,0,20,0
1714375269316,LISP 5A,A00,507541,Munoz Sanchez; Alicia,11,0,20,9
1714375270342,LISP 5B,A00,507671,Munoz Sanchez; Alicia,9,0,20,11
1714375271371,LISP 5C,A00,507696,Munoz Sanchez; Alicia,9,0,20,11
1714375272397,MAE 197,001,528363,Boechler; Nicholas Sebastia,9998,0,9999,1
1714375273427,MATH 197,001,523477,Kedlaya; Kiran S.,9996,0,9999,3
1714375273427,MATH 197,002,563811,Zhang; Danna,9995,0,9999,4
1714375273427,MATH 197,003,628552,Dumitriu; Ioana,9998,0,9999,1
1714375274452,MCWP 40R,A00,518780,Staff,5,0,20,15
1714375274452,MCWP 40R,B00,518781,Staff,7,0,20,13
1714375274452,MCWP 40R,C00,518783,Staff,5,0,20,15
1714375275478,MCWP 50R,A00,518791,Staff,0,0,20,20
1714375275478,MCWP 50R,B00,518792,Staff,0,1,20,20
1714375275478,MCWP 50R,C00,518793,Staff,0,1,20,20
1714375275478,MCWP 50R,D00,518794,Staff,0,0,20,20
1714375275478,MCWP 50R,E00,518795,Staff,0,1,20,20
1714375275478,MCWP 50R,F00,518796,Staff,0,0,20,20
1714375275478,MCWP 50R,G00,518797,Staff,0,1,20,20
1714375276505,MMW 12R,A01,514034,Herbst; Matthew,0,1,16,16
1714375276505,MMW 12R,A02,514035,Herbst; Matthew,2,0,16,14
1714375277533,MMW 13R,A01,514037,Staff,0,4,16,16
1714375277533,MMW 13R,A02,514039,Staff,0,2,16,16
1714375277533,MMW 13R,A03,628519,Staff,0,2,16,16
1714375279588,SIO 295LS,A00,523233,Staff,12,0,30,18
1714375280614,SIO 295S,A00,523232,Staff,12,0,30,18
1714375281641,SIOC 290S,A01,637330,Merrifield; Mark A,27,0,30,3
1714375282667,SIOC 291S,A01,637333,Gabriel; Corey John,27,0,30,3
1714375283695,SOCI 117,A01,494376,Staff,0,4,5,5
1714375284720,WES 237B,A00,494380,Staff,9,0,20,11
1714375286781,AESE 279B,A00,494370,Wade; Jon P,0,0,33,33
1714375287862,AIP 197,001,627712,Vespa; Emanuel Ignacio,9998,0,9999,1
1714375288890,ANAR 135S,A00,494369,Braswell; Geoffrey E.,0,0,0,0
1714375289915,BENG 196,001,628496,Engler; Adam J.,9998,0,9999,1
1714375290940,CAT 124RS,A01,519847,Geibel; William,0,0,20,20
1714375291967,CAT 125RS,A01,515971,Geibel; William,0,0,20,20
1714375292991,CLRE 250,A00,511389,Morris; Sheldon,9993,0,9999,6
1714375294017,CLRE 251,A00,507176,Mehta; Ravindra L.,9993,0,9999,6
1714375294017,CLRE 251,B00,511410,Mehta; Ravindra L.,9998,0,9999,1
1714375295047,CLRE 252,A00,507189,Cuomo; Raphael Eduardo,9995,0,9999,4
1714375296075,CLRE 253,A00,507199,Vaida; Florin,9994,0,9999,5
1714375296075,CLRE 253,B00,507202,Vaida; Florin,9999,0,9999,0
1714375297102,CLRE 259,A00,507211,Patel; Hemal,9996,0,9999,3
1714375298130,CLRE 260,A00,507221,Cuomo; Raphael Eduardo,9999,0,9999,0
1714375299154,CLRE 297,001,507242,Cuomo; Raphael Eduardo,9999,0,9999,0
1714375300181,COGS 197,001,638244,Voytek; Bradley Thomas,9999,0,9999,0
1714375301206,CSE 191,A00,516875,Minnes Kemp; Mor Mia,9993,0,9999,6
1714375302230,CSE 197,001,637388,Minnes Kemp; Mor Mia,9998,0,9999,1
1714375303258,CSS 201S,A01,494383,Staff,35,0,35,0
1714375304283,CSS 202S,A01,494387,Staff,35,0,35,0
1714375305308,DSC 197,001,628532,Eldridge; Justin Matthew,9996,0,9999,3
1714375306335,EAP 100,A00,516065,Staff,9797,0,9999,202
1714375307361,ECE 45,A01,507414,Staff,33,0,60,27
1714375309412,ECE 111,A01,507420,Staff,19,0,50,31
1714375310438,ECE 197,001,548057,Sievenpiper; Daniel F.,9994,0,9999,5
1714375311465,EDS 115,A00,507243,Choi; Bailey Miyeon,12,0,28,16
1714375312492,EDS 117,A01,494379,Staff,0,2,30,30
1714375313517,EDS 125,A00,507246,Hopkins; Megan Beth,12,0,30,18
1714375314546,EDS 128A,A01,507264,Fargason; Sharon Gayle,14,0,26,12
1714375315572,EDS 128B,A01,507293,Pappas; Elizabeth,18,0,30,12
1714375316596,EDS 139,A00,507294,Fargason; Sharon Gayle,18,0,30,12
1714375316596,EDS 139,B00,507313,Pappas; Elizabeth,15,0,30,15
1714375317624,EDS 201,A00,507315,Staff,13,0,30,17
1714375318648,EDS 203,A01,507317,Halter; Christopher P.,12,0,30,18
1714375319676,EDS 204R,A01,507319,Halter; Christopher P.,0,3,30,30
1714375319676,EDS 204R,B01,507331,Heinzman; Erica M.,17,0,30,13
1714375320705,EDS 206R,A00,507332,Staff,0,4,30,30
1714375320705,EDS 206R,B00,507343,Staff,18,0,30,12
1714375321729,EDS 250,A00,507344,Hemans; Patricia Ann Benitez,22,0,40,18
1714375322754,EDS 281,A00,507345,Daly; Alan J.,18,0,18,0
1714375323780,EDS 284,A00,507350,Daly; Alan J.,16,0,16,0
1714375324805,EDS 286,A00,507359,Fine; Sarah,18,0,18,0
1714375325830,EDS 289C,A01,507361,Daly; Alan J.,18,0,18,0
1714375326854,EDS 290,A00,507366,Hofstetter; Carolyn,15,0,15,0
1714375327884,LIGM 5A,A00,507421,Fischer-Grunski; Eva K,18,0,20,2
1714375328918,LIGM 5B,A00,507423,Fischer-Grunski; Eva K,19,0,20,1
1714375329942,LIGM 5C,A00,507425,Fischer-Grunski; Eva K,19,0,20,1
1714375330972,LIIT 5AS,A00,507427,Carnelos; Chiara,20,0,20,0
1714375332002,LIIT 5BS,A00,507430,Carnelos; Chiara,20,0,20,0
1714375333027,LIIT 5CS,A00,507432,Carnelos; Chiara,20,0,20,0
1714375334051,LISP 5A,A00,507541,Munoz Sanchez; Alicia,11,0,20,9
1714375335077,LISP 5B,A00,507671,Munoz Sanchez; Alicia,9,0,20,11
1714375336102,LISP 5C,A00,507696,Munoz Sanchez; Alicia,9,0,20,11
1714375337130,MAE 197,001,528363,Boechler; Nicholas Sebastia,9998,0,9999,1
1714375338159,MATH 197,001,523477,Kedlaya; Kiran S.,9996,0,9999,3
1714375338159,MATH 197,002,563811,Zhang; Danna,9995,0,9999,4
1714375338159,MATH 197,003,628552,Dumitriu; Ioana,9998,0,9999,1
1714375339185,MCWP 40R,A00,518780,Staff,5,0,20,15
1714375339185,MCWP 40R,B00,518781,Staff,7,0,20,13
1714375339185,MCWP 40R,C00,518783,Staff,5,0,20,15
1714375340211,MCWP 50R,A00,518791,Staff,0,0,20,20
1714375340211,MCWP 50R,B00,518792,Staff,0,1,20,20
1714375340211,MCWP 50R,C00,518793,Staff,0,1,20,20
1714375340211,MCWP 50R,D00,518794,Staff,0,0,20,20
1714375340211,MCWP 50R,E00,518795,Staff,0,1,20,20
1714375340211,MCWP 50R,F00,518796,Staff,0,0,20,20
1714375340211,MCWP 50R,G00,518797,Staff,0,1,20,20
1714375341238,MMW 12R,A01,514034,Herbst; Matthew,0,1,16,16
1714375341238,MMW 12R,A02,514035,Herbst; Matthew,2,0,16,14
1714375342267,MMW 13R,A01,514037,Staff,0,4,16,16
1714375342267,MMW 13R,A02,514039,Staff,0,2,16,16
1714375342267,MMW 13R,A03,628519,Staff,0,2,16,16
1714375344319,SIO 295LS,A00,523233,Staff,12,0,30,18
1714375345346,SIO 295S,A00,523232,Staff,12,0,30,18
1714375346373,SIOC 290S,A01,637330,Merrifield; Mark A,27,0,30,3
1714375347400,SIOC 291S,A01,637333,Gabriel; Corey John,27,0,30,3
1714375348425,SOCI 117,A01,494376,Staff,0,4,5,5
1714375349450,WES 237B,A00,494380,Staff,9,0,20,11
1714375351509,AESE 279B,A00,494370,Wade; Jon P,0,0,33,33
1714375352537,AIP 197,001,627712,Vespa; Emanuel Ignacio,9998,0,9999,1
1714375353563,ANAR 135S,A00,494369,Braswell; Geoffrey E.,0,0,0,0
1714375354592,BENG 196,001,628496,Engler; Adam J.,9998,0,9999,1
1714375355618,CAT 124RS,A01,519847,Geibel; William,0,0,20,20
1714375356643,CAT 125RS,A01,515971,Geibel; William,0,0,20,20
1714375357670,CLRE 250,A00,511389,Morris; Sheldon,9993,0,9999,6
1714375358699,CLRE 251,A00,507176,Mehta; Ravindra L.,9993,0,9999,6
1714375358699,CLRE 251,B00,511410,Mehta; Ravindra L.,9998,0,9999,1
1714375359728,CLRE 252,A00,507189,Cuomo; Raphael Eduardo,9995,0,9999,4
1714375360754,CLRE 253,A00,507199,Vaida; Florin,9994,0,9999,5
1714375360754,CLRE 253,B00,507202,Vaida; Florin,9999,0,9999,0
1714375361781,CLRE 259,A00,507211,Patel; Hemal,9996,0,9999,3
1714375362806,CLRE 260,A00,507221,Cuomo; Raphael Eduardo,9999,0,9999,0
1714375363838,CLRE 297,001,507242,Cuomo; Raphael Eduardo,9999,0,9999,0
1714375364866,COGS 197,001,638244,Voytek; Bradley Thomas,9999,0,9999,0
1714375365892,CSE 191,A00,516875,Minnes Kemp; Mor Mia,9993,0,9999,6
1714375366916,CSE 197,001,637388,Minnes Kemp; Mor Mia,9998,0,9999,1
1714375367941,CSS 201S,A01,494383,Staff,35,0,35,0
1714375368966,CSS 202S,A01,494387,Staff,35,0,35,0
1714375369993,DSC 197,001,628532,Eldridge; Justin Matthew,9996,0,9999,3
1714375371020,EAP 100,A00,516065,Staff,9797,0,9999,202
1714375372049,ECE 45,A01,507414,Staff,33,0,60,27
1714375374102,ECE 111,A01,507420,Staff,19,0,50,31
1714375375129,ECE 197,001,548057,Sievenpiper; Daniel F.,9994,0,9999,5
1714375376155,EDS 115,A00,507243,Choi; Bailey Miyeon,12,0,28,16
1714375377183,EDS 117,A01,494379,Staff,0,2,30,30
1714375378209,EDS 125,A00,507246,Hopkins; Megan Beth,12,0,30,18
1714375379234,EDS 128A,A01,507264,Fargason; Sharon Gayle,14,0,26,12
1714375380266,EDS 128B,A01,507293,Pappas; Elizabeth,18,0,30,12
1714375381294,EDS 139,A00,507294,Fargason; Sharon Gayle,18,0,30,12
1714375381294,EDS 139,B00,507313,Pappas; Elizabeth,15,0,30,15
1714375382323,EDS 201,A00,507315,Staff,13,0,30,17
1714375383354,EDS 203,A01,507317,Halter; Christopher P.,12,0,30,18
1714375384380,EDS 204R,A01,507319,Halter; Christopher P.,0,3,30,30
1714375384380,EDS 204R,B01,507331,Heinzman; Erica M.,17,0,30,13
1714375385408,EDS 206R,A00,507332,Staff,0,4,30,30
1714375385408,EDS 206R,B00,507343,Staff,18,0,30,12
1714375386434,EDS 250,A00,507344,Hemans; Patricia Ann Benitez,22,0,40,18
1714375387459,EDS 281,A00,507345,Daly; Alan J.,18,0,18,0
1714375388487,EDS 284,A00,507350,Daly; Alan J.,16,0,16,0
1714375389511,EDS 286,A00,507359,Fine; Sarah,18,0,18,0
1714375390537,EDS 289C,A01,507361,Daly; Alan J.,18,0,18,0
1714375391619,EDS 290,A00,507366,Hofstetter; Carolyn,15,0,15,0
1714375392644,LIGM 5A,A00,507421,Fischer-Grunski; Eva K,18,0,20,2
1714375393668,LIGM 5B,A00,507423,Fischer-Grunski; Eva K,19,0,20,1
1714375394694,LIGM 5C,A00,507425,Fischer-Grunski; Eva K,19,0,20,1
1714375395719,LIIT 5AS,A00,507427,Carnelos; Chiara,20,0,20,0
1714375396744,LIIT 5BS,A00,507430,Carnelos; Chiara,20,0,20,0
1714375397776,LIIT 5CS,A00,507432,Carnelos; Chiara,20,0,20,0
1714375398803,LISP 5A,A00,507541,Munoz Sanchez; Alicia,11,0,20,9
1714375399828,LISP 5B,A00,507671,Munoz Sanchez; Alicia,9,0,20,11
1714375400860,LISP 5C,A00,507696,Munoz Sanchez; Alicia,9,0,20,11
1714375401888,MAE 197,001,528363,Boechler; Nicholas Sebastia,9998,0,9999,1
1714375402917,MATH 197,001,523477,Kedlaya; Kiran S.,9996,0,9999,3
1714375402917,MATH 197,002,563811,Zhang; Danna,9995,0,9999,4
1714375402917,MATH 197,003,628552,Dumitriu; Ioana,9998,0,9999,1
1714375403942,MCWP 40R,A00,518780,Staff,5,0,20,15
1714375403942,MCWP 40R,B00,518781,Staff,7,0,20,13
1714375403942,MCWP 40R,C00,518783,Staff,5,0,20,15
1714375404966,MCWP 50R,A00,518791,Staff,0,0,20,20
1714375404966,MCWP 50R,B00,518792,Staff,0,1,20,20
1714375404966,MCWP 50R,C00,518793,Staff,0,1,20,20
1714375404966,MCWP 50R,D00,518794,Staff,0,0,20,20
1714375404966,MCWP 50R,E00,518795,Staff,0,1,20,20
1714375404966,MCWP 50R,F00,518796,Staff,0,0,20,20
1714375404966,MCWP 50R,G00,518797,Staff,0,1,20,20
1714375405995,MMW 12R,A01,514034,Herbst; Matthew,0,1,16,16
1714375405995,MMW 12R,A02,514035,Herbst; Matthew,2,0,16,14
1714375407021,MMW 13R,A01,514037,Staff,0,4,16,16
1714375407021,MMW 13R,A02,514039,Staff,0,2,16,16
1714375407021,MMW 13R,A03,628519,Staff,0,2,16,16
1714375409072,SIO 295LS,A00,523233,Staff,12,0,30,18
1714375410097,SIO 295S,A00,523232,Staff,12,0,30,18
1714375411122,SIOC 290S,A01,637330,Merrifield; Mark A,27,0,30,3
1714375412153,SIOC 291S,A01,637333,Gabriel; Corey John,27,0,30,3
1714375413178,SOCI 117,A01,494376,Staff,0,4,5,5
1714375414202,WES 237B,A00,494380,Staff,9,0,20,11
1714375416274,AESE 279B,A00,494370,Wade; Jon P,0,0,33,33
1714375417301,AIP 197,001,627712,Vespa; Emanuel Ignacio,9998,0,9999,1
1714375418326,ANAR 135S,A00,494369,Braswell; Geoffrey E.,0,0,0,0
1714375419351,BENG 196,001,628496,Engler; Adam J.,9998,0,9999,1
1714375420376,CAT 124RS,A01,519847,Geibel; William,0,0,20,20
1714375421401,CAT 125RS,A01,515971,Geibel; William,0,0,20,20
1714375422428,CLRE 250,A00,511389,Morris; Sheldon,9993,0,9999,6
1714375423454,CLRE 251,A00,507176,Mehta; Ravindra L.,9993,0,9999,6
1714375423454,CLRE 251,B00,511410,Mehta; Ravindra L.,9998,0,9999,1
1714375424478,CLRE 252,A00,507189,Cuomo; Raphael Eduardo,9995,0,9999,4
1714375425507,CLRE 253,A00,507199,Vaida; Florin,9994,0,9999,5
1714375425507,CLRE 253,B00,507202,Vaida; Florin,9999,0,9999,0
1714375426534,CLRE 259,A00,507211,Patel; Hemal,9996,0,9999,3
1714375427559,CLRE 260,A00,507221,Cuomo; Raphael Eduardo,9999,0,9999,0
1714375428586,CLRE 297,001,507242,Cuomo; Raphael Eduardo,9999,0,9999,0
1714375429610,COGS 197,001,638244,Voytek; Bradley Thomas,9999,0,9999,0
1714375430635,CSE 191,A00,516875,Minnes Kemp; Mor Mia,9993,0,9999,6
1714375431660,CSE 197,001,637388,Minnes Kemp; Mor Mia,9998,0,9999,1
1714375432688,CSS 201S,A01,494383,Staff,35,0,35,0
1714375433714,CSS 202S,A01,494387,Staff,35,0,35,0
1714375434740,DSC 197,001,628532,Eldridge; Justin Matthew,9996,0,9999,3
1714375435768,EAP 100,A00,516065,Staff,9797,0,9999,202
1714375436791,ECE 45,A01,507414,Staff,33,0,60,27
1714375438844,ECE 111,A01,507420,Staff,19,0,50,31
1714375439871,ECE 197,001,548057,Sievenpiper; Daniel F.,9994,0,9999,5
1714375440898,EDS 115,A00,507243,Choi; Bailey Miyeon,12,0,28,16
1714375441925,EDS 117,A01,494379,Staff,0,2,30,30
1714375442953,EDS 125,A00,507246,Hopkins; Megan Beth,12,0,30,18
1714375443984,EDS 128A,A01,507264,Fargason; Sharon Gayle,14,0,26,12
1714375445010,EDS 128B,A01,507293,Pappas; Elizabeth,18,0,30,12
1714375446038,EDS 139,A00,507294,Fargason; Sharon Gayle,18,0,30,12
1714375446038,EDS 139,B00,507313,Pappas; Elizabeth,15,0,30,15
1714375447063,EDS 201,A00,507315,Staff,13,0,30,17
1714375448086,EDS 203,A01,507317,Halter; Christopher P.,12,0,30,18
1714375449111,EDS 204R,A01,507319,Halter; Christopher P.,0,3,30,30
1714375449111,EDS 204R,B01,507331,Heinzman; Erica M.,17,0,30,13
1714375450140,EDS 206R,A00,507332,Staff,0,4,30,30
1714375450140,EDS 206R,B00,507343,Staff,18,0,30,12
1714375451169,EDS 250,A00,507344,Hemans; Patricia Ann Benitez,22,0,40,18
1714375452193,EDS 281,A00,507345,Daly; Alan J.,18,0,18,0
1714375453220,EDS 284,A00,507350,Daly; Alan J.,16,0,16,0
1714375454246,EDS 286,A00,507359,Fine; Sarah,18,0,18,0
1714375455271,EDS 289C,A01,507361,Daly; Alan J.,18,0,18,0
1714375456298,EDS 290,A00,507366,Hofstetter; Carolyn,15,0,15,0
1714375457328,LIGM 5A,A00,507421,Fischer-Grunski; Eva K,18,0,20,2
1714375458353,LIGM 5B,A00,507423,Fischer-Grunski; Eva K,19,0,20,1
1714375459379,LIGM 5C,A00,507425,Fischer-Grunski; Eva K,19,0,20,1
1714375460406,LIIT 5AS,A00,507427,Carnelos; Chiara,20,0,20,0
1714375461436,LIIT 5BS,A00,507430,Carnelos; Chiara,20,0,20,0
1714375462460,LIIT 5CS,A00,507432,Carnelos; Chiara,20,0,20,0
1714375463486,LISP 5A,A00,507541,Munoz Sanchez; Alicia,11,0,20,9
1714375464517,LISP 5B,A00,507671,Munoz Sanchez; Alicia,9,0,20,11
1714375465542,LISP 5C,A00,507696,Munoz Sanchez; Alicia,9,0,20,11
1714375466567,MAE 197,001,528363,Boechler; Nicholas Sebastia,9998,0,9999,1
1714375467591,MATH 197,001,523477,Kedlaya; Kiran S.,9996,0,9999,3
1714375467591,MATH 197,002,563811,Zhang; Danna,9995,0,9999,4
1714375467591,MATH 197,003,628552,Dumitriu; Ioana,9998,0,9999,1
1714375468618,MCWP 40R,A00,518780,Staff,5,0,20,15
1714375468618,MCWP 40R,B00,518781,Staff,7,0,20,13
1714375468618,MCWP 40R,C00,518783,Staff,5,0,20,15
1714375469649,MCWP 50R,A00,518791,Staff,0,0,20,20
1714375469649,MCWP 50R,B00,518792,Staff,0,1,20,20
1714375469649,MCWP 50R,C00,518793,Staff,0,1,20,20
1714375469649,MCWP 50R,D00,518794,Staff,0,0,20,20
1714375469649,MCWP 50R,E00,518795,Staff,0,1,20,20
1714375469649,MCWP 50R,F00,518796,Staff,0,0,20,20
1714375469649,MCWP 50R,G00,518797,Staff,0,1,20,20
1714375470674,MMW 12R,A01,514034,Herbst; Matthew,0,1,16,16
1714375470674,MMW 12R,A02,514035,Herbst; Matthew,2,0,16,14
1714375471697,MMW 13R,A01,514037,Staff,0,4,16,16
1714375471697,MMW 13R,A02,514039,Staff,0,2,16,16
1714375471697,MMW 13R,A03,628519,Staff,0,2,16,16
1714375473749,SIO 295LS,A00,523233,Staff,12,0,30,18
1714375474776,SIO 295S,A00,523232,Staff,12,0,30,18
1714375475800,SIOC 290S,A01,637330,Merrifield; Mark A,27,0,30,3
1714375476830,SIOC 291S,A01,637333,Gabriel; Corey John,27,0,30,3
1714375477855,SOCI 117,A01,494376,Staff,0,4,5,5
1714375478882,WES 237B,A00,494380,Staff,9,0,20,11
1714375480973,AESE 279B,A00,494370,Wade; Jon P,0,0,33,33
1714375482002,AIP 197,001,627712,Vespa; Emanuel Ignacio,9998,0,9999,1
1714375483026,ANAR 135S,A00,494369,Braswell; Geoffrey E.,0,0,0,0
1714375484054,BENG 196,001,628496,Engler; Adam J.,9998,0,9999,1
1714375485083,CAT 124RS,A01,519847,Geibel; William,0,0,20,20
1714375486112,CAT 125RS,A01,515971,Geibel; William,0,0,20,20
1714375487173,CLRE 250,A00,511389,Morris; Sheldon,9993,0,9999,6
1714375488198,CLRE 251,A00,507176,Mehta; Ravindra L.,9993,0,9999,6
1714375488198,CLRE 251,B00,511410,Mehta; Ravindra L.,9998,0,9999,1
1714375489223,CLRE 252,A00,507189,Cuomo; Raphael Eduardo,9995,0,9999,4
1714375490253,CLRE 253,A00,507199,Vaida; Florin,9994,0,9999,5
1714375490253,CLRE 253,B00,507202,Vaida; Florin,9999,0,9999,0
1714375491279,CLRE 259,A00,507211,Patel; Hemal,9996,0,9999,3
1714375492309,CLRE 260,A00,507221,Cuomo; Raphael Eduardo,9999,0,9999,0
1714375493334,CLRE 297,001,507242,Cuomo; Raphael Eduardo,9999,0,9999,0
1714375494362,COGS 197,001,638244,Voytek; Bradley Thomas,9999,0,9999,0
1714375495448,CSE 191,A00,516875,Minnes Kemp; Mor Mia,9993,0,9999,6
1714375496477,CSE 197,001,637388,Minnes Kemp; Mor Mia,9998,0,9999,1
1714375497505,CSS 201S,A01,494383,Staff,35,0,35,0
1714375498534,CSS 202S,A01,494387,Staff,35,0,35,0
1714375499562,DSC 197,001,628532,Eldridge; Justin Matthew,9996,0,9999,3
1714375500588,EAP 100,A00,516065,Staff,9797,0,9999,202
1714375501613,ECE 45,A01,507414,Staff,33,0,60,27
1714375503662,ECE 111,A01,507420,Staff,19,0,50,31
1714375504686,ECE 197,001,548057,Sievenpiper; Daniel F.,9994,0,9999,5
1714375505710,EDS 115,A00,507243,Choi; Bailey Miyeon,12,0,28,16
1714375506739,EDS 117,A01,494379,Staff,0,2,30,30
1714375507764,EDS 125,A00,507246,Hopkins; Megan Beth,12,0,30,18
1714375508792,EDS 128A,A01,507264,Fargason; Sharon Gayle,14,0,26,12
1714375509822,EDS 128B,A01,507293,Pappas; Elizabeth,18,0,30,12
1714375510849,EDS 139,A00,507294,Fargason; Sharon Gayle,18,0,30,12
1714375510849,EDS 139,B00,507313,Pappas; Elizabeth,15,0,30,15
1714375511874,EDS 201,A00,507315,Staff,13,0,30,17
1714375512899,EDS 203,A01,507317,Halter; Christopher P.,12,0,30,18
1714375513926,EDS 204R,A01,507319,Halter; Christopher P.,0,3,30,30
1714375513926,EDS 204R,B01,507331,Heinzman; Erica M.,17,0,30,13
1714375514957,EDS 206R,A00,507332,Staff,0,4,30,30
1714375514957,EDS 206R,B00,507343,Staff,18,0,30,12
1714375515983,EDS 250,A00,507344,Hemans; Patricia Ann Benitez,22,0,40,18
1714375517009,EDS 281,A00,507345,Daly; Alan J.,18,0,18,0
1714375518033,EDS 284,A00,507350,Daly; Alan J.,16,0,16,0
1714375519062,EDS 286,A00,507359,Fine; Sarah,18,0,18,0
1714375520090,EDS 289C,A01,507361,Daly; Alan J.,18,0,18,0
1714375521119,EDS 290,A00,507366,Hofstetter; Carolyn,15,0,15,0
1714375522144,LIGM 5A,A00,507421,Fischer-Grunski; Eva K,18,0,20,2
1714375523169,LIGM 5B,A00,507423,Fischer-Grunski; Eva K,19,0,20,1
1714375524195,LIGM 5C,A00,507425,Fischer-Grunski; Eva K,19,0,20,1
1714375525220,LIIT 5AS,A00,507427,Carnelos; Chiara,20,0,20,0
1714375526245,LIIT 5BS,A00,507430,Carnelos; Chiara,20,0,20,0
1714375527276,LIIT 5CS,A00,507432,Carnelos; Chiara,20,0,20,0
1714375528306,LISP 5A,A00,507541,Munoz Sanchez; Alicia,11,0,20,9
1714375529334,LISP 5B,A00,507671,Munoz Sanchez; Alicia,9,0,20,11
1714375530359,LISP 5C,A00,507696,Munoz Sanchez; Alicia,9,0,20,11
1714375531383,MAE 197,001,528363,Boechler; Nicholas Sebastia,9998,0,9999,1
1714375532411,MATH 197,001,523477,Kedlaya; Kiran S.,9996,0,9999,3
1714375532411,MATH 197,002,563811,Zhang; Danna,9995,0,9999,4
1714375532411,MATH 197,003,628552,Dumitriu; Ioana,9998,0,9999,1
1714375533439,MCWP 40R,A00,518780,Staff,5,0,20,15
1714375533439,MCWP 40R,B00,518781,Staff,7,0,20,13
1714375533439,MCWP 40R,C00,518783,Staff,5,0,20,15
1714375534467,MCWP 50R,A00,518791,Staff,0,0,20,20
1714375534467,MCWP 50R,B00,518792,Staff,0,1,20,20
1714375534467,MCWP 50R,C00,518793,Staff,0,1,20,20
1714375534467,MCWP 50R,D00,518794,Staff,0,0,20,20
1714375534467,MCWP 50R,E00,518795,Staff,0,1,20,20
1714375534467,MCWP 50R,F00,518796,Staff,0,0,20,20
1714375534467,MCWP 50R,G00,518797,Staff,0,1,20,20
1714375535495,MMW 12R,A01,514034,Herbst; Matthew,0,1,16,16
1714375535495,MMW 12R,A02,514035,Herbst; Matthew,2,0,16,14
1714375536523,MMW 13R,A01,514037,Staff,0,4,16,16
1714375536523,MMW 13R,A02,514039,Staff,0,2,16,16
1714375536523,MMW 13R,A03,628519,Staff,0,2,16,16
1714375538576,SIO 295LS,A00,523233,Staff,12,0,30,18
1714375539601,SIO 295S,A00,523232,Staff,12,0,30,18
1714375540627,SIOC 290S,A01,637330,Merrifield; Mark A,27,0,30,3
1714375541655,SIOC 291S,A01,637333,Gabriel; Corey John,27,0,30,3
1714375542679,SOCI 117,A01,494376,Staff,0,4,5,5
1714375543706,WES 237B,A00,494380,Staff,9,0,20,11
1714375545764,AESE 279B,A00,494370,Wade; Jon P,0,0,33,33
1714375546792,AIP 197,001,627712,Vespa; Emanuel Ignacio,9998,0,9999,1
1714375547816,ANAR 135S,A00,494369,Braswell; Geoffrey E.,0,0,0,0
1714375548841,BENG 196,001,628496,Engler; Adam J.,9998,0,9999,1
1714375549870,CAT 124RS,A01,519847,Geibel; William,0,0,20,20
1714375550894,CAT 125RS,A01,515971,Geibel; William,0,0,20,20
1714375551917,CLRE 250,A00,511389,Morris; Sheldon,9993,0,9999,6
1714375552941,CLRE 251,A00,507176,Mehta; Ravindra L.,9993,0,9999,6
1714375552941,CLRE 251,B00,511410,Mehta; Ravindra L.,9998,0,9999,1
1714375553971,CLRE 252,A00,507189,Cuomo; Raphael Eduardo,9995,0,9999,4
1714375554995,CLRE 253,A00,507199,Vaida; Florin,9994,0,9999,5
1714375554995,CLRE 253,B00,507202,Vaida; Florin,9999,0,9999,0
1714375556022,CLRE 259,A00,507211,Patel; Hemal,9996,0,9999,3
1714375557047,CLRE 260,A00,507221,Cuomo; Raphael Eduardo,9999,0,9999,0
1714375558073,CLRE 297,001,507242,Cuomo; Raphael Eduardo,9999,0,9999,0
1714375559098,COGS 197,001,638244,Voytek; Bradley Thomas,9999,0,9999,0
1714375560129,CSE 191,A00,516875,Minnes Kemp; Mor Mia,9993,0,9999,6
1714375561157,CSE 197,001,637388,Minnes Kemp; Mor Mia,9998,0,9999,1
1714375562198,CSS 201S,A01,494383,Staff,35,0,35,0
1714375563223,CSS 202S,A01,494387,Staff,35,0,35,0
1714375564248,DSC 197,001,628532,Eldridge; Justin Matthew,9996,0,9999,3
1714375565275,EAP 100,A00,516065,Staff,9797,0,9999,202
1714375566303,ECE 45,A01,507414,Staff,33,0,60,27
1714375568353,ECE 111,A01,507420,Staff,19,0,50,31
1714375569379,ECE 197,001,548057,Sievenpiper; Daniel F.,9994,0,9999,5
1714375570406,EDS 115,A00,507243,Choi; Bailey Miyeon,12,0,28,16
1714375571432,EDS 117,A01,494379,Staff,0,2,30,30
1714375572461,EDS 125,A00,507246,Hopkins; Megan Beth,12,0,30,18
1714375573486,EDS 128A,A01,507264,Fargason; Sharon Gayle,14,0,26,12
1714375574510,EDS 128B,A01,507293,Pappas; Elizabeth,18,0,30,12
1714375575536,EDS 139,A00,507294,Fargason; Sharon Gayle,18,0,30,12
1714375575536,EDS 139,B00,507313,Pappas; Elizabeth,15,0,30,15
1714375576568,EDS 201,A00,507315,Staff,13,0,30,17
1714375577593,EDS 203,A01,507317,Halter; Christopher P.,12,0,30,18
1714375578619,EDS 204R,A01,507319,Halter; Christopher P.,0,3,30,30
1714375578619,EDS 204R,B01,507331,Heinzman; Erica M.,17,0,30,13
1714375579652,EDS 206R,A00,507332,Staff,0,4,30,30
1714375579652,EDS 206R,B00,507343,Staff,18,0,30,12
1714375580679,EDS 250,A00,507344,Hemans; Patricia Ann Benitez,22,0,40,18
1714375581710,EDS 281,A00,507345,Daly; Alan J.,18,0,18,0
1714375582750,EDS 284,A00,507350,Daly; Alan J.,16,0,16,0
1714375583781,EDS 286,A00,507359,Fine; Sarah,18,0,18,0
1714375584809,EDS 289C,A01,507361,Daly; Alan J.,18,0,18,0
1714375585836,EDS 290,A00,507366,Hofstetter; Carolyn,15,0,15,0
1714375586865,LIGM 5A,A00,507421,Fischer-Grunski; Eva K,18,0,20,2
1714375587889,LIGM 5B,A00,507423,Fischer-Grunski; Eva K,19,0,20,1
1714375588913,LIGM 5C,A00,507425,Fischer-Grunski; Eva K,19,0,20,1
1714375589940,LIIT 5AS,A00,507427,Carnelos; Chiara,20,0,20,0
1714375590963,LIIT 5BS,A00,507430,Carnelos; Chiara,20,0,20,0
1714375591991,LIIT 5CS,A00,507432,Carnelos; Chiara,20,0,20,0
1714375593020,LISP 5A,A00,507541,Munoz Sanchez; Alicia,11,0,20,9
1714375594044,LISP 5B,A00,507671,Munoz Sanchez; Alicia,9,0,20,11
1714375595070,LISP 5C,A00,507696,Munoz Sanchez; Alicia,9,0,20,11
1714375596094,MAE 197,001,528363,Boechler; Nicholas Sebastia,9998,0,9999,1
1714375597118,MATH 197,001,523477,Kedlaya; Kiran S.,9996,0,9999,3
1714375597118,MATH 197,002,563811,Zhang; Danna,9995,0,9999,4
1714375597118,MATH 197,003,628552,Dumitriu; Ioana,9998,0,9999,1
1714375598150,MCWP 40R,A00,518780,Staff,5,0,20,15
1714375598150,MCWP 40R,B00,518781,Staff,7,0,20,13
1714375598150,MCWP 40R,C00,518783,Staff,5,0,20,15
1714375599234,MCWP 50R,A00,518791,Staff,0,0,20,20
1714375599234,MCWP 50R,B00,518792,Staff,0,1,20,20
1714375599234,MCWP 50R,C00,518793,Staff,0,1,20,20
1714375599234,MCWP 50R,D00,518794,Staff,0,0,20,20
1714375599234,MCWP 50R,E00,518795,Staff,0,1,20,20
1714375599234,MCWP 50R,F00,518796,Staff,0,0,20,20
1714375599234,MCWP 50R,G00,518797,Staff,0,1,20,20
1714375600262,MMW 12R,A01,514034,Herbst; Matthew,0,1,16,16
1714375600262,MMW 12R,A02,514035,Herbst; Matthew,2,0,16,14
1714375601294,MMW 13R,A01,514037,Staff,0,4,16,16
1714375601294,MMW 13R,A02,514039,Staff,0,2,16,16
1714375601294,MMW 13R,A03,628519,Staff,0,2,16,16
1714375603349,SIO 295LS,A00,523233,Staff,12,0,30,18
1714375604376,SIO 295S,A00,523232,Staff,12,0,30,18
1714375605405,SIOC 290S,A01,637330,Merrifield; Mark A,27,0,30,3
1714375606433,SIOC 291S,A01,637333,Gabriel; Corey John,27,0,30,3
1714375607461,SOCI 117,A01,494376,Staff,0,4,5,5
1714375608488,WES 237B,A00,494380,Staff,9,0,20,11
1714375610560,AESE 279B,A00,494370,Wade; Jon P,0,0,33,33
1714375611588,AIP 197,001,627712,Vespa; Emanuel Ignacio,9998,0,9999,1
1714375612615,ANAR 135S,A00,494369,Braswell; Geoffrey E.,0,0,0,0
1714375613641,BENG 196,001,628496,Engler; Adam J.,9998,0,9999,1
1714375614666,CAT 124RS,A01,519847,Geibel; William,0,0,20,20
1714375615690,CAT 125RS,A01,515971,Geibel; William,0,0,20,20
1714375616715,CLRE 250,A00,511389,Morris; Sheldon,9993,0,9999,6
1714375617743,CLRE 251,A00,507176,Mehta; Ravindra L.,9993,0,9999,6
1714375617743,CLRE 251,B00,511410,Mehta; Ravindra L.,9998,0,9999,1
1714375618772,CLRE 252,A00,507189,Cuomo; Raphael Eduardo,9995,0,9999,4
1714375619796,CLRE 253,A00,507199,Vaida; Florin,9994,0,9999,5
1714375619796,CLRE 253,B00,507202,Vaida; Florin,9999,0,9999,0
1714375620822,CLRE 259,A00,507211,Patel; Hemal,9996,0,9999,3
1714375621847,CLRE 260,A00,507221,Cuomo; Raphael Eduardo,9999,0,9999,0
1714375622874,CLRE 297,001,507242,Cuomo; Raphael Eduardo,9999,0,9999,0
1714375623902,COGS 197,001,638244,Voytek; Bradley Thomas,9999,0,9999,0
1714375624927,CSE 191,A00,516875,Minnes Kemp; Mor Mia,9993,0,9999,6
1714375625953,CSE 197,001,637388,Minnes Kemp; Mor Mia,9998,0,9999,1
1714375626980,CSS 201S,A01,494383,Staff,35,0,35,0
1714375628004,CSS 202S,A01,494387,Staff,35,0,35,0
1714375629029,DSC 197,001,628532,Eldridge; Justin Matthew,9996,0,9999,3
1714375630057,EAP 100,A00,516065,Staff,9797,0,9999,202
1714375631084,ECE 45,A01,507414,Staff,33,0,60,27
1714375633138,ECE 111,A01,507420,Staff,19,0,50,31
1714375634165,ECE 197,001,548057,Sievenpiper; Daniel F.,9994,0,9999,5
1714375635190,EDS 115,A00,507243,Choi; Bailey Miyeon,12,0,28,16
1714375636217,EDS 117,A01,494379,Staff,0,2,30,30
1714375637243,EDS 125,A00,507246,Hopkins; Megan Beth,12,0,30,18
1714375638275,EDS 128A,A01,507264,Fargason; Sharon Gayle,14,0,26,12
1714375639300,EDS 128B,A01,507293,Pappas; Elizabeth,18,0,30,12
1714375640328,EDS 139,A00,507294,Fargason; Sharon Gayle,18,0,30,12
1714375640328,EDS 139,B00,507313,Pappas; Elizabeth,15,0,30,15
1714375641356,EDS 201,A00,507315,Staff,13,0,30,17
1714375642385,EDS 203,A01,507317,Halter; Christopher P.,12,0,30,18
1714375643415,EDS 204R,A01,507319,Halter; Christopher P.,0,3,30,30
1714375643415,EDS 204R,B01,507331,Heinzman; Erica M.,17,0,30,13
1714375644444,EDS 206R,A00,507332,Staff,0,4,30,30
1714375644444,EDS 206R,B00,507343,Staff,18,0,30,12
1714375645469,EDS 250,A00,507344,Hemans; Patricia Ann Benitez,22,0,40,18
1714375646494,EDS 281,A00,507345,Daly; Alan J.,18,0,18,0
1714375647521,EDS 284,A00,507350,Daly; Alan J.,16,0,16,0
1714375648548,EDS 286,A00,507359,Fine; Sarah,18,0,18,0
1714375649574,EDS 289C,A01,507361,Daly; Alan J.,18,0,18,0
1714375650599,EDS 290,A00,507366,Hofstetter; Carolyn,15,0,15,0
1714375651623,LIGM 5A,A00,507421,Fischer-Grunski; Eva K,18,0,20,2
1714375652649,LIGM 5B,A00,507423,Fischer-Grunski; Eva K,19,0,20,1
1714375653678,LIGM 5C,A00,507425,Fischer-Grunski; Eva K,19,0,20,1
1714375654706,LIIT 5AS,A00,507427,Carnelos; Chiara,20,0,20,0
1714375655730,LIIT 5BS,A00,507430,Carnelos; Chiara,20,0,20,0
1714375656759,LIIT 5CS,A00,507432,Carnelos; Chiara,20,0,20,0
1714375657784,LISP 5A,A00,507541,Munoz Sanchez; Alicia,11,0,20,9
1714375658810,LISP 5B,A00,507671,Munoz Sanchez; Alicia,9,0,20,11
1714375659838,LISP 5C,A00,507696,Munoz Sanchez; Alicia,9,0,20,11
1714375660862,MAE 197,001,528363,Boechler; Nicholas Sebastia,9998,0,9999,1
1714375661886,MATH 197,001,523477,Kedlaya; Kiran S.,9996,0,9999,3
1714375661886,MATH 197,002,563811,Zhang; Danna,9995,0,9999,4
1714375661886,MATH 197,003,628552,Dumitriu; Ioana,9998,0,9999,1
1714375662913,MCWP 40R,A00,518780,Staff,5,0,20,15
1714375662913,MCWP 40R,B00,518781,Staff,7,0,20,13
1714375662913,MCWP 40R,C00,518783,Staff,5,0,20,15
1714375663939,MCWP 50R,A00,518791,Staff,0,0,20,20
1714375663939,MCWP 50R,B00,518792,Staff,0,1,20,20
1714375663939,MCWP 50R,C00,518793,Staff,0,1,20,20
1714375663939,MCWP 50R,D00,518794,Staff,0,0,20,20
1714375663939,MCWP 50R,E00,518795,Staff,0,1,20,20
1714375663939,MCWP 50R,F00,518796,Staff,0,0,20,20
1714375663939,MCWP 50R,G00,518797,Staff,0,1,20,20
1714375664963,MMW 12R,A01,514034,Herbst; Matthew,0,1,16,16
1714375664963,MMW 12R,A02,514035,Herbst; Matthew,2,0,16,14
1714375665988,MMW 13R,A01,514037,Staff,0,4,16,16
1714375665988,MMW 13R,A02,514039,Staff,0,2,16,16
1714375665988,MMW 13R,A03,628519,Staff,0,2,16,16
1714375668041,SIO 295LS,A00,523233,Staff,12,0,30,18
1714375669066,SIO 295S,A00,523232,Staff,12,0,30,18
1714375670090,SIOC 290S,A01,637330,Merrifield; Mark A,27,0,30,3
1714375671117,SIOC 291S,A01,637333,Gabriel; Corey John,27,0,30,3
1714375672146,SOCI 117,A01,494376,Staff,0,4,5,5
1714375673174,WES 237B,A00,494380,Staff,9,0,20,11
1714375675236,AESE 279B,A00,494370,Wade; Jon P,0,0,33,33
1714375676266,AIP 197,001,627712,Vespa; Emanuel Ignacio,9998,0,9999,1
1714375677290,ANAR 135S,A00,494369,Braswell; Geoffrey E.,0,0,0,0
1714375678314,BENG 196,001,628496,Engler; Adam J.,9998,0,9999,1
1714375679342,CAT 124RS,A01,519847,Geibel; William,0,0,20,20
1714375680383,CAT 125RS,A01,515971,Geibel; William,0,0,20,20
1714375681408,CLRE 250,A00,511389,Morris; Sheldon,9993,0,9999,6
1714375682434,CLRE 251,A00,507176,Mehta; Ravindra L.,9993,0,9999,6
1714375682434,CLRE 251,B00,511410,Mehta; Ravindra L.,9998,0,9999,1
1714375683464,CLRE 252,A00,507189,Cuomo; Raphael Eduardo,9995,0,9999,4
1714375684490,CLRE 253,A00,507199,Vaida; Florin,9994,0,9999,5
1714375684490,CLRE 253,B00,507202,Vaida; Florin,9999,0,9999,0
1714375685516,CLRE 259,A00,507211,Patel; Hemal,9996,0,9999,3
1714375686544,CLRE 260,A00,507221,Cuomo; Raphael Eduardo,9999,0,9999,0
1714375687568,CLRE 297,001,507242,Cuomo; Raphael Eduardo,9999,0,9999,0
1714375688595,COGS 197,001,638244,Voytek; Bradley Thomas,9999,0,9999,0
1714375689622,CSE 191,A00,516875,Minnes Kemp; Mor Mia,9993,0,9999,6
1714375690649,CSE 197,001,637388,Minnes Kemp; Mor Mia,9998,0,9999,1
1714375691674,CSS 201S,A01,494383,Staff,35,0,35,0
1714375692698,CSS 202S,A01,494387,Staff,35,0,35,0
1714375693726,DSC 197,001,628532,Eldridge; Justin Matthew,9996,0,9999,3
1714375694751,EAP 100,A00,516065,Staff,9797,0,9999,202
1714375695777,ECE 45,A01,507414,Staff,33,0,60,27
1714375697828,ECE 111,A01,507420,Staff,19,0,50,31
1714375698856,ECE 197,001,548057,Sievenpiper; Daniel F.,9994,0,9999,5
1714375699882,EDS 115,A00,507243,Choi; Bailey Miyeon,12,0,28,16
1714375700906,EDS 117,A01,494379,Staff,0,2,30,30
1714375701930,EDS 125,A00,507246,Hopkins; Megan Beth,12,0,30,18
1714375703013,EDS 128A,A01,507264,Fargason; Sharon Gayle,14,0,26,12
1714375704042,EDS 128B,A01,507293,Pappas; Elizabeth,18,0,30,12
1714375705065,EDS 139,A00,507294,Fargason; Sharon Gayle,18,0,30,12
1714375705065,EDS 139,B00,507313,Pappas; Elizabeth,15,0,30,15
1714375706091,EDS 201,A00,507315,Staff,13,0,30,17
1714375707118,EDS 203,A01,507317,Halter; Christopher P.,12,0,30,18
1714375708147,EDS 204R,A01,507319,Halter; Christopher P.,0,3,30,30
1714375708147,EDS 204R,B01,507331,Heinzman; Erica M.,17,0,30,13
1714375709172,EDS 206R,A00,507332,Staff,0,4,30,30
1714375709172,EDS 206R,B00,507343,Staff,18,0,30,12
1714375710197,EDS 250,A00,507344,Hemans; Patricia Ann Benitez,22,0,40,18
1714375711222,EDS 281,A00,507345,Daly; Alan J.,18,0,18,0
1714375712249,EDS 284,A00,507350,Daly; Alan J.,16,0,16,0
1714375713277,EDS 286,A00,507359,Fine; Sarah,18,0,18,0
1714375714304,EDS 289C,A01,507361,Daly; Alan J.,18,0,18,0
1714375715330,EDS 290,A00,507366,Hofstetter; Carolyn,15,0,15,0
1714375716357,LIGM 5A,A00,507421,Fischer-Grunski; Eva K,18,0,20,2
1714375717381,LIGM 5B,A00,507423,Fischer-Grunski; Eva K,19,0,20,1
1714375718407,LIGM 5C,A00,507425,Fischer-Grunski; Eva K,19,0,20,1
1714375719438,LIIT 5AS,A00,507427,Carnelos; Chiara,20,0,20,0
1714375720468,LIIT 5BS,A00,507430,Carnelos; Chiara,20,0,20,0
1714375721497,LIIT 5CS,A00,507432,Carnelos; Chiara,20,0,20,0
1714375722525,LISP 5A,A00,507541,Munoz Sanchez; Alicia,11,0,20,9
1714375723551,LISP 5B,A00,507671,Munoz Sanchez; Alicia,9,0,20,11
1714375724580,LISP 5C,A00,507696,Munoz Sanchez; Alicia,9,0,20,11
1714375725608,MAE 197,001,528363,Boechler; Nicholas Sebastia,9998,0,9999,1
1714375726640,MATH 197,001,523477,Kedlaya; Kiran S.,9996,0,9999,3
1714375726640,MATH 197,002,563811,Zhang; Danna,9995,0,9999,4
1714375726640,MATH 197,003,628552,Dumitriu; Ioana,9998,0,9999,1
1714375727667,MCWP 40R,A00,518780,Staff,5,0,20,15
1714375727667,MCWP 40R,B00,518781,Staff,7,0,20,13
1714375727667,MCWP 40R,C00,518783,Staff,5,0,20,15
1714375728696,MCWP 50R,A00,518791,Staff,0,0,20,20
1714375728696,MCWP 50R,B00,518792,Staff,0,1,20,20
1714375728696,MCWP 50R,C00,518793,Staff,0,1,20,20
1714375728696,MCWP 50R,D00,518794,Staff,0,0,20,20
1714375728696,MCWP 50R,E00,518795,Staff,0,1,20,20
1714375728696,MCWP 50R,F00,518796,Staff,0,0,20,20
1714375728696,MCWP 50R,G00,518797,Staff,0,1,20,20
1714375729721,MMW 12R,A01,514034,Herbst; Matthew,0,1,16,16
1714375729721,MMW 12R,A02,514035,Herbst; Matthew,2,0,16,14
1714375730749,MMW 13R,A01,514037,Staff,0,4,16,16
1714375730749,MMW 13R,A02,514039,Staff,0,2,16,16
1714375730749,MMW 13R,A03,628519,Staff,0,2,16,16
1714375732805,SIO 295LS,A00,523233,Staff,12,0,30,18
1714375733830,SIO 295S,A00,523232,Staff,12,0,30,18
1714375734854,SIOC 290S,A01,637330,Merrifield; Mark A,27,0,30,3
1714375735880,SIOC 291S,A01,637333,Gabriel; Corey John,27,0,30,3
1714375736904,SOCI 117,A01,494376,Staff,0,4,5,5
1714375737928,WES 237B,A00,494380,Staff,9,0,20,11
1714375739987,AESE 279B,A00,494370,Wade; Jon P,0,0,33,33
1714375741012,AIP 197,001,627712,Vespa; Emanuel Ignacio,9998,0,9999,1
1714375742039,ANAR 135S,A00,494369,Braswell; Geoffrey E.,0,0,0,0
1714375743065,BENG 196,001,628496,Engler; Adam J.,9998,0,9999,1
1714375744093,CAT 124RS,A01,519847,Geibel; William,0,0,20,20
1714375745118,CAT 125RS,A01,515971,Geibel; William,0,0,20,20
1714375746147,CLRE 250,A00,511389,Morris; Sheldon,9993,0,9999,6
1714375747172,CLRE 251,A00,507176,Mehta; Ravindra L.,9993,0,9999,6
1714375747172,CLRE 251,B00,511410,Mehta; Ravindra L.,9998,0,9999,1
1714375748197,CLRE 252,A00,507189,Cuomo; Raphael Eduardo,9995,0,9999,4
1714375749226,CLRE 253,A00,507199,Vaida; Florin,9994,0,9999,5
1714375749226,CLRE 253,B00,507202,Vaida; Florin,9999,0,9999,0
1714375750252,CLRE 259,A00,507211,Patel; Hemal,9996,0,9999,3
1714375751277,CLRE 260,A00,507221,Cuomo; Raphael Eduardo,9999,0,9999,0
1714375752304,CLRE 297,001,507242,Cuomo; Raphael Eduardo,9999,0,9999,0
1714375753329,COGS 197,001,638244,Voytek; Bradley Thomas,9999,0,9999,0
1714375754356,CSE 191,A00,516875,Minnes Kemp; Mor Mia,9993,0,9999,6
1714375755380,CSE 197,001,637388,Minnes Kemp; Mor Mia,9998,0,9999,1
1714375756404,CSS 201S,A01,494383,Staff,35,0,35,0
1714375757428,CSS 202S,A01,494387,Staff,35,0,35,0
1714375758453,DSC 197,001,628532,Eldridge; Justin Matthew,9996,0,9999,3
1714375759477,EAP 100,A00,516065,Staff,9797,0,9999,202
1714375760505,ECE 45,A01,507414,Staff,33,0,60,27
1714375762557,ECE 111,A01,507420,Staff,19,0,50,31
1714375763584,ECE 197,001,548057,Sievenpiper; Daniel F.,9994,0,9999,5
1714375764614,EDS 115,A00,507243,Choi; Bailey Miyeon,12,0,28,16
1714375765641,EDS 117,A01,494379,Staff,0,2,30,30
1714375766669,EDS 125,A00,507246,Hopkins; Megan Beth,12,0,30,18
1714375767697,EDS 128A,A01,507264,Fargason; Sharon Gayle,14,0,26,12
1714375768721,EDS 128B,A01,507293,Pappas; Elizabeth,18,0,30,12
1714375769748,EDS 139,A00,507294,Fargason; Sharon Gayle,18,0,30,12
1714375769748,EDS 139,B00,507313,Pappas; Elizabeth,15,0,30,15
1714375770775,EDS 201,A00,507315,Staff,13,0,30,17
1714375771802,EDS 203,A01,507317,Halter; Christopher P.,12,0,30,18
1714375772826,EDS 204R,A01,507319,Halter; Christopher P.,0,3,30,30
1714375772826,EDS 204R,B01,507331,Heinzman; Erica M.,17,0,30,13
1714375773855,EDS 206R,A00,507332,Staff,0,4,30,30
1714375773855,EDS 206R,B00,507343,Staff,18,0,30,12
1714375774887,EDS 250,A00,507344,Hemans; Patricia Ann Benitez,22,0,40,18
1714375775911,EDS 281,A00,507345,Daly; Alan J.,18,0,18,0
1714375776935,EDS 284,A00,507350,Daly; Alan J.,16,0,16,0
1714375777961,EDS 286,A00,507359,Fine; Sarah,18,0,18,0
1714375778986,EDS 289C,A01,507361,Daly; Alan J.,18,0,18,0
1714375780012,EDS 290,A00,507366,Hofstetter; Carolyn,15,0,15,0
1714375781038,LIGM 5A,A00,507421,Fischer-Grunski; Eva K,18,0,20,2
1714375782066,LIGM 5B,A00,507423,Fischer-Grunski; Eva K,19,0,20,1
1714375783095,LIGM 5C,A00,507425,Fischer-Grunski; Eva K,19,0,20,1
1714375784124,LIIT 5AS,A00,507427,Carnelos; Chiara,20,0,20,0
1714375785154,LIIT 5BS,A00,507430,Carnelos; Chiara,20,0,20,0
1714375786182,LIIT 5CS,A00,507432,Carnelos; Chiara,20,0,20,0
1714375787209,LISP 5A,A00,507541,Munoz Sanchez; Alicia,11,0,20,9
1714375788236,LISP 5B,A00,507671,Munoz Sanchez; Alicia,9,0,20,11
1714375789259,LISP 5C,A00,507696,Munoz Sanchez; Alicia,9,0,20,11
1714375790286,MAE 197,001,528363,Boechler; Nicholas Sebastia,9998,0,9999,1
1714375791314,MATH 197,001,523477,Kedlaya; Kiran S.,9996,0,9999,3
1714375791314,MATH 197,002,563811,Zhang; Danna,9995,0,9999,4
1714375791314,MATH 197,003,628552,Dumitriu; Ioana,9998,0,9999,1
1714375792340,MCWP 40R,A00,518780,Staff,5,0,20,15
1714375792340,MCWP 40R,B00,518781,Staff,7,0,20,13
1714375792340,MCWP 40R,C00,518783,Staff,5,0,20,15
1714375793366,MCWP 50R,A00,518791,Staff,0,0,20,20
1714375793366,MCWP 50R,B00,518792,Staff,0,1,20,20
1714375793366,MCWP 50R,C00,518793,Staff,0,1,20,20
1714375793366,MCWP 50R,D00,518794,Staff,0,0,20,20
1714375793366,MCWP 50R,E00,518795,Staff,0,1,20,20
1714375793366,MCWP 50R,F00,518796,Staff,0,0,20,20
1714375793366,MCWP 50R,G00,518797,Staff,0,1,20,20
1714375794390,MMW 12R,A01,514034,Herbst; Matthew,0,1,16,16
1714375794390,MMW 12R,A02,514035,Herbst; Matthew,2,0,16,14
1714375795414,MMW 13R,A01,514037,Staff,0,4,16,16
1714375795414,MMW 13R,A02,514039,Staff,0,2,16,16
1714375795414,MMW 13R,A03,628519,Staff,0,2,16,16
1714375797464,SIO 295LS,A00,523233,Staff,12,0,30,18
1714375798491,SIO 295S,A00,523232,Staff,12,0,30,18
1714375799515,SIOC 290S,A01,637330,Merrifield; Mark A,27,0,30,3
1714375800539,SIOC 291S,A01,637333,Gabriel; Corey John,27,0,30,3
1714375801565,SOCI 117,A01,494376,Staff,0,4,5,5
1714375802592,WES 237B,A00,494380,Staff,9,0,20,11
1714375804652,AESE 279B,A00,494370,Wade; Jon P,0,0,33,33
1714375805676,AIP 197,001,627712,Vespa; Emanuel Ignacio,9998,0,9999,1
1714375806755,ANAR 135S,A00,494369,Braswell; Geoffrey E.,0,0,0,0
1714375807779,BENG 196,001,628496,Engler; Adam J.,9998,0,9999,1
1714375808804,CAT 124RS,A01,519847,Geibel; William,0,0,20,20
1714375809830,CAT 125RS,A01,515971,Geibel; William,0,0,20,20
1714375810856,CLRE 250,A00,511389,Morris; Sheldon,9993,0,9999,6
1714375811889,CLRE 251,A00,507176,Mehta; Ravindra L.,9993,0,9999,6
1714375811889,CLRE 251,B00,511410,Mehta; Ravindra L.,9998,0,9999,1
1714375812914,CLRE 252,A00,507189,Cuomo; Raphael Eduardo,9995,0,9999,4
1714375813951,CLRE 253,A00,507199,Vaida; Florin,9994,0,9999,5
1714375813951,CLRE 253,B00,507202,Vaida; Florin,9999,0,9999,0
1714375814979,CLRE 259,A00,507211,Patel; Hemal,9996,0,9999,3
1714375816006,CLRE 260,A00,507221,Cuomo; Raphael Eduardo,9999,0,9999,0
1714375817030,CLRE 297,001,507242,Cuomo; Raphael Eduardo,9999,0,9999,0
1714375818056,COGS 197,001,638244,Voytek; Bradley Thomas,9999,0,9999,0
1714375819082,CSE 191,A00,516875,Minnes Kemp; Mor Mia,9993,0,9999,6
1714375820108,CSE 197,001,637388,Minnes Kemp; Mor Mia,9998,0,9999,1
1714375821137,CSS 201S,A01,494383,Staff,35,0,35,0
1714375822161,CSS 202S,A01,494387,Staff,35,0,35,0
1714375823187,DSC 197,001,628532,Eldridge; Justin Matthew,9996,0,9999,3
1714375824211,EAP 100,A00,516065,Staff,9797,0,9999,202
1714375825236,ECE 45,A01,507414,Staff,33,0,60,27
1714375827285,ECE 111,A01,507420,Staff,19,0,50,31
1714375828310,ECE 197,001,548057,Sievenpiper; Daniel F.,9994,0,9999,5
1714375829339,EDS 115,A00,507243,Choi; Bailey Miyeon,12,0,28,16
1714375830363,EDS 117,A01,494379,Staff,0,2,30,30
1714375831387,EDS 125,A00,507246,Hopkins; Megan Beth,12,0,30,18
1714375832411,EDS 128A,A01,507264,Fargason; Sharon Gayle,14,0,26,12
1714375833438,EDS 128B,A01,507293,Pappas; Elizabeth,18,0,30,12
1714375834466,EDS 139,A00,507294,Fargason; Sharon Gayle,18,0,30,12
1714375834466,EDS 139,B00,507313,Pappas; Elizabeth,15,0,30,15
1714375835493,EDS 201,A00,507315,Staff,13,0,30,17
1714375836519,EDS 203,A01,507317,Halter; Christopher P.,12,0,30,18
1714375837548,EDS 204R,A01,507319,Halter; Christopher P.,0,3,30,30
1714375837548,EDS 204R,B01,507331,Heinzman; Erica M.,17,0,30,13
1714375838573,EDS 206R,A00,507332,Staff,0,4,30,30
1714375838573,EDS 206R,B00,507343,Staff,18,0,30,12
1714375839600,EDS 250,A00,507344,Hemans; Patricia Ann Benitez,22,0,40,18
1714375840625,EDS 281,A00,507345,Daly; Alan J.,18,0,18,0
1714375841649,EDS 284,A00,507350,Daly; Alan J.,16,0,16,0
1714375842674,EDS 286,A00,507359,Fine; Sarah,18,0,18,0
1714375843698,EDS 289C,A01,507361,Daly; Alan J.,18,0,18,0
1714375844723,EDS 290,A00,507366,Hofstetter; Carolyn,15,0,15,0
1714375845747,LIGM 5A,A00,507421,Fischer-Grunski; Eva K,18,0,20,2
1714375846776,LIGM 5B,A00,507423,Fischer-Grunski; Eva K,19,0,20,1
1714375847805,LIGM 5C,A00,507425,Fischer-Grunski; Eva K,19,0,20,1
1714375848829,LIIT 5AS,A00,507427,Carnelos; Chiara,20,0,20,0
1714375849857,LIIT 5BS,A00,507430,Carnelos; Chiara,20,0,20,0
1714375850886,LIIT 5CS,A00,507432,Carnelos; Chiara,20,0,20,0
1714375851915,LISP 5A,A00,507541,Munoz Sanchez; Alicia,11,0,20,9
1714375852940,LISP 5B,A00,507671,Munoz Sanchez; Alicia,9,0,20,11
1714375853968,LISP 5C,A00,507696,Munoz Sanchez; Alicia,9,0,20,11
1714375854994,MAE 197,001,528363,Boechler; Nicholas Sebastia,9998,0,9999,1
1714375856018,MATH 197,001,523477,Kedlaya; Kiran S.,9996,0,9999,3
1714375856018,MATH 197,002,563811,Zhang; Danna,9995,0,9999,4
1714375856018,MATH 197,003,628552,Dumitriu; Ioana,9998,0,9999,1
1714375857042,MCWP 40R,A00,518780,Staff,5,0,20,15
1714375857042,MCWP 40R,B00,518781,Staff,7,0,20,13
1714375857042,MCWP 40R,C00,518783,Staff,5,0,20,15
1714375858067,MCWP 50R,A00,518791,Staff,0,0,20,20
1714375858067,MCWP 50R,B00,518792,Staff,0,1,20,20
1714375858067,MCWP 50R,C00,518793,Staff,0,1,20,20
1714375858067,MCWP 50R,D00,518794,Staff,0,0,20,20
1714375858067,MCWP 50R,E00,518795,Staff,0,1,20,20
1714375858067,MCWP 50R,F00,518796,Staff,0,0,20,20
1714375858067,MCWP 50R,G00,518797,Staff,0,1,20,20
1714375859092,MMW 12R,A01,514034,Herbst; Matthew,0,1,16,16
1714375859092,MMW 12R,A02,514035,Herbst; Matthew,2,0,16,14
1714375860120,MMW 13R,A01,514037,Staff,0,4,16,16
1714375860120,MMW 13R,A02,514039,Staff,0,2,16,16
1714375860120,MMW 13R,A03,628519,Staff,0,2,16,16
1714375862168,SIO 295LS,A00,523233,Staff,12,0,30,18
1714375863192,SIO 295S,A00,523232,Staff,12,0,30,18
1714375864218,SIOC 290S,A01,637330,Merrifield; Mark A,27,0,30,3
1714375865248,SIOC 291S,A01,637333,Gabriel; Corey John,27,0,30,3
1714375866275,SOCI 117,A01,494376,Staff,0,4,5,5
1714375867299,WES 237B,A00,494380,Staff,9,0,20,11
1714375869352,AESE 279B,A00,494370,Wade; Jon P,0,0,33,33
1714375870375,AIP 197,001,627712,Vespa; Emanuel Ignacio,9998,0,9999,1
1714375871403,ANAR 135S,A00,494369,Braswell; Geoffrey E.,0,0,0,0
1714375872427,BENG 196,001,628496,Engler; Adam J.,9998,0,9999,1
1714375873453,CAT 124RS,A01,519847,Geibel; William,0,0,20,20
1714375874479,CAT 125RS,A01,515971,Geibel; William,0,0,20,20
1714375875505,CLRE 250,A00,511389,Morris; Sheldon,9993,0,9999,6
1714375876529,CLRE 251,A00,507176,Mehta; Ravindra L.,9993,0,9999,6
1714375876529,CLRE 251,B00,511410,Mehta; Ravindra L.,9998,0,9999,1
1714375877553,CLRE 252,A00,507189,Cuomo; Raphael Eduardo,9995,0,9999,4
1714375878580,CLRE 253,A00,507199,Vaida; Florin,9994,0,9999,5
1714375878580,CLRE 253,B00,507202,Vaida; Florin,9999,0,9999,0
1714375879605,CLRE 259,A00,507211,Patel; Hemal,9996,0,9999,3
1714375880631,CLRE 260,A00,507221,Cuomo; Raphael Eduardo,9999,0,9999,0
1714375881655,CLRE 297,001,507242,Cuomo; Raphael Eduardo,9999,0,9999,0
1714375882682,COGS 197,001,638244,Voytek; Bradley Thomas,9999,0,9999,0
1714375883711,CSE 191,A00,516875,Minnes Kemp; Mor Mia,9993,0,9999,6
1714375884738,CSE 197,001,637388,Minnes Kemp; Mor Mia,9998,0,9999,1
1714375885768,CSS 201S,A01,494383,Staff,35,0,35,0
1714375886798,CSS 202S,A01,494387,Staff,35,0,35,0
1714375887822,DSC 197,001,628532,Eldridge; Justin Matthew,9996,0,9999,3
1714375888849,EAP 100,A00,516065,Staff,9797,0,9999,202
1714375889873,ECE 45,A01,507414,Staff,33,0,60,27
1714375891921,ECE 111,A01,507420,Staff,19,0,50,31
1714375892948,ECE 197,001,548057,Sievenpiper; Daniel F.,9994,0,9999,5
1714375893977,EDS 115,A00,507243,Choi; Bailey Miyeon,12,0,28,16
1714375895003,EDS 117,A01,494379,Staff,0,2,30,30
1714375896028,EDS 125,A00,507246,Hopkins; Megan Beth,12,0,30,18
1714375897056,EDS 128A,A01,507264,Fargason; Sharon Gayle,14,0,26,12
1714375898082,EDS 128B,A01,507293,Pappas; Elizabeth,18,0,30,12
1714375899109,EDS 139,A00,507294,Fargason; Sharon Gayle,18,0,30,12
1714375899109,EDS 139,B00,507313,Pappas; Elizabeth,15,0,30,15
1714375900135,EDS 201,A00,507315,Staff,13,0,30,17
1714375901163,EDS 203,A01,507317,Halter; Christopher P.,12,0,30,18
1714375902193,EDS 204R,A01,507319,Halter; Christopher P.,0,3,30,30
1714375902193,EDS 204R,B01,507331,Heinzman; Erica M.,17,0,30,13
1714375903220,EDS 206R,A00,507332,Staff,0,4,30,30
1714375903220,EDS 206R,B00,507343,Staff,18,0,30,12
1714375904246,EDS 250,A00,507344,Hemans; Patricia Ann Benitez,22,0,40,18
1714375905271,EDS 281,A00,507345,Daly; Alan J.,18,0,18,0
1714375906298,EDS 284,A00,507350,Daly; Alan J.,16,0,16,0
1714375907326,EDS 286,A00,507359,Fine; Sarah,18,0,18,0
1714375908353,EDS 289C,A01,507361,Daly; Alan J.,18,0,18,0
1714375909382,EDS 290,A00,507366,Hofstetter; Carolyn,15,0,15,0
1714375910465,LIGM 5A,A00,507421,Fischer-Grunski; Eva K,18,0,20,2
1714375911493,LIGM 5B,A00,507423,Fischer-Grunski; Eva K,19,0,20,1
1714375912519,LIGM 5C,A00,507425,Fischer-Grunski; Eva K,19,0,20,1
1714375913548,LIIT 5AS,A00,507427,Carnelos; Chiara,20,0,20,0
1714375914574,LIIT 5BS,A00,507430,Carnelos; Chiara,20,0,20,0
1714375915602,LIIT 5CS,A00,507432,Carnelos; Chiara,20,0,20,0
1714375916633,LISP 5A,A00,507541,Munoz Sanchez; Alicia,11,0,20,9
1714375917661,LISP 5B,A00,507671,Munoz Sanchez; Alicia,9,0,20,11
1714375918691,LISP 5C,A00,507696,Munoz Sanchez; Alicia,9,0,20,11
1714375919725,MAE 197,001,528363,Boechler; Nicholas Sebastia,9998,0,9999,1
1714375920766,MATH 197,001,523477,Kedlaya; Kiran S.,9996,0,9999,3
1714375920766,MATH 197,002,563811,Zhang; Danna,9995,0,9999,4
1714375920766,MATH 197,003,628552,Dumitriu; Ioana,9998,0,9999,1
1714375921794,MCWP 40R,A00,518780,Staff,5,0,20,15
1714375921794,MCWP 40R,B00,518781,Staff,7,0,20,13
1714375921794,MCWP 40R,C00,518783,Staff,5,0,20,15
1714375922822,MCWP 50R,A00,518791,Staff,0,0,20,20
1714375922822,MCWP 50R,B00,518792,Staff,0,1,20,20
1714375922822,MCWP 50R,C00,518793,Staff,0,1,20,20
1714375922822,MCWP 50R,D00,518794,Staff,0,0,20,20
1714375922822,MCWP 50R,E00,518795,Staff,0,1,20,20
1714375922822,MCWP 50R,F00,518796,Staff,0,0,20,20
1714375922822,MCWP 50R,G00,518797,Staff,0,1,20,20
1714375923850,MMW 12R,A01,514034,Herbst; Matthew,0,1,16,16
1714375923850,MMW 12R,A02,514035,Herbst; Matthew,2,0,16,14
1714375924876,MMW 13R,A01,514037,Staff,0,4,16,16
1714375924876,MMW 13R,A02,514039,Staff,0,2,16,16
1714375924876,MMW 13R,A03,628519,Staff,0,2,16,16
1714375926928,SIO 295LS,A00,523233,Staff,12,0,30,18
1714375927958,SIO 295S,A00,523232,Staff,12,0,30,18
1714375928986,SIOC 290S,A01,637330,Merrifield; Mark A,27,0,30,3
1714375930014,SIOC 291S,A01,637333,Gabriel; Corey John,27,0,30,3
1714375931046,SOCI 117,A01,494376,Staff,0,4,5,5
1714375932070,WES 237B,A00,494380,Staff,9,0,20,11
1714375934138,AESE 279B,A00,494370,Wade; Jon P,0,0,33,33
1714375935166,AIP 197,001,627712,Vespa; Emanuel Ignacio,9998,0,9999,1
1714375936194,ANAR 135S,A00,494369,Braswell; Geoffrey E.,0,0,0,0
1714375937222,BENG 196,001,628496,Engler; Adam J.,9998,0,9999,1
1714375938247,CAT 124RS,A01,519847,Geibel; William,0,0,20,20
1714375939274,CAT 125RS,A01,515971,Geibel; William,0,0,20,20
1714375940303,CLRE 250,A00,511389,Morris; Sheldon,9993,0,9999,6
1714375941332,CLRE 251,A00,507176,Mehta; Ravindra L.,9993,0,9999,6
1714375941332,CLRE 251,B00,511410,Mehta; Ravindra L.,9998,0,9999,1
1714375942360,CLRE 252,A00,507189,Cuomo; Raphael Eduardo,9995,0,9999,4
1714375943389,CLRE 253,A00,507199,Vaida; Florin,9994,0,9999,5
1714375943389,CLRE 253,B00,507202,Vaida; Florin,9999,0,9999,0
1714375944416,CLRE 259,A00,507211,Patel; Hemal,9996,0,9999,3
1714375945442,CLRE 260,A00,507221,Cuomo; Raphael Eduardo,9999,0,9999,0
1714375946470,CLRE 297,001,507242,Cuomo; Raphael Eduardo,9999,0,9999,0
1714375947498,COGS 197,001,638244,Voytek; Bradley Thomas,9999,0,9999,0
1714375948525,CSE 191,A00,516875,Minnes Kemp; Mor Mia,9993,0,9999,6
1714375949552,CSE 197,001,637388,Minnes Kemp; Mor Mia,9998,0,9999,1
1714375950580,CSS 201S,A01,494383,Staff,35,0,35,0
1714375951609,CSS 202S,A01,494387,Staff,35,0,35,0
1714375952633,DSC 197,001,628532,Eldridge; Justin Matthew,9996,0,9999,3
1714375953661,EAP 100,A00,516065,Staff,9797,0,9999,202
1714375954688,ECE 45,A01,507414,Staff,33,0,60,27
1714375956738,ECE 111,A01,507420,Staff,19,0,50,31
1714375957765,ECE 197,001,548057,Sievenpiper; Daniel F.,9994,0,9999,5
1714375958790,EDS 115,A00,507243,Choi; Bailey Miyeon,12,0,28,16
1714375959816,EDS 117,A01,494379,Staff,0,2,30,30
1714375960841,EDS 125,A00,507246,Hopkins; Megan Beth,12,0,30,18
1714375961866,EDS 128A,A01,507264,Fargason; Sharon Gayle,14,0,26,12
1714375962892,EDS 128B,A01,507293,Pappas; Elizabeth,18,0,30,12
1714375963918,EDS 139,A00,507294,Fargason; Sharon Gayle,18,0,30,12
1714375963918,EDS 139,B00,507313,Pappas; Elizabeth,15,0,30,15
1714375964945,EDS 201,A00,507315,Staff,13,0,30,17
1714375965977,EDS 203,A01,507317,Halter; Christopher P.,12,0,30,18
1714375967008,EDS 204R,A01,507319,Halter; Christopher P.,0,3,30,30
1714375967008,EDS 204R,B01,507331,Heinzman; Erica M.,17,0,30,13
1714375968037,EDS 206R,A00,507332,Staff,0,4,30,30
1714375968037,EDS 206R,B00,507343,Staff,18,0,30,12
1714375969065,EDS 250,A00,507344,Hemans; Patricia Ann Benitez,22,0,40,18
1714375970093,EDS 281,A00,507345,Daly; Alan J.,18,0,18,0
1714375971120,EDS 284,A00,507350,Daly; Alan J.,16,0,16,0
1714375972149,EDS 286,A00,507359,Fine; Sarah,18,0,18,0
1714375973178,EDS 289C,A01,507361,Daly; Alan J.,18,0,18,0
1714375974206,EDS 290,A00,507366,Hofstetter; Carolyn,15,0,15,0
1714375975234,LIGM 5A,A00,507421,Fischer-Grunski; Eva K,18,0,20,2
1714375976263,LIGM 5B,A00,507423,Fischer-Grunski; Eva K,19,0,20,1
1714375977291,LIGM 5C,A00,507425,Fischer-Grunski; Eva K,19,0,20,1
1714375978318,LIIT 5AS,A00,507427,Carnelos; Chiara,20,0,20,0
1714375979350,LIIT 5BS,A00,507430,Carnelos; Chiara,20,0,20,0
1714375980379,LIIT 5CS,A00,507432,Carnelos; Chiara,20,0,20,0
1714375981407,LISP 5A,A00,507541,Munoz Sanchez; Alicia,11,0,20,9
1714375982435,LISP 5B,A00,507671,Munoz Sanchez; Alicia,9,0,20,11
1714375983465,LISP 5C,A00,507696,Munoz Sanchez; Alicia,9,0,20,11
1714375984491,MAE 197,001,528363,Boechler; Nicholas Sebastia,9998,0,9999,1
1714375985519,MATH 197,001,523477,Kedlaya; Kiran S.,9996,0,9999,3
1714375985519,MATH 197,002,563811,Zhang; Danna,9995,0,9999,4
1714375985519,MATH 197,003,628552,Dumitriu; Ioana,9998,0,9999,1
1714375986549,MCWP 40R,A00,518780,Staff,5,0,20,15
1714375986549,MCWP 40R,B00,518781,Staff,7,0,20,13
1714375986549,MCWP 40R,C00,518783,Staff,5,0,20,15
1714375987576,MCWP 50R,A00,518791,Staff,0,0,20,20
1714375987576,MCWP 50R,B00,518792,Staff,0,1,20,20
1714375987576,MCWP 50R,C00,518793,Staff,0,1,20,20
1714375987576,MCWP 50R,D00,518794,Staff,0,0,20,20
1714375987576,MCWP 50R,E00,518795,Staff,0,1,20,20
1714375987576,MCWP 50R,F00,518796,Staff,0,0,20,20
1714375987576,MCWP 50R,G00,518797,Staff,0,1,20,20
1714375988604,MMW 12R,A01,514034,Herbst; Matthew,0,1,16,16
1714375988604,MMW 12R,A02,514035,Herbst; Matthew,2,0,16,14
1714375989633,MMW 13R,A01,514037,Staff,0,4,16,16
1714375989633,MMW 13R,A02,514039,Staff,0,2,16,16
1714375989633,MMW 13R,A03,628519,Staff,0,2,16,16
1714375991688,SIO 295LS,A00,523233,Staff,12,0,30,18
1714375992716,SIO 295S,A00,523232,Staff,12,0,30,18
1714375993747,SIOC 290S,A01,637330,Merrifield; Mark A,27,0,30,3
1714375994777,SIOC 291S,A01,637333,Gabriel; Corey John,27,0,30,3
1714375995805,SOCI 117,A01,494376,Staff,0,4,5,5
1714375996834,WES 237B,A00,494380,Staff,9,0,20,11
1714375998915,AESE 279B,A00,494370,Wade; Jon P,0,0,33,33
1714375999942,AIP 197,001,627712,Vespa; Emanuel Ignacio,9998,0,9999,1
1714376000971,ANAR 135S,A00,494369,Braswell; Geoffrey E.,0,0,0,0
1714376001999,BENG 196,001,628496,Engler; Adam J.,9998,0,9999,1
1714376003026,CAT 124RS,A01,519847,Geibel; William,0,0,20,20
1714376004054,CAT 125RS,A01,515971,Geibel; William,0,0,20,20
1714376005083,CLRE 250,A00,511389,Morris; Sheldon,9993,0,9999,6
1714376006114,CLRE 251,A00,507176,Mehta; Ravindra L.,9993,0,9999,6
1714376006114,CLRE 251,B00,511410,Mehta; Ravindra L.,9998,0,9999,1
1714376007140,CLRE 252,A00,507189,Cuomo; Raphael Eduardo,9995,0,9999,4
1714376008166,CLRE 253,A00,507199,Vaida; Florin,9994,0,9999,5
1714376008166,CLRE 253,B00,507202,Vaida; Florin,9999,0,9999,0
1714376009194,CLRE 259,A00,507211,Patel; Hemal,9996,0,9999,3
1714376010224,CLRE 260,A00,507221,Cuomo; Raphael Eduardo,9999,0,9999,0
1714376011253,CLRE 297,001,507242,Cuomo; Raphael Eduardo,9999,0,9999,0
1714376012282,COGS 197,001,638244,Voytek; Bradley Thomas,9999,0,9999,0
1714376013310,CSE 191,A00,516875,Minnes Kemp; Mor Mia,9993,0,9999,6
1714376014390,CSE 197,001,637388,Minnes Kemp; Mor Mia,9998,0,9999,1
1714376015416,CSS 201S,A01,494383,Staff,35,0,35,0
1714376016445,CSS 202S,A01,494387,Staff,35,0,35,0
1714376017473,DSC 197,001,628532,Eldridge; Justin Matthew,9996,0,9999,3
1714376018498,EAP 100,A00,516065,Staff,9797,0,9999,202
1714376019524,ECE 45,A01,507414,Staff,33,0,60,27
1714376021577,ECE 111,A01,507420,Staff,19,0,50,31
1714376022602,ECE 197,001,548057,Sievenpiper; Daniel F.,9994,0,9999,5
1714376023631,EDS 115,A00,507243,Choi; Bailey Miyeon,12,0,28,16
1714376024656,EDS 117,A01,494379,Staff,0,2,30,30
1714376025681,EDS 125,A00,507246,Hopkins; Megan Beth,12,0,30,18
1714376026706,EDS 128A,A01,507264,Fargason; Sharon Gayle,14,0,26,12
1714376027732,EDS 128B,A01,507293,Pappas; Elizabeth,18,0,30,12
1714376028759,EDS 139,A00,507294,Fargason; Sharon Gayle,18,0,30,12
1714376028759,EDS 139,B00,507313,Pappas; Elizabeth,15,0,30,15
1714376029787,EDS 201,A00,507315,Staff,13,0,30,17
1714376030817,EDS 203,A01,507317,Halter; Christopher P.,12,0,30,18
1714376031851,EDS 204R,A01,507319,Halter; Christopher P.,0,3,30,30
1714376031851,EDS 204R,B01,507331,Heinzman; Erica M.,17,0,30,13
1714376032880,EDS 206R,A00,507332,Staff,0,4,30,30
1714376032880,EDS 206R,B00,507343,Staff,18,0,30,12
1714376033911,EDS 250,A00,507344,Hemans; Patricia Ann Benitez,22,0,40,18
1714376034938,EDS 281,A00,507345,Daly; Alan J.,18,0,18,0
1714376035965,EDS 284,A00,507350,Daly; Alan J.,16,0,16,0
1714376036997,EDS 286,A00,507359,Fine; Sarah,18,0,18,0
1714376038025,EDS 289C,A01,507361,Daly; Alan J.,18,0,18,0
1714376039054,EDS 290,A00,507366,Hofstetter; Carolyn,15,0,15,0
1714376040086,LIGM 5A,A00,507421,Fischer-Grunski; Eva K,18,0,20,2
1714376041123,LIGM 5B,A00,507423,Fischer-Grunski; Eva K,19,0,20,1
1714376042152,LIGM 5C,A00,507425,Fischer-Grunski; Eva K,19,0,20,1
1714376043178,LIIT 5AS,A00,507427,Carnelos; Chiara,20,0,20,0
1714376044217,LIIT 5BS,A00,507430,Carnelos; Chiara,20,0,20,0
1714376045249,LIIT 5CS,A00,507432,Carnelos; Chiara,20,0,20,0
1714376046277,LISP 5A,A00,507541,Munoz Sanchez; Alicia,11,0,20,9
1714376047307,LISP 5B,A00,507671,Munoz Sanchez; Alicia,9,0,20,11
1714376048334,LISP 5C,A00,507696,Munoz Sanchez; Alicia,9,0,20,11
1714376049366,MAE 197,001,528363,Boechler; Nicholas Sebastia,9998,0,9999,1
1714376050393,MATH 197,001,523477,Kedlaya; Kiran S.,9996,0,9999,3
1714376050393,MATH 197,002,563811,Zhang; Danna,9995,0,9999,4
1714376050393,MATH 197,003,628552,Dumitriu; Ioana,9998,0,9999,1
1714376051422,MCWP 40R,A00,518780,Staff,5,0,20,15
1714376051422,MCWP 40R,B00,518781,Staff,7,0,20,13
1714376051422,MCWP 40R,C00,518783,Staff,5,0,20,15
1714376052449,MCWP 50R,A00,518791,Staff,0,0,20,20
1714376052449,MCWP 50R,B00,518792,Staff,0,1,20,20
1714376052449,MCWP 50R,C00,518793,Staff,0,1,20,20
1714376052449,MCWP 50R,D00,518794,Staff,0,0,20,20
1714376052449,MCWP 50R,E00,518795,Staff,0,1,20,20
1714376052449,MCWP 50R,F00,518796,Staff,0,0,20,20
1714376052449,MCWP 50R,G00,518797,Staff,0,1,20,20
1714376053475,MMW 12R,A01,514034,Herbst; Matthew,0,1,16,16
1714376053475,MMW 12R,A02,514035,Herbst; Matthew,2,0,16,14
1714376054509,MMW 13R,A01,514037,Staff,0,4,16,16
1714376054509,MMW 13R,A02,514039,Staff,0,2,16,16
1714376054509,MMW 13R,A03,628519,Staff,0,2,16,16
1714376056571,SIO 295LS,A00,523233,Staff,12,0,30,18
1714376057595,SIO 295S,A00,523232,Staff,12,0,30,18
1714376058622,SIOC 290S,A01,637330,Merrifield; Mark A,27,0,30,3
1714376059652,SIOC 291S,A01,637333,Gabriel; Corey John,27,0,30,3
1714376060678,SOCI 117,A01,494376,Staff,0,4,5,5
1714376061706,WES 237B,A00,494380,Staff,9,0,20,11
1714376063765,AESE 279B,A00,494370,Wade; Jon P,0,0,33,33
1714376064792,AIP 197,001,627712,Vespa; Emanuel Ignacio,9998,0,9999,1
1714376065816,ANAR 135S,A00,494369,Braswell; Geoffrey E.,0,0,0,0
1714376066841,BENG 196,001,628496,Engler; Adam J.,9998,0,9999,1
1714376067868,CAT 124RS,A01,519847,Geibel; William,0,0,20,20
1714376068895,CAT 125RS,A01,515971,Geibel; William,0,0,20,20
1714376069922,CLRE 250,A00,511389,Morris; Sheldon,9993,0,9999,6
1714376070952,CLRE 251,A00,507176,Mehta; Ravindra L.,9993,0,9999,6
1714376070952,CLRE 251,B00,511410,Mehta; Ravindra L.,9998,0,9999,1
1714376071981,CLRE 252,A00,507189,Cuomo; Raphael Eduardo,9995,0,9999,4
1714376073008,CLRE 253,A00,507199,Vaida; Florin,9994,0,9999,5
1714376073008,CLRE 253,B00,507202,Vaida; Florin,9999,0,9999,0
1714376074036,CLRE 259,A00,507211,Patel; Hemal,9996,0,9999,3
1714376075064,CLRE 260,A00,507221,Cuomo; Raphael Eduardo,9999,0,9999,0
1714376076089,CLRE 297,001,507242,Cuomo; Raphael Eduardo,9999,0,9999,0
1714376077117,COGS 197,001,638244,Voytek; Bradley Thomas,9999,0,9999,0
1714376078144,CSE 191,A00,516875,Minnes Kemp; Mor Mia,9993,0,9999,6
1714376079169,CSE 197,001,637388,Minnes Kemp; Mor Mia,9998,0,9999,1
1714376080194,CSS 201S,A01,494383,Staff,35,0,35,0
1714376081218,CSS 202S,A01,494387,Staff,35,0,35,0
1714376082243,DSC 197,001,628532,Eldridge; Justin Matthew,9996,0,9999,3
1714376083271,EAP 100,A00,516065,Staff,9797,0,9999,202
1714376084342,ECE 45,A01,507414,Staff,33,0,60,27
1714376086394,ECE 111,A01,507420,Staff,19,0,50,31
1714376087420,ECE 197,001,548057,Sievenpiper; Daniel F.,9994,0,9999,5
1714376088447,EDS 115,A00,507243,Choi; Bailey Miyeon,12,0,28,16
1714376089472,EDS 117,A01,494379,Staff,0,2,30,30
1714376090496,EDS 125,A00,507246,Hopkins; Megan Beth,12,0,30,18
1714376091521,EDS 128A,A01,507264,Fargason; Sharon Gayle,14,0,26,12
1714376092546,EDS 128B,A01,507293,Pappas; Elizabeth,18,0,30,12
1714376093574,EDS 139,A00,507294,Fargason; Sharon Gayle,18,0,30,12
1714376093574,EDS 139,B00,507313,Pappas; Elizabeth,15,0,30,15
1714376094598,EDS 201,A00,507315,Staff,13,0,30,17
1714376095623,EDS 203,A01,507317,Halter; Christopher P.,12,0,30,18
1714376096652,EDS 204R,A01,507319,Halter; Christopher P.,0,3,30,30
1714376096652,EDS 204R,B01,507331,Heinzman; Erica M.,17,0,30,13
1714376097681,EDS 206R,A00,507332,Staff,0,4,30,30
1714376097681,EDS 206R,B00,507343,Staff,18,0,30,12
1714376098707,EDS 250,A00,507344,Hemans; Patricia Ann Benitez,22,0,40,18
1714376099732,EDS 281,A00,507345,Daly; Alan J.,18,0,18,0
1714376100757,EDS 284,A00,507350,Daly; Alan J.,16,0,16,0
1714376101783,EDS 286,A00,507359,Fine; Sarah,18,0,18,0
1714376102811,EDS 289C,A01,507361,Daly; Alan J.,18,0,18,0
1714376103836,EDS 290,A00,507366,Hofstetter; Carolyn,15,0,15,0
1714376104861,LIGM 5A,A00,507421,Fischer-Grunski; Eva K,18,0,20,2
1714376105886,LIGM 5B,A00,507423,Fischer-Grunski; Eva K,19,0,20,1
1714376106912,LIGM 5C,A00,507425,Fischer-Grunski; Eva K,19,0,20,1
1714376107938,LIIT 5AS,A00,507427,Carnelos; Chiara,20,0,20,0
1714376108970,LIIT 5BS,A00,507430,Carnelos; Chiara,20,0,20,0
1714376109997,LIIT 5CS,A00,507432,Carnelos; Chiara,20,0,20,0
1714376111026,LISP 5A,A00,507541,Munoz Sanchez; Alicia,11,0,20,9
1714376112055,LISP 5B,A00,507671,Munoz Sanchez; Alicia,9,0,20,11
1714376113080,LISP 5C,A00,507696,Munoz Sanchez; Alicia,9,0,20,11
1714376114108,MAE 197,001,528363,Boechler; Nicholas Sebastia,9998,0,9999,1
1714376115138,MATH 197,001,523477,Kedlaya; Kiran S.,9996,0,9999,3
1714376115138,MATH 197,002,563811,Zhang; Danna,9995,0,9999,4
1714376115138,MATH 197,003,628552,Dumitriu; Ioana,9998,0,9999,1
1714376116166,MCWP 40R,A00,518780,Staff,5,0,20,15
1714376116166,MCWP 40R,B00,518781,Staff,7,0,20,13
1714376116166,MCWP 40R,C00,518783,Staff,5,0,20,15
1714376117196,MCWP 50R,A00,518791,Staff,0,0,20,20
1714376117196,MCWP 50R,B00,518792,Staff,0,1,20,20
1714376117196,MCWP 50R,C00,518793,Staff,0,1,20,20
1714376117196,MCWP 50R,D00,518794,Staff,0,0,20,20
1714376117196,MCWP 50R,E00,518795,Staff,0,1,20,20
1714376117196,MCWP 50R,F00,518796,Staff,0,0,20,20
1714376117196,MCWP 50R,G00,518797,Staff,0,1,20,20
1714376118277,MMW 12R,A01,514034,Herbst; Matthew,0,1,16,16
1714376118277,MMW 12R,A02,514035,Herbst; Matthew,2,0,16,14
1714376119308,MMW 13R,A01,514037,Staff,0,4,16,16
1714376119308,MMW 13R,A02,514039,Staff,0,2,16,16
1714376119308,MMW 13R,A03,628519,Staff,0,2,16,16
1714376121369,SIO 295LS,A00,523233,Staff,12,0,30,18
1714376122394,SIO 295S,A00,523232,Staff,12,0,30,18
1714376123420,SIOC 290S,A01,637330,Merrifield; Mark A,27,0,30,3
1714376124449,SIOC 291S,A01,637333,Gabriel; Corey John,27,0,30,3
1714376125474,SOCI 117,A01,494376,Staff,0,4,5,5
1714376126498,WES 237B,A00,494380,Staff,9,0,20,11
1714376128563,AESE 279B,A00,494370,Wade; Jon P,0,0,33,33
1714376129589,AIP 197,001,627712,Vespa; Emanuel Ignacio,9998,0,9999,1
1714376130615,ANAR 135S,A00,494369,Braswell; Geoffrey E.,0,0,0,0
1714376131640,BENG 196,001,628496,Engler; Adam J.,9998,0,9999,1
1714376132665,CAT 124RS,A01,519847,Geibel; William,0,0,20,20
1714376133692,CAT 125RS,A01,515971,Geibel; William,0,0,20,20
1714376134718,CLRE 250,A00,511389,Morris; Sheldon,9993,0,9999,6
1714376135743,CLRE 251,A00,507176,Mehta; Ravindra L.,9993,0,9999,6
1714376135743,CLRE 251,B00,511410,Mehta; Ravindra L.,9998,0,9999,1
1714376136772,CLRE 252,A00,507189,Cuomo; Raphael Eduardo,9995,0,9999,4
1714376137802,CLRE 253,A00,507199,Vaida; Florin,9994,0,9999,5
1714376137802,CLRE 253,B00,507202,Vaida; Florin,9999,0,9999,0
1714376138833,CLRE 259,A00,507211,Patel; Hemal,9996,0,9999,3
1714376139857,CLRE 260,A00,507221,Cuomo; Raphael Eduardo,9999,0,9999,0
1714376140884,CLRE 297,001,507242,Cuomo; Raphael Eduardo,9999,0,9999,0
1714376141910,COGS 197,001,638244,Voytek; Bradley Thomas,9999,0,9999,0
1714376142935,CSE 191,A00,516875,Minnes Kemp; Mor Mia,9993,0,9999,6
1714376143963,CSE 197,001,637388,Minnes Kemp; Mor Mia,9998,0,9999,1
1714376144987,CSS 201S,A01,494383,Staff,35,0,35,0
1714376146012,CSS 202S,A01,494387,Staff,35,0,35,0
1714376147038,DSC 197,001,628532,Eldridge; Justin Matthew,9996,0,9999,3
1714376148062,EAP 100,A00,516065,Staff,9797,0,9999,202
1714376149089,ECE 45,A01,507414,Staff,33,0,60,27
1714376151144,ECE 111,A01,507420,Staff,19,0,50,31
1714376152169,ECE 197,001,548057,Sievenpiper; Daniel F.,9994,0,9999,5
1714376153193,EDS 115,A00,507243,Choi; Bailey Miyeon,12,0,28,16
1714376154218,EDS 117,A01,494379,Staff,0,2,30,30
1714376155244,EDS 125,A00,507246,Hopkins; Megan Beth,12,0,30,18
1714376156273,EDS 128A,A01,507264,Fargason; Sharon Gayle,14,0,26,12
1714376157302,EDS 128B,A01,507293,Pappas; Elizabeth,18,0,30,12
1714376158329,EDS 139,A00,507294,Fargason; Sharon Gayle,18,0,30,12
1714376158329,EDS 139,B00,507313,Pappas; Elizabeth,15,0,30,15
1714376159357,EDS 201,A00,507315,Staff,13,0,30,17
1714376160382,EDS 203,A01,507317,Halter; Christopher P.,12,0,30,18
1714376161412,EDS 204R,A01,507319,Halter; Christopher P.,0,3,30,30
1714376161412,EDS 204R,B01,507331,Heinzman; Erica M.,17,0,30,13
1714376162437,EDS 206R,A00,507332,Staff,0,4,30,30
1714376162437,EDS 206R,B00,507343,Staff,18,0,30,12
1714376163463,EDS 250,A00,507344,Hemans; Patricia Ann Benitez,22,0,40,18
1714376164493,EDS 281,A00,507345,Daly; Alan J.,18,0,18,0
1714376165518,EDS 284,A00,507350,Daly; Alan J.,16,0,16,0
1714376166545,EDS 286,A00,507359,Fine; Sarah,18,0,18,0
1714376167568,EDS 289C,A01,507361,Daly; Alan J.,18,0,18,0
1714376168594,EDS 290,A00,507366,Hofstetter; Carolyn,15,0,15,0
1714376169618,LIGM 5A,A00,507421,Fischer-Grunski; Eva K,18,0,20,2
1714376170643,LIGM 5B,A00,507423,Fischer-Grunski; Eva K,19,0,20,1
1714376171669,LIGM 5C,A00,507425,Fischer-Grunski; Eva K,19,0,20,1
1714376172694,LIIT 5AS,A00,507427,Carnelos; Chiara,20,0,20,0
1714376173724,LIIT 5BS,A00,507430,Carnelos; Chiara,20,0,20,0
1714376174750,LIIT 5CS,A00,507432,Carnelos; Chiara,20,0,20,0
1714376175773,LISP 5A,A00,507541,Munoz Sanchez; Alicia,11,0,20,9
1714376176798,LISP 5B,A00,507671,Munoz Sanchez; Alicia,9,0,20,11
1714376177877,LISP 5C,A00,507696,Munoz Sanchez; Alicia,9,0,20,11
1714376178905,MAE 197,001,528363,Boechler; Nicholas Sebastia,9998,0,9999,1
1714376179929,MATH 197,001,523477,Kedlaya; Kiran S.,9996,0,9999,3
1714376179929,MATH 197,002,563811,Zhang; Danna,9995,0,9999,4
1714376179929,MATH 197,003,628552,Dumitriu; Ioana,9998,0,9999,1
1714376180956,MCWP 40R,A00,518780,Staff,5,0,20,15
1714376180956,MCWP 40R,B00,518781,Staff,7,0,20,13
1714376180956,MCWP 40R,C00,518783,Staff,5,0,20,15
1714376181981,MCWP 50R,A00,518791,Staff,0,0,20,20
1714376181981,MCWP 50R,B00,518792,Staff,0,1,20,20
1714376181981,MCWP 50R,C00,518793,Staff,0,1,20,20
1714376181981,MCWP 50R,D00,518794,Staff,0,0,20,20
1714376181981,MCWP 50R,E00,518795,Staff,0,1,20,20
1714376181981,MCWP 50R,F00,518796,Staff,0,0,20,20
1714376181981,MCWP 50R,G00,518797,Staff,0,1,20,20
1714376183009,MMW 12R,A01,514034,Herbst; Matthew,0,1,16,16
1714376183009,MMW 12R,A02,514035,Herbst; Matthew,2,0,16,14
1714376184035,MMW 13R,A01,514037,Staff,0,4,16,16
1714376184035,MMW 13R,A02,514039,Staff,0,2,16,16
1714376184035,MMW 13R,A03,628519,Staff,0,2,16,16
1714376186089,SIO 295LS,A00,523233,Staff,12,0,30,18
1714376187117,SIO 295S,A00,523232,Staff,12,0,30,18
1714376188141,SIOC 290S,A01,637330,Merrifield; Mark A,27,0,30,3
1714376189165,SIOC 291S,A01,637333,Gabriel; Corey John,27,0,30,3
1714376190190,SOCI 117,A01,494376,Staff,0,4,5,5
1714376191216,WES 237B,A00,494380,Staff,9,0,20,11
1714376193276,AESE 279B,A00,494370,Wade; Jon P,0,0,33,33
1714376194302,AIP 197,001,627712,Vespa; Emanuel Ignacio,9998,0,9999,1
1714376195331,ANAR 135S,A00,494369,Braswell; Geoffrey E.,0,0,0,0
1714376196359,BENG 196,001,628496,Engler; Adam J.,9998,0,9999,1
1714376197386,CAT 124RS,A01,519847,Geibel; William,0,0,20,20
1714376198411,CAT 125RS,A01,515971,Geibel; William,0,0,20,20
1714376199437,CLRE 250,A00,511389,Morris; Sheldon,9993,0,9999,6
1714376200463,CLRE 251,A00,507176,Mehta; Ravindra L.,9993,0,9999,6
1714376200463,CLRE 251,B00,511410,Mehta; Ravindra L.,9998,0,9999,1
1714376201491,CLRE 252,A00,507189,Cuomo; Raphael Eduardo,9995,0,9999,4
1714376202518,CLRE 253,A00,507199,Vaida; Florin,9994,0,9999,5
1714376202518,CLRE 253,B00,507202,Vaida; Florin,9999,0,9999,0
1714376203546,CLRE 259,A00,507211,Patel; Hemal,9996,0,9999,3
1714376204574,CLRE 260,A00,507221,Cuomo; Raphael Eduardo,9999,0,9999,0
1714376205599,CLRE 297,001,507242,Cuomo; Raphael Eduardo,9999,0,9999,0
1714376206624,COGS 197,001,638244,Voytek; Bradley Thomas,9999,0,9999,0
1714376207650,CSE 191,A00,516875,Minnes Kemp; Mor Mia,9993,0,9999,6
1714376208676,CSE 197,001,637388,Minnes Kemp; Mor Mia,9998,0,9999,1
1714376209706,CSS 201S,A01,494383,Staff,35,0,35,0
1714376210890,CSS 202S,A01,494387,Staff,35,0,35,0
1714376211915,DSC 197,001,628532,Eldridge; Justin Matthew,9996,0,9999,3
1714376212941,EAP 100,A00,516065,Staff,9797,0,9999,202
1714376213975,ECE 45,A01,507414,Staff,33,0,60,27
1714376216034,ECE 111,A01,507420,Staff,19,0,50,31
1714376217059,ECE 197,001,548057,Sievenpiper; Daniel F.,9994,0,9999,5
1714376218085,EDS 115,A00,507243,Choi; Bailey Miyeon,12,0,28,16
1714376219110,EDS 117,A01,494379,Staff,0,2,30,30
1714376220141,EDS 125,A00,507246,Hopkins; Megan Beth,12,0,30,18
1714376221168,EDS 128A,A01,507264,Fargason; Sharon Gayle,14,0,26,12
1714376222247,EDS 128B,A01,507293,Pappas; Elizabeth,18,0,30,12
1714376223271,EDS 139,A00,507294,Fargason; Sharon Gayle,18,0,30,12
1714376223271,EDS 139,B00,507313,Pappas; Elizabeth,15,0,30,15
1714376224298,EDS 201,A00,507315,Staff,13,0,30,17
1714376225323,EDS 203,A01,507317,Halter; Christopher P.,12,0,30,18
1714376226348,EDS 204R,A01,507319,Halter; Christopher P.,0,3,30,30
1714376226348,EDS 204R,B01,507331,Heinzman; Erica M.,17,0,30,13
1714376227374,EDS 206R,A00,507332,Staff,0,4,30,30
1714376227374,EDS 206R,B00,507343,Staff,18,0,30,12
1714376228400,EDS 250,A00,507344,Hemans; Patricia Ann Benitez,22,0,40,18
1714376229430,EDS 281,A00,507345,Daly; Alan J.,18,0,18,0
1714376230454,EDS 284,A00,507350,Daly; Alan J.,16,0,16,0
1714376231480,EDS 286,A00,507359,Fine; Sarah,18,0,18,0
1714376232506,EDS 289C,A01,507361,Daly; Alan J.,18,0,18,0
1714376233536,EDS 290,A00,507366,Hofstetter; Carolyn,15,0,15,0
1714376234563,LIGM 5A,A00,507421,Fischer-Grunski; Eva K,18,0,20,2
1714376235589,LIGM 5B,A00,507423,Fischer-Grunski; Eva K,19,0,20,1
1714376236613,LIGM 5C,A00,507425,Fischer-Grunski; Eva K,19,0,20,1
1714376237644,LIIT 5AS,A00,507427,Carnelos; Chiara,20,0,20,0
1714376238671,LIIT 5BS,A00,507430,Carnelos; Chiara,20,0,20,0
1714376239699,LIIT 5CS,A00,507432,Carnelos; Chiara,20,0,20,0
1714376240726,LISP 5A,A00,507541,Munoz Sanchez; Alicia,11,0,20,9
1714376241755,LISP 5B,A00,507671,Munoz Sanchez; Alicia,9,0,20,11
1714376242782,LISP 5C,A00,507696,Munoz Sanchez; Alicia,9,0,20,11
1714376243812,MAE 197,001,528363,Boechler; Nicholas Sebastia,9998,0,9999,1
1714376244841,MATH 197,001,523477,Kedlaya; Kiran S.,9996,0,9999,3
1714376244841,MATH 197,002,563811,Zhang; Danna,9995,0,9999,4
1714376244841,MATH 197,003,628552,Dumitriu; Ioana,9998,0,9999,1
1714376245871,MCWP 40R,A00,518780,Staff,5,0,20,15
1714376245871,MCWP 40R,B00,518781,Staff,7,0,20,13
1714376245871,MCWP 40R,C00,518783,Staff,5,0,20,15
1714376246898,MCWP 50R,A00,518791,Staff,0,0,20,20
1714376246898,MCWP 50R,B00,518792,Staff,0,1,20,20
1714376246898,MCWP 50R,C00,518793,Staff,0,1,20,20
1714376246898,MCWP 50R,D00,518794,Staff,0,0,20,20
1714376246898,MCWP 50R,E00,518795,Staff,0,1,20,20
1714376246898,MCWP 50R,F00,518796,Staff,0,0,20,20
1714376246898,MCWP 50R,G00,518797,Staff,0,1,20,20
1714376247926,MMW 12R,A01,514034,Herbst; Matthew,0,1,16,16
1714376247926,MMW 12R,A02,514035,Herbst; Matthew,2,0,16,14
1714376248951,MMW 13R,A01,514037,Staff,0,4,16,16
1714376248951,MMW 13R,A02,514039,Staff,0,2,16,16
1714376248951,MMW 13R,A03,628519,Staff,0,2,16,16
1714376251005,SIO 295LS,A00,523233,Staff,12,0,30,18
1714376252032,SIO 295S,A00,523232,Staff,12,0,30,18
1714376253059,SIOC 290S,A01,637330,Merrifield; Mark A,27,0,30,3
1714376254091,SIOC 291S,A01,637333,Gabriel; Corey John,27,0,30,3
1714376255119,SOCI 117,A01,494376,Staff,0,4,5,5
1714376256145,WES 237B,A00,494380,Staff,9,0,20,11
1714376258222,AESE 279B,A00,494370,Wade; Jon P,0,0,33,33
1714376259251,AIP 197,001,627712,Vespa; Emanuel Ignacio,9998,0,9999,1
1714376260279,ANAR 135S,A00,494369,Braswell; Geoffrey E.,0,0,0,0
1714376261304,BENG 196,001,628496,Engler; Adam J.,9998,0,9999,1
1714376262332,CAT 124RS,A01,519847,Geibel; William,0,0,20,20
1714376263357,CAT 125RS,A01,515971,Geibel; William,0,0,20,20
1714376264384,CLRE 250,A00,511389,Morris; Sheldon,9993,0,9999,6
1714376265413,CLRE 251,A00,507176,Mehta; Ravindra L.,9993,0,9999,6
1714376265413,CLRE 251,B00,511410,Mehta; Ravindra L.,9998,0,9999,1
1714376266440,CLRE 252,A00,507189,Cuomo; Raphael Eduardo,9995,0,9999,4
1714376267471,CLRE 253,A00,507199,Vaida; Florin,9994,0,9999,5
1714376267471,CLRE 253,B00,507202,Vaida; Florin,9999,0,9999,0
1714376268500,CLRE 259,A00,507211,Patel; Hemal,9996,0,9999,3
1714376269528,CLRE 260,A00,507221,Cuomo; Raphael Eduardo,9999,0,9999,0
1714376270555,CLRE 297,001,507242,Cuomo; Raphael Eduardo,9999,0,9999,0
1714376271580,COGS 197,001,638244,Voytek; Bradley Thomas,9999,0,9999,0
1714376272607,CSE 191,A00,516875,Minnes Kemp; Mor Mia,9993,0,9999,6
1714376273635,CSE 197,001,637388,Minnes Kemp; Mor Mia,9998,0,9999,1
1714376274661,CSS 201S,A01,494383,Staff,35,0,35,0
1714376275686,CSS 202S,A01,494387,Staff,35,0,35,0
1714376276716,DSC 197,001,628532,Eldridge; Justin Matthew,9996,0,9999,3
1714376277744,EAP 100,A00,516065,Staff,9797,0,9999,202
1714376278780,ECE 45,A01,507414,Staff,33,0,60,27
1714376280834,ECE 111,A01,507420,Staff,19,0,50,31
1714376281863,ECE 197,001,548057,Sievenpiper; Daniel F.,9994,0,9999,5
1714376282890,EDS 115,A00,507243,Choi; Bailey Miyeon,12,0,28,16
1714376283917,EDS 117,A01,494379,Staff,0,2,30,30
1714376284944,EDS 125,A00,507246,Hopkins; Megan Beth,12,0,30,18
1714376285971,EDS 128A,A01,507264,Fargason; Sharon Gayle,14,0,26,12
1714376287002,EDS 128B,A01,507293,Pappas; Elizabeth,18,0,30,12
1714376288028,EDS 139,A00,507294,Fargason; Sharon Gayle,18,0,30,12
1714376288028,EDS 139,B00,507313,Pappas; Elizabeth,15,0,30,15
1714376289055,EDS 201,A00,507315,Staff,13,0,30,17
1714376290080,EDS 203,A01,507317,Halter; Christopher P.,12,0,30,18
1714376291112,EDS 204R,A01,507319,Halter; Christopher P.,0,3,30,30
1714376291112,EDS 204R,B01,507331,Heinzman; Erica M.,17,0,30,13
1714376292139,EDS 206R,A00,507332,Staff,0,4,30,30
1714376292139,EDS 206R,B00,507343,Staff,18,0,30,12
1714376293167,EDS 250,A00,507344,Hemans; Patricia Ann Benitez,22,0,40,18
1714376294192,EDS 281,A00,507345,Daly; Alan J.,18,0,18,0
1714376295219,EDS 284,A00,507350,Daly; Alan J.,16,0,16,0
1714376296248,EDS 286,A00,507359,Fine; Sarah,18,0,18,0
1714376297273,EDS 289C,A01,507361,Daly; Alan J.,18,0,18,0
1714376298298,EDS 290,A00,507366,Hofstetter; Carolyn,15,0,15,0
1714376299325,LIGM 5A,A00,507421,Fischer-Grunski; Eva K,18,0,20,2
1714376300353,LIGM 5B,A00,507423,Fischer-Grunski; Eva K,19,0,20,1
1714376301379,LIGM 5C,A00,507425,Fischer-Grunski; Eva K,19,0,20,1
1714376302406,LIIT 5AS,A00,507427,Carnelos; Chiara,20,0,20,0
1714376303435,LIIT 5BS,A00,507430,Carnelos; Chiara,20,0,20,0
1714376304460,LIIT 5CS,A00,507432,Carnelos; Chiara,20,0,20,0
1714376305487,LISP 5A,A00,507541,Munoz Sanchez; Alicia,11,0,20,9
1714376306512,LISP 5B,A00,507671,Munoz Sanchez; Alicia,9,0,20,11
1714376307541,LISP 5C,A00,507696,Munoz Sanchez; Alicia,9,0,20,11
1714376308566,MAE 197,001,528363,Boechler; Nicholas Sebastia,9998,0,9999,1
1714376309593,MATH 197,001,523477,Kedlaya; Kiran S.,9996,0,9999,3
1714376309593,MATH 197,002,563811,Zhang; Danna,9995,0,9999,4
1714376309593,MATH 197,003,628552,Dumitriu; Ioana,9998,0,9999,1
1714376310619,MCWP 40R,A00,518780,Staff,5,0,20,15
1714376310619,MCWP 40R,B00,518781,Staff,7,0,20,13
1714376310619,MCWP 40R,C00,518783,Staff,5,0,20,15
1714376311649,MCWP 50R,A00,518791,Staff,0,0,20,20
1714376311649,MCWP 50R,B00,518792,Staff,0,1,20,20
1714376311649,MCWP 50R,C00,518793,Staff,0,1,20,20
1714376311649,MCWP 50R,D00,518794,Staff,0,0,20,20
1714376311649,MCWP 50R,E00,518795,Staff,0,1,20,20
1714376311649,MCWP 50R,F00,518796,Staff,0,0,20,20
1714376311649,MCWP 50R,G00,518797,Staff,0,1,20,20
1714376312677,MMW 12R,A01,514034,Herbst; Matthew,0,1,16,16
1714376312677,MMW 12R,A02,514035,Herbst; Matthew,2,0,16,14
1714376313704,MMW 13R,A01,514037,Staff,0,4,16,16
1714376313704,MMW 13R,A02,514039,Staff,0,2,16,16
1714376313704,MMW 13R,A03,628519,Staff,0,2,16,16
1714376315757,SIO 295LS,A00,523233,Staff,12,0,30,18
1714376316782,SIO 295S,A00,523232,Staff,12,0,30,18
1714376317809,SIOC 290S,A01,637330,Merrifield; Mark A,27,0,30,3
1714376318841,SIOC 291S,A01,637333,Gabriel; Corey John,27,0,30,3
1714376319871,SOCI 117,A01,494376,Staff,0,4,5,5
1714376320904,WES 237B,A00,494380,Staff,9,0,20,11
1714376322987,AESE 279B,A00,494370,Wade; Jon P,0,0,33,33
1714376324015,AIP 197,001,627712,Vespa; Emanuel Ignacio,9998,0,9999,1
1714376325046,ANAR 135S,A00,494369,Braswell; Geoffrey E.,0,0,0,0
1714376326130,BENG 196,001,628496,Engler; Adam J.,9998,0,9999,1
1714376327159,CAT 124RS,A01,519847,Geibel; William,0,0,20,20
1714376328185,CAT 125RS,A01,515971,Geibel; William,0,0,20,20
1714376329209,CLRE 250,A00,511389,Morris; Sheldon,9993,0,9999,6
1714376330278,CLRE 251,A00,507176,Mehta; Ravindra L.,9993,0,9999,6
1714376330278,CLRE 251,B00,511410,Mehta; Ravindra L.,9998,0,9999,1
1714376331304,CLRE 252,A00,507189,Cuomo; Raphael Eduardo,9995,0,9999,4
1714376332332,CLRE 253,A00,507199,Vaida; Florin,9994,0,9999,5
1714376332332,CLRE 253,B00,507202,Vaida; Florin,9999,0,9999,0
1714376333361,CLRE 259,A00,507211,Patel; Hemal,9996,0,9999,3
1714376334387,CLRE 260,A00,507221,Cuomo; Raphael Eduardo,9999,0,9999,0
1714376335411,CLRE 297,001,507242,Cuomo; Raphael Eduardo,9999,0,9999,0
1714376336434,COGS 197,001,638244,Voytek; Bradley Thomas,9999,0,9999,0
1714376337459,CSE 191,A00,516875,Minnes Kemp; Mor Mia,9993,0,9999,6
1714376338485,CSE 197,001,637388,Minnes Kemp; Mor Mia,9998,0,9999,1
1714376339511,CSS 201S,A01,494383,Staff,35,0,35,0
1714376340540,CSS 202S,A01,494387,Staff,35,0,35,0
1714376341565,DSC 197,001,628532,Eldridge; Justin Matthew,9996,0,9999,3
1714376342590,EAP 100,A00,516065,Staff,9797,0,9999,202
1714376343620,ECE 45,A01,507414,Staff,33,0,60,27
1714376345672,ECE 111,A01,507420,Staff,19,0,50,31
1714376346699,ECE 197,001,548057,Sievenpiper; Daniel F.,9994,0,9999,5
1714376347725,EDS 115,A00,507243,Choi; Bailey Miyeon,12,0,28,16
1714376348752,EDS 117,A01,494379,Staff,0,2,30,30
1714376349781,EDS 125,A00,507246,Hopkins; Megan Beth,12,0,30,18
1714376350807,EDS 128A,A01,507264,Fargason; Sharon Gayle,14,0,26,12
1714376351832,EDS 128B,A01,507293,Pappas; Elizabeth,18,0,30,12
1714376352858,EDS 139,A00,507294,Fargason; Sharon Gayle,18,0,30,12
1714376352858,EDS 139,B00,507313,Pappas; Elizabeth,15,0,30,15
1714376353885,EDS 201,A00,507315,Staff,13,0,30,17
1714376354917,EDS 203,A01,507317,Halter; Christopher P.,12,0,30,18
1714376355942,EDS 204R,A01,507319,Halter; Christopher P.,0,3,30,30
1714376355942,EDS 204R,B01,507331,Heinzman; Erica M.,17,0,30,13
1714376356969,EDS 206R,A00,507332,Staff,0,4,30,30
1714376356969,EDS 206R,B00,507343,Staff,18,0,30,12
1714376357996,EDS 250,A00,507344,Hemans; Patricia Ann Benitez,22,0,40,18
1714376359025,EDS 281,A00,507345,Daly; Alan J.,18,0,18,0
1714376360049,EDS 284,A00,507350,Daly; Alan J.,16,0,16,0
1714376361076,EDS 286,A00,507359,Fine; Sarah,18,0,18,0
1714376362104,EDS 289C,A01,507361,Daly; Alan J.,18,0,18,0
1714376363129,EDS 290,A00,507366,Hofstetter; Carolyn,15,0,15,0
1714376364161,LIGM 5A,A00,507421,Fischer-Grunski; Eva K,18,0,20,2
1714376365186,LIGM 5B,A00,507423,Fischer-Grunski; Eva K,19,0,20,1
1714376366214,LIGM 5C,A00,507425,Fischer-Grunski; Eva K,19,0,20,1
1714376367246,LIIT 5AS,A00,507427,Carnelos; Chiara,20,0,20,0
1714376368275,LIIT 5BS,A00,507430,Carnelos; Chiara,20,0,20,0
1714376369303,LIIT 5CS,A00,507432,Carnelos; Chiara,20,0,20,0
1714376370330,LISP 5A,A00,507541,Munoz Sanchez; Alicia,11,0,20,9
1714376371355,LISP 5B,A00,507671,Munoz Sanchez; Alicia,9,0,20,11
1714376372383,LISP 5C,A00,507696,Munoz Sanchez; Alicia,9,0,20,11
1714376373409,MAE 197,001,528363,Boechler; Nicholas Sebastia,9998,0,9999,1
1714376374435,MATH 197,001,523477,Kedlaya; Kiran S.,9996,0,9999,3
1714376374435,MATH 197,002,563811,Zhang; Danna,9995,0,9999,4
1714376374435,MATH 197,003,628552,Dumitriu; Ioana,9998,0,9999,1
1714376375460,MCWP 40R,A00,518780,Staff,5,0,20,15
1714376375460,MCWP 40R,B00,518781,Staff,7,0,20,13
1714376375460,MCWP 40R,C00,518783,Staff,5,0,20,15
1714376376487,MCWP 50R,A00,518791,Staff,0,0,20,20
1714376376487,MCWP 50R,B00,518792,Staff,0,1,20,20
1714376376487,MCWP 50R,C00,518793,Staff,0,1,20,20
1714376376487,MCWP 50R,D00,518794,Staff,0,0,20,20
1714376376487,MCWP 50R,E00,518795,Staff,0,1,20,20
1714376376487,MCWP 50R,F00,518796,Staff,0,0,20,20
1714376376487,MCWP 50R,G00,518797,Staff,0,1,20,20
1714376377514,MMW 12R,A01,514034,Herbst; Matthew,0,1,16,16
1714376377514,MMW 12R,A02,514035,Herbst; Matthew,2,0,16,14
1714376378541,MMW 13R,A01,514037,Staff,0,4,16,16
1714376378541,MMW 13R,A02,514039,Staff,0,2,16,16
1714376378541,MMW 13R,A03,628519,Staff,0,2,16,16
1714376380593,SIO 295LS,A00,523233,Staff,12,0,30,18
1714376381618,SIO 295S,A00,523232,Staff,12,0,30,18
1714376382650,SIOC 290S,A01,637330,Merrifield; Mark A,27,0,30,3
1714376383681,SIOC 291S,A01,637333,Gabriel; Corey John,27,0,30,3
1714376384711,SOCI 117,A01,494376,Staff,0,4,5,5
1714376385737,WES 237B,A00,494380,Staff,9,0,20,11
1714376387811,AESE 279B,A00,494370,Wade; Jon P,0,0,33,33
1714376388839,AIP 197,001,627712,Vespa; Emanuel Ignacio,9998,0,9999,1
1714376389867,ANAR 135S,A00,494369,Braswell; Geoffrey E.,0,0,0,0
1714376390895,BENG 196,001,628496,Engler; Adam J.,9998,0,9999,1
1714376391926,CAT 124RS,A01,519847,Geibel; William,0,0,20,20
1714376392954,CAT 125RS,A01,515971,Geibel; William,0,0,20,20
1714376393983,CLRE 250,A00,511389,Morris; Sheldon,9993,0,9999,6
1714376395011,CLRE 251,A00,507176,Mehta; Ravindra L.,9993,0,9999,6
1714376395011,CLRE 251,B00,511410,Mehta; Ravindra L.,9998,0,9999,1
1714376396040,CLRE 252,A00,507189,Cuomo; Raphael Eduardo,9995,0,9999,4
1714376397071,CLRE 253,A00,507199,Vaida; Florin,9994,0,9999,5
1714376397071,CLRE 253,B00,507202,Vaida; Florin,9999,0,9999,0
1714376398098,CLRE 259,A00,507211,Patel; Hemal,9996,0,9999,3
1714376399124,CLRE 260,A00,507221,Cuomo; Raphael Eduardo,9999,0,9999,0
1714376400153,CLRE 297,001,507242,Cuomo; Raphael Eduardo,9999,0,9999,0
1714376401183,COGS 197,001,638244,Voytek; Bradley Thomas,9999,0,9999,0
1714376402222,CSE 191,A00,516875,Minnes Kemp; Mor Mia,9993,0,9999,6
1714376403251,CSE 197,001,637388,Minnes Kemp; Mor Mia,9998,0,9999,1
1714376404282,CSS 201S,A01,494383,Staff,35,0,35,0
1714376405307,CSS 202S,A01,494387,Staff,35,0,35,0
1714376406334,DSC 197,001,628532,Eldridge; Justin Matthew,9996,0,9999,3
1714376407358,EAP 100,A00,516065,Staff,9797,0,9999,202
1714376408387,ECE 45,A01,507414,Staff,33,0,60,27
1714376410440,ECE 111,A01,507420,Staff,19,0,50,31
1714376411465,ECE 197,001,548057,Sievenpiper; Daniel F.,9994,0,9999,5
1714376412493,EDS 115,A00,507243,Choi; Bailey Miyeon,12,0,28,16
1714376413519,EDS 117,A01,494379,Staff,0,2,30,30
1714376414548,EDS 125,A00,507246,Hopkins; Megan Beth,12,0,30,18
1714376415580,EDS 128A,A01,507264,Fargason; Sharon Gayle,14,0,26,12
1714376416608,EDS 128B,A01,507293,Pappas; Elizabeth,18,0,30,12
1714376417638,EDS 139,A00,507294,Fargason; Sharon Gayle,18,0,30,12
1714376417638,EDS 139,B00,507313,Pappas; Elizabeth,15,0,30,15
1714376418667,EDS 201,A00,507315,Staff,13,0,30,17
1714376419692,EDS 203,A01,507317,Halter; Christopher P.,12,0,30,18
1714376420720,EDS 204R,A01,507319,Halter; Christopher P.,0,3,30,30
1714376420720,EDS 204R,B01,507331,Heinzman; Erica M.,17,0,30,13
1714376421746,EDS 206R,A00,507332,Staff,0,4,30,30
1714376421746,EDS 206R,B00,507343,Staff,18,0,30,12
1714376422773,EDS 250,A00,507344,Hemans; Patricia Ann Benitez,22,0,40,18
1714376423802,EDS 281,A00,507345,Daly; Alan J.,18,0,18,0
1714376424830,EDS 284,A00,507350,Daly; Alan J.,16,0,16,0
1714376425858,EDS 286,A00,507359,Fine; Sarah,18,0,18,0
1714376426885,EDS 289C,A01,507361,Daly; Alan J.,18,0,18,0
1714376427913,EDS 290,A00,507366,Hofstetter; Carolyn,15,0,15,0
1714376428940,LIGM 5A,A00,507421,Fischer-Grunski; Eva K,18,0,20,2
1714376430018,LIGM 5B,A00,507423,Fischer-Grunski; Eva K,19,0,20,1
1714376431046,LIGM 5C,A00,507425,Fischer-Grunski; Eva K,19,0,20,1
1714376432078,LIIT 5AS,A00,507427,Carnelos; Chiara,20,0,20,0
1714376433106,LIIT 5BS,A00,507430,Carnelos; Chiara,20,0,20,0
1714376434132,LIIT 5CS,A00,507432,Carnelos; Chiara,20,0,20,0
1714376435160,LISP 5A,A00,507541,Munoz Sanchez; Alicia,11,0,20,9
1714376436186,LISP 5B,A00,507671,Munoz Sanchez; Alicia,9,0,20,11
1714376437216,LISP 5C,A00,507696,Munoz Sanchez; Alicia,9,0,20,11
1714376438239,MAE 197,001,528363,Boechler; Nicholas Sebastia,9998,0,9999,1
1714376439266,MATH 197,001,523477,Kedlaya; Kiran S.,9996,0,9999,3
1714376439266,MATH 197,002,563811,Zhang; Danna,9995,0,9999,4
1714376439266,MATH 197,003,628552,Dumitriu; Ioana,9998,0,9999,1
1714376440294,MCWP 40R,A00,518780,Staff,5,0,20,15
1714376440294,MCWP 40R,B00,518781,Staff,7,0,20,13
1714376440294,MCWP 40R,C00,518783,Staff,5,0,20,15
1714376441322,MCWP 50R,A00,518791,Staff,0,0,20,20
1714376441322,MCWP 50R,B00,518792,Staff,0,1,20,20
1714376441322,MCWP 50R,C00,518793,Staff,0,1,20,20
1714376441322,MCWP 50R,D00,518794,Staff,0,0,20,20
1714376441322,MCWP 50R,E00,518795,Staff,0,1,20,20
1714376441322,MCWP 50R,F00,518796,Staff,0,0,20,20
1714376441322,MCWP 50R,G00,518797,Staff,0,1,20,20
1714376442348,MMW 12R,A01,514034,Herbst; Matthew,0,1,16,16
1714376442348,MMW 12R,A02,514035,Herbst; Matthew,2,0,16,14
1714376443376,MMW 13R,A01,514037,Staff,0,4,16,16
1714376443376,MMW 13R,A02,514039,Staff,0,2,16,16
1714376443376,MMW 13R,A03,628519,Staff,0,2,16,16
1714376445425,SIO 295LS,A00,523233,Staff,12,0,30,18
1714376446450,SIO 295S,A00,523232,Staff,12,0,30,18
1714376447480,SIOC 290S,A01,637330,Merrifield; Mark A,27,0,30,3
1714376448506,SIOC 291S,A01,637333,Gabriel; Corey John,27,0,30,3
1714376449534,SOCI 117,A01,494376,Staff,0,4,5,5
1714376450559,WES 237B,A00,494380,Staff,9,0,20,11
1714376452632,AESE 279B,A00,494370,Wade; Jon P,0,0,33,33
1714376453658,AIP 197,001,627712,Vespa; Emanuel Ignacio,9998,0,9999,1
1714376454684,ANAR 135S,A00,494369,Braswell; Geoffrey E.,0,0,0,0
1714376455710,BENG 196,001,628496,Engler; Adam J.,9998,0,9999,1
1714376456736,CAT 124RS,A01,519847,Geibel; William,0,0,20,20
1714376457760,CAT 125RS,A01,515971,Geibel; William,0,0,20,20
1714376458786,CLRE 250,A00,511389,Morris; Sheldon,9993,0,9999,6
1714376459817,CLRE 251,A00,507176,Mehta; Ravindra L.,9993,0,9999,6
1714376459817,CLRE 251,B00,511410,Mehta; Ravindra L.,9998,0,9999,1
1714376460848,CLRE 252,A00,507189,Cuomo; Raphael Eduardo,9995,0,9999,4
1714376461875,CLRE 253,A00,507199,Vaida; Florin,9994,0,9999,5
1714376461875,CLRE 253,B00,507202,Vaida; Florin,9999,0,9999,0
1714376462899,CLRE 259,A00,507211,Patel; Hemal,9996,0,9999,3
1714376463923,CLRE 260,A00,507221,Cuomo; Raphael Eduardo,9999,0,9999,0
1714376464950,CLRE 297,001,507242,Cuomo; Raphael Eduardo,9999,0,9999,0
1714376465976,COGS 197,001,638244,Voytek; Bradley Thomas,9999,0,9999,0
1714376467002,CSE 191,A00,516875,Minnes Kemp; Mor Mia,9993,0,9999,6
1714376468026,CSE 197,001,637388,Minnes Kemp; Mor Mia,9998,0,9999,1
1714376469056,CSS 201S,A01,494383,Staff,35,0,35,0
1714376470084,CSS 202S,A01,494387,Staff,35,0,35,0
1714376471110,DSC 197,001,628532,Eldridge; Justin Matthew,9996,0,9999,3
1714376472134,EAP 100,A00,516065,Staff,9797,0,9999,202
1714376473164,ECE 45,A01,507414,Staff,33,0,60,27
1714376475220,ECE 111,A01,507420,Staff,19,0,50,31
1714376476249,ECE 197,001,548057,Sievenpiper; Daniel F.,9994,0,9999,5
1714376477276,EDS 115,A00,507243,Choi; Bailey Miyeon,12,0,28,16
1714376478308,EDS 117,A01,494379,Staff,0,2,30,30
1714376479340,EDS 125,A00,507246,Hopkins; Megan Beth,12,0,30,18
1714376480368,EDS 128A,A01,507264,Fargason; Sharon Gayle,14,0,26,12
1714376481399,EDS 128B,A01,507293,Pappas; Elizabeth,18,0,30,12
1714376482425,EDS 139,A00,507294,Fargason; Sharon Gayle,18,0,30,12
1714376482425,EDS 139,B00,507313,Pappas; Elizabeth,15,0,30,15
1714376483453,EDS 201,A00,507315,Staff,13,0,30,17
1714376484480,EDS 203,A01,507317,Halter; Christopher P.,12,0,30,18
1714376485506,EDS 204R,A01,507319,Halter; Christopher P.,0,3,30,30
1714376485506,EDS 204R,B01,507331,Heinzman; Erica M.,17,0,30,13
1714376486534,EDS 206R,A00,507332,Staff,0,4,30,30
1714376486534,EDS 206R,B00,507343,Staff,18,0,30,12
1714376487561,EDS 250,A00,507344,Hemans; Patricia Ann Benitez,22,0,40,18
1714376488587,EDS 281,A00,507345,Daly; Alan J.,18,0,18,0
1714376489613,EDS 284,A00,507350,Daly; Alan J.,16,0,16,0
1714376490644,EDS 286,A00,507359,Fine; Sarah,18,0,18,0
1714376491668,EDS 289C,A01,507361,Daly; Alan J.,18,0,18,0
1714376492694,EDS 290,A00,507366,Hofstetter; Carolyn,15,0,15,0
1714376493727,LIGM 5A,A00,507421,Fischer-Grunski; Eva K,18,0,20,2
1714376494752,LIGM 5B,A00,507423,Fischer-Grunski; Eva K,19,0,20,1
1714376495781,LIGM 5C,A00,507425,Fischer-Grunski; Eva K,19,0,20,1
1714376496808,LIIT 5AS,A00,507427,Carnelos; Chiara,20,0,20,0
1714376497834,LIIT 5BS,A00,507430,Carnelos; Chiara,20,0,20,0
1714376498863,LIIT 5CS,A00,507432,Carnelos; Chiara,20,0,20,0
1714376499896,LISP 5A,A00,507541,Munoz Sanchez; Alicia,11,0,20,9
1714376500925,LISP 5B,A00,507671,Munoz Sanchez; Alicia,9,0,20,11
1714376501949,LISP 5C,A00,507696,Munoz Sanchez; Alicia,9,0,20,11
1714376502975,MAE 197,001,528363,Boechler; Nicholas Sebastia,9998,0,9999,1
1714376504005,MATH 197,001,523477,Kedlaya; Kiran S.,9996,0,9999,3
1714376504005,MATH 197,002,563811,Zhang; Danna,9995,0,9999,4
1714376504005,MATH 197,003,628552,Dumitriu; Ioana,9998,0,9999,1
1714376505031,MCWP 40R,A00,518780,Staff,5,0,20,15
1714376505031,MCWP 40R,B00,518781,Staff,7,0,20,13
1714376505031,MCWP 40R,C00,518783,Staff,5,0,20,15
1714376506061,MCWP 50R,A00,518791,Staff,0,0,20,20
1714376506061,MCWP 50R,B00,518792,Staff,0,1,20,20
1714376506061,MCWP 50R,C00,518793,Staff,0,1,20,20
1714376506061,MCWP 50R,D00,518794,Staff,0,0,20,20
1714376506061,MCWP 50R,E00,518795,Staff,0,1,20,20
1714376506061,MCWP 50R,F00,518796,Staff,0,0,20,20
1714376506061,MCWP 50R,G00,518797,Staff,0,1,20,20
1714376507089,MMW 12R,A01,514034,Herbst; Matthew,0,1,16,16
1714376507089,MMW 12R,A02,514035,Herbst; Matthew,2,0,16,14
1714376508115,MMW 13R,A01,514037,Staff,0,4,16,16
1714376508115,MMW 13R,A02,514039,Staff,0,2,16,16
1714376508115,MMW 13R,A03,628519,Staff,0,2,16,16
1714376510170,SIO 295LS,A00,523233,Staff,12,0,30,18
1714376511198,SIO 295S,A00,523232,Staff,12,0,30,18
1714376512225,SIOC 290S,A01,637330,Merrifield; Mark A,27,0,30,3
1714376513253,SIOC 291S,A01,637333,Gabriel; Corey John,27,0,30,3
1714376514281,SOCI 117,A01,494376,Staff,0,4,5,5
1714376515309,WES 237B,A00,494380,Staff,9,0,20,11
1714376517392,AESE 279B,A00,494370,Wade; Jon P,0,0,33,33
1714376518418,AIP 197,001,627712,Vespa; Emanuel Ignacio,9998,0,9999,1
1714376519444,ANAR 135S,A00,494369,Braswell; Geoffrey E.,0,0,0,0
1714376520469,BENG 196,001,628496,Engler; Adam J.,9998,0,9999,1
1714376521497,CAT 124RS,A01,519847,Geibel; William,0,0,20,20
1714376522525,CAT 125RS,A01,515971,Geibel; William,0,0,20,20
1714376523554,CLRE 250,A00,511389,Morris; Sheldon,9993,0,9999,6
1714376524580,CLRE 251,A00,507176,Mehta; Ravindra L.,9993,0,9999,6
1714376524580,CLRE 251,B00,511410,Mehta; Ravindra L.,9998,0,9999,1
1714376525605,CLRE 252,A00,507189,Cuomo; Raphael Eduardo,9995,0,9999,4
1714376526634,CLRE 253,A00,507199,Vaida; Florin,9994,0,9999,5
1714376526634,CLRE 253,B00,507202,Vaida; Florin,9999,0,9999,0
1714376527660,CLRE 259,A00,507211,Patel; Hemal,9996,0,9999,3
1714376528688,CLRE 260,A00,507221,Cuomo; Raphael Eduardo,9999,0,9999,0
1714376529713,CLRE 297,001,507242,Cuomo; Raphael Eduardo,9999,0,9999,0
1714376530740,COGS 197,001,638244,Voytek; Bradley Thomas,9999,0,9999,0
1714376531770,CSE 191,A00,516875,Minnes Kemp; Mor Mia,9993,0,9999,6
1714376532796,CSE 197,001,637388,Minnes Kemp; Mor Mia,9998,0,9999,1
1714376533894,CSS 201S,A01,494383,Staff,35,0,35,0
1714376534919,CSS 202S,A01,494387,Staff,35,0,35,0
1714376535949,DSC 197,001,628532,Eldridge; Justin Matthew,9996,0,9999,3
1714376536982,EAP 100,A00,516065,Staff,9797,0,9999,202
1714376538009,ECE 45,A01,507414,Staff,33,0,60,27
1714376540063,ECE 111,A01,507420,Staff,19,0,50,31
1714376541091,ECE 197,001,548057,Sievenpiper; Daniel F.,9994,0,9999,5
1714376542121,EDS 115,A00,507243,Choi; Bailey Miyeon,12,0,28,16
1714376543157,EDS 117,A01,494379,Staff,0,2,30,30
1714376544189,EDS 125,A00,507246,Hopkins; Megan Beth,12,0,30,18
1714376545219,EDS 128A,A01,507264,Fargason; Sharon Gayle,14,0,26,12
1714376546247,EDS 128B,A01,507293,Pappas; Elizabeth,18,0,30,12
1714376547273,EDS 139,A00,507294,Fargason; Sharon Gayle,18,0,30,12
1714376547273,EDS 139,B00,507313,Pappas; Elizabeth,15,0,30,15
1714376548303,EDS 201,A00,507315,Staff,13,0,30,17
1714376549335,EDS 203,A01,507317,Halter; Christopher P.,12,0,30,18
1714376550371,EDS 204R,A01,507319,Halter; Christopher P.,0,3,30,30
1714376550371,EDS 204R,B01,507331,Heinzman; Erica M.,17,0,30,13
1714376551402,EDS 206R,A00,507332,Staff,0,4,30,30
1714376551402,EDS 206R,B00,507343,Staff,18,0,30,12
1714376552428,EDS 250,A00,507344,Hemans; Patricia Ann Benitez,22,0,40,18
1714376553456,EDS 281,A00,507345,Daly; Alan J.,18,0,18,0
1714376554480,EDS 284,A00,507350,Daly; Alan J.,16,0,16,0
1714376555510,EDS 286,A00,507359,Fine; Sarah,18,0,18,0
1714376556537,EDS 289C,A01,507361,Daly; Alan J.,18,0,18,0
1714376557569,EDS 290,A00,507366,Hofstetter; Carolyn,15,0,15,0
1714376558605,LIGM 5A,A00,507421,Fischer-Grunski; Eva K,18,0,20,2
1714376559635,LIGM 5B,A00,507423,Fischer-Grunski; Eva K,19,0,20,1
1714376560671,LIGM 5C,A00,507425,Fischer-Grunski; Eva K,19,0,20,1
1714376561703,LIIT 5AS,A00,507427,Carnelos; Chiara,20,0,20,0
1714376562734,LIIT 5BS,A00,507430,Carnelos; Chiara,20,0,20,0
1714376563766,LIIT 5CS,A00,507432,Carnelos; Chiara,20,0,20,0
1714376564799,LISP 5A,A00,507541,Munoz Sanchez; Alicia,11,0,20,9
1714376565831,LISP 5B,A00,507671,Munoz Sanchez; Alicia,9,0,20,11
1714376566856,LISP 5C,A00,507696,Munoz Sanchez; Alicia,9,0,20,11
1714376567886,MAE 197,001,528363,Boechler; Nicholas Sebastia,9998,0,9999,1
1714376568918,MATH 197,001,523477,Kedlaya; Kiran S.,9996,0,9999,3
1714376568918,MATH 197,002,563811,Zhang; Danna,9995,0,9999,4
1714376568918,MATH 197,003,628552,Dumitriu; Ioana,9998,0,9999,1
1714376569946,MCWP 40R,A00,518780,Staff,5,0,20,15
1714376569946,MCWP 40R,B00,518781,Staff,7,0,20,13
1714376569946,MCWP 40R,C00,518783,Staff,5,0,20,15
1714376571072,MCWP 50R,A00,518791,Staff,0,0,20,20
1714376571072,MCWP 50R,B00,518792,Staff,0,1,20,20
1714376571072,MCWP 50R,C00,518793,Staff,0,1,20,20
1714376571072,MCWP 50R,D00,518794,Staff,0,0,20,20
1714376571072,MCWP 50R,E00,518795,Staff,0,1,20,20
1714376571072,MCWP 50R,F00,518796,Staff,0,0,20,20
1714376571072,MCWP 50R,G00,518797,Staff,0,1,20,20
1714376572100,MMW 12R,A01,514034,Herbst; Matthew,0,1,16,16
1714376572100,MMW 12R,A02,514035,Herbst; Matthew,2,0,16,14
1714376573130,MMW 13R,A01,514037,Staff,0,4,16,16
1714376573130,MMW 13R,A02,514039,Staff,0,2,16,16
1714376573130,MMW 13R,A03,628519,Staff,0,2,16,16
1714376575191,SIO 295LS,A00,523233,Staff,12,0,30,18
1714376576219,SIO 295S,A00,523232,Staff,12,0,30,18
1714376577251,SIOC 290S,A01,637330,Merrifield; Mark A,27,0,30,3
1714376578276,SIOC 291S,A01,637333,Gabriel; Corey John,27,0,30,3
1714376579307,SOCI 117,A01,494376,Staff,0,4,5,5
1714376580337,WES 237B,A00,494380,Staff,9,0,20,11
1714376582420,AESE 279B,A00,494370,Wade; Jon P,0,0,33,33
1714376583445,AIP 197,001,627712,Vespa; Emanuel Ignacio,9998,0,9999,1
1714376584474,ANAR 135S,A00,494369,Braswell; Geoffrey E.,0,0,0,0
1714376585499,BENG 196,001,628496,Engler; Adam J.,9998,0,9999,1
1714376586533,CAT 124RS,A01,519847,Geibel; William,0,0,20,20
1714376587558,CAT 125RS,A01,515971,Geibel; William,0,0,20,20
1714376588586,CLRE 250,A00,511389,Morris; Sheldon,9993,0,9999,6
1714376589621,CLRE 251,A00,507176,Mehta; Ravindra L.,9993,0,9999,6
1714376589621,CLRE 251,B00,511410,Mehta; Ravindra L.,9998,0,9999,1
1714376590654,CLRE 252,A00,507189,Cuomo; Raphael Eduardo,9995,0,9999,4
1714376591681,CLRE 253,A00,507199,Vaida; Florin,9994,0,9999,5
1714376591681,CLRE 253,B00,507202,Vaida; Florin,9999,0,9999,0
1714376592719,CLRE 259,A00,507211,Patel; Hemal,9996,0,9999,3
1714376593745,CLRE 260,A00,507221,Cuomo; Raphael Eduardo,9999,0,9999,0
1714376594773,CLRE 297,001,507242,Cuomo; Raphael Eduardo,9999,0,9999,0
1714376595805,COGS 197,001,638244,Voytek; Bradley Thomas,9999,0,9999,0
1714376596834,CSE 191,A00,516875,Minnes Kemp; Mor Mia,9993,0,9999,6
1714376597859,CSE 197,001,637388,Minnes Kemp; Mor Mia,9998,0,9999,1
1714376598888,CSS 201S,A01,494383,Staff,35,0,35,0
1714376599912,CSS 202S,A01,494387,Staff,35,0,35,0
1714376600944,DSC 197,001,628532,Eldridge; Justin Matthew,9996,0,9999,3
1714376601971,EAP 100,A00,516065,Staff,9797,0,9999,202
1714376603003,ECE 45,A01,507414,Staff,33,0,60,27
1714376605060,ECE 111,A01,507420,Staff,19,0,50,31
1714376606093,ECE 197,001,548057,Sievenpiper; Daniel F.,9994,0,9999,5
1714376607124,EDS 115,A00,507243,Choi; Bailey Miyeon,12,0,28,16
1714376608154,EDS 117,A01,494379,Staff,0,2,30,30
1714376609181,EDS 125,A00,507246,Hopkins; Megan Beth,12,0,30,18
1714376610210,EDS 128A,A01,507264,Fargason; Sharon Gayle,14,0,26,12
1714376611239,EDS 128B,A01,507293,Pappas; Elizabeth,18,0,30,12
1714376612268,EDS 139,A00,507294,Fargason; Sharon Gayle,18,0,30,12
1714376612268,EDS 139,B00,507313,Pappas; Elizabeth,15,0,30,15
1714376613298,EDS 201,A00,507315,Staff,13,0,30,17
1714376614329,EDS 203,A01,507317,Halter; Christopher P.,12,0,30,18
1714376615361,EDS 204R,A01,507319,Halter; Christopher P.,0,3,30,30
1714376615361,EDS 204R,B01,507331,Heinzman; Erica M.,17,0,30,13
1714376616421,EDS 206R,A00,507332,Staff,0,4,30,30
1714376616421,EDS 206R,B00,507343,Staff,18,0,30,12
1714376617450,EDS 250,A00,507344,Hemans; Patricia Ann Benitez,22,0,40,18
1714376618481,EDS 281,A00,507345,Daly; Alan J.,18,0,18,0
1714376619507,EDS 284,A00,507350,Daly; Alan J.,16,0,16,0
1714376620537,EDS 286,A00,507359,Fine; Sarah,18,0,18,0
1714376621566,EDS 289C,A01,507361,Daly; Alan J.,18,0,18,0
1714376622593,EDS 290,A00,507366,Hofstetter; Carolyn,15,0,15,0
1714376623630,LIGM 5A,A00,507421,Fischer-Grunski; Eva K,18,0,20,2
1714376624660,LIGM 5B,A00,507423,Fischer-Grunski; Eva K,19,0,20,1
1714376625685,LIGM 5C,A00,507425,Fischer-Grunski; Eva K,19,0,20,1
1714376626720,LIIT 5AS,A00,507427,Carnelos; Chiara,20,0,20,0
1714376627748,LIIT 5BS,A00,507430,Carnelos; Chiara,20,0,20,0
1714376628776,LIIT 5CS,A00,507432,Carnelos; Chiara,20,0,20,0
1714376629813,LISP 5A,A00,507541,Munoz Sanchez; Alicia,11,0,20,9
1714376630844,LISP 5B,A00,507671,Munoz Sanchez; Alicia,9,0,20,11
1714376631869,LISP 5C,A00,507696,Munoz Sanchez; Alicia,9,0,20,11
1714376632897,MAE 197,001,528363,Boechler; Nicholas Sebastia,9998,0,9999,1
1714376633930,MATH 197,001,523477,Kedlaya; Kiran S.,9996,0,9999,3
1714376633930,MATH 197,002,563811,Zhang; Danna,9995,0,9999,4
1714376633930,MATH 197,003,628552,Dumitriu; Ioana,9998,0,9999,1
1714376634958,MCWP 40R,A00,518780,Staff,5,0,20,15
1714376634958,MCWP 40R,B00,518781,Staff,7,0,20,13
1714376634958,MCWP 40R,C00,518783,Staff,5,0,20,15
1714376635990,MCWP 50R,A00,518791,Staff,0,0,20,20
1714376635990,MCWP 50R,B00,518792,Staff,0,1,20,20
1714376635990,MCWP 50R,C00,518793,Staff,0,1,20,20
1714376635990,MCWP 50R,D00,518794,Staff,0,0,20,20
1714376635990,MCWP 50R,E00,518795,Staff,0,1,20,20
1714376635990,MCWP 50R,F00,518796,Staff,0,0,20,20
1714376635990,MCWP 50R,G00,518797,Staff,0,1,20,20
1714376637020,MMW 12R,A01,514034,Herbst; Matthew,0,1,16,16
1714376637020,MMW 12R,A02,514035,Herbst; Matthew,2,0,16,14
1714376638103,MMW 13R,A01,514037,Staff,0,4,16,16
1714376638103,MMW 13R,A02,514039,Staff,0,2,16,16
1714376638103,MMW 13R,A03,628519,Staff,0,2,16,16
1714376640153,SIO 295LS,A00,523233,Staff,12,0,30,18
1714376641179,SIO 295S,A00,523232,Staff,12,0,30,18
1714376642210,SIOC 290S,A01,637330,Merrifield; Mark A,27,0,30,3
1714376643241,SIOC 291S,A01,637333,Gabriel; Corey John,27,0,30,3
1714376644271,SOCI 117,A01,494376,Staff,0,4,5,5
1714376645297,WES 237B,A00,494380,Staff,9,0,20,11
1714376647390,AESE 279B,A00,494370,Wade; Jon P,0,0,33,33
1714376648416,AIP 197,001,627712,Vespa; Emanuel Ignacio,9998,0,9999,1
1714376649444,ANAR 135S,A00,494369,Braswell; Geoffrey E.,0,0,0,0
1714376650479,BENG 196,001,628496,Engler; Adam J.,9998,0,9999,1
1714376651509,CAT 124RS,A01,519847,Geibel; William,0,0,20,20
1714376652537,CAT 125RS,A01,515971,Geibel; William,0,0,20,20
1714376653568,CLRE 250,A00,511389,Morris; Sheldon,9993,0,9999,6
1714376654602,CLRE 251,A00,507176,Mehta; Ravindra L.,9993,0,9999,6
1714376654602,CLRE 251,B00,511410,Mehta; Ravindra L.,9998,0,9999,1
1714376655632,CLRE 252,A00,507189,Cuomo; Raphael Eduardo,9995,0,9999,4
1714376656661,CLRE 253,A00,507199,Vaida; Florin,9994,0,9999,5
1714376656661,CLRE 253,B00,507202,Vaida; Florin,9999,0,9999,0
1714376657685,CLRE 259,A00,507211,Patel; Hemal,9996,0,9999,3
1714376658713,CLRE 260,A00,507221,Cuomo; Raphael Eduardo,9999,0,9999,0
1714376659739,CLRE 297,001,507242,Cuomo; Raphael Eduardo,9999,0,9999,0
1714376660768,COGS 197,001,638244,Voytek; Bradley Thomas,9999,0,9999,0
1714376661795,CSE 191,A00,516875,Minnes Kemp; Mor Mia,9993,0,9999,6
1714376662824,CSE 197,001,637388,Minnes Kemp; Mor Mia,9998,0,9999,1
1714376663866,CSS 201S,A01,494383,Staff,35,0,35,0
1714376664897,CSS 202S,A01,494387,Staff,35,0,35,0
1714376665928,DSC 197,001,628532,Eldridge; Justin Matthew,9996,0,9999,3
1714376666956,EAP 100,A00,516065,Staff,9797,0,9999,202
1714376667983,ECE 45,A01,507414,Staff,33,0,60,27
1714376670044,ECE 111,A01,507420,Staff,19,0,50,31
1714376671083,ECE 197,001,548057,Sievenpiper; Daniel F.,9994,0,9999,5
1714376672113,EDS 115,A00,507243,Choi; Bailey Miyeon,12,0,28,16
1714376673146,EDS 117,A01,494379,Staff,0,2,30,30
1714376674173,EDS 125,A00,507246,Hopkins; Megan Beth,12,0,30,18
1714376675197,EDS 128A,A01,507264,Fargason; Sharon Gayle,14,0,26,12
1714376676228,EDS 128B,A01,507293,Pappas; Elizabeth,18,0,30,12
1714376677257,EDS 139,A00,507294,Fargason; Sharon Gayle,18,0,30,12
1714376677257,EDS 139,B00,507313,Pappas; Elizabeth,15,0,30,15
1714376678288,EDS 201,A00,507315,Staff,13,0,30,17
1714376679312,EDS 203,A01,507317,Halter; Christopher P.,12,0,30,18
1714376680342,EDS 204R,A01,507319,Halter; Christopher P.,0,3,30,30
1714376680342,EDS 204R,B01,507331,Heinzman; Erica M.,17,0,30,13
1714376681374,EDS 206R,A00,507332,Staff,0,4,30,30
1714376681374,EDS 206R,B00,507343,Staff,18,0,30,12
1714376682402,EDS 250,A00,507344,Hemans; Patricia Ann Benitez,22,0,40,18
1714376683430,EDS 281,A00,507345,Daly; Alan J.,18,0,18,0
1714376684460,EDS 284,A00,507350,Daly; Alan J.,16,0,16,0
1714376685485,EDS 286,A00,507359,Fine; Sarah,18,0,18,0
1714376686510,EDS 289C,A01,507361,Daly; Alan J.,18,0,18,0
1714376687539,EDS 290,A00,507366,Hofstetter; Carolyn,15,0,15,0
1714376688566,LIGM 5A,A00,507421,Fischer-Grunski; Eva K,18,0,20,2
1714376689596,LIGM 5B,A00,507423,Fischer-Grunski; Eva K,19,0,20,1
1714376690621,LIGM 5C,A00,507425,Fischer-Grunski; Eva K,19,0,20,1
1714376691647,LIIT 5AS,A00,507427,Carnelos; Chiara,20,0,20,0
1714376692675,LIIT 5BS,A00,507430,Carnelos; Chiara,20,0,20,0
1714376693703,LIIT 5CS,A00,507432,Carnelos; Chiara,20,0,20,0
1714376694729,LISP 5A,A00,507541,Munoz Sanchez; Alicia,11,0,20,9
1714376695757,LISP 5B,A00,507671,Munoz Sanchez; Alicia,9,0,20,11
1714376696785,LISP 5C,A00,507696,Munoz Sanchez; Alicia,9,0,20,11
1714376697812,MAE 197,001,528363,Boechler; Nicholas Sebastia,9998,0,9999,1
1714376698839,MATH 197,001,523477,Kedlaya; Kiran S.,9996,0,9999,3
1714376698839,MATH 197,002,563811,Zhang; Danna,9995,0,9999,4
1714376698839,MATH 197,003,628552,Dumitriu; Ioana,9998,0,9999,1
1714376699865,MCWP 40R,A00,518780,Staff,5,0,20,15
1714376699865,MCWP 40R,B00,518781,Staff,7,0,20,13
1714376699865,MCWP 40R,C00,518783,Staff,5,0,20,15
1714376700896,MCWP 50R,A00,518791,Staff,0,0,20,20
1714376700896,MCWP 50R,B00,518792,Staff,0,1,20,20
1714376700896,MCWP 50R,C00,518793,Staff,0,1,20,20
1714376700896,MCWP 50R,D00,518794,Staff,0,0,20,20
1714376700896,MCWP 50R,E00,518795,Staff,0,1,20,20
1714376700896,MCWP 50R,F00,518796,Staff,0,0,20,20
1714376700896,MCWP 50R,G00,518797,Staff,0,1,20,20
1714376701927,MMW 12R,A01,514034,Herbst; Matthew,0,1,16,16
1714376701927,MMW 12R,A02,514035,Herbst; Matthew,2,0,16,14
1714376702953,MMW 13R,A01,514037,Staff,0,4,16,16
1714376702953,MMW 13R,A02,514039,Staff,0,2,16,16
1714376702953,MMW 13R,A03,628519,Staff,0,2,16,16
1714376705004,SIO 295LS,A00,523233,Staff,12,0,30,18
1714376706032,SIO 295S,A00,523232,Staff,12,0,30,18
1714376707062,SIOC 290S,A01,637330,Merrifield; Mark A,27,0,30,3
1714376708091,SIOC 291S,A01,637333,Gabriel; Corey John,27,0,30,3
1714376709121,SOCI 117,A01,494376,Staff,0,4,5,5
1714376710147,WES 237B,A00,494380,Staff,9,0,20,11
1714376712232,AESE 279B,A00,494370,Wade; Jon P,0,0,33,33
1714376713258,AIP 197,001,627712,Vespa; Emanuel Ignacio,9998,0,9999,1
1714376714290,ANAR 135S,A00,494369,Braswell; Geoffrey E.,0,0,0,0
1714376715317,BENG 196,001,628496,Engler; Adam J.,9998,0,9999,1
1714376716345,CAT 124RS,A01,519847,Geibel; William,0,0,20,20
1714376717371,CAT 125RS,A01,515971,Geibel; William,0,0,20,20
1714376718403,CLRE 250,A00,511389,Morris; Sheldon,9993,0,9999,6
1714376719431,CLRE 251,A00,507176,Mehta; Ravindra L.,9993,0,9999,6
1714376719431,CLRE 251,B00,511410,Mehta; Ravindra L.,9998,0,9999,1
1714376720461,CLRE 252,A00,507189,Cuomo; Raphael Eduardo,9995,0,9999,4
1714376721490,CLRE 253,A00,507199,Vaida; Florin,9994,0,9999,5
1714376721490,CLRE 253,B00,507202,Vaida; Florin,9999,0,9999,0
1714376722520,CLRE 259,A00,507211,Patel; Hemal,9996,0,9999,3
1714376723548,CLRE 260,A00,507221,Cuomo; Raphael Eduardo,9999,0,9999,0
1714376724577,CLRE 297,001,507242,Cuomo; Raphael Eduardo,9999,0,9999,0
1714376725601,COGS 197,001,638244,Voytek; Bradley Thomas,9999,0,9999,0
1714376726627,CSE 191,A00,516875,Minnes Kemp; Mor Mia,9993,0,9999,6
1714376727652,CSE 197,001,637388,Minnes Kemp; Mor Mia,9998,0,9999,1
1714376728684,CSS 201S,A01,494383,Staff,35,0,35,0
1714376729709,CSS 202S,A01,494387,Staff,35,0,35,0
1714376730734,DSC 197,001,628532,Eldridge; Justin Matthew,9996,0,9999,3
1714376731760,EAP 100,A00,516065,Staff,9797,0,9999,202
1714376732786,ECE 45,A01,507414,Staff,33,0,60,27
1714376734839,ECE 111,A01,507420,Staff,19,0,50,31
1714376735868,ECE 197,001,548057,Sievenpiper; Daniel F.,9994,0,9999,5
1714376737110,EDS 115,A00,507243,Choi; Bailey Miyeon,12,0,28,16
1714376738140,EDS 117,A01,494379,Staff,0,2,30,30
1714376739166,EDS 125,A00,507246,Hopkins; Megan Beth,12,0,30,18
1714376740192,EDS 128A,A01,507264,Fargason; Sharon Gayle,14,0,26,12
1714376741219,EDS 128B,A01,507293,Pappas; Elizabeth,18,0,30,12
1714376742301,EDS 139,A00,507294,Fargason; Sharon Gayle,18,0,30,12
1714376742301,EDS 139,B00,507313,Pappas; Elizabeth,15,0,30,15
1714376743326,EDS 201,A00,507315,Staff,13,0,30,17
1714376744357,EDS 203,A01,507317,Halter; Christopher P.,12,0,30,18
1714376745388,EDS 204R,A01,507319,Halter; Christopher P.,0,3,30,30
1714376745388,EDS 204R,B01,507331,Heinzman; Erica M.,17,0,30,13
1714376746415,EDS 206R,A00,507332,Staff,0,4,30,30
1714376746415,EDS 206R,B00,507343,Staff,18,0,30,12
1714376747441,EDS 250,A00,507344,Hemans; Patricia Ann Benitez,22,0,40,18
1714376748465,EDS 281,A00,507345,Daly; Alan J.,18,0,18,0
1714376749490,EDS 284,A00,507350,Daly; Alan J.,16,0,16,0
1714376750518,EDS 286,A00,507359,Fine; Sarah,18,0,18,0
1714376751542,EDS 289C,A01,507361,Daly; Alan J.,18,0,18,0
1714376752570,EDS 290,A00,507366,Hofstetter; Carolyn,15,0,15,0
1714376753598,LIGM 5A,A00,507421,Fischer-Grunski; Eva K,18,0,20,2
1714376754629,LIGM 5B,A00,507423,Fischer-Grunski; Eva K,19,0,20,1
1714376755657,LIGM 5C,A00,507425,Fischer-Grunski; Eva K,19,0,20,1
1714376756690,LIIT 5AS,A00,507427,Carnelos; Chiara,20,0,20,0
1714376757716,LIIT 5BS,A00,507430,Carnelos; Chiara,20,0,20,0
1714376758745,LIIT 5CS,A00,507432,Carnelos; Chiara,20,0,20,0
1714376759778,LISP 5A,A00,507541,Munoz Sanchez; Alicia,11,0,20,9
1714376760809,LISP 5B,A00,507671,Munoz Sanchez; Alicia,9,0,20,11
1714376761838,LISP 5C,A00,507696,Munoz Sanchez; Alicia,9,0,20,11
1714376762868,MAE 197,001,528363,Boechler; Nicholas Sebastia,9998,0,9999,1
1714376763905,MATH 197,001,523477,Kedlaya; Kiran S.,9996,0,9999,3
1714376763905,MATH 197,002,563811,Zhang; Danna,9995,0,9999,4
1714376763905,MATH 197,003,628552,Dumitriu; Ioana,9998,0,9999,1
1714376764934,MCWP 40R,A00,518780,Staff,5,0,20,15
1714376764934,MCWP 40R,B00,518781,Staff,7,0,20,13
1714376764934,MCWP 40R,C00,518783,Staff,5,0,20,15
1714376765960,MCWP 50R,A00,518791,Staff,0,0,20,20
1714376765960,MCWP 50R,B00,518792,Staff,0,1,20,20
1714376765960,MCWP 50R,C00,518793,Staff,0,1,20,20
1714376765960,MCWP 50R,D00,518794,Staff,0,0,20,20
1714376765960,MCWP 50R,E00,518795,Staff,0,1,20,20
1714376765960,MCWP 50R,F00,518796,Staff,0,0,20,20
1714376765960,MCWP 50R,G00,518797,Staff,0,1,20,20
1714376766987,MMW 12R,A01,514034,Herbst; Matthew,0,1,16,16
1714376766987,MMW 12R,A02,514035,Herbst; Matthew,2,0,16,14
1714376768020,MMW 13R,A01,514037,Staff,0,4,16,16
1714376768020,MMW 13R,A02,514039,Staff,0,2,16,16
1714376768020,MMW 13R,A03,628519,Staff,0,2,16,16
1714376770070,SIO 295LS,A00,523233,Staff,12,0,30,18
1714376771096,SIO 295S,A00,523232,Staff,12,0,30,18
1714376772121,SIOC 290S,A01,637330,Merrifield; Mark A,27,0,30,3
1714376773147,SIOC 291S,A01,637333,Gabriel; Corey John,27,0,30,3
1714376774174,SOCI 117,A01,494376,Staff,0,4,5,5
1714376775201,WES 237B,A00,494380,Staff,9,0,20,11
1714376777270,AESE 279B,A00,494370,Wade; Jon P,0,0,33,33
1714376778299,AIP 197,001,627712,Vespa; Emanuel Ignacio,9998,0,9999,1
1714376779325,ANAR 135S,A00,494369,Braswell; Geoffrey E.,0,0,0,0
1714376780350,BENG 196,001,628496,Engler; Adam J.,9998,0,9999,1
1714376781378,CAT 124RS,A01,519847,Geibel; William,0,0,20,20
1714376782406,CAT 125RS,A01,515971,Geibel; William,0,0,20,20
1714376783436,CLRE 250,A00,511389,Morris; Sheldon,9993,0,9999,6
1714376784467,CLRE 251,A00,507176,Mehta; Ravindra L.,9993,0,9999,6
1714376784467,CLRE 251,B00,511410,Mehta; Ravindra L.,9998,0,9999,1
1714376785496,CLRE 252,A00,507189,Cuomo; Raphael Eduardo,9995,0,9999,4
1714376786528,CLRE 253,A00,507199,Vaida; Florin,9994,0,9999,5
1714376786528,CLRE 253,B00,507202,Vaida; Florin,9999,0,9999,0
1714376787558,CLRE 259,A00,507211,Patel; Hemal,9996,0,9999,3
1714376788583,CLRE 260,A00,507221,Cuomo; Raphael Eduardo,9999,0,9999,0
1714376789609,CLRE 297,001,507242,Cuomo; Raphael Eduardo,9999,0,9999,0
1714376790635,COGS 197,001,638244,Voytek; Bradley Thomas,9999,0,9999,0
1714376791665,CSE 191,A00,516875,Minnes Kemp; Mor Mia,9993,0,9999,6
1714376792693,CSE 197,001,637388,Minnes Kemp; Mor Mia,9998,0,9999,1
1714376793724,CSS 201S,A01,494383,Staff,35,0,35,0
1714376794751,CSS 202S,A01,494387,Staff,35,0,35,0
1714376795779,DSC 197,001,628532,Eldridge; Justin Matthew,9996,0,9999,3
1714376796806,EAP 100,A00,516065,Staff,9797,0,9999,202
1714376797832,ECE 45,A01,507414,Staff,33,0,60,27
1714376799890,ECE 111,A01,507420,Staff,19,0,50,31
1714376800918,ECE 197,001,548057,Sievenpiper; Daniel F.,9994,0,9999,5
1714376801945,EDS 115,A00,507243,Choi; Bailey Miyeon,12,0,28,16
1714376802975,EDS 117,A01,494379,Staff,0,2,30,30
1714376804002,EDS 125,A00,507246,Hopkins; Megan Beth,12,0,30,18
1714376805027,EDS 128A,A01,507264,Fargason; Sharon Gayle,14,0,26,12
1714376806055,EDS 128B,A01,507293,Pappas; Elizabeth,18,0,30,12
1714376807081,EDS 139,A00,507294,Fargason; Sharon Gayle,18,0,30,12
1714376807081,EDS 139,B00,507313,Pappas; Elizabeth,15,0,30,15
1714376808109,EDS 201,A00,507315,Staff,13,0,30,17
1714376809133,EDS 203,A01,507317,Halter; Christopher P.,12,0,30,18
1714376810157,EDS 204R,A01,507319,Halter; Christopher P.,0,3,30,30
1714376810157,EDS 204R,B01,507331,Heinzman; Erica M.,17,0,30,13
1714376811183,EDS 206R,A00,507332,Staff,0,4,30,30
1714376811183,EDS 206R,B00,507343,Staff,18,0,30,12
1714376812213,EDS 250,A00,507344,Hemans; Patricia Ann Benitez,22,0,40,18
1714376813239,EDS 281,A00,507345,Daly; Alan J.,18,0,18,0
1714376814263,EDS 284,A00,507350,Daly; Alan J.,16,0,16,0
1714376815288,EDS 286,A00,507359,Fine; Sarah,18,0,18,0
1714376816313,EDS 289C,A01,507361,Daly; Alan J.,18,0,18,0
1714376817339,EDS 290,A00,507366,Hofstetter; Carolyn,15,0,15,0
1714376818368,LIGM 5A,A00,507421,Fischer-Grunski; Eva K,18,0,20,2
1714376819396,LIGM 5B,A00,507423,Fischer-Grunski; Eva K,19,0,20,1
1714376820422,LIGM 5C,A00,507425,Fischer-Grunski; Eva K,19,0,20,1
1714376821448,LIIT 5AS,A00,507427,Carnelos; Chiara,20,0,20,0
1714376822476,LIIT 5BS,A00,507430,Carnelos; Chiara,20,0,20,0
1714376823501,LIIT 5CS,A00,507432,Carnelos; Chiara,20,0,20,0
1714376824526,LISP 5A,A00,507541,Munoz Sanchez; Alicia,11,0,20,9
1714376825555,LISP 5B,A00,507671,Munoz Sanchez; Alicia,9,0,20,11
1714376826581,LISP 5C,A00,507696,Munoz Sanchez; Alicia,9,0,20,11
1714376827610,MAE 197,001,528363,Boechler; Nicholas Sebastia,9998,0,9999,1
1714376828638,MATH 197,001,523477,Kedlaya; Kiran S.,9996,0,9999,3
1714376828638,MATH 197,002,563811,Zhang; Danna,9995,0,9999,4
1714376828638,MATH 197,003,628552,Dumitriu; Ioana,9998,0,9999,1
1714376829665,MCWP 40R,A00,518780,Staff,5,0,20,15
1714376829665,MCWP 40R,B00,518781,Staff,7,0,20,13
1714376829665,MCWP 40R,C00,518783,Staff,5,0,20,15
1714376830693,MCWP 50R,A00,518791,Staff,0,0,20,20
1714376830693,MCWP 50R,B00,518792,Staff,0,1,20,20
1714376830693,MCWP 50R,C00,518793,Staff,0,1,20,20
1714376830693,MCWP 50R,D00,518794,Staff,0,0,20,20
1714376830693,MCWP 50R,E00,518795,Staff,0,1,20,20
1714376830693,MCWP 50R,F00,518796,Staff,0,0,20,20
1714376830693,MCWP 50R,G00,518797,Staff,0,1,20,20
1714376831719,MMW 12R,A01,514034,Herbst; Matthew,0,1,16,16
1714376831719,MMW 12R,A02,514035,Herbst; Matthew,2,0,16,14
1714376832747,MMW 13R,A01,514037,Staff,0,4,16,16
1714376832747,MMW 13R,A02,514039,Staff,0,2,16,16
1714376832747,MMW 13R,A03,628519,Staff,0,2,16,16
1714376834800,SIO 295LS,A00,523233,Staff,12,0,30,18
1714376835826,SIO 295S,A00,523232,Staff,12,0,30,18
1714376836857,SIOC 290S,A01,637330,Merrifield; Mark A,27,0,30,3
1714376837887,SIOC 291S,A01,637333,Gabriel; Corey John,27,0,30,3
1714376838912,SOCI 117,A01,494376,Staff,0,4,5,5
1714376839942,WES 237B,A00,494380,Staff,9,0,20,11
1714376842014,AESE 279B,A00,494370,Wade; Jon P,0,0,33,33
1714376843039,AIP 197,001,627712,Vespa; Emanuel Ignacio,9998,0,9999,1
1714376844068,ANAR 135S,A00,494369,Braswell; Geoffrey E.,0,0,0,0
1714376845094,BENG 196,001,628496,Engler; Adam J.,9998,0,9999,1
1714376846174,CAT 124RS,A01,519847,Geibel; William,0,0,20,20
1714376847201,CAT 125RS,A01,515971,Geibel; William,0,0,20,20
1714376848232,CLRE 250,A00,511389,Morris; Sheldon,9993,0,9999,6
1714376849258,CLRE 251,A00,507176,Mehta; Ravindra L.,9993,0,9999,6
1714376849258,CLRE 251,B00,511410,Mehta; Ravindra L.,9998,0,9999,1
1714376850285,CLRE 252,A00,507189,Cuomo; Raphael Eduardo,9995,0,9999,4
1714376851315,CLRE 253,A00,507199,Vaida; Florin,9994,0,9999,5
1714376851315,CLRE 253,B00,507202,Vaida; Florin,9999,0,9999,0
1714376852343,CLRE 259,A00,507211,Patel; Hemal,9996,0,9999,3
1714376853368,CLRE 260,A00,507221,Cuomo; Raphael Eduardo,9999,0,9999,0
1714376854398,CLRE 297,001,507242,Cuomo; Raphael Eduardo,9999,0,9999,0
1714376855424,COGS 197,001,638244,Voytek; Bradley Thomas,9999,0,9999,0
1714376856449,CSE 191,A00,516875,Minnes Kemp; Mor Mia,9993,0,9999,6
1714376857476,CSE 197,001,637388,Minnes Kemp; Mor Mia,9998,0,9999,1
1714376858502,CSS 201S,A01,494383,Staff,35,0,35,0
1714376859529,CSS 202S,A01,494387,Staff,35,0,35,0
1714376860557,DSC 197,001,628532,Eldridge; Justin Matthew,9996,0,9999,3
1714376861582,EAP 100,A00,516065,Staff,9797,0,9999,202
1714376862612,ECE 45,A01,507414,Staff,33,0,60,27
1714376864666,ECE 111,A01,507420,Staff,19,0,50,31
1714376865692,ECE 197,001,548057,Sievenpiper; Daniel F.,9994,0,9999,5
1714376866725,EDS 115,A00,507243,Choi; Bailey Miyeon,12,0,28,16
1714376867756,EDS 117,A01,494379,Staff,0,2,30,30
1714376868781,EDS 125,A00,507246,Hopkins; Megan Beth,12,0,30,18
1714376869811,EDS 128A,A01,507264,Fargason; Sharon Gayle,14,0,26,12
1714376870837,EDS 128B,A01,507293,Pappas; Elizabeth,18,0,30,12
1714376871865,EDS 139,A00,507294,Fargason; Sharon Gayle,18,0,30,12
1714376871865,EDS 139,B00,507313,Pappas; Elizabeth,15,0,30,15
1714376872889,EDS 201,A00,507315,Staff,13,0,30,17
1714376873918,EDS 203,A01,507317,Halter; Christopher P.,12,0,30,18
1714376874943,EDS 204R,A01,507319,Halter; Christopher P.,0,3,30,30
1714376874943,EDS 204R,B01,507331,Heinzman; Erica M.,17,0,30,13
1714376875969,EDS 206R,A00,507332,Staff,0,4,30,30
1714376875969,EDS 206R,B00,507343,Staff,18,0,30,12
1714376876997,EDS 250,A00,507344,Hemans; Patricia Ann Benitez,22,0,40,18
1714376878022,EDS 281,A00,507345,Daly; Alan J.,18,0,18,0
1714376879051,EDS 284,A00,507350,Daly; Alan J.,16,0,16,0
1714376880075,EDS 286,A00,507359,Fine; Sarah,18,0,18,0
1714376881103,EDS 289C,A01,507361,Daly; Alan J.,18,0,18,0
1714376882128,EDS 290,A00,507366,Hofstetter; Carolyn,15,0,15,0
1714376883157,LIGM 5A,A00,507421,Fischer-Grunski; Eva K,18,0,20,2
1714376884186,LIGM 5B,A00,507423,Fischer-Grunski; Eva K,19,0,20,1
1714376885214,LIGM 5C,A00,507425,Fischer-Grunski; Eva K,19,0,20,1
1714376886243,LIIT 5AS,A00,507427,Carnelos; Chiara,20,0,20,0
1714376887273,LIIT 5BS,A00,507430,Carnelos; Chiara,20,0,20,0
1714376888303,LIIT 5CS,A00,507432,Carnelos; Chiara,20,0,20,0
1714376889334,LISP 5A,A00,507541,Munoz Sanchez; Alicia,11,0,20,9
1714376890363,LISP 5B,A00,507671,Munoz Sanchez; Alicia,9,0,20,11
1714376891388,LISP 5C,A00,507696,Munoz Sanchez; Alicia,9,0,20,11
1714376892415,MAE 197,001,528363,Boechler; Nicholas Sebastia,9998,0,9999,1
1714376893445,MATH 197,001,523477,Kedlaya; Kiran S.,9996,0,9999,3
1714376893445,MATH 197,002,563811,Zhang; Danna,9995,0,9999,4
1714376893445,MATH 197,003,628552,Dumitriu; Ioana,9998,0,9999,1
1714376894474,MCWP 40R,A00,518780,Staff,5,0,20,15
1714376894474,MCWP 40R,B00,518781,Staff,7,0,20,13
1714376894474,MCWP 40R,C00,518783,Staff,5,0,20,15
1714376895500,MCWP 50R,A00,518791,Staff,0,0,20,20
1714376895500,MCWP 50R,B00,518792,Staff,0,1,20,20
1714376895500,MCWP 50R,C00,518793,Staff,0,1,20,20
1714376895500,MCWP 50R,D00,518794,Staff,0,0,20,20
1714376895500,MCWP 50R,E00,518795,Staff,0,1,20,20
1714376895500,MCWP 50R,F00,518796,Staff,0,0,20,20
1714376895500,MCWP 50R,G00,518797,Staff,0,1,20,20
1714376896529,MMW 12R,A01,514034,Herbst; Matthew,0,1,16,16
1714376896529,MMW 12R,A02,514035,Herbst; Matthew,2,0,16,14
1714376897554,MMW 13R,A01,514037,Staff,0,4,16,16
1714376897554,MMW 13R,A02,514039,Staff,0,2,16,16
1714376897554,MMW 13R,A03,628519,Staff,0,2,16,16
1714376899608,SIO 295LS,A00,523233,Staff,12,0,30,18
1714376900635,SIO 295S,A00,523232,Staff,12,0,30,18
1714376901661,SIOC 290S,A01,637330,Merrifield; Mark A,27,0,30,3
1714376902691,SIOC 291S,A01,637333,Gabriel; Corey John,27,0,30,3
1714376903717,SOCI 117,A01,494376,Staff,0,4,5,5
1714376904749,WES 237B,A00,494380,Staff,9,0,20,11
1714376907251,AESE 279B,A00,494370,Wade; Jon P,0,0,33,33
1714376908283,AIP 197,001,627712,Vespa; Emanuel Ignacio,9998,0,9999,1
1714376909309,ANAR 135S,A00,494369,Braswell; Geoffrey E.,0,0,0,0
1714376910338,BENG 196,001,628496,Engler; Adam J.,9998,0,9999,1
1714376911367,CAT 124RS,A01,519847,Geibel; William,0,0,20,20
1714376912395,CAT 125RS,A01,515971,Geibel; William,0,0,20,20
1714376913426,CLRE 250,A00,511389,Morris; Sheldon,9993,0,9999,6
1714376914460,CLRE 251,A00,507176,Mehta; Ravindra L.,9993,0,9999,6
1714376914460,CLRE 251,B00,511410,Mehta; Ravindra L.,9998,0,9999,1
1714376915489,CLRE 252,A00,507189,Cuomo; Raphael Eduardo,9995,0,9999,4
1714376916517,CLRE 253,A00,507199,Vaida; Florin,9994,0,9999,5
1714376916517,CLRE 253,B00,507202,Vaida; Florin,9999,0,9999,0
1714376917540,CLRE 259,A00,507211,Patel; Hemal,9996,0,9999,3
1714376918567,CLRE 260,A00,507221,Cuomo; Raphael Eduardo,9999,0,9999,0
1714376919593,CLRE 297,001,507242,Cuomo; Raphael Eduardo,9999,0,9999,0
1714376920620,COGS 197,001,638244,Voytek; Bradley Thomas,9999,0,9999,0
1714376921647,CSE 191,A00,516875,Minnes Kemp; Mor Mia,9993,0,9999,6
1714376922673,CSE 197,001,637388,Minnes Kemp; Mor Mia,9998,0,9999,1
1714376923702,CSS 201S,A01,494383,Staff,35,0,35,0
1714376924727,CSS 202S,A01,494387,Staff,35,0,35,0
1714376925754,DSC 197,001,628532,Eldridge; Justin Matthew,9996,0,9999,3
1714376926784,EAP 100,A00,516065,Staff,9797,0,9999,202
1714376927811,ECE 45,A01,507414,Staff,33,0,60,27
1714376929865,ECE 111,A01,507420,Staff,19,0,50,31
1714376930894,ECE 197,001,548057,Sievenpiper; Daniel F.,9994,0,9999,5
1714376931923,EDS 115,A00,507243,Choi; Bailey Miyeon,12,0,28,16
1714376932950,EDS 117,A01,494379,Staff,0,2,30,30
1714376933980,EDS 125,A00,507246,Hopkins; Megan Beth,12,0,30,18
1714376935004,EDS 128A,A01,507264,Fargason; Sharon Gayle,14,0,26,12
1714376936029,EDS 128B,A01,507293,Pappas; Elizabeth,18,0,30,12
1714376937058,EDS 139,A00,507294,Fargason; Sharon Gayle,18,0,30,12
1714376937058,EDS 139,B00,507313,Pappas; Elizabeth,15,0,30,15
1714376938084,EDS 201,A00,507315,Staff,13,0,30,17
1714376939111,EDS 203,A01,507317,Halter; Christopher P.,12,0,30,18
1714376940136,EDS 204R,A01,507319,Halter; Christopher P.,0,3,30,30
1714376940136,EDS 204R,B01,507331,Heinzman; Erica M.,17,0,30,13
1714376941164,EDS 206R,A00,507332,Staff,0,4,30,30
1714376941164,EDS 206R,B00,507343,Staff,18,0,30,12
1714376942194,EDS 250,A00,507344,Hemans; Patricia Ann Benitez,22,0,40,18
1714376943219,EDS 281,A00,507345,Daly; Alan J.,18,0,18,0
1714376944247,EDS 284,A00,507350,Daly; Alan J.,16,0,16,0
1714376945273,EDS 286,A00,507359,Fine; Sarah,18,0,18,0
1714376946304,EDS 289C,A01,507361,Daly; Alan J.,18,0,18,0
1714376947330,EDS 290,A00,507366,Hofstetter; Carolyn,15,0,15,0
1714376948359,LIGM 5A,A00,507421,Fischer-Grunski; Eva K,18,0,20,2
1714376949388,LIGM 5B,A00,507423,Fischer-Grunski; Eva K,19,0,20,1
1714376950466,LIGM 5C,A00,507425,Fischer-Grunski; Eva K,19,0,20,1
1714376951495,LIIT 5AS,A00,507427,Carnelos; Chiara,20,0,20,0
1714376952524,LIIT 5BS,A00,507430,Carnelos; Chiara,20,0,20,0
1714376953552,LIIT 5CS,A00,507432,Carnelos; Chiara,20,0,20,0
1714376954583,LISP 5A,A00,507541,Munoz Sanchez; Alicia,11,0,20,9
1714376955609,LISP 5B,A00,507671,Munoz Sanchez; Alicia,9,0,20,11
1714376956634,LISP 5C,A00,507696,Munoz Sanchez; Alicia,9,0,20,11
1714376957660,MAE 197,001,528363,Boechler; Nicholas Sebastia,9998,0,9999,1
1714376958686,MATH 197,001,523477,Kedlaya; Kiran S.,9996,0,9999,3
1714376958686,MATH 197,002,563811,Zhang; Danna,9995,0,9999,4
1714376958686,MATH 197,003,628552,Dumitriu; Ioana,9998,0,9999,1
1714376959717,MCWP 40R,A00,518780,Staff,5,0,20,15
1714376959717,MCWP 40R,B00,518781,Staff,7,0,20,13
1714376959717,MCWP 40R,C00,518783,Staff,5,0,20,15
1714376960746,MCWP 50R,A00,518791,Staff,0,0,20,20
1714376960746,MCWP 50R,B00,518792,Staff,0,1,20,20
1714376960746,MCWP 50R,C00,518793,Staff,0,1,20,20
1714376960746,MCWP 50R,D00,518794,Staff,0,0,20,20
1714376960746,MCWP 50R,E00,518795,Staff,0,1,20,20
1714376960746,MCWP 50R,F00,518796,Staff,0,0,20,20
1714376960746,MCWP 50R,G00,518797,Staff,0,1,20,20
1714376961771,MMW 12R,A01,514034,Herbst; Matthew,0,1,16,16
1714376961771,MMW 12R,A02,514035,Herbst; Matthew,2,0,16,14
1714376962798,MMW 13R,A01,514037,Staff,0,4,16,16
1714376962798,MMW 13R,A02,514039,Staff,0,2,16,16
1714376962798,MMW 13R,A03,628519,Staff,0,2,16,16
1714376964848,SIO 295LS,A00,523233,Staff,12,0,30,18
1714376965875,SIO 295S,A00,523232,Staff,12,0,30,18
1714376966905,SIOC 290S,A01,637330,Merrifield; Mark A,27,0,30,3
1714376967930,SIOC 291S,A01,637333,Gabriel; Corey John,27,0,30,3
1714376968959,SOCI 117,A01,494376,Staff,0,4,5,5
1714376969985,WES 237B,A00,494380,Staff,9,0,20,11
1714376972041,AESE 279B,A00,494370,Wade; Jon P,0,0,33,33
1714376973069,AIP 197,001,627712,Vespa; Emanuel Ignacio,9998,0,9999,1
1714376974096,ANAR 135S,A00,494369,Braswell; Geoffrey E.,0,0,0,0
1714376975123,BENG 196,001,628496,Engler; Adam J.,9998,0,9999,1
1714376976152,CAT 124RS,A01,519847,Geibel; William,0,0,20,20
1714376977178,CAT 125RS,A01,515971,Geibel; William,0,0,20,20
1714376978206,CLRE 250,A00,511389,Morris; Sheldon,9993,0,9999,6
1714376979234,CLRE 251,A00,507176,Mehta; Ravindra L.,9993,0,9999,6
1714376979234,CLRE 251,B00,511410,Mehta; Ravindra L.,9998,0,9999,1
1714376980266,CLRE 252,A00,507189,Cuomo; Raphael Eduardo,9995,0,9999,4
1714376981299,CLRE 253,A00,507199,Vaida; Florin,9994,0,9999,5
1714376981299,CLRE 253,B00,507202,Vaida; Florin,9999,0,9999,0
1714376982328,CLRE 259,A00,507211,Patel; Hemal,9996,0,9999,3
1714376983356,CLRE 260,A00,507221,Cuomo; Raphael Eduardo,9999,0,9999,0
1714376984385,CLRE 297,001,507242,Cuomo; Raphael Eduardo,9999,0,9999,0
1714376985412,COGS 197,001,638244,Voytek; Bradley Thomas,9999,0,9999,0
1714376986439,CSE 191,A00,516875,Minnes Kemp; Mor Mia,9993,0,9999,6
1714376987465,CSE 197,001,637388,Minnes Kemp; Mor Mia,9998,0,9999,1
1714376988490,CSS 201S,A01,494383,Staff,35,0,35,0
1714376989517,CSS 202S,A01,494387,Staff,35,0,35,0
1714376990549,DSC 197,001,628532,Eldridge; Justin Matthew,9996,0,9999,3
1714376991575,EAP 100,A00,516065,Staff,9797,0,9999,202
1714376992602,ECE 45,A01,507414,Staff,33,0,60,27
1714376994651,ECE 111,A01,507420,Staff,19,0,50,31
1714376995679,ECE 197,001,548057,Sievenpiper; Daniel F.,9994,0,9999,5
1714376996708,EDS 115,A00,507243,Choi; Bailey Miyeon,12,0,28,16
1714376997732,EDS 117,A01,494379,Staff,0,2,30,30
1714376998760,EDS 125,A00,507246,Hopkins; Megan Beth,12,0,30,18
1714376999786,EDS 128A,A01,507264,Fargason; Sharon Gayle,14,0,26,12
1714377000817,EDS 128B,A01,507293,Pappas; Elizabeth,18,0,30,12
1714377001846,EDS 139,A00,507294,Fargason; Sharon Gayle,18,0,30,12
1714377001846,EDS 139,B00,507313,Pappas; Elizabeth,15,0,30,15
1714377002870,EDS 201,A00,507315,Staff,13,0,30,17
1714377003904,EDS 203,A01,507317,Halter; Christopher P.,12,0,30,18
1714377004930,EDS 204R,A01,507319,Halter; Christopher P.,0,3,30,30
1714377004930,EDS 204R,B01,507331,Heinzman; Erica M.,17,0,30,13
1714377005959,EDS 206R,A00,507332,Staff,0,4,30,30
1714377005959,EDS 206R,B00,507343,Staff,18,0,30,12
1714377006984,EDS 250,A00,507344,Hemans; Patricia Ann Benitez,22,0,40,18
1714377008009,EDS 281,A00,507345,Daly; Alan J.,18,0,18,0
1714377009038,EDS 284,A00,507350,Daly; Alan J.,16,0,16,0
1714377010063,EDS 286,A00,507359,Fine; Sarah,18,0,18,0
1714377011090,EDS 289C,A01,507361,Daly; Alan J.,18,0,18,0
1714377012116,EDS 290,A00,507366,Hofstetter; Carolyn,15,0,15,0
1714377013148,LIGM 5A,A00,507421,Fischer-Grunski; Eva K,18,0,20,2
1714377014173,LIGM 5B,A00,507423,Fischer-Grunski; Eva K,19,0,20,1
1714377015199,LIGM 5C,A00,507425,Fischer-Grunski; Eva K,19,0,20,1
1714377016229,LIIT 5AS,A00,507427,Carnelos; Chiara,20,0,20,0
1714377017259,LIIT 5BS,A00,507430,Carnelos; Chiara,20,0,20,0
1714377018285,LIIT 5CS,A00,507432,Carnelos; Chiara,20,0,20,0
1714377019312,LISP 5A,A00,507541,Munoz Sanchez; Alicia,11,0,20,9
1714377020339,LISP 5B,A00,507671,Munoz Sanchez; Alicia,9,0,20,11
1714377021371,LISP 5C,A00,507696,Munoz Sanchez; Alicia,9,0,20,11
1714377022397,MAE 197,001,528363,Boechler; Nicholas Sebastia,9998,0,9999,1
1714377023426,MATH 197,001,523477,Kedlaya; Kiran S.,9996,0,9999,3
1714377023426,MATH 197,002,563811,Zhang; Danna,9995,0,9999,4
1714377023426,MATH 197,003,628552,Dumitriu; Ioana,9998,0,9999,1
1714377024452,MCWP 40R,A00,518780,Staff,5,0,20,15
1714377024452,MCWP 40R,B00,518781,Staff,7,0,20,13
1714377024452,MCWP 40R,C00,518783,Staff,5,0,20,15
1714377025480,MCWP 50R,A00,518791,Staff,0,0,20,20
1714377025480,MCWP 50R,B00,518792,Staff,0,1,20,20
1714377025480,MCWP 50R,C00,518793,Staff,0,1,20,20
1714377025480,MCWP 50R,D00,518794,Staff,0,0,20,20
1714377025480,MCWP 50R,E00,518795,Staff,0,1,20,20
1714377025480,MCWP 50R,F00,518796,Staff,0,0,20,20
1714377025480,MCWP 50R,G00,518797,Staff,0,1,20,20
1714377026505,MMW 12R,A01,514034,Herbst; Matthew,0,1,16,16
1714377026505,MMW 12R,A02,514035,Herbst; Matthew,2,0,16,14
1714377027530,MMW 13R,A01,514037,Staff,0,4,16,16
1714377027530,MMW 13R,A02,514039,Staff,0,2,16,16
1714377027530,MMW 13R,A03,628519,Staff,0,2,16,16
1714377029584,SIO 295LS,A00,523233,Staff,12,0,30,18
1714377030609,SIO 295S,A00,523232,Staff,12,0,30,18
1714377031637,SIOC 290S,A01,637330,Merrifield; Mark A,27,0,30,3
1714377032670,SIOC 291S,A01,637333,Gabriel; Corey John,27,0,30,3
1714377033699,SOCI 117,A01,494376,Staff,0,4,5,5
1714377034726,WES 237B,A00,494380,Staff,9,0,20,11
1714377036798,AESE 279B,A00,494370,Wade; Jon P,0,0,33,33
1714377037822,AIP 197,001,627712,Vespa; Emanuel Ignacio,9998,0,9999,1
1714377038848,ANAR 135S,A00,494369,Braswell; Geoffrey E.,0,0,0,0
1714377039874,BENG 196,001,628496,Engler; Adam J.,9998,0,9999,1
1714377040900,CAT 124RS,A01,519847,Geibel; William,0,0,20,20
1714377041926,CAT 125RS,A01,515971,Geibel; William,0,0,20,20
1714377042953,CLRE 250,A00,511389,Morris; Sheldon,9993,0,9999,6
1714377043989,CLRE 251,A00,507176,Mehta; Ravindra L.,9993,0,9999,6
1714377043989,CLRE 251,B00,511410,Mehta; Ravindra L.,9998,0,9999,1
1714377045019,CLRE 252,A00,507189,Cuomo; Raphael Eduardo,9995,0,9999,4
1714377046045,CLRE 253,A00,507199,Vaida; Florin,9994,0,9999,5
1714377046045,CLRE 253,B00,507202,Vaida; Florin,9999,0,9999,0
1714377047074,CLRE 259,A00,507211,Patel; Hemal,9996,0,9999,3
1714377048100,CLRE 260,A00,507221,Cuomo; Raphael Eduardo,9999,0,9999,0
1714377049127,CLRE 297,001,507242,Cuomo; Raphael Eduardo,9999,0,9999,0
1714377050154,COGS 197,001,638244,Voytek; Bradley Thomas,9999,0,9999,0
1714377051180,CSE 191,A00,516875,Minnes Kemp; Mor Mia,9993,0,9999,6
1714377052206,CSE 197,001,637388,Minnes Kemp; Mor Mia,9998,0,9999,1
1714377053233,CSS 201S,A01,494383,Staff,35,0,35,0
1714377054313,CSS 202S,A01,494387,Staff,35,0,35,0
1714377055338,DSC 197,001,628532,Eldridge; Justin Matthew,9996,0,9999,3
1714377056363,EAP 100,A00,516065,Staff,9797,0,9999,202
1714377057393,ECE 45,A01,507414,Staff,33,0,60,27
1714377059445,ECE 111,A01,507420,Staff,19,0,50,31
1714377060474,ECE 197,001,548057,Sievenpiper; Daniel F.,9994,0,9999,5
1714377061500,EDS 115,A00,507243,Choi; Bailey Miyeon,12,0,28,16
1714377062526,EDS 117,A01,494379,Staff,0,2,30,30
1714377063556,EDS 125,A00,507246,Hopkins; Megan Beth,12,0,30,18
1714377064585,EDS 128A,A01,507264,Fargason; Sharon Gayle,14,0,26,12
1714377065610,EDS 128B,A01,507293,Pappas; Elizabeth,18,0,30,12
1714377066636,EDS 139,A00,507294,Fargason; Sharon Gayle,18,0,30,12
1714377066636,EDS 139,B00,507313,Pappas; Elizabeth,15,0,30,15
1714377067662,EDS 201,A00,507315,Staff,13,0,30,17
1714377068694,EDS 203,A01,507317,Halter; Christopher P.,12,0,30,18
1714377069721,EDS 204R,A01,507319,Halter; Christopher P.,0,3,30,30
1714377069721,EDS 204R,B01,507331,Heinzman; Erica M.,17,0,30,13
1714377070750,EDS 206R,A00,507332,Staff,0,4,30,30
1714377070750,EDS 206R,B00,507343,Staff,18,0,30,12
1714377071776,EDS 250,A00,507344,Hemans; Patricia Ann Benitez,22,0,40,18
1714377072802,EDS 281,A00,507345,Daly; Alan J.,18,0,18,0
1714377073828,EDS 284,A00,507350,Daly; Alan J.,16,0,16,0
1714377074853,EDS 286,A00,507359,Fine; Sarah,18,0,18,0
1714377075883,EDS 289C,A01,507361,Daly; Alan J.,18,0,18,0
1714377076909,EDS 290,A00,507366,Hofstetter; Carolyn,15,0,15,0
1714377077936,LIGM 5A,A00,507421,Fischer-Grunski; Eva K,18,0,20,2
1714377078962,LIGM 5B,A00,507423,Fischer-Grunski; Eva K,19,0,20,1
1714377079987,LIGM 5C,A00,507425,Fischer-Grunski; Eva K,19,0,20,1
1714377081014,LIIT 5AS,A00,507427,Carnelos; Chiara,20,0,20,0
1714377082043,LIIT 5BS,A00,507430,Carnelos; Chiara,20,0,20,0
1714377083069,LIIT 5CS,A00,507432,Carnelos; Chiara,20,0,20,0
1714377084094,LISP 5A,A00,507541,Munoz Sanchez; Alicia,11,0,20,9
1714377085119,LISP 5B,A00,507671,Munoz Sanchez; Alicia,9,0,20,11
1714377086144,LISP 5C,A00,507696,Munoz Sanchez; Alicia,9,0,20,11
1714377087173,MAE 197,001,528363,Boechler; Nicholas Sebastia,9998,0,9999,1
1714377088201,MATH 197,001,523477,Kedlaya; Kiran S.,9996,0,9999,3
1714377088201,MATH 197,002,563811,Zhang; Danna,9995,0,9999,4
1714377088201,MATH 197,003,628552,Dumitriu; Ioana,9998,0,9999,1
1714377089231,MCWP 40R,A00,518780,Staff,5,0,20,15
1714377089231,MCWP 40R,B00,518781,Staff,7,0,20,13
1714377089231,MCWP 40R,C00,518783,Staff,5,0,20,15
1714377090257,MCWP 50R,A00,518791,Staff,0,0,20,20
1714377090257,MCWP 50R,B00,518792,Staff,0,1,20,20
1714377090257,MCWP 50R,C00,518793,Staff,0,1,20,20
1714377090257,MCWP 50R,D00,518794,Staff,0,0,20,20
1714377090257,MCWP 50R,E00,518795,Staff,0,1,20,20
1714377090257,MCWP 50R,F00,518796,Staff,0,0,20,20
1714377090257,MCWP 50R,G00,518797,Staff,0,1,20,20
1714377091286,MMW 12R,A01,514034,Herbst; Matthew,0,1,16,16
1714377091286,MMW 12R,A02,514035,Herbst; Matthew,2,0,16,14
1714377092315,MMW 13R,A01,514037,Staff,0,4,16,16
1714377092315,MMW 13R,A02,514039,Staff,0,2,16,16
1714377092315,MMW 13R,A03,628519,Staff,0,2,16,16
1714377094366,SIO 295LS,A00,523233,Staff,12,0,30,18
1714377095395,SIO 295S,A00,523232,Staff,12,0,30,18
1714377096425,SIOC 290S,A01,637330,Merrifield; Mark A,27,0,30,3
1714377097451,SIOC 291S,A01,637333,Gabriel; Corey John,27,0,30,3
1714377098481,SOCI 117,A01,494376,Staff,0,4,5,5
1714377099512,WES 237B,A00,494380,Staff,9,0,20,11
1714377101591,AESE 279B,A00,494370,Wade; Jon P,0,0,33,33
1714377102621,AIP 197,001,627712,Vespa; Emanuel Ignacio,9998,0,9999,1
1714377103645,ANAR 135S,A00,494369,Braswell; Geoffrey E.,0,0,0,0
1714377104673,BENG 196,001,628496,Engler; Adam J.,9998,0,9999,1
1714377105699,CAT 124RS,A01,519847,Geibel; William,0,0,20,20
1714377106723,CAT 125RS,A01,515971,Geibel; William,0,0,20,20
1714377107750,CLRE 250,A00,511389,Morris; Sheldon,9993,0,9999,6
1714377108778,CLRE 251,A00,507176,Mehta; Ravindra L.,9993,0,9999,6
1714377108778,CLRE 251,B00,511410,Mehta; Ravindra L.,9998,0,9999,1
1714377109805,CLRE 252,A00,507189,Cuomo; Raphael Eduardo,9995,0,9999,4
1714377110830,CLRE 253,A00,507199,Vaida; Florin,9994,0,9999,5
1714377110830,CLRE 253,B00,507202,Vaida; Florin,9999,0,9999,0
1714377111858,CLRE 259,A00,507211,Patel; Hemal,9996,0,9999,3
1714377112884,CLRE 260,A00,507221,Cuomo; Raphael Eduardo,9999,0,9999,0
1714377113916,CLRE 297,001,507242,Cuomo; Raphael Eduardo,9999,0,9999,0
1714377114945,COGS 197,001,638244,Voytek; Bradley Thomas,9999,0,9999,0
1714377115969,CSE 191,A00,516875,Minnes Kemp; Mor Mia,9993,0,9999,6
1714377116994,CSE 197,001,637388,Minnes Kemp; Mor Mia,9998,0,9999,1
1714377118025,CSS 201S,A01,494383,Staff,35,0,35,0
1714377119053,CSS 202S,A01,494387,Staff,35,0,35,0
1714377120083,DSC 197,001,628532,Eldridge; Justin Matthew,9996,0,9999,3
1714377121110,EAP 100,A00,516065,Staff,9797,0,9999,202
1714377122141,ECE 45,A01,507414,Staff,33,0,60,27
1714377124221,ECE 111,A01,507420,Staff,19,0,50,31
1714377125245,ECE 197,001,548057,Sievenpiper; Daniel F.,9994,0,9999,5
1714377126269,EDS 115,A00,507243,Choi; Bailey Miyeon,12,0,28,16
1714377127294,EDS 117,A01,494379,Staff,0,2,30,30
1714377128320,EDS 125,A00,507246,Hopkins; Megan Beth,12,0,30,18
1714377129347,EDS 128A,A01,507264,Fargason; Sharon Gayle,14,0,26,12
1714377130374,EDS 128B,A01,507293,Pappas; Elizabeth,18,0,30,12
1714377131400,EDS 139,A00,507294,Fargason; Sharon Gayle,18,0,30,12
1714377131400,EDS 139,B00,507313,Pappas; Elizabeth,15,0,30,15
1714377132425,EDS 201,A00,507315,Staff,13,0,30,17
1714377133456,EDS 203,A01,507317,Halter; Christopher P.,12,0,30,18
1714377134483,EDS 204R,A01,507319,Halter; Christopher P.,0,3,30,30
1714377134483,EDS 204R,B01,507331,Heinzman; Erica M.,17,0,30,13
1714377135508,EDS 206R,A00,507332,Staff,0,4,30,30
1714377135508,EDS 206R,B00,507343,Staff,18,0,30,12
1714377136534,EDS 250,A00,507344,Hemans; Patricia Ann Benitez,22,0,40,18
1714377137560,EDS 281,A00,507345,Daly; Alan J.,18,0,18,0
1714377138587,EDS 284,A00,507350,Daly; Alan J.,16,0,16,0
1714377139613,EDS 286,A00,507359,Fine; Sarah,18,0,18,0
1714377140639,EDS 289C,A01,507361,Daly; Alan J.,18,0,18,0
1714377141665,EDS 290,A00,507366,Hofstetter; Carolyn,15,0,15,0
1714377142695,LIGM 5A,A00,507421,Fischer-Grunski; Eva K,18,0,20,2
1714377143724,LIGM 5B,A00,507423,Fischer-Grunski; Eva K,19,0,20,1
1714377144749,LIGM 5C,A00,507425,Fischer-Grunski; Eva K,19,0,20,1
1714377145779,LIIT 5AS,A00,507427,Carnelos; Chiara,20,0,20,0
1714377146808,LIIT 5BS,A00,507430,Carnelos; Chiara,20,0,20,0
1714377147837,LIIT 5CS,A00,507432,Carnelos; Chiara,20,0,20,0
1714377148864,LISP 5A,A00,507541,Munoz Sanchez; Alicia,11,0,20,9
1714377149894,LISP 5B,A00,507671,Munoz Sanchez; Alicia,9,0,20,11
1714377150921,LISP 5C,A00,507696,Munoz Sanchez; Alicia,9,0,20,11
1714377151946,MAE 197,001,528363,Boechler; Nicholas Sebastia,9998,0,9999,1
1714377152976,MATH 197,001,523477,Kedlaya; Kiran S.,9996,0,9999,3
1714377152976,MATH 197,002,563811,Zhang; Danna,9995,0,9999,4
1714377152976,MATH 197,003,628552,Dumitriu; Ioana,9998,0,9999,1
1714377154004,MCWP 40R,A00,518780,Staff,5,0,20,15
1714377154004,MCWP 40R,B00,518781,Staff,7,0,20,13
1714377154004,MCWP 40R,C00,518783,Staff,5,0,20,15
1714377155030,MCWP 50R,A00,518791,Staff,0,0,20,20
1714377155030,MCWP 50R,B00,518792,Staff,0,1,20,20
1714377155030,MCWP 50R,C00,518793,Staff,0,1,20,20
1714377155030,MCWP 50R,D00,518794,Staff,0,0,20,20
1714377155030,MCWP 50R,E00,518795,Staff,0,1,20,20
1714377155030,MCWP 50R,F00,518796,Staff,0,0,20,20
1714377155030,MCWP 50R,G00,518797,Staff,0,1,20,20
1714377156058,MMW 12R,A01,514034,Herbst; Matthew,0,1,16,16
1714377156058,MMW 12R,A02,514035,Herbst; Matthew,2,0,16,14
1714377157082,MMW 13R,A01,514037,Staff,0,4,16,16
1714377157082,MMW 13R,A02,514039,Staff,0,2,16,16
1714377157082,MMW 13R,A03,628519,Staff,0,2,16,16
1714377159190,SIO 295LS,A00,523233,Staff,12,0,30,18
1714377160219,SIO 295S,A00,523232,Staff,12,0,30,18
1714377161248,SIOC 290S,A01,637330,Merrifield; Mark A,27,0,30,3
1714377162279,SIOC 291S,A01,637333,Gabriel; Corey John,27,0,30,3
1714377163307,SOCI 117,A01,494376,Staff,0,4,5,5
1714377164333,WES 237B,A00,494380,Staff,9,0,20,11
1714377166393,AESE 279B,A00,494370,Wade; Jon P,0,0,33,33
1714377167419,AIP 197,001,627712,Vespa; Emanuel Ignacio,9998,0,9999,1
1714377168450,ANAR 135S,A00,494369,Braswell; Geoffrey E.,0,0,0,0
1714377169473,BENG 196,001,628496,Engler; Adam J.,9998,0,9999,1
1714377170498,CAT 124RS,A01,519847,Geibel; William,0,0,20,20
1714377171522,CAT 125RS,A01,515971,Geibel; William,0,0,20,20
1714377172547,CLRE 250,A00,511389,Morris; Sheldon,9993,0,9999,6
1714377173576,CLRE 251,A00,507176,Mehta; Ravindra L.,9993,0,9999,6
1714377173576,CLRE 251,B00,511410,Mehta; Ravindra L.,9998,0,9999,1
1714377174606,CLRE 252,A00,507189,Cuomo; Raphael Eduardo,9995,0,9999,4
1714377175631,CLRE 253,A00,507199,Vaida; Florin,9994,0,9999,5
1714377175631,CLRE 253,B00,507202,Vaida; Florin,9999,0,9999,0
1714377176664,CLRE 259,A00,507211,Patel; Hemal,9996,0,9999,3
1714377177691,CLRE 260,A00,507221,Cuomo; Raphael Eduardo,9999,0,9999,0
1714377178719,CLRE 297,001,507242,Cuomo; Raphael Eduardo,9999,0,9999,0
1714377179748,COGS 197,001,638244,Voytek; Bradley Thomas,9999,0,9999,0
1714377180774,CSE 191,A00,516875,Minnes Kemp; Mor Mia,9993,0,9999,6
1714377181803,CSE 197,001,637388,Minnes Kemp; Mor Mia,9998,0,9999,1
1714377182833,CSS 201S,A01,494383,Staff,35,0,35,0
1714377183859,CSS 202S,A01,494387,Staff,35,0,35,0
1714377184884,DSC 197,001,628532,Eldridge; Justin Matthew,9996,0,9999,3
1714377185910,EAP 100,A00,516065,Staff,9797,0,9999,202
1714377186937,ECE 45,A01,507414,Staff,33,0,60,27
1714377188993,ECE 111,A01,507420,Staff,19,0,50,31
1714377190019,ECE 197,001,548057,Sievenpiper; Daniel F.,9994,0,9999,5
1714377191046,EDS 115,A00,507243,Choi; Bailey Miyeon,12,0,28,16
1714377192072,EDS 117,A01,494379,Staff,0,2,30,30
1714377193099,EDS 125,A00,507246,Hopkins; Megan Beth,12,0,30,18
1714377194124,EDS 128A,A01,507264,Fargason; Sharon Gayle,14,0,26,12
1714377195152,EDS 128B,A01,507293,Pappas; Elizabeth,18,0,30,12
1714377196180,EDS 139,A00,507294,Fargason; Sharon Gayle,18,0,30,12
1714377196180,EDS 139,B00,507313,Pappas; Elizabeth,15,0,30,15
1714377197206,EDS 201,A00,507315,Staff,13,0,30,17
1714377198255,EDS 203,A01,507317,Halter; Christopher P.,12,0,30,18
1714377199283,EDS 204R,A01,507319,Halter; Christopher P.,0,3,30,30
1714377199283,EDS 204R,B01,507331,Heinzman; Erica M.,17,0,30,13
1714377200309,EDS 206R,A00,507332,Staff,0,4,30,30
1714377200309,EDS 206R,B00,507343,Staff,18,0,30,12
1714377201335,EDS 250,A00,507344,Hemans; Patricia Ann Benitez,22,0,40,18
1714377202360,EDS 281,A00,507345,Daly; Alan J.,18,0,18,0
1714377203389,EDS 284,A00,507350,Daly; Alan J.,16,0,16,0
1714377204413,EDS 286,A00,507359,Fine; Sarah,18,0,18,0
1714377205440,EDS 289C,A01,507361,Daly; Alan J.,18,0,18,0
1714377206464,EDS 290,A00,507366,Hofstetter; Carolyn,15,0,15,0
1714377207489,LIGM 5A,A00,507421,Fischer-Grunski; Eva K,18,0,20,2
1714377208513,LIGM 5B,A00,507423,Fischer-Grunski; Eva K,19,0,20,1
1714377209538,LIGM 5C,A00,507425,Fischer-Grunski; Eva K,19,0,20,1
1714377210563,LIIT 5AS,A00,507427,Carnelos; Chiara,20,0,20,0
1714377211589,LIIT 5BS,A00,507430,Carnelos; Chiara,20,0,20,0
1714377212620,LIIT 5CS,A00,507432,Carnelos; Chiara,20,0,20,0
1714377213649,LISP 5A,A00,507541,Munoz Sanchez; Alicia,11,0,20,9
1714377214674,LISP 5B,A00,507671,Munoz Sanchez; Alicia,9,0,20,11
1714377215701,LISP 5C,A00,507696,Munoz Sanchez; Alicia,9,0,20,11
1714377216727,MAE 197,001,528363,Boechler; Nicholas Sebastia,9998,0,9999,1
1714377217754,MATH 197,001,523477,Kedlaya; Kiran S.,9996,0,9999,3
1714377217754,MATH 197,002,563811,Zhang; Danna,9995,0,9999,4
1714377217754,MATH 197,003,628552,Dumitriu; Ioana,9998,0,9999,1
1714377218782,MCWP 40R,A00,518780,Staff,5,0,20,15
1714377218782,MCWP 40R,B00,518781,Staff,7,0,20,13
1714377218782,MCWP 40R,C00,518783,Staff,5,0,20,15
1714377219812,MCWP 50R,A00,518791,Staff,0,0,20,20
1714377219812,MCWP 50R,B00,518792,Staff,0,1,20,20
1714377219812,MCWP 50R,C00,518793,Staff,0,1,20,20
1714377219812,MCWP 50R,D00,518794,Staff,0,0,20,20
1714377219812,MCWP 50R,E00,518795,Staff,0,1,20,20
1714377219812,MCWP 50R,F00,518796,Staff,0,0,20,20
1714377219812,MCWP 50R,G00,518797,Staff,0,1,20,20
1714377220840,MMW 12R,A01,514034,Herbst; Matthew,0,1,16,16
1714377220840,MMW 12R,A02,514035,Herbst; Matthew,2,0,16,14
1714377221866,MMW 13R,A01,514037,Staff,0,4,16,16
1714377221866,MMW 13R,A02,514039,Staff,0,2,16,16
1714377221866,MMW 13R,A03,628519,Staff,0,2,16,16
1714377223917,SIO 295LS,A00,523233,Staff,12,0,30,18
1714377224943,SIO 295S,A00,523232,Staff,12,0,30,18
1714377225972,SIOC 290S,A01,637330,Merrifield; Mark A,27,0,30,3
1714377227000,SIOC 291S,A01,637333,Gabriel; Corey John,27,0,30,3
1714377228027,SOCI 117,A01,494376,Staff,0,4,5,5
1714377229053,WES 237B,A00,494380,Staff,9,0,20,11
1714377231128,AESE 279B,A00,494370,Wade; Jon P,0,0,33,33
1714377232158,AIP 197,001,627712,Vespa; Emanuel Ignacio,9998,0,9999,1
1714377233183,ANAR 135S,A00,494369,Braswell; Geoffrey E.,0,0,0,0
1714377234210,BENG 196,001,628496,Engler; Adam J.,9998,0,9999,1
1714377235237,CAT 124RS,A01,519847,Geibel; William,0,0,20,20
1714377236264,CAT 125RS,A01,515971,Geibel; William,0,0,20,20
1714377237291,CLRE 250,A00,511389,Morris; Sheldon,9993,0,9999,6
1714377238320,CLRE 251,A00,507176,Mehta; Ravindra L.,9993,0,9999,6
1714377238320,CLRE 251,B00,511410,Mehta; Ravindra L.,9998,0,9999,1
1714377239345,CLRE 252,A00,507189,Cuomo; Raphael Eduardo,9995,0,9999,4
1714377240373,CLRE 253,A00,507199,Vaida; Florin,9994,0,9999,5
1714377240373,CLRE 253,B00,507202,Vaida; Florin,9999,0,9999,0
1714377241401,CLRE 259,A00,507211,Patel; Hemal,9996,0,9999,3
1714377242430,CLRE 260,A00,507221,Cuomo; Raphael Eduardo,9999,0,9999,0
1714377243456,CLRE 297,001,507242,Cuomo; Raphael Eduardo,9999,0,9999,0
1714377244480,COGS 197,001,638244,Voytek; Bradley Thomas,9999,0,9999,0
1714377245506,CSE 191,A00,516875,Minnes Kemp; Mor Mia,9993,0,9999,6
1714377246533,CSE 197,001,637388,Minnes Kemp; Mor Mia,9998,0,9999,1
1714377247560,CSS 201S,A01,494383,Staff,35,0,35,0
1714377248591,CSS 202S,A01,494387,Staff,35,0,35,0
1714377249618,DSC 197,001,628532,Eldridge; Justin Matthew,9996,0,9999,3
1714377250641,EAP 100,A00,516065,Staff,9797,0,9999,202
1714377251674,ECE 45,A01,507414,Staff,33,0,60,27
1714377253731,ECE 111,A01,507420,Staff,19,0,50,31
1714377254757,ECE 197,001,548057,Sievenpiper; Daniel F.,9994,0,9999,5
1714377255784,EDS 115,A00,507243,Choi; Bailey Miyeon,12,0,28,16
1714377256814,EDS 117,A01,494379,Staff,0,2,30,30
1714377257841,EDS 125,A00,507246,Hopkins; Megan Beth,12,0,30,18
1714377258867,EDS 128A,A01,507264,Fargason; Sharon Gayle,14,0,26,12
1714377259898,EDS 128B,A01,507293,Pappas; Elizabeth,18,0,30,12
1714377260927,EDS 139,A00,507294,Fargason; Sharon Gayle,18,0,30,12
1714377260927,EDS 139,B00,507313,Pappas; Elizabeth,15,0,30,15
1714377262008,EDS 201,A00,507315,Staff,13,0,30,17
1714377263033,EDS 203,A01,507317,Halter; Christopher P.,12,0,30,18
1714377264062,EDS 204R,A01,507319,Halter; Christopher P.,0,3,30,30
1714377264062,EDS 204R,B01,507331,Heinzman; Erica M.,17,0,30,13
1714377265087,EDS 206R,A00,507332,Staff,0,4,30,30
1714377265087,EDS 206R,B00,507343,Staff,18,0,30,12
1714377266113,EDS 250,A00,507344,Hemans; Patricia Ann Benitez,22,0,40,18
1714377267141,EDS 281,A00,507345,Daly; Alan J.,18,0,18,0
1714377268169,EDS 284,A00,507350,Daly; Alan J.,16,0,16,0
1714377269193,EDS 286,A00,507359,Fine; Sarah,18,0,18,0
1714377270218,EDS 289C,A01,507361,Daly; Alan J.,18,0,18,0
1714377271247,EDS 290,A00,507366,Hofstetter; Carolyn,15,0,15,0
1714377272273,LIGM 5A,A00,507421,Fischer-Grunski; Eva K,18,0,20,2
1714377273300,LIGM 5B,A00,507423,Fischer-Grunski; Eva K,19,0,20,1
1714377274325,LIGM 5C,A00,507425,Fischer-Grunski; Eva K,19,0,20,1
1714377275351,LIIT 5AS,A00,507427,Carnelos; Chiara,20,0,20,0
1714377276380,LIIT 5BS,A00,507430,Carnelos; Chiara,20,0,20,0
1714377277406,LIIT 5CS,A00,507432,Carnelos; Chiara,20,0,20,0
1714377278436,LISP 5A,A00,507541,Munoz Sanchez; Alicia,11,0,20,9
1714377279462,LISP 5B,A00,507671,Munoz Sanchez; Alicia,9,0,20,11
1714377280487,LISP 5C,A00,507696,Munoz Sanchez; Alicia,9,0,20,11
1714377281515,MAE 197,001,528363,Boechler; Nicholas Sebastia,9998,0,9999,1
1714377282541,MATH 197,001,523477,Kedlaya; Kiran S.,9996,0,9999,3
1714377282541,MATH 197,002,563811,Zhang; Danna,9995,0,9999,4
1714377282541,MATH 197,003,628552,Dumitriu; Ioana,9998,0,9999,1
1714377283568,MCWP 40R,A00,518780,Staff,5,0,20,15
1714377283568,MCWP 40R,B00,518781,Staff,7,0,20,13
1714377283568,MCWP 40R,C00,518783,Staff,5,0,20,15
1714377284597,MCWP 50R,A00,518791,Staff,0,0,20,20
1714377284597,MCWP 50R,B00,518792,Staff,0,1,20,20
1714377284597,MCWP 50R,C00,518793,Staff,0,1,20,20
1714377284597,MCWP 50R,D00,518794,Staff,0,0,20,20
1714377284597,MCWP 50R,E00,518795,Staff,0,1,20,20
1714377284597,MCWP 50R,F00,518796,Staff,0,0,20,20
1714377284597,MCWP 50R,G00,518797,Staff,0,1,20,20
1714377285624,MMW 12R,A01,514034,Herbst; Matthew,0,1,16,16
1714377285624,MMW 12R,A02,514035,Herbst; Matthew,2,0,16,14
1714377286648,MMW 13R,A01,514037,Staff,0,4,16,16
1714377286648,MMW 13R,A02,514039,Staff,0,2,16,16
1714377286648,MMW 13R,A03,628519,Staff,0,2,16,16
1714377288698,SIO 295LS,A00,523233,Staff,12,0,30,18
1714377289724,SIO 295S,A00,523232,Staff,12,0,30,18
1714377290751,SIOC 290S,A01,637330,Merrifield; Mark A,27,0,30,3
1714377291778,SIOC 291S,A01,637333,Gabriel; Corey John,27,0,30,3
1714377292806,SOCI 117,A01,494376,Staff,0,4,5,5
1714377293830,WES 237B,A00,494380,Staff,9,0,20,11
1714377295888,AESE 279B,A00,494370,Wade; Jon P,0,0,33,33
1714377296915,AIP 197,001,627712,Vespa; Emanuel Ignacio,9998,0,9999,1
1714377297940,ANAR 135S,A00,494369,Braswell; Geoffrey E.,0,0,0,0
1714377298966,BENG 196,001,628496,Engler; Adam J.,9998,0,9999,1
1714377299993,CAT 124RS,A01,519847,Geibel; William,0,0,20,20
1714377301018,CAT 125RS,A01,515971,Geibel; William,0,0,20,20
1714377302050,CLRE 250,A00,511389,Morris; Sheldon,9993,0,9999,6
1714377303079,CLRE 251,A00,507176,Mehta; Ravindra L.,9993,0,9999,6
1714377303079,CLRE 251,B00,511410,Mehta; Ravindra L.,9998,0,9999,1
1714377304104,CLRE 252,A00,507189,Cuomo; Raphael Eduardo,9995,0,9999,4
1714377305131,CLRE 253,A00,507199,Vaida; Florin,9994,0,9999,5
1714377305131,CLRE 253,B00,507202,Vaida; Florin,9999,0,9999,0
1714377306156,CLRE 259,A00,507211,Patel; Hemal,9996,0,9999,3
1714377307183,CLRE 260,A00,507221,Cuomo; Raphael Eduardo,9999,0,9999,0
1714377308208,CLRE 297,001,507242,Cuomo; Raphael Eduardo,9999,0,9999,0
1714377309238,COGS 197,001,638244,Voytek; Bradley Thomas,9999,0,9999,0
1714377310268,CSE 191,A00,516875,Minnes Kemp; Mor Mia,9993,0,9999,6
1714377311298,CSE 197,001,637388,Minnes Kemp; Mor Mia,9998,0,9999,1
1714377312332,CSS 201S,A01,494383,Staff,35,0,35,0
1714377313365,CSS 202S,A01,494387,Staff,35,0,35,0
1714377314392,DSC 197,001,628532,Eldridge; Justin Matthew,9996,0,9999,3
1714377315417,EAP 100,A00,516065,Staff,9797,0,9999,202
1714377316442,ECE 45,A01,507414,Staff,33,0,60,27
1714377318506,ECE 111,A01,507420,Staff,19,0,50,31
1714377319533,ECE 197,001,548057,Sievenpiper; Daniel F.,9994,0,9999,5
1714377320566,EDS 115,A00,507243,Choi; Bailey Miyeon,12,0,28,16
1714377321594,EDS 117,A01,494379,Staff,0,2,30,30
1714377322624,EDS 125,A00,507246,Hopkins; Megan Beth,12,0,30,18
1714377323653,EDS 128A,A01,507264,Fargason; Sharon Gayle,14,0,26,12
1714377324680,EDS 128B,A01,507293,Pappas; Elizabeth,18,0,30,12
1714377325705,EDS 139,A00,507294,Fargason; Sharon Gayle,18,0,30,12
1714377325705,EDS 139,B00,507313,Pappas; Elizabeth,15,0,30,15
1714377326730,EDS 201,A00,507315,Staff,13,0,30,17
1714377327756,EDS 203,A01,507317,Halter; Christopher P.,12,0,30,18
1714377328787,EDS 204R,A01,507319,Halter; Christopher P.,0,3,30,30
1714377328787,EDS 204R,B01,507331,Heinzman; Erica M.,17,0,30,13
1714377329813,EDS 206R,A00,507332,Staff,0,4,30,30
1714377329813,EDS 206R,B00,507343,Staff,18,0,30,12
1714377330839,EDS 250,A00,507344,Hemans; Patricia Ann Benitez,22,0,40,18
1714377331868,EDS 281,A00,507345,Daly; Alan J.,18,0,18,0
1714377332896,EDS 284,A00,507350,Daly; Alan J.,16,0,16,0
1714377333924,EDS 286,A00,507359,Fine; Sarah,18,0,18,0
1714377334949,EDS 289C,A01,507361,Daly; Alan J.,18,0,18,0
1714377335973,EDS 290,A00,507366,Hofstetter; Carolyn,15,0,15,0
1714377337005,LIGM 5A,A00,507421,Fischer-Grunski; Eva K,18,0,20,2
1714377338031,LIGM 5B,A00,507423,Fischer-Grunski; Eva K,19,0,20,1
1714377339066,LIGM 5C,A00,507425,Fischer-Grunski; Eva K,19,0,20,1
1714377340092,LIIT 5AS,A00,507427,Carnelos; Chiara,20,0,20,0
1714377341120,LIIT 5BS,A00,507430,Carnelos; Chiara,20,0,20,0
1714377342146,LIIT 5CS,A00,507432,Carnelos; Chiara,20,0,20,0
1714377343173,LISP 5A,A00,507541,Munoz Sanchez; Alicia,11,0,20,9
1714377344199,LISP 5B,A00,507671,Munoz Sanchez; Alicia,9,0,20,11
1714377345225,LISP 5C,A00,507696,Munoz Sanchez; Alicia,9,0,20,11
1714377346251,MAE 197,001,528363,Boechler; Nicholas Sebastia,9998,0,9999,1
1714377347279,MATH 197,001,523477,Kedlaya; Kiran S.,9996,0,9999,3
1714377347279,MATH 197,002,563811,Zhang; Danna,9995,0,9999,4
1714377347279,MATH 197,003,628552,Dumitriu; Ioana,9998,0,9999,1
1714377348306,MCWP 40R,A00,518780,Staff,5,0,20,15
1714377348306,MCWP 40R,B00,518781,Staff,7,0,20,13
1714377348306,MCWP 40R,C00,518783,Staff,5,0,20,15
1714377349333,MCWP 50R,A00,518791,Staff,0,0,20,20
1714377349333,MCWP 50R,B00,518792,Staff,0,1,20,20
1714377349333,MCWP 50R,C00,518793,Staff,0,1,20,20
1714377349333,MCWP 50R,D00,518794,Staff,0,0,20,20
1714377349333,MCWP 50R,E00,518795,Staff,0,1,20,20
1714377349333,MCWP 50R,F00,518796,Staff,0,0,20,20
1714377349333,MCWP 50R,G00,518797,Staff,0,1,20,20
1714377350364,MMW 12R,A01,514034,Herbst; Matthew,0,1,16,16
1714377350364,MMW 12R,A02,514035,Herbst; Matthew,2,0,16,14
1714377351393,MMW 13R,A01,514037,Staff,0,4,16,16
1714377351393,MMW 13R,A02,514039,Staff,0,2,16,16
1714377351393,MMW 13R,A03,628519,Staff,0,2,16,16
1714377353454,SIO 295LS,A00,523233,Staff,12,0,30,18
1714377354483,SIO 295S,A00,523232,Staff,12,0,30,18
1714377355517,SIOC 290S,A01,637330,Merrifield; Mark A,27,0,30,3
1714377356544,SIOC 291S,A01,637333,Gabriel; Corey John,27,0,30,3
1714377357576,SOCI 117,A01,494376,Staff,0,4,5,5
1714377358602,WES 237B,A00,494380,Staff,9,0,20,11
1714377360671,AESE 279B,A00,494370,Wade; Jon P,0,0,33,33
1714377361695,AIP 197,001,627712,Vespa; Emanuel Ignacio,9998,0,9999,1
1714377362722,ANAR 135S,A00,494369,Braswell; Geoffrey E.,0,0,0,0
1714377363747,BENG 196,001,628496,Engler; Adam J.,9998,0,9999,1
1714377364774,CAT 124RS,A01,519847,Geibel; William,0,0,20,20
1714377365854,CAT 125RS,A01,515971,Geibel; William,0,0,20,20
1714377366883,CLRE 250,A00,511389,Morris; Sheldon,9993,0,9999,6
1714377367910,CLRE 251,A00,507176,Mehta; Ravindra L.,9993,0,9999,6
1714377367910,CLRE 251,B00,511410,Mehta; Ravindra L.,9998,0,9999,1
1714377368935,CLRE 252,A00,507189,Cuomo; Raphael Eduardo,9995,0,9999,4
1714377369962,CLRE 253,A00,507199,Vaida; Florin,9994,0,9999,5
1714377369962,CLRE 253,B00,507202,Vaida; Florin,9999,0,9999,0
1714377370987,CLRE 259,A00,507211,Patel; Hemal,9996,0,9999,3
1714377372014,CLRE 260,A00,507221,Cuomo; Raphael Eduardo,9999,0,9999,0
1714377373040,CLRE 297,001,507242,Cuomo; Raphael Eduardo,9999,0,9999,0
1714377374067,COGS 197,001,638244,Voytek; Bradley Thomas,9999,0,9999,0
1714377375093,CSE 191,A00,516875,Minnes Kemp; Mor Mia,9993,0,9999,6
1714377376124,CSE 197,001,637388,Minnes Kemp; Mor Mia,9998,0,9999,1
1714377377156,CSS 201S,A01,494383,Staff,35,0,35,0
1714377378181,CSS 202S,A01,494387,Staff,35,0,35,0
1714377379206,DSC 197,001,628532,Eldridge; Justin Matthew,9996,0,9999,3
1714377380229,EAP 100,A00,516065,Staff,9797,0,9999,202
1714377381257,ECE 45,A01,507414,Staff,33,0,60,27
1714377383569,ECE 111,A01,507420,Staff,19,0,50,31
1714377384594,ECE 197,001,548057,Sievenpiper; Daniel F.,9994,0,9999,5
1714377385624,EDS 115,A00,507243,Choi; Bailey Miyeon,12,0,28,16
1714377386653,EDS 117,A01,494379,Staff,0,2,30,30
1714377387682,EDS 125,A00,507246,Hopkins; Megan Beth,12,0,30,18
1714377388706,EDS 128A,A01,507264,Fargason; Sharon Gayle,14,0,26,12
1714377389739,EDS 128B,A01,507293,Pappas; Elizabeth,18,0,30,12
1714377390767,EDS 139,A00,507294,Fargason; Sharon Gayle,18,0,30,12
1714377390767,EDS 139,B00,507313,Pappas; Elizabeth,15,0,30,15
1714377391796,EDS 201,A00,507315,Staff,13,0,30,17
1714377392821,EDS 203,A01,507317,Halter; Christopher P.,12,0,30,18
1714377393847,EDS 204R,A01,507319,Halter; Christopher P.,0,3,30,30
1714377393847,EDS 204R,B01,507331,Heinzman; Erica M.,17,0,30,13
1714377394872,EDS 206R,A00,507332,Staff,0,4,30,30
1714377394872,EDS 206R,B00,507343,Staff,18,0,30,12
1714377395897,EDS 250,A00,507344,Hemans; Patricia Ann Benitez,22,0,40,18
1714377396922,EDS 281,A00,507345,Daly; Alan J.,18,0,18,0
1714377397949,EDS 284,A00,507350,Daly; Alan J.,16,0,16,0
1714377398973,EDS 286,A00,507359,Fine; Sarah,18,0,18,0
1714377399998,EDS 289C,A01,507361,Daly; Alan J.,18,0,18,0
1714377401024,EDS 290,A00,507366,Hofstetter; Carolyn,15,0,15,0
1714377402050,LIGM 5A,A00,507421,Fischer-Grunski; Eva K,18,0,20,2
1714377403075,LIGM 5B,A00,507423,Fischer-Grunski; Eva K,19,0,20,1
1714377404101,LIGM 5C,A00,507425,Fischer-Grunski; Eva K,19,0,20,1
1714377405133,LIIT 5AS,A00,507427,Carnelos; Chiara,20,0,20,0
1714377406161,LIIT 5BS,A00,507430,Carnelos; Chiara,20,0,20,0
1714377407187,LIIT 5CS,A00,507432,Carnelos; Chiara,20,0,20,0
1714377408213,LISP 5A,A00,507541,Munoz Sanchez; Alicia,11,0,20,9
1714377409238,LISP 5B,A00,507671,Munoz Sanchez; Alicia,9,0,20,11
1714377410268,LISP 5C,A00,507696,Munoz Sanchez; Alicia,9,0,20,11
1714377411294,MAE 197,001,528363,Boechler; Nicholas Sebastia,9998,0,9999,1
1714377412325,MATH 197,001,523477,Kedlaya; Kiran S.,9996,0,9999,3
1714377412325,MATH 197,002,563811,Zhang; Danna,9995,0,9999,4
1714377412325,MATH 197,003,628552,Dumitriu; Ioana,9998,0,9999,1
1714377413353,MCWP 40R,A00,518780,Staff,5,0,20,15
1714377413353,MCWP 40R,B00,518781,Staff,7,0,20,13
1714377413353,MCWP 40R,C00,518783,Staff,5,0,20,15
1714377414383,MCWP 50R,A00,518791,Staff,0,0,20,20
1714377414383,MCWP 50R,B00,518792,Staff,0,1,20,20
1714377414383,MCWP 50R,C00,518793,Staff,0,1,20,20
1714377414383,MCWP 50R,D00,518794,Staff,0,0,20,20
1714377414383,MCWP 50R,E00,518795,Staff,0,1,20,20
1714377414383,MCWP 50R,F00,518796,Staff,0,0,20,20
1714377414383,MCWP 50R,G00,518797,Staff,0,1,20,20
1714377415410,MMW 12R,A01,514034,Herbst; Matthew,0,1,16,16
1714377415410,MMW 12R,A02,514035,Herbst; Matthew,2,0,16,14
1714377416443,MMW 13R,A01,514037,Staff,0,4,16,16
1714377416443,MMW 13R,A02,514039,Staff,0,2,16,16
1714377416443,MMW 13R,A03,628519,Staff,0,2,16,16
1714377418498,SIO 295LS,A00,523233,Staff,12,0,30,18
1714377419538,SIO 295S,A00,523232,Staff,12,0,30,18
1714377420565,SIOC 290S,A01,637330,Merrifield; Mark A,27,0,30,3
1714377421593,SIOC 291S,A01,637333,Gabriel; Corey John,27,0,30,3
1714377422617,SOCI 117,A01,494376,Staff,0,4,5,5
1714377423646,WES 237B,A00,494380,Staff,9,0,20,11
1714377425702,AESE 279B,A00,494370,Wade; Jon P,0,0,33,33
1714377426737,AIP 197,001,627712,Vespa; Emanuel Ignacio,9998,0,9999,1
1714377427767,ANAR 135S,A00,494369,Braswell; Geoffrey E.,0,0,0,0
1714377428793,BENG 196,001,628496,Engler; Adam J.,9998,0,9999,1
1714377429818,CAT 124RS,A01,519847,Geibel; William,0,0,20,20
1714377430843,CAT 125RS,A01,515971,Geibel; William,0,0,20,20
1714377431871,CLRE 250,A00,511389,Morris; Sheldon,9993,0,9999,6
1714377432900,CLRE 251,A00,507176,Mehta; Ravindra L.,9993,0,9999,6
1714377432900,CLRE 251,B00,511410,Mehta; Ravindra L.,9998,0,9999,1
1714377433927,CLRE 252,A00,507189,Cuomo; Raphael Eduardo,9995,0,9999,4
1714377434953,CLRE 253,A00,507199,Vaida; Florin,9994,0,9999,5
1714377434953,CLRE 253,B00,507202,Vaida; Florin,9999,0,9999,0
1714377435988,CLRE 259,A00,507211,Patel; Hemal,9996,0,9999,3
1714377437017,CLRE 260,A00,507221,Cuomo; Raphael Eduardo,9999,0,9999,0
1714377438042,CLRE 297,001,507242,Cuomo; Raphael Eduardo,9999,0,9999,0
1714377439077,COGS 197,001,638244,Voytek; Bradley Thomas,9999,0,9999,0
1714377440109,CSE 191,A00,516875,Minnes Kemp; Mor Mia,9993,0,9999,6
1714377441134,CSE 197,001,637388,Minnes Kemp; Mor Mia,9998,0,9999,1
1714377442163,CSS 201S,A01,494383,Staff,35,0,35,0
1714377443193,CSS 202S,A01,494387,Staff,35,0,35,0
1714377444218,DSC 197,001,628532,Eldridge; Justin Matthew,9996,0,9999,3
1714377445245,EAP 100,A00,516065,Staff,9797,0,9999,202
1714377446271,ECE 45,A01,507414,Staff,33,0,60,27
1714377448322,ECE 111,A01,507420,Staff,19,0,50,31
1714377449348,ECE 197,001,548057,Sievenpiper; Daniel F.,9994,0,9999,5
1714377450377,EDS 115,A00,507243,Choi; Bailey Miyeon,12,0,28,16
1714377451421,EDS 117,A01,494379,Staff,0,2,30,30
1714377452447,EDS 125,A00,507246,Hopkins; Megan Beth,12,0,30,18
1714377453473,EDS 128A,A01,507264,Fargason; Sharon Gayle,14,0,26,12
1714377454504,EDS 128B,A01,507293,Pappas; Elizabeth,18,0,30,12
1714377455538,EDS 139,A00,507294,Fargason; Sharon Gayle,18,0,30,12
1714377455538,EDS 139,B00,507313,Pappas; Elizabeth,15,0,30,15
1714377456565,EDS 201,A00,507315,Staff,13,0,30,17
1714377457589,EDS 203,A01,507317,Halter; Christopher P.,12,0,30,18
1714377458616,EDS 204R,A01,507319,Halter; Christopher P.,0,3,30,30
1714377458616,EDS 204R,B01,507331,Heinzman; Erica M.,17,0,30,13
1714377459654,EDS 206R,A00,507332,Staff,0,4,30,30
1714377459654,EDS 206R,B00,507343,Staff,18,0,30,12
1714377460679,EDS 250,A00,507344,Hemans; Patricia Ann Benitez,22,0,40,18
1714377461730,EDS 281,A00,507345,Daly; Alan J.,18,0,18,0
1714377462755,EDS 284,A00,507350,Daly; Alan J.,16,0,16,0
1714377463782,EDS 286,A00,507359,Fine; Sarah,18,0,18,0
1714377464808,EDS 289C,A01,507361,Daly; Alan J.,18,0,18,0
1714377465841,EDS 290,A00,507366,Hofstetter; Carolyn,15,0,15,0
1714377466877,LIGM 5A,A00,507421,Fischer-Grunski; Eva K,18,0,20,2
1714377467904,LIGM 5B,A00,507423,Fischer-Grunski; Eva K,19,0,20,1
1714377468939,LIGM 5C,A00,507425,Fischer-Grunski; Eva K,19,0,20,1
1714377470025,LIIT 5AS,A00,507427,Carnelos; Chiara,20,0,20,0
1714377471055,LIIT 5BS,A00,507430,Carnelos; Chiara,20,0,20,0
1714377472092,LIIT 5CS,A00,507432,Carnelos; Chiara,20,0,20,0
1714377473144,LISP 5A,A00,507541,Munoz Sanchez; Alicia,11,0,20,9
1714377474170,LISP 5B,A00,507671,Munoz Sanchez; Alicia,9,0,20,11
1714377475196,LISP 5C,A00,507696,Munoz Sanchez; Alicia,9,0,20,11
1714377476220,MAE 197,001,528363,Boechler; Nicholas Sebastia,9998,0,9999,1
1714377477248,MATH 197,001,523477,Kedlaya; Kiran S.,9996,0,9999,3
1714377477248,MATH 197,002,563811,Zhang; Danna,9995,0,9999,4
1714377477248,MATH 197,003,628552,Dumitriu; Ioana,9998,0,9999,1
1714377478273,MCWP 40R,A00,518780,Staff,5,0,20,15
1714377478273,MCWP 40R,B00,518781,Staff,7,0,20,13
1714377478273,MCWP 40R,C00,518783,Staff,5,0,20,15
1714377479301,MCWP 50R,A00,518791,Staff,0,0,20,20
1714377479301,MCWP 50R,B00,518792,Staff,0,1,20,20
1714377479301,MCWP 50R,C00,518793,Staff,0,1,20,20
1714377479301,MCWP 50R,D00,518794,Staff,0,0,20,20
1714377479301,MCWP 50R,E00,518795,Staff,0,1,20,20
1714377479301,MCWP 50R,F00,518796,Staff,0,0,20,20
1714377479301,MCWP 50R,G00,518797,Staff,0,1,20,20
1714377480327,MMW 12R,A01,514034,Herbst; Matthew,0,1,16,16
1714377480327,MMW 12R,A02,514035,Herbst; Matthew,2,0,16,14
1714377481351,MMW 13R,A01,514037,Staff,0,4,16,16
1714377481351,MMW 13R,A02,514039,Staff,0,2,16,16
1714377481351,MMW 13R,A03,628519,Staff,0,2,16,16
1714377483409,SIO 295LS,A00,523233,Staff,12,0,30,18
1714377484434,SIO 295S,A00,523232,Staff,12,0,30,18
1714377485473,SIOC 290S,A01,637330,Merrifield; Mark A,27,0,30,3
1714377486498,SIOC 291S,A01,637333,Gabriel; Corey John,27,0,30,3
1714377487521,SOCI 117,A01,494376,Staff,0,4,5,5
1714377488555,WES 237B,A00,494380,Staff,9,0,20,11
1714377490613,AESE 279B,A00,494370,Wade; Jon P,0,0,33,33
1714377491638,AIP 197,001,627712,Vespa; Emanuel Ignacio,9998,0,9999,1
1714377492676,ANAR 135S,A00,494369,Braswell; Geoffrey E.,0,0,0,0
1714377493724,BENG 196,001,628496,Engler; Adam J.,9998,0,9999,1
1714377494749,CAT 124RS,A01,519847,Geibel; William,0,0,20,20
1714377495780,CAT 125RS,A01,515971,Geibel; William,0,0,20,20
1714377496812,CLRE 250,A00,511389,Morris; Sheldon,9993,0,9999,6
1714377497839,CLRE 251,A00,507176,Mehta; Ravindra L.,9993,0,9999,6
1714377497839,CLRE 251,B00,511410,Mehta; Ravindra L.,9998,0,9999,1
1714377498869,CLRE 252,A00,507189,Cuomo; Raphael Eduardo,9995,0,9999,4
1714377499957,CLRE 253,A00,507199,Vaida; Florin,9994,0,9999,5
1714377499957,CLRE 253,B00,507202,Vaida; Florin,9999,0,9999,0
1714377500994,CLRE 259,A00,507211,Patel; Hemal,9996,0,9999,3
1714377502025,CLRE 260,A00,507221,Cuomo; Raphael Eduardo,9999,0,9999,0
1714377503050,CLRE 297,001,507242,Cuomo; Raphael Eduardo,9999,0,9999,0
1714377504083,COGS 197,001,638244,Voytek; Bradley Thomas,9999,0,9999,0
1714377505111,CSE 191,A00,516875,Minnes Kemp; Mor Mia,9993,0,9999,6
1714377506135,CSE 197,001,637388,Minnes Kemp; Mor Mia,9998,0,9999,1
1714377507162,CSS 201S,A01,494383,Staff,35,0,35,0
1714377508186,CSS 202S,A01,494387,Staff,35,0,35,0
1714377509210,DSC 197,001,628532,Eldridge; Justin Matthew,9996,0,9999,3
1714377510235,EAP 100,A00,516065,Staff,9797,0,9999,202
1714377511261,ECE 45,A01,507414,Staff,33,0,60,27
1714377513312,ECE 111,A01,507420,Staff,19,0,50,31
1714377514339,ECE 197,001,548057,Sievenpiper; Daniel F.,9994,0,9999,5
1714377515397,EDS 115,A00,507243,Choi; Bailey Miyeon,12,0,28,16
1714377516424,EDS 117,A01,494379,Staff,0,2,30,30
1714377517448,EDS 125,A00,507246,Hopkins; Megan Beth,12,0,30,18
1714377518476,EDS 128A,A01,507264,Fargason; Sharon Gayle,14,0,26,12
1714377519502,EDS 128B,A01,507293,Pappas; Elizabeth,18,0,30,12
1714377520528,EDS 139,A00,507294,Fargason; Sharon Gayle,18,0,30,12
1714377520528,EDS 139,B00,507313,Pappas; Elizabeth,15,0,30,15
1714377521557,EDS 201,A00,507315,Staff,13,0,30,17
1714377522583,EDS 203,A01,507317,Halter; Christopher P.,12,0,30,18
1714377523615,EDS 204R,A01,507319,Halter; Christopher P.,0,3,30,30
1714377523615,EDS 204R,B01,507331,Heinzman; Erica M.,17,0,30,13
1714377524641,EDS 206R,A00,507332,Staff,0,4,30,30
1714377524641,EDS 206R,B00,507343,Staff,18,0,30,12
1714377525667,EDS 250,A00,507344,Hemans; Patricia Ann Benitez,22,0,40,18
1714377526691,EDS 281,A00,507345,Daly; Alan J.,18,0,18,0
1714377527716,EDS 284,A00,507350,Daly; Alan J.,16,0,16,0
1714377528751,EDS 286,A00,507359,Fine; Sarah,18,0,18,0
1714377529784,EDS 289C,A01,507361,Daly; Alan J.,18,0,18,0
1714377530810,EDS 290,A00,507366,Hofstetter; Carolyn,15,0,15,0
1714377531868,LIGM 5A,A00,507421,Fischer-Grunski; Eva K,18,0,20,2
1714377532931,LIGM 5B,A00,507423,Fischer-Grunski; Eva K,19,0,20,1
1714377533961,LIGM 5C,A00,507425,Fischer-Grunski; Eva K,19,0,20,1
1714377534986,LIIT 5AS,A00,507427,Carnelos; Chiara,20,0,20,0
1714377536031,LIIT 5BS,A00,507430,Carnelos; Chiara,20,0,20,0
1714377537056,LIIT 5CS,A00,507432,Carnelos; Chiara,20,0,20,0
1714377538080,LISP 5A,A00,507541,Munoz Sanchez; Alicia,11,0,20,9
1714377539106,LISP 5B,A00,507671,Munoz Sanchez; Alicia,9,0,20,11
1714377540132,LISP 5C,A00,507696,Munoz Sanchez; Alicia,9,0,20,11
1714377541162,MAE 197,001,528363,Boechler; Nicholas Sebastia,9998,0,9999,1
1714377542189,MATH 197,001,523477,Kedlaya; Kiran S.,9996,0,9999,3
1714377542189,MATH 197,002,563811,Zhang; Danna,9995,0,9999,4
1714377542189,MATH 197,003,628552,Dumitriu; Ioana,9998,0,9999,1
1714377543218,MCWP 40R,A00,518780,Staff,5,0,20,15
1714377543218,MCWP 40R,B00,518781,Staff,7,0,20,13
1714377543218,MCWP 40R,C00,518783,Staff,5,0,20,15
1714377544245,MCWP 50R,A00,518791,Staff,0,0,20,20
1714377544245,MCWP 50R,B00,518792,Staff,0,1,20,20
1714377544245,MCWP 50R,C00,518793,Staff,0,1,20,20
1714377544245,MCWP 50R,D00,518794,Staff,0,0,20,20
1714377544245,MCWP 50R,E00,518795,Staff,0,1,20,20
1714377544245,MCWP 50R,F00,518796,Staff,0,0,20,20
1714377544245,MCWP 50R,G00,518797,Staff,0,1,20,20
1714377545272,MMW 12R,A01,514034,Herbst; Matthew,0,1,16,16
1714377545272,MMW 12R,A02,514035,Herbst; Matthew,2,0,16,14
1714377546300,MMW 13R,A01,514037,Staff,0,4,16,16
1714377546300,MMW 13R,A02,514039,Staff,0,2,16,16
1714377546300,MMW 13R,A03,628519,Staff,0,2,16,16
1714377548356,SIO 295LS,A00,523233,Staff,12,0,30,18
1714377549382,SIO 295S,A00,523232,Staff,12,0,30,18
1714377550426,SIOC 290S,A01,637330,Merrifield; Mark A,27,0,30,3
1714377551452,SIOC 291S,A01,637333,Gabriel; Corey John,27,0,30,3
1714377552477,SOCI 117,A01,494376,Staff,0,4,5,5
1714377553501,WES 237B,A00,494380,Staff,9,0,20,11
1714377555635,AESE 279B,A00,494370,Wade; Jon P,0,0,33,33
1714377556660,AIP 197,001,627712,Vespa; Emanuel Ignacio,9998,0,9999,1
1714377557686,ANAR 135S,A00,494369,Braswell; Geoffrey E.,0,0,0,0
1714377558712,BENG 196,001,628496,Engler; Adam J.,9998,0,9999,1
1714377559740,CAT 124RS,A01,519847,Geibel; William,0,0,20,20
1714377560766,CAT 125RS,A01,515971,Geibel; William,0,0,20,20
1714377561827,CLRE 250,A00,511389,Morris; Sheldon,9993,0,9999,6
1714377562856,CLRE 251,A00,507176,Mehta; Ravindra L.,9993,0,9999,6
1714377562856,CLRE 251,B00,511410,Mehta; Ravindra L.,9998,0,9999,1
1714377563881,CLRE 252,A00,507189,Cuomo; Raphael Eduardo,9995,0,9999,4
1714377564908,CLRE 253,A00,507199,Vaida; Florin,9994,0,9999,5
1714377564908,CLRE 253,B00,507202,Vaida; Florin,9999,0,9999,0
1714377565935,CLRE 259,A00,507211,Patel; Hemal,9996,0,9999,3
1714377566963,CLRE 260,A00,507221,Cuomo; Raphael Eduardo,9999,0,9999,0
1714377567995,CLRE 297,001,507242,Cuomo; Raphael Eduardo,9999,0,9999,0
1714377569020,COGS 197,001,638244,Voytek; Bradley Thomas,9999,0,9999,0
1714377570049,CSE 191,A00,516875,Minnes Kemp; Mor Mia,9993,0,9999,6
1714377571103,CSE 197,001,637388,Minnes Kemp; Mor Mia,9998,0,9999,1
1714377572132,CSS 201S,A01,494383,Staff,35,0,35,0
1714377573163,CSS 202S,A01,494387,Staff,35,0,35,0
1714377574259,DSC 197,001,628532,Eldridge; Justin Matthew,9996,0,9999,3
1714377575286,EAP 100,A00,516065,Staff,9797,0,9999,202
1714377576314,ECE 45,A01,507414,Staff,33,0,60,27
1714377578374,ECE 111,A01,507420,Staff,19,0,50,31
1714377579399,ECE 197,001,548057,Sievenpiper; Daniel F.,9994,0,9999,5
1714377580423,EDS 115,A00,507243,Choi; Bailey Miyeon,12,0,28,16
1714377581459,EDS 117,A01,494379,Staff,0,2,30,30
1714377582493,EDS 125,A00,507246,Hopkins; Megan Beth,12,0,30,18
1714377583518,EDS 128A,A01,507264,Fargason; Sharon Gayle,14,0,26,12
1714377584554,EDS 128B,A01,507293,Pappas; Elizabeth,18,0,30,12
1714377585580,EDS 139,A00,507294,Fargason; Sharon Gayle,18,0,30,12
1714377585580,EDS 139,B00,507313,Pappas; Elizabeth,15,0,30,15
1714377586608,EDS 201,A00,507315,Staff,13,0,30,17
1714377587643,EDS 203,A01,507317,Halter; Christopher P.,12,0,30,18
1714377588668,EDS 204R,A01,507319,Halter; Christopher P.,0,3,30,30
1714377588668,EDS 204R,B01,507331,Heinzman; Erica M.,17,0,30,13
1714377589712,EDS 206R,A00,507332,Staff,0,4,30,30
1714377589712,EDS 206R,B00,507343,Staff,18,0,30,12
1714377590737,EDS 250,A00,507344,Hemans; Patricia Ann Benitez,22,0,40,18
1714377591762,EDS 281,A00,507345,Daly; Alan J.,18,0,18,0
1714377592795,EDS 284,A00,507350,Daly; Alan J.,16,0,16,0
1714377593840,EDS 286,A00,507359,Fine; Sarah,18,0,18,0
1714377594866,EDS 289C,A01,507361,Daly; Alan J.,18,0,18,0
1714377595932,EDS 290,A00,507366,Hofstetter; Carolyn,15,0,15,0
1714377596965,LIGM 5A,A00,507421,Fischer-Grunski; Eva K,18,0,20,2
1714377597991,LIGM 5B,A00,507423,Fischer-Grunski; Eva K,19,0,20,1
1714377599021,LIGM 5C,A00,507425,Fischer-Grunski; Eva K,19,0,20,1
1714377600050,LIIT 5AS,A00,507427,Carnelos; Chiara,20,0,20,0
1714377601075,LIIT 5BS,A00,507430,Carnelos; Chiara,20,0,20,0
1714377602105,LIIT 5CS,A00,507432,Carnelos; Chiara,20,0,20,0
1714377603130,LISP 5A,A00,507541,Munoz Sanchez; Alicia,11,0,20,9
1714377604162,LISP 5B,A00,507671,Munoz Sanchez; Alicia,9,0,20,11
1714377605187,LISP 5C,A00,507696,Munoz Sanchez; Alicia,9,0,20,11
1714377606213,MAE 197,001,528363,Boechler; Nicholas Sebastia,9998,0,9999,1
1714377607240,MATH 197,001,523477,Kedlaya; Kiran S.,9996,0,9999,3
1714377607240,MATH 197,002,563811,Zhang; Danna,9995,0,9999,4
1714377607240,MATH 197,003,628552,Dumitriu; Ioana,9998,0,9999,1
1714377608270,MCWP 40R,A00,518780,Staff,5,0,20,15
1714377608270,MCWP 40R,B00,518781,Staff,7,0,20,13
1714377608270,MCWP 40R,C00,518783,Staff,5,0,20,15
1714377609295,MCWP 50R,A00,518791,Staff,0,0,20,20
1714377609295,MCWP 50R,B00,518792,Staff,0,1,20,20
1714377609295,MCWP 50R,C00,518793,Staff,0,1,20,20
1714377609295,MCWP 50R,D00,518794,Staff,0,0,20,20
1714377609295,MCWP 50R,E00,518795,Staff,0,1,20,20
1714377609295,MCWP 50R,F00,518796,Staff,0,0,20,20
1714377609295,MCWP 50R,G00,518797,Staff,0,1,20,20
1714377610322,MMW 12R,A01,514034,Herbst; Matthew,0,1,16,16
1714377610322,MMW 12R,A02,514035,Herbst; Matthew,2,0,16,14
1714377611351,MMW 13R,A01,514037,Staff,0,4,16,16
1714377611351,MMW 13R,A02,514039,Staff,0,2,16,16
1714377611351,MMW 13R,A03,628519,Staff,0,2,16,16
1714377613401,SIO 295LS,A00,523233,Staff,12,0,30,18
1714377614433,SIO 295S,A00,523232,Staff,12,0,30,18
1714377615463,SIOC 290S,A01,637330,Merrifield; Mark A,27,0,30,3
1714377616499,SIOC 291S,A01,637333,Gabriel; Corey John,27,0,30,3
1714377617524,SOCI 117,A01,494376,Staff,0,4,5,5
1714377618550,WES 237B,A00,494380,Staff,9,0,20,11
1714377620620,AESE 279B,A00,494370,Wade; Jon P,0,0,33,33
1714377621646,AIP 197,001,627712,Vespa; Emanuel Ignacio,9998,0,9999,1
1714377622670,ANAR 135S,A00,494369,Braswell; Geoffrey E.,0,0,0,0
1714377623696,BENG 196,001,628496,Engler; Adam J.,9998,0,9999,1
1714377624723,CAT 124RS,A01,519847,Geibel; William,0,0,20,20
1714377625749,CAT 125RS,A01,515971,Geibel; William,0,0,20,20
1714377626792,CLRE 250,A00,511389,Morris; Sheldon,9993,0,9999,6
1714377627838,CLRE 251,A00,507176,Mehta; Ravindra L.,9993,0,9999,6
1714377627838,CLRE 251,B00,511410,Mehta; Ravindra L.,9998,0,9999,1
1714377628864,CLRE 252,A00,507189,Cuomo; Raphael Eduardo,9995,0,9999,4
1714377629895,CLRE 253,A00,507199,Vaida; Florin,9994,0,9999,5
1714377629895,CLRE 253,B00,507202,Vaida; Florin,9999,0,9999,0
1714377630933,CLRE 259,A00,507211,Patel; Hemal,9996,0,9999,3
1714377631961,CLRE 260,A00,507221,Cuomo; Raphael Eduardo,9999,0,9999,0
1714377632986,CLRE 297,001,507242,Cuomo; Raphael Eduardo,9999,0,9999,0
1714377634014,COGS 197,001,638244,Voytek; Bradley Thomas,9999,0,9999,0
1714377635039,CSE 191,A00,516875,Minnes Kemp; Mor Mia,9993,0,9999,6
1714377636064,CSE 197,001,637388,Minnes Kemp; Mor Mia,9998,0,9999,1
1714377637093,CSS 201S,A01,494383,Staff,35,0,35,0
1714377638150,CSS 202S,A01,494387,Staff,35,0,35,0
1714377639179,DSC 197,001,628532,Eldridge; Justin Matthew,9996,0,9999,3
1714377640212,EAP 100,A00,516065,Staff,9797,0,9999,202
1714377641238,ECE 45,A01,507414,Staff,33,0,60,27
1714377643289,ECE 111,A01,507420,Staff,19,0,50,31
1714377644319,ECE 197,001,548057,Sievenpiper; Daniel F.,9994,0,9999,5
1714377645359,EDS 115,A00,507243,Choi; Bailey Miyeon,12,0,28,16
1714377646395,EDS 117,A01,494379,Staff,0,2,30,30
1714377647420,EDS 125,A00,507246,Hopkins; Megan Beth,12,0,30,18
1714377648452,EDS 128A,A01,507264,Fargason; Sharon Gayle,14,0,26,12
1714377649477,EDS 128B,A01,507293,Pappas; Elizabeth,18,0,30,12
1714377650503,EDS 139,A00,507294,Fargason; Sharon Gayle,18,0,30,12
1714377650503,EDS 139,B00,507313,Pappas; Elizabeth,15,0,30,15
1714377651535,EDS 201,A00,507315,Staff,13,0,30,17
1714377652583,EDS 203,A01,507317,Halter; Christopher P.,12,0,30,18
1714377653608,EDS 204R,A01,507319,Halter; Christopher P.,0,3,30,30
1714377653608,EDS 204R,B01,507331,Heinzman; Erica M.,17,0,30,13
1714377654634,EDS 206R,A00,507332,Staff,0,4,30,30
1714377654634,EDS 206R,B00,507343,Staff,18,0,30,12
1714377655659,EDS 250,A00,507344,Hemans; Patricia Ann Benitez,22,0,40,18
1714377656689,EDS 281,A00,507345,Daly; Alan J.,18,0,18,0
1714377657721,EDS 284,A00,507350,Daly; Alan J.,16,0,16,0
1714377658746,EDS 286,A00,507359,Fine; Sarah,18,0,18,0
1714377659772,EDS 289C,A01,507361,Daly; Alan J.,18,0,18,0
1714377660797,EDS 290,A00,507366,Hofstetter; Carolyn,15,0,15,0
1714377661827,LIGM 5A,A00,507421,Fischer-Grunski; Eva K,18,0,20,2
1714377662854,LIGM 5B,A00,507423,Fischer-Grunski; Eva K,19,0,20,1
1714377663881,LIGM 5C,A00,507425,Fischer-Grunski; Eva K,19,0,20,1
1714377664907,LIIT 5AS,A00,507427,Carnelos; Chiara,20,0,20,0
1714377665936,LIIT 5BS,A00,507430,Carnelos; Chiara,20,0,20,0
1714377666961,LIIT 5CS,A00,507432,Carnelos; Chiara,20,0,20,0
1714377667986,LISP 5A,A00,507541,Munoz Sanchez; Alicia,11,0,20,9
1714377669016,LISP 5B,A00,507671,Munoz Sanchez; Alicia,9,0,20,11
1714377670045,LISP 5C,A00,507696,Munoz Sanchez; Alicia,9,0,20,11
1714377671069,MAE 197,001,528363,Boechler; Nicholas Sebastia,9998,0,9999,1
1714377672094,MATH 197,001,523477,Kedlaya; Kiran S.,9996,0,9999,3
1714377672094,MATH 197,002,563811,Zhang; Danna,9995,0,9999,4
1714377672094,MATH 197,003,628552,Dumitriu; Ioana,9998,0,9999,1
1714377673125,MCWP 40R,A00,518780,Staff,5,0,20,15
1714377673125,MCWP 40R,B00,518781,Staff,7,0,20,13
1714377673125,MCWP 40R,C00,518783,Staff,5,0,20,15
1714377674148,MCWP 50R,A00,518791,Staff,0,0,20,20
1714377674148,MCWP 50R,B00,518792,Staff,0,1,20,20
1714377674148,MCWP 50R,C00,518793,Staff,0,1,20,20
1714377674148,MCWP 50R,D00,518794,Staff,0,0,20,20
1714377674148,MCWP 50R,E00,518795,Staff,0,1,20,20
1714377674148,MCWP 50R,F00,518796,Staff,0,0,20,20
1714377674148,MCWP 50R,G00,518797,Staff,0,1,20,20
1714377675176,MMW 12R,A01,514034,Herbst; Matthew,0,1,16,16
1714377675176,MMW 12R,A02,514035,Herbst; Matthew,2,0,16,14
1714377676200,MMW 13R,A01,514037,Staff,0,4,16,16
1714377676200,MMW 13R,A02,514039,Staff,0,2,16,16
1714377676200,MMW 13R,A03,628519,Staff,0,2,16,16
1714377678309,SIO 295LS,A00,523233,Staff,12,0,30,18
1714377679334,SIO 295S,A00,523232,Staff,12,0,30,18
1714377680359,SIOC 290S,A01,637330,Merrifield; Mark A,27,0,30,3
1714377681383,SIOC 291S,A01,637333,Gabriel; Corey John,27,0,30,3
1714377682407,SOCI 117,A01,494376,Staff,0,4,5,5
1714377683435,WES 237B,A00,494380,Staff,9,0,20,11
1714377685492,AESE 279B,A00,494370,Wade; Jon P,0,0,33,33
1714377686518,AIP 197,001,627712,Vespa; Emanuel Ignacio,9998,0,9999,1
1714377687547,ANAR 135S,A00,494369,Braswell; Geoffrey E.,0,0,0,0
1714377688572,BENG 196,001,628496,Engler; Adam J.,9998,0,9999,1
1714377689598,CAT 124RS,A01,519847,Geibel; William,0,0,20,20
1714377690623,CAT 125RS,A01,515971,Geibel; William,0,0,20,20
1714377691655,CLRE 250,A00,511389,Morris; Sheldon,9993,0,9999,6
1714377692680,CLRE 251,A00,507176,Mehta; Ravindra L.,9993,0,9999,6
1714377692680,CLRE 251,B00,511410,Mehta; Ravindra L.,9998,0,9999,1
1714377693707,CLRE 252,A00,507189,Cuomo; Raphael Eduardo,9995,0,9999,4
1714377694732,CLRE 253,A00,507199,Vaida; Florin,9994,0,9999,5
1714377694732,CLRE 253,B00,507202,Vaida; Florin,9999,0,9999,0
1714377695757,CLRE 259,A00,507211,Patel; Hemal,9996,0,9999,3
1714377696786,CLRE 260,A00,507221,Cuomo; Raphael Eduardo,9999,0,9999,0
1714377697813,CLRE 297,001,507242,Cuomo; Raphael Eduardo,9999,0,9999,0
1714377698838,COGS 197,001,638244,Voytek; Bradley Thomas,9999,0,9999,0
1714377699870,CSE 191,A00,516875,Minnes Kemp; Mor Mia,9993,0,9999,6
1714377700895,CSE 197,001,637388,Minnes Kemp; Mor Mia,9998,0,9999,1
1714377701925,CSS 201S,A01,494383,Staff,35,0,35,0
1714377702950,CSS 202S,A01,494387,Staff,35,0,35,0
1714377703976,DSC 197,001,628532,Eldridge; Justin Matthew,9996,0,9999,3
1714377705001,EAP 100,A00,516065,Staff,9797,0,9999,202
1714377706031,ECE 45,A01,507414,Staff,33,0,60,27
1714377708085,ECE 111,A01,507420,Staff,19,0,50,31
1714377709113,ECE 197,001,548057,Sievenpiper; Daniel F.,9994,0,9999,5
1714377710140,EDS 115,A00,507243,Choi; Bailey Miyeon,12,0,28,16
1714377711168,EDS 117,A01,494379,Staff,0,2,30,30
1714377712193,EDS 125,A00,507246,Hopkins; Megan Beth,12,0,30,18
1714377713223,EDS 128A,A01,507264,Fargason; Sharon Gayle,14,0,26,12
1714377714249,EDS 128B,A01,507293,Pappas; Elizabeth,18,0,30,12
1714377715277,EDS 139,A00,507294,Fargason; Sharon Gayle,18,0,30,12
1714377715277,EDS 139,B00,507313,Pappas; Elizabeth,15,0,30,15
1714377716302,EDS 201,A00,507315,Staff,13,0,30,17
1714377717328,EDS 203,A01,507317,Halter; Christopher P.,12,0,30,18
1714377718358,EDS 204R,A01,507319,Halter; Christopher P.,0,3,30,30
1714377718358,EDS 204R,B01,507331,Heinzman; Erica M.,17,0,30,13
1714377719388,EDS 206R,A00,507332,Staff,0,4,30,30
1714377719388,EDS 206R,B00,507343,Staff,18,0,30,12
1714377720420,EDS 250,A00,507344,Hemans; Patricia Ann Benitez,22,0,40,18
1714377721447,EDS 281,A00,507345,Daly; Alan J.,18,0,18,0
1714377722475,EDS 284,A00,507350,Daly; Alan J.,16,0,16,0
1714377723504,EDS 286,A00,507359,Fine; Sarah,18,0,18,0
1714377724529,EDS 289C,A01,507361,Daly; Alan J.,18,0,18,0
1714377725558,EDS 290,A00,507366,Hofstetter; Carolyn,15,0,15,0
1714377726590,LIGM 5A,A00,507421,Fischer-Grunski; Eva K,18,0,20,2
1714377727617,LIGM 5B,A00,507423,Fischer-Grunski; Eva K,19,0,20,1
1714377728642,LIGM 5C,A00,507425,Fischer-Grunski; Eva K,19,0,20,1
1714377729670,LIIT 5AS,A00,507427,Carnelos; Chiara,20,0,20,0
1714377730701,LIIT 5BS,A00,507430,Carnelos; Chiara,20,0,20,0
1714377731732,LIIT 5CS,A00,507432,Carnelos; Chiara,20,0,20,0
1714377732761,LISP 5A,A00,507541,Munoz Sanchez; Alicia,11,0,20,9
1714377733791,LISP 5B,A00,507671,Munoz Sanchez; Alicia,9,0,20,11
1714377734820,LISP 5C,A00,507696,Munoz Sanchez; Alicia,9,0,20,11
1714377735853,MAE 197,001,528363,Boechler; Nicholas Sebastia,9998,0,9999,1
1714377736887,MATH 197,001,523477,Kedlaya; Kiran S.,9996,0,9999,3
1714377736887,MATH 197,002,563811,Zhang; Danna,9995,0,9999,4
1714377736887,MATH 197,003,628552,Dumitriu; Ioana,9998,0,9999,1
1714377737915,MCWP 40R,A00,518780,Staff,5,0,20,15
1714377737915,MCWP 40R,B00,518781,Staff,7,0,20,13
1714377737915,MCWP 40R,C00,518783,Staff,5,0,20,15
1714377738942,MCWP 50R,A00,518791,Staff,0,0,20,20
1714377738942,MCWP 50R,B00,518792,Staff,0,1,20,20
1714377738942,MCWP 50R,C00,518793,Staff,0,1,20,20
1714377738942,MCWP 50R,D00,518794,Staff,0,0,20,20
1714377738942,MCWP 50R,E00,518795,Staff,0,1,20,20
1714377738942,MCWP 50R,F00,518796,Staff,0,0,20,20
1714377738942,MCWP 50R,G00,518797,Staff,0,1,20,20
1714377739971,MMW 12R,A01,514034,Herbst; Matthew,0,1,16,16
1714377739971,MMW 12R,A02,514035,Herbst; Matthew,2,0,16,14
1714377740996,MMW 13R,A01,514037,Staff,0,4,16,16
1714377740996,MMW 13R,A02,514039,Staff,0,2,16,16
1714377740996,MMW 13R,A03,628519,Staff,0,2,16,16
1714377743046,SIO 295LS,A00,523233,Staff,12,0,30,18
1714377744073,SIO 295S,A00,523232,Staff,12,0,30,18
1714377745110,SIOC 290S,A01,637330,Merrifield; Mark A,27,0,30,3
1714377746137,SIOC 291S,A01,637333,Gabriel; Corey John,27,0,30,3
1714377747164,SOCI 117,A01,494376,Staff,0,4,5,5
1714377748193,WES 237B,A00,494380,Staff,9,0,20,11
1714377750290,AESE 279B,A00,494370,Wade; Jon P,0,0,33,33
1714377751317,AIP 197,001,627712,Vespa; Emanuel Ignacio,9998,0,9999,1
1714377752342,ANAR 135S,A00,494369,Braswell; Geoffrey E.,0,0,0,0
1714377753371,BENG 196,001,628496,Engler; Adam J.,9998,0,9999,1
1714377754398,CAT 124RS,A01,519847,Geibel; William,0,0,20,20
1714377755425,CAT 125RS,A01,515971,Geibel; William,0,0,20,20
1714377756452,CLRE 250,A00,511389,Morris; Sheldon,9993,0,9999,6
1714377757479,CLRE 251,A00,507176,Mehta; Ravindra L.,9993,0,9999,6
1714377757479,CLRE 251,B00,511410,Mehta; Ravindra L.,9998,0,9999,1
1714377758510,CLRE 252,A00,507189,Cuomo; Raphael Eduardo,9995,0,9999,4
1714377759538,CLRE 253,A00,507199,Vaida; Florin,9994,0,9999,5
1714377759538,CLRE 253,B00,507202,Vaida; Florin,9999,0,9999,0
1714377760564,CLRE 259,A00,507211,Patel; Hemal,9996,0,9999,3
1714377761589,CLRE 260,A00,507221,Cuomo; Raphael Eduardo,9999,0,9999,0
1714377762615,CLRE 297,001,507242,Cuomo; Raphael Eduardo,9999,0,9999,0
1714377763640,COGS 197,001,638244,Voytek; Bradley Thomas,9999,0,9999,0
1714377764666,CSE 191,A00,516875,Minnes Kemp; Mor Mia,9993,0,9999,6
1714377765695,CSE 197,001,637388,Minnes Kemp; Mor Mia,9998,0,9999,1
1714377766730,CSS 201S,A01,494383,Staff,35,0,35,0
1714377767756,CSS 202S,A01,494387,Staff,35,0,35,0
1714377768781,DSC 197,001,628532,Eldridge; Justin Matthew,9996,0,9999,3
1714377769805,EAP 100,A00,516065,Staff,9797,0,9999,202
1714377770832,ECE 45,A01,507414,Staff,33,0,60,27
1714377772882,ECE 111,A01,507420,Staff,19,0,50,31
1714377773908,ECE 197,001,548057,Sievenpiper; Daniel F.,9994,0,9999,5
1714377774934,EDS 115,A00,507243,Choi; Bailey Miyeon,12,0,28,16
1714377775959,EDS 117,A01,494379,Staff,0,2,30,30
1714377776984,EDS 125,A00,507246,Hopkins; Megan Beth,12,0,30,18
1714377778014,EDS 128A,A01,507264,Fargason; Sharon Gayle,14,0,26,12
1714377779040,EDS 128B,A01,507293,Pappas; Elizabeth,18,0,30,12
1714377780073,EDS 139,A00,507294,Fargason; Sharon Gayle,18,0,30,12
1714377780073,EDS 139,B00,507313,Pappas; Elizabeth,15,0,30,15
1714377781099,EDS 201,A00,507315,Staff,13,0,30,17
1714377782180,EDS 203,A01,507317,Halter; Christopher P.,12,0,30,18
1714377783213,EDS 204R,A01,507319,Halter; Christopher P.,0,3,30,30
1714377783213,EDS 204R,B01,507331,Heinzman; Erica M.,17,0,30,13
1714377784239,EDS 206R,A00,507332,Staff,0,4,30,30
1714377784239,EDS 206R,B00,507343,Staff,18,0,30,12
1714377785267,EDS 250,A00,507344,Hemans; Patricia Ann Benitez,22,0,40,18
1714377786292,EDS 281,A00,507345,Daly; Alan J.,18,0,18,0
1714377787319,EDS 284,A00,507350,Daly; Alan J.,16,0,16,0
1714377788343,EDS 286,A00,507359,Fine; Sarah,18,0,18,0
1714377789369,EDS 289C,A01,507361,Daly; Alan J.,18,0,18,0
1714377790393,EDS 290,A00,507366,Hofstetter; Carolyn,15,0,15,0
1714377791419,LIGM 5A,A00,507421,Fischer-Grunski; Eva K,18,0,20,2
1714377792444,LIGM 5B,A00,507423,Fischer-Grunski; Eva K,19,0,20,1
1714377793472,LIGM 5C,A00,507425,Fischer-Grunski; Eva K,19,0,20,1
1714377794500,LIIT 5AS,A00,507427,Carnelos; Chiara,20,0,20,0
1714377795527,LIIT 5BS,A00,507430,Carnelos; Chiara,20,0,20,0
1714377796551,LIIT 5CS,A00,507432,Carnelos; Chiara,20,0,20,0
1714377797577,LISP 5A,A00,507541,Munoz Sanchez; Alicia,11,0,20,9
1714377798606,LISP 5B,A00,507671,Munoz Sanchez; Alicia,9,0,20,11
1714377799630,LISP 5C,A00,507696,Munoz Sanchez; Alicia,9,0,20,11
1714377800655,MAE 197,001,528363,Boechler; Nicholas Sebastia,9998,0,9999,1
1714377801679,MATH 197,001,523477,Kedlaya; Kiran S.,9996,0,9999,3
1714377801679,MATH 197,002,563811,Zhang; Danna,9995,0,9999,4
1714377801679,MATH 197,003,628552,Dumitriu; Ioana,9998,0,9999,1
1714377802703,MCWP 40R,A00,518780,Staff,5,0,20,15
1714377802703,MCWP 40R,B00,518781,Staff,7,0,20,13
1714377802703,MCWP 40R,C00,518783,Staff,5,0,20,15
1714377803727,MCWP 50R,A00,518791,Staff,0,0,20,20
1714377803727,MCWP 50R,B00,518792,Staff,0,1,20,20
1714377803727,MCWP 50R,C00,518793,Staff,0,1,20,20
1714377803727,MCWP 50R,D00,518794,Staff,0,0,20,20
1714377803727,MCWP 50R,E00,518795,Staff,0,1,20,20
1714377803727,MCWP 50R,F00,518796,Staff,0,0,20,20
1714377803727,MCWP 50R,G00,518797,Staff,0,1,20,20
1714377804757,MMW 12R,A01,514034,Herbst; Matthew,0,1,16,16
1714377804757,MMW 12R,A02,514035,Herbst; Matthew,2,0,16,14
1714377805780,MMW 13R,A01,514037,Staff,0,4,16,16
1714377805780,MMW 13R,A02,514039,Staff,0,2,16,16
1714377805780,MMW 13R,A03,628519,Staff,0,2,16,16
1714377807833,SIO 295LS,A00,523233,Staff,12,0,30,18
1714377808857,SIO 295S,A00,523232,Staff,12,0,30,18
1714377809882,SIOC 290S,A01,637330,Merrifield; Mark A,27,0,30,3
1714377810908,SIOC 291S,A01,637333,Gabriel; Corey John,27,0,30,3
1714377811933,SOCI 117,A01,494376,Staff,0,4,5,5
1714377812959,WES 237B,A00,494380,Staff,9,0,20,11
1714377815029,AESE 279B,A00,494370,Wade; Jon P,0,0,33,33
1714377816054,AIP 197,001,627712,Vespa; Emanuel Ignacio,9998,0,9999,1
1714377817085,ANAR 135S,A00,494369,Braswell; Geoffrey E.,0,0,0,0
1714377818112,BENG 196,001,628496,Engler; Adam J.,9998,0,9999,1
1714377819137,CAT 124RS,A01,519847,Geibel; William,0,0,20,20
1714377820160,CAT 125RS,A01,515971,Geibel; William,0,0,20,20
1714377821185,CLRE 250,A00,511389,Morris; Sheldon,9993,0,9999,6
1714377822214,CLRE 251,A00,507176,Mehta; Ravindra L.,9993,0,9999,6
1714377822214,CLRE 251,B00,511410,Mehta; Ravindra L.,9998,0,9999,1
1714377823243,CLRE 252,A00,507189,Cuomo; Raphael Eduardo,9995,0,9999,4
1714377824269,CLRE 253,A00,507199,Vaida; Florin,9994,0,9999,5
1714377824269,CLRE 253,B00,507202,Vaida; Florin,9999,0,9999,0
1714377825296,CLRE 259,A00,507211,Patel; Hemal,9996,0,9999,3
1714377826322,CLRE 260,A00,507221,Cuomo; Raphael Eduardo,9999,0,9999,0
1714377827348,CLRE 297,001,507242,Cuomo; Raphael Eduardo,9999,0,9999,0
1714377828375,COGS 197,001,638244,Voytek; Bradley Thomas,9999,0,9999,0
1714377829401,CSE 191,A00,516875,Minnes Kemp; Mor Mia,9993,0,9999,6
1714377830432,CSE 197,001,637388,Minnes Kemp; Mor Mia,9998,0,9999,1
1714377831458,CSS 201S,A01,494383,Staff,35,0,35,0
1714377832484,CSS 202S,A01,494387,Staff,35,0,35,0
1714377833510,DSC 197,001,628532,Eldridge; Justin Matthew,9996,0,9999,3
1714377834534,EAP 100,A00,516065,Staff,9797,0,9999,202
1714377835560,ECE 45,A01,507414,Staff,33,0,60,27
1714377837611,ECE 111,A01,507420,Staff,19,0,50,31
1714377838638,ECE 197,001,548057,Sievenpiper; Daniel F.,9994,0,9999,5
1714377839666,EDS 115,A00,507243,Choi; Bailey Miyeon,12,0,28,16
1714377840697,EDS 117,A01,494379,Staff,0,2,30,30
1714377841743,EDS 125,A00,507246,Hopkins; Megan Beth,12,0,30,18
1714377842773,EDS 128A,A01,507264,Fargason; Sharon Gayle,14,0,26,12
1714377843800,EDS 128B,A01,507293,Pappas; Elizabeth,18,0,30,12
1714377844829,EDS 139,A00,507294,Fargason; Sharon Gayle,18,0,30,12
1714377844829,EDS 139,B00,507313,Pappas; Elizabeth,15,0,30,15
1714377845855,EDS 201,A00,507315,Staff,13,0,30,17
1714377846887,EDS 203,A01,507317,Halter; Christopher P.,12,0,30,18
1714377847917,EDS 204R,A01,507319,Halter; Christopher P.,0,3,30,30
1714377847917,EDS 204R,B01,507331,Heinzman; Erica M.,17,0,30,13
1714377848943,EDS 206R,A00,507332,Staff,0,4,30,30
1714377848943,EDS 206R,B00,507343,Staff,18,0,30,12
1714377849970,EDS 250,A00,507344,Hemans; Patricia Ann Benitez,22,0,40,18
1714377850996,EDS 281,A00,507345,Daly; Alan J.,18,0,18,0
1714377852021,EDS 284,A00,507350,Daly; Alan J.,16,0,16,0
1714377853051,EDS 286,A00,507359,Fine; Sarah,18,0,18,0
1714377854079,EDS 289C,A01,507361,Daly; Alan J.,18,0,18,0
1714377855109,EDS 290,A00,507366,Hofstetter; Carolyn,15,0,15,0
1714377856135,LIGM 5A,A00,507421,Fischer-Grunski; Eva K,18,0,20,2
1714377857165,LIGM 5B,A00,507423,Fischer-Grunski; Eva K,19,0,20,1
1714377858190,LIGM 5C,A00,507425,Fischer-Grunski; Eva K,19,0,20,1
1714377859217,LIIT 5AS,A00,507427,Carnelos; Chiara,20,0,20,0
1714377860248,LIIT 5BS,A00,507430,Carnelos; Chiara,20,0,20,0
1714377861276,LIIT 5CS,A00,507432,Carnelos; Chiara,20,0,20,0
1714377862303,LISP 5A,A00,507541,Munoz Sanchez; Alicia,11,0,20,9
1714377863328,LISP 5B,A00,507671,Munoz Sanchez; Alicia,9,0,20,11
1714377864356,LISP 5C,A00,507696,Munoz Sanchez; Alicia,9,0,20,11
1714377865380,MAE 197,001,528363,Boechler; Nicholas Sebastia,9998,0,9999,1
1714377866412,MATH 197,001,523477,Kedlaya; Kiran S.,9996,0,9999,3
1714377866412,MATH 197,002,563811,Zhang; Danna,9995,0,9999,4
1714377866412,MATH 197,003,628552,Dumitriu; Ioana,9998,0,9999,1
1714377867438,MCWP 40R,A00,518780,Staff,5,0,20,15
1714377867438,MCWP 40R,B00,518781,Staff,7,0,20,13
1714377867438,MCWP 40R,C00,518783,Staff,5,0,20,15
1714377868464,MCWP 50R,A00,518791,Staff,0,0,20,20
1714377868464,MCWP 50R,B00,518792,Staff,0,1,20,20
1714377868464,MCWP 50R,C00,518793,Staff,0,1,20,20
1714377868464,MCWP 50R,D00,518794,Staff,0,0,20,20
1714377868464,MCWP 50R,E00,518795,Staff,0,1,20,20
1714377868464,MCWP 50R,F00,518796,Staff,0,0,20,20
1714377868464,MCWP 50R,G00,518797,Staff,0,1,20,20
1714377869490,MMW 12R,A01,514034,Herbst; Matthew,0,1,16,16
1714377869490,MMW 12R,A02,514035,Herbst; Matthew,2,0,16,14
1714377870520,MMW 13R,A01,514037,Staff,0,4,16,16
1714377870520,MMW 13R,A02,514039,Staff,0,2,16,16
1714377870520,MMW 13R,A03,628519,Staff,0,2,16,16
1714377872569,SIO 295LS,A00,523233,Staff,12,0,30,18
1714377873594,SIO 295S,A00,523232,Staff,12,0,30,18
1714377874623,SIOC 290S,A01,637330,Merrifield; Mark A,27,0,30,3
1714377875649,SIOC 291S,A01,637333,Gabriel; Corey John,27,0,30,3
1714377876731,SOCI 117,A01,494376,Staff,0,4,5,5
1714377877757,WES 237B,A00,494380,Staff,9,0,20,11
1714377879812,AESE 279B,A00,494370,Wade; Jon P,0,0,33,33
1714377880836,AIP 197,001,627712,Vespa; Emanuel Ignacio,9998,0,9999,1
1714377881862,ANAR 135S,A00,494369,Braswell; Geoffrey E.,0,0,0,0
1714377882885,BENG 196,001,628496,Engler; Adam J.,9998,0,9999,1
1714377883910,CAT 124RS,A01,519847,Geibel; William,0,0,20,20
1714377884938,CAT 125RS,A01,515971,Geibel; William,0,0,20,20
1714377886017,CLRE 250,A00,511389,Morris; Sheldon,9993,0,9999,6
1714377887041,CLRE 251,A00,507176,Mehta; Ravindra L.,9993,0,9999,6
1714377887041,CLRE 251,B00,511410,Mehta; Ravindra L.,9998,0,9999,1
1714377888066,CLRE 252,A00,507189,Cuomo; Raphael Eduardo,9995,0,9999,4
1714377889094,CLRE 253,A00,507199,Vaida; Florin,9994,0,9999,5
1714377889094,CLRE 253,B00,507202,Vaida; Florin,9999,0,9999,0
1714377890120,CLRE 259,A00,507211,Patel; Hemal,9996,0,9999,3
1714377891149,CLRE 260,A00,507221,Cuomo; Raphael Eduardo,9999,0,9999,0
1714377892177,CLRE 297,001,507242,Cuomo; Raphael Eduardo,9999,0,9999,0
1714377893205,COGS 197,001,638244,Voytek; Bradley Thomas,9999,0,9999,0
1714377894232,CSE 191,A00,516875,Minnes Kemp; Mor Mia,9993,0,9999,6
1714377895258,CSE 197,001,637388,Minnes Kemp; Mor Mia,9998,0,9999,1
1714377896285,CSS 201S,A01,494383,Staff,35,0,35,0
1714377897309,CSS 202S,A01,494387,Staff,35,0,35,0
1714377898334,DSC 197,001,628532,Eldridge; Justin Matthew,9996,0,9999,3
1714377899358,EAP 100,A00,516065,Staff,9797,0,9999,202
1714377900384,ECE 45,A01,507414,Staff,33,0,60,27
1714377902436,ECE 111,A01,507420,Staff,19,0,50,31
1714377903463,ECE 197,001,548057,Sievenpiper; Daniel F.,9994,0,9999,5
1714377904492,EDS 115,A00,507243,Choi; Bailey Miyeon,12,0,28,16
1714377905523,EDS 117,A01,494379,Staff,0,2,30,30
1714377906550,EDS 125,A00,507246,Hopkins; Megan Beth,12,0,30,18
1714377907574,EDS 128A,A01,507264,Fargason; Sharon Gayle,14,0,26,12
1714377908605,EDS 128B,A01,507293,Pappas; Elizabeth,18,0,30,12
1714377909631,EDS 139,A00,507294,Fargason; Sharon Gayle,18,0,30,12
1714377909631,EDS 139,B00,507313,Pappas; Elizabeth,15,0,30,15
1714377910657,EDS 201,A00,507315,Staff,13,0,30,17
1714377911682,EDS 203,A01,507317,Halter; Christopher P.,12,0,30,18
1714377912707,EDS 204R,A01,507319,Halter; Christopher P.,0,3,30,30
1714377912707,EDS 204R,B01,507331,Heinzman; Erica M.,17,0,30,13
1714377913732,EDS 206R,A00,507332,Staff,0,4,30,30
1714377913732,EDS 206R,B00,507343,Staff,18,0,30,12
1714377914761,EDS 250,A00,507344,Hemans; Patricia Ann Benitez,22,0,40,18
1714377915788,EDS 281,A00,507345,Daly; Alan J.,18,0,18,0
1714377916814,EDS 284,A00,507350,Daly; Alan J.,16,0,16,0
1714377917840,EDS 286,A00,507359,Fine; Sarah,18,0,18,0
1714377918865,EDS 289C,A01,507361,Daly; Alan J.,18,0,18,0
1714377919895,EDS 290,A00,507366,Hofstetter; Carolyn,15,0,15,0
1714377920922,LIGM 5A,A00,507421,Fischer-Grunski; Eva K,18,0,20,2
1714377921949,LIGM 5B,A00,507423,Fischer-Grunski; Eva K,19,0,20,1
1714377922974,LIGM 5C,A00,507425,Fischer-Grunski; Eva K,19,0,20,1
1714377924001,LIIT 5AS,A00,507427,Carnelos; Chiara,20,0,20,0
1714377925027,LIIT 5BS,A00,507430,Carnelos; Chiara,20,0,20,0
1714377926057,LIIT 5CS,A00,507432,Carnelos; Chiara,20,0,20,0
1714377927082,LISP 5A,A00,507541,Munoz Sanchez; Alicia,11,0,20,9
1714377928106,LISP 5B,A00,507671,Munoz Sanchez; Alicia,9,0,20,11
1714377929132,LISP 5C,A00,507696,Munoz Sanchez; Alicia,9,0,20,11
1714377930160,MAE 197,001,528363,Boechler; Nicholas Sebastia,9998,0,9999,1
1714377931195,MATH 197,001,523477,Kedlaya; Kiran S.,9996,0,9999,3
1714377931195,MATH 197,002,563811,Zhang; Danna,9995,0,9999,4
1714377931195,MATH 197,003,628552,Dumitriu; Ioana,9998,0,9999,1
1714377932225,MCWP 40R,A00,518780,Staff,5,0,20,15
1714377932225,MCWP 40R,B00,518781,Staff,7,0,20,13
1714377932225,MCWP 40R,C00,518783,Staff,5,0,20,15
1714377933252,MCWP 50R,A00,518791,Staff,0,0,20,20
1714377933252,MCWP 50R,B00,518792,Staff,0,1,20,20
1714377933252,MCWP 50R,C00,518793,Staff,0,1,20,20
1714377933252,MCWP 50R,D00,518794,Staff,0,0,20,20
1714377933252,MCWP 50R,E00,518795,Staff,0,1,20,20
1714377933252,MCWP 50R,F00,518796,Staff,0,0,20,20
1714377933252,MCWP 50R,G00,518797,Staff,0,1,20,20
1714377934278,MMW 12R,A01,514034,Herbst; Matthew,0,1,16,16
1714377934278,MMW 12R,A02,514035,Herbst; Matthew,2,0,16,14
1714377935305,MMW 13R,A01,514037,Staff,0,4,16,16
1714377935305,MMW 13R,A02,514039,Staff,0,2,16,16
1714377935305,MMW 13R,A03,628519,Staff,0,2,16,16
1714377937358,SIO 295LS,A00,523233,Staff,12,0,30,18
1714377938382,SIO 295S,A00,523232,Staff,12,0,30,18
1714377939412,SIOC 290S,A01,637330,Merrifield; Mark A,27,0,30,3
1714377940436,SIOC 291S,A01,637333,Gabriel; Corey John,27,0,30,3
1714377941467,SOCI 117,A01,494376,Staff,0,4,5,5
1714377942493,WES 237B,A00,494380,Staff,9,0,20,11
1714377944572,AESE 279B,A00,494370,Wade; Jon P,0,0,33,33
1714377945598,AIP 197,001,627712,Vespa; Emanuel Ignacio,9998,0,9999,1
1714377946632,ANAR 135S,A00,494369,Braswell; Geoffrey E.,0,0,0,0
1714377947659,BENG 196,001,628496,Engler; Adam J.,9998,0,9999,1
1714377948686,CAT 124RS,A01,519847,Geibel; William,0,0,20,20
1714377949711,CAT 125RS,A01,515971,Geibel; William,0,0,20,20
1714377950736,CLRE 250,A00,511389,Morris; Sheldon,9993,0,9999,6
1714377951763,CLRE 251,A00,507176,Mehta; Ravindra L.,9993,0,9999,6
1714377951763,CLRE 251,B00,511410,Mehta; Ravindra L.,9998,0,9999,1
1714377952789,CLRE 252,A00,507189,Cuomo; Raphael Eduardo,9995,0,9999,4
1714377953818,CLRE 253,A00,507199,Vaida; Florin,9994,0,9999,5
1714377953818,CLRE 253,B00,507202,Vaida; Florin,9999,0,9999,0
1714377954843,CLRE 259,A00,507211,Patel; Hemal,9996,0,9999,3
1714377955872,CLRE 260,A00,507221,Cuomo; Raphael Eduardo,9999,0,9999,0
1714377956897,CLRE 297,001,507242,Cuomo; Raphael Eduardo,9999,0,9999,0
1714377957925,COGS 197,001,638244,Voytek; Bradley Thomas,9999,0,9999,0
1714377958951,CSE 191,A00,516875,Minnes Kemp; Mor Mia,9993,0,9999,6
1714377959977,CSE 197,001,637388,Minnes Kemp; Mor Mia,9998,0,9999,1
1714377961002,CSS 201S,A01,494383,Staff,35,0,35,0
1714377962028,CSS 202S,A01,494387,Staff,35,0,35,0
1714377963057,DSC 197,001,628532,Eldridge; Justin Matthew,9996,0,9999,3
1714377964082,EAP 100,A00,516065,Staff,9797,0,9999,202
1714377965113,ECE 45,A01,507414,Staff,33,0,60,27
1714377967165,ECE 111,A01,507420,Staff,19,0,50,31
1714377968194,ECE 197,001,548057,Sievenpiper; Daniel F.,9994,0,9999,5
1714377969221,EDS 115,A00,507243,Choi; Bailey Miyeon,12,0,28,16
1714377970248,EDS 117,A01,494379,Staff,0,2,30,30
1714377971273,EDS 125,A00,507246,Hopkins; Megan Beth,12,0,30,18
1714377972303,EDS 128A,A01,507264,Fargason; Sharon Gayle,14,0,26,12
1714377973328,EDS 128B,A01,507293,Pappas; Elizabeth,18,0,30,12
1714377974354,EDS 139,A00,507294,Fargason; Sharon Gayle,18,0,30,12
1714377974354,EDS 139,B00,507313,Pappas; Elizabeth,15,0,30,15
1714377975380,EDS 201,A00,507315,Staff,13,0,30,17
1714377976403,EDS 203,A01,507317,Halter; Christopher P.,12,0,30,18
1714377977430,EDS 204R,A01,507319,Halter; Christopher P.,0,3,30,30
1714377977430,EDS 204R,B01,507331,Heinzman; Erica M.,17,0,30,13
1714377978458,EDS 206R,A00,507332,Staff,0,4,30,30
1714377978458,EDS 206R,B00,507343,Staff,18,0,30,12
1714377979486,EDS 250,A00,507344,Hemans; Patricia Ann Benitez,22,0,40,18
1714377980516,EDS 281,A00,507345,Daly; Alan J.,18,0,18,0
1714377981543,EDS 284,A00,507350,Daly; Alan J.,16,0,16,0
1714377982612,EDS 286,A00,507359,Fine; Sarah,18,0,18,0
1714377983641,EDS 289C,A01,507361,Daly; Alan J.,18,0,18,0
1714377984671,EDS 290,A00,507366,Hofstetter; Carolyn,15,0,15,0
1714377985697,LIGM 5A,A00,507421,Fischer-Grunski; Eva K,18,0,20,2
1714377986723,LIGM 5B,A00,507423,Fischer-Grunski; Eva K,19,0,20,1
1714377987753,LIGM 5C,A00,507425,Fischer-Grunski; Eva K,19,0,20,1
1714377988809,LIIT 5AS,A00,507427,Carnelos; Chiara,20,0,20,0
1714377989887,LIIT 5BS,A00,507430,Carnelos; Chiara,20,0,20,0
1714377990913,LIIT 5CS,A00,507432,Carnelos; Chiara,20,0,20,0
1714377991942,LISP 5A,A00,507541,Munoz Sanchez; Alicia,11,0,20,9
1714377992970,LISP 5B,A00,507671,Munoz Sanchez; Alicia,9,0,20,11
1714377993996,LISP 5C,A00,507696,Munoz Sanchez; Alicia,9,0,20,11
1714377995024,MAE 197,001,528363,Boechler; Nicholas Sebastia,9998,0,9999,1
1714377996048,MATH 197,001,523477,Kedlaya; Kiran S.,9996,0,9999,3
1714377996048,MATH 197,002,563811,Zhang; Danna,9995,0,9999,4
1714377996048,MATH 197,003,628552,Dumitriu; Ioana,9998,0,9999,1
1714377997073,MCWP 40R,A00,518780,Staff,5,0,20,15
1714377997073,MCWP 40R,B00,518781,Staff,7,0,20,13
1714377997073,MCWP 40R,C00,518783,Staff,5,0,20,15
1714377998104,MCWP 50R,A00,518791,Staff,0,0,20,20
1714377998104,MCWP 50R,B00,518792,Staff,0,1,20,20
1714377998104,MCWP 50R,C00,518793,Staff,0,1,20,20
1714377998104,MCWP 50R,D00,518794,Staff,0,0,20,20
1714377998104,MCWP 50R,E00,518795,Staff,0,1,20,20
1714377998104,MCWP 50R,F00,518796,Staff,0,0,20,20
1714377998104,MCWP 50R,G00,518797,Staff,0,1,20,20
1714377999130,MMW 12R,A01,514034,Herbst; Matthew,0,1,16,16
1714377999130,MMW 12R,A02,514035,Herbst; Matthew,2,0,16,14
1714378000155,MMW 13R,A01,514037,Staff,0,4,16,16
1714378000155,MMW 13R,A02,514039,Staff,0,2,16,16
1714378000155,MMW 13R,A03,628519,Staff,0,2,16,16
1714378002209,SIO 295LS,A00,523233,Staff,12,0,30,18
1714378003233,SIO 295S,A00,523232,Staff,12,0,30,18
1714378004259,SIOC 290S,A01,637330,Merrifield; Mark A,27,0,30,3
1714378005287,SIOC 291S,A01,637333,Gabriel; Corey John,27,0,30,3
1714378006318,SOCI 117,A01,494376,Staff,0,4,5,5
1714378007343,WES 237B,A00,494380,Staff,9,0,20,11
1714378009406,AESE 279B,A00,494370,Wade; Jon P,0,0,33,33
1714378010433,AIP 197,001,627712,Vespa; Emanuel Ignacio,9998,0,9999,1
1714378011457,ANAR 135S,A00,494369,Braswell; Geoffrey E.,0,0,0,0
1714378012482,BENG 196,001,628496,Engler; Adam J.,9998,0,9999,1
1714378013508,CAT 124RS,A01,519847,Geibel; William,0,0,20,20
1714378014533,CAT 125RS,A01,515971,Geibel; William,0,0,20,20
1714378015559,CLRE 250,A00,511389,Morris; Sheldon,9993,0,9999,6
1714378016588,CLRE 251,A00,507176,Mehta; Ravindra L.,9993,0,9999,6
1714378016588,CLRE 251,B00,511410,Mehta; Ravindra L.,9998,0,9999,1
1714378017613,CLRE 252,A00,507189,Cuomo; Raphael Eduardo,9995,0,9999,4
1714378018639,CLRE 253,A00,507199,Vaida; Florin,9994,0,9999,5
1714378018639,CLRE 253,B00,507202,Vaida; Florin,9999,0,9999,0
1714378019663,CLRE 259,A00,507211,Patel; Hemal,9996,0,9999,3
1714378020688,CLRE 260,A00,507221,Cuomo; Raphael Eduardo,9999,0,9999,0
1714378021716,CLRE 297,001,507242,Cuomo; Raphael Eduardo,9999,0,9999,0
1714378022744,COGS 197,001,638244,Voytek; Bradley Thomas,9999,0,9999,0
1714378023769,CSE 191,A00,516875,Minnes Kemp; Mor Mia,9993,0,9999,6
1714378024796,CSE 197,001,637388,Minnes Kemp; Mor Mia,9998,0,9999,1
1714378025823,CSS 201S,A01,494383,Staff,35,0,35,0
1714378026847,CSS 202S,A01,494387,Staff,35,0,35,0
1714378027872,DSC 197,001,628532,Eldridge; Justin Matthew,9996,0,9999,3
1714378028899,EAP 100,A00,516065,Staff,9797,0,9999,202
1714378029928,ECE 45,A01,507414,Staff,33,0,60,27
1714378031979,ECE 111,A01,507420,Staff,19,0,50,31
1714378033008,ECE 197,001,548057,Sievenpiper; Daniel F.,9994,0,9999,5
1714378034033,EDS 115,A00,507243,Choi; Bailey Miyeon,12,0,28,16
1714378035058,EDS 117,A01,494379,Staff,0,2,30,30
1714378036087,EDS 125,A00,507246,Hopkins; Megan Beth,12,0,30,18
1714378037117,EDS 128A,A01,507264,Fargason; Sharon Gayle,14,0,26,12
1714378038144,EDS 128B,A01,507293,Pappas; Elizabeth,18,0,30,12
1714378039169,EDS 139,A00,507294,Fargason; Sharon Gayle,18,0,30,12
1714378039169,EDS 139,B00,507313,Pappas; Elizabeth,15,0,30,15
1714378040197,EDS 201,A00,507315,Staff,13,0,30,17
1714378041227,EDS 203,A01,507317,Halter; Christopher P.,12,0,30,18
1714378042258,EDS 204R,A01,507319,Halter; Christopher P.,0,3,30,30
1714378042258,EDS 204R,B01,507331,Heinzman; Erica M.,17,0,30,13
1714378043286,EDS 206R,A00,507332,Staff,0,4,30,30
1714378043286,EDS 206R,B00,507343,Staff,18,0,30,12
1714378044316,EDS 250,A00,507344,Hemans; Patricia Ann Benitez,22,0,40,18
1714378045342,EDS 281,A00,507345,Daly; Alan J.,18,0,18,0
1714378046368,EDS 284,A00,507350,Daly; Alan J.,16,0,16,0
1714378047394,EDS 286,A00,507359,Fine; Sarah,18,0,18,0
1714378048422,EDS 289C,A01,507361,Daly; Alan J.,18,0,18,0
1714378049447,EDS 290,A00,507366,Hofstetter; Carolyn,15,0,15,0
1714378050479,LIGM 5A,A00,507421,Fischer-Grunski; Eva K,18,0,20,2
1714378051505,LIGM 5B,A00,507423,Fischer-Grunski; Eva K,19,0,20,1
1714378052534,LIGM 5C,A00,507425,Fischer-Grunski; Eva K,19,0,20,1
1714378053561,LIIT 5AS,A00,507427,Carnelos; Chiara,20,0,20,0
1714378054586,LIIT 5BS,A00,507430,Carnelos; Chiara,20,0,20,0
1714378055613,LIIT 5CS,A00,507432,Carnelos; Chiara,20,0,20,0
1714378056643,LISP 5A,A00,507541,Munoz Sanchez; Alicia,11,0,20,9
1714378057668,LISP 5B,A00,507671,Munoz Sanchez; Alicia,9,0,20,11
1714378058697,LISP 5C,A00,507696,Munoz Sanchez; Alicia,9,0,20,11
1714378059724,MAE 197,001,528363,Boechler; Nicholas Sebastia,9998,0,9999,1
1714378060750,MATH 197,001,523477,Kedlaya; Kiran S.,9996,0,9999,3
1714378060750,MATH 197,002,563811,Zhang; Danna,9995,0,9999,4
1714378060750,MATH 197,003,628552,Dumitriu; Ioana,9998,0,9999,1
1714378061773,MCWP 40R,A00,518780,Staff,5,0,20,15
1714378061773,MCWP 40R,B00,518781,Staff,7,0,20,13
1714378061773,MCWP 40R,C00,518783,Staff,5,0,20,15
1714378062805,MCWP 50R,A00,518791,Staff,0,0,20,20
1714378062805,MCWP 50R,B00,518792,Staff,0,1,20,20
1714378062805,MCWP 50R,C00,518793,Staff,0,1,20,20
1714378062805,MCWP 50R,D00,518794,Staff,0,0,20,20
1714378062805,MCWP 50R,E00,518795,Staff,0,1,20,20
1714378062805,MCWP 50R,F00,518796,Staff,0,0,20,20
1714378062805,MCWP 50R,G00,518797,Staff,0,1,20,20
1714378063833,MMW 12R,A01,514034,Herbst; Matthew,0,1,16,16
1714378063833,MMW 12R,A02,514035,Herbst; Matthew,2,0,16,14
1714378064860,MMW 13R,A01,514037,Staff,0,4,16,16
1714378064860,MMW 13R,A02,514039,Staff,0,2,16,16
1714378064860,MMW 13R,A03,628519,Staff,0,2,16,16
1714378066914,SIO 295LS,A00,523233,Staff,12,0,30,18
1714378067939,SIO 295S,A00,523232,Staff,12,0,30,18
1714378068966,SIOC 290S,A01,637330,Merrifield; Mark A,27,0,30,3
1714378069992,SIOC 291S,A01,637333,Gabriel; Corey John,27,0,30,3
1714378071019,SOCI 117,A01,494376,Staff,0,4,5,5
1714378072043,WES 237B,A00,494380,Staff,9,0,20,11
1714378074114,AESE 279B,A00,494370,Wade; Jon P,0,0,33,33
1714378075139,AIP 197,001,627712,Vespa; Emanuel Ignacio,9998,0,9999,1
1714378076166,ANAR 135S,A00,494369,Braswell; Geoffrey E.,0,0,0,0
1714378077190,BENG 196,001,628496,Engler; Adam J.,9998,0,9999,1
1714378078227,CAT 124RS,A01,519847,Geibel; William,0,0,20,20
1714378079251,CAT 125RS,A01,515971,Geibel; William,0,0,20,20
1714378080281,CLRE 250,A00,511389,Morris; Sheldon,9993,0,9999,6
1714378081307,CLRE 251,A00,507176,Mehta; Ravindra L.,9993,0,9999,6
1714378081307,CLRE 251,B00,511410,Mehta; Ravindra L.,9998,0,9999,1
1714378082332,CLRE 252,A00,507189,Cuomo; Raphael Eduardo,9995,0,9999,4
1714378083363,CLRE 253,A00,507199,Vaida; Florin,9994,0,9999,5
1714378083363,CLRE 253,B00,507202,Vaida; Florin,9999,0,9999,0
1714378084388,CLRE 259,A00,507211,Patel; Hemal,9996,0,9999,3
1714378085414,CLRE 260,A00,507221,Cuomo; Raphael Eduardo,9999,0,9999,0
1714378086440,CLRE 297,001,507242,Cuomo; Raphael Eduardo,9999,0,9999,0
1714378087468,COGS 197,001,638244,Voytek; Bradley Thomas,9999,0,9999,0
1714378088495,CSE 191,A00,516875,Minnes Kemp; Mor Mia,9993,0,9999,6
1714378089522,CSE 197,001,637388,Minnes Kemp; Mor Mia,9998,0,9999,1
1714378090554,CSS 201S,A01,494383,Staff,35,0,35,0
1714378091582,CSS 202S,A01,494387,Staff,35,0,35,0
1714378092606,DSC 197,001,628532,Eldridge; Justin Matthew,9996,0,9999,3
1714378093705,EAP 100,A00,516065,Staff,9797,0,9999,202
1714378094735,ECE 45,A01,507414,Staff,33,0,60,27
1714378096785,ECE 111,A01,507420,Staff,19,0,50,31
1714378097810,ECE 197,001,548057,Sievenpiper; Daniel F.,9994,0,9999,5
1714378098842,EDS 115,A00,507243,Choi; Bailey Miyeon,12,0,28,16
1714378099867,EDS 117,A01,494379,Staff,0,2,30,30
1714378100891,EDS 125,A00,507246,Hopkins; Megan Beth,12,0,30,18
1714378101918,EDS 128A,A01,507264,Fargason; Sharon Gayle,14,0,26,12
1714378102947,EDS 128B,A01,507293,Pappas; Elizabeth,18,0,30,12
1714378103971,EDS 139,A00,507294,Fargason; Sharon Gayle,18,0,30,12
1714378103971,EDS 139,B00,507313,Pappas; Elizabeth,15,0,30,15
1714378104995,EDS 201,A00,507315,Staff,13,0,30,17
1714378106026,EDS 203,A01,507317,Halter; Christopher P.,12,0,30,18
1714378107057,EDS 204R,A01,507319,Halter; Christopher P.,0,3,30,30
1714378107057,EDS 204R,B01,507331,Heinzman; Erica M.,17,0,30,13
1714378108081,EDS 206R,A00,507332,Staff,0,4,30,30
1714378108081,EDS 206R,B00,507343,Staff,18,0,30,12
1714378109119,EDS 250,A00,507344,Hemans; Patricia Ann Benitez,22,0,40,18
1714378110144,EDS 281,A00,507345,Daly; Alan J.,18,0,18,0
1714378111171,EDS 284,A00,507350,Daly; Alan J.,16,0,16,0
1714378112197,EDS 286,A00,507359,Fine; Sarah,18,0,18,0
1714378113225,EDS 289C,A01,507361,Daly; Alan J.,18,0,18,0
1714378114255,EDS 290,A00,507366,Hofstetter; Carolyn,15,0,15,0
1714378115282,LIGM 5A,A00,507421,Fischer-Grunski; Eva K,18,0,20,2
1714378116309,LIGM 5B,A00,507423,Fischer-Grunski; Eva K,19,0,20,1
1714378117336,LIGM 5C,A00,507425,Fischer-Grunski; Eva K,19,0,20,1
1714378118362,LIIT 5AS,A00,507427,Carnelos; Chiara,20,0,20,0
1714378119386,LIIT 5BS,A00,507430,Carnelos; Chiara,20,0,20,0
1714378120418,LIIT 5CS,A00,507432,Carnelos; Chiara,20,0,20,0
1714378121444,LISP 5A,A00,507541,Munoz Sanchez; Alicia,11,0,20,9
1714378122475,LISP 5B,A00,507671,Munoz Sanchez; Alicia,9,0,20,11
1714378123500,LISP 5C,A00,507696,Munoz Sanchez; Alicia,9,0,20,11
1714378124528,MAE 197,001,528363,Boechler; Nicholas Sebastia,9998,0,9999,1
1714378125554,MATH 197,001,523477,Kedlaya; Kiran S.,9996,0,9999,3
1714378125554,MATH 197,002,563811,Zhang; Danna,9995,0,9999,4
1714378125554,MATH 197,003,628552,Dumitriu; Ioana,9998,0,9999,1
1714378126579,MCWP 40R,A00,518780,Staff,5,0,20,15
1714378126579,MCWP 40R,B00,518781,Staff,7,0,20,13
1714378126579,MCWP 40R,C00,518783,Staff,5,0,20,15
1714378127610,MCWP 50R,A00,518791,Staff,0,0,20,20
1714378127610,MCWP 50R,B00,518792,Staff,0,1,20,20
1714378127610,MCWP 50R,C00,518793,Staff,0,1,20,20
1714378127610,MCWP 50R,D00,518794,Staff,0,0,20,20
1714378127610,MCWP 50R,E00,518795,Staff,0,1,20,20
1714378127610,MCWP 50R,F00,518796,Staff,0,0,20,20
1714378127610,MCWP 50R,G00,518797,Staff,0,1,20,20
1714378128637,MMW 12R,A01,514034,Herbst; Matthew,0,1,16,16
1714378128637,MMW 12R,A02,514035,Herbst; Matthew,2,0,16,14
1714378129668,MMW 13R,A01,514037,Staff,0,4,16,16
1714378129668,MMW 13R,A02,514039,Staff,0,2,16,16
1714378129668,MMW 13R,A03,628519,Staff,0,2,16,16
1714378131721,SIO 295LS,A00,523233,Staff,12,0,30,18
1714378132749,SIO 295S,A00,523232,Staff,12,0,30,18
1714378133778,SIOC 290S,A01,637330,Merrifield; Mark A,27,0,30,3
1714378134804,SIOC 291S,A01,637333,Gabriel; Corey John,27,0,30,3
1714378135832,SOCI 117,A01,494376,Staff,0,4,5,5
1714378136858,WES 237B,A00,494380,Staff,9,0,20,11
1714378138930,AESE 279B,A00,494370,Wade; Jon P,0,0,33,33
1714378139957,AIP 197,001,627712,Vespa; Emanuel Ignacio,9998,0,9999,1
1714378140985,ANAR 135S,A00,494369,Braswell; Geoffrey E.,0,0,0,0
1714378142010,BENG 196,001,628496,Engler; Adam J.,9998,0,9999,1
1714378143035,CAT 124RS,A01,519847,Geibel; William,0,0,20,20
1714378144063,CAT 125RS,A01,515971,Geibel; William,0,0,20,20
1714378145092,CLRE 250,A00,511389,Morris; Sheldon,9993,0,9999,6
1714378146118,CLRE 251,A00,507176,Mehta; Ravindra L.,9993,0,9999,6
1714378146118,CLRE 251,B00,511410,Mehta; Ravindra L.,9998,0,9999,1
1714378147143,CLRE 252,A00,507189,Cuomo; Raphael Eduardo,9995,0,9999,4
1714378148169,CLRE 253,A00,507199,Vaida; Florin,9994,0,9999,5
1714378148169,CLRE 253,B00,507202,Vaida; Florin,9999,0,9999,0
1714378149194,CLRE 259,A00,507211,Patel; Hemal,9996,0,9999,3
1714378150218,CLRE 260,A00,507221,Cuomo; Raphael Eduardo,9999,0,9999,0
1714378151244,CLRE 297,001,507242,Cuomo; Raphael Eduardo,9999,0,9999,0
1714378152271,COGS 197,001,638244,Voytek; Bradley Thomas,9999,0,9999,0
1714378153296,CSE 191,A00,516875,Minnes Kemp; Mor Mia,9993,0,9999,6
1714378154322,CSE 197,001,637388,Minnes Kemp; Mor Mia,9998,0,9999,1
1714378155349,CSS 201S,A01,494383,Staff,35,0,35,0
1714378156372,CSS 202S,A01,494387,Staff,35,0,35,0
1714378157397,DSC 197,001,628532,Eldridge; Justin Matthew,9996,0,9999,3
1714378158423,EAP 100,A00,516065,Staff,9797,0,9999,202
1714378159447,ECE 45,A01,507414,Staff,33,0,60,27
1714378161498,ECE 111,A01,507420,Staff,19,0,50,31
1714378162523,ECE 197,001,548057,Sievenpiper; Daniel F.,9994,0,9999,5
1714378163556,EDS 115,A00,507243,Choi; Bailey Miyeon,12,0,28,16
1714378164586,EDS 117,A01,494379,Staff,0,2,30,30
1714378165613,EDS 125,A00,507246,Hopkins; Megan Beth,12,0,30,18
1714378166637,EDS 128A,A01,507264,Fargason; Sharon Gayle,14,0,26,12
1714378167662,EDS 128B,A01,507293,Pappas; Elizabeth,18,0,30,12
1714378168687,EDS 139,A00,507294,Fargason; Sharon Gayle,18,0,30,12
1714378168687,EDS 139,B00,507313,Pappas; Elizabeth,15,0,30,15
1714378169717,EDS 201,A00,507315,Staff,13,0,30,17
1714378170741,EDS 203,A01,507317,Halter; Christopher P.,12,0,30,18
1714378171766,EDS 204R,A01,507319,Halter; Christopher P.,0,3,30,30
1714378171766,EDS 204R,B01,507331,Heinzman; Erica M.,17,0,30,13
1714378172790,EDS 206R,A00,507332,Staff,0,4,30,30
1714378172790,EDS 206R,B00,507343,Staff,18,0,30,12
1714378173820,EDS 250,A00,507344,Hemans; Patricia Ann Benitez,22,0,40,18
1714378174845,EDS 281,A00,507345,Daly; Alan J.,18,0,18,0
1714378175875,EDS 284,A00,507350,Daly; Alan J.,16,0,16,0
1714378176901,EDS 286,A00,507359,Fine; Sarah,18,0,18,0
1714378177929,EDS 289C,A01,507361,Daly; Alan J.,18,0,18,0
1714378178958,EDS 290,A00,507366,Hofstetter; Carolyn,15,0,15,0
1714378179984,LIGM 5A,A00,507421,Fischer-Grunski; Eva K,18,0,20,2
1714378181011,LIGM 5B,A00,507423,Fischer-Grunski; Eva K,19,0,20,1
1714378182039,LIGM 5C,A00,507425,Fischer-Grunski; Eva K,19,0,20,1
1714378183064,LIIT 5AS,A00,507427,Carnelos; Chiara,20,0,20,0
1714378184089,LIIT 5BS,A00,507430,Carnelos; Chiara,20,0,20,0
1714378185115,LIIT 5CS,A00,507432,Carnelos; Chiara,20,0,20,0
1714378186140,LISP 5A,A00,507541,Munoz Sanchez; Alicia,11,0,20,9
1714378187166,LISP 5B,A00,507671,Munoz Sanchez; Alicia,9,0,20,11
1714378188191,LISP 5C,A00,507696,Munoz Sanchez; Alicia,9,0,20,11
1714378189221,MAE 197,001,528363,Boechler; Nicholas Sebastia,9998,0,9999,1
1714378190250,MATH 197,001,523477,Kedlaya; Kiran S.,9996,0,9999,3
1714378190250,MATH 197,002,563811,Zhang; Danna,9995,0,9999,4
1714378190250,MATH 197,003,628552,Dumitriu; Ioana,9998,0,9999,1
1714378191277,MCWP 40R,A00,518780,Staff,5,0,20,15
1714378191277,MCWP 40R,B00,518781,Staff,7,0,20,13
1714378191277,MCWP 40R,C00,518783,Staff,5,0,20,15
1714378192305,MCWP 50R,A00,518791,Staff,0,0,20,20
1714378192305,MCWP 50R,B00,518792,Staff,0,1,20,20
1714378192305,MCWP 50R,C00,518793,Staff,0,1,20,20
1714378192305,MCWP 50R,D00,518794,Staff,0,0,20,20
1714378192305,MCWP 50R,E00,518795,Staff,0,1,20,20
1714378192305,MCWP 50R,F00,518796,Staff,0,0,20,20
1714378192305,MCWP 50R,G00,518797,Staff,0,1,20,20
1714378193335,MMW 12R,A01,514034,Herbst; Matthew,0,1,16,16
1714378193335,MMW 12R,A02,514035,Herbst; Matthew,2,0,16,14
1714378194361,MMW 13R,A01,514037,Staff,0,4,16,16
1714378194361,MMW 13R,A02,514039,Staff,0,2,16,16
1714378194361,MMW 13R,A03,628519,Staff,0,2,16,16
1714378196416,SIO 295LS,A00,523233,Staff,12,0,30,18
1714378197515,SIO 295S,A00,523232,Staff,12,0,30,18
1714378198540,SIOC 290S,A01,637330,Merrifield; Mark A,27,0,30,3
1714378199570,SIOC 291S,A01,637333,Gabriel; Corey John,27,0,30,3
1714378200596,SOCI 117,A01,494376,Staff,0,4,5,5
1714378201623,WES 237B,A00,494380,Staff,9,0,20,11
1714378203680,AESE 279B,A00,494370,Wade; Jon P,0,0,33,33
1714378204705,AIP 197,001,627712,Vespa; Emanuel Ignacio,9998,0,9999,1
1714378205730,ANAR 135S,A00,494369,Braswell; Geoffrey E.,0,0,0,0
1714378206756,BENG 196,001,628496,Engler; Adam J.,9998,0,9999,1
1714378207780,CAT 124RS,A01,519847,Geibel; William,0,0,20,20
1714378208807,CAT 125RS,A01,515971,Geibel; William,0,0,20,20
1714378209832,CLRE 250,A00,511389,Morris; Sheldon,9993,0,9999,6
1714378210867,CLRE 251,A00,507176,Mehta; Ravindra L.,9993,0,9999,6
1714378210867,CLRE 251,B00,511410,Mehta; Ravindra L.,9998,0,9999,1
1714378211933,CLRE 252,A00,507189,Cuomo; Raphael Eduardo,9995,0,9999,4
1714378212959,CLRE 253,A00,507199,Vaida; Florin,9994,0,9999,5
1714378212959,CLRE 253,B00,507202,Vaida; Florin,9999,0,9999,0
1714378213987,CLRE 259,A00,507211,Patel; Hemal,9996,0,9999,3
1714378215012,CLRE 260,A00,507221,Cuomo; Raphael Eduardo,9999,0,9999,0
1714378216037,CLRE 297,001,507242,Cuomo; Raphael Eduardo,9999,0,9999,0
1714378217065,COGS 197,001,638244,Voytek; Bradley Thomas,9999,0,9999,0
1714378218090,CSE 191,A00,516875,Minnes Kemp; Mor Mia,9993,0,9999,6
1714378219120,CSE 197,001,637388,Minnes Kemp; Mor Mia,9998,0,9999,1
1714378220155,CSS 201S,A01,494383,Staff,35,0,35,0
1714378221182,CSS 202S,A01,494387,Staff,35,0,35,0
1714378222210,DSC 197,001,628532,Eldridge; Justin Matthew,9996,0,9999,3
1714378223238,EAP 100,A00,516065,Staff,9797,0,9999,202
1714378224263,ECE 45,A01,507414,Staff,33,0,60,27
1714378226317,ECE 111,A01,507420,Staff,19,0,50,31
1714378227348,ECE 197,001,548057,Sievenpiper; Daniel F.,9994,0,9999,5
1714378228375,EDS 115,A00,507243,Choi; Bailey Miyeon,12,0,28,16
1714378229402,EDS 117,A01,494379,Staff,0,2,30,30
1714378230428,EDS 125,A00,507246,Hopkins; Megan Beth,12,0,30,18
1714378231454,EDS 128A,A01,507264,Fargason; Sharon Gayle,14,0,26,12
1714378232482,EDS 128B,A01,507293,Pappas; Elizabeth,18,0,30,12
1714378233509,EDS 139,A00,507294,Fargason; Sharon Gayle,18,0,30,12
1714378233509,EDS 139,B00,507313,Pappas; Elizabeth,15,0,30,15
1714378234535,EDS 201,A00,507315,Staff,13,0,30,17
1714378235564,EDS 203,A01,507317,Halter; Christopher P.,12,0,30,18
1714378236591,EDS 204R,A01,507319,Halter; Christopher P.,0,3,30,30
1714378236591,EDS 204R,B01,507331,Heinzman; Erica M.,17,0,30,13
1714378237616,EDS 206R,A00,507332,Staff,0,4,30,30
1714378237616,EDS 206R,B00,507343,Staff,18,0,30,12
1714378238645,EDS 250,A00,507344,Hemans; Patricia Ann Benitez,22,0,40,18
1714378239670,EDS 281,A00,507345,Daly; Alan J.,18,0,18,0
1714378240694,EDS 284,A00,507350,Daly; Alan J.,16,0,16,0
1714378241723,EDS 286,A00,507359,Fine; Sarah,18,0,18,0
1714378242749,EDS 289C,A01,507361,Daly; Alan J.,18,0,18,0
1714378243777,EDS 290,A00,507366,Hofstetter; Carolyn,15,0,15,0
1714378244805,LIGM 5A,A00,507421,Fischer-Grunski; Eva K,18,0,20,2
1714378245831,LIGM 5B,A00,507423,Fischer-Grunski; Eva K,19,0,20,1
1714378246855,LIGM 5C,A00,507425,Fischer-Grunski; Eva K,19,0,20,1
1714378247881,LIIT 5AS,A00,507427,Carnelos; Chiara,20,0,20,0
1714378248912,LIIT 5BS,A00,507430,Carnelos; Chiara,20,0,20,0
1714378249936,LIIT 5CS,A00,507432,Carnelos; Chiara,20,0,20,0
1714378250961,LISP 5A,A00,507541,Munoz Sanchez; Alicia,11,0,20,9
1714378251988,LISP 5B,A00,507671,Munoz Sanchez; Alicia,9,0,20,11
1714378253018,LISP 5C,A00,507696,Munoz Sanchez; Alicia,9,0,20,11
1714378254043,MAE 197,001,528363,Boechler; Nicholas Sebastia,9998,0,9999,1
1714378255071,MATH 197,001,523477,Kedlaya; Kiran S.,9996,0,9999,3
1714378255071,MATH 197,002,563811,Zhang; Danna,9995,0,9999,4
1714378255071,MATH 197,003,628552,Dumitriu; Ioana,9998,0,9999,1
1714378256096,MCWP 40R,A00,518780,Staff,5,0,20,15
1714378256096,MCWP 40R,B00,518781,Staff,7,0,20,13
1714378256096,MCWP 40R,C00,518783,Staff,5,0,20,15
1714378257123,MCWP 50R,A00,518791,Staff,0,0,20,20
1714378257123,MCWP 50R,B00,518792,Staff,0,1,20,20
1714378257123,MCWP 50R,C00,518793,Staff,0,1,20,20
1714378257123,MCWP 50R,D00,518794,Staff,0,0,20,20
1714378257123,MCWP 50R,E00,518795,Staff,0,1,20,20
1714378257123,MCWP 50R,F00,518796,Staff,0,0,20,20
1714378257123,MCWP 50R,G00,518797,Staff,0,1,20,20
1714378258153,MMW 12R,A01,514034,Herbst; Matthew,0,1,16,16
1714378258153,MMW 12R,A02,514035,Herbst; Matthew,2,0,16,14
1714378259179,MMW 13R,A01,514037,Staff,0,4,16,16
1714378259179,MMW 13R,A02,514039,Staff,0,2,16,16
1714378259179,MMW 13R,A03,628519,Staff,0,2,16,16
1714378261230,SIO 295LS,A00,523233,Staff,12,0,30,18
1714378262259,SIO 295S,A00,523232,Staff,12,0,30,18
1714378263286,SIOC 290S,A01,637330,Merrifield; Mark A,27,0,30,3
1714378264312,SIOC 291S,A01,637333,Gabriel; Corey John,27,0,30,3
1714378265342,SOCI 117,A01,494376,Staff,0,4,5,5
1714378266371,WES 237B,A00,494380,Staff,9,0,20,11
1714378268457,AESE 279B,A00,494370,Wade; Jon P,0,0,33,33
1714378269483,AIP 197,001,627712,Vespa; Emanuel Ignacio,9998,0,9999,1
1714378270509,ANAR 135S,A00,494369,Braswell; Geoffrey E.,0,0,0,0
1714378271537,BENG 196,001,628496,Engler; Adam J.,9998,0,9999,1
1714378272564,CAT 124RS,A01,519847,Geibel; William,0,0,20,20
1714378273592,CAT 125RS,A01,515971,Geibel; William,0,0,20,20
1714378274622,CLRE 250,A00,511389,Morris; Sheldon,9993,0,9999,6
1714378275652,CLRE 251,A00,507176,Mehta; Ravindra L.,9993,0,9999,6
1714378275652,CLRE 251,B00,511410,Mehta; Ravindra L.,9998,0,9999,1
1714378276678,CLRE 252,A00,507189,Cuomo; Raphael Eduardo,9995,0,9999,4
1714378277702,CLRE 253,A00,507199,Vaida; Florin,9994,0,9999,5
1714378277702,CLRE 253,B00,507202,Vaida; Florin,9999,0,9999,0
1714378278736,CLRE 259,A00,507211,Patel; Hemal,9996,0,9999,3
1714378279771,CLRE 260,A00,507221,Cuomo; Raphael Eduardo,9999,0,9999,0
1714378280795,CLRE 297,001,507242,Cuomo; Raphael Eduardo,9999,0,9999,0
1714378281821,COGS 197,001,638244,Voytek; Bradley Thomas,9999,0,9999,0
1714378282846,CSE 191,A00,516875,Minnes Kemp; Mor Mia,9993,0,9999,6
1714378283870,CSE 197,001,637388,Minnes Kemp; Mor Mia,9998,0,9999,1
1714378284900,CSS 201S,A01,494383,Staff,35,0,35,0
1714378285927,CSS 202S,A01,494387,Staff,35,0,35,0
1714378286956,DSC 197,001,628532,Eldridge; Justin Matthew,9996,0,9999,3
1714378287982,EAP 100,A00,516065,Staff,9797,0,9999,202
1714378289011,ECE 45,A01,507414,Staff,33,0,60,27
1714378291063,ECE 111,A01,507420,Staff,19,0,50,31
1714378292089,ECE 197,001,548057,Sievenpiper; Daniel F.,9994,0,9999,5
1714378293119,EDS 115,A00,507243,Choi; Bailey Miyeon,12,0,28,16
1714378294145,EDS 117,A01,494379,Staff,0,2,30,30
1714378295174,EDS 125,A00,507246,Hopkins; Megan Beth,12,0,30,18
1714378296199,EDS 128A,A01,507264,Fargason; Sharon Gayle,14,0,26,12
1714378297229,EDS 128B,A01,507293,Pappas; Elizabeth,18,0,30,12
1714378298256,EDS 139,A00,507294,Fargason; Sharon Gayle,18,0,30,12
1714378298256,EDS 139,B00,507313,Pappas; Elizabeth,15,0,30,15
1714378299280,EDS 201,A00,507315,Staff,13,0,30,17
1714378300311,EDS 203,A01,507317,Halter; Christopher P.,12,0,30,18
1714378301388,EDS 204R,A01,507319,Halter; Christopher P.,0,3,30,30
1714378301388,EDS 204R,B01,507331,Heinzman; Erica M.,17,0,30,13
1714378302414,EDS 206R,A00,507332,Staff,0,4,30,30
1714378302414,EDS 206R,B00,507343,Staff,18,0,30,12
1714378303439,EDS 250,A00,507344,Hemans; Patricia Ann Benitez,22,0,40,18
1714378304464,EDS 281,A00,507345,Daly; Alan J.,18,0,18,0
1714378305489,EDS 284,A00,507350,Daly; Alan J.,16,0,16,0
1714378306514,EDS 286,A00,507359,Fine; Sarah,18,0,18,0
1714378307540,EDS 289C,A01,507361,Daly; Alan J.,18,0,18,0
1714378308565,EDS 290,A00,507366,Hofstetter; Carolyn,15,0,15,0
1714378309591,LIGM 5A,A00,507421,Fischer-Grunski; Eva K,18,0,20,2
1714378310617,LIGM 5B,A00,507423,Fischer-Grunski; Eva K,19,0,20,1
1714378311642,LIGM 5C,A00,507425,Fischer-Grunski; Eva K,19,0,20,1
1714378312668,LIIT 5AS,A00,507427,Carnelos; Chiara,20,0,20,0
1714378313698,LIIT 5BS,A00,507430,Carnelos; Chiara,20,0,20,0
1714378314723,LIIT 5CS,A00,507432,Carnelos; Chiara,20,0,20,0
1714378315751,LISP 5A,A00,507541,Munoz Sanchez; Alicia,11,0,20,9
1714378316780,LISP 5B,A00,507671,Munoz Sanchez; Alicia,9,0,20,11
1714378317806,LISP 5C,A00,507696,Munoz Sanchez; Alicia,9,0,20,11
1714378318835,MAE 197,001,528363,Boechler; Nicholas Sebastia,9998,0,9999,1
1714378319864,MATH 197,001,523477,Kedlaya; Kiran S.,9996,0,9999,3
1714378319864,MATH 197,002,563811,Zhang; Danna,9995,0,9999,4
1714378319864,MATH 197,003,628552,Dumitriu; Ioana,9998,0,9999,1
1714378320889,MCWP 40R,A00,518780,Staff,5,0,20,15
1714378320889,MCWP 40R,B00,518781,Staff,7,0,20,13
1714378320889,MCWP 40R,C00,518783,Staff,5,0,20,15
1714378321919,MCWP 50R,A00,518791,Staff,0,0,20,20
1714378321919,MCWP 50R,B00,518792,Staff,0,1,20,20
1714378321919,MCWP 50R,C00,518793,Staff,0,1,20,20
1714378321919,MCWP 50R,D00,518794,Staff,0,0,20,20
1714378321919,MCWP 50R,E00,518795,Staff,0,1,20,20
1714378321919,MCWP 50R,F00,518796,Staff,0,0,20,20
1714378321919,MCWP 50R,G00,518797,Staff,0,1,20,20
1714378322946,MMW 12R,A01,514034,Herbst; Matthew,0,1,16,16
1714378322946,MMW 12R,A02,514035,Herbst; Matthew,2,0,16,14
1714378323973,MMW 13R,A01,514037,Staff,0,4,16,16
1714378323973,MMW 13R,A02,514039,Staff,0,2,16,16
1714378323973,MMW 13R,A03,628519,Staff,0,2,16,16
1714378326027,SIO 295LS,A00,523233,Staff,12,0,30,18
1714378327056,SIO 295S,A00,523232,Staff,12,0,30,18
1714378328091,SIOC 290S,A01,637330,Merrifield; Mark A,27,0,30,3
1714378329117,SIOC 291S,A01,637333,Gabriel; Corey John,27,0,30,3
1714378330142,SOCI 117,A01,494376,Staff,0,4,5,5
1714378331167,WES 237B,A00,494380,Staff,9,0,20,11
1714378333238,AESE 279B,A00,494370,Wade; Jon P,0,0,33,33
1714378334270,AIP 197,001,627712,Vespa; Emanuel Ignacio,9998,0,9999,1
1714378335301,ANAR 135S,A00,494369,Braswell; Geoffrey E.,0,0,0,0
1714378336329,BENG 196,001,628496,Engler; Adam J.,9998,0,9999,1
1714378337356,CAT 124RS,A01,519847,Geibel; William,0,0,20,20
1714378338385,CAT 125RS,A01,515971,Geibel; William,0,0,20,20
1714378339411,CLRE 250,A00,511389,Morris; Sheldon,9993,0,9999,6
1714378340439,CLRE 251,A00,507176,Mehta; Ravindra L.,9993,0,9999,6
1714378340439,CLRE 251,B00,511410,Mehta; Ravindra L.,9998,0,9999,1
1714378341471,CLRE 252,A00,507189,Cuomo; Raphael Eduardo,9995,0,9999,4
1714378342502,CLRE 253,A00,507199,Vaida; Florin,9994,0,9999,5
1714378342502,CLRE 253,B00,507202,Vaida; Florin,9999,0,9999,0
1714378343531,CLRE 259,A00,507211,Patel; Hemal,9996,0,9999,3
1714378344557,CLRE 260,A00,507221,Cuomo; Raphael Eduardo,9999,0,9999,0
1714378345583,CLRE 297,001,507242,Cuomo; Raphael Eduardo,9999,0,9999,0
1714378346609,COGS 197,001,638244,Voytek; Bradley Thomas,9999,0,9999,0
1714378347637,CSE 191,A00,516875,Minnes Kemp; Mor Mia,9993,0,9999,6
1714378348665,CSE 197,001,637388,Minnes Kemp; Mor Mia,9998,0,9999,1
1714378349696,CSS 201S,A01,494383,Staff,35,0,35,0
1714378350720,CSS 202S,A01,494387,Staff,35,0,35,0
1714378351746,DSC 197,001,628532,Eldridge; Justin Matthew,9996,0,9999,3
1714378352773,EAP 100,A00,516065,Staff,9797,0,9999,202
1714378353798,ECE 45,A01,507414,Staff,33,0,60,27
1714378355854,ECE 111,A01,507420,Staff,19,0,50,31
1714378356881,ECE 197,001,548057,Sievenpiper; Daniel F.,9994,0,9999,5
1714378357921,EDS 115,A00,507243,Choi; Bailey Miyeon,12,0,28,16
1714378358951,EDS 117,A01,494379,Staff,0,2,30,30
1714378359981,EDS 125,A00,507246,Hopkins; Megan Beth,12,0,30,18
1714378361006,EDS 128A,A01,507264,Fargason; Sharon Gayle,14,0,26,12
1714378362032,EDS 128B,A01,507293,Pappas; Elizabeth,18,0,30,12
1714378363060,EDS 139,A00,507294,Fargason; Sharon Gayle,18,0,30,12
1714378363060,EDS 139,B00,507313,Pappas; Elizabeth,15,0,30,15
1714378364088,EDS 201,A00,507315,Staff,13,0,30,17
1714378365118,EDS 203,A01,507317,Halter; Christopher P.,12,0,30,18
1714378366147,EDS 204R,A01,507319,Halter; Christopher P.,0,3,30,30
1714378366147,EDS 204R,B01,507331,Heinzman; Erica M.,17,0,30,13
1714378367171,EDS 206R,A00,507332,Staff,0,4,30,30
1714378367171,EDS 206R,B00,507343,Staff,18,0,30,12
1714378368201,EDS 250,A00,507344,Hemans; Patricia Ann Benitez,22,0,40,18
1714378369225,EDS 281,A00,507345,Daly; Alan J.,18,0,18,0
1714378370248,EDS 284,A00,507350,Daly; Alan J.,16,0,16,0
1714378371273,EDS 286,A00,507359,Fine; Sarah,18,0,18,0
1714378372297,EDS 289C,A01,507361,Daly; Alan J.,18,0,18,0
1714378373323,EDS 290,A00,507366,Hofstetter; Carolyn,15,0,15,0
1714378374353,LIGM 5A,A00,507421,Fischer-Grunski; Eva K,18,0,20,2
1714378375379,LIGM 5B,A00,507423,Fischer-Grunski; Eva K,19,0,20,1
1714378376408,LIGM 5C,A00,507425,Fischer-Grunski; Eva K,19,0,20,1
1714378377435,LIIT 5AS,A00,507427,Carnelos; Chiara,20,0,20,0
1714378378465,LIIT 5BS,A00,507430,Carnelos; Chiara,20,0,20,0
1714378379494,LIIT 5CS,A00,507432,Carnelos; Chiara,20,0,20,0
1714378380526,LISP 5A,A00,507541,Munoz Sanchez; Alicia,11,0,20,9
1714378381551,LISP 5B,A00,507671,Munoz Sanchez; Alicia,9,0,20,11
1714378382578,LISP 5C,A00,507696,Munoz Sanchez; Alicia,9,0,20,11
1714378383605,MAE 197,001,528363,Boechler; Nicholas Sebastia,9998,0,9999,1
1714378384640,MATH 197,001,523477,Kedlaya; Kiran S.,9996,0,9999,3
1714378384640,MATH 197,002,563811,Zhang; Danna,9995,0,9999,4
1714378384640,MATH 197,003,628552,Dumitriu; Ioana,9998,0,9999,1
1714378385667,MCWP 40R,A00,518780,Staff,5,0,20,15
1714378385667,MCWP 40R,B00,518781,Staff,7,0,20,13
1714378385667,MCWP 40R,C00,518783,Staff,5,0,20,15
1714378386694,MCWP 50R,A00,518791,Staff,0,0,20,20
1714378386694,MCWP 50R,B00,518792,Staff,0,1,20,20
1714378386694,MCWP 50R,C00,518793,Staff,0,1,20,20
1714378386694,MCWP 50R,D00,518794,Staff,0,0,20,20
1714378386694,MCWP 50R,E00,518795,Staff,0,1,20,20
1714378386694,MCWP 50R,F00,518796,Staff,0,0,20,20
1714378386694,MCWP 50R,G00,518797,Staff,0,1,20,20
1714378387719,MMW 12R,A01,514034,Herbst; Matthew,0,1,16,16
1714378387719,MMW 12R,A02,514035,Herbst; Matthew,2,0,16,14
1714378388747,MMW 13R,A01,514037,Staff,0,4,16,16
1714378388747,MMW 13R,A02,514039,Staff,0,2,16,16
1714378388747,MMW 13R,A03,628519,Staff,0,2,16,16
1714378390797,SIO 295LS,A00,523233,Staff,12,0,30,18
1714378391825,SIO 295S,A00,523232,Staff,12,0,30,18
1714378392852,SIOC 290S,A01,637330,Merrifield; Mark A,27,0,30,3
1714378393878,SIOC 291S,A01,637333,Gabriel; Corey John,27,0,30,3
1714378394907,SOCI 117,A01,494376,Staff,0,4,5,5
1714378395933,WES 237B,A00,494380,Staff,9,0,20,11
1714378398086,AESE 279B,A00,494370,Wade; Jon P,0,0,33,33
1714378399124,AIP 197,001,627712,Vespa; Emanuel Ignacio,9998,0,9999,1
1714378400161,ANAR 135S,A00,494369,Braswell; Geoffrey E.,0,0,0,0
1714378401184,BENG 196,001,628496,Engler; Adam J.,9998,0,9999,1
1714378402210,CAT 124RS,A01,519847,Geibel; William,0,0,20,20
1714378403237,CAT 125RS,A01,515971,Geibel; William,0,0,20,20
1714378404265,CLRE 250,A00,511389,Morris; Sheldon,9993,0,9999,6
1714378405344,CLRE 251,A00,507176,Mehta; Ravindra L.,9993,0,9999,6
1714378405344,CLRE 251,B00,511410,Mehta; Ravindra L.,9998,0,9999,1
1714378406371,CLRE 252,A00,507189,Cuomo; Raphael Eduardo,9995,0,9999,4
1714378407398,CLRE 253,A00,507199,Vaida; Florin,9994,0,9999,5
1714378407398,CLRE 253,B00,507202,Vaida; Florin,9999,0,9999,0
1714378408421,CLRE 259,A00,507211,Patel; Hemal,9996,0,9999,3
1714378409448,CLRE 260,A00,507221,Cuomo; Raphael Eduardo,9999,0,9999,0
1714378410472,CLRE 297,001,507242,Cuomo; Raphael Eduardo,9999,0,9999,0
1714378411499,COGS 197,001,638244,Voytek; Bradley Thomas,9999,0,9999,0
1714378412523,CSE 191,A00,516875,Minnes Kemp; Mor Mia,9993,0,9999,6
1714378413548,CSE 197,001,637388,Minnes Kemp; Mor Mia,9998,0,9999,1
1714378414576,CSS 201S,A01,494383,Staff,35,0,35,0
1714378415604,CSS 202S,A01,494387,Staff,35,0,35,0
1714378416627,DSC 197,001,628532,Eldridge; Justin Matthew,9996,0,9999,3
1714378417650,EAP 100,A00,516065,Staff,9797,0,9999,202
1714378418677,ECE 45,A01,507414,Staff,33,0,60,27
1714378420729,ECE 111,A01,507420,Staff,19,0,50,31
1714378421755,ECE 197,001,548057,Sievenpiper; Daniel F.,9994,0,9999,5
1714378422779,EDS 115,A00,507243,Choi; Bailey Miyeon,12,0,28,16
1714378423806,EDS 117,A01,494379,Staff,0,2,30,30
1714378424834,EDS 125,A00,507246,Hopkins; Megan Beth,12,0,30,18
1714378425861,EDS 128A,A01,507264,Fargason; Sharon Gayle,14,0,26,12
1714378426891,EDS 128B,A01,507293,Pappas; Elizabeth,18,0,30,12
1714378427915,EDS 139,A00,507294,Fargason; Sharon Gayle,18,0,30,12
1714378427915,EDS 139,B00,507313,Pappas; Elizabeth,15,0,30,15
1714378428940,EDS 201,A00,507315,Staff,13,0,30,17
1714378429965,EDS 203,A01,507317,Halter; Christopher P.,12,0,30,18
1714378430990,EDS 204R,A01,507319,Halter; Christopher P.,0,3,30,30
1714378430990,EDS 204R,B01,507331,Heinzman; Erica M.,17,0,30,13
1714378432015,EDS 206R,A00,507332,Staff,0,4,30,30
1714378432015,EDS 206R,B00,507343,Staff,18,0,30,12
1714378433043,EDS 250,A00,507344,Hemans; Patricia Ann Benitez,22,0,40,18
1714378434069,EDS 281,A00,507345,Daly; Alan J.,18,0,18,0
1714378435094,EDS 284,A00,507350,Daly; Alan J.,16,0,16,0
1714378436119,EDS 286,A00,507359,Fine; Sarah,18,0,18,0
1714378437148,EDS 289C,A01,507361,Daly; Alan J.,18,0,18,0
1714378438174,EDS 290,A00,507366,Hofstetter; Carolyn,15,0,15,0
1714378439202,LIGM 5A,A00,507421,Fischer-Grunski; Eva K,18,0,20,2
1714378440227,LIGM 5B,A00,507423,Fischer-Grunski; Eva K,19,0,20,1
1714378441255,LIGM 5C,A00,507425,Fischer-Grunski; Eva K,19,0,20,1
1714378442280,LIIT 5AS,A00,507427,Carnelos; Chiara,20,0,20,0
1714378443306,LIIT 5BS,A00,507430,Carnelos; Chiara,20,0,20,0
1714378444336,LIIT 5CS,A00,507432,Carnelos; Chiara,20,0,20,0
1714378445363,LISP 5A,A00,507541,Munoz Sanchez; Alicia,11,0,20,9
1714378446393,LISP 5B,A00,507671,Munoz Sanchez; Alicia,9,0,20,11
1714378447420,LISP 5C,A00,507696,Munoz Sanchez; Alicia,9,0,20,11
1714378448449,MAE 197,001,528363,Boechler; Nicholas Sebastia,9998,0,9999,1
1714378449478,MATH 197,001,523477,Kedlaya; Kiran S.,9996,0,9999,3
1714378449478,MATH 197,002,563811,Zhang; Danna,9995,0,9999,4
1714378449478,MATH 197,003,628552,Dumitriu; Ioana,9998,0,9999,1
1714378450524,MCWP 40R,A00,518780,Staff,5,0,20,15
1714378450524,MCWP 40R,B00,518781,Staff,7,0,20,13
1714378450524,MCWP 40R,C00,518783,Staff,5,0,20,15
1714378451571,MCWP 50R,A00,518791,Staff,0,0,20,20
1714378451571,MCWP 50R,B00,518792,Staff,0,1,20,20
1714378451571,MCWP 50R,C00,518793,Staff,0,1,20,20
1714378451571,MCWP 50R,D00,518794,Staff,0,0,20,20
1714378451571,MCWP 50R,E00,518795,Staff,0,1,20,20
1714378451571,MCWP 50R,F00,518796,Staff,0,0,20,20
1714378451571,MCWP 50R,G00,518797,Staff,0,1,20,20
1714378452596,MMW 12R,A01,514034,Herbst; Matthew,0,1,16,16
1714378452596,MMW 12R,A02,514035,Herbst; Matthew,2,0,16,14
1714378453621,MMW 13R,A01,514037,Staff,0,4,16,16
1714378453621,MMW 13R,A02,514039,Staff,0,2,16,16
1714378453621,MMW 13R,A03,628519,Staff,0,2,16,16
1714378455675,SIO 295LS,A00,523233,Staff,12,0,30,18
1714378456702,SIO 295S,A00,523232,Staff,12,0,30,18
1714378457728,SIOC 290S,A01,637330,Merrifield; Mark A,27,0,30,3
1714378458755,SIOC 291S,A01,637333,Gabriel; Corey John,27,0,30,3
1714378459784,SOCI 117,A01,494376,Staff,0,4,5,5
1714378460809,WES 237B,A00,494380,Staff,9,0,20,11
1714378462879,AESE 279B,A00,494370,Wade; Jon P,0,0,33,33
1714378463905,AIP 197,001,627712,Vespa; Emanuel Ignacio,9998,0,9999,1
1714378464935,ANAR 135S,A00,494369,Braswell; Geoffrey E.,0,0,0,0
1714378465960,BENG 196,001,628496,Engler; Adam J.,9998,0,9999,1
1714378466985,CAT 124RS,A01,519847,Geibel; William,0,0,20,20
1714378468011,CAT 125RS,A01,515971,Geibel; William,0,0,20,20
1714378469041,CLRE 250,A00,511389,Morris; Sheldon,9993,0,9999,6
1714378470070,CLRE 251,A00,507176,Mehta; Ravindra L.,9993,0,9999,6
1714378470070,CLRE 251,B00,511410,Mehta; Ravindra L.,9998,0,9999,1
1714378471097,CLRE 252,A00,507189,Cuomo; Raphael Eduardo,9995,0,9999,4
1714378472130,CLRE 253,A00,507199,Vaida; Florin,9994,0,9999,5
1714378472130,CLRE 253,B00,507202,Vaida; Florin,9999,0,9999,0
1714378473159,CLRE 259,A00,507211,Patel; Hemal,9996,0,9999,3
1714378474184,CLRE 260,A00,507221,Cuomo; Raphael Eduardo,9999,0,9999,0
1714378475209,CLRE 297,001,507242,Cuomo; Raphael Eduardo,9999,0,9999,0
1714378476235,COGS 197,001,638244,Voytek; Bradley Thomas,9999,0,9999,0
1714378477262,CSE 191,A00,516875,Minnes Kemp; Mor Mia,9993,0,9999,6
1714378478289,CSE 197,001,637388,Minnes Kemp; Mor Mia,9998,0,9999,1
1714378479314,CSS 201S,A01,494383,Staff,35,0,35,0
1714378480338,CSS 202S,A01,494387,Staff,35,0,35,0
1714378481368,DSC 197,001,628532,Eldridge; Justin Matthew,9996,0,9999,3
1714378482392,EAP 100,A00,516065,Staff,9797,0,9999,202
1714378483417,ECE 45,A01,507414,Staff,33,0,60,27
1714378485469,ECE 111,A01,507420,Staff,19,0,50,31
1714378486494,ECE 197,001,548057,Sievenpiper; Daniel F.,9994,0,9999,5
1714378487526,EDS 115,A00,507243,Choi; Bailey Miyeon,12,0,28,16
1714378488556,EDS 117,A01,494379,Staff,0,2,30,30
1714378489580,EDS 125,A00,507246,Hopkins; Megan Beth,12,0,30,18
1714378490605,EDS 128A,A01,507264,Fargason; Sharon Gayle,14,0,26,12
1714378491631,EDS 128B,A01,507293,Pappas; Elizabeth,18,0,30,12
1714378492656,EDS 139,A00,507294,Fargason; Sharon Gayle,18,0,30,12
1714378492656,EDS 139,B00,507313,Pappas; Elizabeth,15,0,30,15
1714378493683,EDS 201,A00,507315,Staff,13,0,30,17
1714378494714,EDS 203,A01,507317,Halter; Christopher P.,12,0,30,18
1714378495740,EDS 204R,A01,507319,Halter; Christopher P.,0,3,30,30
1714378495740,EDS 204R,B01,507331,Heinzman; Erica M.,17,0,30,13
1714378496766,EDS 206R,A00,507332,Staff,0,4,30,30
1714378496766,EDS 206R,B00,507343,Staff,18,0,30,12
1714378497795,EDS 250,A00,507344,Hemans; Patricia Ann Benitez,22,0,40,18
1714378498822,EDS 281,A00,507345,Daly; Alan J.,18,0,18,0
1714378499848,EDS 284,A00,507350,Daly; Alan J.,16,0,16,0
1714378500874,EDS 286,A00,507359,Fine; Sarah,18,0,18,0
1714378501899,EDS 289C,A01,507361,Daly; Alan J.,18,0,18,0
1714378502928,EDS 290,A00,507366,Hofstetter; Carolyn,15,0,15,0
1714378503955,LIGM 5A,A00,507421,Fischer-Grunski; Eva K,18,0,20,2
1714378504981,LIGM 5B,A00,507423,Fischer-Grunski; Eva K,19,0,20,1
1714378506006,LIGM 5C,A00,507425,Fischer-Grunski; Eva K,19,0,20,1
1714378507033,LIIT 5AS,A00,507427,Carnelos; Chiara,20,0,20,0
1714378508064,LIIT 5BS,A00,507430,Carnelos; Chiara,20,0,20,0
1714378509150,LIIT 5CS,A00,507432,Carnelos; Chiara,20,0,20,0
1714378510179,LISP 5A,A00,507541,Munoz Sanchez; Alicia,11,0,20,9
1714378511204,LISP 5B,A00,507671,Munoz Sanchez; Alicia,9,0,20,11
1714378512229,LISP 5C,A00,507696,Munoz Sanchez; Alicia,9,0,20,11
1714378513256,MAE 197,001,528363,Boechler; Nicholas Sebastia,9998,0,9999,1
1714378514282,MATH 197,001,523477,Kedlaya; Kiran S.,9996,0,9999,3
1714378514282,MATH 197,002,563811,Zhang; Danna,9995,0,9999,4
1714378514282,MATH 197,003,628552,Dumitriu; Ioana,9998,0,9999,1
1714378515306,MCWP 40R,A00,518780,Staff,5,0,20,15
1714378515306,MCWP 40R,B00,518781,Staff,7,0,20,13
1714378515306,MCWP 40R,C00,518783,Staff,5,0,20,15
1714378516334,MCWP 50R,A00,518791,Staff,0,0,20,20
1714378516334,MCWP 50R,B00,518792,Staff,0,1,20,20
1714378516334,MCWP 50R,C00,518793,Staff,0,1,20,20
1714378516334,MCWP 50R,D00,518794,Staff,0,0,20,20
1714378516334,MCWP 50R,E00,518795,Staff,0,1,20,20
1714378516334,MCWP 50R,F00,518796,Staff,0,0,20,20
1714378516334,MCWP 50R,G00,518797,Staff,0,1,20,20
1714378517362,MMW 12R,A01,514034,Herbst; Matthew,0,1,16,16
1714378517362,MMW 12R,A02,514035,Herbst; Matthew,2,0,16,14
1714378518393,MMW 13R,A01,514037,Staff,0,4,16,16
1714378518393,MMW 13R,A02,514039,Staff,0,2,16,16
1714378518393,MMW 13R,A03,628519,Staff,0,2,16,16
1714378520445,SIO 295LS,A00,523233,Staff,12,0,30,18
1714378521475,SIO 295S,A00,523232,Staff,12,0,30,18
1714378522501,SIOC 290S,A01,637330,Merrifield; Mark A,27,0,30,3
1714378523531,SIOC 291S,A01,637333,Gabriel; Corey John,27,0,30,3
1714378524556,SOCI 117,A01,494376,Staff,0,4,5,5
1714378525582,WES 237B,A00,494380,Staff,9,0,20,11
1714378527678,AESE 279B,A00,494370,Wade; Jon P,0,0,33,33
1714378528710,AIP 197,001,627712,Vespa; Emanuel Ignacio,9998,0,9999,1
1714378529736,ANAR 135S,A00,494369,Braswell; Geoffrey E.,0,0,0,0
1714378530763,BENG 196,001,628496,Engler; Adam J.,9998,0,9999,1
1714378531788,CAT 124RS,A01,519847,Geibel; William,0,0,20,20
1714378532817,CAT 125RS,A01,515971,Geibel; William,0,0,20,20
1714378533845,CLRE 250,A00,511389,Morris; Sheldon,9993,0,9999,6
1714378534872,CLRE 251,A00,507176,Mehta; Ravindra L.,9993,0,9999,6
1714378534872,CLRE 251,B00,511410,Mehta; Ravindra L.,9998,0,9999,1
1714378535899,CLRE 252,A00,507189,Cuomo; Raphael Eduardo,9995,0,9999,4
1714378536928,CLRE 253,A00,507199,Vaida; Florin,9994,0,9999,5
1714378536928,CLRE 253,B00,507202,Vaida; Florin,9999,0,9999,0
1714378537954,CLRE 259,A00,507211,Patel; Hemal,9996,0,9999,3
1714378538981,CLRE 260,A00,507221,Cuomo; Raphael Eduardo,9999,0,9999,0
1714378540006,CLRE 297,001,507242,Cuomo; Raphael Eduardo,9999,0,9999,0
1714378541033,COGS 197,001,638244,Voytek; Bradley Thomas,9999,0,9999,0
1714378542060,CSE 191,A00,516875,Minnes Kemp; Mor Mia,9993,0,9999,6
1714378543090,CSE 197,001,637388,Minnes Kemp; Mor Mia,9998,0,9999,1
1714378544130,CSS 201S,A01,494383,Staff,35,0,35,0
1714378545162,CSS 202S,A01,494387,Staff,35,0,35,0
1714378546187,DSC 197,001,628532,Eldridge; Justin Matthew,9996,0,9999,3
1714378547212,EAP 100,A00,516065,Staff,9797,0,9999,202
1714378548238,ECE 45,A01,507414,Staff,33,0,60,27
1714378550299,ECE 111,A01,507420,Staff,19,0,50,31
1714378551324,ECE 197,001,548057,Sievenpiper; Daniel F.,9994,0,9999,5
1714378552351,EDS 115,A00,507243,Choi; Bailey Miyeon,12,0,28,16
1714378553379,EDS 117,A01,494379,Staff,0,2,30,30
1714378554406,EDS 125,A00,507246,Hopkins; Megan Beth,12,0,30,18
1714378555431,EDS 128A,A01,507264,Fargason; Sharon Gayle,14,0,26,12
1714378556459,EDS 128B,A01,507293,Pappas; Elizabeth,18,0,30,12
1714378557484,EDS 139,A00,507294,Fargason; Sharon Gayle,18,0,30,12
1714378557484,EDS 139,B00,507313,Pappas; Elizabeth,15,0,30,15
1714378558512,EDS 201,A00,507315,Staff,13,0,30,17
1714378559541,EDS 203,A01,507317,Halter; Christopher P.,12,0,30,18
1714378560594,EDS 204R,A01,507319,Halter; Christopher P.,0,3,30,30
1714378560594,EDS 204R,B01,507331,Heinzman; Erica M.,17,0,30,13
1714378561623,EDS 206R,A00,507332,Staff,0,4,30,30
1714378561623,EDS 206R,B00,507343,Staff,18,0,30,12
1714378562651,EDS 250,A00,507344,Hemans; Patricia Ann Benitez,22,0,40,18
1714378563678,EDS 281,A00,507345,Daly; Alan J.,18,0,18,0
1714378564703,EDS 284,A00,507350,Daly; Alan J.,16,0,16,0
1714378565728,EDS 286,A00,507359,Fine; Sarah,18,0,18,0
1714378566753,EDS 289C,A01,507361,Daly; Alan J.,18,0,18,0
1714378567778,EDS 290,A00,507366,Hofstetter; Carolyn,15,0,15,0
1714378568812,LIGM 5A,A00,507421,Fischer-Grunski; Eva K,18,0,20,2
1714378569842,LIGM 5B,A00,507423,Fischer-Grunski; Eva K,19,0,20,1
1714378570869,LIGM 5C,A00,507425,Fischer-Grunski; Eva K,19,0,20,1
1714378571900,LIIT 5AS,A00,507427,Carnelos; Chiara,20,0,20,0
1714378572927,LIIT 5BS,A00,507430,Carnelos; Chiara,20,0,20,0
1714378573953,LIIT 5CS,A00,507432,Carnelos; Chiara,20,0,20,0
1714378574981,LISP 5A,A00,507541,Munoz Sanchez; Alicia,11,0,20,9
1714378576008,LISP 5B,A00,507671,Munoz Sanchez; Alicia,9,0,20,11
1714378577039,LISP 5C,A00,507696,Munoz Sanchez; Alicia,9,0,20,11
1714378578066,MAE 197,001,528363,Boechler; Nicholas Sebastia,9998,0,9999,1
1714378579094,MATH 197,001,523477,Kedlaya; Kiran S.,9996,0,9999,3
1714378579094,MATH 197,002,563811,Zhang; Danna,9995,0,9999,4
1714378579094,MATH 197,003,628552,Dumitriu; Ioana,9998,0,9999,1
1714378580124,MCWP 40R,A00,518780,Staff,5,0,20,15
1714378580124,MCWP 40R,B00,518781,Staff,7,0,20,13
1714378580124,MCWP 40R,C00,518783,Staff,5,0,20,15
1714378581150,MCWP 50R,A00,518791,Staff,0,0,20,20
1714378581150,MCWP 50R,B00,518792,Staff,0,1,20,20
1714378581150,MCWP 50R,C00,518793,Staff,0,1,20,20
1714378581150,MCWP 50R,D00,518794,Staff,0,0,20,20
1714378581150,MCWP 50R,E00,518795,Staff,0,1,20,20
1714378581150,MCWP 50R,F00,518796,Staff,0,0,20,20
1714378581150,MCWP 50R,G00,518797,Staff,0,1,20,20
1714378582181,MMW 12R,A01,514034,Herbst; Matthew,0,1,16,16
1714378582181,MMW 12R,A02,514035,Herbst; Matthew,2,0,16,14
1714378583211,MMW 13R,A01,514037,Staff,0,4,16,16
1714378583211,MMW 13R,A02,514039,Staff,0,2,16,16
1714378583211,MMW 13R,A03,628519,Staff,0,2,16,16
1714378585269,SIO 295LS,A00,523233,Staff,12,0,30,18
1714378586293,SIO 295S,A00,523232,Staff,12,0,30,18
1714378587324,SIOC 290S,A01,637330,Merrifield; Mark A,27,0,30,3
1714378588350,SIOC 291S,A01,637333,Gabriel; Corey John,27,0,30,3
1714378589382,SOCI 117,A01,494376,Staff,0,4,5,5
1714378590408,WES 237B,A00,494380,Staff,9,0,20,11
1714378592495,AESE 279B,A00,494370,Wade; Jon P,0,0,33,33
1714378593520,AIP 197,001,627712,Vespa; Emanuel Ignacio,9998,0,9999,1
1714378594547,ANAR 135S,A00,494369,Braswell; Geoffrey E.,0,0,0,0
1714378595572,BENG 196,001,628496,Engler; Adam J.,9998,0,9999,1
1714378596598,CAT 124RS,A01,519847,Geibel; William,0,0,20,20
1714378597622,CAT 125RS,A01,515971,Geibel; William,0,0,20,20
1714378598651,CLRE 250,A00,511389,Morris; Sheldon,9993,0,9999,6
1714378599679,CLRE 251,A00,507176,Mehta; Ravindra L.,9993,0,9999,6
1714378599679,CLRE 251,B00,511410,Mehta; Ravindra L.,9998,0,9999,1
1714378600706,CLRE 252,A00,507189,Cuomo; Raphael Eduardo,9995,0,9999,4
1714378601731,CLRE 253,A00,507199,Vaida; Florin,9994,0,9999,5
1714378601731,CLRE 253,B00,507202,Vaida; Florin,9999,0,9999,0
1714378602759,CLRE 259,A00,507211,Patel; Hemal,9996,0,9999,3
1714378603787,CLRE 260,A00,507221,Cuomo; Raphael Eduardo,9999,0,9999,0
1714378604813,CLRE 297,001,507242,Cuomo; Raphael Eduardo,9999,0,9999,0
1714378605837,COGS 197,001,638244,Voytek; Bradley Thomas,9999,0,9999,0
1714378606863,CSE 191,A00,516875,Minnes Kemp; Mor Mia,9993,0,9999,6
1714378607892,CSE 197,001,637388,Minnes Kemp; Mor Mia,9998,0,9999,1
1714378608920,CSS 201S,A01,494383,Staff,35,0,35,0
1714378609953,CSS 202S,A01,494387,Staff,35,0,35,0
1714378610977,DSC 197,001,628532,Eldridge; Justin Matthew,9996,0,9999,3
1714378612003,EAP 100,A00,516065,Staff,9797,0,9999,202
1714378613085,ECE 45,A01,507414,Staff,33,0,60,27
1714378615134,ECE 111,A01,507420,Staff,19,0,50,31
1714378616162,ECE 197,001,548057,Sievenpiper; Daniel F.,9994,0,9999,5
1714378617185,EDS 115,A00,507243,Choi; Bailey Miyeon,12,0,28,16
1714378618213,EDS 117,A01,494379,Staff,0,2,30,30
1714378619241,EDS 125,A00,507246,Hopkins; Megan Beth,12,0,30,18
1714378620274,EDS 128A,A01,507264,Fargason; Sharon Gayle,14,0,26,12
1714378621298,EDS 128B,A01,507293,Pappas; Elizabeth,18,0,30,12
1714378622324,EDS 139,A00,507294,Fargason; Sharon Gayle,18,0,30,12
1714378622324,EDS 139,B00,507313,Pappas; Elizabeth,15,0,30,15
1714378623352,EDS 201,A00,507315,Staff,13,0,30,17
1714378624377,EDS 203,A01,507317,Halter; Christopher P.,12,0,30,18
1714378625404,EDS 204R,A01,507319,Halter; Christopher P.,0,3,30,30
1714378625404,EDS 204R,B01,507331,Heinzman; Erica M.,17,0,30,13
1714378626429,EDS 206R,A00,507332,Staff,0,4,30,30
1714378626429,EDS 206R,B00,507343,Staff,18,0,30,12
1714378627453,EDS 250,A00,507344,Hemans; Patricia Ann Benitez,22,0,40,18
1714378628478,EDS 281,A00,507345,Daly; Alan J.,18,0,18,0
1714378629503,EDS 284,A00,507350,Daly; Alan J.,16,0,16,0
1714378630528,EDS 286,A00,507359,Fine; Sarah,18,0,18,0
1714378631556,EDS 289C,A01,507361,Daly; Alan J.,18,0,18,0
1714378632582,EDS 290,A00,507366,Hofstetter; Carolyn,15,0,15,0
1714378633608,LIGM 5A,A00,507421,Fischer-Grunski; Eva K,18,0,20,2
1714378634638,LIGM 5B,A00,507423,Fischer-Grunski; Eva K,19,0,20,1
1714378635663,LIGM 5C,A00,507425,Fischer-Grunski; Eva K,19,0,20,1
1714378636689,LIIT 5AS,A00,507427,Carnelos; Chiara,20,0,20,0
1714378637718,LIIT 5BS,A00,507430,Carnelos; Chiara,20,0,20,0
1714378638743,LIIT 5CS,A00,507432,Carnelos; Chiara,20,0,20,0
1714378639768,LISP 5A,A00,507541,Munoz Sanchez; Alicia,11,0,20,9
1714378640810,LISP 5B,A00,507671,Munoz Sanchez; Alicia,9,0,20,11
1714378641838,LISP 5C,A00,507696,Munoz Sanchez; Alicia,9,0,20,11
1714378642865,MAE 197,001,528363,Boechler; Nicholas Sebastia,9998,0,9999,1
1714378643908,MATH 197,001,523477,Kedlaya; Kiran S.,9996,0,9999,3
1714378643908,MATH 197,002,563811,Zhang; Danna,9995,0,9999,4
1714378643908,MATH 197,003,628552,Dumitriu; Ioana,9998,0,9999,1
1714378644934,MCWP 40R,A00,518780,Staff,5,0,20,15
1714378644934,MCWP 40R,B00,518781,Staff,7,0,20,13
1714378644934,MCWP 40R,C00,518783,Staff,5,0,20,15
1714378645961,MCWP 50R,A00,518791,Staff,0,0,20,20
1714378645961,MCWP 50R,B00,518792,Staff,0,1,20,20
1714378645961,MCWP 50R,C00,518793,Staff,0,1,20,20
1714378645961,MCWP 50R,D00,518794,Staff,0,0,20,20
1714378645961,MCWP 50R,E00,518795,Staff,0,1,20,20
1714378645961,MCWP 50R,F00,518796,Staff,0,0,20,20
1714378645961,MCWP 50R,G00,518797,Staff,0,1,20,20
1714378646987,MMW 12R,A01,514034,Herbst; Matthew,0,1,16,16
1714378646987,MMW 12R,A02,514035,Herbst; Matthew,2,0,16,14
1714378648014,MMW 13R,A01,514037,Staff,0,4,16,16
1714378648014,MMW 13R,A02,514039,Staff,0,2,16,16
1714378648014,MMW 13R,A03,628519,Staff,0,2,16,16
1714378650068,SIO 295LS,A00,523233,Staff,12,0,30,18
1714378651094,SIO 295S,A00,523232,Staff,12,0,30,18
1714378652124,SIOC 290S,A01,637330,Merrifield; Mark A,27,0,30,3
1714378653149,SIOC 291S,A01,637333,Gabriel; Corey John,27,0,30,3
1714378654178,SOCI 117,A01,494376,Staff,0,4,5,5
1714378655208,WES 237B,A00,494380,Staff,9,0,20,11
1714378657284,AESE 279B,A00,494370,Wade; Jon P,0,0,33,33
1714378658313,AIP 197,001,627712,Vespa; Emanuel Ignacio,9998,0,9999,1
1714378659337,ANAR 135S,A00,494369,Braswell; Geoffrey E.,0,0,0,0
1714378660365,BENG 196,001,628496,Engler; Adam J.,9998,0,9999,1
1714378661390,CAT 124RS,A01,519847,Geibel; William,0,0,20,20
1714378662416,CAT 125RS,A01,515971,Geibel; William,0,0,20,20
1714378663442,CLRE 250,A00,511389,Morris; Sheldon,9993,0,9999,6
1714378664472,CLRE 251,A00,507176,Mehta; Ravindra L.,9993,0,9999,6
1714378664472,CLRE 251,B00,511410,Mehta; Ravindra L.,9998,0,9999,1
1714378665497,CLRE 252,A00,507189,Cuomo; Raphael Eduardo,9995,0,9999,4
1714378666522,CLRE 253,A00,507199,Vaida; Florin,9994,0,9999,5
1714378666522,CLRE 253,B00,507202,Vaida; Florin,9999,0,9999,0
1714378667551,CLRE 259,A00,507211,Patel; Hemal,9996,0,9999,3
1714378668577,CLRE 260,A00,507221,Cuomo; Raphael Eduardo,9999,0,9999,0
1714378669605,CLRE 297,001,507242,Cuomo; Raphael Eduardo,9999,0,9999,0
1714378670632,COGS 197,001,638244,Voytek; Bradley Thomas,9999,0,9999,0
1714378671661,CSE 191,A00,516875,Minnes Kemp; Mor Mia,9993,0,9999,6
1714378672683,CSE 197,001,637388,Minnes Kemp; Mor Mia,9998,0,9999,1
1714378673712,CSS 201S,A01,494383,Staff,35,0,35,0
1714378674737,CSS 202S,A01,494387,Staff,35,0,35,0
1714378675763,DSC 197,001,628532,Eldridge; Justin Matthew,9996,0,9999,3
1714378676791,EAP 100,A00,516065,Staff,9797,0,9999,202
1714378677816,ECE 45,A01,507414,Staff,33,0,60,27
1714378679868,ECE 111,A01,507420,Staff,19,0,50,31
1714378680898,ECE 197,001,548057,Sievenpiper; Daniel F.,9994,0,9999,5
1714378681927,EDS 115,A00,507243,Choi; Bailey Miyeon,12,0,28,16
1714378682963,EDS 117,A01,494379,Staff,0,2,30,30
1714378683987,EDS 125,A00,507246,Hopkins; Megan Beth,12,0,30,18
1714378685014,EDS 128A,A01,507264,Fargason; Sharon Gayle,14,0,26,12
1714378686042,EDS 128B,A01,507293,Pappas; Elizabeth,18,0,30,12
1714378687067,EDS 139,A00,507294,Fargason; Sharon Gayle,18,0,30,12
1714378687067,EDS 139,B00,507313,Pappas; Elizabeth,15,0,30,15
1714378688094,EDS 201,A00,507315,Staff,13,0,30,17
1714378689118,EDS 203,A01,507317,Halter; Christopher P.,12,0,30,18
1714378690145,EDS 204R,A01,507319,Halter; Christopher P.,0,3,30,30
1714378690145,EDS 204R,B01,507331,Heinzman; Erica M.,17,0,30,13
1714378691172,EDS 206R,A00,507332,Staff,0,4,30,30
1714378691172,EDS 206R,B00,507343,Staff,18,0,30,12
1714378692197,EDS 250,A00,507344,Hemans; Patricia Ann Benitez,22,0,40,18
1714378693223,EDS 281,A00,507345,Daly; Alan J.,18,0,18,0
1714378694248,EDS 284,A00,507350,Daly; Alan J.,16,0,16,0
1714378695274,EDS 286,A00,507359,Fine; Sarah,18,0,18,0
1714378696300,EDS 289C,A01,507361,Daly; Alan J.,18,0,18,0
1714378697326,EDS 290,A00,507366,Hofstetter; Carolyn,15,0,15,0
1714378698353,LIGM 5A,A00,507421,Fischer-Grunski; Eva K,18,0,20,2
1714378699384,LIGM 5B,A00,507423,Fischer-Grunski; Eva K,19,0,20,1
1714378700410,LIGM 5C,A00,507425,Fischer-Grunski; Eva K,19,0,20,1
1714378701435,LIIT 5AS,A00,507427,Carnelos; Chiara,20,0,20,0
1714378702464,LIIT 5BS,A00,507430,Carnelos; Chiara,20,0,20,0
1714378703494,LIIT 5CS,A00,507432,Carnelos; Chiara,20,0,20,0
1714378704523,LISP 5A,A00,507541,Munoz Sanchez; Alicia,11,0,20,9
1714378705555,LISP 5B,A00,507671,Munoz Sanchez; Alicia,9,0,20,11
1714378706580,LISP 5C,A00,507696,Munoz Sanchez; Alicia,9,0,20,11
1714378707606,MAE 197,001,528363,Boechler; Nicholas Sebastia,9998,0,9999,1
1714378708633,MATH 197,001,523477,Kedlaya; Kiran S.,9996,0,9999,3
1714378708633,MATH 197,002,563811,Zhang; Danna,9995,0,9999,4
1714378708633,MATH 197,003,628552,Dumitriu; Ioana,9998,0,9999,1
1714378709660,MCWP 40R,A00,518780,Staff,5,0,20,15
1714378709660,MCWP 40R,B00,518781,Staff,7,0,20,13
1714378709660,MCWP 40R,C00,518783,Staff,5,0,20,15
1714378710688,MCWP 50R,A00,518791,Staff,0,0,20,20
1714378710688,MCWP 50R,B00,518792,Staff,0,1,20,20
1714378710688,MCWP 50R,C00,518793,Staff,0,1,20,20
1714378710688,MCWP 50R,D00,518794,Staff,0,0,20,20
1714378710688,MCWP 50R,E00,518795,Staff,0,1,20,20
1714378710688,MCWP 50R,F00,518796,Staff,0,0,20,20
1714378710688,MCWP 50R,G00,518797,Staff,0,1,20,20
1714378711718,MMW 12R,A01,514034,Herbst; Matthew,0,1,16,16
1714378711718,MMW 12R,A02,514035,Herbst; Matthew,2,0,16,14
1714378712748,MMW 13R,A01,514037,Staff,0,4,16,16
1714378712748,MMW 13R,A02,514039,Staff,0,2,16,16
1714378712748,MMW 13R,A03,628519,Staff,0,2,16,16
1714378714815,SIO 295LS,A00,523233,Staff,12,0,30,18
1714378715843,SIO 295S,A00,523232,Staff,12,0,30,18
1714378716925,SIOC 290S,A01,637330,Merrifield; Mark A,27,0,30,3
1714378717951,SIOC 291S,A01,637333,Gabriel; Corey John,27,0,30,3
1714378718980,SOCI 117,A01,494376,Staff,0,4,5,5
1714378720008,WES 237B,A00,494380,Staff,9,0,20,11
1714378722079,AESE 279B,A00,494370,Wade; Jon P,0,0,33,33
1714378723103,AIP 197,001,627712,Vespa; Emanuel Ignacio,9998,0,9999,1
1714378724129,ANAR 135S,A00,494369,Braswell; Geoffrey E.,0,0,0,0
1714378725153,BENG 196,001,628496,Engler; Adam J.,9998,0,9999,1
1714378726178,CAT 124RS,A01,519847,Geibel; William,0,0,20,20
1714378727207,CAT 125RS,A01,515971,Geibel; William,0,0,20,20
1714378728232,CLRE 250,A00,511389,Morris; Sheldon,9993,0,9999,6
1714378729259,CLRE 251,A00,507176,Mehta; Ravindra L.,9993,0,9999,6
1714378729259,CLRE 251,B00,511410,Mehta; Ravindra L.,9998,0,9999,1
1714378730287,CLRE 252,A00,507189,Cuomo; Raphael Eduardo,9995,0,9999,4
1714378731313,CLRE 253,A00,507199,Vaida; Florin,9994,0,9999,5
1714378731313,CLRE 253,B00,507202,Vaida; Florin,9999,0,9999,0
1714378732338,CLRE 259,A00,507211,Patel; Hemal,9996,0,9999,3
1714378733363,CLRE 260,A00,507221,Cuomo; Raphael Eduardo,9999,0,9999,0
1714378734393,CLRE 297,001,507242,Cuomo; Raphael Eduardo,9999,0,9999,0
1714378735418,COGS 197,001,638244,Voytek; Bradley Thomas,9999,0,9999,0
1714378736444,CSE 191,A00,516875,Minnes Kemp; Mor Mia,9993,0,9999,6
1714378737479,CSE 197,001,637388,Minnes Kemp; Mor Mia,9998,0,9999,1
1714378738505,CSS 201S,A01,494383,Staff,35,0,35,0
1714378739533,CSS 202S,A01,494387,Staff,35,0,35,0
1714378740561,DSC 197,001,628532,Eldridge; Justin Matthew,9996,0,9999,3
1714378741591,EAP 100,A00,516065,Staff,9797,0,9999,202
1714378742621,ECE 45,A01,507414,Staff,33,0,60,27
1714378744679,ECE 111,A01,507420,Staff,19,0,50,31
1714378745705,ECE 197,001,548057,Sievenpiper; Daniel F.,9994,0,9999,5
1714378746735,EDS 115,A00,507243,Choi; Bailey Miyeon,12,0,28,16
1714378747766,EDS 117,A01,494379,Staff,0,2,30,30
1714378748792,EDS 125,A00,507246,Hopkins; Megan Beth,12,0,30,18
1714378749818,EDS 128A,A01,507264,Fargason; Sharon Gayle,14,0,26,12
1714378750844,EDS 128B,A01,507293,Pappas; Elizabeth,18,0,30,12
1714378751872,EDS 139,A00,507294,Fargason; Sharon Gayle,18,0,30,12
1714378751872,EDS 139,B00,507313,Pappas; Elizabeth,15,0,30,15
1714378752899,EDS 201,A00,507315,Staff,13,0,30,17
1714378753926,EDS 203,A01,507317,Halter; Christopher P.,12,0,30,18
1714378754959,EDS 204R,A01,507319,Halter; Christopher P.,0,3,30,30
1714378754959,EDS 204R,B01,507331,Heinzman; Erica M.,17,0,30,13
1714378755988,EDS 206R,A00,507332,Staff,0,4,30,30
1714378755988,EDS 206R,B00,507343,Staff,18,0,30,12
1714378757014,EDS 250,A00,507344,Hemans; Patricia Ann Benitez,22,0,40,18
1714378758041,EDS 281,A00,507345,Daly; Alan J.,18,0,18,0
1714378759066,EDS 284,A00,507350,Daly; Alan J.,16,0,16,0
1714378760093,EDS 286,A00,507359,Fine; Sarah,18,0,18,0
1714378761118,EDS 289C,A01,507361,Daly; Alan J.,18,0,18,0
1714378762144,EDS 290,A00,507366,Hofstetter; Carolyn,15,0,15,0
1714378763169,LIGM 5A,A00,507421,Fischer-Grunski; Eva K,18,0,20,2
1714378764193,LIGM 5B,A00,507423,Fischer-Grunski; Eva K,19,0,20,1
1714378765219,LIGM 5C,A00,507425,Fischer-Grunski; Eva K,19,0,20,1
1714378766245,LIIT 5AS,A00,507427,Carnelos; Chiara,20,0,20,0
1714378767271,LIIT 5BS,A00,507430,Carnelos; Chiara,20,0,20,0
1714378768299,LIIT 5CS,A00,507432,Carnelos; Chiara,20,0,20,0
1714378769331,LISP 5A,A00,507541,Munoz Sanchez; Alicia,11,0,20,9
1714378770363,LISP 5B,A00,507671,Munoz Sanchez; Alicia,9,0,20,11
1714378771391,LISP 5C,A00,507696,Munoz Sanchez; Alicia,9,0,20,11
1714378772418,MAE 197,001,528363,Boechler; Nicholas Sebastia,9998,0,9999,1
1714378773447,MATH 197,001,523477,Kedlaya; Kiran S.,9996,0,9999,3
1714378773447,MATH 197,002,563811,Zhang; Danna,9995,0,9999,4
1714378773447,MATH 197,003,628552,Dumitriu; Ioana,9998,0,9999,1
1714378774472,MCWP 40R,A00,518780,Staff,5,0,20,15
1714378774472,MCWP 40R,B00,518781,Staff,7,0,20,13
1714378774472,MCWP 40R,C00,518783,Staff,5,0,20,15
1714378775503,MCWP 50R,A00,518791,Staff,0,0,20,20
1714378775503,MCWP 50R,B00,518792,Staff,0,1,20,20
1714378775503,MCWP 50R,C00,518793,Staff,0,1,20,20
1714378775503,MCWP 50R,D00,518794,Staff,0,0,20,20
1714378775503,MCWP 50R,E00,518795,Staff,0,1,20,20
1714378775503,MCWP 50R,F00,518796,Staff,0,0,20,20
1714378775503,MCWP 50R,G00,518797,Staff,0,1,20,20
1714378776530,MMW 12R,A01,514034,Herbst; Matthew,0,1,16,16
1714378776530,MMW 12R,A02,514035,Herbst; Matthew,2,0,16,14
1714378777558,MMW 13R,A01,514037,Staff,0,4,16,16
1714378777558,MMW 13R,A02,514039,Staff,0,2,16,16
1714378777558,MMW 13R,A03,628519,Staff,0,2,16,16
1714378779611,SIO 295LS,A00,523233,Staff,12,0,30,18
1714378780636,SIO 295S,A00,523232,Staff,12,0,30,18
1714378781664,SIOC 290S,A01,637330,Merrifield; Mark A,27,0,30,3
1714378782695,SIOC 291S,A01,637333,Gabriel; Corey John,27,0,30,3
1714378783725,SOCI 117,A01,494376,Staff,0,4,5,5
1714378784750,WES 237B,A00,494380,Staff,9,0,20,11
1714378786850,AESE 279B,A00,494370,Wade; Jon P,0,0,33,33
1714378787875,AIP 197,001,627712,Vespa; Emanuel Ignacio,9998,0,9999,1
1714378788905,ANAR 135S,A00,494369,Braswell; Geoffrey E.,0,0,0,0
1714378789930,BENG 196,001,628496,Engler; Adam J.,9998,0,9999,1
1714378790958,CAT 124RS,A01,519847,Geibel; William,0,0,20,20
1714378791984,CAT 125RS,A01,515971,Geibel; William,0,0,20,20
1714378793015,CLRE 250,A00,511389,Morris; Sheldon,9993,0,9999,6
1714378794048,CLRE 251,A00,507176,Mehta; Ravindra L.,9993,0,9999,6
1714378794048,CLRE 251,B00,511410,Mehta; Ravindra L.,9998,0,9999,1
1714378795075,CLRE 252,A00,507189,Cuomo; Raphael Eduardo,9995,0,9999,4
1714378796108,CLRE 253,A00,507199,Vaida; Florin,9994,0,9999,5
1714378796108,CLRE 253,B00,507202,Vaida; Florin,9999,0,9999,0
1714378797135,CLRE 259,A00,507211,Patel; Hemal,9996,0,9999,3
1714378798163,CLRE 260,A00,507221,Cuomo; Raphael Eduardo,9999,0,9999,0
1714378799189,CLRE 297,001,507242,Cuomo; Raphael Eduardo,9999,0,9999,0
1714378800217,COGS 197,001,638244,Voytek; Bradley Thomas,9999,0,9999,0
1714378801250,CSE 191,A00,516875,Minnes Kemp; Mor Mia,9993,0,9999,6
1714378802275,CSE 197,001,637388,Minnes Kemp; Mor Mia,9998,0,9999,1
1714378803302,CSS 201S,A01,494383,Staff,35,0,35,0
1714378804328,CSS 202S,A01,494387,Staff,35,0,35,0
1714378805354,DSC 197,001,628532,Eldridge; Justin Matthew,9996,0,9999,3
1714378806380,EAP 100,A00,516065,Staff,9797,0,9999,202
1714378807410,ECE 45,A01,507414,Staff,33,0,60,27
1714378809465,ECE 111,A01,507420,Staff,19,0,50,31
1714378810491,ECE 197,001,548057,Sievenpiper; Daniel F.,9994,0,9999,5
1714378811527,EDS 115,A00,507243,Choi; Bailey Miyeon,12,0,28,16
1714378812557,EDS 117,A01,494379,Staff,0,2,30,30
1714378813586,EDS 125,A00,507246,Hopkins; Megan Beth,12,0,30,18
1714378814618,EDS 128A,A01,507264,Fargason; Sharon Gayle,14,0,26,12
1714378815647,EDS 128B,A01,507293,Pappas; Elizabeth,18,0,30,12
1714378817472,EDS 139,A00,507294,Fargason; Sharon Gayle,18,0,30,12
1714378817472,EDS 139,B00,507313,Pappas; Elizabeth,15,0,30,15
1714378818497,EDS 201,A00,507315,Staff,13,0,30,17
1714378819527,EDS 203,A01,507317,Halter; Christopher P.,12,0,30,18
1714378820558,EDS 204R,A01,507319,Halter; Christopher P.,0,3,30,30
1714378820558,EDS 204R,B01,507331,Heinzman; Erica M.,17,0,30,13
1714378821641,EDS 206R,A00,507332,Staff,0,4,30,30
1714378821641,EDS 206R,B00,507343,Staff,18,0,30,12
1714378822669,EDS 250,A00,507344,Hemans; Patricia Ann Benitez,22,0,40,18
1714378823693,EDS 281,A00,507345,Daly; Alan J.,18,0,18,0
1714378824718,EDS 284,A00,507350,Daly; Alan J.,16,0,16,0
1714378825746,EDS 286,A00,507359,Fine; Sarah,18,0,18,0
1714378826772,EDS 289C,A01,507361,Daly; Alan J.,18,0,18,0
1714378827800,EDS 290,A00,507366,Hofstetter; Carolyn,15,0,15,0
1714378828825,LIGM 5A,A00,507421,Fischer-Grunski; Eva K,18,0,20,2
1714378829851,LIGM 5B,A00,507423,Fischer-Grunski; Eva K,19,0,20,1
1714378830876,LIGM 5C,A00,507425,Fischer-Grunski; Eva K,19,0,20,1
1714378831901,LIIT 5AS,A00,507427,Carnelos; Chiara,20,0,20,0
1714378832930,LIIT 5BS,A00,507430,Carnelos; Chiara,20,0,20,0
1714378833964,LIIT 5CS,A00,507432,Carnelos; Chiara,20,0,20,0
1714378834995,LISP 5A,A00,507541,Munoz Sanchez; Alicia,11,0,20,9
1714378836020,LISP 5B,A00,507671,Munoz Sanchez; Alicia,9,0,20,11
1714378837045,LISP 5C,A00,507696,Munoz Sanchez; Alicia,9,0,20,11
1714378838069,MAE 197,001,528363,Boechler; Nicholas Sebastia,9998,0,9999,1
1714378839093,MATH 197,001,523477,Kedlaya; Kiran S.,9996,0,9999,3
1714378839093,MATH 197,002,563811,Zhang; Danna,9995,0,9999,4
1714378839093,MATH 197,003,628552,Dumitriu; Ioana,9998,0,9999,1
1714378840120,MCWP 40R,A00,518780,Staff,5,0,20,15
1714378840120,MCWP 40R,B00,518781,Staff,7,0,20,13
1714378840120,MCWP 40R,C00,518783,Staff,5,0,20,15
1714378841146,MCWP 50R,A00,518791,Staff,0,0,20,20
1714378841146,MCWP 50R,B00,518792,Staff,0,1,20,20
1714378841146,MCWP 50R,C00,518793,Staff,0,1,20,20
1714378841146,MCWP 50R,D00,518794,Staff,0,0,20,20
1714378841146,MCWP 50R,E00,518795,Staff,0,1,20,20
1714378841146,MCWP 50R,F00,518796,Staff,0,0,20,20
1714378841146,MCWP 50R,G00,518797,Staff,0,1,20,20
1714378842172,MMW 12R,A01,514034,Herbst; Matthew,0,1,16,16
1714378842172,MMW 12R,A02,514035,Herbst; Matthew,2,0,16,14
1714378843196,MMW 13R,A01,514037,Staff,0,4,16,16
1714378843196,MMW 13R,A02,514039,Staff,0,2,16,16
1714378843196,MMW 13R,A03,628519,Staff,0,2,16,16
1714378845248,SIO 295LS,A00,523233,Staff,12,0,30,18
1714378846276,SIO 295S,A00,523232,Staff,12,0,30,18
1714378847301,SIOC 290S,A01,637330,Merrifield; Mark A,27,0,30,3
1714378848326,SIOC 291S,A01,637333,Gabriel; Corey John,27,0,30,3
1714378849351,SOCI 117,A01,494376,Staff,0,4,5,5
1714378850376,WES 237B,A00,494380,Staff,9,0,20,11
1714378852459,AESE 279B,A00,494370,Wade; Jon P,0,0,33,33
1714378853485,AIP 197,001,627712,Vespa; Emanuel Ignacio,9998,0,9999,1
1714378854511,ANAR 135S,A00,494369,Braswell; Geoffrey E.,0,0,0,0
1714378855540,BENG 196,001,628496,Engler; Adam J.,9998,0,9999,1
1714378856566,CAT 124RS,A01,519847,Geibel; William,0,0,20,20
1714378857591,CAT 125RS,A01,515971,Geibel; William,0,0,20,20
1714378858618,CLRE 250,A00,511389,Morris; Sheldon,9993,0,9999,6
1714378859646,CLRE 251,A00,507176,Mehta; Ravindra L.,9993,0,9999,6
1714378859646,CLRE 251,B00,511410,Mehta; Ravindra L.,9998,0,9999,1
1714378860672,CLRE 252,A00,507189,Cuomo; Raphael Eduardo,9995,0,9999,4
1714378861698,CLRE 253,A00,507199,Vaida; Florin,9994,0,9999,5
1714378861698,CLRE 253,B00,507202,Vaida; Florin,9999,0,9999,0
1714378862724,CLRE 259,A00,507211,Patel; Hemal,9996,0,9999,3
1714378863748,CLRE 260,A00,507221,Cuomo; Raphael Eduardo,9999,0,9999,0
1714378864773,CLRE 297,001,507242,Cuomo; Raphael Eduardo,9999,0,9999,0
1714378865800,COGS 197,001,638244,Voytek; Bradley Thomas,9999,0,9999,0
1714378866829,CSE 191,A00,516875,Minnes Kemp; Mor Mia,9993,0,9999,6
1714378867855,CSE 197,001,637388,Minnes Kemp; Mor Mia,9998,0,9999,1
1714378868889,CSS 201S,A01,494383,Staff,35,0,35,0
1714378869919,CSS 202S,A01,494387,Staff,35,0,35,0
1714378870942,DSC 197,001,628532,Eldridge; Justin Matthew,9996,0,9999,3
1714378871967,EAP 100,A00,516065,Staff,9797,0,9999,202
1714378872993,ECE 45,A01,507414,Staff,33,0,60,27
1714378875045,ECE 111,A01,507420,Staff,19,0,50,31
1714378876072,ECE 197,001,548057,Sievenpiper; Daniel F.,9994,0,9999,5
1714378877100,EDS 115,A00,507243,Choi; Bailey Miyeon,12,0,28,16
1714378878127,EDS 117,A01,494379,Staff,0,2,30,30
1714378879153,EDS 125,A00,507246,Hopkins; Megan Beth,12,0,30,18
1714378880179,EDS 128A,A01,507264,Fargason; Sharon Gayle,14,0,26,12
1714378881208,EDS 128B,A01,507293,Pappas; Elizabeth,18,0,30,12
1714378882236,EDS 139,A00,507294,Fargason; Sharon Gayle,18,0,30,12
1714378882236,EDS 139,B00,507313,Pappas; Elizabeth,15,0,30,15
1714378883262,EDS 201,A00,507315,Staff,13,0,30,17
1714378884291,EDS 203,A01,507317,Halter; Christopher P.,12,0,30,18
1714378885321,EDS 204R,A01,507319,Halter; Christopher P.,0,3,30,30
1714378885321,EDS 204R,B01,507331,Heinzman; Erica M.,17,0,30,13
1714378886345,EDS 206R,A00,507332,Staff,0,4,30,30
1714378886345,EDS 206R,B00,507343,Staff,18,0,30,12
1714378887373,EDS 250,A00,507344,Hemans; Patricia Ann Benitez,22,0,40,18
1714378888399,EDS 281,A00,507345,Daly; Alan J.,18,0,18,0
1714378889422,EDS 284,A00,507350,Daly; Alan J.,16,0,16,0
1714378890448,EDS 286,A00,507359,Fine; Sarah,18,0,18,0
1714378891473,EDS 289C,A01,507361,Daly; Alan J.,18,0,18,0
1714378892500,EDS 290,A00,507366,Hofstetter; Carolyn,15,0,15,0
1714378893532,LIGM 5A,A00,507421,Fischer-Grunski; Eva K,18,0,20,2
1714378894558,LIGM 5B,A00,507423,Fischer-Grunski; Eva K,19,0,20,1
1714378895583,LIGM 5C,A00,507425,Fischer-Grunski; Eva K,19,0,20,1
1714378896611,LIIT 5AS,A00,507427,Carnelos; Chiara,20,0,20,0
1714378897639,LIIT 5BS,A00,507430,Carnelos; Chiara,20,0,20,0
1714378898667,LIIT 5CS,A00,507432,Carnelos; Chiara,20,0,20,0
1714378899694,LISP 5A,A00,507541,Munoz Sanchez; Alicia,11,0,20,9
1714378900720,LISP 5B,A00,507671,Munoz Sanchez; Alicia,9,0,20,11
1714378901746,LISP 5C,A00,507696,Munoz Sanchez; Alicia,9,0,20,11
1714378902773,MAE 197,001,528363,Boechler; Nicholas Sebastia,9998,0,9999,1
1714378903798,MATH 197,001,523477,Kedlaya; Kiran S.,9996,0,9999,3
1714378903798,MATH 197,002,563811,Zhang; Danna,9995,0,9999,4
1714378903798,MATH 197,003,628552,Dumitriu; Ioana,9998,0,9999,1
1714378904823,MCWP 40R,A00,518780,Staff,5,0,20,15
1714378904823,MCWP 40R,B00,518781,Staff,7,0,20,13
1714378904823,MCWP 40R,C00,518783,Staff,5,0,20,15
1714378905849,MCWP 50R,A00,518791,Staff,0,0,20,20
1714378905849,MCWP 50R,B00,518792,Staff,0,1,20,20
1714378905849,MCWP 50R,C00,518793,Staff,0,1,20,20
1714378905849,MCWP 50R,D00,518794,Staff,0,0,20,20
1714378905849,MCWP 50R,E00,518795,Staff,0,1,20,20
1714378905849,MCWP 50R,F00,518796,Staff,0,0,20,20
1714378905849,MCWP 50R,G00,518797,Staff,0,1,20,20
1714378906879,MMW 12R,A01,514034,Herbst; Matthew,0,1,16,16
1714378906879,MMW 12R,A02,514035,Herbst; Matthew,2,0,16,14
1714378907903,MMW 13R,A01,514037,Staff,0,4,16,16
1714378907903,MMW 13R,A02,514039,Staff,0,2,16,16
1714378907903,MMW 13R,A03,628519,Staff,0,2,16,16
1714378909957,SIO 295LS,A00,523233,Staff,12,0,30,18
1714378910983,SIO 295S,A00,523232,Staff,12,0,30,18
1714378912009,SIOC 290S,A01,637330,Merrifield; Mark A,27,0,30,3
1714378913036,SIOC 291S,A01,637333,Gabriel; Corey John,27,0,30,3
1714378914061,SOCI 117,A01,494376,Staff,0,4,5,5
1714378915085,WES 237B,A00,494380,Staff,9,0,20,11
1714378917166,AESE 279B,A00,494370,Wade; Jon P,0,0,33,33
1714378918191,AIP 197,001,627712,Vespa; Emanuel Ignacio,9998,0,9999,1
1714378919219,ANAR 135S,A00,494369,Braswell; Geoffrey E.,0,0,0,0
1714378920245,BENG 196,001,628496,Engler; Adam J.,9998,0,9999,1
1714378921275,CAT 124RS,A01,519847,Geibel; William,0,0,20,20
1714378922301,CAT 125RS,A01,515971,Geibel; William,0,0,20,20
1714378923331,CLRE 250,A00,511389,Morris; Sheldon,9993,0,9999,6
1714378924365,CLRE 251,A00,507176,Mehta; Ravindra L.,9993,0,9999,6
1714378924365,CLRE 251,B00,511410,Mehta; Ravindra L.,9998,0,9999,1
1714378925446,CLRE 252,A00,507189,Cuomo; Raphael Eduardo,9995,0,9999,4
1714378926475,CLRE 253,A00,507199,Vaida; Florin,9994,0,9999,5
1714378926475,CLRE 253,B00,507202,Vaida; Florin,9999,0,9999,0
1714378927499,CLRE 259,A00,507211,Patel; Hemal,9996,0,9999,3
1714378928524,CLRE 260,A00,507221,Cuomo; Raphael Eduardo,9999,0,9999,0
1714378929550,CLRE 297,001,507242,Cuomo; Raphael Eduardo,9999,0,9999,0
1714378930575,COGS 197,001,638244,Voytek; Bradley Thomas,9999,0,9999,0
1714378931600,CSE 191,A00,516875,Minnes Kemp; Mor Mia,9993,0,9999,6
1714378932624,CSE 197,001,637388,Minnes Kemp; Mor Mia,9998,0,9999,1
1714378933648,CSS 201S,A01,494383,Staff,35,0,35,0
1714378934674,CSS 202S,A01,494387,Staff,35,0,35,0
1714378935700,DSC 197,001,628532,Eldridge; Justin Matthew,9996,0,9999,3
1714378936727,EAP 100,A00,516065,Staff,9797,0,9999,202
1714378937751,ECE 45,A01,507414,Staff,33,0,60,27
1714378939801,ECE 111,A01,507420,Staff,19,0,50,31
1714378940828,ECE 197,001,548057,Sievenpiper; Daniel F.,9994,0,9999,5
1714378941857,EDS 115,A00,507243,Choi; Bailey Miyeon,12,0,28,16
1714378942887,EDS 117,A01,494379,Staff,0,2,30,30
1714378943912,EDS 125,A00,507246,Hopkins; Megan Beth,12,0,30,18
1714378944939,EDS 128A,A01,507264,Fargason; Sharon Gayle,14,0,26,12
1714378945971,EDS 128B,A01,507293,Pappas; Elizabeth,18,0,30,12
1714378947001,EDS 139,A00,507294,Fargason; Sharon Gayle,18,0,30,12
1714378947001,EDS 139,B00,507313,Pappas; Elizabeth,15,0,30,15
1714378948026,EDS 201,A00,507315,Staff,13,0,30,17
1714378949055,EDS 203,A01,507317,Halter; Christopher P.,12,0,30,18
1714378950080,EDS 204R,A01,507319,Halter; Christopher P.,0,3,30,30
1714378950080,EDS 204R,B01,507331,Heinzman; Erica M.,17,0,30,13
1714378951105,EDS 206R,A00,507332,Staff,0,4,30,30
1714378951105,EDS 206R,B00,507343,Staff,18,0,30,12
1714378952133,EDS 250,A00,507344,Hemans; Patricia Ann Benitez,22,0,40,18
1714378953158,EDS 281,A00,507345,Daly; Alan J.,18,0,18,0
1714378954183,EDS 284,A00,507350,Daly; Alan J.,16,0,16,0
1714378955210,EDS 286,A00,507359,Fine; Sarah,18,0,18,0
1714378956239,EDS 289C,A01,507361,Daly; Alan J.,18,0,18,0
1714378957266,EDS 290,A00,507366,Hofstetter; Carolyn,15,0,15,0
1714378958297,LIGM 5A,A00,507421,Fischer-Grunski; Eva K,18,0,20,2
1714378959322,LIGM 5B,A00,507423,Fischer-Grunski; Eva K,19,0,20,1
1714378960351,LIGM 5C,A00,507425,Fischer-Grunski; Eva K,19,0,20,1
1714378961377,LIIT 5AS,A00,507427,Carnelos; Chiara,20,0,20,0
1714378962407,LIIT 5BS,A00,507430,Carnelos; Chiara,20,0,20,0
1714378963442,LIIT 5CS,A00,507432,Carnelos; Chiara,20,0,20,0
1714378964467,LISP 5A,A00,507541,Munoz Sanchez; Alicia,11,0,20,9
1714378965492,LISP 5B,A00,507671,Munoz Sanchez; Alicia,9,0,20,11
1714378966523,LISP 5C,A00,507696,Munoz Sanchez; Alicia,9,0,20,11
1714378967548,MAE 197,001,528363,Boechler; Nicholas Sebastia,9998,0,9999,1
1714378968574,MATH 197,001,523477,Kedlaya; Kiran S.,9996,0,9999,3
1714378968574,MATH 197,002,563811,Zhang; Danna,9995,0,9999,4
1714378968574,MATH 197,003,628552,Dumitriu; Ioana,9998,0,9999,1
1714378969599,MCWP 40R,A00,518780,Staff,5,0,20,15
1714378969599,MCWP 40R,B00,518781,Staff,7,0,20,13
1714378969599,MCWP 40R,C00,518783,Staff,5,0,20,15
1714378970628,MCWP 50R,A00,518791,Staff,0,0,20,20
1714378970628,MCWP 50R,B00,518792,Staff,0,1,20,20
1714378970628,MCWP 50R,C00,518793,Staff,0,1,20,20
1714378970628,MCWP 50R,D00,518794,Staff,0,0,20,20
1714378970628,MCWP 50R,E00,518795,Staff,0,1,20,20
1714378970628,MCWP 50R,F00,518796,Staff,0,0,20,20
1714378970628,MCWP 50R,G00,518797,Staff,0,1,20,20
1714378971655,MMW 12R,A01,514034,Herbst; Matthew,0,1,16,16
1714378971655,MMW 12R,A02,514035,Herbst; Matthew,2,0,16,14
1714378972679,MMW 13R,A01,514037,Staff,0,4,16,16
1714378972679,MMW 13R,A02,514039,Staff,0,2,16,16
1714378972679,MMW 13R,A03,628519,Staff,0,2,16,16
1714378974732,SIO 295LS,A00,523233,Staff,12,0,30,18
1714378975756,SIO 295S,A00,523232,Staff,12,0,30,18
1714378976782,SIOC 290S,A01,637330,Merrifield; Mark A,27,0,30,3
1714378977807,SIOC 291S,A01,637333,Gabriel; Corey John,27,0,30,3
1714378978834,SOCI 117,A01,494376,Staff,0,4,5,5
1714378979862,WES 237B,A00,494380,Staff,9,0,20,11
1714378981946,AESE 279B,A00,494370,Wade; Jon P,0,0,33,33
1714378982972,AIP 197,001,627712,Vespa; Emanuel Ignacio,9998,0,9999,1
1714378983998,ANAR 135S,A00,494369,Braswell; Geoffrey E.,0,0,0,0
1714378985024,BENG 196,001,628496,Engler; Adam J.,9998,0,9999,1
1714378986049,CAT 124RS,A01,519847,Geibel; William,0,0,20,20
1714378987074,CAT 125RS,A01,515971,Geibel; William,0,0,20,20
1714378988106,CLRE 250,A00,511389,Morris; Sheldon,9993,0,9999,6
1714378989139,CLRE 251,A00,507176,Mehta; Ravindra L.,9993,0,9999,6
1714378989139,CLRE 251,B00,511410,Mehta; Ravindra L.,9998,0,9999,1
1714378990165,CLRE 252,A00,507189,Cuomo; Raphael Eduardo,9995,0,9999,4
1714378991190,CLRE 253,A00,507199,Vaida; Florin,9994,0,9999,5
1714378991190,CLRE 253,B00,507202,Vaida; Florin,9999,0,9999,0
1714378992218,CLRE 259,A00,507211,Patel; Hemal,9996,0,9999,3
1714378993246,CLRE 260,A00,507221,Cuomo; Raphael Eduardo,9999,0,9999,0
1714378994272,CLRE 297,001,507242,Cuomo; Raphael Eduardo,9999,0,9999,0
1714378995295,COGS 197,001,638244,Voytek; Bradley Thomas,9999,0,9999,0
1714378996320,CSE 191,A00,516875,Minnes Kemp; Mor Mia,9993,0,9999,6
1714378997345,CSE 197,001,637388,Minnes Kemp; Mor Mia,9998,0,9999,1
1714378998375,CSS 201S,A01,494383,Staff,35,0,35,0
1714378999401,CSS 202S,A01,494387,Staff,35,0,35,0
1714379000429,DSC 197,001,628532,Eldridge; Justin Matthew,9996,0,9999,3
1714379001454,EAP 100,A00,516065,Staff,9797,0,9999,202
1714379002480,ECE 45,A01,507414,Staff,33,0,60,27
1714379004533,ECE 111,A01,507420,Staff,19,0,50,31
1714379005558,ECE 197,001,548057,Sievenpiper; Daniel F.,9994,0,9999,5
1714379006589,EDS 115,A00,507243,Choi; Bailey Miyeon,12,0,28,16
1714379007616,EDS 117,A01,494379,Staff,0,2,30,30
1714379008641,EDS 125,A00,507246,Hopkins; Megan Beth,12,0,30,18
1714379009668,EDS 128A,A01,507264,Fargason; Sharon Gayle,14,0,26,12
1714379010693,EDS 128B,A01,507293,Pappas; Elizabeth,18,0,30,12
1714379011719,EDS 139,A00,507294,Fargason; Sharon Gayle,18,0,30,12
1714379011719,EDS 139,B00,507313,Pappas; Elizabeth,15,0,30,15
1714379012744,EDS 201,A00,507315,Staff,13,0,30,17
1714379013771,EDS 203,A01,507317,Halter; Christopher P.,12,0,30,18
1714379014801,EDS 204R,A01,507319,Halter; Christopher P.,0,3,30,30
1714379014801,EDS 204R,B01,507331,Heinzman; Erica M.,17,0,30,13
1714379015830,EDS 206R,A00,507332,Staff,0,4,30,30
1714379015830,EDS 206R,B00,507343,Staff,18,0,30,12
1714379016854,EDS 250,A00,507344,Hemans; Patricia Ann Benitez,22,0,40,18
1714379017879,EDS 281,A00,507345,Daly; Alan J.,18,0,18,0
1714379018906,EDS 284,A00,507350,Daly; Alan J.,16,0,16,0
1714379019933,EDS 286,A00,507359,Fine; Sarah,18,0,18,0
1714379020959,EDS 289C,A01,507361,Daly; Alan J.,18,0,18,0
1714379021984,EDS 290,A00,507366,Hofstetter; Carolyn,15,0,15,0
1714379023011,LIGM 5A,A00,507421,Fischer-Grunski; Eva K,18,0,20,2
1714379024043,LIGM 5B,A00,507423,Fischer-Grunski; Eva K,19,0,20,1
1714379025069,LIGM 5C,A00,507425,Fischer-Grunski; Eva K,19,0,20,1
1714379026101,LIIT 5AS,A00,507427,Carnelos; Chiara,20,0,20,0
1714379027125,LIIT 5BS,A00,507430,Carnelos; Chiara,20,0,20,0
1714379028150,LIIT 5CS,A00,507432,Carnelos; Chiara,20,0,20,0
1714379029231,LISP 5A,A00,507541,Munoz Sanchez; Alicia,11,0,20,9
1714379030257,LISP 5B,A00,507671,Munoz Sanchez; Alicia,9,0,20,11
1714379031285,LISP 5C,A00,507696,Munoz Sanchez; Alicia,9,0,20,11
1714379032309,MAE 197,001,528363,Boechler; Nicholas Sebastia,9998,0,9999,1
1714379033334,MATH 197,001,523477,Kedlaya; Kiran S.,9996,0,9999,3
1714379033334,MATH 197,002,563811,Zhang; Danna,9995,0,9999,4
1714379033334,MATH 197,003,628552,Dumitriu; Ioana,9998,0,9999,1
1714379034365,MCWP 40R,A00,518780,Staff,5,0,20,15
1714379034365,MCWP 40R,B00,518781,Staff,7,0,20,13
1714379034365,MCWP 40R,C00,518783,Staff,5,0,20,15
1714379035391,MCWP 50R,A00,518791,Staff,0,0,20,20
1714379035391,MCWP 50R,B00,518792,Staff,0,1,20,20
1714379035391,MCWP 50R,C00,518793,Staff,0,1,20,20
1714379035391,MCWP 50R,D00,518794,Staff,0,0,20,20
1714379035391,MCWP 50R,E00,518795,Staff,0,1,20,20
1714379035391,MCWP 50R,F00,518796,Staff,0,0,20,20
1714379035391,MCWP 50R,G00,518797,Staff,0,1,20,20
1714379036420,MMW 12R,A01,514034,Herbst; Matthew,0,1,16,16
1714379036420,MMW 12R,A02,514035,Herbst; Matthew,2,0,16,14
1714379037448,MMW 13R,A01,514037,Staff,0,4,16,16
1714379037448,MMW 13R,A02,514039,Staff,0,2,16,16
1714379037448,MMW 13R,A03,628519,Staff,0,2,16,16
1714379039496,SIO 295LS,A00,523233,Staff,12,0,30,18
1714379040524,SIO 295S,A00,523232,Staff,12,0,30,18
1714379041552,SIOC 290S,A01,637330,Merrifield; Mark A,27,0,30,3
1714379042577,SIOC 291S,A01,637333,Gabriel; Corey John,27,0,30,3
1714379043603,SOCI 117,A01,494376,Staff,0,4,5,5
1714379044627,WES 237B,A00,494380,Staff,9,0,20,11
1714379046696,AESE 279B,A00,494370,Wade; Jon P,0,0,33,33
1714379047720,AIP 197,001,627712,Vespa; Emanuel Ignacio,9998,0,9999,1
1714379048743,ANAR 135S,A00,494369,Braswell; Geoffrey E.,0,0,0,0
1714379049771,BENG 196,001,628496,Engler; Adam J.,9998,0,9999,1
1714379050799,CAT 124RS,A01,519847,Geibel; William,0,0,20,20
1714379051829,CAT 125RS,A01,515971,Geibel; William,0,0,20,20
1714379052853,CLRE 250,A00,511389,Morris; Sheldon,9993,0,9999,6
1714379053879,CLRE 251,A00,507176,Mehta; Ravindra L.,9993,0,9999,6
1714379053879,CLRE 251,B00,511410,Mehta; Ravindra L.,9998,0,9999,1
1714379054908,CLRE 252,A00,507189,Cuomo; Raphael Eduardo,9995,0,9999,4
1714379055937,CLRE 253,A00,507199,Vaida; Florin,9994,0,9999,5
1714379055937,CLRE 253,B00,507202,Vaida; Florin,9999,0,9999,0
1714379056965,CLRE 259,A00,507211,Patel; Hemal,9996,0,9999,3
1714379057992,CLRE 260,A00,507221,Cuomo; Raphael Eduardo,9999,0,9999,0
1714379059017,CLRE 297,001,507242,Cuomo; Raphael Eduardo,9999,0,9999,0
1714379060041,COGS 197,001,638244,Voytek; Bradley Thomas,9999,0,9999,0
1714379061066,CSE 191,A00,516875,Minnes Kemp; Mor Mia,9993,0,9999,6
1714379062092,CSE 197,001,637388,Minnes Kemp; Mor Mia,9998,0,9999,1
1714379063116,CSS 201S,A01,494383,Staff,35,0,35,0
1714379064141,CSS 202S,A01,494387,Staff,35,0,35,0
1714379065168,DSC 197,001,628532,Eldridge; Justin Matthew,9996,0,9999,3
1714379066192,EAP 100,A00,516065,Staff,9797,0,9999,202
1714379067219,ECE 45,A01,507414,Staff,33,0,60,27
1714379069273,ECE 111,A01,507420,Staff,19,0,50,31
1714379070298,ECE 197,001,548057,Sievenpiper; Daniel F.,9994,0,9999,5
1714379071325,EDS 115,A00,507243,Choi; Bailey Miyeon,12,0,28,16
1714379072351,EDS 117,A01,494379,Staff,0,2,30,30
1714379073376,EDS 125,A00,507246,Hopkins; Megan Beth,12,0,30,18
1714379074402,EDS 128A,A01,507264,Fargason; Sharon Gayle,14,0,26,12
1714379075428,EDS 128B,A01,507293,Pappas; Elizabeth,18,0,30,12
1714379076455,EDS 139,A00,507294,Fargason; Sharon Gayle,18,0,30,12
1714379076455,EDS 139,B00,507313,Pappas; Elizabeth,15,0,30,15
1714379077481,EDS 201,A00,507315,Staff,13,0,30,17
1714379078506,EDS 203,A01,507317,Halter; Christopher P.,12,0,30,18
1714379079534,EDS 204R,A01,507319,Halter; Christopher P.,0,3,30,30
1714379079534,EDS 204R,B01,507331,Heinzman; Erica M.,17,0,30,13
1714379080559,EDS 206R,A00,507332,Staff,0,4,30,30
1714379080559,EDS 206R,B00,507343,Staff,18,0,30,12
1714379081585,EDS 250,A00,507344,Hemans; Patricia Ann Benitez,22,0,40,18
1714379082610,EDS 281,A00,507345,Daly; Alan J.,18,0,18,0
1714379083634,EDS 284,A00,507350,Daly; Alan J.,16,0,16,0
1714379084658,EDS 286,A00,507359,Fine; Sarah,18,0,18,0
1714379085682,EDS 289C,A01,507361,Daly; Alan J.,18,0,18,0
1714379086708,EDS 290,A00,507366,Hofstetter; Carolyn,15,0,15,0
1714379087735,LIGM 5A,A00,507421,Fischer-Grunski; Eva K,18,0,20,2
1714379088765,LIGM 5B,A00,507423,Fischer-Grunski; Eva K,19,0,20,1
1714379089790,LIGM 5C,A00,507425,Fischer-Grunski; Eva K,19,0,20,1
1714379090871,LIIT 5AS,A00,507427,Carnelos; Chiara,20,0,20,0
1714379091895,LIIT 5BS,A00,507430,Carnelos; Chiara,20,0,20,0
1714379092924,LIIT 5CS,A00,507432,Carnelos; Chiara,20,0,20,0
1714379093952,LISP 5A,A00,507541,Munoz Sanchez; Alicia,11,0,20,9
1714379094980,LISP 5B,A00,507671,Munoz Sanchez; Alicia,9,0,20,11
1714379096007,LISP 5C,A00,507696,Munoz Sanchez; Alicia,9,0,20,11
1714379097033,MAE 197,001,528363,Boechler; Nicholas Sebastia,9998,0,9999,1
1714379098060,MATH 197,001,523477,Kedlaya; Kiran S.,9996,0,9999,3
1714379098060,MATH 197,002,563811,Zhang; Danna,9995,0,9999,4
1714379098060,MATH 197,003,628552,Dumitriu; Ioana,9998,0,9999,1
1714379099085,MCWP 40R,A00,518780,Staff,5,0,20,15
1714379099085,MCWP 40R,B00,518781,Staff,7,0,20,13
1714379099085,MCWP 40R,C00,518783,Staff,5,0,20,15
1714379100109,MCWP 50R,A00,518791,Staff,0,0,20,20
1714379100109,MCWP 50R,B00,518792,Staff,0,1,20,20
1714379100109,MCWP 50R,C00,518793,Staff,0,1,20,20
1714379100109,MCWP 50R,D00,518794,Staff,0,0,20,20
1714379100109,MCWP 50R,E00,518795,Staff,0,1,20,20
1714379100109,MCWP 50R,F00,518796,Staff,0,0,20,20
1714379100109,MCWP 50R,G00,518797,Staff,0,1,20,20
1714379101136,MMW 12R,A01,514034,Herbst; Matthew,0,1,16,16
1714379101136,MMW 12R,A02,514035,Herbst; Matthew,2,0,16,14
1714379102165,MMW 13R,A01,514037,Staff,0,4,16,16
1714379102165,MMW 13R,A02,514039,Staff,0,2,16,16
1714379102165,MMW 13R,A03,628519,Staff,0,2,16,16
1714379104221,SIO 295LS,A00,523233,Staff,12,0,30,18
1714379105248,SIO 295S,A00,523232,Staff,12,0,30,18
1714379106272,SIOC 290S,A01,637330,Merrifield; Mark A,27,0,30,3
1714379107303,SIOC 291S,A01,637333,Gabriel; Corey John,27,0,30,3
1714379108331,SOCI 117,A01,494376,Staff,0,4,5,5
1714379109356,WES 237B,A00,494380,Staff,9,0,20,11
1714379111434,AESE 279B,A00,494370,Wade; Jon P,0,0,33,33
1714379112463,AIP 197,001,627712,Vespa; Emanuel Ignacio,9998,0,9999,1
1714379113488,ANAR 135S,A00,494369,Braswell; Geoffrey E.,0,0,0,0
1714379114513,BENG 196,001,628496,Engler; Adam J.,9998,0,9999,1
1714379115543,CAT 124RS,A01,519847,Geibel; William,0,0,20,20
1714379116567,CAT 125RS,A01,515971,Geibel; William,0,0,20,20
1714379117593,CLRE 250,A00,511389,Morris; Sheldon,9993,0,9999,6
1714379118621,CLRE 251,A00,507176,Mehta; Ravindra L.,9993,0,9999,6
1714379118621,CLRE 251,B00,511410,Mehta; Ravindra L.,9998,0,9999,1
1714379119645,CLRE 252,A00,507189,Cuomo; Raphael Eduardo,9995,0,9999,4
1714379120671,CLRE 253,A00,507199,Vaida; Florin,9994,0,9999,5
1714379120671,CLRE 253,B00,507202,Vaida; Florin,9999,0,9999,0
1714379121696,CLRE 259,A00,507211,Patel; Hemal,9996,0,9999,3
1714379122720,CLRE 260,A00,507221,Cuomo; Raphael Eduardo,9999,0,9999,0
1714379123750,CLRE 297,001,507242,Cuomo; Raphael Eduardo,9999,0,9999,0
1714379124779,COGS 197,001,638244,Voytek; Bradley Thomas,9999,0,9999,0
1714379125811,CSE 191,A00,516875,Minnes Kemp; Mor Mia,9993,0,9999,6
1714379126838,CSE 197,001,637388,Minnes Kemp; Mor Mia,9998,0,9999,1
1714379127867,CSS 201S,A01,494383,Staff,35,0,35,0
1714379128892,CSS 202S,A01,494387,Staff,35,0,35,0
1714379129922,DSC 197,001,628532,Eldridge; Justin Matthew,9996,0,9999,3
1714379130947,EAP 100,A00,516065,Staff,9797,0,9999,202
1714379131973,ECE 45,A01,507414,Staff,33,0,60,27
1714379134078,ECE 111,A01,507420,Staff,19,0,50,31
1714379135103,ECE 197,001,548057,Sievenpiper; Daniel F.,9994,0,9999,5
1714379136131,EDS 115,A00,507243,Choi; Bailey Miyeon,12,0,28,16
1714379137156,EDS 117,A01,494379,Staff,0,2,30,30
1714379138181,EDS 125,A00,507246,Hopkins; Megan Beth,12,0,30,18
1714379139208,EDS 128A,A01,507264,Fargason; Sharon Gayle,14,0,26,12
1714379140232,EDS 128B,A01,507293,Pappas; Elizabeth,18,0,30,12
1714379141256,EDS 139,A00,507294,Fargason; Sharon Gayle,18,0,30,12
1714379141256,EDS 139,B00,507313,Pappas; Elizabeth,15,0,30,15
1714379142283,EDS 201,A00,507315,Staff,13,0,30,17
1714379143311,EDS 203,A01,507317,Halter; Christopher P.,12,0,30,18
1714379144335,EDS 204R,A01,507319,Halter; Christopher P.,0,3,30,30
1714379144335,EDS 204R,B01,507331,Heinzman; Erica M.,17,0,30,13
1714379145359,EDS 206R,A00,507332,Staff,0,4,30,30
1714379145359,EDS 206R,B00,507343,Staff,18,0,30,12
1714379146384,EDS 250,A00,507344,Hemans; Patricia Ann Benitez,22,0,40,18
1714379147408,EDS 281,A00,507345,Daly; Alan J.,18,0,18,0
1714379148431,EDS 284,A00,507350,Daly; Alan J.,16,0,16,0
1714379149464,EDS 286,A00,507359,Fine; Sarah,18,0,18,0
1714379150492,EDS 289C,A01,507361,Daly; Alan J.,18,0,18,0
1714379151517,EDS 290,A00,507366,Hofstetter; Carolyn,15,0,15,0
1714379152542,LIGM 5A,A00,507421,Fischer-Grunski; Eva K,18,0,20,2
1714379153571,LIGM 5B,A00,507423,Fischer-Grunski; Eva K,19,0,20,1
1714379154600,LIGM 5C,A00,507425,Fischer-Grunski; Eva K,19,0,20,1
1714379155622,LIIT 5AS,A00,507427,Carnelos; Chiara,20,0,20,0
1714379156652,LIIT 5BS,A00,507430,Carnelos; Chiara,20,0,20,0
1714379157680,LIIT 5CS,A00,507432,Carnelos; Chiara,20,0,20,0
1714379158704,LISP 5A,A00,507541,Munoz Sanchez; Alicia,11,0,20,9
1714379159732,LISP 5B,A00,507671,Munoz Sanchez; Alicia,9,0,20,11
1714379160767,LISP 5C,A00,507696,Munoz Sanchez; Alicia,9,0,20,11
1714379161791,MAE 197,001,528363,Boechler; Nicholas Sebastia,9998,0,9999,1
1714379162820,MATH 197,001,523477,Kedlaya; Kiran S.,9996,0,9999,3
1714379162820,MATH 197,002,563811,Zhang; Danna,9995,0,9999,4
1714379162820,MATH 197,003,628552,Dumitriu; Ioana,9998,0,9999,1
1714379163845,MCWP 40R,A00,518780,Staff,5,0,20,15
1714379163845,MCWP 40R,B00,518781,Staff,7,0,20,13
1714379163845,MCWP 40R,C00,518783,Staff,5,0,20,15
1714379164872,MCWP 50R,A00,518791,Staff,0,0,20,20
1714379164872,MCWP 50R,B00,518792,Staff,0,1,20,20
1714379164872,MCWP 50R,C00,518793,Staff,0,1,20,20
1714379164872,MCWP 50R,D00,518794,Staff,0,0,20,20
1714379164872,MCWP 50R,E00,518795,Staff,0,1,20,20
1714379164872,MCWP 50R,F00,518796,Staff,0,0,20,20
1714379164872,MCWP 50R,G00,518797,Staff,0,1,20,20
1714379165897,MMW 12R,A01,514034,Herbst; Matthew,0,1,16,16
1714379165897,MMW 12R,A02,514035,Herbst; Matthew,2,0,16,14
1714379166921,MMW 13R,A01,514037,Staff,0,4,16,16
1714379166921,MMW 13R,A02,514039,Staff,0,2,16,16
1714379166921,MMW 13R,A03,628519,Staff,0,2,16,16
1714379168971,SIO 295LS,A00,523233,Staff,12,0,30,18
1714379169998,SIO 295S,A00,523232,Staff,12,0,30,18
1714379171023,SIOC 290S,A01,637330,Merrifield; Mark A,27,0,30,3
1714379172054,SIOC 291S,A01,637333,Gabriel; Corey John,27,0,30,3
1714379173082,SOCI 117,A01,494376,Staff,0,4,5,5
1714379174107,WES 237B,A00,494380,Staff,9,0,20,11
